time,subj_course_id,sec_code,sec_id,prof,available,waitlist,total,enrolled_ct
1657970527708,COGS 9,A01,083615,Shannon; Kyle Michael,11,0,75,64
1657970533748,COGS 11,A01,083617,Boyle; Mary E. T.,23,0,48,25
1657970539777,COGS 13,A01,083071,Bastos; Amalia Pinkusfeld,12,0,71,59
1657970545818,COGS 14A,A01,092681,Semenuks; Arturs,5,1,100,95
1657970551846,COGS 14B,A01,083073,Cheng; Tzu-Han,7,0,63,56
1657970557877,COGS 17,A01,092677,Semenuks; Arturs,7,0,81,74
1657970563915,COGS 100,A01,083619,Allen; Michael Gordon,17,0,70,53
1657970569946,COGS 101A,A01,083621,Davis; Joshua Daniel,9,0,68,59
1657970575976,COGS 101B,A01,091572,Allen; Michael Gordon,14,0,65,51
1657970582013,COGS 101C,A01,083625,Delgado; Tania,17,0,35,18
1657970588042,COGS 107A,A01,083627,Boyle; Mary E. T.,14,0,60,46
1657970594071,COGS 118A,A01,083075,Gupta; Anjum,21,0,76,55
1657970600116,CSE 3,A50,083646,Miranda; Gregory Joseph,24,0,50,26
1657970606147,CSE 8A,A50,083650,Miranda; Gregory Joseph,17,1,56,39
1657970612188,CSE 11,A01,083080,Cao; Yingjun,7,15,40,33
1657970618235,CSE 12,A01,083652,Krause-Levy; Sophia Louisa,30,1,120,90
1657970624268,CSE 15L,A01,083654,Morris; Justin Loren,9,0,50,41
1657970624268,CSE 15L,A02,083655,Morris; Justin Loren,11,0,50,39
1657970630301,CSE 20,A01,083657,Tran; Khoa Dang,39,0,80,41
1657970636334,CSE 21,A01,095574,Bach; Quang Tran,23,0,48,25
1657970642367,CSE 30,A01,083084,Eldon; John,8,0,80,72
1657970642367,CSE 30,B01,095061,Bhaskar; Nishant,9,0,50,41
1657970648395,CSE 100,A01,083659,Cao; Yingjun,5,4,70,65
1657970654423,CSE 134B,A01,083661,Powell; Thomas Allan,25,0,100,75
1657970660453,CSE 140,A01,083663,Gungor; Onat,17,0,85,68
1657970666485,CSE 140L,A01,083088,Eldon; John,23,0,100,77
1657970672531,CSE 175,A01,083665,Kumar; Rakesh,3,0,25,22
1657970678564,CSE 190,A00,092507,Dubnov; Shlomo,8,0,20,12
1657970684595,ECE 45,A01,083139,Congero; Spencer William,7,0,75,68
1657970690630,ECE 65,A50,083695,Saad; Andrew S,12,0,30,18
1657970690630,ECE 65,A51,095125,Saad; Andrew S,24,0,26,2
1657970696673,ECE 109,A01,091882,Touri; Behrouz,21,0,70,49
1657970702707,ECE 180,A00,083140,Abi Samra; Nicholas Camill,1,0,30,29
1657970702707,ECE 180,B00,083141,Abi Samra; Nicholas Camill,0,0,30,30
1657970708746,MATH 10A,A01,083735,Patchell; Gregory David,2,0,30,28
1657970708746,MATH 10A,A02,083736,Patchell; Gregory David,20,0,30,10
1657970708746,MATH 10A,A03,083737,Patchell; Gregory David,16,0,30,14
1657970714784,MATH 10B,A01,083207,Lim; Seonhee,9,0,34,25
1657970714784,MATH 10B,A02,083208,Lim; Seonhee,10,0,35,25
1657970714784,MATH 10B,A03,093472,Lim; Seonhee,7,0,34,27
1657970714784,MATH 10B,B01,083739,Sinha; Shubham,14,0,30,16
1657970720830,MATH 18,A01,083743,Cinel; Cameron Alexander,9,0,30,21
1657970720830,MATH 18,A02,083744,Cinel; Cameron Alexander,18,0,30,12
1657970720830,MATH 18,A03,083745,Cinel; Cameron Alexander,10,0,30,20
1657970720830,MATH 18,B01,083748,Rideout; David Porter,5,0,37,32
1657970720830,MATH 18,B02,083749,Rideout; David Porter,5,0,36,31
1657970720830,MATH 18,B03,083750,Rideout; David Porter,3,0,37,34
1657970720830,MATH 18,B04,083751,Rideout; David Porter,7,0,36,29
1657970720830,MATH 18,B05,093473,Rideout; David Porter,7,0,36,29
1657970720830,MATH 18,B06,093474,Rideout; David Porter,6,0,36,30
1657970726859,MATH 20A,A01,083754,Zheng; Zequn,14,0,40,26
1657970732908,MATH 20B,A01,083756,Briones; Jor-el Thomas Caparas,4,0,36,32
1657970732908,MATH 20B,A02,083757,Briones; Jor-el Thomas Caparas,1,0,36,35
1657970732908,MATH 20B,A03,093475,Briones; Jor-el Thomas Caparas,3,0,36,33
1657970738940,MATH 20C,A01,083760,Briones; Jor-el Thomas Caparas,1,0,35,34
1657970738940,MATH 20C,A02,083761,Briones; Jor-el Thomas Caparas,8,0,35,27
1657970738940,MATH 20C,A03,093476,Briones; Jor-el Thomas Caparas,0,1,36,36
1657970738940,MATH 20C,B01,083762,Bach; Quang Tran,1,0,30,29
1657970744972,MATH 20D,A01,083765,Tran; Brian Kha,5,0,30,25
1657970744972,MATH 20D,A02,083766,Tran; Brian Kha,5,0,30,25
1657970744972,MATH 20D,A03,083767,Tran; Brian Kha,6,0,30,24
1657970751014,MATH 20E,A01,083771,Ganguly; Soumya,12,0,32,20
1657970751014,MATH 20E,A02,083772,Ganguly; Soumya,7,0,32,25
1657970751014,MATH 20E,B01,083773,Ciotti; Benjamin,20,0,35,15
1657970751014,MATH 20E,B02,083774,Ciotti; Benjamin,18,0,35,17
1657970757056,MATH 103A,A01,083777,Greenfeld; Be'Eri,6,0,36,30
1657970757056,MATH 103A,A02,083778,Greenfeld; Be'Eri,5,0,36,31
1657970757056,MATH 103A,A03,093561,Greenfeld; Be'Eri,7,0,36,29
1657970757056,MATH 103A,B01,083779,Greenfeld; Be'Eri,8,0,36,28
1657970757056,MATH 103A,B02,083780,Greenfeld; Be'Eri,4,0,36,32
1657970757056,MATH 103A,B03,093562,Greenfeld; Be'Eri,3,0,36,33
1657970763086,MATH 105,A01,085443,Carter; Anne Toulson,15,0,35,20
1657970763086,MATH 105,A02,093477,Carter; Anne Toulson,20,0,35,15
1657970769118,MATH 109,A01,083213,Ganzberger; Geoffrey Michael,3,0,34,31
1657970769118,MATH 109,A02,083214,Ganzberger; Geoffrey Michael,4,0,34,30
1657970769118,MATH 109,A03,093478,Ganzberger; Geoffrey Michael,2,0,34,32
1657970769118,MATH 109,B01,083215,Ganzberger; Geoffrey Michael,3,0,32,29
1657970769118,MATH 109,B02,083216,Ganzberger; Geoffrey Michael,3,0,32,29
1657970769118,MATH 109,B03,093479,Ganzberger; Geoffrey Michael,8,0,32,24
1657970775150,MATH 142A,A01,083219,Chow; Bennett,7,0,32,25
1657970775150,MATH 142A,A02,083220,Chow; Bennett,10,0,32,22
1657970775150,MATH 142A,A03,093480,Chow; Bennett,9,0,32,23
1657970775150,MATH 142A,B03,093481,Chow; Bennett,8,0,32,24
1657970775150,MATH 142A,B04,093558,Chow; Bennett,14,0,32,18
1657970775150,MATH 142A,B05,093559,Chow; Bennett,7,0,32,25
1657970781190,MATH 193A,A01,083224,Rotar; Vladimir,9,0,34,25
1657970781190,MATH 193A,A02,083225,Rotar; Vladimir,11,0,34,23
1657970781190,MATH 193A,A03,083781,Rotar; Vladimir,5,0,34,29
1657970781190,MATH 193A,A04,083782,Rotar; Vladimir,12,0,34,22
1657970781190,MATH 193A,A05,093482,Rotar; Vladimir,11,0,34,23
1657970787221,MATH 197,001,091859,McAuley; Julian John,9999,0,9999,0
1657970787221,MATH 197,002,095566,Kedlaya; Kiran S.,9997,0,9999,2
1657970787221,MATH 197,003,095567,Xiao; Ming,9999,0,9999,0
1657970787221,MATH 197,004,095571,Perols; Johan Lars,9998,0,9999,1
1657970794313,COGS 9,A01,083615,Shannon; Kyle Michael,11,0,75,64
1657970800347,COGS 11,A01,083617,Boyle; Mary E. T.,23,0,48,25
1657970806377,COGS 13,A01,083071,Bastos; Amalia Pinkusfeld,12,0,71,59
1657970822594,COGS 14A,A01,092681,Semenuks; Arturs,5,1,100,95
1657970828625,COGS 14B,A01,083073,Cheng; Tzu-Han,7,0,63,56
1657970843737,COGS 17,A01,092677,Semenuks; Arturs,7,0,81,74
1657970849773,COGS 100,A01,083619,Allen; Michael Gordon,17,0,70,53
1657970855805,COGS 101A,A01,083621,Davis; Joshua Daniel,9,0,68,59
1657970861848,COGS 101B,A01,091572,Allen; Michael Gordon,14,0,65,51
1657970867882,COGS 101C,A01,083625,Delgado; Tania,17,0,35,18
1657970873913,COGS 107A,A01,083627,Boyle; Mary E. T.,14,0,60,46
1657970879941,COGS 118A,A01,083075,Gupta; Anjum,21,0,76,55
1657970885973,CSE 3,A50,083646,Miranda; Gregory Joseph,24,0,50,26
1657970892015,CSE 8A,A50,083650,Miranda; Gregory Joseph,17,1,56,39
1657970898046,CSE 11,A01,083080,Cao; Yingjun,7,15,40,33
1657970904078,CSE 12,A01,083652,Krause-Levy; Sophia Louisa,30,1,120,90
1657970910105,CSE 15L,A01,083654,Morris; Justin Loren,9,0,50,41
1657970910105,CSE 15L,A02,083655,Morris; Justin Loren,11,0,50,39
1657970916134,CSE 20,A01,083657,Tran; Khoa Dang,39,0,80,41
1657970922164,CSE 21,A01,095574,Bach; Quang Tran,23,0,48,25
1657970928202,CSE 30,A01,083084,Eldon; John,8,0,80,72
1657970928202,CSE 30,B01,095061,Bhaskar; Nishant,9,0,50,41
1657970934238,CSE 100,A01,083659,Cao; Yingjun,5,4,70,65
1657970940277,CSE 134B,A01,083661,Powell; Thomas Allan,25,0,100,75
1657970946305,CSE 140,A01,083663,Gungor; Onat,17,0,85,68
1657970952353,CSE 140L,A01,083088,Eldon; John,23,0,100,77
1657970958382,CSE 175,A01,083665,Kumar; Rakesh,3,0,25,22
1657970964427,CSE 190,A00,092507,Dubnov; Shlomo,8,0,20,12
1657970970461,ECE 45,A01,083139,Congero; Spencer William,7,0,75,68
1657970976500,ECE 65,A50,083695,Saad; Andrew S,12,0,30,18
1657970976500,ECE 65,A51,095125,Saad; Andrew S,24,0,26,2
1657970982530,ECE 109,A01,091882,Touri; Behrouz,21,0,70,49
1657970988595,ECE 180,A00,083140,Abi Samra; Nicholas Camill,1,0,30,29
1657970988595,ECE 180,B00,083141,Abi Samra; Nicholas Camill,0,0,30,30
1657970994629,MATH 10A,A01,083735,Patchell; Gregory David,2,0,30,28
1657970994629,MATH 10A,A02,083736,Patchell; Gregory David,20,0,30,10
1657970994629,MATH 10A,A03,083737,Patchell; Gregory David,16,0,30,14
1657971000663,MATH 10B,A01,083207,Lim; Seonhee,9,0,34,25
1657971000663,MATH 10B,A02,083208,Lim; Seonhee,10,0,35,25
1657971000663,MATH 10B,A03,093472,Lim; Seonhee,7,0,34,27
1657971000663,MATH 10B,B01,083739,Sinha; Shubham,14,0,30,16
1657971006703,MATH 18,A01,083743,Cinel; Cameron Alexander,9,0,30,21
1657971006703,MATH 18,A02,083744,Cinel; Cameron Alexander,18,0,30,12
1657971006703,MATH 18,A03,083745,Cinel; Cameron Alexander,10,0,30,20
1657971006703,MATH 18,B01,083748,Rideout; David Porter,5,0,37,32
1657971006703,MATH 18,B02,083749,Rideout; David Porter,5,0,36,31
1657971006703,MATH 18,B03,083750,Rideout; David Porter,3,0,37,34
1657971006703,MATH 18,B04,083751,Rideout; David Porter,7,0,36,29
1657971006703,MATH 18,B05,093473,Rideout; David Porter,7,0,36,29
1657971006703,MATH 18,B06,093474,Rideout; David Porter,6,0,36,30
1657971012729,MATH 20A,A01,083754,Zheng; Zequn,14,0,40,26
1657971018759,MATH 20B,A01,083756,Briones; Jor-el Thomas Caparas,4,0,36,32
1657971018759,MATH 20B,A02,083757,Briones; Jor-el Thomas Caparas,1,0,36,35
1657971018759,MATH 20B,A03,093475,Briones; Jor-el Thomas Caparas,3,0,36,33
1657971024791,MATH 20C,A01,083760,Briones; Jor-el Thomas Caparas,1,0,35,34
1657971024791,MATH 20C,A02,083761,Briones; Jor-el Thomas Caparas,8,0,35,27
1657971024791,MATH 20C,A03,093476,Briones; Jor-el Thomas Caparas,0,1,36,36
1657971024791,MATH 20C,B01,083762,Bach; Quang Tran,1,0,30,29
1657971030817,MATH 20D,A01,083765,Tran; Brian Kha,5,0,30,25
1657971030817,MATH 20D,A02,083766,Tran; Brian Kha,5,0,30,25
1657971030817,MATH 20D,A03,083767,Tran; Brian Kha,6,0,30,24
1657971036852,MATH 20E,A01,083771,Ganguly; Soumya,12,0,32,20
1657971036852,MATH 20E,A02,083772,Ganguly; Soumya,7,0,32,25
1657971036852,MATH 20E,B01,083773,Ciotti; Benjamin,20,0,35,15
1657971036852,MATH 20E,B02,083774,Ciotti; Benjamin,18,0,35,17
1657971042890,MATH 103A,A01,083777,Greenfeld; Be'Eri,6,0,36,30
1657971042890,MATH 103A,A02,083778,Greenfeld; Be'Eri,5,0,36,31
1657971042890,MATH 103A,A03,093561,Greenfeld; Be'Eri,7,0,36,29
1657971042890,MATH 103A,B01,083779,Greenfeld; Be'Eri,8,0,36,28
1657971042890,MATH 103A,B02,083780,Greenfeld; Be'Eri,4,0,36,32
1657971042890,MATH 103A,B03,093562,Greenfeld; Be'Eri,3,0,36,33
1657971048931,MATH 105,A01,085443,Carter; Anne Toulson,15,0,35,20
1657971048931,MATH 105,A02,093477,Carter; Anne Toulson,20,0,35,15
1657971054968,MATH 109,A01,083213,Ganzberger; Geoffrey Michael,3,0,34,31
1657971054968,MATH 109,A02,083214,Ganzberger; Geoffrey Michael,4,0,34,30
1657971054968,MATH 109,A03,093478,Ganzberger; Geoffrey Michael,2,0,34,32
1657971054968,MATH 109,B01,083215,Ganzberger; Geoffrey Michael,3,0,32,29
1657971054968,MATH 109,B02,083216,Ganzberger; Geoffrey Michael,3,0,32,29
1657971054968,MATH 109,B03,093479,Ganzberger; Geoffrey Michael,8,0,32,24
1657971061034,MATH 142A,A01,083219,Chow; Bennett,7,0,32,25
1657971061034,MATH 142A,A02,083220,Chow; Bennett,10,0,32,22
1657971061034,MATH 142A,A03,093480,Chow; Bennett,9,0,32,23
1657971061034,MATH 142A,B03,093481,Chow; Bennett,8,0,32,24
1657971061034,MATH 142A,B04,093558,Chow; Bennett,14,0,32,18
1657971061034,MATH 142A,B05,093559,Chow; Bennett,7,0,32,25
1657971067062,MATH 193A,A01,083224,Rotar; Vladimir,9,0,34,25
1657971067062,MATH 193A,A02,083225,Rotar; Vladimir,11,0,34,23
1657971067062,MATH 193A,A03,083781,Rotar; Vladimir,5,0,34,29
1657971067062,MATH 193A,A04,083782,Rotar; Vladimir,12,0,34,22
1657971067062,MATH 193A,A05,093482,Rotar; Vladimir,11,0,34,23
1657971073103,MATH 197,001,091859,McAuley; Julian John,9999,0,9999,0
1657971073103,MATH 197,002,095566,Kedlaya; Kiran S.,9997,0,9999,2
1657971073103,MATH 197,003,095567,Xiao; Ming,9999,0,9999,0
1657971073103,MATH 197,004,095571,Perols; Johan Lars,9998,0,9999,1
1657971080185,COGS 9,A01,083615,Shannon; Kyle Michael,11,0,75,64
1657971086227,COGS 11,A01,083617,Boyle; Mary E. T.,23,0,48,25
1657971092258,COGS 13,A01,083071,Bastos; Amalia Pinkusfeld,12,0,71,59
1657971098286,COGS 14A,A01,092681,Semenuks; Arturs,5,1,100,95
1657971104311,COGS 14B,A01,083073,Cheng; Tzu-Han,7,0,63,56
1657971110340,COGS 17,A01,092677,Semenuks; Arturs,7,0,81,74
1657971116373,COGS 100,A01,083619,Allen; Michael Gordon,17,0,70,53
1657971122479,COGS 101A,A01,083621,Davis; Joshua Daniel,9,0,68,59
1657971128510,COGS 101B,A01,091572,Allen; Michael Gordon,14,0,65,51
1657971134537,COGS 101C,A01,083625,Delgado; Tania,17,0,35,18
1657971140565,COGS 107A,A01,083627,Boyle; Mary E. T.,14,0,60,46
1657971146597,COGS 118A,A01,083075,Gupta; Anjum,21,0,76,55
1657971152625,CSE 3,A50,083646,Miranda; Gregory Joseph,24,0,50,26
1657971158655,CSE 8A,A50,083650,Miranda; Gregory Joseph,17,1,56,39
1657971164693,CSE 11,A01,083080,Cao; Yingjun,7,15,40,33
1657971170725,CSE 12,A01,083652,Krause-Levy; Sophia Louisa,30,1,120,90
1657971176792,CSE 15L,A01,083654,Morris; Justin Loren,9,0,50,41
1657971176792,CSE 15L,A02,083655,Morris; Justin Loren,11,0,50,39
1657971182818,CSE 20,A01,083657,Tran; Khoa Dang,39,0,80,41
1657971188843,CSE 21,A01,095574,Bach; Quang Tran,23,0,48,25
1657971194897,CSE 30,A01,083084,Eldon; John,8,0,80,72
1657971194897,CSE 30,B01,095061,Bhaskar; Nishant,9,0,50,41
1657971200922,CSE 100,A01,083659,Cao; Yingjun,5,4,70,65
1657971206957,CSE 134B,A01,083661,Powell; Thomas Allan,25,0,100,75
1657971212986,CSE 140,A01,083663,Gungor; Onat,17,0,85,68
1657971219014,CSE 140L,A01,083088,Eldon; John,23,0,100,77
1657971225041,CSE 175,A01,083665,Kumar; Rakesh,3,0,25,22
1657971231074,CSE 190,A00,092507,Dubnov; Shlomo,8,0,20,12
1657971237101,ECE 45,A01,083139,Congero; Spencer William,7,0,75,68
1657971243141,ECE 65,A50,083695,Saad; Andrew S,12,0,30,18
1657971243141,ECE 65,A51,095125,Saad; Andrew S,24,0,26,2
1657971249167,ECE 109,A01,091882,Touri; Behrouz,21,0,70,49
1657971255195,ECE 180,A00,083140,Abi Samra; Nicholas Camill,1,0,30,29
1657971255195,ECE 180,B00,083141,Abi Samra; Nicholas Camill,0,0,30,30
1657971261234,MATH 10A,A01,083735,Patchell; Gregory David,2,0,30,28
1657971261234,MATH 10A,A02,083736,Patchell; Gregory David,20,0,30,10
1657971261234,MATH 10A,A03,083737,Patchell; Gregory David,16,0,30,14
1657971267302,MATH 10B,A01,083207,Lim; Seonhee,9,0,34,25
1657971267302,MATH 10B,A02,083208,Lim; Seonhee,10,0,35,25
1657971267302,MATH 10B,A03,093472,Lim; Seonhee,7,0,34,27
1657971267302,MATH 10B,B01,083739,Sinha; Shubham,14,0,30,16
1657971273334,MATH 18,A01,083743,Cinel; Cameron Alexander,9,0,30,21
1657971273334,MATH 18,A02,083744,Cinel; Cameron Alexander,18,0,30,12
1657971273334,MATH 18,A03,083745,Cinel; Cameron Alexander,10,0,30,20
1657971273334,MATH 18,B01,083748,Rideout; David Porter,5,0,37,32
1657971273334,MATH 18,B02,083749,Rideout; David Porter,5,0,36,31
1657971273334,MATH 18,B03,083750,Rideout; David Porter,3,0,37,34
1657971273334,MATH 18,B04,083751,Rideout; David Porter,7,0,36,29
1657971273334,MATH 18,B05,093473,Rideout; David Porter,7,0,36,29
1657971273334,MATH 18,B06,093474,Rideout; David Porter,6,0,36,30
1657971279360,MATH 20A,A01,083754,Zheng; Zequn,14,0,40,26
1657971285389,MATH 20B,A01,083756,Briones; Jor-el Thomas Caparas,4,0,36,32
1657971285389,MATH 20B,A02,083757,Briones; Jor-el Thomas Caparas,1,0,36,35
1657971285389,MATH 20B,A03,093475,Briones; Jor-el Thomas Caparas,3,0,36,33
1657971291415,MATH 20C,A01,083760,Briones; Jor-el Thomas Caparas,1,0,35,34
1657971291415,MATH 20C,A02,083761,Briones; Jor-el Thomas Caparas,8,0,35,27
1657971291415,MATH 20C,A03,093476,Briones; Jor-el Thomas Caparas,0,1,36,36
1657971291415,MATH 20C,B01,083762,Bach; Quang Tran,1,0,30,29
1657971297446,MATH 20D,A01,083765,Tran; Brian Kha,5,0,30,25
1657971297446,MATH 20D,A02,083766,Tran; Brian Kha,5,0,30,25
1657971297446,MATH 20D,A03,083767,Tran; Brian Kha,6,0,30,24
1657971303482,MATH 20E,A01,083771,Ganguly; Soumya,12,0,32,20
1657971303482,MATH 20E,A02,083772,Ganguly; Soumya,7,0,32,25
1657971303482,MATH 20E,B01,083773,Ciotti; Benjamin,20,0,35,15
1657971303482,MATH 20E,B02,083774,Ciotti; Benjamin,18,0,35,17
1657971309513,MATH 103A,A01,083777,Greenfeld; Be'Eri,6,0,36,30
1657971309513,MATH 103A,A02,083778,Greenfeld; Be'Eri,5,0,36,31
1657971309513,MATH 103A,A03,093561,Greenfeld; Be'Eri,7,0,36,29
1657971309513,MATH 103A,B01,083779,Greenfeld; Be'Eri,8,0,36,28
1657971309513,MATH 103A,B02,083780,Greenfeld; Be'Eri,4,0,36,32
1657971309513,MATH 103A,B03,093562,Greenfeld; Be'Eri,3,0,36,33
1657971315542,MATH 105,A01,085443,Carter; Anne Toulson,15,0,35,20
1657971315542,MATH 105,A02,093477,Carter; Anne Toulson,20,0,35,15
1657971321577,MATH 109,A01,083213,Ganzberger; Geoffrey Michael,3,0,34,31
1657971321577,MATH 109,A02,083214,Ganzberger; Geoffrey Michael,4,0,34,30
1657971321577,MATH 109,A03,093478,Ganzberger; Geoffrey Michael,2,0,34,32
1657971321577,MATH 109,B01,083215,Ganzberger; Geoffrey Michael,3,0,32,29
1657971321577,MATH 109,B02,083216,Ganzberger; Geoffrey Michael,3,0,32,29
1657971321577,MATH 109,B03,093479,Ganzberger; Geoffrey Michael,8,0,32,24
1657971327626,MATH 142A,A01,083219,Chow; Bennett,7,0,32,25
1657971327626,MATH 142A,A02,083220,Chow; Bennett,10,0,32,22
1657971327626,MATH 142A,A03,093480,Chow; Bennett,9,0,32,23
1657971327626,MATH 142A,B03,093481,Chow; Bennett,8,0,32,24
1657971327626,MATH 142A,B04,093558,Chow; Bennett,14,0,32,18
1657971327626,MATH 142A,B05,093559,Chow; Bennett,7,0,32,25
1657971333653,MATH 193A,A01,083224,Rotar; Vladimir,9,0,34,25
1657971333653,MATH 193A,A02,083225,Rotar; Vladimir,11,0,34,23
1657971333653,MATH 193A,A03,083781,Rotar; Vladimir,5,0,34,29
1657971333653,MATH 193A,A04,083782,Rotar; Vladimir,12,0,34,22
1657971333653,MATH 193A,A05,093482,Rotar; Vladimir,11,0,34,23
1657971339682,MATH 197,001,091859,McAuley; Julian John,9999,0,9999,0
1657971339682,MATH 197,002,095566,Kedlaya; Kiran S.,9997,0,9999,2
1657971339682,MATH 197,003,095567,Xiao; Ming,9999,0,9999,0
1657971339682,MATH 197,004,095571,Perols; Johan Lars,9998,0,9999,1
1657971346758,COGS 9,A01,083615,Shannon; Kyle Michael,11,0,75,64
1657971352781,COGS 11,A01,083617,Boyle; Mary E. T.,23,0,48,25
1657971358814,COGS 13,A01,083071,Bastos; Amalia Pinkusfeld,12,0,71,59
1657971364838,COGS 14A,A01,092681,Semenuks; Arturs,5,1,100,95
1657971370863,COGS 14B,A01,083073,Cheng; Tzu-Han,7,0,63,56
1657971376891,COGS 17,A01,092677,Semenuks; Arturs,7,0,81,74
1657971382916,COGS 100,A01,083619,Allen; Michael Gordon,17,0,70,53
1657971388943,COGS 101A,A01,083621,Davis; Joshua Daniel,9,0,68,59
1657971394971,COGS 101B,A01,091572,Allen; Michael Gordon,14,0,65,51
1657971401005,COGS 101C,A01,083625,Delgado; Tania,17,0,35,18
1657971407031,COGS 107A,A01,083627,Boyle; Mary E. T.,14,0,60,46
1657971413059,COGS 118A,A01,083075,Gupta; Anjum,21,0,76,55
1657971419087,CSE 3,A50,083646,Miranda; Gregory Joseph,24,0,50,26
1657971425120,CSE 8A,A50,083650,Miranda; Gregory Joseph,17,1,56,39
1657971431163,CSE 11,A01,083080,Cao; Yingjun,7,15,40,33
1657971437196,CSE 12,A01,083652,Krause-Levy; Sophia Louisa,30,1,120,90
1657971443224,CSE 15L,A01,083654,Morris; Justin Loren,9,0,50,41
1657971443224,CSE 15L,A02,083655,Morris; Justin Loren,11,0,50,39
1657971449253,CSE 20,A01,083657,Tran; Khoa Dang,39,0,80,41
1657971455293,CSE 21,A01,095574,Bach; Quang Tran,23,0,48,25
1657971461321,CSE 30,A01,083084,Eldon; John,8,0,80,72
1657971461321,CSE 30,B01,095061,Bhaskar; Nishant,9,0,50,41
1657971467348,CSE 100,A01,083659,Cao; Yingjun,5,4,70,65
1657971473386,CSE 134B,A01,083661,Powell; Thomas Allan,25,0,100,75
1657971479415,CSE 140,A01,083663,Gungor; Onat,17,0,85,68
1657971485443,CSE 140L,A01,083088,Eldon; John,23,0,100,77
1657971491471,CSE 175,A01,083665,Kumar; Rakesh,3,0,25,22
1657971497505,CSE 190,A00,092507,Dubnov; Shlomo,8,0,20,12
1657971503532,ECE 45,A01,083139,Congero; Spencer William,7,0,75,68
1657971509564,ECE 65,A50,083695,Saad; Andrew S,12,0,30,18
1657971509564,ECE 65,A51,095125,Saad; Andrew S,24,0,26,2
1657971515591,ECE 109,A01,091882,Touri; Behrouz,21,0,70,49
1657971521624,ECE 180,A00,083140,Abi Samra; Nicholas Camill,1,0,30,29
1657971521624,ECE 180,B00,083141,Abi Samra; Nicholas Camill,0,0,30,30
1657971527653,MATH 10A,A01,083735,Patchell; Gregory David,2,0,30,28
1657971527653,MATH 10A,A02,083736,Patchell; Gregory David,20,0,30,10
1657971527653,MATH 10A,A03,083737,Patchell; Gregory David,16,0,30,14
1657971533682,MATH 10B,A01,083207,Lim; Seonhee,9,0,34,25
1657971533682,MATH 10B,A02,083208,Lim; Seonhee,10,0,35,25
1657971533682,MATH 10B,A03,093472,Lim; Seonhee,7,0,34,27
1657971533682,MATH 10B,B01,083739,Sinha; Shubham,14,0,30,16
1657971539730,MATH 18,A01,083743,Cinel; Cameron Alexander,9,0,30,21
1657971539730,MATH 18,A02,083744,Cinel; Cameron Alexander,18,0,30,12
1657971539730,MATH 18,A03,083745,Cinel; Cameron Alexander,10,0,30,20
1657971539730,MATH 18,B01,083748,Rideout; David Porter,5,0,37,32
1657971539730,MATH 18,B02,083749,Rideout; David Porter,5,0,36,31
1657971539730,MATH 18,B03,083750,Rideout; David Porter,3,0,37,34
1657971539730,MATH 18,B04,083751,Rideout; David Porter,7,0,36,29
1657971539730,MATH 18,B05,093473,Rideout; David Porter,7,0,36,29
1657971539730,MATH 18,B06,093474,Rideout; David Porter,6,0,36,30
1657971545757,MATH 20A,A01,083754,Zheng; Zequn,14,0,40,26
1657971551786,MATH 20B,A01,083756,Briones; Jor-el Thomas Caparas,4,0,36,32
1657971551786,MATH 20B,A02,083757,Briones; Jor-el Thomas Caparas,1,0,36,35
1657971551786,MATH 20B,A03,093475,Briones; Jor-el Thomas Caparas,3,0,36,33
1657971557831,MATH 20C,A01,083760,Briones; Jor-el Thomas Caparas,1,0,35,34
1657971557831,MATH 20C,A02,083761,Briones; Jor-el Thomas Caparas,8,0,35,27
1657971557831,MATH 20C,A03,093476,Briones; Jor-el Thomas Caparas,0,1,36,36
1657971557831,MATH 20C,B01,083762,Bach; Quang Tran,1,0,30,29
1657971563857,MATH 20D,A01,083765,Tran; Brian Kha,5,0,30,25
1657971563857,MATH 20D,A02,083766,Tran; Brian Kha,5,0,30,25
1657971563857,MATH 20D,A03,083767,Tran; Brian Kha,6,0,30,24
1657971569910,MATH 20E,A01,083771,Ganguly; Soumya,12,0,32,20
1657971569910,MATH 20E,A02,083772,Ganguly; Soumya,7,0,32,25
1657971569910,MATH 20E,B01,083773,Ciotti; Benjamin,20,0,35,15
1657971569910,MATH 20E,B02,083774,Ciotti; Benjamin,18,0,35,17
1657971575950,MATH 103A,A01,083777,Greenfeld; Be'Eri,6,0,36,30
1657971575950,MATH 103A,A02,083778,Greenfeld; Be'Eri,5,0,36,31
1657971575950,MATH 103A,A03,093561,Greenfeld; Be'Eri,7,0,36,29
1657971575950,MATH 103A,B01,083779,Greenfeld; Be'Eri,8,0,36,28
1657971575950,MATH 103A,B02,083780,Greenfeld; Be'Eri,4,0,36,32
1657971575950,MATH 103A,B03,093562,Greenfeld; Be'Eri,3,0,36,33
1657971581988,MATH 105,A01,085443,Carter; Anne Toulson,15,0,35,20
1657971581988,MATH 105,A02,093477,Carter; Anne Toulson,20,0,35,15
1657971588017,MATH 109,A01,083213,Ganzberger; Geoffrey Michael,3,0,34,31
1657971588017,MATH 109,A02,083214,Ganzberger; Geoffrey Michael,4,0,34,30
1657971588017,MATH 109,A03,093478,Ganzberger; Geoffrey Michael,2,0,34,32
1657971588017,MATH 109,B01,083215,Ganzberger; Geoffrey Michael,3,0,32,29
1657971588017,MATH 109,B02,083216,Ganzberger; Geoffrey Michael,3,0,32,29
1657971588017,MATH 109,B03,093479,Ganzberger; Geoffrey Michael,8,0,32,24
1657971613357,MATH 142A,A01,083219,Chow; Bennett,7,0,32,25
1657971613357,MATH 142A,A02,083220,Chow; Bennett,10,0,32,22
1657971613357,MATH 142A,A03,093480,Chow; Bennett,9,0,32,23
1657971613357,MATH 142A,B03,093481,Chow; Bennett,8,0,32,24
1657971613357,MATH 142A,B04,093558,Chow; Bennett,14,0,32,18
1657971613357,MATH 142A,B05,093559,Chow; Bennett,7,0,32,25
1657971619386,MATH 193A,A01,083224,Rotar; Vladimir,9,0,34,25
1657971619386,MATH 193A,A02,083225,Rotar; Vladimir,11,0,34,23
1657971619386,MATH 193A,A03,083781,Rotar; Vladimir,5,0,34,29
1657971619386,MATH 193A,A04,083782,Rotar; Vladimir,12,0,34,22
1657971619386,MATH 193A,A05,093482,Rotar; Vladimir,11,0,34,23
1657971625418,MATH 197,001,091859,McAuley; Julian John,9999,0,9999,0
1657971625418,MATH 197,002,095566,Kedlaya; Kiran S.,9997,0,9999,2
1657971625418,MATH 197,003,095567,Xiao; Ming,9999,0,9999,0
1657971625418,MATH 197,004,095571,Perols; Johan Lars,9998,0,9999,1
1657971632498,COGS 9,A01,083615,Shannon; Kyle Michael,11,0,75,64
1657971638541,COGS 11,A01,083617,Boyle; Mary E. T.,23,0,48,25
1657971644568,COGS 13,A01,083071,Bastos; Amalia Pinkusfeld,12,0,71,59
1657971650598,COGS 14A,A01,092681,Semenuks; Arturs,5,1,100,95
1657971656624,COGS 14B,A01,083073,Cheng; Tzu-Han,7,0,63,56
1657971662650,COGS 17,A01,092677,Semenuks; Arturs,7,0,81,74
1657971668685,COGS 100,A01,083619,Allen; Michael Gordon,17,0,70,53
1657971674719,COGS 101A,A01,083621,Davis; Joshua Daniel,9,0,68,59
1657971680752,COGS 101B,A01,091572,Allen; Michael Gordon,14,0,65,51
1657971686790,COGS 101C,A01,083625,Delgado; Tania,17,0,35,18
1657971692817,COGS 107A,A01,083627,Boyle; Mary E. T.,14,0,60,46
1657971698845,COGS 118A,A01,083075,Gupta; Anjum,21,0,76,55
1657971704874,CSE 3,A50,083646,Miranda; Gregory Joseph,24,0,50,26
1657971710901,CSE 8A,A50,083650,Miranda; Gregory Joseph,17,1,56,39
1657971716927,CSE 11,A01,083080,Cao; Yingjun,7,15,40,33
1657971722955,CSE 12,A01,083652,Krause-Levy; Sophia Louisa,30,1,120,90
1657971728983,CSE 15L,A01,083654,Morris; Justin Loren,9,0,50,41
1657971728983,CSE 15L,A02,083655,Morris; Justin Loren,11,0,50,39
1657971735010,CSE 20,A01,083657,Tran; Khoa Dang,39,0,80,41
1657971741118,CSE 21,A01,095574,Bach; Quang Tran,23,0,48,25
1657971747149,CSE 30,A01,083084,Eldon; John,8,0,80,72
1657971747149,CSE 30,B01,095061,Bhaskar; Nishant,9,0,50,41
1657971753179,CSE 100,A01,083659,Cao; Yingjun,5,4,70,65
1657971759215,CSE 134B,A01,083661,Powell; Thomas Allan,25,0,100,75
1657971765246,CSE 140,A01,083663,Gungor; Onat,17,0,85,68
1657971771269,CSE 140L,A01,083088,Eldon; John,23,0,100,77
1657971777297,CSE 175,A01,083665,Kumar; Rakesh,3,0,25,22
1657971783324,CSE 190,A00,092507,Dubnov; Shlomo,8,0,20,12
1657971789354,ECE 45,A01,083139,Congero; Spencer William,7,0,75,68
1657971795381,ECE 65,A50,083695,Saad; Andrew S,12,0,30,18
1657971795381,ECE 65,A51,095125,Saad; Andrew S,24,0,26,2
1657971801408,ECE 109,A01,091882,Touri; Behrouz,21,0,70,49
1657971807437,ECE 180,A00,083140,Abi Samra; Nicholas Camill,1,0,30,29
1657971807437,ECE 180,B00,083141,Abi Samra; Nicholas Camill,0,0,30,30
1657971813465,MATH 10A,A01,083735,Patchell; Gregory David,2,0,30,28
1657971813465,MATH 10A,A02,083736,Patchell; Gregory David,20,0,30,10
1657971813465,MATH 10A,A03,083737,Patchell; Gregory David,16,0,30,14
1657971819510,MATH 10B,A01,083207,Lim; Seonhee,9,0,34,25
1657971819510,MATH 10B,A02,083208,Lim; Seonhee,10,0,35,25
1657971819510,MATH 10B,A03,093472,Lim; Seonhee,7,0,34,27
1657971819510,MATH 10B,B01,083739,Sinha; Shubham,14,0,30,16
1657971825540,MATH 18,A01,083743,Cinel; Cameron Alexander,9,0,30,21
1657971825540,MATH 18,A02,083744,Cinel; Cameron Alexander,18,0,30,12
1657971825540,MATH 18,A03,083745,Cinel; Cameron Alexander,10,0,30,20
1657971825540,MATH 18,B01,083748,Rideout; David Porter,5,0,37,32
1657971825540,MATH 18,B02,083749,Rideout; David Porter,5,0,36,31
1657971825540,MATH 18,B03,083750,Rideout; David Porter,3,0,37,34
1657971825540,MATH 18,B04,083751,Rideout; David Porter,7,0,36,29
1657971825540,MATH 18,B05,093473,Rideout; David Porter,7,0,36,29
1657971825540,MATH 18,B06,093474,Rideout; David Porter,6,0,36,30
1657971831572,MATH 20A,A01,083754,Zheng; Zequn,14,0,40,26
1657971837602,MATH 20B,A01,083756,Briones; Jor-el Thomas Caparas,4,0,36,32
1657971837602,MATH 20B,A02,083757,Briones; Jor-el Thomas Caparas,1,0,36,35
1657971837602,MATH 20B,A03,093475,Briones; Jor-el Thomas Caparas,3,0,36,33
1657971843642,MATH 20C,A01,083760,Briones; Jor-el Thomas Caparas,1,0,35,34
1657971843642,MATH 20C,A02,083761,Briones; Jor-el Thomas Caparas,8,0,35,27
1657971843642,MATH 20C,A03,093476,Briones; Jor-el Thomas Caparas,0,1,36,36
1657971843642,MATH 20C,B01,083762,Bach; Quang Tran,1,0,30,29
1657971849676,MATH 20D,A01,083765,Tran; Brian Kha,5,0,30,25
1657971849676,MATH 20D,A02,083766,Tran; Brian Kha,5,0,30,25
1657971849676,MATH 20D,A03,083767,Tran; Brian Kha,6,0,30,24
1657971855703,MATH 20E,A01,083771,Ganguly; Soumya,12,0,32,20
1657971855703,MATH 20E,A02,083772,Ganguly; Soumya,7,0,32,25
1657971855703,MATH 20E,B01,083773,Ciotti; Benjamin,20,0,35,15
1657971855703,MATH 20E,B02,083774,Ciotti; Benjamin,18,0,35,17
1657971861740,MATH 103A,A01,083777,Greenfeld; Be'Eri,6,0,36,30
1657971861740,MATH 103A,A02,083778,Greenfeld; Be'Eri,5,0,36,31
1657971861740,MATH 103A,A03,093561,Greenfeld; Be'Eri,7,0,36,29
1657971861740,MATH 103A,B01,083779,Greenfeld; Be'Eri,8,0,36,28
1657971861740,MATH 103A,B02,083780,Greenfeld; Be'Eri,4,0,36,32
1657971861740,MATH 103A,B03,093562,Greenfeld; Be'Eri,3,0,36,33
1657971867774,MATH 105,A01,085443,Carter; Anne Toulson,15,0,35,20
1657971867774,MATH 105,A02,093477,Carter; Anne Toulson,20,0,35,15
1657971873811,MATH 109,A01,083213,Ganzberger; Geoffrey Michael,3,0,34,31
1657971873811,MATH 109,A02,083214,Ganzberger; Geoffrey Michael,4,0,34,30
1657971873811,MATH 109,A03,093478,Ganzberger; Geoffrey Michael,2,0,34,32
1657971873811,MATH 109,B01,083215,Ganzberger; Geoffrey Michael,3,0,32,29
1657971873811,MATH 109,B02,083216,Ganzberger; Geoffrey Michael,3,0,32,29
1657971873811,MATH 109,B03,093479,Ganzberger; Geoffrey Michael,8,0,32,24
1657971879845,MATH 142A,A01,083219,Chow; Bennett,7,0,32,25
1657971879845,MATH 142A,A02,083220,Chow; Bennett,10,0,32,22
1657971879845,MATH 142A,A03,093480,Chow; Bennett,9,0,32,23
1657971879845,MATH 142A,B03,093481,Chow; Bennett,8,0,32,24
1657971879845,MATH 142A,B04,093558,Chow; Bennett,14,0,32,18
1657971879845,MATH 142A,B05,093559,Chow; Bennett,7,0,32,25
1657971885880,MATH 193A,A01,083224,Rotar; Vladimir,9,0,34,25
1657971885880,MATH 193A,A02,083225,Rotar; Vladimir,11,0,34,23
1657971885880,MATH 193A,A03,083781,Rotar; Vladimir,5,0,34,29
1657971885880,MATH 193A,A04,083782,Rotar; Vladimir,12,0,34,22
1657971885880,MATH 193A,A05,093482,Rotar; Vladimir,11,0,34,23
1657971891909,MATH 197,001,091859,McAuley; Julian John,9999,0,9999,0
1657971891909,MATH 197,002,095566,Kedlaya; Kiran S.,9997,0,9999,2
1657971891909,MATH 197,003,095567,Xiao; Ming,9999,0,9999,0
1657971891909,MATH 197,004,095571,Perols; Johan Lars,9998,0,9999,1
1657971898999,COGS 9,A01,083615,Shannon; Kyle Michael,11,0,75,64
1657971905036,COGS 11,A01,083617,Boyle; Mary E. T.,23,0,48,25
1657971911064,COGS 13,A01,083071,Bastos; Amalia Pinkusfeld,12,0,71,59
1657971917090,COGS 14A,A01,092681,Semenuks; Arturs,5,1,100,95
1657971923118,COGS 14B,A01,083073,Cheng; Tzu-Han,7,0,63,56
1657971929149,COGS 17,A01,092677,Semenuks; Arturs,7,0,81,74
1657971935182,COGS 100,A01,083619,Allen; Michael Gordon,17,0,70,53
1657971941214,COGS 101A,A01,083621,Davis; Joshua Daniel,9,0,68,59
1657971947247,COGS 101B,A01,091572,Allen; Michael Gordon,14,0,65,51
1657971953278,COGS 101C,A01,083625,Delgado; Tania,17,0,35,18
1657971959308,COGS 107A,A01,083627,Boyle; Mary E. T.,14,0,60,46
1657971965334,COGS 118A,A01,083075,Gupta; Anjum,21,0,76,55
1657971971370,CSE 3,A50,083646,Miranda; Gregory Joseph,24,0,50,26
1657971977395,CSE 8A,A50,083650,Miranda; Gregory Joseph,17,1,56,39
1657971983430,CSE 11,A01,083080,Cao; Yingjun,7,15,40,33
1657971989457,CSE 12,A01,083652,Krause-Levy; Sophia Louisa,30,1,120,90
1657971995484,CSE 15L,A01,083654,Morris; Justin Loren,9,0,50,41
1657971995484,CSE 15L,A02,083655,Morris; Justin Loren,11,0,50,39
1657972001514,CSE 20,A01,083657,Tran; Khoa Dang,39,0,80,41
1657972007545,CSE 21,A01,095574,Bach; Quang Tran,23,0,48,25
1657972013573,CSE 30,A01,083084,Eldon; John,8,0,80,72
1657972013573,CSE 30,B01,095061,Bhaskar; Nishant,9,0,50,41
1657972019601,CSE 100,A01,083659,Cao; Yingjun,5,4,70,65
1657972025631,CSE 134B,A01,083661,Powell; Thomas Allan,25,0,100,75
1657972031659,CSE 140,A01,083663,Gungor; Onat,17,0,85,68
1657972037685,CSE 140L,A01,083088,Eldon; John,23,0,100,77
1657972043712,CSE 175,A01,083665,Kumar; Rakesh,3,0,25,22
1657972049749,CSE 190,A00,092507,Dubnov; Shlomo,8,0,20,12
1657972055783,ECE 45,A01,083139,Congero; Spencer William,7,0,75,68
1657972061814,ECE 65,A50,083695,Saad; Andrew S,12,0,30,18
1657972061814,ECE 65,A51,095125,Saad; Andrew S,24,0,26,2
1657972067847,ECE 109,A01,091882,Touri; Behrouz,21,0,70,49
1657972073878,ECE 180,A00,083140,Abi Samra; Nicholas Camill,1,0,30,29
1657972073878,ECE 180,B00,083141,Abi Samra; Nicholas Camill,0,0,30,30
1657972079907,MATH 10A,A01,083735,Patchell; Gregory David,2,0,30,28
1657972079907,MATH 10A,A02,083736,Patchell; Gregory David,20,0,30,10
1657972079907,MATH 10A,A03,083737,Patchell; Gregory David,16,0,30,14
1657972085936,MATH 10B,A01,083207,Lim; Seonhee,9,0,34,25
1657972085936,MATH 10B,A02,083208,Lim; Seonhee,10,0,35,25
1657972085936,MATH 10B,A03,093472,Lim; Seonhee,7,0,34,27
1657972085936,MATH 10B,B01,083739,Sinha; Shubham,14,0,30,16
1657972091967,MATH 18,A01,083743,Cinel; Cameron Alexander,9,0,30,21
1657972091967,MATH 18,A02,083744,Cinel; Cameron Alexander,18,0,30,12
1657972091967,MATH 18,A03,083745,Cinel; Cameron Alexander,10,0,30,20
1657972091967,MATH 18,B01,083748,Rideout; David Porter,5,0,37,32
1657972091967,MATH 18,B02,083749,Rideout; David Porter,5,0,36,31
1657972091967,MATH 18,B03,083750,Rideout; David Porter,3,0,37,34
1657972091967,MATH 18,B04,083751,Rideout; David Porter,7,0,36,29
1657972091967,MATH 18,B05,093473,Rideout; David Porter,7,0,36,29
1657972091967,MATH 18,B06,093474,Rideout; David Porter,6,0,36,30
1657972097991,MATH 20A,A01,083754,Zheng; Zequn,14,0,40,26
1657972104021,MATH 20B,A01,083756,Briones; Jor-el Thomas Caparas,4,0,36,32
1657972104021,MATH 20B,A02,083757,Briones; Jor-el Thomas Caparas,1,0,36,35
1657972104021,MATH 20B,A03,093475,Briones; Jor-el Thomas Caparas,3,0,36,33
1657972110054,MATH 20C,A01,083760,Briones; Jor-el Thomas Caparas,1,0,35,34
1657972110054,MATH 20C,A02,083761,Briones; Jor-el Thomas Caparas,8,0,35,27
1657972110054,MATH 20C,A03,093476,Briones; Jor-el Thomas Caparas,0,1,36,36
1657972110054,MATH 20C,B01,083762,Bach; Quang Tran,1,0,30,29
1657972116081,MATH 20D,A01,083765,Tran; Brian Kha,5,0,30,25
1657972116081,MATH 20D,A02,083766,Tran; Brian Kha,5,0,30,25
1657972116081,MATH 20D,A03,083767,Tran; Brian Kha,6,0,30,24
1657972122111,MATH 20E,A01,083771,Ganguly; Soumya,12,0,32,20
1657972122111,MATH 20E,A02,083772,Ganguly; Soumya,7,0,32,25
1657972122111,MATH 20E,B01,083773,Ciotti; Benjamin,20,0,35,15
1657972122111,MATH 20E,B02,083774,Ciotti; Benjamin,18,0,35,17
1657972128149,MATH 103A,A01,083777,Greenfeld; Be'Eri,6,0,36,30
1657972128149,MATH 103A,A02,083778,Greenfeld; Be'Eri,5,0,36,31
1657972128149,MATH 103A,A03,093561,Greenfeld; Be'Eri,7,0,36,29
1657972128149,MATH 103A,B01,083779,Greenfeld; Be'Eri,8,0,36,28
1657972128149,MATH 103A,B02,083780,Greenfeld; Be'Eri,4,0,36,32
1657972128149,MATH 103A,B03,093562,Greenfeld; Be'Eri,3,0,36,33
1657972134176,MATH 105,A01,085443,Carter; Anne Toulson,15,0,35,20
1657972134176,MATH 105,A02,093477,Carter; Anne Toulson,20,0,35,15
1657972140205,MATH 109,A01,083213,Ganzberger; Geoffrey Michael,3,0,34,31
1657972140205,MATH 109,A02,083214,Ganzberger; Geoffrey Michael,4,0,34,30
1657972140205,MATH 109,A03,093478,Ganzberger; Geoffrey Michael,2,0,34,32
1657972140205,MATH 109,B01,083215,Ganzberger; Geoffrey Michael,3,0,32,29
1657972140205,MATH 109,B02,083216,Ganzberger; Geoffrey Michael,3,0,32,29
1657972140205,MATH 109,B03,093479,Ganzberger; Geoffrey Michael,8,0,32,24
1657972146235,MATH 142A,A01,083219,Chow; Bennett,7,0,32,25
1657972146235,MATH 142A,A02,083220,Chow; Bennett,10,0,32,22
1657972146235,MATH 142A,A03,093480,Chow; Bennett,9,0,32,23
1657972146235,MATH 142A,B03,093481,Chow; Bennett,8,0,32,24
1657972146235,MATH 142A,B04,093558,Chow; Bennett,14,0,32,18
1657972146235,MATH 142A,B05,093559,Chow; Bennett,7,0,32,25
1657972152262,MATH 193A,A01,083224,Rotar; Vladimir,9,0,34,25
1657972152262,MATH 193A,A02,083225,Rotar; Vladimir,11,0,34,23
1657972152262,MATH 193A,A03,083781,Rotar; Vladimir,5,0,34,29
1657972152262,MATH 193A,A04,083782,Rotar; Vladimir,12,0,34,22
1657972152262,MATH 193A,A05,093482,Rotar; Vladimir,11,0,34,23
1657972158289,MATH 197,001,091859,McAuley; Julian John,9999,0,9999,0
1657972158289,MATH 197,002,095566,Kedlaya; Kiran S.,9997,0,9999,2
1657972158289,MATH 197,003,095567,Xiao; Ming,9999,0,9999,0
1657972158289,MATH 197,004,095571,Perols; Johan Lars,9998,0,9999,1
1657972165370,COGS 9,A01,083615,Shannon; Kyle Michael,11,0,75,64
1657972171402,COGS 11,A01,083617,Boyle; Mary E. T.,23,0,48,25
1657972177430,COGS 13,A01,083071,Bastos; Amalia Pinkusfeld,12,0,71,59
1657972183461,COGS 14A,A01,092681,Semenuks; Arturs,5,1,100,95
1657972189489,COGS 14B,A01,083073,Cheng; Tzu-Han,7,0,63,56
1657972195521,COGS 17,A01,092677,Semenuks; Arturs,7,0,81,74
1657972201555,COGS 100,A01,083619,Allen; Michael Gordon,17,0,70,53
1657972207587,COGS 101A,A01,083621,Davis; Joshua Daniel,9,0,68,59
1657972213616,COGS 101B,A01,091572,Allen; Michael Gordon,14,0,65,51
1657972219648,COGS 101C,A01,083625,Delgado; Tania,17,0,35,18
1657972225679,COGS 107A,A01,083627,Boyle; Mary E. T.,14,0,60,46
1657972231706,COGS 118A,A01,083075,Gupta; Anjum,21,0,76,55
1657972237742,CSE 3,A50,083646,Miranda; Gregory Joseph,24,0,50,26
1657972243771,CSE 8A,A50,083650,Miranda; Gregory Joseph,17,1,56,39
1657972249797,CSE 11,A01,083080,Cao; Yingjun,7,15,40,33
1657972255826,CSE 12,A01,083652,Krause-Levy; Sophia Louisa,30,1,120,90
1657972261851,CSE 15L,A01,083654,Morris; Justin Loren,9,0,50,41
1657972261851,CSE 15L,A02,083655,Morris; Justin Loren,11,0,50,39
1657972267881,CSE 20,A01,083657,Tran; Khoa Dang,39,0,80,41
1657972273907,CSE 21,A01,095574,Bach; Quang Tran,23,0,48,25
1657972279943,CSE 30,A01,083084,Eldon; John,8,0,80,72
1657972279943,CSE 30,B01,095061,Bhaskar; Nishant,9,0,50,41
1657972285975,CSE 100,A01,083659,Cao; Yingjun,5,4,70,65
1657972292000,CSE 134B,A01,083661,Powell; Thomas Allan,25,0,100,75
1657972298032,CSE 140,A01,083663,Gungor; Onat,17,0,85,68
1657972304063,CSE 140L,A01,083088,Eldon; John,23,0,100,77
1657972310098,CSE 175,A01,083665,Kumar; Rakesh,3,0,25,22
1657972316128,CSE 190,A00,092507,Dubnov; Shlomo,8,0,20,12
1657972322165,ECE 45,A01,083139,Congero; Spencer William,7,0,75,68
1657972328200,ECE 65,A50,083695,Saad; Andrew S,12,0,30,18
1657972328200,ECE 65,A51,095125,Saad; Andrew S,24,0,26,2
1657972334233,ECE 109,A01,091882,Touri; Behrouz,21,0,70,49
1657972340335,ECE 180,A00,083140,Abi Samra; Nicholas Camill,1,0,30,29
1657972340335,ECE 180,B00,083141,Abi Samra; Nicholas Camill,0,0,30,30
1657972346373,MATH 10A,A01,083735,Patchell; Gregory David,2,0,30,28
1657972346373,MATH 10A,A02,083736,Patchell; Gregory David,20,0,30,10
1657972346373,MATH 10A,A03,083737,Patchell; Gregory David,16,0,30,14
1657972352414,MATH 10B,A01,083207,Lim; Seonhee,9,0,34,25
1657972352414,MATH 10B,A02,083208,Lim; Seonhee,10,0,35,25
1657972352414,MATH 10B,A03,093472,Lim; Seonhee,7,0,34,27
1657972352414,MATH 10B,B01,083739,Sinha; Shubham,14,0,30,16
1657972358449,MATH 18,A01,083743,Cinel; Cameron Alexander,9,0,30,21
1657972358449,MATH 18,A02,083744,Cinel; Cameron Alexander,18,0,30,12
1657972358449,MATH 18,A03,083745,Cinel; Cameron Alexander,10,0,30,20
1657972358449,MATH 18,B01,083748,Rideout; David Porter,5,0,37,32
1657972358449,MATH 18,B02,083749,Rideout; David Porter,5,0,36,31
1657972358449,MATH 18,B03,083750,Rideout; David Porter,3,0,37,34
1657972358449,MATH 18,B04,083751,Rideout; David Porter,7,0,36,29
1657972358449,MATH 18,B05,093473,Rideout; David Porter,7,0,36,29
1657972358449,MATH 18,B06,093474,Rideout; David Porter,6,0,36,30
1657972364481,MATH 20A,A01,083754,Zheng; Zequn,14,0,40,26
1657972370508,MATH 20B,A01,083756,Briones; Jor-el Thomas Caparas,4,0,36,32
1657972370508,MATH 20B,A02,083757,Briones; Jor-el Thomas Caparas,1,0,36,35
1657972370508,MATH 20B,A03,093475,Briones; Jor-el Thomas Caparas,3,0,36,33
1657972376546,MATH 20C,A01,083760,Briones; Jor-el Thomas Caparas,1,0,35,34
1657972376546,MATH 20C,A02,083761,Briones; Jor-el Thomas Caparas,8,0,35,27
1657972376546,MATH 20C,A03,093476,Briones; Jor-el Thomas Caparas,0,1,36,36
1657972376546,MATH 20C,B01,083762,Bach; Quang Tran,1,0,30,29
1657972382582,MATH 20D,A01,083765,Tran; Brian Kha,5,0,30,25
1657972382582,MATH 20D,A02,083766,Tran; Brian Kha,5,0,30,25
1657972382582,MATH 20D,A03,083767,Tran; Brian Kha,6,0,30,24
1657972388610,MATH 20E,A01,083771,Ganguly; Soumya,12,0,32,20
1657972388610,MATH 20E,A02,083772,Ganguly; Soumya,7,0,32,25
1657972388610,MATH 20E,B01,083773,Ciotti; Benjamin,20,0,35,15
1657972388610,MATH 20E,B02,083774,Ciotti; Benjamin,18,0,35,17
1657972394660,MATH 103A,A01,083777,Greenfeld; Be'Eri,6,0,36,30
1657972394660,MATH 103A,A02,083778,Greenfeld; Be'Eri,5,0,36,31
1657972394660,MATH 103A,A03,093561,Greenfeld; Be'Eri,7,0,36,29
1657972394660,MATH 103A,B01,083779,Greenfeld; Be'Eri,8,0,36,28
1657972394660,MATH 103A,B02,083780,Greenfeld; Be'Eri,4,0,36,32
1657972394660,MATH 103A,B03,093562,Greenfeld; Be'Eri,3,0,36,33
1657972400691,MATH 105,A01,085443,Carter; Anne Toulson,15,0,35,20
1657972400691,MATH 105,A02,093477,Carter; Anne Toulson,20,0,35,15
1657972406720,MATH 109,A01,083213,Ganzberger; Geoffrey Michael,3,0,34,31
1657972406720,MATH 109,A02,083214,Ganzberger; Geoffrey Michael,4,0,34,30
1657972406720,MATH 109,A03,093478,Ganzberger; Geoffrey Michael,2,0,34,32
1657972406720,MATH 109,B01,083215,Ganzberger; Geoffrey Michael,3,0,32,29
1657972406720,MATH 109,B02,083216,Ganzberger; Geoffrey Michael,3,0,32,29
1657972406720,MATH 109,B03,093479,Ganzberger; Geoffrey Michael,8,0,32,24
1657972412748,MATH 142A,A01,083219,Chow; Bennett,7,0,32,25
1657972412748,MATH 142A,A02,083220,Chow; Bennett,10,0,32,22
1657972412748,MATH 142A,A03,093480,Chow; Bennett,9,0,32,23
1657972412748,MATH 142A,B03,093481,Chow; Bennett,8,0,32,24
1657972412748,MATH 142A,B04,093558,Chow; Bennett,14,0,32,18
1657972412748,MATH 142A,B05,093559,Chow; Bennett,7,0,32,25
1657972418773,MATH 193A,A01,083224,Rotar; Vladimir,9,0,34,25
1657972418773,MATH 193A,A02,083225,Rotar; Vladimir,11,0,34,23
1657972418773,MATH 193A,A03,083781,Rotar; Vladimir,5,0,34,29
1657972418773,MATH 193A,A04,083782,Rotar; Vladimir,12,0,34,22
1657972418773,MATH 193A,A05,093482,Rotar; Vladimir,11,0,34,23
1657972424801,MATH 197,001,091859,McAuley; Julian John,9999,0,9999,0
1657972424801,MATH 197,002,095566,Kedlaya; Kiran S.,9997,0,9999,2
1657972424801,MATH 197,003,095567,Xiao; Ming,9999,0,9999,0
1657972424801,MATH 197,004,095571,Perols; Johan Lars,9998,0,9999,1
1657972431875,COGS 9,A01,083615,Shannon; Kyle Michael,11,0,75,64
1657972437900,COGS 11,A01,083617,Boyle; Mary E. T.,23,0,48,25
1657972443926,COGS 13,A01,083071,Bastos; Amalia Pinkusfeld,12,0,71,59
1657972449958,COGS 14A,A01,092681,Semenuks; Arturs,5,1,100,95
1657972455989,COGS 14B,A01,083073,Cheng; Tzu-Han,7,0,63,56
1657972462019,COGS 17,A01,092677,Semenuks; Arturs,7,0,81,74
1657972468046,COGS 100,A01,083619,Allen; Michael Gordon,17,0,70,53
1657972474079,COGS 101A,A01,083621,Davis; Joshua Daniel,9,0,68,59
1657972480104,COGS 101B,A01,091572,Allen; Michael Gordon,14,0,65,51
1657972486132,COGS 101C,A01,083625,Delgado; Tania,17,0,35,18
1657972492159,COGS 107A,A01,083627,Boyle; Mary E. T.,14,0,60,46
1657972498187,COGS 118A,A01,083075,Gupta; Anjum,21,0,76,55
1657972504221,CSE 3,A50,083646,Miranda; Gregory Joseph,24,0,50,26
1657972510249,CSE 8A,A50,083650,Miranda; Gregory Joseph,17,1,56,39
1657972516275,CSE 11,A01,083080,Cao; Yingjun,7,15,40,33
1657972522306,CSE 12,A01,083652,Krause-Levy; Sophia Louisa,30,1,120,90
1657972528334,CSE 15L,A01,083654,Morris; Justin Loren,9,0,50,41
1657972528334,CSE 15L,A02,083655,Morris; Justin Loren,11,0,50,39
1657972534364,CSE 20,A01,083657,Tran; Khoa Dang,39,0,80,41
1657972540395,CSE 21,A01,095574,Bach; Quang Tran,23,0,48,25
1657972546431,CSE 30,A01,083084,Eldon; John,8,0,80,72
1657972546431,CSE 30,B01,095061,Bhaskar; Nishant,9,0,50,41
1657972552468,CSE 100,A01,083659,Cao; Yingjun,5,4,70,65
1657972558499,CSE 134B,A01,083661,Powell; Thomas Allan,25,0,100,75
1657972564531,CSE 140,A01,083663,Gungor; Onat,17,0,85,68
1657972570557,CSE 140L,A01,083088,Eldon; John,23,0,100,77
1657972576589,CSE 175,A01,083665,Kumar; Rakesh,3,0,25,22
1657972582618,CSE 190,A00,092507,Dubnov; Shlomo,8,0,20,12
1657972588645,ECE 45,A01,083139,Congero; Spencer William,7,0,75,68
1657972594678,ECE 65,A50,083695,Saad; Andrew S,12,0,30,18
1657972594678,ECE 65,A51,095125,Saad; Andrew S,24,0,26,2
1657972600702,ECE 109,A01,091882,Touri; Behrouz,21,0,70,49
1657972606732,ECE 180,A00,083140,Abi Samra; Nicholas Camill,1,0,30,29
1657972606732,ECE 180,B00,083141,Abi Samra; Nicholas Camill,0,0,30,30
1657972612766,MATH 10A,A01,083735,Patchell; Gregory David,2,0,30,28
1657972612766,MATH 10A,A02,083736,Patchell; Gregory David,20,0,30,10
1657972612766,MATH 10A,A03,083737,Patchell; Gregory David,16,0,30,14
1657972618795,MATH 10B,A01,083207,Lim; Seonhee,9,0,34,25
1657972618795,MATH 10B,A02,083208,Lim; Seonhee,10,0,35,25
1657972618795,MATH 10B,A03,093472,Lim; Seonhee,7,0,34,27
1657972618795,MATH 10B,B01,083739,Sinha; Shubham,14,0,30,16
1657972624825,MATH 18,A01,083743,Cinel; Cameron Alexander,9,0,30,21
1657972624825,MATH 18,A02,083744,Cinel; Cameron Alexander,18,0,30,12
1657972624825,MATH 18,A03,083745,Cinel; Cameron Alexander,10,0,30,20
1657972624825,MATH 18,B01,083748,Rideout; David Porter,5,0,37,32
1657972624825,MATH 18,B02,083749,Rideout; David Porter,5,0,36,31
1657972624825,MATH 18,B03,083750,Rideout; David Porter,3,0,37,34
1657972624825,MATH 18,B04,083751,Rideout; David Porter,7,0,36,29
1657972624825,MATH 18,B05,093473,Rideout; David Porter,7,0,36,29
1657972624825,MATH 18,B06,093474,Rideout; David Porter,6,0,36,30
1657972630852,MATH 20A,A01,083754,Zheng; Zequn,14,0,40,26
1657972636882,MATH 20B,A01,083756,Briones; Jor-el Thomas Caparas,4,0,36,32
1657972636882,MATH 20B,A02,083757,Briones; Jor-el Thomas Caparas,1,0,36,35
1657972636882,MATH 20B,A03,093475,Briones; Jor-el Thomas Caparas,3,0,36,33
1657972642914,MATH 20C,A01,083760,Briones; Jor-el Thomas Caparas,1,0,35,34
1657972642914,MATH 20C,A02,083761,Briones; Jor-el Thomas Caparas,8,0,35,27
1657972642914,MATH 20C,A03,093476,Briones; Jor-el Thomas Caparas,0,1,36,36
1657972642914,MATH 20C,B01,083762,Bach; Quang Tran,1,0,30,29
1657972648944,MATH 20D,A01,083765,Tran; Brian Kha,5,0,30,25
1657972648944,MATH 20D,A02,083766,Tran; Brian Kha,5,0,30,25
1657972648944,MATH 20D,A03,083767,Tran; Brian Kha,6,0,30,24
1657972654971,MATH 20E,A01,083771,Ganguly; Soumya,12,0,32,20
1657972654971,MATH 20E,A02,083772,Ganguly; Soumya,7,0,32,25
1657972654971,MATH 20E,B01,083773,Ciotti; Benjamin,20,0,35,15
1657972654971,MATH 20E,B02,083774,Ciotti; Benjamin,18,0,35,17
1657972660999,MATH 103A,A01,083777,Greenfeld; Be'Eri,6,0,36,30
1657972660999,MATH 103A,A02,083778,Greenfeld; Be'Eri,5,0,36,31
1657972660999,MATH 103A,A03,093561,Greenfeld; Be'Eri,7,0,36,29
1657972660999,MATH 103A,B01,083779,Greenfeld; Be'Eri,8,0,36,28
1657972660999,MATH 103A,B02,083780,Greenfeld; Be'Eri,4,0,36,32
1657972660999,MATH 103A,B03,093562,Greenfeld; Be'Eri,3,0,36,33
1657972667026,MATH 105,A01,085443,Carter; Anne Toulson,15,0,35,20
1657972667026,MATH 105,A02,093477,Carter; Anne Toulson,20,0,35,15
1657972673051,MATH 109,A01,083213,Ganzberger; Geoffrey Michael,3,0,34,31
1657972673051,MATH 109,A02,083214,Ganzberger; Geoffrey Michael,4,0,34,30
1657972673051,MATH 109,A03,093478,Ganzberger; Geoffrey Michael,2,0,34,32
1657972673051,MATH 109,B01,083215,Ganzberger; Geoffrey Michael,3,0,32,29
1657972673051,MATH 109,B02,083216,Ganzberger; Geoffrey Michael,3,0,32,29
1657972673051,MATH 109,B03,093479,Ganzberger; Geoffrey Michael,8,0,32,24
1657972679085,MATH 142A,A01,083219,Chow; Bennett,7,0,32,25
1657972679085,MATH 142A,A02,083220,Chow; Bennett,10,0,32,22
1657972679085,MATH 142A,A03,093480,Chow; Bennett,9,0,32,23
1657972679085,MATH 142A,B03,093481,Chow; Bennett,8,0,32,24
1657972679085,MATH 142A,B04,093558,Chow; Bennett,14,0,32,18
1657972679085,MATH 142A,B05,093559,Chow; Bennett,7,0,32,25
1657972685119,MATH 193A,A01,083224,Rotar; Vladimir,9,0,34,25
1657972685119,MATH 193A,A02,083225,Rotar; Vladimir,11,0,34,23
1657972685119,MATH 193A,A03,083781,Rotar; Vladimir,5,0,34,29
1657972685119,MATH 193A,A04,083782,Rotar; Vladimir,12,0,34,22
1657972685119,MATH 193A,A05,093482,Rotar; Vladimir,11,0,34,23
1657972691147,MATH 197,001,091859,McAuley; Julian John,9999,0,9999,0
1657972691147,MATH 197,002,095566,Kedlaya; Kiran S.,9997,0,9999,2
1657972691147,MATH 197,003,095567,Xiao; Ming,9999,0,9999,0
1657972691147,MATH 197,004,095571,Perols; Johan Lars,9998,0,9999,1
1657972698211,COGS 9,A01,083615,Shannon; Kyle Michael,11,0,75,64
1657972704235,COGS 11,A01,083617,Boyle; Mary E. T.,23,0,48,25
1657972710266,COGS 13,A01,083071,Bastos; Amalia Pinkusfeld,12,0,71,59
1657972716296,COGS 14A,A01,092681,Semenuks; Arturs,5,1,100,95
1657972722320,COGS 14B,A01,083073,Cheng; Tzu-Han,7,0,63,56
1657972728351,COGS 17,A01,092677,Semenuks; Arturs,7,0,81,74
1657972734377,COGS 100,A01,083619,Allen; Michael Gordon,17,0,70,53
1657972740404,COGS 101A,A01,083621,Davis; Joshua Daniel,9,0,68,59
1657972746431,COGS 101B,A01,091572,Allen; Michael Gordon,14,0,65,51
1657972752466,COGS 101C,A01,083625,Delgado; Tania,17,0,35,18
1657972758495,COGS 107A,A01,083627,Boyle; Mary E. T.,14,0,60,46
1657972764520,COGS 118A,A01,083075,Gupta; Anjum,21,0,76,55
1657972770550,CSE 3,A50,083646,Miranda; Gregory Joseph,24,0,50,26
1657972776582,CSE 8A,A50,083650,Miranda; Gregory Joseph,17,1,56,39
1657972782608,CSE 11,A01,083080,Cao; Yingjun,7,15,40,33
1657972788635,CSE 12,A01,083652,Krause-Levy; Sophia Louisa,30,1,120,90
1657972794665,CSE 15L,A01,083654,Morris; Justin Loren,9,0,50,41
1657972794665,CSE 15L,A02,083655,Morris; Justin Loren,11,0,50,39
1657972800691,CSE 20,A01,083657,Tran; Khoa Dang,39,0,80,41
1657972806717,CSE 21,A01,095574,Bach; Quang Tran,23,0,48,25
1657972812751,CSE 30,A01,083084,Eldon; John,8,0,80,72
1657972812751,CSE 30,B01,095061,Bhaskar; Nishant,9,0,50,41
1657972818779,CSE 100,A01,083659,Cao; Yingjun,5,4,70,65
1657972824807,CSE 134B,A01,083661,Powell; Thomas Allan,25,0,100,75
1657972830830,CSE 140,A01,083663,Gungor; Onat,17,0,85,68
1657972836862,CSE 140L,A01,083088,Eldon; John,23,0,100,77
1657972842886,CSE 175,A01,083665,Kumar; Rakesh,3,0,25,22
1657972848913,CSE 190,A00,092507,Dubnov; Shlomo,8,0,20,12
1657972854941,ECE 45,A01,083139,Congero; Spencer William,7,0,75,68
1657972860967,ECE 65,A50,083695,Saad; Andrew S,12,0,30,18
1657972860967,ECE 65,A51,095125,Saad; Andrew S,24,0,26,2
1657972866991,ECE 109,A01,091882,Touri; Behrouz,21,0,70,49
1657972873019,ECE 180,A00,083140,Abi Samra; Nicholas Camill,1,0,30,29
1657972873019,ECE 180,B00,083141,Abi Samra; Nicholas Camill,0,0,30,30
1657972879063,MATH 10A,A01,083735,Patchell; Gregory David,2,0,30,28
1657972879063,MATH 10A,A02,083736,Patchell; Gregory David,20,0,30,10
1657972879063,MATH 10A,A03,083737,Patchell; Gregory David,16,0,30,14
1657972885093,MATH 10B,A01,083207,Lim; Seonhee,9,0,34,25
1657972885093,MATH 10B,A02,083208,Lim; Seonhee,10,0,35,25
1657972885093,MATH 10B,A03,093472,Lim; Seonhee,7,0,34,27
1657972885093,MATH 10B,B01,083739,Sinha; Shubham,14,0,30,16
1657972891143,MATH 18,A01,083743,Cinel; Cameron Alexander,9,0,30,21
1657972891143,MATH 18,A02,083744,Cinel; Cameron Alexander,18,0,30,12
1657972891143,MATH 18,A03,083745,Cinel; Cameron Alexander,10,0,30,20
1657972891143,MATH 18,B01,083748,Rideout; David Porter,5,0,37,32
1657972891143,MATH 18,B02,083749,Rideout; David Porter,5,0,36,31
1657972891143,MATH 18,B03,083750,Rideout; David Porter,3,0,37,34
1657972891143,MATH 18,B04,083751,Rideout; David Porter,7,0,36,29
1657972891143,MATH 18,B05,093473,Rideout; David Porter,7,0,36,29
1657972891143,MATH 18,B06,093474,Rideout; David Porter,6,0,36,30
1657972897173,MATH 20A,A01,083754,Zheng; Zequn,14,0,40,26
1657972903201,MATH 20B,A01,083756,Briones; Jor-el Thomas Caparas,4,0,36,32
1657972903201,MATH 20B,A02,083757,Briones; Jor-el Thomas Caparas,1,0,36,35
1657972903201,MATH 20B,A03,093475,Briones; Jor-el Thomas Caparas,3,0,36,33
1657972909230,MATH 20C,A01,083760,Briones; Jor-el Thomas Caparas,1,0,35,34
1657972909230,MATH 20C,A02,083761,Briones; Jor-el Thomas Caparas,8,0,35,27
1657972909230,MATH 20C,A03,093476,Briones; Jor-el Thomas Caparas,0,1,36,36
1657972909230,MATH 20C,B01,083762,Bach; Quang Tran,1,0,30,29
1657972915256,MATH 20D,A01,083765,Tran; Brian Kha,5,0,30,25
1657972915256,MATH 20D,A02,083766,Tran; Brian Kha,5,0,30,25
1657972915256,MATH 20D,A03,083767,Tran; Brian Kha,6,0,30,24
1657972921285,MATH 20E,A01,083771,Ganguly; Soumya,12,0,32,20
1657972921285,MATH 20E,A02,083772,Ganguly; Soumya,7,0,32,25
1657972921285,MATH 20E,B01,083773,Ciotti; Benjamin,20,0,35,15
1657972921285,MATH 20E,B02,083774,Ciotti; Benjamin,18,0,35,17
1657972927327,MATH 103A,A01,083777,Greenfeld; Be'Eri,6,0,36,30
1657972927327,MATH 103A,A02,083778,Greenfeld; Be'Eri,5,0,36,31
1657972927327,MATH 103A,A03,093561,Greenfeld; Be'Eri,7,0,36,29
1657972927327,MATH 103A,B01,083779,Greenfeld; Be'Eri,8,0,36,28
1657972927327,MATH 103A,B02,083780,Greenfeld; Be'Eri,4,0,36,32
1657972927327,MATH 103A,B03,093562,Greenfeld; Be'Eri,3,0,36,33
1657972933362,MATH 105,A01,085443,Carter; Anne Toulson,15,0,35,20
1657972933362,MATH 105,A02,093477,Carter; Anne Toulson,20,0,35,15
1657972939461,MATH 109,A01,083213,Ganzberger; Geoffrey Michael,3,0,34,31
1657972939461,MATH 109,A02,083214,Ganzberger; Geoffrey Michael,4,0,34,30
1657972939461,MATH 109,A03,093478,Ganzberger; Geoffrey Michael,2,0,34,32
1657972939461,MATH 109,B01,083215,Ganzberger; Geoffrey Michael,3,0,32,29
1657972939461,MATH 109,B02,083216,Ganzberger; Geoffrey Michael,3,0,32,29
1657972939461,MATH 109,B03,093479,Ganzberger; Geoffrey Michael,8,0,32,24
1657972945496,MATH 142A,A01,083219,Chow; Bennett,7,0,32,25
1657972945496,MATH 142A,A02,083220,Chow; Bennett,10,0,32,22
1657972945496,MATH 142A,A03,093480,Chow; Bennett,9,0,32,23
1657972945496,MATH 142A,B03,093481,Chow; Bennett,8,0,32,24
1657972945496,MATH 142A,B04,093558,Chow; Bennett,14,0,32,18
1657972945496,MATH 142A,B05,093559,Chow; Bennett,7,0,32,25
1657972951530,MATH 193A,A01,083224,Rotar; Vladimir,9,0,34,25
1657972951530,MATH 193A,A02,083225,Rotar; Vladimir,11,0,34,23
1657972951530,MATH 193A,A03,083781,Rotar; Vladimir,5,0,34,29
1657972951530,MATH 193A,A04,083782,Rotar; Vladimir,12,0,34,22
1657972951530,MATH 193A,A05,093482,Rotar; Vladimir,11,0,34,23
1657972957558,MATH 197,001,091859,McAuley; Julian John,9999,0,9999,0
1657972957558,MATH 197,002,095566,Kedlaya; Kiran S.,9997,0,9999,2
1657972957558,MATH 197,003,095567,Xiao; Ming,9999,0,9999,0
1657972957558,MATH 197,004,095571,Perols; Johan Lars,9998,0,9999,1
1657972964644,COGS 9,A01,083615,Shannon; Kyle Michael,11,0,75,64
1657972970679,COGS 11,A01,083617,Boyle; Mary E. T.,23,0,48,25
1657972976706,COGS 13,A01,083071,Bastos; Amalia Pinkusfeld,12,0,71,59
1657972982737,COGS 14A,A01,092681,Semenuks; Arturs,5,1,100,95
1657972988778,COGS 14B,A01,083073,Cheng; Tzu-Han,7,0,63,56
1657972994804,COGS 17,A01,092677,Semenuks; Arturs,7,0,81,74
1657973000831,COGS 100,A01,083619,Allen; Michael Gordon,17,0,70,53
1657973006861,COGS 101A,A01,083621,Davis; Joshua Daniel,9,0,68,59
1657973012892,COGS 101B,A01,091572,Allen; Michael Gordon,14,0,65,51
1657973018923,COGS 101C,A01,083625,Delgado; Tania,17,0,35,18
1657973024955,COGS 107A,A01,083627,Boyle; Mary E. T.,14,0,60,46
1657973030981,COGS 118A,A01,083075,Gupta; Anjum,21,0,76,55
1657973037021,CSE 3,A50,083646,Miranda; Gregory Joseph,24,0,50,26
1657973043050,CSE 8A,A50,083650,Miranda; Gregory Joseph,17,1,56,39
1657973049080,CSE 11,A01,083080,Cao; Yingjun,7,15,40,33
1657973055113,CSE 12,A01,083652,Krause-Levy; Sophia Louisa,30,1,120,90
1657973061143,CSE 15L,A01,083654,Morris; Justin Loren,9,0,50,41
1657973061143,CSE 15L,A02,083655,Morris; Justin Loren,11,0,50,39
1657973067177,CSE 20,A01,083657,Tran; Khoa Dang,39,0,80,41
1657973073209,CSE 21,A01,095574,Bach; Quang Tran,23,0,48,25
1657973079238,CSE 30,A01,083084,Eldon; John,8,0,80,72
1657973079238,CSE 30,B01,095061,Bhaskar; Nishant,9,0,50,41
1657973085264,CSE 100,A01,083659,Cao; Yingjun,5,4,70,65
1657973091291,CSE 134B,A01,083661,Powell; Thomas Allan,25,0,100,75
1657973097319,CSE 140,A01,083663,Gungor; Onat,17,0,85,68
1657973103345,CSE 140L,A01,083088,Eldon; John,23,0,100,77
1657973109380,CSE 175,A01,083665,Kumar; Rakesh,3,0,25,22
1657973115408,CSE 190,A00,092507,Dubnov; Shlomo,8,0,20,12
1657973121433,ECE 45,A01,083139,Congero; Spencer William,7,0,75,68
1657973127468,ECE 65,A50,083695,Saad; Andrew S,12,0,30,18
1657973127468,ECE 65,A51,095125,Saad; Andrew S,24,0,26,2
1657973133497,ECE 109,A01,091882,Touri; Behrouz,21,0,70,49
1657973139524,ECE 180,A00,083140,Abi Samra; Nicholas Camill,1,0,30,29
1657973139524,ECE 180,B00,083141,Abi Samra; Nicholas Camill,0,0,30,30
1657973145553,MATH 10A,A01,083735,Patchell; Gregory David,2,0,30,28
1657973145553,MATH 10A,A02,083736,Patchell; Gregory David,20,0,30,10
1657973145553,MATH 10A,A03,083737,Patchell; Gregory David,16,0,30,14
1657973151595,MATH 10B,A01,083207,Lim; Seonhee,9,0,34,25
1657973151595,MATH 10B,A02,083208,Lim; Seonhee,10,0,35,25
1657973151595,MATH 10B,A03,093472,Lim; Seonhee,7,0,34,27
1657973151595,MATH 10B,B01,083739,Sinha; Shubham,14,0,30,16
1657973157624,MATH 18,A01,083743,Cinel; Cameron Alexander,9,0,30,21
1657973157624,MATH 18,A02,083744,Cinel; Cameron Alexander,18,0,30,12
1657973157624,MATH 18,A03,083745,Cinel; Cameron Alexander,10,0,30,20
1657973157624,MATH 18,B01,083748,Rideout; David Porter,5,0,37,32
1657973157624,MATH 18,B02,083749,Rideout; David Porter,5,0,36,31
1657973157624,MATH 18,B03,083750,Rideout; David Porter,3,0,37,34
1657973157624,MATH 18,B04,083751,Rideout; David Porter,7,0,36,29
1657973157624,MATH 18,B05,093473,Rideout; David Porter,7,0,36,29
1657973157624,MATH 18,B06,093474,Rideout; David Porter,6,0,36,30
1657973163655,MATH 20A,A01,083754,Zheng; Zequn,14,0,40,26
1657973169691,MATH 20B,A01,083756,Briones; Jor-el Thomas Caparas,4,0,36,32
1657973169691,MATH 20B,A02,083757,Briones; Jor-el Thomas Caparas,1,0,36,35
1657973169691,MATH 20B,A03,093475,Briones; Jor-el Thomas Caparas,3,0,36,33
1657973175718,MATH 20C,A01,083760,Briones; Jor-el Thomas Caparas,1,0,35,34
1657973175718,MATH 20C,A02,083761,Briones; Jor-el Thomas Caparas,8,0,35,27
1657973175718,MATH 20C,A03,093476,Briones; Jor-el Thomas Caparas,0,1,36,36
1657973175718,MATH 20C,B01,083762,Bach; Quang Tran,1,0,30,29
1657973181751,MATH 20D,A01,083765,Tran; Brian Kha,5,0,30,25
1657973181751,MATH 20D,A02,083766,Tran; Brian Kha,5,0,30,25
1657973181751,MATH 20D,A03,083767,Tran; Brian Kha,6,0,30,24
1657973187782,MATH 20E,A01,083771,Ganguly; Soumya,12,0,32,20
1657973187782,MATH 20E,A02,083772,Ganguly; Soumya,7,0,32,25
1657973187782,MATH 20E,B01,083773,Ciotti; Benjamin,20,0,35,15
1657973187782,MATH 20E,B02,083774,Ciotti; Benjamin,18,0,35,17
1657973193818,MATH 103A,A01,083777,Greenfeld; Be'Eri,6,0,36,30
1657973193818,MATH 103A,A02,083778,Greenfeld; Be'Eri,5,0,36,31
1657973193818,MATH 103A,A03,093561,Greenfeld; Be'Eri,7,0,36,29
1657973193818,MATH 103A,B01,083779,Greenfeld; Be'Eri,8,0,36,28
1657973193818,MATH 103A,B02,083780,Greenfeld; Be'Eri,4,0,36,32
1657973193818,MATH 103A,B03,093562,Greenfeld; Be'Eri,3,0,36,33
1657973199845,MATH 105,A01,085443,Carter; Anne Toulson,15,0,35,20
1657973199845,MATH 105,A02,093477,Carter; Anne Toulson,20,0,35,15
1657973205872,MATH 109,A01,083213,Ganzberger; Geoffrey Michael,3,0,34,31
1657973205872,MATH 109,A02,083214,Ganzberger; Geoffrey Michael,4,0,34,30
1657973205872,MATH 109,A03,093478,Ganzberger; Geoffrey Michael,2,0,34,32
1657973205872,MATH 109,B01,083215,Ganzberger; Geoffrey Michael,3,0,32,29
1657973205872,MATH 109,B02,083216,Ganzberger; Geoffrey Michael,3,0,32,29
1657973205872,MATH 109,B03,093479,Ganzberger; Geoffrey Michael,8,0,32,24
1657973211898,MATH 142A,A01,083219,Chow; Bennett,7,0,32,25
1657973211898,MATH 142A,A02,083220,Chow; Bennett,10,0,32,22
1657973211898,MATH 142A,A03,093480,Chow; Bennett,9,0,32,23
1657973211898,MATH 142A,B03,093481,Chow; Bennett,8,0,32,24
1657973211898,MATH 142A,B04,093558,Chow; Bennett,14,0,32,18
1657973211898,MATH 142A,B05,093559,Chow; Bennett,7,0,32,25
1657973217930,MATH 193A,A01,083224,Rotar; Vladimir,9,0,34,25
1657973217930,MATH 193A,A02,083225,Rotar; Vladimir,11,0,34,23
1657973217930,MATH 193A,A03,083781,Rotar; Vladimir,5,0,34,29
1657973217930,MATH 193A,A04,083782,Rotar; Vladimir,12,0,34,22
1657973217930,MATH 193A,A05,093482,Rotar; Vladimir,11,0,34,23
1657973223957,MATH 197,001,091859,McAuley; Julian John,9999,0,9999,0
1657973223957,MATH 197,002,095566,Kedlaya; Kiran S.,9997,0,9999,2
1657973223957,MATH 197,003,095567,Xiao; Ming,9999,0,9999,0
1657973223957,MATH 197,004,095571,Perols; Johan Lars,9998,0,9999,1
1657973231032,COGS 9,A01,083615,Shannon; Kyle Michael,11,0,75,64
1657973237063,COGS 11,A01,083617,Boyle; Mary E. T.,23,0,48,25
1657973243097,COGS 13,A01,083071,Bastos; Amalia Pinkusfeld,12,0,71,59
1657973249130,COGS 14A,A01,092681,Semenuks; Arturs,5,1,100,95
1657973255155,COGS 14B,A01,083073,Cheng; Tzu-Han,7,0,63,56
1657973261192,COGS 17,A01,092677,Semenuks; Arturs,7,0,81,74
1657973267220,COGS 100,A01,083619,Allen; Michael Gordon,17,0,70,53
1657973273245,COGS 101A,A01,083621,Davis; Joshua Daniel,9,0,68,59
1657973279286,COGS 101B,A01,091572,Allen; Michael Gordon,14,0,65,51
1657973285316,COGS 101C,A01,083625,Delgado; Tania,17,0,35,18
1657973291352,COGS 107A,A01,083627,Boyle; Mary E. T.,14,0,60,46
1657973297380,COGS 118A,A01,083075,Gupta; Anjum,21,0,76,55
1657973303415,CSE 3,A50,083646,Miranda; Gregory Joseph,24,0,50,26
1657973309442,CSE 8A,A50,083650,Miranda; Gregory Joseph,17,1,56,39
1657973315469,CSE 11,A01,083080,Cao; Yingjun,7,15,40,33
1657973321501,CSE 12,A01,083652,Krause-Levy; Sophia Louisa,30,1,120,90
1657973327526,CSE 15L,A01,083654,Morris; Justin Loren,9,0,50,41
1657973327526,CSE 15L,A02,083655,Morris; Justin Loren,11,0,50,39
1657973333551,CSE 20,A01,083657,Tran; Khoa Dang,39,0,80,41
1657973339577,CSE 21,A01,095574,Bach; Quang Tran,23,0,48,25
1657973345612,CSE 30,A01,083084,Eldon; John,8,0,80,72
1657973345612,CSE 30,B01,095061,Bhaskar; Nishant,9,0,50,41
1657973351639,CSE 100,A01,083659,Cao; Yingjun,5,4,70,65
1657973357668,CSE 134B,A01,083661,Powell; Thomas Allan,25,0,100,75
1657973363703,CSE 140,A01,083663,Gungor; Onat,17,0,85,68
1657973369734,CSE 140L,A01,083088,Eldon; John,23,0,100,77
1657973375775,CSE 175,A01,083665,Kumar; Rakesh,3,0,25,22
1657973381805,CSE 190,A00,092507,Dubnov; Shlomo,8,0,20,12
1657973387835,ECE 45,A01,083139,Congero; Spencer William,7,0,75,68
1657973393862,ECE 65,A50,083695,Saad; Andrew S,12,0,30,18
1657973393862,ECE 65,A51,095125,Saad; Andrew S,24,0,26,2
1657973399893,ECE 109,A01,091882,Touri; Behrouz,21,0,70,49
1657973405925,ECE 180,A00,083140,Abi Samra; Nicholas Camill,1,0,30,29
1657973405925,ECE 180,B00,083141,Abi Samra; Nicholas Camill,0,0,30,30
1657973411953,MATH 10A,A01,083735,Patchell; Gregory David,2,0,30,28
1657973411953,MATH 10A,A02,083736,Patchell; Gregory David,20,0,30,10
1657973411953,MATH 10A,A03,083737,Patchell; Gregory David,16,0,30,14
1657973417984,MATH 10B,A01,083207,Lim; Seonhee,9,0,34,25
1657973417984,MATH 10B,A02,083208,Lim; Seonhee,10,0,35,25
1657973417984,MATH 10B,A03,093472,Lim; Seonhee,7,0,34,27
1657973417984,MATH 10B,B01,083739,Sinha; Shubham,14,0,30,16
1657973424023,MATH 18,A01,083743,Cinel; Cameron Alexander,9,0,30,21
1657973424023,MATH 18,A02,083744,Cinel; Cameron Alexander,18,0,30,12
1657973424023,MATH 18,A03,083745,Cinel; Cameron Alexander,10,0,30,20
1657973424023,MATH 18,B01,083748,Rideout; David Porter,5,0,37,32
1657973424023,MATH 18,B02,083749,Rideout; David Porter,5,0,36,31
1657973424023,MATH 18,B03,083750,Rideout; David Porter,3,0,37,34
1657973424023,MATH 18,B04,083751,Rideout; David Porter,7,0,36,29
1657973424023,MATH 18,B05,093473,Rideout; David Porter,7,0,36,29
1657973424023,MATH 18,B06,093474,Rideout; David Porter,6,0,36,30
1657973430054,MATH 20A,A01,083754,Zheng; Zequn,14,0,40,26
1657973436084,MATH 20B,A01,083756,Briones; Jor-el Thomas Caparas,4,0,36,32
1657973436084,MATH 20B,A02,083757,Briones; Jor-el Thomas Caparas,1,0,36,35
1657973436084,MATH 20B,A03,093475,Briones; Jor-el Thomas Caparas,3,0,36,33
1657973442110,MATH 20C,A01,083760,Briones; Jor-el Thomas Caparas,1,0,35,34
1657973442110,MATH 20C,A02,083761,Briones; Jor-el Thomas Caparas,8,0,35,27
1657973442110,MATH 20C,A03,093476,Briones; Jor-el Thomas Caparas,0,1,36,36
1657973442110,MATH 20C,B01,083762,Bach; Quang Tran,1,0,30,29
1657973448143,MATH 20D,A01,083765,Tran; Brian Kha,5,0,30,25
1657973448143,MATH 20D,A02,083766,Tran; Brian Kha,5,0,30,25
1657973448143,MATH 20D,A03,083767,Tran; Brian Kha,6,0,30,24
1657973454172,MATH 20E,A01,083771,Ganguly; Soumya,12,0,32,20
1657973454172,MATH 20E,A02,083772,Ganguly; Soumya,7,0,32,25
1657973454172,MATH 20E,B01,083773,Ciotti; Benjamin,20,0,35,15
1657973454172,MATH 20E,B02,083774,Ciotti; Benjamin,18,0,35,17
1657973460200,MATH 103A,A01,083777,Greenfeld; Be'Eri,6,0,36,30
1657973460200,MATH 103A,A02,083778,Greenfeld; Be'Eri,5,0,36,31
1657973460200,MATH 103A,A03,093561,Greenfeld; Be'Eri,7,0,36,29
1657973460200,MATH 103A,B01,083779,Greenfeld; Be'Eri,8,0,36,28
1657973460200,MATH 103A,B02,083780,Greenfeld; Be'Eri,4,0,36,32
1657973460200,MATH 103A,B03,093562,Greenfeld; Be'Eri,3,0,36,33
1657973466225,MATH 105,A01,085443,Carter; Anne Toulson,15,0,35,20
1657973466225,MATH 105,A02,093477,Carter; Anne Toulson,20,0,35,15
1657973472252,MATH 109,A01,083213,Ganzberger; Geoffrey Michael,3,0,34,31
1657973472252,MATH 109,A02,083214,Ganzberger; Geoffrey Michael,4,0,34,30
1657973472252,MATH 109,A03,093478,Ganzberger; Geoffrey Michael,2,0,34,32
1657973472252,MATH 109,B01,083215,Ganzberger; Geoffrey Michael,3,0,32,29
1657973472252,MATH 109,B02,083216,Ganzberger; Geoffrey Michael,3,0,32,29
1657973472252,MATH 109,B03,093479,Ganzberger; Geoffrey Michael,8,0,32,24
1657973478280,MATH 142A,A01,083219,Chow; Bennett,7,0,32,25
1657973478280,MATH 142A,A02,083220,Chow; Bennett,10,0,32,22
1657973478280,MATH 142A,A03,093480,Chow; Bennett,9,0,32,23
1657973478280,MATH 142A,B03,093481,Chow; Bennett,8,0,32,24
1657973478280,MATH 142A,B04,093558,Chow; Bennett,14,0,32,18
1657973478280,MATH 142A,B05,093559,Chow; Bennett,7,0,32,25
1657973484307,MATH 193A,A01,083224,Rotar; Vladimir,9,0,34,25
1657973484307,MATH 193A,A02,083225,Rotar; Vladimir,11,0,34,23
1657973484307,MATH 193A,A03,083781,Rotar; Vladimir,5,0,34,29
1657973484307,MATH 193A,A04,083782,Rotar; Vladimir,12,0,34,22
1657973484307,MATH 193A,A05,093482,Rotar; Vladimir,11,0,34,23
1657973490332,MATH 197,001,091859,McAuley; Julian John,9999,0,9999,0
1657973490332,MATH 197,002,095566,Kedlaya; Kiran S.,9997,0,9999,2
1657973490332,MATH 197,003,095567,Xiao; Ming,9999,0,9999,0
1657973490332,MATH 197,004,095571,Perols; Johan Lars,9998,0,9999,1
1657973497422,COGS 9,A01,083615,Shannon; Kyle Michael,11,0,75,64
1657973503457,COGS 11,A01,083617,Boyle; Mary E. T.,23,0,48,25
1657973509485,COGS 13,A01,083071,Bastos; Amalia Pinkusfeld,12,0,71,59
1657973515511,COGS 14A,A01,092681,Semenuks; Arturs,5,1,100,95
1657973521539,COGS 14B,A01,083073,Cheng; Tzu-Han,7,0,63,56
1657973527564,COGS 17,A01,092677,Semenuks; Arturs,7,0,81,74
1657973533660,COGS 100,A01,083619,Allen; Michael Gordon,17,0,70,53
1657973539695,COGS 101A,A01,083621,Davis; Joshua Daniel,9,0,68,59
1657973545726,COGS 101B,A01,091572,Allen; Michael Gordon,14,0,65,51
1657973551752,COGS 101C,A01,083625,Delgado; Tania,17,0,35,18
1657973557778,COGS 107A,A01,083627,Boyle; Mary E. T.,14,0,60,46
1657973563804,COGS 118A,A01,083075,Gupta; Anjum,21,0,76,55
1657973569830,CSE 3,A50,083646,Miranda; Gregory Joseph,24,0,50,26
1657973575860,CSE 8A,A50,083650,Miranda; Gregory Joseph,17,1,56,39
1657973581886,CSE 11,A01,083080,Cao; Yingjun,7,15,40,33
1657973587912,CSE 12,A01,083652,Krause-Levy; Sophia Louisa,30,1,120,90
1657973593942,CSE 15L,A01,083654,Morris; Justin Loren,9,0,50,41
1657973593942,CSE 15L,A02,083655,Morris; Justin Loren,11,0,50,39
1657973599973,CSE 20,A01,083657,Tran; Khoa Dang,39,0,80,41
1657973606003,CSE 21,A01,095574,Bach; Quang Tran,23,0,48,25
1657973612030,CSE 30,A01,083084,Eldon; John,8,0,80,72
1657973612030,CSE 30,B01,095061,Bhaskar; Nishant,9,0,50,41
1657973618058,CSE 100,A01,083659,Cao; Yingjun,5,4,70,65
1657973624085,CSE 134B,A01,083661,Powell; Thomas Allan,25,0,100,75
1657973630114,CSE 140,A01,083663,Gungor; Onat,17,0,85,68
1657973636139,CSE 140L,A01,083088,Eldon; John,23,0,100,77
1657973642165,CSE 175,A01,083665,Kumar; Rakesh,3,0,25,22
1657973648190,CSE 190,A00,092507,Dubnov; Shlomo,8,0,20,12
1657973654224,ECE 45,A01,083139,Congero; Spencer William,7,0,75,68
1657973660258,ECE 65,A50,083695,Saad; Andrew S,12,0,30,18
1657973660258,ECE 65,A51,095125,Saad; Andrew S,24,0,26,2
1657973666284,ECE 109,A01,091882,Touri; Behrouz,21,0,70,49
1657973672314,ECE 180,A00,083140,Abi Samra; Nicholas Camill,1,0,30,29
1657973672314,ECE 180,B00,083141,Abi Samra; Nicholas Camill,0,0,30,30
1657973678350,MATH 10A,A01,083735,Patchell; Gregory David,2,0,30,28
1657973678350,MATH 10A,A02,083736,Patchell; Gregory David,20,0,30,10
1657973678350,MATH 10A,A03,083737,Patchell; Gregory David,16,0,30,14
1657973684395,MATH 10B,A01,083207,Lim; Seonhee,9,0,34,25
1657973684395,MATH 10B,A02,083208,Lim; Seonhee,10,0,35,25
1657973684395,MATH 10B,A03,093472,Lim; Seonhee,7,0,34,27
1657973684395,MATH 10B,B01,083739,Sinha; Shubham,14,0,30,16
1657973690425,MATH 18,A01,083743,Cinel; Cameron Alexander,9,0,30,21
1657973690425,MATH 18,A02,083744,Cinel; Cameron Alexander,18,0,30,12
1657973690425,MATH 18,A03,083745,Cinel; Cameron Alexander,10,0,30,20
1657973690425,MATH 18,B01,083748,Rideout; David Porter,5,0,37,32
1657973690425,MATH 18,B02,083749,Rideout; David Porter,5,0,36,31
1657973690425,MATH 18,B03,083750,Rideout; David Porter,3,0,37,34
1657973690425,MATH 18,B04,083751,Rideout; David Porter,7,0,36,29
1657973690425,MATH 18,B05,093473,Rideout; David Porter,7,0,36,29
1657973690425,MATH 18,B06,093474,Rideout; David Porter,6,0,36,30
1657973696456,MATH 20A,A01,083754,Zheng; Zequn,14,0,40,26
1657973702482,MATH 20B,A01,083756,Briones; Jor-el Thomas Caparas,4,0,36,32
1657973702482,MATH 20B,A02,083757,Briones; Jor-el Thomas Caparas,1,0,36,35
1657973702482,MATH 20B,A03,093475,Briones; Jor-el Thomas Caparas,3,0,36,33
1657973708510,MATH 20C,A01,083760,Briones; Jor-el Thomas Caparas,1,0,35,34
1657973708510,MATH 20C,A02,083761,Briones; Jor-el Thomas Caparas,8,0,35,27
1657973708510,MATH 20C,A03,093476,Briones; Jor-el Thomas Caparas,0,1,36,36
1657973708510,MATH 20C,B01,083762,Bach; Quang Tran,1,0,30,29
1657973714540,MATH 20D,A01,083765,Tran; Brian Kha,5,0,30,25
1657973714540,MATH 20D,A02,083766,Tran; Brian Kha,5,0,30,25
1657973714540,MATH 20D,A03,083767,Tran; Brian Kha,6,0,30,24
1657973720569,MATH 20E,A01,083771,Ganguly; Soumya,12,0,32,20
1657973720569,MATH 20E,A02,083772,Ganguly; Soumya,7,0,32,25
1657973720569,MATH 20E,B01,083773,Ciotti; Benjamin,20,0,35,15
1657973720569,MATH 20E,B02,083774,Ciotti; Benjamin,18,0,35,17
1657973726606,MATH 103A,A01,083777,Greenfeld; Be'Eri,6,0,36,30
1657973726606,MATH 103A,A02,083778,Greenfeld; Be'Eri,5,0,36,31
1657973726606,MATH 103A,A03,093561,Greenfeld; Be'Eri,7,0,36,29
1657973726606,MATH 103A,B01,083779,Greenfeld; Be'Eri,8,0,36,28
1657973726606,MATH 103A,B02,083780,Greenfeld; Be'Eri,4,0,36,32
1657973726606,MATH 103A,B03,093562,Greenfeld; Be'Eri,3,0,36,33
1657973732637,MATH 105,A01,085443,Carter; Anne Toulson,15,0,35,20
1657973732637,MATH 105,A02,093477,Carter; Anne Toulson,20,0,35,15
1657973738670,MATH 109,A01,083213,Ganzberger; Geoffrey Michael,3,0,34,31
1657973738670,MATH 109,A02,083214,Ganzberger; Geoffrey Michael,4,0,34,30
1657973738670,MATH 109,A03,093478,Ganzberger; Geoffrey Michael,2,0,34,32
1657973738670,MATH 109,B01,083215,Ganzberger; Geoffrey Michael,3,0,32,29
1657973738670,MATH 109,B02,083216,Ganzberger; Geoffrey Michael,3,0,32,29
1657973738670,MATH 109,B03,093479,Ganzberger; Geoffrey Michael,8,0,32,24
1657973744704,MATH 142A,A01,083219,Chow; Bennett,7,0,32,25
1657973744704,MATH 142A,A02,083220,Chow; Bennett,10,0,32,22
1657973744704,MATH 142A,A03,093480,Chow; Bennett,9,0,32,23
1657973744704,MATH 142A,B03,093481,Chow; Bennett,8,0,32,24
1657973744704,MATH 142A,B04,093558,Chow; Bennett,14,0,32,18
1657973744704,MATH 142A,B05,093559,Chow; Bennett,7,0,32,25
1657973750732,MATH 193A,A01,083224,Rotar; Vladimir,9,0,34,25
1657973750732,MATH 193A,A02,083225,Rotar; Vladimir,11,0,34,23
1657973750732,MATH 193A,A03,083781,Rotar; Vladimir,5,0,34,29
1657973750732,MATH 193A,A04,083782,Rotar; Vladimir,12,0,34,22
1657973750732,MATH 193A,A05,093482,Rotar; Vladimir,11,0,34,23
1657973756756,MATH 197,001,091859,McAuley; Julian John,9999,0,9999,0
1657973756756,MATH 197,002,095566,Kedlaya; Kiran S.,9997,0,9999,2
1657973756756,MATH 197,003,095567,Xiao; Ming,9999,0,9999,0
1657973756756,MATH 197,004,095571,Perols; Johan Lars,9998,0,9999,1
1657973763831,COGS 9,A01,083615,Shannon; Kyle Michael,11,0,75,64
1657973769865,COGS 11,A01,083617,Boyle; Mary E. T.,23,0,48,25
1657973775890,COGS 13,A01,083071,Bastos; Amalia Pinkusfeld,12,0,71,59
1657973781931,COGS 14A,A01,092681,Semenuks; Arturs,5,1,100,95
1657973787958,COGS 14B,A01,083073,Cheng; Tzu-Han,7,0,63,56
1657973793989,COGS 17,A01,092677,Semenuks; Arturs,7,0,81,74
1657973800019,COGS 100,A01,083619,Allen; Michael Gordon,17,0,70,53
1657973806050,COGS 101A,A01,083621,Davis; Joshua Daniel,9,0,68,59
1657973812084,COGS 101B,A01,091572,Allen; Michael Gordon,14,0,65,51
1657973818117,COGS 101C,A01,083625,Delgado; Tania,17,0,35,18
1657973824140,COGS 107A,A01,083627,Boyle; Mary E. T.,14,0,60,46
1657973830172,COGS 118A,A01,083075,Gupta; Anjum,21,0,76,55
1657973836201,CSE 3,A50,083646,Miranda; Gregory Joseph,24,0,50,26
1657973842234,CSE 8A,A50,083650,Miranda; Gregory Joseph,17,1,56,39
1657973848258,CSE 11,A01,083080,Cao; Yingjun,7,15,40,33
1657973854297,CSE 12,A01,083652,Krause-Levy; Sophia Louisa,30,1,120,90
1657973860322,CSE 15L,A01,083654,Morris; Justin Loren,9,0,50,41
1657973860322,CSE 15L,A02,083655,Morris; Justin Loren,11,0,50,39
1657973866350,CSE 20,A01,083657,Tran; Khoa Dang,39,0,80,41
1657973872375,CSE 21,A01,095574,Bach; Quang Tran,23,0,48,25
1657973878410,CSE 30,A01,083084,Eldon; John,8,0,80,72
1657973878410,CSE 30,B01,095061,Bhaskar; Nishant,9,0,50,41
1657973884440,CSE 100,A01,083659,Cao; Yingjun,5,4,70,65
1657973890467,CSE 134B,A01,083661,Powell; Thomas Allan,25,0,100,75
1657973896492,CSE 140,A01,083663,Gungor; Onat,17,0,85,68
1657973902523,CSE 140L,A01,083088,Eldon; John,23,0,100,77
1657973908550,CSE 175,A01,083665,Kumar; Rakesh,3,0,25,22
1657973914580,CSE 190,A00,092507,Dubnov; Shlomo,8,0,20,12
1657973920607,ECE 45,A01,083139,Congero; Spencer William,7,0,75,68
1657973926641,ECE 65,A50,083695,Saad; Andrew S,12,0,30,18
1657973926641,ECE 65,A51,095125,Saad; Andrew S,24,0,26,2
1657973932668,ECE 109,A01,091882,Touri; Behrouz,21,0,70,49
1657973938699,ECE 180,A00,083140,Abi Samra; Nicholas Camill,1,0,30,29
1657973938699,ECE 180,B00,083141,Abi Samra; Nicholas Camill,0,0,30,30
1657973944733,MATH 10A,A01,083735,Patchell; Gregory David,2,0,30,28
1657973944733,MATH 10A,A02,083736,Patchell; Gregory David,20,0,30,10
1657973944733,MATH 10A,A03,083737,Patchell; Gregory David,16,0,30,14
1657973950765,MATH 10B,A01,083207,Lim; Seonhee,9,0,34,25
1657973950765,MATH 10B,A02,083208,Lim; Seonhee,10,0,35,25
1657973950765,MATH 10B,A03,093472,Lim; Seonhee,7,0,34,27
1657973950765,MATH 10B,B01,083739,Sinha; Shubham,14,0,30,16
1657973956806,MATH 18,A01,083743,Cinel; Cameron Alexander,9,0,30,21
1657973956806,MATH 18,A02,083744,Cinel; Cameron Alexander,18,0,30,12
1657973956806,MATH 18,A03,083745,Cinel; Cameron Alexander,10,0,30,20
1657973956806,MATH 18,B01,083748,Rideout; David Porter,5,0,37,32
1657973956806,MATH 18,B02,083749,Rideout; David Porter,5,0,36,31
1657973956806,MATH 18,B03,083750,Rideout; David Porter,3,0,37,34
1657973956806,MATH 18,B04,083751,Rideout; David Porter,7,0,36,29
1657973956806,MATH 18,B05,093473,Rideout; David Porter,7,0,36,29
1657973956806,MATH 18,B06,093474,Rideout; David Porter,6,0,36,30
1657973962835,MATH 20A,A01,083754,Zheng; Zequn,14,0,40,26
1657973968871,MATH 20B,A01,083756,Briones; Jor-el Thomas Caparas,4,0,36,32
1657973968871,MATH 20B,A02,083757,Briones; Jor-el Thomas Caparas,1,0,36,35
1657973968871,MATH 20B,A03,093475,Briones; Jor-el Thomas Caparas,3,0,36,33
1657973974897,MATH 20C,A01,083760,Briones; Jor-el Thomas Caparas,1,0,35,34
1657973974897,MATH 20C,A02,083761,Briones; Jor-el Thomas Caparas,8,0,35,27
1657973974897,MATH 20C,A03,093476,Briones; Jor-el Thomas Caparas,0,1,36,36
1657973974897,MATH 20C,B01,083762,Bach; Quang Tran,1,0,30,29
1657973980930,MATH 20D,A01,083765,Tran; Brian Kha,5,0,30,25
1657973980930,MATH 20D,A02,083766,Tran; Brian Kha,5,0,30,25
1657973980930,MATH 20D,A03,083767,Tran; Brian Kha,6,0,30,24
1657973986958,MATH 20E,A01,083771,Ganguly; Soumya,12,0,32,20
1657973986958,MATH 20E,A02,083772,Ganguly; Soumya,7,0,32,25
1657973986958,MATH 20E,B01,083773,Ciotti; Benjamin,20,0,35,15
1657973986958,MATH 20E,B02,083774,Ciotti; Benjamin,18,0,35,17
1657973992986,MATH 103A,A01,083777,Greenfeld; Be'Eri,6,0,36,30
1657973992986,MATH 103A,A02,083778,Greenfeld; Be'Eri,5,0,36,31
1657973992986,MATH 103A,A03,093561,Greenfeld; Be'Eri,7,0,36,29
1657973992986,MATH 103A,B01,083779,Greenfeld; Be'Eri,8,0,36,28
1657973992986,MATH 103A,B02,083780,Greenfeld; Be'Eri,4,0,36,32
1657973992986,MATH 103A,B03,093562,Greenfeld; Be'Eri,3,0,36,33
1657973999011,MATH 105,A01,085443,Carter; Anne Toulson,15,0,35,20
1657973999011,MATH 105,A02,093477,Carter; Anne Toulson,20,0,35,15
1657974005041,MATH 109,A01,083213,Ganzberger; Geoffrey Michael,3,0,34,31
1657974005041,MATH 109,A02,083214,Ganzberger; Geoffrey Michael,4,0,34,30
1657974005041,MATH 109,A03,093478,Ganzberger; Geoffrey Michael,2,0,34,32
1657974005041,MATH 109,B01,083215,Ganzberger; Geoffrey Michael,3,0,32,29
1657974005041,MATH 109,B02,083216,Ganzberger; Geoffrey Michael,3,0,32,29
1657974005041,MATH 109,B03,093479,Ganzberger; Geoffrey Michael,8,0,32,24
1657974011067,MATH 142A,A01,083219,Chow; Bennett,7,0,32,25
1657974011067,MATH 142A,A02,083220,Chow; Bennett,10,0,32,22
1657974011067,MATH 142A,A03,093480,Chow; Bennett,9,0,32,23
1657974011067,MATH 142A,B03,093481,Chow; Bennett,8,0,32,24
1657974011067,MATH 142A,B04,093558,Chow; Bennett,14,0,32,18
1657974011067,MATH 142A,B05,093559,Chow; Bennett,7,0,32,25
1657974017092,MATH 193A,A01,083224,Rotar; Vladimir,9,0,34,25
1657974017092,MATH 193A,A02,083225,Rotar; Vladimir,11,0,34,23
1657974017092,MATH 193A,A03,083781,Rotar; Vladimir,5,0,34,29
1657974017092,MATH 193A,A04,083782,Rotar; Vladimir,12,0,34,22
1657974017092,MATH 193A,A05,093482,Rotar; Vladimir,11,0,34,23
1657974023123,MATH 197,001,091859,McAuley; Julian John,9999,0,9999,0
1657974023123,MATH 197,002,095566,Kedlaya; Kiran S.,9997,0,9999,2
1657974023123,MATH 197,003,095567,Xiao; Ming,9999,0,9999,0
1657974023123,MATH 197,004,095571,Perols; Johan Lars,9998,0,9999,1
1657974030195,COGS 9,A01,083615,Shannon; Kyle Michael,11,0,75,64
1657974036221,COGS 11,A01,083617,Boyle; Mary E. T.,23,0,48,25
1657974042247,COGS 13,A01,083071,Bastos; Amalia Pinkusfeld,12,0,71,59
1657974048277,COGS 14A,A01,092681,Semenuks; Arturs,5,1,100,95
1657974054305,COGS 14B,A01,083073,Cheng; Tzu-Han,7,0,63,56
1657974060334,COGS 17,A01,092677,Semenuks; Arturs,7,0,81,74
1657974066358,COGS 100,A01,083619,Allen; Michael Gordon,17,0,70,53
1657974072382,COGS 101A,A01,083621,Davis; Joshua Daniel,9,0,68,59
1657974078407,COGS 101B,A01,091572,Allen; Michael Gordon,14,0,65,51
1657974084437,COGS 101C,A01,083625,Delgado; Tania,17,0,35,18
1657974090471,COGS 107A,A01,083627,Boyle; Mary E. T.,14,0,60,46
1657974096499,COGS 118A,A01,083075,Gupta; Anjum,21,0,76,55
1657974102525,CSE 3,A50,083646,Miranda; Gregory Joseph,24,0,50,26
1657974108558,CSE 8A,A50,083650,Miranda; Gregory Joseph,17,1,56,39
1657974114583,CSE 11,A01,083080,Cao; Yingjun,7,15,40,33
1657974120618,CSE 12,A01,083652,Krause-Levy; Sophia Louisa,30,1,120,90
1657974126648,CSE 15L,A01,083654,Morris; Justin Loren,9,0,50,41
1657974126648,CSE 15L,A02,083655,Morris; Justin Loren,11,0,50,39
1657974132769,CSE 20,A01,083657,Tran; Khoa Dang,39,0,80,41
1657974138794,CSE 21,A01,095574,Bach; Quang Tran,23,0,48,25
1657974144820,CSE 30,A01,083084,Eldon; John,8,0,80,72
1657974144820,CSE 30,B01,095061,Bhaskar; Nishant,9,0,50,41
1657974150845,CSE 100,A01,083659,Cao; Yingjun,5,4,70,65
1657974156870,CSE 134B,A01,083661,Powell; Thomas Allan,25,0,100,75
1657974162899,CSE 140,A01,083663,Gungor; Onat,17,0,85,68
1657974168928,CSE 140L,A01,083088,Eldon; John,23,0,100,77
1657974174956,CSE 175,A01,083665,Kumar; Rakesh,3,0,25,22
1657974180993,CSE 190,A00,092507,Dubnov; Shlomo,8,0,20,12
1657974187024,ECE 45,A01,083139,Congero; Spencer William,7,0,75,68
1657974193058,ECE 65,A50,083695,Saad; Andrew S,12,0,30,18
1657974193058,ECE 65,A51,095125,Saad; Andrew S,24,0,26,2
1657974199087,ECE 109,A01,091882,Touri; Behrouz,21,0,70,49
1657974205113,ECE 180,A00,083140,Abi Samra; Nicholas Camill,1,0,30,29
1657974205113,ECE 180,B00,083141,Abi Samra; Nicholas Camill,0,0,30,30
1657974211146,MATH 10A,A01,083735,Patchell; Gregory David,2,0,30,28
1657974211146,MATH 10A,A02,083736,Patchell; Gregory David,20,0,30,10
1657974211146,MATH 10A,A03,083737,Patchell; Gregory David,16,0,30,14
1657974217174,MATH 10B,A01,083207,Lim; Seonhee,9,0,34,25
1657974217174,MATH 10B,A02,083208,Lim; Seonhee,10,0,35,25
1657974217174,MATH 10B,A03,093472,Lim; Seonhee,7,0,34,27
1657974217174,MATH 10B,B01,083739,Sinha; Shubham,14,0,30,16
1657974223201,MATH 18,A01,083743,Cinel; Cameron Alexander,9,0,30,21
1657974223201,MATH 18,A02,083744,Cinel; Cameron Alexander,18,0,30,12
1657974223201,MATH 18,A03,083745,Cinel; Cameron Alexander,10,0,30,20
1657974223201,MATH 18,B01,083748,Rideout; David Porter,5,0,37,32
1657974223201,MATH 18,B02,083749,Rideout; David Porter,5,0,36,31
1657974223201,MATH 18,B03,083750,Rideout; David Porter,3,0,37,34
1657974223201,MATH 18,B04,083751,Rideout; David Porter,7,0,36,29
1657974223201,MATH 18,B05,093473,Rideout; David Porter,7,0,36,29
1657974223201,MATH 18,B06,093474,Rideout; David Porter,6,0,36,30
1657974229230,MATH 20A,A01,083754,Zheng; Zequn,14,0,40,26
1657974235268,MATH 20B,A01,083756,Briones; Jor-el Thomas Caparas,4,0,36,32
1657974235268,MATH 20B,A02,083757,Briones; Jor-el Thomas Caparas,1,0,36,35
1657974235268,MATH 20B,A03,093475,Briones; Jor-el Thomas Caparas,3,0,36,33
1657974241302,MATH 20C,A01,083760,Briones; Jor-el Thomas Caparas,1,0,35,34
1657974241302,MATH 20C,A02,083761,Briones; Jor-el Thomas Caparas,8,0,35,27
1657974241302,MATH 20C,A03,093476,Briones; Jor-el Thomas Caparas,0,1,36,36
1657974241302,MATH 20C,B01,083762,Bach; Quang Tran,1,0,30,29
1657974247334,MATH 20D,A01,083765,Tran; Brian Kha,5,0,30,25
1657974247334,MATH 20D,A02,083766,Tran; Brian Kha,5,0,30,25
1657974247334,MATH 20D,A03,083767,Tran; Brian Kha,6,0,30,24
1657974253364,MATH 20E,A01,083771,Ganguly; Soumya,12,0,32,20
1657974253364,MATH 20E,A02,083772,Ganguly; Soumya,7,0,32,25
1657974253364,MATH 20E,B01,083773,Ciotti; Benjamin,20,0,35,15
1657974253364,MATH 20E,B02,083774,Ciotti; Benjamin,18,0,35,17
1657974259392,MATH 103A,A01,083777,Greenfeld; Be'Eri,6,0,36,30
1657974259392,MATH 103A,A02,083778,Greenfeld; Be'Eri,5,0,36,31
1657974259392,MATH 103A,A03,093561,Greenfeld; Be'Eri,7,0,36,29
1657974259392,MATH 103A,B01,083779,Greenfeld; Be'Eri,8,0,36,28
1657974259392,MATH 103A,B02,083780,Greenfeld; Be'Eri,4,0,36,32
1657974259392,MATH 103A,B03,093562,Greenfeld; Be'Eri,3,0,36,33
1657974265418,MATH 105,A01,085443,Carter; Anne Toulson,15,0,35,20
1657974265418,MATH 105,A02,093477,Carter; Anne Toulson,20,0,35,15
1657974271445,MATH 109,A01,083213,Ganzberger; Geoffrey Michael,3,0,34,31
1657974271445,MATH 109,A02,083214,Ganzberger; Geoffrey Michael,4,0,34,30
1657974271445,MATH 109,A03,093478,Ganzberger; Geoffrey Michael,2,0,34,32
1657974271445,MATH 109,B01,083215,Ganzberger; Geoffrey Michael,3,0,32,29
1657974271445,MATH 109,B02,083216,Ganzberger; Geoffrey Michael,3,0,32,29
1657974271445,MATH 109,B03,093479,Ganzberger; Geoffrey Michael,8,0,32,24
1657974277472,MATH 142A,A01,083219,Chow; Bennett,7,0,32,25
1657974277472,MATH 142A,A02,083220,Chow; Bennett,10,0,32,22
1657974277472,MATH 142A,A03,093480,Chow; Bennett,9,0,32,23
1657974277472,MATH 142A,B03,093481,Chow; Bennett,8,0,32,24
1657974277472,MATH 142A,B04,093558,Chow; Bennett,14,0,32,18
1657974277472,MATH 142A,B05,093559,Chow; Bennett,7,0,32,25
1657974283504,MATH 193A,A01,083224,Rotar; Vladimir,9,0,34,25
1657974283504,MATH 193A,A02,083225,Rotar; Vladimir,11,0,34,23
1657974283504,MATH 193A,A03,083781,Rotar; Vladimir,5,0,34,29
1657974283504,MATH 193A,A04,083782,Rotar; Vladimir,12,0,34,22
1657974283504,MATH 193A,A05,093482,Rotar; Vladimir,11,0,34,23
1657974289531,MATH 197,001,091859,McAuley; Julian John,9999,0,9999,0
1657974289531,MATH 197,002,095566,Kedlaya; Kiran S.,9997,0,9999,2
1657974289531,MATH 197,003,095567,Xiao; Ming,9999,0,9999,0
1657974289531,MATH 197,004,095571,Perols; Johan Lars,9998,0,9999,1
1657974296608,COGS 9,A01,083615,Shannon; Kyle Michael,11,0,75,64
1657974302647,COGS 11,A01,083617,Boyle; Mary E. T.,23,0,48,25
1657974308674,COGS 13,A01,083071,Bastos; Amalia Pinkusfeld,12,0,71,59
1657974314703,COGS 14A,A01,092681,Semenuks; Arturs,5,1,100,95
1657974320728,COGS 14B,A01,083073,Cheng; Tzu-Han,7,0,63,56
1657974326761,COGS 17,A01,092677,Semenuks; Arturs,7,0,81,74
1657974332788,COGS 100,A01,083619,Allen; Michael Gordon,17,0,70,53
1657974338822,COGS 101A,A01,083621,Davis; Joshua Daniel,9,0,68,59
1657974344853,COGS 101B,A01,091572,Allen; Michael Gordon,14,0,65,51
1657974350877,COGS 101C,A01,083625,Delgado; Tania,17,0,35,18
1657974356904,COGS 107A,A01,083627,Boyle; Mary E. T.,14,0,60,46
1657974362932,COGS 118A,A01,083075,Gupta; Anjum,21,0,76,55
1657974368958,CSE 3,A50,083646,Miranda; Gregory Joseph,24,0,50,26
1657974374982,CSE 8A,A50,083650,Miranda; Gregory Joseph,17,1,56,39
1657974381007,CSE 11,A01,083080,Cao; Yingjun,7,15,40,33
1657974387042,CSE 12,A01,083652,Krause-Levy; Sophia Louisa,30,1,120,90
1657974393064,CSE 15L,A01,083654,Morris; Justin Loren,9,0,50,41
1657974393064,CSE 15L,A02,083655,Morris; Justin Loren,11,0,50,39
1657974399094,CSE 20,A01,083657,Tran; Khoa Dang,39,0,80,41
1657974405120,CSE 21,A01,095574,Bach; Quang Tran,23,0,48,25
1657974411160,CSE 30,A01,083084,Eldon; John,8,0,80,72
1657974411160,CSE 30,B01,095061,Bhaskar; Nishant,9,0,50,41
1657974417185,CSE 100,A01,083659,Cao; Yingjun,5,4,70,65
1657974423211,CSE 134B,A01,083661,Powell; Thomas Allan,25,0,100,75
1657974429240,CSE 140,A01,083663,Gungor; Onat,17,0,85,68
1657974435269,CSE 140L,A01,083088,Eldon; John,23,0,100,77
1657974441294,CSE 175,A01,083665,Kumar; Rakesh,3,0,25,22
1657974447323,CSE 190,A00,092507,Dubnov; Shlomo,8,0,20,12
1657974453350,ECE 45,A01,083139,Congero; Spencer William,7,0,75,68
1657974459374,ECE 65,A50,083695,Saad; Andrew S,12,0,30,18
1657974459374,ECE 65,A51,095125,Saad; Andrew S,24,0,26,2
1657974465406,ECE 109,A01,091882,Touri; Behrouz,21,0,70,49
1657974471433,ECE 180,A00,083140,Abi Samra; Nicholas Camill,1,0,30,29
1657974471433,ECE 180,B00,083141,Abi Samra; Nicholas Camill,0,0,30,30
1657974477461,MATH 10A,A01,083735,Patchell; Gregory David,2,0,30,28
1657974477461,MATH 10A,A02,083736,Patchell; Gregory David,20,0,30,10
1657974477461,MATH 10A,A03,083737,Patchell; Gregory David,16,0,30,14
1657974483497,MATH 10B,A01,083207,Lim; Seonhee,9,0,34,25
1657974483497,MATH 10B,A02,083208,Lim; Seonhee,10,0,35,25
1657974483497,MATH 10B,A03,093472,Lim; Seonhee,7,0,34,27
1657974483497,MATH 10B,B01,083739,Sinha; Shubham,14,0,30,16
1657974489526,MATH 18,A01,083743,Cinel; Cameron Alexander,9,0,30,21
1657974489526,MATH 18,A02,083744,Cinel; Cameron Alexander,18,0,30,12
1657974489526,MATH 18,A03,083745,Cinel; Cameron Alexander,10,0,30,20
1657974489526,MATH 18,B01,083748,Rideout; David Porter,5,0,37,32
1657974489526,MATH 18,B02,083749,Rideout; David Porter,5,0,36,31
1657974489526,MATH 18,B03,083750,Rideout; David Porter,3,0,37,34
1657974489526,MATH 18,B04,083751,Rideout; David Porter,7,0,36,29
1657974489526,MATH 18,B05,093473,Rideout; David Porter,7,0,36,29
1657974489526,MATH 18,B06,093474,Rideout; David Porter,6,0,36,30
1657974495551,MATH 20A,A01,083754,Zheng; Zequn,14,0,40,26
1657974501578,MATH 20B,A01,083756,Briones; Jor-el Thomas Caparas,4,0,36,32
1657974501578,MATH 20B,A02,083757,Briones; Jor-el Thomas Caparas,1,0,36,35
1657974501578,MATH 20B,A03,093475,Briones; Jor-el Thomas Caparas,3,0,36,33
1657974507604,MATH 20C,A01,083760,Briones; Jor-el Thomas Caparas,1,0,35,34
1657974507604,MATH 20C,A02,083761,Briones; Jor-el Thomas Caparas,8,0,35,27
1657974507604,MATH 20C,A03,093476,Briones; Jor-el Thomas Caparas,0,1,36,36
1657974507604,MATH 20C,B01,083762,Bach; Quang Tran,1,0,30,29
1657974513630,MATH 20D,A01,083765,Tran; Brian Kha,5,0,30,25
1657974513630,MATH 20D,A02,083766,Tran; Brian Kha,5,0,30,25
1657974513630,MATH 20D,A03,083767,Tran; Brian Kha,6,0,30,24
1657974519664,MATH 20E,A01,083771,Ganguly; Soumya,12,0,32,20
1657974519664,MATH 20E,A02,083772,Ganguly; Soumya,7,0,32,25
1657974519664,MATH 20E,B01,083773,Ciotti; Benjamin,20,0,35,15
1657974519664,MATH 20E,B02,083774,Ciotti; Benjamin,18,0,35,17
1657974525691,MATH 103A,A01,083777,Greenfeld; Be'Eri,6,0,36,30
1657974525691,MATH 103A,A02,083778,Greenfeld; Be'Eri,5,0,36,31
1657974525691,MATH 103A,A03,093561,Greenfeld; Be'Eri,7,0,36,29
1657974525691,MATH 103A,B01,083779,Greenfeld; Be'Eri,8,0,36,28
1657974525691,MATH 103A,B02,083780,Greenfeld; Be'Eri,4,0,36,32
1657974525691,MATH 103A,B03,093562,Greenfeld; Be'Eri,3,0,36,33
1657974531724,MATH 105,A01,085443,Carter; Anne Toulson,15,0,35,20
1657974531724,MATH 105,A02,093477,Carter; Anne Toulson,20,0,35,15
1657974537750,MATH 109,A01,083213,Ganzberger; Geoffrey Michael,3,0,34,31
1657974537750,MATH 109,A02,083214,Ganzberger; Geoffrey Michael,4,0,34,30
1657974537750,MATH 109,A03,093478,Ganzberger; Geoffrey Michael,2,0,34,32
1657974537750,MATH 109,B01,083215,Ganzberger; Geoffrey Michael,3,0,32,29
1657974537750,MATH 109,B02,083216,Ganzberger; Geoffrey Michael,3,0,32,29
1657974537750,MATH 109,B03,093479,Ganzberger; Geoffrey Michael,8,0,32,24
1657974543788,MATH 142A,A01,083219,Chow; Bennett,7,0,32,25
1657974543788,MATH 142A,A02,083220,Chow; Bennett,10,0,32,22
1657974543788,MATH 142A,A03,093480,Chow; Bennett,9,0,32,23
1657974543788,MATH 142A,B03,093481,Chow; Bennett,8,0,32,24
1657974543788,MATH 142A,B04,093558,Chow; Bennett,14,0,32,18
1657974543788,MATH 142A,B05,093559,Chow; Bennett,7,0,32,25
1657974549814,MATH 193A,A01,083224,Rotar; Vladimir,9,0,34,25
1657974549814,MATH 193A,A02,083225,Rotar; Vladimir,11,0,34,23
1657974549814,MATH 193A,A03,083781,Rotar; Vladimir,5,0,34,29
1657974549814,MATH 193A,A04,083782,Rotar; Vladimir,12,0,34,22
1657974549814,MATH 193A,A05,093482,Rotar; Vladimir,11,0,34,23
1657974555844,MATH 197,001,091859,McAuley; Julian John,9999,0,9999,0
1657974555844,MATH 197,002,095566,Kedlaya; Kiran S.,9997,0,9999,2
1657974555844,MATH 197,003,095567,Xiao; Ming,9999,0,9999,0
1657974555844,MATH 197,004,095571,Perols; Johan Lars,9998,0,9999,1
1657974562905,COGS 9,A01,083615,Shannon; Kyle Michael,11,0,75,64
1657974568930,COGS 11,A01,083617,Boyle; Mary E. T.,23,0,48,25
1657974574957,COGS 13,A01,083071,Bastos; Amalia Pinkusfeld,12,0,71,59
1657974580983,COGS 14A,A01,092681,Semenuks; Arturs,5,1,100,95
1657974587013,COGS 14B,A01,083073,Cheng; Tzu-Han,7,0,63,56
1657974593040,COGS 17,A01,092677,Semenuks; Arturs,7,0,81,74
1657974599068,COGS 100,A01,083619,Allen; Michael Gordon,17,0,70,53
1657974605096,COGS 101A,A01,083621,Davis; Joshua Daniel,9,0,68,59
1657974611120,COGS 101B,A01,091572,Allen; Michael Gordon,14,0,65,51
1657974617153,COGS 101C,A01,083625,Delgado; Tania,17,0,35,18
1657974623178,COGS 107A,A01,083627,Boyle; Mary E. T.,14,0,60,46
1657974629202,COGS 118A,A01,083075,Gupta; Anjum,21,0,76,55
1657974635236,CSE 3,A50,083646,Miranda; Gregory Joseph,24,0,50,26
1657974641261,CSE 8A,A50,083650,Miranda; Gregory Joseph,17,1,56,39
1657974647284,CSE 11,A01,083080,Cao; Yingjun,7,15,40,33
1657974653324,CSE 12,A01,083652,Krause-Levy; Sophia Louisa,30,1,120,90
1657974659349,CSE 15L,A01,083654,Morris; Justin Loren,9,0,50,41
1657974659349,CSE 15L,A02,083655,Morris; Justin Loren,11,0,50,39
1657974665378,CSE 20,A01,083657,Tran; Khoa Dang,39,0,80,41
1657974671404,CSE 21,A01,095574,Bach; Quang Tran,23,0,48,25
1657974677431,CSE 30,A01,083084,Eldon; John,8,0,80,72
1657974677431,CSE 30,B01,095061,Bhaskar; Nishant,9,0,50,41
1657974683464,CSE 100,A01,083659,Cao; Yingjun,5,4,70,65
1657974689489,CSE 134B,A01,083661,Powell; Thomas Allan,25,0,100,75
1657974695515,CSE 140,A01,083663,Gungor; Onat,17,0,85,68
1657974701543,CSE 140L,A01,083088,Eldon; John,23,0,100,77
1657974707575,CSE 175,A01,083665,Kumar; Rakesh,3,0,25,22
1657974713605,CSE 190,A00,092507,Dubnov; Shlomo,8,0,20,12
1657974719637,ECE 45,A01,083139,Congero; Spencer William,7,0,75,68
1657974725662,ECE 65,A50,083695,Saad; Andrew S,12,0,30,18
1657974725662,ECE 65,A51,095125,Saad; Andrew S,24,0,26,2
1657974731769,ECE 109,A01,091882,Touri; Behrouz,21,0,70,49
1657974737797,ECE 180,A00,083140,Abi Samra; Nicholas Camill,1,0,30,29
1657974737797,ECE 180,B00,083141,Abi Samra; Nicholas Camill,0,0,30,30
1657974743825,MATH 10A,A01,083735,Patchell; Gregory David,2,0,30,28
1657974743825,MATH 10A,A02,083736,Patchell; Gregory David,20,0,30,10
1657974743825,MATH 10A,A03,083737,Patchell; Gregory David,16,0,30,14
1657974749866,MATH 10B,A01,083207,Lim; Seonhee,9,0,34,25
1657974749866,MATH 10B,A02,083208,Lim; Seonhee,10,0,35,25
1657974749866,MATH 10B,A03,093472,Lim; Seonhee,7,0,34,27
1657974749866,MATH 10B,B01,083739,Sinha; Shubham,14,0,30,16
1657974755906,MATH 18,A01,083743,Cinel; Cameron Alexander,9,0,30,21
1657974755906,MATH 18,A02,083744,Cinel; Cameron Alexander,18,0,30,12
1657974755906,MATH 18,A03,083745,Cinel; Cameron Alexander,10,0,30,20
1657974755906,MATH 18,B01,083748,Rideout; David Porter,5,0,37,32
1657974755906,MATH 18,B02,083749,Rideout; David Porter,5,0,36,31
1657974755906,MATH 18,B03,083750,Rideout; David Porter,3,0,37,34
1657974755906,MATH 18,B04,083751,Rideout; David Porter,7,0,36,29
1657974755906,MATH 18,B05,093473,Rideout; David Porter,7,0,36,29
1657974755906,MATH 18,B06,093474,Rideout; David Porter,6,0,36,30
1657974761935,MATH 20A,A01,083754,Zheng; Zequn,14,0,40,26
1657974767970,MATH 20B,A01,083756,Briones; Jor-el Thomas Caparas,4,0,36,32
1657974767970,MATH 20B,A02,083757,Briones; Jor-el Thomas Caparas,1,0,36,35
1657974767970,MATH 20B,A03,093475,Briones; Jor-el Thomas Caparas,3,0,36,33
1657974773996,MATH 20C,A01,083760,Briones; Jor-el Thomas Caparas,1,0,35,34
1657974773996,MATH 20C,A02,083761,Briones; Jor-el Thomas Caparas,8,0,35,27
1657974773996,MATH 20C,A03,093476,Briones; Jor-el Thomas Caparas,0,1,36,36
1657974773996,MATH 20C,B01,083762,Bach; Quang Tran,1,0,30,29
1657974780024,MATH 20D,A01,083765,Tran; Brian Kha,5,0,30,25
1657974780024,MATH 20D,A02,083766,Tran; Brian Kha,5,0,30,25
1657974780024,MATH 20D,A03,083767,Tran; Brian Kha,6,0,30,24
1657974786058,MATH 20E,A01,083771,Ganguly; Soumya,12,0,32,20
1657974786058,MATH 20E,A02,083772,Ganguly; Soumya,7,0,32,25
1657974786058,MATH 20E,B01,083773,Ciotti; Benjamin,20,0,35,15
1657974786058,MATH 20E,B02,083774,Ciotti; Benjamin,18,0,35,17
1657974792097,MATH 103A,A01,083777,Greenfeld; Be'Eri,6,0,36,30
1657974792097,MATH 103A,A02,083778,Greenfeld; Be'Eri,5,0,36,31
1657974792097,MATH 103A,A03,093561,Greenfeld; Be'Eri,7,0,36,29
1657974792097,MATH 103A,B01,083779,Greenfeld; Be'Eri,8,0,36,28
1657974792097,MATH 103A,B02,083780,Greenfeld; Be'Eri,4,0,36,32
1657974792097,MATH 103A,B03,093562,Greenfeld; Be'Eri,3,0,36,33
1657974798122,MATH 105,A01,085443,Carter; Anne Toulson,15,0,35,20
1657974798122,MATH 105,A02,093477,Carter; Anne Toulson,20,0,35,15
1657974804156,MATH 109,A01,083213,Ganzberger; Geoffrey Michael,3,0,34,31
1657974804156,MATH 109,A02,083214,Ganzberger; Geoffrey Michael,4,0,34,30
1657974804156,MATH 109,A03,093478,Ganzberger; Geoffrey Michael,2,0,34,32
1657974804156,MATH 109,B01,083215,Ganzberger; Geoffrey Michael,3,0,32,29
1657974804156,MATH 109,B02,083216,Ganzberger; Geoffrey Michael,3,0,32,29
1657974804156,MATH 109,B03,093479,Ganzberger; Geoffrey Michael,8,0,32,24
1657974810184,MATH 142A,A01,083219,Chow; Bennett,7,0,32,25
1657974810184,MATH 142A,A02,083220,Chow; Bennett,10,0,32,22
1657974810184,MATH 142A,A03,093480,Chow; Bennett,9,0,32,23
1657974810184,MATH 142A,B03,093481,Chow; Bennett,8,0,32,24
1657974810184,MATH 142A,B04,093558,Chow; Bennett,14,0,32,18
1657974810184,MATH 142A,B05,093559,Chow; Bennett,7,0,32,25
1657974816217,MATH 193A,A01,083224,Rotar; Vladimir,9,0,34,25
1657974816217,MATH 193A,A02,083225,Rotar; Vladimir,11,0,34,23
1657974816217,MATH 193A,A03,083781,Rotar; Vladimir,5,0,34,29
1657974816217,MATH 193A,A04,083782,Rotar; Vladimir,12,0,34,22
1657974816217,MATH 193A,A05,093482,Rotar; Vladimir,11,0,34,23
1657974822250,MATH 197,001,091859,McAuley; Julian John,9999,0,9999,0
1657974822250,MATH 197,002,095566,Kedlaya; Kiran S.,9997,0,9999,2
1657974822250,MATH 197,003,095567,Xiao; Ming,9999,0,9999,0
1657974822250,MATH 197,004,095571,Perols; Johan Lars,9998,0,9999,1
1657974829337,COGS 9,A01,083615,Shannon; Kyle Michael,11,0,75,64
1657974835362,COGS 11,A01,083617,Boyle; Mary E. T.,23,0,48,25
1657974841396,COGS 13,A01,083071,Bastos; Amalia Pinkusfeld,12,0,71,59
1657974847420,COGS 14A,A01,092681,Semenuks; Arturs,5,1,100,95
1657974853452,COGS 14B,A01,083073,Cheng; Tzu-Han,7,0,63,56
1657974859475,COGS 17,A01,092677,Semenuks; Arturs,7,0,81,74
1657974865513,COGS 100,A01,083619,Allen; Michael Gordon,17,0,70,53
1657974871549,COGS 101A,A01,083621,Davis; Joshua Daniel,9,0,68,59
1657974877575,COGS 101B,A01,091572,Allen; Michael Gordon,14,0,65,51
1657974883603,COGS 101C,A01,083625,Delgado; Tania,17,0,35,18
1657974889630,COGS 107A,A01,083627,Boyle; Mary E. T.,14,0,60,46
1657974895664,COGS 118A,A01,083075,Gupta; Anjum,21,0,76,55
1657974901699,CSE 3,A50,083646,Miranda; Gregory Joseph,24,0,50,26
1657974907727,CSE 8A,A50,083650,Miranda; Gregory Joseph,17,1,56,39
1657974913756,CSE 11,A01,083080,Cao; Yingjun,7,15,40,33
1657974919786,CSE 12,A01,083652,Krause-Levy; Sophia Louisa,30,1,120,90
1657974925813,CSE 15L,A01,083654,Morris; Justin Loren,9,0,50,41
1657974925813,CSE 15L,A02,083655,Morris; Justin Loren,11,0,50,39
1657974931849,CSE 20,A01,083657,Tran; Khoa Dang,39,0,80,41
1657974937875,CSE 21,A01,095574,Bach; Quang Tran,23,0,48,25
1657974943908,CSE 30,A01,083084,Eldon; John,8,0,80,72
1657974943908,CSE 30,B01,095061,Bhaskar; Nishant,9,0,50,41
1657974949956,CSE 100,A01,083659,Cao; Yingjun,5,4,70,65
1657974955999,CSE 134B,A01,083661,Powell; Thomas Allan,25,0,100,75
1657974962025,CSE 140,A01,083663,Gungor; Onat,17,0,85,68
1657974968054,CSE 140L,A01,083088,Eldon; John,23,0,100,77
1657974974086,CSE 175,A01,083665,Kumar; Rakesh,3,0,25,22
1657974980113,CSE 190,A00,092507,Dubnov; Shlomo,8,0,20,12
1657974986146,ECE 45,A01,083139,Congero; Spencer William,7,0,75,68
1657974992178,ECE 65,A50,083695,Saad; Andrew S,12,0,30,18
1657974992178,ECE 65,A51,095125,Saad; Andrew S,24,0,26,2
1657974998203,ECE 109,A01,091882,Touri; Behrouz,21,0,70,49
1657975004233,ECE 180,A00,083140,Abi Samra; Nicholas Camill,1,0,30,29
1657975004233,ECE 180,B00,083141,Abi Samra; Nicholas Camill,0,0,30,30
1657975010262,MATH 10A,A01,083735,Patchell; Gregory David,2,0,30,28
1657975010262,MATH 10A,A02,083736,Patchell; Gregory David,20,0,30,10
1657975010262,MATH 10A,A03,083737,Patchell; Gregory David,16,0,30,14
1657975016290,MATH 10B,A01,083207,Lim; Seonhee,9,0,34,25
1657975016290,MATH 10B,A02,083208,Lim; Seonhee,10,0,35,25
1657975016290,MATH 10B,A03,093472,Lim; Seonhee,7,0,34,27
1657975016290,MATH 10B,B01,083739,Sinha; Shubham,14,0,30,16
1657975022320,MATH 18,A01,083743,Cinel; Cameron Alexander,9,0,30,21
1657975022320,MATH 18,A02,083744,Cinel; Cameron Alexander,18,0,30,12
1657975022320,MATH 18,A03,083745,Cinel; Cameron Alexander,10,0,30,20
1657975022320,MATH 18,B01,083748,Rideout; David Porter,5,0,37,32
1657975022320,MATH 18,B02,083749,Rideout; David Porter,5,0,36,31
1657975022320,MATH 18,B03,083750,Rideout; David Porter,3,0,37,34
1657975022320,MATH 18,B04,083751,Rideout; David Porter,7,0,36,29
1657975022320,MATH 18,B05,093473,Rideout; David Porter,7,0,36,29
1657975022320,MATH 18,B06,093474,Rideout; David Porter,6,0,36,30
1657975028345,MATH 20A,A01,083754,Zheng; Zequn,14,0,40,26
1657975034380,MATH 20B,A01,083756,Briones; Jor-el Thomas Caparas,4,0,36,32
1657975034380,MATH 20B,A02,083757,Briones; Jor-el Thomas Caparas,1,0,36,35
1657975034380,MATH 20B,A03,093475,Briones; Jor-el Thomas Caparas,3,0,36,33
1657975040411,MATH 20C,A01,083760,Briones; Jor-el Thomas Caparas,1,0,35,34
1657975040411,MATH 20C,A02,083761,Briones; Jor-el Thomas Caparas,8,0,35,27
1657975040411,MATH 20C,A03,093476,Briones; Jor-el Thomas Caparas,0,1,36,36
1657975040411,MATH 20C,B01,083762,Bach; Quang Tran,1,0,30,29
1657975046447,MATH 20D,A01,083765,Tran; Brian Kha,5,0,30,25
1657975046447,MATH 20D,A02,083766,Tran; Brian Kha,5,0,30,25
1657975046447,MATH 20D,A03,083767,Tran; Brian Kha,6,0,30,24
1657975052478,MATH 20E,A01,083771,Ganguly; Soumya,12,0,32,20
1657975052478,MATH 20E,A02,083772,Ganguly; Soumya,7,0,32,25
1657975052478,MATH 20E,B01,083773,Ciotti; Benjamin,20,0,35,15
1657975052478,MATH 20E,B02,083774,Ciotti; Benjamin,18,0,35,17
1657975058522,MATH 103A,A01,083777,Greenfeld; Be'Eri,6,0,36,30
1657975058522,MATH 103A,A02,083778,Greenfeld; Be'Eri,5,0,36,31
1657975058522,MATH 103A,A03,093561,Greenfeld; Be'Eri,7,0,36,29
1657975058522,MATH 103A,B01,083779,Greenfeld; Be'Eri,8,0,36,28
1657975058522,MATH 103A,B02,083780,Greenfeld; Be'Eri,4,0,36,32
1657975058522,MATH 103A,B03,093562,Greenfeld; Be'Eri,3,0,36,33
1657975064568,MATH 105,A01,085443,Carter; Anne Toulson,15,0,35,20
1657975064568,MATH 105,A02,093477,Carter; Anne Toulson,20,0,35,15
1657975070596,MATH 109,A01,083213,Ganzberger; Geoffrey Michael,3,0,34,31
1657975070596,MATH 109,A02,083214,Ganzberger; Geoffrey Michael,4,0,34,30
1657975070596,MATH 109,A03,093478,Ganzberger; Geoffrey Michael,2,0,34,32
1657975070596,MATH 109,B01,083215,Ganzberger; Geoffrey Michael,3,0,32,29
1657975070596,MATH 109,B02,083216,Ganzberger; Geoffrey Michael,3,0,32,29
1657975070596,MATH 109,B03,093479,Ganzberger; Geoffrey Michael,8,0,32,24
1657975076639,MATH 142A,A01,083219,Chow; Bennett,7,0,32,25
1657975076639,MATH 142A,A02,083220,Chow; Bennett,10,0,32,22
1657975076639,MATH 142A,A03,093480,Chow; Bennett,9,0,32,23
1657975076639,MATH 142A,B03,093481,Chow; Bennett,8,0,32,24
1657975076639,MATH 142A,B04,093558,Chow; Bennett,14,0,32,18
1657975076639,MATH 142A,B05,093559,Chow; Bennett,7,0,32,25
1657975082678,MATH 193A,A01,083224,Rotar; Vladimir,9,0,34,25
1657975082678,MATH 193A,A02,083225,Rotar; Vladimir,11,0,34,23
1657975082678,MATH 193A,A03,083781,Rotar; Vladimir,5,0,34,29
1657975082678,MATH 193A,A04,083782,Rotar; Vladimir,12,0,34,22
1657975082678,MATH 193A,A05,093482,Rotar; Vladimir,11,0,34,23
1657975088711,MATH 197,001,091859,McAuley; Julian John,9999,0,9999,0
1657975088711,MATH 197,002,095566,Kedlaya; Kiran S.,9997,0,9999,2
1657975088711,MATH 197,003,095567,Xiao; Ming,9999,0,9999,0
1657975088711,MATH 197,004,095571,Perols; Johan Lars,9998,0,9999,1
1657975095794,COGS 9,A01,083615,Shannon; Kyle Michael,11,0,75,64
1657975101820,COGS 11,A01,083617,Boyle; Mary E. T.,23,0,48,25
1657975107856,COGS 13,A01,083071,Bastos; Amalia Pinkusfeld,12,0,71,59
1657975113881,COGS 14A,A01,092681,Semenuks; Arturs,5,1,100,95
1657975119908,COGS 14B,A01,083073,Cheng; Tzu-Han,7,0,63,56
1657975125939,COGS 17,A01,092677,Semenuks; Arturs,7,0,81,74
1657975131975,COGS 100,A01,083619,Allen; Michael Gordon,17,0,70,53
1657975138000,COGS 101A,A01,083621,Davis; Joshua Daniel,9,0,68,59
1657975144028,COGS 101B,A01,091572,Allen; Michael Gordon,14,0,65,51
1657975150052,COGS 101C,A01,083625,Delgado; Tania,17,0,35,18
1657975156079,COGS 107A,A01,083627,Boyle; Mary E. T.,14,0,60,46
1657975162116,COGS 118A,A01,083075,Gupta; Anjum,21,0,76,55
1657975168149,CSE 3,A50,083646,Miranda; Gregory Joseph,24,0,50,26
1657975174177,CSE 8A,A50,083650,Miranda; Gregory Joseph,17,1,56,39
1657975180208,CSE 11,A01,083080,Cao; Yingjun,7,15,40,33
1657975186233,CSE 12,A01,083652,Krause-Levy; Sophia Louisa,30,1,120,90
1657975192264,CSE 15L,A01,083654,Morris; Justin Loren,9,0,50,41
1657975192264,CSE 15L,A02,083655,Morris; Justin Loren,11,0,50,39
1657975198287,CSE 20,A01,083657,Tran; Khoa Dang,39,0,80,41
1657975204309,CSE 21,A01,095574,Bach; Quang Tran,23,0,48,25
1657975210334,CSE 30,A01,083084,Eldon; John,8,0,80,72
1657975210334,CSE 30,B01,095061,Bhaskar; Nishant,9,0,50,41
1657975216369,CSE 100,A01,083659,Cao; Yingjun,5,4,70,65
1657975222400,CSE 134B,A01,083661,Powell; Thomas Allan,25,0,100,75
1657975228431,CSE 140,A01,083663,Gungor; Onat,17,0,85,68
1657975234459,CSE 140L,A01,083088,Eldon; John,23,0,100,77
1657975240491,CSE 175,A01,083665,Kumar; Rakesh,3,0,25,22
1657975246523,CSE 190,A00,092507,Dubnov; Shlomo,8,0,20,12
1657975252549,ECE 45,A01,083139,Congero; Spencer William,7,0,75,68
1657975258575,ECE 65,A50,083695,Saad; Andrew S,12,0,30,18
1657975258575,ECE 65,A51,095125,Saad; Andrew S,24,0,26,2
1657975264604,ECE 109,A01,091882,Touri; Behrouz,21,0,70,49
1657975270628,ECE 180,A00,083140,Abi Samra; Nicholas Camill,1,0,30,29
1657975270628,ECE 180,B00,083141,Abi Samra; Nicholas Camill,0,0,30,30
1657975276664,MATH 10A,A01,083735,Patchell; Gregory David,2,0,30,28
1657975276664,MATH 10A,A02,083736,Patchell; Gregory David,20,0,30,10
1657975276664,MATH 10A,A03,083737,Patchell; Gregory David,16,0,30,14
1657975282694,MATH 10B,A01,083207,Lim; Seonhee,9,0,34,25
1657975282694,MATH 10B,A02,083208,Lim; Seonhee,10,0,35,25
1657975282694,MATH 10B,A03,093472,Lim; Seonhee,7,0,34,27
1657975282694,MATH 10B,B01,083739,Sinha; Shubham,14,0,30,16
1657975288733,MATH 18,A01,083743,Cinel; Cameron Alexander,9,0,30,21
1657975288733,MATH 18,A02,083744,Cinel; Cameron Alexander,18,0,30,12
1657975288733,MATH 18,A03,083745,Cinel; Cameron Alexander,10,0,30,20
1657975288733,MATH 18,B01,083748,Rideout; David Porter,5,0,37,32
1657975288733,MATH 18,B02,083749,Rideout; David Porter,5,0,36,31
1657975288733,MATH 18,B03,083750,Rideout; David Porter,3,0,37,34
1657975288733,MATH 18,B04,083751,Rideout; David Porter,7,0,36,29
1657975288733,MATH 18,B05,093473,Rideout; David Porter,7,0,36,29
1657975288733,MATH 18,B06,093474,Rideout; David Porter,6,0,36,30
1657975294763,MATH 20A,A01,083754,Zheng; Zequn,14,0,40,26
1657975300790,MATH 20B,A01,083756,Briones; Jor-el Thomas Caparas,4,0,36,32
1657975300790,MATH 20B,A02,083757,Briones; Jor-el Thomas Caparas,1,0,36,35
1657975300790,MATH 20B,A03,093475,Briones; Jor-el Thomas Caparas,3,0,36,33
1657975306821,MATH 20C,A01,083760,Briones; Jor-el Thomas Caparas,1,0,35,34
1657975306821,MATH 20C,A02,083761,Briones; Jor-el Thomas Caparas,8,0,35,27
1657975306821,MATH 20C,A03,093476,Briones; Jor-el Thomas Caparas,0,1,36,36
1657975306821,MATH 20C,B01,083762,Bach; Quang Tran,1,0,30,29
1657975312850,MATH 20D,A01,083765,Tran; Brian Kha,5,0,30,25
1657975312850,MATH 20D,A02,083766,Tran; Brian Kha,5,0,30,25
1657975312850,MATH 20D,A03,083767,Tran; Brian Kha,6,0,30,24
1657975318877,MATH 20E,A01,083771,Ganguly; Soumya,12,0,32,20
1657975318877,MATH 20E,A02,083772,Ganguly; Soumya,7,0,32,25
1657975318877,MATH 20E,B01,083773,Ciotti; Benjamin,20,0,35,15
1657975318877,MATH 20E,B02,083774,Ciotti; Benjamin,18,0,35,17
1657975324910,MATH 103A,A01,083777,Greenfeld; Be'Eri,6,0,36,30
1657975324910,MATH 103A,A02,083778,Greenfeld; Be'Eri,5,0,36,31
1657975324910,MATH 103A,A03,093561,Greenfeld; Be'Eri,7,0,36,29
1657975324910,MATH 103A,B01,083779,Greenfeld; Be'Eri,8,0,36,28
1657975324910,MATH 103A,B02,083780,Greenfeld; Be'Eri,4,0,36,32
1657975324910,MATH 103A,B03,093562,Greenfeld; Be'Eri,3,0,36,33
1657975331014,MATH 105,A01,085443,Carter; Anne Toulson,15,0,35,20
1657975331014,MATH 105,A02,093477,Carter; Anne Toulson,20,0,35,15
1657975337039,MATH 109,A01,083213,Ganzberger; Geoffrey Michael,3,0,34,31
1657975337039,MATH 109,A02,083214,Ganzberger; Geoffrey Michael,4,0,34,30
1657975337039,MATH 109,A03,093478,Ganzberger; Geoffrey Michael,2,0,34,32
1657975337039,MATH 109,B01,083215,Ganzberger; Geoffrey Michael,3,0,32,29
1657975337039,MATH 109,B02,083216,Ganzberger; Geoffrey Michael,3,0,32,29
1657975337039,MATH 109,B03,093479,Ganzberger; Geoffrey Michael,8,0,32,24
1657975343062,MATH 142A,A01,083219,Chow; Bennett,7,0,32,25
1657975343062,MATH 142A,A02,083220,Chow; Bennett,10,0,32,22
1657975343062,MATH 142A,A03,093480,Chow; Bennett,9,0,32,23
1657975343062,MATH 142A,B03,093481,Chow; Bennett,8,0,32,24
1657975343062,MATH 142A,B04,093558,Chow; Bennett,14,0,32,18
1657975343062,MATH 142A,B05,093559,Chow; Bennett,7,0,32,25
1657975349094,MATH 193A,A01,083224,Rotar; Vladimir,9,0,34,25
1657975349094,MATH 193A,A02,083225,Rotar; Vladimir,11,0,34,23
1657975349094,MATH 193A,A03,083781,Rotar; Vladimir,5,0,34,29
1657975349094,MATH 193A,A04,083782,Rotar; Vladimir,12,0,34,22
1657975349094,MATH 193A,A05,093482,Rotar; Vladimir,11,0,34,23
1657975355122,MATH 197,001,091859,McAuley; Julian John,9999,0,9999,0
1657975355122,MATH 197,002,095566,Kedlaya; Kiran S.,9997,0,9999,2
1657975355122,MATH 197,003,095567,Xiao; Ming,9999,0,9999,0
1657975355122,MATH 197,004,095571,Perols; Johan Lars,9998,0,9999,1
1657975362214,COGS 9,A01,083615,Shannon; Kyle Michael,11,0,75,64
1657975368238,COGS 11,A01,083617,Boyle; Mary E. T.,23,0,48,25
1657975374263,COGS 13,A01,083071,Bastos; Amalia Pinkusfeld,12,0,71,59
1657975380288,COGS 14A,A01,092681,Semenuks; Arturs,5,1,100,95
1657975388023,COGS 14B,A01,083073,Cheng; Tzu-Han,7,0,63,56
1657975394046,COGS 17,A01,092677,Semenuks; Arturs,7,0,81,74
1657975400072,COGS 100,A01,083619,Allen; Michael Gordon,17,0,70,53
1657975406103,COGS 101A,A01,083621,Davis; Joshua Daniel,9,0,68,59
1657975412130,COGS 101B,A01,091572,Allen; Michael Gordon,14,0,65,51
1657975418159,COGS 101C,A01,083625,Delgado; Tania,17,0,35,18
1657975424187,COGS 107A,A01,083627,Boyle; Mary E. T.,14,0,60,46
1657975430211,COGS 118A,A01,083075,Gupta; Anjum,21,0,76,55
1657975436236,CSE 3,A50,083646,Miranda; Gregory Joseph,24,0,50,26
1657975442260,CSE 8A,A50,083650,Miranda; Gregory Joseph,17,1,56,39
1657975448288,CSE 11,A01,083080,Cao; Yingjun,7,15,40,33
1657975454313,CSE 12,A01,083652,Krause-Levy; Sophia Louisa,30,1,120,90
1657975460336,CSE 15L,A01,083654,Morris; Justin Loren,9,0,50,41
1657975460336,CSE 15L,A02,083655,Morris; Justin Loren,11,0,50,39
1657975466365,CSE 20,A01,083657,Tran; Khoa Dang,39,0,80,41
1657975472396,CSE 21,A01,095574,Bach; Quang Tran,23,0,48,25
1657975478428,CSE 30,A01,083084,Eldon; John,8,0,80,72
1657975478428,CSE 30,B01,095061,Bhaskar; Nishant,9,0,50,41
1657975484457,CSE 100,A01,083659,Cao; Yingjun,5,4,70,65
1657975490486,CSE 134B,A01,083661,Powell; Thomas Allan,25,0,100,75
1657975496510,CSE 140,A01,083663,Gungor; Onat,17,0,85,68
1657975502536,CSE 140L,A01,083088,Eldon; John,23,0,100,77
1657975508562,CSE 175,A01,083665,Kumar; Rakesh,3,0,25,22
1657975514592,CSE 190,A00,092507,Dubnov; Shlomo,8,0,20,12
1657975520619,ECE 45,A01,083139,Congero; Spencer William,7,0,75,68
1657975526643,ECE 65,A50,083695,Saad; Andrew S,12,0,30,18
1657975526643,ECE 65,A51,095125,Saad; Andrew S,24,0,26,2
1657975532673,ECE 109,A01,091882,Touri; Behrouz,21,0,70,49
1657975538705,ECE 180,A00,083140,Abi Samra; Nicholas Camill,1,0,30,29
1657975538705,ECE 180,B00,083141,Abi Samra; Nicholas Camill,0,0,30,30
1657975544739,MATH 10A,A01,083735,Patchell; Gregory David,2,0,30,28
1657975544739,MATH 10A,A02,083736,Patchell; Gregory David,20,0,30,10
1657975544739,MATH 10A,A03,083737,Patchell; Gregory David,16,0,30,14
1657975550769,MATH 10B,A01,083207,Lim; Seonhee,9,0,34,25
1657975550769,MATH 10B,A02,083208,Lim; Seonhee,10,0,35,25
1657975550769,MATH 10B,A03,093472,Lim; Seonhee,7,0,34,27
1657975550769,MATH 10B,B01,083739,Sinha; Shubham,14,0,30,16
1657975556796,MATH 18,A01,083743,Cinel; Cameron Alexander,9,0,30,21
1657975556796,MATH 18,A02,083744,Cinel; Cameron Alexander,18,0,30,12
1657975556796,MATH 18,A03,083745,Cinel; Cameron Alexander,10,0,30,20
1657975556796,MATH 18,B01,083748,Rideout; David Porter,5,0,37,32
1657975556796,MATH 18,B02,083749,Rideout; David Porter,5,0,36,31
1657975556796,MATH 18,B03,083750,Rideout; David Porter,3,0,37,34
1657975556796,MATH 18,B04,083751,Rideout; David Porter,7,0,36,29
1657975556796,MATH 18,B05,093473,Rideout; David Porter,7,0,36,29
1657975556796,MATH 18,B06,093474,Rideout; David Porter,6,0,36,30
1657975562826,MATH 20A,A01,083754,Zheng; Zequn,14,0,40,26
1657975568852,MATH 20B,A01,083756,Briones; Jor-el Thomas Caparas,4,0,36,32
1657975568852,MATH 20B,A02,083757,Briones; Jor-el Thomas Caparas,1,0,36,35
1657975568852,MATH 20B,A03,093475,Briones; Jor-el Thomas Caparas,3,0,36,33
1657975574886,MATH 20C,A01,083760,Briones; Jor-el Thomas Caparas,1,0,35,34
1657975574886,MATH 20C,A02,083761,Briones; Jor-el Thomas Caparas,8,0,35,27
1657975574886,MATH 20C,A03,093476,Briones; Jor-el Thomas Caparas,0,1,36,36
1657975574886,MATH 20C,B01,083762,Bach; Quang Tran,1,0,30,29
1657975580917,MATH 20D,A01,083765,Tran; Brian Kha,5,0,30,25
1657975580917,MATH 20D,A02,083766,Tran; Brian Kha,5,0,30,25
1657975580917,MATH 20D,A03,083767,Tran; Brian Kha,6,0,30,24
1657975586946,MATH 20E,A01,083771,Ganguly; Soumya,12,0,32,20
1657975586946,MATH 20E,A02,083772,Ganguly; Soumya,7,0,32,25
1657975586946,MATH 20E,B01,083773,Ciotti; Benjamin,20,0,35,15
1657975586946,MATH 20E,B02,083774,Ciotti; Benjamin,18,0,35,17
1657975592975,MATH 103A,A01,083777,Greenfeld; Be'Eri,6,0,36,30
1657975592975,MATH 103A,A02,083778,Greenfeld; Be'Eri,5,0,36,31
1657975592975,MATH 103A,A03,093561,Greenfeld; Be'Eri,7,0,36,29
1657975592975,MATH 103A,B01,083779,Greenfeld; Be'Eri,8,0,36,28
1657975592975,MATH 103A,B02,083780,Greenfeld; Be'Eri,4,0,36,32
1657975592975,MATH 103A,B03,093562,Greenfeld; Be'Eri,3,0,36,33
1657975599013,MATH 105,A01,085443,Carter; Anne Toulson,15,0,35,20
1657975599013,MATH 105,A02,093477,Carter; Anne Toulson,20,0,35,15
1657975605039,MATH 109,A01,083213,Ganzberger; Geoffrey Michael,3,0,34,31
1657975605039,MATH 109,A02,083214,Ganzberger; Geoffrey Michael,4,0,34,30
1657975605039,MATH 109,A03,093478,Ganzberger; Geoffrey Michael,2,0,34,32
1657975605039,MATH 109,B01,083215,Ganzberger; Geoffrey Michael,3,0,32,29
1657975605039,MATH 109,B02,083216,Ganzberger; Geoffrey Michael,3,0,32,29
1657975605039,MATH 109,B03,093479,Ganzberger; Geoffrey Michael,8,0,32,24
1657975611073,MATH 142A,A01,083219,Chow; Bennett,7,0,32,25
1657975611073,MATH 142A,A02,083220,Chow; Bennett,10,0,32,22
1657975611073,MATH 142A,A03,093480,Chow; Bennett,9,0,32,23
1657975611073,MATH 142A,B03,093481,Chow; Bennett,8,0,32,24
1657975611073,MATH 142A,B04,093558,Chow; Bennett,14,0,32,18
1657975611073,MATH 142A,B05,093559,Chow; Bennett,7,0,32,25
1657975617107,MATH 193A,A01,083224,Rotar; Vladimir,9,0,34,25
1657975617107,MATH 193A,A02,083225,Rotar; Vladimir,11,0,34,23
1657975617107,MATH 193A,A03,083781,Rotar; Vladimir,5,0,34,29
1657975617107,MATH 193A,A04,083782,Rotar; Vladimir,12,0,34,22
1657975617107,MATH 193A,A05,093482,Rotar; Vladimir,11,0,34,23
1657975623133,MATH 197,001,091859,McAuley; Julian John,9999,0,9999,0
1657975623133,MATH 197,002,095566,Kedlaya; Kiran S.,9997,0,9999,2
1657975623133,MATH 197,003,095567,Xiao; Ming,9999,0,9999,0
1657975623133,MATH 197,004,095571,Perols; Johan Lars,9998,0,9999,1
1657975630199,COGS 9,A01,083615,Shannon; Kyle Michael,11,0,75,64
1657975636228,COGS 11,A01,083617,Boyle; Mary E. T.,23,0,48,25
1657975642253,COGS 13,A01,083071,Bastos; Amalia Pinkusfeld,12,0,71,59
1657975648283,COGS 14A,A01,092681,Semenuks; Arturs,5,1,100,95
1657975654311,COGS 14B,A01,083073,Cheng; Tzu-Han,7,0,63,56
1657975660336,COGS 17,A01,092677,Semenuks; Arturs,7,0,81,74
1657975666360,COGS 100,A01,083619,Allen; Michael Gordon,17,0,70,53
1657975672392,COGS 101A,A01,083621,Davis; Joshua Daniel,9,0,68,59
1657975678421,COGS 101B,A01,091572,Allen; Michael Gordon,14,0,65,51
1657975684447,COGS 101C,A01,083625,Delgado; Tania,17,0,35,18
1657975690476,COGS 107A,A01,083627,Boyle; Mary E. T.,14,0,60,46
1657975696501,COGS 118A,A01,083075,Gupta; Anjum,21,0,76,55
1657975702533,CSE 3,A50,083646,Miranda; Gregory Joseph,24,0,50,26
1657975708560,CSE 8A,A50,083650,Miranda; Gregory Joseph,17,1,56,39
1657975714589,CSE 11,A01,083080,Cao; Yingjun,7,15,40,33
1657975720619,CSE 12,A01,083652,Krause-Levy; Sophia Louisa,30,1,120,90
1657975726644,CSE 15L,A01,083654,Morris; Justin Loren,9,0,50,41
1657975726644,CSE 15L,A02,083655,Morris; Justin Loren,11,0,50,39
1657975732668,CSE 20,A01,083657,Tran; Khoa Dang,39,0,80,41
1657975738697,CSE 21,A01,095574,Bach; Quang Tran,23,0,48,25
1657975744722,CSE 30,A01,083084,Eldon; John,8,0,80,72
1657975744722,CSE 30,B01,095061,Bhaskar; Nishant,9,0,50,41
1657975750752,CSE 100,A01,083659,Cao; Yingjun,5,4,70,65
1657975756780,CSE 134B,A01,083661,Powell; Thomas Allan,25,0,100,75
1657975762805,CSE 140,A01,083663,Gungor; Onat,17,0,85,68
1657975768828,CSE 140L,A01,083088,Eldon; John,23,0,100,77
1657975774852,CSE 175,A01,083665,Kumar; Rakesh,3,0,25,22
1657975780883,CSE 190,A00,092507,Dubnov; Shlomo,8,0,20,12
1657975786910,ECE 45,A01,083139,Congero; Spencer William,7,0,75,68
1657975792947,ECE 65,A50,083695,Saad; Andrew S,12,0,30,18
1657975792947,ECE 65,A51,095125,Saad; Andrew S,24,0,26,2
1657975798974,ECE 109,A01,091882,Touri; Behrouz,21,0,70,49
1657975805005,ECE 180,A00,083140,Abi Samra; Nicholas Camill,1,0,30,29
1657975805005,ECE 180,B00,083141,Abi Samra; Nicholas Camill,0,0,30,30
1657975811041,MATH 10A,A01,083735,Patchell; Gregory David,2,0,30,28
1657975811041,MATH 10A,A02,083736,Patchell; Gregory David,20,0,30,10
1657975811041,MATH 10A,A03,083737,Patchell; Gregory David,16,0,30,14
1657975817074,MATH 10B,A01,083207,Lim; Seonhee,9,0,34,25
1657975817074,MATH 10B,A02,083208,Lim; Seonhee,10,0,35,25
1657975817074,MATH 10B,A03,093472,Lim; Seonhee,7,0,34,27
1657975817074,MATH 10B,B01,083739,Sinha; Shubham,14,0,30,16
1657975823111,MATH 18,A01,083743,Cinel; Cameron Alexander,9,0,30,21
1657975823111,MATH 18,A02,083744,Cinel; Cameron Alexander,18,0,30,12
1657975823111,MATH 18,A03,083745,Cinel; Cameron Alexander,10,0,30,20
1657975823111,MATH 18,B01,083748,Rideout; David Porter,5,0,37,32
1657975823111,MATH 18,B02,083749,Rideout; David Porter,5,0,36,31
1657975823111,MATH 18,B03,083750,Rideout; David Porter,3,0,37,34
1657975823111,MATH 18,B04,083751,Rideout; David Porter,7,0,36,29
1657975823111,MATH 18,B05,093473,Rideout; David Porter,7,0,36,29
1657975823111,MATH 18,B06,093474,Rideout; David Porter,6,0,36,30
1657975829137,MATH 20A,A01,083754,Zheng; Zequn,14,0,40,26
1657975835164,MATH 20B,A01,083756,Briones; Jor-el Thomas Caparas,4,0,36,32
1657975835164,MATH 20B,A02,083757,Briones; Jor-el Thomas Caparas,1,0,36,35
1657975835164,MATH 20B,A03,093475,Briones; Jor-el Thomas Caparas,3,0,36,33
1657975841208,MATH 20C,A01,083760,Briones; Jor-el Thomas Caparas,1,0,35,34
1657975841208,MATH 20C,A02,083761,Briones; Jor-el Thomas Caparas,8,0,35,27
1657975841208,MATH 20C,A03,093476,Briones; Jor-el Thomas Caparas,0,1,36,36
1657975841208,MATH 20C,B01,083762,Bach; Quang Tran,1,0,30,29
1657975847233,MATH 20D,A01,083765,Tran; Brian Kha,5,0,30,25
1657975847233,MATH 20D,A02,083766,Tran; Brian Kha,5,0,30,25
1657975847233,MATH 20D,A03,083767,Tran; Brian Kha,6,0,30,24
1657975853279,MATH 20E,A01,083771,Ganguly; Soumya,12,0,32,20
1657975853279,MATH 20E,A02,083772,Ganguly; Soumya,7,0,32,25
1657975853279,MATH 20E,B01,083773,Ciotti; Benjamin,20,0,35,15
1657975853279,MATH 20E,B02,083774,Ciotti; Benjamin,18,0,35,17
1657975859316,MATH 103A,A01,083777,Greenfeld; Be'Eri,6,0,36,30
1657975859316,MATH 103A,A02,083778,Greenfeld; Be'Eri,5,0,36,31
1657975859316,MATH 103A,A03,093561,Greenfeld; Be'Eri,7,0,36,29
1657975859316,MATH 103A,B01,083779,Greenfeld; Be'Eri,8,0,36,28
1657975859316,MATH 103A,B02,083780,Greenfeld; Be'Eri,4,0,36,32
1657975859316,MATH 103A,B03,093562,Greenfeld; Be'Eri,3,0,36,33
1657975865342,MATH 105,A01,085443,Carter; Anne Toulson,15,0,35,20
1657975865342,MATH 105,A02,093477,Carter; Anne Toulson,20,0,35,15
1657975871372,MATH 109,A01,083213,Ganzberger; Geoffrey Michael,3,0,34,31
1657975871372,MATH 109,A02,083214,Ganzberger; Geoffrey Michael,4,0,34,30
1657975871372,MATH 109,A03,093478,Ganzberger; Geoffrey Michael,2,0,34,32
1657975871372,MATH 109,B01,083215,Ganzberger; Geoffrey Michael,3,0,32,29
1657975871372,MATH 109,B02,083216,Ganzberger; Geoffrey Michael,3,0,32,29
1657975871372,MATH 109,B03,093479,Ganzberger; Geoffrey Michael,8,0,32,24
1657975877397,MATH 142A,A01,083219,Chow; Bennett,7,0,32,25
1657975877397,MATH 142A,A02,083220,Chow; Bennett,10,0,32,22
1657975877397,MATH 142A,A03,093480,Chow; Bennett,9,0,32,23
1657975877397,MATH 142A,B03,093481,Chow; Bennett,8,0,32,24
1657975877397,MATH 142A,B04,093558,Chow; Bennett,14,0,32,18
1657975877397,MATH 142A,B05,093559,Chow; Bennett,7,0,32,25
1657975883430,MATH 193A,A01,083224,Rotar; Vladimir,9,0,34,25
1657975883430,MATH 193A,A02,083225,Rotar; Vladimir,11,0,34,23
1657975883430,MATH 193A,A03,083781,Rotar; Vladimir,5,0,34,29
1657975883430,MATH 193A,A04,083782,Rotar; Vladimir,12,0,34,22
1657975883430,MATH 193A,A05,093482,Rotar; Vladimir,11,0,34,23
1657975889457,MATH 197,001,091859,McAuley; Julian John,9999,0,9999,0
1657975889457,MATH 197,002,095566,Kedlaya; Kiran S.,9997,0,9999,2
1657975889457,MATH 197,003,095567,Xiao; Ming,9999,0,9999,0
1657975889457,MATH 197,004,095571,Perols; Johan Lars,9998,0,9999,1
1657975896538,COGS 9,A01,083615,Shannon; Kyle Michael,11,0,75,64
1657975902565,COGS 11,A01,083617,Boyle; Mary E. T.,23,0,48,25
1657975908595,COGS 13,A01,083071,Bastos; Amalia Pinkusfeld,12,0,71,59
1657975914621,COGS 14A,A01,092681,Semenuks; Arturs,5,1,100,95
1657975920652,COGS 14B,A01,083073,Cheng; Tzu-Han,7,0,63,56
1657975926761,COGS 17,A01,092677,Semenuks; Arturs,7,0,81,74
1657975932793,COGS 100,A01,083619,Allen; Michael Gordon,17,0,70,53
1657975938822,COGS 101A,A01,083621,Davis; Joshua Daniel,9,0,68,59
1657975944847,COGS 101B,A01,091572,Allen; Michael Gordon,14,0,65,51
1657975950879,COGS 101C,A01,083625,Delgado; Tania,17,0,35,18
1657975956903,COGS 107A,A01,083627,Boyle; Mary E. T.,14,0,60,46
1657975962936,COGS 118A,A01,083075,Gupta; Anjum,21,0,76,55
1657975968976,CSE 3,A50,083646,Miranda; Gregory Joseph,24,0,50,26
1657975974999,CSE 8A,A50,083650,Miranda; Gregory Joseph,17,1,56,39
1657975981026,CSE 11,A01,083080,Cao; Yingjun,7,15,40,33
1657975987056,CSE 12,A01,083652,Krause-Levy; Sophia Louisa,30,1,120,90
1657975993087,CSE 15L,A01,083654,Morris; Justin Loren,9,0,50,41
1657975993087,CSE 15L,A02,083655,Morris; Justin Loren,11,0,50,39
1657975999112,CSE 20,A01,083657,Tran; Khoa Dang,39,0,80,41
1657976005137,CSE 21,A01,095574,Bach; Quang Tran,23,0,48,25
1657976011162,CSE 30,A01,083084,Eldon; John,8,0,80,72
1657976011162,CSE 30,B01,095061,Bhaskar; Nishant,9,0,50,41
1657976017202,CSE 100,A01,083659,Cao; Yingjun,5,4,70,65
1657976023240,CSE 134B,A01,083661,Powell; Thomas Allan,25,0,100,75
1657976029266,CSE 140,A01,083663,Gungor; Onat,17,0,85,68
1657976035290,CSE 140L,A01,083088,Eldon; John,23,0,100,77
1657976041320,CSE 175,A01,083665,Kumar; Rakesh,3,0,25,22
1657976047364,CSE 190,A00,092507,Dubnov; Shlomo,8,0,20,12
1657976053405,ECE 45,A01,083139,Congero; Spencer William,7,0,75,68
1657976059439,ECE 65,A50,083695,Saad; Andrew S,12,0,30,18
1657976059439,ECE 65,A51,095125,Saad; Andrew S,24,0,26,2
1657976065473,ECE 109,A01,091882,Touri; Behrouz,21,0,70,49
1657976071497,ECE 180,A00,083140,Abi Samra; Nicholas Camill,1,0,30,29
1657976071497,ECE 180,B00,083141,Abi Samra; Nicholas Camill,0,0,30,30
1657976077532,MATH 10A,A01,083735,Patchell; Gregory David,2,0,30,28
1657976077532,MATH 10A,A02,083736,Patchell; Gregory David,20,0,30,10
1657976077532,MATH 10A,A03,083737,Patchell; Gregory David,16,0,30,14
1657976083561,MATH 10B,A01,083207,Lim; Seonhee,9,0,34,25
1657976083561,MATH 10B,A02,083208,Lim; Seonhee,10,0,35,25
1657976083561,MATH 10B,A03,093472,Lim; Seonhee,7,0,34,27
1657976083561,MATH 10B,B01,083739,Sinha; Shubham,14,0,30,16
1657976089599,MATH 18,A01,083743,Cinel; Cameron Alexander,9,0,30,21
1657976089599,MATH 18,A02,083744,Cinel; Cameron Alexander,18,0,30,12
1657976089599,MATH 18,A03,083745,Cinel; Cameron Alexander,10,0,30,20
1657976089599,MATH 18,B01,083748,Rideout; David Porter,5,0,37,32
1657976089599,MATH 18,B02,083749,Rideout; David Porter,5,0,36,31
1657976089599,MATH 18,B03,083750,Rideout; David Porter,3,0,37,34
1657976089599,MATH 18,B04,083751,Rideout; David Porter,7,0,36,29
1657976089599,MATH 18,B05,093473,Rideout; David Porter,7,0,36,29
1657976089599,MATH 18,B06,093474,Rideout; David Porter,6,0,36,30
1657976095624,MATH 20A,A01,083754,Zheng; Zequn,14,0,40,26
1657976101650,MATH 20B,A01,083756,Briones; Jor-el Thomas Caparas,4,0,36,32
1657976101650,MATH 20B,A02,083757,Briones; Jor-el Thomas Caparas,1,0,36,35
1657976101650,MATH 20B,A03,093475,Briones; Jor-el Thomas Caparas,3,0,36,33
1657976107689,MATH 20C,A01,083760,Briones; Jor-el Thomas Caparas,1,0,35,34
1657976107689,MATH 20C,A02,083761,Briones; Jor-el Thomas Caparas,8,0,35,27
1657976107689,MATH 20C,A03,093476,Briones; Jor-el Thomas Caparas,0,1,36,36
1657976107689,MATH 20C,B01,083762,Bach; Quang Tran,1,0,30,29
1657976113716,MATH 20D,A01,083765,Tran; Brian Kha,5,0,30,25
1657976113716,MATH 20D,A02,083766,Tran; Brian Kha,5,0,30,25
1657976113716,MATH 20D,A03,083767,Tran; Brian Kha,6,0,30,24
1657976119742,MATH 20E,A01,083771,Ganguly; Soumya,12,0,32,20
1657976119742,MATH 20E,A02,083772,Ganguly; Soumya,7,0,32,25
1657976119742,MATH 20E,B01,083773,Ciotti; Benjamin,20,0,35,15
1657976119742,MATH 20E,B02,083774,Ciotti; Benjamin,18,0,35,17
1657976125779,MATH 103A,A01,083777,Greenfeld; Be'Eri,6,0,36,30
1657976125779,MATH 103A,A02,083778,Greenfeld; Be'Eri,5,0,36,31
1657976125779,MATH 103A,A03,093561,Greenfeld; Be'Eri,7,0,36,29
1657976125779,MATH 103A,B01,083779,Greenfeld; Be'Eri,8,0,36,28
1657976125779,MATH 103A,B02,083780,Greenfeld; Be'Eri,4,0,36,32
1657976125779,MATH 103A,B03,093562,Greenfeld; Be'Eri,3,0,36,33
1657976131804,MATH 105,A01,085443,Carter; Anne Toulson,15,0,35,20
1657976131804,MATH 105,A02,093477,Carter; Anne Toulson,20,0,35,15
1657976137845,MATH 109,A01,083213,Ganzberger; Geoffrey Michael,3,0,34,31
1657976137845,MATH 109,A02,083214,Ganzberger; Geoffrey Michael,4,0,34,30
1657976137845,MATH 109,A03,093478,Ganzberger; Geoffrey Michael,2,0,34,32
1657976137845,MATH 109,B01,083215,Ganzberger; Geoffrey Michael,3,0,32,29
1657976137845,MATH 109,B02,083216,Ganzberger; Geoffrey Michael,3,0,32,29
1657976137845,MATH 109,B03,093479,Ganzberger; Geoffrey Michael,8,0,32,24
1657976143870,MATH 142A,A01,083219,Chow; Bennett,7,0,32,25
1657976143870,MATH 142A,A02,083220,Chow; Bennett,10,0,32,22
1657976143870,MATH 142A,A03,093480,Chow; Bennett,9,0,32,23
1657976143870,MATH 142A,B03,093481,Chow; Bennett,8,0,32,24
1657976143870,MATH 142A,B04,093558,Chow; Bennett,14,0,32,18
1657976143870,MATH 142A,B05,093559,Chow; Bennett,7,0,32,25
1657976149896,MATH 193A,A01,083224,Rotar; Vladimir,9,0,34,25
1657976149896,MATH 193A,A02,083225,Rotar; Vladimir,11,0,34,23
1657976149896,MATH 193A,A03,083781,Rotar; Vladimir,5,0,34,29
1657976149896,MATH 193A,A04,083782,Rotar; Vladimir,12,0,34,22
1657976149896,MATH 193A,A05,093482,Rotar; Vladimir,11,0,34,23
1657976155935,MATH 197,001,091859,McAuley; Julian John,9999,0,9999,0
1657976155935,MATH 197,002,095566,Kedlaya; Kiran S.,9997,0,9999,2
1657976155935,MATH 197,003,095567,Xiao; Ming,9999,0,9999,0
1657976155935,MATH 197,004,095571,Perols; Johan Lars,9998,0,9999,1
1657976163025,COGS 9,A01,083615,Shannon; Kyle Michael,11,0,75,64
1657976169048,COGS 11,A01,083617,Boyle; Mary E. T.,23,0,48,25
1657976175075,COGS 13,A01,083071,Bastos; Amalia Pinkusfeld,12,0,71,59
1657976181102,COGS 14A,A01,092681,Semenuks; Arturs,5,1,100,95
1657976187129,COGS 14B,A01,083073,Cheng; Tzu-Han,7,0,63,56
1657976193153,COGS 17,A01,092677,Semenuks; Arturs,7,0,81,74
1657976199177,COGS 100,A01,083619,Allen; Michael Gordon,17,0,70,53
1657976205202,COGS 101A,A01,083621,Davis; Joshua Daniel,9,0,68,59
1657976211230,COGS 101B,A01,091572,Allen; Michael Gordon,14,0,65,51
1657976217261,COGS 101C,A01,083625,Delgado; Tania,17,0,35,18
1657976223288,COGS 107A,A01,083627,Boyle; Mary E. T.,14,0,60,46
1657976229318,COGS 118A,A01,083075,Gupta; Anjum,21,0,76,55
1657976235349,CSE 3,A50,083646,Miranda; Gregory Joseph,24,0,50,26
1657976241380,CSE 8A,A50,083650,Miranda; Gregory Joseph,17,1,56,39
1657976247408,CSE 11,A01,083080,Cao; Yingjun,7,15,40,33
1657976253435,CSE 12,A01,083652,Krause-Levy; Sophia Louisa,30,1,120,90
1657976259467,CSE 15L,A01,083654,Morris; Justin Loren,9,0,50,41
1657976259467,CSE 15L,A02,083655,Morris; Justin Loren,11,0,50,39
1657976265490,CSE 20,A01,083657,Tran; Khoa Dang,39,0,80,41
1657976271515,CSE 21,A01,095574,Bach; Quang Tran,23,0,48,25
1657976277543,CSE 30,A01,083084,Eldon; John,8,0,80,72
1657976277543,CSE 30,B01,095061,Bhaskar; Nishant,9,0,50,41
1657976283568,CSE 100,A01,083659,Cao; Yingjun,5,4,70,65
1657976289595,CSE 134B,A01,083661,Powell; Thomas Allan,25,0,100,75
1657976295622,CSE 140,A01,083663,Gungor; Onat,17,0,85,68
1657976301646,CSE 140L,A01,083088,Eldon; John,23,0,100,77
1657976307676,CSE 175,A01,083665,Kumar; Rakesh,3,0,25,22
1657976313703,CSE 190,A00,092507,Dubnov; Shlomo,8,0,20,12
1657976319730,ECE 45,A01,083139,Congero; Spencer William,7,0,75,68
1657976325757,ECE 65,A50,083695,Saad; Andrew S,12,0,30,18
1657976325757,ECE 65,A51,095125,Saad; Andrew S,24,0,26,2
1657976331783,ECE 109,A01,091882,Touri; Behrouz,21,0,70,49
1657976337811,ECE 180,A00,083140,Abi Samra; Nicholas Camill,1,0,30,29
1657976337811,ECE 180,B00,083141,Abi Samra; Nicholas Camill,0,0,30,30
1657976343846,MATH 10A,A01,083735,Patchell; Gregory David,2,0,30,28
1657976343846,MATH 10A,A02,083736,Patchell; Gregory David,20,0,30,10
1657976343846,MATH 10A,A03,083737,Patchell; Gregory David,16,0,30,14
1657976349878,MATH 10B,A01,083207,Lim; Seonhee,9,0,34,25
1657976349878,MATH 10B,A02,083208,Lim; Seonhee,10,0,35,25
1657976349878,MATH 10B,A03,093472,Lim; Seonhee,7,0,34,27
1657976349878,MATH 10B,B01,083739,Sinha; Shubham,14,0,30,16
1657976355917,MATH 18,A01,083743,Cinel; Cameron Alexander,9,0,30,21
1657976355917,MATH 18,A02,083744,Cinel; Cameron Alexander,18,0,30,12
1657976355917,MATH 18,A03,083745,Cinel; Cameron Alexander,10,0,30,20
1657976355917,MATH 18,B01,083748,Rideout; David Porter,5,0,37,32
1657976355917,MATH 18,B02,083749,Rideout; David Porter,5,0,36,31
1657976355917,MATH 18,B03,083750,Rideout; David Porter,3,0,37,34
1657976355917,MATH 18,B04,083751,Rideout; David Porter,7,0,36,29
1657976355917,MATH 18,B05,093473,Rideout; David Porter,7,0,36,29
1657976355917,MATH 18,B06,093474,Rideout; David Porter,6,0,36,30
1657976361945,MATH 20A,A01,083754,Zheng; Zequn,14,0,40,26
1657976367980,MATH 20B,A01,083756,Briones; Jor-el Thomas Caparas,4,0,36,32
1657976367980,MATH 20B,A02,083757,Briones; Jor-el Thomas Caparas,1,0,36,35
1657976367980,MATH 20B,A03,093475,Briones; Jor-el Thomas Caparas,3,0,36,33
1657976374006,MATH 20C,A01,083760,Briones; Jor-el Thomas Caparas,1,0,35,34
1657976374006,MATH 20C,A02,083761,Briones; Jor-el Thomas Caparas,8,0,35,27
1657976374006,MATH 20C,A03,093476,Briones; Jor-el Thomas Caparas,0,1,36,36
1657976374006,MATH 20C,B01,083762,Bach; Quang Tran,1,0,30,29
1657976380037,MATH 20D,A01,083765,Tran; Brian Kha,5,0,30,25
1657976380037,MATH 20D,A02,083766,Tran; Brian Kha,5,0,30,25
1657976380037,MATH 20D,A03,083767,Tran; Brian Kha,6,0,30,24
1657976386069,MATH 20E,A01,083771,Ganguly; Soumya,12,0,32,20
1657976386069,MATH 20E,A02,083772,Ganguly; Soumya,7,0,32,25
1657976386069,MATH 20E,B01,083773,Ciotti; Benjamin,20,0,35,15
1657976386069,MATH 20E,B02,083774,Ciotti; Benjamin,18,0,35,17
1657976392105,MATH 103A,A01,083777,Greenfeld; Be'Eri,6,0,36,30
1657976392105,MATH 103A,A02,083778,Greenfeld; Be'Eri,5,0,36,31
1657976392105,MATH 103A,A03,093561,Greenfeld; Be'Eri,7,0,36,29
1657976392105,MATH 103A,B01,083779,Greenfeld; Be'Eri,8,0,36,28
1657976392105,MATH 103A,B02,083780,Greenfeld; Be'Eri,4,0,36,32
1657976392105,MATH 103A,B03,093562,Greenfeld; Be'Eri,3,0,36,33
1657976398138,MATH 105,A01,085443,Carter; Anne Toulson,15,0,35,20
1657976398138,MATH 105,A02,093477,Carter; Anne Toulson,20,0,35,15
1657976404169,MATH 109,A01,083213,Ganzberger; Geoffrey Michael,3,0,34,31
1657976404169,MATH 109,A02,083214,Ganzberger; Geoffrey Michael,4,0,34,30
1657976404169,MATH 109,A03,093478,Ganzberger; Geoffrey Michael,2,0,34,32
1657976404169,MATH 109,B01,083215,Ganzberger; Geoffrey Michael,3,0,32,29
1657976404169,MATH 109,B02,083216,Ganzberger; Geoffrey Michael,3,0,32,29
1657976404169,MATH 109,B03,093479,Ganzberger; Geoffrey Michael,8,0,32,24
1657976410195,MATH 142A,A01,083219,Chow; Bennett,7,0,32,25
1657976410195,MATH 142A,A02,083220,Chow; Bennett,10,0,32,22
1657976410195,MATH 142A,A03,093480,Chow; Bennett,9,0,32,23
1657976410195,MATH 142A,B03,093481,Chow; Bennett,8,0,32,24
1657976410195,MATH 142A,B04,093558,Chow; Bennett,14,0,32,18
1657976410195,MATH 142A,B05,093559,Chow; Bennett,7,0,32,25
1657976416221,MATH 193A,A01,083224,Rotar; Vladimir,9,0,34,25
1657976416221,MATH 193A,A02,083225,Rotar; Vladimir,11,0,34,23
1657976416221,MATH 193A,A03,083781,Rotar; Vladimir,5,0,34,29
1657976416221,MATH 193A,A04,083782,Rotar; Vladimir,12,0,34,22
1657976416221,MATH 193A,A05,093482,Rotar; Vladimir,11,0,34,23
1657976422247,MATH 197,001,091859,McAuley; Julian John,9999,0,9999,0
1657976422247,MATH 197,002,095566,Kedlaya; Kiran S.,9997,0,9999,2
1657976422247,MATH 197,003,095567,Xiao; Ming,9999,0,9999,0
1657976422247,MATH 197,004,095571,Perols; Johan Lars,9998,0,9999,1
1657976429315,COGS 9,A01,083615,Shannon; Kyle Michael,11,0,75,64
1657976435339,COGS 11,A01,083617,Boyle; Mary E. T.,23,0,48,25
1657976441368,COGS 13,A01,083071,Bastos; Amalia Pinkusfeld,12,0,71,59
1657976447397,COGS 14A,A01,092681,Semenuks; Arturs,5,1,100,95
1657976453442,COGS 14B,A01,083073,Cheng; Tzu-Han,7,0,63,56
1657976459465,COGS 17,A01,092677,Semenuks; Arturs,7,0,81,74
1657976465498,COGS 100,A01,083619,Allen; Michael Gordon,17,0,70,53
1657976471524,COGS 101A,A01,083621,Davis; Joshua Daniel,9,0,68,59
1657976477548,COGS 101B,A01,091572,Allen; Michael Gordon,14,0,65,51
1657976483573,COGS 101C,A01,083625,Delgado; Tania,17,0,35,18
1657976489603,COGS 107A,A01,083627,Boyle; Mary E. T.,14,0,60,46
1657976495633,COGS 118A,A01,083075,Gupta; Anjum,21,0,76,55
1657976501659,CSE 3,A50,083646,Miranda; Gregory Joseph,24,0,50,26
1657976507689,CSE 8A,A50,083650,Miranda; Gregory Joseph,17,1,56,39
1657976513714,CSE 11,A01,083080,Cao; Yingjun,7,15,40,33
1657976519739,CSE 12,A01,083652,Krause-Levy; Sophia Louisa,30,1,120,90
1657976525832,CSE 15L,A01,083654,Morris; Justin Loren,9,0,50,41
1657976525832,CSE 15L,A02,083655,Morris; Justin Loren,11,0,50,39
1657976531862,CSE 20,A01,083657,Tran; Khoa Dang,39,0,80,41
1657976537891,CSE 21,A01,095574,Bach; Quang Tran,23,0,48,25
1657976543918,CSE 30,A01,083084,Eldon; John,8,0,80,72
1657976543918,CSE 30,B01,095061,Bhaskar; Nishant,9,0,50,41
1657976549943,CSE 100,A01,083659,Cao; Yingjun,5,4,70,65
1657976555972,CSE 134B,A01,083661,Powell; Thomas Allan,25,0,100,75
1657976561999,CSE 140,A01,083663,Gungor; Onat,17,0,85,68
1657976568023,CSE 140L,A01,083088,Eldon; John,23,0,100,77
1657976574047,CSE 175,A01,083665,Kumar; Rakesh,3,0,25,22
1657976580081,CSE 190,A00,092507,Dubnov; Shlomo,8,0,20,12
1657976586106,ECE 45,A01,083139,Congero; Spencer William,7,0,75,68
1657976592135,ECE 65,A50,083695,Saad; Andrew S,12,0,30,18
1657976592135,ECE 65,A51,095125,Saad; Andrew S,24,0,26,2
1657976598159,ECE 109,A01,091882,Touri; Behrouz,21,0,70,49
1657976604186,ECE 180,A00,083140,Abi Samra; Nicholas Camill,1,0,30,29
1657976604186,ECE 180,B00,083141,Abi Samra; Nicholas Camill,0,0,30,30
1657976610213,MATH 10A,A01,083735,Patchell; Gregory David,2,0,30,28
1657976610213,MATH 10A,A02,083736,Patchell; Gregory David,20,0,30,10
1657976610213,MATH 10A,A03,083737,Patchell; Gregory David,16,0,30,14
1657976616243,MATH 10B,A01,083207,Lim; Seonhee,9,0,34,25
1657976616243,MATH 10B,A02,083208,Lim; Seonhee,10,0,35,25
1657976616243,MATH 10B,A03,093472,Lim; Seonhee,7,0,34,27
1657976616243,MATH 10B,B01,083739,Sinha; Shubham,14,0,30,16
1657976622281,MATH 18,A01,083743,Cinel; Cameron Alexander,9,0,30,21
1657976622281,MATH 18,A02,083744,Cinel; Cameron Alexander,18,0,30,12
1657976622281,MATH 18,A03,083745,Cinel; Cameron Alexander,10,0,30,20
1657976622281,MATH 18,B01,083748,Rideout; David Porter,5,0,37,32
1657976622281,MATH 18,B02,083749,Rideout; David Porter,5,0,36,31
1657976622281,MATH 18,B03,083750,Rideout; David Porter,3,0,37,34
1657976622281,MATH 18,B04,083751,Rideout; David Porter,7,0,36,29
1657976622281,MATH 18,B05,093473,Rideout; David Porter,7,0,36,29
1657976622281,MATH 18,B06,093474,Rideout; David Porter,6,0,36,30
1657976628310,MATH 20A,A01,083754,Zheng; Zequn,14,0,40,26
1657976634337,MATH 20B,A01,083756,Briones; Jor-el Thomas Caparas,4,0,36,32
1657976634337,MATH 20B,A02,083757,Briones; Jor-el Thomas Caparas,1,0,36,35
1657976634337,MATH 20B,A03,093475,Briones; Jor-el Thomas Caparas,3,0,36,33
1657976640364,MATH 20C,A01,083760,Briones; Jor-el Thomas Caparas,1,0,35,34
1657976640364,MATH 20C,A02,083761,Briones; Jor-el Thomas Caparas,8,0,35,27
1657976640364,MATH 20C,A03,093476,Briones; Jor-el Thomas Caparas,0,1,36,36
1657976640364,MATH 20C,B01,083762,Bach; Quang Tran,1,0,30,29
1657976646393,MATH 20D,A01,083765,Tran; Brian Kha,5,0,30,25
1657976646393,MATH 20D,A02,083766,Tran; Brian Kha,5,0,30,25
1657976646393,MATH 20D,A03,083767,Tran; Brian Kha,6,0,30,24
1657976652430,MATH 20E,A01,083771,Ganguly; Soumya,12,0,32,20
1657976652430,MATH 20E,A02,083772,Ganguly; Soumya,7,0,32,25
1657976652430,MATH 20E,B01,083773,Ciotti; Benjamin,20,0,35,15
1657976652430,MATH 20E,B02,083774,Ciotti; Benjamin,18,0,35,17
1657976658465,MATH 103A,A01,083777,Greenfeld; Be'Eri,6,0,36,30
1657976658465,MATH 103A,A02,083778,Greenfeld; Be'Eri,5,0,36,31
1657976658465,MATH 103A,A03,093561,Greenfeld; Be'Eri,7,0,36,29
1657976658465,MATH 103A,B01,083779,Greenfeld; Be'Eri,8,0,36,28
1657976658465,MATH 103A,B02,083780,Greenfeld; Be'Eri,4,0,36,32
1657976658465,MATH 103A,B03,093562,Greenfeld; Be'Eri,3,0,36,33
1657976664491,MATH 105,A01,085443,Carter; Anne Toulson,15,0,35,20
1657976664491,MATH 105,A02,093477,Carter; Anne Toulson,20,0,35,15
1657976670517,MATH 109,A01,083213,Ganzberger; Geoffrey Michael,3,0,34,31
1657976670517,MATH 109,A02,083214,Ganzberger; Geoffrey Michael,4,0,34,30
1657976670517,MATH 109,A03,093478,Ganzberger; Geoffrey Michael,2,0,34,32
1657976670517,MATH 109,B01,083215,Ganzberger; Geoffrey Michael,3,0,32,29
1657976670517,MATH 109,B02,083216,Ganzberger; Geoffrey Michael,3,0,32,29
1657976670517,MATH 109,B03,093479,Ganzberger; Geoffrey Michael,8,0,32,24
1657976676545,MATH 142A,A01,083219,Chow; Bennett,7,0,32,25
1657976676545,MATH 142A,A02,083220,Chow; Bennett,10,0,32,22
1657976676545,MATH 142A,A03,093480,Chow; Bennett,9,0,32,23
1657976676545,MATH 142A,B03,093481,Chow; Bennett,8,0,32,24
1657976676545,MATH 142A,B04,093558,Chow; Bennett,14,0,32,18
1657976676545,MATH 142A,B05,093559,Chow; Bennett,7,0,32,25
1657976682572,MATH 193A,A01,083224,Rotar; Vladimir,9,0,34,25
1657976682572,MATH 193A,A02,083225,Rotar; Vladimir,11,0,34,23
1657976682572,MATH 193A,A03,083781,Rotar; Vladimir,5,0,34,29
1657976682572,MATH 193A,A04,083782,Rotar; Vladimir,12,0,34,22
1657976682572,MATH 193A,A05,093482,Rotar; Vladimir,11,0,34,23
1657976688597,MATH 197,001,091859,McAuley; Julian John,9999,0,9999,0
1657976688597,MATH 197,002,095566,Kedlaya; Kiran S.,9997,0,9999,2
1657976688597,MATH 197,003,095567,Xiao; Ming,9999,0,9999,0
1657976688597,MATH 197,004,095571,Perols; Johan Lars,9998,0,9999,1
1657976695670,COGS 9,A01,083615,Shannon; Kyle Michael,11,0,75,64
1657976701693,COGS 11,A01,083617,Boyle; Mary E. T.,23,0,48,25
1657976707717,COGS 13,A01,083071,Bastos; Amalia Pinkusfeld,12,0,71,59
1657976713747,COGS 14A,A01,092681,Semenuks; Arturs,5,1,100,95
1657976719771,COGS 14B,A01,083073,Cheng; Tzu-Han,7,0,63,56
1657976725798,COGS 17,A01,092677,Semenuks; Arturs,7,0,81,74
1657976731824,COGS 100,A01,083619,Allen; Michael Gordon,17,0,70,53
1657976737847,COGS 101A,A01,083621,Davis; Joshua Daniel,9,0,68,59
1657976743872,COGS 101B,A01,091572,Allen; Michael Gordon,14,0,65,51
1657976749902,COGS 101C,A01,083625,Delgado; Tania,17,0,35,18
1657976755925,COGS 107A,A01,083627,Boyle; Mary E. T.,14,0,60,46
1657976761954,COGS 118A,A01,083075,Gupta; Anjum,21,0,76,55
1657976767980,CSE 3,A50,083646,Miranda; Gregory Joseph,24,0,50,26
1657976774009,CSE 8A,A50,083650,Miranda; Gregory Joseph,17,1,56,39
1657976780037,CSE 11,A01,083080,Cao; Yingjun,7,15,40,33
1657976786068,CSE 12,A01,083652,Krause-Levy; Sophia Louisa,30,1,120,90
1657976792091,CSE 15L,A01,083654,Morris; Justin Loren,9,0,50,41
1657976792091,CSE 15L,A02,083655,Morris; Justin Loren,11,0,50,39
1657976798116,CSE 20,A01,083657,Tran; Khoa Dang,39,0,80,41
1657976804142,CSE 21,A01,095574,Bach; Quang Tran,23,0,48,25
1657976810178,CSE 30,A01,083084,Eldon; John,8,0,80,72
1657976810178,CSE 30,B01,095061,Bhaskar; Nishant,9,0,50,41
1657976816207,CSE 100,A01,083659,Cao; Yingjun,5,4,70,65
1657976822238,CSE 134B,A01,083661,Powell; Thomas Allan,25,0,100,75
1657976828264,CSE 140,A01,083663,Gungor; Onat,17,0,85,68
1657976834287,CSE 140L,A01,083088,Eldon; John,23,0,100,77
1657976840320,CSE 175,A01,083665,Kumar; Rakesh,3,0,25,22
1657976846349,CSE 190,A00,092507,Dubnov; Shlomo,8,0,20,12
1657976852375,ECE 45,A01,083139,Congero; Spencer William,7,0,75,68
1657976858402,ECE 65,A50,083695,Saad; Andrew S,12,0,30,18
1657976858402,ECE 65,A51,095125,Saad; Andrew S,24,0,26,2
1657976864429,ECE 109,A01,091882,Touri; Behrouz,21,0,70,49
1657976870458,ECE 180,A00,083140,Abi Samra; Nicholas Camill,1,0,30,29
1657976870458,ECE 180,B00,083141,Abi Samra; Nicholas Camill,0,0,30,30
1657976876492,MATH 10A,A01,083735,Patchell; Gregory David,2,0,30,28
1657976876492,MATH 10A,A02,083736,Patchell; Gregory David,20,0,30,10
1657976876492,MATH 10A,A03,083737,Patchell; Gregory David,16,0,30,14
1657976882519,MATH 10B,A01,083207,Lim; Seonhee,9,0,34,25
1657976882519,MATH 10B,A02,083208,Lim; Seonhee,10,0,35,25
1657976882519,MATH 10B,A03,093472,Lim; Seonhee,7,0,34,27
1657976882519,MATH 10B,B01,083739,Sinha; Shubham,14,0,30,16
1657976888560,MATH 18,A01,083743,Cinel; Cameron Alexander,9,0,30,21
1657976888560,MATH 18,A02,083744,Cinel; Cameron Alexander,18,0,30,12
1657976888560,MATH 18,A03,083745,Cinel; Cameron Alexander,10,0,30,20
1657976888560,MATH 18,B01,083748,Rideout; David Porter,5,0,37,32
1657976888560,MATH 18,B02,083749,Rideout; David Porter,5,0,36,31
1657976888560,MATH 18,B03,083750,Rideout; David Porter,3,0,37,34
1657976888560,MATH 18,B04,083751,Rideout; David Porter,7,0,36,29
1657976888560,MATH 18,B05,093473,Rideout; David Porter,7,0,36,29
1657976888560,MATH 18,B06,093474,Rideout; David Porter,6,0,36,30
1657976894588,MATH 20A,A01,083754,Zheng; Zequn,14,0,40,26
1657976900619,MATH 20B,A01,083756,Briones; Jor-el Thomas Caparas,4,0,36,32
1657976900619,MATH 20B,A02,083757,Briones; Jor-el Thomas Caparas,1,0,36,35
1657976900619,MATH 20B,A03,093475,Briones; Jor-el Thomas Caparas,3,0,36,33
1657976906646,MATH 20C,A01,083760,Briones; Jor-el Thomas Caparas,1,0,35,34
1657976906646,MATH 20C,A02,083761,Briones; Jor-el Thomas Caparas,8,0,35,27
1657976906646,MATH 20C,A03,093476,Briones; Jor-el Thomas Caparas,0,1,36,36
1657976906646,MATH 20C,B01,083762,Bach; Quang Tran,1,0,30,29
1657976912672,MATH 20D,A01,083765,Tran; Brian Kha,5,0,30,25
1657976912672,MATH 20D,A02,083766,Tran; Brian Kha,5,0,30,25
1657976912672,MATH 20D,A03,083767,Tran; Brian Kha,6,0,30,24
1657976918698,MATH 20E,A01,083771,Ganguly; Soumya,12,0,32,20
1657976918698,MATH 20E,A02,083772,Ganguly; Soumya,7,0,32,25
1657976918698,MATH 20E,B01,083773,Ciotti; Benjamin,20,0,35,15
1657976918698,MATH 20E,B02,083774,Ciotti; Benjamin,18,0,35,17
1657976924734,MATH 103A,A01,083777,Greenfeld; Be'Eri,6,0,36,30
1657976924734,MATH 103A,A02,083778,Greenfeld; Be'Eri,5,0,36,31
1657976924734,MATH 103A,A03,093561,Greenfeld; Be'Eri,7,0,36,29
1657976924734,MATH 103A,B01,083779,Greenfeld; Be'Eri,8,0,36,28
1657976924734,MATH 103A,B02,083780,Greenfeld; Be'Eri,4,0,36,32
1657976924734,MATH 103A,B03,093562,Greenfeld; Be'Eri,3,0,36,33
1657976930759,MATH 105,A01,085443,Carter; Anne Toulson,15,0,35,20
1657976930759,MATH 105,A02,093477,Carter; Anne Toulson,20,0,35,15
1657976936785,MATH 109,A01,083213,Ganzberger; Geoffrey Michael,3,0,34,31
1657976936785,MATH 109,A02,083214,Ganzberger; Geoffrey Michael,4,0,34,30
1657976936785,MATH 109,A03,093478,Ganzberger; Geoffrey Michael,2,0,34,32
1657976936785,MATH 109,B01,083215,Ganzberger; Geoffrey Michael,3,0,32,29
1657976936785,MATH 109,B02,083216,Ganzberger; Geoffrey Michael,3,0,32,29
1657976936785,MATH 109,B03,093479,Ganzberger; Geoffrey Michael,8,0,32,24
1657976942816,MATH 142A,A01,083219,Chow; Bennett,7,0,32,25
1657976942816,MATH 142A,A02,083220,Chow; Bennett,10,0,32,22
1657976942816,MATH 142A,A03,093480,Chow; Bennett,9,0,32,23
1657976942816,MATH 142A,B03,093481,Chow; Bennett,8,0,32,24
1657976942816,MATH 142A,B04,093558,Chow; Bennett,14,0,32,18
1657976942816,MATH 142A,B05,093559,Chow; Bennett,7,0,32,25
1657976948844,MATH 193A,A01,083224,Rotar; Vladimir,9,0,34,25
1657976948844,MATH 193A,A02,083225,Rotar; Vladimir,11,0,34,23
1657976948844,MATH 193A,A03,083781,Rotar; Vladimir,5,0,34,29
1657976948844,MATH 193A,A04,083782,Rotar; Vladimir,12,0,34,22
1657976948844,MATH 193A,A05,093482,Rotar; Vladimir,11,0,34,23
1657976954871,MATH 197,001,091859,McAuley; Julian John,9999,0,9999,0
1657976954871,MATH 197,002,095566,Kedlaya; Kiran S.,9997,0,9999,2
1657976954871,MATH 197,003,095567,Xiao; Ming,9999,0,9999,0
1657976954871,MATH 197,004,095571,Perols; Johan Lars,9998,0,9999,1
1657976961933,COGS 9,A01,083615,Shannon; Kyle Michael,11,0,75,64
1657976967961,COGS 11,A01,083617,Boyle; Mary E. T.,23,0,48,25
1657976973991,COGS 13,A01,083071,Bastos; Amalia Pinkusfeld,12,0,71,59
1657976980018,COGS 14A,A01,092681,Semenuks; Arturs,5,1,100,95
1657976986044,COGS 14B,A01,083073,Cheng; Tzu-Han,7,0,63,56
1657976992069,COGS 17,A01,092677,Semenuks; Arturs,7,0,81,74
1657976998094,COGS 100,A01,083619,Allen; Michael Gordon,17,0,70,53
1657977004120,COGS 101A,A01,083621,Davis; Joshua Daniel,9,0,68,59
1657977010142,COGS 101B,A01,091572,Allen; Michael Gordon,14,0,65,51
1657977016170,COGS 101C,A01,083625,Delgado; Tania,17,0,35,18
1657977022196,COGS 107A,A01,083627,Boyle; Mary E. T.,14,0,60,46
1657977028221,COGS 118A,A01,083075,Gupta; Anjum,21,0,76,55
1657977034248,CSE 3,A50,083646,Miranda; Gregory Joseph,24,0,50,26
1657977040277,CSE 8A,A50,083650,Miranda; Gregory Joseph,17,1,56,39
1657977046303,CSE 11,A01,083080,Cao; Yingjun,7,15,40,33
1657977052334,CSE 12,A01,083652,Krause-Levy; Sophia Louisa,30,1,120,90
1657977058363,CSE 15L,A01,083654,Morris; Justin Loren,9,0,50,41
1657977058363,CSE 15L,A02,083655,Morris; Justin Loren,11,0,50,39
1657977064391,CSE 20,A01,083657,Tran; Khoa Dang,39,0,80,41
1657977070419,CSE 21,A01,095574,Bach; Quang Tran,23,0,48,25
1657977076445,CSE 30,A01,083084,Eldon; John,8,0,80,72
1657977076445,CSE 30,B01,095061,Bhaskar; Nishant,9,0,50,41
1657977082470,CSE 100,A01,083659,Cao; Yingjun,5,4,70,65
1657977088500,CSE 134B,A01,083661,Powell; Thomas Allan,25,0,100,75
1657977094525,CSE 140,A01,083663,Gungor; Onat,17,0,85,68
1657977100550,CSE 140L,A01,083088,Eldon; John,23,0,100,77
1657977106580,CSE 175,A01,083665,Kumar; Rakesh,3,0,25,22
1657977112605,CSE 190,A00,092507,Dubnov; Shlomo,8,0,20,12
1657977118634,ECE 45,A01,083139,Congero; Spencer William,7,0,75,68
1657977124737,ECE 65,A50,083695,Saad; Andrew S,12,0,30,18
1657977124737,ECE 65,A51,095125,Saad; Andrew S,24,0,26,2
1657977130768,ECE 109,A01,091882,Touri; Behrouz,21,0,70,49
1657977136796,ECE 180,A00,083140,Abi Samra; Nicholas Camill,1,0,30,29
1657977136796,ECE 180,B00,083141,Abi Samra; Nicholas Camill,0,0,30,30
1657977142829,MATH 10A,A01,083735,Patchell; Gregory David,2,0,30,28
1657977142829,MATH 10A,A02,083736,Patchell; Gregory David,20,0,30,10
1657977142829,MATH 10A,A03,083737,Patchell; Gregory David,16,0,30,14
1657977148857,MATH 10B,A01,083207,Lim; Seonhee,9,0,34,25
1657977148857,MATH 10B,A02,083208,Lim; Seonhee,10,0,35,25
1657977148857,MATH 10B,A03,093472,Lim; Seonhee,7,0,34,27
1657977148857,MATH 10B,B01,083739,Sinha; Shubham,14,0,30,16
1657977154887,MATH 18,A01,083743,Cinel; Cameron Alexander,9,0,30,21
1657977154887,MATH 18,A02,083744,Cinel; Cameron Alexander,18,0,30,12
1657977154887,MATH 18,A03,083745,Cinel; Cameron Alexander,10,0,30,20
1657977154887,MATH 18,B01,083748,Rideout; David Porter,5,0,37,32
1657977154887,MATH 18,B02,083749,Rideout; David Porter,5,0,36,31
1657977154887,MATH 18,B03,083750,Rideout; David Porter,3,0,37,34
1657977154887,MATH 18,B04,083751,Rideout; David Porter,7,0,36,29
1657977154887,MATH 18,B05,093473,Rideout; David Porter,7,0,36,29
1657977154887,MATH 18,B06,093474,Rideout; David Porter,6,0,36,30
1657977160912,MATH 20A,A01,083754,Zheng; Zequn,14,0,40,26
1657977166938,MATH 20B,A01,083756,Briones; Jor-el Thomas Caparas,4,0,36,32
1657977166938,MATH 20B,A02,083757,Briones; Jor-el Thomas Caparas,1,0,36,35
1657977166938,MATH 20B,A03,093475,Briones; Jor-el Thomas Caparas,3,0,36,33
1657977172963,MATH 20C,A01,083760,Briones; Jor-el Thomas Caparas,1,0,35,34
1657977172963,MATH 20C,A02,083761,Briones; Jor-el Thomas Caparas,8,0,35,27
1657977172963,MATH 20C,A03,093476,Briones; Jor-el Thomas Caparas,0,1,36,36
1657977172963,MATH 20C,B01,083762,Bach; Quang Tran,1,0,30,29
1657977178993,MATH 20D,A01,083765,Tran; Brian Kha,5,0,30,25
1657977178993,MATH 20D,A02,083766,Tran; Brian Kha,5,0,30,25
1657977178993,MATH 20D,A03,083767,Tran; Brian Kha,6,0,30,24
1657977185028,MATH 20E,A01,083771,Ganguly; Soumya,12,0,32,20
1657977185028,MATH 20E,A02,083772,Ganguly; Soumya,7,0,32,25
1657977185028,MATH 20E,B01,083773,Ciotti; Benjamin,20,0,35,15
1657977185028,MATH 20E,B02,083774,Ciotti; Benjamin,18,0,35,17
1657977191063,MATH 103A,A01,083777,Greenfeld; Be'Eri,6,0,36,30
1657977191063,MATH 103A,A02,083778,Greenfeld; Be'Eri,5,0,36,31
1657977191063,MATH 103A,A03,093561,Greenfeld; Be'Eri,7,0,36,29
1657977191063,MATH 103A,B01,083779,Greenfeld; Be'Eri,8,0,36,28
1657977191063,MATH 103A,B02,083780,Greenfeld; Be'Eri,4,0,36,32
1657977191063,MATH 103A,B03,093562,Greenfeld; Be'Eri,3,0,36,33
1657977197093,MATH 105,A01,085443,Carter; Anne Toulson,15,0,35,20
1657977197093,MATH 105,A02,093477,Carter; Anne Toulson,20,0,35,15
1657977203120,MATH 109,A01,083213,Ganzberger; Geoffrey Michael,3,0,34,31
1657977203120,MATH 109,A02,083214,Ganzberger; Geoffrey Michael,4,0,34,30
1657977203120,MATH 109,A03,093478,Ganzberger; Geoffrey Michael,2,0,34,32
1657977203120,MATH 109,B01,083215,Ganzberger; Geoffrey Michael,3,0,32,29
1657977203120,MATH 109,B02,083216,Ganzberger; Geoffrey Michael,3,0,32,29
1657977203120,MATH 109,B03,093479,Ganzberger; Geoffrey Michael,8,0,32,24
1657977209178,MATH 142A,A01,083219,Chow; Bennett,7,0,32,25
1657977209178,MATH 142A,A02,083220,Chow; Bennett,10,0,32,22
1657977209178,MATH 142A,A03,093480,Chow; Bennett,9,0,32,23
1657977209178,MATH 142A,B03,093481,Chow; Bennett,8,0,32,24
1657977209178,MATH 142A,B04,093558,Chow; Bennett,14,0,32,18
1657977209178,MATH 142A,B05,093559,Chow; Bennett,7,0,32,25
1657977215212,MATH 193A,A01,083224,Rotar; Vladimir,9,0,34,25
1657977215212,MATH 193A,A02,083225,Rotar; Vladimir,11,0,34,23
1657977215212,MATH 193A,A03,083781,Rotar; Vladimir,5,0,34,29
1657977215212,MATH 193A,A04,083782,Rotar; Vladimir,12,0,34,22
1657977215212,MATH 193A,A05,093482,Rotar; Vladimir,11,0,34,23
1657977221238,MATH 197,001,091859,McAuley; Julian John,9999,0,9999,0
1657977221238,MATH 197,002,095566,Kedlaya; Kiran S.,9997,0,9999,2
1657977221238,MATH 197,003,095567,Xiao; Ming,9999,0,9999,0
1657977221238,MATH 197,004,095571,Perols; Johan Lars,9998,0,9999,1
1657977228305,COGS 9,A01,083615,Shannon; Kyle Michael,11,0,75,64
1657977234333,COGS 11,A01,083617,Boyle; Mary E. T.,23,0,48,25
1657977240356,COGS 13,A01,083071,Bastos; Amalia Pinkusfeld,12,0,71,59
1657977246382,COGS 14A,A01,092681,Semenuks; Arturs,5,1,100,95
1657977252408,COGS 14B,A01,083073,Cheng; Tzu-Han,7,0,63,56
1657977258432,COGS 17,A01,092677,Semenuks; Arturs,7,0,81,74
1657977264456,COGS 100,A01,083619,Allen; Michael Gordon,17,0,70,53
1657977270482,COGS 101A,A01,083621,Davis; Joshua Daniel,9,0,68,59
1657977276506,COGS 101B,A01,091572,Allen; Michael Gordon,14,0,65,51
1657977282533,COGS 101C,A01,083625,Delgado; Tania,17,0,35,18
1657977288561,COGS 107A,A01,083627,Boyle; Mary E. T.,14,0,60,46
1657977294585,COGS 118A,A01,083075,Gupta; Anjum,21,0,76,55
1657977300620,CSE 3,A50,083646,Miranda; Gregory Joseph,24,0,50,26
1657977306645,CSE 8A,A50,083650,Miranda; Gregory Joseph,17,1,56,39
1657977312674,CSE 11,A01,083080,Cao; Yingjun,7,15,40,33
1657977318704,CSE 12,A01,083652,Krause-Levy; Sophia Louisa,30,1,120,90
1657977324737,CSE 15L,A01,083654,Morris; Justin Loren,9,0,50,41
1657977324737,CSE 15L,A02,083655,Morris; Justin Loren,11,0,50,39
1657977330761,CSE 20,A01,083657,Tran; Khoa Dang,39,0,80,41
1657977336791,CSE 21,A01,095574,Bach; Quang Tran,23,0,48,25
1657977342819,CSE 30,A01,083084,Eldon; John,8,0,80,72
1657977342819,CSE 30,B01,095061,Bhaskar; Nishant,9,0,50,41
1657977348843,CSE 100,A01,083659,Cao; Yingjun,5,4,70,65
1657977354867,CSE 134B,A01,083661,Powell; Thomas Allan,25,0,100,75
1657977360892,CSE 140,A01,083663,Gungor; Onat,17,0,85,68
1657977366915,CSE 140L,A01,083088,Eldon; John,23,0,100,77
1657977372945,CSE 175,A01,083665,Kumar; Rakesh,3,0,25,22
1657977378978,CSE 190,A00,092507,Dubnov; Shlomo,8,0,20,12
1657977385003,ECE 45,A01,083139,Congero; Spencer William,7,0,75,68
1657977391041,ECE 65,A50,083695,Saad; Andrew S,12,0,30,18
1657977391041,ECE 65,A51,095125,Saad; Andrew S,24,0,26,2
1657977397067,ECE 109,A01,091882,Touri; Behrouz,21,0,70,49
1657977403093,ECE 180,A00,083140,Abi Samra; Nicholas Camill,1,0,30,29
1657977403093,ECE 180,B00,083141,Abi Samra; Nicholas Camill,0,0,30,30
1657977409125,MATH 10A,A01,083735,Patchell; Gregory David,2,0,30,28
1657977409125,MATH 10A,A02,083736,Patchell; Gregory David,20,0,30,10
1657977409125,MATH 10A,A03,083737,Patchell; Gregory David,16,0,30,14
1657977415162,MATH 10B,A01,083207,Lim; Seonhee,9,0,34,25
1657977415162,MATH 10B,A02,083208,Lim; Seonhee,10,0,35,25
1657977415162,MATH 10B,A03,093472,Lim; Seonhee,7,0,34,27
1657977415162,MATH 10B,B01,083739,Sinha; Shubham,14,0,30,16
1657977421198,MATH 18,A01,083743,Cinel; Cameron Alexander,9,0,30,21
1657977421198,MATH 18,A02,083744,Cinel; Cameron Alexander,18,0,30,12
1657977421198,MATH 18,A03,083745,Cinel; Cameron Alexander,10,0,30,20
1657977421198,MATH 18,B01,083748,Rideout; David Porter,5,0,37,32
1657977421198,MATH 18,B02,083749,Rideout; David Porter,5,0,36,31
1657977421198,MATH 18,B03,083750,Rideout; David Porter,3,0,37,34
1657977421198,MATH 18,B04,083751,Rideout; David Porter,7,0,36,29
1657977421198,MATH 18,B05,093473,Rideout; David Porter,7,0,36,29
1657977421198,MATH 18,B06,093474,Rideout; David Porter,6,0,36,30
1657977427227,MATH 20A,A01,083754,Zheng; Zequn,14,0,40,26
1657977433258,MATH 20B,A01,083756,Briones; Jor-el Thomas Caparas,4,0,36,32
1657977433258,MATH 20B,A02,083757,Briones; Jor-el Thomas Caparas,1,0,36,35
1657977433258,MATH 20B,A03,093475,Briones; Jor-el Thomas Caparas,3,0,36,33
1657977439285,MATH 20C,A01,083760,Briones; Jor-el Thomas Caparas,1,0,35,34
1657977439285,MATH 20C,A02,083761,Briones; Jor-el Thomas Caparas,8,0,35,27
1657977439285,MATH 20C,A03,093476,Briones; Jor-el Thomas Caparas,0,1,36,36
1657977439285,MATH 20C,B01,083762,Bach; Quang Tran,1,0,30,29
1657977445320,MATH 20D,A01,083765,Tran; Brian Kha,5,0,30,25
1657977445320,MATH 20D,A02,083766,Tran; Brian Kha,5,0,30,25
1657977445320,MATH 20D,A03,083767,Tran; Brian Kha,6,0,30,24
1657977451358,MATH 20E,A01,083771,Ganguly; Soumya,12,0,32,20
1657977451358,MATH 20E,A02,083772,Ganguly; Soumya,7,0,32,25
1657977451358,MATH 20E,B01,083773,Ciotti; Benjamin,20,0,35,15
1657977451358,MATH 20E,B02,083774,Ciotti; Benjamin,18,0,35,17
1657977457384,MATH 103A,A01,083777,Greenfeld; Be'Eri,6,0,36,30
1657977457384,MATH 103A,A02,083778,Greenfeld; Be'Eri,5,0,36,31
1657977457384,MATH 103A,A03,093561,Greenfeld; Be'Eri,7,0,36,29
1657977457384,MATH 103A,B01,083779,Greenfeld; Be'Eri,8,0,36,28
1657977457384,MATH 103A,B02,083780,Greenfeld; Be'Eri,4,0,36,32
1657977457384,MATH 103A,B03,093562,Greenfeld; Be'Eri,3,0,36,33
1657977463416,MATH 105,A01,085443,Carter; Anne Toulson,15,0,35,20
1657977463416,MATH 105,A02,093477,Carter; Anne Toulson,20,0,35,15
1657977469443,MATH 109,A01,083213,Ganzberger; Geoffrey Michael,3,0,34,31
1657977469443,MATH 109,A02,083214,Ganzberger; Geoffrey Michael,4,0,34,30
1657977469443,MATH 109,A03,093478,Ganzberger; Geoffrey Michael,2,0,34,32
1657977469443,MATH 109,B01,083215,Ganzberger; Geoffrey Michael,3,0,32,29
1657977469443,MATH 109,B02,083216,Ganzberger; Geoffrey Michael,3,0,32,29
1657977469443,MATH 109,B03,093479,Ganzberger; Geoffrey Michael,8,0,32,24
1657977475469,MATH 142A,A01,083219,Chow; Bennett,7,0,32,25
1657977475469,MATH 142A,A02,083220,Chow; Bennett,10,0,32,22
1657977475469,MATH 142A,A03,093480,Chow; Bennett,9,0,32,23
1657977475469,MATH 142A,B03,093481,Chow; Bennett,8,0,32,24
1657977475469,MATH 142A,B04,093558,Chow; Bennett,14,0,32,18
1657977475469,MATH 142A,B05,093559,Chow; Bennett,7,0,32,25
1657977481502,MATH 193A,A01,083224,Rotar; Vladimir,9,0,34,25
1657977481502,MATH 193A,A02,083225,Rotar; Vladimir,11,0,34,23
1657977481502,MATH 193A,A03,083781,Rotar; Vladimir,5,0,34,29
1657977481502,MATH 193A,A04,083782,Rotar; Vladimir,12,0,34,22
1657977481502,MATH 193A,A05,093482,Rotar; Vladimir,11,0,34,23
1657977487533,MATH 197,001,091859,McAuley; Julian John,9999,0,9999,0
1657977487533,MATH 197,002,095566,Kedlaya; Kiran S.,9997,0,9999,2
1657977487533,MATH 197,003,095567,Xiao; Ming,9999,0,9999,0
1657977487533,MATH 197,004,095571,Perols; Johan Lars,9998,0,9999,1
1657977494607,COGS 9,A01,083615,Shannon; Kyle Michael,11,0,75,64
1657977500632,COGS 11,A01,083617,Boyle; Mary E. T.,23,0,48,25
1657977506662,COGS 13,A01,083071,Bastos; Amalia Pinkusfeld,12,0,71,59
1657977512686,COGS 14A,A01,092681,Semenuks; Arturs,5,1,100,95
1657977518711,COGS 14B,A01,083073,Cheng; Tzu-Han,7,0,63,56
1657977524739,COGS 17,A01,092677,Semenuks; Arturs,7,0,81,74
1657977530763,COGS 100,A01,083619,Allen; Michael Gordon,17,0,70,53
1657977536787,COGS 101A,A01,083621,Davis; Joshua Daniel,9,0,68,59
1657977542812,COGS 101B,A01,091572,Allen; Michael Gordon,14,0,65,51
1657977548842,COGS 101C,A01,083625,Delgado; Tania,17,0,35,18
1657977554868,COGS 107A,A01,083627,Boyle; Mary E. T.,14,0,60,46
1657977560892,COGS 118A,A01,083075,Gupta; Anjum,21,0,76,55
1657977566919,CSE 3,A50,083646,Miranda; Gregory Joseph,24,0,50,26
1657977572946,CSE 8A,A50,083650,Miranda; Gregory Joseph,17,1,56,39
1657977578971,CSE 11,A01,083080,Cao; Yingjun,7,15,40,33
1657977585002,CSE 12,A01,083652,Krause-Levy; Sophia Louisa,30,1,120,90
1657977591030,CSE 15L,A01,083654,Morris; Justin Loren,9,0,50,41
1657977591030,CSE 15L,A02,083655,Morris; Justin Loren,11,0,50,39
1657977597053,CSE 20,A01,083657,Tran; Khoa Dang,39,0,80,41
1657977603081,CSE 21,A01,095574,Bach; Quang Tran,23,0,48,25
1657977609114,CSE 30,A01,083084,Eldon; John,8,0,80,72
1657977609114,CSE 30,B01,095061,Bhaskar; Nishant,9,0,50,41
1657977615143,CSE 100,A01,083659,Cao; Yingjun,5,4,70,65
1657977621174,CSE 134B,A01,083661,Powell; Thomas Allan,25,0,100,75
1657977627199,CSE 140,A01,083663,Gungor; Onat,17,0,85,68
1657977633225,CSE 140L,A01,083088,Eldon; John,23,0,100,77
1657977639252,CSE 175,A01,083665,Kumar; Rakesh,3,0,25,22
1657977645276,CSE 190,A00,092507,Dubnov; Shlomo,8,0,20,12
1657977651302,ECE 45,A01,083139,Congero; Spencer William,7,0,75,68
1657977657334,ECE 65,A50,083695,Saad; Andrew S,12,0,30,18
1657977657334,ECE 65,A51,095125,Saad; Andrew S,24,0,26,2
1657977663357,ECE 109,A01,091882,Touri; Behrouz,21,0,70,49
1657977669388,ECE 180,A00,083140,Abi Samra; Nicholas Camill,1,0,30,29
1657977669388,ECE 180,B00,083141,Abi Samra; Nicholas Camill,0,0,30,30
1657977675423,MATH 10A,A01,083735,Patchell; Gregory David,2,0,30,28
1657977675423,MATH 10A,A02,083736,Patchell; Gregory David,20,0,30,10
1657977675423,MATH 10A,A03,083737,Patchell; Gregory David,16,0,30,14
1657977681462,MATH 10B,A01,083207,Lim; Seonhee,9,0,34,25
1657977681462,MATH 10B,A02,083208,Lim; Seonhee,10,0,35,25
1657977681462,MATH 10B,A03,093472,Lim; Seonhee,7,0,34,27
1657977681462,MATH 10B,B01,083739,Sinha; Shubham,14,0,30,16
1657977687491,MATH 18,A01,083743,Cinel; Cameron Alexander,9,0,30,21
1657977687491,MATH 18,A02,083744,Cinel; Cameron Alexander,18,0,30,12
1657977687491,MATH 18,A03,083745,Cinel; Cameron Alexander,10,0,30,20
1657977687491,MATH 18,B01,083748,Rideout; David Porter,5,0,37,32
1657977687491,MATH 18,B02,083749,Rideout; David Porter,5,0,36,31
1657977687491,MATH 18,B03,083750,Rideout; David Porter,3,0,37,34
1657977687491,MATH 18,B04,083751,Rideout; David Porter,7,0,36,29
1657977687491,MATH 18,B05,093473,Rideout; David Porter,7,0,36,29
1657977687491,MATH 18,B06,093474,Rideout; David Porter,6,0,36,30
1657977693515,MATH 20A,A01,083754,Zheng; Zequn,14,0,40,26
1657977699542,MATH 20B,A01,083756,Briones; Jor-el Thomas Caparas,4,0,36,32
1657977699542,MATH 20B,A02,083757,Briones; Jor-el Thomas Caparas,1,0,36,35
1657977699542,MATH 20B,A03,093475,Briones; Jor-el Thomas Caparas,3,0,36,33
1657977705568,MATH 20C,A01,083760,Briones; Jor-el Thomas Caparas,1,0,35,34
1657977705568,MATH 20C,A02,083761,Briones; Jor-el Thomas Caparas,8,0,35,27
1657977705568,MATH 20C,A03,093476,Briones; Jor-el Thomas Caparas,0,1,36,36
1657977705568,MATH 20C,B01,083762,Bach; Quang Tran,1,0,30,29
1657977711592,MATH 20D,A01,083765,Tran; Brian Kha,5,0,30,25
1657977711592,MATH 20D,A02,083766,Tran; Brian Kha,5,0,30,25
1657977711592,MATH 20D,A03,083767,Tran; Brian Kha,6,0,30,24
1657977717619,MATH 20E,A01,083771,Ganguly; Soumya,12,0,32,20
1657977717619,MATH 20E,A02,083772,Ganguly; Soumya,7,0,32,25
1657977717619,MATH 20E,B01,083773,Ciotti; Benjamin,20,0,35,15
1657977717619,MATH 20E,B02,083774,Ciotti; Benjamin,18,0,35,17
1657977723729,MATH 103A,A01,083777,Greenfeld; Be'Eri,6,0,36,30
1657977723729,MATH 103A,A02,083778,Greenfeld; Be'Eri,5,0,36,31
1657977723729,MATH 103A,A03,093561,Greenfeld; Be'Eri,7,0,36,29
1657977723729,MATH 103A,B01,083779,Greenfeld; Be'Eri,8,0,36,28
1657977723729,MATH 103A,B02,083780,Greenfeld; Be'Eri,4,0,36,32
1657977723729,MATH 103A,B03,093562,Greenfeld; Be'Eri,3,0,36,33
1657977729756,MATH 105,A01,085443,Carter; Anne Toulson,15,0,35,20
1657977729756,MATH 105,A02,093477,Carter; Anne Toulson,20,0,35,15
1657977735780,MATH 109,A01,083213,Ganzberger; Geoffrey Michael,3,0,34,31
1657977735780,MATH 109,A02,083214,Ganzberger; Geoffrey Michael,4,0,34,30
1657977735780,MATH 109,A03,093478,Ganzberger; Geoffrey Michael,2,0,34,32
1657977735780,MATH 109,B01,083215,Ganzberger; Geoffrey Michael,3,0,32,29
1657977735780,MATH 109,B02,083216,Ganzberger; Geoffrey Michael,3,0,32,29
1657977735780,MATH 109,B03,093479,Ganzberger; Geoffrey Michael,8,0,32,24
1657977741813,MATH 142A,A01,083219,Chow; Bennett,7,0,32,25
1657977741813,MATH 142A,A02,083220,Chow; Bennett,10,0,32,22
1657977741813,MATH 142A,A03,093480,Chow; Bennett,9,0,32,23
1657977741813,MATH 142A,B03,093481,Chow; Bennett,8,0,32,24
1657977741813,MATH 142A,B04,093558,Chow; Bennett,14,0,32,18
1657977741813,MATH 142A,B05,093559,Chow; Bennett,7,0,32,25
1657977747844,MATH 193A,A01,083224,Rotar; Vladimir,9,0,34,25
1657977747844,MATH 193A,A02,083225,Rotar; Vladimir,11,0,34,23
1657977747844,MATH 193A,A03,083781,Rotar; Vladimir,5,0,34,29
1657977747844,MATH 193A,A04,083782,Rotar; Vladimir,12,0,34,22
1657977747844,MATH 193A,A05,093482,Rotar; Vladimir,11,0,34,23
1657977753870,MATH 197,001,091859,McAuley; Julian John,9999,0,9999,0
1657977753870,MATH 197,002,095566,Kedlaya; Kiran S.,9997,0,9999,2
1657977753870,MATH 197,003,095567,Xiao; Ming,9999,0,9999,0
1657977753870,MATH 197,004,095571,Perols; Johan Lars,9998,0,9999,1
1657977760938,COGS 9,A01,083615,Shannon; Kyle Michael,11,0,75,64
1657977766969,COGS 11,A01,083617,Boyle; Mary E. T.,23,0,48,25
1657977772994,COGS 13,A01,083071,Bastos; Amalia Pinkusfeld,12,0,71,59
1657977779018,COGS 14A,A01,092681,Semenuks; Arturs,5,1,100,95
1657977785043,COGS 14B,A01,083073,Cheng; Tzu-Han,7,0,63,56
1657977791069,COGS 17,A01,092677,Semenuks; Arturs,7,0,81,74
1657977797097,COGS 100,A01,083619,Allen; Michael Gordon,17,0,70,53
1657977803121,COGS 101A,A01,083621,Davis; Joshua Daniel,9,0,68,59
1657977809151,COGS 101B,A01,091572,Allen; Michael Gordon,14,0,65,51
1657977815181,COGS 101C,A01,083625,Delgado; Tania,17,0,35,18
1657977821208,COGS 107A,A01,083627,Boyle; Mary E. T.,14,0,60,46
1657977827236,COGS 118A,A01,083075,Gupta; Anjum,21,0,76,55
1657977833270,CSE 3,A50,083646,Miranda; Gregory Joseph,24,0,50,26
1657977839297,CSE 8A,A50,083650,Miranda; Gregory Joseph,17,1,56,39
1657977845322,CSE 11,A01,083080,Cao; Yingjun,7,15,40,33
1657977851348,CSE 12,A01,083652,Krause-Levy; Sophia Louisa,30,1,120,90
1657977857373,CSE 15L,A01,083654,Morris; Justin Loren,9,0,50,41
1657977857373,CSE 15L,A02,083655,Morris; Justin Loren,11,0,50,39
1657977863397,CSE 20,A01,083657,Tran; Khoa Dang,39,0,80,41
1657977869422,CSE 21,A01,095574,Bach; Quang Tran,23,0,48,25
1657977875447,CSE 30,A01,083084,Eldon; John,8,0,80,72
1657977875447,CSE 30,B01,095061,Bhaskar; Nishant,9,0,50,41
1657977881473,CSE 100,A01,083659,Cao; Yingjun,5,4,70,65
1657977887499,CSE 134B,A01,083661,Powell; Thomas Allan,25,0,100,75
1657977893523,CSE 140,A01,083663,Gungor; Onat,17,0,85,68
1657977899552,CSE 140L,A01,083088,Eldon; John,23,0,100,77
1657977905581,CSE 175,A01,083665,Kumar; Rakesh,3,0,25,22
1657977911611,CSE 190,A00,092507,Dubnov; Shlomo,8,0,20,12
1657977917637,ECE 45,A01,083139,Congero; Spencer William,7,0,75,68
1657977923663,ECE 65,A50,083695,Saad; Andrew S,12,0,30,18
1657977923663,ECE 65,A51,095125,Saad; Andrew S,24,0,26,2
1657977929699,ECE 109,A01,091882,Touri; Behrouz,21,0,70,49
1657977935722,ECE 180,A00,083140,Abi Samra; Nicholas Camill,1,0,30,29
1657977935722,ECE 180,B00,083141,Abi Samra; Nicholas Camill,0,0,30,30
1657977941756,MATH 10A,A01,083735,Patchell; Gregory David,2,0,30,28
1657977941756,MATH 10A,A02,083736,Patchell; Gregory David,20,0,30,10
1657977941756,MATH 10A,A03,083737,Patchell; Gregory David,16,0,30,14
1657977947786,MATH 10B,A01,083207,Lim; Seonhee,9,0,34,25
1657977947786,MATH 10B,A02,083208,Lim; Seonhee,10,0,35,25
1657977947786,MATH 10B,A03,093472,Lim; Seonhee,7,0,34,27
1657977947786,MATH 10B,B01,083739,Sinha; Shubham,14,0,30,16
1657977953825,MATH 18,A01,083743,Cinel; Cameron Alexander,9,0,30,21
1657977953825,MATH 18,A02,083744,Cinel; Cameron Alexander,18,0,30,12
1657977953825,MATH 18,A03,083745,Cinel; Cameron Alexander,10,0,30,20
1657977953825,MATH 18,B01,083748,Rideout; David Porter,5,0,37,32
1657977953825,MATH 18,B02,083749,Rideout; David Porter,5,0,36,31
1657977953825,MATH 18,B03,083750,Rideout; David Porter,3,0,37,34
1657977953825,MATH 18,B04,083751,Rideout; David Porter,7,0,36,29
1657977953825,MATH 18,B05,093473,Rideout; David Porter,7,0,36,29
1657977953825,MATH 18,B06,093474,Rideout; David Porter,6,0,36,30
1657977959855,MATH 20A,A01,083754,Zheng; Zequn,14,0,40,26
1657977965884,MATH 20B,A01,083756,Briones; Jor-el Thomas Caparas,4,0,36,32
1657977965884,MATH 20B,A02,083757,Briones; Jor-el Thomas Caparas,1,0,36,35
1657977965884,MATH 20B,A03,093475,Briones; Jor-el Thomas Caparas,3,0,36,33
1657977971909,MATH 20C,A01,083760,Briones; Jor-el Thomas Caparas,1,0,35,34
1657977971909,MATH 20C,A02,083761,Briones; Jor-el Thomas Caparas,8,0,35,27
1657977971909,MATH 20C,A03,093476,Briones; Jor-el Thomas Caparas,0,1,36,36
1657977971909,MATH 20C,B01,083762,Bach; Quang Tran,1,0,30,29
1657977977940,MATH 20D,A01,083765,Tran; Brian Kha,5,0,30,25
1657977977940,MATH 20D,A02,083766,Tran; Brian Kha,5,0,30,25
1657977977940,MATH 20D,A03,083767,Tran; Brian Kha,6,0,30,24
1657977983971,MATH 20E,A01,083771,Ganguly; Soumya,12,0,32,20
1657977983971,MATH 20E,A02,083772,Ganguly; Soumya,7,0,32,25
1657977983971,MATH 20E,B01,083773,Ciotti; Benjamin,20,0,35,15
1657977983971,MATH 20E,B02,083774,Ciotti; Benjamin,18,0,35,17
1657977990004,MATH 103A,A01,083777,Greenfeld; Be'Eri,6,0,36,30
1657977990004,MATH 103A,A02,083778,Greenfeld; Be'Eri,5,0,36,31
1657977990004,MATH 103A,A03,093561,Greenfeld; Be'Eri,7,0,36,29
1657977990004,MATH 103A,B01,083779,Greenfeld; Be'Eri,8,0,36,28
1657977990004,MATH 103A,B02,083780,Greenfeld; Be'Eri,4,0,36,32
1657977990004,MATH 103A,B03,093562,Greenfeld; Be'Eri,3,0,36,33
1657977996032,MATH 105,A01,085443,Carter; Anne Toulson,15,0,35,20
1657977996032,MATH 105,A02,093477,Carter; Anne Toulson,20,0,35,15
1657978002064,MATH 109,A01,083213,Ganzberger; Geoffrey Michael,3,0,34,31
1657978002064,MATH 109,A02,083214,Ganzberger; Geoffrey Michael,4,0,34,30
1657978002064,MATH 109,A03,093478,Ganzberger; Geoffrey Michael,2,0,34,32
1657978002064,MATH 109,B01,083215,Ganzberger; Geoffrey Michael,3,0,32,29
1657978002064,MATH 109,B02,083216,Ganzberger; Geoffrey Michael,3,0,32,29
1657978002064,MATH 109,B03,093479,Ganzberger; Geoffrey Michael,8,0,32,24
1657978008090,MATH 142A,A01,083219,Chow; Bennett,7,0,32,25
1657978008090,MATH 142A,A02,083220,Chow; Bennett,10,0,32,22
1657978008090,MATH 142A,A03,093480,Chow; Bennett,9,0,32,23
1657978008090,MATH 142A,B03,093481,Chow; Bennett,8,0,32,24
1657978008090,MATH 142A,B04,093558,Chow; Bennett,14,0,32,18
1657978008090,MATH 142A,B05,093559,Chow; Bennett,7,0,32,25
1657978014122,MATH 193A,A01,083224,Rotar; Vladimir,9,0,34,25
1657978014122,MATH 193A,A02,083225,Rotar; Vladimir,11,0,34,23
1657978014122,MATH 193A,A03,083781,Rotar; Vladimir,5,0,34,29
1657978014122,MATH 193A,A04,083782,Rotar; Vladimir,12,0,34,22
1657978014122,MATH 193A,A05,093482,Rotar; Vladimir,11,0,34,23
1657978020147,MATH 197,001,091859,McAuley; Julian John,9999,0,9999,0
1657978020147,MATH 197,002,095566,Kedlaya; Kiran S.,9997,0,9999,2
1657978020147,MATH 197,003,095567,Xiao; Ming,9999,0,9999,0
1657978020147,MATH 197,004,095571,Perols; Johan Lars,9998,0,9999,1
1657978027228,COGS 9,A01,083615,Shannon; Kyle Michael,11,0,75,64
1657978033257,COGS 11,A01,083617,Boyle; Mary E. T.,23,0,48,25
1657978039285,COGS 13,A01,083071,Bastos; Amalia Pinkusfeld,12,0,71,59
1657978045313,COGS 14A,A01,092681,Semenuks; Arturs,5,1,100,95
1657978051337,COGS 14B,A01,083073,Cheng; Tzu-Han,7,0,63,56
1657978057361,COGS 17,A01,092677,Semenuks; Arturs,7,0,81,74
1657978063394,COGS 100,A01,083619,Allen; Michael Gordon,17,0,70,53
1657978069419,COGS 101A,A01,083621,Davis; Joshua Daniel,9,0,68,59
1657978075443,COGS 101B,A01,091572,Allen; Michael Gordon,14,0,65,51
1657978081469,COGS 101C,A01,083625,Delgado; Tania,17,0,35,18
1657978087495,COGS 107A,A01,083627,Boyle; Mary E. T.,14,0,60,46
1657978093519,COGS 118A,A01,083075,Gupta; Anjum,21,0,76,55
1657978099547,CSE 3,A50,083646,Miranda; Gregory Joseph,24,0,50,26
1657978105576,CSE 8A,A50,083650,Miranda; Gregory Joseph,17,1,56,39
1657978111601,CSE 11,A01,083080,Cao; Yingjun,7,15,40,33
1657978117631,CSE 12,A01,083652,Krause-Levy; Sophia Louisa,30,1,120,90
1657978123661,CSE 15L,A01,083654,Morris; Justin Loren,9,0,50,41
1657978123661,CSE 15L,A02,083655,Morris; Justin Loren,11,0,50,39
1657978129688,CSE 20,A01,083657,Tran; Khoa Dang,39,0,80,41
1657978135716,CSE 21,A01,095574,Bach; Quang Tran,23,0,48,25
1657978141741,CSE 30,A01,083084,Eldon; John,8,0,80,72
1657978141741,CSE 30,B01,095061,Bhaskar; Nishant,9,0,50,41
1657978147765,CSE 100,A01,083659,Cao; Yingjun,5,4,70,65
1657978153788,CSE 134B,A01,083661,Powell; Thomas Allan,25,0,100,75
1657978159817,CSE 140,A01,083663,Gungor; Onat,17,0,85,68
1657978165846,CSE 140L,A01,083088,Eldon; John,23,0,100,77
1657978171871,CSE 175,A01,083665,Kumar; Rakesh,3,0,25,22
1657978177894,CSE 190,A00,092507,Dubnov; Shlomo,8,0,20,12
1657978183925,ECE 45,A01,083139,Congero; Spencer William,7,0,75,68
1657978189956,ECE 65,A50,083695,Saad; Andrew S,12,0,30,18
1657978189956,ECE 65,A51,095125,Saad; Andrew S,24,0,26,2
1657978195985,ECE 109,A01,091882,Touri; Behrouz,21,0,70,49
1657978202017,ECE 180,A00,083140,Abi Samra; Nicholas Camill,1,0,30,29
1657978202017,ECE 180,B00,083141,Abi Samra; Nicholas Camill,0,0,30,30
1657978208050,MATH 10A,A01,083735,Patchell; Gregory David,2,0,30,28
1657978208050,MATH 10A,A02,083736,Patchell; Gregory David,20,0,30,10
1657978208050,MATH 10A,A03,083737,Patchell; Gregory David,16,0,30,14
1657978214087,MATH 10B,A01,083207,Lim; Seonhee,9,0,34,25
1657978214087,MATH 10B,A02,083208,Lim; Seonhee,10,0,35,25
1657978214087,MATH 10B,A03,093472,Lim; Seonhee,7,0,34,27
1657978214087,MATH 10B,B01,083739,Sinha; Shubham,14,0,30,16
1657978220113,MATH 18,A01,083743,Cinel; Cameron Alexander,9,0,30,21
1657978220113,MATH 18,A02,083744,Cinel; Cameron Alexander,18,0,30,12
1657978220113,MATH 18,A03,083745,Cinel; Cameron Alexander,10,0,30,20
1657978220113,MATH 18,B01,083748,Rideout; David Porter,5,0,37,32
1657978220113,MATH 18,B02,083749,Rideout; David Porter,5,0,36,31
1657978220113,MATH 18,B03,083750,Rideout; David Porter,3,0,37,34
1657978220113,MATH 18,B04,083751,Rideout; David Porter,7,0,36,29
1657978220113,MATH 18,B05,093473,Rideout; David Porter,7,0,36,29
1657978220113,MATH 18,B06,093474,Rideout; David Porter,6,0,36,30
1657978226138,MATH 20A,A01,083754,Zheng; Zequn,14,0,40,26
1657978232163,MATH 20B,A01,083756,Briones; Jor-el Thomas Caparas,4,0,36,32
1657978232163,MATH 20B,A02,083757,Briones; Jor-el Thomas Caparas,1,0,36,35
1657978232163,MATH 20B,A03,093475,Briones; Jor-el Thomas Caparas,3,0,36,33
1657978238189,MATH 20C,A01,083760,Briones; Jor-el Thomas Caparas,1,0,35,34
1657978238189,MATH 20C,A02,083761,Briones; Jor-el Thomas Caparas,8,0,35,27
1657978238189,MATH 20C,A03,093476,Briones; Jor-el Thomas Caparas,0,1,36,36
1657978238189,MATH 20C,B01,083762,Bach; Quang Tran,1,0,30,29
1657978244218,MATH 20D,A01,083765,Tran; Brian Kha,5,0,30,25
1657978244218,MATH 20D,A02,083766,Tran; Brian Kha,5,0,30,25
1657978244218,MATH 20D,A03,083767,Tran; Brian Kha,6,0,30,24
1657978250245,MATH 20E,A01,083771,Ganguly; Soumya,12,0,32,20
1657978250245,MATH 20E,A02,083772,Ganguly; Soumya,7,0,32,25
1657978250245,MATH 20E,B01,083773,Ciotti; Benjamin,20,0,35,15
1657978250245,MATH 20E,B02,083774,Ciotti; Benjamin,18,0,35,17
1657978256278,MATH 103A,A01,083777,Greenfeld; Be'Eri,6,0,36,30
1657978256278,MATH 103A,A02,083778,Greenfeld; Be'Eri,5,0,36,31
1657978256278,MATH 103A,A03,093561,Greenfeld; Be'Eri,7,0,36,29
1657978256278,MATH 103A,B01,083779,Greenfeld; Be'Eri,8,0,36,28
1657978256278,MATH 103A,B02,083780,Greenfeld; Be'Eri,4,0,36,32
1657978256278,MATH 103A,B03,093562,Greenfeld; Be'Eri,3,0,36,33
1657978262358,MATH 105,A01,085443,Carter; Anne Toulson,15,0,35,20
1657978262358,MATH 105,A02,093477,Carter; Anne Toulson,20,0,35,15
1657978268384,MATH 109,A01,083213,Ganzberger; Geoffrey Michael,3,0,34,31
1657978268384,MATH 109,A02,083214,Ganzberger; Geoffrey Michael,4,0,34,30
1657978268384,MATH 109,A03,093478,Ganzberger; Geoffrey Michael,2,0,34,32
1657978268384,MATH 109,B01,083215,Ganzberger; Geoffrey Michael,3,0,32,29
1657978268384,MATH 109,B02,083216,Ganzberger; Geoffrey Michael,3,0,32,29
1657978268384,MATH 109,B03,093479,Ganzberger; Geoffrey Michael,8,0,32,24
1657978274420,MATH 142A,A01,083219,Chow; Bennett,7,0,32,25
1657978274420,MATH 142A,A02,083220,Chow; Bennett,10,0,32,22
1657978274420,MATH 142A,A03,093480,Chow; Bennett,9,0,32,23
1657978274420,MATH 142A,B03,093481,Chow; Bennett,8,0,32,24
1657978274420,MATH 142A,B04,093558,Chow; Bennett,14,0,32,18
1657978274420,MATH 142A,B05,093559,Chow; Bennett,7,0,32,25
1657978280454,MATH 193A,A01,083224,Rotar; Vladimir,9,0,34,25
1657978280454,MATH 193A,A02,083225,Rotar; Vladimir,11,0,34,23
1657978280454,MATH 193A,A03,083781,Rotar; Vladimir,5,0,34,29
1657978280454,MATH 193A,A04,083782,Rotar; Vladimir,12,0,34,22
1657978280454,MATH 193A,A05,093482,Rotar; Vladimir,11,0,34,23
1657978286485,MATH 197,001,091859,McAuley; Julian John,9999,0,9999,0
1657978286485,MATH 197,002,095566,Kedlaya; Kiran S.,9997,0,9999,2
1657978286485,MATH 197,003,095567,Xiao; Ming,9999,0,9999,0
1657978286485,MATH 197,004,095571,Perols; Johan Lars,9998,0,9999,1
1657978293571,COGS 9,A01,083615,Shannon; Kyle Michael,11,0,75,64
1657978299603,COGS 11,A01,083617,Boyle; Mary E. T.,23,0,48,25
1657978305630,COGS 13,A01,083071,Bastos; Amalia Pinkusfeld,12,0,71,59
1657978311655,COGS 14A,A01,092681,Semenuks; Arturs,5,1,100,95
1657978317770,COGS 14B,A01,083073,Cheng; Tzu-Han,7,0,63,56
1657978323800,COGS 17,A01,092677,Semenuks; Arturs,7,0,81,74
1657978329830,COGS 100,A01,083619,Allen; Michael Gordon,17,0,70,53
1657978335856,COGS 101A,A01,083621,Davis; Joshua Daniel,9,0,68,59
1657978341885,COGS 101B,A01,091572,Allen; Michael Gordon,14,0,65,51
1657978347912,COGS 101C,A01,083625,Delgado; Tania,17,0,35,18
1657978353937,COGS 107A,A01,083627,Boyle; Mary E. T.,14,0,60,46
1657978359967,COGS 118A,A01,083075,Gupta; Anjum,21,0,76,55
1657978365995,CSE 3,A50,083646,Miranda; Gregory Joseph,24,0,50,26
1657978372017,CSE 8A,A50,083650,Miranda; Gregory Joseph,17,1,56,39
1657978378042,CSE 11,A01,083080,Cao; Yingjun,7,15,40,33
1657978384070,CSE 12,A01,083652,Krause-Levy; Sophia Louisa,30,1,120,90
1657978390095,CSE 15L,A01,083654,Morris; Justin Loren,9,0,50,41
1657978390095,CSE 15L,A02,083655,Morris; Justin Loren,11,0,50,39
1657978396120,CSE 20,A01,083657,Tran; Khoa Dang,39,0,80,41
1657978402145,CSE 21,A01,095574,Bach; Quang Tran,23,0,48,25
1657978408180,CSE 30,A01,083084,Eldon; John,8,0,80,72
1657978408180,CSE 30,B01,095061,Bhaskar; Nishant,9,0,50,41
1657978414205,CSE 100,A01,083659,Cao; Yingjun,5,4,70,65
1657978420229,CSE 134B,A01,083661,Powell; Thomas Allan,25,0,100,75
1657978426255,CSE 140,A01,083663,Gungor; Onat,17,0,85,68
1657978432282,CSE 140L,A01,083088,Eldon; John,23,0,100,77
1657978438312,CSE 175,A01,083665,Kumar; Rakesh,3,0,25,22
1657978444349,CSE 190,A00,092507,Dubnov; Shlomo,8,0,20,12
1657978450377,ECE 45,A01,083139,Congero; Spencer William,7,0,75,68
1657978456408,ECE 65,A50,083695,Saad; Andrew S,12,0,30,18
1657978456408,ECE 65,A51,095125,Saad; Andrew S,24,0,26,2
1657978462433,ECE 109,A01,091882,Touri; Behrouz,21,0,70,49
1657978468458,ECE 180,A00,083140,Abi Samra; Nicholas Camill,1,0,30,29
1657978468458,ECE 180,B00,083141,Abi Samra; Nicholas Camill,0,0,30,30
1657978474486,MATH 10A,A01,083735,Patchell; Gregory David,2,0,30,28
1657978474486,MATH 10A,A02,083736,Patchell; Gregory David,20,0,30,10
1657978474486,MATH 10A,A03,083737,Patchell; Gregory David,16,0,30,14
1657978480516,MATH 10B,A01,083207,Lim; Seonhee,9,0,34,25
1657978480516,MATH 10B,A02,083208,Lim; Seonhee,10,0,35,25
1657978480516,MATH 10B,A03,093472,Lim; Seonhee,7,0,34,27
1657978480516,MATH 10B,B01,083739,Sinha; Shubham,14,0,30,16
1657978486563,MATH 18,A01,083743,Cinel; Cameron Alexander,9,0,30,21
1657978486563,MATH 18,A02,083744,Cinel; Cameron Alexander,18,0,30,12
1657978486563,MATH 18,A03,083745,Cinel; Cameron Alexander,10,0,30,20
1657978486563,MATH 18,B01,083748,Rideout; David Porter,5,0,37,32
1657978486563,MATH 18,B02,083749,Rideout; David Porter,5,0,36,31
1657978486563,MATH 18,B03,083750,Rideout; David Porter,3,0,37,34
1657978486563,MATH 18,B04,083751,Rideout; David Porter,7,0,36,29
1657978486563,MATH 18,B05,093473,Rideout; David Porter,7,0,36,29
1657978486563,MATH 18,B06,093474,Rideout; David Porter,6,0,36,30
1657978492588,MATH 20A,A01,083754,Zheng; Zequn,14,0,40,26
1657978498615,MATH 20B,A01,083756,Briones; Jor-el Thomas Caparas,4,0,36,32
1657978498615,MATH 20B,A02,083757,Briones; Jor-el Thomas Caparas,1,0,36,35
1657978498615,MATH 20B,A03,093475,Briones; Jor-el Thomas Caparas,3,0,36,33
1657978504638,MATH 20C,A01,083760,Briones; Jor-el Thomas Caparas,1,0,35,34
1657978504638,MATH 20C,A02,083761,Briones; Jor-el Thomas Caparas,8,0,35,27
1657978504638,MATH 20C,A03,093476,Briones; Jor-el Thomas Caparas,0,1,36,36
1657978504638,MATH 20C,B01,083762,Bach; Quang Tran,1,0,30,29
1657978510670,MATH 20D,A01,083765,Tran; Brian Kha,5,0,30,25
1657978510670,MATH 20D,A02,083766,Tran; Brian Kha,5,0,30,25
1657978510670,MATH 20D,A03,083767,Tran; Brian Kha,6,0,30,24
1657978516703,MATH 20E,A01,083771,Ganguly; Soumya,12,0,32,20
1657978516703,MATH 20E,A02,083772,Ganguly; Soumya,7,0,32,25
1657978516703,MATH 20E,B01,083773,Ciotti; Benjamin,20,0,35,15
1657978516703,MATH 20E,B02,083774,Ciotti; Benjamin,18,0,35,17
1657978522736,MATH 103A,A01,083777,Greenfeld; Be'Eri,6,0,36,30
1657978522736,MATH 103A,A02,083778,Greenfeld; Be'Eri,5,0,36,31
1657978522736,MATH 103A,A03,093561,Greenfeld; Be'Eri,7,0,36,29
1657978522736,MATH 103A,B01,083779,Greenfeld; Be'Eri,8,0,36,28
1657978522736,MATH 103A,B02,083780,Greenfeld; Be'Eri,4,0,36,32
1657978522736,MATH 103A,B03,093562,Greenfeld; Be'Eri,3,0,36,33
1657978528767,MATH 105,A01,085443,Carter; Anne Toulson,15,0,35,20
1657978528767,MATH 105,A02,093477,Carter; Anne Toulson,20,0,35,15
1657978534791,MATH 109,A01,083213,Ganzberger; Geoffrey Michael,3,0,34,31
1657978534791,MATH 109,A02,083214,Ganzberger; Geoffrey Michael,4,0,34,30
1657978534791,MATH 109,A03,093478,Ganzberger; Geoffrey Michael,2,0,34,32
1657978534791,MATH 109,B01,083215,Ganzberger; Geoffrey Michael,3,0,32,29
1657978534791,MATH 109,B02,083216,Ganzberger; Geoffrey Michael,3,0,32,29
1657978534791,MATH 109,B03,093479,Ganzberger; Geoffrey Michael,8,0,32,24
1657978540818,MATH 142A,A01,083219,Chow; Bennett,7,0,32,25
1657978540818,MATH 142A,A02,083220,Chow; Bennett,10,0,32,22
1657978540818,MATH 142A,A03,093480,Chow; Bennett,9,0,32,23
1657978540818,MATH 142A,B03,093481,Chow; Bennett,8,0,32,24
1657978540818,MATH 142A,B04,093558,Chow; Bennett,14,0,32,18
1657978540818,MATH 142A,B05,093559,Chow; Bennett,7,0,32,25
1657978546857,MATH 193A,A01,083224,Rotar; Vladimir,9,0,34,25
1657978546857,MATH 193A,A02,083225,Rotar; Vladimir,11,0,34,23
1657978546857,MATH 193A,A03,083781,Rotar; Vladimir,5,0,34,29
1657978546857,MATH 193A,A04,083782,Rotar; Vladimir,12,0,34,22
1657978546857,MATH 193A,A05,093482,Rotar; Vladimir,11,0,34,23
1657978552889,MATH 197,001,091859,McAuley; Julian John,9999,0,9999,0
1657978552889,MATH 197,002,095566,Kedlaya; Kiran S.,9997,0,9999,2
1657978552889,MATH 197,003,095567,Xiao; Ming,9999,0,9999,0
1657978552889,MATH 197,004,095571,Perols; Johan Lars,9998,0,9999,1
1657978559992,COGS 9,A01,083615,Shannon; Kyle Michael,11,0,75,64
1657978566022,COGS 11,A01,083617,Boyle; Mary E. T.,23,0,48,25
1657978572051,COGS 13,A01,083071,Bastos; Amalia Pinkusfeld,12,0,71,59
1657978578084,COGS 14A,A01,092681,Semenuks; Arturs,5,1,100,95
1657978584117,COGS 14B,A01,083073,Cheng; Tzu-Han,7,0,63,56
1657978590145,COGS 17,A01,092677,Semenuks; Arturs,7,0,81,74
1657978596173,COGS 100,A01,083619,Allen; Michael Gordon,17,0,70,53
1657978602199,COGS 101A,A01,083621,Davis; Joshua Daniel,9,0,68,59
1657978608230,COGS 101B,A01,091572,Allen; Michael Gordon,14,0,65,51
1657978614257,COGS 101C,A01,083625,Delgado; Tania,17,0,35,18
1657978620281,COGS 107A,A01,083627,Boyle; Mary E. T.,14,0,60,46
1657978626310,COGS 118A,A01,083075,Gupta; Anjum,21,0,76,55
1657978632338,CSE 3,A50,083646,Miranda; Gregory Joseph,24,0,50,26
1657978638369,CSE 8A,A50,083650,Miranda; Gregory Joseph,17,1,56,39
1657978644393,CSE 11,A01,083080,Cao; Yingjun,7,15,40,33
1657978650418,CSE 12,A01,083652,Krause-Levy; Sophia Louisa,30,1,120,90
1657978656447,CSE 15L,A01,083654,Morris; Justin Loren,9,0,50,41
1657978656447,CSE 15L,A02,083655,Morris; Justin Loren,11,0,50,39
1657978662480,CSE 20,A01,083657,Tran; Khoa Dang,39,0,80,41
1657978668509,CSE 21,A01,095574,Bach; Quang Tran,23,0,48,25
1657978674541,CSE 30,A01,083084,Eldon; John,8,0,80,72
1657978674541,CSE 30,B01,095061,Bhaskar; Nishant,9,0,50,41
1657978680579,CSE 100,A01,083659,Cao; Yingjun,5,4,70,65
1657978686604,CSE 134B,A01,083661,Powell; Thomas Allan,25,0,100,75
1657978692628,CSE 140,A01,083663,Gungor; Onat,17,0,85,68
1657978698652,CSE 140L,A01,083088,Eldon; John,23,0,100,77
1657978704677,CSE 175,A01,083665,Kumar; Rakesh,3,0,25,22
1657978710704,CSE 190,A00,092507,Dubnov; Shlomo,8,0,20,12
1657978716730,ECE 45,A01,083139,Congero; Spencer William,7,0,75,68
1657978722763,ECE 65,A50,083695,Saad; Andrew S,12,0,30,18
1657978722763,ECE 65,A51,095125,Saad; Andrew S,24,0,26,2
1657978728794,ECE 109,A01,091882,Touri; Behrouz,21,0,70,49
1657978734826,ECE 180,A00,083140,Abi Samra; Nicholas Camill,1,0,30,29
1657978734826,ECE 180,B00,083141,Abi Samra; Nicholas Camill,0,0,30,30
1657978740851,MATH 10A,A01,083735,Patchell; Gregory David,2,0,30,28
1657978740851,MATH 10A,A02,083736,Patchell; Gregory David,20,0,30,10
1657978740851,MATH 10A,A03,083737,Patchell; Gregory David,16,0,30,14
1657978746880,MATH 10B,A01,083207,Lim; Seonhee,9,0,34,25
1657978746880,MATH 10B,A02,083208,Lim; Seonhee,10,0,35,25
1657978746880,MATH 10B,A03,093472,Lim; Seonhee,7,0,34,27
1657978746880,MATH 10B,B01,083739,Sinha; Shubham,14,0,30,16
1657978752922,MATH 18,A01,083743,Cinel; Cameron Alexander,9,0,30,21
1657978752922,MATH 18,A02,083744,Cinel; Cameron Alexander,18,0,30,12
1657978752922,MATH 18,A03,083745,Cinel; Cameron Alexander,10,0,30,20
1657978752922,MATH 18,B01,083748,Rideout; David Porter,5,0,37,32
1657978752922,MATH 18,B02,083749,Rideout; David Porter,5,0,36,31
1657978752922,MATH 18,B03,083750,Rideout; David Porter,3,0,37,34
1657978752922,MATH 18,B04,083751,Rideout; David Porter,7,0,36,29
1657978752922,MATH 18,B05,093473,Rideout; David Porter,7,0,36,29
1657978752922,MATH 18,B06,093474,Rideout; David Porter,6,0,36,30
1657978758948,MATH 20A,A01,083754,Zheng; Zequn,14,0,40,26
1657978764980,MATH 20B,A01,083756,Briones; Jor-el Thomas Caparas,4,0,36,32
1657978764980,MATH 20B,A02,083757,Briones; Jor-el Thomas Caparas,1,0,36,35
1657978764980,MATH 20B,A03,093475,Briones; Jor-el Thomas Caparas,3,0,36,33
1657978771012,MATH 20C,A01,083760,Briones; Jor-el Thomas Caparas,1,0,35,34
1657978771012,MATH 20C,A02,083761,Briones; Jor-el Thomas Caparas,8,0,35,27
1657978771012,MATH 20C,A03,093476,Briones; Jor-el Thomas Caparas,0,1,36,36
1657978771012,MATH 20C,B01,083762,Bach; Quang Tran,1,0,30,29
1657978777042,MATH 20D,A01,083765,Tran; Brian Kha,5,0,30,25
1657978777042,MATH 20D,A02,083766,Tran; Brian Kha,5,0,30,25
1657978777042,MATH 20D,A03,083767,Tran; Brian Kha,6,0,30,24
1657978783070,MATH 20E,A01,083771,Ganguly; Soumya,12,0,32,20
1657978783070,MATH 20E,A02,083772,Ganguly; Soumya,7,0,32,25
1657978783070,MATH 20E,B01,083773,Ciotti; Benjamin,20,0,35,15
1657978783070,MATH 20E,B02,083774,Ciotti; Benjamin,18,0,35,17
1657978789108,MATH 103A,A01,083777,Greenfeld; Be'Eri,6,0,36,30
1657978789108,MATH 103A,A02,083778,Greenfeld; Be'Eri,5,0,36,31
1657978789108,MATH 103A,A03,093561,Greenfeld; Be'Eri,7,0,36,29
1657978789108,MATH 103A,B01,083779,Greenfeld; Be'Eri,8,0,36,28
1657978789108,MATH 103A,B02,083780,Greenfeld; Be'Eri,4,0,36,32
1657978789108,MATH 103A,B03,093562,Greenfeld; Be'Eri,3,0,36,33
1657978795142,MATH 105,A01,085443,Carter; Anne Toulson,15,0,35,20
1657978795142,MATH 105,A02,093477,Carter; Anne Toulson,20,0,35,15
1657978801172,MATH 109,A01,083213,Ganzberger; Geoffrey Michael,3,0,34,31
1657978801172,MATH 109,A02,083214,Ganzberger; Geoffrey Michael,4,0,34,30
1657978801172,MATH 109,A03,093478,Ganzberger; Geoffrey Michael,2,0,34,32
1657978801172,MATH 109,B01,083215,Ganzberger; Geoffrey Michael,3,0,32,29
1657978801172,MATH 109,B02,083216,Ganzberger; Geoffrey Michael,3,0,32,29
1657978801172,MATH 109,B03,093479,Ganzberger; Geoffrey Michael,8,0,32,24
1657978807198,MATH 142A,A01,083219,Chow; Bennett,7,0,32,25
1657978807198,MATH 142A,A02,083220,Chow; Bennett,10,0,32,22
1657978807198,MATH 142A,A03,093480,Chow; Bennett,9,0,32,23
1657978807198,MATH 142A,B03,093481,Chow; Bennett,8,0,32,24
1657978807198,MATH 142A,B04,093558,Chow; Bennett,14,0,32,18
1657978807198,MATH 142A,B05,093559,Chow; Bennett,7,0,32,25
1657978813231,MATH 193A,A01,083224,Rotar; Vladimir,9,0,34,25
1657978813231,MATH 193A,A02,083225,Rotar; Vladimir,11,0,34,23
1657978813231,MATH 193A,A03,083781,Rotar; Vladimir,5,0,34,29
1657978813231,MATH 193A,A04,083782,Rotar; Vladimir,12,0,34,22
1657978813231,MATH 193A,A05,093482,Rotar; Vladimir,11,0,34,23
1657978819263,MATH 197,001,091859,McAuley; Julian John,9999,0,9999,0
1657978819263,MATH 197,002,095566,Kedlaya; Kiran S.,9997,0,9999,2
1657978819263,MATH 197,003,095567,Xiao; Ming,9999,0,9999,0
1657978819263,MATH 197,004,095571,Perols; Johan Lars,9998,0,9999,1
1657978826326,COGS 9,A01,083615,Shannon; Kyle Michael,11,0,75,64
1657978832351,COGS 11,A01,083617,Boyle; Mary E. T.,23,0,48,25
1657978838387,COGS 13,A01,083071,Bastos; Amalia Pinkusfeld,12,0,71,59
1657978844414,COGS 14A,A01,092681,Semenuks; Arturs,5,1,100,95
1657978850455,COGS 14B,A01,083073,Cheng; Tzu-Han,7,0,63,56
1657978856489,COGS 17,A01,092677,Semenuks; Arturs,7,0,81,74
1657978862525,COGS 100,A01,083619,Allen; Michael Gordon,17,0,70,53
1657978868553,COGS 101A,A01,083621,Davis; Joshua Daniel,9,0,68,59
1657978874578,COGS 101B,A01,091572,Allen; Michael Gordon,14,0,65,51
1657978880602,COGS 101C,A01,083625,Delgado; Tania,17,0,35,18
1657978886635,COGS 107A,A01,083627,Boyle; Mary E. T.,14,0,60,46
1657978892661,COGS 118A,A01,083075,Gupta; Anjum,21,0,76,55
1657978898690,CSE 3,A50,083646,Miranda; Gregory Joseph,24,0,50,26
1657978904715,CSE 8A,A50,083650,Miranda; Gregory Joseph,17,1,56,39
1657978910741,CSE 11,A01,083080,Cao; Yingjun,7,15,40,33
1657978916862,CSE 12,A01,083652,Krause-Levy; Sophia Louisa,30,1,120,90
1657978922894,CSE 15L,A01,083654,Morris; Justin Loren,9,0,50,41
1657978922894,CSE 15L,A02,083655,Morris; Justin Loren,11,0,50,39
1657978928919,CSE 20,A01,083657,Tran; Khoa Dang,39,0,80,41
1657978934942,CSE 21,A01,095574,Bach; Quang Tran,23,0,48,25
1657978940974,CSE 30,A01,083084,Eldon; John,8,0,80,72
1657978940974,CSE 30,B01,095061,Bhaskar; Nishant,9,0,50,41
1657978947006,CSE 100,A01,083659,Cao; Yingjun,5,4,70,65
1657978953032,CSE 134B,A01,083661,Powell; Thomas Allan,25,0,100,75
1657978959054,CSE 140,A01,083663,Gungor; Onat,17,0,85,68
1657978965081,CSE 140L,A01,083088,Eldon; John,23,0,100,77
1657978971109,CSE 175,A01,083665,Kumar; Rakesh,3,0,25,22
1657978977138,CSE 190,A00,092507,Dubnov; Shlomo,8,0,20,12
1657978983171,ECE 45,A01,083139,Congero; Spencer William,7,0,75,68
1657978989221,ECE 65,A50,083695,Saad; Andrew S,12,0,30,18
1657978989221,ECE 65,A51,095125,Saad; Andrew S,24,0,26,2
1657978995251,ECE 109,A01,091882,Touri; Behrouz,21,0,70,49
1657979001277,ECE 180,A00,083140,Abi Samra; Nicholas Camill,1,0,30,29
1657979001277,ECE 180,B00,083141,Abi Samra; Nicholas Camill,0,0,30,30
1657979007305,MATH 10A,A01,083735,Patchell; Gregory David,2,0,30,28
1657979007305,MATH 10A,A02,083736,Patchell; Gregory David,20,0,30,10
1657979007305,MATH 10A,A03,083737,Patchell; Gregory David,16,0,30,14
1657979013335,MATH 10B,A01,083207,Lim; Seonhee,9,0,34,25
1657979013335,MATH 10B,A02,083208,Lim; Seonhee,10,0,35,25
1657979013335,MATH 10B,A03,093472,Lim; Seonhee,7,0,34,27
1657979013335,MATH 10B,B01,083739,Sinha; Shubham,14,0,30,16
1657979019375,MATH 18,A01,083743,Cinel; Cameron Alexander,9,0,30,21
1657979019375,MATH 18,A02,083744,Cinel; Cameron Alexander,18,0,30,12
1657979019375,MATH 18,A03,083745,Cinel; Cameron Alexander,10,0,30,20
1657979019375,MATH 18,B01,083748,Rideout; David Porter,5,0,37,32
1657979019375,MATH 18,B02,083749,Rideout; David Porter,5,0,36,31
1657979019375,MATH 18,B03,083750,Rideout; David Porter,3,0,37,34
1657979019375,MATH 18,B04,083751,Rideout; David Porter,7,0,36,29
1657979019375,MATH 18,B05,093473,Rideout; David Porter,7,0,36,29
1657979019375,MATH 18,B06,093474,Rideout; David Porter,6,0,36,30
1657979025413,MATH 20A,A01,083754,Zheng; Zequn,14,0,40,26
1657979031447,MATH 20B,A01,083756,Briones; Jor-el Thomas Caparas,4,0,36,32
1657979031447,MATH 20B,A02,083757,Briones; Jor-el Thomas Caparas,1,0,36,35
1657979031447,MATH 20B,A03,093475,Briones; Jor-el Thomas Caparas,3,0,36,33
1657979037479,MATH 20C,A01,083760,Briones; Jor-el Thomas Caparas,1,0,35,34
1657979037479,MATH 20C,A02,083761,Briones; Jor-el Thomas Caparas,8,0,35,27
1657979037479,MATH 20C,A03,093476,Briones; Jor-el Thomas Caparas,0,1,36,36
1657979037479,MATH 20C,B01,083762,Bach; Quang Tran,1,0,30,29
1657979043513,MATH 20D,A01,083765,Tran; Brian Kha,5,0,30,25
1657979043513,MATH 20D,A02,083766,Tran; Brian Kha,5,0,30,25
1657979043513,MATH 20D,A03,083767,Tran; Brian Kha,6,0,30,24
1657979049545,MATH 20E,A01,083771,Ganguly; Soumya,12,0,32,20
1657979049545,MATH 20E,A02,083772,Ganguly; Soumya,7,0,32,25
1657979049545,MATH 20E,B01,083773,Ciotti; Benjamin,20,0,35,15
1657979049545,MATH 20E,B02,083774,Ciotti; Benjamin,18,0,35,17
1657979055583,MATH 103A,A01,083777,Greenfeld; Be'Eri,6,0,36,30
1657979055583,MATH 103A,A02,083778,Greenfeld; Be'Eri,5,0,36,31
1657979055583,MATH 103A,A03,093561,Greenfeld; Be'Eri,7,0,36,29
1657979055583,MATH 103A,B01,083779,Greenfeld; Be'Eri,8,0,36,28
1657979055583,MATH 103A,B02,083780,Greenfeld; Be'Eri,4,0,36,32
1657979055583,MATH 103A,B03,093562,Greenfeld; Be'Eri,3,0,36,33
1657979061611,MATH 105,A01,085443,Carter; Anne Toulson,15,0,35,20
1657979061611,MATH 105,A02,093477,Carter; Anne Toulson,20,0,35,15
1657979067660,MATH 109,A01,083213,Ganzberger; Geoffrey Michael,3,0,34,31
1657979067660,MATH 109,A02,083214,Ganzberger; Geoffrey Michael,4,0,34,30
1657979067660,MATH 109,A03,093478,Ganzberger; Geoffrey Michael,2,0,34,32
1657979067660,MATH 109,B01,083215,Ganzberger; Geoffrey Michael,3,0,32,29
1657979067660,MATH 109,B02,083216,Ganzberger; Geoffrey Michael,3,0,32,29
1657979067660,MATH 109,B03,093479,Ganzberger; Geoffrey Michael,8,0,32,24
1657979073688,MATH 142A,A01,083219,Chow; Bennett,7,0,32,25
1657979073688,MATH 142A,A02,083220,Chow; Bennett,10,0,32,22
1657979073688,MATH 142A,A03,093480,Chow; Bennett,9,0,32,23
1657979073688,MATH 142A,B03,093481,Chow; Bennett,8,0,32,24
1657979073688,MATH 142A,B04,093558,Chow; Bennett,14,0,32,18
1657979073688,MATH 142A,B05,093559,Chow; Bennett,7,0,32,25
1657979079720,MATH 193A,A01,083224,Rotar; Vladimir,9,0,34,25
1657979079720,MATH 193A,A02,083225,Rotar; Vladimir,11,0,34,23
1657979079720,MATH 193A,A03,083781,Rotar; Vladimir,5,0,34,29
1657979079720,MATH 193A,A04,083782,Rotar; Vladimir,12,0,34,22
1657979079720,MATH 193A,A05,093482,Rotar; Vladimir,11,0,34,23
1657979085753,MATH 197,001,091859,McAuley; Julian John,9999,0,9999,0
1657979085753,MATH 197,002,095566,Kedlaya; Kiran S.,9997,0,9999,2
1657979085753,MATH 197,003,095567,Xiao; Ming,9999,0,9999,0
1657979085753,MATH 197,004,095571,Perols; Johan Lars,9998,0,9999,1
1657979092821,COGS 9,A01,083615,Shannon; Kyle Michael,11,0,75,64
1657979098847,COGS 11,A01,083617,Boyle; Mary E. T.,23,0,48,25
1657979104871,COGS 13,A01,083071,Bastos; Amalia Pinkusfeld,12,0,71,59
1657979110906,COGS 14A,A01,092681,Semenuks; Arturs,5,1,100,95
1657979116940,COGS 14B,A01,083073,Cheng; Tzu-Han,7,0,63,56
1657979122964,COGS 17,A01,092677,Semenuks; Arturs,7,0,81,74
1657979128989,COGS 100,A01,083619,Allen; Michael Gordon,17,0,70,53
1657979135016,COGS 101A,A01,083621,Davis; Joshua Daniel,9,0,68,59
1657979141045,COGS 101B,A01,091572,Allen; Michael Gordon,14,0,65,51
1657979147078,COGS 101C,A01,083625,Delgado; Tania,17,0,35,18
1657979153107,COGS 107A,A01,083627,Boyle; Mary E. T.,14,0,60,46
1657979159137,COGS 118A,A01,083075,Gupta; Anjum,21,0,76,55
1657979165165,CSE 3,A50,083646,Miranda; Gregory Joseph,24,0,50,26
1657979171197,CSE 8A,A50,083650,Miranda; Gregory Joseph,17,1,56,39
1657979177226,CSE 11,A01,083080,Cao; Yingjun,7,15,40,33
1657979183256,CSE 12,A01,083652,Krause-Levy; Sophia Louisa,30,1,120,90
1657979189282,CSE 15L,A01,083654,Morris; Justin Loren,9,0,50,41
1657979189282,CSE 15L,A02,083655,Morris; Justin Loren,11,0,50,39
1657979195306,CSE 20,A01,083657,Tran; Khoa Dang,39,0,80,41
1657979201341,CSE 21,A01,095574,Bach; Quang Tran,23,0,48,25
1657979207366,CSE 30,A01,083084,Eldon; John,8,0,80,72
1657979207366,CSE 30,B01,095061,Bhaskar; Nishant,9,0,50,41
1657979213393,CSE 100,A01,083659,Cao; Yingjun,5,4,70,65
1657979219436,CSE 134B,A01,083661,Powell; Thomas Allan,25,0,100,75
1657979225469,CSE 140,A01,083663,Gungor; Onat,17,0,85,68
1657979231497,CSE 140L,A01,083088,Eldon; John,23,0,100,77
1657979237530,CSE 175,A01,083665,Kumar; Rakesh,3,0,25,22
1657979243557,CSE 190,A00,092507,Dubnov; Shlomo,8,0,20,12
1657979249591,ECE 45,A01,083139,Congero; Spencer William,7,0,75,68
1657979255620,ECE 65,A50,083695,Saad; Andrew S,12,0,30,18
1657979255620,ECE 65,A51,095125,Saad; Andrew S,24,0,26,2
1657979261644,ECE 109,A01,091882,Touri; Behrouz,21,0,70,49
1657979267670,ECE 180,A00,083140,Abi Samra; Nicholas Camill,1,0,30,29
1657979267670,ECE 180,B00,083141,Abi Samra; Nicholas Camill,0,0,30,30
1657979273702,MATH 10A,A01,083735,Patchell; Gregory David,2,0,30,28
1657979273702,MATH 10A,A02,083736,Patchell; Gregory David,20,0,30,10
1657979273702,MATH 10A,A03,083737,Patchell; Gregory David,16,0,30,14
1657979279731,MATH 10B,A01,083207,Lim; Seonhee,9,0,34,25
1657979279731,MATH 10B,A02,083208,Lim; Seonhee,10,0,35,25
1657979279731,MATH 10B,A03,093472,Lim; Seonhee,7,0,34,27
1657979279731,MATH 10B,B01,083739,Sinha; Shubham,14,0,30,16
1657979285775,MATH 18,A01,083743,Cinel; Cameron Alexander,9,0,30,21
1657979285775,MATH 18,A02,083744,Cinel; Cameron Alexander,18,0,30,12
1657979285775,MATH 18,A03,083745,Cinel; Cameron Alexander,10,0,30,20
1657979285775,MATH 18,B01,083748,Rideout; David Porter,5,0,37,32
1657979285775,MATH 18,B02,083749,Rideout; David Porter,5,0,36,31
1657979285775,MATH 18,B03,083750,Rideout; David Porter,3,0,37,34
1657979285775,MATH 18,B04,083751,Rideout; David Porter,7,0,36,29
1657979285775,MATH 18,B05,093473,Rideout; David Porter,7,0,36,29
1657979285775,MATH 18,B06,093474,Rideout; David Porter,6,0,36,30
1657979291816,MATH 20A,A01,083754,Zheng; Zequn,14,0,40,26
1657979297848,MATH 20B,A01,083756,Briones; Jor-el Thomas Caparas,4,0,36,32
1657979297848,MATH 20B,A02,083757,Briones; Jor-el Thomas Caparas,1,0,36,35
1657979297848,MATH 20B,A03,093475,Briones; Jor-el Thomas Caparas,3,0,36,33
1657979303874,MATH 20C,A01,083760,Briones; Jor-el Thomas Caparas,1,0,35,34
1657979303874,MATH 20C,A02,083761,Briones; Jor-el Thomas Caparas,8,0,35,27
1657979303874,MATH 20C,A03,093476,Briones; Jor-el Thomas Caparas,0,1,36,36
1657979303874,MATH 20C,B01,083762,Bach; Quang Tran,1,0,30,29
1657979309905,MATH 20D,A01,083765,Tran; Brian Kha,5,0,30,25
1657979309905,MATH 20D,A02,083766,Tran; Brian Kha,5,0,30,25
1657979309905,MATH 20D,A03,083767,Tran; Brian Kha,6,0,30,24
1657979315931,MATH 20E,A01,083771,Ganguly; Soumya,12,0,32,20
1657979315931,MATH 20E,A02,083772,Ganguly; Soumya,7,0,32,25
1657979315931,MATH 20E,B01,083773,Ciotti; Benjamin,20,0,35,15
1657979315931,MATH 20E,B02,083774,Ciotti; Benjamin,18,0,35,17
1657979321960,MATH 103A,A01,083777,Greenfeld; Be'Eri,6,0,36,30
1657979321960,MATH 103A,A02,083778,Greenfeld; Be'Eri,5,0,36,31
1657979321960,MATH 103A,A03,093561,Greenfeld; Be'Eri,7,0,36,29
1657979321960,MATH 103A,B01,083779,Greenfeld; Be'Eri,8,0,36,28
1657979321960,MATH 103A,B02,083780,Greenfeld; Be'Eri,4,0,36,32
1657979321960,MATH 103A,B03,093562,Greenfeld; Be'Eri,3,0,36,33
1657979327985,MATH 105,A01,085443,Carter; Anne Toulson,15,0,35,20
1657979327985,MATH 105,A02,093477,Carter; Anne Toulson,20,0,35,15
1657979334016,MATH 109,A01,083213,Ganzberger; Geoffrey Michael,3,0,34,31
1657979334016,MATH 109,A02,083214,Ganzberger; Geoffrey Michael,4,0,34,30
1657979334016,MATH 109,A03,093478,Ganzberger; Geoffrey Michael,2,0,34,32
1657979334016,MATH 109,B01,083215,Ganzberger; Geoffrey Michael,3,0,32,29
1657979334016,MATH 109,B02,083216,Ganzberger; Geoffrey Michael,3,0,32,29
1657979334016,MATH 109,B03,093479,Ganzberger; Geoffrey Michael,8,0,32,24
1657979340042,MATH 142A,A01,083219,Chow; Bennett,7,0,32,25
1657979340042,MATH 142A,A02,083220,Chow; Bennett,10,0,32,22
1657979340042,MATH 142A,A03,093480,Chow; Bennett,9,0,32,23
1657979340042,MATH 142A,B03,093481,Chow; Bennett,8,0,32,24
1657979340042,MATH 142A,B04,093558,Chow; Bennett,14,0,32,18
1657979340042,MATH 142A,B05,093559,Chow; Bennett,7,0,32,25
1657979346065,MATH 193A,A01,083224,Rotar; Vladimir,9,0,34,25
1657979346065,MATH 193A,A02,083225,Rotar; Vladimir,11,0,34,23
1657979346065,MATH 193A,A03,083781,Rotar; Vladimir,5,0,34,29
1657979346065,MATH 193A,A04,083782,Rotar; Vladimir,12,0,34,22
1657979346065,MATH 193A,A05,093482,Rotar; Vladimir,11,0,34,23
1657979352090,MATH 197,001,091859,McAuley; Julian John,9999,0,9999,0
1657979352090,MATH 197,002,095566,Kedlaya; Kiran S.,9997,0,9999,2
1657979352090,MATH 197,003,095567,Xiao; Ming,9999,0,9999,0
1657979352090,MATH 197,004,095571,Perols; Johan Lars,9998,0,9999,1
1657979359184,COGS 9,A01,083615,Shannon; Kyle Michael,11,0,75,64
1657979365214,COGS 11,A01,083617,Boyle; Mary E. T.,23,0,48,25
1657979371256,COGS 13,A01,083071,Bastos; Amalia Pinkusfeld,12,0,71,59
1657979377282,COGS 14A,A01,092681,Semenuks; Arturs,5,1,100,95
1657979383306,COGS 14B,A01,083073,Cheng; Tzu-Han,7,0,63,56
1657979389333,COGS 17,A01,092677,Semenuks; Arturs,7,0,81,74
1657979395364,COGS 100,A01,083619,Allen; Michael Gordon,17,0,70,53
1657979401392,COGS 101A,A01,083621,Davis; Joshua Daniel,9,0,68,59
1657979407429,COGS 101B,A01,091572,Allen; Michael Gordon,14,0,65,51
1657979413456,COGS 101C,A01,083625,Delgado; Tania,17,0,35,18
1657979419481,COGS 107A,A01,083627,Boyle; Mary E. T.,14,0,60,46
1657979425506,COGS 118A,A01,083075,Gupta; Anjum,21,0,76,55
1657979431542,CSE 3,A50,083646,Miranda; Gregory Joseph,24,0,50,26
1657979437565,CSE 8A,A50,083650,Miranda; Gregory Joseph,17,1,56,39
1657979443601,CSE 11,A01,083080,Cao; Yingjun,7,15,40,33
1657979449627,CSE 12,A01,083652,Krause-Levy; Sophia Louisa,30,1,120,90
1657979455654,CSE 15L,A01,083654,Morris; Justin Loren,9,0,50,41
1657979455654,CSE 15L,A02,083655,Morris; Justin Loren,11,0,50,39
1657979461680,CSE 20,A01,083657,Tran; Khoa Dang,39,0,80,41
1657979467708,CSE 21,A01,095574,Bach; Quang Tran,23,0,48,25
1657979473733,CSE 30,A01,083084,Eldon; John,8,0,80,72
1657979473733,CSE 30,B01,095061,Bhaskar; Nishant,9,0,50,41
1657979479756,CSE 100,A01,083659,Cao; Yingjun,5,4,70,65
1657979485783,CSE 134B,A01,083661,Powell; Thomas Allan,25,0,100,75
1657979491806,CSE 140,A01,083663,Gungor; Onat,17,0,85,68
1657979497836,CSE 140L,A01,083088,Eldon; John,23,0,100,77
1657979503862,CSE 175,A01,083665,Kumar; Rakesh,3,0,25,22
1657979509891,CSE 190,A00,092507,Dubnov; Shlomo,8,0,20,12
1657979515992,ECE 45,A01,083139,Congero; Spencer William,7,0,75,68
1657979522024,ECE 65,A50,083695,Saad; Andrew S,12,0,30,18
1657979522024,ECE 65,A51,095125,Saad; Andrew S,24,0,26,2
1657979528048,ECE 109,A01,091882,Touri; Behrouz,21,0,70,49
1657979534078,ECE 180,A00,083140,Abi Samra; Nicholas Camill,1,0,30,29
1657979534078,ECE 180,B00,083141,Abi Samra; Nicholas Camill,0,0,30,30
1657979540112,MATH 10A,A01,083735,Patchell; Gregory David,2,0,30,28
1657979540112,MATH 10A,A02,083736,Patchell; Gregory David,20,0,30,10
1657979540112,MATH 10A,A03,083737,Patchell; Gregory David,16,0,30,14
1657979546140,MATH 10B,A01,083207,Lim; Seonhee,9,0,34,25
1657979546140,MATH 10B,A02,083208,Lim; Seonhee,10,0,35,25
1657979546140,MATH 10B,A03,093472,Lim; Seonhee,7,0,34,27
1657979546140,MATH 10B,B01,083739,Sinha; Shubham,14,0,30,16
1657979552170,MATH 18,A01,083743,Cinel; Cameron Alexander,9,0,30,21
1657979552170,MATH 18,A02,083744,Cinel; Cameron Alexander,18,0,30,12
1657979552170,MATH 18,A03,083745,Cinel; Cameron Alexander,10,0,30,20
1657979552170,MATH 18,B01,083748,Rideout; David Porter,5,0,37,32
1657979552170,MATH 18,B02,083749,Rideout; David Porter,5,0,36,31
1657979552170,MATH 18,B03,083750,Rideout; David Porter,3,0,37,34
1657979552170,MATH 18,B04,083751,Rideout; David Porter,7,0,36,29
1657979552170,MATH 18,B05,093473,Rideout; David Porter,7,0,36,29
1657979552170,MATH 18,B06,093474,Rideout; David Porter,6,0,36,30
1657979558195,MATH 20A,A01,083754,Zheng; Zequn,14,0,40,26
1657979564223,MATH 20B,A01,083756,Briones; Jor-el Thomas Caparas,4,0,36,32
1657979564223,MATH 20B,A02,083757,Briones; Jor-el Thomas Caparas,1,0,36,35
1657979564223,MATH 20B,A03,093475,Briones; Jor-el Thomas Caparas,3,0,36,33
1657979570253,MATH 20C,A01,083760,Briones; Jor-el Thomas Caparas,1,0,35,34
1657979570253,MATH 20C,A02,083761,Briones; Jor-el Thomas Caparas,8,0,35,27
1657979570253,MATH 20C,A03,093476,Briones; Jor-el Thomas Caparas,0,1,36,36
1657979570253,MATH 20C,B01,083762,Bach; Quang Tran,1,0,30,29
1657979576281,MATH 20D,A01,083765,Tran; Brian Kha,5,0,30,25
1657979576281,MATH 20D,A02,083766,Tran; Brian Kha,5,0,30,25
1657979576281,MATH 20D,A03,083767,Tran; Brian Kha,6,0,30,24
1657979582308,MATH 20E,A01,083771,Ganguly; Soumya,12,0,32,20
1657979582308,MATH 20E,A02,083772,Ganguly; Soumya,7,0,32,25
1657979582308,MATH 20E,B01,083773,Ciotti; Benjamin,20,0,35,15
1657979582308,MATH 20E,B02,083774,Ciotti; Benjamin,18,0,35,17
1657979588334,MATH 103A,A01,083777,Greenfeld; Be'Eri,6,0,36,30
1657979588334,MATH 103A,A02,083778,Greenfeld; Be'Eri,5,0,36,31
1657979588334,MATH 103A,A03,093561,Greenfeld; Be'Eri,7,0,36,29
1657979588334,MATH 103A,B01,083779,Greenfeld; Be'Eri,8,0,36,28
1657979588334,MATH 103A,B02,083780,Greenfeld; Be'Eri,4,0,36,32
1657979588334,MATH 103A,B03,093562,Greenfeld; Be'Eri,3,0,36,33
1657979594360,MATH 105,A01,085443,Carter; Anne Toulson,15,0,35,20
1657979594360,MATH 105,A02,093477,Carter; Anne Toulson,20,0,35,15
1657979600385,MATH 109,A01,083213,Ganzberger; Geoffrey Michael,3,0,34,31
1657979600385,MATH 109,A02,083214,Ganzberger; Geoffrey Michael,4,0,34,30
1657979600385,MATH 109,A03,093478,Ganzberger; Geoffrey Michael,2,0,34,32
1657979600385,MATH 109,B01,083215,Ganzberger; Geoffrey Michael,3,0,32,29
1657979600385,MATH 109,B02,083216,Ganzberger; Geoffrey Michael,3,0,32,29
1657979600385,MATH 109,B03,093479,Ganzberger; Geoffrey Michael,8,0,32,24
1657979606421,MATH 142A,A01,083219,Chow; Bennett,7,0,32,25
1657979606421,MATH 142A,A02,083220,Chow; Bennett,10,0,32,22
1657979606421,MATH 142A,A03,093480,Chow; Bennett,9,0,32,23
1657979606421,MATH 142A,B03,093481,Chow; Bennett,8,0,32,24
1657979606421,MATH 142A,B04,093558,Chow; Bennett,14,0,32,18
1657979606421,MATH 142A,B05,093559,Chow; Bennett,7,0,32,25
1657979612458,MATH 193A,A01,083224,Rotar; Vladimir,9,0,34,25
1657979612458,MATH 193A,A02,083225,Rotar; Vladimir,11,0,34,23
1657979612458,MATH 193A,A03,083781,Rotar; Vladimir,5,0,34,29
1657979612458,MATH 193A,A04,083782,Rotar; Vladimir,12,0,34,22
1657979612458,MATH 193A,A05,093482,Rotar; Vladimir,11,0,34,23
1657979618484,MATH 197,001,091859,McAuley; Julian John,9999,0,9999,0
1657979618484,MATH 197,002,095566,Kedlaya; Kiran S.,9997,0,9999,2
1657979618484,MATH 197,003,095567,Xiao; Ming,9999,0,9999,0
1657979618484,MATH 197,004,095571,Perols; Johan Lars,9998,0,9999,1
1657979625553,COGS 9,A01,083615,Shannon; Kyle Michael,11,0,75,64
1657979631579,COGS 11,A01,083617,Boyle; Mary E. T.,23,0,48,25
1657979637605,COGS 13,A01,083071,Bastos; Amalia Pinkusfeld,12,0,71,59
1657979643638,COGS 14A,A01,092681,Semenuks; Arturs,5,1,100,95
1657979649668,COGS 14B,A01,083073,Cheng; Tzu-Han,7,0,63,56
1657979655697,COGS 17,A01,092677,Semenuks; Arturs,7,0,81,74
1657979661725,COGS 100,A01,083619,Allen; Michael Gordon,17,0,70,53
1657979667750,COGS 101A,A01,083621,Davis; Joshua Daniel,9,0,68,59
1657979673782,COGS 101B,A01,091572,Allen; Michael Gordon,14,0,65,51
1657979679807,COGS 101C,A01,083625,Delgado; Tania,17,0,35,18
1657979685833,COGS 107A,A01,083627,Boyle; Mary E. T.,14,0,60,46
1657979691860,COGS 118A,A01,083075,Gupta; Anjum,21,0,76,55
1657979697887,CSE 3,A50,083646,Miranda; Gregory Joseph,24,0,50,26
1657979703911,CSE 8A,A50,083650,Miranda; Gregory Joseph,17,1,56,39
1657979709935,CSE 11,A01,083080,Cao; Yingjun,7,15,40,33
1657979715962,CSE 12,A01,083652,Krause-Levy; Sophia Louisa,30,1,120,90
1657979721989,CSE 15L,A01,083654,Morris; Justin Loren,9,0,50,41
1657979721989,CSE 15L,A02,083655,Morris; Justin Loren,11,0,50,39
1657979728014,CSE 20,A01,083657,Tran; Khoa Dang,39,0,80,41
1657979734045,CSE 21,A01,095574,Bach; Quang Tran,23,0,48,25
1657979740077,CSE 30,A01,083084,Eldon; John,8,0,80,72
1657979740077,CSE 30,B01,095061,Bhaskar; Nishant,9,0,50,41
1657979746101,CSE 100,A01,083659,Cao; Yingjun,5,4,70,65
1657979752125,CSE 134B,A01,083661,Powell; Thomas Allan,25,0,100,75
1657979758151,CSE 140,A01,083663,Gungor; Onat,17,0,85,68
1657979764179,CSE 140L,A01,083088,Eldon; John,23,0,100,77
1657979770203,CSE 175,A01,083665,Kumar; Rakesh,3,0,25,22
1657979776229,CSE 190,A00,092507,Dubnov; Shlomo,8,0,20,12
1657979782259,ECE 45,A01,083139,Congero; Spencer William,7,0,75,68
1657979788291,ECE 65,A50,083695,Saad; Andrew S,12,0,30,18
1657979788291,ECE 65,A51,095125,Saad; Andrew S,24,0,26,2
1657979794316,ECE 109,A01,091882,Touri; Behrouz,21,0,70,49
1657979800345,ECE 180,A00,083140,Abi Samra; Nicholas Camill,1,0,30,29
1657979800345,ECE 180,B00,083141,Abi Samra; Nicholas Camill,0,0,30,30
1657979806374,MATH 10A,A01,083735,Patchell; Gregory David,2,0,30,28
1657979806374,MATH 10A,A02,083736,Patchell; Gregory David,20,0,30,10
1657979806374,MATH 10A,A03,083737,Patchell; Gregory David,16,0,30,14
1657979812405,MATH 10B,A01,083207,Lim; Seonhee,9,0,34,25
1657979812405,MATH 10B,A02,083208,Lim; Seonhee,10,0,35,25
1657979812405,MATH 10B,A03,093472,Lim; Seonhee,7,0,34,27
1657979812405,MATH 10B,B01,083739,Sinha; Shubham,14,0,30,16
1657979818435,MATH 18,A01,083743,Cinel; Cameron Alexander,9,0,30,21
1657979818435,MATH 18,A02,083744,Cinel; Cameron Alexander,18,0,30,12
1657979818435,MATH 18,A03,083745,Cinel; Cameron Alexander,10,0,30,20
1657979818435,MATH 18,B01,083748,Rideout; David Porter,5,0,37,32
1657979818435,MATH 18,B02,083749,Rideout; David Porter,5,0,36,31
1657979818435,MATH 18,B03,083750,Rideout; David Porter,3,0,37,34
1657979818435,MATH 18,B04,083751,Rideout; David Porter,7,0,36,29
1657979818435,MATH 18,B05,093473,Rideout; David Porter,7,0,36,29
1657979818435,MATH 18,B06,093474,Rideout; David Porter,6,0,36,30
1657979824464,MATH 20A,A01,083754,Zheng; Zequn,14,0,40,26
1657979830512,MATH 20B,A01,083756,Briones; Jor-el Thomas Caparas,4,0,36,32
1657979830512,MATH 20B,A02,083757,Briones; Jor-el Thomas Caparas,1,0,36,35
1657979830512,MATH 20B,A03,093475,Briones; Jor-el Thomas Caparas,3,0,36,33
1657979836544,MATH 20C,A01,083760,Briones; Jor-el Thomas Caparas,1,0,35,34
1657979836544,MATH 20C,A02,083761,Briones; Jor-el Thomas Caparas,8,0,35,27
1657979836544,MATH 20C,A03,093476,Briones; Jor-el Thomas Caparas,0,1,36,36
1657979836544,MATH 20C,B01,083762,Bach; Quang Tran,1,0,30,29
1657979842581,MATH 20D,A01,083765,Tran; Brian Kha,5,0,30,25
1657979842581,MATH 20D,A02,083766,Tran; Brian Kha,5,0,30,25
1657979842581,MATH 20D,A03,083767,Tran; Brian Kha,6,0,30,24
1657979848609,MATH 20E,A01,083771,Ganguly; Soumya,12,0,32,20
1657979848609,MATH 20E,A02,083772,Ganguly; Soumya,7,0,32,25
1657979848609,MATH 20E,B01,083773,Ciotti; Benjamin,20,0,35,15
1657979848609,MATH 20E,B02,083774,Ciotti; Benjamin,18,0,35,17
1657979854637,MATH 103A,A01,083777,Greenfeld; Be'Eri,6,0,36,30
1657979854637,MATH 103A,A02,083778,Greenfeld; Be'Eri,5,0,36,31
1657979854637,MATH 103A,A03,093561,Greenfeld; Be'Eri,7,0,36,29
1657979854637,MATH 103A,B01,083779,Greenfeld; Be'Eri,8,0,36,28
1657979854637,MATH 103A,B02,083780,Greenfeld; Be'Eri,4,0,36,32
1657979854637,MATH 103A,B03,093562,Greenfeld; Be'Eri,3,0,36,33
1657979860667,MATH 105,A01,085443,Carter; Anne Toulson,15,0,35,20
1657979860667,MATH 105,A02,093477,Carter; Anne Toulson,20,0,35,15
1657979866690,MATH 109,A01,083213,Ganzberger; Geoffrey Michael,3,0,34,31
1657979866690,MATH 109,A02,083214,Ganzberger; Geoffrey Michael,4,0,34,30
1657979866690,MATH 109,A03,093478,Ganzberger; Geoffrey Michael,2,0,34,32
1657979866690,MATH 109,B01,083215,Ganzberger; Geoffrey Michael,3,0,32,29
1657979866690,MATH 109,B02,083216,Ganzberger; Geoffrey Michael,3,0,32,29
1657979866690,MATH 109,B03,093479,Ganzberger; Geoffrey Michael,8,0,32,24
1657979872719,MATH 142A,A01,083219,Chow; Bennett,7,0,32,25
1657979872719,MATH 142A,A02,083220,Chow; Bennett,10,0,32,22
1657979872719,MATH 142A,A03,093480,Chow; Bennett,9,0,32,23
1657979872719,MATH 142A,B03,093481,Chow; Bennett,8,0,32,24
1657979872719,MATH 142A,B04,093558,Chow; Bennett,14,0,32,18
1657979872719,MATH 142A,B05,093559,Chow; Bennett,7,0,32,25
1657979878751,MATH 193A,A01,083224,Rotar; Vladimir,9,0,34,25
1657979878751,MATH 193A,A02,083225,Rotar; Vladimir,11,0,34,23
1657979878751,MATH 193A,A03,083781,Rotar; Vladimir,5,0,34,29
1657979878751,MATH 193A,A04,083782,Rotar; Vladimir,12,0,34,22
1657979878751,MATH 193A,A05,093482,Rotar; Vladimir,11,0,34,23
1657979884779,MATH 197,001,091859,McAuley; Julian John,9999,0,9999,0
1657979884779,MATH 197,002,095566,Kedlaya; Kiran S.,9997,0,9999,2
1657979884779,MATH 197,003,095567,Xiao; Ming,9999,0,9999,0
1657979884779,MATH 197,004,095571,Perols; Johan Lars,9998,0,9999,1
1657979891836,COGS 9,A01,083615,Shannon; Kyle Michael,11,0,75,64
1657979897862,COGS 11,A01,083617,Boyle; Mary E. T.,23,0,48,25
1657979903891,COGS 13,A01,083071,Bastos; Amalia Pinkusfeld,12,0,71,59
1657979909918,COGS 14A,A01,092681,Semenuks; Arturs,5,1,100,95
1657979915943,COGS 14B,A01,083073,Cheng; Tzu-Han,7,0,63,56
1657979921975,COGS 17,A01,092677,Semenuks; Arturs,7,0,81,74
1657979928000,COGS 100,A01,083619,Allen; Michael Gordon,17,0,70,53
1657979934024,COGS 101A,A01,083621,Davis; Joshua Daniel,9,0,68,59
1657979940048,COGS 101B,A01,091572,Allen; Michael Gordon,14,0,65,51
1657979946074,COGS 101C,A01,083625,Delgado; Tania,17,0,35,18
1657979952099,COGS 107A,A01,083627,Boyle; Mary E. T.,14,0,60,46
1657979958127,COGS 118A,A01,083075,Gupta; Anjum,21,0,76,55
1657979964154,CSE 3,A50,083646,Miranda; Gregory Joseph,24,0,50,26
1657979970178,CSE 8A,A50,083650,Miranda; Gregory Joseph,17,1,56,39
1657979976204,CSE 11,A01,083080,Cao; Yingjun,7,15,40,33
1657979982235,CSE 12,A01,083652,Krause-Levy; Sophia Louisa,30,1,120,90
1657979988261,CSE 15L,A01,083654,Morris; Justin Loren,9,0,50,41
1657979988261,CSE 15L,A02,083655,Morris; Justin Loren,11,0,50,39
1657979994288,CSE 20,A01,083657,Tran; Khoa Dang,39,0,80,41
1657980000319,CSE 21,A01,095574,Bach; Quang Tran,23,0,48,25
1657980006349,CSE 30,A01,083084,Eldon; John,8,0,80,72
1657980006349,CSE 30,B01,095061,Bhaskar; Nishant,9,0,50,41
1657980012373,CSE 100,A01,083659,Cao; Yingjun,5,4,70,65
1657980018404,CSE 134B,A01,083661,Powell; Thomas Allan,25,0,100,75
1657980024429,CSE 140,A01,083663,Gungor; Onat,17,0,85,68
1657980030457,CSE 140L,A01,083088,Eldon; John,23,0,100,77
1657980036493,CSE 175,A01,083665,Kumar; Rakesh,3,0,25,22
1657980042522,CSE 190,A00,092507,Dubnov; Shlomo,8,0,20,12
1657980048563,ECE 45,A01,083139,Congero; Spencer William,7,0,75,68
1657980054594,ECE 65,A50,083695,Saad; Andrew S,12,0,30,18
1657980054594,ECE 65,A51,095125,Saad; Andrew S,24,0,26,2
1657980060620,ECE 109,A01,091882,Touri; Behrouz,21,0,70,49
1657980066650,ECE 180,A00,083140,Abi Samra; Nicholas Camill,1,0,30,29
1657980066650,ECE 180,B00,083141,Abi Samra; Nicholas Camill,0,0,30,30
1657980072682,MATH 10A,A01,083735,Patchell; Gregory David,2,0,30,28
1657980072682,MATH 10A,A02,083736,Patchell; Gregory David,20,0,30,10
1657980072682,MATH 10A,A03,083737,Patchell; Gregory David,16,0,30,14
1657980078716,MATH 10B,A01,083207,Lim; Seonhee,9,0,34,25
1657980078716,MATH 10B,A02,083208,Lim; Seonhee,10,0,35,25
1657980078716,MATH 10B,A03,093472,Lim; Seonhee,7,0,34,27
1657980078716,MATH 10B,B01,083739,Sinha; Shubham,14,0,30,16
1657980084754,MATH 18,A01,083743,Cinel; Cameron Alexander,9,0,30,21
1657980084754,MATH 18,A02,083744,Cinel; Cameron Alexander,18,0,30,12
1657980084754,MATH 18,A03,083745,Cinel; Cameron Alexander,10,0,30,20
1657980084754,MATH 18,B01,083748,Rideout; David Porter,5,0,37,32
1657980084754,MATH 18,B02,083749,Rideout; David Porter,5,0,36,31
1657980084754,MATH 18,B03,083750,Rideout; David Porter,3,0,37,34
1657980084754,MATH 18,B04,083751,Rideout; David Porter,7,0,36,29
1657980084754,MATH 18,B05,093473,Rideout; David Porter,7,0,36,29
1657980084754,MATH 18,B06,093474,Rideout; David Porter,6,0,36,30
1657980090781,MATH 20A,A01,083754,Zheng; Zequn,14,0,40,26
1657980096807,MATH 20B,A01,083756,Briones; Jor-el Thomas Caparas,4,0,36,32
1657980096807,MATH 20B,A02,083757,Briones; Jor-el Thomas Caparas,1,0,36,35
1657980096807,MATH 20B,A03,093475,Briones; Jor-el Thomas Caparas,3,0,36,33
1657980102831,MATH 20C,A01,083760,Briones; Jor-el Thomas Caparas,1,0,35,34
1657980102831,MATH 20C,A02,083761,Briones; Jor-el Thomas Caparas,8,0,35,27
1657980102831,MATH 20C,A03,093476,Briones; Jor-el Thomas Caparas,0,1,36,36
1657980102831,MATH 20C,B01,083762,Bach; Quang Tran,1,0,30,29
1657980108863,MATH 20D,A01,083765,Tran; Brian Kha,5,0,30,25
1657980108863,MATH 20D,A02,083766,Tran; Brian Kha,5,0,30,25
1657980108863,MATH 20D,A03,083767,Tran; Brian Kha,6,0,30,24
1657980114964,MATH 20E,A01,083771,Ganguly; Soumya,12,0,32,20
1657980114964,MATH 20E,A02,083772,Ganguly; Soumya,7,0,32,25
1657980114964,MATH 20E,B01,083773,Ciotti; Benjamin,20,0,35,15
1657980114964,MATH 20E,B02,083774,Ciotti; Benjamin,18,0,35,17
1657980120989,MATH 103A,A01,083777,Greenfeld; Be'Eri,6,0,36,30
1657980120989,MATH 103A,A02,083778,Greenfeld; Be'Eri,5,0,36,31
1657980120989,MATH 103A,A03,093561,Greenfeld; Be'Eri,7,0,36,29
1657980120989,MATH 103A,B01,083779,Greenfeld; Be'Eri,8,0,36,28
1657980120989,MATH 103A,B02,083780,Greenfeld; Be'Eri,4,0,36,32
1657980120989,MATH 103A,B03,093562,Greenfeld; Be'Eri,3,0,36,33
1657980127015,MATH 105,A01,085443,Carter; Anne Toulson,15,0,35,20
1657980127015,MATH 105,A02,093477,Carter; Anne Toulson,20,0,35,15
1657980133048,MATH 109,A01,083213,Ganzberger; Geoffrey Michael,3,0,34,31
1657980133048,MATH 109,A02,083214,Ganzberger; Geoffrey Michael,4,0,34,30
1657980133048,MATH 109,A03,093478,Ganzberger; Geoffrey Michael,2,0,34,32
1657980133048,MATH 109,B01,083215,Ganzberger; Geoffrey Michael,3,0,32,29
1657980133048,MATH 109,B02,083216,Ganzberger; Geoffrey Michael,3,0,32,29
1657980133048,MATH 109,B03,093479,Ganzberger; Geoffrey Michael,8,0,32,24
1657980139073,MATH 142A,A01,083219,Chow; Bennett,7,0,32,25
1657980139073,MATH 142A,A02,083220,Chow; Bennett,10,0,32,22
1657980139073,MATH 142A,A03,093480,Chow; Bennett,9,0,32,23
1657980139073,MATH 142A,B03,093481,Chow; Bennett,8,0,32,24
1657980139073,MATH 142A,B04,093558,Chow; Bennett,14,0,32,18
1657980139073,MATH 142A,B05,093559,Chow; Bennett,7,0,32,25
1657980145098,MATH 193A,A01,083224,Rotar; Vladimir,9,0,34,25
1657980145098,MATH 193A,A02,083225,Rotar; Vladimir,11,0,34,23
1657980145098,MATH 193A,A03,083781,Rotar; Vladimir,5,0,34,29
1657980145098,MATH 193A,A04,083782,Rotar; Vladimir,12,0,34,22
1657980145098,MATH 193A,A05,093482,Rotar; Vladimir,11,0,34,23
1657980151122,MATH 197,001,091859,McAuley; Julian John,9999,0,9999,0
1657980151122,MATH 197,002,095566,Kedlaya; Kiran S.,9997,0,9999,2
1657980151122,MATH 197,003,095567,Xiao; Ming,9999,0,9999,0
1657980151122,MATH 197,004,095571,Perols; Johan Lars,9998,0,9999,1
1657980158187,COGS 9,A01,083615,Shannon; Kyle Michael,11,0,75,64
1657980164210,COGS 11,A01,083617,Boyle; Mary E. T.,23,0,48,25
1657980170252,COGS 13,A01,083071,Bastos; Amalia Pinkusfeld,12,0,71,59
1657980176282,COGS 14A,A01,092681,Semenuks; Arturs,5,1,100,95
1657980182310,COGS 14B,A01,083073,Cheng; Tzu-Han,7,0,63,56
1657980188351,COGS 17,A01,092677,Semenuks; Arturs,7,0,81,74
1657980194380,COGS 100,A01,083619,Allen; Michael Gordon,17,0,70,53
1657980200404,COGS 101A,A01,083621,Davis; Joshua Daniel,9,0,68,59
1657980206428,COGS 101B,A01,091572,Allen; Michael Gordon,14,0,65,51
1657980212452,COGS 101C,A01,083625,Delgado; Tania,17,0,35,18
1657980218477,COGS 107A,A01,083627,Boyle; Mary E. T.,14,0,60,46
1657980224499,COGS 118A,A01,083075,Gupta; Anjum,21,0,76,55
1657980230528,CSE 3,A50,083646,Miranda; Gregory Joseph,24,0,50,26
1657980236555,CSE 8A,A50,083650,Miranda; Gregory Joseph,17,1,56,39
1657980242585,CSE 11,A01,083080,Cao; Yingjun,7,15,40,33
1657980248614,CSE 12,A01,083652,Krause-Levy; Sophia Louisa,30,1,120,90
1657980254647,CSE 15L,A01,083654,Morris; Justin Loren,9,0,50,41
1657980254647,CSE 15L,A02,083655,Morris; Justin Loren,11,0,50,39
1657980260677,CSE 20,A01,083657,Tran; Khoa Dang,39,0,80,41
1657980266708,CSE 21,A01,095574,Bach; Quang Tran,23,0,48,25
1657980272739,CSE 30,A01,083084,Eldon; John,8,0,80,72
1657980272739,CSE 30,B01,095061,Bhaskar; Nishant,9,0,50,41
1657980278763,CSE 100,A01,083659,Cao; Yingjun,5,4,70,65
1657980284786,CSE 134B,A01,083661,Powell; Thomas Allan,25,0,100,75
1657980290815,CSE 140,A01,083663,Gungor; Onat,17,0,85,68
1657980296840,CSE 140L,A01,083088,Eldon; John,23,0,100,77
1657980302871,CSE 175,A01,083665,Kumar; Rakesh,3,0,25,22
1657980308899,CSE 190,A00,092507,Dubnov; Shlomo,8,0,20,12
1657980314927,ECE 45,A01,083139,Congero; Spencer William,7,0,75,68
1657980320958,ECE 65,A50,083695,Saad; Andrew S,12,0,30,18
1657980320958,ECE 65,A51,095125,Saad; Andrew S,24,0,26,2
1657980326986,ECE 109,A01,091882,Touri; Behrouz,21,0,70,49
1657980333012,ECE 180,A00,083140,Abi Samra; Nicholas Camill,1,0,30,29
1657980333012,ECE 180,B00,083141,Abi Samra; Nicholas Camill,0,0,30,30
1657980339037,MATH 10A,A01,083735,Patchell; Gregory David,2,0,30,28
1657980339037,MATH 10A,A02,083736,Patchell; Gregory David,20,0,30,10
1657980339037,MATH 10A,A03,083737,Patchell; Gregory David,16,0,30,14
1657980345070,MATH 10B,A01,083207,Lim; Seonhee,9,0,34,25
1657980345070,MATH 10B,A02,083208,Lim; Seonhee,10,0,35,25
1657980345070,MATH 10B,A03,093472,Lim; Seonhee,7,0,34,27
1657980345070,MATH 10B,B01,083739,Sinha; Shubham,14,0,30,16
1657980351117,MATH 18,A01,083743,Cinel; Cameron Alexander,9,0,30,21
1657980351117,MATH 18,A02,083744,Cinel; Cameron Alexander,18,0,30,12
1657980351117,MATH 18,A03,083745,Cinel; Cameron Alexander,10,0,30,20
1657980351117,MATH 18,B01,083748,Rideout; David Porter,5,0,37,32
1657980351117,MATH 18,B02,083749,Rideout; David Porter,5,0,36,31
1657980351117,MATH 18,B03,083750,Rideout; David Porter,3,0,37,34
1657980351117,MATH 18,B04,083751,Rideout; David Porter,7,0,36,29
1657980351117,MATH 18,B05,093473,Rideout; David Porter,7,0,36,29
1657980351117,MATH 18,B06,093474,Rideout; David Porter,6,0,36,30
1657980357145,MATH 20A,A01,083754,Zheng; Zequn,14,0,40,26
1657980363170,MATH 20B,A01,083756,Briones; Jor-el Thomas Caparas,4,0,36,32
1657980363170,MATH 20B,A02,083757,Briones; Jor-el Thomas Caparas,1,0,36,35
1657980363170,MATH 20B,A03,093475,Briones; Jor-el Thomas Caparas,3,0,36,33
1657980369195,MATH 20C,A01,083760,Briones; Jor-el Thomas Caparas,1,0,35,34
1657980369195,MATH 20C,A02,083761,Briones; Jor-el Thomas Caparas,8,0,35,27
1657980369195,MATH 20C,A03,093476,Briones; Jor-el Thomas Caparas,0,1,36,36
1657980369195,MATH 20C,B01,083762,Bach; Quang Tran,1,0,30,29
1657980375222,MATH 20D,A01,083765,Tran; Brian Kha,5,0,30,25
1657980375222,MATH 20D,A02,083766,Tran; Brian Kha,5,0,30,25
1657980375222,MATH 20D,A03,083767,Tran; Brian Kha,6,0,30,24
1657980381254,MATH 20E,A01,083771,Ganguly; Soumya,12,0,32,20
1657980381254,MATH 20E,A02,083772,Ganguly; Soumya,7,0,32,25
1657980381254,MATH 20E,B01,083773,Ciotti; Benjamin,20,0,35,15
1657980381254,MATH 20E,B02,083774,Ciotti; Benjamin,18,0,35,17
1657980387286,MATH 103A,A01,083777,Greenfeld; Be'Eri,6,0,36,30
1657980387286,MATH 103A,A02,083778,Greenfeld; Be'Eri,5,0,36,31
1657980387286,MATH 103A,A03,093561,Greenfeld; Be'Eri,7,0,36,29
1657980387286,MATH 103A,B01,083779,Greenfeld; Be'Eri,8,0,36,28
1657980387286,MATH 103A,B02,083780,Greenfeld; Be'Eri,4,0,36,32
1657980387286,MATH 103A,B03,093562,Greenfeld; Be'Eri,3,0,36,33
1657980393317,MATH 105,A01,085443,Carter; Anne Toulson,15,0,35,20
1657980393317,MATH 105,A02,093477,Carter; Anne Toulson,20,0,35,15
1657980399348,MATH 109,A01,083213,Ganzberger; Geoffrey Michael,3,0,34,31
1657980399348,MATH 109,A02,083214,Ganzberger; Geoffrey Michael,4,0,34,30
1657980399348,MATH 109,A03,093478,Ganzberger; Geoffrey Michael,2,0,34,32
1657980399348,MATH 109,B01,083215,Ganzberger; Geoffrey Michael,3,0,32,29
1657980399348,MATH 109,B02,083216,Ganzberger; Geoffrey Michael,3,0,32,29
1657980399348,MATH 109,B03,093479,Ganzberger; Geoffrey Michael,8,0,32,24
1657980405375,MATH 142A,A01,083219,Chow; Bennett,7,0,32,25
1657980405375,MATH 142A,A02,083220,Chow; Bennett,10,0,32,22
1657980405375,MATH 142A,A03,093480,Chow; Bennett,9,0,32,23
1657980405375,MATH 142A,B03,093481,Chow; Bennett,8,0,32,24
1657980405375,MATH 142A,B04,093558,Chow; Bennett,14,0,32,18
1657980405375,MATH 142A,B05,093559,Chow; Bennett,7,0,32,25
1657980411405,MATH 193A,A01,083224,Rotar; Vladimir,9,0,34,25
1657980411405,MATH 193A,A02,083225,Rotar; Vladimir,11,0,34,23
1657980411405,MATH 193A,A03,083781,Rotar; Vladimir,5,0,34,29
1657980411405,MATH 193A,A04,083782,Rotar; Vladimir,12,0,34,22
1657980411405,MATH 193A,A05,093482,Rotar; Vladimir,11,0,34,23
1657980417429,MATH 197,001,091859,McAuley; Julian John,9999,0,9999,0
1657980417429,MATH 197,002,095566,Kedlaya; Kiran S.,9997,0,9999,2
1657980417429,MATH 197,003,095567,Xiao; Ming,9999,0,9999,0
1657980417429,MATH 197,004,095571,Perols; Johan Lars,9998,0,9999,1
1657980424497,COGS 9,A01,083615,Shannon; Kyle Michael,11,0,75,64
1657980430527,COGS 11,A01,083617,Boyle; Mary E. T.,23,0,48,25
1657980436557,COGS 13,A01,083071,Bastos; Amalia Pinkusfeld,12,0,71,59
1657980442586,COGS 14A,A01,092681,Semenuks; Arturs,5,1,100,95
1657980448609,COGS 14B,A01,083073,Cheng; Tzu-Han,7,0,63,56
1657980454640,COGS 17,A01,092677,Semenuks; Arturs,7,0,81,74
1657980460665,COGS 100,A01,083619,Allen; Michael Gordon,17,0,70,53
1657980466689,COGS 101A,A01,083621,Davis; Joshua Daniel,9,0,68,59
1657980472714,COGS 101B,A01,091572,Allen; Michael Gordon,14,0,65,51
1657980478737,COGS 101C,A01,083625,Delgado; Tania,17,0,35,18
1657980484760,COGS 107A,A01,083627,Boyle; Mary E. T.,14,0,60,46
1657980490787,COGS 118A,A01,083075,Gupta; Anjum,21,0,76,55
1657980496812,CSE 3,A50,083646,Miranda; Gregory Joseph,24,0,50,26
1657980502835,CSE 8A,A50,083650,Miranda; Gregory Joseph,17,1,56,39
1657980508865,CSE 11,A01,083080,Cao; Yingjun,7,15,40,33
1657980514890,CSE 12,A01,083652,Krause-Levy; Sophia Louisa,30,1,120,90
1657980520915,CSE 15L,A01,083654,Morris; Justin Loren,9,0,50,41
1657980520915,CSE 15L,A02,083655,Morris; Justin Loren,11,0,50,39
1657980526940,CSE 20,A01,083657,Tran; Khoa Dang,39,0,80,41
1657980532965,CSE 21,A01,095574,Bach; Quang Tran,23,0,48,25
1657980538998,CSE 30,A01,083084,Eldon; John,8,0,80,72
1657980538998,CSE 30,B01,095061,Bhaskar; Nishant,9,0,50,41
1657980545024,CSE 100,A01,083659,Cao; Yingjun,5,4,70,65
1657980551047,CSE 134B,A01,083661,Powell; Thomas Allan,25,0,100,75
1657980557076,CSE 140,A01,083663,Gungor; Onat,17,0,85,68
1657980563105,CSE 140L,A01,083088,Eldon; John,23,0,100,77
1657980569131,CSE 175,A01,083665,Kumar; Rakesh,3,0,25,22
1657980575157,CSE 190,A00,092507,Dubnov; Shlomo,8,0,20,12
1657980581191,ECE 45,A01,083139,Congero; Spencer William,7,0,75,68
1657980587223,ECE 65,A50,083695,Saad; Andrew S,12,0,30,18
1657980587223,ECE 65,A51,095125,Saad; Andrew S,24,0,26,2
1657980593248,ECE 109,A01,091882,Touri; Behrouz,21,0,70,49
1657980599285,ECE 180,A00,083140,Abi Samra; Nicholas Camill,1,0,30,29
1657980599285,ECE 180,B00,083141,Abi Samra; Nicholas Camill,0,0,30,30
1657980605319,MATH 10A,A01,083735,Patchell; Gregory David,2,0,30,28
1657980605319,MATH 10A,A02,083736,Patchell; Gregory David,20,0,30,10
1657980605319,MATH 10A,A03,083737,Patchell; Gregory David,16,0,30,14
1657980611347,MATH 10B,A01,083207,Lim; Seonhee,9,0,34,25
1657980611347,MATH 10B,A02,083208,Lim; Seonhee,10,0,35,25
1657980611347,MATH 10B,A03,093472,Lim; Seonhee,7,0,34,27
1657980611347,MATH 10B,B01,083739,Sinha; Shubham,14,0,30,16
1657980617386,MATH 18,A01,083743,Cinel; Cameron Alexander,9,0,30,21
1657980617386,MATH 18,A02,083744,Cinel; Cameron Alexander,18,0,30,12
1657980617386,MATH 18,A03,083745,Cinel; Cameron Alexander,10,0,30,20
1657980617386,MATH 18,B01,083748,Rideout; David Porter,5,0,37,32
1657980617386,MATH 18,B02,083749,Rideout; David Porter,5,0,36,31
1657980617386,MATH 18,B03,083750,Rideout; David Porter,3,0,37,34
1657980617386,MATH 18,B04,083751,Rideout; David Porter,7,0,36,29
1657980617386,MATH 18,B05,093473,Rideout; David Porter,7,0,36,29
1657980617386,MATH 18,B06,093474,Rideout; David Porter,6,0,36,30
1657980623412,MATH 20A,A01,083754,Zheng; Zequn,14,0,40,26
1657980629449,MATH 20B,A01,083756,Briones; Jor-el Thomas Caparas,4,0,36,32
1657980629449,MATH 20B,A02,083757,Briones; Jor-el Thomas Caparas,1,0,36,35
1657980629449,MATH 20B,A03,093475,Briones; Jor-el Thomas Caparas,3,0,36,33
1657980635475,MATH 20C,A01,083760,Briones; Jor-el Thomas Caparas,1,0,35,34
1657980635475,MATH 20C,A02,083761,Briones; Jor-el Thomas Caparas,8,0,35,27
1657980635475,MATH 20C,A03,093476,Briones; Jor-el Thomas Caparas,0,1,36,36
1657980635475,MATH 20C,B01,083762,Bach; Quang Tran,1,0,30,29
1657980641501,MATH 20D,A01,083765,Tran; Brian Kha,5,0,30,25
1657980641501,MATH 20D,A02,083766,Tran; Brian Kha,5,0,30,25
1657980641501,MATH 20D,A03,083767,Tran; Brian Kha,6,0,30,24
1657980647531,MATH 20E,A01,083771,Ganguly; Soumya,12,0,32,20
1657980647531,MATH 20E,A02,083772,Ganguly; Soumya,7,0,32,25
1657980647531,MATH 20E,B01,083773,Ciotti; Benjamin,20,0,35,15
1657980647531,MATH 20E,B02,083774,Ciotti; Benjamin,18,0,35,17
1657980653561,MATH 103A,A01,083777,Greenfeld; Be'Eri,6,0,36,30
1657980653561,MATH 103A,A02,083778,Greenfeld; Be'Eri,5,0,36,31
1657980653561,MATH 103A,A03,093561,Greenfeld; Be'Eri,7,0,36,29
1657980653561,MATH 103A,B01,083779,Greenfeld; Be'Eri,8,0,36,28
1657980653561,MATH 103A,B02,083780,Greenfeld; Be'Eri,4,0,36,32
1657980653561,MATH 103A,B03,093562,Greenfeld; Be'Eri,3,0,36,33
1657980659602,MATH 105,A01,085443,Carter; Anne Toulson,15,0,35,20
1657980659602,MATH 105,A02,093477,Carter; Anne Toulson,20,0,35,15
1657980665639,MATH 109,A01,083213,Ganzberger; Geoffrey Michael,3,0,34,31
1657980665639,MATH 109,A02,083214,Ganzberger; Geoffrey Michael,4,0,34,30
1657980665639,MATH 109,A03,093478,Ganzberger; Geoffrey Michael,2,0,34,32
1657980665639,MATH 109,B01,083215,Ganzberger; Geoffrey Michael,3,0,32,29
1657980665639,MATH 109,B02,083216,Ganzberger; Geoffrey Michael,3,0,32,29
1657980665639,MATH 109,B03,093479,Ganzberger; Geoffrey Michael,8,0,32,24
1657980671664,MATH 142A,A01,083219,Chow; Bennett,7,0,32,25
1657980671664,MATH 142A,A02,083220,Chow; Bennett,10,0,32,22
1657980671664,MATH 142A,A03,093480,Chow; Bennett,9,0,32,23
1657980671664,MATH 142A,B03,093481,Chow; Bennett,8,0,32,24
1657980671664,MATH 142A,B04,093558,Chow; Bennett,14,0,32,18
1657980671664,MATH 142A,B05,093559,Chow; Bennett,7,0,32,25
1657980677694,MATH 193A,A01,083224,Rotar; Vladimir,9,0,34,25
1657980677694,MATH 193A,A02,083225,Rotar; Vladimir,11,0,34,23
1657980677694,MATH 193A,A03,083781,Rotar; Vladimir,5,0,34,29
1657980677694,MATH 193A,A04,083782,Rotar; Vladimir,12,0,34,22
1657980677694,MATH 193A,A05,093482,Rotar; Vladimir,11,0,34,23
1657980683724,MATH 197,001,091859,McAuley; Julian John,9999,0,9999,0
1657980683724,MATH 197,002,095566,Kedlaya; Kiran S.,9997,0,9999,2
1657980683724,MATH 197,003,095567,Xiao; Ming,9999,0,9999,0
1657980683724,MATH 197,004,095571,Perols; Johan Lars,9998,0,9999,1
1657980690797,COGS 9,A01,083615,Shannon; Kyle Michael,11,0,75,64
1657980696835,COGS 11,A01,083617,Boyle; Mary E. T.,23,0,48,25
1657980702871,COGS 13,A01,083071,Bastos; Amalia Pinkusfeld,12,0,71,59
1657980708969,COGS 14A,A01,092681,Semenuks; Arturs,5,1,100,95
1657980714993,COGS 14B,A01,083073,Cheng; Tzu-Han,7,0,63,56
1657980721016,COGS 17,A01,092677,Semenuks; Arturs,7,0,81,74
1657980727041,COGS 100,A01,083619,Allen; Michael Gordon,17,0,70,53
1657980733064,COGS 101A,A01,083621,Davis; Joshua Daniel,9,0,68,59
1657980739088,COGS 101B,A01,091572,Allen; Michael Gordon,14,0,65,51
1657980745116,COGS 101C,A01,083625,Delgado; Tania,17,0,35,18
1657980751140,COGS 107A,A01,083627,Boyle; Mary E. T.,14,0,60,46
1657980757164,COGS 118A,A01,083075,Gupta; Anjum,21,0,76,55
1657980763198,CSE 3,A50,083646,Miranda; Gregory Joseph,24,0,50,26
1657980769228,CSE 8A,A50,083650,Miranda; Gregory Joseph,17,1,56,39
1657980775253,CSE 11,A01,083080,Cao; Yingjun,7,15,40,33
1657980781284,CSE 12,A01,083652,Krause-Levy; Sophia Louisa,30,1,120,90
1657980787312,CSE 15L,A01,083654,Morris; Justin Loren,9,0,50,41
1657980787312,CSE 15L,A02,083655,Morris; Justin Loren,11,0,50,39
1657980793343,CSE 20,A01,083657,Tran; Khoa Dang,39,0,80,41
1657980799368,CSE 21,A01,095574,Bach; Quang Tran,23,0,48,25
1657980805393,CSE 30,A01,083084,Eldon; John,8,0,80,72
1657980805393,CSE 30,B01,095061,Bhaskar; Nishant,9,0,50,41
1657980811426,CSE 100,A01,083659,Cao; Yingjun,5,4,70,65
1657980817456,CSE 134B,A01,083661,Powell; Thomas Allan,25,0,100,75
1657980823486,CSE 140,A01,083663,Gungor; Onat,17,0,85,68
1657980829516,CSE 140L,A01,083088,Eldon; John,23,0,100,77
1657980835542,CSE 175,A01,083665,Kumar; Rakesh,3,0,25,22
1657980841569,CSE 190,A00,092507,Dubnov; Shlomo,8,0,20,12
1657980847599,ECE 45,A01,083139,Congero; Spencer William,7,0,75,68
1657980853626,ECE 65,A50,083695,Saad; Andrew S,12,0,30,18
1657980853626,ECE 65,A51,095125,Saad; Andrew S,24,0,26,2
1657980859660,ECE 109,A01,091882,Touri; Behrouz,21,0,70,49
1657980865700,ECE 180,A00,083140,Abi Samra; Nicholas Camill,1,0,30,29
1657980865700,ECE 180,B00,083141,Abi Samra; Nicholas Camill,0,0,30,30
1657980871735,MATH 10A,A01,083735,Patchell; Gregory David,2,0,30,28
1657980871735,MATH 10A,A02,083736,Patchell; Gregory David,20,0,30,10
1657980871735,MATH 10A,A03,083737,Patchell; Gregory David,16,0,30,14
1657980877780,MATH 10B,A01,083207,Lim; Seonhee,9,0,34,25
1657980877780,MATH 10B,A02,083208,Lim; Seonhee,10,0,35,25
1657980877780,MATH 10B,A03,093472,Lim; Seonhee,7,0,34,27
1657980877780,MATH 10B,B01,083739,Sinha; Shubham,14,0,30,16
1657980883808,MATH 18,A01,083743,Cinel; Cameron Alexander,9,0,30,21
1657980883808,MATH 18,A02,083744,Cinel; Cameron Alexander,18,0,30,12
1657980883808,MATH 18,A03,083745,Cinel; Cameron Alexander,10,0,30,20
1657980883808,MATH 18,B01,083748,Rideout; David Porter,5,0,37,32
1657980883808,MATH 18,B02,083749,Rideout; David Porter,5,0,36,31
1657980883808,MATH 18,B03,083750,Rideout; David Porter,3,0,37,34
1657980883808,MATH 18,B04,083751,Rideout; David Porter,7,0,36,29
1657980883808,MATH 18,B05,093473,Rideout; David Porter,7,0,36,29
1657980883808,MATH 18,B06,093474,Rideout; David Porter,6,0,36,30
1657980889839,MATH 20A,A01,083754,Zheng; Zequn,14,0,40,26
1657980895868,MATH 20B,A01,083756,Briones; Jor-el Thomas Caparas,4,0,36,32
1657980895868,MATH 20B,A02,083757,Briones; Jor-el Thomas Caparas,1,0,36,35
1657980895868,MATH 20B,A03,093475,Briones; Jor-el Thomas Caparas,3,0,36,33
1657980901902,MATH 20C,A01,083760,Briones; Jor-el Thomas Caparas,1,0,35,34
1657980901902,MATH 20C,A02,083761,Briones; Jor-el Thomas Caparas,8,0,35,27
1657980901902,MATH 20C,A03,093476,Briones; Jor-el Thomas Caparas,0,1,36,36
1657980901902,MATH 20C,B01,083762,Bach; Quang Tran,1,0,30,29
1657980907936,MATH 20D,A01,083765,Tran; Brian Kha,5,0,30,25
1657980907936,MATH 20D,A02,083766,Tran; Brian Kha,5,0,30,25
1657980907936,MATH 20D,A03,083767,Tran; Brian Kha,6,0,30,24
1657980913962,MATH 20E,A01,083771,Ganguly; Soumya,12,0,32,20
1657980913962,MATH 20E,A02,083772,Ganguly; Soumya,7,0,32,25
1657980913962,MATH 20E,B01,083773,Ciotti; Benjamin,20,0,35,15
1657980913962,MATH 20E,B02,083774,Ciotti; Benjamin,18,0,35,17
1657980920001,MATH 103A,A01,083777,Greenfeld; Be'Eri,6,0,36,30
1657980920001,MATH 103A,A02,083778,Greenfeld; Be'Eri,5,0,36,31
1657980920001,MATH 103A,A03,093561,Greenfeld; Be'Eri,7,0,36,29
1657980920001,MATH 103A,B01,083779,Greenfeld; Be'Eri,8,0,36,28
1657980920001,MATH 103A,B02,083780,Greenfeld; Be'Eri,4,0,36,32
1657980920001,MATH 103A,B03,093562,Greenfeld; Be'Eri,3,0,36,33
1657980926040,MATH 105,A01,085443,Carter; Anne Toulson,15,0,35,20
1657980926040,MATH 105,A02,093477,Carter; Anne Toulson,20,0,35,15
1657980932072,MATH 109,A01,083213,Ganzberger; Geoffrey Michael,3,0,34,31
1657980932072,MATH 109,A02,083214,Ganzberger; Geoffrey Michael,4,0,34,30
1657980932072,MATH 109,A03,093478,Ganzberger; Geoffrey Michael,2,0,34,32
1657980932072,MATH 109,B01,083215,Ganzberger; Geoffrey Michael,3,0,32,29
1657980932072,MATH 109,B02,083216,Ganzberger; Geoffrey Michael,3,0,32,29
1657980932072,MATH 109,B03,093479,Ganzberger; Geoffrey Michael,8,0,32,24
1657980938105,MATH 142A,A01,083219,Chow; Bennett,7,0,32,25
1657980938105,MATH 142A,A02,083220,Chow; Bennett,10,0,32,22
1657980938105,MATH 142A,A03,093480,Chow; Bennett,9,0,32,23
1657980938105,MATH 142A,B03,093481,Chow; Bennett,8,0,32,24
1657980938105,MATH 142A,B04,093558,Chow; Bennett,14,0,32,18
1657980938105,MATH 142A,B05,093559,Chow; Bennett,7,0,32,25
1657980944131,MATH 193A,A01,083224,Rotar; Vladimir,9,0,34,25
1657980944131,MATH 193A,A02,083225,Rotar; Vladimir,11,0,34,23
1657980944131,MATH 193A,A03,083781,Rotar; Vladimir,5,0,34,29
1657980944131,MATH 193A,A04,083782,Rotar; Vladimir,12,0,34,22
1657980944131,MATH 193A,A05,093482,Rotar; Vladimir,11,0,34,23
1657980950166,MATH 197,001,091859,McAuley; Julian John,9999,0,9999,0
1657980950166,MATH 197,002,095566,Kedlaya; Kiran S.,9997,0,9999,2
1657980950166,MATH 197,003,095567,Xiao; Ming,9999,0,9999,0
1657980950166,MATH 197,004,095571,Perols; Johan Lars,9998,0,9999,1
1657980957251,COGS 9,A01,083615,Shannon; Kyle Michael,11,0,75,64
1657980963275,COGS 11,A01,083617,Boyle; Mary E. T.,23,0,48,25
1657980969301,COGS 13,A01,083071,Bastos; Amalia Pinkusfeld,12,0,71,59
1657980975328,COGS 14A,A01,092681,Semenuks; Arturs,5,1,100,95
1657980981353,COGS 14B,A01,083073,Cheng; Tzu-Han,7,0,63,56
1657980987376,COGS 17,A01,092677,Semenuks; Arturs,7,0,81,74
1657980993406,COGS 100,A01,083619,Allen; Michael Gordon,17,0,70,53
1657980999429,COGS 101A,A01,083621,Davis; Joshua Daniel,9,0,68,59
1657981005459,COGS 101B,A01,091572,Allen; Michael Gordon,14,0,65,51
1657981011490,COGS 101C,A01,083625,Delgado; Tania,17,0,35,18
1657981017515,COGS 107A,A01,083627,Boyle; Mary E. T.,14,0,60,46
1657981023541,COGS 118A,A01,083075,Gupta; Anjum,21,0,76,55
1657981029577,CSE 3,A50,083646,Miranda; Gregory Joseph,24,0,50,26
1657981035601,CSE 8A,A50,083650,Miranda; Gregory Joseph,17,1,56,39
1657981041634,CSE 11,A01,083080,Cao; Yingjun,7,15,40,33
1657981047672,CSE 12,A01,083652,Krause-Levy; Sophia Louisa,30,1,120,90
1657981053698,CSE 15L,A01,083654,Morris; Justin Loren,9,0,50,41
1657981053698,CSE 15L,A02,083655,Morris; Justin Loren,11,0,50,39
1657981059733,CSE 20,A01,083657,Tran; Khoa Dang,39,0,80,41
1657981065757,CSE 21,A01,095574,Bach; Quang Tran,23,0,48,25
1657981071790,CSE 30,A01,083084,Eldon; John,8,0,80,72
1657981071790,CSE 30,B01,095061,Bhaskar; Nishant,9,0,50,41
1657981077815,CSE 100,A01,083659,Cao; Yingjun,5,4,70,65
1657981083844,CSE 134B,A01,083661,Powell; Thomas Allan,25,0,100,75
1657981089872,CSE 140,A01,083663,Gungor; Onat,17,0,85,68
1657981095896,CSE 140L,A01,083088,Eldon; John,23,0,100,77
1657981101927,CSE 175,A01,083665,Kumar; Rakesh,3,0,25,22
1657981107953,CSE 190,A00,092507,Dubnov; Shlomo,8,0,20,12
1657981113977,ECE 45,A01,083139,Congero; Spencer William,7,0,75,68
1657981120003,ECE 65,A50,083695,Saad; Andrew S,12,0,30,18
1657981120003,ECE 65,A51,095125,Saad; Andrew S,24,0,26,2
1657981126029,ECE 109,A01,091882,Touri; Behrouz,21,0,70,49
1657981132061,ECE 180,A00,083140,Abi Samra; Nicholas Camill,1,0,30,29
1657981132061,ECE 180,B00,083141,Abi Samra; Nicholas Camill,0,0,30,30
1657981138087,MATH 10A,A01,083735,Patchell; Gregory David,2,0,30,28
1657981138087,MATH 10A,A02,083736,Patchell; Gregory David,20,0,30,10
1657981138087,MATH 10A,A03,083737,Patchell; Gregory David,16,0,30,14
1657981144115,MATH 10B,A01,083207,Lim; Seonhee,9,0,34,25
1657981144115,MATH 10B,A02,083208,Lim; Seonhee,10,0,35,25
1657981144115,MATH 10B,A03,093472,Lim; Seonhee,7,0,34,27
1657981144115,MATH 10B,B01,083739,Sinha; Shubham,14,0,30,16
1657981150151,MATH 18,A01,083743,Cinel; Cameron Alexander,9,0,30,21
1657981150151,MATH 18,A02,083744,Cinel; Cameron Alexander,18,0,30,12
1657981150151,MATH 18,A03,083745,Cinel; Cameron Alexander,10,0,30,20
1657981150151,MATH 18,B01,083748,Rideout; David Porter,5,0,37,32
1657981150151,MATH 18,B02,083749,Rideout; David Porter,5,0,36,31
1657981150151,MATH 18,B03,083750,Rideout; David Porter,3,0,37,34
1657981150151,MATH 18,B04,083751,Rideout; David Porter,7,0,36,29
1657981150151,MATH 18,B05,093473,Rideout; David Porter,7,0,36,29
1657981150151,MATH 18,B06,093474,Rideout; David Porter,6,0,36,30
1657981156176,MATH 20A,A01,083754,Zheng; Zequn,14,0,40,26
1657981162201,MATH 20B,A01,083756,Briones; Jor-el Thomas Caparas,4,0,36,32
1657981162201,MATH 20B,A02,083757,Briones; Jor-el Thomas Caparas,1,0,36,35
1657981162201,MATH 20B,A03,093475,Briones; Jor-el Thomas Caparas,3,0,36,33
1657981168227,MATH 20C,A01,083760,Briones; Jor-el Thomas Caparas,1,0,35,34
1657981168227,MATH 20C,A02,083761,Briones; Jor-el Thomas Caparas,8,0,35,27
1657981168227,MATH 20C,A03,093476,Briones; Jor-el Thomas Caparas,0,1,36,36
1657981168227,MATH 20C,B01,083762,Bach; Quang Tran,1,0,30,29
1657981174254,MATH 20D,A01,083765,Tran; Brian Kha,5,0,30,25
1657981174254,MATH 20D,A02,083766,Tran; Brian Kha,5,0,30,25
1657981174254,MATH 20D,A03,083767,Tran; Brian Kha,6,0,30,24
1657981180285,MATH 20E,A01,083771,Ganguly; Soumya,12,0,32,20
1657981180285,MATH 20E,A02,083772,Ganguly; Soumya,7,0,32,25
1657981180285,MATH 20E,B01,083773,Ciotti; Benjamin,20,0,35,15
1657981180285,MATH 20E,B02,083774,Ciotti; Benjamin,18,0,35,17
1657981186313,MATH 103A,A01,083777,Greenfeld; Be'Eri,6,0,36,30
1657981186313,MATH 103A,A02,083778,Greenfeld; Be'Eri,5,0,36,31
1657981186313,MATH 103A,A03,093561,Greenfeld; Be'Eri,7,0,36,29
1657981186313,MATH 103A,B01,083779,Greenfeld; Be'Eri,8,0,36,28
1657981186313,MATH 103A,B02,083780,Greenfeld; Be'Eri,4,0,36,32
1657981186313,MATH 103A,B03,093562,Greenfeld; Be'Eri,3,0,36,33
1657981192344,MATH 105,A01,085443,Carter; Anne Toulson,15,0,35,20
1657981192344,MATH 105,A02,093477,Carter; Anne Toulson,20,0,35,15
1657981198377,MATH 109,A01,083213,Ganzberger; Geoffrey Michael,3,0,34,31
1657981198377,MATH 109,A02,083214,Ganzberger; Geoffrey Michael,4,0,34,30
1657981198377,MATH 109,A03,093478,Ganzberger; Geoffrey Michael,2,0,34,32
1657981198377,MATH 109,B01,083215,Ganzberger; Geoffrey Michael,3,0,32,29
1657981198377,MATH 109,B02,083216,Ganzberger; Geoffrey Michael,3,0,32,29
1657981198377,MATH 109,B03,093479,Ganzberger; Geoffrey Michael,8,0,32,24
1657981204409,MATH 142A,A01,083219,Chow; Bennett,7,0,32,25
1657981204409,MATH 142A,A02,083220,Chow; Bennett,10,0,32,22
1657981204409,MATH 142A,A03,093480,Chow; Bennett,9,0,32,23
1657981204409,MATH 142A,B03,093481,Chow; Bennett,8,0,32,24
1657981204409,MATH 142A,B04,093558,Chow; Bennett,14,0,32,18
1657981204409,MATH 142A,B05,093559,Chow; Bennett,7,0,32,25
1657981210441,MATH 193A,A01,083224,Rotar; Vladimir,9,0,34,25
1657981210441,MATH 193A,A02,083225,Rotar; Vladimir,11,0,34,23
1657981210441,MATH 193A,A03,083781,Rotar; Vladimir,5,0,34,29
1657981210441,MATH 193A,A04,083782,Rotar; Vladimir,12,0,34,22
1657981210441,MATH 193A,A05,093482,Rotar; Vladimir,11,0,34,23
1657981216466,MATH 197,001,091859,McAuley; Julian John,9999,0,9999,0
1657981216466,MATH 197,002,095566,Kedlaya; Kiran S.,9997,0,9999,2
1657981216466,MATH 197,003,095567,Xiao; Ming,9999,0,9999,0
1657981216466,MATH 197,004,095571,Perols; Johan Lars,9998,0,9999,1
1657981223534,COGS 9,A01,083615,Shannon; Kyle Michael,11,0,75,64
1657981229567,COGS 11,A01,083617,Boyle; Mary E. T.,23,0,48,25
1657981235599,COGS 13,A01,083071,Bastos; Amalia Pinkusfeld,12,0,71,59
1657981241624,COGS 14A,A01,092681,Semenuks; Arturs,5,1,100,95
1657981247650,COGS 14B,A01,083073,Cheng; Tzu-Han,7,0,63,56
1657981253673,COGS 17,A01,092677,Semenuks; Arturs,7,0,81,74
1657981259699,COGS 100,A01,083619,Allen; Michael Gordon,17,0,70,53
1657981265725,COGS 101A,A01,083621,Davis; Joshua Daniel,9,0,68,59
1657981271750,COGS 101B,A01,091572,Allen; Michael Gordon,14,0,65,51
1657981277780,COGS 101C,A01,083625,Delgado; Tania,17,0,35,18
1657981283804,COGS 107A,A01,083627,Boyle; Mary E. T.,14,0,60,46
1657981289831,COGS 118A,A01,083075,Gupta; Anjum,21,0,76,55
1657981295863,CSE 3,A50,083646,Miranda; Gregory Joseph,24,0,50,26
1657981301887,CSE 8A,A50,083650,Miranda; Gregory Joseph,17,1,56,39
1657981307980,CSE 11,A01,083080,Cao; Yingjun,7,15,40,33
1657981314013,CSE 12,A01,083652,Krause-Levy; Sophia Louisa,30,1,120,90
1657981320038,CSE 15L,A01,083654,Morris; Justin Loren,9,0,50,41
1657981320038,CSE 15L,A02,083655,Morris; Justin Loren,11,0,50,39
1657981326067,CSE 20,A01,083657,Tran; Khoa Dang,39,0,80,41
1657981332090,CSE 21,A01,095574,Bach; Quang Tran,23,0,48,25
1657981338117,CSE 30,A01,083084,Eldon; John,8,0,80,72
1657981338117,CSE 30,B01,095061,Bhaskar; Nishant,9,0,50,41
1657981344146,CSE 100,A01,083659,Cao; Yingjun,5,4,70,65
1657981350174,CSE 134B,A01,083661,Powell; Thomas Allan,25,0,100,75
1657981356198,CSE 140,A01,083663,Gungor; Onat,17,0,85,68
1657981362227,CSE 140L,A01,083088,Eldon; John,23,0,100,77
1657981368250,CSE 175,A01,083665,Kumar; Rakesh,3,0,25,22
1657981374279,CSE 190,A00,092507,Dubnov; Shlomo,8,0,20,12
1657981380327,ECE 45,A01,083139,Congero; Spencer William,7,0,75,68
1657981386353,ECE 65,A50,083695,Saad; Andrew S,12,0,30,18
1657981386353,ECE 65,A51,095125,Saad; Andrew S,24,0,26,2
1657981392378,ECE 109,A01,091882,Touri; Behrouz,21,0,70,49
1657981398404,ECE 180,A00,083140,Abi Samra; Nicholas Camill,1,0,30,29
1657981398404,ECE 180,B00,083141,Abi Samra; Nicholas Camill,0,0,30,30
1657981404436,MATH 10A,A01,083735,Patchell; Gregory David,2,0,30,28
1657981404436,MATH 10A,A02,083736,Patchell; Gregory David,20,0,30,10
1657981404436,MATH 10A,A03,083737,Patchell; Gregory David,16,0,30,14
1657981410474,MATH 10B,A01,083207,Lim; Seonhee,9,0,34,25
1657981410474,MATH 10B,A02,083208,Lim; Seonhee,10,0,35,25
1657981410474,MATH 10B,A03,093472,Lim; Seonhee,7,0,34,27
1657981410474,MATH 10B,B01,083739,Sinha; Shubham,14,0,30,16
1657981416504,MATH 18,A01,083743,Cinel; Cameron Alexander,9,0,30,21
1657981416504,MATH 18,A02,083744,Cinel; Cameron Alexander,18,0,30,12
1657981416504,MATH 18,A03,083745,Cinel; Cameron Alexander,10,0,30,20
1657981416504,MATH 18,B01,083748,Rideout; David Porter,5,0,37,32
1657981416504,MATH 18,B02,083749,Rideout; David Porter,5,0,36,31
1657981416504,MATH 18,B03,083750,Rideout; David Porter,3,0,37,34
1657981416504,MATH 18,B04,083751,Rideout; David Porter,7,0,36,29
1657981416504,MATH 18,B05,093473,Rideout; David Porter,7,0,36,29
1657981416504,MATH 18,B06,093474,Rideout; David Porter,6,0,36,30
1657981422529,MATH 20A,A01,083754,Zheng; Zequn,14,0,40,26
1657981428558,MATH 20B,A01,083756,Briones; Jor-el Thomas Caparas,4,0,36,32
1657981428558,MATH 20B,A02,083757,Briones; Jor-el Thomas Caparas,1,0,36,35
1657981428558,MATH 20B,A03,093475,Briones; Jor-el Thomas Caparas,3,0,36,33
1657981434585,MATH 20C,A01,083760,Briones; Jor-el Thomas Caparas,1,0,35,34
1657981434585,MATH 20C,A02,083761,Briones; Jor-el Thomas Caparas,8,0,35,27
1657981434585,MATH 20C,A03,093476,Briones; Jor-el Thomas Caparas,0,1,36,36
1657981434585,MATH 20C,B01,083762,Bach; Quang Tran,1,0,30,29
1657981440610,MATH 20D,A01,083765,Tran; Brian Kha,5,0,30,25
1657981440610,MATH 20D,A02,083766,Tran; Brian Kha,5,0,30,25
1657981440610,MATH 20D,A03,083767,Tran; Brian Kha,6,0,30,24
1657981446636,MATH 20E,A01,083771,Ganguly; Soumya,12,0,32,20
1657981446636,MATH 20E,A02,083772,Ganguly; Soumya,7,0,32,25
1657981446636,MATH 20E,B01,083773,Ciotti; Benjamin,20,0,35,15
1657981446636,MATH 20E,B02,083774,Ciotti; Benjamin,18,0,35,17
1657981452662,MATH 103A,A01,083777,Greenfeld; Be'Eri,6,0,36,30
1657981452662,MATH 103A,A02,083778,Greenfeld; Be'Eri,5,0,36,31
1657981452662,MATH 103A,A03,093561,Greenfeld; Be'Eri,7,0,36,29
1657981452662,MATH 103A,B01,083779,Greenfeld; Be'Eri,8,0,36,28
1657981452662,MATH 103A,B02,083780,Greenfeld; Be'Eri,4,0,36,32
1657981452662,MATH 103A,B03,093562,Greenfeld; Be'Eri,3,0,36,33
1657981458694,MATH 105,A01,085443,Carter; Anne Toulson,15,0,35,20
1657981458694,MATH 105,A02,093477,Carter; Anne Toulson,20,0,35,15
1657981464727,MATH 109,A01,083213,Ganzberger; Geoffrey Michael,3,0,34,31
1657981464727,MATH 109,A02,083214,Ganzberger; Geoffrey Michael,4,0,34,30
1657981464727,MATH 109,A03,093478,Ganzberger; Geoffrey Michael,2,0,34,32
1657981464727,MATH 109,B01,083215,Ganzberger; Geoffrey Michael,3,0,32,29
1657981464727,MATH 109,B02,083216,Ganzberger; Geoffrey Michael,3,0,32,29
1657981464727,MATH 109,B03,093479,Ganzberger; Geoffrey Michael,8,0,32,24
1657981470754,MATH 142A,A01,083219,Chow; Bennett,7,0,32,25
1657981470754,MATH 142A,A02,083220,Chow; Bennett,10,0,32,22
1657981470754,MATH 142A,A03,093480,Chow; Bennett,9,0,32,23
1657981470754,MATH 142A,B03,093481,Chow; Bennett,8,0,32,24
1657981470754,MATH 142A,B04,093558,Chow; Bennett,14,0,32,18
1657981470754,MATH 142A,B05,093559,Chow; Bennett,7,0,32,25
1657981476785,MATH 193A,A01,083224,Rotar; Vladimir,9,0,34,25
1657981476785,MATH 193A,A02,083225,Rotar; Vladimir,11,0,34,23
1657981476785,MATH 193A,A03,083781,Rotar; Vladimir,5,0,34,29
1657981476785,MATH 193A,A04,083782,Rotar; Vladimir,12,0,34,22
1657981476785,MATH 193A,A05,093482,Rotar; Vladimir,11,0,34,23
1657981482810,MATH 197,001,091859,McAuley; Julian John,9999,0,9999,0
1657981482810,MATH 197,002,095566,Kedlaya; Kiran S.,9997,0,9999,2
1657981482810,MATH 197,003,095567,Xiao; Ming,9999,0,9999,0
1657981482810,MATH 197,004,095571,Perols; Johan Lars,9998,0,9999,1
1657981489894,COGS 9,A01,083615,Shannon; Kyle Michael,11,0,75,64
1657981495919,COGS 11,A01,083617,Boyle; Mary E. T.,23,0,48,25
1657981501944,COGS 13,A01,083071,Bastos; Amalia Pinkusfeld,12,0,71,59
1657981507970,COGS 14A,A01,092681,Semenuks; Arturs,5,1,100,95
1657981514000,COGS 14B,A01,083073,Cheng; Tzu-Han,7,0,63,56
1657981520026,COGS 17,A01,092677,Semenuks; Arturs,7,0,81,74
1657981526050,COGS 100,A01,083619,Allen; Michael Gordon,17,0,70,53
1657981532075,COGS 101A,A01,083621,Davis; Joshua Daniel,9,0,68,59
1657981538104,COGS 101B,A01,091572,Allen; Michael Gordon,14,0,65,51
1657981544130,COGS 101C,A01,083625,Delgado; Tania,17,0,35,18
1657981550158,COGS 107A,A01,083627,Boyle; Mary E. T.,14,0,60,46
1657981556183,COGS 118A,A01,083075,Gupta; Anjum,21,0,76,55
1657981562217,CSE 3,A50,083646,Miranda; Gregory Joseph,24,0,50,26
1657981568241,CSE 8A,A50,083650,Miranda; Gregory Joseph,17,1,56,39
1657981574270,CSE 11,A01,083080,Cao; Yingjun,7,15,40,33
1657981580307,CSE 12,A01,083652,Krause-Levy; Sophia Louisa,30,1,120,90
1657981586330,CSE 15L,A01,083654,Morris; Justin Loren,9,0,50,41
1657981586330,CSE 15L,A02,083655,Morris; Justin Loren,11,0,50,39
1657981592355,CSE 20,A01,083657,Tran; Khoa Dang,39,0,80,41
1657981598379,CSE 21,A01,095574,Bach; Quang Tran,23,0,48,25
1657981604406,CSE 30,A01,083084,Eldon; John,8,0,80,72
1657981604406,CSE 30,B01,095061,Bhaskar; Nishant,9,0,50,41
1657981610437,CSE 100,A01,083659,Cao; Yingjun,5,4,70,65
1657981616468,CSE 134B,A01,083661,Powell; Thomas Allan,25,0,100,75
1657981622493,CSE 140,A01,083663,Gungor; Onat,17,0,85,68
1657981628516,CSE 140L,A01,083088,Eldon; John,23,0,100,77
1657981634551,CSE 175,A01,083665,Kumar; Rakesh,3,0,25,22
1657981640582,CSE 190,A00,092507,Dubnov; Shlomo,8,0,20,12
1657981646616,ECE 45,A01,083139,Congero; Spencer William,7,0,75,68
1657981652650,ECE 65,A50,083695,Saad; Andrew S,12,0,30,18
1657981652650,ECE 65,A51,095125,Saad; Andrew S,24,0,26,2
1657981658680,ECE 109,A01,091882,Touri; Behrouz,21,0,70,49
1657981664709,ECE 180,A00,083140,Abi Samra; Nicholas Camill,1,0,30,29
1657981664709,ECE 180,B00,083141,Abi Samra; Nicholas Camill,0,0,30,30
1657981670742,MATH 10A,A01,083735,Patchell; Gregory David,2,0,30,28
1657981670742,MATH 10A,A02,083736,Patchell; Gregory David,20,0,30,10
1657981670742,MATH 10A,A03,083737,Patchell; Gregory David,16,0,30,14
1657981676772,MATH 10B,A01,083207,Lim; Seonhee,9,0,34,25
1657981676772,MATH 10B,A02,083208,Lim; Seonhee,10,0,35,25
1657981676772,MATH 10B,A03,093472,Lim; Seonhee,7,0,34,27
1657981676772,MATH 10B,B01,083739,Sinha; Shubham,14,0,30,16
1657981682800,MATH 18,A01,083743,Cinel; Cameron Alexander,9,0,30,21
1657981682800,MATH 18,A02,083744,Cinel; Cameron Alexander,18,0,30,12
1657981682800,MATH 18,A03,083745,Cinel; Cameron Alexander,10,0,30,20
1657981682800,MATH 18,B01,083748,Rideout; David Porter,5,0,37,32
1657981682800,MATH 18,B02,083749,Rideout; David Porter,5,0,36,31
1657981682800,MATH 18,B03,083750,Rideout; David Porter,3,0,37,34
1657981682800,MATH 18,B04,083751,Rideout; David Porter,7,0,36,29
1657981682800,MATH 18,B05,093473,Rideout; David Porter,7,0,36,29
1657981682800,MATH 18,B06,093474,Rideout; David Porter,6,0,36,30
1657981688823,MATH 20A,A01,083754,Zheng; Zequn,14,0,40,26
1657981694856,MATH 20B,A01,083756,Briones; Jor-el Thomas Caparas,4,0,36,32
1657981694856,MATH 20B,A02,083757,Briones; Jor-el Thomas Caparas,1,0,36,35
1657981694856,MATH 20B,A03,093475,Briones; Jor-el Thomas Caparas,3,0,36,33
1657981700883,MATH 20C,A01,083760,Briones; Jor-el Thomas Caparas,1,0,35,34
1657981700883,MATH 20C,A02,083761,Briones; Jor-el Thomas Caparas,8,0,35,27
1657981700883,MATH 20C,A03,093476,Briones; Jor-el Thomas Caparas,0,1,36,36
1657981700883,MATH 20C,B01,083762,Bach; Quang Tran,1,0,30,29
1657981706915,MATH 20D,A01,083765,Tran; Brian Kha,5,0,30,25
1657981706915,MATH 20D,A02,083766,Tran; Brian Kha,5,0,30,25
1657981706915,MATH 20D,A03,083767,Tran; Brian Kha,6,0,30,24
1657981712943,MATH 20E,A01,083771,Ganguly; Soumya,12,0,32,20
1657981712943,MATH 20E,A02,083772,Ganguly; Soumya,7,0,32,25
1657981712943,MATH 20E,B01,083773,Ciotti; Benjamin,20,0,35,15
1657981712943,MATH 20E,B02,083774,Ciotti; Benjamin,18,0,35,17
1657981718971,MATH 103A,A01,083777,Greenfeld; Be'Eri,6,0,36,30
1657981718971,MATH 103A,A02,083778,Greenfeld; Be'Eri,5,0,36,31
1657981718971,MATH 103A,A03,093561,Greenfeld; Be'Eri,7,0,36,29
1657981718971,MATH 103A,B01,083779,Greenfeld; Be'Eri,8,0,36,28
1657981718971,MATH 103A,B02,083780,Greenfeld; Be'Eri,4,0,36,32
1657981718971,MATH 103A,B03,093562,Greenfeld; Be'Eri,3,0,36,33
1657981724999,MATH 105,A01,085443,Carter; Anne Toulson,15,0,35,20
1657981724999,MATH 105,A02,093477,Carter; Anne Toulson,20,0,35,15
1657981731024,MATH 109,A01,083213,Ganzberger; Geoffrey Michael,3,0,34,31
1657981731024,MATH 109,A02,083214,Ganzberger; Geoffrey Michael,4,0,34,30
1657981731024,MATH 109,A03,093478,Ganzberger; Geoffrey Michael,2,0,34,32
1657981731024,MATH 109,B01,083215,Ganzberger; Geoffrey Michael,3,0,32,29
1657981731024,MATH 109,B02,083216,Ganzberger; Geoffrey Michael,3,0,32,29
1657981731024,MATH 109,B03,093479,Ganzberger; Geoffrey Michael,8,0,32,24
1657981737048,MATH 142A,A01,083219,Chow; Bennett,7,0,32,25
1657981737048,MATH 142A,A02,083220,Chow; Bennett,10,0,32,22
1657981737048,MATH 142A,A03,093480,Chow; Bennett,9,0,32,23
1657981737048,MATH 142A,B03,093481,Chow; Bennett,8,0,32,24
1657981737048,MATH 142A,B04,093558,Chow; Bennett,14,0,32,18
1657981737048,MATH 142A,B05,093559,Chow; Bennett,7,0,32,25
1657981743073,MATH 193A,A01,083224,Rotar; Vladimir,9,0,34,25
1657981743073,MATH 193A,A02,083225,Rotar; Vladimir,11,0,34,23
1657981743073,MATH 193A,A03,083781,Rotar; Vladimir,5,0,34,29
1657981743073,MATH 193A,A04,083782,Rotar; Vladimir,12,0,34,22
1657981743073,MATH 193A,A05,093482,Rotar; Vladimir,11,0,34,23
1657981749103,MATH 197,001,091859,McAuley; Julian John,9999,0,9999,0
1657981749103,MATH 197,002,095566,Kedlaya; Kiran S.,9997,0,9999,2
1657981749103,MATH 197,003,095567,Xiao; Ming,9999,0,9999,0
1657981749103,MATH 197,004,095571,Perols; Johan Lars,9998,0,9999,1
1657981756177,COGS 9,A01,083615,Shannon; Kyle Michael,11,0,75,64
1657981762202,COGS 11,A01,083617,Boyle; Mary E. T.,23,0,48,25
1657981768233,COGS 13,A01,083071,Bastos; Amalia Pinkusfeld,12,0,71,59
1657981774260,COGS 14A,A01,092681,Semenuks; Arturs,5,1,100,95
1657981780291,COGS 14B,A01,083073,Cheng; Tzu-Han,7,0,63,56
1657981786319,COGS 17,A01,092677,Semenuks; Arturs,7,0,81,74
1657981792343,COGS 100,A01,083619,Allen; Michael Gordon,17,0,70,53
1657981798370,COGS 101A,A01,083621,Davis; Joshua Daniel,9,0,68,59
1657981804407,COGS 101B,A01,091572,Allen; Michael Gordon,14,0,65,51
1657981810437,COGS 101C,A01,083625,Delgado; Tania,17,0,35,18
1657981816460,COGS 107A,A01,083627,Boyle; Mary E. T.,14,0,60,46
1657981822486,COGS 118A,A01,083075,Gupta; Anjum,21,0,76,55
1657981828511,CSE 3,A50,083646,Miranda; Gregory Joseph,24,0,50,26
1657981834540,CSE 8A,A50,083650,Miranda; Gregory Joseph,17,1,56,39
1657981840563,CSE 11,A01,083080,Cao; Yingjun,7,15,40,33
1657981846586,CSE 12,A01,083652,Krause-Levy; Sophia Louisa,30,1,120,90
1657981852624,CSE 15L,A01,083654,Morris; Justin Loren,9,0,50,41
1657981852624,CSE 15L,A02,083655,Morris; Justin Loren,11,0,50,39
1657981858648,CSE 20,A01,083657,Tran; Khoa Dang,39,0,80,41
1657981864673,CSE 21,A01,095574,Bach; Quang Tran,23,0,48,25
1657981870711,CSE 30,A01,083084,Eldon; John,8,0,80,72
1657981870711,CSE 30,B01,095061,Bhaskar; Nishant,9,0,50,41
1657981876740,CSE 100,A01,083659,Cao; Yingjun,5,4,70,65
1657981882771,CSE 134B,A01,083661,Powell; Thomas Allan,25,0,100,75
1657981888800,CSE 140,A01,083663,Gungor; Onat,17,0,85,68
1657981894824,CSE 140L,A01,083088,Eldon; John,23,0,100,77
1657981900851,CSE 175,A01,083665,Kumar; Rakesh,3,0,25,22
1657981906946,CSE 190,A00,092507,Dubnov; Shlomo,8,0,20,12
1657981912971,ECE 45,A01,083139,Congero; Spencer William,7,0,75,68
1657981918997,ECE 65,A50,083695,Saad; Andrew S,12,0,30,18
1657981918997,ECE 65,A51,095125,Saad; Andrew S,24,0,26,2
1657981925021,ECE 109,A01,091882,Touri; Behrouz,21,0,70,49
1657981931046,ECE 180,A00,083140,Abi Samra; Nicholas Camill,1,0,30,29
1657981931046,ECE 180,B00,083141,Abi Samra; Nicholas Camill,0,0,30,30
1657981937072,MATH 10A,A01,083735,Patchell; Gregory David,2,0,30,28
1657981937072,MATH 10A,A02,083736,Patchell; Gregory David,20,0,30,10
1657981937072,MATH 10A,A03,083737,Patchell; Gregory David,16,0,30,14
1657981943106,MATH 10B,A01,083207,Lim; Seonhee,9,0,34,25
1657981943106,MATH 10B,A02,083208,Lim; Seonhee,10,0,35,25
1657981943106,MATH 10B,A03,093472,Lim; Seonhee,7,0,34,27
1657981943106,MATH 10B,B01,083739,Sinha; Shubham,14,0,30,16
1657981949146,MATH 18,A01,083743,Cinel; Cameron Alexander,9,0,30,21
1657981949146,MATH 18,A02,083744,Cinel; Cameron Alexander,18,0,30,12
1657981949146,MATH 18,A03,083745,Cinel; Cameron Alexander,10,0,30,20
1657981949146,MATH 18,B01,083748,Rideout; David Porter,5,0,37,32
1657981949146,MATH 18,B02,083749,Rideout; David Porter,5,0,36,31
1657981949146,MATH 18,B03,083750,Rideout; David Porter,3,0,37,34
1657981949146,MATH 18,B04,083751,Rideout; David Porter,7,0,36,29
1657981949146,MATH 18,B05,093473,Rideout; David Porter,7,0,36,29
1657981949146,MATH 18,B06,093474,Rideout; David Porter,6,0,36,30
1657981955171,MATH 20A,A01,083754,Zheng; Zequn,14,0,40,26
1657981961203,MATH 20B,A01,083756,Briones; Jor-el Thomas Caparas,4,0,36,32
1657981961203,MATH 20B,A02,083757,Briones; Jor-el Thomas Caparas,1,0,36,35
1657981961203,MATH 20B,A03,093475,Briones; Jor-el Thomas Caparas,3,0,36,33
1657981967230,MATH 20C,A01,083760,Briones; Jor-el Thomas Caparas,1,0,35,34
1657981967230,MATH 20C,A02,083761,Briones; Jor-el Thomas Caparas,8,0,35,27
1657981967230,MATH 20C,A03,093476,Briones; Jor-el Thomas Caparas,0,1,36,36
1657981967230,MATH 20C,B01,083762,Bach; Quang Tran,1,0,30,29
1657981973260,MATH 20D,A01,083765,Tran; Brian Kha,5,0,30,25
1657981973260,MATH 20D,A02,083766,Tran; Brian Kha,5,0,30,25
1657981973260,MATH 20D,A03,083767,Tran; Brian Kha,6,0,30,24
1657981979287,MATH 20E,A01,083771,Ganguly; Soumya,12,0,32,20
1657981979287,MATH 20E,A02,083772,Ganguly; Soumya,7,0,32,25
1657981979287,MATH 20E,B01,083773,Ciotti; Benjamin,20,0,35,15
1657981979287,MATH 20E,B02,083774,Ciotti; Benjamin,18,0,35,17
1657981985318,MATH 103A,A01,083777,Greenfeld; Be'Eri,6,0,36,30
1657981985318,MATH 103A,A02,083778,Greenfeld; Be'Eri,5,0,36,31
1657981985318,MATH 103A,A03,093561,Greenfeld; Be'Eri,7,0,36,29
1657981985318,MATH 103A,B01,083779,Greenfeld; Be'Eri,8,0,36,28
1657981985318,MATH 103A,B02,083780,Greenfeld; Be'Eri,4,0,36,32
1657981985318,MATH 103A,B03,093562,Greenfeld; Be'Eri,3,0,36,33
1657981991345,MATH 105,A01,085443,Carter; Anne Toulson,15,0,35,20
1657981991345,MATH 105,A02,093477,Carter; Anne Toulson,20,0,35,15
1657981997378,MATH 109,A01,083213,Ganzberger; Geoffrey Michael,3,0,34,31
1657981997378,MATH 109,A02,083214,Ganzberger; Geoffrey Michael,4,0,34,30
1657981997378,MATH 109,A03,093478,Ganzberger; Geoffrey Michael,2,0,34,32
1657981997378,MATH 109,B01,083215,Ganzberger; Geoffrey Michael,3,0,32,29
1657981997378,MATH 109,B02,083216,Ganzberger; Geoffrey Michael,3,0,32,29
1657981997378,MATH 109,B03,093479,Ganzberger; Geoffrey Michael,8,0,32,24
1657982003411,MATH 142A,A01,083219,Chow; Bennett,7,0,32,25
1657982003411,MATH 142A,A02,083220,Chow; Bennett,10,0,32,22
1657982003411,MATH 142A,A03,093480,Chow; Bennett,9,0,32,23
1657982003411,MATH 142A,B03,093481,Chow; Bennett,8,0,32,24
1657982003411,MATH 142A,B04,093558,Chow; Bennett,14,0,32,18
1657982003411,MATH 142A,B05,093559,Chow; Bennett,7,0,32,25
1657982009437,MATH 193A,A01,083224,Rotar; Vladimir,9,0,34,25
1657982009437,MATH 193A,A02,083225,Rotar; Vladimir,11,0,34,23
1657982009437,MATH 193A,A03,083781,Rotar; Vladimir,5,0,34,29
1657982009437,MATH 193A,A04,083782,Rotar; Vladimir,12,0,34,22
1657982009437,MATH 193A,A05,093482,Rotar; Vladimir,11,0,34,23
1657982015464,MATH 197,001,091859,McAuley; Julian John,9999,0,9999,0
1657982015464,MATH 197,002,095566,Kedlaya; Kiran S.,9997,0,9999,2
1657982015464,MATH 197,003,095567,Xiao; Ming,9999,0,9999,0
1657982015464,MATH 197,004,095571,Perols; Johan Lars,9998,0,9999,1
1657982022535,COGS 9,A01,083615,Shannon; Kyle Michael,11,0,75,64
1657982028562,COGS 11,A01,083617,Boyle; Mary E. T.,23,0,48,25
1657982034589,COGS 13,A01,083071,Bastos; Amalia Pinkusfeld,12,0,71,59
1657982040614,COGS 14A,A01,092681,Semenuks; Arturs,5,1,100,95
1657982046638,COGS 14B,A01,083073,Cheng; Tzu-Han,7,0,63,56
1657982052662,COGS 17,A01,092677,Semenuks; Arturs,7,0,81,74
1657982058688,COGS 100,A01,083619,Allen; Michael Gordon,17,0,70,53
1657982064713,COGS 101A,A01,083621,Davis; Joshua Daniel,9,0,68,59
1657982070738,COGS 101B,A01,091572,Allen; Michael Gordon,14,0,65,51
1657982076766,COGS 101C,A01,083625,Delgado; Tania,17,0,35,18
1657982082793,COGS 107A,A01,083627,Boyle; Mary E. T.,14,0,60,46
1657982088820,COGS 118A,A01,083075,Gupta; Anjum,21,0,76,55
1657982094846,CSE 3,A50,083646,Miranda; Gregory Joseph,24,0,50,26
1657982100870,CSE 8A,A50,083650,Miranda; Gregory Joseph,17,1,56,39
1657982106893,CSE 11,A01,083080,Cao; Yingjun,7,15,40,33
1657982112918,CSE 12,A01,083652,Krause-Levy; Sophia Louisa,30,1,120,90
1657982118942,CSE 15L,A01,083654,Morris; Justin Loren,9,0,50,41
1657982118942,CSE 15L,A02,083655,Morris; Justin Loren,11,0,50,39
1657982124968,CSE 20,A01,083657,Tran; Khoa Dang,39,0,80,41
1657982130995,CSE 21,A01,095574,Bach; Quang Tran,23,0,48,25
1657982137025,CSE 30,A01,083084,Eldon; John,8,0,80,72
1657982137025,CSE 30,B01,095061,Bhaskar; Nishant,9,0,50,41
1657982143051,CSE 100,A01,083659,Cao; Yingjun,5,4,70,65
1657982149075,CSE 134B,A01,083661,Powell; Thomas Allan,25,0,100,75
1657982155098,CSE 140,A01,083663,Gungor; Onat,17,0,85,68
1657982161127,CSE 140L,A01,083088,Eldon; John,23,0,100,77
1657982167153,CSE 175,A01,083665,Kumar; Rakesh,3,0,25,22
1657982173180,CSE 190,A00,092507,Dubnov; Shlomo,8,0,20,12
1657982179204,ECE 45,A01,083139,Congero; Spencer William,7,0,75,68
1657982185230,ECE 65,A50,083695,Saad; Andrew S,12,0,30,18
1657982185230,ECE 65,A51,095125,Saad; Andrew S,24,0,26,2
1657982191262,ECE 109,A01,091882,Touri; Behrouz,21,0,70,49
1657982197292,ECE 180,A00,083140,Abi Samra; Nicholas Camill,1,0,30,29
1657982197292,ECE 180,B00,083141,Abi Samra; Nicholas Camill,0,0,30,30
1657982203318,MATH 10A,A01,083735,Patchell; Gregory David,2,0,30,28
1657982203318,MATH 10A,A02,083736,Patchell; Gregory David,20,0,30,10
1657982203318,MATH 10A,A03,083737,Patchell; Gregory David,16,0,30,14
1657982209353,MATH 10B,A01,083207,Lim; Seonhee,9,0,34,25
1657982209353,MATH 10B,A02,083208,Lim; Seonhee,10,0,35,25
1657982209353,MATH 10B,A03,093472,Lim; Seonhee,7,0,34,27
1657982209353,MATH 10B,B01,083739,Sinha; Shubham,14,0,30,16
1657982215381,MATH 18,A01,083743,Cinel; Cameron Alexander,9,0,30,21
1657982215381,MATH 18,A02,083744,Cinel; Cameron Alexander,18,0,30,12
1657982215381,MATH 18,A03,083745,Cinel; Cameron Alexander,10,0,30,20
1657982215381,MATH 18,B01,083748,Rideout; David Porter,5,0,37,32
1657982215381,MATH 18,B02,083749,Rideout; David Porter,5,0,36,31
1657982215381,MATH 18,B03,083750,Rideout; David Porter,3,0,37,34
1657982215381,MATH 18,B04,083751,Rideout; David Porter,7,0,36,29
1657982215381,MATH 18,B05,093473,Rideout; David Porter,7,0,36,29
1657982215381,MATH 18,B06,093474,Rideout; David Porter,6,0,36,30
1657982221417,MATH 20A,A01,083754,Zheng; Zequn,14,0,40,26
1657982227445,MATH 20B,A01,083756,Briones; Jor-el Thomas Caparas,4,0,36,32
1657982227445,MATH 20B,A02,083757,Briones; Jor-el Thomas Caparas,1,0,36,35
1657982227445,MATH 20B,A03,093475,Briones; Jor-el Thomas Caparas,3,0,36,33
1657982233478,MATH 20C,A01,083760,Briones; Jor-el Thomas Caparas,1,0,35,34
1657982233478,MATH 20C,A02,083761,Briones; Jor-el Thomas Caparas,8,0,35,27
1657982233478,MATH 20C,A03,093476,Briones; Jor-el Thomas Caparas,0,1,36,36
1657982233478,MATH 20C,B01,083762,Bach; Quang Tran,1,0,30,29
1657982239504,MATH 20D,A01,083765,Tran; Brian Kha,5,0,30,25
1657982239504,MATH 20D,A02,083766,Tran; Brian Kha,5,0,30,25
1657982239504,MATH 20D,A03,083767,Tran; Brian Kha,6,0,30,24
1657982245543,MATH 20E,A01,083771,Ganguly; Soumya,12,0,32,20
1657982245543,MATH 20E,A02,083772,Ganguly; Soumya,7,0,32,25
1657982245543,MATH 20E,B01,083773,Ciotti; Benjamin,20,0,35,15
1657982245543,MATH 20E,B02,083774,Ciotti; Benjamin,18,0,35,17
1657982251570,MATH 103A,A01,083777,Greenfeld; Be'Eri,6,0,36,30
1657982251570,MATH 103A,A02,083778,Greenfeld; Be'Eri,5,0,36,31
1657982251570,MATH 103A,A03,093561,Greenfeld; Be'Eri,7,0,36,29
1657982251570,MATH 103A,B01,083779,Greenfeld; Be'Eri,8,0,36,28
1657982251570,MATH 103A,B02,083780,Greenfeld; Be'Eri,4,0,36,32
1657982251570,MATH 103A,B03,093562,Greenfeld; Be'Eri,3,0,36,33
1657982257596,MATH 105,A01,085443,Carter; Anne Toulson,15,0,35,20
1657982257596,MATH 105,A02,093477,Carter; Anne Toulson,20,0,35,15
1657982263627,MATH 109,A01,083213,Ganzberger; Geoffrey Michael,3,0,34,31
1657982263627,MATH 109,A02,083214,Ganzberger; Geoffrey Michael,4,0,34,30
1657982263627,MATH 109,A03,093478,Ganzberger; Geoffrey Michael,2,0,34,32
1657982263627,MATH 109,B01,083215,Ganzberger; Geoffrey Michael,3,0,32,29
1657982263627,MATH 109,B02,083216,Ganzberger; Geoffrey Michael,3,0,32,29
1657982263627,MATH 109,B03,093479,Ganzberger; Geoffrey Michael,8,0,32,24
1657982269652,MATH 142A,A01,083219,Chow; Bennett,7,0,32,25
1657982269652,MATH 142A,A02,083220,Chow; Bennett,10,0,32,22
1657982269652,MATH 142A,A03,093480,Chow; Bennett,9,0,32,23
1657982269652,MATH 142A,B03,093481,Chow; Bennett,8,0,32,24
1657982269652,MATH 142A,B04,093558,Chow; Bennett,14,0,32,18
1657982269652,MATH 142A,B05,093559,Chow; Bennett,7,0,32,25
1657982275676,MATH 193A,A01,083224,Rotar; Vladimir,9,0,34,25
1657982275676,MATH 193A,A02,083225,Rotar; Vladimir,11,0,34,23
1657982275676,MATH 193A,A03,083781,Rotar; Vladimir,5,0,34,29
1657982275676,MATH 193A,A04,083782,Rotar; Vladimir,12,0,34,22
1657982275676,MATH 193A,A05,093482,Rotar; Vladimir,11,0,34,23
1657982281707,MATH 197,001,091859,McAuley; Julian John,9999,0,9999,0
1657982281707,MATH 197,002,095566,Kedlaya; Kiran S.,9997,0,9999,2
1657982281707,MATH 197,003,095567,Xiao; Ming,9999,0,9999,0
1657982281707,MATH 197,004,095571,Perols; Johan Lars,9998,0,9999,1
1657982288759,COGS 9,A01,083615,Shannon; Kyle Michael,11,0,75,64
1657982294788,COGS 11,A01,083617,Boyle; Mary E. T.,23,0,48,25
1657982300812,COGS 13,A01,083071,Bastos; Amalia Pinkusfeld,12,0,71,59
1657982306842,COGS 14A,A01,092681,Semenuks; Arturs,5,1,100,95
1657982312870,COGS 14B,A01,083073,Cheng; Tzu-Han,7,0,63,56
1657982318898,COGS 17,A01,092677,Semenuks; Arturs,7,0,81,74
1657982324928,COGS 100,A01,083619,Allen; Michael Gordon,17,0,70,53
1657982330954,COGS 101A,A01,083621,Davis; Joshua Daniel,9,0,68,59
1657982336978,COGS 101B,A01,091572,Allen; Michael Gordon,14,0,65,51
1657982343002,COGS 101C,A01,083625,Delgado; Tania,17,0,35,18
1657982349025,COGS 107A,A01,083627,Boyle; Mary E. T.,14,0,60,46
1657982355050,COGS 118A,A01,083075,Gupta; Anjum,21,0,76,55
1657982361078,CSE 3,A50,083646,Miranda; Gregory Joseph,24,0,50,26
1657982367101,CSE 8A,A50,083650,Miranda; Gregory Joseph,17,1,56,39
1657982373129,CSE 11,A01,083080,Cao; Yingjun,7,15,40,33
1657982379154,CSE 12,A01,083652,Krause-Levy; Sophia Louisa,30,1,120,90
1657982385180,CSE 15L,A01,083654,Morris; Justin Loren,9,0,50,41
1657982385180,CSE 15L,A02,083655,Morris; Justin Loren,11,0,50,39
1657982391205,CSE 20,A01,083657,Tran; Khoa Dang,39,0,80,41
1657982397231,CSE 21,A01,095574,Bach; Quang Tran,23,0,48,25
1657982403255,CSE 30,A01,083084,Eldon; John,8,0,80,72
1657982403255,CSE 30,B01,095061,Bhaskar; Nishant,9,0,50,41
1657982409282,CSE 100,A01,083659,Cao; Yingjun,5,4,70,65
1657982415313,CSE 134B,A01,083661,Powell; Thomas Allan,25,0,100,75
1657982421337,CSE 140,A01,083663,Gungor; Onat,17,0,85,68
1657982427364,CSE 140L,A01,083088,Eldon; John,23,0,100,77
1657982433390,CSE 175,A01,083665,Kumar; Rakesh,3,0,25,22
1657982439435,CSE 190,A00,092507,Dubnov; Shlomo,8,0,20,12
1657982445464,ECE 45,A01,083139,Congero; Spencer William,7,0,75,68
1657982451494,ECE 65,A50,083695,Saad; Andrew S,12,0,30,18
1657982451494,ECE 65,A51,095125,Saad; Andrew S,24,0,26,2
1657982457521,ECE 109,A01,091882,Touri; Behrouz,21,0,70,49
1657982463553,ECE 180,A00,083140,Abi Samra; Nicholas Camill,1,0,30,29
1657982463553,ECE 180,B00,083141,Abi Samra; Nicholas Camill,0,0,30,30
1657982469579,MATH 10A,A01,083735,Patchell; Gregory David,2,0,30,28
1657982469579,MATH 10A,A02,083736,Patchell; Gregory David,20,0,30,10
1657982469579,MATH 10A,A03,083737,Patchell; Gregory David,16,0,30,14
1657982475604,MATH 10B,A01,083207,Lim; Seonhee,9,0,34,25
1657982475604,MATH 10B,A02,083208,Lim; Seonhee,10,0,35,25
1657982475604,MATH 10B,A03,093472,Lim; Seonhee,7,0,34,27
1657982475604,MATH 10B,B01,083739,Sinha; Shubham,14,0,30,16
1657982481632,MATH 18,A01,083743,Cinel; Cameron Alexander,9,0,30,21
1657982481632,MATH 18,A02,083744,Cinel; Cameron Alexander,18,0,30,12
1657982481632,MATH 18,A03,083745,Cinel; Cameron Alexander,10,0,30,20
1657982481632,MATH 18,B01,083748,Rideout; David Porter,5,0,37,32
1657982481632,MATH 18,B02,083749,Rideout; David Porter,5,0,36,31
1657982481632,MATH 18,B03,083750,Rideout; David Porter,3,0,37,34
1657982481632,MATH 18,B04,083751,Rideout; David Porter,7,0,36,29
1657982481632,MATH 18,B05,093473,Rideout; David Porter,7,0,36,29
1657982481632,MATH 18,B06,093474,Rideout; David Porter,6,0,36,30
1657982487657,MATH 20A,A01,083754,Zheng; Zequn,14,0,40,26
1657982493683,MATH 20B,A01,083756,Briones; Jor-el Thomas Caparas,4,0,36,32
1657982493683,MATH 20B,A02,083757,Briones; Jor-el Thomas Caparas,1,0,36,35
1657982493683,MATH 20B,A03,093475,Briones; Jor-el Thomas Caparas,3,0,36,33
1657982499709,MATH 20C,A01,083760,Briones; Jor-el Thomas Caparas,1,0,35,34
1657982499709,MATH 20C,A02,083761,Briones; Jor-el Thomas Caparas,8,0,35,27
1657982499709,MATH 20C,A03,093476,Briones; Jor-el Thomas Caparas,0,1,36,36
1657982499709,MATH 20C,B01,083762,Bach; Quang Tran,1,0,30,29
1657982505807,MATH 20D,A01,083765,Tran; Brian Kha,5,0,30,25
1657982505807,MATH 20D,A02,083766,Tran; Brian Kha,5,0,30,25
1657982505807,MATH 20D,A03,083767,Tran; Brian Kha,6,0,30,24
1657982511835,MATH 20E,A01,083771,Ganguly; Soumya,12,0,32,20
1657982511835,MATH 20E,A02,083772,Ganguly; Soumya,7,0,32,25
1657982511835,MATH 20E,B01,083773,Ciotti; Benjamin,20,0,35,15
1657982511835,MATH 20E,B02,083774,Ciotti; Benjamin,18,0,35,17
1657982517868,MATH 103A,A01,083777,Greenfeld; Be'Eri,6,0,36,30
1657982517868,MATH 103A,A02,083778,Greenfeld; Be'Eri,5,0,36,31
1657982517868,MATH 103A,A03,093561,Greenfeld; Be'Eri,7,0,36,29
1657982517868,MATH 103A,B01,083779,Greenfeld; Be'Eri,8,0,36,28
1657982517868,MATH 103A,B02,083780,Greenfeld; Be'Eri,4,0,36,32
1657982517868,MATH 103A,B03,093562,Greenfeld; Be'Eri,3,0,36,33
1657982523897,MATH 105,A01,085443,Carter; Anne Toulson,15,0,35,20
1657982523897,MATH 105,A02,093477,Carter; Anne Toulson,20,0,35,15
1657982529921,MATH 109,A01,083213,Ganzberger; Geoffrey Michael,3,0,34,31
1657982529921,MATH 109,A02,083214,Ganzberger; Geoffrey Michael,4,0,34,30
1657982529921,MATH 109,A03,093478,Ganzberger; Geoffrey Michael,2,0,34,32
1657982529921,MATH 109,B01,083215,Ganzberger; Geoffrey Michael,3,0,32,29
1657982529921,MATH 109,B02,083216,Ganzberger; Geoffrey Michael,3,0,32,29
1657982529921,MATH 109,B03,093479,Ganzberger; Geoffrey Michael,8,0,32,24
1657982535952,MATH 142A,A01,083219,Chow; Bennett,7,0,32,25
1657982535952,MATH 142A,A02,083220,Chow; Bennett,10,0,32,22
1657982535952,MATH 142A,A03,093480,Chow; Bennett,9,0,32,23
1657982535952,MATH 142A,B03,093481,Chow; Bennett,8,0,32,24
1657982535952,MATH 142A,B04,093558,Chow; Bennett,14,0,32,18
1657982535952,MATH 142A,B05,093559,Chow; Bennett,7,0,32,25
1657982541982,MATH 193A,A01,083224,Rotar; Vladimir,9,0,34,25
1657982541982,MATH 193A,A02,083225,Rotar; Vladimir,11,0,34,23
1657982541982,MATH 193A,A03,083781,Rotar; Vladimir,5,0,34,29
1657982541982,MATH 193A,A04,083782,Rotar; Vladimir,12,0,34,22
1657982541982,MATH 193A,A05,093482,Rotar; Vladimir,11,0,34,23
1657982548010,MATH 197,001,091859,McAuley; Julian John,9999,0,9999,0
1657982548010,MATH 197,002,095566,Kedlaya; Kiran S.,9997,0,9999,2
1657982548010,MATH 197,003,095567,Xiao; Ming,9999,0,9999,0
1657982548010,MATH 197,004,095571,Perols; Johan Lars,9998,0,9999,1
1657982555080,COGS 9,A01,083615,Shannon; Kyle Michael,11,0,75,64
1657982561104,COGS 11,A01,083617,Boyle; Mary E. T.,23,0,48,25
1657982567130,COGS 13,A01,083071,Bastos; Amalia Pinkusfeld,12,0,71,59
1657982573169,COGS 14A,A01,092681,Semenuks; Arturs,5,1,100,95
1657982579193,COGS 14B,A01,083073,Cheng; Tzu-Han,7,0,63,56
1657982585217,COGS 17,A01,092677,Semenuks; Arturs,7,0,81,74
1657982591246,COGS 100,A01,083619,Allen; Michael Gordon,17,0,70,53
1657982597273,COGS 101A,A01,083621,Davis; Joshua Daniel,9,0,68,59
1657982603297,COGS 101B,A01,091572,Allen; Michael Gordon,14,0,65,51
1657982609322,COGS 101C,A01,083625,Delgado; Tania,17,0,35,18
1657982615347,COGS 107A,A01,083627,Boyle; Mary E. T.,14,0,60,46
1657982621375,COGS 118A,A01,083075,Gupta; Anjum,21,0,76,55
1657982627401,CSE 3,A50,083646,Miranda; Gregory Joseph,24,0,50,26
1657982633426,CSE 8A,A50,083650,Miranda; Gregory Joseph,17,1,56,39
1657982639448,CSE 11,A01,083080,Cao; Yingjun,7,15,40,33
1657982645475,CSE 12,A01,083652,Krause-Levy; Sophia Louisa,30,1,120,90
1657982651507,CSE 15L,A01,083654,Morris; Justin Loren,9,0,50,41
1657982651507,CSE 15L,A02,083655,Morris; Justin Loren,11,0,50,39
1657982657532,CSE 20,A01,083657,Tran; Khoa Dang,39,0,80,41
1657982663560,CSE 21,A01,095574,Bach; Quang Tran,23,0,48,25
1657982669587,CSE 30,A01,083084,Eldon; John,8,0,80,72
1657982669587,CSE 30,B01,095061,Bhaskar; Nishant,9,0,50,41
1657982675616,CSE 100,A01,083659,Cao; Yingjun,5,4,70,65
1657982681645,CSE 134B,A01,083661,Powell; Thomas Allan,25,0,100,75
1657982687674,CSE 140,A01,083663,Gungor; Onat,17,0,85,68
1657982693698,CSE 140L,A01,083088,Eldon; John,23,0,100,77
1657982699725,CSE 175,A01,083665,Kumar; Rakesh,3,0,25,22
1657982705749,CSE 190,A00,092507,Dubnov; Shlomo,8,0,20,12
1657982711779,ECE 45,A01,083139,Congero; Spencer William,7,0,75,68
1657982717813,ECE 65,A50,083695,Saad; Andrew S,12,0,30,18
1657982717813,ECE 65,A51,095125,Saad; Andrew S,24,0,26,2
1657982723838,ECE 109,A01,091882,Touri; Behrouz,21,0,70,49
1657982729863,ECE 180,A00,083140,Abi Samra; Nicholas Camill,1,0,30,29
1657982729863,ECE 180,B00,083141,Abi Samra; Nicholas Camill,0,0,30,30
1657982735895,MATH 10A,A01,083735,Patchell; Gregory David,2,0,30,28
1657982735895,MATH 10A,A02,083736,Patchell; Gregory David,20,0,30,10
1657982735895,MATH 10A,A03,083737,Patchell; Gregory David,16,0,30,14
1657982741929,MATH 10B,A01,083207,Lim; Seonhee,9,0,34,25
1657982741929,MATH 10B,A02,083208,Lim; Seonhee,10,0,35,25
1657982741929,MATH 10B,A03,093472,Lim; Seonhee,7,0,34,27
1657982741929,MATH 10B,B01,083739,Sinha; Shubham,14,0,30,16
1657982747970,MATH 18,A01,083743,Cinel; Cameron Alexander,9,0,30,21
1657982747970,MATH 18,A02,083744,Cinel; Cameron Alexander,18,0,30,12
1657982747970,MATH 18,A03,083745,Cinel; Cameron Alexander,10,0,30,20
1657982747970,MATH 18,B01,083748,Rideout; David Porter,5,0,37,32
1657982747970,MATH 18,B02,083749,Rideout; David Porter,5,0,36,31
1657982747970,MATH 18,B03,083750,Rideout; David Porter,3,0,37,34
1657982747970,MATH 18,B04,083751,Rideout; David Porter,7,0,36,29
1657982747970,MATH 18,B05,093473,Rideout; David Porter,7,0,36,29
1657982747970,MATH 18,B06,093474,Rideout; David Porter,6,0,36,30
1657982753996,MATH 20A,A01,083754,Zheng; Zequn,14,0,40,26
1657982760022,MATH 20B,A01,083756,Briones; Jor-el Thomas Caparas,4,0,36,32
1657982760022,MATH 20B,A02,083757,Briones; Jor-el Thomas Caparas,1,0,36,35
1657982760022,MATH 20B,A03,093475,Briones; Jor-el Thomas Caparas,3,0,36,33
1657982766048,MATH 20C,A01,083760,Briones; Jor-el Thomas Caparas,1,0,35,34
1657982766048,MATH 20C,A02,083761,Briones; Jor-el Thomas Caparas,8,0,35,27
1657982766048,MATH 20C,A03,093476,Briones; Jor-el Thomas Caparas,0,1,36,36
1657982766048,MATH 20C,B01,083762,Bach; Quang Tran,1,0,30,29
1657982772079,MATH 20D,A01,083765,Tran; Brian Kha,5,0,30,25
1657982772079,MATH 20D,A02,083766,Tran; Brian Kha,5,0,30,25
1657982772079,MATH 20D,A03,083767,Tran; Brian Kha,6,0,30,24
1657982778115,MATH 20E,A01,083771,Ganguly; Soumya,12,0,32,20
1657982778115,MATH 20E,A02,083772,Ganguly; Soumya,7,0,32,25
1657982778115,MATH 20E,B01,083773,Ciotti; Benjamin,20,0,35,15
1657982778115,MATH 20E,B02,083774,Ciotti; Benjamin,18,0,35,17
1657982784141,MATH 103A,A01,083777,Greenfeld; Be'Eri,6,0,36,30
1657982784141,MATH 103A,A02,083778,Greenfeld; Be'Eri,5,0,36,31
1657982784141,MATH 103A,A03,093561,Greenfeld; Be'Eri,7,0,36,29
1657982784141,MATH 103A,B01,083779,Greenfeld; Be'Eri,8,0,36,28
1657982784141,MATH 103A,B02,083780,Greenfeld; Be'Eri,4,0,36,32
1657982784141,MATH 103A,B03,093562,Greenfeld; Be'Eri,3,0,36,33
1657982790182,MATH 105,A01,085443,Carter; Anne Toulson,15,0,35,20
1657982790182,MATH 105,A02,093477,Carter; Anne Toulson,20,0,35,15
1657982796212,MATH 109,A01,083213,Ganzberger; Geoffrey Michael,3,0,34,31
1657982796212,MATH 109,A02,083214,Ganzberger; Geoffrey Michael,4,0,34,30
1657982796212,MATH 109,A03,093478,Ganzberger; Geoffrey Michael,2,0,34,32
1657982796212,MATH 109,B01,083215,Ganzberger; Geoffrey Michael,3,0,32,29
1657982796212,MATH 109,B02,083216,Ganzberger; Geoffrey Michael,3,0,32,29
1657982796212,MATH 109,B03,093479,Ganzberger; Geoffrey Michael,8,0,32,24
1657982802241,MATH 142A,A01,083219,Chow; Bennett,7,0,32,25
1657982802241,MATH 142A,A02,083220,Chow; Bennett,10,0,32,22
1657982802241,MATH 142A,A03,093480,Chow; Bennett,9,0,32,23
1657982802241,MATH 142A,B03,093481,Chow; Bennett,8,0,32,24
1657982802241,MATH 142A,B04,093558,Chow; Bennett,14,0,32,18
1657982802241,MATH 142A,B05,093559,Chow; Bennett,7,0,32,25
1657982808270,MATH 193A,A01,083224,Rotar; Vladimir,9,0,34,25
1657982808270,MATH 193A,A02,083225,Rotar; Vladimir,11,0,34,23
1657982808270,MATH 193A,A03,083781,Rotar; Vladimir,5,0,34,29
1657982808270,MATH 193A,A04,083782,Rotar; Vladimir,12,0,34,22
1657982808270,MATH 193A,A05,093482,Rotar; Vladimir,11,0,34,23
1657982814298,MATH 197,001,091859,McAuley; Julian John,9999,0,9999,0
1657982814298,MATH 197,002,095566,Kedlaya; Kiran S.,9997,0,9999,2
1657982814298,MATH 197,003,095567,Xiao; Ming,9999,0,9999,0
1657982814298,MATH 197,004,095571,Perols; Johan Lars,9998,0,9999,1
1657982821379,COGS 9,A01,083615,Shannon; Kyle Michael,11,0,75,64
1657982827415,COGS 11,A01,083617,Boyle; Mary E. T.,23,0,48,25
1657982833444,COGS 13,A01,083071,Bastos; Amalia Pinkusfeld,12,0,71,59
1657982839469,COGS 14A,A01,092681,Semenuks; Arturs,5,1,100,95
1657982845493,COGS 14B,A01,083073,Cheng; Tzu-Han,7,0,63,56
1657982851516,COGS 17,A01,092677,Semenuks; Arturs,7,0,81,74
1657982857542,COGS 100,A01,083619,Allen; Michael Gordon,17,0,70,53
1657982863571,COGS 101A,A01,083621,Davis; Joshua Daniel,9,0,68,59
1657982869599,COGS 101B,A01,091572,Allen; Michael Gordon,14,0,65,51
1657982875624,COGS 101C,A01,083625,Delgado; Tania,17,0,35,18
1657982881650,COGS 107A,A01,083627,Boyle; Mary E. T.,14,0,60,46
1657982887673,COGS 118A,A01,083075,Gupta; Anjum,21,0,76,55
1657982893698,CSE 3,A50,083646,Miranda; Gregory Joseph,24,0,50,26
1657982899721,CSE 8A,A50,083650,Miranda; Gregory Joseph,17,1,56,39
1657982905746,CSE 11,A01,083080,Cao; Yingjun,7,15,40,33
1657982911776,CSE 12,A01,083652,Krause-Levy; Sophia Louisa,30,1,120,90
1657982917804,CSE 15L,A01,083654,Morris; Justin Loren,9,0,50,41
1657982917804,CSE 15L,A02,083655,Morris; Justin Loren,11,0,50,39
1657982923829,CSE 20,A01,083657,Tran; Khoa Dang,39,0,80,41
1657982929859,CSE 21,A01,095574,Bach; Quang Tran,23,0,48,25
1657982935890,CSE 30,A01,083084,Eldon; John,8,0,80,72
1657982935890,CSE 30,B01,095061,Bhaskar; Nishant,9,0,50,41
1657982941921,CSE 100,A01,083659,Cao; Yingjun,5,4,70,65
1657982947949,CSE 134B,A01,083661,Powell; Thomas Allan,25,0,100,75
1657982953972,CSE 140,A01,083663,Gungor; Onat,17,0,85,68
1657982959998,CSE 140L,A01,083088,Eldon; John,23,0,100,77
1657982966023,CSE 175,A01,083665,Kumar; Rakesh,3,0,25,22
1657982972052,CSE 190,A00,092507,Dubnov; Shlomo,8,0,20,12
1657982978084,ECE 45,A01,083139,Congero; Spencer William,7,0,75,68
1657982984115,ECE 65,A50,083695,Saad; Andrew S,12,0,30,18
1657982984115,ECE 65,A51,095125,Saad; Andrew S,24,0,26,2
1657982990162,ECE 109,A01,091882,Touri; Behrouz,21,0,70,49
1657982996193,ECE 180,A00,083140,Abi Samra; Nicholas Camill,1,0,30,29
1657982996193,ECE 180,B00,083141,Abi Samra; Nicholas Camill,0,0,30,30
1657983002231,MATH 10A,A01,083735,Patchell; Gregory David,2,0,30,28
1657983002231,MATH 10A,A02,083736,Patchell; Gregory David,20,0,30,10
1657983002231,MATH 10A,A03,083737,Patchell; Gregory David,16,0,30,14
1657983008258,MATH 10B,A01,083207,Lim; Seonhee,9,0,34,25
1657983008258,MATH 10B,A02,083208,Lim; Seonhee,10,0,35,25
1657983008258,MATH 10B,A03,093472,Lim; Seonhee,7,0,34,27
1657983008258,MATH 10B,B01,083739,Sinha; Shubham,14,0,30,16
1657983014295,MATH 18,A01,083743,Cinel; Cameron Alexander,9,0,30,21
1657983014295,MATH 18,A02,083744,Cinel; Cameron Alexander,18,0,30,12
1657983014295,MATH 18,A03,083745,Cinel; Cameron Alexander,10,0,30,20
1657983014295,MATH 18,B01,083748,Rideout; David Porter,5,0,37,32
1657983014295,MATH 18,B02,083749,Rideout; David Porter,5,0,36,31
1657983014295,MATH 18,B03,083750,Rideout; David Porter,3,0,37,34
1657983014295,MATH 18,B04,083751,Rideout; David Porter,7,0,36,29
1657983014295,MATH 18,B05,093473,Rideout; David Porter,7,0,36,29
1657983014295,MATH 18,B06,093474,Rideout; David Porter,6,0,36,30
1657983020320,MATH 20A,A01,083754,Zheng; Zequn,14,0,40,26
1657983026346,MATH 20B,A01,083756,Briones; Jor-el Thomas Caparas,4,0,36,32
1657983026346,MATH 20B,A02,083757,Briones; Jor-el Thomas Caparas,1,0,36,35
1657983026346,MATH 20B,A03,093475,Briones; Jor-el Thomas Caparas,3,0,36,33
1657983032371,MATH 20C,A01,083760,Briones; Jor-el Thomas Caparas,1,0,35,34
1657983032371,MATH 20C,A02,083761,Briones; Jor-el Thomas Caparas,8,0,35,27
1657983032371,MATH 20C,A03,093476,Briones; Jor-el Thomas Caparas,0,1,36,36
1657983032371,MATH 20C,B01,083762,Bach; Quang Tran,1,0,30,29
1657983038396,MATH 20D,A01,083765,Tran; Brian Kha,5,0,30,25
1657983038396,MATH 20D,A02,083766,Tran; Brian Kha,5,0,30,25
1657983038396,MATH 20D,A03,083767,Tran; Brian Kha,6,0,30,24
1657983044430,MATH 20E,A01,083771,Ganguly; Soumya,12,0,32,20
1657983044430,MATH 20E,A02,083772,Ganguly; Soumya,7,0,32,25
1657983044430,MATH 20E,B01,083773,Ciotti; Benjamin,20,0,35,15
1657983044430,MATH 20E,B02,083774,Ciotti; Benjamin,18,0,35,17
1657983050457,MATH 103A,A01,083777,Greenfeld; Be'Eri,6,0,36,30
1657983050457,MATH 103A,A02,083778,Greenfeld; Be'Eri,5,0,36,31
1657983050457,MATH 103A,A03,093561,Greenfeld; Be'Eri,7,0,36,29
1657983050457,MATH 103A,B01,083779,Greenfeld; Be'Eri,8,0,36,28
1657983050457,MATH 103A,B02,083780,Greenfeld; Be'Eri,4,0,36,32
1657983050457,MATH 103A,B03,093562,Greenfeld; Be'Eri,3,0,36,33
1657983056492,MATH 105,A01,085443,Carter; Anne Toulson,15,0,35,20
1657983056492,MATH 105,A02,093477,Carter; Anne Toulson,20,0,35,15
1657983062531,MATH 109,A01,083213,Ganzberger; Geoffrey Michael,3,0,34,31
1657983062531,MATH 109,A02,083214,Ganzberger; Geoffrey Michael,4,0,34,30
1657983062531,MATH 109,A03,093478,Ganzberger; Geoffrey Michael,2,0,34,32
1657983062531,MATH 109,B01,083215,Ganzberger; Geoffrey Michael,3,0,32,29
1657983062531,MATH 109,B02,083216,Ganzberger; Geoffrey Michael,3,0,32,29
1657983062531,MATH 109,B03,093479,Ganzberger; Geoffrey Michael,8,0,32,24
1657983068556,MATH 142A,A01,083219,Chow; Bennett,7,0,32,25
1657983068556,MATH 142A,A02,083220,Chow; Bennett,10,0,32,22
1657983068556,MATH 142A,A03,093480,Chow; Bennett,9,0,32,23
1657983068556,MATH 142A,B03,093481,Chow; Bennett,8,0,32,24
1657983068556,MATH 142A,B04,093558,Chow; Bennett,14,0,32,18
1657983068556,MATH 142A,B05,093559,Chow; Bennett,7,0,32,25
1657983074582,MATH 193A,A01,083224,Rotar; Vladimir,9,0,34,25
1657983074582,MATH 193A,A02,083225,Rotar; Vladimir,11,0,34,23
1657983074582,MATH 193A,A03,083781,Rotar; Vladimir,5,0,34,29
1657983074582,MATH 193A,A04,083782,Rotar; Vladimir,12,0,34,22
1657983074582,MATH 193A,A05,093482,Rotar; Vladimir,11,0,34,23
1657983080611,MATH 197,001,091859,McAuley; Julian John,9999,0,9999,0
1657983080611,MATH 197,002,095566,Kedlaya; Kiran S.,9997,0,9999,2
1657983080611,MATH 197,003,095567,Xiao; Ming,9999,0,9999,0
1657983080611,MATH 197,004,095571,Perols; Johan Lars,9998,0,9999,1
1657983087680,COGS 9,A01,083615,Shannon; Kyle Michael,11,0,75,64
1657983093710,COGS 11,A01,083617,Boyle; Mary E. T.,23,0,48,25
1657983099835,COGS 13,A01,083071,Bastos; Amalia Pinkusfeld,12,0,71,59
1657983105864,COGS 14A,A01,092681,Semenuks; Arturs,5,1,100,95
1657983111888,COGS 14B,A01,083073,Cheng; Tzu-Han,7,0,63,56
1657983117914,COGS 17,A01,092677,Semenuks; Arturs,7,0,81,74
1657983123937,COGS 100,A01,083619,Allen; Michael Gordon,17,0,70,53
1657983129964,COGS 101A,A01,083621,Davis; Joshua Daniel,9,0,68,59
1657983135991,COGS 101B,A01,091572,Allen; Michael Gordon,14,0,65,51
1657983142017,COGS 101C,A01,083625,Delgado; Tania,17,0,35,18
1657983148046,COGS 107A,A01,083627,Boyle; Mary E. T.,14,0,60,46
1657983154070,COGS 118A,A01,083075,Gupta; Anjum,21,0,76,55
1657983160095,CSE 3,A50,083646,Miranda; Gregory Joseph,24,0,50,26
1657983166119,CSE 8A,A50,083650,Miranda; Gregory Joseph,17,1,56,39
1657983172149,CSE 11,A01,083080,Cao; Yingjun,7,15,40,33
1657983178178,CSE 12,A01,083652,Krause-Levy; Sophia Louisa,30,1,120,90
1657983184203,CSE 15L,A01,083654,Morris; Justin Loren,9,0,50,41
1657983184203,CSE 15L,A02,083655,Morris; Justin Loren,11,0,50,39
1657983190228,CSE 20,A01,083657,Tran; Khoa Dang,39,0,80,41
1657983196258,CSE 21,A01,095574,Bach; Quang Tran,23,0,48,25
1657983202284,CSE 30,A01,083084,Eldon; John,8,0,80,72
1657983202284,CSE 30,B01,095061,Bhaskar; Nishant,9,0,50,41
1657983208310,CSE 100,A01,083659,Cao; Yingjun,5,4,70,65
1657983214338,CSE 134B,A01,083661,Powell; Thomas Allan,25,0,100,75
1657983220362,CSE 140,A01,083663,Gungor; Onat,17,0,85,68
1657983226388,CSE 140L,A01,083088,Eldon; John,23,0,100,77
1657983232412,CSE 175,A01,083665,Kumar; Rakesh,3,0,25,22
1657983238437,CSE 190,A00,092507,Dubnov; Shlomo,8,0,20,12
1657983244464,ECE 45,A01,083139,Congero; Spencer William,7,0,75,68
1657983250491,ECE 65,A50,083695,Saad; Andrew S,12,0,30,18
1657983250491,ECE 65,A51,095125,Saad; Andrew S,24,0,26,2
1657983256522,ECE 109,A01,091882,Touri; Behrouz,21,0,70,49
1657983262553,ECE 180,A00,083140,Abi Samra; Nicholas Camill,1,0,30,29
1657983262553,ECE 180,B00,083141,Abi Samra; Nicholas Camill,0,0,30,30
1657983268591,MATH 10A,A01,083735,Patchell; Gregory David,2,0,30,28
1657983268591,MATH 10A,A02,083736,Patchell; Gregory David,20,0,30,10
1657983268591,MATH 10A,A03,083737,Patchell; Gregory David,16,0,30,14
1657983274619,MATH 10B,A01,083207,Lim; Seonhee,9,0,34,25
1657983274619,MATH 10B,A02,083208,Lim; Seonhee,10,0,35,25
1657983274619,MATH 10B,A03,093472,Lim; Seonhee,7,0,34,27
1657983274619,MATH 10B,B01,083739,Sinha; Shubham,14,0,30,16
1657983280660,MATH 18,A01,083743,Cinel; Cameron Alexander,9,0,30,21
1657983280660,MATH 18,A02,083744,Cinel; Cameron Alexander,18,0,30,12
1657983280660,MATH 18,A03,083745,Cinel; Cameron Alexander,10,0,30,20
1657983280660,MATH 18,B01,083748,Rideout; David Porter,5,0,37,32
1657983280660,MATH 18,B02,083749,Rideout; David Porter,5,0,36,31
1657983280660,MATH 18,B03,083750,Rideout; David Porter,3,0,37,34
1657983280660,MATH 18,B04,083751,Rideout; David Porter,7,0,36,29
1657983280660,MATH 18,B05,093473,Rideout; David Porter,7,0,36,29
1657983280660,MATH 18,B06,093474,Rideout; David Porter,6,0,36,30
1657983286692,MATH 20A,A01,083754,Zheng; Zequn,14,0,40,26
1657983292723,MATH 20B,A01,083756,Briones; Jor-el Thomas Caparas,4,0,36,32
1657983292723,MATH 20B,A02,083757,Briones; Jor-el Thomas Caparas,1,0,36,35
1657983292723,MATH 20B,A03,093475,Briones; Jor-el Thomas Caparas,3,0,36,33
1657983298756,MATH 20C,A01,083760,Briones; Jor-el Thomas Caparas,1,0,35,34
1657983298756,MATH 20C,A02,083761,Briones; Jor-el Thomas Caparas,8,0,35,27
1657983298756,MATH 20C,A03,093476,Briones; Jor-el Thomas Caparas,0,1,36,36
1657983298756,MATH 20C,B01,083762,Bach; Quang Tran,1,0,30,29
1657983304791,MATH 20D,A01,083765,Tran; Brian Kha,5,0,30,25
1657983304791,MATH 20D,A02,083766,Tran; Brian Kha,5,0,30,25
1657983304791,MATH 20D,A03,083767,Tran; Brian Kha,6,0,30,24
1657983310818,MATH 20E,A01,083771,Ganguly; Soumya,12,0,32,20
1657983310818,MATH 20E,A02,083772,Ganguly; Soumya,7,0,32,25
1657983310818,MATH 20E,B01,083773,Ciotti; Benjamin,20,0,35,15
1657983310818,MATH 20E,B02,083774,Ciotti; Benjamin,18,0,35,17
1657983316855,MATH 103A,A01,083777,Greenfeld; Be'Eri,6,0,36,30
1657983316855,MATH 103A,A02,083778,Greenfeld; Be'Eri,5,0,36,31
1657983316855,MATH 103A,A03,093561,Greenfeld; Be'Eri,7,0,36,29
1657983316855,MATH 103A,B01,083779,Greenfeld; Be'Eri,8,0,36,28
1657983316855,MATH 103A,B02,083780,Greenfeld; Be'Eri,4,0,36,32
1657983316855,MATH 103A,B03,093562,Greenfeld; Be'Eri,3,0,36,33
1657983322895,MATH 105,A01,085443,Carter; Anne Toulson,15,0,35,20
1657983322895,MATH 105,A02,093477,Carter; Anne Toulson,20,0,35,15
1657983328919,MATH 109,A01,083213,Ganzberger; Geoffrey Michael,3,0,34,31
1657983328919,MATH 109,A02,083214,Ganzberger; Geoffrey Michael,4,0,34,30
1657983328919,MATH 109,A03,093478,Ganzberger; Geoffrey Michael,2,0,34,32
1657983328919,MATH 109,B01,083215,Ganzberger; Geoffrey Michael,3,0,32,29
1657983328919,MATH 109,B02,083216,Ganzberger; Geoffrey Michael,3,0,32,29
1657983328919,MATH 109,B03,093479,Ganzberger; Geoffrey Michael,8,0,32,24
1657983334946,MATH 142A,A01,083219,Chow; Bennett,7,0,32,25
1657983334946,MATH 142A,A02,083220,Chow; Bennett,10,0,32,22
1657983334946,MATH 142A,A03,093480,Chow; Bennett,9,0,32,23
1657983334946,MATH 142A,B03,093481,Chow; Bennett,8,0,32,24
1657983334946,MATH 142A,B04,093558,Chow; Bennett,14,0,32,18
1657983334946,MATH 142A,B05,093559,Chow; Bennett,7,0,32,25
1657983340971,MATH 193A,A01,083224,Rotar; Vladimir,9,0,34,25
1657983340971,MATH 193A,A02,083225,Rotar; Vladimir,11,0,34,23
1657983340971,MATH 193A,A03,083781,Rotar; Vladimir,5,0,34,29
1657983340971,MATH 193A,A04,083782,Rotar; Vladimir,12,0,34,22
1657983340971,MATH 193A,A05,093482,Rotar; Vladimir,11,0,34,23
1657983347003,MATH 197,001,091859,McAuley; Julian John,9999,0,9999,0
1657983347003,MATH 197,002,095566,Kedlaya; Kiran S.,9997,0,9999,2
1657983347003,MATH 197,003,095567,Xiao; Ming,9999,0,9999,0
1657983347003,MATH 197,004,095571,Perols; Johan Lars,9998,0,9999,1
1657983354090,COGS 9,A01,083615,Shannon; Kyle Michael,11,0,75,64
1657983360115,COGS 11,A01,083617,Boyle; Mary E. T.,23,0,48,25
1657983366147,COGS 13,A01,083071,Bastos; Amalia Pinkusfeld,12,0,71,59
1657983372175,COGS 14A,A01,092681,Semenuks; Arturs,5,1,100,95
1657983378201,COGS 14B,A01,083073,Cheng; Tzu-Han,7,0,63,56
1657983384230,COGS 17,A01,092677,Semenuks; Arturs,7,0,81,74
1657983390262,COGS 100,A01,083619,Allen; Michael Gordon,17,0,70,53
1657983396287,COGS 101A,A01,083621,Davis; Joshua Daniel,9,0,68,59
1657983402313,COGS 101B,A01,091572,Allen; Michael Gordon,14,0,65,51
1657983408344,COGS 101C,A01,083625,Delgado; Tania,17,0,35,18
1657983414372,COGS 107A,A01,083627,Boyle; Mary E. T.,14,0,60,46
1657983420407,COGS 118A,A01,083075,Gupta; Anjum,21,0,76,55
1657983426437,CSE 3,A50,083646,Miranda; Gregory Joseph,24,0,50,26
1657983432462,CSE 8A,A50,083650,Miranda; Gregory Joseph,17,1,56,39
1657983438487,CSE 11,A01,083080,Cao; Yingjun,7,15,40,33
1657983444516,CSE 12,A01,083652,Krause-Levy; Sophia Louisa,30,1,120,90
1657983450539,CSE 15L,A01,083654,Morris; Justin Loren,9,0,50,41
1657983450539,CSE 15L,A02,083655,Morris; Justin Loren,11,0,50,39
1657983456565,CSE 20,A01,083657,Tran; Khoa Dang,39,0,80,41
1657983462589,CSE 21,A01,095574,Bach; Quang Tran,23,0,48,25
1657983468632,CSE 30,A01,083084,Eldon; John,8,0,80,72
1657983468632,CSE 30,B01,095061,Bhaskar; Nishant,9,0,50,41
1657983474662,CSE 100,A01,083659,Cao; Yingjun,5,4,70,65
1657983480690,CSE 134B,A01,083661,Powell; Thomas Allan,25,0,100,75
1657983486719,CSE 140,A01,083663,Gungor; Onat,17,0,85,68
1657983492745,CSE 140L,A01,083088,Eldon; John,23,0,100,77
1657983498776,CSE 175,A01,083665,Kumar; Rakesh,3,0,25,22
1657983504805,CSE 190,A00,092507,Dubnov; Shlomo,8,0,20,12
1657983510832,ECE 45,A01,083139,Congero; Spencer William,7,0,75,68
1657983516867,ECE 65,A50,083695,Saad; Andrew S,12,0,30,18
1657983516867,ECE 65,A51,095125,Saad; Andrew S,24,0,26,2
1657983522891,ECE 109,A01,091882,Touri; Behrouz,21,0,70,49
1657983528921,ECE 180,A00,083140,Abi Samra; Nicholas Camill,1,0,30,29
1657983528921,ECE 180,B00,083141,Abi Samra; Nicholas Camill,0,0,30,30
1657983534952,MATH 10A,A01,083735,Patchell; Gregory David,2,0,30,28
1657983534952,MATH 10A,A02,083736,Patchell; Gregory David,20,0,30,10
1657983534952,MATH 10A,A03,083737,Patchell; Gregory David,16,0,30,14
1657983540979,MATH 10B,A01,083207,Lim; Seonhee,9,0,34,25
1657983540979,MATH 10B,A02,083208,Lim; Seonhee,10,0,35,25
1657983540979,MATH 10B,A03,093472,Lim; Seonhee,7,0,34,27
1657983540979,MATH 10B,B01,083739,Sinha; Shubham,14,0,30,16
1657983547022,MATH 18,A01,083743,Cinel; Cameron Alexander,9,0,30,21
1657983547022,MATH 18,A02,083744,Cinel; Cameron Alexander,18,0,30,12
1657983547022,MATH 18,A03,083745,Cinel; Cameron Alexander,10,0,30,20
1657983547022,MATH 18,B01,083748,Rideout; David Porter,5,0,37,32
1657983547022,MATH 18,B02,083749,Rideout; David Porter,5,0,36,31
1657983547022,MATH 18,B03,083750,Rideout; David Porter,3,0,37,34
1657983547022,MATH 18,B04,083751,Rideout; David Porter,7,0,36,29
1657983547022,MATH 18,B05,093473,Rideout; David Porter,7,0,36,29
1657983547022,MATH 18,B06,093474,Rideout; David Porter,6,0,36,30
1657983553050,MATH 20A,A01,083754,Zheng; Zequn,14,0,40,26
1657983559083,MATH 20B,A01,083756,Briones; Jor-el Thomas Caparas,4,0,36,32
1657983559083,MATH 20B,A02,083757,Briones; Jor-el Thomas Caparas,1,0,36,35
1657983559083,MATH 20B,A03,093475,Briones; Jor-el Thomas Caparas,3,0,36,33
1657983565109,MATH 20C,A01,083760,Briones; Jor-el Thomas Caparas,1,0,35,34
1657983565109,MATH 20C,A02,083761,Briones; Jor-el Thomas Caparas,8,0,35,27
1657983565109,MATH 20C,A03,093476,Briones; Jor-el Thomas Caparas,0,1,36,36
1657983565109,MATH 20C,B01,083762,Bach; Quang Tran,1,0,30,29
1657983571135,MATH 20D,A01,083765,Tran; Brian Kha,5,0,30,25
1657983571135,MATH 20D,A02,083766,Tran; Brian Kha,5,0,30,25
1657983571135,MATH 20D,A03,083767,Tran; Brian Kha,6,0,30,24
1657983577169,MATH 20E,A01,083771,Ganguly; Soumya,12,0,32,20
1657983577169,MATH 20E,A02,083772,Ganguly; Soumya,7,0,32,25
1657983577169,MATH 20E,B01,083773,Ciotti; Benjamin,20,0,35,15
1657983577169,MATH 20E,B02,083774,Ciotti; Benjamin,18,0,35,17
1657983583195,MATH 103A,A01,083777,Greenfeld; Be'Eri,6,0,36,30
1657983583195,MATH 103A,A02,083778,Greenfeld; Be'Eri,5,0,36,31
1657983583195,MATH 103A,A03,093561,Greenfeld; Be'Eri,7,0,36,29
1657983583195,MATH 103A,B01,083779,Greenfeld; Be'Eri,8,0,36,28
1657983583195,MATH 103A,B02,083780,Greenfeld; Be'Eri,4,0,36,32
1657983583195,MATH 103A,B03,093562,Greenfeld; Be'Eri,3,0,36,33
1657983589222,MATH 105,A01,085443,Carter; Anne Toulson,15,0,35,20
1657983589222,MATH 105,A02,093477,Carter; Anne Toulson,20,0,35,15
1657983595248,MATH 109,A01,083213,Ganzberger; Geoffrey Michael,3,0,34,31
1657983595248,MATH 109,A02,083214,Ganzberger; Geoffrey Michael,4,0,34,30
1657983595248,MATH 109,A03,093478,Ganzberger; Geoffrey Michael,2,0,34,32
1657983595248,MATH 109,B01,083215,Ganzberger; Geoffrey Michael,3,0,32,29
1657983595248,MATH 109,B02,083216,Ganzberger; Geoffrey Michael,3,0,32,29
1657983595248,MATH 109,B03,093479,Ganzberger; Geoffrey Michael,8,0,32,24
1657983601285,MATH 142A,A01,083219,Chow; Bennett,7,0,32,25
1657983601285,MATH 142A,A02,083220,Chow; Bennett,10,0,32,22
1657983601285,MATH 142A,A03,093480,Chow; Bennett,9,0,32,23
1657983601285,MATH 142A,B03,093481,Chow; Bennett,8,0,32,24
1657983601285,MATH 142A,B04,093558,Chow; Bennett,14,0,32,18
1657983601285,MATH 142A,B05,093559,Chow; Bennett,7,0,32,25
1657983607310,MATH 193A,A01,083224,Rotar; Vladimir,9,0,34,25
1657983607310,MATH 193A,A02,083225,Rotar; Vladimir,11,0,34,23
1657983607310,MATH 193A,A03,083781,Rotar; Vladimir,5,0,34,29
1657983607310,MATH 193A,A04,083782,Rotar; Vladimir,12,0,34,22
1657983607310,MATH 193A,A05,093482,Rotar; Vladimir,11,0,34,23
1657983613341,MATH 197,001,091859,McAuley; Julian John,9999,0,9999,0
1657983613341,MATH 197,002,095566,Kedlaya; Kiran S.,9997,0,9999,2
1657983613341,MATH 197,003,095567,Xiao; Ming,9999,0,9999,0
1657983613341,MATH 197,004,095571,Perols; Johan Lars,9998,0,9999,1
1657983620412,COGS 9,A01,083615,Shannon; Kyle Michael,11,0,75,64
1657983626441,COGS 11,A01,083617,Boyle; Mary E. T.,23,0,48,25
1657983632466,COGS 13,A01,083071,Bastos; Amalia Pinkusfeld,12,0,71,59
1657983638495,COGS 14A,A01,092681,Semenuks; Arturs,5,1,100,95
1657983644525,COGS 14B,A01,083073,Cheng; Tzu-Han,7,0,63,56
1657983650550,COGS 17,A01,092677,Semenuks; Arturs,7,0,81,74
1657983656577,COGS 100,A01,083619,Allen; Michael Gordon,17,0,70,53
1657983662603,COGS 101A,A01,083621,Davis; Joshua Daniel,9,0,68,59
1657983668642,COGS 101B,A01,091572,Allen; Michael Gordon,14,0,65,51
1657983674666,COGS 101C,A01,083625,Delgado; Tania,17,0,35,18
1657983680690,COGS 107A,A01,083627,Boyle; Mary E. T.,14,0,60,46
1657983686722,COGS 118A,A01,083075,Gupta; Anjum,21,0,76,55
1657983692755,CSE 3,A50,083646,Miranda; Gregory Joseph,24,0,50,26
1657983698872,CSE 8A,A50,083650,Miranda; Gregory Joseph,17,1,56,39
1657983704897,CSE 11,A01,083080,Cao; Yingjun,7,15,40,33
1657983710928,CSE 12,A01,083652,Krause-Levy; Sophia Louisa,30,1,120,90
1657983716954,CSE 15L,A01,083654,Morris; Justin Loren,9,0,50,41
1657983716954,CSE 15L,A02,083655,Morris; Justin Loren,11,0,50,39
1657983722978,CSE 20,A01,083657,Tran; Khoa Dang,39,0,80,41
1657983729013,CSE 21,A01,095574,Bach; Quang Tran,23,0,48,25
1657983735044,CSE 30,A01,083084,Eldon; John,8,0,80,72
1657983735044,CSE 30,B01,095061,Bhaskar; Nishant,9,0,50,41
1657983741073,CSE 100,A01,083659,Cao; Yingjun,5,4,70,65
1657983747097,CSE 134B,A01,083661,Powell; Thomas Allan,25,0,100,75
1657983753126,CSE 140,A01,083663,Gungor; Onat,17,0,85,68
1657983759150,CSE 140L,A01,083088,Eldon; John,23,0,100,77
1657983765174,CSE 175,A01,083665,Kumar; Rakesh,3,0,25,22
1657983771209,CSE 190,A00,092507,Dubnov; Shlomo,8,0,20,12
1657983777241,ECE 45,A01,083139,Congero; Spencer William,7,0,75,68
1657983783266,ECE 65,A50,083695,Saad; Andrew S,12,0,30,18
1657983783266,ECE 65,A51,095125,Saad; Andrew S,24,0,26,2
1657983789298,ECE 109,A01,091882,Touri; Behrouz,21,0,70,49
1657983795330,ECE 180,A00,083140,Abi Samra; Nicholas Camill,1,0,30,29
1657983795330,ECE 180,B00,083141,Abi Samra; Nicholas Camill,0,0,30,30
1657983801364,MATH 10A,A01,083735,Patchell; Gregory David,2,0,30,28
1657983801364,MATH 10A,A02,083736,Patchell; Gregory David,20,0,30,10
1657983801364,MATH 10A,A03,083737,Patchell; Gregory David,16,0,30,14
1657983807393,MATH 10B,A01,083207,Lim; Seonhee,9,0,34,25
1657983807393,MATH 10B,A02,083208,Lim; Seonhee,10,0,35,25
1657983807393,MATH 10B,A03,093472,Lim; Seonhee,7,0,34,27
1657983807393,MATH 10B,B01,083739,Sinha; Shubham,14,0,30,16
1657983813432,MATH 18,A01,083743,Cinel; Cameron Alexander,9,0,30,21
1657983813432,MATH 18,A02,083744,Cinel; Cameron Alexander,18,0,30,12
1657983813432,MATH 18,A03,083745,Cinel; Cameron Alexander,10,0,30,20
1657983813432,MATH 18,B01,083748,Rideout; David Porter,5,0,37,32
1657983813432,MATH 18,B02,083749,Rideout; David Porter,5,0,36,31
1657983813432,MATH 18,B03,083750,Rideout; David Porter,3,0,37,34
1657983813432,MATH 18,B04,083751,Rideout; David Porter,7,0,36,29
1657983813432,MATH 18,B05,093473,Rideout; David Porter,7,0,36,29
1657983813432,MATH 18,B06,093474,Rideout; David Porter,6,0,36,30
1657983819456,MATH 20A,A01,083754,Zheng; Zequn,14,0,40,26
1657983825489,MATH 20B,A01,083756,Briones; Jor-el Thomas Caparas,4,0,36,32
1657983825489,MATH 20B,A02,083757,Briones; Jor-el Thomas Caparas,1,0,36,35
1657983825489,MATH 20B,A03,093475,Briones; Jor-el Thomas Caparas,3,0,36,33
1657983831515,MATH 20C,A01,083760,Briones; Jor-el Thomas Caparas,1,0,35,34
1657983831515,MATH 20C,A02,083761,Briones; Jor-el Thomas Caparas,8,0,35,27
1657983831515,MATH 20C,A03,093476,Briones; Jor-el Thomas Caparas,0,1,36,36
1657983831515,MATH 20C,B01,083762,Bach; Quang Tran,1,0,30,29
1657983837540,MATH 20D,A01,083765,Tran; Brian Kha,5,0,30,25
1657983837540,MATH 20D,A02,083766,Tran; Brian Kha,5,0,30,25
1657983837540,MATH 20D,A03,083767,Tran; Brian Kha,6,0,30,24
1657983843571,MATH 20E,A01,083771,Ganguly; Soumya,12,0,32,20
1657983843571,MATH 20E,A02,083772,Ganguly; Soumya,7,0,32,25
1657983843571,MATH 20E,B01,083773,Ciotti; Benjamin,20,0,35,15
1657983843571,MATH 20E,B02,083774,Ciotti; Benjamin,18,0,35,17
1657983849599,MATH 103A,A01,083777,Greenfeld; Be'Eri,6,0,36,30
1657983849599,MATH 103A,A02,083778,Greenfeld; Be'Eri,5,0,36,31
1657983849599,MATH 103A,A03,093561,Greenfeld; Be'Eri,7,0,36,29
1657983849599,MATH 103A,B01,083779,Greenfeld; Be'Eri,8,0,36,28
1657983849599,MATH 103A,B02,083780,Greenfeld; Be'Eri,4,0,36,32
1657983849599,MATH 103A,B03,093562,Greenfeld; Be'Eri,3,0,36,33
1657983855630,MATH 105,A01,085443,Carter; Anne Toulson,15,0,35,20
1657983855630,MATH 105,A02,093477,Carter; Anne Toulson,20,0,35,15
1657983861655,MATH 109,A01,083213,Ganzberger; Geoffrey Michael,3,0,34,31
1657983861655,MATH 109,A02,083214,Ganzberger; Geoffrey Michael,4,0,34,30
1657983861655,MATH 109,A03,093478,Ganzberger; Geoffrey Michael,2,0,34,32
1657983861655,MATH 109,B01,083215,Ganzberger; Geoffrey Michael,3,0,32,29
1657983861655,MATH 109,B02,083216,Ganzberger; Geoffrey Michael,3,0,32,29
1657983861655,MATH 109,B03,093479,Ganzberger; Geoffrey Michael,8,0,32,24
1657983867681,MATH 142A,A01,083219,Chow; Bennett,7,0,32,25
1657983867681,MATH 142A,A02,083220,Chow; Bennett,10,0,32,22
1657983867681,MATH 142A,A03,093480,Chow; Bennett,9,0,32,23
1657983867681,MATH 142A,B03,093481,Chow; Bennett,8,0,32,24
1657983867681,MATH 142A,B04,093558,Chow; Bennett,14,0,32,18
1657983867681,MATH 142A,B05,093559,Chow; Bennett,7,0,32,25
1657983873713,MATH 193A,A01,083224,Rotar; Vladimir,9,0,34,25
1657983873713,MATH 193A,A02,083225,Rotar; Vladimir,11,0,34,23
1657983873713,MATH 193A,A03,083781,Rotar; Vladimir,5,0,34,29
1657983873713,MATH 193A,A04,083782,Rotar; Vladimir,12,0,34,22
1657983873713,MATH 193A,A05,093482,Rotar; Vladimir,11,0,34,23
1657983879749,MATH 197,001,091859,McAuley; Julian John,9999,0,9999,0
1657983879749,MATH 197,002,095566,Kedlaya; Kiran S.,9997,0,9999,2
1657983879749,MATH 197,003,095567,Xiao; Ming,9999,0,9999,0
1657983879749,MATH 197,004,095571,Perols; Johan Lars,9998,0,9999,1
1657983886812,COGS 9,A01,083615,Shannon; Kyle Michael,11,0,75,64
1657983892835,COGS 11,A01,083617,Boyle; Mary E. T.,23,0,48,25
1657983898864,COGS 13,A01,083071,Bastos; Amalia Pinkusfeld,12,0,71,59
1657983904893,COGS 14A,A01,092681,Semenuks; Arturs,5,1,100,95
1657983910926,COGS 14B,A01,083073,Cheng; Tzu-Han,7,0,63,56
1657983916954,COGS 17,A01,092677,Semenuks; Arturs,7,0,81,74
1657983922983,COGS 100,A01,083619,Allen; Michael Gordon,17,0,70,53
1657983929021,COGS 101A,A01,083621,Davis; Joshua Daniel,9,0,68,59
1657983935047,COGS 101B,A01,091572,Allen; Michael Gordon,14,0,65,51
1657983941072,COGS 101C,A01,083625,Delgado; Tania,17,0,35,18
1657983947097,COGS 107A,A01,083627,Boyle; Mary E. T.,14,0,60,46
1657983953124,COGS 118A,A01,083075,Gupta; Anjum,21,0,76,55
1657983959151,CSE 3,A50,083646,Miranda; Gregory Joseph,24,0,50,26
1657983965177,CSE 8A,A50,083650,Miranda; Gregory Joseph,17,1,56,39
1657983971202,CSE 11,A01,083080,Cao; Yingjun,7,15,40,33
1657983977226,CSE 12,A01,083652,Krause-Levy; Sophia Louisa,30,1,120,90
1657983983252,CSE 15L,A01,083654,Morris; Justin Loren,9,0,50,41
1657983983252,CSE 15L,A02,083655,Morris; Justin Loren,11,0,50,39
1657983989281,CSE 20,A01,083657,Tran; Khoa Dang,39,0,80,41
1657983995319,CSE 21,A01,095574,Bach; Quang Tran,23,0,48,25
1657984001344,CSE 30,A01,083084,Eldon; John,8,0,80,72
1657984001344,CSE 30,B01,095061,Bhaskar; Nishant,9,0,50,41
1657984007373,CSE 100,A01,083659,Cao; Yingjun,5,4,70,65
1657984013398,CSE 134B,A01,083661,Powell; Thomas Allan,25,0,100,75
1657984019421,CSE 140,A01,083663,Gungor; Onat,17,0,85,68
1657984025451,CSE 140L,A01,083088,Eldon; John,23,0,100,77
1657984031475,CSE 175,A01,083665,Kumar; Rakesh,3,0,25,22
1657984037499,CSE 190,A00,092507,Dubnov; Shlomo,8,0,20,12
1657984043539,ECE 45,A01,083139,Congero; Spencer William,7,0,75,68
1657984049565,ECE 65,A50,083695,Saad; Andrew S,12,0,30,18
1657984049565,ECE 65,A51,095125,Saad; Andrew S,24,0,26,2
1657984055594,ECE 109,A01,091882,Touri; Behrouz,21,0,70,49
1657984061620,ECE 180,A00,083140,Abi Samra; Nicholas Camill,1,0,30,29
1657984061620,ECE 180,B00,083141,Abi Samra; Nicholas Camill,0,0,30,30
1657984067646,MATH 10A,A01,083735,Patchell; Gregory David,2,0,30,28
1657984067646,MATH 10A,A02,083736,Patchell; Gregory David,20,0,30,10
1657984067646,MATH 10A,A03,083737,Patchell; Gregory David,16,0,30,14
1657984073675,MATH 10B,A01,083207,Lim; Seonhee,9,0,34,25
1657984073675,MATH 10B,A02,083208,Lim; Seonhee,10,0,35,25
1657984073675,MATH 10B,A03,093472,Lim; Seonhee,7,0,34,27
1657984073675,MATH 10B,B01,083739,Sinha; Shubham,14,0,30,16
1657984079728,MATH 18,A01,083743,Cinel; Cameron Alexander,9,0,30,21
1657984079728,MATH 18,A02,083744,Cinel; Cameron Alexander,18,0,30,12
1657984079728,MATH 18,A03,083745,Cinel; Cameron Alexander,10,0,30,20
1657984079728,MATH 18,B01,083748,Rideout; David Porter,5,0,37,32
1657984079728,MATH 18,B02,083749,Rideout; David Porter,5,0,36,31
1657984079728,MATH 18,B03,083750,Rideout; David Porter,3,0,37,34
1657984079728,MATH 18,B04,083751,Rideout; David Porter,7,0,36,29
1657984079728,MATH 18,B05,093473,Rideout; David Porter,7,0,36,29
1657984079728,MATH 18,B06,093474,Rideout; David Porter,6,0,36,30
1657984085753,MATH 20A,A01,083754,Zheng; Zequn,14,0,40,26
1657984091785,MATH 20B,A01,083756,Briones; Jor-el Thomas Caparas,4,0,36,32
1657984091785,MATH 20B,A02,083757,Briones; Jor-el Thomas Caparas,1,0,36,35
1657984091785,MATH 20B,A03,093475,Briones; Jor-el Thomas Caparas,3,0,36,33
1657984097812,MATH 20C,A01,083760,Briones; Jor-el Thomas Caparas,1,0,35,34
1657984097812,MATH 20C,A02,083761,Briones; Jor-el Thomas Caparas,8,0,35,27
1657984097812,MATH 20C,A03,093476,Briones; Jor-el Thomas Caparas,0,1,36,36
1657984097812,MATH 20C,B01,083762,Bach; Quang Tran,1,0,30,29
1657984103841,MATH 20D,A01,083765,Tran; Brian Kha,5,0,30,25
1657984103841,MATH 20D,A02,083766,Tran; Brian Kha,5,0,30,25
1657984103841,MATH 20D,A03,083767,Tran; Brian Kha,6,0,30,24
1657984109866,MATH 20E,A01,083771,Ganguly; Soumya,12,0,32,20
1657984109866,MATH 20E,A02,083772,Ganguly; Soumya,7,0,32,25
1657984109866,MATH 20E,B01,083773,Ciotti; Benjamin,20,0,35,15
1657984109866,MATH 20E,B02,083774,Ciotti; Benjamin,18,0,35,17
1657984115894,MATH 103A,A01,083777,Greenfeld; Be'Eri,6,0,36,30
1657984115894,MATH 103A,A02,083778,Greenfeld; Be'Eri,5,0,36,31
1657984115894,MATH 103A,A03,093561,Greenfeld; Be'Eri,7,0,36,29
1657984115894,MATH 103A,B01,083779,Greenfeld; Be'Eri,8,0,36,28
1657984115894,MATH 103A,B02,083780,Greenfeld; Be'Eri,4,0,36,32
1657984115894,MATH 103A,B03,093562,Greenfeld; Be'Eri,3,0,36,33
1657984121919,MATH 105,A01,085443,Carter; Anne Toulson,15,0,35,20
1657984121919,MATH 105,A02,093477,Carter; Anne Toulson,20,0,35,15
1657984127945,MATH 109,A01,083213,Ganzberger; Geoffrey Michael,3,0,34,31
1657984127945,MATH 109,A02,083214,Ganzberger; Geoffrey Michael,4,0,34,30
1657984127945,MATH 109,A03,093478,Ganzberger; Geoffrey Michael,2,0,34,32
1657984127945,MATH 109,B01,083215,Ganzberger; Geoffrey Michael,3,0,32,29
1657984127945,MATH 109,B02,083216,Ganzberger; Geoffrey Michael,3,0,32,29
1657984127945,MATH 109,B03,093479,Ganzberger; Geoffrey Michael,8,0,32,24
1657984133971,MATH 142A,A01,083219,Chow; Bennett,7,0,32,25
1657984133971,MATH 142A,A02,083220,Chow; Bennett,10,0,32,22
1657984133971,MATH 142A,A03,093480,Chow; Bennett,9,0,32,23
1657984133971,MATH 142A,B03,093481,Chow; Bennett,8,0,32,24
1657984133971,MATH 142A,B04,093558,Chow; Bennett,14,0,32,18
1657984133971,MATH 142A,B05,093559,Chow; Bennett,7,0,32,25
1657984139999,MATH 193A,A01,083224,Rotar; Vladimir,9,0,34,25
1657984139999,MATH 193A,A02,083225,Rotar; Vladimir,11,0,34,23
1657984139999,MATH 193A,A03,083781,Rotar; Vladimir,5,0,34,29
1657984139999,MATH 193A,A04,083782,Rotar; Vladimir,12,0,34,22
1657984139999,MATH 193A,A05,093482,Rotar; Vladimir,11,0,34,23
1657984146030,MATH 197,001,091859,McAuley; Julian John,9999,0,9999,0
1657984146030,MATH 197,002,095566,Kedlaya; Kiran S.,9997,0,9999,2
1657984146030,MATH 197,003,095567,Xiao; Ming,9999,0,9999,0
1657984146030,MATH 197,004,095571,Perols; Johan Lars,9998,0,9999,1
1657984153095,COGS 9,A01,083615,Shannon; Kyle Michael,11,0,75,64
1657984159119,COGS 11,A01,083617,Boyle; Mary E. T.,23,0,48,25
1657984165149,COGS 13,A01,083071,Bastos; Amalia Pinkusfeld,12,0,71,59
1657984171181,COGS 14A,A01,092681,Semenuks; Arturs,5,1,100,95
1657984177214,COGS 14B,A01,083073,Cheng; Tzu-Han,7,0,63,56
1657984183238,COGS 17,A01,092677,Semenuks; Arturs,7,0,81,74
1657984189267,COGS 100,A01,083619,Allen; Michael Gordon,17,0,70,53
1657984195291,COGS 101A,A01,083621,Davis; Joshua Daniel,9,0,68,59
1657984201323,COGS 101B,A01,091572,Allen; Michael Gordon,14,0,65,51
1657984207347,COGS 101C,A01,083625,Delgado; Tania,17,0,35,18
1657984213375,COGS 107A,A01,083627,Boyle; Mary E. T.,14,0,60,46
1657984219399,COGS 118A,A01,083075,Gupta; Anjum,21,0,76,55
1657984225424,CSE 3,A50,083646,Miranda; Gregory Joseph,24,0,50,26
1657984231450,CSE 8A,A50,083650,Miranda; Gregory Joseph,17,1,56,39
1657984237479,CSE 11,A01,083080,Cao; Yingjun,7,15,40,33
1657984243504,CSE 12,A01,083652,Krause-Levy; Sophia Louisa,30,1,120,90
1657984249529,CSE 15L,A01,083654,Morris; Justin Loren,9,0,50,41
1657984249529,CSE 15L,A02,083655,Morris; Justin Loren,11,0,50,39
1657984255561,CSE 20,A01,083657,Tran; Khoa Dang,39,0,80,41
1657984261583,CSE 21,A01,095574,Bach; Quang Tran,23,0,48,25
1657984267617,CSE 30,A01,083084,Eldon; John,8,0,80,72
1657984267617,CSE 30,B01,095061,Bhaskar; Nishant,9,0,50,41
1657984273642,CSE 100,A01,083659,Cao; Yingjun,5,4,70,65
1657984279671,CSE 134B,A01,083661,Powell; Thomas Allan,25,0,100,75
1657984285699,CSE 140,A01,083663,Gungor; Onat,17,0,85,68
1657984291728,CSE 140L,A01,083088,Eldon; John,23,0,100,77
1657984297879,CSE 175,A01,083665,Kumar; Rakesh,3,0,25,22
1657984303903,CSE 190,A00,092507,Dubnov; Shlomo,8,0,20,12
1657984309929,ECE 45,A01,083139,Congero; Spencer William,7,0,75,68
1657984315959,ECE 65,A50,083695,Saad; Andrew S,12,0,30,18
1657984315959,ECE 65,A51,095125,Saad; Andrew S,24,0,26,2
1657984321989,ECE 109,A01,091882,Touri; Behrouz,21,0,70,49
1657984328012,ECE 180,A00,083140,Abi Samra; Nicholas Camill,1,0,30,29
1657984328012,ECE 180,B00,083141,Abi Samra; Nicholas Camill,0,0,30,30
1657984334040,MATH 10A,A01,083735,Patchell; Gregory David,2,0,30,28
1657984334040,MATH 10A,A02,083736,Patchell; Gregory David,20,0,30,10
1657984334040,MATH 10A,A03,083737,Patchell; Gregory David,16,0,30,14
1657984340068,MATH 10B,A01,083207,Lim; Seonhee,9,0,34,25
1657984340068,MATH 10B,A02,083208,Lim; Seonhee,10,0,35,25
1657984340068,MATH 10B,A03,093472,Lim; Seonhee,7,0,34,27
1657984340068,MATH 10B,B01,083739,Sinha; Shubham,14,0,30,16
1657984346098,MATH 18,A01,083743,Cinel; Cameron Alexander,9,0,30,21
1657984346098,MATH 18,A02,083744,Cinel; Cameron Alexander,18,0,30,12
1657984346098,MATH 18,A03,083745,Cinel; Cameron Alexander,10,0,30,20
1657984346098,MATH 18,B01,083748,Rideout; David Porter,5,0,37,32
1657984346098,MATH 18,B02,083749,Rideout; David Porter,5,0,36,31
1657984346098,MATH 18,B03,083750,Rideout; David Porter,3,0,37,34
1657984346098,MATH 18,B04,083751,Rideout; David Porter,7,0,36,29
1657984346098,MATH 18,B05,093473,Rideout; David Porter,7,0,36,29
1657984346098,MATH 18,B06,093474,Rideout; David Porter,6,0,36,30
1657984352124,MATH 20A,A01,083754,Zheng; Zequn,14,0,40,26
1657984358156,MATH 20B,A01,083756,Briones; Jor-el Thomas Caparas,4,0,36,32
1657984358156,MATH 20B,A02,083757,Briones; Jor-el Thomas Caparas,1,0,36,35
1657984358156,MATH 20B,A03,093475,Briones; Jor-el Thomas Caparas,3,0,36,33
1657984364188,MATH 20C,A01,083760,Briones; Jor-el Thomas Caparas,1,0,35,34
1657984364188,MATH 20C,A02,083761,Briones; Jor-el Thomas Caparas,8,0,35,27
1657984364188,MATH 20C,A03,093476,Briones; Jor-el Thomas Caparas,0,1,36,36
1657984364188,MATH 20C,B01,083762,Bach; Quang Tran,1,0,30,29
1657984370221,MATH 20D,A01,083765,Tran; Brian Kha,5,0,30,25
1657984370221,MATH 20D,A02,083766,Tran; Brian Kha,5,0,30,25
1657984370221,MATH 20D,A03,083767,Tran; Brian Kha,6,0,30,24
1657984376255,MATH 20E,A01,083771,Ganguly; Soumya,12,0,32,20
1657984376255,MATH 20E,A02,083772,Ganguly; Soumya,7,0,32,25
1657984376255,MATH 20E,B01,083773,Ciotti; Benjamin,20,0,35,15
1657984376255,MATH 20E,B02,083774,Ciotti; Benjamin,18,0,35,17
1657984382296,MATH 103A,A01,083777,Greenfeld; Be'Eri,6,0,36,30
1657984382296,MATH 103A,A02,083778,Greenfeld; Be'Eri,5,0,36,31
1657984382296,MATH 103A,A03,093561,Greenfeld; Be'Eri,7,0,36,29
1657984382296,MATH 103A,B01,083779,Greenfeld; Be'Eri,8,0,36,28
1657984382296,MATH 103A,B02,083780,Greenfeld; Be'Eri,4,0,36,32
1657984382296,MATH 103A,B03,093562,Greenfeld; Be'Eri,3,0,36,33
1657984388321,MATH 105,A01,085443,Carter; Anne Toulson,15,0,35,20
1657984388321,MATH 105,A02,093477,Carter; Anne Toulson,20,0,35,15
1657984394353,MATH 109,A01,083213,Ganzberger; Geoffrey Michael,3,0,34,31
1657984394353,MATH 109,A02,083214,Ganzberger; Geoffrey Michael,4,0,34,30
1657984394353,MATH 109,A03,093478,Ganzberger; Geoffrey Michael,2,0,34,32
1657984394353,MATH 109,B01,083215,Ganzberger; Geoffrey Michael,3,0,32,29
1657984394353,MATH 109,B02,083216,Ganzberger; Geoffrey Michael,3,0,32,29
1657984394353,MATH 109,B03,093479,Ganzberger; Geoffrey Michael,8,0,32,24
1657984400381,MATH 142A,A01,083219,Chow; Bennett,7,0,32,25
1657984400381,MATH 142A,A02,083220,Chow; Bennett,10,0,32,22
1657984400381,MATH 142A,A03,093480,Chow; Bennett,9,0,32,23
1657984400381,MATH 142A,B03,093481,Chow; Bennett,8,0,32,24
1657984400381,MATH 142A,B04,093558,Chow; Bennett,14,0,32,18
1657984400381,MATH 142A,B05,093559,Chow; Bennett,7,0,32,25
1657984406412,MATH 193A,A01,083224,Rotar; Vladimir,9,0,34,25
1657984406412,MATH 193A,A02,083225,Rotar; Vladimir,11,0,34,23
1657984406412,MATH 193A,A03,083781,Rotar; Vladimir,5,0,34,29
1657984406412,MATH 193A,A04,083782,Rotar; Vladimir,12,0,34,22
1657984406412,MATH 193A,A05,093482,Rotar; Vladimir,11,0,34,23
1657984412439,MATH 197,001,091859,McAuley; Julian John,9999,0,9999,0
1657984412439,MATH 197,002,095566,Kedlaya; Kiran S.,9997,0,9999,2
1657984412439,MATH 197,003,095567,Xiao; Ming,9999,0,9999,0
1657984412439,MATH 197,004,095571,Perols; Johan Lars,9998,0,9999,1
1657984419536,COGS 9,A01,083615,Shannon; Kyle Michael,11,0,75,64
1657984425559,COGS 11,A01,083617,Boyle; Mary E. T.,23,0,48,25
1657984431586,COGS 13,A01,083071,Bastos; Amalia Pinkusfeld,12,0,71,59
1657984437611,COGS 14A,A01,092681,Semenuks; Arturs,5,1,100,95
1657984443644,COGS 14B,A01,083073,Cheng; Tzu-Han,7,0,63,56
1657984449669,COGS 17,A01,092677,Semenuks; Arturs,7,0,81,74
1657984455696,COGS 100,A01,083619,Allen; Michael Gordon,17,0,70,53
1657984461725,COGS 101A,A01,083621,Davis; Joshua Daniel,9,0,68,59
1657984467753,COGS 101B,A01,091572,Allen; Michael Gordon,14,0,65,51
1657984473782,COGS 101C,A01,083625,Delgado; Tania,17,0,35,18
1657984479809,COGS 107A,A01,083627,Boyle; Mary E. T.,14,0,60,46
1657984485835,COGS 118A,A01,083075,Gupta; Anjum,21,0,76,55
1657984491862,CSE 3,A50,083646,Miranda; Gregory Joseph,24,0,50,26
1657984497887,CSE 8A,A50,083650,Miranda; Gregory Joseph,17,1,56,39
1657984503911,CSE 11,A01,083080,Cao; Yingjun,7,15,40,33
1657984509935,CSE 12,A01,083652,Krause-Levy; Sophia Louisa,30,1,120,90
1657984515965,CSE 15L,A01,083654,Morris; Justin Loren,9,0,50,41
1657984515965,CSE 15L,A02,083655,Morris; Justin Loren,11,0,50,39
1657984521989,CSE 20,A01,083657,Tran; Khoa Dang,39,0,80,41
1657984528017,CSE 21,A01,095574,Bach; Quang Tran,23,0,48,25
1657984534045,CSE 30,A01,083084,Eldon; John,8,0,80,72
1657984534045,CSE 30,B01,095061,Bhaskar; Nishant,9,0,50,41
1657984540070,CSE 100,A01,083659,Cao; Yingjun,5,4,70,65
1657984546111,CSE 134B,A01,083661,Powell; Thomas Allan,25,0,100,75
1657984552136,CSE 140,A01,083663,Gungor; Onat,17,0,85,68
1657984558161,CSE 140L,A01,083088,Eldon; John,23,0,100,77
1657984564190,CSE 175,A01,083665,Kumar; Rakesh,3,0,25,22
1657984570218,CSE 190,A00,092507,Dubnov; Shlomo,8,0,20,12
1657984576244,ECE 45,A01,083139,Congero; Spencer William,7,0,75,68
1657984582270,ECE 65,A50,083695,Saad; Andrew S,12,0,30,18
1657984582270,ECE 65,A51,095125,Saad; Andrew S,24,0,26,2
1657984588296,ECE 109,A01,091882,Touri; Behrouz,21,0,70,49
1657984594328,ECE 180,A00,083140,Abi Samra; Nicholas Camill,1,0,30,29
1657984594328,ECE 180,B00,083141,Abi Samra; Nicholas Camill,0,0,30,30
1657984600362,MATH 10A,A01,083735,Patchell; Gregory David,2,0,30,28
1657984600362,MATH 10A,A02,083736,Patchell; Gregory David,20,0,30,10
1657984600362,MATH 10A,A03,083737,Patchell; Gregory David,16,0,30,14
1657984606391,MATH 10B,A01,083207,Lim; Seonhee,9,0,34,25
1657984606391,MATH 10B,A02,083208,Lim; Seonhee,10,0,35,25
1657984606391,MATH 10B,A03,093472,Lim; Seonhee,7,0,34,27
1657984606391,MATH 10B,B01,083739,Sinha; Shubham,14,0,30,16
1657984612423,MATH 18,A01,083743,Cinel; Cameron Alexander,9,0,30,21
1657984612423,MATH 18,A02,083744,Cinel; Cameron Alexander,18,0,30,12
1657984612423,MATH 18,A03,083745,Cinel; Cameron Alexander,10,0,30,20
1657984612423,MATH 18,B01,083748,Rideout; David Porter,5,0,37,32
1657984612423,MATH 18,B02,083749,Rideout; David Porter,5,0,36,31
1657984612423,MATH 18,B03,083750,Rideout; David Porter,3,0,37,34
1657984612423,MATH 18,B04,083751,Rideout; David Porter,7,0,36,29
1657984612423,MATH 18,B05,093473,Rideout; David Porter,7,0,36,29
1657984612423,MATH 18,B06,093474,Rideout; David Porter,6,0,36,30
1657984618448,MATH 20A,A01,083754,Zheng; Zequn,14,0,40,26
1657984624480,MATH 20B,A01,083756,Briones; Jor-el Thomas Caparas,4,0,36,32
1657984624480,MATH 20B,A02,083757,Briones; Jor-el Thomas Caparas,1,0,36,35
1657984624480,MATH 20B,A03,093475,Briones; Jor-el Thomas Caparas,3,0,36,33
1657984630505,MATH 20C,A01,083760,Briones; Jor-el Thomas Caparas,1,0,35,34
1657984630505,MATH 20C,A02,083761,Briones; Jor-el Thomas Caparas,8,0,35,27
1657984630505,MATH 20C,A03,093476,Briones; Jor-el Thomas Caparas,0,1,36,36
1657984630505,MATH 20C,B01,083762,Bach; Quang Tran,1,0,30,29
1657984636531,MATH 20D,A01,083765,Tran; Brian Kha,5,0,30,25
1657984636531,MATH 20D,A02,083766,Tran; Brian Kha,5,0,30,25
1657984636531,MATH 20D,A03,083767,Tran; Brian Kha,6,0,30,24
1657984642565,MATH 20E,A01,083771,Ganguly; Soumya,12,0,32,20
1657984642565,MATH 20E,A02,083772,Ganguly; Soumya,7,0,32,25
1657984642565,MATH 20E,B01,083773,Ciotti; Benjamin,20,0,35,15
1657984642565,MATH 20E,B02,083774,Ciotti; Benjamin,18,0,35,17
1657984648602,MATH 103A,A01,083777,Greenfeld; Be'Eri,6,0,36,30
1657984648602,MATH 103A,A02,083778,Greenfeld; Be'Eri,5,0,36,31
1657984648602,MATH 103A,A03,093561,Greenfeld; Be'Eri,7,0,36,29
1657984648602,MATH 103A,B01,083779,Greenfeld; Be'Eri,8,0,36,28
1657984648602,MATH 103A,B02,083780,Greenfeld; Be'Eri,4,0,36,32
1657984648602,MATH 103A,B03,093562,Greenfeld; Be'Eri,3,0,36,33
1657984654627,MATH 105,A01,085443,Carter; Anne Toulson,15,0,35,20
1657984654627,MATH 105,A02,093477,Carter; Anne Toulson,20,0,35,15
1657984660652,MATH 109,A01,083213,Ganzberger; Geoffrey Michael,3,0,34,31
1657984660652,MATH 109,A02,083214,Ganzberger; Geoffrey Michael,4,0,34,30
1657984660652,MATH 109,A03,093478,Ganzberger; Geoffrey Michael,2,0,34,32
1657984660652,MATH 109,B01,083215,Ganzberger; Geoffrey Michael,3,0,32,29
1657984660652,MATH 109,B02,083216,Ganzberger; Geoffrey Michael,3,0,32,29
1657984660652,MATH 109,B03,093479,Ganzberger; Geoffrey Michael,8,0,32,24
1657984666687,MATH 142A,A01,083219,Chow; Bennett,7,0,32,25
1657984666687,MATH 142A,A02,083220,Chow; Bennett,10,0,32,22
1657984666687,MATH 142A,A03,093480,Chow; Bennett,9,0,32,23
1657984666687,MATH 142A,B03,093481,Chow; Bennett,8,0,32,24
1657984666687,MATH 142A,B04,093558,Chow; Bennett,14,0,32,18
1657984666687,MATH 142A,B05,093559,Chow; Bennett,7,0,32,25
1657984672711,MATH 193A,A01,083224,Rotar; Vladimir,9,0,34,25
1657984672711,MATH 193A,A02,083225,Rotar; Vladimir,11,0,34,23
1657984672711,MATH 193A,A03,083781,Rotar; Vladimir,5,0,34,29
1657984672711,MATH 193A,A04,083782,Rotar; Vladimir,12,0,34,22
1657984672711,MATH 193A,A05,093482,Rotar; Vladimir,11,0,34,23
1657984678736,MATH 197,001,091859,McAuley; Julian John,9999,0,9999,0
1657984678736,MATH 197,002,095566,Kedlaya; Kiran S.,9997,0,9999,2
1657984678736,MATH 197,003,095567,Xiao; Ming,9999,0,9999,0
1657984678736,MATH 197,004,095571,Perols; Johan Lars,9998,0,9999,1
1657984685801,COGS 9,A01,083615,Shannon; Kyle Michael,11,0,75,64
1657984691827,COGS 11,A01,083617,Boyle; Mary E. T.,23,0,48,25
1657984697854,COGS 13,A01,083071,Bastos; Amalia Pinkusfeld,12,0,71,59
1657984703880,COGS 14A,A01,092681,Semenuks; Arturs,5,1,100,95
1657984709906,COGS 14B,A01,083073,Cheng; Tzu-Han,7,0,63,56
1657984715936,COGS 17,A01,092677,Semenuks; Arturs,7,0,81,74
1657984721961,COGS 100,A01,083619,Allen; Michael Gordon,17,0,70,53
1657984727992,COGS 101A,A01,083621,Davis; Joshua Daniel,9,0,68,59
1657984734016,COGS 101B,A01,091572,Allen; Michael Gordon,14,0,65,51
1657984740041,COGS 101C,A01,083625,Delgado; Tania,17,0,35,18
1657984746065,COGS 107A,A01,083627,Boyle; Mary E. T.,14,0,60,46
1657984752094,COGS 118A,A01,083075,Gupta; Anjum,21,0,76,55
1657984758121,CSE 3,A50,083646,Miranda; Gregory Joseph,24,0,50,26
1657984764146,CSE 8A,A50,083650,Miranda; Gregory Joseph,17,1,56,39
1657984775992,CSE 11,A01,083080,Cao; Yingjun,7,15,40,33
1657984782025,CSE 12,A01,083652,Krause-Levy; Sophia Louisa,30,1,120,90
1657984788048,CSE 15L,A01,083654,Morris; Justin Loren,9,0,50,41
1657984788048,CSE 15L,A02,083655,Morris; Justin Loren,11,0,50,39
1657984794075,CSE 20,A01,083657,Tran; Khoa Dang,39,0,80,41
1657984800100,CSE 21,A01,095574,Bach; Quang Tran,23,0,48,25
1657984806136,CSE 30,A01,083084,Eldon; John,8,0,80,72
1657984806136,CSE 30,B01,095061,Bhaskar; Nishant,9,0,50,41
1657984812166,CSE 100,A01,083659,Cao; Yingjun,5,4,70,65
1657984818193,CSE 134B,A01,083661,Powell; Thomas Allan,25,0,100,75
1657984824223,CSE 140,A01,083663,Gungor; Onat,17,0,85,68
1657984830253,CSE 140L,A01,083088,Eldon; John,23,0,100,77
1657984836288,CSE 175,A01,083665,Kumar; Rakesh,3,0,25,22
1657984842313,CSE 190,A00,092507,Dubnov; Shlomo,8,0,20,12
1657984848341,ECE 45,A01,083139,Congero; Spencer William,7,0,75,68
1657984854368,ECE 65,A50,083695,Saad; Andrew S,12,0,30,18
1657984854368,ECE 65,A51,095125,Saad; Andrew S,24,0,26,2
1657984860394,ECE 109,A01,091882,Touri; Behrouz,21,0,70,49
1657984866419,ECE 180,A00,083140,Abi Samra; Nicholas Camill,1,0,30,29
1657984866419,ECE 180,B00,083141,Abi Samra; Nicholas Camill,0,0,30,30
1657984872449,MATH 10A,A01,083735,Patchell; Gregory David,2,0,30,28
1657984872449,MATH 10A,A02,083736,Patchell; Gregory David,20,0,30,10
1657984872449,MATH 10A,A03,083737,Patchell; Gregory David,16,0,30,14
1657984878485,MATH 10B,A01,083207,Lim; Seonhee,9,0,34,25
1657984878485,MATH 10B,A02,083208,Lim; Seonhee,10,0,35,25
1657984878485,MATH 10B,A03,093472,Lim; Seonhee,7,0,34,27
1657984878485,MATH 10B,B01,083739,Sinha; Shubham,14,0,30,16
1657984884526,MATH 18,A01,083743,Cinel; Cameron Alexander,9,0,30,21
1657984884526,MATH 18,A02,083744,Cinel; Cameron Alexander,18,0,30,12
1657984884526,MATH 18,A03,083745,Cinel; Cameron Alexander,10,0,30,20
1657984884526,MATH 18,B01,083748,Rideout; David Porter,5,0,37,32
1657984884526,MATH 18,B02,083749,Rideout; David Porter,5,0,36,31
1657984884526,MATH 18,B03,083750,Rideout; David Porter,3,0,37,34
1657984884526,MATH 18,B04,083751,Rideout; David Porter,7,0,36,29
1657984884526,MATH 18,B05,093473,Rideout; David Porter,7,0,36,29
1657984884526,MATH 18,B06,093474,Rideout; David Porter,6,0,36,30
1657984890557,MATH 20A,A01,083754,Zheng; Zequn,14,0,40,26
1657984896591,MATH 20B,A01,083756,Briones; Jor-el Thomas Caparas,4,0,36,32
1657984896591,MATH 20B,A02,083757,Briones; Jor-el Thomas Caparas,1,0,36,35
1657984896591,MATH 20B,A03,093475,Briones; Jor-el Thomas Caparas,3,0,36,33
1657984902696,MATH 20C,A01,083760,Briones; Jor-el Thomas Caparas,1,0,35,34
1657984902696,MATH 20C,A02,083761,Briones; Jor-el Thomas Caparas,8,0,35,27
1657984902696,MATH 20C,A03,093476,Briones; Jor-el Thomas Caparas,0,1,36,36
1657984902696,MATH 20C,B01,083762,Bach; Quang Tran,1,0,30,29
1657984908729,MATH 20D,A01,083765,Tran; Brian Kha,5,0,30,25
1657984908729,MATH 20D,A02,083766,Tran; Brian Kha,5,0,30,25
1657984908729,MATH 20D,A03,083767,Tran; Brian Kha,6,0,30,24
1657984914762,MATH 20E,A01,083771,Ganguly; Soumya,12,0,32,20
1657984914762,MATH 20E,A02,083772,Ganguly; Soumya,7,0,32,25
1657984914762,MATH 20E,B01,083773,Ciotti; Benjamin,20,0,35,15
1657984914762,MATH 20E,B02,083774,Ciotti; Benjamin,18,0,35,17
1657984920788,MATH 103A,A01,083777,Greenfeld; Be'Eri,6,0,36,30
1657984920788,MATH 103A,A02,083778,Greenfeld; Be'Eri,5,0,36,31
1657984920788,MATH 103A,A03,093561,Greenfeld; Be'Eri,7,0,36,29
1657984920788,MATH 103A,B01,083779,Greenfeld; Be'Eri,8,0,36,28
1657984920788,MATH 103A,B02,083780,Greenfeld; Be'Eri,4,0,36,32
1657984920788,MATH 103A,B03,093562,Greenfeld; Be'Eri,3,0,36,33
1657984926828,MATH 105,A01,085443,Carter; Anne Toulson,15,0,35,20
1657984926828,MATH 105,A02,093477,Carter; Anne Toulson,20,0,35,15
1657984932852,MATH 109,A01,083213,Ganzberger; Geoffrey Michael,3,0,34,31
1657984932852,MATH 109,A02,083214,Ganzberger; Geoffrey Michael,4,0,34,30
1657984932852,MATH 109,A03,093478,Ganzberger; Geoffrey Michael,2,0,34,32
1657984932852,MATH 109,B01,083215,Ganzberger; Geoffrey Michael,3,0,32,29
1657984932852,MATH 109,B02,083216,Ganzberger; Geoffrey Michael,3,0,32,29
1657984932852,MATH 109,B03,093479,Ganzberger; Geoffrey Michael,8,0,32,24
1657984938879,MATH 142A,A01,083219,Chow; Bennett,7,0,32,25
1657984938879,MATH 142A,A02,083220,Chow; Bennett,10,0,32,22
1657984938879,MATH 142A,A03,093480,Chow; Bennett,9,0,32,23
1657984938879,MATH 142A,B03,093481,Chow; Bennett,8,0,32,24
1657984938879,MATH 142A,B04,093558,Chow; Bennett,14,0,32,18
1657984938879,MATH 142A,B05,093559,Chow; Bennett,7,0,32,25
1657984944912,MATH 193A,A01,083224,Rotar; Vladimir,9,0,34,25
1657984944912,MATH 193A,A02,083225,Rotar; Vladimir,11,0,34,23
1657984944912,MATH 193A,A03,083781,Rotar; Vladimir,5,0,34,29
1657984944912,MATH 193A,A04,083782,Rotar; Vladimir,12,0,34,22
1657984944912,MATH 193A,A05,093482,Rotar; Vladimir,11,0,34,23
1657984950951,MATH 197,001,091859,McAuley; Julian John,9999,0,9999,0
1657984950951,MATH 197,002,095566,Kedlaya; Kiran S.,9997,0,9999,2
1657984950951,MATH 197,003,095567,Xiao; Ming,9999,0,9999,0
1657984950951,MATH 197,004,095571,Perols; Johan Lars,9998,0,9999,1
1657984958030,COGS 9,A01,083615,Shannon; Kyle Michael,11,0,75,64
1657984964060,COGS 11,A01,083617,Boyle; Mary E. T.,23,0,48,25
1657984970092,COGS 13,A01,083071,Bastos; Amalia Pinkusfeld,12,0,71,59
1657984976118,COGS 14A,A01,092681,Semenuks; Arturs,5,1,100,95
1657984982144,COGS 14B,A01,083073,Cheng; Tzu-Han,7,0,63,56
1657984988169,COGS 17,A01,092677,Semenuks; Arturs,7,0,81,74
1657984994203,COGS 100,A01,083619,Allen; Michael Gordon,17,0,70,53
1657985000227,COGS 101A,A01,083621,Davis; Joshua Daniel,9,0,68,59
1657985006262,COGS 101B,A01,091572,Allen; Michael Gordon,14,0,65,51
1657985012292,COGS 101C,A01,083625,Delgado; Tania,17,0,35,18
1657985018314,COGS 107A,A01,083627,Boyle; Mary E. T.,14,0,60,46
1657985024339,COGS 118A,A01,083075,Gupta; Anjum,21,0,76,55
1657985030373,CSE 3,A50,083646,Miranda; Gregory Joseph,24,0,50,26
1657985036400,CSE 8A,A50,083650,Miranda; Gregory Joseph,17,1,56,39
1657985042425,CSE 11,A01,083080,Cao; Yingjun,7,15,40,33
1657985048461,CSE 12,A01,083652,Krause-Levy; Sophia Louisa,30,1,120,90
1657985054485,CSE 15L,A01,083654,Morris; Justin Loren,9,0,50,41
1657985054485,CSE 15L,A02,083655,Morris; Justin Loren,11,0,50,39
1657985060515,CSE 20,A01,083657,Tran; Khoa Dang,39,0,80,41
1657985066550,CSE 21,A01,095574,Bach; Quang Tran,23,0,48,25
1657985072590,CSE 30,A01,083084,Eldon; John,8,0,80,72
1657985072590,CSE 30,B01,095061,Bhaskar; Nishant,9,0,50,41
1657985078616,CSE 100,A01,083659,Cao; Yingjun,5,4,70,65
1657985084646,CSE 134B,A01,083661,Powell; Thomas Allan,25,0,100,75
1657985090670,CSE 140,A01,083663,Gungor; Onat,17,0,85,68
1657985096704,CSE 140L,A01,083088,Eldon; John,23,0,100,77
1657985102735,CSE 175,A01,083665,Kumar; Rakesh,3,0,25,22
1657985108760,CSE 190,A00,092507,Dubnov; Shlomo,8,0,20,12
1657985114790,ECE 45,A01,083139,Congero; Spencer William,7,0,75,68
1657985120823,ECE 65,A50,083695,Saad; Andrew S,12,0,30,18
1657985120823,ECE 65,A51,095125,Saad; Andrew S,24,0,26,2
1657985126848,ECE 109,A01,091882,Touri; Behrouz,21,0,70,49
1657985132873,ECE 180,A00,083140,Abi Samra; Nicholas Camill,1,0,30,29
1657985132873,ECE 180,B00,083141,Abi Samra; Nicholas Camill,0,0,30,30
1657985138900,MATH 10A,A01,083735,Patchell; Gregory David,2,0,30,28
1657985138900,MATH 10A,A02,083736,Patchell; Gregory David,20,0,30,10
1657985138900,MATH 10A,A03,083737,Patchell; Gregory David,16,0,30,14
1657985144926,MATH 10B,A01,083207,Lim; Seonhee,9,0,34,25
1657985144926,MATH 10B,A02,083208,Lim; Seonhee,10,0,35,25
1657985144926,MATH 10B,A03,093472,Lim; Seonhee,7,0,34,27
1657985144926,MATH 10B,B01,083739,Sinha; Shubham,14,0,30,16
1657985150955,MATH 18,A01,083743,Cinel; Cameron Alexander,9,0,30,21
1657985150955,MATH 18,A02,083744,Cinel; Cameron Alexander,18,0,30,12
1657985150955,MATH 18,A03,083745,Cinel; Cameron Alexander,10,0,30,20
1657985150955,MATH 18,B01,083748,Rideout; David Porter,5,0,37,32
1657985150955,MATH 18,B02,083749,Rideout; David Porter,5,0,36,31
1657985150955,MATH 18,B03,083750,Rideout; David Porter,3,0,37,34
1657985150955,MATH 18,B04,083751,Rideout; David Porter,7,0,36,29
1657985150955,MATH 18,B05,093473,Rideout; David Porter,7,0,36,29
1657985150955,MATH 18,B06,093474,Rideout; David Porter,6,0,36,30
1657985156988,MATH 20A,A01,083754,Zheng; Zequn,14,0,40,26
1657985163020,MATH 20B,A01,083756,Briones; Jor-el Thomas Caparas,4,0,36,32
1657985163020,MATH 20B,A02,083757,Briones; Jor-el Thomas Caparas,1,0,36,35
1657985163020,MATH 20B,A03,093475,Briones; Jor-el Thomas Caparas,3,0,36,33
1657985169045,MATH 20C,A01,083760,Briones; Jor-el Thomas Caparas,1,0,35,34
1657985169045,MATH 20C,A02,083761,Briones; Jor-el Thomas Caparas,8,0,35,27
1657985169045,MATH 20C,A03,093476,Briones; Jor-el Thomas Caparas,0,1,36,36
1657985169045,MATH 20C,B01,083762,Bach; Quang Tran,1,0,30,29
1657985175071,MATH 20D,A01,083765,Tran; Brian Kha,5,0,30,25
1657985175071,MATH 20D,A02,083766,Tran; Brian Kha,5,0,30,25
1657985175071,MATH 20D,A03,083767,Tran; Brian Kha,6,0,30,24
1657985181098,MATH 20E,A01,083771,Ganguly; Soumya,12,0,32,20
1657985181098,MATH 20E,A02,083772,Ganguly; Soumya,7,0,32,25
1657985181098,MATH 20E,B01,083773,Ciotti; Benjamin,20,0,35,15
1657985181098,MATH 20E,B02,083774,Ciotti; Benjamin,18,0,35,17
1657985187127,MATH 103A,A01,083777,Greenfeld; Be'Eri,6,0,36,30
1657985187127,MATH 103A,A02,083778,Greenfeld; Be'Eri,5,0,36,31
1657985187127,MATH 103A,A03,093561,Greenfeld; Be'Eri,7,0,36,29
1657985187127,MATH 103A,B01,083779,Greenfeld; Be'Eri,8,0,36,28
1657985187127,MATH 103A,B02,083780,Greenfeld; Be'Eri,4,0,36,32
1657985187127,MATH 103A,B03,093562,Greenfeld; Be'Eri,3,0,36,33
1657985193154,MATH 105,A01,085443,Carter; Anne Toulson,15,0,35,20
1657985193154,MATH 105,A02,093477,Carter; Anne Toulson,20,0,35,15
1657985199180,MATH 109,A01,083213,Ganzberger; Geoffrey Michael,3,0,34,31
1657985199180,MATH 109,A02,083214,Ganzberger; Geoffrey Michael,4,0,34,30
1657985199180,MATH 109,A03,093478,Ganzberger; Geoffrey Michael,2,0,34,32
1657985199180,MATH 109,B01,083215,Ganzberger; Geoffrey Michael,3,0,32,29
1657985199180,MATH 109,B02,083216,Ganzberger; Geoffrey Michael,3,0,32,29
1657985199180,MATH 109,B03,093479,Ganzberger; Geoffrey Michael,8,0,32,24
1657985205220,MATH 142A,A01,083219,Chow; Bennett,7,0,32,25
1657985205220,MATH 142A,A02,083220,Chow; Bennett,10,0,32,22
1657985205220,MATH 142A,A03,093480,Chow; Bennett,9,0,32,23
1657985205220,MATH 142A,B03,093481,Chow; Bennett,8,0,32,24
1657985205220,MATH 142A,B04,093558,Chow; Bennett,14,0,32,18
1657985205220,MATH 142A,B05,093559,Chow; Bennett,7,0,32,25
1657985211247,MATH 193A,A01,083224,Rotar; Vladimir,9,0,34,25
1657985211247,MATH 193A,A02,083225,Rotar; Vladimir,11,0,34,23
1657985211247,MATH 193A,A03,083781,Rotar; Vladimir,5,0,34,29
1657985211247,MATH 193A,A04,083782,Rotar; Vladimir,12,0,34,22
1657985211247,MATH 193A,A05,093482,Rotar; Vladimir,11,0,34,23
1657985217277,MATH 197,001,091859,McAuley; Julian John,9999,0,9999,0
1657985217277,MATH 197,002,095566,Kedlaya; Kiran S.,9997,0,9999,2
1657985217277,MATH 197,003,095567,Xiao; Ming,9999,0,9999,0
1657985217277,MATH 197,004,095571,Perols; Johan Lars,9998,0,9999,1
1657985224375,COGS 9,A01,083615,Shannon; Kyle Michael,11,0,75,64
1657985230408,COGS 11,A01,083617,Boyle; Mary E. T.,23,0,48,25
1657985236456,COGS 13,A01,083071,Bastos; Amalia Pinkusfeld,12,0,71,59
1657985242487,COGS 14A,A01,092681,Semenuks; Arturs,5,1,100,95
1657985248524,COGS 14B,A01,083073,Cheng; Tzu-Han,7,0,63,56
1657985254549,COGS 17,A01,092677,Semenuks; Arturs,7,0,81,74
1657985260584,COGS 100,A01,083619,Allen; Michael Gordon,17,0,70,53
1657985266615,COGS 101A,A01,083621,Davis; Joshua Daniel,9,0,68,59
1657985272647,COGS 101B,A01,091572,Allen; Michael Gordon,14,0,65,51
1657985278679,COGS 101C,A01,083625,Delgado; Tania,17,0,35,18
1657985284708,COGS 107A,A01,083627,Boyle; Mary E. T.,14,0,60,46
1657985290735,COGS 118A,A01,083075,Gupta; Anjum,21,0,76,55
1657985296768,CSE 3,A50,083646,Miranda; Gregory Joseph,24,0,50,26
1657985302791,CSE 8A,A50,083650,Miranda; Gregory Joseph,17,1,56,39
1657985308820,CSE 11,A01,083080,Cao; Yingjun,7,15,40,33
1657985314846,CSE 12,A01,083652,Krause-Levy; Sophia Louisa,30,1,120,90
1657985320870,CSE 15L,A01,083654,Morris; Justin Loren,9,0,50,41
1657985320870,CSE 15L,A02,083655,Morris; Justin Loren,11,0,50,39
1657985326892,CSE 20,A01,083657,Tran; Khoa Dang,39,0,80,41
1657985332920,CSE 21,A01,095574,Bach; Quang Tran,23,0,48,25
1657985338949,CSE 30,A01,083084,Eldon; John,8,0,80,72
1657985338949,CSE 30,B01,095061,Bhaskar; Nishant,9,0,50,41
1657985344974,CSE 100,A01,083659,Cao; Yingjun,5,4,70,65
1657985351005,CSE 134B,A01,083661,Powell; Thomas Allan,25,0,100,75
1657985357038,CSE 140,A01,083663,Gungor; Onat,17,0,85,68
1657985363069,CSE 140L,A01,083088,Eldon; John,23,0,100,77
1657985369096,CSE 175,A01,083665,Kumar; Rakesh,3,0,25,22
1657985375128,CSE 190,A00,092507,Dubnov; Shlomo,8,0,20,12
1657985381157,ECE 45,A01,083139,Congero; Spencer William,7,0,75,68
1657985387185,ECE 65,A50,083695,Saad; Andrew S,12,0,30,18
1657985387185,ECE 65,A51,095125,Saad; Andrew S,24,0,26,2
1657985393216,ECE 109,A01,091882,Touri; Behrouz,21,0,70,49
1657985399242,ECE 180,A00,083140,Abi Samra; Nicholas Camill,1,0,30,29
1657985399242,ECE 180,B00,083141,Abi Samra; Nicholas Camill,0,0,30,30
1657985405273,MATH 10A,A01,083735,Patchell; Gregory David,2,0,30,28
1657985405273,MATH 10A,A02,083736,Patchell; Gregory David,20,0,30,10
1657985405273,MATH 10A,A03,083737,Patchell; Gregory David,16,0,30,14
1657985411304,MATH 10B,A01,083207,Lim; Seonhee,9,0,34,25
1657985411304,MATH 10B,A02,083208,Lim; Seonhee,10,0,35,25
1657985411304,MATH 10B,A03,093472,Lim; Seonhee,7,0,34,27
1657985411304,MATH 10B,B01,083739,Sinha; Shubham,14,0,30,16
1657985417348,MATH 18,A01,083743,Cinel; Cameron Alexander,9,0,30,21
1657985417348,MATH 18,A02,083744,Cinel; Cameron Alexander,18,0,30,12
1657985417348,MATH 18,A03,083745,Cinel; Cameron Alexander,10,0,30,20
1657985417348,MATH 18,B01,083748,Rideout; David Porter,5,0,37,32
1657985417348,MATH 18,B02,083749,Rideout; David Porter,5,0,36,31
1657985417348,MATH 18,B03,083750,Rideout; David Porter,3,0,37,34
1657985417348,MATH 18,B04,083751,Rideout; David Porter,7,0,36,29
1657985417348,MATH 18,B05,093473,Rideout; David Porter,7,0,36,29
1657985417348,MATH 18,B06,093474,Rideout; David Porter,6,0,36,30
1657985423371,MATH 20A,A01,083754,Zheng; Zequn,14,0,40,26
1657985429399,MATH 20B,A01,083756,Briones; Jor-el Thomas Caparas,4,0,36,32
1657985429399,MATH 20B,A02,083757,Briones; Jor-el Thomas Caparas,1,0,36,35
1657985429399,MATH 20B,A03,093475,Briones; Jor-el Thomas Caparas,3,0,36,33
1657985435437,MATH 20C,A01,083760,Briones; Jor-el Thomas Caparas,1,0,35,34
1657985435437,MATH 20C,A02,083761,Briones; Jor-el Thomas Caparas,8,0,35,27
1657985435437,MATH 20C,A03,093476,Briones; Jor-el Thomas Caparas,0,1,36,36
1657985435437,MATH 20C,B01,083762,Bach; Quang Tran,1,0,30,29
1657985441469,MATH 20D,A01,083765,Tran; Brian Kha,5,0,30,25
1657985441469,MATH 20D,A02,083766,Tran; Brian Kha,5,0,30,25
1657985441469,MATH 20D,A03,083767,Tran; Brian Kha,6,0,30,24
1657985447497,MATH 20E,A01,083771,Ganguly; Soumya,12,0,32,20
1657985447497,MATH 20E,A02,083772,Ganguly; Soumya,7,0,32,25
1657985447497,MATH 20E,B01,083773,Ciotti; Benjamin,20,0,35,15
1657985447497,MATH 20E,B02,083774,Ciotti; Benjamin,18,0,35,17
1657985453524,MATH 103A,A01,083777,Greenfeld; Be'Eri,6,0,36,30
1657985453524,MATH 103A,A02,083778,Greenfeld; Be'Eri,5,0,36,31
1657985453524,MATH 103A,A03,093561,Greenfeld; Be'Eri,7,0,36,29
1657985453524,MATH 103A,B01,083779,Greenfeld; Be'Eri,8,0,36,28
1657985453524,MATH 103A,B02,083780,Greenfeld; Be'Eri,4,0,36,32
1657985453524,MATH 103A,B03,093562,Greenfeld; Be'Eri,3,0,36,33
1657985459556,MATH 105,A01,085443,Carter; Anne Toulson,15,0,35,20
1657985459556,MATH 105,A02,093477,Carter; Anne Toulson,20,0,35,15
1657985465588,MATH 109,A01,083213,Ganzberger; Geoffrey Michael,3,0,34,31
1657985465588,MATH 109,A02,083214,Ganzberger; Geoffrey Michael,4,0,34,30
1657985465588,MATH 109,A03,093478,Ganzberger; Geoffrey Michael,2,0,34,32
1657985465588,MATH 109,B01,083215,Ganzberger; Geoffrey Michael,3,0,32,29
1657985465588,MATH 109,B02,083216,Ganzberger; Geoffrey Michael,3,0,32,29
1657985465588,MATH 109,B03,093479,Ganzberger; Geoffrey Michael,8,0,32,24
1657985471614,MATH 142A,A01,083219,Chow; Bennett,7,0,32,25
1657985471614,MATH 142A,A02,083220,Chow; Bennett,10,0,32,22
1657985471614,MATH 142A,A03,093480,Chow; Bennett,9,0,32,23
1657985471614,MATH 142A,B03,093481,Chow; Bennett,8,0,32,24
1657985471614,MATH 142A,B04,093558,Chow; Bennett,14,0,32,18
1657985471614,MATH 142A,B05,093559,Chow; Bennett,7,0,32,25
1657985477640,MATH 193A,A01,083224,Rotar; Vladimir,9,0,34,25
1657985477640,MATH 193A,A02,083225,Rotar; Vladimir,11,0,34,23
1657985477640,MATH 193A,A03,083781,Rotar; Vladimir,5,0,34,29
1657985477640,MATH 193A,A04,083782,Rotar; Vladimir,12,0,34,22
1657985477640,MATH 193A,A05,093482,Rotar; Vladimir,11,0,34,23
1657985483665,MATH 197,001,091859,McAuley; Julian John,9999,0,9999,0
1657985483665,MATH 197,002,095566,Kedlaya; Kiran S.,9997,0,9999,2
1657985483665,MATH 197,003,095567,Xiao; Ming,9999,0,9999,0
1657985483665,MATH 197,004,095571,Perols; Johan Lars,9998,0,9999,1
1657985490751,COGS 9,A01,083615,Shannon; Kyle Michael,11,0,75,64
1657985496851,COGS 11,A01,083617,Boyle; Mary E. T.,23,0,48,25
1657985502876,COGS 13,A01,083071,Bastos; Amalia Pinkusfeld,12,0,71,59
1657985508901,COGS 14A,A01,092681,Semenuks; Arturs,5,1,100,95
1657985514925,COGS 14B,A01,083073,Cheng; Tzu-Han,7,0,63,56
1657985520950,COGS 17,A01,092677,Semenuks; Arturs,7,0,81,74
1657985526975,COGS 100,A01,083619,Allen; Michael Gordon,17,0,70,53
1657985533005,COGS 101A,A01,083621,Davis; Joshua Daniel,9,0,68,59
1657985539029,COGS 101B,A01,091572,Allen; Michael Gordon,14,0,65,51
1657985545058,COGS 101C,A01,083625,Delgado; Tania,17,0,35,18
1657985551087,COGS 107A,A01,083627,Boyle; Mary E. T.,14,0,60,46
1657985557111,COGS 118A,A01,083075,Gupta; Anjum,21,0,76,55
1657985563138,CSE 3,A50,083646,Miranda; Gregory Joseph,24,0,50,26
1657985569166,CSE 8A,A50,083650,Miranda; Gregory Joseph,17,1,56,39
1657985575190,CSE 11,A01,083080,Cao; Yingjun,7,15,40,33
1657985581221,CSE 12,A01,083652,Krause-Levy; Sophia Louisa,30,1,120,90
1657985587247,CSE 15L,A01,083654,Morris; Justin Loren,9,0,50,41
1657985587247,CSE 15L,A02,083655,Morris; Justin Loren,11,0,50,39
1657985593276,CSE 20,A01,083657,Tran; Khoa Dang,39,0,80,41
1657985599306,CSE 21,A01,095574,Bach; Quang Tran,23,0,48,25
1657985605331,CSE 30,A01,083084,Eldon; John,8,0,80,72
1657985605331,CSE 30,B01,095061,Bhaskar; Nishant,9,0,50,41
1657985611357,CSE 100,A01,083659,Cao; Yingjun,5,4,70,65
1657985617381,CSE 134B,A01,083661,Powell; Thomas Allan,25,0,100,75
1657985623414,CSE 140,A01,083663,Gungor; Onat,17,0,85,68
1657985629439,CSE 140L,A01,083088,Eldon; John,23,0,100,77
1657985635471,CSE 175,A01,083665,Kumar; Rakesh,3,0,25,22
1657985641495,CSE 190,A00,092507,Dubnov; Shlomo,8,0,20,12
1657985647521,ECE 45,A01,083139,Congero; Spencer William,7,0,75,68
1657985653548,ECE 65,A50,083695,Saad; Andrew S,12,0,30,18
1657985653548,ECE 65,A51,095125,Saad; Andrew S,24,0,26,2
1657985659578,ECE 109,A01,091882,Touri; Behrouz,21,0,70,49
1657985665611,ECE 180,A00,083140,Abi Samra; Nicholas Camill,1,0,30,29
1657985665611,ECE 180,B00,083141,Abi Samra; Nicholas Camill,0,0,30,30
1657985671642,MATH 10A,A01,083735,Patchell; Gregory David,2,0,30,28
1657985671642,MATH 10A,A02,083736,Patchell; Gregory David,20,0,30,10
1657985671642,MATH 10A,A03,083737,Patchell; Gregory David,16,0,30,14
1657985677676,MATH 10B,A01,083207,Lim; Seonhee,9,0,34,25
1657985677676,MATH 10B,A02,083208,Lim; Seonhee,10,0,35,25
1657985677676,MATH 10B,A03,093472,Lim; Seonhee,7,0,34,27
1657985677676,MATH 10B,B01,083739,Sinha; Shubham,14,0,30,16
1657985683701,MATH 18,A01,083743,Cinel; Cameron Alexander,9,0,30,21
1657985683701,MATH 18,A02,083744,Cinel; Cameron Alexander,18,0,30,12
1657985683701,MATH 18,A03,083745,Cinel; Cameron Alexander,10,0,30,20
1657985683701,MATH 18,B01,083748,Rideout; David Porter,5,0,37,32
1657985683701,MATH 18,B02,083749,Rideout; David Porter,5,0,36,31
1657985683701,MATH 18,B03,083750,Rideout; David Porter,3,0,37,34
1657985683701,MATH 18,B04,083751,Rideout; David Porter,7,0,36,29
1657985683701,MATH 18,B05,093473,Rideout; David Porter,7,0,36,29
1657985683701,MATH 18,B06,093474,Rideout; David Porter,6,0,36,30
1657985689731,MATH 20A,A01,083754,Zheng; Zequn,14,0,40,26
1657985695763,MATH 20B,A01,083756,Briones; Jor-el Thomas Caparas,4,0,36,32
1657985695763,MATH 20B,A02,083757,Briones; Jor-el Thomas Caparas,1,0,36,35
1657985695763,MATH 20B,A03,093475,Briones; Jor-el Thomas Caparas,3,0,36,33
1657985701796,MATH 20C,A01,083760,Briones; Jor-el Thomas Caparas,1,0,35,34
1657985701796,MATH 20C,A02,083761,Briones; Jor-el Thomas Caparas,8,0,35,27
1657985701796,MATH 20C,A03,093476,Briones; Jor-el Thomas Caparas,0,1,36,36
1657985701796,MATH 20C,B01,083762,Bach; Quang Tran,1,0,30,29
1657985707821,MATH 20D,A01,083765,Tran; Brian Kha,5,0,30,25
1657985707821,MATH 20D,A02,083766,Tran; Brian Kha,5,0,30,25
1657985707821,MATH 20D,A03,083767,Tran; Brian Kha,6,0,30,24
1657985713853,MATH 20E,A01,083771,Ganguly; Soumya,12,0,32,20
1657985713853,MATH 20E,A02,083772,Ganguly; Soumya,7,0,32,25
1657985713853,MATH 20E,B01,083773,Ciotti; Benjamin,20,0,35,15
1657985713853,MATH 20E,B02,083774,Ciotti; Benjamin,18,0,35,17
1657985719879,MATH 103A,A01,083777,Greenfeld; Be'Eri,6,0,36,30
1657985719879,MATH 103A,A02,083778,Greenfeld; Be'Eri,5,0,36,31
1657985719879,MATH 103A,A03,093561,Greenfeld; Be'Eri,7,0,36,29
1657985719879,MATH 103A,B01,083779,Greenfeld; Be'Eri,8,0,36,28
1657985719879,MATH 103A,B02,083780,Greenfeld; Be'Eri,4,0,36,32
1657985719879,MATH 103A,B03,093562,Greenfeld; Be'Eri,3,0,36,33
1657985725910,MATH 105,A01,085443,Carter; Anne Toulson,15,0,35,20
1657985725910,MATH 105,A02,093477,Carter; Anne Toulson,20,0,35,15
1657985731942,MATH 109,A01,083213,Ganzberger; Geoffrey Michael,3,0,34,31
1657985731942,MATH 109,A02,083214,Ganzberger; Geoffrey Michael,4,0,34,30
1657985731942,MATH 109,A03,093478,Ganzberger; Geoffrey Michael,2,0,34,32
1657985731942,MATH 109,B01,083215,Ganzberger; Geoffrey Michael,3,0,32,29
1657985731942,MATH 109,B02,083216,Ganzberger; Geoffrey Michael,3,0,32,29
1657985731942,MATH 109,B03,093479,Ganzberger; Geoffrey Michael,8,0,32,24
1657985737976,MATH 142A,A01,083219,Chow; Bennett,7,0,32,25
1657985737976,MATH 142A,A02,083220,Chow; Bennett,10,0,32,22
1657985737976,MATH 142A,A03,093480,Chow; Bennett,9,0,32,23
1657985737976,MATH 142A,B03,093481,Chow; Bennett,8,0,32,24
1657985737976,MATH 142A,B04,093558,Chow; Bennett,14,0,32,18
1657985737976,MATH 142A,B05,093559,Chow; Bennett,7,0,32,25
1657985744007,MATH 193A,A01,083224,Rotar; Vladimir,9,0,34,25
1657985744007,MATH 193A,A02,083225,Rotar; Vladimir,11,0,34,23
1657985744007,MATH 193A,A03,083781,Rotar; Vladimir,5,0,34,29
1657985744007,MATH 193A,A04,083782,Rotar; Vladimir,12,0,34,22
1657985744007,MATH 193A,A05,093482,Rotar; Vladimir,11,0,34,23
1657985750031,MATH 197,001,091859,McAuley; Julian John,9999,0,9999,0
1657985750031,MATH 197,002,095566,Kedlaya; Kiran S.,9997,0,9999,2
1657985750031,MATH 197,003,095567,Xiao; Ming,9999,0,9999,0
1657985750031,MATH 197,004,095571,Perols; Johan Lars,9998,0,9999,1
1657985757126,COGS 9,A01,083615,Shannon; Kyle Michael,11,0,75,64
1657985763150,COGS 11,A01,083617,Boyle; Mary E. T.,23,0,48,25
1657985769179,COGS 13,A01,083071,Bastos; Amalia Pinkusfeld,12,0,71,59
1657985775205,COGS 14A,A01,092681,Semenuks; Arturs,5,1,100,95
1657985781228,COGS 14B,A01,083073,Cheng; Tzu-Han,7,0,63,56
1657985787261,COGS 17,A01,092677,Semenuks; Arturs,7,0,81,74
1657985793297,COGS 100,A01,083619,Allen; Michael Gordon,17,0,70,53
1657985799332,COGS 101A,A01,083621,Davis; Joshua Daniel,9,0,68,59
1657985805355,COGS 101B,A01,091572,Allen; Michael Gordon,14,0,65,51
1657985811382,COGS 101C,A01,083625,Delgado; Tania,17,0,35,18
1657985817406,COGS 107A,A01,083627,Boyle; Mary E. T.,14,0,60,46
1657985823433,COGS 118A,A01,083075,Gupta; Anjum,21,0,76,55
1657985829468,CSE 3,A50,083646,Miranda; Gregory Joseph,24,0,50,26
1657985835491,CSE 8A,A50,083650,Miranda; Gregory Joseph,17,1,56,39
1657985841519,CSE 11,A01,083080,Cao; Yingjun,7,15,40,33
1657985847552,CSE 12,A01,083652,Krause-Levy; Sophia Louisa,30,1,120,90
1657985853580,CSE 15L,A01,083654,Morris; Justin Loren,9,0,50,41
1657985853580,CSE 15L,A02,083655,Morris; Justin Loren,11,0,50,39
1657985859609,CSE 20,A01,083657,Tran; Khoa Dang,39,0,80,41
1657985865638,CSE 21,A01,095574,Bach; Quang Tran,23,0,48,25
1657985871667,CSE 30,A01,083084,Eldon; John,8,0,80,72
1657985871667,CSE 30,B01,095061,Bhaskar; Nishant,9,0,50,41
1657985877701,CSE 100,A01,083659,Cao; Yingjun,5,4,70,65
1657985883735,CSE 134B,A01,083661,Powell; Thomas Allan,25,0,100,75
1657985889768,CSE 140,A01,083663,Gungor; Onat,17,0,85,68
1657985895802,CSE 140L,A01,083088,Eldon; John,23,0,100,77
1657985901826,CSE 175,A01,083665,Kumar; Rakesh,3,0,25,22
1657985907849,CSE 190,A00,092507,Dubnov; Shlomo,8,0,20,12
1657985913872,ECE 45,A01,083139,Congero; Spencer William,7,0,75,68
1657985919897,ECE 65,A50,083695,Saad; Andrew S,12,0,30,18
1657985919897,ECE 65,A51,095125,Saad; Andrew S,24,0,26,2
1657985925924,ECE 109,A01,091882,Touri; Behrouz,21,0,70,49
1657985931954,ECE 180,A00,083140,Abi Samra; Nicholas Camill,1,0,30,29
1657985931954,ECE 180,B00,083141,Abi Samra; Nicholas Camill,0,0,30,30
1657985937983,MATH 10A,A01,083735,Patchell; Gregory David,2,0,30,28
1657985937983,MATH 10A,A02,083736,Patchell; Gregory David,20,0,30,10
1657985937983,MATH 10A,A03,083737,Patchell; Gregory David,16,0,30,14
1657985944012,MATH 10B,A01,083207,Lim; Seonhee,9,0,34,25
1657985944012,MATH 10B,A02,083208,Lim; Seonhee,10,0,35,25
1657985944012,MATH 10B,A03,093472,Lim; Seonhee,7,0,34,27
1657985944012,MATH 10B,B01,083739,Sinha; Shubham,14,0,30,16
1657985950038,MATH 18,A01,083743,Cinel; Cameron Alexander,9,0,30,21
1657985950038,MATH 18,A02,083744,Cinel; Cameron Alexander,18,0,30,12
1657985950038,MATH 18,A03,083745,Cinel; Cameron Alexander,10,0,30,20
1657985950038,MATH 18,B01,083748,Rideout; David Porter,5,0,37,32
1657985950038,MATH 18,B02,083749,Rideout; David Porter,5,0,36,31
1657985950038,MATH 18,B03,083750,Rideout; David Porter,3,0,37,34
1657985950038,MATH 18,B04,083751,Rideout; David Porter,7,0,36,29
1657985950038,MATH 18,B05,093473,Rideout; David Porter,7,0,36,29
1657985950038,MATH 18,B06,093474,Rideout; David Porter,6,0,36,30
1657985956062,MATH 20A,A01,083754,Zheng; Zequn,14,0,40,26
1657985962096,MATH 20B,A01,083756,Briones; Jor-el Thomas Caparas,4,0,36,32
1657985962096,MATH 20B,A02,083757,Briones; Jor-el Thomas Caparas,1,0,36,35
1657985962096,MATH 20B,A03,093475,Briones; Jor-el Thomas Caparas,3,0,36,33
1657985968122,MATH 20C,A01,083760,Briones; Jor-el Thomas Caparas,1,0,35,34
1657985968122,MATH 20C,A02,083761,Briones; Jor-el Thomas Caparas,8,0,35,27
1657985968122,MATH 20C,A03,093476,Briones; Jor-el Thomas Caparas,0,1,36,36
1657985968122,MATH 20C,B01,083762,Bach; Quang Tran,1,0,30,29
1657985974147,MATH 20D,A01,083765,Tran; Brian Kha,5,0,30,25
1657985974147,MATH 20D,A02,083766,Tran; Brian Kha,5,0,30,25
1657985974147,MATH 20D,A03,083767,Tran; Brian Kha,6,0,30,24
1657985980172,MATH 20E,A01,083771,Ganguly; Soumya,12,0,32,20
1657985980172,MATH 20E,A02,083772,Ganguly; Soumya,7,0,32,25
1657985980172,MATH 20E,B01,083773,Ciotti; Benjamin,20,0,35,15
1657985980172,MATH 20E,B02,083774,Ciotti; Benjamin,18,0,35,17
1657985986199,MATH 103A,A01,083777,Greenfeld; Be'Eri,6,0,36,30
1657985986199,MATH 103A,A02,083778,Greenfeld; Be'Eri,5,0,36,31
1657985986199,MATH 103A,A03,093561,Greenfeld; Be'Eri,7,0,36,29
1657985986199,MATH 103A,B01,083779,Greenfeld; Be'Eri,8,0,36,28
1657985986199,MATH 103A,B02,083780,Greenfeld; Be'Eri,4,0,36,32
1657985986199,MATH 103A,B03,093562,Greenfeld; Be'Eri,3,0,36,33
1657985992222,MATH 105,A01,085443,Carter; Anne Toulson,15,0,35,20
1657985992222,MATH 105,A02,093477,Carter; Anne Toulson,20,0,35,15
1657985998246,MATH 109,A01,083213,Ganzberger; Geoffrey Michael,3,0,34,31
1657985998246,MATH 109,A02,083214,Ganzberger; Geoffrey Michael,4,0,34,30
1657985998246,MATH 109,A03,093478,Ganzberger; Geoffrey Michael,2,0,34,32
1657985998246,MATH 109,B01,083215,Ganzberger; Geoffrey Michael,3,0,32,29
1657985998246,MATH 109,B02,083216,Ganzberger; Geoffrey Michael,3,0,32,29
1657985998246,MATH 109,B03,093479,Ganzberger; Geoffrey Michael,8,0,32,24
1657986004270,MATH 142A,A01,083219,Chow; Bennett,7,0,32,25
1657986004270,MATH 142A,A02,083220,Chow; Bennett,10,0,32,22
1657986004270,MATH 142A,A03,093480,Chow; Bennett,9,0,32,23
1657986004270,MATH 142A,B03,093481,Chow; Bennett,8,0,32,24
1657986004270,MATH 142A,B04,093558,Chow; Bennett,14,0,32,18
1657986004270,MATH 142A,B05,093559,Chow; Bennett,7,0,32,25
1657986010297,MATH 193A,A01,083224,Rotar; Vladimir,9,0,34,25
1657986010297,MATH 193A,A02,083225,Rotar; Vladimir,11,0,34,23
1657986010297,MATH 193A,A03,083781,Rotar; Vladimir,5,0,34,29
1657986010297,MATH 193A,A04,083782,Rotar; Vladimir,12,0,34,22
1657986010297,MATH 193A,A05,093482,Rotar; Vladimir,11,0,34,23
1657986016321,MATH 197,001,091859,McAuley; Julian John,9999,0,9999,0
1657986016321,MATH 197,002,095566,Kedlaya; Kiran S.,9997,0,9999,2
1657986016321,MATH 197,003,095567,Xiao; Ming,9999,0,9999,0
1657986016321,MATH 197,004,095571,Perols; Johan Lars,9998,0,9999,1
1657986023390,COGS 9,A01,083615,Shannon; Kyle Michael,11,0,75,64
1657986029438,COGS 11,A01,083617,Boyle; Mary E. T.,23,0,48,25
1657986035462,COGS 13,A01,083071,Bastos; Amalia Pinkusfeld,12,0,71,59
1657986041485,COGS 14A,A01,092681,Semenuks; Arturs,5,1,100,95
1657986047514,COGS 14B,A01,083073,Cheng; Tzu-Han,7,0,63,56
1657986053536,COGS 17,A01,092677,Semenuks; Arturs,7,0,81,74
1657986059560,COGS 100,A01,083619,Allen; Michael Gordon,17,0,70,53
1657986065586,COGS 101A,A01,083621,Davis; Joshua Daniel,9,0,68,59
1657986071614,COGS 101B,A01,091572,Allen; Michael Gordon,14,0,65,51
1657986077638,COGS 101C,A01,083625,Delgado; Tania,17,0,35,18
1657986083664,COGS 107A,A01,083627,Boyle; Mary E. T.,14,0,60,46
1657986089687,COGS 118A,A01,083075,Gupta; Anjum,21,0,76,55
1657986095791,CSE 3,A50,083646,Miranda; Gregory Joseph,24,0,50,26
1657986101813,CSE 8A,A50,083650,Miranda; Gregory Joseph,17,1,56,39
1657986107837,CSE 11,A01,083080,Cao; Yingjun,7,15,40,33
1657986113865,CSE 12,A01,083652,Krause-Levy; Sophia Louisa,30,1,120,90
1657986119895,CSE 15L,A01,083654,Morris; Justin Loren,9,0,50,41
1657986119895,CSE 15L,A02,083655,Morris; Justin Loren,11,0,50,39
1657986125919,CSE 20,A01,083657,Tran; Khoa Dang,39,0,80,41
1657986131943,CSE 21,A01,095574,Bach; Quang Tran,23,0,48,25
1657986137974,CSE 30,A01,083084,Eldon; John,8,0,80,72
1657986137974,CSE 30,B01,095061,Bhaskar; Nishant,9,0,50,41
1657986143997,CSE 100,A01,083659,Cao; Yingjun,5,4,70,65
1657986150020,CSE 134B,A01,083661,Powell; Thomas Allan,25,0,100,75
1657986156043,CSE 140,A01,083663,Gungor; Onat,17,0,85,68
1657986162066,CSE 140L,A01,083088,Eldon; John,23,0,100,77
1657986168091,CSE 175,A01,083665,Kumar; Rakesh,3,0,25,22
1657986174113,CSE 190,A00,092507,Dubnov; Shlomo,8,0,20,12
1657986180141,ECE 45,A01,083139,Congero; Spencer William,7,0,75,68
1657986186169,ECE 65,A50,083695,Saad; Andrew S,12,0,30,18
1657986186169,ECE 65,A51,095125,Saad; Andrew S,24,0,26,2
1657986192198,ECE 109,A01,091882,Touri; Behrouz,21,0,70,49
1657986198222,ECE 180,A00,083140,Abi Samra; Nicholas Camill,1,0,30,29
1657986198222,ECE 180,B00,083141,Abi Samra; Nicholas Camill,0,0,30,30
1657986204246,MATH 10A,A01,083735,Patchell; Gregory David,2,0,30,28
1657986204246,MATH 10A,A02,083736,Patchell; Gregory David,20,0,30,10
1657986204246,MATH 10A,A03,083737,Patchell; Gregory David,16,0,30,14
1657986210278,MATH 10B,A01,083207,Lim; Seonhee,9,0,34,25
1657986210278,MATH 10B,A02,083208,Lim; Seonhee,10,0,35,25
1657986210278,MATH 10B,A03,093472,Lim; Seonhee,7,0,34,27
1657986210278,MATH 10B,B01,083739,Sinha; Shubham,14,0,30,16
1657986216322,MATH 18,A01,083743,Cinel; Cameron Alexander,9,0,30,21
1657986216322,MATH 18,A02,083744,Cinel; Cameron Alexander,18,0,30,12
1657986216322,MATH 18,A03,083745,Cinel; Cameron Alexander,10,0,30,20
1657986216322,MATH 18,B01,083748,Rideout; David Porter,5,0,37,32
1657986216322,MATH 18,B02,083749,Rideout; David Porter,5,0,36,31
1657986216322,MATH 18,B03,083750,Rideout; David Porter,3,0,37,34
1657986216322,MATH 18,B04,083751,Rideout; David Porter,7,0,36,29
1657986216322,MATH 18,B05,093473,Rideout; David Porter,7,0,36,29
1657986216322,MATH 18,B06,093474,Rideout; David Porter,6,0,36,30
1657986222347,MATH 20A,A01,083754,Zheng; Zequn,14,0,40,26
1657986228373,MATH 20B,A01,083756,Briones; Jor-el Thomas Caparas,4,0,36,32
1657986228373,MATH 20B,A02,083757,Briones; Jor-el Thomas Caparas,1,0,36,35
1657986228373,MATH 20B,A03,093475,Briones; Jor-el Thomas Caparas,3,0,36,33
1657986234403,MATH 20C,A01,083760,Briones; Jor-el Thomas Caparas,1,0,35,34
1657986234403,MATH 20C,A02,083761,Briones; Jor-el Thomas Caparas,8,0,35,27
1657986234403,MATH 20C,A03,093476,Briones; Jor-el Thomas Caparas,0,1,36,36
1657986234403,MATH 20C,B01,083762,Bach; Quang Tran,1,0,30,29
1657986240429,MATH 20D,A01,083765,Tran; Brian Kha,5,0,30,25
1657986240429,MATH 20D,A02,083766,Tran; Brian Kha,5,0,30,25
1657986240429,MATH 20D,A03,083767,Tran; Brian Kha,6,0,30,24
1657986246456,MATH 20E,A01,083771,Ganguly; Soumya,12,0,32,20
1657986246456,MATH 20E,A02,083772,Ganguly; Soumya,7,0,32,25
1657986246456,MATH 20E,B01,083773,Ciotti; Benjamin,20,0,35,15
1657986246456,MATH 20E,B02,083774,Ciotti; Benjamin,18,0,35,17
1657986252481,MATH 103A,A01,083777,Greenfeld; Be'Eri,6,0,36,30
1657986252481,MATH 103A,A02,083778,Greenfeld; Be'Eri,5,0,36,31
1657986252481,MATH 103A,A03,093561,Greenfeld; Be'Eri,7,0,36,29
1657986252481,MATH 103A,B01,083779,Greenfeld; Be'Eri,8,0,36,28
1657986252481,MATH 103A,B02,083780,Greenfeld; Be'Eri,4,0,36,32
1657986252481,MATH 103A,B03,093562,Greenfeld; Be'Eri,3,0,36,33
1657986258505,MATH 105,A01,085443,Carter; Anne Toulson,15,0,35,20
1657986258505,MATH 105,A02,093477,Carter; Anne Toulson,20,0,35,15
1657986264534,MATH 109,A01,083213,Ganzberger; Geoffrey Michael,3,0,34,31
1657986264534,MATH 109,A02,083214,Ganzberger; Geoffrey Michael,4,0,34,30
1657986264534,MATH 109,A03,093478,Ganzberger; Geoffrey Michael,2,0,34,32
1657986264534,MATH 109,B01,083215,Ganzberger; Geoffrey Michael,3,0,32,29
1657986264534,MATH 109,B02,083216,Ganzberger; Geoffrey Michael,3,0,32,29
1657986264534,MATH 109,B03,093479,Ganzberger; Geoffrey Michael,8,0,32,24
1657986270560,MATH 142A,A01,083219,Chow; Bennett,7,0,32,25
1657986270560,MATH 142A,A02,083220,Chow; Bennett,10,0,32,22
1657986270560,MATH 142A,A03,093480,Chow; Bennett,9,0,32,23
1657986270560,MATH 142A,B03,093481,Chow; Bennett,8,0,32,24
1657986270560,MATH 142A,B04,093558,Chow; Bennett,14,0,32,18
1657986270560,MATH 142A,B05,093559,Chow; Bennett,7,0,32,25
1657986276599,MATH 193A,A01,083224,Rotar; Vladimir,9,0,34,25
1657986276599,MATH 193A,A02,083225,Rotar; Vladimir,11,0,34,23
1657986276599,MATH 193A,A03,083781,Rotar; Vladimir,5,0,34,29
1657986276599,MATH 193A,A04,083782,Rotar; Vladimir,12,0,34,22
1657986276599,MATH 193A,A05,093482,Rotar; Vladimir,11,0,34,23
1657986282624,MATH 197,001,091859,McAuley; Julian John,9999,0,9999,0
1657986282624,MATH 197,002,095566,Kedlaya; Kiran S.,9997,0,9999,2
1657986282624,MATH 197,003,095567,Xiao; Ming,9999,0,9999,0
1657986282624,MATH 197,004,095571,Perols; Johan Lars,9998,0,9999,1
1657986289689,COGS 9,A01,083615,Shannon; Kyle Michael,11,0,75,64
1657986295713,COGS 11,A01,083617,Boyle; Mary E. T.,23,0,48,25
1657986301739,COGS 13,A01,083071,Bastos; Amalia Pinkusfeld,12,0,71,59
1657986307763,COGS 14A,A01,092681,Semenuks; Arturs,5,1,100,95
1657986313791,COGS 14B,A01,083073,Cheng; Tzu-Han,7,0,63,56
1657986319814,COGS 17,A01,092677,Semenuks; Arturs,7,0,81,74
1657986325843,COGS 100,A01,083619,Allen; Michael Gordon,17,0,70,53
1657986331867,COGS 101A,A01,083621,Davis; Joshua Daniel,9,0,68,59
1657986337903,COGS 101B,A01,091572,Allen; Michael Gordon,14,0,65,51
1657986343927,COGS 101C,A01,083625,Delgado; Tania,17,0,35,18
1657986349951,COGS 107A,A01,083627,Boyle; Mary E. T.,14,0,60,46
1657986355976,COGS 118A,A01,083075,Gupta; Anjum,21,0,76,55
1657986362006,CSE 3,A50,083646,Miranda; Gregory Joseph,24,0,50,26
1657986368030,CSE 8A,A50,083650,Miranda; Gregory Joseph,17,1,56,39
1657986374057,CSE 11,A01,083080,Cao; Yingjun,7,15,40,33
1657986380081,CSE 12,A01,083652,Krause-Levy; Sophia Louisa,30,1,120,90
1657986386110,CSE 15L,A01,083654,Morris; Justin Loren,9,0,50,41
1657986386110,CSE 15L,A02,083655,Morris; Justin Loren,11,0,50,39
1657986392135,CSE 20,A01,083657,Tran; Khoa Dang,39,0,80,41
1657986398162,CSE 21,A01,095574,Bach; Quang Tran,23,0,48,25
1657986404189,CSE 30,A01,083084,Eldon; John,8,0,80,72
1657986404189,CSE 30,B01,095061,Bhaskar; Nishant,9,0,50,41
1657986410213,CSE 100,A01,083659,Cao; Yingjun,5,4,70,65
1657986416237,CSE 134B,A01,083661,Powell; Thomas Allan,25,0,100,75
1657986422268,CSE 140,A01,083663,Gungor; Onat,17,0,85,68
1657986428296,CSE 140L,A01,083088,Eldon; John,23,0,100,77
1657986434319,CSE 175,A01,083665,Kumar; Rakesh,3,0,25,22
1657986440342,CSE 190,A00,092507,Dubnov; Shlomo,8,0,20,12
1657986446378,ECE 45,A01,083139,Congero; Spencer William,7,0,75,68
1657986452405,ECE 65,A50,083695,Saad; Andrew S,12,0,30,18
1657986452405,ECE 65,A51,095125,Saad; Andrew S,24,0,26,2
1657986458435,ECE 109,A01,091882,Touri; Behrouz,21,0,70,49
1657986464460,ECE 180,A00,083140,Abi Samra; Nicholas Camill,1,0,30,29
1657986464460,ECE 180,B00,083141,Abi Samra; Nicholas Camill,0,0,30,30
1657986470487,MATH 10A,A01,083735,Patchell; Gregory David,2,0,30,28
1657986470487,MATH 10A,A02,083736,Patchell; Gregory David,20,0,30,10
1657986470487,MATH 10A,A03,083737,Patchell; Gregory David,16,0,30,14
1657986476522,MATH 10B,A01,083207,Lim; Seonhee,9,0,34,25
1657986476522,MATH 10B,A02,083208,Lim; Seonhee,10,0,35,25
1657986476522,MATH 10B,A03,093472,Lim; Seonhee,7,0,34,27
1657986476522,MATH 10B,B01,083739,Sinha; Shubham,14,0,30,16
1657986482561,MATH 18,A01,083743,Cinel; Cameron Alexander,9,0,30,21
1657986482561,MATH 18,A02,083744,Cinel; Cameron Alexander,18,0,30,12
1657986482561,MATH 18,A03,083745,Cinel; Cameron Alexander,10,0,30,20
1657986482561,MATH 18,B01,083748,Rideout; David Porter,5,0,37,32
1657986482561,MATH 18,B02,083749,Rideout; David Porter,5,0,36,31
1657986482561,MATH 18,B03,083750,Rideout; David Porter,3,0,37,34
1657986482561,MATH 18,B04,083751,Rideout; David Porter,7,0,36,29
1657986482561,MATH 18,B05,093473,Rideout; David Porter,7,0,36,29
1657986482561,MATH 18,B06,093474,Rideout; David Porter,6,0,36,30
1657986488585,MATH 20A,A01,083754,Zheng; Zequn,14,0,40,26
1657986494611,MATH 20B,A01,083756,Briones; Jor-el Thomas Caparas,4,0,36,32
1657986494611,MATH 20B,A02,083757,Briones; Jor-el Thomas Caparas,1,0,36,35
1657986494611,MATH 20B,A03,093475,Briones; Jor-el Thomas Caparas,3,0,36,33
1657986500637,MATH 20C,A01,083760,Briones; Jor-el Thomas Caparas,1,0,35,34
1657986500637,MATH 20C,A02,083761,Briones; Jor-el Thomas Caparas,8,0,35,27
1657986500637,MATH 20C,A03,093476,Briones; Jor-el Thomas Caparas,0,1,36,36
1657986500637,MATH 20C,B01,083762,Bach; Quang Tran,1,0,30,29
1657986506666,MATH 20D,A01,083765,Tran; Brian Kha,5,0,30,25
1657986506666,MATH 20D,A02,083766,Tran; Brian Kha,5,0,30,25
1657986506666,MATH 20D,A03,083767,Tran; Brian Kha,6,0,30,24
1657986512693,MATH 20E,A01,083771,Ganguly; Soumya,12,0,32,20
1657986512693,MATH 20E,A02,083772,Ganguly; Soumya,7,0,32,25
1657986512693,MATH 20E,B01,083773,Ciotti; Benjamin,20,0,35,15
1657986512693,MATH 20E,B02,083774,Ciotti; Benjamin,18,0,35,17
1657986518717,MATH 103A,A01,083777,Greenfeld; Be'Eri,6,0,36,30
1657986518717,MATH 103A,A02,083778,Greenfeld; Be'Eri,5,0,36,31
1657986518717,MATH 103A,A03,093561,Greenfeld; Be'Eri,7,0,36,29
1657986518717,MATH 103A,B01,083779,Greenfeld; Be'Eri,8,0,36,28
1657986518717,MATH 103A,B02,083780,Greenfeld; Be'Eri,4,0,36,32
1657986518717,MATH 103A,B03,093562,Greenfeld; Be'Eri,3,0,36,33
1657986524749,MATH 105,A01,085443,Carter; Anne Toulson,15,0,35,20
1657986524749,MATH 105,A02,093477,Carter; Anne Toulson,20,0,35,15
1657986530779,MATH 109,A01,083213,Ganzberger; Geoffrey Michael,3,0,34,31
1657986530779,MATH 109,A02,083214,Ganzberger; Geoffrey Michael,4,0,34,30
1657986530779,MATH 109,A03,093478,Ganzberger; Geoffrey Michael,2,0,34,32
1657986530779,MATH 109,B01,083215,Ganzberger; Geoffrey Michael,3,0,32,29
1657986530779,MATH 109,B02,083216,Ganzberger; Geoffrey Michael,3,0,32,29
1657986530779,MATH 109,B03,093479,Ganzberger; Geoffrey Michael,8,0,32,24
1657986536804,MATH 142A,A01,083219,Chow; Bennett,7,0,32,25
1657986536804,MATH 142A,A02,083220,Chow; Bennett,10,0,32,22
1657986536804,MATH 142A,A03,093480,Chow; Bennett,9,0,32,23
1657986536804,MATH 142A,B03,093481,Chow; Bennett,8,0,32,24
1657986536804,MATH 142A,B04,093558,Chow; Bennett,14,0,32,18
1657986536804,MATH 142A,B05,093559,Chow; Bennett,7,0,32,25
1657986542832,MATH 193A,A01,083224,Rotar; Vladimir,9,0,34,25
1657986542832,MATH 193A,A02,083225,Rotar; Vladimir,11,0,34,23
1657986542832,MATH 193A,A03,083781,Rotar; Vladimir,5,0,34,29
1657986542832,MATH 193A,A04,083782,Rotar; Vladimir,12,0,34,22
1657986542832,MATH 193A,A05,093482,Rotar; Vladimir,11,0,34,23
1657986548862,MATH 197,001,091859,McAuley; Julian John,9999,0,9999,0
1657986548862,MATH 197,002,095566,Kedlaya; Kiran S.,9997,0,9999,2
1657986548862,MATH 197,003,095567,Xiao; Ming,9999,0,9999,0
1657986548862,MATH 197,004,095571,Perols; Johan Lars,9998,0,9999,1
1657986555944,COGS 9,A01,083615,Shannon; Kyle Michael,11,0,75,64
1657986561971,COGS 11,A01,083617,Boyle; Mary E. T.,23,0,48,25
1657986568000,COGS 13,A01,083071,Bastos; Amalia Pinkusfeld,12,0,71,59
1657986574024,COGS 14A,A01,092681,Semenuks; Arturs,5,1,100,95
1657986580052,COGS 14B,A01,083073,Cheng; Tzu-Han,7,0,63,56
1657986586075,COGS 17,A01,092677,Semenuks; Arturs,7,0,81,74
1657986592103,COGS 100,A01,083619,Allen; Michael Gordon,17,0,70,53
1657986598130,COGS 101A,A01,083621,Davis; Joshua Daniel,9,0,68,59
1657986604156,COGS 101B,A01,091572,Allen; Michael Gordon,14,0,65,51
1657986610180,COGS 101C,A01,083625,Delgado; Tania,17,0,35,18
1657986616202,COGS 107A,A01,083627,Boyle; Mary E. T.,14,0,60,46
1657986622227,COGS 118A,A01,083075,Gupta; Anjum,21,0,76,55
1657986628257,CSE 3,A50,083646,Miranda; Gregory Joseph,24,0,50,26
1657986634285,CSE 8A,A50,083650,Miranda; Gregory Joseph,17,1,56,39
1657986640312,CSE 11,A01,083080,Cao; Yingjun,7,15,40,33
1657986646337,CSE 12,A01,083652,Krause-Levy; Sophia Louisa,30,1,120,90
1657986652359,CSE 15L,A01,083654,Morris; Justin Loren,9,0,50,41
1657986652359,CSE 15L,A02,083655,Morris; Justin Loren,11,0,50,39
1657986658391,CSE 20,A01,083657,Tran; Khoa Dang,39,0,80,41
1657986664418,CSE 21,A01,095574,Bach; Quang Tran,23,0,48,25
1657986670442,CSE 30,A01,083084,Eldon; John,8,0,80,72
1657986670442,CSE 30,B01,095061,Bhaskar; Nishant,9,0,50,41
1657986676469,CSE 100,A01,083659,Cao; Yingjun,5,4,70,65
1657986682491,CSE 134B,A01,083661,Powell; Thomas Allan,25,0,100,75
1657986688519,CSE 140,A01,083663,Gungor; Onat,17,0,85,68
1657986694633,CSE 140L,A01,083088,Eldon; John,23,0,100,77
1657986700658,CSE 175,A01,083665,Kumar; Rakesh,3,0,25,22
1657986706685,CSE 190,A00,092507,Dubnov; Shlomo,8,0,20,12
1657986712711,ECE 45,A01,083139,Congero; Spencer William,7,0,75,68
1657986718761,ECE 65,A50,083695,Saad; Andrew S,12,0,30,18
1657986718761,ECE 65,A51,095125,Saad; Andrew S,24,0,26,2
1657986724785,ECE 109,A01,091882,Touri; Behrouz,21,0,70,49
1657986730864,ECE 180,A00,083140,Abi Samra; Nicholas Camill,1,0,30,29
1657986730864,ECE 180,B00,083141,Abi Samra; Nicholas Camill,0,0,30,30
1657986736889,MATH 10A,A01,083735,Patchell; Gregory David,2,0,30,28
1657986736889,MATH 10A,A02,083736,Patchell; Gregory David,20,0,30,10
1657986736889,MATH 10A,A03,083737,Patchell; Gregory David,16,0,30,14
1657986742917,MATH 10B,A01,083207,Lim; Seonhee,9,0,34,25
1657986742917,MATH 10B,A02,083208,Lim; Seonhee,10,0,35,25
1657986742917,MATH 10B,A03,093472,Lim; Seonhee,7,0,34,27
1657986742917,MATH 10B,B01,083739,Sinha; Shubham,14,0,30,16
1657986748944,MATH 18,A01,083743,Cinel; Cameron Alexander,9,0,30,21
1657986748944,MATH 18,A02,083744,Cinel; Cameron Alexander,18,0,30,12
1657986748944,MATH 18,A03,083745,Cinel; Cameron Alexander,10,0,30,20
1657986748944,MATH 18,B01,083748,Rideout; David Porter,5,0,37,32
1657986748944,MATH 18,B02,083749,Rideout; David Porter,5,0,36,31
1657986748944,MATH 18,B03,083750,Rideout; David Porter,3,0,37,34
1657986748944,MATH 18,B04,083751,Rideout; David Porter,7,0,36,29
1657986748944,MATH 18,B05,093473,Rideout; David Porter,7,0,36,29
1657986748944,MATH 18,B06,093474,Rideout; David Porter,6,0,36,30
1657986754969,MATH 20A,A01,083754,Zheng; Zequn,14,0,40,26
1657986760994,MATH 20B,A01,083756,Briones; Jor-el Thomas Caparas,4,0,36,32
1657986760994,MATH 20B,A02,083757,Briones; Jor-el Thomas Caparas,1,0,36,35
1657986760994,MATH 20B,A03,093475,Briones; Jor-el Thomas Caparas,3,0,36,33
1657986767019,MATH 20C,A01,083760,Briones; Jor-el Thomas Caparas,1,0,35,34
1657986767019,MATH 20C,A02,083761,Briones; Jor-el Thomas Caparas,8,0,35,27
1657986767019,MATH 20C,A03,093476,Briones; Jor-el Thomas Caparas,0,1,36,36
1657986767019,MATH 20C,B01,083762,Bach; Quang Tran,1,0,30,29
1657986773041,MATH 20D,A01,083765,Tran; Brian Kha,5,0,30,25
1657986773041,MATH 20D,A02,083766,Tran; Brian Kha,5,0,30,25
1657986773041,MATH 20D,A03,083767,Tran; Brian Kha,6,0,30,24
1657986779073,MATH 20E,A01,083771,Ganguly; Soumya,12,0,32,20
1657986779073,MATH 20E,A02,083772,Ganguly; Soumya,7,0,32,25
1657986779073,MATH 20E,B01,083773,Ciotti; Benjamin,20,0,35,15
1657986779073,MATH 20E,B02,083774,Ciotti; Benjamin,18,0,35,17
1657986785099,MATH 103A,A01,083777,Greenfeld; Be'Eri,6,0,36,30
1657986785099,MATH 103A,A02,083778,Greenfeld; Be'Eri,5,0,36,31
1657986785099,MATH 103A,A03,093561,Greenfeld; Be'Eri,7,0,36,29
1657986785099,MATH 103A,B01,083779,Greenfeld; Be'Eri,8,0,36,28
1657986785099,MATH 103A,B02,083780,Greenfeld; Be'Eri,4,0,36,32
1657986785099,MATH 103A,B03,093562,Greenfeld; Be'Eri,3,0,36,33
1657986791128,MATH 105,A01,085443,Carter; Anne Toulson,15,0,35,20
1657986791128,MATH 105,A02,093477,Carter; Anne Toulson,20,0,35,15
1657986797153,MATH 109,A01,083213,Ganzberger; Geoffrey Michael,3,0,34,31
1657986797153,MATH 109,A02,083214,Ganzberger; Geoffrey Michael,4,0,34,30
1657986797153,MATH 109,A03,093478,Ganzberger; Geoffrey Michael,2,0,34,32
1657986797153,MATH 109,B01,083215,Ganzberger; Geoffrey Michael,3,0,32,29
1657986797153,MATH 109,B02,083216,Ganzberger; Geoffrey Michael,3,0,32,29
1657986797153,MATH 109,B03,093479,Ganzberger; Geoffrey Michael,8,0,32,24
1657986803177,MATH 142A,A01,083219,Chow; Bennett,7,0,32,25
1657986803177,MATH 142A,A02,083220,Chow; Bennett,10,0,32,22
1657986803177,MATH 142A,A03,093480,Chow; Bennett,9,0,32,23
1657986803177,MATH 142A,B03,093481,Chow; Bennett,8,0,32,24
1657986803177,MATH 142A,B04,093558,Chow; Bennett,14,0,32,18
1657986803177,MATH 142A,B05,093559,Chow; Bennett,7,0,32,25
1657986809208,MATH 193A,A01,083224,Rotar; Vladimir,9,0,34,25
1657986809208,MATH 193A,A02,083225,Rotar; Vladimir,11,0,34,23
1657986809208,MATH 193A,A03,083781,Rotar; Vladimir,5,0,34,29
1657986809208,MATH 193A,A04,083782,Rotar; Vladimir,12,0,34,22
1657986809208,MATH 193A,A05,093482,Rotar; Vladimir,11,0,34,23
1657986815249,MATH 197,001,091859,McAuley; Julian John,9999,0,9999,0
1657986815249,MATH 197,002,095566,Kedlaya; Kiran S.,9997,0,9999,2
1657986815249,MATH 197,003,095567,Xiao; Ming,9999,0,9999,0
1657986815249,MATH 197,004,095571,Perols; Johan Lars,9998,0,9999,1
1657986822320,COGS 9,A01,083615,Shannon; Kyle Michael,11,0,75,64
1657986828348,COGS 11,A01,083617,Boyle; Mary E. T.,23,0,48,25
1657986834381,COGS 13,A01,083071,Bastos; Amalia Pinkusfeld,12,0,71,59
1657986840407,COGS 14A,A01,092681,Semenuks; Arturs,5,1,100,95
1657986846431,COGS 14B,A01,083073,Cheng; Tzu-Han,7,0,63,56
1657986852456,COGS 17,A01,092677,Semenuks; Arturs,7,0,81,74
1657986858484,COGS 100,A01,083619,Allen; Michael Gordon,17,0,70,53
1657986864512,COGS 101A,A01,083621,Davis; Joshua Daniel,9,0,68,59
1657986870541,COGS 101B,A01,091572,Allen; Michael Gordon,14,0,65,51
1657986876568,COGS 101C,A01,083625,Delgado; Tania,17,0,35,18
1657986882596,COGS 107A,A01,083627,Boyle; Mary E. T.,14,0,60,46
1657986888623,COGS 118A,A01,083075,Gupta; Anjum,21,0,76,55
1657986894653,CSE 3,A50,083646,Miranda; Gregory Joseph,24,0,50,26
1657986900678,CSE 8A,A50,083650,Miranda; Gregory Joseph,17,1,56,39
1657986906706,CSE 11,A01,083080,Cao; Yingjun,7,15,40,33
1657986912733,CSE 12,A01,083652,Krause-Levy; Sophia Louisa,30,1,120,90
1657986918762,CSE 15L,A01,083654,Morris; Justin Loren,9,0,50,41
1657986918762,CSE 15L,A02,083655,Morris; Justin Loren,11,0,50,39
1657986924787,CSE 20,A01,083657,Tran; Khoa Dang,39,0,80,41
1657986930811,CSE 21,A01,095574,Bach; Quang Tran,23,0,48,25
1657986936837,CSE 30,A01,083084,Eldon; John,8,0,80,72
1657986936837,CSE 30,B01,095061,Bhaskar; Nishant,9,0,50,41
1657986942866,CSE 100,A01,083659,Cao; Yingjun,5,4,70,65
1657986948911,CSE 134B,A01,083661,Powell; Thomas Allan,25,0,100,75
1657986954936,CSE 140,A01,083663,Gungor; Onat,17,0,85,68
1657986960960,CSE 140L,A01,083088,Eldon; John,23,0,100,77
1657986966989,CSE 175,A01,083665,Kumar; Rakesh,3,0,25,22
1657986973018,CSE 190,A00,092507,Dubnov; Shlomo,8,0,20,12
1657986979048,ECE 45,A01,083139,Congero; Spencer William,7,0,75,68
1657986985075,ECE 65,A50,083695,Saad; Andrew S,12,0,30,18
1657986985075,ECE 65,A51,095125,Saad; Andrew S,24,0,26,2
1657986991101,ECE 109,A01,091882,Touri; Behrouz,21,0,70,49
1657986997126,ECE 180,A00,083140,Abi Samra; Nicholas Camill,1,0,30,29
1657986997126,ECE 180,B00,083141,Abi Samra; Nicholas Camill,0,0,30,30
1657987003152,MATH 10A,A01,083735,Patchell; Gregory David,2,0,30,28
1657987003152,MATH 10A,A02,083736,Patchell; Gregory David,20,0,30,10
1657987003152,MATH 10A,A03,083737,Patchell; Gregory David,16,0,30,14
1657987009185,MATH 10B,A01,083207,Lim; Seonhee,9,0,34,25
1657987009185,MATH 10B,A02,083208,Lim; Seonhee,10,0,35,25
1657987009185,MATH 10B,A03,093472,Lim; Seonhee,7,0,34,27
1657987009185,MATH 10B,B01,083739,Sinha; Shubham,14,0,30,16
1657987015213,MATH 18,A01,083743,Cinel; Cameron Alexander,9,0,30,21
1657987015213,MATH 18,A02,083744,Cinel; Cameron Alexander,18,0,30,12
1657987015213,MATH 18,A03,083745,Cinel; Cameron Alexander,10,0,30,20
1657987015213,MATH 18,B01,083748,Rideout; David Porter,5,0,37,32
1657987015213,MATH 18,B02,083749,Rideout; David Porter,5,0,36,31
1657987015213,MATH 18,B03,083750,Rideout; David Porter,3,0,37,34
1657987015213,MATH 18,B04,083751,Rideout; David Porter,7,0,36,29
1657987015213,MATH 18,B05,093473,Rideout; David Porter,7,0,36,29
1657987015213,MATH 18,B06,093474,Rideout; David Porter,6,0,36,30
1657987021238,MATH 20A,A01,083754,Zheng; Zequn,14,0,40,26
1657987027263,MATH 20B,A01,083756,Briones; Jor-el Thomas Caparas,4,0,36,32
1657987027263,MATH 20B,A02,083757,Briones; Jor-el Thomas Caparas,1,0,36,35
1657987027263,MATH 20B,A03,093475,Briones; Jor-el Thomas Caparas,3,0,36,33
1657987033287,MATH 20C,A01,083760,Briones; Jor-el Thomas Caparas,1,0,35,34
1657987033287,MATH 20C,A02,083761,Briones; Jor-el Thomas Caparas,8,0,35,27
1657987033287,MATH 20C,A03,093476,Briones; Jor-el Thomas Caparas,0,1,36,36
1657987033287,MATH 20C,B01,083762,Bach; Quang Tran,1,0,30,29
1657987039318,MATH 20D,A01,083765,Tran; Brian Kha,5,0,30,25
1657987039318,MATH 20D,A02,083766,Tran; Brian Kha,5,0,30,25
1657987039318,MATH 20D,A03,083767,Tran; Brian Kha,6,0,30,24
1657987045345,MATH 20E,A01,083771,Ganguly; Soumya,12,0,32,20
1657987045345,MATH 20E,A02,083772,Ganguly; Soumya,7,0,32,25
1657987045345,MATH 20E,B01,083773,Ciotti; Benjamin,20,0,35,15
1657987045345,MATH 20E,B02,083774,Ciotti; Benjamin,18,0,35,17
1657987051370,MATH 103A,A01,083777,Greenfeld; Be'Eri,6,0,36,30
1657987051370,MATH 103A,A02,083778,Greenfeld; Be'Eri,5,0,36,31
1657987051370,MATH 103A,A03,093561,Greenfeld; Be'Eri,7,0,36,29
1657987051370,MATH 103A,B01,083779,Greenfeld; Be'Eri,8,0,36,28
1657987051370,MATH 103A,B02,083780,Greenfeld; Be'Eri,4,0,36,32
1657987051370,MATH 103A,B03,093562,Greenfeld; Be'Eri,3,0,36,33
1657987057395,MATH 105,A01,085443,Carter; Anne Toulson,15,0,35,20
1657987057395,MATH 105,A02,093477,Carter; Anne Toulson,20,0,35,15
1657987063421,MATH 109,A01,083213,Ganzberger; Geoffrey Michael,3,0,34,31
1657987063421,MATH 109,A02,083214,Ganzberger; Geoffrey Michael,4,0,34,30
1657987063421,MATH 109,A03,093478,Ganzberger; Geoffrey Michael,2,0,34,32
1657987063421,MATH 109,B01,083215,Ganzberger; Geoffrey Michael,3,0,32,29
1657987063421,MATH 109,B02,083216,Ganzberger; Geoffrey Michael,3,0,32,29
1657987063421,MATH 109,B03,093479,Ganzberger; Geoffrey Michael,8,0,32,24
1657987069447,MATH 142A,A01,083219,Chow; Bennett,7,0,32,25
1657987069447,MATH 142A,A02,083220,Chow; Bennett,10,0,32,22
1657987069447,MATH 142A,A03,093480,Chow; Bennett,9,0,32,23
1657987069447,MATH 142A,B03,093481,Chow; Bennett,8,0,32,24
1657987069447,MATH 142A,B04,093558,Chow; Bennett,14,0,32,18
1657987069447,MATH 142A,B05,093559,Chow; Bennett,7,0,32,25
1657987075474,MATH 193A,A01,083224,Rotar; Vladimir,9,0,34,25
1657987075474,MATH 193A,A02,083225,Rotar; Vladimir,11,0,34,23
1657987075474,MATH 193A,A03,083781,Rotar; Vladimir,5,0,34,29
1657987075474,MATH 193A,A04,083782,Rotar; Vladimir,12,0,34,22
1657987075474,MATH 193A,A05,093482,Rotar; Vladimir,11,0,34,23
1657987081498,MATH 197,001,091859,McAuley; Julian John,9999,0,9999,0
1657987081498,MATH 197,002,095566,Kedlaya; Kiran S.,9997,0,9999,2
1657987081498,MATH 197,003,095567,Xiao; Ming,9999,0,9999,0
1657987081498,MATH 197,004,095571,Perols; Johan Lars,9998,0,9999,1
1657987088570,COGS 9,A01,083615,Shannon; Kyle Michael,11,0,75,64
1657987094595,COGS 11,A01,083617,Boyle; Mary E. T.,23,0,48,25
1657987100623,COGS 13,A01,083071,Bastos; Amalia Pinkusfeld,12,0,71,59
1657987106647,COGS 14A,A01,092681,Semenuks; Arturs,5,1,100,95
1657987112677,COGS 14B,A01,083073,Cheng; Tzu-Han,7,0,63,56
1657987118708,COGS 17,A01,092677,Semenuks; Arturs,7,0,81,74
1657987124732,COGS 100,A01,083619,Allen; Michael Gordon,17,0,70,53
1657987130757,COGS 101A,A01,083621,Davis; Joshua Daniel,9,0,68,59
1657987136785,COGS 101B,A01,091572,Allen; Michael Gordon,14,0,65,51
1657987142810,COGS 101C,A01,083625,Delgado; Tania,17,0,35,18
1657987148840,COGS 107A,A01,083627,Boyle; Mary E. T.,14,0,60,46
1657987154865,COGS 118A,A01,083075,Gupta; Anjum,21,0,76,55
1657987160894,CSE 3,A50,083646,Miranda; Gregory Joseph,24,0,50,26
1657987166919,CSE 8A,A50,083650,Miranda; Gregory Joseph,17,1,56,39
1657987172943,CSE 11,A01,083080,Cao; Yingjun,7,15,40,33
1657987178972,CSE 12,A01,083652,Krause-Levy; Sophia Louisa,30,1,120,90
1657987184998,CSE 15L,A01,083654,Morris; Justin Loren,9,0,50,41
1657987184998,CSE 15L,A02,083655,Morris; Justin Loren,11,0,50,39
1657987191032,CSE 20,A01,083657,Tran; Khoa Dang,39,0,80,41
1657987197060,CSE 21,A01,095574,Bach; Quang Tran,23,0,48,25
1657987203090,CSE 30,A01,083084,Eldon; John,8,0,80,72
1657987203090,CSE 30,B01,095061,Bhaskar; Nishant,9,0,50,41
1657987209112,CSE 100,A01,083659,Cao; Yingjun,5,4,70,65
1657987215144,CSE 134B,A01,083661,Powell; Thomas Allan,25,0,100,75
1657987221167,CSE 140,A01,083663,Gungor; Onat,17,0,85,68
1657987227192,CSE 140L,A01,083088,Eldon; John,23,0,100,77
1657987233216,CSE 175,A01,083665,Kumar; Rakesh,3,0,25,22
1657987239240,CSE 190,A00,092507,Dubnov; Shlomo,8,0,20,12
1657987245267,ECE 45,A01,083139,Congero; Spencer William,7,0,75,68
1657987251294,ECE 65,A50,083695,Saad; Andrew S,12,0,30,18
1657987251294,ECE 65,A51,095125,Saad; Andrew S,24,0,26,2
1657987257321,ECE 109,A01,091882,Touri; Behrouz,21,0,70,49
1657987263345,ECE 180,A00,083140,Abi Samra; Nicholas Camill,1,0,30,29
1657987263345,ECE 180,B00,083141,Abi Samra; Nicholas Camill,0,0,30,30
1657987269372,MATH 10A,A01,083735,Patchell; Gregory David,2,0,30,28
1657987269372,MATH 10A,A02,083736,Patchell; Gregory David,20,0,30,10
1657987269372,MATH 10A,A03,083737,Patchell; Gregory David,16,0,30,14
1657987275404,MATH 10B,A01,083207,Lim; Seonhee,9,0,34,25
1657987275404,MATH 10B,A02,083208,Lim; Seonhee,10,0,35,25
1657987275404,MATH 10B,A03,093472,Lim; Seonhee,7,0,34,27
1657987275404,MATH 10B,B01,083739,Sinha; Shubham,14,0,30,16
1657987281439,MATH 18,A01,083743,Cinel; Cameron Alexander,9,0,30,21
1657987281439,MATH 18,A02,083744,Cinel; Cameron Alexander,18,0,30,12
1657987281439,MATH 18,A03,083745,Cinel; Cameron Alexander,10,0,30,20
1657987281439,MATH 18,B01,083748,Rideout; David Porter,5,0,37,32
1657987281439,MATH 18,B02,083749,Rideout; David Porter,5,0,36,31
1657987281439,MATH 18,B03,083750,Rideout; David Porter,3,0,37,34
1657987281439,MATH 18,B04,083751,Rideout; David Porter,7,0,36,29
1657987281439,MATH 18,B05,093473,Rideout; David Porter,7,0,36,29
1657987281439,MATH 18,B06,093474,Rideout; David Porter,6,0,36,30
1657987287468,MATH 20A,A01,083754,Zheng; Zequn,14,0,40,26
1657987293595,MATH 20B,A01,083756,Briones; Jor-el Thomas Caparas,4,0,36,32
1657987293595,MATH 20B,A02,083757,Briones; Jor-el Thomas Caparas,1,0,36,35
1657987293595,MATH 20B,A03,093475,Briones; Jor-el Thomas Caparas,3,0,36,33
1657987299625,MATH 20C,A01,083760,Briones; Jor-el Thomas Caparas,1,0,35,34
1657987299625,MATH 20C,A02,083761,Briones; Jor-el Thomas Caparas,8,0,35,27
1657987299625,MATH 20C,A03,093476,Briones; Jor-el Thomas Caparas,0,1,36,36
1657987299625,MATH 20C,B01,083762,Bach; Quang Tran,1,0,30,29
1657987305654,MATH 20D,A01,083765,Tran; Brian Kha,5,0,30,25
1657987305654,MATH 20D,A02,083766,Tran; Brian Kha,5,0,30,25
1657987305654,MATH 20D,A03,083767,Tran; Brian Kha,6,0,30,24
1657987311683,MATH 20E,A01,083771,Ganguly; Soumya,12,0,32,20
1657987311683,MATH 20E,A02,083772,Ganguly; Soumya,7,0,32,25
1657987311683,MATH 20E,B01,083773,Ciotti; Benjamin,20,0,35,15
1657987311683,MATH 20E,B02,083774,Ciotti; Benjamin,18,0,35,17
1657987317712,MATH 103A,A01,083777,Greenfeld; Be'Eri,6,0,36,30
1657987317712,MATH 103A,A02,083778,Greenfeld; Be'Eri,5,0,36,31
1657987317712,MATH 103A,A03,093561,Greenfeld; Be'Eri,7,0,36,29
1657987317712,MATH 103A,B01,083779,Greenfeld; Be'Eri,8,0,36,28
1657987317712,MATH 103A,B02,083780,Greenfeld; Be'Eri,4,0,36,32
1657987317712,MATH 103A,B03,093562,Greenfeld; Be'Eri,3,0,36,33
1657987323740,MATH 105,A01,085443,Carter; Anne Toulson,15,0,35,20
1657987323740,MATH 105,A02,093477,Carter; Anne Toulson,20,0,35,15
1657987329770,MATH 109,A01,083213,Ganzberger; Geoffrey Michael,3,0,34,31
1657987329770,MATH 109,A02,083214,Ganzberger; Geoffrey Michael,4,0,34,30
1657987329770,MATH 109,A03,093478,Ganzberger; Geoffrey Michael,2,0,34,32
1657987329770,MATH 109,B01,083215,Ganzberger; Geoffrey Michael,3,0,32,29
1657987329770,MATH 109,B02,083216,Ganzberger; Geoffrey Michael,3,0,32,29
1657987329770,MATH 109,B03,093479,Ganzberger; Geoffrey Michael,8,0,32,24
1657987335796,MATH 142A,A01,083219,Chow; Bennett,7,0,32,25
1657987335796,MATH 142A,A02,083220,Chow; Bennett,10,0,32,22
1657987335796,MATH 142A,A03,093480,Chow; Bennett,9,0,32,23
1657987335796,MATH 142A,B03,093481,Chow; Bennett,8,0,32,24
1657987335796,MATH 142A,B04,093558,Chow; Bennett,14,0,32,18
1657987335796,MATH 142A,B05,093559,Chow; Bennett,7,0,32,25
1657987341823,MATH 193A,A01,083224,Rotar; Vladimir,9,0,34,25
1657987341823,MATH 193A,A02,083225,Rotar; Vladimir,11,0,34,23
1657987341823,MATH 193A,A03,083781,Rotar; Vladimir,5,0,34,29
1657987341823,MATH 193A,A04,083782,Rotar; Vladimir,12,0,34,22
1657987341823,MATH 193A,A05,093482,Rotar; Vladimir,11,0,34,23
1657987347847,MATH 197,001,091859,McAuley; Julian John,9999,0,9999,0
1657987347847,MATH 197,002,095566,Kedlaya; Kiran S.,9997,0,9999,2
1657987347847,MATH 197,003,095567,Xiao; Ming,9999,0,9999,0
1657987347847,MATH 197,004,095571,Perols; Johan Lars,9998,0,9999,1
1657987354917,COGS 9,A01,083615,Shannon; Kyle Michael,11,0,75,64
1657987360942,COGS 11,A01,083617,Boyle; Mary E. T.,23,0,48,25
1657987366966,COGS 13,A01,083071,Bastos; Amalia Pinkusfeld,12,0,71,59
1657987372991,COGS 14A,A01,092681,Semenuks; Arturs,5,1,100,95
1657987379019,COGS 14B,A01,083073,Cheng; Tzu-Han,7,0,63,56
1657987385042,COGS 17,A01,092677,Semenuks; Arturs,7,0,81,74
1657987391066,COGS 100,A01,083619,Allen; Michael Gordon,17,0,70,53
1657987397094,COGS 101A,A01,083621,Davis; Joshua Daniel,9,0,68,59
1657987403118,COGS 101B,A01,091572,Allen; Michael Gordon,14,0,65,51
1657987409144,COGS 101C,A01,083625,Delgado; Tania,17,0,35,18
1657987415172,COGS 107A,A01,083627,Boyle; Mary E. T.,14,0,60,46
1657987421201,COGS 118A,A01,083075,Gupta; Anjum,21,0,76,55
1657987427229,CSE 3,A50,083646,Miranda; Gregory Joseph,24,0,50,26
1657987433263,CSE 8A,A50,083650,Miranda; Gregory Joseph,17,1,56,39
1657987439293,CSE 11,A01,083080,Cao; Yingjun,7,15,40,33
1657987445318,CSE 12,A01,083652,Krause-Levy; Sophia Louisa,30,1,120,90
1657987451346,CSE 15L,A01,083654,Morris; Justin Loren,9,0,50,41
1657987451346,CSE 15L,A02,083655,Morris; Justin Loren,11,0,50,39
1657987457370,CSE 20,A01,083657,Tran; Khoa Dang,39,0,80,41
1657987463393,CSE 21,A01,095574,Bach; Quang Tran,23,0,48,25
1657987469419,CSE 30,A01,083084,Eldon; John,8,0,80,72
1657987469419,CSE 30,B01,095061,Bhaskar; Nishant,9,0,50,41
1657987475447,CSE 100,A01,083659,Cao; Yingjun,5,4,70,65
1657987481475,CSE 134B,A01,083661,Powell; Thomas Allan,25,0,100,75
1657987487499,CSE 140,A01,083663,Gungor; Onat,17,0,85,68
1657987493532,CSE 140L,A01,083088,Eldon; John,23,0,100,77
1657987499559,CSE 175,A01,083665,Kumar; Rakesh,3,0,25,22
1657987505583,CSE 190,A00,092507,Dubnov; Shlomo,8,0,20,12
1657987511608,ECE 45,A01,083139,Congero; Spencer William,7,0,75,68
1657987517633,ECE 65,A50,083695,Saad; Andrew S,12,0,30,18
1657987517633,ECE 65,A51,095125,Saad; Andrew S,24,0,26,2
1657987523660,ECE 109,A01,091882,Touri; Behrouz,21,0,70,49
1657987529689,ECE 180,A00,083140,Abi Samra; Nicholas Camill,1,0,30,29
1657987529689,ECE 180,B00,083141,Abi Samra; Nicholas Camill,0,0,30,30
1657987535716,MATH 10A,A01,083735,Patchell; Gregory David,2,0,30,28
1657987535716,MATH 10A,A02,083736,Patchell; Gregory David,20,0,30,10
1657987535716,MATH 10A,A03,083737,Patchell; Gregory David,16,0,30,14
1657987541749,MATH 10B,A01,083207,Lim; Seonhee,9,0,34,25
1657987541749,MATH 10B,A02,083208,Lim; Seonhee,10,0,35,25
1657987541749,MATH 10B,A03,093472,Lim; Seonhee,7,0,34,27
1657987541749,MATH 10B,B01,083739,Sinha; Shubham,14,0,30,16
1657987547776,MATH 18,A01,083743,Cinel; Cameron Alexander,9,0,30,21
1657987547776,MATH 18,A02,083744,Cinel; Cameron Alexander,18,0,30,12
1657987547776,MATH 18,A03,083745,Cinel; Cameron Alexander,10,0,30,20
1657987547776,MATH 18,B01,083748,Rideout; David Porter,5,0,37,32
1657987547776,MATH 18,B02,083749,Rideout; David Porter,5,0,36,31
1657987547776,MATH 18,B03,083750,Rideout; David Porter,3,0,37,34
1657987547776,MATH 18,B04,083751,Rideout; David Porter,7,0,36,29
1657987547776,MATH 18,B05,093473,Rideout; David Porter,7,0,36,29
1657987547776,MATH 18,B06,093474,Rideout; David Porter,6,0,36,30
1657987553802,MATH 20A,A01,083754,Zheng; Zequn,14,0,40,26
1657987559833,MATH 20B,A01,083756,Briones; Jor-el Thomas Caparas,4,0,36,32
1657987559833,MATH 20B,A02,083757,Briones; Jor-el Thomas Caparas,1,0,36,35
1657987559833,MATH 20B,A03,093475,Briones; Jor-el Thomas Caparas,3,0,36,33
1657987565857,MATH 20C,A01,083760,Briones; Jor-el Thomas Caparas,1,0,35,34
1657987565857,MATH 20C,A02,083761,Briones; Jor-el Thomas Caparas,8,0,35,27
1657987565857,MATH 20C,A03,093476,Briones; Jor-el Thomas Caparas,0,1,36,36
1657987565857,MATH 20C,B01,083762,Bach; Quang Tran,1,0,30,29
1657987571881,MATH 20D,A01,083765,Tran; Brian Kha,5,0,30,25
1657987571881,MATH 20D,A02,083766,Tran; Brian Kha,5,0,30,25
1657987571881,MATH 20D,A03,083767,Tran; Brian Kha,6,0,30,24
1657987577912,MATH 20E,A01,083771,Ganguly; Soumya,12,0,32,20
1657987577912,MATH 20E,A02,083772,Ganguly; Soumya,7,0,32,25
1657987577912,MATH 20E,B01,083773,Ciotti; Benjamin,20,0,35,15
1657987577912,MATH 20E,B02,083774,Ciotti; Benjamin,18,0,35,17
1657987583950,MATH 103A,A01,083777,Greenfeld; Be'Eri,6,0,36,30
1657987583950,MATH 103A,A02,083778,Greenfeld; Be'Eri,5,0,36,31
1657987583950,MATH 103A,A03,093561,Greenfeld; Be'Eri,7,0,36,29
1657987583950,MATH 103A,B01,083779,Greenfeld; Be'Eri,8,0,36,28
1657987583950,MATH 103A,B02,083780,Greenfeld; Be'Eri,4,0,36,32
1657987583950,MATH 103A,B03,093562,Greenfeld; Be'Eri,3,0,36,33
1657987589980,MATH 105,A01,085443,Carter; Anne Toulson,15,0,35,20
1657987589980,MATH 105,A02,093477,Carter; Anne Toulson,20,0,35,15
1657987596006,MATH 109,A01,083213,Ganzberger; Geoffrey Michael,3,0,34,31
1657987596006,MATH 109,A02,083214,Ganzberger; Geoffrey Michael,4,0,34,30
1657987596006,MATH 109,A03,093478,Ganzberger; Geoffrey Michael,2,0,34,32
1657987596006,MATH 109,B01,083215,Ganzberger; Geoffrey Michael,3,0,32,29
1657987596006,MATH 109,B02,083216,Ganzberger; Geoffrey Michael,3,0,32,29
1657987596006,MATH 109,B03,093479,Ganzberger; Geoffrey Michael,8,0,32,24
1657987602038,MATH 142A,A01,083219,Chow; Bennett,7,0,32,25
1657987602038,MATH 142A,A02,083220,Chow; Bennett,10,0,32,22
1657987602038,MATH 142A,A03,093480,Chow; Bennett,9,0,32,23
1657987602038,MATH 142A,B03,093481,Chow; Bennett,8,0,32,24
1657987602038,MATH 142A,B04,093558,Chow; Bennett,14,0,32,18
1657987602038,MATH 142A,B05,093559,Chow; Bennett,7,0,32,25
1657987608068,MATH 193A,A01,083224,Rotar; Vladimir,9,0,34,25
1657987608068,MATH 193A,A02,083225,Rotar; Vladimir,11,0,34,23
1657987608068,MATH 193A,A03,083781,Rotar; Vladimir,5,0,34,29
1657987608068,MATH 193A,A04,083782,Rotar; Vladimir,12,0,34,22
1657987608068,MATH 193A,A05,093482,Rotar; Vladimir,11,0,34,23
1657987614094,MATH 197,001,091859,McAuley; Julian John,9999,0,9999,0
1657987614094,MATH 197,002,095566,Kedlaya; Kiran S.,9997,0,9999,2
1657987614094,MATH 197,003,095567,Xiao; Ming,9999,0,9999,0
1657987614094,MATH 197,004,095571,Perols; Johan Lars,9998,0,9999,1
1657987621166,COGS 9,A01,083615,Shannon; Kyle Michael,11,0,75,64
1657987627191,COGS 11,A01,083617,Boyle; Mary E. T.,23,0,48,25
1657987633217,COGS 13,A01,083071,Bastos; Amalia Pinkusfeld,12,0,71,59
1657987639242,COGS 14A,A01,092681,Semenuks; Arturs,5,1,100,95
1657987645267,COGS 14B,A01,083073,Cheng; Tzu-Han,7,0,63,56
1657987651292,COGS 17,A01,092677,Semenuks; Arturs,7,0,81,74
1657987657319,COGS 100,A01,083619,Allen; Michael Gordon,17,0,70,53
1657987663348,COGS 101A,A01,083621,Davis; Joshua Daniel,9,0,68,59
1657987669378,COGS 101B,A01,091572,Allen; Michael Gordon,14,0,65,51
1657987675402,COGS 101C,A01,083625,Delgado; Tania,17,0,35,18
1657987681426,COGS 107A,A01,083627,Boyle; Mary E. T.,14,0,60,46
1657987687452,COGS 118A,A01,083075,Gupta; Anjum,21,0,76,55
1657987693505,CSE 3,A50,083646,Miranda; Gregory Joseph,24,0,50,26
1657987699528,CSE 8A,A50,083650,Miranda; Gregory Joseph,17,1,56,39
1657987705557,CSE 11,A01,083080,Cao; Yingjun,7,15,40,33
1657987711580,CSE 12,A01,083652,Krause-Levy; Sophia Louisa,30,1,120,90
1657987717603,CSE 15L,A01,083654,Morris; Justin Loren,9,0,50,41
1657987717603,CSE 15L,A02,083655,Morris; Justin Loren,11,0,50,39
1657987723630,CSE 20,A01,083657,Tran; Khoa Dang,39,0,80,41
1657987729658,CSE 21,A01,095574,Bach; Quang Tran,23,0,48,25
1657987735683,CSE 30,A01,083084,Eldon; John,8,0,80,72
1657987735683,CSE 30,B01,095061,Bhaskar; Nishant,9,0,50,41
1657987741717,CSE 100,A01,083659,Cao; Yingjun,5,4,70,65
1657987747770,CSE 134B,A01,083661,Powell; Thomas Allan,25,0,100,75
1657987753798,CSE 140,A01,083663,Gungor; Onat,17,0,85,68
1657987759837,CSE 140L,A01,083088,Eldon; John,23,0,100,77
1657987765862,CSE 175,A01,083665,Kumar; Rakesh,3,0,25,22
1657987771885,CSE 190,A00,092507,Dubnov; Shlomo,8,0,20,12
1657987777909,ECE 45,A01,083139,Congero; Spencer William,7,0,75,68
1657987783941,ECE 65,A50,083695,Saad; Andrew S,12,0,30,18
1657987783941,ECE 65,A51,095125,Saad; Andrew S,24,0,26,2
1657987789972,ECE 109,A01,091882,Touri; Behrouz,21,0,70,49
1657987796011,ECE 180,A00,083140,Abi Samra; Nicholas Camill,1,0,30,29
1657987796011,ECE 180,B00,083141,Abi Samra; Nicholas Camill,0,0,30,30
1657987802050,MATH 10A,A01,083735,Patchell; Gregory David,2,0,30,28
1657987802050,MATH 10A,A02,083736,Patchell; Gregory David,20,0,30,10
1657987802050,MATH 10A,A03,083737,Patchell; Gregory David,16,0,30,14
1657987808078,MATH 10B,A01,083207,Lim; Seonhee,9,0,34,25
1657987808078,MATH 10B,A02,083208,Lim; Seonhee,10,0,35,25
1657987808078,MATH 10B,A03,093472,Lim; Seonhee,7,0,34,27
1657987808078,MATH 10B,B01,083739,Sinha; Shubham,14,0,30,16
1657987814105,MATH 18,A01,083743,Cinel; Cameron Alexander,9,0,30,21
1657987814105,MATH 18,A02,083744,Cinel; Cameron Alexander,18,0,30,12
1657987814105,MATH 18,A03,083745,Cinel; Cameron Alexander,10,0,30,20
1657987814105,MATH 18,B01,083748,Rideout; David Porter,5,0,37,32
1657987814105,MATH 18,B02,083749,Rideout; David Porter,5,0,36,31
1657987814105,MATH 18,B03,083750,Rideout; David Porter,3,0,37,34
1657987814105,MATH 18,B04,083751,Rideout; David Porter,7,0,36,29
1657987814105,MATH 18,B05,093473,Rideout; David Porter,7,0,36,29
1657987814105,MATH 18,B06,093474,Rideout; David Porter,6,0,36,30
1657987820133,MATH 20A,A01,083754,Zheng; Zequn,14,0,40,26
1657987826160,MATH 20B,A01,083756,Briones; Jor-el Thomas Caparas,4,0,36,32
1657987826160,MATH 20B,A02,083757,Briones; Jor-el Thomas Caparas,1,0,36,35
1657987826160,MATH 20B,A03,093475,Briones; Jor-el Thomas Caparas,3,0,36,33
1657987832197,MATH 20C,A01,083760,Briones; Jor-el Thomas Caparas,1,0,35,34
1657987832197,MATH 20C,A02,083761,Briones; Jor-el Thomas Caparas,8,0,35,27
1657987832197,MATH 20C,A03,093476,Briones; Jor-el Thomas Caparas,0,1,36,36
1657987832197,MATH 20C,B01,083762,Bach; Quang Tran,1,0,30,29
1657987838228,MATH 20D,A01,083765,Tran; Brian Kha,5,0,30,25
1657987838228,MATH 20D,A02,083766,Tran; Brian Kha,5,0,30,25
1657987838228,MATH 20D,A03,083767,Tran; Brian Kha,6,0,30,24
1657987844256,MATH 20E,A01,083771,Ganguly; Soumya,12,0,32,20
1657987844256,MATH 20E,A02,083772,Ganguly; Soumya,7,0,32,25
1657987844256,MATH 20E,B01,083773,Ciotti; Benjamin,20,0,35,15
1657987844256,MATH 20E,B02,083774,Ciotti; Benjamin,18,0,35,17
1657987850288,MATH 103A,A01,083777,Greenfeld; Be'Eri,6,0,36,30
1657987850288,MATH 103A,A02,083778,Greenfeld; Be'Eri,5,0,36,31
1657987850288,MATH 103A,A03,093561,Greenfeld; Be'Eri,7,0,36,29
1657987850288,MATH 103A,B01,083779,Greenfeld; Be'Eri,8,0,36,28
1657987850288,MATH 103A,B02,083780,Greenfeld; Be'Eri,4,0,36,32
1657987850288,MATH 103A,B03,093562,Greenfeld; Be'Eri,3,0,36,33
1657987856314,MATH 105,A01,085443,Carter; Anne Toulson,15,0,35,20
1657987856314,MATH 105,A02,093477,Carter; Anne Toulson,20,0,35,15
1657987862343,MATH 109,A01,083213,Ganzberger; Geoffrey Michael,3,0,34,31
1657987862343,MATH 109,A02,083214,Ganzberger; Geoffrey Michael,4,0,34,30
1657987862343,MATH 109,A03,093478,Ganzberger; Geoffrey Michael,2,0,34,32
1657987862343,MATH 109,B01,083215,Ganzberger; Geoffrey Michael,3,0,32,29
1657987862343,MATH 109,B02,083216,Ganzberger; Geoffrey Michael,3,0,32,29
1657987862343,MATH 109,B03,093479,Ganzberger; Geoffrey Michael,8,0,32,24
1657987868368,MATH 142A,A01,083219,Chow; Bennett,7,0,32,25
1657987868368,MATH 142A,A02,083220,Chow; Bennett,10,0,32,22
1657987868368,MATH 142A,A03,093480,Chow; Bennett,9,0,32,23
1657987868368,MATH 142A,B03,093481,Chow; Bennett,8,0,32,24
1657987868368,MATH 142A,B04,093558,Chow; Bennett,14,0,32,18
1657987868368,MATH 142A,B05,093559,Chow; Bennett,7,0,32,25
1657987874392,MATH 193A,A01,083224,Rotar; Vladimir,9,0,34,25
1657987874392,MATH 193A,A02,083225,Rotar; Vladimir,11,0,34,23
1657987874392,MATH 193A,A03,083781,Rotar; Vladimir,5,0,34,29
1657987874392,MATH 193A,A04,083782,Rotar; Vladimir,12,0,34,22
1657987874392,MATH 193A,A05,093482,Rotar; Vladimir,11,0,34,23
1657987880415,MATH 197,001,091859,McAuley; Julian John,9999,0,9999,0
1657987880415,MATH 197,002,095566,Kedlaya; Kiran S.,9997,0,9999,2
1657987880415,MATH 197,003,095567,Xiao; Ming,9999,0,9999,0
1657987880415,MATH 197,004,095571,Perols; Johan Lars,9998,0,9999,1
1657987887569,COGS 9,A01,083615,Shannon; Kyle Michael,11,0,75,64
1657987893592,COGS 11,A01,083617,Boyle; Mary E. T.,23,0,48,25
1657987899640,COGS 13,A01,083071,Bastos; Amalia Pinkusfeld,12,0,71,59
1657987905670,COGS 14A,A01,092681,Semenuks; Arturs,5,1,100,95
1657987911697,COGS 14B,A01,083073,Cheng; Tzu-Han,7,0,63,56
1657987917725,COGS 17,A01,092677,Semenuks; Arturs,7,0,81,74
1657987923751,COGS 100,A01,083619,Allen; Michael Gordon,17,0,70,53
1657987929783,COGS 101A,A01,083621,Davis; Joshua Daniel,9,0,68,59
1657987935813,COGS 101B,A01,091572,Allen; Michael Gordon,14,0,65,51
1657987941842,COGS 101C,A01,083625,Delgado; Tania,17,0,35,18
1657987947866,COGS 107A,A01,083627,Boyle; Mary E. T.,14,0,60,46
1657987953891,COGS 118A,A01,083075,Gupta; Anjum,21,0,76,55
1657987959918,CSE 3,A50,083646,Miranda; Gregory Joseph,24,0,50,26
1657987965951,CSE 8A,A50,083650,Miranda; Gregory Joseph,17,1,56,39
1657987971977,CSE 11,A01,083080,Cao; Yingjun,7,15,40,33
1657987978001,CSE 12,A01,083652,Krause-Levy; Sophia Louisa,30,1,120,90
1657987984026,CSE 15L,A01,083654,Morris; Justin Loren,9,0,50,41
1657987984026,CSE 15L,A02,083655,Morris; Justin Loren,11,0,50,39
1657987990074,CSE 20,A01,083657,Tran; Khoa Dang,39,0,80,41
1657987996108,CSE 21,A01,095574,Bach; Quang Tran,23,0,48,25
1657988002133,CSE 30,A01,083084,Eldon; John,8,0,80,72
1657988002133,CSE 30,B01,095061,Bhaskar; Nishant,9,0,50,41
1657988008156,CSE 100,A01,083659,Cao; Yingjun,5,4,70,65
1657988014181,CSE 134B,A01,083661,Powell; Thomas Allan,25,0,100,75
1657988020207,CSE 140,A01,083663,Gungor; Onat,17,0,85,68
1657988026238,CSE 140L,A01,083088,Eldon; John,23,0,100,77
1657988032270,CSE 175,A01,083665,Kumar; Rakesh,3,0,25,22
1657988038297,CSE 190,A00,092507,Dubnov; Shlomo,8,0,20,12
1657988044335,ECE 45,A01,083139,Congero; Spencer William,7,0,75,68
1657988050361,ECE 65,A50,083695,Saad; Andrew S,12,0,30,18
1657988050361,ECE 65,A51,095125,Saad; Andrew S,24,0,26,2
1657988056387,ECE 109,A01,091882,Touri; Behrouz,21,0,70,49
1657988062415,ECE 180,A00,083140,Abi Samra; Nicholas Camill,1,0,30,29
1657988062415,ECE 180,B00,083141,Abi Samra; Nicholas Camill,0,0,30,30
1657988068462,MATH 10A,A01,083735,Patchell; Gregory David,2,0,30,28
1657988068462,MATH 10A,A02,083736,Patchell; Gregory David,20,0,30,10
1657988068462,MATH 10A,A03,083737,Patchell; Gregory David,16,0,30,14
1657988074490,MATH 10B,A01,083207,Lim; Seonhee,9,0,34,25
1657988074490,MATH 10B,A02,083208,Lim; Seonhee,10,0,35,25
1657988074490,MATH 10B,A03,093472,Lim; Seonhee,7,0,34,27
1657988074490,MATH 10B,B01,083739,Sinha; Shubham,14,0,30,16
1657988080528,MATH 18,A01,083743,Cinel; Cameron Alexander,9,0,30,21
1657988080528,MATH 18,A02,083744,Cinel; Cameron Alexander,18,0,30,12
1657988080528,MATH 18,A03,083745,Cinel; Cameron Alexander,10,0,30,20
1657988080528,MATH 18,B01,083748,Rideout; David Porter,5,0,37,32
1657988080528,MATH 18,B02,083749,Rideout; David Porter,5,0,36,31
1657988080528,MATH 18,B03,083750,Rideout; David Porter,3,0,37,34
1657988080528,MATH 18,B04,083751,Rideout; David Porter,7,0,36,29
1657988080528,MATH 18,B05,093473,Rideout; David Porter,7,0,36,29
1657988080528,MATH 18,B06,093474,Rideout; David Porter,6,0,36,30
1657988086553,MATH 20A,A01,083754,Zheng; Zequn,14,0,40,26
1657988092584,MATH 20B,A01,083756,Briones; Jor-el Thomas Caparas,4,0,36,32
1657988092584,MATH 20B,A02,083757,Briones; Jor-el Thomas Caparas,1,0,36,35
1657988092584,MATH 20B,A03,093475,Briones; Jor-el Thomas Caparas,3,0,36,33
1657988098610,MATH 20C,A01,083760,Briones; Jor-el Thomas Caparas,1,0,35,34
1657988098610,MATH 20C,A02,083761,Briones; Jor-el Thomas Caparas,8,0,35,27
1657988098610,MATH 20C,A03,093476,Briones; Jor-el Thomas Caparas,0,1,36,36
1657988098610,MATH 20C,B01,083762,Bach; Quang Tran,1,0,30,29
1657988104641,MATH 20D,A01,083765,Tran; Brian Kha,5,0,30,25
1657988104641,MATH 20D,A02,083766,Tran; Brian Kha,5,0,30,25
1657988104641,MATH 20D,A03,083767,Tran; Brian Kha,6,0,30,24
1657988110666,MATH 20E,A01,083771,Ganguly; Soumya,12,0,32,20
1657988110666,MATH 20E,A02,083772,Ganguly; Soumya,7,0,32,25
1657988110666,MATH 20E,B01,083773,Ciotti; Benjamin,20,0,35,15
1657988110666,MATH 20E,B02,083774,Ciotti; Benjamin,18,0,35,17
1657988116702,MATH 103A,A01,083777,Greenfeld; Be'Eri,6,0,36,30
1657988116702,MATH 103A,A02,083778,Greenfeld; Be'Eri,5,0,36,31
1657988116702,MATH 103A,A03,093561,Greenfeld; Be'Eri,7,0,36,29
1657988116702,MATH 103A,B01,083779,Greenfeld; Be'Eri,8,0,36,28
1657988116702,MATH 103A,B02,083780,Greenfeld; Be'Eri,4,0,36,32
1657988116702,MATH 103A,B03,093562,Greenfeld; Be'Eri,3,0,36,33
1657988122725,MATH 105,A01,085443,Carter; Anne Toulson,15,0,35,20
1657988122725,MATH 105,A02,093477,Carter; Anne Toulson,20,0,35,15
1657988128749,MATH 109,A01,083213,Ganzberger; Geoffrey Michael,3,0,34,31
1657988128749,MATH 109,A02,083214,Ganzberger; Geoffrey Michael,4,0,34,30
1657988128749,MATH 109,A03,093478,Ganzberger; Geoffrey Michael,2,0,34,32
1657988128749,MATH 109,B01,083215,Ganzberger; Geoffrey Michael,3,0,32,29
1657988128749,MATH 109,B02,083216,Ganzberger; Geoffrey Michael,3,0,32,29
1657988128749,MATH 109,B03,093479,Ganzberger; Geoffrey Michael,8,0,32,24
1657988134773,MATH 142A,A01,083219,Chow; Bennett,7,0,32,25
1657988134773,MATH 142A,A02,083220,Chow; Bennett,10,0,32,22
1657988134773,MATH 142A,A03,093480,Chow; Bennett,9,0,32,23
1657988134773,MATH 142A,B03,093481,Chow; Bennett,8,0,32,24
1657988134773,MATH 142A,B04,093558,Chow; Bennett,14,0,32,18
1657988134773,MATH 142A,B05,093559,Chow; Bennett,7,0,32,25
1657988140801,MATH 193A,A01,083224,Rotar; Vladimir,9,0,34,25
1657988140801,MATH 193A,A02,083225,Rotar; Vladimir,11,0,34,23
1657988140801,MATH 193A,A03,083781,Rotar; Vladimir,5,0,34,29
1657988140801,MATH 193A,A04,083782,Rotar; Vladimir,12,0,34,22
1657988140801,MATH 193A,A05,093482,Rotar; Vladimir,11,0,34,23
1657988146826,MATH 197,001,091859,McAuley; Julian John,9999,0,9999,0
1657988146826,MATH 197,002,095566,Kedlaya; Kiran S.,9997,0,9999,2
1657988146826,MATH 197,003,095567,Xiao; Ming,9999,0,9999,0
1657988146826,MATH 197,004,095571,Perols; Johan Lars,9998,0,9999,1
1657988153897,COGS 9,A01,083615,Shannon; Kyle Michael,11,0,75,64
1657988159920,COGS 11,A01,083617,Boyle; Mary E. T.,23,0,48,25
1657988165950,COGS 13,A01,083071,Bastos; Amalia Pinkusfeld,12,0,71,59
1657988171974,COGS 14A,A01,092681,Semenuks; Arturs,5,1,100,95
1657988177998,COGS 14B,A01,083073,Cheng; Tzu-Han,7,0,63,56
1657988184022,COGS 17,A01,092677,Semenuks; Arturs,7,0,81,74
1657988190046,COGS 100,A01,083619,Allen; Michael Gordon,17,0,70,53
1657988196089,COGS 101A,A01,083621,Davis; Joshua Daniel,9,0,68,59
1657988202112,COGS 101B,A01,091572,Allen; Michael Gordon,14,0,65,51
1657988208137,COGS 101C,A01,083625,Delgado; Tania,17,0,35,18
1657988214163,COGS 107A,A01,083627,Boyle; Mary E. T.,14,0,60,46
1657988220192,COGS 118A,A01,083075,Gupta; Anjum,21,0,76,55
1657988226218,CSE 3,A50,083646,Miranda; Gregory Joseph,24,0,50,26
1657988232243,CSE 8A,A50,083650,Miranda; Gregory Joseph,17,1,56,39
1657988238267,CSE 11,A01,083080,Cao; Yingjun,7,15,40,33
1657988244290,CSE 12,A01,083652,Krause-Levy; Sophia Louisa,30,1,120,90
1657988250324,CSE 15L,A01,083654,Morris; Justin Loren,9,0,50,41
1657988250324,CSE 15L,A02,083655,Morris; Justin Loren,11,0,50,39
1657988256354,CSE 20,A01,083657,Tran; Khoa Dang,39,0,80,41
1657988262384,CSE 21,A01,095574,Bach; Quang Tran,23,0,48,25
1657988268408,CSE 30,A01,083084,Eldon; John,8,0,80,72
1657988268408,CSE 30,B01,095061,Bhaskar; Nishant,9,0,50,41
1657988274433,CSE 100,A01,083659,Cao; Yingjun,5,4,70,65
1657988280458,CSE 134B,A01,083661,Powell; Thomas Allan,25,0,100,75
1657988286483,CSE 140,A01,083663,Gungor; Onat,17,0,85,68
1657988292506,CSE 140L,A01,083088,Eldon; John,23,0,100,77
1657988298536,CSE 175,A01,083665,Kumar; Rakesh,3,0,25,22
1657988304559,CSE 190,A00,092507,Dubnov; Shlomo,8,0,20,12
1657988310584,ECE 45,A01,083139,Congero; Spencer William,7,0,75,68
1657988316616,ECE 65,A50,083695,Saad; Andrew S,12,0,30,18
1657988316616,ECE 65,A51,095125,Saad; Andrew S,24,0,26,2
1657988322639,ECE 109,A01,091882,Touri; Behrouz,21,0,70,49
1657988328663,ECE 180,A00,083140,Abi Samra; Nicholas Camill,1,0,30,29
1657988328663,ECE 180,B00,083141,Abi Samra; Nicholas Camill,0,0,30,30
1657988334708,MATH 10A,A01,083735,Patchell; Gregory David,2,0,30,28
1657988334708,MATH 10A,A02,083736,Patchell; Gregory David,20,0,30,10
1657988334708,MATH 10A,A03,083737,Patchell; Gregory David,16,0,30,14
1657988340735,MATH 10B,A01,083207,Lim; Seonhee,9,0,34,25
1657988340735,MATH 10B,A02,083208,Lim; Seonhee,10,0,35,25
1657988340735,MATH 10B,A03,093472,Lim; Seonhee,7,0,34,27
1657988340735,MATH 10B,B01,083739,Sinha; Shubham,14,0,30,16
1657988346762,MATH 18,A01,083743,Cinel; Cameron Alexander,9,0,30,21
1657988346762,MATH 18,A02,083744,Cinel; Cameron Alexander,18,0,30,12
1657988346762,MATH 18,A03,083745,Cinel; Cameron Alexander,10,0,30,20
1657988346762,MATH 18,B01,083748,Rideout; David Porter,5,0,37,32
1657988346762,MATH 18,B02,083749,Rideout; David Porter,5,0,36,31
1657988346762,MATH 18,B03,083750,Rideout; David Porter,3,0,37,34
1657988346762,MATH 18,B04,083751,Rideout; David Porter,7,0,36,29
1657988346762,MATH 18,B05,093473,Rideout; David Porter,7,0,36,29
1657988346762,MATH 18,B06,093474,Rideout; David Porter,6,0,36,30
1657988352788,MATH 20A,A01,083754,Zheng; Zequn,14,0,40,26
1657988358818,MATH 20B,A01,083756,Briones; Jor-el Thomas Caparas,4,0,36,32
1657988358818,MATH 20B,A02,083757,Briones; Jor-el Thomas Caparas,1,0,36,35
1657988358818,MATH 20B,A03,093475,Briones; Jor-el Thomas Caparas,3,0,36,33
1657988364842,MATH 20C,A01,083760,Briones; Jor-el Thomas Caparas,1,0,35,34
1657988364842,MATH 20C,A02,083761,Briones; Jor-el Thomas Caparas,8,0,35,27
1657988364842,MATH 20C,A03,093476,Briones; Jor-el Thomas Caparas,0,1,36,36
1657988364842,MATH 20C,B01,083762,Bach; Quang Tran,1,0,30,29
1657988370866,MATH 20D,A01,083765,Tran; Brian Kha,5,0,30,25
1657988370866,MATH 20D,A02,083766,Tran; Brian Kha,5,0,30,25
1657988370866,MATH 20D,A03,083767,Tran; Brian Kha,6,0,30,24
1657988376896,MATH 20E,A01,083771,Ganguly; Soumya,12,0,32,20
1657988376896,MATH 20E,A02,083772,Ganguly; Soumya,7,0,32,25
1657988376896,MATH 20E,B01,083773,Ciotti; Benjamin,20,0,35,15
1657988376896,MATH 20E,B02,083774,Ciotti; Benjamin,18,0,35,17
1657988382930,MATH 103A,A01,083777,Greenfeld; Be'Eri,6,0,36,30
1657988382930,MATH 103A,A02,083778,Greenfeld; Be'Eri,5,0,36,31
1657988382930,MATH 103A,A03,093561,Greenfeld; Be'Eri,7,0,36,29
1657988382930,MATH 103A,B01,083779,Greenfeld; Be'Eri,8,0,36,28
1657988382930,MATH 103A,B02,083780,Greenfeld; Be'Eri,4,0,36,32
1657988382930,MATH 103A,B03,093562,Greenfeld; Be'Eri,3,0,36,33
1657988388961,MATH 105,A01,085443,Carter; Anne Toulson,15,0,35,20
1657988388961,MATH 105,A02,093477,Carter; Anne Toulson,20,0,35,15
1657988394985,MATH 109,A01,083213,Ganzberger; Geoffrey Michael,3,0,34,31
1657988394985,MATH 109,A02,083214,Ganzberger; Geoffrey Michael,4,0,34,30
1657988394985,MATH 109,A03,093478,Ganzberger; Geoffrey Michael,2,0,34,32
1657988394985,MATH 109,B01,083215,Ganzberger; Geoffrey Michael,3,0,32,29
1657988394985,MATH 109,B02,083216,Ganzberger; Geoffrey Michael,3,0,32,29
1657988394985,MATH 109,B03,093479,Ganzberger; Geoffrey Michael,8,0,32,24
1657988401021,MATH 142A,A01,083219,Chow; Bennett,7,0,32,25
1657988401021,MATH 142A,A02,083220,Chow; Bennett,10,0,32,22
1657988401021,MATH 142A,A03,093480,Chow; Bennett,9,0,32,23
1657988401021,MATH 142A,B03,093481,Chow; Bennett,8,0,32,24
1657988401021,MATH 142A,B04,093558,Chow; Bennett,14,0,32,18
1657988401021,MATH 142A,B05,093559,Chow; Bennett,7,0,32,25
1657988407048,MATH 193A,A01,083224,Rotar; Vladimir,9,0,34,25
1657988407048,MATH 193A,A02,083225,Rotar; Vladimir,11,0,34,23
1657988407048,MATH 193A,A03,083781,Rotar; Vladimir,5,0,34,29
1657988407048,MATH 193A,A04,083782,Rotar; Vladimir,12,0,34,22
1657988407048,MATH 193A,A05,093482,Rotar; Vladimir,11,0,34,23
1657988413082,MATH 197,001,091859,McAuley; Julian John,9999,0,9999,0
1657988413082,MATH 197,002,095566,Kedlaya; Kiran S.,9997,0,9999,2
1657988413082,MATH 197,003,095567,Xiao; Ming,9999,0,9999,0
1657988413082,MATH 197,004,095571,Perols; Johan Lars,9998,0,9999,1
1657988420147,COGS 9,A01,083615,Shannon; Kyle Michael,11,0,75,64
1657988426172,COGS 11,A01,083617,Boyle; Mary E. T.,23,0,48,25
1657988432206,COGS 13,A01,083071,Bastos; Amalia Pinkusfeld,12,0,71,59
1657988438242,COGS 14A,A01,092681,Semenuks; Arturs,5,1,100,95
1657988444271,COGS 14B,A01,083073,Cheng; Tzu-Han,7,0,63,56
1657988450301,COGS 17,A01,092677,Semenuks; Arturs,7,0,81,74
1657988456334,COGS 100,A01,083619,Allen; Michael Gordon,17,0,70,53
1657988462370,COGS 101A,A01,083621,Davis; Joshua Daniel,9,0,68,59
1657988468407,COGS 101B,A01,091572,Allen; Michael Gordon,14,0,65,51
1657988474439,COGS 101C,A01,083625,Delgado; Tania,17,0,35,18
1657988480467,COGS 107A,A01,083627,Boyle; Mary E. T.,14,0,60,46
1657988486573,COGS 118A,A01,083075,Gupta; Anjum,21,0,76,55
1657988492597,CSE 3,A50,083646,Miranda; Gregory Joseph,24,0,50,26
1657988498625,CSE 8A,A50,083650,Miranda; Gregory Joseph,17,1,56,39
1657988504648,CSE 11,A01,083080,Cao; Yingjun,7,15,40,33
1657988510676,CSE 12,A01,083652,Krause-Levy; Sophia Louisa,30,1,120,90
1657988516704,CSE 15L,A01,083654,Morris; Justin Loren,9,0,50,41
1657988516704,CSE 15L,A02,083655,Morris; Justin Loren,11,0,50,39
1657988522751,CSE 20,A01,083657,Tran; Khoa Dang,39,0,80,41
1657988528774,CSE 21,A01,095574,Bach; Quang Tran,23,0,48,25
1657988534797,CSE 30,A01,083084,Eldon; John,8,0,80,72
1657988534797,CSE 30,B01,095061,Bhaskar; Nishant,9,0,50,41
1657988540824,CSE 100,A01,083659,Cao; Yingjun,5,4,70,65
1657988546848,CSE 134B,A01,083661,Powell; Thomas Allan,25,0,100,75
1657988552874,CSE 140,A01,083663,Gungor; Onat,17,0,85,68
1657988558910,CSE 140L,A01,083088,Eldon; John,23,0,100,77
1657988564933,CSE 175,A01,083665,Kumar; Rakesh,3,0,25,22
1657988570960,CSE 190,A00,092507,Dubnov; Shlomo,8,0,20,12
1657988576993,ECE 45,A01,083139,Congero; Spencer William,7,0,75,68
1657988583017,ECE 65,A50,083695,Saad; Andrew S,12,0,30,18
1657988583017,ECE 65,A51,095125,Saad; Andrew S,24,0,26,2
1657988589040,ECE 109,A01,091882,Touri; Behrouz,21,0,70,49
1657988595063,ECE 180,A00,083140,Abi Samra; Nicholas Camill,1,0,30,29
1657988595063,ECE 180,B00,083141,Abi Samra; Nicholas Camill,0,0,30,30
1657988601089,MATH 10A,A01,083735,Patchell; Gregory David,2,0,30,28
1657988601089,MATH 10A,A02,083736,Patchell; Gregory David,20,0,30,10
1657988601089,MATH 10A,A03,083737,Patchell; Gregory David,16,0,30,14
1657988607120,MATH 10B,A01,083207,Lim; Seonhee,9,0,34,25
1657988607120,MATH 10B,A02,083208,Lim; Seonhee,10,0,35,25
1657988607120,MATH 10B,A03,093472,Lim; Seonhee,7,0,34,27
1657988607120,MATH 10B,B01,083739,Sinha; Shubham,14,0,30,16
1657988613146,MATH 18,A01,083743,Cinel; Cameron Alexander,9,0,30,21
1657988613146,MATH 18,A02,083744,Cinel; Cameron Alexander,18,0,30,12
1657988613146,MATH 18,A03,083745,Cinel; Cameron Alexander,10,0,30,20
1657988613146,MATH 18,B01,083748,Rideout; David Porter,5,0,37,32
1657988613146,MATH 18,B02,083749,Rideout; David Porter,5,0,36,31
1657988613146,MATH 18,B03,083750,Rideout; David Porter,3,0,37,34
1657988613146,MATH 18,B04,083751,Rideout; David Porter,7,0,36,29
1657988613146,MATH 18,B05,093473,Rideout; David Porter,7,0,36,29
1657988613146,MATH 18,B06,093474,Rideout; David Porter,6,0,36,30
1657988619172,MATH 20A,A01,083754,Zheng; Zequn,14,0,40,26
1657988625197,MATH 20B,A01,083756,Briones; Jor-el Thomas Caparas,4,0,36,32
1657988625197,MATH 20B,A02,083757,Briones; Jor-el Thomas Caparas,1,0,36,35
1657988625197,MATH 20B,A03,093475,Briones; Jor-el Thomas Caparas,3,0,36,33
1657988631225,MATH 20C,A01,083760,Briones; Jor-el Thomas Caparas,1,0,35,34
1657988631225,MATH 20C,A02,083761,Briones; Jor-el Thomas Caparas,8,0,35,27
1657988631225,MATH 20C,A03,093476,Briones; Jor-el Thomas Caparas,0,1,36,36
1657988631225,MATH 20C,B01,083762,Bach; Quang Tran,1,0,30,29
1657988637248,MATH 20D,A01,083765,Tran; Brian Kha,5,0,30,25
1657988637248,MATH 20D,A02,083766,Tran; Brian Kha,5,0,30,25
1657988637248,MATH 20D,A03,083767,Tran; Brian Kha,6,0,30,24
1657988643271,MATH 20E,A01,083771,Ganguly; Soumya,12,0,32,20
1657988643271,MATH 20E,A02,083772,Ganguly; Soumya,7,0,32,25
1657988643271,MATH 20E,B01,083773,Ciotti; Benjamin,20,0,35,15
1657988643271,MATH 20E,B02,083774,Ciotti; Benjamin,18,0,35,17
1657988649296,MATH 103A,A01,083777,Greenfeld; Be'Eri,6,0,36,30
1657988649296,MATH 103A,A02,083778,Greenfeld; Be'Eri,5,0,36,31
1657988649296,MATH 103A,A03,093561,Greenfeld; Be'Eri,7,0,36,29
1657988649296,MATH 103A,B01,083779,Greenfeld; Be'Eri,8,0,36,28
1657988649296,MATH 103A,B02,083780,Greenfeld; Be'Eri,4,0,36,32
1657988649296,MATH 103A,B03,093562,Greenfeld; Be'Eri,3,0,36,33
1657988655324,MATH 105,A01,085443,Carter; Anne Toulson,15,0,35,20
1657988655324,MATH 105,A02,093477,Carter; Anne Toulson,20,0,35,15
1657988661347,MATH 109,A01,083213,Ganzberger; Geoffrey Michael,3,0,34,31
1657988661347,MATH 109,A02,083214,Ganzberger; Geoffrey Michael,4,0,34,30
1657988661347,MATH 109,A03,093478,Ganzberger; Geoffrey Michael,2,0,34,32
1657988661347,MATH 109,B01,083215,Ganzberger; Geoffrey Michael,3,0,32,29
1657988661347,MATH 109,B02,083216,Ganzberger; Geoffrey Michael,3,0,32,29
1657988661347,MATH 109,B03,093479,Ganzberger; Geoffrey Michael,8,0,32,24
1657988667372,MATH 142A,A01,083219,Chow; Bennett,7,0,32,25
1657988667372,MATH 142A,A02,083220,Chow; Bennett,10,0,32,22
1657988667372,MATH 142A,A03,093480,Chow; Bennett,9,0,32,23
1657988667372,MATH 142A,B03,093481,Chow; Bennett,8,0,32,24
1657988667372,MATH 142A,B04,093558,Chow; Bennett,14,0,32,18
1657988667372,MATH 142A,B05,093559,Chow; Bennett,7,0,32,25
1657988673400,MATH 193A,A01,083224,Rotar; Vladimir,9,0,34,25
1657988673400,MATH 193A,A02,083225,Rotar; Vladimir,11,0,34,23
1657988673400,MATH 193A,A03,083781,Rotar; Vladimir,5,0,34,29
1657988673400,MATH 193A,A04,083782,Rotar; Vladimir,12,0,34,22
1657988673400,MATH 193A,A05,093482,Rotar; Vladimir,11,0,34,23
1657988679425,MATH 197,001,091859,McAuley; Julian John,9999,0,9999,0
1657988679425,MATH 197,002,095566,Kedlaya; Kiran S.,9997,0,9999,2
1657988679425,MATH 197,003,095567,Xiao; Ming,9999,0,9999,0
1657988679425,MATH 197,004,095571,Perols; Johan Lars,9998,0,9999,1
1657988686480,COGS 9,A01,083615,Shannon; Kyle Michael,11,0,75,64
1657988692501,COGS 11,A01,083617,Boyle; Mary E. T.,23,0,48,25
1657988698526,COGS 13,A01,083071,Bastos; Amalia Pinkusfeld,12,0,71,59
1657988704550,COGS 14A,A01,092681,Semenuks; Arturs,5,1,100,95
1657988710574,COGS 14B,A01,083073,Cheng; Tzu-Han,7,0,63,56
1657988716599,COGS 17,A01,092677,Semenuks; Arturs,7,0,81,74
1657988722624,COGS 100,A01,083619,Allen; Michael Gordon,17,0,70,53
1657988728646,COGS 101A,A01,083621,Davis; Joshua Daniel,9,0,68,59
1657988734671,COGS 101B,A01,091572,Allen; Michael Gordon,14,0,65,51
1657988740695,COGS 101C,A01,083625,Delgado; Tania,17,0,35,18
1657988746722,COGS 107A,A01,083627,Boyle; Mary E. T.,14,0,60,46
1657988752754,COGS 118A,A01,083075,Gupta; Anjum,21,0,76,55
1657988758781,CSE 3,A50,083646,Miranda; Gregory Joseph,24,0,50,26
1657988764811,CSE 8A,A50,083650,Miranda; Gregory Joseph,17,1,56,39
1657988770834,CSE 11,A01,083080,Cao; Yingjun,7,15,40,33
1657988776856,CSE 12,A01,083652,Krause-Levy; Sophia Louisa,30,1,120,90
1657988782882,CSE 15L,A01,083654,Morris; Justin Loren,9,0,50,41
1657988782882,CSE 15L,A02,083655,Morris; Justin Loren,11,0,50,39
1657988788908,CSE 20,A01,083657,Tran; Khoa Dang,39,0,80,41
1657988794932,CSE 21,A01,095574,Bach; Quang Tran,23,0,48,25
1657988800958,CSE 30,A01,083084,Eldon; John,8,0,80,72
1657988800958,CSE 30,B01,095061,Bhaskar; Nishant,9,0,50,41
1657988806982,CSE 100,A01,083659,Cao; Yingjun,5,4,70,65
1657988813004,CSE 134B,A01,083661,Powell; Thomas Allan,25,0,100,75
1657988819032,CSE 140,A01,083663,Gungor; Onat,17,0,85,68
1657988825053,CSE 140L,A01,083088,Eldon; John,23,0,100,77
1657988831080,CSE 175,A01,083665,Kumar; Rakesh,3,0,25,22
1657988837109,CSE 190,A00,092507,Dubnov; Shlomo,8,0,20,12
1657988843133,ECE 45,A01,083139,Congero; Spencer William,7,0,75,68
1657988849156,ECE 65,A50,083695,Saad; Andrew S,12,0,30,18
1657988849156,ECE 65,A51,095125,Saad; Andrew S,24,0,26,2
1657988855184,ECE 109,A01,091882,Touri; Behrouz,21,0,70,49
1657988861207,ECE 180,A00,083140,Abi Samra; Nicholas Camill,1,0,30,29
1657988861207,ECE 180,B00,083141,Abi Samra; Nicholas Camill,0,0,30,30
1657988867231,MATH 10A,A01,083735,Patchell; Gregory David,2,0,30,28
1657988867231,MATH 10A,A02,083736,Patchell; Gregory David,20,0,30,10
1657988867231,MATH 10A,A03,083737,Patchell; Gregory David,16,0,30,14
1657988873256,MATH 10B,A01,083207,Lim; Seonhee,9,0,34,25
1657988873256,MATH 10B,A02,083208,Lim; Seonhee,10,0,35,25
1657988873256,MATH 10B,A03,093472,Lim; Seonhee,7,0,34,27
1657988873256,MATH 10B,B01,083739,Sinha; Shubham,14,0,30,16
1657988879281,MATH 18,A01,083743,Cinel; Cameron Alexander,9,0,30,21
1657988879281,MATH 18,A02,083744,Cinel; Cameron Alexander,18,0,30,12
1657988879281,MATH 18,A03,083745,Cinel; Cameron Alexander,10,0,30,20
1657988879281,MATH 18,B01,083748,Rideout; David Porter,5,0,37,32
1657988879281,MATH 18,B02,083749,Rideout; David Porter,5,0,36,31
1657988879281,MATH 18,B03,083750,Rideout; David Porter,3,0,37,34
1657988879281,MATH 18,B04,083751,Rideout; David Porter,7,0,36,29
1657988879281,MATH 18,B05,093473,Rideout; David Porter,7,0,36,29
1657988879281,MATH 18,B06,093474,Rideout; David Porter,6,0,36,30
1657988885306,MATH 20A,A01,083754,Zheng; Zequn,14,0,40,26
1657988891336,MATH 20B,A01,083756,Briones; Jor-el Thomas Caparas,4,0,36,32
1657988891336,MATH 20B,A02,083757,Briones; Jor-el Thomas Caparas,1,0,36,35
1657988891336,MATH 20B,A03,093475,Briones; Jor-el Thomas Caparas,3,0,36,33
1657988897364,MATH 20C,A01,083760,Briones; Jor-el Thomas Caparas,1,0,35,34
1657988897364,MATH 20C,A02,083761,Briones; Jor-el Thomas Caparas,8,0,35,27
1657988897364,MATH 20C,A03,093476,Briones; Jor-el Thomas Caparas,0,1,36,36
1657988897364,MATH 20C,B01,083762,Bach; Quang Tran,1,0,30,29
1657988903391,MATH 20D,A01,083765,Tran; Brian Kha,5,0,30,25
1657988903391,MATH 20D,A02,083766,Tran; Brian Kha,5,0,30,25
1657988903391,MATH 20D,A03,083767,Tran; Brian Kha,6,0,30,24
1657988909419,MATH 20E,A01,083771,Ganguly; Soumya,12,0,32,20
1657988909419,MATH 20E,A02,083772,Ganguly; Soumya,7,0,32,25
1657988909419,MATH 20E,B01,083773,Ciotti; Benjamin,20,0,35,15
1657988909419,MATH 20E,B02,083774,Ciotti; Benjamin,18,0,35,17
1657988915455,MATH 103A,A01,083777,Greenfeld; Be'Eri,6,0,36,30
1657988915455,MATH 103A,A02,083778,Greenfeld; Be'Eri,5,0,36,31
1657988915455,MATH 103A,A03,093561,Greenfeld; Be'Eri,7,0,36,29
1657988915455,MATH 103A,B01,083779,Greenfeld; Be'Eri,8,0,36,28
1657988915455,MATH 103A,B02,083780,Greenfeld; Be'Eri,4,0,36,32
1657988915455,MATH 103A,B03,093562,Greenfeld; Be'Eri,3,0,36,33
1657988921478,MATH 105,A01,085443,Carter; Anne Toulson,15,0,35,20
1657988921478,MATH 105,A02,093477,Carter; Anne Toulson,20,0,35,15
1657988927504,MATH 109,A01,083213,Ganzberger; Geoffrey Michael,3,0,34,31
1657988927504,MATH 109,A02,083214,Ganzberger; Geoffrey Michael,4,0,34,30
1657988927504,MATH 109,A03,093478,Ganzberger; Geoffrey Michael,2,0,34,32
1657988927504,MATH 109,B01,083215,Ganzberger; Geoffrey Michael,3,0,32,29
1657988927504,MATH 109,B02,083216,Ganzberger; Geoffrey Michael,3,0,32,29
1657988927504,MATH 109,B03,093479,Ganzberger; Geoffrey Michael,8,0,32,24
1657988933530,MATH 142A,A01,083219,Chow; Bennett,7,0,32,25
1657988933530,MATH 142A,A02,083220,Chow; Bennett,10,0,32,22
1657988933530,MATH 142A,A03,093480,Chow; Bennett,9,0,32,23
1657988933530,MATH 142A,B03,093481,Chow; Bennett,8,0,32,24
1657988933530,MATH 142A,B04,093558,Chow; Bennett,14,0,32,18
1657988933530,MATH 142A,B05,093559,Chow; Bennett,7,0,32,25
1657988939560,MATH 193A,A01,083224,Rotar; Vladimir,9,0,34,25
1657988939560,MATH 193A,A02,083225,Rotar; Vladimir,11,0,34,23
1657988939560,MATH 193A,A03,083781,Rotar; Vladimir,5,0,34,29
1657988939560,MATH 193A,A04,083782,Rotar; Vladimir,12,0,34,22
1657988939560,MATH 193A,A05,093482,Rotar; Vladimir,11,0,34,23
1657988945587,MATH 197,001,091859,McAuley; Julian John,9999,0,9999,0
1657988945587,MATH 197,002,095566,Kedlaya; Kiran S.,9997,0,9999,2
1657988945587,MATH 197,003,095567,Xiao; Ming,9999,0,9999,0
1657988945587,MATH 197,004,095571,Perols; Johan Lars,9998,0,9999,1
1657988952646,COGS 9,A01,083615,Shannon; Kyle Michael,11,0,75,64
1657988958668,COGS 11,A01,083617,Boyle; Mary E. T.,23,0,48,25
1657988964695,COGS 13,A01,083071,Bastos; Amalia Pinkusfeld,12,0,71,59
1657988970722,COGS 14A,A01,092681,Semenuks; Arturs,5,1,100,95
1657988976746,COGS 14B,A01,083073,Cheng; Tzu-Han,7,0,63,56
1657988982772,COGS 17,A01,092677,Semenuks; Arturs,7,0,81,74
1657988988793,COGS 100,A01,083619,Allen; Michael Gordon,17,0,70,53
1657988994822,COGS 101A,A01,083621,Davis; Joshua Daniel,9,0,68,59
1657989000848,COGS 101B,A01,091572,Allen; Michael Gordon,14,0,65,51
1657989006870,COGS 101C,A01,083625,Delgado; Tania,17,0,35,18
1657989012893,COGS 107A,A01,083627,Boyle; Mary E. T.,14,0,60,46
1657989018916,COGS 118A,A01,083075,Gupta; Anjum,21,0,76,55
1657989024945,CSE 3,A50,083646,Miranda; Gregory Joseph,24,0,50,26
1657989030972,CSE 8A,A50,083650,Miranda; Gregory Joseph,17,1,56,39
1657989036993,CSE 11,A01,083080,Cao; Yingjun,7,15,40,33
1657989043017,CSE 12,A01,083652,Krause-Levy; Sophia Louisa,30,1,120,90
1657989049046,CSE 15L,A01,083654,Morris; Justin Loren,9,0,50,41
1657989049046,CSE 15L,A02,083655,Morris; Justin Loren,11,0,50,39
1657989055069,CSE 20,A01,083657,Tran; Khoa Dang,39,0,80,41
1657989061093,CSE 21,A01,095574,Bach; Quang Tran,23,0,48,25
1657989067129,CSE 30,A01,083084,Eldon; John,8,0,80,72
1657989067129,CSE 30,B01,095061,Bhaskar; Nishant,9,0,50,41
1657989073155,CSE 100,A01,083659,Cao; Yingjun,5,4,70,65
1657989079178,CSE 134B,A01,083661,Powell; Thomas Allan,25,0,100,75
1657989085286,CSE 140,A01,083663,Gungor; Onat,17,0,85,68
1657989091313,CSE 140L,A01,083088,Eldon; John,23,0,100,77
1657989097341,CSE 175,A01,083665,Kumar; Rakesh,3,0,25,22
1657989103369,CSE 190,A00,092507,Dubnov; Shlomo,8,0,20,12
1657989109404,ECE 45,A01,083139,Congero; Spencer William,7,0,75,68
1657989115428,ECE 65,A50,083695,Saad; Andrew S,12,0,30,18
1657989115428,ECE 65,A51,095125,Saad; Andrew S,24,0,26,2
1657989121457,ECE 109,A01,091882,Touri; Behrouz,21,0,70,49
1657989127481,ECE 180,A00,083140,Abi Samra; Nicholas Camill,1,0,30,29
1657989127481,ECE 180,B00,083141,Abi Samra; Nicholas Camill,0,0,30,30
1657989133504,MATH 10A,A01,083735,Patchell; Gregory David,2,0,30,28
1657989133504,MATH 10A,A02,083736,Patchell; Gregory David,20,0,30,10
1657989133504,MATH 10A,A03,083737,Patchell; Gregory David,16,0,30,14
1657989139538,MATH 10B,A01,083207,Lim; Seonhee,9,0,34,25
1657989139538,MATH 10B,A02,083208,Lim; Seonhee,10,0,35,25
1657989139538,MATH 10B,A03,093472,Lim; Seonhee,7,0,34,27
1657989139538,MATH 10B,B01,083739,Sinha; Shubham,14,0,30,16
1657989145564,MATH 18,A01,083743,Cinel; Cameron Alexander,9,0,30,21
1657989145564,MATH 18,A02,083744,Cinel; Cameron Alexander,18,0,30,12
1657989145564,MATH 18,A03,083745,Cinel; Cameron Alexander,10,0,30,20
1657989145564,MATH 18,B01,083748,Rideout; David Porter,5,0,37,32
1657989145564,MATH 18,B02,083749,Rideout; David Porter,5,0,36,31
1657989145564,MATH 18,B03,083750,Rideout; David Porter,3,0,37,34
1657989145564,MATH 18,B04,083751,Rideout; David Porter,7,0,36,29
1657989145564,MATH 18,B05,093473,Rideout; David Porter,7,0,36,29
1657989145564,MATH 18,B06,093474,Rideout; David Porter,6,0,36,30
1657989151586,MATH 20A,A01,083754,Zheng; Zequn,14,0,40,26
1657989157615,MATH 20B,A01,083756,Briones; Jor-el Thomas Caparas,4,0,36,32
1657989157615,MATH 20B,A02,083757,Briones; Jor-el Thomas Caparas,1,0,36,35
1657989157615,MATH 20B,A03,093475,Briones; Jor-el Thomas Caparas,3,0,36,33
1657989163643,MATH 20C,A01,083760,Briones; Jor-el Thomas Caparas,1,0,35,34
1657989163643,MATH 20C,A02,083761,Briones; Jor-el Thomas Caparas,8,0,35,27
1657989163643,MATH 20C,A03,093476,Briones; Jor-el Thomas Caparas,0,1,36,36
1657989163643,MATH 20C,B01,083762,Bach; Quang Tran,1,0,30,29
1657989169677,MATH 20D,A01,083765,Tran; Brian Kha,5,0,30,25
1657989169677,MATH 20D,A02,083766,Tran; Brian Kha,5,0,30,25
1657989169677,MATH 20D,A03,083767,Tran; Brian Kha,6,0,30,24
1657989175711,MATH 20E,A01,083771,Ganguly; Soumya,12,0,32,20
1657989175711,MATH 20E,A02,083772,Ganguly; Soumya,7,0,32,25
1657989175711,MATH 20E,B01,083773,Ciotti; Benjamin,20,0,35,15
1657989175711,MATH 20E,B02,083774,Ciotti; Benjamin,18,0,35,17
1657989181745,MATH 103A,A01,083777,Greenfeld; Be'Eri,6,0,36,30
1657989181745,MATH 103A,A02,083778,Greenfeld; Be'Eri,5,0,36,31
1657989181745,MATH 103A,A03,093561,Greenfeld; Be'Eri,7,0,36,29
1657989181745,MATH 103A,B01,083779,Greenfeld; Be'Eri,8,0,36,28
1657989181745,MATH 103A,B02,083780,Greenfeld; Be'Eri,4,0,36,32
1657989181745,MATH 103A,B03,093562,Greenfeld; Be'Eri,3,0,36,33
1657989187772,MATH 105,A01,085443,Carter; Anne Toulson,15,0,35,20
1657989187772,MATH 105,A02,093477,Carter; Anne Toulson,20,0,35,15
1657989193801,MATH 109,A01,083213,Ganzberger; Geoffrey Michael,3,0,34,31
1657989193801,MATH 109,A02,083214,Ganzberger; Geoffrey Michael,4,0,34,30
1657989193801,MATH 109,A03,093478,Ganzberger; Geoffrey Michael,2,0,34,32
1657989193801,MATH 109,B01,083215,Ganzberger; Geoffrey Michael,3,0,32,29
1657989193801,MATH 109,B02,083216,Ganzberger; Geoffrey Michael,3,0,32,29
1657989193801,MATH 109,B03,093479,Ganzberger; Geoffrey Michael,8,0,32,24
1657989199825,MATH 142A,A01,083219,Chow; Bennett,7,0,32,25
1657989199825,MATH 142A,A02,083220,Chow; Bennett,10,0,32,22
1657989199825,MATH 142A,A03,093480,Chow; Bennett,9,0,32,23
1657989199825,MATH 142A,B03,093481,Chow; Bennett,8,0,32,24
1657989199825,MATH 142A,B04,093558,Chow; Bennett,14,0,32,18
1657989199825,MATH 142A,B05,093559,Chow; Bennett,7,0,32,25
1657989205864,MATH 193A,A01,083224,Rotar; Vladimir,9,0,34,25
1657989205864,MATH 193A,A02,083225,Rotar; Vladimir,11,0,34,23
1657989205864,MATH 193A,A03,083781,Rotar; Vladimir,5,0,34,29
1657989205864,MATH 193A,A04,083782,Rotar; Vladimir,12,0,34,22
1657989205864,MATH 193A,A05,093482,Rotar; Vladimir,11,0,34,23
1657989211890,MATH 197,001,091859,McAuley; Julian John,9999,0,9999,0
1657989211890,MATH 197,002,095566,Kedlaya; Kiran S.,9997,0,9999,2
1657989211890,MATH 197,003,095567,Xiao; Ming,9999,0,9999,0
1657989211890,MATH 197,004,095571,Perols; Johan Lars,9998,0,9999,1
1657989218955,COGS 9,A01,083615,Shannon; Kyle Michael,11,0,75,64
1657989224980,COGS 11,A01,083617,Boyle; Mary E. T.,23,0,48,25
1657989231014,COGS 13,A01,083071,Bastos; Amalia Pinkusfeld,12,0,71,59
1657989237035,COGS 14A,A01,092681,Semenuks; Arturs,5,1,100,95
1657989243059,COGS 14B,A01,083073,Cheng; Tzu-Han,7,0,63,56
1657989249086,COGS 17,A01,092677,Semenuks; Arturs,7,0,81,74
1657989255114,COGS 100,A01,083619,Allen; Michael Gordon,17,0,70,53
1657989261143,COGS 101A,A01,083621,Davis; Joshua Daniel,9,0,68,59
1657989267170,COGS 101B,A01,091572,Allen; Michael Gordon,14,0,65,51
1657989273198,COGS 101C,A01,083625,Delgado; Tania,17,0,35,18
1657989279225,COGS 107A,A01,083627,Boyle; Mary E. T.,14,0,60,46
1657989285251,COGS 118A,A01,083075,Gupta; Anjum,21,0,76,55
1657989291285,CSE 3,A50,083646,Miranda; Gregory Joseph,24,0,50,26
1657989297311,CSE 8A,A50,083650,Miranda; Gregory Joseph,17,1,56,39
1657989303334,CSE 11,A01,083080,Cao; Yingjun,7,15,40,33
1657989309363,CSE 12,A01,083652,Krause-Levy; Sophia Louisa,30,1,120,90
1657989315387,CSE 15L,A01,083654,Morris; Justin Loren,9,0,50,41
1657989315387,CSE 15L,A02,083655,Morris; Justin Loren,11,0,50,39
1657989321409,CSE 20,A01,083657,Tran; Khoa Dang,39,0,80,41
1657989327441,CSE 21,A01,095574,Bach; Quang Tran,23,0,48,25
1657989333466,CSE 30,A01,083084,Eldon; John,8,0,80,72
1657989333466,CSE 30,B01,095061,Bhaskar; Nishant,9,0,50,41
1657989339490,CSE 100,A01,083659,Cao; Yingjun,5,4,70,65
1657989345516,CSE 134B,A01,083661,Powell; Thomas Allan,25,0,100,75
1657989351541,CSE 140,A01,083663,Gungor; Onat,17,0,85,68
1657989357565,CSE 140L,A01,083088,Eldon; John,23,0,100,77
1657989363589,CSE 175,A01,083665,Kumar; Rakesh,3,0,25,22
1657989369613,CSE 190,A00,092507,Dubnov; Shlomo,8,0,20,12
1657989375635,ECE 45,A01,083139,Congero; Spencer William,7,0,75,68
1657989381665,ECE 65,A50,083695,Saad; Andrew S,12,0,30,18
1657989381665,ECE 65,A51,095125,Saad; Andrew S,24,0,26,2
1657989387689,ECE 109,A01,091882,Touri; Behrouz,21,0,70,49
1657989393718,ECE 180,A00,083140,Abi Samra; Nicholas Camill,1,0,30,29
1657989393718,ECE 180,B00,083141,Abi Samra; Nicholas Camill,0,0,30,30
1657989399744,MATH 10A,A01,083735,Patchell; Gregory David,2,0,30,28
1657989399744,MATH 10A,A02,083736,Patchell; Gregory David,20,0,30,10
1657989399744,MATH 10A,A03,083737,Patchell; Gregory David,16,0,30,14
1657989405775,MATH 10B,A01,083207,Lim; Seonhee,9,0,34,25
1657989405775,MATH 10B,A02,083208,Lim; Seonhee,10,0,35,25
1657989405775,MATH 10B,A03,093472,Lim; Seonhee,7,0,34,27
1657989405775,MATH 10B,B01,083739,Sinha; Shubham,14,0,30,16
1657989411807,MATH 18,A01,083743,Cinel; Cameron Alexander,9,0,30,21
1657989411807,MATH 18,A02,083744,Cinel; Cameron Alexander,18,0,30,12
1657989411807,MATH 18,A03,083745,Cinel; Cameron Alexander,10,0,30,20
1657989411807,MATH 18,B01,083748,Rideout; David Porter,5,0,37,32
1657989411807,MATH 18,B02,083749,Rideout; David Porter,5,0,36,31
1657989411807,MATH 18,B03,083750,Rideout; David Porter,3,0,37,34
1657989411807,MATH 18,B04,083751,Rideout; David Porter,7,0,36,29
1657989411807,MATH 18,B05,093473,Rideout; David Porter,7,0,36,29
1657989411807,MATH 18,B06,093474,Rideout; David Porter,6,0,36,30
1657989417834,MATH 20A,A01,083754,Zheng; Zequn,14,0,40,26
1657989423864,MATH 20B,A01,083756,Briones; Jor-el Thomas Caparas,4,0,36,32
1657989423864,MATH 20B,A02,083757,Briones; Jor-el Thomas Caparas,1,0,36,35
1657989423864,MATH 20B,A03,093475,Briones; Jor-el Thomas Caparas,3,0,36,33
1657989429889,MATH 20C,A01,083760,Briones; Jor-el Thomas Caparas,1,0,35,34
1657989429889,MATH 20C,A02,083761,Briones; Jor-el Thomas Caparas,8,0,35,27
1657989429889,MATH 20C,A03,093476,Briones; Jor-el Thomas Caparas,0,1,36,36
1657989429889,MATH 20C,B01,083762,Bach; Quang Tran,1,0,30,29
1657989435913,MATH 20D,A01,083765,Tran; Brian Kha,5,0,30,25
1657989435913,MATH 20D,A02,083766,Tran; Brian Kha,5,0,30,25
1657989435913,MATH 20D,A03,083767,Tran; Brian Kha,6,0,30,24
1657989441945,MATH 20E,A01,083771,Ganguly; Soumya,12,0,32,20
1657989441945,MATH 20E,A02,083772,Ganguly; Soumya,7,0,32,25
1657989441945,MATH 20E,B01,083773,Ciotti; Benjamin,20,0,35,15
1657989441945,MATH 20E,B02,083774,Ciotti; Benjamin,18,0,35,17
1657989447973,MATH 103A,A01,083777,Greenfeld; Be'Eri,6,0,36,30
1657989447973,MATH 103A,A02,083778,Greenfeld; Be'Eri,5,0,36,31
1657989447973,MATH 103A,A03,093561,Greenfeld; Be'Eri,7,0,36,29
1657989447973,MATH 103A,B01,083779,Greenfeld; Be'Eri,8,0,36,28
1657989447973,MATH 103A,B02,083780,Greenfeld; Be'Eri,4,0,36,32
1657989447973,MATH 103A,B03,093562,Greenfeld; Be'Eri,3,0,36,33
1657989453996,MATH 105,A01,085443,Carter; Anne Toulson,15,0,35,20
1657989453996,MATH 105,A02,093477,Carter; Anne Toulson,20,0,35,15
1657989460020,MATH 109,A01,083213,Ganzberger; Geoffrey Michael,3,0,34,31
1657989460020,MATH 109,A02,083214,Ganzberger; Geoffrey Michael,4,0,34,30
1657989460020,MATH 109,A03,093478,Ganzberger; Geoffrey Michael,2,0,34,32
1657989460020,MATH 109,B01,083215,Ganzberger; Geoffrey Michael,3,0,32,29
1657989460020,MATH 109,B02,083216,Ganzberger; Geoffrey Michael,3,0,32,29
1657989460020,MATH 109,B03,093479,Ganzberger; Geoffrey Michael,8,0,32,24
1657989466044,MATH 142A,A01,083219,Chow; Bennett,7,0,32,25
1657989466044,MATH 142A,A02,083220,Chow; Bennett,10,0,32,22
1657989466044,MATH 142A,A03,093480,Chow; Bennett,9,0,32,23
1657989466044,MATH 142A,B03,093481,Chow; Bennett,8,0,32,24
1657989466044,MATH 142A,B04,093558,Chow; Bennett,14,0,32,18
1657989466044,MATH 142A,B05,093559,Chow; Bennett,7,0,32,25
1657989472073,MATH 193A,A01,083224,Rotar; Vladimir,9,0,34,25
1657989472073,MATH 193A,A02,083225,Rotar; Vladimir,11,0,34,23
1657989472073,MATH 193A,A03,083781,Rotar; Vladimir,5,0,34,29
1657989472073,MATH 193A,A04,083782,Rotar; Vladimir,12,0,34,22
1657989472073,MATH 193A,A05,093482,Rotar; Vladimir,11,0,34,23
1657989478099,MATH 197,001,091859,McAuley; Julian John,9999,0,9999,0
1657989478099,MATH 197,002,095566,Kedlaya; Kiran S.,9997,0,9999,2
1657989478099,MATH 197,003,095567,Xiao; Ming,9999,0,9999,0
1657989478099,MATH 197,004,095571,Perols; Johan Lars,9998,0,9999,1
1657989485157,COGS 9,A01,083615,Shannon; Kyle Michael,11,0,75,64
1657989491182,COGS 11,A01,083617,Boyle; Mary E. T.,23,0,48,25
1657989497207,COGS 13,A01,083071,Bastos; Amalia Pinkusfeld,12,0,71,59
1657989503232,COGS 14A,A01,092681,Semenuks; Arturs,5,1,100,95
1657989509256,COGS 14B,A01,083073,Cheng; Tzu-Han,7,0,63,56
1657989515290,COGS 17,A01,092677,Semenuks; Arturs,7,0,81,74
1657989521319,COGS 100,A01,083619,Allen; Michael Gordon,17,0,70,53
1657989527342,COGS 101A,A01,083621,Davis; Joshua Daniel,9,0,68,59
1657989533365,COGS 101B,A01,091572,Allen; Michael Gordon,14,0,65,51
1657989539392,COGS 101C,A01,083625,Delgado; Tania,17,0,35,18
1657989545421,COGS 107A,A01,083627,Boyle; Mary E. T.,14,0,60,46
1657989551444,COGS 118A,A01,083075,Gupta; Anjum,21,0,76,55
1657989557471,CSE 3,A50,083646,Miranda; Gregory Joseph,24,0,50,26
1657989563495,CSE 8A,A50,083650,Miranda; Gregory Joseph,17,1,56,39
1657989569519,CSE 11,A01,083080,Cao; Yingjun,7,15,40,33
1657989575543,CSE 12,A01,083652,Krause-Levy; Sophia Louisa,30,1,120,90
1657989581568,CSE 15L,A01,083654,Morris; Justin Loren,9,0,50,41
1657989581568,CSE 15L,A02,083655,Morris; Justin Loren,11,0,50,39
1657989587595,CSE 20,A01,083657,Tran; Khoa Dang,39,0,80,41
1657989593621,CSE 21,A01,095574,Bach; Quang Tran,23,0,48,25
1657989599653,CSE 30,A01,083084,Eldon; John,8,0,80,72
1657989599653,CSE 30,B01,095061,Bhaskar; Nishant,9,0,50,41
1657989605681,CSE 100,A01,083659,Cao; Yingjun,5,4,70,65
1657989611703,CSE 134B,A01,083661,Powell; Thomas Allan,25,0,100,75
1657989617736,CSE 140,A01,083663,Gungor; Onat,17,0,85,68
1657989623759,CSE 140L,A01,083088,Eldon; John,23,0,100,77
1657989629784,CSE 175,A01,083665,Kumar; Rakesh,3,0,25,22
1657989635807,CSE 190,A00,092507,Dubnov; Shlomo,8,0,20,12
1657989641832,ECE 45,A01,083139,Congero; Spencer William,7,0,75,68
1657989647856,ECE 65,A50,083695,Saad; Andrew S,12,0,30,18
1657989647856,ECE 65,A51,095125,Saad; Andrew S,24,0,26,2
1657989653884,ECE 109,A01,091882,Touri; Behrouz,21,0,70,49
1657989659907,ECE 180,A00,083140,Abi Samra; Nicholas Camill,1,0,30,29
1657989659907,ECE 180,B00,083141,Abi Samra; Nicholas Camill,0,0,30,30
1657989665937,MATH 10A,A01,083735,Patchell; Gregory David,2,0,30,28
1657989665937,MATH 10A,A02,083736,Patchell; Gregory David,20,0,30,10
1657989665937,MATH 10A,A03,083737,Patchell; Gregory David,16,0,30,14
1657989671967,MATH 10B,A01,083207,Lim; Seonhee,9,0,34,25
1657989671967,MATH 10B,A02,083208,Lim; Seonhee,10,0,35,25
1657989671967,MATH 10B,A03,093472,Lim; Seonhee,7,0,34,27
1657989671967,MATH 10B,B01,083739,Sinha; Shubham,14,0,30,16
1657989677992,MATH 18,A01,083743,Cinel; Cameron Alexander,9,0,30,21
1657989677992,MATH 18,A02,083744,Cinel; Cameron Alexander,18,0,30,12
1657989677992,MATH 18,A03,083745,Cinel; Cameron Alexander,10,0,30,20
1657989677992,MATH 18,B01,083748,Rideout; David Porter,5,0,37,32
1657989677992,MATH 18,B02,083749,Rideout; David Porter,5,0,36,31
1657989677992,MATH 18,B03,083750,Rideout; David Porter,3,0,37,34
1657989677992,MATH 18,B04,083751,Rideout; David Porter,7,0,36,29
1657989677992,MATH 18,B05,093473,Rideout; David Porter,7,0,36,29
1657989677992,MATH 18,B06,093474,Rideout; David Porter,6,0,36,30
1657989684101,MATH 20A,A01,083754,Zheng; Zequn,14,0,40,26
1657989690125,MATH 20B,A01,083756,Briones; Jor-el Thomas Caparas,4,0,36,32
1657989690125,MATH 20B,A02,083757,Briones; Jor-el Thomas Caparas,1,0,36,35
1657989690125,MATH 20B,A03,093475,Briones; Jor-el Thomas Caparas,3,0,36,33
1657989696155,MATH 20C,A01,083760,Briones; Jor-el Thomas Caparas,1,0,35,34
1657989696155,MATH 20C,A02,083761,Briones; Jor-el Thomas Caparas,8,0,35,27
1657989696155,MATH 20C,A03,093476,Briones; Jor-el Thomas Caparas,0,1,36,36
1657989696155,MATH 20C,B01,083762,Bach; Quang Tran,1,0,30,29
1657989702180,MATH 20D,A01,083765,Tran; Brian Kha,5,0,30,25
1657989702180,MATH 20D,A02,083766,Tran; Brian Kha,5,0,30,25
1657989702180,MATH 20D,A03,083767,Tran; Brian Kha,6,0,30,24
1657989708209,MATH 20E,A01,083771,Ganguly; Soumya,12,0,32,20
1657989708209,MATH 20E,A02,083772,Ganguly; Soumya,7,0,32,25
1657989708209,MATH 20E,B01,083773,Ciotti; Benjamin,20,0,35,15
1657989708209,MATH 20E,B02,083774,Ciotti; Benjamin,18,0,35,17
1657989714241,MATH 103A,A01,083777,Greenfeld; Be'Eri,6,0,36,30
1657989714241,MATH 103A,A02,083778,Greenfeld; Be'Eri,5,0,36,31
1657989714241,MATH 103A,A03,093561,Greenfeld; Be'Eri,7,0,36,29
1657989714241,MATH 103A,B01,083779,Greenfeld; Be'Eri,8,0,36,28
1657989714241,MATH 103A,B02,083780,Greenfeld; Be'Eri,4,0,36,32
1657989714241,MATH 103A,B03,093562,Greenfeld; Be'Eri,3,0,36,33
1657989720274,MATH 105,A01,085443,Carter; Anne Toulson,15,0,35,20
1657989720274,MATH 105,A02,093477,Carter; Anne Toulson,20,0,35,15
1657989726298,MATH 109,A01,083213,Ganzberger; Geoffrey Michael,3,0,34,31
1657989726298,MATH 109,A02,083214,Ganzberger; Geoffrey Michael,4,0,34,30
1657989726298,MATH 109,A03,093478,Ganzberger; Geoffrey Michael,2,0,34,32
1657989726298,MATH 109,B01,083215,Ganzberger; Geoffrey Michael,3,0,32,29
1657989726298,MATH 109,B02,083216,Ganzberger; Geoffrey Michael,3,0,32,29
1657989726298,MATH 109,B03,093479,Ganzberger; Geoffrey Michael,8,0,32,24
1657989732328,MATH 142A,A01,083219,Chow; Bennett,7,0,32,25
1657989732328,MATH 142A,A02,083220,Chow; Bennett,10,0,32,22
1657989732328,MATH 142A,A03,093480,Chow; Bennett,9,0,32,23
1657989732328,MATH 142A,B03,093481,Chow; Bennett,8,0,32,24
1657989732328,MATH 142A,B04,093558,Chow; Bennett,14,0,32,18
1657989732328,MATH 142A,B05,093559,Chow; Bennett,7,0,32,25
1657989738353,MATH 193A,A01,083224,Rotar; Vladimir,9,0,34,25
1657989738353,MATH 193A,A02,083225,Rotar; Vladimir,11,0,34,23
1657989738353,MATH 193A,A03,083781,Rotar; Vladimir,5,0,34,29
1657989738353,MATH 193A,A04,083782,Rotar; Vladimir,12,0,34,22
1657989738353,MATH 193A,A05,093482,Rotar; Vladimir,11,0,34,23
1657989744393,MATH 197,001,091859,McAuley; Julian John,9999,0,9999,0
1657989744393,MATH 197,002,095566,Kedlaya; Kiran S.,9997,0,9999,2
1657989744393,MATH 197,003,095567,Xiao; Ming,9999,0,9999,0
1657989744393,MATH 197,004,095571,Perols; Johan Lars,9998,0,9999,1
1657989751454,COGS 9,A01,083615,Shannon; Kyle Michael,11,0,75,64
1657989757480,COGS 11,A01,083617,Boyle; Mary E. T.,23,0,48,25
1657989763506,COGS 13,A01,083071,Bastos; Amalia Pinkusfeld,12,0,71,59
1657989769533,COGS 14A,A01,092681,Semenuks; Arturs,5,1,100,95
1657989775559,COGS 14B,A01,083073,Cheng; Tzu-Han,7,0,63,56
1657989781581,COGS 17,A01,092677,Semenuks; Arturs,7,0,81,74
1657989787608,COGS 100,A01,083619,Allen; Michael Gordon,17,0,70,53
1657989793633,COGS 101A,A01,083621,Davis; Joshua Daniel,9,0,68,59
1657989799662,COGS 101B,A01,091572,Allen; Michael Gordon,14,0,65,51
1657989805687,COGS 101C,A01,083625,Delgado; Tania,17,0,35,18
1657989811712,COGS 107A,A01,083627,Boyle; Mary E. T.,14,0,60,46
1657989817735,COGS 118A,A01,083075,Gupta; Anjum,21,0,76,55
1657989823762,CSE 3,A50,083646,Miranda; Gregory Joseph,24,0,50,26
1657989829794,CSE 8A,A50,083650,Miranda; Gregory Joseph,17,1,56,39
1657989835817,CSE 11,A01,083080,Cao; Yingjun,7,15,40,33
1657989841841,CSE 12,A01,083652,Krause-Levy; Sophia Louisa,30,1,120,90
1657989847864,CSE 15L,A01,083654,Morris; Justin Loren,9,0,50,41
1657989847864,CSE 15L,A02,083655,Morris; Justin Loren,11,0,50,39
1657989853903,CSE 20,A01,083657,Tran; Khoa Dang,39,0,80,41
1657989859927,CSE 21,A01,095574,Bach; Quang Tran,23,0,48,25
1657989865956,CSE 30,A01,083084,Eldon; John,8,0,80,72
1657989865956,CSE 30,B01,095061,Bhaskar; Nishant,9,0,50,41
1657989871993,CSE 100,A01,083659,Cao; Yingjun,5,4,70,65
1657989878020,CSE 134B,A01,083661,Powell; Thomas Allan,25,0,100,75
1657989884043,CSE 140,A01,083663,Gungor; Onat,17,0,85,68
1657989890071,CSE 140L,A01,083088,Eldon; John,23,0,100,77
1657989896098,CSE 175,A01,083665,Kumar; Rakesh,3,0,25,22
1657989902122,CSE 190,A00,092507,Dubnov; Shlomo,8,0,20,12
1657989908149,ECE 45,A01,083139,Congero; Spencer William,7,0,75,68
1657989914173,ECE 65,A50,083695,Saad; Andrew S,12,0,30,18
1657989914173,ECE 65,A51,095125,Saad; Andrew S,24,0,26,2
1657989920201,ECE 109,A01,091882,Touri; Behrouz,21,0,70,49
1657989926228,ECE 180,A00,083140,Abi Samra; Nicholas Camill,1,0,30,29
1657989926228,ECE 180,B00,083141,Abi Samra; Nicholas Camill,0,0,30,30
1657989932254,MATH 10A,A01,083735,Patchell; Gregory David,2,0,30,28
1657989932254,MATH 10A,A02,083736,Patchell; Gregory David,20,0,30,10
1657989932254,MATH 10A,A03,083737,Patchell; Gregory David,16,0,30,14
1657989938280,MATH 10B,A01,083207,Lim; Seonhee,9,0,34,25
1657989938280,MATH 10B,A02,083208,Lim; Seonhee,10,0,35,25
1657989938280,MATH 10B,A03,093472,Lim; Seonhee,7,0,34,27
1657989938280,MATH 10B,B01,083739,Sinha; Shubham,14,0,30,16
1657989944306,MATH 18,A01,083743,Cinel; Cameron Alexander,9,0,30,21
1657989944306,MATH 18,A02,083744,Cinel; Cameron Alexander,18,0,30,12
1657989944306,MATH 18,A03,083745,Cinel; Cameron Alexander,10,0,30,20
1657989944306,MATH 18,B01,083748,Rideout; David Porter,5,0,37,32
1657989944306,MATH 18,B02,083749,Rideout; David Porter,5,0,36,31
1657989944306,MATH 18,B03,083750,Rideout; David Porter,3,0,37,34
1657989944306,MATH 18,B04,083751,Rideout; David Porter,7,0,36,29
1657989944306,MATH 18,B05,093473,Rideout; David Porter,7,0,36,29
1657989944306,MATH 18,B06,093474,Rideout; David Porter,6,0,36,30
1657989950336,MATH 20A,A01,083754,Zheng; Zequn,14,0,40,26
1657989956365,MATH 20B,A01,083756,Briones; Jor-el Thomas Caparas,4,0,36,32
1657989956365,MATH 20B,A02,083757,Briones; Jor-el Thomas Caparas,1,0,36,35
1657989956365,MATH 20B,A03,093475,Briones; Jor-el Thomas Caparas,3,0,36,33
1657989962389,MATH 20C,A01,083760,Briones; Jor-el Thomas Caparas,1,0,35,34
1657989962389,MATH 20C,A02,083761,Briones; Jor-el Thomas Caparas,8,0,35,27
1657989962389,MATH 20C,A03,093476,Briones; Jor-el Thomas Caparas,0,1,36,36
1657989962389,MATH 20C,B01,083762,Bach; Quang Tran,1,0,30,29
1657989968418,MATH 20D,A01,083765,Tran; Brian Kha,5,0,30,25
1657989968418,MATH 20D,A02,083766,Tran; Brian Kha,5,0,30,25
1657989968418,MATH 20D,A03,083767,Tran; Brian Kha,6,0,30,24
1657989974445,MATH 20E,A01,083771,Ganguly; Soumya,12,0,32,20
1657989974445,MATH 20E,A02,083772,Ganguly; Soumya,7,0,32,25
1657989974445,MATH 20E,B01,083773,Ciotti; Benjamin,20,0,35,15
1657989974445,MATH 20E,B02,083774,Ciotti; Benjamin,18,0,35,17
1657989980473,MATH 103A,A01,083777,Greenfeld; Be'Eri,6,0,36,30
1657989980473,MATH 103A,A02,083778,Greenfeld; Be'Eri,5,0,36,31
1657989980473,MATH 103A,A03,093561,Greenfeld; Be'Eri,7,0,36,29
1657989980473,MATH 103A,B01,083779,Greenfeld; Be'Eri,8,0,36,28
1657989980473,MATH 103A,B02,083780,Greenfeld; Be'Eri,4,0,36,32
1657989980473,MATH 103A,B03,093562,Greenfeld; Be'Eri,3,0,36,33
1657989986503,MATH 105,A01,085443,Carter; Anne Toulson,15,0,35,20
1657989986503,MATH 105,A02,093477,Carter; Anne Toulson,20,0,35,15
1657989992534,MATH 109,A01,083213,Ganzberger; Geoffrey Michael,3,0,34,31
1657989992534,MATH 109,A02,083214,Ganzberger; Geoffrey Michael,4,0,34,30
1657989992534,MATH 109,A03,093478,Ganzberger; Geoffrey Michael,2,0,34,32
1657989992534,MATH 109,B01,083215,Ganzberger; Geoffrey Michael,3,0,32,29
1657989992534,MATH 109,B02,083216,Ganzberger; Geoffrey Michael,3,0,32,29
1657989992534,MATH 109,B03,093479,Ganzberger; Geoffrey Michael,8,0,32,24
1657989998556,MATH 142A,A01,083219,Chow; Bennett,7,0,32,25
1657989998556,MATH 142A,A02,083220,Chow; Bennett,10,0,32,22
1657989998556,MATH 142A,A03,093480,Chow; Bennett,9,0,32,23
1657989998556,MATH 142A,B03,093481,Chow; Bennett,8,0,32,24
1657989998556,MATH 142A,B04,093558,Chow; Bennett,14,0,32,18
1657989998556,MATH 142A,B05,093559,Chow; Bennett,7,0,32,25
1657990004586,MATH 193A,A01,083224,Rotar; Vladimir,9,0,34,25
1657990004586,MATH 193A,A02,083225,Rotar; Vladimir,11,0,34,23
1657990004586,MATH 193A,A03,083781,Rotar; Vladimir,5,0,34,29
1657990004586,MATH 193A,A04,083782,Rotar; Vladimir,12,0,34,22
1657990004586,MATH 193A,A05,093482,Rotar; Vladimir,11,0,34,23
1657990010610,MATH 197,001,091859,McAuley; Julian John,9999,0,9999,0
1657990010610,MATH 197,002,095566,Kedlaya; Kiran S.,9997,0,9999,2
1657990010610,MATH 197,003,095567,Xiao; Ming,9999,0,9999,0
1657990010610,MATH 197,004,095571,Perols; Johan Lars,9998,0,9999,1
1657990017674,COGS 9,A01,083615,Shannon; Kyle Michael,11,0,75,64
1657990023696,COGS 11,A01,083617,Boyle; Mary E. T.,23,0,48,25
1657990029720,COGS 13,A01,083071,Bastos; Amalia Pinkusfeld,12,0,71,59
1657990035744,COGS 14A,A01,092681,Semenuks; Arturs,5,1,100,95
1657990041767,COGS 14B,A01,083073,Cheng; Tzu-Han,7,0,63,56
1657990047796,COGS 17,A01,092677,Semenuks; Arturs,7,0,81,74
1657990053819,COGS 100,A01,083619,Allen; Michael Gordon,17,0,70,53
1657990059848,COGS 101A,A01,083621,Davis; Joshua Daniel,9,0,68,59
1657990065876,COGS 101B,A01,091572,Allen; Michael Gordon,14,0,65,51
1657990071903,COGS 101C,A01,083625,Delgado; Tania,17,0,35,18
1657990077929,COGS 107A,A01,083627,Boyle; Mary E. T.,14,0,60,46
1657990083953,COGS 118A,A01,083075,Gupta; Anjum,21,0,76,55
1657990089981,CSE 3,A50,083646,Miranda; Gregory Joseph,24,0,50,26
1657990096004,CSE 8A,A50,083650,Miranda; Gregory Joseph,17,1,56,39
1657990102040,CSE 11,A01,083080,Cao; Yingjun,7,15,40,33
1657990108065,CSE 12,A01,083652,Krause-Levy; Sophia Louisa,30,1,120,90
1657990114092,CSE 15L,A01,083654,Morris; Justin Loren,9,0,50,41
1657990114092,CSE 15L,A02,083655,Morris; Justin Loren,11,0,50,39
1657990120123,CSE 20,A01,083657,Tran; Khoa Dang,39,0,80,41
1657990126146,CSE 21,A01,095574,Bach; Quang Tran,23,0,48,25
1657990132178,CSE 30,A01,083084,Eldon; John,8,0,80,72
1657990132178,CSE 30,B01,095061,Bhaskar; Nishant,9,0,50,41
1657990138202,CSE 100,A01,083659,Cao; Yingjun,5,4,70,65
1657990144229,CSE 134B,A01,083661,Powell; Thomas Allan,25,0,100,75
1657990150259,CSE 140,A01,083663,Gungor; Onat,17,0,85,68
1657990156298,CSE 140L,A01,083088,Eldon; John,23,0,100,77
1657990162324,CSE 175,A01,083665,Kumar; Rakesh,3,0,25,22
1657990168363,CSE 190,A00,092507,Dubnov; Shlomo,8,0,20,12
1657990174391,ECE 45,A01,083139,Congero; Spencer William,7,0,75,68
1657990180431,ECE 65,A50,083695,Saad; Andrew S,12,0,30,18
1657990180431,ECE 65,A51,095125,Saad; Andrew S,24,0,26,2
1657990186459,ECE 109,A01,091882,Touri; Behrouz,21,0,70,49
1657990192488,ECE 180,A00,083140,Abi Samra; Nicholas Camill,1,0,30,29
1657990192488,ECE 180,B00,083141,Abi Samra; Nicholas Camill,0,0,30,30
1657990198514,MATH 10A,A01,083735,Patchell; Gregory David,2,0,30,28
1657990198514,MATH 10A,A02,083736,Patchell; Gregory David,20,0,30,10
1657990198514,MATH 10A,A03,083737,Patchell; Gregory David,16,0,30,14
1657990204542,MATH 10B,A01,083207,Lim; Seonhee,9,0,34,25
1657990204542,MATH 10B,A02,083208,Lim; Seonhee,10,0,35,25
1657990204542,MATH 10B,A03,093472,Lim; Seonhee,7,0,34,27
1657990204542,MATH 10B,B01,083739,Sinha; Shubham,14,0,30,16
1657990210569,MATH 18,A01,083743,Cinel; Cameron Alexander,9,0,30,21
1657990210569,MATH 18,A02,083744,Cinel; Cameron Alexander,18,0,30,12
1657990210569,MATH 18,A03,083745,Cinel; Cameron Alexander,10,0,30,20
1657990210569,MATH 18,B01,083748,Rideout; David Porter,5,0,37,32
1657990210569,MATH 18,B02,083749,Rideout; David Porter,5,0,36,31
1657990210569,MATH 18,B03,083750,Rideout; David Porter,3,0,37,34
1657990210569,MATH 18,B04,083751,Rideout; David Porter,7,0,36,29
1657990210569,MATH 18,B05,093473,Rideout; David Porter,7,0,36,29
1657990210569,MATH 18,B06,093474,Rideout; David Porter,6,0,36,30
1657990216592,MATH 20A,A01,083754,Zheng; Zequn,14,0,40,26
1657990222639,MATH 20B,A01,083756,Briones; Jor-el Thomas Caparas,4,0,36,32
1657990222639,MATH 20B,A02,083757,Briones; Jor-el Thomas Caparas,1,0,36,35
1657990222639,MATH 20B,A03,093475,Briones; Jor-el Thomas Caparas,3,0,36,33
1657990228662,MATH 20C,A01,083760,Briones; Jor-el Thomas Caparas,1,0,35,34
1657990228662,MATH 20C,A02,083761,Briones; Jor-el Thomas Caparas,8,0,35,27
1657990228662,MATH 20C,A03,093476,Briones; Jor-el Thomas Caparas,0,1,36,36
1657990228662,MATH 20C,B01,083762,Bach; Quang Tran,1,0,30,29
1657990234691,MATH 20D,A01,083765,Tran; Brian Kha,5,0,30,25
1657990234691,MATH 20D,A02,083766,Tran; Brian Kha,5,0,30,25
1657990234691,MATH 20D,A03,083767,Tran; Brian Kha,6,0,30,24
1657990240716,MATH 20E,A01,083771,Ganguly; Soumya,12,0,32,20
1657990240716,MATH 20E,A02,083772,Ganguly; Soumya,7,0,32,25
1657990240716,MATH 20E,B01,083773,Ciotti; Benjamin,20,0,35,15
1657990240716,MATH 20E,B02,083774,Ciotti; Benjamin,18,0,35,17
1657990246747,MATH 103A,A01,083777,Greenfeld; Be'Eri,6,0,36,30
1657990246747,MATH 103A,A02,083778,Greenfeld; Be'Eri,5,0,36,31
1657990246747,MATH 103A,A03,093561,Greenfeld; Be'Eri,7,0,36,29
1657990246747,MATH 103A,B01,083779,Greenfeld; Be'Eri,8,0,36,28
1657990246747,MATH 103A,B02,083780,Greenfeld; Be'Eri,4,0,36,32
1657990246747,MATH 103A,B03,093562,Greenfeld; Be'Eri,3,0,36,33
1657990252770,MATH 105,A01,085443,Carter; Anne Toulson,15,0,35,20
1657990252770,MATH 105,A02,093477,Carter; Anne Toulson,20,0,35,15
1657990258800,MATH 109,A01,083213,Ganzberger; Geoffrey Michael,3,0,34,31
1657990258800,MATH 109,A02,083214,Ganzberger; Geoffrey Michael,4,0,34,30
1657990258800,MATH 109,A03,093478,Ganzberger; Geoffrey Michael,2,0,34,32
1657990258800,MATH 109,B01,083215,Ganzberger; Geoffrey Michael,3,0,32,29
1657990258800,MATH 109,B02,083216,Ganzberger; Geoffrey Michael,3,0,32,29
1657990258800,MATH 109,B03,093479,Ganzberger; Geoffrey Michael,8,0,32,24
1657990264832,MATH 142A,A01,083219,Chow; Bennett,7,0,32,25
1657990264832,MATH 142A,A02,083220,Chow; Bennett,10,0,32,22
1657990264832,MATH 142A,A03,093480,Chow; Bennett,9,0,32,23
1657990264832,MATH 142A,B03,093481,Chow; Bennett,8,0,32,24
1657990264832,MATH 142A,B04,093558,Chow; Bennett,14,0,32,18
1657990264832,MATH 142A,B05,093559,Chow; Bennett,7,0,32,25
1657990270858,MATH 193A,A01,083224,Rotar; Vladimir,9,0,34,25
1657990270858,MATH 193A,A02,083225,Rotar; Vladimir,11,0,34,23
1657990270858,MATH 193A,A03,083781,Rotar; Vladimir,5,0,34,29
1657990270858,MATH 193A,A04,083782,Rotar; Vladimir,12,0,34,22
1657990270858,MATH 193A,A05,093482,Rotar; Vladimir,11,0,34,23
1657990276882,MATH 197,001,091859,McAuley; Julian John,9999,0,9999,0
1657990276882,MATH 197,002,095566,Kedlaya; Kiran S.,9997,0,9999,2
1657990276882,MATH 197,003,095567,Xiao; Ming,9999,0,9999,0
1657990276882,MATH 197,004,095571,Perols; Johan Lars,9998,0,9999,1
1657990284031,COGS 9,A01,083615,Shannon; Kyle Michael,11,0,75,64
1657990290055,COGS 11,A01,083617,Boyle; Mary E. T.,23,0,48,25
1657990296082,COGS 13,A01,083071,Bastos; Amalia Pinkusfeld,12,0,71,59
1657990302107,COGS 14A,A01,092681,Semenuks; Arturs,5,1,100,95
1657990308132,COGS 14B,A01,083073,Cheng; Tzu-Han,7,0,63,56
1657990314159,COGS 17,A01,092677,Semenuks; Arturs,7,0,81,74
1657990320189,COGS 100,A01,083619,Allen; Michael Gordon,17,0,70,53
1657990326224,COGS 101A,A01,083621,Davis; Joshua Daniel,9,0,68,59
1657990332247,COGS 101B,A01,091572,Allen; Michael Gordon,14,0,65,51
1657990338271,COGS 101C,A01,083625,Delgado; Tania,17,0,35,18
1657990344299,COGS 107A,A01,083627,Boyle; Mary E. T.,14,0,60,46
1657990350322,COGS 118A,A01,083075,Gupta; Anjum,21,0,76,55
1657990356351,CSE 3,A50,083646,Miranda; Gregory Joseph,24,0,50,26
1657990362375,CSE 8A,A50,083650,Miranda; Gregory Joseph,17,1,56,39
1657990368399,CSE 11,A01,083080,Cao; Yingjun,7,15,40,33
1657990374424,CSE 12,A01,083652,Krause-Levy; Sophia Louisa,30,1,120,90
1657990380451,CSE 15L,A01,083654,Morris; Justin Loren,9,0,50,41
1657990380451,CSE 15L,A02,083655,Morris; Justin Loren,11,0,50,39
1657990386476,CSE 20,A01,083657,Tran; Khoa Dang,39,0,80,41
1657990392509,CSE 21,A01,095574,Bach; Quang Tran,23,0,48,25
1657990398541,CSE 30,A01,083084,Eldon; John,8,0,80,72
1657990398541,CSE 30,B01,095061,Bhaskar; Nishant,9,0,50,41
1657990404565,CSE 100,A01,083659,Cao; Yingjun,5,4,70,65
1657990410587,CSE 134B,A01,083661,Powell; Thomas Allan,25,0,100,75
1657990416613,CSE 140,A01,083663,Gungor; Onat,17,0,85,68
1657990422637,CSE 140L,A01,083088,Eldon; John,23,0,100,77
1657990428665,CSE 175,A01,083665,Kumar; Rakesh,3,0,25,22
1657990434689,CSE 190,A00,092507,Dubnov; Shlomo,8,0,20,12
1657990440718,ECE 45,A01,083139,Congero; Spencer William,7,0,75,68
1657990446747,ECE 65,A50,083695,Saad; Andrew S,12,0,30,18
1657990446747,ECE 65,A51,095125,Saad; Andrew S,24,0,26,2
1657990452776,ECE 109,A01,091882,Touri; Behrouz,21,0,70,49
1657990458800,ECE 180,A00,083140,Abi Samra; Nicholas Camill,1,0,30,29
1657990458800,ECE 180,B00,083141,Abi Samra; Nicholas Camill,0,0,30,30
1657990464825,MATH 10A,A01,083735,Patchell; Gregory David,2,0,30,28
1657990464825,MATH 10A,A02,083736,Patchell; Gregory David,20,0,30,10
1657990464825,MATH 10A,A03,083737,Patchell; Gregory David,16,0,30,14
1657990470853,MATH 10B,A01,083207,Lim; Seonhee,9,0,34,25
1657990470853,MATH 10B,A02,083208,Lim; Seonhee,10,0,35,25
1657990470853,MATH 10B,A03,093472,Lim; Seonhee,7,0,34,27
1657990470853,MATH 10B,B01,083739,Sinha; Shubham,14,0,30,16
1657990476887,MATH 18,A01,083743,Cinel; Cameron Alexander,9,0,30,21
1657990476887,MATH 18,A02,083744,Cinel; Cameron Alexander,18,0,30,12
1657990476887,MATH 18,A03,083745,Cinel; Cameron Alexander,10,0,30,20
1657990476887,MATH 18,B01,083748,Rideout; David Porter,5,0,37,32
1657990476887,MATH 18,B02,083749,Rideout; David Porter,5,0,36,31
1657990476887,MATH 18,B03,083750,Rideout; David Porter,3,0,37,34
1657990476887,MATH 18,B04,083751,Rideout; David Porter,7,0,36,29
1657990476887,MATH 18,B05,093473,Rideout; David Porter,7,0,36,29
1657990476887,MATH 18,B06,093474,Rideout; David Porter,6,0,36,30
1657990482910,MATH 20A,A01,083754,Zheng; Zequn,14,0,40,26
1657990488940,MATH 20B,A01,083756,Briones; Jor-el Thomas Caparas,4,0,36,32
1657990488940,MATH 20B,A02,083757,Briones; Jor-el Thomas Caparas,1,0,36,35
1657990488940,MATH 20B,A03,093475,Briones; Jor-el Thomas Caparas,3,0,36,33
1657990494965,MATH 20C,A01,083760,Briones; Jor-el Thomas Caparas,1,0,35,34
1657990494965,MATH 20C,A02,083761,Briones; Jor-el Thomas Caparas,8,0,35,27
1657990494965,MATH 20C,A03,093476,Briones; Jor-el Thomas Caparas,0,1,36,36
1657990494965,MATH 20C,B01,083762,Bach; Quang Tran,1,0,30,29
1657990500989,MATH 20D,A01,083765,Tran; Brian Kha,5,0,30,25
1657990500989,MATH 20D,A02,083766,Tran; Brian Kha,5,0,30,25
1657990500989,MATH 20D,A03,083767,Tran; Brian Kha,6,0,30,24
1657990507022,MATH 20E,A01,083771,Ganguly; Soumya,12,0,32,20
1657990507022,MATH 20E,A02,083772,Ganguly; Soumya,7,0,32,25
1657990507022,MATH 20E,B01,083773,Ciotti; Benjamin,20,0,35,15
1657990507022,MATH 20E,B02,083774,Ciotti; Benjamin,18,0,35,17
1657990513054,MATH 103A,A01,083777,Greenfeld; Be'Eri,6,0,36,30
1657990513054,MATH 103A,A02,083778,Greenfeld; Be'Eri,5,0,36,31
1657990513054,MATH 103A,A03,093561,Greenfeld; Be'Eri,7,0,36,29
1657990513054,MATH 103A,B01,083779,Greenfeld; Be'Eri,8,0,36,28
1657990513054,MATH 103A,B02,083780,Greenfeld; Be'Eri,4,0,36,32
1657990513054,MATH 103A,B03,093562,Greenfeld; Be'Eri,3,0,36,33
1657990519092,MATH 105,A01,085443,Carter; Anne Toulson,15,0,35,20
1657990519092,MATH 105,A02,093477,Carter; Anne Toulson,20,0,35,15
1657990525116,MATH 109,A01,083213,Ganzberger; Geoffrey Michael,3,0,34,31
1657990525116,MATH 109,A02,083214,Ganzberger; Geoffrey Michael,4,0,34,30
1657990525116,MATH 109,A03,093478,Ganzberger; Geoffrey Michael,2,0,34,32
1657990525116,MATH 109,B01,083215,Ganzberger; Geoffrey Michael,3,0,32,29
1657990525116,MATH 109,B02,083216,Ganzberger; Geoffrey Michael,3,0,32,29
1657990525116,MATH 109,B03,093479,Ganzberger; Geoffrey Michael,8,0,32,24
1657990531158,MATH 142A,A01,083219,Chow; Bennett,7,0,32,25
1657990531158,MATH 142A,A02,083220,Chow; Bennett,10,0,32,22
1657990531158,MATH 142A,A03,093480,Chow; Bennett,9,0,32,23
1657990531158,MATH 142A,B03,093481,Chow; Bennett,8,0,32,24
1657990531158,MATH 142A,B04,093558,Chow; Bennett,14,0,32,18
1657990531158,MATH 142A,B05,093559,Chow; Bennett,7,0,32,25
1657990537188,MATH 193A,A01,083224,Rotar; Vladimir,9,0,34,25
1657990537188,MATH 193A,A02,083225,Rotar; Vladimir,11,0,34,23
1657990537188,MATH 193A,A03,083781,Rotar; Vladimir,5,0,34,29
1657990537188,MATH 193A,A04,083782,Rotar; Vladimir,12,0,34,22
1657990537188,MATH 193A,A05,093482,Rotar; Vladimir,11,0,34,23
1657990543212,MATH 197,001,091859,McAuley; Julian John,9999,0,9999,0
1657990543212,MATH 197,002,095566,Kedlaya; Kiran S.,9997,0,9999,2
1657990543212,MATH 197,003,095567,Xiao; Ming,9999,0,9999,0
1657990543212,MATH 197,004,095571,Perols; Johan Lars,9998,0,9999,1
1657990550287,COGS 9,A01,083615,Shannon; Kyle Michael,11,0,75,64
1657990556317,COGS 11,A01,083617,Boyle; Mary E. T.,23,0,48,25
1657990562341,COGS 13,A01,083071,Bastos; Amalia Pinkusfeld,12,0,71,59
1657990568367,COGS 14A,A01,092681,Semenuks; Arturs,5,1,100,95
1657990574396,COGS 14B,A01,083073,Cheng; Tzu-Han,7,0,63,56
1657990580423,COGS 17,A01,092677,Semenuks; Arturs,7,0,81,74
1657990586447,COGS 100,A01,083619,Allen; Michael Gordon,17,0,70,53
1657990592470,COGS 101A,A01,083621,Davis; Joshua Daniel,9,0,68,59
1657990598493,COGS 101B,A01,091572,Allen; Michael Gordon,14,0,65,51
1657990604534,COGS 101C,A01,083625,Delgado; Tania,17,0,35,18
1657990610560,COGS 107A,A01,083627,Boyle; Mary E. T.,14,0,60,46
1657990616585,COGS 118A,A01,083075,Gupta; Anjum,21,0,76,55
1657990622609,CSE 3,A50,083646,Miranda; Gregory Joseph,24,0,50,26
1657990628637,CSE 8A,A50,083650,Miranda; Gregory Joseph,17,1,56,39
1657990634676,CSE 11,A01,083080,Cao; Yingjun,7,15,40,33
1657990640705,CSE 12,A01,083652,Krause-Levy; Sophia Louisa,30,1,120,90
1657990646732,CSE 15L,A01,083654,Morris; Justin Loren,9,0,50,41
1657990646732,CSE 15L,A02,083655,Morris; Justin Loren,11,0,50,39
1657990652755,CSE 20,A01,083657,Tran; Khoa Dang,39,0,80,41
1657990658779,CSE 21,A01,095574,Bach; Quang Tran,23,0,48,25
1657990664802,CSE 30,A01,083084,Eldon; John,8,0,80,72
1657990664802,CSE 30,B01,095061,Bhaskar; Nishant,9,0,50,41
1657990670831,CSE 100,A01,083659,Cao; Yingjun,5,4,70,65
1657990676854,CSE 134B,A01,083661,Powell; Thomas Allan,25,0,100,75
1657990682877,CSE 140,A01,083663,Gungor; Onat,17,0,85,68
1657990688905,CSE 140L,A01,083088,Eldon; John,23,0,100,77
1657990694932,CSE 175,A01,083665,Kumar; Rakesh,3,0,25,22
1657990700958,CSE 190,A00,092507,Dubnov; Shlomo,8,0,20,12
1657990706982,ECE 45,A01,083139,Congero; Spencer William,7,0,75,68
1657990713011,ECE 65,A50,083695,Saad; Andrew S,12,0,30,18
1657990713011,ECE 65,A51,095125,Saad; Andrew S,24,0,26,2
1657990719047,ECE 109,A01,091882,Touri; Behrouz,21,0,70,49
1657990725074,ECE 180,A00,083140,Abi Samra; Nicholas Camill,1,0,30,29
1657990725074,ECE 180,B00,083141,Abi Samra; Nicholas Camill,0,0,30,30
1657990731096,MATH 10A,A01,083735,Patchell; Gregory David,2,0,30,28
1657990731096,MATH 10A,A02,083736,Patchell; Gregory David,20,0,30,10
1657990731096,MATH 10A,A03,083737,Patchell; Gregory David,16,0,30,14
1657990737128,MATH 10B,A01,083207,Lim; Seonhee,9,0,34,25
1657990737128,MATH 10B,A02,083208,Lim; Seonhee,10,0,35,25
1657990737128,MATH 10B,A03,093472,Lim; Seonhee,7,0,34,27
1657990737128,MATH 10B,B01,083739,Sinha; Shubham,14,0,30,16
1657990743152,MATH 18,A01,083743,Cinel; Cameron Alexander,9,0,30,21
1657990743152,MATH 18,A02,083744,Cinel; Cameron Alexander,18,0,30,12
1657990743152,MATH 18,A03,083745,Cinel; Cameron Alexander,10,0,30,20
1657990743152,MATH 18,B01,083748,Rideout; David Porter,5,0,37,32
1657990743152,MATH 18,B02,083749,Rideout; David Porter,5,0,36,31
1657990743152,MATH 18,B03,083750,Rideout; David Porter,3,0,37,34
1657990743152,MATH 18,B04,083751,Rideout; David Porter,7,0,36,29
1657990743152,MATH 18,B05,093473,Rideout; David Porter,7,0,36,29
1657990743152,MATH 18,B06,093474,Rideout; David Porter,6,0,36,30
1657990749179,MATH 20A,A01,083754,Zheng; Zequn,14,0,40,26
1657990755204,MATH 20B,A01,083756,Briones; Jor-el Thomas Caparas,4,0,36,32
1657990755204,MATH 20B,A02,083757,Briones; Jor-el Thomas Caparas,1,0,36,35
1657990755204,MATH 20B,A03,093475,Briones; Jor-el Thomas Caparas,3,0,36,33
1657990761232,MATH 20C,A01,083760,Briones; Jor-el Thomas Caparas,1,0,35,34
1657990761232,MATH 20C,A02,083761,Briones; Jor-el Thomas Caparas,8,0,35,27
1657990761232,MATH 20C,A03,093476,Briones; Jor-el Thomas Caparas,0,1,36,36
1657990761232,MATH 20C,B01,083762,Bach; Quang Tran,1,0,30,29
1657990767257,MATH 20D,A01,083765,Tran; Brian Kha,5,0,30,25
1657990767257,MATH 20D,A02,083766,Tran; Brian Kha,5,0,30,25
1657990767257,MATH 20D,A03,083767,Tran; Brian Kha,6,0,30,24
1657990773284,MATH 20E,A01,083771,Ganguly; Soumya,12,0,32,20
1657990773284,MATH 20E,A02,083772,Ganguly; Soumya,7,0,32,25
1657990773284,MATH 20E,B01,083773,Ciotti; Benjamin,20,0,35,15
1657990773284,MATH 20E,B02,083774,Ciotti; Benjamin,18,0,35,17
1657990779314,MATH 103A,A01,083777,Greenfeld; Be'Eri,6,0,36,30
1657990779314,MATH 103A,A02,083778,Greenfeld; Be'Eri,5,0,36,31
1657990779314,MATH 103A,A03,093561,Greenfeld; Be'Eri,7,0,36,29
1657990779314,MATH 103A,B01,083779,Greenfeld; Be'Eri,8,0,36,28
1657990779314,MATH 103A,B02,083780,Greenfeld; Be'Eri,4,0,36,32
1657990779314,MATH 103A,B03,093562,Greenfeld; Be'Eri,3,0,36,33
1657990785353,MATH 105,A01,085443,Carter; Anne Toulson,15,0,35,20
1657990785353,MATH 105,A02,093477,Carter; Anne Toulson,20,0,35,15
1657990791378,MATH 109,A01,083213,Ganzberger; Geoffrey Michael,3,0,34,31
1657990791378,MATH 109,A02,083214,Ganzberger; Geoffrey Michael,4,0,34,30
1657990791378,MATH 109,A03,093478,Ganzberger; Geoffrey Michael,2,0,34,32
1657990791378,MATH 109,B01,083215,Ganzberger; Geoffrey Michael,3,0,32,29
1657990791378,MATH 109,B02,083216,Ganzberger; Geoffrey Michael,3,0,32,29
1657990791378,MATH 109,B03,093479,Ganzberger; Geoffrey Michael,8,0,32,24
1657990797407,MATH 142A,A01,083219,Chow; Bennett,7,0,32,25
1657990797407,MATH 142A,A02,083220,Chow; Bennett,10,0,32,22
1657990797407,MATH 142A,A03,093480,Chow; Bennett,9,0,32,23
1657990797407,MATH 142A,B03,093481,Chow; Bennett,8,0,32,24
1657990797407,MATH 142A,B04,093558,Chow; Bennett,14,0,32,18
1657990797407,MATH 142A,B05,093559,Chow; Bennett,7,0,32,25
1657990803447,MATH 193A,A01,083224,Rotar; Vladimir,9,0,34,25
1657990803447,MATH 193A,A02,083225,Rotar; Vladimir,11,0,34,23
1657990803447,MATH 193A,A03,083781,Rotar; Vladimir,5,0,34,29
1657990803447,MATH 193A,A04,083782,Rotar; Vladimir,12,0,34,22
1657990803447,MATH 193A,A05,093482,Rotar; Vladimir,11,0,34,23
1657990809479,MATH 197,001,091859,McAuley; Julian John,9999,0,9999,0
1657990809479,MATH 197,002,095566,Kedlaya; Kiran S.,9997,0,9999,2
1657990809479,MATH 197,003,095567,Xiao; Ming,9999,0,9999,0
1657990809479,MATH 197,004,095571,Perols; Johan Lars,9998,0,9999,1
1657990816547,COGS 9,A01,083615,Shannon; Kyle Michael,11,0,75,64
1657990822570,COGS 11,A01,083617,Boyle; Mary E. T.,23,0,48,25
1657990828593,COGS 13,A01,083071,Bastos; Amalia Pinkusfeld,12,0,71,59
1657990834621,COGS 14A,A01,092681,Semenuks; Arturs,5,1,100,95
1657990840642,COGS 14B,A01,083073,Cheng; Tzu-Han,7,0,63,56
1657990846664,COGS 17,A01,092677,Semenuks; Arturs,7,0,81,74
1657990852696,COGS 100,A01,083619,Allen; Michael Gordon,17,0,70,53
1657990858727,COGS 101A,A01,083621,Davis; Joshua Daniel,9,0,68,59
1657990864761,COGS 101B,A01,091572,Allen; Michael Gordon,14,0,65,51
1657990870785,COGS 101C,A01,083625,Delgado; Tania,17,0,35,18
1657990876887,COGS 107A,A01,083627,Boyle; Mary E. T.,14,0,60,46
1657990882915,COGS 118A,A01,083075,Gupta; Anjum,21,0,76,55
1657990888943,CSE 3,A50,083646,Miranda; Gregory Joseph,24,0,50,26
1657990894970,CSE 8A,A50,083650,Miranda; Gregory Joseph,17,1,56,39
1657990900994,CSE 11,A01,083080,Cao; Yingjun,7,15,40,33
1657990907023,CSE 12,A01,083652,Krause-Levy; Sophia Louisa,30,1,120,90
1657990913045,CSE 15L,A01,083654,Morris; Justin Loren,9,0,50,41
1657990913045,CSE 15L,A02,083655,Morris; Justin Loren,11,0,50,39
1657990919071,CSE 20,A01,083657,Tran; Khoa Dang,39,0,80,41
1657990925118,CSE 21,A01,095574,Bach; Quang Tran,23,0,48,25
1657990931153,CSE 30,A01,083084,Eldon; John,8,0,80,72
1657990931153,CSE 30,B01,095061,Bhaskar; Nishant,9,0,50,41
1657990937179,CSE 100,A01,083659,Cao; Yingjun,5,4,70,65
1657990943201,CSE 134B,A01,083661,Powell; Thomas Allan,25,0,100,75
1657990949226,CSE 140,A01,083663,Gungor; Onat,17,0,85,68
1657990955260,CSE 140L,A01,083088,Eldon; John,23,0,100,77
1657990961284,CSE 175,A01,083665,Kumar; Rakesh,3,0,25,22
1657990967309,CSE 190,A00,092507,Dubnov; Shlomo,8,0,20,12
1657990973333,ECE 45,A01,083139,Congero; Spencer William,7,0,75,68
1657990979363,ECE 65,A50,083695,Saad; Andrew S,12,0,30,18
1657990979363,ECE 65,A51,095125,Saad; Andrew S,24,0,26,2
1657990985394,ECE 109,A01,091882,Touri; Behrouz,21,0,70,49
1657990991418,ECE 180,A00,083140,Abi Samra; Nicholas Camill,1,0,30,29
1657990991418,ECE 180,B00,083141,Abi Samra; Nicholas Camill,0,0,30,30
1657990997453,MATH 10A,A01,083735,Patchell; Gregory David,2,0,30,28
1657990997453,MATH 10A,A02,083736,Patchell; Gregory David,20,0,30,10
1657990997453,MATH 10A,A03,083737,Patchell; Gregory David,16,0,30,14
1657991003482,MATH 10B,A01,083207,Lim; Seonhee,9,0,34,25
1657991003482,MATH 10B,A02,083208,Lim; Seonhee,10,0,35,25
1657991003482,MATH 10B,A03,093472,Lim; Seonhee,7,0,34,27
1657991003482,MATH 10B,B01,083739,Sinha; Shubham,14,0,30,16
1657991009506,MATH 18,A01,083743,Cinel; Cameron Alexander,9,0,30,21
1657991009506,MATH 18,A02,083744,Cinel; Cameron Alexander,18,0,30,12
1657991009506,MATH 18,A03,083745,Cinel; Cameron Alexander,10,0,30,20
1657991009506,MATH 18,B01,083748,Rideout; David Porter,5,0,37,32
1657991009506,MATH 18,B02,083749,Rideout; David Porter,5,0,36,31
1657991009506,MATH 18,B03,083750,Rideout; David Porter,3,0,37,34
1657991009506,MATH 18,B04,083751,Rideout; David Porter,7,0,36,29
1657991009506,MATH 18,B05,093473,Rideout; David Porter,7,0,36,29
1657991009506,MATH 18,B06,093474,Rideout; David Porter,6,0,36,30
1657991015534,MATH 20A,A01,083754,Zheng; Zequn,14,0,40,26
1657991021561,MATH 20B,A01,083756,Briones; Jor-el Thomas Caparas,4,0,36,32
1657991021561,MATH 20B,A02,083757,Briones; Jor-el Thomas Caparas,1,0,36,35
1657991021561,MATH 20B,A03,093475,Briones; Jor-el Thomas Caparas,3,0,36,33
1657991027585,MATH 20C,A01,083760,Briones; Jor-el Thomas Caparas,1,0,35,34
1657991027585,MATH 20C,A02,083761,Briones; Jor-el Thomas Caparas,8,0,35,27
1657991027585,MATH 20C,A03,093476,Briones; Jor-el Thomas Caparas,0,1,36,36
1657991027585,MATH 20C,B01,083762,Bach; Quang Tran,1,0,30,29
1657991033608,MATH 20D,A01,083765,Tran; Brian Kha,5,0,30,25
1657991033608,MATH 20D,A02,083766,Tran; Brian Kha,5,0,30,25
1657991033608,MATH 20D,A03,083767,Tran; Brian Kha,6,0,30,24
1657991039637,MATH 20E,A01,083771,Ganguly; Soumya,12,0,32,20
1657991039637,MATH 20E,A02,083772,Ganguly; Soumya,7,0,32,25
1657991039637,MATH 20E,B01,083773,Ciotti; Benjamin,20,0,35,15
1657991039637,MATH 20E,B02,083774,Ciotti; Benjamin,18,0,35,17
1657991045661,MATH 103A,A01,083777,Greenfeld; Be'Eri,6,0,36,30
1657991045661,MATH 103A,A02,083778,Greenfeld; Be'Eri,5,0,36,31
1657991045661,MATH 103A,A03,093561,Greenfeld; Be'Eri,7,0,36,29
1657991045661,MATH 103A,B01,083779,Greenfeld; Be'Eri,8,0,36,28
1657991045661,MATH 103A,B02,083780,Greenfeld; Be'Eri,4,0,36,32
1657991045661,MATH 103A,B03,093562,Greenfeld; Be'Eri,3,0,36,33
1657991051682,MATH 105,A01,085443,Carter; Anne Toulson,15,0,35,20
1657991051682,MATH 105,A02,093477,Carter; Anne Toulson,20,0,35,15
1657991057708,MATH 109,A01,083213,Ganzberger; Geoffrey Michael,3,0,34,31
1657991057708,MATH 109,A02,083214,Ganzberger; Geoffrey Michael,4,0,34,30
1657991057708,MATH 109,A03,093478,Ganzberger; Geoffrey Michael,2,0,34,32
1657991057708,MATH 109,B01,083215,Ganzberger; Geoffrey Michael,3,0,32,29
1657991057708,MATH 109,B02,083216,Ganzberger; Geoffrey Michael,3,0,32,29
1657991057708,MATH 109,B03,093479,Ganzberger; Geoffrey Michael,8,0,32,24
1657991063741,MATH 142A,A01,083219,Chow; Bennett,7,0,32,25
1657991063741,MATH 142A,A02,083220,Chow; Bennett,10,0,32,22
1657991063741,MATH 142A,A03,093480,Chow; Bennett,9,0,32,23
1657991063741,MATH 142A,B03,093481,Chow; Bennett,8,0,32,24
1657991063741,MATH 142A,B04,093558,Chow; Bennett,14,0,32,18
1657991063741,MATH 142A,B05,093559,Chow; Bennett,7,0,32,25
1657991069766,MATH 193A,A01,083224,Rotar; Vladimir,9,0,34,25
1657991069766,MATH 193A,A02,083225,Rotar; Vladimir,11,0,34,23
1657991069766,MATH 193A,A03,083781,Rotar; Vladimir,5,0,34,29
1657991069766,MATH 193A,A04,083782,Rotar; Vladimir,12,0,34,22
1657991069766,MATH 193A,A05,093482,Rotar; Vladimir,11,0,34,23
1657991075794,MATH 197,001,091859,McAuley; Julian John,9999,0,9999,0
1657991075794,MATH 197,002,095566,Kedlaya; Kiran S.,9997,0,9999,2
1657991075794,MATH 197,003,095567,Xiao; Ming,9999,0,9999,0
1657991075794,MATH 197,004,095571,Perols; Johan Lars,9998,0,9999,1
1657991082849,COGS 9,A01,083615,Shannon; Kyle Michael,11,0,75,64
1657991088874,COGS 11,A01,083617,Boyle; Mary E. T.,23,0,48,25
1657991094898,COGS 13,A01,083071,Bastos; Amalia Pinkusfeld,12,0,71,59
1657991100925,COGS 14A,A01,092681,Semenuks; Arturs,5,1,100,95
1657991106960,COGS 14B,A01,083073,Cheng; Tzu-Han,7,0,63,56
1657991112982,COGS 17,A01,092677,Semenuks; Arturs,7,0,81,74
1657991119005,COGS 100,A01,083619,Allen; Michael Gordon,17,0,70,53
1657991125031,COGS 101A,A01,083621,Davis; Joshua Daniel,9,0,68,59
1657991131054,COGS 101B,A01,091572,Allen; Michael Gordon,14,0,65,51
1657991137083,COGS 101C,A01,083625,Delgado; Tania,17,0,35,18
1657991143110,COGS 107A,A01,083627,Boyle; Mary E. T.,14,0,60,46
1657991149133,COGS 118A,A01,083075,Gupta; Anjum,21,0,76,55
1657991155156,CSE 3,A50,083646,Miranda; Gregory Joseph,24,0,50,26
1657991161180,CSE 8A,A50,083650,Miranda; Gregory Joseph,17,1,56,39
1657991167204,CSE 11,A01,083080,Cao; Yingjun,7,15,40,33
1657991173234,CSE 12,A01,083652,Krause-Levy; Sophia Louisa,30,1,120,90
1657991179260,CSE 15L,A01,083654,Morris; Justin Loren,9,0,50,41
1657991179260,CSE 15L,A02,083655,Morris; Justin Loren,11,0,50,39
1657991185284,CSE 20,A01,083657,Tran; Khoa Dang,39,0,80,41
1657991191307,CSE 21,A01,095574,Bach; Quang Tran,23,0,48,25
1657991197335,CSE 30,A01,083084,Eldon; John,8,0,80,72
1657991197335,CSE 30,B01,095061,Bhaskar; Nishant,9,0,50,41
1657991203371,CSE 100,A01,083659,Cao; Yingjun,5,4,70,65
1657991209394,CSE 134B,A01,083661,Powell; Thomas Allan,25,0,100,75
1657991215417,CSE 140,A01,083663,Gungor; Onat,17,0,85,68
1657991221440,CSE 140L,A01,083088,Eldon; John,23,0,100,77
1657991227464,CSE 175,A01,083665,Kumar; Rakesh,3,0,25,22
1657991233488,CSE 190,A00,092507,Dubnov; Shlomo,8,0,20,12
1657991239510,ECE 45,A01,083139,Congero; Spencer William,7,0,75,68
1657991245534,ECE 65,A50,083695,Saad; Andrew S,12,0,30,18
1657991245534,ECE 65,A51,095125,Saad; Andrew S,24,0,26,2
1657991251558,ECE 109,A01,091882,Touri; Behrouz,21,0,70,49
1657991257584,ECE 180,A00,083140,Abi Samra; Nicholas Camill,1,0,30,29
1657991257584,ECE 180,B00,083141,Abi Samra; Nicholas Camill,0,0,30,30
1657991263608,MATH 10A,A01,083735,Patchell; Gregory David,2,0,30,28
1657991263608,MATH 10A,A02,083736,Patchell; Gregory David,20,0,30,10
1657991263608,MATH 10A,A03,083737,Patchell; Gregory David,16,0,30,14
1657991269632,MATH 10B,A01,083207,Lim; Seonhee,9,0,34,25
1657991269632,MATH 10B,A02,083208,Lim; Seonhee,10,0,35,25
1657991269632,MATH 10B,A03,093472,Lim; Seonhee,7,0,34,27
1657991269632,MATH 10B,B01,083739,Sinha; Shubham,14,0,30,16
1657991275656,MATH 18,A01,083743,Cinel; Cameron Alexander,9,0,30,21
1657991275656,MATH 18,A02,083744,Cinel; Cameron Alexander,18,0,30,12
1657991275656,MATH 18,A03,083745,Cinel; Cameron Alexander,10,0,30,20
1657991275656,MATH 18,B01,083748,Rideout; David Porter,5,0,37,32
1657991275656,MATH 18,B02,083749,Rideout; David Porter,5,0,36,31
1657991275656,MATH 18,B03,083750,Rideout; David Porter,3,0,37,34
1657991275656,MATH 18,B04,083751,Rideout; David Porter,7,0,36,29
1657991275656,MATH 18,B05,093473,Rideout; David Porter,7,0,36,29
1657991275656,MATH 18,B06,093474,Rideout; David Porter,6,0,36,30
1657991281679,MATH 20A,A01,083754,Zheng; Zequn,14,0,40,26
1657991287705,MATH 20B,A01,083756,Briones; Jor-el Thomas Caparas,4,0,36,32
1657991287705,MATH 20B,A02,083757,Briones; Jor-el Thomas Caparas,1,0,36,35
1657991287705,MATH 20B,A03,093475,Briones; Jor-el Thomas Caparas,3,0,36,33
1657991293729,MATH 20C,A01,083760,Briones; Jor-el Thomas Caparas,1,0,35,34
1657991293729,MATH 20C,A02,083761,Briones; Jor-el Thomas Caparas,8,0,35,27
1657991293729,MATH 20C,A03,093476,Briones; Jor-el Thomas Caparas,0,1,36,36
1657991293729,MATH 20C,B01,083762,Bach; Quang Tran,1,0,30,29
1657991299753,MATH 20D,A01,083765,Tran; Brian Kha,5,0,30,25
1657991299753,MATH 20D,A02,083766,Tran; Brian Kha,5,0,30,25
1657991299753,MATH 20D,A03,083767,Tran; Brian Kha,6,0,30,24
1657991305787,MATH 20E,A01,083771,Ganguly; Soumya,12,0,32,20
1657991305787,MATH 20E,A02,083772,Ganguly; Soumya,7,0,32,25
1657991305787,MATH 20E,B01,083773,Ciotti; Benjamin,20,0,35,15
1657991305787,MATH 20E,B02,083774,Ciotti; Benjamin,18,0,35,17
1657991311819,MATH 103A,A01,083777,Greenfeld; Be'Eri,6,0,36,30
1657991311819,MATH 103A,A02,083778,Greenfeld; Be'Eri,5,0,36,31
1657991311819,MATH 103A,A03,093561,Greenfeld; Be'Eri,7,0,36,29
1657991311819,MATH 103A,B01,083779,Greenfeld; Be'Eri,8,0,36,28
1657991311819,MATH 103A,B02,083780,Greenfeld; Be'Eri,4,0,36,32
1657991311819,MATH 103A,B03,093562,Greenfeld; Be'Eri,3,0,36,33
1657991317842,MATH 105,A01,085443,Carter; Anne Toulson,15,0,35,20
1657991317842,MATH 105,A02,093477,Carter; Anne Toulson,20,0,35,15
1657991323870,MATH 109,A01,083213,Ganzberger; Geoffrey Michael,3,0,34,31
1657991323870,MATH 109,A02,083214,Ganzberger; Geoffrey Michael,4,0,34,30
1657991323870,MATH 109,A03,093478,Ganzberger; Geoffrey Michael,2,0,34,32
1657991323870,MATH 109,B01,083215,Ganzberger; Geoffrey Michael,3,0,32,29
1657991323870,MATH 109,B02,083216,Ganzberger; Geoffrey Michael,3,0,32,29
1657991323870,MATH 109,B03,093479,Ganzberger; Geoffrey Michael,8,0,32,24
1657991329902,MATH 142A,A01,083219,Chow; Bennett,7,0,32,25
1657991329902,MATH 142A,A02,083220,Chow; Bennett,10,0,32,22
1657991329902,MATH 142A,A03,093480,Chow; Bennett,9,0,32,23
1657991329902,MATH 142A,B03,093481,Chow; Bennett,8,0,32,24
1657991329902,MATH 142A,B04,093558,Chow; Bennett,14,0,32,18
1657991329902,MATH 142A,B05,093559,Chow; Bennett,7,0,32,25
1657991335927,MATH 193A,A01,083224,Rotar; Vladimir,9,0,34,25
1657991335927,MATH 193A,A02,083225,Rotar; Vladimir,11,0,34,23
1657991335927,MATH 193A,A03,083781,Rotar; Vladimir,5,0,34,29
1657991335927,MATH 193A,A04,083782,Rotar; Vladimir,12,0,34,22
1657991335927,MATH 193A,A05,093482,Rotar; Vladimir,11,0,34,23
1657991341956,MATH 197,001,091859,McAuley; Julian John,9999,0,9999,0
1657991341956,MATH 197,002,095566,Kedlaya; Kiran S.,9997,0,9999,2
1657991341956,MATH 197,003,095567,Xiao; Ming,9999,0,9999,0
1657991341956,MATH 197,004,095571,Perols; Johan Lars,9998,0,9999,1
1657991349028,COGS 9,A01,083615,Shannon; Kyle Michael,11,0,75,64
1657991355055,COGS 11,A01,083617,Boyle; Mary E. T.,23,0,48,25
1657991361080,COGS 13,A01,083071,Bastos; Amalia Pinkusfeld,12,0,71,59
1657991367104,COGS 14A,A01,092681,Semenuks; Arturs,5,1,100,95
1657991373139,COGS 14B,A01,083073,Cheng; Tzu-Han,7,0,63,56
1657991379166,COGS 17,A01,092677,Semenuks; Arturs,7,0,81,74
1657991385192,COGS 100,A01,083619,Allen; Michael Gordon,17,0,70,53
1657991391217,COGS 101A,A01,083621,Davis; Joshua Daniel,9,0,68,59
1657991397241,COGS 101B,A01,091572,Allen; Michael Gordon,14,0,65,51
1657991403266,COGS 101C,A01,083625,Delgado; Tania,17,0,35,18
1657991409292,COGS 107A,A01,083627,Boyle; Mary E. T.,14,0,60,46
1657991415316,COGS 118A,A01,083075,Gupta; Anjum,21,0,76,55
1657991421340,CSE 3,A50,083646,Miranda; Gregory Joseph,24,0,50,26
1657991427368,CSE 8A,A50,083650,Miranda; Gregory Joseph,17,1,56,39
1657991433392,CSE 11,A01,083080,Cao; Yingjun,7,15,40,33
1657991439422,CSE 12,A01,083652,Krause-Levy; Sophia Louisa,30,1,120,90
1657991445449,CSE 15L,A01,083654,Morris; Justin Loren,9,0,50,41
1657991445449,CSE 15L,A02,083655,Morris; Justin Loren,11,0,50,39
1657991451476,CSE 20,A01,083657,Tran; Khoa Dang,39,0,80,41
1657991457509,CSE 21,A01,095574,Bach; Quang Tran,23,0,48,25
1657991463537,CSE 30,A01,083084,Eldon; John,8,0,80,72
1657991463537,CSE 30,B01,095061,Bhaskar; Nishant,9,0,50,41
1657991469567,CSE 100,A01,083659,Cao; Yingjun,5,4,70,65
1657991475672,CSE 134B,A01,083661,Powell; Thomas Allan,25,0,100,75
1657991481708,CSE 140,A01,083663,Gungor; Onat,17,0,85,68
1657991487737,CSE 140L,A01,083088,Eldon; John,23,0,100,77
1657991493761,CSE 175,A01,083665,Kumar; Rakesh,3,0,25,22
1657991499787,CSE 190,A00,092507,Dubnov; Shlomo,8,0,20,12
1657991505815,ECE 45,A01,083139,Congero; Spencer William,7,0,75,68
1657991511840,ECE 65,A50,083695,Saad; Andrew S,12,0,30,18
1657991511840,ECE 65,A51,095125,Saad; Andrew S,24,0,26,2
1657991517869,ECE 109,A01,091882,Touri; Behrouz,21,0,70,49
1657991523898,ECE 180,A00,083140,Abi Samra; Nicholas Camill,1,0,30,29
1657991523898,ECE 180,B00,083141,Abi Samra; Nicholas Camill,0,0,30,30
1657991529921,MATH 10A,A01,083735,Patchell; Gregory David,2,0,30,28
1657991529921,MATH 10A,A02,083736,Patchell; Gregory David,20,0,30,10
1657991529921,MATH 10A,A03,083737,Patchell; Gregory David,16,0,30,14
1657991535948,MATH 10B,A01,083207,Lim; Seonhee,9,0,34,25
1657991535948,MATH 10B,A02,083208,Lim; Seonhee,10,0,35,25
1657991535948,MATH 10B,A03,093472,Lim; Seonhee,7,0,34,27
1657991535948,MATH 10B,B01,083739,Sinha; Shubham,14,0,30,16
1657991541973,MATH 18,A01,083743,Cinel; Cameron Alexander,9,0,30,21
1657991541973,MATH 18,A02,083744,Cinel; Cameron Alexander,18,0,30,12
1657991541973,MATH 18,A03,083745,Cinel; Cameron Alexander,10,0,30,20
1657991541973,MATH 18,B01,083748,Rideout; David Porter,5,0,37,32
1657991541973,MATH 18,B02,083749,Rideout; David Porter,5,0,36,31
1657991541973,MATH 18,B03,083750,Rideout; David Porter,3,0,37,34
1657991541973,MATH 18,B04,083751,Rideout; David Porter,7,0,36,29
1657991541973,MATH 18,B05,093473,Rideout; David Porter,7,0,36,29
1657991541973,MATH 18,B06,093474,Rideout; David Porter,6,0,36,30
1657991547996,MATH 20A,A01,083754,Zheng; Zequn,14,0,40,26
1657991554020,MATH 20B,A01,083756,Briones; Jor-el Thomas Caparas,4,0,36,32
1657991554020,MATH 20B,A02,083757,Briones; Jor-el Thomas Caparas,1,0,36,35
1657991554020,MATH 20B,A03,093475,Briones; Jor-el Thomas Caparas,3,0,36,33
1657991560050,MATH 20C,A01,083760,Briones; Jor-el Thomas Caparas,1,0,35,34
1657991560050,MATH 20C,A02,083761,Briones; Jor-el Thomas Caparas,8,0,35,27
1657991560050,MATH 20C,A03,093476,Briones; Jor-el Thomas Caparas,0,1,36,36
1657991560050,MATH 20C,B01,083762,Bach; Quang Tran,1,0,30,29
1657991566080,MATH 20D,A01,083765,Tran; Brian Kha,5,0,30,25
1657991566080,MATH 20D,A02,083766,Tran; Brian Kha,5,0,30,25
1657991566080,MATH 20D,A03,083767,Tran; Brian Kha,6,0,30,24
1657991572105,MATH 20E,A01,083771,Ganguly; Soumya,12,0,32,20
1657991572105,MATH 20E,A02,083772,Ganguly; Soumya,7,0,32,25
1657991572105,MATH 20E,B01,083773,Ciotti; Benjamin,20,0,35,15
1657991572105,MATH 20E,B02,083774,Ciotti; Benjamin,18,0,35,17
1657991578134,MATH 103A,A01,083777,Greenfeld; Be'Eri,6,0,36,30
1657991578134,MATH 103A,A02,083778,Greenfeld; Be'Eri,5,0,36,31
1657991578134,MATH 103A,A03,093561,Greenfeld; Be'Eri,7,0,36,29
1657991578134,MATH 103A,B01,083779,Greenfeld; Be'Eri,8,0,36,28
1657991578134,MATH 103A,B02,083780,Greenfeld; Be'Eri,4,0,36,32
1657991578134,MATH 103A,B03,093562,Greenfeld; Be'Eri,3,0,36,33
1657991584157,MATH 105,A01,085443,Carter; Anne Toulson,15,0,35,20
1657991584157,MATH 105,A02,093477,Carter; Anne Toulson,20,0,35,15
1657991590179,MATH 109,A01,083213,Ganzberger; Geoffrey Michael,3,0,34,31
1657991590179,MATH 109,A02,083214,Ganzberger; Geoffrey Michael,4,0,34,30
1657991590179,MATH 109,A03,093478,Ganzberger; Geoffrey Michael,2,0,34,32
1657991590179,MATH 109,B01,083215,Ganzberger; Geoffrey Michael,3,0,32,29
1657991590179,MATH 109,B02,083216,Ganzberger; Geoffrey Michael,3,0,32,29
1657991590179,MATH 109,B03,093479,Ganzberger; Geoffrey Michael,8,0,32,24
1657991596202,MATH 142A,A01,083219,Chow; Bennett,7,0,32,25
1657991596202,MATH 142A,A02,083220,Chow; Bennett,10,0,32,22
1657991596202,MATH 142A,A03,093480,Chow; Bennett,9,0,32,23
1657991596202,MATH 142A,B03,093481,Chow; Bennett,8,0,32,24
1657991596202,MATH 142A,B04,093558,Chow; Bennett,14,0,32,18
1657991596202,MATH 142A,B05,093559,Chow; Bennett,7,0,32,25
1657991602232,MATH 193A,A01,083224,Rotar; Vladimir,9,0,34,25
1657991602232,MATH 193A,A02,083225,Rotar; Vladimir,11,0,34,23
1657991602232,MATH 193A,A03,083781,Rotar; Vladimir,5,0,34,29
1657991602232,MATH 193A,A04,083782,Rotar; Vladimir,12,0,34,22
1657991602232,MATH 193A,A05,093482,Rotar; Vladimir,11,0,34,23
1657991608260,MATH 197,001,091859,McAuley; Julian John,9999,0,9999,0
1657991608260,MATH 197,002,095566,Kedlaya; Kiran S.,9997,0,9999,2
1657991608260,MATH 197,003,095567,Xiao; Ming,9999,0,9999,0
1657991608260,MATH 197,004,095571,Perols; Johan Lars,9998,0,9999,1
1657991615330,COGS 9,A01,083615,Shannon; Kyle Michael,11,0,75,64
1657991621354,COGS 11,A01,083617,Boyle; Mary E. T.,23,0,48,25
1657991627378,COGS 13,A01,083071,Bastos; Amalia Pinkusfeld,12,0,71,59
1657991633402,COGS 14A,A01,092681,Semenuks; Arturs,5,1,100,95
1657991639428,COGS 14B,A01,083073,Cheng; Tzu-Han,7,0,63,56
1657991645455,COGS 17,A01,092677,Semenuks; Arturs,7,0,81,74
1657991651480,COGS 100,A01,083619,Allen; Michael Gordon,17,0,70,53
1657991657505,COGS 101A,A01,083621,Davis; Joshua Daniel,9,0,68,59
1657991663534,COGS 101B,A01,091572,Allen; Michael Gordon,14,0,65,51
1657991669556,COGS 101C,A01,083625,Delgado; Tania,17,0,35,18
1657991675583,COGS 107A,A01,083627,Boyle; Mary E. T.,14,0,60,46
1657991681605,COGS 118A,A01,083075,Gupta; Anjum,21,0,76,55
1657991687628,CSE 3,A50,083646,Miranda; Gregory Joseph,24,0,50,26
1657991693652,CSE 8A,A50,083650,Miranda; Gregory Joseph,17,1,56,39
1657991699677,CSE 11,A01,083080,Cao; Yingjun,7,15,40,33
1657991705701,CSE 12,A01,083652,Krause-Levy; Sophia Louisa,30,1,120,90
1657991711725,CSE 15L,A01,083654,Morris; Justin Loren,9,0,50,41
1657991711725,CSE 15L,A02,083655,Morris; Justin Loren,11,0,50,39
1657991717758,CSE 20,A01,083657,Tran; Khoa Dang,39,0,80,41
1657991723782,CSE 21,A01,095574,Bach; Quang Tran,23,0,48,25
1657991729810,CSE 30,A01,083084,Eldon; John,8,0,80,72
1657991729810,CSE 30,B01,095061,Bhaskar; Nishant,9,0,50,41
1657991735832,CSE 100,A01,083659,Cao; Yingjun,5,4,70,65
1657991741855,CSE 134B,A01,083661,Powell; Thomas Allan,25,0,100,75
1657991747882,CSE 140,A01,083663,Gungor; Onat,17,0,85,68
1657991753910,CSE 140L,A01,083088,Eldon; John,23,0,100,77
1657991759938,CSE 175,A01,083665,Kumar; Rakesh,3,0,25,22
1657991765962,CSE 190,A00,092507,Dubnov; Shlomo,8,0,20,12
1657991771991,ECE 45,A01,083139,Congero; Spencer William,7,0,75,68
1657991778017,ECE 65,A50,083695,Saad; Andrew S,12,0,30,18
1657991778017,ECE 65,A51,095125,Saad; Andrew S,24,0,26,2
1657991784039,ECE 109,A01,091882,Touri; Behrouz,21,0,70,49
1657991790064,ECE 180,A00,083140,Abi Samra; Nicholas Camill,1,0,30,29
1657991790064,ECE 180,B00,083141,Abi Samra; Nicholas Camill,0,0,30,30
1657991796106,MATH 10A,A01,083735,Patchell; Gregory David,2,0,30,28
1657991796106,MATH 10A,A02,083736,Patchell; Gregory David,20,0,30,10
1657991796106,MATH 10A,A03,083737,Patchell; Gregory David,16,0,30,14
1657991802132,MATH 10B,A01,083207,Lim; Seonhee,9,0,34,25
1657991802132,MATH 10B,A02,083208,Lim; Seonhee,10,0,35,25
1657991802132,MATH 10B,A03,093472,Lim; Seonhee,7,0,34,27
1657991802132,MATH 10B,B01,083739,Sinha; Shubham,14,0,30,16
1657991808164,MATH 18,A01,083743,Cinel; Cameron Alexander,9,0,30,21
1657991808164,MATH 18,A02,083744,Cinel; Cameron Alexander,18,0,30,12
1657991808164,MATH 18,A03,083745,Cinel; Cameron Alexander,10,0,30,20
1657991808164,MATH 18,B01,083748,Rideout; David Porter,5,0,37,32
1657991808164,MATH 18,B02,083749,Rideout; David Porter,5,0,36,31
1657991808164,MATH 18,B03,083750,Rideout; David Porter,3,0,37,34
1657991808164,MATH 18,B04,083751,Rideout; David Porter,7,0,36,29
1657991808164,MATH 18,B05,093473,Rideout; David Porter,7,0,36,29
1657991808164,MATH 18,B06,093474,Rideout; David Porter,6,0,36,30
1657991814185,MATH 20A,A01,083754,Zheng; Zequn,14,0,40,26
1657991820212,MATH 20B,A01,083756,Briones; Jor-el Thomas Caparas,4,0,36,32
1657991820212,MATH 20B,A02,083757,Briones; Jor-el Thomas Caparas,1,0,36,35
1657991820212,MATH 20B,A03,093475,Briones; Jor-el Thomas Caparas,3,0,36,33
1657991826236,MATH 20C,A01,083760,Briones; Jor-el Thomas Caparas,1,0,35,34
1657991826236,MATH 20C,A02,083761,Briones; Jor-el Thomas Caparas,8,0,35,27
1657991826236,MATH 20C,A03,093476,Briones; Jor-el Thomas Caparas,0,1,36,36
1657991826236,MATH 20C,B01,083762,Bach; Quang Tran,1,0,30,29
1657991832261,MATH 20D,A01,083765,Tran; Brian Kha,5,0,30,25
1657991832261,MATH 20D,A02,083766,Tran; Brian Kha,5,0,30,25
1657991832261,MATH 20D,A03,083767,Tran; Brian Kha,6,0,30,24
1657991838289,MATH 20E,A01,083771,Ganguly; Soumya,12,0,32,20
1657991838289,MATH 20E,A02,083772,Ganguly; Soumya,7,0,32,25
1657991838289,MATH 20E,B01,083773,Ciotti; Benjamin,20,0,35,15
1657991838289,MATH 20E,B02,083774,Ciotti; Benjamin,18,0,35,17
1657991844314,MATH 103A,A01,083777,Greenfeld; Be'Eri,6,0,36,30
1657991844314,MATH 103A,A02,083778,Greenfeld; Be'Eri,5,0,36,31
1657991844314,MATH 103A,A03,093561,Greenfeld; Be'Eri,7,0,36,29
1657991844314,MATH 103A,B01,083779,Greenfeld; Be'Eri,8,0,36,28
1657991844314,MATH 103A,B02,083780,Greenfeld; Be'Eri,4,0,36,32
1657991844314,MATH 103A,B03,093562,Greenfeld; Be'Eri,3,0,36,33
1657991850336,MATH 105,A01,085443,Carter; Anne Toulson,15,0,35,20
1657991850336,MATH 105,A02,093477,Carter; Anne Toulson,20,0,35,15
1657991856365,MATH 109,A01,083213,Ganzberger; Geoffrey Michael,3,0,34,31
1657991856365,MATH 109,A02,083214,Ganzberger; Geoffrey Michael,4,0,34,30
1657991856365,MATH 109,A03,093478,Ganzberger; Geoffrey Michael,2,0,34,32
1657991856365,MATH 109,B01,083215,Ganzberger; Geoffrey Michael,3,0,32,29
1657991856365,MATH 109,B02,083216,Ganzberger; Geoffrey Michael,3,0,32,29
1657991856365,MATH 109,B03,093479,Ganzberger; Geoffrey Michael,8,0,32,24
1657991866623,MATH 142A,A01,083219,Chow; Bennett,7,0,32,25
1657991866623,MATH 142A,A02,083220,Chow; Bennett,10,0,32,22
1657991866623,MATH 142A,A03,093480,Chow; Bennett,9,0,32,23
1657991866623,MATH 142A,B03,093481,Chow; Bennett,8,0,32,24
1657991866623,MATH 142A,B04,093558,Chow; Bennett,14,0,32,18
1657991866623,MATH 142A,B05,093559,Chow; Bennett,7,0,32,25
1657991872645,MATH 193A,A01,083224,Rotar; Vladimir,9,0,34,25
1657991872645,MATH 193A,A02,083225,Rotar; Vladimir,11,0,34,23
1657991872645,MATH 193A,A03,083781,Rotar; Vladimir,5,0,34,29
1657991872645,MATH 193A,A04,083782,Rotar; Vladimir,12,0,34,22
1657991872645,MATH 193A,A05,093482,Rotar; Vladimir,11,0,34,23
1657991878672,MATH 197,001,091859,McAuley; Julian John,9999,0,9999,0
1657991878672,MATH 197,002,095566,Kedlaya; Kiran S.,9997,0,9999,2
1657991878672,MATH 197,003,095567,Xiao; Ming,9999,0,9999,0
1657991878672,MATH 197,004,095571,Perols; Johan Lars,9998,0,9999,1
1657991885727,COGS 9,A01,083615,Shannon; Kyle Michael,11,0,75,64
1657991891752,COGS 11,A01,083617,Boyle; Mary E. T.,23,0,48,25
1657991897778,COGS 13,A01,083071,Bastos; Amalia Pinkusfeld,12,0,71,59
1657991903819,COGS 14A,A01,092681,Semenuks; Arturs,5,1,100,95
1657991909845,COGS 14B,A01,083073,Cheng; Tzu-Han,7,0,63,56
1657991915872,COGS 17,A01,092677,Semenuks; Arturs,7,0,81,74
1657991921895,COGS 100,A01,083619,Allen; Michael Gordon,17,0,70,53
1657991927918,COGS 101A,A01,083621,Davis; Joshua Daniel,9,0,68,59
1657991933944,COGS 101B,A01,091572,Allen; Michael Gordon,14,0,65,51
1657991939967,COGS 101C,A01,083625,Delgado; Tania,17,0,35,18
1657991945994,COGS 107A,A01,083627,Boyle; Mary E. T.,14,0,60,46
1657991952017,COGS 118A,A01,083075,Gupta; Anjum,21,0,76,55
1657991958040,CSE 3,A50,083646,Miranda; Gregory Joseph,24,0,50,26
1657991964063,CSE 8A,A50,083650,Miranda; Gregory Joseph,17,1,56,39
1657991970088,CSE 11,A01,083080,Cao; Yingjun,7,15,40,33
1657991976115,CSE 12,A01,083652,Krause-Levy; Sophia Louisa,30,1,120,90
1657991982141,CSE 15L,A01,083654,Morris; Justin Loren,9,0,50,41
1657991982141,CSE 15L,A02,083655,Morris; Justin Loren,11,0,50,39
1657991988172,CSE 20,A01,083657,Tran; Khoa Dang,39,0,80,41
1657991994195,CSE 21,A01,095574,Bach; Quang Tran,23,0,48,25
1657992000221,CSE 30,A01,083084,Eldon; John,8,0,80,72
1657992000221,CSE 30,B01,095061,Bhaskar; Nishant,9,0,50,41
1657992006251,CSE 100,A01,083659,Cao; Yingjun,5,4,70,65
1657992012282,CSE 134B,A01,083661,Powell; Thomas Allan,25,0,100,75
1657992018308,CSE 140,A01,083663,Gungor; Onat,17,0,85,68
1657992024331,CSE 140L,A01,083088,Eldon; John,23,0,100,77
1657992030367,CSE 175,A01,083665,Kumar; Rakesh,3,0,25,22
1657992036391,CSE 190,A00,092507,Dubnov; Shlomo,8,0,20,12
1657992042414,ECE 45,A01,083139,Congero; Spencer William,7,0,75,68
1657992048441,ECE 65,A50,083695,Saad; Andrew S,12,0,30,18
1657992048441,ECE 65,A51,095125,Saad; Andrew S,24,0,26,2
1657992054484,ECE 109,A01,091882,Touri; Behrouz,21,0,70,49
1657992060507,ECE 180,A00,083140,Abi Samra; Nicholas Camill,1,0,30,29
1657992060507,ECE 180,B00,083141,Abi Samra; Nicholas Camill,0,0,30,30
1657992066533,MATH 10A,A01,083735,Patchell; Gregory David,2,0,30,28
1657992066533,MATH 10A,A02,083736,Patchell; Gregory David,20,0,30,10
1657992066533,MATH 10A,A03,083737,Patchell; Gregory David,16,0,30,14
1657992072561,MATH 10B,A01,083207,Lim; Seonhee,9,0,34,25
1657992072561,MATH 10B,A02,083208,Lim; Seonhee,10,0,35,25
1657992072561,MATH 10B,A03,093472,Lim; Seonhee,7,0,34,27
1657992072561,MATH 10B,B01,083739,Sinha; Shubham,14,0,30,16
1657992078670,MATH 18,A01,083743,Cinel; Cameron Alexander,9,0,30,21
1657992078670,MATH 18,A02,083744,Cinel; Cameron Alexander,18,0,30,12
1657992078670,MATH 18,A03,083745,Cinel; Cameron Alexander,10,0,30,20
1657992078670,MATH 18,B01,083748,Rideout; David Porter,5,0,37,32
1657992078670,MATH 18,B02,083749,Rideout; David Porter,5,0,36,31
1657992078670,MATH 18,B03,083750,Rideout; David Porter,3,0,37,34
1657992078670,MATH 18,B04,083751,Rideout; David Porter,7,0,36,29
1657992078670,MATH 18,B05,093473,Rideout; David Porter,7,0,36,29
1657992078670,MATH 18,B06,093474,Rideout; David Porter,6,0,36,30
1657992084699,MATH 20A,A01,083754,Zheng; Zequn,14,0,40,26
1657992090721,MATH 20B,A01,083756,Briones; Jor-el Thomas Caparas,4,0,36,32
1657992090721,MATH 20B,A02,083757,Briones; Jor-el Thomas Caparas,1,0,36,35
1657992090721,MATH 20B,A03,093475,Briones; Jor-el Thomas Caparas,3,0,36,33
1657992096749,MATH 20C,A01,083760,Briones; Jor-el Thomas Caparas,1,0,35,34
1657992096749,MATH 20C,A02,083761,Briones; Jor-el Thomas Caparas,8,0,35,27
1657992096749,MATH 20C,A03,093476,Briones; Jor-el Thomas Caparas,0,1,36,36
1657992096749,MATH 20C,B01,083762,Bach; Quang Tran,1,0,30,29
1657992102772,MATH 20D,A01,083765,Tran; Brian Kha,5,0,30,25
1657992102772,MATH 20D,A02,083766,Tran; Brian Kha,5,0,30,25
1657992102772,MATH 20D,A03,083767,Tran; Brian Kha,6,0,30,24
1657992108795,MATH 20E,A01,083771,Ganguly; Soumya,12,0,32,20
1657992108795,MATH 20E,A02,083772,Ganguly; Soumya,7,0,32,25
1657992108795,MATH 20E,B01,083773,Ciotti; Benjamin,20,0,35,15
1657992108795,MATH 20E,B02,083774,Ciotti; Benjamin,18,0,35,17
1657992114818,MATH 103A,A01,083777,Greenfeld; Be'Eri,6,0,36,30
1657992114818,MATH 103A,A02,083778,Greenfeld; Be'Eri,5,0,36,31
1657992114818,MATH 103A,A03,093561,Greenfeld; Be'Eri,7,0,36,29
1657992114818,MATH 103A,B01,083779,Greenfeld; Be'Eri,8,0,36,28
1657992114818,MATH 103A,B02,083780,Greenfeld; Be'Eri,4,0,36,32
1657992114818,MATH 103A,B03,093562,Greenfeld; Be'Eri,3,0,36,33
1657992120842,MATH 105,A01,085443,Carter; Anne Toulson,15,0,35,20
1657992120842,MATH 105,A02,093477,Carter; Anne Toulson,20,0,35,15
1657992126868,MATH 109,A01,083213,Ganzberger; Geoffrey Michael,3,0,34,31
1657992126868,MATH 109,A02,083214,Ganzberger; Geoffrey Michael,4,0,34,30
1657992126868,MATH 109,A03,093478,Ganzberger; Geoffrey Michael,2,0,34,32
1657992126868,MATH 109,B01,083215,Ganzberger; Geoffrey Michael,3,0,32,29
1657992126868,MATH 109,B02,083216,Ganzberger; Geoffrey Michael,3,0,32,29
1657992126868,MATH 109,B03,093479,Ganzberger; Geoffrey Michael,8,0,32,24
1657992132900,MATH 142A,A01,083219,Chow; Bennett,7,0,32,25
1657992132900,MATH 142A,A02,083220,Chow; Bennett,10,0,32,22
1657992132900,MATH 142A,A03,093480,Chow; Bennett,9,0,32,23
1657992132900,MATH 142A,B03,093481,Chow; Bennett,8,0,32,24
1657992132900,MATH 142A,B04,093558,Chow; Bennett,14,0,32,18
1657992132900,MATH 142A,B05,093559,Chow; Bennett,7,0,32,25
1657992138927,MATH 193A,A01,083224,Rotar; Vladimir,9,0,34,25
1657992138927,MATH 193A,A02,083225,Rotar; Vladimir,11,0,34,23
1657992138927,MATH 193A,A03,083781,Rotar; Vladimir,5,0,34,29
1657992138927,MATH 193A,A04,083782,Rotar; Vladimir,12,0,34,22
1657992138927,MATH 193A,A05,093482,Rotar; Vladimir,11,0,34,23
1657992144951,MATH 197,001,091859,McAuley; Julian John,9999,0,9999,0
1657992144951,MATH 197,002,095566,Kedlaya; Kiran S.,9997,0,9999,2
1657992144951,MATH 197,003,095567,Xiao; Ming,9999,0,9999,0
1657992144951,MATH 197,004,095571,Perols; Johan Lars,9998,0,9999,1
1657992152009,COGS 9,A01,083615,Shannon; Kyle Michael,11,0,75,64
1657992158064,COGS 11,A01,083617,Boyle; Mary E. T.,23,0,48,25
1657992164090,COGS 13,A01,083071,Bastos; Amalia Pinkusfeld,12,0,71,59
1657992170111,COGS 14A,A01,092681,Semenuks; Arturs,5,1,100,95
1657992176137,COGS 14B,A01,083073,Cheng; Tzu-Han,7,0,63,56
1657992182161,COGS 17,A01,092677,Semenuks; Arturs,7,0,81,74
1657992188186,COGS 100,A01,083619,Allen; Michael Gordon,17,0,70,53
1657992194214,COGS 101A,A01,083621,Davis; Joshua Daniel,9,0,68,59
1657992200237,COGS 101B,A01,091572,Allen; Michael Gordon,14,0,65,51
1657992206262,COGS 101C,A01,083625,Delgado; Tania,17,0,35,18
1657992212288,COGS 107A,A01,083627,Boyle; Mary E. T.,14,0,60,46
1657992218315,COGS 118A,A01,083075,Gupta; Anjum,21,0,76,55
1657992224337,CSE 3,A50,083646,Miranda; Gregory Joseph,24,0,50,26
1657992230363,CSE 8A,A50,083650,Miranda; Gregory Joseph,17,1,56,39
1657992236391,CSE 11,A01,083080,Cao; Yingjun,7,15,40,33
1657992242413,CSE 12,A01,083652,Krause-Levy; Sophia Louisa,30,1,120,90
1657992248437,CSE 15L,A01,083654,Morris; Justin Loren,9,0,50,41
1657992248437,CSE 15L,A02,083655,Morris; Justin Loren,11,0,50,39
1657992254466,CSE 20,A01,083657,Tran; Khoa Dang,39,0,80,41
1657992260488,CSE 21,A01,095574,Bach; Quang Tran,23,0,48,25
1657992266510,CSE 30,A01,083084,Eldon; John,8,0,80,72
1657992266510,CSE 30,B01,095061,Bhaskar; Nishant,9,0,50,41
1657992272536,CSE 100,A01,083659,Cao; Yingjun,5,4,70,65
1657992278561,CSE 134B,A01,083661,Powell; Thomas Allan,25,0,100,75
1657992284677,CSE 140,A01,083663,Gungor; Onat,17,0,85,68
1657992290704,CSE 140L,A01,083088,Eldon; John,23,0,100,77
1657992296727,CSE 175,A01,083665,Kumar; Rakesh,3,0,25,22
1657992302751,CSE 190,A00,092507,Dubnov; Shlomo,8,0,20,12
1657992308779,ECE 45,A01,083139,Congero; Spencer William,7,0,75,68
1657992314802,ECE 65,A50,083695,Saad; Andrew S,12,0,30,18
1657992314802,ECE 65,A51,095125,Saad; Andrew S,24,0,26,2
1657992320825,ECE 109,A01,091882,Touri; Behrouz,21,0,70,49
1657992326847,ECE 180,A00,083140,Abi Samra; Nicholas Camill,1,0,30,29
1657992326847,ECE 180,B00,083141,Abi Samra; Nicholas Camill,0,0,30,30
1657992332884,MATH 10A,A01,083735,Patchell; Gregory David,2,0,30,28
1657992332884,MATH 10A,A02,083736,Patchell; Gregory David,20,0,30,10
1657992332884,MATH 10A,A03,083737,Patchell; Gregory David,16,0,30,14
1657992338908,MATH 10B,A01,083207,Lim; Seonhee,9,0,34,25
1657992338908,MATH 10B,A02,083208,Lim; Seonhee,10,0,35,25
1657992338908,MATH 10B,A03,093472,Lim; Seonhee,7,0,34,27
1657992338908,MATH 10B,B01,083739,Sinha; Shubham,14,0,30,16
1657992344937,MATH 18,A01,083743,Cinel; Cameron Alexander,9,0,30,21
1657992344937,MATH 18,A02,083744,Cinel; Cameron Alexander,18,0,30,12
1657992344937,MATH 18,A03,083745,Cinel; Cameron Alexander,10,0,30,20
1657992344937,MATH 18,B01,083748,Rideout; David Porter,5,0,37,32
1657992344937,MATH 18,B02,083749,Rideout; David Porter,5,0,36,31
1657992344937,MATH 18,B03,083750,Rideout; David Porter,3,0,37,34
1657992344937,MATH 18,B04,083751,Rideout; David Porter,7,0,36,29
1657992344937,MATH 18,B05,093473,Rideout; David Porter,7,0,36,29
1657992344937,MATH 18,B06,093474,Rideout; David Porter,6,0,36,30
1657992350962,MATH 20A,A01,083754,Zheng; Zequn,14,0,40,26
1657992356986,MATH 20B,A01,083756,Briones; Jor-el Thomas Caparas,4,0,36,32
1657992356986,MATH 20B,A02,083757,Briones; Jor-el Thomas Caparas,1,0,36,35
1657992356986,MATH 20B,A03,093475,Briones; Jor-el Thomas Caparas,3,0,36,33
1657992363017,MATH 20C,A01,083760,Briones; Jor-el Thomas Caparas,1,0,35,34
1657992363017,MATH 20C,A02,083761,Briones; Jor-el Thomas Caparas,8,0,35,27
1657992363017,MATH 20C,A03,093476,Briones; Jor-el Thomas Caparas,0,1,36,36
1657992363017,MATH 20C,B01,083762,Bach; Quang Tran,1,0,30,29
1657992369040,MATH 20D,A01,083765,Tran; Brian Kha,5,0,30,25
1657992369040,MATH 20D,A02,083766,Tran; Brian Kha,5,0,30,25
1657992369040,MATH 20D,A03,083767,Tran; Brian Kha,6,0,30,24
1657992375063,MATH 20E,A01,083771,Ganguly; Soumya,12,0,32,20
1657992375063,MATH 20E,A02,083772,Ganguly; Soumya,7,0,32,25
1657992375063,MATH 20E,B01,083773,Ciotti; Benjamin,20,0,35,15
1657992375063,MATH 20E,B02,083774,Ciotti; Benjamin,18,0,35,17
1657992381089,MATH 103A,A01,083777,Greenfeld; Be'Eri,6,0,36,30
1657992381089,MATH 103A,A02,083778,Greenfeld; Be'Eri,5,0,36,31
1657992381089,MATH 103A,A03,093561,Greenfeld; Be'Eri,7,0,36,29
1657992381089,MATH 103A,B01,083779,Greenfeld; Be'Eri,8,0,36,28
1657992381089,MATH 103A,B02,083780,Greenfeld; Be'Eri,4,0,36,32
1657992381089,MATH 103A,B03,093562,Greenfeld; Be'Eri,3,0,36,33
1657992387114,MATH 105,A01,085443,Carter; Anne Toulson,15,0,35,20
1657992387114,MATH 105,A02,093477,Carter; Anne Toulson,20,0,35,15
1657992393138,MATH 109,A01,083213,Ganzberger; Geoffrey Michael,3,0,34,31
1657992393138,MATH 109,A02,083214,Ganzberger; Geoffrey Michael,4,0,34,30
1657992393138,MATH 109,A03,093478,Ganzberger; Geoffrey Michael,2,0,34,32
1657992393138,MATH 109,B01,083215,Ganzberger; Geoffrey Michael,3,0,32,29
1657992393138,MATH 109,B02,083216,Ganzberger; Geoffrey Michael,3,0,32,29
1657992393138,MATH 109,B03,093479,Ganzberger; Geoffrey Michael,8,0,32,24
1657992399166,MATH 142A,A01,083219,Chow; Bennett,7,0,32,25
1657992399166,MATH 142A,A02,083220,Chow; Bennett,10,0,32,22
1657992399166,MATH 142A,A03,093480,Chow; Bennett,9,0,32,23
1657992399166,MATH 142A,B03,093481,Chow; Bennett,8,0,32,24
1657992399166,MATH 142A,B04,093558,Chow; Bennett,14,0,32,18
1657992399166,MATH 142A,B05,093559,Chow; Bennett,7,0,32,25
1657992405193,MATH 193A,A01,083224,Rotar; Vladimir,9,0,34,25
1657992405193,MATH 193A,A02,083225,Rotar; Vladimir,11,0,34,23
1657992405193,MATH 193A,A03,083781,Rotar; Vladimir,5,0,34,29
1657992405193,MATH 193A,A04,083782,Rotar; Vladimir,12,0,34,22
1657992405193,MATH 193A,A05,093482,Rotar; Vladimir,11,0,34,23
1657992411216,MATH 197,001,091859,McAuley; Julian John,9999,0,9999,0
1657992411216,MATH 197,002,095566,Kedlaya; Kiran S.,9997,0,9999,2
1657992411216,MATH 197,003,095567,Xiao; Ming,9999,0,9999,0
1657992411216,MATH 197,004,095571,Perols; Johan Lars,9998,0,9999,1
1657992418270,COGS 9,A01,083615,Shannon; Kyle Michael,11,0,75,64
1657992424293,COGS 11,A01,083617,Boyle; Mary E. T.,23,0,48,25
1657992430318,COGS 13,A01,083071,Bastos; Amalia Pinkusfeld,12,0,71,59
1657992436344,COGS 14A,A01,092681,Semenuks; Arturs,5,1,100,95
1657992442367,COGS 14B,A01,083073,Cheng; Tzu-Han,7,0,63,56
1657992448390,COGS 17,A01,092677,Semenuks; Arturs,7,0,81,74
1657992454417,COGS 100,A01,083619,Allen; Michael Gordon,17,0,70,53
1657992460444,COGS 101A,A01,083621,Davis; Joshua Daniel,9,0,68,59
1657992466470,COGS 101B,A01,091572,Allen; Michael Gordon,14,0,65,51
1657992472497,COGS 101C,A01,083625,Delgado; Tania,17,0,35,18
1657992478524,COGS 107A,A01,083627,Boyle; Mary E. T.,14,0,60,46
1657992484553,COGS 118A,A01,083075,Gupta; Anjum,21,0,76,55
1657992490580,CSE 3,A50,083646,Miranda; Gregory Joseph,24,0,50,26
1657992496607,CSE 8A,A50,083650,Miranda; Gregory Joseph,17,1,56,39
1657992502629,CSE 11,A01,083080,Cao; Yingjun,7,15,40,33
1657992508656,CSE 12,A01,083652,Krause-Levy; Sophia Louisa,30,1,120,90
1657992514683,CSE 15L,A01,083654,Morris; Justin Loren,9,0,50,41
1657992514683,CSE 15L,A02,083655,Morris; Justin Loren,11,0,50,39
1657992520707,CSE 20,A01,083657,Tran; Khoa Dang,39,0,80,41
1657992526730,CSE 21,A01,095574,Bach; Quang Tran,23,0,48,25
1657992532751,CSE 30,A01,083084,Eldon; John,8,0,80,72
1657992532751,CSE 30,B01,095061,Bhaskar; Nishant,9,0,50,41
1657992538779,CSE 100,A01,083659,Cao; Yingjun,5,4,70,65
1657992544804,CSE 134B,A01,083661,Powell; Thomas Allan,25,0,100,75
1657992550826,CSE 140,A01,083663,Gungor; Onat,17,0,85,68
1657992556852,CSE 140L,A01,083088,Eldon; John,23,0,100,77
1657992562877,CSE 175,A01,083665,Kumar; Rakesh,3,0,25,22
1657992568903,CSE 190,A00,092507,Dubnov; Shlomo,8,0,20,12
1657992574932,ECE 45,A01,083139,Congero; Spencer William,7,0,75,68
1657992580977,ECE 65,A50,083695,Saad; Andrew S,12,0,30,18
1657992580977,ECE 65,A51,095125,Saad; Andrew S,24,0,26,2
1657992587009,ECE 109,A01,091882,Touri; Behrouz,21,0,70,49
1657992593036,ECE 180,A00,083140,Abi Samra; Nicholas Camill,1,0,30,29
1657992593036,ECE 180,B00,083141,Abi Samra; Nicholas Camill,0,0,30,30
1657992599059,MATH 10A,A01,083735,Patchell; Gregory David,2,0,30,28
1657992599059,MATH 10A,A02,083736,Patchell; Gregory David,20,0,30,10
1657992599059,MATH 10A,A03,083737,Patchell; Gregory David,16,0,30,14
1657992605082,MATH 10B,A01,083207,Lim; Seonhee,9,0,34,25
1657992605082,MATH 10B,A02,083208,Lim; Seonhee,10,0,35,25
1657992605082,MATH 10B,A03,093472,Lim; Seonhee,7,0,34,27
1657992605082,MATH 10B,B01,083739,Sinha; Shubham,14,0,30,16
1657992611113,MATH 18,A01,083743,Cinel; Cameron Alexander,9,0,30,21
1657992611113,MATH 18,A02,083744,Cinel; Cameron Alexander,18,0,30,12
1657992611113,MATH 18,A03,083745,Cinel; Cameron Alexander,10,0,30,20
1657992611113,MATH 18,B01,083748,Rideout; David Porter,5,0,37,32
1657992611113,MATH 18,B02,083749,Rideout; David Porter,5,0,36,31
1657992611113,MATH 18,B03,083750,Rideout; David Porter,3,0,37,34
1657992611113,MATH 18,B04,083751,Rideout; David Porter,7,0,36,29
1657992611113,MATH 18,B05,093473,Rideout; David Porter,7,0,36,29
1657992611113,MATH 18,B06,093474,Rideout; David Porter,6,0,36,30
1657992617138,MATH 20A,A01,083754,Zheng; Zequn,14,0,40,26
1657992623160,MATH 20B,A01,083756,Briones; Jor-el Thomas Caparas,4,0,36,32
1657992623160,MATH 20B,A02,083757,Briones; Jor-el Thomas Caparas,1,0,36,35
1657992623160,MATH 20B,A03,093475,Briones; Jor-el Thomas Caparas,3,0,36,33
1657992629188,MATH 20C,A01,083760,Briones; Jor-el Thomas Caparas,1,0,35,34
1657992629188,MATH 20C,A02,083761,Briones; Jor-el Thomas Caparas,8,0,35,27
1657992629188,MATH 20C,A03,093476,Briones; Jor-el Thomas Caparas,0,1,36,36
1657992629188,MATH 20C,B01,083762,Bach; Quang Tran,1,0,30,29
1657992635211,MATH 20D,A01,083765,Tran; Brian Kha,5,0,30,25
1657992635211,MATH 20D,A02,083766,Tran; Brian Kha,5,0,30,25
1657992635211,MATH 20D,A03,083767,Tran; Brian Kha,6,0,30,24
1657992641235,MATH 20E,A01,083771,Ganguly; Soumya,12,0,32,20
1657992641235,MATH 20E,A02,083772,Ganguly; Soumya,7,0,32,25
1657992641235,MATH 20E,B01,083773,Ciotti; Benjamin,20,0,35,15
1657992641235,MATH 20E,B02,083774,Ciotti; Benjamin,18,0,35,17
1657992647261,MATH 103A,A01,083777,Greenfeld; Be'Eri,6,0,36,30
1657992647261,MATH 103A,A02,083778,Greenfeld; Be'Eri,5,0,36,31
1657992647261,MATH 103A,A03,093561,Greenfeld; Be'Eri,7,0,36,29
1657992647261,MATH 103A,B01,083779,Greenfeld; Be'Eri,8,0,36,28
1657992647261,MATH 103A,B02,083780,Greenfeld; Be'Eri,4,0,36,32
1657992647261,MATH 103A,B03,093562,Greenfeld; Be'Eri,3,0,36,33
1657992653284,MATH 105,A01,085443,Carter; Anne Toulson,15,0,35,20
1657992653284,MATH 105,A02,093477,Carter; Anne Toulson,20,0,35,15
1657992659313,MATH 109,A01,083213,Ganzberger; Geoffrey Michael,3,0,34,31
1657992659313,MATH 109,A02,083214,Ganzberger; Geoffrey Michael,4,0,34,30
1657992659313,MATH 109,A03,093478,Ganzberger; Geoffrey Michael,2,0,34,32
1657992659313,MATH 109,B01,083215,Ganzberger; Geoffrey Michael,3,0,32,29
1657992659313,MATH 109,B02,083216,Ganzberger; Geoffrey Michael,3,0,32,29
1657992659313,MATH 109,B03,093479,Ganzberger; Geoffrey Michael,8,0,32,24
1657992665344,MATH 142A,A01,083219,Chow; Bennett,7,0,32,25
1657992665344,MATH 142A,A02,083220,Chow; Bennett,10,0,32,22
1657992665344,MATH 142A,A03,093480,Chow; Bennett,9,0,32,23
1657992665344,MATH 142A,B03,093481,Chow; Bennett,8,0,32,24
1657992665344,MATH 142A,B04,093558,Chow; Bennett,14,0,32,18
1657992665344,MATH 142A,B05,093559,Chow; Bennett,7,0,32,25
1657992671372,MATH 193A,A01,083224,Rotar; Vladimir,9,0,34,25
1657992671372,MATH 193A,A02,083225,Rotar; Vladimir,11,0,34,23
1657992671372,MATH 193A,A03,083781,Rotar; Vladimir,5,0,34,29
1657992671372,MATH 193A,A04,083782,Rotar; Vladimir,12,0,34,22
1657992671372,MATH 193A,A05,093482,Rotar; Vladimir,11,0,34,23
1657992677477,MATH 197,001,091859,McAuley; Julian John,9999,0,9999,0
1657992677477,MATH 197,002,095566,Kedlaya; Kiran S.,9997,0,9999,2
1657992677477,MATH 197,003,095567,Xiao; Ming,9999,0,9999,0
1657992677477,MATH 197,004,095571,Perols; Johan Lars,9998,0,9999,1
1657992684546,COGS 9,A01,083615,Shannon; Kyle Michael,11,0,75,64
1657992690573,COGS 11,A01,083617,Boyle; Mary E. T.,23,0,48,25
1657992696599,COGS 13,A01,083071,Bastos; Amalia Pinkusfeld,12,0,71,59
1657992702624,COGS 14A,A01,092681,Semenuks; Arturs,5,1,100,95
1657992708647,COGS 14B,A01,083073,Cheng; Tzu-Han,7,0,63,56
1657992714673,COGS 17,A01,092677,Semenuks; Arturs,7,0,81,74
1657992720695,COGS 100,A01,083619,Allen; Michael Gordon,17,0,70,53
1657992726717,COGS 101A,A01,083621,Davis; Joshua Daniel,9,0,68,59
1657992732739,COGS 101B,A01,091572,Allen; Michael Gordon,14,0,65,51
1657992738766,COGS 101C,A01,083625,Delgado; Tania,17,0,35,18
1657992744793,COGS 107A,A01,083627,Boyle; Mary E. T.,14,0,60,46
1657992750820,COGS 118A,A01,083075,Gupta; Anjum,21,0,76,55
1657992756842,CSE 3,A50,083646,Miranda; Gregory Joseph,24,0,50,26
1657992762869,CSE 8A,A50,083650,Miranda; Gregory Joseph,17,1,56,39
1657992768894,CSE 11,A01,083080,Cao; Yingjun,7,15,40,33
1657992774921,CSE 12,A01,083652,Krause-Levy; Sophia Louisa,30,1,120,90
1657992780943,CSE 15L,A01,083654,Morris; Justin Loren,9,0,50,41
1657992780943,CSE 15L,A02,083655,Morris; Justin Loren,11,0,50,39
1657992786969,CSE 20,A01,083657,Tran; Khoa Dang,39,0,80,41
1657992792991,CSE 21,A01,095574,Bach; Quang Tran,23,0,48,25
1657992799014,CSE 30,A01,083084,Eldon; John,8,0,80,72
1657992799014,CSE 30,B01,095061,Bhaskar; Nishant,9,0,50,41
1657992805037,CSE 100,A01,083659,Cao; Yingjun,5,4,70,65
1657992811060,CSE 134B,A01,083661,Powell; Thomas Allan,25,0,100,75
1657992817088,CSE 140,A01,083663,Gungor; Onat,17,0,85,68
1657992823114,CSE 140L,A01,083088,Eldon; John,23,0,100,77
1657992829137,CSE 175,A01,083665,Kumar; Rakesh,3,0,25,22
1657992835159,CSE 190,A00,092507,Dubnov; Shlomo,8,0,20,12
1657992841181,ECE 45,A01,083139,Congero; Spencer William,7,0,75,68
1657992847209,ECE 65,A50,083695,Saad; Andrew S,12,0,30,18
1657992847209,ECE 65,A51,095125,Saad; Andrew S,24,0,26,2
1657992853232,ECE 109,A01,091882,Touri; Behrouz,21,0,70,49
1657992859255,ECE 180,A00,083140,Abi Samra; Nicholas Camill,1,0,30,29
1657992859255,ECE 180,B00,083141,Abi Samra; Nicholas Camill,0,0,30,30
1657992865278,MATH 10A,A01,083735,Patchell; Gregory David,2,0,30,28
1657992865278,MATH 10A,A02,083736,Patchell; Gregory David,20,0,30,10
1657992865278,MATH 10A,A03,083737,Patchell; Gregory David,16,0,30,14
1657992871302,MATH 10B,A01,083207,Lim; Seonhee,9,0,34,25
1657992871302,MATH 10B,A02,083208,Lim; Seonhee,10,0,35,25
1657992871302,MATH 10B,A03,093472,Lim; Seonhee,7,0,34,27
1657992871302,MATH 10B,B01,083739,Sinha; Shubham,14,0,30,16
1657992877331,MATH 18,A01,083743,Cinel; Cameron Alexander,9,0,30,21
1657992877331,MATH 18,A02,083744,Cinel; Cameron Alexander,18,0,30,12
1657992877331,MATH 18,A03,083745,Cinel; Cameron Alexander,10,0,30,20
1657992877331,MATH 18,B01,083748,Rideout; David Porter,5,0,37,32
1657992877331,MATH 18,B02,083749,Rideout; David Porter,5,0,36,31
1657992877331,MATH 18,B03,083750,Rideout; David Porter,3,0,37,34
1657992877331,MATH 18,B04,083751,Rideout; David Porter,7,0,36,29
1657992877331,MATH 18,B05,093473,Rideout; David Porter,7,0,36,29
1657992877331,MATH 18,B06,093474,Rideout; David Porter,6,0,36,30
1657992883354,MATH 20A,A01,083754,Zheng; Zequn,14,0,40,26
1657992889377,MATH 20B,A01,083756,Briones; Jor-el Thomas Caparas,4,0,36,32
1657992889377,MATH 20B,A02,083757,Briones; Jor-el Thomas Caparas,1,0,36,35
1657992889377,MATH 20B,A03,093475,Briones; Jor-el Thomas Caparas,3,0,36,33
1657992895400,MATH 20C,A01,083760,Briones; Jor-el Thomas Caparas,1,0,35,34
1657992895400,MATH 20C,A02,083761,Briones; Jor-el Thomas Caparas,8,0,35,27
1657992895400,MATH 20C,A03,093476,Briones; Jor-el Thomas Caparas,0,1,36,36
1657992895400,MATH 20C,B01,083762,Bach; Quang Tran,1,0,30,29
1657992901429,MATH 20D,A01,083765,Tran; Brian Kha,5,0,30,25
1657992901429,MATH 20D,A02,083766,Tran; Brian Kha,5,0,30,25
1657992901429,MATH 20D,A03,083767,Tran; Brian Kha,6,0,30,24
1657992907453,MATH 20E,A01,083771,Ganguly; Soumya,12,0,32,20
1657992907453,MATH 20E,A02,083772,Ganguly; Soumya,7,0,32,25
1657992907453,MATH 20E,B01,083773,Ciotti; Benjamin,20,0,35,15
1657992907453,MATH 20E,B02,083774,Ciotti; Benjamin,18,0,35,17
1657992913483,MATH 103A,A01,083777,Greenfeld; Be'Eri,6,0,36,30
1657992913483,MATH 103A,A02,083778,Greenfeld; Be'Eri,5,0,36,31
1657992913483,MATH 103A,A03,093561,Greenfeld; Be'Eri,7,0,36,29
1657992913483,MATH 103A,B01,083779,Greenfeld; Be'Eri,8,0,36,28
1657992913483,MATH 103A,B02,083780,Greenfeld; Be'Eri,4,0,36,32
1657992913483,MATH 103A,B03,093562,Greenfeld; Be'Eri,3,0,36,33
1657992919507,MATH 105,A01,085443,Carter; Anne Toulson,15,0,35,20
1657992919507,MATH 105,A02,093477,Carter; Anne Toulson,20,0,35,15
1657992925535,MATH 109,A01,083213,Ganzberger; Geoffrey Michael,3,0,34,31
1657992925535,MATH 109,A02,083214,Ganzberger; Geoffrey Michael,4,0,34,30
1657992925535,MATH 109,A03,093478,Ganzberger; Geoffrey Michael,2,0,34,32
1657992925535,MATH 109,B01,083215,Ganzberger; Geoffrey Michael,3,0,32,29
1657992925535,MATH 109,B02,083216,Ganzberger; Geoffrey Michael,3,0,32,29
1657992925535,MATH 109,B03,093479,Ganzberger; Geoffrey Michael,8,0,32,24
1657992931564,MATH 142A,A01,083219,Chow; Bennett,7,0,32,25
1657992931564,MATH 142A,A02,083220,Chow; Bennett,10,0,32,22
1657992931564,MATH 142A,A03,093480,Chow; Bennett,9,0,32,23
1657992931564,MATH 142A,B03,093481,Chow; Bennett,8,0,32,24
1657992931564,MATH 142A,B04,093558,Chow; Bennett,14,0,32,18
1657992931564,MATH 142A,B05,093559,Chow; Bennett,7,0,32,25
1657992937597,MATH 193A,A01,083224,Rotar; Vladimir,9,0,34,25
1657992937597,MATH 193A,A02,083225,Rotar; Vladimir,11,0,34,23
1657992937597,MATH 193A,A03,083781,Rotar; Vladimir,5,0,34,29
1657992937597,MATH 193A,A04,083782,Rotar; Vladimir,12,0,34,22
1657992937597,MATH 193A,A05,093482,Rotar; Vladimir,11,0,34,23
1657992943622,MATH 197,001,091859,McAuley; Julian John,9999,0,9999,0
1657992943622,MATH 197,002,095566,Kedlaya; Kiran S.,9997,0,9999,2
1657992943622,MATH 197,003,095567,Xiao; Ming,9999,0,9999,0
1657992943622,MATH 197,004,095571,Perols; Johan Lars,9998,0,9999,1
1657992950677,COGS 9,A01,083615,Shannon; Kyle Michael,11,0,75,64
1657992956700,COGS 11,A01,083617,Boyle; Mary E. T.,23,0,48,25
1657992962727,COGS 13,A01,083071,Bastos; Amalia Pinkusfeld,12,0,71,59
1657992968755,COGS 14A,A01,092681,Semenuks; Arturs,5,1,100,95
1657992974780,COGS 14B,A01,083073,Cheng; Tzu-Han,7,0,63,56
1657992980806,COGS 17,A01,092677,Semenuks; Arturs,7,0,81,74
1657992986833,COGS 100,A01,083619,Allen; Michael Gordon,17,0,70,53
1657992992857,COGS 101A,A01,083621,Davis; Joshua Daniel,9,0,68,59
1657992998879,COGS 101B,A01,091572,Allen; Michael Gordon,14,0,65,51
1657993004905,COGS 101C,A01,083625,Delgado; Tania,17,0,35,18
1657993010931,COGS 107A,A01,083627,Boyle; Mary E. T.,14,0,60,46
1657993016954,COGS 118A,A01,083075,Gupta; Anjum,21,0,76,55
1657993022977,CSE 3,A50,083646,Miranda; Gregory Joseph,24,0,50,26
1657993029004,CSE 8A,A50,083650,Miranda; Gregory Joseph,17,1,56,39
1657993035031,CSE 11,A01,083080,Cao; Yingjun,7,15,40,33
1657993041053,CSE 12,A01,083652,Krause-Levy; Sophia Louisa,30,1,120,90
1657993047076,CSE 15L,A01,083654,Morris; Justin Loren,9,0,50,41
1657993047076,CSE 15L,A02,083655,Morris; Justin Loren,11,0,50,39
1657993053102,CSE 20,A01,083657,Tran; Khoa Dang,39,0,80,41
1657993059127,CSE 21,A01,095574,Bach; Quang Tran,23,0,48,25
1657993065153,CSE 30,A01,083084,Eldon; John,8,0,80,72
1657993065153,CSE 30,B01,095061,Bhaskar; Nishant,9,0,50,41
1657993071176,CSE 100,A01,083659,Cao; Yingjun,5,4,70,65
1657993077202,CSE 134B,A01,083661,Powell; Thomas Allan,25,0,100,75
1657993083225,CSE 140,A01,083663,Gungor; Onat,17,0,85,68
1657993089248,CSE 140L,A01,083088,Eldon; John,23,0,100,77
1657993095271,CSE 175,A01,083665,Kumar; Rakesh,3,0,25,22
1657993101296,CSE 190,A00,092507,Dubnov; Shlomo,8,0,20,12
1657993107322,ECE 45,A01,083139,Congero; Spencer William,7,0,75,68
1657993113349,ECE 65,A50,083695,Saad; Andrew S,12,0,30,18
1657993113349,ECE 65,A51,095125,Saad; Andrew S,24,0,26,2
1657993119376,ECE 109,A01,091882,Touri; Behrouz,21,0,70,49
1657993125401,ECE 180,A00,083140,Abi Samra; Nicholas Camill,1,0,30,29
1657993125401,ECE 180,B00,083141,Abi Samra; Nicholas Camill,0,0,30,30
1657993131424,MATH 10A,A01,083735,Patchell; Gregory David,2,0,30,28
1657993131424,MATH 10A,A02,083736,Patchell; Gregory David,20,0,30,10
1657993131424,MATH 10A,A03,083737,Patchell; Gregory David,16,0,30,14
1657993137451,MATH 10B,A01,083207,Lim; Seonhee,9,0,34,25
1657993137451,MATH 10B,A02,083208,Lim; Seonhee,10,0,35,25
1657993137451,MATH 10B,A03,093472,Lim; Seonhee,7,0,34,27
1657993137451,MATH 10B,B01,083739,Sinha; Shubham,14,0,30,16
1657993143481,MATH 18,A01,083743,Cinel; Cameron Alexander,9,0,30,21
1657993143481,MATH 18,A02,083744,Cinel; Cameron Alexander,18,0,30,12
1657993143481,MATH 18,A03,083745,Cinel; Cameron Alexander,10,0,30,20
1657993143481,MATH 18,B01,083748,Rideout; David Porter,5,0,37,32
1657993143481,MATH 18,B02,083749,Rideout; David Porter,5,0,36,31
1657993143481,MATH 18,B03,083750,Rideout; David Porter,3,0,37,34
1657993143481,MATH 18,B04,083751,Rideout; David Porter,7,0,36,29
1657993143481,MATH 18,B05,093473,Rideout; David Porter,7,0,36,29
1657993143481,MATH 18,B06,093474,Rideout; David Porter,6,0,36,30
1657993149504,MATH 20A,A01,083754,Zheng; Zequn,14,0,40,26
1657993155529,MATH 20B,A01,083756,Briones; Jor-el Thomas Caparas,4,0,36,32
1657993155529,MATH 20B,A02,083757,Briones; Jor-el Thomas Caparas,1,0,36,35
1657993155529,MATH 20B,A03,093475,Briones; Jor-el Thomas Caparas,3,0,36,33
1657993161556,MATH 20C,A01,083760,Briones; Jor-el Thomas Caparas,1,0,35,34
1657993161556,MATH 20C,A02,083761,Briones; Jor-el Thomas Caparas,8,0,35,27
1657993161556,MATH 20C,A03,093476,Briones; Jor-el Thomas Caparas,0,1,36,36
1657993161556,MATH 20C,B01,083762,Bach; Quang Tran,1,0,30,29
1657993167581,MATH 20D,A01,083765,Tran; Brian Kha,5,0,30,25
1657993167581,MATH 20D,A02,083766,Tran; Brian Kha,5,0,30,25
1657993167581,MATH 20D,A03,083767,Tran; Brian Kha,6,0,30,24
1657993173605,MATH 20E,A01,083771,Ganguly; Soumya,12,0,32,20
1657993173605,MATH 20E,A02,083772,Ganguly; Soumya,7,0,32,25
1657993173605,MATH 20E,B01,083773,Ciotti; Benjamin,20,0,35,15
1657993173605,MATH 20E,B02,083774,Ciotti; Benjamin,18,0,35,17
1657993179635,MATH 103A,A01,083777,Greenfeld; Be'Eri,6,0,36,30
1657993179635,MATH 103A,A02,083778,Greenfeld; Be'Eri,5,0,36,31
1657993179635,MATH 103A,A03,093561,Greenfeld; Be'Eri,7,0,36,29
1657993179635,MATH 103A,B01,083779,Greenfeld; Be'Eri,8,0,36,28
1657993179635,MATH 103A,B02,083780,Greenfeld; Be'Eri,4,0,36,32
1657993179635,MATH 103A,B03,093562,Greenfeld; Be'Eri,3,0,36,33
1657993185657,MATH 105,A01,085443,Carter; Anne Toulson,15,0,35,20
1657993185657,MATH 105,A02,093477,Carter; Anne Toulson,20,0,35,15
1657993191691,MATH 109,A01,083213,Ganzberger; Geoffrey Michael,3,0,34,31
1657993191691,MATH 109,A02,083214,Ganzberger; Geoffrey Michael,4,0,34,30
1657993191691,MATH 109,A03,093478,Ganzberger; Geoffrey Michael,2,0,34,32
1657993191691,MATH 109,B01,083215,Ganzberger; Geoffrey Michael,3,0,32,29
1657993191691,MATH 109,B02,083216,Ganzberger; Geoffrey Michael,3,0,32,29
1657993191691,MATH 109,B03,093479,Ganzberger; Geoffrey Michael,8,0,32,24
1657993197718,MATH 142A,A01,083219,Chow; Bennett,7,0,32,25
1657993197718,MATH 142A,A02,083220,Chow; Bennett,10,0,32,22
1657993197718,MATH 142A,A03,093480,Chow; Bennett,9,0,32,23
1657993197718,MATH 142A,B03,093481,Chow; Bennett,8,0,32,24
1657993197718,MATH 142A,B04,093558,Chow; Bennett,14,0,32,18
1657993197718,MATH 142A,B05,093559,Chow; Bennett,7,0,32,25
1657993203742,MATH 193A,A01,083224,Rotar; Vladimir,9,0,34,25
1657993203742,MATH 193A,A02,083225,Rotar; Vladimir,11,0,34,23
1657993203742,MATH 193A,A03,083781,Rotar; Vladimir,5,0,34,29
1657993203742,MATH 193A,A04,083782,Rotar; Vladimir,12,0,34,22
1657993203742,MATH 193A,A05,093482,Rotar; Vladimir,11,0,34,23
1657993209767,MATH 197,001,091859,McAuley; Julian John,9999,0,9999,0
1657993209767,MATH 197,002,095566,Kedlaya; Kiran S.,9997,0,9999,2
1657993209767,MATH 197,003,095567,Xiao; Ming,9999,0,9999,0
1657993209767,MATH 197,004,095571,Perols; Johan Lars,9998,0,9999,1
1657993216830,COGS 9,A01,083615,Shannon; Kyle Michael,11,0,75,64
1657993222856,COGS 11,A01,083617,Boyle; Mary E. T.,23,0,48,25
1657993228878,COGS 13,A01,083071,Bastos; Amalia Pinkusfeld,12,0,71,59
1657993234902,COGS 14A,A01,092681,Semenuks; Arturs,5,1,100,95
1657993240924,COGS 14B,A01,083073,Cheng; Tzu-Han,7,0,63,56
1657993246951,COGS 17,A01,092677,Semenuks; Arturs,7,0,81,74
1657993252977,COGS 100,A01,083619,Allen; Michael Gordon,17,0,70,53
1657993259000,COGS 101A,A01,083621,Davis; Joshua Daniel,9,0,68,59
1657993265027,COGS 101B,A01,091572,Allen; Michael Gordon,14,0,65,51
1657993271140,COGS 101C,A01,083625,Delgado; Tania,17,0,35,18
1657993277163,COGS 107A,A01,083627,Boyle; Mary E. T.,14,0,60,46
1657993283186,COGS 118A,A01,083075,Gupta; Anjum,21,0,76,55
1657993289213,CSE 3,A50,083646,Miranda; Gregory Joseph,24,0,50,26
1657993295239,CSE 8A,A50,083650,Miranda; Gregory Joseph,17,1,56,39
1657993301267,CSE 11,A01,083080,Cao; Yingjun,7,15,40,33
1657993307292,CSE 12,A01,083652,Krause-Levy; Sophia Louisa,30,1,120,90
1657993313315,CSE 15L,A01,083654,Morris; Justin Loren,9,0,50,41
1657993313315,CSE 15L,A02,083655,Morris; Justin Loren,11,0,50,39
1657993319337,CSE 20,A01,083657,Tran; Khoa Dang,39,0,80,41
1657993325373,CSE 21,A01,095574,Bach; Quang Tran,23,0,48,25
1657993331397,CSE 30,A01,083084,Eldon; John,8,0,80,72
1657993331397,CSE 30,B01,095061,Bhaskar; Nishant,9,0,50,41
1657993337423,CSE 100,A01,083659,Cao; Yingjun,5,4,70,65
1657993343445,CSE 134B,A01,083661,Powell; Thomas Allan,25,0,100,75
1657993349471,CSE 140,A01,083663,Gungor; Onat,17,0,85,68
1657993355501,CSE 140L,A01,083088,Eldon; John,23,0,100,77
1657993361527,CSE 175,A01,083665,Kumar; Rakesh,3,0,25,22
1657993367551,CSE 190,A00,092507,Dubnov; Shlomo,8,0,20,12
1657993373575,ECE 45,A01,083139,Congero; Spencer William,7,0,75,68
1657993379604,ECE 65,A50,083695,Saad; Andrew S,12,0,30,18
1657993379604,ECE 65,A51,095125,Saad; Andrew S,24,0,26,2
1657993385628,ECE 109,A01,091882,Touri; Behrouz,21,0,70,49
1657993391653,ECE 180,A00,083140,Abi Samra; Nicholas Camill,1,0,30,29
1657993391653,ECE 180,B00,083141,Abi Samra; Nicholas Camill,0,0,30,30
1657993397677,MATH 10A,A01,083735,Patchell; Gregory David,2,0,30,28
1657993397677,MATH 10A,A02,083736,Patchell; Gregory David,20,0,30,10
1657993397677,MATH 10A,A03,083737,Patchell; Gregory David,16,0,30,14
1657993403700,MATH 10B,A01,083207,Lim; Seonhee,9,0,34,25
1657993403700,MATH 10B,A02,083208,Lim; Seonhee,10,0,35,25
1657993403700,MATH 10B,A03,093472,Lim; Seonhee,7,0,34,27
1657993403700,MATH 10B,B01,083739,Sinha; Shubham,14,0,30,16
1657993409726,MATH 18,A01,083743,Cinel; Cameron Alexander,9,0,30,21
1657993409726,MATH 18,A02,083744,Cinel; Cameron Alexander,18,0,30,12
1657993409726,MATH 18,A03,083745,Cinel; Cameron Alexander,10,0,30,20
1657993409726,MATH 18,B01,083748,Rideout; David Porter,5,0,37,32
1657993409726,MATH 18,B02,083749,Rideout; David Porter,5,0,36,31
1657993409726,MATH 18,B03,083750,Rideout; David Porter,3,0,37,34
1657993409726,MATH 18,B04,083751,Rideout; David Porter,7,0,36,29
1657993409726,MATH 18,B05,093473,Rideout; David Porter,7,0,36,29
1657993409726,MATH 18,B06,093474,Rideout; David Porter,6,0,36,30
1657993415753,MATH 20A,A01,083754,Zheng; Zequn,14,0,40,26
1657993421780,MATH 20B,A01,083756,Briones; Jor-el Thomas Caparas,4,0,36,32
1657993421780,MATH 20B,A02,083757,Briones; Jor-el Thomas Caparas,1,0,36,35
1657993421780,MATH 20B,A03,093475,Briones; Jor-el Thomas Caparas,3,0,36,33
1657993427811,MATH 20C,A01,083760,Briones; Jor-el Thomas Caparas,1,0,35,34
1657993427811,MATH 20C,A02,083761,Briones; Jor-el Thomas Caparas,8,0,35,27
1657993427811,MATH 20C,A03,093476,Briones; Jor-el Thomas Caparas,0,1,36,36
1657993427811,MATH 20C,B01,083762,Bach; Quang Tran,1,0,30,29
1657993433838,MATH 20D,A01,083765,Tran; Brian Kha,5,0,30,25
1657993433838,MATH 20D,A02,083766,Tran; Brian Kha,5,0,30,25
1657993433838,MATH 20D,A03,083767,Tran; Brian Kha,6,0,30,24
1657993439867,MATH 20E,A01,083771,Ganguly; Soumya,12,0,32,20
1657993439867,MATH 20E,A02,083772,Ganguly; Soumya,7,0,32,25
1657993439867,MATH 20E,B01,083773,Ciotti; Benjamin,20,0,35,15
1657993439867,MATH 20E,B02,083774,Ciotti; Benjamin,18,0,35,17
1657993445896,MATH 103A,A01,083777,Greenfeld; Be'Eri,6,0,36,30
1657993445896,MATH 103A,A02,083778,Greenfeld; Be'Eri,5,0,36,31
1657993445896,MATH 103A,A03,093561,Greenfeld; Be'Eri,7,0,36,29
1657993445896,MATH 103A,B01,083779,Greenfeld; Be'Eri,8,0,36,28
1657993445896,MATH 103A,B02,083780,Greenfeld; Be'Eri,4,0,36,32
1657993445896,MATH 103A,B03,093562,Greenfeld; Be'Eri,3,0,36,33
1657993451924,MATH 105,A01,085443,Carter; Anne Toulson,15,0,35,20
1657993451924,MATH 105,A02,093477,Carter; Anne Toulson,20,0,35,15
1657993457948,MATH 109,A01,083213,Ganzberger; Geoffrey Michael,3,0,34,31
1657993457948,MATH 109,A02,083214,Ganzberger; Geoffrey Michael,4,0,34,30
1657993457948,MATH 109,A03,093478,Ganzberger; Geoffrey Michael,2,0,34,32
1657993457948,MATH 109,B01,083215,Ganzberger; Geoffrey Michael,3,0,32,29
1657993457948,MATH 109,B02,083216,Ganzberger; Geoffrey Michael,3,0,32,29
1657993457948,MATH 109,B03,093479,Ganzberger; Geoffrey Michael,8,0,32,24
1657993463972,MATH 142A,A01,083219,Chow; Bennett,7,0,32,25
1657993463972,MATH 142A,A02,083220,Chow; Bennett,10,0,32,22
1657993463972,MATH 142A,A03,093480,Chow; Bennett,9,0,32,23
1657993463972,MATH 142A,B03,093481,Chow; Bennett,8,0,32,24
1657993463972,MATH 142A,B04,093558,Chow; Bennett,14,0,32,18
1657993463972,MATH 142A,B05,093559,Chow; Bennett,7,0,32,25
1657993469997,MATH 193A,A01,083224,Rotar; Vladimir,9,0,34,25
1657993469997,MATH 193A,A02,083225,Rotar; Vladimir,11,0,34,23
1657993469997,MATH 193A,A03,083781,Rotar; Vladimir,5,0,34,29
1657993469997,MATH 193A,A04,083782,Rotar; Vladimir,12,0,34,22
1657993469997,MATH 193A,A05,093482,Rotar; Vladimir,11,0,34,23
1657993476023,MATH 197,001,091859,McAuley; Julian John,9999,0,9999,0
1657993476023,MATH 197,002,095566,Kedlaya; Kiran S.,9997,0,9999,2
1657993476023,MATH 197,003,095567,Xiao; Ming,9999,0,9999,0
1657993476023,MATH 197,004,095571,Perols; Johan Lars,9998,0,9999,1
1657993483074,COGS 9,A01,083615,Shannon; Kyle Michael,11,0,75,64
1657993489102,COGS 11,A01,083617,Boyle; Mary E. T.,23,0,48,25
1657993495125,COGS 13,A01,083071,Bastos; Amalia Pinkusfeld,12,0,71,59
1657993501151,COGS 14A,A01,092681,Semenuks; Arturs,5,1,100,95
1657993507177,COGS 14B,A01,083073,Cheng; Tzu-Han,7,0,63,56
1657993513202,COGS 17,A01,092677,Semenuks; Arturs,7,0,81,74
1657993519224,COGS 100,A01,083619,Allen; Michael Gordon,17,0,70,53
1657993525247,COGS 101A,A01,083621,Davis; Joshua Daniel,9,0,68,59
1657993531272,COGS 101B,A01,091572,Allen; Michael Gordon,14,0,65,51
1657993537298,COGS 101C,A01,083625,Delgado; Tania,17,0,35,18
1657993543322,COGS 107A,A01,083627,Boyle; Mary E. T.,14,0,60,46
1657993549346,COGS 118A,A01,083075,Gupta; Anjum,21,0,76,55
1657993555368,CSE 3,A50,083646,Miranda; Gregory Joseph,24,0,50,26
1657993561390,CSE 8A,A50,083650,Miranda; Gregory Joseph,17,1,56,39
1657993567411,CSE 11,A01,083080,Cao; Yingjun,7,15,40,33
1657993573434,CSE 12,A01,083652,Krause-Levy; Sophia Louisa,30,1,120,90
1657993579460,CSE 15L,A01,083654,Morris; Justin Loren,9,0,50,41
1657993579460,CSE 15L,A02,083655,Morris; Justin Loren,11,0,50,39
1657993585483,CSE 20,A01,083657,Tran; Khoa Dang,39,0,80,41
1657993591508,CSE 21,A01,095574,Bach; Quang Tran,23,0,48,25
1657993597532,CSE 30,A01,083084,Eldon; John,8,0,80,72
1657993597532,CSE 30,B01,095061,Bhaskar; Nishant,9,0,50,41
1657993603558,CSE 100,A01,083659,Cao; Yingjun,5,4,70,65
1657993609584,CSE 134B,A01,083661,Powell; Thomas Allan,25,0,100,75
1657993615605,CSE 140,A01,083663,Gungor; Onat,17,0,85,68
1657993621633,CSE 140L,A01,083088,Eldon; John,23,0,100,77
1657993627661,CSE 175,A01,083665,Kumar; Rakesh,3,0,25,22
1657993633686,CSE 190,A00,092507,Dubnov; Shlomo,8,0,20,12
1657993639716,ECE 45,A01,083139,Congero; Spencer William,7,0,75,68
1657993645742,ECE 65,A50,083695,Saad; Andrew S,12,0,30,18
1657993645742,ECE 65,A51,095125,Saad; Andrew S,24,0,26,2
1657993651763,ECE 109,A01,091882,Touri; Behrouz,21,0,70,49
1657993657785,ECE 180,A00,083140,Abi Samra; Nicholas Camill,1,0,30,29
1657993657785,ECE 180,B00,083141,Abi Samra; Nicholas Camill,0,0,30,30
1657993663810,MATH 10A,A01,083735,Patchell; Gregory David,2,0,30,28
1657993663810,MATH 10A,A02,083736,Patchell; Gregory David,20,0,30,10
1657993663810,MATH 10A,A03,083737,Patchell; Gregory David,16,0,30,14
1657993669833,MATH 10B,A01,083207,Lim; Seonhee,9,0,34,25
1657993669833,MATH 10B,A02,083208,Lim; Seonhee,10,0,35,25
1657993669833,MATH 10B,A03,093472,Lim; Seonhee,7,0,34,27
1657993669833,MATH 10B,B01,083739,Sinha; Shubham,14,0,30,16
1657993675857,MATH 18,A01,083743,Cinel; Cameron Alexander,9,0,30,21
1657993675857,MATH 18,A02,083744,Cinel; Cameron Alexander,18,0,30,12
1657993675857,MATH 18,A03,083745,Cinel; Cameron Alexander,10,0,30,20
1657993675857,MATH 18,B01,083748,Rideout; David Porter,5,0,37,32
1657993675857,MATH 18,B02,083749,Rideout; David Porter,5,0,36,31
1657993675857,MATH 18,B03,083750,Rideout; David Porter,3,0,37,34
1657993675857,MATH 18,B04,083751,Rideout; David Porter,7,0,36,29
1657993675857,MATH 18,B05,093473,Rideout; David Porter,7,0,36,29
1657993675857,MATH 18,B06,093474,Rideout; David Porter,6,0,36,30
1657993681882,MATH 20A,A01,083754,Zheng; Zequn,14,0,40,26
1657993687908,MATH 20B,A01,083756,Briones; Jor-el Thomas Caparas,4,0,36,32
1657993687908,MATH 20B,A02,083757,Briones; Jor-el Thomas Caparas,1,0,36,35
1657993687908,MATH 20B,A03,093475,Briones; Jor-el Thomas Caparas,3,0,36,33
1657993693938,MATH 20C,A01,083760,Briones; Jor-el Thomas Caparas,1,0,35,34
1657993693938,MATH 20C,A02,083761,Briones; Jor-el Thomas Caparas,8,0,35,27
1657993693938,MATH 20C,A03,093476,Briones; Jor-el Thomas Caparas,0,1,36,36
1657993693938,MATH 20C,B01,083762,Bach; Quang Tran,1,0,30,29
1657993699966,MATH 20D,A01,083765,Tran; Brian Kha,5,0,30,25
1657993699966,MATH 20D,A02,083766,Tran; Brian Kha,5,0,30,25
1657993699966,MATH 20D,A03,083767,Tran; Brian Kha,6,0,30,24
1657993705993,MATH 20E,A01,083771,Ganguly; Soumya,12,0,32,20
1657993705993,MATH 20E,A02,083772,Ganguly; Soumya,7,0,32,25
1657993705993,MATH 20E,B01,083773,Ciotti; Benjamin,20,0,35,15
1657993705993,MATH 20E,B02,083774,Ciotti; Benjamin,18,0,35,17
1657993712018,MATH 103A,A01,083777,Greenfeld; Be'Eri,6,0,36,30
1657993712018,MATH 103A,A02,083778,Greenfeld; Be'Eri,5,0,36,31
1657993712018,MATH 103A,A03,093561,Greenfeld; Be'Eri,7,0,36,29
1657993712018,MATH 103A,B01,083779,Greenfeld; Be'Eri,8,0,36,28
1657993712018,MATH 103A,B02,083780,Greenfeld; Be'Eri,4,0,36,32
1657993712018,MATH 103A,B03,093562,Greenfeld; Be'Eri,3,0,36,33
1657993718043,MATH 105,A01,085443,Carter; Anne Toulson,15,0,35,20
1657993718043,MATH 105,A02,093477,Carter; Anne Toulson,20,0,35,15
1657993724066,MATH 109,A01,083213,Ganzberger; Geoffrey Michael,3,0,34,31
1657993724066,MATH 109,A02,083214,Ganzberger; Geoffrey Michael,4,0,34,30
1657993724066,MATH 109,A03,093478,Ganzberger; Geoffrey Michael,2,0,34,32
1657993724066,MATH 109,B01,083215,Ganzberger; Geoffrey Michael,3,0,32,29
1657993724066,MATH 109,B02,083216,Ganzberger; Geoffrey Michael,3,0,32,29
1657993724066,MATH 109,B03,093479,Ganzberger; Geoffrey Michael,8,0,32,24
1657993730094,MATH 142A,A01,083219,Chow; Bennett,7,0,32,25
1657993730094,MATH 142A,A02,083220,Chow; Bennett,10,0,32,22
1657993730094,MATH 142A,A03,093480,Chow; Bennett,9,0,32,23
1657993730094,MATH 142A,B03,093481,Chow; Bennett,8,0,32,24
1657993730094,MATH 142A,B04,093558,Chow; Bennett,14,0,32,18
1657993730094,MATH 142A,B05,093559,Chow; Bennett,7,0,32,25
1657993736122,MATH 193A,A01,083224,Rotar; Vladimir,9,0,34,25
1657993736122,MATH 193A,A02,083225,Rotar; Vladimir,11,0,34,23
1657993736122,MATH 193A,A03,083781,Rotar; Vladimir,5,0,34,29
1657993736122,MATH 193A,A04,083782,Rotar; Vladimir,12,0,34,22
1657993736122,MATH 193A,A05,093482,Rotar; Vladimir,11,0,34,23
1657993742158,MATH 197,001,091859,McAuley; Julian John,9999,0,9999,0
1657993742158,MATH 197,002,095566,Kedlaya; Kiran S.,9997,0,9999,2
1657993742158,MATH 197,003,095567,Xiao; Ming,9999,0,9999,0
1657993742158,MATH 197,004,095571,Perols; Johan Lars,9998,0,9999,1
1657993749223,COGS 9,A01,083615,Shannon; Kyle Michael,11,0,75,64
1657993755245,COGS 11,A01,083617,Boyle; Mary E. T.,23,0,48,25
1657993761272,COGS 13,A01,083071,Bastos; Amalia Pinkusfeld,12,0,71,59
1657993767299,COGS 14A,A01,092681,Semenuks; Arturs,5,1,100,95
1657993773325,COGS 14B,A01,083073,Cheng; Tzu-Han,7,0,63,56
1657993779351,COGS 17,A01,092677,Semenuks; Arturs,7,0,81,74
1657993785378,COGS 100,A01,083619,Allen; Michael Gordon,17,0,70,53
1657993791404,COGS 101A,A01,083621,Davis; Joshua Daniel,9,0,68,59
1657993797430,COGS 101B,A01,091572,Allen; Michael Gordon,14,0,65,51
1657993803453,COGS 101C,A01,083625,Delgado; Tania,17,0,35,18
1657993809478,COGS 107A,A01,083627,Boyle; Mary E. T.,14,0,60,46
1657993815499,COGS 118A,A01,083075,Gupta; Anjum,21,0,76,55
1657993821521,CSE 3,A50,083646,Miranda; Gregory Joseph,24,0,50,26
1657993827548,CSE 8A,A50,083650,Miranda; Gregory Joseph,17,1,56,39
1657993833576,CSE 11,A01,083080,Cao; Yingjun,7,15,40,33
1657993839603,CSE 12,A01,083652,Krause-Levy; Sophia Louisa,30,1,120,90
1657993845625,CSE 15L,A01,083654,Morris; Justin Loren,9,0,50,41
1657993845625,CSE 15L,A02,083655,Morris; Justin Loren,11,0,50,39
1657993851649,CSE 20,A01,083657,Tran; Khoa Dang,39,0,80,41
1657993857675,CSE 21,A01,095574,Bach; Quang Tran,23,0,48,25
1657993863697,CSE 30,A01,083084,Eldon; John,8,0,80,72
1657993863697,CSE 30,B01,095061,Bhaskar; Nishant,9,0,50,41
1657993869807,CSE 100,A01,083659,Cao; Yingjun,5,4,70,65
1657993875828,CSE 134B,A01,083661,Powell; Thomas Allan,25,0,100,75
1657993881855,CSE 140,A01,083663,Gungor; Onat,17,0,85,68
1657993887882,CSE 140L,A01,083088,Eldon; John,23,0,100,77
1657993893910,CSE 175,A01,083665,Kumar; Rakesh,3,0,25,22
1657993899938,CSE 190,A00,092507,Dubnov; Shlomo,8,0,20,12
1657993905964,ECE 45,A01,083139,Congero; Spencer William,7,0,75,68
1657993911987,ECE 65,A50,083695,Saad; Andrew S,12,0,30,18
1657993911987,ECE 65,A51,095125,Saad; Andrew S,24,0,26,2
1657993918014,ECE 109,A01,091882,Touri; Behrouz,21,0,70,49
1657993924038,ECE 180,A00,083140,Abi Samra; Nicholas Camill,1,0,30,29
1657993924038,ECE 180,B00,083141,Abi Samra; Nicholas Camill,0,0,30,30
1657993930074,MATH 10A,A01,083735,Patchell; Gregory David,2,0,30,28
1657993930074,MATH 10A,A02,083736,Patchell; Gregory David,20,0,30,10
1657993930074,MATH 10A,A03,083737,Patchell; Gregory David,16,0,30,14
1657993936103,MATH 10B,A01,083207,Lim; Seonhee,9,0,34,25
1657993936103,MATH 10B,A02,083208,Lim; Seonhee,10,0,35,25
1657993936103,MATH 10B,A03,093472,Lim; Seonhee,7,0,34,27
1657993936103,MATH 10B,B01,083739,Sinha; Shubham,14,0,30,16
1657993942133,MATH 18,A01,083743,Cinel; Cameron Alexander,9,0,30,21
1657993942133,MATH 18,A02,083744,Cinel; Cameron Alexander,18,0,30,12
1657993942133,MATH 18,A03,083745,Cinel; Cameron Alexander,10,0,30,20
1657993942133,MATH 18,B01,083748,Rideout; David Porter,5,0,37,32
1657993942133,MATH 18,B02,083749,Rideout; David Porter,5,0,36,31
1657993942133,MATH 18,B03,083750,Rideout; David Porter,3,0,37,34
1657993942133,MATH 18,B04,083751,Rideout; David Porter,7,0,36,29
1657993942133,MATH 18,B05,093473,Rideout; David Porter,7,0,36,29
1657993942133,MATH 18,B06,093474,Rideout; David Porter,6,0,36,30
1657993948160,MATH 20A,A01,083754,Zheng; Zequn,14,0,40,26
1657993954188,MATH 20B,A01,083756,Briones; Jor-el Thomas Caparas,4,0,36,32
1657993954188,MATH 20B,A02,083757,Briones; Jor-el Thomas Caparas,1,0,36,35
1657993954188,MATH 20B,A03,093475,Briones; Jor-el Thomas Caparas,3,0,36,33
1657993960210,MATH 20C,A01,083760,Briones; Jor-el Thomas Caparas,1,0,35,34
1657993960210,MATH 20C,A02,083761,Briones; Jor-el Thomas Caparas,8,0,35,27
1657993960210,MATH 20C,A03,093476,Briones; Jor-el Thomas Caparas,0,1,36,36
1657993960210,MATH 20C,B01,083762,Bach; Quang Tran,1,0,30,29
1657993966233,MATH 20D,A01,083765,Tran; Brian Kha,5,0,30,25
1657993966233,MATH 20D,A02,083766,Tran; Brian Kha,5,0,30,25
1657993966233,MATH 20D,A03,083767,Tran; Brian Kha,6,0,30,24
1657993972258,MATH 20E,A01,083771,Ganguly; Soumya,12,0,32,20
1657993972258,MATH 20E,A02,083772,Ganguly; Soumya,7,0,32,25
1657993972258,MATH 20E,B01,083773,Ciotti; Benjamin,20,0,35,15
1657993972258,MATH 20E,B02,083774,Ciotti; Benjamin,18,0,35,17
1657993978285,MATH 103A,A01,083777,Greenfeld; Be'Eri,6,0,36,30
1657993978285,MATH 103A,A02,083778,Greenfeld; Be'Eri,5,0,36,31
1657993978285,MATH 103A,A03,093561,Greenfeld; Be'Eri,7,0,36,29
1657993978285,MATH 103A,B01,083779,Greenfeld; Be'Eri,8,0,36,28
1657993978285,MATH 103A,B02,083780,Greenfeld; Be'Eri,4,0,36,32
1657993978285,MATH 103A,B03,093562,Greenfeld; Be'Eri,3,0,36,33
1657993984310,MATH 105,A01,085443,Carter; Anne Toulson,15,0,35,20
1657993984310,MATH 105,A02,093477,Carter; Anne Toulson,20,0,35,15
1657993990332,MATH 109,A01,083213,Ganzberger; Geoffrey Michael,3,0,34,31
1657993990332,MATH 109,A02,083214,Ganzberger; Geoffrey Michael,4,0,34,30
1657993990332,MATH 109,A03,093478,Ganzberger; Geoffrey Michael,2,0,34,32
1657993990332,MATH 109,B01,083215,Ganzberger; Geoffrey Michael,3,0,32,29
1657993990332,MATH 109,B02,083216,Ganzberger; Geoffrey Michael,3,0,32,29
1657993990332,MATH 109,B03,093479,Ganzberger; Geoffrey Michael,8,0,32,24
1657993996356,MATH 142A,A01,083219,Chow; Bennett,7,0,32,25
1657993996356,MATH 142A,A02,083220,Chow; Bennett,10,0,32,22
1657993996356,MATH 142A,A03,093480,Chow; Bennett,9,0,32,23
1657993996356,MATH 142A,B03,093481,Chow; Bennett,8,0,32,24
1657993996356,MATH 142A,B04,093558,Chow; Bennett,14,0,32,18
1657993996356,MATH 142A,B05,093559,Chow; Bennett,7,0,32,25
1657994002383,MATH 193A,A01,083224,Rotar; Vladimir,9,0,34,25
1657994002383,MATH 193A,A02,083225,Rotar; Vladimir,11,0,34,23
1657994002383,MATH 193A,A03,083781,Rotar; Vladimir,5,0,34,29
1657994002383,MATH 193A,A04,083782,Rotar; Vladimir,12,0,34,22
1657994002383,MATH 193A,A05,093482,Rotar; Vladimir,11,0,34,23
1657994008411,MATH 197,001,091859,McAuley; Julian John,9999,0,9999,0
1657994008411,MATH 197,002,095566,Kedlaya; Kiran S.,9997,0,9999,2
1657994008411,MATH 197,003,095567,Xiao; Ming,9999,0,9999,0
1657994008411,MATH 197,004,095571,Perols; Johan Lars,9998,0,9999,1
1657994015474,COGS 9,A01,083615,Shannon; Kyle Michael,11,0,75,64
1657994021499,COGS 11,A01,083617,Boyle; Mary E. T.,23,0,48,25
1657994027526,COGS 13,A01,083071,Bastos; Amalia Pinkusfeld,12,0,71,59
1657994033553,COGS 14A,A01,092681,Semenuks; Arturs,5,1,100,95
1657994039578,COGS 14B,A01,083073,Cheng; Tzu-Han,7,0,63,56
1657994045613,COGS 17,A01,092677,Semenuks; Arturs,7,0,81,74
1657994051639,COGS 100,A01,083619,Allen; Michael Gordon,17,0,70,53
1657994057663,COGS 101A,A01,083621,Davis; Joshua Daniel,9,0,68,59
1657994063688,COGS 101B,A01,091572,Allen; Michael Gordon,14,0,65,51
1657994069715,COGS 101C,A01,083625,Delgado; Tania,17,0,35,18
1657994075737,COGS 107A,A01,083627,Boyle; Mary E. T.,14,0,60,46
1657994081764,COGS 118A,A01,083075,Gupta; Anjum,21,0,76,55
1657994087788,CSE 3,A50,083646,Miranda; Gregory Joseph,24,0,50,26
1657994093821,CSE 8A,A50,083650,Miranda; Gregory Joseph,17,1,56,39
1657994099848,CSE 11,A01,083080,Cao; Yingjun,7,15,40,33
1657994105874,CSE 12,A01,083652,Krause-Levy; Sophia Louisa,30,1,120,90
1657994111901,CSE 15L,A01,083654,Morris; Justin Loren,9,0,50,41
1657994111901,CSE 15L,A02,083655,Morris; Justin Loren,11,0,50,39
1657994117924,CSE 20,A01,083657,Tran; Khoa Dang,39,0,80,41
1657994123945,CSE 21,A01,095574,Bach; Quang Tran,23,0,48,25
1657994129973,CSE 30,A01,083084,Eldon; John,8,0,80,72
1657994129973,CSE 30,B01,095061,Bhaskar; Nishant,9,0,50,41
1657994135999,CSE 100,A01,083659,Cao; Yingjun,5,4,70,65
1657994142023,CSE 134B,A01,083661,Powell; Thomas Allan,25,0,100,75
1657994148047,CSE 140,A01,083663,Gungor; Onat,17,0,85,68
1657994154070,CSE 140L,A01,083088,Eldon; John,23,0,100,77
1657994160096,CSE 175,A01,083665,Kumar; Rakesh,3,0,25,22
1657994166118,CSE 190,A00,092507,Dubnov; Shlomo,8,0,20,12
1657994172144,ECE 45,A01,083139,Congero; Spencer William,7,0,75,68
1657994178168,ECE 65,A50,083695,Saad; Andrew S,12,0,30,18
1657994178168,ECE 65,A51,095125,Saad; Andrew S,24,0,26,2
1657994184191,ECE 109,A01,091882,Touri; Behrouz,21,0,70,49
1657994190216,ECE 180,A00,083140,Abi Samra; Nicholas Camill,1,0,30,29
1657994190216,ECE 180,B00,083141,Abi Samra; Nicholas Camill,0,0,30,30
1657994196245,MATH 10A,A01,083735,Patchell; Gregory David,2,0,30,28
1657994196245,MATH 10A,A02,083736,Patchell; Gregory David,20,0,30,10
1657994196245,MATH 10A,A03,083737,Patchell; Gregory David,16,0,30,14
1657994202269,MATH 10B,A01,083207,Lim; Seonhee,9,0,34,25
1657994202269,MATH 10B,A02,083208,Lim; Seonhee,10,0,35,25
1657994202269,MATH 10B,A03,093472,Lim; Seonhee,7,0,34,27
1657994202269,MATH 10B,B01,083739,Sinha; Shubham,14,0,30,16
1657994208294,MATH 18,A01,083743,Cinel; Cameron Alexander,9,0,30,21
1657994208294,MATH 18,A02,083744,Cinel; Cameron Alexander,18,0,30,12
1657994208294,MATH 18,A03,083745,Cinel; Cameron Alexander,10,0,30,20
1657994208294,MATH 18,B01,083748,Rideout; David Porter,5,0,37,32
1657994208294,MATH 18,B02,083749,Rideout; David Porter,5,0,36,31
1657994208294,MATH 18,B03,083750,Rideout; David Porter,3,0,37,34
1657994208294,MATH 18,B04,083751,Rideout; David Porter,7,0,36,29
1657994208294,MATH 18,B05,093473,Rideout; David Porter,7,0,36,29
1657994208294,MATH 18,B06,093474,Rideout; David Porter,6,0,36,30
1657994214322,MATH 20A,A01,083754,Zheng; Zequn,14,0,40,26
1657994220344,MATH 20B,A01,083756,Briones; Jor-el Thomas Caparas,4,0,36,32
1657994220344,MATH 20B,A02,083757,Briones; Jor-el Thomas Caparas,1,0,36,35
1657994220344,MATH 20B,A03,093475,Briones; Jor-el Thomas Caparas,3,0,36,33
1657994226366,MATH 20C,A01,083760,Briones; Jor-el Thomas Caparas,1,0,35,34
1657994226366,MATH 20C,A02,083761,Briones; Jor-el Thomas Caparas,8,0,35,27
1657994226366,MATH 20C,A03,093476,Briones; Jor-el Thomas Caparas,0,1,36,36
1657994226366,MATH 20C,B01,083762,Bach; Quang Tran,1,0,30,29
1657994232389,MATH 20D,A01,083765,Tran; Brian Kha,5,0,30,25
1657994232389,MATH 20D,A02,083766,Tran; Brian Kha,5,0,30,25
1657994232389,MATH 20D,A03,083767,Tran; Brian Kha,6,0,30,24
1657994238416,MATH 20E,A01,083771,Ganguly; Soumya,12,0,32,20
1657994238416,MATH 20E,A02,083772,Ganguly; Soumya,7,0,32,25
1657994238416,MATH 20E,B01,083773,Ciotti; Benjamin,20,0,35,15
1657994238416,MATH 20E,B02,083774,Ciotti; Benjamin,18,0,35,17
1657994244447,MATH 103A,A01,083777,Greenfeld; Be'Eri,6,0,36,30
1657994244447,MATH 103A,A02,083778,Greenfeld; Be'Eri,5,0,36,31
1657994244447,MATH 103A,A03,093561,Greenfeld; Be'Eri,7,0,36,29
1657994244447,MATH 103A,B01,083779,Greenfeld; Be'Eri,8,0,36,28
1657994244447,MATH 103A,B02,083780,Greenfeld; Be'Eri,4,0,36,32
1657994244447,MATH 103A,B03,093562,Greenfeld; Be'Eri,3,0,36,33
1657994250474,MATH 105,A01,085443,Carter; Anne Toulson,15,0,35,20
1657994250474,MATH 105,A02,093477,Carter; Anne Toulson,20,0,35,15
1657994256497,MATH 109,A01,083213,Ganzberger; Geoffrey Michael,3,0,34,31
1657994256497,MATH 109,A02,083214,Ganzberger; Geoffrey Michael,4,0,34,30
1657994256497,MATH 109,A03,093478,Ganzberger; Geoffrey Michael,2,0,34,32
1657994256497,MATH 109,B01,083215,Ganzberger; Geoffrey Michael,3,0,32,29
1657994256497,MATH 109,B02,083216,Ganzberger; Geoffrey Michael,3,0,32,29
1657994256497,MATH 109,B03,093479,Ganzberger; Geoffrey Michael,8,0,32,24
1657994262524,MATH 142A,A01,083219,Chow; Bennett,7,0,32,25
1657994262524,MATH 142A,A02,083220,Chow; Bennett,10,0,32,22
1657994262524,MATH 142A,A03,093480,Chow; Bennett,9,0,32,23
1657994262524,MATH 142A,B03,093481,Chow; Bennett,8,0,32,24
1657994262524,MATH 142A,B04,093558,Chow; Bennett,14,0,32,18
1657994262524,MATH 142A,B05,093559,Chow; Bennett,7,0,32,25
1657994268548,MATH 193A,A01,083224,Rotar; Vladimir,9,0,34,25
1657994268548,MATH 193A,A02,083225,Rotar; Vladimir,11,0,34,23
1657994268548,MATH 193A,A03,083781,Rotar; Vladimir,5,0,34,29
1657994268548,MATH 193A,A04,083782,Rotar; Vladimir,12,0,34,22
1657994268548,MATH 193A,A05,093482,Rotar; Vladimir,11,0,34,23
1657994274571,MATH 197,001,091859,McAuley; Julian John,9999,0,9999,0
1657994274571,MATH 197,002,095566,Kedlaya; Kiran S.,9997,0,9999,2
1657994274571,MATH 197,003,095567,Xiao; Ming,9999,0,9999,0
1657994274571,MATH 197,004,095571,Perols; Johan Lars,9998,0,9999,1
1657994281625,COGS 9,A01,083615,Shannon; Kyle Michael,11,0,75,64
1657994287648,COGS 11,A01,083617,Boyle; Mary E. T.,23,0,48,25
1657994293673,COGS 13,A01,083071,Bastos; Amalia Pinkusfeld,12,0,71,59
1657994299700,COGS 14A,A01,092681,Semenuks; Arturs,5,1,100,95
1657994305722,COGS 14B,A01,083073,Cheng; Tzu-Han,7,0,63,56
1657994311745,COGS 17,A01,092677,Semenuks; Arturs,7,0,81,74
1657994317770,COGS 100,A01,083619,Allen; Michael Gordon,17,0,70,53
1657994323794,COGS 101A,A01,083621,Davis; Joshua Daniel,9,0,68,59
1657994329816,COGS 101B,A01,091572,Allen; Michael Gordon,14,0,65,51
1657994335845,COGS 101C,A01,083625,Delgado; Tania,17,0,35,18
1657994341871,COGS 107A,A01,083627,Boyle; Mary E. T.,14,0,60,46
1657994347896,COGS 118A,A01,083075,Gupta; Anjum,21,0,76,55
1657994353919,CSE 3,A50,083646,Miranda; Gregory Joseph,24,0,50,26
1657994359946,CSE 8A,A50,083650,Miranda; Gregory Joseph,17,1,56,39
1657994365971,CSE 11,A01,083080,Cao; Yingjun,7,15,40,33
1657994371998,CSE 12,A01,083652,Krause-Levy; Sophia Louisa,30,1,120,90
1657994378033,CSE 15L,A01,083654,Morris; Justin Loren,9,0,50,41
1657994378033,CSE 15L,A02,083655,Morris; Justin Loren,11,0,50,39
1657994384063,CSE 20,A01,083657,Tran; Khoa Dang,39,0,80,41
1657994390088,CSE 21,A01,095574,Bach; Quang Tran,23,0,48,25
1657994396115,CSE 30,A01,083084,Eldon; John,8,0,80,72
1657994396115,CSE 30,B01,095061,Bhaskar; Nishant,9,0,50,41
1657994402138,CSE 100,A01,083659,Cao; Yingjun,5,4,70,65
1657994408160,CSE 134B,A01,083661,Powell; Thomas Allan,25,0,100,75
1657994414185,CSE 140,A01,083663,Gungor; Onat,17,0,85,68
1657994420207,CSE 140L,A01,083088,Eldon; John,23,0,100,77
1657994426238,CSE 175,A01,083665,Kumar; Rakesh,3,0,25,22
1657994432273,CSE 190,A00,092507,Dubnov; Shlomo,8,0,20,12
1657994438311,ECE 45,A01,083139,Congero; Spencer William,7,0,75,68
1657994444345,ECE 65,A50,083695,Saad; Andrew S,12,0,30,18
1657994444345,ECE 65,A51,095125,Saad; Andrew S,24,0,26,2
1657994450368,ECE 109,A01,091882,Touri; Behrouz,21,0,70,49
1657994456390,ECE 180,A00,083140,Abi Samra; Nicholas Camill,1,0,30,29
1657994456390,ECE 180,B00,083141,Abi Samra; Nicholas Camill,0,0,30,30
1657994462419,MATH 10A,A01,083735,Patchell; Gregory David,2,0,30,28
1657994462419,MATH 10A,A02,083736,Patchell; Gregory David,20,0,30,10
1657994462419,MATH 10A,A03,083737,Patchell; Gregory David,16,0,30,14
1657994468512,MATH 10B,A01,083207,Lim; Seonhee,9,0,34,25
1657994468512,MATH 10B,A02,083208,Lim; Seonhee,10,0,35,25
1657994468512,MATH 10B,A03,093472,Lim; Seonhee,7,0,34,27
1657994468512,MATH 10B,B01,083739,Sinha; Shubham,14,0,30,16
1657994474536,MATH 18,A01,083743,Cinel; Cameron Alexander,9,0,30,21
1657994474536,MATH 18,A02,083744,Cinel; Cameron Alexander,18,0,30,12
1657994474536,MATH 18,A03,083745,Cinel; Cameron Alexander,10,0,30,20
1657994474536,MATH 18,B01,083748,Rideout; David Porter,5,0,37,32
1657994474536,MATH 18,B02,083749,Rideout; David Porter,5,0,36,31
1657994474536,MATH 18,B03,083750,Rideout; David Porter,3,0,37,34
1657994474536,MATH 18,B04,083751,Rideout; David Porter,7,0,36,29
1657994474536,MATH 18,B05,093473,Rideout; David Porter,7,0,36,29
1657994474536,MATH 18,B06,093474,Rideout; David Porter,6,0,36,30
1657994480558,MATH 20A,A01,083754,Zheng; Zequn,14,0,40,26
1657994486581,MATH 20B,A01,083756,Briones; Jor-el Thomas Caparas,4,0,36,32
1657994486581,MATH 20B,A02,083757,Briones; Jor-el Thomas Caparas,1,0,36,35
1657994486581,MATH 20B,A03,093475,Briones; Jor-el Thomas Caparas,3,0,36,33
1657994492608,MATH 20C,A01,083760,Briones; Jor-el Thomas Caparas,1,0,35,34
1657994492608,MATH 20C,A02,083761,Briones; Jor-el Thomas Caparas,8,0,35,27
1657994492608,MATH 20C,A03,093476,Briones; Jor-el Thomas Caparas,0,1,36,36
1657994492608,MATH 20C,B01,083762,Bach; Quang Tran,1,0,30,29
1657994498634,MATH 20D,A01,083765,Tran; Brian Kha,5,0,30,25
1657994498634,MATH 20D,A02,083766,Tran; Brian Kha,5,0,30,25
1657994498634,MATH 20D,A03,083767,Tran; Brian Kha,6,0,30,24
1657994504658,MATH 20E,A01,083771,Ganguly; Soumya,12,0,32,20
1657994504658,MATH 20E,A02,083772,Ganguly; Soumya,7,0,32,25
1657994504658,MATH 20E,B01,083773,Ciotti; Benjamin,20,0,35,15
1657994504658,MATH 20E,B02,083774,Ciotti; Benjamin,18,0,35,17
1657994510681,MATH 103A,A01,083777,Greenfeld; Be'Eri,6,0,36,30
1657994510681,MATH 103A,A02,083778,Greenfeld; Be'Eri,5,0,36,31
1657994510681,MATH 103A,A03,093561,Greenfeld; Be'Eri,7,0,36,29
1657994510681,MATH 103A,B01,083779,Greenfeld; Be'Eri,8,0,36,28
1657994510681,MATH 103A,B02,083780,Greenfeld; Be'Eri,4,0,36,32
1657994510681,MATH 103A,B03,093562,Greenfeld; Be'Eri,3,0,36,33
1657994516703,MATH 105,A01,085443,Carter; Anne Toulson,15,0,35,20
1657994516703,MATH 105,A02,093477,Carter; Anne Toulson,20,0,35,15
1657994522734,MATH 109,A01,083213,Ganzberger; Geoffrey Michael,3,0,34,31
1657994522734,MATH 109,A02,083214,Ganzberger; Geoffrey Michael,4,0,34,30
1657994522734,MATH 109,A03,093478,Ganzberger; Geoffrey Michael,2,0,34,32
1657994522734,MATH 109,B01,083215,Ganzberger; Geoffrey Michael,3,0,32,29
1657994522734,MATH 109,B02,083216,Ganzberger; Geoffrey Michael,3,0,32,29
1657994522734,MATH 109,B03,093479,Ganzberger; Geoffrey Michael,8,0,32,24
1657994528757,MATH 142A,A01,083219,Chow; Bennett,7,0,32,25
1657994528757,MATH 142A,A02,083220,Chow; Bennett,10,0,32,22
1657994528757,MATH 142A,A03,093480,Chow; Bennett,9,0,32,23
1657994528757,MATH 142A,B03,093481,Chow; Bennett,8,0,32,24
1657994528757,MATH 142A,B04,093558,Chow; Bennett,14,0,32,18
1657994528757,MATH 142A,B05,093559,Chow; Bennett,7,0,32,25
1657994534781,MATH 193A,A01,083224,Rotar; Vladimir,9,0,34,25
1657994534781,MATH 193A,A02,083225,Rotar; Vladimir,11,0,34,23
1657994534781,MATH 193A,A03,083781,Rotar; Vladimir,5,0,34,29
1657994534781,MATH 193A,A04,083782,Rotar; Vladimir,12,0,34,22
1657994534781,MATH 193A,A05,093482,Rotar; Vladimir,11,0,34,23
1657994540807,MATH 197,001,091859,McAuley; Julian John,9999,0,9999,0
1657994540807,MATH 197,002,095566,Kedlaya; Kiran S.,9997,0,9999,2
1657994540807,MATH 197,003,095567,Xiao; Ming,9999,0,9999,0
1657994540807,MATH 197,004,095571,Perols; Johan Lars,9998,0,9999,1
1657994547869,COGS 9,A01,083615,Shannon; Kyle Michael,11,0,75,64
1657994553892,COGS 11,A01,083617,Boyle; Mary E. T.,23,0,48,25
1657994559914,COGS 13,A01,083071,Bastos; Amalia Pinkusfeld,12,0,71,59
1657994565947,COGS 14A,A01,092681,Semenuks; Arturs,5,1,100,95
1657994571970,COGS 14B,A01,083073,Cheng; Tzu-Han,7,0,63,56
1657994577994,COGS 17,A01,092677,Semenuks; Arturs,7,0,81,74
1657994584016,COGS 100,A01,083619,Allen; Michael Gordon,17,0,70,53
1657994590042,COGS 101A,A01,083621,Davis; Joshua Daniel,9,0,68,59
1657994596067,COGS 101B,A01,091572,Allen; Michael Gordon,14,0,65,51
1657994602090,COGS 101C,A01,083625,Delgado; Tania,17,0,35,18
1657994608112,COGS 107A,A01,083627,Boyle; Mary E. T.,14,0,60,46
1657994614134,COGS 118A,A01,083075,Gupta; Anjum,21,0,76,55
1657994620162,CSE 3,A50,083646,Miranda; Gregory Joseph,24,0,50,26
1657994626188,CSE 8A,A50,083650,Miranda; Gregory Joseph,17,1,56,39
1657994632214,CSE 11,A01,083080,Cao; Yingjun,7,15,40,33
1657994638241,CSE 12,A01,083652,Krause-Levy; Sophia Louisa,30,1,120,90
1657994644262,CSE 15L,A01,083654,Morris; Justin Loren,9,0,50,41
1657994644262,CSE 15L,A02,083655,Morris; Justin Loren,11,0,50,39
1657994650285,CSE 20,A01,083657,Tran; Khoa Dang,39,0,80,41
1657994656312,CSE 21,A01,095574,Bach; Quang Tran,23,0,48,25
1657994662333,CSE 30,A01,083084,Eldon; John,8,0,80,72
1657994662333,CSE 30,B01,095061,Bhaskar; Nishant,9,0,50,41
1657994668356,CSE 100,A01,083659,Cao; Yingjun,5,4,70,65
1657994674380,CSE 134B,A01,083661,Powell; Thomas Allan,25,0,100,75
1657994680405,CSE 140,A01,083663,Gungor; Onat,17,0,85,68
1657994686427,CSE 140L,A01,083088,Eldon; John,23,0,100,77
1657994692454,CSE 175,A01,083665,Kumar; Rakesh,3,0,25,22
1657994698481,CSE 190,A00,092507,Dubnov; Shlomo,8,0,20,12
1657994704507,ECE 45,A01,083139,Congero; Spencer William,7,0,75,68
1657994710530,ECE 65,A50,083695,Saad; Andrew S,12,0,30,18
1657994710530,ECE 65,A51,095125,Saad; Andrew S,24,0,26,2
1657994716556,ECE 109,A01,091882,Touri; Behrouz,21,0,70,49
1657994722584,ECE 180,A00,083140,Abi Samra; Nicholas Camill,1,0,30,29
1657994722584,ECE 180,B00,083141,Abi Samra; Nicholas Camill,0,0,30,30
1657994728607,MATH 10A,A01,083735,Patchell; Gregory David,2,0,30,28
1657994728607,MATH 10A,A02,083736,Patchell; Gregory David,20,0,30,10
1657994728607,MATH 10A,A03,083737,Patchell; Gregory David,16,0,30,14
1657994734630,MATH 10B,A01,083207,Lim; Seonhee,9,0,34,25
1657994734630,MATH 10B,A02,083208,Lim; Seonhee,10,0,35,25
1657994734630,MATH 10B,A03,093472,Lim; Seonhee,7,0,34,27
1657994734630,MATH 10B,B01,083739,Sinha; Shubham,14,0,30,16
1657994740654,MATH 18,A01,083743,Cinel; Cameron Alexander,9,0,30,21
1657994740654,MATH 18,A02,083744,Cinel; Cameron Alexander,18,0,30,12
1657994740654,MATH 18,A03,083745,Cinel; Cameron Alexander,10,0,30,20
1657994740654,MATH 18,B01,083748,Rideout; David Porter,5,0,37,32
1657994740654,MATH 18,B02,083749,Rideout; David Porter,5,0,36,31
1657994740654,MATH 18,B03,083750,Rideout; David Porter,3,0,37,34
1657994740654,MATH 18,B04,083751,Rideout; David Porter,7,0,36,29
1657994740654,MATH 18,B05,093473,Rideout; David Porter,7,0,36,29
1657994740654,MATH 18,B06,093474,Rideout; David Porter,6,0,36,30
1657994746679,MATH 20A,A01,083754,Zheng; Zequn,14,0,40,26
1657994752707,MATH 20B,A01,083756,Briones; Jor-el Thomas Caparas,4,0,36,32
1657994752707,MATH 20B,A02,083757,Briones; Jor-el Thomas Caparas,1,0,36,35
1657994752707,MATH 20B,A03,093475,Briones; Jor-el Thomas Caparas,3,0,36,33
1657994758729,MATH 20C,A01,083760,Briones; Jor-el Thomas Caparas,1,0,35,34
1657994758729,MATH 20C,A02,083761,Briones; Jor-el Thomas Caparas,8,0,35,27
1657994758729,MATH 20C,A03,093476,Briones; Jor-el Thomas Caparas,0,1,36,36
1657994758729,MATH 20C,B01,083762,Bach; Quang Tran,1,0,30,29
1657994764755,MATH 20D,A01,083765,Tran; Brian Kha,5,0,30,25
1657994764755,MATH 20D,A02,083766,Tran; Brian Kha,5,0,30,25
1657994764755,MATH 20D,A03,083767,Tran; Brian Kha,6,0,30,24
1657994770782,MATH 20E,A01,083771,Ganguly; Soumya,12,0,32,20
1657994770782,MATH 20E,A02,083772,Ganguly; Soumya,7,0,32,25
1657994770782,MATH 20E,B01,083773,Ciotti; Benjamin,20,0,35,15
1657994770782,MATH 20E,B02,083774,Ciotti; Benjamin,18,0,35,17
1657994776813,MATH 103A,A01,083777,Greenfeld; Be'Eri,6,0,36,30
1657994776813,MATH 103A,A02,083778,Greenfeld; Be'Eri,5,0,36,31
1657994776813,MATH 103A,A03,093561,Greenfeld; Be'Eri,7,0,36,29
1657994776813,MATH 103A,B01,083779,Greenfeld; Be'Eri,8,0,36,28
1657994776813,MATH 103A,B02,083780,Greenfeld; Be'Eri,4,0,36,32
1657994776813,MATH 103A,B03,093562,Greenfeld; Be'Eri,3,0,36,33
1657994782836,MATH 105,A01,085443,Carter; Anne Toulson,15,0,35,20
1657994782836,MATH 105,A02,093477,Carter; Anne Toulson,20,0,35,15
1657994788859,MATH 109,A01,083213,Ganzberger; Geoffrey Michael,3,0,34,31
1657994788859,MATH 109,A02,083214,Ganzberger; Geoffrey Michael,4,0,34,30
1657994788859,MATH 109,A03,093478,Ganzberger; Geoffrey Michael,2,0,34,32
1657994788859,MATH 109,B01,083215,Ganzberger; Geoffrey Michael,3,0,32,29
1657994788859,MATH 109,B02,083216,Ganzberger; Geoffrey Michael,3,0,32,29
1657994788859,MATH 109,B03,093479,Ganzberger; Geoffrey Michael,8,0,32,24
1657994794893,MATH 142A,A01,083219,Chow; Bennett,7,0,32,25
1657994794893,MATH 142A,A02,083220,Chow; Bennett,10,0,32,22
1657994794893,MATH 142A,A03,093480,Chow; Bennett,9,0,32,23
1657994794893,MATH 142A,B03,093481,Chow; Bennett,8,0,32,24
1657994794893,MATH 142A,B04,093558,Chow; Bennett,14,0,32,18
1657994794893,MATH 142A,B05,093559,Chow; Bennett,7,0,32,25
1657994800920,MATH 193A,A01,083224,Rotar; Vladimir,9,0,34,25
1657994800920,MATH 193A,A02,083225,Rotar; Vladimir,11,0,34,23
1657994800920,MATH 193A,A03,083781,Rotar; Vladimir,5,0,34,29
1657994800920,MATH 193A,A04,083782,Rotar; Vladimir,12,0,34,22
1657994800920,MATH 193A,A05,093482,Rotar; Vladimir,11,0,34,23
1657994806944,MATH 197,001,091859,McAuley; Julian John,9999,0,9999,0
1657994806944,MATH 197,002,095566,Kedlaya; Kiran S.,9997,0,9999,2
1657994806944,MATH 197,003,095567,Xiao; Ming,9999,0,9999,0
1657994806944,MATH 197,004,095571,Perols; Johan Lars,9998,0,9999,1
1657994814009,COGS 9,A01,083615,Shannon; Kyle Michael,11,0,75,64
1657994820033,COGS 11,A01,083617,Boyle; Mary E. T.,23,0,48,25
1657994826061,COGS 13,A01,083071,Bastos; Amalia Pinkusfeld,12,0,71,59
1657994832084,COGS 14A,A01,092681,Semenuks; Arturs,5,1,100,95
1657994838111,COGS 14B,A01,083073,Cheng; Tzu-Han,7,0,63,56
1657994844134,COGS 17,A01,092677,Semenuks; Arturs,7,0,81,74
1657994850161,COGS 100,A01,083619,Allen; Michael Gordon,17,0,70,53
1657994856184,COGS 101A,A01,083621,Davis; Joshua Daniel,9,0,68,59
1657994862207,COGS 101B,A01,091572,Allen; Michael Gordon,14,0,65,51
1657994868229,COGS 101C,A01,083625,Delgado; Tania,17,0,35,18
1657994874256,COGS 107A,A01,083627,Boyle; Mary E. T.,14,0,60,46
1657994880280,COGS 118A,A01,083075,Gupta; Anjum,21,0,76,55
1657994886303,CSE 3,A50,083646,Miranda; Gregory Joseph,24,0,50,26
1657994892326,CSE 8A,A50,083650,Miranda; Gregory Joseph,17,1,56,39
1657994898350,CSE 11,A01,083080,Cao; Yingjun,7,15,40,33
1657994904372,CSE 12,A01,083652,Krause-Levy; Sophia Louisa,30,1,120,90
1657994910396,CSE 15L,A01,083654,Morris; Justin Loren,9,0,50,41
1657994910396,CSE 15L,A02,083655,Morris; Justin Loren,11,0,50,39
1657994916424,CSE 20,A01,083657,Tran; Khoa Dang,39,0,80,41
1657994922451,CSE 21,A01,095574,Bach; Quang Tran,23,0,48,25
1657994928472,CSE 30,A01,083084,Eldon; John,8,0,80,72
1657994928472,CSE 30,B01,095061,Bhaskar; Nishant,9,0,50,41
1657994934496,CSE 100,A01,083659,Cao; Yingjun,5,4,70,65
1657994940524,CSE 134B,A01,083661,Powell; Thomas Allan,25,0,100,75
1657994946547,CSE 140,A01,083663,Gungor; Onat,17,0,85,68
1657994952573,CSE 140L,A01,083088,Eldon; John,23,0,100,77
1657994958608,CSE 175,A01,083665,Kumar; Rakesh,3,0,25,22
1657994964633,CSE 190,A00,092507,Dubnov; Shlomo,8,0,20,12
1657994970654,ECE 45,A01,083139,Congero; Spencer William,7,0,75,68
1657994976681,ECE 65,A50,083695,Saad; Andrew S,12,0,30,18
1657994976681,ECE 65,A51,095125,Saad; Andrew S,24,0,26,2
1657994982709,ECE 109,A01,091882,Touri; Behrouz,21,0,70,49
1657994988732,ECE 180,A00,083140,Abi Samra; Nicholas Camill,1,0,30,29
1657994988732,ECE 180,B00,083141,Abi Samra; Nicholas Camill,0,0,30,30
1657994994759,MATH 10A,A01,083735,Patchell; Gregory David,2,0,30,28
1657994994759,MATH 10A,A02,083736,Patchell; Gregory David,20,0,30,10
1657994994759,MATH 10A,A03,083737,Patchell; Gregory David,16,0,30,14
1657995000783,MATH 10B,A01,083207,Lim; Seonhee,9,0,34,25
1657995000783,MATH 10B,A02,083208,Lim; Seonhee,10,0,35,25
1657995000783,MATH 10B,A03,093472,Lim; Seonhee,7,0,34,27
1657995000783,MATH 10B,B01,083739,Sinha; Shubham,14,0,30,16
1657995006808,MATH 18,A01,083743,Cinel; Cameron Alexander,9,0,30,21
1657995006808,MATH 18,A02,083744,Cinel; Cameron Alexander,18,0,30,12
1657995006808,MATH 18,A03,083745,Cinel; Cameron Alexander,10,0,30,20
1657995006808,MATH 18,B01,083748,Rideout; David Porter,5,0,37,32
1657995006808,MATH 18,B02,083749,Rideout; David Porter,5,0,36,31
1657995006808,MATH 18,B03,083750,Rideout; David Porter,3,0,37,34
1657995006808,MATH 18,B04,083751,Rideout; David Porter,7,0,36,29
1657995006808,MATH 18,B05,093473,Rideout; David Porter,7,0,36,29
1657995006808,MATH 18,B06,093474,Rideout; David Porter,6,0,36,30
1657995012833,MATH 20A,A01,083754,Zheng; Zequn,14,0,40,26
1657995018857,MATH 20B,A01,083756,Briones; Jor-el Thomas Caparas,4,0,36,32
1657995018857,MATH 20B,A02,083757,Briones; Jor-el Thomas Caparas,1,0,36,35
1657995018857,MATH 20B,A03,093475,Briones; Jor-el Thomas Caparas,3,0,36,33
1657995024879,MATH 20C,A01,083760,Briones; Jor-el Thomas Caparas,1,0,35,34
1657995024879,MATH 20C,A02,083761,Briones; Jor-el Thomas Caparas,8,0,35,27
1657995024879,MATH 20C,A03,093476,Briones; Jor-el Thomas Caparas,0,1,36,36
1657995024879,MATH 20C,B01,083762,Bach; Quang Tran,1,0,30,29
1657995030913,MATH 20D,A01,083765,Tran; Brian Kha,5,0,30,25
1657995030913,MATH 20D,A02,083766,Tran; Brian Kha,5,0,30,25
1657995030913,MATH 20D,A03,083767,Tran; Brian Kha,6,0,30,24
1657995036959,MATH 20E,A01,083771,Ganguly; Soumya,12,0,32,20
1657995036959,MATH 20E,A02,083772,Ganguly; Soumya,7,0,32,25
1657995036959,MATH 20E,B01,083773,Ciotti; Benjamin,20,0,35,15
1657995036959,MATH 20E,B02,083774,Ciotti; Benjamin,18,0,35,17
1657995042983,MATH 103A,A01,083777,Greenfeld; Be'Eri,6,0,36,30
1657995042983,MATH 103A,A02,083778,Greenfeld; Be'Eri,5,0,36,31
1657995042983,MATH 103A,A03,093561,Greenfeld; Be'Eri,7,0,36,29
1657995042983,MATH 103A,B01,083779,Greenfeld; Be'Eri,8,0,36,28
1657995042983,MATH 103A,B02,083780,Greenfeld; Be'Eri,4,0,36,32
1657995042983,MATH 103A,B03,093562,Greenfeld; Be'Eri,3,0,36,33
1657995049007,MATH 105,A01,085443,Carter; Anne Toulson,15,0,35,20
1657995049007,MATH 105,A02,093477,Carter; Anne Toulson,20,0,35,15
1657995055036,MATH 109,A01,083213,Ganzberger; Geoffrey Michael,3,0,34,31
1657995055036,MATH 109,A02,083214,Ganzberger; Geoffrey Michael,4,0,34,30
1657995055036,MATH 109,A03,093478,Ganzberger; Geoffrey Michael,2,0,34,32
1657995055036,MATH 109,B01,083215,Ganzberger; Geoffrey Michael,3,0,32,29
1657995055036,MATH 109,B02,083216,Ganzberger; Geoffrey Michael,3,0,32,29
1657995055036,MATH 109,B03,093479,Ganzberger; Geoffrey Michael,8,0,32,24
1657995061059,MATH 142A,A01,083219,Chow; Bennett,7,0,32,25
1657995061059,MATH 142A,A02,083220,Chow; Bennett,10,0,32,22
1657995061059,MATH 142A,A03,093480,Chow; Bennett,9,0,32,23
1657995061059,MATH 142A,B03,093481,Chow; Bennett,8,0,32,24
1657995061059,MATH 142A,B04,093558,Chow; Bennett,14,0,32,18
1657995061059,MATH 142A,B05,093559,Chow; Bennett,7,0,32,25
1657995067157,MATH 193A,A01,083224,Rotar; Vladimir,9,0,34,25
1657995067157,MATH 193A,A02,083225,Rotar; Vladimir,11,0,34,23
1657995067157,MATH 193A,A03,083781,Rotar; Vladimir,5,0,34,29
1657995067157,MATH 193A,A04,083782,Rotar; Vladimir,12,0,34,22
1657995067157,MATH 193A,A05,093482,Rotar; Vladimir,11,0,34,23
1657995073182,MATH 197,001,091859,McAuley; Julian John,9999,0,9999,0
1657995073182,MATH 197,002,095566,Kedlaya; Kiran S.,9997,0,9999,2
1657995073182,MATH 197,003,095567,Xiao; Ming,9999,0,9999,0
1657995073182,MATH 197,004,095571,Perols; Johan Lars,9998,0,9999,1
1657995080234,COGS 9,A01,083615,Shannon; Kyle Michael,11,0,75,64
1657995086259,COGS 11,A01,083617,Boyle; Mary E. T.,23,0,48,25
1657995092282,COGS 13,A01,083071,Bastos; Amalia Pinkusfeld,12,0,71,59
1657995098308,COGS 14A,A01,092681,Semenuks; Arturs,5,1,100,95
1657995104330,COGS 14B,A01,083073,Cheng; Tzu-Han,7,0,63,56
1657995110353,COGS 17,A01,092677,Semenuks; Arturs,7,0,81,74
1657995116386,COGS 100,A01,083619,Allen; Michael Gordon,17,0,70,53
1657995122407,COGS 101A,A01,083621,Davis; Joshua Daniel,9,0,68,59
1657995128432,COGS 101B,A01,091572,Allen; Michael Gordon,14,0,65,51
1657995134454,COGS 101C,A01,083625,Delgado; Tania,17,0,35,18
1657995140484,COGS 107A,A01,083627,Boyle; Mary E. T.,14,0,60,46
1657995146509,COGS 118A,A01,083075,Gupta; Anjum,21,0,76,55
1657995152534,CSE 3,A50,083646,Miranda; Gregory Joseph,24,0,50,26
1657995158566,CSE 8A,A50,083650,Miranda; Gregory Joseph,17,1,56,39
1657995164593,CSE 11,A01,083080,Cao; Yingjun,7,15,40,33
1657995170618,CSE 12,A01,083652,Krause-Levy; Sophia Louisa,30,1,120,90
1657995176641,CSE 15L,A01,083654,Morris; Justin Loren,9,0,50,41
1657995176641,CSE 15L,A02,083655,Morris; Justin Loren,11,0,50,39
1657995182665,CSE 20,A01,083657,Tran; Khoa Dang,39,0,80,41
1657995188688,CSE 21,A01,095574,Bach; Quang Tran,23,0,48,25
1657995194716,CSE 30,A01,083084,Eldon; John,8,0,80,72
1657995194716,CSE 30,B01,095061,Bhaskar; Nishant,9,0,50,41
1657995200743,CSE 100,A01,083659,Cao; Yingjun,5,4,70,65
1657995206766,CSE 134B,A01,083661,Powell; Thomas Allan,25,0,100,75
1657995212793,CSE 140,A01,083663,Gungor; Onat,17,0,85,68
1657995218831,CSE 140L,A01,083088,Eldon; John,23,0,100,77
1657995224858,CSE 175,A01,083665,Kumar; Rakesh,3,0,25,22
1657995230882,CSE 190,A00,092507,Dubnov; Shlomo,8,0,20,12
1657995236908,ECE 45,A01,083139,Congero; Spencer William,7,0,75,68
1657995242930,ECE 65,A50,083695,Saad; Andrew S,12,0,30,18
1657995242930,ECE 65,A51,095125,Saad; Andrew S,24,0,26,2
1657995248959,ECE 109,A01,091882,Touri; Behrouz,21,0,70,49
1657995254982,ECE 180,A00,083140,Abi Samra; Nicholas Camill,1,0,30,29
1657995254982,ECE 180,B00,083141,Abi Samra; Nicholas Camill,0,0,30,30
1657995261011,MATH 10A,A01,083735,Patchell; Gregory David,2,0,30,28
1657995261011,MATH 10A,A02,083736,Patchell; Gregory David,20,0,30,10
1657995261011,MATH 10A,A03,083737,Patchell; Gregory David,16,0,30,14
1657995267044,MATH 10B,A01,083207,Lim; Seonhee,9,0,34,25
1657995267044,MATH 10B,A02,083208,Lim; Seonhee,10,0,35,25
1657995267044,MATH 10B,A03,093472,Lim; Seonhee,7,0,34,27
1657995267044,MATH 10B,B01,083739,Sinha; Shubham,14,0,30,16
1657995273077,MATH 18,A01,083743,Cinel; Cameron Alexander,9,0,30,21
1657995273077,MATH 18,A02,083744,Cinel; Cameron Alexander,18,0,30,12
1657995273077,MATH 18,A03,083745,Cinel; Cameron Alexander,10,0,30,20
1657995273077,MATH 18,B01,083748,Rideout; David Porter,5,0,37,32
1657995273077,MATH 18,B02,083749,Rideout; David Porter,5,0,36,31
1657995273077,MATH 18,B03,083750,Rideout; David Porter,3,0,37,34
1657995273077,MATH 18,B04,083751,Rideout; David Porter,7,0,36,29
1657995273077,MATH 18,B05,093473,Rideout; David Porter,7,0,36,29
1657995273077,MATH 18,B06,093474,Rideout; David Porter,6,0,36,30
1657995279104,MATH 20A,A01,083754,Zheng; Zequn,14,0,40,26
1657995285126,MATH 20B,A01,083756,Briones; Jor-el Thomas Caparas,4,0,36,32
1657995285126,MATH 20B,A02,083757,Briones; Jor-el Thomas Caparas,1,0,36,35
1657995285126,MATH 20B,A03,093475,Briones; Jor-el Thomas Caparas,3,0,36,33
1657995291150,MATH 20C,A01,083760,Briones; Jor-el Thomas Caparas,1,0,35,34
1657995291150,MATH 20C,A02,083761,Briones; Jor-el Thomas Caparas,8,0,35,27
1657995291150,MATH 20C,A03,093476,Briones; Jor-el Thomas Caparas,0,1,36,36
1657995291150,MATH 20C,B01,083762,Bach; Quang Tran,1,0,30,29
1657995297173,MATH 20D,A01,083765,Tran; Brian Kha,5,0,30,25
1657995297173,MATH 20D,A02,083766,Tran; Brian Kha,5,0,30,25
1657995297173,MATH 20D,A03,083767,Tran; Brian Kha,6,0,30,24
1657995303201,MATH 20E,A01,083771,Ganguly; Soumya,12,0,32,20
1657995303201,MATH 20E,A02,083772,Ganguly; Soumya,7,0,32,25
1657995303201,MATH 20E,B01,083773,Ciotti; Benjamin,20,0,35,15
1657995303201,MATH 20E,B02,083774,Ciotti; Benjamin,18,0,35,17
1657995309229,MATH 103A,A01,083777,Greenfeld; Be'Eri,6,0,36,30
1657995309229,MATH 103A,A02,083778,Greenfeld; Be'Eri,5,0,36,31
1657995309229,MATH 103A,A03,093561,Greenfeld; Be'Eri,7,0,36,29
1657995309229,MATH 103A,B01,083779,Greenfeld; Be'Eri,8,0,36,28
1657995309229,MATH 103A,B02,083780,Greenfeld; Be'Eri,4,0,36,32
1657995309229,MATH 103A,B03,093562,Greenfeld; Be'Eri,3,0,36,33
1657995315256,MATH 105,A01,085443,Carter; Anne Toulson,15,0,35,20
1657995315256,MATH 105,A02,093477,Carter; Anne Toulson,20,0,35,15
1657995321281,MATH 109,A01,083213,Ganzberger; Geoffrey Michael,3,0,34,31
1657995321281,MATH 109,A02,083214,Ganzberger; Geoffrey Michael,4,0,34,30
1657995321281,MATH 109,A03,093478,Ganzberger; Geoffrey Michael,2,0,34,32
1657995321281,MATH 109,B01,083215,Ganzberger; Geoffrey Michael,3,0,32,29
1657995321281,MATH 109,B02,083216,Ganzberger; Geoffrey Michael,3,0,32,29
1657995321281,MATH 109,B03,093479,Ganzberger; Geoffrey Michael,8,0,32,24
1657995327305,MATH 142A,A01,083219,Chow; Bennett,7,0,32,25
1657995327305,MATH 142A,A02,083220,Chow; Bennett,10,0,32,22
1657995327305,MATH 142A,A03,093480,Chow; Bennett,9,0,32,23
1657995327305,MATH 142A,B03,093481,Chow; Bennett,8,0,32,24
1657995327305,MATH 142A,B04,093558,Chow; Bennett,14,0,32,18
1657995327305,MATH 142A,B05,093559,Chow; Bennett,7,0,32,25
1657995333340,MATH 193A,A01,083224,Rotar; Vladimir,9,0,34,25
1657995333340,MATH 193A,A02,083225,Rotar; Vladimir,11,0,34,23
1657995333340,MATH 193A,A03,083781,Rotar; Vladimir,5,0,34,29
1657995333340,MATH 193A,A04,083782,Rotar; Vladimir,12,0,34,22
1657995333340,MATH 193A,A05,093482,Rotar; Vladimir,11,0,34,23
1657995339363,MATH 197,001,091859,McAuley; Julian John,9999,0,9999,0
1657995339363,MATH 197,002,095566,Kedlaya; Kiran S.,9997,0,9999,2
1657995339363,MATH 197,003,095567,Xiao; Ming,9999,0,9999,0
1657995339363,MATH 197,004,095571,Perols; Johan Lars,9998,0,9999,1
1657995346425,COGS 9,A01,083615,Shannon; Kyle Michael,11,0,75,64
1657995352451,COGS 11,A01,083617,Boyle; Mary E. T.,23,0,48,25
1657995358478,COGS 13,A01,083071,Bastos; Amalia Pinkusfeld,12,0,71,59
1657995364507,COGS 14A,A01,092681,Semenuks; Arturs,5,1,100,95
1657995370538,COGS 14B,A01,083073,Cheng; Tzu-Han,7,0,63,56
1657995376566,COGS 17,A01,092677,Semenuks; Arturs,7,0,81,74
1657995382588,COGS 100,A01,083619,Allen; Michael Gordon,17,0,70,53
1657995388610,COGS 101A,A01,083621,Davis; Joshua Daniel,9,0,68,59
1657995394636,COGS 101B,A01,091572,Allen; Michael Gordon,14,0,65,51
1657995400660,COGS 101C,A01,083625,Delgado; Tania,17,0,35,18
1657995406688,COGS 107A,A01,083627,Boyle; Mary E. T.,14,0,60,46
1657995412711,COGS 118A,A01,083075,Gupta; Anjum,21,0,76,55
1657995418738,CSE 3,A50,083646,Miranda; Gregory Joseph,24,0,50,26
1657995424764,CSE 8A,A50,083650,Miranda; Gregory Joseph,17,1,56,39
1657995430786,CSE 11,A01,083080,Cao; Yingjun,7,15,40,33
1657995436808,CSE 12,A01,083652,Krause-Levy; Sophia Louisa,30,1,120,90
1657995442829,CSE 15L,A01,083654,Morris; Justin Loren,9,0,50,41
1657995442829,CSE 15L,A02,083655,Morris; Justin Loren,11,0,50,39
1657995448852,CSE 20,A01,083657,Tran; Khoa Dang,39,0,80,41
1657995454880,CSE 21,A01,095574,Bach; Quang Tran,23,0,48,25
1657995460903,CSE 30,A01,083084,Eldon; John,8,0,80,72
1657995460903,CSE 30,B01,095061,Bhaskar; Nishant,9,0,50,41
1657995466924,CSE 100,A01,083659,Cao; Yingjun,5,4,70,65
1657995472947,CSE 134B,A01,083661,Powell; Thomas Allan,25,0,100,75
1657995478971,CSE 140,A01,083663,Gungor; Onat,17,0,85,68
1657995484995,CSE 140L,A01,083088,Eldon; John,23,0,100,77
1657995491032,CSE 175,A01,083665,Kumar; Rakesh,3,0,25,22
1657995497056,CSE 190,A00,092507,Dubnov; Shlomo,8,0,20,12
1657995503083,ECE 45,A01,083139,Congero; Spencer William,7,0,75,68
1657995509107,ECE 65,A50,083695,Saad; Andrew S,12,0,30,18
1657995509107,ECE 65,A51,095125,Saad; Andrew S,24,0,26,2
1657995515130,ECE 109,A01,091882,Touri; Behrouz,21,0,70,49
1657995521160,ECE 180,A00,083140,Abi Samra; Nicholas Camill,1,0,30,29
1657995521160,ECE 180,B00,083141,Abi Samra; Nicholas Camill,0,0,30,30
1657995527188,MATH 10A,A01,083735,Patchell; Gregory David,2,0,30,28
1657995527188,MATH 10A,A02,083736,Patchell; Gregory David,20,0,30,10
1657995527188,MATH 10A,A03,083737,Patchell; Gregory David,16,0,30,14
1657995533212,MATH 10B,A01,083207,Lim; Seonhee,9,0,34,25
1657995533212,MATH 10B,A02,083208,Lim; Seonhee,10,0,35,25
1657995533212,MATH 10B,A03,093472,Lim; Seonhee,7,0,34,27
1657995533212,MATH 10B,B01,083739,Sinha; Shubham,14,0,30,16
1657995539238,MATH 18,A01,083743,Cinel; Cameron Alexander,9,0,30,21
1657995539238,MATH 18,A02,083744,Cinel; Cameron Alexander,18,0,30,12
1657995539238,MATH 18,A03,083745,Cinel; Cameron Alexander,10,0,30,20
1657995539238,MATH 18,B01,083748,Rideout; David Porter,5,0,37,32
1657995539238,MATH 18,B02,083749,Rideout; David Porter,5,0,36,31
1657995539238,MATH 18,B03,083750,Rideout; David Porter,3,0,37,34
1657995539238,MATH 18,B04,083751,Rideout; David Porter,7,0,36,29
1657995539238,MATH 18,B05,093473,Rideout; David Porter,7,0,36,29
1657995539238,MATH 18,B06,093474,Rideout; David Porter,6,0,36,30
1657995545261,MATH 20A,A01,083754,Zheng; Zequn,14,0,40,26
1657995551291,MATH 20B,A01,083756,Briones; Jor-el Thomas Caparas,4,0,36,32
1657995551291,MATH 20B,A02,083757,Briones; Jor-el Thomas Caparas,1,0,36,35
1657995551291,MATH 20B,A03,093475,Briones; Jor-el Thomas Caparas,3,0,36,33
1657995557322,MATH 20C,A01,083760,Briones; Jor-el Thomas Caparas,1,0,35,34
1657995557322,MATH 20C,A02,083761,Briones; Jor-el Thomas Caparas,8,0,35,27
1657995557322,MATH 20C,A03,093476,Briones; Jor-el Thomas Caparas,0,1,36,36
1657995557322,MATH 20C,B01,083762,Bach; Quang Tran,1,0,30,29
1657995563349,MATH 20D,A01,083765,Tran; Brian Kha,5,0,30,25
1657995563349,MATH 20D,A02,083766,Tran; Brian Kha,5,0,30,25
1657995563349,MATH 20D,A03,083767,Tran; Brian Kha,6,0,30,24
1657995569371,MATH 20E,A01,083771,Ganguly; Soumya,12,0,32,20
1657995569371,MATH 20E,A02,083772,Ganguly; Soumya,7,0,32,25
1657995569371,MATH 20E,B01,083773,Ciotti; Benjamin,20,0,35,15
1657995569371,MATH 20E,B02,083774,Ciotti; Benjamin,18,0,35,17
1657995575401,MATH 103A,A01,083777,Greenfeld; Be'Eri,6,0,36,30
1657995575401,MATH 103A,A02,083778,Greenfeld; Be'Eri,5,0,36,31
1657995575401,MATH 103A,A03,093561,Greenfeld; Be'Eri,7,0,36,29
1657995575401,MATH 103A,B01,083779,Greenfeld; Be'Eri,8,0,36,28
1657995575401,MATH 103A,B02,083780,Greenfeld; Be'Eri,4,0,36,32
1657995575401,MATH 103A,B03,093562,Greenfeld; Be'Eri,3,0,36,33
1657995581425,MATH 105,A01,085443,Carter; Anne Toulson,15,0,35,20
1657995581425,MATH 105,A02,093477,Carter; Anne Toulson,20,0,35,15
1657995587447,MATH 109,A01,083213,Ganzberger; Geoffrey Michael,3,0,34,31
1657995587447,MATH 109,A02,083214,Ganzberger; Geoffrey Michael,4,0,34,30
1657995587447,MATH 109,A03,093478,Ganzberger; Geoffrey Michael,2,0,34,32
1657995587447,MATH 109,B01,083215,Ganzberger; Geoffrey Michael,3,0,32,29
1657995587447,MATH 109,B02,083216,Ganzberger; Geoffrey Michael,3,0,32,29
1657995587447,MATH 109,B03,093479,Ganzberger; Geoffrey Michael,8,0,32,24
1657995593470,MATH 142A,A01,083219,Chow; Bennett,7,0,32,25
1657995593470,MATH 142A,A02,083220,Chow; Bennett,10,0,32,22
1657995593470,MATH 142A,A03,093480,Chow; Bennett,9,0,32,23
1657995593470,MATH 142A,B03,093481,Chow; Bennett,8,0,32,24
1657995593470,MATH 142A,B04,093558,Chow; Bennett,14,0,32,18
1657995593470,MATH 142A,B05,093559,Chow; Bennett,7,0,32,25
1657995599493,MATH 193A,A01,083224,Rotar; Vladimir,9,0,34,25
1657995599493,MATH 193A,A02,083225,Rotar; Vladimir,11,0,34,23
1657995599493,MATH 193A,A03,083781,Rotar; Vladimir,5,0,34,29
1657995599493,MATH 193A,A04,083782,Rotar; Vladimir,12,0,34,22
1657995599493,MATH 193A,A05,093482,Rotar; Vladimir,11,0,34,23
1657995605515,MATH 197,001,091859,McAuley; Julian John,9999,0,9999,0
1657995605515,MATH 197,002,095566,Kedlaya; Kiran S.,9997,0,9999,2
1657995605515,MATH 197,003,095567,Xiao; Ming,9999,0,9999,0
1657995605515,MATH 197,004,095571,Perols; Johan Lars,9998,0,9999,1
1657995612568,COGS 9,A01,083615,Shannon; Kyle Michael,11,0,75,64
1657995618597,COGS 11,A01,083617,Boyle; Mary E. T.,23,0,48,25
1657995624627,COGS 13,A01,083071,Bastos; Amalia Pinkusfeld,12,0,71,59
1657995630650,COGS 14A,A01,092681,Semenuks; Arturs,5,1,100,95
1657995636673,COGS 14B,A01,083073,Cheng; Tzu-Han,7,0,63,56
1657995642695,COGS 17,A01,092677,Semenuks; Arturs,7,0,81,74
1657995648718,COGS 100,A01,083619,Allen; Michael Gordon,17,0,70,53
1657995654742,COGS 101A,A01,083621,Davis; Joshua Daniel,9,0,68,59
1657995660858,COGS 101B,A01,091572,Allen; Michael Gordon,14,0,65,51
1657995666880,COGS 101C,A01,083625,Delgado; Tania,17,0,35,18
1657995672904,COGS 107A,A01,083627,Boyle; Mary E. T.,14,0,60,46
1657995678943,COGS 118A,A01,083075,Gupta; Anjum,21,0,76,55
1657995684972,CSE 3,A50,083646,Miranda; Gregory Joseph,24,0,50,26
1657995690999,CSE 8A,A50,083650,Miranda; Gregory Joseph,17,1,56,39
1657995697026,CSE 11,A01,083080,Cao; Yingjun,7,15,40,33
1657995703053,CSE 12,A01,083652,Krause-Levy; Sophia Louisa,30,1,120,90
1657995709076,CSE 15L,A01,083654,Morris; Justin Loren,9,0,50,41
1657995709076,CSE 15L,A02,083655,Morris; Justin Loren,11,0,50,39
1657995715103,CSE 20,A01,083657,Tran; Khoa Dang,39,0,80,41
1657995721124,CSE 21,A01,095574,Bach; Quang Tran,23,0,48,25
1657995727148,CSE 30,A01,083084,Eldon; John,8,0,80,72
1657995727148,CSE 30,B01,095061,Bhaskar; Nishant,9,0,50,41
1657995733170,CSE 100,A01,083659,Cao; Yingjun,5,4,70,65
1657995739207,CSE 134B,A01,083661,Powell; Thomas Allan,25,0,100,75
1657995745229,CSE 140,A01,083663,Gungor; Onat,17,0,85,68
1657995751254,CSE 140L,A01,083088,Eldon; John,23,0,100,77
1657995757281,CSE 175,A01,083665,Kumar; Rakesh,3,0,25,22
1657995763304,CSE 190,A00,092507,Dubnov; Shlomo,8,0,20,12
1657995769329,ECE 45,A01,083139,Congero; Spencer William,7,0,75,68
1657995775357,ECE 65,A50,083695,Saad; Andrew S,12,0,30,18
1657995775357,ECE 65,A51,095125,Saad; Andrew S,24,0,26,2
1657995781383,ECE 109,A01,091882,Touri; Behrouz,21,0,70,49
1657995787415,ECE 180,A00,083140,Abi Samra; Nicholas Camill,1,0,30,29
1657995787415,ECE 180,B00,083141,Abi Samra; Nicholas Camill,0,0,30,30
1657995793439,MATH 10A,A01,083735,Patchell; Gregory David,2,0,30,28
1657995793439,MATH 10A,A02,083736,Patchell; Gregory David,20,0,30,10
1657995793439,MATH 10A,A03,083737,Patchell; Gregory David,16,0,30,14
1657995799469,MATH 10B,A01,083207,Lim; Seonhee,9,0,34,25
1657995799469,MATH 10B,A02,083208,Lim; Seonhee,10,0,35,25
1657995799469,MATH 10B,A03,093472,Lim; Seonhee,7,0,34,27
1657995799469,MATH 10B,B01,083739,Sinha; Shubham,14,0,30,16
1657995805499,MATH 18,A01,083743,Cinel; Cameron Alexander,9,0,30,21
1657995805499,MATH 18,A02,083744,Cinel; Cameron Alexander,18,0,30,12
1657995805499,MATH 18,A03,083745,Cinel; Cameron Alexander,10,0,30,20
1657995805499,MATH 18,B01,083748,Rideout; David Porter,5,0,37,32
1657995805499,MATH 18,B02,083749,Rideout; David Porter,5,0,36,31
1657995805499,MATH 18,B03,083750,Rideout; David Porter,3,0,37,34
1657995805499,MATH 18,B04,083751,Rideout; David Porter,7,0,36,29
1657995805499,MATH 18,B05,093473,Rideout; David Porter,7,0,36,29
1657995805499,MATH 18,B06,093474,Rideout; David Porter,6,0,36,30
1657995811522,MATH 20A,A01,083754,Zheng; Zequn,14,0,40,26
1657995817550,MATH 20B,A01,083756,Briones; Jor-el Thomas Caparas,4,0,36,32
1657995817550,MATH 20B,A02,083757,Briones; Jor-el Thomas Caparas,1,0,36,35
1657995817550,MATH 20B,A03,093475,Briones; Jor-el Thomas Caparas,3,0,36,33
1657995823575,MATH 20C,A01,083760,Briones; Jor-el Thomas Caparas,1,0,35,34
1657995823575,MATH 20C,A02,083761,Briones; Jor-el Thomas Caparas,8,0,35,27
1657995823575,MATH 20C,A03,093476,Briones; Jor-el Thomas Caparas,0,1,36,36
1657995823575,MATH 20C,B01,083762,Bach; Quang Tran,1,0,30,29
1657995829601,MATH 20D,A01,083765,Tran; Brian Kha,5,0,30,25
1657995829601,MATH 20D,A02,083766,Tran; Brian Kha,5,0,30,25
1657995829601,MATH 20D,A03,083767,Tran; Brian Kha,6,0,30,24
1657995835624,MATH 20E,A01,083771,Ganguly; Soumya,12,0,32,20
1657995835624,MATH 20E,A02,083772,Ganguly; Soumya,7,0,32,25
1657995835624,MATH 20E,B01,083773,Ciotti; Benjamin,20,0,35,15
1657995835624,MATH 20E,B02,083774,Ciotti; Benjamin,18,0,35,17
1657995841648,MATH 103A,A01,083777,Greenfeld; Be'Eri,6,0,36,30
1657995841648,MATH 103A,A02,083778,Greenfeld; Be'Eri,5,0,36,31
1657995841648,MATH 103A,A03,093561,Greenfeld; Be'Eri,7,0,36,29
1657995841648,MATH 103A,B01,083779,Greenfeld; Be'Eri,8,0,36,28
1657995841648,MATH 103A,B02,083780,Greenfeld; Be'Eri,4,0,36,32
1657995841648,MATH 103A,B03,093562,Greenfeld; Be'Eri,3,0,36,33
1657995847673,MATH 105,A01,085443,Carter; Anne Toulson,15,0,35,20
1657995847673,MATH 105,A02,093477,Carter; Anne Toulson,20,0,35,15
1657995853698,MATH 109,A01,083213,Ganzberger; Geoffrey Michael,3,0,34,31
1657995853698,MATH 109,A02,083214,Ganzberger; Geoffrey Michael,4,0,34,30
1657995853698,MATH 109,A03,093478,Ganzberger; Geoffrey Michael,2,0,34,32
1657995853698,MATH 109,B01,083215,Ganzberger; Geoffrey Michael,3,0,32,29
1657995853698,MATH 109,B02,083216,Ganzberger; Geoffrey Michael,3,0,32,29
1657995853698,MATH 109,B03,093479,Ganzberger; Geoffrey Michael,8,0,32,24
1657995859726,MATH 142A,A01,083219,Chow; Bennett,7,0,32,25
1657995859726,MATH 142A,A02,083220,Chow; Bennett,10,0,32,22
1657995859726,MATH 142A,A03,093480,Chow; Bennett,9,0,32,23
1657995859726,MATH 142A,B03,093481,Chow; Bennett,8,0,32,24
1657995859726,MATH 142A,B04,093558,Chow; Bennett,14,0,32,18
1657995859726,MATH 142A,B05,093559,Chow; Bennett,7,0,32,25
1657995865754,MATH 193A,A01,083224,Rotar; Vladimir,9,0,34,25
1657995865754,MATH 193A,A02,083225,Rotar; Vladimir,11,0,34,23
1657995865754,MATH 193A,A03,083781,Rotar; Vladimir,5,0,34,29
1657995865754,MATH 193A,A04,083782,Rotar; Vladimir,12,0,34,22
1657995865754,MATH 193A,A05,093482,Rotar; Vladimir,11,0,34,23
1657995871776,MATH 197,001,091859,McAuley; Julian John,9999,0,9999,0
1657995871776,MATH 197,002,095566,Kedlaya; Kiran S.,9997,0,9999,2
1657995871776,MATH 197,003,095567,Xiao; Ming,9999,0,9999,0
1657995871776,MATH 197,004,095571,Perols; Johan Lars,9998,0,9999,1
1657995878830,COGS 9,A01,083615,Shannon; Kyle Michael,11,0,75,64
1657995884853,COGS 11,A01,083617,Boyle; Mary E. T.,23,0,48,25
1657995890879,COGS 13,A01,083071,Bastos; Amalia Pinkusfeld,12,0,71,59
1657995896903,COGS 14A,A01,092681,Semenuks; Arturs,5,1,100,95
1657995902933,COGS 14B,A01,083073,Cheng; Tzu-Han,7,0,63,56
1657995908955,COGS 17,A01,092677,Semenuks; Arturs,7,0,81,74
1657995914978,COGS 100,A01,083619,Allen; Michael Gordon,17,0,70,53
1657995921006,COGS 101A,A01,083621,Davis; Joshua Daniel,9,0,68,59
1657995927030,COGS 101B,A01,091572,Allen; Michael Gordon,14,0,65,51
1657995933055,COGS 101C,A01,083625,Delgado; Tania,17,0,35,18
1657995939080,COGS 107A,A01,083627,Boyle; Mary E. T.,14,0,60,46
1657995945102,COGS 118A,A01,083075,Gupta; Anjum,21,0,76,55
1657995951125,CSE 3,A50,083646,Miranda; Gregory Joseph,24,0,50,26
1657995957152,CSE 8A,A50,083650,Miranda; Gregory Joseph,17,1,56,39
1657995963178,CSE 11,A01,083080,Cao; Yingjun,7,15,40,33
1657995969204,CSE 12,A01,083652,Krause-Levy; Sophia Louisa,30,1,120,90
1657995975231,CSE 15L,A01,083654,Morris; Justin Loren,9,0,50,41
1657995975231,CSE 15L,A02,083655,Morris; Justin Loren,11,0,50,39
1657995981254,CSE 20,A01,083657,Tran; Khoa Dang,39,0,80,41
1657995987276,CSE 21,A01,095574,Bach; Quang Tran,23,0,48,25
1657995993299,CSE 30,A01,083084,Eldon; John,8,0,80,72
1657995993299,CSE 30,B01,095061,Bhaskar; Nishant,9,0,50,41
1657995999323,CSE 100,A01,083659,Cao; Yingjun,5,4,70,65
1657996005354,CSE 134B,A01,083661,Powell; Thomas Allan,25,0,100,75
1657996011381,CSE 140,A01,083663,Gungor; Onat,17,0,85,68
1657996017407,CSE 140L,A01,083088,Eldon; John,23,0,100,77
1657996023430,CSE 175,A01,083665,Kumar; Rakesh,3,0,25,22
1657996029456,CSE 190,A00,092507,Dubnov; Shlomo,8,0,20,12
1657996035481,ECE 45,A01,083139,Congero; Spencer William,7,0,75,68
1657996041508,ECE 65,A50,083695,Saad; Andrew S,12,0,30,18
1657996041508,ECE 65,A51,095125,Saad; Andrew S,24,0,26,2
1657996047533,ECE 109,A01,091882,Touri; Behrouz,21,0,70,49
1657996053559,ECE 180,A00,083140,Abi Samra; Nicholas Camill,1,0,30,29
1657996053559,ECE 180,B00,083141,Abi Samra; Nicholas Camill,0,0,30,30
1657996059586,MATH 10A,A01,083735,Patchell; Gregory David,2,0,30,28
1657996059586,MATH 10A,A02,083736,Patchell; Gregory David,20,0,30,10
1657996059586,MATH 10A,A03,083737,Patchell; Gregory David,16,0,30,14
1657996065616,MATH 10B,A01,083207,Lim; Seonhee,9,0,34,25
1657996065616,MATH 10B,A02,083208,Lim; Seonhee,10,0,35,25
1657996065616,MATH 10B,A03,093472,Lim; Seonhee,7,0,34,27
1657996065616,MATH 10B,B01,083739,Sinha; Shubham,14,0,30,16
1657996071640,MATH 18,A01,083743,Cinel; Cameron Alexander,9,0,30,21
1657996071640,MATH 18,A02,083744,Cinel; Cameron Alexander,18,0,30,12
1657996071640,MATH 18,A03,083745,Cinel; Cameron Alexander,10,0,30,20
1657996071640,MATH 18,B01,083748,Rideout; David Porter,5,0,37,32
1657996071640,MATH 18,B02,083749,Rideout; David Porter,5,0,36,31
1657996071640,MATH 18,B03,083750,Rideout; David Porter,3,0,37,34
1657996071640,MATH 18,B04,083751,Rideout; David Porter,7,0,36,29
1657996071640,MATH 18,B05,093473,Rideout; David Porter,7,0,36,29
1657996071640,MATH 18,B06,093474,Rideout; David Porter,6,0,36,30
1657996077662,MATH 20A,A01,083754,Zheng; Zequn,14,0,40,26
1657996083689,MATH 20B,A01,083756,Briones; Jor-el Thomas Caparas,4,0,36,32
1657996083689,MATH 20B,A02,083757,Briones; Jor-el Thomas Caparas,1,0,36,35
1657996083689,MATH 20B,A03,093475,Briones; Jor-el Thomas Caparas,3,0,36,33
1657996089713,MATH 20C,A01,083760,Briones; Jor-el Thomas Caparas,1,0,35,34
1657996089713,MATH 20C,A02,083761,Briones; Jor-el Thomas Caparas,8,0,35,27
1657996089713,MATH 20C,A03,093476,Briones; Jor-el Thomas Caparas,0,1,36,36
1657996089713,MATH 20C,B01,083762,Bach; Quang Tran,1,0,30,29
1657996095741,MATH 20D,A01,083765,Tran; Brian Kha,5,0,30,25
1657996095741,MATH 20D,A02,083766,Tran; Brian Kha,5,0,30,25
1657996095741,MATH 20D,A03,083767,Tran; Brian Kha,6,0,30,24
1657996101764,MATH 20E,A01,083771,Ganguly; Soumya,12,0,32,20
1657996101764,MATH 20E,A02,083772,Ganguly; Soumya,7,0,32,25
1657996101764,MATH 20E,B01,083773,Ciotti; Benjamin,20,0,35,15
1657996101764,MATH 20E,B02,083774,Ciotti; Benjamin,18,0,35,17
1657996107793,MATH 103A,A01,083777,Greenfeld; Be'Eri,6,0,36,30
1657996107793,MATH 103A,A02,083778,Greenfeld; Be'Eri,5,0,36,31
1657996107793,MATH 103A,A03,093561,Greenfeld; Be'Eri,7,0,36,29
1657996107793,MATH 103A,B01,083779,Greenfeld; Be'Eri,8,0,36,28
1657996107793,MATH 103A,B02,083780,Greenfeld; Be'Eri,4,0,36,32
1657996107793,MATH 103A,B03,093562,Greenfeld; Be'Eri,3,0,36,33
1657996113825,MATH 105,A01,085443,Carter; Anne Toulson,15,0,35,20
1657996113825,MATH 105,A02,093477,Carter; Anne Toulson,20,0,35,15
1657996119853,MATH 109,A01,083213,Ganzberger; Geoffrey Michael,3,0,34,31
1657996119853,MATH 109,A02,083214,Ganzberger; Geoffrey Michael,4,0,34,30
1657996119853,MATH 109,A03,093478,Ganzberger; Geoffrey Michael,2,0,34,32
1657996119853,MATH 109,B01,083215,Ganzberger; Geoffrey Michael,3,0,32,29
1657996119853,MATH 109,B02,083216,Ganzberger; Geoffrey Michael,3,0,32,29
1657996119853,MATH 109,B03,093479,Ganzberger; Geoffrey Michael,8,0,32,24
1657996125877,MATH 142A,A01,083219,Chow; Bennett,7,0,32,25
1657996125877,MATH 142A,A02,083220,Chow; Bennett,10,0,32,22
1657996125877,MATH 142A,A03,093480,Chow; Bennett,9,0,32,23
1657996125877,MATH 142A,B03,093481,Chow; Bennett,8,0,32,24
1657996125877,MATH 142A,B04,093558,Chow; Bennett,14,0,32,18
1657996125877,MATH 142A,B05,093559,Chow; Bennett,7,0,32,25
1657996137322,MATH 193A,A01,083224,Rotar; Vladimir,9,0,34,25
1657996137322,MATH 193A,A02,083225,Rotar; Vladimir,11,0,34,23
1657996137322,MATH 193A,A03,083781,Rotar; Vladimir,5,0,34,29
1657996137322,MATH 193A,A04,083782,Rotar; Vladimir,12,0,34,22
1657996137322,MATH 193A,A05,093482,Rotar; Vladimir,11,0,34,23
1657996143349,MATH 197,001,091859,McAuley; Julian John,9999,0,9999,0
1657996143349,MATH 197,002,095566,Kedlaya; Kiran S.,9997,0,9999,2
1657996143349,MATH 197,003,095567,Xiao; Ming,9999,0,9999,0
1657996143349,MATH 197,004,095571,Perols; Johan Lars,9998,0,9999,1
1657996150403,COGS 9,A01,083615,Shannon; Kyle Michael,11,0,75,64
1657996156427,COGS 11,A01,083617,Boyle; Mary E. T.,23,0,48,25
1657996162452,COGS 13,A01,083071,Bastos; Amalia Pinkusfeld,12,0,71,59
1657996168476,COGS 14A,A01,092681,Semenuks; Arturs,5,1,100,95
1657996174499,COGS 14B,A01,083073,Cheng; Tzu-Han,7,0,63,56
1657996180523,COGS 17,A01,092677,Semenuks; Arturs,7,0,81,74
1657996186546,COGS 100,A01,083619,Allen; Michael Gordon,17,0,70,53
1657996192567,COGS 101A,A01,083621,Davis; Joshua Daniel,9,0,68,59
1657996198590,COGS 101B,A01,091572,Allen; Michael Gordon,14,0,65,51
1657996204619,COGS 101C,A01,083625,Delgado; Tania,17,0,35,18
1657996210645,COGS 107A,A01,083627,Boyle; Mary E. T.,14,0,60,46
1657996216668,COGS 118A,A01,083075,Gupta; Anjum,21,0,76,55
1657996222693,CSE 3,A50,083646,Miranda; Gregory Joseph,24,0,50,26
1657996228715,CSE 8A,A50,083650,Miranda; Gregory Joseph,17,1,56,39
1657996234736,CSE 11,A01,083080,Cao; Yingjun,7,15,40,33
1657996240759,CSE 12,A01,083652,Krause-Levy; Sophia Louisa,30,1,120,90
1657996246781,CSE 15L,A01,083654,Morris; Justin Loren,9,0,50,41
1657996246781,CSE 15L,A02,083655,Morris; Justin Loren,11,0,50,39
1657996252810,CSE 20,A01,083657,Tran; Khoa Dang,39,0,80,41
1657996258835,CSE 21,A01,095574,Bach; Quang Tran,23,0,48,25
1657996264930,CSE 30,A01,083084,Eldon; John,8,0,80,72
1657996264930,CSE 30,B01,095061,Bhaskar; Nishant,9,0,50,41
1657996270956,CSE 100,A01,083659,Cao; Yingjun,5,4,70,65
1657996276990,CSE 134B,A01,083661,Powell; Thomas Allan,25,0,100,75
1657996283014,CSE 140,A01,083663,Gungor; Onat,17,0,85,68
1657996289041,CSE 140L,A01,083088,Eldon; John,23,0,100,77
1657996295066,CSE 175,A01,083665,Kumar; Rakesh,3,0,25,22
1657996301089,CSE 190,A00,092507,Dubnov; Shlomo,8,0,20,12
1657996307115,ECE 45,A01,083139,Congero; Spencer William,7,0,75,68
1657996313138,ECE 65,A50,083695,Saad; Andrew S,12,0,30,18
1657996313138,ECE 65,A51,095125,Saad; Andrew S,24,0,26,2
1657996319163,ECE 109,A01,091882,Touri; Behrouz,21,0,70,49
1657996325190,ECE 180,A00,083140,Abi Samra; Nicholas Camill,1,0,30,29
1657996325190,ECE 180,B00,083141,Abi Samra; Nicholas Camill,0,0,30,30
1657996331218,MATH 10A,A01,083735,Patchell; Gregory David,2,0,30,28
1657996331218,MATH 10A,A02,083736,Patchell; Gregory David,20,0,30,10
1657996331218,MATH 10A,A03,083737,Patchell; Gregory David,16,0,30,14
1657996337243,MATH 10B,A01,083207,Lim; Seonhee,9,0,34,25
1657996337243,MATH 10B,A02,083208,Lim; Seonhee,10,0,35,25
1657996337243,MATH 10B,A03,093472,Lim; Seonhee,7,0,34,27
1657996337243,MATH 10B,B01,083739,Sinha; Shubham,14,0,30,16
1657996343276,MATH 18,A01,083743,Cinel; Cameron Alexander,9,0,30,21
1657996343276,MATH 18,A02,083744,Cinel; Cameron Alexander,18,0,30,12
1657996343276,MATH 18,A03,083745,Cinel; Cameron Alexander,10,0,30,20
1657996343276,MATH 18,B01,083748,Rideout; David Porter,5,0,37,32
1657996343276,MATH 18,B02,083749,Rideout; David Porter,5,0,36,31
1657996343276,MATH 18,B03,083750,Rideout; David Porter,3,0,37,34
1657996343276,MATH 18,B04,083751,Rideout; David Porter,7,0,36,29
1657996343276,MATH 18,B05,093473,Rideout; David Porter,7,0,36,29
1657996343276,MATH 18,B06,093474,Rideout; David Porter,6,0,36,30
1657996349300,MATH 20A,A01,083754,Zheng; Zequn,14,0,40,26
1657996355322,MATH 20B,A01,083756,Briones; Jor-el Thomas Caparas,4,0,36,32
1657996355322,MATH 20B,A02,083757,Briones; Jor-el Thomas Caparas,1,0,36,35
1657996355322,MATH 20B,A03,093475,Briones; Jor-el Thomas Caparas,3,0,36,33
1657996361356,MATH 20C,A01,083760,Briones; Jor-el Thomas Caparas,1,0,35,34
1657996361356,MATH 20C,A02,083761,Briones; Jor-el Thomas Caparas,8,0,35,27
1657996361356,MATH 20C,A03,093476,Briones; Jor-el Thomas Caparas,0,1,36,36
1657996361356,MATH 20C,B01,083762,Bach; Quang Tran,1,0,30,29
1657996367388,MATH 20D,A01,083765,Tran; Brian Kha,5,0,30,25
1657996367388,MATH 20D,A02,083766,Tran; Brian Kha,5,0,30,25
1657996367388,MATH 20D,A03,083767,Tran; Brian Kha,6,0,30,24
1657996373416,MATH 20E,A01,083771,Ganguly; Soumya,12,0,32,20
1657996373416,MATH 20E,A02,083772,Ganguly; Soumya,7,0,32,25
1657996373416,MATH 20E,B01,083773,Ciotti; Benjamin,20,0,35,15
1657996373416,MATH 20E,B02,083774,Ciotti; Benjamin,18,0,35,17
1657996379444,MATH 103A,A01,083777,Greenfeld; Be'Eri,6,0,36,30
1657996379444,MATH 103A,A02,083778,Greenfeld; Be'Eri,5,0,36,31
1657996379444,MATH 103A,A03,093561,Greenfeld; Be'Eri,7,0,36,29
1657996379444,MATH 103A,B01,083779,Greenfeld; Be'Eri,8,0,36,28
1657996379444,MATH 103A,B02,083780,Greenfeld; Be'Eri,4,0,36,32
1657996379444,MATH 103A,B03,093562,Greenfeld; Be'Eri,3,0,36,33
1657996385471,MATH 105,A01,085443,Carter; Anne Toulson,15,0,35,20
1657996385471,MATH 105,A02,093477,Carter; Anne Toulson,20,0,35,15
1657996391500,MATH 109,A01,083213,Ganzberger; Geoffrey Michael,3,0,34,31
1657996391500,MATH 109,A02,083214,Ganzberger; Geoffrey Michael,4,0,34,30
1657996391500,MATH 109,A03,093478,Ganzberger; Geoffrey Michael,2,0,34,32
1657996391500,MATH 109,B01,083215,Ganzberger; Geoffrey Michael,3,0,32,29
1657996391500,MATH 109,B02,083216,Ganzberger; Geoffrey Michael,3,0,32,29
1657996391500,MATH 109,B03,093479,Ganzberger; Geoffrey Michael,8,0,32,24
1657996397528,MATH 142A,A01,083219,Chow; Bennett,7,0,32,25
1657996397528,MATH 142A,A02,083220,Chow; Bennett,10,0,32,22
1657996397528,MATH 142A,A03,093480,Chow; Bennett,9,0,32,23
1657996397528,MATH 142A,B03,093481,Chow; Bennett,8,0,32,24
1657996397528,MATH 142A,B04,093558,Chow; Bennett,14,0,32,18
1657996397528,MATH 142A,B05,093559,Chow; Bennett,7,0,32,25
1657996403555,MATH 193A,A01,083224,Rotar; Vladimir,9,0,34,25
1657996403555,MATH 193A,A02,083225,Rotar; Vladimir,11,0,34,23
1657996403555,MATH 193A,A03,083781,Rotar; Vladimir,5,0,34,29
1657996403555,MATH 193A,A04,083782,Rotar; Vladimir,12,0,34,22
1657996403555,MATH 193A,A05,093482,Rotar; Vladimir,11,0,34,23
1657996409579,MATH 197,001,091859,McAuley; Julian John,9999,0,9999,0
1657996409579,MATH 197,002,095566,Kedlaya; Kiran S.,9997,0,9999,2
1657996409579,MATH 197,003,095567,Xiao; Ming,9999,0,9999,0
1657996409579,MATH 197,004,095571,Perols; Johan Lars,9998,0,9999,1
1657996416634,COGS 9,A01,083615,Shannon; Kyle Michael,11,0,75,64
1657996422658,COGS 11,A01,083617,Boyle; Mary E. T.,23,0,48,25
1657996428682,COGS 13,A01,083071,Bastos; Amalia Pinkusfeld,12,0,71,59
1657996434706,COGS 14A,A01,092681,Semenuks; Arturs,5,1,100,95
1657996440728,COGS 14B,A01,083073,Cheng; Tzu-Han,7,0,63,56
1657996446751,COGS 17,A01,092677,Semenuks; Arturs,7,0,81,74
1657996452777,COGS 100,A01,083619,Allen; Michael Gordon,17,0,70,53
1657996458799,COGS 101A,A01,083621,Davis; Joshua Daniel,9,0,68,59
1657996464823,COGS 101B,A01,091572,Allen; Michael Gordon,14,0,65,51
1657996470850,COGS 101C,A01,083625,Delgado; Tania,17,0,35,18
1657996476873,COGS 107A,A01,083627,Boyle; Mary E. T.,14,0,60,46
1657996482896,COGS 118A,A01,083075,Gupta; Anjum,21,0,76,55
1657996488919,CSE 3,A50,083646,Miranda; Gregory Joseph,24,0,50,26
1657996494948,CSE 8A,A50,083650,Miranda; Gregory Joseph,17,1,56,39
1657996500970,CSE 11,A01,083080,Cao; Yingjun,7,15,40,33
1657996506992,CSE 12,A01,083652,Krause-Levy; Sophia Louisa,30,1,120,90
1657996513016,CSE 15L,A01,083654,Morris; Justin Loren,9,0,50,41
1657996513016,CSE 15L,A02,083655,Morris; Justin Loren,11,0,50,39
1657996519043,CSE 20,A01,083657,Tran; Khoa Dang,39,0,80,41
1657996525064,CSE 21,A01,095574,Bach; Quang Tran,23,0,48,25
1657996531093,CSE 30,A01,083084,Eldon; John,8,0,80,72
1657996531093,CSE 30,B01,095061,Bhaskar; Nishant,9,0,50,41
1657996537128,CSE 100,A01,083659,Cao; Yingjun,5,4,70,65
1657996543150,CSE 134B,A01,083661,Powell; Thomas Allan,25,0,100,75
1657996549173,CSE 140,A01,083663,Gungor; Onat,17,0,85,68
1657996555204,CSE 140L,A01,083088,Eldon; John,23,0,100,77
1657996561227,CSE 175,A01,083665,Kumar; Rakesh,3,0,25,22
1657996567257,CSE 190,A00,092507,Dubnov; Shlomo,8,0,20,12
1657996573282,ECE 45,A01,083139,Congero; Spencer William,7,0,75,68
1657996579306,ECE 65,A50,083695,Saad; Andrew S,12,0,30,18
1657996579306,ECE 65,A51,095125,Saad; Andrew S,24,0,26,2
1657996585331,ECE 109,A01,091882,Touri; Behrouz,21,0,70,49
1657996591352,ECE 180,A00,083140,Abi Samra; Nicholas Camill,1,0,30,29
1657996591352,ECE 180,B00,083141,Abi Samra; Nicholas Camill,0,0,30,30
1657996597375,MATH 10A,A01,083735,Patchell; Gregory David,2,0,30,28
1657996597375,MATH 10A,A02,083736,Patchell; Gregory David,20,0,30,10
1657996597375,MATH 10A,A03,083737,Patchell; Gregory David,16,0,30,14
1657996603398,MATH 10B,A01,083207,Lim; Seonhee,9,0,34,25
1657996603398,MATH 10B,A02,083208,Lim; Seonhee,10,0,35,25
1657996603398,MATH 10B,A03,093472,Lim; Seonhee,7,0,34,27
1657996603398,MATH 10B,B01,083739,Sinha; Shubham,14,0,30,16
1657996609421,MATH 18,A01,083743,Cinel; Cameron Alexander,9,0,30,21
1657996609421,MATH 18,A02,083744,Cinel; Cameron Alexander,18,0,30,12
1657996609421,MATH 18,A03,083745,Cinel; Cameron Alexander,10,0,30,20
1657996609421,MATH 18,B01,083748,Rideout; David Porter,5,0,37,32
1657996609421,MATH 18,B02,083749,Rideout; David Porter,5,0,36,31
1657996609421,MATH 18,B03,083750,Rideout; David Porter,3,0,37,34
1657996609421,MATH 18,B04,083751,Rideout; David Porter,7,0,36,29
1657996609421,MATH 18,B05,093473,Rideout; David Porter,7,0,36,29
1657996609421,MATH 18,B06,093474,Rideout; David Porter,6,0,36,30
1657996615455,MATH 20A,A01,083754,Zheng; Zequn,14,0,40,26
1657996621477,MATH 20B,A01,083756,Briones; Jor-el Thomas Caparas,4,0,36,32
1657996621477,MATH 20B,A02,083757,Briones; Jor-el Thomas Caparas,1,0,36,35
1657996621477,MATH 20B,A03,093475,Briones; Jor-el Thomas Caparas,3,0,36,33
1657996627514,MATH 20C,A01,083760,Briones; Jor-el Thomas Caparas,1,0,35,34
1657996627514,MATH 20C,A02,083761,Briones; Jor-el Thomas Caparas,8,0,35,27
1657996627514,MATH 20C,A03,093476,Briones; Jor-el Thomas Caparas,0,1,36,36
1657996627514,MATH 20C,B01,083762,Bach; Quang Tran,1,0,30,29
1657996633547,MATH 20D,A01,083765,Tran; Brian Kha,5,0,30,25
1657996633547,MATH 20D,A02,083766,Tran; Brian Kha,5,0,30,25
1657996633547,MATH 20D,A03,083767,Tran; Brian Kha,6,0,30,24
1657996639571,MATH 20E,A01,083771,Ganguly; Soumya,12,0,32,20
1657996639571,MATH 20E,A02,083772,Ganguly; Soumya,7,0,32,25
1657996639571,MATH 20E,B01,083773,Ciotti; Benjamin,20,0,35,15
1657996639571,MATH 20E,B02,083774,Ciotti; Benjamin,18,0,35,17
1657996645596,MATH 103A,A01,083777,Greenfeld; Be'Eri,6,0,36,30
1657996645596,MATH 103A,A02,083778,Greenfeld; Be'Eri,5,0,36,31
1657996645596,MATH 103A,A03,093561,Greenfeld; Be'Eri,7,0,36,29
1657996645596,MATH 103A,B01,083779,Greenfeld; Be'Eri,8,0,36,28
1657996645596,MATH 103A,B02,083780,Greenfeld; Be'Eri,4,0,36,32
1657996645596,MATH 103A,B03,093562,Greenfeld; Be'Eri,3,0,36,33
1657996651618,MATH 105,A01,085443,Carter; Anne Toulson,15,0,35,20
1657996651618,MATH 105,A02,093477,Carter; Anne Toulson,20,0,35,15
1657996657640,MATH 109,A01,083213,Ganzberger; Geoffrey Michael,3,0,34,31
1657996657640,MATH 109,A02,083214,Ganzberger; Geoffrey Michael,4,0,34,30
1657996657640,MATH 109,A03,093478,Ganzberger; Geoffrey Michael,2,0,34,32
1657996657640,MATH 109,B01,083215,Ganzberger; Geoffrey Michael,3,0,32,29
1657996657640,MATH 109,B02,083216,Ganzberger; Geoffrey Michael,3,0,32,29
1657996657640,MATH 109,B03,093479,Ganzberger; Geoffrey Michael,8,0,32,24
1657996663664,MATH 142A,A01,083219,Chow; Bennett,7,0,32,25
1657996663664,MATH 142A,A02,083220,Chow; Bennett,10,0,32,22
1657996663664,MATH 142A,A03,093480,Chow; Bennett,9,0,32,23
1657996663664,MATH 142A,B03,093481,Chow; Bennett,8,0,32,24
1657996663664,MATH 142A,B04,093558,Chow; Bennett,14,0,32,18
1657996663664,MATH 142A,B05,093559,Chow; Bennett,7,0,32,25
1657996669686,MATH 193A,A01,083224,Rotar; Vladimir,9,0,34,25
1657996669686,MATH 193A,A02,083225,Rotar; Vladimir,11,0,34,23
1657996669686,MATH 193A,A03,083781,Rotar; Vladimir,5,0,34,29
1657996669686,MATH 193A,A04,083782,Rotar; Vladimir,12,0,34,22
1657996669686,MATH 193A,A05,093482,Rotar; Vladimir,11,0,34,23
1657996675709,MATH 197,001,091859,McAuley; Julian John,9999,0,9999,0
1657996675709,MATH 197,002,095566,Kedlaya; Kiran S.,9997,0,9999,2
1657996675709,MATH 197,003,095567,Xiao; Ming,9999,0,9999,0
1657996675709,MATH 197,004,095571,Perols; Johan Lars,9998,0,9999,1
1657996682764,COGS 9,A01,083615,Shannon; Kyle Michael,11,0,75,64
1657996688790,COGS 11,A01,083617,Boyle; Mary E. T.,23,0,48,25
1657996694816,COGS 13,A01,083071,Bastos; Amalia Pinkusfeld,12,0,71,59
1657996700842,COGS 14A,A01,092681,Semenuks; Arturs,5,1,100,95
1657996706866,COGS 14B,A01,083073,Cheng; Tzu-Han,7,0,63,56
1657996712890,COGS 17,A01,092677,Semenuks; Arturs,7,0,81,74
1657996718917,COGS 100,A01,083619,Allen; Michael Gordon,17,0,70,53
1657996724943,COGS 101A,A01,083621,Davis; Joshua Daniel,9,0,68,59
1657996730971,COGS 101B,A01,091572,Allen; Michael Gordon,14,0,65,51
1657996736995,COGS 101C,A01,083625,Delgado; Tania,17,0,35,18
1657996743019,COGS 107A,A01,083627,Boyle; Mary E. T.,14,0,60,46
1657996749048,COGS 118A,A01,083075,Gupta; Anjum,21,0,76,55
1657996755071,CSE 3,A50,083646,Miranda; Gregory Joseph,24,0,50,26
1657996761092,CSE 8A,A50,083650,Miranda; Gregory Joseph,17,1,56,39
1657996767119,CSE 11,A01,083080,Cao; Yingjun,7,15,40,33
1657996773144,CSE 12,A01,083652,Krause-Levy; Sophia Louisa,30,1,120,90
1657996779173,CSE 15L,A01,083654,Morris; Justin Loren,9,0,50,41
1657996779173,CSE 15L,A02,083655,Morris; Justin Loren,11,0,50,39
1657996785199,CSE 20,A01,083657,Tran; Khoa Dang,39,0,80,41
1657996791222,CSE 21,A01,095574,Bach; Quang Tran,23,0,48,25
1657996797251,CSE 30,A01,083084,Eldon; John,8,0,80,72
1657996797251,CSE 30,B01,095061,Bhaskar; Nishant,9,0,50,41
1657996803285,CSE 100,A01,083659,Cao; Yingjun,5,4,70,65
1657996809312,CSE 134B,A01,083661,Powell; Thomas Allan,25,0,100,75
1657996815334,CSE 140,A01,083663,Gungor; Onat,17,0,85,68
1657996821357,CSE 140L,A01,083088,Eldon; John,23,0,100,77
1657996827380,CSE 175,A01,083665,Kumar; Rakesh,3,0,25,22
1657996833405,CSE 190,A00,092507,Dubnov; Shlomo,8,0,20,12
1657996839427,ECE 45,A01,083139,Congero; Spencer William,7,0,75,68
1657996845450,ECE 65,A50,083695,Saad; Andrew S,12,0,30,18
1657996845450,ECE 65,A51,095125,Saad; Andrew S,24,0,26,2
1657996851477,ECE 109,A01,091882,Touri; Behrouz,21,0,70,49
1657996857502,ECE 180,A00,083140,Abi Samra; Nicholas Camill,1,0,30,29
1657996857502,ECE 180,B00,083141,Abi Samra; Nicholas Camill,0,0,30,30
1657996863603,MATH 10A,A01,083735,Patchell; Gregory David,2,0,30,28
1657996863603,MATH 10A,A02,083736,Patchell; Gregory David,20,0,30,10
1657996863603,MATH 10A,A03,083737,Patchell; Gregory David,16,0,30,14
1657996869626,MATH 10B,A01,083207,Lim; Seonhee,9,0,34,25
1657996869626,MATH 10B,A02,083208,Lim; Seonhee,10,0,35,25
1657996869626,MATH 10B,A03,093472,Lim; Seonhee,7,0,34,27
1657996869626,MATH 10B,B01,083739,Sinha; Shubham,14,0,30,16
1657996875650,MATH 18,A01,083743,Cinel; Cameron Alexander,9,0,30,21
1657996875650,MATH 18,A02,083744,Cinel; Cameron Alexander,18,0,30,12
1657996875650,MATH 18,A03,083745,Cinel; Cameron Alexander,10,0,30,20
1657996875650,MATH 18,B01,083748,Rideout; David Porter,5,0,37,32
1657996875650,MATH 18,B02,083749,Rideout; David Porter,5,0,36,31
1657996875650,MATH 18,B03,083750,Rideout; David Porter,3,0,37,34
1657996875650,MATH 18,B04,083751,Rideout; David Porter,7,0,36,29
1657996875650,MATH 18,B05,093473,Rideout; David Porter,7,0,36,29
1657996875650,MATH 18,B06,093474,Rideout; David Porter,6,0,36,30
1657996881684,MATH 20A,A01,083754,Zheng; Zequn,14,0,40,26
1657996887711,MATH 20B,A01,083756,Briones; Jor-el Thomas Caparas,4,0,36,32
1657996887711,MATH 20B,A02,083757,Briones; Jor-el Thomas Caparas,1,0,36,35
1657996887711,MATH 20B,A03,093475,Briones; Jor-el Thomas Caparas,3,0,36,33
1657996893738,MATH 20C,A01,083760,Briones; Jor-el Thomas Caparas,1,0,35,34
1657996893738,MATH 20C,A02,083761,Briones; Jor-el Thomas Caparas,8,0,35,27
1657996893738,MATH 20C,A03,093476,Briones; Jor-el Thomas Caparas,0,1,36,36
1657996893738,MATH 20C,B01,083762,Bach; Quang Tran,1,0,30,29
1657996899766,MATH 20D,A01,083765,Tran; Brian Kha,5,0,30,25
1657996899766,MATH 20D,A02,083766,Tran; Brian Kha,5,0,30,25
1657996899766,MATH 20D,A03,083767,Tran; Brian Kha,6,0,30,24
1657996905790,MATH 20E,A01,083771,Ganguly; Soumya,12,0,32,20
1657996905790,MATH 20E,A02,083772,Ganguly; Soumya,7,0,32,25
1657996905790,MATH 20E,B01,083773,Ciotti; Benjamin,20,0,35,15
1657996905790,MATH 20E,B02,083774,Ciotti; Benjamin,18,0,35,17
1657996911813,MATH 103A,A01,083777,Greenfeld; Be'Eri,6,0,36,30
1657996911813,MATH 103A,A02,083778,Greenfeld; Be'Eri,5,0,36,31
1657996911813,MATH 103A,A03,093561,Greenfeld; Be'Eri,7,0,36,29
1657996911813,MATH 103A,B01,083779,Greenfeld; Be'Eri,8,0,36,28
1657996911813,MATH 103A,B02,083780,Greenfeld; Be'Eri,4,0,36,32
1657996911813,MATH 103A,B03,093562,Greenfeld; Be'Eri,3,0,36,33
1657996917842,MATH 105,A01,085443,Carter; Anne Toulson,15,0,35,20
1657996917842,MATH 105,A02,093477,Carter; Anne Toulson,20,0,35,15
1657996923870,MATH 109,A01,083213,Ganzberger; Geoffrey Michael,3,0,34,31
1657996923870,MATH 109,A02,083214,Ganzberger; Geoffrey Michael,4,0,34,30
1657996923870,MATH 109,A03,093478,Ganzberger; Geoffrey Michael,2,0,34,32
1657996923870,MATH 109,B01,083215,Ganzberger; Geoffrey Michael,3,0,32,29
1657996923870,MATH 109,B02,083216,Ganzberger; Geoffrey Michael,3,0,32,29
1657996923870,MATH 109,B03,093479,Ganzberger; Geoffrey Michael,8,0,32,24
1657996929894,MATH 142A,A01,083219,Chow; Bennett,7,0,32,25
1657996929894,MATH 142A,A02,083220,Chow; Bennett,10,0,32,22
1657996929894,MATH 142A,A03,093480,Chow; Bennett,9,0,32,23
1657996929894,MATH 142A,B03,093481,Chow; Bennett,8,0,32,24
1657996929894,MATH 142A,B04,093558,Chow; Bennett,14,0,32,18
1657996929894,MATH 142A,B05,093559,Chow; Bennett,7,0,32,25
1657996935928,MATH 193A,A01,083224,Rotar; Vladimir,9,0,34,25
1657996935928,MATH 193A,A02,083225,Rotar; Vladimir,11,0,34,23
1657996935928,MATH 193A,A03,083781,Rotar; Vladimir,5,0,34,29
1657996935928,MATH 193A,A04,083782,Rotar; Vladimir,12,0,34,22
1657996935928,MATH 193A,A05,093482,Rotar; Vladimir,11,0,34,23
1657996941954,MATH 197,001,091859,McAuley; Julian John,9999,0,9999,0
1657996941954,MATH 197,002,095566,Kedlaya; Kiran S.,9997,0,9999,2
1657996941954,MATH 197,003,095567,Xiao; Ming,9999,0,9999,0
1657996941954,MATH 197,004,095571,Perols; Johan Lars,9998,0,9999,1
1657996949023,COGS 9,A01,083615,Shannon; Kyle Michael,11,0,75,64
1657996955045,COGS 11,A01,083617,Boyle; Mary E. T.,23,0,48,25
1657996961075,COGS 13,A01,083071,Bastos; Amalia Pinkusfeld,12,0,71,59
1657996967100,COGS 14A,A01,092681,Semenuks; Arturs,5,1,100,95
1657996973127,COGS 14B,A01,083073,Cheng; Tzu-Han,7,0,63,56
1657996979150,COGS 17,A01,092677,Semenuks; Arturs,7,0,81,74
1657996985174,COGS 100,A01,083619,Allen; Michael Gordon,17,0,70,53
1657996991200,COGS 101A,A01,083621,Davis; Joshua Daniel,9,0,68,59
1657996997227,COGS 101B,A01,091572,Allen; Michael Gordon,14,0,65,51
1657997003250,COGS 101C,A01,083625,Delgado; Tania,17,0,35,18
1657997009278,COGS 107A,A01,083627,Boyle; Mary E. T.,14,0,60,46
1657997015303,COGS 118A,A01,083075,Gupta; Anjum,21,0,76,55
1657997021335,CSE 3,A50,083646,Miranda; Gregory Joseph,24,0,50,26
1657997027360,CSE 8A,A50,083650,Miranda; Gregory Joseph,17,1,56,39
1657997033383,CSE 11,A01,083080,Cao; Yingjun,7,15,40,33
1657997039412,CSE 12,A01,083652,Krause-Levy; Sophia Louisa,30,1,120,90
1657997045439,CSE 15L,A01,083654,Morris; Justin Loren,9,0,50,41
1657997045439,CSE 15L,A02,083655,Morris; Justin Loren,11,0,50,39
1657997051461,CSE 20,A01,083657,Tran; Khoa Dang,39,0,80,41
1657997057486,CSE 21,A01,095574,Bach; Quang Tran,23,0,48,25
1657997063515,CSE 30,A01,083084,Eldon; John,8,0,80,72
1657997063515,CSE 30,B01,095061,Bhaskar; Nishant,9,0,50,41
1657997069541,CSE 100,A01,083659,Cao; Yingjun,5,4,70,65
1657997075563,CSE 134B,A01,083661,Powell; Thomas Allan,25,0,100,75
1657997081588,CSE 140,A01,083663,Gungor; Onat,17,0,85,68
1657997087613,CSE 140L,A01,083088,Eldon; John,23,0,100,77
1657997093638,CSE 175,A01,083665,Kumar; Rakesh,3,0,25,22
1657997099661,CSE 190,A00,092507,Dubnov; Shlomo,8,0,20,12
1657997105683,ECE 45,A01,083139,Congero; Spencer William,7,0,75,68
1657997111709,ECE 65,A50,083695,Saad; Andrew S,12,0,30,18
1657997111709,ECE 65,A51,095125,Saad; Andrew S,24,0,26,2
1657997117735,ECE 109,A01,091882,Touri; Behrouz,21,0,70,49
1657997123758,ECE 180,A00,083140,Abi Samra; Nicholas Camill,1,0,30,29
1657997123758,ECE 180,B00,083141,Abi Samra; Nicholas Camill,0,0,30,30
1657997129794,MATH 10A,A01,083735,Patchell; Gregory David,2,0,30,28
1657997129794,MATH 10A,A02,083736,Patchell; Gregory David,20,0,30,10
1657997129794,MATH 10A,A03,083737,Patchell; Gregory David,16,0,30,14
1657997135827,MATH 10B,A01,083207,Lim; Seonhee,9,0,34,25
1657997135827,MATH 10B,A02,083208,Lim; Seonhee,10,0,35,25
1657997135827,MATH 10B,A03,093472,Lim; Seonhee,7,0,34,27
1657997135827,MATH 10B,B01,083739,Sinha; Shubham,14,0,30,16
1657997141864,MATH 18,A01,083743,Cinel; Cameron Alexander,9,0,30,21
1657997141864,MATH 18,A02,083744,Cinel; Cameron Alexander,18,0,30,12
1657997141864,MATH 18,A03,083745,Cinel; Cameron Alexander,10,0,30,20
1657997141864,MATH 18,B01,083748,Rideout; David Porter,5,0,37,32
1657997141864,MATH 18,B02,083749,Rideout; David Porter,5,0,36,31
1657997141864,MATH 18,B03,083750,Rideout; David Porter,3,0,37,34
1657997141864,MATH 18,B04,083751,Rideout; David Porter,7,0,36,29
1657997141864,MATH 18,B05,093473,Rideout; David Porter,7,0,36,29
1657997141864,MATH 18,B06,093474,Rideout; David Porter,6,0,36,30
1657997147889,MATH 20A,A01,083754,Zheng; Zequn,14,0,40,26
1657997153927,MATH 20B,A01,083756,Briones; Jor-el Thomas Caparas,4,0,36,32
1657997153927,MATH 20B,A02,083757,Briones; Jor-el Thomas Caparas,1,0,36,35
1657997153927,MATH 20B,A03,093475,Briones; Jor-el Thomas Caparas,3,0,36,33
1657997159952,MATH 20C,A01,083760,Briones; Jor-el Thomas Caparas,1,0,35,34
1657997159952,MATH 20C,A02,083761,Briones; Jor-el Thomas Caparas,8,0,35,27
1657997159952,MATH 20C,A03,093476,Briones; Jor-el Thomas Caparas,0,1,36,36
1657997159952,MATH 20C,B01,083762,Bach; Quang Tran,1,0,30,29
1657997165987,MATH 20D,A01,083765,Tran; Brian Kha,5,0,30,25
1657997165987,MATH 20D,A02,083766,Tran; Brian Kha,5,0,30,25
1657997165987,MATH 20D,A03,083767,Tran; Brian Kha,6,0,30,24
1657997172011,MATH 20E,A01,083771,Ganguly; Soumya,12,0,32,20
1657997172011,MATH 20E,A02,083772,Ganguly; Soumya,7,0,32,25
1657997172011,MATH 20E,B01,083773,Ciotti; Benjamin,20,0,35,15
1657997172011,MATH 20E,B02,083774,Ciotti; Benjamin,18,0,35,17
1657997178040,MATH 103A,A01,083777,Greenfeld; Be'Eri,6,0,36,30
1657997178040,MATH 103A,A02,083778,Greenfeld; Be'Eri,5,0,36,31
1657997178040,MATH 103A,A03,093561,Greenfeld; Be'Eri,7,0,36,29
1657997178040,MATH 103A,B01,083779,Greenfeld; Be'Eri,8,0,36,28
1657997178040,MATH 103A,B02,083780,Greenfeld; Be'Eri,4,0,36,32
1657997178040,MATH 103A,B03,093562,Greenfeld; Be'Eri,3,0,36,33
1657997184068,MATH 105,A01,085443,Carter; Anne Toulson,15,0,35,20
1657997184068,MATH 105,A02,093477,Carter; Anne Toulson,20,0,35,15
1657997190094,MATH 109,A01,083213,Ganzberger; Geoffrey Michael,3,0,34,31
1657997190094,MATH 109,A02,083214,Ganzberger; Geoffrey Michael,4,0,34,30
1657997190094,MATH 109,A03,093478,Ganzberger; Geoffrey Michael,2,0,34,32
1657997190094,MATH 109,B01,083215,Ganzberger; Geoffrey Michael,3,0,32,29
1657997190094,MATH 109,B02,083216,Ganzberger; Geoffrey Michael,3,0,32,29
1657997190094,MATH 109,B03,093479,Ganzberger; Geoffrey Michael,8,0,32,24
1657997196118,MATH 142A,A01,083219,Chow; Bennett,7,0,32,25
1657997196118,MATH 142A,A02,083220,Chow; Bennett,10,0,32,22
1657997196118,MATH 142A,A03,093480,Chow; Bennett,9,0,32,23
1657997196118,MATH 142A,B03,093481,Chow; Bennett,8,0,32,24
1657997196118,MATH 142A,B04,093558,Chow; Bennett,14,0,32,18
1657997196118,MATH 142A,B05,093559,Chow; Bennett,7,0,32,25
1657997202141,MATH 193A,A01,083224,Rotar; Vladimir,9,0,34,25
1657997202141,MATH 193A,A02,083225,Rotar; Vladimir,11,0,34,23
1657997202141,MATH 193A,A03,083781,Rotar; Vladimir,5,0,34,29
1657997202141,MATH 193A,A04,083782,Rotar; Vladimir,12,0,34,22
1657997202141,MATH 193A,A05,093482,Rotar; Vladimir,11,0,34,23
1657997208169,MATH 197,001,091859,McAuley; Julian John,9999,0,9999,0
1657997208169,MATH 197,002,095566,Kedlaya; Kiran S.,9997,0,9999,2
1657997208169,MATH 197,003,095567,Xiao; Ming,9999,0,9999,0
1657997208169,MATH 197,004,095571,Perols; Johan Lars,9998,0,9999,1
1657997215233,COGS 9,A01,083615,Shannon; Kyle Michael,11,0,75,64
1657997221256,COGS 11,A01,083617,Boyle; Mary E. T.,23,0,48,25
1657997227280,COGS 13,A01,083071,Bastos; Amalia Pinkusfeld,12,0,71,59
1657997233315,COGS 14A,A01,092681,Semenuks; Arturs,5,1,100,95
1657997239343,COGS 14B,A01,083073,Cheng; Tzu-Han,7,0,63,56
1657997245372,COGS 17,A01,092677,Semenuks; Arturs,7,0,81,74
1657997251393,COGS 100,A01,083619,Allen; Michael Gordon,17,0,70,53
1657997257416,COGS 101A,A01,083621,Davis; Joshua Daniel,9,0,68,59
1657997263444,COGS 101B,A01,091572,Allen; Michael Gordon,14,0,65,51
1657997269467,COGS 101C,A01,083625,Delgado; Tania,17,0,35,18
1657997275494,COGS 107A,A01,083627,Boyle; Mary E. T.,14,0,60,46
1657997281516,COGS 118A,A01,083075,Gupta; Anjum,21,0,76,55
1657997287542,CSE 3,A50,083646,Miranda; Gregory Joseph,24,0,50,26
1657997293568,CSE 8A,A50,083650,Miranda; Gregory Joseph,17,1,56,39
1657997299592,CSE 11,A01,083080,Cao; Yingjun,7,15,40,33
1657997305618,CSE 12,A01,083652,Krause-Levy; Sophia Louisa,30,1,120,90
1657997311649,CSE 15L,A01,083654,Morris; Justin Loren,9,0,50,41
1657997311649,CSE 15L,A02,083655,Morris; Justin Loren,11,0,50,39
1657997317674,CSE 20,A01,083657,Tran; Khoa Dang,39,0,80,41
1657997323697,CSE 21,A01,095574,Bach; Quang Tran,23,0,48,25
1657997329721,CSE 30,A01,083084,Eldon; John,8,0,80,72
1657997329721,CSE 30,B01,095061,Bhaskar; Nishant,9,0,50,41
1657997335748,CSE 100,A01,083659,Cao; Yingjun,5,4,70,65
1657997341771,CSE 134B,A01,083661,Powell; Thomas Allan,25,0,100,75
1657997347796,CSE 140,A01,083663,Gungor; Onat,17,0,85,68
1657997353831,CSE 140L,A01,083088,Eldon; John,23,0,100,77
1657997359855,CSE 175,A01,083665,Kumar; Rakesh,3,0,25,22
1657997365880,CSE 190,A00,092507,Dubnov; Shlomo,8,0,20,12
1657997371903,ECE 45,A01,083139,Congero; Spencer William,7,0,75,68
1657997377933,ECE 65,A50,083695,Saad; Andrew S,12,0,30,18
1657997377933,ECE 65,A51,095125,Saad; Andrew S,24,0,26,2
1657997383959,ECE 109,A01,091882,Touri; Behrouz,21,0,70,49
1657997389982,ECE 180,A00,083140,Abi Samra; Nicholas Camill,1,0,30,29
1657997389982,ECE 180,B00,083141,Abi Samra; Nicholas Camill,0,0,30,30
1657997396009,MATH 10A,A01,083735,Patchell; Gregory David,2,0,30,28
1657997396009,MATH 10A,A02,083736,Patchell; Gregory David,20,0,30,10
1657997396009,MATH 10A,A03,083737,Patchell; Gregory David,16,0,30,14
1657997402033,MATH 10B,A01,083207,Lim; Seonhee,9,0,34,25
1657997402033,MATH 10B,A02,083208,Lim; Seonhee,10,0,35,25
1657997402033,MATH 10B,A03,093472,Lim; Seonhee,7,0,34,27
1657997402033,MATH 10B,B01,083739,Sinha; Shubham,14,0,30,16
1657997408063,MATH 18,A01,083743,Cinel; Cameron Alexander,9,0,30,21
1657997408063,MATH 18,A02,083744,Cinel; Cameron Alexander,18,0,30,12
1657997408063,MATH 18,A03,083745,Cinel; Cameron Alexander,10,0,30,20
1657997408063,MATH 18,B01,083748,Rideout; David Porter,5,0,37,32
1657997408063,MATH 18,B02,083749,Rideout; David Porter,5,0,36,31
1657997408063,MATH 18,B03,083750,Rideout; David Porter,3,0,37,34
1657997408063,MATH 18,B04,083751,Rideout; David Porter,7,0,36,29
1657997408063,MATH 18,B05,093473,Rideout; David Porter,7,0,36,29
1657997408063,MATH 18,B06,093474,Rideout; David Porter,6,0,36,30
1657997414094,MATH 20A,A01,083754,Zheng; Zequn,14,0,40,26
1657997420122,MATH 20B,A01,083756,Briones; Jor-el Thomas Caparas,4,0,36,32
1657997420122,MATH 20B,A02,083757,Briones; Jor-el Thomas Caparas,1,0,36,35
1657997420122,MATH 20B,A03,093475,Briones; Jor-el Thomas Caparas,3,0,36,33
1657997426145,MATH 20C,A01,083760,Briones; Jor-el Thomas Caparas,1,0,35,34
1657997426145,MATH 20C,A02,083761,Briones; Jor-el Thomas Caparas,8,0,35,27
1657997426145,MATH 20C,A03,093476,Briones; Jor-el Thomas Caparas,0,1,36,36
1657997426145,MATH 20C,B01,083762,Bach; Quang Tran,1,0,30,29
1657997432172,MATH 20D,A01,083765,Tran; Brian Kha,5,0,30,25
1657997432172,MATH 20D,A02,083766,Tran; Brian Kha,5,0,30,25
1657997432172,MATH 20D,A03,083767,Tran; Brian Kha,6,0,30,24
1657997438196,MATH 20E,A01,083771,Ganguly; Soumya,12,0,32,20
1657997438196,MATH 20E,A02,083772,Ganguly; Soumya,7,0,32,25
1657997438196,MATH 20E,B01,083773,Ciotti; Benjamin,20,0,35,15
1657997438196,MATH 20E,B02,083774,Ciotti; Benjamin,18,0,35,17
1657997444220,MATH 103A,A01,083777,Greenfeld; Be'Eri,6,0,36,30
1657997444220,MATH 103A,A02,083778,Greenfeld; Be'Eri,5,0,36,31
1657997444220,MATH 103A,A03,093561,Greenfeld; Be'Eri,7,0,36,29
1657997444220,MATH 103A,B01,083779,Greenfeld; Be'Eri,8,0,36,28
1657997444220,MATH 103A,B02,083780,Greenfeld; Be'Eri,4,0,36,32
1657997444220,MATH 103A,B03,093562,Greenfeld; Be'Eri,3,0,36,33
1657997450254,MATH 105,A01,085443,Carter; Anne Toulson,15,0,35,20
1657997450254,MATH 105,A02,093477,Carter; Anne Toulson,20,0,35,15
1657997456277,MATH 109,A01,083213,Ganzberger; Geoffrey Michael,3,0,34,31
1657997456277,MATH 109,A02,083214,Ganzberger; Geoffrey Michael,4,0,34,30
1657997456277,MATH 109,A03,093478,Ganzberger; Geoffrey Michael,2,0,34,32
1657997456277,MATH 109,B01,083215,Ganzberger; Geoffrey Michael,3,0,32,29
1657997456277,MATH 109,B02,083216,Ganzberger; Geoffrey Michael,3,0,32,29
1657997456277,MATH 109,B03,093479,Ganzberger; Geoffrey Michael,8,0,32,24
1657997462388,MATH 142A,A01,083219,Chow; Bennett,7,0,32,25
1657997462388,MATH 142A,A02,083220,Chow; Bennett,10,0,32,22
1657997462388,MATH 142A,A03,093480,Chow; Bennett,9,0,32,23
1657997462388,MATH 142A,B03,093481,Chow; Bennett,8,0,32,24
1657997462388,MATH 142A,B04,093558,Chow; Bennett,14,0,32,18
1657997462388,MATH 142A,B05,093559,Chow; Bennett,7,0,32,25
1657997468410,MATH 193A,A01,083224,Rotar; Vladimir,9,0,34,25
1657997468410,MATH 193A,A02,083225,Rotar; Vladimir,11,0,34,23
1657997468410,MATH 193A,A03,083781,Rotar; Vladimir,5,0,34,29
1657997468410,MATH 193A,A04,083782,Rotar; Vladimir,12,0,34,22
1657997468410,MATH 193A,A05,093482,Rotar; Vladimir,11,0,34,23
1657997474436,MATH 197,001,091859,McAuley; Julian John,9999,0,9999,0
1657997474436,MATH 197,002,095566,Kedlaya; Kiran S.,9997,0,9999,2
1657997474436,MATH 197,003,095567,Xiao; Ming,9999,0,9999,0
1657997474436,MATH 197,004,095571,Perols; Johan Lars,9998,0,9999,1
1657997481485,COGS 9,A01,083615,Shannon; Kyle Michael,11,0,75,64
1657997487508,COGS 11,A01,083617,Boyle; Mary E. T.,23,0,48,25
1657997493537,COGS 13,A01,083071,Bastos; Amalia Pinkusfeld,12,0,71,59
1657997499562,COGS 14A,A01,092681,Semenuks; Arturs,5,1,100,95
1657997505584,COGS 14B,A01,083073,Cheng; Tzu-Han,7,0,63,56
1657997511608,COGS 17,A01,092677,Semenuks; Arturs,7,0,81,74
1657997517635,COGS 100,A01,083619,Allen; Michael Gordon,17,0,70,53
1657997523658,COGS 101A,A01,083621,Davis; Joshua Daniel,9,0,68,59
1657997529679,COGS 101B,A01,091572,Allen; Michael Gordon,14,0,65,51
1657997535705,COGS 101C,A01,083625,Delgado; Tania,17,0,35,18
1657997541733,COGS 107A,A01,083627,Boyle; Mary E. T.,14,0,60,46
1657997547756,COGS 118A,A01,083075,Gupta; Anjum,21,0,76,55
1657997553778,CSE 3,A50,083646,Miranda; Gregory Joseph,24,0,50,26
1657997559801,CSE 8A,A50,083650,Miranda; Gregory Joseph,17,1,56,39
1657997565824,CSE 11,A01,083080,Cao; Yingjun,7,15,40,33
1657997571851,CSE 12,A01,083652,Krause-Levy; Sophia Louisa,30,1,120,90
1657997577874,CSE 15L,A01,083654,Morris; Justin Loren,9,0,50,41
1657997577874,CSE 15L,A02,083655,Morris; Justin Loren,11,0,50,39
1657997583896,CSE 20,A01,083657,Tran; Khoa Dang,39,0,80,41
1657997589922,CSE 21,A01,095574,Bach; Quang Tran,23,0,48,25
1657997595948,CSE 30,A01,083084,Eldon; John,8,0,80,72
1657997595948,CSE 30,B01,095061,Bhaskar; Nishant,9,0,50,41
1657997601971,CSE 100,A01,083659,Cao; Yingjun,5,4,70,65
1657997607994,CSE 134B,A01,083661,Powell; Thomas Allan,25,0,100,75
1657997614019,CSE 140,A01,083663,Gungor; Onat,17,0,85,68
1657997620041,CSE 140L,A01,083088,Eldon; John,23,0,100,77
1657997626067,CSE 175,A01,083665,Kumar; Rakesh,3,0,25,22
1657997632091,CSE 190,A00,092507,Dubnov; Shlomo,8,0,20,12
1657997638130,ECE 45,A01,083139,Congero; Spencer William,7,0,75,68
1657997644154,ECE 65,A50,083695,Saad; Andrew S,12,0,30,18
1657997644154,ECE 65,A51,095125,Saad; Andrew S,24,0,26,2
1657997650177,ECE 109,A01,091882,Touri; Behrouz,21,0,70,49
1657997656204,ECE 180,A00,083140,Abi Samra; Nicholas Camill,1,0,30,29
1657997656204,ECE 180,B00,083141,Abi Samra; Nicholas Camill,0,0,30,30
1657997662226,MATH 10A,A01,083735,Patchell; Gregory David,2,0,30,28
1657997662226,MATH 10A,A02,083736,Patchell; Gregory David,20,0,30,10
1657997662226,MATH 10A,A03,083737,Patchell; Gregory David,16,0,30,14
1657997668254,MATH 10B,A01,083207,Lim; Seonhee,9,0,34,25
1657997668254,MATH 10B,A02,083208,Lim; Seonhee,10,0,35,25
1657997668254,MATH 10B,A03,093472,Lim; Seonhee,7,0,34,27
1657997668254,MATH 10B,B01,083739,Sinha; Shubham,14,0,30,16
1657997674285,MATH 18,A01,083743,Cinel; Cameron Alexander,9,0,30,21
1657997674285,MATH 18,A02,083744,Cinel; Cameron Alexander,18,0,30,12
1657997674285,MATH 18,A03,083745,Cinel; Cameron Alexander,10,0,30,20
1657997674285,MATH 18,B01,083748,Rideout; David Porter,5,0,37,32
1657997674285,MATH 18,B02,083749,Rideout; David Porter,5,0,36,31
1657997674285,MATH 18,B03,083750,Rideout; David Porter,3,0,37,34
1657997674285,MATH 18,B04,083751,Rideout; David Porter,7,0,36,29
1657997674285,MATH 18,B05,093473,Rideout; David Porter,7,0,36,29
1657997674285,MATH 18,B06,093474,Rideout; David Porter,6,0,36,30
1657997680309,MATH 20A,A01,083754,Zheng; Zequn,14,0,40,26
1657997686334,MATH 20B,A01,083756,Briones; Jor-el Thomas Caparas,4,0,36,32
1657997686334,MATH 20B,A02,083757,Briones; Jor-el Thomas Caparas,1,0,36,35
1657997686334,MATH 20B,A03,093475,Briones; Jor-el Thomas Caparas,3,0,36,33
1657997692359,MATH 20C,A01,083760,Briones; Jor-el Thomas Caparas,1,0,35,34
1657997692359,MATH 20C,A02,083761,Briones; Jor-el Thomas Caparas,8,0,35,27
1657997692359,MATH 20C,A03,093476,Briones; Jor-el Thomas Caparas,0,1,36,36
1657997692359,MATH 20C,B01,083762,Bach; Quang Tran,1,0,30,29
1657997698382,MATH 20D,A01,083765,Tran; Brian Kha,5,0,30,25
1657997698382,MATH 20D,A02,083766,Tran; Brian Kha,5,0,30,25
1657997698382,MATH 20D,A03,083767,Tran; Brian Kha,6,0,30,24
1657997704405,MATH 20E,A01,083771,Ganguly; Soumya,12,0,32,20
1657997704405,MATH 20E,A02,083772,Ganguly; Soumya,7,0,32,25
1657997704405,MATH 20E,B01,083773,Ciotti; Benjamin,20,0,35,15
1657997704405,MATH 20E,B02,083774,Ciotti; Benjamin,18,0,35,17
1657997710435,MATH 103A,A01,083777,Greenfeld; Be'Eri,6,0,36,30
1657997710435,MATH 103A,A02,083778,Greenfeld; Be'Eri,5,0,36,31
1657997710435,MATH 103A,A03,093561,Greenfeld; Be'Eri,7,0,36,29
1657997710435,MATH 103A,B01,083779,Greenfeld; Be'Eri,8,0,36,28
1657997710435,MATH 103A,B02,083780,Greenfeld; Be'Eri,4,0,36,32
1657997710435,MATH 103A,B03,093562,Greenfeld; Be'Eri,3,0,36,33
1657997716456,MATH 105,A01,085443,Carter; Anne Toulson,15,0,35,20
1657997716456,MATH 105,A02,093477,Carter; Anne Toulson,20,0,35,15
1657997722483,MATH 109,A01,083213,Ganzberger; Geoffrey Michael,3,0,34,31
1657997722483,MATH 109,A02,083214,Ganzberger; Geoffrey Michael,4,0,34,30
1657997722483,MATH 109,A03,093478,Ganzberger; Geoffrey Michael,2,0,34,32
1657997722483,MATH 109,B01,083215,Ganzberger; Geoffrey Michael,3,0,32,29
1657997722483,MATH 109,B02,083216,Ganzberger; Geoffrey Michael,3,0,32,29
1657997722483,MATH 109,B03,093479,Ganzberger; Geoffrey Michael,8,0,32,24
1657997728512,MATH 142A,A01,083219,Chow; Bennett,7,0,32,25
1657997728512,MATH 142A,A02,083220,Chow; Bennett,10,0,32,22
1657997728512,MATH 142A,A03,093480,Chow; Bennett,9,0,32,23
1657997728512,MATH 142A,B03,093481,Chow; Bennett,8,0,32,24
1657997728512,MATH 142A,B04,093558,Chow; Bennett,14,0,32,18
1657997728512,MATH 142A,B05,093559,Chow; Bennett,7,0,32,25
1657997734536,MATH 193A,A01,083224,Rotar; Vladimir,9,0,34,25
1657997734536,MATH 193A,A02,083225,Rotar; Vladimir,11,0,34,23
1657997734536,MATH 193A,A03,083781,Rotar; Vladimir,5,0,34,29
1657997734536,MATH 193A,A04,083782,Rotar; Vladimir,12,0,34,22
1657997734536,MATH 193A,A05,093482,Rotar; Vladimir,11,0,34,23
1657997740560,MATH 197,001,091859,McAuley; Julian John,9999,0,9999,0
1657997740560,MATH 197,002,095566,Kedlaya; Kiran S.,9997,0,9999,2
1657997740560,MATH 197,003,095567,Xiao; Ming,9999,0,9999,0
1657997740560,MATH 197,004,095571,Perols; Johan Lars,9998,0,9999,1
1657997747617,COGS 9,A01,083615,Shannon; Kyle Michael,11,0,75,64
1657997753644,COGS 11,A01,083617,Boyle; Mary E. T.,23,0,48,25
1657997759667,COGS 13,A01,083071,Bastos; Amalia Pinkusfeld,12,0,71,59
1657997765700,COGS 14A,A01,092681,Semenuks; Arturs,5,1,100,95
1657997771727,COGS 14B,A01,083073,Cheng; Tzu-Han,7,0,63,56
1657997777750,COGS 17,A01,092677,Semenuks; Arturs,7,0,81,74
1657997783776,COGS 100,A01,083619,Allen; Michael Gordon,17,0,70,53
1657997789799,COGS 101A,A01,083621,Davis; Joshua Daniel,9,0,68,59
1657997795824,COGS 101B,A01,091572,Allen; Michael Gordon,14,0,65,51
1657997801851,COGS 101C,A01,083625,Delgado; Tania,17,0,35,18
1657997807879,COGS 107A,A01,083627,Boyle; Mary E. T.,14,0,60,46
1657997813908,COGS 118A,A01,083075,Gupta; Anjum,21,0,76,55
1657997819937,CSE 3,A50,083646,Miranda; Gregory Joseph,24,0,50,26
1657997825966,CSE 8A,A50,083650,Miranda; Gregory Joseph,17,1,56,39
1657997831992,CSE 11,A01,083080,Cao; Yingjun,7,15,40,33
1657997838021,CSE 12,A01,083652,Krause-Levy; Sophia Louisa,30,1,120,90
1657997844044,CSE 15L,A01,083654,Morris; Justin Loren,9,0,50,41
1657997844044,CSE 15L,A02,083655,Morris; Justin Loren,11,0,50,39
1657997850066,CSE 20,A01,083657,Tran; Khoa Dang,39,0,80,41
1657997856091,CSE 21,A01,095574,Bach; Quang Tran,23,0,48,25
1657997862117,CSE 30,A01,083084,Eldon; John,8,0,80,72
1657997862117,CSE 30,B01,095061,Bhaskar; Nishant,9,0,50,41
1657997868140,CSE 100,A01,083659,Cao; Yingjun,5,4,70,65
1657997874163,CSE 134B,A01,083661,Powell; Thomas Allan,25,0,100,75
1657997880188,CSE 140,A01,083663,Gungor; Onat,17,0,85,68
1657997886211,CSE 140L,A01,083088,Eldon; John,23,0,100,77
1657997892233,CSE 175,A01,083665,Kumar; Rakesh,3,0,25,22
1657997898266,CSE 190,A00,092507,Dubnov; Shlomo,8,0,20,12
1657997904294,ECE 45,A01,083139,Congero; Spencer William,7,0,75,68
1657997910316,ECE 65,A50,083695,Saad; Andrew S,12,0,30,18
1657997910316,ECE 65,A51,095125,Saad; Andrew S,24,0,26,2
1657997916347,ECE 109,A01,091882,Touri; Behrouz,21,0,70,49
1657997922371,ECE 180,A00,083140,Abi Samra; Nicholas Camill,1,0,30,29
1657997922371,ECE 180,B00,083141,Abi Samra; Nicholas Camill,0,0,30,30
1657997928401,MATH 10A,A01,083735,Patchell; Gregory David,2,0,30,28
1657997928401,MATH 10A,A02,083736,Patchell; Gregory David,20,0,30,10
1657997928401,MATH 10A,A03,083737,Patchell; Gregory David,16,0,30,14
1657997934430,MATH 10B,A01,083207,Lim; Seonhee,9,0,34,25
1657997934430,MATH 10B,A02,083208,Lim; Seonhee,10,0,35,25
1657997934430,MATH 10B,A03,093472,Lim; Seonhee,7,0,34,27
1657997934430,MATH 10B,B01,083739,Sinha; Shubham,14,0,30,16
1657997940454,MATH 18,A01,083743,Cinel; Cameron Alexander,9,0,30,21
1657997940454,MATH 18,A02,083744,Cinel; Cameron Alexander,18,0,30,12
1657997940454,MATH 18,A03,083745,Cinel; Cameron Alexander,10,0,30,20
1657997940454,MATH 18,B01,083748,Rideout; David Porter,5,0,37,32
1657997940454,MATH 18,B02,083749,Rideout; David Porter,5,0,36,31
1657997940454,MATH 18,B03,083750,Rideout; David Porter,3,0,37,34
1657997940454,MATH 18,B04,083751,Rideout; David Porter,7,0,36,29
1657997940454,MATH 18,B05,093473,Rideout; David Porter,7,0,36,29
1657997940454,MATH 18,B06,093474,Rideout; David Porter,6,0,36,30
1657997946476,MATH 20A,A01,083754,Zheng; Zequn,14,0,40,26
1657997952503,MATH 20B,A01,083756,Briones; Jor-el Thomas Caparas,4,0,36,32
1657997952503,MATH 20B,A02,083757,Briones; Jor-el Thomas Caparas,1,0,36,35
1657997952503,MATH 20B,A03,093475,Briones; Jor-el Thomas Caparas,3,0,36,33
1657997958525,MATH 20C,A01,083760,Briones; Jor-el Thomas Caparas,1,0,35,34
1657997958525,MATH 20C,A02,083761,Briones; Jor-el Thomas Caparas,8,0,35,27
1657997958525,MATH 20C,A03,093476,Briones; Jor-el Thomas Caparas,0,1,36,36
1657997958525,MATH 20C,B01,083762,Bach; Quang Tran,1,0,30,29
1657997964549,MATH 20D,A01,083765,Tran; Brian Kha,5,0,30,25
1657997964549,MATH 20D,A02,083766,Tran; Brian Kha,5,0,30,25
1657997964549,MATH 20D,A03,083767,Tran; Brian Kha,6,0,30,24
1657997970577,MATH 20E,A01,083771,Ganguly; Soumya,12,0,32,20
1657997970577,MATH 20E,A02,083772,Ganguly; Soumya,7,0,32,25
1657997970577,MATH 20E,B01,083773,Ciotti; Benjamin,20,0,35,15
1657997970577,MATH 20E,B02,083774,Ciotti; Benjamin,18,0,35,17
1657997976600,MATH 103A,A01,083777,Greenfeld; Be'Eri,6,0,36,30
1657997976600,MATH 103A,A02,083778,Greenfeld; Be'Eri,5,0,36,31
1657997976600,MATH 103A,A03,093561,Greenfeld; Be'Eri,7,0,36,29
1657997976600,MATH 103A,B01,083779,Greenfeld; Be'Eri,8,0,36,28
1657997976600,MATH 103A,B02,083780,Greenfeld; Be'Eri,4,0,36,32
1657997976600,MATH 103A,B03,093562,Greenfeld; Be'Eri,3,0,36,33
1657997982624,MATH 105,A01,085443,Carter; Anne Toulson,15,0,35,20
1657997982624,MATH 105,A02,093477,Carter; Anne Toulson,20,0,35,15
1657997988670,MATH 109,A01,083213,Ganzberger; Geoffrey Michael,3,0,34,31
1657997988670,MATH 109,A02,083214,Ganzberger; Geoffrey Michael,4,0,34,30
1657997988670,MATH 109,A03,093478,Ganzberger; Geoffrey Michael,2,0,34,32
1657997988670,MATH 109,B01,083215,Ganzberger; Geoffrey Michael,3,0,32,29
1657997988670,MATH 109,B02,083216,Ganzberger; Geoffrey Michael,3,0,32,29
1657997988670,MATH 109,B03,093479,Ganzberger; Geoffrey Michael,8,0,32,24
1657997994695,MATH 142A,A01,083219,Chow; Bennett,7,0,32,25
1657997994695,MATH 142A,A02,083220,Chow; Bennett,10,0,32,22
1657997994695,MATH 142A,A03,093480,Chow; Bennett,9,0,32,23
1657997994695,MATH 142A,B03,093481,Chow; Bennett,8,0,32,24
1657997994695,MATH 142A,B04,093558,Chow; Bennett,14,0,32,18
1657997994695,MATH 142A,B05,093559,Chow; Bennett,7,0,32,25
1657998000723,MATH 193A,A01,083224,Rotar; Vladimir,9,0,34,25
1657998000723,MATH 193A,A02,083225,Rotar; Vladimir,11,0,34,23
1657998000723,MATH 193A,A03,083781,Rotar; Vladimir,5,0,34,29
1657998000723,MATH 193A,A04,083782,Rotar; Vladimir,12,0,34,22
1657998000723,MATH 193A,A05,093482,Rotar; Vladimir,11,0,34,23
1657998006746,MATH 197,001,091859,McAuley; Julian John,9999,0,9999,0
1657998006746,MATH 197,002,095566,Kedlaya; Kiran S.,9997,0,9999,2
1657998006746,MATH 197,003,095567,Xiao; Ming,9999,0,9999,0
1657998006746,MATH 197,004,095571,Perols; Johan Lars,9998,0,9999,1
1657998013810,COGS 9,A01,083615,Shannon; Kyle Michael,11,0,75,64
1657998019835,COGS 11,A01,083617,Boyle; Mary E. T.,23,0,48,25
1657998025861,COGS 13,A01,083071,Bastos; Amalia Pinkusfeld,12,0,71,59
1657998031886,COGS 14A,A01,092681,Semenuks; Arturs,5,1,100,95
1657998037908,COGS 14B,A01,083073,Cheng; Tzu-Han,7,0,63,56
1657998043930,COGS 17,A01,092677,Semenuks; Arturs,7,0,81,74
1657998049954,COGS 100,A01,083619,Allen; Michael Gordon,17,0,70,53
1657998056070,COGS 101A,A01,083621,Davis; Joshua Daniel,9,0,68,59
1657998062111,COGS 101B,A01,091572,Allen; Michael Gordon,14,0,65,51
1657998068136,COGS 101C,A01,083625,Delgado; Tania,17,0,35,18
1657998074158,COGS 107A,A01,083627,Boyle; Mary E. T.,14,0,60,46
1657998080182,COGS 118A,A01,083075,Gupta; Anjum,21,0,76,55
1657998086209,CSE 3,A50,083646,Miranda; Gregory Joseph,24,0,50,26
1657998092235,CSE 8A,A50,083650,Miranda; Gregory Joseph,17,1,56,39
1657998098257,CSE 11,A01,083080,Cao; Yingjun,7,15,40,33
1657998104280,CSE 12,A01,083652,Krause-Levy; Sophia Louisa,30,1,120,90
1657998110303,CSE 15L,A01,083654,Morris; Justin Loren,9,0,50,41
1657998110303,CSE 15L,A02,083655,Morris; Justin Loren,11,0,50,39
1657998116328,CSE 20,A01,083657,Tran; Khoa Dang,39,0,80,41
1657998122354,CSE 21,A01,095574,Bach; Quang Tran,23,0,48,25
1657998128381,CSE 30,A01,083084,Eldon; John,8,0,80,72
1657998128381,CSE 30,B01,095061,Bhaskar; Nishant,9,0,50,41
1657998134404,CSE 100,A01,083659,Cao; Yingjun,5,4,70,65
1657998140427,CSE 134B,A01,083661,Powell; Thomas Allan,25,0,100,75
1657998146454,CSE 140,A01,083663,Gungor; Onat,17,0,85,68
1657998152480,CSE 140L,A01,083088,Eldon; John,23,0,100,77
1657998158505,CSE 175,A01,083665,Kumar; Rakesh,3,0,25,22
1657998164527,CSE 190,A00,092507,Dubnov; Shlomo,8,0,20,12
1657998170555,ECE 45,A01,083139,Congero; Spencer William,7,0,75,68
1657998176581,ECE 65,A50,083695,Saad; Andrew S,12,0,30,18
1657998176581,ECE 65,A51,095125,Saad; Andrew S,24,0,26,2
1657998182606,ECE 109,A01,091882,Touri; Behrouz,21,0,70,49
1657998188633,ECE 180,A00,083140,Abi Samra; Nicholas Camill,1,0,30,29
1657998188633,ECE 180,B00,083141,Abi Samra; Nicholas Camill,0,0,30,30
1657998194657,MATH 10A,A01,083735,Patchell; Gregory David,2,0,30,28
1657998194657,MATH 10A,A02,083736,Patchell; Gregory David,20,0,30,10
1657998194657,MATH 10A,A03,083737,Patchell; Gregory David,16,0,30,14
1657998200682,MATH 10B,A01,083207,Lim; Seonhee,9,0,34,25
1657998200682,MATH 10B,A02,083208,Lim; Seonhee,10,0,35,25
1657998200682,MATH 10B,A03,093472,Lim; Seonhee,7,0,34,27
1657998200682,MATH 10B,B01,083739,Sinha; Shubham,14,0,30,16
1657998206707,MATH 18,A01,083743,Cinel; Cameron Alexander,9,0,30,21
1657998206707,MATH 18,A02,083744,Cinel; Cameron Alexander,18,0,30,12
1657998206707,MATH 18,A03,083745,Cinel; Cameron Alexander,10,0,30,20
1657998206707,MATH 18,B01,083748,Rideout; David Porter,5,0,37,32
1657998206707,MATH 18,B02,083749,Rideout; David Porter,5,0,36,31
1657998206707,MATH 18,B03,083750,Rideout; David Porter,3,0,37,34
1657998206707,MATH 18,B04,083751,Rideout; David Porter,7,0,36,29
1657998206707,MATH 18,B05,093473,Rideout; David Porter,7,0,36,29
1657998206707,MATH 18,B06,093474,Rideout; David Porter,6,0,36,30
1657998212729,MATH 20A,A01,083754,Zheng; Zequn,14,0,40,26
1657998218756,MATH 20B,A01,083756,Briones; Jor-el Thomas Caparas,4,0,36,32
1657998218756,MATH 20B,A02,083757,Briones; Jor-el Thomas Caparas,1,0,36,35
1657998218756,MATH 20B,A03,093475,Briones; Jor-el Thomas Caparas,3,0,36,33
1657998224779,MATH 20C,A01,083760,Briones; Jor-el Thomas Caparas,1,0,35,34
1657998224779,MATH 20C,A02,083761,Briones; Jor-el Thomas Caparas,8,0,35,27
1657998224779,MATH 20C,A03,093476,Briones; Jor-el Thomas Caparas,0,1,36,36
1657998224779,MATH 20C,B01,083762,Bach; Quang Tran,1,0,30,29
1657998230803,MATH 20D,A01,083765,Tran; Brian Kha,5,0,30,25
1657998230803,MATH 20D,A02,083766,Tran; Brian Kha,5,0,30,25
1657998230803,MATH 20D,A03,083767,Tran; Brian Kha,6,0,30,24
1657998236830,MATH 20E,A01,083771,Ganguly; Soumya,12,0,32,20
1657998236830,MATH 20E,A02,083772,Ganguly; Soumya,7,0,32,25
1657998236830,MATH 20E,B01,083773,Ciotti; Benjamin,20,0,35,15
1657998236830,MATH 20E,B02,083774,Ciotti; Benjamin,18,0,35,17
1657998242854,MATH 103A,A01,083777,Greenfeld; Be'Eri,6,0,36,30
1657998242854,MATH 103A,A02,083778,Greenfeld; Be'Eri,5,0,36,31
1657998242854,MATH 103A,A03,093561,Greenfeld; Be'Eri,7,0,36,29
1657998242854,MATH 103A,B01,083779,Greenfeld; Be'Eri,8,0,36,28
1657998242854,MATH 103A,B02,083780,Greenfeld; Be'Eri,4,0,36,32
1657998242854,MATH 103A,B03,093562,Greenfeld; Be'Eri,3,0,36,33
1657998248877,MATH 105,A01,085443,Carter; Anne Toulson,15,0,35,20
1657998248877,MATH 105,A02,093477,Carter; Anne Toulson,20,0,35,15
1657998254907,MATH 109,A01,083213,Ganzberger; Geoffrey Michael,3,0,34,31
1657998254907,MATH 109,A02,083214,Ganzberger; Geoffrey Michael,4,0,34,30
1657998254907,MATH 109,A03,093478,Ganzberger; Geoffrey Michael,2,0,34,32
1657998254907,MATH 109,B01,083215,Ganzberger; Geoffrey Michael,3,0,32,29
1657998254907,MATH 109,B02,083216,Ganzberger; Geoffrey Michael,3,0,32,29
1657998254907,MATH 109,B03,093479,Ganzberger; Geoffrey Michael,8,0,32,24
1657998260931,MATH 142A,A01,083219,Chow; Bennett,7,0,32,25
1657998260931,MATH 142A,A02,083220,Chow; Bennett,10,0,32,22
1657998260931,MATH 142A,A03,093480,Chow; Bennett,9,0,32,23
1657998260931,MATH 142A,B03,093481,Chow; Bennett,8,0,32,24
1657998260931,MATH 142A,B04,093558,Chow; Bennett,14,0,32,18
1657998260931,MATH 142A,B05,093559,Chow; Bennett,7,0,32,25
1657998266959,MATH 193A,A01,083224,Rotar; Vladimir,9,0,34,25
1657998266959,MATH 193A,A02,083225,Rotar; Vladimir,11,0,34,23
1657998266959,MATH 193A,A03,083781,Rotar; Vladimir,5,0,34,29
1657998266959,MATH 193A,A04,083782,Rotar; Vladimir,12,0,34,22
1657998266959,MATH 193A,A05,093482,Rotar; Vladimir,11,0,34,23
1657998272982,MATH 197,001,091859,McAuley; Julian John,9999,0,9999,0
1657998272982,MATH 197,002,095566,Kedlaya; Kiran S.,9997,0,9999,2
1657998272982,MATH 197,003,095567,Xiao; Ming,9999,0,9999,0
1657998272982,MATH 197,004,095571,Perols; Johan Lars,9998,0,9999,1
1657998280037,COGS 9,A01,083615,Shannon; Kyle Michael,11,0,75,64
1657998286058,COGS 11,A01,083617,Boyle; Mary E. T.,23,0,48,25
1657998292080,COGS 13,A01,083071,Bastos; Amalia Pinkusfeld,12,0,71,59
1657998298105,COGS 14A,A01,092681,Semenuks; Arturs,5,1,100,95
1657998304127,COGS 14B,A01,083073,Cheng; Tzu-Han,7,0,63,56
1657998310149,COGS 17,A01,092677,Semenuks; Arturs,7,0,81,74
1657998316172,COGS 100,A01,083619,Allen; Michael Gordon,17,0,70,53
1657998322194,COGS 101A,A01,083621,Davis; Joshua Daniel,9,0,68,59
1657998328217,COGS 101B,A01,091572,Allen; Michael Gordon,14,0,65,51
1657998334240,COGS 101C,A01,083625,Delgado; Tania,17,0,35,18
1657998340271,COGS 107A,A01,083627,Boyle; Mary E. T.,14,0,60,46
1657998346297,COGS 118A,A01,083075,Gupta; Anjum,21,0,76,55
1657998352322,CSE 3,A50,083646,Miranda; Gregory Joseph,24,0,50,26
1657998358349,CSE 8A,A50,083650,Miranda; Gregory Joseph,17,1,56,39
1657998364372,CSE 11,A01,083080,Cao; Yingjun,7,15,40,33
1657998370394,CSE 12,A01,083652,Krause-Levy; Sophia Louisa,30,1,120,90
1657998376417,CSE 15L,A01,083654,Morris; Justin Loren,9,0,50,41
1657998376417,CSE 15L,A02,083655,Morris; Justin Loren,11,0,50,39
1657998382443,CSE 20,A01,083657,Tran; Khoa Dang,39,0,80,41
1657998388466,CSE 21,A01,095574,Bach; Quang Tran,23,0,48,25
1657998394488,CSE 30,A01,083084,Eldon; John,8,0,80,72
1657998394488,CSE 30,B01,095061,Bhaskar; Nishant,9,0,50,41
1657998400515,CSE 100,A01,083659,Cao; Yingjun,5,4,70,65
1657998406541,CSE 134B,A01,083661,Powell; Thomas Allan,25,0,100,75
1657998412566,CSE 140,A01,083663,Gungor; Onat,17,0,85,68
1657998418591,CSE 140L,A01,083088,Eldon; John,23,0,100,77
1657998424613,CSE 175,A01,083665,Kumar; Rakesh,3,0,25,22
1657998430634,CSE 190,A00,092507,Dubnov; Shlomo,8,0,20,12
1657998436661,ECE 45,A01,083139,Congero; Spencer William,7,0,75,68
1657998442688,ECE 65,A50,083695,Saad; Andrew S,12,0,30,18
1657998442688,ECE 65,A51,095125,Saad; Andrew S,24,0,26,2
1657998448719,ECE 109,A01,091882,Touri; Behrouz,21,0,70,49
1657998454745,ECE 180,A00,083140,Abi Samra; Nicholas Camill,1,0,30,29
1657998454745,ECE 180,B00,083141,Abi Samra; Nicholas Camill,0,0,30,30
1657998460775,MATH 10A,A01,083735,Patchell; Gregory David,2,0,30,28
1657998460775,MATH 10A,A02,083736,Patchell; Gregory David,20,0,30,10
1657998460775,MATH 10A,A03,083737,Patchell; Gregory David,16,0,30,14
1657998466799,MATH 10B,A01,083207,Lim; Seonhee,9,0,34,25
1657998466799,MATH 10B,A02,083208,Lim; Seonhee,10,0,35,25
1657998466799,MATH 10B,A03,093472,Lim; Seonhee,7,0,34,27
1657998466799,MATH 10B,B01,083739,Sinha; Shubham,14,0,30,16
1657998472830,MATH 18,A01,083743,Cinel; Cameron Alexander,9,0,30,21
1657998472830,MATH 18,A02,083744,Cinel; Cameron Alexander,18,0,30,12
1657998472830,MATH 18,A03,083745,Cinel; Cameron Alexander,10,0,30,20
1657998472830,MATH 18,B01,083748,Rideout; David Porter,5,0,37,32
1657998472830,MATH 18,B02,083749,Rideout; David Porter,5,0,36,31
1657998472830,MATH 18,B03,083750,Rideout; David Porter,3,0,37,34
1657998472830,MATH 18,B04,083751,Rideout; David Porter,7,0,36,29
1657998472830,MATH 18,B05,093473,Rideout; David Porter,7,0,36,29
1657998472830,MATH 18,B06,093474,Rideout; David Porter,6,0,36,30
1657998478864,MATH 20A,A01,083754,Zheng; Zequn,14,0,40,26
1657998484888,MATH 20B,A01,083756,Briones; Jor-el Thomas Caparas,4,0,36,32
1657998484888,MATH 20B,A02,083757,Briones; Jor-el Thomas Caparas,1,0,36,35
1657998484888,MATH 20B,A03,093475,Briones; Jor-el Thomas Caparas,3,0,36,33
1657998490910,MATH 20C,A01,083760,Briones; Jor-el Thomas Caparas,1,0,35,34
1657998490910,MATH 20C,A02,083761,Briones; Jor-el Thomas Caparas,8,0,35,27
1657998490910,MATH 20C,A03,093476,Briones; Jor-el Thomas Caparas,0,1,36,36
1657998490910,MATH 20C,B01,083762,Bach; Quang Tran,1,0,30,29
1657998496932,MATH 20D,A01,083765,Tran; Brian Kha,5,0,30,25
1657998496932,MATH 20D,A02,083766,Tran; Brian Kha,5,0,30,25
1657998496932,MATH 20D,A03,083767,Tran; Brian Kha,6,0,30,24
1657998502956,MATH 20E,A01,083771,Ganguly; Soumya,12,0,32,20
1657998502956,MATH 20E,A02,083772,Ganguly; Soumya,7,0,32,25
1657998502956,MATH 20E,B01,083773,Ciotti; Benjamin,20,0,35,15
1657998502956,MATH 20E,B02,083774,Ciotti; Benjamin,18,0,35,17
1657998508985,MATH 103A,A01,083777,Greenfeld; Be'Eri,6,0,36,30
1657998508985,MATH 103A,A02,083778,Greenfeld; Be'Eri,5,0,36,31
1657998508985,MATH 103A,A03,093561,Greenfeld; Be'Eri,7,0,36,29
1657998508985,MATH 103A,B01,083779,Greenfeld; Be'Eri,8,0,36,28
1657998508985,MATH 103A,B02,083780,Greenfeld; Be'Eri,4,0,36,32
1657998508985,MATH 103A,B03,093562,Greenfeld; Be'Eri,3,0,36,33
1657998515009,MATH 105,A01,085443,Carter; Anne Toulson,15,0,35,20
1657998515009,MATH 105,A02,093477,Carter; Anne Toulson,20,0,35,15
1657998521032,MATH 109,A01,083213,Ganzberger; Geoffrey Michael,3,0,34,31
1657998521032,MATH 109,A02,083214,Ganzberger; Geoffrey Michael,4,0,34,30
1657998521032,MATH 109,A03,093478,Ganzberger; Geoffrey Michael,2,0,34,32
1657998521032,MATH 109,B01,083215,Ganzberger; Geoffrey Michael,3,0,32,29
1657998521032,MATH 109,B02,083216,Ganzberger; Geoffrey Michael,3,0,32,29
1657998521032,MATH 109,B03,093479,Ganzberger; Geoffrey Michael,8,0,32,24
1657998527060,MATH 142A,A01,083219,Chow; Bennett,7,0,32,25
1657998527060,MATH 142A,A02,083220,Chow; Bennett,10,0,32,22
1657998527060,MATH 142A,A03,093480,Chow; Bennett,9,0,32,23
1657998527060,MATH 142A,B03,093481,Chow; Bennett,8,0,32,24
1657998527060,MATH 142A,B04,093558,Chow; Bennett,14,0,32,18
1657998527060,MATH 142A,B05,093559,Chow; Bennett,7,0,32,25
1657998533088,MATH 193A,A01,083224,Rotar; Vladimir,9,0,34,25
1657998533088,MATH 193A,A02,083225,Rotar; Vladimir,11,0,34,23
1657998533088,MATH 193A,A03,083781,Rotar; Vladimir,5,0,34,29
1657998533088,MATH 193A,A04,083782,Rotar; Vladimir,12,0,34,22
1657998533088,MATH 193A,A05,093482,Rotar; Vladimir,11,0,34,23
1657998539112,MATH 197,001,091859,McAuley; Julian John,9999,0,9999,0
1657998539112,MATH 197,002,095566,Kedlaya; Kiran S.,9997,0,9999,2
1657998539112,MATH 197,003,095567,Xiao; Ming,9999,0,9999,0
1657998539112,MATH 197,004,095571,Perols; Johan Lars,9998,0,9999,1
1657998546176,COGS 9,A01,083615,Shannon; Kyle Michael,11,0,75,64
1657998552198,COGS 11,A01,083617,Boyle; Mary E. T.,23,0,48,25
1657998558220,COGS 13,A01,083071,Bastos; Amalia Pinkusfeld,12,0,71,59
1657998564246,COGS 14A,A01,092681,Semenuks; Arturs,5,1,100,95
1657998570273,COGS 14B,A01,083073,Cheng; Tzu-Han,7,0,63,56
1657998576299,COGS 17,A01,092677,Semenuks; Arturs,7,0,81,74
1657998582322,COGS 100,A01,083619,Allen; Michael Gordon,17,0,70,53
1657998588345,COGS 101A,A01,083621,Davis; Joshua Daniel,9,0,68,59
1657998594379,COGS 101B,A01,091572,Allen; Michael Gordon,14,0,65,51
1657998600406,COGS 101C,A01,083625,Delgado; Tania,17,0,35,18
1657998606432,COGS 107A,A01,083627,Boyle; Mary E. T.,14,0,60,46
1657998612454,COGS 118A,A01,083075,Gupta; Anjum,21,0,76,55
1657998618476,CSE 3,A50,083646,Miranda; Gregory Joseph,24,0,50,26
1657998624499,CSE 8A,A50,083650,Miranda; Gregory Joseph,17,1,56,39
1657998630525,CSE 11,A01,083080,Cao; Yingjun,7,15,40,33
1657998636551,CSE 12,A01,083652,Krause-Levy; Sophia Louisa,30,1,120,90
1657998642575,CSE 15L,A01,083654,Morris; Justin Loren,9,0,50,41
1657998642575,CSE 15L,A02,083655,Morris; Justin Loren,11,0,50,39
1657998648601,CSE 20,A01,083657,Tran; Khoa Dang,39,0,80,41
1657998654713,CSE 21,A01,095574,Bach; Quang Tran,23,0,48,25
1657998660735,CSE 30,A01,083084,Eldon; John,8,0,80,72
1657998660735,CSE 30,B01,095061,Bhaskar; Nishant,9,0,50,41
1657998666761,CSE 100,A01,083659,Cao; Yingjun,5,4,70,65
1657998672784,CSE 134B,A01,083661,Powell; Thomas Allan,25,0,100,75
1657998678809,CSE 140,A01,083663,Gungor; Onat,17,0,85,68
1657998684835,CSE 140L,A01,083088,Eldon; John,23,0,100,77
1657998690861,CSE 175,A01,083665,Kumar; Rakesh,3,0,25,22
1657998696887,CSE 190,A00,092507,Dubnov; Shlomo,8,0,20,12
1657998702909,ECE 45,A01,083139,Congero; Spencer William,7,0,75,68
1657998708931,ECE 65,A50,083695,Saad; Andrew S,12,0,30,18
1657998708931,ECE 65,A51,095125,Saad; Andrew S,24,0,26,2
1657998714953,ECE 109,A01,091882,Touri; Behrouz,21,0,70,49
1657998720980,ECE 180,A00,083140,Abi Samra; Nicholas Camill,1,0,30,29
1657998720980,ECE 180,B00,083141,Abi Samra; Nicholas Camill,0,0,30,30
1657998727009,MATH 10A,A01,083735,Patchell; Gregory David,2,0,30,28
1657998727009,MATH 10A,A02,083736,Patchell; Gregory David,20,0,30,10
1657998727009,MATH 10A,A03,083737,Patchell; Gregory David,16,0,30,14
1657998733032,MATH 10B,A01,083207,Lim; Seonhee,9,0,34,25
1657998733032,MATH 10B,A02,083208,Lim; Seonhee,10,0,35,25
1657998733032,MATH 10B,A03,093472,Lim; Seonhee,7,0,34,27
1657998733032,MATH 10B,B01,083739,Sinha; Shubham,14,0,30,16
1657998739056,MATH 18,A01,083743,Cinel; Cameron Alexander,9,0,30,21
1657998739056,MATH 18,A02,083744,Cinel; Cameron Alexander,18,0,30,12
1657998739056,MATH 18,A03,083745,Cinel; Cameron Alexander,10,0,30,20
1657998739056,MATH 18,B01,083748,Rideout; David Porter,5,0,37,32
1657998739056,MATH 18,B02,083749,Rideout; David Porter,5,0,36,31
1657998739056,MATH 18,B03,083750,Rideout; David Porter,3,0,37,34
1657998739056,MATH 18,B04,083751,Rideout; David Porter,7,0,36,29
1657998739056,MATH 18,B05,093473,Rideout; David Porter,7,0,36,29
1657998739056,MATH 18,B06,093474,Rideout; David Porter,6,0,36,30
1657998745080,MATH 20A,A01,083754,Zheng; Zequn,14,0,40,26
1657998751107,MATH 20B,A01,083756,Briones; Jor-el Thomas Caparas,4,0,36,32
1657998751107,MATH 20B,A02,083757,Briones; Jor-el Thomas Caparas,1,0,36,35
1657998751107,MATH 20B,A03,093475,Briones; Jor-el Thomas Caparas,3,0,36,33
1657998757131,MATH 20C,A01,083760,Briones; Jor-el Thomas Caparas,1,0,35,34
1657998757131,MATH 20C,A02,083761,Briones; Jor-el Thomas Caparas,8,0,35,27
1657998757131,MATH 20C,A03,093476,Briones; Jor-el Thomas Caparas,0,1,36,36
1657998757131,MATH 20C,B01,083762,Bach; Quang Tran,1,0,30,29
1657998763154,MATH 20D,A01,083765,Tran; Brian Kha,5,0,30,25
1657998763154,MATH 20D,A02,083766,Tran; Brian Kha,5,0,30,25
1657998763154,MATH 20D,A03,083767,Tran; Brian Kha,6,0,30,24
1657998769182,MATH 20E,A01,083771,Ganguly; Soumya,12,0,32,20
1657998769182,MATH 20E,A02,083772,Ganguly; Soumya,7,0,32,25
1657998769182,MATH 20E,B01,083773,Ciotti; Benjamin,20,0,35,15
1657998769182,MATH 20E,B02,083774,Ciotti; Benjamin,18,0,35,17
1657998775213,MATH 103A,A01,083777,Greenfeld; Be'Eri,6,0,36,30
1657998775213,MATH 103A,A02,083778,Greenfeld; Be'Eri,5,0,36,31
1657998775213,MATH 103A,A03,093561,Greenfeld; Be'Eri,7,0,36,29
1657998775213,MATH 103A,B01,083779,Greenfeld; Be'Eri,8,0,36,28
1657998775213,MATH 103A,B02,083780,Greenfeld; Be'Eri,4,0,36,32
1657998775213,MATH 103A,B03,093562,Greenfeld; Be'Eri,3,0,36,33
1657998781237,MATH 105,A01,085443,Carter; Anne Toulson,15,0,35,20
1657998781237,MATH 105,A02,093477,Carter; Anne Toulson,20,0,35,15
1657998787268,MATH 109,A01,083213,Ganzberger; Geoffrey Michael,3,0,34,31
1657998787268,MATH 109,A02,083214,Ganzberger; Geoffrey Michael,4,0,34,30
1657998787268,MATH 109,A03,093478,Ganzberger; Geoffrey Michael,2,0,34,32
1657998787268,MATH 109,B01,083215,Ganzberger; Geoffrey Michael,3,0,32,29
1657998787268,MATH 109,B02,083216,Ganzberger; Geoffrey Michael,3,0,32,29
1657998787268,MATH 109,B03,093479,Ganzberger; Geoffrey Michael,8,0,32,24
1657998793307,MATH 142A,A01,083219,Chow; Bennett,7,0,32,25
1657998793307,MATH 142A,A02,083220,Chow; Bennett,10,0,32,22
1657998793307,MATH 142A,A03,093480,Chow; Bennett,9,0,32,23
1657998793307,MATH 142A,B03,093481,Chow; Bennett,8,0,32,24
1657998793307,MATH 142A,B04,093558,Chow; Bennett,14,0,32,18
1657998793307,MATH 142A,B05,093559,Chow; Bennett,7,0,32,25
1657998799333,MATH 193A,A01,083224,Rotar; Vladimir,9,0,34,25
1657998799333,MATH 193A,A02,083225,Rotar; Vladimir,11,0,34,23
1657998799333,MATH 193A,A03,083781,Rotar; Vladimir,5,0,34,29
1657998799333,MATH 193A,A04,083782,Rotar; Vladimir,12,0,34,22
1657998799333,MATH 193A,A05,093482,Rotar; Vladimir,11,0,34,23
1657998805357,MATH 197,001,091859,McAuley; Julian John,9999,0,9999,0
1657998805357,MATH 197,002,095566,Kedlaya; Kiran S.,9997,0,9999,2
1657998805357,MATH 197,003,095567,Xiao; Ming,9999,0,9999,0
1657998805357,MATH 197,004,095571,Perols; Johan Lars,9998,0,9999,1
1657998812422,COGS 9,A01,083615,Shannon; Kyle Michael,11,0,75,64
1657998818449,COGS 11,A01,083617,Boyle; Mary E. T.,23,0,48,25
1657998824476,COGS 13,A01,083071,Bastos; Amalia Pinkusfeld,12,0,71,59
1657998830529,COGS 14A,A01,092681,Semenuks; Arturs,5,1,100,95
1657998836554,COGS 14B,A01,083073,Cheng; Tzu-Han,7,0,63,56
1657998842579,COGS 17,A01,092677,Semenuks; Arturs,7,0,81,74
1657998848605,COGS 100,A01,083619,Allen; Michael Gordon,17,0,70,53
1657998854628,COGS 101A,A01,083621,Davis; Joshua Daniel,9,0,68,59
1657998860650,COGS 101B,A01,091572,Allen; Michael Gordon,14,0,65,51
1657998866672,COGS 101C,A01,083625,Delgado; Tania,17,0,35,18
1657998872695,COGS 107A,A01,083627,Boyle; Mary E. T.,14,0,60,46
1657998878720,COGS 118A,A01,083075,Gupta; Anjum,21,0,76,55
1657998884748,CSE 3,A50,083646,Miranda; Gregory Joseph,24,0,50,26
1657998890771,CSE 8A,A50,083650,Miranda; Gregory Joseph,17,1,56,39
1657998896794,CSE 11,A01,083080,Cao; Yingjun,7,15,40,33
1657998902822,CSE 12,A01,083652,Krause-Levy; Sophia Louisa,30,1,120,90
1657998908847,CSE 15L,A01,083654,Morris; Justin Loren,9,0,50,41
1657998908847,CSE 15L,A02,083655,Morris; Justin Loren,11,0,50,39
1657998914870,CSE 20,A01,083657,Tran; Khoa Dang,39,0,80,41
1657998920892,CSE 21,A01,095574,Bach; Quang Tran,23,0,48,25
1657998926919,CSE 30,A01,083084,Eldon; John,8,0,80,72
1657998926919,CSE 30,B01,095061,Bhaskar; Nishant,9,0,50,41
1657998932945,CSE 100,A01,083659,Cao; Yingjun,5,4,70,65
1657998938967,CSE 134B,A01,083661,Powell; Thomas Allan,25,0,100,75
1657998945002,CSE 140,A01,083663,Gungor; Onat,17,0,85,68
1657998951024,CSE 140L,A01,083088,Eldon; John,23,0,100,77
1657998957046,CSE 175,A01,083665,Kumar; Rakesh,3,0,25,22
1657998963068,CSE 190,A00,092507,Dubnov; Shlomo,8,0,20,12
1657998969097,ECE 45,A01,083139,Congero; Spencer William,7,0,75,68
1657998975121,ECE 65,A50,083695,Saad; Andrew S,12,0,30,18
1657998975121,ECE 65,A51,095125,Saad; Andrew S,24,0,26,2
1657998981146,ECE 109,A01,091882,Touri; Behrouz,21,0,70,49
1657998987172,ECE 180,A00,083140,Abi Samra; Nicholas Camill,1,0,30,29
1657998987172,ECE 180,B00,083141,Abi Samra; Nicholas Camill,0,0,30,30
1657998993204,MATH 10A,A01,083735,Patchell; Gregory David,2,0,30,28
1657998993204,MATH 10A,A02,083736,Patchell; Gregory David,20,0,30,10
1657998993204,MATH 10A,A03,083737,Patchell; Gregory David,16,0,30,14
1657998999233,MATH 10B,A01,083207,Lim; Seonhee,9,0,34,25
1657998999233,MATH 10B,A02,083208,Lim; Seonhee,10,0,35,25
1657998999233,MATH 10B,A03,093472,Lim; Seonhee,7,0,34,27
1657998999233,MATH 10B,B01,083739,Sinha; Shubham,14,0,30,16
1657999005257,MATH 18,A01,083743,Cinel; Cameron Alexander,9,0,30,21
1657999005257,MATH 18,A02,083744,Cinel; Cameron Alexander,18,0,30,12
1657999005257,MATH 18,A03,083745,Cinel; Cameron Alexander,10,0,30,20
1657999005257,MATH 18,B01,083748,Rideout; David Porter,5,0,37,32
1657999005257,MATH 18,B02,083749,Rideout; David Porter,5,0,36,31
1657999005257,MATH 18,B03,083750,Rideout; David Porter,3,0,37,34
1657999005257,MATH 18,B04,083751,Rideout; David Porter,7,0,36,29
1657999005257,MATH 18,B05,093473,Rideout; David Porter,7,0,36,29
1657999005257,MATH 18,B06,093474,Rideout; David Porter,6,0,36,30
1657999011279,MATH 20A,A01,083754,Zheng; Zequn,14,0,40,26
1657999017302,MATH 20B,A01,083756,Briones; Jor-el Thomas Caparas,4,0,36,32
1657999017302,MATH 20B,A02,083757,Briones; Jor-el Thomas Caparas,1,0,36,35
1657999017302,MATH 20B,A03,093475,Briones; Jor-el Thomas Caparas,3,0,36,33
1657999023332,MATH 20C,A01,083760,Briones; Jor-el Thomas Caparas,1,0,35,34
1657999023332,MATH 20C,A02,083761,Briones; Jor-el Thomas Caparas,8,0,35,27
1657999023332,MATH 20C,A03,093476,Briones; Jor-el Thomas Caparas,0,1,36,36
1657999023332,MATH 20C,B01,083762,Bach; Quang Tran,1,0,30,29
1657999029355,MATH 20D,A01,083765,Tran; Brian Kha,5,0,30,25
1657999029355,MATH 20D,A02,083766,Tran; Brian Kha,5,0,30,25
1657999029355,MATH 20D,A03,083767,Tran; Brian Kha,6,0,30,24
1657999035384,MATH 20E,A01,083771,Ganguly; Soumya,12,0,32,20
1657999035384,MATH 20E,A02,083772,Ganguly; Soumya,7,0,32,25
1657999035384,MATH 20E,B01,083773,Ciotti; Benjamin,20,0,35,15
1657999035384,MATH 20E,B02,083774,Ciotti; Benjamin,18,0,35,17
1657999041421,MATH 103A,A01,083777,Greenfeld; Be'Eri,6,0,36,30
1657999041421,MATH 103A,A02,083778,Greenfeld; Be'Eri,5,0,36,31
1657999041421,MATH 103A,A03,093561,Greenfeld; Be'Eri,7,0,36,29
1657999041421,MATH 103A,B01,083779,Greenfeld; Be'Eri,8,0,36,28
1657999041421,MATH 103A,B02,083780,Greenfeld; Be'Eri,4,0,36,32
1657999041421,MATH 103A,B03,093562,Greenfeld; Be'Eri,3,0,36,33
1657999047448,MATH 105,A01,085443,Carter; Anne Toulson,15,0,35,20
1657999047448,MATH 105,A02,093477,Carter; Anne Toulson,20,0,35,15
1657999053478,MATH 109,A01,083213,Ganzberger; Geoffrey Michael,3,0,34,31
1657999053478,MATH 109,A02,083214,Ganzberger; Geoffrey Michael,4,0,34,30
1657999053478,MATH 109,A03,093478,Ganzberger; Geoffrey Michael,2,0,34,32
1657999053478,MATH 109,B01,083215,Ganzberger; Geoffrey Michael,3,0,32,29
1657999053478,MATH 109,B02,083216,Ganzberger; Geoffrey Michael,3,0,32,29
1657999053478,MATH 109,B03,093479,Ganzberger; Geoffrey Michael,8,0,32,24
1657999059501,MATH 142A,A01,083219,Chow; Bennett,7,0,32,25
1657999059501,MATH 142A,A02,083220,Chow; Bennett,10,0,32,22
1657999059501,MATH 142A,A03,093480,Chow; Bennett,9,0,32,23
1657999059501,MATH 142A,B03,093481,Chow; Bennett,8,0,32,24
1657999059501,MATH 142A,B04,093558,Chow; Bennett,14,0,32,18
1657999059501,MATH 142A,B05,093559,Chow; Bennett,7,0,32,25
1657999065529,MATH 193A,A01,083224,Rotar; Vladimir,9,0,34,25
1657999065529,MATH 193A,A02,083225,Rotar; Vladimir,11,0,34,23
1657999065529,MATH 193A,A03,083781,Rotar; Vladimir,5,0,34,29
1657999065529,MATH 193A,A04,083782,Rotar; Vladimir,12,0,34,22
1657999065529,MATH 193A,A05,093482,Rotar; Vladimir,11,0,34,23
1657999071554,MATH 197,001,091859,McAuley; Julian John,9999,0,9999,0
1657999071554,MATH 197,002,095566,Kedlaya; Kiran S.,9997,0,9999,2
1657999071554,MATH 197,003,095567,Xiao; Ming,9999,0,9999,0
1657999071554,MATH 197,004,095571,Perols; Johan Lars,9998,0,9999,1
1657999078605,COGS 9,A01,083615,Shannon; Kyle Michael,11,0,75,64
1657999084633,COGS 11,A01,083617,Boyle; Mary E. T.,23,0,48,25
1657999090664,COGS 13,A01,083071,Bastos; Amalia Pinkusfeld,12,0,71,59
1657999096693,COGS 14A,A01,092681,Semenuks; Arturs,5,1,100,95
1657999102718,COGS 14B,A01,083073,Cheng; Tzu-Han,7,0,63,56
1657999108746,COGS 17,A01,092677,Semenuks; Arturs,7,0,81,74
1657999114772,COGS 100,A01,083619,Allen; Michael Gordon,17,0,70,53
1657999120799,COGS 101A,A01,083621,Davis; Joshua Daniel,9,0,68,59
1657999126823,COGS 101B,A01,091572,Allen; Michael Gordon,14,0,65,51
1657999132851,COGS 101C,A01,083625,Delgado; Tania,17,0,35,18
1657999138873,COGS 107A,A01,083627,Boyle; Mary E. T.,14,0,60,46
1657999144902,COGS 118A,A01,083075,Gupta; Anjum,21,0,76,55
1657999150929,CSE 3,A50,083646,Miranda; Gregory Joseph,24,0,50,26
1657999156955,CSE 8A,A50,083650,Miranda; Gregory Joseph,17,1,56,39
1657999162978,CSE 11,A01,083080,Cao; Yingjun,7,15,40,33
1657999169004,CSE 12,A01,083652,Krause-Levy; Sophia Louisa,30,1,120,90
1657999175027,CSE 15L,A01,083654,Morris; Justin Loren,9,0,50,41
1657999175027,CSE 15L,A02,083655,Morris; Justin Loren,11,0,50,39
1657999181054,CSE 20,A01,083657,Tran; Khoa Dang,39,0,80,41
1657999187081,CSE 21,A01,095574,Bach; Quang Tran,23,0,48,25
1657999193105,CSE 30,A01,083084,Eldon; John,8,0,80,72
1657999193105,CSE 30,B01,095061,Bhaskar; Nishant,9,0,50,41
1657999199135,CSE 100,A01,083659,Cao; Yingjun,5,4,70,65
1657999205160,CSE 134B,A01,083661,Powell; Thomas Allan,25,0,100,75
1657999211183,CSE 140,A01,083663,Gungor; Onat,17,0,85,68
1657999217210,CSE 140L,A01,083088,Eldon; John,23,0,100,77
1657999223239,CSE 175,A01,083665,Kumar; Rakesh,3,0,25,22
1657999229267,CSE 190,A00,092507,Dubnov; Shlomo,8,0,20,12
1657999235293,ECE 45,A01,083139,Congero; Spencer William,7,0,75,68
1657999241317,ECE 65,A50,083695,Saad; Andrew S,12,0,30,18
1657999241317,ECE 65,A51,095125,Saad; Andrew S,24,0,26,2
1657999247339,ECE 109,A01,091882,Touri; Behrouz,21,0,70,49
1657999253436,ECE 180,A00,083140,Abi Samra; Nicholas Camill,1,0,30,29
1657999253436,ECE 180,B00,083141,Abi Samra; Nicholas Camill,0,0,30,30
1657999259466,MATH 10A,A01,083735,Patchell; Gregory David,2,0,30,28
1657999259466,MATH 10A,A02,083736,Patchell; Gregory David,20,0,30,10
1657999259466,MATH 10A,A03,083737,Patchell; Gregory David,16,0,30,14
1657999265489,MATH 10B,A01,083207,Lim; Seonhee,9,0,34,25
1657999265489,MATH 10B,A02,083208,Lim; Seonhee,10,0,35,25
1657999265489,MATH 10B,A03,093472,Lim; Seonhee,7,0,34,27
1657999265489,MATH 10B,B01,083739,Sinha; Shubham,14,0,30,16
1657999271518,MATH 18,A01,083743,Cinel; Cameron Alexander,9,0,30,21
1657999271518,MATH 18,A02,083744,Cinel; Cameron Alexander,18,0,30,12
1657999271518,MATH 18,A03,083745,Cinel; Cameron Alexander,10,0,30,20
1657999271518,MATH 18,B01,083748,Rideout; David Porter,5,0,37,32
1657999271518,MATH 18,B02,083749,Rideout; David Porter,5,0,36,31
1657999271518,MATH 18,B03,083750,Rideout; David Porter,3,0,37,34
1657999271518,MATH 18,B04,083751,Rideout; David Porter,7,0,36,29
1657999271518,MATH 18,B05,093473,Rideout; David Porter,7,0,36,29
1657999271518,MATH 18,B06,093474,Rideout; David Porter,6,0,36,30
1657999277541,MATH 20A,A01,083754,Zheng; Zequn,14,0,40,26
1657999283566,MATH 20B,A01,083756,Briones; Jor-el Thomas Caparas,4,0,36,32
1657999283566,MATH 20B,A02,083757,Briones; Jor-el Thomas Caparas,1,0,36,35
1657999283566,MATH 20B,A03,093475,Briones; Jor-el Thomas Caparas,3,0,36,33
1657999289594,MATH 20C,A01,083760,Briones; Jor-el Thomas Caparas,1,0,35,34
1657999289594,MATH 20C,A02,083761,Briones; Jor-el Thomas Caparas,8,0,35,27
1657999289594,MATH 20C,A03,093476,Briones; Jor-el Thomas Caparas,0,1,36,36
1657999289594,MATH 20C,B01,083762,Bach; Quang Tran,1,0,30,29
1657999295623,MATH 20D,A01,083765,Tran; Brian Kha,5,0,30,25
1657999295623,MATH 20D,A02,083766,Tran; Brian Kha,5,0,30,25
1657999295623,MATH 20D,A03,083767,Tran; Brian Kha,6,0,30,24
1657999301650,MATH 20E,A01,083771,Ganguly; Soumya,12,0,32,20
1657999301650,MATH 20E,A02,083772,Ganguly; Soumya,7,0,32,25
1657999301650,MATH 20E,B01,083773,Ciotti; Benjamin,20,0,35,15
1657999301650,MATH 20E,B02,083774,Ciotti; Benjamin,18,0,35,17
1657999307673,MATH 103A,A01,083777,Greenfeld; Be'Eri,6,0,36,30
1657999307673,MATH 103A,A02,083778,Greenfeld; Be'Eri,5,0,36,31
1657999307673,MATH 103A,A03,093561,Greenfeld; Be'Eri,7,0,36,29
1657999307673,MATH 103A,B01,083779,Greenfeld; Be'Eri,8,0,36,28
1657999307673,MATH 103A,B02,083780,Greenfeld; Be'Eri,4,0,36,32
1657999307673,MATH 103A,B03,093562,Greenfeld; Be'Eri,3,0,36,33
1657999313697,MATH 105,A01,085443,Carter; Anne Toulson,15,0,35,20
1657999313697,MATH 105,A02,093477,Carter; Anne Toulson,20,0,35,15
1657999319724,MATH 109,A01,083213,Ganzberger; Geoffrey Michael,3,0,34,31
1657999319724,MATH 109,A02,083214,Ganzberger; Geoffrey Michael,4,0,34,30
1657999319724,MATH 109,A03,093478,Ganzberger; Geoffrey Michael,2,0,34,32
1657999319724,MATH 109,B01,083215,Ganzberger; Geoffrey Michael,3,0,32,29
1657999319724,MATH 109,B02,083216,Ganzberger; Geoffrey Michael,3,0,32,29
1657999319724,MATH 109,B03,093479,Ganzberger; Geoffrey Michael,8,0,32,24
1657999325755,MATH 142A,A01,083219,Chow; Bennett,7,0,32,25
1657999325755,MATH 142A,A02,083220,Chow; Bennett,10,0,32,22
1657999325755,MATH 142A,A03,093480,Chow; Bennett,9,0,32,23
1657999325755,MATH 142A,B03,093481,Chow; Bennett,8,0,32,24
1657999325755,MATH 142A,B04,093558,Chow; Bennett,14,0,32,18
1657999325755,MATH 142A,B05,093559,Chow; Bennett,7,0,32,25
1657999331782,MATH 193A,A01,083224,Rotar; Vladimir,9,0,34,25
1657999331782,MATH 193A,A02,083225,Rotar; Vladimir,11,0,34,23
1657999331782,MATH 193A,A03,083781,Rotar; Vladimir,5,0,34,29
1657999331782,MATH 193A,A04,083782,Rotar; Vladimir,12,0,34,22
1657999331782,MATH 193A,A05,093482,Rotar; Vladimir,11,0,34,23
1657999337809,MATH 197,001,091859,McAuley; Julian John,9999,0,9999,0
1657999337809,MATH 197,002,095566,Kedlaya; Kiran S.,9997,0,9999,2
1657999337809,MATH 197,003,095567,Xiao; Ming,9999,0,9999,0
1657999337809,MATH 197,004,095571,Perols; Johan Lars,9998,0,9999,1
1657999344875,COGS 9,A01,083615,Shannon; Kyle Michael,11,0,75,64
1657999350901,COGS 11,A01,083617,Boyle; Mary E. T.,23,0,48,25
1657999356923,COGS 13,A01,083071,Bastos; Amalia Pinkusfeld,12,0,71,59
1657999362945,COGS 14A,A01,092681,Semenuks; Arturs,5,1,100,95
1657999368968,COGS 14B,A01,083073,Cheng; Tzu-Han,7,0,63,56
1657999374991,COGS 17,A01,092677,Semenuks; Arturs,7,0,81,74
1657999381015,COGS 100,A01,083619,Allen; Michael Gordon,17,0,70,53
1657999387057,COGS 101A,A01,083621,Davis; Joshua Daniel,9,0,68,59
1657999393084,COGS 101B,A01,091572,Allen; Michael Gordon,14,0,65,51
1657999399106,COGS 101C,A01,083625,Delgado; Tania,17,0,35,18
1657999405133,COGS 107A,A01,083627,Boyle; Mary E. T.,14,0,60,46
1657999411160,COGS 118A,A01,083075,Gupta; Anjum,21,0,76,55
1657999417185,CSE 3,A50,083646,Miranda; Gregory Joseph,24,0,50,26
1657999423210,CSE 8A,A50,083650,Miranda; Gregory Joseph,17,1,56,39
1657999429232,CSE 11,A01,083080,Cao; Yingjun,7,15,40,33
1657999435257,CSE 12,A01,083652,Krause-Levy; Sophia Louisa,30,1,120,90
1657999441280,CSE 15L,A01,083654,Morris; Justin Loren,9,0,50,41
1657999441280,CSE 15L,A02,083655,Morris; Justin Loren,11,0,50,39
1657999447304,CSE 20,A01,083657,Tran; Khoa Dang,39,0,80,41
1657999453330,CSE 21,A01,095574,Bach; Quang Tran,23,0,48,25
1657999459351,CSE 30,A01,083084,Eldon; John,8,0,80,72
1657999459351,CSE 30,B01,095061,Bhaskar; Nishant,9,0,50,41
1657999465374,CSE 100,A01,083659,Cao; Yingjun,5,4,70,65
1657999471399,CSE 134B,A01,083661,Powell; Thomas Allan,25,0,100,75
1657999477421,CSE 140,A01,083663,Gungor; Onat,17,0,85,68
1657999483442,CSE 140L,A01,083088,Eldon; John,23,0,100,77
1657999489465,CSE 175,A01,083665,Kumar; Rakesh,3,0,25,22
1657999495489,CSE 190,A00,092507,Dubnov; Shlomo,8,0,20,12
1657999501516,ECE 45,A01,083139,Congero; Spencer William,7,0,75,68
1657999507543,ECE 65,A50,083695,Saad; Andrew S,12,0,30,18
1657999507543,ECE 65,A51,095125,Saad; Andrew S,24,0,26,2
1657999513567,ECE 109,A01,091882,Touri; Behrouz,21,0,70,49
1657999519589,ECE 180,A00,083140,Abi Samra; Nicholas Camill,1,0,30,29
1657999519589,ECE 180,B00,083141,Abi Samra; Nicholas Camill,0,0,30,30
1657999525613,MATH 10A,A01,083735,Patchell; Gregory David,2,0,30,28
1657999525613,MATH 10A,A02,083736,Patchell; Gregory David,20,0,30,10
1657999525613,MATH 10A,A03,083737,Patchell; Gregory David,16,0,30,14
1657999531644,MATH 10B,A01,083207,Lim; Seonhee,9,0,34,25
1657999531644,MATH 10B,A02,083208,Lim; Seonhee,10,0,35,25
1657999531644,MATH 10B,A03,093472,Lim; Seonhee,7,0,34,27
1657999531644,MATH 10B,B01,083739,Sinha; Shubham,14,0,30,16
1657999537667,MATH 18,A01,083743,Cinel; Cameron Alexander,9,0,30,21
1657999537667,MATH 18,A02,083744,Cinel; Cameron Alexander,18,0,30,12
1657999537667,MATH 18,A03,083745,Cinel; Cameron Alexander,10,0,30,20
1657999537667,MATH 18,B01,083748,Rideout; David Porter,5,0,37,32
1657999537667,MATH 18,B02,083749,Rideout; David Porter,5,0,36,31
1657999537667,MATH 18,B03,083750,Rideout; David Porter,3,0,37,34
1657999537667,MATH 18,B04,083751,Rideout; David Porter,7,0,36,29
1657999537667,MATH 18,B05,093473,Rideout; David Porter,7,0,36,29
1657999537667,MATH 18,B06,093474,Rideout; David Porter,6,0,36,30
1657999543689,MATH 20A,A01,083754,Zheng; Zequn,14,0,40,26
1657999549723,MATH 20B,A01,083756,Briones; Jor-el Thomas Caparas,4,0,36,32
1657999549723,MATH 20B,A02,083757,Briones; Jor-el Thomas Caparas,1,0,36,35
1657999549723,MATH 20B,A03,093475,Briones; Jor-el Thomas Caparas,3,0,36,33
1657999555746,MATH 20C,A01,083760,Briones; Jor-el Thomas Caparas,1,0,35,34
1657999555746,MATH 20C,A02,083761,Briones; Jor-el Thomas Caparas,8,0,35,27
1657999555746,MATH 20C,A03,093476,Briones; Jor-el Thomas Caparas,0,1,36,36
1657999555746,MATH 20C,B01,083762,Bach; Quang Tran,1,0,30,29
1657999561773,MATH 20D,A01,083765,Tran; Brian Kha,5,0,30,25
1657999561773,MATH 20D,A02,083766,Tran; Brian Kha,5,0,30,25
1657999561773,MATH 20D,A03,083767,Tran; Brian Kha,6,0,30,24
1657999567799,MATH 20E,A01,083771,Ganguly; Soumya,12,0,32,20
1657999567799,MATH 20E,A02,083772,Ganguly; Soumya,7,0,32,25
1657999567799,MATH 20E,B01,083773,Ciotti; Benjamin,20,0,35,15
1657999567799,MATH 20E,B02,083774,Ciotti; Benjamin,18,0,35,17
1657999573823,MATH 103A,A01,083777,Greenfeld; Be'Eri,6,0,36,30
1657999573823,MATH 103A,A02,083778,Greenfeld; Be'Eri,5,0,36,31
1657999573823,MATH 103A,A03,093561,Greenfeld; Be'Eri,7,0,36,29
1657999573823,MATH 103A,B01,083779,Greenfeld; Be'Eri,8,0,36,28
1657999573823,MATH 103A,B02,083780,Greenfeld; Be'Eri,4,0,36,32
1657999573823,MATH 103A,B03,093562,Greenfeld; Be'Eri,3,0,36,33
1657999579846,MATH 105,A01,085443,Carter; Anne Toulson,15,0,35,20
1657999579846,MATH 105,A02,093477,Carter; Anne Toulson,20,0,35,15
1657999585871,MATH 109,A01,083213,Ganzberger; Geoffrey Michael,3,0,34,31
1657999585871,MATH 109,A02,083214,Ganzberger; Geoffrey Michael,4,0,34,30
1657999585871,MATH 109,A03,093478,Ganzberger; Geoffrey Michael,2,0,34,32
1657999585871,MATH 109,B01,083215,Ganzberger; Geoffrey Michael,3,0,32,29
1657999585871,MATH 109,B02,083216,Ganzberger; Geoffrey Michael,3,0,32,29
1657999585871,MATH 109,B03,093479,Ganzberger; Geoffrey Michael,8,0,32,24
1657999591899,MATH 142A,A01,083219,Chow; Bennett,7,0,32,25
1657999591899,MATH 142A,A02,083220,Chow; Bennett,10,0,32,22
1657999591899,MATH 142A,A03,093480,Chow; Bennett,9,0,32,23
1657999591899,MATH 142A,B03,093481,Chow; Bennett,8,0,32,24
1657999591899,MATH 142A,B04,093558,Chow; Bennett,14,0,32,18
1657999591899,MATH 142A,B05,093559,Chow; Bennett,7,0,32,25
1657999597921,MATH 193A,A01,083224,Rotar; Vladimir,9,0,34,25
1657999597921,MATH 193A,A02,083225,Rotar; Vladimir,11,0,34,23
1657999597921,MATH 193A,A03,083781,Rotar; Vladimir,5,0,34,29
1657999597921,MATH 193A,A04,083782,Rotar; Vladimir,12,0,34,22
1657999597921,MATH 193A,A05,093482,Rotar; Vladimir,11,0,34,23
1657999603948,MATH 197,001,091859,McAuley; Julian John,9999,0,9999,0
1657999603948,MATH 197,002,095566,Kedlaya; Kiran S.,9997,0,9999,2
1657999603948,MATH 197,003,095567,Xiao; Ming,9999,0,9999,0
1657999603948,MATH 197,004,095571,Perols; Johan Lars,9998,0,9999,1
1657999611017,COGS 9,A01,083615,Shannon; Kyle Michael,11,0,75,64
1657999617039,COGS 11,A01,083617,Boyle; Mary E. T.,23,0,48,25
1657999623060,COGS 13,A01,083071,Bastos; Amalia Pinkusfeld,12,0,71,59
1657999629093,COGS 14A,A01,092681,Semenuks; Arturs,5,1,100,95
1657999635117,COGS 14B,A01,083073,Cheng; Tzu-Han,7,0,63,56
1657999641145,COGS 17,A01,092677,Semenuks; Arturs,7,0,81,74
1657999647169,COGS 100,A01,083619,Allen; Michael Gordon,17,0,70,53
1657999653192,COGS 101A,A01,083621,Davis; Joshua Daniel,9,0,68,59
1657999659215,COGS 101B,A01,091572,Allen; Michael Gordon,14,0,65,51
1657999665238,COGS 101C,A01,083625,Delgado; Tania,17,0,35,18
1657999671263,COGS 107A,A01,083627,Boyle; Mary E. T.,14,0,60,46
1657999677287,COGS 118A,A01,083075,Gupta; Anjum,21,0,76,55
1657999683311,CSE 3,A50,083646,Miranda; Gregory Joseph,24,0,50,26
1657999689333,CSE 8A,A50,083650,Miranda; Gregory Joseph,17,1,56,39
1657999695358,CSE 11,A01,083080,Cao; Yingjun,7,15,40,33
1657999701383,CSE 12,A01,083652,Krause-Levy; Sophia Louisa,30,1,120,90
1657999707405,CSE 15L,A01,083654,Morris; Justin Loren,9,0,50,41
1657999707405,CSE 15L,A02,083655,Morris; Justin Loren,11,0,50,39
1657999713430,CSE 20,A01,083657,Tran; Khoa Dang,39,0,80,41
1657999719452,CSE 21,A01,095574,Bach; Quang Tran,23,0,48,25
1657999725480,CSE 30,A01,083084,Eldon; John,8,0,80,72
1657999725480,CSE 30,B01,095061,Bhaskar; Nishant,9,0,50,41
1657999731506,CSE 100,A01,083659,Cao; Yingjun,5,4,70,65
1657999737529,CSE 134B,A01,083661,Powell; Thomas Allan,25,0,100,75
1657999743551,CSE 140,A01,083663,Gungor; Onat,17,0,85,68
1657999749577,CSE 140L,A01,083088,Eldon; John,23,0,100,77
1657999755605,CSE 175,A01,083665,Kumar; Rakesh,3,0,25,22
1657999761631,CSE 190,A00,092507,Dubnov; Shlomo,8,0,20,12
1657999767653,ECE 45,A01,083139,Congero; Spencer William,7,0,75,68
1657999773681,ECE 65,A50,083695,Saad; Andrew S,12,0,30,18
1657999773681,ECE 65,A51,095125,Saad; Andrew S,24,0,26,2
1657999779708,ECE 109,A01,091882,Touri; Behrouz,21,0,70,49
1657999785732,ECE 180,A00,083140,Abi Samra; Nicholas Camill,1,0,30,29
1657999785732,ECE 180,B00,083141,Abi Samra; Nicholas Camill,0,0,30,30
1657999791755,MATH 10A,A01,083735,Patchell; Gregory David,2,0,30,28
1657999791755,MATH 10A,A02,083736,Patchell; Gregory David,20,0,30,10
1657999791755,MATH 10A,A03,083737,Patchell; Gregory David,16,0,30,14
1657999797780,MATH 10B,A01,083207,Lim; Seonhee,9,0,34,25
1657999797780,MATH 10B,A02,083208,Lim; Seonhee,10,0,35,25
1657999797780,MATH 10B,A03,093472,Lim; Seonhee,7,0,34,27
1657999797780,MATH 10B,B01,083739,Sinha; Shubham,14,0,30,16
1657999803806,MATH 18,A01,083743,Cinel; Cameron Alexander,9,0,30,21
1657999803806,MATH 18,A02,083744,Cinel; Cameron Alexander,18,0,30,12
1657999803806,MATH 18,A03,083745,Cinel; Cameron Alexander,10,0,30,20
1657999803806,MATH 18,B01,083748,Rideout; David Porter,5,0,37,32
1657999803806,MATH 18,B02,083749,Rideout; David Porter,5,0,36,31
1657999803806,MATH 18,B03,083750,Rideout; David Porter,3,0,37,34
1657999803806,MATH 18,B04,083751,Rideout; David Porter,7,0,36,29
1657999803806,MATH 18,B05,093473,Rideout; David Porter,7,0,36,29
1657999803806,MATH 18,B06,093474,Rideout; David Porter,6,0,36,30
1657999809828,MATH 20A,A01,083754,Zheng; Zequn,14,0,40,26
1657999815851,MATH 20B,A01,083756,Briones; Jor-el Thomas Caparas,4,0,36,32
1657999815851,MATH 20B,A02,083757,Briones; Jor-el Thomas Caparas,1,0,36,35
1657999815851,MATH 20B,A03,093475,Briones; Jor-el Thomas Caparas,3,0,36,33
1657999821878,MATH 20C,A01,083760,Briones; Jor-el Thomas Caparas,1,0,35,34
1657999821878,MATH 20C,A02,083761,Briones; Jor-el Thomas Caparas,8,0,35,27
1657999821878,MATH 20C,A03,093476,Briones; Jor-el Thomas Caparas,0,1,36,36
1657999821878,MATH 20C,B01,083762,Bach; Quang Tran,1,0,30,29
1657999827901,MATH 20D,A01,083765,Tran; Brian Kha,5,0,30,25
1657999827901,MATH 20D,A02,083766,Tran; Brian Kha,5,0,30,25
1657999827901,MATH 20D,A03,083767,Tran; Brian Kha,6,0,30,24
1657999833924,MATH 20E,A01,083771,Ganguly; Soumya,12,0,32,20
1657999833924,MATH 20E,A02,083772,Ganguly; Soumya,7,0,32,25
1657999833924,MATH 20E,B01,083773,Ciotti; Benjamin,20,0,35,15
1657999833924,MATH 20E,B02,083774,Ciotti; Benjamin,18,0,35,17
1657999839947,MATH 103A,A01,083777,Greenfeld; Be'Eri,6,0,36,30
1657999839947,MATH 103A,A02,083778,Greenfeld; Be'Eri,5,0,36,31
1657999839947,MATH 103A,A03,093561,Greenfeld; Be'Eri,7,0,36,29
1657999839947,MATH 103A,B01,083779,Greenfeld; Be'Eri,8,0,36,28
1657999839947,MATH 103A,B02,083780,Greenfeld; Be'Eri,4,0,36,32
1657999839947,MATH 103A,B03,093562,Greenfeld; Be'Eri,3,0,36,33
1657999845976,MATH 105,A01,085443,Carter; Anne Toulson,15,0,35,20
1657999845976,MATH 105,A02,093477,Carter; Anne Toulson,20,0,35,15
1657999852100,MATH 109,A01,083213,Ganzberger; Geoffrey Michael,3,0,34,31
1657999852100,MATH 109,A02,083214,Ganzberger; Geoffrey Michael,4,0,34,30
1657999852100,MATH 109,A03,093478,Ganzberger; Geoffrey Michael,2,0,34,32
1657999852100,MATH 109,B01,083215,Ganzberger; Geoffrey Michael,3,0,32,29
1657999852100,MATH 109,B02,083216,Ganzberger; Geoffrey Michael,3,0,32,29
1657999852100,MATH 109,B03,093479,Ganzberger; Geoffrey Michael,8,0,32,24
1657999858123,MATH 142A,A01,083219,Chow; Bennett,7,0,32,25
1657999858123,MATH 142A,A02,083220,Chow; Bennett,10,0,32,22
1657999858123,MATH 142A,A03,093480,Chow; Bennett,9,0,32,23
1657999858123,MATH 142A,B03,093481,Chow; Bennett,8,0,32,24
1657999858123,MATH 142A,B04,093558,Chow; Bennett,14,0,32,18
1657999858123,MATH 142A,B05,093559,Chow; Bennett,7,0,32,25
1657999864147,MATH 193A,A01,083224,Rotar; Vladimir,9,0,34,25
1657999864147,MATH 193A,A02,083225,Rotar; Vladimir,11,0,34,23
1657999864147,MATH 193A,A03,083781,Rotar; Vladimir,5,0,34,29
1657999864147,MATH 193A,A04,083782,Rotar; Vladimir,12,0,34,22
1657999864147,MATH 193A,A05,093482,Rotar; Vladimir,11,0,34,23
1657999870171,MATH 197,001,091859,McAuley; Julian John,9999,0,9999,0
1657999870171,MATH 197,002,095566,Kedlaya; Kiran S.,9997,0,9999,2
1657999870171,MATH 197,003,095567,Xiao; Ming,9999,0,9999,0
1657999870171,MATH 197,004,095571,Perols; Johan Lars,9998,0,9999,1
1657999877235,COGS 9,A01,083615,Shannon; Kyle Michael,11,0,75,64
1657999883269,COGS 11,A01,083617,Boyle; Mary E. T.,23,0,48,25
1657999889292,COGS 13,A01,083071,Bastos; Amalia Pinkusfeld,12,0,71,59
1657999895314,COGS 14A,A01,092681,Semenuks; Arturs,5,1,100,95
1657999901338,COGS 14B,A01,083073,Cheng; Tzu-Han,7,0,63,56
1657999907365,COGS 17,A01,092677,Semenuks; Arturs,7,0,81,74
1657999913393,COGS 100,A01,083619,Allen; Michael Gordon,17,0,70,53
1657999919420,COGS 101A,A01,083621,Davis; Joshua Daniel,9,0,68,59
1657999925447,COGS 101B,A01,091572,Allen; Michael Gordon,14,0,65,51
1657999931470,COGS 101C,A01,083625,Delgado; Tania,17,0,35,18
1657999937495,COGS 107A,A01,083627,Boyle; Mary E. T.,14,0,60,46
1657999943519,COGS 118A,A01,083075,Gupta; Anjum,21,0,76,55
1657999949548,CSE 3,A50,083646,Miranda; Gregory Joseph,24,0,50,26
1657999955570,CSE 8A,A50,083650,Miranda; Gregory Joseph,17,1,56,39
1657999961593,CSE 11,A01,083080,Cao; Yingjun,7,15,40,33
1657999967616,CSE 12,A01,083652,Krause-Levy; Sophia Louisa,30,1,120,90
1657999973644,CSE 15L,A01,083654,Morris; Justin Loren,9,0,50,41
1657999973644,CSE 15L,A02,083655,Morris; Justin Loren,11,0,50,39
1657999979667,CSE 20,A01,083657,Tran; Khoa Dang,39,0,80,41
1657999985690,CSE 21,A01,095574,Bach; Quang Tran,23,0,48,25
1657999991714,CSE 30,A01,083084,Eldon; John,8,0,80,72
1657999991714,CSE 30,B01,095061,Bhaskar; Nishant,9,0,50,41
1657999997737,CSE 100,A01,083659,Cao; Yingjun,5,4,70,65
1658000003762,CSE 134B,A01,083661,Powell; Thomas Allan,25,0,100,75
1658000009788,CSE 140,A01,083663,Gungor; Onat,17,0,85,68
1658000015811,CSE 140L,A01,083088,Eldon; John,23,0,100,77
1658000021833,CSE 175,A01,083665,Kumar; Rakesh,3,0,25,22
1658000027864,CSE 190,A00,092507,Dubnov; Shlomo,8,0,20,12
1658000033892,ECE 45,A01,083139,Congero; Spencer William,7,0,75,68
1658000039916,ECE 65,A50,083695,Saad; Andrew S,12,0,30,18
1658000039916,ECE 65,A51,095125,Saad; Andrew S,24,0,26,2
1658000045939,ECE 109,A01,091882,Touri; Behrouz,21,0,70,49
1658000051962,ECE 180,A00,083140,Abi Samra; Nicholas Camill,1,0,30,29
1658000051962,ECE 180,B00,083141,Abi Samra; Nicholas Camill,0,0,30,30
1658000057992,MATH 10A,A01,083735,Patchell; Gregory David,2,0,30,28
1658000057992,MATH 10A,A02,083736,Patchell; Gregory David,20,0,30,10
1658000057992,MATH 10A,A03,083737,Patchell; Gregory David,16,0,30,14
1658000064021,MATH 10B,A01,083207,Lim; Seonhee,9,0,34,25
1658000064021,MATH 10B,A02,083208,Lim; Seonhee,10,0,35,25
1658000064021,MATH 10B,A03,093472,Lim; Seonhee,7,0,34,27
1658000064021,MATH 10B,B01,083739,Sinha; Shubham,14,0,30,16
1658000070046,MATH 18,A01,083743,Cinel; Cameron Alexander,9,0,30,21
1658000070046,MATH 18,A02,083744,Cinel; Cameron Alexander,18,0,30,12
1658000070046,MATH 18,A03,083745,Cinel; Cameron Alexander,10,0,30,20
1658000070046,MATH 18,B01,083748,Rideout; David Porter,5,0,37,32
1658000070046,MATH 18,B02,083749,Rideout; David Porter,5,0,36,31
1658000070046,MATH 18,B03,083750,Rideout; David Porter,3,0,37,34
1658000070046,MATH 18,B04,083751,Rideout; David Porter,7,0,36,29
1658000070046,MATH 18,B05,093473,Rideout; David Porter,7,0,36,29
1658000070046,MATH 18,B06,093474,Rideout; David Porter,6,0,36,30
1658000076068,MATH 20A,A01,083754,Zheng; Zequn,14,0,40,26
1658000082096,MATH 20B,A01,083756,Briones; Jor-el Thomas Caparas,4,0,36,32
1658000082096,MATH 20B,A02,083757,Briones; Jor-el Thomas Caparas,1,0,36,35
1658000082096,MATH 20B,A03,093475,Briones; Jor-el Thomas Caparas,3,0,36,33
1658000088119,MATH 20C,A01,083760,Briones; Jor-el Thomas Caparas,1,0,35,34
1658000088119,MATH 20C,A02,083761,Briones; Jor-el Thomas Caparas,8,0,35,27
1658000088119,MATH 20C,A03,093476,Briones; Jor-el Thomas Caparas,0,1,36,36
1658000088119,MATH 20C,B01,083762,Bach; Quang Tran,1,0,30,29
1658000094142,MATH 20D,A01,083765,Tran; Brian Kha,5,0,30,25
1658000094142,MATH 20D,A02,083766,Tran; Brian Kha,5,0,30,25
1658000094142,MATH 20D,A03,083767,Tran; Brian Kha,6,0,30,24
1658000100165,MATH 20E,A01,083771,Ganguly; Soumya,12,0,32,20
1658000100165,MATH 20E,A02,083772,Ganguly; Soumya,7,0,32,25
1658000100165,MATH 20E,B01,083773,Ciotti; Benjamin,20,0,35,15
1658000100165,MATH 20E,B02,083774,Ciotti; Benjamin,18,0,35,17
1658000106195,MATH 103A,A01,083777,Greenfeld; Be'Eri,6,0,36,30
1658000106195,MATH 103A,A02,083778,Greenfeld; Be'Eri,5,0,36,31
1658000106195,MATH 103A,A03,093561,Greenfeld; Be'Eri,7,0,36,29
1658000106195,MATH 103A,B01,083779,Greenfeld; Be'Eri,8,0,36,28
1658000106195,MATH 103A,B02,083780,Greenfeld; Be'Eri,4,0,36,32
1658000106195,MATH 103A,B03,093562,Greenfeld; Be'Eri,3,0,36,33
1658000112217,MATH 105,A01,085443,Carter; Anne Toulson,15,0,35,20
1658000112217,MATH 105,A02,093477,Carter; Anne Toulson,20,0,35,15
1658000118240,MATH 109,A01,083213,Ganzberger; Geoffrey Michael,3,0,34,31
1658000118240,MATH 109,A02,083214,Ganzberger; Geoffrey Michael,4,0,34,30
1658000118240,MATH 109,A03,093478,Ganzberger; Geoffrey Michael,2,0,34,32
1658000118240,MATH 109,B01,083215,Ganzberger; Geoffrey Michael,3,0,32,29
1658000118240,MATH 109,B02,083216,Ganzberger; Geoffrey Michael,3,0,32,29
1658000118240,MATH 109,B03,093479,Ganzberger; Geoffrey Michael,8,0,32,24
1658000124269,MATH 142A,A01,083219,Chow; Bennett,7,0,32,25
1658000124269,MATH 142A,A02,083220,Chow; Bennett,10,0,32,22
1658000124269,MATH 142A,A03,093480,Chow; Bennett,9,0,32,23
1658000124269,MATH 142A,B03,093481,Chow; Bennett,8,0,32,24
1658000124269,MATH 142A,B04,093558,Chow; Bennett,14,0,32,18
1658000124269,MATH 142A,B05,093559,Chow; Bennett,7,0,32,25
1658000130301,MATH 193A,A01,083224,Rotar; Vladimir,9,0,34,25
1658000130301,MATH 193A,A02,083225,Rotar; Vladimir,11,0,34,23
1658000130301,MATH 193A,A03,083781,Rotar; Vladimir,5,0,34,29
1658000130301,MATH 193A,A04,083782,Rotar; Vladimir,12,0,34,22
1658000130301,MATH 193A,A05,093482,Rotar; Vladimir,11,0,34,23
1658000136327,MATH 197,001,091859,McAuley; Julian John,9999,0,9999,0
1658000136327,MATH 197,002,095566,Kedlaya; Kiran S.,9997,0,9999,2
1658000136327,MATH 197,003,095567,Xiao; Ming,9999,0,9999,0
1658000136327,MATH 197,004,095571,Perols; Johan Lars,9998,0,9999,1
1658000143391,COGS 9,A01,083615,Shannon; Kyle Michael,11,0,75,64
1658000149413,COGS 11,A01,083617,Boyle; Mary E. T.,23,0,48,25
1658000155435,COGS 13,A01,083071,Bastos; Amalia Pinkusfeld,12,0,71,59
1658000161458,COGS 14A,A01,092681,Semenuks; Arturs,5,1,100,95
1658000167481,COGS 14B,A01,083073,Cheng; Tzu-Han,7,0,63,56
1658000173505,COGS 17,A01,092677,Semenuks; Arturs,7,0,81,74
1658000179526,COGS 100,A01,083619,Allen; Michael Gordon,17,0,70,53
1658000185552,COGS 101A,A01,083621,Davis; Joshua Daniel,9,0,68,59
1658000191579,COGS 101B,A01,091572,Allen; Michael Gordon,14,0,65,51
1658000197601,COGS 101C,A01,083625,Delgado; Tania,17,0,35,18
1658000203623,COGS 107A,A01,083627,Boyle; Mary E. T.,14,0,60,46
1658000209649,COGS 118A,A01,083075,Gupta; Anjum,21,0,76,55
1658000215671,CSE 3,A50,083646,Miranda; Gregory Joseph,24,0,50,26
1658000221693,CSE 8A,A50,083650,Miranda; Gregory Joseph,17,1,56,39
1658000227718,CSE 11,A01,083080,Cao; Yingjun,7,15,40,33
1658000233739,CSE 12,A01,083652,Krause-Levy; Sophia Louisa,30,1,120,90
1658000239763,CSE 15L,A01,083654,Morris; Justin Loren,9,0,50,41
1658000239763,CSE 15L,A02,083655,Morris; Justin Loren,11,0,50,39
1658000245794,CSE 20,A01,083657,Tran; Khoa Dang,39,0,80,41
1658000251820,CSE 21,A01,095574,Bach; Quang Tran,23,0,48,25
1658000257842,CSE 30,A01,083084,Eldon; John,8,0,80,72
1658000257842,CSE 30,B01,095061,Bhaskar; Nishant,9,0,50,41
1658000263867,CSE 100,A01,083659,Cao; Yingjun,5,4,70,65
1658000269891,CSE 134B,A01,083661,Powell; Thomas Allan,25,0,100,75
1658000275912,CSE 140,A01,083663,Gungor; Onat,17,0,85,68
1658000281934,CSE 140L,A01,083088,Eldon; John,23,0,100,77
1658000287958,CSE 175,A01,083665,Kumar; Rakesh,3,0,25,22
1658000293984,CSE 190,A00,092507,Dubnov; Shlomo,8,0,20,12
1658000300009,ECE 45,A01,083139,Congero; Spencer William,7,0,75,68
1658000306031,ECE 65,A50,083695,Saad; Andrew S,12,0,30,18
1658000306031,ECE 65,A51,095125,Saad; Andrew S,24,0,26,2
1658000312052,ECE 109,A01,091882,Touri; Behrouz,21,0,70,49
1658000318077,ECE 180,A00,083140,Abi Samra; Nicholas Camill,1,0,30,29
1658000318077,ECE 180,B00,083141,Abi Samra; Nicholas Camill,0,0,30,30
1658000324110,MATH 10A,A01,083735,Patchell; Gregory David,2,0,30,28
1658000324110,MATH 10A,A02,083736,Patchell; Gregory David,20,0,30,10
1658000324110,MATH 10A,A03,083737,Patchell; Gregory David,16,0,30,14
1658000330133,MATH 10B,A01,083207,Lim; Seonhee,9,0,34,25
1658000330133,MATH 10B,A02,083208,Lim; Seonhee,10,0,35,25
1658000330133,MATH 10B,A03,093472,Lim; Seonhee,7,0,34,27
1658000330133,MATH 10B,B01,083739,Sinha; Shubham,14,0,30,16
1658000336156,MATH 18,A01,083743,Cinel; Cameron Alexander,9,0,30,21
1658000336156,MATH 18,A02,083744,Cinel; Cameron Alexander,18,0,30,12
1658000336156,MATH 18,A03,083745,Cinel; Cameron Alexander,10,0,30,20
1658000336156,MATH 18,B01,083748,Rideout; David Porter,5,0,37,32
1658000336156,MATH 18,B02,083749,Rideout; David Porter,5,0,36,31
1658000336156,MATH 18,B03,083750,Rideout; David Porter,3,0,37,34
1658000336156,MATH 18,B04,083751,Rideout; David Porter,7,0,36,29
1658000336156,MATH 18,B05,093473,Rideout; David Porter,7,0,36,29
1658000336156,MATH 18,B06,093474,Rideout; David Porter,6,0,36,30
1658000342182,MATH 20A,A01,083754,Zheng; Zequn,14,0,40,26
1658000348205,MATH 20B,A01,083756,Briones; Jor-el Thomas Caparas,4,0,36,32
1658000348205,MATH 20B,A02,083757,Briones; Jor-el Thomas Caparas,1,0,36,35
1658000348205,MATH 20B,A03,093475,Briones; Jor-el Thomas Caparas,3,0,36,33
1658000354227,MATH 20C,A01,083760,Briones; Jor-el Thomas Caparas,1,0,35,34
1658000354227,MATH 20C,A02,083761,Briones; Jor-el Thomas Caparas,8,0,35,27
1658000354227,MATH 20C,A03,093476,Briones; Jor-el Thomas Caparas,0,1,36,36
1658000354227,MATH 20C,B01,083762,Bach; Quang Tran,1,0,30,29
1658000360249,MATH 20D,A01,083765,Tran; Brian Kha,5,0,30,25
1658000360249,MATH 20D,A02,083766,Tran; Brian Kha,5,0,30,25
1658000360249,MATH 20D,A03,083767,Tran; Brian Kha,6,0,30,24
1658000366276,MATH 20E,A01,083771,Ganguly; Soumya,12,0,32,20
1658000366276,MATH 20E,A02,083772,Ganguly; Soumya,7,0,32,25
1658000366276,MATH 20E,B01,083773,Ciotti; Benjamin,20,0,35,15
1658000366276,MATH 20E,B02,083774,Ciotti; Benjamin,18,0,35,17
1658000372300,MATH 103A,A01,083777,Greenfeld; Be'Eri,6,0,36,30
1658000372300,MATH 103A,A02,083778,Greenfeld; Be'Eri,5,0,36,31
1658000372300,MATH 103A,A03,093561,Greenfeld; Be'Eri,7,0,36,29
1658000372300,MATH 103A,B01,083779,Greenfeld; Be'Eri,8,0,36,28
1658000372300,MATH 103A,B02,083780,Greenfeld; Be'Eri,4,0,36,32
1658000372300,MATH 103A,B03,093562,Greenfeld; Be'Eri,3,0,36,33
1658000378321,MATH 105,A01,085443,Carter; Anne Toulson,15,0,35,20
1658000378321,MATH 105,A02,093477,Carter; Anne Toulson,20,0,35,15
1658000384344,MATH 109,A01,083213,Ganzberger; Geoffrey Michael,3,0,34,31
1658000384344,MATH 109,A02,083214,Ganzberger; Geoffrey Michael,4,0,34,30
1658000384344,MATH 109,A03,093478,Ganzberger; Geoffrey Michael,2,0,34,32
1658000384344,MATH 109,B01,083215,Ganzberger; Geoffrey Michael,3,0,32,29
1658000384344,MATH 109,B02,083216,Ganzberger; Geoffrey Michael,3,0,32,29
1658000384344,MATH 109,B03,093479,Ganzberger; Geoffrey Michael,8,0,32,24
1658000390374,MATH 142A,A01,083219,Chow; Bennett,7,0,32,25
1658000390374,MATH 142A,A02,083220,Chow; Bennett,10,0,32,22
1658000390374,MATH 142A,A03,093480,Chow; Bennett,9,0,32,23
1658000390374,MATH 142A,B03,093481,Chow; Bennett,8,0,32,24
1658000390374,MATH 142A,B04,093558,Chow; Bennett,14,0,32,18
1658000390374,MATH 142A,B05,093559,Chow; Bennett,7,0,32,25
1658000396401,MATH 193A,A01,083224,Rotar; Vladimir,9,0,34,25
1658000396401,MATH 193A,A02,083225,Rotar; Vladimir,11,0,34,23
1658000396401,MATH 193A,A03,083781,Rotar; Vladimir,5,0,34,29
1658000396401,MATH 193A,A04,083782,Rotar; Vladimir,12,0,34,22
1658000396401,MATH 193A,A05,093482,Rotar; Vladimir,11,0,34,23
1658000402424,MATH 197,001,091859,McAuley; Julian John,9999,0,9999,0
1658000402424,MATH 197,002,095566,Kedlaya; Kiran S.,9997,0,9999,2
1658000402424,MATH 197,003,095567,Xiao; Ming,9999,0,9999,0
1658000402424,MATH 197,004,095571,Perols; Johan Lars,9998,0,9999,1
1658000409478,COGS 9,A01,083615,Shannon; Kyle Michael,11,0,75,64
1658000415503,COGS 11,A01,083617,Boyle; Mary E. T.,23,0,48,25
1658000421525,COGS 13,A01,083071,Bastos; Amalia Pinkusfeld,12,0,71,59
1658000427549,COGS 14A,A01,092681,Semenuks; Arturs,5,1,100,95
1658000433573,COGS 14B,A01,083073,Cheng; Tzu-Han,7,0,63,56
1658000439604,COGS 17,A01,092677,Semenuks; Arturs,7,0,81,74
1658000445707,COGS 100,A01,083619,Allen; Michael Gordon,17,0,70,53
1658000451733,COGS 101A,A01,083621,Davis; Joshua Daniel,9,0,68,59
1658000457757,COGS 101B,A01,091572,Allen; Michael Gordon,14,0,65,51
1658000463784,COGS 101C,A01,083625,Delgado; Tania,17,0,35,18
1658000469806,COGS 107A,A01,083627,Boyle; Mary E. T.,14,0,60,46
1658000475832,COGS 118A,A01,083075,Gupta; Anjum,21,0,76,55
1658000481860,CSE 3,A50,083646,Miranda; Gregory Joseph,24,0,50,26
1658000487882,CSE 8A,A50,083650,Miranda; Gregory Joseph,17,1,56,39
1658000493904,CSE 11,A01,083080,Cao; Yingjun,7,15,40,33
1658000499932,CSE 12,A01,083652,Krause-Levy; Sophia Louisa,30,1,120,90
1658000505958,CSE 15L,A01,083654,Morris; Justin Loren,9,0,50,41
1658000505958,CSE 15L,A02,083655,Morris; Justin Loren,11,0,50,39
1658000511980,CSE 20,A01,083657,Tran; Khoa Dang,39,0,80,41
1658000518003,CSE 21,A01,095574,Bach; Quang Tran,23,0,48,25
1658000524025,CSE 30,A01,083084,Eldon; John,8,0,80,72
1658000524025,CSE 30,B01,095061,Bhaskar; Nishant,9,0,50,41
1658000530047,CSE 100,A01,083659,Cao; Yingjun,5,4,70,65
1658000536071,CSE 134B,A01,083661,Powell; Thomas Allan,25,0,100,75
1658000542094,CSE 140,A01,083663,Gungor; Onat,17,0,85,68
1658000548117,CSE 140L,A01,083088,Eldon; John,23,0,100,77
1658000554143,CSE 175,A01,083665,Kumar; Rakesh,3,0,25,22
1658000560173,CSE 190,A00,092507,Dubnov; Shlomo,8,0,20,12
1658000566199,ECE 45,A01,083139,Congero; Spencer William,7,0,75,68
1658000572220,ECE 65,A50,083695,Saad; Andrew S,12,0,30,18
1658000572220,ECE 65,A51,095125,Saad; Andrew S,24,0,26,2
1658000578242,ECE 109,A01,091882,Touri; Behrouz,21,0,70,49
1658000584266,ECE 180,A00,083140,Abi Samra; Nicholas Camill,1,0,30,29
1658000584266,ECE 180,B00,083141,Abi Samra; Nicholas Camill,0,0,30,30
1658000590290,MATH 10A,A01,083735,Patchell; Gregory David,2,0,30,28
1658000590290,MATH 10A,A02,083736,Patchell; Gregory David,20,0,30,10
1658000590290,MATH 10A,A03,083737,Patchell; Gregory David,16,0,30,14
1658000596313,MATH 10B,A01,083207,Lim; Seonhee,9,0,34,25
1658000596313,MATH 10B,A02,083208,Lim; Seonhee,10,0,35,25
1658000596313,MATH 10B,A03,093472,Lim; Seonhee,7,0,34,27
1658000596313,MATH 10B,B01,083739,Sinha; Shubham,14,0,30,16
1658000602338,MATH 18,A01,083743,Cinel; Cameron Alexander,9,0,30,21
1658000602338,MATH 18,A02,083744,Cinel; Cameron Alexander,18,0,30,12
1658000602338,MATH 18,A03,083745,Cinel; Cameron Alexander,10,0,30,20
1658000602338,MATH 18,B01,083748,Rideout; David Porter,5,0,37,32
1658000602338,MATH 18,B02,083749,Rideout; David Porter,5,0,36,31
1658000602338,MATH 18,B03,083750,Rideout; David Porter,3,0,37,34
1658000602338,MATH 18,B04,083751,Rideout; David Porter,7,0,36,29
1658000602338,MATH 18,B05,093473,Rideout; David Porter,7,0,36,29
1658000602338,MATH 18,B06,093474,Rideout; David Porter,6,0,36,30
1658000608365,MATH 20A,A01,083754,Zheng; Zequn,14,0,40,26
1658000614391,MATH 20B,A01,083756,Briones; Jor-el Thomas Caparas,4,0,36,32
1658000614391,MATH 20B,A02,083757,Briones; Jor-el Thomas Caparas,1,0,36,35
1658000614391,MATH 20B,A03,093475,Briones; Jor-el Thomas Caparas,3,0,36,33
1658000620420,MATH 20C,A01,083760,Briones; Jor-el Thomas Caparas,1,0,35,34
1658000620420,MATH 20C,A02,083761,Briones; Jor-el Thomas Caparas,8,0,35,27
1658000620420,MATH 20C,A03,093476,Briones; Jor-el Thomas Caparas,0,1,36,36
1658000620420,MATH 20C,B01,083762,Bach; Quang Tran,1,0,30,29
1658000626447,MATH 20D,A01,083765,Tran; Brian Kha,5,0,30,25
1658000626447,MATH 20D,A02,083766,Tran; Brian Kha,5,0,30,25
1658000626447,MATH 20D,A03,083767,Tran; Brian Kha,6,0,30,24
1658000632469,MATH 20E,A01,083771,Ganguly; Soumya,12,0,32,20
1658000632469,MATH 20E,A02,083772,Ganguly; Soumya,7,0,32,25
1658000632469,MATH 20E,B01,083773,Ciotti; Benjamin,20,0,35,15
1658000632469,MATH 20E,B02,083774,Ciotti; Benjamin,18,0,35,17
1658000638499,MATH 103A,A01,083777,Greenfeld; Be'Eri,6,0,36,30
1658000638499,MATH 103A,A02,083778,Greenfeld; Be'Eri,5,0,36,31
1658000638499,MATH 103A,A03,093561,Greenfeld; Be'Eri,7,0,36,29
1658000638499,MATH 103A,B01,083779,Greenfeld; Be'Eri,8,0,36,28
1658000638499,MATH 103A,B02,083780,Greenfeld; Be'Eri,4,0,36,32
1658000638499,MATH 103A,B03,093562,Greenfeld; Be'Eri,3,0,36,33
1658000644522,MATH 105,A01,085443,Carter; Anne Toulson,15,0,35,20
1658000644522,MATH 105,A02,093477,Carter; Anne Toulson,20,0,35,15
1658000650544,MATH 109,A01,083213,Ganzberger; Geoffrey Michael,3,0,34,31
1658000650544,MATH 109,A02,083214,Ganzberger; Geoffrey Michael,4,0,34,30
1658000650544,MATH 109,A03,093478,Ganzberger; Geoffrey Michael,2,0,34,32
1658000650544,MATH 109,B01,083215,Ganzberger; Geoffrey Michael,3,0,32,29
1658000650544,MATH 109,B02,083216,Ganzberger; Geoffrey Michael,3,0,32,29
1658000650544,MATH 109,B03,093479,Ganzberger; Geoffrey Michael,8,0,32,24
1658000656570,MATH 142A,A01,083219,Chow; Bennett,7,0,32,25
1658000656570,MATH 142A,A02,083220,Chow; Bennett,10,0,32,22
1658000656570,MATH 142A,A03,093480,Chow; Bennett,9,0,32,23
1658000656570,MATH 142A,B03,093481,Chow; Bennett,8,0,32,24
1658000656570,MATH 142A,B04,093558,Chow; Bennett,14,0,32,18
1658000656570,MATH 142A,B05,093559,Chow; Bennett,7,0,32,25
1658000662596,MATH 193A,A01,083224,Rotar; Vladimir,9,0,34,25
1658000662596,MATH 193A,A02,083225,Rotar; Vladimir,11,0,34,23
1658000662596,MATH 193A,A03,083781,Rotar; Vladimir,5,0,34,29
1658000662596,MATH 193A,A04,083782,Rotar; Vladimir,12,0,34,22
1658000662596,MATH 193A,A05,093482,Rotar; Vladimir,11,0,34,23
1658000668621,MATH 197,001,091859,McAuley; Julian John,9999,0,9999,0
1658000668621,MATH 197,002,095566,Kedlaya; Kiran S.,9997,0,9999,2
1658000668621,MATH 197,003,095567,Xiao; Ming,9999,0,9999,0
1658000668621,MATH 197,004,095571,Perols; Johan Lars,9998,0,9999,1
1658000675677,COGS 9,A01,083615,Shannon; Kyle Michael,11,0,75,64
1658000681703,COGS 11,A01,083617,Boyle; Mary E. T.,23,0,48,25
1658000687729,COGS 13,A01,083071,Bastos; Amalia Pinkusfeld,12,0,71,59
1658000693757,COGS 14A,A01,092681,Semenuks; Arturs,5,1,100,95
1658000699780,COGS 14B,A01,083073,Cheng; Tzu-Han,7,0,63,56
1658000705802,COGS 17,A01,092677,Semenuks; Arturs,7,0,81,74
1658000711828,COGS 100,A01,083619,Allen; Michael Gordon,17,0,70,53
1658000717852,COGS 101A,A01,083621,Davis; Joshua Daniel,9,0,68,59
1658000723879,COGS 101B,A01,091572,Allen; Michael Gordon,14,0,65,51
1658000729905,COGS 101C,A01,083625,Delgado; Tania,17,0,35,18
1658000735928,COGS 107A,A01,083627,Boyle; Mary E. T.,14,0,60,46
1658000741949,COGS 118A,A01,083075,Gupta; Anjum,21,0,76,55
1658000747977,CSE 3,A50,083646,Miranda; Gregory Joseph,24,0,50,26
1658000754004,CSE 8A,A50,083650,Miranda; Gregory Joseph,17,1,56,39
1658000760027,CSE 11,A01,083080,Cao; Yingjun,7,15,40,33
1658000766057,CSE 12,A01,083652,Krause-Levy; Sophia Louisa,30,1,120,90
1658000772080,CSE 15L,A01,083654,Morris; Justin Loren,9,0,50,41
1658000772080,CSE 15L,A02,083655,Morris; Justin Loren,11,0,50,39
1658000778106,CSE 20,A01,083657,Tran; Khoa Dang,39,0,80,41
1658000784135,CSE 21,A01,095574,Bach; Quang Tran,23,0,48,25
1658000790162,CSE 30,A01,083084,Eldon; John,8,0,80,72
1658000790162,CSE 30,B01,095061,Bhaskar; Nishant,9,0,50,41
1658000796186,CSE 100,A01,083659,Cao; Yingjun,5,4,70,65
1658000802211,CSE 134B,A01,083661,Powell; Thomas Allan,25,0,100,75
1658000808237,CSE 140,A01,083663,Gungor; Onat,17,0,85,68
1658000814271,CSE 140L,A01,083088,Eldon; John,23,0,100,77
1658000820294,CSE 175,A01,083665,Kumar; Rakesh,3,0,25,22
1658000826316,CSE 190,A00,092507,Dubnov; Shlomo,8,0,20,12
1658000832343,ECE 45,A01,083139,Congero; Spencer William,7,0,75,68
1658000838376,ECE 65,A50,083695,Saad; Andrew S,12,0,30,18
1658000838376,ECE 65,A51,095125,Saad; Andrew S,24,0,26,2
1658000844402,ECE 109,A01,091882,Touri; Behrouz,21,0,70,49
1658000850427,ECE 180,A00,083140,Abi Samra; Nicholas Camill,1,0,30,29
1658000850427,ECE 180,B00,083141,Abi Samra; Nicholas Camill,0,0,30,30
1658000856450,MATH 10A,A01,083735,Patchell; Gregory David,2,0,30,28
1658000856450,MATH 10A,A02,083736,Patchell; Gregory David,20,0,30,10
1658000856450,MATH 10A,A03,083737,Patchell; Gregory David,16,0,30,14
1658000862478,MATH 10B,A01,083207,Lim; Seonhee,9,0,34,25
1658000862478,MATH 10B,A02,083208,Lim; Seonhee,10,0,35,25
1658000862478,MATH 10B,A03,093472,Lim; Seonhee,7,0,34,27
1658000862478,MATH 10B,B01,083739,Sinha; Shubham,14,0,30,16
1658000868508,MATH 18,A01,083743,Cinel; Cameron Alexander,9,0,30,21
1658000868508,MATH 18,A02,083744,Cinel; Cameron Alexander,18,0,30,12
1658000868508,MATH 18,A03,083745,Cinel; Cameron Alexander,10,0,30,20
1658000868508,MATH 18,B01,083748,Rideout; David Porter,5,0,37,32
1658000868508,MATH 18,B02,083749,Rideout; David Porter,5,0,36,31
1658000868508,MATH 18,B03,083750,Rideout; David Porter,3,0,37,34
1658000868508,MATH 18,B04,083751,Rideout; David Porter,7,0,36,29
1658000868508,MATH 18,B05,093473,Rideout; David Porter,7,0,36,29
1658000868508,MATH 18,B06,093474,Rideout; David Porter,6,0,36,30
1658000874539,MATH 20A,A01,083754,Zheng; Zequn,14,0,40,26
1658000880567,MATH 20B,A01,083756,Briones; Jor-el Thomas Caparas,4,0,36,32
1658000880567,MATH 20B,A02,083757,Briones; Jor-el Thomas Caparas,1,0,36,35
1658000880567,MATH 20B,A03,093475,Briones; Jor-el Thomas Caparas,3,0,36,33
1658000886589,MATH 20C,A01,083760,Briones; Jor-el Thomas Caparas,1,0,35,34
1658000886589,MATH 20C,A02,083761,Briones; Jor-el Thomas Caparas,8,0,35,27
1658000886589,MATH 20C,A03,093476,Briones; Jor-el Thomas Caparas,0,1,36,36
1658000886589,MATH 20C,B01,083762,Bach; Quang Tran,1,0,30,29
1658000892617,MATH 20D,A01,083765,Tran; Brian Kha,5,0,30,25
1658000892617,MATH 20D,A02,083766,Tran; Brian Kha,5,0,30,25
1658000892617,MATH 20D,A03,083767,Tran; Brian Kha,6,0,30,24
1658000898650,MATH 20E,A01,083771,Ganguly; Soumya,12,0,32,20
1658000898650,MATH 20E,A02,083772,Ganguly; Soumya,7,0,32,25
1658000898650,MATH 20E,B01,083773,Ciotti; Benjamin,20,0,35,15
1658000898650,MATH 20E,B02,083774,Ciotti; Benjamin,18,0,35,17
1658000904676,MATH 103A,A01,083777,Greenfeld; Be'Eri,6,0,36,30
1658000904676,MATH 103A,A02,083778,Greenfeld; Be'Eri,5,0,36,31
1658000904676,MATH 103A,A03,093561,Greenfeld; Be'Eri,7,0,36,29
1658000904676,MATH 103A,B01,083779,Greenfeld; Be'Eri,8,0,36,28
1658000904676,MATH 103A,B02,083780,Greenfeld; Be'Eri,4,0,36,32
1658000904676,MATH 103A,B03,093562,Greenfeld; Be'Eri,3,0,36,33
1658000910703,MATH 105,A01,085443,Carter; Anne Toulson,15,0,35,20
1658000910703,MATH 105,A02,093477,Carter; Anne Toulson,20,0,35,15
1658000916730,MATH 109,A01,083213,Ganzberger; Geoffrey Michael,3,0,34,31
1658000916730,MATH 109,A02,083214,Ganzberger; Geoffrey Michael,4,0,34,30
1658000916730,MATH 109,A03,093478,Ganzberger; Geoffrey Michael,2,0,34,32
1658000916730,MATH 109,B01,083215,Ganzberger; Geoffrey Michael,3,0,32,29
1658000916730,MATH 109,B02,083216,Ganzberger; Geoffrey Michael,3,0,32,29
1658000916730,MATH 109,B03,093479,Ganzberger; Geoffrey Michael,8,0,32,24
1658000922758,MATH 142A,A01,083219,Chow; Bennett,7,0,32,25
1658000922758,MATH 142A,A02,083220,Chow; Bennett,10,0,32,22
1658000922758,MATH 142A,A03,093480,Chow; Bennett,9,0,32,23
1658000922758,MATH 142A,B03,093481,Chow; Bennett,8,0,32,24
1658000922758,MATH 142A,B04,093558,Chow; Bennett,14,0,32,18
1658000922758,MATH 142A,B05,093559,Chow; Bennett,7,0,32,25
1658000928786,MATH 193A,A01,083224,Rotar; Vladimir,9,0,34,25
1658000928786,MATH 193A,A02,083225,Rotar; Vladimir,11,0,34,23
1658000928786,MATH 193A,A03,083781,Rotar; Vladimir,5,0,34,29
1658000928786,MATH 193A,A04,083782,Rotar; Vladimir,12,0,34,22
1658000928786,MATH 193A,A05,093482,Rotar; Vladimir,11,0,34,23
1658000934812,MATH 197,001,091859,McAuley; Julian John,9999,0,9999,0
1658000934812,MATH 197,002,095566,Kedlaya; Kiran S.,9997,0,9999,2
1658000934812,MATH 197,003,095567,Xiao; Ming,9999,0,9999,0
1658000934812,MATH 197,004,095571,Perols; Johan Lars,9998,0,9999,1
1658000941877,COGS 9,A01,083615,Shannon; Kyle Michael,11,0,75,64
1658000947901,COGS 11,A01,083617,Boyle; Mary E. T.,23,0,48,25
1658000953923,COGS 13,A01,083071,Bastos; Amalia Pinkusfeld,12,0,71,59
1658000959947,COGS 14A,A01,092681,Semenuks; Arturs,5,1,100,95
1658000965971,COGS 14B,A01,083073,Cheng; Tzu-Han,7,0,63,56
1658000971994,COGS 17,A01,092677,Semenuks; Arturs,7,0,81,74
1658000978028,COGS 100,A01,083619,Allen; Michael Gordon,17,0,70,53
1658000984055,COGS 101A,A01,083621,Davis; Joshua Daniel,9,0,68,59
1658000990077,COGS 101B,A01,091572,Allen; Michael Gordon,14,0,65,51
1658000996100,COGS 101C,A01,083625,Delgado; Tania,17,0,35,18
1658001002123,COGS 107A,A01,083627,Boyle; Mary E. T.,14,0,60,46
1658001008145,COGS 118A,A01,083075,Gupta; Anjum,21,0,76,55
1658001014167,CSE 3,A50,083646,Miranda; Gregory Joseph,24,0,50,26
1658001020195,CSE 8A,A50,083650,Miranda; Gregory Joseph,17,1,56,39
1658001026222,CSE 11,A01,083080,Cao; Yingjun,7,15,40,33
1658001032245,CSE 12,A01,083652,Krause-Levy; Sophia Louisa,30,1,120,90
1658001038268,CSE 15L,A01,083654,Morris; Justin Loren,9,0,50,41
1658001038268,CSE 15L,A02,083655,Morris; Justin Loren,11,0,50,39
1658001044363,CSE 20,A01,083657,Tran; Khoa Dang,39,0,80,41
1658001050390,CSE 21,A01,095574,Bach; Quang Tran,23,0,48,25
1658001056414,CSE 30,A01,083084,Eldon; John,8,0,80,72
1658001056414,CSE 30,B01,095061,Bhaskar; Nishant,9,0,50,41
1658001062437,CSE 100,A01,083659,Cao; Yingjun,5,4,70,65
1658001068459,CSE 134B,A01,083661,Powell; Thomas Allan,25,0,100,75
1658001074484,CSE 140,A01,083663,Gungor; Onat,17,0,85,68
1658001080510,CSE 140L,A01,083088,Eldon; John,23,0,100,77
1658001086536,CSE 175,A01,083665,Kumar; Rakesh,3,0,25,22
1658001092562,CSE 190,A00,092507,Dubnov; Shlomo,8,0,20,12
1658001098585,ECE 45,A01,083139,Congero; Spencer William,7,0,75,68
1658001104608,ECE 65,A50,083695,Saad; Andrew S,12,0,30,18
1658001104608,ECE 65,A51,095125,Saad; Andrew S,24,0,26,2
1658001110636,ECE 109,A01,091882,Touri; Behrouz,21,0,70,49
1658001116662,ECE 180,A00,083140,Abi Samra; Nicholas Camill,1,0,30,29
1658001116662,ECE 180,B00,083141,Abi Samra; Nicholas Camill,0,0,30,30
1658001122686,MATH 10A,A01,083735,Patchell; Gregory David,2,0,30,28
1658001122686,MATH 10A,A02,083736,Patchell; Gregory David,20,0,30,10
1658001122686,MATH 10A,A03,083737,Patchell; Gregory David,16,0,30,14
1658001128715,MATH 10B,A01,083207,Lim; Seonhee,9,0,34,25
1658001128715,MATH 10B,A02,083208,Lim; Seonhee,10,0,35,25
1658001128715,MATH 10B,A03,093472,Lim; Seonhee,7,0,34,27
1658001128715,MATH 10B,B01,083739,Sinha; Shubham,14,0,30,16
1658001134747,MATH 18,A01,083743,Cinel; Cameron Alexander,9,0,30,21
1658001134747,MATH 18,A02,083744,Cinel; Cameron Alexander,18,0,30,12
1658001134747,MATH 18,A03,083745,Cinel; Cameron Alexander,10,0,30,20
1658001134747,MATH 18,B01,083748,Rideout; David Porter,5,0,37,32
1658001134747,MATH 18,B02,083749,Rideout; David Porter,5,0,36,31
1658001134747,MATH 18,B03,083750,Rideout; David Porter,3,0,37,34
1658001134747,MATH 18,B04,083751,Rideout; David Porter,7,0,36,29
1658001134747,MATH 18,B05,093473,Rideout; David Porter,7,0,36,29
1658001134747,MATH 18,B06,093474,Rideout; David Porter,6,0,36,30
1658001140772,MATH 20A,A01,083754,Zheng; Zequn,14,0,40,26
1658001146796,MATH 20B,A01,083756,Briones; Jor-el Thomas Caparas,4,0,36,32
1658001146796,MATH 20B,A02,083757,Briones; Jor-el Thomas Caparas,1,0,36,35
1658001146796,MATH 20B,A03,093475,Briones; Jor-el Thomas Caparas,3,0,36,33
1658001152838,MATH 20C,A01,083760,Briones; Jor-el Thomas Caparas,1,0,35,34
1658001152838,MATH 20C,A02,083761,Briones; Jor-el Thomas Caparas,8,0,35,27
1658001152838,MATH 20C,A03,093476,Briones; Jor-el Thomas Caparas,0,1,36,36
1658001152838,MATH 20C,B01,083762,Bach; Quang Tran,1,0,30,29
1658001158867,MATH 20D,A01,083765,Tran; Brian Kha,5,0,30,25
1658001158867,MATH 20D,A02,083766,Tran; Brian Kha,5,0,30,25
1658001158867,MATH 20D,A03,083767,Tran; Brian Kha,6,0,30,24
1658001164894,MATH 20E,A01,083771,Ganguly; Soumya,12,0,32,20
1658001164894,MATH 20E,A02,083772,Ganguly; Soumya,7,0,32,25
1658001164894,MATH 20E,B01,083773,Ciotti; Benjamin,20,0,35,15
1658001164894,MATH 20E,B02,083774,Ciotti; Benjamin,18,0,35,17
1658001170925,MATH 103A,A01,083777,Greenfeld; Be'Eri,6,0,36,30
1658001170925,MATH 103A,A02,083778,Greenfeld; Be'Eri,5,0,36,31
1658001170925,MATH 103A,A03,093561,Greenfeld; Be'Eri,7,0,36,29
1658001170925,MATH 103A,B01,083779,Greenfeld; Be'Eri,8,0,36,28
1658001170925,MATH 103A,B02,083780,Greenfeld; Be'Eri,4,0,36,32
1658001170925,MATH 103A,B03,093562,Greenfeld; Be'Eri,3,0,36,33
1658001176953,MATH 105,A01,085443,Carter; Anne Toulson,15,0,35,20
1658001176953,MATH 105,A02,093477,Carter; Anne Toulson,20,0,35,15
1658001182983,MATH 109,A01,083213,Ganzberger; Geoffrey Michael,3,0,34,31
1658001182983,MATH 109,A02,083214,Ganzberger; Geoffrey Michael,4,0,34,30
1658001182983,MATH 109,A03,093478,Ganzberger; Geoffrey Michael,2,0,34,32
1658001182983,MATH 109,B01,083215,Ganzberger; Geoffrey Michael,3,0,32,29
1658001182983,MATH 109,B02,083216,Ganzberger; Geoffrey Michael,3,0,32,29
1658001182983,MATH 109,B03,093479,Ganzberger; Geoffrey Michael,8,0,32,24
1658001189006,MATH 142A,A01,083219,Chow; Bennett,7,0,32,25
1658001189006,MATH 142A,A02,083220,Chow; Bennett,10,0,32,22
1658001189006,MATH 142A,A03,093480,Chow; Bennett,9,0,32,23
1658001189006,MATH 142A,B03,093481,Chow; Bennett,8,0,32,24
1658001189006,MATH 142A,B04,093558,Chow; Bennett,14,0,32,18
1658001189006,MATH 142A,B05,093559,Chow; Bennett,7,0,32,25
1658001195032,MATH 193A,A01,083224,Rotar; Vladimir,9,0,34,25
1658001195032,MATH 193A,A02,083225,Rotar; Vladimir,11,0,34,23
1658001195032,MATH 193A,A03,083781,Rotar; Vladimir,5,0,34,29
1658001195032,MATH 193A,A04,083782,Rotar; Vladimir,12,0,34,22
1658001195032,MATH 193A,A05,093482,Rotar; Vladimir,11,0,34,23
1658001201058,MATH 197,001,091859,McAuley; Julian John,9999,0,9999,0
1658001201058,MATH 197,002,095566,Kedlaya; Kiran S.,9997,0,9999,2
1658001201058,MATH 197,003,095567,Xiao; Ming,9999,0,9999,0
1658001201058,MATH 197,004,095571,Perols; Johan Lars,9998,0,9999,1
1658001208118,COGS 9,A01,083615,Shannon; Kyle Michael,11,0,75,64
1658001214142,COGS 11,A01,083617,Boyle; Mary E. T.,23,0,48,25
1658001220169,COGS 13,A01,083071,Bastos; Amalia Pinkusfeld,12,0,71,59
1658001226194,COGS 14A,A01,092681,Semenuks; Arturs,5,1,100,95
1658001232217,COGS 14B,A01,083073,Cheng; Tzu-Han,7,0,63,56
1658001238244,COGS 17,A01,092677,Semenuks; Arturs,7,0,81,74
1658001244269,COGS 100,A01,083619,Allen; Michael Gordon,17,0,70,53
1658001250295,COGS 101A,A01,083621,Davis; Joshua Daniel,9,0,68,59
1658001256321,COGS 101B,A01,091572,Allen; Michael Gordon,14,0,65,51
1658001262351,COGS 101C,A01,083625,Delgado; Tania,17,0,35,18
1658001268373,COGS 107A,A01,083627,Boyle; Mary E. T.,14,0,60,46
1658001274399,COGS 118A,A01,083075,Gupta; Anjum,21,0,76,55
1658001280426,CSE 3,A50,083646,Miranda; Gregory Joseph,24,0,50,26
1658001286453,CSE 8A,A50,083650,Miranda; Gregory Joseph,17,1,56,39
1658001292477,CSE 11,A01,083080,Cao; Yingjun,7,15,40,33
1658001298499,CSE 12,A01,083652,Krause-Levy; Sophia Louisa,30,1,120,90
1658001304524,CSE 15L,A01,083654,Morris; Justin Loren,9,0,50,41
1658001304524,CSE 15L,A02,083655,Morris; Justin Loren,11,0,50,39
1658001310547,CSE 20,A01,083657,Tran; Khoa Dang,39,0,80,41
1658001316570,CSE 21,A01,095574,Bach; Quang Tran,23,0,48,25
1658001322595,CSE 30,A01,083084,Eldon; John,8,0,80,72
1658001322595,CSE 30,B01,095061,Bhaskar; Nishant,9,0,50,41
1658001328617,CSE 100,A01,083659,Cao; Yingjun,5,4,70,65
1658001334642,CSE 134B,A01,083661,Powell; Thomas Allan,25,0,100,75
1658001340665,CSE 140,A01,083663,Gungor; Onat,17,0,85,68
1658001346687,CSE 140L,A01,083088,Eldon; John,23,0,100,77
1658001352717,CSE 175,A01,083665,Kumar; Rakesh,3,0,25,22
1658001358739,CSE 190,A00,092507,Dubnov; Shlomo,8,0,20,12
1658001364773,ECE 45,A01,083139,Congero; Spencer William,7,0,75,68
1658001370797,ECE 65,A50,083695,Saad; Andrew S,12,0,30,18
1658001370797,ECE 65,A51,095125,Saad; Andrew S,24,0,26,2
1658001376820,ECE 109,A01,091882,Touri; Behrouz,21,0,70,49
1658001382842,ECE 180,A00,083140,Abi Samra; Nicholas Camill,1,0,30,29
1658001382842,ECE 180,B00,083141,Abi Samra; Nicholas Camill,0,0,30,30
1658001388871,MATH 10A,A01,083735,Patchell; Gregory David,2,0,30,28
1658001388871,MATH 10A,A02,083736,Patchell; Gregory David,20,0,30,10
1658001388871,MATH 10A,A03,083737,Patchell; Gregory David,16,0,30,14
1658001394899,MATH 10B,A01,083207,Lim; Seonhee,9,0,34,25
1658001394899,MATH 10B,A02,083208,Lim; Seonhee,10,0,35,25
1658001394899,MATH 10B,A03,093472,Lim; Seonhee,7,0,34,27
1658001394899,MATH 10B,B01,083739,Sinha; Shubham,14,0,30,16
1658001400931,MATH 18,A01,083743,Cinel; Cameron Alexander,9,0,30,21
1658001400931,MATH 18,A02,083744,Cinel; Cameron Alexander,18,0,30,12
1658001400931,MATH 18,A03,083745,Cinel; Cameron Alexander,10,0,30,20
1658001400931,MATH 18,B01,083748,Rideout; David Porter,5,0,37,32
1658001400931,MATH 18,B02,083749,Rideout; David Porter,5,0,36,31
1658001400931,MATH 18,B03,083750,Rideout; David Porter,3,0,37,34
1658001400931,MATH 18,B04,083751,Rideout; David Porter,7,0,36,29
1658001400931,MATH 18,B05,093473,Rideout; David Porter,7,0,36,29
1658001400931,MATH 18,B06,093474,Rideout; David Porter,6,0,36,30
1658001406959,MATH 20A,A01,083754,Zheng; Zequn,14,0,40,26
1658001412987,MATH 20B,A01,083756,Briones; Jor-el Thomas Caparas,4,0,36,32
1658001412987,MATH 20B,A02,083757,Briones; Jor-el Thomas Caparas,1,0,36,35
1658001412987,MATH 20B,A03,093475,Briones; Jor-el Thomas Caparas,3,0,36,33
1658001419016,MATH 20C,A01,083760,Briones; Jor-el Thomas Caparas,1,0,35,34
1658001419016,MATH 20C,A02,083761,Briones; Jor-el Thomas Caparas,8,0,35,27
1658001419016,MATH 20C,A03,093476,Briones; Jor-el Thomas Caparas,0,1,36,36
1658001419016,MATH 20C,B01,083762,Bach; Quang Tran,1,0,30,29
1658001425039,MATH 20D,A01,083765,Tran; Brian Kha,5,0,30,25
1658001425039,MATH 20D,A02,083766,Tran; Brian Kha,5,0,30,25
1658001425039,MATH 20D,A03,083767,Tran; Brian Kha,6,0,30,24
1658001431062,MATH 20E,A01,083771,Ganguly; Soumya,12,0,32,20
1658001431062,MATH 20E,A02,083772,Ganguly; Soumya,7,0,32,25
1658001431062,MATH 20E,B01,083773,Ciotti; Benjamin,20,0,35,15
1658001431062,MATH 20E,B02,083774,Ciotti; Benjamin,18,0,35,17
1658001437092,MATH 103A,A01,083777,Greenfeld; Be'Eri,6,0,36,30
1658001437092,MATH 103A,A02,083778,Greenfeld; Be'Eri,5,0,36,31
1658001437092,MATH 103A,A03,093561,Greenfeld; Be'Eri,7,0,36,29
1658001437092,MATH 103A,B01,083779,Greenfeld; Be'Eri,8,0,36,28
1658001437092,MATH 103A,B02,083780,Greenfeld; Be'Eri,4,0,36,32
1658001437092,MATH 103A,B03,093562,Greenfeld; Be'Eri,3,0,36,33
1658001443119,MATH 105,A01,085443,Carter; Anne Toulson,15,0,35,20
1658001443119,MATH 105,A02,093477,Carter; Anne Toulson,20,0,35,15
1658001449144,MATH 109,A01,083213,Ganzberger; Geoffrey Michael,3,0,34,31
1658001449144,MATH 109,A02,083214,Ganzberger; Geoffrey Michael,4,0,34,30
1658001449144,MATH 109,A03,093478,Ganzberger; Geoffrey Michael,2,0,34,32
1658001449144,MATH 109,B01,083215,Ganzberger; Geoffrey Michael,3,0,32,29
1658001449144,MATH 109,B02,083216,Ganzberger; Geoffrey Michael,3,0,32,29
1658001449144,MATH 109,B03,093479,Ganzberger; Geoffrey Michael,8,0,32,24
1658001455173,MATH 142A,A01,083219,Chow; Bennett,7,0,32,25
1658001455173,MATH 142A,A02,083220,Chow; Bennett,10,0,32,22
1658001455173,MATH 142A,A03,093480,Chow; Bennett,9,0,32,23
1658001455173,MATH 142A,B03,093481,Chow; Bennett,8,0,32,24
1658001455173,MATH 142A,B04,093558,Chow; Bennett,14,0,32,18
1658001455173,MATH 142A,B05,093559,Chow; Bennett,7,0,32,25
1658001461197,MATH 193A,A01,083224,Rotar; Vladimir,9,0,34,25
1658001461197,MATH 193A,A02,083225,Rotar; Vladimir,11,0,34,23
1658001461197,MATH 193A,A03,083781,Rotar; Vladimir,5,0,34,29
1658001461197,MATH 193A,A04,083782,Rotar; Vladimir,12,0,34,22
1658001461197,MATH 193A,A05,093482,Rotar; Vladimir,11,0,34,23
1658001467238,MATH 197,001,091859,McAuley; Julian John,9999,0,9999,0
1658001467238,MATH 197,002,095566,Kedlaya; Kiran S.,9997,0,9999,2
1658001467238,MATH 197,003,095567,Xiao; Ming,9999,0,9999,0
1658001467238,MATH 197,004,095571,Perols; Johan Lars,9998,0,9999,1
1658001474296,COGS 9,A01,083615,Shannon; Kyle Michael,11,0,75,64
1658001480319,COGS 11,A01,083617,Boyle; Mary E. T.,23,0,48,25
1658001486346,COGS 13,A01,083071,Bastos; Amalia Pinkusfeld,12,0,71,59
1658001492373,COGS 14A,A01,092681,Semenuks; Arturs,5,1,100,95
1658001498396,COGS 14B,A01,083073,Cheng; Tzu-Han,7,0,63,56
1658001504420,COGS 17,A01,092677,Semenuks; Arturs,7,0,81,74
1658001510446,COGS 100,A01,083619,Allen; Michael Gordon,17,0,70,53
1658001516474,COGS 101A,A01,083621,Davis; Joshua Daniel,9,0,68,59
1658001522500,COGS 101B,A01,091572,Allen; Michael Gordon,14,0,65,51
1658001528523,COGS 101C,A01,083625,Delgado; Tania,17,0,35,18
1658001534546,COGS 107A,A01,083627,Boyle; Mary E. T.,14,0,60,46
1658001540570,COGS 118A,A01,083075,Gupta; Anjum,21,0,76,55
1658001546592,CSE 3,A50,083646,Miranda; Gregory Joseph,24,0,50,26
1658001552615,CSE 8A,A50,083650,Miranda; Gregory Joseph,17,1,56,39
1658001558640,CSE 11,A01,083080,Cao; Yingjun,7,15,40,33
1658001564663,CSE 12,A01,083652,Krause-Levy; Sophia Louisa,30,1,120,90
1658001570691,CSE 15L,A01,083654,Morris; Justin Loren,9,0,50,41
1658001570691,CSE 15L,A02,083655,Morris; Justin Loren,11,0,50,39
1658001576714,CSE 20,A01,083657,Tran; Khoa Dang,39,0,80,41
1658001582743,CSE 21,A01,095574,Bach; Quang Tran,23,0,48,25
1658001588766,CSE 30,A01,083084,Eldon; John,8,0,80,72
1658001588766,CSE 30,B01,095061,Bhaskar; Nishant,9,0,50,41
1658001594794,CSE 100,A01,083659,Cao; Yingjun,5,4,70,65
1658001600819,CSE 134B,A01,083661,Powell; Thomas Allan,25,0,100,75
1658001606843,CSE 140,A01,083663,Gungor; Onat,17,0,85,68
1658001612865,CSE 140L,A01,083088,Eldon; John,23,0,100,77
1658001618890,CSE 175,A01,083665,Kumar; Rakesh,3,0,25,22
1658001624913,CSE 190,A00,092507,Dubnov; Shlomo,8,0,20,12
1658001630939,ECE 45,A01,083139,Congero; Spencer William,7,0,75,68
1658001636968,ECE 65,A50,083695,Saad; Andrew S,12,0,30,18
1658001636968,ECE 65,A51,095125,Saad; Andrew S,24,0,26,2
1658001643061,ECE 109,A01,091882,Touri; Behrouz,21,0,70,49
1658001649083,ECE 180,A00,083140,Abi Samra; Nicholas Camill,1,0,30,29
1658001649083,ECE 180,B00,083141,Abi Samra; Nicholas Camill,0,0,30,30
1658001655107,MATH 10A,A01,083735,Patchell; Gregory David,2,0,30,28
1658001655107,MATH 10A,A02,083736,Patchell; Gregory David,20,0,30,10
1658001655107,MATH 10A,A03,083737,Patchell; Gregory David,16,0,30,14
1658001661132,MATH 10B,A01,083207,Lim; Seonhee,9,0,34,25
1658001661132,MATH 10B,A02,083208,Lim; Seonhee,10,0,35,25
1658001661132,MATH 10B,A03,093472,Lim; Seonhee,7,0,34,27
1658001661132,MATH 10B,B01,083739,Sinha; Shubham,14,0,30,16
1658001667162,MATH 18,A01,083743,Cinel; Cameron Alexander,9,0,30,21
1658001667162,MATH 18,A02,083744,Cinel; Cameron Alexander,18,0,30,12
1658001667162,MATH 18,A03,083745,Cinel; Cameron Alexander,10,0,30,20
1658001667162,MATH 18,B01,083748,Rideout; David Porter,5,0,37,32
1658001667162,MATH 18,B02,083749,Rideout; David Porter,5,0,36,31
1658001667162,MATH 18,B03,083750,Rideout; David Porter,3,0,37,34
1658001667162,MATH 18,B04,083751,Rideout; David Porter,7,0,36,29
1658001667162,MATH 18,B05,093473,Rideout; David Porter,7,0,36,29
1658001667162,MATH 18,B06,093474,Rideout; David Porter,6,0,36,30
1658001673185,MATH 20A,A01,083754,Zheng; Zequn,14,0,40,26
1658001679209,MATH 20B,A01,083756,Briones; Jor-el Thomas Caparas,4,0,36,32
1658001679209,MATH 20B,A02,083757,Briones; Jor-el Thomas Caparas,1,0,36,35
1658001679209,MATH 20B,A03,093475,Briones; Jor-el Thomas Caparas,3,0,36,33
1658001685233,MATH 20C,A01,083760,Briones; Jor-el Thomas Caparas,1,0,35,34
1658001685233,MATH 20C,A02,083761,Briones; Jor-el Thomas Caparas,8,0,35,27
1658001685233,MATH 20C,A03,093476,Briones; Jor-el Thomas Caparas,0,1,36,36
1658001685233,MATH 20C,B01,083762,Bach; Quang Tran,1,0,30,29
1658001691258,MATH 20D,A01,083765,Tran; Brian Kha,5,0,30,25
1658001691258,MATH 20D,A02,083766,Tran; Brian Kha,5,0,30,25
1658001691258,MATH 20D,A03,083767,Tran; Brian Kha,6,0,30,24
1658001697285,MATH 20E,A01,083771,Ganguly; Soumya,12,0,32,20
1658001697285,MATH 20E,A02,083772,Ganguly; Soumya,7,0,32,25
1658001697285,MATH 20E,B01,083773,Ciotti; Benjamin,20,0,35,15
1658001697285,MATH 20E,B02,083774,Ciotti; Benjamin,18,0,35,17
1658001703314,MATH 103A,A01,083777,Greenfeld; Be'Eri,6,0,36,30
1658001703314,MATH 103A,A02,083778,Greenfeld; Be'Eri,5,0,36,31
1658001703314,MATH 103A,A03,093561,Greenfeld; Be'Eri,7,0,36,29
1658001703314,MATH 103A,B01,083779,Greenfeld; Be'Eri,8,0,36,28
1658001703314,MATH 103A,B02,083780,Greenfeld; Be'Eri,4,0,36,32
1658001703314,MATH 103A,B03,093562,Greenfeld; Be'Eri,3,0,36,33
1658001709343,MATH 105,A01,085443,Carter; Anne Toulson,15,0,35,20
1658001709343,MATH 105,A02,093477,Carter; Anne Toulson,20,0,35,15
1658001715370,MATH 109,A01,083213,Ganzberger; Geoffrey Michael,3,0,34,31
1658001715370,MATH 109,A02,083214,Ganzberger; Geoffrey Michael,4,0,34,30
1658001715370,MATH 109,A03,093478,Ganzberger; Geoffrey Michael,2,0,34,32
1658001715370,MATH 109,B01,083215,Ganzberger; Geoffrey Michael,3,0,32,29
1658001715370,MATH 109,B02,083216,Ganzberger; Geoffrey Michael,3,0,32,29
1658001715370,MATH 109,B03,093479,Ganzberger; Geoffrey Michael,8,0,32,24
1658001721395,MATH 142A,A01,083219,Chow; Bennett,7,0,32,25
1658001721395,MATH 142A,A02,083220,Chow; Bennett,10,0,32,22
1658001721395,MATH 142A,A03,093480,Chow; Bennett,9,0,32,23
1658001721395,MATH 142A,B03,093481,Chow; Bennett,8,0,32,24
1658001721395,MATH 142A,B04,093558,Chow; Bennett,14,0,32,18
1658001721395,MATH 142A,B05,093559,Chow; Bennett,7,0,32,25
1658001727419,MATH 193A,A01,083224,Rotar; Vladimir,9,0,34,25
1658001727419,MATH 193A,A02,083225,Rotar; Vladimir,11,0,34,23
1658001727419,MATH 193A,A03,083781,Rotar; Vladimir,5,0,34,29
1658001727419,MATH 193A,A04,083782,Rotar; Vladimir,12,0,34,22
1658001727419,MATH 193A,A05,093482,Rotar; Vladimir,11,0,34,23
1658001733449,MATH 197,001,091859,McAuley; Julian John,9999,0,9999,0
1658001733449,MATH 197,002,095566,Kedlaya; Kiran S.,9997,0,9999,2
1658001733449,MATH 197,003,095567,Xiao; Ming,9999,0,9999,0
1658001733449,MATH 197,004,095571,Perols; Johan Lars,9998,0,9999,1
1658001740511,COGS 9,A01,083615,Shannon; Kyle Michael,11,0,75,64
1658001746537,COGS 11,A01,083617,Boyle; Mary E. T.,23,0,48,25
1658001752560,COGS 13,A01,083071,Bastos; Amalia Pinkusfeld,12,0,71,59
1658001758583,COGS 14A,A01,092681,Semenuks; Arturs,5,1,100,95
1658001764608,COGS 14B,A01,083073,Cheng; Tzu-Han,7,0,63,56
1658001770636,COGS 17,A01,092677,Semenuks; Arturs,7,0,81,74
1658001776662,COGS 100,A01,083619,Allen; Michael Gordon,17,0,70,53
1658001782686,COGS 101A,A01,083621,Davis; Joshua Daniel,9,0,68,59
1658001788709,COGS 101B,A01,091572,Allen; Michael Gordon,14,0,65,51
1658001794733,COGS 101C,A01,083625,Delgado; Tania,17,0,35,18
1658001800758,COGS 107A,A01,083627,Boyle; Mary E. T.,14,0,60,46
1658001806783,COGS 118A,A01,083075,Gupta; Anjum,21,0,76,55
1658001812810,CSE 3,A50,083646,Miranda; Gregory Joseph,24,0,50,26
1658001818837,CSE 8A,A50,083650,Miranda; Gregory Joseph,17,1,56,39
1658001824860,CSE 11,A01,083080,Cao; Yingjun,7,15,40,33
1658001830887,CSE 12,A01,083652,Krause-Levy; Sophia Louisa,30,1,120,90
1658001836909,CSE 15L,A01,083654,Morris; Justin Loren,9,0,50,41
1658001836909,CSE 15L,A02,083655,Morris; Justin Loren,11,0,50,39
1658001842933,CSE 20,A01,083657,Tran; Khoa Dang,39,0,80,41
1658001848966,CSE 21,A01,095574,Bach; Quang Tran,23,0,48,25
1658001854990,CSE 30,A01,083084,Eldon; John,8,0,80,72
1658001854990,CSE 30,B01,095061,Bhaskar; Nishant,9,0,50,41
1658001861015,CSE 100,A01,083659,Cao; Yingjun,5,4,70,65
1658001867037,CSE 134B,A01,083661,Powell; Thomas Allan,25,0,100,75
1658001873059,CSE 140,A01,083663,Gungor; Onat,17,0,85,68
1658001879084,CSE 140L,A01,083088,Eldon; John,23,0,100,77
1658001885106,CSE 175,A01,083665,Kumar; Rakesh,3,0,25,22
1658001891132,CSE 190,A00,092507,Dubnov; Shlomo,8,0,20,12
1658001897159,ECE 45,A01,083139,Congero; Spencer William,7,0,75,68
1658001903185,ECE 65,A50,083695,Saad; Andrew S,12,0,30,18
1658001903185,ECE 65,A51,095125,Saad; Andrew S,24,0,26,2
1658001909207,ECE 109,A01,091882,Touri; Behrouz,21,0,70,49
1658001915233,ECE 180,A00,083140,Abi Samra; Nicholas Camill,1,0,30,29
1658001915233,ECE 180,B00,083141,Abi Samra; Nicholas Camill,0,0,30,30
1658001921254,MATH 10A,A01,083735,Patchell; Gregory David,2,0,30,28
1658001921254,MATH 10A,A02,083736,Patchell; Gregory David,20,0,30,10
1658001921254,MATH 10A,A03,083737,Patchell; Gregory David,16,0,30,14
1658001927279,MATH 10B,A01,083207,Lim; Seonhee,9,0,34,25
1658001927279,MATH 10B,A02,083208,Lim; Seonhee,10,0,35,25
1658001927279,MATH 10B,A03,093472,Lim; Seonhee,7,0,34,27
1658001927279,MATH 10B,B01,083739,Sinha; Shubham,14,0,30,16
1658001933304,MATH 18,A01,083743,Cinel; Cameron Alexander,9,0,30,21
1658001933304,MATH 18,A02,083744,Cinel; Cameron Alexander,18,0,30,12
1658001933304,MATH 18,A03,083745,Cinel; Cameron Alexander,10,0,30,20
1658001933304,MATH 18,B01,083748,Rideout; David Porter,5,0,37,32
1658001933304,MATH 18,B02,083749,Rideout; David Porter,5,0,36,31
1658001933304,MATH 18,B03,083750,Rideout; David Porter,3,0,37,34
1658001933304,MATH 18,B04,083751,Rideout; David Porter,7,0,36,29
1658001933304,MATH 18,B05,093473,Rideout; David Porter,7,0,36,29
1658001933304,MATH 18,B06,093474,Rideout; David Porter,6,0,36,30
1658001939327,MATH 20A,A01,083754,Zheng; Zequn,14,0,40,26
1658001945354,MATH 20B,A01,083756,Briones; Jor-el Thomas Caparas,4,0,36,32
1658001945354,MATH 20B,A02,083757,Briones; Jor-el Thomas Caparas,1,0,36,35
1658001945354,MATH 20B,A03,093475,Briones; Jor-el Thomas Caparas,3,0,36,33
1658001951379,MATH 20C,A01,083760,Briones; Jor-el Thomas Caparas,1,0,35,34
1658001951379,MATH 20C,A02,083761,Briones; Jor-el Thomas Caparas,8,0,35,27
1658001951379,MATH 20C,A03,093476,Briones; Jor-el Thomas Caparas,0,1,36,36
1658001951379,MATH 20C,B01,083762,Bach; Quang Tran,1,0,30,29
1658001957401,MATH 20D,A01,083765,Tran; Brian Kha,5,0,30,25
1658001957401,MATH 20D,A02,083766,Tran; Brian Kha,5,0,30,25
1658001957401,MATH 20D,A03,083767,Tran; Brian Kha,6,0,30,24
1658001963434,MATH 20E,A01,083771,Ganguly; Soumya,12,0,32,20
1658001963434,MATH 20E,A02,083772,Ganguly; Soumya,7,0,32,25
1658001963434,MATH 20E,B01,083773,Ciotti; Benjamin,20,0,35,15
1658001963434,MATH 20E,B02,083774,Ciotti; Benjamin,18,0,35,17
1658001969463,MATH 103A,A01,083777,Greenfeld; Be'Eri,6,0,36,30
1658001969463,MATH 103A,A02,083778,Greenfeld; Be'Eri,5,0,36,31
1658001969463,MATH 103A,A03,093561,Greenfeld; Be'Eri,7,0,36,29
1658001969463,MATH 103A,B01,083779,Greenfeld; Be'Eri,8,0,36,28
1658001969463,MATH 103A,B02,083780,Greenfeld; Be'Eri,4,0,36,32
1658001969463,MATH 103A,B03,093562,Greenfeld; Be'Eri,3,0,36,33
1658001975490,MATH 105,A01,085443,Carter; Anne Toulson,15,0,35,20
1658001975490,MATH 105,A02,093477,Carter; Anne Toulson,20,0,35,15
1658001981520,MATH 109,A01,083213,Ganzberger; Geoffrey Michael,3,0,34,31
1658001981520,MATH 109,A02,083214,Ganzberger; Geoffrey Michael,4,0,34,30
1658001981520,MATH 109,A03,093478,Ganzberger; Geoffrey Michael,2,0,34,32
1658001981520,MATH 109,B01,083215,Ganzberger; Geoffrey Michael,3,0,32,29
1658001981520,MATH 109,B02,083216,Ganzberger; Geoffrey Michael,3,0,32,29
1658001981520,MATH 109,B03,093479,Ganzberger; Geoffrey Michael,8,0,32,24
1658001987545,MATH 142A,A01,083219,Chow; Bennett,7,0,32,25
1658001987545,MATH 142A,A02,083220,Chow; Bennett,10,0,32,22
1658001987545,MATH 142A,A03,093480,Chow; Bennett,9,0,32,23
1658001987545,MATH 142A,B03,093481,Chow; Bennett,8,0,32,24
1658001987545,MATH 142A,B04,093558,Chow; Bennett,14,0,32,18
1658001987545,MATH 142A,B05,093559,Chow; Bennett,7,0,32,25
1658001993572,MATH 193A,A01,083224,Rotar; Vladimir,9,0,34,25
1658001993572,MATH 193A,A02,083225,Rotar; Vladimir,11,0,34,23
1658001993572,MATH 193A,A03,083781,Rotar; Vladimir,5,0,34,29
1658001993572,MATH 193A,A04,083782,Rotar; Vladimir,12,0,34,22
1658001993572,MATH 193A,A05,093482,Rotar; Vladimir,11,0,34,23
1658001999599,MATH 197,001,091859,McAuley; Julian John,9999,0,9999,0
1658001999599,MATH 197,002,095566,Kedlaya; Kiran S.,9997,0,9999,2
1658001999599,MATH 197,003,095567,Xiao; Ming,9999,0,9999,0
1658001999599,MATH 197,004,095571,Perols; Johan Lars,9998,0,9999,1
1658002006653,COGS 9,A01,083615,Shannon; Kyle Michael,11,0,75,64
1658002012676,COGS 11,A01,083617,Boyle; Mary E. T.,23,0,48,25
1658002018703,COGS 13,A01,083071,Bastos; Amalia Pinkusfeld,12,0,71,59
1658002024729,COGS 14A,A01,092681,Semenuks; Arturs,5,1,100,95
1658002030750,COGS 14B,A01,083073,Cheng; Tzu-Han,7,0,63,56
1658002036776,COGS 17,A01,092677,Semenuks; Arturs,7,0,81,74
1658002042799,COGS 100,A01,083619,Allen; Michael Gordon,17,0,70,53
1658002048821,COGS 101A,A01,083621,Davis; Joshua Daniel,9,0,68,59
1658002054848,COGS 101B,A01,091572,Allen; Michael Gordon,14,0,65,51
1658002060872,COGS 101C,A01,083625,Delgado; Tania,17,0,35,18
1658002066899,COGS 107A,A01,083627,Boyle; Mary E. T.,14,0,60,46
1658002072927,COGS 118A,A01,083075,Gupta; Anjum,21,0,76,55
1658002078951,CSE 3,A50,083646,Miranda; Gregory Joseph,24,0,50,26
1658002084974,CSE 8A,A50,083650,Miranda; Gregory Joseph,17,1,56,39
1658002090997,CSE 11,A01,083080,Cao; Yingjun,7,15,40,33
1658002097024,CSE 12,A01,083652,Krause-Levy; Sophia Louisa,30,1,120,90
1658002103052,CSE 15L,A01,083654,Morris; Justin Loren,9,0,50,41
1658002103052,CSE 15L,A02,083655,Morris; Justin Loren,11,0,50,39
1658002109078,CSE 20,A01,083657,Tran; Khoa Dang,39,0,80,41
1658002115105,CSE 21,A01,095574,Bach; Quang Tran,23,0,48,25
1658002121143,CSE 30,A01,083084,Eldon; John,8,0,80,72
1658002121143,CSE 30,B01,095061,Bhaskar; Nishant,9,0,50,41
1658002127166,CSE 100,A01,083659,Cao; Yingjun,5,4,70,65
1658002133195,CSE 134B,A01,083661,Powell; Thomas Allan,25,0,100,75
1658002139221,CSE 140,A01,083663,Gungor; Onat,17,0,85,68
1658002145245,CSE 140L,A01,083088,Eldon; John,23,0,100,77
1658002151268,CSE 175,A01,083665,Kumar; Rakesh,3,0,25,22
1658002157290,CSE 190,A00,092507,Dubnov; Shlomo,8,0,20,12
1658002163317,ECE 45,A01,083139,Congero; Spencer William,7,0,75,68
1658002169340,ECE 65,A50,083695,Saad; Andrew S,12,0,30,18
1658002169340,ECE 65,A51,095125,Saad; Andrew S,24,0,26,2
1658002175363,ECE 109,A01,091882,Touri; Behrouz,21,0,70,49
1658002181385,ECE 180,A00,083140,Abi Samra; Nicholas Camill,1,0,30,29
1658002181385,ECE 180,B00,083141,Abi Samra; Nicholas Camill,0,0,30,30
1658002187413,MATH 10A,A01,083735,Patchell; Gregory David,2,0,30,28
1658002187413,MATH 10A,A02,083736,Patchell; Gregory David,20,0,30,10
1658002187413,MATH 10A,A03,083737,Patchell; Gregory David,16,0,30,14
1658002193438,MATH 10B,A01,083207,Lim; Seonhee,9,0,34,25
1658002193438,MATH 10B,A02,083208,Lim; Seonhee,10,0,35,25
1658002193438,MATH 10B,A03,093472,Lim; Seonhee,7,0,34,27
1658002193438,MATH 10B,B01,083739,Sinha; Shubham,14,0,30,16
1658002199470,MATH 18,A01,083743,Cinel; Cameron Alexander,9,0,30,21
1658002199470,MATH 18,A02,083744,Cinel; Cameron Alexander,18,0,30,12
1658002199470,MATH 18,A03,083745,Cinel; Cameron Alexander,10,0,30,20
1658002199470,MATH 18,B01,083748,Rideout; David Porter,5,0,37,32
1658002199470,MATH 18,B02,083749,Rideout; David Porter,5,0,36,31
1658002199470,MATH 18,B03,083750,Rideout; David Porter,3,0,37,34
1658002199470,MATH 18,B04,083751,Rideout; David Porter,7,0,36,29
1658002199470,MATH 18,B05,093473,Rideout; David Porter,7,0,36,29
1658002199470,MATH 18,B06,093474,Rideout; David Porter,6,0,36,30
1658002205492,MATH 20A,A01,083754,Zheng; Zequn,14,0,40,26
1658002211520,MATH 20B,A01,083756,Briones; Jor-el Thomas Caparas,4,0,36,32
1658002211520,MATH 20B,A02,083757,Briones; Jor-el Thomas Caparas,1,0,36,35
1658002211520,MATH 20B,A03,093475,Briones; Jor-el Thomas Caparas,3,0,36,33
1658002217544,MATH 20C,A01,083760,Briones; Jor-el Thomas Caparas,1,0,35,34
1658002217544,MATH 20C,A02,083761,Briones; Jor-el Thomas Caparas,8,0,35,27
1658002217544,MATH 20C,A03,093476,Briones; Jor-el Thomas Caparas,0,1,36,36
1658002217544,MATH 20C,B01,083762,Bach; Quang Tran,1,0,30,29
1658002223566,MATH 20D,A01,083765,Tran; Brian Kha,5,0,30,25
1658002223566,MATH 20D,A02,083766,Tran; Brian Kha,5,0,30,25
1658002223566,MATH 20D,A03,083767,Tran; Brian Kha,6,0,30,24
1658002229589,MATH 20E,A01,083771,Ganguly; Soumya,12,0,32,20
1658002229589,MATH 20E,A02,083772,Ganguly; Soumya,7,0,32,25
1658002229589,MATH 20E,B01,083773,Ciotti; Benjamin,20,0,35,15
1658002229589,MATH 20E,B02,083774,Ciotti; Benjamin,18,0,35,17
1658002235618,MATH 103A,A01,083777,Greenfeld; Be'Eri,6,0,36,30
1658002235618,MATH 103A,A02,083778,Greenfeld; Be'Eri,5,0,36,31
1658002235618,MATH 103A,A03,093561,Greenfeld; Be'Eri,7,0,36,29
1658002235618,MATH 103A,B01,083779,Greenfeld; Be'Eri,8,0,36,28
1658002235618,MATH 103A,B02,083780,Greenfeld; Be'Eri,4,0,36,32
1658002235618,MATH 103A,B03,093562,Greenfeld; Be'Eri,3,0,36,33
1658002241729,MATH 105,A01,085443,Carter; Anne Toulson,15,0,35,20
1658002241729,MATH 105,A02,093477,Carter; Anne Toulson,20,0,35,15
1658002247752,MATH 109,A01,083213,Ganzberger; Geoffrey Michael,3,0,34,31
1658002247752,MATH 109,A02,083214,Ganzberger; Geoffrey Michael,4,0,34,30
1658002247752,MATH 109,A03,093478,Ganzberger; Geoffrey Michael,2,0,34,32
1658002247752,MATH 109,B01,083215,Ganzberger; Geoffrey Michael,3,0,32,29
1658002247752,MATH 109,B02,083216,Ganzberger; Geoffrey Michael,3,0,32,29
1658002247752,MATH 109,B03,093479,Ganzberger; Geoffrey Michael,8,0,32,24
1658002253779,MATH 142A,A01,083219,Chow; Bennett,7,0,32,25
1658002253779,MATH 142A,A02,083220,Chow; Bennett,10,0,32,22
1658002253779,MATH 142A,A03,093480,Chow; Bennett,9,0,32,23
1658002253779,MATH 142A,B03,093481,Chow; Bennett,8,0,32,24
1658002253779,MATH 142A,B04,093558,Chow; Bennett,14,0,32,18
1658002253779,MATH 142A,B05,093559,Chow; Bennett,7,0,32,25
1658002259806,MATH 193A,A01,083224,Rotar; Vladimir,9,0,34,25
1658002259806,MATH 193A,A02,083225,Rotar; Vladimir,11,0,34,23
1658002259806,MATH 193A,A03,083781,Rotar; Vladimir,5,0,34,29
1658002259806,MATH 193A,A04,083782,Rotar; Vladimir,12,0,34,22
1658002259806,MATH 193A,A05,093482,Rotar; Vladimir,11,0,34,23
1658002265829,MATH 197,001,091859,McAuley; Julian John,9999,0,9999,0
1658002265829,MATH 197,002,095566,Kedlaya; Kiran S.,9997,0,9999,2
1658002265829,MATH 197,003,095567,Xiao; Ming,9999,0,9999,0
1658002265829,MATH 197,004,095571,Perols; Johan Lars,9998,0,9999,1
1658002272891,COGS 9,A01,083615,Shannon; Kyle Michael,11,0,75,64
1658002278913,COGS 11,A01,083617,Boyle; Mary E. T.,23,0,48,25
1658002284936,COGS 13,A01,083071,Bastos; Amalia Pinkusfeld,12,0,71,59
1658002290960,COGS 14A,A01,092681,Semenuks; Arturs,5,1,100,95
1658002296983,COGS 14B,A01,083073,Cheng; Tzu-Han,7,0,63,56
1658002303004,COGS 17,A01,092677,Semenuks; Arturs,7,0,81,74
1658002309027,COGS 100,A01,083619,Allen; Michael Gordon,17,0,70,53
1658002315052,COGS 101A,A01,083621,Davis; Joshua Daniel,9,0,68,59
1658002321075,COGS 101B,A01,091572,Allen; Michael Gordon,14,0,65,51
1658002327099,COGS 101C,A01,083625,Delgado; Tania,17,0,35,18
1658002333126,COGS 107A,A01,083627,Boyle; Mary E. T.,14,0,60,46
1658002339152,COGS 118A,A01,083075,Gupta; Anjum,21,0,76,55
1658002345175,CSE 3,A50,083646,Miranda; Gregory Joseph,24,0,50,26
1658002351202,CSE 8A,A50,083650,Miranda; Gregory Joseph,17,1,56,39
1658002357226,CSE 11,A01,083080,Cao; Yingjun,7,15,40,33
1658002363249,CSE 12,A01,083652,Krause-Levy; Sophia Louisa,30,1,120,90
1658002369276,CSE 15L,A01,083654,Morris; Justin Loren,9,0,50,41
1658002369276,CSE 15L,A02,083655,Morris; Justin Loren,11,0,50,39
1658002375306,CSE 20,A01,083657,Tran; Khoa Dang,39,0,80,41
1658002381328,CSE 21,A01,095574,Bach; Quang Tran,23,0,48,25
1658002387356,CSE 30,A01,083084,Eldon; John,8,0,80,72
1658002387356,CSE 30,B01,095061,Bhaskar; Nishant,9,0,50,41
1658002393382,CSE 100,A01,083659,Cao; Yingjun,5,4,70,65
1658002399404,CSE 134B,A01,083661,Powell; Thomas Allan,25,0,100,75
1658002405428,CSE 140,A01,083663,Gungor; Onat,17,0,85,68
1658002411457,CSE 140L,A01,083088,Eldon; John,23,0,100,77
1658002417481,CSE 175,A01,083665,Kumar; Rakesh,3,0,25,22
1658002423507,CSE 190,A00,092507,Dubnov; Shlomo,8,0,20,12
1658002429534,ECE 45,A01,083139,Congero; Spencer William,7,0,75,68
1658002435558,ECE 65,A50,083695,Saad; Andrew S,12,0,30,18
1658002435558,ECE 65,A51,095125,Saad; Andrew S,24,0,26,2
1658002441581,ECE 109,A01,091882,Touri; Behrouz,21,0,70,49
1658002447615,ECE 180,A00,083140,Abi Samra; Nicholas Camill,1,0,30,29
1658002447615,ECE 180,B00,083141,Abi Samra; Nicholas Camill,0,0,30,30
1658002453641,MATH 10A,A01,083735,Patchell; Gregory David,2,0,30,28
1658002453641,MATH 10A,A02,083736,Patchell; Gregory David,20,0,30,10
1658002453641,MATH 10A,A03,083737,Patchell; Gregory David,16,0,30,14
1658002459673,MATH 10B,A01,083207,Lim; Seonhee,9,0,34,25
1658002459673,MATH 10B,A02,083208,Lim; Seonhee,10,0,35,25
1658002459673,MATH 10B,A03,093472,Lim; Seonhee,7,0,34,27
1658002459673,MATH 10B,B01,083739,Sinha; Shubham,14,0,30,16
1658002465702,MATH 18,A01,083743,Cinel; Cameron Alexander,9,0,30,21
1658002465702,MATH 18,A02,083744,Cinel; Cameron Alexander,18,0,30,12
1658002465702,MATH 18,A03,083745,Cinel; Cameron Alexander,10,0,30,20
1658002465702,MATH 18,B01,083748,Rideout; David Porter,5,0,37,32
1658002465702,MATH 18,B02,083749,Rideout; David Porter,5,0,36,31
1658002465702,MATH 18,B03,083750,Rideout; David Porter,3,0,37,34
1658002465702,MATH 18,B04,083751,Rideout; David Porter,7,0,36,29
1658002465702,MATH 18,B05,093473,Rideout; David Porter,7,0,36,29
1658002465702,MATH 18,B06,093474,Rideout; David Porter,6,0,36,30
1658002471724,MATH 20A,A01,083754,Zheng; Zequn,14,0,40,26
1658002477749,MATH 20B,A01,083756,Briones; Jor-el Thomas Caparas,4,0,36,32
1658002477749,MATH 20B,A02,083757,Briones; Jor-el Thomas Caparas,1,0,36,35
1658002477749,MATH 20B,A03,093475,Briones; Jor-el Thomas Caparas,3,0,36,33
1658002483777,MATH 20C,A01,083760,Briones; Jor-el Thomas Caparas,1,0,35,34
1658002483777,MATH 20C,A02,083761,Briones; Jor-el Thomas Caparas,8,0,35,27
1658002483777,MATH 20C,A03,093476,Briones; Jor-el Thomas Caparas,0,1,36,36
1658002483777,MATH 20C,B01,083762,Bach; Quang Tran,1,0,30,29
1658002489812,MATH 20D,A01,083765,Tran; Brian Kha,5,0,30,25
1658002489812,MATH 20D,A02,083766,Tran; Brian Kha,5,0,30,25
1658002489812,MATH 20D,A03,083767,Tran; Brian Kha,6,0,30,24
1658002495835,MATH 20E,A01,083771,Ganguly; Soumya,12,0,32,20
1658002495835,MATH 20E,A02,083772,Ganguly; Soumya,7,0,32,25
1658002495835,MATH 20E,B01,083773,Ciotti; Benjamin,20,0,35,15
1658002495835,MATH 20E,B02,083774,Ciotti; Benjamin,18,0,35,17
1658002501859,MATH 103A,A01,083777,Greenfeld; Be'Eri,6,0,36,30
1658002501859,MATH 103A,A02,083778,Greenfeld; Be'Eri,5,0,36,31
1658002501859,MATH 103A,A03,093561,Greenfeld; Be'Eri,7,0,36,29
1658002501859,MATH 103A,B01,083779,Greenfeld; Be'Eri,8,0,36,28
1658002501859,MATH 103A,B02,083780,Greenfeld; Be'Eri,4,0,36,32
1658002501859,MATH 103A,B03,093562,Greenfeld; Be'Eri,3,0,36,33
1658002507884,MATH 105,A01,085443,Carter; Anne Toulson,15,0,35,20
1658002507884,MATH 105,A02,093477,Carter; Anne Toulson,20,0,35,15
1658002513912,MATH 109,A01,083213,Ganzberger; Geoffrey Michael,3,0,34,31
1658002513912,MATH 109,A02,083214,Ganzberger; Geoffrey Michael,4,0,34,30
1658002513912,MATH 109,A03,093478,Ganzberger; Geoffrey Michael,2,0,34,32
1658002513912,MATH 109,B01,083215,Ganzberger; Geoffrey Michael,3,0,32,29
1658002513912,MATH 109,B02,083216,Ganzberger; Geoffrey Michael,3,0,32,29
1658002513912,MATH 109,B03,093479,Ganzberger; Geoffrey Michael,8,0,32,24
1658002519937,MATH 142A,A01,083219,Chow; Bennett,7,0,32,25
1658002519937,MATH 142A,A02,083220,Chow; Bennett,10,0,32,22
1658002519937,MATH 142A,A03,093480,Chow; Bennett,9,0,32,23
1658002519937,MATH 142A,B03,093481,Chow; Bennett,8,0,32,24
1658002519937,MATH 142A,B04,093558,Chow; Bennett,14,0,32,18
1658002519937,MATH 142A,B05,093559,Chow; Bennett,7,0,32,25
1658002525971,MATH 193A,A01,083224,Rotar; Vladimir,9,0,34,25
1658002525971,MATH 193A,A02,083225,Rotar; Vladimir,11,0,34,23
1658002525971,MATH 193A,A03,083781,Rotar; Vladimir,5,0,34,29
1658002525971,MATH 193A,A04,083782,Rotar; Vladimir,12,0,34,22
1658002525971,MATH 193A,A05,093482,Rotar; Vladimir,11,0,34,23
1658002531999,MATH 197,001,091859,McAuley; Julian John,9999,0,9999,0
1658002531999,MATH 197,002,095566,Kedlaya; Kiran S.,9997,0,9999,2
1658002531999,MATH 197,003,095567,Xiao; Ming,9999,0,9999,0
1658002531999,MATH 197,004,095571,Perols; Johan Lars,9998,0,9999,1
1658002539065,COGS 9,A01,083615,Shannon; Kyle Michael,11,0,75,64
1658002545092,COGS 11,A01,083617,Boyle; Mary E. T.,23,0,48,25
1658002551116,COGS 13,A01,083071,Bastos; Amalia Pinkusfeld,12,0,71,59
1658002557139,COGS 14A,A01,092681,Semenuks; Arturs,5,1,100,95
1658002563171,COGS 14B,A01,083073,Cheng; Tzu-Han,7,0,63,56
1658002569198,COGS 17,A01,092677,Semenuks; Arturs,7,0,81,74
1658002575221,COGS 100,A01,083619,Allen; Michael Gordon,17,0,70,53
1658002581249,COGS 101A,A01,083621,Davis; Joshua Daniel,9,0,68,59
1658002587279,COGS 101B,A01,091572,Allen; Michael Gordon,14,0,65,51
1658002593302,COGS 101C,A01,083625,Delgado; Tania,17,0,35,18
1658002599325,COGS 107A,A01,083627,Boyle; Mary E. T.,14,0,60,46
1658002605348,COGS 118A,A01,083075,Gupta; Anjum,21,0,76,55
1658002611376,CSE 3,A50,083646,Miranda; Gregory Joseph,24,0,50,26
1658002617400,CSE 8A,A50,083650,Miranda; Gregory Joseph,17,1,56,39
1658002623422,CSE 11,A01,083080,Cao; Yingjun,7,15,40,33
1658002629453,CSE 12,A01,083652,Krause-Levy; Sophia Louisa,30,1,120,90
1658002635475,CSE 15L,A01,083654,Morris; Justin Loren,9,0,50,41
1658002635475,CSE 15L,A02,083655,Morris; Justin Loren,11,0,50,39
1658002641498,CSE 20,A01,083657,Tran; Khoa Dang,39,0,80,41
1658002647520,CSE 21,A01,095574,Bach; Quang Tran,23,0,48,25
1658002653544,CSE 30,A01,083084,Eldon; John,8,0,80,72
1658002653544,CSE 30,B01,095061,Bhaskar; Nishant,9,0,50,41
1658002659569,CSE 100,A01,083659,Cao; Yingjun,5,4,70,65
1658002665593,CSE 134B,A01,083661,Powell; Thomas Allan,25,0,100,75
1658002671616,CSE 140,A01,083663,Gungor; Onat,17,0,85,68
1658002677639,CSE 140L,A01,083088,Eldon; John,23,0,100,77
1658002683661,CSE 175,A01,083665,Kumar; Rakesh,3,0,25,22
1658002689686,CSE 190,A00,092507,Dubnov; Shlomo,8,0,20,12
1658002695710,ECE 45,A01,083139,Congero; Spencer William,7,0,75,68
1658002701736,ECE 65,A50,083695,Saad; Andrew S,12,0,30,18
1658002701736,ECE 65,A51,095125,Saad; Andrew S,24,0,26,2
1658002707760,ECE 109,A01,091882,Touri; Behrouz,21,0,70,49
1658002713785,ECE 180,A00,083140,Abi Samra; Nicholas Camill,1,0,30,29
1658002713785,ECE 180,B00,083141,Abi Samra; Nicholas Camill,0,0,30,30
1658002719808,MATH 10A,A01,083735,Patchell; Gregory David,2,0,30,28
1658002719808,MATH 10A,A02,083736,Patchell; Gregory David,20,0,30,10
1658002719808,MATH 10A,A03,083737,Patchell; Gregory David,16,0,30,14
1658002725837,MATH 10B,A01,083207,Lim; Seonhee,9,0,34,25
1658002725837,MATH 10B,A02,083208,Lim; Seonhee,10,0,35,25
1658002725837,MATH 10B,A03,093472,Lim; Seonhee,7,0,34,27
1658002725837,MATH 10B,B01,083739,Sinha; Shubham,14,0,30,16
1658002731866,MATH 18,A01,083743,Cinel; Cameron Alexander,9,0,30,21
1658002731866,MATH 18,A02,083744,Cinel; Cameron Alexander,18,0,30,12
1658002731866,MATH 18,A03,083745,Cinel; Cameron Alexander,10,0,30,20
1658002731866,MATH 18,B01,083748,Rideout; David Porter,5,0,37,32
1658002731866,MATH 18,B02,083749,Rideout; David Porter,5,0,36,31
1658002731866,MATH 18,B03,083750,Rideout; David Porter,3,0,37,34
1658002731866,MATH 18,B04,083751,Rideout; David Porter,7,0,36,29
1658002731866,MATH 18,B05,093473,Rideout; David Porter,7,0,36,29
1658002731866,MATH 18,B06,093474,Rideout; David Porter,6,0,36,30
1658002737890,MATH 20A,A01,083754,Zheng; Zequn,14,0,40,26
1658002743916,MATH 20B,A01,083756,Briones; Jor-el Thomas Caparas,4,0,36,32
1658002743916,MATH 20B,A02,083757,Briones; Jor-el Thomas Caparas,1,0,36,35
1658002743916,MATH 20B,A03,093475,Briones; Jor-el Thomas Caparas,3,0,36,33
1658002749939,MATH 20C,A01,083760,Briones; Jor-el Thomas Caparas,1,0,35,34
1658002749939,MATH 20C,A02,083761,Briones; Jor-el Thomas Caparas,8,0,35,27
1658002749939,MATH 20C,A03,093476,Briones; Jor-el Thomas Caparas,0,1,36,36
1658002749939,MATH 20C,B01,083762,Bach; Quang Tran,1,0,30,29
1658002755968,MATH 20D,A01,083765,Tran; Brian Kha,5,0,30,25
1658002755968,MATH 20D,A02,083766,Tran; Brian Kha,5,0,30,25
1658002755968,MATH 20D,A03,083767,Tran; Brian Kha,6,0,30,24
1658002761991,MATH 20E,A01,083771,Ganguly; Soumya,12,0,32,20
1658002761991,MATH 20E,A02,083772,Ganguly; Soumya,7,0,32,25
1658002761991,MATH 20E,B01,083773,Ciotti; Benjamin,20,0,35,15
1658002761991,MATH 20E,B02,083774,Ciotti; Benjamin,18,0,35,17
1658002768015,MATH 103A,A01,083777,Greenfeld; Be'Eri,6,0,36,30
1658002768015,MATH 103A,A02,083778,Greenfeld; Be'Eri,5,0,36,31
1658002768015,MATH 103A,A03,093561,Greenfeld; Be'Eri,7,0,36,29
1658002768015,MATH 103A,B01,083779,Greenfeld; Be'Eri,8,0,36,28
1658002768015,MATH 103A,B02,083780,Greenfeld; Be'Eri,4,0,36,32
1658002768015,MATH 103A,B03,093562,Greenfeld; Be'Eri,3,0,36,33
1658002774038,MATH 105,A01,085443,Carter; Anne Toulson,15,0,35,20
1658002774038,MATH 105,A02,093477,Carter; Anne Toulson,20,0,35,15
1658002780065,MATH 109,A01,083213,Ganzberger; Geoffrey Michael,3,0,34,31
1658002780065,MATH 109,A02,083214,Ganzberger; Geoffrey Michael,4,0,34,30
1658002780065,MATH 109,A03,093478,Ganzberger; Geoffrey Michael,2,0,34,32
1658002780065,MATH 109,B01,083215,Ganzberger; Geoffrey Michael,3,0,32,29
1658002780065,MATH 109,B02,083216,Ganzberger; Geoffrey Michael,3,0,32,29
1658002780065,MATH 109,B03,093479,Ganzberger; Geoffrey Michael,8,0,32,24
1658002786093,MATH 142A,A01,083219,Chow; Bennett,7,0,32,25
1658002786093,MATH 142A,A02,083220,Chow; Bennett,10,0,32,22
1658002786093,MATH 142A,A03,093480,Chow; Bennett,9,0,32,23
1658002786093,MATH 142A,B03,093481,Chow; Bennett,8,0,32,24
1658002786093,MATH 142A,B04,093558,Chow; Bennett,14,0,32,18
1658002786093,MATH 142A,B05,093559,Chow; Bennett,7,0,32,25
1658002792120,MATH 193A,A01,083224,Rotar; Vladimir,9,0,34,25
1658002792120,MATH 193A,A02,083225,Rotar; Vladimir,11,0,34,23
1658002792120,MATH 193A,A03,083781,Rotar; Vladimir,5,0,34,29
1658002792120,MATH 193A,A04,083782,Rotar; Vladimir,12,0,34,22
1658002792120,MATH 193A,A05,093482,Rotar; Vladimir,11,0,34,23
1658002798146,MATH 197,001,091859,McAuley; Julian John,9999,0,9999,0
1658002798146,MATH 197,002,095566,Kedlaya; Kiran S.,9997,0,9999,2
1658002798146,MATH 197,003,095567,Xiao; Ming,9999,0,9999,0
1658002798146,MATH 197,004,095571,Perols; Johan Lars,9998,0,9999,1
1658002805207,COGS 9,A01,083615,Shannon; Kyle Michael,11,0,75,64
1658002811230,COGS 11,A01,083617,Boyle; Mary E. T.,23,0,48,25
1658002817253,COGS 13,A01,083071,Bastos; Amalia Pinkusfeld,12,0,71,59
1658002823275,COGS 14A,A01,092681,Semenuks; Arturs,5,1,100,95
1658002829300,COGS 14B,A01,083073,Cheng; Tzu-Han,7,0,63,56
1658002835394,COGS 17,A01,092677,Semenuks; Arturs,7,0,81,74
1658002841416,COGS 100,A01,083619,Allen; Michael Gordon,17,0,70,53
1658002847440,COGS 101A,A01,083621,Davis; Joshua Daniel,9,0,68,59
1658002853465,COGS 101B,A01,091572,Allen; Michael Gordon,14,0,65,51
1658002859488,COGS 101C,A01,083625,Delgado; Tania,17,0,35,18
1658002865513,COGS 107A,A01,083627,Boyle; Mary E. T.,14,0,60,46
1658002871545,COGS 118A,A01,083075,Gupta; Anjum,21,0,76,55
1658002877570,CSE 3,A50,083646,Miranda; Gregory Joseph,24,0,50,26
1658002883594,CSE 8A,A50,083650,Miranda; Gregory Joseph,17,1,56,39
1658002889617,CSE 11,A01,083080,Cao; Yingjun,7,15,40,33
1658002895642,CSE 12,A01,083652,Krause-Levy; Sophia Louisa,30,1,120,90
1658002901665,CSE 15L,A01,083654,Morris; Justin Loren,9,0,50,41
1658002901665,CSE 15L,A02,083655,Morris; Justin Loren,11,0,50,39
1658002907691,CSE 20,A01,083657,Tran; Khoa Dang,39,0,80,41
1658002913718,CSE 21,A01,095574,Bach; Quang Tran,23,0,48,25
1658002919742,CSE 30,A01,083084,Eldon; John,8,0,80,72
1658002919742,CSE 30,B01,095061,Bhaskar; Nishant,9,0,50,41
1658002925765,CSE 100,A01,083659,Cao; Yingjun,5,4,70,65
1658002931788,CSE 134B,A01,083661,Powell; Thomas Allan,25,0,100,75
1658002937811,CSE 140,A01,083663,Gungor; Onat,17,0,85,68
1658002943838,CSE 140L,A01,083088,Eldon; John,23,0,100,77
1658002949863,CSE 175,A01,083665,Kumar; Rakesh,3,0,25,22
1658002955887,CSE 190,A00,092507,Dubnov; Shlomo,8,0,20,12
1658002961909,ECE 45,A01,083139,Congero; Spencer William,7,0,75,68
1658002967932,ECE 65,A50,083695,Saad; Andrew S,12,0,30,18
1658002967932,ECE 65,A51,095125,Saad; Andrew S,24,0,26,2
1658002973958,ECE 109,A01,091882,Touri; Behrouz,21,0,70,49
1658002979984,ECE 180,A00,083140,Abi Samra; Nicholas Camill,1,0,30,29
1658002979984,ECE 180,B00,083141,Abi Samra; Nicholas Camill,0,0,30,30
1658002986009,MATH 10A,A01,083735,Patchell; Gregory David,2,0,30,28
1658002986009,MATH 10A,A02,083736,Patchell; Gregory David,20,0,30,10
1658002986009,MATH 10A,A03,083737,Patchell; Gregory David,16,0,30,14
1658002992032,MATH 10B,A01,083207,Lim; Seonhee,9,0,34,25
1658002992032,MATH 10B,A02,083208,Lim; Seonhee,10,0,35,25
1658002992032,MATH 10B,A03,093472,Lim; Seonhee,7,0,34,27
1658002992032,MATH 10B,B01,083739,Sinha; Shubham,14,0,30,16
1658002998072,MATH 18,A01,083743,Cinel; Cameron Alexander,9,0,30,21
1658002998072,MATH 18,A02,083744,Cinel; Cameron Alexander,18,0,30,12
1658002998072,MATH 18,A03,083745,Cinel; Cameron Alexander,10,0,30,20
1658002998072,MATH 18,B01,083748,Rideout; David Porter,5,0,37,32
1658002998072,MATH 18,B02,083749,Rideout; David Porter,5,0,36,31
1658002998072,MATH 18,B03,083750,Rideout; David Porter,3,0,37,34
1658002998072,MATH 18,B04,083751,Rideout; David Porter,7,0,36,29
1658002998072,MATH 18,B05,093473,Rideout; David Porter,7,0,36,29
1658002998072,MATH 18,B06,093474,Rideout; David Porter,6,0,36,30
1658003004096,MATH 20A,A01,083754,Zheng; Zequn,14,0,40,26
1658003010117,MATH 20B,A01,083756,Briones; Jor-el Thomas Caparas,4,0,36,32
1658003010117,MATH 20B,A02,083757,Briones; Jor-el Thomas Caparas,1,0,36,35
1658003010117,MATH 20B,A03,093475,Briones; Jor-el Thomas Caparas,3,0,36,33
1658003016142,MATH 20C,A01,083760,Briones; Jor-el Thomas Caparas,1,0,35,34
1658003016142,MATH 20C,A02,083761,Briones; Jor-el Thomas Caparas,8,0,35,27
1658003016142,MATH 20C,A03,093476,Briones; Jor-el Thomas Caparas,0,1,36,36
1658003016142,MATH 20C,B01,083762,Bach; Quang Tran,1,0,30,29
1658003022170,MATH 20D,A01,083765,Tran; Brian Kha,5,0,30,25
1658003022170,MATH 20D,A02,083766,Tran; Brian Kha,5,0,30,25
1658003022170,MATH 20D,A03,083767,Tran; Brian Kha,6,0,30,24
1658003028199,MATH 20E,A01,083771,Ganguly; Soumya,12,0,32,20
1658003028199,MATH 20E,A02,083772,Ganguly; Soumya,7,0,32,25
1658003028199,MATH 20E,B01,083773,Ciotti; Benjamin,20,0,35,15
1658003028199,MATH 20E,B02,083774,Ciotti; Benjamin,18,0,35,17
1658003034237,MATH 103A,A01,083777,Greenfeld; Be'Eri,6,0,36,30
1658003034237,MATH 103A,A02,083778,Greenfeld; Be'Eri,5,0,36,31
1658003034237,MATH 103A,A03,093561,Greenfeld; Be'Eri,7,0,36,29
1658003034237,MATH 103A,B01,083779,Greenfeld; Be'Eri,8,0,36,28
1658003034237,MATH 103A,B02,083780,Greenfeld; Be'Eri,4,0,36,32
1658003034237,MATH 103A,B03,093562,Greenfeld; Be'Eri,3,0,36,33
1658003040263,MATH 105,A01,085443,Carter; Anne Toulson,15,0,35,20
1658003040263,MATH 105,A02,093477,Carter; Anne Toulson,20,0,35,15
1658003046287,MATH 109,A01,083213,Ganzberger; Geoffrey Michael,3,0,34,31
1658003046287,MATH 109,A02,083214,Ganzberger; Geoffrey Michael,4,0,34,30
1658003046287,MATH 109,A03,093478,Ganzberger; Geoffrey Michael,2,0,34,32
1658003046287,MATH 109,B01,083215,Ganzberger; Geoffrey Michael,3,0,32,29
1658003046287,MATH 109,B02,083216,Ganzberger; Geoffrey Michael,3,0,32,29
1658003046287,MATH 109,B03,093479,Ganzberger; Geoffrey Michael,8,0,32,24
1658003052311,MATH 142A,A01,083219,Chow; Bennett,7,0,32,25
1658003052311,MATH 142A,A02,083220,Chow; Bennett,10,0,32,22
1658003052311,MATH 142A,A03,093480,Chow; Bennett,9,0,32,23
1658003052311,MATH 142A,B03,093481,Chow; Bennett,8,0,32,24
1658003052311,MATH 142A,B04,093558,Chow; Bennett,14,0,32,18
1658003052311,MATH 142A,B05,093559,Chow; Bennett,7,0,32,25
1658003058335,MATH 193A,A01,083224,Rotar; Vladimir,9,0,34,25
1658003058335,MATH 193A,A02,083225,Rotar; Vladimir,11,0,34,23
1658003058335,MATH 193A,A03,083781,Rotar; Vladimir,5,0,34,29
1658003058335,MATH 193A,A04,083782,Rotar; Vladimir,12,0,34,22
1658003058335,MATH 193A,A05,093482,Rotar; Vladimir,11,0,34,23
1658003064362,MATH 197,001,091859,McAuley; Julian John,9999,0,9999,0
1658003064362,MATH 197,002,095566,Kedlaya; Kiran S.,9997,0,9999,2
1658003064362,MATH 197,003,095567,Xiao; Ming,9999,0,9999,0
1658003064362,MATH 197,004,095571,Perols; Johan Lars,9998,0,9999,1
1658003071430,COGS 9,A01,083615,Shannon; Kyle Michael,11,0,75,64
1658003077459,COGS 11,A01,083617,Boyle; Mary E. T.,23,0,48,25
1658003083482,COGS 13,A01,083071,Bastos; Amalia Pinkusfeld,12,0,71,59
1658003089506,COGS 14A,A01,092681,Semenuks; Arturs,5,1,100,95
1658003095528,COGS 14B,A01,083073,Cheng; Tzu-Han,7,0,63,56
1658003101560,COGS 17,A01,092677,Semenuks; Arturs,7,0,81,74
1658003107582,COGS 100,A01,083619,Allen; Michael Gordon,17,0,70,53
1658003113605,COGS 101A,A01,083621,Davis; Joshua Daniel,9,0,68,59
1658003119636,COGS 101B,A01,091572,Allen; Michael Gordon,14,0,65,51
1658003125657,COGS 101C,A01,083625,Delgado; Tania,17,0,35,18
1658003131683,COGS 107A,A01,083627,Boyle; Mary E. T.,14,0,60,46
1658003137707,COGS 118A,A01,083075,Gupta; Anjum,21,0,76,55
1658003143730,CSE 3,A50,083646,Miranda; Gregory Joseph,24,0,50,26
1658003149754,CSE 8A,A50,083650,Miranda; Gregory Joseph,17,1,56,39
1658003155788,CSE 11,A01,083080,Cao; Yingjun,7,15,40,33
1658003161814,CSE 12,A01,083652,Krause-Levy; Sophia Louisa,30,1,120,90
1658003167841,CSE 15L,A01,083654,Morris; Justin Loren,9,0,50,41
1658003167841,CSE 15L,A02,083655,Morris; Justin Loren,11,0,50,39
1658003173863,CSE 20,A01,083657,Tran; Khoa Dang,39,0,80,41
1658003179888,CSE 21,A01,095574,Bach; Quang Tran,23,0,48,25
1658003185917,CSE 30,A01,083084,Eldon; John,8,0,80,72
1658003185917,CSE 30,B01,095061,Bhaskar; Nishant,9,0,50,41
1658003191939,CSE 100,A01,083659,Cao; Yingjun,5,4,70,65
1658003197966,CSE 134B,A01,083661,Powell; Thomas Allan,25,0,100,75
1658003203992,CSE 140,A01,083663,Gungor; Onat,17,0,85,68
1658003210016,CSE 140L,A01,083088,Eldon; John,23,0,100,77
1658003216041,CSE 175,A01,083665,Kumar; Rakesh,3,0,25,22
1658003222067,CSE 190,A00,092507,Dubnov; Shlomo,8,0,20,12
1658003228090,ECE 45,A01,083139,Congero; Spencer William,7,0,75,68
1658003234117,ECE 65,A50,083695,Saad; Andrew S,12,0,30,18
1658003234117,ECE 65,A51,095125,Saad; Andrew S,24,0,26,2
1658003240139,ECE 109,A01,091882,Touri; Behrouz,21,0,70,49
1658003246170,ECE 180,A00,083140,Abi Samra; Nicholas Camill,1,0,30,29
1658003246170,ECE 180,B00,083141,Abi Samra; Nicholas Camill,0,0,30,30
1658003252194,MATH 10A,A01,083735,Patchell; Gregory David,2,0,30,28
1658003252194,MATH 10A,A02,083736,Patchell; Gregory David,20,0,30,10
1658003252194,MATH 10A,A03,083737,Patchell; Gregory David,16,0,30,14
1658003258222,MATH 10B,A01,083207,Lim; Seonhee,9,0,34,25
1658003258222,MATH 10B,A02,083208,Lim; Seonhee,10,0,35,25
1658003258222,MATH 10B,A03,093472,Lim; Seonhee,7,0,34,27
1658003258222,MATH 10B,B01,083739,Sinha; Shubham,14,0,30,16
1658003264247,MATH 18,A01,083743,Cinel; Cameron Alexander,9,0,30,21
1658003264247,MATH 18,A02,083744,Cinel; Cameron Alexander,18,0,30,12
1658003264247,MATH 18,A03,083745,Cinel; Cameron Alexander,10,0,30,20
1658003264247,MATH 18,B01,083748,Rideout; David Porter,5,0,37,32
1658003264247,MATH 18,B02,083749,Rideout; David Porter,5,0,36,31
1658003264247,MATH 18,B03,083750,Rideout; David Porter,3,0,37,34
1658003264247,MATH 18,B04,083751,Rideout; David Porter,7,0,36,29
1658003264247,MATH 18,B05,093473,Rideout; David Porter,7,0,36,29
1658003264247,MATH 18,B06,093474,Rideout; David Porter,6,0,36,30
1658003270274,MATH 20A,A01,083754,Zheng; Zequn,14,0,40,26
1658003276300,MATH 20B,A01,083756,Briones; Jor-el Thomas Caparas,4,0,36,32
1658003276300,MATH 20B,A02,083757,Briones; Jor-el Thomas Caparas,1,0,36,35
1658003276300,MATH 20B,A03,093475,Briones; Jor-el Thomas Caparas,3,0,36,33
1658003282325,MATH 20C,A01,083760,Briones; Jor-el Thomas Caparas,1,0,35,34
1658003282325,MATH 20C,A02,083761,Briones; Jor-el Thomas Caparas,8,0,35,27
1658003282325,MATH 20C,A03,093476,Briones; Jor-el Thomas Caparas,0,1,36,36
1658003282325,MATH 20C,B01,083762,Bach; Quang Tran,1,0,30,29
1658003288354,MATH 20D,A01,083765,Tran; Brian Kha,5,0,30,25
1658003288354,MATH 20D,A02,083766,Tran; Brian Kha,5,0,30,25
1658003288354,MATH 20D,A03,083767,Tran; Brian Kha,6,0,30,24
1658003294388,MATH 20E,A01,083771,Ganguly; Soumya,12,0,32,20
1658003294388,MATH 20E,A02,083772,Ganguly; Soumya,7,0,32,25
1658003294388,MATH 20E,B01,083773,Ciotti; Benjamin,20,0,35,15
1658003294388,MATH 20E,B02,083774,Ciotti; Benjamin,18,0,35,17
1658003300411,MATH 103A,A01,083777,Greenfeld; Be'Eri,6,0,36,30
1658003300411,MATH 103A,A02,083778,Greenfeld; Be'Eri,5,0,36,31
1658003300411,MATH 103A,A03,093561,Greenfeld; Be'Eri,7,0,36,29
1658003300411,MATH 103A,B01,083779,Greenfeld; Be'Eri,8,0,36,28
1658003300411,MATH 103A,B02,083780,Greenfeld; Be'Eri,4,0,36,32
1658003300411,MATH 103A,B03,093562,Greenfeld; Be'Eri,3,0,36,33
1658003306438,MATH 105,A01,085443,Carter; Anne Toulson,15,0,35,20
1658003306438,MATH 105,A02,093477,Carter; Anne Toulson,20,0,35,15
1658003312466,MATH 109,A01,083213,Ganzberger; Geoffrey Michael,3,0,34,31
1658003312466,MATH 109,A02,083214,Ganzberger; Geoffrey Michael,4,0,34,30
1658003312466,MATH 109,A03,093478,Ganzberger; Geoffrey Michael,2,0,34,32
1658003312466,MATH 109,B01,083215,Ganzberger; Geoffrey Michael,3,0,32,29
1658003312466,MATH 109,B02,083216,Ganzberger; Geoffrey Michael,3,0,32,29
1658003312466,MATH 109,B03,093479,Ganzberger; Geoffrey Michael,8,0,32,24
1658003318499,MATH 142A,A01,083219,Chow; Bennett,7,0,32,25
1658003318499,MATH 142A,A02,083220,Chow; Bennett,10,0,32,22
1658003318499,MATH 142A,A03,093480,Chow; Bennett,9,0,32,23
1658003318499,MATH 142A,B03,093481,Chow; Bennett,8,0,32,24
1658003318499,MATH 142A,B04,093558,Chow; Bennett,14,0,32,18
1658003318499,MATH 142A,B05,093559,Chow; Bennett,7,0,32,25
1658003324524,MATH 193A,A01,083224,Rotar; Vladimir,9,0,34,25
1658003324524,MATH 193A,A02,083225,Rotar; Vladimir,11,0,34,23
1658003324524,MATH 193A,A03,083781,Rotar; Vladimir,5,0,34,29
1658003324524,MATH 193A,A04,083782,Rotar; Vladimir,12,0,34,22
1658003324524,MATH 193A,A05,093482,Rotar; Vladimir,11,0,34,23
1658003330550,MATH 197,001,091859,McAuley; Julian John,9999,0,9999,0
1658003330550,MATH 197,002,095566,Kedlaya; Kiran S.,9997,0,9999,2
1658003330550,MATH 197,003,095567,Xiao; Ming,9999,0,9999,0
1658003330550,MATH 197,004,095571,Perols; Johan Lars,9998,0,9999,1
1658003337610,COGS 9,A01,083615,Shannon; Kyle Michael,11,0,75,64
1658003343634,COGS 11,A01,083617,Boyle; Mary E. T.,23,0,48,25
1658003349657,COGS 13,A01,083071,Bastos; Amalia Pinkusfeld,12,0,71,59
1658003355680,COGS 14A,A01,092681,Semenuks; Arturs,5,1,100,95
1658003361701,COGS 14B,A01,083073,Cheng; Tzu-Han,7,0,63,56
1658003367725,COGS 17,A01,092677,Semenuks; Arturs,7,0,81,74
1658003373752,COGS 100,A01,083619,Allen; Michael Gordon,17,0,70,53
1658003379779,COGS 101A,A01,083621,Davis; Joshua Daniel,9,0,68,59
1658003385801,COGS 101B,A01,091572,Allen; Michael Gordon,14,0,65,51
1658003391823,COGS 101C,A01,083625,Delgado; Tania,17,0,35,18
1658003397846,COGS 107A,A01,083627,Boyle; Mary E. T.,14,0,60,46
1658003403869,COGS 118A,A01,083075,Gupta; Anjum,21,0,76,55
1658003409891,CSE 3,A50,083646,Miranda; Gregory Joseph,24,0,50,26
1658003415914,CSE 8A,A50,083650,Miranda; Gregory Joseph,17,1,56,39
1658003421936,CSE 11,A01,083080,Cao; Yingjun,7,15,40,33
1658003427960,CSE 12,A01,083652,Krause-Levy; Sophia Louisa,30,1,120,90
1658003434058,CSE 15L,A01,083654,Morris; Justin Loren,9,0,50,41
1658003434058,CSE 15L,A02,083655,Morris; Justin Loren,11,0,50,39
1658003440086,CSE 20,A01,083657,Tran; Khoa Dang,39,0,80,41
1658003446110,CSE 21,A01,095574,Bach; Quang Tran,23,0,48,25
1658003452139,CSE 30,A01,083084,Eldon; John,8,0,80,72
1658003452139,CSE 30,B01,095061,Bhaskar; Nishant,9,0,50,41
1658003458163,CSE 100,A01,083659,Cao; Yingjun,5,4,70,65
1658003464199,CSE 134B,A01,083661,Powell; Thomas Allan,25,0,100,75
1658003470226,CSE 140,A01,083663,Gungor; Onat,17,0,85,68
1658003476253,CSE 140L,A01,083088,Eldon; John,23,0,100,77
1658003482308,CSE 175,A01,083665,Kumar; Rakesh,3,0,25,22
1658003488331,CSE 190,A00,092507,Dubnov; Shlomo,8,0,20,12
1658003494355,ECE 45,A01,083139,Congero; Spencer William,7,0,75,68
1658003500383,ECE 65,A50,083695,Saad; Andrew S,12,0,30,18
1658003500383,ECE 65,A51,095125,Saad; Andrew S,24,0,26,2
1658003506411,ECE 109,A01,091882,Touri; Behrouz,21,0,70,49
1658003512435,ECE 180,A00,083140,Abi Samra; Nicholas Camill,1,0,30,29
1658003512435,ECE 180,B00,083141,Abi Samra; Nicholas Camill,0,0,30,30
1658003518457,MATH 10A,A01,083735,Patchell; Gregory David,2,0,30,28
1658003518457,MATH 10A,A02,083736,Patchell; Gregory David,20,0,30,10
1658003518457,MATH 10A,A03,083737,Patchell; Gregory David,16,0,30,14
1658003524482,MATH 10B,A01,083207,Lim; Seonhee,9,0,34,25
1658003524482,MATH 10B,A02,083208,Lim; Seonhee,10,0,35,25
1658003524482,MATH 10B,A03,093472,Lim; Seonhee,7,0,34,27
1658003524482,MATH 10B,B01,083739,Sinha; Shubham,14,0,30,16
1658003530507,MATH 18,A01,083743,Cinel; Cameron Alexander,9,0,30,21
1658003530507,MATH 18,A02,083744,Cinel; Cameron Alexander,18,0,30,12
1658003530507,MATH 18,A03,083745,Cinel; Cameron Alexander,10,0,30,20
1658003530507,MATH 18,B01,083748,Rideout; David Porter,5,0,37,32
1658003530507,MATH 18,B02,083749,Rideout; David Porter,5,0,36,31
1658003530507,MATH 18,B03,083750,Rideout; David Porter,3,0,37,34
1658003530507,MATH 18,B04,083751,Rideout; David Porter,7,0,36,29
1658003530507,MATH 18,B05,093473,Rideout; David Porter,7,0,36,29
1658003530507,MATH 18,B06,093474,Rideout; David Porter,6,0,36,30
1658003536532,MATH 20A,A01,083754,Zheng; Zequn,14,0,40,26
1658003542555,MATH 20B,A01,083756,Briones; Jor-el Thomas Caparas,4,0,36,32
1658003542555,MATH 20B,A02,083757,Briones; Jor-el Thomas Caparas,1,0,36,35
1658003542555,MATH 20B,A03,093475,Briones; Jor-el Thomas Caparas,3,0,36,33
1658003548584,MATH 20C,A01,083760,Briones; Jor-el Thomas Caparas,1,0,35,34
1658003548584,MATH 20C,A02,083761,Briones; Jor-el Thomas Caparas,8,0,35,27
1658003548584,MATH 20C,A03,093476,Briones; Jor-el Thomas Caparas,0,1,36,36
1658003548584,MATH 20C,B01,083762,Bach; Quang Tran,1,0,30,29
1658003554607,MATH 20D,A01,083765,Tran; Brian Kha,5,0,30,25
1658003554607,MATH 20D,A02,083766,Tran; Brian Kha,5,0,30,25
1658003554607,MATH 20D,A03,083767,Tran; Brian Kha,6,0,30,24
1658003560632,MATH 20E,A01,083771,Ganguly; Soumya,12,0,32,20
1658003560632,MATH 20E,A02,083772,Ganguly; Soumya,7,0,32,25
1658003560632,MATH 20E,B01,083773,Ciotti; Benjamin,20,0,35,15
1658003560632,MATH 20E,B02,083774,Ciotti; Benjamin,18,0,35,17
1658003566661,MATH 103A,A01,083777,Greenfeld; Be'Eri,6,0,36,30
1658003566661,MATH 103A,A02,083778,Greenfeld; Be'Eri,5,0,36,31
1658003566661,MATH 103A,A03,093561,Greenfeld; Be'Eri,7,0,36,29
1658003566661,MATH 103A,B01,083779,Greenfeld; Be'Eri,8,0,36,28
1658003566661,MATH 103A,B02,083780,Greenfeld; Be'Eri,4,0,36,32
1658003566661,MATH 103A,B03,093562,Greenfeld; Be'Eri,3,0,36,33
1658003572685,MATH 105,A01,085443,Carter; Anne Toulson,15,0,35,20
1658003572685,MATH 105,A02,093477,Carter; Anne Toulson,20,0,35,15
1658003578713,MATH 109,A01,083213,Ganzberger; Geoffrey Michael,3,0,34,31
1658003578713,MATH 109,A02,083214,Ganzberger; Geoffrey Michael,4,0,34,30
1658003578713,MATH 109,A03,093478,Ganzberger; Geoffrey Michael,2,0,34,32
1658003578713,MATH 109,B01,083215,Ganzberger; Geoffrey Michael,3,0,32,29
1658003578713,MATH 109,B02,083216,Ganzberger; Geoffrey Michael,3,0,32,29
1658003578713,MATH 109,B03,093479,Ganzberger; Geoffrey Michael,8,0,32,24
1658003584736,MATH 142A,A01,083219,Chow; Bennett,7,0,32,25
1658003584736,MATH 142A,A02,083220,Chow; Bennett,10,0,32,22
1658003584736,MATH 142A,A03,093480,Chow; Bennett,9,0,32,23
1658003584736,MATH 142A,B03,093481,Chow; Bennett,8,0,32,24
1658003584736,MATH 142A,B04,093558,Chow; Bennett,14,0,32,18
1658003584736,MATH 142A,B05,093559,Chow; Bennett,7,0,32,25
1658003590759,MATH 193A,A01,083224,Rotar; Vladimir,9,0,34,25
1658003590759,MATH 193A,A02,083225,Rotar; Vladimir,11,0,34,23
1658003590759,MATH 193A,A03,083781,Rotar; Vladimir,5,0,34,29
1658003590759,MATH 193A,A04,083782,Rotar; Vladimir,12,0,34,22
1658003590759,MATH 193A,A05,093482,Rotar; Vladimir,11,0,34,23
1658003596782,MATH 197,001,091859,McAuley; Julian John,9999,0,9999,0
1658003596782,MATH 197,002,095566,Kedlaya; Kiran S.,9997,0,9999,2
1658003596782,MATH 197,003,095567,Xiao; Ming,9999,0,9999,0
1658003596782,MATH 197,004,095571,Perols; Johan Lars,9998,0,9999,1
1658003603847,COGS 9,A01,083615,Shannon; Kyle Michael,11,0,75,64
1658003609871,COGS 11,A01,083617,Boyle; Mary E. T.,23,0,48,25
1658003615895,COGS 13,A01,083071,Bastos; Amalia Pinkusfeld,12,0,71,59
1658003621921,COGS 14A,A01,092681,Semenuks; Arturs,5,1,100,95
1658003627946,COGS 14B,A01,083073,Cheng; Tzu-Han,7,0,63,56
1658003633967,COGS 17,A01,092677,Semenuks; Arturs,7,0,81,74
1658003639996,COGS 100,A01,083619,Allen; Michael Gordon,17,0,70,53
1658003646030,COGS 101A,A01,083621,Davis; Joshua Daniel,9,0,68,59
1658003652052,COGS 101B,A01,091572,Allen; Michael Gordon,14,0,65,51
1658003658079,COGS 101C,A01,083625,Delgado; Tania,17,0,35,18
1658003664103,COGS 107A,A01,083627,Boyle; Mary E. T.,14,0,60,46
1658003670130,COGS 118A,A01,083075,Gupta; Anjum,21,0,76,55
1658003676159,CSE 3,A50,083646,Miranda; Gregory Joseph,24,0,50,26
1658003682192,CSE 8A,A50,083650,Miranda; Gregory Joseph,17,1,56,39
1658003688215,CSE 11,A01,083080,Cao; Yingjun,7,15,40,33
1658003694238,CSE 12,A01,083652,Krause-Levy; Sophia Louisa,30,1,120,90
1658003700265,CSE 15L,A01,083654,Morris; Justin Loren,9,0,50,41
1658003700265,CSE 15L,A02,083655,Morris; Justin Loren,11,0,50,39
1658003706294,CSE 20,A01,083657,Tran; Khoa Dang,39,0,80,41
1658003712316,CSE 21,A01,095574,Bach; Quang Tran,23,0,48,25
1658003718346,CSE 30,A01,083084,Eldon; John,8,0,80,72
1658003718346,CSE 30,B01,095061,Bhaskar; Nishant,9,0,50,41
1658003724372,CSE 100,A01,083659,Cao; Yingjun,5,4,70,65
1658003730395,CSE 134B,A01,083661,Powell; Thomas Allan,25,0,100,75
1658003736418,CSE 140,A01,083663,Gungor; Onat,17,0,85,68
1658003742444,CSE 140L,A01,083088,Eldon; John,23,0,100,77
1658003748469,CSE 175,A01,083665,Kumar; Rakesh,3,0,25,22
1658003754495,CSE 190,A00,092507,Dubnov; Shlomo,8,0,20,12
1658003760517,ECE 45,A01,083139,Congero; Spencer William,7,0,75,68
1658003766541,ECE 65,A50,083695,Saad; Andrew S,12,0,30,18
1658003766541,ECE 65,A51,095125,Saad; Andrew S,24,0,26,2
1658003772563,ECE 109,A01,091882,Touri; Behrouz,21,0,70,49
1658003778586,ECE 180,A00,083140,Abi Samra; Nicholas Camill,1,0,30,29
1658003778586,ECE 180,B00,083141,Abi Samra; Nicholas Camill,0,0,30,30
1658003784614,MATH 10A,A01,083735,Patchell; Gregory David,2,0,30,28
1658003784614,MATH 10A,A02,083736,Patchell; Gregory David,20,0,30,10
1658003784614,MATH 10A,A03,083737,Patchell; Gregory David,16,0,30,14
1658003790642,MATH 10B,A01,083207,Lim; Seonhee,9,0,34,25
1658003790642,MATH 10B,A02,083208,Lim; Seonhee,10,0,35,25
1658003790642,MATH 10B,A03,093472,Lim; Seonhee,7,0,34,27
1658003790642,MATH 10B,B01,083739,Sinha; Shubham,14,0,30,16
1658003796673,MATH 18,A01,083743,Cinel; Cameron Alexander,9,0,30,21
1658003796673,MATH 18,A02,083744,Cinel; Cameron Alexander,18,0,30,12
1658003796673,MATH 18,A03,083745,Cinel; Cameron Alexander,10,0,30,20
1658003796673,MATH 18,B01,083748,Rideout; David Porter,5,0,37,32
1658003796673,MATH 18,B02,083749,Rideout; David Porter,5,0,36,31
1658003796673,MATH 18,B03,083750,Rideout; David Porter,3,0,37,34
1658003796673,MATH 18,B04,083751,Rideout; David Porter,7,0,36,29
1658003796673,MATH 18,B05,093473,Rideout; David Porter,7,0,36,29
1658003796673,MATH 18,B06,093474,Rideout; David Porter,6,0,36,30
1658003802700,MATH 20A,A01,083754,Zheng; Zequn,14,0,40,26
1658003808724,MATH 20B,A01,083756,Briones; Jor-el Thomas Caparas,4,0,36,32
1658003808724,MATH 20B,A02,083757,Briones; Jor-el Thomas Caparas,1,0,36,35
1658003808724,MATH 20B,A03,093475,Briones; Jor-el Thomas Caparas,3,0,36,33
1658003814746,MATH 20C,A01,083760,Briones; Jor-el Thomas Caparas,1,0,35,34
1658003814746,MATH 20C,A02,083761,Briones; Jor-el Thomas Caparas,8,0,35,27
1658003814746,MATH 20C,A03,093476,Briones; Jor-el Thomas Caparas,0,1,36,36
1658003814746,MATH 20C,B01,083762,Bach; Quang Tran,1,0,30,29
1658003820774,MATH 20D,A01,083765,Tran; Brian Kha,5,0,30,25
1658003820774,MATH 20D,A02,083766,Tran; Brian Kha,5,0,30,25
1658003820774,MATH 20D,A03,083767,Tran; Brian Kha,6,0,30,24
1658003826799,MATH 20E,A01,083771,Ganguly; Soumya,12,0,32,20
1658003826799,MATH 20E,A02,083772,Ganguly; Soumya,7,0,32,25
1658003826799,MATH 20E,B01,083773,Ciotti; Benjamin,20,0,35,15
1658003826799,MATH 20E,B02,083774,Ciotti; Benjamin,18,0,35,17
1658003832824,MATH 103A,A01,083777,Greenfeld; Be'Eri,6,0,36,30
1658003832824,MATH 103A,A02,083778,Greenfeld; Be'Eri,5,0,36,31
1658003832824,MATH 103A,A03,093561,Greenfeld; Be'Eri,7,0,36,29
1658003832824,MATH 103A,B01,083779,Greenfeld; Be'Eri,8,0,36,28
1658003832824,MATH 103A,B02,083780,Greenfeld; Be'Eri,4,0,36,32
1658003832824,MATH 103A,B03,093562,Greenfeld; Be'Eri,3,0,36,33
1658003838852,MATH 105,A01,085443,Carter; Anne Toulson,15,0,35,20
1658003838852,MATH 105,A02,093477,Carter; Anne Toulson,20,0,35,15
1658003844880,MATH 109,A01,083213,Ganzberger; Geoffrey Michael,3,0,34,31
1658003844880,MATH 109,A02,083214,Ganzberger; Geoffrey Michael,4,0,34,30
1658003844880,MATH 109,A03,093478,Ganzberger; Geoffrey Michael,2,0,34,32
1658003844880,MATH 109,B01,083215,Ganzberger; Geoffrey Michael,3,0,32,29
1658003844880,MATH 109,B02,083216,Ganzberger; Geoffrey Michael,3,0,32,29
1658003844880,MATH 109,B03,093479,Ganzberger; Geoffrey Michael,8,0,32,24
1658003850905,MATH 142A,A01,083219,Chow; Bennett,7,0,32,25
1658003850905,MATH 142A,A02,083220,Chow; Bennett,10,0,32,22
1658003850905,MATH 142A,A03,093480,Chow; Bennett,9,0,32,23
1658003850905,MATH 142A,B03,093481,Chow; Bennett,8,0,32,24
1658003850905,MATH 142A,B04,093558,Chow; Bennett,14,0,32,18
1658003850905,MATH 142A,B05,093559,Chow; Bennett,7,0,32,25
1658003856939,MATH 193A,A01,083224,Rotar; Vladimir,9,0,34,25
1658003856939,MATH 193A,A02,083225,Rotar; Vladimir,11,0,34,23
1658003856939,MATH 193A,A03,083781,Rotar; Vladimir,5,0,34,29
1658003856939,MATH 193A,A04,083782,Rotar; Vladimir,12,0,34,22
1658003856939,MATH 193A,A05,093482,Rotar; Vladimir,11,0,34,23
1658003862962,MATH 197,001,091859,McAuley; Julian John,9999,0,9999,0
1658003862962,MATH 197,002,095566,Kedlaya; Kiran S.,9997,0,9999,2
1658003862962,MATH 197,003,095567,Xiao; Ming,9999,0,9999,0
1658003862962,MATH 197,004,095571,Perols; Johan Lars,9998,0,9999,1
1658003870013,COGS 9,A01,083615,Shannon; Kyle Michael,11,0,75,64
1658003876041,COGS 11,A01,083617,Boyle; Mary E. T.,23,0,48,25
1658003882068,COGS 13,A01,083071,Bastos; Amalia Pinkusfeld,12,0,71,59
1658003888097,COGS 14A,A01,092681,Semenuks; Arturs,5,1,100,95
1658003894125,COGS 14B,A01,083073,Cheng; Tzu-Han,7,0,63,56
1658003900157,COGS 17,A01,092677,Semenuks; Arturs,7,0,81,74
1658003906183,COGS 100,A01,083619,Allen; Michael Gordon,17,0,70,53
1658003912208,COGS 101A,A01,083621,Davis; Joshua Daniel,9,0,68,59
1658003918230,COGS 101B,A01,091572,Allen; Michael Gordon,14,0,65,51
1658003924253,COGS 101C,A01,083625,Delgado; Tania,17,0,35,18
1658003930279,COGS 107A,A01,083627,Boyle; Mary E. T.,14,0,60,46
1658003936304,COGS 118A,A01,083075,Gupta; Anjum,21,0,76,55
1658003942331,CSE 3,A50,083646,Miranda; Gregory Joseph,24,0,50,26
1658003948358,CSE 8A,A50,083650,Miranda; Gregory Joseph,17,1,56,39
1658003954380,CSE 11,A01,083080,Cao; Yingjun,7,15,40,33
1658003960403,CSE 12,A01,083652,Krause-Levy; Sophia Louisa,30,1,120,90
1658003966431,CSE 15L,A01,083654,Morris; Justin Loren,9,0,50,41
1658003966431,CSE 15L,A02,083655,Morris; Justin Loren,11,0,50,39
1658003972454,CSE 20,A01,083657,Tran; Khoa Dang,39,0,80,41
1658003978477,CSE 21,A01,095574,Bach; Quang Tran,23,0,48,25
1658003984498,CSE 30,A01,083084,Eldon; John,8,0,80,72
1658003984498,CSE 30,B01,095061,Bhaskar; Nishant,9,0,50,41
1658003990522,CSE 100,A01,083659,Cao; Yingjun,5,4,70,65
1658003996553,CSE 134B,A01,083661,Powell; Thomas Allan,25,0,100,75
1658004002576,CSE 140,A01,083663,Gungor; Onat,17,0,85,68
1658004008603,CSE 140L,A01,083088,Eldon; John,23,0,100,77
1658004014640,CSE 175,A01,083665,Kumar; Rakesh,3,0,25,22
1658004020666,CSE 190,A00,092507,Dubnov; Shlomo,8,0,20,12
1658004026688,ECE 45,A01,083139,Congero; Spencer William,7,0,75,68
1658004032785,ECE 65,A50,083695,Saad; Andrew S,12,0,30,18
1658004032785,ECE 65,A51,095125,Saad; Andrew S,24,0,26,2
1658004038818,ECE 109,A01,091882,Touri; Behrouz,21,0,70,49
1658004044844,ECE 180,A00,083140,Abi Samra; Nicholas Camill,1,0,30,29
1658004044844,ECE 180,B00,083141,Abi Samra; Nicholas Camill,0,0,30,30
1658004050868,MATH 10A,A01,083735,Patchell; Gregory David,2,0,30,28
1658004050868,MATH 10A,A02,083736,Patchell; Gregory David,20,0,30,10
1658004050868,MATH 10A,A03,083737,Patchell; Gregory David,16,0,30,14
1658004056898,MATH 10B,A01,083207,Lim; Seonhee,9,0,34,25
1658004056898,MATH 10B,A02,083208,Lim; Seonhee,10,0,35,25
1658004056898,MATH 10B,A03,093472,Lim; Seonhee,7,0,34,27
1658004056898,MATH 10B,B01,083739,Sinha; Shubham,14,0,30,16
1658004062922,MATH 18,A01,083743,Cinel; Cameron Alexander,9,0,30,21
1658004062922,MATH 18,A02,083744,Cinel; Cameron Alexander,18,0,30,12
1658004062922,MATH 18,A03,083745,Cinel; Cameron Alexander,10,0,30,20
1658004062922,MATH 18,B01,083748,Rideout; David Porter,5,0,37,32
1658004062922,MATH 18,B02,083749,Rideout; David Porter,5,0,36,31
1658004062922,MATH 18,B03,083750,Rideout; David Porter,3,0,37,34
1658004062922,MATH 18,B04,083751,Rideout; David Porter,7,0,36,29
1658004062922,MATH 18,B05,093473,Rideout; David Porter,7,0,36,29
1658004062922,MATH 18,B06,093474,Rideout; David Porter,6,0,36,30
1658004068949,MATH 20A,A01,083754,Zheng; Zequn,14,0,40,26
1658004074977,MATH 20B,A01,083756,Briones; Jor-el Thomas Caparas,4,0,36,32
1658004074977,MATH 20B,A02,083757,Briones; Jor-el Thomas Caparas,1,0,36,35
1658004074977,MATH 20B,A03,093475,Briones; Jor-el Thomas Caparas,3,0,36,33
1658004081000,MATH 20C,A01,083760,Briones; Jor-el Thomas Caparas,1,0,35,34
1658004081000,MATH 20C,A02,083761,Briones; Jor-el Thomas Caparas,8,0,35,27
1658004081000,MATH 20C,A03,093476,Briones; Jor-el Thomas Caparas,0,1,36,36
1658004081000,MATH 20C,B01,083762,Bach; Quang Tran,1,0,30,29
1658004087022,MATH 20D,A01,083765,Tran; Brian Kha,5,0,30,25
1658004087022,MATH 20D,A02,083766,Tran; Brian Kha,5,0,30,25
1658004087022,MATH 20D,A03,083767,Tran; Brian Kha,6,0,30,24
1658004093046,MATH 20E,A01,083771,Ganguly; Soumya,12,0,32,20
1658004093046,MATH 20E,A02,083772,Ganguly; Soumya,7,0,32,25
1658004093046,MATH 20E,B01,083773,Ciotti; Benjamin,20,0,35,15
1658004093046,MATH 20E,B02,083774,Ciotti; Benjamin,18,0,35,17
1658004099069,MATH 103A,A01,083777,Greenfeld; Be'Eri,6,0,36,30
1658004099069,MATH 103A,A02,083778,Greenfeld; Be'Eri,5,0,36,31
1658004099069,MATH 103A,A03,093561,Greenfeld; Be'Eri,7,0,36,29
1658004099069,MATH 103A,B01,083779,Greenfeld; Be'Eri,8,0,36,28
1658004099069,MATH 103A,B02,083780,Greenfeld; Be'Eri,4,0,36,32
1658004099069,MATH 103A,B03,093562,Greenfeld; Be'Eri,3,0,36,33
1658004105096,MATH 105,A01,085443,Carter; Anne Toulson,15,0,35,20
1658004105096,MATH 105,A02,093477,Carter; Anne Toulson,20,0,35,15
1658004111125,MATH 109,A01,083213,Ganzberger; Geoffrey Michael,3,0,34,31
1658004111125,MATH 109,A02,083214,Ganzberger; Geoffrey Michael,4,0,34,30
1658004111125,MATH 109,A03,093478,Ganzberger; Geoffrey Michael,2,0,34,32
1658004111125,MATH 109,B01,083215,Ganzberger; Geoffrey Michael,3,0,32,29
1658004111125,MATH 109,B02,083216,Ganzberger; Geoffrey Michael,3,0,32,29
1658004111125,MATH 109,B03,093479,Ganzberger; Geoffrey Michael,8,0,32,24
1658004117153,MATH 142A,A01,083219,Chow; Bennett,7,0,32,25
1658004117153,MATH 142A,A02,083220,Chow; Bennett,10,0,32,22
1658004117153,MATH 142A,A03,093480,Chow; Bennett,9,0,32,23
1658004117153,MATH 142A,B03,093481,Chow; Bennett,8,0,32,24
1658004117153,MATH 142A,B04,093558,Chow; Bennett,14,0,32,18
1658004117153,MATH 142A,B05,093559,Chow; Bennett,7,0,32,25
1658004123180,MATH 193A,A01,083224,Rotar; Vladimir,9,0,34,25
1658004123180,MATH 193A,A02,083225,Rotar; Vladimir,11,0,34,23
1658004123180,MATH 193A,A03,083781,Rotar; Vladimir,5,0,34,29
1658004123180,MATH 193A,A04,083782,Rotar; Vladimir,12,0,34,22
1658004123180,MATH 193A,A05,093482,Rotar; Vladimir,11,0,34,23
1658004129207,MATH 197,001,091859,McAuley; Julian John,9999,0,9999,0
1658004129207,MATH 197,002,095566,Kedlaya; Kiran S.,9997,0,9999,2
1658004129207,MATH 197,003,095567,Xiao; Ming,9999,0,9999,0
1658004129207,MATH 197,004,095571,Perols; Johan Lars,9998,0,9999,1
1658004136255,COGS 9,A01,083615,Shannon; Kyle Michael,11,0,75,64
1658004142278,COGS 11,A01,083617,Boyle; Mary E. T.,23,0,48,25
1658004148307,COGS 13,A01,083071,Bastos; Amalia Pinkusfeld,12,0,71,59
1658004154331,COGS 14A,A01,092681,Semenuks; Arturs,5,1,100,95
1658004160361,COGS 14B,A01,083073,Cheng; Tzu-Han,7,0,63,56
1658004166383,COGS 17,A01,092677,Semenuks; Arturs,7,0,81,74
1658004172409,COGS 100,A01,083619,Allen; Michael Gordon,17,0,70,53
1658004178432,COGS 101A,A01,083621,Davis; Joshua Daniel,9,0,68,59
1658004184455,COGS 101B,A01,091572,Allen; Michael Gordon,14,0,65,51
1658004190486,COGS 101C,A01,083625,Delgado; Tania,17,0,35,18
1658004196509,COGS 107A,A01,083627,Boyle; Mary E. T.,14,0,60,46
1658004202549,COGS 118A,A01,083075,Gupta; Anjum,21,0,76,55
1658004208578,CSE 3,A50,083646,Miranda; Gregory Joseph,24,0,50,26
1658004214611,CSE 8A,A50,083650,Miranda; Gregory Joseph,17,1,56,39
1658004220635,CSE 11,A01,083080,Cao; Yingjun,7,15,40,33
1658004226657,CSE 12,A01,083652,Krause-Levy; Sophia Louisa,30,1,120,90
1658004232682,CSE 15L,A01,083654,Morris; Justin Loren,9,0,50,41
1658004232682,CSE 15L,A02,083655,Morris; Justin Loren,11,0,50,39
1658004238706,CSE 20,A01,083657,Tran; Khoa Dang,39,0,80,41
1658004244728,CSE 21,A01,095574,Bach; Quang Tran,23,0,48,25
1658004250757,CSE 30,A01,083084,Eldon; John,8,0,80,72
1658004250757,CSE 30,B01,095061,Bhaskar; Nishant,9,0,50,41
1658004256780,CSE 100,A01,083659,Cao; Yingjun,5,4,70,65
1658004262803,CSE 134B,A01,083661,Powell; Thomas Allan,25,0,100,75
1658004268830,CSE 140,A01,083663,Gungor; Onat,17,0,85,68
1658004274853,CSE 140L,A01,083088,Eldon; John,23,0,100,77
1658004280875,CSE 175,A01,083665,Kumar; Rakesh,3,0,25,22
1658004286899,CSE 190,A00,092507,Dubnov; Shlomo,8,0,20,12
1658004292922,ECE 45,A01,083139,Congero; Spencer William,7,0,75,68
1658004298944,ECE 65,A50,083695,Saad; Andrew S,12,0,30,18
1658004298944,ECE 65,A51,095125,Saad; Andrew S,24,0,26,2
1658004304964,ECE 109,A01,091882,Touri; Behrouz,21,0,70,49
1658004310988,ECE 180,A00,083140,Abi Samra; Nicholas Camill,1,0,30,29
1658004310988,ECE 180,B00,083141,Abi Samra; Nicholas Camill,0,0,30,30
1658004317010,MATH 10A,A01,083735,Patchell; Gregory David,2,0,30,28
1658004317010,MATH 10A,A02,083736,Patchell; Gregory David,20,0,30,10
1658004317010,MATH 10A,A03,083737,Patchell; Gregory David,16,0,30,14
1658004323038,MATH 10B,A01,083207,Lim; Seonhee,9,0,34,25
1658004323038,MATH 10B,A02,083208,Lim; Seonhee,10,0,35,25
1658004323038,MATH 10B,A03,093472,Lim; Seonhee,7,0,34,27
1658004323038,MATH 10B,B01,083739,Sinha; Shubham,14,0,30,16
1658004329067,MATH 18,A01,083743,Cinel; Cameron Alexander,9,0,30,21
1658004329067,MATH 18,A02,083744,Cinel; Cameron Alexander,18,0,30,12
1658004329067,MATH 18,A03,083745,Cinel; Cameron Alexander,10,0,30,20
1658004329067,MATH 18,B01,083748,Rideout; David Porter,5,0,37,32
1658004329067,MATH 18,B02,083749,Rideout; David Porter,5,0,36,31
1658004329067,MATH 18,B03,083750,Rideout; David Porter,3,0,37,34
1658004329067,MATH 18,B04,083751,Rideout; David Porter,7,0,36,29
1658004329067,MATH 18,B05,093473,Rideout; David Porter,7,0,36,29
1658004329067,MATH 18,B06,093474,Rideout; David Porter,6,0,36,30
1658004335090,MATH 20A,A01,083754,Zheng; Zequn,14,0,40,26
1658004341116,MATH 20B,A01,083756,Briones; Jor-el Thomas Caparas,4,0,36,32
1658004341116,MATH 20B,A02,083757,Briones; Jor-el Thomas Caparas,1,0,36,35
1658004341116,MATH 20B,A03,093475,Briones; Jor-el Thomas Caparas,3,0,36,33
1658004347150,MATH 20C,A01,083760,Briones; Jor-el Thomas Caparas,1,0,35,34
1658004347150,MATH 20C,A02,083761,Briones; Jor-el Thomas Caparas,8,0,35,27
1658004347150,MATH 20C,A03,093476,Briones; Jor-el Thomas Caparas,0,1,36,36
1658004347150,MATH 20C,B01,083762,Bach; Quang Tran,1,0,30,29
1658004353172,MATH 20D,A01,083765,Tran; Brian Kha,5,0,30,25
1658004353172,MATH 20D,A02,083766,Tran; Brian Kha,5,0,30,25
1658004353172,MATH 20D,A03,083767,Tran; Brian Kha,6,0,30,24
1658004359199,MATH 20E,A01,083771,Ganguly; Soumya,12,0,32,20
1658004359199,MATH 20E,A02,083772,Ganguly; Soumya,7,0,32,25
1658004359199,MATH 20E,B01,083773,Ciotti; Benjamin,20,0,35,15
1658004359199,MATH 20E,B02,083774,Ciotti; Benjamin,18,0,35,17
1658004365223,MATH 103A,A01,083777,Greenfeld; Be'Eri,6,0,36,30
1658004365223,MATH 103A,A02,083778,Greenfeld; Be'Eri,5,0,36,31
1658004365223,MATH 103A,A03,093561,Greenfeld; Be'Eri,7,0,36,29
1658004365223,MATH 103A,B01,083779,Greenfeld; Be'Eri,8,0,36,28
1658004365223,MATH 103A,B02,083780,Greenfeld; Be'Eri,4,0,36,32
1658004365223,MATH 103A,B03,093562,Greenfeld; Be'Eri,3,0,36,33
1658004371253,MATH 105,A01,085443,Carter; Anne Toulson,15,0,35,20
1658004371253,MATH 105,A02,093477,Carter; Anne Toulson,20,0,35,15
1658004377277,MATH 109,A01,083213,Ganzberger; Geoffrey Michael,3,0,34,31
1658004377277,MATH 109,A02,083214,Ganzberger; Geoffrey Michael,4,0,34,30
1658004377277,MATH 109,A03,093478,Ganzberger; Geoffrey Michael,2,0,34,32
1658004377277,MATH 109,B01,083215,Ganzberger; Geoffrey Michael,3,0,32,29
1658004377277,MATH 109,B02,083216,Ganzberger; Geoffrey Michael,3,0,32,29
1658004377277,MATH 109,B03,093479,Ganzberger; Geoffrey Michael,8,0,32,24
1658004383304,MATH 142A,A01,083219,Chow; Bennett,7,0,32,25
1658004383304,MATH 142A,A02,083220,Chow; Bennett,10,0,32,22
1658004383304,MATH 142A,A03,093480,Chow; Bennett,9,0,32,23
1658004383304,MATH 142A,B03,093481,Chow; Bennett,8,0,32,24
1658004383304,MATH 142A,B04,093558,Chow; Bennett,14,0,32,18
1658004383304,MATH 142A,B05,093559,Chow; Bennett,7,0,32,25
1658004389333,MATH 193A,A01,083224,Rotar; Vladimir,9,0,34,25
1658004389333,MATH 193A,A02,083225,Rotar; Vladimir,11,0,34,23
1658004389333,MATH 193A,A03,083781,Rotar; Vladimir,5,0,34,29
1658004389333,MATH 193A,A04,083782,Rotar; Vladimir,12,0,34,22
1658004389333,MATH 193A,A05,093482,Rotar; Vladimir,11,0,34,23
1658004395360,MATH 197,001,091859,McAuley; Julian John,9999,0,9999,0
1658004395360,MATH 197,002,095566,Kedlaya; Kiran S.,9997,0,9999,2
1658004395360,MATH 197,003,095567,Xiao; Ming,9999,0,9999,0
1658004395360,MATH 197,004,095571,Perols; Johan Lars,9998,0,9999,1
1658004402434,COGS 9,A01,083615,Shannon; Kyle Michael,11,0,75,64
1658004408455,COGS 11,A01,083617,Boyle; Mary E. T.,23,0,48,25
1658004414478,COGS 13,A01,083071,Bastos; Amalia Pinkusfeld,12,0,71,59
1658004420500,COGS 14A,A01,092681,Semenuks; Arturs,5,1,100,95
1658004426526,COGS 14B,A01,083073,Cheng; Tzu-Han,7,0,63,56
1658004432549,COGS 17,A01,092677,Semenuks; Arturs,7,0,81,74
1658004438571,COGS 100,A01,083619,Allen; Michael Gordon,17,0,70,53
1658004444595,COGS 101A,A01,083621,Davis; Joshua Daniel,9,0,68,59
1658004450616,COGS 101B,A01,091572,Allen; Michael Gordon,14,0,65,51
1658004456642,COGS 101C,A01,083625,Delgado; Tania,17,0,35,18
1658004462670,COGS 107A,A01,083627,Boyle; Mary E. T.,14,0,60,46
1658004468692,COGS 118A,A01,083075,Gupta; Anjum,21,0,76,55
1658004474719,CSE 3,A50,083646,Miranda; Gregory Joseph,24,0,50,26
1658004480747,CSE 8A,A50,083650,Miranda; Gregory Joseph,17,1,56,39
1658004486773,CSE 11,A01,083080,Cao; Yingjun,7,15,40,33
1658004492797,CSE 12,A01,083652,Krause-Levy; Sophia Louisa,30,1,120,90
1658004498822,CSE 15L,A01,083654,Morris; Justin Loren,9,0,50,41
1658004498822,CSE 15L,A02,083655,Morris; Justin Loren,11,0,50,39
1658004504849,CSE 20,A01,083657,Tran; Khoa Dang,39,0,80,41
1658004510871,CSE 21,A01,095574,Bach; Quang Tran,23,0,48,25
1658004516896,CSE 30,A01,083084,Eldon; John,8,0,80,72
1658004516896,CSE 30,B01,095061,Bhaskar; Nishant,9,0,50,41
1658004522922,CSE 100,A01,083659,Cao; Yingjun,5,4,70,65
1658004528947,CSE 134B,A01,083661,Powell; Thomas Allan,25,0,100,75
1658004534973,CSE 140,A01,083663,Gungor; Onat,17,0,85,68
1658004541008,CSE 140L,A01,083088,Eldon; John,23,0,100,77
1658004547043,CSE 175,A01,083665,Kumar; Rakesh,3,0,25,22
1658004553069,CSE 190,A00,092507,Dubnov; Shlomo,8,0,20,12
1658004559091,ECE 45,A01,083139,Congero; Spencer William,7,0,75,68
1658004565114,ECE 65,A50,083695,Saad; Andrew S,12,0,30,18
1658004565114,ECE 65,A51,095125,Saad; Andrew S,24,0,26,2
1658004571139,ECE 109,A01,091882,Touri; Behrouz,21,0,70,49
1658004577166,ECE 180,A00,083140,Abi Samra; Nicholas Camill,1,0,30,29
1658004577166,ECE 180,B00,083141,Abi Samra; Nicholas Camill,0,0,30,30
1658004583193,MATH 10A,A01,083735,Patchell; Gregory David,2,0,30,28
1658004583193,MATH 10A,A02,083736,Patchell; Gregory David,20,0,30,10
1658004583193,MATH 10A,A03,083737,Patchell; Gregory David,16,0,30,14
1658004589221,MATH 10B,A01,083207,Lim; Seonhee,9,0,34,25
1658004589221,MATH 10B,A02,083208,Lim; Seonhee,10,0,35,25
1658004589221,MATH 10B,A03,093472,Lim; Seonhee,7,0,34,27
1658004589221,MATH 10B,B01,083739,Sinha; Shubham,14,0,30,16
1658004595244,MATH 18,A01,083743,Cinel; Cameron Alexander,9,0,30,21
1658004595244,MATH 18,A02,083744,Cinel; Cameron Alexander,18,0,30,12
1658004595244,MATH 18,A03,083745,Cinel; Cameron Alexander,10,0,30,20
1658004595244,MATH 18,B01,083748,Rideout; David Porter,5,0,37,32
1658004595244,MATH 18,B02,083749,Rideout; David Porter,5,0,36,31
1658004595244,MATH 18,B03,083750,Rideout; David Porter,3,0,37,34
1658004595244,MATH 18,B04,083751,Rideout; David Porter,7,0,36,29
1658004595244,MATH 18,B05,093473,Rideout; David Porter,7,0,36,29
1658004595244,MATH 18,B06,093474,Rideout; David Porter,6,0,36,30
1658004601270,MATH 20A,A01,083754,Zheng; Zequn,14,0,40,26
1658004607296,MATH 20B,A01,083756,Briones; Jor-el Thomas Caparas,4,0,36,32
1658004607296,MATH 20B,A02,083757,Briones; Jor-el Thomas Caparas,1,0,36,35
1658004607296,MATH 20B,A03,093475,Briones; Jor-el Thomas Caparas,3,0,36,33
1658004613319,MATH 20C,A01,083760,Briones; Jor-el Thomas Caparas,1,0,35,34
1658004613319,MATH 20C,A02,083761,Briones; Jor-el Thomas Caparas,8,0,35,27
1658004613319,MATH 20C,A03,093476,Briones; Jor-el Thomas Caparas,0,1,36,36
1658004613319,MATH 20C,B01,083762,Bach; Quang Tran,1,0,30,29
1658004619342,MATH 20D,A01,083765,Tran; Brian Kha,5,0,30,25
1658004619342,MATH 20D,A02,083766,Tran; Brian Kha,5,0,30,25
1658004619342,MATH 20D,A03,083767,Tran; Brian Kha,6,0,30,24
1658004625369,MATH 20E,A01,083771,Ganguly; Soumya,12,0,32,20
1658004625369,MATH 20E,A02,083772,Ganguly; Soumya,7,0,32,25
1658004625369,MATH 20E,B01,083773,Ciotti; Benjamin,20,0,35,15
1658004625369,MATH 20E,B02,083774,Ciotti; Benjamin,18,0,35,17
1658004631465,MATH 103A,A01,083777,Greenfeld; Be'Eri,6,0,36,30
1658004631465,MATH 103A,A02,083778,Greenfeld; Be'Eri,5,0,36,31
1658004631465,MATH 103A,A03,093561,Greenfeld; Be'Eri,7,0,36,29
1658004631465,MATH 103A,B01,083779,Greenfeld; Be'Eri,8,0,36,28
1658004631465,MATH 103A,B02,083780,Greenfeld; Be'Eri,4,0,36,32
1658004631465,MATH 103A,B03,093562,Greenfeld; Be'Eri,3,0,36,33
1658004637495,MATH 105,A01,085443,Carter; Anne Toulson,15,0,35,20
1658004637495,MATH 105,A02,093477,Carter; Anne Toulson,20,0,35,15
1658004643523,MATH 109,A01,083213,Ganzberger; Geoffrey Michael,3,0,34,31
1658004643523,MATH 109,A02,083214,Ganzberger; Geoffrey Michael,4,0,34,30
1658004643523,MATH 109,A03,093478,Ganzberger; Geoffrey Michael,2,0,34,32
1658004643523,MATH 109,B01,083215,Ganzberger; Geoffrey Michael,3,0,32,29
1658004643523,MATH 109,B02,083216,Ganzberger; Geoffrey Michael,3,0,32,29
1658004643523,MATH 109,B03,093479,Ganzberger; Geoffrey Michael,8,0,32,24
1658004649549,MATH 142A,A01,083219,Chow; Bennett,7,0,32,25
1658004649549,MATH 142A,A02,083220,Chow; Bennett,10,0,32,22
1658004649549,MATH 142A,A03,093480,Chow; Bennett,9,0,32,23
1658004649549,MATH 142A,B03,093481,Chow; Bennett,8,0,32,24
1658004649549,MATH 142A,B04,093558,Chow; Bennett,14,0,32,18
1658004649549,MATH 142A,B05,093559,Chow; Bennett,7,0,32,25
1658004655572,MATH 193A,A01,083224,Rotar; Vladimir,9,0,34,25
1658004655572,MATH 193A,A02,083225,Rotar; Vladimir,11,0,34,23
1658004655572,MATH 193A,A03,083781,Rotar; Vladimir,5,0,34,29
1658004655572,MATH 193A,A04,083782,Rotar; Vladimir,12,0,34,22
1658004655572,MATH 193A,A05,093482,Rotar; Vladimir,11,0,34,23
1658004661599,MATH 197,001,091859,McAuley; Julian John,9999,0,9999,0
1658004661599,MATH 197,002,095566,Kedlaya; Kiran S.,9997,0,9999,2
1658004661599,MATH 197,003,095567,Xiao; Ming,9999,0,9999,0
1658004661599,MATH 197,004,095571,Perols; Johan Lars,9998,0,9999,1
1658004668657,COGS 9,A01,083615,Shannon; Kyle Michael,11,0,75,64
1658004674680,COGS 11,A01,083617,Boyle; Mary E. T.,23,0,48,25
1658004680705,COGS 13,A01,083071,Bastos; Amalia Pinkusfeld,12,0,71,59
1658004686731,COGS 14A,A01,092681,Semenuks; Arturs,5,1,100,95
1658004692752,COGS 14B,A01,083073,Cheng; Tzu-Han,7,0,63,56
1658004698775,COGS 17,A01,092677,Semenuks; Arturs,7,0,81,74
1658004704802,COGS 100,A01,083619,Allen; Michael Gordon,17,0,70,53
1658004710828,COGS 101A,A01,083621,Davis; Joshua Daniel,9,0,68,59
1658004716852,COGS 101B,A01,091572,Allen; Michael Gordon,14,0,65,51
1658004722879,COGS 101C,A01,083625,Delgado; Tania,17,0,35,18
1658004728965,COGS 107A,A01,083627,Boyle; Mary E. T.,14,0,60,46
1658004734987,COGS 118A,A01,083075,Gupta; Anjum,21,0,76,55
1658004741021,CSE 3,A50,083646,Miranda; Gregory Joseph,24,0,50,26
1658004747044,CSE 8A,A50,083650,Miranda; Gregory Joseph,17,1,56,39
1658004753068,CSE 11,A01,083080,Cao; Yingjun,7,15,40,33
1658004759091,CSE 12,A01,083652,Krause-Levy; Sophia Louisa,30,1,120,90
1658004765114,CSE 15L,A01,083654,Morris; Justin Loren,9,0,50,41
1658004765114,CSE 15L,A02,083655,Morris; Justin Loren,11,0,50,39
1658004771137,CSE 20,A01,083657,Tran; Khoa Dang,39,0,80,41
1658004777165,CSE 21,A01,095574,Bach; Quang Tran,23,0,48,25
1658004783189,CSE 30,A01,083084,Eldon; John,8,0,80,72
1658004783189,CSE 30,B01,095061,Bhaskar; Nishant,9,0,50,41
1658004789212,CSE 100,A01,083659,Cao; Yingjun,5,4,70,65
1658004795234,CSE 134B,A01,083661,Powell; Thomas Allan,25,0,100,75
1658004801256,CSE 140,A01,083663,Gungor; Onat,17,0,85,68
1658004807279,CSE 140L,A01,083088,Eldon; John,23,0,100,77
1658004813305,CSE 175,A01,083665,Kumar; Rakesh,3,0,25,22
1658004819328,CSE 190,A00,092507,Dubnov; Shlomo,8,0,20,12
1658004825362,ECE 45,A01,083139,Congero; Spencer William,7,0,75,68
1658004831391,ECE 65,A50,083695,Saad; Andrew S,12,0,30,18
1658004831391,ECE 65,A51,095125,Saad; Andrew S,24,0,26,2
1658004837414,ECE 109,A01,091882,Touri; Behrouz,21,0,70,49
1658004843437,ECE 180,A00,083140,Abi Samra; Nicholas Camill,1,0,30,29
1658004843437,ECE 180,B00,083141,Abi Samra; Nicholas Camill,0,0,30,30
1658004849462,MATH 10A,A01,083735,Patchell; Gregory David,2,0,30,28
1658004849462,MATH 10A,A02,083736,Patchell; Gregory David,20,0,30,10
1658004849462,MATH 10A,A03,083737,Patchell; Gregory David,16,0,30,14
1658004855485,MATH 10B,A01,083207,Lim; Seonhee,9,0,34,25
1658004855485,MATH 10B,A02,083208,Lim; Seonhee,10,0,35,25
1658004855485,MATH 10B,A03,093472,Lim; Seonhee,7,0,34,27
1658004855485,MATH 10B,B01,083739,Sinha; Shubham,14,0,30,16
1658004861513,MATH 18,A01,083743,Cinel; Cameron Alexander,9,0,30,21
1658004861513,MATH 18,A02,083744,Cinel; Cameron Alexander,18,0,30,12
1658004861513,MATH 18,A03,083745,Cinel; Cameron Alexander,10,0,30,20
1658004861513,MATH 18,B01,083748,Rideout; David Porter,5,0,37,32
1658004861513,MATH 18,B02,083749,Rideout; David Porter,5,0,36,31
1658004861513,MATH 18,B03,083750,Rideout; David Porter,3,0,37,34
1658004861513,MATH 18,B04,083751,Rideout; David Porter,7,0,36,29
1658004861513,MATH 18,B05,093473,Rideout; David Porter,7,0,36,29
1658004861513,MATH 18,B06,093474,Rideout; David Porter,6,0,36,30
1658004867536,MATH 20A,A01,083754,Zheng; Zequn,14,0,40,26
1658004873564,MATH 20B,A01,083756,Briones; Jor-el Thomas Caparas,4,0,36,32
1658004873564,MATH 20B,A02,083757,Briones; Jor-el Thomas Caparas,1,0,36,35
1658004873564,MATH 20B,A03,093475,Briones; Jor-el Thomas Caparas,3,0,36,33
1658004879588,MATH 20C,A01,083760,Briones; Jor-el Thomas Caparas,1,0,35,34
1658004879588,MATH 20C,A02,083761,Briones; Jor-el Thomas Caparas,8,0,35,27
1658004879588,MATH 20C,A03,093476,Briones; Jor-el Thomas Caparas,0,1,36,36
1658004879588,MATH 20C,B01,083762,Bach; Quang Tran,1,0,30,29
1658004885616,MATH 20D,A01,083765,Tran; Brian Kha,5,0,30,25
1658004885616,MATH 20D,A02,083766,Tran; Brian Kha,5,0,30,25
1658004885616,MATH 20D,A03,083767,Tran; Brian Kha,6,0,30,24
1658004891638,MATH 20E,A01,083771,Ganguly; Soumya,12,0,32,20
1658004891638,MATH 20E,A02,083772,Ganguly; Soumya,7,0,32,25
1658004891638,MATH 20E,B01,083773,Ciotti; Benjamin,20,0,35,15
1658004891638,MATH 20E,B02,083774,Ciotti; Benjamin,18,0,35,17
1658004897668,MATH 103A,A01,083777,Greenfeld; Be'Eri,6,0,36,30
1658004897668,MATH 103A,A02,083778,Greenfeld; Be'Eri,5,0,36,31
1658004897668,MATH 103A,A03,093561,Greenfeld; Be'Eri,7,0,36,29
1658004897668,MATH 103A,B01,083779,Greenfeld; Be'Eri,8,0,36,28
1658004897668,MATH 103A,B02,083780,Greenfeld; Be'Eri,4,0,36,32
1658004897668,MATH 103A,B03,093562,Greenfeld; Be'Eri,3,0,36,33
1658004903696,MATH 105,A01,085443,Carter; Anne Toulson,15,0,35,20
1658004903696,MATH 105,A02,093477,Carter; Anne Toulson,20,0,35,15
1658004909725,MATH 109,A01,083213,Ganzberger; Geoffrey Michael,3,0,34,31
1658004909725,MATH 109,A02,083214,Ganzberger; Geoffrey Michael,4,0,34,30
1658004909725,MATH 109,A03,093478,Ganzberger; Geoffrey Michael,2,0,34,32
1658004909725,MATH 109,B01,083215,Ganzberger; Geoffrey Michael,3,0,32,29
1658004909725,MATH 109,B02,083216,Ganzberger; Geoffrey Michael,3,0,32,29
1658004909725,MATH 109,B03,093479,Ganzberger; Geoffrey Michael,8,0,32,24
1658004915747,MATH 142A,A01,083219,Chow; Bennett,7,0,32,25
1658004915747,MATH 142A,A02,083220,Chow; Bennett,10,0,32,22
1658004915747,MATH 142A,A03,093480,Chow; Bennett,9,0,32,23
1658004915747,MATH 142A,B03,093481,Chow; Bennett,8,0,32,24
1658004915747,MATH 142A,B04,093558,Chow; Bennett,14,0,32,18
1658004915747,MATH 142A,B05,093559,Chow; Bennett,7,0,32,25
1658004921772,MATH 193A,A01,083224,Rotar; Vladimir,9,0,34,25
1658004921772,MATH 193A,A02,083225,Rotar; Vladimir,11,0,34,23
1658004921772,MATH 193A,A03,083781,Rotar; Vladimir,5,0,34,29
1658004921772,MATH 193A,A04,083782,Rotar; Vladimir,12,0,34,22
1658004921772,MATH 193A,A05,093482,Rotar; Vladimir,11,0,34,23
1658004927795,MATH 197,001,091859,McAuley; Julian John,9999,0,9999,0
1658004927795,MATH 197,002,095566,Kedlaya; Kiran S.,9997,0,9999,2
1658004927795,MATH 197,003,095567,Xiao; Ming,9999,0,9999,0
1658004927795,MATH 197,004,095571,Perols; Johan Lars,9998,0,9999,1
1658004934863,COGS 9,A01,083615,Shannon; Kyle Michael,11,0,75,64
1658004940885,COGS 11,A01,083617,Boyle; Mary E. T.,23,0,48,25
1658004946908,COGS 13,A01,083071,Bastos; Amalia Pinkusfeld,12,0,71,59
1658004952935,COGS 14A,A01,092681,Semenuks; Arturs,5,1,100,95
1658004958958,COGS 14B,A01,083073,Cheng; Tzu-Han,7,0,63,56
1658004964980,COGS 17,A01,092677,Semenuks; Arturs,7,0,81,74
1658004971002,COGS 100,A01,083619,Allen; Michael Gordon,17,0,70,53
1658004977026,COGS 101A,A01,083621,Davis; Joshua Daniel,9,0,68,59
1658004983055,COGS 101B,A01,091572,Allen; Michael Gordon,14,0,65,51
1658004989077,COGS 101C,A01,083625,Delgado; Tania,17,0,35,18
1658004995103,COGS 107A,A01,083627,Boyle; Mary E. T.,14,0,60,46
1658005001126,COGS 118A,A01,083075,Gupta; Anjum,21,0,76,55
1658005007153,CSE 3,A50,083646,Miranda; Gregory Joseph,24,0,50,26
1658005013177,CSE 8A,A50,083650,Miranda; Gregory Joseph,17,1,56,39
1658005019200,CSE 11,A01,083080,Cao; Yingjun,7,15,40,33
1658005025227,CSE 12,A01,083652,Krause-Levy; Sophia Louisa,30,1,120,90
1658005031251,CSE 15L,A01,083654,Morris; Justin Loren,9,0,50,41
1658005031251,CSE 15L,A02,083655,Morris; Justin Loren,11,0,50,39
1658005037274,CSE 20,A01,083657,Tran; Khoa Dang,39,0,80,41
1658005043304,CSE 21,A01,095574,Bach; Quang Tran,23,0,48,25
1658005049333,CSE 30,A01,083084,Eldon; John,8,0,80,72
1658005049333,CSE 30,B01,095061,Bhaskar; Nishant,9,0,50,41
1658005055358,CSE 100,A01,083659,Cao; Yingjun,5,4,70,65
1658005061382,CSE 134B,A01,083661,Powell; Thomas Allan,25,0,100,75
1658005067408,CSE 140,A01,083663,Gungor; Onat,17,0,85,68
1658005073432,CSE 140L,A01,083088,Eldon; John,23,0,100,77
1658005079454,CSE 175,A01,083665,Kumar; Rakesh,3,0,25,22
1658005085478,CSE 190,A00,092507,Dubnov; Shlomo,8,0,20,12
1658005091512,ECE 45,A01,083139,Congero; Spencer William,7,0,75,68
1658005097535,ECE 65,A50,083695,Saad; Andrew S,12,0,30,18
1658005097535,ECE 65,A51,095125,Saad; Andrew S,24,0,26,2
1658005103557,ECE 109,A01,091882,Touri; Behrouz,21,0,70,49
1658005109580,ECE 180,A00,083140,Abi Samra; Nicholas Camill,1,0,30,29
1658005109580,ECE 180,B00,083141,Abi Samra; Nicholas Camill,0,0,30,30
1658005115603,MATH 10A,A01,083735,Patchell; Gregory David,2,0,30,28
1658005115603,MATH 10A,A02,083736,Patchell; Gregory David,20,0,30,10
1658005115603,MATH 10A,A03,083737,Patchell; Gregory David,16,0,30,14
1658005121630,MATH 10B,A01,083207,Lim; Seonhee,9,0,34,25
1658005121630,MATH 10B,A02,083208,Lim; Seonhee,10,0,35,25
1658005121630,MATH 10B,A03,093472,Lim; Seonhee,7,0,34,27
1658005121630,MATH 10B,B01,083739,Sinha; Shubham,14,0,30,16
1658005127655,MATH 18,A01,083743,Cinel; Cameron Alexander,9,0,30,21
1658005127655,MATH 18,A02,083744,Cinel; Cameron Alexander,18,0,30,12
1658005127655,MATH 18,A03,083745,Cinel; Cameron Alexander,10,0,30,20
1658005127655,MATH 18,B01,083748,Rideout; David Porter,5,0,37,32
1658005127655,MATH 18,B02,083749,Rideout; David Porter,5,0,36,31
1658005127655,MATH 18,B03,083750,Rideout; David Porter,3,0,37,34
1658005127655,MATH 18,B04,083751,Rideout; David Porter,7,0,36,29
1658005127655,MATH 18,B05,093473,Rideout; David Porter,7,0,36,29
1658005127655,MATH 18,B06,093474,Rideout; David Porter,6,0,36,30
1658005133682,MATH 20A,A01,083754,Zheng; Zequn,14,0,40,26
1658005139706,MATH 20B,A01,083756,Briones; Jor-el Thomas Caparas,4,0,36,32
1658005139706,MATH 20B,A02,083757,Briones; Jor-el Thomas Caparas,1,0,36,35
1658005139706,MATH 20B,A03,093475,Briones; Jor-el Thomas Caparas,3,0,36,33
1658005145736,MATH 20C,A01,083760,Briones; Jor-el Thomas Caparas,1,0,35,34
1658005145736,MATH 20C,A02,083761,Briones; Jor-el Thomas Caparas,8,0,35,27
1658005145736,MATH 20C,A03,093476,Briones; Jor-el Thomas Caparas,0,1,36,36
1658005145736,MATH 20C,B01,083762,Bach; Quang Tran,1,0,30,29
1658005151761,MATH 20D,A01,083765,Tran; Brian Kha,5,0,30,25
1658005151761,MATH 20D,A02,083766,Tran; Brian Kha,5,0,30,25
1658005151761,MATH 20D,A03,083767,Tran; Brian Kha,6,0,30,24
1658005157784,MATH 20E,A01,083771,Ganguly; Soumya,12,0,32,20
1658005157784,MATH 20E,A02,083772,Ganguly; Soumya,7,0,32,25
1658005157784,MATH 20E,B01,083773,Ciotti; Benjamin,20,0,35,15
1658005157784,MATH 20E,B02,083774,Ciotti; Benjamin,18,0,35,17
1658005163808,MATH 103A,A01,083777,Greenfeld; Be'Eri,6,0,36,30
1658005163808,MATH 103A,A02,083778,Greenfeld; Be'Eri,5,0,36,31
1658005163808,MATH 103A,A03,093561,Greenfeld; Be'Eri,7,0,36,29
1658005163808,MATH 103A,B01,083779,Greenfeld; Be'Eri,8,0,36,28
1658005163808,MATH 103A,B02,083780,Greenfeld; Be'Eri,4,0,36,32
1658005163808,MATH 103A,B03,093562,Greenfeld; Be'Eri,3,0,36,33
1658005169834,MATH 105,A01,085443,Carter; Anne Toulson,15,0,35,20
1658005169834,MATH 105,A02,093477,Carter; Anne Toulson,20,0,35,15
1658005175861,MATH 109,A01,083213,Ganzberger; Geoffrey Michael,3,0,34,31
1658005175861,MATH 109,A02,083214,Ganzberger; Geoffrey Michael,4,0,34,30
1658005175861,MATH 109,A03,093478,Ganzberger; Geoffrey Michael,2,0,34,32
1658005175861,MATH 109,B01,083215,Ganzberger; Geoffrey Michael,3,0,32,29
1658005175861,MATH 109,B02,083216,Ganzberger; Geoffrey Michael,3,0,32,29
1658005175861,MATH 109,B03,093479,Ganzberger; Geoffrey Michael,8,0,32,24
1658005181885,MATH 142A,A01,083219,Chow; Bennett,7,0,32,25
1658005181885,MATH 142A,A02,083220,Chow; Bennett,10,0,32,22
1658005181885,MATH 142A,A03,093480,Chow; Bennett,9,0,32,23
1658005181885,MATH 142A,B03,093481,Chow; Bennett,8,0,32,24
1658005181885,MATH 142A,B04,093558,Chow; Bennett,14,0,32,18
1658005181885,MATH 142A,B05,093559,Chow; Bennett,7,0,32,25
1658005187908,MATH 193A,A01,083224,Rotar; Vladimir,9,0,34,25
1658005187908,MATH 193A,A02,083225,Rotar; Vladimir,11,0,34,23
1658005187908,MATH 193A,A03,083781,Rotar; Vladimir,5,0,34,29
1658005187908,MATH 193A,A04,083782,Rotar; Vladimir,12,0,34,22
1658005187908,MATH 193A,A05,093482,Rotar; Vladimir,11,0,34,23
1658005193932,MATH 197,001,091859,McAuley; Julian John,9999,0,9999,0
1658005193932,MATH 197,002,095566,Kedlaya; Kiran S.,9997,0,9999,2
1658005193932,MATH 197,003,095567,Xiao; Ming,9999,0,9999,0
1658005193932,MATH 197,004,095571,Perols; Johan Lars,9998,0,9999,1
1658005200986,COGS 9,A01,083615,Shannon; Kyle Michael,11,0,75,64
1658005207009,COGS 11,A01,083617,Boyle; Mary E. T.,23,0,48,25
1658005213031,COGS 13,A01,083071,Bastos; Amalia Pinkusfeld,12,0,71,59
1658005219068,COGS 14A,A01,092681,Semenuks; Arturs,5,1,100,95
1658005225185,COGS 14B,A01,083073,Cheng; Tzu-Han,7,0,63,56
1658005231207,COGS 17,A01,092677,Semenuks; Arturs,7,0,81,74
1658005237233,COGS 100,A01,083619,Allen; Michael Gordon,17,0,70,53
1658005243260,COGS 101A,A01,083621,Davis; Joshua Daniel,9,0,68,59
1658005249283,COGS 101B,A01,091572,Allen; Michael Gordon,14,0,65,51
1658005255307,COGS 101C,A01,083625,Delgado; Tania,17,0,35,18
1658005261332,COGS 107A,A01,083627,Boyle; Mary E. T.,14,0,60,46
1658005267354,COGS 118A,A01,083075,Gupta; Anjum,21,0,76,55
1658005273378,CSE 3,A50,083646,Miranda; Gregory Joseph,24,0,50,26
1658005279405,CSE 8A,A50,083650,Miranda; Gregory Joseph,17,1,56,39
1658005285427,CSE 11,A01,083080,Cao; Yingjun,7,15,40,33
1658005291454,CSE 12,A01,083652,Krause-Levy; Sophia Louisa,30,1,120,90
1658005297477,CSE 15L,A01,083654,Morris; Justin Loren,9,0,50,41
1658005297477,CSE 15L,A02,083655,Morris; Justin Loren,11,0,50,39
1658005303499,CSE 20,A01,083657,Tran; Khoa Dang,39,0,80,41
1658005309526,CSE 21,A01,095574,Bach; Quang Tran,23,0,48,25
1658005315553,CSE 30,A01,083084,Eldon; John,8,0,80,72
1658005315553,CSE 30,B01,095061,Bhaskar; Nishant,9,0,50,41
1658005321578,CSE 100,A01,083659,Cao; Yingjun,5,4,70,65
1658005327600,CSE 134B,A01,083661,Powell; Thomas Allan,25,0,100,75
1658005333623,CSE 140,A01,083663,Gungor; Onat,17,0,85,68
1658005339647,CSE 140L,A01,083088,Eldon; John,23,0,100,77
1658005345668,CSE 175,A01,083665,Kumar; Rakesh,3,0,25,22
1658005351690,CSE 190,A00,092507,Dubnov; Shlomo,8,0,20,12
1658005357711,ECE 45,A01,083139,Congero; Spencer William,7,0,75,68
1658005363736,ECE 65,A50,083695,Saad; Andrew S,12,0,30,18
1658005363736,ECE 65,A51,095125,Saad; Andrew S,24,0,26,2
1658005369758,ECE 109,A01,091882,Touri; Behrouz,21,0,70,49
1658005375784,ECE 180,A00,083140,Abi Samra; Nicholas Camill,1,0,30,29
1658005375784,ECE 180,B00,083141,Abi Samra; Nicholas Camill,0,0,30,30
1658005381810,MATH 10A,A01,083735,Patchell; Gregory David,2,0,30,28
1658005381810,MATH 10A,A02,083736,Patchell; Gregory David,20,0,30,10
1658005381810,MATH 10A,A03,083737,Patchell; Gregory David,16,0,30,14
1658005387832,MATH 10B,A01,083207,Lim; Seonhee,9,0,34,25
1658005387832,MATH 10B,A02,083208,Lim; Seonhee,10,0,35,25
1658005387832,MATH 10B,A03,093472,Lim; Seonhee,7,0,34,27
1658005387832,MATH 10B,B01,083739,Sinha; Shubham,14,0,30,16
1658005393855,MATH 18,A01,083743,Cinel; Cameron Alexander,9,0,30,21
1658005393855,MATH 18,A02,083744,Cinel; Cameron Alexander,18,0,30,12
1658005393855,MATH 18,A03,083745,Cinel; Cameron Alexander,10,0,30,20
1658005393855,MATH 18,B01,083748,Rideout; David Porter,5,0,37,32
1658005393855,MATH 18,B02,083749,Rideout; David Porter,5,0,36,31
1658005393855,MATH 18,B03,083750,Rideout; David Porter,3,0,37,34
1658005393855,MATH 18,B04,083751,Rideout; David Porter,7,0,36,29
1658005393855,MATH 18,B05,093473,Rideout; David Porter,7,0,36,29
1658005393855,MATH 18,B06,093474,Rideout; David Porter,6,0,36,30
1658005399882,MATH 20A,A01,083754,Zheng; Zequn,14,0,40,26
1658005405912,MATH 20B,A01,083756,Briones; Jor-el Thomas Caparas,4,0,36,32
1658005405912,MATH 20B,A02,083757,Briones; Jor-el Thomas Caparas,1,0,36,35
1658005405912,MATH 20B,A03,093475,Briones; Jor-el Thomas Caparas,3,0,36,33
1658005411937,MATH 20C,A01,083760,Briones; Jor-el Thomas Caparas,1,0,35,34
1658005411937,MATH 20C,A02,083761,Briones; Jor-el Thomas Caparas,8,0,35,27
1658005411937,MATH 20C,A03,093476,Briones; Jor-el Thomas Caparas,0,1,36,36
1658005411937,MATH 20C,B01,083762,Bach; Quang Tran,1,0,30,29
1658005417962,MATH 20D,A01,083765,Tran; Brian Kha,5,0,30,25
1658005417962,MATH 20D,A02,083766,Tran; Brian Kha,5,0,30,25
1658005417962,MATH 20D,A03,083767,Tran; Brian Kha,6,0,30,24
1658005423990,MATH 20E,A01,083771,Ganguly; Soumya,12,0,32,20
1658005423990,MATH 20E,A02,083772,Ganguly; Soumya,7,0,32,25
1658005423990,MATH 20E,B01,083773,Ciotti; Benjamin,20,0,35,15
1658005423990,MATH 20E,B02,083774,Ciotti; Benjamin,18,0,35,17
1658005430026,MATH 103A,A01,083777,Greenfeld; Be'Eri,6,0,36,30
1658005430026,MATH 103A,A02,083778,Greenfeld; Be'Eri,5,0,36,31
1658005430026,MATH 103A,A03,093561,Greenfeld; Be'Eri,7,0,36,29
1658005430026,MATH 103A,B01,083779,Greenfeld; Be'Eri,8,0,36,28
1658005430026,MATH 103A,B02,083780,Greenfeld; Be'Eri,4,0,36,32
1658005430026,MATH 103A,B03,093562,Greenfeld; Be'Eri,3,0,36,33
1658005436051,MATH 105,A01,085443,Carter; Anne Toulson,15,0,35,20
1658005436051,MATH 105,A02,093477,Carter; Anne Toulson,20,0,35,15
1658005442075,MATH 109,A01,083213,Ganzberger; Geoffrey Michael,3,0,34,31
1658005442075,MATH 109,A02,083214,Ganzberger; Geoffrey Michael,4,0,34,30
1658005442075,MATH 109,A03,093478,Ganzberger; Geoffrey Michael,2,0,34,32
1658005442075,MATH 109,B01,083215,Ganzberger; Geoffrey Michael,3,0,32,29
1658005442075,MATH 109,B02,083216,Ganzberger; Geoffrey Michael,3,0,32,29
1658005442075,MATH 109,B03,093479,Ganzberger; Geoffrey Michael,8,0,32,24
1658005448100,MATH 142A,A01,083219,Chow; Bennett,7,0,32,25
1658005448100,MATH 142A,A02,083220,Chow; Bennett,10,0,32,22
1658005448100,MATH 142A,A03,093480,Chow; Bennett,9,0,32,23
1658005448100,MATH 142A,B03,093481,Chow; Bennett,8,0,32,24
1658005448100,MATH 142A,B04,093558,Chow; Bennett,14,0,32,18
1658005448100,MATH 142A,B05,093559,Chow; Bennett,7,0,32,25
1658005454123,MATH 193A,A01,083224,Rotar; Vladimir,9,0,34,25
1658005454123,MATH 193A,A02,083225,Rotar; Vladimir,11,0,34,23
1658005454123,MATH 193A,A03,083781,Rotar; Vladimir,5,0,34,29
1658005454123,MATH 193A,A04,083782,Rotar; Vladimir,12,0,34,22
1658005454123,MATH 193A,A05,093482,Rotar; Vladimir,11,0,34,23
1658005460148,MATH 197,001,091859,McAuley; Julian John,9999,0,9999,0
1658005460148,MATH 197,002,095566,Kedlaya; Kiran S.,9997,0,9999,2
1658005460148,MATH 197,003,095567,Xiao; Ming,9999,0,9999,0
1658005460148,MATH 197,004,095571,Perols; Johan Lars,9998,0,9999,1
1658005467207,COGS 9,A01,083615,Shannon; Kyle Michael,11,0,75,64
1658005473237,COGS 11,A01,083617,Boyle; Mary E. T.,23,0,48,25
1658005479271,COGS 13,A01,083071,Bastos; Amalia Pinkusfeld,12,0,71,59
1658005485298,COGS 14A,A01,092681,Semenuks; Arturs,5,1,100,95
1658005491324,COGS 14B,A01,083073,Cheng; Tzu-Han,7,0,63,56
1658005497359,COGS 17,A01,092677,Semenuks; Arturs,7,0,81,74
1658005503387,COGS 100,A01,083619,Allen; Michael Gordon,17,0,70,53
1658005509416,COGS 101A,A01,083621,Davis; Joshua Daniel,9,0,68,59
1658005515442,COGS 101B,A01,091572,Allen; Michael Gordon,14,0,65,51
1658005521468,COGS 101C,A01,083625,Delgado; Tania,17,0,35,18
1658005527494,COGS 107A,A01,083627,Boyle; Mary E. T.,14,0,60,46
1658005533519,COGS 118A,A01,083075,Gupta; Anjum,21,0,76,55
1658005539543,CSE 3,A50,083646,Miranda; Gregory Joseph,24,0,50,26
1658005545566,CSE 8A,A50,083650,Miranda; Gregory Joseph,17,1,56,39
1658005551590,CSE 11,A01,083080,Cao; Yingjun,7,15,40,33
1658005557619,CSE 12,A01,083652,Krause-Levy; Sophia Louisa,30,1,120,90
1658005563645,CSE 15L,A01,083654,Morris; Justin Loren,9,0,50,41
1658005563645,CSE 15L,A02,083655,Morris; Justin Loren,11,0,50,39
1658005569668,CSE 20,A01,083657,Tran; Khoa Dang,39,0,80,41
1658005575692,CSE 21,A01,095574,Bach; Quang Tran,23,0,48,25
1658005581715,CSE 30,A01,083084,Eldon; John,8,0,80,72
1658005581715,CSE 30,B01,095061,Bhaskar; Nishant,9,0,50,41
1658005587737,CSE 100,A01,083659,Cao; Yingjun,5,4,70,65
1658005593772,CSE 134B,A01,083661,Powell; Thomas Allan,25,0,100,75
1658005599795,CSE 140,A01,083663,Gungor; Onat,17,0,85,68
1658005605819,CSE 140L,A01,083088,Eldon; John,23,0,100,77
1658005611845,CSE 175,A01,083665,Kumar; Rakesh,3,0,25,22
1658005617871,CSE 190,A00,092507,Dubnov; Shlomo,8,0,20,12
1658005623894,ECE 45,A01,083139,Congero; Spencer William,7,0,75,68
1658005629918,ECE 65,A50,083695,Saad; Andrew S,12,0,30,18
1658005629918,ECE 65,A51,095125,Saad; Andrew S,24,0,26,2
1658005635957,ECE 109,A01,091882,Touri; Behrouz,21,0,70,49
1658005641984,ECE 180,A00,083140,Abi Samra; Nicholas Camill,1,0,30,29
1658005641984,ECE 180,B00,083141,Abi Samra; Nicholas Camill,0,0,30,30
1658005648009,MATH 10A,A01,083735,Patchell; Gregory David,2,0,30,28
1658005648009,MATH 10A,A02,083736,Patchell; Gregory David,20,0,30,10
1658005648009,MATH 10A,A03,083737,Patchell; Gregory David,16,0,30,14
1658005654031,MATH 10B,A01,083207,Lim; Seonhee,9,0,34,25
1658005654031,MATH 10B,A02,083208,Lim; Seonhee,10,0,35,25
1658005654031,MATH 10B,A03,093472,Lim; Seonhee,7,0,34,27
1658005654031,MATH 10B,B01,083739,Sinha; Shubham,14,0,30,16
1658005660060,MATH 18,A01,083743,Cinel; Cameron Alexander,9,0,30,21
1658005660060,MATH 18,A02,083744,Cinel; Cameron Alexander,18,0,30,12
1658005660060,MATH 18,A03,083745,Cinel; Cameron Alexander,10,0,30,20
1658005660060,MATH 18,B01,083748,Rideout; David Porter,5,0,37,32
1658005660060,MATH 18,B02,083749,Rideout; David Porter,5,0,36,31
1658005660060,MATH 18,B03,083750,Rideout; David Porter,3,0,37,34
1658005660060,MATH 18,B04,083751,Rideout; David Porter,7,0,36,29
1658005660060,MATH 18,B05,093473,Rideout; David Porter,7,0,36,29
1658005660060,MATH 18,B06,093474,Rideout; David Porter,6,0,36,30
1658005666083,MATH 20A,A01,083754,Zheng; Zequn,14,0,40,26
1658005672106,MATH 20B,A01,083756,Briones; Jor-el Thomas Caparas,4,0,36,32
1658005672106,MATH 20B,A02,083757,Briones; Jor-el Thomas Caparas,1,0,36,35
1658005672106,MATH 20B,A03,093475,Briones; Jor-el Thomas Caparas,3,0,36,33
1658005678130,MATH 20C,A01,083760,Briones; Jor-el Thomas Caparas,1,0,35,34
1658005678130,MATH 20C,A02,083761,Briones; Jor-el Thomas Caparas,8,0,35,27
1658005678130,MATH 20C,A03,093476,Briones; Jor-el Thomas Caparas,0,1,36,36
1658005678130,MATH 20C,B01,083762,Bach; Quang Tran,1,0,30,29
1658005684152,MATH 20D,A01,083765,Tran; Brian Kha,5,0,30,25
1658005684152,MATH 20D,A02,083766,Tran; Brian Kha,5,0,30,25
1658005684152,MATH 20D,A03,083767,Tran; Brian Kha,6,0,30,24
1658005690177,MATH 20E,A01,083771,Ganguly; Soumya,12,0,32,20
1658005690177,MATH 20E,A02,083772,Ganguly; Soumya,7,0,32,25
1658005690177,MATH 20E,B01,083773,Ciotti; Benjamin,20,0,35,15
1658005690177,MATH 20E,B02,083774,Ciotti; Benjamin,18,0,35,17
1658005696205,MATH 103A,A01,083777,Greenfeld; Be'Eri,6,0,36,30
1658005696205,MATH 103A,A02,083778,Greenfeld; Be'Eri,5,0,36,31
1658005696205,MATH 103A,A03,093561,Greenfeld; Be'Eri,7,0,36,29
1658005696205,MATH 103A,B01,083779,Greenfeld; Be'Eri,8,0,36,28
1658005696205,MATH 103A,B02,083780,Greenfeld; Be'Eri,4,0,36,32
1658005696205,MATH 103A,B03,093562,Greenfeld; Be'Eri,3,0,36,33
1658005702229,MATH 105,A01,085443,Carter; Anne Toulson,15,0,35,20
1658005702229,MATH 105,A02,093477,Carter; Anne Toulson,20,0,35,15
1658005708254,MATH 109,A01,083213,Ganzberger; Geoffrey Michael,3,0,34,31
1658005708254,MATH 109,A02,083214,Ganzberger; Geoffrey Michael,4,0,34,30
1658005708254,MATH 109,A03,093478,Ganzberger; Geoffrey Michael,2,0,34,32
1658005708254,MATH 109,B01,083215,Ganzberger; Geoffrey Michael,3,0,32,29
1658005708254,MATH 109,B02,083216,Ganzberger; Geoffrey Michael,3,0,32,29
1658005708254,MATH 109,B03,093479,Ganzberger; Geoffrey Michael,8,0,32,24
1658005714279,MATH 142A,A01,083219,Chow; Bennett,7,0,32,25
1658005714279,MATH 142A,A02,083220,Chow; Bennett,10,0,32,22
1658005714279,MATH 142A,A03,093480,Chow; Bennett,9,0,32,23
1658005714279,MATH 142A,B03,093481,Chow; Bennett,8,0,32,24
1658005714279,MATH 142A,B04,093558,Chow; Bennett,14,0,32,18
1658005714279,MATH 142A,B05,093559,Chow; Bennett,7,0,32,25
1658005720309,MATH 193A,A01,083224,Rotar; Vladimir,9,0,34,25
1658005720309,MATH 193A,A02,083225,Rotar; Vladimir,11,0,34,23
1658005720309,MATH 193A,A03,083781,Rotar; Vladimir,5,0,34,29
1658005720309,MATH 193A,A04,083782,Rotar; Vladimir,12,0,34,22
1658005720309,MATH 193A,A05,093482,Rotar; Vladimir,11,0,34,23
1658005726331,MATH 197,001,091859,McAuley; Julian John,9999,0,9999,0
1658005726331,MATH 197,002,095566,Kedlaya; Kiran S.,9997,0,9999,2
1658005726331,MATH 197,003,095567,Xiao; Ming,9999,0,9999,0
1658005726331,MATH 197,004,095571,Perols; Johan Lars,9998,0,9999,1
1658005733387,COGS 9,A01,083615,Shannon; Kyle Michael,11,0,75,64
1658005739415,COGS 11,A01,083617,Boyle; Mary E. T.,23,0,48,25
1658005745446,COGS 13,A01,083071,Bastos; Amalia Pinkusfeld,12,0,71,59
1658005751471,COGS 14A,A01,092681,Semenuks; Arturs,5,1,100,95
1658005757499,COGS 14B,A01,083073,Cheng; Tzu-Han,7,0,63,56
1658005763525,COGS 17,A01,092677,Semenuks; Arturs,7,0,81,74
1658005769548,COGS 100,A01,083619,Allen; Michael Gordon,17,0,70,53
1658005775575,COGS 101A,A01,083621,Davis; Joshua Daniel,9,0,68,59
1658005781598,COGS 101B,A01,091572,Allen; Michael Gordon,14,0,65,51
1658005787621,COGS 101C,A01,083625,Delgado; Tania,17,0,35,18
1658005793646,COGS 107A,A01,083627,Boyle; Mary E. T.,14,0,60,46
1658005799668,COGS 118A,A01,083075,Gupta; Anjum,21,0,76,55
1658005805702,CSE 3,A50,083646,Miranda; Gregory Joseph,24,0,50,26
1658005811726,CSE 8A,A50,083650,Miranda; Gregory Joseph,17,1,56,39
1658005817752,CSE 11,A01,083080,Cao; Yingjun,7,15,40,33
1658005823850,CSE 12,A01,083652,Krause-Levy; Sophia Louisa,30,1,120,90
1658005829874,CSE 15L,A01,083654,Morris; Justin Loren,9,0,50,41
1658005829874,CSE 15L,A02,083655,Morris; Justin Loren,11,0,50,39
1658005835896,CSE 20,A01,083657,Tran; Khoa Dang,39,0,80,41
1658005841919,CSE 21,A01,095574,Bach; Quang Tran,23,0,48,25
1658005847942,CSE 30,A01,083084,Eldon; John,8,0,80,72
1658005847942,CSE 30,B01,095061,Bhaskar; Nishant,9,0,50,41
1658005853969,CSE 100,A01,083659,Cao; Yingjun,5,4,70,65
1658005859991,CSE 134B,A01,083661,Powell; Thomas Allan,25,0,100,75
1658005866018,CSE 140,A01,083663,Gungor; Onat,17,0,85,68
1658005872041,CSE 140L,A01,083088,Eldon; John,23,0,100,77
1658005878068,CSE 175,A01,083665,Kumar; Rakesh,3,0,25,22
1658005884091,CSE 190,A00,092507,Dubnov; Shlomo,8,0,20,12
1658005890115,ECE 45,A01,083139,Congero; Spencer William,7,0,75,68
1658005896141,ECE 65,A50,083695,Saad; Andrew S,12,0,30,18
1658005896141,ECE 65,A51,095125,Saad; Andrew S,24,0,26,2
1658005902163,ECE 109,A01,091882,Touri; Behrouz,21,0,70,49
1658005908190,ECE 180,A00,083140,Abi Samra; Nicholas Camill,1,0,30,29
1658005908190,ECE 180,B00,083141,Abi Samra; Nicholas Camill,0,0,30,30
1658005914213,MATH 10A,A01,083735,Patchell; Gregory David,2,0,30,28
1658005914213,MATH 10A,A02,083736,Patchell; Gregory David,20,0,30,10
1658005914213,MATH 10A,A03,083737,Patchell; Gregory David,16,0,30,14
1658005920242,MATH 10B,A01,083207,Lim; Seonhee,9,0,34,25
1658005920242,MATH 10B,A02,083208,Lim; Seonhee,10,0,35,25
1658005920242,MATH 10B,A03,093472,Lim; Seonhee,7,0,34,27
1658005920242,MATH 10B,B01,083739,Sinha; Shubham,14,0,30,16
1658005926273,MATH 18,A01,083743,Cinel; Cameron Alexander,9,0,30,21
1658005926273,MATH 18,A02,083744,Cinel; Cameron Alexander,18,0,30,12
1658005926273,MATH 18,A03,083745,Cinel; Cameron Alexander,10,0,30,20
1658005926273,MATH 18,B01,083748,Rideout; David Porter,5,0,37,32
1658005926273,MATH 18,B02,083749,Rideout; David Porter,5,0,36,31
1658005926273,MATH 18,B03,083750,Rideout; David Porter,3,0,37,34
1658005926273,MATH 18,B04,083751,Rideout; David Porter,7,0,36,29
1658005926273,MATH 18,B05,093473,Rideout; David Porter,7,0,36,29
1658005926273,MATH 18,B06,093474,Rideout; David Porter,6,0,36,30
1658005932296,MATH 20A,A01,083754,Zheng; Zequn,14,0,40,26
1658005938319,MATH 20B,A01,083756,Briones; Jor-el Thomas Caparas,4,0,36,32
1658005938319,MATH 20B,A02,083757,Briones; Jor-el Thomas Caparas,1,0,36,35
1658005938319,MATH 20B,A03,093475,Briones; Jor-el Thomas Caparas,3,0,36,33
1658005944343,MATH 20C,A01,083760,Briones; Jor-el Thomas Caparas,1,0,35,34
1658005944343,MATH 20C,A02,083761,Briones; Jor-el Thomas Caparas,8,0,35,27
1658005944343,MATH 20C,A03,093476,Briones; Jor-el Thomas Caparas,0,1,36,36
1658005944343,MATH 20C,B01,083762,Bach; Quang Tran,1,0,30,29
1658005950367,MATH 20D,A01,083765,Tran; Brian Kha,5,0,30,25
1658005950367,MATH 20D,A02,083766,Tran; Brian Kha,5,0,30,25
1658005950367,MATH 20D,A03,083767,Tran; Brian Kha,6,0,30,24
1658005956396,MATH 20E,A01,083771,Ganguly; Soumya,12,0,32,20
1658005956396,MATH 20E,A02,083772,Ganguly; Soumya,7,0,32,25
1658005956396,MATH 20E,B01,083773,Ciotti; Benjamin,20,0,35,15
1658005956396,MATH 20E,B02,083774,Ciotti; Benjamin,18,0,35,17
1658005962425,MATH 103A,A01,083777,Greenfeld; Be'Eri,6,0,36,30
1658005962425,MATH 103A,A02,083778,Greenfeld; Be'Eri,5,0,36,31
1658005962425,MATH 103A,A03,093561,Greenfeld; Be'Eri,7,0,36,29
1658005962425,MATH 103A,B01,083779,Greenfeld; Be'Eri,8,0,36,28
1658005962425,MATH 103A,B02,083780,Greenfeld; Be'Eri,4,0,36,32
1658005962425,MATH 103A,B03,093562,Greenfeld; Be'Eri,3,0,36,33
1658005968447,MATH 105,A01,085443,Carter; Anne Toulson,15,0,35,20
1658005968447,MATH 105,A02,093477,Carter; Anne Toulson,20,0,35,15
1658005974470,MATH 109,A01,083213,Ganzberger; Geoffrey Michael,3,0,34,31
1658005974470,MATH 109,A02,083214,Ganzberger; Geoffrey Michael,4,0,34,30
1658005974470,MATH 109,A03,093478,Ganzberger; Geoffrey Michael,2,0,34,32
1658005974470,MATH 109,B01,083215,Ganzberger; Geoffrey Michael,3,0,32,29
1658005974470,MATH 109,B02,083216,Ganzberger; Geoffrey Michael,3,0,32,29
1658005974470,MATH 109,B03,093479,Ganzberger; Geoffrey Michael,8,0,32,24
1658005980493,MATH 142A,A01,083219,Chow; Bennett,7,0,32,25
1658005980493,MATH 142A,A02,083220,Chow; Bennett,10,0,32,22
1658005980493,MATH 142A,A03,093480,Chow; Bennett,9,0,32,23
1658005980493,MATH 142A,B03,093481,Chow; Bennett,8,0,32,24
1658005980493,MATH 142A,B04,093558,Chow; Bennett,14,0,32,18
1658005980493,MATH 142A,B05,093559,Chow; Bennett,7,0,32,25
1658005986516,MATH 193A,A01,083224,Rotar; Vladimir,9,0,34,25
1658005986516,MATH 193A,A02,083225,Rotar; Vladimir,11,0,34,23
1658005986516,MATH 193A,A03,083781,Rotar; Vladimir,5,0,34,29
1658005986516,MATH 193A,A04,083782,Rotar; Vladimir,12,0,34,22
1658005986516,MATH 193A,A05,093482,Rotar; Vladimir,11,0,34,23
1658005992538,MATH 197,001,091859,McAuley; Julian John,9999,0,9999,0
1658005992538,MATH 197,002,095566,Kedlaya; Kiran S.,9997,0,9999,2
1658005992538,MATH 197,003,095567,Xiao; Ming,9999,0,9999,0
1658005992538,MATH 197,004,095571,Perols; Johan Lars,9998,0,9999,1
1658005999620,COGS 9,A01,083615,Shannon; Kyle Michael,11,0,75,64
1658006005644,COGS 11,A01,083617,Boyle; Mary E. T.,23,0,48,25
1658006011669,COGS 13,A01,083071,Bastos; Amalia Pinkusfeld,12,0,71,59
1658006017697,COGS 14A,A01,092681,Semenuks; Arturs,5,1,100,95
1658006023720,COGS 14B,A01,083073,Cheng; Tzu-Han,7,0,63,56
1658006029742,COGS 17,A01,092677,Semenuks; Arturs,7,0,81,74
1658006035766,COGS 100,A01,083619,Allen; Michael Gordon,17,0,70,53
1658006041788,COGS 101A,A01,083621,Davis; Joshua Daniel,9,0,68,59
1658006047811,COGS 101B,A01,091572,Allen; Michael Gordon,14,0,65,51
1658006053834,COGS 101C,A01,083625,Delgado; Tania,17,0,35,18
1658006059857,COGS 107A,A01,083627,Boyle; Mary E. T.,14,0,60,46
1658006065881,COGS 118A,A01,083075,Gupta; Anjum,21,0,76,55
1658006071904,CSE 3,A50,083646,Miranda; Gregory Joseph,24,0,50,26
1658006077926,CSE 8A,A50,083650,Miranda; Gregory Joseph,17,1,56,39
1658006083953,CSE 11,A01,083080,Cao; Yingjun,7,15,40,33
1658006089976,CSE 12,A01,083652,Krause-Levy; Sophia Louisa,30,1,120,90
1658006095998,CSE 15L,A01,083654,Morris; Justin Loren,9,0,50,41
1658006095998,CSE 15L,A02,083655,Morris; Justin Loren,11,0,50,39
1658006102030,CSE 20,A01,083657,Tran; Khoa Dang,39,0,80,41
1658006108053,CSE 21,A01,095574,Bach; Quang Tran,23,0,48,25
1658006114084,CSE 30,A01,083084,Eldon; John,8,0,80,72
1658006114084,CSE 30,B01,095061,Bhaskar; Nishant,9,0,50,41
1658006120107,CSE 100,A01,083659,Cao; Yingjun,5,4,70,65
1658006126130,CSE 134B,A01,083661,Powell; Thomas Allan,25,0,100,75
1658006132157,CSE 140,A01,083663,Gungor; Onat,17,0,85,68
1658006138183,CSE 140L,A01,083088,Eldon; John,23,0,100,77
1658006144211,CSE 175,A01,083665,Kumar; Rakesh,3,0,25,22
1658006150235,CSE 190,A00,092507,Dubnov; Shlomo,8,0,20,12
1658006156257,ECE 45,A01,083139,Congero; Spencer William,7,0,75,68
1658006162279,ECE 65,A50,083695,Saad; Andrew S,12,0,30,18
1658006162279,ECE 65,A51,095125,Saad; Andrew S,24,0,26,2
1658006168302,ECE 109,A01,091882,Touri; Behrouz,21,0,70,49
1658006174338,ECE 180,A00,083140,Abi Samra; Nicholas Camill,1,0,30,29
1658006174338,ECE 180,B00,083141,Abi Samra; Nicholas Camill,0,0,30,30
1658006180361,MATH 10A,A01,083735,Patchell; Gregory David,2,0,30,28
1658006180361,MATH 10A,A02,083736,Patchell; Gregory David,20,0,30,10
1658006180361,MATH 10A,A03,083737,Patchell; Gregory David,16,0,30,14
1658006186384,MATH 10B,A01,083207,Lim; Seonhee,9,0,34,25
1658006186384,MATH 10B,A02,083208,Lim; Seonhee,10,0,35,25
1658006186384,MATH 10B,A03,093472,Lim; Seonhee,7,0,34,27
1658006186384,MATH 10B,B01,083739,Sinha; Shubham,14,0,30,16
1658006192424,MATH 18,A01,083743,Cinel; Cameron Alexander,9,0,30,21
1658006192424,MATH 18,A02,083744,Cinel; Cameron Alexander,18,0,30,12
1658006192424,MATH 18,A03,083745,Cinel; Cameron Alexander,10,0,30,20
1658006192424,MATH 18,B01,083748,Rideout; David Porter,5,0,37,32
1658006192424,MATH 18,B02,083749,Rideout; David Porter,5,0,36,31
1658006192424,MATH 18,B03,083750,Rideout; David Porter,3,0,37,34
1658006192424,MATH 18,B04,083751,Rideout; David Porter,7,0,36,29
1658006192424,MATH 18,B05,093473,Rideout; David Porter,7,0,36,29
1658006192424,MATH 18,B06,093474,Rideout; David Porter,6,0,36,30
1658006198450,MATH 20A,A01,083754,Zheng; Zequn,14,0,40,26
1658006204473,MATH 20B,A01,083756,Briones; Jor-el Thomas Caparas,4,0,36,32
1658006204473,MATH 20B,A02,083757,Briones; Jor-el Thomas Caparas,1,0,36,35
1658006204473,MATH 20B,A03,093475,Briones; Jor-el Thomas Caparas,3,0,36,33
1658006210499,MATH 20C,A01,083760,Briones; Jor-el Thomas Caparas,1,0,35,34
1658006210499,MATH 20C,A02,083761,Briones; Jor-el Thomas Caparas,8,0,35,27
1658006210499,MATH 20C,A03,093476,Briones; Jor-el Thomas Caparas,0,1,36,36
1658006210499,MATH 20C,B01,083762,Bach; Quang Tran,1,0,30,29
1658006216523,MATH 20D,A01,083765,Tran; Brian Kha,5,0,30,25
1658006216523,MATH 20D,A02,083766,Tran; Brian Kha,5,0,30,25
1658006216523,MATH 20D,A03,083767,Tran; Brian Kha,6,0,30,24
1658006222547,MATH 20E,A01,083771,Ganguly; Soumya,12,0,32,20
1658006222547,MATH 20E,A02,083772,Ganguly; Soumya,7,0,32,25
1658006222547,MATH 20E,B01,083773,Ciotti; Benjamin,20,0,35,15
1658006222547,MATH 20E,B02,083774,Ciotti; Benjamin,18,0,35,17
1658006228578,MATH 103A,A01,083777,Greenfeld; Be'Eri,6,0,36,30
1658006228578,MATH 103A,A02,083778,Greenfeld; Be'Eri,5,0,36,31
1658006228578,MATH 103A,A03,093561,Greenfeld; Be'Eri,7,0,36,29
1658006228578,MATH 103A,B01,083779,Greenfeld; Be'Eri,8,0,36,28
1658006228578,MATH 103A,B02,083780,Greenfeld; Be'Eri,4,0,36,32
1658006228578,MATH 103A,B03,093562,Greenfeld; Be'Eri,3,0,36,33
1658006234604,MATH 105,A01,085443,Carter; Anne Toulson,15,0,35,20
1658006234604,MATH 105,A02,093477,Carter; Anne Toulson,20,0,35,15
1658006240632,MATH 109,A01,083213,Ganzberger; Geoffrey Michael,3,0,34,31
1658006240632,MATH 109,A02,083214,Ganzberger; Geoffrey Michael,4,0,34,30
1658006240632,MATH 109,A03,093478,Ganzberger; Geoffrey Michael,2,0,34,32
1658006240632,MATH 109,B01,083215,Ganzberger; Geoffrey Michael,3,0,32,29
1658006240632,MATH 109,B02,083216,Ganzberger; Geoffrey Michael,3,0,32,29
1658006240632,MATH 109,B03,093479,Ganzberger; Geoffrey Michael,8,0,32,24
1658006246664,MATH 142A,A01,083219,Chow; Bennett,7,0,32,25
1658006246664,MATH 142A,A02,083220,Chow; Bennett,10,0,32,22
1658006246664,MATH 142A,A03,093480,Chow; Bennett,9,0,32,23
1658006246664,MATH 142A,B03,093481,Chow; Bennett,8,0,32,24
1658006246664,MATH 142A,B04,093558,Chow; Bennett,14,0,32,18
1658006246664,MATH 142A,B05,093559,Chow; Bennett,7,0,32,25
1658006252693,MATH 193A,A01,083224,Rotar; Vladimir,9,0,34,25
1658006252693,MATH 193A,A02,083225,Rotar; Vladimir,11,0,34,23
1658006252693,MATH 193A,A03,083781,Rotar; Vladimir,5,0,34,29
1658006252693,MATH 193A,A04,083782,Rotar; Vladimir,12,0,34,22
1658006252693,MATH 193A,A05,093482,Rotar; Vladimir,11,0,34,23
1658006258715,MATH 197,001,091859,McAuley; Julian John,9999,0,9999,0
1658006258715,MATH 197,002,095566,Kedlaya; Kiran S.,9997,0,9999,2
1658006258715,MATH 197,003,095567,Xiao; Ming,9999,0,9999,0
1658006258715,MATH 197,004,095571,Perols; Johan Lars,9998,0,9999,1
1658006265781,COGS 9,A01,083615,Shannon; Kyle Michael,11,0,75,64
1658006271808,COGS 11,A01,083617,Boyle; Mary E. T.,23,0,48,25
1658006277831,COGS 13,A01,083071,Bastos; Amalia Pinkusfeld,12,0,71,59
1658006283855,COGS 14A,A01,092681,Semenuks; Arturs,5,1,100,95
1658006289881,COGS 14B,A01,083073,Cheng; Tzu-Han,7,0,63,56
1658006295904,COGS 17,A01,092677,Semenuks; Arturs,7,0,81,74
1658006301931,COGS 100,A01,083619,Allen; Michael Gordon,17,0,70,53
1658006307959,COGS 101A,A01,083621,Davis; Joshua Daniel,9,0,68,59
1658006313985,COGS 101B,A01,091572,Allen; Michael Gordon,14,0,65,51
1658006320013,COGS 101C,A01,083625,Delgado; Tania,17,0,35,18
1658006326035,COGS 107A,A01,083627,Boyle; Mary E. T.,14,0,60,46
1658006332056,COGS 118A,A01,083075,Gupta; Anjum,21,0,76,55
1658006338080,CSE 3,A50,083646,Miranda; Gregory Joseph,24,0,50,26
1658006344115,CSE 8A,A50,083650,Miranda; Gregory Joseph,17,1,56,39
1658006350142,CSE 11,A01,083080,Cao; Yingjun,7,15,40,33
1658006356166,CSE 12,A01,083652,Krause-Levy; Sophia Louisa,30,1,120,90
1658006362193,CSE 15L,A01,083654,Morris; Justin Loren,9,0,50,41
1658006362193,CSE 15L,A02,083655,Morris; Justin Loren,11,0,50,39
1658006368221,CSE 20,A01,083657,Tran; Khoa Dang,39,0,80,41
1658006374248,CSE 21,A01,095574,Bach; Quang Tran,23,0,48,25
1658006380270,CSE 30,A01,083084,Eldon; John,8,0,80,72
1658006380270,CSE 30,B01,095061,Bhaskar; Nishant,9,0,50,41
1658006386292,CSE 100,A01,083659,Cao; Yingjun,5,4,70,65
1658006392314,CSE 134B,A01,083661,Powell; Thomas Allan,25,0,100,75
1658006398342,CSE 140,A01,083663,Gungor; Onat,17,0,85,68
1658006404368,CSE 140L,A01,083088,Eldon; John,23,0,100,77
1658006410390,CSE 175,A01,083665,Kumar; Rakesh,3,0,25,22
1658006416413,CSE 190,A00,092507,Dubnov; Shlomo,8,0,20,12
1658006422517,ECE 45,A01,083139,Congero; Spencer William,7,0,75,68
1658006428541,ECE 65,A50,083695,Saad; Andrew S,12,0,30,18
1658006428541,ECE 65,A51,095125,Saad; Andrew S,24,0,26,2
1658006434563,ECE 109,A01,091882,Touri; Behrouz,21,0,70,49
1658006440587,ECE 180,A00,083140,Abi Samra; Nicholas Camill,1,0,30,29
1658006440587,ECE 180,B00,083141,Abi Samra; Nicholas Camill,0,0,30,30
1658006446616,MATH 10A,A01,083735,Patchell; Gregory David,2,0,30,28
1658006446616,MATH 10A,A02,083736,Patchell; Gregory David,20,0,30,10
1658006446616,MATH 10A,A03,083737,Patchell; Gregory David,16,0,30,14
1658006452639,MATH 10B,A01,083207,Lim; Seonhee,9,0,34,25
1658006452639,MATH 10B,A02,083208,Lim; Seonhee,10,0,35,25
1658006452639,MATH 10B,A03,093472,Lim; Seonhee,7,0,34,27
1658006452639,MATH 10B,B01,083739,Sinha; Shubham,14,0,30,16
1658006458668,MATH 18,A01,083743,Cinel; Cameron Alexander,9,0,30,21
1658006458668,MATH 18,A02,083744,Cinel; Cameron Alexander,18,0,30,12
1658006458668,MATH 18,A03,083745,Cinel; Cameron Alexander,10,0,30,20
1658006458668,MATH 18,B01,083748,Rideout; David Porter,5,0,37,32
1658006458668,MATH 18,B02,083749,Rideout; David Porter,5,0,36,31
1658006458668,MATH 18,B03,083750,Rideout; David Porter,3,0,37,34
1658006458668,MATH 18,B04,083751,Rideout; David Porter,7,0,36,29
1658006458668,MATH 18,B05,093473,Rideout; David Porter,7,0,36,29
1658006458668,MATH 18,B06,093474,Rideout; David Porter,6,0,36,30
1658006464692,MATH 20A,A01,083754,Zheng; Zequn,14,0,40,26
1658006470717,MATH 20B,A01,083756,Briones; Jor-el Thomas Caparas,4,0,36,32
1658006470717,MATH 20B,A02,083757,Briones; Jor-el Thomas Caparas,1,0,36,35
1658006470717,MATH 20B,A03,093475,Briones; Jor-el Thomas Caparas,3,0,36,33
1658006476740,MATH 20C,A01,083760,Briones; Jor-el Thomas Caparas,1,0,35,34
1658006476740,MATH 20C,A02,083761,Briones; Jor-el Thomas Caparas,8,0,35,27
1658006476740,MATH 20C,A03,093476,Briones; Jor-el Thomas Caparas,0,1,36,36
1658006476740,MATH 20C,B01,083762,Bach; Quang Tran,1,0,30,29
1658006482764,MATH 20D,A01,083765,Tran; Brian Kha,5,0,30,25
1658006482764,MATH 20D,A02,083766,Tran; Brian Kha,5,0,30,25
1658006482764,MATH 20D,A03,083767,Tran; Brian Kha,6,0,30,24
1658006488796,MATH 20E,A01,083771,Ganguly; Soumya,12,0,32,20
1658006488796,MATH 20E,A02,083772,Ganguly; Soumya,7,0,32,25
1658006488796,MATH 20E,B01,083773,Ciotti; Benjamin,20,0,35,15
1658006488796,MATH 20E,B02,083774,Ciotti; Benjamin,18,0,35,17
1658006494819,MATH 103A,A01,083777,Greenfeld; Be'Eri,6,0,36,30
1658006494819,MATH 103A,A02,083778,Greenfeld; Be'Eri,5,0,36,31
1658006494819,MATH 103A,A03,093561,Greenfeld; Be'Eri,7,0,36,29
1658006494819,MATH 103A,B01,083779,Greenfeld; Be'Eri,8,0,36,28
1658006494819,MATH 103A,B02,083780,Greenfeld; Be'Eri,4,0,36,32
1658006494819,MATH 103A,B03,093562,Greenfeld; Be'Eri,3,0,36,33
1658006500842,MATH 105,A01,085443,Carter; Anne Toulson,15,0,35,20
1658006500842,MATH 105,A02,093477,Carter; Anne Toulson,20,0,35,15
1658006506868,MATH 109,A01,083213,Ganzberger; Geoffrey Michael,3,0,34,31
1658006506868,MATH 109,A02,083214,Ganzberger; Geoffrey Michael,4,0,34,30
1658006506868,MATH 109,A03,093478,Ganzberger; Geoffrey Michael,2,0,34,32
1658006506868,MATH 109,B01,083215,Ganzberger; Geoffrey Michael,3,0,32,29
1658006506868,MATH 109,B02,083216,Ganzberger; Geoffrey Michael,3,0,32,29
1658006506868,MATH 109,B03,093479,Ganzberger; Geoffrey Michael,8,0,32,24
1658006512892,MATH 142A,A01,083219,Chow; Bennett,7,0,32,25
1658006512892,MATH 142A,A02,083220,Chow; Bennett,10,0,32,22
1658006512892,MATH 142A,A03,093480,Chow; Bennett,9,0,32,23
1658006512892,MATH 142A,B03,093481,Chow; Bennett,8,0,32,24
1658006512892,MATH 142A,B04,093558,Chow; Bennett,14,0,32,18
1658006512892,MATH 142A,B05,093559,Chow; Bennett,7,0,32,25
1658006518919,MATH 193A,A01,083224,Rotar; Vladimir,9,0,34,25
1658006518919,MATH 193A,A02,083225,Rotar; Vladimir,11,0,34,23
1658006518919,MATH 193A,A03,083781,Rotar; Vladimir,5,0,34,29
1658006518919,MATH 193A,A04,083782,Rotar; Vladimir,12,0,34,22
1658006518919,MATH 193A,A05,093482,Rotar; Vladimir,11,0,34,23
1658006524948,MATH 197,001,091859,McAuley; Julian John,9999,0,9999,0
1658006524948,MATH 197,002,095566,Kedlaya; Kiran S.,9997,0,9999,2
1658006524948,MATH 197,003,095567,Xiao; Ming,9999,0,9999,0
1658006524948,MATH 197,004,095571,Perols; Johan Lars,9998,0,9999,1
1658006532004,COGS 9,A01,083615,Shannon; Kyle Michael,11,0,75,64
1658006538030,COGS 11,A01,083617,Boyle; Mary E. T.,23,0,48,25
1658006544054,COGS 13,A01,083071,Bastos; Amalia Pinkusfeld,12,0,71,59
1658006550077,COGS 14A,A01,092681,Semenuks; Arturs,5,1,100,95
1658006556099,COGS 14B,A01,083073,Cheng; Tzu-Han,7,0,63,56
1658006562125,COGS 17,A01,092677,Semenuks; Arturs,7,0,81,74
1658006568149,COGS 100,A01,083619,Allen; Michael Gordon,17,0,70,53
1658006574176,COGS 101A,A01,083621,Davis; Joshua Daniel,9,0,68,59
1658006580198,COGS 101B,A01,091572,Allen; Michael Gordon,14,0,65,51
1658006586225,COGS 101C,A01,083625,Delgado; Tania,17,0,35,18
1658006592251,COGS 107A,A01,083627,Boyle; Mary E. T.,14,0,60,46
1658006598275,COGS 118A,A01,083075,Gupta; Anjum,21,0,76,55
1658006604298,CSE 3,A50,083646,Miranda; Gregory Joseph,24,0,50,26
1658006610327,CSE 8A,A50,083650,Miranda; Gregory Joseph,17,1,56,39
1658006616349,CSE 11,A01,083080,Cao; Yingjun,7,15,40,33
1658006622373,CSE 12,A01,083652,Krause-Levy; Sophia Louisa,30,1,120,90
1658006628396,CSE 15L,A01,083654,Morris; Justin Loren,9,0,50,41
1658006628396,CSE 15L,A02,083655,Morris; Justin Loren,11,0,50,39
1658006634418,CSE 20,A01,083657,Tran; Khoa Dang,39,0,80,41
1658006640439,CSE 21,A01,095574,Bach; Quang Tran,23,0,48,25
1658006646464,CSE 30,A01,083084,Eldon; John,8,0,80,72
1658006646464,CSE 30,B01,095061,Bhaskar; Nishant,9,0,50,41
1658006652494,CSE 100,A01,083659,Cao; Yingjun,5,4,70,65
1658006658518,CSE 134B,A01,083661,Powell; Thomas Allan,25,0,100,75
1658006664545,CSE 140,A01,083663,Gungor; Onat,17,0,85,68
1658006670572,CSE 140L,A01,083088,Eldon; John,23,0,100,77
1658006676598,CSE 175,A01,083665,Kumar; Rakesh,3,0,25,22
1658006682621,CSE 190,A00,092507,Dubnov; Shlomo,8,0,20,12
1658006688646,ECE 45,A01,083139,Congero; Spencer William,7,0,75,68
1658006694671,ECE 65,A50,083695,Saad; Andrew S,12,0,30,18
1658006694671,ECE 65,A51,095125,Saad; Andrew S,24,0,26,2
1658006700695,ECE 109,A01,091882,Touri; Behrouz,21,0,70,49
1658006706719,ECE 180,A00,083140,Abi Samra; Nicholas Camill,1,0,30,29
1658006706719,ECE 180,B00,083141,Abi Samra; Nicholas Camill,0,0,30,30
1658006712752,MATH 10A,A01,083735,Patchell; Gregory David,2,0,30,28
1658006712752,MATH 10A,A02,083736,Patchell; Gregory David,20,0,30,10
1658006712752,MATH 10A,A03,083737,Patchell; Gregory David,16,0,30,14
1658006718776,MATH 10B,A01,083207,Lim; Seonhee,9,0,34,25
1658006718776,MATH 10B,A02,083208,Lim; Seonhee,10,0,35,25
1658006718776,MATH 10B,A03,093472,Lim; Seonhee,7,0,34,27
1658006718776,MATH 10B,B01,083739,Sinha; Shubham,14,0,30,16
1658006724801,MATH 18,A01,083743,Cinel; Cameron Alexander,9,0,30,21
1658006724801,MATH 18,A02,083744,Cinel; Cameron Alexander,18,0,30,12
1658006724801,MATH 18,A03,083745,Cinel; Cameron Alexander,10,0,30,20
1658006724801,MATH 18,B01,083748,Rideout; David Porter,5,0,37,32
1658006724801,MATH 18,B02,083749,Rideout; David Porter,5,0,36,31
1658006724801,MATH 18,B03,083750,Rideout; David Porter,3,0,37,34
1658006724801,MATH 18,B04,083751,Rideout; David Porter,7,0,36,29
1658006724801,MATH 18,B05,093473,Rideout; David Porter,7,0,36,29
1658006724801,MATH 18,B06,093474,Rideout; David Porter,6,0,36,30
1658006730826,MATH 20A,A01,083754,Zheng; Zequn,14,0,40,26
1658006736853,MATH 20B,A01,083756,Briones; Jor-el Thomas Caparas,4,0,36,32
1658006736853,MATH 20B,A02,083757,Briones; Jor-el Thomas Caparas,1,0,36,35
1658006736853,MATH 20B,A03,093475,Briones; Jor-el Thomas Caparas,3,0,36,33
1658006742881,MATH 20C,A01,083760,Briones; Jor-el Thomas Caparas,1,0,35,34
1658006742881,MATH 20C,A02,083761,Briones; Jor-el Thomas Caparas,8,0,35,27
1658006742881,MATH 20C,A03,093476,Briones; Jor-el Thomas Caparas,0,1,36,36
1658006742881,MATH 20C,B01,083762,Bach; Quang Tran,1,0,30,29
1658006748908,MATH 20D,A01,083765,Tran; Brian Kha,5,0,30,25
1658006748908,MATH 20D,A02,083766,Tran; Brian Kha,5,0,30,25
1658006748908,MATH 20D,A03,083767,Tran; Brian Kha,6,0,30,24
1658006754933,MATH 20E,A01,083771,Ganguly; Soumya,12,0,32,20
1658006754933,MATH 20E,A02,083772,Ganguly; Soumya,7,0,32,25
1658006754933,MATH 20E,B01,083773,Ciotti; Benjamin,20,0,35,15
1658006754933,MATH 20E,B02,083774,Ciotti; Benjamin,18,0,35,17
1658006769516,MATH 103A,A01,083777,Greenfeld; Be'Eri,6,0,36,30
1658006769516,MATH 103A,A02,083778,Greenfeld; Be'Eri,5,0,36,31
1658006769516,MATH 103A,A03,093561,Greenfeld; Be'Eri,7,0,36,29
1658006769516,MATH 103A,B01,083779,Greenfeld; Be'Eri,8,0,36,28
1658006769516,MATH 103A,B02,083780,Greenfeld; Be'Eri,4,0,36,32
1658006769516,MATH 103A,B03,093562,Greenfeld; Be'Eri,3,0,36,33
1658006775552,MATH 105,A01,085443,Carter; Anne Toulson,15,0,35,20
1658006775552,MATH 105,A02,093477,Carter; Anne Toulson,20,0,35,15
1658006781583,MATH 109,A01,083213,Ganzberger; Geoffrey Michael,3,0,34,31
1658006781583,MATH 109,A02,083214,Ganzberger; Geoffrey Michael,4,0,34,30
1658006781583,MATH 109,A03,093478,Ganzberger; Geoffrey Michael,2,0,34,32
1658006781583,MATH 109,B01,083215,Ganzberger; Geoffrey Michael,3,0,32,29
1658006781583,MATH 109,B02,083216,Ganzberger; Geoffrey Michael,3,0,32,29
1658006781583,MATH 109,B03,093479,Ganzberger; Geoffrey Michael,8,0,32,24
1658006787608,MATH 142A,A01,083219,Chow; Bennett,7,0,32,25
1658006787608,MATH 142A,A02,083220,Chow; Bennett,10,0,32,22
1658006787608,MATH 142A,A03,093480,Chow; Bennett,9,0,32,23
1658006787608,MATH 142A,B03,093481,Chow; Bennett,8,0,32,24
1658006787608,MATH 142A,B04,093558,Chow; Bennett,14,0,32,18
1658006787608,MATH 142A,B05,093559,Chow; Bennett,7,0,32,25
1658006793635,MATH 193A,A01,083224,Rotar; Vladimir,9,0,34,25
1658006793635,MATH 193A,A02,083225,Rotar; Vladimir,11,0,34,23
1658006793635,MATH 193A,A03,083781,Rotar; Vladimir,5,0,34,29
1658006793635,MATH 193A,A04,083782,Rotar; Vladimir,12,0,34,22
1658006793635,MATH 193A,A05,093482,Rotar; Vladimir,11,0,34,23
1658006799660,MATH 197,001,091859,McAuley; Julian John,9999,0,9999,0
1658006799660,MATH 197,002,095566,Kedlaya; Kiran S.,9997,0,9999,2
1658006799660,MATH 197,003,095567,Xiao; Ming,9999,0,9999,0
1658006799660,MATH 197,004,095571,Perols; Johan Lars,9998,0,9999,1
1658006806720,COGS 9,A01,083615,Shannon; Kyle Michael,11,0,75,64
1658006812745,COGS 11,A01,083617,Boyle; Mary E. T.,23,0,48,25
1658006818767,COGS 13,A01,083071,Bastos; Amalia Pinkusfeld,12,0,71,59
1658006824792,COGS 14A,A01,092681,Semenuks; Arturs,5,1,100,95
1658006830819,COGS 14B,A01,083073,Cheng; Tzu-Han,7,0,63,56
1658006836843,COGS 17,A01,092677,Semenuks; Arturs,7,0,81,74
1658006842869,COGS 100,A01,083619,Allen; Michael Gordon,17,0,70,53
1658006848898,COGS 101A,A01,083621,Davis; Joshua Daniel,9,0,68,59
1658006854924,COGS 101B,A01,091572,Allen; Michael Gordon,14,0,65,51
1658006860947,COGS 101C,A01,083625,Delgado; Tania,17,0,35,18
1658006866970,COGS 107A,A01,083627,Boyle; Mary E. T.,14,0,60,46
1658006873000,COGS 118A,A01,083075,Gupta; Anjum,21,0,76,55
1658006879023,CSE 3,A50,083646,Miranda; Gregory Joseph,24,0,50,26
1658006885051,CSE 8A,A50,083650,Miranda; Gregory Joseph,17,1,56,39
1658006891075,CSE 11,A01,083080,Cao; Yingjun,7,15,40,33
1658006897098,CSE 12,A01,083652,Krause-Levy; Sophia Louisa,30,1,120,90
1658006903124,CSE 15L,A01,083654,Morris; Justin Loren,9,0,50,41
1658006903124,CSE 15L,A02,083655,Morris; Justin Loren,11,0,50,39
1658006909148,CSE 20,A01,083657,Tran; Khoa Dang,39,0,80,41
1658006915175,CSE 21,A01,095574,Bach; Quang Tran,23,0,48,25
1658006921203,CSE 30,A01,083084,Eldon; John,8,0,80,72
1658006921203,CSE 30,B01,095061,Bhaskar; Nishant,9,0,50,41
1658006927225,CSE 100,A01,083659,Cao; Yingjun,5,4,70,65
1658006933250,CSE 134B,A01,083661,Powell; Thomas Allan,25,0,100,75
1658006939273,CSE 140,A01,083663,Gungor; Onat,17,0,85,68
1658006945300,CSE 140L,A01,083088,Eldon; John,23,0,100,77
1658006951322,CSE 175,A01,083665,Kumar; Rakesh,3,0,25,22
1658006957344,CSE 190,A00,092507,Dubnov; Shlomo,8,0,20,12
1658006963371,ECE 45,A01,083139,Congero; Spencer William,7,0,75,68
1658006969397,ECE 65,A50,083695,Saad; Andrew S,12,0,30,18
1658006969397,ECE 65,A51,095125,Saad; Andrew S,24,0,26,2
1658006975421,ECE 109,A01,091882,Touri; Behrouz,21,0,70,49
1658006981447,ECE 180,A00,083140,Abi Samra; Nicholas Camill,1,0,30,29
1658006981447,ECE 180,B00,083141,Abi Samra; Nicholas Camill,0,0,30,30
1658006987476,MATH 10A,A01,083735,Patchell; Gregory David,2,0,30,28
1658006987476,MATH 10A,A02,083736,Patchell; Gregory David,20,0,30,10
1658006987476,MATH 10A,A03,083737,Patchell; Gregory David,16,0,30,14
1658006993501,MATH 10B,A01,083207,Lim; Seonhee,9,0,34,25
1658006993501,MATH 10B,A02,083208,Lim; Seonhee,10,0,35,25
1658006993501,MATH 10B,A03,093472,Lim; Seonhee,7,0,34,27
1658006993501,MATH 10B,B01,083739,Sinha; Shubham,14,0,30,16
1658006999530,MATH 18,A01,083743,Cinel; Cameron Alexander,9,0,30,21
1658006999530,MATH 18,A02,083744,Cinel; Cameron Alexander,18,0,30,12
1658006999530,MATH 18,A03,083745,Cinel; Cameron Alexander,10,0,30,20
1658006999530,MATH 18,B01,083748,Rideout; David Porter,5,0,37,32
1658006999530,MATH 18,B02,083749,Rideout; David Porter,5,0,36,31
1658006999530,MATH 18,B03,083750,Rideout; David Porter,3,0,37,34
1658006999530,MATH 18,B04,083751,Rideout; David Porter,7,0,36,29
1658006999530,MATH 18,B05,093473,Rideout; David Porter,7,0,36,29
1658006999530,MATH 18,B06,093474,Rideout; David Porter,6,0,36,30
1658007005557,MATH 20A,A01,083754,Zheng; Zequn,14,0,40,26
1658007011583,MATH 20B,A01,083756,Briones; Jor-el Thomas Caparas,4,0,36,32
1658007011583,MATH 20B,A02,083757,Briones; Jor-el Thomas Caparas,1,0,36,35
1658007011583,MATH 20B,A03,093475,Briones; Jor-el Thomas Caparas,3,0,36,33
1658007017604,MATH 20C,A01,083760,Briones; Jor-el Thomas Caparas,1,0,35,34
1658007017604,MATH 20C,A02,083761,Briones; Jor-el Thomas Caparas,8,0,35,27
1658007017604,MATH 20C,A03,093476,Briones; Jor-el Thomas Caparas,0,1,36,36
1658007017604,MATH 20C,B01,083762,Bach; Quang Tran,1,0,30,29
1658007023632,MATH 20D,A01,083765,Tran; Brian Kha,5,0,30,25
1658007023632,MATH 20D,A02,083766,Tran; Brian Kha,5,0,30,25
1658007023632,MATH 20D,A03,083767,Tran; Brian Kha,6,0,30,24
1658007029732,MATH 20E,A01,083771,Ganguly; Soumya,12,0,32,20
1658007029732,MATH 20E,A02,083772,Ganguly; Soumya,7,0,32,25
1658007029732,MATH 20E,B01,083773,Ciotti; Benjamin,20,0,35,15
1658007029732,MATH 20E,B02,083774,Ciotti; Benjamin,18,0,35,17
1658007035757,MATH 103A,A01,083777,Greenfeld; Be'Eri,6,0,36,30
1658007035757,MATH 103A,A02,083778,Greenfeld; Be'Eri,5,0,36,31
1658007035757,MATH 103A,A03,093561,Greenfeld; Be'Eri,7,0,36,29
1658007035757,MATH 103A,B01,083779,Greenfeld; Be'Eri,8,0,36,28
1658007035757,MATH 103A,B02,083780,Greenfeld; Be'Eri,4,0,36,32
1658007035757,MATH 103A,B03,093562,Greenfeld; Be'Eri,3,0,36,33
1658007041782,MATH 105,A01,085443,Carter; Anne Toulson,15,0,35,20
1658007041782,MATH 105,A02,093477,Carter; Anne Toulson,20,0,35,15
1658007047806,MATH 109,A01,083213,Ganzberger; Geoffrey Michael,3,0,34,31
1658007047806,MATH 109,A02,083214,Ganzberger; Geoffrey Michael,4,0,34,30
1658007047806,MATH 109,A03,093478,Ganzberger; Geoffrey Michael,2,0,34,32
1658007047806,MATH 109,B01,083215,Ganzberger; Geoffrey Michael,3,0,32,29
1658007047806,MATH 109,B02,083216,Ganzberger; Geoffrey Michael,3,0,32,29
1658007047806,MATH 109,B03,093479,Ganzberger; Geoffrey Michael,8,0,32,24
1658007053828,MATH 142A,A01,083219,Chow; Bennett,7,0,32,25
1658007053828,MATH 142A,A02,083220,Chow; Bennett,10,0,32,22
1658007053828,MATH 142A,A03,093480,Chow; Bennett,9,0,32,23
1658007053828,MATH 142A,B03,093481,Chow; Bennett,8,0,32,24
1658007053828,MATH 142A,B04,093558,Chow; Bennett,14,0,32,18
1658007053828,MATH 142A,B05,093559,Chow; Bennett,7,0,32,25
1658007059850,MATH 193A,A01,083224,Rotar; Vladimir,9,0,34,25
1658007059850,MATH 193A,A02,083225,Rotar; Vladimir,11,0,34,23
1658007059850,MATH 193A,A03,083781,Rotar; Vladimir,5,0,34,29
1658007059850,MATH 193A,A04,083782,Rotar; Vladimir,12,0,34,22
1658007059850,MATH 193A,A05,093482,Rotar; Vladimir,11,0,34,23
1658007065872,MATH 197,001,091859,McAuley; Julian John,9999,0,9999,0
1658007065872,MATH 197,002,095566,Kedlaya; Kiran S.,9997,0,9999,2
1658007065872,MATH 197,003,095567,Xiao; Ming,9999,0,9999,0
1658007065872,MATH 197,004,095571,Perols; Johan Lars,9998,0,9999,1
1658007072922,COGS 9,A01,083615,Shannon; Kyle Michael,11,0,75,64
1658007078949,COGS 11,A01,083617,Boyle; Mary E. T.,23,0,48,25
1658007084972,COGS 13,A01,083071,Bastos; Amalia Pinkusfeld,12,0,71,59
1658007090994,COGS 14A,A01,092681,Semenuks; Arturs,5,1,100,95
1658007097017,COGS 14B,A01,083073,Cheng; Tzu-Han,7,0,63,56
1658007103039,COGS 17,A01,092677,Semenuks; Arturs,7,0,81,74
1658007109061,COGS 100,A01,083619,Allen; Michael Gordon,17,0,70,53
1658007115091,COGS 101A,A01,083621,Davis; Joshua Daniel,9,0,68,59
1658007121114,COGS 101B,A01,091572,Allen; Michael Gordon,14,0,65,51
1658007127135,COGS 101C,A01,083625,Delgado; Tania,17,0,35,18
1658007133162,COGS 107A,A01,083627,Boyle; Mary E. T.,14,0,60,46
1658007139186,COGS 118A,A01,083075,Gupta; Anjum,21,0,76,55
1658007145213,CSE 3,A50,083646,Miranda; Gregory Joseph,24,0,50,26
1658007151235,CSE 8A,A50,083650,Miranda; Gregory Joseph,17,1,56,39
1658007157256,CSE 11,A01,083080,Cao; Yingjun,7,15,40,33
1658007163278,CSE 12,A01,083652,Krause-Levy; Sophia Louisa,30,1,120,90
1658007169301,CSE 15L,A01,083654,Morris; Justin Loren,9,0,50,41
1658007169301,CSE 15L,A02,083655,Morris; Justin Loren,11,0,50,39
1658007175331,CSE 20,A01,083657,Tran; Khoa Dang,39,0,80,41
1658007181360,CSE 21,A01,095574,Bach; Quang Tran,23,0,48,25
1658007187383,CSE 30,A01,083084,Eldon; John,8,0,80,72
1658007187383,CSE 30,B01,095061,Bhaskar; Nishant,9,0,50,41
1658007193408,CSE 100,A01,083659,Cao; Yingjun,5,4,70,65
1658007199431,CSE 134B,A01,083661,Powell; Thomas Allan,25,0,100,75
1658007205456,CSE 140,A01,083663,Gungor; Onat,17,0,85,68
1658007211481,CSE 140L,A01,083088,Eldon; John,23,0,100,77
1658007217504,CSE 175,A01,083665,Kumar; Rakesh,3,0,25,22
1658007223528,CSE 190,A00,092507,Dubnov; Shlomo,8,0,20,12
1658007229552,ECE 45,A01,083139,Congero; Spencer William,7,0,75,68
1658007235578,ECE 65,A50,083695,Saad; Andrew S,12,0,30,18
1658007235578,ECE 65,A51,095125,Saad; Andrew S,24,0,26,2
1658007241601,ECE 109,A01,091882,Touri; Behrouz,21,0,70,49
1658007247626,ECE 180,A00,083140,Abi Samra; Nicholas Camill,1,0,30,29
1658007247626,ECE 180,B00,083141,Abi Samra; Nicholas Camill,0,0,30,30
1658007253649,MATH 10A,A01,083735,Patchell; Gregory David,2,0,30,28
1658007253649,MATH 10A,A02,083736,Patchell; Gregory David,20,0,30,10
1658007253649,MATH 10A,A03,083737,Patchell; Gregory David,16,0,30,14
1658007259678,MATH 10B,A01,083207,Lim; Seonhee,9,0,34,25
1658007259678,MATH 10B,A02,083208,Lim; Seonhee,10,0,35,25
1658007259678,MATH 10B,A03,093472,Lim; Seonhee,7,0,34,27
1658007259678,MATH 10B,B01,083739,Sinha; Shubham,14,0,30,16
1658007265706,MATH 18,A01,083743,Cinel; Cameron Alexander,9,0,30,21
1658007265706,MATH 18,A02,083744,Cinel; Cameron Alexander,18,0,30,12
1658007265706,MATH 18,A03,083745,Cinel; Cameron Alexander,10,0,30,20
1658007265706,MATH 18,B01,083748,Rideout; David Porter,5,0,37,32
1658007265706,MATH 18,B02,083749,Rideout; David Porter,5,0,36,31
1658007265706,MATH 18,B03,083750,Rideout; David Porter,3,0,37,34
1658007265706,MATH 18,B04,083751,Rideout; David Porter,7,0,36,29
1658007265706,MATH 18,B05,093473,Rideout; David Porter,7,0,36,29
1658007265706,MATH 18,B06,093474,Rideout; David Porter,6,0,36,30
1658007271728,MATH 20A,A01,083754,Zheng; Zequn,14,0,40,26
1658007277749,MATH 20B,A01,083756,Briones; Jor-el Thomas Caparas,4,0,36,32
1658007277749,MATH 20B,A02,083757,Briones; Jor-el Thomas Caparas,1,0,36,35
1658007277749,MATH 20B,A03,093475,Briones; Jor-el Thomas Caparas,3,0,36,33
1658007283770,MATH 20C,A01,083760,Briones; Jor-el Thomas Caparas,1,0,35,34
1658007283770,MATH 20C,A02,083761,Briones; Jor-el Thomas Caparas,8,0,35,27
1658007283770,MATH 20C,A03,093476,Briones; Jor-el Thomas Caparas,0,1,36,36
1658007283770,MATH 20C,B01,083762,Bach; Quang Tran,1,0,30,29
1658007289793,MATH 20D,A01,083765,Tran; Brian Kha,5,0,30,25
1658007289793,MATH 20D,A02,083766,Tran; Brian Kha,5,0,30,25
1658007289793,MATH 20D,A03,083767,Tran; Brian Kha,6,0,30,24
1658007295820,MATH 20E,A01,083771,Ganguly; Soumya,12,0,32,20
1658007295820,MATH 20E,A02,083772,Ganguly; Soumya,7,0,32,25
1658007295820,MATH 20E,B01,083773,Ciotti; Benjamin,20,0,35,15
1658007295820,MATH 20E,B02,083774,Ciotti; Benjamin,18,0,35,17
1658007301842,MATH 103A,A01,083777,Greenfeld; Be'Eri,6,0,36,30
1658007301842,MATH 103A,A02,083778,Greenfeld; Be'Eri,5,0,36,31
1658007301842,MATH 103A,A03,093561,Greenfeld; Be'Eri,7,0,36,29
1658007301842,MATH 103A,B01,083779,Greenfeld; Be'Eri,8,0,36,28
1658007301842,MATH 103A,B02,083780,Greenfeld; Be'Eri,4,0,36,32
1658007301842,MATH 103A,B03,093562,Greenfeld; Be'Eri,3,0,36,33
1658007307873,MATH 105,A01,085443,Carter; Anne Toulson,15,0,35,20
1658007307873,MATH 105,A02,093477,Carter; Anne Toulson,20,0,35,15
1658007313895,MATH 109,A01,083213,Ganzberger; Geoffrey Michael,3,0,34,31
1658007313895,MATH 109,A02,083214,Ganzberger; Geoffrey Michael,4,0,34,30
1658007313895,MATH 109,A03,093478,Ganzberger; Geoffrey Michael,2,0,34,32
1658007313895,MATH 109,B01,083215,Ganzberger; Geoffrey Michael,3,0,32,29
1658007313895,MATH 109,B02,083216,Ganzberger; Geoffrey Michael,3,0,32,29
1658007313895,MATH 109,B03,093479,Ganzberger; Geoffrey Michael,8,0,32,24
1658007319924,MATH 142A,A01,083219,Chow; Bennett,7,0,32,25
1658007319924,MATH 142A,A02,083220,Chow; Bennett,10,0,32,22
1658007319924,MATH 142A,A03,093480,Chow; Bennett,9,0,32,23
1658007319924,MATH 142A,B03,093481,Chow; Bennett,8,0,32,24
1658007319924,MATH 142A,B04,093558,Chow; Bennett,14,0,32,18
1658007319924,MATH 142A,B05,093559,Chow; Bennett,7,0,32,25
1658007325948,MATH 193A,A01,083224,Rotar; Vladimir,9,0,34,25
1658007325948,MATH 193A,A02,083225,Rotar; Vladimir,11,0,34,23
1658007325948,MATH 193A,A03,083781,Rotar; Vladimir,5,0,34,29
1658007325948,MATH 193A,A04,083782,Rotar; Vladimir,12,0,34,22
1658007325948,MATH 193A,A05,093482,Rotar; Vladimir,11,0,34,23
1658007331971,MATH 197,001,091859,McAuley; Julian John,9999,0,9999,0
1658007331971,MATH 197,002,095566,Kedlaya; Kiran S.,9997,0,9999,2
1658007331971,MATH 197,003,095567,Xiao; Ming,9999,0,9999,0
1658007331971,MATH 197,004,095571,Perols; Johan Lars,9998,0,9999,1
1658007339029,COGS 9,A01,083615,Shannon; Kyle Michael,11,0,75,64
1658007345054,COGS 11,A01,083617,Boyle; Mary E. T.,23,0,48,25
1658007351081,COGS 13,A01,083071,Bastos; Amalia Pinkusfeld,12,0,71,59
1658007357102,COGS 14A,A01,092681,Semenuks; Arturs,5,1,100,95
1658007363128,COGS 14B,A01,083073,Cheng; Tzu-Han,7,0,63,56
1658007369150,COGS 17,A01,092677,Semenuks; Arturs,7,0,81,74
1658007375175,COGS 100,A01,083619,Allen; Michael Gordon,17,0,70,53
1658007381198,COGS 101A,A01,083621,Davis; Joshua Daniel,9,0,68,59
1658007387220,COGS 101B,A01,091572,Allen; Michael Gordon,14,0,65,51
1658007393248,COGS 101C,A01,083625,Delgado; Tania,17,0,35,18
1658007399275,COGS 107A,A01,083627,Boyle; Mary E. T.,14,0,60,46
1658007405296,COGS 118A,A01,083075,Gupta; Anjum,21,0,76,55
1658007411323,CSE 3,A50,083646,Miranda; Gregory Joseph,24,0,50,26
1658007417351,CSE 8A,A50,083650,Miranda; Gregory Joseph,17,1,56,39
1658007423377,CSE 11,A01,083080,Cao; Yingjun,7,15,40,33
1658007429405,CSE 12,A01,083652,Krause-Levy; Sophia Louisa,30,1,120,90
1658007435431,CSE 15L,A01,083654,Morris; Justin Loren,9,0,50,41
1658007435431,CSE 15L,A02,083655,Morris; Justin Loren,11,0,50,39
1658007441453,CSE 20,A01,083657,Tran; Khoa Dang,39,0,80,41
1658007447481,CSE 21,A01,095574,Bach; Quang Tran,23,0,48,25
1658007453504,CSE 30,A01,083084,Eldon; John,8,0,80,72
1658007453504,CSE 30,B01,095061,Bhaskar; Nishant,9,0,50,41
1658007459527,CSE 100,A01,083659,Cao; Yingjun,5,4,70,65
1658007465553,CSE 134B,A01,083661,Powell; Thomas Allan,25,0,100,75
1658007471576,CSE 140,A01,083663,Gungor; Onat,17,0,85,68
1658007477598,CSE 140L,A01,083088,Eldon; John,23,0,100,77
1658007483625,CSE 175,A01,083665,Kumar; Rakesh,3,0,25,22
1658007489651,CSE 190,A00,092507,Dubnov; Shlomo,8,0,20,12
1658007495672,ECE 45,A01,083139,Congero; Spencer William,7,0,75,68
1658007501698,ECE 65,A50,083695,Saad; Andrew S,12,0,30,18
1658007501698,ECE 65,A51,095125,Saad; Andrew S,24,0,26,2
1658007507728,ECE 109,A01,091882,Touri; Behrouz,21,0,70,49
1658007513749,ECE 180,A00,083140,Abi Samra; Nicholas Camill,1,0,30,29
1658007513749,ECE 180,B00,083141,Abi Samra; Nicholas Camill,0,0,30,30
1658007519772,MATH 10A,A01,083735,Patchell; Gregory David,2,0,30,28
1658007519772,MATH 10A,A02,083736,Patchell; Gregory David,20,0,30,10
1658007519772,MATH 10A,A03,083737,Patchell; Gregory David,16,0,30,14
1658007525799,MATH 10B,A01,083207,Lim; Seonhee,9,0,34,25
1658007525799,MATH 10B,A02,083208,Lim; Seonhee,10,0,35,25
1658007525799,MATH 10B,A03,093472,Lim; Seonhee,7,0,34,27
1658007525799,MATH 10B,B01,083739,Sinha; Shubham,14,0,30,16
1658007531823,MATH 18,A01,083743,Cinel; Cameron Alexander,9,0,30,21
1658007531823,MATH 18,A02,083744,Cinel; Cameron Alexander,18,0,30,12
1658007531823,MATH 18,A03,083745,Cinel; Cameron Alexander,10,0,30,20
1658007531823,MATH 18,B01,083748,Rideout; David Porter,5,0,37,32
1658007531823,MATH 18,B02,083749,Rideout; David Porter,5,0,36,31
1658007531823,MATH 18,B03,083750,Rideout; David Porter,3,0,37,34
1658007531823,MATH 18,B04,083751,Rideout; David Porter,7,0,36,29
1658007531823,MATH 18,B05,093473,Rideout; David Porter,7,0,36,29
1658007531823,MATH 18,B06,093474,Rideout; David Porter,6,0,36,30
1658007537846,MATH 20A,A01,083754,Zheng; Zequn,14,0,40,26
1658007543885,MATH 20B,A01,083756,Briones; Jor-el Thomas Caparas,4,0,36,32
1658007543885,MATH 20B,A02,083757,Briones; Jor-el Thomas Caparas,1,0,36,35
1658007543885,MATH 20B,A03,093475,Briones; Jor-el Thomas Caparas,3,0,36,33
1658007549912,MATH 20C,A01,083760,Briones; Jor-el Thomas Caparas,1,0,35,34
1658007549912,MATH 20C,A02,083761,Briones; Jor-el Thomas Caparas,8,0,35,27
1658007549912,MATH 20C,A03,093476,Briones; Jor-el Thomas Caparas,0,1,36,36
1658007549912,MATH 20C,B01,083762,Bach; Quang Tran,1,0,30,29
1658007555936,MATH 20D,A01,083765,Tran; Brian Kha,5,0,30,25
1658007555936,MATH 20D,A02,083766,Tran; Brian Kha,5,0,30,25
1658007555936,MATH 20D,A03,083767,Tran; Brian Kha,6,0,30,24
1658007561963,MATH 20E,A01,083771,Ganguly; Soumya,12,0,32,20
1658007561963,MATH 20E,A02,083772,Ganguly; Soumya,7,0,32,25
1658007561963,MATH 20E,B01,083773,Ciotti; Benjamin,20,0,35,15
1658007561963,MATH 20E,B02,083774,Ciotti; Benjamin,18,0,35,17
1658007567993,MATH 103A,A01,083777,Greenfeld; Be'Eri,6,0,36,30
1658007567993,MATH 103A,A02,083778,Greenfeld; Be'Eri,5,0,36,31
1658007567993,MATH 103A,A03,093561,Greenfeld; Be'Eri,7,0,36,29
1658007567993,MATH 103A,B01,083779,Greenfeld; Be'Eri,8,0,36,28
1658007567993,MATH 103A,B02,083780,Greenfeld; Be'Eri,4,0,36,32
1658007567993,MATH 103A,B03,093562,Greenfeld; Be'Eri,3,0,36,33
1658007574019,MATH 105,A01,085443,Carter; Anne Toulson,15,0,35,20
1658007574019,MATH 105,A02,093477,Carter; Anne Toulson,20,0,35,15
1658007580041,MATH 109,A01,083213,Ganzberger; Geoffrey Michael,3,0,34,31
1658007580041,MATH 109,A02,083214,Ganzberger; Geoffrey Michael,4,0,34,30
1658007580041,MATH 109,A03,093478,Ganzberger; Geoffrey Michael,2,0,34,32
1658007580041,MATH 109,B01,083215,Ganzberger; Geoffrey Michael,3,0,32,29
1658007580041,MATH 109,B02,083216,Ganzberger; Geoffrey Michael,3,0,32,29
1658007580041,MATH 109,B03,093479,Ganzberger; Geoffrey Michael,8,0,32,24
1658007586064,MATH 142A,A01,083219,Chow; Bennett,7,0,32,25
1658007586064,MATH 142A,A02,083220,Chow; Bennett,10,0,32,22
1658007586064,MATH 142A,A03,093480,Chow; Bennett,9,0,32,23
1658007586064,MATH 142A,B03,093481,Chow; Bennett,8,0,32,24
1658007586064,MATH 142A,B04,093558,Chow; Bennett,14,0,32,18
1658007586064,MATH 142A,B05,093559,Chow; Bennett,7,0,32,25
1658007592092,MATH 193A,A01,083224,Rotar; Vladimir,9,0,34,25
1658007592092,MATH 193A,A02,083225,Rotar; Vladimir,11,0,34,23
1658007592092,MATH 193A,A03,083781,Rotar; Vladimir,5,0,34,29
1658007592092,MATH 193A,A04,083782,Rotar; Vladimir,12,0,34,22
1658007592092,MATH 193A,A05,093482,Rotar; Vladimir,11,0,34,23
1658007598118,MATH 197,001,091859,McAuley; Julian John,9999,0,9999,0
1658007598118,MATH 197,002,095566,Kedlaya; Kiran S.,9997,0,9999,2
1658007598118,MATH 197,003,095567,Xiao; Ming,9999,0,9999,0
1658007598118,MATH 197,004,095571,Perols; Johan Lars,9998,0,9999,1
1658007605181,COGS 9,A01,083615,Shannon; Kyle Michael,11,0,75,64
1658007611203,COGS 11,A01,083617,Boyle; Mary E. T.,23,0,48,25
1658007617231,COGS 13,A01,083071,Bastos; Amalia Pinkusfeld,12,0,71,59
1658007623368,COGS 14A,A01,092681,Semenuks; Arturs,5,1,100,95
1658007629391,COGS 14B,A01,083073,Cheng; Tzu-Han,7,0,63,56
1658007635416,COGS 17,A01,092677,Semenuks; Arturs,7,0,81,74
1658007641444,COGS 100,A01,083619,Allen; Michael Gordon,17,0,70,53
1658007647469,COGS 101A,A01,083621,Davis; Joshua Daniel,9,0,68,59
1658007653493,COGS 101B,A01,091572,Allen; Michael Gordon,14,0,65,51
1658007659519,COGS 101C,A01,083625,Delgado; Tania,17,0,35,18
1658007665546,COGS 107A,A01,083627,Boyle; Mary E. T.,14,0,60,46
1658007671571,COGS 118A,A01,083075,Gupta; Anjum,21,0,76,55
1658007677595,CSE 3,A50,083646,Miranda; Gregory Joseph,24,0,50,26
1658007683622,CSE 8A,A50,083650,Miranda; Gregory Joseph,17,1,56,39
1658007689647,CSE 11,A01,083080,Cao; Yingjun,7,15,40,33
1658007695670,CSE 12,A01,083652,Krause-Levy; Sophia Louisa,30,1,120,90
1658007701696,CSE 15L,A01,083654,Morris; Justin Loren,9,0,50,41
1658007701696,CSE 15L,A02,083655,Morris; Justin Loren,11,0,50,39
1658007707719,CSE 20,A01,083657,Tran; Khoa Dang,39,0,80,41
1658007713746,CSE 21,A01,095574,Bach; Quang Tran,23,0,48,25
1658007719772,CSE 30,A01,083084,Eldon; John,8,0,80,72
1658007719772,CSE 30,B01,095061,Bhaskar; Nishant,9,0,50,41
1658007725795,CSE 100,A01,083659,Cao; Yingjun,5,4,70,65
1658007731819,CSE 134B,A01,083661,Powell; Thomas Allan,25,0,100,75
1658007737841,CSE 140,A01,083663,Gungor; Onat,17,0,85,68
1658007743864,CSE 140L,A01,083088,Eldon; John,23,0,100,77
1658007749887,CSE 175,A01,083665,Kumar; Rakesh,3,0,25,22
1658007755909,CSE 190,A00,092507,Dubnov; Shlomo,8,0,20,12
1658007761935,ECE 45,A01,083139,Congero; Spencer William,7,0,75,68
1658007767963,ECE 65,A50,083695,Saad; Andrew S,12,0,30,18
1658007767963,ECE 65,A51,095125,Saad; Andrew S,24,0,26,2
1658007773986,ECE 109,A01,091882,Touri; Behrouz,21,0,70,49
1658007780012,ECE 180,A00,083140,Abi Samra; Nicholas Camill,1,0,30,29
1658007780012,ECE 180,B00,083141,Abi Samra; Nicholas Camill,0,0,30,30
1658007786041,MATH 10A,A01,083735,Patchell; Gregory David,2,0,30,28
1658007786041,MATH 10A,A02,083736,Patchell; Gregory David,20,0,30,10
1658007786041,MATH 10A,A03,083737,Patchell; Gregory David,16,0,30,14
1658007792069,MATH 10B,A01,083207,Lim; Seonhee,9,0,34,25
1658007792069,MATH 10B,A02,083208,Lim; Seonhee,10,0,35,25
1658007792069,MATH 10B,A03,093472,Lim; Seonhee,7,0,34,27
1658007792069,MATH 10B,B01,083739,Sinha; Shubham,14,0,30,16
1658007798101,MATH 18,A01,083743,Cinel; Cameron Alexander,9,0,30,21
1658007798101,MATH 18,A02,083744,Cinel; Cameron Alexander,18,0,30,12
1658007798101,MATH 18,A03,083745,Cinel; Cameron Alexander,10,0,30,20
1658007798101,MATH 18,B01,083748,Rideout; David Porter,5,0,37,32
1658007798101,MATH 18,B02,083749,Rideout; David Porter,5,0,36,31
1658007798101,MATH 18,B03,083750,Rideout; David Porter,3,0,37,34
1658007798101,MATH 18,B04,083751,Rideout; David Porter,7,0,36,29
1658007798101,MATH 18,B05,093473,Rideout; David Porter,7,0,36,29
1658007798101,MATH 18,B06,093474,Rideout; David Porter,6,0,36,30
1658007804125,MATH 20A,A01,083754,Zheng; Zequn,14,0,40,26
1658007810159,MATH 20B,A01,083756,Briones; Jor-el Thomas Caparas,4,0,36,32
1658007810159,MATH 20B,A02,083757,Briones; Jor-el Thomas Caparas,1,0,36,35
1658007810159,MATH 20B,A03,093475,Briones; Jor-el Thomas Caparas,3,0,36,33
1658007816187,MATH 20C,A01,083760,Briones; Jor-el Thomas Caparas,1,0,35,34
1658007816187,MATH 20C,A02,083761,Briones; Jor-el Thomas Caparas,8,0,35,27
1658007816187,MATH 20C,A03,093476,Briones; Jor-el Thomas Caparas,0,1,36,36
1658007816187,MATH 20C,B01,083762,Bach; Quang Tran,1,0,30,29
1658007822210,MATH 20D,A01,083765,Tran; Brian Kha,5,0,30,25
1658007822210,MATH 20D,A02,083766,Tran; Brian Kha,5,0,30,25
1658007822210,MATH 20D,A03,083767,Tran; Brian Kha,6,0,30,24
1658007828233,MATH 20E,A01,083771,Ganguly; Soumya,12,0,32,20
1658007828233,MATH 20E,A02,083772,Ganguly; Soumya,7,0,32,25
1658007828233,MATH 20E,B01,083773,Ciotti; Benjamin,20,0,35,15
1658007828233,MATH 20E,B02,083774,Ciotti; Benjamin,18,0,35,17
1658007834255,MATH 103A,A01,083777,Greenfeld; Be'Eri,6,0,36,30
1658007834255,MATH 103A,A02,083778,Greenfeld; Be'Eri,5,0,36,31
1658007834255,MATH 103A,A03,093561,Greenfeld; Be'Eri,7,0,36,29
1658007834255,MATH 103A,B01,083779,Greenfeld; Be'Eri,8,0,36,28
1658007834255,MATH 103A,B02,083780,Greenfeld; Be'Eri,4,0,36,32
1658007834255,MATH 103A,B03,093562,Greenfeld; Be'Eri,3,0,36,33
1658007840281,MATH 105,A01,085443,Carter; Anne Toulson,15,0,35,20
1658007840281,MATH 105,A02,093477,Carter; Anne Toulson,20,0,35,15
1658007846308,MATH 109,A01,083213,Ganzberger; Geoffrey Michael,3,0,34,31
1658007846308,MATH 109,A02,083214,Ganzberger; Geoffrey Michael,4,0,34,30
1658007846308,MATH 109,A03,093478,Ganzberger; Geoffrey Michael,2,0,34,32
1658007846308,MATH 109,B01,083215,Ganzberger; Geoffrey Michael,3,0,32,29
1658007846308,MATH 109,B02,083216,Ganzberger; Geoffrey Michael,3,0,32,29
1658007846308,MATH 109,B03,093479,Ganzberger; Geoffrey Michael,8,0,32,24
1658007852337,MATH 142A,A01,083219,Chow; Bennett,7,0,32,25
1658007852337,MATH 142A,A02,083220,Chow; Bennett,10,0,32,22
1658007852337,MATH 142A,A03,093480,Chow; Bennett,9,0,32,23
1658007852337,MATH 142A,B03,093481,Chow; Bennett,8,0,32,24
1658007852337,MATH 142A,B04,093558,Chow; Bennett,14,0,32,18
1658007852337,MATH 142A,B05,093559,Chow; Bennett,7,0,32,25
1658007858362,MATH 193A,A01,083224,Rotar; Vladimir,9,0,34,25
1658007858362,MATH 193A,A02,083225,Rotar; Vladimir,11,0,34,23
1658007858362,MATH 193A,A03,083781,Rotar; Vladimir,5,0,34,29
1658007858362,MATH 193A,A04,083782,Rotar; Vladimir,12,0,34,22
1658007858362,MATH 193A,A05,093482,Rotar; Vladimir,11,0,34,23
1658007864390,MATH 197,001,091859,McAuley; Julian John,9999,0,9999,0
1658007864390,MATH 197,002,095566,Kedlaya; Kiran S.,9997,0,9999,2
1658007864390,MATH 197,003,095567,Xiao; Ming,9999,0,9999,0
1658007864390,MATH 197,004,095571,Perols; Johan Lars,9998,0,9999,1
1658007871455,COGS 9,A01,083615,Shannon; Kyle Michael,11,0,75,64
1658007877483,COGS 11,A01,083617,Boyle; Mary E. T.,23,0,48,25
1658007883507,COGS 13,A01,083071,Bastos; Amalia Pinkusfeld,12,0,71,59
1658007889529,COGS 14A,A01,092681,Semenuks; Arturs,5,1,100,95
1658007895553,COGS 14B,A01,083073,Cheng; Tzu-Han,7,0,63,56
1658007901577,COGS 17,A01,092677,Semenuks; Arturs,7,0,81,74
1658007907598,COGS 100,A01,083619,Allen; Michael Gordon,17,0,70,53
1658007913619,COGS 101A,A01,083621,Davis; Joshua Daniel,9,0,68,59
1658007919647,COGS 101B,A01,091572,Allen; Michael Gordon,14,0,65,51
1658007925670,COGS 101C,A01,083625,Delgado; Tania,17,0,35,18
1658007931694,COGS 107A,A01,083627,Boyle; Mary E. T.,14,0,60,46
1658007937715,COGS 118A,A01,083075,Gupta; Anjum,21,0,76,55
1658007943742,CSE 3,A50,083646,Miranda; Gregory Joseph,24,0,50,26
1658007949764,CSE 8A,A50,083650,Miranda; Gregory Joseph,17,1,56,39
1658007955786,CSE 11,A01,083080,Cao; Yingjun,7,15,40,33
1658007961808,CSE 12,A01,083652,Krause-Levy; Sophia Louisa,30,1,120,90
1658007967840,CSE 15L,A01,083654,Morris; Justin Loren,9,0,50,41
1658007967840,CSE 15L,A02,083655,Morris; Justin Loren,11,0,50,39
1658007973862,CSE 20,A01,083657,Tran; Khoa Dang,39,0,80,41
1658007979900,CSE 21,A01,095574,Bach; Quang Tran,23,0,48,25
1658007985923,CSE 30,A01,083084,Eldon; John,8,0,80,72
1658007985923,CSE 30,B01,095061,Bhaskar; Nishant,9,0,50,41
1658007991944,CSE 100,A01,083659,Cao; Yingjun,5,4,70,65
1658007997966,CSE 134B,A01,083661,Powell; Thomas Allan,25,0,100,75
1658008003993,CSE 140,A01,083663,Gungor; Onat,17,0,85,68
1658008010017,CSE 140L,A01,083088,Eldon; John,23,0,100,77
1658008016042,CSE 175,A01,083665,Kumar; Rakesh,3,0,25,22
1658008022067,CSE 190,A00,092507,Dubnov; Shlomo,8,0,20,12
1658008028089,ECE 45,A01,083139,Congero; Spencer William,7,0,75,68
1658008034113,ECE 65,A50,083695,Saad; Andrew S,12,0,30,18
1658008034113,ECE 65,A51,095125,Saad; Andrew S,24,0,26,2
1658008040139,ECE 109,A01,091882,Touri; Behrouz,21,0,70,49
1658008046166,ECE 180,A00,083140,Abi Samra; Nicholas Camill,1,0,30,29
1658008046166,ECE 180,B00,083141,Abi Samra; Nicholas Camill,0,0,30,30
1658008052193,MATH 10A,A01,083735,Patchell; Gregory David,2,0,30,28
1658008052193,MATH 10A,A02,083736,Patchell; Gregory David,20,0,30,10
1658008052193,MATH 10A,A03,083737,Patchell; Gregory David,16,0,30,14
1658008058222,MATH 10B,A01,083207,Lim; Seonhee,9,0,34,25
1658008058222,MATH 10B,A02,083208,Lim; Seonhee,10,0,35,25
1658008058222,MATH 10B,A03,093472,Lim; Seonhee,7,0,34,27
1658008058222,MATH 10B,B01,083739,Sinha; Shubham,14,0,30,16
1658008064248,MATH 18,A01,083743,Cinel; Cameron Alexander,9,0,30,21
1658008064248,MATH 18,A02,083744,Cinel; Cameron Alexander,18,0,30,12
1658008064248,MATH 18,A03,083745,Cinel; Cameron Alexander,10,0,30,20
1658008064248,MATH 18,B01,083748,Rideout; David Porter,5,0,37,32
1658008064248,MATH 18,B02,083749,Rideout; David Porter,5,0,36,31
1658008064248,MATH 18,B03,083750,Rideout; David Porter,3,0,37,34
1658008064248,MATH 18,B04,083751,Rideout; David Porter,7,0,36,29
1658008064248,MATH 18,B05,093473,Rideout; David Porter,7,0,36,29
1658008064248,MATH 18,B06,093474,Rideout; David Porter,6,0,36,30
1658008070271,MATH 20A,A01,083754,Zheng; Zequn,14,0,40,26
1658008076294,MATH 20B,A01,083756,Briones; Jor-el Thomas Caparas,4,0,36,32
1658008076294,MATH 20B,A02,083757,Briones; Jor-el Thomas Caparas,1,0,36,35
1658008076294,MATH 20B,A03,093475,Briones; Jor-el Thomas Caparas,3,0,36,33
1658008082324,MATH 20C,A01,083760,Briones; Jor-el Thomas Caparas,1,0,35,34
1658008082324,MATH 20C,A02,083761,Briones; Jor-el Thomas Caparas,8,0,35,27
1658008082324,MATH 20C,A03,093476,Briones; Jor-el Thomas Caparas,0,1,36,36
1658008082324,MATH 20C,B01,083762,Bach; Quang Tran,1,0,30,29
1658008088346,MATH 20D,A01,083765,Tran; Brian Kha,5,0,30,25
1658008088346,MATH 20D,A02,083766,Tran; Brian Kha,5,0,30,25
1658008088346,MATH 20D,A03,083767,Tran; Brian Kha,6,0,30,24
1658008094378,MATH 20E,A01,083771,Ganguly; Soumya,12,0,32,20
1658008094378,MATH 20E,A02,083772,Ganguly; Soumya,7,0,32,25
1658008094378,MATH 20E,B01,083773,Ciotti; Benjamin,20,0,35,15
1658008094378,MATH 20E,B02,083774,Ciotti; Benjamin,18,0,35,17
1658008100406,MATH 103A,A01,083777,Greenfeld; Be'Eri,6,0,36,30
1658008100406,MATH 103A,A02,083778,Greenfeld; Be'Eri,5,0,36,31
1658008100406,MATH 103A,A03,093561,Greenfeld; Be'Eri,7,0,36,29
1658008100406,MATH 103A,B01,083779,Greenfeld; Be'Eri,8,0,36,28
1658008100406,MATH 103A,B02,083780,Greenfeld; Be'Eri,4,0,36,32
1658008100406,MATH 103A,B03,093562,Greenfeld; Be'Eri,3,0,36,33
1658008106431,MATH 105,A01,085443,Carter; Anne Toulson,15,0,35,20
1658008106431,MATH 105,A02,093477,Carter; Anne Toulson,20,0,35,15
1658008112455,MATH 109,A01,083213,Ganzberger; Geoffrey Michael,3,0,34,31
1658008112455,MATH 109,A02,083214,Ganzberger; Geoffrey Michael,4,0,34,30
1658008112455,MATH 109,A03,093478,Ganzberger; Geoffrey Michael,2,0,34,32
1658008112455,MATH 109,B01,083215,Ganzberger; Geoffrey Michael,3,0,32,29
1658008112455,MATH 109,B02,083216,Ganzberger; Geoffrey Michael,3,0,32,29
1658008112455,MATH 109,B03,093479,Ganzberger; Geoffrey Michael,8,0,32,24
1658008118480,MATH 142A,A01,083219,Chow; Bennett,7,0,32,25
1658008118480,MATH 142A,A02,083220,Chow; Bennett,10,0,32,22
1658008118480,MATH 142A,A03,093480,Chow; Bennett,9,0,32,23
1658008118480,MATH 142A,B03,093481,Chow; Bennett,8,0,32,24
1658008118480,MATH 142A,B04,093558,Chow; Bennett,14,0,32,18
1658008118480,MATH 142A,B05,093559,Chow; Bennett,7,0,32,25
1658008124518,MATH 193A,A01,083224,Rotar; Vladimir,9,0,34,25
1658008124518,MATH 193A,A02,083225,Rotar; Vladimir,11,0,34,23
1658008124518,MATH 193A,A03,083781,Rotar; Vladimir,5,0,34,29
1658008124518,MATH 193A,A04,083782,Rotar; Vladimir,12,0,34,22
1658008124518,MATH 193A,A05,093482,Rotar; Vladimir,11,0,34,23
1658008130541,MATH 197,001,091859,McAuley; Julian John,9999,0,9999,0
1658008130541,MATH 197,002,095566,Kedlaya; Kiran S.,9997,0,9999,2
1658008130541,MATH 197,003,095567,Xiao; Ming,9999,0,9999,0
1658008130541,MATH 197,004,095571,Perols; Johan Lars,9998,0,9999,1
1658008137598,COGS 9,A01,083615,Shannon; Kyle Michael,11,0,75,64
1658008143623,COGS 11,A01,083617,Boyle; Mary E. T.,23,0,48,25
1658008149650,COGS 13,A01,083071,Bastos; Amalia Pinkusfeld,12,0,71,59
1658008155673,COGS 14A,A01,092681,Semenuks; Arturs,5,1,100,95
1658008161695,COGS 14B,A01,083073,Cheng; Tzu-Han,7,0,63,56
1658008167719,COGS 17,A01,092677,Semenuks; Arturs,7,0,81,74
1658008173756,COGS 100,A01,083619,Allen; Michael Gordon,17,0,70,53
1658008179780,COGS 101A,A01,083621,Davis; Joshua Daniel,9,0,68,59
1658008185803,COGS 101B,A01,091572,Allen; Michael Gordon,14,0,65,51
1658008191826,COGS 101C,A01,083625,Delgado; Tania,17,0,35,18
1658008197848,COGS 107A,A01,083627,Boyle; Mary E. T.,14,0,60,46
1658008203875,COGS 118A,A01,083075,Gupta; Anjum,21,0,76,55
1658008209897,CSE 3,A50,083646,Miranda; Gregory Joseph,24,0,50,26
1658008215919,CSE 8A,A50,083650,Miranda; Gregory Joseph,17,1,56,39
1658008222015,CSE 11,A01,083080,Cao; Yingjun,7,15,40,33
1658008228037,CSE 12,A01,083652,Krause-Levy; Sophia Louisa,30,1,120,90
1658008234062,CSE 15L,A01,083654,Morris; Justin Loren,9,0,50,41
1658008234062,CSE 15L,A02,083655,Morris; Justin Loren,11,0,50,39
1658008240097,CSE 20,A01,083657,Tran; Khoa Dang,39,0,80,41
1658008246121,CSE 21,A01,095574,Bach; Quang Tran,23,0,48,25
1658008252144,CSE 30,A01,083084,Eldon; John,8,0,80,72
1658008252144,CSE 30,B01,095061,Bhaskar; Nishant,9,0,50,41
1658008258171,CSE 100,A01,083659,Cao; Yingjun,5,4,70,65
1658008264198,CSE 134B,A01,083661,Powell; Thomas Allan,25,0,100,75
1658008270219,CSE 140,A01,083663,Gungor; Onat,17,0,85,68
1658008276242,CSE 140L,A01,083088,Eldon; John,23,0,100,77
1658008282267,CSE 175,A01,083665,Kumar; Rakesh,3,0,25,22
1658008288294,CSE 190,A00,092507,Dubnov; Shlomo,8,0,20,12
1658008294318,ECE 45,A01,083139,Congero; Spencer William,7,0,75,68
1658008300344,ECE 65,A50,083695,Saad; Andrew S,12,0,30,18
1658008300344,ECE 65,A51,095125,Saad; Andrew S,24,0,26,2
1658008306367,ECE 109,A01,091882,Touri; Behrouz,21,0,70,49
1658008312392,ECE 180,A00,083140,Abi Samra; Nicholas Camill,1,0,30,29
1658008312392,ECE 180,B00,083141,Abi Samra; Nicholas Camill,0,0,30,30
1658008318418,MATH 10A,A01,083735,Patchell; Gregory David,2,0,30,28
1658008318418,MATH 10A,A02,083736,Patchell; Gregory David,20,0,30,10
1658008318418,MATH 10A,A03,083737,Patchell; Gregory David,16,0,30,14
1658008324439,MATH 10B,A01,083207,Lim; Seonhee,9,0,34,25
1658008324439,MATH 10B,A02,083208,Lim; Seonhee,10,0,35,25
1658008324439,MATH 10B,A03,093472,Lim; Seonhee,7,0,34,27
1658008324439,MATH 10B,B01,083739,Sinha; Shubham,14,0,30,16
1658008330464,MATH 18,A01,083743,Cinel; Cameron Alexander,9,0,30,21
1658008330464,MATH 18,A02,083744,Cinel; Cameron Alexander,18,0,30,12
1658008330464,MATH 18,A03,083745,Cinel; Cameron Alexander,10,0,30,20
1658008330464,MATH 18,B01,083748,Rideout; David Porter,5,0,37,32
1658008330464,MATH 18,B02,083749,Rideout; David Porter,5,0,36,31
1658008330464,MATH 18,B03,083750,Rideout; David Porter,3,0,37,34
1658008330464,MATH 18,B04,083751,Rideout; David Porter,7,0,36,29
1658008330464,MATH 18,B05,093473,Rideout; David Porter,7,0,36,29
1658008330464,MATH 18,B06,093474,Rideout; David Porter,6,0,36,30
1658008336575,MATH 20A,A01,083754,Zheng; Zequn,14,0,40,26
1658008342597,MATH 20B,A01,083756,Briones; Jor-el Thomas Caparas,4,0,36,32
1658008342597,MATH 20B,A02,083757,Briones; Jor-el Thomas Caparas,1,0,36,35
1658008342597,MATH 20B,A03,093475,Briones; Jor-el Thomas Caparas,3,0,36,33
1658008348619,MATH 20C,A01,083760,Briones; Jor-el Thomas Caparas,1,0,35,34
1658008348619,MATH 20C,A02,083761,Briones; Jor-el Thomas Caparas,8,0,35,27
1658008348619,MATH 20C,A03,093476,Briones; Jor-el Thomas Caparas,0,1,36,36
1658008348619,MATH 20C,B01,083762,Bach; Quang Tran,1,0,30,29
1658008354641,MATH 20D,A01,083765,Tran; Brian Kha,5,0,30,25
1658008354641,MATH 20D,A02,083766,Tran; Brian Kha,5,0,30,25
1658008354641,MATH 20D,A03,083767,Tran; Brian Kha,6,0,30,24
1658008360669,MATH 20E,A01,083771,Ganguly; Soumya,12,0,32,20
1658008360669,MATH 20E,A02,083772,Ganguly; Soumya,7,0,32,25
1658008360669,MATH 20E,B01,083773,Ciotti; Benjamin,20,0,35,15
1658008360669,MATH 20E,B02,083774,Ciotti; Benjamin,18,0,35,17
1658008366696,MATH 103A,A01,083777,Greenfeld; Be'Eri,6,0,36,30
1658008366696,MATH 103A,A02,083778,Greenfeld; Be'Eri,5,0,36,31
1658008366696,MATH 103A,A03,093561,Greenfeld; Be'Eri,7,0,36,29
1658008366696,MATH 103A,B01,083779,Greenfeld; Be'Eri,8,0,36,28
1658008366696,MATH 103A,B02,083780,Greenfeld; Be'Eri,4,0,36,32
1658008366696,MATH 103A,B03,093562,Greenfeld; Be'Eri,3,0,36,33
1658008372721,MATH 105,A01,085443,Carter; Anne Toulson,15,0,35,20
1658008372721,MATH 105,A02,093477,Carter; Anne Toulson,20,0,35,15
1658008378744,MATH 109,A01,083213,Ganzberger; Geoffrey Michael,3,0,34,31
1658008378744,MATH 109,A02,083214,Ganzberger; Geoffrey Michael,4,0,34,30
1658008378744,MATH 109,A03,093478,Ganzberger; Geoffrey Michael,2,0,34,32
1658008378744,MATH 109,B01,083215,Ganzberger; Geoffrey Michael,3,0,32,29
1658008378744,MATH 109,B02,083216,Ganzberger; Geoffrey Michael,3,0,32,29
1658008378744,MATH 109,B03,093479,Ganzberger; Geoffrey Michael,8,0,32,24
1658008384766,MATH 142A,A01,083219,Chow; Bennett,7,0,32,25
1658008384766,MATH 142A,A02,083220,Chow; Bennett,10,0,32,22
1658008384766,MATH 142A,A03,093480,Chow; Bennett,9,0,32,23
1658008384766,MATH 142A,B03,093481,Chow; Bennett,8,0,32,24
1658008384766,MATH 142A,B04,093558,Chow; Bennett,14,0,32,18
1658008384766,MATH 142A,B05,093559,Chow; Bennett,7,0,32,25
1658008390788,MATH 193A,A01,083224,Rotar; Vladimir,9,0,34,25
1658008390788,MATH 193A,A02,083225,Rotar; Vladimir,11,0,34,23
1658008390788,MATH 193A,A03,083781,Rotar; Vladimir,5,0,34,29
1658008390788,MATH 193A,A04,083782,Rotar; Vladimir,12,0,34,22
1658008390788,MATH 193A,A05,093482,Rotar; Vladimir,11,0,34,23
1658008396812,MATH 197,001,091859,McAuley; Julian John,9999,0,9999,0
1658008396812,MATH 197,002,095566,Kedlaya; Kiran S.,9997,0,9999,2
1658008396812,MATH 197,003,095567,Xiao; Ming,9999,0,9999,0
1658008396812,MATH 197,004,095571,Perols; Johan Lars,9998,0,9999,1
1658008403873,COGS 9,A01,083615,Shannon; Kyle Michael,11,0,75,64
1658008409895,COGS 11,A01,083617,Boyle; Mary E. T.,23,0,48,25
1658008415919,COGS 13,A01,083071,Bastos; Amalia Pinkusfeld,12,0,71,59
1658008421950,COGS 14A,A01,092681,Semenuks; Arturs,5,1,100,95
1658008427973,COGS 14B,A01,083073,Cheng; Tzu-Han,7,0,63,56
1658008433998,COGS 17,A01,092677,Semenuks; Arturs,7,0,81,74
1658008440023,COGS 100,A01,083619,Allen; Michael Gordon,17,0,70,53
1658008446046,COGS 101A,A01,083621,Davis; Joshua Daniel,9,0,68,59
1658008452072,COGS 101B,A01,091572,Allen; Michael Gordon,14,0,65,51
1658008458102,COGS 101C,A01,083625,Delgado; Tania,17,0,35,18
1658008464127,COGS 107A,A01,083627,Boyle; Mary E. T.,14,0,60,46
1658008470153,COGS 118A,A01,083075,Gupta; Anjum,21,0,76,55
1658008476180,CSE 3,A50,083646,Miranda; Gregory Joseph,24,0,50,26
1658008482208,CSE 8A,A50,083650,Miranda; Gregory Joseph,17,1,56,39
1658008488236,CSE 11,A01,083080,Cao; Yingjun,7,15,40,33
1658008494262,CSE 12,A01,083652,Krause-Levy; Sophia Louisa,30,1,120,90
1658008500285,CSE 15L,A01,083654,Morris; Justin Loren,9,0,50,41
1658008500285,CSE 15L,A02,083655,Morris; Justin Loren,11,0,50,39
1658008506308,CSE 20,A01,083657,Tran; Khoa Dang,39,0,80,41
1658008512335,CSE 21,A01,095574,Bach; Quang Tran,23,0,48,25
1658008518357,CSE 30,A01,083084,Eldon; John,8,0,80,72
1658008518357,CSE 30,B01,095061,Bhaskar; Nishant,9,0,50,41
1658008524381,CSE 100,A01,083659,Cao; Yingjun,5,4,70,65
1658008530407,CSE 134B,A01,083661,Powell; Thomas Allan,25,0,100,75
1658008536434,CSE 140,A01,083663,Gungor; Onat,17,0,85,68
1658008542457,CSE 140L,A01,083088,Eldon; John,23,0,100,77
1658008548484,CSE 175,A01,083665,Kumar; Rakesh,3,0,25,22
1658008554508,CSE 190,A00,092507,Dubnov; Shlomo,8,0,20,12
1658008560538,ECE 45,A01,083139,Congero; Spencer William,7,0,75,68
1658008566593,ECE 65,A50,083695,Saad; Andrew S,12,0,30,18
1658008566593,ECE 65,A51,095125,Saad; Andrew S,24,0,26,2
1658008572616,ECE 109,A01,091882,Touri; Behrouz,21,0,70,49
1658008578643,ECE 180,A00,083140,Abi Samra; Nicholas Camill,1,0,30,29
1658008578643,ECE 180,B00,083141,Abi Samra; Nicholas Camill,0,0,30,30
1658008584676,MATH 10A,A01,083735,Patchell; Gregory David,2,0,30,28
1658008584676,MATH 10A,A02,083736,Patchell; Gregory David,20,0,30,10
1658008584676,MATH 10A,A03,083737,Patchell; Gregory David,16,0,30,14
1658008590699,MATH 10B,A01,083207,Lim; Seonhee,9,0,34,25
1658008590699,MATH 10B,A02,083208,Lim; Seonhee,10,0,35,25
1658008590699,MATH 10B,A03,093472,Lim; Seonhee,7,0,34,27
1658008590699,MATH 10B,B01,083739,Sinha; Shubham,14,0,30,16
1658008596728,MATH 18,A01,083743,Cinel; Cameron Alexander,9,0,30,21
1658008596728,MATH 18,A02,083744,Cinel; Cameron Alexander,18,0,30,12
1658008596728,MATH 18,A03,083745,Cinel; Cameron Alexander,10,0,30,20
1658008596728,MATH 18,B01,083748,Rideout; David Porter,5,0,37,32
1658008596728,MATH 18,B02,083749,Rideout; David Porter,5,0,36,31
1658008596728,MATH 18,B03,083750,Rideout; David Porter,3,0,37,34
1658008596728,MATH 18,B04,083751,Rideout; David Porter,7,0,36,29
1658008596728,MATH 18,B05,093473,Rideout; David Porter,7,0,36,29
1658008596728,MATH 18,B06,093474,Rideout; David Porter,6,0,36,30
1658008602759,MATH 20A,A01,083754,Zheng; Zequn,14,0,40,26
1658008608782,MATH 20B,A01,083756,Briones; Jor-el Thomas Caparas,4,0,36,32
1658008608782,MATH 20B,A02,083757,Briones; Jor-el Thomas Caparas,1,0,36,35
1658008608782,MATH 20B,A03,093475,Briones; Jor-el Thomas Caparas,3,0,36,33
1658008614810,MATH 20C,A01,083760,Briones; Jor-el Thomas Caparas,1,0,35,34
1658008614810,MATH 20C,A02,083761,Briones; Jor-el Thomas Caparas,8,0,35,27
1658008614810,MATH 20C,A03,093476,Briones; Jor-el Thomas Caparas,0,1,36,36
1658008614810,MATH 20C,B01,083762,Bach; Quang Tran,1,0,30,29
1658008620833,MATH 20D,A01,083765,Tran; Brian Kha,5,0,30,25
1658008620833,MATH 20D,A02,083766,Tran; Brian Kha,5,0,30,25
1658008620833,MATH 20D,A03,083767,Tran; Brian Kha,6,0,30,24
1658008626877,MATH 20E,A01,083771,Ganguly; Soumya,12,0,32,20
1658008626877,MATH 20E,A02,083772,Ganguly; Soumya,7,0,32,25
1658008626877,MATH 20E,B01,083773,Ciotti; Benjamin,20,0,35,15
1658008626877,MATH 20E,B02,083774,Ciotti; Benjamin,18,0,35,17
1658008632913,MATH 103A,A01,083777,Greenfeld; Be'Eri,6,0,36,30
1658008632913,MATH 103A,A02,083778,Greenfeld; Be'Eri,5,0,36,31
1658008632913,MATH 103A,A03,093561,Greenfeld; Be'Eri,7,0,36,29
1658008632913,MATH 103A,B01,083779,Greenfeld; Be'Eri,8,0,36,28
1658008632913,MATH 103A,B02,083780,Greenfeld; Be'Eri,4,0,36,32
1658008632913,MATH 103A,B03,093562,Greenfeld; Be'Eri,3,0,36,33
1658008638936,MATH 105,A01,085443,Carter; Anne Toulson,15,0,35,20
1658008638936,MATH 105,A02,093477,Carter; Anne Toulson,20,0,35,15
1658008644961,MATH 109,A01,083213,Ganzberger; Geoffrey Michael,3,0,34,31
1658008644961,MATH 109,A02,083214,Ganzberger; Geoffrey Michael,4,0,34,30
1658008644961,MATH 109,A03,093478,Ganzberger; Geoffrey Michael,2,0,34,32
1658008644961,MATH 109,B01,083215,Ganzberger; Geoffrey Michael,3,0,32,29
1658008644961,MATH 109,B02,083216,Ganzberger; Geoffrey Michael,3,0,32,29
1658008644961,MATH 109,B03,093479,Ganzberger; Geoffrey Michael,8,0,32,24
1658008650984,MATH 142A,A01,083219,Chow; Bennett,7,0,32,25
1658008650984,MATH 142A,A02,083220,Chow; Bennett,10,0,32,22
1658008650984,MATH 142A,A03,093480,Chow; Bennett,9,0,32,23
1658008650984,MATH 142A,B03,093481,Chow; Bennett,8,0,32,24
1658008650984,MATH 142A,B04,093558,Chow; Bennett,14,0,32,18
1658008650984,MATH 142A,B05,093559,Chow; Bennett,7,0,32,25
1658008657012,MATH 193A,A01,083224,Rotar; Vladimir,9,0,34,25
1658008657012,MATH 193A,A02,083225,Rotar; Vladimir,11,0,34,23
1658008657012,MATH 193A,A03,083781,Rotar; Vladimir,5,0,34,29
1658008657012,MATH 193A,A04,083782,Rotar; Vladimir,12,0,34,22
1658008657012,MATH 193A,A05,093482,Rotar; Vladimir,11,0,34,23
1658008663036,MATH 197,001,091859,McAuley; Julian John,9999,0,9999,0
1658008663036,MATH 197,002,095566,Kedlaya; Kiran S.,9997,0,9999,2
1658008663036,MATH 197,003,095567,Xiao; Ming,9999,0,9999,0
1658008663036,MATH 197,004,095571,Perols; Johan Lars,9998,0,9999,1
1658008670092,COGS 9,A01,083615,Shannon; Kyle Michael,11,0,75,64
1658008676114,COGS 11,A01,083617,Boyle; Mary E. T.,23,0,48,25
1658008682142,COGS 13,A01,083071,Bastos; Amalia Pinkusfeld,12,0,71,59
1658008688165,COGS 14A,A01,092681,Semenuks; Arturs,5,1,100,95
1658008694189,COGS 14B,A01,083073,Cheng; Tzu-Han,7,0,63,56
1658008700214,COGS 17,A01,092677,Semenuks; Arturs,7,0,81,74
1658008706241,COGS 100,A01,083619,Allen; Michael Gordon,17,0,70,53
1658008712265,COGS 101A,A01,083621,Davis; Joshua Daniel,9,0,68,59
1658008718292,COGS 101B,A01,091572,Allen; Michael Gordon,14,0,65,51
1658008724319,COGS 101C,A01,083625,Delgado; Tania,17,0,35,18
1658008730342,COGS 107A,A01,083627,Boyle; Mary E. T.,14,0,60,46
1658008736369,COGS 118A,A01,083075,Gupta; Anjum,21,0,76,55
1658008742398,CSE 3,A50,083646,Miranda; Gregory Joseph,24,0,50,26
1658008748421,CSE 8A,A50,083650,Miranda; Gregory Joseph,17,1,56,39
1658008754444,CSE 11,A01,083080,Cao; Yingjun,7,15,40,33
1658008760473,CSE 12,A01,083652,Krause-Levy; Sophia Louisa,30,1,120,90
1658008766501,CSE 15L,A01,083654,Morris; Justin Loren,9,0,50,41
1658008766501,CSE 15L,A02,083655,Morris; Justin Loren,11,0,50,39
1658008772523,CSE 20,A01,083657,Tran; Khoa Dang,39,0,80,41
1658008778547,CSE 21,A01,095574,Bach; Quang Tran,23,0,48,25
1658008784575,CSE 30,A01,083084,Eldon; John,8,0,80,72
1658008784575,CSE 30,B01,095061,Bhaskar; Nishant,9,0,50,41
1658008790600,CSE 100,A01,083659,Cao; Yingjun,5,4,70,65
1658008796622,CSE 134B,A01,083661,Powell; Thomas Allan,25,0,100,75
1658008802649,CSE 140,A01,083663,Gungor; Onat,17,0,85,68
1658008808675,CSE 140L,A01,083088,Eldon; John,23,0,100,77
1658008814701,CSE 175,A01,083665,Kumar; Rakesh,3,0,25,22
1658008820803,CSE 190,A00,092507,Dubnov; Shlomo,8,0,20,12
1658008826830,ECE 45,A01,083139,Congero; Spencer William,7,0,75,68
1658008832855,ECE 65,A50,083695,Saad; Andrew S,12,0,30,18
1658008832855,ECE 65,A51,095125,Saad; Andrew S,24,0,26,2
1658008838880,ECE 109,A01,091882,Touri; Behrouz,21,0,70,49
1658008844906,ECE 180,A00,083140,Abi Samra; Nicholas Camill,1,0,30,29
1658008844906,ECE 180,B00,083141,Abi Samra; Nicholas Camill,0,0,30,30
1658008850934,MATH 10A,A01,083735,Patchell; Gregory David,2,0,30,28
1658008850934,MATH 10A,A02,083736,Patchell; Gregory David,20,0,30,10
1658008850934,MATH 10A,A03,083737,Patchell; Gregory David,16,0,30,14
1658008856957,MATH 10B,A01,083207,Lim; Seonhee,9,0,34,25
1658008856957,MATH 10B,A02,083208,Lim; Seonhee,10,0,35,25
1658008856957,MATH 10B,A03,093472,Lim; Seonhee,7,0,34,27
1658008856957,MATH 10B,B01,083739,Sinha; Shubham,14,0,30,16
1658008862979,MATH 18,A01,083743,Cinel; Cameron Alexander,9,0,30,21
1658008862979,MATH 18,A02,083744,Cinel; Cameron Alexander,18,0,30,12
1658008862979,MATH 18,A03,083745,Cinel; Cameron Alexander,10,0,30,20
1658008862979,MATH 18,B01,083748,Rideout; David Porter,5,0,37,32
1658008862979,MATH 18,B02,083749,Rideout; David Porter,5,0,36,31
1658008862979,MATH 18,B03,083750,Rideout; David Porter,3,0,37,34
1658008862979,MATH 18,B04,083751,Rideout; David Porter,7,0,36,29
1658008862979,MATH 18,B05,093473,Rideout; David Porter,7,0,36,29
1658008862979,MATH 18,B06,093474,Rideout; David Porter,6,0,36,30
1658008869005,MATH 20A,A01,083754,Zheng; Zequn,14,0,40,26
1658008875032,MATH 20B,A01,083756,Briones; Jor-el Thomas Caparas,4,0,36,32
1658008875032,MATH 20B,A02,083757,Briones; Jor-el Thomas Caparas,1,0,36,35
1658008875032,MATH 20B,A03,093475,Briones; Jor-el Thomas Caparas,3,0,36,33
1658008881055,MATH 20C,A01,083760,Briones; Jor-el Thomas Caparas,1,0,35,34
1658008881055,MATH 20C,A02,083761,Briones; Jor-el Thomas Caparas,8,0,35,27
1658008881055,MATH 20C,A03,093476,Briones; Jor-el Thomas Caparas,0,1,36,36
1658008881055,MATH 20C,B01,083762,Bach; Quang Tran,1,0,30,29
1658008887078,MATH 20D,A01,083765,Tran; Brian Kha,5,0,30,25
1658008887078,MATH 20D,A02,083766,Tran; Brian Kha,5,0,30,25
1658008887078,MATH 20D,A03,083767,Tran; Brian Kha,6,0,30,24
1658008893101,MATH 20E,A01,083771,Ganguly; Soumya,12,0,32,20
1658008893101,MATH 20E,A02,083772,Ganguly; Soumya,7,0,32,25
1658008893101,MATH 20E,B01,083773,Ciotti; Benjamin,20,0,35,15
1658008893101,MATH 20E,B02,083774,Ciotti; Benjamin,18,0,35,17
1658008899125,MATH 103A,A01,083777,Greenfeld; Be'Eri,6,0,36,30
1658008899125,MATH 103A,A02,083778,Greenfeld; Be'Eri,5,0,36,31
1658008899125,MATH 103A,A03,093561,Greenfeld; Be'Eri,7,0,36,29
1658008899125,MATH 103A,B01,083779,Greenfeld; Be'Eri,8,0,36,28
1658008899125,MATH 103A,B02,083780,Greenfeld; Be'Eri,4,0,36,32
1658008899125,MATH 103A,B03,093562,Greenfeld; Be'Eri,3,0,36,33
1658008905148,MATH 105,A01,085443,Carter; Anne Toulson,15,0,35,20
1658008905148,MATH 105,A02,093477,Carter; Anne Toulson,20,0,35,15
1658008911180,MATH 109,A01,083213,Ganzberger; Geoffrey Michael,3,0,34,31
1658008911180,MATH 109,A02,083214,Ganzberger; Geoffrey Michael,4,0,34,30
1658008911180,MATH 109,A03,093478,Ganzberger; Geoffrey Michael,2,0,34,32
1658008911180,MATH 109,B01,083215,Ganzberger; Geoffrey Michael,3,0,32,29
1658008911180,MATH 109,B02,083216,Ganzberger; Geoffrey Michael,3,0,32,29
1658008911180,MATH 109,B03,093479,Ganzberger; Geoffrey Michael,8,0,32,24
1658008917204,MATH 142A,A01,083219,Chow; Bennett,7,0,32,25
1658008917204,MATH 142A,A02,083220,Chow; Bennett,10,0,32,22
1658008917204,MATH 142A,A03,093480,Chow; Bennett,9,0,32,23
1658008917204,MATH 142A,B03,093481,Chow; Bennett,8,0,32,24
1658008917204,MATH 142A,B04,093558,Chow; Bennett,14,0,32,18
1658008917204,MATH 142A,B05,093559,Chow; Bennett,7,0,32,25
1658008923225,MATH 193A,A01,083224,Rotar; Vladimir,9,0,34,25
1658008923225,MATH 193A,A02,083225,Rotar; Vladimir,11,0,34,23
1658008923225,MATH 193A,A03,083781,Rotar; Vladimir,5,0,34,29
1658008923225,MATH 193A,A04,083782,Rotar; Vladimir,12,0,34,22
1658008923225,MATH 193A,A05,093482,Rotar; Vladimir,11,0,34,23
1658008929252,MATH 197,001,091859,McAuley; Julian John,9999,0,9999,0
1658008929252,MATH 197,002,095566,Kedlaya; Kiran S.,9997,0,9999,2
1658008929252,MATH 197,003,095567,Xiao; Ming,9999,0,9999,0
1658008929252,MATH 197,004,095571,Perols; Johan Lars,9998,0,9999,1
1658008936312,COGS 9,A01,083615,Shannon; Kyle Michael,11,0,75,64
1658008942334,COGS 11,A01,083617,Boyle; Mary E. T.,23,0,48,25
1658008948359,COGS 13,A01,083071,Bastos; Amalia Pinkusfeld,12,0,71,59
1658008954385,COGS 14A,A01,092681,Semenuks; Arturs,5,1,100,95
1658008960408,COGS 14B,A01,083073,Cheng; Tzu-Han,7,0,63,56
1658008966433,COGS 17,A01,092677,Semenuks; Arturs,7,0,81,74
1658008972453,COGS 100,A01,083619,Allen; Michael Gordon,17,0,70,53
1658008978481,COGS 101A,A01,083621,Davis; Joshua Daniel,9,0,68,59
1658008984505,COGS 101B,A01,091572,Allen; Michael Gordon,14,0,65,51
1658008990529,COGS 101C,A01,083625,Delgado; Tania,17,0,35,18
1658008996553,COGS 107A,A01,083627,Boyle; Mary E. T.,14,0,60,46
1658009002581,COGS 118A,A01,083075,Gupta; Anjum,21,0,76,55
1658009008603,CSE 3,A50,083646,Miranda; Gregory Joseph,24,0,50,26
1658009014628,CSE 8A,A50,083650,Miranda; Gregory Joseph,17,1,56,39
1658009020654,CSE 11,A01,083080,Cao; Yingjun,7,15,40,33
1658009026676,CSE 12,A01,083652,Krause-Levy; Sophia Louisa,30,1,120,90
1658009032700,CSE 15L,A01,083654,Morris; Justin Loren,9,0,50,41
1658009032700,CSE 15L,A02,083655,Morris; Justin Loren,11,0,50,39
1658009038725,CSE 20,A01,083657,Tran; Khoa Dang,39,0,80,41
1658009044748,CSE 21,A01,095574,Bach; Quang Tran,23,0,48,25
1658009050770,CSE 30,A01,083084,Eldon; John,8,0,80,72
1658009050770,CSE 30,B01,095061,Bhaskar; Nishant,9,0,50,41
1658009056792,CSE 100,A01,083659,Cao; Yingjun,5,4,70,65
1658009062817,CSE 134B,A01,083661,Powell; Thomas Allan,25,0,100,75
1658009068838,CSE 140,A01,083663,Gungor; Onat,17,0,85,68
1658009074864,CSE 140L,A01,083088,Eldon; John,23,0,100,77
1658009080888,CSE 175,A01,083665,Kumar; Rakesh,3,0,25,22
1658009086912,CSE 190,A00,092507,Dubnov; Shlomo,8,0,20,12
1658009092933,ECE 45,A01,083139,Congero; Spencer William,7,0,75,68
1658009098958,ECE 65,A50,083695,Saad; Andrew S,12,0,30,18
1658009098958,ECE 65,A51,095125,Saad; Andrew S,24,0,26,2
1658009104981,ECE 109,A01,091882,Touri; Behrouz,21,0,70,49
1658009111008,ECE 180,A00,083140,Abi Samra; Nicholas Camill,1,0,30,29
1658009111008,ECE 180,B00,083141,Abi Samra; Nicholas Camill,0,0,30,30
1658009117033,MATH 10A,A01,083735,Patchell; Gregory David,2,0,30,28
1658009117033,MATH 10A,A02,083736,Patchell; Gregory David,20,0,30,10
1658009117033,MATH 10A,A03,083737,Patchell; Gregory David,16,0,30,14
1658009123055,MATH 10B,A01,083207,Lim; Seonhee,9,0,34,25
1658009123055,MATH 10B,A02,083208,Lim; Seonhee,10,0,35,25
1658009123055,MATH 10B,A03,093472,Lim; Seonhee,7,0,34,27
1658009123055,MATH 10B,B01,083739,Sinha; Shubham,14,0,30,16
1658009129088,MATH 18,A01,083743,Cinel; Cameron Alexander,9,0,30,21
1658009129088,MATH 18,A02,083744,Cinel; Cameron Alexander,18,0,30,12
1658009129088,MATH 18,A03,083745,Cinel; Cameron Alexander,10,0,30,20
1658009129088,MATH 18,B01,083748,Rideout; David Porter,5,0,37,32
1658009129088,MATH 18,B02,083749,Rideout; David Porter,5,0,36,31
1658009129088,MATH 18,B03,083750,Rideout; David Porter,3,0,37,34
1658009129088,MATH 18,B04,083751,Rideout; David Porter,7,0,36,29
1658009129088,MATH 18,B05,093473,Rideout; David Porter,7,0,36,29
1658009129088,MATH 18,B06,093474,Rideout; David Porter,6,0,36,30
1658009135110,MATH 20A,A01,083754,Zheng; Zequn,14,0,40,26
1658009141137,MATH 20B,A01,083756,Briones; Jor-el Thomas Caparas,4,0,36,32
1658009141137,MATH 20B,A02,083757,Briones; Jor-el Thomas Caparas,1,0,36,35
1658009141137,MATH 20B,A03,093475,Briones; Jor-el Thomas Caparas,3,0,36,33
1658009147159,MATH 20C,A01,083760,Briones; Jor-el Thomas Caparas,1,0,35,34
1658009147159,MATH 20C,A02,083761,Briones; Jor-el Thomas Caparas,8,0,35,27
1658009147159,MATH 20C,A03,093476,Briones; Jor-el Thomas Caparas,0,1,36,36
1658009147159,MATH 20C,B01,083762,Bach; Quang Tran,1,0,30,29
1658009153181,MATH 20D,A01,083765,Tran; Brian Kha,5,0,30,25
1658009153181,MATH 20D,A02,083766,Tran; Brian Kha,5,0,30,25
1658009153181,MATH 20D,A03,083767,Tran; Brian Kha,6,0,30,24
1658009159214,MATH 20E,A01,083771,Ganguly; Soumya,12,0,32,20
1658009159214,MATH 20E,A02,083772,Ganguly; Soumya,7,0,32,25
1658009159214,MATH 20E,B01,083773,Ciotti; Benjamin,20,0,35,15
1658009159214,MATH 20E,B02,083774,Ciotti; Benjamin,18,0,35,17
1658009165236,MATH 103A,A01,083777,Greenfeld; Be'Eri,6,0,36,30
1658009165236,MATH 103A,A02,083778,Greenfeld; Be'Eri,5,0,36,31
1658009165236,MATH 103A,A03,093561,Greenfeld; Be'Eri,7,0,36,29
1658009165236,MATH 103A,B01,083779,Greenfeld; Be'Eri,8,0,36,28
1658009165236,MATH 103A,B02,083780,Greenfeld; Be'Eri,4,0,36,32
1658009165236,MATH 103A,B03,093562,Greenfeld; Be'Eri,3,0,36,33
1658009171257,MATH 105,A01,085443,Carter; Anne Toulson,15,0,35,20
1658009171257,MATH 105,A02,093477,Carter; Anne Toulson,20,0,35,15
1658009177282,MATH 109,A01,083213,Ganzberger; Geoffrey Michael,3,0,34,31
1658009177282,MATH 109,A02,083214,Ganzberger; Geoffrey Michael,4,0,34,30
1658009177282,MATH 109,A03,093478,Ganzberger; Geoffrey Michael,2,0,34,32
1658009177282,MATH 109,B01,083215,Ganzberger; Geoffrey Michael,3,0,32,29
1658009177282,MATH 109,B02,083216,Ganzberger; Geoffrey Michael,3,0,32,29
1658009177282,MATH 109,B03,093479,Ganzberger; Geoffrey Michael,8,0,32,24
1658009183310,MATH 142A,A01,083219,Chow; Bennett,7,0,32,25
1658009183310,MATH 142A,A02,083220,Chow; Bennett,10,0,32,22
1658009183310,MATH 142A,A03,093480,Chow; Bennett,9,0,32,23
1658009183310,MATH 142A,B03,093481,Chow; Bennett,8,0,32,24
1658009183310,MATH 142A,B04,093558,Chow; Bennett,14,0,32,18
1658009183310,MATH 142A,B05,093559,Chow; Bennett,7,0,32,25
1658009189336,MATH 193A,A01,083224,Rotar; Vladimir,9,0,34,25
1658009189336,MATH 193A,A02,083225,Rotar; Vladimir,11,0,34,23
1658009189336,MATH 193A,A03,083781,Rotar; Vladimir,5,0,34,29
1658009189336,MATH 193A,A04,083782,Rotar; Vladimir,12,0,34,22
1658009189336,MATH 193A,A05,093482,Rotar; Vladimir,11,0,34,23
1658009195366,MATH 197,001,091859,McAuley; Julian John,9999,0,9999,0
1658009195366,MATH 197,002,095566,Kedlaya; Kiran S.,9997,0,9999,2
1658009195366,MATH 197,003,095567,Xiao; Ming,9999,0,9999,0
1658009195366,MATH 197,004,095571,Perols; Johan Lars,9998,0,9999,1
1658009202433,COGS 9,A01,083615,Shannon; Kyle Michael,11,0,75,64
1658009208460,COGS 11,A01,083617,Boyle; Mary E. T.,23,0,48,25
1658009214487,COGS 13,A01,083071,Bastos; Amalia Pinkusfeld,12,0,71,59
1658009220518,COGS 14A,A01,092681,Semenuks; Arturs,5,1,100,95
1658009226540,COGS 14B,A01,083073,Cheng; Tzu-Han,7,0,63,56
1658009232562,COGS 17,A01,092677,Semenuks; Arturs,7,0,81,74
1658009238589,COGS 100,A01,083619,Allen; Michael Gordon,17,0,70,53
1658009244613,COGS 101A,A01,083621,Davis; Joshua Daniel,9,0,68,59
1658009250635,COGS 101B,A01,091572,Allen; Michael Gordon,14,0,65,51
1658009256659,COGS 101C,A01,083625,Delgado; Tania,17,0,35,18
1658009262682,COGS 107A,A01,083627,Boyle; Mary E. T.,14,0,60,46
1658009268709,COGS 118A,A01,083075,Gupta; Anjum,21,0,76,55
1658009274746,CSE 3,A50,083646,Miranda; Gregory Joseph,24,0,50,26
1658009280771,CSE 8A,A50,083650,Miranda; Gregory Joseph,17,1,56,39
1658009286803,CSE 11,A01,083080,Cao; Yingjun,7,15,40,33
1658009292825,CSE 12,A01,083652,Krause-Levy; Sophia Louisa,30,1,120,90
1658009298851,CSE 15L,A01,083654,Morris; Justin Loren,9,0,50,41
1658009298851,CSE 15L,A02,083655,Morris; Justin Loren,11,0,50,39
1658009304877,CSE 20,A01,083657,Tran; Khoa Dang,39,0,80,41
1658009310904,CSE 21,A01,095574,Bach; Quang Tran,23,0,48,25
1658009316927,CSE 30,A01,083084,Eldon; John,8,0,80,72
1658009316927,CSE 30,B01,095061,Bhaskar; Nishant,9,0,50,41
1658009322949,CSE 100,A01,083659,Cao; Yingjun,5,4,70,65
1658009328972,CSE 134B,A01,083661,Powell; Thomas Allan,25,0,100,75
1658009334997,CSE 140,A01,083663,Gungor; Onat,17,0,85,68
1658009341023,CSE 140L,A01,083088,Eldon; John,23,0,100,77
1658009347054,CSE 175,A01,083665,Kumar; Rakesh,3,0,25,22
1658009353076,CSE 190,A00,092507,Dubnov; Shlomo,8,0,20,12
1658009359103,ECE 45,A01,083139,Congero; Spencer William,7,0,75,68
1658009365131,ECE 65,A50,083695,Saad; Andrew S,12,0,30,18
1658009365131,ECE 65,A51,095125,Saad; Andrew S,24,0,26,2
1658009371158,ECE 109,A01,091882,Touri; Behrouz,21,0,70,49
1658009377180,ECE 180,A00,083140,Abi Samra; Nicholas Camill,1,0,30,29
1658009377180,ECE 180,B00,083141,Abi Samra; Nicholas Camill,0,0,30,30
1658009383204,MATH 10A,A01,083735,Patchell; Gregory David,2,0,30,28
1658009383204,MATH 10A,A02,083736,Patchell; Gregory David,20,0,30,10
1658009383204,MATH 10A,A03,083737,Patchell; Gregory David,16,0,30,14
1658009389226,MATH 10B,A01,083207,Lim; Seonhee,9,0,34,25
1658009389226,MATH 10B,A02,083208,Lim; Seonhee,10,0,35,25
1658009389226,MATH 10B,A03,093472,Lim; Seonhee,7,0,34,27
1658009389226,MATH 10B,B01,083739,Sinha; Shubham,14,0,30,16
1658009395257,MATH 18,A01,083743,Cinel; Cameron Alexander,9,0,30,21
1658009395257,MATH 18,A02,083744,Cinel; Cameron Alexander,18,0,30,12
1658009395257,MATH 18,A03,083745,Cinel; Cameron Alexander,10,0,30,20
1658009395257,MATH 18,B01,083748,Rideout; David Porter,5,0,37,32
1658009395257,MATH 18,B02,083749,Rideout; David Porter,5,0,36,31
1658009395257,MATH 18,B03,083750,Rideout; David Porter,3,0,37,34
1658009395257,MATH 18,B04,083751,Rideout; David Porter,7,0,36,29
1658009395257,MATH 18,B05,093473,Rideout; David Porter,7,0,36,29
1658009395257,MATH 18,B06,093474,Rideout; David Porter,6,0,36,30
1658009401283,MATH 20A,A01,083754,Zheng; Zequn,14,0,40,26
1658009407310,MATH 20B,A01,083756,Briones; Jor-el Thomas Caparas,4,0,36,32
1658009407310,MATH 20B,A02,083757,Briones; Jor-el Thomas Caparas,1,0,36,35
1658009407310,MATH 20B,A03,093475,Briones; Jor-el Thomas Caparas,3,0,36,33
1658009413333,MATH 20C,A01,083760,Briones; Jor-el Thomas Caparas,1,0,35,34
1658009413333,MATH 20C,A02,083761,Briones; Jor-el Thomas Caparas,8,0,35,27
1658009413333,MATH 20C,A03,093476,Briones; Jor-el Thomas Caparas,0,1,36,36
1658009413333,MATH 20C,B01,083762,Bach; Quang Tran,1,0,30,29
1658009419456,MATH 20D,A01,083765,Tran; Brian Kha,5,0,30,25
1658009419456,MATH 20D,A02,083766,Tran; Brian Kha,5,0,30,25
1658009419456,MATH 20D,A03,083767,Tran; Brian Kha,6,0,30,24
1658009425481,MATH 20E,A01,083771,Ganguly; Soumya,12,0,32,20
1658009425481,MATH 20E,A02,083772,Ganguly; Soumya,7,0,32,25
1658009425481,MATH 20E,B01,083773,Ciotti; Benjamin,20,0,35,15
1658009425481,MATH 20E,B02,083774,Ciotti; Benjamin,18,0,35,17
1658009431516,MATH 103A,A01,083777,Greenfeld; Be'Eri,6,0,36,30
1658009431516,MATH 103A,A02,083778,Greenfeld; Be'Eri,5,0,36,31
1658009431516,MATH 103A,A03,093561,Greenfeld; Be'Eri,7,0,36,29
1658009431516,MATH 103A,B01,083779,Greenfeld; Be'Eri,8,0,36,28
1658009431516,MATH 103A,B02,083780,Greenfeld; Be'Eri,4,0,36,32
1658009431516,MATH 103A,B03,093562,Greenfeld; Be'Eri,3,0,36,33
1658009437544,MATH 105,A01,085443,Carter; Anne Toulson,15,0,35,20
1658009437544,MATH 105,A02,093477,Carter; Anne Toulson,20,0,35,15
1658009443582,MATH 109,A01,083213,Ganzberger; Geoffrey Michael,3,0,34,31
1658009443582,MATH 109,A02,083214,Ganzberger; Geoffrey Michael,4,0,34,30
1658009443582,MATH 109,A03,093478,Ganzberger; Geoffrey Michael,2,0,34,32
1658009443582,MATH 109,B01,083215,Ganzberger; Geoffrey Michael,3,0,32,29
1658009443582,MATH 109,B02,083216,Ganzberger; Geoffrey Michael,3,0,32,29
1658009443582,MATH 109,B03,093479,Ganzberger; Geoffrey Michael,8,0,32,24
1658009449605,MATH 142A,A01,083219,Chow; Bennett,7,0,32,25
1658009449605,MATH 142A,A02,083220,Chow; Bennett,10,0,32,22
1658009449605,MATH 142A,A03,093480,Chow; Bennett,9,0,32,23
1658009449605,MATH 142A,B03,093481,Chow; Bennett,8,0,32,24
1658009449605,MATH 142A,B04,093558,Chow; Bennett,14,0,32,18
1658009449605,MATH 142A,B05,093559,Chow; Bennett,7,0,32,25
1658009455633,MATH 193A,A01,083224,Rotar; Vladimir,9,0,34,25
1658009455633,MATH 193A,A02,083225,Rotar; Vladimir,11,0,34,23
1658009455633,MATH 193A,A03,083781,Rotar; Vladimir,5,0,34,29
1658009455633,MATH 193A,A04,083782,Rotar; Vladimir,12,0,34,22
1658009455633,MATH 193A,A05,093482,Rotar; Vladimir,11,0,34,23
1658009461662,MATH 197,001,091859,McAuley; Julian John,9999,0,9999,0
1658009461662,MATH 197,002,095566,Kedlaya; Kiran S.,9997,0,9999,2
1658009461662,MATH 197,003,095567,Xiao; Ming,9999,0,9999,0
1658009461662,MATH 197,004,095571,Perols; Johan Lars,9998,0,9999,1
1658009468724,COGS 9,A01,083615,Shannon; Kyle Michael,11,0,75,64
1658009474747,COGS 11,A01,083617,Boyle; Mary E. T.,23,0,48,25
1658009480774,COGS 13,A01,083071,Bastos; Amalia Pinkusfeld,12,0,71,59
1658009486797,COGS 14A,A01,092681,Semenuks; Arturs,5,1,100,95
1658009492820,COGS 14B,A01,083073,Cheng; Tzu-Han,7,0,63,56
1658009498841,COGS 17,A01,092677,Semenuks; Arturs,7,0,81,74
1658009504866,COGS 100,A01,083619,Allen; Michael Gordon,17,0,70,53
1658009510888,COGS 101A,A01,083621,Davis; Joshua Daniel,9,0,68,59
1658009516911,COGS 101B,A01,091572,Allen; Michael Gordon,14,0,65,51
1658009522935,COGS 101C,A01,083625,Delgado; Tania,17,0,35,18
1658009528958,COGS 107A,A01,083627,Boyle; Mary E. T.,14,0,60,46
1658009534982,COGS 118A,A01,083075,Gupta; Anjum,21,0,76,55
1658009541010,CSE 3,A50,083646,Miranda; Gregory Joseph,24,0,50,26
1658009547032,CSE 8A,A50,083650,Miranda; Gregory Joseph,17,1,56,39
1658009553058,CSE 11,A01,083080,Cao; Yingjun,7,15,40,33
1658009559081,CSE 12,A01,083652,Krause-Levy; Sophia Louisa,30,1,120,90
1658009565108,CSE 15L,A01,083654,Morris; Justin Loren,9,0,50,41
1658009565108,CSE 15L,A02,083655,Morris; Justin Loren,11,0,50,39
1658009571131,CSE 20,A01,083657,Tran; Khoa Dang,39,0,80,41
1658009577154,CSE 21,A01,095574,Bach; Quang Tran,23,0,48,25
1658009583179,CSE 30,A01,083084,Eldon; John,8,0,80,72
1658009583179,CSE 30,B01,095061,Bhaskar; Nishant,9,0,50,41
1658009589205,CSE 100,A01,083659,Cao; Yingjun,5,4,70,65
1658009595228,CSE 134B,A01,083661,Powell; Thomas Allan,25,0,100,75
1658009601253,CSE 140,A01,083663,Gungor; Onat,17,0,85,68
1658009607277,CSE 140L,A01,083088,Eldon; John,23,0,100,77
1658009613298,CSE 175,A01,083665,Kumar; Rakesh,3,0,25,22
1658009619322,CSE 190,A00,092507,Dubnov; Shlomo,8,0,20,12
1658009625346,ECE 45,A01,083139,Congero; Spencer William,7,0,75,68
1658009631368,ECE 65,A50,083695,Saad; Andrew S,12,0,30,18
1658009631368,ECE 65,A51,095125,Saad; Andrew S,24,0,26,2
1658009637391,ECE 109,A01,091882,Touri; Behrouz,21,0,70,49
1658009643417,ECE 180,A00,083140,Abi Samra; Nicholas Camill,1,0,30,29
1658009643417,ECE 180,B00,083141,Abi Samra; Nicholas Camill,0,0,30,30
1658009649441,MATH 10A,A01,083735,Patchell; Gregory David,2,0,30,28
1658009649441,MATH 10A,A02,083736,Patchell; Gregory David,20,0,30,10
1658009649441,MATH 10A,A03,083737,Patchell; Gregory David,16,0,30,14
1658009655469,MATH 10B,A01,083207,Lim; Seonhee,9,0,34,25
1658009655469,MATH 10B,A02,083208,Lim; Seonhee,10,0,35,25
1658009655469,MATH 10B,A03,093472,Lim; Seonhee,7,0,34,27
1658009655469,MATH 10B,B01,083739,Sinha; Shubham,14,0,30,16
1658009661494,MATH 18,A01,083743,Cinel; Cameron Alexander,9,0,30,21
1658009661494,MATH 18,A02,083744,Cinel; Cameron Alexander,18,0,30,12
1658009661494,MATH 18,A03,083745,Cinel; Cameron Alexander,10,0,30,20
1658009661494,MATH 18,B01,083748,Rideout; David Porter,5,0,37,32
1658009661494,MATH 18,B02,083749,Rideout; David Porter,5,0,36,31
1658009661494,MATH 18,B03,083750,Rideout; David Porter,3,0,37,34
1658009661494,MATH 18,B04,083751,Rideout; David Porter,7,0,36,29
1658009661494,MATH 18,B05,093473,Rideout; David Porter,7,0,36,29
1658009661494,MATH 18,B06,093474,Rideout; David Porter,6,0,36,30
1658009667563,MATH 20A,A01,083754,Zheng; Zequn,14,0,40,26
1658009673587,MATH 20B,A01,083756,Briones; Jor-el Thomas Caparas,4,0,36,32
1658009673587,MATH 20B,A02,083757,Briones; Jor-el Thomas Caparas,1,0,36,35
1658009673587,MATH 20B,A03,093475,Briones; Jor-el Thomas Caparas,3,0,36,33
1658009679616,MATH 20C,A01,083760,Briones; Jor-el Thomas Caparas,1,0,35,34
1658009679616,MATH 20C,A02,083761,Briones; Jor-el Thomas Caparas,8,0,35,27
1658009679616,MATH 20C,A03,093476,Briones; Jor-el Thomas Caparas,0,1,36,36
1658009679616,MATH 20C,B01,083762,Bach; Quang Tran,1,0,30,29
1658009685643,MATH 20D,A01,083765,Tran; Brian Kha,5,0,30,25
1658009685643,MATH 20D,A02,083766,Tran; Brian Kha,5,0,30,25
1658009685643,MATH 20D,A03,083767,Tran; Brian Kha,6,0,30,24
1658009691670,MATH 20E,A01,083771,Ganguly; Soumya,12,0,32,20
1658009691670,MATH 20E,A02,083772,Ganguly; Soumya,7,0,32,25
1658009691670,MATH 20E,B01,083773,Ciotti; Benjamin,20,0,35,15
1658009691670,MATH 20E,B02,083774,Ciotti; Benjamin,18,0,35,17
1658009697694,MATH 103A,A01,083777,Greenfeld; Be'Eri,6,0,36,30
1658009697694,MATH 103A,A02,083778,Greenfeld; Be'Eri,5,0,36,31
1658009697694,MATH 103A,A03,093561,Greenfeld; Be'Eri,7,0,36,29
1658009697694,MATH 103A,B01,083779,Greenfeld; Be'Eri,8,0,36,28
1658009697694,MATH 103A,B02,083780,Greenfeld; Be'Eri,4,0,36,32
1658009697694,MATH 103A,B03,093562,Greenfeld; Be'Eri,3,0,36,33
1658009703717,MATH 105,A01,085443,Carter; Anne Toulson,15,0,35,20
1658009703717,MATH 105,A02,093477,Carter; Anne Toulson,20,0,35,15
1658009709740,MATH 109,A01,083213,Ganzberger; Geoffrey Michael,3,0,34,31
1658009709740,MATH 109,A02,083214,Ganzberger; Geoffrey Michael,4,0,34,30
1658009709740,MATH 109,A03,093478,Ganzberger; Geoffrey Michael,2,0,34,32
1658009709740,MATH 109,B01,083215,Ganzberger; Geoffrey Michael,3,0,32,29
1658009709740,MATH 109,B02,083216,Ganzberger; Geoffrey Michael,3,0,32,29
1658009709740,MATH 109,B03,093479,Ganzberger; Geoffrey Michael,8,0,32,24
1658009715763,MATH 142A,A01,083219,Chow; Bennett,7,0,32,25
1658009715763,MATH 142A,A02,083220,Chow; Bennett,10,0,32,22
1658009715763,MATH 142A,A03,093480,Chow; Bennett,9,0,32,23
1658009715763,MATH 142A,B03,093481,Chow; Bennett,8,0,32,24
1658009715763,MATH 142A,B04,093558,Chow; Bennett,14,0,32,18
1658009715763,MATH 142A,B05,093559,Chow; Bennett,7,0,32,25
1658009721787,MATH 193A,A01,083224,Rotar; Vladimir,9,0,34,25
1658009721787,MATH 193A,A02,083225,Rotar; Vladimir,11,0,34,23
1658009721787,MATH 193A,A03,083781,Rotar; Vladimir,5,0,34,29
1658009721787,MATH 193A,A04,083782,Rotar; Vladimir,12,0,34,22
1658009721787,MATH 193A,A05,093482,Rotar; Vladimir,11,0,34,23
1658009727810,MATH 197,001,091859,McAuley; Julian John,9999,0,9999,0
1658009727810,MATH 197,002,095566,Kedlaya; Kiran S.,9997,0,9999,2
1658009727810,MATH 197,003,095567,Xiao; Ming,9999,0,9999,0
1658009727810,MATH 197,004,095571,Perols; Johan Lars,9998,0,9999,1
1658009734871,COGS 9,A01,083615,Shannon; Kyle Michael,11,0,75,64
1658009740894,COGS 11,A01,083617,Boyle; Mary E. T.,23,0,48,25
1658009746919,COGS 13,A01,083071,Bastos; Amalia Pinkusfeld,12,0,71,59
1658009752944,COGS 14A,A01,092681,Semenuks; Arturs,5,1,100,95
1658009758969,COGS 14B,A01,083073,Cheng; Tzu-Han,7,0,63,56
1658009764996,COGS 17,A01,092677,Semenuks; Arturs,7,0,81,74
1658009771020,COGS 100,A01,083619,Allen; Michael Gordon,17,0,70,53
1658009777047,COGS 101A,A01,083621,Davis; Joshua Daniel,9,0,68,59
1658009783068,COGS 101B,A01,091572,Allen; Michael Gordon,14,0,65,51
1658009789093,COGS 101C,A01,083625,Delgado; Tania,17,0,35,18
1658009795119,COGS 107A,A01,083627,Boyle; Mary E. T.,14,0,60,46
1658009801142,COGS 118A,A01,083075,Gupta; Anjum,21,0,76,55
1658009807185,CSE 3,A50,083646,Miranda; Gregory Joseph,24,0,50,26
1658009813207,CSE 8A,A50,083650,Miranda; Gregory Joseph,17,1,56,39
1658009819232,CSE 11,A01,083080,Cao; Yingjun,7,15,40,33
1658009825256,CSE 12,A01,083652,Krause-Levy; Sophia Louisa,30,1,120,90
1658009831283,CSE 15L,A01,083654,Morris; Justin Loren,9,0,50,41
1658009831283,CSE 15L,A02,083655,Morris; Justin Loren,11,0,50,39
1658009837306,CSE 20,A01,083657,Tran; Khoa Dang,39,0,80,41
1658009843334,CSE 21,A01,095574,Bach; Quang Tran,23,0,48,25
1658009849360,CSE 30,A01,083084,Eldon; John,8,0,80,72
1658009849360,CSE 30,B01,095061,Bhaskar; Nishant,9,0,50,41
1658009855385,CSE 100,A01,083659,Cao; Yingjun,5,4,70,65
1658009861411,CSE 134B,A01,083661,Powell; Thomas Allan,25,0,100,75
1658009867432,CSE 140,A01,083663,Gungor; Onat,17,0,85,68
1658009873455,CSE 140L,A01,083088,Eldon; John,23,0,100,77
1658009879488,CSE 175,A01,083665,Kumar; Rakesh,3,0,25,22
1658009885513,CSE 190,A00,092507,Dubnov; Shlomo,8,0,20,12
1658009891539,ECE 45,A01,083139,Congero; Spencer William,7,0,75,68
1658009897566,ECE 65,A50,083695,Saad; Andrew S,12,0,30,18
1658009897566,ECE 65,A51,095125,Saad; Andrew S,24,0,26,2
1658009903600,ECE 109,A01,091882,Touri; Behrouz,21,0,70,49
1658009909624,ECE 180,A00,083140,Abi Samra; Nicholas Camill,1,0,30,29
1658009909624,ECE 180,B00,083141,Abi Samra; Nicholas Camill,0,0,30,30
1658009915650,MATH 10A,A01,083735,Patchell; Gregory David,2,0,30,28
1658009915650,MATH 10A,A02,083736,Patchell; Gregory David,20,0,30,10
1658009915650,MATH 10A,A03,083737,Patchell; Gregory David,16,0,30,14
1658009921679,MATH 10B,A01,083207,Lim; Seonhee,9,0,34,25
1658009921679,MATH 10B,A02,083208,Lim; Seonhee,10,0,35,25
1658009921679,MATH 10B,A03,093472,Lim; Seonhee,7,0,34,27
1658009921679,MATH 10B,B01,083739,Sinha; Shubham,14,0,30,16
1658009927704,MATH 18,A01,083743,Cinel; Cameron Alexander,9,0,30,21
1658009927704,MATH 18,A02,083744,Cinel; Cameron Alexander,18,0,30,12
1658009927704,MATH 18,A03,083745,Cinel; Cameron Alexander,10,0,30,20
1658009927704,MATH 18,B01,083748,Rideout; David Porter,5,0,37,32
1658009927704,MATH 18,B02,083749,Rideout; David Porter,5,0,36,31
1658009927704,MATH 18,B03,083750,Rideout; David Porter,3,0,37,34
1658009927704,MATH 18,B04,083751,Rideout; David Porter,7,0,36,29
1658009927704,MATH 18,B05,093473,Rideout; David Porter,7,0,36,29
1658009927704,MATH 18,B06,093474,Rideout; David Porter,6,0,36,30
1658009933726,MATH 20A,A01,083754,Zheng; Zequn,14,0,40,26
1658009939751,MATH 20B,A01,083756,Briones; Jor-el Thomas Caparas,4,0,36,32
1658009939751,MATH 20B,A02,083757,Briones; Jor-el Thomas Caparas,1,0,36,35
1658009939751,MATH 20B,A03,093475,Briones; Jor-el Thomas Caparas,3,0,36,33
1658009945774,MATH 20C,A01,083760,Briones; Jor-el Thomas Caparas,1,0,35,34
1658009945774,MATH 20C,A02,083761,Briones; Jor-el Thomas Caparas,8,0,35,27
1658009945774,MATH 20C,A03,093476,Briones; Jor-el Thomas Caparas,0,1,36,36
1658009945774,MATH 20C,B01,083762,Bach; Quang Tran,1,0,30,29
1658009951797,MATH 20D,A01,083765,Tran; Brian Kha,5,0,30,25
1658009951797,MATH 20D,A02,083766,Tran; Brian Kha,5,0,30,25
1658009951797,MATH 20D,A03,083767,Tran; Brian Kha,6,0,30,24
1658009957827,MATH 20E,A01,083771,Ganguly; Soumya,12,0,32,20
1658009957827,MATH 20E,A02,083772,Ganguly; Soumya,7,0,32,25
1658009957827,MATH 20E,B01,083773,Ciotti; Benjamin,20,0,35,15
1658009957827,MATH 20E,B02,083774,Ciotti; Benjamin,18,0,35,17
1658009963855,MATH 103A,A01,083777,Greenfeld; Be'Eri,6,0,36,30
1658009963855,MATH 103A,A02,083778,Greenfeld; Be'Eri,5,0,36,31
1658009963855,MATH 103A,A03,093561,Greenfeld; Be'Eri,7,0,36,29
1658009963855,MATH 103A,B01,083779,Greenfeld; Be'Eri,8,0,36,28
1658009963855,MATH 103A,B02,083780,Greenfeld; Be'Eri,4,0,36,32
1658009963855,MATH 103A,B03,093562,Greenfeld; Be'Eri,3,0,36,33
1658009969878,MATH 105,A01,085443,Carter; Anne Toulson,15,0,35,20
1658009969878,MATH 105,A02,093477,Carter; Anne Toulson,20,0,35,15
1658009975902,MATH 109,A01,083213,Ganzberger; Geoffrey Michael,3,0,34,31
1658009975902,MATH 109,A02,083214,Ganzberger; Geoffrey Michael,4,0,34,30
1658009975902,MATH 109,A03,093478,Ganzberger; Geoffrey Michael,2,0,34,32
1658009975902,MATH 109,B01,083215,Ganzberger; Geoffrey Michael,3,0,32,29
1658009975902,MATH 109,B02,083216,Ganzberger; Geoffrey Michael,3,0,32,29
1658009975902,MATH 109,B03,093479,Ganzberger; Geoffrey Michael,8,0,32,24
1658009981931,MATH 142A,A01,083219,Chow; Bennett,7,0,32,25
1658009981931,MATH 142A,A02,083220,Chow; Bennett,10,0,32,22
1658009981931,MATH 142A,A03,093480,Chow; Bennett,9,0,32,23
1658009981931,MATH 142A,B03,093481,Chow; Bennett,8,0,32,24
1658009981931,MATH 142A,B04,093558,Chow; Bennett,14,0,32,18
1658009981931,MATH 142A,B05,093559,Chow; Bennett,7,0,32,25
1658009987957,MATH 193A,A01,083224,Rotar; Vladimir,9,0,34,25
1658009987957,MATH 193A,A02,083225,Rotar; Vladimir,11,0,34,23
1658009987957,MATH 193A,A03,083781,Rotar; Vladimir,5,0,34,29
1658009987957,MATH 193A,A04,083782,Rotar; Vladimir,12,0,34,22
1658009987957,MATH 193A,A05,093482,Rotar; Vladimir,11,0,34,23
1658009993979,MATH 197,001,091859,McAuley; Julian John,9999,0,9999,0
1658009993979,MATH 197,002,095566,Kedlaya; Kiran S.,9997,0,9999,2
1658009993979,MATH 197,003,095567,Xiao; Ming,9999,0,9999,0
1658009993979,MATH 197,004,095571,Perols; Johan Lars,9998,0,9999,1
1658010001035,COGS 9,A01,083615,Shannon; Kyle Michael,11,0,75,64
1658010007063,COGS 11,A01,083617,Boyle; Mary E. T.,23,0,48,25
1658010013181,COGS 13,A01,083071,Bastos; Amalia Pinkusfeld,12,0,71,59
1658010019203,COGS 14A,A01,092681,Semenuks; Arturs,5,1,100,95
1658010025230,COGS 14B,A01,083073,Cheng; Tzu-Han,7,0,63,56
1658010031255,COGS 17,A01,092677,Semenuks; Arturs,7,0,81,74
1658010037281,COGS 100,A01,083619,Allen; Michael Gordon,17,0,70,53
1658010043303,COGS 101A,A01,083621,Davis; Joshua Daniel,9,0,68,59
1658010049328,COGS 101B,A01,091572,Allen; Michael Gordon,14,0,65,51
1658010055355,COGS 101C,A01,083625,Delgado; Tania,17,0,35,18
1658010061381,COGS 107A,A01,083627,Boyle; Mary E. T.,14,0,60,46
1658010067404,COGS 118A,A01,083075,Gupta; Anjum,21,0,76,55
1658010073426,CSE 3,A50,083646,Miranda; Gregory Joseph,24,0,50,26
1658010079449,CSE 8A,A50,083650,Miranda; Gregory Joseph,17,1,56,39
1658010085474,CSE 11,A01,083080,Cao; Yingjun,7,15,40,33
1658010091495,CSE 12,A01,083652,Krause-Levy; Sophia Louisa,30,1,120,90
1658010097521,CSE 15L,A01,083654,Morris; Justin Loren,9,0,50,41
1658010097521,CSE 15L,A02,083655,Morris; Justin Loren,11,0,50,39
1658010103546,CSE 20,A01,083657,Tran; Khoa Dang,39,0,80,41
1658010109569,CSE 21,A01,095574,Bach; Quang Tran,23,0,48,25
1658010115596,CSE 30,A01,083084,Eldon; John,8,0,80,72
1658010115596,CSE 30,B01,095061,Bhaskar; Nishant,9,0,50,41
1658010121618,CSE 100,A01,083659,Cao; Yingjun,5,4,70,65
1658010127643,CSE 134B,A01,083661,Powell; Thomas Allan,25,0,100,75
1658010133669,CSE 140,A01,083663,Gungor; Onat,17,0,85,68
1658010139694,CSE 140L,A01,083088,Eldon; John,23,0,100,77
1658010145719,CSE 175,A01,083665,Kumar; Rakesh,3,0,25,22
1658010151742,CSE 190,A00,092507,Dubnov; Shlomo,8,0,20,12
1658010157764,ECE 45,A01,083139,Congero; Spencer William,7,0,75,68
1658010163786,ECE 65,A50,083695,Saad; Andrew S,12,0,30,18
1658010163786,ECE 65,A51,095125,Saad; Andrew S,24,0,26,2
1658010169811,ECE 109,A01,091882,Touri; Behrouz,21,0,70,49
1658010175839,ECE 180,A00,083140,Abi Samra; Nicholas Camill,1,0,30,29
1658010175839,ECE 180,B00,083141,Abi Samra; Nicholas Camill,0,0,30,30
1658010181860,MATH 10A,A01,083735,Patchell; Gregory David,2,0,30,28
1658010181860,MATH 10A,A02,083736,Patchell; Gregory David,20,0,30,10
1658010181860,MATH 10A,A03,083737,Patchell; Gregory David,16,0,30,14
1658010187888,MATH 10B,A01,083207,Lim; Seonhee,9,0,34,25
1658010187888,MATH 10B,A02,083208,Lim; Seonhee,10,0,35,25
1658010187888,MATH 10B,A03,093472,Lim; Seonhee,7,0,34,27
1658010187888,MATH 10B,B01,083739,Sinha; Shubham,14,0,30,16
1658010193918,MATH 18,A01,083743,Cinel; Cameron Alexander,9,0,30,21
1658010193918,MATH 18,A02,083744,Cinel; Cameron Alexander,18,0,30,12
1658010193918,MATH 18,A03,083745,Cinel; Cameron Alexander,10,0,30,20
1658010193918,MATH 18,B01,083748,Rideout; David Porter,5,0,37,32
1658010193918,MATH 18,B02,083749,Rideout; David Porter,5,0,36,31
1658010193918,MATH 18,B03,083750,Rideout; David Porter,3,0,37,34
1658010193918,MATH 18,B04,083751,Rideout; David Porter,7,0,36,29
1658010193918,MATH 18,B05,093473,Rideout; David Porter,7,0,36,29
1658010193918,MATH 18,B06,093474,Rideout; David Porter,6,0,36,30
1658010199943,MATH 20A,A01,083754,Zheng; Zequn,14,0,40,26
1658010205968,MATH 20B,A01,083756,Briones; Jor-el Thomas Caparas,4,0,36,32
1658010205968,MATH 20B,A02,083757,Briones; Jor-el Thomas Caparas,1,0,36,35
1658010205968,MATH 20B,A03,093475,Briones; Jor-el Thomas Caparas,3,0,36,33
1658010211997,MATH 20C,A01,083760,Briones; Jor-el Thomas Caparas,1,0,35,34
1658010211997,MATH 20C,A02,083761,Briones; Jor-el Thomas Caparas,8,0,35,27
1658010211997,MATH 20C,A03,093476,Briones; Jor-el Thomas Caparas,0,1,36,36
1658010211997,MATH 20C,B01,083762,Bach; Quang Tran,1,0,30,29
1658010218022,MATH 20D,A01,083765,Tran; Brian Kha,5,0,30,25
1658010218022,MATH 20D,A02,083766,Tran; Brian Kha,5,0,30,25
1658010218022,MATH 20D,A03,083767,Tran; Brian Kha,6,0,30,24
1658010224044,MATH 20E,A01,083771,Ganguly; Soumya,12,0,32,20
1658010224044,MATH 20E,A02,083772,Ganguly; Soumya,7,0,32,25
1658010224044,MATH 20E,B01,083773,Ciotti; Benjamin,20,0,35,15
1658010224044,MATH 20E,B02,083774,Ciotti; Benjamin,18,0,35,17
1658010230065,MATH 103A,A01,083777,Greenfeld; Be'Eri,6,0,36,30
1658010230065,MATH 103A,A02,083778,Greenfeld; Be'Eri,5,0,36,31
1658010230065,MATH 103A,A03,093561,Greenfeld; Be'Eri,7,0,36,29
1658010230065,MATH 103A,B01,083779,Greenfeld; Be'Eri,8,0,36,28
1658010230065,MATH 103A,B02,083780,Greenfeld; Be'Eri,4,0,36,32
1658010230065,MATH 103A,B03,093562,Greenfeld; Be'Eri,3,0,36,33
1658010236090,MATH 105,A01,085443,Carter; Anne Toulson,15,0,35,20
1658010236090,MATH 105,A02,093477,Carter; Anne Toulson,20,0,35,15
1658010242114,MATH 109,A01,083213,Ganzberger; Geoffrey Michael,3,0,34,31
1658010242114,MATH 109,A02,083214,Ganzberger; Geoffrey Michael,4,0,34,30
1658010242114,MATH 109,A03,093478,Ganzberger; Geoffrey Michael,2,0,34,32
1658010242114,MATH 109,B01,083215,Ganzberger; Geoffrey Michael,3,0,32,29
1658010242114,MATH 109,B02,083216,Ganzberger; Geoffrey Michael,3,0,32,29
1658010242114,MATH 109,B03,093479,Ganzberger; Geoffrey Michael,8,0,32,24
1658010248138,MATH 142A,A01,083219,Chow; Bennett,7,0,32,25
1658010248138,MATH 142A,A02,083220,Chow; Bennett,10,0,32,22
1658010248138,MATH 142A,A03,093480,Chow; Bennett,9,0,32,23
1658010248138,MATH 142A,B03,093481,Chow; Bennett,8,0,32,24
1658010248138,MATH 142A,B04,093558,Chow; Bennett,14,0,32,18
1658010248138,MATH 142A,B05,093559,Chow; Bennett,7,0,32,25
1658010254164,MATH 193A,A01,083224,Rotar; Vladimir,9,0,34,25
1658010254164,MATH 193A,A02,083225,Rotar; Vladimir,11,0,34,23
1658010254164,MATH 193A,A03,083781,Rotar; Vladimir,5,0,34,29
1658010254164,MATH 193A,A04,083782,Rotar; Vladimir,12,0,34,22
1658010254164,MATH 193A,A05,093482,Rotar; Vladimir,11,0,34,23
1658010260194,MATH 197,001,091859,McAuley; Julian John,9999,0,9999,0
1658010260194,MATH 197,002,095566,Kedlaya; Kiran S.,9997,0,9999,2
1658010260194,MATH 197,003,095567,Xiao; Ming,9999,0,9999,0
1658010260194,MATH 197,004,095571,Perols; Johan Lars,9998,0,9999,1
1658010267255,COGS 9,A01,083615,Shannon; Kyle Michael,11,0,75,64
1658010273282,COGS 11,A01,083617,Boyle; Mary E. T.,23,0,48,25
1658010279304,COGS 13,A01,083071,Bastos; Amalia Pinkusfeld,12,0,71,59
1658010285326,COGS 14A,A01,092681,Semenuks; Arturs,5,1,100,95
1658010291349,COGS 14B,A01,083073,Cheng; Tzu-Han,7,0,63,56
1658010297378,COGS 17,A01,092677,Semenuks; Arturs,7,0,81,74
1658010303405,COGS 100,A01,083619,Allen; Michael Gordon,17,0,70,53
1658010309432,COGS 101A,A01,083621,Davis; Joshua Daniel,9,0,68,59
1658010315455,COGS 101B,A01,091572,Allen; Michael Gordon,14,0,65,51
1658010321479,COGS 101C,A01,083625,Delgado; Tania,17,0,35,18
1658010327501,COGS 107A,A01,083627,Boyle; Mary E. T.,14,0,60,46
1658010333528,COGS 118A,A01,083075,Gupta; Anjum,21,0,76,55
1658010339554,CSE 3,A50,083646,Miranda; Gregory Joseph,24,0,50,26
1658010345576,CSE 8A,A50,083650,Miranda; Gregory Joseph,17,1,56,39
1658010351604,CSE 11,A01,083080,Cao; Yingjun,7,15,40,33
1658010357628,CSE 12,A01,083652,Krause-Levy; Sophia Louisa,30,1,120,90
1658010363655,CSE 15L,A01,083654,Morris; Justin Loren,9,0,50,41
1658010363655,CSE 15L,A02,083655,Morris; Justin Loren,11,0,50,39
1658010369682,CSE 20,A01,083657,Tran; Khoa Dang,39,0,80,41
1658010375709,CSE 21,A01,095574,Bach; Quang Tran,23,0,48,25
1658010381733,CSE 30,A01,083084,Eldon; John,8,0,80,72
1658010381733,CSE 30,B01,095061,Bhaskar; Nishant,9,0,50,41
1658010387757,CSE 100,A01,083659,Cao; Yingjun,5,4,70,65
1658010393784,CSE 134B,A01,083661,Powell; Thomas Allan,25,0,100,75
1658010399813,CSE 140,A01,083663,Gungor; Onat,17,0,85,68
1658010405841,CSE 140L,A01,083088,Eldon; John,23,0,100,77
1658010411864,CSE 175,A01,083665,Kumar; Rakesh,3,0,25,22
1658010417903,CSE 190,A00,092507,Dubnov; Shlomo,8,0,20,12
1658010423927,ECE 45,A01,083139,Congero; Spencer William,7,0,75,68
1658010429955,ECE 65,A50,083695,Saad; Andrew S,12,0,30,18
1658010429955,ECE 65,A51,095125,Saad; Andrew S,24,0,26,2
1658010435977,ECE 109,A01,091882,Touri; Behrouz,21,0,70,49
1658010442003,ECE 180,A00,083140,Abi Samra; Nicholas Camill,1,0,30,29
1658010442003,ECE 180,B00,083141,Abi Samra; Nicholas Camill,0,0,30,30
1658010448028,MATH 10A,A01,083735,Patchell; Gregory David,2,0,30,28
1658010448028,MATH 10A,A02,083736,Patchell; Gregory David,20,0,30,10
1658010448028,MATH 10A,A03,083737,Patchell; Gregory David,16,0,30,14
1658010454057,MATH 10B,A01,083207,Lim; Seonhee,9,0,34,25
1658010454057,MATH 10B,A02,083208,Lim; Seonhee,10,0,35,25
1658010454057,MATH 10B,A03,093472,Lim; Seonhee,7,0,34,27
1658010454057,MATH 10B,B01,083739,Sinha; Shubham,14,0,30,16
1658010460091,MATH 18,A01,083743,Cinel; Cameron Alexander,9,0,30,21
1658010460091,MATH 18,A02,083744,Cinel; Cameron Alexander,18,0,30,12
1658010460091,MATH 18,A03,083745,Cinel; Cameron Alexander,10,0,30,20
1658010460091,MATH 18,B01,083748,Rideout; David Porter,5,0,37,32
1658010460091,MATH 18,B02,083749,Rideout; David Porter,5,0,36,31
1658010460091,MATH 18,B03,083750,Rideout; David Porter,3,0,37,34
1658010460091,MATH 18,B04,083751,Rideout; David Porter,7,0,36,29
1658010460091,MATH 18,B05,093473,Rideout; David Porter,7,0,36,29
1658010460091,MATH 18,B06,093474,Rideout; David Porter,6,0,36,30
1658010466118,MATH 20A,A01,083754,Zheng; Zequn,14,0,40,26
1658010472149,MATH 20B,A01,083756,Briones; Jor-el Thomas Caparas,4,0,36,32
1658010472149,MATH 20B,A02,083757,Briones; Jor-el Thomas Caparas,1,0,36,35
1658010472149,MATH 20B,A03,093475,Briones; Jor-el Thomas Caparas,3,0,36,33
1658010478171,MATH 20C,A01,083760,Briones; Jor-el Thomas Caparas,1,0,35,34
1658010478171,MATH 20C,A02,083761,Briones; Jor-el Thomas Caparas,8,0,35,27
1658010478171,MATH 20C,A03,093476,Briones; Jor-el Thomas Caparas,0,1,36,36
1658010478171,MATH 20C,B01,083762,Bach; Quang Tran,1,0,30,29
1658010484194,MATH 20D,A01,083765,Tran; Brian Kha,5,0,30,25
1658010484194,MATH 20D,A02,083766,Tran; Brian Kha,5,0,30,25
1658010484194,MATH 20D,A03,083767,Tran; Brian Kha,6,0,30,24
1658010490216,MATH 20E,A01,083771,Ganguly; Soumya,12,0,32,20
1658010490216,MATH 20E,A02,083772,Ganguly; Soumya,7,0,32,25
1658010490216,MATH 20E,B01,083773,Ciotti; Benjamin,20,0,35,15
1658010490216,MATH 20E,B02,083774,Ciotti; Benjamin,18,0,35,17
1658010496245,MATH 103A,A01,083777,Greenfeld; Be'Eri,6,0,36,30
1658010496245,MATH 103A,A02,083778,Greenfeld; Be'Eri,5,0,36,31
1658010496245,MATH 103A,A03,093561,Greenfeld; Be'Eri,7,0,36,29
1658010496245,MATH 103A,B01,083779,Greenfeld; Be'Eri,8,0,36,28
1658010496245,MATH 103A,B02,083780,Greenfeld; Be'Eri,4,0,36,32
1658010496245,MATH 103A,B03,093562,Greenfeld; Be'Eri,3,0,36,33
1658010502271,MATH 105,A01,085443,Carter; Anne Toulson,15,0,35,20
1658010502271,MATH 105,A02,093477,Carter; Anne Toulson,20,0,35,15
1658010508295,MATH 109,A01,083213,Ganzberger; Geoffrey Michael,3,0,34,31
1658010508295,MATH 109,A02,083214,Ganzberger; Geoffrey Michael,4,0,34,30
1658010508295,MATH 109,A03,093478,Ganzberger; Geoffrey Michael,2,0,34,32
1658010508295,MATH 109,B01,083215,Ganzberger; Geoffrey Michael,3,0,32,29
1658010508295,MATH 109,B02,083216,Ganzberger; Geoffrey Michael,3,0,32,29
1658010508295,MATH 109,B03,093479,Ganzberger; Geoffrey Michael,8,0,32,24
1658010514325,MATH 142A,A01,083219,Chow; Bennett,7,0,32,25
1658010514325,MATH 142A,A02,083220,Chow; Bennett,10,0,32,22
1658010514325,MATH 142A,A03,093480,Chow; Bennett,9,0,32,23
1658010514325,MATH 142A,B03,093481,Chow; Bennett,8,0,32,24
1658010514325,MATH 142A,B04,093558,Chow; Bennett,14,0,32,18
1658010514325,MATH 142A,B05,093559,Chow; Bennett,7,0,32,25
1658010520348,MATH 193A,A01,083224,Rotar; Vladimir,9,0,34,25
1658010520348,MATH 193A,A02,083225,Rotar; Vladimir,11,0,34,23
1658010520348,MATH 193A,A03,083781,Rotar; Vladimir,5,0,34,29
1658010520348,MATH 193A,A04,083782,Rotar; Vladimir,12,0,34,22
1658010520348,MATH 193A,A05,093482,Rotar; Vladimir,11,0,34,23
1658010526383,MATH 197,001,091859,McAuley; Julian John,9999,0,9999,0
1658010526383,MATH 197,002,095566,Kedlaya; Kiran S.,9997,0,9999,2
1658010526383,MATH 197,003,095567,Xiao; Ming,9999,0,9999,0
1658010526383,MATH 197,004,095571,Perols; Johan Lars,9998,0,9999,1
1658010533438,COGS 9,A01,083615,Shannon; Kyle Michael,11,0,75,64
1658010539463,COGS 11,A01,083617,Boyle; Mary E. T.,23,0,48,25
1658010545485,COGS 13,A01,083071,Bastos; Amalia Pinkusfeld,12,0,71,59
1658010551512,COGS 14A,A01,092681,Semenuks; Arturs,5,1,100,95
1658010557536,COGS 14B,A01,083073,Cheng; Tzu-Han,7,0,63,56
1658010563558,COGS 17,A01,092677,Semenuks; Arturs,7,0,81,74
1658010569589,COGS 100,A01,083619,Allen; Michael Gordon,17,0,70,53
1658010575613,COGS 101A,A01,083621,Davis; Joshua Daniel,9,0,68,59
1658010581636,COGS 101B,A01,091572,Allen; Michael Gordon,14,0,65,51
1658010587661,COGS 101C,A01,083625,Delgado; Tania,17,0,35,18
1658010593689,COGS 107A,A01,083627,Boyle; Mary E. T.,14,0,60,46
1658010599722,COGS 118A,A01,083075,Gupta; Anjum,21,0,76,55
1658010605753,CSE 3,A50,083646,Miranda; Gregory Joseph,24,0,50,26
1658010611856,CSE 8A,A50,083650,Miranda; Gregory Joseph,17,1,56,39
1658010617880,CSE 11,A01,083080,Cao; Yingjun,7,15,40,33
1658010623901,CSE 12,A01,083652,Krause-Levy; Sophia Louisa,30,1,120,90
1658010629928,CSE 15L,A01,083654,Morris; Justin Loren,9,0,50,41
1658010629928,CSE 15L,A02,083655,Morris; Justin Loren,11,0,50,39
1658010635954,CSE 20,A01,083657,Tran; Khoa Dang,39,0,80,41
1658010641979,CSE 21,A01,095574,Bach; Quang Tran,23,0,48,25
1658010648003,CSE 30,A01,083084,Eldon; John,8,0,80,72
1658010648003,CSE 30,B01,095061,Bhaskar; Nishant,9,0,50,41
1658010654029,CSE 100,A01,083659,Cao; Yingjun,5,4,70,65
1658010660055,CSE 134B,A01,083661,Powell; Thomas Allan,25,0,100,75
1658010666082,CSE 140,A01,083663,Gungor; Onat,17,0,85,68
1658010672108,CSE 140L,A01,083088,Eldon; John,23,0,100,77
1658010678143,CSE 175,A01,083665,Kumar; Rakesh,3,0,25,22
1658010684169,CSE 190,A00,092507,Dubnov; Shlomo,8,0,20,12
1658010690195,ECE 45,A01,083139,Congero; Spencer William,7,0,75,68
1658010696220,ECE 65,A50,083695,Saad; Andrew S,12,0,30,18
1658010696220,ECE 65,A51,095125,Saad; Andrew S,24,0,26,2
1658010702242,ECE 109,A01,091882,Touri; Behrouz,21,0,70,49
1658010708265,ECE 180,A00,083140,Abi Samra; Nicholas Camill,1,0,30,29
1658010708265,ECE 180,B00,083141,Abi Samra; Nicholas Camill,0,0,30,30
1658010714291,MATH 10A,A01,083735,Patchell; Gregory David,2,0,30,28
1658010714291,MATH 10A,A02,083736,Patchell; Gregory David,20,0,30,10
1658010714291,MATH 10A,A03,083737,Patchell; Gregory David,16,0,30,14
1658010720314,MATH 10B,A01,083207,Lim; Seonhee,9,0,34,25
1658010720314,MATH 10B,A02,083208,Lim; Seonhee,10,0,35,25
1658010720314,MATH 10B,A03,093472,Lim; Seonhee,7,0,34,27
1658010720314,MATH 10B,B01,083739,Sinha; Shubham,14,0,30,16
1658010726343,MATH 18,A01,083743,Cinel; Cameron Alexander,9,0,30,21
1658010726343,MATH 18,A02,083744,Cinel; Cameron Alexander,18,0,30,12
1658010726343,MATH 18,A03,083745,Cinel; Cameron Alexander,10,0,30,20
1658010726343,MATH 18,B01,083748,Rideout; David Porter,5,0,37,32
1658010726343,MATH 18,B02,083749,Rideout; David Porter,5,0,36,31
1658010726343,MATH 18,B03,083750,Rideout; David Porter,3,0,37,34
1658010726343,MATH 18,B04,083751,Rideout; David Porter,7,0,36,29
1658010726343,MATH 18,B05,093473,Rideout; David Porter,7,0,36,29
1658010726343,MATH 18,B06,093474,Rideout; David Porter,6,0,36,30
1658010732366,MATH 20A,A01,083754,Zheng; Zequn,14,0,40,26
1658010738393,MATH 20B,A01,083756,Briones; Jor-el Thomas Caparas,4,0,36,32
1658010738393,MATH 20B,A02,083757,Briones; Jor-el Thomas Caparas,1,0,36,35
1658010738393,MATH 20B,A03,093475,Briones; Jor-el Thomas Caparas,3,0,36,33
1658010744416,MATH 20C,A01,083760,Briones; Jor-el Thomas Caparas,1,0,35,34
1658010744416,MATH 20C,A02,083761,Briones; Jor-el Thomas Caparas,8,0,35,27
1658010744416,MATH 20C,A03,093476,Briones; Jor-el Thomas Caparas,0,1,36,36
1658010744416,MATH 20C,B01,083762,Bach; Quang Tran,1,0,30,29
1658010750445,MATH 20D,A01,083765,Tran; Brian Kha,5,0,30,25
1658010750445,MATH 20D,A02,083766,Tran; Brian Kha,5,0,30,25
1658010750445,MATH 20D,A03,083767,Tran; Brian Kha,6,0,30,24
1658010756469,MATH 20E,A01,083771,Ganguly; Soumya,12,0,32,20
1658010756469,MATH 20E,A02,083772,Ganguly; Soumya,7,0,32,25
1658010756469,MATH 20E,B01,083773,Ciotti; Benjamin,20,0,35,15
1658010756469,MATH 20E,B02,083774,Ciotti; Benjamin,18,0,35,17
1658010762491,MATH 103A,A01,083777,Greenfeld; Be'Eri,6,0,36,30
1658010762491,MATH 103A,A02,083778,Greenfeld; Be'Eri,5,0,36,31
1658010762491,MATH 103A,A03,093561,Greenfeld; Be'Eri,7,0,36,29
1658010762491,MATH 103A,B01,083779,Greenfeld; Be'Eri,8,0,36,28
1658010762491,MATH 103A,B02,083780,Greenfeld; Be'Eri,4,0,36,32
1658010762491,MATH 103A,B03,093562,Greenfeld; Be'Eri,3,0,36,33
1658010768518,MATH 105,A01,085443,Carter; Anne Toulson,15,0,35,20
1658010768518,MATH 105,A02,093477,Carter; Anne Toulson,20,0,35,15
1658010774544,MATH 109,A01,083213,Ganzberger; Geoffrey Michael,3,0,34,31
1658010774544,MATH 109,A02,083214,Ganzberger; Geoffrey Michael,4,0,34,30
1658010774544,MATH 109,A03,093478,Ganzberger; Geoffrey Michael,2,0,34,32
1658010774544,MATH 109,B01,083215,Ganzberger; Geoffrey Michael,3,0,32,29
1658010774544,MATH 109,B02,083216,Ganzberger; Geoffrey Michael,3,0,32,29
1658010774544,MATH 109,B03,093479,Ganzberger; Geoffrey Michael,8,0,32,24
1658010780568,MATH 142A,A01,083219,Chow; Bennett,7,0,32,25
1658010780568,MATH 142A,A02,083220,Chow; Bennett,10,0,32,22
1658010780568,MATH 142A,A03,093480,Chow; Bennett,9,0,32,23
1658010780568,MATH 142A,B03,093481,Chow; Bennett,8,0,32,24
1658010780568,MATH 142A,B04,093558,Chow; Bennett,14,0,32,18
1658010780568,MATH 142A,B05,093559,Chow; Bennett,7,0,32,25
1658010786590,MATH 193A,A01,083224,Rotar; Vladimir,9,0,34,25
1658010786590,MATH 193A,A02,083225,Rotar; Vladimir,11,0,34,23
1658010786590,MATH 193A,A03,083781,Rotar; Vladimir,5,0,34,29
1658010786590,MATH 193A,A04,083782,Rotar; Vladimir,12,0,34,22
1658010786590,MATH 193A,A05,093482,Rotar; Vladimir,11,0,34,23
1658010792613,MATH 197,001,091859,McAuley; Julian John,9999,0,9999,0
1658010792613,MATH 197,002,095566,Kedlaya; Kiran S.,9997,0,9999,2
1658010792613,MATH 197,003,095567,Xiao; Ming,9999,0,9999,0
1658010792613,MATH 197,004,095571,Perols; Johan Lars,9998,0,9999,1
1658010799664,COGS 9,A01,083615,Shannon; Kyle Michael,11,0,75,64
1658010805691,COGS 11,A01,083617,Boyle; Mary E. T.,23,0,48,25
1658010811715,COGS 13,A01,083071,Bastos; Amalia Pinkusfeld,12,0,71,59
1658010817736,COGS 14A,A01,092681,Semenuks; Arturs,5,1,100,95
1658010823761,COGS 14B,A01,083073,Cheng; Tzu-Han,7,0,63,56
1658010829784,COGS 17,A01,092677,Semenuks; Arturs,7,0,81,74
1658010835817,COGS 100,A01,083619,Allen; Michael Gordon,17,0,70,53
1658010841838,COGS 101A,A01,083621,Davis; Joshua Daniel,9,0,68,59
1658010847860,COGS 101B,A01,091572,Allen; Michael Gordon,14,0,65,51
1658010853886,COGS 101C,A01,083625,Delgado; Tania,17,0,35,18
1658010859909,COGS 107A,A01,083627,Boyle; Mary E. T.,14,0,60,46
1658010865931,COGS 118A,A01,083075,Gupta; Anjum,21,0,76,55
1658010871956,CSE 3,A50,083646,Miranda; Gregory Joseph,24,0,50,26
1658010877982,CSE 8A,A50,083650,Miranda; Gregory Joseph,17,1,56,39
1658010884008,CSE 11,A01,083080,Cao; Yingjun,7,15,40,33
1658010890030,CSE 12,A01,083652,Krause-Levy; Sophia Louisa,30,1,120,90
1658010896056,CSE 15L,A01,083654,Morris; Justin Loren,9,0,50,41
1658010896056,CSE 15L,A02,083655,Morris; Justin Loren,11,0,50,39
1658010902083,CSE 20,A01,083657,Tran; Khoa Dang,39,0,80,41
1658010908109,CSE 21,A01,095574,Bach; Quang Tran,23,0,48,25
1658010914135,CSE 30,A01,083084,Eldon; John,8,0,80,72
1658010914135,CSE 30,B01,095061,Bhaskar; Nishant,9,0,50,41
1658010920157,CSE 100,A01,083659,Cao; Yingjun,5,4,70,65
1658010926186,CSE 134B,A01,083661,Powell; Thomas Allan,25,0,100,75
1658010932211,CSE 140,A01,083663,Gungor; Onat,17,0,85,68
1658010938234,CSE 140L,A01,083088,Eldon; John,23,0,100,77
1658010944258,CSE 175,A01,083665,Kumar; Rakesh,3,0,25,22
1658010950380,CSE 190,A00,092507,Dubnov; Shlomo,8,0,20,12
1658010956404,ECE 45,A01,083139,Congero; Spencer William,7,0,75,68
1658010962428,ECE 65,A50,083695,Saad; Andrew S,12,0,30,18
1658010962428,ECE 65,A51,095125,Saad; Andrew S,24,0,26,2
1658010968454,ECE 109,A01,091882,Touri; Behrouz,21,0,70,49
1658010974476,ECE 180,A00,083140,Abi Samra; Nicholas Camill,1,0,30,29
1658010974476,ECE 180,B00,083141,Abi Samra; Nicholas Camill,0,0,30,30
1658010980501,MATH 10A,A01,083735,Patchell; Gregory David,2,0,30,28
1658010980501,MATH 10A,A02,083736,Patchell; Gregory David,20,0,30,10
1658010980501,MATH 10A,A03,083737,Patchell; Gregory David,16,0,30,14
1658010986523,MATH 10B,A01,083207,Lim; Seonhee,9,0,34,25
1658010986523,MATH 10B,A02,083208,Lim; Seonhee,10,0,35,25
1658010986523,MATH 10B,A03,093472,Lim; Seonhee,7,0,34,27
1658010986523,MATH 10B,B01,083739,Sinha; Shubham,14,0,30,16
1658010992561,MATH 18,A01,083743,Cinel; Cameron Alexander,9,0,30,21
1658010992561,MATH 18,A02,083744,Cinel; Cameron Alexander,18,0,30,12
1658010992561,MATH 18,A03,083745,Cinel; Cameron Alexander,10,0,30,20
1658010992561,MATH 18,B01,083748,Rideout; David Porter,5,0,37,32
1658010992561,MATH 18,B02,083749,Rideout; David Porter,5,0,36,31
1658010992561,MATH 18,B03,083750,Rideout; David Porter,3,0,37,34
1658010992561,MATH 18,B04,083751,Rideout; David Porter,7,0,36,29
1658010992561,MATH 18,B05,093473,Rideout; David Porter,7,0,36,29
1658010992561,MATH 18,B06,093474,Rideout; David Porter,6,0,36,30
1658010998584,MATH 20A,A01,083754,Zheng; Zequn,14,0,40,26
1658011004606,MATH 20B,A01,083756,Briones; Jor-el Thomas Caparas,4,0,36,32
1658011004606,MATH 20B,A02,083757,Briones; Jor-el Thomas Caparas,1,0,36,35
1658011004606,MATH 20B,A03,093475,Briones; Jor-el Thomas Caparas,3,0,36,33
1658011010635,MATH 20C,A01,083760,Briones; Jor-el Thomas Caparas,1,0,35,34
1658011010635,MATH 20C,A02,083761,Briones; Jor-el Thomas Caparas,8,0,35,27
1658011010635,MATH 20C,A03,093476,Briones; Jor-el Thomas Caparas,0,1,36,36
1658011010635,MATH 20C,B01,083762,Bach; Quang Tran,1,0,30,29
1658011016659,MATH 20D,A01,083765,Tran; Brian Kha,5,0,30,25
1658011016659,MATH 20D,A02,083766,Tran; Brian Kha,5,0,30,25
1658011016659,MATH 20D,A03,083767,Tran; Brian Kha,6,0,30,24
1658011022681,MATH 20E,A01,083771,Ganguly; Soumya,12,0,32,20
1658011022681,MATH 20E,A02,083772,Ganguly; Soumya,7,0,32,25
1658011022681,MATH 20E,B01,083773,Ciotti; Benjamin,20,0,35,15
1658011022681,MATH 20E,B02,083774,Ciotti; Benjamin,18,0,35,17
1658011028705,MATH 103A,A01,083777,Greenfeld; Be'Eri,6,0,36,30
1658011028705,MATH 103A,A02,083778,Greenfeld; Be'Eri,5,0,36,31
1658011028705,MATH 103A,A03,093561,Greenfeld; Be'Eri,7,0,36,29
1658011028705,MATH 103A,B01,083779,Greenfeld; Be'Eri,8,0,36,28
1658011028705,MATH 103A,B02,083780,Greenfeld; Be'Eri,4,0,36,32
1658011028705,MATH 103A,B03,093562,Greenfeld; Be'Eri,3,0,36,33
1658011034728,MATH 105,A01,085443,Carter; Anne Toulson,15,0,35,20
1658011034728,MATH 105,A02,093477,Carter; Anne Toulson,20,0,35,15
1658011040752,MATH 109,A01,083213,Ganzberger; Geoffrey Michael,3,0,34,31
1658011040752,MATH 109,A02,083214,Ganzberger; Geoffrey Michael,4,0,34,30
1658011040752,MATH 109,A03,093478,Ganzberger; Geoffrey Michael,2,0,34,32
1658011040752,MATH 109,B01,083215,Ganzberger; Geoffrey Michael,3,0,32,29
1658011040752,MATH 109,B02,083216,Ganzberger; Geoffrey Michael,3,0,32,29
1658011040752,MATH 109,B03,093479,Ganzberger; Geoffrey Michael,8,0,32,24
1658011046775,MATH 142A,A01,083219,Chow; Bennett,7,0,32,25
1658011046775,MATH 142A,A02,083220,Chow; Bennett,10,0,32,22
1658011046775,MATH 142A,A03,093480,Chow; Bennett,9,0,32,23
1658011046775,MATH 142A,B03,093481,Chow; Bennett,8,0,32,24
1658011046775,MATH 142A,B04,093558,Chow; Bennett,14,0,32,18
1658011046775,MATH 142A,B05,093559,Chow; Bennett,7,0,32,25
1658011052800,MATH 193A,A01,083224,Rotar; Vladimir,9,0,34,25
1658011052800,MATH 193A,A02,083225,Rotar; Vladimir,11,0,34,23
1658011052800,MATH 193A,A03,083781,Rotar; Vladimir,5,0,34,29
1658011052800,MATH 193A,A04,083782,Rotar; Vladimir,12,0,34,22
1658011052800,MATH 193A,A05,093482,Rotar; Vladimir,11,0,34,23
1658011058823,MATH 197,001,091859,McAuley; Julian John,9999,0,9999,0
1658011058823,MATH 197,002,095566,Kedlaya; Kiran S.,9997,0,9999,2
1658011058823,MATH 197,003,095567,Xiao; Ming,9999,0,9999,0
1658011058823,MATH 197,004,095571,Perols; Johan Lars,9998,0,9999,1
1658011065890,COGS 9,A01,083615,Shannon; Kyle Michael,11,0,75,64
1658011071913,COGS 11,A01,083617,Boyle; Mary E. T.,23,0,48,25
1658011077936,COGS 13,A01,083071,Bastos; Amalia Pinkusfeld,12,0,71,59
1658011083964,COGS 14A,A01,092681,Semenuks; Arturs,5,1,100,95
1658011089987,COGS 14B,A01,083073,Cheng; Tzu-Han,7,0,63,56
1658011096009,COGS 17,A01,092677,Semenuks; Arturs,7,0,81,74
1658011102034,COGS 100,A01,083619,Allen; Michael Gordon,17,0,70,53
1658011108057,COGS 101A,A01,083621,Davis; Joshua Daniel,9,0,68,59
1658011114083,COGS 101B,A01,091572,Allen; Michael Gordon,14,0,65,51
1658011120110,COGS 101C,A01,083625,Delgado; Tania,17,0,35,18
1658011126133,COGS 107A,A01,083627,Boyle; Mary E. T.,14,0,60,46
1658011132163,COGS 118A,A01,083075,Gupta; Anjum,21,0,76,55
1658011138186,CSE 3,A50,083646,Miranda; Gregory Joseph,24,0,50,26
1658011144210,CSE 8A,A50,083650,Miranda; Gregory Joseph,17,1,56,39
1658011150236,CSE 11,A01,083080,Cao; Yingjun,7,15,40,33
1658011156260,CSE 12,A01,083652,Krause-Levy; Sophia Louisa,30,1,120,90
1658011162289,CSE 15L,A01,083654,Morris; Justin Loren,9,0,50,41
1658011162289,CSE 15L,A02,083655,Morris; Justin Loren,11,0,50,39
1658011168312,CSE 20,A01,083657,Tran; Khoa Dang,39,0,80,41
1658011174334,CSE 21,A01,095574,Bach; Quang Tran,23,0,48,25
1658011180364,CSE 30,A01,083084,Eldon; John,8,0,80,72
1658011180364,CSE 30,B01,095061,Bhaskar; Nishant,9,0,50,41
1658011186388,CSE 100,A01,083659,Cao; Yingjun,5,4,70,65
1658011192410,CSE 134B,A01,083661,Powell; Thomas Allan,25,0,100,75
1658011198437,CSE 140,A01,083663,Gungor; Onat,17,0,85,68
1658011204459,CSE 140L,A01,083088,Eldon; John,23,0,100,77
1658011210555,CSE 175,A01,083665,Kumar; Rakesh,3,0,25,22
1658011216580,CSE 190,A00,092507,Dubnov; Shlomo,8,0,20,12
1658011222607,ECE 45,A01,083139,Congero; Spencer William,7,0,75,68
1658011228636,ECE 65,A50,083695,Saad; Andrew S,12,0,30,18
1658011228636,ECE 65,A51,095125,Saad; Andrew S,24,0,26,2
1658011234658,ECE 109,A01,091882,Touri; Behrouz,21,0,70,49
1658011240685,ECE 180,A00,083140,Abi Samra; Nicholas Camill,1,0,30,29
1658011240685,ECE 180,B00,083141,Abi Samra; Nicholas Camill,0,0,30,30
1658011246728,MATH 10A,A01,083735,Patchell; Gregory David,2,0,30,28
1658011246728,MATH 10A,A02,083736,Patchell; Gregory David,20,0,30,10
1658011246728,MATH 10A,A03,083737,Patchell; Gregory David,16,0,30,14
1658011252754,MATH 10B,A01,083207,Lim; Seonhee,9,0,34,25
1658011252754,MATH 10B,A02,083208,Lim; Seonhee,10,0,35,25
1658011252754,MATH 10B,A03,093472,Lim; Seonhee,7,0,34,27
1658011252754,MATH 10B,B01,083739,Sinha; Shubham,14,0,30,16
1658011258777,MATH 18,A01,083743,Cinel; Cameron Alexander,9,0,30,21
1658011258777,MATH 18,A02,083744,Cinel; Cameron Alexander,18,0,30,12
1658011258777,MATH 18,A03,083745,Cinel; Cameron Alexander,10,0,30,20
1658011258777,MATH 18,B01,083748,Rideout; David Porter,5,0,37,32
1658011258777,MATH 18,B02,083749,Rideout; David Porter,5,0,36,31
1658011258777,MATH 18,B03,083750,Rideout; David Porter,3,0,37,34
1658011258777,MATH 18,B04,083751,Rideout; David Porter,7,0,36,29
1658011258777,MATH 18,B05,093473,Rideout; David Porter,7,0,36,29
1658011258777,MATH 18,B06,093474,Rideout; David Porter,6,0,36,30
1658011264798,MATH 20A,A01,083754,Zheng; Zequn,14,0,40,26
1658011270825,MATH 20B,A01,083756,Briones; Jor-el Thomas Caparas,4,0,36,32
1658011270825,MATH 20B,A02,083757,Briones; Jor-el Thomas Caparas,1,0,36,35
1658011270825,MATH 20B,A03,093475,Briones; Jor-el Thomas Caparas,3,0,36,33
1658011276848,MATH 20C,A01,083760,Briones; Jor-el Thomas Caparas,1,0,35,34
1658011276848,MATH 20C,A02,083761,Briones; Jor-el Thomas Caparas,8,0,35,27
1658011276848,MATH 20C,A03,093476,Briones; Jor-el Thomas Caparas,0,1,36,36
1658011276848,MATH 20C,B01,083762,Bach; Quang Tran,1,0,30,29
1658011282873,MATH 20D,A01,083765,Tran; Brian Kha,5,0,30,25
1658011282873,MATH 20D,A02,083766,Tran; Brian Kha,5,0,30,25
1658011282873,MATH 20D,A03,083767,Tran; Brian Kha,6,0,30,24
1658011288895,MATH 20E,A01,083771,Ganguly; Soumya,12,0,32,20
1658011288895,MATH 20E,A02,083772,Ganguly; Soumya,7,0,32,25
1658011288895,MATH 20E,B01,083773,Ciotti; Benjamin,20,0,35,15
1658011288895,MATH 20E,B02,083774,Ciotti; Benjamin,18,0,35,17
1658011294924,MATH 103A,A01,083777,Greenfeld; Be'Eri,6,0,36,30
1658011294924,MATH 103A,A02,083778,Greenfeld; Be'Eri,5,0,36,31
1658011294924,MATH 103A,A03,093561,Greenfeld; Be'Eri,7,0,36,29
1658011294924,MATH 103A,B01,083779,Greenfeld; Be'Eri,8,0,36,28
1658011294924,MATH 103A,B02,083780,Greenfeld; Be'Eri,4,0,36,32
1658011294924,MATH 103A,B03,093562,Greenfeld; Be'Eri,3,0,36,33
1658011300958,MATH 105,A01,085443,Carter; Anne Toulson,15,0,35,20
1658011300958,MATH 105,A02,093477,Carter; Anne Toulson,20,0,35,15
1658011306990,MATH 109,A01,083213,Ganzberger; Geoffrey Michael,3,0,34,31
1658011306990,MATH 109,A02,083214,Ganzberger; Geoffrey Michael,4,0,34,30
1658011306990,MATH 109,A03,093478,Ganzberger; Geoffrey Michael,2,0,34,32
1658011306990,MATH 109,B01,083215,Ganzberger; Geoffrey Michael,3,0,32,29
1658011306990,MATH 109,B02,083216,Ganzberger; Geoffrey Michael,3,0,32,29
1658011306990,MATH 109,B03,093479,Ganzberger; Geoffrey Michael,8,0,32,24
1658011313020,MATH 142A,A01,083219,Chow; Bennett,7,0,32,25
1658011313020,MATH 142A,A02,083220,Chow; Bennett,10,0,32,22
1658011313020,MATH 142A,A03,093480,Chow; Bennett,9,0,32,23
1658011313020,MATH 142A,B03,093481,Chow; Bennett,8,0,32,24
1658011313020,MATH 142A,B04,093558,Chow; Bennett,14,0,32,18
1658011313020,MATH 142A,B05,093559,Chow; Bennett,7,0,32,25
1658011319043,MATH 193A,A01,083224,Rotar; Vladimir,9,0,34,25
1658011319043,MATH 193A,A02,083225,Rotar; Vladimir,11,0,34,23
1658011319043,MATH 193A,A03,083781,Rotar; Vladimir,5,0,34,29
1658011319043,MATH 193A,A04,083782,Rotar; Vladimir,12,0,34,22
1658011319043,MATH 193A,A05,093482,Rotar; Vladimir,11,0,34,23
1658011325068,MATH 197,001,091859,McAuley; Julian John,9999,0,9999,0
1658011325068,MATH 197,002,095566,Kedlaya; Kiran S.,9997,0,9999,2
1658011325068,MATH 197,003,095567,Xiao; Ming,9999,0,9999,0
1658011325068,MATH 197,004,095571,Perols; Johan Lars,9998,0,9999,1
1658011332129,COGS 9,A01,083615,Shannon; Kyle Michael,11,0,75,64
1658011338153,COGS 11,A01,083617,Boyle; Mary E. T.,23,0,48,25
1658011344177,COGS 13,A01,083071,Bastos; Amalia Pinkusfeld,12,0,71,59
1658011350203,COGS 14A,A01,092681,Semenuks; Arturs,5,1,100,95
1658011356226,COGS 14B,A01,083073,Cheng; Tzu-Han,7,0,63,56
1658011362255,COGS 17,A01,092677,Semenuks; Arturs,7,0,81,74
1658011368282,COGS 100,A01,083619,Allen; Michael Gordon,17,0,70,53
1658011374304,COGS 101A,A01,083621,Davis; Joshua Daniel,9,0,68,59
1658011380326,COGS 101B,A01,091572,Allen; Michael Gordon,14,0,65,51
1658011386350,COGS 101C,A01,083625,Delgado; Tania,17,0,35,18
1658011392376,COGS 107A,A01,083627,Boyle; Mary E. T.,14,0,60,46
1658011398404,COGS 118A,A01,083075,Gupta; Anjum,21,0,76,55
1658011404428,CSE 3,A50,083646,Miranda; Gregory Joseph,24,0,50,26
1658011410454,CSE 8A,A50,083650,Miranda; Gregory Joseph,17,1,56,39
1658011416482,CSE 11,A01,083080,Cao; Yingjun,7,15,40,33
1658011422505,CSE 12,A01,083652,Krause-Levy; Sophia Louisa,30,1,120,90
1658011428532,CSE 15L,A01,083654,Morris; Justin Loren,9,0,50,41
1658011428532,CSE 15L,A02,083655,Morris; Justin Loren,11,0,50,39
1658011434555,CSE 20,A01,083657,Tran; Khoa Dang,39,0,80,41
1658011440580,CSE 21,A01,095574,Bach; Quang Tran,23,0,48,25
1658011446602,CSE 30,A01,083084,Eldon; John,8,0,80,72
1658011446602,CSE 30,B01,095061,Bhaskar; Nishant,9,0,50,41
1658011452627,CSE 100,A01,083659,Cao; Yingjun,5,4,70,65
1658011458653,CSE 134B,A01,083661,Powell; Thomas Allan,25,0,100,75
1658011464676,CSE 140,A01,083663,Gungor; Onat,17,0,85,68
1658011470702,CSE 140L,A01,083088,Eldon; John,23,0,100,77
1658011476725,CSE 175,A01,083665,Kumar; Rakesh,3,0,25,22
1658011482751,CSE 190,A00,092507,Dubnov; Shlomo,8,0,20,12
1658011488773,ECE 45,A01,083139,Congero; Spencer William,7,0,75,68
1658011494802,ECE 65,A50,083695,Saad; Andrew S,12,0,30,18
1658011494802,ECE 65,A51,095125,Saad; Andrew S,24,0,26,2
1658011500827,ECE 109,A01,091882,Touri; Behrouz,21,0,70,49
1658011506853,ECE 180,A00,083140,Abi Samra; Nicholas Camill,1,0,30,29
1658011506853,ECE 180,B00,083141,Abi Samra; Nicholas Camill,0,0,30,30
1658011512891,MATH 10A,A01,083735,Patchell; Gregory David,2,0,30,28
1658011512891,MATH 10A,A02,083736,Patchell; Gregory David,20,0,30,10
1658011512891,MATH 10A,A03,083737,Patchell; Gregory David,16,0,30,14
1658011518915,MATH 10B,A01,083207,Lim; Seonhee,9,0,34,25
1658011518915,MATH 10B,A02,083208,Lim; Seonhee,10,0,35,25
1658011518915,MATH 10B,A03,093472,Lim; Seonhee,7,0,34,27
1658011518915,MATH 10B,B01,083739,Sinha; Shubham,14,0,30,16
1658011524946,MATH 18,A01,083743,Cinel; Cameron Alexander,9,0,30,21
1658011524946,MATH 18,A02,083744,Cinel; Cameron Alexander,18,0,30,12
1658011524946,MATH 18,A03,083745,Cinel; Cameron Alexander,10,0,30,20
1658011524946,MATH 18,B01,083748,Rideout; David Porter,5,0,37,32
1658011524946,MATH 18,B02,083749,Rideout; David Porter,5,0,36,31
1658011524946,MATH 18,B03,083750,Rideout; David Porter,3,0,37,34
1658011524946,MATH 18,B04,083751,Rideout; David Porter,7,0,36,29
1658011524946,MATH 18,B05,093473,Rideout; David Porter,7,0,36,29
1658011524946,MATH 18,B06,093474,Rideout; David Porter,6,0,36,30
1658011530968,MATH 20A,A01,083754,Zheng; Zequn,14,0,40,26
1658011536990,MATH 20B,A01,083756,Briones; Jor-el Thomas Caparas,4,0,36,32
1658011536990,MATH 20B,A02,083757,Briones; Jor-el Thomas Caparas,1,0,36,35
1658011536990,MATH 20B,A03,093475,Briones; Jor-el Thomas Caparas,3,0,36,33
1658011543020,MATH 20C,A01,083760,Briones; Jor-el Thomas Caparas,1,0,35,34
1658011543020,MATH 20C,A02,083761,Briones; Jor-el Thomas Caparas,8,0,35,27
1658011543020,MATH 20C,A03,093476,Briones; Jor-el Thomas Caparas,0,1,36,36
1658011543020,MATH 20C,B01,083762,Bach; Quang Tran,1,0,30,29
1658011549047,MATH 20D,A01,083765,Tran; Brian Kha,5,0,30,25
1658011549047,MATH 20D,A02,083766,Tran; Brian Kha,5,0,30,25
1658011549047,MATH 20D,A03,083767,Tran; Brian Kha,6,0,30,24
1658011555070,MATH 20E,A01,083771,Ganguly; Soumya,12,0,32,20
1658011555070,MATH 20E,A02,083772,Ganguly; Soumya,7,0,32,25
1658011555070,MATH 20E,B01,083773,Ciotti; Benjamin,20,0,35,15
1658011555070,MATH 20E,B02,083774,Ciotti; Benjamin,18,0,35,17
1658011561098,MATH 103A,A01,083777,Greenfeld; Be'Eri,6,0,36,30
1658011561098,MATH 103A,A02,083778,Greenfeld; Be'Eri,5,0,36,31
1658011561098,MATH 103A,A03,093561,Greenfeld; Be'Eri,7,0,36,29
1658011561098,MATH 103A,B01,083779,Greenfeld; Be'Eri,8,0,36,28
1658011561098,MATH 103A,B02,083780,Greenfeld; Be'Eri,4,0,36,32
1658011561098,MATH 103A,B03,093562,Greenfeld; Be'Eri,3,0,36,33
1658011567121,MATH 105,A01,085443,Carter; Anne Toulson,15,0,35,20
1658011567121,MATH 105,A02,093477,Carter; Anne Toulson,20,0,35,15
1658011573143,MATH 109,A01,083213,Ganzberger; Geoffrey Michael,3,0,34,31
1658011573143,MATH 109,A02,083214,Ganzberger; Geoffrey Michael,4,0,34,30
1658011573143,MATH 109,A03,093478,Ganzberger; Geoffrey Michael,2,0,34,32
1658011573143,MATH 109,B01,083215,Ganzberger; Geoffrey Michael,3,0,32,29
1658011573143,MATH 109,B02,083216,Ganzberger; Geoffrey Michael,3,0,32,29
1658011573143,MATH 109,B03,093479,Ganzberger; Geoffrey Michael,8,0,32,24
1658011579168,MATH 142A,A01,083219,Chow; Bennett,7,0,32,25
1658011579168,MATH 142A,A02,083220,Chow; Bennett,10,0,32,22
1658011579168,MATH 142A,A03,093480,Chow; Bennett,9,0,32,23
1658011579168,MATH 142A,B03,093481,Chow; Bennett,8,0,32,24
1658011579168,MATH 142A,B04,093558,Chow; Bennett,14,0,32,18
1658011579168,MATH 142A,B05,093559,Chow; Bennett,7,0,32,25
1658011585191,MATH 193A,A01,083224,Rotar; Vladimir,9,0,34,25
1658011585191,MATH 193A,A02,083225,Rotar; Vladimir,11,0,34,23
1658011585191,MATH 193A,A03,083781,Rotar; Vladimir,5,0,34,29
1658011585191,MATH 193A,A04,083782,Rotar; Vladimir,12,0,34,22
1658011585191,MATH 193A,A05,093482,Rotar; Vladimir,11,0,34,23
1658011591214,MATH 197,001,091859,McAuley; Julian John,9999,0,9999,0
1658011591214,MATH 197,002,095566,Kedlaya; Kiran S.,9997,0,9999,2
1658011591214,MATH 197,003,095567,Xiao; Ming,9999,0,9999,0
1658011591214,MATH 197,004,095571,Perols; Johan Lars,9998,0,9999,1
1658011598274,COGS 9,A01,083615,Shannon; Kyle Michael,11,0,75,64
1658011604298,COGS 11,A01,083617,Boyle; Mary E. T.,23,0,48,25
1658011610326,COGS 13,A01,083071,Bastos; Amalia Pinkusfeld,12,0,71,59
1658011616351,COGS 14A,A01,092681,Semenuks; Arturs,5,1,100,95
1658011622375,COGS 14B,A01,083073,Cheng; Tzu-Han,7,0,63,56
1658011628398,COGS 17,A01,092677,Semenuks; Arturs,7,0,81,74
1658011634420,COGS 100,A01,083619,Allen; Michael Gordon,17,0,70,53
1658011640446,COGS 101A,A01,083621,Davis; Joshua Daniel,9,0,68,59
1658011646470,COGS 101B,A01,091572,Allen; Michael Gordon,14,0,65,51
1658011652499,COGS 101C,A01,083625,Delgado; Tania,17,0,35,18
1658011658538,COGS 107A,A01,083627,Boyle; Mary E. T.,14,0,60,46
1658011664565,COGS 118A,A01,083075,Gupta; Anjum,21,0,76,55
1658011670587,CSE 3,A50,083646,Miranda; Gregory Joseph,24,0,50,26
1658011676611,CSE 8A,A50,083650,Miranda; Gregory Joseph,17,1,56,39
1658011682639,CSE 11,A01,083080,Cao; Yingjun,7,15,40,33
1658011688665,CSE 12,A01,083652,Krause-Levy; Sophia Louisa,30,1,120,90
1658011694689,CSE 15L,A01,083654,Morris; Justin Loren,9,0,50,41
1658011694689,CSE 15L,A02,083655,Morris; Justin Loren,11,0,50,39
1658011700715,CSE 20,A01,083657,Tran; Khoa Dang,39,0,80,41
1658011706736,CSE 21,A01,095574,Bach; Quang Tran,23,0,48,25
1658011712760,CSE 30,A01,083084,Eldon; John,8,0,80,72
1658011712760,CSE 30,B01,095061,Bhaskar; Nishant,9,0,50,41
1658011718788,CSE 100,A01,083659,Cao; Yingjun,5,4,70,65
1658011724817,CSE 134B,A01,083661,Powell; Thomas Allan,25,0,100,75
1658011730843,CSE 140,A01,083663,Gungor; Onat,17,0,85,68
1658011736867,CSE 140L,A01,083088,Eldon; John,23,0,100,77
1658011742889,CSE 175,A01,083665,Kumar; Rakesh,3,0,25,22
1658011748912,CSE 190,A00,092507,Dubnov; Shlomo,8,0,20,12
1658011754936,ECE 45,A01,083139,Congero; Spencer William,7,0,75,68
1658011760960,ECE 65,A50,083695,Saad; Andrew S,12,0,30,18
1658011760960,ECE 65,A51,095125,Saad; Andrew S,24,0,26,2
1658011766988,ECE 109,A01,091882,Touri; Behrouz,21,0,70,49
1658011773014,ECE 180,A00,083140,Abi Samra; Nicholas Camill,1,0,30,29
1658011773014,ECE 180,B00,083141,Abi Samra; Nicholas Camill,0,0,30,30
1658011779045,MATH 10A,A01,083735,Patchell; Gregory David,2,0,30,28
1658011779045,MATH 10A,A02,083736,Patchell; Gregory David,20,0,30,10
1658011779045,MATH 10A,A03,083737,Patchell; Gregory David,16,0,30,14
1658011785067,MATH 10B,A01,083207,Lim; Seonhee,9,0,34,25
1658011785067,MATH 10B,A02,083208,Lim; Seonhee,10,0,35,25
1658011785067,MATH 10B,A03,093472,Lim; Seonhee,7,0,34,27
1658011785067,MATH 10B,B01,083739,Sinha; Shubham,14,0,30,16
1658011791101,MATH 18,A01,083743,Cinel; Cameron Alexander,9,0,30,21
1658011791101,MATH 18,A02,083744,Cinel; Cameron Alexander,18,0,30,12
1658011791101,MATH 18,A03,083745,Cinel; Cameron Alexander,10,0,30,20
1658011791101,MATH 18,B01,083748,Rideout; David Porter,5,0,37,32
1658011791101,MATH 18,B02,083749,Rideout; David Porter,5,0,36,31
1658011791101,MATH 18,B03,083750,Rideout; David Porter,3,0,37,34
1658011791101,MATH 18,B04,083751,Rideout; David Porter,7,0,36,29
1658011791101,MATH 18,B05,093473,Rideout; David Porter,7,0,36,29
1658011791101,MATH 18,B06,093474,Rideout; David Porter,6,0,36,30
1658011797129,MATH 20A,A01,083754,Zheng; Zequn,14,0,40,26
1658011803153,MATH 20B,A01,083756,Briones; Jor-el Thomas Caparas,4,0,36,32
1658011803153,MATH 20B,A02,083757,Briones; Jor-el Thomas Caparas,1,0,36,35
1658011803153,MATH 20B,A03,093475,Briones; Jor-el Thomas Caparas,3,0,36,33
1658011809269,MATH 20C,A01,083760,Briones; Jor-el Thomas Caparas,1,0,35,34
1658011809269,MATH 20C,A02,083761,Briones; Jor-el Thomas Caparas,8,0,35,27
1658011809269,MATH 20C,A03,093476,Briones; Jor-el Thomas Caparas,0,1,36,36
1658011809269,MATH 20C,B01,083762,Bach; Quang Tran,1,0,30,29
1658011815296,MATH 20D,A01,083765,Tran; Brian Kha,5,0,30,25
1658011815296,MATH 20D,A02,083766,Tran; Brian Kha,5,0,30,25
1658011815296,MATH 20D,A03,083767,Tran; Brian Kha,6,0,30,24
1658011821320,MATH 20E,A01,083771,Ganguly; Soumya,12,0,32,20
1658011821320,MATH 20E,A02,083772,Ganguly; Soumya,7,0,32,25
1658011821320,MATH 20E,B01,083773,Ciotti; Benjamin,20,0,35,15
1658011821320,MATH 20E,B02,083774,Ciotti; Benjamin,18,0,35,17
1658011827343,MATH 103A,A01,083777,Greenfeld; Be'Eri,6,0,36,30
1658011827343,MATH 103A,A02,083778,Greenfeld; Be'Eri,5,0,36,31
1658011827343,MATH 103A,A03,093561,Greenfeld; Be'Eri,7,0,36,29
1658011827343,MATH 103A,B01,083779,Greenfeld; Be'Eri,8,0,36,28
1658011827343,MATH 103A,B02,083780,Greenfeld; Be'Eri,4,0,36,32
1658011827343,MATH 103A,B03,093562,Greenfeld; Be'Eri,3,0,36,33
1658011833372,MATH 105,A01,085443,Carter; Anne Toulson,15,0,35,20
1658011833372,MATH 105,A02,093477,Carter; Anne Toulson,20,0,35,15
1658011839401,MATH 109,A01,083213,Ganzberger; Geoffrey Michael,3,0,34,31
1658011839401,MATH 109,A02,083214,Ganzberger; Geoffrey Michael,4,0,34,30
1658011839401,MATH 109,A03,093478,Ganzberger; Geoffrey Michael,2,0,34,32
1658011839401,MATH 109,B01,083215,Ganzberger; Geoffrey Michael,3,0,32,29
1658011839401,MATH 109,B02,083216,Ganzberger; Geoffrey Michael,3,0,32,29
1658011839401,MATH 109,B03,093479,Ganzberger; Geoffrey Michael,8,0,32,24
1658011845424,MATH 142A,A01,083219,Chow; Bennett,7,0,32,25
1658011845424,MATH 142A,A02,083220,Chow; Bennett,10,0,32,22
1658011845424,MATH 142A,A03,093480,Chow; Bennett,9,0,32,23
1658011845424,MATH 142A,B03,093481,Chow; Bennett,8,0,32,24
1658011845424,MATH 142A,B04,093558,Chow; Bennett,14,0,32,18
1658011845424,MATH 142A,B05,093559,Chow; Bennett,7,0,32,25
1658011851453,MATH 193A,A01,083224,Rotar; Vladimir,9,0,34,25
1658011851453,MATH 193A,A02,083225,Rotar; Vladimir,11,0,34,23
1658011851453,MATH 193A,A03,083781,Rotar; Vladimir,5,0,34,29
1658011851453,MATH 193A,A04,083782,Rotar; Vladimir,12,0,34,22
1658011851453,MATH 193A,A05,093482,Rotar; Vladimir,11,0,34,23
1658011857480,MATH 197,001,091859,McAuley; Julian John,9999,0,9999,0
1658011857480,MATH 197,002,095566,Kedlaya; Kiran S.,9997,0,9999,2
1658011857480,MATH 197,003,095567,Xiao; Ming,9999,0,9999,0
1658011857480,MATH 197,004,095571,Perols; Johan Lars,9998,0,9999,1
1658011864539,COGS 9,A01,083615,Shannon; Kyle Michael,11,0,75,64
1658011870562,COGS 11,A01,083617,Boyle; Mary E. T.,23,0,48,25
1658011876585,COGS 13,A01,083071,Bastos; Amalia Pinkusfeld,12,0,71,59
1658011882611,COGS 14A,A01,092681,Semenuks; Arturs,5,1,100,95
1658011888637,COGS 14B,A01,083073,Cheng; Tzu-Han,7,0,63,56
1658011894664,COGS 17,A01,092677,Semenuks; Arturs,7,0,81,74
1658011900688,COGS 100,A01,083619,Allen; Michael Gordon,17,0,70,53
1658011906709,COGS 101A,A01,083621,Davis; Joshua Daniel,9,0,68,59
1658011912733,COGS 101B,A01,091572,Allen; Michael Gordon,14,0,65,51
1658011918755,COGS 101C,A01,083625,Delgado; Tania,17,0,35,18
1658011924776,COGS 107A,A01,083627,Boyle; Mary E. T.,14,0,60,46
1658011930799,COGS 118A,A01,083075,Gupta; Anjum,21,0,76,55
1658011936825,CSE 3,A50,083646,Miranda; Gregory Joseph,24,0,50,26
1658011942849,CSE 8A,A50,083650,Miranda; Gregory Joseph,17,1,56,39
1658011948873,CSE 11,A01,083080,Cao; Yingjun,7,15,40,33
1658011954898,CSE 12,A01,083652,Krause-Levy; Sophia Louisa,30,1,120,90
1658011960931,CSE 15L,A01,083654,Morris; Justin Loren,9,0,50,41
1658011960931,CSE 15L,A02,083655,Morris; Justin Loren,11,0,50,39
1658011966957,CSE 20,A01,083657,Tran; Khoa Dang,39,0,80,41
1658011972982,CSE 21,A01,095574,Bach; Quang Tran,23,0,48,25
1658011979015,CSE 30,A01,083084,Eldon; John,8,0,80,72
1658011979015,CSE 30,B01,095061,Bhaskar; Nishant,9,0,50,41
1658011985037,CSE 100,A01,083659,Cao; Yingjun,5,4,70,65
1658011991060,CSE 134B,A01,083661,Powell; Thomas Allan,25,0,100,75
1658011997082,CSE 140,A01,083663,Gungor; Onat,17,0,85,68
1658012003108,CSE 140L,A01,083088,Eldon; John,23,0,100,77
1658012009134,CSE 175,A01,083665,Kumar; Rakesh,3,0,25,22
1658012015155,CSE 190,A00,092507,Dubnov; Shlomo,8,0,20,12
1658012021186,ECE 45,A01,083139,Congero; Spencer William,7,0,75,68
1658012027210,ECE 65,A50,083695,Saad; Andrew S,12,0,30,18
1658012027210,ECE 65,A51,095125,Saad; Andrew S,24,0,26,2
1658012033231,ECE 109,A01,091882,Touri; Behrouz,21,0,70,49
1658012039255,ECE 180,A00,083140,Abi Samra; Nicholas Camill,1,0,30,29
1658012039255,ECE 180,B00,083141,Abi Samra; Nicholas Camill,0,0,30,30
1658012045289,MATH 10A,A01,083735,Patchell; Gregory David,2,0,30,28
1658012045289,MATH 10A,A02,083736,Patchell; Gregory David,20,0,30,10
1658012045289,MATH 10A,A03,083737,Patchell; Gregory David,16,0,30,14
1658012051315,MATH 10B,A01,083207,Lim; Seonhee,9,0,34,25
1658012051315,MATH 10B,A02,083208,Lim; Seonhee,10,0,35,25
1658012051315,MATH 10B,A03,093472,Lim; Seonhee,7,0,34,27
1658012051315,MATH 10B,B01,083739,Sinha; Shubham,14,0,30,16
1658012057345,MATH 18,A01,083743,Cinel; Cameron Alexander,9,0,30,21
1658012057345,MATH 18,A02,083744,Cinel; Cameron Alexander,18,0,30,12
1658012057345,MATH 18,A03,083745,Cinel; Cameron Alexander,10,0,30,20
1658012057345,MATH 18,B01,083748,Rideout; David Porter,5,0,37,32
1658012057345,MATH 18,B02,083749,Rideout; David Porter,5,0,36,31
1658012057345,MATH 18,B03,083750,Rideout; David Porter,3,0,37,34
1658012057345,MATH 18,B04,083751,Rideout; David Porter,7,0,36,29
1658012057345,MATH 18,B05,093473,Rideout; David Porter,7,0,36,29
1658012057345,MATH 18,B06,093474,Rideout; David Porter,6,0,36,30
1658012063367,MATH 20A,A01,083754,Zheng; Zequn,14,0,40,26
1658012069393,MATH 20B,A01,083756,Briones; Jor-el Thomas Caparas,4,0,36,32
1658012069393,MATH 20B,A02,083757,Briones; Jor-el Thomas Caparas,1,0,36,35
1658012069393,MATH 20B,A03,093475,Briones; Jor-el Thomas Caparas,3,0,36,33
1658012075421,MATH 20C,A01,083760,Briones; Jor-el Thomas Caparas,1,0,35,34
1658012075421,MATH 20C,A02,083761,Briones; Jor-el Thomas Caparas,8,0,35,27
1658012075421,MATH 20C,A03,093476,Briones; Jor-el Thomas Caparas,0,1,36,36
1658012075421,MATH 20C,B01,083762,Bach; Quang Tran,1,0,30,29
1658012081449,MATH 20D,A01,083765,Tran; Brian Kha,5,0,30,25
1658012081449,MATH 20D,A02,083766,Tran; Brian Kha,5,0,30,25
1658012081449,MATH 20D,A03,083767,Tran; Brian Kha,6,0,30,24
1658012087472,MATH 20E,A01,083771,Ganguly; Soumya,12,0,32,20
1658012087472,MATH 20E,A02,083772,Ganguly; Soumya,7,0,32,25
1658012087472,MATH 20E,B01,083773,Ciotti; Benjamin,20,0,35,15
1658012087472,MATH 20E,B02,083774,Ciotti; Benjamin,18,0,35,17
1658012093497,MATH 103A,A01,083777,Greenfeld; Be'Eri,6,0,36,30
1658012093497,MATH 103A,A02,083778,Greenfeld; Be'Eri,5,0,36,31
1658012093497,MATH 103A,A03,093561,Greenfeld; Be'Eri,7,0,36,29
1658012093497,MATH 103A,B01,083779,Greenfeld; Be'Eri,8,0,36,28
1658012093497,MATH 103A,B02,083780,Greenfeld; Be'Eri,4,0,36,32
1658012093497,MATH 103A,B03,093562,Greenfeld; Be'Eri,3,0,36,33
1658012099520,MATH 105,A01,085443,Carter; Anne Toulson,15,0,35,20
1658012099520,MATH 105,A02,093477,Carter; Anne Toulson,20,0,35,15
1658012105543,MATH 109,A01,083213,Ganzberger; Geoffrey Michael,3,0,34,31
1658012105543,MATH 109,A02,083214,Ganzberger; Geoffrey Michael,4,0,34,30
1658012105543,MATH 109,A03,093478,Ganzberger; Geoffrey Michael,2,0,34,32
1658012105543,MATH 109,B01,083215,Ganzberger; Geoffrey Michael,3,0,32,29
1658012105543,MATH 109,B02,083216,Ganzberger; Geoffrey Michael,3,0,32,29
1658012105543,MATH 109,B03,093479,Ganzberger; Geoffrey Michael,8,0,32,24
1658012111577,MATH 142A,A01,083219,Chow; Bennett,7,0,32,25
1658012111577,MATH 142A,A02,083220,Chow; Bennett,10,0,32,22
1658012111577,MATH 142A,A03,093480,Chow; Bennett,9,0,32,23
1658012111577,MATH 142A,B03,093481,Chow; Bennett,8,0,32,24
1658012111577,MATH 142A,B04,093558,Chow; Bennett,14,0,32,18
1658012111577,MATH 142A,B05,093559,Chow; Bennett,7,0,32,25
1658012117605,MATH 193A,A01,083224,Rotar; Vladimir,9,0,34,25
1658012117605,MATH 193A,A02,083225,Rotar; Vladimir,11,0,34,23
1658012117605,MATH 193A,A03,083781,Rotar; Vladimir,5,0,34,29
1658012117605,MATH 193A,A04,083782,Rotar; Vladimir,12,0,34,22
1658012117605,MATH 193A,A05,093482,Rotar; Vladimir,11,0,34,23
1658012123627,MATH 197,001,091859,McAuley; Julian John,9999,0,9999,0
1658012123627,MATH 197,002,095566,Kedlaya; Kiran S.,9997,0,9999,2
1658012123627,MATH 197,003,095567,Xiao; Ming,9999,0,9999,0
1658012123627,MATH 197,004,095571,Perols; Johan Lars,9998,0,9999,1
1658012130691,COGS 9,A01,083615,Shannon; Kyle Michael,11,0,75,64
1658012136714,COGS 11,A01,083617,Boyle; Mary E. T.,23,0,48,25
1658012142735,COGS 13,A01,083071,Bastos; Amalia Pinkusfeld,12,0,71,59
1658012148770,COGS 14A,A01,092681,Semenuks; Arturs,5,1,100,95
1658012154792,COGS 14B,A01,083073,Cheng; Tzu-Han,7,0,63,56
1658012160815,COGS 17,A01,092677,Semenuks; Arturs,7,0,81,74
1658012166842,COGS 100,A01,083619,Allen; Michael Gordon,17,0,70,53
1658012172868,COGS 101A,A01,083621,Davis; Joshua Daniel,9,0,68,59
1658012178890,COGS 101B,A01,091572,Allen; Michael Gordon,14,0,65,51
1658012184912,COGS 101C,A01,083625,Delgado; Tania,17,0,35,18
1658012190933,COGS 107A,A01,083627,Boyle; Mary E. T.,14,0,60,46
1658012196957,COGS 118A,A01,083075,Gupta; Anjum,21,0,76,55
1658012202980,CSE 3,A50,083646,Miranda; Gregory Joseph,24,0,50,26
1658012209013,CSE 8A,A50,083650,Miranda; Gregory Joseph,17,1,56,39
1658012215035,CSE 11,A01,083080,Cao; Yingjun,7,15,40,33
1658012221061,CSE 12,A01,083652,Krause-Levy; Sophia Louisa,30,1,120,90
1658012227086,CSE 15L,A01,083654,Morris; Justin Loren,9,0,50,41
1658012227086,CSE 15L,A02,083655,Morris; Justin Loren,11,0,50,39
1658012233112,CSE 20,A01,083657,Tran; Khoa Dang,39,0,80,41
1658012239138,CSE 21,A01,095574,Bach; Quang Tran,23,0,48,25
1658012245162,CSE 30,A01,083084,Eldon; John,8,0,80,72
1658012245162,CSE 30,B01,095061,Bhaskar; Nishant,9,0,50,41
1658012251190,CSE 100,A01,083659,Cao; Yingjun,5,4,70,65
1658012257217,CSE 134B,A01,083661,Powell; Thomas Allan,25,0,100,75
1658012263239,CSE 140,A01,083663,Gungor; Onat,17,0,85,68
1658012269268,CSE 140L,A01,083088,Eldon; John,23,0,100,77
1658012275290,CSE 175,A01,083665,Kumar; Rakesh,3,0,25,22
1658012281311,CSE 190,A00,092507,Dubnov; Shlomo,8,0,20,12
1658012287334,ECE 45,A01,083139,Congero; Spencer William,7,0,75,68
1658012293356,ECE 65,A50,083695,Saad; Andrew S,12,0,30,18
1658012293356,ECE 65,A51,095125,Saad; Andrew S,24,0,26,2
1658012299383,ECE 109,A01,091882,Touri; Behrouz,21,0,70,49
1658012305406,ECE 180,A00,083140,Abi Samra; Nicholas Camill,1,0,30,29
1658012305406,ECE 180,B00,083141,Abi Samra; Nicholas Camill,0,0,30,30
1658012311434,MATH 10A,A01,083735,Patchell; Gregory David,2,0,30,28
1658012311434,MATH 10A,A02,083736,Patchell; Gregory David,20,0,30,10
1658012311434,MATH 10A,A03,083737,Patchell; Gregory David,16,0,30,14
1658012317464,MATH 10B,A01,083207,Lim; Seonhee,9,0,34,25
1658012317464,MATH 10B,A02,083208,Lim; Seonhee,10,0,35,25
1658012317464,MATH 10B,A03,093472,Lim; Seonhee,7,0,34,27
1658012317464,MATH 10B,B01,083739,Sinha; Shubham,14,0,30,16
1658012323490,MATH 18,A01,083743,Cinel; Cameron Alexander,9,0,30,21
1658012323490,MATH 18,A02,083744,Cinel; Cameron Alexander,18,0,30,12
1658012323490,MATH 18,A03,083745,Cinel; Cameron Alexander,10,0,30,20
1658012323490,MATH 18,B01,083748,Rideout; David Porter,5,0,37,32
1658012323490,MATH 18,B02,083749,Rideout; David Porter,5,0,36,31
1658012323490,MATH 18,B03,083750,Rideout; David Porter,3,0,37,34
1658012323490,MATH 18,B04,083751,Rideout; David Porter,7,0,36,29
1658012323490,MATH 18,B05,093473,Rideout; David Porter,7,0,36,29
1658012323490,MATH 18,B06,093474,Rideout; David Porter,6,0,36,30
1658012329518,MATH 20A,A01,083754,Zheng; Zequn,14,0,40,26
1658012335545,MATH 20B,A01,083756,Briones; Jor-el Thomas Caparas,4,0,36,32
1658012335545,MATH 20B,A02,083757,Briones; Jor-el Thomas Caparas,1,0,36,35
1658012335545,MATH 20B,A03,093475,Briones; Jor-el Thomas Caparas,3,0,36,33
1658012341569,MATH 20C,A01,083760,Briones; Jor-el Thomas Caparas,1,0,35,34
1658012341569,MATH 20C,A02,083761,Briones; Jor-el Thomas Caparas,8,0,35,27
1658012341569,MATH 20C,A03,093476,Briones; Jor-el Thomas Caparas,0,1,36,36
1658012341569,MATH 20C,B01,083762,Bach; Quang Tran,1,0,30,29
1658012347591,MATH 20D,A01,083765,Tran; Brian Kha,5,0,30,25
1658012347591,MATH 20D,A02,083766,Tran; Brian Kha,5,0,30,25
1658012347591,MATH 20D,A03,083767,Tran; Brian Kha,6,0,30,24
1658012353616,MATH 20E,A01,083771,Ganguly; Soumya,12,0,32,20
1658012353616,MATH 20E,A02,083772,Ganguly; Soumya,7,0,32,25
1658012353616,MATH 20E,B01,083773,Ciotti; Benjamin,20,0,35,15
1658012353616,MATH 20E,B02,083774,Ciotti; Benjamin,18,0,35,17
1658012359645,MATH 103A,A01,083777,Greenfeld; Be'Eri,6,0,36,30
1658012359645,MATH 103A,A02,083778,Greenfeld; Be'Eri,5,0,36,31
1658012359645,MATH 103A,A03,093561,Greenfeld; Be'Eri,7,0,36,29
1658012359645,MATH 103A,B01,083779,Greenfeld; Be'Eri,8,0,36,28
1658012359645,MATH 103A,B02,083780,Greenfeld; Be'Eri,4,0,36,32
1658012359645,MATH 103A,B03,093562,Greenfeld; Be'Eri,3,0,36,33
1658012365666,MATH 105,A01,085443,Carter; Anne Toulson,15,0,35,20
1658012365666,MATH 105,A02,093477,Carter; Anne Toulson,20,0,35,15
1658012371688,MATH 109,A01,083213,Ganzberger; Geoffrey Michael,3,0,34,31
1658012371688,MATH 109,A02,083214,Ganzberger; Geoffrey Michael,4,0,34,30
1658012371688,MATH 109,A03,093478,Ganzberger; Geoffrey Michael,2,0,34,32
1658012371688,MATH 109,B01,083215,Ganzberger; Geoffrey Michael,3,0,32,29
1658012371688,MATH 109,B02,083216,Ganzberger; Geoffrey Michael,3,0,32,29
1658012371688,MATH 109,B03,093479,Ganzberger; Geoffrey Michael,8,0,32,24
1658012377711,MATH 142A,A01,083219,Chow; Bennett,7,0,32,25
1658012377711,MATH 142A,A02,083220,Chow; Bennett,10,0,32,22
1658012377711,MATH 142A,A03,093480,Chow; Bennett,9,0,32,23
1658012377711,MATH 142A,B03,093481,Chow; Bennett,8,0,32,24
1658012377711,MATH 142A,B04,093558,Chow; Bennett,14,0,32,18
1658012377711,MATH 142A,B05,093559,Chow; Bennett,7,0,32,25
1658012383741,MATH 193A,A01,083224,Rotar; Vladimir,9,0,34,25
1658012383741,MATH 193A,A02,083225,Rotar; Vladimir,11,0,34,23
1658012383741,MATH 193A,A03,083781,Rotar; Vladimir,5,0,34,29
1658012383741,MATH 193A,A04,083782,Rotar; Vladimir,12,0,34,22
1658012383741,MATH 193A,A05,093482,Rotar; Vladimir,11,0,34,23
1658012389763,MATH 197,001,091859,McAuley; Julian John,9999,0,9999,0
1658012389763,MATH 197,002,095566,Kedlaya; Kiran S.,9997,0,9999,2
1658012389763,MATH 197,003,095567,Xiao; Ming,9999,0,9999,0
1658012389763,MATH 197,004,095571,Perols; Johan Lars,9998,0,9999,1
1658012396824,COGS 9,A01,083615,Shannon; Kyle Michael,11,0,75,64
1658012402938,COGS 11,A01,083617,Boyle; Mary E. T.,23,0,48,25
1658012408966,COGS 13,A01,083071,Bastos; Amalia Pinkusfeld,12,0,71,59
1658012414988,COGS 14A,A01,092681,Semenuks; Arturs,5,1,100,95
1658012421010,COGS 14B,A01,083073,Cheng; Tzu-Han,7,0,63,56
1658012427033,COGS 17,A01,092677,Semenuks; Arturs,7,0,81,74
1658012433056,COGS 100,A01,083619,Allen; Michael Gordon,17,0,70,53
1658012439079,COGS 101A,A01,083621,Davis; Joshua Daniel,9,0,68,59
1658012445104,COGS 101B,A01,091572,Allen; Michael Gordon,14,0,65,51
1658012451126,COGS 101C,A01,083625,Delgado; Tania,17,0,35,18
1658012457148,COGS 107A,A01,083627,Boyle; Mary E. T.,14,0,60,46
1658012463173,COGS 118A,A01,083075,Gupta; Anjum,21,0,76,55
1658012469195,CSE 3,A50,083646,Miranda; Gregory Joseph,24,0,50,26
1658012475221,CSE 8A,A50,083650,Miranda; Gregory Joseph,17,1,56,39
1658012481243,CSE 11,A01,083080,Cao; Yingjun,7,15,40,33
1658012487266,CSE 12,A01,083652,Krause-Levy; Sophia Louisa,30,1,120,90
1658012493290,CSE 15L,A01,083654,Morris; Justin Loren,9,0,50,41
1658012493290,CSE 15L,A02,083655,Morris; Justin Loren,11,0,50,39
1658012499315,CSE 20,A01,083657,Tran; Khoa Dang,39,0,80,41
1658012505337,CSE 21,A01,095574,Bach; Quang Tran,23,0,48,25
1658012511359,CSE 30,A01,083084,Eldon; John,8,0,80,72
1658012511359,CSE 30,B01,095061,Bhaskar; Nishant,9,0,50,41
1658012517381,CSE 100,A01,083659,Cao; Yingjun,5,4,70,65
1658012523413,CSE 134B,A01,083661,Powell; Thomas Allan,25,0,100,75
1658012529434,CSE 140,A01,083663,Gungor; Onat,17,0,85,68
1658012535459,CSE 140L,A01,083088,Eldon; John,23,0,100,77
1658012541484,CSE 175,A01,083665,Kumar; Rakesh,3,0,25,22
1658012547548,CSE 190,A00,092507,Dubnov; Shlomo,8,0,20,12
1658012553574,ECE 45,A01,083139,Congero; Spencer William,7,0,75,68
1658012559596,ECE 65,A50,083695,Saad; Andrew S,12,0,30,18
1658012559596,ECE 65,A51,095125,Saad; Andrew S,24,0,26,2
1658012565623,ECE 109,A01,091882,Touri; Behrouz,21,0,70,49
1658012571644,ECE 180,A00,083140,Abi Samra; Nicholas Camill,1,0,30,29
1658012571644,ECE 180,B00,083141,Abi Samra; Nicholas Camill,0,0,30,30
1658012577667,MATH 10A,A01,083735,Patchell; Gregory David,2,0,30,28
1658012577667,MATH 10A,A02,083736,Patchell; Gregory David,20,0,30,10
1658012577667,MATH 10A,A03,083737,Patchell; Gregory David,16,0,30,14
1658012583692,MATH 10B,A01,083207,Lim; Seonhee,9,0,34,25
1658012583692,MATH 10B,A02,083208,Lim; Seonhee,10,0,35,25
1658012583692,MATH 10B,A03,093472,Lim; Seonhee,7,0,34,27
1658012583692,MATH 10B,B01,083739,Sinha; Shubham,14,0,30,16
1658012589717,MATH 18,A01,083743,Cinel; Cameron Alexander,9,0,30,21
1658012589717,MATH 18,A02,083744,Cinel; Cameron Alexander,18,0,30,12
1658012589717,MATH 18,A03,083745,Cinel; Cameron Alexander,10,0,30,20
1658012589717,MATH 18,B01,083748,Rideout; David Porter,5,0,37,32
1658012589717,MATH 18,B02,083749,Rideout; David Porter,5,0,36,31
1658012589717,MATH 18,B03,083750,Rideout; David Porter,3,0,37,34
1658012589717,MATH 18,B04,083751,Rideout; David Porter,7,0,36,29
1658012589717,MATH 18,B05,093473,Rideout; David Porter,7,0,36,29
1658012589717,MATH 18,B06,093474,Rideout; David Porter,6,0,36,30
1658012595739,MATH 20A,A01,083754,Zheng; Zequn,14,0,40,26
1658012601764,MATH 20B,A01,083756,Briones; Jor-el Thomas Caparas,4,0,36,32
1658012601764,MATH 20B,A02,083757,Briones; Jor-el Thomas Caparas,1,0,36,35
1658012601764,MATH 20B,A03,093475,Briones; Jor-el Thomas Caparas,3,0,36,33
1658012607787,MATH 20C,A01,083760,Briones; Jor-el Thomas Caparas,1,0,35,34
1658012607787,MATH 20C,A02,083761,Briones; Jor-el Thomas Caparas,8,0,35,27
1658012607787,MATH 20C,A03,093476,Briones; Jor-el Thomas Caparas,0,1,36,36
1658012607787,MATH 20C,B01,083762,Bach; Quang Tran,1,0,30,29
1658012613813,MATH 20D,A01,083765,Tran; Brian Kha,5,0,30,25
1658012613813,MATH 20D,A02,083766,Tran; Brian Kha,5,0,30,25
1658012613813,MATH 20D,A03,083767,Tran; Brian Kha,6,0,30,24
1658012619839,MATH 20E,A01,083771,Ganguly; Soumya,12,0,32,20
1658012619839,MATH 20E,A02,083772,Ganguly; Soumya,7,0,32,25
1658012619839,MATH 20E,B01,083773,Ciotti; Benjamin,20,0,35,15
1658012619839,MATH 20E,B02,083774,Ciotti; Benjamin,18,0,35,17
1658012625863,MATH 103A,A01,083777,Greenfeld; Be'Eri,6,0,36,30
1658012625863,MATH 103A,A02,083778,Greenfeld; Be'Eri,5,0,36,31
1658012625863,MATH 103A,A03,093561,Greenfeld; Be'Eri,7,0,36,29
1658012625863,MATH 103A,B01,083779,Greenfeld; Be'Eri,8,0,36,28
1658012625863,MATH 103A,B02,083780,Greenfeld; Be'Eri,4,0,36,32
1658012625863,MATH 103A,B03,093562,Greenfeld; Be'Eri,3,0,36,33
1658012631885,MATH 105,A01,085443,Carter; Anne Toulson,15,0,35,20
1658012631885,MATH 105,A02,093477,Carter; Anne Toulson,20,0,35,15
1658012637913,MATH 109,A01,083213,Ganzberger; Geoffrey Michael,3,0,34,31
1658012637913,MATH 109,A02,083214,Ganzberger; Geoffrey Michael,4,0,34,30
1658012637913,MATH 109,A03,093478,Ganzberger; Geoffrey Michael,2,0,34,32
1658012637913,MATH 109,B01,083215,Ganzberger; Geoffrey Michael,3,0,32,29
1658012637913,MATH 109,B02,083216,Ganzberger; Geoffrey Michael,3,0,32,29
1658012637913,MATH 109,B03,093479,Ganzberger; Geoffrey Michael,8,0,32,24
1658012643943,MATH 142A,A01,083219,Chow; Bennett,7,0,32,25
1658012643943,MATH 142A,A02,083220,Chow; Bennett,10,0,32,22
1658012643943,MATH 142A,A03,093480,Chow; Bennett,9,0,32,23
1658012643943,MATH 142A,B03,093481,Chow; Bennett,8,0,32,24
1658012643943,MATH 142A,B04,093558,Chow; Bennett,14,0,32,18
1658012643943,MATH 142A,B05,093559,Chow; Bennett,7,0,32,25
1658012649964,MATH 193A,A01,083224,Rotar; Vladimir,9,0,34,25
1658012649964,MATH 193A,A02,083225,Rotar; Vladimir,11,0,34,23
1658012649964,MATH 193A,A03,083781,Rotar; Vladimir,5,0,34,29
1658012649964,MATH 193A,A04,083782,Rotar; Vladimir,12,0,34,22
1658012649964,MATH 193A,A05,093482,Rotar; Vladimir,11,0,34,23
1658012655985,MATH 197,001,091859,McAuley; Julian John,9999,0,9999,0
1658012655985,MATH 197,002,095566,Kedlaya; Kiran S.,9997,0,9999,2
1658012655985,MATH 197,003,095567,Xiao; Ming,9999,0,9999,0
1658012655985,MATH 197,004,095571,Perols; Johan Lars,9998,0,9999,1
1658012663038,COGS 9,A01,083615,Shannon; Kyle Michael,11,0,75,64
1658012669071,COGS 11,A01,083617,Boyle; Mary E. T.,23,0,48,25
1658012675093,COGS 13,A01,083071,Bastos; Amalia Pinkusfeld,12,0,71,59
1658012681115,COGS 14A,A01,092681,Semenuks; Arturs,5,1,100,95
1658012687135,COGS 14B,A01,083073,Cheng; Tzu-Han,7,0,63,56
1658012693161,COGS 17,A01,092677,Semenuks; Arturs,7,0,81,74
1658012699183,COGS 100,A01,083619,Allen; Michael Gordon,17,0,70,53
1658012705205,COGS 101A,A01,083621,Davis; Joshua Daniel,9,0,68,59
1658012711231,COGS 101B,A01,091572,Allen; Michael Gordon,14,0,65,51
1658012717257,COGS 101C,A01,083625,Delgado; Tania,17,0,35,18
1658012723282,COGS 107A,A01,083627,Boyle; Mary E. T.,14,0,60,46
1658012729304,COGS 118A,A01,083075,Gupta; Anjum,21,0,76,55
1658012735332,CSE 3,A50,083646,Miranda; Gregory Joseph,24,0,50,26
1658012741366,CSE 8A,A50,083650,Miranda; Gregory Joseph,17,1,56,39
1658012747391,CSE 11,A01,083080,Cao; Yingjun,7,15,40,33
1658012753416,CSE 12,A01,083652,Krause-Levy; Sophia Louisa,30,1,120,90
1658012759443,CSE 15L,A01,083654,Morris; Justin Loren,9,0,50,41
1658012759443,CSE 15L,A02,083655,Morris; Justin Loren,11,0,50,39
1658012765469,CSE 20,A01,083657,Tran; Khoa Dang,39,0,80,41
1658012771490,CSE 21,A01,095574,Bach; Quang Tran,23,0,48,25
1658012777513,CSE 30,A01,083084,Eldon; John,8,0,80,72
1658012777513,CSE 30,B01,095061,Bhaskar; Nishant,9,0,50,41
1658012783543,CSE 100,A01,083659,Cao; Yingjun,5,4,70,65
1658012789565,CSE 134B,A01,083661,Powell; Thomas Allan,25,0,100,75
1658012795591,CSE 140,A01,083663,Gungor; Onat,17,0,85,68
1658012801613,CSE 140L,A01,083088,Eldon; John,23,0,100,77
1658012807635,CSE 175,A01,083665,Kumar; Rakesh,3,0,25,22
1658012813656,CSE 190,A00,092507,Dubnov; Shlomo,8,0,20,12
1658012819685,ECE 45,A01,083139,Congero; Spencer William,7,0,75,68
1658012825712,ECE 65,A50,083695,Saad; Andrew S,12,0,30,18
1658012825712,ECE 65,A51,095125,Saad; Andrew S,24,0,26,2
1658012831735,ECE 109,A01,091882,Touri; Behrouz,21,0,70,49
1658012837769,ECE 180,A00,083140,Abi Samra; Nicholas Camill,1,0,30,29
1658012837769,ECE 180,B00,083141,Abi Samra; Nicholas Camill,0,0,30,30
1658012843793,MATH 10A,A01,083735,Patchell; Gregory David,2,0,30,28
1658012843793,MATH 10A,A02,083736,Patchell; Gregory David,20,0,30,10
1658012843793,MATH 10A,A03,083737,Patchell; Gregory David,16,0,30,14
1658012849815,MATH 10B,A01,083207,Lim; Seonhee,9,0,34,25
1658012849815,MATH 10B,A02,083208,Lim; Seonhee,10,0,35,25
1658012849815,MATH 10B,A03,093472,Lim; Seonhee,7,0,34,27
1658012849815,MATH 10B,B01,083739,Sinha; Shubham,14,0,30,16
1658012855839,MATH 18,A01,083743,Cinel; Cameron Alexander,9,0,30,21
1658012855839,MATH 18,A02,083744,Cinel; Cameron Alexander,18,0,30,12
1658012855839,MATH 18,A03,083745,Cinel; Cameron Alexander,10,0,30,20
1658012855839,MATH 18,B01,083748,Rideout; David Porter,5,0,37,32
1658012855839,MATH 18,B02,083749,Rideout; David Porter,5,0,36,31
1658012855839,MATH 18,B03,083750,Rideout; David Porter,3,0,37,34
1658012855839,MATH 18,B04,083751,Rideout; David Porter,7,0,36,29
1658012855839,MATH 18,B05,093473,Rideout; David Porter,7,0,36,29
1658012855839,MATH 18,B06,093474,Rideout; David Porter,6,0,36,30
1658012861872,MATH 20A,A01,083754,Zheng; Zequn,14,0,40,26
1658012867896,MATH 20B,A01,083756,Briones; Jor-el Thomas Caparas,4,0,36,32
1658012867896,MATH 20B,A02,083757,Briones; Jor-el Thomas Caparas,1,0,36,35
1658012867896,MATH 20B,A03,093475,Briones; Jor-el Thomas Caparas,3,0,36,33
1658012873920,MATH 20C,A01,083760,Briones; Jor-el Thomas Caparas,1,0,35,34
1658012873920,MATH 20C,A02,083761,Briones; Jor-el Thomas Caparas,8,0,35,27
1658012873920,MATH 20C,A03,093476,Briones; Jor-el Thomas Caparas,0,1,36,36
1658012873920,MATH 20C,B01,083762,Bach; Quang Tran,1,0,30,29
1658012879959,MATH 20D,A01,083765,Tran; Brian Kha,5,0,30,25
1658012879959,MATH 20D,A02,083766,Tran; Brian Kha,5,0,30,25
1658012879959,MATH 20D,A03,083767,Tran; Brian Kha,6,0,30,24
1658012885981,MATH 20E,A01,083771,Ganguly; Soumya,12,0,32,20
1658012885981,MATH 20E,A02,083772,Ganguly; Soumya,7,0,32,25
1658012885981,MATH 20E,B01,083773,Ciotti; Benjamin,20,0,35,15
1658012885981,MATH 20E,B02,083774,Ciotti; Benjamin,18,0,35,17
1658012892005,MATH 103A,A01,083777,Greenfeld; Be'Eri,6,0,36,30
1658012892005,MATH 103A,A02,083778,Greenfeld; Be'Eri,5,0,36,31
1658012892005,MATH 103A,A03,093561,Greenfeld; Be'Eri,7,0,36,29
1658012892005,MATH 103A,B01,083779,Greenfeld; Be'Eri,8,0,36,28
1658012892005,MATH 103A,B02,083780,Greenfeld; Be'Eri,4,0,36,32
1658012892005,MATH 103A,B03,093562,Greenfeld; Be'Eri,3,0,36,33
1658012898031,MATH 105,A01,085443,Carter; Anne Toulson,15,0,35,20
1658012898031,MATH 105,A02,093477,Carter; Anne Toulson,20,0,35,15
1658012904059,MATH 109,A01,083213,Ganzberger; Geoffrey Michael,3,0,34,31
1658012904059,MATH 109,A02,083214,Ganzberger; Geoffrey Michael,4,0,34,30
1658012904059,MATH 109,A03,093478,Ganzberger; Geoffrey Michael,2,0,34,32
1658012904059,MATH 109,B01,083215,Ganzberger; Geoffrey Michael,3,0,32,29
1658012904059,MATH 109,B02,083216,Ganzberger; Geoffrey Michael,3,0,32,29
1658012904059,MATH 109,B03,093479,Ganzberger; Geoffrey Michael,8,0,32,24
1658012910081,MATH 142A,A01,083219,Chow; Bennett,7,0,32,25
1658012910081,MATH 142A,A02,083220,Chow; Bennett,10,0,32,22
1658012910081,MATH 142A,A03,093480,Chow; Bennett,9,0,32,23
1658012910081,MATH 142A,B03,093481,Chow; Bennett,8,0,32,24
1658012910081,MATH 142A,B04,093558,Chow; Bennett,14,0,32,18
1658012910081,MATH 142A,B05,093559,Chow; Bennett,7,0,32,25
1658012916110,MATH 193A,A01,083224,Rotar; Vladimir,9,0,34,25
1658012916110,MATH 193A,A02,083225,Rotar; Vladimir,11,0,34,23
1658012916110,MATH 193A,A03,083781,Rotar; Vladimir,5,0,34,29
1658012916110,MATH 193A,A04,083782,Rotar; Vladimir,12,0,34,22
1658012916110,MATH 193A,A05,093482,Rotar; Vladimir,11,0,34,23
1658012922135,MATH 197,001,091859,McAuley; Julian John,9999,0,9999,0
1658012922135,MATH 197,002,095566,Kedlaya; Kiran S.,9997,0,9999,2
1658012922135,MATH 197,003,095567,Xiao; Ming,9999,0,9999,0
1658012922135,MATH 197,004,095571,Perols; Johan Lars,9998,0,9999,1
1658012929194,COGS 9,A01,083615,Shannon; Kyle Michael,11,0,75,64
1658012935217,COGS 11,A01,083617,Boyle; Mary E. T.,23,0,48,25
1658012941243,COGS 13,A01,083071,Bastos; Amalia Pinkusfeld,12,0,71,59
1658012947272,COGS 14A,A01,092681,Semenuks; Arturs,5,1,100,95
1658012953293,COGS 14B,A01,083073,Cheng; Tzu-Han,7,0,63,56
1658012959320,COGS 17,A01,092677,Semenuks; Arturs,7,0,81,74
1658012965349,COGS 100,A01,083619,Allen; Michael Gordon,17,0,70,53
1658012971371,COGS 101A,A01,083621,Davis; Joshua Daniel,9,0,68,59
1658012977394,COGS 101B,A01,091572,Allen; Michael Gordon,14,0,65,51
1658012983420,COGS 101C,A01,083625,Delgado; Tania,17,0,35,18
1658012989448,COGS 107A,A01,083627,Boyle; Mary E. T.,14,0,60,46
1658012995475,COGS 118A,A01,083075,Gupta; Anjum,21,0,76,55
1658013001588,CSE 3,A50,083646,Miranda; Gregory Joseph,24,0,50,26
1658013007611,CSE 8A,A50,083650,Miranda; Gregory Joseph,17,1,56,39
1658013013634,CSE 11,A01,083080,Cao; Yingjun,7,15,40,33
1658013019658,CSE 12,A01,083652,Krause-Levy; Sophia Louisa,30,1,120,90
1658013025686,CSE 15L,A01,083654,Morris; Justin Loren,9,0,50,41
1658013025686,CSE 15L,A02,083655,Morris; Justin Loren,11,0,50,39
1658013031709,CSE 20,A01,083657,Tran; Khoa Dang,39,0,80,41
1658013037735,CSE 21,A01,095574,Bach; Quang Tran,23,0,48,25
1658013043760,CSE 30,A01,083084,Eldon; John,8,0,80,72
1658013043760,CSE 30,B01,095061,Bhaskar; Nishant,9,0,50,41
1658013049782,CSE 100,A01,083659,Cao; Yingjun,5,4,70,65
1658013055805,CSE 134B,A01,083661,Powell; Thomas Allan,25,0,100,75
1658013061829,CSE 140,A01,083663,Gungor; Onat,17,0,85,68
1658013067856,CSE 140L,A01,083088,Eldon; John,23,0,100,77
1658013073884,CSE 175,A01,083665,Kumar; Rakesh,3,0,25,22
1658013079911,CSE 190,A00,092507,Dubnov; Shlomo,8,0,20,12
1658013085935,ECE 45,A01,083139,Congero; Spencer William,7,0,75,68
1658013091958,ECE 65,A50,083695,Saad; Andrew S,12,0,30,18
1658013091958,ECE 65,A51,095125,Saad; Andrew S,24,0,26,2
1658013097981,ECE 109,A01,091882,Touri; Behrouz,21,0,70,49
1658013104008,ECE 180,A00,083140,Abi Samra; Nicholas Camill,1,0,30,29
1658013104008,ECE 180,B00,083141,Abi Samra; Nicholas Camill,0,0,30,30
1658013110035,MATH 10A,A01,083735,Patchell; Gregory David,2,0,30,28
1658013110035,MATH 10A,A02,083736,Patchell; Gregory David,20,0,30,10
1658013110035,MATH 10A,A03,083737,Patchell; Gregory David,16,0,30,14
1658013116059,MATH 10B,A01,083207,Lim; Seonhee,9,0,34,25
1658013116059,MATH 10B,A02,083208,Lim; Seonhee,10,0,35,25
1658013116059,MATH 10B,A03,093472,Lim; Seonhee,7,0,34,27
1658013116059,MATH 10B,B01,083739,Sinha; Shubham,14,0,30,16
1658013122082,MATH 18,A01,083743,Cinel; Cameron Alexander,9,0,30,21
1658013122082,MATH 18,A02,083744,Cinel; Cameron Alexander,18,0,30,12
1658013122082,MATH 18,A03,083745,Cinel; Cameron Alexander,10,0,30,20
1658013122082,MATH 18,B01,083748,Rideout; David Porter,5,0,37,32
1658013122082,MATH 18,B02,083749,Rideout; David Porter,5,0,36,31
1658013122082,MATH 18,B03,083750,Rideout; David Porter,3,0,37,34
1658013122082,MATH 18,B04,083751,Rideout; David Porter,7,0,36,29
1658013122082,MATH 18,B05,093473,Rideout; David Porter,7,0,36,29
1658013122082,MATH 18,B06,093474,Rideout; David Porter,6,0,36,30
1658013128105,MATH 20A,A01,083754,Zheng; Zequn,14,0,40,26
1658013134132,MATH 20B,A01,083756,Briones; Jor-el Thomas Caparas,4,0,36,32
1658013134132,MATH 20B,A02,083757,Briones; Jor-el Thomas Caparas,1,0,36,35
1658013134132,MATH 20B,A03,093475,Briones; Jor-el Thomas Caparas,3,0,36,33
1658013140161,MATH 20C,A01,083760,Briones; Jor-el Thomas Caparas,1,0,35,34
1658013140161,MATH 20C,A02,083761,Briones; Jor-el Thomas Caparas,8,0,35,27
1658013140161,MATH 20C,A03,093476,Briones; Jor-el Thomas Caparas,0,1,36,36
1658013140161,MATH 20C,B01,083762,Bach; Quang Tran,1,0,30,29
1658013146189,MATH 20D,A01,083765,Tran; Brian Kha,5,0,30,25
1658013146189,MATH 20D,A02,083766,Tran; Brian Kha,5,0,30,25
1658013146189,MATH 20D,A03,083767,Tran; Brian Kha,6,0,30,24
1658013152217,MATH 20E,A01,083771,Ganguly; Soumya,12,0,32,20
1658013152217,MATH 20E,A02,083772,Ganguly; Soumya,7,0,32,25
1658013152217,MATH 20E,B01,083773,Ciotti; Benjamin,20,0,35,15
1658013152217,MATH 20E,B02,083774,Ciotti; Benjamin,18,0,35,17
1658013158244,MATH 103A,A01,083777,Greenfeld; Be'Eri,6,0,36,30
1658013158244,MATH 103A,A02,083778,Greenfeld; Be'Eri,5,0,36,31
1658013158244,MATH 103A,A03,093561,Greenfeld; Be'Eri,7,0,36,29
1658013158244,MATH 103A,B01,083779,Greenfeld; Be'Eri,8,0,36,28
1658013158244,MATH 103A,B02,083780,Greenfeld; Be'Eri,4,0,36,32
1658013158244,MATH 103A,B03,093562,Greenfeld; Be'Eri,3,0,36,33
1658013164271,MATH 105,A01,085443,Carter; Anne Toulson,15,0,35,20
1658013164271,MATH 105,A02,093477,Carter; Anne Toulson,20,0,35,15
1658013170294,MATH 109,A01,083213,Ganzberger; Geoffrey Michael,3,0,34,31
1658013170294,MATH 109,A02,083214,Ganzberger; Geoffrey Michael,4,0,34,30
1658013170294,MATH 109,A03,093478,Ganzberger; Geoffrey Michael,2,0,34,32
1658013170294,MATH 109,B01,083215,Ganzberger; Geoffrey Michael,3,0,32,29
1658013170294,MATH 109,B02,083216,Ganzberger; Geoffrey Michael,3,0,32,29
1658013170294,MATH 109,B03,093479,Ganzberger; Geoffrey Michael,8,0,32,24
1658013176319,MATH 142A,A01,083219,Chow; Bennett,7,0,32,25
1658013176319,MATH 142A,A02,083220,Chow; Bennett,10,0,32,22
1658013176319,MATH 142A,A03,093480,Chow; Bennett,9,0,32,23
1658013176319,MATH 142A,B03,093481,Chow; Bennett,8,0,32,24
1658013176319,MATH 142A,B04,093558,Chow; Bennett,14,0,32,18
1658013176319,MATH 142A,B05,093559,Chow; Bennett,7,0,32,25
1658013182343,MATH 193A,A01,083224,Rotar; Vladimir,9,0,34,25
1658013182343,MATH 193A,A02,083225,Rotar; Vladimir,11,0,34,23
1658013182343,MATH 193A,A03,083781,Rotar; Vladimir,5,0,34,29
1658013182343,MATH 193A,A04,083782,Rotar; Vladimir,12,0,34,22
1658013182343,MATH 193A,A05,093482,Rotar; Vladimir,11,0,34,23
1658013188364,MATH 197,001,091859,McAuley; Julian John,9999,0,9999,0
1658013188364,MATH 197,002,095566,Kedlaya; Kiran S.,9997,0,9999,2
1658013188364,MATH 197,003,095567,Xiao; Ming,9999,0,9999,0
1658013188364,MATH 197,004,095571,Perols; Johan Lars,9998,0,9999,1
1658013195427,COGS 9,A01,083615,Shannon; Kyle Michael,11,0,75,64
1658013201450,COGS 11,A01,083617,Boyle; Mary E. T.,23,0,48,25
1658013207473,COGS 13,A01,083071,Bastos; Amalia Pinkusfeld,12,0,71,59
1658013213499,COGS 14A,A01,092681,Semenuks; Arturs,5,1,100,95
1658013219528,COGS 14B,A01,083073,Cheng; Tzu-Han,7,0,63,56
1658013225554,COGS 17,A01,092677,Semenuks; Arturs,7,0,81,74
1658013231575,COGS 100,A01,083619,Allen; Michael Gordon,17,0,70,53
1658013237603,COGS 101A,A01,083621,Davis; Joshua Daniel,9,0,68,59
1658013243630,COGS 101B,A01,091572,Allen; Michael Gordon,14,0,65,51
1658013249652,COGS 101C,A01,083625,Delgado; Tania,17,0,35,18
1658013255687,COGS 107A,A01,083627,Boyle; Mary E. T.,14,0,60,46
1658013261713,COGS 118A,A01,083075,Gupta; Anjum,21,0,76,55
1658013267736,CSE 3,A50,083646,Miranda; Gregory Joseph,24,0,50,26
1658013273759,CSE 8A,A50,083650,Miranda; Gregory Joseph,17,1,56,39
1658013279784,CSE 11,A01,083080,Cao; Yingjun,7,15,40,33
1658013285820,CSE 12,A01,083652,Krause-Levy; Sophia Louisa,30,1,120,90
1658013291843,CSE 15L,A01,083654,Morris; Justin Loren,9,0,50,41
1658013291843,CSE 15L,A02,083655,Morris; Justin Loren,11,0,50,39
1658013297870,CSE 20,A01,083657,Tran; Khoa Dang,39,0,80,41
1658013303892,CSE 21,A01,095574,Bach; Quang Tran,23,0,48,25
1658013309926,CSE 30,A01,083084,Eldon; John,8,0,80,72
1658013309926,CSE 30,B01,095061,Bhaskar; Nishant,9,0,50,41
1658013315951,CSE 100,A01,083659,Cao; Yingjun,5,4,70,65
1658013321977,CSE 134B,A01,083661,Powell; Thomas Allan,25,0,100,75
1658013328001,CSE 140,A01,083663,Gungor; Onat,17,0,85,68
1658013334029,CSE 140L,A01,083088,Eldon; John,23,0,100,77
1658013340057,CSE 175,A01,083665,Kumar; Rakesh,3,0,25,22
1658013346082,CSE 190,A00,092507,Dubnov; Shlomo,8,0,20,12
1658013352105,ECE 45,A01,083139,Congero; Spencer William,7,0,75,68
1658013358131,ECE 65,A50,083695,Saad; Andrew S,12,0,30,18
1658013358131,ECE 65,A51,095125,Saad; Andrew S,24,0,26,2
1658013364155,ECE 109,A01,091882,Touri; Behrouz,21,0,70,49
1658013370181,ECE 180,A00,083140,Abi Samra; Nicholas Camill,1,0,30,29
1658013370181,ECE 180,B00,083141,Abi Samra; Nicholas Camill,0,0,30,30
1658013376209,MATH 10A,A01,083735,Patchell; Gregory David,2,0,30,28
1658013376209,MATH 10A,A02,083736,Patchell; Gregory David,20,0,30,10
1658013376209,MATH 10A,A03,083737,Patchell; Gregory David,16,0,30,14
1658013382238,MATH 10B,A01,083207,Lim; Seonhee,9,0,34,25
1658013382238,MATH 10B,A02,083208,Lim; Seonhee,10,0,35,25
1658013382238,MATH 10B,A03,093472,Lim; Seonhee,7,0,34,27
1658013382238,MATH 10B,B01,083739,Sinha; Shubham,14,0,30,16
1658013388261,MATH 18,A01,083743,Cinel; Cameron Alexander,9,0,30,21
1658013388261,MATH 18,A02,083744,Cinel; Cameron Alexander,18,0,30,12
1658013388261,MATH 18,A03,083745,Cinel; Cameron Alexander,10,0,30,20
1658013388261,MATH 18,B01,083748,Rideout; David Porter,5,0,37,32
1658013388261,MATH 18,B02,083749,Rideout; David Porter,5,0,36,31
1658013388261,MATH 18,B03,083750,Rideout; David Porter,3,0,37,34
1658013388261,MATH 18,B04,083751,Rideout; David Porter,7,0,36,29
1658013388261,MATH 18,B05,093473,Rideout; David Porter,7,0,36,29
1658013388261,MATH 18,B06,093474,Rideout; David Porter,6,0,36,30
1658013394284,MATH 20A,A01,083754,Zheng; Zequn,14,0,40,26
1658013400308,MATH 20B,A01,083756,Briones; Jor-el Thomas Caparas,4,0,36,32
1658013400308,MATH 20B,A02,083757,Briones; Jor-el Thomas Caparas,1,0,36,35
1658013400308,MATH 20B,A03,093475,Briones; Jor-el Thomas Caparas,3,0,36,33
1658013406333,MATH 20C,A01,083760,Briones; Jor-el Thomas Caparas,1,0,35,34
1658013406333,MATH 20C,A02,083761,Briones; Jor-el Thomas Caparas,8,0,35,27
1658013406333,MATH 20C,A03,093476,Briones; Jor-el Thomas Caparas,0,1,36,36
1658013406333,MATH 20C,B01,083762,Bach; Quang Tran,1,0,30,29
1658013412357,MATH 20D,A01,083765,Tran; Brian Kha,5,0,30,25
1658013412357,MATH 20D,A02,083766,Tran; Brian Kha,5,0,30,25
1658013412357,MATH 20D,A03,083767,Tran; Brian Kha,6,0,30,24
1658013418383,MATH 20E,A01,083771,Ganguly; Soumya,12,0,32,20
1658013418383,MATH 20E,A02,083772,Ganguly; Soumya,7,0,32,25
1658013418383,MATH 20E,B01,083773,Ciotti; Benjamin,20,0,35,15
1658013418383,MATH 20E,B02,083774,Ciotti; Benjamin,18,0,35,17
1658013424412,MATH 103A,A01,083777,Greenfeld; Be'Eri,6,0,36,30
1658013424412,MATH 103A,A02,083778,Greenfeld; Be'Eri,5,0,36,31
1658013424412,MATH 103A,A03,093561,Greenfeld; Be'Eri,7,0,36,29
1658013424412,MATH 103A,B01,083779,Greenfeld; Be'Eri,8,0,36,28
1658013424412,MATH 103A,B02,083780,Greenfeld; Be'Eri,4,0,36,32
1658013424412,MATH 103A,B03,093562,Greenfeld; Be'Eri,3,0,36,33
1658013430446,MATH 105,A01,085443,Carter; Anne Toulson,15,0,35,20
1658013430446,MATH 105,A02,093477,Carter; Anne Toulson,20,0,35,15
1658013436478,MATH 109,A01,083213,Ganzberger; Geoffrey Michael,3,0,34,31
1658013436478,MATH 109,A02,083214,Ganzberger; Geoffrey Michael,4,0,34,30
1658013436478,MATH 109,A03,093478,Ganzberger; Geoffrey Michael,2,0,34,32
1658013436478,MATH 109,B01,083215,Ganzberger; Geoffrey Michael,3,0,32,29
1658013436478,MATH 109,B02,083216,Ganzberger; Geoffrey Michael,3,0,32,29
1658013436478,MATH 109,B03,093479,Ganzberger; Geoffrey Michael,8,0,32,24
1658013442507,MATH 142A,A01,083219,Chow; Bennett,7,0,32,25
1658013442507,MATH 142A,A02,083220,Chow; Bennett,10,0,32,22
1658013442507,MATH 142A,A03,093480,Chow; Bennett,9,0,32,23
1658013442507,MATH 142A,B03,093481,Chow; Bennett,8,0,32,24
1658013442507,MATH 142A,B04,093558,Chow; Bennett,14,0,32,18
1658013442507,MATH 142A,B05,093559,Chow; Bennett,7,0,32,25
1658013448535,MATH 193A,A01,083224,Rotar; Vladimir,9,0,34,25
1658013448535,MATH 193A,A02,083225,Rotar; Vladimir,11,0,34,23
1658013448535,MATH 193A,A03,083781,Rotar; Vladimir,5,0,34,29
1658013448535,MATH 193A,A04,083782,Rotar; Vladimir,12,0,34,22
1658013448535,MATH 193A,A05,093482,Rotar; Vladimir,11,0,34,23
1658013454562,MATH 197,001,091859,McAuley; Julian John,9999,0,9999,0
1658013454562,MATH 197,002,095566,Kedlaya; Kiran S.,9997,0,9999,2
1658013454562,MATH 197,003,095567,Xiao; Ming,9999,0,9999,0
1658013454562,MATH 197,004,095571,Perols; Johan Lars,9998,0,9999,1
1658013461622,COGS 9,A01,083615,Shannon; Kyle Michael,11,0,75,64
1658013467648,COGS 11,A01,083617,Boyle; Mary E. T.,23,0,48,25
1658013473675,COGS 13,A01,083071,Bastos; Amalia Pinkusfeld,12,0,71,59
1658013479709,COGS 14A,A01,092681,Semenuks; Arturs,5,1,100,95
1658013485731,COGS 14B,A01,083073,Cheng; Tzu-Han,7,0,63,56
1658013491755,COGS 17,A01,092677,Semenuks; Arturs,7,0,81,74
1658013497776,COGS 100,A01,083619,Allen; Michael Gordon,17,0,70,53
1658013503800,COGS 101A,A01,083621,Davis; Joshua Daniel,9,0,68,59
1658013509826,COGS 101B,A01,091572,Allen; Michael Gordon,14,0,65,51
1658013515847,COGS 101C,A01,083625,Delgado; Tania,17,0,35,18
1658013521870,COGS 107A,A01,083627,Boyle; Mary E. T.,14,0,60,46
1658013527896,COGS 118A,A01,083075,Gupta; Anjum,21,0,76,55
1658013533930,CSE 3,A50,083646,Miranda; Gregory Joseph,24,0,50,26
1658013539954,CSE 8A,A50,083650,Miranda; Gregory Joseph,17,1,56,39
1658013545979,CSE 11,A01,083080,Cao; Yingjun,7,15,40,33
1658013552001,CSE 12,A01,083652,Krause-Levy; Sophia Louisa,30,1,120,90
1658013558023,CSE 15L,A01,083654,Morris; Justin Loren,9,0,50,41
1658013558023,CSE 15L,A02,083655,Morris; Justin Loren,11,0,50,39
1658013564057,CSE 20,A01,083657,Tran; Khoa Dang,39,0,80,41
1658013570083,CSE 21,A01,095574,Bach; Quang Tran,23,0,48,25
1658013576106,CSE 30,A01,083084,Eldon; John,8,0,80,72
1658013576106,CSE 30,B01,095061,Bhaskar; Nishant,9,0,50,41
1658013582140,CSE 100,A01,083659,Cao; Yingjun,5,4,70,65
1658013588163,CSE 134B,A01,083661,Powell; Thomas Allan,25,0,100,75
1658013594202,CSE 140,A01,083663,Gungor; Onat,17,0,85,68
1658013600303,CSE 140L,A01,083088,Eldon; John,23,0,100,77
1658013606330,CSE 175,A01,083665,Kumar; Rakesh,3,0,25,22
1658013612355,CSE 190,A00,092507,Dubnov; Shlomo,8,0,20,12
1658013618377,ECE 45,A01,083139,Congero; Spencer William,7,0,75,68
1658013624409,ECE 65,A50,083695,Saad; Andrew S,12,0,30,18
1658013624409,ECE 65,A51,095125,Saad; Andrew S,24,0,26,2
1658013630436,ECE 109,A01,091882,Touri; Behrouz,21,0,70,49
1658013636459,ECE 180,A00,083140,Abi Samra; Nicholas Camill,1,0,30,29
1658013636459,ECE 180,B00,083141,Abi Samra; Nicholas Camill,0,0,30,30
1658013642485,MATH 10A,A01,083735,Patchell; Gregory David,2,0,30,28
1658013642485,MATH 10A,A02,083736,Patchell; Gregory David,20,0,30,10
1658013642485,MATH 10A,A03,083737,Patchell; Gregory David,16,0,30,14
1658013648514,MATH 10B,A01,083207,Lim; Seonhee,9,0,34,25
1658013648514,MATH 10B,A02,083208,Lim; Seonhee,10,0,35,25
1658013648514,MATH 10B,A03,093472,Lim; Seonhee,7,0,34,27
1658013648514,MATH 10B,B01,083739,Sinha; Shubham,14,0,30,16
1658013654540,MATH 18,A01,083743,Cinel; Cameron Alexander,9,0,30,21
1658013654540,MATH 18,A02,083744,Cinel; Cameron Alexander,18,0,30,12
1658013654540,MATH 18,A03,083745,Cinel; Cameron Alexander,10,0,30,20
1658013654540,MATH 18,B01,083748,Rideout; David Porter,5,0,37,32
1658013654540,MATH 18,B02,083749,Rideout; David Porter,5,0,36,31
1658013654540,MATH 18,B03,083750,Rideout; David Porter,3,0,37,34
1658013654540,MATH 18,B04,083751,Rideout; David Porter,7,0,36,29
1658013654540,MATH 18,B05,093473,Rideout; David Porter,7,0,36,29
1658013654540,MATH 18,B06,093474,Rideout; David Porter,6,0,36,30
1658013660568,MATH 20A,A01,083754,Zheng; Zequn,14,0,40,26
1658013666590,MATH 20B,A01,083756,Briones; Jor-el Thomas Caparas,4,0,36,32
1658013666590,MATH 20B,A02,083757,Briones; Jor-el Thomas Caparas,1,0,36,35
1658013666590,MATH 20B,A03,093475,Briones; Jor-el Thomas Caparas,3,0,36,33
1658013672625,MATH 20C,A01,083760,Briones; Jor-el Thomas Caparas,1,0,35,34
1658013672625,MATH 20C,A02,083761,Briones; Jor-el Thomas Caparas,8,0,35,27
1658013672625,MATH 20C,A03,093476,Briones; Jor-el Thomas Caparas,0,1,36,36
1658013672625,MATH 20C,B01,083762,Bach; Quang Tran,1,0,30,29
1658013678654,MATH 20D,A01,083765,Tran; Brian Kha,5,0,30,25
1658013678654,MATH 20D,A02,083766,Tran; Brian Kha,5,0,30,25
1658013678654,MATH 20D,A03,083767,Tran; Brian Kha,6,0,30,24
1658013684682,MATH 20E,A01,083771,Ganguly; Soumya,12,0,32,20
1658013684682,MATH 20E,A02,083772,Ganguly; Soumya,7,0,32,25
1658013684682,MATH 20E,B01,083773,Ciotti; Benjamin,20,0,35,15
1658013684682,MATH 20E,B02,083774,Ciotti; Benjamin,18,0,35,17
1658013690710,MATH 103A,A01,083777,Greenfeld; Be'Eri,6,0,36,30
1658013690710,MATH 103A,A02,083778,Greenfeld; Be'Eri,5,0,36,31
1658013690710,MATH 103A,A03,093561,Greenfeld; Be'Eri,7,0,36,29
1658013690710,MATH 103A,B01,083779,Greenfeld; Be'Eri,8,0,36,28
1658013690710,MATH 103A,B02,083780,Greenfeld; Be'Eri,4,0,36,32
1658013690710,MATH 103A,B03,093562,Greenfeld; Be'Eri,3,0,36,33
1658013696737,MATH 105,A01,085443,Carter; Anne Toulson,15,0,35,20
1658013696737,MATH 105,A02,093477,Carter; Anne Toulson,20,0,35,15
1658013702765,MATH 109,A01,083213,Ganzberger; Geoffrey Michael,3,0,34,31
1658013702765,MATH 109,A02,083214,Ganzberger; Geoffrey Michael,4,0,34,30
1658013702765,MATH 109,A03,093478,Ganzberger; Geoffrey Michael,2,0,34,32
1658013702765,MATH 109,B01,083215,Ganzberger; Geoffrey Michael,3,0,32,29
1658013702765,MATH 109,B02,083216,Ganzberger; Geoffrey Michael,3,0,32,29
1658013702765,MATH 109,B03,093479,Ganzberger; Geoffrey Michael,8,0,32,24
1658013708787,MATH 142A,A01,083219,Chow; Bennett,7,0,32,25
1658013708787,MATH 142A,A02,083220,Chow; Bennett,10,0,32,22
1658013708787,MATH 142A,A03,093480,Chow; Bennett,9,0,32,23
1658013708787,MATH 142A,B03,093481,Chow; Bennett,8,0,32,24
1658013708787,MATH 142A,B04,093558,Chow; Bennett,14,0,32,18
1658013708787,MATH 142A,B05,093559,Chow; Bennett,7,0,32,25
1658013714816,MATH 193A,A01,083224,Rotar; Vladimir,9,0,34,25
1658013714816,MATH 193A,A02,083225,Rotar; Vladimir,11,0,34,23
1658013714816,MATH 193A,A03,083781,Rotar; Vladimir,5,0,34,29
1658013714816,MATH 193A,A04,083782,Rotar; Vladimir,12,0,34,22
1658013714816,MATH 193A,A05,093482,Rotar; Vladimir,11,0,34,23
1658013720843,MATH 197,001,091859,McAuley; Julian John,9999,0,9999,0
1658013720843,MATH 197,002,095566,Kedlaya; Kiran S.,9997,0,9999,2
1658013720843,MATH 197,003,095567,Xiao; Ming,9999,0,9999,0
1658013720843,MATH 197,004,095571,Perols; Johan Lars,9998,0,9999,1
1658013727913,COGS 9,A01,083615,Shannon; Kyle Michael,11,0,75,64
1658013733939,COGS 11,A01,083617,Boyle; Mary E. T.,23,0,48,25
1658013739962,COGS 13,A01,083071,Bastos; Amalia Pinkusfeld,12,0,71,59
1658013746003,COGS 14A,A01,092681,Semenuks; Arturs,5,1,100,95
1658013752033,COGS 14B,A01,083073,Cheng; Tzu-Han,7,0,63,56
1658013758059,COGS 17,A01,092677,Semenuks; Arturs,7,0,81,74
1658013764089,COGS 100,A01,083619,Allen; Michael Gordon,17,0,70,53
1658013770114,COGS 101A,A01,083621,Davis; Joshua Daniel,9,0,68,59
1658013776138,COGS 101B,A01,091572,Allen; Michael Gordon,14,0,65,51
1658013782159,COGS 101C,A01,083625,Delgado; Tania,17,0,35,18
1658013788184,COGS 107A,A01,083627,Boyle; Mary E. T.,14,0,60,46
1658013794207,COGS 118A,A01,083075,Gupta; Anjum,21,0,76,55
1658013800230,CSE 3,A50,083646,Miranda; Gregory Joseph,24,0,50,26
1658013806252,CSE 8A,A50,083650,Miranda; Gregory Joseph,17,1,56,39
1658013812278,CSE 11,A01,083080,Cao; Yingjun,7,15,40,33
1658013818305,CSE 12,A01,083652,Krause-Levy; Sophia Louisa,30,1,120,90
1658013824330,CSE 15L,A01,083654,Morris; Justin Loren,9,0,50,41
1658013824330,CSE 15L,A02,083655,Morris; Justin Loren,11,0,50,39
1658013830353,CSE 20,A01,083657,Tran; Khoa Dang,39,0,80,41
1658013836376,CSE 21,A01,095574,Bach; Quang Tran,23,0,48,25
1658013842403,CSE 30,A01,083084,Eldon; John,8,0,80,72
1658013842403,CSE 30,B01,095061,Bhaskar; Nishant,9,0,50,41
1658013848431,CSE 100,A01,083659,Cao; Yingjun,5,4,70,65
1658013854458,CSE 134B,A01,083661,Powell; Thomas Allan,25,0,100,75
1658013860481,CSE 140,A01,083663,Gungor; Onat,17,0,85,68
1658013866514,CSE 140L,A01,083088,Eldon; John,23,0,100,77
1658013872539,CSE 175,A01,083665,Kumar; Rakesh,3,0,25,22
1658013878574,CSE 190,A00,092507,Dubnov; Shlomo,8,0,20,12
1658013884601,ECE 45,A01,083139,Congero; Spencer William,7,0,75,68
1658013890628,ECE 65,A50,083695,Saad; Andrew S,12,0,30,18
1658013890628,ECE 65,A51,095125,Saad; Andrew S,24,0,26,2
1658013896654,ECE 109,A01,091882,Touri; Behrouz,21,0,70,49
1658013902681,ECE 180,A00,083140,Abi Samra; Nicholas Camill,1,0,30,29
1658013902681,ECE 180,B00,083141,Abi Samra; Nicholas Camill,0,0,30,30
1658013908704,MATH 10A,A01,083735,Patchell; Gregory David,2,0,30,28
1658013908704,MATH 10A,A02,083736,Patchell; Gregory David,20,0,30,10
1658013908704,MATH 10A,A03,083737,Patchell; Gregory David,16,0,30,14
1658013914732,MATH 10B,A01,083207,Lim; Seonhee,9,0,34,25
1658013914732,MATH 10B,A02,083208,Lim; Seonhee,10,0,35,25
1658013914732,MATH 10B,A03,093472,Lim; Seonhee,7,0,34,27
1658013914732,MATH 10B,B01,083739,Sinha; Shubham,14,0,30,16
1658013920762,MATH 18,A01,083743,Cinel; Cameron Alexander,9,0,30,21
1658013920762,MATH 18,A02,083744,Cinel; Cameron Alexander,18,0,30,12
1658013920762,MATH 18,A03,083745,Cinel; Cameron Alexander,10,0,30,20
1658013920762,MATH 18,B01,083748,Rideout; David Porter,5,0,37,32
1658013920762,MATH 18,B02,083749,Rideout; David Porter,5,0,36,31
1658013920762,MATH 18,B03,083750,Rideout; David Porter,3,0,37,34
1658013920762,MATH 18,B04,083751,Rideout; David Porter,7,0,36,29
1658013920762,MATH 18,B05,093473,Rideout; David Porter,7,0,36,29
1658013920762,MATH 18,B06,093474,Rideout; David Porter,6,0,36,30
1658013926786,MATH 20A,A01,083754,Zheng; Zequn,14,0,40,26
1658013932822,MATH 20B,A01,083756,Briones; Jor-el Thomas Caparas,4,0,36,32
1658013932822,MATH 20B,A02,083757,Briones; Jor-el Thomas Caparas,1,0,36,35
1658013932822,MATH 20B,A03,093475,Briones; Jor-el Thomas Caparas,3,0,36,33
1658013938846,MATH 20C,A01,083760,Briones; Jor-el Thomas Caparas,1,0,35,34
1658013938846,MATH 20C,A02,083761,Briones; Jor-el Thomas Caparas,8,0,35,27
1658013938846,MATH 20C,A03,093476,Briones; Jor-el Thomas Caparas,0,1,36,36
1658013938846,MATH 20C,B01,083762,Bach; Quang Tran,1,0,30,29
1658013944887,MATH 20D,A01,083765,Tran; Brian Kha,5,0,30,25
1658013944887,MATH 20D,A02,083766,Tran; Brian Kha,5,0,30,25
1658013944887,MATH 20D,A03,083767,Tran; Brian Kha,6,0,30,24
1658013950916,MATH 20E,A01,083771,Ganguly; Soumya,12,0,32,20
1658013950916,MATH 20E,A02,083772,Ganguly; Soumya,7,0,32,25
1658013950916,MATH 20E,B01,083773,Ciotti; Benjamin,20,0,35,15
1658013950916,MATH 20E,B02,083774,Ciotti; Benjamin,18,0,35,17
1658013956945,MATH 103A,A01,083777,Greenfeld; Be'Eri,6,0,36,30
1658013956945,MATH 103A,A02,083778,Greenfeld; Be'Eri,5,0,36,31
1658013956945,MATH 103A,A03,093561,Greenfeld; Be'Eri,7,0,36,29
1658013956945,MATH 103A,B01,083779,Greenfeld; Be'Eri,8,0,36,28
1658013956945,MATH 103A,B02,083780,Greenfeld; Be'Eri,4,0,36,32
1658013956945,MATH 103A,B03,093562,Greenfeld; Be'Eri,3,0,36,33
1658013963042,MATH 105,A01,085443,Carter; Anne Toulson,15,0,35,20
1658013963042,MATH 105,A02,093477,Carter; Anne Toulson,20,0,35,15
1658013969064,MATH 109,A01,083213,Ganzberger; Geoffrey Michael,3,0,34,31
1658013969064,MATH 109,A02,083214,Ganzberger; Geoffrey Michael,4,0,34,30
1658013969064,MATH 109,A03,093478,Ganzberger; Geoffrey Michael,2,0,34,32
1658013969064,MATH 109,B01,083215,Ganzberger; Geoffrey Michael,3,0,32,29
1658013969064,MATH 109,B02,083216,Ganzberger; Geoffrey Michael,3,0,32,29
1658013969064,MATH 109,B03,093479,Ganzberger; Geoffrey Michael,8,0,32,24
1658013975086,MATH 142A,A01,083219,Chow; Bennett,7,0,32,25
1658013975086,MATH 142A,A02,083220,Chow; Bennett,10,0,32,22
1658013975086,MATH 142A,A03,093480,Chow; Bennett,9,0,32,23
1658013975086,MATH 142A,B03,093481,Chow; Bennett,8,0,32,24
1658013975086,MATH 142A,B04,093558,Chow; Bennett,14,0,32,18
1658013975086,MATH 142A,B05,093559,Chow; Bennett,7,0,32,25
1658013981112,MATH 193A,A01,083224,Rotar; Vladimir,9,0,34,25
1658013981112,MATH 193A,A02,083225,Rotar; Vladimir,11,0,34,23
1658013981112,MATH 193A,A03,083781,Rotar; Vladimir,5,0,34,29
1658013981112,MATH 193A,A04,083782,Rotar; Vladimir,12,0,34,22
1658013981112,MATH 193A,A05,093482,Rotar; Vladimir,11,0,34,23
1658013987138,MATH 197,001,091859,McAuley; Julian John,9999,0,9999,0
1658013987138,MATH 197,002,095566,Kedlaya; Kiran S.,9997,0,9999,2
1658013987138,MATH 197,003,095567,Xiao; Ming,9999,0,9999,0
1658013987138,MATH 197,004,095571,Perols; Johan Lars,9998,0,9999,1
1658013994207,COGS 9,A01,083615,Shannon; Kyle Michael,11,0,75,64
1658014000233,COGS 11,A01,083617,Boyle; Mary E. T.,23,0,48,25
1658014006270,COGS 13,A01,083071,Bastos; Amalia Pinkusfeld,12,0,71,59
1658014012291,COGS 14A,A01,092681,Semenuks; Arturs,5,1,100,95
1658014018314,COGS 14B,A01,083073,Cheng; Tzu-Han,7,0,63,56
1658014024344,COGS 17,A01,092677,Semenuks; Arturs,7,0,81,74
1658014030365,COGS 100,A01,083619,Allen; Michael Gordon,17,0,70,53
1658014036396,COGS 101A,A01,083621,Davis; Joshua Daniel,9,0,68,59
1658014042419,COGS 101B,A01,091572,Allen; Michael Gordon,14,0,65,51
1658014048442,COGS 101C,A01,083625,Delgado; Tania,17,0,35,18
1658014054466,COGS 107A,A01,083627,Boyle; Mary E. T.,14,0,60,46
1658014060492,COGS 118A,A01,083075,Gupta; Anjum,21,0,76,55
1658014066515,CSE 3,A50,083646,Miranda; Gregory Joseph,24,0,50,26
1658014072539,CSE 8A,A50,083650,Miranda; Gregory Joseph,17,1,56,39
1658014078573,CSE 11,A01,083080,Cao; Yingjun,7,15,40,33
1658014084600,CSE 12,A01,083652,Krause-Levy; Sophia Louisa,30,1,120,90
1658014090629,CSE 15L,A01,083654,Morris; Justin Loren,9,0,50,41
1658014090629,CSE 15L,A02,083655,Morris; Justin Loren,11,0,50,39
1658014096652,CSE 20,A01,083657,Tran; Khoa Dang,39,0,80,41
1658014102674,CSE 21,A01,095574,Bach; Quang Tran,23,0,48,25
1658014108700,CSE 30,A01,083084,Eldon; John,8,0,80,72
1658014108700,CSE 30,B01,095061,Bhaskar; Nishant,9,0,50,41
1658014114723,CSE 100,A01,083659,Cao; Yingjun,5,4,70,65
1658014120747,CSE 134B,A01,083661,Powell; Thomas Allan,25,0,100,75
1658014126769,CSE 140,A01,083663,Gungor; Onat,17,0,85,68
1658014132791,CSE 140L,A01,083088,Eldon; John,23,0,100,77
1658014138813,CSE 175,A01,083665,Kumar; Rakesh,3,0,25,22
1658014144836,CSE 190,A00,092507,Dubnov; Shlomo,8,0,20,12
1658014150859,ECE 45,A01,083139,Congero; Spencer William,7,0,75,68
1658014156882,ECE 65,A50,083695,Saad; Andrew S,12,0,30,18
1658014156882,ECE 65,A51,095125,Saad; Andrew S,24,0,26,2
1658014162905,ECE 109,A01,091882,Touri; Behrouz,21,0,70,49
1658014168928,ECE 180,A00,083140,Abi Samra; Nicholas Camill,1,0,30,29
1658014168928,ECE 180,B00,083141,Abi Samra; Nicholas Camill,0,0,30,30
1658014174955,MATH 10A,A01,083735,Patchell; Gregory David,2,0,30,28
1658014174955,MATH 10A,A02,083736,Patchell; Gregory David,20,0,30,10
1658014174955,MATH 10A,A03,083737,Patchell; Gregory David,16,0,30,14
1658014180988,MATH 10B,A01,083207,Lim; Seonhee,9,0,34,25
1658014180988,MATH 10B,A02,083208,Lim; Seonhee,10,0,35,25
1658014180988,MATH 10B,A03,093472,Lim; Seonhee,7,0,34,27
1658014180988,MATH 10B,B01,083739,Sinha; Shubham,14,0,30,16
1658014187030,MATH 18,A01,083743,Cinel; Cameron Alexander,9,0,30,21
1658014187030,MATH 18,A02,083744,Cinel; Cameron Alexander,18,0,30,12
1658014187030,MATH 18,A03,083745,Cinel; Cameron Alexander,10,0,30,20
1658014187030,MATH 18,B01,083748,Rideout; David Porter,5,0,37,32
1658014187030,MATH 18,B02,083749,Rideout; David Porter,5,0,36,31
1658014187030,MATH 18,B03,083750,Rideout; David Porter,3,0,37,34
1658014187030,MATH 18,B04,083751,Rideout; David Porter,7,0,36,29
1658014187030,MATH 18,B05,093473,Rideout; David Porter,7,0,36,29
1658014187030,MATH 18,B06,093474,Rideout; David Porter,6,0,36,30
1658014193056,MATH 20A,A01,083754,Zheng; Zequn,14,0,40,26
1658014199166,MATH 20B,A01,083756,Briones; Jor-el Thomas Caparas,4,0,36,32
1658014199166,MATH 20B,A02,083757,Briones; Jor-el Thomas Caparas,1,0,36,35
1658014199166,MATH 20B,A03,093475,Briones; Jor-el Thomas Caparas,3,0,36,33
1658014205188,MATH 20C,A01,083760,Briones; Jor-el Thomas Caparas,1,0,35,34
1658014205188,MATH 20C,A02,083761,Briones; Jor-el Thomas Caparas,8,0,35,27
1658014205188,MATH 20C,A03,093476,Briones; Jor-el Thomas Caparas,0,1,36,36
1658014205188,MATH 20C,B01,083762,Bach; Quang Tran,1,0,30,29
1658014211216,MATH 20D,A01,083765,Tran; Brian Kha,5,0,30,25
1658014211216,MATH 20D,A02,083766,Tran; Brian Kha,5,0,30,25
1658014211216,MATH 20D,A03,083767,Tran; Brian Kha,6,0,30,24
1658014217238,MATH 20E,A01,083771,Ganguly; Soumya,12,0,32,20
1658014217238,MATH 20E,A02,083772,Ganguly; Soumya,7,0,32,25
1658014217238,MATH 20E,B01,083773,Ciotti; Benjamin,20,0,35,15
1658014217238,MATH 20E,B02,083774,Ciotti; Benjamin,18,0,35,17
1658014223262,MATH 103A,A01,083777,Greenfeld; Be'Eri,6,0,36,30
1658014223262,MATH 103A,A02,083778,Greenfeld; Be'Eri,5,0,36,31
1658014223262,MATH 103A,A03,093561,Greenfeld; Be'Eri,7,0,36,29
1658014223262,MATH 103A,B01,083779,Greenfeld; Be'Eri,8,0,36,28
1658014223262,MATH 103A,B02,083780,Greenfeld; Be'Eri,4,0,36,32
1658014223262,MATH 103A,B03,093562,Greenfeld; Be'Eri,3,0,36,33
1658014229288,MATH 105,A01,085443,Carter; Anne Toulson,15,0,35,20
1658014229288,MATH 105,A02,093477,Carter; Anne Toulson,20,0,35,15
1658014235317,MATH 109,A01,083213,Ganzberger; Geoffrey Michael,3,0,34,31
1658014235317,MATH 109,A02,083214,Ganzberger; Geoffrey Michael,4,0,34,30
1658014235317,MATH 109,A03,093478,Ganzberger; Geoffrey Michael,2,0,34,32
1658014235317,MATH 109,B01,083215,Ganzberger; Geoffrey Michael,3,0,32,29
1658014235317,MATH 109,B02,083216,Ganzberger; Geoffrey Michael,3,0,32,29
1658014235317,MATH 109,B03,093479,Ganzberger; Geoffrey Michael,8,0,32,24
1658014241340,MATH 142A,A01,083219,Chow; Bennett,7,0,32,25
1658014241340,MATH 142A,A02,083220,Chow; Bennett,10,0,32,22
1658014241340,MATH 142A,A03,093480,Chow; Bennett,9,0,32,23
1658014241340,MATH 142A,B03,093481,Chow; Bennett,8,0,32,24
1658014241340,MATH 142A,B04,093558,Chow; Bennett,14,0,32,18
1658014241340,MATH 142A,B05,093559,Chow; Bennett,7,0,32,25
1658014247367,MATH 193A,A01,083224,Rotar; Vladimir,9,0,34,25
1658014247367,MATH 193A,A02,083225,Rotar; Vladimir,11,0,34,23
1658014247367,MATH 193A,A03,083781,Rotar; Vladimir,5,0,34,29
1658014247367,MATH 193A,A04,083782,Rotar; Vladimir,12,0,34,22
1658014247367,MATH 193A,A05,093482,Rotar; Vladimir,11,0,34,23
1658014253388,MATH 197,001,091859,McAuley; Julian John,9999,0,9999,0
1658014253388,MATH 197,002,095566,Kedlaya; Kiran S.,9997,0,9999,2
1658014253388,MATH 197,003,095567,Xiao; Ming,9999,0,9999,0
1658014253388,MATH 197,004,095571,Perols; Johan Lars,9998,0,9999,1
1658014260455,COGS 9,A01,083615,Shannon; Kyle Michael,11,0,75,64
1658014266478,COGS 11,A01,083617,Boyle; Mary E. T.,23,0,48,25
1658014272515,COGS 13,A01,083071,Bastos; Amalia Pinkusfeld,12,0,71,59
1658014278550,COGS 14A,A01,092681,Semenuks; Arturs,5,1,100,95
1658014284572,COGS 14B,A01,083073,Cheng; Tzu-Han,7,0,63,56
1658014290596,COGS 17,A01,092677,Semenuks; Arturs,7,0,81,74
1658014296624,COGS 100,A01,083619,Allen; Michael Gordon,17,0,70,53
1658014302647,COGS 101A,A01,083621,Davis; Joshua Daniel,9,0,68,59
1658014308670,COGS 101B,A01,091572,Allen; Michael Gordon,14,0,65,51
1658014314698,COGS 101C,A01,083625,Delgado; Tania,17,0,35,18
1658014320722,COGS 107A,A01,083627,Boyle; Mary E. T.,14,0,60,46
1658014326749,COGS 118A,A01,083075,Gupta; Anjum,21,0,76,55
1658014332776,CSE 3,A50,083646,Miranda; Gregory Joseph,24,0,50,26
1658014338803,CSE 8A,A50,083650,Miranda; Gregory Joseph,17,1,56,39
1658014344826,CSE 11,A01,083080,Cao; Yingjun,7,15,40,33
1658014350863,CSE 12,A01,083652,Krause-Levy; Sophia Louisa,30,1,120,90
1658014356887,CSE 15L,A01,083654,Morris; Justin Loren,9,0,50,41
1658014356887,CSE 15L,A02,083655,Morris; Justin Loren,11,0,50,39
1658014362912,CSE 20,A01,083657,Tran; Khoa Dang,39,0,80,41
1658014368935,CSE 21,A01,095574,Bach; Quang Tran,23,0,48,25
1658014374958,CSE 30,A01,083084,Eldon; John,8,0,80,72
1658014374958,CSE 30,B01,095061,Bhaskar; Nishant,9,0,50,41
1658014380982,CSE 100,A01,083659,Cao; Yingjun,5,4,70,65
1658014387004,CSE 134B,A01,083661,Powell; Thomas Allan,25,0,100,75
1658014401649,CSE 140,A01,083663,Gungor; Onat,17,0,85,68
1658014407672,CSE 140L,A01,083088,Eldon; John,23,0,100,77
1658014413698,CSE 175,A01,083665,Kumar; Rakesh,3,0,25,22
1658014419725,CSE 190,A00,092507,Dubnov; Shlomo,8,0,20,12
1658014425747,ECE 45,A01,083139,Congero; Spencer William,7,0,75,68
1658014431769,ECE 65,A50,083695,Saad; Andrew S,12,0,30,18
1658014431769,ECE 65,A51,095125,Saad; Andrew S,24,0,26,2
1658014437796,ECE 109,A01,091882,Touri; Behrouz,21,0,70,49
1658014443828,ECE 180,A00,083140,Abi Samra; Nicholas Camill,1,0,30,29
1658014443828,ECE 180,B00,083141,Abi Samra; Nicholas Camill,0,0,30,30
1658014449851,MATH 10A,A01,083735,Patchell; Gregory David,2,0,30,28
1658014449851,MATH 10A,A02,083736,Patchell; Gregory David,20,0,30,10
1658014449851,MATH 10A,A03,083737,Patchell; Gregory David,16,0,30,14
1658014455877,MATH 10B,A01,083207,Lim; Seonhee,9,0,34,25
1658014455877,MATH 10B,A02,083208,Lim; Seonhee,10,0,35,25
1658014455877,MATH 10B,A03,093472,Lim; Seonhee,7,0,34,27
1658014455877,MATH 10B,B01,083739,Sinha; Shubham,14,0,30,16
1658014461901,MATH 18,A01,083743,Cinel; Cameron Alexander,9,0,30,21
1658014461901,MATH 18,A02,083744,Cinel; Cameron Alexander,18,0,30,12
1658014461901,MATH 18,A03,083745,Cinel; Cameron Alexander,10,0,30,20
1658014461901,MATH 18,B01,083748,Rideout; David Porter,5,0,37,32
1658014461901,MATH 18,B02,083749,Rideout; David Porter,5,0,36,31
1658014461901,MATH 18,B03,083750,Rideout; David Porter,3,0,37,34
1658014461901,MATH 18,B04,083751,Rideout; David Porter,7,0,36,29
1658014461901,MATH 18,B05,093473,Rideout; David Porter,7,0,36,29
1658014461901,MATH 18,B06,093474,Rideout; David Porter,6,0,36,30
1658014467927,MATH 20A,A01,083754,Zheng; Zequn,14,0,40,26
1658014473953,MATH 20B,A01,083756,Briones; Jor-el Thomas Caparas,4,0,36,32
1658014473953,MATH 20B,A02,083757,Briones; Jor-el Thomas Caparas,1,0,36,35
1658014473953,MATH 20B,A03,093475,Briones; Jor-el Thomas Caparas,3,0,36,33
1658014479977,MATH 20C,A01,083760,Briones; Jor-el Thomas Caparas,1,0,35,34
1658014479977,MATH 20C,A02,083761,Briones; Jor-el Thomas Caparas,8,0,35,27
1658014479977,MATH 20C,A03,093476,Briones; Jor-el Thomas Caparas,0,1,36,36
1658014479977,MATH 20C,B01,083762,Bach; Quang Tran,1,0,30,29
1658014486004,MATH 20D,A01,083765,Tran; Brian Kha,5,0,30,25
1658014486004,MATH 20D,A02,083766,Tran; Brian Kha,5,0,30,25
1658014486004,MATH 20D,A03,083767,Tran; Brian Kha,6,0,30,24
1658014492028,MATH 20E,A01,083771,Ganguly; Soumya,12,0,32,20
1658014492028,MATH 20E,A02,083772,Ganguly; Soumya,7,0,32,25
1658014492028,MATH 20E,B01,083773,Ciotti; Benjamin,20,0,35,15
1658014492028,MATH 20E,B02,083774,Ciotti; Benjamin,18,0,35,17
1658014498057,MATH 103A,A01,083777,Greenfeld; Be'Eri,6,0,36,30
1658014498057,MATH 103A,A02,083778,Greenfeld; Be'Eri,5,0,36,31
1658014498057,MATH 103A,A03,093561,Greenfeld; Be'Eri,7,0,36,29
1658014498057,MATH 103A,B01,083779,Greenfeld; Be'Eri,8,0,36,28
1658014498057,MATH 103A,B02,083780,Greenfeld; Be'Eri,4,0,36,32
1658014498057,MATH 103A,B03,093562,Greenfeld; Be'Eri,3,0,36,33
1658014504084,MATH 105,A01,085443,Carter; Anne Toulson,15,0,35,20
1658014504084,MATH 105,A02,093477,Carter; Anne Toulson,20,0,35,15
1658014510107,MATH 109,A01,083213,Ganzberger; Geoffrey Michael,3,0,34,31
1658014510107,MATH 109,A02,083214,Ganzberger; Geoffrey Michael,4,0,34,30
1658014510107,MATH 109,A03,093478,Ganzberger; Geoffrey Michael,2,0,34,32
1658014510107,MATH 109,B01,083215,Ganzberger; Geoffrey Michael,3,0,32,29
1658014510107,MATH 109,B02,083216,Ganzberger; Geoffrey Michael,3,0,32,29
1658014510107,MATH 109,B03,093479,Ganzberger; Geoffrey Michael,8,0,32,24
1658014516136,MATH 142A,A01,083219,Chow; Bennett,7,0,32,25
1658014516136,MATH 142A,A02,083220,Chow; Bennett,10,0,32,22
1658014516136,MATH 142A,A03,093480,Chow; Bennett,9,0,32,23
1658014516136,MATH 142A,B03,093481,Chow; Bennett,8,0,32,24
1658014516136,MATH 142A,B04,093558,Chow; Bennett,14,0,32,18
1658014516136,MATH 142A,B05,093559,Chow; Bennett,7,0,32,25
1658014522158,MATH 193A,A01,083224,Rotar; Vladimir,9,0,34,25
1658014522158,MATH 193A,A02,083225,Rotar; Vladimir,11,0,34,23
1658014522158,MATH 193A,A03,083781,Rotar; Vladimir,5,0,34,29
1658014522158,MATH 193A,A04,083782,Rotar; Vladimir,12,0,34,22
1658014522158,MATH 193A,A05,093482,Rotar; Vladimir,11,0,34,23
1658014528178,MATH 197,001,091859,McAuley; Julian John,9999,0,9999,0
1658014528178,MATH 197,002,095566,Kedlaya; Kiran S.,9997,0,9999,2
1658014528178,MATH 197,003,095567,Xiao; Ming,9999,0,9999,0
1658014528178,MATH 197,004,095571,Perols; Johan Lars,9998,0,9999,1
1658014535236,COGS 9,A01,083615,Shannon; Kyle Michael,11,0,75,64
1658014541266,COGS 11,A01,083617,Boyle; Mary E. T.,23,0,48,25
1658014547298,COGS 13,A01,083071,Bastos; Amalia Pinkusfeld,12,0,71,59
1658014553327,COGS 14A,A01,092681,Semenuks; Arturs,5,1,100,95
1658014559349,COGS 14B,A01,083073,Cheng; Tzu-Han,7,0,63,56
1658014565371,COGS 17,A01,092677,Semenuks; Arturs,7,0,81,74
1658014571394,COGS 100,A01,083619,Allen; Michael Gordon,17,0,70,53
1658014577430,COGS 101A,A01,083621,Davis; Joshua Daniel,9,0,68,59
1658014583470,COGS 101B,A01,091572,Allen; Michael Gordon,14,0,65,51
1658014589493,COGS 101C,A01,083625,Delgado; Tania,17,0,35,18
1658014595520,COGS 107A,A01,083627,Boyle; Mary E. T.,14,0,60,46
1658014601555,COGS 118A,A01,083075,Gupta; Anjum,21,0,76,55
1658014607583,CSE 3,A50,083646,Miranda; Gregory Joseph,24,0,50,26
1658014613607,CSE 8A,A50,083650,Miranda; Gregory Joseph,17,1,56,39
1658014619630,CSE 11,A01,083080,Cao; Yingjun,7,15,40,33
1658014625654,CSE 12,A01,083652,Krause-Levy; Sophia Louisa,30,1,120,90
1658014631676,CSE 15L,A01,083654,Morris; Justin Loren,9,0,50,41
1658014631676,CSE 15L,A02,083655,Morris; Justin Loren,11,0,50,39
1658014637700,CSE 20,A01,083657,Tran; Khoa Dang,39,0,80,41
1658014643727,CSE 21,A01,095574,Bach; Quang Tran,23,0,48,25
1658014649749,CSE 30,A01,083084,Eldon; John,8,0,80,72
1658014649749,CSE 30,B01,095061,Bhaskar; Nishant,9,0,50,41
1658014655772,CSE 100,A01,083659,Cao; Yingjun,5,4,70,65
1658014661796,CSE 134B,A01,083661,Powell; Thomas Allan,25,0,100,75
1658014667819,CSE 140,A01,083663,Gungor; Onat,17,0,85,68
1658014673850,CSE 140L,A01,083088,Eldon; John,23,0,100,77
1658014679872,CSE 175,A01,083665,Kumar; Rakesh,3,0,25,22
1658014685897,CSE 190,A00,092507,Dubnov; Shlomo,8,0,20,12
1658014691923,ECE 45,A01,083139,Congero; Spencer William,7,0,75,68
1658014697949,ECE 65,A50,083695,Saad; Andrew S,12,0,30,18
1658014697949,ECE 65,A51,095125,Saad; Andrew S,24,0,26,2
1658014703972,ECE 109,A01,091882,Touri; Behrouz,21,0,70,49
1658014709995,ECE 180,A00,083140,Abi Samra; Nicholas Camill,1,0,30,29
1658014709995,ECE 180,B00,083141,Abi Samra; Nicholas Camill,0,0,30,30
1658014716017,MATH 10A,A01,083735,Patchell; Gregory David,2,0,30,28
1658014716017,MATH 10A,A02,083736,Patchell; Gregory David,20,0,30,10
1658014716017,MATH 10A,A03,083737,Patchell; Gregory David,16,0,30,14
1658014722044,MATH 10B,A01,083207,Lim; Seonhee,9,0,34,25
1658014722044,MATH 10B,A02,083208,Lim; Seonhee,10,0,35,25
1658014722044,MATH 10B,A03,093472,Lim; Seonhee,7,0,34,27
1658014722044,MATH 10B,B01,083739,Sinha; Shubham,14,0,30,16
1658014728074,MATH 18,A01,083743,Cinel; Cameron Alexander,9,0,30,21
1658014728074,MATH 18,A02,083744,Cinel; Cameron Alexander,18,0,30,12
1658014728074,MATH 18,A03,083745,Cinel; Cameron Alexander,10,0,30,20
1658014728074,MATH 18,B01,083748,Rideout; David Porter,5,0,37,32
1658014728074,MATH 18,B02,083749,Rideout; David Porter,5,0,36,31
1658014728074,MATH 18,B03,083750,Rideout; David Porter,3,0,37,34
1658014728074,MATH 18,B04,083751,Rideout; David Porter,7,0,36,29
1658014728074,MATH 18,B05,093473,Rideout; David Porter,7,0,36,29
1658014728074,MATH 18,B06,093474,Rideout; David Porter,6,0,36,30
1658014734099,MATH 20A,A01,083754,Zheng; Zequn,14,0,40,26
1658014740125,MATH 20B,A01,083756,Briones; Jor-el Thomas Caparas,4,0,36,32
1658014740125,MATH 20B,A02,083757,Briones; Jor-el Thomas Caparas,1,0,36,35
1658014740125,MATH 20B,A03,093475,Briones; Jor-el Thomas Caparas,3,0,36,33
1658014746147,MATH 20C,A01,083760,Briones; Jor-el Thomas Caparas,1,0,35,34
1658014746147,MATH 20C,A02,083761,Briones; Jor-el Thomas Caparas,8,0,35,27
1658014746147,MATH 20C,A03,093476,Briones; Jor-el Thomas Caparas,0,1,36,36
1658014746147,MATH 20C,B01,083762,Bach; Quang Tran,1,0,30,29
1658014752171,MATH 20D,A01,083765,Tran; Brian Kha,5,0,30,25
1658014752171,MATH 20D,A02,083766,Tran; Brian Kha,5,0,30,25
1658014752171,MATH 20D,A03,083767,Tran; Brian Kha,6,0,30,24
1658014758197,MATH 20E,A01,083771,Ganguly; Soumya,12,0,32,20
1658014758197,MATH 20E,A02,083772,Ganguly; Soumya,7,0,32,25
1658014758197,MATH 20E,B01,083773,Ciotti; Benjamin,20,0,35,15
1658014758197,MATH 20E,B02,083774,Ciotti; Benjamin,18,0,35,17
1658014764219,MATH 103A,A01,083777,Greenfeld; Be'Eri,6,0,36,30
1658014764219,MATH 103A,A02,083778,Greenfeld; Be'Eri,5,0,36,31
1658014764219,MATH 103A,A03,093561,Greenfeld; Be'Eri,7,0,36,29
1658014764219,MATH 103A,B01,083779,Greenfeld; Be'Eri,8,0,36,28
1658014764219,MATH 103A,B02,083780,Greenfeld; Be'Eri,4,0,36,32
1658014764219,MATH 103A,B03,093562,Greenfeld; Be'Eri,3,0,36,33
1658014770241,MATH 105,A01,085443,Carter; Anne Toulson,15,0,35,20
1658014770241,MATH 105,A02,093477,Carter; Anne Toulson,20,0,35,15
1658014776262,MATH 109,A01,083213,Ganzberger; Geoffrey Michael,3,0,34,31
1658014776262,MATH 109,A02,083214,Ganzberger; Geoffrey Michael,4,0,34,30
1658014776262,MATH 109,A03,093478,Ganzberger; Geoffrey Michael,2,0,34,32
1658014776262,MATH 109,B01,083215,Ganzberger; Geoffrey Michael,3,0,32,29
1658014776262,MATH 109,B02,083216,Ganzberger; Geoffrey Michael,3,0,32,29
1658014776262,MATH 109,B03,093479,Ganzberger; Geoffrey Michael,8,0,32,24
1658014782295,MATH 142A,A01,083219,Chow; Bennett,7,0,32,25
1658014782295,MATH 142A,A02,083220,Chow; Bennett,10,0,32,22
1658014782295,MATH 142A,A03,093480,Chow; Bennett,9,0,32,23
1658014782295,MATH 142A,B03,093481,Chow; Bennett,8,0,32,24
1658014782295,MATH 142A,B04,093558,Chow; Bennett,14,0,32,18
1658014782295,MATH 142A,B05,093559,Chow; Bennett,7,0,32,25
1658014788317,MATH 193A,A01,083224,Rotar; Vladimir,9,0,34,25
1658014788317,MATH 193A,A02,083225,Rotar; Vladimir,11,0,34,23
1658014788317,MATH 193A,A03,083781,Rotar; Vladimir,5,0,34,29
1658014788317,MATH 193A,A04,083782,Rotar; Vladimir,12,0,34,22
1658014788317,MATH 193A,A05,093482,Rotar; Vladimir,11,0,34,23
1658014794340,MATH 197,001,091859,McAuley; Julian John,9999,0,9999,0
1658014794340,MATH 197,002,095566,Kedlaya; Kiran S.,9997,0,9999,2
1658014794340,MATH 197,003,095567,Xiao; Ming,9999,0,9999,0
1658014794340,MATH 197,004,095571,Perols; Johan Lars,9998,0,9999,1
1658014801499,COGS 9,A01,083615,Shannon; Kyle Michael,11,0,75,64
1658014807521,COGS 11,A01,083617,Boyle; Mary E. T.,23,0,48,25
1658014813553,COGS 13,A01,083071,Bastos; Amalia Pinkusfeld,12,0,71,59
1658014819575,COGS 14A,A01,092681,Semenuks; Arturs,5,1,100,95
1658014825609,COGS 14B,A01,083073,Cheng; Tzu-Han,7,0,63,56
1658014831634,COGS 17,A01,092677,Semenuks; Arturs,7,0,81,74
1658014837657,COGS 100,A01,083619,Allen; Michael Gordon,17,0,70,53
1658014843679,COGS 101A,A01,083621,Davis; Joshua Daniel,9,0,68,59
1658014849700,COGS 101B,A01,091572,Allen; Michael Gordon,14,0,65,51
1658014855724,COGS 101C,A01,083625,Delgado; Tania,17,0,35,18
1658014861764,COGS 107A,A01,083627,Boyle; Mary E. T.,14,0,60,46
1658014867786,COGS 118A,A01,083075,Gupta; Anjum,21,0,76,55
1658014873808,CSE 3,A50,083646,Miranda; Gregory Joseph,24,0,50,26
1658014879847,CSE 8A,A50,083650,Miranda; Gregory Joseph,17,1,56,39
1658014885870,CSE 11,A01,083080,Cao; Yingjun,7,15,40,33
1658014891893,CSE 12,A01,083652,Krause-Levy; Sophia Louisa,30,1,120,90
1658014897916,CSE 15L,A01,083654,Morris; Justin Loren,9,0,50,41
1658014897916,CSE 15L,A02,083655,Morris; Justin Loren,11,0,50,39
1658014903942,CSE 20,A01,083657,Tran; Khoa Dang,39,0,80,41
1658014909970,CSE 21,A01,095574,Bach; Quang Tran,23,0,48,25
1658014915996,CSE 30,A01,083084,Eldon; John,8,0,80,72
1658014915996,CSE 30,B01,095061,Bhaskar; Nishant,9,0,50,41
1658014922021,CSE 100,A01,083659,Cao; Yingjun,5,4,70,65
1658014928044,CSE 134B,A01,083661,Powell; Thomas Allan,25,0,100,75
1658014934069,CSE 140,A01,083663,Gungor; Onat,17,0,85,68
1658014940092,CSE 140L,A01,083088,Eldon; John,23,0,100,77
1658014946115,CSE 175,A01,083665,Kumar; Rakesh,3,0,25,22
1658014952139,CSE 190,A00,092507,Dubnov; Shlomo,8,0,20,12
1658014958162,ECE 45,A01,083139,Congero; Spencer William,7,0,75,68
1658014964190,ECE 65,A50,083695,Saad; Andrew S,12,0,30,18
1658014964190,ECE 65,A51,095125,Saad; Andrew S,24,0,26,2
1658014970213,ECE 109,A01,091882,Touri; Behrouz,21,0,70,49
1658014976239,ECE 180,A00,083140,Abi Samra; Nicholas Camill,1,0,30,29
1658014976239,ECE 180,B00,083141,Abi Samra; Nicholas Camill,0,0,30,30
1658014982266,MATH 10A,A01,083735,Patchell; Gregory David,2,0,30,28
1658014982266,MATH 10A,A02,083736,Patchell; Gregory David,20,0,30,10
1658014982266,MATH 10A,A03,083737,Patchell; Gregory David,16,0,30,14
1658014988292,MATH 10B,A01,083207,Lim; Seonhee,9,0,34,25
1658014988292,MATH 10B,A02,083208,Lim; Seonhee,10,0,35,25
1658014988292,MATH 10B,A03,093472,Lim; Seonhee,7,0,34,27
1658014988292,MATH 10B,B01,083739,Sinha; Shubham,14,0,30,16
1658014994323,MATH 18,A01,083743,Cinel; Cameron Alexander,9,0,30,21
1658014994323,MATH 18,A02,083744,Cinel; Cameron Alexander,18,0,30,12
1658014994323,MATH 18,A03,083745,Cinel; Cameron Alexander,10,0,30,20
1658014994323,MATH 18,B01,083748,Rideout; David Porter,5,0,37,32
1658014994323,MATH 18,B02,083749,Rideout; David Porter,5,0,36,31
1658014994323,MATH 18,B03,083750,Rideout; David Porter,3,0,37,34
1658014994323,MATH 18,B04,083751,Rideout; David Porter,7,0,36,29
1658014994323,MATH 18,B05,093473,Rideout; David Porter,7,0,36,29
1658014994323,MATH 18,B06,093474,Rideout; David Porter,6,0,36,30
1658015000345,MATH 20A,A01,083754,Zheng; Zequn,14,0,40,26
1658015006373,MATH 20B,A01,083756,Briones; Jor-el Thomas Caparas,4,0,36,32
1658015006373,MATH 20B,A02,083757,Briones; Jor-el Thomas Caparas,1,0,36,35
1658015006373,MATH 20B,A03,093475,Briones; Jor-el Thomas Caparas,3,0,36,33
1658015012396,MATH 20C,A01,083760,Briones; Jor-el Thomas Caparas,1,0,35,34
1658015012396,MATH 20C,A02,083761,Briones; Jor-el Thomas Caparas,8,0,35,27
1658015012396,MATH 20C,A03,093476,Briones; Jor-el Thomas Caparas,0,1,36,36
1658015012396,MATH 20C,B01,083762,Bach; Quang Tran,1,0,30,29
1658015018427,MATH 20D,A01,083765,Tran; Brian Kha,5,0,30,25
1658015018427,MATH 20D,A02,083766,Tran; Brian Kha,5,0,30,25
1658015018427,MATH 20D,A03,083767,Tran; Brian Kha,6,0,30,24
1658015024454,MATH 20E,A01,083771,Ganguly; Soumya,12,0,32,20
1658015024454,MATH 20E,A02,083772,Ganguly; Soumya,7,0,32,25
1658015024454,MATH 20E,B01,083773,Ciotti; Benjamin,20,0,35,15
1658015024454,MATH 20E,B02,083774,Ciotti; Benjamin,18,0,35,17
1658015030483,MATH 103A,A01,083777,Greenfeld; Be'Eri,6,0,36,30
1658015030483,MATH 103A,A02,083778,Greenfeld; Be'Eri,5,0,36,31
1658015030483,MATH 103A,A03,093561,Greenfeld; Be'Eri,7,0,36,29
1658015030483,MATH 103A,B01,083779,Greenfeld; Be'Eri,8,0,36,28
1658015030483,MATH 103A,B02,083780,Greenfeld; Be'Eri,4,0,36,32
1658015030483,MATH 103A,B03,093562,Greenfeld; Be'Eri,3,0,36,33
1658015036507,MATH 105,A01,085443,Carter; Anne Toulson,15,0,35,20
1658015036507,MATH 105,A02,093477,Carter; Anne Toulson,20,0,35,15
1658015042531,MATH 109,A01,083213,Ganzberger; Geoffrey Michael,3,0,34,31
1658015042531,MATH 109,A02,083214,Ganzberger; Geoffrey Michael,4,0,34,30
1658015042531,MATH 109,A03,093478,Ganzberger; Geoffrey Michael,2,0,34,32
1658015042531,MATH 109,B01,083215,Ganzberger; Geoffrey Michael,3,0,32,29
1658015042531,MATH 109,B02,083216,Ganzberger; Geoffrey Michael,3,0,32,29
1658015042531,MATH 109,B03,093479,Ganzberger; Geoffrey Michael,8,0,32,24
1658015048560,MATH 142A,A01,083219,Chow; Bennett,7,0,32,25
1658015048560,MATH 142A,A02,083220,Chow; Bennett,10,0,32,22
1658015048560,MATH 142A,A03,093480,Chow; Bennett,9,0,32,23
1658015048560,MATH 142A,B03,093481,Chow; Bennett,8,0,32,24
1658015048560,MATH 142A,B04,093558,Chow; Bennett,14,0,32,18
1658015048560,MATH 142A,B05,093559,Chow; Bennett,7,0,32,25
1658015054587,MATH 193A,A01,083224,Rotar; Vladimir,9,0,34,25
1658015054587,MATH 193A,A02,083225,Rotar; Vladimir,11,0,34,23
1658015054587,MATH 193A,A03,083781,Rotar; Vladimir,5,0,34,29
1658015054587,MATH 193A,A04,083782,Rotar; Vladimir,12,0,34,22
1658015054587,MATH 193A,A05,093482,Rotar; Vladimir,11,0,34,23
1658015060610,MATH 197,001,091859,McAuley; Julian John,9999,0,9999,0
1658015060610,MATH 197,002,095566,Kedlaya; Kiran S.,9997,0,9999,2
1658015060610,MATH 197,003,095567,Xiao; Ming,9999,0,9999,0
1658015060610,MATH 197,004,095571,Perols; Johan Lars,9998,0,9999,1
1658015067668,COGS 9,A01,083615,Shannon; Kyle Michael,11,0,75,64
1658015073694,COGS 11,A01,083617,Boyle; Mary E. T.,23,0,48,25
1658015079715,COGS 13,A01,083071,Bastos; Amalia Pinkusfeld,12,0,71,59
1658015085738,COGS 14A,A01,092681,Semenuks; Arturs,5,1,100,95
1658015091763,COGS 14B,A01,083073,Cheng; Tzu-Han,7,0,63,56
1658015097789,COGS 17,A01,092677,Semenuks; Arturs,7,0,81,74
1658015103815,COGS 100,A01,083619,Allen; Michael Gordon,17,0,70,53
1658015109841,COGS 101A,A01,083621,Davis; Joshua Daniel,9,0,68,59
1658015115866,COGS 101B,A01,091572,Allen; Michael Gordon,14,0,65,51
1658015121890,COGS 101C,A01,083625,Delgado; Tania,17,0,35,18
1658015127916,COGS 107A,A01,083627,Boyle; Mary E. T.,14,0,60,46
1658015133940,COGS 118A,A01,083075,Gupta; Anjum,21,0,76,55
1658015139963,CSE 3,A50,083646,Miranda; Gregory Joseph,24,0,50,26
1658015145990,CSE 8A,A50,083650,Miranda; Gregory Joseph,17,1,56,39
1658015152015,CSE 11,A01,083080,Cao; Yingjun,7,15,40,33
1658015158039,CSE 12,A01,083652,Krause-Levy; Sophia Louisa,30,1,120,90
1658015164060,CSE 15L,A01,083654,Morris; Justin Loren,9,0,50,41
1658015164060,CSE 15L,A02,083655,Morris; Justin Loren,11,0,50,39
1658015170085,CSE 20,A01,083657,Tran; Khoa Dang,39,0,80,41
1658015176114,CSE 21,A01,095574,Bach; Quang Tran,23,0,48,25
1658015182137,CSE 30,A01,083084,Eldon; John,8,0,80,72
1658015182137,CSE 30,B01,095061,Bhaskar; Nishant,9,0,50,41
1658015188162,CSE 100,A01,083659,Cao; Yingjun,5,4,70,65
1658015194188,CSE 134B,A01,083661,Powell; Thomas Allan,25,0,100,75
1658015200210,CSE 140,A01,083663,Gungor; Onat,17,0,85,68
1658015206234,CSE 140L,A01,083088,Eldon; John,23,0,100,77
1658015212255,CSE 175,A01,083665,Kumar; Rakesh,3,0,25,22
1658015218285,CSE 190,A00,092507,Dubnov; Shlomo,8,0,20,12
1658015224307,ECE 45,A01,083139,Congero; Spencer William,7,0,75,68
1658015230330,ECE 65,A50,083695,Saad; Andrew S,12,0,30,18
1658015230330,ECE 65,A51,095125,Saad; Andrew S,24,0,26,2
1658015236353,ECE 109,A01,091882,Touri; Behrouz,21,0,70,49
1658015242380,ECE 180,A00,083140,Abi Samra; Nicholas Camill,1,0,30,29
1658015242380,ECE 180,B00,083141,Abi Samra; Nicholas Camill,0,0,30,30
1658015248408,MATH 10A,A01,083735,Patchell; Gregory David,2,0,30,28
1658015248408,MATH 10A,A02,083736,Patchell; Gregory David,20,0,30,10
1658015248408,MATH 10A,A03,083737,Patchell; Gregory David,16,0,30,14
1658015254432,MATH 10B,A01,083207,Lim; Seonhee,9,0,34,25
1658015254432,MATH 10B,A02,083208,Lim; Seonhee,10,0,35,25
1658015254432,MATH 10B,A03,093472,Lim; Seonhee,7,0,34,27
1658015254432,MATH 10B,B01,083739,Sinha; Shubham,14,0,30,16
1658015260457,MATH 18,A01,083743,Cinel; Cameron Alexander,9,0,30,21
1658015260457,MATH 18,A02,083744,Cinel; Cameron Alexander,18,0,30,12
1658015260457,MATH 18,A03,083745,Cinel; Cameron Alexander,10,0,30,20
1658015260457,MATH 18,B01,083748,Rideout; David Porter,5,0,37,32
1658015260457,MATH 18,B02,083749,Rideout; David Porter,5,0,36,31
1658015260457,MATH 18,B03,083750,Rideout; David Porter,3,0,37,34
1658015260457,MATH 18,B04,083751,Rideout; David Porter,7,0,36,29
1658015260457,MATH 18,B05,093473,Rideout; David Porter,7,0,36,29
1658015260457,MATH 18,B06,093474,Rideout; David Porter,6,0,36,30
1658015266490,MATH 20A,A01,083754,Zheng; Zequn,14,0,40,26
1658015272513,MATH 20B,A01,083756,Briones; Jor-el Thomas Caparas,4,0,36,32
1658015272513,MATH 20B,A02,083757,Briones; Jor-el Thomas Caparas,1,0,36,35
1658015272513,MATH 20B,A03,093475,Briones; Jor-el Thomas Caparas,3,0,36,33
1658015278556,MATH 20C,A01,083760,Briones; Jor-el Thomas Caparas,1,0,35,34
1658015278556,MATH 20C,A02,083761,Briones; Jor-el Thomas Caparas,8,0,35,27
1658015278556,MATH 20C,A03,093476,Briones; Jor-el Thomas Caparas,0,1,36,36
1658015278556,MATH 20C,B01,083762,Bach; Quang Tran,1,0,30,29
1658015284595,MATH 20D,A01,083765,Tran; Brian Kha,5,0,30,25
1658015284595,MATH 20D,A02,083766,Tran; Brian Kha,5,0,30,25
1658015284595,MATH 20D,A03,083767,Tran; Brian Kha,6,0,30,24
1658015290617,MATH 20E,A01,083771,Ganguly; Soumya,12,0,32,20
1658015290617,MATH 20E,A02,083772,Ganguly; Soumya,7,0,32,25
1658015290617,MATH 20E,B01,083773,Ciotti; Benjamin,20,0,35,15
1658015290617,MATH 20E,B02,083774,Ciotti; Benjamin,18,0,35,17
1658015296649,MATH 103A,A01,083777,Greenfeld; Be'Eri,6,0,36,30
1658015296649,MATH 103A,A02,083778,Greenfeld; Be'Eri,5,0,36,31
1658015296649,MATH 103A,A03,093561,Greenfeld; Be'Eri,7,0,36,29
1658015296649,MATH 103A,B01,083779,Greenfeld; Be'Eri,8,0,36,28
1658015296649,MATH 103A,B02,083780,Greenfeld; Be'Eri,4,0,36,32
1658015296649,MATH 103A,B03,093562,Greenfeld; Be'Eri,3,0,36,33
1658015302670,MATH 105,A01,085443,Carter; Anne Toulson,15,0,35,20
1658015302670,MATH 105,A02,093477,Carter; Anne Toulson,20,0,35,15
1658015308706,MATH 109,A01,083213,Ganzberger; Geoffrey Michael,3,0,34,31
1658015308706,MATH 109,A02,083214,Ganzberger; Geoffrey Michael,4,0,34,30
1658015308706,MATH 109,A03,093478,Ganzberger; Geoffrey Michael,2,0,34,32
1658015308706,MATH 109,B01,083215,Ganzberger; Geoffrey Michael,3,0,32,29
1658015308706,MATH 109,B02,083216,Ganzberger; Geoffrey Michael,3,0,32,29
1658015308706,MATH 109,B03,093479,Ganzberger; Geoffrey Michael,8,0,32,24
1658015314734,MATH 142A,A01,083219,Chow; Bennett,7,0,32,25
1658015314734,MATH 142A,A02,083220,Chow; Bennett,10,0,32,22
1658015314734,MATH 142A,A03,093480,Chow; Bennett,9,0,32,23
1658015314734,MATH 142A,B03,093481,Chow; Bennett,8,0,32,24
1658015314734,MATH 142A,B04,093558,Chow; Bennett,14,0,32,18
1658015314734,MATH 142A,B05,093559,Chow; Bennett,7,0,32,25
1658015320756,MATH 193A,A01,083224,Rotar; Vladimir,9,0,34,25
1658015320756,MATH 193A,A02,083225,Rotar; Vladimir,11,0,34,23
1658015320756,MATH 193A,A03,083781,Rotar; Vladimir,5,0,34,29
1658015320756,MATH 193A,A04,083782,Rotar; Vladimir,12,0,34,22
1658015320756,MATH 193A,A05,093482,Rotar; Vladimir,11,0,34,23
1658015326783,MATH 197,001,091859,McAuley; Julian John,9999,0,9999,0
1658015326783,MATH 197,002,095566,Kedlaya; Kiran S.,9997,0,9999,2
1658015326783,MATH 197,003,095567,Xiao; Ming,9999,0,9999,0
1658015326783,MATH 197,004,095571,Perols; Johan Lars,9998,0,9999,1
1658015333831,COGS 9,A01,083615,Shannon; Kyle Michael,11,0,75,64
1658015339857,COGS 11,A01,083617,Boyle; Mary E. T.,23,0,48,25
1658015345884,COGS 13,A01,083071,Bastos; Amalia Pinkusfeld,12,0,71,59
1658015351906,COGS 14A,A01,092681,Semenuks; Arturs,5,1,100,95
1658015357928,COGS 14B,A01,083073,Cheng; Tzu-Han,7,0,63,56
1658015363951,COGS 17,A01,092677,Semenuks; Arturs,7,0,81,74
1658015369973,COGS 100,A01,083619,Allen; Michael Gordon,17,0,70,53
1658015375999,COGS 101A,A01,083621,Davis; Joshua Daniel,9,0,68,59
1658015382023,COGS 101B,A01,091572,Allen; Michael Gordon,14,0,65,51
1658015388046,COGS 101C,A01,083625,Delgado; Tania,17,0,35,18
1658015394072,COGS 107A,A01,083627,Boyle; Mary E. T.,14,0,60,46
1658015400196,COGS 118A,A01,083075,Gupta; Anjum,21,0,76,55
1658015406219,CSE 3,A50,083646,Miranda; Gregory Joseph,24,0,50,26
1658015412253,CSE 8A,A50,083650,Miranda; Gregory Joseph,17,1,56,39
1658015418277,CSE 11,A01,083080,Cao; Yingjun,7,15,40,33
1658015424299,CSE 12,A01,083652,Krause-Levy; Sophia Louisa,30,1,120,90
1658015430330,CSE 15L,A01,083654,Morris; Justin Loren,9,0,50,41
1658015430330,CSE 15L,A02,083655,Morris; Justin Loren,11,0,50,39
1658015436357,CSE 20,A01,083657,Tran; Khoa Dang,39,0,80,41
1658015442384,CSE 21,A01,095574,Bach; Quang Tran,23,0,48,25
1658015448410,CSE 30,A01,083084,Eldon; John,8,0,80,72
1658015448410,CSE 30,B01,095061,Bhaskar; Nishant,9,0,50,41
1658015454432,CSE 100,A01,083659,Cao; Yingjun,5,4,70,65
1658015460454,CSE 134B,A01,083661,Powell; Thomas Allan,25,0,100,75
1658015466478,CSE 140,A01,083663,Gungor; Onat,17,0,85,68
1658015472503,CSE 140L,A01,083088,Eldon; John,23,0,100,77
1658015478526,CSE 175,A01,083665,Kumar; Rakesh,3,0,25,22
1658015484555,CSE 190,A00,092507,Dubnov; Shlomo,8,0,20,12
1658015490583,ECE 45,A01,083139,Congero; Spencer William,7,0,75,68
1658015496606,ECE 65,A50,083695,Saad; Andrew S,12,0,30,18
1658015496606,ECE 65,A51,095125,Saad; Andrew S,24,0,26,2
1658015502629,ECE 109,A01,091882,Touri; Behrouz,21,0,70,49
1658015508652,ECE 180,A00,083140,Abi Samra; Nicholas Camill,1,0,30,29
1658015508652,ECE 180,B00,083141,Abi Samra; Nicholas Camill,0,0,30,30
1658015514675,MATH 10A,A01,083735,Patchell; Gregory David,2,0,30,28
1658015514675,MATH 10A,A02,083736,Patchell; Gregory David,20,0,30,10
1658015514675,MATH 10A,A03,083737,Patchell; Gregory David,16,0,30,14
1658015520698,MATH 10B,A01,083207,Lim; Seonhee,9,0,34,25
1658015520698,MATH 10B,A02,083208,Lim; Seonhee,10,0,35,25
1658015520698,MATH 10B,A03,093472,Lim; Seonhee,7,0,34,27
1658015520698,MATH 10B,B01,083739,Sinha; Shubham,14,0,30,16
1658015526730,MATH 18,A01,083743,Cinel; Cameron Alexander,9,0,30,21
1658015526730,MATH 18,A02,083744,Cinel; Cameron Alexander,18,0,30,12
1658015526730,MATH 18,A03,083745,Cinel; Cameron Alexander,10,0,30,20
1658015526730,MATH 18,B01,083748,Rideout; David Porter,5,0,37,32
1658015526730,MATH 18,B02,083749,Rideout; David Porter,5,0,36,31
1658015526730,MATH 18,B03,083750,Rideout; David Porter,3,0,37,34
1658015526730,MATH 18,B04,083751,Rideout; David Porter,7,0,36,29
1658015526730,MATH 18,B05,093473,Rideout; David Porter,7,0,36,29
1658015526730,MATH 18,B06,093474,Rideout; David Porter,6,0,36,30
1658015532759,MATH 20A,A01,083754,Zheng; Zequn,14,0,40,26
1658015538783,MATH 20B,A01,083756,Briones; Jor-el Thomas Caparas,4,0,36,32
1658015538783,MATH 20B,A02,083757,Briones; Jor-el Thomas Caparas,1,0,36,35
1658015538783,MATH 20B,A03,093475,Briones; Jor-el Thomas Caparas,3,0,36,33
1658015544807,MATH 20C,A01,083760,Briones; Jor-el Thomas Caparas,1,0,35,34
1658015544807,MATH 20C,A02,083761,Briones; Jor-el Thomas Caparas,8,0,35,27
1658015544807,MATH 20C,A03,093476,Briones; Jor-el Thomas Caparas,0,1,36,36
1658015544807,MATH 20C,B01,083762,Bach; Quang Tran,1,0,30,29
1658015550832,MATH 20D,A01,083765,Tran; Brian Kha,5,0,30,25
1658015550832,MATH 20D,A02,083766,Tran; Brian Kha,5,0,30,25
1658015550832,MATH 20D,A03,083767,Tran; Brian Kha,6,0,30,24
1658015556861,MATH 20E,A01,083771,Ganguly; Soumya,12,0,32,20
1658015556861,MATH 20E,A02,083772,Ganguly; Soumya,7,0,32,25
1658015556861,MATH 20E,B01,083773,Ciotti; Benjamin,20,0,35,15
1658015556861,MATH 20E,B02,083774,Ciotti; Benjamin,18,0,35,17
1658015562890,MATH 103A,A01,083777,Greenfeld; Be'Eri,6,0,36,30
1658015562890,MATH 103A,A02,083778,Greenfeld; Be'Eri,5,0,36,31
1658015562890,MATH 103A,A03,093561,Greenfeld; Be'Eri,7,0,36,29
1658015562890,MATH 103A,B01,083779,Greenfeld; Be'Eri,8,0,36,28
1658015562890,MATH 103A,B02,083780,Greenfeld; Be'Eri,4,0,36,32
1658015562890,MATH 103A,B03,093562,Greenfeld; Be'Eri,3,0,36,33
1658015568912,MATH 105,A01,085443,Carter; Anne Toulson,15,0,35,20
1658015568912,MATH 105,A02,093477,Carter; Anne Toulson,20,0,35,15
1658015574936,MATH 109,A01,083213,Ganzberger; Geoffrey Michael,3,0,34,31
1658015574936,MATH 109,A02,083214,Ganzberger; Geoffrey Michael,4,0,34,30
1658015574936,MATH 109,A03,093478,Ganzberger; Geoffrey Michael,2,0,34,32
1658015574936,MATH 109,B01,083215,Ganzberger; Geoffrey Michael,3,0,32,29
1658015574936,MATH 109,B02,083216,Ganzberger; Geoffrey Michael,3,0,32,29
1658015574936,MATH 109,B03,093479,Ganzberger; Geoffrey Michael,8,0,32,24
1658015580965,MATH 142A,A01,083219,Chow; Bennett,7,0,32,25
1658015580965,MATH 142A,A02,083220,Chow; Bennett,10,0,32,22
1658015580965,MATH 142A,A03,093480,Chow; Bennett,9,0,32,23
1658015580965,MATH 142A,B03,093481,Chow; Bennett,8,0,32,24
1658015580965,MATH 142A,B04,093558,Chow; Bennett,14,0,32,18
1658015580965,MATH 142A,B05,093559,Chow; Bennett,7,0,32,25
1658015587002,MATH 193A,A01,083224,Rotar; Vladimir,9,0,34,25
1658015587002,MATH 193A,A02,083225,Rotar; Vladimir,11,0,34,23
1658015587002,MATH 193A,A03,083781,Rotar; Vladimir,5,0,34,29
1658015587002,MATH 193A,A04,083782,Rotar; Vladimir,12,0,34,22
1658015587002,MATH 193A,A05,093482,Rotar; Vladimir,11,0,34,23
1658015593029,MATH 197,001,091859,McAuley; Julian John,9999,0,9999,0
1658015593029,MATH 197,002,095566,Kedlaya; Kiran S.,9997,0,9999,2
1658015593029,MATH 197,003,095567,Xiao; Ming,9999,0,9999,0
1658015593029,MATH 197,004,095571,Perols; Johan Lars,9998,0,9999,1
1658015600093,COGS 9,A01,083615,Shannon; Kyle Michael,11,0,75,64
1658015606113,COGS 11,A01,083617,Boyle; Mary E. T.,23,0,48,25
1658015612147,COGS 13,A01,083071,Bastos; Amalia Pinkusfeld,12,0,71,59
1658015618173,COGS 14A,A01,092681,Semenuks; Arturs,5,1,100,95
1658015624207,COGS 14B,A01,083073,Cheng; Tzu-Han,7,0,63,56
1658015630232,COGS 17,A01,092677,Semenuks; Arturs,7,0,81,74
1658015636257,COGS 100,A01,083619,Allen; Michael Gordon,17,0,70,53
1658015642280,COGS 101A,A01,083621,Davis; Joshua Daniel,9,0,68,59
1658015648307,COGS 101B,A01,091572,Allen; Michael Gordon,14,0,65,51
1658015654334,COGS 101C,A01,083625,Delgado; Tania,17,0,35,18
1658015660357,COGS 107A,A01,083627,Boyle; Mary E. T.,14,0,60,46
1658015666381,COGS 118A,A01,083075,Gupta; Anjum,21,0,76,55
1658015672416,CSE 3,A50,083646,Miranda; Gregory Joseph,24,0,50,26
1658015678438,CSE 8A,A50,083650,Miranda; Gregory Joseph,17,1,56,39
1658015684464,CSE 11,A01,083080,Cao; Yingjun,7,15,40,33
1658015690490,CSE 12,A01,083652,Krause-Levy; Sophia Louisa,30,1,120,90
1658015696518,CSE 15L,A01,083654,Morris; Justin Loren,9,0,50,41
1658015696518,CSE 15L,A02,083655,Morris; Justin Loren,11,0,50,39
1658015702542,CSE 20,A01,083657,Tran; Khoa Dang,39,0,80,41
1658015708568,CSE 21,A01,095574,Bach; Quang Tran,23,0,48,25
1658015714590,CSE 30,A01,083084,Eldon; John,8,0,80,72
1658015714590,CSE 30,B01,095061,Bhaskar; Nishant,9,0,50,41
1658015720612,CSE 100,A01,083659,Cao; Yingjun,5,4,70,65
1658015726638,CSE 134B,A01,083661,Powell; Thomas Allan,25,0,100,75
1658015732663,CSE 140,A01,083663,Gungor; Onat,17,0,85,68
1658015738689,CSE 140L,A01,083088,Eldon; John,23,0,100,77
1658015744718,CSE 175,A01,083665,Kumar; Rakesh,3,0,25,22
1658015750774,CSE 190,A00,092507,Dubnov; Shlomo,8,0,20,12
1658015756796,ECE 45,A01,083139,Congero; Spencer William,7,0,75,68
1658015762819,ECE 65,A50,083695,Saad; Andrew S,12,0,30,18
1658015762819,ECE 65,A51,095125,Saad; Andrew S,24,0,26,2
1658015768842,ECE 109,A01,091882,Touri; Behrouz,21,0,70,49
1658015774864,ECE 180,A00,083140,Abi Samra; Nicholas Camill,1,0,30,29
1658015774864,ECE 180,B00,083141,Abi Samra; Nicholas Camill,0,0,30,30
1658015780886,MATH 10A,A01,083735,Patchell; Gregory David,2,0,30,28
1658015780886,MATH 10A,A02,083736,Patchell; Gregory David,20,0,30,10
1658015780886,MATH 10A,A03,083737,Patchell; Gregory David,16,0,30,14
1658015786913,MATH 10B,A01,083207,Lim; Seonhee,9,0,34,25
1658015786913,MATH 10B,A02,083208,Lim; Seonhee,10,0,35,25
1658015786913,MATH 10B,A03,093472,Lim; Seonhee,7,0,34,27
1658015786913,MATH 10B,B01,083739,Sinha; Shubham,14,0,30,16
1658015792936,MATH 18,A01,083743,Cinel; Cameron Alexander,9,0,30,21
1658015792936,MATH 18,A02,083744,Cinel; Cameron Alexander,18,0,30,12
1658015792936,MATH 18,A03,083745,Cinel; Cameron Alexander,10,0,30,20
1658015792936,MATH 18,B01,083748,Rideout; David Porter,5,0,37,32
1658015792936,MATH 18,B02,083749,Rideout; David Porter,5,0,36,31
1658015792936,MATH 18,B03,083750,Rideout; David Porter,3,0,37,34
1658015792936,MATH 18,B04,083751,Rideout; David Porter,7,0,36,29
1658015792936,MATH 18,B05,093473,Rideout; David Porter,7,0,36,29
1658015792936,MATH 18,B06,093474,Rideout; David Porter,6,0,36,30
1658015798964,MATH 20A,A01,083754,Zheng; Zequn,14,0,40,26
1658015804987,MATH 20B,A01,083756,Briones; Jor-el Thomas Caparas,4,0,36,32
1658015804987,MATH 20B,A02,083757,Briones; Jor-el Thomas Caparas,1,0,36,35
1658015804987,MATH 20B,A03,093475,Briones; Jor-el Thomas Caparas,3,0,36,33
1658015811010,MATH 20C,A01,083760,Briones; Jor-el Thomas Caparas,1,0,35,34
1658015811010,MATH 20C,A02,083761,Briones; Jor-el Thomas Caparas,8,0,35,27
1658015811010,MATH 20C,A03,093476,Briones; Jor-el Thomas Caparas,0,1,36,36
1658015811010,MATH 20C,B01,083762,Bach; Quang Tran,1,0,30,29
1658015817037,MATH 20D,A01,083765,Tran; Brian Kha,5,0,30,25
1658015817037,MATH 20D,A02,083766,Tran; Brian Kha,5,0,30,25
1658015817037,MATH 20D,A03,083767,Tran; Brian Kha,6,0,30,24
1658015823064,MATH 20E,A01,083771,Ganguly; Soumya,12,0,32,20
1658015823064,MATH 20E,A02,083772,Ganguly; Soumya,7,0,32,25
1658015823064,MATH 20E,B01,083773,Ciotti; Benjamin,20,0,35,15
1658015823064,MATH 20E,B02,083774,Ciotti; Benjamin,18,0,35,17
1658015829089,MATH 103A,A01,083777,Greenfeld; Be'Eri,6,0,36,30
1658015829089,MATH 103A,A02,083778,Greenfeld; Be'Eri,5,0,36,31
1658015829089,MATH 103A,A03,093561,Greenfeld; Be'Eri,7,0,36,29
1658015829089,MATH 103A,B01,083779,Greenfeld; Be'Eri,8,0,36,28
1658015829089,MATH 103A,B02,083780,Greenfeld; Be'Eri,4,0,36,32
1658015829089,MATH 103A,B03,093562,Greenfeld; Be'Eri,3,0,36,33
1658015835112,MATH 105,A01,085443,Carter; Anne Toulson,15,0,35,20
1658015835112,MATH 105,A02,093477,Carter; Anne Toulson,20,0,35,15
1658015841136,MATH 109,A01,083213,Ganzberger; Geoffrey Michael,3,0,34,31
1658015841136,MATH 109,A02,083214,Ganzberger; Geoffrey Michael,4,0,34,30
1658015841136,MATH 109,A03,093478,Ganzberger; Geoffrey Michael,2,0,34,32
1658015841136,MATH 109,B01,083215,Ganzberger; Geoffrey Michael,3,0,32,29
1658015841136,MATH 109,B02,083216,Ganzberger; Geoffrey Michael,3,0,32,29
1658015841136,MATH 109,B03,093479,Ganzberger; Geoffrey Michael,8,0,32,24
1658015847168,MATH 142A,A01,083219,Chow; Bennett,7,0,32,25
1658015847168,MATH 142A,A02,083220,Chow; Bennett,10,0,32,22
1658015847168,MATH 142A,A03,093480,Chow; Bennett,9,0,32,23
1658015847168,MATH 142A,B03,093481,Chow; Bennett,8,0,32,24
1658015847168,MATH 142A,B04,093558,Chow; Bennett,14,0,32,18
1658015847168,MATH 142A,B05,093559,Chow; Bennett,7,0,32,25
1658015853197,MATH 193A,A01,083224,Rotar; Vladimir,9,0,34,25
1658015853197,MATH 193A,A02,083225,Rotar; Vladimir,11,0,34,23
1658015853197,MATH 193A,A03,083781,Rotar; Vladimir,5,0,34,29
1658015853197,MATH 193A,A04,083782,Rotar; Vladimir,12,0,34,22
1658015853197,MATH 193A,A05,093482,Rotar; Vladimir,11,0,34,23
1658015859224,MATH 197,001,091859,McAuley; Julian John,9999,0,9999,0
1658015859224,MATH 197,002,095566,Kedlaya; Kiran S.,9997,0,9999,2
1658015859224,MATH 197,003,095567,Xiao; Ming,9999,0,9999,0
1658015859224,MATH 197,004,095571,Perols; Johan Lars,9998,0,9999,1
1658015866287,COGS 9,A01,083615,Shannon; Kyle Michael,11,0,75,64
1658015872327,COGS 11,A01,083617,Boyle; Mary E. T.,23,0,48,25
1658015878354,COGS 13,A01,083071,Bastos; Amalia Pinkusfeld,12,0,71,59
1658015884377,COGS 14A,A01,092681,Semenuks; Arturs,5,1,100,95
1658015890401,COGS 14B,A01,083073,Cheng; Tzu-Han,7,0,63,56
1658015896425,COGS 17,A01,092677,Semenuks; Arturs,7,0,81,74
1658015902449,COGS 100,A01,083619,Allen; Michael Gordon,17,0,70,53
1658015908472,COGS 101A,A01,083621,Davis; Joshua Daniel,9,0,68,59
1658015914495,COGS 101B,A01,091572,Allen; Michael Gordon,14,0,65,51
1658015920523,COGS 101C,A01,083625,Delgado; Tania,17,0,35,18
1658015926546,COGS 107A,A01,083627,Boyle; Mary E. T.,14,0,60,46
1658015932572,COGS 118A,A01,083075,Gupta; Anjum,21,0,76,55
1658015938604,CSE 3,A50,083646,Miranda; Gregory Joseph,24,0,50,26
1658015944628,CSE 8A,A50,083650,Miranda; Gregory Joseph,17,1,56,39
1658015950649,CSE 11,A01,083080,Cao; Yingjun,7,15,40,33
1658015956670,CSE 12,A01,083652,Krause-Levy; Sophia Louisa,30,1,120,90
1658015962692,CSE 15L,A01,083654,Morris; Justin Loren,9,0,50,41
1658015962692,CSE 15L,A02,083655,Morris; Justin Loren,11,0,50,39
1658015968714,CSE 20,A01,083657,Tran; Khoa Dang,39,0,80,41
1658015974735,CSE 21,A01,095574,Bach; Quang Tran,23,0,48,25
1658015980758,CSE 30,A01,083084,Eldon; John,8,0,80,72
1658015980758,CSE 30,B01,095061,Bhaskar; Nishant,9,0,50,41
1658015986784,CSE 100,A01,083659,Cao; Yingjun,5,4,70,65
1658015992811,CSE 134B,A01,083661,Powell; Thomas Allan,25,0,100,75
1658015998905,CSE 140,A01,083663,Gungor; Onat,17,0,85,68
1658016004928,CSE 140L,A01,083088,Eldon; John,23,0,100,77
1658016010950,CSE 175,A01,083665,Kumar; Rakesh,3,0,25,22
1658016016971,CSE 190,A00,092507,Dubnov; Shlomo,8,0,20,12
1658016022994,ECE 45,A01,083139,Congero; Spencer William,7,0,75,68
1658016029019,ECE 65,A50,083695,Saad; Andrew S,12,0,30,18
1658016029019,ECE 65,A51,095125,Saad; Andrew S,24,0,26,2
1658016035051,ECE 109,A01,091882,Touri; Behrouz,21,0,70,49
1658016041074,ECE 180,A00,083140,Abi Samra; Nicholas Camill,1,0,30,29
1658016041074,ECE 180,B00,083141,Abi Samra; Nicholas Camill,0,0,30,30
1658016047100,MATH 10A,A01,083735,Patchell; Gregory David,2,0,30,28
1658016047100,MATH 10A,A02,083736,Patchell; Gregory David,20,0,30,10
1658016047100,MATH 10A,A03,083737,Patchell; Gregory David,16,0,30,14
1658016053128,MATH 10B,A01,083207,Lim; Seonhee,9,0,34,25
1658016053128,MATH 10B,A02,083208,Lim; Seonhee,10,0,35,25
1658016053128,MATH 10B,A03,093472,Lim; Seonhee,7,0,34,27
1658016053128,MATH 10B,B01,083739,Sinha; Shubham,14,0,30,16
1658016059150,MATH 18,A01,083743,Cinel; Cameron Alexander,9,0,30,21
1658016059150,MATH 18,A02,083744,Cinel; Cameron Alexander,18,0,30,12
1658016059150,MATH 18,A03,083745,Cinel; Cameron Alexander,10,0,30,20
1658016059150,MATH 18,B01,083748,Rideout; David Porter,5,0,37,32
1658016059150,MATH 18,B02,083749,Rideout; David Porter,5,0,36,31
1658016059150,MATH 18,B03,083750,Rideout; David Porter,3,0,37,34
1658016059150,MATH 18,B04,083751,Rideout; David Porter,7,0,36,29
1658016059150,MATH 18,B05,093473,Rideout; David Porter,7,0,36,29
1658016059150,MATH 18,B06,093474,Rideout; David Porter,6,0,36,30
1658016065177,MATH 20A,A01,083754,Zheng; Zequn,14,0,40,26
1658016071205,MATH 20B,A01,083756,Briones; Jor-el Thomas Caparas,4,0,36,32
1658016071205,MATH 20B,A02,083757,Briones; Jor-el Thomas Caparas,1,0,36,35
1658016071205,MATH 20B,A03,093475,Briones; Jor-el Thomas Caparas,3,0,36,33
1658016077233,MATH 20C,A01,083760,Briones; Jor-el Thomas Caparas,1,0,35,34
1658016077233,MATH 20C,A02,083761,Briones; Jor-el Thomas Caparas,8,0,35,27
1658016077233,MATH 20C,A03,093476,Briones; Jor-el Thomas Caparas,0,1,36,36
1658016077233,MATH 20C,B01,083762,Bach; Quang Tran,1,0,30,29
1658016083257,MATH 20D,A01,083765,Tran; Brian Kha,5,0,30,25
1658016083257,MATH 20D,A02,083766,Tran; Brian Kha,5,0,30,25
1658016083257,MATH 20D,A03,083767,Tran; Brian Kha,6,0,30,24
1658016089285,MATH 20E,A01,083771,Ganguly; Soumya,12,0,32,20
1658016089285,MATH 20E,A02,083772,Ganguly; Soumya,7,0,32,25
1658016089285,MATH 20E,B01,083773,Ciotti; Benjamin,20,0,35,15
1658016089285,MATH 20E,B02,083774,Ciotti; Benjamin,18,0,35,17
1658016095314,MATH 103A,A01,083777,Greenfeld; Be'Eri,6,0,36,30
1658016095314,MATH 103A,A02,083778,Greenfeld; Be'Eri,5,0,36,31
1658016095314,MATH 103A,A03,093561,Greenfeld; Be'Eri,7,0,36,29
1658016095314,MATH 103A,B01,083779,Greenfeld; Be'Eri,8,0,36,28
1658016095314,MATH 103A,B02,083780,Greenfeld; Be'Eri,4,0,36,32
1658016095314,MATH 103A,B03,093562,Greenfeld; Be'Eri,3,0,36,33
1658016101338,MATH 105,A01,085443,Carter; Anne Toulson,15,0,35,20
1658016101338,MATH 105,A02,093477,Carter; Anne Toulson,20,0,35,15
1658016107360,MATH 109,A01,083213,Ganzberger; Geoffrey Michael,3,0,34,31
1658016107360,MATH 109,A02,083214,Ganzberger; Geoffrey Michael,4,0,34,30
1658016107360,MATH 109,A03,093478,Ganzberger; Geoffrey Michael,2,0,34,32
1658016107360,MATH 109,B01,083215,Ganzberger; Geoffrey Michael,3,0,32,29
1658016107360,MATH 109,B02,083216,Ganzberger; Geoffrey Michael,3,0,32,29
1658016107360,MATH 109,B03,093479,Ganzberger; Geoffrey Michael,8,0,32,24
1658016113389,MATH 142A,A01,083219,Chow; Bennett,7,0,32,25
1658016113389,MATH 142A,A02,083220,Chow; Bennett,10,0,32,22
1658016113389,MATH 142A,A03,093480,Chow; Bennett,9,0,32,23
1658016113389,MATH 142A,B03,093481,Chow; Bennett,8,0,32,24
1658016113389,MATH 142A,B04,093558,Chow; Bennett,14,0,32,18
1658016113389,MATH 142A,B05,093559,Chow; Bennett,7,0,32,25
1658016119418,MATH 193A,A01,083224,Rotar; Vladimir,9,0,34,25
1658016119418,MATH 193A,A02,083225,Rotar; Vladimir,11,0,34,23
1658016119418,MATH 193A,A03,083781,Rotar; Vladimir,5,0,34,29
1658016119418,MATH 193A,A04,083782,Rotar; Vladimir,12,0,34,22
1658016119418,MATH 193A,A05,093482,Rotar; Vladimir,11,0,34,23
1658016125444,MATH 197,001,091859,McAuley; Julian John,9999,0,9999,0
1658016125444,MATH 197,002,095566,Kedlaya; Kiran S.,9997,0,9999,2
1658016125444,MATH 197,003,095567,Xiao; Ming,9999,0,9999,0
1658016125444,MATH 197,004,095571,Perols; Johan Lars,9998,0,9999,1
1658016132499,COGS 9,A01,083615,Shannon; Kyle Michael,11,0,75,64
1658016138527,COGS 11,A01,083617,Boyle; Mary E. T.,23,0,48,25
1658016144551,COGS 13,A01,083071,Bastos; Amalia Pinkusfeld,12,0,71,59
1658016150576,COGS 14A,A01,092681,Semenuks; Arturs,5,1,100,95
1658016156599,COGS 14B,A01,083073,Cheng; Tzu-Han,7,0,63,56
1658016162625,COGS 17,A01,092677,Semenuks; Arturs,7,0,81,74
1658016168654,COGS 100,A01,083619,Allen; Michael Gordon,17,0,70,53
1658016174681,COGS 101A,A01,083621,Davis; Joshua Daniel,9,0,68,59
1658016180703,COGS 101B,A01,091572,Allen; Michael Gordon,14,0,65,51
1658016186726,COGS 101C,A01,083625,Delgado; Tania,17,0,35,18
1658016192748,COGS 107A,A01,083627,Boyle; Mary E. T.,14,0,60,46
1658016198772,COGS 118A,A01,083075,Gupta; Anjum,21,0,76,55
1658016204795,CSE 3,A50,083646,Miranda; Gregory Joseph,24,0,50,26
1658016210819,CSE 8A,A50,083650,Miranda; Gregory Joseph,17,1,56,39
1658016216841,CSE 11,A01,083080,Cao; Yingjun,7,15,40,33
1658016222866,CSE 12,A01,083652,Krause-Levy; Sophia Louisa,30,1,120,90
1658016228894,CSE 15L,A01,083654,Morris; Justin Loren,9,0,50,41
1658016228894,CSE 15L,A02,083655,Morris; Justin Loren,11,0,50,39
1658016234917,CSE 20,A01,083657,Tran; Khoa Dang,39,0,80,41
1658016240942,CSE 21,A01,095574,Bach; Quang Tran,23,0,48,25
1658016246968,CSE 30,A01,083084,Eldon; John,8,0,80,72
1658016246968,CSE 30,B01,095061,Bhaskar; Nishant,9,0,50,41
1658016252996,CSE 100,A01,083659,Cao; Yingjun,5,4,70,65
1658016259032,CSE 134B,A01,083661,Powell; Thomas Allan,25,0,100,75
1658016265060,CSE 140,A01,083663,Gungor; Onat,17,0,85,68
1658016271091,CSE 140L,A01,083088,Eldon; John,23,0,100,77
1658016277113,CSE 175,A01,083665,Kumar; Rakesh,3,0,25,22
1658016283135,CSE 190,A00,092507,Dubnov; Shlomo,8,0,20,12
1658016289160,ECE 45,A01,083139,Congero; Spencer William,7,0,75,68
1658016295184,ECE 65,A50,083695,Saad; Andrew S,12,0,30,18
1658016295184,ECE 65,A51,095125,Saad; Andrew S,24,0,26,2
1658016301206,ECE 109,A01,091882,Touri; Behrouz,21,0,70,49
1658016307237,ECE 180,A00,083140,Abi Samra; Nicholas Camill,1,0,30,29
1658016307237,ECE 180,B00,083141,Abi Samra; Nicholas Camill,0,0,30,30
1658016313259,MATH 10A,A01,083735,Patchell; Gregory David,2,0,30,28
1658016313259,MATH 10A,A02,083736,Patchell; Gregory David,20,0,30,10
1658016313259,MATH 10A,A03,083737,Patchell; Gregory David,16,0,30,14
1658016319287,MATH 10B,A01,083207,Lim; Seonhee,9,0,34,25
1658016319287,MATH 10B,A02,083208,Lim; Seonhee,10,0,35,25
1658016319287,MATH 10B,A03,093472,Lim; Seonhee,7,0,34,27
1658016319287,MATH 10B,B01,083739,Sinha; Shubham,14,0,30,16
1658016325318,MATH 18,A01,083743,Cinel; Cameron Alexander,9,0,30,21
1658016325318,MATH 18,A02,083744,Cinel; Cameron Alexander,18,0,30,12
1658016325318,MATH 18,A03,083745,Cinel; Cameron Alexander,10,0,30,20
1658016325318,MATH 18,B01,083748,Rideout; David Porter,5,0,37,32
1658016325318,MATH 18,B02,083749,Rideout; David Porter,5,0,36,31
1658016325318,MATH 18,B03,083750,Rideout; David Porter,3,0,37,34
1658016325318,MATH 18,B04,083751,Rideout; David Porter,7,0,36,29
1658016325318,MATH 18,B05,093473,Rideout; David Porter,7,0,36,29
1658016325318,MATH 18,B06,093474,Rideout; David Porter,6,0,36,30
1658016331346,MATH 20A,A01,083754,Zheng; Zequn,14,0,40,26
1658016337370,MATH 20B,A01,083756,Briones; Jor-el Thomas Caparas,4,0,36,32
1658016337370,MATH 20B,A02,083757,Briones; Jor-el Thomas Caparas,1,0,36,35
1658016337370,MATH 20B,A03,093475,Briones; Jor-el Thomas Caparas,3,0,36,33
1658016343398,MATH 20C,A01,083760,Briones; Jor-el Thomas Caparas,1,0,35,34
1658016343398,MATH 20C,A02,083761,Briones; Jor-el Thomas Caparas,8,0,35,27
1658016343398,MATH 20C,A03,093476,Briones; Jor-el Thomas Caparas,0,1,36,36
1658016343398,MATH 20C,B01,083762,Bach; Quang Tran,1,0,30,29
1658016349422,MATH 20D,A01,083765,Tran; Brian Kha,5,0,30,25
1658016349422,MATH 20D,A02,083766,Tran; Brian Kha,5,0,30,25
1658016349422,MATH 20D,A03,083767,Tran; Brian Kha,6,0,30,24
1658016355445,MATH 20E,A01,083771,Ganguly; Soumya,12,0,32,20
1658016355445,MATH 20E,A02,083772,Ganguly; Soumya,7,0,32,25
1658016355445,MATH 20E,B01,083773,Ciotti; Benjamin,20,0,35,15
1658016355445,MATH 20E,B02,083774,Ciotti; Benjamin,18,0,35,17
1658016361470,MATH 103A,A01,083777,Greenfeld; Be'Eri,6,0,36,30
1658016361470,MATH 103A,A02,083778,Greenfeld; Be'Eri,5,0,36,31
1658016361470,MATH 103A,A03,093561,Greenfeld; Be'Eri,7,0,36,29
1658016361470,MATH 103A,B01,083779,Greenfeld; Be'Eri,8,0,36,28
1658016361470,MATH 103A,B02,083780,Greenfeld; Be'Eri,4,0,36,32
1658016361470,MATH 103A,B03,093562,Greenfeld; Be'Eri,3,0,36,33
1658016367496,MATH 105,A01,085443,Carter; Anne Toulson,15,0,35,20
1658016367496,MATH 105,A02,093477,Carter; Anne Toulson,20,0,35,15
1658016373519,MATH 109,A01,083213,Ganzberger; Geoffrey Michael,3,0,34,31
1658016373519,MATH 109,A02,083214,Ganzberger; Geoffrey Michael,4,0,34,30
1658016373519,MATH 109,A03,093478,Ganzberger; Geoffrey Michael,2,0,34,32
1658016373519,MATH 109,B01,083215,Ganzberger; Geoffrey Michael,3,0,32,29
1658016373519,MATH 109,B02,083216,Ganzberger; Geoffrey Michael,3,0,32,29
1658016373519,MATH 109,B03,093479,Ganzberger; Geoffrey Michael,8,0,32,24
1658016379548,MATH 142A,A01,083219,Chow; Bennett,7,0,32,25
1658016379548,MATH 142A,A02,083220,Chow; Bennett,10,0,32,22
1658016379548,MATH 142A,A03,093480,Chow; Bennett,9,0,32,23
1658016379548,MATH 142A,B03,093481,Chow; Bennett,8,0,32,24
1658016379548,MATH 142A,B04,093558,Chow; Bennett,14,0,32,18
1658016379548,MATH 142A,B05,093559,Chow; Bennett,7,0,32,25
1658016385571,MATH 193A,A01,083224,Rotar; Vladimir,9,0,34,25
1658016385571,MATH 193A,A02,083225,Rotar; Vladimir,11,0,34,23
1658016385571,MATH 193A,A03,083781,Rotar; Vladimir,5,0,34,29
1658016385571,MATH 193A,A04,083782,Rotar; Vladimir,12,0,34,22
1658016385571,MATH 193A,A05,093482,Rotar; Vladimir,11,0,34,23
1658016391596,MATH 197,001,091859,McAuley; Julian John,9999,0,9999,0
1658016391596,MATH 197,002,095566,Kedlaya; Kiran S.,9997,0,9999,2
1658016391596,MATH 197,003,095567,Xiao; Ming,9999,0,9999,0
1658016391596,MATH 197,004,095571,Perols; Johan Lars,9998,0,9999,1
1658016398664,COGS 9,A01,083615,Shannon; Kyle Michael,11,0,75,64
1658016404689,COGS 11,A01,083617,Boyle; Mary E. T.,23,0,48,25
1658016410710,COGS 13,A01,083071,Bastos; Amalia Pinkusfeld,12,0,71,59
1658016416739,COGS 14A,A01,092681,Semenuks; Arturs,5,1,100,95
1658016422766,COGS 14B,A01,083073,Cheng; Tzu-Han,7,0,63,56
1658016428789,COGS 17,A01,092677,Semenuks; Arturs,7,0,81,74
1658016434814,COGS 100,A01,083619,Allen; Michael Gordon,17,0,70,53
1658016440842,COGS 101A,A01,083621,Davis; Joshua Daniel,9,0,68,59
1658016446864,COGS 101B,A01,091572,Allen; Michael Gordon,14,0,65,51
1658016452887,COGS 101C,A01,083625,Delgado; Tania,17,0,35,18
1658016458909,COGS 107A,A01,083627,Boyle; Mary E. T.,14,0,60,46
1658016464935,COGS 118A,A01,083075,Gupta; Anjum,21,0,76,55
1658016470959,CSE 3,A50,083646,Miranda; Gregory Joseph,24,0,50,26
1658016476985,CSE 8A,A50,083650,Miranda; Gregory Joseph,17,1,56,39
1658016483007,CSE 11,A01,083080,Cao; Yingjun,7,15,40,33
1658016489030,CSE 12,A01,083652,Krause-Levy; Sophia Louisa,30,1,120,90
1658016495057,CSE 15L,A01,083654,Morris; Justin Loren,9,0,50,41
1658016495057,CSE 15L,A02,083655,Morris; Justin Loren,11,0,50,39
1658016501081,CSE 20,A01,083657,Tran; Khoa Dang,39,0,80,41
1658016507103,CSE 21,A01,095574,Bach; Quang Tran,23,0,48,25
1658016513131,CSE 30,A01,083084,Eldon; John,8,0,80,72
1658016513131,CSE 30,B01,095061,Bhaskar; Nishant,9,0,50,41
1658016519153,CSE 100,A01,083659,Cao; Yingjun,5,4,70,65
1658016525182,CSE 134B,A01,083661,Powell; Thomas Allan,25,0,100,75
1658016531206,CSE 140,A01,083663,Gungor; Onat,17,0,85,68
1658016537229,CSE 140L,A01,083088,Eldon; John,23,0,100,77
1658016543251,CSE 175,A01,083665,Kumar; Rakesh,3,0,25,22
1658016549280,CSE 190,A00,092507,Dubnov; Shlomo,8,0,20,12
1658016555307,ECE 45,A01,083139,Congero; Spencer William,7,0,75,68
1658016561335,ECE 65,A50,083695,Saad; Andrew S,12,0,30,18
1658016561335,ECE 65,A51,095125,Saad; Andrew S,24,0,26,2
1658016567362,ECE 109,A01,091882,Touri; Behrouz,21,0,70,49
1658016573389,ECE 180,A00,083140,Abi Samra; Nicholas Camill,1,0,30,29
1658016573389,ECE 180,B00,083141,Abi Samra; Nicholas Camill,0,0,30,30
1658016579417,MATH 10A,A01,083735,Patchell; Gregory David,2,0,30,28
1658016579417,MATH 10A,A02,083736,Patchell; Gregory David,20,0,30,10
1658016579417,MATH 10A,A03,083737,Patchell; Gregory David,16,0,30,14
1658016585442,MATH 10B,A01,083207,Lim; Seonhee,9,0,34,25
1658016585442,MATH 10B,A02,083208,Lim; Seonhee,10,0,35,25
1658016585442,MATH 10B,A03,093472,Lim; Seonhee,7,0,34,27
1658016585442,MATH 10B,B01,083739,Sinha; Shubham,14,0,30,16
1658016591477,MATH 18,A01,083743,Cinel; Cameron Alexander,9,0,30,21
1658016591477,MATH 18,A02,083744,Cinel; Cameron Alexander,18,0,30,12
1658016591477,MATH 18,A03,083745,Cinel; Cameron Alexander,10,0,30,20
1658016591477,MATH 18,B01,083748,Rideout; David Porter,5,0,37,32
1658016591477,MATH 18,B02,083749,Rideout; David Porter,5,0,36,31
1658016591477,MATH 18,B03,083750,Rideout; David Porter,3,0,37,34
1658016591477,MATH 18,B04,083751,Rideout; David Porter,7,0,36,29
1658016591477,MATH 18,B05,093473,Rideout; David Porter,7,0,36,29
1658016591477,MATH 18,B06,093474,Rideout; David Porter,6,0,36,30
1658016597587,MATH 20A,A01,083754,Zheng; Zequn,14,0,40,26
1658016603609,MATH 20B,A01,083756,Briones; Jor-el Thomas Caparas,4,0,36,32
1658016603609,MATH 20B,A02,083757,Briones; Jor-el Thomas Caparas,1,0,36,35
1658016603609,MATH 20B,A03,093475,Briones; Jor-el Thomas Caparas,3,0,36,33
1658016609634,MATH 20C,A01,083760,Briones; Jor-el Thomas Caparas,1,0,35,34
1658016609634,MATH 20C,A02,083761,Briones; Jor-el Thomas Caparas,8,0,35,27
1658016609634,MATH 20C,A03,093476,Briones; Jor-el Thomas Caparas,0,1,36,36
1658016609634,MATH 20C,B01,083762,Bach; Quang Tran,1,0,30,29
1658016615658,MATH 20D,A01,083765,Tran; Brian Kha,5,0,30,25
1658016615658,MATH 20D,A02,083766,Tran; Brian Kha,5,0,30,25
1658016615658,MATH 20D,A03,083767,Tran; Brian Kha,6,0,30,24
1658016621680,MATH 20E,A01,083771,Ganguly; Soumya,12,0,32,20
1658016621680,MATH 20E,A02,083772,Ganguly; Soumya,7,0,32,25
1658016621680,MATH 20E,B01,083773,Ciotti; Benjamin,20,0,35,15
1658016621680,MATH 20E,B02,083774,Ciotti; Benjamin,18,0,35,17
1658016627705,MATH 103A,A01,083777,Greenfeld; Be'Eri,6,0,36,30
1658016627705,MATH 103A,A02,083778,Greenfeld; Be'Eri,5,0,36,31
1658016627705,MATH 103A,A03,093561,Greenfeld; Be'Eri,7,0,36,29
1658016627705,MATH 103A,B01,083779,Greenfeld; Be'Eri,8,0,36,28
1658016627705,MATH 103A,B02,083780,Greenfeld; Be'Eri,4,0,36,32
1658016627705,MATH 103A,B03,093562,Greenfeld; Be'Eri,3,0,36,33
1658016633727,MATH 105,A01,085443,Carter; Anne Toulson,15,0,35,20
1658016633727,MATH 105,A02,093477,Carter; Anne Toulson,20,0,35,15
1658016639756,MATH 109,A01,083213,Ganzberger; Geoffrey Michael,3,0,34,31
1658016639756,MATH 109,A02,083214,Ganzberger; Geoffrey Michael,4,0,34,30
1658016639756,MATH 109,A03,093478,Ganzberger; Geoffrey Michael,2,0,34,32
1658016639756,MATH 109,B01,083215,Ganzberger; Geoffrey Michael,3,0,32,29
1658016639756,MATH 109,B02,083216,Ganzberger; Geoffrey Michael,3,0,32,29
1658016639756,MATH 109,B03,093479,Ganzberger; Geoffrey Michael,8,0,32,24
1658016645779,MATH 142A,A01,083219,Chow; Bennett,7,0,32,25
1658016645779,MATH 142A,A02,083220,Chow; Bennett,10,0,32,22
1658016645779,MATH 142A,A03,093480,Chow; Bennett,9,0,32,23
1658016645779,MATH 142A,B03,093481,Chow; Bennett,8,0,32,24
1658016645779,MATH 142A,B04,093558,Chow; Bennett,14,0,32,18
1658016645779,MATH 142A,B05,093559,Chow; Bennett,7,0,32,25
1658016651802,MATH 193A,A01,083224,Rotar; Vladimir,9,0,34,25
1658016651802,MATH 193A,A02,083225,Rotar; Vladimir,11,0,34,23
1658016651802,MATH 193A,A03,083781,Rotar; Vladimir,5,0,34,29
1658016651802,MATH 193A,A04,083782,Rotar; Vladimir,12,0,34,22
1658016651802,MATH 193A,A05,093482,Rotar; Vladimir,11,0,34,23
1658016657824,MATH 197,001,091859,McAuley; Julian John,9999,0,9999,0
1658016657824,MATH 197,002,095566,Kedlaya; Kiran S.,9997,0,9999,2
1658016657824,MATH 197,003,095567,Xiao; Ming,9999,0,9999,0
1658016657824,MATH 197,004,095571,Perols; Johan Lars,9998,0,9999,1
1658016664874,COGS 9,A01,083615,Shannon; Kyle Michael,11,0,75,64
1658016670897,COGS 11,A01,083617,Boyle; Mary E. T.,23,0,48,25
1658016676924,COGS 13,A01,083071,Bastos; Amalia Pinkusfeld,12,0,71,59
1658016682950,COGS 14A,A01,092681,Semenuks; Arturs,5,1,100,95
1658016688975,COGS 14B,A01,083073,Cheng; Tzu-Han,7,0,63,56
1658016695003,COGS 17,A01,092677,Semenuks; Arturs,7,0,81,74
1658016701029,COGS 100,A01,083619,Allen; Michael Gordon,17,0,70,53
1658016707056,COGS 101A,A01,083621,Davis; Joshua Daniel,9,0,68,59
1658016713082,COGS 101B,A01,091572,Allen; Michael Gordon,14,0,65,51
1658016719104,COGS 101C,A01,083625,Delgado; Tania,17,0,35,18
1658016725132,COGS 107A,A01,083627,Boyle; Mary E. T.,14,0,60,46
1658016731158,COGS 118A,A01,083075,Gupta; Anjum,21,0,76,55
1658016737182,CSE 3,A50,083646,Miranda; Gregory Joseph,24,0,50,26
1658016743205,CSE 8A,A50,083650,Miranda; Gregory Joseph,17,1,56,39
1658016749229,CSE 11,A01,083080,Cao; Yingjun,7,15,40,33
1658016755253,CSE 12,A01,083652,Krause-Levy; Sophia Louisa,30,1,120,90
1658016761277,CSE 15L,A01,083654,Morris; Justin Loren,9,0,50,41
1658016761277,CSE 15L,A02,083655,Morris; Justin Loren,11,0,50,39
1658016767300,CSE 20,A01,083657,Tran; Khoa Dang,39,0,80,41
1658016773325,CSE 21,A01,095574,Bach; Quang Tran,23,0,48,25
1658016779349,CSE 30,A01,083084,Eldon; John,8,0,80,72
1658016779349,CSE 30,B01,095061,Bhaskar; Nishant,9,0,50,41
1658016785373,CSE 100,A01,083659,Cao; Yingjun,5,4,70,65
1658016791404,CSE 134B,A01,083661,Powell; Thomas Allan,25,0,100,75
1658016797430,CSE 140,A01,083663,Gungor; Onat,17,0,85,68
1658016803458,CSE 140L,A01,083088,Eldon; John,23,0,100,77
1658016809484,CSE 175,A01,083665,Kumar; Rakesh,3,0,25,22
1658016815509,CSE 190,A00,092507,Dubnov; Shlomo,8,0,20,12
1658016821533,ECE 45,A01,083139,Congero; Spencer William,7,0,75,68
1658016827559,ECE 65,A50,083695,Saad; Andrew S,12,0,30,18
1658016827559,ECE 65,A51,095125,Saad; Andrew S,24,0,26,2
1658016833587,ECE 109,A01,091882,Touri; Behrouz,21,0,70,49
1658016839614,ECE 180,A00,083140,Abi Samra; Nicholas Camill,1,0,30,29
1658016839614,ECE 180,B00,083141,Abi Samra; Nicholas Camill,0,0,30,30
1658016845639,MATH 10A,A01,083735,Patchell; Gregory David,2,0,30,28
1658016845639,MATH 10A,A02,083736,Patchell; Gregory David,20,0,30,10
1658016845639,MATH 10A,A03,083737,Patchell; Gregory David,16,0,30,14
1658016851669,MATH 10B,A01,083207,Lim; Seonhee,9,0,34,25
1658016851669,MATH 10B,A02,083208,Lim; Seonhee,10,0,35,25
1658016851669,MATH 10B,A03,093472,Lim; Seonhee,7,0,34,27
1658016851669,MATH 10B,B01,083739,Sinha; Shubham,14,0,30,16
1658016857695,MATH 18,A01,083743,Cinel; Cameron Alexander,9,0,30,21
1658016857695,MATH 18,A02,083744,Cinel; Cameron Alexander,18,0,30,12
1658016857695,MATH 18,A03,083745,Cinel; Cameron Alexander,10,0,30,20
1658016857695,MATH 18,B01,083748,Rideout; David Porter,5,0,37,32
1658016857695,MATH 18,B02,083749,Rideout; David Porter,5,0,36,31
1658016857695,MATH 18,B03,083750,Rideout; David Porter,3,0,37,34
1658016857695,MATH 18,B04,083751,Rideout; David Porter,7,0,36,29
1658016857695,MATH 18,B05,093473,Rideout; David Porter,7,0,36,29
1658016857695,MATH 18,B06,093474,Rideout; David Porter,6,0,36,30
1658016863719,MATH 20A,A01,083754,Zheng; Zequn,14,0,40,26
1658016869742,MATH 20B,A01,083756,Briones; Jor-el Thomas Caparas,4,0,36,32
1658016869742,MATH 20B,A02,083757,Briones; Jor-el Thomas Caparas,1,0,36,35
1658016869742,MATH 20B,A03,093475,Briones; Jor-el Thomas Caparas,3,0,36,33
1658016875764,MATH 20C,A01,083760,Briones; Jor-el Thomas Caparas,1,0,35,34
1658016875764,MATH 20C,A02,083761,Briones; Jor-el Thomas Caparas,8,0,35,27
1658016875764,MATH 20C,A03,093476,Briones; Jor-el Thomas Caparas,0,1,36,36
1658016875764,MATH 20C,B01,083762,Bach; Quang Tran,1,0,30,29
1658016881789,MATH 20D,A01,083765,Tran; Brian Kha,5,0,30,25
1658016881789,MATH 20D,A02,083766,Tran; Brian Kha,5,0,30,25
1658016881789,MATH 20D,A03,083767,Tran; Brian Kha,6,0,30,24
1658016887813,MATH 20E,A01,083771,Ganguly; Soumya,12,0,32,20
1658016887813,MATH 20E,A02,083772,Ganguly; Soumya,7,0,32,25
1658016887813,MATH 20E,B01,083773,Ciotti; Benjamin,20,0,35,15
1658016887813,MATH 20E,B02,083774,Ciotti; Benjamin,18,0,35,17
1658016893836,MATH 103A,A01,083777,Greenfeld; Be'Eri,6,0,36,30
1658016893836,MATH 103A,A02,083778,Greenfeld; Be'Eri,5,0,36,31
1658016893836,MATH 103A,A03,093561,Greenfeld; Be'Eri,7,0,36,29
1658016893836,MATH 103A,B01,083779,Greenfeld; Be'Eri,8,0,36,28
1658016893836,MATH 103A,B02,083780,Greenfeld; Be'Eri,4,0,36,32
1658016893836,MATH 103A,B03,093562,Greenfeld; Be'Eri,3,0,36,33
1658016899865,MATH 105,A01,085443,Carter; Anne Toulson,15,0,35,20
1658016899865,MATH 105,A02,093477,Carter; Anne Toulson,20,0,35,15
1658016905889,MATH 109,A01,083213,Ganzberger; Geoffrey Michael,3,0,34,31
1658016905889,MATH 109,A02,083214,Ganzberger; Geoffrey Michael,4,0,34,30
1658016905889,MATH 109,A03,093478,Ganzberger; Geoffrey Michael,2,0,34,32
1658016905889,MATH 109,B01,083215,Ganzberger; Geoffrey Michael,3,0,32,29
1658016905889,MATH 109,B02,083216,Ganzberger; Geoffrey Michael,3,0,32,29
1658016905889,MATH 109,B03,093479,Ganzberger; Geoffrey Michael,8,0,32,24
1658016911917,MATH 142A,A01,083219,Chow; Bennett,7,0,32,25
1658016911917,MATH 142A,A02,083220,Chow; Bennett,10,0,32,22
1658016911917,MATH 142A,A03,093480,Chow; Bennett,9,0,32,23
1658016911917,MATH 142A,B03,093481,Chow; Bennett,8,0,32,24
1658016911917,MATH 142A,B04,093558,Chow; Bennett,14,0,32,18
1658016911917,MATH 142A,B05,093559,Chow; Bennett,7,0,32,25
1658016917941,MATH 193A,A01,083224,Rotar; Vladimir,9,0,34,25
1658016917941,MATH 193A,A02,083225,Rotar; Vladimir,11,0,34,23
1658016917941,MATH 193A,A03,083781,Rotar; Vladimir,5,0,34,29
1658016917941,MATH 193A,A04,083782,Rotar; Vladimir,12,0,34,22
1658016917941,MATH 193A,A05,093482,Rotar; Vladimir,11,0,34,23
1658016923963,MATH 197,001,091859,McAuley; Julian John,9999,0,9999,0
1658016923963,MATH 197,002,095566,Kedlaya; Kiran S.,9997,0,9999,2
1658016923963,MATH 197,003,095567,Xiao; Ming,9999,0,9999,0
1658016923963,MATH 197,004,095571,Perols; Johan Lars,9998,0,9999,1
1658016931019,COGS 9,A01,083615,Shannon; Kyle Michael,11,0,75,64
1658016937042,COGS 11,A01,083617,Boyle; Mary E. T.,23,0,48,25
1658016943067,COGS 13,A01,083071,Bastos; Amalia Pinkusfeld,12,0,71,59
1658016949088,COGS 14A,A01,092681,Semenuks; Arturs,5,1,100,95
1658016955115,COGS 14B,A01,083073,Cheng; Tzu-Han,7,0,63,56
1658016961142,COGS 17,A01,092677,Semenuks; Arturs,7,0,81,74
1658016967163,COGS 100,A01,083619,Allen; Michael Gordon,17,0,70,53
1658016973187,COGS 101A,A01,083621,Davis; Joshua Daniel,9,0,68,59
1658016979214,COGS 101B,A01,091572,Allen; Michael Gordon,14,0,65,51
1658016985242,COGS 101C,A01,083625,Delgado; Tania,17,0,35,18
1658016991269,COGS 107A,A01,083627,Boyle; Mary E. T.,14,0,60,46
1658016997295,COGS 118A,A01,083075,Gupta; Anjum,21,0,76,55
1658017003318,CSE 3,A50,083646,Miranda; Gregory Joseph,24,0,50,26
1658017009342,CSE 8A,A50,083650,Miranda; Gregory Joseph,17,1,56,39
1658017015368,CSE 11,A01,083080,Cao; Yingjun,7,15,40,33
1658017021392,CSE 12,A01,083652,Krause-Levy; Sophia Louisa,30,1,120,90
1658017027420,CSE 15L,A01,083654,Morris; Justin Loren,9,0,50,41
1658017027420,CSE 15L,A02,083655,Morris; Justin Loren,11,0,50,39
1658017033441,CSE 20,A01,083657,Tran; Khoa Dang,39,0,80,41
1658017039473,CSE 21,A01,095574,Bach; Quang Tran,23,0,48,25
1658017045496,CSE 30,A01,083084,Eldon; John,8,0,80,72
1658017045496,CSE 30,B01,095061,Bhaskar; Nishant,9,0,50,41
1658017051534,CSE 100,A01,083659,Cao; Yingjun,5,4,70,65
1658017057561,CSE 134B,A01,083661,Powell; Thomas Allan,25,0,100,75
1658017063588,CSE 140,A01,083663,Gungor; Onat,17,0,85,68
1658017069612,CSE 140L,A01,083088,Eldon; John,23,0,100,77
1658017075634,CSE 175,A01,083665,Kumar; Rakesh,3,0,25,22
1658017081658,CSE 190,A00,092507,Dubnov; Shlomo,8,0,20,12
1658017087679,ECE 45,A01,083139,Congero; Spencer William,7,0,75,68
1658017093703,ECE 65,A50,083695,Saad; Andrew S,12,0,30,18
1658017093703,ECE 65,A51,095125,Saad; Andrew S,24,0,26,2
1658017099724,ECE 109,A01,091882,Touri; Behrouz,21,0,70,49
1658017105751,ECE 180,A00,083140,Abi Samra; Nicholas Camill,1,0,30,29
1658017105751,ECE 180,B00,083141,Abi Samra; Nicholas Camill,0,0,30,30
1658017111773,MATH 10A,A01,083735,Patchell; Gregory David,2,0,30,28
1658017111773,MATH 10A,A02,083736,Patchell; Gregory David,20,0,30,10
1658017111773,MATH 10A,A03,083737,Patchell; Gregory David,16,0,30,14
1658017117802,MATH 10B,A01,083207,Lim; Seonhee,9,0,34,25
1658017117802,MATH 10B,A02,083208,Lim; Seonhee,10,0,35,25
1658017117802,MATH 10B,A03,093472,Lim; Seonhee,7,0,34,27
1658017117802,MATH 10B,B01,083739,Sinha; Shubham,14,0,30,16
1658017123825,MATH 18,A01,083743,Cinel; Cameron Alexander,9,0,30,21
1658017123825,MATH 18,A02,083744,Cinel; Cameron Alexander,18,0,30,12
1658017123825,MATH 18,A03,083745,Cinel; Cameron Alexander,10,0,30,20
1658017123825,MATH 18,B01,083748,Rideout; David Porter,5,0,37,32
1658017123825,MATH 18,B02,083749,Rideout; David Porter,5,0,36,31
1658017123825,MATH 18,B03,083750,Rideout; David Porter,3,0,37,34
1658017123825,MATH 18,B04,083751,Rideout; David Porter,7,0,36,29
1658017123825,MATH 18,B05,093473,Rideout; David Porter,7,0,36,29
1658017123825,MATH 18,B06,093474,Rideout; David Porter,6,0,36,30
1658017129849,MATH 20A,A01,083754,Zheng; Zequn,14,0,40,26
1658017135877,MATH 20B,A01,083756,Briones; Jor-el Thomas Caparas,4,0,36,32
1658017135877,MATH 20B,A02,083757,Briones; Jor-el Thomas Caparas,1,0,36,35
1658017135877,MATH 20B,A03,093475,Briones; Jor-el Thomas Caparas,3,0,36,33
1658017141901,MATH 20C,A01,083760,Briones; Jor-el Thomas Caparas,1,0,35,34
1658017141901,MATH 20C,A02,083761,Briones; Jor-el Thomas Caparas,8,0,35,27
1658017141901,MATH 20C,A03,093476,Briones; Jor-el Thomas Caparas,0,1,36,36
1658017141901,MATH 20C,B01,083762,Bach; Quang Tran,1,0,30,29
1658017147929,MATH 20D,A01,083765,Tran; Brian Kha,5,0,30,25
1658017147929,MATH 20D,A02,083766,Tran; Brian Kha,5,0,30,25
1658017147929,MATH 20D,A03,083767,Tran; Brian Kha,6,0,30,24
1658017153951,MATH 20E,A01,083771,Ganguly; Soumya,12,0,32,20
1658017153951,MATH 20E,A02,083772,Ganguly; Soumya,7,0,32,25
1658017153951,MATH 20E,B01,083773,Ciotti; Benjamin,20,0,35,15
1658017153951,MATH 20E,B02,083774,Ciotti; Benjamin,18,0,35,17
1658017159976,MATH 103A,A01,083777,Greenfeld; Be'Eri,6,0,36,30
1658017159976,MATH 103A,A02,083778,Greenfeld; Be'Eri,5,0,36,31
1658017159976,MATH 103A,A03,093561,Greenfeld; Be'Eri,7,0,36,29
1658017159976,MATH 103A,B01,083779,Greenfeld; Be'Eri,8,0,36,28
1658017159976,MATH 103A,B02,083780,Greenfeld; Be'Eri,4,0,36,32
1658017159976,MATH 103A,B03,093562,Greenfeld; Be'Eri,3,0,36,33
1658017166004,MATH 105,A01,085443,Carter; Anne Toulson,15,0,35,20
1658017166004,MATH 105,A02,093477,Carter; Anne Toulson,20,0,35,15
1658017172027,MATH 109,A01,083213,Ganzberger; Geoffrey Michael,3,0,34,31
1658017172027,MATH 109,A02,083214,Ganzberger; Geoffrey Michael,4,0,34,30
1658017172027,MATH 109,A03,093478,Ganzberger; Geoffrey Michael,2,0,34,32
1658017172027,MATH 109,B01,083215,Ganzberger; Geoffrey Michael,3,0,32,29
1658017172027,MATH 109,B02,083216,Ganzberger; Geoffrey Michael,3,0,32,29
1658017172027,MATH 109,B03,093479,Ganzberger; Geoffrey Michael,8,0,32,24
1658017178050,MATH 142A,A01,083219,Chow; Bennett,7,0,32,25
1658017178050,MATH 142A,A02,083220,Chow; Bennett,10,0,32,22
1658017178050,MATH 142A,A03,093480,Chow; Bennett,9,0,32,23
1658017178050,MATH 142A,B03,093481,Chow; Bennett,8,0,32,24
1658017178050,MATH 142A,B04,093558,Chow; Bennett,14,0,32,18
1658017178050,MATH 142A,B05,093559,Chow; Bennett,7,0,32,25
1658017184072,MATH 193A,A01,083224,Rotar; Vladimir,9,0,34,25
1658017184072,MATH 193A,A02,083225,Rotar; Vladimir,11,0,34,23
1658017184072,MATH 193A,A03,083781,Rotar; Vladimir,5,0,34,29
1658017184072,MATH 193A,A04,083782,Rotar; Vladimir,12,0,34,22
1658017184072,MATH 193A,A05,093482,Rotar; Vladimir,11,0,34,23
1658017190095,MATH 197,001,091859,McAuley; Julian John,9999,0,9999,0
1658017190095,MATH 197,002,095566,Kedlaya; Kiran S.,9997,0,9999,2
1658017190095,MATH 197,003,095567,Xiao; Ming,9999,0,9999,0
1658017190095,MATH 197,004,095571,Perols; Johan Lars,9998,0,9999,1
1658017197254,COGS 9,A01,083615,Shannon; Kyle Michael,11,0,75,64
1658017203280,COGS 11,A01,083617,Boyle; Mary E. T.,23,0,48,25
1658017209304,COGS 13,A01,083071,Bastos; Amalia Pinkusfeld,12,0,71,59
1658017215329,COGS 14A,A01,092681,Semenuks; Arturs,5,1,100,95
1658017221356,COGS 14B,A01,083073,Cheng; Tzu-Han,7,0,63,56
1658017227379,COGS 17,A01,092677,Semenuks; Arturs,7,0,81,74
1658017233401,COGS 100,A01,083619,Allen; Michael Gordon,17,0,70,53
1658017239433,COGS 101A,A01,083621,Davis; Joshua Daniel,9,0,68,59
1658017245460,COGS 101B,A01,091572,Allen; Michael Gordon,14,0,65,51
1658017251483,COGS 101C,A01,083625,Delgado; Tania,17,0,35,18
1658017257505,COGS 107A,A01,083627,Boyle; Mary E. T.,14,0,60,46
1658017263532,COGS 118A,A01,083075,Gupta; Anjum,21,0,76,55
1658017269556,CSE 3,A50,083646,Miranda; Gregory Joseph,24,0,50,26
1658017275581,CSE 8A,A50,083650,Miranda; Gregory Joseph,17,1,56,39
1658017281605,CSE 11,A01,083080,Cao; Yingjun,7,15,40,33
1658017287645,CSE 12,A01,083652,Krause-Levy; Sophia Louisa,30,1,120,90
1658017293668,CSE 15L,A01,083654,Morris; Justin Loren,9,0,50,41
1658017293668,CSE 15L,A02,083655,Morris; Justin Loren,11,0,50,39
1658017299696,CSE 20,A01,083657,Tran; Khoa Dang,39,0,80,41
1658017305722,CSE 21,A01,095574,Bach; Quang Tran,23,0,48,25
1658017311749,CSE 30,A01,083084,Eldon; John,8,0,80,72
1658017311749,CSE 30,B01,095061,Bhaskar; Nishant,9,0,50,41
1658017317773,CSE 100,A01,083659,Cao; Yingjun,5,4,70,65
1658017323798,CSE 134B,A01,083661,Powell; Thomas Allan,25,0,100,75
1658017329823,CSE 140,A01,083663,Gungor; Onat,17,0,85,68
1658017335849,CSE 140L,A01,083088,Eldon; John,23,0,100,77
1658017341875,CSE 175,A01,083665,Kumar; Rakesh,3,0,25,22
1658017347900,CSE 190,A00,092507,Dubnov; Shlomo,8,0,20,12
1658017353926,ECE 45,A01,083139,Congero; Spencer William,7,0,75,68
1658017359956,ECE 65,A50,083695,Saad; Andrew S,12,0,30,18
1658017359956,ECE 65,A51,095125,Saad; Andrew S,24,0,26,2
1658017365982,ECE 109,A01,091882,Touri; Behrouz,21,0,70,49
1658017372005,ECE 180,A00,083140,Abi Samra; Nicholas Camill,1,0,30,29
1658017372005,ECE 180,B00,083141,Abi Samra; Nicholas Camill,0,0,30,30
1658017378029,MATH 10A,A01,083735,Patchell; Gregory David,2,0,30,28
1658017378029,MATH 10A,A02,083736,Patchell; Gregory David,20,0,30,10
1658017378029,MATH 10A,A03,083737,Patchell; Gregory David,16,0,30,14
1658017384054,MATH 10B,A01,083207,Lim; Seonhee,9,0,34,25
1658017384054,MATH 10B,A02,083208,Lim; Seonhee,10,0,35,25
1658017384054,MATH 10B,A03,093472,Lim; Seonhee,7,0,34,27
1658017384054,MATH 10B,B01,083739,Sinha; Shubham,14,0,30,16
1658017390078,MATH 18,A01,083743,Cinel; Cameron Alexander,9,0,30,21
1658017390078,MATH 18,A02,083744,Cinel; Cameron Alexander,18,0,30,12
1658017390078,MATH 18,A03,083745,Cinel; Cameron Alexander,10,0,30,20
1658017390078,MATH 18,B01,083748,Rideout; David Porter,5,0,37,32
1658017390078,MATH 18,B02,083749,Rideout; David Porter,5,0,36,31
1658017390078,MATH 18,B03,083750,Rideout; David Porter,3,0,37,34
1658017390078,MATH 18,B04,083751,Rideout; David Porter,7,0,36,29
1658017390078,MATH 18,B05,093473,Rideout; David Porter,7,0,36,29
1658017390078,MATH 18,B06,093474,Rideout; David Porter,6,0,36,30
1658017396100,MATH 20A,A01,083754,Zheng; Zequn,14,0,40,26
1658017402126,MATH 20B,A01,083756,Briones; Jor-el Thomas Caparas,4,0,36,32
1658017402126,MATH 20B,A02,083757,Briones; Jor-el Thomas Caparas,1,0,36,35
1658017402126,MATH 20B,A03,093475,Briones; Jor-el Thomas Caparas,3,0,36,33
1658017408151,MATH 20C,A01,083760,Briones; Jor-el Thomas Caparas,1,0,35,34
1658017408151,MATH 20C,A02,083761,Briones; Jor-el Thomas Caparas,8,0,35,27
1658017408151,MATH 20C,A03,093476,Briones; Jor-el Thomas Caparas,0,1,36,36
1658017408151,MATH 20C,B01,083762,Bach; Quang Tran,1,0,30,29
1658017414174,MATH 20D,A01,083765,Tran; Brian Kha,5,0,30,25
1658017414174,MATH 20D,A02,083766,Tran; Brian Kha,5,0,30,25
1658017414174,MATH 20D,A03,083767,Tran; Brian Kha,6,0,30,24
1658017420196,MATH 20E,A01,083771,Ganguly; Soumya,12,0,32,20
1658017420196,MATH 20E,A02,083772,Ganguly; Soumya,7,0,32,25
1658017420196,MATH 20E,B01,083773,Ciotti; Benjamin,20,0,35,15
1658017420196,MATH 20E,B02,083774,Ciotti; Benjamin,18,0,35,17
1658017426222,MATH 103A,A01,083777,Greenfeld; Be'Eri,6,0,36,30
1658017426222,MATH 103A,A02,083778,Greenfeld; Be'Eri,5,0,36,31
1658017426222,MATH 103A,A03,093561,Greenfeld; Be'Eri,7,0,36,29
1658017426222,MATH 103A,B01,083779,Greenfeld; Be'Eri,8,0,36,28
1658017426222,MATH 103A,B02,083780,Greenfeld; Be'Eri,4,0,36,32
1658017426222,MATH 103A,B03,093562,Greenfeld; Be'Eri,3,0,36,33
1658017432245,MATH 105,A01,085443,Carter; Anne Toulson,15,0,35,20
1658017432245,MATH 105,A02,093477,Carter; Anne Toulson,20,0,35,15
1658017438279,MATH 109,A01,083213,Ganzberger; Geoffrey Michael,3,0,34,31
1658017438279,MATH 109,A02,083214,Ganzberger; Geoffrey Michael,4,0,34,30
1658017438279,MATH 109,A03,093478,Ganzberger; Geoffrey Michael,2,0,34,32
1658017438279,MATH 109,B01,083215,Ganzberger; Geoffrey Michael,3,0,32,29
1658017438279,MATH 109,B02,083216,Ganzberger; Geoffrey Michael,3,0,32,29
1658017438279,MATH 109,B03,093479,Ganzberger; Geoffrey Michael,8,0,32,24
1658017444303,MATH 142A,A01,083219,Chow; Bennett,7,0,32,25
1658017444303,MATH 142A,A02,083220,Chow; Bennett,10,0,32,22
1658017444303,MATH 142A,A03,093480,Chow; Bennett,9,0,32,23
1658017444303,MATH 142A,B03,093481,Chow; Bennett,8,0,32,24
1658017444303,MATH 142A,B04,093558,Chow; Bennett,14,0,32,18
1658017444303,MATH 142A,B05,093559,Chow; Bennett,7,0,32,25
1658017450332,MATH 193A,A01,083224,Rotar; Vladimir,9,0,34,25
1658017450332,MATH 193A,A02,083225,Rotar; Vladimir,11,0,34,23
1658017450332,MATH 193A,A03,083781,Rotar; Vladimir,5,0,34,29
1658017450332,MATH 193A,A04,083782,Rotar; Vladimir,12,0,34,22
1658017450332,MATH 193A,A05,093482,Rotar; Vladimir,11,0,34,23
1658017456356,MATH 197,001,091859,McAuley; Julian John,9999,0,9999,0
1658017456356,MATH 197,002,095566,Kedlaya; Kiran S.,9997,0,9999,2
1658017456356,MATH 197,003,095567,Xiao; Ming,9999,0,9999,0
1658017456356,MATH 197,004,095571,Perols; Johan Lars,9998,0,9999,1
1658017463411,COGS 9,A01,083615,Shannon; Kyle Michael,11,0,75,64
1658017469437,COGS 11,A01,083617,Boyle; Mary E. T.,23,0,48,25
1658017475461,COGS 13,A01,083071,Bastos; Amalia Pinkusfeld,12,0,71,59
1658017481485,COGS 14A,A01,092681,Semenuks; Arturs,5,1,100,95
1658017487514,COGS 14B,A01,083073,Cheng; Tzu-Han,7,0,63,56
1658017493539,COGS 17,A01,092677,Semenuks; Arturs,7,0,81,74
1658017499565,COGS 100,A01,083619,Allen; Michael Gordon,17,0,70,53
1658017505588,COGS 101A,A01,083621,Davis; Joshua Daniel,9,0,68,59
1658017511614,COGS 101B,A01,091572,Allen; Michael Gordon,14,0,65,51
1658017517637,COGS 101C,A01,083625,Delgado; Tania,17,0,35,18
1658017523660,COGS 107A,A01,083627,Boyle; Mary E. T.,14,0,60,46
1658017529687,COGS 118A,A01,083075,Gupta; Anjum,21,0,76,55
1658017535719,CSE 3,A50,083646,Miranda; Gregory Joseph,24,0,50,26
1658017541747,CSE 8A,A50,083650,Miranda; Gregory Joseph,17,1,56,39
1658017547772,CSE 11,A01,083080,Cao; Yingjun,7,15,40,33
1658017553805,CSE 12,A01,083652,Krause-Levy; Sophia Louisa,30,1,120,90
1658017559833,CSE 15L,A01,083654,Morris; Justin Loren,9,0,50,41
1658017559833,CSE 15L,A02,083655,Morris; Justin Loren,11,0,50,39
1658017565858,CSE 20,A01,083657,Tran; Khoa Dang,39,0,80,41
1658017571881,CSE 21,A01,095574,Bach; Quang Tran,23,0,48,25
1658017577909,CSE 30,A01,083084,Eldon; John,8,0,80,72
1658017577909,CSE 30,B01,095061,Bhaskar; Nishant,9,0,50,41
1658017583931,CSE 100,A01,083659,Cao; Yingjun,5,4,70,65
1658017589953,CSE 134B,A01,083661,Powell; Thomas Allan,25,0,100,75
1658017595976,CSE 140,A01,083663,Gungor; Onat,17,0,85,68
1658017602000,CSE 140L,A01,083088,Eldon; John,23,0,100,77
1658017608023,CSE 175,A01,083665,Kumar; Rakesh,3,0,25,22
1658017614046,CSE 190,A00,092507,Dubnov; Shlomo,8,0,20,12
1658017620069,ECE 45,A01,083139,Congero; Spencer William,7,0,75,68
1658017626097,ECE 65,A50,083695,Saad; Andrew S,12,0,30,18
1658017626097,ECE 65,A51,095125,Saad; Andrew S,24,0,26,2
1658017632119,ECE 109,A01,091882,Touri; Behrouz,21,0,70,49
1658017638143,ECE 180,A00,083140,Abi Samra; Nicholas Camill,1,0,30,29
1658017638143,ECE 180,B00,083141,Abi Samra; Nicholas Camill,0,0,30,30
1658017644166,MATH 10A,A01,083735,Patchell; Gregory David,2,0,30,28
1658017644166,MATH 10A,A02,083736,Patchell; Gregory David,20,0,30,10
1658017644166,MATH 10A,A03,083737,Patchell; Gregory David,16,0,30,14
1658017650190,MATH 10B,A01,083207,Lim; Seonhee,9,0,34,25
1658017650190,MATH 10B,A02,083208,Lim; Seonhee,10,0,35,25
1658017650190,MATH 10B,A03,093472,Lim; Seonhee,7,0,34,27
1658017650190,MATH 10B,B01,083739,Sinha; Shubham,14,0,30,16
1658017656215,MATH 18,A01,083743,Cinel; Cameron Alexander,9,0,30,21
1658017656215,MATH 18,A02,083744,Cinel; Cameron Alexander,18,0,30,12
1658017656215,MATH 18,A03,083745,Cinel; Cameron Alexander,10,0,30,20
1658017656215,MATH 18,B01,083748,Rideout; David Porter,5,0,37,32
1658017656215,MATH 18,B02,083749,Rideout; David Porter,5,0,36,31
1658017656215,MATH 18,B03,083750,Rideout; David Porter,3,0,37,34
1658017656215,MATH 18,B04,083751,Rideout; David Porter,7,0,36,29
1658017656215,MATH 18,B05,093473,Rideout; David Porter,7,0,36,29
1658017656215,MATH 18,B06,093474,Rideout; David Porter,6,0,36,30
1658017662241,MATH 20A,A01,083754,Zheng; Zequn,14,0,40,26
1658017668264,MATH 20B,A01,083756,Briones; Jor-el Thomas Caparas,4,0,36,32
1658017668264,MATH 20B,A02,083757,Briones; Jor-el Thomas Caparas,1,0,36,35
1658017668264,MATH 20B,A03,093475,Briones; Jor-el Thomas Caparas,3,0,36,33
1658017674289,MATH 20C,A01,083760,Briones; Jor-el Thomas Caparas,1,0,35,34
1658017674289,MATH 20C,A02,083761,Briones; Jor-el Thomas Caparas,8,0,35,27
1658017674289,MATH 20C,A03,093476,Briones; Jor-el Thomas Caparas,0,1,36,36
1658017674289,MATH 20C,B01,083762,Bach; Quang Tran,1,0,30,29
1658017680314,MATH 20D,A01,083765,Tran; Brian Kha,5,0,30,25
1658017680314,MATH 20D,A02,083766,Tran; Brian Kha,5,0,30,25
1658017680314,MATH 20D,A03,083767,Tran; Brian Kha,6,0,30,24
1658017686338,MATH 20E,A01,083771,Ganguly; Soumya,12,0,32,20
1658017686338,MATH 20E,A02,083772,Ganguly; Soumya,7,0,32,25
1658017686338,MATH 20E,B01,083773,Ciotti; Benjamin,20,0,35,15
1658017686338,MATH 20E,B02,083774,Ciotti; Benjamin,18,0,35,17
1658017692363,MATH 103A,A01,083777,Greenfeld; Be'Eri,6,0,36,30
1658017692363,MATH 103A,A02,083778,Greenfeld; Be'Eri,5,0,36,31
1658017692363,MATH 103A,A03,093561,Greenfeld; Be'Eri,7,0,36,29
1658017692363,MATH 103A,B01,083779,Greenfeld; Be'Eri,8,0,36,28
1658017692363,MATH 103A,B02,083780,Greenfeld; Be'Eri,4,0,36,32
1658017692363,MATH 103A,B03,093562,Greenfeld; Be'Eri,3,0,36,33
1658017698388,MATH 105,A01,085443,Carter; Anne Toulson,15,0,35,20
1658017698388,MATH 105,A02,093477,Carter; Anne Toulson,20,0,35,15
1658017704412,MATH 109,A01,083213,Ganzberger; Geoffrey Michael,3,0,34,31
1658017704412,MATH 109,A02,083214,Ganzberger; Geoffrey Michael,4,0,34,30
1658017704412,MATH 109,A03,093478,Ganzberger; Geoffrey Michael,2,0,34,32
1658017704412,MATH 109,B01,083215,Ganzberger; Geoffrey Michael,3,0,32,29
1658017704412,MATH 109,B02,083216,Ganzberger; Geoffrey Michael,3,0,32,29
1658017704412,MATH 109,B03,093479,Ganzberger; Geoffrey Michael,8,0,32,24
1658017710443,MATH 142A,A01,083219,Chow; Bennett,7,0,32,25
1658017710443,MATH 142A,A02,083220,Chow; Bennett,10,0,32,22
1658017710443,MATH 142A,A03,093480,Chow; Bennett,9,0,32,23
1658017710443,MATH 142A,B03,093481,Chow; Bennett,8,0,32,24
1658017710443,MATH 142A,B04,093558,Chow; Bennett,14,0,32,18
1658017710443,MATH 142A,B05,093559,Chow; Bennett,7,0,32,25
1658017716470,MATH 193A,A01,083224,Rotar; Vladimir,9,0,34,25
1658017716470,MATH 193A,A02,083225,Rotar; Vladimir,11,0,34,23
1658017716470,MATH 193A,A03,083781,Rotar; Vladimir,5,0,34,29
1658017716470,MATH 193A,A04,083782,Rotar; Vladimir,12,0,34,22
1658017716470,MATH 193A,A05,093482,Rotar; Vladimir,11,0,34,23
1658017722495,MATH 197,001,091859,McAuley; Julian John,9999,0,9999,0
1658017722495,MATH 197,002,095566,Kedlaya; Kiran S.,9997,0,9999,2
1658017722495,MATH 197,003,095567,Xiao; Ming,9999,0,9999,0
1658017722495,MATH 197,004,095571,Perols; Johan Lars,9998,0,9999,1
1658017729544,COGS 9,A01,083615,Shannon; Kyle Michael,11,0,75,64
1658017735571,COGS 11,A01,083617,Boyle; Mary E. T.,23,0,48,25
1658017741594,COGS 13,A01,083071,Bastos; Amalia Pinkusfeld,12,0,71,59
1658017747617,COGS 14A,A01,092681,Semenuks; Arturs,5,1,100,95
1658017753642,COGS 14B,A01,083073,Cheng; Tzu-Han,7,0,63,56
1658017759665,COGS 17,A01,092677,Semenuks; Arturs,7,0,81,74
1658017765688,COGS 100,A01,083619,Allen; Michael Gordon,17,0,70,53
1658017771712,COGS 101A,A01,083621,Davis; Joshua Daniel,9,0,68,59
1658017777734,COGS 101B,A01,091572,Allen; Michael Gordon,14,0,65,51
1658017783768,COGS 101C,A01,083625,Delgado; Tania,17,0,35,18
1658017789878,COGS 107A,A01,083627,Boyle; Mary E. T.,14,0,60,46
1658017795903,COGS 118A,A01,083075,Gupta; Anjum,21,0,76,55
1658017801929,CSE 3,A50,083646,Miranda; Gregory Joseph,24,0,50,26
1658017807952,CSE 8A,A50,083650,Miranda; Gregory Joseph,17,1,56,39
1658017813974,CSE 11,A01,083080,Cao; Yingjun,7,15,40,33
1658017819997,CSE 12,A01,083652,Krause-Levy; Sophia Louisa,30,1,120,90
1658017826023,CSE 15L,A01,083654,Morris; Justin Loren,9,0,50,41
1658017826023,CSE 15L,A02,083655,Morris; Justin Loren,11,0,50,39
1658017832045,CSE 20,A01,083657,Tran; Khoa Dang,39,0,80,41
1658017838067,CSE 21,A01,095574,Bach; Quang Tran,23,0,48,25
1658017844093,CSE 30,A01,083084,Eldon; John,8,0,80,72
1658017844093,CSE 30,B01,095061,Bhaskar; Nishant,9,0,50,41
1658017850117,CSE 100,A01,083659,Cao; Yingjun,5,4,70,65
1658017856139,CSE 134B,A01,083661,Powell; Thomas Allan,25,0,100,75
1658017862169,CSE 140,A01,083663,Gungor; Onat,17,0,85,68
1658017868196,CSE 140L,A01,083088,Eldon; John,23,0,100,77
1658017874221,CSE 175,A01,083665,Kumar; Rakesh,3,0,25,22
1658017880242,CSE 190,A00,092507,Dubnov; Shlomo,8,0,20,12
1658017886275,ECE 45,A01,083139,Congero; Spencer William,7,0,75,68
1658017892298,ECE 65,A50,083695,Saad; Andrew S,12,0,30,18
1658017892298,ECE 65,A51,095125,Saad; Andrew S,24,0,26,2
1658017898320,ECE 109,A01,091882,Touri; Behrouz,21,0,70,49
1658017904347,ECE 180,A00,083140,Abi Samra; Nicholas Camill,1,0,30,29
1658017904347,ECE 180,B00,083141,Abi Samra; Nicholas Camill,0,0,30,30
1658017910374,MATH 10A,A01,083735,Patchell; Gregory David,2,0,30,28
1658017910374,MATH 10A,A02,083736,Patchell; Gregory David,20,0,30,10
1658017910374,MATH 10A,A03,083737,Patchell; Gregory David,16,0,30,14
1658017916397,MATH 10B,A01,083207,Lim; Seonhee,9,0,34,25
1658017916397,MATH 10B,A02,083208,Lim; Seonhee,10,0,35,25
1658017916397,MATH 10B,A03,093472,Lim; Seonhee,7,0,34,27
1658017916397,MATH 10B,B01,083739,Sinha; Shubham,14,0,30,16
1658017922422,MATH 18,A01,083743,Cinel; Cameron Alexander,9,0,30,21
1658017922422,MATH 18,A02,083744,Cinel; Cameron Alexander,18,0,30,12
1658017922422,MATH 18,A03,083745,Cinel; Cameron Alexander,10,0,30,20
1658017922422,MATH 18,B01,083748,Rideout; David Porter,5,0,37,32
1658017922422,MATH 18,B02,083749,Rideout; David Porter,5,0,36,31
1658017922422,MATH 18,B03,083750,Rideout; David Porter,3,0,37,34
1658017922422,MATH 18,B04,083751,Rideout; David Porter,7,0,36,29
1658017922422,MATH 18,B05,093473,Rideout; David Porter,7,0,36,29
1658017922422,MATH 18,B06,093474,Rideout; David Porter,6,0,36,30
1658017928448,MATH 20A,A01,083754,Zheng; Zequn,14,0,40,26
1658017934471,MATH 20B,A01,083756,Briones; Jor-el Thomas Caparas,4,0,36,32
1658017934471,MATH 20B,A02,083757,Briones; Jor-el Thomas Caparas,1,0,36,35
1658017934471,MATH 20B,A03,093475,Briones; Jor-el Thomas Caparas,3,0,36,33
1658017940501,MATH 20C,A01,083760,Briones; Jor-el Thomas Caparas,1,0,35,34
1658017940501,MATH 20C,A02,083761,Briones; Jor-el Thomas Caparas,8,0,35,27
1658017940501,MATH 20C,A03,093476,Briones; Jor-el Thomas Caparas,0,1,36,36
1658017940501,MATH 20C,B01,083762,Bach; Quang Tran,1,0,30,29
1658017946529,MATH 20D,A01,083765,Tran; Brian Kha,5,0,30,25
1658017946529,MATH 20D,A02,083766,Tran; Brian Kha,5,0,30,25
1658017946529,MATH 20D,A03,083767,Tran; Brian Kha,6,0,30,24
1658017952553,MATH 20E,A01,083771,Ganguly; Soumya,12,0,32,20
1658017952553,MATH 20E,A02,083772,Ganguly; Soumya,7,0,32,25
1658017952553,MATH 20E,B01,083773,Ciotti; Benjamin,20,0,35,15
1658017952553,MATH 20E,B02,083774,Ciotti; Benjamin,18,0,35,17
1658017958580,MATH 103A,A01,083777,Greenfeld; Be'Eri,6,0,36,30
1658017958580,MATH 103A,A02,083778,Greenfeld; Be'Eri,5,0,36,31
1658017958580,MATH 103A,A03,093561,Greenfeld; Be'Eri,7,0,36,29
1658017958580,MATH 103A,B01,083779,Greenfeld; Be'Eri,8,0,36,28
1658017958580,MATH 103A,B02,083780,Greenfeld; Be'Eri,4,0,36,32
1658017958580,MATH 103A,B03,093562,Greenfeld; Be'Eri,3,0,36,33
1658017964608,MATH 105,A01,085443,Carter; Anne Toulson,15,0,35,20
1658017964608,MATH 105,A02,093477,Carter; Anne Toulson,20,0,35,15
1658017970637,MATH 109,A01,083213,Ganzberger; Geoffrey Michael,3,0,34,31
1658017970637,MATH 109,A02,083214,Ganzberger; Geoffrey Michael,4,0,34,30
1658017970637,MATH 109,A03,093478,Ganzberger; Geoffrey Michael,2,0,34,32
1658017970637,MATH 109,B01,083215,Ganzberger; Geoffrey Michael,3,0,32,29
1658017970637,MATH 109,B02,083216,Ganzberger; Geoffrey Michael,3,0,32,29
1658017970637,MATH 109,B03,093479,Ganzberger; Geoffrey Michael,8,0,32,24
1658017976661,MATH 142A,A01,083219,Chow; Bennett,7,0,32,25
1658017976661,MATH 142A,A02,083220,Chow; Bennett,10,0,32,22
1658017976661,MATH 142A,A03,093480,Chow; Bennett,9,0,32,23
1658017976661,MATH 142A,B03,093481,Chow; Bennett,8,0,32,24
1658017976661,MATH 142A,B04,093558,Chow; Bennett,14,0,32,18
1658017976661,MATH 142A,B05,093559,Chow; Bennett,7,0,32,25
1658017982686,MATH 193A,A01,083224,Rotar; Vladimir,9,0,34,25
1658017982686,MATH 193A,A02,083225,Rotar; Vladimir,11,0,34,23
1658017982686,MATH 193A,A03,083781,Rotar; Vladimir,5,0,34,29
1658017982686,MATH 193A,A04,083782,Rotar; Vladimir,12,0,34,22
1658017982686,MATH 193A,A05,093482,Rotar; Vladimir,11,0,34,23
1658017988715,MATH 197,001,091859,McAuley; Julian John,9999,0,9999,0
1658017988715,MATH 197,002,095566,Kedlaya; Kiran S.,9997,0,9999,2
1658017988715,MATH 197,003,095567,Xiao; Ming,9999,0,9999,0
1658017988715,MATH 197,004,095571,Perols; Johan Lars,9998,0,9999,1
1658017995780,COGS 9,A01,083615,Shannon; Kyle Michael,11,0,75,64
1658018001803,COGS 11,A01,083617,Boyle; Mary E. T.,23,0,48,25
1658018007826,COGS 13,A01,083071,Bastos; Amalia Pinkusfeld,12,0,71,59
1658018013853,COGS 14A,A01,092681,Semenuks; Arturs,5,1,100,95
1658018019876,COGS 14B,A01,083073,Cheng; Tzu-Han,7,0,63,56
1658018025899,COGS 17,A01,092677,Semenuks; Arturs,7,0,81,74
1658018031922,COGS 100,A01,083619,Allen; Michael Gordon,17,0,70,53
1658018037944,COGS 101A,A01,083621,Davis; Joshua Daniel,9,0,68,59
1658018043967,COGS 101B,A01,091572,Allen; Michael Gordon,14,0,65,51
1658018049991,COGS 101C,A01,083625,Delgado; Tania,17,0,35,18
1658018056019,COGS 107A,A01,083627,Boyle; Mary E. T.,14,0,60,46
1658018062047,COGS 118A,A01,083075,Gupta; Anjum,21,0,76,55
1658018068071,CSE 3,A50,083646,Miranda; Gregory Joseph,24,0,50,26
1658018074093,CSE 8A,A50,083650,Miranda; Gregory Joseph,17,1,56,39
1658018080117,CSE 11,A01,083080,Cao; Yingjun,7,15,40,33
1658018086143,CSE 12,A01,083652,Krause-Levy; Sophia Louisa,30,1,120,90
1658018092170,CSE 15L,A01,083654,Morris; Justin Loren,9,0,50,41
1658018092170,CSE 15L,A02,083655,Morris; Justin Loren,11,0,50,39
1658018098197,CSE 20,A01,083657,Tran; Khoa Dang,39,0,80,41
1658018104223,CSE 21,A01,095574,Bach; Quang Tran,23,0,48,25
1658018110251,CSE 30,A01,083084,Eldon; John,8,0,80,72
1658018110251,CSE 30,B01,095061,Bhaskar; Nishant,9,0,50,41
1658018116272,CSE 100,A01,083659,Cao; Yingjun,5,4,70,65
1658018122299,CSE 134B,A01,083661,Powell; Thomas Allan,25,0,100,75
1658018128321,CSE 140,A01,083663,Gungor; Onat,17,0,85,68
1658018134347,CSE 140L,A01,083088,Eldon; John,23,0,100,77
1658018140372,CSE 175,A01,083665,Kumar; Rakesh,3,0,25,22
1658018146398,CSE 190,A00,092507,Dubnov; Shlomo,8,0,20,12
1658018152423,ECE 45,A01,083139,Congero; Spencer William,7,0,75,68
1658018158449,ECE 65,A50,083695,Saad; Andrew S,12,0,30,18
1658018158449,ECE 65,A51,095125,Saad; Andrew S,24,0,26,2
1658018164476,ECE 109,A01,091882,Touri; Behrouz,21,0,70,49
1658018170500,ECE 180,A00,083140,Abi Samra; Nicholas Camill,1,0,30,29
1658018170500,ECE 180,B00,083141,Abi Samra; Nicholas Camill,0,0,30,30
1658018176522,MATH 10A,A01,083735,Patchell; Gregory David,2,0,30,28
1658018176522,MATH 10A,A02,083736,Patchell; Gregory David,20,0,30,10
1658018176522,MATH 10A,A03,083737,Patchell; Gregory David,16,0,30,14
1658018182552,MATH 10B,A01,083207,Lim; Seonhee,9,0,34,25
1658018182552,MATH 10B,A02,083208,Lim; Seonhee,10,0,35,25
1658018182552,MATH 10B,A03,093472,Lim; Seonhee,7,0,34,27
1658018182552,MATH 10B,B01,083739,Sinha; Shubham,14,0,30,16
1658018188577,MATH 18,A01,083743,Cinel; Cameron Alexander,9,0,30,21
1658018188577,MATH 18,A02,083744,Cinel; Cameron Alexander,18,0,30,12
1658018188577,MATH 18,A03,083745,Cinel; Cameron Alexander,10,0,30,20
1658018188577,MATH 18,B01,083748,Rideout; David Porter,5,0,37,32
1658018188577,MATH 18,B02,083749,Rideout; David Porter,5,0,36,31
1658018188577,MATH 18,B03,083750,Rideout; David Porter,3,0,37,34
1658018188577,MATH 18,B04,083751,Rideout; David Porter,7,0,36,29
1658018188577,MATH 18,B05,093473,Rideout; David Porter,7,0,36,29
1658018188577,MATH 18,B06,093474,Rideout; David Porter,6,0,36,30
1658018194604,MATH 20A,A01,083754,Zheng; Zequn,14,0,40,26
1658018200633,MATH 20B,A01,083756,Briones; Jor-el Thomas Caparas,4,0,36,32
1658018200633,MATH 20B,A02,083757,Briones; Jor-el Thomas Caparas,1,0,36,35
1658018200633,MATH 20B,A03,093475,Briones; Jor-el Thomas Caparas,3,0,36,33
1658018206656,MATH 20C,A01,083760,Briones; Jor-el Thomas Caparas,1,0,35,34
1658018206656,MATH 20C,A02,083761,Briones; Jor-el Thomas Caparas,8,0,35,27
1658018206656,MATH 20C,A03,093476,Briones; Jor-el Thomas Caparas,0,1,36,36
1658018206656,MATH 20C,B01,083762,Bach; Quang Tran,1,0,30,29
1658018212677,MATH 20D,A01,083765,Tran; Brian Kha,5,0,30,25
1658018212677,MATH 20D,A02,083766,Tran; Brian Kha,5,0,30,25
1658018212677,MATH 20D,A03,083767,Tran; Brian Kha,6,0,30,24
1658018218701,MATH 20E,A01,083771,Ganguly; Soumya,12,0,32,20
1658018218701,MATH 20E,A02,083772,Ganguly; Soumya,7,0,32,25
1658018218701,MATH 20E,B01,083773,Ciotti; Benjamin,20,0,35,15
1658018218701,MATH 20E,B02,083774,Ciotti; Benjamin,18,0,35,17
1658018224728,MATH 103A,A01,083777,Greenfeld; Be'Eri,6,0,36,30
1658018224728,MATH 103A,A02,083778,Greenfeld; Be'Eri,5,0,36,31
1658018224728,MATH 103A,A03,093561,Greenfeld; Be'Eri,7,0,36,29
1658018224728,MATH 103A,B01,083779,Greenfeld; Be'Eri,8,0,36,28
1658018224728,MATH 103A,B02,083780,Greenfeld; Be'Eri,4,0,36,32
1658018224728,MATH 103A,B03,093562,Greenfeld; Be'Eri,3,0,36,33
1658018230752,MATH 105,A01,085443,Carter; Anne Toulson,15,0,35,20
1658018230752,MATH 105,A02,093477,Carter; Anne Toulson,20,0,35,15
1658018236775,MATH 109,A01,083213,Ganzberger; Geoffrey Michael,3,0,34,31
1658018236775,MATH 109,A02,083214,Ganzberger; Geoffrey Michael,4,0,34,30
1658018236775,MATH 109,A03,093478,Ganzberger; Geoffrey Michael,2,0,34,32
1658018236775,MATH 109,B01,083215,Ganzberger; Geoffrey Michael,3,0,32,29
1658018236775,MATH 109,B02,083216,Ganzberger; Geoffrey Michael,3,0,32,29
1658018236775,MATH 109,B03,093479,Ganzberger; Geoffrey Michael,8,0,32,24
1658018242802,MATH 142A,A01,083219,Chow; Bennett,7,0,32,25
1658018242802,MATH 142A,A02,083220,Chow; Bennett,10,0,32,22
1658018242802,MATH 142A,A03,093480,Chow; Bennett,9,0,32,23
1658018242802,MATH 142A,B03,093481,Chow; Bennett,8,0,32,24
1658018242802,MATH 142A,B04,093558,Chow; Bennett,14,0,32,18
1658018242802,MATH 142A,B05,093559,Chow; Bennett,7,0,32,25
1658018248831,MATH 193A,A01,083224,Rotar; Vladimir,9,0,34,25
1658018248831,MATH 193A,A02,083225,Rotar; Vladimir,11,0,34,23
1658018248831,MATH 193A,A03,083781,Rotar; Vladimir,5,0,34,29
1658018248831,MATH 193A,A04,083782,Rotar; Vladimir,12,0,34,22
1658018248831,MATH 193A,A05,093482,Rotar; Vladimir,11,0,34,23
1658018254854,MATH 197,001,091859,McAuley; Julian John,9999,0,9999,0
1658018254854,MATH 197,002,095566,Kedlaya; Kiran S.,9997,0,9999,2
1658018254854,MATH 197,003,095567,Xiao; Ming,9999,0,9999,0
1658018254854,MATH 197,004,095571,Perols; Johan Lars,9998,0,9999,1
1658018261908,COGS 9,A01,083615,Shannon; Kyle Michael,11,0,75,64
1658018267934,COGS 11,A01,083617,Boyle; Mary E. T.,23,0,48,25
1658018273961,COGS 13,A01,083071,Bastos; Amalia Pinkusfeld,12,0,71,59
1658018279984,COGS 14A,A01,092681,Semenuks; Arturs,5,1,100,95
1658018286006,COGS 14B,A01,083073,Cheng; Tzu-Han,7,0,63,56
1658018292032,COGS 17,A01,092677,Semenuks; Arturs,7,0,81,74
1658018298059,COGS 100,A01,083619,Allen; Michael Gordon,17,0,70,53
1658018304082,COGS 101A,A01,083621,Davis; Joshua Daniel,9,0,68,59
1658018310107,COGS 101B,A01,091572,Allen; Michael Gordon,14,0,65,51
1658018316129,COGS 101C,A01,083625,Delgado; Tania,17,0,35,18
1658018322151,COGS 107A,A01,083627,Boyle; Mary E. T.,14,0,60,46
1658018328189,COGS 118A,A01,083075,Gupta; Anjum,21,0,76,55
1658018334213,CSE 3,A50,083646,Miranda; Gregory Joseph,24,0,50,26
1658018340243,CSE 8A,A50,083650,Miranda; Gregory Joseph,17,1,56,39
1658018346270,CSE 11,A01,083080,Cao; Yingjun,7,15,40,33
1658018352292,CSE 12,A01,083652,Krause-Levy; Sophia Louisa,30,1,120,90
1658018358315,CSE 15L,A01,083654,Morris; Justin Loren,9,0,50,41
1658018358315,CSE 15L,A02,083655,Morris; Justin Loren,11,0,50,39
1658018364340,CSE 20,A01,083657,Tran; Khoa Dang,39,0,80,41
1658018370368,CSE 21,A01,095574,Bach; Quang Tran,23,0,48,25
1658018376391,CSE 30,A01,083084,Eldon; John,8,0,80,72
1658018376391,CSE 30,B01,095061,Bhaskar; Nishant,9,0,50,41
1658018382415,CSE 100,A01,083659,Cao; Yingjun,5,4,70,65
1658018388526,CSE 134B,A01,083661,Powell; Thomas Allan,25,0,100,75
1658018394552,CSE 140,A01,083663,Gungor; Onat,17,0,85,68
1658018400575,CSE 140L,A01,083088,Eldon; John,23,0,100,77
1658018406599,CSE 175,A01,083665,Kumar; Rakesh,3,0,25,22
1658018412629,CSE 190,A00,092507,Dubnov; Shlomo,8,0,20,12
1658018418655,ECE 45,A01,083139,Congero; Spencer William,7,0,75,68
1658018424679,ECE 65,A50,083695,Saad; Andrew S,12,0,30,18
1658018424679,ECE 65,A51,095125,Saad; Andrew S,24,0,26,2
1658018430704,ECE 109,A01,091882,Touri; Behrouz,21,0,70,49
1658018436729,ECE 180,A00,083140,Abi Samra; Nicholas Camill,1,0,30,29
1658018436729,ECE 180,B00,083141,Abi Samra; Nicholas Camill,0,0,30,30
1658018442752,MATH 10A,A01,083735,Patchell; Gregory David,2,0,30,28
1658018442752,MATH 10A,A02,083736,Patchell; Gregory David,20,0,30,10
1658018442752,MATH 10A,A03,083737,Patchell; Gregory David,16,0,30,14
1658018448780,MATH 10B,A01,083207,Lim; Seonhee,9,0,34,25
1658018448780,MATH 10B,A02,083208,Lim; Seonhee,10,0,35,25
1658018448780,MATH 10B,A03,093472,Lim; Seonhee,7,0,34,27
1658018448780,MATH 10B,B01,083739,Sinha; Shubham,14,0,30,16
1658018454812,MATH 18,A01,083743,Cinel; Cameron Alexander,9,0,30,21
1658018454812,MATH 18,A02,083744,Cinel; Cameron Alexander,18,0,30,12
1658018454812,MATH 18,A03,083745,Cinel; Cameron Alexander,10,0,30,20
1658018454812,MATH 18,B01,083748,Rideout; David Porter,5,0,37,32
1658018454812,MATH 18,B02,083749,Rideout; David Porter,5,0,36,31
1658018454812,MATH 18,B03,083750,Rideout; David Porter,3,0,37,34
1658018454812,MATH 18,B04,083751,Rideout; David Porter,7,0,36,29
1658018454812,MATH 18,B05,093473,Rideout; David Porter,7,0,36,29
1658018454812,MATH 18,B06,093474,Rideout; David Porter,6,0,36,30
1658018460838,MATH 20A,A01,083754,Zheng; Zequn,14,0,40,26
1658018466860,MATH 20B,A01,083756,Briones; Jor-el Thomas Caparas,4,0,36,32
1658018466860,MATH 20B,A02,083757,Briones; Jor-el Thomas Caparas,1,0,36,35
1658018466860,MATH 20B,A03,093475,Briones; Jor-el Thomas Caparas,3,0,36,33
1658018472885,MATH 20C,A01,083760,Briones; Jor-el Thomas Caparas,1,0,35,34
1658018472885,MATH 20C,A02,083761,Briones; Jor-el Thomas Caparas,8,0,35,27
1658018472885,MATH 20C,A03,093476,Briones; Jor-el Thomas Caparas,0,1,36,36
1658018472885,MATH 20C,B01,083762,Bach; Quang Tran,1,0,30,29
1658018478918,MATH 20D,A01,083765,Tran; Brian Kha,5,0,30,25
1658018478918,MATH 20D,A02,083766,Tran; Brian Kha,5,0,30,25
1658018478918,MATH 20D,A03,083767,Tran; Brian Kha,6,0,30,24
1658018484942,MATH 20E,A01,083771,Ganguly; Soumya,12,0,32,20
1658018484942,MATH 20E,A02,083772,Ganguly; Soumya,7,0,32,25
1658018484942,MATH 20E,B01,083773,Ciotti; Benjamin,20,0,35,15
1658018484942,MATH 20E,B02,083774,Ciotti; Benjamin,18,0,35,17
1658018490972,MATH 103A,A01,083777,Greenfeld; Be'Eri,6,0,36,30
1658018490972,MATH 103A,A02,083778,Greenfeld; Be'Eri,5,0,36,31
1658018490972,MATH 103A,A03,093561,Greenfeld; Be'Eri,7,0,36,29
1658018490972,MATH 103A,B01,083779,Greenfeld; Be'Eri,8,0,36,28
1658018490972,MATH 103A,B02,083780,Greenfeld; Be'Eri,4,0,36,32
1658018490972,MATH 103A,B03,093562,Greenfeld; Be'Eri,3,0,36,33
1658018496998,MATH 105,A01,085443,Carter; Anne Toulson,15,0,35,20
1658018496998,MATH 105,A02,093477,Carter; Anne Toulson,20,0,35,15
1658018503022,MATH 109,A01,083213,Ganzberger; Geoffrey Michael,3,0,34,31
1658018503022,MATH 109,A02,083214,Ganzberger; Geoffrey Michael,4,0,34,30
1658018503022,MATH 109,A03,093478,Ganzberger; Geoffrey Michael,2,0,34,32
1658018503022,MATH 109,B01,083215,Ganzberger; Geoffrey Michael,3,0,32,29
1658018503022,MATH 109,B02,083216,Ganzberger; Geoffrey Michael,3,0,32,29
1658018503022,MATH 109,B03,093479,Ganzberger; Geoffrey Michael,8,0,32,24
1658018509045,MATH 142A,A01,083219,Chow; Bennett,7,0,32,25
1658018509045,MATH 142A,A02,083220,Chow; Bennett,10,0,32,22
1658018509045,MATH 142A,A03,093480,Chow; Bennett,9,0,32,23
1658018509045,MATH 142A,B03,093481,Chow; Bennett,8,0,32,24
1658018509045,MATH 142A,B04,093558,Chow; Bennett,14,0,32,18
1658018509045,MATH 142A,B05,093559,Chow; Bennett,7,0,32,25
1658018515073,MATH 193A,A01,083224,Rotar; Vladimir,9,0,34,25
1658018515073,MATH 193A,A02,083225,Rotar; Vladimir,11,0,34,23
1658018515073,MATH 193A,A03,083781,Rotar; Vladimir,5,0,34,29
1658018515073,MATH 193A,A04,083782,Rotar; Vladimir,12,0,34,22
1658018515073,MATH 193A,A05,093482,Rotar; Vladimir,11,0,34,23
1658018521095,MATH 197,001,091859,McAuley; Julian John,9999,0,9999,0
1658018521095,MATH 197,002,095566,Kedlaya; Kiran S.,9997,0,9999,2
1658018521095,MATH 197,003,095567,Xiao; Ming,9999,0,9999,0
1658018521095,MATH 197,004,095571,Perols; Johan Lars,9998,0,9999,1
1658018528146,COGS 9,A01,083615,Shannon; Kyle Michael,11,0,75,64
1658018534171,COGS 11,A01,083617,Boyle; Mary E. T.,23,0,48,25
1658018540197,COGS 13,A01,083071,Bastos; Amalia Pinkusfeld,12,0,71,59
1658018546223,COGS 14A,A01,092681,Semenuks; Arturs,5,1,100,95
1658018552249,COGS 14B,A01,083073,Cheng; Tzu-Han,7,0,63,56
1658018558272,COGS 17,A01,092677,Semenuks; Arturs,7,0,81,74
1658018564297,COGS 100,A01,083619,Allen; Michael Gordon,17,0,70,53
1658018570324,COGS 101A,A01,083621,Davis; Joshua Daniel,9,0,68,59
1658018576347,COGS 101B,A01,091572,Allen; Michael Gordon,14,0,65,51
1658018582373,COGS 101C,A01,083625,Delgado; Tania,17,0,35,18
1658018588397,COGS 107A,A01,083627,Boyle; Mary E. T.,14,0,60,46
1658018594425,COGS 118A,A01,083075,Gupta; Anjum,21,0,76,55
1658018600451,CSE 3,A50,083646,Miranda; Gregory Joseph,24,0,50,26
1658018606474,CSE 8A,A50,083650,Miranda; Gregory Joseph,17,1,56,39
1658018612501,CSE 11,A01,083080,Cao; Yingjun,7,15,40,33
1658018618533,CSE 12,A01,083652,Krause-Levy; Sophia Louisa,30,1,120,90
1658018624556,CSE 15L,A01,083654,Morris; Justin Loren,9,0,50,41
1658018624556,CSE 15L,A02,083655,Morris; Justin Loren,11,0,50,39
1658018630578,CSE 20,A01,083657,Tran; Khoa Dang,39,0,80,41
1658018636601,CSE 21,A01,095574,Bach; Quang Tran,23,0,48,25
1658018642627,CSE 30,A01,083084,Eldon; John,8,0,80,72
1658018642627,CSE 30,B01,095061,Bhaskar; Nishant,9,0,50,41
1658018648652,CSE 100,A01,083659,Cao; Yingjun,5,4,70,65
1658018654676,CSE 134B,A01,083661,Powell; Thomas Allan,25,0,100,75
1658018660702,CSE 140,A01,083663,Gungor; Onat,17,0,85,68
1658018666729,CSE 140L,A01,083088,Eldon; John,23,0,100,77
1658018672753,CSE 175,A01,083665,Kumar; Rakesh,3,0,25,22
1658018678784,CSE 190,A00,092507,Dubnov; Shlomo,8,0,20,12
1658018684810,ECE 45,A01,083139,Congero; Spencer William,7,0,75,68
1658018690833,ECE 65,A50,083695,Saad; Andrew S,12,0,30,18
1658018690833,ECE 65,A51,095125,Saad; Andrew S,24,0,26,2
1658018696860,ECE 109,A01,091882,Touri; Behrouz,21,0,70,49
1658018702883,ECE 180,A00,083140,Abi Samra; Nicholas Camill,1,0,30,29
1658018702883,ECE 180,B00,083141,Abi Samra; Nicholas Camill,0,0,30,30
1658018708909,MATH 10A,A01,083735,Patchell; Gregory David,2,0,30,28
1658018708909,MATH 10A,A02,083736,Patchell; Gregory David,20,0,30,10
1658018708909,MATH 10A,A03,083737,Patchell; Gregory David,16,0,30,14
1658018714932,MATH 10B,A01,083207,Lim; Seonhee,9,0,34,25
1658018714932,MATH 10B,A02,083208,Lim; Seonhee,10,0,35,25
1658018714932,MATH 10B,A03,093472,Lim; Seonhee,7,0,34,27
1658018714932,MATH 10B,B01,083739,Sinha; Shubham,14,0,30,16
1658018720957,MATH 18,A01,083743,Cinel; Cameron Alexander,9,0,30,21
1658018720957,MATH 18,A02,083744,Cinel; Cameron Alexander,18,0,30,12
1658018720957,MATH 18,A03,083745,Cinel; Cameron Alexander,10,0,30,20
1658018720957,MATH 18,B01,083748,Rideout; David Porter,5,0,37,32
1658018720957,MATH 18,B02,083749,Rideout; David Porter,5,0,36,31
1658018720957,MATH 18,B03,083750,Rideout; David Porter,3,0,37,34
1658018720957,MATH 18,B04,083751,Rideout; David Porter,7,0,36,29
1658018720957,MATH 18,B05,093473,Rideout; David Porter,7,0,36,29
1658018720957,MATH 18,B06,093474,Rideout; David Porter,6,0,36,30
1658018726984,MATH 20A,A01,083754,Zheng; Zequn,14,0,40,26
1658018733013,MATH 20B,A01,083756,Briones; Jor-el Thomas Caparas,4,0,36,32
1658018733013,MATH 20B,A02,083757,Briones; Jor-el Thomas Caparas,1,0,36,35
1658018733013,MATH 20B,A03,093475,Briones; Jor-el Thomas Caparas,3,0,36,33
1658018739037,MATH 20C,A01,083760,Briones; Jor-el Thomas Caparas,1,0,35,34
1658018739037,MATH 20C,A02,083761,Briones; Jor-el Thomas Caparas,8,0,35,27
1658018739037,MATH 20C,A03,093476,Briones; Jor-el Thomas Caparas,0,1,36,36
1658018739037,MATH 20C,B01,083762,Bach; Quang Tran,1,0,30,29
1658018745059,MATH 20D,A01,083765,Tran; Brian Kha,5,0,30,25
1658018745059,MATH 20D,A02,083766,Tran; Brian Kha,5,0,30,25
1658018745059,MATH 20D,A03,083767,Tran; Brian Kha,6,0,30,24
1658018751084,MATH 20E,A01,083771,Ganguly; Soumya,12,0,32,20
1658018751084,MATH 20E,A02,083772,Ganguly; Soumya,7,0,32,25
1658018751084,MATH 20E,B01,083773,Ciotti; Benjamin,20,0,35,15
1658018751084,MATH 20E,B02,083774,Ciotti; Benjamin,18,0,35,17
1658018757113,MATH 103A,A01,083777,Greenfeld; Be'Eri,6,0,36,30
1658018757113,MATH 103A,A02,083778,Greenfeld; Be'Eri,5,0,36,31
1658018757113,MATH 103A,A03,093561,Greenfeld; Be'Eri,7,0,36,29
1658018757113,MATH 103A,B01,083779,Greenfeld; Be'Eri,8,0,36,28
1658018757113,MATH 103A,B02,083780,Greenfeld; Be'Eri,4,0,36,32
1658018757113,MATH 103A,B03,093562,Greenfeld; Be'Eri,3,0,36,33
1658018763142,MATH 105,A01,085443,Carter; Anne Toulson,15,0,35,20
1658018763142,MATH 105,A02,093477,Carter; Anne Toulson,20,0,35,15
1658018769175,MATH 109,A01,083213,Ganzberger; Geoffrey Michael,3,0,34,31
1658018769175,MATH 109,A02,083214,Ganzberger; Geoffrey Michael,4,0,34,30
1658018769175,MATH 109,A03,093478,Ganzberger; Geoffrey Michael,2,0,34,32
1658018769175,MATH 109,B01,083215,Ganzberger; Geoffrey Michael,3,0,32,29
1658018769175,MATH 109,B02,083216,Ganzberger; Geoffrey Michael,3,0,32,29
1658018769175,MATH 109,B03,093479,Ganzberger; Geoffrey Michael,8,0,32,24
1658018775203,MATH 142A,A01,083219,Chow; Bennett,7,0,32,25
1658018775203,MATH 142A,A02,083220,Chow; Bennett,10,0,32,22
1658018775203,MATH 142A,A03,093480,Chow; Bennett,9,0,32,23
1658018775203,MATH 142A,B03,093481,Chow; Bennett,8,0,32,24
1658018775203,MATH 142A,B04,093558,Chow; Bennett,14,0,32,18
1658018775203,MATH 142A,B05,093559,Chow; Bennett,7,0,32,25
1658018781226,MATH 193A,A01,083224,Rotar; Vladimir,9,0,34,25
1658018781226,MATH 193A,A02,083225,Rotar; Vladimir,11,0,34,23
1658018781226,MATH 193A,A03,083781,Rotar; Vladimir,5,0,34,29
1658018781226,MATH 193A,A04,083782,Rotar; Vladimir,12,0,34,22
1658018781226,MATH 193A,A05,093482,Rotar; Vladimir,11,0,34,23
1658018787249,MATH 197,001,091859,McAuley; Julian John,9999,0,9999,0
1658018787249,MATH 197,002,095566,Kedlaya; Kiran S.,9997,0,9999,2
1658018787249,MATH 197,003,095567,Xiao; Ming,9999,0,9999,0
1658018787249,MATH 197,004,095571,Perols; Johan Lars,9998,0,9999,1
1658018794306,COGS 9,A01,083615,Shannon; Kyle Michael,11,0,75,64
1658018800333,COGS 11,A01,083617,Boyle; Mary E. T.,23,0,48,25
1658018806365,COGS 13,A01,083071,Bastos; Amalia Pinkusfeld,12,0,71,59
1658018812406,COGS 14A,A01,092681,Semenuks; Arturs,5,1,100,95
1658018818434,COGS 14B,A01,083073,Cheng; Tzu-Han,7,0,63,56
1658018824463,COGS 17,A01,092677,Semenuks; Arturs,7,0,81,74
1658018830486,COGS 100,A01,083619,Allen; Michael Gordon,17,0,70,53
1658018836511,COGS 101A,A01,083621,Davis; Joshua Daniel,9,0,68,59
1658018842533,COGS 101B,A01,091572,Allen; Michael Gordon,14,0,65,51
1658018848556,COGS 101C,A01,083625,Delgado; Tania,17,0,35,18
1658018854579,COGS 107A,A01,083627,Boyle; Mary E. T.,14,0,60,46
1658018860602,COGS 118A,A01,083075,Gupta; Anjum,21,0,76,55
1658018866625,CSE 3,A50,083646,Miranda; Gregory Joseph,24,0,50,26
1658018872653,CSE 8A,A50,083650,Miranda; Gregory Joseph,17,1,56,39
1658018878675,CSE 11,A01,083080,Cao; Yingjun,7,15,40,33
1658018884702,CSE 12,A01,083652,Krause-Levy; Sophia Louisa,30,1,120,90
1658018890732,CSE 15L,A01,083654,Morris; Justin Loren,9,0,50,41
1658018890732,CSE 15L,A02,083655,Morris; Justin Loren,11,0,50,39
1658018896759,CSE 20,A01,083657,Tran; Khoa Dang,39,0,80,41
1658018902787,CSE 21,A01,095574,Bach; Quang Tran,23,0,48,25
1658018908810,CSE 30,A01,083084,Eldon; John,8,0,80,72
1658018908810,CSE 30,B01,095061,Bhaskar; Nishant,9,0,50,41
1658018914831,CSE 100,A01,083659,Cao; Yingjun,5,4,70,65
1658018920853,CSE 134B,A01,083661,Powell; Thomas Allan,25,0,100,75
1658018926899,CSE 140,A01,083663,Gungor; Onat,17,0,85,68
1658018932922,CSE 140L,A01,083088,Eldon; John,23,0,100,77
1658018938946,CSE 175,A01,083665,Kumar; Rakesh,3,0,25,22
1658018944968,CSE 190,A00,092507,Dubnov; Shlomo,8,0,20,12
1658018950992,ECE 45,A01,083139,Congero; Spencer William,7,0,75,68
1658018957015,ECE 65,A50,083695,Saad; Andrew S,12,0,30,18
1658018957015,ECE 65,A51,095125,Saad; Andrew S,24,0,26,2
1658018963037,ECE 109,A01,091882,Touri; Behrouz,21,0,70,49
1658018969063,ECE 180,A00,083140,Abi Samra; Nicholas Camill,1,0,30,29
1658018969063,ECE 180,B00,083141,Abi Samra; Nicholas Camill,0,0,30,30
1658018975086,MATH 10A,A01,083735,Patchell; Gregory David,2,0,30,28
1658018975086,MATH 10A,A02,083736,Patchell; Gregory David,20,0,30,10
1658018975086,MATH 10A,A03,083737,Patchell; Gregory David,16,0,30,14
1658018981116,MATH 10B,A01,083207,Lim; Seonhee,9,0,34,25
1658018981116,MATH 10B,A02,083208,Lim; Seonhee,10,0,35,25
1658018981116,MATH 10B,A03,093472,Lim; Seonhee,7,0,34,27
1658018981116,MATH 10B,B01,083739,Sinha; Shubham,14,0,30,16
1658018987213,MATH 18,A01,083743,Cinel; Cameron Alexander,9,0,30,21
1658018987213,MATH 18,A02,083744,Cinel; Cameron Alexander,18,0,30,12
1658018987213,MATH 18,A03,083745,Cinel; Cameron Alexander,10,0,30,20
1658018987213,MATH 18,B01,083748,Rideout; David Porter,5,0,37,32
1658018987213,MATH 18,B02,083749,Rideout; David Porter,5,0,36,31
1658018987213,MATH 18,B03,083750,Rideout; David Porter,3,0,37,34
1658018987213,MATH 18,B04,083751,Rideout; David Porter,7,0,36,29
1658018987213,MATH 18,B05,093473,Rideout; David Porter,7,0,36,29
1658018987213,MATH 18,B06,093474,Rideout; David Porter,6,0,36,30
1658018993237,MATH 20A,A01,083754,Zheng; Zequn,14,0,40,26
1658018999266,MATH 20B,A01,083756,Briones; Jor-el Thomas Caparas,4,0,36,32
1658018999266,MATH 20B,A02,083757,Briones; Jor-el Thomas Caparas,1,0,36,35
1658018999266,MATH 20B,A03,093475,Briones; Jor-el Thomas Caparas,3,0,36,33
1658019005295,MATH 20C,A01,083760,Briones; Jor-el Thomas Caparas,1,0,35,34
1658019005295,MATH 20C,A02,083761,Briones; Jor-el Thomas Caparas,8,0,35,27
1658019005295,MATH 20C,A03,093476,Briones; Jor-el Thomas Caparas,0,1,36,36
1658019005295,MATH 20C,B01,083762,Bach; Quang Tran,1,0,30,29
1658019011318,MATH 20D,A01,083765,Tran; Brian Kha,5,0,30,25
1658019011318,MATH 20D,A02,083766,Tran; Brian Kha,5,0,30,25
1658019011318,MATH 20D,A03,083767,Tran; Brian Kha,6,0,30,24
1658019017346,MATH 20E,A01,083771,Ganguly; Soumya,12,0,32,20
1658019017346,MATH 20E,A02,083772,Ganguly; Soumya,7,0,32,25
1658019017346,MATH 20E,B01,083773,Ciotti; Benjamin,20,0,35,15
1658019017346,MATH 20E,B02,083774,Ciotti; Benjamin,18,0,35,17
1658019023373,MATH 103A,A01,083777,Greenfeld; Be'Eri,6,0,36,30
1658019023373,MATH 103A,A02,083778,Greenfeld; Be'Eri,5,0,36,31
1658019023373,MATH 103A,A03,093561,Greenfeld; Be'Eri,7,0,36,29
1658019023373,MATH 103A,B01,083779,Greenfeld; Be'Eri,8,0,36,28
1658019023373,MATH 103A,B02,083780,Greenfeld; Be'Eri,4,0,36,32
1658019023373,MATH 103A,B03,093562,Greenfeld; Be'Eri,3,0,36,33
1658019029398,MATH 105,A01,085443,Carter; Anne Toulson,15,0,35,20
1658019029398,MATH 105,A02,093477,Carter; Anne Toulson,20,0,35,15
1658019035426,MATH 109,A01,083213,Ganzberger; Geoffrey Michael,3,0,34,31
1658019035426,MATH 109,A02,083214,Ganzberger; Geoffrey Michael,4,0,34,30
1658019035426,MATH 109,A03,093478,Ganzberger; Geoffrey Michael,2,0,34,32
1658019035426,MATH 109,B01,083215,Ganzberger; Geoffrey Michael,3,0,32,29
1658019035426,MATH 109,B02,083216,Ganzberger; Geoffrey Michael,3,0,32,29
1658019035426,MATH 109,B03,093479,Ganzberger; Geoffrey Michael,8,0,32,24
1658019041455,MATH 142A,A01,083219,Chow; Bennett,7,0,32,25
1658019041455,MATH 142A,A02,083220,Chow; Bennett,10,0,32,22
1658019041455,MATH 142A,A03,093480,Chow; Bennett,9,0,32,23
1658019041455,MATH 142A,B03,093481,Chow; Bennett,8,0,32,24
1658019041455,MATH 142A,B04,093558,Chow; Bennett,14,0,32,18
1658019041455,MATH 142A,B05,093559,Chow; Bennett,7,0,32,25
1658019047479,MATH 193A,A01,083224,Rotar; Vladimir,9,0,34,25
1658019047479,MATH 193A,A02,083225,Rotar; Vladimir,11,0,34,23
1658019047479,MATH 193A,A03,083781,Rotar; Vladimir,5,0,34,29
1658019047479,MATH 193A,A04,083782,Rotar; Vladimir,12,0,34,22
1658019047479,MATH 193A,A05,093482,Rotar; Vladimir,11,0,34,23
1658019053502,MATH 197,001,091859,McAuley; Julian John,9999,0,9999,0
1658019053502,MATH 197,002,095566,Kedlaya; Kiran S.,9997,0,9999,2
1658019053502,MATH 197,003,095567,Xiao; Ming,9999,0,9999,0
1658019053502,MATH 197,004,095571,Perols; Johan Lars,9998,0,9999,1
1658019060554,COGS 9,A01,083615,Shannon; Kyle Michael,11,0,75,64
1658019066576,COGS 11,A01,083617,Boyle; Mary E. T.,23,0,48,25
1658019072602,COGS 13,A01,083071,Bastos; Amalia Pinkusfeld,12,0,71,59
1658019078629,COGS 14A,A01,092681,Semenuks; Arturs,5,1,100,95
1658019084654,COGS 14B,A01,083073,Cheng; Tzu-Han,7,0,63,56
1658019090680,COGS 17,A01,092677,Semenuks; Arturs,7,0,81,74
1658019096707,COGS 100,A01,083619,Allen; Michael Gordon,17,0,70,53
1658019102735,COGS 101A,A01,083621,Davis; Joshua Daniel,9,0,68,59
1658019108764,COGS 101B,A01,091572,Allen; Michael Gordon,14,0,65,51
1658019114790,COGS 101C,A01,083625,Delgado; Tania,17,0,35,18
1658019120813,COGS 107A,A01,083627,Boyle; Mary E. T.,14,0,60,46
1658019126836,COGS 118A,A01,083075,Gupta; Anjum,21,0,76,55
1658019132864,CSE 3,A50,083646,Miranda; Gregory Joseph,24,0,50,26
1658019138889,CSE 8A,A50,083650,Miranda; Gregory Joseph,17,1,56,39
1658019144916,CSE 11,A01,083080,Cao; Yingjun,7,15,40,33
1658019150942,CSE 12,A01,083652,Krause-Levy; Sophia Louisa,30,1,120,90
1658019156969,CSE 15L,A01,083654,Morris; Justin Loren,9,0,50,41
1658019156969,CSE 15L,A02,083655,Morris; Justin Loren,11,0,50,39
1658019162992,CSE 20,A01,083657,Tran; Khoa Dang,39,0,80,41
1658019169015,CSE 21,A01,095574,Bach; Quang Tran,23,0,48,25
1658019175037,CSE 30,A01,083084,Eldon; John,8,0,80,72
1658019175037,CSE 30,B01,095061,Bhaskar; Nishant,9,0,50,41
1658019181060,CSE 100,A01,083659,Cao; Yingjun,5,4,70,65
1658019187085,CSE 134B,A01,083661,Powell; Thomas Allan,25,0,100,75
1658019193107,CSE 140,A01,083663,Gungor; Onat,17,0,85,68
1658019199130,CSE 140L,A01,083088,Eldon; John,23,0,100,77
1658019205156,CSE 175,A01,083665,Kumar; Rakesh,3,0,25,22
1658019211181,CSE 190,A00,092507,Dubnov; Shlomo,8,0,20,12
1658019217207,ECE 45,A01,083139,Congero; Spencer William,7,0,75,68
1658019223231,ECE 65,A50,083695,Saad; Andrew S,12,0,30,18
1658019223231,ECE 65,A51,095125,Saad; Andrew S,24,0,26,2
1658019229253,ECE 109,A01,091882,Touri; Behrouz,21,0,70,49
1658019235279,ECE 180,A00,083140,Abi Samra; Nicholas Camill,1,0,30,29
1658019235279,ECE 180,B00,083141,Abi Samra; Nicholas Camill,0,0,30,30
1658019241307,MATH 10A,A01,083735,Patchell; Gregory David,2,0,30,28
1658019241307,MATH 10A,A02,083736,Patchell; Gregory David,20,0,30,10
1658019241307,MATH 10A,A03,083737,Patchell; Gregory David,16,0,30,14
1658019247331,MATH 10B,A01,083207,Lim; Seonhee,9,0,34,25
1658019247331,MATH 10B,A02,083208,Lim; Seonhee,10,0,35,25
1658019247331,MATH 10B,A03,093472,Lim; Seonhee,7,0,34,27
1658019247331,MATH 10B,B01,083739,Sinha; Shubham,14,0,30,16
1658019253365,MATH 18,A01,083743,Cinel; Cameron Alexander,9,0,30,21
1658019253365,MATH 18,A02,083744,Cinel; Cameron Alexander,18,0,30,12
1658019253365,MATH 18,A03,083745,Cinel; Cameron Alexander,10,0,30,20
1658019253365,MATH 18,B01,083748,Rideout; David Porter,5,0,37,32
1658019253365,MATH 18,B02,083749,Rideout; David Porter,5,0,36,31
1658019253365,MATH 18,B03,083750,Rideout; David Porter,3,0,37,34
1658019253365,MATH 18,B04,083751,Rideout; David Porter,7,0,36,29
1658019253365,MATH 18,B05,093473,Rideout; David Porter,7,0,36,29
1658019253365,MATH 18,B06,093474,Rideout; David Porter,6,0,36,30
1658019259392,MATH 20A,A01,083754,Zheng; Zequn,14,0,40,26
1658019265414,MATH 20B,A01,083756,Briones; Jor-el Thomas Caparas,4,0,36,32
1658019265414,MATH 20B,A02,083757,Briones; Jor-el Thomas Caparas,1,0,36,35
1658019265414,MATH 20B,A03,093475,Briones; Jor-el Thomas Caparas,3,0,36,33
1658019271438,MATH 20C,A01,083760,Briones; Jor-el Thomas Caparas,1,0,35,34
1658019271438,MATH 20C,A02,083761,Briones; Jor-el Thomas Caparas,8,0,35,27
1658019271438,MATH 20C,A03,093476,Briones; Jor-el Thomas Caparas,0,1,36,36
1658019271438,MATH 20C,B01,083762,Bach; Quang Tran,1,0,30,29
1658019277461,MATH 20D,A01,083765,Tran; Brian Kha,5,0,30,25
1658019277461,MATH 20D,A02,083766,Tran; Brian Kha,5,0,30,25
1658019277461,MATH 20D,A03,083767,Tran; Brian Kha,6,0,30,24
1658019283489,MATH 20E,A01,083771,Ganguly; Soumya,12,0,32,20
1658019283489,MATH 20E,A02,083772,Ganguly; Soumya,7,0,32,25
1658019283489,MATH 20E,B01,083773,Ciotti; Benjamin,20,0,35,15
1658019283489,MATH 20E,B02,083774,Ciotti; Benjamin,18,0,35,17
1658019289512,MATH 103A,A01,083777,Greenfeld; Be'Eri,6,0,36,30
1658019289512,MATH 103A,A02,083778,Greenfeld; Be'Eri,5,0,36,31
1658019289512,MATH 103A,A03,093561,Greenfeld; Be'Eri,7,0,36,29
1658019289512,MATH 103A,B01,083779,Greenfeld; Be'Eri,8,0,36,28
1658019289512,MATH 103A,B02,083780,Greenfeld; Be'Eri,4,0,36,32
1658019289512,MATH 103A,B03,093562,Greenfeld; Be'Eri,3,0,36,33
1658019295545,MATH 105,A01,085443,Carter; Anne Toulson,15,0,35,20
1658019295545,MATH 105,A02,093477,Carter; Anne Toulson,20,0,35,15
1658019301568,MATH 109,A01,083213,Ganzberger; Geoffrey Michael,3,0,34,31
1658019301568,MATH 109,A02,083214,Ganzberger; Geoffrey Michael,4,0,34,30
1658019301568,MATH 109,A03,093478,Ganzberger; Geoffrey Michael,2,0,34,32
1658019301568,MATH 109,B01,083215,Ganzberger; Geoffrey Michael,3,0,32,29
1658019301568,MATH 109,B02,083216,Ganzberger; Geoffrey Michael,3,0,32,29
1658019301568,MATH 109,B03,093479,Ganzberger; Geoffrey Michael,8,0,32,24
1658019307590,MATH 142A,A01,083219,Chow; Bennett,7,0,32,25
1658019307590,MATH 142A,A02,083220,Chow; Bennett,10,0,32,22
1658019307590,MATH 142A,A03,093480,Chow; Bennett,9,0,32,23
1658019307590,MATH 142A,B03,093481,Chow; Bennett,8,0,32,24
1658019307590,MATH 142A,B04,093558,Chow; Bennett,14,0,32,18
1658019307590,MATH 142A,B05,093559,Chow; Bennett,7,0,32,25
1658019313617,MATH 193A,A01,083224,Rotar; Vladimir,9,0,34,25
1658019313617,MATH 193A,A02,083225,Rotar; Vladimir,11,0,34,23
1658019313617,MATH 193A,A03,083781,Rotar; Vladimir,5,0,34,29
1658019313617,MATH 193A,A04,083782,Rotar; Vladimir,12,0,34,22
1658019313617,MATH 193A,A05,093482,Rotar; Vladimir,11,0,34,23
1658019319640,MATH 197,001,091859,McAuley; Julian John,9999,0,9999,0
1658019319640,MATH 197,002,095566,Kedlaya; Kiran S.,9997,0,9999,2
1658019319640,MATH 197,003,095567,Xiao; Ming,9999,0,9999,0
1658019319640,MATH 197,004,095571,Perols; Johan Lars,9998,0,9999,1
1658019326708,COGS 9,A01,083615,Shannon; Kyle Michael,11,0,75,64
1658019332734,COGS 11,A01,083617,Boyle; Mary E. T.,23,0,48,25
1658019338757,COGS 13,A01,083071,Bastos; Amalia Pinkusfeld,12,0,71,59
1658019344780,COGS 14A,A01,092681,Semenuks; Arturs,5,1,100,95
1658019350803,COGS 14B,A01,083073,Cheng; Tzu-Han,7,0,63,56
1658019356828,COGS 17,A01,092677,Semenuks; Arturs,7,0,81,74
1658019362852,COGS 100,A01,083619,Allen; Michael Gordon,17,0,70,53
1658019368878,COGS 101A,A01,083621,Davis; Joshua Daniel,9,0,68,59
1658019374904,COGS 101B,A01,091572,Allen; Michael Gordon,14,0,65,51
1658019380927,COGS 101C,A01,083625,Delgado; Tania,17,0,35,18
1658019386949,COGS 107A,A01,083627,Boyle; Mary E. T.,14,0,60,46
1658019392973,COGS 118A,A01,083075,Gupta; Anjum,21,0,76,55
1658019399000,CSE 3,A50,083646,Miranda; Gregory Joseph,24,0,50,26
1658019405033,CSE 8A,A50,083650,Miranda; Gregory Joseph,17,1,56,39
1658019411060,CSE 11,A01,083080,Cao; Yingjun,7,15,40,33
1658019417083,CSE 12,A01,083652,Krause-Levy; Sophia Louisa,30,1,120,90
1658019423106,CSE 15L,A01,083654,Morris; Justin Loren,9,0,50,41
1658019423106,CSE 15L,A02,083655,Morris; Justin Loren,11,0,50,39
1658019429129,CSE 20,A01,083657,Tran; Khoa Dang,39,0,80,41
1658019435153,CSE 21,A01,095574,Bach; Quang Tran,23,0,48,25
1658019441178,CSE 30,A01,083084,Eldon; John,8,0,80,72
1658019441178,CSE 30,B01,095061,Bhaskar; Nishant,9,0,50,41
1658019447206,CSE 100,A01,083659,Cao; Yingjun,5,4,70,65
1658019453229,CSE 134B,A01,083661,Powell; Thomas Allan,25,0,100,75
1658019459256,CSE 140,A01,083663,Gungor; Onat,17,0,85,68
1658019465279,CSE 140L,A01,083088,Eldon; John,23,0,100,77
1658019471304,CSE 175,A01,083665,Kumar; Rakesh,3,0,25,22
1658019477329,CSE 190,A00,092507,Dubnov; Shlomo,8,0,20,12
1658019483353,ECE 45,A01,083139,Congero; Spencer William,7,0,75,68
1658019489381,ECE 65,A50,083695,Saad; Andrew S,12,0,30,18
1658019489381,ECE 65,A51,095125,Saad; Andrew S,24,0,26,2
1658019495403,ECE 109,A01,091882,Touri; Behrouz,21,0,70,49
1658019501425,ECE 180,A00,083140,Abi Samra; Nicholas Camill,1,0,30,29
1658019501425,ECE 180,B00,083141,Abi Samra; Nicholas Camill,0,0,30,30
1658019507448,MATH 10A,A01,083735,Patchell; Gregory David,2,0,30,28
1658019507448,MATH 10A,A02,083736,Patchell; Gregory David,20,0,30,10
1658019507448,MATH 10A,A03,083737,Patchell; Gregory David,16,0,30,14
1658019513476,MATH 10B,A01,083207,Lim; Seonhee,9,0,34,25
1658019513476,MATH 10B,A02,083208,Lim; Seonhee,10,0,35,25
1658019513476,MATH 10B,A03,093472,Lim; Seonhee,7,0,34,27
1658019513476,MATH 10B,B01,083739,Sinha; Shubham,14,0,30,16
1658019519507,MATH 18,A01,083743,Cinel; Cameron Alexander,9,0,30,21
1658019519507,MATH 18,A02,083744,Cinel; Cameron Alexander,18,0,30,12
1658019519507,MATH 18,A03,083745,Cinel; Cameron Alexander,10,0,30,20
1658019519507,MATH 18,B01,083748,Rideout; David Porter,5,0,37,32
1658019519507,MATH 18,B02,083749,Rideout; David Porter,5,0,36,31
1658019519507,MATH 18,B03,083750,Rideout; David Porter,3,0,37,34
1658019519507,MATH 18,B04,083751,Rideout; David Porter,7,0,36,29
1658019519507,MATH 18,B05,093473,Rideout; David Porter,7,0,36,29
1658019519507,MATH 18,B06,093474,Rideout; David Porter,6,0,36,30
1658019525532,MATH 20A,A01,083754,Zheng; Zequn,14,0,40,26
1658019531557,MATH 20B,A01,083756,Briones; Jor-el Thomas Caparas,4,0,36,32
1658019531557,MATH 20B,A02,083757,Briones; Jor-el Thomas Caparas,1,0,36,35
1658019531557,MATH 20B,A03,093475,Briones; Jor-el Thomas Caparas,3,0,36,33
1658019537587,MATH 20C,A01,083760,Briones; Jor-el Thomas Caparas,1,0,35,34
1658019537587,MATH 20C,A02,083761,Briones; Jor-el Thomas Caparas,8,0,35,27
1658019537587,MATH 20C,A03,093476,Briones; Jor-el Thomas Caparas,0,1,36,36
1658019537587,MATH 20C,B01,083762,Bach; Quang Tran,1,0,30,29
1658019543610,MATH 20D,A01,083765,Tran; Brian Kha,5,0,30,25
1658019543610,MATH 20D,A02,083766,Tran; Brian Kha,5,0,30,25
1658019543610,MATH 20D,A03,083767,Tran; Brian Kha,6,0,30,24
1658019549640,MATH 20E,A01,083771,Ganguly; Soumya,12,0,32,20
1658019549640,MATH 20E,A02,083772,Ganguly; Soumya,7,0,32,25
1658019549640,MATH 20E,B01,083773,Ciotti; Benjamin,20,0,35,15
1658019549640,MATH 20E,B02,083774,Ciotti; Benjamin,18,0,35,17
1658019555668,MATH 103A,A01,083777,Greenfeld; Be'Eri,6,0,36,30
1658019555668,MATH 103A,A02,083778,Greenfeld; Be'Eri,5,0,36,31
1658019555668,MATH 103A,A03,093561,Greenfeld; Be'Eri,7,0,36,29
1658019555668,MATH 103A,B01,083779,Greenfeld; Be'Eri,8,0,36,28
1658019555668,MATH 103A,B02,083780,Greenfeld; Be'Eri,4,0,36,32
1658019555668,MATH 103A,B03,093562,Greenfeld; Be'Eri,3,0,36,33
1658019561690,MATH 105,A01,085443,Carter; Anne Toulson,15,0,35,20
1658019561690,MATH 105,A02,093477,Carter; Anne Toulson,20,0,35,15
1658019567714,MATH 109,A01,083213,Ganzberger; Geoffrey Michael,3,0,34,31
1658019567714,MATH 109,A02,083214,Ganzberger; Geoffrey Michael,4,0,34,30
1658019567714,MATH 109,A03,093478,Ganzberger; Geoffrey Michael,2,0,34,32
1658019567714,MATH 109,B01,083215,Ganzberger; Geoffrey Michael,3,0,32,29
1658019567714,MATH 109,B02,083216,Ganzberger; Geoffrey Michael,3,0,32,29
1658019567714,MATH 109,B03,093479,Ganzberger; Geoffrey Michael,8,0,32,24
1658019573744,MATH 142A,A01,083219,Chow; Bennett,7,0,32,25
1658019573744,MATH 142A,A02,083220,Chow; Bennett,10,0,32,22
1658019573744,MATH 142A,A03,093480,Chow; Bennett,9,0,32,23
1658019573744,MATH 142A,B03,093481,Chow; Bennett,8,0,32,24
1658019573744,MATH 142A,B04,093558,Chow; Bennett,14,0,32,18
1658019573744,MATH 142A,B05,093559,Chow; Bennett,7,0,32,25
1658019579768,MATH 193A,A01,083224,Rotar; Vladimir,9,0,34,25
1658019579768,MATH 193A,A02,083225,Rotar; Vladimir,11,0,34,23
1658019579768,MATH 193A,A03,083781,Rotar; Vladimir,5,0,34,29
1658019579768,MATH 193A,A04,083782,Rotar; Vladimir,12,0,34,22
1658019579768,MATH 193A,A05,093482,Rotar; Vladimir,11,0,34,23
1658019585865,MATH 197,001,091859,McAuley; Julian John,9999,0,9999,0
1658019585865,MATH 197,002,095566,Kedlaya; Kiran S.,9997,0,9999,2
1658019585865,MATH 197,003,095567,Xiao; Ming,9999,0,9999,0
1658019585865,MATH 197,004,095571,Perols; Johan Lars,9998,0,9999,1
1658019592930,COGS 9,A01,083615,Shannon; Kyle Michael,11,0,75,64
1658019598953,COGS 11,A01,083617,Boyle; Mary E. T.,23,0,48,25
1658019604979,COGS 13,A01,083071,Bastos; Amalia Pinkusfeld,12,0,71,59
1658019611008,COGS 14A,A01,092681,Semenuks; Arturs,5,1,100,95
1658019617035,COGS 14B,A01,083073,Cheng; Tzu-Han,7,0,63,56
1658019623068,COGS 17,A01,092677,Semenuks; Arturs,7,0,81,74
1658019629090,COGS 100,A01,083619,Allen; Michael Gordon,17,0,70,53
1658019635112,COGS 101A,A01,083621,Davis; Joshua Daniel,9,0,68,59
1658019641139,COGS 101B,A01,091572,Allen; Michael Gordon,14,0,65,51
1658019647174,COGS 101C,A01,083625,Delgado; Tania,17,0,35,18
1658019653201,COGS 107A,A01,083627,Boyle; Mary E. T.,14,0,60,46
1658019659236,COGS 118A,A01,083075,Gupta; Anjum,21,0,76,55
1658019665263,CSE 3,A50,083646,Miranda; Gregory Joseph,24,0,50,26
1658019671286,CSE 8A,A50,083650,Miranda; Gregory Joseph,17,1,56,39
1658019677307,CSE 11,A01,083080,Cao; Yingjun,7,15,40,33
1658019683342,CSE 12,A01,083652,Krause-Levy; Sophia Louisa,30,1,120,90
1658019689370,CSE 15L,A01,083654,Morris; Justin Loren,9,0,50,41
1658019689370,CSE 15L,A02,083655,Morris; Justin Loren,11,0,50,39
1658019695395,CSE 20,A01,083657,Tran; Khoa Dang,39,0,80,41
1658019701419,CSE 21,A01,095574,Bach; Quang Tran,23,0,48,25
1658019707447,CSE 30,A01,083084,Eldon; John,8,0,80,72
1658019707447,CSE 30,B01,095061,Bhaskar; Nishant,9,0,50,41
1658019713471,CSE 100,A01,083659,Cao; Yingjun,5,4,70,65
1658019719498,CSE 134B,A01,083661,Powell; Thomas Allan,25,0,100,75
1658019725524,CSE 140,A01,083663,Gungor; Onat,17,0,85,68
1658019731549,CSE 140L,A01,083088,Eldon; John,23,0,100,77
1658019737574,CSE 175,A01,083665,Kumar; Rakesh,3,0,25,22
1658019743598,CSE 190,A00,092507,Dubnov; Shlomo,8,0,20,12
1658019749621,ECE 45,A01,083139,Congero; Spencer William,7,0,75,68
1658019755649,ECE 65,A50,083695,Saad; Andrew S,12,0,30,18
1658019755649,ECE 65,A51,095125,Saad; Andrew S,24,0,26,2
1658019761671,ECE 109,A01,091882,Touri; Behrouz,21,0,70,49
1658019767701,ECE 180,A00,083140,Abi Samra; Nicholas Camill,1,0,30,29
1658019767701,ECE 180,B00,083141,Abi Samra; Nicholas Camill,0,0,30,30
1658019773727,MATH 10A,A01,083735,Patchell; Gregory David,2,0,30,28
1658019773727,MATH 10A,A02,083736,Patchell; Gregory David,20,0,30,10
1658019773727,MATH 10A,A03,083737,Patchell; Gregory David,16,0,30,14
1658019779765,MATH 10B,A01,083207,Lim; Seonhee,9,0,34,25
1658019779765,MATH 10B,A02,083208,Lim; Seonhee,10,0,35,25
1658019779765,MATH 10B,A03,093472,Lim; Seonhee,7,0,34,27
1658019779765,MATH 10B,B01,083739,Sinha; Shubham,14,0,30,16
1658019785791,MATH 18,A01,083743,Cinel; Cameron Alexander,9,0,30,21
1658019785791,MATH 18,A02,083744,Cinel; Cameron Alexander,18,0,30,12
1658019785791,MATH 18,A03,083745,Cinel; Cameron Alexander,10,0,30,20
1658019785791,MATH 18,B01,083748,Rideout; David Porter,5,0,37,32
1658019785791,MATH 18,B02,083749,Rideout; David Porter,5,0,36,31
1658019785791,MATH 18,B03,083750,Rideout; David Porter,3,0,37,34
1658019785791,MATH 18,B04,083751,Rideout; David Porter,7,0,36,29
1658019785791,MATH 18,B05,093473,Rideout; David Porter,7,0,36,29
1658019785791,MATH 18,B06,093474,Rideout; David Porter,6,0,36,30
1658019791818,MATH 20A,A01,083754,Zheng; Zequn,14,0,40,26
1658019797843,MATH 20B,A01,083756,Briones; Jor-el Thomas Caparas,4,0,36,32
1658019797843,MATH 20B,A02,083757,Briones; Jor-el Thomas Caparas,1,0,36,35
1658019797843,MATH 20B,A03,093475,Briones; Jor-el Thomas Caparas,3,0,36,33
1658019803872,MATH 20C,A01,083760,Briones; Jor-el Thomas Caparas,1,0,35,34
1658019803872,MATH 20C,A02,083761,Briones; Jor-el Thomas Caparas,8,0,35,27
1658019803872,MATH 20C,A03,093476,Briones; Jor-el Thomas Caparas,0,1,36,36
1658019803872,MATH 20C,B01,083762,Bach; Quang Tran,1,0,30,29
1658019809900,MATH 20D,A01,083765,Tran; Brian Kha,5,0,30,25
1658019809900,MATH 20D,A02,083766,Tran; Brian Kha,5,0,30,25
1658019809900,MATH 20D,A03,083767,Tran; Brian Kha,6,0,30,24
1658019815928,MATH 20E,A01,083771,Ganguly; Soumya,12,0,32,20
1658019815928,MATH 20E,A02,083772,Ganguly; Soumya,7,0,32,25
1658019815928,MATH 20E,B01,083773,Ciotti; Benjamin,20,0,35,15
1658019815928,MATH 20E,B02,083774,Ciotti; Benjamin,18,0,35,17
1658019821952,MATH 103A,A01,083777,Greenfeld; Be'Eri,6,0,36,30
1658019821952,MATH 103A,A02,083778,Greenfeld; Be'Eri,5,0,36,31
1658019821952,MATH 103A,A03,093561,Greenfeld; Be'Eri,7,0,36,29
1658019821952,MATH 103A,B01,083779,Greenfeld; Be'Eri,8,0,36,28
1658019821952,MATH 103A,B02,083780,Greenfeld; Be'Eri,4,0,36,32
1658019821952,MATH 103A,B03,093562,Greenfeld; Be'Eri,3,0,36,33
1658019827975,MATH 105,A01,085443,Carter; Anne Toulson,15,0,35,20
1658019827975,MATH 105,A02,093477,Carter; Anne Toulson,20,0,35,15
1658019833999,MATH 109,A01,083213,Ganzberger; Geoffrey Michael,3,0,34,31
1658019833999,MATH 109,A02,083214,Ganzberger; Geoffrey Michael,4,0,34,30
1658019833999,MATH 109,A03,093478,Ganzberger; Geoffrey Michael,2,0,34,32
1658019833999,MATH 109,B01,083215,Ganzberger; Geoffrey Michael,3,0,32,29
1658019833999,MATH 109,B02,083216,Ganzberger; Geoffrey Michael,3,0,32,29
1658019833999,MATH 109,B03,093479,Ganzberger; Geoffrey Michael,8,0,32,24
1658019840030,MATH 142A,A01,083219,Chow; Bennett,7,0,32,25
1658019840030,MATH 142A,A02,083220,Chow; Bennett,10,0,32,22
1658019840030,MATH 142A,A03,093480,Chow; Bennett,9,0,32,23
1658019840030,MATH 142A,B03,093481,Chow; Bennett,8,0,32,24
1658019840030,MATH 142A,B04,093558,Chow; Bennett,14,0,32,18
1658019840030,MATH 142A,B05,093559,Chow; Bennett,7,0,32,25
1658019846060,MATH 193A,A01,083224,Rotar; Vladimir,9,0,34,25
1658019846060,MATH 193A,A02,083225,Rotar; Vladimir,11,0,34,23
1658019846060,MATH 193A,A03,083781,Rotar; Vladimir,5,0,34,29
1658019846060,MATH 193A,A04,083782,Rotar; Vladimir,12,0,34,22
1658019846060,MATH 193A,A05,093482,Rotar; Vladimir,11,0,34,23
1658019852082,MATH 197,001,091859,McAuley; Julian John,9999,0,9999,0
1658019852082,MATH 197,002,095566,Kedlaya; Kiran S.,9997,0,9999,2
1658019852082,MATH 197,003,095567,Xiao; Ming,9999,0,9999,0
1658019852082,MATH 197,004,095571,Perols; Johan Lars,9998,0,9999,1
1658019859137,COGS 9,A01,083615,Shannon; Kyle Michael,11,0,75,64
1658019865178,COGS 11,A01,083617,Boyle; Mary E. T.,23,0,48,25
1658019871203,COGS 13,A01,083071,Bastos; Amalia Pinkusfeld,12,0,71,59
1658019877228,COGS 14A,A01,092681,Semenuks; Arturs,5,1,100,95
1658019883250,COGS 14B,A01,083073,Cheng; Tzu-Han,7,0,63,56
1658019889273,COGS 17,A01,092677,Semenuks; Arturs,7,0,81,74
1658019895295,COGS 100,A01,083619,Allen; Michael Gordon,17,0,70,53
1658019901323,COGS 101A,A01,083621,Davis; Joshua Daniel,9,0,68,59
1658019907345,COGS 101B,A01,091572,Allen; Michael Gordon,14,0,65,51
1658019913368,COGS 101C,A01,083625,Delgado; Tania,17,0,35,18
1658019919390,COGS 107A,A01,083627,Boyle; Mary E. T.,14,0,60,46
1658019925418,COGS 118A,A01,083075,Gupta; Anjum,21,0,76,55
1658019931441,CSE 3,A50,083646,Miranda; Gregory Joseph,24,0,50,26
1658019937465,CSE 8A,A50,083650,Miranda; Gregory Joseph,17,1,56,39
1658019943489,CSE 11,A01,083080,Cao; Yingjun,7,15,40,33
1658019949516,CSE 12,A01,083652,Krause-Levy; Sophia Louisa,30,1,120,90
1658019955538,CSE 15L,A01,083654,Morris; Justin Loren,9,0,50,41
1658019955538,CSE 15L,A02,083655,Morris; Justin Loren,11,0,50,39
1658019961559,CSE 20,A01,083657,Tran; Khoa Dang,39,0,80,41
1658019967582,CSE 21,A01,095574,Bach; Quang Tran,23,0,48,25
1658019973609,CSE 30,A01,083084,Eldon; John,8,0,80,72
1658019973609,CSE 30,B01,095061,Bhaskar; Nishant,9,0,50,41
1658019979633,CSE 100,A01,083659,Cao; Yingjun,5,4,70,65
1658019985657,CSE 134B,A01,083661,Powell; Thomas Allan,25,0,100,75
1658019991688,CSE 140,A01,083663,Gungor; Onat,17,0,85,68
1658019997715,CSE 140L,A01,083088,Eldon; John,23,0,100,77
1658020003740,CSE 175,A01,083665,Kumar; Rakesh,3,0,25,22
1658020009763,CSE 190,A00,092507,Dubnov; Shlomo,8,0,20,12
1658020015786,ECE 45,A01,083139,Congero; Spencer William,7,0,75,68
1658020021814,ECE 65,A50,083695,Saad; Andrew S,12,0,30,18
1658020021814,ECE 65,A51,095125,Saad; Andrew S,24,0,26,2
1658020027836,ECE 109,A01,091882,Touri; Behrouz,21,0,70,49
1658020033860,ECE 180,A00,083140,Abi Samra; Nicholas Camill,1,0,30,29
1658020033860,ECE 180,B00,083141,Abi Samra; Nicholas Camill,0,0,30,30
1658020039886,MATH 10A,A01,083735,Patchell; Gregory David,2,0,30,28
1658020039886,MATH 10A,A02,083736,Patchell; Gregory David,20,0,30,10
1658020039886,MATH 10A,A03,083737,Patchell; Gregory David,16,0,30,14
1658020045910,MATH 10B,A01,083207,Lim; Seonhee,9,0,34,25
1658020045910,MATH 10B,A02,083208,Lim; Seonhee,10,0,35,25
1658020045910,MATH 10B,A03,093472,Lim; Seonhee,7,0,34,27
1658020045910,MATH 10B,B01,083739,Sinha; Shubham,14,0,30,16
1658020051936,MATH 18,A01,083743,Cinel; Cameron Alexander,9,0,30,21
1658020051936,MATH 18,A02,083744,Cinel; Cameron Alexander,18,0,30,12
1658020051936,MATH 18,A03,083745,Cinel; Cameron Alexander,10,0,30,20
1658020051936,MATH 18,B01,083748,Rideout; David Porter,5,0,37,32
1658020051936,MATH 18,B02,083749,Rideout; David Porter,5,0,36,31
1658020051936,MATH 18,B03,083750,Rideout; David Porter,3,0,37,34
1658020051936,MATH 18,B04,083751,Rideout; David Porter,7,0,36,29
1658020051936,MATH 18,B05,093473,Rideout; David Porter,7,0,36,29
1658020051936,MATH 18,B06,093474,Rideout; David Porter,6,0,36,30
1658020057961,MATH 20A,A01,083754,Zheng; Zequn,14,0,40,26
1658020063989,MATH 20B,A01,083756,Briones; Jor-el Thomas Caparas,4,0,36,32
1658020063989,MATH 20B,A02,083757,Briones; Jor-el Thomas Caparas,1,0,36,35
1658020063989,MATH 20B,A03,093475,Briones; Jor-el Thomas Caparas,3,0,36,33
1658020070012,MATH 20C,A01,083760,Briones; Jor-el Thomas Caparas,1,0,35,34
1658020070012,MATH 20C,A02,083761,Briones; Jor-el Thomas Caparas,8,0,35,27
1658020070012,MATH 20C,A03,093476,Briones; Jor-el Thomas Caparas,0,1,36,36
1658020070012,MATH 20C,B01,083762,Bach; Quang Tran,1,0,30,29
1658020076041,MATH 20D,A01,083765,Tran; Brian Kha,5,0,30,25
1658020076041,MATH 20D,A02,083766,Tran; Brian Kha,5,0,30,25
1658020076041,MATH 20D,A03,083767,Tran; Brian Kha,6,0,30,24
1658020082063,MATH 20E,A01,083771,Ganguly; Soumya,12,0,32,20
1658020082063,MATH 20E,A02,083772,Ganguly; Soumya,7,0,32,25
1658020082063,MATH 20E,B01,083773,Ciotti; Benjamin,20,0,35,15
1658020082063,MATH 20E,B02,083774,Ciotti; Benjamin,18,0,35,17
1658020088087,MATH 103A,A01,083777,Greenfeld; Be'Eri,6,0,36,30
1658020088087,MATH 103A,A02,083778,Greenfeld; Be'Eri,5,0,36,31
1658020088087,MATH 103A,A03,093561,Greenfeld; Be'Eri,7,0,36,29
1658020088087,MATH 103A,B01,083779,Greenfeld; Be'Eri,8,0,36,28
1658020088087,MATH 103A,B02,083780,Greenfeld; Be'Eri,4,0,36,32
1658020088087,MATH 103A,B03,093562,Greenfeld; Be'Eri,3,0,36,33
1658020094111,MATH 105,A01,085443,Carter; Anne Toulson,15,0,35,20
1658020094111,MATH 105,A02,093477,Carter; Anne Toulson,20,0,35,15
1658020100141,MATH 109,A01,083213,Ganzberger; Geoffrey Michael,3,0,34,31
1658020100141,MATH 109,A02,083214,Ganzberger; Geoffrey Michael,4,0,34,30
1658020100141,MATH 109,A03,093478,Ganzberger; Geoffrey Michael,2,0,34,32
1658020100141,MATH 109,B01,083215,Ganzberger; Geoffrey Michael,3,0,32,29
1658020100141,MATH 109,B02,083216,Ganzberger; Geoffrey Michael,3,0,32,29
1658020100141,MATH 109,B03,093479,Ganzberger; Geoffrey Michael,8,0,32,24
1658020106165,MATH 142A,A01,083219,Chow; Bennett,7,0,32,25
1658020106165,MATH 142A,A02,083220,Chow; Bennett,10,0,32,22
1658020106165,MATH 142A,A03,093480,Chow; Bennett,9,0,32,23
1658020106165,MATH 142A,B03,093481,Chow; Bennett,8,0,32,24
1658020106165,MATH 142A,B04,093558,Chow; Bennett,14,0,32,18
1658020106165,MATH 142A,B05,093559,Chow; Bennett,7,0,32,25
1658020112195,MATH 193A,A01,083224,Rotar; Vladimir,9,0,34,25
1658020112195,MATH 193A,A02,083225,Rotar; Vladimir,11,0,34,23
1658020112195,MATH 193A,A03,083781,Rotar; Vladimir,5,0,34,29
1658020112195,MATH 193A,A04,083782,Rotar; Vladimir,12,0,34,22
1658020112195,MATH 193A,A05,093482,Rotar; Vladimir,11,0,34,23
1658020118216,MATH 197,001,091859,McAuley; Julian John,9999,0,9999,0
1658020118216,MATH 197,002,095566,Kedlaya; Kiran S.,9997,0,9999,2
1658020118216,MATH 197,003,095567,Xiao; Ming,9999,0,9999,0
1658020118216,MATH 197,004,095571,Perols; Johan Lars,9998,0,9999,1
1658020125270,COGS 9,A01,083615,Shannon; Kyle Michael,11,0,75,64
1658020131293,COGS 11,A01,083617,Boyle; Mary E. T.,23,0,48,25
1658020137319,COGS 13,A01,083071,Bastos; Amalia Pinkusfeld,12,0,71,59
1658020143342,COGS 14A,A01,092681,Semenuks; Arturs,5,1,100,95
1658020149365,COGS 14B,A01,083073,Cheng; Tzu-Han,7,0,63,56
1658020155388,COGS 17,A01,092677,Semenuks; Arturs,7,0,81,74
1658020161414,COGS 100,A01,083619,Allen; Michael Gordon,17,0,70,53
1658020167440,COGS 101A,A01,083621,Davis; Joshua Daniel,9,0,68,59
1658020173466,COGS 101B,A01,091572,Allen; Michael Gordon,14,0,65,51
1658020179569,COGS 101C,A01,083625,Delgado; Tania,17,0,35,18
1658020185591,COGS 107A,A01,083627,Boyle; Mary E. T.,14,0,60,46
1658020191619,COGS 118A,A01,083075,Gupta; Anjum,21,0,76,55
1658020197644,CSE 3,A50,083646,Miranda; Gregory Joseph,24,0,50,26
1658020203669,CSE 8A,A50,083650,Miranda; Gregory Joseph,17,1,56,39
1658020209693,CSE 11,A01,083080,Cao; Yingjun,7,15,40,33
1658020215721,CSE 12,A01,083652,Krause-Levy; Sophia Louisa,30,1,120,90
1658020221750,CSE 15L,A01,083654,Morris; Justin Loren,9,0,50,41
1658020221750,CSE 15L,A02,083655,Morris; Justin Loren,11,0,50,39
1658020227775,CSE 20,A01,083657,Tran; Khoa Dang,39,0,80,41
1658020233798,CSE 21,A01,095574,Bach; Quang Tran,23,0,48,25
1658020239820,CSE 30,A01,083084,Eldon; John,8,0,80,72
1658020239820,CSE 30,B01,095061,Bhaskar; Nishant,9,0,50,41
1658020245847,CSE 100,A01,083659,Cao; Yingjun,5,4,70,65
1658020251869,CSE 134B,A01,083661,Powell; Thomas Allan,25,0,100,75
1658020257892,CSE 140,A01,083663,Gungor; Onat,17,0,85,68
1658020263923,CSE 140L,A01,083088,Eldon; John,23,0,100,77
1658020269957,CSE 175,A01,083665,Kumar; Rakesh,3,0,25,22
1658020275979,CSE 190,A00,092507,Dubnov; Shlomo,8,0,20,12
1658020282005,ECE 45,A01,083139,Congero; Spencer William,7,0,75,68
1658020288028,ECE 65,A50,083695,Saad; Andrew S,12,0,30,18
1658020288028,ECE 65,A51,095125,Saad; Andrew S,24,0,26,2
1658020294049,ECE 109,A01,091882,Touri; Behrouz,21,0,70,49
1658020300072,ECE 180,A00,083140,Abi Samra; Nicholas Camill,1,0,30,29
1658020300072,ECE 180,B00,083141,Abi Samra; Nicholas Camill,0,0,30,30
1658020306101,MATH 10A,A01,083735,Patchell; Gregory David,2,0,30,28
1658020306101,MATH 10A,A02,083736,Patchell; Gregory David,20,0,30,10
1658020306101,MATH 10A,A03,083737,Patchell; Gregory David,16,0,30,14
1658020312125,MATH 10B,A01,083207,Lim; Seonhee,9,0,34,25
1658020312125,MATH 10B,A02,083208,Lim; Seonhee,10,0,35,25
1658020312125,MATH 10B,A03,093472,Lim; Seonhee,7,0,34,27
1658020312125,MATH 10B,B01,083739,Sinha; Shubham,14,0,30,16
1658020318151,MATH 18,A01,083743,Cinel; Cameron Alexander,9,0,30,21
1658020318151,MATH 18,A02,083744,Cinel; Cameron Alexander,18,0,30,12
1658020318151,MATH 18,A03,083745,Cinel; Cameron Alexander,10,0,30,20
1658020318151,MATH 18,B01,083748,Rideout; David Porter,5,0,37,32
1658020318151,MATH 18,B02,083749,Rideout; David Porter,5,0,36,31
1658020318151,MATH 18,B03,083750,Rideout; David Porter,3,0,37,34
1658020318151,MATH 18,B04,083751,Rideout; David Porter,7,0,36,29
1658020318151,MATH 18,B05,093473,Rideout; David Porter,7,0,36,29
1658020318151,MATH 18,B06,093474,Rideout; David Porter,6,0,36,30
1658020324180,MATH 20A,A01,083754,Zheng; Zequn,14,0,40,26
1658020330204,MATH 20B,A01,083756,Briones; Jor-el Thomas Caparas,4,0,36,32
1658020330204,MATH 20B,A02,083757,Briones; Jor-el Thomas Caparas,1,0,36,35
1658020330204,MATH 20B,A03,093475,Briones; Jor-el Thomas Caparas,3,0,36,33
1658020336232,MATH 20C,A01,083760,Briones; Jor-el Thomas Caparas,1,0,35,34
1658020336232,MATH 20C,A02,083761,Briones; Jor-el Thomas Caparas,8,0,35,27
1658020336232,MATH 20C,A03,093476,Briones; Jor-el Thomas Caparas,0,1,36,36
1658020336232,MATH 20C,B01,083762,Bach; Quang Tran,1,0,30,29
1658020342260,MATH 20D,A01,083765,Tran; Brian Kha,5,0,30,25
1658020342260,MATH 20D,A02,083766,Tran; Brian Kha,5,0,30,25
1658020342260,MATH 20D,A03,083767,Tran; Brian Kha,6,0,30,24
1658020348287,MATH 20E,A01,083771,Ganguly; Soumya,12,0,32,20
1658020348287,MATH 20E,A02,083772,Ganguly; Soumya,7,0,32,25
1658020348287,MATH 20E,B01,083773,Ciotti; Benjamin,20,0,35,15
1658020348287,MATH 20E,B02,083774,Ciotti; Benjamin,18,0,35,17
1658020354311,MATH 103A,A01,083777,Greenfeld; Be'Eri,6,0,36,30
1658020354311,MATH 103A,A02,083778,Greenfeld; Be'Eri,5,0,36,31
1658020354311,MATH 103A,A03,093561,Greenfeld; Be'Eri,7,0,36,29
1658020354311,MATH 103A,B01,083779,Greenfeld; Be'Eri,8,0,36,28
1658020354311,MATH 103A,B02,083780,Greenfeld; Be'Eri,4,0,36,32
1658020354311,MATH 103A,B03,093562,Greenfeld; Be'Eri,3,0,36,33
1658020360334,MATH 105,A01,085443,Carter; Anne Toulson,15,0,35,20
1658020360334,MATH 105,A02,093477,Carter; Anne Toulson,20,0,35,15
1658020366361,MATH 109,A01,083213,Ganzberger; Geoffrey Michael,3,0,34,31
1658020366361,MATH 109,A02,083214,Ganzberger; Geoffrey Michael,4,0,34,30
1658020366361,MATH 109,A03,093478,Ganzberger; Geoffrey Michael,2,0,34,32
1658020366361,MATH 109,B01,083215,Ganzberger; Geoffrey Michael,3,0,32,29
1658020366361,MATH 109,B02,083216,Ganzberger; Geoffrey Michael,3,0,32,29
1658020366361,MATH 109,B03,093479,Ganzberger; Geoffrey Michael,8,0,32,24
1658020372386,MATH 142A,A01,083219,Chow; Bennett,7,0,32,25
1658020372386,MATH 142A,A02,083220,Chow; Bennett,10,0,32,22
1658020372386,MATH 142A,A03,093480,Chow; Bennett,9,0,32,23
1658020372386,MATH 142A,B03,093481,Chow; Bennett,8,0,32,24
1658020372386,MATH 142A,B04,093558,Chow; Bennett,14,0,32,18
1658020372386,MATH 142A,B05,093559,Chow; Bennett,7,0,32,25
1658020378411,MATH 193A,A01,083224,Rotar; Vladimir,9,0,34,25
1658020378411,MATH 193A,A02,083225,Rotar; Vladimir,11,0,34,23
1658020378411,MATH 193A,A03,083781,Rotar; Vladimir,5,0,34,29
1658020378411,MATH 193A,A04,083782,Rotar; Vladimir,12,0,34,22
1658020378411,MATH 193A,A05,093482,Rotar; Vladimir,11,0,34,23
1658020384438,MATH 197,001,091859,McAuley; Julian John,9999,0,9999,0
1658020384438,MATH 197,002,095566,Kedlaya; Kiran S.,9997,0,9999,2
1658020384438,MATH 197,003,095567,Xiao; Ming,9999,0,9999,0
1658020384438,MATH 197,004,095571,Perols; Johan Lars,9998,0,9999,1
1658020391505,COGS 9,A01,083615,Shannon; Kyle Michael,11,0,75,64
1658020397527,COGS 11,A01,083617,Boyle; Mary E. T.,23,0,48,25
1658020403555,COGS 13,A01,083071,Bastos; Amalia Pinkusfeld,12,0,71,59
1658020409578,COGS 14A,A01,092681,Semenuks; Arturs,5,1,100,95
1658020415602,COGS 14B,A01,083073,Cheng; Tzu-Han,7,0,63,56
1658020421628,COGS 17,A01,092677,Semenuks; Arturs,7,0,81,74
1658020427653,COGS 100,A01,083619,Allen; Michael Gordon,17,0,70,53
1658020433684,COGS 101A,A01,083621,Davis; Joshua Daniel,9,0,68,59
1658020439713,COGS 101B,A01,091572,Allen; Michael Gordon,14,0,65,51
1658020445743,COGS 101C,A01,083625,Delgado; Tania,17,0,35,18
1658020451771,COGS 107A,A01,083627,Boyle; Mary E. T.,14,0,60,46
1658020457793,COGS 118A,A01,083075,Gupta; Anjum,21,0,76,55
1658020463823,CSE 3,A50,083646,Miranda; Gregory Joseph,24,0,50,26
1658020469851,CSE 8A,A50,083650,Miranda; Gregory Joseph,17,1,56,39
1658020475875,CSE 11,A01,083080,Cao; Yingjun,7,15,40,33
1658020481902,CSE 12,A01,083652,Krause-Levy; Sophia Louisa,30,1,120,90
1658020487926,CSE 15L,A01,083654,Morris; Justin Loren,9,0,50,41
1658020487926,CSE 15L,A02,083655,Morris; Justin Loren,11,0,50,39
1658020493950,CSE 20,A01,083657,Tran; Khoa Dang,39,0,80,41
1658020499984,CSE 21,A01,095574,Bach; Quang Tran,23,0,48,25
1658020506006,CSE 30,A01,083084,Eldon; John,8,0,80,72
1658020506006,CSE 30,B01,095061,Bhaskar; Nishant,9,0,50,41
1658020512030,CSE 100,A01,083659,Cao; Yingjun,5,4,70,65
1658020518052,CSE 134B,A01,083661,Powell; Thomas Allan,25,0,100,75
1658020524076,CSE 140,A01,083663,Gungor; Onat,17,0,85,68
1658020530097,CSE 140L,A01,083088,Eldon; John,23,0,100,77
1658020536120,CSE 175,A01,083665,Kumar; Rakesh,3,0,25,22
1658020542144,CSE 190,A00,092507,Dubnov; Shlomo,8,0,20,12
1658020548176,ECE 45,A01,083139,Congero; Spencer William,7,0,75,68
1658020554204,ECE 65,A50,083695,Saad; Andrew S,12,0,30,18
1658020554204,ECE 65,A51,095125,Saad; Andrew S,24,0,26,2
1658020560228,ECE 109,A01,091882,Touri; Behrouz,21,0,70,49
1658020566251,ECE 180,A00,083140,Abi Samra; Nicholas Camill,1,0,30,29
1658020566251,ECE 180,B00,083141,Abi Samra; Nicholas Camill,0,0,30,30
1658020572287,MATH 10A,A01,083735,Patchell; Gregory David,2,0,30,28
1658020572287,MATH 10A,A02,083736,Patchell; Gregory David,20,0,30,10
1658020572287,MATH 10A,A03,083737,Patchell; Gregory David,16,0,30,14
1658020578311,MATH 10B,A01,083207,Lim; Seonhee,9,0,34,25
1658020578311,MATH 10B,A02,083208,Lim; Seonhee,10,0,35,25
1658020578311,MATH 10B,A03,093472,Lim; Seonhee,7,0,34,27
1658020578311,MATH 10B,B01,083739,Sinha; Shubham,14,0,30,16
1658020584335,MATH 18,A01,083743,Cinel; Cameron Alexander,9,0,30,21
1658020584335,MATH 18,A02,083744,Cinel; Cameron Alexander,18,0,30,12
1658020584335,MATH 18,A03,083745,Cinel; Cameron Alexander,10,0,30,20
1658020584335,MATH 18,B01,083748,Rideout; David Porter,5,0,37,32
1658020584335,MATH 18,B02,083749,Rideout; David Porter,5,0,36,31
1658020584335,MATH 18,B03,083750,Rideout; David Porter,3,0,37,34
1658020584335,MATH 18,B04,083751,Rideout; David Porter,7,0,36,29
1658020584335,MATH 18,B05,093473,Rideout; David Porter,7,0,36,29
1658020584335,MATH 18,B06,093474,Rideout; David Porter,6,0,36,30
1658020590359,MATH 20A,A01,083754,Zheng; Zequn,14,0,40,26
1658020596381,MATH 20B,A01,083756,Briones; Jor-el Thomas Caparas,4,0,36,32
1658020596381,MATH 20B,A02,083757,Briones; Jor-el Thomas Caparas,1,0,36,35
1658020596381,MATH 20B,A03,093475,Briones; Jor-el Thomas Caparas,3,0,36,33
1658020602410,MATH 20C,A01,083760,Briones; Jor-el Thomas Caparas,1,0,35,34
1658020602410,MATH 20C,A02,083761,Briones; Jor-el Thomas Caparas,8,0,35,27
1658020602410,MATH 20C,A03,093476,Briones; Jor-el Thomas Caparas,0,1,36,36
1658020602410,MATH 20C,B01,083762,Bach; Quang Tran,1,0,30,29
1658020608439,MATH 20D,A01,083765,Tran; Brian Kha,5,0,30,25
1658020608439,MATH 20D,A02,083766,Tran; Brian Kha,5,0,30,25
1658020608439,MATH 20D,A03,083767,Tran; Brian Kha,6,0,30,24
1658020614474,MATH 20E,A01,083771,Ganguly; Soumya,12,0,32,20
1658020614474,MATH 20E,A02,083772,Ganguly; Soumya,7,0,32,25
1658020614474,MATH 20E,B01,083773,Ciotti; Benjamin,20,0,35,15
1658020614474,MATH 20E,B02,083774,Ciotti; Benjamin,18,0,35,17
1658020620497,MATH 103A,A01,083777,Greenfeld; Be'Eri,6,0,36,30
1658020620497,MATH 103A,A02,083778,Greenfeld; Be'Eri,5,0,36,31
1658020620497,MATH 103A,A03,093561,Greenfeld; Be'Eri,7,0,36,29
1658020620497,MATH 103A,B01,083779,Greenfeld; Be'Eri,8,0,36,28
1658020620497,MATH 103A,B02,083780,Greenfeld; Be'Eri,4,0,36,32
1658020620497,MATH 103A,B03,093562,Greenfeld; Be'Eri,3,0,36,33
1658020626521,MATH 105,A01,085443,Carter; Anne Toulson,15,0,35,20
1658020626521,MATH 105,A02,093477,Carter; Anne Toulson,20,0,35,15
1658020632557,MATH 109,A01,083213,Ganzberger; Geoffrey Michael,3,0,34,31
1658020632557,MATH 109,A02,083214,Ganzberger; Geoffrey Michael,4,0,34,30
1658020632557,MATH 109,A03,093478,Ganzberger; Geoffrey Michael,2,0,34,32
1658020632557,MATH 109,B01,083215,Ganzberger; Geoffrey Michael,3,0,32,29
1658020632557,MATH 109,B02,083216,Ganzberger; Geoffrey Michael,3,0,32,29
1658020632557,MATH 109,B03,093479,Ganzberger; Geoffrey Michael,8,0,32,24
1658020638581,MATH 142A,A01,083219,Chow; Bennett,7,0,32,25
1658020638581,MATH 142A,A02,083220,Chow; Bennett,10,0,32,22
1658020638581,MATH 142A,A03,093480,Chow; Bennett,9,0,32,23
1658020638581,MATH 142A,B03,093481,Chow; Bennett,8,0,32,24
1658020638581,MATH 142A,B04,093558,Chow; Bennett,14,0,32,18
1658020638581,MATH 142A,B05,093559,Chow; Bennett,7,0,32,25
1658020644609,MATH 193A,A01,083224,Rotar; Vladimir,9,0,34,25
1658020644609,MATH 193A,A02,083225,Rotar; Vladimir,11,0,34,23
1658020644609,MATH 193A,A03,083781,Rotar; Vladimir,5,0,34,29
1658020644609,MATH 193A,A04,083782,Rotar; Vladimir,12,0,34,22
1658020644609,MATH 193A,A05,093482,Rotar; Vladimir,11,0,34,23
1658020650632,MATH 197,001,091859,McAuley; Julian John,9999,0,9999,0
1658020650632,MATH 197,002,095566,Kedlaya; Kiran S.,9997,0,9999,2
1658020650632,MATH 197,003,095567,Xiao; Ming,9999,0,9999,0
1658020650632,MATH 197,004,095571,Perols; Johan Lars,9998,0,9999,1
1658020657695,COGS 9,A01,083615,Shannon; Kyle Michael,11,0,75,64
1658020663718,COGS 11,A01,083617,Boyle; Mary E. T.,23,0,48,25
1658020669739,COGS 13,A01,083071,Bastos; Amalia Pinkusfeld,12,0,71,59
1658020675774,COGS 14A,A01,092681,Semenuks; Arturs,5,1,100,95
1658020681801,COGS 14B,A01,083073,Cheng; Tzu-Han,7,0,63,56
1658020687828,COGS 17,A01,092677,Semenuks; Arturs,7,0,81,74
1658020693851,COGS 100,A01,083619,Allen; Michael Gordon,17,0,70,53
1658020699875,COGS 101A,A01,083621,Davis; Joshua Daniel,9,0,68,59
1658020705898,COGS 101B,A01,091572,Allen; Michael Gordon,14,0,65,51
1658020711926,COGS 101C,A01,083625,Delgado; Tania,17,0,35,18
1658020717949,COGS 107A,A01,083627,Boyle; Mary E. T.,14,0,60,46
1658020723975,COGS 118A,A01,083075,Gupta; Anjum,21,0,76,55
1658020730003,CSE 3,A50,083646,Miranda; Gregory Joseph,24,0,50,26
1658020736026,CSE 8A,A50,083650,Miranda; Gregory Joseph,17,1,56,39
1658020742049,CSE 11,A01,083080,Cao; Yingjun,7,15,40,33
1658020748076,CSE 12,A01,083652,Krause-Levy; Sophia Louisa,30,1,120,90
1658020754100,CSE 15L,A01,083654,Morris; Justin Loren,9,0,50,41
1658020754100,CSE 15L,A02,083655,Morris; Justin Loren,11,0,50,39
1658020760122,CSE 20,A01,083657,Tran; Khoa Dang,39,0,80,41
1658020766149,CSE 21,A01,095574,Bach; Quang Tran,23,0,48,25
1658020772173,CSE 30,A01,083084,Eldon; John,8,0,80,72
1658020772173,CSE 30,B01,095061,Bhaskar; Nishant,9,0,50,41
1658020778270,CSE 100,A01,083659,Cao; Yingjun,5,4,70,65
1658020784293,CSE 134B,A01,083661,Powell; Thomas Allan,25,0,100,75
1658020790321,CSE 140,A01,083663,Gungor; Onat,17,0,85,68
1658020796345,CSE 140L,A01,083088,Eldon; John,23,0,100,77
1658020802371,CSE 175,A01,083665,Kumar; Rakesh,3,0,25,22
1658020808396,CSE 190,A00,092507,Dubnov; Shlomo,8,0,20,12
1658020814418,ECE 45,A01,083139,Congero; Spencer William,7,0,75,68
1658020820446,ECE 65,A50,083695,Saad; Andrew S,12,0,30,18
1658020820446,ECE 65,A51,095125,Saad; Andrew S,24,0,26,2
1658020826472,ECE 109,A01,091882,Touri; Behrouz,21,0,70,49
1658020832499,ECE 180,A00,083140,Abi Samra; Nicholas Camill,1,0,30,29
1658020832499,ECE 180,B00,083141,Abi Samra; Nicholas Camill,0,0,30,30
1658020838525,MATH 10A,A01,083735,Patchell; Gregory David,2,0,30,28
1658020838525,MATH 10A,A02,083736,Patchell; Gregory David,20,0,30,10
1658020838525,MATH 10A,A03,083737,Patchell; Gregory David,16,0,30,14
1658020844548,MATH 10B,A01,083207,Lim; Seonhee,9,0,34,25
1658020844548,MATH 10B,A02,083208,Lim; Seonhee,10,0,35,25
1658020844548,MATH 10B,A03,093472,Lim; Seonhee,7,0,34,27
1658020844548,MATH 10B,B01,083739,Sinha; Shubham,14,0,30,16
1658020850578,MATH 18,A01,083743,Cinel; Cameron Alexander,9,0,30,21
1658020850578,MATH 18,A02,083744,Cinel; Cameron Alexander,18,0,30,12
1658020850578,MATH 18,A03,083745,Cinel; Cameron Alexander,10,0,30,20
1658020850578,MATH 18,B01,083748,Rideout; David Porter,5,0,37,32
1658020850578,MATH 18,B02,083749,Rideout; David Porter,5,0,36,31
1658020850578,MATH 18,B03,083750,Rideout; David Porter,3,0,37,34
1658020850578,MATH 18,B04,083751,Rideout; David Porter,7,0,36,29
1658020850578,MATH 18,B05,093473,Rideout; David Porter,7,0,36,29
1658020850578,MATH 18,B06,093474,Rideout; David Porter,6,0,36,30
1658020856604,MATH 20A,A01,083754,Zheng; Zequn,14,0,40,26
1658020862628,MATH 20B,A01,083756,Briones; Jor-el Thomas Caparas,4,0,36,32
1658020862628,MATH 20B,A02,083757,Briones; Jor-el Thomas Caparas,1,0,36,35
1658020862628,MATH 20B,A03,093475,Briones; Jor-el Thomas Caparas,3,0,36,33
1658020868651,MATH 20C,A01,083760,Briones; Jor-el Thomas Caparas,1,0,35,34
1658020868651,MATH 20C,A02,083761,Briones; Jor-el Thomas Caparas,8,0,35,27
1658020868651,MATH 20C,A03,093476,Briones; Jor-el Thomas Caparas,0,1,36,36
1658020868651,MATH 20C,B01,083762,Bach; Quang Tran,1,0,30,29
1658020874675,MATH 20D,A01,083765,Tran; Brian Kha,5,0,30,25
1658020874675,MATH 20D,A02,083766,Tran; Brian Kha,5,0,30,25
1658020874675,MATH 20D,A03,083767,Tran; Brian Kha,6,0,30,24
1658020880699,MATH 20E,A01,083771,Ganguly; Soumya,12,0,32,20
1658020880699,MATH 20E,A02,083772,Ganguly; Soumya,7,0,32,25
1658020880699,MATH 20E,B01,083773,Ciotti; Benjamin,20,0,35,15
1658020880699,MATH 20E,B02,083774,Ciotti; Benjamin,18,0,35,17
1658020886723,MATH 103A,A01,083777,Greenfeld; Be'Eri,6,0,36,30
1658020886723,MATH 103A,A02,083778,Greenfeld; Be'Eri,5,0,36,31
1658020886723,MATH 103A,A03,093561,Greenfeld; Be'Eri,7,0,36,29
1658020886723,MATH 103A,B01,083779,Greenfeld; Be'Eri,8,0,36,28
1658020886723,MATH 103A,B02,083780,Greenfeld; Be'Eri,4,0,36,32
1658020886723,MATH 103A,B03,093562,Greenfeld; Be'Eri,3,0,36,33
1658020892752,MATH 105,A01,085443,Carter; Anne Toulson,15,0,35,20
1658020892752,MATH 105,A02,093477,Carter; Anne Toulson,20,0,35,15
1658020898776,MATH 109,A01,083213,Ganzberger; Geoffrey Michael,3,0,34,31
1658020898776,MATH 109,A02,083214,Ganzberger; Geoffrey Michael,4,0,34,30
1658020898776,MATH 109,A03,093478,Ganzberger; Geoffrey Michael,2,0,34,32
1658020898776,MATH 109,B01,083215,Ganzberger; Geoffrey Michael,3,0,32,29
1658020898776,MATH 109,B02,083216,Ganzberger; Geoffrey Michael,3,0,32,29
1658020898776,MATH 109,B03,093479,Ganzberger; Geoffrey Michael,8,0,32,24
1658020904800,MATH 142A,A01,083219,Chow; Bennett,7,0,32,25
1658020904800,MATH 142A,A02,083220,Chow; Bennett,10,0,32,22
1658020904800,MATH 142A,A03,093480,Chow; Bennett,9,0,32,23
1658020904800,MATH 142A,B03,093481,Chow; Bennett,8,0,32,24
1658020904800,MATH 142A,B04,093558,Chow; Bennett,14,0,32,18
1658020904800,MATH 142A,B05,093559,Chow; Bennett,7,0,32,25
1658020910827,MATH 193A,A01,083224,Rotar; Vladimir,9,0,34,25
1658020910827,MATH 193A,A02,083225,Rotar; Vladimir,11,0,34,23
1658020910827,MATH 193A,A03,083781,Rotar; Vladimir,5,0,34,29
1658020910827,MATH 193A,A04,083782,Rotar; Vladimir,12,0,34,22
1658020910827,MATH 193A,A05,093482,Rotar; Vladimir,11,0,34,23
1658020916853,MATH 197,001,091859,McAuley; Julian John,9999,0,9999,0
1658020916853,MATH 197,002,095566,Kedlaya; Kiran S.,9997,0,9999,2
1658020916853,MATH 197,003,095567,Xiao; Ming,9999,0,9999,0
1658020916853,MATH 197,004,095571,Perols; Johan Lars,9998,0,9999,1
1658020923903,COGS 9,A01,083615,Shannon; Kyle Michael,11,0,75,64
1658020929931,COGS 11,A01,083617,Boyle; Mary E. T.,23,0,48,25
1658020935953,COGS 13,A01,083071,Bastos; Amalia Pinkusfeld,12,0,71,59
1658020941977,COGS 14A,A01,092681,Semenuks; Arturs,5,1,100,95
1658020948004,COGS 14B,A01,083073,Cheng; Tzu-Han,7,0,63,56
1658020954036,COGS 17,A01,092677,Semenuks; Arturs,7,0,81,74
1658020960059,COGS 100,A01,083619,Allen; Michael Gordon,17,0,70,53
1658020966081,COGS 101A,A01,083621,Davis; Joshua Daniel,9,0,68,59
1658020972108,COGS 101B,A01,091572,Allen; Michael Gordon,14,0,65,51
1658020978132,COGS 101C,A01,083625,Delgado; Tania,17,0,35,18
1658020984155,COGS 107A,A01,083627,Boyle; Mary E. T.,14,0,60,46
1658020990182,COGS 118A,A01,083075,Gupta; Anjum,21,0,76,55
1658020996206,CSE 3,A50,083646,Miranda; Gregory Joseph,24,0,50,26
1658021002229,CSE 8A,A50,083650,Miranda; Gregory Joseph,17,1,56,39
1658021008256,CSE 11,A01,083080,Cao; Yingjun,7,15,40,33
1658021014281,CSE 12,A01,083652,Krause-Levy; Sophia Louisa,30,1,120,90
1658021020310,CSE 15L,A01,083654,Morris; Justin Loren,9,0,50,41
1658021020310,CSE 15L,A02,083655,Morris; Justin Loren,11,0,50,39
1658021026337,CSE 20,A01,083657,Tran; Khoa Dang,39,0,80,41
1658021032359,CSE 21,A01,095574,Bach; Quang Tran,23,0,48,25
1658021038389,CSE 30,A01,083084,Eldon; John,8,0,80,72
1658021038389,CSE 30,B01,095061,Bhaskar; Nishant,9,0,50,41
1658021044416,CSE 100,A01,083659,Cao; Yingjun,5,4,70,65
1658021050444,CSE 134B,A01,083661,Powell; Thomas Allan,25,0,100,75
1658021056465,CSE 140,A01,083663,Gungor; Onat,17,0,85,68
1658021062489,CSE 140L,A01,083088,Eldon; John,23,0,100,77
1658021068512,CSE 175,A01,083665,Kumar; Rakesh,3,0,25,22
1658021074535,CSE 190,A00,092507,Dubnov; Shlomo,8,0,20,12
1658021080558,ECE 45,A01,083139,Congero; Spencer William,7,0,75,68
1658021086583,ECE 65,A50,083695,Saad; Andrew S,12,0,30,18
1658021086583,ECE 65,A51,095125,Saad; Andrew S,24,0,26,2
1658021092607,ECE 109,A01,091882,Touri; Behrouz,21,0,70,49
1658021098629,ECE 180,A00,083140,Abi Samra; Nicholas Camill,1,0,30,29
1658021098629,ECE 180,B00,083141,Abi Samra; Nicholas Camill,0,0,30,30
1658021104653,MATH 10A,A01,083735,Patchell; Gregory David,2,0,30,28
1658021104653,MATH 10A,A02,083736,Patchell; Gregory David,20,0,30,10
1658021104653,MATH 10A,A03,083737,Patchell; Gregory David,16,0,30,14
1658021110675,MATH 10B,A01,083207,Lim; Seonhee,9,0,34,25
1658021110675,MATH 10B,A02,083208,Lim; Seonhee,10,0,35,25
1658021110675,MATH 10B,A03,093472,Lim; Seonhee,7,0,34,27
1658021110675,MATH 10B,B01,083739,Sinha; Shubham,14,0,30,16
1658021116699,MATH 18,A01,083743,Cinel; Cameron Alexander,9,0,30,21
1658021116699,MATH 18,A02,083744,Cinel; Cameron Alexander,18,0,30,12
1658021116699,MATH 18,A03,083745,Cinel; Cameron Alexander,10,0,30,20
1658021116699,MATH 18,B01,083748,Rideout; David Porter,5,0,37,32
1658021116699,MATH 18,B02,083749,Rideout; David Porter,5,0,36,31
1658021116699,MATH 18,B03,083750,Rideout; David Porter,3,0,37,34
1658021116699,MATH 18,B04,083751,Rideout; David Porter,7,0,36,29
1658021116699,MATH 18,B05,093473,Rideout; David Porter,7,0,36,29
1658021116699,MATH 18,B06,093474,Rideout; David Porter,6,0,36,30
1658021122724,MATH 20A,A01,083754,Zheng; Zequn,14,0,40,26
1658021128751,MATH 20B,A01,083756,Briones; Jor-el Thomas Caparas,4,0,36,32
1658021128751,MATH 20B,A02,083757,Briones; Jor-el Thomas Caparas,1,0,36,35
1658021128751,MATH 20B,A03,093475,Briones; Jor-el Thomas Caparas,3,0,36,33
1658021134774,MATH 20C,A01,083760,Briones; Jor-el Thomas Caparas,1,0,35,34
1658021134774,MATH 20C,A02,083761,Briones; Jor-el Thomas Caparas,8,0,35,27
1658021134774,MATH 20C,A03,093476,Briones; Jor-el Thomas Caparas,0,1,36,36
1658021134774,MATH 20C,B01,083762,Bach; Quang Tran,1,0,30,29
1658021140796,MATH 20D,A01,083765,Tran; Brian Kha,5,0,30,25
1658021140796,MATH 20D,A02,083766,Tran; Brian Kha,5,0,30,25
1658021140796,MATH 20D,A03,083767,Tran; Brian Kha,6,0,30,24
1658021146825,MATH 20E,A01,083771,Ganguly; Soumya,12,0,32,20
1658021146825,MATH 20E,A02,083772,Ganguly; Soumya,7,0,32,25
1658021146825,MATH 20E,B01,083773,Ciotti; Benjamin,20,0,35,15
1658021146825,MATH 20E,B02,083774,Ciotti; Benjamin,18,0,35,17
1658021152846,MATH 103A,A01,083777,Greenfeld; Be'Eri,6,0,36,30
1658021152846,MATH 103A,A02,083778,Greenfeld; Be'Eri,5,0,36,31
1658021152846,MATH 103A,A03,093561,Greenfeld; Be'Eri,7,0,36,29
1658021152846,MATH 103A,B01,083779,Greenfeld; Be'Eri,8,0,36,28
1658021152846,MATH 103A,B02,083780,Greenfeld; Be'Eri,4,0,36,32
1658021152846,MATH 103A,B03,093562,Greenfeld; Be'Eri,3,0,36,33
1658021158878,MATH 105,A01,085443,Carter; Anne Toulson,15,0,35,20
1658021158878,MATH 105,A02,093477,Carter; Anne Toulson,20,0,35,15
1658021164900,MATH 109,A01,083213,Ganzberger; Geoffrey Michael,3,0,34,31
1658021164900,MATH 109,A02,083214,Ganzberger; Geoffrey Michael,4,0,34,30
1658021164900,MATH 109,A03,093478,Ganzberger; Geoffrey Michael,2,0,34,32
1658021164900,MATH 109,B01,083215,Ganzberger; Geoffrey Michael,3,0,32,29
1658021164900,MATH 109,B02,083216,Ganzberger; Geoffrey Michael,3,0,32,29
1658021164900,MATH 109,B03,093479,Ganzberger; Geoffrey Michael,8,0,32,24
1658021170928,MATH 142A,A01,083219,Chow; Bennett,7,0,32,25
1658021170928,MATH 142A,A02,083220,Chow; Bennett,10,0,32,22
1658021170928,MATH 142A,A03,093480,Chow; Bennett,9,0,32,23
1658021170928,MATH 142A,B03,093481,Chow; Bennett,8,0,32,24
1658021170928,MATH 142A,B04,093558,Chow; Bennett,14,0,32,18
1658021170928,MATH 142A,B05,093559,Chow; Bennett,7,0,32,25
1658021176951,MATH 193A,A01,083224,Rotar; Vladimir,9,0,34,25
1658021176951,MATH 193A,A02,083225,Rotar; Vladimir,11,0,34,23
1658021176951,MATH 193A,A03,083781,Rotar; Vladimir,5,0,34,29
1658021176951,MATH 193A,A04,083782,Rotar; Vladimir,12,0,34,22
1658021176951,MATH 193A,A05,093482,Rotar; Vladimir,11,0,34,23
1658021182977,MATH 197,001,091859,McAuley; Julian John,9999,0,9999,0
1658021182977,MATH 197,002,095566,Kedlaya; Kiran S.,9997,0,9999,2
1658021182977,MATH 197,003,095567,Xiao; Ming,9999,0,9999,0
1658021182977,MATH 197,004,095571,Perols; Johan Lars,9998,0,9999,1
1658021190033,COGS 9,A01,083615,Shannon; Kyle Michael,11,0,75,64
1658021196056,COGS 11,A01,083617,Boyle; Mary E. T.,23,0,48,25
1658021202085,COGS 13,A01,083071,Bastos; Amalia Pinkusfeld,12,0,71,59
1658021208108,COGS 14A,A01,092681,Semenuks; Arturs,5,1,100,95
1658021214135,COGS 14B,A01,083073,Cheng; Tzu-Han,7,0,63,56
1658021220162,COGS 17,A01,092677,Semenuks; Arturs,7,0,81,74
1658021226189,COGS 100,A01,083619,Allen; Michael Gordon,17,0,70,53
1658021232214,COGS 101A,A01,083621,Davis; Joshua Daniel,9,0,68,59
1658021238240,COGS 101B,A01,091572,Allen; Michael Gordon,14,0,65,51
1658021244264,COGS 101C,A01,083625,Delgado; Tania,17,0,35,18
1658021250292,COGS 107A,A01,083627,Boyle; Mary E. T.,14,0,60,46
1658021256318,COGS 118A,A01,083075,Gupta; Anjum,21,0,76,55
1658021262343,CSE 3,A50,083646,Miranda; Gregory Joseph,24,0,50,26
1658021268370,CSE 8A,A50,083650,Miranda; Gregory Joseph,17,1,56,39
1658021274392,CSE 11,A01,083080,Cao; Yingjun,7,15,40,33
1658021280415,CSE 12,A01,083652,Krause-Levy; Sophia Louisa,30,1,120,90
1658021286443,CSE 15L,A01,083654,Morris; Justin Loren,9,0,50,41
1658021286443,CSE 15L,A02,083655,Morris; Justin Loren,11,0,50,39
1658021292465,CSE 20,A01,083657,Tran; Khoa Dang,39,0,80,41
1658021298493,CSE 21,A01,095574,Bach; Quang Tran,23,0,48,25
1658021304521,CSE 30,A01,083084,Eldon; John,8,0,80,72
1658021304521,CSE 30,B01,095061,Bhaskar; Nishant,9,0,50,41
1658021310543,CSE 100,A01,083659,Cao; Yingjun,5,4,70,65
1658021316571,CSE 134B,A01,083661,Powell; Thomas Allan,25,0,100,75
1658021322595,CSE 140,A01,083663,Gungor; Onat,17,0,85,68
1658021328621,CSE 140L,A01,083088,Eldon; John,23,0,100,77
1658021334643,CSE 175,A01,083665,Kumar; Rakesh,3,0,25,22
1658021340669,CSE 190,A00,092507,Dubnov; Shlomo,8,0,20,12
1658021346700,ECE 45,A01,083139,Congero; Spencer William,7,0,75,68
1658021352724,ECE 65,A50,083695,Saad; Andrew S,12,0,30,18
1658021352724,ECE 65,A51,095125,Saad; Andrew S,24,0,26,2
1658021358751,ECE 109,A01,091882,Touri; Behrouz,21,0,70,49
1658021364773,ECE 180,A00,083140,Abi Samra; Nicholas Camill,1,0,30,29
1658021364773,ECE 180,B00,083141,Abi Samra; Nicholas Camill,0,0,30,30
1658021370795,MATH 10A,A01,083735,Patchell; Gregory David,2,0,30,28
1658021370795,MATH 10A,A02,083736,Patchell; Gregory David,20,0,30,10
1658021370795,MATH 10A,A03,083737,Patchell; Gregory David,16,0,30,14
1658021376898,MATH 10B,A01,083207,Lim; Seonhee,9,0,34,25
1658021376898,MATH 10B,A02,083208,Lim; Seonhee,10,0,35,25
1658021376898,MATH 10B,A03,093472,Lim; Seonhee,7,0,34,27
1658021376898,MATH 10B,B01,083739,Sinha; Shubham,14,0,30,16
1658021382924,MATH 18,A01,083743,Cinel; Cameron Alexander,9,0,30,21
1658021382924,MATH 18,A02,083744,Cinel; Cameron Alexander,18,0,30,12
1658021382924,MATH 18,A03,083745,Cinel; Cameron Alexander,10,0,30,20
1658021382924,MATH 18,B01,083748,Rideout; David Porter,5,0,37,32
1658021382924,MATH 18,B02,083749,Rideout; David Porter,5,0,36,31
1658021382924,MATH 18,B03,083750,Rideout; David Porter,3,0,37,34
1658021382924,MATH 18,B04,083751,Rideout; David Porter,7,0,36,29
1658021382924,MATH 18,B05,093473,Rideout; David Porter,7,0,36,29
1658021382924,MATH 18,B06,093474,Rideout; David Porter,6,0,36,30
1658021388946,MATH 20A,A01,083754,Zheng; Zequn,14,0,40,26
1658021394968,MATH 20B,A01,083756,Briones; Jor-el Thomas Caparas,4,0,36,32
1658021394968,MATH 20B,A02,083757,Briones; Jor-el Thomas Caparas,1,0,36,35
1658021394968,MATH 20B,A03,093475,Briones; Jor-el Thomas Caparas,3,0,36,33
1658021401000,MATH 20C,A01,083760,Briones; Jor-el Thomas Caparas,1,0,35,34
1658021401000,MATH 20C,A02,083761,Briones; Jor-el Thomas Caparas,8,0,35,27
1658021401000,MATH 20C,A03,093476,Briones; Jor-el Thomas Caparas,0,1,36,36
1658021401000,MATH 20C,B01,083762,Bach; Quang Tran,1,0,30,29
1658021407029,MATH 20D,A01,083765,Tran; Brian Kha,5,0,30,25
1658021407029,MATH 20D,A02,083766,Tran; Brian Kha,5,0,30,25
1658021407029,MATH 20D,A03,083767,Tran; Brian Kha,6,0,30,24
1658021413053,MATH 20E,A01,083771,Ganguly; Soumya,12,0,32,20
1658021413053,MATH 20E,A02,083772,Ganguly; Soumya,7,0,32,25
1658021413053,MATH 20E,B01,083773,Ciotti; Benjamin,20,0,35,15
1658021413053,MATH 20E,B02,083774,Ciotti; Benjamin,18,0,35,17
1658021419077,MATH 103A,A01,083777,Greenfeld; Be'Eri,6,0,36,30
1658021419077,MATH 103A,A02,083778,Greenfeld; Be'Eri,5,0,36,31
1658021419077,MATH 103A,A03,093561,Greenfeld; Be'Eri,7,0,36,29
1658021419077,MATH 103A,B01,083779,Greenfeld; Be'Eri,8,0,36,28
1658021419077,MATH 103A,B02,083780,Greenfeld; Be'Eri,4,0,36,32
1658021419077,MATH 103A,B03,093562,Greenfeld; Be'Eri,3,0,36,33
1658021425099,MATH 105,A01,085443,Carter; Anne Toulson,15,0,35,20
1658021425099,MATH 105,A02,093477,Carter; Anne Toulson,20,0,35,15
1658021431121,MATH 109,A01,083213,Ganzberger; Geoffrey Michael,3,0,34,31
1658021431121,MATH 109,A02,083214,Ganzberger; Geoffrey Michael,4,0,34,30
1658021431121,MATH 109,A03,093478,Ganzberger; Geoffrey Michael,2,0,34,32
1658021431121,MATH 109,B01,083215,Ganzberger; Geoffrey Michael,3,0,32,29
1658021431121,MATH 109,B02,083216,Ganzberger; Geoffrey Michael,3,0,32,29
1658021431121,MATH 109,B03,093479,Ganzberger; Geoffrey Michael,8,0,32,24
1658021437152,MATH 142A,A01,083219,Chow; Bennett,7,0,32,25
1658021437152,MATH 142A,A02,083220,Chow; Bennett,10,0,32,22
1658021437152,MATH 142A,A03,093480,Chow; Bennett,9,0,32,23
1658021437152,MATH 142A,B03,093481,Chow; Bennett,8,0,32,24
1658021437152,MATH 142A,B04,093558,Chow; Bennett,14,0,32,18
1658021437152,MATH 142A,B05,093559,Chow; Bennett,7,0,32,25
1658021443173,MATH 193A,A01,083224,Rotar; Vladimir,9,0,34,25
1658021443173,MATH 193A,A02,083225,Rotar; Vladimir,11,0,34,23
1658021443173,MATH 193A,A03,083781,Rotar; Vladimir,5,0,34,29
1658021443173,MATH 193A,A04,083782,Rotar; Vladimir,12,0,34,22
1658021443173,MATH 193A,A05,093482,Rotar; Vladimir,11,0,34,23
1658021449196,MATH 197,001,091859,McAuley; Julian John,9999,0,9999,0
1658021449196,MATH 197,002,095566,Kedlaya; Kiran S.,9997,0,9999,2
1658021449196,MATH 197,003,095567,Xiao; Ming,9999,0,9999,0
1658021449196,MATH 197,004,095571,Perols; Johan Lars,9998,0,9999,1
1658021456264,COGS 9,A01,083615,Shannon; Kyle Michael,11,0,75,64
1658021462286,COGS 11,A01,083617,Boyle; Mary E. T.,23,0,48,25
1658021468310,COGS 13,A01,083071,Bastos; Amalia Pinkusfeld,12,0,71,59
1658021474336,COGS 14A,A01,092681,Semenuks; Arturs,5,1,100,95
1658021480364,COGS 14B,A01,083073,Cheng; Tzu-Han,7,0,63,56
1658021486386,COGS 17,A01,092677,Semenuks; Arturs,7,0,81,74
1658021492407,COGS 100,A01,083619,Allen; Michael Gordon,17,0,70,53
1658021498444,COGS 101A,A01,083621,Davis; Joshua Daniel,9,0,68,59
1658021504467,COGS 101B,A01,091572,Allen; Michael Gordon,14,0,65,51
1658021510493,COGS 101C,A01,083625,Delgado; Tania,17,0,35,18
1658021516514,COGS 107A,A01,083627,Boyle; Mary E. T.,14,0,60,46
1658021522538,COGS 118A,A01,083075,Gupta; Anjum,21,0,76,55
1658021528559,CSE 3,A50,083646,Miranda; Gregory Joseph,24,0,50,26
1658021534586,CSE 8A,A50,083650,Miranda; Gregory Joseph,17,1,56,39
1658021540609,CSE 11,A01,083080,Cao; Yingjun,7,15,40,33
1658021546632,CSE 12,A01,083652,Krause-Levy; Sophia Louisa,30,1,120,90
1658021552658,CSE 15L,A01,083654,Morris; Justin Loren,9,0,50,41
1658021552658,CSE 15L,A02,083655,Morris; Justin Loren,11,0,50,39
1658021558684,CSE 20,A01,083657,Tran; Khoa Dang,39,0,80,41
1658021564717,CSE 21,A01,095574,Bach; Quang Tran,23,0,48,25
1658021570740,CSE 30,A01,083084,Eldon; John,8,0,80,72
1658021570740,CSE 30,B01,095061,Bhaskar; Nishant,9,0,50,41
1658021576766,CSE 100,A01,083659,Cao; Yingjun,5,4,70,65
1658021582792,CSE 134B,A01,083661,Powell; Thomas Allan,25,0,100,75
1658021588814,CSE 140,A01,083663,Gungor; Onat,17,0,85,68
1658021594842,CSE 140L,A01,083088,Eldon; John,23,0,100,77
1658021600864,CSE 175,A01,083665,Kumar; Rakesh,3,0,25,22
1658021606890,CSE 190,A00,092507,Dubnov; Shlomo,8,0,20,12
1658021612917,ECE 45,A01,083139,Congero; Spencer William,7,0,75,68
1658021618944,ECE 65,A50,083695,Saad; Andrew S,12,0,30,18
1658021618944,ECE 65,A51,095125,Saad; Andrew S,24,0,26,2
1658021624968,ECE 109,A01,091882,Touri; Behrouz,21,0,70,49
1658021630994,ECE 180,A00,083140,Abi Samra; Nicholas Camill,1,0,30,29
1658021630994,ECE 180,B00,083141,Abi Samra; Nicholas Camill,0,0,30,30
1658021637034,MATH 10A,A01,083735,Patchell; Gregory David,2,0,30,28
1658021637034,MATH 10A,A02,083736,Patchell; Gregory David,20,0,30,10
1658021637034,MATH 10A,A03,083737,Patchell; Gregory David,16,0,30,14
1658021643063,MATH 10B,A01,083207,Lim; Seonhee,9,0,34,25
1658021643063,MATH 10B,A02,083208,Lim; Seonhee,10,0,35,25
1658021643063,MATH 10B,A03,093472,Lim; Seonhee,7,0,34,27
1658021643063,MATH 10B,B01,083739,Sinha; Shubham,14,0,30,16
1658021649094,MATH 18,A01,083743,Cinel; Cameron Alexander,9,0,30,21
1658021649094,MATH 18,A02,083744,Cinel; Cameron Alexander,18,0,30,12
1658021649094,MATH 18,A03,083745,Cinel; Cameron Alexander,10,0,30,20
1658021649094,MATH 18,B01,083748,Rideout; David Porter,5,0,37,32
1658021649094,MATH 18,B02,083749,Rideout; David Porter,5,0,36,31
1658021649094,MATH 18,B03,083750,Rideout; David Porter,3,0,37,34
1658021649094,MATH 18,B04,083751,Rideout; David Porter,7,0,36,29
1658021649094,MATH 18,B05,093473,Rideout; David Porter,7,0,36,29
1658021649094,MATH 18,B06,093474,Rideout; David Porter,6,0,36,30
1658021655116,MATH 20A,A01,083754,Zheng; Zequn,14,0,40,26
1658021661138,MATH 20B,A01,083756,Briones; Jor-el Thomas Caparas,4,0,36,32
1658021661138,MATH 20B,A02,083757,Briones; Jor-el Thomas Caparas,1,0,36,35
1658021661138,MATH 20B,A03,093475,Briones; Jor-el Thomas Caparas,3,0,36,33
1658021667161,MATH 20C,A01,083760,Briones; Jor-el Thomas Caparas,1,0,35,34
1658021667161,MATH 20C,A02,083761,Briones; Jor-el Thomas Caparas,8,0,35,27
1658021667161,MATH 20C,A03,093476,Briones; Jor-el Thomas Caparas,0,1,36,36
1658021667161,MATH 20C,B01,083762,Bach; Quang Tran,1,0,30,29
1658021673184,MATH 20D,A01,083765,Tran; Brian Kha,5,0,30,25
1658021673184,MATH 20D,A02,083766,Tran; Brian Kha,5,0,30,25
1658021673184,MATH 20D,A03,083767,Tran; Brian Kha,6,0,30,24
1658021679207,MATH 20E,A01,083771,Ganguly; Soumya,12,0,32,20
1658021679207,MATH 20E,A02,083772,Ganguly; Soumya,7,0,32,25
1658021679207,MATH 20E,B01,083773,Ciotti; Benjamin,20,0,35,15
1658021679207,MATH 20E,B02,083774,Ciotti; Benjamin,18,0,35,17
1658021685238,MATH 103A,A01,083777,Greenfeld; Be'Eri,6,0,36,30
1658021685238,MATH 103A,A02,083778,Greenfeld; Be'Eri,5,0,36,31
1658021685238,MATH 103A,A03,093561,Greenfeld; Be'Eri,7,0,36,29
1658021685238,MATH 103A,B01,083779,Greenfeld; Be'Eri,8,0,36,28
1658021685238,MATH 103A,B02,083780,Greenfeld; Be'Eri,4,0,36,32
1658021685238,MATH 103A,B03,093562,Greenfeld; Be'Eri,3,0,36,33
1658021691260,MATH 105,A01,085443,Carter; Anne Toulson,15,0,35,20
1658021691260,MATH 105,A02,093477,Carter; Anne Toulson,20,0,35,15
1658021697282,MATH 109,A01,083213,Ganzberger; Geoffrey Michael,3,0,34,31
1658021697282,MATH 109,A02,083214,Ganzberger; Geoffrey Michael,4,0,34,30
1658021697282,MATH 109,A03,093478,Ganzberger; Geoffrey Michael,2,0,34,32
1658021697282,MATH 109,B01,083215,Ganzberger; Geoffrey Michael,3,0,32,29
1658021697282,MATH 109,B02,083216,Ganzberger; Geoffrey Michael,3,0,32,29
1658021697282,MATH 109,B03,093479,Ganzberger; Geoffrey Michael,8,0,32,24
1658021703306,MATH 142A,A01,083219,Chow; Bennett,7,0,32,25
1658021703306,MATH 142A,A02,083220,Chow; Bennett,10,0,32,22
1658021703306,MATH 142A,A03,093480,Chow; Bennett,9,0,32,23
1658021703306,MATH 142A,B03,093481,Chow; Bennett,8,0,32,24
1658021703306,MATH 142A,B04,093558,Chow; Bennett,14,0,32,18
1658021703306,MATH 142A,B05,093559,Chow; Bennett,7,0,32,25
1658021709346,MATH 193A,A01,083224,Rotar; Vladimir,9,0,34,25
1658021709346,MATH 193A,A02,083225,Rotar; Vladimir,11,0,34,23
1658021709346,MATH 193A,A03,083781,Rotar; Vladimir,5,0,34,29
1658021709346,MATH 193A,A04,083782,Rotar; Vladimir,12,0,34,22
1658021709346,MATH 193A,A05,093482,Rotar; Vladimir,11,0,34,23
1658021715369,MATH 197,001,091859,McAuley; Julian John,9999,0,9999,0
1658021715369,MATH 197,002,095566,Kedlaya; Kiran S.,9997,0,9999,2
1658021715369,MATH 197,003,095567,Xiao; Ming,9999,0,9999,0
1658021715369,MATH 197,004,095571,Perols; Johan Lars,9998,0,9999,1
1658021722430,COGS 9,A01,083615,Shannon; Kyle Michael,11,0,75,64
1658021728457,COGS 11,A01,083617,Boyle; Mary E. T.,23,0,48,25
1658021734480,COGS 13,A01,083071,Bastos; Amalia Pinkusfeld,12,0,71,59
1658021740502,COGS 14A,A01,092681,Semenuks; Arturs,5,1,100,95
1658021746527,COGS 14B,A01,083073,Cheng; Tzu-Han,7,0,63,56
1658021752549,COGS 17,A01,092677,Semenuks; Arturs,7,0,81,74
1658021758574,COGS 100,A01,083619,Allen; Michael Gordon,17,0,70,53
1658021764596,COGS 101A,A01,083621,Davis; Joshua Daniel,9,0,68,59
1658021770623,COGS 101B,A01,091572,Allen; Michael Gordon,14,0,65,51
1658021776649,COGS 101C,A01,083625,Delgado; Tania,17,0,35,18
1658021782674,COGS 107A,A01,083627,Boyle; Mary E. T.,14,0,60,46
1658021788696,COGS 118A,A01,083075,Gupta; Anjum,21,0,76,55
1658021794719,CSE 3,A50,083646,Miranda; Gregory Joseph,24,0,50,26
1658021800746,CSE 8A,A50,083650,Miranda; Gregory Joseph,17,1,56,39
1658021806771,CSE 11,A01,083080,Cao; Yingjun,7,15,40,33
1658021812796,CSE 12,A01,083652,Krause-Levy; Sophia Louisa,30,1,120,90
1658021818818,CSE 15L,A01,083654,Morris; Justin Loren,9,0,50,41
1658021818818,CSE 15L,A02,083655,Morris; Justin Loren,11,0,50,39
1658021824846,CSE 20,A01,083657,Tran; Khoa Dang,39,0,80,41
1658021830872,CSE 21,A01,095574,Bach; Quang Tran,23,0,48,25
1658021836895,CSE 30,A01,083084,Eldon; John,8,0,80,72
1658021836895,CSE 30,B01,095061,Bhaskar; Nishant,9,0,50,41
1658021842921,CSE 100,A01,083659,Cao; Yingjun,5,4,70,65
1658021848947,CSE 134B,A01,083661,Powell; Thomas Allan,25,0,100,75
1658021854971,CSE 140,A01,083663,Gungor; Onat,17,0,85,68
1658021860997,CSE 140L,A01,083088,Eldon; John,23,0,100,77
1658021867023,CSE 175,A01,083665,Kumar; Rakesh,3,0,25,22
1658021873046,CSE 190,A00,092507,Dubnov; Shlomo,8,0,20,12
1658021879073,ECE 45,A01,083139,Congero; Spencer William,7,0,75,68
1658021885100,ECE 65,A50,083695,Saad; Andrew S,12,0,30,18
1658021885100,ECE 65,A51,095125,Saad; Andrew S,24,0,26,2
1658021891125,ECE 109,A01,091882,Touri; Behrouz,21,0,70,49
1658021897152,ECE 180,A00,083140,Abi Samra; Nicholas Camill,1,0,30,29
1658021897152,ECE 180,B00,083141,Abi Samra; Nicholas Camill,0,0,30,30
1658021903175,MATH 10A,A01,083735,Patchell; Gregory David,2,0,30,28
1658021903175,MATH 10A,A02,083736,Patchell; Gregory David,20,0,30,10
1658021903175,MATH 10A,A03,083737,Patchell; Gregory David,16,0,30,14
1658021909198,MATH 10B,A01,083207,Lim; Seonhee,9,0,34,25
1658021909198,MATH 10B,A02,083208,Lim; Seonhee,10,0,35,25
1658021909198,MATH 10B,A03,093472,Lim; Seonhee,7,0,34,27
1658021909198,MATH 10B,B01,083739,Sinha; Shubham,14,0,30,16
1658021915228,MATH 18,A01,083743,Cinel; Cameron Alexander,9,0,30,21
1658021915228,MATH 18,A02,083744,Cinel; Cameron Alexander,18,0,30,12
1658021915228,MATH 18,A03,083745,Cinel; Cameron Alexander,10,0,30,20
1658021915228,MATH 18,B01,083748,Rideout; David Porter,5,0,37,32
1658021915228,MATH 18,B02,083749,Rideout; David Porter,5,0,36,31
1658021915228,MATH 18,B03,083750,Rideout; David Porter,3,0,37,34
1658021915228,MATH 18,B04,083751,Rideout; David Porter,7,0,36,29
1658021915228,MATH 18,B05,093473,Rideout; David Porter,7,0,36,29
1658021915228,MATH 18,B06,093474,Rideout; David Porter,6,0,36,30
1658021921252,MATH 20A,A01,083754,Zheng; Zequn,14,0,40,26
1658021927279,MATH 20B,A01,083756,Briones; Jor-el Thomas Caparas,4,0,36,32
1658021927279,MATH 20B,A02,083757,Briones; Jor-el Thomas Caparas,1,0,36,35
1658021927279,MATH 20B,A03,093475,Briones; Jor-el Thomas Caparas,3,0,36,33
1658021933304,MATH 20C,A01,083760,Briones; Jor-el Thomas Caparas,1,0,35,34
1658021933304,MATH 20C,A02,083761,Briones; Jor-el Thomas Caparas,8,0,35,27
1658021933304,MATH 20C,A03,093476,Briones; Jor-el Thomas Caparas,0,1,36,36
1658021933304,MATH 20C,B01,083762,Bach; Quang Tran,1,0,30,29
1658021939328,MATH 20D,A01,083765,Tran; Brian Kha,5,0,30,25
1658021939328,MATH 20D,A02,083766,Tran; Brian Kha,5,0,30,25
1658021939328,MATH 20D,A03,083767,Tran; Brian Kha,6,0,30,24
1658021945356,MATH 20E,A01,083771,Ganguly; Soumya,12,0,32,20
1658021945356,MATH 20E,A02,083772,Ganguly; Soumya,7,0,32,25
1658021945356,MATH 20E,B01,083773,Ciotti; Benjamin,20,0,35,15
1658021945356,MATH 20E,B02,083774,Ciotti; Benjamin,18,0,35,17
1658021951380,MATH 103A,A01,083777,Greenfeld; Be'Eri,6,0,36,30
1658021951380,MATH 103A,A02,083778,Greenfeld; Be'Eri,5,0,36,31
1658021951380,MATH 103A,A03,093561,Greenfeld; Be'Eri,7,0,36,29
1658021951380,MATH 103A,B01,083779,Greenfeld; Be'Eri,8,0,36,28
1658021951380,MATH 103A,B02,083780,Greenfeld; Be'Eri,4,0,36,32
1658021951380,MATH 103A,B03,093562,Greenfeld; Be'Eri,3,0,36,33
1658021957405,MATH 105,A01,085443,Carter; Anne Toulson,15,0,35,20
1658021957405,MATH 105,A02,093477,Carter; Anne Toulson,20,0,35,15
1658021963429,MATH 109,A01,083213,Ganzberger; Geoffrey Michael,3,0,34,31
1658021963429,MATH 109,A02,083214,Ganzberger; Geoffrey Michael,4,0,34,30
1658021963429,MATH 109,A03,093478,Ganzberger; Geoffrey Michael,2,0,34,32
1658021963429,MATH 109,B01,083215,Ganzberger; Geoffrey Michael,3,0,32,29
1658021963429,MATH 109,B02,083216,Ganzberger; Geoffrey Michael,3,0,32,29
1658021963429,MATH 109,B03,093479,Ganzberger; Geoffrey Michael,8,0,32,24
1658021969453,MATH 142A,A01,083219,Chow; Bennett,7,0,32,25
1658021969453,MATH 142A,A02,083220,Chow; Bennett,10,0,32,22
1658021969453,MATH 142A,A03,093480,Chow; Bennett,9,0,32,23
1658021969453,MATH 142A,B03,093481,Chow; Bennett,8,0,32,24
1658021969453,MATH 142A,B04,093558,Chow; Bennett,14,0,32,18
1658021969453,MATH 142A,B05,093559,Chow; Bennett,7,0,32,25
1658021975554,MATH 193A,A01,083224,Rotar; Vladimir,9,0,34,25
1658021975554,MATH 193A,A02,083225,Rotar; Vladimir,11,0,34,23
1658021975554,MATH 193A,A03,083781,Rotar; Vladimir,5,0,34,29
1658021975554,MATH 193A,A04,083782,Rotar; Vladimir,12,0,34,22
1658021975554,MATH 193A,A05,093482,Rotar; Vladimir,11,0,34,23
1658021981579,MATH 197,001,091859,McAuley; Julian John,9999,0,9999,0
1658021981579,MATH 197,002,095566,Kedlaya; Kiran S.,9997,0,9999,2
1658021981579,MATH 197,003,095567,Xiao; Ming,9999,0,9999,0
1658021981579,MATH 197,004,095571,Perols; Johan Lars,9998,0,9999,1
1658021988637,COGS 9,A01,083615,Shannon; Kyle Michael,11,0,75,64
1658021994663,COGS 11,A01,083617,Boyle; Mary E. T.,23,0,48,25
1658022000691,COGS 13,A01,083071,Bastos; Amalia Pinkusfeld,12,0,71,59
1658022006717,COGS 14A,A01,092681,Semenuks; Arturs,5,1,100,95
1658022012740,COGS 14B,A01,083073,Cheng; Tzu-Han,7,0,63,56
1658022018768,COGS 17,A01,092677,Semenuks; Arturs,7,0,81,74
1658022024794,COGS 100,A01,083619,Allen; Michael Gordon,17,0,70,53
1658022030818,COGS 101A,A01,083621,Davis; Joshua Daniel,9,0,68,59
1658022036841,COGS 101B,A01,091572,Allen; Michael Gordon,14,0,65,51
1658022042867,COGS 101C,A01,083625,Delgado; Tania,17,0,35,18
1658022048891,COGS 107A,A01,083627,Boyle; Mary E. T.,14,0,60,46
1658022054917,COGS 118A,A01,083075,Gupta; Anjum,21,0,76,55
1658022060939,CSE 3,A50,083646,Miranda; Gregory Joseph,24,0,50,26
1658022066967,CSE 8A,A50,083650,Miranda; Gregory Joseph,17,1,56,39
1658022072991,CSE 11,A01,083080,Cao; Yingjun,7,15,40,33
1658022079015,CSE 12,A01,083652,Krause-Levy; Sophia Louisa,30,1,120,90
1658022085037,CSE 15L,A01,083654,Morris; Justin Loren,9,0,50,41
1658022085037,CSE 15L,A02,083655,Morris; Justin Loren,11,0,50,39
1658022091059,CSE 20,A01,083657,Tran; Khoa Dang,39,0,80,41
1658022097087,CSE 21,A01,095574,Bach; Quang Tran,23,0,48,25
1658022103110,CSE 30,A01,083084,Eldon; John,8,0,80,72
1658022103110,CSE 30,B01,095061,Bhaskar; Nishant,9,0,50,41
1658022109137,CSE 100,A01,083659,Cao; Yingjun,5,4,70,65
1658022115160,CSE 134B,A01,083661,Powell; Thomas Allan,25,0,100,75
1658022121183,CSE 140,A01,083663,Gungor; Onat,17,0,85,68
1658022127213,CSE 140L,A01,083088,Eldon; John,23,0,100,77
1658022133237,CSE 175,A01,083665,Kumar; Rakesh,3,0,25,22
1658022139261,CSE 190,A00,092507,Dubnov; Shlomo,8,0,20,12
1658022145286,ECE 45,A01,083139,Congero; Spencer William,7,0,75,68
1658022151308,ECE 65,A50,083695,Saad; Andrew S,12,0,30,18
1658022151308,ECE 65,A51,095125,Saad; Andrew S,24,0,26,2
1658022157332,ECE 109,A01,091882,Touri; Behrouz,21,0,70,49
1658022163359,ECE 180,A00,083140,Abi Samra; Nicholas Camill,1,0,30,29
1658022163359,ECE 180,B00,083141,Abi Samra; Nicholas Camill,0,0,30,30
1658022169382,MATH 10A,A01,083735,Patchell; Gregory David,2,0,30,28
1658022169382,MATH 10A,A02,083736,Patchell; Gregory David,20,0,30,10
1658022169382,MATH 10A,A03,083737,Patchell; Gregory David,16,0,30,14
1658022175406,MATH 10B,A01,083207,Lim; Seonhee,9,0,34,25
1658022175406,MATH 10B,A02,083208,Lim; Seonhee,10,0,35,25
1658022175406,MATH 10B,A03,093472,Lim; Seonhee,7,0,34,27
1658022175406,MATH 10B,B01,083739,Sinha; Shubham,14,0,30,16
1658022181432,MATH 18,A01,083743,Cinel; Cameron Alexander,9,0,30,21
1658022181432,MATH 18,A02,083744,Cinel; Cameron Alexander,18,0,30,12
1658022181432,MATH 18,A03,083745,Cinel; Cameron Alexander,10,0,30,20
1658022181432,MATH 18,B01,083748,Rideout; David Porter,5,0,37,32
1658022181432,MATH 18,B02,083749,Rideout; David Porter,5,0,36,31
1658022181432,MATH 18,B03,083750,Rideout; David Porter,3,0,37,34
1658022181432,MATH 18,B04,083751,Rideout; David Porter,7,0,36,29
1658022181432,MATH 18,B05,093473,Rideout; David Porter,7,0,36,29
1658022181432,MATH 18,B06,093474,Rideout; David Porter,6,0,36,30
1658022187456,MATH 20A,A01,083754,Zheng; Zequn,14,0,40,26
1658022193483,MATH 20B,A01,083756,Briones; Jor-el Thomas Caparas,4,0,36,32
1658022193483,MATH 20B,A02,083757,Briones; Jor-el Thomas Caparas,1,0,36,35
1658022193483,MATH 20B,A03,093475,Briones; Jor-el Thomas Caparas,3,0,36,33
1658022199506,MATH 20C,A01,083760,Briones; Jor-el Thomas Caparas,1,0,35,34
1658022199506,MATH 20C,A02,083761,Briones; Jor-el Thomas Caparas,8,0,35,27
1658022199506,MATH 20C,A03,093476,Briones; Jor-el Thomas Caparas,0,1,36,36
1658022199506,MATH 20C,B01,083762,Bach; Quang Tran,1,0,30,29
1658022205533,MATH 20D,A01,083765,Tran; Brian Kha,5,0,30,25
1658022205533,MATH 20D,A02,083766,Tran; Brian Kha,5,0,30,25
1658022205533,MATH 20D,A03,083767,Tran; Brian Kha,6,0,30,24
1658022211561,MATH 20E,A01,083771,Ganguly; Soumya,12,0,32,20
1658022211561,MATH 20E,A02,083772,Ganguly; Soumya,7,0,32,25
1658022211561,MATH 20E,B01,083773,Ciotti; Benjamin,20,0,35,15
1658022211561,MATH 20E,B02,083774,Ciotti; Benjamin,18,0,35,17
1658022217591,MATH 103A,A01,083777,Greenfeld; Be'Eri,6,0,36,30
1658022217591,MATH 103A,A02,083778,Greenfeld; Be'Eri,5,0,36,31
1658022217591,MATH 103A,A03,093561,Greenfeld; Be'Eri,7,0,36,29
1658022217591,MATH 103A,B01,083779,Greenfeld; Be'Eri,8,0,36,28
1658022217591,MATH 103A,B02,083780,Greenfeld; Be'Eri,4,0,36,32
1658022217591,MATH 103A,B03,093562,Greenfeld; Be'Eri,3,0,36,33
1658022223626,MATH 105,A01,085443,Carter; Anne Toulson,15,0,35,20
1658022223626,MATH 105,A02,093477,Carter; Anne Toulson,20,0,35,15
1658022229649,MATH 109,A01,083213,Ganzberger; Geoffrey Michael,3,0,34,31
1658022229649,MATH 109,A02,083214,Ganzberger; Geoffrey Michael,4,0,34,30
1658022229649,MATH 109,A03,093478,Ganzberger; Geoffrey Michael,2,0,34,32
1658022229649,MATH 109,B01,083215,Ganzberger; Geoffrey Michael,3,0,32,29
1658022229649,MATH 109,B02,083216,Ganzberger; Geoffrey Michael,3,0,32,29
1658022229649,MATH 109,B03,093479,Ganzberger; Geoffrey Michael,8,0,32,24
1658022235673,MATH 142A,A01,083219,Chow; Bennett,7,0,32,25
1658022235673,MATH 142A,A02,083220,Chow; Bennett,10,0,32,22
1658022235673,MATH 142A,A03,093480,Chow; Bennett,9,0,32,23
1658022235673,MATH 142A,B03,093481,Chow; Bennett,8,0,32,24
1658022235673,MATH 142A,B04,093558,Chow; Bennett,14,0,32,18
1658022235673,MATH 142A,B05,093559,Chow; Bennett,7,0,32,25
1658022241695,MATH 193A,A01,083224,Rotar; Vladimir,9,0,34,25
1658022241695,MATH 193A,A02,083225,Rotar; Vladimir,11,0,34,23
1658022241695,MATH 193A,A03,083781,Rotar; Vladimir,5,0,34,29
1658022241695,MATH 193A,A04,083782,Rotar; Vladimir,12,0,34,22
1658022241695,MATH 193A,A05,093482,Rotar; Vladimir,11,0,34,23
1658022247718,MATH 197,001,091859,McAuley; Julian John,9999,0,9999,0
1658022247718,MATH 197,002,095566,Kedlaya; Kiran S.,9997,0,9999,2
1658022247718,MATH 197,003,095567,Xiao; Ming,9999,0,9999,0
1658022247718,MATH 197,004,095571,Perols; Johan Lars,9998,0,9999,1
1658022254773,COGS 9,A01,083615,Shannon; Kyle Michael,11,0,75,64
1658022260796,COGS 11,A01,083617,Boyle; Mary E. T.,23,0,48,25
1658022266821,COGS 13,A01,083071,Bastos; Amalia Pinkusfeld,12,0,71,59
1658022272844,COGS 14A,A01,092681,Semenuks; Arturs,5,1,100,95
1658022278867,COGS 14B,A01,083073,Cheng; Tzu-Han,7,0,63,56
1658022284894,COGS 17,A01,092677,Semenuks; Arturs,7,0,81,74
1658022290915,COGS 100,A01,083619,Allen; Michael Gordon,17,0,70,53
1658022296941,COGS 101A,A01,083621,Davis; Joshua Daniel,9,0,68,59
1658022302977,COGS 101B,A01,091572,Allen; Michael Gordon,14,0,65,51
1658022309003,COGS 101C,A01,083625,Delgado; Tania,17,0,35,18
1658022315026,COGS 107A,A01,083627,Boyle; Mary E. T.,14,0,60,46
1658022321051,COGS 118A,A01,083075,Gupta; Anjum,21,0,76,55
1658022327077,CSE 3,A50,083646,Miranda; Gregory Joseph,24,0,50,26
1658022333099,CSE 8A,A50,083650,Miranda; Gregory Joseph,17,1,56,39
1658022339125,CSE 11,A01,083080,Cao; Yingjun,7,15,40,33
1658022345152,CSE 12,A01,083652,Krause-Levy; Sophia Louisa,30,1,120,90
1658022351175,CSE 15L,A01,083654,Morris; Justin Loren,9,0,50,41
1658022351175,CSE 15L,A02,083655,Morris; Justin Loren,11,0,50,39
1658022357202,CSE 20,A01,083657,Tran; Khoa Dang,39,0,80,41
1658022363225,CSE 21,A01,095574,Bach; Quang Tran,23,0,48,25
1658022369252,CSE 30,A01,083084,Eldon; John,8,0,80,72
1658022369252,CSE 30,B01,095061,Bhaskar; Nishant,9,0,50,41
1658022375275,CSE 100,A01,083659,Cao; Yingjun,5,4,70,65
1658022381302,CSE 134B,A01,083661,Powell; Thomas Allan,25,0,100,75
1658022387326,CSE 140,A01,083663,Gungor; Onat,17,0,85,68
1658022393349,CSE 140L,A01,083088,Eldon; John,23,0,100,77
1658022399371,CSE 175,A01,083665,Kumar; Rakesh,3,0,25,22
1658022405398,CSE 190,A00,092507,Dubnov; Shlomo,8,0,20,12
1658022411421,ECE 45,A01,083139,Congero; Spencer William,7,0,75,68
1658022417445,ECE 65,A50,083695,Saad; Andrew S,12,0,30,18
1658022417445,ECE 65,A51,095125,Saad; Andrew S,24,0,26,2
1658022423472,ECE 109,A01,091882,Touri; Behrouz,21,0,70,49
1658022429498,ECE 180,A00,083140,Abi Samra; Nicholas Camill,1,0,30,29
1658022429498,ECE 180,B00,083141,Abi Samra; Nicholas Camill,0,0,30,30
1658022435522,MATH 10A,A01,083735,Patchell; Gregory David,2,0,30,28
1658022435522,MATH 10A,A02,083736,Patchell; Gregory David,20,0,30,10
1658022435522,MATH 10A,A03,083737,Patchell; Gregory David,16,0,30,14
1658022441549,MATH 10B,A01,083207,Lim; Seonhee,9,0,34,25
1658022441549,MATH 10B,A02,083208,Lim; Seonhee,10,0,35,25
1658022441549,MATH 10B,A03,093472,Lim; Seonhee,7,0,34,27
1658022441549,MATH 10B,B01,083739,Sinha; Shubham,14,0,30,16
1658022447573,MATH 18,A01,083743,Cinel; Cameron Alexander,9,0,30,21
1658022447573,MATH 18,A02,083744,Cinel; Cameron Alexander,18,0,30,12
1658022447573,MATH 18,A03,083745,Cinel; Cameron Alexander,10,0,30,20
1658022447573,MATH 18,B01,083748,Rideout; David Porter,5,0,37,32
1658022447573,MATH 18,B02,083749,Rideout; David Porter,5,0,36,31
1658022447573,MATH 18,B03,083750,Rideout; David Porter,3,0,37,34
1658022447573,MATH 18,B04,083751,Rideout; David Porter,7,0,36,29
1658022447573,MATH 18,B05,093473,Rideout; David Porter,7,0,36,29
1658022447573,MATH 18,B06,093474,Rideout; David Porter,6,0,36,30
1658022453606,MATH 20A,A01,083754,Zheng; Zequn,14,0,40,26
1658022459629,MATH 20B,A01,083756,Briones; Jor-el Thomas Caparas,4,0,36,32
1658022459629,MATH 20B,A02,083757,Briones; Jor-el Thomas Caparas,1,0,36,35
1658022459629,MATH 20B,A03,093475,Briones; Jor-el Thomas Caparas,3,0,36,33
1658022465658,MATH 20C,A01,083760,Briones; Jor-el Thomas Caparas,1,0,35,34
1658022465658,MATH 20C,A02,083761,Briones; Jor-el Thomas Caparas,8,0,35,27
1658022465658,MATH 20C,A03,093476,Briones; Jor-el Thomas Caparas,0,1,36,36
1658022465658,MATH 20C,B01,083762,Bach; Quang Tran,1,0,30,29
1658022471687,MATH 20D,A01,083765,Tran; Brian Kha,5,0,30,25
1658022471687,MATH 20D,A02,083766,Tran; Brian Kha,5,0,30,25
1658022471687,MATH 20D,A03,083767,Tran; Brian Kha,6,0,30,24
1658022477714,MATH 20E,A01,083771,Ganguly; Soumya,12,0,32,20
1658022477714,MATH 20E,A02,083772,Ganguly; Soumya,7,0,32,25
1658022477714,MATH 20E,B01,083773,Ciotti; Benjamin,20,0,35,15
1658022477714,MATH 20E,B02,083774,Ciotti; Benjamin,18,0,35,17
1658022483739,MATH 103A,A01,083777,Greenfeld; Be'Eri,6,0,36,30
1658022483739,MATH 103A,A02,083778,Greenfeld; Be'Eri,5,0,36,31
1658022483739,MATH 103A,A03,093561,Greenfeld; Be'Eri,7,0,36,29
1658022483739,MATH 103A,B01,083779,Greenfeld; Be'Eri,8,0,36,28
1658022483739,MATH 103A,B02,083780,Greenfeld; Be'Eri,4,0,36,32
1658022483739,MATH 103A,B03,093562,Greenfeld; Be'Eri,3,0,36,33
1658022489766,MATH 105,A01,085443,Carter; Anne Toulson,15,0,35,20
1658022489766,MATH 105,A02,093477,Carter; Anne Toulson,20,0,35,15
1658022495795,MATH 109,A01,083213,Ganzberger; Geoffrey Michael,3,0,34,31
1658022495795,MATH 109,A02,083214,Ganzberger; Geoffrey Michael,4,0,34,30
1658022495795,MATH 109,A03,093478,Ganzberger; Geoffrey Michael,2,0,34,32
1658022495795,MATH 109,B01,083215,Ganzberger; Geoffrey Michael,3,0,32,29
1658022495795,MATH 109,B02,083216,Ganzberger; Geoffrey Michael,3,0,32,29
1658022495795,MATH 109,B03,093479,Ganzberger; Geoffrey Michael,8,0,32,24
1658022501824,MATH 142A,A01,083219,Chow; Bennett,7,0,32,25
1658022501824,MATH 142A,A02,083220,Chow; Bennett,10,0,32,22
1658022501824,MATH 142A,A03,093480,Chow; Bennett,9,0,32,23
1658022501824,MATH 142A,B03,093481,Chow; Bennett,8,0,32,24
1658022501824,MATH 142A,B04,093558,Chow; Bennett,14,0,32,18
1658022501824,MATH 142A,B05,093559,Chow; Bennett,7,0,32,25
1658022507851,MATH 193A,A01,083224,Rotar; Vladimir,9,0,34,25
1658022507851,MATH 193A,A02,083225,Rotar; Vladimir,11,0,34,23
1658022507851,MATH 193A,A03,083781,Rotar; Vladimir,5,0,34,29
1658022507851,MATH 193A,A04,083782,Rotar; Vladimir,12,0,34,22
1658022507851,MATH 193A,A05,093482,Rotar; Vladimir,11,0,34,23
1658022513877,MATH 197,001,091859,McAuley; Julian John,9999,0,9999,0
1658022513877,MATH 197,002,095566,Kedlaya; Kiran S.,9997,0,9999,2
1658022513877,MATH 197,003,095567,Xiao; Ming,9999,0,9999,0
1658022513877,MATH 197,004,095571,Perols; Johan Lars,9998,0,9999,1
1658022520927,COGS 9,A01,083615,Shannon; Kyle Michael,11,0,75,64
1658022526952,COGS 11,A01,083617,Boyle; Mary E. T.,23,0,48,25
1658022532974,COGS 13,A01,083071,Bastos; Amalia Pinkusfeld,12,0,71,59
1658022538996,COGS 14A,A01,092681,Semenuks; Arturs,5,1,100,95
1658022545022,COGS 14B,A01,083073,Cheng; Tzu-Han,7,0,63,56
1658022551044,COGS 17,A01,092677,Semenuks; Arturs,7,0,81,74
1658022557068,COGS 100,A01,083619,Allen; Michael Gordon,17,0,70,53
1658022563092,COGS 101A,A01,083621,Davis; Joshua Daniel,9,0,68,59
1658022569215,COGS 101B,A01,091572,Allen; Michael Gordon,14,0,65,51
1658022575247,COGS 101C,A01,083625,Delgado; Tania,17,0,35,18
1658022581270,COGS 107A,A01,083627,Boyle; Mary E. T.,14,0,60,46
1658022587303,COGS 118A,A01,083075,Gupta; Anjum,21,0,76,55
1658022593331,CSE 3,A50,083646,Miranda; Gregory Joseph,24,0,50,26
1658022599361,CSE 8A,A50,083650,Miranda; Gregory Joseph,17,1,56,39
1658022605384,CSE 11,A01,083080,Cao; Yingjun,7,15,40,33
1658022611411,CSE 12,A01,083652,Krause-Levy; Sophia Louisa,30,1,120,90
1658022617434,CSE 15L,A01,083654,Morris; Justin Loren,9,0,50,41
1658022617434,CSE 15L,A02,083655,Morris; Justin Loren,11,0,50,39
1658022623460,CSE 20,A01,083657,Tran; Khoa Dang,39,0,80,41
1658022629484,CSE 21,A01,095574,Bach; Quang Tran,23,0,48,25
1658022635510,CSE 30,A01,083084,Eldon; John,8,0,80,72
1658022635510,CSE 30,B01,095061,Bhaskar; Nishant,9,0,50,41
1658022641536,CSE 100,A01,083659,Cao; Yingjun,5,4,70,65
1658022647562,CSE 134B,A01,083661,Powell; Thomas Allan,25,0,100,75
1658022653585,CSE 140,A01,083663,Gungor; Onat,17,0,85,68
1658022659612,CSE 140L,A01,083088,Eldon; John,23,0,100,77
1658022665635,CSE 175,A01,083665,Kumar; Rakesh,3,0,25,22
1658022671657,CSE 190,A00,092507,Dubnov; Shlomo,8,0,20,12
1658022677688,ECE 45,A01,083139,Congero; Spencer William,7,0,75,68
1658022683711,ECE 65,A50,083695,Saad; Andrew S,12,0,30,18
1658022683711,ECE 65,A51,095125,Saad; Andrew S,24,0,26,2
1658022689733,ECE 109,A01,091882,Touri; Behrouz,21,0,70,49
1658022695755,ECE 180,A00,083140,Abi Samra; Nicholas Camill,1,0,30,29
1658022695755,ECE 180,B00,083141,Abi Samra; Nicholas Camill,0,0,30,30
1658022701778,MATH 10A,A01,083735,Patchell; Gregory David,2,0,30,28
1658022701778,MATH 10A,A02,083736,Patchell; Gregory David,20,0,30,10
1658022701778,MATH 10A,A03,083737,Patchell; Gregory David,16,0,30,14
1658022707807,MATH 10B,A01,083207,Lim; Seonhee,9,0,34,25
1658022707807,MATH 10B,A02,083208,Lim; Seonhee,10,0,35,25
1658022707807,MATH 10B,A03,093472,Lim; Seonhee,7,0,34,27
1658022707807,MATH 10B,B01,083739,Sinha; Shubham,14,0,30,16
1658022713831,MATH 18,A01,083743,Cinel; Cameron Alexander,9,0,30,21
1658022713831,MATH 18,A02,083744,Cinel; Cameron Alexander,18,0,30,12
1658022713831,MATH 18,A03,083745,Cinel; Cameron Alexander,10,0,30,20
1658022713831,MATH 18,B01,083748,Rideout; David Porter,5,0,37,32
1658022713831,MATH 18,B02,083749,Rideout; David Porter,5,0,36,31
1658022713831,MATH 18,B03,083750,Rideout; David Porter,3,0,37,34
1658022713831,MATH 18,B04,083751,Rideout; David Porter,7,0,36,29
1658022713831,MATH 18,B05,093473,Rideout; David Porter,7,0,36,29
1658022713831,MATH 18,B06,093474,Rideout; David Porter,6,0,36,30
1658022719857,MATH 20A,A01,083754,Zheng; Zequn,14,0,40,26
1658022725883,MATH 20B,A01,083756,Briones; Jor-el Thomas Caparas,4,0,36,32
1658022725883,MATH 20B,A02,083757,Briones; Jor-el Thomas Caparas,1,0,36,35
1658022725883,MATH 20B,A03,093475,Briones; Jor-el Thomas Caparas,3,0,36,33
1658022731917,MATH 20C,A01,083760,Briones; Jor-el Thomas Caparas,1,0,35,34
1658022731917,MATH 20C,A02,083761,Briones; Jor-el Thomas Caparas,8,0,35,27
1658022731917,MATH 20C,A03,093476,Briones; Jor-el Thomas Caparas,0,1,36,36
1658022731917,MATH 20C,B01,083762,Bach; Quang Tran,1,0,30,29
1658022737945,MATH 20D,A01,083765,Tran; Brian Kha,5,0,30,25
1658022737945,MATH 20D,A02,083766,Tran; Brian Kha,5,0,30,25
1658022737945,MATH 20D,A03,083767,Tran; Brian Kha,6,0,30,24
1658022753432,MATH 20E,A01,083771,Ganguly; Soumya,12,0,32,20
1658022753432,MATH 20E,A02,083772,Ganguly; Soumya,7,0,32,25
1658022753432,MATH 20E,B01,083773,Ciotti; Benjamin,20,0,35,15
1658022753432,MATH 20E,B02,083774,Ciotti; Benjamin,18,0,35,17
1658022759463,MATH 103A,A01,083777,Greenfeld; Be'Eri,6,0,36,30
1658022759463,MATH 103A,A02,083778,Greenfeld; Be'Eri,5,0,36,31
1658022759463,MATH 103A,A03,093561,Greenfeld; Be'Eri,7,0,36,29
1658022759463,MATH 103A,B01,083779,Greenfeld; Be'Eri,8,0,36,28
1658022759463,MATH 103A,B02,083780,Greenfeld; Be'Eri,4,0,36,32
1658022759463,MATH 103A,B03,093562,Greenfeld; Be'Eri,3,0,36,33
1658022765488,MATH 105,A01,085443,Carter; Anne Toulson,15,0,35,20
1658022765488,MATH 105,A02,093477,Carter; Anne Toulson,20,0,35,15
1658022771512,MATH 109,A01,083213,Ganzberger; Geoffrey Michael,3,0,34,31
1658022771512,MATH 109,A02,083214,Ganzberger; Geoffrey Michael,4,0,34,30
1658022771512,MATH 109,A03,093478,Ganzberger; Geoffrey Michael,2,0,34,32
1658022771512,MATH 109,B01,083215,Ganzberger; Geoffrey Michael,3,0,32,29
1658022771512,MATH 109,B02,083216,Ganzberger; Geoffrey Michael,3,0,32,29
1658022771512,MATH 109,B03,093479,Ganzberger; Geoffrey Michael,8,0,32,24
1658022777543,MATH 142A,A01,083219,Chow; Bennett,7,0,32,25
1658022777543,MATH 142A,A02,083220,Chow; Bennett,10,0,32,22
1658022777543,MATH 142A,A03,093480,Chow; Bennett,9,0,32,23
1658022777543,MATH 142A,B03,093481,Chow; Bennett,8,0,32,24
1658022777543,MATH 142A,B04,093558,Chow; Bennett,14,0,32,18
1658022777543,MATH 142A,B05,093559,Chow; Bennett,7,0,32,25
1658022783572,MATH 193A,A01,083224,Rotar; Vladimir,9,0,34,25
1658022783572,MATH 193A,A02,083225,Rotar; Vladimir,11,0,34,23
1658022783572,MATH 193A,A03,083781,Rotar; Vladimir,5,0,34,29
1658022783572,MATH 193A,A04,083782,Rotar; Vladimir,12,0,34,22
1658022783572,MATH 193A,A05,093482,Rotar; Vladimir,11,0,34,23
1658022789595,MATH 197,001,091859,McAuley; Julian John,9999,0,9999,0
1658022789595,MATH 197,002,095566,Kedlaya; Kiran S.,9997,0,9999,2
1658022789595,MATH 197,003,095567,Xiao; Ming,9999,0,9999,0
1658022789595,MATH 197,004,095571,Perols; Johan Lars,9998,0,9999,1
1658022796659,COGS 9,A01,083615,Shannon; Kyle Michael,11,0,75,64
1658022802680,COGS 11,A01,083617,Boyle; Mary E. T.,23,0,48,25
1658022808704,COGS 13,A01,083071,Bastos; Amalia Pinkusfeld,12,0,71,59
1658022814732,COGS 14A,A01,092681,Semenuks; Arturs,5,1,100,95
1658022820755,COGS 14B,A01,083073,Cheng; Tzu-Han,7,0,63,56
1658022826775,COGS 17,A01,092677,Semenuks; Arturs,7,0,81,74
1658022832800,COGS 100,A01,083619,Allen; Michael Gordon,17,0,70,53
1658022838823,COGS 101A,A01,083621,Davis; Joshua Daniel,9,0,68,59
1658022844847,COGS 101B,A01,091572,Allen; Michael Gordon,14,0,65,51
1658022850871,COGS 101C,A01,083625,Delgado; Tania,17,0,35,18
1658022856897,COGS 107A,A01,083627,Boyle; Mary E. T.,14,0,60,46
1658022862919,COGS 118A,A01,083075,Gupta; Anjum,21,0,76,55
1658022868942,CSE 3,A50,083646,Miranda; Gregory Joseph,24,0,50,26
1658022874969,CSE 8A,A50,083650,Miranda; Gregory Joseph,17,1,56,39
1658022880995,CSE 11,A01,083080,Cao; Yingjun,7,15,40,33
1658022887019,CSE 12,A01,083652,Krause-Levy; Sophia Louisa,30,1,120,90
1658022893041,CSE 15L,A01,083654,Morris; Justin Loren,9,0,50,41
1658022893041,CSE 15L,A02,083655,Morris; Justin Loren,11,0,50,39
1658022899068,CSE 20,A01,083657,Tran; Khoa Dang,39,0,80,41
1658022905095,CSE 21,A01,095574,Bach; Quang Tran,23,0,48,25
1658022911118,CSE 30,A01,083084,Eldon; John,8,0,80,72
1658022911118,CSE 30,B01,095061,Bhaskar; Nishant,9,0,50,41
1658022917141,CSE 100,A01,083659,Cao; Yingjun,5,4,70,65
1658022923162,CSE 134B,A01,083661,Powell; Thomas Allan,25,0,100,75
1658022929188,CSE 140,A01,083663,Gungor; Onat,17,0,85,68
1658022935213,CSE 140L,A01,083088,Eldon; John,23,0,100,77
1658022941236,CSE 175,A01,083665,Kumar; Rakesh,3,0,25,22
1658022947261,CSE 190,A00,092507,Dubnov; Shlomo,8,0,20,12
1658022953284,ECE 45,A01,083139,Congero; Spencer William,7,0,75,68
1658022959307,ECE 65,A50,083695,Saad; Andrew S,12,0,30,18
1658022959307,ECE 65,A51,095125,Saad; Andrew S,24,0,26,2
1658022965329,ECE 109,A01,091882,Touri; Behrouz,21,0,70,49
1658022971356,ECE 180,A00,083140,Abi Samra; Nicholas Camill,1,0,30,29
1658022971356,ECE 180,B00,083141,Abi Samra; Nicholas Camill,0,0,30,30
1658022977380,MATH 10A,A01,083735,Patchell; Gregory David,2,0,30,28
1658022977380,MATH 10A,A02,083736,Patchell; Gregory David,20,0,30,10
1658022977380,MATH 10A,A03,083737,Patchell; Gregory David,16,0,30,14
1658022983408,MATH 10B,A01,083207,Lim; Seonhee,9,0,34,25
1658022983408,MATH 10B,A02,083208,Lim; Seonhee,10,0,35,25
1658022983408,MATH 10B,A03,093472,Lim; Seonhee,7,0,34,27
1658022983408,MATH 10B,B01,083739,Sinha; Shubham,14,0,30,16
1658022989431,MATH 18,A01,083743,Cinel; Cameron Alexander,9,0,30,21
1658022989431,MATH 18,A02,083744,Cinel; Cameron Alexander,18,0,30,12
1658022989431,MATH 18,A03,083745,Cinel; Cameron Alexander,10,0,30,20
1658022989431,MATH 18,B01,083748,Rideout; David Porter,5,0,37,32
1658022989431,MATH 18,B02,083749,Rideout; David Porter,5,0,36,31
1658022989431,MATH 18,B03,083750,Rideout; David Porter,3,0,37,34
1658022989431,MATH 18,B04,083751,Rideout; David Porter,7,0,36,29
1658022989431,MATH 18,B05,093473,Rideout; David Porter,7,0,36,29
1658022989431,MATH 18,B06,093474,Rideout; David Porter,6,0,36,30
1658022995453,MATH 20A,A01,083754,Zheng; Zequn,14,0,40,26
1658023001476,MATH 20B,A01,083756,Briones; Jor-el Thomas Caparas,4,0,36,32
1658023001476,MATH 20B,A02,083757,Briones; Jor-el Thomas Caparas,1,0,36,35
1658023001476,MATH 20B,A03,093475,Briones; Jor-el Thomas Caparas,3,0,36,33
1658023007504,MATH 20C,A01,083760,Briones; Jor-el Thomas Caparas,1,0,35,34
1658023007504,MATH 20C,A02,083761,Briones; Jor-el Thomas Caparas,8,0,35,27
1658023007504,MATH 20C,A03,093476,Briones; Jor-el Thomas Caparas,0,1,36,36
1658023007504,MATH 20C,B01,083762,Bach; Quang Tran,1,0,30,29
1658023013527,MATH 20D,A01,083765,Tran; Brian Kha,5,0,30,25
1658023013527,MATH 20D,A02,083766,Tran; Brian Kha,5,0,30,25
1658023013527,MATH 20D,A03,083767,Tran; Brian Kha,6,0,30,24
1658023019551,MATH 20E,A01,083771,Ganguly; Soumya,12,0,32,20
1658023019551,MATH 20E,A02,083772,Ganguly; Soumya,7,0,32,25
1658023019551,MATH 20E,B01,083773,Ciotti; Benjamin,20,0,35,15
1658023019551,MATH 20E,B02,083774,Ciotti; Benjamin,18,0,35,17
1658023025583,MATH 103A,A01,083777,Greenfeld; Be'Eri,6,0,36,30
1658023025583,MATH 103A,A02,083778,Greenfeld; Be'Eri,5,0,36,31
1658023025583,MATH 103A,A03,093561,Greenfeld; Be'Eri,7,0,36,29
1658023025583,MATH 103A,B01,083779,Greenfeld; Be'Eri,8,0,36,28
1658023025583,MATH 103A,B02,083780,Greenfeld; Be'Eri,4,0,36,32
1658023025583,MATH 103A,B03,093562,Greenfeld; Be'Eri,3,0,36,33
1658023031605,MATH 105,A01,085443,Carter; Anne Toulson,15,0,35,20
1658023031605,MATH 105,A02,093477,Carter; Anne Toulson,20,0,35,15
1658023037634,MATH 109,A01,083213,Ganzberger; Geoffrey Michael,3,0,34,31
1658023037634,MATH 109,A02,083214,Ganzberger; Geoffrey Michael,4,0,34,30
1658023037634,MATH 109,A03,093478,Ganzberger; Geoffrey Michael,2,0,34,32
1658023037634,MATH 109,B01,083215,Ganzberger; Geoffrey Michael,3,0,32,29
1658023037634,MATH 109,B02,083216,Ganzberger; Geoffrey Michael,3,0,32,29
1658023037634,MATH 109,B03,093479,Ganzberger; Geoffrey Michael,8,0,32,24
1658023043659,MATH 142A,A01,083219,Chow; Bennett,7,0,32,25
1658023043659,MATH 142A,A02,083220,Chow; Bennett,10,0,32,22
1658023043659,MATH 142A,A03,093480,Chow; Bennett,9,0,32,23
1658023043659,MATH 142A,B03,093481,Chow; Bennett,8,0,32,24
1658023043659,MATH 142A,B04,093558,Chow; Bennett,14,0,32,18
1658023043659,MATH 142A,B05,093559,Chow; Bennett,7,0,32,25
1658023049687,MATH 193A,A01,083224,Rotar; Vladimir,9,0,34,25
1658023049687,MATH 193A,A02,083225,Rotar; Vladimir,11,0,34,23
1658023049687,MATH 193A,A03,083781,Rotar; Vladimir,5,0,34,29
1658023049687,MATH 193A,A04,083782,Rotar; Vladimir,12,0,34,22
1658023049687,MATH 193A,A05,093482,Rotar; Vladimir,11,0,34,23
1658023055712,MATH 197,001,091859,McAuley; Julian John,9999,0,9999,0
1658023055712,MATH 197,002,095566,Kedlaya; Kiran S.,9997,0,9999,2
1658023055712,MATH 197,003,095567,Xiao; Ming,9999,0,9999,0
1658023055712,MATH 197,004,095571,Perols; Johan Lars,9998,0,9999,1
1658023062774,COGS 9,A01,083615,Shannon; Kyle Michael,11,0,75,64
1658023068798,COGS 11,A01,083617,Boyle; Mary E. T.,23,0,48,25
1658023074820,COGS 13,A01,083071,Bastos; Amalia Pinkusfeld,12,0,71,59
1658023080844,COGS 14A,A01,092681,Semenuks; Arturs,5,1,100,95
1658023086871,COGS 14B,A01,083073,Cheng; Tzu-Han,7,0,63,56
1658023092893,COGS 17,A01,092677,Semenuks; Arturs,7,0,81,74
1658023098920,COGS 100,A01,083619,Allen; Michael Gordon,17,0,70,53
1658023104947,COGS 101A,A01,083621,Davis; Joshua Daniel,9,0,68,59
1658023110970,COGS 101B,A01,091572,Allen; Michael Gordon,14,0,65,51
1658023116993,COGS 101C,A01,083625,Delgado; Tania,17,0,35,18
1658023123016,COGS 107A,A01,083627,Boyle; Mary E. T.,14,0,60,46
1658023129039,COGS 118A,A01,083075,Gupta; Anjum,21,0,76,55
1658023135062,CSE 3,A50,083646,Miranda; Gregory Joseph,24,0,50,26
1658023141088,CSE 8A,A50,083650,Miranda; Gregory Joseph,17,1,56,39
1658023147114,CSE 11,A01,083080,Cao; Yingjun,7,15,40,33
1658023153137,CSE 12,A01,083652,Krause-Levy; Sophia Louisa,30,1,120,90
1658023159162,CSE 15L,A01,083654,Morris; Justin Loren,9,0,50,41
1658023159162,CSE 15L,A02,083655,Morris; Justin Loren,11,0,50,39
1658023165185,CSE 20,A01,083657,Tran; Khoa Dang,39,0,80,41
1658023171215,CSE 21,A01,095574,Bach; Quang Tran,23,0,48,25
1658023177330,CSE 30,A01,083084,Eldon; John,8,0,80,72
1658023177330,CSE 30,B01,095061,Bhaskar; Nishant,9,0,50,41
1658023183356,CSE 100,A01,083659,Cao; Yingjun,5,4,70,65
1658023189382,CSE 134B,A01,083661,Powell; Thomas Allan,25,0,100,75
1658023195408,CSE 140,A01,083663,Gungor; Onat,17,0,85,68
1658023201430,CSE 140L,A01,083088,Eldon; John,23,0,100,77
1658023207456,CSE 175,A01,083665,Kumar; Rakesh,3,0,25,22
1658023213480,CSE 190,A00,092507,Dubnov; Shlomo,8,0,20,12
1658023219503,ECE 45,A01,083139,Congero; Spencer William,7,0,75,68
1658023225529,ECE 65,A50,083695,Saad; Andrew S,12,0,30,18
1658023225529,ECE 65,A51,095125,Saad; Andrew S,24,0,26,2
1658023231552,ECE 109,A01,091882,Touri; Behrouz,21,0,70,49
1658023237573,ECE 180,A00,083140,Abi Samra; Nicholas Camill,1,0,30,29
1658023237573,ECE 180,B00,083141,Abi Samra; Nicholas Camill,0,0,30,30
1658023243596,MATH 10A,A01,083735,Patchell; Gregory David,2,0,30,28
1658023243596,MATH 10A,A02,083736,Patchell; Gregory David,20,0,30,10
1658023243596,MATH 10A,A03,083737,Patchell; Gregory David,16,0,30,14
1658023249623,MATH 10B,A01,083207,Lim; Seonhee,9,0,34,25
1658023249623,MATH 10B,A02,083208,Lim; Seonhee,10,0,35,25
1658023249623,MATH 10B,A03,093472,Lim; Seonhee,7,0,34,27
1658023249623,MATH 10B,B01,083739,Sinha; Shubham,14,0,30,16
1658023255647,MATH 18,A01,083743,Cinel; Cameron Alexander,9,0,30,21
1658023255647,MATH 18,A02,083744,Cinel; Cameron Alexander,18,0,30,12
1658023255647,MATH 18,A03,083745,Cinel; Cameron Alexander,10,0,30,20
1658023255647,MATH 18,B01,083748,Rideout; David Porter,5,0,37,32
1658023255647,MATH 18,B02,083749,Rideout; David Porter,5,0,36,31
1658023255647,MATH 18,B03,083750,Rideout; David Porter,3,0,37,34
1658023255647,MATH 18,B04,083751,Rideout; David Porter,7,0,36,29
1658023255647,MATH 18,B05,093473,Rideout; David Porter,7,0,36,29
1658023255647,MATH 18,B06,093474,Rideout; David Porter,6,0,36,30
1658023261673,MATH 20A,A01,083754,Zheng; Zequn,14,0,40,26
1658023267697,MATH 20B,A01,083756,Briones; Jor-el Thomas Caparas,4,0,36,32
1658023267697,MATH 20B,A02,083757,Briones; Jor-el Thomas Caparas,1,0,36,35
1658023267697,MATH 20B,A03,093475,Briones; Jor-el Thomas Caparas,3,0,36,33
1658023273719,MATH 20C,A01,083760,Briones; Jor-el Thomas Caparas,1,0,35,34
1658023273719,MATH 20C,A02,083761,Briones; Jor-el Thomas Caparas,8,0,35,27
1658023273719,MATH 20C,A03,093476,Briones; Jor-el Thomas Caparas,0,1,36,36
1658023273719,MATH 20C,B01,083762,Bach; Quang Tran,1,0,30,29
1658023279751,MATH 20D,A01,083765,Tran; Brian Kha,5,0,30,25
1658023279751,MATH 20D,A02,083766,Tran; Brian Kha,5,0,30,25
1658023279751,MATH 20D,A03,083767,Tran; Brian Kha,6,0,30,24
1658023285773,MATH 20E,A01,083771,Ganguly; Soumya,12,0,32,20
1658023285773,MATH 20E,A02,083772,Ganguly; Soumya,7,0,32,25
1658023285773,MATH 20E,B01,083773,Ciotti; Benjamin,20,0,35,15
1658023285773,MATH 20E,B02,083774,Ciotti; Benjamin,18,0,35,17
1658023291795,MATH 103A,A01,083777,Greenfeld; Be'Eri,6,0,36,30
1658023291795,MATH 103A,A02,083778,Greenfeld; Be'Eri,5,0,36,31
1658023291795,MATH 103A,A03,093561,Greenfeld; Be'Eri,7,0,36,29
1658023291795,MATH 103A,B01,083779,Greenfeld; Be'Eri,8,0,36,28
1658023291795,MATH 103A,B02,083780,Greenfeld; Be'Eri,4,0,36,32
1658023291795,MATH 103A,B03,093562,Greenfeld; Be'Eri,3,0,36,33
1658023297816,MATH 105,A01,085443,Carter; Anne Toulson,15,0,35,20
1658023297816,MATH 105,A02,093477,Carter; Anne Toulson,20,0,35,15
1658023303842,MATH 109,A01,083213,Ganzberger; Geoffrey Michael,3,0,34,31
1658023303842,MATH 109,A02,083214,Ganzberger; Geoffrey Michael,4,0,34,30
1658023303842,MATH 109,A03,093478,Ganzberger; Geoffrey Michael,2,0,34,32
1658023303842,MATH 109,B01,083215,Ganzberger; Geoffrey Michael,3,0,32,29
1658023303842,MATH 109,B02,083216,Ganzberger; Geoffrey Michael,3,0,32,29
1658023303842,MATH 109,B03,093479,Ganzberger; Geoffrey Michael,8,0,32,24
1658023309865,MATH 142A,A01,083219,Chow; Bennett,7,0,32,25
1658023309865,MATH 142A,A02,083220,Chow; Bennett,10,0,32,22
1658023309865,MATH 142A,A03,093480,Chow; Bennett,9,0,32,23
1658023309865,MATH 142A,B03,093481,Chow; Bennett,8,0,32,24
1658023309865,MATH 142A,B04,093558,Chow; Bennett,14,0,32,18
1658023309865,MATH 142A,B05,093559,Chow; Bennett,7,0,32,25
1658023315901,MATH 193A,A01,083224,Rotar; Vladimir,9,0,34,25
1658023315901,MATH 193A,A02,083225,Rotar; Vladimir,11,0,34,23
1658023315901,MATH 193A,A03,083781,Rotar; Vladimir,5,0,34,29
1658023315901,MATH 193A,A04,083782,Rotar; Vladimir,12,0,34,22
1658023315901,MATH 193A,A05,093482,Rotar; Vladimir,11,0,34,23
1658023321935,MATH 197,001,091859,McAuley; Julian John,9999,0,9999,0
1658023321935,MATH 197,002,095566,Kedlaya; Kiran S.,9997,0,9999,2
1658023321935,MATH 197,003,095567,Xiao; Ming,9999,0,9999,0
1658023321935,MATH 197,004,095571,Perols; Johan Lars,9998,0,9999,1
1658023328992,COGS 9,A01,083615,Shannon; Kyle Michael,11,0,75,64
1658023335019,COGS 11,A01,083617,Boyle; Mary E. T.,23,0,48,25
1658023341044,COGS 13,A01,083071,Bastos; Amalia Pinkusfeld,12,0,71,59
1658023347072,COGS 14A,A01,092681,Semenuks; Arturs,5,1,100,95
1658023353094,COGS 14B,A01,083073,Cheng; Tzu-Han,7,0,63,56
1658023359119,COGS 17,A01,092677,Semenuks; Arturs,7,0,81,74
1658023365143,COGS 100,A01,083619,Allen; Michael Gordon,17,0,70,53
1658023371164,COGS 101A,A01,083621,Davis; Joshua Daniel,9,0,68,59
1658023377191,COGS 101B,A01,091572,Allen; Michael Gordon,14,0,65,51
1658023383214,COGS 101C,A01,083625,Delgado; Tania,17,0,35,18
1658023389237,COGS 107A,A01,083627,Boyle; Mary E. T.,14,0,60,46
1658023395264,COGS 118A,A01,083075,Gupta; Anjum,21,0,76,55
1658023401294,CSE 3,A50,083646,Miranda; Gregory Joseph,24,0,50,26
1658023407317,CSE 8A,A50,083650,Miranda; Gregory Joseph,17,1,56,39
1658023413345,CSE 11,A01,083080,Cao; Yingjun,7,15,40,33
1658023419371,CSE 12,A01,083652,Krause-Levy; Sophia Louisa,30,1,120,90
1658023425393,CSE 15L,A01,083654,Morris; Justin Loren,9,0,50,41
1658023425393,CSE 15L,A02,083655,Morris; Justin Loren,11,0,50,39
1658023431417,CSE 20,A01,083657,Tran; Khoa Dang,39,0,80,41
1658023437443,CSE 21,A01,095574,Bach; Quang Tran,23,0,48,25
1658023443471,CSE 30,A01,083084,Eldon; John,8,0,80,72
1658023443471,CSE 30,B01,095061,Bhaskar; Nishant,9,0,50,41
1658023449494,CSE 100,A01,083659,Cao; Yingjun,5,4,70,65
1658023455516,CSE 134B,A01,083661,Powell; Thomas Allan,25,0,100,75
1658023461540,CSE 140,A01,083663,Gungor; Onat,17,0,85,68
1658023467562,CSE 140L,A01,083088,Eldon; John,23,0,100,77
1658023473588,CSE 175,A01,083665,Kumar; Rakesh,3,0,25,22
1658023479614,CSE 190,A00,092507,Dubnov; Shlomo,8,0,20,12
1658023485637,ECE 45,A01,083139,Congero; Spencer William,7,0,75,68
1658023491668,ECE 65,A50,083695,Saad; Andrew S,12,0,30,18
1658023491668,ECE 65,A51,095125,Saad; Andrew S,24,0,26,2
1658023497691,ECE 109,A01,091882,Touri; Behrouz,21,0,70,49
1658023503717,ECE 180,A00,083140,Abi Samra; Nicholas Camill,1,0,30,29
1658023503717,ECE 180,B00,083141,Abi Samra; Nicholas Camill,0,0,30,30
1658023509739,MATH 10A,A01,083735,Patchell; Gregory David,2,0,30,28
1658023509739,MATH 10A,A02,083736,Patchell; Gregory David,20,0,30,10
1658023509739,MATH 10A,A03,083737,Patchell; Gregory David,16,0,30,14
1658023515762,MATH 10B,A01,083207,Lim; Seonhee,9,0,34,25
1658023515762,MATH 10B,A02,083208,Lim; Seonhee,10,0,35,25
1658023515762,MATH 10B,A03,093472,Lim; Seonhee,7,0,34,27
1658023515762,MATH 10B,B01,083739,Sinha; Shubham,14,0,30,16
1658023521791,MATH 18,A01,083743,Cinel; Cameron Alexander,9,0,30,21
1658023521791,MATH 18,A02,083744,Cinel; Cameron Alexander,18,0,30,12
1658023521791,MATH 18,A03,083745,Cinel; Cameron Alexander,10,0,30,20
1658023521791,MATH 18,B01,083748,Rideout; David Porter,5,0,37,32
1658023521791,MATH 18,B02,083749,Rideout; David Porter,5,0,36,31
1658023521791,MATH 18,B03,083750,Rideout; David Porter,3,0,37,34
1658023521791,MATH 18,B04,083751,Rideout; David Porter,7,0,36,29
1658023521791,MATH 18,B05,093473,Rideout; David Porter,7,0,36,29
1658023521791,MATH 18,B06,093474,Rideout; David Porter,6,0,36,30
1658023527812,MATH 20A,A01,083754,Zheng; Zequn,14,0,40,26
1658023533838,MATH 20B,A01,083756,Briones; Jor-el Thomas Caparas,4,0,36,32
1658023533838,MATH 20B,A02,083757,Briones; Jor-el Thomas Caparas,1,0,36,35
1658023533838,MATH 20B,A03,093475,Briones; Jor-el Thomas Caparas,3,0,36,33
1658023539866,MATH 20C,A01,083760,Briones; Jor-el Thomas Caparas,1,0,35,34
1658023539866,MATH 20C,A02,083761,Briones; Jor-el Thomas Caparas,8,0,35,27
1658023539866,MATH 20C,A03,093476,Briones; Jor-el Thomas Caparas,0,1,36,36
1658023539866,MATH 20C,B01,083762,Bach; Quang Tran,1,0,30,29
1658023545890,MATH 20D,A01,083765,Tran; Brian Kha,5,0,30,25
1658023545890,MATH 20D,A02,083766,Tran; Brian Kha,5,0,30,25
1658023545890,MATH 20D,A03,083767,Tran; Brian Kha,6,0,30,24
1658023551914,MATH 20E,A01,083771,Ganguly; Soumya,12,0,32,20
1658023551914,MATH 20E,A02,083772,Ganguly; Soumya,7,0,32,25
1658023551914,MATH 20E,B01,083773,Ciotti; Benjamin,20,0,35,15
1658023551914,MATH 20E,B02,083774,Ciotti; Benjamin,18,0,35,17
1658023557943,MATH 103A,A01,083777,Greenfeld; Be'Eri,6,0,36,30
1658023557943,MATH 103A,A02,083778,Greenfeld; Be'Eri,5,0,36,31
1658023557943,MATH 103A,A03,093561,Greenfeld; Be'Eri,7,0,36,29
1658023557943,MATH 103A,B01,083779,Greenfeld; Be'Eri,8,0,36,28
1658023557943,MATH 103A,B02,083780,Greenfeld; Be'Eri,4,0,36,32
1658023557943,MATH 103A,B03,093562,Greenfeld; Be'Eri,3,0,36,33
1658023563966,MATH 105,A01,085443,Carter; Anne Toulson,15,0,35,20
1658023563966,MATH 105,A02,093477,Carter; Anne Toulson,20,0,35,15
1658023569989,MATH 109,A01,083213,Ganzberger; Geoffrey Michael,3,0,34,31
1658023569989,MATH 109,A02,083214,Ganzberger; Geoffrey Michael,4,0,34,30
1658023569989,MATH 109,A03,093478,Ganzberger; Geoffrey Michael,2,0,34,32
1658023569989,MATH 109,B01,083215,Ganzberger; Geoffrey Michael,3,0,32,29
1658023569989,MATH 109,B02,083216,Ganzberger; Geoffrey Michael,3,0,32,29
1658023569989,MATH 109,B03,093479,Ganzberger; Geoffrey Michael,8,0,32,24
1658023576016,MATH 142A,A01,083219,Chow; Bennett,7,0,32,25
1658023576016,MATH 142A,A02,083220,Chow; Bennett,10,0,32,22
1658023576016,MATH 142A,A03,093480,Chow; Bennett,9,0,32,23
1658023576016,MATH 142A,B03,093481,Chow; Bennett,8,0,32,24
1658023576016,MATH 142A,B04,093558,Chow; Bennett,14,0,32,18
1658023576016,MATH 142A,B05,093559,Chow; Bennett,7,0,32,25
1658023582038,MATH 193A,A01,083224,Rotar; Vladimir,9,0,34,25
1658023582038,MATH 193A,A02,083225,Rotar; Vladimir,11,0,34,23
1658023582038,MATH 193A,A03,083781,Rotar; Vladimir,5,0,34,29
1658023582038,MATH 193A,A04,083782,Rotar; Vladimir,12,0,34,22
1658023582038,MATH 193A,A05,093482,Rotar; Vladimir,11,0,34,23
1658023588066,MATH 197,001,091859,McAuley; Julian John,9999,0,9999,0
1658023588066,MATH 197,002,095566,Kedlaya; Kiran S.,9997,0,9999,2
1658023588066,MATH 197,003,095567,Xiao; Ming,9999,0,9999,0
1658023588066,MATH 197,004,095571,Perols; Johan Lars,9998,0,9999,1
1658023595146,COGS 9,A01,083615,Shannon; Kyle Michael,11,0,75,64
1658023601173,COGS 11,A01,083617,Boyle; Mary E. T.,23,0,48,25
1658023607195,COGS 13,A01,083071,Bastos; Amalia Pinkusfeld,12,0,71,59
1658023613221,COGS 14A,A01,092681,Semenuks; Arturs,5,1,100,95
1658023619244,COGS 14B,A01,083073,Cheng; Tzu-Han,7,0,63,56
1658023625267,COGS 17,A01,092677,Semenuks; Arturs,7,0,81,74
1658023631290,COGS 100,A01,083619,Allen; Michael Gordon,17,0,70,53
1658023637313,COGS 101A,A01,083621,Davis; Joshua Daniel,9,0,68,59
1658023643336,COGS 101B,A01,091572,Allen; Michael Gordon,14,0,65,51
1658023649363,COGS 101C,A01,083625,Delgado; Tania,17,0,35,18
1658023655389,COGS 107A,A01,083627,Boyle; Mary E. T.,14,0,60,46
1658023661415,COGS 118A,A01,083075,Gupta; Anjum,21,0,76,55
1658023667447,CSE 3,A50,083646,Miranda; Gregory Joseph,24,0,50,26
1658023673478,CSE 8A,A50,083650,Miranda; Gregory Joseph,17,1,56,39
1658023679505,CSE 11,A01,083080,Cao; Yingjun,7,15,40,33
1658023685526,CSE 12,A01,083652,Krause-Levy; Sophia Louisa,30,1,120,90
1658023691554,CSE 15L,A01,083654,Morris; Justin Loren,9,0,50,41
1658023691554,CSE 15L,A02,083655,Morris; Justin Loren,11,0,50,39
1658023697579,CSE 20,A01,083657,Tran; Khoa Dang,39,0,80,41
1658023703607,CSE 21,A01,095574,Bach; Quang Tran,23,0,48,25
1658023709632,CSE 30,A01,083084,Eldon; John,8,0,80,72
1658023709632,CSE 30,B01,095061,Bhaskar; Nishant,9,0,50,41
1658023715655,CSE 100,A01,083659,Cao; Yingjun,5,4,70,65
1658023721682,CSE 134B,A01,083661,Powell; Thomas Allan,25,0,100,75
1658023727706,CSE 140,A01,083663,Gungor; Onat,17,0,85,68
1658023733730,CSE 140L,A01,083088,Eldon; John,23,0,100,77
1658023739756,CSE 175,A01,083665,Kumar; Rakesh,3,0,25,22
1658023745781,CSE 190,A00,092507,Dubnov; Shlomo,8,0,20,12
1658023751805,ECE 45,A01,083139,Congero; Spencer William,7,0,75,68
1658023757832,ECE 65,A50,083695,Saad; Andrew S,12,0,30,18
1658023757832,ECE 65,A51,095125,Saad; Andrew S,24,0,26,2
1658023763855,ECE 109,A01,091882,Touri; Behrouz,21,0,70,49
1658023769882,ECE 180,A00,083140,Abi Samra; Nicholas Camill,1,0,30,29
1658023769882,ECE 180,B00,083141,Abi Samra; Nicholas Camill,0,0,30,30
1658023775979,MATH 10A,A01,083735,Patchell; Gregory David,2,0,30,28
1658023775979,MATH 10A,A02,083736,Patchell; Gregory David,20,0,30,10
1658023775979,MATH 10A,A03,083737,Patchell; Gregory David,16,0,30,14
1658023782003,MATH 10B,A01,083207,Lim; Seonhee,9,0,34,25
1658023782003,MATH 10B,A02,083208,Lim; Seonhee,10,0,35,25
1658023782003,MATH 10B,A03,093472,Lim; Seonhee,7,0,34,27
1658023782003,MATH 10B,B01,083739,Sinha; Shubham,14,0,30,16
1658023788027,MATH 18,A01,083743,Cinel; Cameron Alexander,9,0,30,21
1658023788027,MATH 18,A02,083744,Cinel; Cameron Alexander,18,0,30,12
1658023788027,MATH 18,A03,083745,Cinel; Cameron Alexander,10,0,30,20
1658023788027,MATH 18,B01,083748,Rideout; David Porter,5,0,37,32
1658023788027,MATH 18,B02,083749,Rideout; David Porter,5,0,36,31
1658023788027,MATH 18,B03,083750,Rideout; David Porter,3,0,37,34
1658023788027,MATH 18,B04,083751,Rideout; David Porter,7,0,36,29
1658023788027,MATH 18,B05,093473,Rideout; David Porter,7,0,36,29
1658023788027,MATH 18,B06,093474,Rideout; David Porter,6,0,36,30
1658023794051,MATH 20A,A01,083754,Zheng; Zequn,14,0,40,26
1658023800076,MATH 20B,A01,083756,Briones; Jor-el Thomas Caparas,4,0,36,32
1658023800076,MATH 20B,A02,083757,Briones; Jor-el Thomas Caparas,1,0,36,35
1658023800076,MATH 20B,A03,093475,Briones; Jor-el Thomas Caparas,3,0,36,33
1658023806099,MATH 20C,A01,083760,Briones; Jor-el Thomas Caparas,1,0,35,34
1658023806099,MATH 20C,A02,083761,Briones; Jor-el Thomas Caparas,8,0,35,27
1658023806099,MATH 20C,A03,093476,Briones; Jor-el Thomas Caparas,0,1,36,36
1658023806099,MATH 20C,B01,083762,Bach; Quang Tran,1,0,30,29
1658023812126,MATH 20D,A01,083765,Tran; Brian Kha,5,0,30,25
1658023812126,MATH 20D,A02,083766,Tran; Brian Kha,5,0,30,25
1658023812126,MATH 20D,A03,083767,Tran; Brian Kha,6,0,30,24
1658023818153,MATH 20E,A01,083771,Ganguly; Soumya,12,0,32,20
1658023818153,MATH 20E,A02,083772,Ganguly; Soumya,7,0,32,25
1658023818153,MATH 20E,B01,083773,Ciotti; Benjamin,20,0,35,15
1658023818153,MATH 20E,B02,083774,Ciotti; Benjamin,18,0,35,17
1658023824181,MATH 103A,A01,083777,Greenfeld; Be'Eri,6,0,36,30
1658023824181,MATH 103A,A02,083778,Greenfeld; Be'Eri,5,0,36,31
1658023824181,MATH 103A,A03,093561,Greenfeld; Be'Eri,7,0,36,29
1658023824181,MATH 103A,B01,083779,Greenfeld; Be'Eri,8,0,36,28
1658023824181,MATH 103A,B02,083780,Greenfeld; Be'Eri,4,0,36,32
1658023824181,MATH 103A,B03,093562,Greenfeld; Be'Eri,3,0,36,33
1658023830207,MATH 105,A01,085443,Carter; Anne Toulson,15,0,35,20
1658023830207,MATH 105,A02,093477,Carter; Anne Toulson,20,0,35,15
1658023836235,MATH 109,A01,083213,Ganzberger; Geoffrey Michael,3,0,34,31
1658023836235,MATH 109,A02,083214,Ganzberger; Geoffrey Michael,4,0,34,30
1658023836235,MATH 109,A03,093478,Ganzberger; Geoffrey Michael,2,0,34,32
1658023836235,MATH 109,B01,083215,Ganzberger; Geoffrey Michael,3,0,32,29
1658023836235,MATH 109,B02,083216,Ganzberger; Geoffrey Michael,3,0,32,29
1658023836235,MATH 109,B03,093479,Ganzberger; Geoffrey Michael,8,0,32,24
1658023842259,MATH 142A,A01,083219,Chow; Bennett,7,0,32,25
1658023842259,MATH 142A,A02,083220,Chow; Bennett,10,0,32,22
1658023842259,MATH 142A,A03,093480,Chow; Bennett,9,0,32,23
1658023842259,MATH 142A,B03,093481,Chow; Bennett,8,0,32,24
1658023842259,MATH 142A,B04,093558,Chow; Bennett,14,0,32,18
1658023842259,MATH 142A,B05,093559,Chow; Bennett,7,0,32,25
1658023848286,MATH 193A,A01,083224,Rotar; Vladimir,9,0,34,25
1658023848286,MATH 193A,A02,083225,Rotar; Vladimir,11,0,34,23
1658023848286,MATH 193A,A03,083781,Rotar; Vladimir,5,0,34,29
1658023848286,MATH 193A,A04,083782,Rotar; Vladimir,12,0,34,22
1658023848286,MATH 193A,A05,093482,Rotar; Vladimir,11,0,34,23
1658023854309,MATH 197,001,091859,McAuley; Julian John,9999,0,9999,0
1658023854309,MATH 197,002,095566,Kedlaya; Kiran S.,9997,0,9999,2
1658023854309,MATH 197,003,095567,Xiao; Ming,9999,0,9999,0
1658023854309,MATH 197,004,095571,Perols; Johan Lars,9998,0,9999,1
1658023861370,COGS 9,A01,083615,Shannon; Kyle Michael,11,0,75,64
1658023867392,COGS 11,A01,083617,Boyle; Mary E. T.,23,0,48,25
1658023873415,COGS 13,A01,083071,Bastos; Amalia Pinkusfeld,12,0,71,59
1658023879442,COGS 14A,A01,092681,Semenuks; Arturs,5,1,100,95
1658023885468,COGS 14B,A01,083073,Cheng; Tzu-Han,7,0,63,56
1658023891493,COGS 17,A01,092677,Semenuks; Arturs,7,0,81,74
1658023897516,COGS 100,A01,083619,Allen; Michael Gordon,17,0,70,53
1658023903542,COGS 101A,A01,083621,Davis; Joshua Daniel,9,0,68,59
1658023909565,COGS 101B,A01,091572,Allen; Michael Gordon,14,0,65,51
1658023915591,COGS 101C,A01,083625,Delgado; Tania,17,0,35,18
1658023921617,COGS 107A,A01,083627,Boyle; Mary E. T.,14,0,60,46
1658023927641,COGS 118A,A01,083075,Gupta; Anjum,21,0,76,55
1658023933665,CSE 3,A50,083646,Miranda; Gregory Joseph,24,0,50,26
1658023939689,CSE 8A,A50,083650,Miranda; Gregory Joseph,17,1,56,39
1658023945712,CSE 11,A01,083080,Cao; Yingjun,7,15,40,33
1658023951737,CSE 12,A01,083652,Krause-Levy; Sophia Louisa,30,1,120,90
1658023957760,CSE 15L,A01,083654,Morris; Justin Loren,9,0,50,41
1658023957760,CSE 15L,A02,083655,Morris; Justin Loren,11,0,50,39
1658023963781,CSE 20,A01,083657,Tran; Khoa Dang,39,0,80,41
1658023969803,CSE 21,A01,095574,Bach; Quang Tran,23,0,48,25
1658023975841,CSE 30,A01,083084,Eldon; John,8,0,80,72
1658023975841,CSE 30,B01,095061,Bhaskar; Nishant,9,0,50,41
1658023981868,CSE 100,A01,083659,Cao; Yingjun,5,4,70,65
1658023987890,CSE 134B,A01,083661,Powell; Thomas Allan,25,0,100,75
1658023993913,CSE 140,A01,083663,Gungor; Onat,17,0,85,68
1658023999935,CSE 140L,A01,083088,Eldon; John,23,0,100,77
1658024005977,CSE 175,A01,083665,Kumar; Rakesh,3,0,25,22
1658024012001,CSE 190,A00,092507,Dubnov; Shlomo,8,0,20,12
1658024018026,ECE 45,A01,083139,Congero; Spencer William,7,0,75,68
1658024024053,ECE 65,A50,083695,Saad; Andrew S,12,0,30,18
1658024024053,ECE 65,A51,095125,Saad; Andrew S,24,0,26,2
1658024030075,ECE 109,A01,091882,Touri; Behrouz,21,0,70,49
1658024036098,ECE 180,A00,083140,Abi Samra; Nicholas Camill,1,0,30,29
1658024036098,ECE 180,B00,083141,Abi Samra; Nicholas Camill,0,0,30,30
1658024042125,MATH 10A,A01,083735,Patchell; Gregory David,2,0,30,28
1658024042125,MATH 10A,A02,083736,Patchell; Gregory David,20,0,30,10
1658024042125,MATH 10A,A03,083737,Patchell; Gregory David,16,0,30,14
1658024048148,MATH 10B,A01,083207,Lim; Seonhee,9,0,34,25
1658024048148,MATH 10B,A02,083208,Lim; Seonhee,10,0,35,25
1658024048148,MATH 10B,A03,093472,Lim; Seonhee,7,0,34,27
1658024048148,MATH 10B,B01,083739,Sinha; Shubham,14,0,30,16
1658024054173,MATH 18,A01,083743,Cinel; Cameron Alexander,9,0,30,21
1658024054173,MATH 18,A02,083744,Cinel; Cameron Alexander,18,0,30,12
1658024054173,MATH 18,A03,083745,Cinel; Cameron Alexander,10,0,30,20
1658024054173,MATH 18,B01,083748,Rideout; David Porter,5,0,37,32
1658024054173,MATH 18,B02,083749,Rideout; David Porter,5,0,36,31
1658024054173,MATH 18,B03,083750,Rideout; David Porter,3,0,37,34
1658024054173,MATH 18,B04,083751,Rideout; David Porter,7,0,36,29
1658024054173,MATH 18,B05,093473,Rideout; David Porter,7,0,36,29
1658024054173,MATH 18,B06,093474,Rideout; David Porter,6,0,36,30
1658024060197,MATH 20A,A01,083754,Zheng; Zequn,14,0,40,26
1658024066223,MATH 20B,A01,083756,Briones; Jor-el Thomas Caparas,4,0,36,32
1658024066223,MATH 20B,A02,083757,Briones; Jor-el Thomas Caparas,1,0,36,35
1658024066223,MATH 20B,A03,093475,Briones; Jor-el Thomas Caparas,3,0,36,33
1658024072252,MATH 20C,A01,083760,Briones; Jor-el Thomas Caparas,1,0,35,34
1658024072252,MATH 20C,A02,083761,Briones; Jor-el Thomas Caparas,8,0,35,27
1658024072252,MATH 20C,A03,093476,Briones; Jor-el Thomas Caparas,0,1,36,36
1658024072252,MATH 20C,B01,083762,Bach; Quang Tran,1,0,30,29
1658024078284,MATH 20D,A01,083765,Tran; Brian Kha,5,0,30,25
1658024078284,MATH 20D,A02,083766,Tran; Brian Kha,5,0,30,25
1658024078284,MATH 20D,A03,083767,Tran; Brian Kha,6,0,30,24
1658024084311,MATH 20E,A01,083771,Ganguly; Soumya,12,0,32,20
1658024084311,MATH 20E,A02,083772,Ganguly; Soumya,7,0,32,25
1658024084311,MATH 20E,B01,083773,Ciotti; Benjamin,20,0,35,15
1658024084311,MATH 20E,B02,083774,Ciotti; Benjamin,18,0,35,17
1658024090335,MATH 103A,A01,083777,Greenfeld; Be'Eri,6,0,36,30
1658024090335,MATH 103A,A02,083778,Greenfeld; Be'Eri,5,0,36,31
1658024090335,MATH 103A,A03,093561,Greenfeld; Be'Eri,7,0,36,29
1658024090335,MATH 103A,B01,083779,Greenfeld; Be'Eri,8,0,36,28
1658024090335,MATH 103A,B02,083780,Greenfeld; Be'Eri,4,0,36,32
1658024090335,MATH 103A,B03,093562,Greenfeld; Be'Eri,3,0,36,33
1658024096362,MATH 105,A01,085443,Carter; Anne Toulson,15,0,35,20
1658024096362,MATH 105,A02,093477,Carter; Anne Toulson,20,0,35,15
1658024102390,MATH 109,A01,083213,Ganzberger; Geoffrey Michael,3,0,34,31
1658024102390,MATH 109,A02,083214,Ganzberger; Geoffrey Michael,4,0,34,30
1658024102390,MATH 109,A03,093478,Ganzberger; Geoffrey Michael,2,0,34,32
1658024102390,MATH 109,B01,083215,Ganzberger; Geoffrey Michael,3,0,32,29
1658024102390,MATH 109,B02,083216,Ganzberger; Geoffrey Michael,3,0,32,29
1658024102390,MATH 109,B03,093479,Ganzberger; Geoffrey Michael,8,0,32,24
1658024108420,MATH 142A,A01,083219,Chow; Bennett,7,0,32,25
1658024108420,MATH 142A,A02,083220,Chow; Bennett,10,0,32,22
1658024108420,MATH 142A,A03,093480,Chow; Bennett,9,0,32,23
1658024108420,MATH 142A,B03,093481,Chow; Bennett,8,0,32,24
1658024108420,MATH 142A,B04,093558,Chow; Bennett,14,0,32,18
1658024108420,MATH 142A,B05,093559,Chow; Bennett,7,0,32,25
1658024114444,MATH 193A,A01,083224,Rotar; Vladimir,9,0,34,25
1658024114444,MATH 193A,A02,083225,Rotar; Vladimir,11,0,34,23
1658024114444,MATH 193A,A03,083781,Rotar; Vladimir,5,0,34,29
1658024114444,MATH 193A,A04,083782,Rotar; Vladimir,12,0,34,22
1658024114444,MATH 193A,A05,093482,Rotar; Vladimir,11,0,34,23
1658024120471,MATH 197,001,091859,McAuley; Julian John,9999,0,9999,0
1658024120471,MATH 197,002,095566,Kedlaya; Kiran S.,9997,0,9999,2
1658024120471,MATH 197,003,095567,Xiao; Ming,9999,0,9999,0
1658024120471,MATH 197,004,095571,Perols; Johan Lars,9998,0,9999,1
1658024127522,COGS 9,A01,083615,Shannon; Kyle Michael,11,0,75,64
1658024133545,COGS 11,A01,083617,Boyle; Mary E. T.,23,0,48,25
1658024139568,COGS 13,A01,083071,Bastos; Amalia Pinkusfeld,12,0,71,59
1658024145592,COGS 14A,A01,092681,Semenuks; Arturs,5,1,100,95
1658024151618,COGS 14B,A01,083073,Cheng; Tzu-Han,7,0,63,56
1658024157642,COGS 17,A01,092677,Semenuks; Arturs,7,0,81,74
1658024163669,COGS 100,A01,083619,Allen; Michael Gordon,17,0,70,53
1658024169693,COGS 101A,A01,083621,Davis; Joshua Daniel,9,0,68,59
1658024175720,COGS 101B,A01,091572,Allen; Michael Gordon,14,0,65,51
1658024181746,COGS 101C,A01,083625,Delgado; Tania,17,0,35,18
1658024187769,COGS 107A,A01,083627,Boyle; Mary E. T.,14,0,60,46
1658024193792,COGS 118A,A01,083075,Gupta; Anjum,21,0,76,55
1658024199818,CSE 3,A50,083646,Miranda; Gregory Joseph,24,0,50,26
1658024205841,CSE 8A,A50,083650,Miranda; Gregory Joseph,17,1,56,39
1658024211864,CSE 11,A01,083080,Cao; Yingjun,7,15,40,33
1658024217895,CSE 12,A01,083652,Krause-Levy; Sophia Louisa,30,1,120,90
1658024223918,CSE 15L,A01,083654,Morris; Justin Loren,9,0,50,41
1658024223918,CSE 15L,A02,083655,Morris; Justin Loren,11,0,50,39
1658024229939,CSE 20,A01,083657,Tran; Khoa Dang,39,0,80,41
1658024235964,CSE 21,A01,095574,Bach; Quang Tran,23,0,48,25
1658024241990,CSE 30,A01,083084,Eldon; John,8,0,80,72
1658024241990,CSE 30,B01,095061,Bhaskar; Nishant,9,0,50,41
1658024248018,CSE 100,A01,083659,Cao; Yingjun,5,4,70,65
1658024254046,CSE 134B,A01,083661,Powell; Thomas Allan,25,0,100,75
1658024260069,CSE 140,A01,083663,Gungor; Onat,17,0,85,68
1658024266096,CSE 140L,A01,083088,Eldon; John,23,0,100,77
1658024272119,CSE 175,A01,083665,Kumar; Rakesh,3,0,25,22
1658024278142,CSE 190,A00,092507,Dubnov; Shlomo,8,0,20,12
1658024284174,ECE 45,A01,083139,Congero; Spencer William,7,0,75,68
1658024290198,ECE 65,A50,083695,Saad; Andrew S,12,0,30,18
1658024290198,ECE 65,A51,095125,Saad; Andrew S,24,0,26,2
1658024296220,ECE 109,A01,091882,Touri; Behrouz,21,0,70,49
1658024302251,ECE 180,A00,083140,Abi Samra; Nicholas Camill,1,0,30,29
1658024302251,ECE 180,B00,083141,Abi Samra; Nicholas Camill,0,0,30,30
1658024308274,MATH 10A,A01,083735,Patchell; Gregory David,2,0,30,28
1658024308274,MATH 10A,A02,083736,Patchell; Gregory David,20,0,30,10
1658024308274,MATH 10A,A03,083737,Patchell; Gregory David,16,0,30,14
1658024314297,MATH 10B,A01,083207,Lim; Seonhee,9,0,34,25
1658024314297,MATH 10B,A02,083208,Lim; Seonhee,10,0,35,25
1658024314297,MATH 10B,A03,093472,Lim; Seonhee,7,0,34,27
1658024314297,MATH 10B,B01,083739,Sinha; Shubham,14,0,30,16
1658024320327,MATH 18,A01,083743,Cinel; Cameron Alexander,9,0,30,21
1658024320327,MATH 18,A02,083744,Cinel; Cameron Alexander,18,0,30,12
1658024320327,MATH 18,A03,083745,Cinel; Cameron Alexander,10,0,30,20
1658024320327,MATH 18,B01,083748,Rideout; David Porter,5,0,37,32
1658024320327,MATH 18,B02,083749,Rideout; David Porter,5,0,36,31
1658024320327,MATH 18,B03,083750,Rideout; David Porter,3,0,37,34
1658024320327,MATH 18,B04,083751,Rideout; David Porter,7,0,36,29
1658024320327,MATH 18,B05,093473,Rideout; David Porter,7,0,36,29
1658024320327,MATH 18,B06,093474,Rideout; David Porter,6,0,36,30
1658024326350,MATH 20A,A01,083754,Zheng; Zequn,14,0,40,26
1658024332378,MATH 20B,A01,083756,Briones; Jor-el Thomas Caparas,4,0,36,32
1658024332378,MATH 20B,A02,083757,Briones; Jor-el Thomas Caparas,1,0,36,35
1658024332378,MATH 20B,A03,093475,Briones; Jor-el Thomas Caparas,3,0,36,33
1658024338402,MATH 20C,A01,083760,Briones; Jor-el Thomas Caparas,1,0,35,34
1658024338402,MATH 20C,A02,083761,Briones; Jor-el Thomas Caparas,8,0,35,27
1658024338402,MATH 20C,A03,093476,Briones; Jor-el Thomas Caparas,0,1,36,36
1658024338402,MATH 20C,B01,083762,Bach; Quang Tran,1,0,30,29
1658024344426,MATH 20D,A01,083765,Tran; Brian Kha,5,0,30,25
1658024344426,MATH 20D,A02,083766,Tran; Brian Kha,5,0,30,25
1658024344426,MATH 20D,A03,083767,Tran; Brian Kha,6,0,30,24
1658024350457,MATH 20E,A01,083771,Ganguly; Soumya,12,0,32,20
1658024350457,MATH 20E,A02,083772,Ganguly; Soumya,7,0,32,25
1658024350457,MATH 20E,B01,083773,Ciotti; Benjamin,20,0,35,15
1658024350457,MATH 20E,B02,083774,Ciotti; Benjamin,18,0,35,17
1658024356482,MATH 103A,A01,083777,Greenfeld; Be'Eri,6,0,36,30
1658024356482,MATH 103A,A02,083778,Greenfeld; Be'Eri,5,0,36,31
1658024356482,MATH 103A,A03,093561,Greenfeld; Be'Eri,7,0,36,29
1658024356482,MATH 103A,B01,083779,Greenfeld; Be'Eri,8,0,36,28
1658024356482,MATH 103A,B02,083780,Greenfeld; Be'Eri,4,0,36,32
1658024356482,MATH 103A,B03,093562,Greenfeld; Be'Eri,3,0,36,33
1658024362507,MATH 105,A01,085443,Carter; Anne Toulson,15,0,35,20
1658024362507,MATH 105,A02,093477,Carter; Anne Toulson,20,0,35,15
1658024368536,MATH 109,A01,083213,Ganzberger; Geoffrey Michael,3,0,34,31
1658024368536,MATH 109,A02,083214,Ganzberger; Geoffrey Michael,4,0,34,30
1658024368536,MATH 109,A03,093478,Ganzberger; Geoffrey Michael,2,0,34,32
1658024368536,MATH 109,B01,083215,Ganzberger; Geoffrey Michael,3,0,32,29
1658024368536,MATH 109,B02,083216,Ganzberger; Geoffrey Michael,3,0,32,29
1658024368536,MATH 109,B03,093479,Ganzberger; Geoffrey Michael,8,0,32,24
1658024374641,MATH 142A,A01,083219,Chow; Bennett,7,0,32,25
1658024374641,MATH 142A,A02,083220,Chow; Bennett,10,0,32,22
1658024374641,MATH 142A,A03,093480,Chow; Bennett,9,0,32,23
1658024374641,MATH 142A,B03,093481,Chow; Bennett,8,0,32,24
1658024374641,MATH 142A,B04,093558,Chow; Bennett,14,0,32,18
1658024374641,MATH 142A,B05,093559,Chow; Bennett,7,0,32,25
1658024380664,MATH 193A,A01,083224,Rotar; Vladimir,9,0,34,25
1658024380664,MATH 193A,A02,083225,Rotar; Vladimir,11,0,34,23
1658024380664,MATH 193A,A03,083781,Rotar; Vladimir,5,0,34,29
1658024380664,MATH 193A,A04,083782,Rotar; Vladimir,12,0,34,22
1658024380664,MATH 193A,A05,093482,Rotar; Vladimir,11,0,34,23
1658024386687,MATH 197,001,091859,McAuley; Julian John,9999,0,9999,0
1658024386687,MATH 197,002,095566,Kedlaya; Kiran S.,9997,0,9999,2
1658024386687,MATH 197,003,095567,Xiao; Ming,9999,0,9999,0
1658024386687,MATH 197,004,095571,Perols; Johan Lars,9998,0,9999,1
1658024393737,COGS 9,A01,083615,Shannon; Kyle Michael,11,0,75,64
1658024399761,COGS 11,A01,083617,Boyle; Mary E. T.,23,0,48,25
1658024405787,COGS 13,A01,083071,Bastos; Amalia Pinkusfeld,12,0,71,59
1658024411810,COGS 14A,A01,092681,Semenuks; Arturs,5,1,100,95
1658024417833,COGS 14B,A01,083073,Cheng; Tzu-Han,7,0,63,56
1658024423856,COGS 17,A01,092677,Semenuks; Arturs,7,0,81,74
1658024429879,COGS 100,A01,083619,Allen; Michael Gordon,17,0,70,53
1658024435902,COGS 101A,A01,083621,Davis; Joshua Daniel,9,0,68,59
1658024441928,COGS 101B,A01,091572,Allen; Michael Gordon,14,0,65,51
1658024447951,COGS 101C,A01,083625,Delgado; Tania,17,0,35,18
1658024453976,COGS 107A,A01,083627,Boyle; Mary E. T.,14,0,60,46
1658024460000,COGS 118A,A01,083075,Gupta; Anjum,21,0,76,55
1658024466027,CSE 3,A50,083646,Miranda; Gregory Joseph,24,0,50,26
1658024472051,CSE 8A,A50,083650,Miranda; Gregory Joseph,17,1,56,39
1658024478072,CSE 11,A01,083080,Cao; Yingjun,7,15,40,33
1658024484094,CSE 12,A01,083652,Krause-Levy; Sophia Louisa,30,1,120,90
1658024490124,CSE 15L,A01,083654,Morris; Justin Loren,9,0,50,41
1658024490124,CSE 15L,A02,083655,Morris; Justin Loren,11,0,50,39
1658024496150,CSE 20,A01,083657,Tran; Khoa Dang,39,0,80,41
1658024502172,CSE 21,A01,095574,Bach; Quang Tran,23,0,48,25
1658024508209,CSE 30,A01,083084,Eldon; John,8,0,80,72
1658024508209,CSE 30,B01,095061,Bhaskar; Nishant,9,0,50,41
1658024514235,CSE 100,A01,083659,Cao; Yingjun,5,4,70,65
1658024520257,CSE 134B,A01,083661,Powell; Thomas Allan,25,0,100,75
1658024526279,CSE 140,A01,083663,Gungor; Onat,17,0,85,68
1658024532303,CSE 140L,A01,083088,Eldon; John,23,0,100,77
1658024538325,CSE 175,A01,083665,Kumar; Rakesh,3,0,25,22
1658024544350,CSE 190,A00,092507,Dubnov; Shlomo,8,0,20,12
1658024550382,ECE 45,A01,083139,Congero; Spencer William,7,0,75,68
1658024556405,ECE 65,A50,083695,Saad; Andrew S,12,0,30,18
1658024556405,ECE 65,A51,095125,Saad; Andrew S,24,0,26,2
1658024562427,ECE 109,A01,091882,Touri; Behrouz,21,0,70,49
1658024568449,ECE 180,A00,083140,Abi Samra; Nicholas Camill,1,0,30,29
1658024568449,ECE 180,B00,083141,Abi Samra; Nicholas Camill,0,0,30,30
1658024574475,MATH 10A,A01,083735,Patchell; Gregory David,2,0,30,28
1658024574475,MATH 10A,A02,083736,Patchell; Gregory David,20,0,30,10
1658024574475,MATH 10A,A03,083737,Patchell; Gregory David,16,0,30,14
1658024580509,MATH 10B,A01,083207,Lim; Seonhee,9,0,34,25
1658024580509,MATH 10B,A02,083208,Lim; Seonhee,10,0,35,25
1658024580509,MATH 10B,A03,093472,Lim; Seonhee,7,0,34,27
1658024580509,MATH 10B,B01,083739,Sinha; Shubham,14,0,30,16
1658024586533,MATH 18,A01,083743,Cinel; Cameron Alexander,9,0,30,21
1658024586533,MATH 18,A02,083744,Cinel; Cameron Alexander,18,0,30,12
1658024586533,MATH 18,A03,083745,Cinel; Cameron Alexander,10,0,30,20
1658024586533,MATH 18,B01,083748,Rideout; David Porter,5,0,37,32
1658024586533,MATH 18,B02,083749,Rideout; David Porter,5,0,36,31
1658024586533,MATH 18,B03,083750,Rideout; David Porter,3,0,37,34
1658024586533,MATH 18,B04,083751,Rideout; David Porter,7,0,36,29
1658024586533,MATH 18,B05,093473,Rideout; David Porter,7,0,36,29
1658024586533,MATH 18,B06,093474,Rideout; David Porter,6,0,36,30
1658024592560,MATH 20A,A01,083754,Zheng; Zequn,14,0,40,26
1658024598581,MATH 20B,A01,083756,Briones; Jor-el Thomas Caparas,4,0,36,32
1658024598581,MATH 20B,A02,083757,Briones; Jor-el Thomas Caparas,1,0,36,35
1658024598581,MATH 20B,A03,093475,Briones; Jor-el Thomas Caparas,3,0,36,33
1658024604604,MATH 20C,A01,083760,Briones; Jor-el Thomas Caparas,1,0,35,34
1658024604604,MATH 20C,A02,083761,Briones; Jor-el Thomas Caparas,8,0,35,27
1658024604604,MATH 20C,A03,093476,Briones; Jor-el Thomas Caparas,0,1,36,36
1658024604604,MATH 20C,B01,083762,Bach; Quang Tran,1,0,30,29
1658024610632,MATH 20D,A01,083765,Tran; Brian Kha,5,0,30,25
1658024610632,MATH 20D,A02,083766,Tran; Brian Kha,5,0,30,25
1658024610632,MATH 20D,A03,083767,Tran; Brian Kha,6,0,30,24
1658024616656,MATH 20E,A01,083771,Ganguly; Soumya,12,0,32,20
1658024616656,MATH 20E,A02,083772,Ganguly; Soumya,7,0,32,25
1658024616656,MATH 20E,B01,083773,Ciotti; Benjamin,20,0,35,15
1658024616656,MATH 20E,B02,083774,Ciotti; Benjamin,18,0,35,17
1658024622680,MATH 103A,A01,083777,Greenfeld; Be'Eri,6,0,36,30
1658024622680,MATH 103A,A02,083778,Greenfeld; Be'Eri,5,0,36,31
1658024622680,MATH 103A,A03,093561,Greenfeld; Be'Eri,7,0,36,29
1658024622680,MATH 103A,B01,083779,Greenfeld; Be'Eri,8,0,36,28
1658024622680,MATH 103A,B02,083780,Greenfeld; Be'Eri,4,0,36,32
1658024622680,MATH 103A,B03,093562,Greenfeld; Be'Eri,3,0,36,33
1658024628704,MATH 105,A01,085443,Carter; Anne Toulson,15,0,35,20
1658024628704,MATH 105,A02,093477,Carter; Anne Toulson,20,0,35,15
1658024634732,MATH 109,A01,083213,Ganzberger; Geoffrey Michael,3,0,34,31
1658024634732,MATH 109,A02,083214,Ganzberger; Geoffrey Michael,4,0,34,30
1658024634732,MATH 109,A03,093478,Ganzberger; Geoffrey Michael,2,0,34,32
1658024634732,MATH 109,B01,083215,Ganzberger; Geoffrey Michael,3,0,32,29
1658024634732,MATH 109,B02,083216,Ganzberger; Geoffrey Michael,3,0,32,29
1658024634732,MATH 109,B03,093479,Ganzberger; Geoffrey Michael,8,0,32,24
1658024640761,MATH 142A,A01,083219,Chow; Bennett,7,0,32,25
1658024640761,MATH 142A,A02,083220,Chow; Bennett,10,0,32,22
1658024640761,MATH 142A,A03,093480,Chow; Bennett,9,0,32,23
1658024640761,MATH 142A,B03,093481,Chow; Bennett,8,0,32,24
1658024640761,MATH 142A,B04,093558,Chow; Bennett,14,0,32,18
1658024640761,MATH 142A,B05,093559,Chow; Bennett,7,0,32,25
1658024646788,MATH 193A,A01,083224,Rotar; Vladimir,9,0,34,25
1658024646788,MATH 193A,A02,083225,Rotar; Vladimir,11,0,34,23
1658024646788,MATH 193A,A03,083781,Rotar; Vladimir,5,0,34,29
1658024646788,MATH 193A,A04,083782,Rotar; Vladimir,12,0,34,22
1658024646788,MATH 193A,A05,093482,Rotar; Vladimir,11,0,34,23
1658024652810,MATH 197,001,091859,McAuley; Julian John,9999,0,9999,0
1658024652810,MATH 197,002,095566,Kedlaya; Kiran S.,9997,0,9999,2
1658024652810,MATH 197,003,095567,Xiao; Ming,9999,0,9999,0
1658024652810,MATH 197,004,095571,Perols; Johan Lars,9998,0,9999,1
1658024659866,COGS 9,A01,083615,Shannon; Kyle Michael,11,0,75,64
1658024665895,COGS 11,A01,083617,Boyle; Mary E. T.,23,0,48,25
1658024671918,COGS 13,A01,083071,Bastos; Amalia Pinkusfeld,12,0,71,59
1658024677940,COGS 14A,A01,092681,Semenuks; Arturs,5,1,100,95
1658024683967,COGS 14B,A01,083073,Cheng; Tzu-Han,7,0,63,56
1658024690001,COGS 17,A01,092677,Semenuks; Arturs,7,0,81,74
1658024696026,COGS 100,A01,083619,Allen; Michael Gordon,17,0,70,53
1658024702056,COGS 101A,A01,083621,Davis; Joshua Daniel,9,0,68,59
1658024708080,COGS 101B,A01,091572,Allen; Michael Gordon,14,0,65,51
1658024714106,COGS 101C,A01,083625,Delgado; Tania,17,0,35,18
1658024720133,COGS 107A,A01,083627,Boyle; Mary E. T.,14,0,60,46
1658024726155,COGS 118A,A01,083075,Gupta; Anjum,21,0,76,55
1658024732183,CSE 3,A50,083646,Miranda; Gregory Joseph,24,0,50,26
1658024738207,CSE 8A,A50,083650,Miranda; Gregory Joseph,17,1,56,39
1658024744235,CSE 11,A01,083080,Cao; Yingjun,7,15,40,33
1658024750259,CSE 12,A01,083652,Krause-Levy; Sophia Louisa,30,1,120,90
1658024756285,CSE 15L,A01,083654,Morris; Justin Loren,9,0,50,41
1658024756285,CSE 15L,A02,083655,Morris; Justin Loren,11,0,50,39
1658024762311,CSE 20,A01,083657,Tran; Khoa Dang,39,0,80,41
1658024768334,CSE 21,A01,095574,Bach; Quang Tran,23,0,48,25
1658024774359,CSE 30,A01,083084,Eldon; John,8,0,80,72
1658024774359,CSE 30,B01,095061,Bhaskar; Nishant,9,0,50,41
1658024780382,CSE 100,A01,083659,Cao; Yingjun,5,4,70,65
1658024786412,CSE 134B,A01,083661,Powell; Thomas Allan,25,0,100,75
1658024792435,CSE 140,A01,083663,Gungor; Onat,17,0,85,68
1658024798456,CSE 140L,A01,083088,Eldon; John,23,0,100,77
1658024804479,CSE 175,A01,083665,Kumar; Rakesh,3,0,25,22
1658024810506,CSE 190,A00,092507,Dubnov; Shlomo,8,0,20,12
1658024816537,ECE 45,A01,083139,Congero; Spencer William,7,0,75,68
1658024822560,ECE 65,A50,083695,Saad; Andrew S,12,0,30,18
1658024822560,ECE 65,A51,095125,Saad; Andrew S,24,0,26,2
1658024828582,ECE 109,A01,091882,Touri; Behrouz,21,0,70,49
1658024834604,ECE 180,A00,083140,Abi Samra; Nicholas Camill,1,0,30,29
1658024834604,ECE 180,B00,083141,Abi Samra; Nicholas Camill,0,0,30,30
1658024840626,MATH 10A,A01,083735,Patchell; Gregory David,2,0,30,28
1658024840626,MATH 10A,A02,083736,Patchell; Gregory David,20,0,30,10
1658024840626,MATH 10A,A03,083737,Patchell; Gregory David,16,0,30,14
1658024846655,MATH 10B,A01,083207,Lim; Seonhee,9,0,34,25
1658024846655,MATH 10B,A02,083208,Lim; Seonhee,10,0,35,25
1658024846655,MATH 10B,A03,093472,Lim; Seonhee,7,0,34,27
1658024846655,MATH 10B,B01,083739,Sinha; Shubham,14,0,30,16
1658024852686,MATH 18,A01,083743,Cinel; Cameron Alexander,9,0,30,21
1658024852686,MATH 18,A02,083744,Cinel; Cameron Alexander,18,0,30,12
1658024852686,MATH 18,A03,083745,Cinel; Cameron Alexander,10,0,30,20
1658024852686,MATH 18,B01,083748,Rideout; David Porter,5,0,37,32
1658024852686,MATH 18,B02,083749,Rideout; David Porter,5,0,36,31
1658024852686,MATH 18,B03,083750,Rideout; David Porter,3,0,37,34
1658024852686,MATH 18,B04,083751,Rideout; David Porter,7,0,36,29
1658024852686,MATH 18,B05,093473,Rideout; David Porter,7,0,36,29
1658024852686,MATH 18,B06,093474,Rideout; David Porter,6,0,36,30
1658024858710,MATH 20A,A01,083754,Zheng; Zequn,14,0,40,26
1658024864733,MATH 20B,A01,083756,Briones; Jor-el Thomas Caparas,4,0,36,32
1658024864733,MATH 20B,A02,083757,Briones; Jor-el Thomas Caparas,1,0,36,35
1658024864733,MATH 20B,A03,093475,Briones; Jor-el Thomas Caparas,3,0,36,33
1658024870759,MATH 20C,A01,083760,Briones; Jor-el Thomas Caparas,1,0,35,34
1658024870759,MATH 20C,A02,083761,Briones; Jor-el Thomas Caparas,8,0,35,27
1658024870759,MATH 20C,A03,093476,Briones; Jor-el Thomas Caparas,0,1,36,36
1658024870759,MATH 20C,B01,083762,Bach; Quang Tran,1,0,30,29
1658024876782,MATH 20D,A01,083765,Tran; Brian Kha,5,0,30,25
1658024876782,MATH 20D,A02,083766,Tran; Brian Kha,5,0,30,25
1658024876782,MATH 20D,A03,083767,Tran; Brian Kha,6,0,30,24
1658024882805,MATH 20E,A01,083771,Ganguly; Soumya,12,0,32,20
1658024882805,MATH 20E,A02,083772,Ganguly; Soumya,7,0,32,25
1658024882805,MATH 20E,B01,083773,Ciotti; Benjamin,20,0,35,15
1658024882805,MATH 20E,B02,083774,Ciotti; Benjamin,18,0,35,17
1658024888829,MATH 103A,A01,083777,Greenfeld; Be'Eri,6,0,36,30
1658024888829,MATH 103A,A02,083778,Greenfeld; Be'Eri,5,0,36,31
1658024888829,MATH 103A,A03,093561,Greenfeld; Be'Eri,7,0,36,29
1658024888829,MATH 103A,B01,083779,Greenfeld; Be'Eri,8,0,36,28
1658024888829,MATH 103A,B02,083780,Greenfeld; Be'Eri,4,0,36,32
1658024888829,MATH 103A,B03,093562,Greenfeld; Be'Eri,3,0,36,33
1658024894855,MATH 105,A01,085443,Carter; Anne Toulson,15,0,35,20
1658024894855,MATH 105,A02,093477,Carter; Anne Toulson,20,0,35,15
1658024900878,MATH 109,A01,083213,Ganzberger; Geoffrey Michael,3,0,34,31
1658024900878,MATH 109,A02,083214,Ganzberger; Geoffrey Michael,4,0,34,30
1658024900878,MATH 109,A03,093478,Ganzberger; Geoffrey Michael,2,0,34,32
1658024900878,MATH 109,B01,083215,Ganzberger; Geoffrey Michael,3,0,32,29
1658024900878,MATH 109,B02,083216,Ganzberger; Geoffrey Michael,3,0,32,29
1658024900878,MATH 109,B03,093479,Ganzberger; Geoffrey Michael,8,0,32,24
1658024906904,MATH 142A,A01,083219,Chow; Bennett,7,0,32,25
1658024906904,MATH 142A,A02,083220,Chow; Bennett,10,0,32,22
1658024906904,MATH 142A,A03,093480,Chow; Bennett,9,0,32,23
1658024906904,MATH 142A,B03,093481,Chow; Bennett,8,0,32,24
1658024906904,MATH 142A,B04,093558,Chow; Bennett,14,0,32,18
1658024906904,MATH 142A,B05,093559,Chow; Bennett,7,0,32,25
1658024912932,MATH 193A,A01,083224,Rotar; Vladimir,9,0,34,25
1658024912932,MATH 193A,A02,083225,Rotar; Vladimir,11,0,34,23
1658024912932,MATH 193A,A03,083781,Rotar; Vladimir,5,0,34,29
1658024912932,MATH 193A,A04,083782,Rotar; Vladimir,12,0,34,22
1658024912932,MATH 193A,A05,093482,Rotar; Vladimir,11,0,34,23
1658024918954,MATH 197,001,091859,McAuley; Julian John,9999,0,9999,0
1658024918954,MATH 197,002,095566,Kedlaya; Kiran S.,9997,0,9999,2
1658024918954,MATH 197,003,095567,Xiao; Ming,9999,0,9999,0
1658024918954,MATH 197,004,095571,Perols; Johan Lars,9998,0,9999,1
1658024926015,COGS 9,A01,083615,Shannon; Kyle Michael,11,0,75,64
1658024932039,COGS 11,A01,083617,Boyle; Mary E. T.,23,0,48,25
1658024938061,COGS 13,A01,083071,Bastos; Amalia Pinkusfeld,12,0,71,59
1658024944089,COGS 14A,A01,092681,Semenuks; Arturs,5,1,100,95
1658024950113,COGS 14B,A01,083073,Cheng; Tzu-Han,7,0,63,56
1658024956139,COGS 17,A01,092677,Semenuks; Arturs,7,0,81,74
1658024962164,COGS 100,A01,083619,Allen; Michael Gordon,17,0,70,53
1658024968276,COGS 101A,A01,083621,Davis; Joshua Daniel,9,0,68,59
1658024974298,COGS 101B,A01,091572,Allen; Michael Gordon,14,0,65,51
1658024980321,COGS 101C,A01,083625,Delgado; Tania,17,0,35,18
1658024986347,COGS 107A,A01,083627,Boyle; Mary E. T.,14,0,60,46
1658024992374,COGS 118A,A01,083075,Gupta; Anjum,21,0,76,55
1658024998401,CSE 3,A50,083646,Miranda; Gregory Joseph,24,0,50,26
1658025004434,CSE 8A,A50,083650,Miranda; Gregory Joseph,17,1,56,39
1658025010459,CSE 11,A01,083080,Cao; Yingjun,7,15,40,33
1658025016482,CSE 12,A01,083652,Krause-Levy; Sophia Louisa,30,1,120,90
1658025022504,CSE 15L,A01,083654,Morris; Justin Loren,9,0,50,41
1658025022504,CSE 15L,A02,083655,Morris; Justin Loren,11,0,50,39
1658025028531,CSE 20,A01,083657,Tran; Khoa Dang,39,0,80,41
1658025034554,CSE 21,A01,095574,Bach; Quang Tran,23,0,48,25
1658025040578,CSE 30,A01,083084,Eldon; John,8,0,80,72
1658025040578,CSE 30,B01,095061,Bhaskar; Nishant,9,0,50,41
1658025046599,CSE 100,A01,083659,Cao; Yingjun,5,4,70,65
1658025052626,CSE 134B,A01,083661,Powell; Thomas Allan,25,0,100,75
1658025058647,CSE 140,A01,083663,Gungor; Onat,17,0,85,68
1658025064672,CSE 140L,A01,083088,Eldon; John,23,0,100,77
1658025070693,CSE 175,A01,083665,Kumar; Rakesh,3,0,25,22
1658025076714,CSE 190,A00,092507,Dubnov; Shlomo,8,0,20,12
1658025082737,ECE 45,A01,083139,Congero; Spencer William,7,0,75,68
1658025088760,ECE 65,A50,083695,Saad; Andrew S,12,0,30,18
1658025088760,ECE 65,A51,095125,Saad; Andrew S,24,0,26,2
1658025094782,ECE 109,A01,091882,Touri; Behrouz,21,0,70,49
1658025100804,ECE 180,A00,083140,Abi Samra; Nicholas Camill,1,0,30,29
1658025100804,ECE 180,B00,083141,Abi Samra; Nicholas Camill,0,0,30,30
1658025106831,MATH 10A,A01,083735,Patchell; Gregory David,2,0,30,28
1658025106831,MATH 10A,A02,083736,Patchell; Gregory David,20,0,30,10
1658025106831,MATH 10A,A03,083737,Patchell; Gregory David,16,0,30,14
1658025112855,MATH 10B,A01,083207,Lim; Seonhee,9,0,34,25
1658025112855,MATH 10B,A02,083208,Lim; Seonhee,10,0,35,25
1658025112855,MATH 10B,A03,093472,Lim; Seonhee,7,0,34,27
1658025112855,MATH 10B,B01,083739,Sinha; Shubham,14,0,30,16
1658025118885,MATH 18,A01,083743,Cinel; Cameron Alexander,9,0,30,21
1658025118885,MATH 18,A02,083744,Cinel; Cameron Alexander,18,0,30,12
1658025118885,MATH 18,A03,083745,Cinel; Cameron Alexander,10,0,30,20
1658025118885,MATH 18,B01,083748,Rideout; David Porter,5,0,37,32
1658025118885,MATH 18,B02,083749,Rideout; David Porter,5,0,36,31
1658025118885,MATH 18,B03,083750,Rideout; David Porter,3,0,37,34
1658025118885,MATH 18,B04,083751,Rideout; David Porter,7,0,36,29
1658025118885,MATH 18,B05,093473,Rideout; David Porter,7,0,36,29
1658025118885,MATH 18,B06,093474,Rideout; David Porter,6,0,36,30
1658025124911,MATH 20A,A01,083754,Zheng; Zequn,14,0,40,26
1658025130934,MATH 20B,A01,083756,Briones; Jor-el Thomas Caparas,4,0,36,32
1658025130934,MATH 20B,A02,083757,Briones; Jor-el Thomas Caparas,1,0,36,35
1658025130934,MATH 20B,A03,093475,Briones; Jor-el Thomas Caparas,3,0,36,33
1658025136961,MATH 20C,A01,083760,Briones; Jor-el Thomas Caparas,1,0,35,34
1658025136961,MATH 20C,A02,083761,Briones; Jor-el Thomas Caparas,8,0,35,27
1658025136961,MATH 20C,A03,093476,Briones; Jor-el Thomas Caparas,0,1,36,36
1658025136961,MATH 20C,B01,083762,Bach; Quang Tran,1,0,30,29
1658025142988,MATH 20D,A01,083765,Tran; Brian Kha,5,0,30,25
1658025142988,MATH 20D,A02,083766,Tran; Brian Kha,5,0,30,25
1658025142988,MATH 20D,A03,083767,Tran; Brian Kha,6,0,30,24
1658025149014,MATH 20E,A01,083771,Ganguly; Soumya,12,0,32,20
1658025149014,MATH 20E,A02,083772,Ganguly; Soumya,7,0,32,25
1658025149014,MATH 20E,B01,083773,Ciotti; Benjamin,20,0,35,15
1658025149014,MATH 20E,B02,083774,Ciotti; Benjamin,18,0,35,17
1658025155038,MATH 103A,A01,083777,Greenfeld; Be'Eri,6,0,36,30
1658025155038,MATH 103A,A02,083778,Greenfeld; Be'Eri,5,0,36,31
1658025155038,MATH 103A,A03,093561,Greenfeld; Be'Eri,7,0,36,29
1658025155038,MATH 103A,B01,083779,Greenfeld; Be'Eri,8,0,36,28
1658025155038,MATH 103A,B02,083780,Greenfeld; Be'Eri,4,0,36,32
1658025155038,MATH 103A,B03,093562,Greenfeld; Be'Eri,3,0,36,33
1658025161066,MATH 105,A01,085443,Carter; Anne Toulson,15,0,35,20
1658025161066,MATH 105,A02,093477,Carter; Anne Toulson,20,0,35,15
1658025167088,MATH 109,A01,083213,Ganzberger; Geoffrey Michael,3,0,34,31
1658025167088,MATH 109,A02,083214,Ganzberger; Geoffrey Michael,4,0,34,30
1658025167088,MATH 109,A03,093478,Ganzberger; Geoffrey Michael,2,0,34,32
1658025167088,MATH 109,B01,083215,Ganzberger; Geoffrey Michael,3,0,32,29
1658025167088,MATH 109,B02,083216,Ganzberger; Geoffrey Michael,3,0,32,29
1658025167088,MATH 109,B03,093479,Ganzberger; Geoffrey Michael,8,0,32,24
1658025173112,MATH 142A,A01,083219,Chow; Bennett,7,0,32,25
1658025173112,MATH 142A,A02,083220,Chow; Bennett,10,0,32,22
1658025173112,MATH 142A,A03,093480,Chow; Bennett,9,0,32,23
1658025173112,MATH 142A,B03,093481,Chow; Bennett,8,0,32,24
1658025173112,MATH 142A,B04,093558,Chow; Bennett,14,0,32,18
1658025173112,MATH 142A,B05,093559,Chow; Bennett,7,0,32,25
1658025179146,MATH 193A,A01,083224,Rotar; Vladimir,9,0,34,25
1658025179146,MATH 193A,A02,083225,Rotar; Vladimir,11,0,34,23
1658025179146,MATH 193A,A03,083781,Rotar; Vladimir,5,0,34,29
1658025179146,MATH 193A,A04,083782,Rotar; Vladimir,12,0,34,22
1658025179146,MATH 193A,A05,093482,Rotar; Vladimir,11,0,34,23
1658025185172,MATH 197,001,091859,McAuley; Julian John,9999,0,9999,0
1658025185172,MATH 197,002,095566,Kedlaya; Kiran S.,9997,0,9999,2
1658025185172,MATH 197,003,095567,Xiao; Ming,9999,0,9999,0
1658025185172,MATH 197,004,095571,Perols; Johan Lars,9998,0,9999,1
1658025192235,COGS 9,A01,083615,Shannon; Kyle Michael,11,0,75,64
1658025198274,COGS 11,A01,083617,Boyle; Mary E. T.,23,0,48,25
1658025204298,COGS 13,A01,083071,Bastos; Amalia Pinkusfeld,12,0,71,59
1658025210325,COGS 14A,A01,092681,Semenuks; Arturs,5,1,100,95
1658025216358,COGS 14B,A01,083073,Cheng; Tzu-Han,7,0,63,56
1658025222380,COGS 17,A01,092677,Semenuks; Arturs,7,0,81,74
1658025228403,COGS 100,A01,083619,Allen; Michael Gordon,17,0,70,53
1658025234426,COGS 101A,A01,083621,Davis; Joshua Daniel,9,0,68,59
1658025240453,COGS 101B,A01,091572,Allen; Michael Gordon,14,0,65,51
1658025246475,COGS 101C,A01,083625,Delgado; Tania,17,0,35,18
1658025252498,COGS 107A,A01,083627,Boyle; Mary E. T.,14,0,60,46
1658025258525,COGS 118A,A01,083075,Gupta; Anjum,21,0,76,55
1658025264548,CSE 3,A50,083646,Miranda; Gregory Joseph,24,0,50,26
1658025270571,CSE 8A,A50,083650,Miranda; Gregory Joseph,17,1,56,39
1658025276593,CSE 11,A01,083080,Cao; Yingjun,7,15,40,33
1658025282623,CSE 12,A01,083652,Krause-Levy; Sophia Louisa,30,1,120,90
1658025288652,CSE 15L,A01,083654,Morris; Justin Loren,9,0,50,41
1658025288652,CSE 15L,A02,083655,Morris; Justin Loren,11,0,50,39
1658025294679,CSE 20,A01,083657,Tran; Khoa Dang,39,0,80,41
1658025300706,CSE 21,A01,095574,Bach; Quang Tran,23,0,48,25
1658025306728,CSE 30,A01,083084,Eldon; John,8,0,80,72
1658025306728,CSE 30,B01,095061,Bhaskar; Nishant,9,0,50,41
1658025312752,CSE 100,A01,083659,Cao; Yingjun,5,4,70,65
1658025318779,CSE 134B,A01,083661,Powell; Thomas Allan,25,0,100,75
1658025324802,CSE 140,A01,083663,Gungor; Onat,17,0,85,68
1658025330825,CSE 140L,A01,083088,Eldon; John,23,0,100,77
1658025336850,CSE 175,A01,083665,Kumar; Rakesh,3,0,25,22
1658025342872,CSE 190,A00,092507,Dubnov; Shlomo,8,0,20,12
1658025348911,ECE 45,A01,083139,Congero; Spencer William,7,0,75,68
1658025354935,ECE 65,A50,083695,Saad; Andrew S,12,0,30,18
1658025354935,ECE 65,A51,095125,Saad; Andrew S,24,0,26,2
1658025360961,ECE 109,A01,091882,Touri; Behrouz,21,0,70,49
1658025366984,ECE 180,A00,083140,Abi Samra; Nicholas Camill,1,0,30,29
1658025366984,ECE 180,B00,083141,Abi Samra; Nicholas Camill,0,0,30,30
1658025373013,MATH 10A,A01,083735,Patchell; Gregory David,2,0,30,28
1658025373013,MATH 10A,A02,083736,Patchell; Gregory David,20,0,30,10
1658025373013,MATH 10A,A03,083737,Patchell; Gregory David,16,0,30,14
1658025379036,MATH 10B,A01,083207,Lim; Seonhee,9,0,34,25
1658025379036,MATH 10B,A02,083208,Lim; Seonhee,10,0,35,25
1658025379036,MATH 10B,A03,093472,Lim; Seonhee,7,0,34,27
1658025379036,MATH 10B,B01,083739,Sinha; Shubham,14,0,30,16
1658025385066,MATH 18,A01,083743,Cinel; Cameron Alexander,9,0,30,21
1658025385066,MATH 18,A02,083744,Cinel; Cameron Alexander,18,0,30,12
1658025385066,MATH 18,A03,083745,Cinel; Cameron Alexander,10,0,30,20
1658025385066,MATH 18,B01,083748,Rideout; David Porter,5,0,37,32
1658025385066,MATH 18,B02,083749,Rideout; David Porter,5,0,36,31
1658025385066,MATH 18,B03,083750,Rideout; David Porter,3,0,37,34
1658025385066,MATH 18,B04,083751,Rideout; David Porter,7,0,36,29
1658025385066,MATH 18,B05,093473,Rideout; David Porter,7,0,36,29
1658025385066,MATH 18,B06,093474,Rideout; David Porter,6,0,36,30
1658025391088,MATH 20A,A01,083754,Zheng; Zequn,14,0,40,26
1658025397115,MATH 20B,A01,083756,Briones; Jor-el Thomas Caparas,4,0,36,32
1658025397115,MATH 20B,A02,083757,Briones; Jor-el Thomas Caparas,1,0,36,35
1658025397115,MATH 20B,A03,093475,Briones; Jor-el Thomas Caparas,3,0,36,33
1658025403144,MATH 20C,A01,083760,Briones; Jor-el Thomas Caparas,1,0,35,34
1658025403144,MATH 20C,A02,083761,Briones; Jor-el Thomas Caparas,8,0,35,27
1658025403144,MATH 20C,A03,093476,Briones; Jor-el Thomas Caparas,0,1,36,36
1658025403144,MATH 20C,B01,083762,Bach; Quang Tran,1,0,30,29
1658025409176,MATH 20D,A01,083765,Tran; Brian Kha,5,0,30,25
1658025409176,MATH 20D,A02,083766,Tran; Brian Kha,5,0,30,25
1658025409176,MATH 20D,A03,083767,Tran; Brian Kha,6,0,30,24
1658025415204,MATH 20E,A01,083771,Ganguly; Soumya,12,0,32,20
1658025415204,MATH 20E,A02,083772,Ganguly; Soumya,7,0,32,25
1658025415204,MATH 20E,B01,083773,Ciotti; Benjamin,20,0,35,15
1658025415204,MATH 20E,B02,083774,Ciotti; Benjamin,18,0,35,17
1658025421230,MATH 103A,A01,083777,Greenfeld; Be'Eri,6,0,36,30
1658025421230,MATH 103A,A02,083778,Greenfeld; Be'Eri,5,0,36,31
1658025421230,MATH 103A,A03,093561,Greenfeld; Be'Eri,7,0,36,29
1658025421230,MATH 103A,B01,083779,Greenfeld; Be'Eri,8,0,36,28
1658025421230,MATH 103A,B02,083780,Greenfeld; Be'Eri,4,0,36,32
1658025421230,MATH 103A,B03,093562,Greenfeld; Be'Eri,3,0,36,33
1658025427254,MATH 105,A01,085443,Carter; Anne Toulson,15,0,35,20
1658025427254,MATH 105,A02,093477,Carter; Anne Toulson,20,0,35,15
1658025433292,MATH 109,A01,083213,Ganzberger; Geoffrey Michael,3,0,34,31
1658025433292,MATH 109,A02,083214,Ganzberger; Geoffrey Michael,4,0,34,30
1658025433292,MATH 109,A03,093478,Ganzberger; Geoffrey Michael,2,0,34,32
1658025433292,MATH 109,B01,083215,Ganzberger; Geoffrey Michael,3,0,32,29
1658025433292,MATH 109,B02,083216,Ganzberger; Geoffrey Michael,3,0,32,29
1658025433292,MATH 109,B03,093479,Ganzberger; Geoffrey Michael,8,0,32,24
1658025439323,MATH 142A,A01,083219,Chow; Bennett,7,0,32,25
1658025439323,MATH 142A,A02,083220,Chow; Bennett,10,0,32,22
1658025439323,MATH 142A,A03,093480,Chow; Bennett,9,0,32,23
1658025439323,MATH 142A,B03,093481,Chow; Bennett,8,0,32,24
1658025439323,MATH 142A,B04,093558,Chow; Bennett,14,0,32,18
1658025439323,MATH 142A,B05,093559,Chow; Bennett,7,0,32,25
1658025445351,MATH 193A,A01,083224,Rotar; Vladimir,9,0,34,25
1658025445351,MATH 193A,A02,083225,Rotar; Vladimir,11,0,34,23
1658025445351,MATH 193A,A03,083781,Rotar; Vladimir,5,0,34,29
1658025445351,MATH 193A,A04,083782,Rotar; Vladimir,12,0,34,22
1658025445351,MATH 193A,A05,093482,Rotar; Vladimir,11,0,34,23
1658025451389,MATH 197,001,091859,McAuley; Julian John,9999,0,9999,0
1658025451389,MATH 197,002,095566,Kedlaya; Kiran S.,9997,0,9999,2
1658025451389,MATH 197,003,095567,Xiao; Ming,9999,0,9999,0
1658025451389,MATH 197,004,095571,Perols; Johan Lars,9998,0,9999,1
1658025458444,COGS 9,A01,083615,Shannon; Kyle Michael,11,0,75,64
1658025464474,COGS 11,A01,083617,Boyle; Mary E. T.,23,0,48,25
1658025470498,COGS 13,A01,083071,Bastos; Amalia Pinkusfeld,12,0,71,59
1658025476521,COGS 14A,A01,092681,Semenuks; Arturs,5,1,100,95
1658025482549,COGS 14B,A01,083073,Cheng; Tzu-Han,7,0,63,56
1658025488572,COGS 17,A01,092677,Semenuks; Arturs,7,0,81,74
1658025494594,COGS 100,A01,083619,Allen; Michael Gordon,17,0,70,53
1658025500618,COGS 101A,A01,083621,Davis; Joshua Daniel,9,0,68,59
1658025506644,COGS 101B,A01,091572,Allen; Michael Gordon,14,0,65,51
1658025512667,COGS 101C,A01,083625,Delgado; Tania,17,0,35,18
1658025518692,COGS 107A,A01,083627,Boyle; Mary E. T.,14,0,60,46
1658025524721,COGS 118A,A01,083075,Gupta; Anjum,21,0,76,55
1658025530744,CSE 3,A50,083646,Miranda; Gregory Joseph,24,0,50,26
1658025536769,CSE 8A,A50,083650,Miranda; Gregory Joseph,17,1,56,39
1658025542794,CSE 11,A01,083080,Cao; Yingjun,7,15,40,33
1658025548817,CSE 12,A01,083652,Krause-Levy; Sophia Louisa,30,1,120,90
1658025554840,CSE 15L,A01,083654,Morris; Justin Loren,9,0,50,41
1658025554840,CSE 15L,A02,083655,Morris; Justin Loren,11,0,50,39
1658025560877,CSE 20,A01,083657,Tran; Khoa Dang,39,0,80,41
1658025566981,CSE 21,A01,095574,Bach; Quang Tran,23,0,48,25
1658025573010,CSE 30,A01,083084,Eldon; John,8,0,80,72
1658025573010,CSE 30,B01,095061,Bhaskar; Nishant,9,0,50,41
1658025579031,CSE 100,A01,083659,Cao; Yingjun,5,4,70,65
1658025585054,CSE 134B,A01,083661,Powell; Thomas Allan,25,0,100,75
1658025591076,CSE 140,A01,083663,Gungor; Onat,17,0,85,68
1658025597102,CSE 140L,A01,083088,Eldon; John,23,0,100,77
1658025603129,CSE 175,A01,083665,Kumar; Rakesh,3,0,25,22
1658025609155,CSE 190,A00,092507,Dubnov; Shlomo,8,0,20,12
1658025615185,ECE 45,A01,083139,Congero; Spencer William,7,0,75,68
1658025621213,ECE 65,A50,083695,Saad; Andrew S,12,0,30,18
1658025621213,ECE 65,A51,095125,Saad; Andrew S,24,0,26,2
1658025627237,ECE 109,A01,091882,Touri; Behrouz,21,0,70,49
1658025633265,ECE 180,A00,083140,Abi Samra; Nicholas Camill,1,0,30,29
1658025633265,ECE 180,B00,083141,Abi Samra; Nicholas Camill,0,0,30,30
1658025639289,MATH 10A,A01,083735,Patchell; Gregory David,2,0,30,28
1658025639289,MATH 10A,A02,083736,Patchell; Gregory David,20,0,30,10
1658025639289,MATH 10A,A03,083737,Patchell; Gregory David,16,0,30,14
1658025645312,MATH 10B,A01,083207,Lim; Seonhee,9,0,34,25
1658025645312,MATH 10B,A02,083208,Lim; Seonhee,10,0,35,25
1658025645312,MATH 10B,A03,093472,Lim; Seonhee,7,0,34,27
1658025645312,MATH 10B,B01,083739,Sinha; Shubham,14,0,30,16
1658025651337,MATH 18,A01,083743,Cinel; Cameron Alexander,9,0,30,21
1658025651337,MATH 18,A02,083744,Cinel; Cameron Alexander,18,0,30,12
1658025651337,MATH 18,A03,083745,Cinel; Cameron Alexander,10,0,30,20
1658025651337,MATH 18,B01,083748,Rideout; David Porter,5,0,37,32
1658025651337,MATH 18,B02,083749,Rideout; David Porter,5,0,36,31
1658025651337,MATH 18,B03,083750,Rideout; David Porter,3,0,37,34
1658025651337,MATH 18,B04,083751,Rideout; David Porter,7,0,36,29
1658025651337,MATH 18,B05,093473,Rideout; David Porter,7,0,36,29
1658025651337,MATH 18,B06,093474,Rideout; David Porter,6,0,36,30
1658025657362,MATH 20A,A01,083754,Zheng; Zequn,14,0,40,26
1658025663389,MATH 20B,A01,083756,Briones; Jor-el Thomas Caparas,4,0,36,32
1658025663389,MATH 20B,A02,083757,Briones; Jor-el Thomas Caparas,1,0,36,35
1658025663389,MATH 20B,A03,093475,Briones; Jor-el Thomas Caparas,3,0,36,33
1658025669413,MATH 20C,A01,083760,Briones; Jor-el Thomas Caparas,1,0,35,34
1658025669413,MATH 20C,A02,083761,Briones; Jor-el Thomas Caparas,8,0,35,27
1658025669413,MATH 20C,A03,093476,Briones; Jor-el Thomas Caparas,0,1,36,36
1658025669413,MATH 20C,B01,083762,Bach; Quang Tran,1,0,30,29
1658025675436,MATH 20D,A01,083765,Tran; Brian Kha,5,0,30,25
1658025675436,MATH 20D,A02,083766,Tran; Brian Kha,5,0,30,25
1658025675436,MATH 20D,A03,083767,Tran; Brian Kha,6,0,30,24
1658025681464,MATH 20E,A01,083771,Ganguly; Soumya,12,0,32,20
1658025681464,MATH 20E,A02,083772,Ganguly; Soumya,7,0,32,25
1658025681464,MATH 20E,B01,083773,Ciotti; Benjamin,20,0,35,15
1658025681464,MATH 20E,B02,083774,Ciotti; Benjamin,18,0,35,17
1658025687488,MATH 103A,A01,083777,Greenfeld; Be'Eri,6,0,36,30
1658025687488,MATH 103A,A02,083778,Greenfeld; Be'Eri,5,0,36,31
1658025687488,MATH 103A,A03,093561,Greenfeld; Be'Eri,7,0,36,29
1658025687488,MATH 103A,B01,083779,Greenfeld; Be'Eri,8,0,36,28
1658025687488,MATH 103A,B02,083780,Greenfeld; Be'Eri,4,0,36,32
1658025687488,MATH 103A,B03,093562,Greenfeld; Be'Eri,3,0,36,33
1658025693515,MATH 105,A01,085443,Carter; Anne Toulson,15,0,35,20
1658025693515,MATH 105,A02,093477,Carter; Anne Toulson,20,0,35,15
1658025699544,MATH 109,A01,083213,Ganzberger; Geoffrey Michael,3,0,34,31
1658025699544,MATH 109,A02,083214,Ganzberger; Geoffrey Michael,4,0,34,30
1658025699544,MATH 109,A03,093478,Ganzberger; Geoffrey Michael,2,0,34,32
1658025699544,MATH 109,B01,083215,Ganzberger; Geoffrey Michael,3,0,32,29
1658025699544,MATH 109,B02,083216,Ganzberger; Geoffrey Michael,3,0,32,29
1658025699544,MATH 109,B03,093479,Ganzberger; Geoffrey Michael,8,0,32,24
1658025705580,MATH 142A,A01,083219,Chow; Bennett,7,0,32,25
1658025705580,MATH 142A,A02,083220,Chow; Bennett,10,0,32,22
1658025705580,MATH 142A,A03,093480,Chow; Bennett,9,0,32,23
1658025705580,MATH 142A,B03,093481,Chow; Bennett,8,0,32,24
1658025705580,MATH 142A,B04,093558,Chow; Bennett,14,0,32,18
1658025705580,MATH 142A,B05,093559,Chow; Bennett,7,0,32,25
1658025711612,MATH 193A,A01,083224,Rotar; Vladimir,9,0,34,25
1658025711612,MATH 193A,A02,083225,Rotar; Vladimir,11,0,34,23
1658025711612,MATH 193A,A03,083781,Rotar; Vladimir,5,0,34,29
1658025711612,MATH 193A,A04,083782,Rotar; Vladimir,12,0,34,22
1658025711612,MATH 193A,A05,093482,Rotar; Vladimir,11,0,34,23
1658025717634,MATH 197,001,091859,McAuley; Julian John,9999,0,9999,0
1658025717634,MATH 197,002,095566,Kedlaya; Kiran S.,9997,0,9999,2
1658025717634,MATH 197,003,095567,Xiao; Ming,9999,0,9999,0
1658025717634,MATH 197,004,095571,Perols; Johan Lars,9998,0,9999,1
1658025724698,COGS 9,A01,083615,Shannon; Kyle Michael,11,0,75,64
1658025730719,COGS 11,A01,083617,Boyle; Mary E. T.,23,0,48,25
1658025736741,COGS 13,A01,083071,Bastos; Amalia Pinkusfeld,12,0,71,59
1658025742767,COGS 14A,A01,092681,Semenuks; Arturs,5,1,100,95
1658025748794,COGS 14B,A01,083073,Cheng; Tzu-Han,7,0,63,56
1658025754820,COGS 17,A01,092677,Semenuks; Arturs,7,0,81,74
1658025760842,COGS 100,A01,083619,Allen; Michael Gordon,17,0,70,53
1658025766865,COGS 101A,A01,083621,Davis; Joshua Daniel,9,0,68,59
1658025772891,COGS 101B,A01,091572,Allen; Michael Gordon,14,0,65,51
1658025778914,COGS 101C,A01,083625,Delgado; Tania,17,0,35,18
1658025784937,COGS 107A,A01,083627,Boyle; Mary E. T.,14,0,60,46
1658025790966,COGS 118A,A01,083075,Gupta; Anjum,21,0,76,55
1658025796990,CSE 3,A50,083646,Miranda; Gregory Joseph,24,0,50,26
1658025803018,CSE 8A,A50,083650,Miranda; Gregory Joseph,17,1,56,39
1658025809057,CSE 11,A01,083080,Cao; Yingjun,7,15,40,33
1658025815083,CSE 12,A01,083652,Krause-Levy; Sophia Louisa,30,1,120,90
1658025821109,CSE 15L,A01,083654,Morris; Justin Loren,9,0,50,41
1658025821109,CSE 15L,A02,083655,Morris; Justin Loren,11,0,50,39
1658025827149,CSE 20,A01,083657,Tran; Khoa Dang,39,0,80,41
1658025833173,CSE 21,A01,095574,Bach; Quang Tran,23,0,48,25
1658025839196,CSE 30,A01,083084,Eldon; John,8,0,80,72
1658025839196,CSE 30,B01,095061,Bhaskar; Nishant,9,0,50,41
1658025845223,CSE 100,A01,083659,Cao; Yingjun,5,4,70,65
1658025851250,CSE 134B,A01,083661,Powell; Thomas Allan,25,0,100,75
1658025857271,CSE 140,A01,083663,Gungor; Onat,17,0,85,68
1658025863300,CSE 140L,A01,083088,Eldon; John,23,0,100,77
1658025869325,CSE 175,A01,083665,Kumar; Rakesh,3,0,25,22
1658025875352,CSE 190,A00,092507,Dubnov; Shlomo,8,0,20,12
1658025881379,ECE 45,A01,083139,Congero; Spencer William,7,0,75,68
1658025887405,ECE 65,A50,083695,Saad; Andrew S,12,0,30,18
1658025887405,ECE 65,A51,095125,Saad; Andrew S,24,0,26,2
1658025893428,ECE 109,A01,091882,Touri; Behrouz,21,0,70,49
1658025899452,ECE 180,A00,083140,Abi Samra; Nicholas Camill,1,0,30,29
1658025899452,ECE 180,B00,083141,Abi Samra; Nicholas Camill,0,0,30,30
1658025905476,MATH 10A,A01,083735,Patchell; Gregory David,2,0,30,28
1658025905476,MATH 10A,A02,083736,Patchell; Gregory David,20,0,30,10
1658025905476,MATH 10A,A03,083737,Patchell; Gregory David,16,0,30,14
1658025911506,MATH 10B,A01,083207,Lim; Seonhee,9,0,34,25
1658025911506,MATH 10B,A02,083208,Lim; Seonhee,10,0,35,25
1658025911506,MATH 10B,A03,093472,Lim; Seonhee,7,0,34,27
1658025911506,MATH 10B,B01,083739,Sinha; Shubham,14,0,30,16
1658025917529,MATH 18,A01,083743,Cinel; Cameron Alexander,9,0,30,21
1658025917529,MATH 18,A02,083744,Cinel; Cameron Alexander,18,0,30,12
1658025917529,MATH 18,A03,083745,Cinel; Cameron Alexander,10,0,30,20
1658025917529,MATH 18,B01,083748,Rideout; David Porter,5,0,37,32
1658025917529,MATH 18,B02,083749,Rideout; David Porter,5,0,36,31
1658025917529,MATH 18,B03,083750,Rideout; David Porter,3,0,37,34
1658025917529,MATH 18,B04,083751,Rideout; David Porter,7,0,36,29
1658025917529,MATH 18,B05,093473,Rideout; David Porter,7,0,36,29
1658025917529,MATH 18,B06,093474,Rideout; David Porter,6,0,36,30
1658025923554,MATH 20A,A01,083754,Zheng; Zequn,14,0,40,26
1658025929584,MATH 20B,A01,083756,Briones; Jor-el Thomas Caparas,4,0,36,32
1658025929584,MATH 20B,A02,083757,Briones; Jor-el Thomas Caparas,1,0,36,35
1658025929584,MATH 20B,A03,093475,Briones; Jor-el Thomas Caparas,3,0,36,33
1658025935622,MATH 20C,A01,083760,Briones; Jor-el Thomas Caparas,1,0,35,34
1658025935622,MATH 20C,A02,083761,Briones; Jor-el Thomas Caparas,8,0,35,27
1658025935622,MATH 20C,A03,093476,Briones; Jor-el Thomas Caparas,0,1,36,36
1658025935622,MATH 20C,B01,083762,Bach; Quang Tran,1,0,30,29
1658025941651,MATH 20D,A01,083765,Tran; Brian Kha,5,0,30,25
1658025941651,MATH 20D,A02,083766,Tran; Brian Kha,5,0,30,25
1658025941651,MATH 20D,A03,083767,Tran; Brian Kha,6,0,30,24
1658025947679,MATH 20E,A01,083771,Ganguly; Soumya,12,0,32,20
1658025947679,MATH 20E,A02,083772,Ganguly; Soumya,7,0,32,25
1658025947679,MATH 20E,B01,083773,Ciotti; Benjamin,20,0,35,15
1658025947679,MATH 20E,B02,083774,Ciotti; Benjamin,18,0,35,17
1658025953708,MATH 103A,A01,083777,Greenfeld; Be'Eri,6,0,36,30
1658025953708,MATH 103A,A02,083778,Greenfeld; Be'Eri,5,0,36,31
1658025953708,MATH 103A,A03,093561,Greenfeld; Be'Eri,7,0,36,29
1658025953708,MATH 103A,B01,083779,Greenfeld; Be'Eri,8,0,36,28
1658025953708,MATH 103A,B02,083780,Greenfeld; Be'Eri,4,0,36,32
1658025953708,MATH 103A,B03,093562,Greenfeld; Be'Eri,3,0,36,33
1658025959731,MATH 105,A01,085443,Carter; Anne Toulson,15,0,35,20
1658025959731,MATH 105,A02,093477,Carter; Anne Toulson,20,0,35,15
1658025965755,MATH 109,A01,083213,Ganzberger; Geoffrey Michael,3,0,34,31
1658025965755,MATH 109,A02,083214,Ganzberger; Geoffrey Michael,4,0,34,30
1658025965755,MATH 109,A03,093478,Ganzberger; Geoffrey Michael,2,0,34,32
1658025965755,MATH 109,B01,083215,Ganzberger; Geoffrey Michael,3,0,32,29
1658025965755,MATH 109,B02,083216,Ganzberger; Geoffrey Michael,3,0,32,29
1658025965755,MATH 109,B03,093479,Ganzberger; Geoffrey Michael,8,0,32,24
1658025971778,MATH 142A,A01,083219,Chow; Bennett,7,0,32,25
1658025971778,MATH 142A,A02,083220,Chow; Bennett,10,0,32,22
1658025971778,MATH 142A,A03,093480,Chow; Bennett,9,0,32,23
1658025971778,MATH 142A,B03,093481,Chow; Bennett,8,0,32,24
1658025971778,MATH 142A,B04,093558,Chow; Bennett,14,0,32,18
1658025971778,MATH 142A,B05,093559,Chow; Bennett,7,0,32,25
1658025977811,MATH 193A,A01,083224,Rotar; Vladimir,9,0,34,25
1658025977811,MATH 193A,A02,083225,Rotar; Vladimir,11,0,34,23
1658025977811,MATH 193A,A03,083781,Rotar; Vladimir,5,0,34,29
1658025977811,MATH 193A,A04,083782,Rotar; Vladimir,12,0,34,22
1658025977811,MATH 193A,A05,093482,Rotar; Vladimir,11,0,34,23
1658025983834,MATH 197,001,091859,McAuley; Julian John,9999,0,9999,0
1658025983834,MATH 197,002,095566,Kedlaya; Kiran S.,9997,0,9999,2
1658025983834,MATH 197,003,095567,Xiao; Ming,9999,0,9999,0
1658025983834,MATH 197,004,095571,Perols; Johan Lars,9998,0,9999,1
1658025990884,COGS 9,A01,083615,Shannon; Kyle Michael,11,0,75,64
1658025996910,COGS 11,A01,083617,Boyle; Mary E. T.,23,0,48,25
1658026002934,COGS 13,A01,083071,Bastos; Amalia Pinkusfeld,12,0,71,59
1658026008959,COGS 14A,A01,092681,Semenuks; Arturs,5,1,100,95
1658026014982,COGS 14B,A01,083073,Cheng; Tzu-Han,7,0,63,56
1658026021010,COGS 17,A01,092677,Semenuks; Arturs,7,0,81,74
1658026027037,COGS 100,A01,083619,Allen; Michael Gordon,17,0,70,53
1658026033063,COGS 101A,A01,083621,Davis; Joshua Daniel,9,0,68,59
1658026039089,COGS 101B,A01,091572,Allen; Michael Gordon,14,0,65,51
1658026045112,COGS 101C,A01,083625,Delgado; Tania,17,0,35,18
1658026051139,COGS 107A,A01,083627,Boyle; Mary E. T.,14,0,60,46
1658026057167,COGS 118A,A01,083075,Gupta; Anjum,21,0,76,55
1658026063191,CSE 3,A50,083646,Miranda; Gregory Joseph,24,0,50,26
1658026069215,CSE 8A,A50,083650,Miranda; Gregory Joseph,17,1,56,39
1658026075242,CSE 11,A01,083080,Cao; Yingjun,7,15,40,33
1658026081268,CSE 12,A01,083652,Krause-Levy; Sophia Louisa,30,1,120,90
1658026087291,CSE 15L,A01,083654,Morris; Justin Loren,9,0,50,41
1658026087291,CSE 15L,A02,083655,Morris; Justin Loren,11,0,50,39
1658026093314,CSE 20,A01,083657,Tran; Khoa Dang,39,0,80,41
1658026099338,CSE 21,A01,095574,Bach; Quang Tran,23,0,48,25
1658026105364,CSE 30,A01,083084,Eldon; John,8,0,80,72
1658026105364,CSE 30,B01,095061,Bhaskar; Nishant,9,0,50,41
1658026111390,CSE 100,A01,083659,Cao; Yingjun,5,4,70,65
1658026117421,CSE 134B,A01,083661,Powell; Thomas Allan,25,0,100,75
1658026123448,CSE 140,A01,083663,Gungor; Onat,17,0,85,68
1658026129473,CSE 140L,A01,083088,Eldon; John,23,0,100,77
1658026135508,CSE 175,A01,083665,Kumar; Rakesh,3,0,25,22
1658026141535,CSE 190,A00,092507,Dubnov; Shlomo,8,0,20,12
1658026147561,ECE 45,A01,083139,Congero; Spencer William,7,0,75,68
1658026153593,ECE 65,A50,083695,Saad; Andrew S,12,0,30,18
1658026153593,ECE 65,A51,095125,Saad; Andrew S,24,0,26,2
1658026159616,ECE 109,A01,091882,Touri; Behrouz,21,0,70,49
1658026165736,ECE 180,A00,083140,Abi Samra; Nicholas Camill,1,0,30,29
1658026165736,ECE 180,B00,083141,Abi Samra; Nicholas Camill,0,0,30,30
1658026171759,MATH 10A,A01,083735,Patchell; Gregory David,2,0,30,28
1658026171759,MATH 10A,A02,083736,Patchell; Gregory David,20,0,30,10
1658026171759,MATH 10A,A03,083737,Patchell; Gregory David,16,0,30,14
1658026177785,MATH 10B,A01,083207,Lim; Seonhee,9,0,34,25
1658026177785,MATH 10B,A02,083208,Lim; Seonhee,10,0,35,25
1658026177785,MATH 10B,A03,093472,Lim; Seonhee,7,0,34,27
1658026177785,MATH 10B,B01,083739,Sinha; Shubham,14,0,30,16
1658026183807,MATH 18,A01,083743,Cinel; Cameron Alexander,9,0,30,21
1658026183807,MATH 18,A02,083744,Cinel; Cameron Alexander,18,0,30,12
1658026183807,MATH 18,A03,083745,Cinel; Cameron Alexander,10,0,30,20
1658026183807,MATH 18,B01,083748,Rideout; David Porter,5,0,37,32
1658026183807,MATH 18,B02,083749,Rideout; David Porter,5,0,36,31
1658026183807,MATH 18,B03,083750,Rideout; David Porter,3,0,37,34
1658026183807,MATH 18,B04,083751,Rideout; David Porter,7,0,36,29
1658026183807,MATH 18,B05,093473,Rideout; David Porter,7,0,36,29
1658026183807,MATH 18,B06,093474,Rideout; David Porter,6,0,36,30
1658026189831,MATH 20A,A01,083754,Zheng; Zequn,14,0,40,26
1658026195857,MATH 20B,A01,083756,Briones; Jor-el Thomas Caparas,4,0,36,32
1658026195857,MATH 20B,A02,083757,Briones; Jor-el Thomas Caparas,1,0,36,35
1658026195857,MATH 20B,A03,093475,Briones; Jor-el Thomas Caparas,3,0,36,33
1658026201879,MATH 20C,A01,083760,Briones; Jor-el Thomas Caparas,1,0,35,34
1658026201879,MATH 20C,A02,083761,Briones; Jor-el Thomas Caparas,8,0,35,27
1658026201879,MATH 20C,A03,093476,Briones; Jor-el Thomas Caparas,0,1,36,36
1658026201879,MATH 20C,B01,083762,Bach; Quang Tran,1,0,30,29
1658026207901,MATH 20D,A01,083765,Tran; Brian Kha,5,0,30,25
1658026207901,MATH 20D,A02,083766,Tran; Brian Kha,5,0,30,25
1658026207901,MATH 20D,A03,083767,Tran; Brian Kha,6,0,30,24
1658026213929,MATH 20E,A01,083771,Ganguly; Soumya,12,0,32,20
1658026213929,MATH 20E,A02,083772,Ganguly; Soumya,7,0,32,25
1658026213929,MATH 20E,B01,083773,Ciotti; Benjamin,20,0,35,15
1658026213929,MATH 20E,B02,083774,Ciotti; Benjamin,18,0,35,17
1658026219953,MATH 103A,A01,083777,Greenfeld; Be'Eri,6,0,36,30
1658026219953,MATH 103A,A02,083778,Greenfeld; Be'Eri,5,0,36,31
1658026219953,MATH 103A,A03,093561,Greenfeld; Be'Eri,7,0,36,29
1658026219953,MATH 103A,B01,083779,Greenfeld; Be'Eri,8,0,36,28
1658026219953,MATH 103A,B02,083780,Greenfeld; Be'Eri,4,0,36,32
1658026219953,MATH 103A,B03,093562,Greenfeld; Be'Eri,3,0,36,33
1658026225988,MATH 105,A01,085443,Carter; Anne Toulson,15,0,35,20
1658026225988,MATH 105,A02,093477,Carter; Anne Toulson,20,0,35,15
1658026232018,MATH 109,A01,083213,Ganzberger; Geoffrey Michael,3,0,34,31
1658026232018,MATH 109,A02,083214,Ganzberger; Geoffrey Michael,4,0,34,30
1658026232018,MATH 109,A03,093478,Ganzberger; Geoffrey Michael,2,0,34,32
1658026232018,MATH 109,B01,083215,Ganzberger; Geoffrey Michael,3,0,32,29
1658026232018,MATH 109,B02,083216,Ganzberger; Geoffrey Michael,3,0,32,29
1658026232018,MATH 109,B03,093479,Ganzberger; Geoffrey Michael,8,0,32,24
1658026238047,MATH 142A,A01,083219,Chow; Bennett,7,0,32,25
1658026238047,MATH 142A,A02,083220,Chow; Bennett,10,0,32,22
1658026238047,MATH 142A,A03,093480,Chow; Bennett,9,0,32,23
1658026238047,MATH 142A,B03,093481,Chow; Bennett,8,0,32,24
1658026238047,MATH 142A,B04,093558,Chow; Bennett,14,0,32,18
1658026238047,MATH 142A,B05,093559,Chow; Bennett,7,0,32,25
1658026244079,MATH 193A,A01,083224,Rotar; Vladimir,9,0,34,25
1658026244079,MATH 193A,A02,083225,Rotar; Vladimir,11,0,34,23
1658026244079,MATH 193A,A03,083781,Rotar; Vladimir,5,0,34,29
1658026244079,MATH 193A,A04,083782,Rotar; Vladimir,12,0,34,22
1658026244079,MATH 193A,A05,093482,Rotar; Vladimir,11,0,34,23
1658026250104,MATH 197,001,091859,McAuley; Julian John,9999,0,9999,0
1658026250104,MATH 197,002,095566,Kedlaya; Kiran S.,9997,0,9999,2
1658026250104,MATH 197,003,095567,Xiao; Ming,9999,0,9999,0
1658026250104,MATH 197,004,095571,Perols; Johan Lars,9998,0,9999,1
1658026257163,COGS 9,A01,083615,Shannon; Kyle Michael,11,0,75,64
1658026263187,COGS 11,A01,083617,Boyle; Mary E. T.,23,0,48,25
1658026269213,COGS 13,A01,083071,Bastos; Amalia Pinkusfeld,12,0,71,59
1658026275236,COGS 14A,A01,092681,Semenuks; Arturs,5,1,100,95
1658026281260,COGS 14B,A01,083073,Cheng; Tzu-Han,7,0,63,56
1658026287286,COGS 17,A01,092677,Semenuks; Arturs,7,0,81,74
1658026293312,COGS 100,A01,083619,Allen; Michael Gordon,17,0,70,53
1658026299335,COGS 101A,A01,083621,Davis; Joshua Daniel,9,0,68,59
1658026305356,COGS 101B,A01,091572,Allen; Michael Gordon,14,0,65,51
1658026311379,COGS 101C,A01,083625,Delgado; Tania,17,0,35,18
1658026317402,COGS 107A,A01,083627,Boyle; Mary E. T.,14,0,60,46
1658026323428,COGS 118A,A01,083075,Gupta; Anjum,21,0,76,55
1658026329453,CSE 3,A50,083646,Miranda; Gregory Joseph,24,0,50,26
1658026335480,CSE 8A,A50,083650,Miranda; Gregory Joseph,17,1,56,39
1658026341503,CSE 11,A01,083080,Cao; Yingjun,7,15,40,33
1658026347531,CSE 12,A01,083652,Krause-Levy; Sophia Louisa,30,1,120,90
1658026353562,CSE 15L,A01,083654,Morris; Justin Loren,9,0,50,41
1658026353562,CSE 15L,A02,083655,Morris; Justin Loren,11,0,50,39
1658026359586,CSE 20,A01,083657,Tran; Khoa Dang,39,0,80,41
1658026365609,CSE 21,A01,095574,Bach; Quang Tran,23,0,48,25
1658026371642,CSE 30,A01,083084,Eldon; John,8,0,80,72
1658026371642,CSE 30,B01,095061,Bhaskar; Nishant,9,0,50,41
1658026377669,CSE 100,A01,083659,Cao; Yingjun,5,4,70,65
1658026383696,CSE 134B,A01,083661,Powell; Thomas Allan,25,0,100,75
1658026389720,CSE 140,A01,083663,Gungor; Onat,17,0,85,68
1658026395747,CSE 140L,A01,083088,Eldon; John,23,0,100,77
1658026401770,CSE 175,A01,083665,Kumar; Rakesh,3,0,25,22
1658026407792,CSE 190,A00,092507,Dubnov; Shlomo,8,0,20,12
1658026413820,ECE 45,A01,083139,Congero; Spencer William,7,0,75,68
1658026419844,ECE 65,A50,083695,Saad; Andrew S,12,0,30,18
1658026419844,ECE 65,A51,095125,Saad; Andrew S,24,0,26,2
1658026425866,ECE 109,A01,091882,Touri; Behrouz,21,0,70,49
1658026431889,ECE 180,A00,083140,Abi Samra; Nicholas Camill,1,0,30,29
1658026431889,ECE 180,B00,083141,Abi Samra; Nicholas Camill,0,0,30,30
1658026437913,MATH 10A,A01,083735,Patchell; Gregory David,2,0,30,28
1658026437913,MATH 10A,A02,083736,Patchell; Gregory David,20,0,30,10
1658026437913,MATH 10A,A03,083737,Patchell; Gregory David,16,0,30,14
1658026443938,MATH 10B,A01,083207,Lim; Seonhee,9,0,34,25
1658026443938,MATH 10B,A02,083208,Lim; Seonhee,10,0,35,25
1658026443938,MATH 10B,A03,093472,Lim; Seonhee,7,0,34,27
1658026443938,MATH 10B,B01,083739,Sinha; Shubham,14,0,30,16
1658026449968,MATH 18,A01,083743,Cinel; Cameron Alexander,9,0,30,21
1658026449968,MATH 18,A02,083744,Cinel; Cameron Alexander,18,0,30,12
1658026449968,MATH 18,A03,083745,Cinel; Cameron Alexander,10,0,30,20
1658026449968,MATH 18,B01,083748,Rideout; David Porter,5,0,37,32
1658026449968,MATH 18,B02,083749,Rideout; David Porter,5,0,36,31
1658026449968,MATH 18,B03,083750,Rideout; David Porter,3,0,37,34
1658026449968,MATH 18,B04,083751,Rideout; David Porter,7,0,36,29
1658026449968,MATH 18,B05,093473,Rideout; David Porter,7,0,36,29
1658026449968,MATH 18,B06,093474,Rideout; David Porter,6,0,36,30
1658026455990,MATH 20A,A01,083754,Zheng; Zequn,14,0,40,26
1658026462013,MATH 20B,A01,083756,Briones; Jor-el Thomas Caparas,4,0,36,32
1658026462013,MATH 20B,A02,083757,Briones; Jor-el Thomas Caparas,1,0,36,35
1658026462013,MATH 20B,A03,093475,Briones; Jor-el Thomas Caparas,3,0,36,33
1658026468039,MATH 20C,A01,083760,Briones; Jor-el Thomas Caparas,1,0,35,34
1658026468039,MATH 20C,A02,083761,Briones; Jor-el Thomas Caparas,8,0,35,27
1658026468039,MATH 20C,A03,093476,Briones; Jor-el Thomas Caparas,0,1,36,36
1658026468039,MATH 20C,B01,083762,Bach; Quang Tran,1,0,30,29
1658026474065,MATH 20D,A01,083765,Tran; Brian Kha,5,0,30,25
1658026474065,MATH 20D,A02,083766,Tran; Brian Kha,5,0,30,25
1658026474065,MATH 20D,A03,083767,Tran; Brian Kha,6,0,30,24
1658026480091,MATH 20E,A01,083771,Ganguly; Soumya,12,0,32,20
1658026480091,MATH 20E,A02,083772,Ganguly; Soumya,7,0,32,25
1658026480091,MATH 20E,B01,083773,Ciotti; Benjamin,20,0,35,15
1658026480091,MATH 20E,B02,083774,Ciotti; Benjamin,18,0,35,17
1658026486114,MATH 103A,A01,083777,Greenfeld; Be'Eri,6,0,36,30
1658026486114,MATH 103A,A02,083778,Greenfeld; Be'Eri,5,0,36,31
1658026486114,MATH 103A,A03,093561,Greenfeld; Be'Eri,7,0,36,29
1658026486114,MATH 103A,B01,083779,Greenfeld; Be'Eri,8,0,36,28
1658026486114,MATH 103A,B02,083780,Greenfeld; Be'Eri,4,0,36,32
1658026486114,MATH 103A,B03,093562,Greenfeld; Be'Eri,3,0,36,33
1658026492140,MATH 105,A01,085443,Carter; Anne Toulson,15,0,35,20
1658026492140,MATH 105,A02,093477,Carter; Anne Toulson,20,0,35,15
1658026498164,MATH 109,A01,083213,Ganzberger; Geoffrey Michael,3,0,34,31
1658026498164,MATH 109,A02,083214,Ganzberger; Geoffrey Michael,4,0,34,30
1658026498164,MATH 109,A03,093478,Ganzberger; Geoffrey Michael,2,0,34,32
1658026498164,MATH 109,B01,083215,Ganzberger; Geoffrey Michael,3,0,32,29
1658026498164,MATH 109,B02,083216,Ganzberger; Geoffrey Michael,3,0,32,29
1658026498164,MATH 109,B03,093479,Ganzberger; Geoffrey Michael,8,0,32,24
1658026504187,MATH 142A,A01,083219,Chow; Bennett,7,0,32,25
1658026504187,MATH 142A,A02,083220,Chow; Bennett,10,0,32,22
1658026504187,MATH 142A,A03,093480,Chow; Bennett,9,0,32,23
1658026504187,MATH 142A,B03,093481,Chow; Bennett,8,0,32,24
1658026504187,MATH 142A,B04,093558,Chow; Bennett,14,0,32,18
1658026504187,MATH 142A,B05,093559,Chow; Bennett,7,0,32,25
1658026510210,MATH 193A,A01,083224,Rotar; Vladimir,9,0,34,25
1658026510210,MATH 193A,A02,083225,Rotar; Vladimir,11,0,34,23
1658026510210,MATH 193A,A03,083781,Rotar; Vladimir,5,0,34,29
1658026510210,MATH 193A,A04,083782,Rotar; Vladimir,12,0,34,22
1658026510210,MATH 193A,A05,093482,Rotar; Vladimir,11,0,34,23
1658026516234,MATH 197,001,091859,McAuley; Julian John,9999,0,9999,0
1658026516234,MATH 197,002,095566,Kedlaya; Kiran S.,9997,0,9999,2
1658026516234,MATH 197,003,095567,Xiao; Ming,9999,0,9999,0
1658026516234,MATH 197,004,095571,Perols; Johan Lars,9998,0,9999,1
1658026523301,COGS 9,A01,083615,Shannon; Kyle Michael,11,0,75,64
1658026529326,COGS 11,A01,083617,Boyle; Mary E. T.,23,0,48,25
1658026535354,COGS 13,A01,083071,Bastos; Amalia Pinkusfeld,12,0,71,59
1658026541378,COGS 14A,A01,092681,Semenuks; Arturs,5,1,100,95
1658026547399,COGS 14B,A01,083073,Cheng; Tzu-Han,7,0,63,56
1658026553422,COGS 17,A01,092677,Semenuks; Arturs,7,0,81,74
1658026559446,COGS 100,A01,083619,Allen; Michael Gordon,17,0,70,53
1658026565468,COGS 101A,A01,083621,Davis; Joshua Daniel,9,0,68,59
1658026571491,COGS 101B,A01,091572,Allen; Michael Gordon,14,0,65,51
1658026577513,COGS 101C,A01,083625,Delgado; Tania,17,0,35,18
1658026583536,COGS 107A,A01,083627,Boyle; Mary E. T.,14,0,60,46
1658026589563,COGS 118A,A01,083075,Gupta; Anjum,21,0,76,55
1658026595590,CSE 3,A50,083646,Miranda; Gregory Joseph,24,0,50,26
1658026601616,CSE 8A,A50,083650,Miranda; Gregory Joseph,17,1,56,39
1658026607640,CSE 11,A01,083080,Cao; Yingjun,7,15,40,33
1658026613663,CSE 12,A01,083652,Krause-Levy; Sophia Louisa,30,1,120,90
1658026619687,CSE 15L,A01,083654,Morris; Justin Loren,9,0,50,41
1658026619687,CSE 15L,A02,083655,Morris; Justin Loren,11,0,50,39
1658026625709,CSE 20,A01,083657,Tran; Khoa Dang,39,0,80,41
1658026631740,CSE 21,A01,095574,Bach; Quang Tran,23,0,48,25
1658026637763,CSE 30,A01,083084,Eldon; John,8,0,80,72
1658026637763,CSE 30,B01,095061,Bhaskar; Nishant,9,0,50,41
1658026643788,CSE 100,A01,083659,Cao; Yingjun,5,4,70,65
1658026649816,CSE 134B,A01,083661,Powell; Thomas Allan,25,0,100,75
1658026655837,CSE 140,A01,083663,Gungor; Onat,17,0,85,68
1658026661861,CSE 140L,A01,083088,Eldon; John,23,0,100,77
1658026667884,CSE 175,A01,083665,Kumar; Rakesh,3,0,25,22
1658026673908,CSE 190,A00,092507,Dubnov; Shlomo,8,0,20,12
1658026679930,ECE 45,A01,083139,Congero; Spencer William,7,0,75,68
1658026685952,ECE 65,A50,083695,Saad; Andrew S,12,0,30,18
1658026685952,ECE 65,A51,095125,Saad; Andrew S,24,0,26,2
1658026691975,ECE 109,A01,091882,Touri; Behrouz,21,0,70,49
1658026697998,ECE 180,A00,083140,Abi Samra; Nicholas Camill,1,0,30,29
1658026697998,ECE 180,B00,083141,Abi Samra; Nicholas Camill,0,0,30,30
1658026704026,MATH 10A,A01,083735,Patchell; Gregory David,2,0,30,28
1658026704026,MATH 10A,A02,083736,Patchell; Gregory David,20,0,30,10
1658026704026,MATH 10A,A03,083737,Patchell; Gregory David,16,0,30,14
1658026710049,MATH 10B,A01,083207,Lim; Seonhee,9,0,34,25
1658026710049,MATH 10B,A02,083208,Lim; Seonhee,10,0,35,25
1658026710049,MATH 10B,A03,093472,Lim; Seonhee,7,0,34,27
1658026710049,MATH 10B,B01,083739,Sinha; Shubham,14,0,30,16
1658026716073,MATH 18,A01,083743,Cinel; Cameron Alexander,9,0,30,21
1658026716073,MATH 18,A02,083744,Cinel; Cameron Alexander,18,0,30,12
1658026716073,MATH 18,A03,083745,Cinel; Cameron Alexander,10,0,30,20
1658026716073,MATH 18,B01,083748,Rideout; David Porter,5,0,37,32
1658026716073,MATH 18,B02,083749,Rideout; David Porter,5,0,36,31
1658026716073,MATH 18,B03,083750,Rideout; David Porter,3,0,37,34
1658026716073,MATH 18,B04,083751,Rideout; David Porter,7,0,36,29
1658026716073,MATH 18,B05,093473,Rideout; David Porter,7,0,36,29
1658026716073,MATH 18,B06,093474,Rideout; David Porter,6,0,36,30
1658026722096,MATH 20A,A01,083754,Zheng; Zequn,14,0,40,26
1658026728120,MATH 20B,A01,083756,Briones; Jor-el Thomas Caparas,4,0,36,32
1658026728120,MATH 20B,A02,083757,Briones; Jor-el Thomas Caparas,1,0,36,35
1658026728120,MATH 20B,A03,093475,Briones; Jor-el Thomas Caparas,3,0,36,33
1658026734149,MATH 20C,A01,083760,Briones; Jor-el Thomas Caparas,1,0,35,34
1658026734149,MATH 20C,A02,083761,Briones; Jor-el Thomas Caparas,8,0,35,27
1658026734149,MATH 20C,A03,093476,Briones; Jor-el Thomas Caparas,0,1,36,36
1658026734149,MATH 20C,B01,083762,Bach; Quang Tran,1,0,30,29
1658026740185,MATH 20D,A01,083765,Tran; Brian Kha,5,0,30,25
1658026740185,MATH 20D,A02,083766,Tran; Brian Kha,5,0,30,25
1658026740185,MATH 20D,A03,083767,Tran; Brian Kha,6,0,30,24
1658026746241,MATH 20E,A01,083771,Ganguly; Soumya,12,0,32,20
1658026746241,MATH 20E,A02,083772,Ganguly; Soumya,7,0,32,25
1658026746241,MATH 20E,B01,083773,Ciotti; Benjamin,20,0,35,15
1658026746241,MATH 20E,B02,083774,Ciotti; Benjamin,18,0,35,17
1658026752267,MATH 103A,A01,083777,Greenfeld; Be'Eri,6,0,36,30
1658026752267,MATH 103A,A02,083778,Greenfeld; Be'Eri,5,0,36,31
1658026752267,MATH 103A,A03,093561,Greenfeld; Be'Eri,7,0,36,29
1658026752267,MATH 103A,B01,083779,Greenfeld; Be'Eri,8,0,36,28
1658026752267,MATH 103A,B02,083780,Greenfeld; Be'Eri,4,0,36,32
1658026752267,MATH 103A,B03,093562,Greenfeld; Be'Eri,3,0,36,33
1658026758293,MATH 105,A01,085443,Carter; Anne Toulson,15,0,35,20
1658026758293,MATH 105,A02,093477,Carter; Anne Toulson,20,0,35,15
1658026764389,MATH 109,A01,083213,Ganzberger; Geoffrey Michael,3,0,34,31
1658026764389,MATH 109,A02,083214,Ganzberger; Geoffrey Michael,4,0,34,30
1658026764389,MATH 109,A03,093478,Ganzberger; Geoffrey Michael,2,0,34,32
1658026764389,MATH 109,B01,083215,Ganzberger; Geoffrey Michael,3,0,32,29
1658026764389,MATH 109,B02,083216,Ganzberger; Geoffrey Michael,3,0,32,29
1658026764389,MATH 109,B03,093479,Ganzberger; Geoffrey Michael,8,0,32,24
1658026770412,MATH 142A,A01,083219,Chow; Bennett,7,0,32,25
1658026770412,MATH 142A,A02,083220,Chow; Bennett,10,0,32,22
1658026770412,MATH 142A,A03,093480,Chow; Bennett,9,0,32,23
1658026770412,MATH 142A,B03,093481,Chow; Bennett,8,0,32,24
1658026770412,MATH 142A,B04,093558,Chow; Bennett,14,0,32,18
1658026770412,MATH 142A,B05,093559,Chow; Bennett,7,0,32,25
1658026776439,MATH 193A,A01,083224,Rotar; Vladimir,9,0,34,25
1658026776439,MATH 193A,A02,083225,Rotar; Vladimir,11,0,34,23
1658026776439,MATH 193A,A03,083781,Rotar; Vladimir,5,0,34,29
1658026776439,MATH 193A,A04,083782,Rotar; Vladimir,12,0,34,22
1658026776439,MATH 193A,A05,093482,Rotar; Vladimir,11,0,34,23
1658026782465,MATH 197,001,091859,McAuley; Julian John,9999,0,9999,0
1658026782465,MATH 197,002,095566,Kedlaya; Kiran S.,9997,0,9999,2
1658026782465,MATH 197,003,095567,Xiao; Ming,9999,0,9999,0
1658026782465,MATH 197,004,095571,Perols; Johan Lars,9998,0,9999,1
1658026789526,COGS 9,A01,083615,Shannon; Kyle Michael,11,0,75,64
1658026795552,COGS 11,A01,083617,Boyle; Mary E. T.,23,0,48,25
1658026801579,COGS 13,A01,083071,Bastos; Amalia Pinkusfeld,12,0,71,59
1658026807601,COGS 14A,A01,092681,Semenuks; Arturs,5,1,100,95
1658026813627,COGS 14B,A01,083073,Cheng; Tzu-Han,7,0,63,56
1658026819650,COGS 17,A01,092677,Semenuks; Arturs,7,0,81,74
1658026825675,COGS 100,A01,083619,Allen; Michael Gordon,17,0,70,53
1658026831700,COGS 101A,A01,083621,Davis; Joshua Daniel,9,0,68,59
1658026837721,COGS 101B,A01,091572,Allen; Michael Gordon,14,0,65,51
1658026843746,COGS 101C,A01,083625,Delgado; Tania,17,0,35,18
1658026849777,COGS 107A,A01,083627,Boyle; Mary E. T.,14,0,60,46
1658026855804,COGS 118A,A01,083075,Gupta; Anjum,21,0,76,55
1658026861833,CSE 3,A50,083646,Miranda; Gregory Joseph,24,0,50,26
1658026867859,CSE 8A,A50,083650,Miranda; Gregory Joseph,17,1,56,39
1658026873885,CSE 11,A01,083080,Cao; Yingjun,7,15,40,33
1658026879906,CSE 12,A01,083652,Krause-Levy; Sophia Louisa,30,1,120,90
1658026885932,CSE 15L,A01,083654,Morris; Justin Loren,9,0,50,41
1658026885932,CSE 15L,A02,083655,Morris; Justin Loren,11,0,50,39
1658026891954,CSE 20,A01,083657,Tran; Khoa Dang,39,0,80,41
1658026897977,CSE 21,A01,095574,Bach; Quang Tran,23,0,48,25
1658026904005,CSE 30,A01,083084,Eldon; John,8,0,80,72
1658026904005,CSE 30,B01,095061,Bhaskar; Nishant,9,0,50,41
1658026910029,CSE 100,A01,083659,Cao; Yingjun,5,4,70,65
1658026916060,CSE 134B,A01,083661,Powell; Thomas Allan,25,0,100,75
1658026922084,CSE 140,A01,083663,Gungor; Onat,17,0,85,68
1658026928111,CSE 140L,A01,083088,Eldon; John,23,0,100,77
1658026934134,CSE 175,A01,083665,Kumar; Rakesh,3,0,25,22
1658026940158,CSE 190,A00,092507,Dubnov; Shlomo,8,0,20,12
1658026946185,ECE 45,A01,083139,Congero; Spencer William,7,0,75,68
1658026952208,ECE 65,A50,083695,Saad; Andrew S,12,0,30,18
1658026952208,ECE 65,A51,095125,Saad; Andrew S,24,0,26,2
1658026958229,ECE 109,A01,091882,Touri; Behrouz,21,0,70,49
1658026964264,ECE 180,A00,083140,Abi Samra; Nicholas Camill,1,0,30,29
1658026964264,ECE 180,B00,083141,Abi Samra; Nicholas Camill,0,0,30,30
1658026970292,MATH 10A,A01,083735,Patchell; Gregory David,2,0,30,28
1658026970292,MATH 10A,A02,083736,Patchell; Gregory David,20,0,30,10
1658026970292,MATH 10A,A03,083737,Patchell; Gregory David,16,0,30,14
1658026976315,MATH 10B,A01,083207,Lim; Seonhee,9,0,34,25
1658026976315,MATH 10B,A02,083208,Lim; Seonhee,10,0,35,25
1658026976315,MATH 10B,A03,093472,Lim; Seonhee,7,0,34,27
1658026976315,MATH 10B,B01,083739,Sinha; Shubham,14,0,30,16
1658026982339,MATH 18,A01,083743,Cinel; Cameron Alexander,9,0,30,21
1658026982339,MATH 18,A02,083744,Cinel; Cameron Alexander,18,0,30,12
1658026982339,MATH 18,A03,083745,Cinel; Cameron Alexander,10,0,30,20
1658026982339,MATH 18,B01,083748,Rideout; David Porter,5,0,37,32
1658026982339,MATH 18,B02,083749,Rideout; David Porter,5,0,36,31
1658026982339,MATH 18,B03,083750,Rideout; David Porter,3,0,37,34
1658026982339,MATH 18,B04,083751,Rideout; David Porter,7,0,36,29
1658026982339,MATH 18,B05,093473,Rideout; David Porter,7,0,36,29
1658026982339,MATH 18,B06,093474,Rideout; David Porter,6,0,36,30
1658026988362,MATH 20A,A01,083754,Zheng; Zequn,14,0,40,26
1658026994390,MATH 20B,A01,083756,Briones; Jor-el Thomas Caparas,4,0,36,32
1658026994390,MATH 20B,A02,083757,Briones; Jor-el Thomas Caparas,1,0,36,35
1658026994390,MATH 20B,A03,093475,Briones; Jor-el Thomas Caparas,3,0,36,33
1658027000415,MATH 20C,A01,083760,Briones; Jor-el Thomas Caparas,1,0,35,34
1658027000415,MATH 20C,A02,083761,Briones; Jor-el Thomas Caparas,8,0,35,27
1658027000415,MATH 20C,A03,093476,Briones; Jor-el Thomas Caparas,0,1,36,36
1658027000415,MATH 20C,B01,083762,Bach; Quang Tran,1,0,30,29
1658027006439,MATH 20D,A01,083765,Tran; Brian Kha,5,0,30,25
1658027006439,MATH 20D,A02,083766,Tran; Brian Kha,5,0,30,25
1658027006439,MATH 20D,A03,083767,Tran; Brian Kha,6,0,30,24
1658027012462,MATH 20E,A01,083771,Ganguly; Soumya,12,0,32,20
1658027012462,MATH 20E,A02,083772,Ganguly; Soumya,7,0,32,25
1658027012462,MATH 20E,B01,083773,Ciotti; Benjamin,20,0,35,15
1658027012462,MATH 20E,B02,083774,Ciotti; Benjamin,18,0,35,17
1658027018487,MATH 103A,A01,083777,Greenfeld; Be'Eri,6,0,36,30
1658027018487,MATH 103A,A02,083778,Greenfeld; Be'Eri,5,0,36,31
1658027018487,MATH 103A,A03,093561,Greenfeld; Be'Eri,7,0,36,29
1658027018487,MATH 103A,B01,083779,Greenfeld; Be'Eri,8,0,36,28
1658027018487,MATH 103A,B02,083780,Greenfeld; Be'Eri,4,0,36,32
1658027018487,MATH 103A,B03,093562,Greenfeld; Be'Eri,3,0,36,33
1658027024508,MATH 105,A01,085443,Carter; Anne Toulson,15,0,35,20
1658027024508,MATH 105,A02,093477,Carter; Anne Toulson,20,0,35,15
1658027030530,MATH 109,A01,083213,Ganzberger; Geoffrey Michael,3,0,34,31
1658027030530,MATH 109,A02,083214,Ganzberger; Geoffrey Michael,4,0,34,30
1658027030530,MATH 109,A03,093478,Ganzberger; Geoffrey Michael,2,0,34,32
1658027030530,MATH 109,B01,083215,Ganzberger; Geoffrey Michael,3,0,32,29
1658027030530,MATH 109,B02,083216,Ganzberger; Geoffrey Michael,3,0,32,29
1658027030530,MATH 109,B03,093479,Ganzberger; Geoffrey Michael,8,0,32,24
1658027036560,MATH 142A,A01,083219,Chow; Bennett,7,0,32,25
1658027036560,MATH 142A,A02,083220,Chow; Bennett,10,0,32,22
1658027036560,MATH 142A,A03,093480,Chow; Bennett,9,0,32,23
1658027036560,MATH 142A,B03,093481,Chow; Bennett,8,0,32,24
1658027036560,MATH 142A,B04,093558,Chow; Bennett,14,0,32,18
1658027036560,MATH 142A,B05,093559,Chow; Bennett,7,0,32,25
1658027042584,MATH 193A,A01,083224,Rotar; Vladimir,9,0,34,25
1658027042584,MATH 193A,A02,083225,Rotar; Vladimir,11,0,34,23
1658027042584,MATH 193A,A03,083781,Rotar; Vladimir,5,0,34,29
1658027042584,MATH 193A,A04,083782,Rotar; Vladimir,12,0,34,22
1658027042584,MATH 193A,A05,093482,Rotar; Vladimir,11,0,34,23
1658027048606,MATH 197,001,091859,McAuley; Julian John,9999,0,9999,0
1658027048606,MATH 197,002,095566,Kedlaya; Kiran S.,9997,0,9999,2
1658027048606,MATH 197,003,095567,Xiao; Ming,9999,0,9999,0
1658027048606,MATH 197,004,095571,Perols; Johan Lars,9998,0,9999,1
1658027055670,COGS 9,A01,083615,Shannon; Kyle Michael,11,0,75,64
1658027061691,COGS 11,A01,083617,Boyle; Mary E. T.,23,0,48,25
1658027067716,COGS 13,A01,083071,Bastos; Amalia Pinkusfeld,12,0,71,59
1658027073738,COGS 14A,A01,092681,Semenuks; Arturs,5,1,100,95
1658027079761,COGS 14B,A01,083073,Cheng; Tzu-Han,7,0,63,56
1658027085797,COGS 17,A01,092677,Semenuks; Arturs,7,0,81,74
1658027091830,COGS 100,A01,083619,Allen; Michael Gordon,17,0,70,53
1658027097858,COGS 101A,A01,083621,Davis; Joshua Daniel,9,0,68,59
1658027103884,COGS 101B,A01,091572,Allen; Michael Gordon,14,0,65,51
1658027109905,COGS 101C,A01,083625,Delgado; Tania,17,0,35,18
1658027115933,COGS 107A,A01,083627,Boyle; Mary E. T.,14,0,60,46
1658027121968,COGS 118A,A01,083075,Gupta; Anjum,21,0,76,55
1658027127991,CSE 3,A50,083646,Miranda; Gregory Joseph,24,0,50,26
1658027134016,CSE 8A,A50,083650,Miranda; Gregory Joseph,17,1,56,39
1658027140040,CSE 11,A01,083080,Cao; Yingjun,7,15,40,33
1658027146067,CSE 12,A01,083652,Krause-Levy; Sophia Louisa,30,1,120,90
1658027152092,CSE 15L,A01,083654,Morris; Justin Loren,9,0,50,41
1658027152092,CSE 15L,A02,083655,Morris; Justin Loren,11,0,50,39
1658027158116,CSE 20,A01,083657,Tran; Khoa Dang,39,0,80,41
1658027164143,CSE 21,A01,095574,Bach; Quang Tran,23,0,48,25
1658027170168,CSE 30,A01,083084,Eldon; John,8,0,80,72
1658027170168,CSE 30,B01,095061,Bhaskar; Nishant,9,0,50,41
1658027176191,CSE 100,A01,083659,Cao; Yingjun,5,4,70,65
1658027182217,CSE 134B,A01,083661,Powell; Thomas Allan,25,0,100,75
1658027188243,CSE 140,A01,083663,Gungor; Onat,17,0,85,68
1658027194266,CSE 140L,A01,083088,Eldon; John,23,0,100,77
1658027200290,CSE 175,A01,083665,Kumar; Rakesh,3,0,25,22
1658027206313,CSE 190,A00,092507,Dubnov; Shlomo,8,0,20,12
1658027212340,ECE 45,A01,083139,Congero; Spencer William,7,0,75,68
1658027218362,ECE 65,A50,083695,Saad; Andrew S,12,0,30,18
1658027218362,ECE 65,A51,095125,Saad; Andrew S,24,0,26,2
1658027224393,ECE 109,A01,091882,Touri; Behrouz,21,0,70,49
1658027230418,ECE 180,A00,083140,Abi Samra; Nicholas Camill,1,0,30,29
1658027230418,ECE 180,B00,083141,Abi Samra; Nicholas Camill,0,0,30,30
1658027236441,MATH 10A,A01,083735,Patchell; Gregory David,2,0,30,28
1658027236441,MATH 10A,A02,083736,Patchell; Gregory David,20,0,30,10
1658027236441,MATH 10A,A03,083737,Patchell; Gregory David,16,0,30,14
1658027242471,MATH 10B,A01,083207,Lim; Seonhee,9,0,34,25
1658027242471,MATH 10B,A02,083208,Lim; Seonhee,10,0,35,25
1658027242471,MATH 10B,A03,093472,Lim; Seonhee,7,0,34,27
1658027242471,MATH 10B,B01,083739,Sinha; Shubham,14,0,30,16
1658027248495,MATH 18,A01,083743,Cinel; Cameron Alexander,9,0,30,21
1658027248495,MATH 18,A02,083744,Cinel; Cameron Alexander,18,0,30,12
1658027248495,MATH 18,A03,083745,Cinel; Cameron Alexander,10,0,30,20
1658027248495,MATH 18,B01,083748,Rideout; David Porter,5,0,37,32
1658027248495,MATH 18,B02,083749,Rideout; David Porter,5,0,36,31
1658027248495,MATH 18,B03,083750,Rideout; David Porter,3,0,37,34
1658027248495,MATH 18,B04,083751,Rideout; David Porter,7,0,36,29
1658027248495,MATH 18,B05,093473,Rideout; David Porter,7,0,36,29
1658027248495,MATH 18,B06,093474,Rideout; David Porter,6,0,36,30
1658027254521,MATH 20A,A01,083754,Zheng; Zequn,14,0,40,26
1658027260546,MATH 20B,A01,083756,Briones; Jor-el Thomas Caparas,4,0,36,32
1658027260546,MATH 20B,A02,083757,Briones; Jor-el Thomas Caparas,1,0,36,35
1658027260546,MATH 20B,A03,093475,Briones; Jor-el Thomas Caparas,3,0,36,33
1658027266574,MATH 20C,A01,083760,Briones; Jor-el Thomas Caparas,1,0,35,34
1658027266574,MATH 20C,A02,083761,Briones; Jor-el Thomas Caparas,8,0,35,27
1658027266574,MATH 20C,A03,093476,Briones; Jor-el Thomas Caparas,0,1,36,36
1658027266574,MATH 20C,B01,083762,Bach; Quang Tran,1,0,30,29
1658027272596,MATH 20D,A01,083765,Tran; Brian Kha,5,0,30,25
1658027272596,MATH 20D,A02,083766,Tran; Brian Kha,5,0,30,25
1658027272596,MATH 20D,A03,083767,Tran; Brian Kha,6,0,30,24
1658027278621,MATH 20E,A01,083771,Ganguly; Soumya,12,0,32,20
1658027278621,MATH 20E,A02,083772,Ganguly; Soumya,7,0,32,25
1658027278621,MATH 20E,B01,083773,Ciotti; Benjamin,20,0,35,15
1658027278621,MATH 20E,B02,083774,Ciotti; Benjamin,18,0,35,17
1658027284646,MATH 103A,A01,083777,Greenfeld; Be'Eri,6,0,36,30
1658027284646,MATH 103A,A02,083778,Greenfeld; Be'Eri,5,0,36,31
1658027284646,MATH 103A,A03,093561,Greenfeld; Be'Eri,7,0,36,29
1658027284646,MATH 103A,B01,083779,Greenfeld; Be'Eri,8,0,36,28
1658027284646,MATH 103A,B02,083780,Greenfeld; Be'Eri,4,0,36,32
1658027284646,MATH 103A,B03,093562,Greenfeld; Be'Eri,3,0,36,33
1658027290672,MATH 105,A01,085443,Carter; Anne Toulson,15,0,35,20
1658027290672,MATH 105,A02,093477,Carter; Anne Toulson,20,0,35,15
1658027296693,MATH 109,A01,083213,Ganzberger; Geoffrey Michael,3,0,34,31
1658027296693,MATH 109,A02,083214,Ganzberger; Geoffrey Michael,4,0,34,30
1658027296693,MATH 109,A03,093478,Ganzberger; Geoffrey Michael,2,0,34,32
1658027296693,MATH 109,B01,083215,Ganzberger; Geoffrey Michael,3,0,32,29
1658027296693,MATH 109,B02,083216,Ganzberger; Geoffrey Michael,3,0,32,29
1658027296693,MATH 109,B03,093479,Ganzberger; Geoffrey Michael,8,0,32,24
1658027302717,MATH 142A,A01,083219,Chow; Bennett,7,0,32,25
1658027302717,MATH 142A,A02,083220,Chow; Bennett,10,0,32,22
1658027302717,MATH 142A,A03,093480,Chow; Bennett,9,0,32,23
1658027302717,MATH 142A,B03,093481,Chow; Bennett,8,0,32,24
1658027302717,MATH 142A,B04,093558,Chow; Bennett,14,0,32,18
1658027302717,MATH 142A,B05,093559,Chow; Bennett,7,0,32,25
1658027308739,MATH 193A,A01,083224,Rotar; Vladimir,9,0,34,25
1658027308739,MATH 193A,A02,083225,Rotar; Vladimir,11,0,34,23
1658027308739,MATH 193A,A03,083781,Rotar; Vladimir,5,0,34,29
1658027308739,MATH 193A,A04,083782,Rotar; Vladimir,12,0,34,22
1658027308739,MATH 193A,A05,093482,Rotar; Vladimir,11,0,34,23
1658027314764,MATH 197,001,091859,McAuley; Julian John,9999,0,9999,0
1658027314764,MATH 197,002,095566,Kedlaya; Kiran S.,9997,0,9999,2
1658027314764,MATH 197,003,095567,Xiao; Ming,9999,0,9999,0
1658027314764,MATH 197,004,095571,Perols; Johan Lars,9998,0,9999,1
1658027321826,COGS 9,A01,083615,Shannon; Kyle Michael,11,0,75,64
1658027327852,COGS 11,A01,083617,Boyle; Mary E. T.,23,0,48,25
1658027333878,COGS 13,A01,083071,Bastos; Amalia Pinkusfeld,12,0,71,59
1658027339903,COGS 14A,A01,092681,Semenuks; Arturs,5,1,100,95
1658027345925,COGS 14B,A01,083073,Cheng; Tzu-Han,7,0,63,56
1658027351949,COGS 17,A01,092677,Semenuks; Arturs,7,0,81,74
1658027358061,COGS 100,A01,083619,Allen; Michael Gordon,17,0,70,53
1658027364087,COGS 101A,A01,083621,Davis; Joshua Daniel,9,0,68,59
1658027370116,COGS 101B,A01,091572,Allen; Michael Gordon,14,0,65,51
1658027376144,COGS 101C,A01,083625,Delgado; Tania,17,0,35,18
1658027382167,COGS 107A,A01,083627,Boyle; Mary E. T.,14,0,60,46
1658027388194,COGS 118A,A01,083075,Gupta; Anjum,21,0,76,55
1658027394218,CSE 3,A50,083646,Miranda; Gregory Joseph,24,0,50,26
1658027400245,CSE 8A,A50,083650,Miranda; Gregory Joseph,17,1,56,39
1658027406267,CSE 11,A01,083080,Cao; Yingjun,7,15,40,33
1658027412294,CSE 12,A01,083652,Krause-Levy; Sophia Louisa,30,1,120,90
1658027418317,CSE 15L,A01,083654,Morris; Justin Loren,9,0,50,41
1658027418317,CSE 15L,A02,083655,Morris; Justin Loren,11,0,50,39
1658027424340,CSE 20,A01,083657,Tran; Khoa Dang,39,0,80,41
1658027430371,CSE 21,A01,095574,Bach; Quang Tran,23,0,48,25
1658027436401,CSE 30,A01,083084,Eldon; John,8,0,80,72
1658027436401,CSE 30,B01,095061,Bhaskar; Nishant,9,0,50,41
1658027442425,CSE 100,A01,083659,Cao; Yingjun,5,4,70,65
1658027448451,CSE 134B,A01,083661,Powell; Thomas Allan,25,0,100,75
1658027454474,CSE 140,A01,083663,Gungor; Onat,17,0,85,68
1658027460497,CSE 140L,A01,083088,Eldon; John,23,0,100,77
1658027466521,CSE 175,A01,083665,Kumar; Rakesh,3,0,25,22
1658027472548,CSE 190,A00,092507,Dubnov; Shlomo,8,0,20,12
1658027478571,ECE 45,A01,083139,Congero; Spencer William,7,0,75,68
1658027484594,ECE 65,A50,083695,Saad; Andrew S,12,0,30,18
1658027484594,ECE 65,A51,095125,Saad; Andrew S,24,0,26,2
1658027490617,ECE 109,A01,091882,Touri; Behrouz,21,0,70,49
1658027496641,ECE 180,A00,083140,Abi Samra; Nicholas Camill,1,0,30,29
1658027496641,ECE 180,B00,083141,Abi Samra; Nicholas Camill,0,0,30,30
1658027502665,MATH 10A,A01,083735,Patchell; Gregory David,2,0,30,28
1658027502665,MATH 10A,A02,083736,Patchell; Gregory David,20,0,30,10
1658027502665,MATH 10A,A03,083737,Patchell; Gregory David,16,0,30,14
1658027508694,MATH 10B,A01,083207,Lim; Seonhee,9,0,34,25
1658027508694,MATH 10B,A02,083208,Lim; Seonhee,10,0,35,25
1658027508694,MATH 10B,A03,093472,Lim; Seonhee,7,0,34,27
1658027508694,MATH 10B,B01,083739,Sinha; Shubham,14,0,30,16
1658027514727,MATH 18,A01,083743,Cinel; Cameron Alexander,9,0,30,21
1658027514727,MATH 18,A02,083744,Cinel; Cameron Alexander,18,0,30,12
1658027514727,MATH 18,A03,083745,Cinel; Cameron Alexander,10,0,30,20
1658027514727,MATH 18,B01,083748,Rideout; David Porter,5,0,37,32
1658027514727,MATH 18,B02,083749,Rideout; David Porter,5,0,36,31
1658027514727,MATH 18,B03,083750,Rideout; David Porter,3,0,37,34
1658027514727,MATH 18,B04,083751,Rideout; David Porter,7,0,36,29
1658027514727,MATH 18,B05,093473,Rideout; David Porter,7,0,36,29
1658027514727,MATH 18,B06,093474,Rideout; David Porter,6,0,36,30
1658027520750,MATH 20A,A01,083754,Zheng; Zequn,14,0,40,26
1658027526779,MATH 20B,A01,083756,Briones; Jor-el Thomas Caparas,4,0,36,32
1658027526779,MATH 20B,A02,083757,Briones; Jor-el Thomas Caparas,1,0,36,35
1658027526779,MATH 20B,A03,093475,Briones; Jor-el Thomas Caparas,3,0,36,33
1658027532803,MATH 20C,A01,083760,Briones; Jor-el Thomas Caparas,1,0,35,34
1658027532803,MATH 20C,A02,083761,Briones; Jor-el Thomas Caparas,8,0,35,27
1658027532803,MATH 20C,A03,093476,Briones; Jor-el Thomas Caparas,0,1,36,36
1658027532803,MATH 20C,B01,083762,Bach; Quang Tran,1,0,30,29
1658027538828,MATH 20D,A01,083765,Tran; Brian Kha,5,0,30,25
1658027538828,MATH 20D,A02,083766,Tran; Brian Kha,5,0,30,25
1658027538828,MATH 20D,A03,083767,Tran; Brian Kha,6,0,30,24
1658027544856,MATH 20E,A01,083771,Ganguly; Soumya,12,0,32,20
1658027544856,MATH 20E,A02,083772,Ganguly; Soumya,7,0,32,25
1658027544856,MATH 20E,B01,083773,Ciotti; Benjamin,20,0,35,15
1658027544856,MATH 20E,B02,083774,Ciotti; Benjamin,18,0,35,17
1658027550879,MATH 103A,A01,083777,Greenfeld; Be'Eri,6,0,36,30
1658027550879,MATH 103A,A02,083778,Greenfeld; Be'Eri,5,0,36,31
1658027550879,MATH 103A,A03,093561,Greenfeld; Be'Eri,7,0,36,29
1658027550879,MATH 103A,B01,083779,Greenfeld; Be'Eri,8,0,36,28
1658027550879,MATH 103A,B02,083780,Greenfeld; Be'Eri,4,0,36,32
1658027550879,MATH 103A,B03,093562,Greenfeld; Be'Eri,3,0,36,33
1658027556904,MATH 105,A01,085443,Carter; Anne Toulson,15,0,35,20
1658027556904,MATH 105,A02,093477,Carter; Anne Toulson,20,0,35,15
1658027562927,MATH 109,A01,083213,Ganzberger; Geoffrey Michael,3,0,34,31
1658027562927,MATH 109,A02,083214,Ganzberger; Geoffrey Michael,4,0,34,30
1658027562927,MATH 109,A03,093478,Ganzberger; Geoffrey Michael,2,0,34,32
1658027562927,MATH 109,B01,083215,Ganzberger; Geoffrey Michael,3,0,32,29
1658027562927,MATH 109,B02,083216,Ganzberger; Geoffrey Michael,3,0,32,29
1658027562927,MATH 109,B03,093479,Ganzberger; Geoffrey Michael,8,0,32,24
1658027568952,MATH 142A,A01,083219,Chow; Bennett,7,0,32,25
1658027568952,MATH 142A,A02,083220,Chow; Bennett,10,0,32,22
1658027568952,MATH 142A,A03,093480,Chow; Bennett,9,0,32,23
1658027568952,MATH 142A,B03,093481,Chow; Bennett,8,0,32,24
1658027568952,MATH 142A,B04,093558,Chow; Bennett,14,0,32,18
1658027568952,MATH 142A,B05,093559,Chow; Bennett,7,0,32,25
1658027574976,MATH 193A,A01,083224,Rotar; Vladimir,9,0,34,25
1658027574976,MATH 193A,A02,083225,Rotar; Vladimir,11,0,34,23
1658027574976,MATH 193A,A03,083781,Rotar; Vladimir,5,0,34,29
1658027574976,MATH 193A,A04,083782,Rotar; Vladimir,12,0,34,22
1658027574976,MATH 193A,A05,093482,Rotar; Vladimir,11,0,34,23
1658027581000,MATH 197,001,091859,McAuley; Julian John,9999,0,9999,0
1658027581000,MATH 197,002,095566,Kedlaya; Kiran S.,9997,0,9999,2
1658027581000,MATH 197,003,095567,Xiao; Ming,9999,0,9999,0
1658027581000,MATH 197,004,095571,Perols; Johan Lars,9998,0,9999,1
1658027588064,COGS 9,A01,083615,Shannon; Kyle Michael,11,0,75,64
1658027594089,COGS 11,A01,083617,Boyle; Mary E. T.,23,0,48,25
1658027600112,COGS 13,A01,083071,Bastos; Amalia Pinkusfeld,12,0,71,59
1658027606138,COGS 14A,A01,092681,Semenuks; Arturs,5,1,100,95
1658027612161,COGS 14B,A01,083073,Cheng; Tzu-Han,7,0,63,56
1658027618184,COGS 17,A01,092677,Semenuks; Arturs,7,0,81,74
1658027624208,COGS 100,A01,083619,Allen; Michael Gordon,17,0,70,53
1658027630231,COGS 101A,A01,083621,Davis; Joshua Daniel,9,0,68,59
1658027636258,COGS 101B,A01,091572,Allen; Michael Gordon,14,0,65,51
1658027642282,COGS 101C,A01,083625,Delgado; Tania,17,0,35,18
1658027648305,COGS 107A,A01,083627,Boyle; Mary E. T.,14,0,60,46
1658027654332,COGS 118A,A01,083075,Gupta; Anjum,21,0,76,55
1658027660354,CSE 3,A50,083646,Miranda; Gregory Joseph,24,0,50,26
1658027666381,CSE 8A,A50,083650,Miranda; Gregory Joseph,17,1,56,39
1658027672407,CSE 11,A01,083080,Cao; Yingjun,7,15,40,33
1658027678429,CSE 12,A01,083652,Krause-Levy; Sophia Louisa,30,1,120,90
1658027684454,CSE 15L,A01,083654,Morris; Justin Loren,9,0,50,41
1658027684454,CSE 15L,A02,083655,Morris; Justin Loren,11,0,50,39
1658027690480,CSE 20,A01,083657,Tran; Khoa Dang,39,0,80,41
1658027696504,CSE 21,A01,095574,Bach; Quang Tran,23,0,48,25
1658027702530,CSE 30,A01,083084,Eldon; John,8,0,80,72
1658027702530,CSE 30,B01,095061,Bhaskar; Nishant,9,0,50,41
1658027708552,CSE 100,A01,083659,Cao; Yingjun,5,4,70,65
1658027714574,CSE 134B,A01,083661,Powell; Thomas Allan,25,0,100,75
1658027720598,CSE 140,A01,083663,Gungor; Onat,17,0,85,68
1658027726626,CSE 140L,A01,083088,Eldon; John,23,0,100,77
1658027732653,CSE 175,A01,083665,Kumar; Rakesh,3,0,25,22
1658027738683,CSE 190,A00,092507,Dubnov; Shlomo,8,0,20,12
1658027744708,ECE 45,A01,083139,Congero; Spencer William,7,0,75,68
1658027750732,ECE 65,A50,083695,Saad; Andrew S,12,0,30,18
1658027750732,ECE 65,A51,095125,Saad; Andrew S,24,0,26,2
1658027756754,ECE 109,A01,091882,Touri; Behrouz,21,0,70,49
1658027762778,ECE 180,A00,083140,Abi Samra; Nicholas Camill,1,0,30,29
1658027762778,ECE 180,B00,083141,Abi Samra; Nicholas Camill,0,0,30,30
1658027768802,MATH 10A,A01,083735,Patchell; Gregory David,2,0,30,28
1658027768802,MATH 10A,A02,083736,Patchell; Gregory David,20,0,30,10
1658027768802,MATH 10A,A03,083737,Patchell; Gregory David,16,0,30,14
1658027774830,MATH 10B,A01,083207,Lim; Seonhee,9,0,34,25
1658027774830,MATH 10B,A02,083208,Lim; Seonhee,10,0,35,25
1658027774830,MATH 10B,A03,093472,Lim; Seonhee,7,0,34,27
1658027774830,MATH 10B,B01,083739,Sinha; Shubham,14,0,30,16
1658027780853,MATH 18,A01,083743,Cinel; Cameron Alexander,9,0,30,21
1658027780853,MATH 18,A02,083744,Cinel; Cameron Alexander,18,0,30,12
1658027780853,MATH 18,A03,083745,Cinel; Cameron Alexander,10,0,30,20
1658027780853,MATH 18,B01,083748,Rideout; David Porter,5,0,37,32
1658027780853,MATH 18,B02,083749,Rideout; David Porter,5,0,36,31
1658027780853,MATH 18,B03,083750,Rideout; David Porter,3,0,37,34
1658027780853,MATH 18,B04,083751,Rideout; David Porter,7,0,36,29
1658027780853,MATH 18,B05,093473,Rideout; David Porter,7,0,36,29
1658027780853,MATH 18,B06,093474,Rideout; David Porter,6,0,36,30
1658027786876,MATH 20A,A01,083754,Zheng; Zequn,14,0,40,26
1658027792900,MATH 20B,A01,083756,Briones; Jor-el Thomas Caparas,4,0,36,32
1658027792900,MATH 20B,A02,083757,Briones; Jor-el Thomas Caparas,1,0,36,35
1658027792900,MATH 20B,A03,093475,Briones; Jor-el Thomas Caparas,3,0,36,33
1658027798927,MATH 20C,A01,083760,Briones; Jor-el Thomas Caparas,1,0,35,34
1658027798927,MATH 20C,A02,083761,Briones; Jor-el Thomas Caparas,8,0,35,27
1658027798927,MATH 20C,A03,093476,Briones; Jor-el Thomas Caparas,0,1,36,36
1658027798927,MATH 20C,B01,083762,Bach; Quang Tran,1,0,30,29
1658027804955,MATH 20D,A01,083765,Tran; Brian Kha,5,0,30,25
1658027804955,MATH 20D,A02,083766,Tran; Brian Kha,5,0,30,25
1658027804955,MATH 20D,A03,083767,Tran; Brian Kha,6,0,30,24
1658027810983,MATH 20E,A01,083771,Ganguly; Soumya,12,0,32,20
1658027810983,MATH 20E,A02,083772,Ganguly; Soumya,7,0,32,25
1658027810983,MATH 20E,B01,083773,Ciotti; Benjamin,20,0,35,15
1658027810983,MATH 20E,B02,083774,Ciotti; Benjamin,18,0,35,17
1658027817011,MATH 103A,A01,083777,Greenfeld; Be'Eri,6,0,36,30
1658027817011,MATH 103A,A02,083778,Greenfeld; Be'Eri,5,0,36,31
1658027817011,MATH 103A,A03,093561,Greenfeld; Be'Eri,7,0,36,29
1658027817011,MATH 103A,B01,083779,Greenfeld; Be'Eri,8,0,36,28
1658027817011,MATH 103A,B02,083780,Greenfeld; Be'Eri,4,0,36,32
1658027817011,MATH 103A,B03,093562,Greenfeld; Be'Eri,3,0,36,33
1658027823034,MATH 105,A01,085443,Carter; Anne Toulson,15,0,35,20
1658027823034,MATH 105,A02,093477,Carter; Anne Toulson,20,0,35,15
1658027829061,MATH 109,A01,083213,Ganzberger; Geoffrey Michael,3,0,34,31
1658027829061,MATH 109,A02,083214,Ganzberger; Geoffrey Michael,4,0,34,30
1658027829061,MATH 109,A03,093478,Ganzberger; Geoffrey Michael,2,0,34,32
1658027829061,MATH 109,B01,083215,Ganzberger; Geoffrey Michael,3,0,32,29
1658027829061,MATH 109,B02,083216,Ganzberger; Geoffrey Michael,3,0,32,29
1658027829061,MATH 109,B03,093479,Ganzberger; Geoffrey Michael,8,0,32,24
1658027835091,MATH 142A,A01,083219,Chow; Bennett,7,0,32,25
1658027835091,MATH 142A,A02,083220,Chow; Bennett,10,0,32,22
1658027835091,MATH 142A,A03,093480,Chow; Bennett,9,0,32,23
1658027835091,MATH 142A,B03,093481,Chow; Bennett,8,0,32,24
1658027835091,MATH 142A,B04,093558,Chow; Bennett,14,0,32,18
1658027835091,MATH 142A,B05,093559,Chow; Bennett,7,0,32,25
1658027841119,MATH 193A,A01,083224,Rotar; Vladimir,9,0,34,25
1658027841119,MATH 193A,A02,083225,Rotar; Vladimir,11,0,34,23
1658027841119,MATH 193A,A03,083781,Rotar; Vladimir,5,0,34,29
1658027841119,MATH 193A,A04,083782,Rotar; Vladimir,12,0,34,22
1658027841119,MATH 193A,A05,093482,Rotar; Vladimir,11,0,34,23
1658027847143,MATH 197,001,091859,McAuley; Julian John,9999,0,9999,0
1658027847143,MATH 197,002,095566,Kedlaya; Kiran S.,9997,0,9999,2
1658027847143,MATH 197,003,095567,Xiao; Ming,9999,0,9999,0
1658027847143,MATH 197,004,095571,Perols; Johan Lars,9998,0,9999,1
1658027854207,COGS 9,A01,083615,Shannon; Kyle Michael,11,0,75,64
1658027860235,COGS 11,A01,083617,Boyle; Mary E. T.,23,0,48,25
1658027866258,COGS 13,A01,083071,Bastos; Amalia Pinkusfeld,12,0,71,59
1658027872283,COGS 14A,A01,092681,Semenuks; Arturs,5,1,100,95
1658027878312,COGS 14B,A01,083073,Cheng; Tzu-Han,7,0,63,56
1658027884341,COGS 17,A01,092677,Semenuks; Arturs,7,0,81,74
1658027890367,COGS 100,A01,083619,Allen; Michael Gordon,17,0,70,53
1658027896393,COGS 101A,A01,083621,Davis; Joshua Daniel,9,0,68,59
1658027902415,COGS 101B,A01,091572,Allen; Michael Gordon,14,0,65,51
1658027908437,COGS 101C,A01,083625,Delgado; Tania,17,0,35,18
1658027914464,COGS 107A,A01,083627,Boyle; Mary E. T.,14,0,60,46
1658027920487,COGS 118A,A01,083075,Gupta; Anjum,21,0,76,55
1658027926509,CSE 3,A50,083646,Miranda; Gregory Joseph,24,0,50,26
1658027932532,CSE 8A,A50,083650,Miranda; Gregory Joseph,17,1,56,39
1658027938557,CSE 11,A01,083080,Cao; Yingjun,7,15,40,33
1658027944580,CSE 12,A01,083652,Krause-Levy; Sophia Louisa,30,1,120,90
1658027950603,CSE 15L,A01,083654,Morris; Justin Loren,9,0,50,41
1658027950603,CSE 15L,A02,083655,Morris; Justin Loren,11,0,50,39
1658027956698,CSE 20,A01,083657,Tran; Khoa Dang,39,0,80,41
1658027962719,CSE 21,A01,095574,Bach; Quang Tran,23,0,48,25
1658027968750,CSE 30,A01,083084,Eldon; John,8,0,80,72
1658027968750,CSE 30,B01,095061,Bhaskar; Nishant,9,0,50,41
1658027974773,CSE 100,A01,083659,Cao; Yingjun,5,4,70,65
1658027980799,CSE 134B,A01,083661,Powell; Thomas Allan,25,0,100,75
1658027986822,CSE 140,A01,083663,Gungor; Onat,17,0,85,68
1658027992845,CSE 140L,A01,083088,Eldon; John,23,0,100,77
1658027998871,CSE 175,A01,083665,Kumar; Rakesh,3,0,25,22
1658028004894,CSE 190,A00,092507,Dubnov; Shlomo,8,0,20,12
1658028010916,ECE 45,A01,083139,Congero; Spencer William,7,0,75,68
1658028016938,ECE 65,A50,083695,Saad; Andrew S,12,0,30,18
1658028016938,ECE 65,A51,095125,Saad; Andrew S,24,0,26,2
1658028022969,ECE 109,A01,091882,Touri; Behrouz,21,0,70,49
1658028028994,ECE 180,A00,083140,Abi Samra; Nicholas Camill,1,0,30,29
1658028028994,ECE 180,B00,083141,Abi Samra; Nicholas Camill,0,0,30,30
1658028035018,MATH 10A,A01,083735,Patchell; Gregory David,2,0,30,28
1658028035018,MATH 10A,A02,083736,Patchell; Gregory David,20,0,30,10
1658028035018,MATH 10A,A03,083737,Patchell; Gregory David,16,0,30,14
1658028041042,MATH 10B,A01,083207,Lim; Seonhee,9,0,34,25
1658028041042,MATH 10B,A02,083208,Lim; Seonhee,10,0,35,25
1658028041042,MATH 10B,A03,093472,Lim; Seonhee,7,0,34,27
1658028041042,MATH 10B,B01,083739,Sinha; Shubham,14,0,30,16
1658028047073,MATH 18,A01,083743,Cinel; Cameron Alexander,9,0,30,21
1658028047073,MATH 18,A02,083744,Cinel; Cameron Alexander,18,0,30,12
1658028047073,MATH 18,A03,083745,Cinel; Cameron Alexander,10,0,30,20
1658028047073,MATH 18,B01,083748,Rideout; David Porter,5,0,37,32
1658028047073,MATH 18,B02,083749,Rideout; David Porter,5,0,36,31
1658028047073,MATH 18,B03,083750,Rideout; David Porter,3,0,37,34
1658028047073,MATH 18,B04,083751,Rideout; David Porter,7,0,36,29
1658028047073,MATH 18,B05,093473,Rideout; David Porter,7,0,36,29
1658028047073,MATH 18,B06,093474,Rideout; David Porter,6,0,36,30
1658028053095,MATH 20A,A01,083754,Zheng; Zequn,14,0,40,26
1658028059120,MATH 20B,A01,083756,Briones; Jor-el Thomas Caparas,4,0,36,32
1658028059120,MATH 20B,A02,083757,Briones; Jor-el Thomas Caparas,1,0,36,35
1658028059120,MATH 20B,A03,093475,Briones; Jor-el Thomas Caparas,3,0,36,33
1658028065143,MATH 20C,A01,083760,Briones; Jor-el Thomas Caparas,1,0,35,34
1658028065143,MATH 20C,A02,083761,Briones; Jor-el Thomas Caparas,8,0,35,27
1658028065143,MATH 20C,A03,093476,Briones; Jor-el Thomas Caparas,0,1,36,36
1658028065143,MATH 20C,B01,083762,Bach; Quang Tran,1,0,30,29
1658028071171,MATH 20D,A01,083765,Tran; Brian Kha,5,0,30,25
1658028071171,MATH 20D,A02,083766,Tran; Brian Kha,5,0,30,25
1658028071171,MATH 20D,A03,083767,Tran; Brian Kha,6,0,30,24
1658028077200,MATH 20E,A01,083771,Ganguly; Soumya,12,0,32,20
1658028077200,MATH 20E,A02,083772,Ganguly; Soumya,7,0,32,25
1658028077200,MATH 20E,B01,083773,Ciotti; Benjamin,20,0,35,15
1658028077200,MATH 20E,B02,083774,Ciotti; Benjamin,18,0,35,17
1658028083225,MATH 103A,A01,083777,Greenfeld; Be'Eri,6,0,36,30
1658028083225,MATH 103A,A02,083778,Greenfeld; Be'Eri,5,0,36,31
1658028083225,MATH 103A,A03,093561,Greenfeld; Be'Eri,7,0,36,29
1658028083225,MATH 103A,B01,083779,Greenfeld; Be'Eri,8,0,36,28
1658028083225,MATH 103A,B02,083780,Greenfeld; Be'Eri,4,0,36,32
1658028083225,MATH 103A,B03,093562,Greenfeld; Be'Eri,3,0,36,33
1658028089254,MATH 105,A01,085443,Carter; Anne Toulson,15,0,35,20
1658028089254,MATH 105,A02,093477,Carter; Anne Toulson,20,0,35,15
1658028095284,MATH 109,A01,083213,Ganzberger; Geoffrey Michael,3,0,34,31
1658028095284,MATH 109,A02,083214,Ganzberger; Geoffrey Michael,4,0,34,30
1658028095284,MATH 109,A03,093478,Ganzberger; Geoffrey Michael,2,0,34,32
1658028095284,MATH 109,B01,083215,Ganzberger; Geoffrey Michael,3,0,32,29
1658028095284,MATH 109,B02,083216,Ganzberger; Geoffrey Michael,3,0,32,29
1658028095284,MATH 109,B03,093479,Ganzberger; Geoffrey Michael,8,0,32,24
1658028101312,MATH 142A,A01,083219,Chow; Bennett,7,0,32,25
1658028101312,MATH 142A,A02,083220,Chow; Bennett,10,0,32,22
1658028101312,MATH 142A,A03,093480,Chow; Bennett,9,0,32,23
1658028101312,MATH 142A,B03,093481,Chow; Bennett,8,0,32,24
1658028101312,MATH 142A,B04,093558,Chow; Bennett,14,0,32,18
1658028101312,MATH 142A,B05,093559,Chow; Bennett,7,0,32,25
1658028107337,MATH 193A,A01,083224,Rotar; Vladimir,9,0,34,25
1658028107337,MATH 193A,A02,083225,Rotar; Vladimir,11,0,34,23
1658028107337,MATH 193A,A03,083781,Rotar; Vladimir,5,0,34,29
1658028107337,MATH 193A,A04,083782,Rotar; Vladimir,12,0,34,22
1658028107337,MATH 193A,A05,093482,Rotar; Vladimir,11,0,34,23
1658028113360,MATH 197,001,091859,McAuley; Julian John,9999,0,9999,0
1658028113360,MATH 197,002,095566,Kedlaya; Kiran S.,9997,0,9999,2
1658028113360,MATH 197,003,095567,Xiao; Ming,9999,0,9999,0
1658028113360,MATH 197,004,095571,Perols; Johan Lars,9998,0,9999,1
1658028120424,COGS 9,A01,083615,Shannon; Kyle Michael,11,0,75,64
1658028126450,COGS 11,A01,083617,Boyle; Mary E. T.,23,0,48,25
1658028132481,COGS 13,A01,083071,Bastos; Amalia Pinkusfeld,12,0,71,59
1658028138506,COGS 14A,A01,092681,Semenuks; Arturs,5,1,100,95
1658028144532,COGS 14B,A01,083073,Cheng; Tzu-Han,7,0,63,56
1658028150560,COGS 17,A01,092677,Semenuks; Arturs,7,0,81,74
1658028156586,COGS 100,A01,083619,Allen; Michael Gordon,17,0,70,53
1658028162610,COGS 101A,A01,083621,Davis; Joshua Daniel,9,0,68,59
1658028168634,COGS 101B,A01,091572,Allen; Michael Gordon,14,0,65,51
1658028174660,COGS 101C,A01,083625,Delgado; Tania,17,0,35,18
1658028180685,COGS 107A,A01,083627,Boyle; Mary E. T.,14,0,60,46
1658028186708,COGS 118A,A01,083075,Gupta; Anjum,21,0,76,55
1658028192732,CSE 3,A50,083646,Miranda; Gregory Joseph,24,0,50,26
1658028198757,CSE 8A,A50,083650,Miranda; Gregory Joseph,17,1,56,39
1658028204782,CSE 11,A01,083080,Cao; Yingjun,7,15,40,33
1658028210809,CSE 12,A01,083652,Krause-Levy; Sophia Louisa,30,1,120,90
1658028216832,CSE 15L,A01,083654,Morris; Justin Loren,9,0,50,41
1658028216832,CSE 15L,A02,083655,Morris; Justin Loren,11,0,50,39
1658028222859,CSE 20,A01,083657,Tran; Khoa Dang,39,0,80,41
1658028228883,CSE 21,A01,095574,Bach; Quang Tran,23,0,48,25
1658028234906,CSE 30,A01,083084,Eldon; John,8,0,80,72
1658028234906,CSE 30,B01,095061,Bhaskar; Nishant,9,0,50,41
1658028240929,CSE 100,A01,083659,Cao; Yingjun,5,4,70,65
1658028246956,CSE 134B,A01,083661,Powell; Thomas Allan,25,0,100,75
1658028252982,CSE 140,A01,083663,Gungor; Onat,17,0,85,68
1658028259006,CSE 140L,A01,083088,Eldon; John,23,0,100,77
1658028265040,CSE 175,A01,083665,Kumar; Rakesh,3,0,25,22
1658028271074,CSE 190,A00,092507,Dubnov; Shlomo,8,0,20,12
1658028277100,ECE 45,A01,083139,Congero; Spencer William,7,0,75,68
1658028283134,ECE 65,A50,083695,Saad; Andrew S,12,0,30,18
1658028283134,ECE 65,A51,095125,Saad; Andrew S,24,0,26,2
1658028289157,ECE 109,A01,091882,Touri; Behrouz,21,0,70,49
1658028295180,ECE 180,A00,083140,Abi Samra; Nicholas Camill,1,0,30,29
1658028295180,ECE 180,B00,083141,Abi Samra; Nicholas Camill,0,0,30,30
1658028301206,MATH 10A,A01,083735,Patchell; Gregory David,2,0,30,28
1658028301206,MATH 10A,A02,083736,Patchell; Gregory David,20,0,30,10
1658028301206,MATH 10A,A03,083737,Patchell; Gregory David,16,0,30,14
1658028307228,MATH 10B,A01,083207,Lim; Seonhee,9,0,34,25
1658028307228,MATH 10B,A02,083208,Lim; Seonhee,10,0,35,25
1658028307228,MATH 10B,A03,093472,Lim; Seonhee,7,0,34,27
1658028307228,MATH 10B,B01,083739,Sinha; Shubham,14,0,30,16
1658028313252,MATH 18,A01,083743,Cinel; Cameron Alexander,9,0,30,21
1658028313252,MATH 18,A02,083744,Cinel; Cameron Alexander,18,0,30,12
1658028313252,MATH 18,A03,083745,Cinel; Cameron Alexander,10,0,30,20
1658028313252,MATH 18,B01,083748,Rideout; David Porter,5,0,37,32
1658028313252,MATH 18,B02,083749,Rideout; David Porter,5,0,36,31
1658028313252,MATH 18,B03,083750,Rideout; David Porter,3,0,37,34
1658028313252,MATH 18,B04,083751,Rideout; David Porter,7,0,36,29
1658028313252,MATH 18,B05,093473,Rideout; David Porter,7,0,36,29
1658028313252,MATH 18,B06,093474,Rideout; David Porter,6,0,36,30
1658028319278,MATH 20A,A01,083754,Zheng; Zequn,14,0,40,26
1658028325300,MATH 20B,A01,083756,Briones; Jor-el Thomas Caparas,4,0,36,32
1658028325300,MATH 20B,A02,083757,Briones; Jor-el Thomas Caparas,1,0,36,35
1658028325300,MATH 20B,A03,093475,Briones; Jor-el Thomas Caparas,3,0,36,33
1658028331324,MATH 20C,A01,083760,Briones; Jor-el Thomas Caparas,1,0,35,34
1658028331324,MATH 20C,A02,083761,Briones; Jor-el Thomas Caparas,8,0,35,27
1658028331324,MATH 20C,A03,093476,Briones; Jor-el Thomas Caparas,0,1,36,36
1658028331324,MATH 20C,B01,083762,Bach; Quang Tran,1,0,30,29
1658028337349,MATH 20D,A01,083765,Tran; Brian Kha,5,0,30,25
1658028337349,MATH 20D,A02,083766,Tran; Brian Kha,5,0,30,25
1658028337349,MATH 20D,A03,083767,Tran; Brian Kha,6,0,30,24
1658028343377,MATH 20E,A01,083771,Ganguly; Soumya,12,0,32,20
1658028343377,MATH 20E,A02,083772,Ganguly; Soumya,7,0,32,25
1658028343377,MATH 20E,B01,083773,Ciotti; Benjamin,20,0,35,15
1658028343377,MATH 20E,B02,083774,Ciotti; Benjamin,18,0,35,17
1658028349442,MATH 103A,A01,083777,Greenfeld; Be'Eri,6,0,36,30
1658028349442,MATH 103A,A02,083778,Greenfeld; Be'Eri,5,0,36,31
1658028349442,MATH 103A,A03,093561,Greenfeld; Be'Eri,7,0,36,29
1658028349442,MATH 103A,B01,083779,Greenfeld; Be'Eri,8,0,36,28
1658028349442,MATH 103A,B02,083780,Greenfeld; Be'Eri,4,0,36,32
1658028349442,MATH 103A,B03,093562,Greenfeld; Be'Eri,3,0,36,33
1658028355478,MATH 105,A01,085443,Carter; Anne Toulson,15,0,35,20
1658028355478,MATH 105,A02,093477,Carter; Anne Toulson,20,0,35,15
1658028361501,MATH 109,A01,083213,Ganzberger; Geoffrey Michael,3,0,34,31
1658028361501,MATH 109,A02,083214,Ganzberger; Geoffrey Michael,4,0,34,30
1658028361501,MATH 109,A03,093478,Ganzberger; Geoffrey Michael,2,0,34,32
1658028361501,MATH 109,B01,083215,Ganzberger; Geoffrey Michael,3,0,32,29
1658028361501,MATH 109,B02,083216,Ganzberger; Geoffrey Michael,3,0,32,29
1658028361501,MATH 109,B03,093479,Ganzberger; Geoffrey Michael,8,0,32,24
1658028367534,MATH 142A,A01,083219,Chow; Bennett,7,0,32,25
1658028367534,MATH 142A,A02,083220,Chow; Bennett,10,0,32,22
1658028367534,MATH 142A,A03,093480,Chow; Bennett,9,0,32,23
1658028367534,MATH 142A,B03,093481,Chow; Bennett,8,0,32,24
1658028367534,MATH 142A,B04,093558,Chow; Bennett,14,0,32,18
1658028367534,MATH 142A,B05,093559,Chow; Bennett,7,0,32,25
1658028373557,MATH 193A,A01,083224,Rotar; Vladimir,9,0,34,25
1658028373557,MATH 193A,A02,083225,Rotar; Vladimir,11,0,34,23
1658028373557,MATH 193A,A03,083781,Rotar; Vladimir,5,0,34,29
1658028373557,MATH 193A,A04,083782,Rotar; Vladimir,12,0,34,22
1658028373557,MATH 193A,A05,093482,Rotar; Vladimir,11,0,34,23
1658028379583,MATH 197,001,091859,McAuley; Julian John,9999,0,9999,0
1658028379583,MATH 197,002,095566,Kedlaya; Kiran S.,9997,0,9999,2
1658028379583,MATH 197,003,095567,Xiao; Ming,9999,0,9999,0
1658028379583,MATH 197,004,095571,Perols; Johan Lars,9998,0,9999,1
1658028386633,COGS 9,A01,083615,Shannon; Kyle Michael,11,0,75,64
1658028392655,COGS 11,A01,083617,Boyle; Mary E. T.,23,0,48,25
1658028398678,COGS 13,A01,083071,Bastos; Amalia Pinkusfeld,12,0,71,59
1658028404700,COGS 14A,A01,092681,Semenuks; Arturs,5,1,100,95
1658028410724,COGS 14B,A01,083073,Cheng; Tzu-Han,7,0,63,56
1658028416749,COGS 17,A01,092677,Semenuks; Arturs,7,0,81,74
1658028422773,COGS 100,A01,083619,Allen; Michael Gordon,17,0,70,53
1658028428801,COGS 101A,A01,083621,Davis; Joshua Daniel,9,0,68,59
1658028434823,COGS 101B,A01,091572,Allen; Michael Gordon,14,0,65,51
1658028440851,COGS 101C,A01,083625,Delgado; Tania,17,0,35,18
1658028446874,COGS 107A,A01,083627,Boyle; Mary E. T.,14,0,60,46
1658028452906,COGS 118A,A01,083075,Gupta; Anjum,21,0,76,55
1658028458930,CSE 3,A50,083646,Miranda; Gregory Joseph,24,0,50,26
1658028464953,CSE 8A,A50,083650,Miranda; Gregory Joseph,17,1,56,39
1658028470976,CSE 11,A01,083080,Cao; Yingjun,7,15,40,33
1658028476999,CSE 12,A01,083652,Krause-Levy; Sophia Louisa,30,1,120,90
1658028483027,CSE 15L,A01,083654,Morris; Justin Loren,9,0,50,41
1658028483027,CSE 15L,A02,083655,Morris; Justin Loren,11,0,50,39
1658028489054,CSE 20,A01,083657,Tran; Khoa Dang,39,0,80,41
1658028495085,CSE 21,A01,095574,Bach; Quang Tran,23,0,48,25
1658028501112,CSE 30,A01,083084,Eldon; John,8,0,80,72
1658028501112,CSE 30,B01,095061,Bhaskar; Nishant,9,0,50,41
1658028507138,CSE 100,A01,083659,Cao; Yingjun,5,4,70,65
1658028513174,CSE 134B,A01,083661,Powell; Thomas Allan,25,0,100,75
1658028519203,CSE 140,A01,083663,Gungor; Onat,17,0,85,68
1658028525228,CSE 140L,A01,083088,Eldon; John,23,0,100,77
1658028531253,CSE 175,A01,083665,Kumar; Rakesh,3,0,25,22
1658028537281,CSE 190,A00,092507,Dubnov; Shlomo,8,0,20,12
1658028543305,ECE 45,A01,083139,Congero; Spencer William,7,0,75,68
1658028549326,ECE 65,A50,083695,Saad; Andrew S,12,0,30,18
1658028549326,ECE 65,A51,095125,Saad; Andrew S,24,0,26,2
1658028555422,ECE 109,A01,091882,Touri; Behrouz,21,0,70,49
1658028561444,ECE 180,A00,083140,Abi Samra; Nicholas Camill,1,0,30,29
1658028561444,ECE 180,B00,083141,Abi Samra; Nicholas Camill,0,0,30,30
1658028567471,MATH 10A,A01,083735,Patchell; Gregory David,2,0,30,28
1658028567471,MATH 10A,A02,083736,Patchell; Gregory David,20,0,30,10
1658028567471,MATH 10A,A03,083737,Patchell; Gregory David,16,0,30,14
1658028573510,MATH 10B,A01,083207,Lim; Seonhee,9,0,34,25
1658028573510,MATH 10B,A02,083208,Lim; Seonhee,10,0,35,25
1658028573510,MATH 10B,A03,093472,Lim; Seonhee,7,0,34,27
1658028573510,MATH 10B,B01,083739,Sinha; Shubham,14,0,30,16
1658028579539,MATH 18,A01,083743,Cinel; Cameron Alexander,9,0,30,21
1658028579539,MATH 18,A02,083744,Cinel; Cameron Alexander,18,0,30,12
1658028579539,MATH 18,A03,083745,Cinel; Cameron Alexander,10,0,30,20
1658028579539,MATH 18,B01,083748,Rideout; David Porter,5,0,37,32
1658028579539,MATH 18,B02,083749,Rideout; David Porter,5,0,36,31
1658028579539,MATH 18,B03,083750,Rideout; David Porter,3,0,37,34
1658028579539,MATH 18,B04,083751,Rideout; David Porter,7,0,36,29
1658028579539,MATH 18,B05,093473,Rideout; David Porter,7,0,36,29
1658028579539,MATH 18,B06,093474,Rideout; David Porter,6,0,36,30
1658028585560,MATH 20A,A01,083754,Zheng; Zequn,14,0,40,26
1658028591584,MATH 20B,A01,083756,Briones; Jor-el Thomas Caparas,4,0,36,32
1658028591584,MATH 20B,A02,083757,Briones; Jor-el Thomas Caparas,1,0,36,35
1658028591584,MATH 20B,A03,093475,Briones; Jor-el Thomas Caparas,3,0,36,33
1658028597612,MATH 20C,A01,083760,Briones; Jor-el Thomas Caparas,1,0,35,34
1658028597612,MATH 20C,A02,083761,Briones; Jor-el Thomas Caparas,8,0,35,27
1658028597612,MATH 20C,A03,093476,Briones; Jor-el Thomas Caparas,0,1,36,36
1658028597612,MATH 20C,B01,083762,Bach; Quang Tran,1,0,30,29
1658028603640,MATH 20D,A01,083765,Tran; Brian Kha,5,0,30,25
1658028603640,MATH 20D,A02,083766,Tran; Brian Kha,5,0,30,25
1658028603640,MATH 20D,A03,083767,Tran; Brian Kha,6,0,30,24
1658028609668,MATH 20E,A01,083771,Ganguly; Soumya,12,0,32,20
1658028609668,MATH 20E,A02,083772,Ganguly; Soumya,7,0,32,25
1658028609668,MATH 20E,B01,083773,Ciotti; Benjamin,20,0,35,15
1658028609668,MATH 20E,B02,083774,Ciotti; Benjamin,18,0,35,17
1658028615696,MATH 103A,A01,083777,Greenfeld; Be'Eri,6,0,36,30
1658028615696,MATH 103A,A02,083778,Greenfeld; Be'Eri,5,0,36,31
1658028615696,MATH 103A,A03,093561,Greenfeld; Be'Eri,7,0,36,29
1658028615696,MATH 103A,B01,083779,Greenfeld; Be'Eri,8,0,36,28
1658028615696,MATH 103A,B02,083780,Greenfeld; Be'Eri,4,0,36,32
1658028615696,MATH 103A,B03,093562,Greenfeld; Be'Eri,3,0,36,33
1658028621722,MATH 105,A01,085443,Carter; Anne Toulson,15,0,35,20
1658028621722,MATH 105,A02,093477,Carter; Anne Toulson,20,0,35,15
1658028627744,MATH 109,A01,083213,Ganzberger; Geoffrey Michael,3,0,34,31
1658028627744,MATH 109,A02,083214,Ganzberger; Geoffrey Michael,4,0,34,30
1658028627744,MATH 109,A03,093478,Ganzberger; Geoffrey Michael,2,0,34,32
1658028627744,MATH 109,B01,083215,Ganzberger; Geoffrey Michael,3,0,32,29
1658028627744,MATH 109,B02,083216,Ganzberger; Geoffrey Michael,3,0,32,29
1658028627744,MATH 109,B03,093479,Ganzberger; Geoffrey Michael,8,0,32,24
1658028633766,MATH 142A,A01,083219,Chow; Bennett,7,0,32,25
1658028633766,MATH 142A,A02,083220,Chow; Bennett,10,0,32,22
1658028633766,MATH 142A,A03,093480,Chow; Bennett,9,0,32,23
1658028633766,MATH 142A,B03,093481,Chow; Bennett,8,0,32,24
1658028633766,MATH 142A,B04,093558,Chow; Bennett,14,0,32,18
1658028633766,MATH 142A,B05,093559,Chow; Bennett,7,0,32,25
1658028639793,MATH 193A,A01,083224,Rotar; Vladimir,9,0,34,25
1658028639793,MATH 193A,A02,083225,Rotar; Vladimir,11,0,34,23
1658028639793,MATH 193A,A03,083781,Rotar; Vladimir,5,0,34,29
1658028639793,MATH 193A,A04,083782,Rotar; Vladimir,12,0,34,22
1658028639793,MATH 193A,A05,093482,Rotar; Vladimir,11,0,34,23
1658028645815,MATH 197,001,091859,McAuley; Julian John,9999,0,9999,0
1658028645815,MATH 197,002,095566,Kedlaya; Kiran S.,9997,0,9999,2
1658028645815,MATH 197,003,095567,Xiao; Ming,9999,0,9999,0
1658028645815,MATH 197,004,095571,Perols; Johan Lars,9998,0,9999,1
1658028652869,COGS 9,A01,083615,Shannon; Kyle Michael,11,0,75,64
1658028658894,COGS 11,A01,083617,Boyle; Mary E. T.,23,0,48,25
1658028664920,COGS 13,A01,083071,Bastos; Amalia Pinkusfeld,12,0,71,59
1658028670944,COGS 14A,A01,092681,Semenuks; Arturs,5,1,100,95
1658028676970,COGS 14B,A01,083073,Cheng; Tzu-Han,7,0,63,56
1658028682993,COGS 17,A01,092677,Semenuks; Arturs,7,0,81,74
1658028689019,COGS 100,A01,083619,Allen; Michael Gordon,17,0,70,53
1658028695043,COGS 101A,A01,083621,Davis; Joshua Daniel,9,0,68,59
1658028701065,COGS 101B,A01,091572,Allen; Michael Gordon,14,0,65,51
1658028707090,COGS 101C,A01,083625,Delgado; Tania,17,0,35,18
1658028713112,COGS 107A,A01,083627,Boyle; Mary E. T.,14,0,60,46
1658028719134,COGS 118A,A01,083075,Gupta; Anjum,21,0,76,55
1658028725158,CSE 3,A50,083646,Miranda; Gregory Joseph,24,0,50,26
1658028731181,CSE 8A,A50,083650,Miranda; Gregory Joseph,17,1,56,39
1658028737203,CSE 11,A01,083080,Cao; Yingjun,7,15,40,33
1658028743225,CSE 12,A01,083652,Krause-Levy; Sophia Louisa,30,1,120,90
1658028749248,CSE 15L,A01,083654,Morris; Justin Loren,9,0,50,41
1658028749248,CSE 15L,A02,083655,Morris; Justin Loren,11,0,50,39
1658028755273,CSE 20,A01,083657,Tran; Khoa Dang,39,0,80,41
1658028761296,CSE 21,A01,095574,Bach; Quang Tran,23,0,48,25
1658028767322,CSE 30,A01,083084,Eldon; John,8,0,80,72
1658028767322,CSE 30,B01,095061,Bhaskar; Nishant,9,0,50,41
1658028773345,CSE 100,A01,083659,Cao; Yingjun,5,4,70,65
1658028779368,CSE 134B,A01,083661,Powell; Thomas Allan,25,0,100,75
1658028785393,CSE 140,A01,083663,Gungor; Onat,17,0,85,68
1658028791420,CSE 140L,A01,083088,Eldon; John,23,0,100,77
1658028797442,CSE 175,A01,083665,Kumar; Rakesh,3,0,25,22
1658028803464,CSE 190,A00,092507,Dubnov; Shlomo,8,0,20,12
1658028809487,ECE 45,A01,083139,Congero; Spencer William,7,0,75,68
1658028815510,ECE 65,A50,083695,Saad; Andrew S,12,0,30,18
1658028815510,ECE 65,A51,095125,Saad; Andrew S,24,0,26,2
1658028821532,ECE 109,A01,091882,Touri; Behrouz,21,0,70,49
1658028827555,ECE 180,A00,083140,Abi Samra; Nicholas Camill,1,0,30,29
1658028827555,ECE 180,B00,083141,Abi Samra; Nicholas Camill,0,0,30,30
1658028833578,MATH 10A,A01,083735,Patchell; Gregory David,2,0,30,28
1658028833578,MATH 10A,A02,083736,Patchell; Gregory David,20,0,30,10
1658028833578,MATH 10A,A03,083737,Patchell; Gregory David,16,0,30,14
1658028839606,MATH 10B,A01,083207,Lim; Seonhee,9,0,34,25
1658028839606,MATH 10B,A02,083208,Lim; Seonhee,10,0,35,25
1658028839606,MATH 10B,A03,093472,Lim; Seonhee,7,0,34,27
1658028839606,MATH 10B,B01,083739,Sinha; Shubham,14,0,30,16
1658028845631,MATH 18,A01,083743,Cinel; Cameron Alexander,9,0,30,21
1658028845631,MATH 18,A02,083744,Cinel; Cameron Alexander,18,0,30,12
1658028845631,MATH 18,A03,083745,Cinel; Cameron Alexander,10,0,30,20
1658028845631,MATH 18,B01,083748,Rideout; David Porter,5,0,37,32
1658028845631,MATH 18,B02,083749,Rideout; David Porter,5,0,36,31
1658028845631,MATH 18,B03,083750,Rideout; David Porter,3,0,37,34
1658028845631,MATH 18,B04,083751,Rideout; David Porter,7,0,36,29
1658028845631,MATH 18,B05,093473,Rideout; David Porter,7,0,36,29
1658028845631,MATH 18,B06,093474,Rideout; David Porter,6,0,36,30
1658028851655,MATH 20A,A01,083754,Zheng; Zequn,14,0,40,26
1658028857678,MATH 20B,A01,083756,Briones; Jor-el Thomas Caparas,4,0,36,32
1658028857678,MATH 20B,A02,083757,Briones; Jor-el Thomas Caparas,1,0,36,35
1658028857678,MATH 20B,A03,093475,Briones; Jor-el Thomas Caparas,3,0,36,33
1658028863699,MATH 20C,A01,083760,Briones; Jor-el Thomas Caparas,1,0,35,34
1658028863699,MATH 20C,A02,083761,Briones; Jor-el Thomas Caparas,8,0,35,27
1658028863699,MATH 20C,A03,093476,Briones; Jor-el Thomas Caparas,0,1,36,36
1658028863699,MATH 20C,B01,083762,Bach; Quang Tran,1,0,30,29
1658028869722,MATH 20D,A01,083765,Tran; Brian Kha,5,0,30,25
1658028869722,MATH 20D,A02,083766,Tran; Brian Kha,5,0,30,25
1658028869722,MATH 20D,A03,083767,Tran; Brian Kha,6,0,30,24
1658028875746,MATH 20E,A01,083771,Ganguly; Soumya,12,0,32,20
1658028875746,MATH 20E,A02,083772,Ganguly; Soumya,7,0,32,25
1658028875746,MATH 20E,B01,083773,Ciotti; Benjamin,20,0,35,15
1658028875746,MATH 20E,B02,083774,Ciotti; Benjamin,18,0,35,17
1658028881775,MATH 103A,A01,083777,Greenfeld; Be'Eri,6,0,36,30
1658028881775,MATH 103A,A02,083778,Greenfeld; Be'Eri,5,0,36,31
1658028881775,MATH 103A,A03,093561,Greenfeld; Be'Eri,7,0,36,29
1658028881775,MATH 103A,B01,083779,Greenfeld; Be'Eri,8,0,36,28
1658028881775,MATH 103A,B02,083780,Greenfeld; Be'Eri,4,0,36,32
1658028881775,MATH 103A,B03,093562,Greenfeld; Be'Eri,3,0,36,33
1658028887801,MATH 105,A01,085443,Carter; Anne Toulson,15,0,35,20
1658028887801,MATH 105,A02,093477,Carter; Anne Toulson,20,0,35,15
1658028893825,MATH 109,A01,083213,Ganzberger; Geoffrey Michael,3,0,34,31
1658028893825,MATH 109,A02,083214,Ganzberger; Geoffrey Michael,4,0,34,30
1658028893825,MATH 109,A03,093478,Ganzberger; Geoffrey Michael,2,0,34,32
1658028893825,MATH 109,B01,083215,Ganzberger; Geoffrey Michael,3,0,32,29
1658028893825,MATH 109,B02,083216,Ganzberger; Geoffrey Michael,3,0,32,29
1658028893825,MATH 109,B03,093479,Ganzberger; Geoffrey Michael,8,0,32,24
1658028899851,MATH 142A,A01,083219,Chow; Bennett,7,0,32,25
1658028899851,MATH 142A,A02,083220,Chow; Bennett,10,0,32,22
1658028899851,MATH 142A,A03,093480,Chow; Bennett,9,0,32,23
1658028899851,MATH 142A,B03,093481,Chow; Bennett,8,0,32,24
1658028899851,MATH 142A,B04,093558,Chow; Bennett,14,0,32,18
1658028899851,MATH 142A,B05,093559,Chow; Bennett,7,0,32,25
1658028905873,MATH 193A,A01,083224,Rotar; Vladimir,9,0,34,25
1658028905873,MATH 193A,A02,083225,Rotar; Vladimir,11,0,34,23
1658028905873,MATH 193A,A03,083781,Rotar; Vladimir,5,0,34,29
1658028905873,MATH 193A,A04,083782,Rotar; Vladimir,12,0,34,22
1658028905873,MATH 193A,A05,093482,Rotar; Vladimir,11,0,34,23
1658028911902,MATH 197,001,091859,McAuley; Julian John,9999,0,9999,0
1658028911902,MATH 197,002,095566,Kedlaya; Kiran S.,9997,0,9999,2
1658028911902,MATH 197,003,095567,Xiao; Ming,9999,0,9999,0
1658028911902,MATH 197,004,095571,Perols; Johan Lars,9998,0,9999,1
1658028918961,COGS 9,A01,083615,Shannon; Kyle Michael,11,0,75,64
1658028924984,COGS 11,A01,083617,Boyle; Mary E. T.,23,0,48,25
1658028931005,COGS 13,A01,083071,Bastos; Amalia Pinkusfeld,12,0,71,59
1658028937032,COGS 14A,A01,092681,Semenuks; Arturs,5,1,100,95
1658028943058,COGS 14B,A01,083073,Cheng; Tzu-Han,7,0,63,56
1658028949081,COGS 17,A01,092677,Semenuks; Arturs,7,0,81,74
1658028955108,COGS 100,A01,083619,Allen; Michael Gordon,17,0,70,53
1658028961138,COGS 101A,A01,083621,Davis; Joshua Daniel,9,0,68,59
1658028967163,COGS 101B,A01,091572,Allen; Michael Gordon,14,0,65,51
1658028973185,COGS 101C,A01,083625,Delgado; Tania,17,0,35,18
1658028979212,COGS 107A,A01,083627,Boyle; Mary E. T.,14,0,60,46
1658028985238,COGS 118A,A01,083075,Gupta; Anjum,21,0,76,55
1658028991262,CSE 3,A50,083646,Miranda; Gregory Joseph,24,0,50,26
1658028997289,CSE 8A,A50,083650,Miranda; Gregory Joseph,17,1,56,39
1658029003314,CSE 11,A01,083080,Cao; Yingjun,7,15,40,33
1658029009338,CSE 12,A01,083652,Krause-Levy; Sophia Louisa,30,1,120,90
1658029015361,CSE 15L,A01,083654,Morris; Justin Loren,9,0,50,41
1658029015361,CSE 15L,A02,083655,Morris; Justin Loren,11,0,50,39
1658029021383,CSE 20,A01,083657,Tran; Khoa Dang,39,0,80,41
1658029027410,CSE 21,A01,095574,Bach; Quang Tran,23,0,48,25
1658029033433,CSE 30,A01,083084,Eldon; John,8,0,80,72
1658029033433,CSE 30,B01,095061,Bhaskar; Nishant,9,0,50,41
1658029039457,CSE 100,A01,083659,Cao; Yingjun,5,4,70,65
1658029045480,CSE 134B,A01,083661,Powell; Thomas Allan,25,0,100,75
1658029051506,CSE 140,A01,083663,Gungor; Onat,17,0,85,68
1658029057529,CSE 140L,A01,083088,Eldon; John,23,0,100,77
1658029063553,CSE 175,A01,083665,Kumar; Rakesh,3,0,25,22
1658029069574,CSE 190,A00,092507,Dubnov; Shlomo,8,0,20,12
1658029075601,ECE 45,A01,083139,Congero; Spencer William,7,0,75,68
1658029081624,ECE 65,A50,083695,Saad; Andrew S,12,0,30,18
1658029081624,ECE 65,A51,095125,Saad; Andrew S,24,0,26,2
1658029087646,ECE 109,A01,091882,Touri; Behrouz,21,0,70,49
1658029093669,ECE 180,A00,083140,Abi Samra; Nicholas Camill,1,0,30,29
1658029093669,ECE 180,B00,083141,Abi Samra; Nicholas Camill,0,0,30,30
1658029099692,MATH 10A,A01,083735,Patchell; Gregory David,2,0,30,28
1658029099692,MATH 10A,A02,083736,Patchell; Gregory David,20,0,30,10
1658029099692,MATH 10A,A03,083737,Patchell; Gregory David,16,0,30,14
1658029105715,MATH 10B,A01,083207,Lim; Seonhee,9,0,34,25
1658029105715,MATH 10B,A02,083208,Lim; Seonhee,10,0,35,25
1658029105715,MATH 10B,A03,093472,Lim; Seonhee,7,0,34,27
1658029105715,MATH 10B,B01,083739,Sinha; Shubham,14,0,30,16
1658029111744,MATH 18,A01,083743,Cinel; Cameron Alexander,9,0,30,21
1658029111744,MATH 18,A02,083744,Cinel; Cameron Alexander,18,0,30,12
1658029111744,MATH 18,A03,083745,Cinel; Cameron Alexander,10,0,30,20
1658029111744,MATH 18,B01,083748,Rideout; David Porter,5,0,37,32
1658029111744,MATH 18,B02,083749,Rideout; David Porter,5,0,36,31
1658029111744,MATH 18,B03,083750,Rideout; David Porter,3,0,37,34
1658029111744,MATH 18,B04,083751,Rideout; David Porter,7,0,36,29
1658029111744,MATH 18,B05,093473,Rideout; David Porter,7,0,36,29
1658029111744,MATH 18,B06,093474,Rideout; David Porter,6,0,36,30
1658029117765,MATH 20A,A01,083754,Zheng; Zequn,14,0,40,26
1658029123792,MATH 20B,A01,083756,Briones; Jor-el Thomas Caparas,4,0,36,32
1658029123792,MATH 20B,A02,083757,Briones; Jor-el Thomas Caparas,1,0,36,35
1658029123792,MATH 20B,A03,093475,Briones; Jor-el Thomas Caparas,3,0,36,33
1658029129819,MATH 20C,A01,083760,Briones; Jor-el Thomas Caparas,1,0,35,34
1658029129819,MATH 20C,A02,083761,Briones; Jor-el Thomas Caparas,8,0,35,27
1658029129819,MATH 20C,A03,093476,Briones; Jor-el Thomas Caparas,0,1,36,36
1658029129819,MATH 20C,B01,083762,Bach; Quang Tran,1,0,30,29
1658029135843,MATH 20D,A01,083765,Tran; Brian Kha,5,0,30,25
1658029135843,MATH 20D,A02,083766,Tran; Brian Kha,5,0,30,25
1658029135843,MATH 20D,A03,083767,Tran; Brian Kha,6,0,30,24
1658029141867,MATH 20E,A01,083771,Ganguly; Soumya,12,0,32,20
1658029141867,MATH 20E,A02,083772,Ganguly; Soumya,7,0,32,25
1658029141867,MATH 20E,B01,083773,Ciotti; Benjamin,20,0,35,15
1658029141867,MATH 20E,B02,083774,Ciotti; Benjamin,18,0,35,17
1658029147892,MATH 103A,A01,083777,Greenfeld; Be'Eri,6,0,36,30
1658029147892,MATH 103A,A02,083778,Greenfeld; Be'Eri,5,0,36,31
1658029147892,MATH 103A,A03,093561,Greenfeld; Be'Eri,7,0,36,29
1658029147892,MATH 103A,B01,083779,Greenfeld; Be'Eri,8,0,36,28
1658029147892,MATH 103A,B02,083780,Greenfeld; Be'Eri,4,0,36,32
1658029147892,MATH 103A,B03,093562,Greenfeld; Be'Eri,3,0,36,33
1658029153985,MATH 105,A01,085443,Carter; Anne Toulson,15,0,35,20
1658029153985,MATH 105,A02,093477,Carter; Anne Toulson,20,0,35,15
1658029160009,MATH 109,A01,083213,Ganzberger; Geoffrey Michael,3,0,34,31
1658029160009,MATH 109,A02,083214,Ganzberger; Geoffrey Michael,4,0,34,30
1658029160009,MATH 109,A03,093478,Ganzberger; Geoffrey Michael,2,0,34,32
1658029160009,MATH 109,B01,083215,Ganzberger; Geoffrey Michael,3,0,32,29
1658029160009,MATH 109,B02,083216,Ganzberger; Geoffrey Michael,3,0,32,29
1658029160009,MATH 109,B03,093479,Ganzberger; Geoffrey Michael,8,0,32,24
1658029166032,MATH 142A,A01,083219,Chow; Bennett,7,0,32,25
1658029166032,MATH 142A,A02,083220,Chow; Bennett,10,0,32,22
1658029166032,MATH 142A,A03,093480,Chow; Bennett,9,0,32,23
1658029166032,MATH 142A,B03,093481,Chow; Bennett,8,0,32,24
1658029166032,MATH 142A,B04,093558,Chow; Bennett,14,0,32,18
1658029166032,MATH 142A,B05,093559,Chow; Bennett,7,0,32,25
1658029172059,MATH 193A,A01,083224,Rotar; Vladimir,9,0,34,25
1658029172059,MATH 193A,A02,083225,Rotar; Vladimir,11,0,34,23
1658029172059,MATH 193A,A03,083781,Rotar; Vladimir,5,0,34,29
1658029172059,MATH 193A,A04,083782,Rotar; Vladimir,12,0,34,22
1658029172059,MATH 193A,A05,093482,Rotar; Vladimir,11,0,34,23
1658029178081,MATH 197,001,091859,McAuley; Julian John,9999,0,9999,0
1658029178081,MATH 197,002,095566,Kedlaya; Kiran S.,9997,0,9999,2
1658029178081,MATH 197,003,095567,Xiao; Ming,9999,0,9999,0
1658029178081,MATH 197,004,095571,Perols; Johan Lars,9998,0,9999,1
1658029185133,COGS 9,A01,083615,Shannon; Kyle Michael,11,0,75,64
1658029191155,COGS 11,A01,083617,Boyle; Mary E. T.,23,0,48,25
1658029197181,COGS 13,A01,083071,Bastos; Amalia Pinkusfeld,12,0,71,59
1658029203208,COGS 14A,A01,092681,Semenuks; Arturs,5,1,100,95
1658029209230,COGS 14B,A01,083073,Cheng; Tzu-Han,7,0,63,56
1658029215252,COGS 17,A01,092677,Semenuks; Arturs,7,0,81,74
1658029221274,COGS 100,A01,083619,Allen; Michael Gordon,17,0,70,53
1658029227297,COGS 101A,A01,083621,Davis; Joshua Daniel,9,0,68,59
1658029233324,COGS 101B,A01,091572,Allen; Michael Gordon,14,0,65,51
1658029239350,COGS 101C,A01,083625,Delgado; Tania,17,0,35,18
1658029245373,COGS 107A,A01,083627,Boyle; Mary E. T.,14,0,60,46
1658029251397,COGS 118A,A01,083075,Gupta; Anjum,21,0,76,55
1658029257424,CSE 3,A50,083646,Miranda; Gregory Joseph,24,0,50,26
1658029263460,CSE 8A,A50,083650,Miranda; Gregory Joseph,17,1,56,39
1658029269487,CSE 11,A01,083080,Cao; Yingjun,7,15,40,33
1658029275509,CSE 12,A01,083652,Krause-Levy; Sophia Louisa,30,1,120,90
1658029281532,CSE 15L,A01,083654,Morris; Justin Loren,9,0,50,41
1658029281532,CSE 15L,A02,083655,Morris; Justin Loren,11,0,50,39
1658029287554,CSE 20,A01,083657,Tran; Khoa Dang,39,0,80,41
1658029293577,CSE 21,A01,095574,Bach; Quang Tran,23,0,48,25
1658029299605,CSE 30,A01,083084,Eldon; John,8,0,80,72
1658029299605,CSE 30,B01,095061,Bhaskar; Nishant,9,0,50,41
1658029305629,CSE 100,A01,083659,Cao; Yingjun,5,4,70,65
1658029311653,CSE 134B,A01,083661,Powell; Thomas Allan,25,0,100,75
1658029317679,CSE 140,A01,083663,Gungor; Onat,17,0,85,68
1658029323704,CSE 140L,A01,083088,Eldon; John,23,0,100,77
1658029329730,CSE 175,A01,083665,Kumar; Rakesh,3,0,25,22
1658029335756,CSE 190,A00,092507,Dubnov; Shlomo,8,0,20,12
1658029341786,ECE 45,A01,083139,Congero; Spencer William,7,0,75,68
1658029347809,ECE 65,A50,083695,Saad; Andrew S,12,0,30,18
1658029347809,ECE 65,A51,095125,Saad; Andrew S,24,0,26,2
1658029353831,ECE 109,A01,091882,Touri; Behrouz,21,0,70,49
1658029359853,ECE 180,A00,083140,Abi Samra; Nicholas Camill,1,0,30,29
1658029359853,ECE 180,B00,083141,Abi Samra; Nicholas Camill,0,0,30,30
1658029365880,MATH 10A,A01,083735,Patchell; Gregory David,2,0,30,28
1658029365880,MATH 10A,A02,083736,Patchell; Gregory David,20,0,30,10
1658029365880,MATH 10A,A03,083737,Patchell; Gregory David,16,0,30,14
1658029371907,MATH 10B,A01,083207,Lim; Seonhee,9,0,34,25
1658029371907,MATH 10B,A02,083208,Lim; Seonhee,10,0,35,25
1658029371907,MATH 10B,A03,093472,Lim; Seonhee,7,0,34,27
1658029371907,MATH 10B,B01,083739,Sinha; Shubham,14,0,30,16
1658029377931,MATH 18,A01,083743,Cinel; Cameron Alexander,9,0,30,21
1658029377931,MATH 18,A02,083744,Cinel; Cameron Alexander,18,0,30,12
1658029377931,MATH 18,A03,083745,Cinel; Cameron Alexander,10,0,30,20
1658029377931,MATH 18,B01,083748,Rideout; David Porter,5,0,37,32
1658029377931,MATH 18,B02,083749,Rideout; David Porter,5,0,36,31
1658029377931,MATH 18,B03,083750,Rideout; David Porter,3,0,37,34
1658029377931,MATH 18,B04,083751,Rideout; David Porter,7,0,36,29
1658029377931,MATH 18,B05,093473,Rideout; David Porter,7,0,36,29
1658029377931,MATH 18,B06,093474,Rideout; David Porter,6,0,36,30
1658029383957,MATH 20A,A01,083754,Zheng; Zequn,14,0,40,26
1658029389980,MATH 20B,A01,083756,Briones; Jor-el Thomas Caparas,4,0,36,32
1658029389980,MATH 20B,A02,083757,Briones; Jor-el Thomas Caparas,1,0,36,35
1658029389980,MATH 20B,A03,093475,Briones; Jor-el Thomas Caparas,3,0,36,33
1658029396005,MATH 20C,A01,083760,Briones; Jor-el Thomas Caparas,1,0,35,34
1658029396005,MATH 20C,A02,083761,Briones; Jor-el Thomas Caparas,8,0,35,27
1658029396005,MATH 20C,A03,093476,Briones; Jor-el Thomas Caparas,0,1,36,36
1658029396005,MATH 20C,B01,083762,Bach; Quang Tran,1,0,30,29
1658029402030,MATH 20D,A01,083765,Tran; Brian Kha,5,0,30,25
1658029402030,MATH 20D,A02,083766,Tran; Brian Kha,5,0,30,25
1658029402030,MATH 20D,A03,083767,Tran; Brian Kha,6,0,30,24
1658029408059,MATH 20E,A01,083771,Ganguly; Soumya,12,0,32,20
1658029408059,MATH 20E,A02,083772,Ganguly; Soumya,7,0,32,25
1658029408059,MATH 20E,B01,083773,Ciotti; Benjamin,20,0,35,15
1658029408059,MATH 20E,B02,083774,Ciotti; Benjamin,18,0,35,17
1658029414088,MATH 103A,A01,083777,Greenfeld; Be'Eri,6,0,36,30
1658029414088,MATH 103A,A02,083778,Greenfeld; Be'Eri,5,0,36,31
1658029414088,MATH 103A,A03,093561,Greenfeld; Be'Eri,7,0,36,29
1658029414088,MATH 103A,B01,083779,Greenfeld; Be'Eri,8,0,36,28
1658029414088,MATH 103A,B02,083780,Greenfeld; Be'Eri,4,0,36,32
1658029414088,MATH 103A,B03,093562,Greenfeld; Be'Eri,3,0,36,33
1658029420111,MATH 105,A01,085443,Carter; Anne Toulson,15,0,35,20
1658029420111,MATH 105,A02,093477,Carter; Anne Toulson,20,0,35,15
1658029426140,MATH 109,A01,083213,Ganzberger; Geoffrey Michael,3,0,34,31
1658029426140,MATH 109,A02,083214,Ganzberger; Geoffrey Michael,4,0,34,30
1658029426140,MATH 109,A03,093478,Ganzberger; Geoffrey Michael,2,0,34,32
1658029426140,MATH 109,B01,083215,Ganzberger; Geoffrey Michael,3,0,32,29
1658029426140,MATH 109,B02,083216,Ganzberger; Geoffrey Michael,3,0,32,29
1658029426140,MATH 109,B03,093479,Ganzberger; Geoffrey Michael,8,0,32,24
1658029432170,MATH 142A,A01,083219,Chow; Bennett,7,0,32,25
1658029432170,MATH 142A,A02,083220,Chow; Bennett,10,0,32,22
1658029432170,MATH 142A,A03,093480,Chow; Bennett,9,0,32,23
1658029432170,MATH 142A,B03,093481,Chow; Bennett,8,0,32,24
1658029432170,MATH 142A,B04,093558,Chow; Bennett,14,0,32,18
1658029432170,MATH 142A,B05,093559,Chow; Bennett,7,0,32,25
1658029438193,MATH 193A,A01,083224,Rotar; Vladimir,9,0,34,25
1658029438193,MATH 193A,A02,083225,Rotar; Vladimir,11,0,34,23
1658029438193,MATH 193A,A03,083781,Rotar; Vladimir,5,0,34,29
1658029438193,MATH 193A,A04,083782,Rotar; Vladimir,12,0,34,22
1658029438193,MATH 193A,A05,093482,Rotar; Vladimir,11,0,34,23
1658029444217,MATH 197,001,091859,McAuley; Julian John,9999,0,9999,0
1658029444217,MATH 197,002,095566,Kedlaya; Kiran S.,9997,0,9999,2
1658029444217,MATH 197,003,095567,Xiao; Ming,9999,0,9999,0
1658029444217,MATH 197,004,095571,Perols; Johan Lars,9998,0,9999,1
1658029451272,COGS 9,A01,083615,Shannon; Kyle Michael,11,0,75,64
1658029457295,COGS 11,A01,083617,Boyle; Mary E. T.,23,0,48,25
1658029463320,COGS 13,A01,083071,Bastos; Amalia Pinkusfeld,12,0,71,59
1658029469364,COGS 14A,A01,092681,Semenuks; Arturs,5,1,100,95
1658029475387,COGS 14B,A01,083073,Cheng; Tzu-Han,7,0,63,56
1658029481413,COGS 17,A01,092677,Semenuks; Arturs,7,0,81,74
1658029487437,COGS 100,A01,083619,Allen; Michael Gordon,17,0,70,53
1658029493460,COGS 101A,A01,083621,Davis; Joshua Daniel,9,0,68,59
1658029499485,COGS 101B,A01,091572,Allen; Michael Gordon,14,0,65,51
1658029505509,COGS 101C,A01,083625,Delgado; Tania,17,0,35,18
1658029511535,COGS 107A,A01,083627,Boyle; Mary E. T.,14,0,60,46
1658029517558,COGS 118A,A01,083075,Gupta; Anjum,21,0,76,55
1658029523586,CSE 3,A50,083646,Miranda; Gregory Joseph,24,0,50,26
1658029529611,CSE 8A,A50,083650,Miranda; Gregory Joseph,17,1,56,39
1658029535637,CSE 11,A01,083080,Cao; Yingjun,7,15,40,33
1658029541664,CSE 12,A01,083652,Krause-Levy; Sophia Louisa,30,1,120,90
1658029547695,CSE 15L,A01,083654,Morris; Justin Loren,9,0,50,41
1658029547695,CSE 15L,A02,083655,Morris; Justin Loren,11,0,50,39
1658029553718,CSE 20,A01,083657,Tran; Khoa Dang,39,0,80,41
1658029559763,CSE 21,A01,095574,Bach; Quang Tran,23,0,48,25
1658029565787,CSE 30,A01,083084,Eldon; John,8,0,80,72
1658029565787,CSE 30,B01,095061,Bhaskar; Nishant,9,0,50,41
1658029571814,CSE 100,A01,083659,Cao; Yingjun,5,4,70,65
1658029577838,CSE 134B,A01,083661,Powell; Thomas Allan,25,0,100,75
1658029583863,CSE 140,A01,083663,Gungor; Onat,17,0,85,68
1658029589887,CSE 140L,A01,083088,Eldon; John,23,0,100,77
1658029595913,CSE 175,A01,083665,Kumar; Rakesh,3,0,25,22
1658029601940,CSE 190,A00,092507,Dubnov; Shlomo,8,0,20,12
1658029607964,ECE 45,A01,083139,Congero; Spencer William,7,0,75,68
1658029613987,ECE 65,A50,083695,Saad; Andrew S,12,0,30,18
1658029613987,ECE 65,A51,095125,Saad; Andrew S,24,0,26,2
1658029620012,ECE 109,A01,091882,Touri; Behrouz,21,0,70,49
1658029626041,ECE 180,A00,083140,Abi Samra; Nicholas Camill,1,0,30,29
1658029626041,ECE 180,B00,083141,Abi Samra; Nicholas Camill,0,0,30,30
1658029632070,MATH 10A,A01,083735,Patchell; Gregory David,2,0,30,28
1658029632070,MATH 10A,A02,083736,Patchell; Gregory David,20,0,30,10
1658029632070,MATH 10A,A03,083737,Patchell; Gregory David,16,0,30,14
1658029638096,MATH 10B,A01,083207,Lim; Seonhee,9,0,34,25
1658029638096,MATH 10B,A02,083208,Lim; Seonhee,10,0,35,25
1658029638096,MATH 10B,A03,093472,Lim; Seonhee,7,0,34,27
1658029638096,MATH 10B,B01,083739,Sinha; Shubham,14,0,30,16
1658029644120,MATH 18,A01,083743,Cinel; Cameron Alexander,9,0,30,21
1658029644120,MATH 18,A02,083744,Cinel; Cameron Alexander,18,0,30,12
1658029644120,MATH 18,A03,083745,Cinel; Cameron Alexander,10,0,30,20
1658029644120,MATH 18,B01,083748,Rideout; David Porter,5,0,37,32
1658029644120,MATH 18,B02,083749,Rideout; David Porter,5,0,36,31
1658029644120,MATH 18,B03,083750,Rideout; David Porter,3,0,37,34
1658029644120,MATH 18,B04,083751,Rideout; David Porter,7,0,36,29
1658029644120,MATH 18,B05,093473,Rideout; David Porter,7,0,36,29
1658029644120,MATH 18,B06,093474,Rideout; David Porter,6,0,36,30
1658029650143,MATH 20A,A01,083754,Zheng; Zequn,14,0,40,26
1658029656166,MATH 20B,A01,083756,Briones; Jor-el Thomas Caparas,4,0,36,32
1658029656166,MATH 20B,A02,083757,Briones; Jor-el Thomas Caparas,1,0,36,35
1658029656166,MATH 20B,A03,093475,Briones; Jor-el Thomas Caparas,3,0,36,33
1658029662193,MATH 20C,A01,083760,Briones; Jor-el Thomas Caparas,1,0,35,34
1658029662193,MATH 20C,A02,083761,Briones; Jor-el Thomas Caparas,8,0,35,27
1658029662193,MATH 20C,A03,093476,Briones; Jor-el Thomas Caparas,0,1,36,36
1658029662193,MATH 20C,B01,083762,Bach; Quang Tran,1,0,30,29
1658029668215,MATH 20D,A01,083765,Tran; Brian Kha,5,0,30,25
1658029668215,MATH 20D,A02,083766,Tran; Brian Kha,5,0,30,25
1658029668215,MATH 20D,A03,083767,Tran; Brian Kha,6,0,30,24
1658029674242,MATH 20E,A01,083771,Ganguly; Soumya,12,0,32,20
1658029674242,MATH 20E,A02,083772,Ganguly; Soumya,7,0,32,25
1658029674242,MATH 20E,B01,083773,Ciotti; Benjamin,20,0,35,15
1658029674242,MATH 20E,B02,083774,Ciotti; Benjamin,18,0,35,17
1658029680287,MATH 103A,A01,083777,Greenfeld; Be'Eri,6,0,36,30
1658029680287,MATH 103A,A02,083778,Greenfeld; Be'Eri,5,0,36,31
1658029680287,MATH 103A,A03,093561,Greenfeld; Be'Eri,7,0,36,29
1658029680287,MATH 103A,B01,083779,Greenfeld; Be'Eri,8,0,36,28
1658029680287,MATH 103A,B02,083780,Greenfeld; Be'Eri,4,0,36,32
1658029680287,MATH 103A,B03,093562,Greenfeld; Be'Eri,3,0,36,33
1658029686311,MATH 105,A01,085443,Carter; Anne Toulson,15,0,35,20
1658029686311,MATH 105,A02,093477,Carter; Anne Toulson,20,0,35,15
1658029692335,MATH 109,A01,083213,Ganzberger; Geoffrey Michael,3,0,34,31
1658029692335,MATH 109,A02,083214,Ganzberger; Geoffrey Michael,4,0,34,30
1658029692335,MATH 109,A03,093478,Ganzberger; Geoffrey Michael,2,0,34,32
1658029692335,MATH 109,B01,083215,Ganzberger; Geoffrey Michael,3,0,32,29
1658029692335,MATH 109,B02,083216,Ganzberger; Geoffrey Michael,3,0,32,29
1658029692335,MATH 109,B03,093479,Ganzberger; Geoffrey Michael,8,0,32,24
1658029698364,MATH 142A,A01,083219,Chow; Bennett,7,0,32,25
1658029698364,MATH 142A,A02,083220,Chow; Bennett,10,0,32,22
1658029698364,MATH 142A,A03,093480,Chow; Bennett,9,0,32,23
1658029698364,MATH 142A,B03,093481,Chow; Bennett,8,0,32,24
1658029698364,MATH 142A,B04,093558,Chow; Bennett,14,0,32,18
1658029698364,MATH 142A,B05,093559,Chow; Bennett,7,0,32,25
1658029704392,MATH 193A,A01,083224,Rotar; Vladimir,9,0,34,25
1658029704392,MATH 193A,A02,083225,Rotar; Vladimir,11,0,34,23
1658029704392,MATH 193A,A03,083781,Rotar; Vladimir,5,0,34,29
1658029704392,MATH 193A,A04,083782,Rotar; Vladimir,12,0,34,22
1658029704392,MATH 193A,A05,093482,Rotar; Vladimir,11,0,34,23
1658029710415,MATH 197,001,091859,McAuley; Julian John,9999,0,9999,0
1658029710415,MATH 197,002,095566,Kedlaya; Kiran S.,9997,0,9999,2
1658029710415,MATH 197,003,095567,Xiao; Ming,9999,0,9999,0
1658029710415,MATH 197,004,095571,Perols; Johan Lars,9998,0,9999,1
1658029717469,COGS 9,A01,083615,Shannon; Kyle Michael,11,0,75,64
1658029723495,COGS 11,A01,083617,Boyle; Mary E. T.,23,0,48,25
1658029729518,COGS 13,A01,083071,Bastos; Amalia Pinkusfeld,12,0,71,59
1658029735542,COGS 14A,A01,092681,Semenuks; Arturs,5,1,100,95
1658029741565,COGS 14B,A01,083073,Cheng; Tzu-Han,7,0,63,56
1658029747663,COGS 17,A01,092677,Semenuks; Arturs,7,0,81,74
1658029753689,COGS 100,A01,083619,Allen; Michael Gordon,17,0,70,53
1658029759716,COGS 101A,A01,083621,Davis; Joshua Daniel,9,0,68,59
1658029765751,COGS 101B,A01,091572,Allen; Michael Gordon,14,0,65,51
1658029771774,COGS 101C,A01,083625,Delgado; Tania,17,0,35,18
1658029777796,COGS 107A,A01,083627,Boyle; Mary E. T.,14,0,60,46
1658029783819,COGS 118A,A01,083075,Gupta; Anjum,21,0,76,55
1658029789843,CSE 3,A50,083646,Miranda; Gregory Joseph,24,0,50,26
1658029795867,CSE 8A,A50,083650,Miranda; Gregory Joseph,17,1,56,39
1658029801890,CSE 11,A01,083080,Cao; Yingjun,7,15,40,33
1658029807913,CSE 12,A01,083652,Krause-Levy; Sophia Louisa,30,1,120,90
1658029813935,CSE 15L,A01,083654,Morris; Justin Loren,9,0,50,41
1658029813935,CSE 15L,A02,083655,Morris; Justin Loren,11,0,50,39
1658029819964,CSE 20,A01,083657,Tran; Khoa Dang,39,0,80,41
1658029825992,CSE 21,A01,095574,Bach; Quang Tran,23,0,48,25
1658029832018,CSE 30,A01,083084,Eldon; John,8,0,80,72
1658029832018,CSE 30,B01,095061,Bhaskar; Nishant,9,0,50,41
1658029838040,CSE 100,A01,083659,Cao; Yingjun,5,4,70,65
1658029844063,CSE 134B,A01,083661,Powell; Thomas Allan,25,0,100,75
1658029850084,CSE 140,A01,083663,Gungor; Onat,17,0,85,68
1658029856109,CSE 140L,A01,083088,Eldon; John,23,0,100,77
1658029862132,CSE 175,A01,083665,Kumar; Rakesh,3,0,25,22
1658029868153,CSE 190,A00,092507,Dubnov; Shlomo,8,0,20,12
1658029874183,ECE 45,A01,083139,Congero; Spencer William,7,0,75,68
1658029880206,ECE 65,A50,083695,Saad; Andrew S,12,0,30,18
1658029880206,ECE 65,A51,095125,Saad; Andrew S,24,0,26,2
1658029886233,ECE 109,A01,091882,Touri; Behrouz,21,0,70,49
1658029892256,ECE 180,A00,083140,Abi Samra; Nicholas Camill,1,0,30,29
1658029892256,ECE 180,B00,083141,Abi Samra; Nicholas Camill,0,0,30,30
1658029898288,MATH 10A,A01,083735,Patchell; Gregory David,2,0,30,28
1658029898288,MATH 10A,A02,083736,Patchell; Gregory David,20,0,30,10
1658029898288,MATH 10A,A03,083737,Patchell; Gregory David,16,0,30,14
1658029904313,MATH 10B,A01,083207,Lim; Seonhee,9,0,34,25
1658029904313,MATH 10B,A02,083208,Lim; Seonhee,10,0,35,25
1658029904313,MATH 10B,A03,093472,Lim; Seonhee,7,0,34,27
1658029904313,MATH 10B,B01,083739,Sinha; Shubham,14,0,30,16
1658029910345,MATH 18,A01,083743,Cinel; Cameron Alexander,9,0,30,21
1658029910345,MATH 18,A02,083744,Cinel; Cameron Alexander,18,0,30,12
1658029910345,MATH 18,A03,083745,Cinel; Cameron Alexander,10,0,30,20
1658029910345,MATH 18,B01,083748,Rideout; David Porter,5,0,37,32
1658029910345,MATH 18,B02,083749,Rideout; David Porter,5,0,36,31
1658029910345,MATH 18,B03,083750,Rideout; David Porter,3,0,37,34
1658029910345,MATH 18,B04,083751,Rideout; David Porter,7,0,36,29
1658029910345,MATH 18,B05,093473,Rideout; David Porter,7,0,36,29
1658029910345,MATH 18,B06,093474,Rideout; David Porter,6,0,36,30
1658029916368,MATH 20A,A01,083754,Zheng; Zequn,14,0,40,26
1658029922393,MATH 20B,A01,083756,Briones; Jor-el Thomas Caparas,4,0,36,32
1658029922393,MATH 20B,A02,083757,Briones; Jor-el Thomas Caparas,1,0,36,35
1658029922393,MATH 20B,A03,093475,Briones; Jor-el Thomas Caparas,3,0,36,33
1658029928421,MATH 20C,A01,083760,Briones; Jor-el Thomas Caparas,1,0,35,34
1658029928421,MATH 20C,A02,083761,Briones; Jor-el Thomas Caparas,8,0,35,27
1658029928421,MATH 20C,A03,093476,Briones; Jor-el Thomas Caparas,0,1,36,36
1658029928421,MATH 20C,B01,083762,Bach; Quang Tran,1,0,30,29
1658029934445,MATH 20D,A01,083765,Tran; Brian Kha,5,0,30,25
1658029934445,MATH 20D,A02,083766,Tran; Brian Kha,5,0,30,25
1658029934445,MATH 20D,A03,083767,Tran; Brian Kha,6,0,30,24
1658029940469,MATH 20E,A01,083771,Ganguly; Soumya,12,0,32,20
1658029940469,MATH 20E,A02,083772,Ganguly; Soumya,7,0,32,25
1658029940469,MATH 20E,B01,083773,Ciotti; Benjamin,20,0,35,15
1658029940469,MATH 20E,B02,083774,Ciotti; Benjamin,18,0,35,17
1658029946493,MATH 103A,A01,083777,Greenfeld; Be'Eri,6,0,36,30
1658029946493,MATH 103A,A02,083778,Greenfeld; Be'Eri,5,0,36,31
1658029946493,MATH 103A,A03,093561,Greenfeld; Be'Eri,7,0,36,29
1658029946493,MATH 103A,B01,083779,Greenfeld; Be'Eri,8,0,36,28
1658029946493,MATH 103A,B02,083780,Greenfeld; Be'Eri,4,0,36,32
1658029946493,MATH 103A,B03,093562,Greenfeld; Be'Eri,3,0,36,33
1658029952515,MATH 105,A01,085443,Carter; Anne Toulson,15,0,35,20
1658029952515,MATH 105,A02,093477,Carter; Anne Toulson,20,0,35,15
1658029965423,MATH 109,A01,083213,Ganzberger; Geoffrey Michael,3,0,34,31
1658029965423,MATH 109,A02,083214,Ganzberger; Geoffrey Michael,4,0,34,30
1658029965423,MATH 109,A03,093478,Ganzberger; Geoffrey Michael,2,0,34,32
1658029965423,MATH 109,B01,083215,Ganzberger; Geoffrey Michael,3,0,32,29
1658029965423,MATH 109,B02,083216,Ganzberger; Geoffrey Michael,3,0,32,29
1658029965423,MATH 109,B03,093479,Ganzberger; Geoffrey Michael,8,0,32,24
1658029971452,MATH 142A,A01,083219,Chow; Bennett,7,0,32,25
1658029971452,MATH 142A,A02,083220,Chow; Bennett,10,0,32,22
1658029971452,MATH 142A,A03,093480,Chow; Bennett,9,0,32,23
1658029971452,MATH 142A,B03,093481,Chow; Bennett,8,0,32,24
1658029971452,MATH 142A,B04,093558,Chow; Bennett,14,0,32,18
1658029971452,MATH 142A,B05,093559,Chow; Bennett,7,0,32,25
1658029977476,MATH 193A,A01,083224,Rotar; Vladimir,9,0,34,25
1658029977476,MATH 193A,A02,083225,Rotar; Vladimir,11,0,34,23
1658029977476,MATH 193A,A03,083781,Rotar; Vladimir,5,0,34,29
1658029977476,MATH 193A,A04,083782,Rotar; Vladimir,12,0,34,22
1658029977476,MATH 193A,A05,093482,Rotar; Vladimir,11,0,34,23
1658029983500,MATH 197,001,091859,McAuley; Julian John,9999,0,9999,0
1658029983500,MATH 197,002,095566,Kedlaya; Kiran S.,9997,0,9999,2
1658029983500,MATH 197,003,095567,Xiao; Ming,9999,0,9999,0
1658029983500,MATH 197,004,095571,Perols; Johan Lars,9998,0,9999,1
1658029990548,COGS 9,A01,083615,Shannon; Kyle Michael,11,0,75,64
1658029996574,COGS 11,A01,083617,Boyle; Mary E. T.,23,0,48,25
1658030002599,COGS 13,A01,083071,Bastos; Amalia Pinkusfeld,12,0,71,59
1658030008623,COGS 14A,A01,092681,Semenuks; Arturs,5,1,100,95
1658030014646,COGS 14B,A01,083073,Cheng; Tzu-Han,7,0,63,56
1658030020667,COGS 17,A01,092677,Semenuks; Arturs,7,0,81,74
1658030026695,COGS 100,A01,083619,Allen; Michael Gordon,17,0,70,53
1658030032718,COGS 101A,A01,083621,Davis; Joshua Daniel,9,0,68,59
1658030038740,COGS 101B,A01,091572,Allen; Michael Gordon,14,0,65,51
1658030044766,COGS 101C,A01,083625,Delgado; Tania,17,0,35,18
1658030050791,COGS 107A,A01,083627,Boyle; Mary E. T.,14,0,60,46
1658030056817,COGS 118A,A01,083075,Gupta; Anjum,21,0,76,55
1658030062840,CSE 3,A50,083646,Miranda; Gregory Joseph,24,0,50,26
1658030068864,CSE 8A,A50,083650,Miranda; Gregory Joseph,17,1,56,39
1658030074890,CSE 11,A01,083080,Cao; Yingjun,7,15,40,33
1658030080916,CSE 12,A01,083652,Krause-Levy; Sophia Louisa,30,1,120,90
1658030086942,CSE 15L,A01,083654,Morris; Justin Loren,9,0,50,41
1658030086942,CSE 15L,A02,083655,Morris; Justin Loren,11,0,50,39
1658030092966,CSE 20,A01,083657,Tran; Khoa Dang,39,0,80,41
1658030098991,CSE 21,A01,095574,Bach; Quang Tran,23,0,48,25
1658030105016,CSE 30,A01,083084,Eldon; John,8,0,80,72
1658030105016,CSE 30,B01,095061,Bhaskar; Nishant,9,0,50,41
1658030111049,CSE 100,A01,083659,Cao; Yingjun,5,4,70,65
1658030117071,CSE 134B,A01,083661,Powell; Thomas Allan,25,0,100,75
1658030123093,CSE 140,A01,083663,Gungor; Onat,17,0,85,68
1658030129119,CSE 140L,A01,083088,Eldon; John,23,0,100,77
1658030135142,CSE 175,A01,083665,Kumar; Rakesh,3,0,25,22
1658030141167,CSE 190,A00,092507,Dubnov; Shlomo,8,0,20,12
1658030147197,ECE 45,A01,083139,Congero; Spencer William,7,0,75,68
1658030153224,ECE 65,A50,083695,Saad; Andrew S,12,0,30,18
1658030153224,ECE 65,A51,095125,Saad; Andrew S,24,0,26,2
1658030159250,ECE 109,A01,091882,Touri; Behrouz,21,0,70,49
1658030165275,ECE 180,A00,083140,Abi Samra; Nicholas Camill,1,0,30,29
1658030165275,ECE 180,B00,083141,Abi Samra; Nicholas Camill,0,0,30,30
1658030171298,MATH 10A,A01,083735,Patchell; Gregory David,2,0,30,28
1658030171298,MATH 10A,A02,083736,Patchell; Gregory David,20,0,30,10
1658030171298,MATH 10A,A03,083737,Patchell; Gregory David,16,0,30,14
1658030177321,MATH 10B,A01,083207,Lim; Seonhee,9,0,34,25
1658030177321,MATH 10B,A02,083208,Lim; Seonhee,10,0,35,25
1658030177321,MATH 10B,A03,093472,Lim; Seonhee,7,0,34,27
1658030177321,MATH 10B,B01,083739,Sinha; Shubham,14,0,30,16
1658030183346,MATH 18,A01,083743,Cinel; Cameron Alexander,9,0,30,21
1658030183346,MATH 18,A02,083744,Cinel; Cameron Alexander,18,0,30,12
1658030183346,MATH 18,A03,083745,Cinel; Cameron Alexander,10,0,30,20
1658030183346,MATH 18,B01,083748,Rideout; David Porter,5,0,37,32
1658030183346,MATH 18,B02,083749,Rideout; David Porter,5,0,36,31
1658030183346,MATH 18,B03,083750,Rideout; David Porter,3,0,37,34
1658030183346,MATH 18,B04,083751,Rideout; David Porter,7,0,36,29
1658030183346,MATH 18,B05,093473,Rideout; David Porter,7,0,36,29
1658030183346,MATH 18,B06,093474,Rideout; David Porter,6,0,36,30
1658030189373,MATH 20A,A01,083754,Zheng; Zequn,14,0,40,26
1658030195400,MATH 20B,A01,083756,Briones; Jor-el Thomas Caparas,4,0,36,32
1658030195400,MATH 20B,A02,083757,Briones; Jor-el Thomas Caparas,1,0,36,35
1658030195400,MATH 20B,A03,093475,Briones; Jor-el Thomas Caparas,3,0,36,33
1658030201428,MATH 20C,A01,083760,Briones; Jor-el Thomas Caparas,1,0,35,34
1658030201428,MATH 20C,A02,083761,Briones; Jor-el Thomas Caparas,8,0,35,27
1658030201428,MATH 20C,A03,093476,Briones; Jor-el Thomas Caparas,0,1,36,36
1658030201428,MATH 20C,B01,083762,Bach; Quang Tran,1,0,30,29
1658030207455,MATH 20D,A01,083765,Tran; Brian Kha,5,0,30,25
1658030207455,MATH 20D,A02,083766,Tran; Brian Kha,5,0,30,25
1658030207455,MATH 20D,A03,083767,Tran; Brian Kha,6,0,30,24
1658030213483,MATH 20E,A01,083771,Ganguly; Soumya,12,0,32,20
1658030213483,MATH 20E,A02,083772,Ganguly; Soumya,7,0,32,25
1658030213483,MATH 20E,B01,083773,Ciotti; Benjamin,20,0,35,15
1658030213483,MATH 20E,B02,083774,Ciotti; Benjamin,18,0,35,17
1658030219512,MATH 103A,A01,083777,Greenfeld; Be'Eri,6,0,36,30
1658030219512,MATH 103A,A02,083778,Greenfeld; Be'Eri,5,0,36,31
1658030219512,MATH 103A,A03,093561,Greenfeld; Be'Eri,7,0,36,29
1658030219512,MATH 103A,B01,083779,Greenfeld; Be'Eri,8,0,36,28
1658030219512,MATH 103A,B02,083780,Greenfeld; Be'Eri,4,0,36,32
1658030219512,MATH 103A,B03,093562,Greenfeld; Be'Eri,3,0,36,33
1658030225535,MATH 105,A01,085443,Carter; Anne Toulson,15,0,35,20
1658030225535,MATH 105,A02,093477,Carter; Anne Toulson,20,0,35,15
1658030231558,MATH 109,A01,083213,Ganzberger; Geoffrey Michael,3,0,34,31
1658030231558,MATH 109,A02,083214,Ganzberger; Geoffrey Michael,4,0,34,30
1658030231558,MATH 109,A03,093478,Ganzberger; Geoffrey Michael,2,0,34,32
1658030231558,MATH 109,B01,083215,Ganzberger; Geoffrey Michael,3,0,32,29
1658030231558,MATH 109,B02,083216,Ganzberger; Geoffrey Michael,3,0,32,29
1658030231558,MATH 109,B03,093479,Ganzberger; Geoffrey Michael,8,0,32,24
1658030237581,MATH 142A,A01,083219,Chow; Bennett,7,0,32,25
1658030237581,MATH 142A,A02,083220,Chow; Bennett,10,0,32,22
1658030237581,MATH 142A,A03,093480,Chow; Bennett,9,0,32,23
1658030237581,MATH 142A,B03,093481,Chow; Bennett,8,0,32,24
1658030237581,MATH 142A,B04,093558,Chow; Bennett,14,0,32,18
1658030237581,MATH 142A,B05,093559,Chow; Bennett,7,0,32,25
1658030243608,MATH 193A,A01,083224,Rotar; Vladimir,9,0,34,25
1658030243608,MATH 193A,A02,083225,Rotar; Vladimir,11,0,34,23
1658030243608,MATH 193A,A03,083781,Rotar; Vladimir,5,0,34,29
1658030243608,MATH 193A,A04,083782,Rotar; Vladimir,12,0,34,22
1658030243608,MATH 193A,A05,093482,Rotar; Vladimir,11,0,34,23
1658030249631,MATH 197,001,091859,McAuley; Julian John,9999,0,9999,0
1658030249631,MATH 197,002,095566,Kedlaya; Kiran S.,9997,0,9999,2
1658030249631,MATH 197,003,095567,Xiao; Ming,9999,0,9999,0
1658030249631,MATH 197,004,095571,Perols; Johan Lars,9998,0,9999,1
1658030256694,COGS 9,A01,083615,Shannon; Kyle Michael,11,0,75,64
1658030262721,COGS 11,A01,083617,Boyle; Mary E. T.,23,0,48,25
1658030268744,COGS 13,A01,083071,Bastos; Amalia Pinkusfeld,12,0,71,59
1658030274768,COGS 14A,A01,092681,Semenuks; Arturs,5,1,100,95
1658030280796,COGS 14B,A01,083073,Cheng; Tzu-Han,7,0,63,56
1658030286819,COGS 17,A01,092677,Semenuks; Arturs,7,0,81,74
1658030292841,COGS 100,A01,083619,Allen; Michael Gordon,17,0,70,53
1658030298863,COGS 101A,A01,083621,Davis; Joshua Daniel,9,0,68,59
1658030304890,COGS 101B,A01,091572,Allen; Michael Gordon,14,0,65,51
1658030310914,COGS 101C,A01,083625,Delgado; Tania,17,0,35,18
1658030316941,COGS 107A,A01,083627,Boyle; Mary E. T.,14,0,60,46
1658030322965,COGS 118A,A01,083075,Gupta; Anjum,21,0,76,55
1658030328992,CSE 3,A50,083646,Miranda; Gregory Joseph,24,0,50,26
1658030335017,CSE 8A,A50,083650,Miranda; Gregory Joseph,17,1,56,39
1658030341042,CSE 11,A01,083080,Cao; Yingjun,7,15,40,33
1658030347064,CSE 12,A01,083652,Krause-Levy; Sophia Louisa,30,1,120,90
1658030353183,CSE 15L,A01,083654,Morris; Justin Loren,9,0,50,41
1658030353183,CSE 15L,A02,083655,Morris; Justin Loren,11,0,50,39
1658030359206,CSE 20,A01,083657,Tran; Khoa Dang,39,0,80,41
1658030365229,CSE 21,A01,095574,Bach; Quang Tran,23,0,48,25
1658030371254,CSE 30,A01,083084,Eldon; John,8,0,80,72
1658030371254,CSE 30,B01,095061,Bhaskar; Nishant,9,0,50,41
1658030377276,CSE 100,A01,083659,Cao; Yingjun,5,4,70,65
1658030383299,CSE 134B,A01,083661,Powell; Thomas Allan,25,0,100,75
1658030389323,CSE 140,A01,083663,Gungor; Onat,17,0,85,68
1658030395346,CSE 140L,A01,083088,Eldon; John,23,0,100,77
1658030401368,CSE 175,A01,083665,Kumar; Rakesh,3,0,25,22
1658030407391,CSE 190,A00,092507,Dubnov; Shlomo,8,0,20,12
1658030413414,ECE 45,A01,083139,Congero; Spencer William,7,0,75,68
1658030419440,ECE 65,A50,083695,Saad; Andrew S,12,0,30,18
1658030419440,ECE 65,A51,095125,Saad; Andrew S,24,0,26,2
1658030425464,ECE 109,A01,091882,Touri; Behrouz,21,0,70,49
1658030431490,ECE 180,A00,083140,Abi Samra; Nicholas Camill,1,0,30,29
1658030431490,ECE 180,B00,083141,Abi Samra; Nicholas Camill,0,0,30,30
1658030437517,MATH 10A,A01,083735,Patchell; Gregory David,2,0,30,28
1658030437517,MATH 10A,A02,083736,Patchell; Gregory David,20,0,30,10
1658030437517,MATH 10A,A03,083737,Patchell; Gregory David,16,0,30,14
1658030443546,MATH 10B,A01,083207,Lim; Seonhee,9,0,34,25
1658030443546,MATH 10B,A02,083208,Lim; Seonhee,10,0,35,25
1658030443546,MATH 10B,A03,093472,Lim; Seonhee,7,0,34,27
1658030443546,MATH 10B,B01,083739,Sinha; Shubham,14,0,30,16
1658030449570,MATH 18,A01,083743,Cinel; Cameron Alexander,9,0,30,21
1658030449570,MATH 18,A02,083744,Cinel; Cameron Alexander,18,0,30,12
1658030449570,MATH 18,A03,083745,Cinel; Cameron Alexander,10,0,30,20
1658030449570,MATH 18,B01,083748,Rideout; David Porter,5,0,37,32
1658030449570,MATH 18,B02,083749,Rideout; David Porter,5,0,36,31
1658030449570,MATH 18,B03,083750,Rideout; David Porter,3,0,37,34
1658030449570,MATH 18,B04,083751,Rideout; David Porter,7,0,36,29
1658030449570,MATH 18,B05,093473,Rideout; David Porter,7,0,36,29
1658030449570,MATH 18,B06,093474,Rideout; David Porter,6,0,36,30
1658030455594,MATH 20A,A01,083754,Zheng; Zequn,14,0,40,26
1658030461620,MATH 20B,A01,083756,Briones; Jor-el Thomas Caparas,4,0,36,32
1658030461620,MATH 20B,A02,083757,Briones; Jor-el Thomas Caparas,1,0,36,35
1658030461620,MATH 20B,A03,093475,Briones; Jor-el Thomas Caparas,3,0,36,33
1658030467647,MATH 20C,A01,083760,Briones; Jor-el Thomas Caparas,1,0,35,34
1658030467647,MATH 20C,A02,083761,Briones; Jor-el Thomas Caparas,8,0,35,27
1658030467647,MATH 20C,A03,093476,Briones; Jor-el Thomas Caparas,0,1,36,36
1658030467647,MATH 20C,B01,083762,Bach; Quang Tran,1,0,30,29
1658030473671,MATH 20D,A01,083765,Tran; Brian Kha,5,0,30,25
1658030473671,MATH 20D,A02,083766,Tran; Brian Kha,5,0,30,25
1658030473671,MATH 20D,A03,083767,Tran; Brian Kha,6,0,30,24
1658030479695,MATH 20E,A01,083771,Ganguly; Soumya,12,0,32,20
1658030479695,MATH 20E,A02,083772,Ganguly; Soumya,7,0,32,25
1658030479695,MATH 20E,B01,083773,Ciotti; Benjamin,20,0,35,15
1658030479695,MATH 20E,B02,083774,Ciotti; Benjamin,18,0,35,17
1658030485719,MATH 103A,A01,083777,Greenfeld; Be'Eri,6,0,36,30
1658030485719,MATH 103A,A02,083778,Greenfeld; Be'Eri,5,0,36,31
1658030485719,MATH 103A,A03,093561,Greenfeld; Be'Eri,7,0,36,29
1658030485719,MATH 103A,B01,083779,Greenfeld; Be'Eri,8,0,36,28
1658030485719,MATH 103A,B02,083780,Greenfeld; Be'Eri,4,0,36,32
1658030485719,MATH 103A,B03,093562,Greenfeld; Be'Eri,3,0,36,33
1658030491746,MATH 105,A01,085443,Carter; Anne Toulson,15,0,35,20
1658030491746,MATH 105,A02,093477,Carter; Anne Toulson,20,0,35,15
1658030497772,MATH 109,A01,083213,Ganzberger; Geoffrey Michael,3,0,34,31
1658030497772,MATH 109,A02,083214,Ganzberger; Geoffrey Michael,4,0,34,30
1658030497772,MATH 109,A03,093478,Ganzberger; Geoffrey Michael,2,0,34,32
1658030497772,MATH 109,B01,083215,Ganzberger; Geoffrey Michael,3,0,32,29
1658030497772,MATH 109,B02,083216,Ganzberger; Geoffrey Michael,3,0,32,29
1658030497772,MATH 109,B03,093479,Ganzberger; Geoffrey Michael,8,0,32,24
1658030503795,MATH 142A,A01,083219,Chow; Bennett,7,0,32,25
1658030503795,MATH 142A,A02,083220,Chow; Bennett,10,0,32,22
1658030503795,MATH 142A,A03,093480,Chow; Bennett,9,0,32,23
1658030503795,MATH 142A,B03,093481,Chow; Bennett,8,0,32,24
1658030503795,MATH 142A,B04,093558,Chow; Bennett,14,0,32,18
1658030503795,MATH 142A,B05,093559,Chow; Bennett,7,0,32,25
1658030509821,MATH 193A,A01,083224,Rotar; Vladimir,9,0,34,25
1658030509821,MATH 193A,A02,083225,Rotar; Vladimir,11,0,34,23
1658030509821,MATH 193A,A03,083781,Rotar; Vladimir,5,0,34,29
1658030509821,MATH 193A,A04,083782,Rotar; Vladimir,12,0,34,22
1658030509821,MATH 193A,A05,093482,Rotar; Vladimir,11,0,34,23
1658030515842,MATH 197,001,091859,McAuley; Julian John,9999,0,9999,0
1658030515842,MATH 197,002,095566,Kedlaya; Kiran S.,9997,0,9999,2
1658030515842,MATH 197,003,095567,Xiao; Ming,9999,0,9999,0
1658030515842,MATH 197,004,095571,Perols; Johan Lars,9998,0,9999,1
1658030522897,COGS 9,A01,083615,Shannon; Kyle Michael,11,0,75,64
1658030528924,COGS 11,A01,083617,Boyle; Mary E. T.,23,0,48,25
1658030534947,COGS 13,A01,083071,Bastos; Amalia Pinkusfeld,12,0,71,59
1658030540976,COGS 14A,A01,092681,Semenuks; Arturs,5,1,100,95
1658030547004,COGS 14B,A01,083073,Cheng; Tzu-Han,7,0,63,56
1658030553029,COGS 17,A01,092677,Semenuks; Arturs,7,0,81,74
1658030559052,COGS 100,A01,083619,Allen; Michael Gordon,17,0,70,53
1658030565077,COGS 101A,A01,083621,Davis; Joshua Daniel,9,0,68,59
1658030571100,COGS 101B,A01,091572,Allen; Michael Gordon,14,0,65,51
1658030577122,COGS 101C,A01,083625,Delgado; Tania,17,0,35,18
1658030583150,COGS 107A,A01,083627,Boyle; Mary E. T.,14,0,60,46
1658030589177,COGS 118A,A01,083075,Gupta; Anjum,21,0,76,55
1658030595199,CSE 3,A50,083646,Miranda; Gregory Joseph,24,0,50,26
1658030601231,CSE 8A,A50,083650,Miranda; Gregory Joseph,17,1,56,39
1658030607254,CSE 11,A01,083080,Cao; Yingjun,7,15,40,33
1658030613279,CSE 12,A01,083652,Krause-Levy; Sophia Louisa,30,1,120,90
1658030619306,CSE 15L,A01,083654,Morris; Justin Loren,9,0,50,41
1658030619306,CSE 15L,A02,083655,Morris; Justin Loren,11,0,50,39
1658030625335,CSE 20,A01,083657,Tran; Khoa Dang,39,0,80,41
1658030631357,CSE 21,A01,095574,Bach; Quang Tran,23,0,48,25
1658030637382,CSE 30,A01,083084,Eldon; John,8,0,80,72
1658030637382,CSE 30,B01,095061,Bhaskar; Nishant,9,0,50,41
1658030643406,CSE 100,A01,083659,Cao; Yingjun,5,4,70,65
1658030649428,CSE 134B,A01,083661,Powell; Thomas Allan,25,0,100,75
1658030655451,CSE 140,A01,083663,Gungor; Onat,17,0,85,68
1658030661478,CSE 140L,A01,083088,Eldon; John,23,0,100,77
1658030667502,CSE 175,A01,083665,Kumar; Rakesh,3,0,25,22
1658030673528,CSE 190,A00,092507,Dubnov; Shlomo,8,0,20,12
1658030679553,ECE 45,A01,083139,Congero; Spencer William,7,0,75,68
1658030685586,ECE 65,A50,083695,Saad; Andrew S,12,0,30,18
1658030685586,ECE 65,A51,095125,Saad; Andrew S,24,0,26,2
1658030691607,ECE 109,A01,091882,Touri; Behrouz,21,0,70,49
1658030697630,ECE 180,A00,083140,Abi Samra; Nicholas Camill,1,0,30,29
1658030697630,ECE 180,B00,083141,Abi Samra; Nicholas Camill,0,0,30,30
1658030703653,MATH 10A,A01,083735,Patchell; Gregory David,2,0,30,28
1658030703653,MATH 10A,A02,083736,Patchell; Gregory David,20,0,30,10
1658030703653,MATH 10A,A03,083737,Patchell; Gregory David,16,0,30,14
1658030709678,MATH 10B,A01,083207,Lim; Seonhee,9,0,34,25
1658030709678,MATH 10B,A02,083208,Lim; Seonhee,10,0,35,25
1658030709678,MATH 10B,A03,093472,Lim; Seonhee,7,0,34,27
1658030709678,MATH 10B,B01,083739,Sinha; Shubham,14,0,30,16
1658030715702,MATH 18,A01,083743,Cinel; Cameron Alexander,9,0,30,21
1658030715702,MATH 18,A02,083744,Cinel; Cameron Alexander,18,0,30,12
1658030715702,MATH 18,A03,083745,Cinel; Cameron Alexander,10,0,30,20
1658030715702,MATH 18,B01,083748,Rideout; David Porter,5,0,37,32
1658030715702,MATH 18,B02,083749,Rideout; David Porter,5,0,36,31
1658030715702,MATH 18,B03,083750,Rideout; David Porter,3,0,37,34
1658030715702,MATH 18,B04,083751,Rideout; David Porter,7,0,36,29
1658030715702,MATH 18,B05,093473,Rideout; David Porter,7,0,36,29
1658030715702,MATH 18,B06,093474,Rideout; David Porter,6,0,36,30
1658030721724,MATH 20A,A01,083754,Zheng; Zequn,14,0,40,26
1658030727752,MATH 20B,A01,083756,Briones; Jor-el Thomas Caparas,4,0,36,32
1658030727752,MATH 20B,A02,083757,Briones; Jor-el Thomas Caparas,1,0,36,35
1658030727752,MATH 20B,A03,093475,Briones; Jor-el Thomas Caparas,3,0,36,33
1658030733774,MATH 20C,A01,083760,Briones; Jor-el Thomas Caparas,1,0,35,34
1658030733774,MATH 20C,A02,083761,Briones; Jor-el Thomas Caparas,8,0,35,27
1658030733774,MATH 20C,A03,093476,Briones; Jor-el Thomas Caparas,0,1,36,36
1658030733774,MATH 20C,B01,083762,Bach; Quang Tran,1,0,30,29
1658030739797,MATH 20D,A01,083765,Tran; Brian Kha,5,0,30,25
1658030739797,MATH 20D,A02,083766,Tran; Brian Kha,5,0,30,25
1658030739797,MATH 20D,A03,083767,Tran; Brian Kha,6,0,30,24
1658030745821,MATH 20E,A01,083771,Ganguly; Soumya,12,0,32,20
1658030745821,MATH 20E,A02,083772,Ganguly; Soumya,7,0,32,25
1658030745821,MATH 20E,B01,083773,Ciotti; Benjamin,20,0,35,15
1658030745821,MATH 20E,B02,083774,Ciotti; Benjamin,18,0,35,17
1658030751843,MATH 103A,A01,083777,Greenfeld; Be'Eri,6,0,36,30
1658030751843,MATH 103A,A02,083778,Greenfeld; Be'Eri,5,0,36,31
1658030751843,MATH 103A,A03,093561,Greenfeld; Be'Eri,7,0,36,29
1658030751843,MATH 103A,B01,083779,Greenfeld; Be'Eri,8,0,36,28
1658030751843,MATH 103A,B02,083780,Greenfeld; Be'Eri,4,0,36,32
1658030751843,MATH 103A,B03,093562,Greenfeld; Be'Eri,3,0,36,33
1658030757871,MATH 105,A01,085443,Carter; Anne Toulson,15,0,35,20
1658030757871,MATH 105,A02,093477,Carter; Anne Toulson,20,0,35,15
1658030763898,MATH 109,A01,083213,Ganzberger; Geoffrey Michael,3,0,34,31
1658030763898,MATH 109,A02,083214,Ganzberger; Geoffrey Michael,4,0,34,30
1658030763898,MATH 109,A03,093478,Ganzberger; Geoffrey Michael,2,0,34,32
1658030763898,MATH 109,B01,083215,Ganzberger; Geoffrey Michael,3,0,32,29
1658030763898,MATH 109,B02,083216,Ganzberger; Geoffrey Michael,3,0,32,29
1658030763898,MATH 109,B03,093479,Ganzberger; Geoffrey Michael,8,0,32,24
1658030769927,MATH 142A,A01,083219,Chow; Bennett,7,0,32,25
1658030769927,MATH 142A,A02,083220,Chow; Bennett,10,0,32,22
1658030769927,MATH 142A,A03,093480,Chow; Bennett,9,0,32,23
1658030769927,MATH 142A,B03,093481,Chow; Bennett,8,0,32,24
1658030769927,MATH 142A,B04,093558,Chow; Bennett,14,0,32,18
1658030769927,MATH 142A,B05,093559,Chow; Bennett,7,0,32,25
1658030775954,MATH 193A,A01,083224,Rotar; Vladimir,9,0,34,25
1658030775954,MATH 193A,A02,083225,Rotar; Vladimir,11,0,34,23
1658030775954,MATH 193A,A03,083781,Rotar; Vladimir,5,0,34,29
1658030775954,MATH 193A,A04,083782,Rotar; Vladimir,12,0,34,22
1658030775954,MATH 193A,A05,093482,Rotar; Vladimir,11,0,34,23
1658030781976,MATH 197,001,091859,McAuley; Julian John,9999,0,9999,0
1658030781976,MATH 197,002,095566,Kedlaya; Kiran S.,9997,0,9999,2
1658030781976,MATH 197,003,095567,Xiao; Ming,9999,0,9999,0
1658030781976,MATH 197,004,095571,Perols; Johan Lars,9998,0,9999,1
1658030789027,COGS 9,A01,083615,Shannon; Kyle Michael,11,0,75,64
1658030795049,COGS 11,A01,083617,Boyle; Mary E. T.,23,0,48,25
1658030801077,COGS 13,A01,083071,Bastos; Amalia Pinkusfeld,12,0,71,59
1658030807100,COGS 14A,A01,092681,Semenuks; Arturs,5,1,100,95
1658030813125,COGS 14B,A01,083073,Cheng; Tzu-Han,7,0,63,56
1658030819152,COGS 17,A01,092677,Semenuks; Arturs,7,0,81,74
1658030825181,COGS 100,A01,083619,Allen; Michael Gordon,17,0,70,53
1658030831211,COGS 101A,A01,083621,Davis; Joshua Daniel,9,0,68,59
1658030837234,COGS 101B,A01,091572,Allen; Michael Gordon,14,0,65,51
1658030843258,COGS 101C,A01,083625,Delgado; Tania,17,0,35,18
1658030849282,COGS 107A,A01,083627,Boyle; Mary E. T.,14,0,60,46
1658030855306,COGS 118A,A01,083075,Gupta; Anjum,21,0,76,55
1658030861330,CSE 3,A50,083646,Miranda; Gregory Joseph,24,0,50,26
1658030867354,CSE 8A,A50,083650,Miranda; Gregory Joseph,17,1,56,39
1658030873379,CSE 11,A01,083080,Cao; Yingjun,7,15,40,33
1658030879404,CSE 12,A01,083652,Krause-Levy; Sophia Louisa,30,1,120,90
1658030885427,CSE 15L,A01,083654,Morris; Justin Loren,9,0,50,41
1658030885427,CSE 15L,A02,083655,Morris; Justin Loren,11,0,50,39
1658030891455,CSE 20,A01,083657,Tran; Khoa Dang,39,0,80,41
1658030897482,CSE 21,A01,095574,Bach; Quang Tran,23,0,48,25
1658030903508,CSE 30,A01,083084,Eldon; John,8,0,80,72
1658030903508,CSE 30,B01,095061,Bhaskar; Nishant,9,0,50,41
1658030909531,CSE 100,A01,083659,Cao; Yingjun,5,4,70,65
1658030915558,CSE 134B,A01,083661,Powell; Thomas Allan,25,0,100,75
1658030921584,CSE 140,A01,083663,Gungor; Onat,17,0,85,68
1658030927606,CSE 140L,A01,083088,Eldon; John,23,0,100,77
1658030933630,CSE 175,A01,083665,Kumar; Rakesh,3,0,25,22
1658030939656,CSE 190,A00,092507,Dubnov; Shlomo,8,0,20,12
1658030945685,ECE 45,A01,083139,Congero; Spencer William,7,0,75,68
1658030951796,ECE 65,A50,083695,Saad; Andrew S,12,0,30,18
1658030951796,ECE 65,A51,095125,Saad; Andrew S,24,0,26,2
1658030957819,ECE 109,A01,091882,Touri; Behrouz,21,0,70,49
1658030963842,ECE 180,A00,083140,Abi Samra; Nicholas Camill,1,0,30,29
1658030963842,ECE 180,B00,083141,Abi Samra; Nicholas Camill,0,0,30,30
1658030969864,MATH 10A,A01,083735,Patchell; Gregory David,2,0,30,28
1658030969864,MATH 10A,A02,083736,Patchell; Gregory David,20,0,30,10
1658030969864,MATH 10A,A03,083737,Patchell; Gregory David,16,0,30,14
1658030975888,MATH 10B,A01,083207,Lim; Seonhee,9,0,34,25
1658030975888,MATH 10B,A02,083208,Lim; Seonhee,10,0,35,25
1658030975888,MATH 10B,A03,093472,Lim; Seonhee,7,0,34,27
1658030975888,MATH 10B,B01,083739,Sinha; Shubham,14,0,30,16
1658030981913,MATH 18,A01,083743,Cinel; Cameron Alexander,9,0,30,21
1658030981913,MATH 18,A02,083744,Cinel; Cameron Alexander,18,0,30,12
1658030981913,MATH 18,A03,083745,Cinel; Cameron Alexander,10,0,30,20
1658030981913,MATH 18,B01,083748,Rideout; David Porter,5,0,37,32
1658030981913,MATH 18,B02,083749,Rideout; David Porter,5,0,36,31
1658030981913,MATH 18,B03,083750,Rideout; David Porter,3,0,37,34
1658030981913,MATH 18,B04,083751,Rideout; David Porter,7,0,36,29
1658030981913,MATH 18,B05,093473,Rideout; David Porter,7,0,36,29
1658030981913,MATH 18,B06,093474,Rideout; David Porter,6,0,36,30
1658030987936,MATH 20A,A01,083754,Zheng; Zequn,14,0,40,26
1658030993961,MATH 20B,A01,083756,Briones; Jor-el Thomas Caparas,4,0,36,32
1658030993961,MATH 20B,A02,083757,Briones; Jor-el Thomas Caparas,1,0,36,35
1658030993961,MATH 20B,A03,093475,Briones; Jor-el Thomas Caparas,3,0,36,33
1658030999990,MATH 20C,A01,083760,Briones; Jor-el Thomas Caparas,1,0,35,34
1658030999990,MATH 20C,A02,083761,Briones; Jor-el Thomas Caparas,8,0,35,27
1658030999990,MATH 20C,A03,093476,Briones; Jor-el Thomas Caparas,0,1,36,36
1658030999990,MATH 20C,B01,083762,Bach; Quang Tran,1,0,30,29
1658031006014,MATH 20D,A01,083765,Tran; Brian Kha,5,0,30,25
1658031006014,MATH 20D,A02,083766,Tran; Brian Kha,5,0,30,25
1658031006014,MATH 20D,A03,083767,Tran; Brian Kha,6,0,30,24
1658031012039,MATH 20E,A01,083771,Ganguly; Soumya,12,0,32,20
1658031012039,MATH 20E,A02,083772,Ganguly; Soumya,7,0,32,25
1658031012039,MATH 20E,B01,083773,Ciotti; Benjamin,20,0,35,15
1658031012039,MATH 20E,B02,083774,Ciotti; Benjamin,18,0,35,17
1658031018062,MATH 103A,A01,083777,Greenfeld; Be'Eri,6,0,36,30
1658031018062,MATH 103A,A02,083778,Greenfeld; Be'Eri,5,0,36,31
1658031018062,MATH 103A,A03,093561,Greenfeld; Be'Eri,7,0,36,29
1658031018062,MATH 103A,B01,083779,Greenfeld; Be'Eri,8,0,36,28
1658031018062,MATH 103A,B02,083780,Greenfeld; Be'Eri,4,0,36,32
1658031018062,MATH 103A,B03,093562,Greenfeld; Be'Eri,3,0,36,33
1658031024084,MATH 105,A01,085443,Carter; Anne Toulson,15,0,35,20
1658031024084,MATH 105,A02,093477,Carter; Anne Toulson,20,0,35,15
1658031030107,MATH 109,A01,083213,Ganzberger; Geoffrey Michael,3,0,34,31
1658031030107,MATH 109,A02,083214,Ganzberger; Geoffrey Michael,4,0,34,30
1658031030107,MATH 109,A03,093478,Ganzberger; Geoffrey Michael,2,0,34,32
1658031030107,MATH 109,B01,083215,Ganzberger; Geoffrey Michael,3,0,32,29
1658031030107,MATH 109,B02,083216,Ganzberger; Geoffrey Michael,3,0,32,29
1658031030107,MATH 109,B03,093479,Ganzberger; Geoffrey Michael,8,0,32,24
1658031036131,MATH 142A,A01,083219,Chow; Bennett,7,0,32,25
1658031036131,MATH 142A,A02,083220,Chow; Bennett,10,0,32,22
1658031036131,MATH 142A,A03,093480,Chow; Bennett,9,0,32,23
1658031036131,MATH 142A,B03,093481,Chow; Bennett,8,0,32,24
1658031036131,MATH 142A,B04,093558,Chow; Bennett,14,0,32,18
1658031036131,MATH 142A,B05,093559,Chow; Bennett,7,0,32,25
1658031042158,MATH 193A,A01,083224,Rotar; Vladimir,9,0,34,25
1658031042158,MATH 193A,A02,083225,Rotar; Vladimir,11,0,34,23
1658031042158,MATH 193A,A03,083781,Rotar; Vladimir,5,0,34,29
1658031042158,MATH 193A,A04,083782,Rotar; Vladimir,12,0,34,22
1658031042158,MATH 193A,A05,093482,Rotar; Vladimir,11,0,34,23
1658031048181,MATH 197,001,091859,McAuley; Julian John,9999,0,9999,0
1658031048181,MATH 197,002,095566,Kedlaya; Kiran S.,9997,0,9999,2
1658031048181,MATH 197,003,095567,Xiao; Ming,9999,0,9999,0
1658031048181,MATH 197,004,095571,Perols; Johan Lars,9998,0,9999,1
1658031055243,COGS 9,A01,083615,Shannon; Kyle Michael,11,0,75,64
1658031061266,COGS 11,A01,083617,Boyle; Mary E. T.,23,0,48,25
1658031067293,COGS 13,A01,083071,Bastos; Amalia Pinkusfeld,12,0,71,59
1658031073319,COGS 14A,A01,092681,Semenuks; Arturs,5,1,100,95
1658031079343,COGS 14B,A01,083073,Cheng; Tzu-Han,7,0,63,56
1658031085370,COGS 17,A01,092677,Semenuks; Arturs,7,0,81,74
1658031091392,COGS 100,A01,083619,Allen; Michael Gordon,17,0,70,53
1658031097418,COGS 101A,A01,083621,Davis; Joshua Daniel,9,0,68,59
1658031103442,COGS 101B,A01,091572,Allen; Michael Gordon,14,0,65,51
1658031109466,COGS 101C,A01,083625,Delgado; Tania,17,0,35,18
1658031115489,COGS 107A,A01,083627,Boyle; Mary E. T.,14,0,60,46
1658031121513,COGS 118A,A01,083075,Gupta; Anjum,21,0,76,55
1658031127541,CSE 3,A50,083646,Miranda; Gregory Joseph,24,0,50,26
1658031133567,CSE 8A,A50,083650,Miranda; Gregory Joseph,17,1,56,39
1658031139590,CSE 11,A01,083080,Cao; Yingjun,7,15,40,33
1658031145613,CSE 12,A01,083652,Krause-Levy; Sophia Louisa,30,1,120,90
1658031151639,CSE 15L,A01,083654,Morris; Justin Loren,9,0,50,41
1658031151639,CSE 15L,A02,083655,Morris; Justin Loren,11,0,50,39
1658031157663,CSE 20,A01,083657,Tran; Khoa Dang,39,0,80,41
1658031163690,CSE 21,A01,095574,Bach; Quang Tran,23,0,48,25
1658031169713,CSE 30,A01,083084,Eldon; John,8,0,80,72
1658031169713,CSE 30,B01,095061,Bhaskar; Nishant,9,0,50,41
1658031175738,CSE 100,A01,083659,Cao; Yingjun,5,4,70,65
1658031181771,CSE 134B,A01,083661,Powell; Thomas Allan,25,0,100,75
1658031187801,CSE 140,A01,083663,Gungor; Onat,17,0,85,68
1658031193828,CSE 140L,A01,083088,Eldon; John,23,0,100,77
1658031199849,CSE 175,A01,083665,Kumar; Rakesh,3,0,25,22
1658031205875,CSE 190,A00,092507,Dubnov; Shlomo,8,0,20,12
1658031211899,ECE 45,A01,083139,Congero; Spencer William,7,0,75,68
1658031217945,ECE 65,A50,083695,Saad; Andrew S,12,0,30,18
1658031217945,ECE 65,A51,095125,Saad; Andrew S,24,0,26,2
1658031223967,ECE 109,A01,091882,Touri; Behrouz,21,0,70,49
1658031229992,ECE 180,A00,083140,Abi Samra; Nicholas Camill,1,0,30,29
1658031229992,ECE 180,B00,083141,Abi Samra; Nicholas Camill,0,0,30,30
1658031236015,MATH 10A,A01,083735,Patchell; Gregory David,2,0,30,28
1658031236015,MATH 10A,A02,083736,Patchell; Gregory David,20,0,30,10
1658031236015,MATH 10A,A03,083737,Patchell; Gregory David,16,0,30,14
1658031242039,MATH 10B,A01,083207,Lim; Seonhee,9,0,34,25
1658031242039,MATH 10B,A02,083208,Lim; Seonhee,10,0,35,25
1658031242039,MATH 10B,A03,093472,Lim; Seonhee,7,0,34,27
1658031242039,MATH 10B,B01,083739,Sinha; Shubham,14,0,30,16
1658031248062,MATH 18,A01,083743,Cinel; Cameron Alexander,9,0,30,21
1658031248062,MATH 18,A02,083744,Cinel; Cameron Alexander,18,0,30,12
1658031248062,MATH 18,A03,083745,Cinel; Cameron Alexander,10,0,30,20
1658031248062,MATH 18,B01,083748,Rideout; David Porter,5,0,37,32
1658031248062,MATH 18,B02,083749,Rideout; David Porter,5,0,36,31
1658031248062,MATH 18,B03,083750,Rideout; David Porter,3,0,37,34
1658031248062,MATH 18,B04,083751,Rideout; David Porter,7,0,36,29
1658031248062,MATH 18,B05,093473,Rideout; David Porter,7,0,36,29
1658031248062,MATH 18,B06,093474,Rideout; David Porter,6,0,36,30
1658031254090,MATH 20A,A01,083754,Zheng; Zequn,14,0,40,26
1658031260113,MATH 20B,A01,083756,Briones; Jor-el Thomas Caparas,4,0,36,32
1658031260113,MATH 20B,A02,083757,Briones; Jor-el Thomas Caparas,1,0,36,35
1658031260113,MATH 20B,A03,093475,Briones; Jor-el Thomas Caparas,3,0,36,33
1658031266138,MATH 20C,A01,083760,Briones; Jor-el Thomas Caparas,1,0,35,34
1658031266138,MATH 20C,A02,083761,Briones; Jor-el Thomas Caparas,8,0,35,27
1658031266138,MATH 20C,A03,093476,Briones; Jor-el Thomas Caparas,0,1,36,36
1658031266138,MATH 20C,B01,083762,Bach; Quang Tran,1,0,30,29
1658031272161,MATH 20D,A01,083765,Tran; Brian Kha,5,0,30,25
1658031272161,MATH 20D,A02,083766,Tran; Brian Kha,5,0,30,25
1658031272161,MATH 20D,A03,083767,Tran; Brian Kha,6,0,30,24
1658031278191,MATH 20E,A01,083771,Ganguly; Soumya,12,0,32,20
1658031278191,MATH 20E,A02,083772,Ganguly; Soumya,7,0,32,25
1658031278191,MATH 20E,B01,083773,Ciotti; Benjamin,20,0,35,15
1658031278191,MATH 20E,B02,083774,Ciotti; Benjamin,18,0,35,17
1658031284222,MATH 103A,A01,083777,Greenfeld; Be'Eri,6,0,36,30
1658031284222,MATH 103A,A02,083778,Greenfeld; Be'Eri,5,0,36,31
1658031284222,MATH 103A,A03,093561,Greenfeld; Be'Eri,7,0,36,29
1658031284222,MATH 103A,B01,083779,Greenfeld; Be'Eri,8,0,36,28
1658031284222,MATH 103A,B02,083780,Greenfeld; Be'Eri,4,0,36,32
1658031284222,MATH 103A,B03,093562,Greenfeld; Be'Eri,3,0,36,33
1658031290245,MATH 105,A01,085443,Carter; Anne Toulson,15,0,35,20
1658031290245,MATH 105,A02,093477,Carter; Anne Toulson,20,0,35,15
1658031296275,MATH 109,A01,083213,Ganzberger; Geoffrey Michael,3,0,34,31
1658031296275,MATH 109,A02,083214,Ganzberger; Geoffrey Michael,4,0,34,30
1658031296275,MATH 109,A03,093478,Ganzberger; Geoffrey Michael,2,0,34,32
1658031296275,MATH 109,B01,083215,Ganzberger; Geoffrey Michael,3,0,32,29
1658031296275,MATH 109,B02,083216,Ganzberger; Geoffrey Michael,3,0,32,29
1658031296275,MATH 109,B03,093479,Ganzberger; Geoffrey Michael,8,0,32,24
1658031302305,MATH 142A,A01,083219,Chow; Bennett,7,0,32,25
1658031302305,MATH 142A,A02,083220,Chow; Bennett,10,0,32,22
1658031302305,MATH 142A,A03,093480,Chow; Bennett,9,0,32,23
1658031302305,MATH 142A,B03,093481,Chow; Bennett,8,0,32,24
1658031302305,MATH 142A,B04,093558,Chow; Bennett,14,0,32,18
1658031302305,MATH 142A,B05,093559,Chow; Bennett,7,0,32,25
1658031308328,MATH 193A,A01,083224,Rotar; Vladimir,9,0,34,25
1658031308328,MATH 193A,A02,083225,Rotar; Vladimir,11,0,34,23
1658031308328,MATH 193A,A03,083781,Rotar; Vladimir,5,0,34,29
1658031308328,MATH 193A,A04,083782,Rotar; Vladimir,12,0,34,22
1658031308328,MATH 193A,A05,093482,Rotar; Vladimir,11,0,34,23
1658031314350,MATH 197,001,091859,McAuley; Julian John,9999,0,9999,0
1658031314350,MATH 197,002,095566,Kedlaya; Kiran S.,9997,0,9999,2
1658031314350,MATH 197,003,095567,Xiao; Ming,9999,0,9999,0
1658031314350,MATH 197,004,095571,Perols; Johan Lars,9998,0,9999,1
1658031321404,COGS 9,A01,083615,Shannon; Kyle Michael,11,0,75,64
1658031327430,COGS 11,A01,083617,Boyle; Mary E. T.,23,0,48,25
1658031333453,COGS 13,A01,083071,Bastos; Amalia Pinkusfeld,12,0,71,59
1658031339485,COGS 14A,A01,092681,Semenuks; Arturs,5,1,100,95
1658031345507,COGS 14B,A01,083073,Cheng; Tzu-Han,7,0,63,56
1658031351529,COGS 17,A01,092677,Semenuks; Arturs,7,0,81,74
1658031357553,COGS 100,A01,083619,Allen; Michael Gordon,17,0,70,53
1658031363577,COGS 101A,A01,083621,Davis; Joshua Daniel,9,0,68,59
1658031369603,COGS 101B,A01,091572,Allen; Michael Gordon,14,0,65,51
1658031375626,COGS 101C,A01,083625,Delgado; Tania,17,0,35,18
1658031381650,COGS 107A,A01,083627,Boyle; Mary E. T.,14,0,60,46
1658031387676,COGS 118A,A01,083075,Gupta; Anjum,21,0,76,55
1658031393703,CSE 3,A50,083646,Miranda; Gregory Joseph,24,0,50,26
1658031399726,CSE 8A,A50,083650,Miranda; Gregory Joseph,17,1,56,39
1658031405753,CSE 11,A01,083080,Cao; Yingjun,7,15,40,33
1658031411780,CSE 12,A01,083652,Krause-Levy; Sophia Louisa,30,1,120,90
1658031417804,CSE 15L,A01,083654,Morris; Justin Loren,9,0,50,41
1658031417804,CSE 15L,A02,083655,Morris; Justin Loren,11,0,50,39
1658031423827,CSE 20,A01,083657,Tran; Khoa Dang,39,0,80,41
1658031429851,CSE 21,A01,095574,Bach; Quang Tran,23,0,48,25
1658031435877,CSE 30,A01,083084,Eldon; John,8,0,80,72
1658031435877,CSE 30,B01,095061,Bhaskar; Nishant,9,0,50,41
1658031441901,CSE 100,A01,083659,Cao; Yingjun,5,4,70,65
1658031447928,CSE 134B,A01,083661,Powell; Thomas Allan,25,0,100,75
1658031453955,CSE 140,A01,083663,Gungor; Onat,17,0,85,68
1658031459983,CSE 140L,A01,083088,Eldon; John,23,0,100,77
1658031466011,CSE 175,A01,083665,Kumar; Rakesh,3,0,25,22
1658031472035,CSE 190,A00,092507,Dubnov; Shlomo,8,0,20,12
1658031478059,ECE 45,A01,083139,Congero; Spencer William,7,0,75,68
1658031484087,ECE 65,A50,083695,Saad; Andrew S,12,0,30,18
1658031484087,ECE 65,A51,095125,Saad; Andrew S,24,0,26,2
1658031490114,ECE 109,A01,091882,Touri; Behrouz,21,0,70,49
1658031496142,ECE 180,A00,083140,Abi Samra; Nicholas Camill,1,0,30,29
1658031496142,ECE 180,B00,083141,Abi Samra; Nicholas Camill,0,0,30,30
1658031502166,MATH 10A,A01,083735,Patchell; Gregory David,2,0,30,28
1658031502166,MATH 10A,A02,083736,Patchell; Gregory David,20,0,30,10
1658031502166,MATH 10A,A03,083737,Patchell; Gregory David,16,0,30,14
1658031508198,MATH 10B,A01,083207,Lim; Seonhee,9,0,34,25
1658031508198,MATH 10B,A02,083208,Lim; Seonhee,10,0,35,25
1658031508198,MATH 10B,A03,093472,Lim; Seonhee,7,0,34,27
1658031508198,MATH 10B,B01,083739,Sinha; Shubham,14,0,30,16
1658031514225,MATH 18,A01,083743,Cinel; Cameron Alexander,9,0,30,21
1658031514225,MATH 18,A02,083744,Cinel; Cameron Alexander,18,0,30,12
1658031514225,MATH 18,A03,083745,Cinel; Cameron Alexander,10,0,30,20
1658031514225,MATH 18,B01,083748,Rideout; David Porter,5,0,37,32
1658031514225,MATH 18,B02,083749,Rideout; David Porter,5,0,36,31
1658031514225,MATH 18,B03,083750,Rideout; David Porter,3,0,37,34
1658031514225,MATH 18,B04,083751,Rideout; David Porter,7,0,36,29
1658031514225,MATH 18,B05,093473,Rideout; David Porter,7,0,36,29
1658031514225,MATH 18,B06,093474,Rideout; David Porter,6,0,36,30
1658031520252,MATH 20A,A01,083754,Zheng; Zequn,14,0,40,26
1658031526280,MATH 20B,A01,083756,Briones; Jor-el Thomas Caparas,4,0,36,32
1658031526280,MATH 20B,A02,083757,Briones; Jor-el Thomas Caparas,1,0,36,35
1658031526280,MATH 20B,A03,093475,Briones; Jor-el Thomas Caparas,3,0,36,33
1658031532311,MATH 20C,A01,083760,Briones; Jor-el Thomas Caparas,1,0,35,34
1658031532311,MATH 20C,A02,083761,Briones; Jor-el Thomas Caparas,8,0,35,27
1658031532311,MATH 20C,A03,093476,Briones; Jor-el Thomas Caparas,0,1,36,36
1658031532311,MATH 20C,B01,083762,Bach; Quang Tran,1,0,30,29
1658031538335,MATH 20D,A01,083765,Tran; Brian Kha,5,0,30,25
1658031538335,MATH 20D,A02,083766,Tran; Brian Kha,5,0,30,25
1658031538335,MATH 20D,A03,083767,Tran; Brian Kha,6,0,30,24
1658031544364,MATH 20E,A01,083771,Ganguly; Soumya,12,0,32,20
1658031544364,MATH 20E,A02,083772,Ganguly; Soumya,7,0,32,25
1658031544364,MATH 20E,B01,083773,Ciotti; Benjamin,20,0,35,15
1658031544364,MATH 20E,B02,083774,Ciotti; Benjamin,18,0,35,17
1658031550464,MATH 103A,A01,083777,Greenfeld; Be'Eri,6,0,36,30
1658031550464,MATH 103A,A02,083778,Greenfeld; Be'Eri,5,0,36,31
1658031550464,MATH 103A,A03,093561,Greenfeld; Be'Eri,7,0,36,29
1658031550464,MATH 103A,B01,083779,Greenfeld; Be'Eri,8,0,36,28
1658031550464,MATH 103A,B02,083780,Greenfeld; Be'Eri,4,0,36,32
1658031550464,MATH 103A,B03,093562,Greenfeld; Be'Eri,3,0,36,33
1658031556492,MATH 105,A01,085443,Carter; Anne Toulson,15,0,35,20
1658031556492,MATH 105,A02,093477,Carter; Anne Toulson,20,0,35,15
1658031562520,MATH 109,A01,083213,Ganzberger; Geoffrey Michael,3,0,34,31
1658031562520,MATH 109,A02,083214,Ganzberger; Geoffrey Michael,4,0,34,30
1658031562520,MATH 109,A03,093478,Ganzberger; Geoffrey Michael,2,0,34,32
1658031562520,MATH 109,B01,083215,Ganzberger; Geoffrey Michael,3,0,32,29
1658031562520,MATH 109,B02,083216,Ganzberger; Geoffrey Michael,3,0,32,29
1658031562520,MATH 109,B03,093479,Ganzberger; Geoffrey Michael,8,0,32,24
1658031568556,MATH 142A,A01,083219,Chow; Bennett,7,0,32,25
1658031568556,MATH 142A,A02,083220,Chow; Bennett,10,0,32,22
1658031568556,MATH 142A,A03,093480,Chow; Bennett,9,0,32,23
1658031568556,MATH 142A,B03,093481,Chow; Bennett,8,0,32,24
1658031568556,MATH 142A,B04,093558,Chow; Bennett,14,0,32,18
1658031568556,MATH 142A,B05,093559,Chow; Bennett,7,0,32,25
1658031574580,MATH 193A,A01,083224,Rotar; Vladimir,9,0,34,25
1658031574580,MATH 193A,A02,083225,Rotar; Vladimir,11,0,34,23
1658031574580,MATH 193A,A03,083781,Rotar; Vladimir,5,0,34,29
1658031574580,MATH 193A,A04,083782,Rotar; Vladimir,12,0,34,22
1658031574580,MATH 193A,A05,093482,Rotar; Vladimir,11,0,34,23
1658031580602,MATH 197,001,091859,McAuley; Julian John,9999,0,9999,0
1658031580602,MATH 197,002,095566,Kedlaya; Kiran S.,9997,0,9999,2
1658031580602,MATH 197,003,095567,Xiao; Ming,9999,0,9999,0
1658031580602,MATH 197,004,095571,Perols; Johan Lars,9998,0,9999,1
1658031587676,COGS 9,A01,083615,Shannon; Kyle Michael,11,0,75,64
1658031593699,COGS 11,A01,083617,Boyle; Mary E. T.,23,0,48,25
1658031599734,COGS 13,A01,083071,Bastos; Amalia Pinkusfeld,12,0,71,59
1658031605757,COGS 14A,A01,092681,Semenuks; Arturs,5,1,100,95
1658031611781,COGS 14B,A01,083073,Cheng; Tzu-Han,7,0,63,56
1658031617810,COGS 17,A01,092677,Semenuks; Arturs,7,0,81,74
1658031623835,COGS 100,A01,083619,Allen; Michael Gordon,17,0,70,53
1658031629863,COGS 101A,A01,083621,Davis; Joshua Daniel,9,0,68,59
1658031635891,COGS 101B,A01,091572,Allen; Michael Gordon,14,0,65,51
1658031641920,COGS 101C,A01,083625,Delgado; Tania,17,0,35,18
1658031647949,COGS 107A,A01,083627,Boyle; Mary E. T.,14,0,60,46
1658031653972,COGS 118A,A01,083075,Gupta; Anjum,21,0,76,55
1658031660006,CSE 3,A50,083646,Miranda; Gregory Joseph,24,0,50,26
1658031666031,CSE 8A,A50,083650,Miranda; Gregory Joseph,17,1,56,39
1658031672054,CSE 11,A01,083080,Cao; Yingjun,7,15,40,33
1658031678084,CSE 12,A01,083652,Krause-Levy; Sophia Louisa,30,1,120,90
1658031684112,CSE 15L,A01,083654,Morris; Justin Loren,9,0,50,41
1658031684112,CSE 15L,A02,083655,Morris; Justin Loren,11,0,50,39
1658031690136,CSE 20,A01,083657,Tran; Khoa Dang,39,0,80,41
1658031696164,CSE 21,A01,095574,Bach; Quang Tran,23,0,48,25
1658031702188,CSE 30,A01,083084,Eldon; John,8,0,80,72
1658031702188,CSE 30,B01,095061,Bhaskar; Nishant,9,0,50,41
1658031708215,CSE 100,A01,083659,Cao; Yingjun,5,4,70,65
1658031714239,CSE 134B,A01,083661,Powell; Thomas Allan,25,0,100,75
1658031720269,CSE 140,A01,083663,Gungor; Onat,17,0,85,68
1658031726295,CSE 140L,A01,083088,Eldon; John,23,0,100,77
1658031732319,CSE 175,A01,083665,Kumar; Rakesh,3,0,25,22
1658031738344,CSE 190,A00,092507,Dubnov; Shlomo,8,0,20,12
1658031744372,ECE 45,A01,083139,Congero; Spencer William,7,0,75,68
1658031750396,ECE 65,A50,083695,Saad; Andrew S,12,0,30,18
1658031750396,ECE 65,A51,095125,Saad; Andrew S,24,0,26,2
1658031756423,ECE 109,A01,091882,Touri; Behrouz,21,0,70,49
1658031762451,ECE 180,A00,083140,Abi Samra; Nicholas Camill,1,0,30,29
1658031762451,ECE 180,B00,083141,Abi Samra; Nicholas Camill,0,0,30,30
1658031768479,MATH 10A,A01,083735,Patchell; Gregory David,2,0,30,28
1658031768479,MATH 10A,A02,083736,Patchell; Gregory David,20,0,30,10
1658031768479,MATH 10A,A03,083737,Patchell; Gregory David,16,0,30,14
1658031774504,MATH 10B,A01,083207,Lim; Seonhee,9,0,34,25
1658031774504,MATH 10B,A02,083208,Lim; Seonhee,10,0,35,25
1658031774504,MATH 10B,A03,093472,Lim; Seonhee,7,0,34,27
1658031774504,MATH 10B,B01,083739,Sinha; Shubham,14,0,30,16
1658031780534,MATH 18,A01,083743,Cinel; Cameron Alexander,9,0,30,21
1658031780534,MATH 18,A02,083744,Cinel; Cameron Alexander,18,0,30,12
1658031780534,MATH 18,A03,083745,Cinel; Cameron Alexander,10,0,30,20
1658031780534,MATH 18,B01,083748,Rideout; David Porter,5,0,37,32
1658031780534,MATH 18,B02,083749,Rideout; David Porter,5,0,36,31
1658031780534,MATH 18,B03,083750,Rideout; David Porter,3,0,37,34
1658031780534,MATH 18,B04,083751,Rideout; David Porter,7,0,36,29
1658031780534,MATH 18,B05,093473,Rideout; David Porter,7,0,36,29
1658031780534,MATH 18,B06,093474,Rideout; David Porter,6,0,36,30
1658031786557,MATH 20A,A01,083754,Zheng; Zequn,14,0,40,26
1658031792586,MATH 20B,A01,083756,Briones; Jor-el Thomas Caparas,4,0,36,32
1658031792586,MATH 20B,A02,083757,Briones; Jor-el Thomas Caparas,1,0,36,35
1658031792586,MATH 20B,A03,093475,Briones; Jor-el Thomas Caparas,3,0,36,33
1658031798613,MATH 20C,A01,083760,Briones; Jor-el Thomas Caparas,1,0,35,34
1658031798613,MATH 20C,A02,083761,Briones; Jor-el Thomas Caparas,8,0,35,27
1658031798613,MATH 20C,A03,093476,Briones; Jor-el Thomas Caparas,0,1,36,36
1658031798613,MATH 20C,B01,083762,Bach; Quang Tran,1,0,30,29
1658031804638,MATH 20D,A01,083765,Tran; Brian Kha,5,0,30,25
1658031804638,MATH 20D,A02,083766,Tran; Brian Kha,5,0,30,25
1658031804638,MATH 20D,A03,083767,Tran; Brian Kha,6,0,30,24
1658031810661,MATH 20E,A01,083771,Ganguly; Soumya,12,0,32,20
1658031810661,MATH 20E,A02,083772,Ganguly; Soumya,7,0,32,25
1658031810661,MATH 20E,B01,083773,Ciotti; Benjamin,20,0,35,15
1658031810661,MATH 20E,B02,083774,Ciotti; Benjamin,18,0,35,17
1658031816685,MATH 103A,A01,083777,Greenfeld; Be'Eri,6,0,36,30
1658031816685,MATH 103A,A02,083778,Greenfeld; Be'Eri,5,0,36,31
1658031816685,MATH 103A,A03,093561,Greenfeld; Be'Eri,7,0,36,29
1658031816685,MATH 103A,B01,083779,Greenfeld; Be'Eri,8,0,36,28
1658031816685,MATH 103A,B02,083780,Greenfeld; Be'Eri,4,0,36,32
1658031816685,MATH 103A,B03,093562,Greenfeld; Be'Eri,3,0,36,33
1658031822710,MATH 105,A01,085443,Carter; Anne Toulson,15,0,35,20
1658031822710,MATH 105,A02,093477,Carter; Anne Toulson,20,0,35,15
1658031828738,MATH 109,A01,083213,Ganzberger; Geoffrey Michael,3,0,34,31
1658031828738,MATH 109,A02,083214,Ganzberger; Geoffrey Michael,4,0,34,30
1658031828738,MATH 109,A03,093478,Ganzberger; Geoffrey Michael,2,0,34,32
1658031828738,MATH 109,B01,083215,Ganzberger; Geoffrey Michael,3,0,32,29
1658031828738,MATH 109,B02,083216,Ganzberger; Geoffrey Michael,3,0,32,29
1658031828738,MATH 109,B03,093479,Ganzberger; Geoffrey Michael,8,0,32,24
1658031834763,MATH 142A,A01,083219,Chow; Bennett,7,0,32,25
1658031834763,MATH 142A,A02,083220,Chow; Bennett,10,0,32,22
1658031834763,MATH 142A,A03,093480,Chow; Bennett,9,0,32,23
1658031834763,MATH 142A,B03,093481,Chow; Bennett,8,0,32,24
1658031834763,MATH 142A,B04,093558,Chow; Bennett,14,0,32,18
1658031834763,MATH 142A,B05,093559,Chow; Bennett,7,0,32,25
1658031840787,MATH 193A,A01,083224,Rotar; Vladimir,9,0,34,25
1658031840787,MATH 193A,A02,083225,Rotar; Vladimir,11,0,34,23
1658031840787,MATH 193A,A03,083781,Rotar; Vladimir,5,0,34,29
1658031840787,MATH 193A,A04,083782,Rotar; Vladimir,12,0,34,22
1658031840787,MATH 193A,A05,093482,Rotar; Vladimir,11,0,34,23
1658031846810,MATH 197,001,091859,McAuley; Julian John,9999,0,9999,0
1658031846810,MATH 197,002,095566,Kedlaya; Kiran S.,9997,0,9999,2
1658031846810,MATH 197,003,095567,Xiao; Ming,9999,0,9999,0
1658031846810,MATH 197,004,095571,Perols; Johan Lars,9998,0,9999,1
1658031853870,COGS 9,A01,083615,Shannon; Kyle Michael,11,0,75,64
1658031859895,COGS 11,A01,083617,Boyle; Mary E. T.,23,0,48,25
1658031865918,COGS 13,A01,083071,Bastos; Amalia Pinkusfeld,12,0,71,59
1658031871941,COGS 14A,A01,092681,Semenuks; Arturs,5,1,100,95
1658031877966,COGS 14B,A01,083073,Cheng; Tzu-Han,7,0,63,56
1658031883990,COGS 17,A01,092677,Semenuks; Arturs,7,0,81,74
1658031890013,COGS 100,A01,083619,Allen; Michael Gordon,17,0,70,53
1658031896035,COGS 101A,A01,083621,Davis; Joshua Daniel,9,0,68,59
1658031902058,COGS 101B,A01,091572,Allen; Michael Gordon,14,0,65,51
1658031908082,COGS 101C,A01,083625,Delgado; Tania,17,0,35,18
1658031914108,COGS 107A,A01,083627,Boyle; Mary E. T.,14,0,60,46
1658031920135,COGS 118A,A01,083075,Gupta; Anjum,21,0,76,55
1658031926158,CSE 3,A50,083646,Miranda; Gregory Joseph,24,0,50,26
1658031932186,CSE 8A,A50,083650,Miranda; Gregory Joseph,17,1,56,39
1658031938209,CSE 11,A01,083080,Cao; Yingjun,7,15,40,33
1658031944232,CSE 12,A01,083652,Krause-Levy; Sophia Louisa,30,1,120,90
1658031950258,CSE 15L,A01,083654,Morris; Justin Loren,9,0,50,41
1658031950258,CSE 15L,A02,083655,Morris; Justin Loren,11,0,50,39
1658031956281,CSE 20,A01,083657,Tran; Khoa Dang,39,0,80,41
1658031962303,CSE 21,A01,095574,Bach; Quang Tran,23,0,48,25
1658031968332,CSE 30,A01,083084,Eldon; John,8,0,80,72
1658031968332,CSE 30,B01,095061,Bhaskar; Nishant,9,0,50,41
1658031974354,CSE 100,A01,083659,Cao; Yingjun,5,4,70,65
1658031980381,CSE 134B,A01,083661,Powell; Thomas Allan,25,0,100,75
1658031986405,CSE 140,A01,083663,Gungor; Onat,17,0,85,68
1658031992432,CSE 140L,A01,083088,Eldon; John,23,0,100,77
1658031998453,CSE 175,A01,083665,Kumar; Rakesh,3,0,25,22
1658032004479,CSE 190,A00,092507,Dubnov; Shlomo,8,0,20,12
1658032010501,ECE 45,A01,083139,Congero; Spencer William,7,0,75,68
1658032016527,ECE 65,A50,083695,Saad; Andrew S,12,0,30,18
1658032016527,ECE 65,A51,095125,Saad; Andrew S,24,0,26,2
1658032022550,ECE 109,A01,091882,Touri; Behrouz,21,0,70,49
1658032028577,ECE 180,A00,083140,Abi Samra; Nicholas Camill,1,0,30,29
1658032028577,ECE 180,B00,083141,Abi Samra; Nicholas Camill,0,0,30,30
1658032034605,MATH 10A,A01,083735,Patchell; Gregory David,2,0,30,28
1658032034605,MATH 10A,A02,083736,Patchell; Gregory David,20,0,30,10
1658032034605,MATH 10A,A03,083737,Patchell; Gregory David,16,0,30,14
1658032040634,MATH 10B,A01,083207,Lim; Seonhee,9,0,34,25
1658032040634,MATH 10B,A02,083208,Lim; Seonhee,10,0,35,25
1658032040634,MATH 10B,A03,093472,Lim; Seonhee,7,0,34,27
1658032040634,MATH 10B,B01,083739,Sinha; Shubham,14,0,30,16
1658032046666,MATH 18,A01,083743,Cinel; Cameron Alexander,9,0,30,21
1658032046666,MATH 18,A02,083744,Cinel; Cameron Alexander,18,0,30,12
1658032046666,MATH 18,A03,083745,Cinel; Cameron Alexander,10,0,30,20
1658032046666,MATH 18,B01,083748,Rideout; David Porter,5,0,37,32
1658032046666,MATH 18,B02,083749,Rideout; David Porter,5,0,36,31
1658032046666,MATH 18,B03,083750,Rideout; David Porter,3,0,37,34
1658032046666,MATH 18,B04,083751,Rideout; David Porter,7,0,36,29
1658032046666,MATH 18,B05,093473,Rideout; David Porter,7,0,36,29
1658032046666,MATH 18,B06,093474,Rideout; David Porter,6,0,36,30
1658032052690,MATH 20A,A01,083754,Zheng; Zequn,14,0,40,26
1658032058717,MATH 20B,A01,083756,Briones; Jor-el Thomas Caparas,4,0,36,32
1658032058717,MATH 20B,A02,083757,Briones; Jor-el Thomas Caparas,1,0,36,35
1658032058717,MATH 20B,A03,093475,Briones; Jor-el Thomas Caparas,3,0,36,33
1658032064740,MATH 20C,A01,083760,Briones; Jor-el Thomas Caparas,1,0,35,34
1658032064740,MATH 20C,A02,083761,Briones; Jor-el Thomas Caparas,8,0,35,27
1658032064740,MATH 20C,A03,093476,Briones; Jor-el Thomas Caparas,0,1,36,36
1658032064740,MATH 20C,B01,083762,Bach; Quang Tran,1,0,30,29
1658032070768,MATH 20D,A01,083765,Tran; Brian Kha,5,0,30,25
1658032070768,MATH 20D,A02,083766,Tran; Brian Kha,5,0,30,25
1658032070768,MATH 20D,A03,083767,Tran; Brian Kha,6,0,30,24
1658032076805,MATH 20E,A01,083771,Ganguly; Soumya,12,0,32,20
1658032076805,MATH 20E,A02,083772,Ganguly; Soumya,7,0,32,25
1658032076805,MATH 20E,B01,083773,Ciotti; Benjamin,20,0,35,15
1658032076805,MATH 20E,B02,083774,Ciotti; Benjamin,18,0,35,17
1658032082830,MATH 103A,A01,083777,Greenfeld; Be'Eri,6,0,36,30
1658032082830,MATH 103A,A02,083778,Greenfeld; Be'Eri,5,0,36,31
1658032082830,MATH 103A,A03,093561,Greenfeld; Be'Eri,7,0,36,29
1658032082830,MATH 103A,B01,083779,Greenfeld; Be'Eri,8,0,36,28
1658032082830,MATH 103A,B02,083780,Greenfeld; Be'Eri,4,0,36,32
1658032082830,MATH 103A,B03,093562,Greenfeld; Be'Eri,3,0,36,33
1658032088856,MATH 105,A01,085443,Carter; Anne Toulson,15,0,35,20
1658032088856,MATH 105,A02,093477,Carter; Anne Toulson,20,0,35,15
1658032094881,MATH 109,A01,083213,Ganzberger; Geoffrey Michael,3,0,34,31
1658032094881,MATH 109,A02,083214,Ganzberger; Geoffrey Michael,4,0,34,30
1658032094881,MATH 109,A03,093478,Ganzberger; Geoffrey Michael,2,0,34,32
1658032094881,MATH 109,B01,083215,Ganzberger; Geoffrey Michael,3,0,32,29
1658032094881,MATH 109,B02,083216,Ganzberger; Geoffrey Michael,3,0,32,29
1658032094881,MATH 109,B03,093479,Ganzberger; Geoffrey Michael,8,0,32,24
1658032100905,MATH 142A,A01,083219,Chow; Bennett,7,0,32,25
1658032100905,MATH 142A,A02,083220,Chow; Bennett,10,0,32,22
1658032100905,MATH 142A,A03,093480,Chow; Bennett,9,0,32,23
1658032100905,MATH 142A,B03,093481,Chow; Bennett,8,0,32,24
1658032100905,MATH 142A,B04,093558,Chow; Bennett,14,0,32,18
1658032100905,MATH 142A,B05,093559,Chow; Bennett,7,0,32,25
1658032106937,MATH 193A,A01,083224,Rotar; Vladimir,9,0,34,25
1658032106937,MATH 193A,A02,083225,Rotar; Vladimir,11,0,34,23
1658032106937,MATH 193A,A03,083781,Rotar; Vladimir,5,0,34,29
1658032106937,MATH 193A,A04,083782,Rotar; Vladimir,12,0,34,22
1658032106937,MATH 193A,A05,093482,Rotar; Vladimir,11,0,34,23
1658032112958,MATH 197,001,091859,McAuley; Julian John,9999,0,9999,0
1658032112958,MATH 197,002,095566,Kedlaya; Kiran S.,9997,0,9999,2
1658032112958,MATH 197,003,095567,Xiao; Ming,9999,0,9999,0
1658032112958,MATH 197,004,095571,Perols; Johan Lars,9998,0,9999,1
1658032120016,COGS 9,A01,083615,Shannon; Kyle Michael,11,0,75,64
1658032126043,COGS 11,A01,083617,Boyle; Mary E. T.,23,0,48,25
1658032132070,COGS 13,A01,083071,Bastos; Amalia Pinkusfeld,12,0,71,59
1658032138096,COGS 14A,A01,092681,Semenuks; Arturs,5,1,100,95
1658032144201,COGS 14B,A01,083073,Cheng; Tzu-Han,7,0,63,56
1658032150229,COGS 17,A01,092677,Semenuks; Arturs,7,0,81,74
1658032156251,COGS 100,A01,083619,Allen; Michael Gordon,17,0,70,53
1658032162285,COGS 101A,A01,083621,Davis; Joshua Daniel,9,0,68,59
1658032168307,COGS 101B,A01,091572,Allen; Michael Gordon,14,0,65,51
1658032174359,COGS 101C,A01,083625,Delgado; Tania,17,0,35,18
1658032180385,COGS 107A,A01,083627,Boyle; Mary E. T.,14,0,60,46
1658032186419,COGS 118A,A01,083075,Gupta; Anjum,21,0,76,55
1658032192442,CSE 3,A50,083646,Miranda; Gregory Joseph,24,0,50,26
1658032198469,CSE 8A,A50,083650,Miranda; Gregory Joseph,17,1,56,39
1658032204495,CSE 11,A01,083080,Cao; Yingjun,7,15,40,33
1658032210517,CSE 12,A01,083652,Krause-Levy; Sophia Louisa,30,1,120,90
1658032216543,CSE 15L,A01,083654,Morris; Justin Loren,9,0,50,41
1658032216543,CSE 15L,A02,083655,Morris; Justin Loren,11,0,50,39
1658032222570,CSE 20,A01,083657,Tran; Khoa Dang,39,0,80,41
1658032228596,CSE 21,A01,095574,Bach; Quang Tran,23,0,48,25
1658032234622,CSE 30,A01,083084,Eldon; John,8,0,80,72
1658032234622,CSE 30,B01,095061,Bhaskar; Nishant,9,0,50,41
1658032240643,CSE 100,A01,083659,Cao; Yingjun,5,4,70,65
1658032246668,CSE 134B,A01,083661,Powell; Thomas Allan,25,0,100,75
1658032252690,CSE 140,A01,083663,Gungor; Onat,17,0,85,68
1658032258712,CSE 140L,A01,083088,Eldon; John,23,0,100,77
1658032264735,CSE 175,A01,083665,Kumar; Rakesh,3,0,25,22
1658032270762,CSE 190,A00,092507,Dubnov; Shlomo,8,0,20,12
1658032276787,ECE 45,A01,083139,Congero; Spencer William,7,0,75,68
1658032282815,ECE 65,A50,083695,Saad; Andrew S,12,0,30,18
1658032282815,ECE 65,A51,095125,Saad; Andrew S,24,0,26,2
1658032288839,ECE 109,A01,091882,Touri; Behrouz,21,0,70,49
1658032294876,ECE 180,A00,083140,Abi Samra; Nicholas Camill,1,0,30,29
1658032294876,ECE 180,B00,083141,Abi Samra; Nicholas Camill,0,0,30,30
1658032300902,MATH 10A,A01,083735,Patchell; Gregory David,2,0,30,28
1658032300902,MATH 10A,A02,083736,Patchell; Gregory David,20,0,30,10
1658032300902,MATH 10A,A03,083737,Patchell; Gregory David,16,0,30,14
1658032306925,MATH 10B,A01,083207,Lim; Seonhee,9,0,34,25
1658032306925,MATH 10B,A02,083208,Lim; Seonhee,10,0,35,25
1658032306925,MATH 10B,A03,093472,Lim; Seonhee,7,0,34,27
1658032306925,MATH 10B,B01,083739,Sinha; Shubham,14,0,30,16
1658032312949,MATH 18,A01,083743,Cinel; Cameron Alexander,9,0,30,21
1658032312949,MATH 18,A02,083744,Cinel; Cameron Alexander,18,0,30,12
1658032312949,MATH 18,A03,083745,Cinel; Cameron Alexander,10,0,30,20
1658032312949,MATH 18,B01,083748,Rideout; David Porter,5,0,37,32
1658032312949,MATH 18,B02,083749,Rideout; David Porter,5,0,36,31
1658032312949,MATH 18,B03,083750,Rideout; David Porter,3,0,37,34
1658032312949,MATH 18,B04,083751,Rideout; David Porter,7,0,36,29
1658032312949,MATH 18,B05,093473,Rideout; David Porter,7,0,36,29
1658032312949,MATH 18,B06,093474,Rideout; David Porter,6,0,36,30
1658032318971,MATH 20A,A01,083754,Zheng; Zequn,14,0,40,26
1658032324997,MATH 20B,A01,083756,Briones; Jor-el Thomas Caparas,4,0,36,32
1658032324997,MATH 20B,A02,083757,Briones; Jor-el Thomas Caparas,1,0,36,35
1658032324997,MATH 20B,A03,093475,Briones; Jor-el Thomas Caparas,3,0,36,33
1658032331019,MATH 20C,A01,083760,Briones; Jor-el Thomas Caparas,1,0,35,34
1658032331019,MATH 20C,A02,083761,Briones; Jor-el Thomas Caparas,8,0,35,27
1658032331019,MATH 20C,A03,093476,Briones; Jor-el Thomas Caparas,0,1,36,36
1658032331019,MATH 20C,B01,083762,Bach; Quang Tran,1,0,30,29
1658032337041,MATH 20D,A01,083765,Tran; Brian Kha,5,0,30,25
1658032337041,MATH 20D,A02,083766,Tran; Brian Kha,5,0,30,25
1658032337041,MATH 20D,A03,083767,Tran; Brian Kha,6,0,30,24
1658032343063,MATH 20E,A01,083771,Ganguly; Soumya,12,0,32,20
1658032343063,MATH 20E,A02,083772,Ganguly; Soumya,7,0,32,25
1658032343063,MATH 20E,B01,083773,Ciotti; Benjamin,20,0,35,15
1658032343063,MATH 20E,B02,083774,Ciotti; Benjamin,18,0,35,17
1658032349088,MATH 103A,A01,083777,Greenfeld; Be'Eri,6,0,36,30
1658032349088,MATH 103A,A02,083778,Greenfeld; Be'Eri,5,0,36,31
1658032349088,MATH 103A,A03,093561,Greenfeld; Be'Eri,7,0,36,29
1658032349088,MATH 103A,B01,083779,Greenfeld; Be'Eri,8,0,36,28
1658032349088,MATH 103A,B02,083780,Greenfeld; Be'Eri,4,0,36,32
1658032349088,MATH 103A,B03,093562,Greenfeld; Be'Eri,3,0,36,33
1658032355115,MATH 105,A01,085443,Carter; Anne Toulson,15,0,35,20
1658032355115,MATH 105,A02,093477,Carter; Anne Toulson,20,0,35,15
1658032361138,MATH 109,A01,083213,Ganzberger; Geoffrey Michael,3,0,34,31
1658032361138,MATH 109,A02,083214,Ganzberger; Geoffrey Michael,4,0,34,30
1658032361138,MATH 109,A03,093478,Ganzberger; Geoffrey Michael,2,0,34,32
1658032361138,MATH 109,B01,083215,Ganzberger; Geoffrey Michael,3,0,32,29
1658032361138,MATH 109,B02,083216,Ganzberger; Geoffrey Michael,3,0,32,29
1658032361138,MATH 109,B03,093479,Ganzberger; Geoffrey Michael,8,0,32,24
1658032367177,MATH 142A,A01,083219,Chow; Bennett,7,0,32,25
1658032367177,MATH 142A,A02,083220,Chow; Bennett,10,0,32,22
1658032367177,MATH 142A,A03,093480,Chow; Bennett,9,0,32,23
1658032367177,MATH 142A,B03,093481,Chow; Bennett,8,0,32,24
1658032367177,MATH 142A,B04,093558,Chow; Bennett,14,0,32,18
1658032367177,MATH 142A,B05,093559,Chow; Bennett,7,0,32,25
1658032373201,MATH 193A,A01,083224,Rotar; Vladimir,9,0,34,25
1658032373201,MATH 193A,A02,083225,Rotar; Vladimir,11,0,34,23
1658032373201,MATH 193A,A03,083781,Rotar; Vladimir,5,0,34,29
1658032373201,MATH 193A,A04,083782,Rotar; Vladimir,12,0,34,22
1658032373201,MATH 193A,A05,093482,Rotar; Vladimir,11,0,34,23
1658032379226,MATH 197,001,091859,McAuley; Julian John,9999,0,9999,0
1658032379226,MATH 197,002,095566,Kedlaya; Kiran S.,9997,0,9999,2
1658032379226,MATH 197,003,095567,Xiao; Ming,9999,0,9999,0
1658032379226,MATH 197,004,095571,Perols; Johan Lars,9998,0,9999,1
1658032386279,COGS 9,A01,083615,Shannon; Kyle Michael,11,0,75,64
1658032392307,COGS 11,A01,083617,Boyle; Mary E. T.,23,0,48,25
1658032398332,COGS 13,A01,083071,Bastos; Amalia Pinkusfeld,12,0,71,59
1658032404360,COGS 14A,A01,092681,Semenuks; Arturs,5,1,100,95
1658032410383,COGS 14B,A01,083073,Cheng; Tzu-Han,7,0,63,56
1658032416407,COGS 17,A01,092677,Semenuks; Arturs,7,0,81,74
1658032422430,COGS 100,A01,083619,Allen; Michael Gordon,17,0,70,53
1658032428458,COGS 101A,A01,083621,Davis; Joshua Daniel,9,0,68,59
1658032434484,COGS 101B,A01,091572,Allen; Michael Gordon,14,0,65,51
1658032440510,COGS 101C,A01,083625,Delgado; Tania,17,0,35,18
1658032446534,COGS 107A,A01,083627,Boyle; Mary E. T.,14,0,60,46
1658032452559,COGS 118A,A01,083075,Gupta; Anjum,21,0,76,55
1658032458581,CSE 3,A50,083646,Miranda; Gregory Joseph,24,0,50,26
1658032464608,CSE 8A,A50,083650,Miranda; Gregory Joseph,17,1,56,39
1658032470630,CSE 11,A01,083080,Cao; Yingjun,7,15,40,33
1658032476657,CSE 12,A01,083652,Krause-Levy; Sophia Louisa,30,1,120,90
1658032482679,CSE 15L,A01,083654,Morris; Justin Loren,9,0,50,41
1658032482679,CSE 15L,A02,083655,Morris; Justin Loren,11,0,50,39
1658032488705,CSE 20,A01,083657,Tran; Khoa Dang,39,0,80,41
1658032494731,CSE 21,A01,095574,Bach; Quang Tran,23,0,48,25
1658032500754,CSE 30,A01,083084,Eldon; John,8,0,80,72
1658032500754,CSE 30,B01,095061,Bhaskar; Nishant,9,0,50,41
1658032506777,CSE 100,A01,083659,Cao; Yingjun,5,4,70,65
1658032512799,CSE 134B,A01,083661,Powell; Thomas Allan,25,0,100,75
1658032518825,CSE 140,A01,083663,Gungor; Onat,17,0,85,68
1658032524846,CSE 140L,A01,083088,Eldon; John,23,0,100,77
1658032530868,CSE 175,A01,083665,Kumar; Rakesh,3,0,25,22
1658032536893,CSE 190,A00,092507,Dubnov; Shlomo,8,0,20,12
1658032542916,ECE 45,A01,083139,Congero; Spencer William,7,0,75,68
1658032548939,ECE 65,A50,083695,Saad; Andrew S,12,0,30,18
1658032548939,ECE 65,A51,095125,Saad; Andrew S,24,0,26,2
1658032554962,ECE 109,A01,091882,Touri; Behrouz,21,0,70,49
1658032560988,ECE 180,A00,083140,Abi Samra; Nicholas Camill,1,0,30,29
1658032560988,ECE 180,B00,083141,Abi Samra; Nicholas Camill,0,0,30,30
1658032567016,MATH 10A,A01,083735,Patchell; Gregory David,2,0,30,28
1658032567016,MATH 10A,A02,083736,Patchell; Gregory David,20,0,30,10
1658032567016,MATH 10A,A03,083737,Patchell; Gregory David,16,0,30,14
1658032573050,MATH 10B,A01,083207,Lim; Seonhee,9,0,34,25
1658032573050,MATH 10B,A02,083208,Lim; Seonhee,10,0,35,25
1658032573050,MATH 10B,A03,093472,Lim; Seonhee,7,0,34,27
1658032573050,MATH 10B,B01,083739,Sinha; Shubham,14,0,30,16
1658032579074,MATH 18,A01,083743,Cinel; Cameron Alexander,9,0,30,21
1658032579074,MATH 18,A02,083744,Cinel; Cameron Alexander,18,0,30,12
1658032579074,MATH 18,A03,083745,Cinel; Cameron Alexander,10,0,30,20
1658032579074,MATH 18,B01,083748,Rideout; David Porter,5,0,37,32
1658032579074,MATH 18,B02,083749,Rideout; David Porter,5,0,36,31
1658032579074,MATH 18,B03,083750,Rideout; David Porter,3,0,37,34
1658032579074,MATH 18,B04,083751,Rideout; David Porter,7,0,36,29
1658032579074,MATH 18,B05,093473,Rideout; David Porter,7,0,36,29
1658032579074,MATH 18,B06,093474,Rideout; David Porter,6,0,36,30
1658032585099,MATH 20A,A01,083754,Zheng; Zequn,14,0,40,26
1658032591122,MATH 20B,A01,083756,Briones; Jor-el Thomas Caparas,4,0,36,32
1658032591122,MATH 20B,A02,083757,Briones; Jor-el Thomas Caparas,1,0,36,35
1658032591122,MATH 20B,A03,093475,Briones; Jor-el Thomas Caparas,3,0,36,33
1658032597144,MATH 20C,A01,083760,Briones; Jor-el Thomas Caparas,1,0,35,34
1658032597144,MATH 20C,A02,083761,Briones; Jor-el Thomas Caparas,8,0,35,27
1658032597144,MATH 20C,A03,093476,Briones; Jor-el Thomas Caparas,0,1,36,36
1658032597144,MATH 20C,B01,083762,Bach; Quang Tran,1,0,30,29
1658032603168,MATH 20D,A01,083765,Tran; Brian Kha,5,0,30,25
1658032603168,MATH 20D,A02,083766,Tran; Brian Kha,5,0,30,25
1658032603168,MATH 20D,A03,083767,Tran; Brian Kha,6,0,30,24
1658032609203,MATH 20E,A01,083771,Ganguly; Soumya,12,0,32,20
1658032609203,MATH 20E,A02,083772,Ganguly; Soumya,7,0,32,25
1658032609203,MATH 20E,B01,083773,Ciotti; Benjamin,20,0,35,15
1658032609203,MATH 20E,B02,083774,Ciotti; Benjamin,18,0,35,17
1658032615226,MATH 103A,A01,083777,Greenfeld; Be'Eri,6,0,36,30
1658032615226,MATH 103A,A02,083778,Greenfeld; Be'Eri,5,0,36,31
1658032615226,MATH 103A,A03,093561,Greenfeld; Be'Eri,7,0,36,29
1658032615226,MATH 103A,B01,083779,Greenfeld; Be'Eri,8,0,36,28
1658032615226,MATH 103A,B02,083780,Greenfeld; Be'Eri,4,0,36,32
1658032615226,MATH 103A,B03,093562,Greenfeld; Be'Eri,3,0,36,33
1658032621253,MATH 105,A01,085443,Carter; Anne Toulson,15,0,35,20
1658032621253,MATH 105,A02,093477,Carter; Anne Toulson,20,0,35,15
1658032627276,MATH 109,A01,083213,Ganzberger; Geoffrey Michael,3,0,34,31
1658032627276,MATH 109,A02,083214,Ganzberger; Geoffrey Michael,4,0,34,30
1658032627276,MATH 109,A03,093478,Ganzberger; Geoffrey Michael,2,0,34,32
1658032627276,MATH 109,B01,083215,Ganzberger; Geoffrey Michael,3,0,32,29
1658032627276,MATH 109,B02,083216,Ganzberger; Geoffrey Michael,3,0,32,29
1658032627276,MATH 109,B03,093479,Ganzberger; Geoffrey Michael,8,0,32,24
1658032633315,MATH 142A,A01,083219,Chow; Bennett,7,0,32,25
1658032633315,MATH 142A,A02,083220,Chow; Bennett,10,0,32,22
1658032633315,MATH 142A,A03,093480,Chow; Bennett,9,0,32,23
1658032633315,MATH 142A,B03,093481,Chow; Bennett,8,0,32,24
1658032633315,MATH 142A,B04,093558,Chow; Bennett,14,0,32,18
1658032633315,MATH 142A,B05,093559,Chow; Bennett,7,0,32,25
1658032639343,MATH 193A,A01,083224,Rotar; Vladimir,9,0,34,25
1658032639343,MATH 193A,A02,083225,Rotar; Vladimir,11,0,34,23
1658032639343,MATH 193A,A03,083781,Rotar; Vladimir,5,0,34,29
1658032639343,MATH 193A,A04,083782,Rotar; Vladimir,12,0,34,22
1658032639343,MATH 193A,A05,093482,Rotar; Vladimir,11,0,34,23
1658032645367,MATH 197,001,091859,McAuley; Julian John,9999,0,9999,0
1658032645367,MATH 197,002,095566,Kedlaya; Kiran S.,9997,0,9999,2
1658032645367,MATH 197,003,095567,Xiao; Ming,9999,0,9999,0
1658032645367,MATH 197,004,095571,Perols; Johan Lars,9998,0,9999,1
1658032652431,COGS 9,A01,083615,Shannon; Kyle Michael,11,0,75,64
1658032658458,COGS 11,A01,083617,Boyle; Mary E. T.,23,0,48,25
1658032664482,COGS 13,A01,083071,Bastos; Amalia Pinkusfeld,12,0,71,59
1658032670504,COGS 14A,A01,092681,Semenuks; Arturs,5,1,100,95
1658032676526,COGS 14B,A01,083073,Cheng; Tzu-Han,7,0,63,56
1658032682550,COGS 17,A01,092677,Semenuks; Arturs,7,0,81,74
1658032688574,COGS 100,A01,083619,Allen; Michael Gordon,17,0,70,53
1658032694601,COGS 101A,A01,083621,Davis; Joshua Daniel,9,0,68,59
1658032700629,COGS 101B,A01,091572,Allen; Michael Gordon,14,0,65,51
1658032706653,COGS 101C,A01,083625,Delgado; Tania,17,0,35,18
1658032712679,COGS 107A,A01,083627,Boyle; Mary E. T.,14,0,60,46
1658032718703,COGS 118A,A01,083075,Gupta; Anjum,21,0,76,55
1658032724728,CSE 3,A50,083646,Miranda; Gregory Joseph,24,0,50,26
1658032730752,CSE 8A,A50,083650,Miranda; Gregory Joseph,17,1,56,39
1658032736779,CSE 11,A01,083080,Cao; Yingjun,7,15,40,33
1658032742963,CSE 12,A01,083652,Krause-Levy; Sophia Louisa,30,1,120,90
1658032748986,CSE 15L,A01,083654,Morris; Justin Loren,9,0,50,41
1658032748986,CSE 15L,A02,083655,Morris; Justin Loren,11,0,50,39
1658032755011,CSE 20,A01,083657,Tran; Khoa Dang,39,0,80,41
1658032761034,CSE 21,A01,095574,Bach; Quang Tran,23,0,48,25
1658032767060,CSE 30,A01,083084,Eldon; John,8,0,80,72
1658032767060,CSE 30,B01,095061,Bhaskar; Nishant,9,0,50,41
1658032773083,CSE 100,A01,083659,Cao; Yingjun,5,4,70,65
1658032779112,CSE 134B,A01,083661,Powell; Thomas Allan,25,0,100,75
1658032785139,CSE 140,A01,083663,Gungor; Onat,17,0,85,68
1658032791161,CSE 140L,A01,083088,Eldon; John,23,0,100,77
1658032797184,CSE 175,A01,083665,Kumar; Rakesh,3,0,25,22
1658032803210,CSE 190,A00,092507,Dubnov; Shlomo,8,0,20,12
1658032809232,ECE 45,A01,083139,Congero; Spencer William,7,0,75,68
1658032815272,ECE 65,A50,083695,Saad; Andrew S,12,0,30,18
1658032815272,ECE 65,A51,095125,Saad; Andrew S,24,0,26,2
1658032821298,ECE 109,A01,091882,Touri; Behrouz,21,0,70,49
1658032827321,ECE 180,A00,083140,Abi Samra; Nicholas Camill,1,0,30,29
1658032827321,ECE 180,B00,083141,Abi Samra; Nicholas Camill,0,0,30,30
1658032833349,MATH 10A,A01,083735,Patchell; Gregory David,2,0,30,28
1658032833349,MATH 10A,A02,083736,Patchell; Gregory David,20,0,30,10
1658032833349,MATH 10A,A03,083737,Patchell; Gregory David,16,0,30,14
1658032839373,MATH 10B,A01,083207,Lim; Seonhee,9,0,34,25
1658032839373,MATH 10B,A02,083208,Lim; Seonhee,10,0,35,25
1658032839373,MATH 10B,A03,093472,Lim; Seonhee,7,0,34,27
1658032839373,MATH 10B,B01,083739,Sinha; Shubham,14,0,30,16
1658032845396,MATH 18,A01,083743,Cinel; Cameron Alexander,9,0,30,21
1658032845396,MATH 18,A02,083744,Cinel; Cameron Alexander,18,0,30,12
1658032845396,MATH 18,A03,083745,Cinel; Cameron Alexander,10,0,30,20
1658032845396,MATH 18,B01,083748,Rideout; David Porter,5,0,37,32
1658032845396,MATH 18,B02,083749,Rideout; David Porter,5,0,36,31
1658032845396,MATH 18,B03,083750,Rideout; David Porter,3,0,37,34
1658032845396,MATH 18,B04,083751,Rideout; David Porter,7,0,36,29
1658032845396,MATH 18,B05,093473,Rideout; David Porter,7,0,36,29
1658032845396,MATH 18,B06,093474,Rideout; David Porter,6,0,36,30
1658032851419,MATH 20A,A01,083754,Zheng; Zequn,14,0,40,26
1658032857443,MATH 20B,A01,083756,Briones; Jor-el Thomas Caparas,4,0,36,32
1658032857443,MATH 20B,A02,083757,Briones; Jor-el Thomas Caparas,1,0,36,35
1658032857443,MATH 20B,A03,093475,Briones; Jor-el Thomas Caparas,3,0,36,33
1658032863471,MATH 20C,A01,083760,Briones; Jor-el Thomas Caparas,1,0,35,34
1658032863471,MATH 20C,A02,083761,Briones; Jor-el Thomas Caparas,8,0,35,27
1658032863471,MATH 20C,A03,093476,Briones; Jor-el Thomas Caparas,0,1,36,36
1658032863471,MATH 20C,B01,083762,Bach; Quang Tran,1,0,30,29
1658032869500,MATH 20D,A01,083765,Tran; Brian Kha,5,0,30,25
1658032869500,MATH 20D,A02,083766,Tran; Brian Kha,5,0,30,25
1658032869500,MATH 20D,A03,083767,Tran; Brian Kha,6,0,30,24
1658032875529,MATH 20E,A01,083771,Ganguly; Soumya,12,0,32,20
1658032875529,MATH 20E,A02,083772,Ganguly; Soumya,7,0,32,25
1658032875529,MATH 20E,B01,083773,Ciotti; Benjamin,20,0,35,15
1658032875529,MATH 20E,B02,083774,Ciotti; Benjamin,18,0,35,17
1658032881561,MATH 103A,A01,083777,Greenfeld; Be'Eri,6,0,36,30
1658032881561,MATH 103A,A02,083778,Greenfeld; Be'Eri,5,0,36,31
1658032881561,MATH 103A,A03,093561,Greenfeld; Be'Eri,7,0,36,29
1658032881561,MATH 103A,B01,083779,Greenfeld; Be'Eri,8,0,36,28
1658032881561,MATH 103A,B02,083780,Greenfeld; Be'Eri,4,0,36,32
1658032881561,MATH 103A,B03,093562,Greenfeld; Be'Eri,3,0,36,33
1658032887590,MATH 105,A01,085443,Carter; Anne Toulson,15,0,35,20
1658032887590,MATH 105,A02,093477,Carter; Anne Toulson,20,0,35,15
1658032893619,MATH 109,A01,083213,Ganzberger; Geoffrey Michael,3,0,34,31
1658032893619,MATH 109,A02,083214,Ganzberger; Geoffrey Michael,4,0,34,30
1658032893619,MATH 109,A03,093478,Ganzberger; Geoffrey Michael,2,0,34,32
1658032893619,MATH 109,B01,083215,Ganzberger; Geoffrey Michael,3,0,32,29
1658032893619,MATH 109,B02,083216,Ganzberger; Geoffrey Michael,3,0,32,29
1658032893619,MATH 109,B03,093479,Ganzberger; Geoffrey Michael,8,0,32,24
1658032899664,MATH 142A,A01,083219,Chow; Bennett,7,0,32,25
1658032899664,MATH 142A,A02,083220,Chow; Bennett,10,0,32,22
1658032899664,MATH 142A,A03,093480,Chow; Bennett,9,0,32,23
1658032899664,MATH 142A,B03,093481,Chow; Bennett,8,0,32,24
1658032899664,MATH 142A,B04,093558,Chow; Bennett,14,0,32,18
1658032899664,MATH 142A,B05,093559,Chow; Bennett,7,0,32,25
1658032905692,MATH 193A,A01,083224,Rotar; Vladimir,9,0,34,25
1658032905692,MATH 193A,A02,083225,Rotar; Vladimir,11,0,34,23
1658032905692,MATH 193A,A03,083781,Rotar; Vladimir,5,0,34,29
1658032905692,MATH 193A,A04,083782,Rotar; Vladimir,12,0,34,22
1658032905692,MATH 193A,A05,093482,Rotar; Vladimir,11,0,34,23
1658032911719,MATH 197,001,091859,McAuley; Julian John,9999,0,9999,0
1658032911719,MATH 197,002,095566,Kedlaya; Kiran S.,9997,0,9999,2
1658032911719,MATH 197,003,095567,Xiao; Ming,9999,0,9999,0
1658032911719,MATH 197,004,095571,Perols; Johan Lars,9998,0,9999,1
1658032918773,COGS 9,A01,083615,Shannon; Kyle Michael,11,0,75,64
1658032924799,COGS 11,A01,083617,Boyle; Mary E. T.,23,0,48,25
1658032930821,COGS 13,A01,083071,Bastos; Amalia Pinkusfeld,12,0,71,59
1658032936844,COGS 14A,A01,092681,Semenuks; Arturs,5,1,100,95
1658032942870,COGS 14B,A01,083073,Cheng; Tzu-Han,7,0,63,56
1658032948898,COGS 17,A01,092677,Semenuks; Arturs,7,0,81,74
1658032954921,COGS 100,A01,083619,Allen; Michael Gordon,17,0,70,53
1658032960951,COGS 101A,A01,083621,Davis; Joshua Daniel,9,0,68,59
1658032966978,COGS 101B,A01,091572,Allen; Michael Gordon,14,0,65,51
1658032973001,COGS 101C,A01,083625,Delgado; Tania,17,0,35,18
1658032979024,COGS 107A,A01,083627,Boyle; Mary E. T.,14,0,60,46
1658032985050,COGS 118A,A01,083075,Gupta; Anjum,21,0,76,55
1658032991077,CSE 3,A50,083646,Miranda; Gregory Joseph,24,0,50,26
1658032997103,CSE 8A,A50,083650,Miranda; Gregory Joseph,17,1,56,39
1658033003125,CSE 11,A01,083080,Cao; Yingjun,7,15,40,33
1658033009146,CSE 12,A01,083652,Krause-Levy; Sophia Louisa,30,1,120,90
1658033015171,CSE 15L,A01,083654,Morris; Justin Loren,9,0,50,41
1658033015171,CSE 15L,A02,083655,Morris; Justin Loren,11,0,50,39
1658033021193,CSE 20,A01,083657,Tran; Khoa Dang,39,0,80,41
1658033027219,CSE 21,A01,095574,Bach; Quang Tran,23,0,48,25
1658033033248,CSE 30,A01,083084,Eldon; John,8,0,80,72
1658033033248,CSE 30,B01,095061,Bhaskar; Nishant,9,0,50,41
1658033039271,CSE 100,A01,083659,Cao; Yingjun,5,4,70,65
1658033045297,CSE 134B,A01,083661,Powell; Thomas Allan,25,0,100,75
1658033051323,CSE 140,A01,083663,Gungor; Onat,17,0,85,68
1658033057346,CSE 140L,A01,083088,Eldon; John,23,0,100,77
1658033063367,CSE 175,A01,083665,Kumar; Rakesh,3,0,25,22
1658033069391,CSE 190,A00,092507,Dubnov; Shlomo,8,0,20,12
1658033075415,ECE 45,A01,083139,Congero; Spencer William,7,0,75,68
1658033081439,ECE 65,A50,083695,Saad; Andrew S,12,0,30,18
1658033081439,ECE 65,A51,095125,Saad; Andrew S,24,0,26,2
1658033087464,ECE 109,A01,091882,Touri; Behrouz,21,0,70,49
1658033093486,ECE 180,A00,083140,Abi Samra; Nicholas Camill,1,0,30,29
1658033093486,ECE 180,B00,083141,Abi Samra; Nicholas Camill,0,0,30,30
1658033099519,MATH 10A,A01,083735,Patchell; Gregory David,2,0,30,28
1658033099519,MATH 10A,A02,083736,Patchell; Gregory David,20,0,30,10
1658033099519,MATH 10A,A03,083737,Patchell; Gregory David,16,0,30,14
1658033105546,MATH 10B,A01,083207,Lim; Seonhee,9,0,34,25
1658033105546,MATH 10B,A02,083208,Lim; Seonhee,10,0,35,25
1658033105546,MATH 10B,A03,093472,Lim; Seonhee,7,0,34,27
1658033105546,MATH 10B,B01,083739,Sinha; Shubham,14,0,30,16
1658033111577,MATH 18,A01,083743,Cinel; Cameron Alexander,9,0,30,21
1658033111577,MATH 18,A02,083744,Cinel; Cameron Alexander,18,0,30,12
1658033111577,MATH 18,A03,083745,Cinel; Cameron Alexander,10,0,30,20
1658033111577,MATH 18,B01,083748,Rideout; David Porter,5,0,37,32
1658033111577,MATH 18,B02,083749,Rideout; David Porter,5,0,36,31
1658033111577,MATH 18,B03,083750,Rideout; David Porter,3,0,37,34
1658033111577,MATH 18,B04,083751,Rideout; David Porter,7,0,36,29
1658033111577,MATH 18,B05,093473,Rideout; David Porter,7,0,36,29
1658033111577,MATH 18,B06,093474,Rideout; David Porter,6,0,36,30
1658033117602,MATH 20A,A01,083754,Zheng; Zequn,14,0,40,26
1658033123627,MATH 20B,A01,083756,Briones; Jor-el Thomas Caparas,4,0,36,32
1658033123627,MATH 20B,A02,083757,Briones; Jor-el Thomas Caparas,1,0,36,35
1658033123627,MATH 20B,A03,093475,Briones; Jor-el Thomas Caparas,3,0,36,33
1658033129659,MATH 20C,A01,083760,Briones; Jor-el Thomas Caparas,1,0,35,34
1658033129659,MATH 20C,A02,083761,Briones; Jor-el Thomas Caparas,8,0,35,27
1658033129659,MATH 20C,A03,093476,Briones; Jor-el Thomas Caparas,0,1,36,36
1658033129659,MATH 20C,B01,083762,Bach; Quang Tran,1,0,30,29
1658033135687,MATH 20D,A01,083765,Tran; Brian Kha,5,0,30,25
1658033135687,MATH 20D,A02,083766,Tran; Brian Kha,5,0,30,25
1658033135687,MATH 20D,A03,083767,Tran; Brian Kha,6,0,30,24
1658033141711,MATH 20E,A01,083771,Ganguly; Soumya,12,0,32,20
1658033141711,MATH 20E,A02,083772,Ganguly; Soumya,7,0,32,25
1658033141711,MATH 20E,B01,083773,Ciotti; Benjamin,20,0,35,15
1658033141711,MATH 20E,B02,083774,Ciotti; Benjamin,18,0,35,17
1658033147736,MATH 103A,A01,083777,Greenfeld; Be'Eri,6,0,36,30
1658033147736,MATH 103A,A02,083778,Greenfeld; Be'Eri,5,0,36,31
1658033147736,MATH 103A,A03,093561,Greenfeld; Be'Eri,7,0,36,29
1658033147736,MATH 103A,B01,083779,Greenfeld; Be'Eri,8,0,36,28
1658033147736,MATH 103A,B02,083780,Greenfeld; Be'Eri,4,0,36,32
1658033147736,MATH 103A,B03,093562,Greenfeld; Be'Eri,3,0,36,33
1658033153759,MATH 105,A01,085443,Carter; Anne Toulson,15,0,35,20
1658033153759,MATH 105,A02,093477,Carter; Anne Toulson,20,0,35,15
1658033159786,MATH 109,A01,083213,Ganzberger; Geoffrey Michael,3,0,34,31
1658033159786,MATH 109,A02,083214,Ganzberger; Geoffrey Michael,4,0,34,30
1658033159786,MATH 109,A03,093478,Ganzberger; Geoffrey Michael,2,0,34,32
1658033159786,MATH 109,B01,083215,Ganzberger; Geoffrey Michael,3,0,32,29
1658033159786,MATH 109,B02,083216,Ganzberger; Geoffrey Michael,3,0,32,29
1658033159786,MATH 109,B03,093479,Ganzberger; Geoffrey Michael,8,0,32,24
1658033165815,MATH 142A,A01,083219,Chow; Bennett,7,0,32,25
1658033165815,MATH 142A,A02,083220,Chow; Bennett,10,0,32,22
1658033165815,MATH 142A,A03,093480,Chow; Bennett,9,0,32,23
1658033165815,MATH 142A,B03,093481,Chow; Bennett,8,0,32,24
1658033165815,MATH 142A,B04,093558,Chow; Bennett,14,0,32,18
1658033165815,MATH 142A,B05,093559,Chow; Bennett,7,0,32,25
1658033171838,MATH 193A,A01,083224,Rotar; Vladimir,9,0,34,25
1658033171838,MATH 193A,A02,083225,Rotar; Vladimir,11,0,34,23
1658033171838,MATH 193A,A03,083781,Rotar; Vladimir,5,0,34,29
1658033171838,MATH 193A,A04,083782,Rotar; Vladimir,12,0,34,22
1658033171838,MATH 193A,A05,093482,Rotar; Vladimir,11,0,34,23
1658033177861,MATH 197,001,091859,McAuley; Julian John,9999,0,9999,0
1658033177861,MATH 197,002,095566,Kedlaya; Kiran S.,9997,0,9999,2
1658033177861,MATH 197,003,095567,Xiao; Ming,9999,0,9999,0
1658033177861,MATH 197,004,095571,Perols; Johan Lars,9998,0,9999,1
1658033184914,COGS 9,A01,083615,Shannon; Kyle Michael,11,0,75,64
1658033190945,COGS 11,A01,083617,Boyle; Mary E. T.,23,0,48,25
1658033196968,COGS 13,A01,083071,Bastos; Amalia Pinkusfeld,12,0,71,59
1658033202995,COGS 14A,A01,092681,Semenuks; Arturs,5,1,100,95
1658033209021,COGS 14B,A01,083073,Cheng; Tzu-Han,7,0,63,56
1658033215045,COGS 17,A01,092677,Semenuks; Arturs,7,0,81,74
1658033221068,COGS 100,A01,083619,Allen; Michael Gordon,17,0,70,53
1658033227090,COGS 101A,A01,083621,Davis; Joshua Daniel,9,0,68,59
1658033233115,COGS 101B,A01,091572,Allen; Michael Gordon,14,0,65,51
1658033239137,COGS 101C,A01,083625,Delgado; Tania,17,0,35,18
1658033245171,COGS 107A,A01,083627,Boyle; Mary E. T.,14,0,60,46
1658033251210,COGS 118A,A01,083075,Gupta; Anjum,21,0,76,55
1658033257235,CSE 3,A50,083646,Miranda; Gregory Joseph,24,0,50,26
1658033263258,CSE 8A,A50,083650,Miranda; Gregory Joseph,17,1,56,39
1658033269282,CSE 11,A01,083080,Cao; Yingjun,7,15,40,33
1658033275305,CSE 12,A01,083652,Krause-Levy; Sophia Louisa,30,1,120,90
1658033281330,CSE 15L,A01,083654,Morris; Justin Loren,9,0,50,41
1658033281330,CSE 15L,A02,083655,Morris; Justin Loren,11,0,50,39
1658033287356,CSE 20,A01,083657,Tran; Khoa Dang,39,0,80,41
1658033293380,CSE 21,A01,095574,Bach; Quang Tran,23,0,48,25
1658033299406,CSE 30,A01,083084,Eldon; John,8,0,80,72
1658033299406,CSE 30,B01,095061,Bhaskar; Nishant,9,0,50,41
1658033305430,CSE 100,A01,083659,Cao; Yingjun,5,4,70,65
1658033311457,CSE 134B,A01,083661,Powell; Thomas Allan,25,0,100,75
1658033317483,CSE 140,A01,083663,Gungor; Onat,17,0,85,68
1658033323506,CSE 140L,A01,083088,Eldon; John,23,0,100,77
1658033329532,CSE 175,A01,083665,Kumar; Rakesh,3,0,25,22
1658033335556,CSE 190,A00,092507,Dubnov; Shlomo,8,0,20,12
1658033341694,ECE 45,A01,083139,Congero; Spencer William,7,0,75,68
1658033347721,ECE 65,A50,083695,Saad; Andrew S,12,0,30,18
1658033347721,ECE 65,A51,095125,Saad; Andrew S,24,0,26,2
1658033353744,ECE 109,A01,091882,Touri; Behrouz,21,0,70,49
1658033359768,ECE 180,A00,083140,Abi Samra; Nicholas Camill,1,0,30,29
1658033359768,ECE 180,B00,083141,Abi Samra; Nicholas Camill,0,0,30,30
1658033365794,MATH 10A,A01,083735,Patchell; Gregory David,2,0,30,28
1658033365794,MATH 10A,A02,083736,Patchell; Gregory David,20,0,30,10
1658033365794,MATH 10A,A03,083737,Patchell; Gregory David,16,0,30,14
1658033371818,MATH 10B,A01,083207,Lim; Seonhee,9,0,34,25
1658033371818,MATH 10B,A02,083208,Lim; Seonhee,10,0,35,25
1658033371818,MATH 10B,A03,093472,Lim; Seonhee,7,0,34,27
1658033371818,MATH 10B,B01,083739,Sinha; Shubham,14,0,30,16
1658033377840,MATH 18,A01,083743,Cinel; Cameron Alexander,9,0,30,21
1658033377840,MATH 18,A02,083744,Cinel; Cameron Alexander,18,0,30,12
1658033377840,MATH 18,A03,083745,Cinel; Cameron Alexander,10,0,30,20
1658033377840,MATH 18,B01,083748,Rideout; David Porter,5,0,37,32
1658033377840,MATH 18,B02,083749,Rideout; David Porter,5,0,36,31
1658033377840,MATH 18,B03,083750,Rideout; David Porter,3,0,37,34
1658033377840,MATH 18,B04,083751,Rideout; David Porter,7,0,36,29
1658033377840,MATH 18,B05,093473,Rideout; David Porter,7,0,36,29
1658033377840,MATH 18,B06,093474,Rideout; David Porter,6,0,36,30
1658033383863,MATH 20A,A01,083754,Zheng; Zequn,14,0,40,26
1658033389891,MATH 20B,A01,083756,Briones; Jor-el Thomas Caparas,4,0,36,32
1658033389891,MATH 20B,A02,083757,Briones; Jor-el Thomas Caparas,1,0,36,35
1658033389891,MATH 20B,A03,093475,Briones; Jor-el Thomas Caparas,3,0,36,33
1658033395914,MATH 20C,A01,083760,Briones; Jor-el Thomas Caparas,1,0,35,34
1658033395914,MATH 20C,A02,083761,Briones; Jor-el Thomas Caparas,8,0,35,27
1658033395914,MATH 20C,A03,093476,Briones; Jor-el Thomas Caparas,0,1,36,36
1658033395914,MATH 20C,B01,083762,Bach; Quang Tran,1,0,30,29
1658033401943,MATH 20D,A01,083765,Tran; Brian Kha,5,0,30,25
1658033401943,MATH 20D,A02,083766,Tran; Brian Kha,5,0,30,25
1658033401943,MATH 20D,A03,083767,Tran; Brian Kha,6,0,30,24
1658033407965,MATH 20E,A01,083771,Ganguly; Soumya,12,0,32,20
1658033407965,MATH 20E,A02,083772,Ganguly; Soumya,7,0,32,25
1658033407965,MATH 20E,B01,083773,Ciotti; Benjamin,20,0,35,15
1658033407965,MATH 20E,B02,083774,Ciotti; Benjamin,18,0,35,17
1658033413994,MATH 103A,A01,083777,Greenfeld; Be'Eri,6,0,36,30
1658033413994,MATH 103A,A02,083778,Greenfeld; Be'Eri,5,0,36,31
1658033413994,MATH 103A,A03,093561,Greenfeld; Be'Eri,7,0,36,29
1658033413994,MATH 103A,B01,083779,Greenfeld; Be'Eri,8,0,36,28
1658033413994,MATH 103A,B02,083780,Greenfeld; Be'Eri,4,0,36,32
1658033413994,MATH 103A,B03,093562,Greenfeld; Be'Eri,3,0,36,33
1658033420017,MATH 105,A01,085443,Carter; Anne Toulson,15,0,35,20
1658033420017,MATH 105,A02,093477,Carter; Anne Toulson,20,0,35,15
1658033426043,MATH 109,A01,083213,Ganzberger; Geoffrey Michael,3,0,34,31
1658033426043,MATH 109,A02,083214,Ganzberger; Geoffrey Michael,4,0,34,30
1658033426043,MATH 109,A03,093478,Ganzberger; Geoffrey Michael,2,0,34,32
1658033426043,MATH 109,B01,083215,Ganzberger; Geoffrey Michael,3,0,32,29
1658033426043,MATH 109,B02,083216,Ganzberger; Geoffrey Michael,3,0,32,29
1658033426043,MATH 109,B03,093479,Ganzberger; Geoffrey Michael,8,0,32,24
1658033432068,MATH 142A,A01,083219,Chow; Bennett,7,0,32,25
1658033432068,MATH 142A,A02,083220,Chow; Bennett,10,0,32,22
1658033432068,MATH 142A,A03,093480,Chow; Bennett,9,0,32,23
1658033432068,MATH 142A,B03,093481,Chow; Bennett,8,0,32,24
1658033432068,MATH 142A,B04,093558,Chow; Bennett,14,0,32,18
1658033432068,MATH 142A,B05,093559,Chow; Bennett,7,0,32,25
1658033438093,MATH 193A,A01,083224,Rotar; Vladimir,9,0,34,25
1658033438093,MATH 193A,A02,083225,Rotar; Vladimir,11,0,34,23
1658033438093,MATH 193A,A03,083781,Rotar; Vladimir,5,0,34,29
1658033438093,MATH 193A,A04,083782,Rotar; Vladimir,12,0,34,22
1658033438093,MATH 193A,A05,093482,Rotar; Vladimir,11,0,34,23
1658033444115,MATH 197,001,091859,McAuley; Julian John,9999,0,9999,0
1658033444115,MATH 197,002,095566,Kedlaya; Kiran S.,9997,0,9999,2
1658033444115,MATH 197,003,095567,Xiao; Ming,9999,0,9999,0
1658033444115,MATH 197,004,095571,Perols; Johan Lars,9998,0,9999,1
1658033451174,COGS 9,A01,083615,Shannon; Kyle Michael,11,0,75,64
1658033457199,COGS 11,A01,083617,Boyle; Mary E. T.,23,0,48,25
1658033463228,COGS 13,A01,083071,Bastos; Amalia Pinkusfeld,12,0,71,59
1658033469250,COGS 14A,A01,092681,Semenuks; Arturs,5,1,100,95
1658033475283,COGS 14B,A01,083073,Cheng; Tzu-Han,7,0,63,56
1658033481310,COGS 17,A01,092677,Semenuks; Arturs,7,0,81,74
1658033487333,COGS 100,A01,083619,Allen; Michael Gordon,17,0,70,53
1658033493355,COGS 101A,A01,083621,Davis; Joshua Daniel,9,0,68,59
1658033499381,COGS 101B,A01,091572,Allen; Michael Gordon,14,0,65,51
1658033505407,COGS 101C,A01,083625,Delgado; Tania,17,0,35,18
1658033511430,COGS 107A,A01,083627,Boyle; Mary E. T.,14,0,60,46
1658033517453,COGS 118A,A01,083075,Gupta; Anjum,21,0,76,55
1658033523493,CSE 3,A50,083646,Miranda; Gregory Joseph,24,0,50,26
1658033529520,CSE 8A,A50,083650,Miranda; Gregory Joseph,17,1,56,39
1658033535544,CSE 11,A01,083080,Cao; Yingjun,7,15,40,33
1658033541572,CSE 12,A01,083652,Krause-Levy; Sophia Louisa,30,1,120,90
1658033547599,CSE 15L,A01,083654,Morris; Justin Loren,9,0,50,41
1658033547599,CSE 15L,A02,083655,Morris; Justin Loren,11,0,50,39
1658033553641,CSE 20,A01,083657,Tran; Khoa Dang,39,0,80,41
1658033559669,CSE 21,A01,095574,Bach; Quang Tran,23,0,48,25
1658033565697,CSE 30,A01,083084,Eldon; John,8,0,80,72
1658033565697,CSE 30,B01,095061,Bhaskar; Nishant,9,0,50,41
1658033571724,CSE 100,A01,083659,Cao; Yingjun,5,4,70,65
1658033577748,CSE 134B,A01,083661,Powell; Thomas Allan,25,0,100,75
1658033583778,CSE 140,A01,083663,Gungor; Onat,17,0,85,68
1658033589806,CSE 140L,A01,083088,Eldon; John,23,0,100,77
1658033595835,CSE 175,A01,083665,Kumar; Rakesh,3,0,25,22
1658033601857,CSE 190,A00,092507,Dubnov; Shlomo,8,0,20,12
1658033607880,ECE 45,A01,083139,Congero; Spencer William,7,0,75,68
1658033613904,ECE 65,A50,083695,Saad; Andrew S,12,0,30,18
1658033613904,ECE 65,A51,095125,Saad; Andrew S,24,0,26,2
1658033619934,ECE 109,A01,091882,Touri; Behrouz,21,0,70,49
1658033625957,ECE 180,A00,083140,Abi Samra; Nicholas Camill,1,0,30,29
1658033625957,ECE 180,B00,083141,Abi Samra; Nicholas Camill,0,0,30,30
1658033631985,MATH 10A,A01,083735,Patchell; Gregory David,2,0,30,28
1658033631985,MATH 10A,A02,083736,Patchell; Gregory David,20,0,30,10
1658033631985,MATH 10A,A03,083737,Patchell; Gregory David,16,0,30,14
1658033638008,MATH 10B,A01,083207,Lim; Seonhee,9,0,34,25
1658033638008,MATH 10B,A02,083208,Lim; Seonhee,10,0,35,25
1658033638008,MATH 10B,A03,093472,Lim; Seonhee,7,0,34,27
1658033638008,MATH 10B,B01,083739,Sinha; Shubham,14,0,30,16
1658033644040,MATH 18,A01,083743,Cinel; Cameron Alexander,9,0,30,21
1658033644040,MATH 18,A02,083744,Cinel; Cameron Alexander,18,0,30,12
1658033644040,MATH 18,A03,083745,Cinel; Cameron Alexander,10,0,30,20
1658033644040,MATH 18,B01,083748,Rideout; David Porter,5,0,37,32
1658033644040,MATH 18,B02,083749,Rideout; David Porter,5,0,36,31
1658033644040,MATH 18,B03,083750,Rideout; David Porter,3,0,37,34
1658033644040,MATH 18,B04,083751,Rideout; David Porter,7,0,36,29
1658033644040,MATH 18,B05,093473,Rideout; David Porter,7,0,36,29
1658033644040,MATH 18,B06,093474,Rideout; David Porter,6,0,36,30
1658033650066,MATH 20A,A01,083754,Zheng; Zequn,14,0,40,26
1658033656091,MATH 20B,A01,083756,Briones; Jor-el Thomas Caparas,4,0,36,32
1658033656091,MATH 20B,A02,083757,Briones; Jor-el Thomas Caparas,1,0,36,35
1658033656091,MATH 20B,A03,093475,Briones; Jor-el Thomas Caparas,3,0,36,33
1658033662115,MATH 20C,A01,083760,Briones; Jor-el Thomas Caparas,1,0,35,34
1658033662115,MATH 20C,A02,083761,Briones; Jor-el Thomas Caparas,8,0,35,27
1658033662115,MATH 20C,A03,093476,Briones; Jor-el Thomas Caparas,0,1,36,36
1658033662115,MATH 20C,B01,083762,Bach; Quang Tran,1,0,30,29
1658033668139,MATH 20D,A01,083765,Tran; Brian Kha,5,0,30,25
1658033668139,MATH 20D,A02,083766,Tran; Brian Kha,5,0,30,25
1658033668139,MATH 20D,A03,083767,Tran; Brian Kha,6,0,30,24
1658033674173,MATH 20E,A01,083771,Ganguly; Soumya,12,0,32,20
1658033674173,MATH 20E,A02,083772,Ganguly; Soumya,7,0,32,25
1658033674173,MATH 20E,B01,083773,Ciotti; Benjamin,20,0,35,15
1658033674173,MATH 20E,B02,083774,Ciotti; Benjamin,18,0,35,17
1658033680195,MATH 103A,A01,083777,Greenfeld; Be'Eri,6,0,36,30
1658033680195,MATH 103A,A02,083778,Greenfeld; Be'Eri,5,0,36,31
1658033680195,MATH 103A,A03,093561,Greenfeld; Be'Eri,7,0,36,29
1658033680195,MATH 103A,B01,083779,Greenfeld; Be'Eri,8,0,36,28
1658033680195,MATH 103A,B02,083780,Greenfeld; Be'Eri,4,0,36,32
1658033680195,MATH 103A,B03,093562,Greenfeld; Be'Eri,3,0,36,33
1658033686222,MATH 105,A01,085443,Carter; Anne Toulson,15,0,35,20
1658033686222,MATH 105,A02,093477,Carter; Anne Toulson,20,0,35,15
1658033692246,MATH 109,A01,083213,Ganzberger; Geoffrey Michael,3,0,34,31
1658033692246,MATH 109,A02,083214,Ganzberger; Geoffrey Michael,4,0,34,30
1658033692246,MATH 109,A03,093478,Ganzberger; Geoffrey Michael,2,0,34,32
1658033692246,MATH 109,B01,083215,Ganzberger; Geoffrey Michael,3,0,32,29
1658033692246,MATH 109,B02,083216,Ganzberger; Geoffrey Michael,3,0,32,29
1658033692246,MATH 109,B03,093479,Ganzberger; Geoffrey Michael,8,0,32,24
1658033698273,MATH 142A,A01,083219,Chow; Bennett,7,0,32,25
1658033698273,MATH 142A,A02,083220,Chow; Bennett,10,0,32,22
1658033698273,MATH 142A,A03,093480,Chow; Bennett,9,0,32,23
1658033698273,MATH 142A,B03,093481,Chow; Bennett,8,0,32,24
1658033698273,MATH 142A,B04,093558,Chow; Bennett,14,0,32,18
1658033698273,MATH 142A,B05,093559,Chow; Bennett,7,0,32,25
1658033704296,MATH 193A,A01,083224,Rotar; Vladimir,9,0,34,25
1658033704296,MATH 193A,A02,083225,Rotar; Vladimir,11,0,34,23
1658033704296,MATH 193A,A03,083781,Rotar; Vladimir,5,0,34,29
1658033704296,MATH 193A,A04,083782,Rotar; Vladimir,12,0,34,22
1658033704296,MATH 193A,A05,093482,Rotar; Vladimir,11,0,34,23
1658033710318,MATH 197,001,091859,McAuley; Julian John,9999,0,9999,0
1658033710318,MATH 197,002,095566,Kedlaya; Kiran S.,9997,0,9999,2
1658033710318,MATH 197,003,095567,Xiao; Ming,9999,0,9999,0
1658033710318,MATH 197,004,095571,Perols; Johan Lars,9998,0,9999,1
1658033717369,COGS 9,A01,083615,Shannon; Kyle Michael,11,0,75,64
1658033723397,COGS 11,A01,083617,Boyle; Mary E. T.,23,0,48,25
1658033729423,COGS 13,A01,083071,Bastos; Amalia Pinkusfeld,12,0,71,59
1658033735451,COGS 14A,A01,092681,Semenuks; Arturs,5,1,100,95
1658033741480,COGS 14B,A01,083073,Cheng; Tzu-Han,7,0,63,56
1658033747505,COGS 17,A01,092677,Semenuks; Arturs,7,0,81,74
1658033753531,COGS 100,A01,083619,Allen; Michael Gordon,17,0,70,53
1658033759563,COGS 101A,A01,083621,Davis; Joshua Daniel,9,0,68,59
1658033765588,COGS 101B,A01,091572,Allen; Michael Gordon,14,0,65,51
1658033771615,COGS 101C,A01,083625,Delgado; Tania,17,0,35,18
1658033777641,COGS 107A,A01,083627,Boyle; Mary E. T.,14,0,60,46
1658033783664,COGS 118A,A01,083075,Gupta; Anjum,21,0,76,55
1658033789690,CSE 3,A50,083646,Miranda; Gregory Joseph,24,0,50,26
1658033795718,CSE 8A,A50,083650,Miranda; Gregory Joseph,17,1,56,39
1658033801743,CSE 11,A01,083080,Cao; Yingjun,7,15,40,33
1658033807769,CSE 12,A01,083652,Krause-Levy; Sophia Louisa,30,1,120,90
1658033813793,CSE 15L,A01,083654,Morris; Justin Loren,9,0,50,41
1658033813793,CSE 15L,A02,083655,Morris; Justin Loren,11,0,50,39
1658033819824,CSE 20,A01,083657,Tran; Khoa Dang,39,0,80,41
1658033825850,CSE 21,A01,095574,Bach; Quang Tran,23,0,48,25
1658033831877,CSE 30,A01,083084,Eldon; John,8,0,80,72
1658033831877,CSE 30,B01,095061,Bhaskar; Nishant,9,0,50,41
1658033837901,CSE 100,A01,083659,Cao; Yingjun,5,4,70,65
1658033843926,CSE 134B,A01,083661,Powell; Thomas Allan,25,0,100,75
1658033849949,CSE 140,A01,083663,Gungor; Onat,17,0,85,68
1658033855973,CSE 140L,A01,083088,Eldon; John,23,0,100,77
1658033861996,CSE 175,A01,083665,Kumar; Rakesh,3,0,25,22
1658033868022,CSE 190,A00,092507,Dubnov; Shlomo,8,0,20,12
1658033874044,ECE 45,A01,083139,Congero; Spencer William,7,0,75,68
1658033880071,ECE 65,A50,083695,Saad; Andrew S,12,0,30,18
1658033880071,ECE 65,A51,095125,Saad; Andrew S,24,0,26,2
1658033886098,ECE 109,A01,091882,Touri; Behrouz,21,0,70,49
1658033892129,ECE 180,A00,083140,Abi Samra; Nicholas Camill,1,0,30,29
1658033892129,ECE 180,B00,083141,Abi Samra; Nicholas Camill,0,0,30,30
1658033898156,MATH 10A,A01,083735,Patchell; Gregory David,2,0,30,28
1658033898156,MATH 10A,A02,083736,Patchell; Gregory David,20,0,30,10
1658033898156,MATH 10A,A03,083737,Patchell; Gregory David,16,0,30,14
1658033904179,MATH 10B,A01,083207,Lim; Seonhee,9,0,34,25
1658033904179,MATH 10B,A02,083208,Lim; Seonhee,10,0,35,25
1658033904179,MATH 10B,A03,093472,Lim; Seonhee,7,0,34,27
1658033904179,MATH 10B,B01,083739,Sinha; Shubham,14,0,30,16
1658033910203,MATH 18,A01,083743,Cinel; Cameron Alexander,9,0,30,21
1658033910203,MATH 18,A02,083744,Cinel; Cameron Alexander,18,0,30,12
1658033910203,MATH 18,A03,083745,Cinel; Cameron Alexander,10,0,30,20
1658033910203,MATH 18,B01,083748,Rideout; David Porter,5,0,37,32
1658033910203,MATH 18,B02,083749,Rideout; David Porter,5,0,36,31
1658033910203,MATH 18,B03,083750,Rideout; David Porter,3,0,37,34
1658033910203,MATH 18,B04,083751,Rideout; David Porter,7,0,36,29
1658033910203,MATH 18,B05,093473,Rideout; David Porter,7,0,36,29
1658033910203,MATH 18,B06,093474,Rideout; David Porter,6,0,36,30
1658033916225,MATH 20A,A01,083754,Zheng; Zequn,14,0,40,26
1658033922249,MATH 20B,A01,083756,Briones; Jor-el Thomas Caparas,4,0,36,32
1658033922249,MATH 20B,A02,083757,Briones; Jor-el Thomas Caparas,1,0,36,35
1658033922249,MATH 20B,A03,093475,Briones; Jor-el Thomas Caparas,3,0,36,33
1658033928276,MATH 20C,A01,083760,Briones; Jor-el Thomas Caparas,1,0,35,34
1658033928276,MATH 20C,A02,083761,Briones; Jor-el Thomas Caparas,8,0,35,27
1658033928276,MATH 20C,A03,093476,Briones; Jor-el Thomas Caparas,0,1,36,36
1658033928276,MATH 20C,B01,083762,Bach; Quang Tran,1,0,30,29
1658033934303,MATH 20D,A01,083765,Tran; Brian Kha,5,0,30,25
1658033934303,MATH 20D,A02,083766,Tran; Brian Kha,5,0,30,25
1658033934303,MATH 20D,A03,083767,Tran; Brian Kha,6,0,30,24
1658033940414,MATH 20E,A01,083771,Ganguly; Soumya,12,0,32,20
1658033940414,MATH 20E,A02,083772,Ganguly; Soumya,7,0,32,25
1658033940414,MATH 20E,B01,083773,Ciotti; Benjamin,20,0,35,15
1658033940414,MATH 20E,B02,083774,Ciotti; Benjamin,18,0,35,17
1658033946454,MATH 103A,A01,083777,Greenfeld; Be'Eri,6,0,36,30
1658033946454,MATH 103A,A02,083778,Greenfeld; Be'Eri,5,0,36,31
1658033946454,MATH 103A,A03,093561,Greenfeld; Be'Eri,7,0,36,29
1658033946454,MATH 103A,B01,083779,Greenfeld; Be'Eri,8,0,36,28
1658033946454,MATH 103A,B02,083780,Greenfeld; Be'Eri,4,0,36,32
1658033946454,MATH 103A,B03,093562,Greenfeld; Be'Eri,3,0,36,33
1658033952482,MATH 105,A01,085443,Carter; Anne Toulson,15,0,35,20
1658033952482,MATH 105,A02,093477,Carter; Anne Toulson,20,0,35,15
1658033958506,MATH 109,A01,083213,Ganzberger; Geoffrey Michael,3,0,34,31
1658033958506,MATH 109,A02,083214,Ganzberger; Geoffrey Michael,4,0,34,30
1658033958506,MATH 109,A03,093478,Ganzberger; Geoffrey Michael,2,0,34,32
1658033958506,MATH 109,B01,083215,Ganzberger; Geoffrey Michael,3,0,32,29
1658033958506,MATH 109,B02,083216,Ganzberger; Geoffrey Michael,3,0,32,29
1658033958506,MATH 109,B03,093479,Ganzberger; Geoffrey Michael,8,0,32,24
1658033964530,MATH 142A,A01,083219,Chow; Bennett,7,0,32,25
1658033964530,MATH 142A,A02,083220,Chow; Bennett,10,0,32,22
1658033964530,MATH 142A,A03,093480,Chow; Bennett,9,0,32,23
1658033964530,MATH 142A,B03,093481,Chow; Bennett,8,0,32,24
1658033964530,MATH 142A,B04,093558,Chow; Bennett,14,0,32,18
1658033964530,MATH 142A,B05,093559,Chow; Bennett,7,0,32,25
1658033970557,MATH 193A,A01,083224,Rotar; Vladimir,9,0,34,25
1658033970557,MATH 193A,A02,083225,Rotar; Vladimir,11,0,34,23
1658033970557,MATH 193A,A03,083781,Rotar; Vladimir,5,0,34,29
1658033970557,MATH 193A,A04,083782,Rotar; Vladimir,12,0,34,22
1658033970557,MATH 193A,A05,093482,Rotar; Vladimir,11,0,34,23
1658033976580,MATH 197,001,091859,McAuley; Julian John,9999,0,9999,0
1658033976580,MATH 197,002,095566,Kedlaya; Kiran S.,9997,0,9999,2
1658033976580,MATH 197,003,095567,Xiao; Ming,9999,0,9999,0
1658033976580,MATH 197,004,095571,Perols; Johan Lars,9998,0,9999,1
1658033983634,COGS 9,A01,083615,Shannon; Kyle Michael,11,0,75,64
1658033989660,COGS 11,A01,083617,Boyle; Mary E. T.,23,0,48,25
1658033995687,COGS 13,A01,083071,Bastos; Amalia Pinkusfeld,12,0,71,59
1658034001728,COGS 14A,A01,092681,Semenuks; Arturs,5,1,100,95
1658034007761,COGS 14B,A01,083073,Cheng; Tzu-Han,7,0,63,56
1658034013799,COGS 17,A01,092677,Semenuks; Arturs,7,0,81,74
1658034019822,COGS 100,A01,083619,Allen; Michael Gordon,17,0,70,53
1658034025848,COGS 101A,A01,083621,Davis; Joshua Daniel,9,0,68,59
1658034031875,COGS 101B,A01,091572,Allen; Michael Gordon,14,0,65,51
1658034037899,COGS 101C,A01,083625,Delgado; Tania,17,0,35,18
1658034043925,COGS 107A,A01,083627,Boyle; Mary E. T.,14,0,60,46
1658034049948,COGS 118A,A01,083075,Gupta; Anjum,21,0,76,55
1658034055975,CSE 3,A50,083646,Miranda; Gregory Joseph,24,0,50,26
1658034062003,CSE 8A,A50,083650,Miranda; Gregory Joseph,17,1,56,39
1658034068028,CSE 11,A01,083080,Cao; Yingjun,7,15,40,33
1658034074052,CSE 12,A01,083652,Krause-Levy; Sophia Louisa,30,1,120,90
1658034080074,CSE 15L,A01,083654,Morris; Justin Loren,9,0,50,41
1658034080074,CSE 15L,A02,083655,Morris; Justin Loren,11,0,50,39
1658034086102,CSE 20,A01,083657,Tran; Khoa Dang,39,0,80,41
1658034092124,CSE 21,A01,095574,Bach; Quang Tran,23,0,48,25
1658034098152,CSE 30,A01,083084,Eldon; John,8,0,80,72
1658034098152,CSE 30,B01,095061,Bhaskar; Nishant,9,0,50,41
1658034104176,CSE 100,A01,083659,Cao; Yingjun,5,4,70,65
1658034110199,CSE 134B,A01,083661,Powell; Thomas Allan,25,0,100,75
1658034116222,CSE 140,A01,083663,Gungor; Onat,17,0,85,68
1658034122250,CSE 140L,A01,083088,Eldon; John,23,0,100,77
1658034128273,CSE 175,A01,083665,Kumar; Rakesh,3,0,25,22
1658034134296,CSE 190,A00,092507,Dubnov; Shlomo,8,0,20,12
1658034140322,ECE 45,A01,083139,Congero; Spencer William,7,0,75,68
1658034146349,ECE 65,A50,083695,Saad; Andrew S,12,0,30,18
1658034146349,ECE 65,A51,095125,Saad; Andrew S,24,0,26,2
1658034152373,ECE 109,A01,091882,Touri; Behrouz,21,0,70,49
1658034158394,ECE 180,A00,083140,Abi Samra; Nicholas Camill,1,0,30,29
1658034158394,ECE 180,B00,083141,Abi Samra; Nicholas Camill,0,0,30,30
1658034164422,MATH 10A,A01,083735,Patchell; Gregory David,2,0,30,28
1658034164422,MATH 10A,A02,083736,Patchell; Gregory David,20,0,30,10
1658034164422,MATH 10A,A03,083737,Patchell; Gregory David,16,0,30,14
1658034170447,MATH 10B,A01,083207,Lim; Seonhee,9,0,34,25
1658034170447,MATH 10B,A02,083208,Lim; Seonhee,10,0,35,25
1658034170447,MATH 10B,A03,093472,Lim; Seonhee,7,0,34,27
1658034170447,MATH 10B,B01,083739,Sinha; Shubham,14,0,30,16
1658034176478,MATH 18,A01,083743,Cinel; Cameron Alexander,9,0,30,21
1658034176478,MATH 18,A02,083744,Cinel; Cameron Alexander,18,0,30,12
1658034176478,MATH 18,A03,083745,Cinel; Cameron Alexander,10,0,30,20
1658034176478,MATH 18,B01,083748,Rideout; David Porter,5,0,37,32
1658034176478,MATH 18,B02,083749,Rideout; David Porter,5,0,36,31
1658034176478,MATH 18,B03,083750,Rideout; David Porter,3,0,37,34
1658034176478,MATH 18,B04,083751,Rideout; David Porter,7,0,36,29
1658034176478,MATH 18,B05,093473,Rideout; David Porter,7,0,36,29
1658034176478,MATH 18,B06,093474,Rideout; David Porter,6,0,36,30
1658034182506,MATH 20A,A01,083754,Zheng; Zequn,14,0,40,26
1658034188534,MATH 20B,A01,083756,Briones; Jor-el Thomas Caparas,4,0,36,32
1658034188534,MATH 20B,A02,083757,Briones; Jor-el Thomas Caparas,1,0,36,35
1658034188534,MATH 20B,A03,093475,Briones; Jor-el Thomas Caparas,3,0,36,33
1658034194558,MATH 20C,A01,083760,Briones; Jor-el Thomas Caparas,1,0,35,34
1658034194558,MATH 20C,A02,083761,Briones; Jor-el Thomas Caparas,8,0,35,27
1658034194558,MATH 20C,A03,093476,Briones; Jor-el Thomas Caparas,0,1,36,36
1658034194558,MATH 20C,B01,083762,Bach; Quang Tran,1,0,30,29
1658034200586,MATH 20D,A01,083765,Tran; Brian Kha,5,0,30,25
1658034200586,MATH 20D,A02,083766,Tran; Brian Kha,5,0,30,25
1658034200586,MATH 20D,A03,083767,Tran; Brian Kha,6,0,30,24
1658034206610,MATH 20E,A01,083771,Ganguly; Soumya,12,0,32,20
1658034206610,MATH 20E,A02,083772,Ganguly; Soumya,7,0,32,25
1658034206610,MATH 20E,B01,083773,Ciotti; Benjamin,20,0,35,15
1658034206610,MATH 20E,B02,083774,Ciotti; Benjamin,18,0,35,17
1658034212631,MATH 103A,A01,083777,Greenfeld; Be'Eri,6,0,36,30
1658034212631,MATH 103A,A02,083778,Greenfeld; Be'Eri,5,0,36,31
1658034212631,MATH 103A,A03,093561,Greenfeld; Be'Eri,7,0,36,29
1658034212631,MATH 103A,B01,083779,Greenfeld; Be'Eri,8,0,36,28
1658034212631,MATH 103A,B02,083780,Greenfeld; Be'Eri,4,0,36,32
1658034212631,MATH 103A,B03,093562,Greenfeld; Be'Eri,3,0,36,33
1658034218654,MATH 105,A01,085443,Carter; Anne Toulson,15,0,35,20
1658034218654,MATH 105,A02,093477,Carter; Anne Toulson,20,0,35,15
1658034224682,MATH 109,A01,083213,Ganzberger; Geoffrey Michael,3,0,34,31
1658034224682,MATH 109,A02,083214,Ganzberger; Geoffrey Michael,4,0,34,30
1658034224682,MATH 109,A03,093478,Ganzberger; Geoffrey Michael,2,0,34,32
1658034224682,MATH 109,B01,083215,Ganzberger; Geoffrey Michael,3,0,32,29
1658034224682,MATH 109,B02,083216,Ganzberger; Geoffrey Michael,3,0,32,29
1658034224682,MATH 109,B03,093479,Ganzberger; Geoffrey Michael,8,0,32,24
1658034230706,MATH 142A,A01,083219,Chow; Bennett,7,0,32,25
1658034230706,MATH 142A,A02,083220,Chow; Bennett,10,0,32,22
1658034230706,MATH 142A,A03,093480,Chow; Bennett,9,0,32,23
1658034230706,MATH 142A,B03,093481,Chow; Bennett,8,0,32,24
1658034230706,MATH 142A,B04,093558,Chow; Bennett,14,0,32,18
1658034230706,MATH 142A,B05,093559,Chow; Bennett,7,0,32,25
1658034236736,MATH 193A,A01,083224,Rotar; Vladimir,9,0,34,25
1658034236736,MATH 193A,A02,083225,Rotar; Vladimir,11,0,34,23
1658034236736,MATH 193A,A03,083781,Rotar; Vladimir,5,0,34,29
1658034236736,MATH 193A,A04,083782,Rotar; Vladimir,12,0,34,22
1658034236736,MATH 193A,A05,093482,Rotar; Vladimir,11,0,34,23
1658034242759,MATH 197,001,091859,McAuley; Julian John,9999,0,9999,0
1658034242759,MATH 197,002,095566,Kedlaya; Kiran S.,9997,0,9999,2
1658034242759,MATH 197,003,095567,Xiao; Ming,9999,0,9999,0
1658034242759,MATH 197,004,095571,Perols; Johan Lars,9998,0,9999,1
1658034249811,COGS 9,A01,083615,Shannon; Kyle Michael,11,0,75,64
1658034255838,COGS 11,A01,083617,Boyle; Mary E. T.,23,0,48,25
1658034261859,COGS 13,A01,083071,Bastos; Amalia Pinkusfeld,12,0,71,59
1658034267888,COGS 14A,A01,092681,Semenuks; Arturs,5,1,100,95
1658034273915,COGS 14B,A01,083073,Cheng; Tzu-Han,7,0,63,56
1658034279946,COGS 17,A01,092677,Semenuks; Arturs,7,0,81,74
1658034285973,COGS 100,A01,083619,Allen; Michael Gordon,17,0,70,53
1658034291997,COGS 101A,A01,083621,Davis; Joshua Daniel,9,0,68,59
1658034298020,COGS 101B,A01,091572,Allen; Michael Gordon,14,0,65,51
1658034304047,COGS 101C,A01,083625,Delgado; Tania,17,0,35,18
1658034310069,COGS 107A,A01,083627,Boyle; Mary E. T.,14,0,60,46
1658034316091,COGS 118A,A01,083075,Gupta; Anjum,21,0,76,55
1658034322114,CSE 3,A50,083646,Miranda; Gregory Joseph,24,0,50,26
1658034328136,CSE 8A,A50,083650,Miranda; Gregory Joseph,17,1,56,39
1658034334160,CSE 11,A01,083080,Cao; Yingjun,7,15,40,33
1658034340191,CSE 12,A01,083652,Krause-Levy; Sophia Louisa,30,1,120,90
1658034346216,CSE 15L,A01,083654,Morris; Justin Loren,9,0,50,41
1658034346216,CSE 15L,A02,083655,Morris; Justin Loren,11,0,50,39
1658034352237,CSE 20,A01,083657,Tran; Khoa Dang,39,0,80,41
1658034358264,CSE 21,A01,095574,Bach; Quang Tran,23,0,48,25
1658034364291,CSE 30,A01,083084,Eldon; John,8,0,80,72
1658034364291,CSE 30,B01,095061,Bhaskar; Nishant,9,0,50,41
1658034370313,CSE 100,A01,083659,Cao; Yingjun,5,4,70,65
1658034376335,CSE 134B,A01,083661,Powell; Thomas Allan,25,0,100,75
1658034382358,CSE 140,A01,083663,Gungor; Onat,17,0,85,68
1658034388386,CSE 140L,A01,083088,Eldon; John,23,0,100,77
1658034394411,CSE 175,A01,083665,Kumar; Rakesh,3,0,25,22
1658034400433,CSE 190,A00,092507,Dubnov; Shlomo,8,0,20,12
1658034406456,ECE 45,A01,083139,Congero; Spencer William,7,0,75,68
1658034412479,ECE 65,A50,083695,Saad; Andrew S,12,0,30,18
1658034412479,ECE 65,A51,095125,Saad; Andrew S,24,0,26,2
1658034418500,ECE 109,A01,091882,Touri; Behrouz,21,0,70,49
1658034424523,ECE 180,A00,083140,Abi Samra; Nicholas Camill,1,0,30,29
1658034424523,ECE 180,B00,083141,Abi Samra; Nicholas Camill,0,0,30,30
1658034430551,MATH 10A,A01,083735,Patchell; Gregory David,2,0,30,28
1658034430551,MATH 10A,A02,083736,Patchell; Gregory David,20,0,30,10
1658034430551,MATH 10A,A03,083737,Patchell; Gregory David,16,0,30,14
1658034436586,MATH 10B,A01,083207,Lim; Seonhee,9,0,34,25
1658034436586,MATH 10B,A02,083208,Lim; Seonhee,10,0,35,25
1658034436586,MATH 10B,A03,093472,Lim; Seonhee,7,0,34,27
1658034436586,MATH 10B,B01,083739,Sinha; Shubham,14,0,30,16
1658034442610,MATH 18,A01,083743,Cinel; Cameron Alexander,9,0,30,21
1658034442610,MATH 18,A02,083744,Cinel; Cameron Alexander,18,0,30,12
1658034442610,MATH 18,A03,083745,Cinel; Cameron Alexander,10,0,30,20
1658034442610,MATH 18,B01,083748,Rideout; David Porter,5,0,37,32
1658034442610,MATH 18,B02,083749,Rideout; David Porter,5,0,36,31
1658034442610,MATH 18,B03,083750,Rideout; David Porter,3,0,37,34
1658034442610,MATH 18,B04,083751,Rideout; David Porter,7,0,36,29
1658034442610,MATH 18,B05,093473,Rideout; David Porter,7,0,36,29
1658034442610,MATH 18,B06,093474,Rideout; David Porter,6,0,36,30
1658034448631,MATH 20A,A01,083754,Zheng; Zequn,14,0,40,26
1658034454656,MATH 20B,A01,083756,Briones; Jor-el Thomas Caparas,4,0,36,32
1658034454656,MATH 20B,A02,083757,Briones; Jor-el Thomas Caparas,1,0,36,35
1658034454656,MATH 20B,A03,093475,Briones; Jor-el Thomas Caparas,3,0,36,33
1658034460680,MATH 20C,A01,083760,Briones; Jor-el Thomas Caparas,1,0,35,34
1658034460680,MATH 20C,A02,083761,Briones; Jor-el Thomas Caparas,8,0,35,27
1658034460680,MATH 20C,A03,093476,Briones; Jor-el Thomas Caparas,0,1,36,36
1658034460680,MATH 20C,B01,083762,Bach; Quang Tran,1,0,30,29
1658034466705,MATH 20D,A01,083765,Tran; Brian Kha,5,0,30,25
1658034466705,MATH 20D,A02,083766,Tran; Brian Kha,5,0,30,25
1658034466705,MATH 20D,A03,083767,Tran; Brian Kha,6,0,30,24
1658034472731,MATH 20E,A01,083771,Ganguly; Soumya,12,0,32,20
1658034472731,MATH 20E,A02,083772,Ganguly; Soumya,7,0,32,25
1658034472731,MATH 20E,B01,083773,Ciotti; Benjamin,20,0,35,15
1658034472731,MATH 20E,B02,083774,Ciotti; Benjamin,18,0,35,17
1658034478755,MATH 103A,A01,083777,Greenfeld; Be'Eri,6,0,36,30
1658034478755,MATH 103A,A02,083778,Greenfeld; Be'Eri,5,0,36,31
1658034478755,MATH 103A,A03,093561,Greenfeld; Be'Eri,7,0,36,29
1658034478755,MATH 103A,B01,083779,Greenfeld; Be'Eri,8,0,36,28
1658034478755,MATH 103A,B02,083780,Greenfeld; Be'Eri,4,0,36,32
1658034478755,MATH 103A,B03,093562,Greenfeld; Be'Eri,3,0,36,33
1658034484783,MATH 105,A01,085443,Carter; Anne Toulson,15,0,35,20
1658034484783,MATH 105,A02,093477,Carter; Anne Toulson,20,0,35,15
1658034490812,MATH 109,A01,083213,Ganzberger; Geoffrey Michael,3,0,34,31
1658034490812,MATH 109,A02,083214,Ganzberger; Geoffrey Michael,4,0,34,30
1658034490812,MATH 109,A03,093478,Ganzberger; Geoffrey Michael,2,0,34,32
1658034490812,MATH 109,B01,083215,Ganzberger; Geoffrey Michael,3,0,32,29
1658034490812,MATH 109,B02,083216,Ganzberger; Geoffrey Michael,3,0,32,29
1658034490812,MATH 109,B03,093479,Ganzberger; Geoffrey Michael,8,0,32,24
1658034496835,MATH 142A,A01,083219,Chow; Bennett,7,0,32,25
1658034496835,MATH 142A,A02,083220,Chow; Bennett,10,0,32,22
1658034496835,MATH 142A,A03,093480,Chow; Bennett,9,0,32,23
1658034496835,MATH 142A,B03,093481,Chow; Bennett,8,0,32,24
1658034496835,MATH 142A,B04,093558,Chow; Bennett,14,0,32,18
1658034496835,MATH 142A,B05,093559,Chow; Bennett,7,0,32,25
1658034502859,MATH 193A,A01,083224,Rotar; Vladimir,9,0,34,25
1658034502859,MATH 193A,A02,083225,Rotar; Vladimir,11,0,34,23
1658034502859,MATH 193A,A03,083781,Rotar; Vladimir,5,0,34,29
1658034502859,MATH 193A,A04,083782,Rotar; Vladimir,12,0,34,22
1658034502859,MATH 193A,A05,093482,Rotar; Vladimir,11,0,34,23
1658034508883,MATH 197,001,091859,McAuley; Julian John,9999,0,9999,0
1658034508883,MATH 197,002,095566,Kedlaya; Kiran S.,9997,0,9999,2
1658034508883,MATH 197,003,095567,Xiao; Ming,9999,0,9999,0
1658034508883,MATH 197,004,095571,Perols; Johan Lars,9998,0,9999,1
1658034515938,COGS 9,A01,083615,Shannon; Kyle Michael,11,0,75,64
1658034521960,COGS 11,A01,083617,Boyle; Mary E. T.,23,0,48,25
1658034527988,COGS 13,A01,083071,Bastos; Amalia Pinkusfeld,12,0,71,59
1658034534106,COGS 14A,A01,092681,Semenuks; Arturs,5,1,100,95
1658034540132,COGS 14B,A01,083073,Cheng; Tzu-Han,7,0,63,56
1658034546157,COGS 17,A01,092677,Semenuks; Arturs,7,0,81,74
1658034552185,COGS 100,A01,083619,Allen; Michael Gordon,17,0,70,53
1658034558208,COGS 101A,A01,083621,Davis; Joshua Daniel,9,0,68,59
1658034564231,COGS 101B,A01,091572,Allen; Michael Gordon,14,0,65,51
1658034570255,COGS 101C,A01,083625,Delgado; Tania,17,0,35,18
1658034576280,COGS 107A,A01,083627,Boyle; Mary E. T.,14,0,60,46
1658034582305,COGS 118A,A01,083075,Gupta; Anjum,21,0,76,55
1658034588337,CSE 3,A50,083646,Miranda; Gregory Joseph,24,0,50,26
1658034594360,CSE 8A,A50,083650,Miranda; Gregory Joseph,17,1,56,39
1658034600383,CSE 11,A01,083080,Cao; Yingjun,7,15,40,33
1658034606405,CSE 12,A01,083652,Krause-Levy; Sophia Louisa,30,1,120,90
1658034612429,CSE 15L,A01,083654,Morris; Justin Loren,9,0,50,41
1658034612429,CSE 15L,A02,083655,Morris; Justin Loren,11,0,50,39
1658034618456,CSE 20,A01,083657,Tran; Khoa Dang,39,0,80,41
1658034624487,CSE 21,A01,095574,Bach; Quang Tran,23,0,48,25
1658034630511,CSE 30,A01,083084,Eldon; John,8,0,80,72
1658034630511,CSE 30,B01,095061,Bhaskar; Nishant,9,0,50,41
1658034636550,CSE 100,A01,083659,Cao; Yingjun,5,4,70,65
1658034642575,CSE 134B,A01,083661,Powell; Thomas Allan,25,0,100,75
1658034648596,CSE 140,A01,083663,Gungor; Onat,17,0,85,68
1658034654619,CSE 140L,A01,083088,Eldon; John,23,0,100,77
1658034660644,CSE 175,A01,083665,Kumar; Rakesh,3,0,25,22
1658034666670,CSE 190,A00,092507,Dubnov; Shlomo,8,0,20,12
1658034672696,ECE 45,A01,083139,Congero; Spencer William,7,0,75,68
1658034678720,ECE 65,A50,083695,Saad; Andrew S,12,0,30,18
1658034678720,ECE 65,A51,095125,Saad; Andrew S,24,0,26,2
1658034684743,ECE 109,A01,091882,Touri; Behrouz,21,0,70,49
1658034690766,ECE 180,A00,083140,Abi Samra; Nicholas Camill,1,0,30,29
1658034690766,ECE 180,B00,083141,Abi Samra; Nicholas Camill,0,0,30,30
1658034696789,MATH 10A,A01,083735,Patchell; Gregory David,2,0,30,28
1658034696789,MATH 10A,A02,083736,Patchell; Gregory David,20,0,30,10
1658034696789,MATH 10A,A03,083737,Patchell; Gregory David,16,0,30,14
1658034702814,MATH 10B,A01,083207,Lim; Seonhee,9,0,34,25
1658034702814,MATH 10B,A02,083208,Lim; Seonhee,10,0,35,25
1658034702814,MATH 10B,A03,093472,Lim; Seonhee,7,0,34,27
1658034702814,MATH 10B,B01,083739,Sinha; Shubham,14,0,30,16
1658034708837,MATH 18,A01,083743,Cinel; Cameron Alexander,9,0,30,21
1658034708837,MATH 18,A02,083744,Cinel; Cameron Alexander,18,0,30,12
1658034708837,MATH 18,A03,083745,Cinel; Cameron Alexander,10,0,30,20
1658034708837,MATH 18,B01,083748,Rideout; David Porter,5,0,37,32
1658034708837,MATH 18,B02,083749,Rideout; David Porter,5,0,36,31
1658034708837,MATH 18,B03,083750,Rideout; David Porter,3,0,37,34
1658034708837,MATH 18,B04,083751,Rideout; David Porter,7,0,36,29
1658034708837,MATH 18,B05,093473,Rideout; David Porter,7,0,36,29
1658034708837,MATH 18,B06,093474,Rideout; David Porter,6,0,36,30
1658034714860,MATH 20A,A01,083754,Zheng; Zequn,14,0,40,26
1658034720888,MATH 20B,A01,083756,Briones; Jor-el Thomas Caparas,4,0,36,32
1658034720888,MATH 20B,A02,083757,Briones; Jor-el Thomas Caparas,1,0,36,35
1658034720888,MATH 20B,A03,093475,Briones; Jor-el Thomas Caparas,3,0,36,33
1658034726911,MATH 20C,A01,083760,Briones; Jor-el Thomas Caparas,1,0,35,34
1658034726911,MATH 20C,A02,083761,Briones; Jor-el Thomas Caparas,8,0,35,27
1658034726911,MATH 20C,A03,093476,Briones; Jor-el Thomas Caparas,0,1,36,36
1658034726911,MATH 20C,B01,083762,Bach; Quang Tran,1,0,30,29
1658034732935,MATH 20D,A01,083765,Tran; Brian Kha,5,0,30,25
1658034732935,MATH 20D,A02,083766,Tran; Brian Kha,5,0,30,25
1658034732935,MATH 20D,A03,083767,Tran; Brian Kha,6,0,30,24
1658034738958,MATH 20E,A01,083771,Ganguly; Soumya,12,0,32,20
1658034738958,MATH 20E,A02,083772,Ganguly; Soumya,7,0,32,25
1658034738958,MATH 20E,B01,083773,Ciotti; Benjamin,20,0,35,15
1658034738958,MATH 20E,B02,083774,Ciotti; Benjamin,18,0,35,17
1658034744982,MATH 103A,A01,083777,Greenfeld; Be'Eri,6,0,36,30
1658034744982,MATH 103A,A02,083778,Greenfeld; Be'Eri,5,0,36,31
1658034744982,MATH 103A,A03,093561,Greenfeld; Be'Eri,7,0,36,29
1658034744982,MATH 103A,B01,083779,Greenfeld; Be'Eri,8,0,36,28
1658034744982,MATH 103A,B02,083780,Greenfeld; Be'Eri,4,0,36,32
1658034744982,MATH 103A,B03,093562,Greenfeld; Be'Eri,3,0,36,33
1658034751006,MATH 105,A01,085443,Carter; Anne Toulson,15,0,35,20
1658034751006,MATH 105,A02,093477,Carter; Anne Toulson,20,0,35,15
1658034757030,MATH 109,A01,083213,Ganzberger; Geoffrey Michael,3,0,34,31
1658034757030,MATH 109,A02,083214,Ganzberger; Geoffrey Michael,4,0,34,30
1658034757030,MATH 109,A03,093478,Ganzberger; Geoffrey Michael,2,0,34,32
1658034757030,MATH 109,B01,083215,Ganzberger; Geoffrey Michael,3,0,32,29
1658034757030,MATH 109,B02,083216,Ganzberger; Geoffrey Michael,3,0,32,29
1658034757030,MATH 109,B03,093479,Ganzberger; Geoffrey Michael,8,0,32,24
1658034763054,MATH 142A,A01,083219,Chow; Bennett,7,0,32,25
1658034763054,MATH 142A,A02,083220,Chow; Bennett,10,0,32,22
1658034763054,MATH 142A,A03,093480,Chow; Bennett,9,0,32,23
1658034763054,MATH 142A,B03,093481,Chow; Bennett,8,0,32,24
1658034763054,MATH 142A,B04,093558,Chow; Bennett,14,0,32,18
1658034763054,MATH 142A,B05,093559,Chow; Bennett,7,0,32,25
1658034769079,MATH 193A,A01,083224,Rotar; Vladimir,9,0,34,25
1658034769079,MATH 193A,A02,083225,Rotar; Vladimir,11,0,34,23
1658034769079,MATH 193A,A03,083781,Rotar; Vladimir,5,0,34,29
1658034769079,MATH 193A,A04,083782,Rotar; Vladimir,12,0,34,22
1658034769079,MATH 193A,A05,093482,Rotar; Vladimir,11,0,34,23
1658034775105,MATH 197,001,091859,McAuley; Julian John,9999,0,9999,0
1658034775105,MATH 197,002,095566,Kedlaya; Kiran S.,9997,0,9999,2
1658034775105,MATH 197,003,095567,Xiao; Ming,9999,0,9999,0
1658034775105,MATH 197,004,095571,Perols; Johan Lars,9998,0,9999,1
1658034782156,COGS 9,A01,083615,Shannon; Kyle Michael,11,0,75,64
1658034788179,COGS 11,A01,083617,Boyle; Mary E. T.,23,0,48,25
1658034794207,COGS 13,A01,083071,Bastos; Amalia Pinkusfeld,12,0,71,59
1658034800233,COGS 14A,A01,092681,Semenuks; Arturs,5,1,100,95
1658034806256,COGS 14B,A01,083073,Cheng; Tzu-Han,7,0,63,56
1658034812278,COGS 17,A01,092677,Semenuks; Arturs,7,0,81,74
1658034818303,COGS 100,A01,083619,Allen; Michael Gordon,17,0,70,53
1658034824329,COGS 101A,A01,083621,Davis; Joshua Daniel,9,0,68,59
1658034830351,COGS 101B,A01,091572,Allen; Michael Gordon,14,0,65,51
1658034836374,COGS 101C,A01,083625,Delgado; Tania,17,0,35,18
1658034842402,COGS 107A,A01,083627,Boyle; Mary E. T.,14,0,60,46
1658034848424,COGS 118A,A01,083075,Gupta; Anjum,21,0,76,55
1658034854447,CSE 3,A50,083646,Miranda; Gregory Joseph,24,0,50,26
1658034860473,CSE 8A,A50,083650,Miranda; Gregory Joseph,17,1,56,39
1658034866498,CSE 11,A01,083080,Cao; Yingjun,7,15,40,33
1658034872521,CSE 12,A01,083652,Krause-Levy; Sophia Louisa,30,1,120,90
1658034878548,CSE 15L,A01,083654,Morris; Justin Loren,9,0,50,41
1658034878548,CSE 15L,A02,083655,Morris; Justin Loren,11,0,50,39
1658034884571,CSE 20,A01,083657,Tran; Khoa Dang,39,0,80,41
1658034890595,CSE 21,A01,095574,Bach; Quang Tran,23,0,48,25
1658034896624,CSE 30,A01,083084,Eldon; John,8,0,80,72
1658034896624,CSE 30,B01,095061,Bhaskar; Nishant,9,0,50,41
1658034902648,CSE 100,A01,083659,Cao; Yingjun,5,4,70,65
1658034908671,CSE 134B,A01,083661,Powell; Thomas Allan,25,0,100,75
1658034914695,CSE 140,A01,083663,Gungor; Onat,17,0,85,68
1658034920736,CSE 140L,A01,083088,Eldon; John,23,0,100,77
1658034926762,CSE 175,A01,083665,Kumar; Rakesh,3,0,25,22
1658034932785,CSE 190,A00,092507,Dubnov; Shlomo,8,0,20,12
1658034938813,ECE 45,A01,083139,Congero; Spencer William,7,0,75,68
1658034944836,ECE 65,A50,083695,Saad; Andrew S,12,0,30,18
1658034944836,ECE 65,A51,095125,Saad; Andrew S,24,0,26,2
1658034950860,ECE 109,A01,091882,Touri; Behrouz,21,0,70,49
1658034956883,ECE 180,A00,083140,Abi Samra; Nicholas Camill,1,0,30,29
1658034956883,ECE 180,B00,083141,Abi Samra; Nicholas Camill,0,0,30,30
1658034962906,MATH 10A,A01,083735,Patchell; Gregory David,2,0,30,28
1658034962906,MATH 10A,A02,083736,Patchell; Gregory David,20,0,30,10
1658034962906,MATH 10A,A03,083737,Patchell; Gregory David,16,0,30,14
1658034968938,MATH 10B,A01,083207,Lim; Seonhee,9,0,34,25
1658034968938,MATH 10B,A02,083208,Lim; Seonhee,10,0,35,25
1658034968938,MATH 10B,A03,093472,Lim; Seonhee,7,0,34,27
1658034968938,MATH 10B,B01,083739,Sinha; Shubham,14,0,30,16
1658034974972,MATH 18,A01,083743,Cinel; Cameron Alexander,9,0,30,21
1658034974972,MATH 18,A02,083744,Cinel; Cameron Alexander,18,0,30,12
1658034974972,MATH 18,A03,083745,Cinel; Cameron Alexander,10,0,30,20
1658034974972,MATH 18,B01,083748,Rideout; David Porter,5,0,37,32
1658034974972,MATH 18,B02,083749,Rideout; David Porter,5,0,36,31
1658034974972,MATH 18,B03,083750,Rideout; David Porter,3,0,37,34
1658034974972,MATH 18,B04,083751,Rideout; David Porter,7,0,36,29
1658034974972,MATH 18,B05,093473,Rideout; David Porter,7,0,36,29
1658034974972,MATH 18,B06,093474,Rideout; David Porter,6,0,36,30
1658034980995,MATH 20A,A01,083754,Zheng; Zequn,14,0,40,26
1658034987022,MATH 20B,A01,083756,Briones; Jor-el Thomas Caparas,4,0,36,32
1658034987022,MATH 20B,A02,083757,Briones; Jor-el Thomas Caparas,1,0,36,35
1658034987022,MATH 20B,A03,093475,Briones; Jor-el Thomas Caparas,3,0,36,33
1658034993047,MATH 20C,A01,083760,Briones; Jor-el Thomas Caparas,1,0,35,34
1658034993047,MATH 20C,A02,083761,Briones; Jor-el Thomas Caparas,8,0,35,27
1658034993047,MATH 20C,A03,093476,Briones; Jor-el Thomas Caparas,0,1,36,36
1658034993047,MATH 20C,B01,083762,Bach; Quang Tran,1,0,30,29
1658034999069,MATH 20D,A01,083765,Tran; Brian Kha,5,0,30,25
1658034999069,MATH 20D,A02,083766,Tran; Brian Kha,5,0,30,25
1658034999069,MATH 20D,A03,083767,Tran; Brian Kha,6,0,30,24
1658035005099,MATH 20E,A01,083771,Ganguly; Soumya,12,0,32,20
1658035005099,MATH 20E,A02,083772,Ganguly; Soumya,7,0,32,25
1658035005099,MATH 20E,B01,083773,Ciotti; Benjamin,20,0,35,15
1658035005099,MATH 20E,B02,083774,Ciotti; Benjamin,18,0,35,17
1658035011123,MATH 103A,A01,083777,Greenfeld; Be'Eri,6,0,36,30
1658035011123,MATH 103A,A02,083778,Greenfeld; Be'Eri,5,0,36,31
1658035011123,MATH 103A,A03,093561,Greenfeld; Be'Eri,7,0,36,29
1658035011123,MATH 103A,B01,083779,Greenfeld; Be'Eri,8,0,36,28
1658035011123,MATH 103A,B02,083780,Greenfeld; Be'Eri,4,0,36,32
1658035011123,MATH 103A,B03,093562,Greenfeld; Be'Eri,3,0,36,33
1658035017146,MATH 105,A01,085443,Carter; Anne Toulson,15,0,35,20
1658035017146,MATH 105,A02,093477,Carter; Anne Toulson,20,0,35,15
1658035023169,MATH 109,A01,083213,Ganzberger; Geoffrey Michael,3,0,34,31
1658035023169,MATH 109,A02,083214,Ganzberger; Geoffrey Michael,4,0,34,30
1658035023169,MATH 109,A03,093478,Ganzberger; Geoffrey Michael,2,0,34,32
1658035023169,MATH 109,B01,083215,Ganzberger; Geoffrey Michael,3,0,32,29
1658035023169,MATH 109,B02,083216,Ganzberger; Geoffrey Michael,3,0,32,29
1658035023169,MATH 109,B03,093479,Ganzberger; Geoffrey Michael,8,0,32,24
1658035029194,MATH 142A,A01,083219,Chow; Bennett,7,0,32,25
1658035029194,MATH 142A,A02,083220,Chow; Bennett,10,0,32,22
1658035029194,MATH 142A,A03,093480,Chow; Bennett,9,0,32,23
1658035029194,MATH 142A,B03,093481,Chow; Bennett,8,0,32,24
1658035029194,MATH 142A,B04,093558,Chow; Bennett,14,0,32,18
1658035029194,MATH 142A,B05,093559,Chow; Bennett,7,0,32,25
1658035035218,MATH 193A,A01,083224,Rotar; Vladimir,9,0,34,25
1658035035218,MATH 193A,A02,083225,Rotar; Vladimir,11,0,34,23
1658035035218,MATH 193A,A03,083781,Rotar; Vladimir,5,0,34,29
1658035035218,MATH 193A,A04,083782,Rotar; Vladimir,12,0,34,22
1658035035218,MATH 193A,A05,093482,Rotar; Vladimir,11,0,34,23
1658035041248,MATH 197,001,091859,McAuley; Julian John,9999,0,9999,0
1658035041248,MATH 197,002,095566,Kedlaya; Kiran S.,9997,0,9999,2
1658035041248,MATH 197,003,095567,Xiao; Ming,9999,0,9999,0
1658035041248,MATH 197,004,095571,Perols; Johan Lars,9998,0,9999,1
1658035048300,COGS 9,A01,083615,Shannon; Kyle Michael,11,0,75,64
1658035054326,COGS 11,A01,083617,Boyle; Mary E. T.,23,0,48,25
1658035060348,COGS 13,A01,083071,Bastos; Amalia Pinkusfeld,12,0,71,59
1658035066374,COGS 14A,A01,092681,Semenuks; Arturs,5,1,100,95
1658035072402,COGS 14B,A01,083073,Cheng; Tzu-Han,7,0,63,56
1658035078429,COGS 17,A01,092677,Semenuks; Arturs,7,0,81,74
1658035084455,COGS 100,A01,083619,Allen; Michael Gordon,17,0,70,53
1658035090478,COGS 101A,A01,083621,Davis; Joshua Daniel,9,0,68,59
1658035096505,COGS 101B,A01,091572,Allen; Michael Gordon,14,0,65,51
1658035102528,COGS 101C,A01,083625,Delgado; Tania,17,0,35,18
1658035108553,COGS 107A,A01,083627,Boyle; Mary E. T.,14,0,60,46
1658035114578,COGS 118A,A01,083075,Gupta; Anjum,21,0,76,55
1658035120602,CSE 3,A50,083646,Miranda; Gregory Joseph,24,0,50,26
1658035126626,CSE 8A,A50,083650,Miranda; Gregory Joseph,17,1,56,39
1658035132724,CSE 11,A01,083080,Cao; Yingjun,7,15,40,33
1658035138749,CSE 12,A01,083652,Krause-Levy; Sophia Louisa,30,1,120,90
1658035144773,CSE 15L,A01,083654,Morris; Justin Loren,9,0,50,41
1658035144773,CSE 15L,A02,083655,Morris; Justin Loren,11,0,50,39
1658035150796,CSE 20,A01,083657,Tran; Khoa Dang,39,0,80,41
1658035156819,CSE 21,A01,095574,Bach; Quang Tran,23,0,48,25
1658035162841,CSE 30,A01,083084,Eldon; John,8,0,80,72
1658035162841,CSE 30,B01,095061,Bhaskar; Nishant,9,0,50,41
1658035168864,CSE 100,A01,083659,Cao; Yingjun,5,4,70,65
1658035174890,CSE 134B,A01,083661,Powell; Thomas Allan,25,0,100,75
1658035180915,CSE 140,A01,083663,Gungor; Onat,17,0,85,68
1658035186942,CSE 140L,A01,083088,Eldon; John,23,0,100,77
1658035192965,CSE 175,A01,083665,Kumar; Rakesh,3,0,25,22
1658035198989,CSE 190,A00,092507,Dubnov; Shlomo,8,0,20,12
1658035205011,ECE 45,A01,083139,Congero; Spencer William,7,0,75,68
1658035211039,ECE 65,A50,083695,Saad; Andrew S,12,0,30,18
1658035211039,ECE 65,A51,095125,Saad; Andrew S,24,0,26,2
1658035217068,ECE 109,A01,091882,Touri; Behrouz,21,0,70,49
1658035223091,ECE 180,A00,083140,Abi Samra; Nicholas Camill,1,0,30,29
1658035223091,ECE 180,B00,083141,Abi Samra; Nicholas Camill,0,0,30,30
1658035229118,MATH 10A,A01,083735,Patchell; Gregory David,2,0,30,28
1658035229118,MATH 10A,A02,083736,Patchell; Gregory David,20,0,30,10
1658035229118,MATH 10A,A03,083737,Patchell; Gregory David,16,0,30,14
1658035235140,MATH 10B,A01,083207,Lim; Seonhee,9,0,34,25
1658035235140,MATH 10B,A02,083208,Lim; Seonhee,10,0,35,25
1658035235140,MATH 10B,A03,093472,Lim; Seonhee,7,0,34,27
1658035235140,MATH 10B,B01,083739,Sinha; Shubham,14,0,30,16
1658035241163,MATH 18,A01,083743,Cinel; Cameron Alexander,9,0,30,21
1658035241163,MATH 18,A02,083744,Cinel; Cameron Alexander,18,0,30,12
1658035241163,MATH 18,A03,083745,Cinel; Cameron Alexander,10,0,30,20
1658035241163,MATH 18,B01,083748,Rideout; David Porter,5,0,37,32
1658035241163,MATH 18,B02,083749,Rideout; David Porter,5,0,36,31
1658035241163,MATH 18,B03,083750,Rideout; David Porter,3,0,37,34
1658035241163,MATH 18,B04,083751,Rideout; David Porter,7,0,36,29
1658035241163,MATH 18,B05,093473,Rideout; David Porter,7,0,36,29
1658035241163,MATH 18,B06,093474,Rideout; David Porter,6,0,36,30
1658035247186,MATH 20A,A01,083754,Zheng; Zequn,14,0,40,26
1658035253212,MATH 20B,A01,083756,Briones; Jor-el Thomas Caparas,4,0,36,32
1658035253212,MATH 20B,A02,083757,Briones; Jor-el Thomas Caparas,1,0,36,35
1658035253212,MATH 20B,A03,093475,Briones; Jor-el Thomas Caparas,3,0,36,33
1658035259235,MATH 20C,A01,083760,Briones; Jor-el Thomas Caparas,1,0,35,34
1658035259235,MATH 20C,A02,083761,Briones; Jor-el Thomas Caparas,8,0,35,27
1658035259235,MATH 20C,A03,093476,Briones; Jor-el Thomas Caparas,0,1,36,36
1658035259235,MATH 20C,B01,083762,Bach; Quang Tran,1,0,30,29
1658035265267,MATH 20D,A01,083765,Tran; Brian Kha,5,0,30,25
1658035265267,MATH 20D,A02,083766,Tran; Brian Kha,5,0,30,25
1658035265267,MATH 20D,A03,083767,Tran; Brian Kha,6,0,30,24
1658035271290,MATH 20E,A01,083771,Ganguly; Soumya,12,0,32,20
1658035271290,MATH 20E,A02,083772,Ganguly; Soumya,7,0,32,25
1658035271290,MATH 20E,B01,083773,Ciotti; Benjamin,20,0,35,15
1658035271290,MATH 20E,B02,083774,Ciotti; Benjamin,18,0,35,17
1658035277314,MATH 103A,A01,083777,Greenfeld; Be'Eri,6,0,36,30
1658035277314,MATH 103A,A02,083778,Greenfeld; Be'Eri,5,0,36,31
1658035277314,MATH 103A,A03,093561,Greenfeld; Be'Eri,7,0,36,29
1658035277314,MATH 103A,B01,083779,Greenfeld; Be'Eri,8,0,36,28
1658035277314,MATH 103A,B02,083780,Greenfeld; Be'Eri,4,0,36,32
1658035277314,MATH 103A,B03,093562,Greenfeld; Be'Eri,3,0,36,33
1658035283340,MATH 105,A01,085443,Carter; Anne Toulson,15,0,35,20
1658035283340,MATH 105,A02,093477,Carter; Anne Toulson,20,0,35,15
1658035289369,MATH 109,A01,083213,Ganzberger; Geoffrey Michael,3,0,34,31
1658035289369,MATH 109,A02,083214,Ganzberger; Geoffrey Michael,4,0,34,30
1658035289369,MATH 109,A03,093478,Ganzberger; Geoffrey Michael,2,0,34,32
1658035289369,MATH 109,B01,083215,Ganzberger; Geoffrey Michael,3,0,32,29
1658035289369,MATH 109,B02,083216,Ganzberger; Geoffrey Michael,3,0,32,29
1658035289369,MATH 109,B03,093479,Ganzberger; Geoffrey Michael,8,0,32,24
1658035295397,MATH 142A,A01,083219,Chow; Bennett,7,0,32,25
1658035295397,MATH 142A,A02,083220,Chow; Bennett,10,0,32,22
1658035295397,MATH 142A,A03,093480,Chow; Bennett,9,0,32,23
1658035295397,MATH 142A,B03,093481,Chow; Bennett,8,0,32,24
1658035295397,MATH 142A,B04,093558,Chow; Bennett,14,0,32,18
1658035295397,MATH 142A,B05,093559,Chow; Bennett,7,0,32,25
1658035301421,MATH 193A,A01,083224,Rotar; Vladimir,9,0,34,25
1658035301421,MATH 193A,A02,083225,Rotar; Vladimir,11,0,34,23
1658035301421,MATH 193A,A03,083781,Rotar; Vladimir,5,0,34,29
1658035301421,MATH 193A,A04,083782,Rotar; Vladimir,12,0,34,22
1658035301421,MATH 193A,A05,093482,Rotar; Vladimir,11,0,34,23
1658035307447,MATH 197,001,091859,McAuley; Julian John,9999,0,9999,0
1658035307447,MATH 197,002,095566,Kedlaya; Kiran S.,9997,0,9999,2
1658035307447,MATH 197,003,095567,Xiao; Ming,9999,0,9999,0
1658035307447,MATH 197,004,095571,Perols; Johan Lars,9998,0,9999,1
1658035314499,COGS 9,A01,083615,Shannon; Kyle Michael,11,0,75,64
1658035320523,COGS 11,A01,083617,Boyle; Mary E. T.,23,0,48,25
1658035326548,COGS 13,A01,083071,Bastos; Amalia Pinkusfeld,12,0,71,59
1658035332574,COGS 14A,A01,092681,Semenuks; Arturs,5,1,100,95
1658035338602,COGS 14B,A01,083073,Cheng; Tzu-Han,7,0,63,56
1658035344623,COGS 17,A01,092677,Semenuks; Arturs,7,0,81,74
1658035350657,COGS 100,A01,083619,Allen; Michael Gordon,17,0,70,53
1658035356684,COGS 101A,A01,083621,Davis; Joshua Daniel,9,0,68,59
1658035362708,COGS 101B,A01,091572,Allen; Michael Gordon,14,0,65,51
1658035368735,COGS 101C,A01,083625,Delgado; Tania,17,0,35,18
1658035374761,COGS 107A,A01,083627,Boyle; Mary E. T.,14,0,60,46
1658035380787,COGS 118A,A01,083075,Gupta; Anjum,21,0,76,55
1658035386813,CSE 3,A50,083646,Miranda; Gregory Joseph,24,0,50,26
1658035392851,CSE 8A,A50,083650,Miranda; Gregory Joseph,17,1,56,39
1658035398877,CSE 11,A01,083080,Cao; Yingjun,7,15,40,33
1658035404898,CSE 12,A01,083652,Krause-Levy; Sophia Louisa,30,1,120,90
1658035410925,CSE 15L,A01,083654,Morris; Justin Loren,9,0,50,41
1658035410925,CSE 15L,A02,083655,Morris; Justin Loren,11,0,50,39
1658035416948,CSE 20,A01,083657,Tran; Khoa Dang,39,0,80,41
1658035422971,CSE 21,A01,095574,Bach; Quang Tran,23,0,48,25
1658035429000,CSE 30,A01,083084,Eldon; John,8,0,80,72
1658035429000,CSE 30,B01,095061,Bhaskar; Nishant,9,0,50,41
1658035435031,CSE 100,A01,083659,Cao; Yingjun,5,4,70,65
1658035441061,CSE 134B,A01,083661,Powell; Thomas Allan,25,0,100,75
1658035447085,CSE 140,A01,083663,Gungor; Onat,17,0,85,68
1658035453111,CSE 140L,A01,083088,Eldon; John,23,0,100,77
1658035459133,CSE 175,A01,083665,Kumar; Rakesh,3,0,25,22
1658035465155,CSE 190,A00,092507,Dubnov; Shlomo,8,0,20,12
1658035471186,ECE 45,A01,083139,Congero; Spencer William,7,0,75,68
1658035477212,ECE 65,A50,083695,Saad; Andrew S,12,0,30,18
1658035477212,ECE 65,A51,095125,Saad; Andrew S,24,0,26,2
1658035483237,ECE 109,A01,091882,Touri; Behrouz,21,0,70,49
1658035489263,ECE 180,A00,083140,Abi Samra; Nicholas Camill,1,0,30,29
1658035489263,ECE 180,B00,083141,Abi Samra; Nicholas Camill,0,0,30,30
1658035495287,MATH 10A,A01,083735,Patchell; Gregory David,2,0,30,28
1658035495287,MATH 10A,A02,083736,Patchell; Gregory David,20,0,30,10
1658035495287,MATH 10A,A03,083737,Patchell; Gregory David,16,0,30,14
1658035501312,MATH 10B,A01,083207,Lim; Seonhee,9,0,34,25
1658035501312,MATH 10B,A02,083208,Lim; Seonhee,10,0,35,25
1658035501312,MATH 10B,A03,093472,Lim; Seonhee,7,0,34,27
1658035501312,MATH 10B,B01,083739,Sinha; Shubham,14,0,30,16
1658035507335,MATH 18,A01,083743,Cinel; Cameron Alexander,9,0,30,21
1658035507335,MATH 18,A02,083744,Cinel; Cameron Alexander,18,0,30,12
1658035507335,MATH 18,A03,083745,Cinel; Cameron Alexander,10,0,30,20
1658035507335,MATH 18,B01,083748,Rideout; David Porter,5,0,37,32
1658035507335,MATH 18,B02,083749,Rideout; David Porter,5,0,36,31
1658035507335,MATH 18,B03,083750,Rideout; David Porter,3,0,37,34
1658035507335,MATH 18,B04,083751,Rideout; David Porter,7,0,36,29
1658035507335,MATH 18,B05,093473,Rideout; David Porter,7,0,36,29
1658035507335,MATH 18,B06,093474,Rideout; David Porter,6,0,36,30
1658035513357,MATH 20A,A01,083754,Zheng; Zequn,14,0,40,26
1658035519380,MATH 20B,A01,083756,Briones; Jor-el Thomas Caparas,4,0,36,32
1658035519380,MATH 20B,A02,083757,Briones; Jor-el Thomas Caparas,1,0,36,35
1658035519380,MATH 20B,A03,093475,Briones; Jor-el Thomas Caparas,3,0,36,33
1658035525403,MATH 20C,A01,083760,Briones; Jor-el Thomas Caparas,1,0,35,34
1658035525403,MATH 20C,A02,083761,Briones; Jor-el Thomas Caparas,8,0,35,27
1658035525403,MATH 20C,A03,093476,Briones; Jor-el Thomas Caparas,0,1,36,36
1658035525403,MATH 20C,B01,083762,Bach; Quang Tran,1,0,30,29
1658035531431,MATH 20D,A01,083765,Tran; Brian Kha,5,0,30,25
1658035531431,MATH 20D,A02,083766,Tran; Brian Kha,5,0,30,25
1658035531431,MATH 20D,A03,083767,Tran; Brian Kha,6,0,30,24
1658035537459,MATH 20E,A01,083771,Ganguly; Soumya,12,0,32,20
1658035537459,MATH 20E,A02,083772,Ganguly; Soumya,7,0,32,25
1658035537459,MATH 20E,B01,083773,Ciotti; Benjamin,20,0,35,15
1658035537459,MATH 20E,B02,083774,Ciotti; Benjamin,18,0,35,17
1658035543488,MATH 103A,A01,083777,Greenfeld; Be'Eri,6,0,36,30
1658035543488,MATH 103A,A02,083778,Greenfeld; Be'Eri,5,0,36,31
1658035543488,MATH 103A,A03,093561,Greenfeld; Be'Eri,7,0,36,29
1658035543488,MATH 103A,B01,083779,Greenfeld; Be'Eri,8,0,36,28
1658035543488,MATH 103A,B02,083780,Greenfeld; Be'Eri,4,0,36,32
1658035543488,MATH 103A,B03,093562,Greenfeld; Be'Eri,3,0,36,33
1658035549513,MATH 105,A01,085443,Carter; Anne Toulson,15,0,35,20
1658035549513,MATH 105,A02,093477,Carter; Anne Toulson,20,0,35,15
1658035555542,MATH 109,A01,083213,Ganzberger; Geoffrey Michael,3,0,34,31
1658035555542,MATH 109,A02,083214,Ganzberger; Geoffrey Michael,4,0,34,30
1658035555542,MATH 109,A03,093478,Ganzberger; Geoffrey Michael,2,0,34,32
1658035555542,MATH 109,B01,083215,Ganzberger; Geoffrey Michael,3,0,32,29
1658035555542,MATH 109,B02,083216,Ganzberger; Geoffrey Michael,3,0,32,29
1658035555542,MATH 109,B03,093479,Ganzberger; Geoffrey Michael,8,0,32,24
1658035561564,MATH 142A,A01,083219,Chow; Bennett,7,0,32,25
1658035561564,MATH 142A,A02,083220,Chow; Bennett,10,0,32,22
1658035561564,MATH 142A,A03,093480,Chow; Bennett,9,0,32,23
1658035561564,MATH 142A,B03,093481,Chow; Bennett,8,0,32,24
1658035561564,MATH 142A,B04,093558,Chow; Bennett,14,0,32,18
1658035561564,MATH 142A,B05,093559,Chow; Bennett,7,0,32,25
1658035567593,MATH 193A,A01,083224,Rotar; Vladimir,9,0,34,25
1658035567593,MATH 193A,A02,083225,Rotar; Vladimir,11,0,34,23
1658035567593,MATH 193A,A03,083781,Rotar; Vladimir,5,0,34,29
1658035567593,MATH 193A,A04,083782,Rotar; Vladimir,12,0,34,22
1658035567593,MATH 193A,A05,093482,Rotar; Vladimir,11,0,34,23
1658035573618,MATH 197,001,091859,McAuley; Julian John,9999,0,9999,0
1658035573618,MATH 197,002,095566,Kedlaya; Kiran S.,9997,0,9999,2
1658035573618,MATH 197,003,095567,Xiao; Ming,9999,0,9999,0
1658035573618,MATH 197,004,095571,Perols; Johan Lars,9998,0,9999,1
1658035580689,COGS 9,A01,083615,Shannon; Kyle Michael,11,0,75,64
1658035586711,COGS 11,A01,083617,Boyle; Mary E. T.,23,0,48,25
1658035592734,COGS 13,A01,083071,Bastos; Amalia Pinkusfeld,12,0,71,59
1658035598762,COGS 14A,A01,092681,Semenuks; Arturs,5,1,100,95
1658035604784,COGS 14B,A01,083073,Cheng; Tzu-Han,7,0,63,56
1658035610813,COGS 17,A01,092677,Semenuks; Arturs,7,0,81,74
1658035616839,COGS 100,A01,083619,Allen; Michael Gordon,17,0,70,53
1658035622865,COGS 101A,A01,083621,Davis; Joshua Daniel,9,0,68,59
1658035628892,COGS 101B,A01,091572,Allen; Michael Gordon,14,0,65,51
1658035634917,COGS 101C,A01,083625,Delgado; Tania,17,0,35,18
1658035640938,COGS 107A,A01,083627,Boyle; Mary E. T.,14,0,60,46
1658035646966,COGS 118A,A01,083075,Gupta; Anjum,21,0,76,55
1658035652988,CSE 3,A50,083646,Miranda; Gregory Joseph,24,0,50,26
1658035659016,CSE 8A,A50,083650,Miranda; Gregory Joseph,17,1,56,39
1658035665038,CSE 11,A01,083080,Cao; Yingjun,7,15,40,33
1658035671063,CSE 12,A01,083652,Krause-Levy; Sophia Louisa,30,1,120,90
1658035677090,CSE 15L,A01,083654,Morris; Justin Loren,9,0,50,41
1658035677090,CSE 15L,A02,083655,Morris; Justin Loren,11,0,50,39
1658035683114,CSE 20,A01,083657,Tran; Khoa Dang,39,0,80,41
1658035689141,CSE 21,A01,095574,Bach; Quang Tran,23,0,48,25
1658035695163,CSE 30,A01,083084,Eldon; John,8,0,80,72
1658035695163,CSE 30,B01,095061,Bhaskar; Nishant,9,0,50,41
1658035701202,CSE 100,A01,083659,Cao; Yingjun,5,4,70,65
1658035707229,CSE 134B,A01,083661,Powell; Thomas Allan,25,0,100,75
1658035713254,CSE 140,A01,083663,Gungor; Onat,17,0,85,68
1658035719278,CSE 140L,A01,083088,Eldon; John,23,0,100,77
1658035725304,CSE 175,A01,083665,Kumar; Rakesh,3,0,25,22
1658035731417,CSE 190,A00,092507,Dubnov; Shlomo,8,0,20,12
1658035737442,ECE 45,A01,083139,Congero; Spencer William,7,0,75,68
1658035743463,ECE 65,A50,083695,Saad; Andrew S,12,0,30,18
1658035743463,ECE 65,A51,095125,Saad; Andrew S,24,0,26,2
1658035749487,ECE 109,A01,091882,Touri; Behrouz,21,0,70,49
1658035755512,ECE 180,A00,083140,Abi Samra; Nicholas Camill,1,0,30,29
1658035755512,ECE 180,B00,083141,Abi Samra; Nicholas Camill,0,0,30,30
1658035761533,MATH 10A,A01,083735,Patchell; Gregory David,2,0,30,28
1658035761533,MATH 10A,A02,083736,Patchell; Gregory David,20,0,30,10
1658035761533,MATH 10A,A03,083737,Patchell; Gregory David,16,0,30,14
1658035767557,MATH 10B,A01,083207,Lim; Seonhee,9,0,34,25
1658035767557,MATH 10B,A02,083208,Lim; Seonhee,10,0,35,25
1658035767557,MATH 10B,A03,093472,Lim; Seonhee,7,0,34,27
1658035767557,MATH 10B,B01,083739,Sinha; Shubham,14,0,30,16
1658035773587,MATH 18,A01,083743,Cinel; Cameron Alexander,9,0,30,21
1658035773587,MATH 18,A02,083744,Cinel; Cameron Alexander,18,0,30,12
1658035773587,MATH 18,A03,083745,Cinel; Cameron Alexander,10,0,30,20
1658035773587,MATH 18,B01,083748,Rideout; David Porter,5,0,37,32
1658035773587,MATH 18,B02,083749,Rideout; David Porter,5,0,36,31
1658035773587,MATH 18,B03,083750,Rideout; David Porter,3,0,37,34
1658035773587,MATH 18,B04,083751,Rideout; David Porter,7,0,36,29
1658035773587,MATH 18,B05,093473,Rideout; David Porter,7,0,36,29
1658035773587,MATH 18,B06,093474,Rideout; David Porter,6,0,36,30
1658035779613,MATH 20A,A01,083754,Zheng; Zequn,14,0,40,26
1658035785636,MATH 20B,A01,083756,Briones; Jor-el Thomas Caparas,4,0,36,32
1658035785636,MATH 20B,A02,083757,Briones; Jor-el Thomas Caparas,1,0,36,35
1658035785636,MATH 20B,A03,093475,Briones; Jor-el Thomas Caparas,3,0,36,33
1658035791661,MATH 20C,A01,083760,Briones; Jor-el Thomas Caparas,1,0,35,34
1658035791661,MATH 20C,A02,083761,Briones; Jor-el Thomas Caparas,8,0,35,27
1658035791661,MATH 20C,A03,093476,Briones; Jor-el Thomas Caparas,0,1,36,36
1658035791661,MATH 20C,B01,083762,Bach; Quang Tran,1,0,30,29
1658035797690,MATH 20D,A01,083765,Tran; Brian Kha,5,0,30,25
1658035797690,MATH 20D,A02,083766,Tran; Brian Kha,5,0,30,25
1658035797690,MATH 20D,A03,083767,Tran; Brian Kha,6,0,30,24
1658035803714,MATH 20E,A01,083771,Ganguly; Soumya,12,0,32,20
1658035803714,MATH 20E,A02,083772,Ganguly; Soumya,7,0,32,25
1658035803714,MATH 20E,B01,083773,Ciotti; Benjamin,20,0,35,15
1658035803714,MATH 20E,B02,083774,Ciotti; Benjamin,18,0,35,17
1658035809737,MATH 103A,A01,083777,Greenfeld; Be'Eri,6,0,36,30
1658035809737,MATH 103A,A02,083778,Greenfeld; Be'Eri,5,0,36,31
1658035809737,MATH 103A,A03,093561,Greenfeld; Be'Eri,7,0,36,29
1658035809737,MATH 103A,B01,083779,Greenfeld; Be'Eri,8,0,36,28
1658035809737,MATH 103A,B02,083780,Greenfeld; Be'Eri,4,0,36,32
1658035809737,MATH 103A,B03,093562,Greenfeld; Be'Eri,3,0,36,33
1658035815759,MATH 105,A01,085443,Carter; Anne Toulson,15,0,35,20
1658035815759,MATH 105,A02,093477,Carter; Anne Toulson,20,0,35,15
1658035821787,MATH 109,A01,083213,Ganzberger; Geoffrey Michael,3,0,34,31
1658035821787,MATH 109,A02,083214,Ganzberger; Geoffrey Michael,4,0,34,30
1658035821787,MATH 109,A03,093478,Ganzberger; Geoffrey Michael,2,0,34,32
1658035821787,MATH 109,B01,083215,Ganzberger; Geoffrey Michael,3,0,32,29
1658035821787,MATH 109,B02,083216,Ganzberger; Geoffrey Michael,3,0,32,29
1658035821787,MATH 109,B03,093479,Ganzberger; Geoffrey Michael,8,0,32,24
1658035827810,MATH 142A,A01,083219,Chow; Bennett,7,0,32,25
1658035827810,MATH 142A,A02,083220,Chow; Bennett,10,0,32,22
1658035827810,MATH 142A,A03,093480,Chow; Bennett,9,0,32,23
1658035827810,MATH 142A,B03,093481,Chow; Bennett,8,0,32,24
1658035827810,MATH 142A,B04,093558,Chow; Bennett,14,0,32,18
1658035827810,MATH 142A,B05,093559,Chow; Bennett,7,0,32,25
1658035833834,MATH 193A,A01,083224,Rotar; Vladimir,9,0,34,25
1658035833834,MATH 193A,A02,083225,Rotar; Vladimir,11,0,34,23
1658035833834,MATH 193A,A03,083781,Rotar; Vladimir,5,0,34,29
1658035833834,MATH 193A,A04,083782,Rotar; Vladimir,12,0,34,22
1658035833834,MATH 193A,A05,093482,Rotar; Vladimir,11,0,34,23
1658035839857,MATH 197,001,091859,McAuley; Julian John,9999,0,9999,0
1658035839857,MATH 197,002,095566,Kedlaya; Kiran S.,9997,0,9999,2
1658035839857,MATH 197,003,095567,Xiao; Ming,9999,0,9999,0
1658035839857,MATH 197,004,095571,Perols; Johan Lars,9998,0,9999,1
1658035846912,COGS 9,A01,083615,Shannon; Kyle Michael,11,0,75,64
1658035852934,COGS 11,A01,083617,Boyle; Mary E. T.,23,0,48,25
1658035858956,COGS 13,A01,083071,Bastos; Amalia Pinkusfeld,12,0,71,59
1658035864980,COGS 14A,A01,092681,Semenuks; Arturs,5,1,100,95
1658035871012,COGS 14B,A01,083073,Cheng; Tzu-Han,7,0,63,56
1658035877041,COGS 17,A01,092677,Semenuks; Arturs,7,0,81,74
1658035883063,COGS 100,A01,083619,Allen; Michael Gordon,17,0,70,53
1658035889090,COGS 101A,A01,083621,Davis; Joshua Daniel,9,0,68,59
1658035895112,COGS 101B,A01,091572,Allen; Michael Gordon,14,0,65,51
1658035901138,COGS 101C,A01,083625,Delgado; Tania,17,0,35,18
1658035907160,COGS 107A,A01,083627,Boyle; Mary E. T.,14,0,60,46
1658035913186,COGS 118A,A01,083075,Gupta; Anjum,21,0,76,55
1658035919210,CSE 3,A50,083646,Miranda; Gregory Joseph,24,0,50,26
1658035925233,CSE 8A,A50,083650,Miranda; Gregory Joseph,17,1,56,39
1658035931257,CSE 11,A01,083080,Cao; Yingjun,7,15,40,33
1658035937280,CSE 12,A01,083652,Krause-Levy; Sophia Louisa,30,1,120,90
1658035943310,CSE 15L,A01,083654,Morris; Justin Loren,9,0,50,41
1658035943310,CSE 15L,A02,083655,Morris; Justin Loren,11,0,50,39
1658035949335,CSE 20,A01,083657,Tran; Khoa Dang,39,0,80,41
1658035955361,CSE 21,A01,095574,Bach; Quang Tran,23,0,48,25
1658035961384,CSE 30,A01,083084,Eldon; John,8,0,80,72
1658035961384,CSE 30,B01,095061,Bhaskar; Nishant,9,0,50,41
1658035967410,CSE 100,A01,083659,Cao; Yingjun,5,4,70,65
1658035973433,CSE 134B,A01,083661,Powell; Thomas Allan,25,0,100,75
1658035979455,CSE 140,A01,083663,Gungor; Onat,17,0,85,68
1658035985481,CSE 140L,A01,083088,Eldon; John,23,0,100,77
1658035991506,CSE 175,A01,083665,Kumar; Rakesh,3,0,25,22
1658035997529,CSE 190,A00,092507,Dubnov; Shlomo,8,0,20,12
1658036003552,ECE 45,A01,083139,Congero; Spencer William,7,0,75,68
1658036009576,ECE 65,A50,083695,Saad; Andrew S,12,0,30,18
1658036009576,ECE 65,A51,095125,Saad; Andrew S,24,0,26,2
1658036015598,ECE 109,A01,091882,Touri; Behrouz,21,0,70,49
1658036021621,ECE 180,A00,083140,Abi Samra; Nicholas Camill,1,0,30,29
1658036021621,ECE 180,B00,083141,Abi Samra; Nicholas Camill,0,0,30,30
1658036027645,MATH 10A,A01,083735,Patchell; Gregory David,2,0,30,28
1658036027645,MATH 10A,A02,083736,Patchell; Gregory David,20,0,30,10
1658036027645,MATH 10A,A03,083737,Patchell; Gregory David,16,0,30,14
1658036033675,MATH 10B,A01,083207,Lim; Seonhee,9,0,34,25
1658036033675,MATH 10B,A02,083208,Lim; Seonhee,10,0,35,25
1658036033675,MATH 10B,A03,093472,Lim; Seonhee,7,0,34,27
1658036033675,MATH 10B,B01,083739,Sinha; Shubham,14,0,30,16
1658036039699,MATH 18,A01,083743,Cinel; Cameron Alexander,9,0,30,21
1658036039699,MATH 18,A02,083744,Cinel; Cameron Alexander,18,0,30,12
1658036039699,MATH 18,A03,083745,Cinel; Cameron Alexander,10,0,30,20
1658036039699,MATH 18,B01,083748,Rideout; David Porter,5,0,37,32
1658036039699,MATH 18,B02,083749,Rideout; David Porter,5,0,36,31
1658036039699,MATH 18,B03,083750,Rideout; David Porter,3,0,37,34
1658036039699,MATH 18,B04,083751,Rideout; David Porter,7,0,36,29
1658036039699,MATH 18,B05,093473,Rideout; David Porter,7,0,36,29
1658036039699,MATH 18,B06,093474,Rideout; David Porter,6,0,36,30
1658036045725,MATH 20A,A01,083754,Zheng; Zequn,14,0,40,26
1658036051749,MATH 20B,A01,083756,Briones; Jor-el Thomas Caparas,4,0,36,32
1658036051749,MATH 20B,A02,083757,Briones; Jor-el Thomas Caparas,1,0,36,35
1658036051749,MATH 20B,A03,093475,Briones; Jor-el Thomas Caparas,3,0,36,33
1658036057779,MATH 20C,A01,083760,Briones; Jor-el Thomas Caparas,1,0,35,34
1658036057779,MATH 20C,A02,083761,Briones; Jor-el Thomas Caparas,8,0,35,27
1658036057779,MATH 20C,A03,093476,Briones; Jor-el Thomas Caparas,0,1,36,36
1658036057779,MATH 20C,B01,083762,Bach; Quang Tran,1,0,30,29
1658036063801,MATH 20D,A01,083765,Tran; Brian Kha,5,0,30,25
1658036063801,MATH 20D,A02,083766,Tran; Brian Kha,5,0,30,25
1658036063801,MATH 20D,A03,083767,Tran; Brian Kha,6,0,30,24
1658036069825,MATH 20E,A01,083771,Ganguly; Soumya,12,0,32,20
1658036069825,MATH 20E,A02,083772,Ganguly; Soumya,7,0,32,25
1658036069825,MATH 20E,B01,083773,Ciotti; Benjamin,20,0,35,15
1658036069825,MATH 20E,B02,083774,Ciotti; Benjamin,18,0,35,17
1658036075852,MATH 103A,A01,083777,Greenfeld; Be'Eri,6,0,36,30
1658036075852,MATH 103A,A02,083778,Greenfeld; Be'Eri,5,0,36,31
1658036075852,MATH 103A,A03,093561,Greenfeld; Be'Eri,7,0,36,29
1658036075852,MATH 103A,B01,083779,Greenfeld; Be'Eri,8,0,36,28
1658036075852,MATH 103A,B02,083780,Greenfeld; Be'Eri,4,0,36,32
1658036075852,MATH 103A,B03,093562,Greenfeld; Be'Eri,3,0,36,33
1658036081877,MATH 105,A01,085443,Carter; Anne Toulson,15,0,35,20
1658036081877,MATH 105,A02,093477,Carter; Anne Toulson,20,0,35,15
1658036087900,MATH 109,A01,083213,Ganzberger; Geoffrey Michael,3,0,34,31
1658036087900,MATH 109,A02,083214,Ganzberger; Geoffrey Michael,4,0,34,30
1658036087900,MATH 109,A03,093478,Ganzberger; Geoffrey Michael,2,0,34,32
1658036087900,MATH 109,B01,083215,Ganzberger; Geoffrey Michael,3,0,32,29
1658036087900,MATH 109,B02,083216,Ganzberger; Geoffrey Michael,3,0,32,29
1658036087900,MATH 109,B03,093479,Ganzberger; Geoffrey Michael,8,0,32,24
1658036093933,MATH 142A,A01,083219,Chow; Bennett,7,0,32,25
1658036093933,MATH 142A,A02,083220,Chow; Bennett,10,0,32,22
1658036093933,MATH 142A,A03,093480,Chow; Bennett,9,0,32,23
1658036093933,MATH 142A,B03,093481,Chow; Bennett,8,0,32,24
1658036093933,MATH 142A,B04,093558,Chow; Bennett,14,0,32,18
1658036093933,MATH 142A,B05,093559,Chow; Bennett,7,0,32,25
1658036099956,MATH 193A,A01,083224,Rotar; Vladimir,9,0,34,25
1658036099956,MATH 193A,A02,083225,Rotar; Vladimir,11,0,34,23
1658036099956,MATH 193A,A03,083781,Rotar; Vladimir,5,0,34,29
1658036099956,MATH 193A,A04,083782,Rotar; Vladimir,12,0,34,22
1658036099956,MATH 193A,A05,093482,Rotar; Vladimir,11,0,34,23
1658036105978,MATH 197,001,091859,McAuley; Julian John,9999,0,9999,0
1658036105978,MATH 197,002,095566,Kedlaya; Kiran S.,9997,0,9999,2
1658036105978,MATH 197,003,095567,Xiao; Ming,9999,0,9999,0
1658036105978,MATH 197,004,095571,Perols; Johan Lars,9998,0,9999,1
1658036113045,COGS 9,A01,083615,Shannon; Kyle Michael,11,0,75,64
1658036119067,COGS 11,A01,083617,Boyle; Mary E. T.,23,0,48,25
1658036125092,COGS 13,A01,083071,Bastos; Amalia Pinkusfeld,12,0,71,59
1658036131114,COGS 14A,A01,092681,Semenuks; Arturs,5,1,100,95
1658036137136,COGS 14B,A01,083073,Cheng; Tzu-Han,7,0,63,56
1658036143161,COGS 17,A01,092677,Semenuks; Arturs,7,0,81,74
1658036149183,COGS 100,A01,083619,Allen; Michael Gordon,17,0,70,53
1658036155206,COGS 101A,A01,083621,Davis; Joshua Daniel,9,0,68,59
1658036161228,COGS 101B,A01,091572,Allen; Michael Gordon,14,0,65,51
1658036167250,COGS 101C,A01,083625,Delgado; Tania,17,0,35,18
1658036173277,COGS 107A,A01,083627,Boyle; Mary E. T.,14,0,60,46
1658036179300,COGS 118A,A01,083075,Gupta; Anjum,21,0,76,55
1658036185327,CSE 3,A50,083646,Miranda; Gregory Joseph,24,0,50,26
1658036191355,CSE 8A,A50,083650,Miranda; Gregory Joseph,17,1,56,39
1658036197378,CSE 11,A01,083080,Cao; Yingjun,7,15,40,33
1658036203404,CSE 12,A01,083652,Krause-Levy; Sophia Louisa,30,1,120,90
1658036209432,CSE 15L,A01,083654,Morris; Justin Loren,9,0,50,41
1658036209432,CSE 15L,A02,083655,Morris; Justin Loren,11,0,50,39
1658036215455,CSE 20,A01,083657,Tran; Khoa Dang,39,0,80,41
1658036221485,CSE 21,A01,095574,Bach; Quang Tran,23,0,48,25
1658036227529,CSE 30,A01,083084,Eldon; John,8,0,80,72
1658036227529,CSE 30,B01,095061,Bhaskar; Nishant,9,0,50,41
1658036233552,CSE 100,A01,083659,Cao; Yingjun,5,4,70,65
1658036239578,CSE 134B,A01,083661,Powell; Thomas Allan,25,0,100,75
1658036245601,CSE 140,A01,083663,Gungor; Onat,17,0,85,68
1658036251627,CSE 140L,A01,083088,Eldon; John,23,0,100,77
1658036257658,CSE 175,A01,083665,Kumar; Rakesh,3,0,25,22
1658036263680,CSE 190,A00,092507,Dubnov; Shlomo,8,0,20,12
1658036269710,ECE 45,A01,083139,Congero; Spencer William,7,0,75,68
1658036275733,ECE 65,A50,083695,Saad; Andrew S,12,0,30,18
1658036275733,ECE 65,A51,095125,Saad; Andrew S,24,0,26,2
1658036281757,ECE 109,A01,091882,Touri; Behrouz,21,0,70,49
1658036287779,ECE 180,A00,083140,Abi Samra; Nicholas Camill,1,0,30,29
1658036287779,ECE 180,B00,083141,Abi Samra; Nicholas Camill,0,0,30,30
1658036293806,MATH 10A,A01,083735,Patchell; Gregory David,2,0,30,28
1658036293806,MATH 10A,A02,083736,Patchell; Gregory David,20,0,30,10
1658036293806,MATH 10A,A03,083737,Patchell; Gregory David,16,0,30,14
1658036299833,MATH 10B,A01,083207,Lim; Seonhee,9,0,34,25
1658036299833,MATH 10B,A02,083208,Lim; Seonhee,10,0,35,25
1658036299833,MATH 10B,A03,093472,Lim; Seonhee,7,0,34,27
1658036299833,MATH 10B,B01,083739,Sinha; Shubham,14,0,30,16
1658036305870,MATH 18,A01,083743,Cinel; Cameron Alexander,9,0,30,21
1658036305870,MATH 18,A02,083744,Cinel; Cameron Alexander,18,0,30,12
1658036305870,MATH 18,A03,083745,Cinel; Cameron Alexander,10,0,30,20
1658036305870,MATH 18,B01,083748,Rideout; David Porter,5,0,37,32
1658036305870,MATH 18,B02,083749,Rideout; David Porter,5,0,36,31
1658036305870,MATH 18,B03,083750,Rideout; David Porter,3,0,37,34
1658036305870,MATH 18,B04,083751,Rideout; David Porter,7,0,36,29
1658036305870,MATH 18,B05,093473,Rideout; David Porter,7,0,36,29
1658036305870,MATH 18,B06,093474,Rideout; David Porter,6,0,36,30
1658036311900,MATH 20A,A01,083754,Zheng; Zequn,14,0,40,26
1658036317933,MATH 20B,A01,083756,Briones; Jor-el Thomas Caparas,4,0,36,32
1658036317933,MATH 20B,A02,083757,Briones; Jor-el Thomas Caparas,1,0,36,35
1658036317933,MATH 20B,A03,093475,Briones; Jor-el Thomas Caparas,3,0,36,33
1658036323958,MATH 20C,A01,083760,Briones; Jor-el Thomas Caparas,1,0,35,34
1658036323958,MATH 20C,A02,083761,Briones; Jor-el Thomas Caparas,8,0,35,27
1658036323958,MATH 20C,A03,093476,Briones; Jor-el Thomas Caparas,0,1,36,36
1658036323958,MATH 20C,B01,083762,Bach; Quang Tran,1,0,30,29
1658036330052,MATH 20D,A01,083765,Tran; Brian Kha,5,0,30,25
1658036330052,MATH 20D,A02,083766,Tran; Brian Kha,5,0,30,25
1658036330052,MATH 20D,A03,083767,Tran; Brian Kha,6,0,30,24
1658036336079,MATH 20E,A01,083771,Ganguly; Soumya,12,0,32,20
1658036336079,MATH 20E,A02,083772,Ganguly; Soumya,7,0,32,25
1658036336079,MATH 20E,B01,083773,Ciotti; Benjamin,20,0,35,15
1658036336079,MATH 20E,B02,083774,Ciotti; Benjamin,18,0,35,17
1658036342114,MATH 103A,A01,083777,Greenfeld; Be'Eri,6,0,36,30
1658036342114,MATH 103A,A02,083778,Greenfeld; Be'Eri,5,0,36,31
1658036342114,MATH 103A,A03,093561,Greenfeld; Be'Eri,7,0,36,29
1658036342114,MATH 103A,B01,083779,Greenfeld; Be'Eri,8,0,36,28
1658036342114,MATH 103A,B02,083780,Greenfeld; Be'Eri,4,0,36,32
1658036342114,MATH 103A,B03,093562,Greenfeld; Be'Eri,3,0,36,33
1658036348144,MATH 105,A01,085443,Carter; Anne Toulson,15,0,35,20
1658036348144,MATH 105,A02,093477,Carter; Anne Toulson,20,0,35,15
1658036354171,MATH 109,A01,083213,Ganzberger; Geoffrey Michael,3,0,34,31
1658036354171,MATH 109,A02,083214,Ganzberger; Geoffrey Michael,4,0,34,30
1658036354171,MATH 109,A03,093478,Ganzberger; Geoffrey Michael,2,0,34,32
1658036354171,MATH 109,B01,083215,Ganzberger; Geoffrey Michael,3,0,32,29
1658036354171,MATH 109,B02,083216,Ganzberger; Geoffrey Michael,3,0,32,29
1658036354171,MATH 109,B03,093479,Ganzberger; Geoffrey Michael,8,0,32,24
1658036360194,MATH 142A,A01,083219,Chow; Bennett,7,0,32,25
1658036360194,MATH 142A,A02,083220,Chow; Bennett,10,0,32,22
1658036360194,MATH 142A,A03,093480,Chow; Bennett,9,0,32,23
1658036360194,MATH 142A,B03,093481,Chow; Bennett,8,0,32,24
1658036360194,MATH 142A,B04,093558,Chow; Bennett,14,0,32,18
1658036360194,MATH 142A,B05,093559,Chow; Bennett,7,0,32,25
1658036366218,MATH 193A,A01,083224,Rotar; Vladimir,9,0,34,25
1658036366218,MATH 193A,A02,083225,Rotar; Vladimir,11,0,34,23
1658036366218,MATH 193A,A03,083781,Rotar; Vladimir,5,0,34,29
1658036366218,MATH 193A,A04,083782,Rotar; Vladimir,12,0,34,22
1658036366218,MATH 193A,A05,093482,Rotar; Vladimir,11,0,34,23
1658036372240,MATH 197,001,091859,McAuley; Julian John,9999,0,9999,0
1658036372240,MATH 197,002,095566,Kedlaya; Kiran S.,9997,0,9999,2
1658036372240,MATH 197,003,095567,Xiao; Ming,9999,0,9999,0
1658036372240,MATH 197,004,095571,Perols; Johan Lars,9998,0,9999,1
1658036379300,COGS 9,A01,083615,Shannon; Kyle Michael,11,0,75,64
1658036385323,COGS 11,A01,083617,Boyle; Mary E. T.,23,0,48,25
1658036391349,COGS 13,A01,083071,Bastos; Amalia Pinkusfeld,12,0,71,59
1658036397372,COGS 14A,A01,092681,Semenuks; Arturs,5,1,100,95
1658036403397,COGS 14B,A01,083073,Cheng; Tzu-Han,7,0,63,56
1658036409419,COGS 17,A01,092677,Semenuks; Arturs,7,0,81,74
1658036415445,COGS 100,A01,083619,Allen; Michael Gordon,17,0,70,53
1658036421473,COGS 101A,A01,083621,Davis; Joshua Daniel,9,0,68,59
1658036427496,COGS 101B,A01,091572,Allen; Michael Gordon,14,0,65,51
1658036433522,COGS 101C,A01,083625,Delgado; Tania,17,0,35,18
1658036439545,COGS 107A,A01,083627,Boyle; Mary E. T.,14,0,60,46
1658036445572,COGS 118A,A01,083075,Gupta; Anjum,21,0,76,55
1658036451595,CSE 3,A50,083646,Miranda; Gregory Joseph,24,0,50,26
1658036457625,CSE 8A,A50,083650,Miranda; Gregory Joseph,17,1,56,39
1658036463647,CSE 11,A01,083080,Cao; Yingjun,7,15,40,33
1658036469670,CSE 12,A01,083652,Krause-Levy; Sophia Louisa,30,1,120,90
1658036475697,CSE 15L,A01,083654,Morris; Justin Loren,9,0,50,41
1658036475697,CSE 15L,A02,083655,Morris; Justin Loren,11,0,50,39
1658036481722,CSE 20,A01,083657,Tran; Khoa Dang,39,0,80,41
1658036487747,CSE 21,A01,095574,Bach; Quang Tran,23,0,48,25
1658036493771,CSE 30,A01,083084,Eldon; John,8,0,80,72
1658036493771,CSE 30,B01,095061,Bhaskar; Nishant,9,0,50,41
1658036499800,CSE 100,A01,083659,Cao; Yingjun,5,4,70,65
1658036505829,CSE 134B,A01,083661,Powell; Thomas Allan,25,0,100,75
1658036511862,CSE 140,A01,083663,Gungor; Onat,17,0,85,68
1658036517888,CSE 140L,A01,083088,Eldon; John,23,0,100,77
1658036523913,CSE 175,A01,083665,Kumar; Rakesh,3,0,25,22
1658036529935,CSE 190,A00,092507,Dubnov; Shlomo,8,0,20,12
1658036535958,ECE 45,A01,083139,Congero; Spencer William,7,0,75,68
1658036541981,ECE 65,A50,083695,Saad; Andrew S,12,0,30,18
1658036541981,ECE 65,A51,095125,Saad; Andrew S,24,0,26,2
1658036548009,ECE 109,A01,091882,Touri; Behrouz,21,0,70,49
1658036554035,ECE 180,A00,083140,Abi Samra; Nicholas Camill,1,0,30,29
1658036554035,ECE 180,B00,083141,Abi Samra; Nicholas Camill,0,0,30,30
1658036560059,MATH 10A,A01,083735,Patchell; Gregory David,2,0,30,28
1658036560059,MATH 10A,A02,083736,Patchell; Gregory David,20,0,30,10
1658036560059,MATH 10A,A03,083737,Patchell; Gregory David,16,0,30,14
1658036566082,MATH 10B,A01,083207,Lim; Seonhee,9,0,34,25
1658036566082,MATH 10B,A02,083208,Lim; Seonhee,10,0,35,25
1658036566082,MATH 10B,A03,093472,Lim; Seonhee,7,0,34,27
1658036566082,MATH 10B,B01,083739,Sinha; Shubham,14,0,30,16
1658036572107,MATH 18,A01,083743,Cinel; Cameron Alexander,9,0,30,21
1658036572107,MATH 18,A02,083744,Cinel; Cameron Alexander,18,0,30,12
1658036572107,MATH 18,A03,083745,Cinel; Cameron Alexander,10,0,30,20
1658036572107,MATH 18,B01,083748,Rideout; David Porter,5,0,37,32
1658036572107,MATH 18,B02,083749,Rideout; David Porter,5,0,36,31
1658036572107,MATH 18,B03,083750,Rideout; David Porter,3,0,37,34
1658036572107,MATH 18,B04,083751,Rideout; David Porter,7,0,36,29
1658036572107,MATH 18,B05,093473,Rideout; David Porter,7,0,36,29
1658036572107,MATH 18,B06,093474,Rideout; David Porter,6,0,36,30
1658036578132,MATH 20A,A01,083754,Zheng; Zequn,14,0,40,26
1658036584159,MATH 20B,A01,083756,Briones; Jor-el Thomas Caparas,4,0,36,32
1658036584159,MATH 20B,A02,083757,Briones; Jor-el Thomas Caparas,1,0,36,35
1658036584159,MATH 20B,A03,093475,Briones; Jor-el Thomas Caparas,3,0,36,33
1658036590183,MATH 20C,A01,083760,Briones; Jor-el Thomas Caparas,1,0,35,34
1658036590183,MATH 20C,A02,083761,Briones; Jor-el Thomas Caparas,8,0,35,27
1658036590183,MATH 20C,A03,093476,Briones; Jor-el Thomas Caparas,0,1,36,36
1658036590183,MATH 20C,B01,083762,Bach; Quang Tran,1,0,30,29
1658036596210,MATH 20D,A01,083765,Tran; Brian Kha,5,0,30,25
1658036596210,MATH 20D,A02,083766,Tran; Brian Kha,5,0,30,25
1658036596210,MATH 20D,A03,083767,Tran; Brian Kha,6,0,30,24
1658036602238,MATH 20E,A01,083771,Ganguly; Soumya,12,0,32,20
1658036602238,MATH 20E,A02,083772,Ganguly; Soumya,7,0,32,25
1658036602238,MATH 20E,B01,083773,Ciotti; Benjamin,20,0,35,15
1658036602238,MATH 20E,B02,083774,Ciotti; Benjamin,18,0,35,17
1658036608262,MATH 103A,A01,083777,Greenfeld; Be'Eri,6,0,36,30
1658036608262,MATH 103A,A02,083778,Greenfeld; Be'Eri,5,0,36,31
1658036608262,MATH 103A,A03,093561,Greenfeld; Be'Eri,7,0,36,29
1658036608262,MATH 103A,B01,083779,Greenfeld; Be'Eri,8,0,36,28
1658036608262,MATH 103A,B02,083780,Greenfeld; Be'Eri,4,0,36,32
1658036608262,MATH 103A,B03,093562,Greenfeld; Be'Eri,3,0,36,33
1658036614284,MATH 105,A01,085443,Carter; Anne Toulson,15,0,35,20
1658036614284,MATH 105,A02,093477,Carter; Anne Toulson,20,0,35,15
1658036620313,MATH 109,A01,083213,Ganzberger; Geoffrey Michael,3,0,34,31
1658036620313,MATH 109,A02,083214,Ganzberger; Geoffrey Michael,4,0,34,30
1658036620313,MATH 109,A03,093478,Ganzberger; Geoffrey Michael,2,0,34,32
1658036620313,MATH 109,B01,083215,Ganzberger; Geoffrey Michael,3,0,32,29
1658036620313,MATH 109,B02,083216,Ganzberger; Geoffrey Michael,3,0,32,29
1658036620313,MATH 109,B03,093479,Ganzberger; Geoffrey Michael,8,0,32,24
1658036626337,MATH 142A,A01,083219,Chow; Bennett,7,0,32,25
1658036626337,MATH 142A,A02,083220,Chow; Bennett,10,0,32,22
1658036626337,MATH 142A,A03,093480,Chow; Bennett,9,0,32,23
1658036626337,MATH 142A,B03,093481,Chow; Bennett,8,0,32,24
1658036626337,MATH 142A,B04,093558,Chow; Bennett,14,0,32,18
1658036626337,MATH 142A,B05,093559,Chow; Bennett,7,0,32,25
1658036632365,MATH 193A,A01,083224,Rotar; Vladimir,9,0,34,25
1658036632365,MATH 193A,A02,083225,Rotar; Vladimir,11,0,34,23
1658036632365,MATH 193A,A03,083781,Rotar; Vladimir,5,0,34,29
1658036632365,MATH 193A,A04,083782,Rotar; Vladimir,12,0,34,22
1658036632365,MATH 193A,A05,093482,Rotar; Vladimir,11,0,34,23
1658036638389,MATH 197,001,091859,McAuley; Julian John,9999,0,9999,0
1658036638389,MATH 197,002,095566,Kedlaya; Kiran S.,9997,0,9999,2
1658036638389,MATH 197,003,095567,Xiao; Ming,9999,0,9999,0
1658036638389,MATH 197,004,095571,Perols; Johan Lars,9998,0,9999,1
1658036645452,COGS 9,A01,083615,Shannon; Kyle Michael,11,0,75,64
1658036651474,COGS 11,A01,083617,Boyle; Mary E. T.,23,0,48,25
1658036657501,COGS 13,A01,083071,Bastos; Amalia Pinkusfeld,12,0,71,59
1658036663528,COGS 14A,A01,092681,Semenuks; Arturs,5,1,100,95
1658036669556,COGS 14B,A01,083073,Cheng; Tzu-Han,7,0,63,56
1658036675582,COGS 17,A01,092677,Semenuks; Arturs,7,0,81,74
1658036681607,COGS 100,A01,083619,Allen; Michael Gordon,17,0,70,53
1658036687633,COGS 101A,A01,083621,Davis; Joshua Daniel,9,0,68,59
1658036693658,COGS 101B,A01,091572,Allen; Michael Gordon,14,0,65,51
1658036699685,COGS 101C,A01,083625,Delgado; Tania,17,0,35,18
1658036705713,COGS 107A,A01,083627,Boyle; Mary E. T.,14,0,60,46
1658036711739,COGS 118A,A01,083075,Gupta; Anjum,21,0,76,55
1658036717766,CSE 3,A50,083646,Miranda; Gregory Joseph,24,0,50,26
1658036723796,CSE 8A,A50,083650,Miranda; Gregory Joseph,17,1,56,39
1658036729819,CSE 11,A01,083080,Cao; Yingjun,7,15,40,33
1658036735842,CSE 12,A01,083652,Krause-Levy; Sophia Louisa,30,1,120,90
1658036741863,CSE 15L,A01,083654,Morris; Justin Loren,9,0,50,41
1658036741863,CSE 15L,A02,083655,Morris; Justin Loren,11,0,50,39
1658036747886,CSE 20,A01,083657,Tran; Khoa Dang,39,0,80,41
1658036753912,CSE 21,A01,095574,Bach; Quang Tran,23,0,48,25
1658036759938,CSE 30,A01,083084,Eldon; John,8,0,80,72
1658036759938,CSE 30,B01,095061,Bhaskar; Nishant,9,0,50,41
1658036765961,CSE 100,A01,083659,Cao; Yingjun,5,4,70,65
1658036771983,CSE 134B,A01,083661,Powell; Thomas Allan,25,0,100,75
1658036778008,CSE 140,A01,083663,Gungor; Onat,17,0,85,68
1658036784031,CSE 140L,A01,083088,Eldon; John,23,0,100,77
1658036790057,CSE 175,A01,083665,Kumar; Rakesh,3,0,25,22
1658036796081,CSE 190,A00,092507,Dubnov; Shlomo,8,0,20,12
1658036802107,ECE 45,A01,083139,Congero; Spencer William,7,0,75,68
1658036808129,ECE 65,A50,083695,Saad; Andrew S,12,0,30,18
1658036808129,ECE 65,A51,095125,Saad; Andrew S,24,0,26,2
1658036814150,ECE 109,A01,091882,Touri; Behrouz,21,0,70,49
1658036820172,ECE 180,A00,083140,Abi Samra; Nicholas Camill,1,0,30,29
1658036820172,ECE 180,B00,083141,Abi Samra; Nicholas Camill,0,0,30,30
1658036826195,MATH 10A,A01,083735,Patchell; Gregory David,2,0,30,28
1658036826195,MATH 10A,A02,083736,Patchell; Gregory David,20,0,30,10
1658036826195,MATH 10A,A03,083737,Patchell; Gregory David,16,0,30,14
1658036832218,MATH 10B,A01,083207,Lim; Seonhee,9,0,34,25
1658036832218,MATH 10B,A02,083208,Lim; Seonhee,10,0,35,25
1658036832218,MATH 10B,A03,093472,Lim; Seonhee,7,0,34,27
1658036832218,MATH 10B,B01,083739,Sinha; Shubham,14,0,30,16
1658036838249,MATH 18,A01,083743,Cinel; Cameron Alexander,9,0,30,21
1658036838249,MATH 18,A02,083744,Cinel; Cameron Alexander,18,0,30,12
1658036838249,MATH 18,A03,083745,Cinel; Cameron Alexander,10,0,30,20
1658036838249,MATH 18,B01,083748,Rideout; David Porter,5,0,37,32
1658036838249,MATH 18,B02,083749,Rideout; David Porter,5,0,36,31
1658036838249,MATH 18,B03,083750,Rideout; David Porter,3,0,37,34
1658036838249,MATH 18,B04,083751,Rideout; David Porter,7,0,36,29
1658036838249,MATH 18,B05,093473,Rideout; David Porter,7,0,36,29
1658036838249,MATH 18,B06,093474,Rideout; David Porter,6,0,36,30
1658036844273,MATH 20A,A01,083754,Zheng; Zequn,14,0,40,26
1658036850301,MATH 20B,A01,083756,Briones; Jor-el Thomas Caparas,4,0,36,32
1658036850301,MATH 20B,A02,083757,Briones; Jor-el Thomas Caparas,1,0,36,35
1658036850301,MATH 20B,A03,093475,Briones; Jor-el Thomas Caparas,3,0,36,33
1658036856335,MATH 20C,A01,083760,Briones; Jor-el Thomas Caparas,1,0,35,34
1658036856335,MATH 20C,A02,083761,Briones; Jor-el Thomas Caparas,8,0,35,27
1658036856335,MATH 20C,A03,093476,Briones; Jor-el Thomas Caparas,0,1,36,36
1658036856335,MATH 20C,B01,083762,Bach; Quang Tran,1,0,30,29
1658036862363,MATH 20D,A01,083765,Tran; Brian Kha,5,0,30,25
1658036862363,MATH 20D,A02,083766,Tran; Brian Kha,5,0,30,25
1658036862363,MATH 20D,A03,083767,Tran; Brian Kha,6,0,30,24
1658036868391,MATH 20E,A01,083771,Ganguly; Soumya,12,0,32,20
1658036868391,MATH 20E,A02,083772,Ganguly; Soumya,7,0,32,25
1658036868391,MATH 20E,B01,083773,Ciotti; Benjamin,20,0,35,15
1658036868391,MATH 20E,B02,083774,Ciotti; Benjamin,18,0,35,17
1658036874420,MATH 103A,A01,083777,Greenfeld; Be'Eri,6,0,36,30
1658036874420,MATH 103A,A02,083778,Greenfeld; Be'Eri,5,0,36,31
1658036874420,MATH 103A,A03,093561,Greenfeld; Be'Eri,7,0,36,29
1658036874420,MATH 103A,B01,083779,Greenfeld; Be'Eri,8,0,36,28
1658036874420,MATH 103A,B02,083780,Greenfeld; Be'Eri,4,0,36,32
1658036874420,MATH 103A,B03,093562,Greenfeld; Be'Eri,3,0,36,33
1658036880442,MATH 105,A01,085443,Carter; Anne Toulson,15,0,35,20
1658036880442,MATH 105,A02,093477,Carter; Anne Toulson,20,0,35,15
1658036886470,MATH 109,A01,083213,Ganzberger; Geoffrey Michael,3,0,34,31
1658036886470,MATH 109,A02,083214,Ganzberger; Geoffrey Michael,4,0,34,30
1658036886470,MATH 109,A03,093478,Ganzberger; Geoffrey Michael,2,0,34,32
1658036886470,MATH 109,B01,083215,Ganzberger; Geoffrey Michael,3,0,32,29
1658036886470,MATH 109,B02,083216,Ganzberger; Geoffrey Michael,3,0,32,29
1658036886470,MATH 109,B03,093479,Ganzberger; Geoffrey Michael,8,0,32,24
1658036892493,MATH 142A,A01,083219,Chow; Bennett,7,0,32,25
1658036892493,MATH 142A,A02,083220,Chow; Bennett,10,0,32,22
1658036892493,MATH 142A,A03,093480,Chow; Bennett,9,0,32,23
1658036892493,MATH 142A,B03,093481,Chow; Bennett,8,0,32,24
1658036892493,MATH 142A,B04,093558,Chow; Bennett,14,0,32,18
1658036892493,MATH 142A,B05,093559,Chow; Bennett,7,0,32,25
1658036898528,MATH 193A,A01,083224,Rotar; Vladimir,9,0,34,25
1658036898528,MATH 193A,A02,083225,Rotar; Vladimir,11,0,34,23
1658036898528,MATH 193A,A03,083781,Rotar; Vladimir,5,0,34,29
1658036898528,MATH 193A,A04,083782,Rotar; Vladimir,12,0,34,22
1658036898528,MATH 193A,A05,093482,Rotar; Vladimir,11,0,34,23
1658036904554,MATH 197,001,091859,McAuley; Julian John,9999,0,9999,0
1658036904554,MATH 197,002,095566,Kedlaya; Kiran S.,9997,0,9999,2
1658036904554,MATH 197,003,095567,Xiao; Ming,9999,0,9999,0
1658036904554,MATH 197,004,095571,Perols; Johan Lars,9998,0,9999,1
1658036911618,COGS 9,A01,083615,Shannon; Kyle Michael,11,0,75,64
1658036917646,COGS 11,A01,083617,Boyle; Mary E. T.,23,0,48,25
1658036923744,COGS 13,A01,083071,Bastos; Amalia Pinkusfeld,12,0,71,59
1658036929767,COGS 14A,A01,092681,Semenuks; Arturs,5,1,100,95
1658036935794,COGS 14B,A01,083073,Cheng; Tzu-Han,7,0,63,56
1658036941817,COGS 17,A01,092677,Semenuks; Arturs,7,0,81,74
1658036947841,COGS 100,A01,083619,Allen; Michael Gordon,17,0,70,53
1658036953864,COGS 101A,A01,083621,Davis; Joshua Daniel,9,0,68,59
1658036959890,COGS 101B,A01,091572,Allen; Michael Gordon,14,0,65,51
1658036965916,COGS 101C,A01,083625,Delgado; Tania,17,0,35,18
1658036971941,COGS 107A,A01,083627,Boyle; Mary E. T.,14,0,60,46
1658036977966,COGS 118A,A01,083075,Gupta; Anjum,21,0,76,55
1658036983990,CSE 3,A50,083646,Miranda; Gregory Joseph,24,0,50,26
1658036990014,CSE 8A,A50,083650,Miranda; Gregory Joseph,17,1,56,39
1658036996041,CSE 11,A01,083080,Cao; Yingjun,7,15,40,33
1658037002068,CSE 12,A01,083652,Krause-Levy; Sophia Louisa,30,1,120,90
1658037008095,CSE 15L,A01,083654,Morris; Justin Loren,9,0,50,41
1658037008095,CSE 15L,A02,083655,Morris; Justin Loren,11,0,50,39
1658037014117,CSE 20,A01,083657,Tran; Khoa Dang,39,0,80,41
1658037020143,CSE 21,A01,095574,Bach; Quang Tran,23,0,48,25
1658037026167,CSE 30,A01,083084,Eldon; John,8,0,80,72
1658037026167,CSE 30,B01,095061,Bhaskar; Nishant,9,0,50,41
1658037032190,CSE 100,A01,083659,Cao; Yingjun,5,4,70,65
1658037038215,CSE 134B,A01,083661,Powell; Thomas Allan,25,0,100,75
1658037044240,CSE 140,A01,083663,Gungor; Onat,17,0,85,68
1658037050263,CSE 140L,A01,083088,Eldon; John,23,0,100,77
1658037056286,CSE 175,A01,083665,Kumar; Rakesh,3,0,25,22
1658037062313,CSE 190,A00,092507,Dubnov; Shlomo,8,0,20,12
1658037068339,ECE 45,A01,083139,Congero; Spencer William,7,0,75,68
1658037074362,ECE 65,A50,083695,Saad; Andrew S,12,0,30,18
1658037074362,ECE 65,A51,095125,Saad; Andrew S,24,0,26,2
1658037080385,ECE 109,A01,091882,Touri; Behrouz,21,0,70,49
1658037086409,ECE 180,A00,083140,Abi Samra; Nicholas Camill,1,0,30,29
1658037086409,ECE 180,B00,083141,Abi Samra; Nicholas Camill,0,0,30,30
1658037092433,MATH 10A,A01,083735,Patchell; Gregory David,2,0,30,28
1658037092433,MATH 10A,A02,083736,Patchell; Gregory David,20,0,30,10
1658037092433,MATH 10A,A03,083737,Patchell; Gregory David,16,0,30,14
1658037098457,MATH 10B,A01,083207,Lim; Seonhee,9,0,34,25
1658037098457,MATH 10B,A02,083208,Lim; Seonhee,10,0,35,25
1658037098457,MATH 10B,A03,093472,Lim; Seonhee,7,0,34,27
1658037098457,MATH 10B,B01,083739,Sinha; Shubham,14,0,30,16
1658037104489,MATH 18,A01,083743,Cinel; Cameron Alexander,9,0,30,21
1658037104489,MATH 18,A02,083744,Cinel; Cameron Alexander,18,0,30,12
1658037104489,MATH 18,A03,083745,Cinel; Cameron Alexander,10,0,30,20
1658037104489,MATH 18,B01,083748,Rideout; David Porter,5,0,37,32
1658037104489,MATH 18,B02,083749,Rideout; David Porter,5,0,36,31
1658037104489,MATH 18,B03,083750,Rideout; David Porter,3,0,37,34
1658037104489,MATH 18,B04,083751,Rideout; David Porter,7,0,36,29
1658037104489,MATH 18,B05,093473,Rideout; David Porter,7,0,36,29
1658037104489,MATH 18,B06,093474,Rideout; David Porter,6,0,36,30
1658037110514,MATH 20A,A01,083754,Zheng; Zequn,14,0,40,26
1658037116546,MATH 20B,A01,083756,Briones; Jor-el Thomas Caparas,4,0,36,32
1658037116546,MATH 20B,A02,083757,Briones; Jor-el Thomas Caparas,1,0,36,35
1658037116546,MATH 20B,A03,093475,Briones; Jor-el Thomas Caparas,3,0,36,33
1658037122572,MATH 20C,A01,083760,Briones; Jor-el Thomas Caparas,1,0,35,34
1658037122572,MATH 20C,A02,083761,Briones; Jor-el Thomas Caparas,8,0,35,27
1658037122572,MATH 20C,A03,093476,Briones; Jor-el Thomas Caparas,0,1,36,36
1658037122572,MATH 20C,B01,083762,Bach; Quang Tran,1,0,30,29
1658037128601,MATH 20D,A01,083765,Tran; Brian Kha,5,0,30,25
1658037128601,MATH 20D,A02,083766,Tran; Brian Kha,5,0,30,25
1658037128601,MATH 20D,A03,083767,Tran; Brian Kha,6,0,30,24
1658037134629,MATH 20E,A01,083771,Ganguly; Soumya,12,0,32,20
1658037134629,MATH 20E,A02,083772,Ganguly; Soumya,7,0,32,25
1658037134629,MATH 20E,B01,083773,Ciotti; Benjamin,20,0,35,15
1658037134629,MATH 20E,B02,083774,Ciotti; Benjamin,18,0,35,17
1658037140652,MATH 103A,A01,083777,Greenfeld; Be'Eri,6,0,36,30
1658037140652,MATH 103A,A02,083778,Greenfeld; Be'Eri,5,0,36,31
1658037140652,MATH 103A,A03,093561,Greenfeld; Be'Eri,7,0,36,29
1658037140652,MATH 103A,B01,083779,Greenfeld; Be'Eri,8,0,36,28
1658037140652,MATH 103A,B02,083780,Greenfeld; Be'Eri,4,0,36,32
1658037140652,MATH 103A,B03,093562,Greenfeld; Be'Eri,3,0,36,33
1658037146677,MATH 105,A01,085443,Carter; Anne Toulson,15,0,35,20
1658037146677,MATH 105,A02,093477,Carter; Anne Toulson,20,0,35,15
1658037152701,MATH 109,A01,083213,Ganzberger; Geoffrey Michael,3,0,34,31
1658037152701,MATH 109,A02,083214,Ganzberger; Geoffrey Michael,4,0,34,30
1658037152701,MATH 109,A03,093478,Ganzberger; Geoffrey Michael,2,0,34,32
1658037152701,MATH 109,B01,083215,Ganzberger; Geoffrey Michael,3,0,32,29
1658037152701,MATH 109,B02,083216,Ganzberger; Geoffrey Michael,3,0,32,29
1658037152701,MATH 109,B03,093479,Ganzberger; Geoffrey Michael,8,0,32,24
1658037158726,MATH 142A,A01,083219,Chow; Bennett,7,0,32,25
1658037158726,MATH 142A,A02,083220,Chow; Bennett,10,0,32,22
1658037158726,MATH 142A,A03,093480,Chow; Bennett,9,0,32,23
1658037158726,MATH 142A,B03,093481,Chow; Bennett,8,0,32,24
1658037158726,MATH 142A,B04,093558,Chow; Bennett,14,0,32,18
1658037158726,MATH 142A,B05,093559,Chow; Bennett,7,0,32,25
1658037164749,MATH 193A,A01,083224,Rotar; Vladimir,9,0,34,25
1658037164749,MATH 193A,A02,083225,Rotar; Vladimir,11,0,34,23
1658037164749,MATH 193A,A03,083781,Rotar; Vladimir,5,0,34,29
1658037164749,MATH 193A,A04,083782,Rotar; Vladimir,12,0,34,22
1658037164749,MATH 193A,A05,093482,Rotar; Vladimir,11,0,34,23
1658037170774,MATH 197,001,091859,McAuley; Julian John,9999,0,9999,0
1658037170774,MATH 197,002,095566,Kedlaya; Kiran S.,9997,0,9999,2
1658037170774,MATH 197,003,095567,Xiao; Ming,9999,0,9999,0
1658037170774,MATH 197,004,095571,Perols; Johan Lars,9998,0,9999,1
1658037177823,COGS 9,A01,083615,Shannon; Kyle Michael,11,0,75,64
1658037183846,COGS 11,A01,083617,Boyle; Mary E. T.,23,0,48,25
1658037189873,COGS 13,A01,083071,Bastos; Amalia Pinkusfeld,12,0,71,59
1658037195896,COGS 14A,A01,092681,Semenuks; Arturs,5,1,100,95
1658037201920,COGS 14B,A01,083073,Cheng; Tzu-Han,7,0,63,56
1658037207943,COGS 17,A01,092677,Semenuks; Arturs,7,0,81,74
1658037213966,COGS 100,A01,083619,Allen; Michael Gordon,17,0,70,53
1658037219990,COGS 101A,A01,083621,Davis; Joshua Daniel,9,0,68,59
1658037226015,COGS 101B,A01,091572,Allen; Michael Gordon,14,0,65,51
1658037232041,COGS 101C,A01,083625,Delgado; Tania,17,0,35,18
1658037238069,COGS 107A,A01,083627,Boyle; Mary E. T.,14,0,60,46
1658037244090,COGS 118A,A01,083075,Gupta; Anjum,21,0,76,55
1658037250117,CSE 3,A50,083646,Miranda; Gregory Joseph,24,0,50,26
1658037256146,CSE 8A,A50,083650,Miranda; Gregory Joseph,17,1,56,39
1658037262168,CSE 11,A01,083080,Cao; Yingjun,7,15,40,33
1658037268196,CSE 12,A01,083652,Krause-Levy; Sophia Louisa,30,1,120,90
1658037274222,CSE 15L,A01,083654,Morris; Justin Loren,9,0,50,41
1658037274222,CSE 15L,A02,083655,Morris; Justin Loren,11,0,50,39
1658037280248,CSE 20,A01,083657,Tran; Khoa Dang,39,0,80,41
1658037286272,CSE 21,A01,095574,Bach; Quang Tran,23,0,48,25
1658037292305,CSE 30,A01,083084,Eldon; John,8,0,80,72
1658037292305,CSE 30,B01,095061,Bhaskar; Nishant,9,0,50,41
1658037298327,CSE 100,A01,083659,Cao; Yingjun,5,4,70,65
1658037304352,CSE 134B,A01,083661,Powell; Thomas Allan,25,0,100,75
1658037310377,CSE 140,A01,083663,Gungor; Onat,17,0,85,68
1658037316400,CSE 140L,A01,083088,Eldon; John,23,0,100,77
1658037322421,CSE 175,A01,083665,Kumar; Rakesh,3,0,25,22
1658037328445,CSE 190,A00,092507,Dubnov; Shlomo,8,0,20,12
1658037334468,ECE 45,A01,083139,Congero; Spencer William,7,0,75,68
1658037340491,ECE 65,A50,083695,Saad; Andrew S,12,0,30,18
1658037340491,ECE 65,A51,095125,Saad; Andrew S,24,0,26,2
1658037346514,ECE 109,A01,091882,Touri; Behrouz,21,0,70,49
1658037352538,ECE 180,A00,083140,Abi Samra; Nicholas Camill,1,0,30,29
1658037352538,ECE 180,B00,083141,Abi Samra; Nicholas Camill,0,0,30,30
1658037358561,MATH 10A,A01,083735,Patchell; Gregory David,2,0,30,28
1658037358561,MATH 10A,A02,083736,Patchell; Gregory David,20,0,30,10
1658037358561,MATH 10A,A03,083737,Patchell; Gregory David,16,0,30,14
1658037364585,MATH 10B,A01,083207,Lim; Seonhee,9,0,34,25
1658037364585,MATH 10B,A02,083208,Lim; Seonhee,10,0,35,25
1658037364585,MATH 10B,A03,093472,Lim; Seonhee,7,0,34,27
1658037364585,MATH 10B,B01,083739,Sinha; Shubham,14,0,30,16
1658037370614,MATH 18,A01,083743,Cinel; Cameron Alexander,9,0,30,21
1658037370614,MATH 18,A02,083744,Cinel; Cameron Alexander,18,0,30,12
1658037370614,MATH 18,A03,083745,Cinel; Cameron Alexander,10,0,30,20
1658037370614,MATH 18,B01,083748,Rideout; David Porter,5,0,37,32
1658037370614,MATH 18,B02,083749,Rideout; David Porter,5,0,36,31
1658037370614,MATH 18,B03,083750,Rideout; David Porter,3,0,37,34
1658037370614,MATH 18,B04,083751,Rideout; David Porter,7,0,36,29
1658037370614,MATH 18,B05,093473,Rideout; David Porter,7,0,36,29
1658037370614,MATH 18,B06,093474,Rideout; David Porter,6,0,36,30
1658037376637,MATH 20A,A01,083754,Zheng; Zequn,14,0,40,26
1658037382664,MATH 20B,A01,083756,Briones; Jor-el Thomas Caparas,4,0,36,32
1658037382664,MATH 20B,A02,083757,Briones; Jor-el Thomas Caparas,1,0,36,35
1658037382664,MATH 20B,A03,093475,Briones; Jor-el Thomas Caparas,3,0,36,33
1658037388688,MATH 20C,A01,083760,Briones; Jor-el Thomas Caparas,1,0,35,34
1658037388688,MATH 20C,A02,083761,Briones; Jor-el Thomas Caparas,8,0,35,27
1658037388688,MATH 20C,A03,093476,Briones; Jor-el Thomas Caparas,0,1,36,36
1658037388688,MATH 20C,B01,083762,Bach; Quang Tran,1,0,30,29
1658037394715,MATH 20D,A01,083765,Tran; Brian Kha,5,0,30,25
1658037394715,MATH 20D,A02,083766,Tran; Brian Kha,5,0,30,25
1658037394715,MATH 20D,A03,083767,Tran; Brian Kha,6,0,30,24
1658037400744,MATH 20E,A01,083771,Ganguly; Soumya,12,0,32,20
1658037400744,MATH 20E,A02,083772,Ganguly; Soumya,7,0,32,25
1658037400744,MATH 20E,B01,083773,Ciotti; Benjamin,20,0,35,15
1658037400744,MATH 20E,B02,083774,Ciotti; Benjamin,18,0,35,17
1658037406768,MATH 103A,A01,083777,Greenfeld; Be'Eri,6,0,36,30
1658037406768,MATH 103A,A02,083778,Greenfeld; Be'Eri,5,0,36,31
1658037406768,MATH 103A,A03,093561,Greenfeld; Be'Eri,7,0,36,29
1658037406768,MATH 103A,B01,083779,Greenfeld; Be'Eri,8,0,36,28
1658037406768,MATH 103A,B02,083780,Greenfeld; Be'Eri,4,0,36,32
1658037406768,MATH 103A,B03,093562,Greenfeld; Be'Eri,3,0,36,33
1658037412795,MATH 105,A01,085443,Carter; Anne Toulson,15,0,35,20
1658037412795,MATH 105,A02,093477,Carter; Anne Toulson,20,0,35,15
1658037418819,MATH 109,A01,083213,Ganzberger; Geoffrey Michael,3,0,34,31
1658037418819,MATH 109,A02,083214,Ganzberger; Geoffrey Michael,4,0,34,30
1658037418819,MATH 109,A03,093478,Ganzberger; Geoffrey Michael,2,0,34,32
1658037418819,MATH 109,B01,083215,Ganzberger; Geoffrey Michael,3,0,32,29
1658037418819,MATH 109,B02,083216,Ganzberger; Geoffrey Michael,3,0,32,29
1658037418819,MATH 109,B03,093479,Ganzberger; Geoffrey Michael,8,0,32,24
1658037424848,MATH 142A,A01,083219,Chow; Bennett,7,0,32,25
1658037424848,MATH 142A,A02,083220,Chow; Bennett,10,0,32,22
1658037424848,MATH 142A,A03,093480,Chow; Bennett,9,0,32,23
1658037424848,MATH 142A,B03,093481,Chow; Bennett,8,0,32,24
1658037424848,MATH 142A,B04,093558,Chow; Bennett,14,0,32,18
1658037424848,MATH 142A,B05,093559,Chow; Bennett,7,0,32,25
1658037430873,MATH 193A,A01,083224,Rotar; Vladimir,9,0,34,25
1658037430873,MATH 193A,A02,083225,Rotar; Vladimir,11,0,34,23
1658037430873,MATH 193A,A03,083781,Rotar; Vladimir,5,0,34,29
1658037430873,MATH 193A,A04,083782,Rotar; Vladimir,12,0,34,22
1658037430873,MATH 193A,A05,093482,Rotar; Vladimir,11,0,34,23
1658037436897,MATH 197,001,091859,McAuley; Julian John,9999,0,9999,0
1658037436897,MATH 197,002,095566,Kedlaya; Kiran S.,9997,0,9999,2
1658037436897,MATH 197,003,095567,Xiao; Ming,9999,0,9999,0
1658037436897,MATH 197,004,095571,Perols; Johan Lars,9998,0,9999,1
1658037443950,COGS 9,A01,083615,Shannon; Kyle Michael,11,0,75,64
1658037449973,COGS 11,A01,083617,Boyle; Mary E. T.,23,0,48,25
1658037456004,COGS 13,A01,083071,Bastos; Amalia Pinkusfeld,12,0,71,59
1658037462031,COGS 14A,A01,092681,Semenuks; Arturs,5,1,100,95
1658037468055,COGS 14B,A01,083073,Cheng; Tzu-Han,7,0,63,56
1658037474079,COGS 17,A01,092677,Semenuks; Arturs,7,0,81,74
1658037480105,COGS 100,A01,083619,Allen; Michael Gordon,17,0,70,53
1658037486138,COGS 101A,A01,083621,Davis; Joshua Daniel,9,0,68,59
1658037492165,COGS 101B,A01,091572,Allen; Michael Gordon,14,0,65,51
1658037498189,COGS 101C,A01,083625,Delgado; Tania,17,0,35,18
1658037504214,COGS 107A,A01,083627,Boyle; Mary E. T.,14,0,60,46
1658037510249,COGS 118A,A01,083075,Gupta; Anjum,21,0,76,55
1658037516283,CSE 3,A50,083646,Miranda; Gregory Joseph,24,0,50,26
1658037522380,CSE 8A,A50,083650,Miranda; Gregory Joseph,17,1,56,39
1658037528402,CSE 11,A01,083080,Cao; Yingjun,7,15,40,33
1658037534423,CSE 12,A01,083652,Krause-Levy; Sophia Louisa,30,1,120,90
1658037540446,CSE 15L,A01,083654,Morris; Justin Loren,9,0,50,41
1658037540446,CSE 15L,A02,083655,Morris; Justin Loren,11,0,50,39
1658037546469,CSE 20,A01,083657,Tran; Khoa Dang,39,0,80,41
1658037552492,CSE 21,A01,095574,Bach; Quang Tran,23,0,48,25
1658037558517,CSE 30,A01,083084,Eldon; John,8,0,80,72
1658037558517,CSE 30,B01,095061,Bhaskar; Nishant,9,0,50,41
1658037564540,CSE 100,A01,083659,Cao; Yingjun,5,4,70,65
1658037570567,CSE 134B,A01,083661,Powell; Thomas Allan,25,0,100,75
1658037576592,CSE 140,A01,083663,Gungor; Onat,17,0,85,68
1658037582616,CSE 140L,A01,083088,Eldon; John,23,0,100,77
1658037588642,CSE 175,A01,083665,Kumar; Rakesh,3,0,25,22
1658037594668,CSE 190,A00,092507,Dubnov; Shlomo,8,0,20,12
1658037600691,ECE 45,A01,083139,Congero; Spencer William,7,0,75,68
1658037606714,ECE 65,A50,083695,Saad; Andrew S,12,0,30,18
1658037606714,ECE 65,A51,095125,Saad; Andrew S,24,0,26,2
1658037612736,ECE 109,A01,091882,Touri; Behrouz,21,0,70,49
1658037618758,ECE 180,A00,083140,Abi Samra; Nicholas Camill,1,0,30,29
1658037618758,ECE 180,B00,083141,Abi Samra; Nicholas Camill,0,0,30,30
1658037624783,MATH 10A,A01,083735,Patchell; Gregory David,2,0,30,28
1658037624783,MATH 10A,A02,083736,Patchell; Gregory David,20,0,30,10
1658037624783,MATH 10A,A03,083737,Patchell; Gregory David,16,0,30,14
1658037630808,MATH 10B,A01,083207,Lim; Seonhee,9,0,34,25
1658037630808,MATH 10B,A02,083208,Lim; Seonhee,10,0,35,25
1658037630808,MATH 10B,A03,093472,Lim; Seonhee,7,0,34,27
1658037630808,MATH 10B,B01,083739,Sinha; Shubham,14,0,30,16
1658037636847,MATH 18,A01,083743,Cinel; Cameron Alexander,9,0,30,21
1658037636847,MATH 18,A02,083744,Cinel; Cameron Alexander,18,0,30,12
1658037636847,MATH 18,A03,083745,Cinel; Cameron Alexander,10,0,30,20
1658037636847,MATH 18,B01,083748,Rideout; David Porter,5,0,37,32
1658037636847,MATH 18,B02,083749,Rideout; David Porter,5,0,36,31
1658037636847,MATH 18,B03,083750,Rideout; David Porter,3,0,37,34
1658037636847,MATH 18,B04,083751,Rideout; David Porter,7,0,36,29
1658037636847,MATH 18,B05,093473,Rideout; David Porter,7,0,36,29
1658037636847,MATH 18,B06,093474,Rideout; David Porter,6,0,36,30
1658037642871,MATH 20A,A01,083754,Zheng; Zequn,14,0,40,26
1658037648896,MATH 20B,A01,083756,Briones; Jor-el Thomas Caparas,4,0,36,32
1658037648896,MATH 20B,A02,083757,Briones; Jor-el Thomas Caparas,1,0,36,35
1658037648896,MATH 20B,A03,093475,Briones; Jor-el Thomas Caparas,3,0,36,33
1658037654921,MATH 20C,A01,083760,Briones; Jor-el Thomas Caparas,1,0,35,34
1658037654921,MATH 20C,A02,083761,Briones; Jor-el Thomas Caparas,8,0,35,27
1658037654921,MATH 20C,A03,093476,Briones; Jor-el Thomas Caparas,0,1,36,36
1658037654921,MATH 20C,B01,083762,Bach; Quang Tran,1,0,30,29
1658037660946,MATH 20D,A01,083765,Tran; Brian Kha,5,0,30,25
1658037660946,MATH 20D,A02,083766,Tran; Brian Kha,5,0,30,25
1658037660946,MATH 20D,A03,083767,Tran; Brian Kha,6,0,30,24
1658037666971,MATH 20E,A01,083771,Ganguly; Soumya,12,0,32,20
1658037666971,MATH 20E,A02,083772,Ganguly; Soumya,7,0,32,25
1658037666971,MATH 20E,B01,083773,Ciotti; Benjamin,20,0,35,15
1658037666971,MATH 20E,B02,083774,Ciotti; Benjamin,18,0,35,17
1658037672997,MATH 103A,A01,083777,Greenfeld; Be'Eri,6,0,36,30
1658037672997,MATH 103A,A02,083778,Greenfeld; Be'Eri,5,0,36,31
1658037672997,MATH 103A,A03,093561,Greenfeld; Be'Eri,7,0,36,29
1658037672997,MATH 103A,B01,083779,Greenfeld; Be'Eri,8,0,36,28
1658037672997,MATH 103A,B02,083780,Greenfeld; Be'Eri,4,0,36,32
1658037672997,MATH 103A,B03,093562,Greenfeld; Be'Eri,3,0,36,33
1658037679020,MATH 105,A01,085443,Carter; Anne Toulson,15,0,35,20
1658037679020,MATH 105,A02,093477,Carter; Anne Toulson,20,0,35,15
1658037685049,MATH 109,A01,083213,Ganzberger; Geoffrey Michael,3,0,34,31
1658037685049,MATH 109,A02,083214,Ganzberger; Geoffrey Michael,4,0,34,30
1658037685049,MATH 109,A03,093478,Ganzberger; Geoffrey Michael,2,0,34,32
1658037685049,MATH 109,B01,083215,Ganzberger; Geoffrey Michael,3,0,32,29
1658037685049,MATH 109,B02,083216,Ganzberger; Geoffrey Michael,3,0,32,29
1658037685049,MATH 109,B03,093479,Ganzberger; Geoffrey Michael,8,0,32,24
1658037691074,MATH 142A,A01,083219,Chow; Bennett,7,0,32,25
1658037691074,MATH 142A,A02,083220,Chow; Bennett,10,0,32,22
1658037691074,MATH 142A,A03,093480,Chow; Bennett,9,0,32,23
1658037691074,MATH 142A,B03,093481,Chow; Bennett,8,0,32,24
1658037691074,MATH 142A,B04,093558,Chow; Bennett,14,0,32,18
1658037691074,MATH 142A,B05,093559,Chow; Bennett,7,0,32,25
1658037697102,MATH 193A,A01,083224,Rotar; Vladimir,9,0,34,25
1658037697102,MATH 193A,A02,083225,Rotar; Vladimir,11,0,34,23
1658037697102,MATH 193A,A03,083781,Rotar; Vladimir,5,0,34,29
1658037697102,MATH 193A,A04,083782,Rotar; Vladimir,12,0,34,22
1658037697102,MATH 193A,A05,093482,Rotar; Vladimir,11,0,34,23
1658037703125,MATH 197,001,091859,McAuley; Julian John,9999,0,9999,0
1658037703125,MATH 197,002,095566,Kedlaya; Kiran S.,9997,0,9999,2
1658037703125,MATH 197,003,095567,Xiao; Ming,9999,0,9999,0
1658037703125,MATH 197,004,095571,Perols; Johan Lars,9998,0,9999,1
1658037710189,COGS 9,A01,083615,Shannon; Kyle Michael,11,0,75,64
1658037716216,COGS 11,A01,083617,Boyle; Mary E. T.,23,0,48,25
1658037722264,COGS 13,A01,083071,Bastos; Amalia Pinkusfeld,12,0,71,59
1658037728293,COGS 14A,A01,092681,Semenuks; Arturs,5,1,100,95
1658037734322,COGS 14B,A01,083073,Cheng; Tzu-Han,7,0,63,56
1658037740352,COGS 17,A01,092677,Semenuks; Arturs,7,0,81,74
1658037746373,COGS 100,A01,083619,Allen; Michael Gordon,17,0,70,53
1658037752395,COGS 101A,A01,083621,Davis; Joshua Daniel,9,0,68,59
1658037758418,COGS 101B,A01,091572,Allen; Michael Gordon,14,0,65,51
1658037764442,COGS 101C,A01,083625,Delgado; Tania,17,0,35,18
1658037770467,COGS 107A,A01,083627,Boyle; Mary E. T.,14,0,60,46
1658037776495,COGS 118A,A01,083075,Gupta; Anjum,21,0,76,55
1658037782518,CSE 3,A50,083646,Miranda; Gregory Joseph,24,0,50,26
1658037788540,CSE 8A,A50,083650,Miranda; Gregory Joseph,17,1,56,39
1658037794563,CSE 11,A01,083080,Cao; Yingjun,7,15,40,33
1658037800584,CSE 12,A01,083652,Krause-Levy; Sophia Louisa,30,1,120,90
1658037806611,CSE 15L,A01,083654,Morris; Justin Loren,9,0,50,41
1658037806611,CSE 15L,A02,083655,Morris; Justin Loren,11,0,50,39
1658037812635,CSE 20,A01,083657,Tran; Khoa Dang,39,0,80,41
1658037818659,CSE 21,A01,095574,Bach; Quang Tran,23,0,48,25
1658037824683,CSE 30,A01,083084,Eldon; John,8,0,80,72
1658037824683,CSE 30,B01,095061,Bhaskar; Nishant,9,0,50,41
1658037830709,CSE 100,A01,083659,Cao; Yingjun,5,4,70,65
1658037836733,CSE 134B,A01,083661,Powell; Thomas Allan,25,0,100,75
1658037842767,CSE 140,A01,083663,Gungor; Onat,17,0,85,68
1658037848794,CSE 140L,A01,083088,Eldon; John,23,0,100,77
1658037854817,CSE 175,A01,083665,Kumar; Rakesh,3,0,25,22
1658037860844,CSE 190,A00,092507,Dubnov; Shlomo,8,0,20,12
1658037866867,ECE 45,A01,083139,Congero; Spencer William,7,0,75,68
1658037872891,ECE 65,A50,083695,Saad; Andrew S,12,0,30,18
1658037872891,ECE 65,A51,095125,Saad; Andrew S,24,0,26,2
1658037878921,ECE 109,A01,091882,Touri; Behrouz,21,0,70,49
1658037884951,ECE 180,A00,083140,Abi Samra; Nicholas Camill,1,0,30,29
1658037884951,ECE 180,B00,083141,Abi Samra; Nicholas Camill,0,0,30,30
1658037890975,MATH 10A,A01,083735,Patchell; Gregory David,2,0,30,28
1658037890975,MATH 10A,A02,083736,Patchell; Gregory David,20,0,30,10
1658037890975,MATH 10A,A03,083737,Patchell; Gregory David,16,0,30,14
1658037897004,MATH 10B,A01,083207,Lim; Seonhee,9,0,34,25
1658037897004,MATH 10B,A02,083208,Lim; Seonhee,10,0,35,25
1658037897004,MATH 10B,A03,093472,Lim; Seonhee,7,0,34,27
1658037897004,MATH 10B,B01,083739,Sinha; Shubham,14,0,30,16
1658037903041,MATH 18,A01,083743,Cinel; Cameron Alexander,9,0,30,21
1658037903041,MATH 18,A02,083744,Cinel; Cameron Alexander,18,0,30,12
1658037903041,MATH 18,A03,083745,Cinel; Cameron Alexander,10,0,30,20
1658037903041,MATH 18,B01,083748,Rideout; David Porter,5,0,37,32
1658037903041,MATH 18,B02,083749,Rideout; David Porter,5,0,36,31
1658037903041,MATH 18,B03,083750,Rideout; David Porter,3,0,37,34
1658037903041,MATH 18,B04,083751,Rideout; David Porter,7,0,36,29
1658037903041,MATH 18,B05,093473,Rideout; David Porter,7,0,36,29
1658037903041,MATH 18,B06,093474,Rideout; David Porter,6,0,36,30
1658037909071,MATH 20A,A01,083754,Zheng; Zequn,14,0,40,26
1658037915098,MATH 20B,A01,083756,Briones; Jor-el Thomas Caparas,4,0,36,32
1658037915098,MATH 20B,A02,083757,Briones; Jor-el Thomas Caparas,1,0,36,35
1658037915098,MATH 20B,A03,093475,Briones; Jor-el Thomas Caparas,3,0,36,33
1658037921121,MATH 20C,A01,083760,Briones; Jor-el Thomas Caparas,1,0,35,34
1658037921121,MATH 20C,A02,083761,Briones; Jor-el Thomas Caparas,8,0,35,27
1658037921121,MATH 20C,A03,093476,Briones; Jor-el Thomas Caparas,0,1,36,36
1658037921121,MATH 20C,B01,083762,Bach; Quang Tran,1,0,30,29
1658037927143,MATH 20D,A01,083765,Tran; Brian Kha,5,0,30,25
1658037927143,MATH 20D,A02,083766,Tran; Brian Kha,5,0,30,25
1658037927143,MATH 20D,A03,083767,Tran; Brian Kha,6,0,30,24
1658037933171,MATH 20E,A01,083771,Ganguly; Soumya,12,0,32,20
1658037933171,MATH 20E,A02,083772,Ganguly; Soumya,7,0,32,25
1658037933171,MATH 20E,B01,083773,Ciotti; Benjamin,20,0,35,15
1658037933171,MATH 20E,B02,083774,Ciotti; Benjamin,18,0,35,17
1658037939194,MATH 103A,A01,083777,Greenfeld; Be'Eri,6,0,36,30
1658037939194,MATH 103A,A02,083778,Greenfeld; Be'Eri,5,0,36,31
1658037939194,MATH 103A,A03,093561,Greenfeld; Be'Eri,7,0,36,29
1658037939194,MATH 103A,B01,083779,Greenfeld; Be'Eri,8,0,36,28
1658037939194,MATH 103A,B02,083780,Greenfeld; Be'Eri,4,0,36,32
1658037939194,MATH 103A,B03,093562,Greenfeld; Be'Eri,3,0,36,33
1658037945215,MATH 105,A01,085443,Carter; Anne Toulson,15,0,35,20
1658037945215,MATH 105,A02,093477,Carter; Anne Toulson,20,0,35,15
1658037951237,MATH 109,A01,083213,Ganzberger; Geoffrey Michael,3,0,34,31
1658037951237,MATH 109,A02,083214,Ganzberger; Geoffrey Michael,4,0,34,30
1658037951237,MATH 109,A03,093478,Ganzberger; Geoffrey Michael,2,0,34,32
1658037951237,MATH 109,B01,083215,Ganzberger; Geoffrey Michael,3,0,32,29
1658037951237,MATH 109,B02,083216,Ganzberger; Geoffrey Michael,3,0,32,29
1658037951237,MATH 109,B03,093479,Ganzberger; Geoffrey Michael,8,0,32,24
1658037957260,MATH 142A,A01,083219,Chow; Bennett,7,0,32,25
1658037957260,MATH 142A,A02,083220,Chow; Bennett,10,0,32,22
1658037957260,MATH 142A,A03,093480,Chow; Bennett,9,0,32,23
1658037957260,MATH 142A,B03,093481,Chow; Bennett,8,0,32,24
1658037957260,MATH 142A,B04,093558,Chow; Bennett,14,0,32,18
1658037957260,MATH 142A,B05,093559,Chow; Bennett,7,0,32,25
1658037963288,MATH 193A,A01,083224,Rotar; Vladimir,9,0,34,25
1658037963288,MATH 193A,A02,083225,Rotar; Vladimir,11,0,34,23
1658037963288,MATH 193A,A03,083781,Rotar; Vladimir,5,0,34,29
1658037963288,MATH 193A,A04,083782,Rotar; Vladimir,12,0,34,22
1658037963288,MATH 193A,A05,093482,Rotar; Vladimir,11,0,34,23
1658037969311,MATH 197,001,091859,McAuley; Julian John,9999,0,9999,0
1658037969311,MATH 197,002,095566,Kedlaya; Kiran S.,9997,0,9999,2
1658037969311,MATH 197,003,095567,Xiao; Ming,9999,0,9999,0
1658037969311,MATH 197,004,095571,Perols; Johan Lars,9998,0,9999,1
1658037976363,COGS 9,A01,083615,Shannon; Kyle Michael,11,0,75,64
1658037982388,COGS 11,A01,083617,Boyle; Mary E. T.,23,0,48,25
1658037988415,COGS 13,A01,083071,Bastos; Amalia Pinkusfeld,12,0,71,59
1658037994442,COGS 14A,A01,092681,Semenuks; Arturs,5,1,100,95
1658038000464,COGS 14B,A01,083073,Cheng; Tzu-Han,7,0,63,56
1658038006491,COGS 17,A01,092677,Semenuks; Arturs,7,0,81,74
1658038012518,COGS 100,A01,083619,Allen; Michael Gordon,17,0,70,53
1658038018545,COGS 101A,A01,083621,Davis; Joshua Daniel,9,0,68,59
1658038024570,COGS 101B,A01,091572,Allen; Michael Gordon,14,0,65,51
1658038030593,COGS 101C,A01,083625,Delgado; Tania,17,0,35,18
1658038036624,COGS 107A,A01,083627,Boyle; Mary E. T.,14,0,60,46
1658038042649,COGS 118A,A01,083075,Gupta; Anjum,21,0,76,55
1658038048681,CSE 3,A50,083646,Miranda; Gregory Joseph,24,0,50,26
1658038054704,CSE 8A,A50,083650,Miranda; Gregory Joseph,17,1,56,39
1658038060725,CSE 11,A01,083080,Cao; Yingjun,7,15,40,33
1658038066750,CSE 12,A01,083652,Krause-Levy; Sophia Louisa,30,1,120,90
1658038072776,CSE 15L,A01,083654,Morris; Justin Loren,9,0,50,41
1658038072776,CSE 15L,A02,083655,Morris; Justin Loren,11,0,50,39
1658038078797,CSE 20,A01,083657,Tran; Khoa Dang,39,0,80,41
1658038084820,CSE 21,A01,095574,Bach; Quang Tran,23,0,48,25
1658038090842,CSE 30,A01,083084,Eldon; John,8,0,80,72
1658038090842,CSE 30,B01,095061,Bhaskar; Nishant,9,0,50,41
1658038096863,CSE 100,A01,083659,Cao; Yingjun,5,4,70,65
1658038102887,CSE 134B,A01,083661,Powell; Thomas Allan,25,0,100,75
1658038108909,CSE 140,A01,083663,Gungor; Onat,17,0,85,68
1658038114934,CSE 140L,A01,083088,Eldon; John,23,0,100,77
1658038121032,CSE 175,A01,083665,Kumar; Rakesh,3,0,25,22
1658038127055,CSE 190,A00,092507,Dubnov; Shlomo,8,0,20,12
1658038133081,ECE 45,A01,083139,Congero; Spencer William,7,0,75,68
1658038139107,ECE 65,A50,083695,Saad; Andrew S,12,0,30,18
1658038139107,ECE 65,A51,095125,Saad; Andrew S,24,0,26,2
1658038145133,ECE 109,A01,091882,Touri; Behrouz,21,0,70,49
1658038151158,ECE 180,A00,083140,Abi Samra; Nicholas Camill,1,0,30,29
1658038151158,ECE 180,B00,083141,Abi Samra; Nicholas Camill,0,0,30,30
1658038157180,MATH 10A,A01,083735,Patchell; Gregory David,2,0,30,28
1658038157180,MATH 10A,A02,083736,Patchell; Gregory David,20,0,30,10
1658038157180,MATH 10A,A03,083737,Patchell; Gregory David,16,0,30,14
1658038163210,MATH 10B,A01,083207,Lim; Seonhee,9,0,34,25
1658038163210,MATH 10B,A02,083208,Lim; Seonhee,10,0,35,25
1658038163210,MATH 10B,A03,093472,Lim; Seonhee,7,0,34,27
1658038163210,MATH 10B,B01,083739,Sinha; Shubham,14,0,30,16
1658038169242,MATH 18,A01,083743,Cinel; Cameron Alexander,9,0,30,21
1658038169242,MATH 18,A02,083744,Cinel; Cameron Alexander,18,0,30,12
1658038169242,MATH 18,A03,083745,Cinel; Cameron Alexander,10,0,30,20
1658038169242,MATH 18,B01,083748,Rideout; David Porter,5,0,37,32
1658038169242,MATH 18,B02,083749,Rideout; David Porter,5,0,36,31
1658038169242,MATH 18,B03,083750,Rideout; David Porter,3,0,37,34
1658038169242,MATH 18,B04,083751,Rideout; David Porter,7,0,36,29
1658038169242,MATH 18,B05,093473,Rideout; David Porter,7,0,36,29
1658038169242,MATH 18,B06,093474,Rideout; David Porter,6,0,36,30
1658038175265,MATH 20A,A01,083754,Zheng; Zequn,14,0,40,26
1658038181292,MATH 20B,A01,083756,Briones; Jor-el Thomas Caparas,4,0,36,32
1658038181292,MATH 20B,A02,083757,Briones; Jor-el Thomas Caparas,1,0,36,35
1658038181292,MATH 20B,A03,093475,Briones; Jor-el Thomas Caparas,3,0,36,33
1658038187315,MATH 20C,A01,083760,Briones; Jor-el Thomas Caparas,1,0,35,34
1658038187315,MATH 20C,A02,083761,Briones; Jor-el Thomas Caparas,8,0,35,27
1658038187315,MATH 20C,A03,093476,Briones; Jor-el Thomas Caparas,0,1,36,36
1658038187315,MATH 20C,B01,083762,Bach; Quang Tran,1,0,30,29
1658038193343,MATH 20D,A01,083765,Tran; Brian Kha,5,0,30,25
1658038193343,MATH 20D,A02,083766,Tran; Brian Kha,5,0,30,25
1658038193343,MATH 20D,A03,083767,Tran; Brian Kha,6,0,30,24
1658038199367,MATH 20E,A01,083771,Ganguly; Soumya,12,0,32,20
1658038199367,MATH 20E,A02,083772,Ganguly; Soumya,7,0,32,25
1658038199367,MATH 20E,B01,083773,Ciotti; Benjamin,20,0,35,15
1658038199367,MATH 20E,B02,083774,Ciotti; Benjamin,18,0,35,17
1658038205396,MATH 103A,A01,083777,Greenfeld; Be'Eri,6,0,36,30
1658038205396,MATH 103A,A02,083778,Greenfeld; Be'Eri,5,0,36,31
1658038205396,MATH 103A,A03,093561,Greenfeld; Be'Eri,7,0,36,29
1658038205396,MATH 103A,B01,083779,Greenfeld; Be'Eri,8,0,36,28
1658038205396,MATH 103A,B02,083780,Greenfeld; Be'Eri,4,0,36,32
1658038205396,MATH 103A,B03,093562,Greenfeld; Be'Eri,3,0,36,33
1658038211422,MATH 105,A01,085443,Carter; Anne Toulson,15,0,35,20
1658038211422,MATH 105,A02,093477,Carter; Anne Toulson,20,0,35,15
1658038217451,MATH 109,A01,083213,Ganzberger; Geoffrey Michael,3,0,34,31
1658038217451,MATH 109,A02,083214,Ganzberger; Geoffrey Michael,4,0,34,30
1658038217451,MATH 109,A03,093478,Ganzberger; Geoffrey Michael,2,0,34,32
1658038217451,MATH 109,B01,083215,Ganzberger; Geoffrey Michael,3,0,32,29
1658038217451,MATH 109,B02,083216,Ganzberger; Geoffrey Michael,3,0,32,29
1658038217451,MATH 109,B03,093479,Ganzberger; Geoffrey Michael,8,0,32,24
1658038223478,MATH 142A,A01,083219,Chow; Bennett,7,0,32,25
1658038223478,MATH 142A,A02,083220,Chow; Bennett,10,0,32,22
1658038223478,MATH 142A,A03,093480,Chow; Bennett,9,0,32,23
1658038223478,MATH 142A,B03,093481,Chow; Bennett,8,0,32,24
1658038223478,MATH 142A,B04,093558,Chow; Bennett,14,0,32,18
1658038223478,MATH 142A,B05,093559,Chow; Bennett,7,0,32,25
1658038229507,MATH 193A,A01,083224,Rotar; Vladimir,9,0,34,25
1658038229507,MATH 193A,A02,083225,Rotar; Vladimir,11,0,34,23
1658038229507,MATH 193A,A03,083781,Rotar; Vladimir,5,0,34,29
1658038229507,MATH 193A,A04,083782,Rotar; Vladimir,12,0,34,22
1658038229507,MATH 193A,A05,093482,Rotar; Vladimir,11,0,34,23
1658038235532,MATH 197,001,091859,McAuley; Julian John,9999,0,9999,0
1658038235532,MATH 197,002,095566,Kedlaya; Kiran S.,9997,0,9999,2
1658038235532,MATH 197,003,095567,Xiao; Ming,9999,0,9999,0
1658038235532,MATH 197,004,095571,Perols; Johan Lars,9998,0,9999,1
1658038242595,COGS 9,A01,083615,Shannon; Kyle Michael,11,0,75,64
1658038248625,COGS 11,A01,083617,Boyle; Mary E. T.,23,0,48,25
1658038254649,COGS 13,A01,083071,Bastos; Amalia Pinkusfeld,12,0,71,59
1658038260676,COGS 14A,A01,092681,Semenuks; Arturs,5,1,100,95
1658038266702,COGS 14B,A01,083073,Cheng; Tzu-Han,7,0,63,56
1658038272725,COGS 17,A01,092677,Semenuks; Arturs,7,0,81,74
1658038278749,COGS 100,A01,083619,Allen; Michael Gordon,17,0,70,53
1658038284781,COGS 101A,A01,083621,Davis; Joshua Daniel,9,0,68,59
1658038290811,COGS 101B,A01,091572,Allen; Michael Gordon,14,0,65,51
1658038296838,COGS 101C,A01,083625,Delgado; Tania,17,0,35,18
1658038302865,COGS 107A,A01,083627,Boyle; Mary E. T.,14,0,60,46
1658038308886,COGS 118A,A01,083075,Gupta; Anjum,21,0,76,55
1658038314910,CSE 3,A50,083646,Miranda; Gregory Joseph,24,0,50,26
1658038320936,CSE 8A,A50,083650,Miranda; Gregory Joseph,17,1,56,39
1658038326965,CSE 11,A01,083080,Cao; Yingjun,7,15,40,33
1658038332987,CSE 12,A01,083652,Krause-Levy; Sophia Louisa,30,1,120,90
1658038339009,CSE 15L,A01,083654,Morris; Justin Loren,9,0,50,41
1658038339009,CSE 15L,A02,083655,Morris; Justin Loren,11,0,50,39
1658038345034,CSE 20,A01,083657,Tran; Khoa Dang,39,0,80,41
1658038351057,CSE 21,A01,095574,Bach; Quang Tran,23,0,48,25
1658038357086,CSE 30,A01,083084,Eldon; John,8,0,80,72
1658038357086,CSE 30,B01,095061,Bhaskar; Nishant,9,0,50,41
1658038363112,CSE 100,A01,083659,Cao; Yingjun,5,4,70,65
1658038369135,CSE 134B,A01,083661,Powell; Thomas Allan,25,0,100,75
1658038375162,CSE 140,A01,083663,Gungor; Onat,17,0,85,68
1658038381191,CSE 140L,A01,083088,Eldon; John,23,0,100,77
1658038387218,CSE 175,A01,083665,Kumar; Rakesh,3,0,25,22
1658038393244,CSE 190,A00,092507,Dubnov; Shlomo,8,0,20,12
1658038399267,ECE 45,A01,083139,Congero; Spencer William,7,0,75,68
1658038405295,ECE 65,A50,083695,Saad; Andrew S,12,0,30,18
1658038405295,ECE 65,A51,095125,Saad; Andrew S,24,0,26,2
1658038411319,ECE 109,A01,091882,Touri; Behrouz,21,0,70,49
1658038417343,ECE 180,A00,083140,Abi Samra; Nicholas Camill,1,0,30,29
1658038417343,ECE 180,B00,083141,Abi Samra; Nicholas Camill,0,0,30,30
1658038423372,MATH 10A,A01,083735,Patchell; Gregory David,2,0,30,28
1658038423372,MATH 10A,A02,083736,Patchell; Gregory David,20,0,30,10
1658038423372,MATH 10A,A03,083737,Patchell; Gregory David,16,0,30,14
1658038437402,MATH 10B,A01,083207,Lim; Seonhee,9,0,34,25
1658038437402,MATH 10B,A02,083208,Lim; Seonhee,10,0,35,25
1658038437402,MATH 10B,A03,093472,Lim; Seonhee,7,0,34,27
1658038437402,MATH 10B,B01,083739,Sinha; Shubham,14,0,30,16
1658038443432,MATH 18,A01,083743,Cinel; Cameron Alexander,9,0,30,21
1658038443432,MATH 18,A02,083744,Cinel; Cameron Alexander,18,0,30,12
1658038443432,MATH 18,A03,083745,Cinel; Cameron Alexander,10,0,30,20
1658038443432,MATH 18,B01,083748,Rideout; David Porter,5,0,37,32
1658038443432,MATH 18,B02,083749,Rideout; David Porter,5,0,36,31
1658038443432,MATH 18,B03,083750,Rideout; David Porter,3,0,37,34
1658038443432,MATH 18,B04,083751,Rideout; David Porter,7,0,36,29
1658038443432,MATH 18,B05,093473,Rideout; David Porter,7,0,36,29
1658038443432,MATH 18,B06,093474,Rideout; David Porter,6,0,36,30
1658038449456,MATH 20A,A01,083754,Zheng; Zequn,14,0,40,26
1658038455485,MATH 20B,A01,083756,Briones; Jor-el Thomas Caparas,4,0,36,32
1658038455485,MATH 20B,A02,083757,Briones; Jor-el Thomas Caparas,1,0,36,35
1658038455485,MATH 20B,A03,093475,Briones; Jor-el Thomas Caparas,3,0,36,33
1658038461514,MATH 20C,A01,083760,Briones; Jor-el Thomas Caparas,1,0,35,34
1658038461514,MATH 20C,A02,083761,Briones; Jor-el Thomas Caparas,8,0,35,27
1658038461514,MATH 20C,A03,093476,Briones; Jor-el Thomas Caparas,0,1,36,36
1658038461514,MATH 20C,B01,083762,Bach; Quang Tran,1,0,30,29
1658038467538,MATH 20D,A01,083765,Tran; Brian Kha,5,0,30,25
1658038467538,MATH 20D,A02,083766,Tran; Brian Kha,5,0,30,25
1658038467538,MATH 20D,A03,083767,Tran; Brian Kha,6,0,30,24
1658038473567,MATH 20E,A01,083771,Ganguly; Soumya,12,0,32,20
1658038473567,MATH 20E,A02,083772,Ganguly; Soumya,7,0,32,25
1658038473567,MATH 20E,B01,083773,Ciotti; Benjamin,20,0,35,15
1658038473567,MATH 20E,B02,083774,Ciotti; Benjamin,18,0,35,17
1658038479591,MATH 103A,A01,083777,Greenfeld; Be'Eri,6,0,36,30
1658038479591,MATH 103A,A02,083778,Greenfeld; Be'Eri,5,0,36,31
1658038479591,MATH 103A,A03,093561,Greenfeld; Be'Eri,7,0,36,29
1658038479591,MATH 103A,B01,083779,Greenfeld; Be'Eri,8,0,36,28
1658038479591,MATH 103A,B02,083780,Greenfeld; Be'Eri,4,0,36,32
1658038479591,MATH 103A,B03,093562,Greenfeld; Be'Eri,3,0,36,33
1658038485614,MATH 105,A01,085443,Carter; Anne Toulson,15,0,35,20
1658038485614,MATH 105,A02,093477,Carter; Anne Toulson,20,0,35,15
1658038491640,MATH 109,A01,083213,Ganzberger; Geoffrey Michael,3,0,34,31
1658038491640,MATH 109,A02,083214,Ganzberger; Geoffrey Michael,4,0,34,30
1658038491640,MATH 109,A03,093478,Ganzberger; Geoffrey Michael,2,0,34,32
1658038491640,MATH 109,B01,083215,Ganzberger; Geoffrey Michael,3,0,32,29
1658038491640,MATH 109,B02,083216,Ganzberger; Geoffrey Michael,3,0,32,29
1658038491640,MATH 109,B03,093479,Ganzberger; Geoffrey Michael,8,0,32,24
1658038497666,MATH 142A,A01,083219,Chow; Bennett,7,0,32,25
1658038497666,MATH 142A,A02,083220,Chow; Bennett,10,0,32,22
1658038497666,MATH 142A,A03,093480,Chow; Bennett,9,0,32,23
1658038497666,MATH 142A,B03,093481,Chow; Bennett,8,0,32,24
1658038497666,MATH 142A,B04,093558,Chow; Bennett,14,0,32,18
1658038497666,MATH 142A,B05,093559,Chow; Bennett,7,0,32,25
1658038503693,MATH 193A,A01,083224,Rotar; Vladimir,9,0,34,25
1658038503693,MATH 193A,A02,083225,Rotar; Vladimir,11,0,34,23
1658038503693,MATH 193A,A03,083781,Rotar; Vladimir,5,0,34,29
1658038503693,MATH 193A,A04,083782,Rotar; Vladimir,12,0,34,22
1658038503693,MATH 193A,A05,093482,Rotar; Vladimir,11,0,34,23
1658038509717,MATH 197,001,091859,McAuley; Julian John,9999,0,9999,0
1658038509717,MATH 197,002,095566,Kedlaya; Kiran S.,9997,0,9999,2
1658038509717,MATH 197,003,095567,Xiao; Ming,9999,0,9999,0
1658038509717,MATH 197,004,095571,Perols; Johan Lars,9998,0,9999,1
1658038516769,COGS 9,A01,083615,Shannon; Kyle Michael,11,0,75,64
1658038522792,COGS 11,A01,083617,Boyle; Mary E. T.,23,0,48,25
1658038528821,COGS 13,A01,083071,Bastos; Amalia Pinkusfeld,12,0,71,59
1658038534844,COGS 14A,A01,092681,Semenuks; Arturs,5,1,100,95
1658038540867,COGS 14B,A01,083073,Cheng; Tzu-Han,7,0,63,56
1658038546889,COGS 17,A01,092677,Semenuks; Arturs,7,0,81,74
1658038552915,COGS 100,A01,083619,Allen; Michael Gordon,17,0,70,53
1658038558937,COGS 101A,A01,083621,Davis; Joshua Daniel,9,0,68,59
1658038564963,COGS 101B,A01,091572,Allen; Michael Gordon,14,0,65,51
1658038570987,COGS 101C,A01,083625,Delgado; Tania,17,0,35,18
1658038577009,COGS 107A,A01,083627,Boyle; Mary E. T.,14,0,60,46
1658038583036,COGS 118A,A01,083075,Gupta; Anjum,21,0,76,55
1658038589064,CSE 3,A50,083646,Miranda; Gregory Joseph,24,0,50,26
1658038595088,CSE 8A,A50,083650,Miranda; Gregory Joseph,17,1,56,39
1658038601110,CSE 11,A01,083080,Cao; Yingjun,7,15,40,33
1658038607133,CSE 12,A01,083652,Krause-Levy; Sophia Louisa,30,1,120,90
1658038613162,CSE 15L,A01,083654,Morris; Justin Loren,9,0,50,41
1658038613162,CSE 15L,A02,083655,Morris; Justin Loren,11,0,50,39
1658038619186,CSE 20,A01,083657,Tran; Khoa Dang,39,0,80,41
1658038625213,CSE 21,A01,095574,Bach; Quang Tran,23,0,48,25
1658038631238,CSE 30,A01,083084,Eldon; John,8,0,80,72
1658038631238,CSE 30,B01,095061,Bhaskar; Nishant,9,0,50,41
1658038637261,CSE 100,A01,083659,Cao; Yingjun,5,4,70,65
1658038643283,CSE 134B,A01,083661,Powell; Thomas Allan,25,0,100,75
1658038649311,CSE 140,A01,083663,Gungor; Onat,17,0,85,68
1658038655339,CSE 140L,A01,083088,Eldon; John,23,0,100,77
1658038661363,CSE 175,A01,083665,Kumar; Rakesh,3,0,25,22
1658038667386,CSE 190,A00,092507,Dubnov; Shlomo,8,0,20,12
1658038673409,ECE 45,A01,083139,Congero; Spencer William,7,0,75,68
1658038679433,ECE 65,A50,083695,Saad; Andrew S,12,0,30,18
1658038679433,ECE 65,A51,095125,Saad; Andrew S,24,0,26,2
1658038685457,ECE 109,A01,091882,Touri; Behrouz,21,0,70,49
1658038691483,ECE 180,A00,083140,Abi Samra; Nicholas Camill,1,0,30,29
1658038691483,ECE 180,B00,083141,Abi Samra; Nicholas Camill,0,0,30,30
1658038697507,MATH 10A,A01,083735,Patchell; Gregory David,2,0,30,28
1658038697507,MATH 10A,A02,083736,Patchell; Gregory David,20,0,30,10
1658038697507,MATH 10A,A03,083737,Patchell; Gregory David,16,0,30,14
1658038703533,MATH 10B,A01,083207,Lim; Seonhee,9,0,34,25
1658038703533,MATH 10B,A02,083208,Lim; Seonhee,10,0,35,25
1658038703533,MATH 10B,A03,093472,Lim; Seonhee,7,0,34,27
1658038703533,MATH 10B,B01,083739,Sinha; Shubham,14,0,30,16
1658038709556,MATH 18,A01,083743,Cinel; Cameron Alexander,9,0,30,21
1658038709556,MATH 18,A02,083744,Cinel; Cameron Alexander,18,0,30,12
1658038709556,MATH 18,A03,083745,Cinel; Cameron Alexander,10,0,30,20
1658038709556,MATH 18,B01,083748,Rideout; David Porter,5,0,37,32
1658038709556,MATH 18,B02,083749,Rideout; David Porter,5,0,36,31
1658038709556,MATH 18,B03,083750,Rideout; David Porter,3,0,37,34
1658038709556,MATH 18,B04,083751,Rideout; David Porter,7,0,36,29
1658038709556,MATH 18,B05,093473,Rideout; David Porter,7,0,36,29
1658038709556,MATH 18,B06,093474,Rideout; David Porter,6,0,36,30
1658038715583,MATH 20A,A01,083754,Zheng; Zequn,14,0,40,26
1658038721613,MATH 20B,A01,083756,Briones; Jor-el Thomas Caparas,4,0,36,32
1658038721613,MATH 20B,A02,083757,Briones; Jor-el Thomas Caparas,1,0,36,35
1658038721613,MATH 20B,A03,093475,Briones; Jor-el Thomas Caparas,3,0,36,33
1658038727710,MATH 20C,A01,083760,Briones; Jor-el Thomas Caparas,1,0,35,34
1658038727710,MATH 20C,A02,083761,Briones; Jor-el Thomas Caparas,8,0,35,27
1658038727710,MATH 20C,A03,093476,Briones; Jor-el Thomas Caparas,0,1,36,36
1658038727710,MATH 20C,B01,083762,Bach; Quang Tran,1,0,30,29
1658038733734,MATH 20D,A01,083765,Tran; Brian Kha,5,0,30,25
1658038733734,MATH 20D,A02,083766,Tran; Brian Kha,5,0,30,25
1658038733734,MATH 20D,A03,083767,Tran; Brian Kha,6,0,30,24
1658038739760,MATH 20E,A01,083771,Ganguly; Soumya,12,0,32,20
1658038739760,MATH 20E,A02,083772,Ganguly; Soumya,7,0,32,25
1658038739760,MATH 20E,B01,083773,Ciotti; Benjamin,20,0,35,15
1658038739760,MATH 20E,B02,083774,Ciotti; Benjamin,18,0,35,17
1658038745795,MATH 103A,A01,083777,Greenfeld; Be'Eri,6,0,36,30
1658038745795,MATH 103A,A02,083778,Greenfeld; Be'Eri,5,0,36,31
1658038745795,MATH 103A,A03,093561,Greenfeld; Be'Eri,7,0,36,29
1658038745795,MATH 103A,B01,083779,Greenfeld; Be'Eri,8,0,36,28
1658038745795,MATH 103A,B02,083780,Greenfeld; Be'Eri,4,0,36,32
1658038745795,MATH 103A,B03,093562,Greenfeld; Be'Eri,3,0,36,33
1658038751824,MATH 105,A01,085443,Carter; Anne Toulson,15,0,35,20
1658038751824,MATH 105,A02,093477,Carter; Anne Toulson,20,0,35,15
1658038757857,MATH 109,A01,083213,Ganzberger; Geoffrey Michael,3,0,34,31
1658038757857,MATH 109,A02,083214,Ganzberger; Geoffrey Michael,4,0,34,30
1658038757857,MATH 109,A03,093478,Ganzberger; Geoffrey Michael,2,0,34,32
1658038757857,MATH 109,B01,083215,Ganzberger; Geoffrey Michael,3,0,32,29
1658038757857,MATH 109,B02,083216,Ganzberger; Geoffrey Michael,3,0,32,29
1658038757857,MATH 109,B03,093479,Ganzberger; Geoffrey Michael,8,0,32,24
1658038763882,MATH 142A,A01,083219,Chow; Bennett,7,0,32,25
1658038763882,MATH 142A,A02,083220,Chow; Bennett,10,0,32,22
1658038763882,MATH 142A,A03,093480,Chow; Bennett,9,0,32,23
1658038763882,MATH 142A,B03,093481,Chow; Bennett,8,0,32,24
1658038763882,MATH 142A,B04,093558,Chow; Bennett,14,0,32,18
1658038763882,MATH 142A,B05,093559,Chow; Bennett,7,0,32,25
1658038769912,MATH 193A,A01,083224,Rotar; Vladimir,9,0,34,25
1658038769912,MATH 193A,A02,083225,Rotar; Vladimir,11,0,34,23
1658038769912,MATH 193A,A03,083781,Rotar; Vladimir,5,0,34,29
1658038769912,MATH 193A,A04,083782,Rotar; Vladimir,12,0,34,22
1658038769912,MATH 193A,A05,093482,Rotar; Vladimir,11,0,34,23
1658038775936,MATH 197,001,091859,McAuley; Julian John,9999,0,9999,0
1658038775936,MATH 197,002,095566,Kedlaya; Kiran S.,9997,0,9999,2
1658038775936,MATH 197,003,095567,Xiao; Ming,9999,0,9999,0
1658038775936,MATH 197,004,095571,Perols; Johan Lars,9998,0,9999,1
1658038782985,COGS 9,A01,083615,Shannon; Kyle Michael,11,0,75,64
1658038789010,COGS 11,A01,083617,Boyle; Mary E. T.,23,0,48,25
1658038795036,COGS 13,A01,083071,Bastos; Amalia Pinkusfeld,12,0,71,59
1658038801058,COGS 14A,A01,092681,Semenuks; Arturs,5,1,100,95
1658038807083,COGS 14B,A01,083073,Cheng; Tzu-Han,7,0,63,56
1658038813107,COGS 17,A01,092677,Semenuks; Arturs,7,0,81,74
1658038819129,COGS 100,A01,083619,Allen; Michael Gordon,17,0,70,53
1658038825152,COGS 101A,A01,083621,Davis; Joshua Daniel,9,0,68,59
1658038831174,COGS 101B,A01,091572,Allen; Michael Gordon,14,0,65,51
1658038837201,COGS 101C,A01,083625,Delgado; Tania,17,0,35,18
1658038843230,COGS 107A,A01,083627,Boyle; Mary E. T.,14,0,60,46
1658038849253,COGS 118A,A01,083075,Gupta; Anjum,21,0,76,55
1658038855276,CSE 3,A50,083646,Miranda; Gregory Joseph,24,0,50,26
1658038861305,CSE 8A,A50,083650,Miranda; Gregory Joseph,17,1,56,39
1658038867330,CSE 11,A01,083080,Cao; Yingjun,7,15,40,33
1658038873351,CSE 12,A01,083652,Krause-Levy; Sophia Louisa,30,1,120,90
1658038879375,CSE 15L,A01,083654,Morris; Justin Loren,9,0,50,41
1658038879375,CSE 15L,A02,083655,Morris; Justin Loren,11,0,50,39
1658038885400,CSE 20,A01,083657,Tran; Khoa Dang,39,0,80,41
1658038891427,CSE 21,A01,095574,Bach; Quang Tran,23,0,48,25
1658038897450,CSE 30,A01,083084,Eldon; John,8,0,80,72
1658038897450,CSE 30,B01,095061,Bhaskar; Nishant,9,0,50,41
1658038903474,CSE 100,A01,083659,Cao; Yingjun,5,4,70,65
1658038909503,CSE 134B,A01,083661,Powell; Thomas Allan,25,0,100,75
1658038915527,CSE 140,A01,083663,Gungor; Onat,17,0,85,68
1658038921554,CSE 140L,A01,083088,Eldon; John,23,0,100,77
1658038927579,CSE 175,A01,083665,Kumar; Rakesh,3,0,25,22
1658038933601,CSE 190,A00,092507,Dubnov; Shlomo,8,0,20,12
1658038939628,ECE 45,A01,083139,Congero; Spencer William,7,0,75,68
1658038945652,ECE 65,A50,083695,Saad; Andrew S,12,0,30,18
1658038945652,ECE 65,A51,095125,Saad; Andrew S,24,0,26,2
1658038951676,ECE 109,A01,091882,Touri; Behrouz,21,0,70,49
1658038957700,ECE 180,A00,083140,Abi Samra; Nicholas Camill,1,0,30,29
1658038957700,ECE 180,B00,083141,Abi Samra; Nicholas Camill,0,0,30,30
1658038963723,MATH 10A,A01,083735,Patchell; Gregory David,2,0,30,28
1658038963723,MATH 10A,A02,083736,Patchell; Gregory David,20,0,30,10
1658038963723,MATH 10A,A03,083737,Patchell; Gregory David,16,0,30,14
1658038969744,MATH 10B,A01,083207,Lim; Seonhee,9,0,34,25
1658038969744,MATH 10B,A02,083208,Lim; Seonhee,10,0,35,25
1658038969744,MATH 10B,A03,093472,Lim; Seonhee,7,0,34,27
1658038969744,MATH 10B,B01,083739,Sinha; Shubham,14,0,30,16
1658038975776,MATH 18,A01,083743,Cinel; Cameron Alexander,9,0,30,21
1658038975776,MATH 18,A02,083744,Cinel; Cameron Alexander,18,0,30,12
1658038975776,MATH 18,A03,083745,Cinel; Cameron Alexander,10,0,30,20
1658038975776,MATH 18,B01,083748,Rideout; David Porter,5,0,37,32
1658038975776,MATH 18,B02,083749,Rideout; David Porter,5,0,36,31
1658038975776,MATH 18,B03,083750,Rideout; David Porter,3,0,37,34
1658038975776,MATH 18,B04,083751,Rideout; David Porter,7,0,36,29
1658038975776,MATH 18,B05,093473,Rideout; David Porter,7,0,36,29
1658038975776,MATH 18,B06,093474,Rideout; David Porter,6,0,36,30
1658038981799,MATH 20A,A01,083754,Zheng; Zequn,14,0,40,26
1658038987822,MATH 20B,A01,083756,Briones; Jor-el Thomas Caparas,4,0,36,32
1658038987822,MATH 20B,A02,083757,Briones; Jor-el Thomas Caparas,1,0,36,35
1658038987822,MATH 20B,A03,093475,Briones; Jor-el Thomas Caparas,3,0,36,33
1658038993850,MATH 20C,A01,083760,Briones; Jor-el Thomas Caparas,1,0,35,34
1658038993850,MATH 20C,A02,083761,Briones; Jor-el Thomas Caparas,8,0,35,27
1658038993850,MATH 20C,A03,093476,Briones; Jor-el Thomas Caparas,0,1,36,36
1658038993850,MATH 20C,B01,083762,Bach; Quang Tran,1,0,30,29
1658038999875,MATH 20D,A01,083765,Tran; Brian Kha,5,0,30,25
1658038999875,MATH 20D,A02,083766,Tran; Brian Kha,5,0,30,25
1658038999875,MATH 20D,A03,083767,Tran; Brian Kha,6,0,30,24
1658039005898,MATH 20E,A01,083771,Ganguly; Soumya,12,0,32,20
1658039005898,MATH 20E,A02,083772,Ganguly; Soumya,7,0,32,25
1658039005898,MATH 20E,B01,083773,Ciotti; Benjamin,20,0,35,15
1658039005898,MATH 20E,B02,083774,Ciotti; Benjamin,18,0,35,17
1658039011922,MATH 103A,A01,083777,Greenfeld; Be'Eri,6,0,36,30
1658039011922,MATH 103A,A02,083778,Greenfeld; Be'Eri,5,0,36,31
1658039011922,MATH 103A,A03,093561,Greenfeld; Be'Eri,7,0,36,29
1658039011922,MATH 103A,B01,083779,Greenfeld; Be'Eri,8,0,36,28
1658039011922,MATH 103A,B02,083780,Greenfeld; Be'Eri,4,0,36,32
1658039011922,MATH 103A,B03,093562,Greenfeld; Be'Eri,3,0,36,33
1658039017946,MATH 105,A01,085443,Carter; Anne Toulson,15,0,35,20
1658039017946,MATH 105,A02,093477,Carter; Anne Toulson,20,0,35,15
1658039023977,MATH 109,A01,083213,Ganzberger; Geoffrey Michael,3,0,34,31
1658039023977,MATH 109,A02,083214,Ganzberger; Geoffrey Michael,4,0,34,30
1658039023977,MATH 109,A03,093478,Ganzberger; Geoffrey Michael,2,0,34,32
1658039023977,MATH 109,B01,083215,Ganzberger; Geoffrey Michael,3,0,32,29
1658039023977,MATH 109,B02,083216,Ganzberger; Geoffrey Michael,3,0,32,29
1658039023977,MATH 109,B03,093479,Ganzberger; Geoffrey Michael,8,0,32,24
1658039030002,MATH 142A,A01,083219,Chow; Bennett,7,0,32,25
1658039030002,MATH 142A,A02,083220,Chow; Bennett,10,0,32,22
1658039030002,MATH 142A,A03,093480,Chow; Bennett,9,0,32,23
1658039030002,MATH 142A,B03,093481,Chow; Bennett,8,0,32,24
1658039030002,MATH 142A,B04,093558,Chow; Bennett,14,0,32,18
1658039030002,MATH 142A,B05,093559,Chow; Bennett,7,0,32,25
1658039036030,MATH 193A,A01,083224,Rotar; Vladimir,9,0,34,25
1658039036030,MATH 193A,A02,083225,Rotar; Vladimir,11,0,34,23
1658039036030,MATH 193A,A03,083781,Rotar; Vladimir,5,0,34,29
1658039036030,MATH 193A,A04,083782,Rotar; Vladimir,12,0,34,22
1658039036030,MATH 193A,A05,093482,Rotar; Vladimir,11,0,34,23
1658039042058,MATH 197,001,091859,McAuley; Julian John,9999,0,9999,0
1658039042058,MATH 197,002,095566,Kedlaya; Kiran S.,9997,0,9999,2
1658039042058,MATH 197,003,095567,Xiao; Ming,9999,0,9999,0
1658039042058,MATH 197,004,095571,Perols; Johan Lars,9998,0,9999,1
1658039049107,COGS 9,A01,083615,Shannon; Kyle Michael,11,0,75,64
1658039055129,COGS 11,A01,083617,Boyle; Mary E. T.,23,0,48,25
1658039061152,COGS 13,A01,083071,Bastos; Amalia Pinkusfeld,12,0,71,59
1658039067174,COGS 14A,A01,092681,Semenuks; Arturs,5,1,100,95
1658039073200,COGS 14B,A01,083073,Cheng; Tzu-Han,7,0,63,56
1658039079222,COGS 17,A01,092677,Semenuks; Arturs,7,0,81,74
1658039085248,COGS 100,A01,083619,Allen; Michael Gordon,17,0,70,53
1658039091273,COGS 101A,A01,083621,Davis; Joshua Daniel,9,0,68,59
1658039097304,COGS 101B,A01,091572,Allen; Michael Gordon,14,0,65,51
1658039103331,COGS 101C,A01,083625,Delgado; Tania,17,0,35,18
1658039109355,COGS 107A,A01,083627,Boyle; Mary E. T.,14,0,60,46
1658039115382,COGS 118A,A01,083075,Gupta; Anjum,21,0,76,55
1658039121404,CSE 3,A50,083646,Miranda; Gregory Joseph,24,0,50,26
1658039127428,CSE 8A,A50,083650,Miranda; Gregory Joseph,17,1,56,39
1658039133451,CSE 11,A01,083080,Cao; Yingjun,7,15,40,33
1658039139474,CSE 12,A01,083652,Krause-Levy; Sophia Louisa,30,1,120,90
1658039145498,CSE 15L,A01,083654,Morris; Justin Loren,9,0,50,41
1658039145498,CSE 15L,A02,083655,Morris; Justin Loren,11,0,50,39
1658039151521,CSE 20,A01,083657,Tran; Khoa Dang,39,0,80,41
1658039157546,CSE 21,A01,095574,Bach; Quang Tran,23,0,48,25
1658039163570,CSE 30,A01,083084,Eldon; John,8,0,80,72
1658039163570,CSE 30,B01,095061,Bhaskar; Nishant,9,0,50,41
1658039169595,CSE 100,A01,083659,Cao; Yingjun,5,4,70,65
1658039175616,CSE 134B,A01,083661,Powell; Thomas Allan,25,0,100,75
1658039181643,CSE 140,A01,083663,Gungor; Onat,17,0,85,68
1658039187666,CSE 140L,A01,083088,Eldon; John,23,0,100,77
1658039193689,CSE 175,A01,083665,Kumar; Rakesh,3,0,25,22
1658039199715,CSE 190,A00,092507,Dubnov; Shlomo,8,0,20,12
1658039205742,ECE 45,A01,083139,Congero; Spencer William,7,0,75,68
1658039211772,ECE 65,A50,083695,Saad; Andrew S,12,0,30,18
1658039211772,ECE 65,A51,095125,Saad; Andrew S,24,0,26,2
1658039217794,ECE 109,A01,091882,Touri; Behrouz,21,0,70,49
1658039223819,ECE 180,A00,083140,Abi Samra; Nicholas Camill,1,0,30,29
1658039223819,ECE 180,B00,083141,Abi Samra; Nicholas Camill,0,0,30,30
1658039229842,MATH 10A,A01,083735,Patchell; Gregory David,2,0,30,28
1658039229842,MATH 10A,A02,083736,Patchell; Gregory David,20,0,30,10
1658039229842,MATH 10A,A03,083737,Patchell; Gregory David,16,0,30,14
1658039235865,MATH 10B,A01,083207,Lim; Seonhee,9,0,34,25
1658039235865,MATH 10B,A02,083208,Lim; Seonhee,10,0,35,25
1658039235865,MATH 10B,A03,093472,Lim; Seonhee,7,0,34,27
1658039235865,MATH 10B,B01,083739,Sinha; Shubham,14,0,30,16
1658039241895,MATH 18,A01,083743,Cinel; Cameron Alexander,9,0,30,21
1658039241895,MATH 18,A02,083744,Cinel; Cameron Alexander,18,0,30,12
1658039241895,MATH 18,A03,083745,Cinel; Cameron Alexander,10,0,30,20
1658039241895,MATH 18,B01,083748,Rideout; David Porter,5,0,37,32
1658039241895,MATH 18,B02,083749,Rideout; David Porter,5,0,36,31
1658039241895,MATH 18,B03,083750,Rideout; David Porter,3,0,37,34
1658039241895,MATH 18,B04,083751,Rideout; David Porter,7,0,36,29
1658039241895,MATH 18,B05,093473,Rideout; David Porter,7,0,36,29
1658039241895,MATH 18,B06,093474,Rideout; David Porter,6,0,36,30
1658039247919,MATH 20A,A01,083754,Zheng; Zequn,14,0,40,26
1658039253943,MATH 20B,A01,083756,Briones; Jor-el Thomas Caparas,4,0,36,32
1658039253943,MATH 20B,A02,083757,Briones; Jor-el Thomas Caparas,1,0,36,35
1658039253943,MATH 20B,A03,093475,Briones; Jor-el Thomas Caparas,3,0,36,33
1658039259975,MATH 20C,A01,083760,Briones; Jor-el Thomas Caparas,1,0,35,34
1658039259975,MATH 20C,A02,083761,Briones; Jor-el Thomas Caparas,8,0,35,27
1658039259975,MATH 20C,A03,093476,Briones; Jor-el Thomas Caparas,0,1,36,36
1658039259975,MATH 20C,B01,083762,Bach; Quang Tran,1,0,30,29
1658039265998,MATH 20D,A01,083765,Tran; Brian Kha,5,0,30,25
1658039265998,MATH 20D,A02,083766,Tran; Brian Kha,5,0,30,25
1658039265998,MATH 20D,A03,083767,Tran; Brian Kha,6,0,30,24
1658039272022,MATH 20E,A01,083771,Ganguly; Soumya,12,0,32,20
1658039272022,MATH 20E,A02,083772,Ganguly; Soumya,7,0,32,25
1658039272022,MATH 20E,B01,083773,Ciotti; Benjamin,20,0,35,15
1658039272022,MATH 20E,B02,083774,Ciotti; Benjamin,18,0,35,17
1658039278046,MATH 103A,A01,083777,Greenfeld; Be'Eri,6,0,36,30
1658039278046,MATH 103A,A02,083778,Greenfeld; Be'Eri,5,0,36,31
1658039278046,MATH 103A,A03,093561,Greenfeld; Be'Eri,7,0,36,29
1658039278046,MATH 103A,B01,083779,Greenfeld; Be'Eri,8,0,36,28
1658039278046,MATH 103A,B02,083780,Greenfeld; Be'Eri,4,0,36,32
1658039278046,MATH 103A,B03,093562,Greenfeld; Be'Eri,3,0,36,33
1658039284078,MATH 105,A01,085443,Carter; Anne Toulson,15,0,35,20
1658039284078,MATH 105,A02,093477,Carter; Anne Toulson,20,0,35,15
1658039290106,MATH 109,A01,083213,Ganzberger; Geoffrey Michael,3,0,34,31
1658039290106,MATH 109,A02,083214,Ganzberger; Geoffrey Michael,4,0,34,30
1658039290106,MATH 109,A03,093478,Ganzberger; Geoffrey Michael,2,0,34,32
1658039290106,MATH 109,B01,083215,Ganzberger; Geoffrey Michael,3,0,32,29
1658039290106,MATH 109,B02,083216,Ganzberger; Geoffrey Michael,3,0,32,29
1658039290106,MATH 109,B03,093479,Ganzberger; Geoffrey Michael,8,0,32,24
1658039296135,MATH 142A,A01,083219,Chow; Bennett,7,0,32,25
1658039296135,MATH 142A,A02,083220,Chow; Bennett,10,0,32,22
1658039296135,MATH 142A,A03,093480,Chow; Bennett,9,0,32,23
1658039296135,MATH 142A,B03,093481,Chow; Bennett,8,0,32,24
1658039296135,MATH 142A,B04,093558,Chow; Bennett,14,0,32,18
1658039296135,MATH 142A,B05,093559,Chow; Bennett,7,0,32,25
1658039302161,MATH 193A,A01,083224,Rotar; Vladimir,9,0,34,25
1658039302161,MATH 193A,A02,083225,Rotar; Vladimir,11,0,34,23
1658039302161,MATH 193A,A03,083781,Rotar; Vladimir,5,0,34,29
1658039302161,MATH 193A,A04,083782,Rotar; Vladimir,12,0,34,22
1658039302161,MATH 193A,A05,093482,Rotar; Vladimir,11,0,34,23
1658039308184,MATH 197,001,091859,McAuley; Julian John,9999,0,9999,0
1658039308184,MATH 197,002,095566,Kedlaya; Kiran S.,9997,0,9999,2
1658039308184,MATH 197,003,095567,Xiao; Ming,9999,0,9999,0
1658039308184,MATH 197,004,095571,Perols; Johan Lars,9998,0,9999,1
1658039315246,COGS 9,A01,083615,Shannon; Kyle Michael,11,0,75,64
1658039321341,COGS 11,A01,083617,Boyle; Mary E. T.,23,0,48,25
1658039327363,COGS 13,A01,083071,Bastos; Amalia Pinkusfeld,12,0,71,59
1658039333391,COGS 14A,A01,092681,Semenuks; Arturs,5,1,100,95
1658039339414,COGS 14B,A01,083073,Cheng; Tzu-Han,7,0,63,56
1658039345441,COGS 17,A01,092677,Semenuks; Arturs,7,0,81,74
1658039351466,COGS 100,A01,083619,Allen; Michael Gordon,17,0,70,53
1658039357489,COGS 101A,A01,083621,Davis; Joshua Daniel,9,0,68,59
1658039363514,COGS 101B,A01,091572,Allen; Michael Gordon,14,0,65,51
1658039369541,COGS 101C,A01,083625,Delgado; Tania,17,0,35,18
1658039375562,COGS 107A,A01,083627,Boyle; Mary E. T.,14,0,60,46
1658039381588,COGS 118A,A01,083075,Gupta; Anjum,21,0,76,55
1658039387615,CSE 3,A50,083646,Miranda; Gregory Joseph,24,0,50,26
1658039393640,CSE 8A,A50,083650,Miranda; Gregory Joseph,17,1,56,39
1658039399665,CSE 11,A01,083080,Cao; Yingjun,7,15,40,33
1658039405691,CSE 12,A01,083652,Krause-Levy; Sophia Louisa,30,1,120,90
1658039411717,CSE 15L,A01,083654,Morris; Justin Loren,9,0,50,41
1658039411717,CSE 15L,A02,083655,Morris; Justin Loren,11,0,50,39
1658039417743,CSE 20,A01,083657,Tran; Khoa Dang,39,0,80,41
1658039423766,CSE 21,A01,095574,Bach; Quang Tran,23,0,48,25
1658039429792,CSE 30,A01,083084,Eldon; John,8,0,80,72
1658039429792,CSE 30,B01,095061,Bhaskar; Nishant,9,0,50,41
1658039435818,CSE 100,A01,083659,Cao; Yingjun,5,4,70,65
1658039441842,CSE 134B,A01,083661,Powell; Thomas Allan,25,0,100,75
1658039447864,CSE 140,A01,083663,Gungor; Onat,17,0,85,68
1658039453889,CSE 140L,A01,083088,Eldon; John,23,0,100,77
1658039459915,CSE 175,A01,083665,Kumar; Rakesh,3,0,25,22
1658039465937,CSE 190,A00,092507,Dubnov; Shlomo,8,0,20,12
1658039471960,ECE 45,A01,083139,Congero; Spencer William,7,0,75,68
1658039477985,ECE 65,A50,083695,Saad; Andrew S,12,0,30,18
1658039477985,ECE 65,A51,095125,Saad; Andrew S,24,0,26,2
1658039484013,ECE 109,A01,091882,Touri; Behrouz,21,0,70,49
1658039490038,ECE 180,A00,083140,Abi Samra; Nicholas Camill,1,0,30,29
1658039490038,ECE 180,B00,083141,Abi Samra; Nicholas Camill,0,0,30,30
1658039496068,MATH 10A,A01,083735,Patchell; Gregory David,2,0,30,28
1658039496068,MATH 10A,A02,083736,Patchell; Gregory David,20,0,30,10
1658039496068,MATH 10A,A03,083737,Patchell; Gregory David,16,0,30,14
1658039502106,MATH 10B,A01,083207,Lim; Seonhee,9,0,34,25
1658039502106,MATH 10B,A02,083208,Lim; Seonhee,10,0,35,25
1658039502106,MATH 10B,A03,093472,Lim; Seonhee,7,0,34,27
1658039502106,MATH 10B,B01,083739,Sinha; Shubham,14,0,30,16
1658039508133,MATH 18,A01,083743,Cinel; Cameron Alexander,9,0,30,21
1658039508133,MATH 18,A02,083744,Cinel; Cameron Alexander,18,0,30,12
1658039508133,MATH 18,A03,083745,Cinel; Cameron Alexander,10,0,30,20
1658039508133,MATH 18,B01,083748,Rideout; David Porter,5,0,37,32
1658039508133,MATH 18,B02,083749,Rideout; David Porter,5,0,36,31
1658039508133,MATH 18,B03,083750,Rideout; David Porter,3,0,37,34
1658039508133,MATH 18,B04,083751,Rideout; David Porter,7,0,36,29
1658039508133,MATH 18,B05,093473,Rideout; David Porter,7,0,36,29
1658039508133,MATH 18,B06,093474,Rideout; David Porter,6,0,36,30
1658039514154,MATH 20A,A01,083754,Zheng; Zequn,14,0,40,26
1658039520184,MATH 20B,A01,083756,Briones; Jor-el Thomas Caparas,4,0,36,32
1658039520184,MATH 20B,A02,083757,Briones; Jor-el Thomas Caparas,1,0,36,35
1658039520184,MATH 20B,A03,093475,Briones; Jor-el Thomas Caparas,3,0,36,33
1658039526210,MATH 20C,A01,083760,Briones; Jor-el Thomas Caparas,1,0,35,34
1658039526210,MATH 20C,A02,083761,Briones; Jor-el Thomas Caparas,8,0,35,27
1658039526210,MATH 20C,A03,093476,Briones; Jor-el Thomas Caparas,0,1,36,36
1658039526210,MATH 20C,B01,083762,Bach; Quang Tran,1,0,30,29
1658039532237,MATH 20D,A01,083765,Tran; Brian Kha,5,0,30,25
1658039532237,MATH 20D,A02,083766,Tran; Brian Kha,5,0,30,25
1658039532237,MATH 20D,A03,083767,Tran; Brian Kha,6,0,30,24
1658039538261,MATH 20E,A01,083771,Ganguly; Soumya,12,0,32,20
1658039538261,MATH 20E,A02,083772,Ganguly; Soumya,7,0,32,25
1658039538261,MATH 20E,B01,083773,Ciotti; Benjamin,20,0,35,15
1658039538261,MATH 20E,B02,083774,Ciotti; Benjamin,18,0,35,17
1658039544288,MATH 103A,A01,083777,Greenfeld; Be'Eri,6,0,36,30
1658039544288,MATH 103A,A02,083778,Greenfeld; Be'Eri,5,0,36,31
1658039544288,MATH 103A,A03,093561,Greenfeld; Be'Eri,7,0,36,29
1658039544288,MATH 103A,B01,083779,Greenfeld; Be'Eri,8,0,36,28
1658039544288,MATH 103A,B02,083780,Greenfeld; Be'Eri,4,0,36,32
1658039544288,MATH 103A,B03,093562,Greenfeld; Be'Eri,3,0,36,33
1658039550316,MATH 105,A01,085443,Carter; Anne Toulson,15,0,35,20
1658039550316,MATH 105,A02,093477,Carter; Anne Toulson,20,0,35,15
1658039556340,MATH 109,A01,083213,Ganzberger; Geoffrey Michael,3,0,34,31
1658039556340,MATH 109,A02,083214,Ganzberger; Geoffrey Michael,4,0,34,30
1658039556340,MATH 109,A03,093478,Ganzberger; Geoffrey Michael,2,0,34,32
1658039556340,MATH 109,B01,083215,Ganzberger; Geoffrey Michael,3,0,32,29
1658039556340,MATH 109,B02,083216,Ganzberger; Geoffrey Michael,3,0,32,29
1658039556340,MATH 109,B03,093479,Ganzberger; Geoffrey Michael,8,0,32,24
1658039562363,MATH 142A,A01,083219,Chow; Bennett,7,0,32,25
1658039562363,MATH 142A,A02,083220,Chow; Bennett,10,0,32,22
1658039562363,MATH 142A,A03,093480,Chow; Bennett,9,0,32,23
1658039562363,MATH 142A,B03,093481,Chow; Bennett,8,0,32,24
1658039562363,MATH 142A,B04,093558,Chow; Bennett,14,0,32,18
1658039562363,MATH 142A,B05,093559,Chow; Bennett,7,0,32,25
1658039568391,MATH 193A,A01,083224,Rotar; Vladimir,9,0,34,25
1658039568391,MATH 193A,A02,083225,Rotar; Vladimir,11,0,34,23
1658039568391,MATH 193A,A03,083781,Rotar; Vladimir,5,0,34,29
1658039568391,MATH 193A,A04,083782,Rotar; Vladimir,12,0,34,22
1658039568391,MATH 193A,A05,093482,Rotar; Vladimir,11,0,34,23
1658039574417,MATH 197,001,091859,McAuley; Julian John,9999,0,9999,0
1658039574417,MATH 197,002,095566,Kedlaya; Kiran S.,9997,0,9999,2
1658039574417,MATH 197,003,095567,Xiao; Ming,9999,0,9999,0
1658039574417,MATH 197,004,095571,Perols; Johan Lars,9998,0,9999,1
1658039581472,COGS 9,A01,083615,Shannon; Kyle Michael,11,0,75,64
1658039587502,COGS 11,A01,083617,Boyle; Mary E. T.,23,0,48,25
1658039593525,COGS 13,A01,083071,Bastos; Amalia Pinkusfeld,12,0,71,59
1658039599552,COGS 14A,A01,092681,Semenuks; Arturs,5,1,100,95
1658039605575,COGS 14B,A01,083073,Cheng; Tzu-Han,7,0,63,56
1658039611597,COGS 17,A01,092677,Semenuks; Arturs,7,0,81,74
1658039617620,COGS 100,A01,083619,Allen; Michael Gordon,17,0,70,53
1658039623641,COGS 101A,A01,083621,Davis; Joshua Daniel,9,0,68,59
1658039629668,COGS 101B,A01,091572,Allen; Michael Gordon,14,0,65,51
1658039635689,COGS 101C,A01,083625,Delgado; Tania,17,0,35,18
1658039641715,COGS 107A,A01,083627,Boyle; Mary E. T.,14,0,60,46
1658039647739,COGS 118A,A01,083075,Gupta; Anjum,21,0,76,55
1658039653762,CSE 3,A50,083646,Miranda; Gregory Joseph,24,0,50,26
1658039659789,CSE 8A,A50,083650,Miranda; Gregory Joseph,17,1,56,39
1658039665812,CSE 11,A01,083080,Cao; Yingjun,7,15,40,33
1658039671834,CSE 12,A01,083652,Krause-Levy; Sophia Louisa,30,1,120,90
1658039677858,CSE 15L,A01,083654,Morris; Justin Loren,9,0,50,41
1658039677858,CSE 15L,A02,083655,Morris; Justin Loren,11,0,50,39
1658039683885,CSE 20,A01,083657,Tran; Khoa Dang,39,0,80,41
1658039689907,CSE 21,A01,095574,Bach; Quang Tran,23,0,48,25
1658039695933,CSE 30,A01,083084,Eldon; John,8,0,80,72
1658039695933,CSE 30,B01,095061,Bhaskar; Nishant,9,0,50,41
1658039701958,CSE 100,A01,083659,Cao; Yingjun,5,4,70,65
1658039707983,CSE 134B,A01,083661,Powell; Thomas Allan,25,0,100,75
1658039714004,CSE 140,A01,083663,Gungor; Onat,17,0,85,68
1658039720031,CSE 140L,A01,083088,Eldon; John,23,0,100,77
1658039726055,CSE 175,A01,083665,Kumar; Rakesh,3,0,25,22
1658039732077,CSE 190,A00,092507,Dubnov; Shlomo,8,0,20,12
1658039738104,ECE 45,A01,083139,Congero; Spencer William,7,0,75,68
1658039744131,ECE 65,A50,083695,Saad; Andrew S,12,0,30,18
1658039744131,ECE 65,A51,095125,Saad; Andrew S,24,0,26,2
1658039750154,ECE 109,A01,091882,Touri; Behrouz,21,0,70,49
1658039756176,ECE 180,A00,083140,Abi Samra; Nicholas Camill,1,0,30,29
1658039756176,ECE 180,B00,083141,Abi Samra; Nicholas Camill,0,0,30,30
1658039762200,MATH 10A,A01,083735,Patchell; Gregory David,2,0,30,28
1658039762200,MATH 10A,A02,083736,Patchell; Gregory David,20,0,30,10
1658039762200,MATH 10A,A03,083737,Patchell; Gregory David,16,0,30,14
1658039768224,MATH 10B,A01,083207,Lim; Seonhee,9,0,34,25
1658039768224,MATH 10B,A02,083208,Lim; Seonhee,10,0,35,25
1658039768224,MATH 10B,A03,093472,Lim; Seonhee,7,0,34,27
1658039768224,MATH 10B,B01,083739,Sinha; Shubham,14,0,30,16
1658039774250,MATH 18,A01,083743,Cinel; Cameron Alexander,9,0,30,21
1658039774250,MATH 18,A02,083744,Cinel; Cameron Alexander,18,0,30,12
1658039774250,MATH 18,A03,083745,Cinel; Cameron Alexander,10,0,30,20
1658039774250,MATH 18,B01,083748,Rideout; David Porter,5,0,37,32
1658039774250,MATH 18,B02,083749,Rideout; David Porter,5,0,36,31
1658039774250,MATH 18,B03,083750,Rideout; David Porter,3,0,37,34
1658039774250,MATH 18,B04,083751,Rideout; David Porter,7,0,36,29
1658039774250,MATH 18,B05,093473,Rideout; David Porter,7,0,36,29
1658039774250,MATH 18,B06,093474,Rideout; David Porter,6,0,36,30
1658039780274,MATH 20A,A01,083754,Zheng; Zequn,14,0,40,26
1658039786297,MATH 20B,A01,083756,Briones; Jor-el Thomas Caparas,4,0,36,32
1658039786297,MATH 20B,A02,083757,Briones; Jor-el Thomas Caparas,1,0,36,35
1658039786297,MATH 20B,A03,093475,Briones; Jor-el Thomas Caparas,3,0,36,33
1658039792324,MATH 20C,A01,083760,Briones; Jor-el Thomas Caparas,1,0,35,34
1658039792324,MATH 20C,A02,083761,Briones; Jor-el Thomas Caparas,8,0,35,27
1658039792324,MATH 20C,A03,093476,Briones; Jor-el Thomas Caparas,0,1,36,36
1658039792324,MATH 20C,B01,083762,Bach; Quang Tran,1,0,30,29
1658039798350,MATH 20D,A01,083765,Tran; Brian Kha,5,0,30,25
1658039798350,MATH 20D,A02,083766,Tran; Brian Kha,5,0,30,25
1658039798350,MATH 20D,A03,083767,Tran; Brian Kha,6,0,30,24
1658039804374,MATH 20E,A01,083771,Ganguly; Soumya,12,0,32,20
1658039804374,MATH 20E,A02,083772,Ganguly; Soumya,7,0,32,25
1658039804374,MATH 20E,B01,083773,Ciotti; Benjamin,20,0,35,15
1658039804374,MATH 20E,B02,083774,Ciotti; Benjamin,18,0,35,17
1658039810397,MATH 103A,A01,083777,Greenfeld; Be'Eri,6,0,36,30
1658039810397,MATH 103A,A02,083778,Greenfeld; Be'Eri,5,0,36,31
1658039810397,MATH 103A,A03,093561,Greenfeld; Be'Eri,7,0,36,29
1658039810397,MATH 103A,B01,083779,Greenfeld; Be'Eri,8,0,36,28
1658039810397,MATH 103A,B02,083780,Greenfeld; Be'Eri,4,0,36,32
1658039810397,MATH 103A,B03,093562,Greenfeld; Be'Eri,3,0,36,33
1658039816420,MATH 105,A01,085443,Carter; Anne Toulson,15,0,35,20
1658039816420,MATH 105,A02,093477,Carter; Anne Toulson,20,0,35,15
1658039822442,MATH 109,A01,083213,Ganzberger; Geoffrey Michael,3,0,34,31
1658039822442,MATH 109,A02,083214,Ganzberger; Geoffrey Michael,4,0,34,30
1658039822442,MATH 109,A03,093478,Ganzberger; Geoffrey Michael,2,0,34,32
1658039822442,MATH 109,B01,083215,Ganzberger; Geoffrey Michael,3,0,32,29
1658039822442,MATH 109,B02,083216,Ganzberger; Geoffrey Michael,3,0,32,29
1658039822442,MATH 109,B03,093479,Ganzberger; Geoffrey Michael,8,0,32,24
1658039828473,MATH 142A,A01,083219,Chow; Bennett,7,0,32,25
1658039828473,MATH 142A,A02,083220,Chow; Bennett,10,0,32,22
1658039828473,MATH 142A,A03,093480,Chow; Bennett,9,0,32,23
1658039828473,MATH 142A,B03,093481,Chow; Bennett,8,0,32,24
1658039828473,MATH 142A,B04,093558,Chow; Bennett,14,0,32,18
1658039828473,MATH 142A,B05,093559,Chow; Bennett,7,0,32,25
1658039834498,MATH 193A,A01,083224,Rotar; Vladimir,9,0,34,25
1658039834498,MATH 193A,A02,083225,Rotar; Vladimir,11,0,34,23
1658039834498,MATH 193A,A03,083781,Rotar; Vladimir,5,0,34,29
1658039834498,MATH 193A,A04,083782,Rotar; Vladimir,12,0,34,22
1658039834498,MATH 193A,A05,093482,Rotar; Vladimir,11,0,34,23
1658039840521,MATH 197,001,091859,McAuley; Julian John,9999,0,9999,0
1658039840521,MATH 197,002,095566,Kedlaya; Kiran S.,9997,0,9999,2
1658039840521,MATH 197,003,095567,Xiao; Ming,9999,0,9999,0
1658039840521,MATH 197,004,095571,Perols; Johan Lars,9998,0,9999,1
1658039847580,COGS 9,A01,083615,Shannon; Kyle Michael,11,0,75,64
1658039853602,COGS 11,A01,083617,Boyle; Mary E. T.,23,0,48,25
1658039859626,COGS 13,A01,083071,Bastos; Amalia Pinkusfeld,12,0,71,59
1658039865649,COGS 14A,A01,092681,Semenuks; Arturs,5,1,100,95
1658039871675,COGS 14B,A01,083073,Cheng; Tzu-Han,7,0,63,56
1658039877701,COGS 17,A01,092677,Semenuks; Arturs,7,0,81,74
1658039883724,COGS 100,A01,083619,Allen; Michael Gordon,17,0,70,53
1658039889749,COGS 101A,A01,083621,Davis; Joshua Daniel,9,0,68,59
1658039895774,COGS 101B,A01,091572,Allen; Michael Gordon,14,0,65,51
1658039901797,COGS 101C,A01,083625,Delgado; Tania,17,0,35,18
1658039907823,COGS 107A,A01,083627,Boyle; Mary E. T.,14,0,60,46
1658039913845,COGS 118A,A01,083075,Gupta; Anjum,21,0,76,55
1658039919971,CSE 3,A50,083646,Miranda; Gregory Joseph,24,0,50,26
1658039925999,CSE 8A,A50,083650,Miranda; Gregory Joseph,17,1,56,39
1658039932021,CSE 11,A01,083080,Cao; Yingjun,7,15,40,33
1658039938049,CSE 12,A01,083652,Krause-Levy; Sophia Louisa,30,1,120,90
1658039944073,CSE 15L,A01,083654,Morris; Justin Loren,9,0,50,41
1658039944073,CSE 15L,A02,083655,Morris; Justin Loren,11,0,50,39
1658039950095,CSE 20,A01,083657,Tran; Khoa Dang,39,0,80,41
1658039956117,CSE 21,A01,095574,Bach; Quang Tran,23,0,48,25
1658039962144,CSE 30,A01,083084,Eldon; John,8,0,80,72
1658039962144,CSE 30,B01,095061,Bhaskar; Nishant,9,0,50,41
1658039968174,CSE 100,A01,083659,Cao; Yingjun,5,4,70,65
1658039974198,CSE 134B,A01,083661,Powell; Thomas Allan,25,0,100,75
1658039980224,CSE 140,A01,083663,Gungor; Onat,17,0,85,68
1658039986250,CSE 140L,A01,083088,Eldon; John,23,0,100,77
1658039992274,CSE 175,A01,083665,Kumar; Rakesh,3,0,25,22
1658039998299,CSE 190,A00,092507,Dubnov; Shlomo,8,0,20,12
1658040004324,ECE 45,A01,083139,Congero; Spencer William,7,0,75,68
1658040010346,ECE 65,A50,083695,Saad; Andrew S,12,0,30,18
1658040010346,ECE 65,A51,095125,Saad; Andrew S,24,0,26,2
1658040016368,ECE 109,A01,091882,Touri; Behrouz,21,0,70,49
1658040022391,ECE 180,A00,083140,Abi Samra; Nicholas Camill,1,0,30,29
1658040022391,ECE 180,B00,083141,Abi Samra; Nicholas Camill,0,0,30,30
1658040028418,MATH 10A,A01,083735,Patchell; Gregory David,2,0,30,28
1658040028418,MATH 10A,A02,083736,Patchell; Gregory David,20,0,30,10
1658040028418,MATH 10A,A03,083737,Patchell; Gregory David,16,0,30,14
1658040034441,MATH 10B,A01,083207,Lim; Seonhee,9,0,34,25
1658040034441,MATH 10B,A02,083208,Lim; Seonhee,10,0,35,25
1658040034441,MATH 10B,A03,093472,Lim; Seonhee,7,0,34,27
1658040034441,MATH 10B,B01,083739,Sinha; Shubham,14,0,30,16
1658040040465,MATH 18,A01,083743,Cinel; Cameron Alexander,9,0,30,21
1658040040465,MATH 18,A02,083744,Cinel; Cameron Alexander,18,0,30,12
1658040040465,MATH 18,A03,083745,Cinel; Cameron Alexander,10,0,30,20
1658040040465,MATH 18,B01,083748,Rideout; David Porter,5,0,37,32
1658040040465,MATH 18,B02,083749,Rideout; David Porter,5,0,36,31
1658040040465,MATH 18,B03,083750,Rideout; David Porter,3,0,37,34
1658040040465,MATH 18,B04,083751,Rideout; David Porter,7,0,36,29
1658040040465,MATH 18,B05,093473,Rideout; David Porter,7,0,36,29
1658040040465,MATH 18,B06,093474,Rideout; David Porter,6,0,36,30
1658040046488,MATH 20A,A01,083754,Zheng; Zequn,14,0,40,26
1658040052513,MATH 20B,A01,083756,Briones; Jor-el Thomas Caparas,4,0,36,32
1658040052513,MATH 20B,A02,083757,Briones; Jor-el Thomas Caparas,1,0,36,35
1658040052513,MATH 20B,A03,093475,Briones; Jor-el Thomas Caparas,3,0,36,33
1658040058540,MATH 20C,A01,083760,Briones; Jor-el Thomas Caparas,1,0,35,34
1658040058540,MATH 20C,A02,083761,Briones; Jor-el Thomas Caparas,8,0,35,27
1658040058540,MATH 20C,A03,093476,Briones; Jor-el Thomas Caparas,0,1,36,36
1658040058540,MATH 20C,B01,083762,Bach; Quang Tran,1,0,30,29
1658040064568,MATH 20D,A01,083765,Tran; Brian Kha,5,0,30,25
1658040064568,MATH 20D,A02,083766,Tran; Brian Kha,5,0,30,25
1658040064568,MATH 20D,A03,083767,Tran; Brian Kha,6,0,30,24
1658040070593,MATH 20E,A01,083771,Ganguly; Soumya,12,0,32,20
1658040070593,MATH 20E,A02,083772,Ganguly; Soumya,7,0,32,25
1658040070593,MATH 20E,B01,083773,Ciotti; Benjamin,20,0,35,15
1658040070593,MATH 20E,B02,083774,Ciotti; Benjamin,18,0,35,17
1658040076616,MATH 103A,A01,083777,Greenfeld; Be'Eri,6,0,36,30
1658040076616,MATH 103A,A02,083778,Greenfeld; Be'Eri,5,0,36,31
1658040076616,MATH 103A,A03,093561,Greenfeld; Be'Eri,7,0,36,29
1658040076616,MATH 103A,B01,083779,Greenfeld; Be'Eri,8,0,36,28
1658040076616,MATH 103A,B02,083780,Greenfeld; Be'Eri,4,0,36,32
1658040076616,MATH 103A,B03,093562,Greenfeld; Be'Eri,3,0,36,33
1658040082639,MATH 105,A01,085443,Carter; Anne Toulson,15,0,35,20
1658040082639,MATH 105,A02,093477,Carter; Anne Toulson,20,0,35,15
1658040088660,MATH 109,A01,083213,Ganzberger; Geoffrey Michael,3,0,34,31
1658040088660,MATH 109,A02,083214,Ganzberger; Geoffrey Michael,4,0,34,30
1658040088660,MATH 109,A03,093478,Ganzberger; Geoffrey Michael,2,0,34,32
1658040088660,MATH 109,B01,083215,Ganzberger; Geoffrey Michael,3,0,32,29
1658040088660,MATH 109,B02,083216,Ganzberger; Geoffrey Michael,3,0,32,29
1658040088660,MATH 109,B03,093479,Ganzberger; Geoffrey Michael,8,0,32,24
1658040094687,MATH 142A,A01,083219,Chow; Bennett,7,0,32,25
1658040094687,MATH 142A,A02,083220,Chow; Bennett,10,0,32,22
1658040094687,MATH 142A,A03,093480,Chow; Bennett,9,0,32,23
1658040094687,MATH 142A,B03,093481,Chow; Bennett,8,0,32,24
1658040094687,MATH 142A,B04,093558,Chow; Bennett,14,0,32,18
1658040094687,MATH 142A,B05,093559,Chow; Bennett,7,0,32,25
1658040100711,MATH 193A,A01,083224,Rotar; Vladimir,9,0,34,25
1658040100711,MATH 193A,A02,083225,Rotar; Vladimir,11,0,34,23
1658040100711,MATH 193A,A03,083781,Rotar; Vladimir,5,0,34,29
1658040100711,MATH 193A,A04,083782,Rotar; Vladimir,12,0,34,22
1658040100711,MATH 193A,A05,093482,Rotar; Vladimir,11,0,34,23
1658040106734,MATH 197,001,091859,McAuley; Julian John,9999,0,9999,0
1658040106734,MATH 197,002,095566,Kedlaya; Kiran S.,9997,0,9999,2
1658040106734,MATH 197,003,095567,Xiao; Ming,9999,0,9999,0
1658040106734,MATH 197,004,095571,Perols; Johan Lars,9998,0,9999,1
1658040113799,COGS 9,A01,083615,Shannon; Kyle Michael,11,0,75,64
1658040119822,COGS 11,A01,083617,Boyle; Mary E. T.,23,0,48,25
1658040125845,COGS 13,A01,083071,Bastos; Amalia Pinkusfeld,12,0,71,59
1658040131873,COGS 14A,A01,092681,Semenuks; Arturs,5,1,100,95
1658040137898,COGS 14B,A01,083073,Cheng; Tzu-Han,7,0,63,56
1658040143922,COGS 17,A01,092677,Semenuks; Arturs,7,0,81,74
1658040149950,COGS 100,A01,083619,Allen; Michael Gordon,17,0,70,53
1658040155976,COGS 101A,A01,083621,Davis; Joshua Daniel,9,0,68,59
1658040162000,COGS 101B,A01,091572,Allen; Michael Gordon,14,0,65,51
1658040168023,COGS 101C,A01,083625,Delgado; Tania,17,0,35,18
1658040174045,COGS 107A,A01,083627,Boyle; Mary E. T.,14,0,60,46
1658040180067,COGS 118A,A01,083075,Gupta; Anjum,21,0,76,55
1658040186091,CSE 3,A50,083646,Miranda; Gregory Joseph,24,0,50,26
1658040192116,CSE 8A,A50,083650,Miranda; Gregory Joseph,17,1,56,39
1658040198140,CSE 11,A01,083080,Cao; Yingjun,7,15,40,33
1658040204167,CSE 12,A01,083652,Krause-Levy; Sophia Louisa,30,1,120,90
1658040210194,CSE 15L,A01,083654,Morris; Justin Loren,9,0,50,41
1658040210194,CSE 15L,A02,083655,Morris; Justin Loren,11,0,50,39
1658040216220,CSE 20,A01,083657,Tran; Khoa Dang,39,0,80,41
1658040222247,CSE 21,A01,095574,Bach; Quang Tran,23,0,48,25
1658040228271,CSE 30,A01,083084,Eldon; John,8,0,80,72
1658040228271,CSE 30,B01,095061,Bhaskar; Nishant,9,0,50,41
1658040234298,CSE 100,A01,083659,Cao; Yingjun,5,4,70,65
1658040240330,CSE 134B,A01,083661,Powell; Thomas Allan,25,0,100,75
1658040246356,CSE 140,A01,083663,Gungor; Onat,17,0,85,68
1658040252382,CSE 140L,A01,083088,Eldon; John,23,0,100,77
1658040258407,CSE 175,A01,083665,Kumar; Rakesh,3,0,25,22
1658040264432,CSE 190,A00,092507,Dubnov; Shlomo,8,0,20,12
1658040270456,ECE 45,A01,083139,Congero; Spencer William,7,0,75,68
1658040276479,ECE 65,A50,083695,Saad; Andrew S,12,0,30,18
1658040276479,ECE 65,A51,095125,Saad; Andrew S,24,0,26,2
1658040282502,ECE 109,A01,091882,Touri; Behrouz,21,0,70,49
1658040288523,ECE 180,A00,083140,Abi Samra; Nicholas Camill,1,0,30,29
1658040288523,ECE 180,B00,083141,Abi Samra; Nicholas Camill,0,0,30,30
1658040294546,MATH 10A,A01,083735,Patchell; Gregory David,2,0,30,28
1658040294546,MATH 10A,A02,083736,Patchell; Gregory David,20,0,30,10
1658040294546,MATH 10A,A03,083737,Patchell; Gregory David,16,0,30,14
1658040300577,MATH 10B,A01,083207,Lim; Seonhee,9,0,34,25
1658040300577,MATH 10B,A02,083208,Lim; Seonhee,10,0,35,25
1658040300577,MATH 10B,A03,093472,Lim; Seonhee,7,0,34,27
1658040300577,MATH 10B,B01,083739,Sinha; Shubham,14,0,30,16
1658040306601,MATH 18,A01,083743,Cinel; Cameron Alexander,9,0,30,21
1658040306601,MATH 18,A02,083744,Cinel; Cameron Alexander,18,0,30,12
1658040306601,MATH 18,A03,083745,Cinel; Cameron Alexander,10,0,30,20
1658040306601,MATH 18,B01,083748,Rideout; David Porter,5,0,37,32
1658040306601,MATH 18,B02,083749,Rideout; David Porter,5,0,36,31
1658040306601,MATH 18,B03,083750,Rideout; David Porter,3,0,37,34
1658040306601,MATH 18,B04,083751,Rideout; David Porter,7,0,36,29
1658040306601,MATH 18,B05,093473,Rideout; David Porter,7,0,36,29
1658040306601,MATH 18,B06,093474,Rideout; David Porter,6,0,36,30
1658040312631,MATH 20A,A01,083754,Zheng; Zequn,14,0,40,26
1658040318654,MATH 20B,A01,083756,Briones; Jor-el Thomas Caparas,4,0,36,32
1658040318654,MATH 20B,A02,083757,Briones; Jor-el Thomas Caparas,1,0,36,35
1658040318654,MATH 20B,A03,093475,Briones; Jor-el Thomas Caparas,3,0,36,33
1658040324677,MATH 20C,A01,083760,Briones; Jor-el Thomas Caparas,1,0,35,34
1658040324677,MATH 20C,A02,083761,Briones; Jor-el Thomas Caparas,8,0,35,27
1658040324677,MATH 20C,A03,093476,Briones; Jor-el Thomas Caparas,0,1,36,36
1658040324677,MATH 20C,B01,083762,Bach; Quang Tran,1,0,30,29
1658040330708,MATH 20D,A01,083765,Tran; Brian Kha,5,0,30,25
1658040330708,MATH 20D,A02,083766,Tran; Brian Kha,5,0,30,25
1658040330708,MATH 20D,A03,083767,Tran; Brian Kha,6,0,30,24
1658040336735,MATH 20E,A01,083771,Ganguly; Soumya,12,0,32,20
1658040336735,MATH 20E,A02,083772,Ganguly; Soumya,7,0,32,25
1658040336735,MATH 20E,B01,083773,Ciotti; Benjamin,20,0,35,15
1658040336735,MATH 20E,B02,083774,Ciotti; Benjamin,18,0,35,17
1658040342758,MATH 103A,A01,083777,Greenfeld; Be'Eri,6,0,36,30
1658040342758,MATH 103A,A02,083778,Greenfeld; Be'Eri,5,0,36,31
1658040342758,MATH 103A,A03,093561,Greenfeld; Be'Eri,7,0,36,29
1658040342758,MATH 103A,B01,083779,Greenfeld; Be'Eri,8,0,36,28
1658040342758,MATH 103A,B02,083780,Greenfeld; Be'Eri,4,0,36,32
1658040342758,MATH 103A,B03,093562,Greenfeld; Be'Eri,3,0,36,33
1658040348784,MATH 105,A01,085443,Carter; Anne Toulson,15,0,35,20
1658040348784,MATH 105,A02,093477,Carter; Anne Toulson,20,0,35,15
1658040354813,MATH 109,A01,083213,Ganzberger; Geoffrey Michael,3,0,34,31
1658040354813,MATH 109,A02,083214,Ganzberger; Geoffrey Michael,4,0,34,30
1658040354813,MATH 109,A03,093478,Ganzberger; Geoffrey Michael,2,0,34,32
1658040354813,MATH 109,B01,083215,Ganzberger; Geoffrey Michael,3,0,32,29
1658040354813,MATH 109,B02,083216,Ganzberger; Geoffrey Michael,3,0,32,29
1658040354813,MATH 109,B03,093479,Ganzberger; Geoffrey Michael,8,0,32,24
1658040360836,MATH 142A,A01,083219,Chow; Bennett,7,0,32,25
1658040360836,MATH 142A,A02,083220,Chow; Bennett,10,0,32,22
1658040360836,MATH 142A,A03,093480,Chow; Bennett,9,0,32,23
1658040360836,MATH 142A,B03,093481,Chow; Bennett,8,0,32,24
1658040360836,MATH 142A,B04,093558,Chow; Bennett,14,0,32,18
1658040360836,MATH 142A,B05,093559,Chow; Bennett,7,0,32,25
1658040366858,MATH 193A,A01,083224,Rotar; Vladimir,9,0,34,25
1658040366858,MATH 193A,A02,083225,Rotar; Vladimir,11,0,34,23
1658040366858,MATH 193A,A03,083781,Rotar; Vladimir,5,0,34,29
1658040366858,MATH 193A,A04,083782,Rotar; Vladimir,12,0,34,22
1658040366858,MATH 193A,A05,093482,Rotar; Vladimir,11,0,34,23
1658040372881,MATH 197,001,091859,McAuley; Julian John,9999,0,9999,0
1658040372881,MATH 197,002,095566,Kedlaya; Kiran S.,9997,0,9999,2
1658040372881,MATH 197,003,095567,Xiao; Ming,9999,0,9999,0
1658040372881,MATH 197,004,095571,Perols; Johan Lars,9998,0,9999,1
1658040379944,COGS 9,A01,083615,Shannon; Kyle Michael,11,0,75,64
1658040385968,COGS 11,A01,083617,Boyle; Mary E. T.,23,0,48,25
1658040391992,COGS 13,A01,083071,Bastos; Amalia Pinkusfeld,12,0,71,59
1658040398026,COGS 14A,A01,092681,Semenuks; Arturs,5,1,100,95
1658040404053,COGS 14B,A01,083073,Cheng; Tzu-Han,7,0,63,56
1658040410076,COGS 17,A01,092677,Semenuks; Arturs,7,0,81,74
1658040416099,COGS 100,A01,083619,Allen; Michael Gordon,17,0,70,53
1658040422125,COGS 101A,A01,083621,Davis; Joshua Daniel,9,0,68,59
1658040428148,COGS 101B,A01,091572,Allen; Michael Gordon,14,0,65,51
1658040434173,COGS 101C,A01,083625,Delgado; Tania,17,0,35,18
1658040440199,COGS 107A,A01,083627,Boyle; Mary E. T.,14,0,60,46
1658040446228,COGS 118A,A01,083075,Gupta; Anjum,21,0,76,55
1658040452251,CSE 3,A50,083646,Miranda; Gregory Joseph,24,0,50,26
1658040458278,CSE 8A,A50,083650,Miranda; Gregory Joseph,17,1,56,39
1658040464301,CSE 11,A01,083080,Cao; Yingjun,7,15,40,33
1658040470328,CSE 12,A01,083652,Krause-Levy; Sophia Louisa,30,1,120,90
1658040476350,CSE 15L,A01,083654,Morris; Justin Loren,9,0,50,41
1658040476350,CSE 15L,A02,083655,Morris; Justin Loren,11,0,50,39
1658040482379,CSE 20,A01,083657,Tran; Khoa Dang,39,0,80,41
1658040488404,CSE 21,A01,095574,Bach; Quang Tran,23,0,48,25
1658040494431,CSE 30,A01,083084,Eldon; John,8,0,80,72
1658040494431,CSE 30,B01,095061,Bhaskar; Nishant,9,0,50,41
1658040500458,CSE 100,A01,083659,Cao; Yingjun,5,4,70,65
1658040506481,CSE 134B,A01,083661,Powell; Thomas Allan,25,0,100,75
1658040512505,CSE 140,A01,083663,Gungor; Onat,17,0,85,68
1658040518607,CSE 140L,A01,083088,Eldon; John,23,0,100,77
1658040524630,CSE 175,A01,083665,Kumar; Rakesh,3,0,25,22
1658040530661,CSE 190,A00,092507,Dubnov; Shlomo,8,0,20,12
1658040536686,ECE 45,A01,083139,Congero; Spencer William,7,0,75,68
1658040542712,ECE 65,A50,083695,Saad; Andrew S,12,0,30,18
1658040542712,ECE 65,A51,095125,Saad; Andrew S,24,0,26,2
1658040548735,ECE 109,A01,091882,Touri; Behrouz,21,0,70,49
1658040554756,ECE 180,A00,083140,Abi Samra; Nicholas Camill,1,0,30,29
1658040554756,ECE 180,B00,083141,Abi Samra; Nicholas Camill,0,0,30,30
1658040560780,MATH 10A,A01,083735,Patchell; Gregory David,2,0,30,28
1658040560780,MATH 10A,A02,083736,Patchell; Gregory David,20,0,30,10
1658040560780,MATH 10A,A03,083737,Patchell; Gregory David,16,0,30,14
1658040566803,MATH 10B,A01,083207,Lim; Seonhee,9,0,34,25
1658040566803,MATH 10B,A02,083208,Lim; Seonhee,10,0,35,25
1658040566803,MATH 10B,A03,093472,Lim; Seonhee,7,0,34,27
1658040566803,MATH 10B,B01,083739,Sinha; Shubham,14,0,30,16
1658040572831,MATH 18,A01,083743,Cinel; Cameron Alexander,9,0,30,21
1658040572831,MATH 18,A02,083744,Cinel; Cameron Alexander,18,0,30,12
1658040572831,MATH 18,A03,083745,Cinel; Cameron Alexander,10,0,30,20
1658040572831,MATH 18,B01,083748,Rideout; David Porter,5,0,37,32
1658040572831,MATH 18,B02,083749,Rideout; David Porter,5,0,36,31
1658040572831,MATH 18,B03,083750,Rideout; David Porter,3,0,37,34
1658040572831,MATH 18,B04,083751,Rideout; David Porter,7,0,36,29
1658040572831,MATH 18,B05,093473,Rideout; David Porter,7,0,36,29
1658040572831,MATH 18,B06,093474,Rideout; David Porter,6,0,36,30
1658040578853,MATH 20A,A01,083754,Zheng; Zequn,14,0,40,26
1658040584881,MATH 20B,A01,083756,Briones; Jor-el Thomas Caparas,4,0,36,32
1658040584881,MATH 20B,A02,083757,Briones; Jor-el Thomas Caparas,1,0,36,35
1658040584881,MATH 20B,A03,093475,Briones; Jor-el Thomas Caparas,3,0,36,33
1658040590904,MATH 20C,A01,083760,Briones; Jor-el Thomas Caparas,1,0,35,34
1658040590904,MATH 20C,A02,083761,Briones; Jor-el Thomas Caparas,8,0,35,27
1658040590904,MATH 20C,A03,093476,Briones; Jor-el Thomas Caparas,0,1,36,36
1658040590904,MATH 20C,B01,083762,Bach; Quang Tran,1,0,30,29
1658040596928,MATH 20D,A01,083765,Tran; Brian Kha,5,0,30,25
1658040596928,MATH 20D,A02,083766,Tran; Brian Kha,5,0,30,25
1658040596928,MATH 20D,A03,083767,Tran; Brian Kha,6,0,30,24
1658040602951,MATH 20E,A01,083771,Ganguly; Soumya,12,0,32,20
1658040602951,MATH 20E,A02,083772,Ganguly; Soumya,7,0,32,25
1658040602951,MATH 20E,B01,083773,Ciotti; Benjamin,20,0,35,15
1658040602951,MATH 20E,B02,083774,Ciotti; Benjamin,18,0,35,17
1658040608974,MATH 103A,A01,083777,Greenfeld; Be'Eri,6,0,36,30
1658040608974,MATH 103A,A02,083778,Greenfeld; Be'Eri,5,0,36,31
1658040608974,MATH 103A,A03,093561,Greenfeld; Be'Eri,7,0,36,29
1658040608974,MATH 103A,B01,083779,Greenfeld; Be'Eri,8,0,36,28
1658040608974,MATH 103A,B02,083780,Greenfeld; Be'Eri,4,0,36,32
1658040608974,MATH 103A,B03,093562,Greenfeld; Be'Eri,3,0,36,33
1658040614996,MATH 105,A01,085443,Carter; Anne Toulson,15,0,35,20
1658040614996,MATH 105,A02,093477,Carter; Anne Toulson,20,0,35,15
1658040621020,MATH 109,A01,083213,Ganzberger; Geoffrey Michael,3,0,34,31
1658040621020,MATH 109,A02,083214,Ganzberger; Geoffrey Michael,4,0,34,30
1658040621020,MATH 109,A03,093478,Ganzberger; Geoffrey Michael,2,0,34,32
1658040621020,MATH 109,B01,083215,Ganzberger; Geoffrey Michael,3,0,32,29
1658040621020,MATH 109,B02,083216,Ganzberger; Geoffrey Michael,3,0,32,29
1658040621020,MATH 109,B03,093479,Ganzberger; Geoffrey Michael,8,0,32,24
1658040627049,MATH 142A,A01,083219,Chow; Bennett,7,0,32,25
1658040627049,MATH 142A,A02,083220,Chow; Bennett,10,0,32,22
1658040627049,MATH 142A,A03,093480,Chow; Bennett,9,0,32,23
1658040627049,MATH 142A,B03,093481,Chow; Bennett,8,0,32,24
1658040627049,MATH 142A,B04,093558,Chow; Bennett,14,0,32,18
1658040627049,MATH 142A,B05,093559,Chow; Bennett,7,0,32,25
1658040633073,MATH 193A,A01,083224,Rotar; Vladimir,9,0,34,25
1658040633073,MATH 193A,A02,083225,Rotar; Vladimir,11,0,34,23
1658040633073,MATH 193A,A03,083781,Rotar; Vladimir,5,0,34,29
1658040633073,MATH 193A,A04,083782,Rotar; Vladimir,12,0,34,22
1658040633073,MATH 193A,A05,093482,Rotar; Vladimir,11,0,34,23
1658040639095,MATH 197,001,091859,McAuley; Julian John,9999,0,9999,0
1658040639095,MATH 197,002,095566,Kedlaya; Kiran S.,9997,0,9999,2
1658040639095,MATH 197,003,095567,Xiao; Ming,9999,0,9999,0
1658040639095,MATH 197,004,095571,Perols; Johan Lars,9998,0,9999,1
1658040646151,COGS 9,A01,083615,Shannon; Kyle Michael,11,0,75,64
1658040652175,COGS 11,A01,083617,Boyle; Mary E. T.,23,0,48,25
1658040658201,COGS 13,A01,083071,Bastos; Amalia Pinkusfeld,12,0,71,59
1658040664225,COGS 14A,A01,092681,Semenuks; Arturs,5,1,100,95
1658040670246,COGS 14B,A01,083073,Cheng; Tzu-Han,7,0,63,56
1658040676267,COGS 17,A01,092677,Semenuks; Arturs,7,0,81,74
1658040682290,COGS 100,A01,083619,Allen; Michael Gordon,17,0,70,53
1658040688316,COGS 101A,A01,083621,Davis; Joshua Daniel,9,0,68,59
1658040694350,COGS 101B,A01,091572,Allen; Michael Gordon,14,0,65,51
1658040700378,COGS 101C,A01,083625,Delgado; Tania,17,0,35,18
1658040706400,COGS 107A,A01,083627,Boyle; Mary E. T.,14,0,60,46
1658040712425,COGS 118A,A01,083075,Gupta; Anjum,21,0,76,55
1658040718452,CSE 3,A50,083646,Miranda; Gregory Joseph,24,0,50,26
1658040724479,CSE 8A,A50,083650,Miranda; Gregory Joseph,17,1,56,39
1658040730501,CSE 11,A01,083080,Cao; Yingjun,7,15,40,33
1658040736525,CSE 12,A01,083652,Krause-Levy; Sophia Louisa,30,1,120,90
1658040742557,CSE 15L,A01,083654,Morris; Justin Loren,9,0,50,41
1658040742557,CSE 15L,A02,083655,Morris; Justin Loren,11,0,50,39
1658040748584,CSE 20,A01,083657,Tran; Khoa Dang,39,0,80,41
1658040754607,CSE 21,A01,095574,Bach; Quang Tran,23,0,48,25
1658040760629,CSE 30,A01,083084,Eldon; John,8,0,80,72
1658040760629,CSE 30,B01,095061,Bhaskar; Nishant,9,0,50,41
1658040766656,CSE 100,A01,083659,Cao; Yingjun,5,4,70,65
1658040772677,CSE 134B,A01,083661,Powell; Thomas Allan,25,0,100,75
1658040778702,CSE 140,A01,083663,Gungor; Onat,17,0,85,68
1658040784726,CSE 140L,A01,083088,Eldon; John,23,0,100,77
1658040790749,CSE 175,A01,083665,Kumar; Rakesh,3,0,25,22
1658040796774,CSE 190,A00,092507,Dubnov; Shlomo,8,0,20,12
1658040802797,ECE 45,A01,083139,Congero; Spencer William,7,0,75,68
1658040808819,ECE 65,A50,083695,Saad; Andrew S,12,0,30,18
1658040808819,ECE 65,A51,095125,Saad; Andrew S,24,0,26,2
1658040814842,ECE 109,A01,091882,Touri; Behrouz,21,0,70,49
1658040820867,ECE 180,A00,083140,Abi Samra; Nicholas Camill,1,0,30,29
1658040820867,ECE 180,B00,083141,Abi Samra; Nicholas Camill,0,0,30,30
1658040826894,MATH 10A,A01,083735,Patchell; Gregory David,2,0,30,28
1658040826894,MATH 10A,A02,083736,Patchell; Gregory David,20,0,30,10
1658040826894,MATH 10A,A03,083737,Patchell; Gregory David,16,0,30,14
1658040832917,MATH 10B,A01,083207,Lim; Seonhee,9,0,34,25
1658040832917,MATH 10B,A02,083208,Lim; Seonhee,10,0,35,25
1658040832917,MATH 10B,A03,093472,Lim; Seonhee,7,0,34,27
1658040832917,MATH 10B,B01,083739,Sinha; Shubham,14,0,30,16
1658040838948,MATH 18,A01,083743,Cinel; Cameron Alexander,9,0,30,21
1658040838948,MATH 18,A02,083744,Cinel; Cameron Alexander,18,0,30,12
1658040838948,MATH 18,A03,083745,Cinel; Cameron Alexander,10,0,30,20
1658040838948,MATH 18,B01,083748,Rideout; David Porter,5,0,37,32
1658040838948,MATH 18,B02,083749,Rideout; David Porter,5,0,36,31
1658040838948,MATH 18,B03,083750,Rideout; David Porter,3,0,37,34
1658040838948,MATH 18,B04,083751,Rideout; David Porter,7,0,36,29
1658040838948,MATH 18,B05,093473,Rideout; David Porter,7,0,36,29
1658040838948,MATH 18,B06,093474,Rideout; David Porter,6,0,36,30
1658040844973,MATH 20A,A01,083754,Zheng; Zequn,14,0,40,26
1658040850998,MATH 20B,A01,083756,Briones; Jor-el Thomas Caparas,4,0,36,32
1658040850998,MATH 20B,A02,083757,Briones; Jor-el Thomas Caparas,1,0,36,35
1658040850998,MATH 20B,A03,093475,Briones; Jor-el Thomas Caparas,3,0,36,33
1658040857021,MATH 20C,A01,083760,Briones; Jor-el Thomas Caparas,1,0,35,34
1658040857021,MATH 20C,A02,083761,Briones; Jor-el Thomas Caparas,8,0,35,27
1658040857021,MATH 20C,A03,093476,Briones; Jor-el Thomas Caparas,0,1,36,36
1658040857021,MATH 20C,B01,083762,Bach; Quang Tran,1,0,30,29
1658040863044,MATH 20D,A01,083765,Tran; Brian Kha,5,0,30,25
1658040863044,MATH 20D,A02,083766,Tran; Brian Kha,5,0,30,25
1658040863044,MATH 20D,A03,083767,Tran; Brian Kha,6,0,30,24
1658040869087,MATH 20E,A01,083771,Ganguly; Soumya,12,0,32,20
1658040869087,MATH 20E,A02,083772,Ganguly; Soumya,7,0,32,25
1658040869087,MATH 20E,B01,083773,Ciotti; Benjamin,20,0,35,15
1658040869087,MATH 20E,B02,083774,Ciotti; Benjamin,18,0,35,17
1658040875110,MATH 103A,A01,083777,Greenfeld; Be'Eri,6,0,36,30
1658040875110,MATH 103A,A02,083778,Greenfeld; Be'Eri,5,0,36,31
1658040875110,MATH 103A,A03,093561,Greenfeld; Be'Eri,7,0,36,29
1658040875110,MATH 103A,B01,083779,Greenfeld; Be'Eri,8,0,36,28
1658040875110,MATH 103A,B02,083780,Greenfeld; Be'Eri,4,0,36,32
1658040875110,MATH 103A,B03,093562,Greenfeld; Be'Eri,3,0,36,33
1658040881133,MATH 105,A01,085443,Carter; Anne Toulson,15,0,35,20
1658040881133,MATH 105,A02,093477,Carter; Anne Toulson,20,0,35,15
1658040887159,MATH 109,A01,083213,Ganzberger; Geoffrey Michael,3,0,34,31
1658040887159,MATH 109,A02,083214,Ganzberger; Geoffrey Michael,4,0,34,30
1658040887159,MATH 109,A03,093478,Ganzberger; Geoffrey Michael,2,0,34,32
1658040887159,MATH 109,B01,083215,Ganzberger; Geoffrey Michael,3,0,32,29
1658040887159,MATH 109,B02,083216,Ganzberger; Geoffrey Michael,3,0,32,29
1658040887159,MATH 109,B03,093479,Ganzberger; Geoffrey Michael,8,0,32,24
1658040893183,MATH 142A,A01,083219,Chow; Bennett,7,0,32,25
1658040893183,MATH 142A,A02,083220,Chow; Bennett,10,0,32,22
1658040893183,MATH 142A,A03,093480,Chow; Bennett,9,0,32,23
1658040893183,MATH 142A,B03,093481,Chow; Bennett,8,0,32,24
1658040893183,MATH 142A,B04,093558,Chow; Bennett,14,0,32,18
1658040893183,MATH 142A,B05,093559,Chow; Bennett,7,0,32,25
1658040899206,MATH 193A,A01,083224,Rotar; Vladimir,9,0,34,25
1658040899206,MATH 193A,A02,083225,Rotar; Vladimir,11,0,34,23
1658040899206,MATH 193A,A03,083781,Rotar; Vladimir,5,0,34,29
1658040899206,MATH 193A,A04,083782,Rotar; Vladimir,12,0,34,22
1658040899206,MATH 193A,A05,093482,Rotar; Vladimir,11,0,34,23
1658040905230,MATH 197,001,091859,McAuley; Julian John,9999,0,9999,0
1658040905230,MATH 197,002,095566,Kedlaya; Kiran S.,9997,0,9999,2
1658040905230,MATH 197,003,095567,Xiao; Ming,9999,0,9999,0
1658040905230,MATH 197,004,095571,Perols; Johan Lars,9998,0,9999,1
1658040912292,COGS 9,A01,083615,Shannon; Kyle Michael,11,0,75,64
1658040918315,COGS 11,A01,083617,Boyle; Mary E. T.,23,0,48,25
1658040924336,COGS 13,A01,083071,Bastos; Amalia Pinkusfeld,12,0,71,59
1658040930361,COGS 14A,A01,092681,Semenuks; Arturs,5,1,100,95
1658040936383,COGS 14B,A01,083073,Cheng; Tzu-Han,7,0,63,56
1658040942407,COGS 17,A01,092677,Semenuks; Arturs,7,0,81,74
1658040948433,COGS 100,A01,083619,Allen; Michael Gordon,17,0,70,53
1658040954455,COGS 101A,A01,083621,Davis; Joshua Daniel,9,0,68,59
1658040960478,COGS 101B,A01,091572,Allen; Michael Gordon,14,0,65,51
1658040966500,COGS 101C,A01,083625,Delgado; Tania,17,0,35,18
1658040972522,COGS 107A,A01,083627,Boyle; Mary E. T.,14,0,60,46
1658040978548,COGS 118A,A01,083075,Gupta; Anjum,21,0,76,55
1658040984576,CSE 3,A50,083646,Miranda; Gregory Joseph,24,0,50,26
1658040990600,CSE 8A,A50,083650,Miranda; Gregory Joseph,17,1,56,39
1658040996620,CSE 11,A01,083080,Cao; Yingjun,7,15,40,33
1658041002642,CSE 12,A01,083652,Krause-Levy; Sophia Louisa,30,1,120,90
1658041008675,CSE 15L,A01,083654,Morris; Justin Loren,9,0,50,41
1658041008675,CSE 15L,A02,083655,Morris; Justin Loren,11,0,50,39
1658041014701,CSE 20,A01,083657,Tran; Khoa Dang,39,0,80,41
1658041020727,CSE 21,A01,095574,Bach; Quang Tran,23,0,48,25
1658041026754,CSE 30,A01,083084,Eldon; John,8,0,80,72
1658041026754,CSE 30,B01,095061,Bhaskar; Nishant,9,0,50,41
1658041032781,CSE 100,A01,083659,Cao; Yingjun,5,4,70,65
1658041038807,CSE 134B,A01,083661,Powell; Thomas Allan,25,0,100,75
1658041044835,CSE 140,A01,083663,Gungor; Onat,17,0,85,68
1658041050857,CSE 140L,A01,083088,Eldon; John,23,0,100,77
1658041056879,CSE 175,A01,083665,Kumar; Rakesh,3,0,25,22
1658041062901,CSE 190,A00,092507,Dubnov; Shlomo,8,0,20,12
1658041068929,ECE 45,A01,083139,Congero; Spencer William,7,0,75,68
1658041074957,ECE 65,A50,083695,Saad; Andrew S,12,0,30,18
1658041074957,ECE 65,A51,095125,Saad; Andrew S,24,0,26,2
1658041080982,ECE 109,A01,091882,Touri; Behrouz,21,0,70,49
1658041087012,ECE 180,A00,083140,Abi Samra; Nicholas Camill,1,0,30,29
1658041087012,ECE 180,B00,083141,Abi Samra; Nicholas Camill,0,0,30,30
1658041093035,MATH 10A,A01,083735,Patchell; Gregory David,2,0,30,28
1658041093035,MATH 10A,A02,083736,Patchell; Gregory David,20,0,30,10
1658041093035,MATH 10A,A03,083737,Patchell; Gregory David,16,0,30,14
1658041099060,MATH 10B,A01,083207,Lim; Seonhee,9,0,34,25
1658041099060,MATH 10B,A02,083208,Lim; Seonhee,10,0,35,25
1658041099060,MATH 10B,A03,093472,Lim; Seonhee,7,0,34,27
1658041099060,MATH 10B,B01,083739,Sinha; Shubham,14,0,30,16
1658041105092,MATH 18,A01,083743,Cinel; Cameron Alexander,9,0,30,21
1658041105092,MATH 18,A02,083744,Cinel; Cameron Alexander,18,0,30,12
1658041105092,MATH 18,A03,083745,Cinel; Cameron Alexander,10,0,30,20
1658041105092,MATH 18,B01,083748,Rideout; David Porter,5,0,37,32
1658041105092,MATH 18,B02,083749,Rideout; David Porter,5,0,36,31
1658041105092,MATH 18,B03,083750,Rideout; David Porter,3,0,37,34
1658041105092,MATH 18,B04,083751,Rideout; David Porter,7,0,36,29
1658041105092,MATH 18,B05,093473,Rideout; David Porter,7,0,36,29
1658041105092,MATH 18,B06,093474,Rideout; David Porter,6,0,36,30
1658041111118,MATH 20A,A01,083754,Zheng; Zequn,14,0,40,26
1658041117212,MATH 20B,A01,083756,Briones; Jor-el Thomas Caparas,4,0,36,32
1658041117212,MATH 20B,A02,083757,Briones; Jor-el Thomas Caparas,1,0,36,35
1658041117212,MATH 20B,A03,093475,Briones; Jor-el Thomas Caparas,3,0,36,33
1658041123237,MATH 20C,A01,083760,Briones; Jor-el Thomas Caparas,1,0,35,34
1658041123237,MATH 20C,A02,083761,Briones; Jor-el Thomas Caparas,8,0,35,27
1658041123237,MATH 20C,A03,093476,Briones; Jor-el Thomas Caparas,0,1,36,36
1658041123237,MATH 20C,B01,083762,Bach; Quang Tran,1,0,30,29
1658041129258,MATH 20D,A01,083765,Tran; Brian Kha,5,0,30,25
1658041129258,MATH 20D,A02,083766,Tran; Brian Kha,5,0,30,25
1658041129258,MATH 20D,A03,083767,Tran; Brian Kha,6,0,30,24
1658041135286,MATH 20E,A01,083771,Ganguly; Soumya,12,0,32,20
1658041135286,MATH 20E,A02,083772,Ganguly; Soumya,7,0,32,25
1658041135286,MATH 20E,B01,083773,Ciotti; Benjamin,20,0,35,15
1658041135286,MATH 20E,B02,083774,Ciotti; Benjamin,18,0,35,17
1658041141309,MATH 103A,A01,083777,Greenfeld; Be'Eri,6,0,36,30
1658041141309,MATH 103A,A02,083778,Greenfeld; Be'Eri,5,0,36,31
1658041141309,MATH 103A,A03,093561,Greenfeld; Be'Eri,7,0,36,29
1658041141309,MATH 103A,B01,083779,Greenfeld; Be'Eri,8,0,36,28
1658041141309,MATH 103A,B02,083780,Greenfeld; Be'Eri,4,0,36,32
1658041141309,MATH 103A,B03,093562,Greenfeld; Be'Eri,3,0,36,33
1658041147333,MATH 105,A01,085443,Carter; Anne Toulson,15,0,35,20
1658041147333,MATH 105,A02,093477,Carter; Anne Toulson,20,0,35,15
1658041153360,MATH 109,A01,083213,Ganzberger; Geoffrey Michael,3,0,34,31
1658041153360,MATH 109,A02,083214,Ganzberger; Geoffrey Michael,4,0,34,30
1658041153360,MATH 109,A03,093478,Ganzberger; Geoffrey Michael,2,0,34,32
1658041153360,MATH 109,B01,083215,Ganzberger; Geoffrey Michael,3,0,32,29
1658041153360,MATH 109,B02,083216,Ganzberger; Geoffrey Michael,3,0,32,29
1658041153360,MATH 109,B03,093479,Ganzberger; Geoffrey Michael,8,0,32,24
1658041159383,MATH 142A,A01,083219,Chow; Bennett,7,0,32,25
1658041159383,MATH 142A,A02,083220,Chow; Bennett,10,0,32,22
1658041159383,MATH 142A,A03,093480,Chow; Bennett,9,0,32,23
1658041159383,MATH 142A,B03,093481,Chow; Bennett,8,0,32,24
1658041159383,MATH 142A,B04,093558,Chow; Bennett,14,0,32,18
1658041159383,MATH 142A,B05,093559,Chow; Bennett,7,0,32,25
1658041165406,MATH 193A,A01,083224,Rotar; Vladimir,9,0,34,25
1658041165406,MATH 193A,A02,083225,Rotar; Vladimir,11,0,34,23
1658041165406,MATH 193A,A03,083781,Rotar; Vladimir,5,0,34,29
1658041165406,MATH 193A,A04,083782,Rotar; Vladimir,12,0,34,22
1658041165406,MATH 193A,A05,093482,Rotar; Vladimir,11,0,34,23
1658041171434,MATH 197,001,091859,McAuley; Julian John,9999,0,9999,0
1658041171434,MATH 197,002,095566,Kedlaya; Kiran S.,9997,0,9999,2
1658041171434,MATH 197,003,095567,Xiao; Ming,9999,0,9999,0
1658041171434,MATH 197,004,095571,Perols; Johan Lars,9998,0,9999,1
1658041178491,COGS 9,A01,083615,Shannon; Kyle Michael,11,0,75,64
1658041184522,COGS 11,A01,083617,Boyle; Mary E. T.,23,0,48,25
1658041190543,COGS 13,A01,083071,Bastos; Amalia Pinkusfeld,12,0,71,59
1658041196567,COGS 14A,A01,092681,Semenuks; Arturs,5,1,100,95
1658041202596,COGS 14B,A01,083073,Cheng; Tzu-Han,7,0,63,56
1658041208625,COGS 17,A01,092677,Semenuks; Arturs,7,0,81,74
1658041214651,COGS 100,A01,083619,Allen; Michael Gordon,17,0,70,53
1658041220676,COGS 101A,A01,083621,Davis; Joshua Daniel,9,0,68,59
1658041226707,COGS 101B,A01,091572,Allen; Michael Gordon,14,0,65,51
1658041232733,COGS 101C,A01,083625,Delgado; Tania,17,0,35,18
1658041238755,COGS 107A,A01,083627,Boyle; Mary E. T.,14,0,60,46
1658041244781,COGS 118A,A01,083075,Gupta; Anjum,21,0,76,55
1658041250810,CSE 3,A50,083646,Miranda; Gregory Joseph,24,0,50,26
1658041256832,CSE 8A,A50,083650,Miranda; Gregory Joseph,17,1,56,39
1658041262859,CSE 11,A01,083080,Cao; Yingjun,7,15,40,33
1658041268883,CSE 12,A01,083652,Krause-Levy; Sophia Louisa,30,1,120,90
1658041274909,CSE 15L,A01,083654,Morris; Justin Loren,9,0,50,41
1658041274909,CSE 15L,A02,083655,Morris; Justin Loren,11,0,50,39
1658041280936,CSE 20,A01,083657,Tran; Khoa Dang,39,0,80,41
1658041286959,CSE 21,A01,095574,Bach; Quang Tran,23,0,48,25
1658041292983,CSE 30,A01,083084,Eldon; John,8,0,80,72
1658041292983,CSE 30,B01,095061,Bhaskar; Nishant,9,0,50,41
1658041299006,CSE 100,A01,083659,Cao; Yingjun,5,4,70,65
1658041305030,CSE 134B,A01,083661,Powell; Thomas Allan,25,0,100,75
1658041311062,CSE 140,A01,083663,Gungor; Onat,17,0,85,68
1658041317087,CSE 140L,A01,083088,Eldon; John,23,0,100,77
1658041323111,CSE 175,A01,083665,Kumar; Rakesh,3,0,25,22
1658041329140,CSE 190,A00,092507,Dubnov; Shlomo,8,0,20,12
1658041335164,ECE 45,A01,083139,Congero; Spencer William,7,0,75,68
1658041341189,ECE 65,A50,083695,Saad; Andrew S,12,0,30,18
1658041341189,ECE 65,A51,095125,Saad; Andrew S,24,0,26,2
1658041347216,ECE 109,A01,091882,Touri; Behrouz,21,0,70,49
1658041353239,ECE 180,A00,083140,Abi Samra; Nicholas Camill,1,0,30,29
1658041353239,ECE 180,B00,083141,Abi Samra; Nicholas Camill,0,0,30,30
1658041359264,MATH 10A,A01,083735,Patchell; Gregory David,2,0,30,28
1658041359264,MATH 10A,A02,083736,Patchell; Gregory David,20,0,30,10
1658041359264,MATH 10A,A03,083737,Patchell; Gregory David,16,0,30,14
1658041365287,MATH 10B,A01,083207,Lim; Seonhee,9,0,34,25
1658041365287,MATH 10B,A02,083208,Lim; Seonhee,10,0,35,25
1658041365287,MATH 10B,A03,093472,Lim; Seonhee,7,0,34,27
1658041365287,MATH 10B,B01,083739,Sinha; Shubham,14,0,30,16
1658041371310,MATH 18,A01,083743,Cinel; Cameron Alexander,9,0,30,21
1658041371310,MATH 18,A02,083744,Cinel; Cameron Alexander,18,0,30,12
1658041371310,MATH 18,A03,083745,Cinel; Cameron Alexander,10,0,30,20
1658041371310,MATH 18,B01,083748,Rideout; David Porter,5,0,37,32
1658041371310,MATH 18,B02,083749,Rideout; David Porter,5,0,36,31
1658041371310,MATH 18,B03,083750,Rideout; David Porter,3,0,37,34
1658041371310,MATH 18,B04,083751,Rideout; David Porter,7,0,36,29
1658041371310,MATH 18,B05,093473,Rideout; David Porter,7,0,36,29
1658041371310,MATH 18,B06,093474,Rideout; David Porter,6,0,36,30
1658041377338,MATH 20A,A01,083754,Zheng; Zequn,14,0,40,26
1658041387379,MATH 20B,A01,083756,Briones; Jor-el Thomas Caparas,4,0,36,32
1658041387379,MATH 20B,A02,083757,Briones; Jor-el Thomas Caparas,1,0,36,35
1658041387379,MATH 20B,A03,093475,Briones; Jor-el Thomas Caparas,3,0,36,33
1658041393401,MATH 20C,A01,083760,Briones; Jor-el Thomas Caparas,1,0,35,34
1658041393401,MATH 20C,A02,083761,Briones; Jor-el Thomas Caparas,8,0,35,27
1658041393401,MATH 20C,A03,093476,Briones; Jor-el Thomas Caparas,0,1,36,36
1658041393401,MATH 20C,B01,083762,Bach; Quang Tran,1,0,30,29
1658041399430,MATH 20D,A01,083765,Tran; Brian Kha,5,0,30,25
1658041399430,MATH 20D,A02,083766,Tran; Brian Kha,5,0,30,25
1658041399430,MATH 20D,A03,083767,Tran; Brian Kha,6,0,30,24
1658041405455,MATH 20E,A01,083771,Ganguly; Soumya,12,0,32,20
1658041405455,MATH 20E,A02,083772,Ganguly; Soumya,7,0,32,25
1658041405455,MATH 20E,B01,083773,Ciotti; Benjamin,20,0,35,15
1658041405455,MATH 20E,B02,083774,Ciotti; Benjamin,18,0,35,17
1658041411485,MATH 103A,A01,083777,Greenfeld; Be'Eri,6,0,36,30
1658041411485,MATH 103A,A02,083778,Greenfeld; Be'Eri,5,0,36,31
1658041411485,MATH 103A,A03,093561,Greenfeld; Be'Eri,7,0,36,29
1658041411485,MATH 103A,B01,083779,Greenfeld; Be'Eri,8,0,36,28
1658041411485,MATH 103A,B02,083780,Greenfeld; Be'Eri,4,0,36,32
1658041411485,MATH 103A,B03,093562,Greenfeld; Be'Eri,3,0,36,33
1658041417536,MATH 105,A01,085443,Carter; Anne Toulson,15,0,35,20
1658041417536,MATH 105,A02,093477,Carter; Anne Toulson,20,0,35,15
1658041423559,MATH 109,A01,083213,Ganzberger; Geoffrey Michael,3,0,34,31
1658041423559,MATH 109,A02,083214,Ganzberger; Geoffrey Michael,4,0,34,30
1658041423559,MATH 109,A03,093478,Ganzberger; Geoffrey Michael,2,0,34,32
1658041423559,MATH 109,B01,083215,Ganzberger; Geoffrey Michael,3,0,32,29
1658041423559,MATH 109,B02,083216,Ganzberger; Geoffrey Michael,3,0,32,29
1658041423559,MATH 109,B03,093479,Ganzberger; Geoffrey Michael,8,0,32,24
1658041429581,MATH 142A,A01,083219,Chow; Bennett,7,0,32,25
1658041429581,MATH 142A,A02,083220,Chow; Bennett,10,0,32,22
1658041429581,MATH 142A,A03,093480,Chow; Bennett,9,0,32,23
1658041429581,MATH 142A,B03,093481,Chow; Bennett,8,0,32,24
1658041429581,MATH 142A,B04,093558,Chow; Bennett,14,0,32,18
1658041429581,MATH 142A,B05,093559,Chow; Bennett,7,0,32,25
1658041435604,MATH 193A,A01,083224,Rotar; Vladimir,9,0,34,25
1658041435604,MATH 193A,A02,083225,Rotar; Vladimir,11,0,34,23
1658041435604,MATH 193A,A03,083781,Rotar; Vladimir,5,0,34,29
1658041435604,MATH 193A,A04,083782,Rotar; Vladimir,12,0,34,22
1658041435604,MATH 193A,A05,093482,Rotar; Vladimir,11,0,34,23
1658041441663,MATH 197,001,091859,McAuley; Julian John,9999,0,9999,0
1658041441663,MATH 197,002,095566,Kedlaya; Kiran S.,9997,0,9999,2
1658041441663,MATH 197,003,095567,Xiao; Ming,9999,0,9999,0
1658041441663,MATH 197,004,095571,Perols; Johan Lars,9998,0,9999,1
1658041448719,COGS 9,A01,083615,Shannon; Kyle Michael,11,0,75,64
1658041454744,COGS 11,A01,083617,Boyle; Mary E. T.,23,0,48,25
1658041460771,COGS 13,A01,083071,Bastos; Amalia Pinkusfeld,12,0,71,59
1658041466794,COGS 14A,A01,092681,Semenuks; Arturs,5,1,100,95
1658041472825,COGS 14B,A01,083073,Cheng; Tzu-Han,7,0,63,56
1658041478853,COGS 17,A01,092677,Semenuks; Arturs,7,0,81,74
1658041484875,COGS 100,A01,083619,Allen; Michael Gordon,17,0,70,53
1658041490903,COGS 101A,A01,083621,Davis; Joshua Daniel,9,0,68,59
1658041496926,COGS 101B,A01,091572,Allen; Michael Gordon,14,0,65,51
1658041502949,COGS 101C,A01,083625,Delgado; Tania,17,0,35,18
1658041508972,COGS 107A,A01,083627,Boyle; Mary E. T.,14,0,60,46
1658041514996,COGS 118A,A01,083075,Gupta; Anjum,21,0,76,55
1658041521019,CSE 3,A50,083646,Miranda; Gregory Joseph,24,0,50,26
1658041527046,CSE 8A,A50,083650,Miranda; Gregory Joseph,17,1,56,39
1658041533073,CSE 11,A01,083080,Cao; Yingjun,7,15,40,33
1658041539096,CSE 12,A01,083652,Krause-Levy; Sophia Louisa,30,1,120,90
1658041545124,CSE 15L,A01,083654,Morris; Justin Loren,9,0,50,41
1658041545124,CSE 15L,A02,083655,Morris; Justin Loren,11,0,50,39
1658041551150,CSE 20,A01,083657,Tran; Khoa Dang,39,0,80,41
1658041557172,CSE 21,A01,095574,Bach; Quang Tran,23,0,48,25
1658041563202,CSE 30,A01,083084,Eldon; John,8,0,80,72
1658041563202,CSE 30,B01,095061,Bhaskar; Nishant,9,0,50,41
1658041569225,CSE 100,A01,083659,Cao; Yingjun,5,4,70,65
1658041575250,CSE 134B,A01,083661,Powell; Thomas Allan,25,0,100,75
1658041581280,CSE 140,A01,083663,Gungor; Onat,17,0,85,68
1658041587304,CSE 140L,A01,083088,Eldon; John,23,0,100,77
1658041593329,CSE 175,A01,083665,Kumar; Rakesh,3,0,25,22
1658041599352,CSE 190,A00,092507,Dubnov; Shlomo,8,0,20,12
1658041605379,ECE 45,A01,083139,Congero; Spencer William,7,0,75,68
1658041611406,ECE 65,A50,083695,Saad; Andrew S,12,0,30,18
1658041611406,ECE 65,A51,095125,Saad; Andrew S,24,0,26,2
1658041617429,ECE 109,A01,091882,Touri; Behrouz,21,0,70,49
1658041623452,ECE 180,A00,083140,Abi Samra; Nicholas Camill,1,0,30,29
1658041623452,ECE 180,B00,083141,Abi Samra; Nicholas Camill,0,0,30,30
1658041629476,MATH 10A,A01,083735,Patchell; Gregory David,2,0,30,28
1658041629476,MATH 10A,A02,083736,Patchell; Gregory David,20,0,30,10
1658041629476,MATH 10A,A03,083737,Patchell; Gregory David,16,0,30,14
1658041635499,MATH 10B,A01,083207,Lim; Seonhee,9,0,34,25
1658041635499,MATH 10B,A02,083208,Lim; Seonhee,10,0,35,25
1658041635499,MATH 10B,A03,093472,Lim; Seonhee,7,0,34,27
1658041635499,MATH 10B,B01,083739,Sinha; Shubham,14,0,30,16
1658041641528,MATH 18,A01,083743,Cinel; Cameron Alexander,9,0,30,21
1658041641528,MATH 18,A02,083744,Cinel; Cameron Alexander,18,0,30,12
1658041641528,MATH 18,A03,083745,Cinel; Cameron Alexander,10,0,30,20
1658041641528,MATH 18,B01,083748,Rideout; David Porter,5,0,37,32
1658041641528,MATH 18,B02,083749,Rideout; David Porter,5,0,36,31
1658041641528,MATH 18,B03,083750,Rideout; David Porter,3,0,37,34
1658041641528,MATH 18,B04,083751,Rideout; David Porter,7,0,36,29
1658041641528,MATH 18,B05,093473,Rideout; David Porter,7,0,36,29
1658041641528,MATH 18,B06,093474,Rideout; David Porter,6,0,36,30
1658041647552,MATH 20A,A01,083754,Zheng; Zequn,14,0,40,26
1658041653576,MATH 20B,A01,083756,Briones; Jor-el Thomas Caparas,4,0,36,32
1658041653576,MATH 20B,A02,083757,Briones; Jor-el Thomas Caparas,1,0,36,35
1658041653576,MATH 20B,A03,093475,Briones; Jor-el Thomas Caparas,3,0,36,33
1658041659600,MATH 20C,A01,083760,Briones; Jor-el Thomas Caparas,1,0,35,34
1658041659600,MATH 20C,A02,083761,Briones; Jor-el Thomas Caparas,8,0,35,27
1658041659600,MATH 20C,A03,093476,Briones; Jor-el Thomas Caparas,0,1,36,36
1658041659600,MATH 20C,B01,083762,Bach; Quang Tran,1,0,30,29
1658041665627,MATH 20D,A01,083765,Tran; Brian Kha,5,0,30,25
1658041665627,MATH 20D,A02,083766,Tran; Brian Kha,5,0,30,25
1658041665627,MATH 20D,A03,083767,Tran; Brian Kha,6,0,30,24
1658041671650,MATH 20E,A01,083771,Ganguly; Soumya,12,0,32,20
1658041671650,MATH 20E,A02,083772,Ganguly; Soumya,7,0,32,25
1658041671650,MATH 20E,B01,083773,Ciotti; Benjamin,20,0,35,15
1658041671650,MATH 20E,B02,083774,Ciotti; Benjamin,18,0,35,17
1658041677678,MATH 103A,A01,083777,Greenfeld; Be'Eri,6,0,36,30
1658041677678,MATH 103A,A02,083778,Greenfeld; Be'Eri,5,0,36,31
1658041677678,MATH 103A,A03,093561,Greenfeld; Be'Eri,7,0,36,29
1658041677678,MATH 103A,B01,083779,Greenfeld; Be'Eri,8,0,36,28
1658041677678,MATH 103A,B02,083780,Greenfeld; Be'Eri,4,0,36,32
1658041677678,MATH 103A,B03,093562,Greenfeld; Be'Eri,3,0,36,33
1658041683706,MATH 105,A01,085443,Carter; Anne Toulson,15,0,35,20
1658041683706,MATH 105,A02,093477,Carter; Anne Toulson,20,0,35,15
1658041689730,MATH 109,A01,083213,Ganzberger; Geoffrey Michael,3,0,34,31
1658041689730,MATH 109,A02,083214,Ganzberger; Geoffrey Michael,4,0,34,30
1658041689730,MATH 109,A03,093478,Ganzberger; Geoffrey Michael,2,0,34,32
1658041689730,MATH 109,B01,083215,Ganzberger; Geoffrey Michael,3,0,32,29
1658041689730,MATH 109,B02,083216,Ganzberger; Geoffrey Michael,3,0,32,29
1658041689730,MATH 109,B03,093479,Ganzberger; Geoffrey Michael,8,0,32,24
1658041695755,MATH 142A,A01,083219,Chow; Bennett,7,0,32,25
1658041695755,MATH 142A,A02,083220,Chow; Bennett,10,0,32,22
1658041695755,MATH 142A,A03,093480,Chow; Bennett,9,0,32,23
1658041695755,MATH 142A,B03,093481,Chow; Bennett,8,0,32,24
1658041695755,MATH 142A,B04,093558,Chow; Bennett,14,0,32,18
1658041695755,MATH 142A,B05,093559,Chow; Bennett,7,0,32,25
1658041701779,MATH 193A,A01,083224,Rotar; Vladimir,9,0,34,25
1658041701779,MATH 193A,A02,083225,Rotar; Vladimir,11,0,34,23
1658041701779,MATH 193A,A03,083781,Rotar; Vladimir,5,0,34,29
1658041701779,MATH 193A,A04,083782,Rotar; Vladimir,12,0,34,22
1658041701779,MATH 193A,A05,093482,Rotar; Vladimir,11,0,34,23
1658041707802,MATH 197,001,091859,McAuley; Julian John,9999,0,9999,0
1658041707802,MATH 197,002,095566,Kedlaya; Kiran S.,9997,0,9999,2
1658041707802,MATH 197,003,095567,Xiao; Ming,9999,0,9999,0
1658041707802,MATH 197,004,095571,Perols; Johan Lars,9998,0,9999,1
1658041714948,COGS 9,A01,083615,Shannon; Kyle Michael,11,0,75,64
1658041720978,COGS 11,A01,083617,Boyle; Mary E. T.,23,0,48,25
1658041727002,COGS 13,A01,083071,Bastos; Amalia Pinkusfeld,12,0,71,59
1658041733025,COGS 14A,A01,092681,Semenuks; Arturs,5,1,100,95
1658041739049,COGS 14B,A01,083073,Cheng; Tzu-Han,7,0,63,56
1658041745078,COGS 17,A01,092677,Semenuks; Arturs,7,0,81,74
1658041751105,COGS 100,A01,083619,Allen; Michael Gordon,17,0,70,53
1658041757135,COGS 101A,A01,083621,Davis; Joshua Daniel,9,0,68,59
1658041763161,COGS 101B,A01,091572,Allen; Michael Gordon,14,0,65,51
1658041769184,COGS 101C,A01,083625,Delgado; Tania,17,0,35,18
1658041775214,COGS 107A,A01,083627,Boyle; Mary E. T.,14,0,60,46
1658041781238,COGS 118A,A01,083075,Gupta; Anjum,21,0,76,55
1658041787269,CSE 3,A50,083646,Miranda; Gregory Joseph,24,0,50,26
1658041793293,CSE 8A,A50,083650,Miranda; Gregory Joseph,17,1,56,39
1658041799316,CSE 11,A01,083080,Cao; Yingjun,7,15,40,33
1658041805340,CSE 12,A01,083652,Krause-Levy; Sophia Louisa,30,1,120,90
1658041811363,CSE 15L,A01,083654,Morris; Justin Loren,9,0,50,41
1658041811363,CSE 15L,A02,083655,Morris; Justin Loren,11,0,50,39
1658041817391,CSE 20,A01,083657,Tran; Khoa Dang,39,0,80,41
1658041823414,CSE 21,A01,095574,Bach; Quang Tran,23,0,48,25
1658041829446,CSE 30,A01,083084,Eldon; John,8,0,80,72
1658041829446,CSE 30,B01,095061,Bhaskar; Nishant,9,0,50,41
1658041835473,CSE 100,A01,083659,Cao; Yingjun,5,4,70,65
1658041841497,CSE 134B,A01,083661,Powell; Thomas Allan,25,0,100,75
1658041847524,CSE 140,A01,083663,Gungor; Onat,17,0,85,68
1658041853547,CSE 140L,A01,083088,Eldon; John,23,0,100,77
1658041859572,CSE 175,A01,083665,Kumar; Rakesh,3,0,25,22
1658041865593,CSE 190,A00,092507,Dubnov; Shlomo,8,0,20,12
1658041871616,ECE 45,A01,083139,Congero; Spencer William,7,0,75,68
1658041877640,ECE 65,A50,083695,Saad; Andrew S,12,0,30,18
1658041877640,ECE 65,A51,095125,Saad; Andrew S,24,0,26,2
1658041883664,ECE 109,A01,091882,Touri; Behrouz,21,0,70,49
1658041889693,ECE 180,A00,083140,Abi Samra; Nicholas Camill,1,0,30,29
1658041889693,ECE 180,B00,083141,Abi Samra; Nicholas Camill,0,0,30,30
1658041895723,MATH 10A,A01,083735,Patchell; Gregory David,2,0,30,28
1658041895723,MATH 10A,A02,083736,Patchell; Gregory David,20,0,30,10
1658041895723,MATH 10A,A03,083737,Patchell; Gregory David,16,0,30,14
1658041901768,MATH 10B,A01,083207,Lim; Seonhee,9,0,34,25
1658041901768,MATH 10B,A02,083208,Lim; Seonhee,10,0,35,25
1658041901768,MATH 10B,A03,093472,Lim; Seonhee,7,0,34,27
1658041901768,MATH 10B,B01,083739,Sinha; Shubham,14,0,30,16
1658041907793,MATH 18,A01,083743,Cinel; Cameron Alexander,9,0,30,21
1658041907793,MATH 18,A02,083744,Cinel; Cameron Alexander,18,0,30,12
1658041907793,MATH 18,A03,083745,Cinel; Cameron Alexander,10,0,30,20
1658041907793,MATH 18,B01,083748,Rideout; David Porter,5,0,37,32
1658041907793,MATH 18,B02,083749,Rideout; David Porter,5,0,36,31
1658041907793,MATH 18,B03,083750,Rideout; David Porter,3,0,37,34
1658041907793,MATH 18,B04,083751,Rideout; David Porter,7,0,36,29
1658041907793,MATH 18,B05,093473,Rideout; David Porter,7,0,36,29
1658041907793,MATH 18,B06,093474,Rideout; David Porter,6,0,36,30
1658041913816,MATH 20A,A01,083754,Zheng; Zequn,14,0,40,26
1658041919838,MATH 20B,A01,083756,Briones; Jor-el Thomas Caparas,4,0,36,32
1658041919838,MATH 20B,A02,083757,Briones; Jor-el Thomas Caparas,1,0,36,35
1658041919838,MATH 20B,A03,093475,Briones; Jor-el Thomas Caparas,3,0,36,33
1658041925860,MATH 20C,A01,083760,Briones; Jor-el Thomas Caparas,1,0,35,34
1658041925860,MATH 20C,A02,083761,Briones; Jor-el Thomas Caparas,8,0,35,27
1658041925860,MATH 20C,A03,093476,Briones; Jor-el Thomas Caparas,0,1,36,36
1658041925860,MATH 20C,B01,083762,Bach; Quang Tran,1,0,30,29
1658041931885,MATH 20D,A01,083765,Tran; Brian Kha,5,0,30,25
1658041931885,MATH 20D,A02,083766,Tran; Brian Kha,5,0,30,25
1658041931885,MATH 20D,A03,083767,Tran; Brian Kha,6,0,30,24
1658041937907,MATH 20E,A01,083771,Ganguly; Soumya,12,0,32,20
1658041937907,MATH 20E,A02,083772,Ganguly; Soumya,7,0,32,25
1658041937907,MATH 20E,B01,083773,Ciotti; Benjamin,20,0,35,15
1658041937907,MATH 20E,B02,083774,Ciotti; Benjamin,18,0,35,17
1658041943934,MATH 103A,A01,083777,Greenfeld; Be'Eri,6,0,36,30
1658041943934,MATH 103A,A02,083778,Greenfeld; Be'Eri,5,0,36,31
1658041943934,MATH 103A,A03,093561,Greenfeld; Be'Eri,7,0,36,29
1658041943934,MATH 103A,B01,083779,Greenfeld; Be'Eri,8,0,36,28
1658041943934,MATH 103A,B02,083780,Greenfeld; Be'Eri,4,0,36,32
1658041943934,MATH 103A,B03,093562,Greenfeld; Be'Eri,3,0,36,33
1658041949965,MATH 105,A01,085443,Carter; Anne Toulson,15,0,35,20
1658041949965,MATH 105,A02,093477,Carter; Anne Toulson,20,0,35,15
1658041955994,MATH 109,A01,083213,Ganzberger; Geoffrey Michael,3,0,34,31
1658041955994,MATH 109,A02,083214,Ganzberger; Geoffrey Michael,4,0,34,30
1658041955994,MATH 109,A03,093478,Ganzberger; Geoffrey Michael,2,0,34,32
1658041955994,MATH 109,B01,083215,Ganzberger; Geoffrey Michael,3,0,32,29
1658041955994,MATH 109,B02,083216,Ganzberger; Geoffrey Michael,3,0,32,29
1658041955994,MATH 109,B03,093479,Ganzberger; Geoffrey Michael,8,0,32,24
1658041962024,MATH 142A,A01,083219,Chow; Bennett,7,0,32,25
1658041962024,MATH 142A,A02,083220,Chow; Bennett,10,0,32,22
1658041962024,MATH 142A,A03,093480,Chow; Bennett,9,0,32,23
1658041962024,MATH 142A,B03,093481,Chow; Bennett,8,0,32,24
1658041962024,MATH 142A,B04,093558,Chow; Bennett,14,0,32,18
1658041962024,MATH 142A,B05,093559,Chow; Bennett,7,0,32,25
1658041968049,MATH 193A,A01,083224,Rotar; Vladimir,9,0,34,25
1658041968049,MATH 193A,A02,083225,Rotar; Vladimir,11,0,34,23
1658041968049,MATH 193A,A03,083781,Rotar; Vladimir,5,0,34,29
1658041968049,MATH 193A,A04,083782,Rotar; Vladimir,12,0,34,22
1658041968049,MATH 193A,A05,093482,Rotar; Vladimir,11,0,34,23
1658041974073,MATH 197,001,091859,McAuley; Julian John,9999,0,9999,0
1658041974073,MATH 197,002,095566,Kedlaya; Kiran S.,9997,0,9999,2
1658041974073,MATH 197,003,095567,Xiao; Ming,9999,0,9999,0
1658041974073,MATH 197,004,095571,Perols; Johan Lars,9998,0,9999,1
1658041981164,COGS 9,A01,083615,Shannon; Kyle Michael,11,0,75,64
1658041987187,COGS 11,A01,083617,Boyle; Mary E. T.,23,0,48,25
1658041993214,COGS 13,A01,083071,Bastos; Amalia Pinkusfeld,12,0,71,59
1658041999243,COGS 14A,A01,092681,Semenuks; Arturs,5,1,100,95
1658042005267,COGS 14B,A01,083073,Cheng; Tzu-Han,7,0,63,56
1658042011307,COGS 17,A01,092677,Semenuks; Arturs,7,0,81,74
1658042017339,COGS 100,A01,083619,Allen; Michael Gordon,17,0,70,53
1658042023362,COGS 101A,A01,083621,Davis; Joshua Daniel,9,0,68,59
1658042029390,COGS 101B,A01,091572,Allen; Michael Gordon,14,0,65,51
1658042035413,COGS 101C,A01,083625,Delgado; Tania,17,0,35,18
1658042041441,COGS 107A,A01,083627,Boyle; Mary E. T.,14,0,60,46
1658042047465,COGS 118A,A01,083075,Gupta; Anjum,21,0,76,55
1658042053493,CSE 3,A50,083646,Miranda; Gregory Joseph,24,0,50,26
1658042059530,CSE 8A,A50,083650,Miranda; Gregory Joseph,17,1,56,39
1658042065552,CSE 11,A01,083080,Cao; Yingjun,7,15,40,33
1658042071576,CSE 12,A01,083652,Krause-Levy; Sophia Louisa,30,1,120,90
1658042077604,CSE 15L,A01,083654,Morris; Justin Loren,9,0,50,41
1658042077604,CSE 15L,A02,083655,Morris; Justin Loren,11,0,50,39
1658042083630,CSE 20,A01,083657,Tran; Khoa Dang,39,0,80,41
1658042089654,CSE 21,A01,095574,Bach; Quang Tran,23,0,48,25
1658042095684,CSE 30,A01,083084,Eldon; John,8,0,80,72
1658042095684,CSE 30,B01,095061,Bhaskar; Nishant,9,0,50,41
1658042101713,CSE 100,A01,083659,Cao; Yingjun,5,4,70,65
1658042107747,CSE 134B,A01,083661,Powell; Thomas Allan,25,0,100,75
1658042113770,CSE 140,A01,083663,Gungor; Onat,17,0,85,68
1658042119792,CSE 140L,A01,083088,Eldon; John,23,0,100,77
1658042125819,CSE 175,A01,083665,Kumar; Rakesh,3,0,25,22
1658042131845,CSE 190,A00,092507,Dubnov; Shlomo,8,0,20,12
1658042137867,ECE 45,A01,083139,Congero; Spencer William,7,0,75,68
1658042143890,ECE 65,A50,083695,Saad; Andrew S,12,0,30,18
1658042143890,ECE 65,A51,095125,Saad; Andrew S,24,0,26,2
1658042149912,ECE 109,A01,091882,Touri; Behrouz,21,0,70,49
1658042155935,ECE 180,A00,083140,Abi Samra; Nicholas Camill,1,0,30,29
1658042155935,ECE 180,B00,083141,Abi Samra; Nicholas Camill,0,0,30,30
1658042161963,MATH 10A,A01,083735,Patchell; Gregory David,2,0,30,28
1658042161963,MATH 10A,A02,083736,Patchell; Gregory David,20,0,30,10
1658042161963,MATH 10A,A03,083737,Patchell; Gregory David,16,0,30,14
1658042167990,MATH 10B,A01,083207,Lim; Seonhee,9,0,34,25
1658042167990,MATH 10B,A02,083208,Lim; Seonhee,10,0,35,25
1658042167990,MATH 10B,A03,093472,Lim; Seonhee,7,0,34,27
1658042167990,MATH 10B,B01,083739,Sinha; Shubham,14,0,30,16
1658042174021,MATH 18,A01,083743,Cinel; Cameron Alexander,9,0,30,21
1658042174021,MATH 18,A02,083744,Cinel; Cameron Alexander,18,0,30,12
1658042174021,MATH 18,A03,083745,Cinel; Cameron Alexander,10,0,30,20
1658042174021,MATH 18,B01,083748,Rideout; David Porter,5,0,37,32
1658042174021,MATH 18,B02,083749,Rideout; David Porter,5,0,36,31
1658042174021,MATH 18,B03,083750,Rideout; David Porter,3,0,37,34
1658042174021,MATH 18,B04,083751,Rideout; David Porter,7,0,36,29
1658042174021,MATH 18,B05,093473,Rideout; David Porter,7,0,36,29
1658042174021,MATH 18,B06,093474,Rideout; David Porter,6,0,36,30
1658042180048,MATH 20A,A01,083754,Zheng; Zequn,14,0,40,26
1658042186078,MATH 20B,A01,083756,Briones; Jor-el Thomas Caparas,4,0,36,32
1658042186078,MATH 20B,A02,083757,Briones; Jor-el Thomas Caparas,1,0,36,35
1658042186078,MATH 20B,A03,093475,Briones; Jor-el Thomas Caparas,3,0,36,33
1658042192102,MATH 20C,A01,083760,Briones; Jor-el Thomas Caparas,1,0,35,34
1658042192102,MATH 20C,A02,083761,Briones; Jor-el Thomas Caparas,8,0,35,27
1658042192102,MATH 20C,A03,093476,Briones; Jor-el Thomas Caparas,0,1,36,36
1658042192102,MATH 20C,B01,083762,Bach; Quang Tran,1,0,30,29
1658042198135,MATH 20D,A01,083765,Tran; Brian Kha,5,0,30,25
1658042198135,MATH 20D,A02,083766,Tran; Brian Kha,5,0,30,25
1658042198135,MATH 20D,A03,083767,Tran; Brian Kha,6,0,30,24
1658042204158,MATH 20E,A01,083771,Ganguly; Soumya,12,0,32,20
1658042204158,MATH 20E,A02,083772,Ganguly; Soumya,7,0,32,25
1658042204158,MATH 20E,B01,083773,Ciotti; Benjamin,20,0,35,15
1658042204158,MATH 20E,B02,083774,Ciotti; Benjamin,18,0,35,17
1658042210189,MATH 103A,A01,083777,Greenfeld; Be'Eri,6,0,36,30
1658042210189,MATH 103A,A02,083778,Greenfeld; Be'Eri,5,0,36,31
1658042210189,MATH 103A,A03,093561,Greenfeld; Be'Eri,7,0,36,29
1658042210189,MATH 103A,B01,083779,Greenfeld; Be'Eri,8,0,36,28
1658042210189,MATH 103A,B02,083780,Greenfeld; Be'Eri,4,0,36,32
1658042210189,MATH 103A,B03,093562,Greenfeld; Be'Eri,3,0,36,33
1658042216215,MATH 105,A01,085443,Carter; Anne Toulson,15,0,35,20
1658042216215,MATH 105,A02,093477,Carter; Anne Toulson,20,0,35,15
1658042222248,MATH 109,A01,083213,Ganzberger; Geoffrey Michael,3,0,34,31
1658042222248,MATH 109,A02,083214,Ganzberger; Geoffrey Michael,4,0,34,30
1658042222248,MATH 109,A03,093478,Ganzberger; Geoffrey Michael,2,0,34,32
1658042222248,MATH 109,B01,083215,Ganzberger; Geoffrey Michael,3,0,32,29
1658042222248,MATH 109,B02,083216,Ganzberger; Geoffrey Michael,3,0,32,29
1658042222248,MATH 109,B03,093479,Ganzberger; Geoffrey Michael,8,0,32,24
1658042228271,MATH 142A,A01,083219,Chow; Bennett,7,0,32,25
1658042228271,MATH 142A,A02,083220,Chow; Bennett,10,0,32,22
1658042228271,MATH 142A,A03,093480,Chow; Bennett,9,0,32,23
1658042228271,MATH 142A,B03,093481,Chow; Bennett,8,0,32,24
1658042228271,MATH 142A,B04,093558,Chow; Bennett,14,0,32,18
1658042228271,MATH 142A,B05,093559,Chow; Bennett,7,0,32,25
1658042234296,MATH 193A,A01,083224,Rotar; Vladimir,9,0,34,25
1658042234296,MATH 193A,A02,083225,Rotar; Vladimir,11,0,34,23
1658042234296,MATH 193A,A03,083781,Rotar; Vladimir,5,0,34,29
1658042234296,MATH 193A,A04,083782,Rotar; Vladimir,12,0,34,22
1658042234296,MATH 193A,A05,093482,Rotar; Vladimir,11,0,34,23
1658042240323,MATH 197,001,091859,McAuley; Julian John,9999,0,9999,0
1658042240323,MATH 197,002,095566,Kedlaya; Kiran S.,9997,0,9999,2
1658042240323,MATH 197,003,095567,Xiao; Ming,9999,0,9999,0
1658042240323,MATH 197,004,095571,Perols; Johan Lars,9998,0,9999,1
1658042247378,COGS 9,A01,083615,Shannon; Kyle Michael,11,0,75,64
1658042253403,COGS 11,A01,083617,Boyle; Mary E. T.,23,0,48,25
1658042259430,COGS 13,A01,083071,Bastos; Amalia Pinkusfeld,12,0,71,59
1658042265469,COGS 14A,A01,092681,Semenuks; Arturs,5,1,100,95
1658042271493,COGS 14B,A01,083073,Cheng; Tzu-Han,7,0,63,56
1658042277517,COGS 17,A01,092677,Semenuks; Arturs,7,0,81,74
1658042283539,COGS 100,A01,083619,Allen; Michael Gordon,17,0,70,53
1658042289567,COGS 101A,A01,083621,Davis; Joshua Daniel,9,0,68,59
1658042295595,COGS 101B,A01,091572,Allen; Michael Gordon,14,0,65,51
1658042301619,COGS 101C,A01,083625,Delgado; Tania,17,0,35,18
1658042307641,COGS 107A,A01,083627,Boyle; Mary E. T.,14,0,60,46
1658042313761,COGS 118A,A01,083075,Gupta; Anjum,21,0,76,55
1658042319789,CSE 3,A50,083646,Miranda; Gregory Joseph,24,0,50,26
1658042325813,CSE 8A,A50,083650,Miranda; Gregory Joseph,17,1,56,39
1658042331841,CSE 11,A01,083080,Cao; Yingjun,7,15,40,33
1658042337870,CSE 12,A01,083652,Krause-Levy; Sophia Louisa,30,1,120,90
1658042343893,CSE 15L,A01,083654,Morris; Justin Loren,9,0,50,41
1658042343893,CSE 15L,A02,083655,Morris; Justin Loren,11,0,50,39
1658042349917,CSE 20,A01,083657,Tran; Khoa Dang,39,0,80,41
1658042355945,CSE 21,A01,095574,Bach; Quang Tran,23,0,48,25
1658042361969,CSE 30,A01,083084,Eldon; John,8,0,80,72
1658042361969,CSE 30,B01,095061,Bhaskar; Nishant,9,0,50,41
1658042367991,CSE 100,A01,083659,Cao; Yingjun,5,4,70,65
1658042374014,CSE 134B,A01,083661,Powell; Thomas Allan,25,0,100,75
1658042380039,CSE 140,A01,083663,Gungor; Onat,17,0,85,68
1658042386062,CSE 140L,A01,083088,Eldon; John,23,0,100,77
1658042392084,CSE 175,A01,083665,Kumar; Rakesh,3,0,25,22
1658042398109,CSE 190,A00,092507,Dubnov; Shlomo,8,0,20,12
1658042404130,ECE 45,A01,083139,Congero; Spencer William,7,0,75,68
1658042410156,ECE 65,A50,083695,Saad; Andrew S,12,0,30,18
1658042410156,ECE 65,A51,095125,Saad; Andrew S,24,0,26,2
1658042416179,ECE 109,A01,091882,Touri; Behrouz,21,0,70,49
1658042422201,ECE 180,A00,083140,Abi Samra; Nicholas Camill,1,0,30,29
1658042422201,ECE 180,B00,083141,Abi Samra; Nicholas Camill,0,0,30,30
1658042428225,MATH 10A,A01,083735,Patchell; Gregory David,2,0,30,28
1658042428225,MATH 10A,A02,083736,Patchell; Gregory David,20,0,30,10
1658042428225,MATH 10A,A03,083737,Patchell; Gregory David,16,0,30,14
1658042434252,MATH 10B,A01,083207,Lim; Seonhee,9,0,34,25
1658042434252,MATH 10B,A02,083208,Lim; Seonhee,10,0,35,25
1658042434252,MATH 10B,A03,093472,Lim; Seonhee,7,0,34,27
1658042434252,MATH 10B,B01,083739,Sinha; Shubham,14,0,30,16
1658042440282,MATH 18,A01,083743,Cinel; Cameron Alexander,9,0,30,21
1658042440282,MATH 18,A02,083744,Cinel; Cameron Alexander,18,0,30,12
1658042440282,MATH 18,A03,083745,Cinel; Cameron Alexander,10,0,30,20
1658042440282,MATH 18,B01,083748,Rideout; David Porter,5,0,37,32
1658042440282,MATH 18,B02,083749,Rideout; David Porter,5,0,36,31
1658042440282,MATH 18,B03,083750,Rideout; David Porter,3,0,37,34
1658042440282,MATH 18,B04,083751,Rideout; David Porter,7,0,36,29
1658042440282,MATH 18,B05,093473,Rideout; David Porter,7,0,36,29
1658042440282,MATH 18,B06,093474,Rideout; David Porter,6,0,36,30
1658042446304,MATH 20A,A01,083754,Zheng; Zequn,14,0,40,26
1658042452331,MATH 20B,A01,083756,Briones; Jor-el Thomas Caparas,4,0,36,32
1658042452331,MATH 20B,A02,083757,Briones; Jor-el Thomas Caparas,1,0,36,35
1658042452331,MATH 20B,A03,093475,Briones; Jor-el Thomas Caparas,3,0,36,33
1658042458360,MATH 20C,A01,083760,Briones; Jor-el Thomas Caparas,1,0,35,34
1658042458360,MATH 20C,A02,083761,Briones; Jor-el Thomas Caparas,8,0,35,27
1658042458360,MATH 20C,A03,093476,Briones; Jor-el Thomas Caparas,0,1,36,36
1658042458360,MATH 20C,B01,083762,Bach; Quang Tran,1,0,30,29
1658042464388,MATH 20D,A01,083765,Tran; Brian Kha,5,0,30,25
1658042464388,MATH 20D,A02,083766,Tran; Brian Kha,5,0,30,25
1658042464388,MATH 20D,A03,083767,Tran; Brian Kha,6,0,30,24
1658042470415,MATH 20E,A01,083771,Ganguly; Soumya,12,0,32,20
1658042470415,MATH 20E,A02,083772,Ganguly; Soumya,7,0,32,25
1658042470415,MATH 20E,B01,083773,Ciotti; Benjamin,20,0,35,15
1658042470415,MATH 20E,B02,083774,Ciotti; Benjamin,18,0,35,17
1658042476444,MATH 103A,A01,083777,Greenfeld; Be'Eri,6,0,36,30
1658042476444,MATH 103A,A02,083778,Greenfeld; Be'Eri,5,0,36,31
1658042476444,MATH 103A,A03,093561,Greenfeld; Be'Eri,7,0,36,29
1658042476444,MATH 103A,B01,083779,Greenfeld; Be'Eri,8,0,36,28
1658042476444,MATH 103A,B02,083780,Greenfeld; Be'Eri,4,0,36,32
1658042476444,MATH 103A,B03,093562,Greenfeld; Be'Eri,3,0,36,33
1658042482468,MATH 105,A01,085443,Carter; Anne Toulson,15,0,35,20
1658042482468,MATH 105,A02,093477,Carter; Anne Toulson,20,0,35,15
1658042488496,MATH 109,A01,083213,Ganzberger; Geoffrey Michael,3,0,34,31
1658042488496,MATH 109,A02,083214,Ganzberger; Geoffrey Michael,4,0,34,30
1658042488496,MATH 109,A03,093478,Ganzberger; Geoffrey Michael,2,0,34,32
1658042488496,MATH 109,B01,083215,Ganzberger; Geoffrey Michael,3,0,32,29
1658042488496,MATH 109,B02,083216,Ganzberger; Geoffrey Michael,3,0,32,29
1658042488496,MATH 109,B03,093479,Ganzberger; Geoffrey Michael,8,0,32,24
1658042494534,MATH 142A,A01,083219,Chow; Bennett,7,0,32,25
1658042494534,MATH 142A,A02,083220,Chow; Bennett,10,0,32,22
1658042494534,MATH 142A,A03,093480,Chow; Bennett,9,0,32,23
1658042494534,MATH 142A,B03,093481,Chow; Bennett,8,0,32,24
1658042494534,MATH 142A,B04,093558,Chow; Bennett,14,0,32,18
1658042494534,MATH 142A,B05,093559,Chow; Bennett,7,0,32,25
1658042500557,MATH 193A,A01,083224,Rotar; Vladimir,9,0,34,25
1658042500557,MATH 193A,A02,083225,Rotar; Vladimir,11,0,34,23
1658042500557,MATH 193A,A03,083781,Rotar; Vladimir,5,0,34,29
1658042500557,MATH 193A,A04,083782,Rotar; Vladimir,12,0,34,22
1658042500557,MATH 193A,A05,093482,Rotar; Vladimir,11,0,34,23
1658042506583,MATH 197,001,091859,McAuley; Julian John,9999,0,9999,0
1658042506583,MATH 197,002,095566,Kedlaya; Kiran S.,9997,0,9999,2
1658042506583,MATH 197,003,095567,Xiao; Ming,9999,0,9999,0
1658042506583,MATH 197,004,095571,Perols; Johan Lars,9998,0,9999,1
1658042513643,COGS 9,A01,083615,Shannon; Kyle Michael,11,0,75,64
1658042519669,COGS 11,A01,083617,Boyle; Mary E. T.,23,0,48,25
1658042525691,COGS 13,A01,083071,Bastos; Amalia Pinkusfeld,12,0,71,59
1658042531718,COGS 14A,A01,092681,Semenuks; Arturs,5,1,100,95
1658042537742,COGS 14B,A01,083073,Cheng; Tzu-Han,7,0,63,56
1658042543765,COGS 17,A01,092677,Semenuks; Arturs,7,0,81,74
1658042549787,COGS 100,A01,083619,Allen; Michael Gordon,17,0,70,53
1658042555813,COGS 101A,A01,083621,Davis; Joshua Daniel,9,0,68,59
1658042561840,COGS 101B,A01,091572,Allen; Michael Gordon,14,0,65,51
1658042567866,COGS 101C,A01,083625,Delgado; Tania,17,0,35,18
1658042573899,COGS 107A,A01,083627,Boyle; Mary E. T.,14,0,60,46
1658042579925,COGS 118A,A01,083075,Gupta; Anjum,21,0,76,55
1658042585954,CSE 3,A50,083646,Miranda; Gregory Joseph,24,0,50,26
1658042591981,CSE 8A,A50,083650,Miranda; Gregory Joseph,17,1,56,39
1658042598008,CSE 11,A01,083080,Cao; Yingjun,7,15,40,33
1658042604031,CSE 12,A01,083652,Krause-Levy; Sophia Louisa,30,1,120,90
1658042610058,CSE 15L,A01,083654,Morris; Justin Loren,9,0,50,41
1658042610058,CSE 15L,A02,083655,Morris; Justin Loren,11,0,50,39
1658042616087,CSE 20,A01,083657,Tran; Khoa Dang,39,0,80,41
1658042622110,CSE 21,A01,095574,Bach; Quang Tran,23,0,48,25
1658042628143,CSE 30,A01,083084,Eldon; John,8,0,80,72
1658042628143,CSE 30,B01,095061,Bhaskar; Nishant,9,0,50,41
1658042634169,CSE 100,A01,083659,Cao; Yingjun,5,4,70,65
1658042640194,CSE 134B,A01,083661,Powell; Thomas Allan,25,0,100,75
1658042646221,CSE 140,A01,083663,Gungor; Onat,17,0,85,68
1658042652244,CSE 140L,A01,083088,Eldon; John,23,0,100,77
1658042658270,CSE 175,A01,083665,Kumar; Rakesh,3,0,25,22
1658042664301,CSE 190,A00,092507,Dubnov; Shlomo,8,0,20,12
1658042670324,ECE 45,A01,083139,Congero; Spencer William,7,0,75,68
1658042676350,ECE 65,A50,083695,Saad; Andrew S,12,0,30,18
1658042676350,ECE 65,A51,095125,Saad; Andrew S,24,0,26,2
1658042682376,ECE 109,A01,091882,Touri; Behrouz,21,0,70,49
1658042688400,ECE 180,A00,083140,Abi Samra; Nicholas Camill,1,0,30,29
1658042688400,ECE 180,B00,083141,Abi Samra; Nicholas Camill,0,0,30,30
1658042694423,MATH 10A,A01,083735,Patchell; Gregory David,2,0,30,28
1658042694423,MATH 10A,A02,083736,Patchell; Gregory David,20,0,30,10
1658042694423,MATH 10A,A03,083737,Patchell; Gregory David,16,0,30,14
1658042700446,MATH 10B,A01,083207,Lim; Seonhee,9,0,34,25
1658042700446,MATH 10B,A02,083208,Lim; Seonhee,10,0,35,25
1658042700446,MATH 10B,A03,093472,Lim; Seonhee,7,0,34,27
1658042700446,MATH 10B,B01,083739,Sinha; Shubham,14,0,30,16
1658042706484,MATH 18,A01,083743,Cinel; Cameron Alexander,9,0,30,21
1658042706484,MATH 18,A02,083744,Cinel; Cameron Alexander,18,0,30,12
1658042706484,MATH 18,A03,083745,Cinel; Cameron Alexander,10,0,30,20
1658042706484,MATH 18,B01,083748,Rideout; David Porter,5,0,37,32
1658042706484,MATH 18,B02,083749,Rideout; David Porter,5,0,36,31
1658042706484,MATH 18,B03,083750,Rideout; David Porter,3,0,37,34
1658042706484,MATH 18,B04,083751,Rideout; David Porter,7,0,36,29
1658042706484,MATH 18,B05,093473,Rideout; David Porter,7,0,36,29
1658042706484,MATH 18,B06,093474,Rideout; David Porter,6,0,36,30
1658042712510,MATH 20A,A01,083754,Zheng; Zequn,14,0,40,26
1658042718536,MATH 20B,A01,083756,Briones; Jor-el Thomas Caparas,4,0,36,32
1658042718536,MATH 20B,A02,083757,Briones; Jor-el Thomas Caparas,1,0,36,35
1658042718536,MATH 20B,A03,093475,Briones; Jor-el Thomas Caparas,3,0,36,33
1658042724565,MATH 20C,A01,083760,Briones; Jor-el Thomas Caparas,1,0,35,34
1658042724565,MATH 20C,A02,083761,Briones; Jor-el Thomas Caparas,8,0,35,27
1658042724565,MATH 20C,A03,093476,Briones; Jor-el Thomas Caparas,0,1,36,36
1658042724565,MATH 20C,B01,083762,Bach; Quang Tran,1,0,30,29
1658042730588,MATH 20D,A01,083765,Tran; Brian Kha,5,0,30,25
1658042730588,MATH 20D,A02,083766,Tran; Brian Kha,5,0,30,25
1658042730588,MATH 20D,A03,083767,Tran; Brian Kha,6,0,30,24
1658042736611,MATH 20E,A01,083771,Ganguly; Soumya,12,0,32,20
1658042736611,MATH 20E,A02,083772,Ganguly; Soumya,7,0,32,25
1658042736611,MATH 20E,B01,083773,Ciotti; Benjamin,20,0,35,15
1658042736611,MATH 20E,B02,083774,Ciotti; Benjamin,18,0,35,17
1658042742634,MATH 103A,A01,083777,Greenfeld; Be'Eri,6,0,36,30
1658042742634,MATH 103A,A02,083778,Greenfeld; Be'Eri,5,0,36,31
1658042742634,MATH 103A,A03,093561,Greenfeld; Be'Eri,7,0,36,29
1658042742634,MATH 103A,B01,083779,Greenfeld; Be'Eri,8,0,36,28
1658042742634,MATH 103A,B02,083780,Greenfeld; Be'Eri,4,0,36,32
1658042742634,MATH 103A,B03,093562,Greenfeld; Be'Eri,3,0,36,33
1658042748657,MATH 105,A01,085443,Carter; Anne Toulson,15,0,35,20
1658042748657,MATH 105,A02,093477,Carter; Anne Toulson,20,0,35,15
1658042754686,MATH 109,A01,083213,Ganzberger; Geoffrey Michael,3,0,34,31
1658042754686,MATH 109,A02,083214,Ganzberger; Geoffrey Michael,4,0,34,30
1658042754686,MATH 109,A03,093478,Ganzberger; Geoffrey Michael,2,0,34,32
1658042754686,MATH 109,B01,083215,Ganzberger; Geoffrey Michael,3,0,32,29
1658042754686,MATH 109,B02,083216,Ganzberger; Geoffrey Michael,3,0,32,29
1658042754686,MATH 109,B03,093479,Ganzberger; Geoffrey Michael,8,0,32,24
1658042760710,MATH 142A,A01,083219,Chow; Bennett,7,0,32,25
1658042760710,MATH 142A,A02,083220,Chow; Bennett,10,0,32,22
1658042760710,MATH 142A,A03,093480,Chow; Bennett,9,0,32,23
1658042760710,MATH 142A,B03,093481,Chow; Bennett,8,0,32,24
1658042760710,MATH 142A,B04,093558,Chow; Bennett,14,0,32,18
1658042760710,MATH 142A,B05,093559,Chow; Bennett,7,0,32,25
1658042766738,MATH 193A,A01,083224,Rotar; Vladimir,9,0,34,25
1658042766738,MATH 193A,A02,083225,Rotar; Vladimir,11,0,34,23
1658042766738,MATH 193A,A03,083781,Rotar; Vladimir,5,0,34,29
1658042766738,MATH 193A,A04,083782,Rotar; Vladimir,12,0,34,22
1658042766738,MATH 193A,A05,093482,Rotar; Vladimir,11,0,34,23
1658042772761,MATH 197,001,091859,McAuley; Julian John,9999,0,9999,0
1658042772761,MATH 197,002,095566,Kedlaya; Kiran S.,9997,0,9999,2
1658042772761,MATH 197,003,095567,Xiao; Ming,9999,0,9999,0
1658042772761,MATH 197,004,095571,Perols; Johan Lars,9998,0,9999,1
1658042779814,COGS 9,A01,083615,Shannon; Kyle Michael,11,0,75,64
1658042785839,COGS 11,A01,083617,Boyle; Mary E. T.,23,0,48,25
1658042791865,COGS 13,A01,083071,Bastos; Amalia Pinkusfeld,12,0,71,59
1658042797889,COGS 14A,A01,092681,Semenuks; Arturs,5,1,100,95
1658042803914,COGS 14B,A01,083073,Cheng; Tzu-Han,7,0,63,56
1658042809937,COGS 17,A01,092677,Semenuks; Arturs,7,0,81,74
1658042815966,COGS 100,A01,083619,Allen; Michael Gordon,17,0,70,53
1658042821994,COGS 101A,A01,083621,Davis; Joshua Daniel,9,0,68,59
1658042828017,COGS 101B,A01,091572,Allen; Michael Gordon,14,0,65,51
1658042834043,COGS 101C,A01,083625,Delgado; Tania,17,0,35,18
1658042840070,COGS 107A,A01,083627,Boyle; Mary E. T.,14,0,60,46
1658042846093,COGS 118A,A01,083075,Gupta; Anjum,21,0,76,55
1658042852124,CSE 3,A50,083646,Miranda; Gregory Joseph,24,0,50,26
1658042858149,CSE 8A,A50,083650,Miranda; Gregory Joseph,17,1,56,39
1658042864175,CSE 11,A01,083080,Cao; Yingjun,7,15,40,33
1658042870202,CSE 12,A01,083652,Krause-Levy; Sophia Louisa,30,1,120,90
1658042876234,CSE 15L,A01,083654,Morris; Justin Loren,9,0,50,41
1658042876234,CSE 15L,A02,083655,Morris; Justin Loren,11,0,50,39
1658042882256,CSE 20,A01,083657,Tran; Khoa Dang,39,0,80,41
1658042888279,CSE 21,A01,095574,Bach; Quang Tran,23,0,48,25
1658042894306,CSE 30,A01,083084,Eldon; John,8,0,80,72
1658042894306,CSE 30,B01,095061,Bhaskar; Nishant,9,0,50,41
1658042900336,CSE 100,A01,083659,Cao; Yingjun,5,4,70,65
1658042906358,CSE 134B,A01,083661,Powell; Thomas Allan,25,0,100,75
1658042912454,CSE 140,A01,083663,Gungor; Onat,17,0,85,68
1658042918480,CSE 140L,A01,083088,Eldon; John,23,0,100,77
1658042924512,CSE 175,A01,083665,Kumar; Rakesh,3,0,25,22
1658042930539,CSE 190,A00,092507,Dubnov; Shlomo,8,0,20,12
1658042936562,ECE 45,A01,083139,Congero; Spencer William,7,0,75,68
1658042942591,ECE 65,A50,083695,Saad; Andrew S,12,0,30,18
1658042942591,ECE 65,A51,095125,Saad; Andrew S,24,0,26,2
1658042948612,ECE 109,A01,091882,Touri; Behrouz,21,0,70,49
1658042954638,ECE 180,A00,083140,Abi Samra; Nicholas Camill,1,0,30,29
1658042954638,ECE 180,B00,083141,Abi Samra; Nicholas Camill,0,0,30,30
1658042960659,MATH 10A,A01,083735,Patchell; Gregory David,2,0,30,28
1658042960659,MATH 10A,A02,083736,Patchell; Gregory David,20,0,30,10
1658042960659,MATH 10A,A03,083737,Patchell; Gregory David,16,0,30,14
1658042966692,MATH 10B,A01,083207,Lim; Seonhee,9,0,34,25
1658042966692,MATH 10B,A02,083208,Lim; Seonhee,10,0,35,25
1658042966692,MATH 10B,A03,093472,Lim; Seonhee,7,0,34,27
1658042966692,MATH 10B,B01,083739,Sinha; Shubham,14,0,30,16
1658042972715,MATH 18,A01,083743,Cinel; Cameron Alexander,9,0,30,21
1658042972715,MATH 18,A02,083744,Cinel; Cameron Alexander,18,0,30,12
1658042972715,MATH 18,A03,083745,Cinel; Cameron Alexander,10,0,30,20
1658042972715,MATH 18,B01,083748,Rideout; David Porter,5,0,37,32
1658042972715,MATH 18,B02,083749,Rideout; David Porter,5,0,36,31
1658042972715,MATH 18,B03,083750,Rideout; David Porter,3,0,37,34
1658042972715,MATH 18,B04,083751,Rideout; David Porter,7,0,36,29
1658042972715,MATH 18,B05,093473,Rideout; David Porter,7,0,36,29
1658042972715,MATH 18,B06,093474,Rideout; David Porter,6,0,36,30
1658042978745,MATH 20A,A01,083754,Zheng; Zequn,14,0,40,26
1658042984772,MATH 20B,A01,083756,Briones; Jor-el Thomas Caparas,4,0,36,32
1658042984772,MATH 20B,A02,083757,Briones; Jor-el Thomas Caparas,1,0,36,35
1658042984772,MATH 20B,A03,093475,Briones; Jor-el Thomas Caparas,3,0,36,33
1658042990800,MATH 20C,A01,083760,Briones; Jor-el Thomas Caparas,1,0,35,34
1658042990800,MATH 20C,A02,083761,Briones; Jor-el Thomas Caparas,8,0,35,27
1658042990800,MATH 20C,A03,093476,Briones; Jor-el Thomas Caparas,0,1,36,36
1658042990800,MATH 20C,B01,083762,Bach; Quang Tran,1,0,30,29
1658042996829,MATH 20D,A01,083765,Tran; Brian Kha,5,0,30,25
1658042996829,MATH 20D,A02,083766,Tran; Brian Kha,5,0,30,25
1658042996829,MATH 20D,A03,083767,Tran; Brian Kha,6,0,30,24
1658043002856,MATH 20E,A01,083771,Ganguly; Soumya,12,0,32,20
1658043002856,MATH 20E,A02,083772,Ganguly; Soumya,7,0,32,25
1658043002856,MATH 20E,B01,083773,Ciotti; Benjamin,20,0,35,15
1658043002856,MATH 20E,B02,083774,Ciotti; Benjamin,18,0,35,17
1658043008879,MATH 103A,A01,083777,Greenfeld; Be'Eri,6,0,36,30
1658043008879,MATH 103A,A02,083778,Greenfeld; Be'Eri,5,0,36,31
1658043008879,MATH 103A,A03,093561,Greenfeld; Be'Eri,7,0,36,29
1658043008879,MATH 103A,B01,083779,Greenfeld; Be'Eri,8,0,36,28
1658043008879,MATH 103A,B02,083780,Greenfeld; Be'Eri,4,0,36,32
1658043008879,MATH 103A,B03,093562,Greenfeld; Be'Eri,3,0,36,33
1658043014911,MATH 105,A01,085443,Carter; Anne Toulson,15,0,35,20
1658043014911,MATH 105,A02,093477,Carter; Anne Toulson,20,0,35,15
1658043020934,MATH 109,A01,083213,Ganzberger; Geoffrey Michael,3,0,34,31
1658043020934,MATH 109,A02,083214,Ganzberger; Geoffrey Michael,4,0,34,30
1658043020934,MATH 109,A03,093478,Ganzberger; Geoffrey Michael,2,0,34,32
1658043020934,MATH 109,B01,083215,Ganzberger; Geoffrey Michael,3,0,32,29
1658043020934,MATH 109,B02,083216,Ganzberger; Geoffrey Michael,3,0,32,29
1658043020934,MATH 109,B03,093479,Ganzberger; Geoffrey Michael,8,0,32,24
1658043026957,MATH 142A,A01,083219,Chow; Bennett,7,0,32,25
1658043026957,MATH 142A,A02,083220,Chow; Bennett,10,0,32,22
1658043026957,MATH 142A,A03,093480,Chow; Bennett,9,0,32,23
1658043026957,MATH 142A,B03,093481,Chow; Bennett,8,0,32,24
1658043026957,MATH 142A,B04,093558,Chow; Bennett,14,0,32,18
1658043026957,MATH 142A,B05,093559,Chow; Bennett,7,0,32,25
1658043032981,MATH 193A,A01,083224,Rotar; Vladimir,9,0,34,25
1658043032981,MATH 193A,A02,083225,Rotar; Vladimir,11,0,34,23
1658043032981,MATH 193A,A03,083781,Rotar; Vladimir,5,0,34,29
1658043032981,MATH 193A,A04,083782,Rotar; Vladimir,12,0,34,22
1658043032981,MATH 193A,A05,093482,Rotar; Vladimir,11,0,34,23
1658043039005,MATH 197,001,091859,McAuley; Julian John,9999,0,9999,0
1658043039005,MATH 197,002,095566,Kedlaya; Kiran S.,9997,0,9999,2
1658043039005,MATH 197,003,095567,Xiao; Ming,9999,0,9999,0
1658043039005,MATH 197,004,095571,Perols; Johan Lars,9998,0,9999,1
1658043046062,COGS 9,A01,083615,Shannon; Kyle Michael,11,0,75,64
1658043052085,COGS 11,A01,083617,Boyle; Mary E. T.,23,0,48,25
1658043058109,COGS 13,A01,083071,Bastos; Amalia Pinkusfeld,12,0,71,59
1658043064131,COGS 14A,A01,092681,Semenuks; Arturs,5,1,100,95
1658043070153,COGS 14B,A01,083073,Cheng; Tzu-Han,7,0,63,56
1658043076175,COGS 17,A01,092677,Semenuks; Arturs,7,0,81,74
1658043082200,COGS 100,A01,083619,Allen; Michael Gordon,17,0,70,53
1658043088221,COGS 101A,A01,083621,Davis; Joshua Daniel,9,0,68,59
1658043094247,COGS 101B,A01,091572,Allen; Michael Gordon,14,0,65,51
1658043100271,COGS 101C,A01,083625,Delgado; Tania,17,0,35,18
1658043106296,COGS 107A,A01,083627,Boyle; Mary E. T.,14,0,60,46
1658043112322,COGS 118A,A01,083075,Gupta; Anjum,21,0,76,55
1658043118355,CSE 3,A50,083646,Miranda; Gregory Joseph,24,0,50,26
1658043124378,CSE 8A,A50,083650,Miranda; Gregory Joseph,17,1,56,39
1658043130402,CSE 11,A01,083080,Cao; Yingjun,7,15,40,33
1658043136425,CSE 12,A01,083652,Krause-Levy; Sophia Louisa,30,1,120,90
1658043142451,CSE 15L,A01,083654,Morris; Justin Loren,9,0,50,41
1658043142451,CSE 15L,A02,083655,Morris; Justin Loren,11,0,50,39
1658043148474,CSE 20,A01,083657,Tran; Khoa Dang,39,0,80,41
1658043154501,CSE 21,A01,095574,Bach; Quang Tran,23,0,48,25
1658043160536,CSE 30,A01,083084,Eldon; John,8,0,80,72
1658043160536,CSE 30,B01,095061,Bhaskar; Nishant,9,0,50,41
1658043166600,CSE 100,A01,083659,Cao; Yingjun,5,4,70,65
1658043172636,CSE 134B,A01,083661,Powell; Thomas Allan,25,0,100,75
1658043178664,CSE 140,A01,083663,Gungor; Onat,17,0,85,68
1658043184690,CSE 140L,A01,083088,Eldon; John,23,0,100,77
1658043190720,CSE 175,A01,083665,Kumar; Rakesh,3,0,25,22
1658043196742,CSE 190,A00,092507,Dubnov; Shlomo,8,0,20,12
1658043202786,ECE 45,A01,083139,Congero; Spencer William,7,0,75,68
1658043208811,ECE 65,A50,083695,Saad; Andrew S,12,0,30,18
1658043208811,ECE 65,A51,095125,Saad; Andrew S,24,0,26,2
1658043214840,ECE 109,A01,091882,Touri; Behrouz,21,0,70,49
1658043220864,ECE 180,A00,083140,Abi Samra; Nicholas Camill,1,0,30,29
1658043220864,ECE 180,B00,083141,Abi Samra; Nicholas Camill,0,0,30,30
1658043226896,MATH 10A,A01,083735,Patchell; Gregory David,2,0,30,28
1658043226896,MATH 10A,A02,083736,Patchell; Gregory David,20,0,30,10
1658043226896,MATH 10A,A03,083737,Patchell; Gregory David,16,0,30,14
1658043232923,MATH 10B,A01,083207,Lim; Seonhee,9,0,34,25
1658043232923,MATH 10B,A02,083208,Lim; Seonhee,10,0,35,25
1658043232923,MATH 10B,A03,093472,Lim; Seonhee,7,0,34,27
1658043232923,MATH 10B,B01,083739,Sinha; Shubham,14,0,30,16
1658043238952,MATH 18,A01,083743,Cinel; Cameron Alexander,9,0,30,21
1658043238952,MATH 18,A02,083744,Cinel; Cameron Alexander,18,0,30,12
1658043238952,MATH 18,A03,083745,Cinel; Cameron Alexander,10,0,30,20
1658043238952,MATH 18,B01,083748,Rideout; David Porter,5,0,37,32
1658043238952,MATH 18,B02,083749,Rideout; David Porter,5,0,36,31
1658043238952,MATH 18,B03,083750,Rideout; David Porter,3,0,37,34
1658043238952,MATH 18,B04,083751,Rideout; David Porter,7,0,36,29
1658043238952,MATH 18,B05,093473,Rideout; David Porter,7,0,36,29
1658043238952,MATH 18,B06,093474,Rideout; David Porter,6,0,36,30
1658043244979,MATH 20A,A01,083754,Zheng; Zequn,14,0,40,26
1658043251000,MATH 20B,A01,083756,Briones; Jor-el Thomas Caparas,4,0,36,32
1658043251000,MATH 20B,A02,083757,Briones; Jor-el Thomas Caparas,1,0,36,35
1658043251000,MATH 20B,A03,093475,Briones; Jor-el Thomas Caparas,3,0,36,33
1658043257023,MATH 20C,A01,083760,Briones; Jor-el Thomas Caparas,1,0,35,34
1658043257023,MATH 20C,A02,083761,Briones; Jor-el Thomas Caparas,8,0,35,27
1658043257023,MATH 20C,A03,093476,Briones; Jor-el Thomas Caparas,0,1,36,36
1658043257023,MATH 20C,B01,083762,Bach; Quang Tran,1,0,30,29
1658043263046,MATH 20D,A01,083765,Tran; Brian Kha,5,0,30,25
1658043263046,MATH 20D,A02,083766,Tran; Brian Kha,5,0,30,25
1658043263046,MATH 20D,A03,083767,Tran; Brian Kha,6,0,30,24
1658043269069,MATH 20E,A01,083771,Ganguly; Soumya,12,0,32,20
1658043269069,MATH 20E,A02,083772,Ganguly; Soumya,7,0,32,25
1658043269069,MATH 20E,B01,083773,Ciotti; Benjamin,20,0,35,15
1658043269069,MATH 20E,B02,083774,Ciotti; Benjamin,18,0,35,17
1658043275092,MATH 103A,A01,083777,Greenfeld; Be'Eri,6,0,36,30
1658043275092,MATH 103A,A02,083778,Greenfeld; Be'Eri,5,0,36,31
1658043275092,MATH 103A,A03,093561,Greenfeld; Be'Eri,7,0,36,29
1658043275092,MATH 103A,B01,083779,Greenfeld; Be'Eri,8,0,36,28
1658043275092,MATH 103A,B02,083780,Greenfeld; Be'Eri,4,0,36,32
1658043275092,MATH 103A,B03,093562,Greenfeld; Be'Eri,3,0,36,33
1658043281115,MATH 105,A01,085443,Carter; Anne Toulson,15,0,35,20
1658043281115,MATH 105,A02,093477,Carter; Anne Toulson,20,0,35,15
1658043287143,MATH 109,A01,083213,Ganzberger; Geoffrey Michael,3,0,34,31
1658043287143,MATH 109,A02,083214,Ganzberger; Geoffrey Michael,4,0,34,30
1658043287143,MATH 109,A03,093478,Ganzberger; Geoffrey Michael,2,0,34,32
1658043287143,MATH 109,B01,083215,Ganzberger; Geoffrey Michael,3,0,32,29
1658043287143,MATH 109,B02,083216,Ganzberger; Geoffrey Michael,3,0,32,29
1658043287143,MATH 109,B03,093479,Ganzberger; Geoffrey Michael,8,0,32,24
1658043293166,MATH 142A,A01,083219,Chow; Bennett,7,0,32,25
1658043293166,MATH 142A,A02,083220,Chow; Bennett,10,0,32,22
1658043293166,MATH 142A,A03,093480,Chow; Bennett,9,0,32,23
1658043293166,MATH 142A,B03,093481,Chow; Bennett,8,0,32,24
1658043293166,MATH 142A,B04,093558,Chow; Bennett,14,0,32,18
1658043293166,MATH 142A,B05,093559,Chow; Bennett,7,0,32,25
1658043299190,MATH 193A,A01,083224,Rotar; Vladimir,9,0,34,25
1658043299190,MATH 193A,A02,083225,Rotar; Vladimir,11,0,34,23
1658043299190,MATH 193A,A03,083781,Rotar; Vladimir,5,0,34,29
1658043299190,MATH 193A,A04,083782,Rotar; Vladimir,12,0,34,22
1658043299190,MATH 193A,A05,093482,Rotar; Vladimir,11,0,34,23
1658043305212,MATH 197,001,091859,McAuley; Julian John,9999,0,9999,0
1658043305212,MATH 197,002,095566,Kedlaya; Kiran S.,9997,0,9999,2
1658043305212,MATH 197,003,095567,Xiao; Ming,9999,0,9999,0
1658043305212,MATH 197,004,095571,Perols; Johan Lars,9998,0,9999,1
1658043312272,COGS 9,A01,083615,Shannon; Kyle Michael,11,0,75,64
1658043318299,COGS 11,A01,083617,Boyle; Mary E. T.,23,0,48,25
1658043324328,COGS 13,A01,083071,Bastos; Amalia Pinkusfeld,12,0,71,59
1658043330351,COGS 14A,A01,092681,Semenuks; Arturs,5,1,100,95
1658043336378,COGS 14B,A01,083073,Cheng; Tzu-Han,7,0,63,56
1658043342405,COGS 17,A01,092677,Semenuks; Arturs,7,0,81,74
1658043348446,COGS 100,A01,083619,Allen; Michael Gordon,17,0,70,53
1658043354469,COGS 101A,A01,083621,Davis; Joshua Daniel,9,0,68,59
1658043360494,COGS 101B,A01,091572,Allen; Michael Gordon,14,0,65,51
1658043366516,COGS 101C,A01,083625,Delgado; Tania,17,0,35,18
1658043372542,COGS 107A,A01,083627,Boyle; Mary E. T.,14,0,60,46
1658043378570,COGS 118A,A01,083075,Gupta; Anjum,21,0,76,55
1658043384597,CSE 3,A50,083646,Miranda; Gregory Joseph,24,0,50,26
1658043390624,CSE 8A,A50,083650,Miranda; Gregory Joseph,17,1,56,39
1658043396654,CSE 11,A01,083080,Cao; Yingjun,7,15,40,33
1658043402679,CSE 12,A01,083652,Krause-Levy; Sophia Louisa,30,1,120,90
1658043408706,CSE 15L,A01,083654,Morris; Justin Loren,9,0,50,41
1658043408706,CSE 15L,A02,083655,Morris; Justin Loren,11,0,50,39
1658043414735,CSE 20,A01,083657,Tran; Khoa Dang,39,0,80,41
1658043420763,CSE 21,A01,095574,Bach; Quang Tran,23,0,48,25
1658043426787,CSE 30,A01,083084,Eldon; John,8,0,80,72
1658043426787,CSE 30,B01,095061,Bhaskar; Nishant,9,0,50,41
1658043432812,CSE 100,A01,083659,Cao; Yingjun,5,4,70,65
1658043438836,CSE 134B,A01,083661,Powell; Thomas Allan,25,0,100,75
1658043444861,CSE 140,A01,083663,Gungor; Onat,17,0,85,68
1658043450886,CSE 140L,A01,083088,Eldon; John,23,0,100,77
1658043456908,CSE 175,A01,083665,Kumar; Rakesh,3,0,25,22
1658043462936,CSE 190,A00,092507,Dubnov; Shlomo,8,0,20,12
1658043468971,ECE 45,A01,083139,Congero; Spencer William,7,0,75,68
1658043475005,ECE 65,A50,083695,Saad; Andrew S,12,0,30,18
1658043475005,ECE 65,A51,095125,Saad; Andrew S,24,0,26,2
1658043481030,ECE 109,A01,091882,Touri; Behrouz,21,0,70,49
1658043487056,ECE 180,A00,083140,Abi Samra; Nicholas Camill,1,0,30,29
1658043487056,ECE 180,B00,083141,Abi Samra; Nicholas Camill,0,0,30,30
1658043493082,MATH 10A,A01,083735,Patchell; Gregory David,2,0,30,28
1658043493082,MATH 10A,A02,083736,Patchell; Gregory David,20,0,30,10
1658043493082,MATH 10A,A03,083737,Patchell; Gregory David,16,0,30,14
1658043499118,MATH 10B,A01,083207,Lim; Seonhee,9,0,34,25
1658043499118,MATH 10B,A02,083208,Lim; Seonhee,10,0,35,25
1658043499118,MATH 10B,A03,093472,Lim; Seonhee,7,0,34,27
1658043499118,MATH 10B,B01,083739,Sinha; Shubham,14,0,30,16
1658043505143,MATH 18,A01,083743,Cinel; Cameron Alexander,9,0,30,21
1658043505143,MATH 18,A02,083744,Cinel; Cameron Alexander,18,0,30,12
1658043505143,MATH 18,A03,083745,Cinel; Cameron Alexander,10,0,30,20
1658043505143,MATH 18,B01,083748,Rideout; David Porter,5,0,37,32
1658043505143,MATH 18,B02,083749,Rideout; David Porter,5,0,36,31
1658043505143,MATH 18,B03,083750,Rideout; David Porter,3,0,37,34
1658043505143,MATH 18,B04,083751,Rideout; David Porter,7,0,36,29
1658043505143,MATH 18,B05,093473,Rideout; David Porter,7,0,36,29
1658043505143,MATH 18,B06,093474,Rideout; David Porter,6,0,36,30
1658043511254,MATH 20A,A01,083754,Zheng; Zequn,14,0,40,26
1658043517279,MATH 20B,A01,083756,Briones; Jor-el Thomas Caparas,4,0,36,32
1658043517279,MATH 20B,A02,083757,Briones; Jor-el Thomas Caparas,1,0,36,35
1658043517279,MATH 20B,A03,093475,Briones; Jor-el Thomas Caparas,3,0,36,33
1658043523301,MATH 20C,A01,083760,Briones; Jor-el Thomas Caparas,1,0,35,34
1658043523301,MATH 20C,A02,083761,Briones; Jor-el Thomas Caparas,8,0,35,27
1658043523301,MATH 20C,A03,093476,Briones; Jor-el Thomas Caparas,0,1,36,36
1658043523301,MATH 20C,B01,083762,Bach; Quang Tran,1,0,30,29
1658043529327,MATH 20D,A01,083765,Tran; Brian Kha,5,0,30,25
1658043529327,MATH 20D,A02,083766,Tran; Brian Kha,5,0,30,25
1658043529327,MATH 20D,A03,083767,Tran; Brian Kha,6,0,30,24
1658043535350,MATH 20E,A01,083771,Ganguly; Soumya,12,0,32,20
1658043535350,MATH 20E,A02,083772,Ganguly; Soumya,7,0,32,25
1658043535350,MATH 20E,B01,083773,Ciotti; Benjamin,20,0,35,15
1658043535350,MATH 20E,B02,083774,Ciotti; Benjamin,18,0,35,17
1658043541373,MATH 103A,A01,083777,Greenfeld; Be'Eri,6,0,36,30
1658043541373,MATH 103A,A02,083778,Greenfeld; Be'Eri,5,0,36,31
1658043541373,MATH 103A,A03,093561,Greenfeld; Be'Eri,7,0,36,29
1658043541373,MATH 103A,B01,083779,Greenfeld; Be'Eri,8,0,36,28
1658043541373,MATH 103A,B02,083780,Greenfeld; Be'Eri,4,0,36,32
1658043541373,MATH 103A,B03,093562,Greenfeld; Be'Eri,3,0,36,33
1658043547396,MATH 105,A01,085443,Carter; Anne Toulson,15,0,35,20
1658043547396,MATH 105,A02,093477,Carter; Anne Toulson,20,0,35,15
1658043553418,MATH 109,A01,083213,Ganzberger; Geoffrey Michael,3,0,34,31
1658043553418,MATH 109,A02,083214,Ganzberger; Geoffrey Michael,4,0,34,30
1658043553418,MATH 109,A03,093478,Ganzberger; Geoffrey Michael,2,0,34,32
1658043553418,MATH 109,B01,083215,Ganzberger; Geoffrey Michael,3,0,32,29
1658043553418,MATH 109,B02,083216,Ganzberger; Geoffrey Michael,3,0,32,29
1658043553418,MATH 109,B03,093479,Ganzberger; Geoffrey Michael,8,0,32,24
1658043559439,MATH 142A,A01,083219,Chow; Bennett,7,0,32,25
1658043559439,MATH 142A,A02,083220,Chow; Bennett,10,0,32,22
1658043559439,MATH 142A,A03,093480,Chow; Bennett,9,0,32,23
1658043559439,MATH 142A,B03,093481,Chow; Bennett,8,0,32,24
1658043559439,MATH 142A,B04,093558,Chow; Bennett,14,0,32,18
1658043559439,MATH 142A,B05,093559,Chow; Bennett,7,0,32,25
1658043565469,MATH 193A,A01,083224,Rotar; Vladimir,9,0,34,25
1658043565469,MATH 193A,A02,083225,Rotar; Vladimir,11,0,34,23
1658043565469,MATH 193A,A03,083781,Rotar; Vladimir,5,0,34,29
1658043565469,MATH 193A,A04,083782,Rotar; Vladimir,12,0,34,22
1658043565469,MATH 193A,A05,093482,Rotar; Vladimir,11,0,34,23
1658043571491,MATH 197,001,091859,McAuley; Julian John,9999,0,9999,0
1658043571491,MATH 197,002,095566,Kedlaya; Kiran S.,9997,0,9999,2
1658043571491,MATH 197,003,095567,Xiao; Ming,9999,0,9999,0
1658043571491,MATH 197,004,095571,Perols; Johan Lars,9998,0,9999,1
1658043578542,COGS 9,A01,083615,Shannon; Kyle Michael,11,0,75,64
1658043584564,COGS 11,A01,083617,Boyle; Mary E. T.,23,0,48,25
1658043590592,COGS 13,A01,083071,Bastos; Amalia Pinkusfeld,12,0,71,59
1658043596618,COGS 14A,A01,092681,Semenuks; Arturs,5,1,100,95
1658043602652,COGS 14B,A01,083073,Cheng; Tzu-Han,7,0,63,56
1658043608675,COGS 17,A01,092677,Semenuks; Arturs,7,0,81,74
1658043614700,COGS 100,A01,083619,Allen; Michael Gordon,17,0,70,53
1658043620722,COGS 101A,A01,083621,Davis; Joshua Daniel,9,0,68,59
1658043626745,COGS 101B,A01,091572,Allen; Michael Gordon,14,0,65,51
1658043632767,COGS 101C,A01,083625,Delgado; Tania,17,0,35,18
1658043638788,COGS 107A,A01,083627,Boyle; Mary E. T.,14,0,60,46
1658043644811,COGS 118A,A01,083075,Gupta; Anjum,21,0,76,55
1658043650834,CSE 3,A50,083646,Miranda; Gregory Joseph,24,0,50,26
1658043656868,CSE 8A,A50,083650,Miranda; Gregory Joseph,17,1,56,39
1658043662892,CSE 11,A01,083080,Cao; Yingjun,7,15,40,33
1658043668918,CSE 12,A01,083652,Krause-Levy; Sophia Louisa,30,1,120,90
1658043674941,CSE 15L,A01,083654,Morris; Justin Loren,9,0,50,41
1658043674941,CSE 15L,A02,083655,Morris; Justin Loren,11,0,50,39
1658043680967,CSE 20,A01,083657,Tran; Khoa Dang,39,0,80,41
1658043686989,CSE 21,A01,095574,Bach; Quang Tran,23,0,48,25
1658043693013,CSE 30,A01,083084,Eldon; John,8,0,80,72
1658043693013,CSE 30,B01,095061,Bhaskar; Nishant,9,0,50,41
1658043699040,CSE 100,A01,083659,Cao; Yingjun,5,4,70,65
1658043705062,CSE 134B,A01,083661,Powell; Thomas Allan,25,0,100,75
1658043711088,CSE 140,A01,083663,Gungor; Onat,17,0,85,68
1658043717110,CSE 140L,A01,083088,Eldon; John,23,0,100,77
1658043723133,CSE 175,A01,083665,Kumar; Rakesh,3,0,25,22
1658043729156,CSE 190,A00,092507,Dubnov; Shlomo,8,0,20,12
1658043735179,ECE 45,A01,083139,Congero; Spencer William,7,0,75,68
1658043741206,ECE 65,A50,083695,Saad; Andrew S,12,0,30,18
1658043741206,ECE 65,A51,095125,Saad; Andrew S,24,0,26,2
1658043747233,ECE 109,A01,091882,Touri; Behrouz,21,0,70,49
1658043753257,ECE 180,A00,083140,Abi Samra; Nicholas Camill,1,0,30,29
1658043753257,ECE 180,B00,083141,Abi Samra; Nicholas Camill,0,0,30,30
1658043759278,MATH 10A,A01,083735,Patchell; Gregory David,2,0,30,28
1658043759278,MATH 10A,A02,083736,Patchell; Gregory David,20,0,30,10
1658043759278,MATH 10A,A03,083737,Patchell; Gregory David,16,0,30,14
1658043765303,MATH 10B,A01,083207,Lim; Seonhee,9,0,34,25
1658043765303,MATH 10B,A02,083208,Lim; Seonhee,10,0,35,25
1658043765303,MATH 10B,A03,093472,Lim; Seonhee,7,0,34,27
1658043765303,MATH 10B,B01,083739,Sinha; Shubham,14,0,30,16
1658043771334,MATH 18,A01,083743,Cinel; Cameron Alexander,9,0,30,21
1658043771334,MATH 18,A02,083744,Cinel; Cameron Alexander,18,0,30,12
1658043771334,MATH 18,A03,083745,Cinel; Cameron Alexander,10,0,30,20
1658043771334,MATH 18,B01,083748,Rideout; David Porter,5,0,37,32
1658043771334,MATH 18,B02,083749,Rideout; David Porter,5,0,36,31
1658043771334,MATH 18,B03,083750,Rideout; David Porter,3,0,37,34
1658043771334,MATH 18,B04,083751,Rideout; David Porter,7,0,36,29
1658043771334,MATH 18,B05,093473,Rideout; David Porter,7,0,36,29
1658043771334,MATH 18,B06,093474,Rideout; David Porter,6,0,36,30
1658043777356,MATH 20A,A01,083754,Zheng; Zequn,14,0,40,26
1658043783384,MATH 20B,A01,083756,Briones; Jor-el Thomas Caparas,4,0,36,32
1658043783384,MATH 20B,A02,083757,Briones; Jor-el Thomas Caparas,1,0,36,35
1658043783384,MATH 20B,A03,093475,Briones; Jor-el Thomas Caparas,3,0,36,33
1658043789418,MATH 20C,A01,083760,Briones; Jor-el Thomas Caparas,1,0,35,34
1658043789418,MATH 20C,A02,083761,Briones; Jor-el Thomas Caparas,8,0,35,27
1658043789418,MATH 20C,A03,093476,Briones; Jor-el Thomas Caparas,0,1,36,36
1658043789418,MATH 20C,B01,083762,Bach; Quang Tran,1,0,30,29
1658043795440,MATH 20D,A01,083765,Tran; Brian Kha,5,0,30,25
1658043795440,MATH 20D,A02,083766,Tran; Brian Kha,5,0,30,25
1658043795440,MATH 20D,A03,083767,Tran; Brian Kha,6,0,30,24
1658043801467,MATH 20E,A01,083771,Ganguly; Soumya,12,0,32,20
1658043801467,MATH 20E,A02,083772,Ganguly; Soumya,7,0,32,25
1658043801467,MATH 20E,B01,083773,Ciotti; Benjamin,20,0,35,15
1658043801467,MATH 20E,B02,083774,Ciotti; Benjamin,18,0,35,17
1658043807491,MATH 103A,A01,083777,Greenfeld; Be'Eri,6,0,36,30
1658043807491,MATH 103A,A02,083778,Greenfeld; Be'Eri,5,0,36,31
1658043807491,MATH 103A,A03,093561,Greenfeld; Be'Eri,7,0,36,29
1658043807491,MATH 103A,B01,083779,Greenfeld; Be'Eri,8,0,36,28
1658043807491,MATH 103A,B02,083780,Greenfeld; Be'Eri,4,0,36,32
1658043807491,MATH 103A,B03,093562,Greenfeld; Be'Eri,3,0,36,33
1658043813514,MATH 105,A01,085443,Carter; Anne Toulson,15,0,35,20
1658043813514,MATH 105,A02,093477,Carter; Anne Toulson,20,0,35,15
1658043819537,MATH 109,A01,083213,Ganzberger; Geoffrey Michael,3,0,34,31
1658043819537,MATH 109,A02,083214,Ganzberger; Geoffrey Michael,4,0,34,30
1658043819537,MATH 109,A03,093478,Ganzberger; Geoffrey Michael,2,0,34,32
1658043819537,MATH 109,B01,083215,Ganzberger; Geoffrey Michael,3,0,32,29
1658043819537,MATH 109,B02,083216,Ganzberger; Geoffrey Michael,3,0,32,29
1658043819537,MATH 109,B03,093479,Ganzberger; Geoffrey Michael,8,0,32,24
1658043825566,MATH 142A,A01,083219,Chow; Bennett,7,0,32,25
1658043825566,MATH 142A,A02,083220,Chow; Bennett,10,0,32,22
1658043825566,MATH 142A,A03,093480,Chow; Bennett,9,0,32,23
1658043825566,MATH 142A,B03,093481,Chow; Bennett,8,0,32,24
1658043825566,MATH 142A,B04,093558,Chow; Bennett,14,0,32,18
1658043825566,MATH 142A,B05,093559,Chow; Bennett,7,0,32,25
1658043831594,MATH 193A,A01,083224,Rotar; Vladimir,9,0,34,25
1658043831594,MATH 193A,A02,083225,Rotar; Vladimir,11,0,34,23
1658043831594,MATH 193A,A03,083781,Rotar; Vladimir,5,0,34,29
1658043831594,MATH 193A,A04,083782,Rotar; Vladimir,12,0,34,22
1658043831594,MATH 193A,A05,093482,Rotar; Vladimir,11,0,34,23
1658043837617,MATH 197,001,091859,McAuley; Julian John,9999,0,9999,0
1658043837617,MATH 197,002,095566,Kedlaya; Kiran S.,9997,0,9999,2
1658043837617,MATH 197,003,095567,Xiao; Ming,9999,0,9999,0
1658043837617,MATH 197,004,095571,Perols; Johan Lars,9998,0,9999,1
1658043844675,COGS 9,A01,083615,Shannon; Kyle Michael,11,0,75,64
1658043850698,COGS 11,A01,083617,Boyle; Mary E. T.,23,0,48,25
1658043856721,COGS 13,A01,083071,Bastos; Amalia Pinkusfeld,12,0,71,59
1658043862759,COGS 14A,A01,092681,Semenuks; Arturs,5,1,100,95
1658043868781,COGS 14B,A01,083073,Cheng; Tzu-Han,7,0,63,56
1658043874806,COGS 17,A01,092677,Semenuks; Arturs,7,0,81,74
1658043880828,COGS 100,A01,083619,Allen; Michael Gordon,17,0,70,53
1658043886853,COGS 101A,A01,083621,Davis; Joshua Daniel,9,0,68,59
1658043892876,COGS 101B,A01,091572,Allen; Michael Gordon,14,0,65,51
1658043898898,COGS 101C,A01,083625,Delgado; Tania,17,0,35,18
1658043904936,COGS 107A,A01,083627,Boyle; Mary E. T.,14,0,60,46
1658043910957,COGS 118A,A01,083075,Gupta; Anjum,21,0,76,55
1658043916979,CSE 3,A50,083646,Miranda; Gregory Joseph,24,0,50,26
1658043923007,CSE 8A,A50,083650,Miranda; Gregory Joseph,17,1,56,39
1658043929030,CSE 11,A01,083080,Cao; Yingjun,7,15,40,33
1658043935056,CSE 12,A01,083652,Krause-Levy; Sophia Louisa,30,1,120,90
1658043941080,CSE 15L,A01,083654,Morris; Justin Loren,9,0,50,41
1658043941080,CSE 15L,A02,083655,Morris; Justin Loren,11,0,50,39
1658043947103,CSE 20,A01,083657,Tran; Khoa Dang,39,0,80,41
1658043953125,CSE 21,A01,095574,Bach; Quang Tran,23,0,48,25
1658043959148,CSE 30,A01,083084,Eldon; John,8,0,80,72
1658043959148,CSE 30,B01,095061,Bhaskar; Nishant,9,0,50,41
1658043965170,CSE 100,A01,083659,Cao; Yingjun,5,4,70,65
1658043971196,CSE 134B,A01,083661,Powell; Thomas Allan,25,0,100,75
1658043977222,CSE 140,A01,083663,Gungor; Onat,17,0,85,68
1658043983248,CSE 140L,A01,083088,Eldon; John,23,0,100,77
1658043989273,CSE 175,A01,083665,Kumar; Rakesh,3,0,25,22
1658043995299,CSE 190,A00,092507,Dubnov; Shlomo,8,0,20,12
1658044001323,ECE 45,A01,083139,Congero; Spencer William,7,0,75,68
1658044007347,ECE 65,A50,083695,Saad; Andrew S,12,0,30,18
1658044007347,ECE 65,A51,095125,Saad; Andrew S,24,0,26,2
1658044013370,ECE 109,A01,091882,Touri; Behrouz,21,0,70,49
1658044019397,ECE 180,A00,083140,Abi Samra; Nicholas Camill,1,0,30,29
1658044019397,ECE 180,B00,083141,Abi Samra; Nicholas Camill,0,0,30,30
1658044025424,MATH 10A,A01,083735,Patchell; Gregory David,2,0,30,28
1658044025424,MATH 10A,A02,083736,Patchell; Gregory David,20,0,30,10
1658044025424,MATH 10A,A03,083737,Patchell; Gregory David,16,0,30,14
1658044031448,MATH 10B,A01,083207,Lim; Seonhee,9,0,34,25
1658044031448,MATH 10B,A02,083208,Lim; Seonhee,10,0,35,25
1658044031448,MATH 10B,A03,093472,Lim; Seonhee,7,0,34,27
1658044031448,MATH 10B,B01,083739,Sinha; Shubham,14,0,30,16
1658044037471,MATH 18,A01,083743,Cinel; Cameron Alexander,9,0,30,21
1658044037471,MATH 18,A02,083744,Cinel; Cameron Alexander,18,0,30,12
1658044037471,MATH 18,A03,083745,Cinel; Cameron Alexander,10,0,30,20
1658044037471,MATH 18,B01,083748,Rideout; David Porter,5,0,37,32
1658044037471,MATH 18,B02,083749,Rideout; David Porter,5,0,36,31
1658044037471,MATH 18,B03,083750,Rideout; David Porter,3,0,37,34
1658044037471,MATH 18,B04,083751,Rideout; David Porter,7,0,36,29
1658044037471,MATH 18,B05,093473,Rideout; David Porter,7,0,36,29
1658044037471,MATH 18,B06,093474,Rideout; David Porter,6,0,36,30
1658044043497,MATH 20A,A01,083754,Zheng; Zequn,14,0,40,26
1658044049520,MATH 20B,A01,083756,Briones; Jor-el Thomas Caparas,4,0,36,32
1658044049520,MATH 20B,A02,083757,Briones; Jor-el Thomas Caparas,1,0,36,35
1658044049520,MATH 20B,A03,093475,Briones; Jor-el Thomas Caparas,3,0,36,33
1658044055548,MATH 20C,A01,083760,Briones; Jor-el Thomas Caparas,1,0,35,34
1658044055548,MATH 20C,A02,083761,Briones; Jor-el Thomas Caparas,8,0,35,27
1658044055548,MATH 20C,A03,093476,Briones; Jor-el Thomas Caparas,0,1,36,36
1658044055548,MATH 20C,B01,083762,Bach; Quang Tran,1,0,30,29
1658044061570,MATH 20D,A01,083765,Tran; Brian Kha,5,0,30,25
1658044061570,MATH 20D,A02,083766,Tran; Brian Kha,5,0,30,25
1658044061570,MATH 20D,A03,083767,Tran; Brian Kha,6,0,30,24
1658044067598,MATH 20E,A01,083771,Ganguly; Soumya,12,0,32,20
1658044067598,MATH 20E,A02,083772,Ganguly; Soumya,7,0,32,25
1658044067598,MATH 20E,B01,083773,Ciotti; Benjamin,20,0,35,15
1658044067598,MATH 20E,B02,083774,Ciotti; Benjamin,18,0,35,17
1658044073627,MATH 103A,A01,083777,Greenfeld; Be'Eri,6,0,36,30
1658044073627,MATH 103A,A02,083778,Greenfeld; Be'Eri,5,0,36,31
1658044073627,MATH 103A,A03,093561,Greenfeld; Be'Eri,7,0,36,29
1658044073627,MATH 103A,B01,083779,Greenfeld; Be'Eri,8,0,36,28
1658044073627,MATH 103A,B02,083780,Greenfeld; Be'Eri,4,0,36,32
1658044073627,MATH 103A,B03,093562,Greenfeld; Be'Eri,3,0,36,33
1658044079655,MATH 105,A01,085443,Carter; Anne Toulson,15,0,35,20
1658044079655,MATH 105,A02,093477,Carter; Anne Toulson,20,0,35,15
1658044085680,MATH 109,A01,083213,Ganzberger; Geoffrey Michael,3,0,34,31
1658044085680,MATH 109,A02,083214,Ganzberger; Geoffrey Michael,4,0,34,30
1658044085680,MATH 109,A03,093478,Ganzberger; Geoffrey Michael,2,0,34,32
1658044085680,MATH 109,B01,083215,Ganzberger; Geoffrey Michael,3,0,32,29
1658044085680,MATH 109,B02,083216,Ganzberger; Geoffrey Michael,3,0,32,29
1658044085680,MATH 109,B03,093479,Ganzberger; Geoffrey Michael,8,0,32,24
1658044091717,MATH 142A,A01,083219,Chow; Bennett,7,0,32,25
1658044091717,MATH 142A,A02,083220,Chow; Bennett,10,0,32,22
1658044091717,MATH 142A,A03,093480,Chow; Bennett,9,0,32,23
1658044091717,MATH 142A,B03,093481,Chow; Bennett,8,0,32,24
1658044091717,MATH 142A,B04,093558,Chow; Bennett,14,0,32,18
1658044091717,MATH 142A,B05,093559,Chow; Bennett,7,0,32,25
1658044097741,MATH 193A,A01,083224,Rotar; Vladimir,9,0,34,25
1658044097741,MATH 193A,A02,083225,Rotar; Vladimir,11,0,34,23
1658044097741,MATH 193A,A03,083781,Rotar; Vladimir,5,0,34,29
1658044097741,MATH 193A,A04,083782,Rotar; Vladimir,12,0,34,22
1658044097741,MATH 193A,A05,093482,Rotar; Vladimir,11,0,34,23
1658044103768,MATH 197,001,091859,McAuley; Julian John,9999,0,9999,0
1658044103768,MATH 197,002,095566,Kedlaya; Kiran S.,9997,0,9999,2
1658044103768,MATH 197,003,095567,Xiao; Ming,9999,0,9999,0
1658044103768,MATH 197,004,095571,Perols; Johan Lars,9998,0,9999,1
1658044110906,COGS 9,A01,083615,Shannon; Kyle Michael,11,0,75,64
1658044116928,COGS 11,A01,083617,Boyle; Mary E. T.,23,0,48,25
1658044122952,COGS 13,A01,083071,Bastos; Amalia Pinkusfeld,12,0,71,59
1658044128979,COGS 14A,A01,092681,Semenuks; Arturs,5,1,100,95
1658044135005,COGS 14B,A01,083073,Cheng; Tzu-Han,7,0,63,56
1658044141032,COGS 17,A01,092677,Semenuks; Arturs,7,0,81,74
1658044147057,COGS 100,A01,083619,Allen; Michael Gordon,17,0,70,53
1658044153081,COGS 101A,A01,083621,Davis; Joshua Daniel,9,0,68,59
1658044159103,COGS 101B,A01,091572,Allen; Michael Gordon,14,0,65,51
1658044165135,COGS 101C,A01,083625,Delgado; Tania,17,0,35,18
1658044171162,COGS 107A,A01,083627,Boyle; Mary E. T.,14,0,60,46
1658044177184,COGS 118A,A01,083075,Gupta; Anjum,21,0,76,55
1658044183207,CSE 3,A50,083646,Miranda; Gregory Joseph,24,0,50,26
1658044189229,CSE 8A,A50,083650,Miranda; Gregory Joseph,17,1,56,39
1658044195256,CSE 11,A01,083080,Cao; Yingjun,7,15,40,33
1658044201280,CSE 12,A01,083652,Krause-Levy; Sophia Louisa,30,1,120,90
1658044207311,CSE 15L,A01,083654,Morris; Justin Loren,9,0,50,41
1658044207311,CSE 15L,A02,083655,Morris; Justin Loren,11,0,50,39
1658044213337,CSE 20,A01,083657,Tran; Khoa Dang,39,0,80,41
1658044219361,CSE 21,A01,095574,Bach; Quang Tran,23,0,48,25
1658044225394,CSE 30,A01,083084,Eldon; John,8,0,80,72
1658044225394,CSE 30,B01,095061,Bhaskar; Nishant,9,0,50,41
1658044231417,CSE 100,A01,083659,Cao; Yingjun,5,4,70,65
1658044237440,CSE 134B,A01,083661,Powell; Thomas Allan,25,0,100,75
1658044243466,CSE 140,A01,083663,Gungor; Onat,17,0,85,68
1658044249489,CSE 140L,A01,083088,Eldon; John,23,0,100,77
1658044255522,CSE 175,A01,083665,Kumar; Rakesh,3,0,25,22
1658044261548,CSE 190,A00,092507,Dubnov; Shlomo,8,0,20,12
1658044267575,ECE 45,A01,083139,Congero; Spencer William,7,0,75,68
1658044273598,ECE 65,A50,083695,Saad; Andrew S,12,0,30,18
1658044273598,ECE 65,A51,095125,Saad; Andrew S,24,0,26,2
1658044279621,ECE 109,A01,091882,Touri; Behrouz,21,0,70,49
1658044285650,ECE 180,A00,083140,Abi Samra; Nicholas Camill,1,0,30,29
1658044285650,ECE 180,B00,083141,Abi Samra; Nicholas Camill,0,0,30,30
1658044291676,MATH 10A,A01,083735,Patchell; Gregory David,2,0,30,28
1658044291676,MATH 10A,A02,083736,Patchell; Gregory David,20,0,30,10
1658044291676,MATH 10A,A03,083737,Patchell; Gregory David,16,0,30,14
1658044297698,MATH 10B,A01,083207,Lim; Seonhee,9,0,34,25
1658044297698,MATH 10B,A02,083208,Lim; Seonhee,10,0,35,25
1658044297698,MATH 10B,A03,093472,Lim; Seonhee,7,0,34,27
1658044297698,MATH 10B,B01,083739,Sinha; Shubham,14,0,30,16
1658044303723,MATH 18,A01,083743,Cinel; Cameron Alexander,9,0,30,21
1658044303723,MATH 18,A02,083744,Cinel; Cameron Alexander,18,0,30,12
1658044303723,MATH 18,A03,083745,Cinel; Cameron Alexander,10,0,30,20
1658044303723,MATH 18,B01,083748,Rideout; David Porter,5,0,37,32
1658044303723,MATH 18,B02,083749,Rideout; David Porter,5,0,36,31
1658044303723,MATH 18,B03,083750,Rideout; David Porter,3,0,37,34
1658044303723,MATH 18,B04,083751,Rideout; David Porter,7,0,36,29
1658044303723,MATH 18,B05,093473,Rideout; David Porter,7,0,36,29
1658044303723,MATH 18,B06,093474,Rideout; David Porter,6,0,36,30
1658044309751,MATH 20A,A01,083754,Zheng; Zequn,14,0,40,26
1658044315779,MATH 20B,A01,083756,Briones; Jor-el Thomas Caparas,4,0,36,32
1658044315779,MATH 20B,A02,083757,Briones; Jor-el Thomas Caparas,1,0,36,35
1658044315779,MATH 20B,A03,093475,Briones; Jor-el Thomas Caparas,3,0,36,33
1658044321803,MATH 20C,A01,083760,Briones; Jor-el Thomas Caparas,1,0,35,34
1658044321803,MATH 20C,A02,083761,Briones; Jor-el Thomas Caparas,8,0,35,27
1658044321803,MATH 20C,A03,093476,Briones; Jor-el Thomas Caparas,0,1,36,36
1658044321803,MATH 20C,B01,083762,Bach; Quang Tran,1,0,30,29
1658044327825,MATH 20D,A01,083765,Tran; Brian Kha,5,0,30,25
1658044327825,MATH 20D,A02,083766,Tran; Brian Kha,5,0,30,25
1658044327825,MATH 20D,A03,083767,Tran; Brian Kha,6,0,30,24
1658044333847,MATH 20E,A01,083771,Ganguly; Soumya,12,0,32,20
1658044333847,MATH 20E,A02,083772,Ganguly; Soumya,7,0,32,25
1658044333847,MATH 20E,B01,083773,Ciotti; Benjamin,20,0,35,15
1658044333847,MATH 20E,B02,083774,Ciotti; Benjamin,18,0,35,17
1658044339869,MATH 103A,A01,083777,Greenfeld; Be'Eri,6,0,36,30
1658044339869,MATH 103A,A02,083778,Greenfeld; Be'Eri,5,0,36,31
1658044339869,MATH 103A,A03,093561,Greenfeld; Be'Eri,7,0,36,29
1658044339869,MATH 103A,B01,083779,Greenfeld; Be'Eri,8,0,36,28
1658044339869,MATH 103A,B02,083780,Greenfeld; Be'Eri,4,0,36,32
1658044339869,MATH 103A,B03,093562,Greenfeld; Be'Eri,3,0,36,33
1658044345893,MATH 105,A01,085443,Carter; Anne Toulson,15,0,35,20
1658044345893,MATH 105,A02,093477,Carter; Anne Toulson,20,0,35,15
1658044351917,MATH 109,A01,083213,Ganzberger; Geoffrey Michael,3,0,34,31
1658044351917,MATH 109,A02,083214,Ganzberger; Geoffrey Michael,4,0,34,30
1658044351917,MATH 109,A03,093478,Ganzberger; Geoffrey Michael,2,0,34,32
1658044351917,MATH 109,B01,083215,Ganzberger; Geoffrey Michael,3,0,32,29
1658044351917,MATH 109,B02,083216,Ganzberger; Geoffrey Michael,3,0,32,29
1658044351917,MATH 109,B03,093479,Ganzberger; Geoffrey Michael,8,0,32,24
1658044357946,MATH 142A,A01,083219,Chow; Bennett,7,0,32,25
1658044357946,MATH 142A,A02,083220,Chow; Bennett,10,0,32,22
1658044357946,MATH 142A,A03,093480,Chow; Bennett,9,0,32,23
1658044357946,MATH 142A,B03,093481,Chow; Bennett,8,0,32,24
1658044357946,MATH 142A,B04,093558,Chow; Bennett,14,0,32,18
1658044357946,MATH 142A,B05,093559,Chow; Bennett,7,0,32,25
1658044363969,MATH 193A,A01,083224,Rotar; Vladimir,9,0,34,25
1658044363969,MATH 193A,A02,083225,Rotar; Vladimir,11,0,34,23
1658044363969,MATH 193A,A03,083781,Rotar; Vladimir,5,0,34,29
1658044363969,MATH 193A,A04,083782,Rotar; Vladimir,12,0,34,22
1658044363969,MATH 193A,A05,093482,Rotar; Vladimir,11,0,34,23
1658044369996,MATH 197,001,091859,McAuley; Julian John,9999,0,9999,0
1658044369996,MATH 197,002,095566,Kedlaya; Kiran S.,9997,0,9999,2
1658044369996,MATH 197,003,095567,Xiao; Ming,9999,0,9999,0
1658044369996,MATH 197,004,095571,Perols; Johan Lars,9998,0,9999,1
1658044377052,COGS 9,A01,083615,Shannon; Kyle Michael,11,0,75,64
1658044383077,COGS 11,A01,083617,Boyle; Mary E. T.,23,0,48,25
1658044389100,COGS 13,A01,083071,Bastos; Amalia Pinkusfeld,12,0,71,59
1658044395123,COGS 14A,A01,092681,Semenuks; Arturs,5,1,100,95
1658044401145,COGS 14B,A01,083073,Cheng; Tzu-Han,7,0,63,56
1658044407167,COGS 17,A01,092677,Semenuks; Arturs,7,0,81,74
1658044413189,COGS 100,A01,083619,Allen; Michael Gordon,17,0,70,53
1658044419215,COGS 101A,A01,083621,Davis; Joshua Daniel,9,0,68,59
1658044425237,COGS 101B,A01,091572,Allen; Michael Gordon,14,0,65,51
1658044431264,COGS 101C,A01,083625,Delgado; Tania,17,0,35,18
1658044437286,COGS 107A,A01,083627,Boyle; Mary E. T.,14,0,60,46
1658044443312,COGS 118A,A01,083075,Gupta; Anjum,21,0,76,55
1658044449346,CSE 3,A50,083646,Miranda; Gregory Joseph,24,0,50,26
1658044455374,CSE 8A,A50,083650,Miranda; Gregory Joseph,17,1,56,39
1658044461397,CSE 11,A01,083080,Cao; Yingjun,7,15,40,33
1658044467419,CSE 12,A01,083652,Krause-Levy; Sophia Louisa,30,1,120,90
1658044473444,CSE 15L,A01,083654,Morris; Justin Loren,9,0,50,41
1658044473444,CSE 15L,A02,083655,Morris; Justin Loren,11,0,50,39
1658044479466,CSE 20,A01,083657,Tran; Khoa Dang,39,0,80,41
1658044485492,CSE 21,A01,095574,Bach; Quang Tran,23,0,48,25
1658044491513,CSE 30,A01,083084,Eldon; John,8,0,80,72
1658044491513,CSE 30,B01,095061,Bhaskar; Nishant,9,0,50,41
1658044497537,CSE 100,A01,083659,Cao; Yingjun,5,4,70,65
1658044503559,CSE 134B,A01,083661,Powell; Thomas Allan,25,0,100,75
1658044509582,CSE 140,A01,083663,Gungor; Onat,17,0,85,68
1658044515609,CSE 140L,A01,083088,Eldon; John,23,0,100,77
1658044521631,CSE 175,A01,083665,Kumar; Rakesh,3,0,25,22
1658044527653,CSE 190,A00,092507,Dubnov; Shlomo,8,0,20,12
1658044533677,ECE 45,A01,083139,Congero; Spencer William,7,0,75,68
1658044539700,ECE 65,A50,083695,Saad; Andrew S,12,0,30,18
1658044539700,ECE 65,A51,095125,Saad; Andrew S,24,0,26,2
1658044545724,ECE 109,A01,091882,Touri; Behrouz,21,0,70,49
1658044551758,ECE 180,A00,083140,Abi Samra; Nicholas Camill,1,0,30,29
1658044551758,ECE 180,B00,083141,Abi Samra; Nicholas Camill,0,0,30,30
1658044557787,MATH 10A,A01,083735,Patchell; Gregory David,2,0,30,28
1658044557787,MATH 10A,A02,083736,Patchell; Gregory David,20,0,30,10
1658044557787,MATH 10A,A03,083737,Patchell; Gregory David,16,0,30,14
1658044563810,MATH 10B,A01,083207,Lim; Seonhee,9,0,34,25
1658044563810,MATH 10B,A02,083208,Lim; Seonhee,10,0,35,25
1658044563810,MATH 10B,A03,093472,Lim; Seonhee,7,0,34,27
1658044563810,MATH 10B,B01,083739,Sinha; Shubham,14,0,30,16
1658044569843,MATH 18,A01,083743,Cinel; Cameron Alexander,9,0,30,21
1658044569843,MATH 18,A02,083744,Cinel; Cameron Alexander,18,0,30,12
1658044569843,MATH 18,A03,083745,Cinel; Cameron Alexander,10,0,30,20
1658044569843,MATH 18,B01,083748,Rideout; David Porter,5,0,37,32
1658044569843,MATH 18,B02,083749,Rideout; David Porter,5,0,36,31
1658044569843,MATH 18,B03,083750,Rideout; David Porter,3,0,37,34
1658044569843,MATH 18,B04,083751,Rideout; David Porter,7,0,36,29
1658044569843,MATH 18,B05,093473,Rideout; David Porter,7,0,36,29
1658044569843,MATH 18,B06,093474,Rideout; David Porter,6,0,36,30
1658044575865,MATH 20A,A01,083754,Zheng; Zequn,14,0,40,26
1658044581891,MATH 20B,A01,083756,Briones; Jor-el Thomas Caparas,4,0,36,32
1658044581891,MATH 20B,A02,083757,Briones; Jor-el Thomas Caparas,1,0,36,35
1658044581891,MATH 20B,A03,093475,Briones; Jor-el Thomas Caparas,3,0,36,33
1658044587918,MATH 20C,A01,083760,Briones; Jor-el Thomas Caparas,1,0,35,34
1658044587918,MATH 20C,A02,083761,Briones; Jor-el Thomas Caparas,8,0,35,27
1658044587918,MATH 20C,A03,093476,Briones; Jor-el Thomas Caparas,0,1,36,36
1658044587918,MATH 20C,B01,083762,Bach; Quang Tran,1,0,30,29
1658044593942,MATH 20D,A01,083765,Tran; Brian Kha,5,0,30,25
1658044593942,MATH 20D,A02,083766,Tran; Brian Kha,5,0,30,25
1658044593942,MATH 20D,A03,083767,Tran; Brian Kha,6,0,30,24
1658044599965,MATH 20E,A01,083771,Ganguly; Soumya,12,0,32,20
1658044599965,MATH 20E,A02,083772,Ganguly; Soumya,7,0,32,25
1658044599965,MATH 20E,B01,083773,Ciotti; Benjamin,20,0,35,15
1658044599965,MATH 20E,B02,083774,Ciotti; Benjamin,18,0,35,17
1658044605994,MATH 103A,A01,083777,Greenfeld; Be'Eri,6,0,36,30
1658044605994,MATH 103A,A02,083778,Greenfeld; Be'Eri,5,0,36,31
1658044605994,MATH 103A,A03,093561,Greenfeld; Be'Eri,7,0,36,29
1658044605994,MATH 103A,B01,083779,Greenfeld; Be'Eri,8,0,36,28
1658044605994,MATH 103A,B02,083780,Greenfeld; Be'Eri,4,0,36,32
1658044605994,MATH 103A,B03,093562,Greenfeld; Be'Eri,3,0,36,33
1658044612017,MATH 105,A01,085443,Carter; Anne Toulson,15,0,35,20
1658044612017,MATH 105,A02,093477,Carter; Anne Toulson,20,0,35,15
1658044618043,MATH 109,A01,083213,Ganzberger; Geoffrey Michael,3,0,34,31
1658044618043,MATH 109,A02,083214,Ganzberger; Geoffrey Michael,4,0,34,30
1658044618043,MATH 109,A03,093478,Ganzberger; Geoffrey Michael,2,0,34,32
1658044618043,MATH 109,B01,083215,Ganzberger; Geoffrey Michael,3,0,32,29
1658044618043,MATH 109,B02,083216,Ganzberger; Geoffrey Michael,3,0,32,29
1658044618043,MATH 109,B03,093479,Ganzberger; Geoffrey Michael,8,0,32,24
1658044624073,MATH 142A,A01,083219,Chow; Bennett,7,0,32,25
1658044624073,MATH 142A,A02,083220,Chow; Bennett,10,0,32,22
1658044624073,MATH 142A,A03,093480,Chow; Bennett,9,0,32,23
1658044624073,MATH 142A,B03,093481,Chow; Bennett,8,0,32,24
1658044624073,MATH 142A,B04,093558,Chow; Bennett,14,0,32,18
1658044624073,MATH 142A,B05,093559,Chow; Bennett,7,0,32,25
1658044630101,MATH 193A,A01,083224,Rotar; Vladimir,9,0,34,25
1658044630101,MATH 193A,A02,083225,Rotar; Vladimir,11,0,34,23
1658044630101,MATH 193A,A03,083781,Rotar; Vladimir,5,0,34,29
1658044630101,MATH 193A,A04,083782,Rotar; Vladimir,12,0,34,22
1658044630101,MATH 193A,A05,093482,Rotar; Vladimir,11,0,34,23
1658044636125,MATH 197,001,091859,McAuley; Julian John,9999,0,9999,0
1658044636125,MATH 197,002,095566,Kedlaya; Kiran S.,9997,0,9999,2
1658044636125,MATH 197,003,095567,Xiao; Ming,9999,0,9999,0
1658044636125,MATH 197,004,095571,Perols; Johan Lars,9998,0,9999,1
1658044643196,COGS 9,A01,083615,Shannon; Kyle Michael,11,0,75,64
1658044649223,COGS 11,A01,083617,Boyle; Mary E. T.,23,0,48,25
1658044655249,COGS 13,A01,083071,Bastos; Amalia Pinkusfeld,12,0,71,59
1658044661274,COGS 14A,A01,092681,Semenuks; Arturs,5,1,100,95
1658044667300,COGS 14B,A01,083073,Cheng; Tzu-Han,7,0,63,56
1658044673333,COGS 17,A01,092677,Semenuks; Arturs,7,0,81,74
1658044679359,COGS 100,A01,083619,Allen; Michael Gordon,17,0,70,53
1658044685383,COGS 101A,A01,083621,Davis; Joshua Daniel,9,0,68,59
1658044691408,COGS 101B,A01,091572,Allen; Michael Gordon,14,0,65,51
1658044697431,COGS 101C,A01,083625,Delgado; Tania,17,0,35,18
1658044703545,COGS 107A,A01,083627,Boyle; Mary E. T.,14,0,60,46
1658044709568,COGS 118A,A01,083075,Gupta; Anjum,21,0,76,55
1658044715595,CSE 3,A50,083646,Miranda; Gregory Joseph,24,0,50,26
1658044721618,CSE 8A,A50,083650,Miranda; Gregory Joseph,17,1,56,39
1658044727639,CSE 11,A01,083080,Cao; Yingjun,7,15,40,33
1658044733661,CSE 12,A01,083652,Krause-Levy; Sophia Louisa,30,1,120,90
1658044739696,CSE 15L,A01,083654,Morris; Justin Loren,9,0,50,41
1658044739696,CSE 15L,A02,083655,Morris; Justin Loren,11,0,50,39
1658044745722,CSE 20,A01,083657,Tran; Khoa Dang,39,0,80,41
1658044751757,CSE 21,A01,095574,Bach; Quang Tran,23,0,48,25
1658044757786,CSE 30,A01,083084,Eldon; John,8,0,80,72
1658044757786,CSE 30,B01,095061,Bhaskar; Nishant,9,0,50,41
1658044763810,CSE 100,A01,083659,Cao; Yingjun,5,4,70,65
1658044769833,CSE 134B,A01,083661,Powell; Thomas Allan,25,0,100,75
1658044775859,CSE 140,A01,083663,Gungor; Onat,17,0,85,68
1658044781885,CSE 140L,A01,083088,Eldon; John,23,0,100,77
1658044787912,CSE 175,A01,083665,Kumar; Rakesh,3,0,25,22
1658044793938,CSE 190,A00,092507,Dubnov; Shlomo,8,0,20,12
1658044799960,ECE 45,A01,083139,Congero; Spencer William,7,0,75,68
1658044805988,ECE 65,A50,083695,Saad; Andrew S,12,0,30,18
1658044805988,ECE 65,A51,095125,Saad; Andrew S,24,0,26,2
1658044812013,ECE 109,A01,091882,Touri; Behrouz,21,0,70,49
1658044818035,ECE 180,A00,083140,Abi Samra; Nicholas Camill,1,0,30,29
1658044818035,ECE 180,B00,083141,Abi Samra; Nicholas Camill,0,0,30,30
1658044824062,MATH 10A,A01,083735,Patchell; Gregory David,2,0,30,28
1658044824062,MATH 10A,A02,083736,Patchell; Gregory David,20,0,30,10
1658044824062,MATH 10A,A03,083737,Patchell; Gregory David,16,0,30,14
1658044830089,MATH 10B,A01,083207,Lim; Seonhee,9,0,34,25
1658044830089,MATH 10B,A02,083208,Lim; Seonhee,10,0,35,25
1658044830089,MATH 10B,A03,093472,Lim; Seonhee,7,0,34,27
1658044830089,MATH 10B,B01,083739,Sinha; Shubham,14,0,30,16
1658044836140,MATH 18,A01,083743,Cinel; Cameron Alexander,9,0,30,21
1658044836140,MATH 18,A02,083744,Cinel; Cameron Alexander,18,0,30,12
1658044836140,MATH 18,A03,083745,Cinel; Cameron Alexander,10,0,30,20
1658044836140,MATH 18,B01,083748,Rideout; David Porter,5,0,37,32
1658044836140,MATH 18,B02,083749,Rideout; David Porter,5,0,36,31
1658044836140,MATH 18,B03,083750,Rideout; David Porter,3,0,37,34
1658044836140,MATH 18,B04,083751,Rideout; David Porter,7,0,36,29
1658044836140,MATH 18,B05,093473,Rideout; David Porter,7,0,36,29
1658044836140,MATH 18,B06,093474,Rideout; David Porter,6,0,36,30
1658044842163,MATH 20A,A01,083754,Zheng; Zequn,14,0,40,26
1658044848196,MATH 20B,A01,083756,Briones; Jor-el Thomas Caparas,4,0,36,32
1658044848196,MATH 20B,A02,083757,Briones; Jor-el Thomas Caparas,1,0,36,35
1658044848196,MATH 20B,A03,093475,Briones; Jor-el Thomas Caparas,3,0,36,33
1658044854226,MATH 20C,A01,083760,Briones; Jor-el Thomas Caparas,1,0,35,34
1658044854226,MATH 20C,A02,083761,Briones; Jor-el Thomas Caparas,8,0,35,27
1658044854226,MATH 20C,A03,093476,Briones; Jor-el Thomas Caparas,0,1,36,36
1658044854226,MATH 20C,B01,083762,Bach; Quang Tran,1,0,30,29
1658044860255,MATH 20D,A01,083765,Tran; Brian Kha,5,0,30,25
1658044860255,MATH 20D,A02,083766,Tran; Brian Kha,5,0,30,25
1658044860255,MATH 20D,A03,083767,Tran; Brian Kha,6,0,30,24
1658044866288,MATH 20E,A01,083771,Ganguly; Soumya,12,0,32,20
1658044866288,MATH 20E,A02,083772,Ganguly; Soumya,7,0,32,25
1658044866288,MATH 20E,B01,083773,Ciotti; Benjamin,20,0,35,15
1658044866288,MATH 20E,B02,083774,Ciotti; Benjamin,18,0,35,17
1658044872318,MATH 103A,A01,083777,Greenfeld; Be'Eri,6,0,36,30
1658044872318,MATH 103A,A02,083778,Greenfeld; Be'Eri,5,0,36,31
1658044872318,MATH 103A,A03,093561,Greenfeld; Be'Eri,7,0,36,29
1658044872318,MATH 103A,B01,083779,Greenfeld; Be'Eri,8,0,36,28
1658044872318,MATH 103A,B02,083780,Greenfeld; Be'Eri,4,0,36,32
1658044872318,MATH 103A,B03,093562,Greenfeld; Be'Eri,3,0,36,33
1658044878344,MATH 105,A01,085443,Carter; Anne Toulson,15,0,35,20
1658044878344,MATH 105,A02,093477,Carter; Anne Toulson,20,0,35,15
1658044884368,MATH 109,A01,083213,Ganzberger; Geoffrey Michael,3,0,34,31
1658044884368,MATH 109,A02,083214,Ganzberger; Geoffrey Michael,4,0,34,30
1658044884368,MATH 109,A03,093478,Ganzberger; Geoffrey Michael,2,0,34,32
1658044884368,MATH 109,B01,083215,Ganzberger; Geoffrey Michael,3,0,32,29
1658044884368,MATH 109,B02,083216,Ganzberger; Geoffrey Michael,3,0,32,29
1658044884368,MATH 109,B03,093479,Ganzberger; Geoffrey Michael,8,0,32,24
1658044890391,MATH 142A,A01,083219,Chow; Bennett,7,0,32,25
1658044890391,MATH 142A,A02,083220,Chow; Bennett,10,0,32,22
1658044890391,MATH 142A,A03,093480,Chow; Bennett,9,0,32,23
1658044890391,MATH 142A,B03,093481,Chow; Bennett,8,0,32,24
1658044890391,MATH 142A,B04,093558,Chow; Bennett,14,0,32,18
1658044890391,MATH 142A,B05,093559,Chow; Bennett,7,0,32,25
1658044896419,MATH 193A,A01,083224,Rotar; Vladimir,9,0,34,25
1658044896419,MATH 193A,A02,083225,Rotar; Vladimir,11,0,34,23
1658044896419,MATH 193A,A03,083781,Rotar; Vladimir,5,0,34,29
1658044896419,MATH 193A,A04,083782,Rotar; Vladimir,12,0,34,22
1658044896419,MATH 193A,A05,093482,Rotar; Vladimir,11,0,34,23
1658044902442,MATH 197,001,091859,McAuley; Julian John,9999,0,9999,0
1658044902442,MATH 197,002,095566,Kedlaya; Kiran S.,9997,0,9999,2
1658044902442,MATH 197,003,095567,Xiao; Ming,9999,0,9999,0
1658044902442,MATH 197,004,095571,Perols; Johan Lars,9998,0,9999,1
1658044909497,COGS 9,A01,083615,Shannon; Kyle Michael,11,0,75,64
1658044915518,COGS 11,A01,083617,Boyle; Mary E. T.,23,0,48,25
1658044921544,COGS 13,A01,083071,Bastos; Amalia Pinkusfeld,12,0,71,59
1658044927568,COGS 14A,A01,092681,Semenuks; Arturs,5,1,100,95
1658044933593,COGS 14B,A01,083073,Cheng; Tzu-Han,7,0,63,56
1658044939617,COGS 17,A01,092677,Semenuks; Arturs,7,0,81,74
1658044945639,COGS 100,A01,083619,Allen; Michael Gordon,17,0,70,53
1658044951665,COGS 101A,A01,083621,Davis; Joshua Daniel,9,0,68,59
1658044957687,COGS 101B,A01,091572,Allen; Michael Gordon,14,0,65,51
1658044963721,COGS 101C,A01,083625,Delgado; Tania,17,0,35,18
1658044969743,COGS 107A,A01,083627,Boyle; Mary E. T.,14,0,60,46
1658044975772,COGS 118A,A01,083075,Gupta; Anjum,21,0,76,55
1658044981800,CSE 3,A50,083646,Miranda; Gregory Joseph,24,0,50,26
1658044987824,CSE 8A,A50,083650,Miranda; Gregory Joseph,17,1,56,39
1658044993848,CSE 11,A01,083080,Cao; Yingjun,7,15,40,33
1658044999869,CSE 12,A01,083652,Krause-Levy; Sophia Louisa,30,1,120,90
1658045005893,CSE 15L,A01,083654,Morris; Justin Loren,9,0,50,41
1658045005893,CSE 15L,A02,083655,Morris; Justin Loren,11,0,50,39
1658045011920,CSE 20,A01,083657,Tran; Khoa Dang,39,0,80,41
1658045017945,CSE 21,A01,095574,Bach; Quang Tran,23,0,48,25
1658045023968,CSE 30,A01,083084,Eldon; John,8,0,80,72
1658045023968,CSE 30,B01,095061,Bhaskar; Nishant,9,0,50,41
1658045029991,CSE 100,A01,083659,Cao; Yingjun,5,4,70,65
1658045036014,CSE 134B,A01,083661,Powell; Thomas Allan,25,0,100,75
1658045042040,CSE 140,A01,083663,Gungor; Onat,17,0,85,68
1658045048063,CSE 140L,A01,083088,Eldon; John,23,0,100,77
1658045054084,CSE 175,A01,083665,Kumar; Rakesh,3,0,25,22
1658045060108,CSE 190,A00,092507,Dubnov; Shlomo,8,0,20,12
1658045066131,ECE 45,A01,083139,Congero; Spencer William,7,0,75,68
1658045072157,ECE 65,A50,083695,Saad; Andrew S,12,0,30,18
1658045072157,ECE 65,A51,095125,Saad; Andrew S,24,0,26,2
1658045078182,ECE 109,A01,091882,Touri; Behrouz,21,0,70,49
1658045084208,ECE 180,A00,083140,Abi Samra; Nicholas Camill,1,0,30,29
1658045084208,ECE 180,B00,083141,Abi Samra; Nicholas Camill,0,0,30,30
1658045090231,MATH 10A,A01,083735,Patchell; Gregory David,2,0,30,28
1658045090231,MATH 10A,A02,083736,Patchell; Gregory David,20,0,30,10
1658045090231,MATH 10A,A03,083737,Patchell; Gregory David,16,0,30,14
1658045096258,MATH 10B,A01,083207,Lim; Seonhee,9,0,34,25
1658045096258,MATH 10B,A02,083208,Lim; Seonhee,10,0,35,25
1658045096258,MATH 10B,A03,093472,Lim; Seonhee,7,0,34,27
1658045096258,MATH 10B,B01,083739,Sinha; Shubham,14,0,30,16
1658045102282,MATH 18,A01,083743,Cinel; Cameron Alexander,9,0,30,21
1658045102282,MATH 18,A02,083744,Cinel; Cameron Alexander,18,0,30,12
1658045102282,MATH 18,A03,083745,Cinel; Cameron Alexander,10,0,30,20
1658045102282,MATH 18,B01,083748,Rideout; David Porter,5,0,37,32
1658045102282,MATH 18,B02,083749,Rideout; David Porter,5,0,36,31
1658045102282,MATH 18,B03,083750,Rideout; David Porter,3,0,37,34
1658045102282,MATH 18,B04,083751,Rideout; David Porter,7,0,36,29
1658045102282,MATH 18,B05,093473,Rideout; David Porter,7,0,36,29
1658045102282,MATH 18,B06,093474,Rideout; David Porter,6,0,36,30
1658045108309,MATH 20A,A01,083754,Zheng; Zequn,14,0,40,26
1658045114343,MATH 20B,A01,083756,Briones; Jor-el Thomas Caparas,4,0,36,32
1658045114343,MATH 20B,A02,083757,Briones; Jor-el Thomas Caparas,1,0,36,35
1658045114343,MATH 20B,A03,093475,Briones; Jor-el Thomas Caparas,3,0,36,33
1658045120365,MATH 20C,A01,083760,Briones; Jor-el Thomas Caparas,1,0,35,34
1658045120365,MATH 20C,A02,083761,Briones; Jor-el Thomas Caparas,8,0,35,27
1658045120365,MATH 20C,A03,093476,Briones; Jor-el Thomas Caparas,0,1,36,36
1658045120365,MATH 20C,B01,083762,Bach; Quang Tran,1,0,30,29
1658045126388,MATH 20D,A01,083765,Tran; Brian Kha,5,0,30,25
1658045126388,MATH 20D,A02,083766,Tran; Brian Kha,5,0,30,25
1658045126388,MATH 20D,A03,083767,Tran; Brian Kha,6,0,30,24
1658045132412,MATH 20E,A01,083771,Ganguly; Soumya,12,0,32,20
1658045132412,MATH 20E,A02,083772,Ganguly; Soumya,7,0,32,25
1658045132412,MATH 20E,B01,083773,Ciotti; Benjamin,20,0,35,15
1658045132412,MATH 20E,B02,083774,Ciotti; Benjamin,18,0,35,17
1658045138437,MATH 103A,A01,083777,Greenfeld; Be'Eri,6,0,36,30
1658045138437,MATH 103A,A02,083778,Greenfeld; Be'Eri,5,0,36,31
1658045138437,MATH 103A,A03,093561,Greenfeld; Be'Eri,7,0,36,29
1658045138437,MATH 103A,B01,083779,Greenfeld; Be'Eri,8,0,36,28
1658045138437,MATH 103A,B02,083780,Greenfeld; Be'Eri,4,0,36,32
1658045138437,MATH 103A,B03,093562,Greenfeld; Be'Eri,3,0,36,33
1658045144459,MATH 105,A01,085443,Carter; Anne Toulson,15,0,35,20
1658045144459,MATH 105,A02,093477,Carter; Anne Toulson,20,0,35,15
1658045150491,MATH 109,A01,083213,Ganzberger; Geoffrey Michael,3,0,34,31
1658045150491,MATH 109,A02,083214,Ganzberger; Geoffrey Michael,4,0,34,30
1658045150491,MATH 109,A03,093478,Ganzberger; Geoffrey Michael,2,0,34,32
1658045150491,MATH 109,B01,083215,Ganzberger; Geoffrey Michael,3,0,32,29
1658045150491,MATH 109,B02,083216,Ganzberger; Geoffrey Michael,3,0,32,29
1658045150491,MATH 109,B03,093479,Ganzberger; Geoffrey Michael,8,0,32,24
1658045156514,MATH 142A,A01,083219,Chow; Bennett,7,0,32,25
1658045156514,MATH 142A,A02,083220,Chow; Bennett,10,0,32,22
1658045156514,MATH 142A,A03,093480,Chow; Bennett,9,0,32,23
1658045156514,MATH 142A,B03,093481,Chow; Bennett,8,0,32,24
1658045156514,MATH 142A,B04,093558,Chow; Bennett,14,0,32,18
1658045156514,MATH 142A,B05,093559,Chow; Bennett,7,0,32,25
1658045162536,MATH 193A,A01,083224,Rotar; Vladimir,9,0,34,25
1658045162536,MATH 193A,A02,083225,Rotar; Vladimir,11,0,34,23
1658045162536,MATH 193A,A03,083781,Rotar; Vladimir,5,0,34,29
1658045162536,MATH 193A,A04,083782,Rotar; Vladimir,12,0,34,22
1658045162536,MATH 193A,A05,093482,Rotar; Vladimir,11,0,34,23
1658045168607,MATH 197,001,091859,McAuley; Julian John,9999,0,9999,0
1658045168607,MATH 197,002,095566,Kedlaya; Kiran S.,9997,0,9999,2
1658045168607,MATH 197,003,095567,Xiao; Ming,9999,0,9999,0
1658045168607,MATH 197,004,095571,Perols; Johan Lars,9998,0,9999,1
1658045175669,COGS 9,A01,083615,Shannon; Kyle Michael,11,0,75,64
1658045181696,COGS 11,A01,083617,Boyle; Mary E. T.,23,0,48,25
1658045187724,COGS 13,A01,083071,Bastos; Amalia Pinkusfeld,12,0,71,59
1658045193756,COGS 14A,A01,092681,Semenuks; Arturs,5,1,100,95
1658045199787,COGS 14B,A01,083073,Cheng; Tzu-Han,7,0,63,56
1658045205816,COGS 17,A01,092677,Semenuks; Arturs,7,0,81,74
1658045211843,COGS 100,A01,083619,Allen; Michael Gordon,17,0,70,53
1658045217869,COGS 101A,A01,083621,Davis; Joshua Daniel,9,0,68,59
1658045223895,COGS 101B,A01,091572,Allen; Michael Gordon,14,0,65,51
1658045229919,COGS 101C,A01,083625,Delgado; Tania,17,0,35,18
1658045235945,COGS 107A,A01,083627,Boyle; Mary E. T.,14,0,60,46
1658045241967,COGS 118A,A01,083075,Gupta; Anjum,21,0,76,55
1658045247992,CSE 3,A50,083646,Miranda; Gregory Joseph,24,0,50,26
1658045254023,CSE 8A,A50,083650,Miranda; Gregory Joseph,17,1,56,39
1658045260047,CSE 11,A01,083080,Cao; Yingjun,7,15,40,33
1658045266071,CSE 12,A01,083652,Krause-Levy; Sophia Louisa,30,1,120,90
1658045272093,CSE 15L,A01,083654,Morris; Justin Loren,9,0,50,41
1658045272093,CSE 15L,A02,083655,Morris; Justin Loren,11,0,50,39
1658045278131,CSE 20,A01,083657,Tran; Khoa Dang,39,0,80,41
1658045284155,CSE 21,A01,095574,Bach; Quang Tran,23,0,48,25
1658045290183,CSE 30,A01,083084,Eldon; John,8,0,80,72
1658045290183,CSE 30,B01,095061,Bhaskar; Nishant,9,0,50,41
1658045296209,CSE 100,A01,083659,Cao; Yingjun,5,4,70,65
1658045302309,CSE 134B,A01,083661,Powell; Thomas Allan,25,0,100,75
1658045308332,CSE 140,A01,083663,Gungor; Onat,17,0,85,68
1658045314355,CSE 140L,A01,083088,Eldon; John,23,0,100,77
1658045320378,CSE 175,A01,083665,Kumar; Rakesh,3,0,25,22
1658045326400,CSE 190,A00,092507,Dubnov; Shlomo,8,0,20,12
1658045332427,ECE 45,A01,083139,Congero; Spencer William,7,0,75,68
1658045338458,ECE 65,A50,083695,Saad; Andrew S,12,0,30,18
1658045338458,ECE 65,A51,095125,Saad; Andrew S,24,0,26,2
1658045344480,ECE 109,A01,091882,Touri; Behrouz,21,0,70,49
1658045350506,ECE 180,A00,083140,Abi Samra; Nicholas Camill,1,0,30,29
1658045350506,ECE 180,B00,083141,Abi Samra; Nicholas Camill,0,0,30,30
1658045356537,MATH 10A,A01,083735,Patchell; Gregory David,2,0,30,28
1658045356537,MATH 10A,A02,083736,Patchell; Gregory David,20,0,30,10
1658045356537,MATH 10A,A03,083737,Patchell; Gregory David,16,0,30,14
1658045362559,MATH 10B,A01,083207,Lim; Seonhee,9,0,34,25
1658045362559,MATH 10B,A02,083208,Lim; Seonhee,10,0,35,25
1658045362559,MATH 10B,A03,093472,Lim; Seonhee,7,0,34,27
1658045362559,MATH 10B,B01,083739,Sinha; Shubham,14,0,30,16
1658045368589,MATH 18,A01,083743,Cinel; Cameron Alexander,9,0,30,21
1658045368589,MATH 18,A02,083744,Cinel; Cameron Alexander,18,0,30,12
1658045368589,MATH 18,A03,083745,Cinel; Cameron Alexander,10,0,30,20
1658045368589,MATH 18,B01,083748,Rideout; David Porter,5,0,37,32
1658045368589,MATH 18,B02,083749,Rideout; David Porter,5,0,36,31
1658045368589,MATH 18,B03,083750,Rideout; David Porter,3,0,37,34
1658045368589,MATH 18,B04,083751,Rideout; David Porter,7,0,36,29
1658045368589,MATH 18,B05,093473,Rideout; David Porter,7,0,36,29
1658045368589,MATH 18,B06,093474,Rideout; David Porter,6,0,36,30
1658045374616,MATH 20A,A01,083754,Zheng; Zequn,14,0,40,26
1658045380640,MATH 20B,A01,083756,Briones; Jor-el Thomas Caparas,4,0,36,32
1658045380640,MATH 20B,A02,083757,Briones; Jor-el Thomas Caparas,1,0,36,35
1658045380640,MATH 20B,A03,093475,Briones; Jor-el Thomas Caparas,3,0,36,33
1658045386668,MATH 20C,A01,083760,Briones; Jor-el Thomas Caparas,1,0,35,34
1658045386668,MATH 20C,A02,083761,Briones; Jor-el Thomas Caparas,8,0,35,27
1658045386668,MATH 20C,A03,093476,Briones; Jor-el Thomas Caparas,0,1,36,36
1658045386668,MATH 20C,B01,083762,Bach; Quang Tran,1,0,30,29
1658045392697,MATH 20D,A01,083765,Tran; Brian Kha,5,0,30,25
1658045392697,MATH 20D,A02,083766,Tran; Brian Kha,5,0,30,25
1658045392697,MATH 20D,A03,083767,Tran; Brian Kha,6,0,30,24
1658045398726,MATH 20E,A01,083771,Ganguly; Soumya,12,0,32,20
1658045398726,MATH 20E,A02,083772,Ganguly; Soumya,7,0,32,25
1658045398726,MATH 20E,B01,083773,Ciotti; Benjamin,20,0,35,15
1658045398726,MATH 20E,B02,083774,Ciotti; Benjamin,18,0,35,17
1658045404748,MATH 103A,A01,083777,Greenfeld; Be'Eri,6,0,36,30
1658045404748,MATH 103A,A02,083778,Greenfeld; Be'Eri,5,0,36,31
1658045404748,MATH 103A,A03,093561,Greenfeld; Be'Eri,7,0,36,29
1658045404748,MATH 103A,B01,083779,Greenfeld; Be'Eri,8,0,36,28
1658045404748,MATH 103A,B02,083780,Greenfeld; Be'Eri,4,0,36,32
1658045404748,MATH 103A,B03,093562,Greenfeld; Be'Eri,3,0,36,33
1658045410772,MATH 105,A01,085443,Carter; Anne Toulson,15,0,35,20
1658045410772,MATH 105,A02,093477,Carter; Anne Toulson,20,0,35,15
1658045416799,MATH 109,A01,083213,Ganzberger; Geoffrey Michael,3,0,34,31
1658045416799,MATH 109,A02,083214,Ganzberger; Geoffrey Michael,4,0,34,30
1658045416799,MATH 109,A03,093478,Ganzberger; Geoffrey Michael,2,0,34,32
1658045416799,MATH 109,B01,083215,Ganzberger; Geoffrey Michael,3,0,32,29
1658045416799,MATH 109,B02,083216,Ganzberger; Geoffrey Michael,3,0,32,29
1658045416799,MATH 109,B03,093479,Ganzberger; Geoffrey Michael,8,0,32,24
1658045422824,MATH 142A,A01,083219,Chow; Bennett,7,0,32,25
1658045422824,MATH 142A,A02,083220,Chow; Bennett,10,0,32,22
1658045422824,MATH 142A,A03,093480,Chow; Bennett,9,0,32,23
1658045422824,MATH 142A,B03,093481,Chow; Bennett,8,0,32,24
1658045422824,MATH 142A,B04,093558,Chow; Bennett,14,0,32,18
1658045422824,MATH 142A,B05,093559,Chow; Bennett,7,0,32,25
1658045428847,MATH 193A,A01,083224,Rotar; Vladimir,9,0,34,25
1658045428847,MATH 193A,A02,083225,Rotar; Vladimir,11,0,34,23
1658045428847,MATH 193A,A03,083781,Rotar; Vladimir,5,0,34,29
1658045428847,MATH 193A,A04,083782,Rotar; Vladimir,12,0,34,22
1658045428847,MATH 193A,A05,093482,Rotar; Vladimir,11,0,34,23
1658045434871,MATH 197,001,091859,McAuley; Julian John,9999,0,9999,0
1658045434871,MATH 197,002,095566,Kedlaya; Kiran S.,9997,0,9999,2
1658045434871,MATH 197,003,095567,Xiao; Ming,9999,0,9999,0
1658045434871,MATH 197,004,095571,Perols; Johan Lars,9998,0,9999,1
1658045441924,COGS 9,A01,083615,Shannon; Kyle Michael,11,0,75,64
1658045447945,COGS 11,A01,083617,Boyle; Mary E. T.,23,0,48,25
1658045453970,COGS 13,A01,083071,Bastos; Amalia Pinkusfeld,12,0,71,59
1658045459997,COGS 14A,A01,092681,Semenuks; Arturs,5,1,100,95
1658045466023,COGS 14B,A01,083073,Cheng; Tzu-Han,7,0,63,56
1658045472049,COGS 17,A01,092677,Semenuks; Arturs,7,0,81,74
1658045478075,COGS 100,A01,083619,Allen; Michael Gordon,17,0,70,53
1658045484099,COGS 101A,A01,083621,Davis; Joshua Daniel,9,0,68,59
1658045490126,COGS 101B,A01,091572,Allen; Michael Gordon,14,0,65,51
1658045496152,COGS 101C,A01,083625,Delgado; Tania,17,0,35,18
1658045502173,COGS 107A,A01,083627,Boyle; Mary E. T.,14,0,60,46
1658045508212,COGS 118A,A01,083075,Gupta; Anjum,21,0,76,55
1658045514236,CSE 3,A50,083646,Miranda; Gregory Joseph,24,0,50,26
1658045520267,CSE 8A,A50,083650,Miranda; Gregory Joseph,17,1,56,39
1658045526293,CSE 11,A01,083080,Cao; Yingjun,7,15,40,33
1658045532315,CSE 12,A01,083652,Krause-Levy; Sophia Louisa,30,1,120,90
1658045538338,CSE 15L,A01,083654,Morris; Justin Loren,9,0,50,41
1658045538338,CSE 15L,A02,083655,Morris; Justin Loren,11,0,50,39
1658045544361,CSE 20,A01,083657,Tran; Khoa Dang,39,0,80,41
1658045550387,CSE 21,A01,095574,Bach; Quang Tran,23,0,48,25
1658045556416,CSE 30,A01,083084,Eldon; John,8,0,80,72
1658045556416,CSE 30,B01,095061,Bhaskar; Nishant,9,0,50,41
1658045562440,CSE 100,A01,083659,Cao; Yingjun,5,4,70,65
1658045568468,CSE 134B,A01,083661,Powell; Thomas Allan,25,0,100,75
1658045574492,CSE 140,A01,083663,Gungor; Onat,17,0,85,68
1658045580524,CSE 140L,A01,083088,Eldon; John,23,0,100,77
1658045586547,CSE 175,A01,083665,Kumar; Rakesh,3,0,25,22
1658045592578,CSE 190,A00,092507,Dubnov; Shlomo,8,0,20,12
1658045598605,ECE 45,A01,083139,Congero; Spencer William,7,0,75,68
1658045604634,ECE 65,A50,083695,Saad; Andrew S,12,0,30,18
1658045604634,ECE 65,A51,095125,Saad; Andrew S,24,0,26,2
1658045610656,ECE 109,A01,091882,Touri; Behrouz,21,0,70,49
1658045616683,ECE 180,A00,083140,Abi Samra; Nicholas Camill,1,0,30,29
1658045616683,ECE 180,B00,083141,Abi Samra; Nicholas Camill,0,0,30,30
1658045622708,MATH 10A,A01,083735,Patchell; Gregory David,2,0,30,28
1658045622708,MATH 10A,A02,083736,Patchell; Gregory David,20,0,30,10
1658045622708,MATH 10A,A03,083737,Patchell; Gregory David,16,0,30,14
1658045628752,MATH 10B,A01,083207,Lim; Seonhee,9,0,34,25
1658045628752,MATH 10B,A02,083208,Lim; Seonhee,10,0,35,25
1658045628752,MATH 10B,A03,093472,Lim; Seonhee,7,0,34,27
1658045628752,MATH 10B,B01,083739,Sinha; Shubham,14,0,30,16
1658045634776,MATH 18,A01,083743,Cinel; Cameron Alexander,9,0,30,21
1658045634776,MATH 18,A02,083744,Cinel; Cameron Alexander,18,0,30,12
1658045634776,MATH 18,A03,083745,Cinel; Cameron Alexander,10,0,30,20
1658045634776,MATH 18,B01,083748,Rideout; David Porter,5,0,37,32
1658045634776,MATH 18,B02,083749,Rideout; David Porter,5,0,36,31
1658045634776,MATH 18,B03,083750,Rideout; David Porter,3,0,37,34
1658045634776,MATH 18,B04,083751,Rideout; David Porter,7,0,36,29
1658045634776,MATH 18,B05,093473,Rideout; David Porter,7,0,36,29
1658045634776,MATH 18,B06,093474,Rideout; David Porter,6,0,36,30
1658045640802,MATH 20A,A01,083754,Zheng; Zequn,14,0,40,26
1658045646829,MATH 20B,A01,083756,Briones; Jor-el Thomas Caparas,4,0,36,32
1658045646829,MATH 20B,A02,083757,Briones; Jor-el Thomas Caparas,1,0,36,35
1658045646829,MATH 20B,A03,093475,Briones; Jor-el Thomas Caparas,3,0,36,33
1658045652854,MATH 20C,A01,083760,Briones; Jor-el Thomas Caparas,1,0,35,34
1658045652854,MATH 20C,A02,083761,Briones; Jor-el Thomas Caparas,8,0,35,27
1658045652854,MATH 20C,A03,093476,Briones; Jor-el Thomas Caparas,0,1,36,36
1658045652854,MATH 20C,B01,083762,Bach; Quang Tran,1,0,30,29
1658045658877,MATH 20D,A01,083765,Tran; Brian Kha,5,0,30,25
1658045658877,MATH 20D,A02,083766,Tran; Brian Kha,5,0,30,25
1658045658877,MATH 20D,A03,083767,Tran; Brian Kha,6,0,30,24
1658045664901,MATH 20E,A01,083771,Ganguly; Soumya,12,0,32,20
1658045664901,MATH 20E,A02,083772,Ganguly; Soumya,7,0,32,25
1658045664901,MATH 20E,B01,083773,Ciotti; Benjamin,20,0,35,15
1658045664901,MATH 20E,B02,083774,Ciotti; Benjamin,18,0,35,17
1658045670929,MATH 103A,A01,083777,Greenfeld; Be'Eri,6,0,36,30
1658045670929,MATH 103A,A02,083778,Greenfeld; Be'Eri,5,0,36,31
1658045670929,MATH 103A,A03,093561,Greenfeld; Be'Eri,7,0,36,29
1658045670929,MATH 103A,B01,083779,Greenfeld; Be'Eri,8,0,36,28
1658045670929,MATH 103A,B02,083780,Greenfeld; Be'Eri,4,0,36,32
1658045670929,MATH 103A,B03,093562,Greenfeld; Be'Eri,3,0,36,33
1658045676952,MATH 105,A01,085443,Carter; Anne Toulson,15,0,35,20
1658045676952,MATH 105,A02,093477,Carter; Anne Toulson,20,0,35,15
1658045682975,MATH 109,A01,083213,Ganzberger; Geoffrey Michael,3,0,34,31
1658045682975,MATH 109,A02,083214,Ganzberger; Geoffrey Michael,4,0,34,30
1658045682975,MATH 109,A03,093478,Ganzberger; Geoffrey Michael,2,0,34,32
1658045682975,MATH 109,B01,083215,Ganzberger; Geoffrey Michael,3,0,32,29
1658045682975,MATH 109,B02,083216,Ganzberger; Geoffrey Michael,3,0,32,29
1658045682975,MATH 109,B03,093479,Ganzberger; Geoffrey Michael,8,0,32,24
1658045688999,MATH 142A,A01,083219,Chow; Bennett,7,0,32,25
1658045688999,MATH 142A,A02,083220,Chow; Bennett,10,0,32,22
1658045688999,MATH 142A,A03,093480,Chow; Bennett,9,0,32,23
1658045688999,MATH 142A,B03,093481,Chow; Bennett,8,0,32,24
1658045688999,MATH 142A,B04,093558,Chow; Bennett,14,0,32,18
1658045688999,MATH 142A,B05,093559,Chow; Bennett,7,0,32,25
1658045695022,MATH 193A,A01,083224,Rotar; Vladimir,9,0,34,25
1658045695022,MATH 193A,A02,083225,Rotar; Vladimir,11,0,34,23
1658045695022,MATH 193A,A03,083781,Rotar; Vladimir,5,0,34,29
1658045695022,MATH 193A,A04,083782,Rotar; Vladimir,12,0,34,22
1658045695022,MATH 193A,A05,093482,Rotar; Vladimir,11,0,34,23
1658045701049,MATH 197,001,091859,McAuley; Julian John,9999,0,9999,0
1658045701049,MATH 197,002,095566,Kedlaya; Kiran S.,9997,0,9999,2
1658045701049,MATH 197,003,095567,Xiao; Ming,9999,0,9999,0
1658045701049,MATH 197,004,095571,Perols; Johan Lars,9998,0,9999,1
1658045708113,COGS 9,A01,083615,Shannon; Kyle Michael,11,0,75,64
1658045714135,COGS 11,A01,083617,Boyle; Mary E. T.,23,0,48,25
1658045720161,COGS 13,A01,083071,Bastos; Amalia Pinkusfeld,12,0,71,59
1658045726186,COGS 14A,A01,092681,Semenuks; Arturs,5,1,100,95
1658045732213,COGS 14B,A01,083073,Cheng; Tzu-Han,7,0,63,56
1658045738240,COGS 17,A01,092677,Semenuks; Arturs,7,0,81,74
1658045744264,COGS 100,A01,083619,Allen; Michael Gordon,17,0,70,53
1658045750291,COGS 101A,A01,083621,Davis; Joshua Daniel,9,0,68,59
1658045756314,COGS 101B,A01,091572,Allen; Michael Gordon,14,0,65,51
1658045762348,COGS 101C,A01,083625,Delgado; Tania,17,0,35,18
1658045768371,COGS 107A,A01,083627,Boyle; Mary E. T.,14,0,60,46
1658045774412,COGS 118A,A01,083075,Gupta; Anjum,21,0,76,55
1658045780455,CSE 3,A50,083646,Miranda; Gregory Joseph,24,0,50,26
1658045786482,CSE 8A,A50,083650,Miranda; Gregory Joseph,17,1,56,39
1658045792511,CSE 11,A01,083080,Cao; Yingjun,7,15,40,33
1658045798533,CSE 12,A01,083652,Krause-Levy; Sophia Louisa,30,1,120,90
1658045804558,CSE 15L,A01,083654,Morris; Justin Loren,9,0,50,41
1658045804558,CSE 15L,A02,083655,Morris; Justin Loren,11,0,50,39
1658045810586,CSE 20,A01,083657,Tran; Khoa Dang,39,0,80,41
1658045816622,CSE 21,A01,095574,Bach; Quang Tran,23,0,48,25
1658045822645,CSE 30,A01,083084,Eldon; John,8,0,80,72
1658045822645,CSE 30,B01,095061,Bhaskar; Nishant,9,0,50,41
1658045828671,CSE 100,A01,083659,Cao; Yingjun,5,4,70,65
1658045834693,CSE 134B,A01,083661,Powell; Thomas Allan,25,0,100,75
1658045840716,CSE 140,A01,083663,Gungor; Onat,17,0,85,68
1658045846741,CSE 140L,A01,083088,Eldon; John,23,0,100,77
1658045852765,CSE 175,A01,083665,Kumar; Rakesh,3,0,25,22
1658045858786,CSE 190,A00,092507,Dubnov; Shlomo,8,0,20,12
1658045864813,ECE 45,A01,083139,Congero; Spencer William,7,0,75,68
1658045870841,ECE 65,A50,083695,Saad; Andrew S,12,0,30,18
1658045870841,ECE 65,A51,095125,Saad; Andrew S,24,0,26,2
1658045876863,ECE 109,A01,091882,Touri; Behrouz,21,0,70,49
1658045882888,ECE 180,A00,083140,Abi Samra; Nicholas Camill,1,0,30,29
1658045882888,ECE 180,B00,083141,Abi Samra; Nicholas Camill,0,0,30,30
1658045888910,MATH 10A,A01,083735,Patchell; Gregory David,2,0,30,28
1658045888910,MATH 10A,A02,083736,Patchell; Gregory David,20,0,30,10
1658045888910,MATH 10A,A03,083737,Patchell; Gregory David,16,0,30,14
1658045894946,MATH 10B,A01,083207,Lim; Seonhee,9,0,34,25
1658045894946,MATH 10B,A02,083208,Lim; Seonhee,10,0,35,25
1658045894946,MATH 10B,A03,093472,Lim; Seonhee,7,0,34,27
1658045894946,MATH 10B,B01,083739,Sinha; Shubham,14,0,30,16
1658045901049,MATH 18,A01,083743,Cinel; Cameron Alexander,9,0,30,21
1658045901049,MATH 18,A02,083744,Cinel; Cameron Alexander,18,0,30,12
1658045901049,MATH 18,A03,083745,Cinel; Cameron Alexander,10,0,30,20
1658045901049,MATH 18,B01,083748,Rideout; David Porter,5,0,37,32
1658045901049,MATH 18,B02,083749,Rideout; David Porter,5,0,36,31
1658045901049,MATH 18,B03,083750,Rideout; David Porter,3,0,37,34
1658045901049,MATH 18,B04,083751,Rideout; David Porter,7,0,36,29
1658045901049,MATH 18,B05,093473,Rideout; David Porter,7,0,36,29
1658045901049,MATH 18,B06,093474,Rideout; David Porter,6,0,36,30
1658045907076,MATH 20A,A01,083754,Zheng; Zequn,14,0,40,26
1658045913101,MATH 20B,A01,083756,Briones; Jor-el Thomas Caparas,4,0,36,32
1658045913101,MATH 20B,A02,083757,Briones; Jor-el Thomas Caparas,1,0,36,35
1658045913101,MATH 20B,A03,093475,Briones; Jor-el Thomas Caparas,3,0,36,33
1658045919123,MATH 20C,A01,083760,Briones; Jor-el Thomas Caparas,1,0,35,34
1658045919123,MATH 20C,A02,083761,Briones; Jor-el Thomas Caparas,8,0,35,27
1658045919123,MATH 20C,A03,093476,Briones; Jor-el Thomas Caparas,0,1,36,36
1658045919123,MATH 20C,B01,083762,Bach; Quang Tran,1,0,30,29
1658045925152,MATH 20D,A01,083765,Tran; Brian Kha,5,0,30,25
1658045925152,MATH 20D,A02,083766,Tran; Brian Kha,5,0,30,25
1658045925152,MATH 20D,A03,083767,Tran; Brian Kha,6,0,30,24
1658045931178,MATH 20E,A01,083771,Ganguly; Soumya,12,0,32,20
1658045931178,MATH 20E,A02,083772,Ganguly; Soumya,7,0,32,25
1658045931178,MATH 20E,B01,083773,Ciotti; Benjamin,20,0,35,15
1658045931178,MATH 20E,B02,083774,Ciotti; Benjamin,18,0,35,17
1658045937203,MATH 103A,A01,083777,Greenfeld; Be'Eri,6,0,36,30
1658045937203,MATH 103A,A02,083778,Greenfeld; Be'Eri,5,0,36,31
1658045937203,MATH 103A,A03,093561,Greenfeld; Be'Eri,7,0,36,29
1658045937203,MATH 103A,B01,083779,Greenfeld; Be'Eri,8,0,36,28
1658045937203,MATH 103A,B02,083780,Greenfeld; Be'Eri,4,0,36,32
1658045937203,MATH 103A,B03,093562,Greenfeld; Be'Eri,3,0,36,33
1658045943230,MATH 105,A01,085443,Carter; Anne Toulson,15,0,35,20
1658045943230,MATH 105,A02,093477,Carter; Anne Toulson,20,0,35,15
1658045949253,MATH 109,A01,083213,Ganzberger; Geoffrey Michael,3,0,34,31
1658045949253,MATH 109,A02,083214,Ganzberger; Geoffrey Michael,4,0,34,30
1658045949253,MATH 109,A03,093478,Ganzberger; Geoffrey Michael,2,0,34,32
1658045949253,MATH 109,B01,083215,Ganzberger; Geoffrey Michael,3,0,32,29
1658045949253,MATH 109,B02,083216,Ganzberger; Geoffrey Michael,3,0,32,29
1658045949253,MATH 109,B03,093479,Ganzberger; Geoffrey Michael,8,0,32,24
1658045955279,MATH 142A,A01,083219,Chow; Bennett,7,0,32,25
1658045955279,MATH 142A,A02,083220,Chow; Bennett,10,0,32,22
1658045955279,MATH 142A,A03,093480,Chow; Bennett,9,0,32,23
1658045955279,MATH 142A,B03,093481,Chow; Bennett,8,0,32,24
1658045955279,MATH 142A,B04,093558,Chow; Bennett,14,0,32,18
1658045955279,MATH 142A,B05,093559,Chow; Bennett,7,0,32,25
1658045961307,MATH 193A,A01,083224,Rotar; Vladimir,9,0,34,25
1658045961307,MATH 193A,A02,083225,Rotar; Vladimir,11,0,34,23
1658045961307,MATH 193A,A03,083781,Rotar; Vladimir,5,0,34,29
1658045961307,MATH 193A,A04,083782,Rotar; Vladimir,12,0,34,22
1658045961307,MATH 193A,A05,093482,Rotar; Vladimir,11,0,34,23
1658045967332,MATH 197,001,091859,McAuley; Julian John,9999,0,9999,0
1658045967332,MATH 197,002,095566,Kedlaya; Kiran S.,9997,0,9999,2
1658045967332,MATH 197,003,095567,Xiao; Ming,9999,0,9999,0
1658045967332,MATH 197,004,095571,Perols; Johan Lars,9998,0,9999,1
1658045974397,COGS 9,A01,083615,Shannon; Kyle Michael,11,0,75,64
1658045980423,COGS 11,A01,083617,Boyle; Mary E. T.,23,0,48,25
1658045986456,COGS 13,A01,083071,Bastos; Amalia Pinkusfeld,12,0,71,59
1658045992482,COGS 14A,A01,092681,Semenuks; Arturs,5,1,100,95
1658045998509,COGS 14B,A01,083073,Cheng; Tzu-Han,7,0,63,56
1658046004533,COGS 17,A01,092677,Semenuks; Arturs,7,0,81,74
1658046010562,COGS 100,A01,083619,Allen; Michael Gordon,17,0,70,53
1658046016585,COGS 101A,A01,083621,Davis; Joshua Daniel,9,0,68,59
1658046022609,COGS 101B,A01,091572,Allen; Michael Gordon,14,0,65,51
1658046028630,COGS 101C,A01,083625,Delgado; Tania,17,0,35,18
1658046034654,COGS 107A,A01,083627,Boyle; Mary E. T.,14,0,60,46
1658046040677,COGS 118A,A01,083075,Gupta; Anjum,21,0,76,55
1658046046713,CSE 3,A50,083646,Miranda; Gregory Joseph,24,0,50,26
1658046052740,CSE 8A,A50,083650,Miranda; Gregory Joseph,17,1,56,39
1658046058765,CSE 11,A01,083080,Cao; Yingjun,7,15,40,33
1658046064791,CSE 12,A01,083652,Krause-Levy; Sophia Louisa,30,1,120,90
1658046070827,CSE 15L,A01,083654,Morris; Justin Loren,9,0,50,41
1658046070827,CSE 15L,A02,083655,Morris; Justin Loren,11,0,50,39
1658046076853,CSE 20,A01,083657,Tran; Khoa Dang,39,0,80,41
1658046082876,CSE 21,A01,095574,Bach; Quang Tran,23,0,48,25
1658046088906,CSE 30,A01,083084,Eldon; John,8,0,80,72
1658046088906,CSE 30,B01,095061,Bhaskar; Nishant,9,0,50,41
1658046094929,CSE 100,A01,083659,Cao; Yingjun,5,4,70,65
1658046100959,CSE 134B,A01,083661,Powell; Thomas Allan,25,0,100,75
1658046106984,CSE 140,A01,083663,Gungor; Onat,17,0,85,68
1658046113008,CSE 140L,A01,083088,Eldon; John,23,0,100,77
1658046119034,CSE 175,A01,083665,Kumar; Rakesh,3,0,25,22
1658046125061,CSE 190,A00,092507,Dubnov; Shlomo,8,0,20,12
1658046131084,ECE 45,A01,083139,Congero; Spencer William,7,0,75,68
1658046137106,ECE 65,A50,083695,Saad; Andrew S,12,0,30,18
1658046137106,ECE 65,A51,095125,Saad; Andrew S,24,0,26,2
1658046143132,ECE 109,A01,091882,Touri; Behrouz,21,0,70,49
1658046149154,ECE 180,A00,083140,Abi Samra; Nicholas Camill,1,0,30,29
1658046149154,ECE 180,B00,083141,Abi Samra; Nicholas Camill,0,0,30,30
1658046155177,MATH 10A,A01,083735,Patchell; Gregory David,2,0,30,28
1658046155177,MATH 10A,A02,083736,Patchell; Gregory David,20,0,30,10
1658046155177,MATH 10A,A03,083737,Patchell; Gregory David,16,0,30,14
1658046161207,MATH 10B,A01,083207,Lim; Seonhee,9,0,34,25
1658046161207,MATH 10B,A02,083208,Lim; Seonhee,10,0,35,25
1658046161207,MATH 10B,A03,093472,Lim; Seonhee,7,0,34,27
1658046161207,MATH 10B,B01,083739,Sinha; Shubham,14,0,30,16
1658046167232,MATH 18,A01,083743,Cinel; Cameron Alexander,9,0,30,21
1658046167232,MATH 18,A02,083744,Cinel; Cameron Alexander,18,0,30,12
1658046167232,MATH 18,A03,083745,Cinel; Cameron Alexander,10,0,30,20
1658046167232,MATH 18,B01,083748,Rideout; David Porter,5,0,37,32
1658046167232,MATH 18,B02,083749,Rideout; David Porter,5,0,36,31
1658046167232,MATH 18,B03,083750,Rideout; David Porter,3,0,37,34
1658046167232,MATH 18,B04,083751,Rideout; David Porter,7,0,36,29
1658046167232,MATH 18,B05,093473,Rideout; David Porter,7,0,36,29
1658046167232,MATH 18,B06,093474,Rideout; David Porter,6,0,36,30
1658046173256,MATH 20A,A01,083754,Zheng; Zequn,14,0,40,26
1658046179279,MATH 20B,A01,083756,Briones; Jor-el Thomas Caparas,4,0,36,32
1658046179279,MATH 20B,A02,083757,Briones; Jor-el Thomas Caparas,1,0,36,35
1658046179279,MATH 20B,A03,093475,Briones; Jor-el Thomas Caparas,3,0,36,33
1658046185302,MATH 20C,A01,083760,Briones; Jor-el Thomas Caparas,1,0,35,34
1658046185302,MATH 20C,A02,083761,Briones; Jor-el Thomas Caparas,8,0,35,27
1658046185302,MATH 20C,A03,093476,Briones; Jor-el Thomas Caparas,0,1,36,36
1658046185302,MATH 20C,B01,083762,Bach; Quang Tran,1,0,30,29
1658046191330,MATH 20D,A01,083765,Tran; Brian Kha,5,0,30,25
1658046191330,MATH 20D,A02,083766,Tran; Brian Kha,5,0,30,25
1658046191330,MATH 20D,A03,083767,Tran; Brian Kha,6,0,30,24
1658046197359,MATH 20E,A01,083771,Ganguly; Soumya,12,0,32,20
1658046197359,MATH 20E,A02,083772,Ganguly; Soumya,7,0,32,25
1658046197359,MATH 20E,B01,083773,Ciotti; Benjamin,20,0,35,15
1658046197359,MATH 20E,B02,083774,Ciotti; Benjamin,18,0,35,17
1658046203382,MATH 103A,A01,083777,Greenfeld; Be'Eri,6,0,36,30
1658046203382,MATH 103A,A02,083778,Greenfeld; Be'Eri,5,0,36,31
1658046203382,MATH 103A,A03,093561,Greenfeld; Be'Eri,7,0,36,29
1658046203382,MATH 103A,B01,083779,Greenfeld; Be'Eri,8,0,36,28
1658046203382,MATH 103A,B02,083780,Greenfeld; Be'Eri,4,0,36,32
1658046203382,MATH 103A,B03,093562,Greenfeld; Be'Eri,3,0,36,33
1658046209405,MATH 105,A01,085443,Carter; Anne Toulson,15,0,35,20
1658046209405,MATH 105,A02,093477,Carter; Anne Toulson,20,0,35,15
1658046215431,MATH 109,A01,083213,Ganzberger; Geoffrey Michael,3,0,34,31
1658046215431,MATH 109,A02,083214,Ganzberger; Geoffrey Michael,4,0,34,30
1658046215431,MATH 109,A03,093478,Ganzberger; Geoffrey Michael,2,0,34,32
1658046215431,MATH 109,B01,083215,Ganzberger; Geoffrey Michael,3,0,32,29
1658046215431,MATH 109,B02,083216,Ganzberger; Geoffrey Michael,3,0,32,29
1658046215431,MATH 109,B03,093479,Ganzberger; Geoffrey Michael,8,0,32,24
1658046221455,MATH 142A,A01,083219,Chow; Bennett,7,0,32,25
1658046221455,MATH 142A,A02,083220,Chow; Bennett,10,0,32,22
1658046221455,MATH 142A,A03,093480,Chow; Bennett,9,0,32,23
1658046221455,MATH 142A,B03,093481,Chow; Bennett,8,0,32,24
1658046221455,MATH 142A,B04,093558,Chow; Bennett,14,0,32,18
1658046221455,MATH 142A,B05,093559,Chow; Bennett,7,0,32,25
1658046227478,MATH 193A,A01,083224,Rotar; Vladimir,9,0,34,25
1658046227478,MATH 193A,A02,083225,Rotar; Vladimir,11,0,34,23
1658046227478,MATH 193A,A03,083781,Rotar; Vladimir,5,0,34,29
1658046227478,MATH 193A,A04,083782,Rotar; Vladimir,12,0,34,22
1658046227478,MATH 193A,A05,093482,Rotar; Vladimir,11,0,34,23
1658046233505,MATH 197,001,091859,McAuley; Julian John,9999,0,9999,0
1658046233505,MATH 197,002,095566,Kedlaya; Kiran S.,9997,0,9999,2
1658046233505,MATH 197,003,095567,Xiao; Ming,9999,0,9999,0
1658046233505,MATH 197,004,095571,Perols; Johan Lars,9998,0,9999,1
1658046240557,COGS 9,A01,083615,Shannon; Kyle Michael,11,0,75,64
1658046246584,COGS 11,A01,083617,Boyle; Mary E. T.,23,0,48,25
1658046252607,COGS 13,A01,083071,Bastos; Amalia Pinkusfeld,12,0,71,59
1658046258631,COGS 14A,A01,092681,Semenuks; Arturs,5,1,100,95
1658046264655,COGS 14B,A01,083073,Cheng; Tzu-Han,7,0,63,56
1658046270678,COGS 17,A01,092677,Semenuks; Arturs,7,0,81,74
1658046276706,COGS 100,A01,083619,Allen; Michael Gordon,17,0,70,53
1658046282729,COGS 101A,A01,083621,Davis; Joshua Daniel,9,0,68,59
1658046288760,COGS 101B,A01,091572,Allen; Michael Gordon,14,0,65,51
1658046294783,COGS 101C,A01,083625,Delgado; Tania,17,0,35,18
1658046300804,COGS 107A,A01,083627,Boyle; Mary E. T.,14,0,60,46
1658046306830,COGS 118A,A01,083075,Gupta; Anjum,21,0,76,55
1658046312859,CSE 3,A50,083646,Miranda; Gregory Joseph,24,0,50,26
1658046318882,CSE 8A,A50,083650,Miranda; Gregory Joseph,17,1,56,39
1658046324905,CSE 11,A01,083080,Cao; Yingjun,7,15,40,33
1658046330932,CSE 12,A01,083652,Krause-Levy; Sophia Louisa,30,1,120,90
1658046336961,CSE 15L,A01,083654,Morris; Justin Loren,9,0,50,41
1658046336961,CSE 15L,A02,083655,Morris; Justin Loren,11,0,50,39
1658046342988,CSE 20,A01,083657,Tran; Khoa Dang,39,0,80,41
1658046349010,CSE 21,A01,095574,Bach; Quang Tran,23,0,48,25
1658046355036,CSE 30,A01,083084,Eldon; John,8,0,80,72
1658046355036,CSE 30,B01,095061,Bhaskar; Nishant,9,0,50,41
1658046361059,CSE 100,A01,083659,Cao; Yingjun,5,4,70,65
1658046367088,CSE 134B,A01,083661,Powell; Thomas Allan,25,0,100,75
1658046373110,CSE 140,A01,083663,Gungor; Onat,17,0,85,68
1658046379133,CSE 140L,A01,083088,Eldon; John,23,0,100,77
1658046385156,CSE 175,A01,083665,Kumar; Rakesh,3,0,25,22
1658046391180,CSE 190,A00,092507,Dubnov; Shlomo,8,0,20,12
1658046397203,ECE 45,A01,083139,Congero; Spencer William,7,0,75,68
1658046403226,ECE 65,A50,083695,Saad; Andrew S,12,0,30,18
1658046403226,ECE 65,A51,095125,Saad; Andrew S,24,0,26,2
1658046409253,ECE 109,A01,091882,Touri; Behrouz,21,0,70,49
1658046415276,ECE 180,A00,083140,Abi Samra; Nicholas Camill,1,0,30,29
1658046415276,ECE 180,B00,083141,Abi Samra; Nicholas Camill,0,0,30,30
1658046421303,MATH 10A,A01,083735,Patchell; Gregory David,2,0,30,28
1658046421303,MATH 10A,A02,083736,Patchell; Gregory David,20,0,30,10
1658046421303,MATH 10A,A03,083737,Patchell; Gregory David,16,0,30,14
1658046427327,MATH 10B,A01,083207,Lim; Seonhee,9,0,34,25
1658046427327,MATH 10B,A02,083208,Lim; Seonhee,10,0,35,25
1658046427327,MATH 10B,A03,093472,Lim; Seonhee,7,0,34,27
1658046427327,MATH 10B,B01,083739,Sinha; Shubham,14,0,30,16
1658046433357,MATH 18,A01,083743,Cinel; Cameron Alexander,9,0,30,21
1658046433357,MATH 18,A02,083744,Cinel; Cameron Alexander,18,0,30,12
1658046433357,MATH 18,A03,083745,Cinel; Cameron Alexander,10,0,30,20
1658046433357,MATH 18,B01,083748,Rideout; David Porter,5,0,37,32
1658046433357,MATH 18,B02,083749,Rideout; David Porter,5,0,36,31
1658046433357,MATH 18,B03,083750,Rideout; David Porter,3,0,37,34
1658046433357,MATH 18,B04,083751,Rideout; David Porter,7,0,36,29
1658046433357,MATH 18,B05,093473,Rideout; David Porter,7,0,36,29
1658046433357,MATH 18,B06,093474,Rideout; David Porter,6,0,36,30
1658046439383,MATH 20A,A01,083754,Zheng; Zequn,14,0,40,26
1658046445407,MATH 20B,A01,083756,Briones; Jor-el Thomas Caparas,4,0,36,32
1658046445407,MATH 20B,A02,083757,Briones; Jor-el Thomas Caparas,1,0,36,35
1658046445407,MATH 20B,A03,093475,Briones; Jor-el Thomas Caparas,3,0,36,33
1658046451435,MATH 20C,A01,083760,Briones; Jor-el Thomas Caparas,1,0,35,34
1658046451435,MATH 20C,A02,083761,Briones; Jor-el Thomas Caparas,8,0,35,27
1658046451435,MATH 20C,A03,093476,Briones; Jor-el Thomas Caparas,0,1,36,36
1658046451435,MATH 20C,B01,083762,Bach; Quang Tran,1,0,30,29
1658046457463,MATH 20D,A01,083765,Tran; Brian Kha,5,0,30,25
1658046457463,MATH 20D,A02,083766,Tran; Brian Kha,5,0,30,25
1658046457463,MATH 20D,A03,083767,Tran; Brian Kha,6,0,30,24
1658046463489,MATH 20E,A01,083771,Ganguly; Soumya,12,0,32,20
1658046463489,MATH 20E,A02,083772,Ganguly; Soumya,7,0,32,25
1658046463489,MATH 20E,B01,083773,Ciotti; Benjamin,20,0,35,15
1658046463489,MATH 20E,B02,083774,Ciotti; Benjamin,18,0,35,17
1658046469513,MATH 103A,A01,083777,Greenfeld; Be'Eri,6,0,36,30
1658046469513,MATH 103A,A02,083778,Greenfeld; Be'Eri,5,0,36,31
1658046469513,MATH 103A,A03,093561,Greenfeld; Be'Eri,7,0,36,29
1658046469513,MATH 103A,B01,083779,Greenfeld; Be'Eri,8,0,36,28
1658046469513,MATH 103A,B02,083780,Greenfeld; Be'Eri,4,0,36,32
1658046469513,MATH 103A,B03,093562,Greenfeld; Be'Eri,3,0,36,33
1658046475536,MATH 105,A01,085443,Carter; Anne Toulson,15,0,35,20
1658046475536,MATH 105,A02,093477,Carter; Anne Toulson,20,0,35,15
1658046481565,MATH 109,A01,083213,Ganzberger; Geoffrey Michael,3,0,34,31
1658046481565,MATH 109,A02,083214,Ganzberger; Geoffrey Michael,4,0,34,30
1658046481565,MATH 109,A03,093478,Ganzberger; Geoffrey Michael,2,0,34,32
1658046481565,MATH 109,B01,083215,Ganzberger; Geoffrey Michael,3,0,32,29
1658046481565,MATH 109,B02,083216,Ganzberger; Geoffrey Michael,3,0,32,29
1658046481565,MATH 109,B03,093479,Ganzberger; Geoffrey Michael,8,0,32,24
1658046487588,MATH 142A,A01,083219,Chow; Bennett,7,0,32,25
1658046487588,MATH 142A,A02,083220,Chow; Bennett,10,0,32,22
1658046487588,MATH 142A,A03,093480,Chow; Bennett,9,0,32,23
1658046487588,MATH 142A,B03,093481,Chow; Bennett,8,0,32,24
1658046487588,MATH 142A,B04,093558,Chow; Bennett,14,0,32,18
1658046487588,MATH 142A,B05,093559,Chow; Bennett,7,0,32,25
1658046493611,MATH 193A,A01,083224,Rotar; Vladimir,9,0,34,25
1658046493611,MATH 193A,A02,083225,Rotar; Vladimir,11,0,34,23
1658046493611,MATH 193A,A03,083781,Rotar; Vladimir,5,0,34,29
1658046493611,MATH 193A,A04,083782,Rotar; Vladimir,12,0,34,22
1658046493611,MATH 193A,A05,093482,Rotar; Vladimir,11,0,34,23
1658046499711,MATH 197,001,091859,McAuley; Julian John,9999,0,9999,0
1658046499711,MATH 197,002,095566,Kedlaya; Kiran S.,9997,0,9999,2
1658046499711,MATH 197,003,095567,Xiao; Ming,9999,0,9999,0
1658046499711,MATH 197,004,095571,Perols; Johan Lars,9998,0,9999,1
1658046506773,COGS 9,A01,083615,Shannon; Kyle Michael,11,0,75,64
1658046512796,COGS 11,A01,083617,Boyle; Mary E. T.,23,0,48,25
1658046518820,COGS 13,A01,083071,Bastos; Amalia Pinkusfeld,12,0,71,59
1658046524843,COGS 14A,A01,092681,Semenuks; Arturs,5,1,100,95
1658046530867,COGS 14B,A01,083073,Cheng; Tzu-Han,7,0,63,56
1658046536893,COGS 17,A01,092677,Semenuks; Arturs,7,0,81,74
1658046542920,COGS 100,A01,083619,Allen; Michael Gordon,17,0,70,53
1658046548947,COGS 101A,A01,083621,Davis; Joshua Daniel,9,0,68,59
1658046554969,COGS 101B,A01,091572,Allen; Michael Gordon,14,0,65,51
1658046560996,COGS 101C,A01,083625,Delgado; Tania,17,0,35,18
1658046567029,COGS 107A,A01,083627,Boyle; Mary E. T.,14,0,60,46
1658046573055,COGS 118A,A01,083075,Gupta; Anjum,21,0,76,55
1658046579084,CSE 3,A50,083646,Miranda; Gregory Joseph,24,0,50,26
1658046585110,CSE 8A,A50,083650,Miranda; Gregory Joseph,17,1,56,39
1658046591133,CSE 11,A01,083080,Cao; Yingjun,7,15,40,33
1658046597157,CSE 12,A01,083652,Krause-Levy; Sophia Louisa,30,1,120,90
1658046603183,CSE 15L,A01,083654,Morris; Justin Loren,9,0,50,41
1658046603183,CSE 15L,A02,083655,Morris; Justin Loren,11,0,50,39
1658046609209,CSE 20,A01,083657,Tran; Khoa Dang,39,0,80,41
1658046615236,CSE 21,A01,095574,Bach; Quang Tran,23,0,48,25
1658046621259,CSE 30,A01,083084,Eldon; John,8,0,80,72
1658046621259,CSE 30,B01,095061,Bhaskar; Nishant,9,0,50,41
1658046627282,CSE 100,A01,083659,Cao; Yingjun,5,4,70,65
1658046633304,CSE 134B,A01,083661,Powell; Thomas Allan,25,0,100,75
1658046639326,CSE 140,A01,083663,Gungor; Onat,17,0,85,68
1658046645363,CSE 140L,A01,083088,Eldon; John,23,0,100,77
1658046651385,CSE 175,A01,083665,Kumar; Rakesh,3,0,25,22
1658046657408,CSE 190,A00,092507,Dubnov; Shlomo,8,0,20,12
1658046663431,ECE 45,A01,083139,Congero; Spencer William,7,0,75,68
1658046669465,ECE 65,A50,083695,Saad; Andrew S,12,0,30,18
1658046669465,ECE 65,A51,095125,Saad; Andrew S,24,0,26,2
1658046675487,ECE 109,A01,091882,Touri; Behrouz,21,0,70,49
1658046681512,ECE 180,A00,083140,Abi Samra; Nicholas Camill,1,0,30,29
1658046681512,ECE 180,B00,083141,Abi Samra; Nicholas Camill,0,0,30,30
1658046687541,MATH 10A,A01,083735,Patchell; Gregory David,2,0,30,28
1658046687541,MATH 10A,A02,083736,Patchell; Gregory David,20,0,30,10
1658046687541,MATH 10A,A03,083737,Patchell; Gregory David,16,0,30,14
1658046693571,MATH 10B,A01,083207,Lim; Seonhee,9,0,34,25
1658046693571,MATH 10B,A02,083208,Lim; Seonhee,10,0,35,25
1658046693571,MATH 10B,A03,093472,Lim; Seonhee,7,0,34,27
1658046693571,MATH 10B,B01,083739,Sinha; Shubham,14,0,30,16
1658046699597,MATH 18,A01,083743,Cinel; Cameron Alexander,9,0,30,21
1658046699597,MATH 18,A02,083744,Cinel; Cameron Alexander,18,0,30,12
1658046699597,MATH 18,A03,083745,Cinel; Cameron Alexander,10,0,30,20
1658046699597,MATH 18,B01,083748,Rideout; David Porter,5,0,37,32
1658046699597,MATH 18,B02,083749,Rideout; David Porter,5,0,36,31
1658046699597,MATH 18,B03,083750,Rideout; David Porter,3,0,37,34
1658046699597,MATH 18,B04,083751,Rideout; David Porter,7,0,36,29
1658046699597,MATH 18,B05,093473,Rideout; David Porter,7,0,36,29
1658046699597,MATH 18,B06,093474,Rideout; David Porter,6,0,36,30
1658046705623,MATH 20A,A01,083754,Zheng; Zequn,14,0,40,26
1658046711647,MATH 20B,A01,083756,Briones; Jor-el Thomas Caparas,4,0,36,32
1658046711647,MATH 20B,A02,083757,Briones; Jor-el Thomas Caparas,1,0,36,35
1658046711647,MATH 20B,A03,093475,Briones; Jor-el Thomas Caparas,3,0,36,33
1658046717670,MATH 20C,A01,083760,Briones; Jor-el Thomas Caparas,1,0,35,34
1658046717670,MATH 20C,A02,083761,Briones; Jor-el Thomas Caparas,8,0,35,27
1658046717670,MATH 20C,A03,093476,Briones; Jor-el Thomas Caparas,0,1,36,36
1658046717670,MATH 20C,B01,083762,Bach; Quang Tran,1,0,30,29
1658046723695,MATH 20D,A01,083765,Tran; Brian Kha,5,0,30,25
1658046723695,MATH 20D,A02,083766,Tran; Brian Kha,5,0,30,25
1658046723695,MATH 20D,A03,083767,Tran; Brian Kha,6,0,30,24
1658046729718,MATH 20E,A01,083771,Ganguly; Soumya,12,0,32,20
1658046729718,MATH 20E,A02,083772,Ganguly; Soumya,7,0,32,25
1658046729718,MATH 20E,B01,083773,Ciotti; Benjamin,20,0,35,15
1658046729718,MATH 20E,B02,083774,Ciotti; Benjamin,18,0,35,17
1658046735742,MATH 103A,A01,083777,Greenfeld; Be'Eri,6,0,36,30
1658046735742,MATH 103A,A02,083778,Greenfeld; Be'Eri,5,0,36,31
1658046735742,MATH 103A,A03,093561,Greenfeld; Be'Eri,7,0,36,29
1658046735742,MATH 103A,B01,083779,Greenfeld; Be'Eri,8,0,36,28
1658046735742,MATH 103A,B02,083780,Greenfeld; Be'Eri,4,0,36,32
1658046735742,MATH 103A,B03,093562,Greenfeld; Be'Eri,3,0,36,33
1658046741763,MATH 105,A01,085443,Carter; Anne Toulson,15,0,35,20
1658046741763,MATH 105,A02,093477,Carter; Anne Toulson,20,0,35,15
1658046747794,MATH 109,A01,083213,Ganzberger; Geoffrey Michael,3,0,34,31
1658046747794,MATH 109,A02,083214,Ganzberger; Geoffrey Michael,4,0,34,30
1658046747794,MATH 109,A03,093478,Ganzberger; Geoffrey Michael,2,0,34,32
1658046747794,MATH 109,B01,083215,Ganzberger; Geoffrey Michael,3,0,32,29
1658046747794,MATH 109,B02,083216,Ganzberger; Geoffrey Michael,3,0,32,29
1658046747794,MATH 109,B03,093479,Ganzberger; Geoffrey Michael,8,0,32,24
1658046753824,MATH 142A,A01,083219,Chow; Bennett,7,0,32,25
1658046753824,MATH 142A,A02,083220,Chow; Bennett,10,0,32,22
1658046753824,MATH 142A,A03,093480,Chow; Bennett,9,0,32,23
1658046753824,MATH 142A,B03,093481,Chow; Bennett,8,0,32,24
1658046753824,MATH 142A,B04,093558,Chow; Bennett,14,0,32,18
1658046753824,MATH 142A,B05,093559,Chow; Bennett,7,0,32,25
1658046759847,MATH 193A,A01,083224,Rotar; Vladimir,9,0,34,25
1658046759847,MATH 193A,A02,083225,Rotar; Vladimir,11,0,34,23
1658046759847,MATH 193A,A03,083781,Rotar; Vladimir,5,0,34,29
1658046759847,MATH 193A,A04,083782,Rotar; Vladimir,12,0,34,22
1658046759847,MATH 193A,A05,093482,Rotar; Vladimir,11,0,34,23
1658046765873,MATH 197,001,091859,McAuley; Julian John,9999,0,9999,0
1658046765873,MATH 197,002,095566,Kedlaya; Kiran S.,9997,0,9999,2
1658046765873,MATH 197,003,095567,Xiao; Ming,9999,0,9999,0
1658046765873,MATH 197,004,095571,Perols; Johan Lars,9998,0,9999,1
1658046772925,COGS 9,A01,083615,Shannon; Kyle Michael,11,0,75,64
1658046778954,COGS 11,A01,083617,Boyle; Mary E. T.,23,0,48,25
1658046784981,COGS 13,A01,083071,Bastos; Amalia Pinkusfeld,12,0,71,59
1658046791010,COGS 14A,A01,092681,Semenuks; Arturs,5,1,100,95
1658046797036,COGS 14B,A01,083073,Cheng; Tzu-Han,7,0,63,56
1658046803063,COGS 17,A01,092677,Semenuks; Arturs,7,0,81,74
1658046809087,COGS 100,A01,083619,Allen; Michael Gordon,17,0,70,53
1658046815109,COGS 101A,A01,083621,Davis; Joshua Daniel,9,0,68,59
1658046821147,COGS 101B,A01,091572,Allen; Michael Gordon,14,0,65,51
1658046827173,COGS 101C,A01,083625,Delgado; Tania,17,0,35,18
1658046833195,COGS 107A,A01,083627,Boyle; Mary E. T.,14,0,60,46
1658046839219,COGS 118A,A01,083075,Gupta; Anjum,21,0,76,55
1658046845254,CSE 3,A50,083646,Miranda; Gregory Joseph,24,0,50,26
1658046851276,CSE 8A,A50,083650,Miranda; Gregory Joseph,17,1,56,39
1658046857304,CSE 11,A01,083080,Cao; Yingjun,7,15,40,33
1658046863329,CSE 12,A01,083652,Krause-Levy; Sophia Louisa,30,1,120,90
1658046869353,CSE 15L,A01,083654,Morris; Justin Loren,9,0,50,41
1658046869353,CSE 15L,A02,083655,Morris; Justin Loren,11,0,50,39
1658046875381,CSE 20,A01,083657,Tran; Khoa Dang,39,0,80,41
1658046881405,CSE 21,A01,095574,Bach; Quang Tran,23,0,48,25
1658046887432,CSE 30,A01,083084,Eldon; John,8,0,80,72
1658046887432,CSE 30,B01,095061,Bhaskar; Nishant,9,0,50,41
1658046893454,CSE 100,A01,083659,Cao; Yingjun,5,4,70,65
1658046899492,CSE 134B,A01,083661,Powell; Thomas Allan,25,0,100,75
1658046905515,CSE 140,A01,083663,Gungor; Onat,17,0,85,68
1658046911573,CSE 140L,A01,083088,Eldon; John,23,0,100,77
1658046917596,CSE 175,A01,083665,Kumar; Rakesh,3,0,25,22
1658046923637,CSE 190,A00,092507,Dubnov; Shlomo,8,0,20,12
1658046929661,ECE 45,A01,083139,Congero; Spencer William,7,0,75,68
1658046935691,ECE 65,A50,083695,Saad; Andrew S,12,0,30,18
1658046935691,ECE 65,A51,095125,Saad; Andrew S,24,0,26,2
1658046941717,ECE 109,A01,091882,Touri; Behrouz,21,0,70,49
1658046947740,ECE 180,A00,083140,Abi Samra; Nicholas Camill,1,0,30,29
1658046947740,ECE 180,B00,083141,Abi Samra; Nicholas Camill,0,0,30,30
1658046953764,MATH 10A,A01,083735,Patchell; Gregory David,2,0,30,28
1658046953764,MATH 10A,A02,083736,Patchell; Gregory David,20,0,30,10
1658046953764,MATH 10A,A03,083737,Patchell; Gregory David,16,0,30,14
1658046959804,MATH 10B,A01,083207,Lim; Seonhee,9,0,34,25
1658046959804,MATH 10B,A02,083208,Lim; Seonhee,10,0,35,25
1658046959804,MATH 10B,A03,093472,Lim; Seonhee,7,0,34,27
1658046959804,MATH 10B,B01,083739,Sinha; Shubham,14,0,30,16
1658046965830,MATH 18,A01,083743,Cinel; Cameron Alexander,9,0,30,21
1658046965830,MATH 18,A02,083744,Cinel; Cameron Alexander,18,0,30,12
1658046965830,MATH 18,A03,083745,Cinel; Cameron Alexander,10,0,30,20
1658046965830,MATH 18,B01,083748,Rideout; David Porter,5,0,37,32
1658046965830,MATH 18,B02,083749,Rideout; David Porter,5,0,36,31
1658046965830,MATH 18,B03,083750,Rideout; David Porter,3,0,37,34
1658046965830,MATH 18,B04,083751,Rideout; David Porter,7,0,36,29
1658046965830,MATH 18,B05,093473,Rideout; David Porter,7,0,36,29
1658046965830,MATH 18,B06,093474,Rideout; David Porter,6,0,36,30
1658046971855,MATH 20A,A01,083754,Zheng; Zequn,14,0,40,26
1658046977880,MATH 20B,A01,083756,Briones; Jor-el Thomas Caparas,4,0,36,32
1658046977880,MATH 20B,A02,083757,Briones; Jor-el Thomas Caparas,1,0,36,35
1658046977880,MATH 20B,A03,093475,Briones; Jor-el Thomas Caparas,3,0,36,33
1658046983904,MATH 20C,A01,083760,Briones; Jor-el Thomas Caparas,1,0,35,34
1658046983904,MATH 20C,A02,083761,Briones; Jor-el Thomas Caparas,8,0,35,27
1658046983904,MATH 20C,A03,093476,Briones; Jor-el Thomas Caparas,0,1,36,36
1658046983904,MATH 20C,B01,083762,Bach; Quang Tran,1,0,30,29
1658046989932,MATH 20D,A01,083765,Tran; Brian Kha,5,0,30,25
1658046989932,MATH 20D,A02,083766,Tran; Brian Kha,5,0,30,25
1658046989932,MATH 20D,A03,083767,Tran; Brian Kha,6,0,30,24
1658046995957,MATH 20E,A01,083771,Ganguly; Soumya,12,0,32,20
1658046995957,MATH 20E,A02,083772,Ganguly; Soumya,7,0,32,25
1658046995957,MATH 20E,B01,083773,Ciotti; Benjamin,20,0,35,15
1658046995957,MATH 20E,B02,083774,Ciotti; Benjamin,18,0,35,17
1658047001982,MATH 103A,A01,083777,Greenfeld; Be'Eri,6,0,36,30
1658047001982,MATH 103A,A02,083778,Greenfeld; Be'Eri,5,0,36,31
1658047001982,MATH 103A,A03,093561,Greenfeld; Be'Eri,7,0,36,29
1658047001982,MATH 103A,B01,083779,Greenfeld; Be'Eri,8,0,36,28
1658047001982,MATH 103A,B02,083780,Greenfeld; Be'Eri,4,0,36,32
1658047001982,MATH 103A,B03,093562,Greenfeld; Be'Eri,3,0,36,33
1658047008007,MATH 105,A01,085443,Carter; Anne Toulson,15,0,35,20
1658047008007,MATH 105,A02,093477,Carter; Anne Toulson,20,0,35,15
1658047014033,MATH 109,A01,083213,Ganzberger; Geoffrey Michael,3,0,34,31
1658047014033,MATH 109,A02,083214,Ganzberger; Geoffrey Michael,4,0,34,30
1658047014033,MATH 109,A03,093478,Ganzberger; Geoffrey Michael,2,0,34,32
1658047014033,MATH 109,B01,083215,Ganzberger; Geoffrey Michael,3,0,32,29
1658047014033,MATH 109,B02,083216,Ganzberger; Geoffrey Michael,3,0,32,29
1658047014033,MATH 109,B03,093479,Ganzberger; Geoffrey Michael,8,0,32,24
1658047020062,MATH 142A,A01,083219,Chow; Bennett,7,0,32,25
1658047020062,MATH 142A,A02,083220,Chow; Bennett,10,0,32,22
1658047020062,MATH 142A,A03,093480,Chow; Bennett,9,0,32,23
1658047020062,MATH 142A,B03,093481,Chow; Bennett,8,0,32,24
1658047020062,MATH 142A,B04,093558,Chow; Bennett,14,0,32,18
1658047020062,MATH 142A,B05,093559,Chow; Bennett,7,0,32,25
1658047026091,MATH 193A,A01,083224,Rotar; Vladimir,9,0,34,25
1658047026091,MATH 193A,A02,083225,Rotar; Vladimir,11,0,34,23
1658047026091,MATH 193A,A03,083781,Rotar; Vladimir,5,0,34,29
1658047026091,MATH 193A,A04,083782,Rotar; Vladimir,12,0,34,22
1658047026091,MATH 193A,A05,093482,Rotar; Vladimir,11,0,34,23
1658047032116,MATH 197,001,091859,McAuley; Julian John,9999,0,9999,0
1658047032116,MATH 197,002,095566,Kedlaya; Kiran S.,9997,0,9999,2
1658047032116,MATH 197,003,095567,Xiao; Ming,9999,0,9999,0
1658047032116,MATH 197,004,095571,Perols; Johan Lars,9998,0,9999,1
1658047039175,COGS 9,A01,083615,Shannon; Kyle Michael,11,0,75,64
1658047045209,COGS 11,A01,083617,Boyle; Mary E. T.,23,0,48,25
1658047051233,COGS 13,A01,083071,Bastos; Amalia Pinkusfeld,12,0,71,59
1658047057256,COGS 14A,A01,092681,Semenuks; Arturs,5,1,100,95
1658047063277,COGS 14B,A01,083073,Cheng; Tzu-Han,7,0,63,56
1658047069303,COGS 17,A01,092677,Semenuks; Arturs,7,0,81,74
1658047075326,COGS 100,A01,083619,Allen; Michael Gordon,17,0,70,53
1658047081352,COGS 101A,A01,083621,Davis; Joshua Daniel,9,0,68,59
1658047087373,COGS 101B,A01,091572,Allen; Michael Gordon,14,0,65,51
1658047093486,COGS 101C,A01,083625,Delgado; Tania,17,0,35,18
1658047099517,COGS 107A,A01,083627,Boyle; Mary E. T.,14,0,60,46
1658047105545,COGS 118A,A01,083075,Gupta; Anjum,21,0,76,55
1658047111568,CSE 3,A50,083646,Miranda; Gregory Joseph,24,0,50,26
1658047117593,CSE 8A,A50,083650,Miranda; Gregory Joseph,17,1,56,39
1658047123620,CSE 11,A01,083080,Cao; Yingjun,7,15,40,33
1658047129647,CSE 12,A01,083652,Krause-Levy; Sophia Louisa,30,1,120,90
1658047135673,CSE 15L,A01,083654,Morris; Justin Loren,9,0,50,41
1658047135673,CSE 15L,A02,083655,Morris; Justin Loren,11,0,50,39
1658047141698,CSE 20,A01,083657,Tran; Khoa Dang,39,0,80,41
1658047147721,CSE 21,A01,095574,Bach; Quang Tran,23,0,48,25
1658047153747,CSE 30,A01,083084,Eldon; John,8,0,80,72
1658047153747,CSE 30,B01,095061,Bhaskar; Nishant,9,0,50,41
1658047159785,CSE 100,A01,083659,Cao; Yingjun,5,4,70,65
1658047165807,CSE 134B,A01,083661,Powell; Thomas Allan,25,0,100,75
1658047171832,CSE 140,A01,083663,Gungor; Onat,17,0,85,68
1658047177856,CSE 140L,A01,083088,Eldon; John,23,0,100,77
1658047183880,CSE 175,A01,083665,Kumar; Rakesh,3,0,25,22
1658047189903,CSE 190,A00,092507,Dubnov; Shlomo,8,0,20,12
1658047195940,ECE 45,A01,083139,Congero; Spencer William,7,0,75,68
1658047201969,ECE 65,A50,083695,Saad; Andrew S,12,0,30,18
1658047201969,ECE 65,A51,095125,Saad; Andrew S,24,0,26,2
