time,subj_course_id,sec_code,sec_id,prof,available,waitlist,total,enrolled_ct
1657884376998,COGS 9,A01,083615,Shannon; Kyle Michael,10,0,75,65
1657884383025,COGS 11,A01,083617,Boyle; Mary E. T.,23,0,48,25
1657884389060,COGS 13,A01,083071,Bastos; Amalia Pinkusfeld,11,0,71,60
1657884395090,COGS 14A,A01,092681,Semenuks; Arturs,5,1,100,95
1657884401125,COGS 14B,A01,083073,Cheng; Tzu-Han,6,0,63,57
1657884407157,COGS 17,A01,092677,Semenuks; Arturs,6,0,81,75
1657884413190,COGS 100,A01,083619,Allen; Michael Gordon,17,0,70,53
1657884419223,COGS 101A,A01,083621,Davis; Joshua Daniel,9,0,68,59
1657884425250,COGS 101B,A01,091572,Allen; Michael Gordon,13,0,65,52
1657884431281,COGS 101C,A01,083625,Delgado; Tania,17,0,35,18
1657884437309,COGS 107A,A01,083627,Boyle; Mary E. T.,14,0,60,46
1657884443341,COGS 118A,A01,083075,Gupta; Anjum,21,0,76,55
1657884449377,CSE 3,A50,083646,Miranda; Gregory Joseph,24,0,50,26
1657884455404,CSE 8A,A50,083650,Miranda; Gregory Joseph,17,1,56,39
1657884461431,CSE 11,A01,083080,Cao; Yingjun,6,15,40,34
1657884467465,CSE 12,A01,083652,Krause-Levy; Sophia Louisa,30,1,120,90
1657884473494,CSE 15L,A01,083654,Morris; Justin Loren,9,0,50,41
1657884473494,CSE 15L,A02,083655,Morris; Justin Loren,10,0,50,40
1657884479523,CSE 20,A01,083657,Tran; Khoa Dang,39,0,80,41
1657884485560,CSE 21,A01,095574,Bach; Quang Tran,22,0,48,26
1657884491589,CSE 30,A01,083084,Eldon; John,6,0,80,74
1657884491589,CSE 30,B01,095061,Bhaskar; Nishant,9,0,50,41
1657884497624,CSE 100,A01,083659,Cao; Yingjun,5,4,70,65
1657884503655,CSE 134B,A01,083661,Powell; Thomas Allan,24,0,100,76
1657884509687,CSE 140,A01,083663,Gungor; Onat,15,0,85,70
1657884515715,CSE 140L,A01,083088,Eldon; John,23,0,100,77
1657884521748,CSE 175,A01,083665,Kumar; Rakesh,3,0,25,22
1657884527773,CSE 190,A00,092507,Dubnov; Shlomo,8,0,20,12
1657884533805,ECE 45,A01,083139,Congero; Spencer William,6,0,75,69
1657884539836,ECE 65,A50,083695,Saad; Andrew S,12,0,30,18
1657884539836,ECE 65,A51,095125,Saad; Andrew S,24,0,26,2
1657884545864,ECE 109,A01,091882,Touri; Behrouz,20,0,70,50
1657884551900,ECE 180,A00,083140,Abi Samra; Nicholas Camill,1,0,30,29
1657884551900,ECE 180,B00,083141,Abi Samra; Nicholas Camill,0,0,30,30
1657884557940,MATH 10A,A01,083735,Patchell; Gregory David,2,0,30,28
1657884557940,MATH 10A,A02,083736,Patchell; Gregory David,20,0,30,10
1657884557940,MATH 10A,A03,083737,Patchell; Gregory David,16,0,30,14
1657884563972,MATH 10B,A01,083207,Lim; Seonhee,8,0,34,26
1657884563972,MATH 10B,A02,083208,Lim; Seonhee,10,0,35,25
1657884563972,MATH 10B,A03,093472,Lim; Seonhee,7,0,34,27
1657884563972,MATH 10B,B01,083739,Sinha; Shubham,14,0,30,16
1657884570005,MATH 18,A01,083743,Cinel; Cameron Alexander,9,0,30,21
1657884570005,MATH 18,A02,083744,Cinel; Cameron Alexander,18,0,30,12
1657884570005,MATH 18,A03,083745,Cinel; Cameron Alexander,10,0,30,20
1657884570005,MATH 18,B01,083748,Rideout; David Porter,5,0,37,32
1657884570005,MATH 18,B02,083749,Rideout; David Porter,5,0,36,31
1657884570005,MATH 18,B03,083750,Rideout; David Porter,3,0,37,34
1657884570005,MATH 18,B04,083751,Rideout; David Porter,6,0,36,30
1657884570005,MATH 18,B05,093473,Rideout; David Porter,6,0,36,30
1657884570005,MATH 18,B06,093474,Rideout; David Porter,6,0,36,30
1657884576038,MATH 20A,A01,083754,Zheng; Zequn,14,0,40,26
1657884582069,MATH 20B,A01,083756,Briones; Jor-el Thomas Caparas,4,0,36,32
1657884582069,MATH 20B,A02,083757,Briones; Jor-el Thomas Caparas,1,0,36,35
1657884582069,MATH 20B,A03,093475,Briones; Jor-el Thomas Caparas,2,0,36,34
1657884588100,MATH 20C,A01,083760,Briones; Jor-el Thomas Caparas,1,0,35,34
1657884588100,MATH 20C,A02,083761,Briones; Jor-el Thomas Caparas,8,0,35,27
1657884588100,MATH 20C,A03,093476,Briones; Jor-el Thomas Caparas,0,1,36,36
1657884588100,MATH 20C,B01,083762,Bach; Quang Tran,1,0,30,29
1657884594140,MATH 20D,A01,083765,Tran; Brian Kha,5,0,30,25
1657884594140,MATH 20D,A02,083766,Tran; Brian Kha,5,0,30,25
1657884594140,MATH 20D,A03,083767,Tran; Brian Kha,5,0,30,25
1657884600174,MATH 20E,A01,083771,Ganguly; Soumya,10,0,32,22
1657884600174,MATH 20E,A02,083772,Ganguly; Soumya,6,0,32,26
1657884600174,MATH 20E,B01,083773,Ciotti; Benjamin,20,0,35,15
1657884600174,MATH 20E,B02,083774,Ciotti; Benjamin,18,0,35,17
1657884606223,MATH 103A,A01,083777,Greenfeld; Be'Eri,3,0,36,33
1657884606223,MATH 103A,A02,083778,Greenfeld; Be'Eri,5,0,36,31
1657884606223,MATH 103A,A03,093561,Greenfeld; Be'Eri,6,0,36,30
1657884606223,MATH 103A,B01,083779,Greenfeld; Be'Eri,7,0,36,29
1657884606223,MATH 103A,B02,083780,Greenfeld; Be'Eri,4,0,36,32
1657884606223,MATH 103A,B03,093562,Greenfeld; Be'Eri,3,0,36,33
1657884612257,MATH 105,A01,085443,Carter; Anne Toulson,15,0,35,20
1657884612257,MATH 105,A02,093477,Carter; Anne Toulson,20,0,35,15
1657884618292,MATH 109,A01,083213,Ganzberger; Geoffrey Michael,3,0,34,31
1657884618292,MATH 109,A02,083214,Ganzberger; Geoffrey Michael,4,0,34,30
1657884618292,MATH 109,A03,093478,Ganzberger; Geoffrey Michael,2,0,34,32
1657884618292,MATH 109,B01,083215,Ganzberger; Geoffrey Michael,1,0,32,31
1657884618292,MATH 109,B02,083216,Ganzberger; Geoffrey Michael,2,0,32,30
1657884618292,MATH 109,B03,093479,Ganzberger; Geoffrey Michael,8,0,32,24
1657884624322,MATH 142A,A01,083219,Chow; Bennett,7,0,32,25
1657884624322,MATH 142A,A02,083220,Chow; Bennett,10,0,32,22
1657884624322,MATH 142A,A03,093480,Chow; Bennett,9,0,32,23
1657884624322,MATH 142A,B03,093481,Chow; Bennett,8,0,32,24
1657884624322,MATH 142A,B04,093558,Chow; Bennett,13,0,32,19
1657884624322,MATH 142A,B05,093559,Chow; Bennett,7,0,32,25
1657884630358,MATH 193A,A01,083224,Rotar; Vladimir,8,0,34,26
1657884630358,MATH 193A,A02,083225,Rotar; Vladimir,10,0,34,24
1657884630358,MATH 193A,A03,083781,Rotar; Vladimir,5,0,34,29
1657884630358,MATH 193A,A04,083782,Rotar; Vladimir,11,0,34,23
1657884630358,MATH 193A,A05,093482,Rotar; Vladimir,10,0,34,24
1657884636388,MATH 197,001,091859,McAuley; Julian John,9999,0,9999,0
1657884636388,MATH 197,002,095566,Kedlaya; Kiran S.,9997,0,9999,2
1657884636388,MATH 197,003,095567,Xiao; Ming,9999,0,9999,0
1657884636388,MATH 197,004,095571,Perols; Johan Lars,9998,0,9999,1
1657884643468,COGS 9,A01,083615,Shannon; Kyle Michael,10,0,75,65
1657884649497,COGS 11,A01,083617,Boyle; Mary E. T.,23,0,48,25
1657884655537,COGS 13,A01,083071,Bastos; Amalia Pinkusfeld,11,0,71,60
1657884661563,COGS 14A,A01,092681,Semenuks; Arturs,5,1,100,95
1657884667588,COGS 14B,A01,083073,Cheng; Tzu-Han,6,0,63,57
1657884673617,COGS 17,A01,092677,Semenuks; Arturs,6,0,81,75
1657884679655,COGS 100,A01,083619,Allen; Michael Gordon,17,0,70,53
1657884685688,COGS 101A,A01,083621,Davis; Joshua Daniel,9,0,68,59
1657884691714,COGS 101B,A01,091572,Allen; Michael Gordon,13,0,65,52
1657884697743,COGS 101C,A01,083625,Delgado; Tania,17,0,35,18
1657884714583,COGS 107A,A01,083627,Boyle; Mary E. T.,14,0,60,46
1657884720613,COGS 118A,A01,083075,Gupta; Anjum,21,0,76,55
1657884736289,CSE 3,A50,083646,Miranda; Gregory Joseph,24,0,50,26
1657884742319,CSE 8A,A50,083650,Miranda; Gregory Joseph,17,1,56,39
1657884748402,CSE 11,A01,083080,Cao; Yingjun,6,15,40,34
1657884754430,CSE 12,A01,083652,Krause-Levy; Sophia Louisa,30,1,120,90
1657884760458,CSE 15L,A01,083654,Morris; Justin Loren,9,0,50,41
1657884760458,CSE 15L,A02,083655,Morris; Justin Loren,10,0,50,40
1657884766488,CSE 20,A01,083657,Tran; Khoa Dang,39,0,80,41
1657884772518,CSE 21,A01,095574,Bach; Quang Tran,22,0,48,26
1657884778551,CSE 30,A01,083084,Eldon; John,6,0,80,74
1657884778551,CSE 30,B01,095061,Bhaskar; Nishant,9,0,50,41
1657884784582,CSE 100,A01,083659,Cao; Yingjun,5,4,70,65
1657884790628,CSE 134B,A01,083661,Powell; Thomas Allan,24,0,100,76
1657884796655,CSE 140,A01,083663,Gungor; Onat,15,0,85,70
1657884802682,CSE 140L,A01,083088,Eldon; John,23,0,100,77
1657884808715,CSE 175,A01,083665,Kumar; Rakesh,3,0,25,22
1657884814742,CSE 190,A00,092507,Dubnov; Shlomo,8,0,20,12
1657884820777,ECE 45,A01,083139,Congero; Spencer William,6,0,75,69
1657884826813,ECE 65,A50,083695,Saad; Andrew S,12,0,30,18
1657884826813,ECE 65,A51,095125,Saad; Andrew S,24,0,26,2
1657884832841,ECE 109,A01,091882,Touri; Behrouz,20,0,70,50
1657884838882,ECE 180,A00,083140,Abi Samra; Nicholas Camill,1,0,30,29
1657884838882,ECE 180,B00,083141,Abi Samra; Nicholas Camill,0,0,30,30
1657884844917,MATH 10A,A01,083735,Patchell; Gregory David,2,0,30,28
1657884844917,MATH 10A,A02,083736,Patchell; Gregory David,20,0,30,10
1657884844917,MATH 10A,A03,083737,Patchell; Gregory David,16,0,30,14
1657884850967,MATH 10B,A01,083207,Lim; Seonhee,8,0,34,26
1657884850967,MATH 10B,A02,083208,Lim; Seonhee,10,0,35,25
1657884850967,MATH 10B,A03,093472,Lim; Seonhee,7,0,34,27
1657884850967,MATH 10B,B01,083739,Sinha; Shubham,14,0,30,16
1657884856997,MATH 18,A01,083743,Cinel; Cameron Alexander,9,0,30,21
1657884856997,MATH 18,A02,083744,Cinel; Cameron Alexander,18,0,30,12
1657884856997,MATH 18,A03,083745,Cinel; Cameron Alexander,10,0,30,20
1657884856997,MATH 18,B01,083748,Rideout; David Porter,5,0,37,32
1657884856997,MATH 18,B02,083749,Rideout; David Porter,5,0,36,31
1657884856997,MATH 18,B03,083750,Rideout; David Porter,3,0,37,34
1657884856997,MATH 18,B04,083751,Rideout; David Porter,6,0,36,30
1657884856997,MATH 18,B05,093473,Rideout; David Porter,6,0,36,30
1657884856997,MATH 18,B06,093474,Rideout; David Porter,6,0,36,30
1657884863025,MATH 20A,A01,083754,Zheng; Zequn,14,0,40,26
1657884869064,MATH 20B,A01,083756,Briones; Jor-el Thomas Caparas,4,0,36,32
1657884869064,MATH 20B,A02,083757,Briones; Jor-el Thomas Caparas,1,0,36,35
1657884869064,MATH 20B,A03,093475,Briones; Jor-el Thomas Caparas,2,0,36,34
1657884875104,MATH 20C,A01,083760,Briones; Jor-el Thomas Caparas,1,0,35,34
1657884875104,MATH 20C,A02,083761,Briones; Jor-el Thomas Caparas,8,0,35,27
1657884875104,MATH 20C,A03,093476,Briones; Jor-el Thomas Caparas,0,1,36,36
1657884875104,MATH 20C,B01,083762,Bach; Quang Tran,1,0,30,29
1657884881133,MATH 20D,A01,083765,Tran; Brian Kha,5,0,30,25
1657884881133,MATH 20D,A02,083766,Tran; Brian Kha,5,0,30,25
1657884881133,MATH 20D,A03,083767,Tran; Brian Kha,5,0,30,25
1657884887164,MATH 20E,A01,083771,Ganguly; Soumya,10,0,32,22
1657884887164,MATH 20E,A02,083772,Ganguly; Soumya,6,0,32,26
1657884887164,MATH 20E,B01,083773,Ciotti; Benjamin,20,0,35,15
1657884887164,MATH 20E,B02,083774,Ciotti; Benjamin,18,0,35,17
1657884893196,MATH 103A,A01,083777,Greenfeld; Be'Eri,3,0,36,33
1657884893196,MATH 103A,A02,083778,Greenfeld; Be'Eri,5,0,36,31
1657884893196,MATH 103A,A03,093561,Greenfeld; Be'Eri,6,0,36,30
1657884893196,MATH 103A,B01,083779,Greenfeld; Be'Eri,7,0,36,29
1657884893196,MATH 103A,B02,083780,Greenfeld; Be'Eri,4,0,36,32
1657884893196,MATH 103A,B03,093562,Greenfeld; Be'Eri,3,0,36,33
1657884899226,MATH 105,A01,085443,Carter; Anne Toulson,15,0,35,20
1657884899226,MATH 105,A02,093477,Carter; Anne Toulson,20,0,35,15
1657884905260,MATH 109,A01,083213,Ganzberger; Geoffrey Michael,3,0,34,31
1657884905260,MATH 109,A02,083214,Ganzberger; Geoffrey Michael,4,0,34,30
1657884905260,MATH 109,A03,093478,Ganzberger; Geoffrey Michael,2,0,34,32
1657884905260,MATH 109,B01,083215,Ganzberger; Geoffrey Michael,1,0,32,31
1657884905260,MATH 109,B02,083216,Ganzberger; Geoffrey Michael,2,0,32,30
1657884905260,MATH 109,B03,093479,Ganzberger; Geoffrey Michael,8,0,32,24
1657884911297,MATH 142A,A01,083219,Chow; Bennett,7,0,32,25
1657884911297,MATH 142A,A02,083220,Chow; Bennett,10,0,32,22
1657884911297,MATH 142A,A03,093480,Chow; Bennett,9,0,32,23
1657884911297,MATH 142A,B03,093481,Chow; Bennett,8,0,32,24
1657884911297,MATH 142A,B04,093558,Chow; Bennett,13,0,32,19
1657884911297,MATH 142A,B05,093559,Chow; Bennett,7,0,32,25
1657884917324,MATH 193A,A01,083224,Rotar; Vladimir,8,0,34,26
1657884917324,MATH 193A,A02,083225,Rotar; Vladimir,10,0,34,24
1657884917324,MATH 193A,A03,083781,Rotar; Vladimir,5,0,34,29
1657884917324,MATH 193A,A04,083782,Rotar; Vladimir,11,0,34,23
1657884917324,MATH 193A,A05,093482,Rotar; Vladimir,10,0,34,24
1657884923351,MATH 197,001,091859,McAuley; Julian John,9999,0,9999,0
1657884923351,MATH 197,002,095566,Kedlaya; Kiran S.,9997,0,9999,2
1657884923351,MATH 197,003,095567,Xiao; Ming,9999,0,9999,0
1657884923351,MATH 197,004,095571,Perols; Johan Lars,9998,0,9999,1
1657884930419,COGS 9,A01,083615,Shannon; Kyle Michael,10,0,75,65
1657884936448,COGS 11,A01,083617,Boyle; Mary E. T.,23,0,48,25
1657884942481,COGS 13,A01,083071,Bastos; Amalia Pinkusfeld,11,0,71,60
1657884948514,COGS 14A,A01,092681,Semenuks; Arturs,5,1,100,95
1657884954539,COGS 14B,A01,083073,Cheng; Tzu-Han,6,0,63,57
1657884960565,COGS 17,A01,092677,Semenuks; Arturs,6,0,81,75
1657884966600,COGS 100,A01,083619,Allen; Michael Gordon,17,0,70,53
1657884972696,COGS 101A,A01,083621,Davis; Joshua Daniel,9,0,68,59
1657884978725,COGS 101B,A01,091572,Allen; Michael Gordon,13,0,65,52
1657884984753,COGS 101C,A01,083625,Delgado; Tania,17,0,35,18
1657884990781,COGS 107A,A01,083627,Boyle; Mary E. T.,14,0,60,46
1657884996807,COGS 118A,A01,083075,Gupta; Anjum,21,0,76,55
1657885002842,CSE 3,A50,083646,Miranda; Gregory Joseph,24,0,50,26
1657885008874,CSE 8A,A50,083650,Miranda; Gregory Joseph,17,1,56,39
1657885014900,CSE 11,A01,083080,Cao; Yingjun,6,15,40,34
1657885020928,CSE 12,A01,083652,Krause-Levy; Sophia Louisa,30,1,120,90
1657885026957,CSE 15L,A01,083654,Morris; Justin Loren,9,0,50,41
1657885026957,CSE 15L,A02,083655,Morris; Justin Loren,10,0,50,40
1657885032987,CSE 20,A01,083657,Tran; Khoa Dang,39,0,80,41
1657885039017,CSE 21,A01,095574,Bach; Quang Tran,22,0,48,26
1657885045045,CSE 30,A01,083084,Eldon; John,6,0,80,74
1657885045045,CSE 30,B01,095061,Bhaskar; Nishant,9,0,50,41
1657885051077,CSE 100,A01,083659,Cao; Yingjun,5,4,70,65
1657885057104,CSE 134B,A01,083661,Powell; Thomas Allan,24,0,100,76
1657885063128,CSE 140,A01,083663,Gungor; Onat,15,0,85,70
1657885069157,CSE 140L,A01,083088,Eldon; John,23,0,100,77
1657885075184,CSE 175,A01,083665,Kumar; Rakesh,3,0,25,22
1657885081221,CSE 190,A00,092507,Dubnov; Shlomo,8,0,20,12
1657885087250,ECE 45,A01,083139,Congero; Spencer William,6,0,75,69
1657885093283,ECE 65,A50,083695,Saad; Andrew S,12,0,30,18
1657885093283,ECE 65,A51,095125,Saad; Andrew S,24,0,26,2
1657885099310,ECE 109,A01,091882,Touri; Behrouz,20,0,70,50
1657885105352,ECE 180,A00,083140,Abi Samra; Nicholas Camill,1,0,30,29
1657885105352,ECE 180,B00,083141,Abi Samra; Nicholas Camill,0,0,30,30
1657885111379,MATH 10A,A01,083735,Patchell; Gregory David,2,0,30,28
1657885111379,MATH 10A,A02,083736,Patchell; Gregory David,20,0,30,10
1657885111379,MATH 10A,A03,083737,Patchell; Gregory David,16,0,30,14
1657885117410,MATH 10B,A01,083207,Lim; Seonhee,8,0,34,26
1657885117410,MATH 10B,A02,083208,Lim; Seonhee,10,0,35,25
1657885117410,MATH 10B,A03,093472,Lim; Seonhee,7,0,34,27
1657885117410,MATH 10B,B01,083739,Sinha; Shubham,14,0,30,16
1657885123451,MATH 18,A01,083743,Cinel; Cameron Alexander,9,0,30,21
1657885123451,MATH 18,A02,083744,Cinel; Cameron Alexander,18,0,30,12
1657885123451,MATH 18,A03,083745,Cinel; Cameron Alexander,10,0,30,20
1657885123451,MATH 18,B01,083748,Rideout; David Porter,5,0,37,32
1657885123451,MATH 18,B02,083749,Rideout; David Porter,5,0,36,31
1657885123451,MATH 18,B03,083750,Rideout; David Porter,3,0,37,34
1657885123451,MATH 18,B04,083751,Rideout; David Porter,6,0,36,30
1657885123451,MATH 18,B05,093473,Rideout; David Porter,6,0,36,30
1657885123451,MATH 18,B06,093474,Rideout; David Porter,6,0,36,30
1657885129477,MATH 20A,A01,083754,Zheng; Zequn,14,0,40,26
1657885135512,MATH 20B,A01,083756,Briones; Jor-el Thomas Caparas,4,0,36,32
1657885135512,MATH 20B,A02,083757,Briones; Jor-el Thomas Caparas,1,0,36,35
1657885135512,MATH 20B,A03,093475,Briones; Jor-el Thomas Caparas,2,0,36,34
1657885141544,MATH 20C,A01,083760,Briones; Jor-el Thomas Caparas,1,0,35,34
1657885141544,MATH 20C,A02,083761,Briones; Jor-el Thomas Caparas,8,0,35,27
1657885141544,MATH 20C,A03,093476,Briones; Jor-el Thomas Caparas,0,1,36,36
1657885141544,MATH 20C,B01,083762,Bach; Quang Tran,1,0,30,29
1657885147573,MATH 20D,A01,083765,Tran; Brian Kha,5,0,30,25
1657885147573,MATH 20D,A02,083766,Tran; Brian Kha,5,0,30,25
1657885147573,MATH 20D,A03,083767,Tran; Brian Kha,5,0,30,25
1657885153602,MATH 20E,A01,083771,Ganguly; Soumya,10,0,32,22
1657885153602,MATH 20E,A02,083772,Ganguly; Soumya,6,0,32,26
1657885153602,MATH 20E,B01,083773,Ciotti; Benjamin,20,0,35,15
1657885153602,MATH 20E,B02,083774,Ciotti; Benjamin,18,0,35,17
1657885159633,MATH 103A,A01,083777,Greenfeld; Be'Eri,3,0,36,33
1657885159633,MATH 103A,A02,083778,Greenfeld; Be'Eri,5,0,36,31
1657885159633,MATH 103A,A03,093561,Greenfeld; Be'Eri,6,0,36,30
1657885159633,MATH 103A,B01,083779,Greenfeld; Be'Eri,7,0,36,29
1657885159633,MATH 103A,B02,083780,Greenfeld; Be'Eri,4,0,36,32
1657885159633,MATH 103A,B03,093562,Greenfeld; Be'Eri,3,0,36,33
1657885165665,MATH 105,A01,085443,Carter; Anne Toulson,15,0,35,20
1657885165665,MATH 105,A02,093477,Carter; Anne Toulson,20,0,35,15
1657885171698,MATH 109,A01,083213,Ganzberger; Geoffrey Michael,3,0,34,31
1657885171698,MATH 109,A02,083214,Ganzberger; Geoffrey Michael,4,0,34,30
1657885171698,MATH 109,A03,093478,Ganzberger; Geoffrey Michael,2,0,34,32
1657885171698,MATH 109,B01,083215,Ganzberger; Geoffrey Michael,1,0,32,31
1657885171698,MATH 109,B02,083216,Ganzberger; Geoffrey Michael,2,0,32,30
1657885171698,MATH 109,B03,093479,Ganzberger; Geoffrey Michael,8,0,32,24
1657885177725,MATH 142A,A01,083219,Chow; Bennett,7,0,32,25
1657885177725,MATH 142A,A02,083220,Chow; Bennett,10,0,32,22
1657885177725,MATH 142A,A03,093480,Chow; Bennett,9,0,32,23
1657885177725,MATH 142A,B03,093481,Chow; Bennett,8,0,32,24
1657885177725,MATH 142A,B04,093558,Chow; Bennett,13,0,32,19
1657885177725,MATH 142A,B05,093559,Chow; Bennett,7,0,32,25
1657885183750,MATH 193A,A01,083224,Rotar; Vladimir,8,0,34,26
1657885183750,MATH 193A,A02,083225,Rotar; Vladimir,10,0,34,24
1657885183750,MATH 193A,A03,083781,Rotar; Vladimir,5,0,34,29
1657885183750,MATH 193A,A04,083782,Rotar; Vladimir,11,0,34,23
1657885183750,MATH 193A,A05,093482,Rotar; Vladimir,10,0,34,24
1657885189782,MATH 197,001,091859,McAuley; Julian John,9999,0,9999,0
1657885189782,MATH 197,002,095566,Kedlaya; Kiran S.,9997,0,9999,2
1657885189782,MATH 197,003,095567,Xiao; Ming,9999,0,9999,0
1657885189782,MATH 197,004,095571,Perols; Johan Lars,9998,0,9999,1
1657885196849,COGS 9,A01,083615,Shannon; Kyle Michael,10,0,75,65
1657885202883,COGS 11,A01,083617,Boyle; Mary E. T.,23,0,48,25
1657885208913,COGS 13,A01,083071,Bastos; Amalia Pinkusfeld,11,0,71,60
1657885214945,COGS 14A,A01,092681,Semenuks; Arturs,5,1,100,95
1657885220969,COGS 14B,A01,083073,Cheng; Tzu-Han,6,0,63,57
1657885226994,COGS 17,A01,092677,Semenuks; Arturs,6,0,81,75
1657885233021,COGS 100,A01,083619,Allen; Michael Gordon,17,0,70,53
1657885239050,COGS 101A,A01,083621,Davis; Joshua Daniel,9,0,68,59
1657885245076,COGS 101B,A01,091572,Allen; Michael Gordon,13,0,65,52
1657885251106,COGS 101C,A01,083625,Delgado; Tania,17,0,35,18
1657885257130,COGS 107A,A01,083627,Boyle; Mary E. T.,14,0,60,46
1657885263160,COGS 118A,A01,083075,Gupta; Anjum,21,0,76,55
1657885269197,CSE 3,A50,083646,Miranda; Gregory Joseph,24,0,50,26
1657885275226,CSE 8A,A50,083650,Miranda; Gregory Joseph,17,1,56,39
1657885281255,CSE 11,A01,083080,Cao; Yingjun,6,15,40,34
1657885287284,CSE 12,A01,083652,Krause-Levy; Sophia Louisa,30,1,120,90
1657885293309,CSE 15L,A01,083654,Morris; Justin Loren,9,0,50,41
1657885293309,CSE 15L,A02,083655,Morris; Justin Loren,10,0,50,40
1657885299334,CSE 20,A01,083657,Tran; Khoa Dang,39,0,80,41
1657885305361,CSE 21,A01,095574,Bach; Quang Tran,22,0,48,26
1657885311388,CSE 30,A01,083084,Eldon; John,6,0,80,74
1657885311388,CSE 30,B01,095061,Bhaskar; Nishant,9,0,50,41
1657885317424,CSE 100,A01,083659,Cao; Yingjun,5,4,70,65
1657885323453,CSE 134B,A01,083661,Powell; Thomas Allan,24,0,100,76
1657885329485,CSE 140,A01,083663,Gungor; Onat,15,0,85,70
1657885335511,CSE 140L,A01,083088,Eldon; John,23,0,100,77
1657885341544,CSE 175,A01,083665,Kumar; Rakesh,3,0,25,22
1657885347573,CSE 190,A00,092507,Dubnov; Shlomo,8,0,20,12
1657885353609,ECE 45,A01,083139,Congero; Spencer William,6,0,75,69
1657885359638,ECE 65,A50,083695,Saad; Andrew S,12,0,30,18
1657885359638,ECE 65,A51,095125,Saad; Andrew S,24,0,26,2
1657885365665,ECE 109,A01,091882,Touri; Behrouz,20,0,70,50
1657885371691,ECE 180,A00,083140,Abi Samra; Nicholas Camill,1,0,30,29
1657885371691,ECE 180,B00,083141,Abi Samra; Nicholas Camill,0,0,30,30
1657885377721,MATH 10A,A01,083735,Patchell; Gregory David,2,0,30,28
1657885377721,MATH 10A,A02,083736,Patchell; Gregory David,20,0,30,10
1657885377721,MATH 10A,A03,083737,Patchell; Gregory David,16,0,30,14
1657885383750,MATH 10B,A01,083207,Lim; Seonhee,8,0,34,26
1657885383750,MATH 10B,A02,083208,Lim; Seonhee,10,0,35,25
1657885383750,MATH 10B,A03,093472,Lim; Seonhee,7,0,34,27
1657885383750,MATH 10B,B01,083739,Sinha; Shubham,14,0,30,16
1657885389791,MATH 18,A01,083743,Cinel; Cameron Alexander,9,0,30,21
1657885389791,MATH 18,A02,083744,Cinel; Cameron Alexander,18,0,30,12
1657885389791,MATH 18,A03,083745,Cinel; Cameron Alexander,10,0,30,20
1657885389791,MATH 18,B01,083748,Rideout; David Porter,5,0,37,32
1657885389791,MATH 18,B02,083749,Rideout; David Porter,5,0,36,31
1657885389791,MATH 18,B03,083750,Rideout; David Porter,3,0,37,34
1657885389791,MATH 18,B04,083751,Rideout; David Porter,6,0,36,30
1657885389791,MATH 18,B05,093473,Rideout; David Porter,6,0,36,30
1657885389791,MATH 18,B06,093474,Rideout; David Porter,6,0,36,30
1657885395816,MATH 20A,A01,083754,Zheng; Zequn,14,0,40,26
1657885401841,MATH 20B,A01,083756,Briones; Jor-el Thomas Caparas,4,0,36,32
1657885401841,MATH 20B,A02,083757,Briones; Jor-el Thomas Caparas,1,0,36,35
1657885401841,MATH 20B,A03,093475,Briones; Jor-el Thomas Caparas,2,0,36,34
1657885407868,MATH 20C,A01,083760,Briones; Jor-el Thomas Caparas,1,0,35,34
1657885407868,MATH 20C,A02,083761,Briones; Jor-el Thomas Caparas,8,0,35,27
1657885407868,MATH 20C,A03,093476,Briones; Jor-el Thomas Caparas,0,1,36,36
1657885407868,MATH 20C,B01,083762,Bach; Quang Tran,1,0,30,29
1657885413894,MATH 20D,A01,083765,Tran; Brian Kha,5,0,30,25
1657885413894,MATH 20D,A02,083766,Tran; Brian Kha,5,0,30,25
1657885413894,MATH 20D,A03,083767,Tran; Brian Kha,5,0,30,25
1657885419922,MATH 20E,A01,083771,Ganguly; Soumya,10,0,32,22
1657885419922,MATH 20E,A02,083772,Ganguly; Soumya,6,0,32,26
1657885419922,MATH 20E,B01,083773,Ciotti; Benjamin,20,0,35,15
1657885419922,MATH 20E,B02,083774,Ciotti; Benjamin,18,0,35,17
1657885425949,MATH 103A,A01,083777,Greenfeld; Be'Eri,3,0,36,33
1657885425949,MATH 103A,A02,083778,Greenfeld; Be'Eri,5,0,36,31
1657885425949,MATH 103A,A03,093561,Greenfeld; Be'Eri,6,0,36,30
1657885425949,MATH 103A,B01,083779,Greenfeld; Be'Eri,7,0,36,29
1657885425949,MATH 103A,B02,083780,Greenfeld; Be'Eri,4,0,36,32
1657885425949,MATH 103A,B03,093562,Greenfeld; Be'Eri,3,0,36,33
1657885431981,MATH 105,A01,085443,Carter; Anne Toulson,15,0,35,20
1657885431981,MATH 105,A02,093477,Carter; Anne Toulson,20,0,35,15
1657885438010,MATH 109,A01,083213,Ganzberger; Geoffrey Michael,3,0,34,31
1657885438010,MATH 109,A02,083214,Ganzberger; Geoffrey Michael,4,0,34,30
1657885438010,MATH 109,A03,093478,Ganzberger; Geoffrey Michael,2,0,34,32
1657885438010,MATH 109,B01,083215,Ganzberger; Geoffrey Michael,1,0,32,31
1657885438010,MATH 109,B02,083216,Ganzberger; Geoffrey Michael,2,0,32,30
1657885438010,MATH 109,B03,093479,Ganzberger; Geoffrey Michael,8,0,32,24
1657885444037,MATH 142A,A01,083219,Chow; Bennett,7,0,32,25
1657885444037,MATH 142A,A02,083220,Chow; Bennett,10,0,32,22
1657885444037,MATH 142A,A03,093480,Chow; Bennett,9,0,32,23
1657885444037,MATH 142A,B03,093481,Chow; Bennett,8,0,32,24
1657885444037,MATH 142A,B04,093558,Chow; Bennett,13,0,32,19
1657885444037,MATH 142A,B05,093559,Chow; Bennett,7,0,32,25
1657885450066,MATH 193A,A01,083224,Rotar; Vladimir,8,0,34,26
1657885450066,MATH 193A,A02,083225,Rotar; Vladimir,10,0,34,24
1657885450066,MATH 193A,A03,083781,Rotar; Vladimir,5,0,34,29
1657885450066,MATH 193A,A04,083782,Rotar; Vladimir,11,0,34,23
1657885450066,MATH 193A,A05,093482,Rotar; Vladimir,10,0,34,24
1657885456092,MATH 197,001,091859,McAuley; Julian John,9999,0,9999,0
1657885456092,MATH 197,002,095566,Kedlaya; Kiran S.,9997,0,9999,2
1657885456092,MATH 197,003,095567,Xiao; Ming,9999,0,9999,0
1657885456092,MATH 197,004,095571,Perols; Johan Lars,9998,0,9999,1
1657885463654,COGS 9,A01,083615,Shannon; Kyle Michael,10,0,75,65
1657885469682,COGS 11,A01,083617,Boyle; Mary E. T.,23,0,48,25
1657885475711,COGS 13,A01,083071,Bastos; Amalia Pinkusfeld,11,0,71,60
1657885481738,COGS 14A,A01,092681,Semenuks; Arturs,5,1,100,95
1657885487766,COGS 14B,A01,083073,Cheng; Tzu-Han,6,0,63,57
1657885493793,COGS 17,A01,092677,Semenuks; Arturs,6,0,81,75
1657885499819,COGS 100,A01,083619,Allen; Michael Gordon,17,0,70,53
1657885505844,COGS 101A,A01,083621,Davis; Joshua Daniel,9,0,68,59
1657885511879,COGS 101B,A01,091572,Allen; Michael Gordon,13,0,65,52
1657885517905,COGS 101C,A01,083625,Delgado; Tania,17,0,35,18
1657885523931,COGS 107A,A01,083627,Boyle; Mary E. T.,14,0,60,46
1657885529957,COGS 118A,A01,083075,Gupta; Anjum,21,0,76,55
1657885535985,CSE 3,A50,083646,Miranda; Gregory Joseph,24,0,50,26
1657885542010,CSE 8A,A50,083650,Miranda; Gregory Joseph,17,1,56,39
1657885548039,CSE 11,A01,083080,Cao; Yingjun,6,15,40,34
1657885554071,CSE 12,A01,083652,Krause-Levy; Sophia Louisa,30,1,120,90
1657885560099,CSE 15L,A01,083654,Morris; Justin Loren,9,0,50,41
1657885560099,CSE 15L,A02,083655,Morris; Justin Loren,10,0,50,40
1657885566131,CSE 20,A01,083657,Tran; Khoa Dang,39,0,80,41
1657885572231,CSE 21,A01,095574,Bach; Quang Tran,22,0,48,26
1657885578259,CSE 30,A01,083084,Eldon; John,6,0,80,74
1657885578259,CSE 30,B01,095061,Bhaskar; Nishant,9,0,50,41
1657885584284,CSE 100,A01,083659,Cao; Yingjun,5,4,70,65
1657885590309,CSE 134B,A01,083661,Powell; Thomas Allan,24,0,100,76
1657885596339,CSE 140,A01,083663,Gungor; Onat,15,0,85,70
1657885602365,CSE 140L,A01,083088,Eldon; John,23,0,100,77
1657885608391,CSE 175,A01,083665,Kumar; Rakesh,3,0,25,22
1657885614419,CSE 190,A00,092507,Dubnov; Shlomo,8,0,20,12
1657885620453,ECE 45,A01,083139,Congero; Spencer William,6,0,75,69
1657885626484,ECE 65,A50,083695,Saad; Andrew S,12,0,30,18
1657885626484,ECE 65,A51,095125,Saad; Andrew S,24,0,26,2
1657885632511,ECE 109,A01,091882,Touri; Behrouz,20,0,70,50
1657885638553,ECE 180,A00,083140,Abi Samra; Nicholas Camill,1,0,30,29
1657885638553,ECE 180,B00,083141,Abi Samra; Nicholas Camill,0,0,30,30
1657885644581,MATH 10A,A01,083735,Patchell; Gregory David,2,0,30,28
1657885644581,MATH 10A,A02,083736,Patchell; Gregory David,20,0,30,10
1657885644581,MATH 10A,A03,083737,Patchell; Gregory David,16,0,30,14
1657885650614,MATH 10B,A01,083207,Lim; Seonhee,8,0,34,26
1657885650614,MATH 10B,A02,083208,Lim; Seonhee,10,0,35,25
1657885650614,MATH 10B,A03,093472,Lim; Seonhee,7,0,34,27
1657885650614,MATH 10B,B01,083739,Sinha; Shubham,14,0,30,16
1657885656645,MATH 18,A01,083743,Cinel; Cameron Alexander,9,0,30,21
1657885656645,MATH 18,A02,083744,Cinel; Cameron Alexander,18,0,30,12
1657885656645,MATH 18,A03,083745,Cinel; Cameron Alexander,10,0,30,20
1657885656645,MATH 18,B01,083748,Rideout; David Porter,5,0,37,32
1657885656645,MATH 18,B02,083749,Rideout; David Porter,5,0,36,31
1657885656645,MATH 18,B03,083750,Rideout; David Porter,3,0,37,34
1657885656645,MATH 18,B04,083751,Rideout; David Porter,6,0,36,30
1657885656645,MATH 18,B05,093473,Rideout; David Porter,6,0,36,30
1657885656645,MATH 18,B06,093474,Rideout; David Porter,6,0,36,30
1657885662673,MATH 20A,A01,083754,Zheng; Zequn,14,0,40,26
1657885668709,MATH 20B,A01,083756,Briones; Jor-el Thomas Caparas,4,0,36,32
1657885668709,MATH 20B,A02,083757,Briones; Jor-el Thomas Caparas,1,0,36,35
1657885668709,MATH 20B,A03,093475,Briones; Jor-el Thomas Caparas,2,0,36,34
1657885674742,MATH 20C,A01,083760,Briones; Jor-el Thomas Caparas,1,0,35,34
1657885674742,MATH 20C,A02,083761,Briones; Jor-el Thomas Caparas,8,0,35,27
1657885674742,MATH 20C,A03,093476,Briones; Jor-el Thomas Caparas,0,1,36,36
1657885674742,MATH 20C,B01,083762,Bach; Quang Tran,1,0,30,29
1657885680769,MATH 20D,A01,083765,Tran; Brian Kha,5,0,30,25
1657885680769,MATH 20D,A02,083766,Tran; Brian Kha,5,0,30,25
1657885680769,MATH 20D,A03,083767,Tran; Brian Kha,5,0,30,25
1657885686809,MATH 20E,A01,083771,Ganguly; Soumya,10,0,32,22
1657885686809,MATH 20E,A02,083772,Ganguly; Soumya,6,0,32,26
1657885686809,MATH 20E,B01,083773,Ciotti; Benjamin,20,0,35,15
1657885686809,MATH 20E,B02,083774,Ciotti; Benjamin,18,0,35,17
1657885692838,MATH 103A,A01,083777,Greenfeld; Be'Eri,3,0,36,33
1657885692838,MATH 103A,A02,083778,Greenfeld; Be'Eri,5,0,36,31
1657885692838,MATH 103A,A03,093561,Greenfeld; Be'Eri,6,0,36,30
1657885692838,MATH 103A,B01,083779,Greenfeld; Be'Eri,7,0,36,29
1657885692838,MATH 103A,B02,083780,Greenfeld; Be'Eri,4,0,36,32
1657885692838,MATH 103A,B03,093562,Greenfeld; Be'Eri,3,0,36,33
1657885698867,MATH 105,A01,085443,Carter; Anne Toulson,15,0,35,20
1657885698867,MATH 105,A02,093477,Carter; Anne Toulson,20,0,35,15
1657885704904,MATH 109,A01,083213,Ganzberger; Geoffrey Michael,3,0,34,31
1657885704904,MATH 109,A02,083214,Ganzberger; Geoffrey Michael,4,0,34,30
1657885704904,MATH 109,A03,093478,Ganzberger; Geoffrey Michael,2,0,34,32
1657885704904,MATH 109,B01,083215,Ganzberger; Geoffrey Michael,1,0,32,31
1657885704904,MATH 109,B02,083216,Ganzberger; Geoffrey Michael,2,0,32,30
1657885704904,MATH 109,B03,093479,Ganzberger; Geoffrey Michael,8,0,32,24
1657885710934,MATH 142A,A01,083219,Chow; Bennett,7,0,32,25
1657885710934,MATH 142A,A02,083220,Chow; Bennett,10,0,32,22
1657885710934,MATH 142A,A03,093480,Chow; Bennett,9,0,32,23
1657885710934,MATH 142A,B03,093481,Chow; Bennett,8,0,32,24
1657885710934,MATH 142A,B04,093558,Chow; Bennett,13,0,32,19
1657885710934,MATH 142A,B05,093559,Chow; Bennett,7,0,32,25
1657885716966,MATH 193A,A01,083224,Rotar; Vladimir,8,0,34,26
1657885716966,MATH 193A,A02,083225,Rotar; Vladimir,10,0,34,24
1657885716966,MATH 193A,A03,083781,Rotar; Vladimir,5,0,34,29
1657885716966,MATH 193A,A04,083782,Rotar; Vladimir,11,0,34,23
1657885716966,MATH 193A,A05,093482,Rotar; Vladimir,10,0,34,24
1657885722994,MATH 197,001,091859,McAuley; Julian John,9999,0,9999,0
1657885722994,MATH 197,002,095566,Kedlaya; Kiran S.,9997,0,9999,2
1657885722994,MATH 197,003,095567,Xiao; Ming,9999,0,9999,0
1657885722994,MATH 197,004,095571,Perols; Johan Lars,9998,0,9999,1
1657885730079,COGS 9,A01,083615,Shannon; Kyle Michael,10,0,75,65
1657885736109,COGS 11,A01,083617,Boyle; Mary E. T.,23,0,48,25
1657885742136,COGS 13,A01,083071,Bastos; Amalia Pinkusfeld,11,0,71,60
1657885748166,COGS 14A,A01,092681,Semenuks; Arturs,5,1,100,95
1657885754194,COGS 14B,A01,083073,Cheng; Tzu-Han,6,0,63,57
1657885760222,COGS 17,A01,092677,Semenuks; Arturs,6,0,81,75
1657885766254,COGS 100,A01,083619,Allen; Michael Gordon,17,0,70,53
1657885772283,COGS 101A,A01,083621,Davis; Joshua Daniel,9,0,68,59
1657885778313,COGS 101B,A01,091572,Allen; Michael Gordon,13,0,65,52
1657885784344,COGS 101C,A01,083625,Delgado; Tania,17,0,35,18
1657885790370,COGS 107A,A01,083627,Boyle; Mary E. T.,14,0,60,46
1657885796397,COGS 118A,A01,083075,Gupta; Anjum,21,0,76,55
1657885802434,CSE 3,A50,083646,Miranda; Gregory Joseph,24,0,50,26
1657885808464,CSE 8A,A50,083650,Miranda; Gregory Joseph,17,1,56,39
1657885814496,CSE 11,A01,083080,Cao; Yingjun,6,15,40,34
1657885820530,CSE 12,A01,083652,Krause-Levy; Sophia Louisa,30,1,120,90
1657885826560,CSE 15L,A01,083654,Morris; Justin Loren,9,0,50,41
1657885826560,CSE 15L,A02,083655,Morris; Justin Loren,10,0,50,40
1657885832590,CSE 20,A01,083657,Tran; Khoa Dang,39,0,80,41
1657885838618,CSE 21,A01,095574,Bach; Quang Tran,22,0,48,26
1657885844646,CSE 30,A01,083084,Eldon; John,6,0,80,74
1657885844646,CSE 30,B01,095061,Bhaskar; Nishant,9,0,50,41
1657885850676,CSE 100,A01,083659,Cao; Yingjun,5,4,70,65
1657885856707,CSE 134B,A01,083661,Powell; Thomas Allan,24,0,100,76
1657885862732,CSE 140,A01,083663,Gungor; Onat,15,0,85,70
1657885868760,CSE 140L,A01,083088,Eldon; John,23,0,100,77
1657885874787,CSE 175,A01,083665,Kumar; Rakesh,3,0,25,22
1657885880815,CSE 190,A00,092507,Dubnov; Shlomo,8,0,20,12
1657885886846,ECE 45,A01,083139,Congero; Spencer William,6,0,75,69
1657885892872,ECE 65,A50,083695,Saad; Andrew S,12,0,30,18
1657885892872,ECE 65,A51,095125,Saad; Andrew S,24,0,26,2
1657885898903,ECE 109,A01,091882,Touri; Behrouz,20,0,70,50
1657885904931,ECE 180,A00,083140,Abi Samra; Nicholas Camill,1,0,30,29
1657885904931,ECE 180,B00,083141,Abi Samra; Nicholas Camill,0,0,30,30
1657885910960,MATH 10A,A01,083735,Patchell; Gregory David,2,0,30,28
1657885910960,MATH 10A,A02,083736,Patchell; Gregory David,20,0,30,10
1657885910960,MATH 10A,A03,083737,Patchell; Gregory David,16,0,30,14
1657885917007,MATH 10B,A01,083207,Lim; Seonhee,8,0,34,26
1657885917007,MATH 10B,A02,083208,Lim; Seonhee,10,0,35,25
1657885917007,MATH 10B,A03,093472,Lim; Seonhee,7,0,34,27
1657885917007,MATH 10B,B01,083739,Sinha; Shubham,14,0,30,16
1657885923039,MATH 18,A01,083743,Cinel; Cameron Alexander,9,0,30,21
1657885923039,MATH 18,A02,083744,Cinel; Cameron Alexander,18,0,30,12
1657885923039,MATH 18,A03,083745,Cinel; Cameron Alexander,10,0,30,20
1657885923039,MATH 18,B01,083748,Rideout; David Porter,5,0,37,32
1657885923039,MATH 18,B02,083749,Rideout; David Porter,5,0,36,31
1657885923039,MATH 18,B03,083750,Rideout; David Porter,3,0,37,34
1657885923039,MATH 18,B04,083751,Rideout; David Porter,6,0,36,30
1657885923039,MATH 18,B05,093473,Rideout; David Porter,6,0,36,30
1657885923039,MATH 18,B06,093474,Rideout; David Porter,6,0,36,30
1657885929064,MATH 20A,A01,083754,Zheng; Zequn,14,0,40,26
1657885935092,MATH 20B,A01,083756,Briones; Jor-el Thomas Caparas,4,0,36,32
1657885935092,MATH 20B,A02,083757,Briones; Jor-el Thomas Caparas,1,0,36,35
1657885935092,MATH 20B,A03,093475,Briones; Jor-el Thomas Caparas,2,0,36,34
1657885941124,MATH 20C,A01,083760,Briones; Jor-el Thomas Caparas,1,0,35,34
1657885941124,MATH 20C,A02,083761,Briones; Jor-el Thomas Caparas,8,0,35,27
1657885941124,MATH 20C,A03,093476,Briones; Jor-el Thomas Caparas,0,1,36,36
1657885941124,MATH 20C,B01,083762,Bach; Quang Tran,1,0,30,29
1657885947153,MATH 20D,A01,083765,Tran; Brian Kha,5,0,30,25
1657885947153,MATH 20D,A02,083766,Tran; Brian Kha,5,0,30,25
1657885947153,MATH 20D,A03,083767,Tran; Brian Kha,5,0,30,25
1657885953187,MATH 20E,A01,083771,Ganguly; Soumya,10,0,32,22
1657885953187,MATH 20E,A02,083772,Ganguly; Soumya,6,0,32,26
1657885953187,MATH 20E,B01,083773,Ciotti; Benjamin,20,0,35,15
1657885953187,MATH 20E,B02,083774,Ciotti; Benjamin,18,0,35,17
1657885959217,MATH 103A,A01,083777,Greenfeld; Be'Eri,3,0,36,33
1657885959217,MATH 103A,A02,083778,Greenfeld; Be'Eri,5,0,36,31
1657885959217,MATH 103A,A03,093561,Greenfeld; Be'Eri,6,0,36,30
1657885959217,MATH 103A,B01,083779,Greenfeld; Be'Eri,7,0,36,29
1657885959217,MATH 103A,B02,083780,Greenfeld; Be'Eri,4,0,36,32
1657885959217,MATH 103A,B03,093562,Greenfeld; Be'Eri,3,0,36,33
1657885965246,MATH 105,A01,085443,Carter; Anne Toulson,15,0,35,20
1657885965246,MATH 105,A02,093477,Carter; Anne Toulson,20,0,35,15
1657885971274,MATH 109,A01,083213,Ganzberger; Geoffrey Michael,3,0,34,31
1657885971274,MATH 109,A02,083214,Ganzberger; Geoffrey Michael,4,0,34,30
1657885971274,MATH 109,A03,093478,Ganzberger; Geoffrey Michael,2,0,34,32
1657885971274,MATH 109,B01,083215,Ganzberger; Geoffrey Michael,1,0,32,31
1657885971274,MATH 109,B02,083216,Ganzberger; Geoffrey Michael,2,0,32,30
1657885971274,MATH 109,B03,093479,Ganzberger; Geoffrey Michael,8,0,32,24
1657885977308,MATH 142A,A01,083219,Chow; Bennett,7,0,32,25
1657885977308,MATH 142A,A02,083220,Chow; Bennett,10,0,32,22
1657885977308,MATH 142A,A03,093480,Chow; Bennett,9,0,32,23
1657885977308,MATH 142A,B03,093481,Chow; Bennett,8,0,32,24
1657885977308,MATH 142A,B04,093558,Chow; Bennett,13,0,32,19
1657885977308,MATH 142A,B05,093559,Chow; Bennett,7,0,32,25
1657885983335,MATH 193A,A01,083224,Rotar; Vladimir,8,0,34,26
1657885983335,MATH 193A,A02,083225,Rotar; Vladimir,10,0,34,24
1657885983335,MATH 193A,A03,083781,Rotar; Vladimir,5,0,34,29
1657885983335,MATH 193A,A04,083782,Rotar; Vladimir,11,0,34,23
1657885983335,MATH 193A,A05,093482,Rotar; Vladimir,10,0,34,24
1657885989360,MATH 197,001,091859,McAuley; Julian John,9999,0,9999,0
1657885989360,MATH 197,002,095566,Kedlaya; Kiran S.,9997,0,9999,2
1657885989360,MATH 197,003,095567,Xiao; Ming,9999,0,9999,0
1657885989360,MATH 197,004,095571,Perols; Johan Lars,9998,0,9999,1
1657885996433,COGS 9,A01,083615,Shannon; Kyle Michael,10,0,75,65
1657886002461,COGS 11,A01,083617,Boyle; Mary E. T.,23,0,48,25
1657886008488,COGS 13,A01,083071,Bastos; Amalia Pinkusfeld,11,0,71,60
1657886014514,COGS 14A,A01,092681,Semenuks; Arturs,5,1,100,95
1657886020546,COGS 14B,A01,083073,Cheng; Tzu-Han,6,0,63,57
1657886026573,COGS 17,A01,092677,Semenuks; Arturs,6,0,81,75
1657886032614,COGS 100,A01,083619,Allen; Michael Gordon,17,0,70,53
1657886038640,COGS 101A,A01,083621,Davis; Joshua Daniel,9,0,68,59
1657886044665,COGS 101B,A01,091572,Allen; Michael Gordon,13,0,65,52
1657886050694,COGS 101C,A01,083625,Delgado; Tania,17,0,35,18
1657886056719,COGS 107A,A01,083627,Boyle; Mary E. T.,14,0,60,46
1657886062745,COGS 118A,A01,083075,Gupta; Anjum,21,0,76,55
1657886068772,CSE 3,A50,083646,Miranda; Gregory Joseph,24,0,50,26
1657886074798,CSE 8A,A50,083650,Miranda; Gregory Joseph,17,1,56,39
1657886080829,CSE 11,A01,083080,Cao; Yingjun,6,15,40,34
1657886086861,CSE 12,A01,083652,Krause-Levy; Sophia Louisa,30,1,120,90
1657886092888,CSE 15L,A01,083654,Morris; Justin Loren,9,0,50,41
1657886092888,CSE 15L,A02,083655,Morris; Justin Loren,10,0,50,40
1657886098916,CSE 20,A01,083657,Tran; Khoa Dang,39,0,80,41
1657886104948,CSE 21,A01,095574,Bach; Quang Tran,22,0,48,26
1657886110985,CSE 30,A01,083084,Eldon; John,6,0,80,74
1657886110985,CSE 30,B01,095061,Bhaskar; Nishant,9,0,50,41
1657886117015,CSE 100,A01,083659,Cao; Yingjun,5,4,70,65
1657886123042,CSE 134B,A01,083661,Powell; Thomas Allan,24,0,100,76
1657886129073,CSE 140,A01,083663,Gungor; Onat,15,0,85,70
1657886135098,CSE 140L,A01,083088,Eldon; John,23,0,100,77
1657886141131,CSE 175,A01,083665,Kumar; Rakesh,3,0,25,22
1657886147173,CSE 190,A00,092507,Dubnov; Shlomo,8,0,20,12
1657886153207,ECE 45,A01,083139,Congero; Spencer William,6,0,75,69
1657886159235,ECE 65,A50,083695,Saad; Andrew S,12,0,30,18
1657886159235,ECE 65,A51,095125,Saad; Andrew S,24,0,26,2
1657886165263,ECE 109,A01,091882,Touri; Behrouz,20,0,70,50
1657886171377,ECE 180,A00,083140,Abi Samra; Nicholas Camill,1,0,30,29
1657886171377,ECE 180,B00,083141,Abi Samra; Nicholas Camill,0,0,30,30
1657886177404,MATH 10A,A01,083735,Patchell; Gregory David,2,0,30,28
1657886177404,MATH 10A,A02,083736,Patchell; Gregory David,20,0,30,10
1657886177404,MATH 10A,A03,083737,Patchell; Gregory David,16,0,30,14
1657886183440,MATH 10B,A01,083207,Lim; Seonhee,8,0,34,26
1657886183440,MATH 10B,A02,083208,Lim; Seonhee,10,0,35,25
1657886183440,MATH 10B,A03,093472,Lim; Seonhee,7,0,34,27
1657886183440,MATH 10B,B01,083739,Sinha; Shubham,14,0,30,16
1657886189479,MATH 18,A01,083743,Cinel; Cameron Alexander,9,0,30,21
1657886189479,MATH 18,A02,083744,Cinel; Cameron Alexander,18,0,30,12
1657886189479,MATH 18,A03,083745,Cinel; Cameron Alexander,10,0,30,20
1657886189479,MATH 18,B01,083748,Rideout; David Porter,5,0,37,32
1657886189479,MATH 18,B02,083749,Rideout; David Porter,5,0,36,31
1657886189479,MATH 18,B03,083750,Rideout; David Porter,3,0,37,34
1657886189479,MATH 18,B04,083751,Rideout; David Porter,6,0,36,30
1657886189479,MATH 18,B05,093473,Rideout; David Porter,6,0,36,30
1657886189479,MATH 18,B06,093474,Rideout; David Porter,6,0,36,30
1657886195504,MATH 20A,A01,083754,Zheng; Zequn,14,0,40,26
1657886201532,MATH 20B,A01,083756,Briones; Jor-el Thomas Caparas,4,0,36,32
1657886201532,MATH 20B,A02,083757,Briones; Jor-el Thomas Caparas,1,0,36,35
1657886201532,MATH 20B,A03,093475,Briones; Jor-el Thomas Caparas,2,0,36,34
1657886207558,MATH 20C,A01,083760,Briones; Jor-el Thomas Caparas,1,0,35,34
1657886207558,MATH 20C,A02,083761,Briones; Jor-el Thomas Caparas,8,0,35,27
1657886207558,MATH 20C,A03,093476,Briones; Jor-el Thomas Caparas,0,1,36,36
1657886207558,MATH 20C,B01,083762,Bach; Quang Tran,1,0,30,29
1657886213587,MATH 20D,A01,083765,Tran; Brian Kha,5,0,30,25
1657886213587,MATH 20D,A02,083766,Tran; Brian Kha,5,0,30,25
1657886213587,MATH 20D,A03,083767,Tran; Brian Kha,5,0,30,25
1657886219614,MATH 20E,A01,083771,Ganguly; Soumya,10,0,32,22
1657886219614,MATH 20E,A02,083772,Ganguly; Soumya,6,0,32,26
1657886219614,MATH 20E,B01,083773,Ciotti; Benjamin,20,0,35,15
1657886219614,MATH 20E,B02,083774,Ciotti; Benjamin,18,0,35,17
1657886225643,MATH 103A,A01,083777,Greenfeld; Be'Eri,3,0,36,33
1657886225643,MATH 103A,A02,083778,Greenfeld; Be'Eri,5,0,36,31
1657886225643,MATH 103A,A03,093561,Greenfeld; Be'Eri,6,0,36,30
1657886225643,MATH 103A,B01,083779,Greenfeld; Be'Eri,7,0,36,29
1657886225643,MATH 103A,B02,083780,Greenfeld; Be'Eri,4,0,36,32
1657886225643,MATH 103A,B03,093562,Greenfeld; Be'Eri,3,0,36,33
1657886231671,MATH 105,A01,085443,Carter; Anne Toulson,15,0,35,20
1657886231671,MATH 105,A02,093477,Carter; Anne Toulson,20,0,35,15
1657886237709,MATH 109,A01,083213,Ganzberger; Geoffrey Michael,3,0,34,31
1657886237709,MATH 109,A02,083214,Ganzberger; Geoffrey Michael,4,0,34,30
1657886237709,MATH 109,A03,093478,Ganzberger; Geoffrey Michael,2,0,34,32
1657886237709,MATH 109,B01,083215,Ganzberger; Geoffrey Michael,1,0,32,31
1657886237709,MATH 109,B02,083216,Ganzberger; Geoffrey Michael,2,0,32,30
1657886237709,MATH 109,B03,093479,Ganzberger; Geoffrey Michael,8,0,32,24
1657886243736,MATH 142A,A01,083219,Chow; Bennett,7,0,32,25
1657886243736,MATH 142A,A02,083220,Chow; Bennett,10,0,32,22
1657886243736,MATH 142A,A03,093480,Chow; Bennett,9,0,32,23
1657886243736,MATH 142A,B03,093481,Chow; Bennett,8,0,32,24
1657886243736,MATH 142A,B04,093558,Chow; Bennett,13,0,32,19
1657886243736,MATH 142A,B05,093559,Chow; Bennett,7,0,32,25
1657886249763,MATH 193A,A01,083224,Rotar; Vladimir,8,0,34,26
1657886249763,MATH 193A,A02,083225,Rotar; Vladimir,10,0,34,24
1657886249763,MATH 193A,A03,083781,Rotar; Vladimir,5,0,34,29
1657886249763,MATH 193A,A04,083782,Rotar; Vladimir,11,0,34,23
1657886249763,MATH 193A,A05,093482,Rotar; Vladimir,10,0,34,24
1657886255791,MATH 197,001,091859,McAuley; Julian John,9999,0,9999,0
1657886255791,MATH 197,002,095566,Kedlaya; Kiran S.,9997,0,9999,2
1657886255791,MATH 197,003,095567,Xiao; Ming,9999,0,9999,0
1657886255791,MATH 197,004,095571,Perols; Johan Lars,9998,0,9999,1
1657886262852,COGS 9,A01,083615,Shannon; Kyle Michael,10,0,75,65
1657886268882,COGS 11,A01,083617,Boyle; Mary E. T.,23,0,48,25
1657886274908,COGS 13,A01,083071,Bastos; Amalia Pinkusfeld,11,0,71,60
1657886280938,COGS 14A,A01,092681,Semenuks; Arturs,5,1,100,95
1657886286967,COGS 14B,A01,083073,Cheng; Tzu-Han,6,0,63,57
1657886292996,COGS 17,A01,092677,Semenuks; Arturs,6,0,81,75
1657886299020,COGS 100,A01,083619,Allen; Michael Gordon,17,0,70,53
1657886305052,COGS 101A,A01,083621,Davis; Joshua Daniel,9,0,68,59
1657886311088,COGS 101B,A01,091572,Allen; Michael Gordon,13,0,65,52
1657886317114,COGS 101C,A01,083625,Delgado; Tania,17,0,35,18
1657886323143,COGS 107A,A01,083627,Boyle; Mary E. T.,14,0,60,46
1657886329172,COGS 118A,A01,083075,Gupta; Anjum,21,0,76,55
1657886335197,CSE 3,A50,083646,Miranda; Gregory Joseph,24,0,50,26
1657886341230,CSE 8A,A50,083650,Miranda; Gregory Joseph,17,1,56,39
1657886347255,CSE 11,A01,083080,Cao; Yingjun,6,15,40,34
1657886353282,CSE 12,A01,083652,Krause-Levy; Sophia Louisa,30,1,120,90
1657886359307,CSE 15L,A01,083654,Morris; Justin Loren,9,0,50,41
1657886359307,CSE 15L,A02,083655,Morris; Justin Loren,10,0,50,40
1657886365332,CSE 20,A01,083657,Tran; Khoa Dang,39,0,80,41
1657886371367,CSE 21,A01,095574,Bach; Quang Tran,22,0,48,26
1657886377394,CSE 30,A01,083084,Eldon; John,6,0,80,74
1657886377394,CSE 30,B01,095061,Bhaskar; Nishant,9,0,50,41
1657886383419,CSE 100,A01,083659,Cao; Yingjun,5,4,70,65
1657886389446,CSE 134B,A01,083661,Powell; Thomas Allan,24,0,100,76
1657886395477,CSE 140,A01,083663,Gungor; Onat,15,0,85,70
1657886401509,CSE 140L,A01,083088,Eldon; John,23,0,100,77
1657886407539,CSE 175,A01,083665,Kumar; Rakesh,3,0,25,22
1657886413564,CSE 190,A00,092507,Dubnov; Shlomo,8,0,20,12
1657886419595,ECE 45,A01,083139,Congero; Spencer William,6,0,75,69
1657886425627,ECE 65,A50,083695,Saad; Andrew S,12,0,30,18
1657886425627,ECE 65,A51,095125,Saad; Andrew S,24,0,26,2
1657886431652,ECE 109,A01,091882,Touri; Behrouz,20,0,70,50
1657886437677,ECE 180,A00,083140,Abi Samra; Nicholas Camill,1,0,30,29
1657886437677,ECE 180,B00,083141,Abi Samra; Nicholas Camill,0,0,30,30
1657886443709,MATH 10A,A01,083735,Patchell; Gregory David,2,0,30,28
1657886443709,MATH 10A,A02,083736,Patchell; Gregory David,20,0,30,10
1657886443709,MATH 10A,A03,083737,Patchell; Gregory David,16,0,30,14
1657886449738,MATH 10B,A01,083207,Lim; Seonhee,8,0,34,26
1657886449738,MATH 10B,A02,083208,Lim; Seonhee,10,0,35,25
1657886449738,MATH 10B,A03,093472,Lim; Seonhee,7,0,34,27
1657886449738,MATH 10B,B01,083739,Sinha; Shubham,14,0,30,16
1657886455766,MATH 18,A01,083743,Cinel; Cameron Alexander,9,0,30,21
1657886455766,MATH 18,A02,083744,Cinel; Cameron Alexander,18,0,30,12
1657886455766,MATH 18,A03,083745,Cinel; Cameron Alexander,10,0,30,20
1657886455766,MATH 18,B01,083748,Rideout; David Porter,5,0,37,32
1657886455766,MATH 18,B02,083749,Rideout; David Porter,5,0,36,31
1657886455766,MATH 18,B03,083750,Rideout; David Porter,3,0,37,34
1657886455766,MATH 18,B04,083751,Rideout; David Porter,6,0,36,30
1657886455766,MATH 18,B05,093473,Rideout; David Porter,6,0,36,30
1657886455766,MATH 18,B06,093474,Rideout; David Porter,6,0,36,30
1657886461811,MATH 20A,A01,083754,Zheng; Zequn,14,0,40,26
1657886467841,MATH 20B,A01,083756,Briones; Jor-el Thomas Caparas,4,0,36,32
1657886467841,MATH 20B,A02,083757,Briones; Jor-el Thomas Caparas,1,0,36,35
1657886467841,MATH 20B,A03,093475,Briones; Jor-el Thomas Caparas,2,0,36,34
1657886473866,MATH 20C,A01,083760,Briones; Jor-el Thomas Caparas,1,0,35,34
1657886473866,MATH 20C,A02,083761,Briones; Jor-el Thomas Caparas,8,0,35,27
1657886473866,MATH 20C,A03,093476,Briones; Jor-el Thomas Caparas,0,1,36,36
1657886473866,MATH 20C,B01,083762,Bach; Quang Tran,1,0,30,29
1657886479898,MATH 20D,A01,083765,Tran; Brian Kha,5,0,30,25
1657886479898,MATH 20D,A02,083766,Tran; Brian Kha,5,0,30,25
1657886479898,MATH 20D,A03,083767,Tran; Brian Kha,5,0,30,25
1657886485930,MATH 20E,A01,083771,Ganguly; Soumya,10,0,32,22
1657886485930,MATH 20E,A02,083772,Ganguly; Soumya,6,0,32,26
1657886485930,MATH 20E,B01,083773,Ciotti; Benjamin,20,0,35,15
1657886485930,MATH 20E,B02,083774,Ciotti; Benjamin,18,0,35,17
1657886491964,MATH 103A,A01,083777,Greenfeld; Be'Eri,3,0,36,33
1657886491964,MATH 103A,A02,083778,Greenfeld; Be'Eri,5,0,36,31
1657886491964,MATH 103A,A03,093561,Greenfeld; Be'Eri,6,0,36,30
1657886491964,MATH 103A,B01,083779,Greenfeld; Be'Eri,7,0,36,29
1657886491964,MATH 103A,B02,083780,Greenfeld; Be'Eri,4,0,36,32
1657886491964,MATH 103A,B03,093562,Greenfeld; Be'Eri,3,0,36,33
1657886497994,MATH 105,A01,085443,Carter; Anne Toulson,15,0,35,20
1657886497994,MATH 105,A02,093477,Carter; Anne Toulson,20,0,35,15
1657886504040,MATH 109,A01,083213,Ganzberger; Geoffrey Michael,3,0,34,31
1657886504040,MATH 109,A02,083214,Ganzberger; Geoffrey Michael,4,0,34,30
1657886504040,MATH 109,A03,093478,Ganzberger; Geoffrey Michael,2,0,34,32
1657886504040,MATH 109,B01,083215,Ganzberger; Geoffrey Michael,1,0,32,31
1657886504040,MATH 109,B02,083216,Ganzberger; Geoffrey Michael,2,0,32,30
1657886504040,MATH 109,B03,093479,Ganzberger; Geoffrey Michael,8,0,32,24
1657886510070,MATH 142A,A01,083219,Chow; Bennett,7,0,32,25
1657886510070,MATH 142A,A02,083220,Chow; Bennett,10,0,32,22
1657886510070,MATH 142A,A03,093480,Chow; Bennett,9,0,32,23
1657886510070,MATH 142A,B03,093481,Chow; Bennett,8,0,32,24
1657886510070,MATH 142A,B04,093558,Chow; Bennett,13,0,32,19
1657886510070,MATH 142A,B05,093559,Chow; Bennett,7,0,32,25
1657886516101,MATH 193A,A01,083224,Rotar; Vladimir,8,0,34,26
1657886516101,MATH 193A,A02,083225,Rotar; Vladimir,10,0,34,24
1657886516101,MATH 193A,A03,083781,Rotar; Vladimir,5,0,34,29
1657886516101,MATH 193A,A04,083782,Rotar; Vladimir,11,0,34,23
1657886516101,MATH 193A,A05,093482,Rotar; Vladimir,10,0,34,24
1657886522127,MATH 197,001,091859,McAuley; Julian John,9999,0,9999,0
1657886522127,MATH 197,002,095566,Kedlaya; Kiran S.,9997,0,9999,2
1657886522127,MATH 197,003,095567,Xiao; Ming,9999,0,9999,0
1657886522127,MATH 197,004,095571,Perols; Johan Lars,9998,0,9999,1
1657886529192,COGS 9,A01,083615,Shannon; Kyle Michael,10,0,75,65
1657886535216,COGS 11,A01,083617,Boyle; Mary E. T.,23,0,48,25
1657886541242,COGS 13,A01,083071,Bastos; Amalia Pinkusfeld,11,0,71,60
1657886547273,COGS 14A,A01,092681,Semenuks; Arturs,5,1,100,95
1657886553299,COGS 14B,A01,083073,Cheng; Tzu-Han,6,0,63,57
1657886559332,COGS 17,A01,092677,Semenuks; Arturs,6,0,81,75
1657886565359,COGS 100,A01,083619,Allen; Michael Gordon,17,0,70,53
1657886571389,COGS 101A,A01,083621,Davis; Joshua Daniel,9,0,68,59
1657886577413,COGS 101B,A01,091572,Allen; Michael Gordon,13,0,65,52
1657886583438,COGS 101C,A01,083625,Delgado; Tania,17,0,35,18
1657886589466,COGS 107A,A01,083627,Boyle; Mary E. T.,14,0,60,46
1657886595514,COGS 118A,A01,083075,Gupta; Anjum,21,0,76,55
1657886601552,CSE 3,A50,083646,Miranda; Gregory Joseph,24,0,50,26
1657886607579,CSE 8A,A50,083650,Miranda; Gregory Joseph,17,1,56,39
1657886613605,CSE 11,A01,083080,Cao; Yingjun,6,15,40,34
1657886619645,CSE 12,A01,083652,Krause-Levy; Sophia Louisa,30,1,120,90
1657886625670,CSE 15L,A01,083654,Morris; Justin Loren,9,0,50,41
1657886625670,CSE 15L,A02,083655,Morris; Justin Loren,10,0,50,40
1657886631695,CSE 20,A01,083657,Tran; Khoa Dang,39,0,80,41
1657886637722,CSE 21,A01,095574,Bach; Quang Tran,22,0,48,26
1657886643751,CSE 30,A01,083084,Eldon; John,6,0,80,74
1657886643751,CSE 30,B01,095061,Bhaskar; Nishant,9,0,50,41
1657886649777,CSE 100,A01,083659,Cao; Yingjun,5,4,70,65
1657886655810,CSE 134B,A01,083661,Powell; Thomas Allan,24,0,100,76
1657886661838,CSE 140,A01,083663,Gungor; Onat,15,0,85,70
1657886667874,CSE 140L,A01,083088,Eldon; John,23,0,100,77
1657886673901,CSE 175,A01,083665,Kumar; Rakesh,3,0,25,22
1657886679935,CSE 190,A00,092507,Dubnov; Shlomo,8,0,20,12
1657886685969,ECE 45,A01,083139,Congero; Spencer William,6,0,75,69
1657886691996,ECE 65,A50,083695,Saad; Andrew S,12,0,30,18
1657886691996,ECE 65,A51,095125,Saad; Andrew S,24,0,26,2
1657886698022,ECE 109,A01,091882,Touri; Behrouz,20,0,70,50
1657886704052,ECE 180,A00,083140,Abi Samra; Nicholas Camill,1,0,30,29
1657886704052,ECE 180,B00,083141,Abi Samra; Nicholas Camill,0,0,30,30
1657886710079,MATH 10A,A01,083735,Patchell; Gregory David,2,0,30,28
1657886710079,MATH 10A,A02,083736,Patchell; Gregory David,20,0,30,10
1657886710079,MATH 10A,A03,083737,Patchell; Gregory David,16,0,30,14
1657886716116,MATH 10B,A01,083207,Lim; Seonhee,8,0,34,26
1657886716116,MATH 10B,A02,083208,Lim; Seonhee,10,0,35,25
1657886716116,MATH 10B,A03,093472,Lim; Seonhee,7,0,34,27
1657886716116,MATH 10B,B01,083739,Sinha; Shubham,14,0,30,16
1657886722145,MATH 18,A01,083743,Cinel; Cameron Alexander,9,0,30,21
1657886722145,MATH 18,A02,083744,Cinel; Cameron Alexander,18,0,30,12
1657886722145,MATH 18,A03,083745,Cinel; Cameron Alexander,10,0,30,20
1657886722145,MATH 18,B01,083748,Rideout; David Porter,5,0,37,32
1657886722145,MATH 18,B02,083749,Rideout; David Porter,5,0,36,31
1657886722145,MATH 18,B03,083750,Rideout; David Porter,3,0,37,34
1657886722145,MATH 18,B04,083751,Rideout; David Porter,6,0,36,30
1657886722145,MATH 18,B05,093473,Rideout; David Porter,6,0,36,30
1657886722145,MATH 18,B06,093474,Rideout; David Porter,6,0,36,30
1657886728179,MATH 20A,A01,083754,Zheng; Zequn,14,0,40,26
1657886734209,MATH 20B,A01,083756,Briones; Jor-el Thomas Caparas,4,0,36,32
1657886734209,MATH 20B,A02,083757,Briones; Jor-el Thomas Caparas,1,0,36,35
1657886734209,MATH 20B,A03,093475,Briones; Jor-el Thomas Caparas,2,0,36,34
1657886740236,MATH 20C,A01,083760,Briones; Jor-el Thomas Caparas,1,0,35,34
1657886740236,MATH 20C,A02,083761,Briones; Jor-el Thomas Caparas,8,0,35,27
1657886740236,MATH 20C,A03,093476,Briones; Jor-el Thomas Caparas,0,1,36,36
1657886740236,MATH 20C,B01,083762,Bach; Quang Tran,1,0,30,29
1657886746268,MATH 20D,A01,083765,Tran; Brian Kha,5,0,30,25
1657886746268,MATH 20D,A02,083766,Tran; Brian Kha,5,0,30,25
1657886746268,MATH 20D,A03,083767,Tran; Brian Kha,5,0,30,25
1657886752297,MATH 20E,A01,083771,Ganguly; Soumya,10,0,32,22
1657886752297,MATH 20E,A02,083772,Ganguly; Soumya,6,0,32,26
1657886752297,MATH 20E,B01,083773,Ciotti; Benjamin,20,0,35,15
1657886752297,MATH 20E,B02,083774,Ciotti; Benjamin,18,0,35,17
1657886758339,MATH 103A,A01,083777,Greenfeld; Be'Eri,3,0,36,33
1657886758339,MATH 103A,A02,083778,Greenfeld; Be'Eri,5,0,36,31
1657886758339,MATH 103A,A03,093561,Greenfeld; Be'Eri,6,0,36,30
1657886758339,MATH 103A,B01,083779,Greenfeld; Be'Eri,7,0,36,29
1657886758339,MATH 103A,B02,083780,Greenfeld; Be'Eri,4,0,36,32
1657886758339,MATH 103A,B03,093562,Greenfeld; Be'Eri,3,0,36,33
1657886764367,MATH 105,A01,085443,Carter; Anne Toulson,15,0,35,20
1657886764367,MATH 105,A02,093477,Carter; Anne Toulson,20,0,35,15
1657886770483,MATH 109,A01,083213,Ganzberger; Geoffrey Michael,3,0,34,31
1657886770483,MATH 109,A02,083214,Ganzberger; Geoffrey Michael,4,0,34,30
1657886770483,MATH 109,A03,093478,Ganzberger; Geoffrey Michael,2,0,34,32
1657886770483,MATH 109,B01,083215,Ganzberger; Geoffrey Michael,1,0,32,31
1657886770483,MATH 109,B02,083216,Ganzberger; Geoffrey Michael,2,0,32,30
1657886770483,MATH 109,B03,093479,Ganzberger; Geoffrey Michael,8,0,32,24
1657886776519,MATH 142A,A01,083219,Chow; Bennett,7,0,32,25
1657886776519,MATH 142A,A02,083220,Chow; Bennett,10,0,32,22
1657886776519,MATH 142A,A03,093480,Chow; Bennett,9,0,32,23
1657886776519,MATH 142A,B03,093481,Chow; Bennett,8,0,32,24
1657886776519,MATH 142A,B04,093558,Chow; Bennett,13,0,32,19
1657886776519,MATH 142A,B05,093559,Chow; Bennett,7,0,32,25
1657886782548,MATH 193A,A01,083224,Rotar; Vladimir,8,0,34,26
1657886782548,MATH 193A,A02,083225,Rotar; Vladimir,10,0,34,24
1657886782548,MATH 193A,A03,083781,Rotar; Vladimir,5,0,34,29
1657886782548,MATH 193A,A04,083782,Rotar; Vladimir,11,0,34,23
1657886782548,MATH 193A,A05,093482,Rotar; Vladimir,10,0,34,24
1657886788580,MATH 197,001,091859,McAuley; Julian John,9999,0,9999,0
1657886788580,MATH 197,002,095566,Kedlaya; Kiran S.,9997,0,9999,2
1657886788580,MATH 197,003,095567,Xiao; Ming,9999,0,9999,0
1657886788580,MATH 197,004,095571,Perols; Johan Lars,9998,0,9999,1
1657886795679,COGS 9,A01,083615,Shannon; Kyle Michael,10,0,75,65
1657886801705,COGS 11,A01,083617,Boyle; Mary E. T.,23,0,48,25
1657886807744,COGS 13,A01,083071,Bastos; Amalia Pinkusfeld,11,0,71,60
1657886813776,COGS 14A,A01,092681,Semenuks; Arturs,5,1,100,95
1657886819801,COGS 14B,A01,083073,Cheng; Tzu-Han,6,0,63,57
1657886825828,COGS 17,A01,092677,Semenuks; Arturs,6,0,81,75
1657886831854,COGS 100,A01,083619,Allen; Michael Gordon,17,0,70,53
1657886837880,COGS 101A,A01,083621,Davis; Joshua Daniel,9,0,68,59
1657886843904,COGS 101B,A01,091572,Allen; Michael Gordon,13,0,65,52
1657886849929,COGS 101C,A01,083625,Delgado; Tania,17,0,35,18
1657886855954,COGS 107A,A01,083627,Boyle; Mary E. T.,14,0,60,46
1657886861981,COGS 118A,A01,083075,Gupta; Anjum,21,0,76,55
1657886868008,CSE 3,A50,083646,Miranda; Gregory Joseph,24,0,50,26
1657886874034,CSE 8A,A50,083650,Miranda; Gregory Joseph,17,1,56,39
1657886880059,CSE 11,A01,083080,Cao; Yingjun,6,15,40,34
1657886886088,CSE 12,A01,083652,Krause-Levy; Sophia Louisa,30,1,120,90
1657886892113,CSE 15L,A01,083654,Morris; Justin Loren,9,0,50,41
1657886892113,CSE 15L,A02,083655,Morris; Justin Loren,10,0,50,40
1657886898137,CSE 20,A01,083657,Tran; Khoa Dang,39,0,80,41
1657886904163,CSE 21,A01,095574,Bach; Quang Tran,22,0,48,26
1657886910196,CSE 30,A01,083084,Eldon; John,6,0,80,74
1657886910196,CSE 30,B01,095061,Bhaskar; Nishant,9,0,50,41
1657886916226,CSE 100,A01,083659,Cao; Yingjun,5,4,70,65
1657886922252,CSE 134B,A01,083661,Powell; Thomas Allan,24,0,100,76
1657886928281,CSE 140,A01,083663,Gungor; Onat,15,0,85,70
1657886934306,CSE 140L,A01,083088,Eldon; John,23,0,100,77
1657886940335,CSE 175,A01,083665,Kumar; Rakesh,3,0,25,22
1657886946361,CSE 190,A00,092507,Dubnov; Shlomo,8,0,20,12
1657886952395,ECE 45,A01,083139,Congero; Spencer William,6,0,75,69
1657886958419,ECE 65,A50,083695,Saad; Andrew S,12,0,30,18
1657886958419,ECE 65,A51,095125,Saad; Andrew S,24,0,26,2
1657886964451,ECE 109,A01,091882,Touri; Behrouz,20,0,70,50
1657886970478,ECE 180,A00,083140,Abi Samra; Nicholas Camill,1,0,30,29
1657886970478,ECE 180,B00,083141,Abi Samra; Nicholas Camill,0,0,30,30
1657886976505,MATH 10A,A01,083735,Patchell; Gregory David,2,0,30,28
1657886976505,MATH 10A,A02,083736,Patchell; Gregory David,20,0,30,10
1657886976505,MATH 10A,A03,083737,Patchell; Gregory David,16,0,30,14
1657886982534,MATH 10B,A01,083207,Lim; Seonhee,8,0,34,26
1657886982534,MATH 10B,A02,083208,Lim; Seonhee,10,0,35,25
1657886982534,MATH 10B,A03,093472,Lim; Seonhee,7,0,34,27
1657886982534,MATH 10B,B01,083739,Sinha; Shubham,14,0,30,16
1657886988564,MATH 18,A01,083743,Cinel; Cameron Alexander,9,0,30,21
1657886988564,MATH 18,A02,083744,Cinel; Cameron Alexander,18,0,30,12
1657886988564,MATH 18,A03,083745,Cinel; Cameron Alexander,10,0,30,20
1657886988564,MATH 18,B01,083748,Rideout; David Porter,5,0,37,32
1657886988564,MATH 18,B02,083749,Rideout; David Porter,5,0,36,31
1657886988564,MATH 18,B03,083750,Rideout; David Porter,3,0,37,34
1657886988564,MATH 18,B04,083751,Rideout; David Porter,6,0,36,30
1657886988564,MATH 18,B05,093473,Rideout; David Porter,6,0,36,30
1657886988564,MATH 18,B06,093474,Rideout; David Porter,6,0,36,30
1657886994593,MATH 20A,A01,083754,Zheng; Zequn,14,0,40,26
1657887000624,MATH 20B,A01,083756,Briones; Jor-el Thomas Caparas,4,0,36,32
1657887000624,MATH 20B,A02,083757,Briones; Jor-el Thomas Caparas,1,0,36,35
1657887000624,MATH 20B,A03,093475,Briones; Jor-el Thomas Caparas,2,0,36,34
1657887006659,MATH 20C,A01,083760,Briones; Jor-el Thomas Caparas,1,0,35,34
1657887006659,MATH 20C,A02,083761,Briones; Jor-el Thomas Caparas,8,0,35,27
1657887006659,MATH 20C,A03,093476,Briones; Jor-el Thomas Caparas,0,1,36,36
1657887006659,MATH 20C,B01,083762,Bach; Quang Tran,1,0,30,29
1657887012685,MATH 20D,A01,083765,Tran; Brian Kha,5,0,30,25
1657887012685,MATH 20D,A02,083766,Tran; Brian Kha,5,0,30,25
1657887012685,MATH 20D,A03,083767,Tran; Brian Kha,5,0,30,25
1657887018713,MATH 20E,A01,083771,Ganguly; Soumya,10,0,32,22
1657887018713,MATH 20E,A02,083772,Ganguly; Soumya,6,0,32,26
1657887018713,MATH 20E,B01,083773,Ciotti; Benjamin,20,0,35,15
1657887018713,MATH 20E,B02,083774,Ciotti; Benjamin,18,0,35,17
1657887024749,MATH 103A,A01,083777,Greenfeld; Be'Eri,3,0,36,33
1657887024749,MATH 103A,A02,083778,Greenfeld; Be'Eri,5,0,36,31
1657887024749,MATH 103A,A03,093561,Greenfeld; Be'Eri,6,0,36,30
1657887024749,MATH 103A,B01,083779,Greenfeld; Be'Eri,7,0,36,29
1657887024749,MATH 103A,B02,083780,Greenfeld; Be'Eri,4,0,36,32
1657887024749,MATH 103A,B03,093562,Greenfeld; Be'Eri,3,0,36,33
1657887030780,MATH 105,A01,085443,Carter; Anne Toulson,15,0,35,20
1657887030780,MATH 105,A02,093477,Carter; Anne Toulson,20,0,35,15
1657887036805,MATH 109,A01,083213,Ganzberger; Geoffrey Michael,3,0,34,31
1657887036805,MATH 109,A02,083214,Ganzberger; Geoffrey Michael,4,0,34,30
1657887036805,MATH 109,A03,093478,Ganzberger; Geoffrey Michael,2,0,34,32
1657887036805,MATH 109,B01,083215,Ganzberger; Geoffrey Michael,1,0,32,31
1657887036805,MATH 109,B02,083216,Ganzberger; Geoffrey Michael,2,0,32,30
1657887036805,MATH 109,B03,093479,Ganzberger; Geoffrey Michael,8,0,32,24
1657887042842,MATH 142A,A01,083219,Chow; Bennett,7,0,32,25
1657887042842,MATH 142A,A02,083220,Chow; Bennett,10,0,32,22
1657887042842,MATH 142A,A03,093480,Chow; Bennett,9,0,32,23
1657887042842,MATH 142A,B03,093481,Chow; Bennett,8,0,32,24
1657887042842,MATH 142A,B04,093558,Chow; Bennett,13,0,32,19
1657887042842,MATH 142A,B05,093559,Chow; Bennett,7,0,32,25
1657887048869,MATH 193A,A01,083224,Rotar; Vladimir,8,0,34,26
1657887048869,MATH 193A,A02,083225,Rotar; Vladimir,10,0,34,24
1657887048869,MATH 193A,A03,083781,Rotar; Vladimir,5,0,34,29
1657887048869,MATH 193A,A04,083782,Rotar; Vladimir,11,0,34,23
1657887048869,MATH 193A,A05,093482,Rotar; Vladimir,10,0,34,24
1657887054900,MATH 197,001,091859,McAuley; Julian John,9999,0,9999,0
1657887054900,MATH 197,002,095566,Kedlaya; Kiran S.,9997,0,9999,2
1657887054900,MATH 197,003,095567,Xiao; Ming,9999,0,9999,0
1657887054900,MATH 197,004,095571,Perols; Johan Lars,9998,0,9999,1
1657887061960,COGS 9,A01,083615,Shannon; Kyle Michael,10,0,75,65
1657887067986,COGS 11,A01,083617,Boyle; Mary E. T.,23,0,48,25
1657887074018,COGS 13,A01,083071,Bastos; Amalia Pinkusfeld,11,0,71,60
1657887080042,COGS 14A,A01,092681,Semenuks; Arturs,5,1,100,95
1657887086069,COGS 14B,A01,083073,Cheng; Tzu-Han,6,0,63,57
1657887092094,COGS 17,A01,092677,Semenuks; Arturs,6,0,81,75
1657887098122,COGS 100,A01,083619,Allen; Michael Gordon,17,0,70,53
1657887104147,COGS 101A,A01,083621,Davis; Joshua Daniel,9,0,68,59
1657887110173,COGS 101B,A01,091572,Allen; Michael Gordon,13,0,65,52
1657887116197,COGS 101C,A01,083625,Delgado; Tania,17,0,35,18
1657887122233,COGS 107A,A01,083627,Boyle; Mary E. T.,14,0,60,46
1657887128264,COGS 118A,A01,083075,Gupta; Anjum,21,0,76,55
1657887134304,CSE 3,A50,083646,Miranda; Gregory Joseph,24,0,50,26
1657887140331,CSE 8A,A50,083650,Miranda; Gregory Joseph,17,1,56,39
1657887146356,CSE 11,A01,083080,Cao; Yingjun,6,15,40,34
1657887152388,CSE 12,A01,083652,Krause-Levy; Sophia Louisa,30,1,120,90
1657887158418,CSE 15L,A01,083654,Morris; Justin Loren,9,0,50,41
1657887158418,CSE 15L,A02,083655,Morris; Justin Loren,10,0,50,40
1657887164444,CSE 20,A01,083657,Tran; Khoa Dang,39,0,80,41
1657887170469,CSE 21,A01,095574,Bach; Quang Tran,22,0,48,26
1657887176496,CSE 30,A01,083084,Eldon; John,6,0,80,74
1657887176496,CSE 30,B01,095061,Bhaskar; Nishant,9,0,50,41
1657887182521,CSE 100,A01,083659,Cao; Yingjun,5,4,70,65
1657887188551,CSE 134B,A01,083661,Powell; Thomas Allan,24,0,100,76
1657887194582,CSE 140,A01,083663,Gungor; Onat,15,0,85,70
1657887200606,CSE 140L,A01,083088,Eldon; John,23,0,100,77
1657887206636,CSE 175,A01,083665,Kumar; Rakesh,3,0,25,22
1657887212661,CSE 190,A00,092507,Dubnov; Shlomo,8,0,20,12
1657887218693,ECE 45,A01,083139,Congero; Spencer William,6,0,75,69
1657887224720,ECE 65,A50,083695,Saad; Andrew S,12,0,30,18
1657887224720,ECE 65,A51,095125,Saad; Andrew S,24,0,26,2
1657887230751,ECE 109,A01,091882,Touri; Behrouz,20,0,70,50
1657887236777,ECE 180,A00,083140,Abi Samra; Nicholas Camill,1,0,30,29
1657887236777,ECE 180,B00,083141,Abi Samra; Nicholas Camill,0,0,30,30
1657887242802,MATH 10A,A01,083735,Patchell; Gregory David,2,0,30,28
1657887242802,MATH 10A,A02,083736,Patchell; Gregory David,20,0,30,10
1657887242802,MATH 10A,A03,083737,Patchell; Gregory David,16,0,30,14
1657887248838,MATH 10B,A01,083207,Lim; Seonhee,8,0,34,26
1657887248838,MATH 10B,A02,083208,Lim; Seonhee,10,0,35,25
1657887248838,MATH 10B,A03,093472,Lim; Seonhee,7,0,34,27
1657887248838,MATH 10B,B01,083739,Sinha; Shubham,14,0,30,16
1657887254864,MATH 18,A01,083743,Cinel; Cameron Alexander,9,0,30,21
1657887254864,MATH 18,A02,083744,Cinel; Cameron Alexander,18,0,30,12
1657887254864,MATH 18,A03,083745,Cinel; Cameron Alexander,10,0,30,20
1657887254864,MATH 18,B01,083748,Rideout; David Porter,5,0,37,32
1657887254864,MATH 18,B02,083749,Rideout; David Porter,5,0,36,31
1657887254864,MATH 18,B03,083750,Rideout; David Porter,3,0,37,34
1657887254864,MATH 18,B04,083751,Rideout; David Porter,6,0,36,30
1657887254864,MATH 18,B05,093473,Rideout; David Porter,6,0,36,30
1657887254864,MATH 18,B06,093474,Rideout; David Porter,6,0,36,30
1657887260894,MATH 20A,A01,083754,Zheng; Zequn,14,0,40,26
1657887266926,MATH 20B,A01,083756,Briones; Jor-el Thomas Caparas,4,0,36,32
1657887266926,MATH 20B,A02,083757,Briones; Jor-el Thomas Caparas,1,0,36,35
1657887266926,MATH 20B,A03,093475,Briones; Jor-el Thomas Caparas,2,0,36,34
1657887272950,MATH 20C,A01,083760,Briones; Jor-el Thomas Caparas,1,0,35,34
1657887272950,MATH 20C,A02,083761,Briones; Jor-el Thomas Caparas,8,0,35,27
1657887272950,MATH 20C,A03,093476,Briones; Jor-el Thomas Caparas,0,1,36,36
1657887272950,MATH 20C,B01,083762,Bach; Quang Tran,1,0,30,29
1657887278985,MATH 20D,A01,083765,Tran; Brian Kha,5,0,30,25
1657887278985,MATH 20D,A02,083766,Tran; Brian Kha,5,0,30,25
1657887278985,MATH 20D,A03,083767,Tran; Brian Kha,5,0,30,25
1657887285012,MATH 20E,A01,083771,Ganguly; Soumya,10,0,32,22
1657887285012,MATH 20E,A02,083772,Ganguly; Soumya,6,0,32,26
1657887285012,MATH 20E,B01,083773,Ciotti; Benjamin,20,0,35,15
1657887285012,MATH 20E,B02,083774,Ciotti; Benjamin,18,0,35,17
1657887291039,MATH 103A,A01,083777,Greenfeld; Be'Eri,3,0,36,33
1657887291039,MATH 103A,A02,083778,Greenfeld; Be'Eri,5,0,36,31
1657887291039,MATH 103A,A03,093561,Greenfeld; Be'Eri,6,0,36,30
1657887291039,MATH 103A,B01,083779,Greenfeld; Be'Eri,7,0,36,29
1657887291039,MATH 103A,B02,083780,Greenfeld; Be'Eri,4,0,36,32
1657887291039,MATH 103A,B03,093562,Greenfeld; Be'Eri,3,0,36,33
1657887297075,MATH 105,A01,085443,Carter; Anne Toulson,15,0,35,20
1657887297075,MATH 105,A02,093477,Carter; Anne Toulson,20,0,35,15
1657887303106,MATH 109,A01,083213,Ganzberger; Geoffrey Michael,3,0,34,31
1657887303106,MATH 109,A02,083214,Ganzberger; Geoffrey Michael,4,0,34,30
1657887303106,MATH 109,A03,093478,Ganzberger; Geoffrey Michael,2,0,34,32
1657887303106,MATH 109,B01,083215,Ganzberger; Geoffrey Michael,1,0,32,31
1657887303106,MATH 109,B02,083216,Ganzberger; Geoffrey Michael,2,0,32,30
1657887303106,MATH 109,B03,093479,Ganzberger; Geoffrey Michael,8,0,32,24
1657887309138,MATH 142A,A01,083219,Chow; Bennett,7,0,32,25
1657887309138,MATH 142A,A02,083220,Chow; Bennett,10,0,32,22
1657887309138,MATH 142A,A03,093480,Chow; Bennett,9,0,32,23
1657887309138,MATH 142A,B03,093481,Chow; Bennett,8,0,32,24
1657887309138,MATH 142A,B04,093558,Chow; Bennett,13,0,32,19
1657887309138,MATH 142A,B05,093559,Chow; Bennett,7,0,32,25
1657887315170,MATH 193A,A01,083224,Rotar; Vladimir,8,0,34,26
1657887315170,MATH 193A,A02,083225,Rotar; Vladimir,10,0,34,24
1657887315170,MATH 193A,A03,083781,Rotar; Vladimir,5,0,34,29
1657887315170,MATH 193A,A04,083782,Rotar; Vladimir,11,0,34,23
1657887315170,MATH 193A,A05,093482,Rotar; Vladimir,10,0,34,24
1657887321200,MATH 197,001,091859,McAuley; Julian John,9999,0,9999,0
1657887321200,MATH 197,002,095566,Kedlaya; Kiran S.,9997,0,9999,2
1657887321200,MATH 197,003,095567,Xiao; Ming,9999,0,9999,0
1657887321200,MATH 197,004,095571,Perols; Johan Lars,9998,0,9999,1
1657887328267,COGS 9,A01,083615,Shannon; Kyle Michael,10,0,75,65
1657887334296,COGS 11,A01,083617,Boyle; Mary E. T.,23,0,48,25
1657887340321,COGS 13,A01,083071,Bastos; Amalia Pinkusfeld,11,0,71,60
1657887346346,COGS 14A,A01,092681,Semenuks; Arturs,5,1,100,95
1657887352376,COGS 14B,A01,083073,Cheng; Tzu-Han,6,0,63,57
1657887358402,COGS 17,A01,092677,Semenuks; Arturs,6,0,81,75
1657887364506,COGS 100,A01,083619,Allen; Michael Gordon,17,0,70,53
1657887370532,COGS 101A,A01,083621,Davis; Joshua Daniel,9,0,68,59
1657887376562,COGS 101B,A01,091572,Allen; Michael Gordon,13,0,65,52
1657887382589,COGS 101C,A01,083625,Delgado; Tania,17,0,35,18
1657887388620,COGS 107A,A01,083627,Boyle; Mary E. T.,14,0,60,46
1657887394651,COGS 118A,A01,083075,Gupta; Anjum,21,0,76,55
1657887400676,CSE 3,A50,083646,Miranda; Gregory Joseph,24,0,50,26
1657887406701,CSE 8A,A50,083650,Miranda; Gregory Joseph,17,1,56,39
1657887412726,CSE 11,A01,083080,Cao; Yingjun,6,15,40,34
1657887418757,CSE 12,A01,083652,Krause-Levy; Sophia Louisa,30,1,120,90
1657887424782,CSE 15L,A01,083654,Morris; Justin Loren,9,0,50,41
1657887424782,CSE 15L,A02,083655,Morris; Justin Loren,10,0,50,40
1657887430812,CSE 20,A01,083657,Tran; Khoa Dang,39,0,80,41
1657887436840,CSE 21,A01,095574,Bach; Quang Tran,22,0,48,26
1657887442876,CSE 30,A01,083084,Eldon; John,6,0,80,74
1657887442876,CSE 30,B01,095061,Bhaskar; Nishant,9,0,50,41
1657887448902,CSE 100,A01,083659,Cao; Yingjun,5,4,70,65
1657887454928,CSE 134B,A01,083661,Powell; Thomas Allan,24,0,100,76
1657887460952,CSE 140,A01,083663,Gungor; Onat,15,0,85,70
1657887466975,CSE 140L,A01,083088,Eldon; John,23,0,100,77
1657887473002,CSE 175,A01,083665,Kumar; Rakesh,3,0,25,22
1657887479031,CSE 190,A00,092507,Dubnov; Shlomo,8,0,20,12
1657887485059,ECE 45,A01,083139,Congero; Spencer William,6,0,75,69
1657887491092,ECE 65,A50,083695,Saad; Andrew S,12,0,30,18
1657887491092,ECE 65,A51,095125,Saad; Andrew S,24,0,26,2
1657887497121,ECE 109,A01,091882,Touri; Behrouz,20,0,70,50
1657887503152,ECE 180,A00,083140,Abi Samra; Nicholas Camill,1,0,30,29
1657887503152,ECE 180,B00,083141,Abi Samra; Nicholas Camill,0,0,30,30
1657887509179,MATH 10A,A01,083735,Patchell; Gregory David,2,0,30,28
1657887509179,MATH 10A,A02,083736,Patchell; Gregory David,20,0,30,10
1657887509179,MATH 10A,A03,083737,Patchell; Gregory David,16,0,30,14
1657887515208,MATH 10B,A01,083207,Lim; Seonhee,8,0,34,26
1657887515208,MATH 10B,A02,083208,Lim; Seonhee,10,0,35,25
1657887515208,MATH 10B,A03,093472,Lim; Seonhee,7,0,34,27
1657887515208,MATH 10B,B01,083739,Sinha; Shubham,14,0,30,16
1657887521245,MATH 18,A01,083743,Cinel; Cameron Alexander,9,0,30,21
1657887521245,MATH 18,A02,083744,Cinel; Cameron Alexander,18,0,30,12
1657887521245,MATH 18,A03,083745,Cinel; Cameron Alexander,10,0,30,20
1657887521245,MATH 18,B01,083748,Rideout; David Porter,5,0,37,32
1657887521245,MATH 18,B02,083749,Rideout; David Porter,5,0,36,31
1657887521245,MATH 18,B03,083750,Rideout; David Porter,3,0,37,34
1657887521245,MATH 18,B04,083751,Rideout; David Porter,6,0,36,30
1657887521245,MATH 18,B05,093473,Rideout; David Porter,6,0,36,30
1657887521245,MATH 18,B06,093474,Rideout; David Porter,6,0,36,30
1657887527275,MATH 20A,A01,083754,Zheng; Zequn,14,0,40,26
1657887533312,MATH 20B,A01,083756,Briones; Jor-el Thomas Caparas,4,0,36,32
1657887533312,MATH 20B,A02,083757,Briones; Jor-el Thomas Caparas,1,0,36,35
1657887533312,MATH 20B,A03,093475,Briones; Jor-el Thomas Caparas,2,0,36,34
1657887539338,MATH 20C,A01,083760,Briones; Jor-el Thomas Caparas,1,0,35,34
1657887539338,MATH 20C,A02,083761,Briones; Jor-el Thomas Caparas,8,0,35,27
1657887539338,MATH 20C,A03,093476,Briones; Jor-el Thomas Caparas,0,1,36,36
1657887539338,MATH 20C,B01,083762,Bach; Quang Tran,1,0,30,29
1657887545366,MATH 20D,A01,083765,Tran; Brian Kha,5,0,30,25
1657887545366,MATH 20D,A02,083766,Tran; Brian Kha,5,0,30,25
1657887545366,MATH 20D,A03,083767,Tran; Brian Kha,5,0,30,25
1657887551392,MATH 20E,A01,083771,Ganguly; Soumya,10,0,32,22
1657887551392,MATH 20E,A02,083772,Ganguly; Soumya,6,0,32,26
1657887551392,MATH 20E,B01,083773,Ciotti; Benjamin,20,0,35,15
1657887551392,MATH 20E,B02,083774,Ciotti; Benjamin,18,0,35,17
1657887557418,MATH 103A,A01,083777,Greenfeld; Be'Eri,3,0,36,33
1657887557418,MATH 103A,A02,083778,Greenfeld; Be'Eri,5,0,36,31
1657887557418,MATH 103A,A03,093561,Greenfeld; Be'Eri,6,0,36,30
1657887557418,MATH 103A,B01,083779,Greenfeld; Be'Eri,7,0,36,29
1657887557418,MATH 103A,B02,083780,Greenfeld; Be'Eri,4,0,36,32
1657887557418,MATH 103A,B03,093562,Greenfeld; Be'Eri,3,0,36,33
1657887563443,MATH 105,A01,085443,Carter; Anne Toulson,15,0,35,20
1657887563443,MATH 105,A02,093477,Carter; Anne Toulson,20,0,35,15
1657887569474,MATH 109,A01,083213,Ganzberger; Geoffrey Michael,3,0,34,31
1657887569474,MATH 109,A02,083214,Ganzberger; Geoffrey Michael,4,0,34,30
1657887569474,MATH 109,A03,093478,Ganzberger; Geoffrey Michael,2,0,34,32
1657887569474,MATH 109,B01,083215,Ganzberger; Geoffrey Michael,1,0,32,31
1657887569474,MATH 109,B02,083216,Ganzberger; Geoffrey Michael,2,0,32,30
1657887569474,MATH 109,B03,093479,Ganzberger; Geoffrey Michael,8,0,32,24
1657887575509,MATH 142A,A01,083219,Chow; Bennett,7,0,32,25
1657887575509,MATH 142A,A02,083220,Chow; Bennett,10,0,32,22
1657887575509,MATH 142A,A03,093480,Chow; Bennett,9,0,32,23
1657887575509,MATH 142A,B03,093481,Chow; Bennett,8,0,32,24
1657887575509,MATH 142A,B04,093558,Chow; Bennett,13,0,32,19
1657887575509,MATH 142A,B05,093559,Chow; Bennett,7,0,32,25
1657887581535,MATH 193A,A01,083224,Rotar; Vladimir,8,0,34,26
1657887581535,MATH 193A,A02,083225,Rotar; Vladimir,10,0,34,24
1657887581535,MATH 193A,A03,083781,Rotar; Vladimir,5,0,34,29
1657887581535,MATH 193A,A04,083782,Rotar; Vladimir,11,0,34,23
1657887581535,MATH 193A,A05,093482,Rotar; Vladimir,10,0,34,24
1657887587565,MATH 197,001,091859,McAuley; Julian John,9999,0,9999,0
1657887587565,MATH 197,002,095566,Kedlaya; Kiran S.,9997,0,9999,2
1657887587565,MATH 197,003,095567,Xiao; Ming,9999,0,9999,0
1657887587565,MATH 197,004,095571,Perols; Johan Lars,9998,0,9999,1
1657887594641,COGS 9,A01,083615,Shannon; Kyle Michael,10,0,75,65
1657887600666,COGS 11,A01,083617,Boyle; Mary E. T.,23,0,48,25
1657887606697,COGS 13,A01,083071,Bastos; Amalia Pinkusfeld,11,0,71,60
1657887612723,COGS 14A,A01,092681,Semenuks; Arturs,5,1,100,95
1657887618752,COGS 14B,A01,083073,Cheng; Tzu-Han,6,0,63,57
1657887624778,COGS 17,A01,092677,Semenuks; Arturs,6,0,81,75
1657887630805,COGS 100,A01,083619,Allen; Michael Gordon,17,0,70,53
1657887636829,COGS 101A,A01,083621,Davis; Joshua Daniel,9,0,68,59
1657887642854,COGS 101B,A01,091572,Allen; Michael Gordon,13,0,65,52
1657887648879,COGS 101C,A01,083625,Delgado; Tania,17,0,35,18
1657887654907,COGS 107A,A01,083627,Boyle; Mary E. T.,14,0,60,46
1657887660933,COGS 118A,A01,083075,Gupta; Anjum,21,0,76,55
1657887666960,CSE 3,A50,083646,Miranda; Gregory Joseph,24,0,50,26
1657887672988,CSE 8A,A50,083650,Miranda; Gregory Joseph,17,1,56,39
1657887679017,CSE 11,A01,083080,Cao; Yingjun,6,15,40,34
1657887685047,CSE 12,A01,083652,Krause-Levy; Sophia Louisa,30,1,120,90
1657887691071,CSE 15L,A01,083654,Morris; Justin Loren,9,0,50,41
1657887691071,CSE 15L,A02,083655,Morris; Justin Loren,10,0,50,40
1657887697097,CSE 20,A01,083657,Tran; Khoa Dang,39,0,80,41
1657887703130,CSE 21,A01,095574,Bach; Quang Tran,22,0,48,26
1657887709159,CSE 30,A01,083084,Eldon; John,6,0,80,74
1657887709159,CSE 30,B01,095061,Bhaskar; Nishant,9,0,50,41
1657887715188,CSE 100,A01,083659,Cao; Yingjun,5,4,70,65
1657887721212,CSE 134B,A01,083661,Powell; Thomas Allan,24,0,100,76
1657887727238,CSE 140,A01,083663,Gungor; Onat,15,0,85,70
1657887733263,CSE 140L,A01,083088,Eldon; John,23,0,100,77
1657887739291,CSE 175,A01,083665,Kumar; Rakesh,3,0,25,22
1657887745314,CSE 190,A00,092507,Dubnov; Shlomo,8,0,20,12
1657887751338,ECE 45,A01,083139,Congero; Spencer William,6,0,75,69
1657887757369,ECE 65,A50,083695,Saad; Andrew S,12,0,30,18
1657887757369,ECE 65,A51,095125,Saad; Andrew S,24,0,26,2
1657887763395,ECE 109,A01,091882,Touri; Behrouz,20,0,70,50
1657887769424,ECE 180,A00,083140,Abi Samra; Nicholas Camill,1,0,30,29
1657887769424,ECE 180,B00,083141,Abi Samra; Nicholas Camill,0,0,30,30
1657887775453,MATH 10A,A01,083735,Patchell; Gregory David,2,0,30,28
1657887775453,MATH 10A,A02,083736,Patchell; Gregory David,20,0,30,10
1657887775453,MATH 10A,A03,083737,Patchell; Gregory David,16,0,30,14
1657887781479,MATH 10B,A01,083207,Lim; Seonhee,8,0,34,26
1657887781479,MATH 10B,A02,083208,Lim; Seonhee,10,0,35,25
1657887781479,MATH 10B,A03,093472,Lim; Seonhee,7,0,34,27
1657887781479,MATH 10B,B01,083739,Sinha; Shubham,14,0,30,16
1657887787505,MATH 18,A01,083743,Cinel; Cameron Alexander,9,0,30,21
1657887787505,MATH 18,A02,083744,Cinel; Cameron Alexander,18,0,30,12
1657887787505,MATH 18,A03,083745,Cinel; Cameron Alexander,10,0,30,20
1657887787505,MATH 18,B01,083748,Rideout; David Porter,5,0,37,32
1657887787505,MATH 18,B02,083749,Rideout; David Porter,5,0,36,31
1657887787505,MATH 18,B03,083750,Rideout; David Porter,3,0,37,34
1657887787505,MATH 18,B04,083751,Rideout; David Porter,6,0,36,30
1657887787505,MATH 18,B05,093473,Rideout; David Porter,6,0,36,30
1657887787505,MATH 18,B06,093474,Rideout; David Porter,6,0,36,30
1657887793556,MATH 20A,A01,083754,Zheng; Zequn,14,0,40,26
1657887799583,MATH 20B,A01,083756,Briones; Jor-el Thomas Caparas,4,0,36,32
1657887799583,MATH 20B,A02,083757,Briones; Jor-el Thomas Caparas,1,0,36,35
1657887799583,MATH 20B,A03,093475,Briones; Jor-el Thomas Caparas,2,0,36,34
1657887805618,MATH 20C,A01,083760,Briones; Jor-el Thomas Caparas,1,0,35,34
1657887805618,MATH 20C,A02,083761,Briones; Jor-el Thomas Caparas,8,0,35,27
1657887805618,MATH 20C,A03,093476,Briones; Jor-el Thomas Caparas,0,1,36,36
1657887805618,MATH 20C,B01,083762,Bach; Quang Tran,1,0,30,29
1657887811648,MATH 20D,A01,083765,Tran; Brian Kha,5,0,30,25
1657887811648,MATH 20D,A02,083766,Tran; Brian Kha,5,0,30,25
1657887811648,MATH 20D,A03,083767,Tran; Brian Kha,5,0,30,25
1657887817676,MATH 20E,A01,083771,Ganguly; Soumya,10,0,32,22
1657887817676,MATH 20E,A02,083772,Ganguly; Soumya,6,0,32,26
1657887817676,MATH 20E,B01,083773,Ciotti; Benjamin,20,0,35,15
1657887817676,MATH 20E,B02,083774,Ciotti; Benjamin,18,0,35,17
1657887823715,MATH 103A,A01,083777,Greenfeld; Be'Eri,3,0,36,33
1657887823715,MATH 103A,A02,083778,Greenfeld; Be'Eri,5,0,36,31
1657887823715,MATH 103A,A03,093561,Greenfeld; Be'Eri,6,0,36,30
1657887823715,MATH 103A,B01,083779,Greenfeld; Be'Eri,7,0,36,29
1657887823715,MATH 103A,B02,083780,Greenfeld; Be'Eri,4,0,36,32
1657887823715,MATH 103A,B03,093562,Greenfeld; Be'Eri,3,0,36,33
1657887829756,MATH 105,A01,085443,Carter; Anne Toulson,15,0,35,20
1657887829756,MATH 105,A02,093477,Carter; Anne Toulson,20,0,35,15
1657887835783,MATH 109,A01,083213,Ganzberger; Geoffrey Michael,3,0,34,31
1657887835783,MATH 109,A02,083214,Ganzberger; Geoffrey Michael,4,0,34,30
1657887835783,MATH 109,A03,093478,Ganzberger; Geoffrey Michael,2,0,34,32
1657887835783,MATH 109,B01,083215,Ganzberger; Geoffrey Michael,1,0,32,31
1657887835783,MATH 109,B02,083216,Ganzberger; Geoffrey Michael,2,0,32,30
1657887835783,MATH 109,B03,093479,Ganzberger; Geoffrey Michael,8,0,32,24
1657887841810,MATH 142A,A01,083219,Chow; Bennett,7,0,32,25
1657887841810,MATH 142A,A02,083220,Chow; Bennett,10,0,32,22
1657887841810,MATH 142A,A03,093480,Chow; Bennett,9,0,32,23
1657887841810,MATH 142A,B03,093481,Chow; Bennett,8,0,32,24
1657887841810,MATH 142A,B04,093558,Chow; Bennett,13,0,32,19
1657887841810,MATH 142A,B05,093559,Chow; Bennett,7,0,32,25
1657887847835,MATH 193A,A01,083224,Rotar; Vladimir,8,0,34,26
1657887847835,MATH 193A,A02,083225,Rotar; Vladimir,10,0,34,24
1657887847835,MATH 193A,A03,083781,Rotar; Vladimir,5,0,34,29
1657887847835,MATH 193A,A04,083782,Rotar; Vladimir,11,0,34,23
1657887847835,MATH 193A,A05,093482,Rotar; Vladimir,10,0,34,24
1657887853872,MATH 197,001,091859,McAuley; Julian John,9999,0,9999,0
1657887853872,MATH 197,002,095566,Kedlaya; Kiran S.,9997,0,9999,2
1657887853872,MATH 197,003,095567,Xiao; Ming,9999,0,9999,0
1657887853872,MATH 197,004,095571,Perols; Johan Lars,9998,0,9999,1
1657887860966,COGS 9,A01,083615,Shannon; Kyle Michael,10,0,75,65
1657887866999,COGS 11,A01,083617,Boyle; Mary E. T.,23,0,48,25
1657887873040,COGS 13,A01,083071,Bastos; Amalia Pinkusfeld,11,0,71,60
1657887879068,COGS 14A,A01,092681,Semenuks; Arturs,5,1,100,95
1657887885094,COGS 14B,A01,083073,Cheng; Tzu-Han,6,0,63,57
1657887891121,COGS 17,A01,092677,Semenuks; Arturs,6,0,81,75
1657887897151,COGS 100,A01,083619,Allen; Michael Gordon,17,0,70,53
1657887903184,COGS 101A,A01,083621,Davis; Joshua Daniel,9,0,68,59
1657887909212,COGS 101B,A01,091572,Allen; Michael Gordon,13,0,65,52
1657887915246,COGS 101C,A01,083625,Delgado; Tania,17,0,35,18
1657887921274,COGS 107A,A01,083627,Boyle; Mary E. T.,14,0,60,46
1657887927301,COGS 118A,A01,083075,Gupta; Anjum,21,0,76,55
1657887933327,CSE 3,A50,083646,Miranda; Gregory Joseph,24,0,50,26
1657887939354,CSE 8A,A50,083650,Miranda; Gregory Joseph,17,1,56,39
1657887945381,CSE 11,A01,083080,Cao; Yingjun,6,15,40,34
1657887951410,CSE 12,A01,083652,Krause-Levy; Sophia Louisa,30,1,120,90
1657887957435,CSE 15L,A01,083654,Morris; Justin Loren,9,0,50,41
1657887957435,CSE 15L,A02,083655,Morris; Justin Loren,10,0,50,40
1657887963534,CSE 20,A01,083657,Tran; Khoa Dang,39,0,80,41
1657887969564,CSE 21,A01,095574,Bach; Quang Tran,22,0,48,26
1657887975595,CSE 30,A01,083084,Eldon; John,6,0,80,74
1657887975595,CSE 30,B01,095061,Bhaskar; Nishant,9,0,50,41
1657887981620,CSE 100,A01,083659,Cao; Yingjun,5,4,70,65
1657887987643,CSE 134B,A01,083661,Powell; Thomas Allan,24,0,100,76
1657887993674,CSE 140,A01,083663,Gungor; Onat,15,0,85,70
1657887999702,CSE 140L,A01,083088,Eldon; John,23,0,100,77
1657888005727,CSE 175,A01,083665,Kumar; Rakesh,3,0,25,22
1657888011751,CSE 190,A00,092507,Dubnov; Shlomo,8,0,20,12
1657888017782,ECE 45,A01,083139,Congero; Spencer William,6,0,75,69
1657888023812,ECE 65,A50,083695,Saad; Andrew S,12,0,30,18
1657888023812,ECE 65,A51,095125,Saad; Andrew S,24,0,26,2
1657888029842,ECE 109,A01,091882,Touri; Behrouz,20,0,70,50
1657888035868,ECE 180,A00,083140,Abi Samra; Nicholas Camill,1,0,30,29
1657888035868,ECE 180,B00,083141,Abi Samra; Nicholas Camill,0,0,30,30
1657888041894,MATH 10A,A01,083735,Patchell; Gregory David,2,0,30,28
1657888041894,MATH 10A,A02,083736,Patchell; Gregory David,20,0,30,10
1657888041894,MATH 10A,A03,083737,Patchell; Gregory David,16,0,30,14
1657888047924,MATH 10B,A01,083207,Lim; Seonhee,8,0,34,26
1657888047924,MATH 10B,A02,083208,Lim; Seonhee,10,0,35,25
1657888047924,MATH 10B,A03,093472,Lim; Seonhee,7,0,34,27
1657888047924,MATH 10B,B01,083739,Sinha; Shubham,14,0,30,16
1657888053953,MATH 18,A01,083743,Cinel; Cameron Alexander,9,0,30,21
1657888053953,MATH 18,A02,083744,Cinel; Cameron Alexander,18,0,30,12
1657888053953,MATH 18,A03,083745,Cinel; Cameron Alexander,10,0,30,20
1657888053953,MATH 18,B01,083748,Rideout; David Porter,5,0,37,32
1657888053953,MATH 18,B02,083749,Rideout; David Porter,5,0,36,31
1657888053953,MATH 18,B03,083750,Rideout; David Porter,3,0,37,34
1657888053953,MATH 18,B04,083751,Rideout; David Porter,6,0,36,30
1657888053953,MATH 18,B05,093473,Rideout; David Porter,6,0,36,30
1657888053953,MATH 18,B06,093474,Rideout; David Porter,6,0,36,30
1657888059984,MATH 20A,A01,083754,Zheng; Zequn,14,0,40,26
1657888066011,MATH 20B,A01,083756,Briones; Jor-el Thomas Caparas,4,0,36,32
1657888066011,MATH 20B,A02,083757,Briones; Jor-el Thomas Caparas,1,0,36,35
1657888066011,MATH 20B,A03,093475,Briones; Jor-el Thomas Caparas,2,0,36,34
1657888072040,MATH 20C,A01,083760,Briones; Jor-el Thomas Caparas,1,0,35,34
1657888072040,MATH 20C,A02,083761,Briones; Jor-el Thomas Caparas,8,0,35,27
1657888072040,MATH 20C,A03,093476,Briones; Jor-el Thomas Caparas,0,1,36,36
1657888072040,MATH 20C,B01,083762,Bach; Quang Tran,1,0,30,29
1657888078067,MATH 20D,A01,083765,Tran; Brian Kha,5,0,30,25
1657888078067,MATH 20D,A02,083766,Tran; Brian Kha,5,0,30,25
1657888078067,MATH 20D,A03,083767,Tran; Brian Kha,5,0,30,25
1657888084094,MATH 20E,A01,083771,Ganguly; Soumya,10,0,32,22
1657888084094,MATH 20E,A02,083772,Ganguly; Soumya,6,0,32,26
1657888084094,MATH 20E,B01,083773,Ciotti; Benjamin,20,0,35,15
1657888084094,MATH 20E,B02,083774,Ciotti; Benjamin,18,0,35,17
1657888090126,MATH 103A,A01,083777,Greenfeld; Be'Eri,3,0,36,33
1657888090126,MATH 103A,A02,083778,Greenfeld; Be'Eri,5,0,36,31
1657888090126,MATH 103A,A03,093561,Greenfeld; Be'Eri,6,0,36,30
1657888090126,MATH 103A,B01,083779,Greenfeld; Be'Eri,7,0,36,29
1657888090126,MATH 103A,B02,083780,Greenfeld; Be'Eri,4,0,36,32
1657888090126,MATH 103A,B03,093562,Greenfeld; Be'Eri,3,0,36,33
1657888096154,MATH 105,A01,085443,Carter; Anne Toulson,15,0,35,20
1657888096154,MATH 105,A02,093477,Carter; Anne Toulson,20,0,35,15
1657888102184,MATH 109,A01,083213,Ganzberger; Geoffrey Michael,3,0,34,31
1657888102184,MATH 109,A02,083214,Ganzberger; Geoffrey Michael,4,0,34,30
1657888102184,MATH 109,A03,093478,Ganzberger; Geoffrey Michael,2,0,34,32
1657888102184,MATH 109,B01,083215,Ganzberger; Geoffrey Michael,1,0,32,31
1657888102184,MATH 109,B02,083216,Ganzberger; Geoffrey Michael,2,0,32,30
1657888102184,MATH 109,B03,093479,Ganzberger; Geoffrey Michael,8,0,32,24
1657888108215,MATH 142A,A01,083219,Chow; Bennett,7,0,32,25
1657888108215,MATH 142A,A02,083220,Chow; Bennett,10,0,32,22
1657888108215,MATH 142A,A03,093480,Chow; Bennett,9,0,32,23
1657888108215,MATH 142A,B03,093481,Chow; Bennett,8,0,32,24
1657888108215,MATH 142A,B04,093558,Chow; Bennett,13,0,32,19
1657888108215,MATH 142A,B05,093559,Chow; Bennett,7,0,32,25
1657888114240,MATH 193A,A01,083224,Rotar; Vladimir,8,0,34,26
1657888114240,MATH 193A,A02,083225,Rotar; Vladimir,10,0,34,24
1657888114240,MATH 193A,A03,083781,Rotar; Vladimir,5,0,34,29
1657888114240,MATH 193A,A04,083782,Rotar; Vladimir,11,0,34,23
1657888114240,MATH 193A,A05,093482,Rotar; Vladimir,10,0,34,24
1657888120267,MATH 197,001,091859,McAuley; Julian John,9999,0,9999,0
1657888120267,MATH 197,002,095566,Kedlaya; Kiran S.,9997,0,9999,2
1657888120267,MATH 197,003,095567,Xiao; Ming,9999,0,9999,0
1657888120267,MATH 197,004,095571,Perols; Johan Lars,9998,0,9999,1
1657888127332,COGS 9,A01,083615,Shannon; Kyle Michael,10,0,75,65
1657888133368,COGS 11,A01,083617,Boyle; Mary E. T.,23,0,48,25
1657888139394,COGS 13,A01,083071,Bastos; Amalia Pinkusfeld,11,0,71,60
1657888145420,COGS 14A,A01,092681,Semenuks; Arturs,5,1,100,95
1657888151443,COGS 14B,A01,083073,Cheng; Tzu-Han,6,0,63,57
1657888157470,COGS 17,A01,092677,Semenuks; Arturs,6,0,81,75
1657888163497,COGS 100,A01,083619,Allen; Michael Gordon,17,0,70,53
1657888169521,COGS 101A,A01,083621,Davis; Joshua Daniel,9,0,68,59
1657888175557,COGS 101B,A01,091572,Allen; Michael Gordon,13,0,65,52
1657888181582,COGS 101C,A01,083625,Delgado; Tania,17,0,35,18
1657888187609,COGS 107A,A01,083627,Boyle; Mary E. T.,14,0,60,46
1657888193634,COGS 118A,A01,083075,Gupta; Anjum,21,0,76,55
1657888199666,CSE 3,A50,083646,Miranda; Gregory Joseph,24,0,50,26
1657888205690,CSE 8A,A50,083650,Miranda; Gregory Joseph,17,1,56,39
1657888211717,CSE 11,A01,083080,Cao; Yingjun,6,15,40,34
1657888217742,CSE 12,A01,083652,Krause-Levy; Sophia Louisa,30,1,120,90
1657888223785,CSE 15L,A01,083654,Morris; Justin Loren,9,0,50,41
1657888223785,CSE 15L,A02,083655,Morris; Justin Loren,10,0,50,40
1657888229810,CSE 20,A01,083657,Tran; Khoa Dang,39,0,80,41
1657888235842,CSE 21,A01,095574,Bach; Quang Tran,22,0,48,26
1657888241867,CSE 30,A01,083084,Eldon; John,6,0,80,74
1657888241867,CSE 30,B01,095061,Bhaskar; Nishant,9,0,50,41
1657888247891,CSE 100,A01,083659,Cao; Yingjun,5,4,70,65
1657888253917,CSE 134B,A01,083661,Powell; Thomas Allan,24,0,100,76
1657888259945,CSE 140,A01,083663,Gungor; Onat,15,0,85,70
1657888265970,CSE 140L,A01,083088,Eldon; John,23,0,100,77
1657888272006,CSE 175,A01,083665,Kumar; Rakesh,3,0,25,22
1657888278040,CSE 190,A00,092507,Dubnov; Shlomo,8,0,20,12
1657888284074,ECE 45,A01,083139,Congero; Spencer William,6,0,75,69
1657888290112,ECE 65,A50,083695,Saad; Andrew S,12,0,30,18
1657888290112,ECE 65,A51,095125,Saad; Andrew S,24,0,26,2
1657888296138,ECE 109,A01,091882,Touri; Behrouz,20,0,70,50
1657888302163,ECE 180,A00,083140,Abi Samra; Nicholas Camill,1,0,30,29
1657888302163,ECE 180,B00,083141,Abi Samra; Nicholas Camill,0,0,30,30
1657888308202,MATH 10A,A01,083735,Patchell; Gregory David,2,0,30,28
1657888308202,MATH 10A,A02,083736,Patchell; Gregory David,20,0,30,10
1657888308202,MATH 10A,A03,083737,Patchell; Gregory David,16,0,30,14
1657888314235,MATH 10B,A01,083207,Lim; Seonhee,8,0,34,26
1657888314235,MATH 10B,A02,083208,Lim; Seonhee,10,0,35,25
1657888314235,MATH 10B,A03,093472,Lim; Seonhee,7,0,34,27
1657888314235,MATH 10B,B01,083739,Sinha; Shubham,14,0,30,16
1657888320283,MATH 18,A01,083743,Cinel; Cameron Alexander,9,0,30,21
1657888320283,MATH 18,A02,083744,Cinel; Cameron Alexander,18,0,30,12
1657888320283,MATH 18,A03,083745,Cinel; Cameron Alexander,10,0,30,20
1657888320283,MATH 18,B01,083748,Rideout; David Porter,5,0,37,32
1657888320283,MATH 18,B02,083749,Rideout; David Porter,5,0,36,31
1657888320283,MATH 18,B03,083750,Rideout; David Porter,3,0,37,34
1657888320283,MATH 18,B04,083751,Rideout; David Porter,6,0,36,30
1657888320283,MATH 18,B05,093473,Rideout; David Porter,6,0,36,30
1657888320283,MATH 18,B06,093474,Rideout; David Porter,6,0,36,30
1657888326314,MATH 20A,A01,083754,Zheng; Zequn,14,0,40,26
1657888332344,MATH 20B,A01,083756,Briones; Jor-el Thomas Caparas,4,0,36,32
1657888332344,MATH 20B,A02,083757,Briones; Jor-el Thomas Caparas,1,0,36,35
1657888332344,MATH 20B,A03,093475,Briones; Jor-el Thomas Caparas,2,0,36,34
1657888338373,MATH 20C,A01,083760,Briones; Jor-el Thomas Caparas,1,0,35,34
1657888338373,MATH 20C,A02,083761,Briones; Jor-el Thomas Caparas,8,0,35,27
1657888338373,MATH 20C,A03,093476,Briones; Jor-el Thomas Caparas,0,1,36,36
1657888338373,MATH 20C,B01,083762,Bach; Quang Tran,1,0,30,29
1657888344404,MATH 20D,A01,083765,Tran; Brian Kha,5,0,30,25
1657888344404,MATH 20D,A02,083766,Tran; Brian Kha,5,0,30,25
1657888344404,MATH 20D,A03,083767,Tran; Brian Kha,5,0,30,25
1657888350434,MATH 20E,A01,083771,Ganguly; Soumya,10,0,32,22
1657888350434,MATH 20E,A02,083772,Ganguly; Soumya,6,0,32,26
1657888350434,MATH 20E,B01,083773,Ciotti; Benjamin,20,0,35,15
1657888350434,MATH 20E,B02,083774,Ciotti; Benjamin,18,0,35,17
1657888356497,MATH 103A,A01,083777,Greenfeld; Be'Eri,3,0,36,33
1657888356497,MATH 103A,A02,083778,Greenfeld; Be'Eri,5,0,36,31
1657888356497,MATH 103A,A03,093561,Greenfeld; Be'Eri,6,0,36,30
1657888356497,MATH 103A,B01,083779,Greenfeld; Be'Eri,7,0,36,29
1657888356497,MATH 103A,B02,083780,Greenfeld; Be'Eri,4,0,36,32
1657888356497,MATH 103A,B03,093562,Greenfeld; Be'Eri,3,0,36,33
1657888362527,MATH 105,A01,085443,Carter; Anne Toulson,15,0,35,20
1657888362527,MATH 105,A02,093477,Carter; Anne Toulson,20,0,35,15
1657888368556,MATH 109,A01,083213,Ganzberger; Geoffrey Michael,3,0,34,31
1657888368556,MATH 109,A02,083214,Ganzberger; Geoffrey Michael,4,0,34,30
1657888368556,MATH 109,A03,093478,Ganzberger; Geoffrey Michael,2,0,34,32
1657888368556,MATH 109,B01,083215,Ganzberger; Geoffrey Michael,1,0,32,31
1657888368556,MATH 109,B02,083216,Ganzberger; Geoffrey Michael,2,0,32,30
1657888368556,MATH 109,B03,093479,Ganzberger; Geoffrey Michael,8,0,32,24
1657888374591,MATH 142A,A01,083219,Chow; Bennett,7,0,32,25
1657888374591,MATH 142A,A02,083220,Chow; Bennett,10,0,32,22
1657888374591,MATH 142A,A03,093480,Chow; Bennett,9,0,32,23
1657888374591,MATH 142A,B03,093481,Chow; Bennett,8,0,32,24
1657888374591,MATH 142A,B04,093558,Chow; Bennett,13,0,32,19
1657888374591,MATH 142A,B05,093559,Chow; Bennett,7,0,32,25
1657888380628,MATH 193A,A01,083224,Rotar; Vladimir,8,0,34,26
1657888380628,MATH 193A,A02,083225,Rotar; Vladimir,10,0,34,24
1657888380628,MATH 193A,A03,083781,Rotar; Vladimir,5,0,34,29
1657888380628,MATH 193A,A04,083782,Rotar; Vladimir,11,0,34,23
1657888380628,MATH 193A,A05,093482,Rotar; Vladimir,10,0,34,24
1657888386655,MATH 197,001,091859,McAuley; Julian John,9999,0,9999,0
1657888386655,MATH 197,002,095566,Kedlaya; Kiran S.,9997,0,9999,2
1657888386655,MATH 197,003,095567,Xiao; Ming,9999,0,9999,0
1657888386655,MATH 197,004,095571,Perols; Johan Lars,9998,0,9999,1
1657888393748,COGS 9,A01,083615,Shannon; Kyle Michael,10,0,75,65
1657888399778,COGS 11,A01,083617,Boyle; Mary E. T.,23,0,48,25
1657888405812,COGS 13,A01,083071,Bastos; Amalia Pinkusfeld,11,0,71,60
1657888411838,COGS 14A,A01,092681,Semenuks; Arturs,5,1,100,95
1657888417868,COGS 14B,A01,083073,Cheng; Tzu-Han,6,0,63,57
1657888423897,COGS 17,A01,092677,Semenuks; Arturs,6,0,81,75
1657888429930,COGS 100,A01,083619,Allen; Michael Gordon,17,0,70,53
1657888435956,COGS 101A,A01,083621,Davis; Joshua Daniel,9,0,68,59
1657888441982,COGS 101B,A01,091572,Allen; Michael Gordon,13,0,65,52
1657888448013,COGS 101C,A01,083625,Delgado; Tania,17,0,35,18
1657888454041,COGS 107A,A01,083627,Boyle; Mary E. T.,14,0,60,46
1657888460075,COGS 118A,A01,083075,Gupta; Anjum,21,0,76,55
1657888466105,CSE 3,A50,083646,Miranda; Gregory Joseph,24,0,50,26
1657888472130,CSE 8A,A50,083650,Miranda; Gregory Joseph,17,1,56,39
1657888478161,CSE 11,A01,083080,Cao; Yingjun,6,15,40,34
1657888484186,CSE 12,A01,083652,Krause-Levy; Sophia Louisa,30,1,120,90
1657888490223,CSE 15L,A01,083654,Morris; Justin Loren,9,0,50,41
1657888490223,CSE 15L,A02,083655,Morris; Justin Loren,10,0,50,40
1657888496261,CSE 20,A01,083657,Tran; Khoa Dang,39,0,80,41
1657888502288,CSE 21,A01,095574,Bach; Quang Tran,22,0,48,26
1657888508317,CSE 30,A01,083084,Eldon; John,6,0,80,74
1657888508317,CSE 30,B01,095061,Bhaskar; Nishant,9,0,50,41
1657888514347,CSE 100,A01,083659,Cao; Yingjun,5,4,70,65
1657888520378,CSE 134B,A01,083661,Powell; Thomas Allan,24,0,100,76
1657888526403,CSE 140,A01,083663,Gungor; Onat,15,0,85,70
1657888532430,CSE 140L,A01,083088,Eldon; John,23,0,100,77
1657888538462,CSE 175,A01,083665,Kumar; Rakesh,3,0,25,22
1657888544488,CSE 190,A00,092507,Dubnov; Shlomo,8,0,20,12
1657888550519,ECE 45,A01,083139,Congero; Spencer William,6,0,75,69
1657888556553,ECE 65,A50,083695,Saad; Andrew S,12,0,30,18
1657888556553,ECE 65,A51,095125,Saad; Andrew S,24,0,26,2
1657888562649,ECE 109,A01,091882,Touri; Behrouz,20,0,70,50
1657888568674,ECE 180,A00,083140,Abi Samra; Nicholas Camill,1,0,30,29
1657888568674,ECE 180,B00,083141,Abi Samra; Nicholas Camill,0,0,30,30
1657888574702,MATH 10A,A01,083735,Patchell; Gregory David,2,0,30,28
1657888574702,MATH 10A,A02,083736,Patchell; Gregory David,20,0,30,10
1657888574702,MATH 10A,A03,083737,Patchell; Gregory David,16,0,30,14
1657888580732,MATH 10B,A01,083207,Lim; Seonhee,8,0,34,26
1657888580732,MATH 10B,A02,083208,Lim; Seonhee,10,0,35,25
1657888580732,MATH 10B,A03,093472,Lim; Seonhee,7,0,34,27
1657888580732,MATH 10B,B01,083739,Sinha; Shubham,14,0,30,16
1657888586761,MATH 18,A01,083743,Cinel; Cameron Alexander,9,0,30,21
1657888586761,MATH 18,A02,083744,Cinel; Cameron Alexander,18,0,30,12
1657888586761,MATH 18,A03,083745,Cinel; Cameron Alexander,10,0,30,20
1657888586761,MATH 18,B01,083748,Rideout; David Porter,5,0,37,32
1657888586761,MATH 18,B02,083749,Rideout; David Porter,5,0,36,31
1657888586761,MATH 18,B03,083750,Rideout; David Porter,3,0,37,34
1657888586761,MATH 18,B04,083751,Rideout; David Porter,6,0,36,30
1657888586761,MATH 18,B05,093473,Rideout; David Porter,6,0,36,30
1657888586761,MATH 18,B06,093474,Rideout; David Porter,6,0,36,30
1657888592789,MATH 20A,A01,083754,Zheng; Zequn,14,0,40,26
1657888598817,MATH 20B,A01,083756,Briones; Jor-el Thomas Caparas,4,0,36,32
1657888598817,MATH 20B,A02,083757,Briones; Jor-el Thomas Caparas,1,0,36,35
1657888598817,MATH 20B,A03,093475,Briones; Jor-el Thomas Caparas,2,0,36,34
1657888604844,MATH 20C,A01,083760,Briones; Jor-el Thomas Caparas,1,0,35,34
1657888604844,MATH 20C,A02,083761,Briones; Jor-el Thomas Caparas,8,0,35,27
1657888604844,MATH 20C,A03,093476,Briones; Jor-el Thomas Caparas,0,1,36,36
1657888604844,MATH 20C,B01,083762,Bach; Quang Tran,1,0,30,29
1657888610879,MATH 20D,A01,083765,Tran; Brian Kha,5,0,30,25
1657888610879,MATH 20D,A02,083766,Tran; Brian Kha,5,0,30,25
1657888610879,MATH 20D,A03,083767,Tran; Brian Kha,5,0,30,25
1657888616915,MATH 20E,A01,083771,Ganguly; Soumya,10,0,32,22
1657888616915,MATH 20E,A02,083772,Ganguly; Soumya,6,0,32,26
1657888616915,MATH 20E,B01,083773,Ciotti; Benjamin,20,0,35,15
1657888616915,MATH 20E,B02,083774,Ciotti; Benjamin,18,0,35,17
1657888622951,MATH 103A,A01,083777,Greenfeld; Be'Eri,3,0,36,33
1657888622951,MATH 103A,A02,083778,Greenfeld; Be'Eri,5,0,36,31
1657888622951,MATH 103A,A03,093561,Greenfeld; Be'Eri,6,0,36,30
1657888622951,MATH 103A,B01,083779,Greenfeld; Be'Eri,7,0,36,29
1657888622951,MATH 103A,B02,083780,Greenfeld; Be'Eri,4,0,36,32
1657888622951,MATH 103A,B03,093562,Greenfeld; Be'Eri,3,0,36,33
1657888628983,MATH 105,A01,085443,Carter; Anne Toulson,15,0,35,20
1657888628983,MATH 105,A02,093477,Carter; Anne Toulson,20,0,35,15
1657888635012,MATH 109,A01,083213,Ganzberger; Geoffrey Michael,3,0,34,31
1657888635012,MATH 109,A02,083214,Ganzberger; Geoffrey Michael,4,0,34,30
1657888635012,MATH 109,A03,093478,Ganzberger; Geoffrey Michael,2,0,34,32
1657888635012,MATH 109,B01,083215,Ganzberger; Geoffrey Michael,1,0,32,31
1657888635012,MATH 109,B02,083216,Ganzberger; Geoffrey Michael,2,0,32,30
1657888635012,MATH 109,B03,093479,Ganzberger; Geoffrey Michael,8,0,32,24
1657888641040,MATH 142A,A01,083219,Chow; Bennett,7,0,32,25
1657888641040,MATH 142A,A02,083220,Chow; Bennett,10,0,32,22
1657888641040,MATH 142A,A03,093480,Chow; Bennett,9,0,32,23
1657888641040,MATH 142A,B03,093481,Chow; Bennett,8,0,32,24
1657888641040,MATH 142A,B04,093558,Chow; Bennett,13,0,32,19
1657888641040,MATH 142A,B05,093559,Chow; Bennett,7,0,32,25
1657888647070,MATH 193A,A01,083224,Rotar; Vladimir,8,0,34,26
1657888647070,MATH 193A,A02,083225,Rotar; Vladimir,10,0,34,24
1657888647070,MATH 193A,A03,083781,Rotar; Vladimir,5,0,34,29
1657888647070,MATH 193A,A04,083782,Rotar; Vladimir,11,0,34,23
1657888647070,MATH 193A,A05,093482,Rotar; Vladimir,10,0,34,24
1657888653093,MATH 197,001,091859,McAuley; Julian John,9999,0,9999,0
1657888653093,MATH 197,002,095566,Kedlaya; Kiran S.,9997,0,9999,2
1657888653093,MATH 197,003,095567,Xiao; Ming,9999,0,9999,0
1657888653093,MATH 197,004,095571,Perols; Johan Lars,9998,0,9999,1
1657888660167,COGS 9,A01,083615,Shannon; Kyle Michael,10,0,75,65
1657888666194,COGS 11,A01,083617,Boyle; Mary E. T.,23,0,48,25
1657888672226,COGS 13,A01,083071,Bastos; Amalia Pinkusfeld,11,0,71,60
1657888678252,COGS 14A,A01,092681,Semenuks; Arturs,5,1,100,95
1657888684281,COGS 14B,A01,083073,Cheng; Tzu-Han,6,0,63,57
1657888690306,COGS 17,A01,092677,Semenuks; Arturs,6,0,81,75
1657888696335,COGS 100,A01,083619,Allen; Michael Gordon,17,0,70,53
1657888702359,COGS 101A,A01,083621,Davis; Joshua Daniel,9,0,68,59
1657888708392,COGS 101B,A01,091572,Allen; Michael Gordon,13,0,65,52
1657888714416,COGS 101C,A01,083625,Delgado; Tania,17,0,35,18
1657888720441,COGS 107A,A01,083627,Boyle; Mary E. T.,14,0,60,46
1657888726465,COGS 118A,A01,083075,Gupta; Anjum,21,0,76,55
1657888732493,CSE 3,A50,083646,Miranda; Gregory Joseph,24,0,50,26
1657888738527,CSE 8A,A50,083650,Miranda; Gregory Joseph,17,1,56,39
1657888744557,CSE 11,A01,083080,Cao; Yingjun,6,15,40,34
1657888750585,CSE 12,A01,083652,Krause-Levy; Sophia Louisa,30,1,120,90
1657888756616,CSE 15L,A01,083654,Morris; Justin Loren,9,0,50,41
1657888756616,CSE 15L,A02,083655,Morris; Justin Loren,10,0,50,40
1657888762642,CSE 20,A01,083657,Tran; Khoa Dang,39,0,80,41
1657888768674,CSE 21,A01,095574,Bach; Quang Tran,22,0,48,26
1657888774708,CSE 30,A01,083084,Eldon; John,6,0,80,74
1657888774708,CSE 30,B01,095061,Bhaskar; Nishant,9,0,50,41
1657888780734,CSE 100,A01,083659,Cao; Yingjun,5,4,70,65
1657888786758,CSE 134B,A01,083661,Powell; Thomas Allan,24,0,100,76
1657888792781,CSE 140,A01,083663,Gungor; Onat,15,0,85,70
1657888798807,CSE 140L,A01,083088,Eldon; John,23,0,100,77
1657888804832,CSE 175,A01,083665,Kumar; Rakesh,3,0,25,22
1657888810859,CSE 190,A00,092507,Dubnov; Shlomo,8,0,20,12
1657888816886,ECE 45,A01,083139,Congero; Spencer William,6,0,75,69
1657888822921,ECE 65,A50,083695,Saad; Andrew S,12,0,30,18
1657888822921,ECE 65,A51,095125,Saad; Andrew S,24,0,26,2
1657888828952,ECE 109,A01,091882,Touri; Behrouz,20,0,70,50
1657888834985,ECE 180,A00,083140,Abi Samra; Nicholas Camill,1,0,30,29
1657888834985,ECE 180,B00,083141,Abi Samra; Nicholas Camill,0,0,30,30
1657888841013,MATH 10A,A01,083735,Patchell; Gregory David,2,0,30,28
1657888841013,MATH 10A,A02,083736,Patchell; Gregory David,20,0,30,10
1657888841013,MATH 10A,A03,083737,Patchell; Gregory David,16,0,30,14
1657888847049,MATH 10B,A01,083207,Lim; Seonhee,8,0,34,26
1657888847049,MATH 10B,A02,083208,Lim; Seonhee,10,0,35,25
1657888847049,MATH 10B,A03,093472,Lim; Seonhee,7,0,34,27
1657888847049,MATH 10B,B01,083739,Sinha; Shubham,14,0,30,16
1657888853080,MATH 18,A01,083743,Cinel; Cameron Alexander,9,0,30,21
1657888853080,MATH 18,A02,083744,Cinel; Cameron Alexander,18,0,30,12
1657888853080,MATH 18,A03,083745,Cinel; Cameron Alexander,10,0,30,20
1657888853080,MATH 18,B01,083748,Rideout; David Porter,5,0,37,32
1657888853080,MATH 18,B02,083749,Rideout; David Porter,5,0,36,31
1657888853080,MATH 18,B03,083750,Rideout; David Porter,3,0,37,34
1657888853080,MATH 18,B04,083751,Rideout; David Porter,6,0,36,30
1657888853080,MATH 18,B05,093473,Rideout; David Porter,6,0,36,30
1657888853080,MATH 18,B06,093474,Rideout; David Porter,6,0,36,30
1657888859105,MATH 20A,A01,083754,Zheng; Zequn,14,0,40,26
1657888865130,MATH 20B,A01,083756,Briones; Jor-el Thomas Caparas,4,0,36,32
1657888865130,MATH 20B,A02,083757,Briones; Jor-el Thomas Caparas,1,0,36,35
1657888865130,MATH 20B,A03,093475,Briones; Jor-el Thomas Caparas,2,0,36,34
1657888871160,MATH 20C,A01,083760,Briones; Jor-el Thomas Caparas,1,0,35,34
1657888871160,MATH 20C,A02,083761,Briones; Jor-el Thomas Caparas,8,0,35,27
1657888871160,MATH 20C,A03,093476,Briones; Jor-el Thomas Caparas,0,1,36,36
1657888871160,MATH 20C,B01,083762,Bach; Quang Tran,1,0,30,29
1657888877188,MATH 20D,A01,083765,Tran; Brian Kha,5,0,30,25
1657888877188,MATH 20D,A02,083766,Tran; Brian Kha,5,0,30,25
1657888877188,MATH 20D,A03,083767,Tran; Brian Kha,5,0,30,25
1657888883222,MATH 20E,A01,083771,Ganguly; Soumya,10,0,32,22
1657888883222,MATH 20E,A02,083772,Ganguly; Soumya,6,0,32,26
1657888883222,MATH 20E,B01,083773,Ciotti; Benjamin,20,0,35,15
1657888883222,MATH 20E,B02,083774,Ciotti; Benjamin,18,0,35,17
1657888889257,MATH 103A,A01,083777,Greenfeld; Be'Eri,3,0,36,33
1657888889257,MATH 103A,A02,083778,Greenfeld; Be'Eri,5,0,36,31
1657888889257,MATH 103A,A03,093561,Greenfeld; Be'Eri,6,0,36,30
1657888889257,MATH 103A,B01,083779,Greenfeld; Be'Eri,7,0,36,29
1657888889257,MATH 103A,B02,083780,Greenfeld; Be'Eri,4,0,36,32
1657888889257,MATH 103A,B03,093562,Greenfeld; Be'Eri,3,0,36,33
1657888895288,MATH 105,A01,085443,Carter; Anne Toulson,15,0,35,20
1657888895288,MATH 105,A02,093477,Carter; Anne Toulson,20,0,35,15
1657888901313,MATH 109,A01,083213,Ganzberger; Geoffrey Michael,3,0,34,31
1657888901313,MATH 109,A02,083214,Ganzberger; Geoffrey Michael,4,0,34,30
1657888901313,MATH 109,A03,093478,Ganzberger; Geoffrey Michael,2,0,34,32
1657888901313,MATH 109,B01,083215,Ganzberger; Geoffrey Michael,1,0,32,31
1657888901313,MATH 109,B02,083216,Ganzberger; Geoffrey Michael,2,0,32,30
1657888901313,MATH 109,B03,093479,Ganzberger; Geoffrey Michael,8,0,32,24
1657888907341,MATH 142A,A01,083219,Chow; Bennett,7,0,32,25
1657888907341,MATH 142A,A02,083220,Chow; Bennett,10,0,32,22
1657888907341,MATH 142A,A03,093480,Chow; Bennett,9,0,32,23
1657888907341,MATH 142A,B03,093481,Chow; Bennett,8,0,32,24
1657888907341,MATH 142A,B04,093558,Chow; Bennett,13,0,32,19
1657888907341,MATH 142A,B05,093559,Chow; Bennett,7,0,32,25
1657888913369,MATH 193A,A01,083224,Rotar; Vladimir,8,0,34,26
1657888913369,MATH 193A,A02,083225,Rotar; Vladimir,10,0,34,24
1657888913369,MATH 193A,A03,083781,Rotar; Vladimir,5,0,34,29
1657888913369,MATH 193A,A04,083782,Rotar; Vladimir,11,0,34,23
1657888913369,MATH 193A,A05,093482,Rotar; Vladimir,10,0,34,24
1657888919397,MATH 197,001,091859,McAuley; Julian John,9999,0,9999,0
1657888919397,MATH 197,002,095566,Kedlaya; Kiran S.,9997,0,9999,2
1657888919397,MATH 197,003,095567,Xiao; Ming,9999,0,9999,0
1657888919397,MATH 197,004,095571,Perols; Johan Lars,9998,0,9999,1
1657888926482,COGS 9,A01,083615,Shannon; Kyle Michael,10,0,75,65
1657888932508,COGS 11,A01,083617,Boyle; Mary E. T.,23,0,48,25
1657888938534,COGS 13,A01,083071,Bastos; Amalia Pinkusfeld,11,0,71,60
1657888944561,COGS 14A,A01,092681,Semenuks; Arturs,5,1,100,95
1657888950588,COGS 14B,A01,083073,Cheng; Tzu-Han,6,0,63,57
1657888956615,COGS 17,A01,092677,Semenuks; Arturs,6,0,81,75
1657888962646,COGS 100,A01,083619,Allen; Michael Gordon,17,0,70,53
1657888968675,COGS 101A,A01,083621,Davis; Joshua Daniel,9,0,68,59
1657888974703,COGS 101B,A01,091572,Allen; Michael Gordon,13,0,65,52
1657888980728,COGS 101C,A01,083625,Delgado; Tania,17,0,35,18
1657888986753,COGS 107A,A01,083627,Boyle; Mary E. T.,14,0,60,46
1657888992789,COGS 118A,A01,083075,Gupta; Anjum,21,0,76,55
1657888998817,CSE 3,A50,083646,Miranda; Gregory Joseph,24,0,50,26
1657889004852,CSE 8A,A50,083650,Miranda; Gregory Joseph,17,1,56,39
1657889010886,CSE 11,A01,083080,Cao; Yingjun,6,15,40,34
1657889016912,CSE 12,A01,083652,Krause-Levy; Sophia Louisa,30,1,120,90
1657889022936,CSE 15L,A01,083654,Morris; Justin Loren,9,0,50,41
1657889022936,CSE 15L,A02,083655,Morris; Justin Loren,10,0,50,40
1657889028962,CSE 20,A01,083657,Tran; Khoa Dang,39,0,80,41
1657889034991,CSE 21,A01,095574,Bach; Quang Tran,22,0,48,26
1657889041019,CSE 30,A01,083084,Eldon; John,6,0,80,74
1657889041019,CSE 30,B01,095061,Bhaskar; Nishant,9,0,50,41
1657889047045,CSE 100,A01,083659,Cao; Yingjun,5,4,70,65
1657889053075,CSE 134B,A01,083661,Powell; Thomas Allan,24,0,100,76
1657889059103,CSE 140,A01,083663,Gungor; Onat,15,0,85,70
1657889065131,CSE 140L,A01,083088,Eldon; John,23,0,100,77
1657889071161,CSE 175,A01,083665,Kumar; Rakesh,3,0,25,22
1657889077187,CSE 190,A00,092507,Dubnov; Shlomo,8,0,20,12
1657889083214,ECE 45,A01,083139,Congero; Spencer William,6,0,75,69
1657889089241,ECE 65,A50,083695,Saad; Andrew S,12,0,30,18
1657889089241,ECE 65,A51,095125,Saad; Andrew S,24,0,26,2
1657889095278,ECE 109,A01,091882,Touri; Behrouz,20,0,70,50
1657889101309,ECE 180,A00,083140,Abi Samra; Nicholas Camill,1,0,30,29
1657889101309,ECE 180,B00,083141,Abi Samra; Nicholas Camill,0,0,30,30
1657889107342,MATH 10A,A01,083735,Patchell; Gregory David,2,0,30,28
1657889107342,MATH 10A,A02,083736,Patchell; Gregory David,20,0,30,10
1657889107342,MATH 10A,A03,083737,Patchell; Gregory David,16,0,30,14
1657889113389,MATH 10B,A01,083207,Lim; Seonhee,8,0,34,26
1657889113389,MATH 10B,A02,083208,Lim; Seonhee,10,0,35,25
1657889113389,MATH 10B,A03,093472,Lim; Seonhee,7,0,34,27
1657889113389,MATH 10B,B01,083739,Sinha; Shubham,14,0,30,16
1657889119415,MATH 18,A01,083743,Cinel; Cameron Alexander,9,0,30,21
1657889119415,MATH 18,A02,083744,Cinel; Cameron Alexander,18,0,30,12
1657889119415,MATH 18,A03,083745,Cinel; Cameron Alexander,10,0,30,20
1657889119415,MATH 18,B01,083748,Rideout; David Porter,5,0,37,32
1657889119415,MATH 18,B02,083749,Rideout; David Porter,5,0,36,31
1657889119415,MATH 18,B03,083750,Rideout; David Porter,3,0,37,34
1657889119415,MATH 18,B04,083751,Rideout; David Porter,6,0,36,30
1657889119415,MATH 18,B05,093473,Rideout; David Porter,6,0,36,30
1657889119415,MATH 18,B06,093474,Rideout; David Porter,6,0,36,30
1657889125440,MATH 20A,A01,083754,Zheng; Zequn,14,0,40,26
1657889131466,MATH 20B,A01,083756,Briones; Jor-el Thomas Caparas,4,0,36,32
1657889131466,MATH 20B,A02,083757,Briones; Jor-el Thomas Caparas,1,0,36,35
1657889131466,MATH 20B,A03,093475,Briones; Jor-el Thomas Caparas,2,0,36,34
1657889137497,MATH 20C,A01,083760,Briones; Jor-el Thomas Caparas,1,0,35,34
1657889137497,MATH 20C,A02,083761,Briones; Jor-el Thomas Caparas,8,0,35,27
1657889137497,MATH 20C,A03,093476,Briones; Jor-el Thomas Caparas,0,1,36,36
1657889137497,MATH 20C,B01,083762,Bach; Quang Tran,1,0,30,29
1657889143524,MATH 20D,A01,083765,Tran; Brian Kha,5,0,30,25
1657889143524,MATH 20D,A02,083766,Tran; Brian Kha,5,0,30,25
1657889143524,MATH 20D,A03,083767,Tran; Brian Kha,5,0,30,25
1657889149558,MATH 20E,A01,083771,Ganguly; Soumya,10,0,32,22
1657889149558,MATH 20E,A02,083772,Ganguly; Soumya,6,0,32,26
1657889149558,MATH 20E,B01,083773,Ciotti; Benjamin,20,0,35,15
1657889149558,MATH 20E,B02,083774,Ciotti; Benjamin,18,0,35,17
1657889155586,MATH 103A,A01,083777,Greenfeld; Be'Eri,3,0,36,33
1657889155586,MATH 103A,A02,083778,Greenfeld; Be'Eri,5,0,36,31
1657889155586,MATH 103A,A03,093561,Greenfeld; Be'Eri,6,0,36,30
1657889155586,MATH 103A,B01,083779,Greenfeld; Be'Eri,7,0,36,29
1657889155586,MATH 103A,B02,083780,Greenfeld; Be'Eri,4,0,36,32
1657889155586,MATH 103A,B03,093562,Greenfeld; Be'Eri,3,0,36,33
1657889161692,MATH 105,A01,085443,Carter; Anne Toulson,15,0,35,20
1657889161692,MATH 105,A02,093477,Carter; Anne Toulson,20,0,35,15
1657889167721,MATH 109,A01,083213,Ganzberger; Geoffrey Michael,3,0,34,31
1657889167721,MATH 109,A02,083214,Ganzberger; Geoffrey Michael,4,0,34,30
1657889167721,MATH 109,A03,093478,Ganzberger; Geoffrey Michael,2,0,34,32
1657889167721,MATH 109,B01,083215,Ganzberger; Geoffrey Michael,1,0,32,31
1657889167721,MATH 109,B02,083216,Ganzberger; Geoffrey Michael,2,0,32,30
1657889167721,MATH 109,B03,093479,Ganzberger; Geoffrey Michael,8,0,32,24
1657889173753,MATH 142A,A01,083219,Chow; Bennett,7,0,32,25
1657889173753,MATH 142A,A02,083220,Chow; Bennett,10,0,32,22
1657889173753,MATH 142A,A03,093480,Chow; Bennett,9,0,32,23
1657889173753,MATH 142A,B03,093481,Chow; Bennett,8,0,32,24
1657889173753,MATH 142A,B04,093558,Chow; Bennett,13,0,32,19
1657889173753,MATH 142A,B05,093559,Chow; Bennett,7,0,32,25
1657889179780,MATH 193A,A01,083224,Rotar; Vladimir,8,0,34,26
1657889179780,MATH 193A,A02,083225,Rotar; Vladimir,10,0,34,24
1657889179780,MATH 193A,A03,083781,Rotar; Vladimir,5,0,34,29
1657889179780,MATH 193A,A04,083782,Rotar; Vladimir,11,0,34,23
1657889179780,MATH 193A,A05,093482,Rotar; Vladimir,10,0,34,24
1657889185808,MATH 197,001,091859,McAuley; Julian John,9999,0,9999,0
1657889185808,MATH 197,002,095566,Kedlaya; Kiran S.,9997,0,9999,2
1657889185808,MATH 197,003,095567,Xiao; Ming,9999,0,9999,0
1657889185808,MATH 197,004,095571,Perols; Johan Lars,9998,0,9999,1
1657889192874,COGS 9,A01,083615,Shannon; Kyle Michael,10,0,75,65
1657889198900,COGS 11,A01,083617,Boyle; Mary E. T.,23,0,48,25
1657889204924,COGS 13,A01,083071,Bastos; Amalia Pinkusfeld,11,0,71,60
1657889210954,COGS 14A,A01,092681,Semenuks; Arturs,5,1,100,95
1657889216979,COGS 14B,A01,083073,Cheng; Tzu-Han,6,0,63,57
1657889223006,COGS 17,A01,092677,Semenuks; Arturs,6,0,81,75
1657889229039,COGS 100,A01,083619,Allen; Michael Gordon,17,0,70,53
1657889235065,COGS 101A,A01,083621,Davis; Joshua Daniel,9,0,68,59
1657889241097,COGS 101B,A01,091572,Allen; Michael Gordon,13,0,65,52
1657889247126,COGS 101C,A01,083625,Delgado; Tania,17,0,35,18
1657889253151,COGS 107A,A01,083627,Boyle; Mary E. T.,14,0,60,46
1657889259181,COGS 118A,A01,083075,Gupta; Anjum,21,0,76,55
1657889265207,CSE 3,A50,083646,Miranda; Gregory Joseph,24,0,50,26
1657889271233,CSE 8A,A50,083650,Miranda; Gregory Joseph,17,1,56,39
1657889277264,CSE 11,A01,083080,Cao; Yingjun,6,15,40,34
1657889283297,CSE 12,A01,083652,Krause-Levy; Sophia Louisa,30,1,120,90
1657889289328,CSE 15L,A01,083654,Morris; Justin Loren,9,0,50,41
1657889289328,CSE 15L,A02,083655,Morris; Justin Loren,10,0,50,40
1657889295354,CSE 20,A01,083657,Tran; Khoa Dang,39,0,80,41
1657889301381,CSE 21,A01,095574,Bach; Quang Tran,22,0,48,26
1657889307409,CSE 30,A01,083084,Eldon; John,6,0,80,74
1657889307409,CSE 30,B01,095061,Bhaskar; Nishant,9,0,50,41
1657889313436,CSE 100,A01,083659,Cao; Yingjun,5,4,70,65
1657889319463,CSE 134B,A01,083661,Powell; Thomas Allan,24,0,100,76
1657889325488,CSE 140,A01,083663,Gungor; Onat,15,0,85,70
1657889331517,CSE 140L,A01,083088,Eldon; John,23,0,100,77
1657889337548,CSE 175,A01,083665,Kumar; Rakesh,3,0,25,22
1657889343575,CSE 190,A00,092507,Dubnov; Shlomo,8,0,20,12
1657889349608,ECE 45,A01,083139,Congero; Spencer William,6,0,75,69
1657889355639,ECE 65,A50,083695,Saad; Andrew S,12,0,30,18
1657889355639,ECE 65,A51,095125,Saad; Andrew S,24,0,26,2
1657889361665,ECE 109,A01,091882,Touri; Behrouz,20,0,70,50
1657889367692,ECE 180,A00,083140,Abi Samra; Nicholas Camill,1,0,30,29
1657889367692,ECE 180,B00,083141,Abi Samra; Nicholas Camill,0,0,30,30
1657889373728,MATH 10A,A01,083735,Patchell; Gregory David,2,0,30,28
1657889373728,MATH 10A,A02,083736,Patchell; Gregory David,20,0,30,10
1657889373728,MATH 10A,A03,083737,Patchell; Gregory David,16,0,30,14
1657889379767,MATH 10B,A01,083207,Lim; Seonhee,8,0,34,26
1657889379767,MATH 10B,A02,083208,Lim; Seonhee,10,0,35,25
1657889379767,MATH 10B,A03,093472,Lim; Seonhee,7,0,34,27
1657889379767,MATH 10B,B01,083739,Sinha; Shubham,14,0,30,16
1657889385811,MATH 18,A01,083743,Cinel; Cameron Alexander,9,0,30,21
1657889385811,MATH 18,A02,083744,Cinel; Cameron Alexander,18,0,30,12
1657889385811,MATH 18,A03,083745,Cinel; Cameron Alexander,10,0,30,20
1657889385811,MATH 18,B01,083748,Rideout; David Porter,5,0,37,32
1657889385811,MATH 18,B02,083749,Rideout; David Porter,5,0,36,31
1657889385811,MATH 18,B03,083750,Rideout; David Porter,3,0,37,34
1657889385811,MATH 18,B04,083751,Rideout; David Porter,6,0,36,30
1657889385811,MATH 18,B05,093473,Rideout; David Porter,6,0,36,30
1657889385811,MATH 18,B06,093474,Rideout; David Porter,6,0,36,30
1657889391837,MATH 20A,A01,083754,Zheng; Zequn,14,0,40,26
1657889397864,MATH 20B,A01,083756,Briones; Jor-el Thomas Caparas,4,0,36,32
1657889397864,MATH 20B,A02,083757,Briones; Jor-el Thomas Caparas,1,0,36,35
1657889397864,MATH 20B,A03,093475,Briones; Jor-el Thomas Caparas,2,0,36,34
1657889403910,MATH 20C,A01,083760,Briones; Jor-el Thomas Caparas,1,0,35,34
1657889403910,MATH 20C,A02,083761,Briones; Jor-el Thomas Caparas,8,0,35,27
1657889403910,MATH 20C,A03,093476,Briones; Jor-el Thomas Caparas,0,1,36,36
1657889403910,MATH 20C,B01,083762,Bach; Quang Tran,1,0,30,29
1657889409944,MATH 20D,A01,083765,Tran; Brian Kha,5,0,30,25
1657889409944,MATH 20D,A02,083766,Tran; Brian Kha,5,0,30,25
1657889409944,MATH 20D,A03,083767,Tran; Brian Kha,5,0,30,25
1657889415981,MATH 20E,A01,083771,Ganguly; Soumya,10,0,32,22
1657889415981,MATH 20E,A02,083772,Ganguly; Soumya,6,0,32,26
1657889415981,MATH 20E,B01,083773,Ciotti; Benjamin,20,0,35,15
1657889415981,MATH 20E,B02,083774,Ciotti; Benjamin,18,0,35,17
1657889422008,MATH 103A,A01,083777,Greenfeld; Be'Eri,3,0,36,33
1657889422008,MATH 103A,A02,083778,Greenfeld; Be'Eri,5,0,36,31
1657889422008,MATH 103A,A03,093561,Greenfeld; Be'Eri,6,0,36,30
1657889422008,MATH 103A,B01,083779,Greenfeld; Be'Eri,7,0,36,29
1657889422008,MATH 103A,B02,083780,Greenfeld; Be'Eri,4,0,36,32
1657889422008,MATH 103A,B03,093562,Greenfeld; Be'Eri,3,0,36,33
1657889428042,MATH 105,A01,085443,Carter; Anne Toulson,15,0,35,20
1657889428042,MATH 105,A02,093477,Carter; Anne Toulson,20,0,35,15
1657889434069,MATH 109,A01,083213,Ganzberger; Geoffrey Michael,3,0,34,31
1657889434069,MATH 109,A02,083214,Ganzberger; Geoffrey Michael,4,0,34,30
1657889434069,MATH 109,A03,093478,Ganzberger; Geoffrey Michael,2,0,34,32
1657889434069,MATH 109,B01,083215,Ganzberger; Geoffrey Michael,1,0,32,31
1657889434069,MATH 109,B02,083216,Ganzberger; Geoffrey Michael,2,0,32,30
1657889434069,MATH 109,B03,093479,Ganzberger; Geoffrey Michael,8,0,32,24
1657889440106,MATH 142A,A01,083219,Chow; Bennett,7,0,32,25
1657889440106,MATH 142A,A02,083220,Chow; Bennett,10,0,32,22
1657889440106,MATH 142A,A03,093480,Chow; Bennett,9,0,32,23
1657889440106,MATH 142A,B03,093481,Chow; Bennett,8,0,32,24
1657889440106,MATH 142A,B04,093558,Chow; Bennett,13,0,32,19
1657889440106,MATH 142A,B05,093559,Chow; Bennett,7,0,32,25
1657889446134,MATH 193A,A01,083224,Rotar; Vladimir,8,0,34,26
1657889446134,MATH 193A,A02,083225,Rotar; Vladimir,10,0,34,24
1657889446134,MATH 193A,A03,083781,Rotar; Vladimir,5,0,34,29
1657889446134,MATH 193A,A04,083782,Rotar; Vladimir,11,0,34,23
1657889446134,MATH 193A,A05,093482,Rotar; Vladimir,10,0,34,24
1657889452159,MATH 197,001,091859,McAuley; Julian John,9999,0,9999,0
1657889452159,MATH 197,002,095566,Kedlaya; Kiran S.,9997,0,9999,2
1657889452159,MATH 197,003,095567,Xiao; Ming,9999,0,9999,0
1657889452159,MATH 197,004,095571,Perols; Johan Lars,9998,0,9999,1
1657889459225,COGS 9,A01,083615,Shannon; Kyle Michael,10,0,75,65
1657889465250,COGS 11,A01,083617,Boyle; Mary E. T.,23,0,48,25
1657889471280,COGS 13,A01,083071,Bastos; Amalia Pinkusfeld,11,0,71,60
1657889477313,COGS 14A,A01,092681,Semenuks; Arturs,5,1,100,95
1657889483342,COGS 14B,A01,083073,Cheng; Tzu-Han,6,0,63,57
1657889489381,COGS 17,A01,092677,Semenuks; Arturs,6,0,81,75
1657889495406,COGS 100,A01,083619,Allen; Michael Gordon,17,0,70,53
1657889501434,COGS 101A,A01,083621,Davis; Joshua Daniel,9,0,68,59
1657889507462,COGS 101B,A01,091572,Allen; Michael Gordon,13,0,65,52
1657889513488,COGS 101C,A01,083625,Delgado; Tania,17,0,35,18
1657889519512,COGS 107A,A01,083627,Boyle; Mary E. T.,14,0,60,46
1657889525536,COGS 118A,A01,083075,Gupta; Anjum,21,0,76,55
1657889531577,CSE 3,A50,083646,Miranda; Gregory Joseph,24,0,50,26
1657889537608,CSE 8A,A50,083650,Miranda; Gregory Joseph,17,1,56,39
1657889543637,CSE 11,A01,083080,Cao; Yingjun,6,15,40,34
1657889549669,CSE 12,A01,083652,Krause-Levy; Sophia Louisa,30,1,120,90
1657889555699,CSE 15L,A01,083654,Morris; Justin Loren,9,0,50,41
1657889555699,CSE 15L,A02,083655,Morris; Justin Loren,10,0,50,40
1657889561730,CSE 20,A01,083657,Tran; Khoa Dang,39,0,80,41
1657889567764,CSE 21,A01,095574,Bach; Quang Tran,22,0,48,26
1657889573792,CSE 30,A01,083084,Eldon; John,6,0,80,74
1657889573792,CSE 30,B01,095061,Bhaskar; Nishant,9,0,50,41
1657889579825,CSE 100,A01,083659,Cao; Yingjun,5,4,70,65
1657889585857,CSE 134B,A01,083661,Powell; Thomas Allan,24,0,100,76
1657889591885,CSE 140,A01,083663,Gungor; Onat,15,0,85,70
1657889597910,CSE 140L,A01,083088,Eldon; John,23,0,100,77
1657889603949,CSE 175,A01,083665,Kumar; Rakesh,3,0,25,22
1657889609980,CSE 190,A00,092507,Dubnov; Shlomo,8,0,20,12
1657889616008,ECE 45,A01,083139,Congero; Spencer William,6,0,75,69
1657889622045,ECE 65,A50,083695,Saad; Andrew S,12,0,30,18
1657889622045,ECE 65,A51,095125,Saad; Andrew S,24,0,26,2
1657889628077,ECE 109,A01,091882,Touri; Behrouz,20,0,70,50
1657889634102,ECE 180,A00,083140,Abi Samra; Nicholas Camill,1,0,30,29
1657889634102,ECE 180,B00,083141,Abi Samra; Nicholas Camill,0,0,30,30
1657889640137,MATH 10A,A01,083735,Patchell; Gregory David,2,0,30,28
1657889640137,MATH 10A,A02,083736,Patchell; Gregory David,20,0,30,10
1657889640137,MATH 10A,A03,083737,Patchell; Gregory David,16,0,30,14
1657889646163,MATH 10B,A01,083207,Lim; Seonhee,8,0,34,26
1657889646163,MATH 10B,A02,083208,Lim; Seonhee,10,0,35,25
1657889646163,MATH 10B,A03,093472,Lim; Seonhee,7,0,34,27
1657889646163,MATH 10B,B01,083739,Sinha; Shubham,14,0,30,16
1657889652189,MATH 18,A01,083743,Cinel; Cameron Alexander,9,0,30,21
1657889652189,MATH 18,A02,083744,Cinel; Cameron Alexander,18,0,30,12
1657889652189,MATH 18,A03,083745,Cinel; Cameron Alexander,10,0,30,20
1657889652189,MATH 18,B01,083748,Rideout; David Porter,5,0,37,32
1657889652189,MATH 18,B02,083749,Rideout; David Porter,5,0,36,31
1657889652189,MATH 18,B03,083750,Rideout; David Porter,3,0,37,34
1657889652189,MATH 18,B04,083751,Rideout; David Porter,6,0,36,30
1657889652189,MATH 18,B05,093473,Rideout; David Porter,6,0,36,30
1657889652189,MATH 18,B06,093474,Rideout; David Porter,6,0,36,30
1657889658214,MATH 20A,A01,083754,Zheng; Zequn,14,0,40,26
1657889664244,MATH 20B,A01,083756,Briones; Jor-el Thomas Caparas,4,0,36,32
1657889664244,MATH 20B,A02,083757,Briones; Jor-el Thomas Caparas,1,0,36,35
1657889664244,MATH 20B,A03,093475,Briones; Jor-el Thomas Caparas,2,0,36,34
1657889670277,MATH 20C,A01,083760,Briones; Jor-el Thomas Caparas,1,0,35,34
1657889670277,MATH 20C,A02,083761,Briones; Jor-el Thomas Caparas,8,0,35,27
1657889670277,MATH 20C,A03,093476,Briones; Jor-el Thomas Caparas,0,1,36,36
1657889670277,MATH 20C,B01,083762,Bach; Quang Tran,1,0,30,29
1657889676301,MATH 20D,A01,083765,Tran; Brian Kha,5,0,30,25
1657889676301,MATH 20D,A02,083766,Tran; Brian Kha,5,0,30,25
1657889676301,MATH 20D,A03,083767,Tran; Brian Kha,5,0,30,25
1657889682335,MATH 20E,A01,083771,Ganguly; Soumya,10,0,32,22
1657889682335,MATH 20E,A02,083772,Ganguly; Soumya,6,0,32,26
1657889682335,MATH 20E,B01,083773,Ciotti; Benjamin,20,0,35,15
1657889682335,MATH 20E,B02,083774,Ciotti; Benjamin,18,0,35,17
1657889688381,MATH 103A,A01,083777,Greenfeld; Be'Eri,3,0,36,33
1657889688381,MATH 103A,A02,083778,Greenfeld; Be'Eri,5,0,36,31
1657889688381,MATH 103A,A03,093561,Greenfeld; Be'Eri,6,0,36,30
1657889688381,MATH 103A,B01,083779,Greenfeld; Be'Eri,7,0,36,29
1657889688381,MATH 103A,B02,083780,Greenfeld; Be'Eri,4,0,36,32
1657889688381,MATH 103A,B03,093562,Greenfeld; Be'Eri,3,0,36,33
1657889694414,MATH 105,A01,085443,Carter; Anne Toulson,15,0,35,20
1657889694414,MATH 105,A02,093477,Carter; Anne Toulson,20,0,35,15
1657889700447,MATH 109,A01,083213,Ganzberger; Geoffrey Michael,3,0,34,31
1657889700447,MATH 109,A02,083214,Ganzberger; Geoffrey Michael,4,0,34,30
1657889700447,MATH 109,A03,093478,Ganzberger; Geoffrey Michael,2,0,34,32
1657889700447,MATH 109,B01,083215,Ganzberger; Geoffrey Michael,1,0,32,31
1657889700447,MATH 109,B02,083216,Ganzberger; Geoffrey Michael,2,0,32,30
1657889700447,MATH 109,B03,093479,Ganzberger; Geoffrey Michael,8,0,32,24
1657889706473,MATH 142A,A01,083219,Chow; Bennett,7,0,32,25
1657889706473,MATH 142A,A02,083220,Chow; Bennett,10,0,32,22
1657889706473,MATH 142A,A03,093480,Chow; Bennett,9,0,32,23
1657889706473,MATH 142A,B03,093481,Chow; Bennett,8,0,32,24
1657889706473,MATH 142A,B04,093558,Chow; Bennett,13,0,32,19
1657889706473,MATH 142A,B05,093559,Chow; Bennett,7,0,32,25
1657889712497,MATH 193A,A01,083224,Rotar; Vladimir,8,0,34,26
1657889712497,MATH 193A,A02,083225,Rotar; Vladimir,10,0,34,24
1657889712497,MATH 193A,A03,083781,Rotar; Vladimir,5,0,34,29
1657889712497,MATH 193A,A04,083782,Rotar; Vladimir,11,0,34,23
1657889712497,MATH 193A,A05,093482,Rotar; Vladimir,10,0,34,24
1657889718526,MATH 197,001,091859,McAuley; Julian John,9999,0,9999,0
1657889718526,MATH 197,002,095566,Kedlaya; Kiran S.,9997,0,9999,2
1657889718526,MATH 197,003,095567,Xiao; Ming,9999,0,9999,0
1657889718526,MATH 197,004,095571,Perols; Johan Lars,9998,0,9999,1
1657889725588,COGS 9,A01,083615,Shannon; Kyle Michael,10,0,75,65
1657889731616,COGS 11,A01,083617,Boyle; Mary E. T.,23,0,48,25
1657889737646,COGS 13,A01,083071,Bastos; Amalia Pinkusfeld,11,0,71,60
1657889743677,COGS 14A,A01,092681,Semenuks; Arturs,5,1,100,95
1657889749703,COGS 14B,A01,083073,Cheng; Tzu-Han,6,0,63,57
1657889755812,COGS 17,A01,092677,Semenuks; Arturs,6,0,81,75
1657889761838,COGS 100,A01,083619,Allen; Michael Gordon,17,0,70,53
1657889767864,COGS 101A,A01,083621,Davis; Joshua Daniel,9,0,68,59
1657889773891,COGS 101B,A01,091572,Allen; Michael Gordon,13,0,65,52
1657889779916,COGS 101C,A01,083625,Delgado; Tania,17,0,35,18
1657889785943,COGS 107A,A01,083627,Boyle; Mary E. T.,14,0,60,46
1657889791971,COGS 118A,A01,083075,Gupta; Anjum,21,0,76,55
1657889797999,CSE 3,A50,083646,Miranda; Gregory Joseph,24,0,50,26
1657889804025,CSE 8A,A50,083650,Miranda; Gregory Joseph,17,1,56,39
1657889810050,CSE 11,A01,083080,Cao; Yingjun,6,15,40,34
1657889816078,CSE 12,A01,083652,Krause-Levy; Sophia Louisa,30,1,120,90
1657889822110,CSE 15L,A01,083654,Morris; Justin Loren,9,0,50,41
1657889822110,CSE 15L,A02,083655,Morris; Justin Loren,10,0,50,40
1657889828138,CSE 20,A01,083657,Tran; Khoa Dang,39,0,80,41
1657889834169,CSE 21,A01,095574,Bach; Quang Tran,22,0,48,26
1657889840196,CSE 30,A01,083084,Eldon; John,6,0,80,74
1657889840196,CSE 30,B01,095061,Bhaskar; Nishant,9,0,50,41
1657889846220,CSE 100,A01,083659,Cao; Yingjun,5,4,70,65
1657889852251,CSE 134B,A01,083661,Powell; Thomas Allan,24,0,100,76
1657889858273,CSE 140,A01,083663,Gungor; Onat,15,0,85,70
1657889864298,CSE 140L,A01,083088,Eldon; John,23,0,100,77
1657889870331,CSE 175,A01,083665,Kumar; Rakesh,3,0,25,22
1657889876356,CSE 190,A00,092507,Dubnov; Shlomo,8,0,20,12
1657889882383,ECE 45,A01,083139,Congero; Spencer William,6,0,75,69
1657889888420,ECE 65,A50,083695,Saad; Andrew S,12,0,30,18
1657889888420,ECE 65,A51,095125,Saad; Andrew S,24,0,26,2
1657889894445,ECE 109,A01,091882,Touri; Behrouz,20,0,70,50
1657889900475,ECE 180,A00,083140,Abi Samra; Nicholas Camill,1,0,30,29
1657889900475,ECE 180,B00,083141,Abi Samra; Nicholas Camill,0,0,30,30
1657889906507,MATH 10A,A01,083735,Patchell; Gregory David,2,0,30,28
1657889906507,MATH 10A,A02,083736,Patchell; Gregory David,20,0,30,10
1657889906507,MATH 10A,A03,083737,Patchell; Gregory David,16,0,30,14
1657889912539,MATH 10B,A01,083207,Lim; Seonhee,8,0,34,26
1657889912539,MATH 10B,A02,083208,Lim; Seonhee,10,0,35,25
1657889912539,MATH 10B,A03,093472,Lim; Seonhee,7,0,34,27
1657889912539,MATH 10B,B01,083739,Sinha; Shubham,14,0,30,16
1657889918574,MATH 18,A01,083743,Cinel; Cameron Alexander,9,0,30,21
1657889918574,MATH 18,A02,083744,Cinel; Cameron Alexander,18,0,30,12
1657889918574,MATH 18,A03,083745,Cinel; Cameron Alexander,10,0,30,20
1657889918574,MATH 18,B01,083748,Rideout; David Porter,5,0,37,32
1657889918574,MATH 18,B02,083749,Rideout; David Porter,5,0,36,31
1657889918574,MATH 18,B03,083750,Rideout; David Porter,3,0,37,34
1657889918574,MATH 18,B04,083751,Rideout; David Porter,6,0,36,30
1657889918574,MATH 18,B05,093473,Rideout; David Porter,6,0,36,30
1657889918574,MATH 18,B06,093474,Rideout; David Porter,6,0,36,30
1657889924604,MATH 20A,A01,083754,Zheng; Zequn,14,0,40,26
1657889930632,MATH 20B,A01,083756,Briones; Jor-el Thomas Caparas,4,0,36,32
1657889930632,MATH 20B,A02,083757,Briones; Jor-el Thomas Caparas,1,0,36,35
1657889930632,MATH 20B,A03,093475,Briones; Jor-el Thomas Caparas,2,0,36,34
1657889936660,MATH 20C,A01,083760,Briones; Jor-el Thomas Caparas,1,0,35,34
1657889936660,MATH 20C,A02,083761,Briones; Jor-el Thomas Caparas,8,0,35,27
1657889936660,MATH 20C,A03,093476,Briones; Jor-el Thomas Caparas,0,1,36,36
1657889936660,MATH 20C,B01,083762,Bach; Quang Tran,1,0,30,29
1657889942691,MATH 20D,A01,083765,Tran; Brian Kha,5,0,30,25
1657889942691,MATH 20D,A02,083766,Tran; Brian Kha,5,0,30,25
1657889942691,MATH 20D,A03,083767,Tran; Brian Kha,5,0,30,25
1657889948723,MATH 20E,A01,083771,Ganguly; Soumya,10,0,32,22
1657889948723,MATH 20E,A02,083772,Ganguly; Soumya,6,0,32,26
1657889948723,MATH 20E,B01,083773,Ciotti; Benjamin,20,0,35,15
1657889948723,MATH 20E,B02,083774,Ciotti; Benjamin,18,0,35,17
1657889954755,MATH 103A,A01,083777,Greenfeld; Be'Eri,3,0,36,33
1657889954755,MATH 103A,A02,083778,Greenfeld; Be'Eri,5,0,36,31
1657889954755,MATH 103A,A03,093561,Greenfeld; Be'Eri,6,0,36,30
1657889954755,MATH 103A,B01,083779,Greenfeld; Be'Eri,7,0,36,29
1657889954755,MATH 103A,B02,083780,Greenfeld; Be'Eri,4,0,36,32
1657889954755,MATH 103A,B03,093562,Greenfeld; Be'Eri,3,0,36,33
1657889960779,MATH 105,A01,085443,Carter; Anne Toulson,15,0,35,20
1657889960779,MATH 105,A02,093477,Carter; Anne Toulson,20,0,35,15
1657889966812,MATH 109,A01,083213,Ganzberger; Geoffrey Michael,3,0,34,31
1657889966812,MATH 109,A02,083214,Ganzberger; Geoffrey Michael,4,0,34,30
1657889966812,MATH 109,A03,093478,Ganzberger; Geoffrey Michael,2,0,34,32
1657889966812,MATH 109,B01,083215,Ganzberger; Geoffrey Michael,1,0,32,31
1657889966812,MATH 109,B02,083216,Ganzberger; Geoffrey Michael,2,0,32,30
1657889966812,MATH 109,B03,093479,Ganzberger; Geoffrey Michael,8,0,32,24
1657889972846,MATH 142A,A01,083219,Chow; Bennett,7,0,32,25
1657889972846,MATH 142A,A02,083220,Chow; Bennett,10,0,32,22
1657889972846,MATH 142A,A03,093480,Chow; Bennett,9,0,32,23
1657889972846,MATH 142A,B03,093481,Chow; Bennett,8,0,32,24
1657889972846,MATH 142A,B04,093558,Chow; Bennett,13,0,32,19
1657889972846,MATH 142A,B05,093559,Chow; Bennett,7,0,32,25
1657889978872,MATH 193A,A01,083224,Rotar; Vladimir,8,0,34,26
1657889978872,MATH 193A,A02,083225,Rotar; Vladimir,10,0,34,24
1657889978872,MATH 193A,A03,083781,Rotar; Vladimir,5,0,34,29
1657889978872,MATH 193A,A04,083782,Rotar; Vladimir,11,0,34,23
1657889978872,MATH 193A,A05,093482,Rotar; Vladimir,10,0,34,24
1657889984897,MATH 197,001,091859,McAuley; Julian John,9999,0,9999,0
1657889984897,MATH 197,002,095566,Kedlaya; Kiran S.,9997,0,9999,2
1657889984897,MATH 197,003,095567,Xiao; Ming,9999,0,9999,0
1657889984897,MATH 197,004,095571,Perols; Johan Lars,9998,0,9999,1
1657889991974,COGS 9,A01,083615,Shannon; Kyle Michael,10,0,75,65
1657889998004,COGS 11,A01,083617,Boyle; Mary E. T.,23,0,48,25
1657890004029,COGS 13,A01,083071,Bastos; Amalia Pinkusfeld,11,0,71,60
1657890010056,COGS 14A,A01,092681,Semenuks; Arturs,5,1,100,95
1657890016091,COGS 14B,A01,083073,Cheng; Tzu-Han,6,0,63,57
1657890022117,COGS 17,A01,092677,Semenuks; Arturs,6,0,81,75
1657890028147,COGS 100,A01,083619,Allen; Michael Gordon,17,0,70,53
1657890034176,COGS 101A,A01,083621,Davis; Joshua Daniel,9,0,68,59
1657890040203,COGS 101B,A01,091572,Allen; Michael Gordon,13,0,65,52
1657890046228,COGS 101C,A01,083625,Delgado; Tania,17,0,35,18
1657890052253,COGS 107A,A01,083627,Boyle; Mary E. T.,14,0,60,46
1657890058281,COGS 118A,A01,083075,Gupta; Anjum,21,0,76,55
1657890064310,CSE 3,A50,083646,Miranda; Gregory Joseph,24,0,50,26
1657890070334,CSE 8A,A50,083650,Miranda; Gregory Joseph,17,1,56,39
1657890076360,CSE 11,A01,083080,Cao; Yingjun,6,15,40,34
1657890082398,CSE 12,A01,083652,Krause-Levy; Sophia Louisa,30,1,120,90
1657890088423,CSE 15L,A01,083654,Morris; Justin Loren,9,0,50,41
1657890088423,CSE 15L,A02,083655,Morris; Justin Loren,10,0,50,40
1657890094448,CSE 20,A01,083657,Tran; Khoa Dang,39,0,80,41
1657890100471,CSE 21,A01,095574,Bach; Quang Tran,22,0,48,26
1657890106501,CSE 30,A01,083084,Eldon; John,6,0,80,74
1657890106501,CSE 30,B01,095061,Bhaskar; Nishant,9,0,50,41
1657890112537,CSE 100,A01,083659,Cao; Yingjun,5,4,70,65
1657890118566,CSE 134B,A01,083661,Powell; Thomas Allan,24,0,100,76
1657890124592,CSE 140,A01,083663,Gungor; Onat,15,0,85,70
1657890130618,CSE 140L,A01,083088,Eldon; John,23,0,100,77
1657890136642,CSE 175,A01,083665,Kumar; Rakesh,3,0,25,22
1657890142669,CSE 190,A00,092507,Dubnov; Shlomo,8,0,20,12
1657890148697,ECE 45,A01,083139,Congero; Spencer William,6,0,75,69
1657890154721,ECE 65,A50,083695,Saad; Andrew S,12,0,30,18
1657890154721,ECE 65,A51,095125,Saad; Andrew S,24,0,26,2
1657890160747,ECE 109,A01,091882,Touri; Behrouz,20,0,70,50
1657890166773,ECE 180,A00,083140,Abi Samra; Nicholas Camill,1,0,30,29
1657890166773,ECE 180,B00,083141,Abi Samra; Nicholas Camill,0,0,30,30
1657890172805,MATH 10A,A01,083735,Patchell; Gregory David,2,0,30,28
1657890172805,MATH 10A,A02,083736,Patchell; Gregory David,20,0,30,10
1657890172805,MATH 10A,A03,083737,Patchell; Gregory David,16,0,30,14
1657890178836,MATH 10B,A01,083207,Lim; Seonhee,8,0,34,26
1657890178836,MATH 10B,A02,083208,Lim; Seonhee,10,0,35,25
1657890178836,MATH 10B,A03,093472,Lim; Seonhee,7,0,34,27
1657890178836,MATH 10B,B01,083739,Sinha; Shubham,14,0,30,16
1657890184863,MATH 18,A01,083743,Cinel; Cameron Alexander,9,0,30,21
1657890184863,MATH 18,A02,083744,Cinel; Cameron Alexander,18,0,30,12
1657890184863,MATH 18,A03,083745,Cinel; Cameron Alexander,10,0,30,20
1657890184863,MATH 18,B01,083748,Rideout; David Porter,5,0,37,32
1657890184863,MATH 18,B02,083749,Rideout; David Porter,5,0,36,31
1657890184863,MATH 18,B03,083750,Rideout; David Porter,3,0,37,34
1657890184863,MATH 18,B04,083751,Rideout; David Porter,6,0,36,30
1657890184863,MATH 18,B05,093473,Rideout; David Porter,6,0,36,30
1657890184863,MATH 18,B06,093474,Rideout; David Porter,6,0,36,30
1657890190887,MATH 20A,A01,083754,Zheng; Zequn,14,0,40,26
1657890196912,MATH 20B,A01,083756,Briones; Jor-el Thomas Caparas,4,0,36,32
1657890196912,MATH 20B,A02,083757,Briones; Jor-el Thomas Caparas,1,0,36,35
1657890196912,MATH 20B,A03,093475,Briones; Jor-el Thomas Caparas,2,0,36,34
1657890202941,MATH 20C,A01,083760,Briones; Jor-el Thomas Caparas,1,0,35,34
1657890202941,MATH 20C,A02,083761,Briones; Jor-el Thomas Caparas,8,0,35,27
1657890202941,MATH 20C,A03,093476,Briones; Jor-el Thomas Caparas,0,1,36,36
1657890202941,MATH 20C,B01,083762,Bach; Quang Tran,1,0,30,29
1657890208965,MATH 20D,A01,083765,Tran; Brian Kha,5,0,30,25
1657890208965,MATH 20D,A02,083766,Tran; Brian Kha,5,0,30,25
1657890208965,MATH 20D,A03,083767,Tran; Brian Kha,5,0,30,25
1657890215004,MATH 20E,A01,083771,Ganguly; Soumya,10,0,32,22
1657890215004,MATH 20E,A02,083772,Ganguly; Soumya,6,0,32,26
1657890215004,MATH 20E,B01,083773,Ciotti; Benjamin,20,0,35,15
1657890215004,MATH 20E,B02,083774,Ciotti; Benjamin,18,0,35,17
1657890221030,MATH 103A,A01,083777,Greenfeld; Be'Eri,3,0,36,33
1657890221030,MATH 103A,A02,083778,Greenfeld; Be'Eri,5,0,36,31
1657890221030,MATH 103A,A03,093561,Greenfeld; Be'Eri,6,0,36,30
1657890221030,MATH 103A,B01,083779,Greenfeld; Be'Eri,7,0,36,29
1657890221030,MATH 103A,B02,083780,Greenfeld; Be'Eri,4,0,36,32
1657890221030,MATH 103A,B03,093562,Greenfeld; Be'Eri,3,0,36,33
1657890227054,MATH 105,A01,085443,Carter; Anne Toulson,15,0,35,20
1657890227054,MATH 105,A02,093477,Carter; Anne Toulson,20,0,35,15
1657890233084,MATH 109,A01,083213,Ganzberger; Geoffrey Michael,3,0,34,31
1657890233084,MATH 109,A02,083214,Ganzberger; Geoffrey Michael,4,0,34,30
1657890233084,MATH 109,A03,093478,Ganzberger; Geoffrey Michael,2,0,34,32
1657890233084,MATH 109,B01,083215,Ganzberger; Geoffrey Michael,1,0,32,31
1657890233084,MATH 109,B02,083216,Ganzberger; Geoffrey Michael,2,0,32,30
1657890233084,MATH 109,B03,093479,Ganzberger; Geoffrey Michael,8,0,32,24
1657890239110,MATH 142A,A01,083219,Chow; Bennett,7,0,32,25
1657890239110,MATH 142A,A02,083220,Chow; Bennett,10,0,32,22
1657890239110,MATH 142A,A03,093480,Chow; Bennett,9,0,32,23
1657890239110,MATH 142A,B03,093481,Chow; Bennett,8,0,32,24
1657890239110,MATH 142A,B04,093558,Chow; Bennett,13,0,32,19
1657890239110,MATH 142A,B05,093559,Chow; Bennett,7,0,32,25
1657890245139,MATH 193A,A01,083224,Rotar; Vladimir,8,0,34,26
1657890245139,MATH 193A,A02,083225,Rotar; Vladimir,10,0,34,24
1657890245139,MATH 193A,A03,083781,Rotar; Vladimir,5,0,34,29
1657890245139,MATH 193A,A04,083782,Rotar; Vladimir,11,0,34,23
1657890245139,MATH 193A,A05,093482,Rotar; Vladimir,10,0,34,24
1657890251165,MATH 197,001,091859,McAuley; Julian John,9999,0,9999,0
1657890251165,MATH 197,002,095566,Kedlaya; Kiran S.,9997,0,9999,2
1657890251165,MATH 197,003,095567,Xiao; Ming,9999,0,9999,0
1657890251165,MATH 197,004,095571,Perols; Johan Lars,9998,0,9999,1
1657890258237,COGS 9,A01,083615,Shannon; Kyle Michael,10,0,75,65
1657890264262,COGS 11,A01,083617,Boyle; Mary E. T.,23,0,48,25
1657890270286,COGS 13,A01,083071,Bastos; Amalia Pinkusfeld,11,0,71,60
1657890276316,COGS 14A,A01,092681,Semenuks; Arturs,5,1,100,95
1657890282341,COGS 14B,A01,083073,Cheng; Tzu-Han,6,0,63,57
1657890288365,COGS 17,A01,092677,Semenuks; Arturs,6,0,81,75
1657890294393,COGS 100,A01,083619,Allen; Michael Gordon,17,0,70,53
1657890300419,COGS 101A,A01,083621,Davis; Joshua Daniel,9,0,68,59
1657890306447,COGS 101B,A01,091572,Allen; Michael Gordon,13,0,65,52
1657890312483,COGS 101C,A01,083625,Delgado; Tania,17,0,35,18
1657890318508,COGS 107A,A01,083627,Boyle; Mary E. T.,14,0,60,46
1657890324536,COGS 118A,A01,083075,Gupta; Anjum,21,0,76,55
1657890330561,CSE 3,A50,083646,Miranda; Gregory Joseph,24,0,50,26
1657890336594,CSE 8A,A50,083650,Miranda; Gregory Joseph,17,1,56,39
1657890342631,CSE 11,A01,083080,Cao; Yingjun,6,15,40,34
1657890348664,CSE 12,A01,083652,Krause-Levy; Sophia Louisa,30,1,120,90
1657890354779,CSE 15L,A01,083654,Morris; Justin Loren,9,0,50,41
1657890354779,CSE 15L,A02,083655,Morris; Justin Loren,10,0,50,40
1657890360805,CSE 20,A01,083657,Tran; Khoa Dang,39,0,80,41
1657890366831,CSE 21,A01,095574,Bach; Quang Tran,22,0,48,26
1657890372857,CSE 30,A01,083084,Eldon; John,6,0,80,74
1657890372857,CSE 30,B01,095061,Bhaskar; Nishant,9,0,50,41
1657890378896,CSE 100,A01,083659,Cao; Yingjun,5,4,70,65
1657890384919,CSE 134B,A01,083661,Powell; Thomas Allan,24,0,100,76
1657890390954,CSE 140,A01,083663,Gungor; Onat,15,0,85,70
1657890396977,CSE 140L,A01,083088,Eldon; John,23,0,100,77
1657890403001,CSE 175,A01,083665,Kumar; Rakesh,3,0,25,22
1657890409026,CSE 190,A00,092507,Dubnov; Shlomo,8,0,20,12
1657890415054,ECE 45,A01,083139,Congero; Spencer William,6,0,75,69
1657890421080,ECE 65,A50,083695,Saad; Andrew S,12,0,30,18
1657890421080,ECE 65,A51,095125,Saad; Andrew S,24,0,26,2
1657890427106,ECE 109,A01,091882,Touri; Behrouz,20,0,70,50
1657890433129,ECE 180,A00,083140,Abi Samra; Nicholas Camill,1,0,30,29
1657890433129,ECE 180,B00,083141,Abi Samra; Nicholas Camill,0,0,30,30
1657890439161,MATH 10A,A01,083735,Patchell; Gregory David,2,0,30,28
1657890439161,MATH 10A,A02,083736,Patchell; Gregory David,20,0,30,10
1657890439161,MATH 10A,A03,083737,Patchell; Gregory David,16,0,30,14
1657890445188,MATH 10B,A01,083207,Lim; Seonhee,8,0,34,26
1657890445188,MATH 10B,A02,083208,Lim; Seonhee,10,0,35,25
1657890445188,MATH 10B,A03,093472,Lim; Seonhee,7,0,34,27
1657890445188,MATH 10B,B01,083739,Sinha; Shubham,14,0,30,16
1657890451215,MATH 18,A01,083743,Cinel; Cameron Alexander,9,0,30,21
1657890451215,MATH 18,A02,083744,Cinel; Cameron Alexander,18,0,30,12
1657890451215,MATH 18,A03,083745,Cinel; Cameron Alexander,10,0,30,20
1657890451215,MATH 18,B01,083748,Rideout; David Porter,5,0,37,32
1657890451215,MATH 18,B02,083749,Rideout; David Porter,5,0,36,31
1657890451215,MATH 18,B03,083750,Rideout; David Porter,3,0,37,34
1657890451215,MATH 18,B04,083751,Rideout; David Porter,6,0,36,30
1657890451215,MATH 18,B05,093473,Rideout; David Porter,6,0,36,30
1657890451215,MATH 18,B06,093474,Rideout; David Porter,6,0,36,30
1657890457244,MATH 20A,A01,083754,Zheng; Zequn,14,0,40,26
1657890463274,MATH 20B,A01,083756,Briones; Jor-el Thomas Caparas,4,0,36,32
1657890463274,MATH 20B,A02,083757,Briones; Jor-el Thomas Caparas,1,0,36,35
1657890463274,MATH 20B,A03,093475,Briones; Jor-el Thomas Caparas,2,0,36,34
1657890469310,MATH 20C,A01,083760,Briones; Jor-el Thomas Caparas,1,0,35,34
1657890469310,MATH 20C,A02,083761,Briones; Jor-el Thomas Caparas,8,0,35,27
1657890469310,MATH 20C,A03,093476,Briones; Jor-el Thomas Caparas,0,1,36,36
1657890469310,MATH 20C,B01,083762,Bach; Quang Tran,1,0,30,29
1657890475340,MATH 20D,A01,083765,Tran; Brian Kha,5,0,30,25
1657890475340,MATH 20D,A02,083766,Tran; Brian Kha,5,0,30,25
1657890475340,MATH 20D,A03,083767,Tran; Brian Kha,5,0,30,25
1657890481385,MATH 20E,A01,083771,Ganguly; Soumya,10,0,32,22
1657890481385,MATH 20E,A02,083772,Ganguly; Soumya,6,0,32,26
1657890481385,MATH 20E,B01,083773,Ciotti; Benjamin,20,0,35,15
1657890481385,MATH 20E,B02,083774,Ciotti; Benjamin,18,0,35,17
1657890487411,MATH 103A,A01,083777,Greenfeld; Be'Eri,3,0,36,33
1657890487411,MATH 103A,A02,083778,Greenfeld; Be'Eri,5,0,36,31
1657890487411,MATH 103A,A03,093561,Greenfeld; Be'Eri,6,0,36,30
1657890487411,MATH 103A,B01,083779,Greenfeld; Be'Eri,7,0,36,29
1657890487411,MATH 103A,B02,083780,Greenfeld; Be'Eri,4,0,36,32
1657890487411,MATH 103A,B03,093562,Greenfeld; Be'Eri,3,0,36,33
1657890493441,MATH 105,A01,085443,Carter; Anne Toulson,15,0,35,20
1657890493441,MATH 105,A02,093477,Carter; Anne Toulson,20,0,35,15
1657890499465,MATH 109,A01,083213,Ganzberger; Geoffrey Michael,3,0,34,31
1657890499465,MATH 109,A02,083214,Ganzberger; Geoffrey Michael,4,0,34,30
1657890499465,MATH 109,A03,093478,Ganzberger; Geoffrey Michael,2,0,34,32
1657890499465,MATH 109,B01,083215,Ganzberger; Geoffrey Michael,1,0,32,31
1657890499465,MATH 109,B02,083216,Ganzberger; Geoffrey Michael,2,0,32,30
1657890499465,MATH 109,B03,093479,Ganzberger; Geoffrey Michael,8,0,32,24
1657890505496,MATH 142A,A01,083219,Chow; Bennett,7,0,32,25
1657890505496,MATH 142A,A02,083220,Chow; Bennett,10,0,32,22
1657890505496,MATH 142A,A03,093480,Chow; Bennett,9,0,32,23
1657890505496,MATH 142A,B03,093481,Chow; Bennett,8,0,32,24
1657890505496,MATH 142A,B04,093558,Chow; Bennett,13,0,32,19
1657890505496,MATH 142A,B05,093559,Chow; Bennett,7,0,32,25
1657890511521,MATH 193A,A01,083224,Rotar; Vladimir,8,0,34,26
1657890511521,MATH 193A,A02,083225,Rotar; Vladimir,10,0,34,24
1657890511521,MATH 193A,A03,083781,Rotar; Vladimir,5,0,34,29
1657890511521,MATH 193A,A04,083782,Rotar; Vladimir,11,0,34,23
1657890511521,MATH 193A,A05,093482,Rotar; Vladimir,10,0,34,24
1657890517544,MATH 197,001,091859,McAuley; Julian John,9999,0,9999,0
1657890517544,MATH 197,002,095566,Kedlaya; Kiran S.,9997,0,9999,2
1657890517544,MATH 197,003,095567,Xiao; Ming,9999,0,9999,0
1657890517544,MATH 197,004,095571,Perols; Johan Lars,9998,0,9999,1
1657890524621,COGS 9,A01,083615,Shannon; Kyle Michael,10,0,75,65
1657890530648,COGS 11,A01,083617,Boyle; Mary E. T.,23,0,48,25
1657890536673,COGS 13,A01,083071,Bastos; Amalia Pinkusfeld,11,0,71,60
1657890542699,COGS 14A,A01,092681,Semenuks; Arturs,5,1,100,95
1657890548730,COGS 14B,A01,083073,Cheng; Tzu-Han,6,0,63,57
1657890554759,COGS 17,A01,092677,Semenuks; Arturs,6,0,81,75
1657890560790,COGS 100,A01,083619,Allen; Michael Gordon,17,0,70,53
1657890566815,COGS 101A,A01,083621,Davis; Joshua Daniel,9,0,68,59
1657890572843,COGS 101B,A01,091572,Allen; Michael Gordon,13,0,65,52
1657890578868,COGS 101C,A01,083625,Delgado; Tania,17,0,35,18
1657890584895,COGS 107A,A01,083627,Boyle; Mary E. T.,14,0,60,46
1657890590917,COGS 118A,A01,083075,Gupta; Anjum,21,0,76,55
1657890596952,CSE 3,A50,083646,Miranda; Gregory Joseph,24,0,50,26
1657890602982,CSE 8A,A50,083650,Miranda; Gregory Joseph,17,1,56,39
1657890609013,CSE 11,A01,083080,Cao; Yingjun,6,15,40,34
1657890615042,CSE 12,A01,083652,Krause-Levy; Sophia Louisa,30,1,120,90
1657890621065,CSE 15L,A01,083654,Morris; Justin Loren,9,0,50,41
1657890621065,CSE 15L,A02,083655,Morris; Justin Loren,10,0,50,40
1657890627089,CSE 20,A01,083657,Tran; Khoa Dang,39,0,80,41
1657890633112,CSE 21,A01,095574,Bach; Quang Tran,22,0,48,26
1657890639135,CSE 30,A01,083084,Eldon; John,6,0,80,74
1657890639135,CSE 30,B01,095061,Bhaskar; Nishant,9,0,50,41
1657890645158,CSE 100,A01,083659,Cao; Yingjun,5,4,70,65
1657890651185,CSE 134B,A01,083661,Powell; Thomas Allan,24,0,100,76
1657890657213,CSE 140,A01,083663,Gungor; Onat,15,0,85,70
1657890663243,CSE 140L,A01,083088,Eldon; John,23,0,100,77
1657890669270,CSE 175,A01,083665,Kumar; Rakesh,3,0,25,22
1657890675305,CSE 190,A00,092507,Dubnov; Shlomo,8,0,20,12
1657890681333,ECE 45,A01,083139,Congero; Spencer William,6,0,75,69
1657890687360,ECE 65,A50,083695,Saad; Andrew S,12,0,30,18
1657890687360,ECE 65,A51,095125,Saad; Andrew S,24,0,26,2
1657890693388,ECE 109,A01,091882,Touri; Behrouz,20,0,70,50
1657890699412,ECE 180,A00,083140,Abi Samra; Nicholas Camill,1,0,30,29
1657890699412,ECE 180,B00,083141,Abi Samra; Nicholas Camill,0,0,30,30
1657890705445,MATH 10A,A01,083735,Patchell; Gregory David,2,0,30,28
1657890705445,MATH 10A,A02,083736,Patchell; Gregory David,20,0,30,10
1657890705445,MATH 10A,A03,083737,Patchell; Gregory David,16,0,30,14
1657890712511,MATH 10B,A01,083207,Lim; Seonhee,8,0,34,26
1657890712511,MATH 10B,A02,083208,Lim; Seonhee,10,0,35,25
1657890712511,MATH 10B,A03,093472,Lim; Seonhee,7,0,34,27
1657890712511,MATH 10B,B01,083739,Sinha; Shubham,14,0,30,16
1657890718578,MATH 18,A01,083743,Cinel; Cameron Alexander,9,0,30,21
1657890718578,MATH 18,A02,083744,Cinel; Cameron Alexander,18,0,30,12
1657890718578,MATH 18,A03,083745,Cinel; Cameron Alexander,10,0,30,20
1657890718578,MATH 18,B01,083748,Rideout; David Porter,5,0,37,32
1657890718578,MATH 18,B02,083749,Rideout; David Porter,5,0,36,31
1657890718578,MATH 18,B03,083750,Rideout; David Porter,3,0,37,34
1657890718578,MATH 18,B04,083751,Rideout; David Porter,6,0,36,30
1657890718578,MATH 18,B05,093473,Rideout; David Porter,6,0,36,30
1657890718578,MATH 18,B06,093474,Rideout; David Porter,6,0,36,30
1657890724602,MATH 20A,A01,083754,Zheng; Zequn,14,0,40,26
1657890730631,MATH 20B,A01,083756,Briones; Jor-el Thomas Caparas,4,0,36,32
1657890730631,MATH 20B,A02,083757,Briones; Jor-el Thomas Caparas,1,0,36,35
1657890730631,MATH 20B,A03,093475,Briones; Jor-el Thomas Caparas,2,0,36,34
1657890736656,MATH 20C,A01,083760,Briones; Jor-el Thomas Caparas,1,0,35,34
1657890736656,MATH 20C,A02,083761,Briones; Jor-el Thomas Caparas,8,0,35,27
1657890736656,MATH 20C,A03,093476,Briones; Jor-el Thomas Caparas,0,1,36,36
1657890736656,MATH 20C,B01,083762,Bach; Quang Tran,1,0,30,29
1657890742687,MATH 20D,A01,083765,Tran; Brian Kha,5,0,30,25
1657890742687,MATH 20D,A02,083766,Tran; Brian Kha,5,0,30,25
1657890742687,MATH 20D,A03,083767,Tran; Brian Kha,5,0,30,25
1657890748711,MATH 20E,A01,083771,Ganguly; Soumya,10,0,32,22
1657890748711,MATH 20E,A02,083772,Ganguly; Soumya,6,0,32,26
1657890748711,MATH 20E,B01,083773,Ciotti; Benjamin,20,0,35,15
1657890748711,MATH 20E,B02,083774,Ciotti; Benjamin,18,0,35,17
1657890754742,MATH 103A,A01,083777,Greenfeld; Be'Eri,3,0,36,33
1657890754742,MATH 103A,A02,083778,Greenfeld; Be'Eri,5,0,36,31
1657890754742,MATH 103A,A03,093561,Greenfeld; Be'Eri,6,0,36,30
1657890754742,MATH 103A,B01,083779,Greenfeld; Be'Eri,7,0,36,29
1657890754742,MATH 103A,B02,083780,Greenfeld; Be'Eri,4,0,36,32
1657890754742,MATH 103A,B03,093562,Greenfeld; Be'Eri,3,0,36,33
1657890760788,MATH 105,A01,085443,Carter; Anne Toulson,15,0,35,20
1657890760788,MATH 105,A02,093477,Carter; Anne Toulson,20,0,35,15
1657890766813,MATH 109,A01,083213,Ganzberger; Geoffrey Michael,3,0,34,31
1657890766813,MATH 109,A02,083214,Ganzberger; Geoffrey Michael,4,0,34,30
1657890766813,MATH 109,A03,093478,Ganzberger; Geoffrey Michael,2,0,34,32
1657890766813,MATH 109,B01,083215,Ganzberger; Geoffrey Michael,1,0,32,31
1657890766813,MATH 109,B02,083216,Ganzberger; Geoffrey Michael,2,0,32,30
1657890766813,MATH 109,B03,093479,Ganzberger; Geoffrey Michael,8,0,32,24
1657890772843,MATH 142A,A01,083219,Chow; Bennett,7,0,32,25
1657890772843,MATH 142A,A02,083220,Chow; Bennett,10,0,32,22
1657890772843,MATH 142A,A03,093480,Chow; Bennett,9,0,32,23
1657890772843,MATH 142A,B03,093481,Chow; Bennett,8,0,32,24
1657890772843,MATH 142A,B04,093558,Chow; Bennett,13,0,32,19
1657890772843,MATH 142A,B05,093559,Chow; Bennett,7,0,32,25
1657890778870,MATH 193A,A01,083224,Rotar; Vladimir,8,0,34,26
1657890778870,MATH 193A,A02,083225,Rotar; Vladimir,10,0,34,24
1657890778870,MATH 193A,A03,083781,Rotar; Vladimir,5,0,34,29
1657890778870,MATH 193A,A04,083782,Rotar; Vladimir,11,0,34,23
1657890778870,MATH 193A,A05,093482,Rotar; Vladimir,10,0,34,24
1657890784895,MATH 197,001,091859,McAuley; Julian John,9999,0,9999,0
1657890784895,MATH 197,002,095566,Kedlaya; Kiran S.,9997,0,9999,2
1657890784895,MATH 197,003,095567,Xiao; Ming,9999,0,9999,0
1657890784895,MATH 197,004,095571,Perols; Johan Lars,9998,0,9999,1
1657890791970,COGS 9,A01,083615,Shannon; Kyle Michael,10,0,75,65
1657890797994,COGS 11,A01,083617,Boyle; Mary E. T.,23,0,48,25
1657890804019,COGS 13,A01,083071,Bastos; Amalia Pinkusfeld,11,0,71,60
1657890810051,COGS 14A,A01,092681,Semenuks; Arturs,5,1,100,95
1657890816075,COGS 14B,A01,083073,Cheng; Tzu-Han,6,0,63,57
1657890822099,COGS 17,A01,092677,Semenuks; Arturs,6,0,81,75
1657890828124,COGS 100,A01,083619,Allen; Michael Gordon,17,0,70,53
1657890834149,COGS 101A,A01,083621,Davis; Joshua Daniel,9,0,68,59
1657890840174,COGS 101B,A01,091572,Allen; Michael Gordon,13,0,65,52
1657890846200,COGS 101C,A01,083625,Delgado; Tania,17,0,35,18
1657890852232,COGS 107A,A01,083627,Boyle; Mary E. T.,14,0,60,46
1657890858260,COGS 118A,A01,083075,Gupta; Anjum,21,0,76,55
1657890864290,CSE 3,A50,083646,Miranda; Gregory Joseph,24,0,50,26
1657890870318,CSE 8A,A50,083650,Miranda; Gregory Joseph,17,1,56,39
1657890876346,CSE 11,A01,083080,Cao; Yingjun,6,15,40,34
1657890882374,CSE 12,A01,083652,Krause-Levy; Sophia Louisa,30,1,120,90
1657890888396,CSE 15L,A01,083654,Morris; Justin Loren,9,0,50,41
1657890888396,CSE 15L,A02,083655,Morris; Justin Loren,10,0,50,40
1657890894419,CSE 20,A01,083657,Tran; Khoa Dang,39,0,80,41
1657890900445,CSE 21,A01,095574,Bach; Quang Tran,22,0,48,26
1657890906475,CSE 30,A01,083084,Eldon; John,6,0,80,74
1657890906475,CSE 30,B01,095061,Bhaskar; Nishant,9,0,50,41
1657890912501,CSE 100,A01,083659,Cao; Yingjun,5,4,70,65
1657890918527,CSE 134B,A01,083661,Powell; Thomas Allan,24,0,100,76
1657890924552,CSE 140,A01,083663,Gungor; Onat,15,0,85,70
1657890930575,CSE 140L,A01,083088,Eldon; John,23,0,100,77
1657890936603,CSE 175,A01,083665,Kumar; Rakesh,3,0,25,22
1657890942626,CSE 190,A00,092507,Dubnov; Shlomo,8,0,20,12
1657890948649,ECE 45,A01,083139,Congero; Spencer William,6,0,75,69
1657890954752,ECE 65,A50,083695,Saad; Andrew S,12,0,30,18
1657890954752,ECE 65,A51,095125,Saad; Andrew S,24,0,26,2
1657890960782,ECE 109,A01,091882,Touri; Behrouz,20,0,70,50
1657890966811,ECE 180,A00,083140,Abi Samra; Nicholas Camill,1,0,30,29
1657890966811,ECE 180,B00,083141,Abi Samra; Nicholas Camill,0,0,30,30
1657890972842,MATH 10A,A01,083735,Patchell; Gregory David,2,0,30,28
1657890972842,MATH 10A,A02,083736,Patchell; Gregory David,20,0,30,10
1657890972842,MATH 10A,A03,083737,Patchell; Gregory David,16,0,30,14
1657890978873,MATH 10B,A01,083207,Lim; Seonhee,8,0,34,26
1657890978873,MATH 10B,A02,083208,Lim; Seonhee,10,0,35,25
1657890978873,MATH 10B,A03,093472,Lim; Seonhee,7,0,34,27
1657890978873,MATH 10B,B01,083739,Sinha; Shubham,14,0,30,16
1657890984900,MATH 18,A01,083743,Cinel; Cameron Alexander,9,0,30,21
1657890984900,MATH 18,A02,083744,Cinel; Cameron Alexander,18,0,30,12
1657890984900,MATH 18,A03,083745,Cinel; Cameron Alexander,10,0,30,20
1657890984900,MATH 18,B01,083748,Rideout; David Porter,5,0,37,32
1657890984900,MATH 18,B02,083749,Rideout; David Porter,5,0,36,31
1657890984900,MATH 18,B03,083750,Rideout; David Porter,3,0,37,34
1657890984900,MATH 18,B04,083751,Rideout; David Porter,6,0,36,30
1657890984900,MATH 18,B05,093473,Rideout; David Porter,6,0,36,30
1657890984900,MATH 18,B06,093474,Rideout; David Porter,6,0,36,30
1657890990925,MATH 20A,A01,083754,Zheng; Zequn,14,0,40,26
1657890996960,MATH 20B,A01,083756,Briones; Jor-el Thomas Caparas,4,0,36,32
1657890996960,MATH 20B,A02,083757,Briones; Jor-el Thomas Caparas,1,0,36,35
1657890996960,MATH 20B,A03,093475,Briones; Jor-el Thomas Caparas,2,0,36,34
1657891002985,MATH 20C,A01,083760,Briones; Jor-el Thomas Caparas,1,0,35,34
1657891002985,MATH 20C,A02,083761,Briones; Jor-el Thomas Caparas,8,0,35,27
1657891002985,MATH 20C,A03,093476,Briones; Jor-el Thomas Caparas,0,1,36,36
1657891002985,MATH 20C,B01,083762,Bach; Quang Tran,1,0,30,29
1657891009011,MATH 20D,A01,083765,Tran; Brian Kha,5,0,30,25
1657891009011,MATH 20D,A02,083766,Tran; Brian Kha,5,0,30,25
1657891009011,MATH 20D,A03,083767,Tran; Brian Kha,5,0,30,25
1657891015049,MATH 20E,A01,083771,Ganguly; Soumya,10,0,32,22
1657891015049,MATH 20E,A02,083772,Ganguly; Soumya,6,0,32,26
1657891015049,MATH 20E,B01,083773,Ciotti; Benjamin,20,0,35,15
1657891015049,MATH 20E,B02,083774,Ciotti; Benjamin,18,0,35,17
1657891021075,MATH 103A,A01,083777,Greenfeld; Be'Eri,3,0,36,33
1657891021075,MATH 103A,A02,083778,Greenfeld; Be'Eri,5,0,36,31
1657891021075,MATH 103A,A03,093561,Greenfeld; Be'Eri,6,0,36,30
1657891021075,MATH 103A,B01,083779,Greenfeld; Be'Eri,7,0,36,29
1657891021075,MATH 103A,B02,083780,Greenfeld; Be'Eri,4,0,36,32
1657891021075,MATH 103A,B03,093562,Greenfeld; Be'Eri,3,0,36,33
1657891027104,MATH 105,A01,085443,Carter; Anne Toulson,15,0,35,20
1657891027104,MATH 105,A02,093477,Carter; Anne Toulson,20,0,35,15
1657891033142,MATH 109,A01,083213,Ganzberger; Geoffrey Michael,3,0,34,31
1657891033142,MATH 109,A02,083214,Ganzberger; Geoffrey Michael,4,0,34,30
1657891033142,MATH 109,A03,093478,Ganzberger; Geoffrey Michael,2,0,34,32
1657891033142,MATH 109,B01,083215,Ganzberger; Geoffrey Michael,1,0,32,31
1657891033142,MATH 109,B02,083216,Ganzberger; Geoffrey Michael,2,0,32,30
1657891033142,MATH 109,B03,093479,Ganzberger; Geoffrey Michael,8,0,32,24
1657891039168,MATH 142A,A01,083219,Chow; Bennett,7,0,32,25
1657891039168,MATH 142A,A02,083220,Chow; Bennett,10,0,32,22
1657891039168,MATH 142A,A03,093480,Chow; Bennett,9,0,32,23
1657891039168,MATH 142A,B03,093481,Chow; Bennett,8,0,32,24
1657891039168,MATH 142A,B04,093558,Chow; Bennett,13,0,32,19
1657891039168,MATH 142A,B05,093559,Chow; Bennett,7,0,32,25
1657891045202,MATH 193A,A01,083224,Rotar; Vladimir,8,0,34,26
1657891045202,MATH 193A,A02,083225,Rotar; Vladimir,10,0,34,24
1657891045202,MATH 193A,A03,083781,Rotar; Vladimir,5,0,34,29
1657891045202,MATH 193A,A04,083782,Rotar; Vladimir,11,0,34,23
1657891045202,MATH 193A,A05,093482,Rotar; Vladimir,10,0,34,24
1657891051236,MATH 197,001,091859,McAuley; Julian John,9999,0,9999,0
1657891051236,MATH 197,002,095566,Kedlaya; Kiran S.,9997,0,9999,2
1657891051236,MATH 197,003,095567,Xiao; Ming,9999,0,9999,0
1657891051236,MATH 197,004,095571,Perols; Johan Lars,9998,0,9999,1
1657891058304,COGS 9,A01,083615,Shannon; Kyle Michael,10,0,75,65
1657891064332,COGS 11,A01,083617,Boyle; Mary E. T.,23,0,48,25
1657891070358,COGS 13,A01,083071,Bastos; Amalia Pinkusfeld,11,0,71,60
1657891076389,COGS 14A,A01,092681,Semenuks; Arturs,5,1,100,95
1657891082415,COGS 14B,A01,083073,Cheng; Tzu-Han,6,0,63,57
1657891088445,COGS 17,A01,092677,Semenuks; Arturs,6,0,81,75
1657891094469,COGS 100,A01,083619,Allen; Michael Gordon,17,0,70,53
1657891100497,COGS 101A,A01,083621,Davis; Joshua Daniel,9,0,68,59
1657891106522,COGS 101B,A01,091572,Allen; Michael Gordon,13,0,65,52
1657891112547,COGS 101C,A01,083625,Delgado; Tania,17,0,35,18
1657891118571,COGS 107A,A01,083627,Boyle; Mary E. T.,14,0,60,46
1657891124594,COGS 118A,A01,083075,Gupta; Anjum,21,0,76,55
1657891130624,CSE 3,A50,083646,Miranda; Gregory Joseph,24,0,50,26
1657891136654,CSE 8A,A50,083650,Miranda; Gregory Joseph,17,1,56,39
1657891142679,CSE 11,A01,083080,Cao; Yingjun,6,15,40,34
1657891148707,CSE 12,A01,083652,Krause-Levy; Sophia Louisa,30,1,120,90
1657891154731,CSE 15L,A01,083654,Morris; Justin Loren,9,0,50,41
1657891154731,CSE 15L,A02,083655,Morris; Justin Loren,10,0,50,40
1657891160759,CSE 20,A01,083657,Tran; Khoa Dang,39,0,80,41
1657891166784,CSE 21,A01,095574,Bach; Quang Tran,22,0,48,26
1657891172810,CSE 30,A01,083084,Eldon; John,6,0,80,74
1657891172810,CSE 30,B01,095061,Bhaskar; Nishant,9,0,50,41
1657891178835,CSE 100,A01,083659,Cao; Yingjun,5,4,70,65
1657891184860,CSE 134B,A01,083661,Powell; Thomas Allan,24,0,100,76
1657891190886,CSE 140,A01,083663,Gungor; Onat,15,0,85,70
1657891196915,CSE 140L,A01,083088,Eldon; John,23,0,100,77
1657891202943,CSE 175,A01,083665,Kumar; Rakesh,3,0,25,22
1657891208966,CSE 190,A00,092507,Dubnov; Shlomo,8,0,20,12
1657891214994,ECE 45,A01,083139,Congero; Spencer William,6,0,75,69
1657891221022,ECE 65,A50,083695,Saad; Andrew S,12,0,30,18
1657891221022,ECE 65,A51,095125,Saad; Andrew S,24,0,26,2
1657891227047,ECE 109,A01,091882,Touri; Behrouz,20,0,70,50
1657891233070,ECE 180,A00,083140,Abi Samra; Nicholas Camill,1,0,30,29
1657891233070,ECE 180,B00,083141,Abi Samra; Nicholas Camill,0,0,30,30
1657891239101,MATH 10A,A01,083735,Patchell; Gregory David,2,0,30,28
1657891239101,MATH 10A,A02,083736,Patchell; Gregory David,20,0,30,10
1657891239101,MATH 10A,A03,083737,Patchell; Gregory David,16,0,30,14
1657891245128,MATH 10B,A01,083207,Lim; Seonhee,8,0,34,26
1657891245128,MATH 10B,A02,083208,Lim; Seonhee,10,0,35,25
1657891245128,MATH 10B,A03,093472,Lim; Seonhee,7,0,34,27
1657891245128,MATH 10B,B01,083739,Sinha; Shubham,14,0,30,16
1657891251157,MATH 18,A01,083743,Cinel; Cameron Alexander,9,0,30,21
1657891251157,MATH 18,A02,083744,Cinel; Cameron Alexander,18,0,30,12
1657891251157,MATH 18,A03,083745,Cinel; Cameron Alexander,10,0,30,20
1657891251157,MATH 18,B01,083748,Rideout; David Porter,5,0,37,32
1657891251157,MATH 18,B02,083749,Rideout; David Porter,5,0,36,31
1657891251157,MATH 18,B03,083750,Rideout; David Porter,3,0,37,34
1657891251157,MATH 18,B04,083751,Rideout; David Porter,6,0,36,30
1657891251157,MATH 18,B05,093473,Rideout; David Porter,6,0,36,30
1657891251157,MATH 18,B06,093474,Rideout; David Porter,6,0,36,30
1657891257183,MATH 20A,A01,083754,Zheng; Zequn,14,0,40,26
1657891263220,MATH 20B,A01,083756,Briones; Jor-el Thomas Caparas,4,0,36,32
1657891263220,MATH 20B,A02,083757,Briones; Jor-el Thomas Caparas,1,0,36,35
1657891263220,MATH 20B,A03,093475,Briones; Jor-el Thomas Caparas,2,0,36,34
1657891269244,MATH 20C,A01,083760,Briones; Jor-el Thomas Caparas,1,0,35,34
1657891269244,MATH 20C,A02,083761,Briones; Jor-el Thomas Caparas,8,0,35,27
1657891269244,MATH 20C,A03,093476,Briones; Jor-el Thomas Caparas,0,1,36,36
1657891269244,MATH 20C,B01,083762,Bach; Quang Tran,1,0,30,29
1657891275269,MATH 20D,A01,083765,Tran; Brian Kha,5,0,30,25
1657891275269,MATH 20D,A02,083766,Tran; Brian Kha,5,0,30,25
1657891275269,MATH 20D,A03,083767,Tran; Brian Kha,5,0,30,25
1657891281296,MATH 20E,A01,083771,Ganguly; Soumya,10,0,32,22
1657891281296,MATH 20E,A02,083772,Ganguly; Soumya,6,0,32,26
1657891281296,MATH 20E,B01,083773,Ciotti; Benjamin,20,0,35,15
1657891281296,MATH 20E,B02,083774,Ciotti; Benjamin,18,0,35,17
1657891287330,MATH 103A,A01,083777,Greenfeld; Be'Eri,3,0,36,33
1657891287330,MATH 103A,A02,083778,Greenfeld; Be'Eri,5,0,36,31
1657891287330,MATH 103A,A03,093561,Greenfeld; Be'Eri,6,0,36,30
1657891287330,MATH 103A,B01,083779,Greenfeld; Be'Eri,7,0,36,29
1657891287330,MATH 103A,B02,083780,Greenfeld; Be'Eri,4,0,36,32
1657891287330,MATH 103A,B03,093562,Greenfeld; Be'Eri,3,0,36,33
1657891293356,MATH 105,A01,085443,Carter; Anne Toulson,15,0,35,20
1657891293356,MATH 105,A02,093477,Carter; Anne Toulson,20,0,35,15
1657891299384,MATH 109,A01,083213,Ganzberger; Geoffrey Michael,3,0,34,31
1657891299384,MATH 109,A02,083214,Ganzberger; Geoffrey Michael,4,0,34,30
1657891299384,MATH 109,A03,093478,Ganzberger; Geoffrey Michael,2,0,34,32
1657891299384,MATH 109,B01,083215,Ganzberger; Geoffrey Michael,1,0,32,31
1657891299384,MATH 109,B02,083216,Ganzberger; Geoffrey Michael,2,0,32,30
1657891299384,MATH 109,B03,093479,Ganzberger; Geoffrey Michael,8,0,32,24
1657891305417,MATH 142A,A01,083219,Chow; Bennett,7,0,32,25
1657891305417,MATH 142A,A02,083220,Chow; Bennett,10,0,32,22
1657891305417,MATH 142A,A03,093480,Chow; Bennett,9,0,32,23
1657891305417,MATH 142A,B03,093481,Chow; Bennett,8,0,32,24
1657891305417,MATH 142A,B04,093558,Chow; Bennett,13,0,32,19
1657891305417,MATH 142A,B05,093559,Chow; Bennett,7,0,32,25
1657891311448,MATH 193A,A01,083224,Rotar; Vladimir,8,0,34,26
1657891311448,MATH 193A,A02,083225,Rotar; Vladimir,10,0,34,24
1657891311448,MATH 193A,A03,083781,Rotar; Vladimir,5,0,34,29
1657891311448,MATH 193A,A04,083782,Rotar; Vladimir,11,0,34,23
1657891311448,MATH 193A,A05,093482,Rotar; Vladimir,10,0,34,24
1657891317475,MATH 197,001,091859,McAuley; Julian John,9999,0,9999,0
1657891317475,MATH 197,002,095566,Kedlaya; Kiran S.,9997,0,9999,2
1657891317475,MATH 197,003,095567,Xiao; Ming,9999,0,9999,0
1657891317475,MATH 197,004,095571,Perols; Johan Lars,9998,0,9999,1
1657891324534,COGS 9,A01,083615,Shannon; Kyle Michael,10,0,75,65
1657891330557,COGS 11,A01,083617,Boyle; Mary E. T.,23,0,48,25
1657891336581,COGS 13,A01,083071,Bastos; Amalia Pinkusfeld,11,0,71,60
1657891342607,COGS 14A,A01,092681,Semenuks; Arturs,5,1,100,95
1657891348633,COGS 14B,A01,083073,Cheng; Tzu-Han,6,0,63,57
1657891354655,COGS 17,A01,092677,Semenuks; Arturs,6,0,81,75
1657891360686,COGS 100,A01,083619,Allen; Michael Gordon,17,0,70,53
1657891366709,COGS 101A,A01,083621,Davis; Joshua Daniel,9,0,68,59
1657891372737,COGS 101B,A01,091572,Allen; Michael Gordon,13,0,65,52
1657891378762,COGS 101C,A01,083625,Delgado; Tania,17,0,35,18
1657891384788,COGS 107A,A01,083627,Boyle; Mary E. T.,14,0,60,46
1657891390811,COGS 118A,A01,083075,Gupta; Anjum,21,0,76,55
1657891396841,CSE 3,A50,083646,Miranda; Gregory Joseph,24,0,50,26
1657891402869,CSE 8A,A50,083650,Miranda; Gregory Joseph,17,1,56,39
1657891408893,CSE 11,A01,083080,Cao; Yingjun,6,15,40,34
1657891414919,CSE 12,A01,083652,Krause-Levy; Sophia Louisa,30,1,120,90
1657891420950,CSE 15L,A01,083654,Morris; Justin Loren,9,0,50,41
1657891420950,CSE 15L,A02,083655,Morris; Justin Loren,10,0,50,40
1657891426978,CSE 20,A01,083657,Tran; Khoa Dang,39,0,80,41
1657891433011,CSE 21,A01,095574,Bach; Quang Tran,22,0,48,26
1657891439035,CSE 30,A01,083084,Eldon; John,6,0,80,74
1657891439035,CSE 30,B01,095061,Bhaskar; Nishant,9,0,50,41
1657891445062,CSE 100,A01,083659,Cao; Yingjun,5,4,70,65
1657891451087,CSE 134B,A01,083661,Powell; Thomas Allan,24,0,100,76
1657891457110,CSE 140,A01,083663,Gungor; Onat,15,0,85,70
1657891463138,CSE 140L,A01,083088,Eldon; John,23,0,100,77
1657891469166,CSE 175,A01,083665,Kumar; Rakesh,3,0,25,22
1657891475191,CSE 190,A00,092507,Dubnov; Shlomo,8,0,20,12
1657891481215,ECE 45,A01,083139,Congero; Spencer William,6,0,75,69
1657891487245,ECE 65,A50,083695,Saad; Andrew S,12,0,30,18
1657891487245,ECE 65,A51,095125,Saad; Andrew S,24,0,26,2
1657891493272,ECE 109,A01,091882,Touri; Behrouz,20,0,70,50
1657891499297,ECE 180,A00,083140,Abi Samra; Nicholas Camill,1,0,30,29
1657891499297,ECE 180,B00,083141,Abi Samra; Nicholas Camill,0,0,30,30
1657891505330,MATH 10A,A01,083735,Patchell; Gregory David,2,0,30,28
1657891505330,MATH 10A,A02,083736,Patchell; Gregory David,20,0,30,10
1657891505330,MATH 10A,A03,083737,Patchell; Gregory David,16,0,30,14
1657891511355,MATH 10B,A01,083207,Lim; Seonhee,8,0,34,26
1657891511355,MATH 10B,A02,083208,Lim; Seonhee,10,0,35,25
1657891511355,MATH 10B,A03,093472,Lim; Seonhee,7,0,34,27
1657891511355,MATH 10B,B01,083739,Sinha; Shubham,14,0,30,16
1657891517380,MATH 18,A01,083743,Cinel; Cameron Alexander,9,0,30,21
1657891517380,MATH 18,A02,083744,Cinel; Cameron Alexander,18,0,30,12
1657891517380,MATH 18,A03,083745,Cinel; Cameron Alexander,10,0,30,20
1657891517380,MATH 18,B01,083748,Rideout; David Porter,5,0,37,32
1657891517380,MATH 18,B02,083749,Rideout; David Porter,5,0,36,31
1657891517380,MATH 18,B03,083750,Rideout; David Porter,3,0,37,34
1657891517380,MATH 18,B04,083751,Rideout; David Porter,6,0,36,30
1657891517380,MATH 18,B05,093473,Rideout; David Porter,6,0,36,30
1657891517380,MATH 18,B06,093474,Rideout; David Porter,6,0,36,30
1657891523419,MATH 20A,A01,083754,Zheng; Zequn,14,0,40,26
1657891529443,MATH 20B,A01,083756,Briones; Jor-el Thomas Caparas,4,0,36,32
1657891529443,MATH 20B,A02,083757,Briones; Jor-el Thomas Caparas,1,0,36,35
1657891529443,MATH 20B,A03,093475,Briones; Jor-el Thomas Caparas,2,0,36,34
1657891535468,MATH 20C,A01,083760,Briones; Jor-el Thomas Caparas,1,0,35,34
1657891535468,MATH 20C,A02,083761,Briones; Jor-el Thomas Caparas,8,0,35,27
1657891535468,MATH 20C,A03,093476,Briones; Jor-el Thomas Caparas,0,1,36,36
1657891535468,MATH 20C,B01,083762,Bach; Quang Tran,1,0,30,29
1657891541499,MATH 20D,A01,083765,Tran; Brian Kha,5,0,30,25
1657891541499,MATH 20D,A02,083766,Tran; Brian Kha,5,0,30,25
1657891541499,MATH 20D,A03,083767,Tran; Brian Kha,5,0,30,25
1657891547526,MATH 20E,A01,083771,Ganguly; Soumya,10,0,32,22
1657891547526,MATH 20E,A02,083772,Ganguly; Soumya,6,0,32,26
1657891547526,MATH 20E,B01,083773,Ciotti; Benjamin,20,0,35,15
1657891547526,MATH 20E,B02,083774,Ciotti; Benjamin,18,0,35,17
1657891553636,MATH 103A,A01,083777,Greenfeld; Be'Eri,3,0,36,33
1657891553636,MATH 103A,A02,083778,Greenfeld; Be'Eri,5,0,36,31
1657891553636,MATH 103A,A03,093561,Greenfeld; Be'Eri,6,0,36,30
1657891553636,MATH 103A,B01,083779,Greenfeld; Be'Eri,7,0,36,29
1657891553636,MATH 103A,B02,083780,Greenfeld; Be'Eri,4,0,36,32
1657891553636,MATH 103A,B03,093562,Greenfeld; Be'Eri,3,0,36,33
1657891559666,MATH 105,A01,085443,Carter; Anne Toulson,15,0,35,20
1657891559666,MATH 105,A02,093477,Carter; Anne Toulson,20,0,35,15
1657891565690,MATH 109,A01,083213,Ganzberger; Geoffrey Michael,3,0,34,31
1657891565690,MATH 109,A02,083214,Ganzberger; Geoffrey Michael,4,0,34,30
1657891565690,MATH 109,A03,093478,Ganzberger; Geoffrey Michael,2,0,34,32
1657891565690,MATH 109,B01,083215,Ganzberger; Geoffrey Michael,1,0,32,31
1657891565690,MATH 109,B02,083216,Ganzberger; Geoffrey Michael,2,0,32,30
1657891565690,MATH 109,B03,093479,Ganzberger; Geoffrey Michael,8,0,32,24
1657891571716,MATH 142A,A01,083219,Chow; Bennett,7,0,32,25
1657891571716,MATH 142A,A02,083220,Chow; Bennett,10,0,32,22
1657891571716,MATH 142A,A03,093480,Chow; Bennett,9,0,32,23
1657891571716,MATH 142A,B03,093481,Chow; Bennett,8,0,32,24
1657891571716,MATH 142A,B04,093558,Chow; Bennett,13,0,32,19
1657891571716,MATH 142A,B05,093559,Chow; Bennett,7,0,32,25
1657891577742,MATH 193A,A01,083224,Rotar; Vladimir,8,0,34,26
1657891577742,MATH 193A,A02,083225,Rotar; Vladimir,10,0,34,24
1657891577742,MATH 193A,A03,083781,Rotar; Vladimir,5,0,34,29
1657891577742,MATH 193A,A04,083782,Rotar; Vladimir,11,0,34,23
1657891577742,MATH 193A,A05,093482,Rotar; Vladimir,10,0,34,24
1657891583771,MATH 197,001,091859,McAuley; Julian John,9999,0,9999,0
1657891583771,MATH 197,002,095566,Kedlaya; Kiran S.,9997,0,9999,2
1657891583771,MATH 197,003,095567,Xiao; Ming,9999,0,9999,0
1657891583771,MATH 197,004,095571,Perols; Johan Lars,9998,0,9999,1
1657891590847,COGS 9,A01,083615,Shannon; Kyle Michael,10,0,75,65
1657891596879,COGS 11,A01,083617,Boyle; Mary E. T.,23,0,48,25
1657891602904,COGS 13,A01,083071,Bastos; Amalia Pinkusfeld,11,0,71,60
1657891608934,COGS 14A,A01,092681,Semenuks; Arturs,5,1,100,95
1657891614957,COGS 14B,A01,083073,Cheng; Tzu-Han,6,0,63,57
1657891620981,COGS 17,A01,092677,Semenuks; Arturs,6,0,81,75
1657891627006,COGS 100,A01,083619,Allen; Michael Gordon,17,0,70,53
1657891633034,COGS 101A,A01,083621,Davis; Joshua Daniel,9,0,68,59
1657891639059,COGS 101B,A01,091572,Allen; Michael Gordon,13,0,65,52
1657891645083,COGS 101C,A01,083625,Delgado; Tania,17,0,35,18
1657891651110,COGS 107A,A01,083627,Boyle; Mary E. T.,14,0,60,46
1657891657141,COGS 118A,A01,083075,Gupta; Anjum,21,0,76,55
1657891663166,CSE 3,A50,083646,Miranda; Gregory Joseph,24,0,50,26
1657891669200,CSE 8A,A50,083650,Miranda; Gregory Joseph,17,1,56,39
1657891675229,CSE 11,A01,083080,Cao; Yingjun,6,15,40,34
1657891681259,CSE 12,A01,083652,Krause-Levy; Sophia Louisa,30,1,120,90
1657891687286,CSE 15L,A01,083654,Morris; Justin Loren,9,0,50,41
1657891687286,CSE 15L,A02,083655,Morris; Justin Loren,10,0,50,40
1657891693310,CSE 20,A01,083657,Tran; Khoa Dang,39,0,80,41
1657891699339,CSE 21,A01,095574,Bach; Quang Tran,22,0,48,26
1657891705368,CSE 30,A01,083084,Eldon; John,6,0,80,74
1657891705368,CSE 30,B01,095061,Bhaskar; Nishant,9,0,50,41
1657891711398,CSE 100,A01,083659,Cao; Yingjun,5,4,70,65
1657891717433,CSE 134B,A01,083661,Powell; Thomas Allan,24,0,100,76
1657891723459,CSE 140,A01,083663,Gungor; Onat,15,0,85,70
1657891729488,CSE 140L,A01,083088,Eldon; John,23,0,100,77
1657891735519,CSE 175,A01,083665,Kumar; Rakesh,3,0,25,22
1657891741545,CSE 190,A00,092507,Dubnov; Shlomo,8,0,20,12
1657891747569,ECE 45,A01,083139,Congero; Spencer William,6,0,75,69
1657891753594,ECE 65,A50,083695,Saad; Andrew S,12,0,30,18
1657891753594,ECE 65,A51,095125,Saad; Andrew S,24,0,26,2
1657891759620,ECE 109,A01,091882,Touri; Behrouz,20,0,70,50
1657891765646,ECE 180,A00,083140,Abi Samra; Nicholas Camill,1,0,30,29
1657891765646,ECE 180,B00,083141,Abi Samra; Nicholas Camill,0,0,30,30
1657891771669,MATH 10A,A01,083735,Patchell; Gregory David,2,0,30,28
1657891771669,MATH 10A,A02,083736,Patchell; Gregory David,20,0,30,10
1657891771669,MATH 10A,A03,083737,Patchell; Gregory David,16,0,30,14
1657891777694,MATH 10B,A01,083207,Lim; Seonhee,8,0,34,26
1657891777694,MATH 10B,A02,083208,Lim; Seonhee,10,0,35,25
1657891777694,MATH 10B,A03,093472,Lim; Seonhee,7,0,34,27
1657891777694,MATH 10B,B01,083739,Sinha; Shubham,14,0,30,16
1657891783718,MATH 18,A01,083743,Cinel; Cameron Alexander,9,0,30,21
1657891783718,MATH 18,A02,083744,Cinel; Cameron Alexander,18,0,30,12
1657891783718,MATH 18,A03,083745,Cinel; Cameron Alexander,10,0,30,20
1657891783718,MATH 18,B01,083748,Rideout; David Porter,5,0,37,32
1657891783718,MATH 18,B02,083749,Rideout; David Porter,5,0,36,31
1657891783718,MATH 18,B03,083750,Rideout; David Porter,3,0,37,34
1657891783718,MATH 18,B04,083751,Rideout; David Porter,6,0,36,30
1657891783718,MATH 18,B05,093473,Rideout; David Porter,6,0,36,30
1657891783718,MATH 18,B06,093474,Rideout; David Porter,6,0,36,30
1657891789759,MATH 20A,A01,083754,Zheng; Zequn,14,0,40,26
1657891795789,MATH 20B,A01,083756,Briones; Jor-el Thomas Caparas,4,0,36,32
1657891795789,MATH 20B,A02,083757,Briones; Jor-el Thomas Caparas,1,0,36,35
1657891795789,MATH 20B,A03,093475,Briones; Jor-el Thomas Caparas,2,0,36,34
1657891801814,MATH 20C,A01,083760,Briones; Jor-el Thomas Caparas,1,0,35,34
1657891801814,MATH 20C,A02,083761,Briones; Jor-el Thomas Caparas,8,0,35,27
1657891801814,MATH 20C,A03,093476,Briones; Jor-el Thomas Caparas,0,1,36,36
1657891801814,MATH 20C,B01,083762,Bach; Quang Tran,1,0,30,29
1657891807837,MATH 20D,A01,083765,Tran; Brian Kha,5,0,30,25
1657891807837,MATH 20D,A02,083766,Tran; Brian Kha,5,0,30,25
1657891807837,MATH 20D,A03,083767,Tran; Brian Kha,5,0,30,25
1657891813864,MATH 20E,A01,083771,Ganguly; Soumya,10,0,32,22
1657891813864,MATH 20E,A02,083772,Ganguly; Soumya,6,0,32,26
1657891813864,MATH 20E,B01,083773,Ciotti; Benjamin,20,0,35,15
1657891813864,MATH 20E,B02,083774,Ciotti; Benjamin,18,0,35,17
1657891819912,MATH 103A,A01,083777,Greenfeld; Be'Eri,3,0,36,33
1657891819912,MATH 103A,A02,083778,Greenfeld; Be'Eri,5,0,36,31
1657891819912,MATH 103A,A03,093561,Greenfeld; Be'Eri,6,0,36,30
1657891819912,MATH 103A,B01,083779,Greenfeld; Be'Eri,7,0,36,29
1657891819912,MATH 103A,B02,083780,Greenfeld; Be'Eri,4,0,36,32
1657891819912,MATH 103A,B03,093562,Greenfeld; Be'Eri,3,0,36,33
1657891825936,MATH 105,A01,085443,Carter; Anne Toulson,15,0,35,20
1657891825936,MATH 105,A02,093477,Carter; Anne Toulson,20,0,35,15
1657891831963,MATH 109,A01,083213,Ganzberger; Geoffrey Michael,3,0,34,31
1657891831963,MATH 109,A02,083214,Ganzberger; Geoffrey Michael,4,0,34,30
1657891831963,MATH 109,A03,093478,Ganzberger; Geoffrey Michael,2,0,34,32
1657891831963,MATH 109,B01,083215,Ganzberger; Geoffrey Michael,1,0,32,31
1657891831963,MATH 109,B02,083216,Ganzberger; Geoffrey Michael,2,0,32,30
1657891831963,MATH 109,B03,093479,Ganzberger; Geoffrey Michael,8,0,32,24
1657891837999,MATH 142A,A01,083219,Chow; Bennett,7,0,32,25
1657891837999,MATH 142A,A02,083220,Chow; Bennett,10,0,32,22
1657891837999,MATH 142A,A03,093480,Chow; Bennett,9,0,32,23
1657891837999,MATH 142A,B03,093481,Chow; Bennett,8,0,32,24
1657891837999,MATH 142A,B04,093558,Chow; Bennett,13,0,32,19
1657891837999,MATH 142A,B05,093559,Chow; Bennett,7,0,32,25
1657891844027,MATH 193A,A01,083224,Rotar; Vladimir,8,0,34,26
1657891844027,MATH 193A,A02,083225,Rotar; Vladimir,10,0,34,24
1657891844027,MATH 193A,A03,083781,Rotar; Vladimir,5,0,34,29
1657891844027,MATH 193A,A04,083782,Rotar; Vladimir,11,0,34,23
1657891844027,MATH 193A,A05,093482,Rotar; Vladimir,10,0,34,24
1657891850052,MATH 197,001,091859,McAuley; Julian John,9999,0,9999,0
1657891850052,MATH 197,002,095566,Kedlaya; Kiran S.,9997,0,9999,2
1657891850052,MATH 197,003,095567,Xiao; Ming,9999,0,9999,0
1657891850052,MATH 197,004,095571,Perols; Johan Lars,9998,0,9999,1
1657891857115,COGS 9,A01,083615,Shannon; Kyle Michael,10,0,75,65
1657891863140,COGS 11,A01,083617,Boyle; Mary E. T.,23,0,48,25
1657891869169,COGS 13,A01,083071,Bastos; Amalia Pinkusfeld,11,0,71,60
1657891875192,COGS 14A,A01,092681,Semenuks; Arturs,5,1,100,95
1657891881221,COGS 14B,A01,083073,Cheng; Tzu-Han,6,0,63,57
1657891887248,COGS 17,A01,092677,Semenuks; Arturs,6,0,81,75
1657891893276,COGS 100,A01,083619,Allen; Michael Gordon,17,0,70,53
1657891899300,COGS 101A,A01,083621,Davis; Joshua Daniel,9,0,68,59
1657891905323,COGS 101B,A01,091572,Allen; Michael Gordon,13,0,65,52
1657891911347,COGS 101C,A01,083625,Delgado; Tania,17,0,35,18
1657891917371,COGS 107A,A01,083627,Boyle; Mary E. T.,14,0,60,46
1657891923405,COGS 118A,A01,083075,Gupta; Anjum,21,0,76,55
1657891929436,CSE 3,A50,083646,Miranda; Gregory Joseph,24,0,50,26
1657891935460,CSE 8A,A50,083650,Miranda; Gregory Joseph,17,1,56,39
1657891941488,CSE 11,A01,083080,Cao; Yingjun,6,15,40,34
1657891947515,CSE 12,A01,083652,Krause-Levy; Sophia Louisa,30,1,120,90
1657891953543,CSE 15L,A01,083654,Morris; Justin Loren,9,0,50,41
1657891953543,CSE 15L,A02,083655,Morris; Justin Loren,10,0,50,40
1657891959567,CSE 20,A01,083657,Tran; Khoa Dang,39,0,80,41
1657891965595,CSE 21,A01,095574,Bach; Quang Tran,22,0,48,26
1657891971624,CSE 30,A01,083084,Eldon; John,6,0,80,74
1657891971624,CSE 30,B01,095061,Bhaskar; Nishant,9,0,50,41
1657891977652,CSE 100,A01,083659,Cao; Yingjun,5,4,70,65
1657891983677,CSE 134B,A01,083661,Powell; Thomas Allan,24,0,100,76
1657891989706,CSE 140,A01,083663,Gungor; Onat,15,0,85,70
1657891995733,CSE 140L,A01,083088,Eldon; John,23,0,100,77
1657892001757,CSE 175,A01,083665,Kumar; Rakesh,3,0,25,22
1657892007783,CSE 190,A00,092507,Dubnov; Shlomo,8,0,20,12
1657892013806,ECE 45,A01,083139,Congero; Spencer William,6,0,75,69
1657892019829,ECE 65,A50,083695,Saad; Andrew S,12,0,30,18
1657892019829,ECE 65,A51,095125,Saad; Andrew S,24,0,26,2
1657892025853,ECE 109,A01,091882,Touri; Behrouz,20,0,70,50
1657892031877,ECE 180,A00,083140,Abi Samra; Nicholas Camill,1,0,30,29
1657892031877,ECE 180,B00,083141,Abi Samra; Nicholas Camill,0,0,30,30
1657892037907,MATH 10A,A01,083735,Patchell; Gregory David,2,0,30,28
1657892037907,MATH 10A,A02,083736,Patchell; Gregory David,20,0,30,10
1657892037907,MATH 10A,A03,083737,Patchell; Gregory David,16,0,30,14
1657892043935,MATH 10B,A01,083207,Lim; Seonhee,8,0,34,26
1657892043935,MATH 10B,A02,083208,Lim; Seonhee,10,0,35,25
1657892043935,MATH 10B,A03,093472,Lim; Seonhee,7,0,34,27
1657892043935,MATH 10B,B01,083739,Sinha; Shubham,14,0,30,16
1657892049979,MATH 18,A01,083743,Cinel; Cameron Alexander,9,0,30,21
1657892049979,MATH 18,A02,083744,Cinel; Cameron Alexander,18,0,30,12
1657892049979,MATH 18,A03,083745,Cinel; Cameron Alexander,10,0,30,20
1657892049979,MATH 18,B01,083748,Rideout; David Porter,5,0,37,32
1657892049979,MATH 18,B02,083749,Rideout; David Porter,5,0,36,31
1657892049979,MATH 18,B03,083750,Rideout; David Porter,3,0,37,34
1657892049979,MATH 18,B04,083751,Rideout; David Porter,6,0,36,30
1657892049979,MATH 18,B05,093473,Rideout; David Porter,6,0,36,30
1657892049979,MATH 18,B06,093474,Rideout; David Porter,6,0,36,30
1657892056004,MATH 20A,A01,083754,Zheng; Zequn,14,0,40,26
1657892062029,MATH 20B,A01,083756,Briones; Jor-el Thomas Caparas,4,0,36,32
1657892062029,MATH 20B,A02,083757,Briones; Jor-el Thomas Caparas,1,0,36,35
1657892062029,MATH 20B,A03,093475,Briones; Jor-el Thomas Caparas,2,0,36,34
1657892068053,MATH 20C,A01,083760,Briones; Jor-el Thomas Caparas,1,0,35,34
1657892068053,MATH 20C,A02,083761,Briones; Jor-el Thomas Caparas,8,0,35,27
1657892068053,MATH 20C,A03,093476,Briones; Jor-el Thomas Caparas,0,1,36,36
1657892068053,MATH 20C,B01,083762,Bach; Quang Tran,1,0,30,29
1657892074084,MATH 20D,A01,083765,Tran; Brian Kha,5,0,30,25
1657892074084,MATH 20D,A02,083766,Tran; Brian Kha,5,0,30,25
1657892074084,MATH 20D,A03,083767,Tran; Brian Kha,5,0,30,25
1657892080108,MATH 20E,A01,083771,Ganguly; Soumya,10,0,32,22
1657892080108,MATH 20E,A02,083772,Ganguly; Soumya,6,0,32,26
1657892080108,MATH 20E,B01,083773,Ciotti; Benjamin,20,0,35,15
1657892080108,MATH 20E,B02,083774,Ciotti; Benjamin,18,0,35,17
1657892086138,MATH 103A,A01,083777,Greenfeld; Be'Eri,3,0,36,33
1657892086138,MATH 103A,A02,083778,Greenfeld; Be'Eri,5,0,36,31
1657892086138,MATH 103A,A03,093561,Greenfeld; Be'Eri,6,0,36,30
1657892086138,MATH 103A,B01,083779,Greenfeld; Be'Eri,7,0,36,29
1657892086138,MATH 103A,B02,083780,Greenfeld; Be'Eri,4,0,36,32
1657892086138,MATH 103A,B03,093562,Greenfeld; Be'Eri,3,0,36,33
1657892092161,MATH 105,A01,085443,Carter; Anne Toulson,15,0,35,20
1657892092161,MATH 105,A02,093477,Carter; Anne Toulson,20,0,35,15
1657892098185,MATH 109,A01,083213,Ganzberger; Geoffrey Michael,3,0,34,31
1657892098185,MATH 109,A02,083214,Ganzberger; Geoffrey Michael,4,0,34,30
1657892098185,MATH 109,A03,093478,Ganzberger; Geoffrey Michael,2,0,34,32
1657892098185,MATH 109,B01,083215,Ganzberger; Geoffrey Michael,1,0,32,31
1657892098185,MATH 109,B02,083216,Ganzberger; Geoffrey Michael,2,0,32,30
1657892098185,MATH 109,B03,093479,Ganzberger; Geoffrey Michael,8,0,32,24
1657892104210,MATH 142A,A01,083219,Chow; Bennett,7,0,32,25
1657892104210,MATH 142A,A02,083220,Chow; Bennett,10,0,32,22
1657892104210,MATH 142A,A03,093480,Chow; Bennett,9,0,32,23
1657892104210,MATH 142A,B03,093481,Chow; Bennett,8,0,32,24
1657892104210,MATH 142A,B04,093558,Chow; Bennett,13,0,32,19
1657892104210,MATH 142A,B05,093559,Chow; Bennett,7,0,32,25
1657892110232,MATH 193A,A01,083224,Rotar; Vladimir,8,0,34,26
1657892110232,MATH 193A,A02,083225,Rotar; Vladimir,10,0,34,24
1657892110232,MATH 193A,A03,083781,Rotar; Vladimir,5,0,34,29
1657892110232,MATH 193A,A04,083782,Rotar; Vladimir,11,0,34,23
1657892110232,MATH 193A,A05,093482,Rotar; Vladimir,10,0,34,24
1657892116259,MATH 197,001,091859,McAuley; Julian John,9999,0,9999,0
1657892116259,MATH 197,002,095566,Kedlaya; Kiran S.,9997,0,9999,2
1657892116259,MATH 197,003,095567,Xiao; Ming,9999,0,9999,0
1657892116259,MATH 197,004,095571,Perols; Johan Lars,9998,0,9999,1
1657892123322,COGS 9,A01,083615,Shannon; Kyle Michael,10,0,75,65
1657892129345,COGS 11,A01,083617,Boyle; Mary E. T.,23,0,48,25
1657892135369,COGS 13,A01,083071,Bastos; Amalia Pinkusfeld,11,0,71,60
1657892141395,COGS 14A,A01,092681,Semenuks; Arturs,5,1,100,95
1657892147491,COGS 14B,A01,083073,Cheng; Tzu-Han,6,0,63,57
1657892153526,COGS 17,A01,092677,Semenuks; Arturs,6,0,81,75
1657892159551,COGS 100,A01,083619,Allen; Michael Gordon,17,0,70,53
1657892165578,COGS 101A,A01,083621,Davis; Joshua Daniel,9,0,68,59
1657892171605,COGS 101B,A01,091572,Allen; Michael Gordon,13,0,65,52
1657892177629,COGS 101C,A01,083625,Delgado; Tania,17,0,35,18
1657892183656,COGS 107A,A01,083627,Boyle; Mary E. T.,14,0,60,46
1657892189684,COGS 118A,A01,083075,Gupta; Anjum,21,0,76,55
1657892195708,CSE 3,A50,083646,Miranda; Gregory Joseph,24,0,50,26
1657892201735,CSE 8A,A50,083650,Miranda; Gregory Joseph,17,1,56,39
1657892207759,CSE 11,A01,083080,Cao; Yingjun,6,15,40,34
1657892213783,CSE 12,A01,083652,Krause-Levy; Sophia Louisa,30,1,120,90
1657892219806,CSE 15L,A01,083654,Morris; Justin Loren,9,0,50,41
1657892219806,CSE 15L,A02,083655,Morris; Justin Loren,10,0,50,40
1657892225830,CSE 20,A01,083657,Tran; Khoa Dang,39,0,80,41
1657892231853,CSE 21,A01,095574,Bach; Quang Tran,22,0,48,26
1657892237881,CSE 30,A01,083084,Eldon; John,6,0,80,74
1657892237881,CSE 30,B01,095061,Bhaskar; Nishant,9,0,50,41
1657892243909,CSE 100,A01,083659,Cao; Yingjun,5,4,70,65
1657892249932,CSE 134B,A01,083661,Powell; Thomas Allan,24,0,100,76
1657892255956,CSE 140,A01,083663,Gungor; Onat,15,0,85,70
1657892261979,CSE 140L,A01,083088,Eldon; John,23,0,100,77
1657892268007,CSE 175,A01,083665,Kumar; Rakesh,3,0,25,22
1657892274031,CSE 190,A00,092507,Dubnov; Shlomo,8,0,20,12
1657892280059,ECE 45,A01,083139,Congero; Spencer William,6,0,75,69
1657892286082,ECE 65,A50,083695,Saad; Andrew S,12,0,30,18
1657892286082,ECE 65,A51,095125,Saad; Andrew S,24,0,26,2
1657892292105,ECE 109,A01,091882,Touri; Behrouz,20,0,70,50
1657892298134,ECE 180,A00,083140,Abi Samra; Nicholas Camill,1,0,30,29
1657892298134,ECE 180,B00,083141,Abi Samra; Nicholas Camill,0,0,30,30
1657892304158,MATH 10A,A01,083735,Patchell; Gregory David,2,0,30,28
1657892304158,MATH 10A,A02,083736,Patchell; Gregory David,20,0,30,10
1657892304158,MATH 10A,A03,083737,Patchell; Gregory David,16,0,30,14
1657892310181,MATH 10B,A01,083207,Lim; Seonhee,8,0,34,26
1657892310181,MATH 10B,A02,083208,Lim; Seonhee,10,0,35,25
1657892310181,MATH 10B,A03,093472,Lim; Seonhee,7,0,34,27
1657892310181,MATH 10B,B01,083739,Sinha; Shubham,14,0,30,16
1657892316211,MATH 18,A01,083743,Cinel; Cameron Alexander,9,0,30,21
1657892316211,MATH 18,A02,083744,Cinel; Cameron Alexander,18,0,30,12
1657892316211,MATH 18,A03,083745,Cinel; Cameron Alexander,10,0,30,20
1657892316211,MATH 18,B01,083748,Rideout; David Porter,5,0,37,32
1657892316211,MATH 18,B02,083749,Rideout; David Porter,5,0,36,31
1657892316211,MATH 18,B03,083750,Rideout; David Porter,3,0,37,34
1657892316211,MATH 18,B04,083751,Rideout; David Porter,6,0,36,30
1657892316211,MATH 18,B05,093473,Rideout; David Porter,6,0,36,30
1657892316211,MATH 18,B06,093474,Rideout; David Porter,6,0,36,30
1657892322240,MATH 20A,A01,083754,Zheng; Zequn,14,0,40,26
1657892328263,MATH 20B,A01,083756,Briones; Jor-el Thomas Caparas,4,0,36,32
1657892328263,MATH 20B,A02,083757,Briones; Jor-el Thomas Caparas,1,0,36,35
1657892328263,MATH 20B,A03,093475,Briones; Jor-el Thomas Caparas,2,0,36,34
1657892334287,MATH 20C,A01,083760,Briones; Jor-el Thomas Caparas,1,0,35,34
1657892334287,MATH 20C,A02,083761,Briones; Jor-el Thomas Caparas,8,0,35,27
1657892334287,MATH 20C,A03,093476,Briones; Jor-el Thomas Caparas,0,1,36,36
1657892334287,MATH 20C,B01,083762,Bach; Quang Tran,1,0,30,29
1657892340318,MATH 20D,A01,083765,Tran; Brian Kha,5,0,30,25
1657892340318,MATH 20D,A02,083766,Tran; Brian Kha,5,0,30,25
1657892340318,MATH 20D,A03,083767,Tran; Brian Kha,5,0,30,25
1657892346344,MATH 20E,A01,083771,Ganguly; Soumya,10,0,32,22
1657892346344,MATH 20E,A02,083772,Ganguly; Soumya,6,0,32,26
1657892346344,MATH 20E,B01,083773,Ciotti; Benjamin,20,0,35,15
1657892346344,MATH 20E,B02,083774,Ciotti; Benjamin,18,0,35,17
1657892352368,MATH 103A,A01,083777,Greenfeld; Be'Eri,3,0,36,33
1657892352368,MATH 103A,A02,083778,Greenfeld; Be'Eri,5,0,36,31
1657892352368,MATH 103A,A03,093561,Greenfeld; Be'Eri,6,0,36,30
1657892352368,MATH 103A,B01,083779,Greenfeld; Be'Eri,7,0,36,29
1657892352368,MATH 103A,B02,083780,Greenfeld; Be'Eri,4,0,36,32
1657892352368,MATH 103A,B03,093562,Greenfeld; Be'Eri,3,0,36,33
1657892358391,MATH 105,A01,085443,Carter; Anne Toulson,15,0,35,20
1657892358391,MATH 105,A02,093477,Carter; Anne Toulson,20,0,35,15
1657892364418,MATH 109,A01,083213,Ganzberger; Geoffrey Michael,3,0,34,31
1657892364418,MATH 109,A02,083214,Ganzberger; Geoffrey Michael,4,0,34,30
1657892364418,MATH 109,A03,093478,Ganzberger; Geoffrey Michael,2,0,34,32
1657892364418,MATH 109,B01,083215,Ganzberger; Geoffrey Michael,1,0,32,31
1657892364418,MATH 109,B02,083216,Ganzberger; Geoffrey Michael,2,0,32,30
1657892364418,MATH 109,B03,093479,Ganzberger; Geoffrey Michael,8,0,32,24
1657892370449,MATH 142A,A01,083219,Chow; Bennett,7,0,32,25
1657892370449,MATH 142A,A02,083220,Chow; Bennett,10,0,32,22
1657892370449,MATH 142A,A03,093480,Chow; Bennett,9,0,32,23
1657892370449,MATH 142A,B03,093481,Chow; Bennett,8,0,32,24
1657892370449,MATH 142A,B04,093558,Chow; Bennett,13,0,32,19
1657892370449,MATH 142A,B05,093559,Chow; Bennett,7,0,32,25
1657892376473,MATH 193A,A01,083224,Rotar; Vladimir,8,0,34,26
1657892376473,MATH 193A,A02,083225,Rotar; Vladimir,10,0,34,24
1657892376473,MATH 193A,A03,083781,Rotar; Vladimir,5,0,34,29
1657892376473,MATH 193A,A04,083782,Rotar; Vladimir,11,0,34,23
1657892376473,MATH 193A,A05,093482,Rotar; Vladimir,10,0,34,24
1657892382496,MATH 197,001,091859,McAuley; Julian John,9999,0,9999,0
1657892382496,MATH 197,002,095566,Kedlaya; Kiran S.,9997,0,9999,2
1657892382496,MATH 197,003,095567,Xiao; Ming,9999,0,9999,0
1657892382496,MATH 197,004,095571,Perols; Johan Lars,9998,0,9999,1
1657892389554,COGS 9,A01,083615,Shannon; Kyle Michael,10,0,75,65
1657892395578,COGS 11,A01,083617,Boyle; Mary E. T.,23,0,48,25
1657892401610,COGS 13,A01,083071,Bastos; Amalia Pinkusfeld,11,0,71,60
1657892407631,COGS 14A,A01,092681,Semenuks; Arturs,5,1,100,95
1657892413664,COGS 14B,A01,083073,Cheng; Tzu-Han,6,0,63,57
1657892419690,COGS 17,A01,092677,Semenuks; Arturs,6,0,81,75
1657892425714,COGS 100,A01,083619,Allen; Michael Gordon,17,0,70,53
1657892431737,COGS 101A,A01,083621,Davis; Joshua Daniel,9,0,68,59
1657892437758,COGS 101B,A01,091572,Allen; Michael Gordon,13,0,65,52
1657892443786,COGS 101C,A01,083625,Delgado; Tania,17,0,35,18
1657892449810,COGS 107A,A01,083627,Boyle; Mary E. T.,14,0,60,46
1657892455837,COGS 118A,A01,083075,Gupta; Anjum,21,0,76,55
1657892461867,CSE 3,A50,083646,Miranda; Gregory Joseph,24,0,50,26
1657892467891,CSE 8A,A50,083650,Miranda; Gregory Joseph,17,1,56,39
1657892473916,CSE 11,A01,083080,Cao; Yingjun,6,15,40,34
1657892479939,CSE 12,A01,083652,Krause-Levy; Sophia Louisa,30,1,120,90
1657892485961,CSE 15L,A01,083654,Morris; Justin Loren,9,0,50,41
1657892485961,CSE 15L,A02,083655,Morris; Justin Loren,10,0,50,40
1657892491985,CSE 20,A01,083657,Tran; Khoa Dang,39,0,80,41
1657892498010,CSE 21,A01,095574,Bach; Quang Tran,22,0,48,26
1657892504032,CSE 30,A01,083084,Eldon; John,6,0,80,74
1657892504032,CSE 30,B01,095061,Bhaskar; Nishant,9,0,50,41
1657892510060,CSE 100,A01,083659,Cao; Yingjun,5,4,70,65
1657892516082,CSE 134B,A01,083661,Powell; Thomas Allan,24,0,100,76
1657892522109,CSE 140,A01,083663,Gungor; Onat,15,0,85,70
1657892528136,CSE 140L,A01,083088,Eldon; John,23,0,100,77
1657892534160,CSE 175,A01,083665,Kumar; Rakesh,3,0,25,22
1657892540183,CSE 190,A00,092507,Dubnov; Shlomo,8,0,20,12
1657892546205,ECE 45,A01,083139,Congero; Spencer William,6,0,75,69
1657892552233,ECE 65,A50,083695,Saad; Andrew S,12,0,30,18
1657892552233,ECE 65,A51,095125,Saad; Andrew S,24,0,26,2
1657892558257,ECE 109,A01,091882,Touri; Behrouz,20,0,70,50
1657892564284,ECE 180,A00,083140,Abi Samra; Nicholas Camill,1,0,30,29
1657892564284,ECE 180,B00,083141,Abi Samra; Nicholas Camill,0,0,30,30
1657892570314,MATH 10A,A01,083735,Patchell; Gregory David,2,0,30,28
1657892570314,MATH 10A,A02,083736,Patchell; Gregory David,20,0,30,10
1657892570314,MATH 10A,A03,083737,Patchell; Gregory David,16,0,30,14
1657892576344,MATH 10B,A01,083207,Lim; Seonhee,8,0,34,26
1657892576344,MATH 10B,A02,083208,Lim; Seonhee,10,0,35,25
1657892576344,MATH 10B,A03,093472,Lim; Seonhee,7,0,34,27
1657892576344,MATH 10B,B01,083739,Sinha; Shubham,14,0,30,16
1657892582368,MATH 18,A01,083743,Cinel; Cameron Alexander,9,0,30,21
1657892582368,MATH 18,A02,083744,Cinel; Cameron Alexander,18,0,30,12
1657892582368,MATH 18,A03,083745,Cinel; Cameron Alexander,10,0,30,20
1657892582368,MATH 18,B01,083748,Rideout; David Porter,5,0,37,32
1657892582368,MATH 18,B02,083749,Rideout; David Porter,5,0,36,31
1657892582368,MATH 18,B03,083750,Rideout; David Porter,3,0,37,34
1657892582368,MATH 18,B04,083751,Rideout; David Porter,6,0,36,30
1657892582368,MATH 18,B05,093473,Rideout; David Porter,6,0,36,30
1657892582368,MATH 18,B06,093474,Rideout; David Porter,6,0,36,30
1657892588391,MATH 20A,A01,083754,Zheng; Zequn,14,0,40,26
1657892594414,MATH 20B,A01,083756,Briones; Jor-el Thomas Caparas,4,0,36,32
1657892594414,MATH 20B,A02,083757,Briones; Jor-el Thomas Caparas,1,0,36,35
1657892594414,MATH 20B,A03,093475,Briones; Jor-el Thomas Caparas,2,0,36,34
1657892600442,MATH 20C,A01,083760,Briones; Jor-el Thomas Caparas,1,0,35,34
1657892600442,MATH 20C,A02,083761,Briones; Jor-el Thomas Caparas,8,0,35,27
1657892600442,MATH 20C,A03,093476,Briones; Jor-el Thomas Caparas,0,1,36,36
1657892600442,MATH 20C,B01,083762,Bach; Quang Tran,1,0,30,29
1657892606470,MATH 20D,A01,083765,Tran; Brian Kha,5,0,30,25
1657892606470,MATH 20D,A02,083766,Tran; Brian Kha,5,0,30,25
1657892606470,MATH 20D,A03,083767,Tran; Brian Kha,5,0,30,25
1657892612493,MATH 20E,A01,083771,Ganguly; Soumya,10,0,32,22
1657892612493,MATH 20E,A02,083772,Ganguly; Soumya,6,0,32,26
1657892612493,MATH 20E,B01,083773,Ciotti; Benjamin,20,0,35,15
1657892612493,MATH 20E,B02,083774,Ciotti; Benjamin,18,0,35,17
1657892618523,MATH 103A,A01,083777,Greenfeld; Be'Eri,3,0,36,33
1657892618523,MATH 103A,A02,083778,Greenfeld; Be'Eri,5,0,36,31
1657892618523,MATH 103A,A03,093561,Greenfeld; Be'Eri,6,0,36,30
1657892618523,MATH 103A,B01,083779,Greenfeld; Be'Eri,7,0,36,29
1657892618523,MATH 103A,B02,083780,Greenfeld; Be'Eri,4,0,36,32
1657892618523,MATH 103A,B03,093562,Greenfeld; Be'Eri,3,0,36,33
1657892624548,MATH 105,A01,085443,Carter; Anne Toulson,15,0,35,20
1657892624548,MATH 105,A02,093477,Carter; Anne Toulson,20,0,35,15
1657892630576,MATH 109,A01,083213,Ganzberger; Geoffrey Michael,3,0,34,31
1657892630576,MATH 109,A02,083214,Ganzberger; Geoffrey Michael,4,0,34,30
1657892630576,MATH 109,A03,093478,Ganzberger; Geoffrey Michael,2,0,34,32
1657892630576,MATH 109,B01,083215,Ganzberger; Geoffrey Michael,1,0,32,31
1657892630576,MATH 109,B02,083216,Ganzberger; Geoffrey Michael,2,0,32,30
1657892630576,MATH 109,B03,093479,Ganzberger; Geoffrey Michael,8,0,32,24
1657892636607,MATH 142A,A01,083219,Chow; Bennett,7,0,32,25
1657892636607,MATH 142A,A02,083220,Chow; Bennett,10,0,32,22
1657892636607,MATH 142A,A03,093480,Chow; Bennett,9,0,32,23
1657892636607,MATH 142A,B03,093481,Chow; Bennett,8,0,32,24
1657892636607,MATH 142A,B04,093558,Chow; Bennett,13,0,32,19
1657892636607,MATH 142A,B05,093559,Chow; Bennett,7,0,32,25
1657892642636,MATH 193A,A01,083224,Rotar; Vladimir,8,0,34,26
1657892642636,MATH 193A,A02,083225,Rotar; Vladimir,10,0,34,24
1657892642636,MATH 193A,A03,083781,Rotar; Vladimir,5,0,34,29
1657892642636,MATH 193A,A04,083782,Rotar; Vladimir,11,0,34,23
1657892642636,MATH 193A,A05,093482,Rotar; Vladimir,10,0,34,24
1657892648662,MATH 197,001,091859,McAuley; Julian John,9999,0,9999,0
1657892648662,MATH 197,002,095566,Kedlaya; Kiran S.,9997,0,9999,2
1657892648662,MATH 197,003,095567,Xiao; Ming,9999,0,9999,0
1657892648662,MATH 197,004,095571,Perols; Johan Lars,9998,0,9999,1
1657892655713,COGS 9,A01,083615,Shannon; Kyle Michael,10,0,75,65
1657892661738,COGS 11,A01,083617,Boyle; Mary E. T.,23,0,48,25
1657892667766,COGS 13,A01,083071,Bastos; Amalia Pinkusfeld,11,0,71,60
1657892673791,COGS 14A,A01,092681,Semenuks; Arturs,5,1,100,95
1657892679815,COGS 14B,A01,083073,Cheng; Tzu-Han,6,0,63,57
1657892685849,COGS 17,A01,092677,Semenuks; Arturs,6,0,81,75
1657892691877,COGS 100,A01,083619,Allen; Michael Gordon,17,0,70,53
1657892697900,COGS 101A,A01,083621,Davis; Joshua Daniel,9,0,68,59
1657892703928,COGS 101B,A01,091572,Allen; Michael Gordon,13,0,65,52
1657892709956,COGS 101C,A01,083625,Delgado; Tania,17,0,35,18
1657892715980,COGS 107A,A01,083627,Boyle; Mary E. T.,14,0,60,46
1657892722004,COGS 118A,A01,083075,Gupta; Anjum,21,0,76,55
1657892728031,CSE 3,A50,083646,Miranda; Gregory Joseph,24,0,50,26
1657892734054,CSE 8A,A50,083650,Miranda; Gregory Joseph,17,1,56,39
1657892740078,CSE 11,A01,083080,Cao; Yingjun,6,15,40,34
1657892746188,CSE 12,A01,083652,Krause-Levy; Sophia Louisa,30,1,120,90
1657892752217,CSE 15L,A01,083654,Morris; Justin Loren,9,0,50,41
1657892752217,CSE 15L,A02,083655,Morris; Justin Loren,10,0,50,40
1657892758241,CSE 20,A01,083657,Tran; Khoa Dang,39,0,80,41
1657892764265,CSE 21,A01,095574,Bach; Quang Tran,22,0,48,26
1657892770294,CSE 30,A01,083084,Eldon; John,6,0,80,74
1657892770294,CSE 30,B01,095061,Bhaskar; Nishant,9,0,50,41
1657892776320,CSE 100,A01,083659,Cao; Yingjun,5,4,70,65
1657892782343,CSE 134B,A01,083661,Powell; Thomas Allan,24,0,100,76
1657892788370,CSE 140,A01,083663,Gungor; Onat,15,0,85,70
1657892794393,CSE 140L,A01,083088,Eldon; John,23,0,100,77
1657892800417,CSE 175,A01,083665,Kumar; Rakesh,3,0,25,22
1657892806445,CSE 190,A00,092507,Dubnov; Shlomo,8,0,20,12
1657892812468,ECE 45,A01,083139,Congero; Spencer William,6,0,75,69
1657892818497,ECE 65,A50,083695,Saad; Andrew S,12,0,30,18
1657892818497,ECE 65,A51,095125,Saad; Andrew S,24,0,26,2
1657892824520,ECE 109,A01,091882,Touri; Behrouz,20,0,70,50
1657892830544,ECE 180,A00,083140,Abi Samra; Nicholas Camill,1,0,30,29
1657892830544,ECE 180,B00,083141,Abi Samra; Nicholas Camill,0,0,30,30
1657892836580,MATH 10A,A01,083735,Patchell; Gregory David,2,0,30,28
1657892836580,MATH 10A,A02,083736,Patchell; Gregory David,20,0,30,10
1657892836580,MATH 10A,A03,083737,Patchell; Gregory David,16,0,30,14
1657892842605,MATH 10B,A01,083207,Lim; Seonhee,8,0,34,26
1657892842605,MATH 10B,A02,083208,Lim; Seonhee,10,0,35,25
1657892842605,MATH 10B,A03,093472,Lim; Seonhee,7,0,34,27
1657892842605,MATH 10B,B01,083739,Sinha; Shubham,14,0,30,16
1657892848630,MATH 18,A01,083743,Cinel; Cameron Alexander,9,0,30,21
1657892848630,MATH 18,A02,083744,Cinel; Cameron Alexander,18,0,30,12
1657892848630,MATH 18,A03,083745,Cinel; Cameron Alexander,10,0,30,20
1657892848630,MATH 18,B01,083748,Rideout; David Porter,5,0,37,32
1657892848630,MATH 18,B02,083749,Rideout; David Porter,5,0,36,31
1657892848630,MATH 18,B03,083750,Rideout; David Porter,3,0,37,34
1657892848630,MATH 18,B04,083751,Rideout; David Porter,6,0,36,30
1657892848630,MATH 18,B05,093473,Rideout; David Porter,6,0,36,30
1657892848630,MATH 18,B06,093474,Rideout; David Porter,6,0,36,30
1657892854652,MATH 20A,A01,083754,Zheng; Zequn,14,0,40,26
1657892860675,MATH 20B,A01,083756,Briones; Jor-el Thomas Caparas,4,0,36,32
1657892860675,MATH 20B,A02,083757,Briones; Jor-el Thomas Caparas,1,0,36,35
1657892860675,MATH 20B,A03,093475,Briones; Jor-el Thomas Caparas,2,0,36,34
1657892866700,MATH 20C,A01,083760,Briones; Jor-el Thomas Caparas,1,0,35,34
1657892866700,MATH 20C,A02,083761,Briones; Jor-el Thomas Caparas,8,0,35,27
1657892866700,MATH 20C,A03,093476,Briones; Jor-el Thomas Caparas,0,1,36,36
1657892866700,MATH 20C,B01,083762,Bach; Quang Tran,1,0,30,29
1657892872726,MATH 20D,A01,083765,Tran; Brian Kha,5,0,30,25
1657892872726,MATH 20D,A02,083766,Tran; Brian Kha,5,0,30,25
1657892872726,MATH 20D,A03,083767,Tran; Brian Kha,5,0,30,25
1657892878750,MATH 20E,A01,083771,Ganguly; Soumya,10,0,32,22
1657892878750,MATH 20E,A02,083772,Ganguly; Soumya,6,0,32,26
1657892878750,MATH 20E,B01,083773,Ciotti; Benjamin,20,0,35,15
1657892878750,MATH 20E,B02,083774,Ciotti; Benjamin,18,0,35,17
1657892884789,MATH 103A,A01,083777,Greenfeld; Be'Eri,3,0,36,33
1657892884789,MATH 103A,A02,083778,Greenfeld; Be'Eri,5,0,36,31
1657892884789,MATH 103A,A03,093561,Greenfeld; Be'Eri,6,0,36,30
1657892884789,MATH 103A,B01,083779,Greenfeld; Be'Eri,7,0,36,29
1657892884789,MATH 103A,B02,083780,Greenfeld; Be'Eri,4,0,36,32
1657892884789,MATH 103A,B03,093562,Greenfeld; Be'Eri,3,0,36,33
1657892890811,MATH 105,A01,085443,Carter; Anne Toulson,15,0,35,20
1657892890811,MATH 105,A02,093477,Carter; Anne Toulson,20,0,35,15
1657892896834,MATH 109,A01,083213,Ganzberger; Geoffrey Michael,3,0,34,31
1657892896834,MATH 109,A02,083214,Ganzberger; Geoffrey Michael,4,0,34,30
1657892896834,MATH 109,A03,093478,Ganzberger; Geoffrey Michael,2,0,34,32
1657892896834,MATH 109,B01,083215,Ganzberger; Geoffrey Michael,1,0,32,31
1657892896834,MATH 109,B02,083216,Ganzberger; Geoffrey Michael,2,0,32,30
1657892896834,MATH 109,B03,093479,Ganzberger; Geoffrey Michael,8,0,32,24
1657892902858,MATH 142A,A01,083219,Chow; Bennett,7,0,32,25
1657892902858,MATH 142A,A02,083220,Chow; Bennett,10,0,32,22
1657892902858,MATH 142A,A03,093480,Chow; Bennett,9,0,32,23
1657892902858,MATH 142A,B03,093481,Chow; Bennett,8,0,32,24
1657892902858,MATH 142A,B04,093558,Chow; Bennett,13,0,32,19
1657892902858,MATH 142A,B05,093559,Chow; Bennett,7,0,32,25
1657892908886,MATH 193A,A01,083224,Rotar; Vladimir,8,0,34,26
1657892908886,MATH 193A,A02,083225,Rotar; Vladimir,10,0,34,24
1657892908886,MATH 193A,A03,083781,Rotar; Vladimir,5,0,34,29
1657892908886,MATH 193A,A04,083782,Rotar; Vladimir,11,0,34,23
1657892908886,MATH 193A,A05,093482,Rotar; Vladimir,10,0,34,24
1657892914913,MATH 197,001,091859,McAuley; Julian John,9999,0,9999,0
1657892914913,MATH 197,002,095566,Kedlaya; Kiran S.,9997,0,9999,2
1657892914913,MATH 197,003,095567,Xiao; Ming,9999,0,9999,0
1657892914913,MATH 197,004,095571,Perols; Johan Lars,9998,0,9999,1
1657892921976,COGS 9,A01,083615,Shannon; Kyle Michael,10,0,75,65
1657892928014,COGS 11,A01,083617,Boyle; Mary E. T.,23,0,48,25
1657892934049,COGS 13,A01,083071,Bastos; Amalia Pinkusfeld,11,0,71,60
1657892940075,COGS 14A,A01,092681,Semenuks; Arturs,5,1,100,95
1657892946109,COGS 14B,A01,083073,Cheng; Tzu-Han,6,0,63,57
1657892952133,COGS 17,A01,092677,Semenuks; Arturs,6,0,81,75
1657892958156,COGS 100,A01,083619,Allen; Michael Gordon,17,0,70,53
1657892964187,COGS 101A,A01,083621,Davis; Joshua Daniel,9,0,68,59
1657892970213,COGS 101B,A01,091572,Allen; Michael Gordon,13,0,65,52
1657892976236,COGS 101C,A01,083625,Delgado; Tania,17,0,35,18
1657892982260,COGS 107A,A01,083627,Boyle; Mary E. T.,14,0,60,46
1657892988284,COGS 118A,A01,083075,Gupta; Anjum,21,0,76,55
1657892994310,CSE 3,A50,083646,Miranda; Gregory Joseph,24,0,50,26
1657893000340,CSE 8A,A50,083650,Miranda; Gregory Joseph,17,1,56,39
1657893006367,CSE 11,A01,083080,Cao; Yingjun,6,15,40,34
1657893012392,CSE 12,A01,083652,Krause-Levy; Sophia Louisa,30,1,120,90
1657893018419,CSE 15L,A01,083654,Morris; Justin Loren,9,0,50,41
1657893018419,CSE 15L,A02,083655,Morris; Justin Loren,10,0,50,40
1657893024443,CSE 20,A01,083657,Tran; Khoa Dang,39,0,80,41
1657893030469,CSE 21,A01,095574,Bach; Quang Tran,22,0,48,26
1657893036498,CSE 30,A01,083084,Eldon; John,6,0,80,74
1657893036498,CSE 30,B01,095061,Bhaskar; Nishant,9,0,50,41
1657893042521,CSE 100,A01,083659,Cao; Yingjun,5,4,70,65
1657893048548,CSE 134B,A01,083661,Powell; Thomas Allan,24,0,100,76
1657893054571,CSE 140,A01,083663,Gungor; Onat,15,0,85,70
1657893060606,CSE 140L,A01,083088,Eldon; John,23,0,100,77
1657893066630,CSE 175,A01,083665,Kumar; Rakesh,3,0,25,22
1657893072653,CSE 190,A00,092507,Dubnov; Shlomo,8,0,20,12
1657893078682,ECE 45,A01,083139,Congero; Spencer William,6,0,75,69
1657893084709,ECE 65,A50,083695,Saad; Andrew S,12,0,30,18
1657893084709,ECE 65,A51,095125,Saad; Andrew S,24,0,26,2
1657893090733,ECE 109,A01,091882,Touri; Behrouz,20,0,70,50
1657893096758,ECE 180,A00,083140,Abi Samra; Nicholas Camill,1,0,30,29
1657893096758,ECE 180,B00,083141,Abi Samra; Nicholas Camill,0,0,30,30
1657893102784,MATH 10A,A01,083735,Patchell; Gregory David,2,0,30,28
1657893102784,MATH 10A,A02,083736,Patchell; Gregory David,20,0,30,10
1657893102784,MATH 10A,A03,083737,Patchell; Gregory David,16,0,30,14
1657893108820,MATH 10B,A01,083207,Lim; Seonhee,8,0,34,26
1657893108820,MATH 10B,A02,083208,Lim; Seonhee,10,0,35,25
1657893108820,MATH 10B,A03,093472,Lim; Seonhee,7,0,34,27
1657893108820,MATH 10B,B01,083739,Sinha; Shubham,14,0,30,16
1657893114853,MATH 18,A01,083743,Cinel; Cameron Alexander,9,0,30,21
1657893114853,MATH 18,A02,083744,Cinel; Cameron Alexander,18,0,30,12
1657893114853,MATH 18,A03,083745,Cinel; Cameron Alexander,10,0,30,20
1657893114853,MATH 18,B01,083748,Rideout; David Porter,5,0,37,32
1657893114853,MATH 18,B02,083749,Rideout; David Porter,5,0,36,31
1657893114853,MATH 18,B03,083750,Rideout; David Porter,3,0,37,34
1657893114853,MATH 18,B04,083751,Rideout; David Porter,6,0,36,30
1657893114853,MATH 18,B05,093473,Rideout; David Porter,6,0,36,30
1657893114853,MATH 18,B06,093474,Rideout; David Porter,6,0,36,30
1657893120878,MATH 20A,A01,083754,Zheng; Zequn,14,0,40,26
1657893126903,MATH 20B,A01,083756,Briones; Jor-el Thomas Caparas,4,0,36,32
1657893126903,MATH 20B,A02,083757,Briones; Jor-el Thomas Caparas,1,0,36,35
1657893126903,MATH 20B,A03,093475,Briones; Jor-el Thomas Caparas,2,0,36,34
1657893132927,MATH 20C,A01,083760,Briones; Jor-el Thomas Caparas,1,0,35,34
1657893132927,MATH 20C,A02,083761,Briones; Jor-el Thomas Caparas,8,0,35,27
1657893132927,MATH 20C,A03,093476,Briones; Jor-el Thomas Caparas,0,1,36,36
1657893132927,MATH 20C,B01,083762,Bach; Quang Tran,1,0,30,29
1657893138951,MATH 20D,A01,083765,Tran; Brian Kha,5,0,30,25
1657893138951,MATH 20D,A02,083766,Tran; Brian Kha,5,0,30,25
1657893138951,MATH 20D,A03,083767,Tran; Brian Kha,5,0,30,25
1657893144979,MATH 20E,A01,083771,Ganguly; Soumya,10,0,32,22
1657893144979,MATH 20E,A02,083772,Ganguly; Soumya,6,0,32,26
1657893144979,MATH 20E,B01,083773,Ciotti; Benjamin,20,0,35,15
1657893144979,MATH 20E,B02,083774,Ciotti; Benjamin,18,0,35,17
1657893151001,MATH 103A,A01,083777,Greenfeld; Be'Eri,3,0,36,33
1657893151001,MATH 103A,A02,083778,Greenfeld; Be'Eri,5,0,36,31
1657893151001,MATH 103A,A03,093561,Greenfeld; Be'Eri,6,0,36,30
1657893151001,MATH 103A,B01,083779,Greenfeld; Be'Eri,7,0,36,29
1657893151001,MATH 103A,B02,083780,Greenfeld; Be'Eri,4,0,36,32
1657893151001,MATH 103A,B03,093562,Greenfeld; Be'Eri,3,0,36,33
1657893157025,MATH 105,A01,085443,Carter; Anne Toulson,15,0,35,20
1657893157025,MATH 105,A02,093477,Carter; Anne Toulson,20,0,35,15
1657893163049,MATH 109,A01,083213,Ganzberger; Geoffrey Michael,3,0,34,31
1657893163049,MATH 109,A02,083214,Ganzberger; Geoffrey Michael,4,0,34,30
1657893163049,MATH 109,A03,093478,Ganzberger; Geoffrey Michael,2,0,34,32
1657893163049,MATH 109,B01,083215,Ganzberger; Geoffrey Michael,1,0,32,31
1657893163049,MATH 109,B02,083216,Ganzberger; Geoffrey Michael,2,0,32,30
1657893163049,MATH 109,B03,093479,Ganzberger; Geoffrey Michael,8,0,32,24
1657893169072,MATH 142A,A01,083219,Chow; Bennett,7,0,32,25
1657893169072,MATH 142A,A02,083220,Chow; Bennett,10,0,32,22
1657893169072,MATH 142A,A03,093480,Chow; Bennett,9,0,32,23
1657893169072,MATH 142A,B03,093481,Chow; Bennett,8,0,32,24
1657893169072,MATH 142A,B04,093558,Chow; Bennett,13,0,32,19
1657893169072,MATH 142A,B05,093559,Chow; Bennett,7,0,32,25
1657893175096,MATH 193A,A01,083224,Rotar; Vladimir,8,0,34,26
1657893175096,MATH 193A,A02,083225,Rotar; Vladimir,10,0,34,24
1657893175096,MATH 193A,A03,083781,Rotar; Vladimir,5,0,34,29
1657893175096,MATH 193A,A04,083782,Rotar; Vladimir,11,0,34,23
1657893175096,MATH 193A,A05,093482,Rotar; Vladimir,10,0,34,24
1657893181118,MATH 197,001,091859,McAuley; Julian John,9999,0,9999,0
1657893181118,MATH 197,002,095566,Kedlaya; Kiran S.,9997,0,9999,2
1657893181118,MATH 197,003,095567,Xiao; Ming,9999,0,9999,0
1657893181118,MATH 197,004,095571,Perols; Johan Lars,9998,0,9999,1
1657893188177,COGS 9,A01,083615,Shannon; Kyle Michael,10,0,75,65
1657893194201,COGS 11,A01,083617,Boyle; Mary E. T.,23,0,48,25
1657893200225,COGS 13,A01,083071,Bastos; Amalia Pinkusfeld,11,0,71,60
1657893206251,COGS 14A,A01,092681,Semenuks; Arturs,5,1,100,95
1657893212275,COGS 14B,A01,083073,Cheng; Tzu-Han,6,0,63,57
1657893218302,COGS 17,A01,092677,Semenuks; Arturs,6,0,81,75
1657893224327,COGS 100,A01,083619,Allen; Michael Gordon,17,0,70,53
1657893230357,COGS 101A,A01,083621,Davis; Joshua Daniel,9,0,68,59
1657893236386,COGS 101B,A01,091572,Allen; Michael Gordon,13,0,65,52
1657893242410,COGS 101C,A01,083625,Delgado; Tania,17,0,35,18
1657893248435,COGS 107A,A01,083627,Boyle; Mary E. T.,14,0,60,46
1657893254459,COGS 118A,A01,083075,Gupta; Anjum,21,0,76,55
1657893260483,CSE 3,A50,083646,Miranda; Gregory Joseph,24,0,50,26
1657893266507,CSE 8A,A50,083650,Miranda; Gregory Joseph,17,1,56,39
1657893272529,CSE 11,A01,083080,Cao; Yingjun,6,15,40,34
1657893278553,CSE 12,A01,083652,Krause-Levy; Sophia Louisa,30,1,120,90
1657893284579,CSE 15L,A01,083654,Morris; Justin Loren,9,0,50,41
1657893284579,CSE 15L,A02,083655,Morris; Justin Loren,10,0,50,40
1657893290606,CSE 20,A01,083657,Tran; Khoa Dang,39,0,80,41
1657893296631,CSE 21,A01,095574,Bach; Quang Tran,22,0,48,26
1657893302655,CSE 30,A01,083084,Eldon; John,6,0,80,74
1657893302655,CSE 30,B01,095061,Bhaskar; Nishant,9,0,50,41
1657893308677,CSE 100,A01,083659,Cao; Yingjun,5,4,70,65
1657893314700,CSE 134B,A01,083661,Powell; Thomas Allan,24,0,100,76
1657893320723,CSE 140,A01,083663,Gungor; Onat,15,0,85,70
1657893326748,CSE 140L,A01,083088,Eldon; John,23,0,100,77
1657893332772,CSE 175,A01,083665,Kumar; Rakesh,3,0,25,22
1657893338795,CSE 190,A00,092507,Dubnov; Shlomo,8,0,20,12
1657893344911,ECE 45,A01,083139,Congero; Spencer William,6,0,75,69
1657893350935,ECE 65,A50,083695,Saad; Andrew S,12,0,30,18
1657893350935,ECE 65,A51,095125,Saad; Andrew S,24,0,26,2
1657893356961,ECE 109,A01,091882,Touri; Behrouz,20,0,70,50
1657893362983,ECE 180,A00,083140,Abi Samra; Nicholas Camill,1,0,30,29
1657893362983,ECE 180,B00,083141,Abi Samra; Nicholas Camill,0,0,30,30
1657893369010,MATH 10A,A01,083735,Patchell; Gregory David,2,0,30,28
1657893369010,MATH 10A,A02,083736,Patchell; Gregory David,20,0,30,10
1657893369010,MATH 10A,A03,083737,Patchell; Gregory David,16,0,30,14
1657893375043,MATH 10B,A01,083207,Lim; Seonhee,8,0,34,26
1657893375043,MATH 10B,A02,083208,Lim; Seonhee,10,0,35,25
1657893375043,MATH 10B,A03,093472,Lim; Seonhee,7,0,34,27
1657893375043,MATH 10B,B01,083739,Sinha; Shubham,14,0,30,16
1657893381069,MATH 18,A01,083743,Cinel; Cameron Alexander,9,0,30,21
1657893381069,MATH 18,A02,083744,Cinel; Cameron Alexander,18,0,30,12
1657893381069,MATH 18,A03,083745,Cinel; Cameron Alexander,10,0,30,20
1657893381069,MATH 18,B01,083748,Rideout; David Porter,5,0,37,32
1657893381069,MATH 18,B02,083749,Rideout; David Porter,5,0,36,31
1657893381069,MATH 18,B03,083750,Rideout; David Porter,3,0,37,34
1657893381069,MATH 18,B04,083751,Rideout; David Porter,6,0,36,30
1657893381069,MATH 18,B05,093473,Rideout; David Porter,6,0,36,30
1657893381069,MATH 18,B06,093474,Rideout; David Porter,6,0,36,30
1657893387093,MATH 20A,A01,083754,Zheng; Zequn,14,0,40,26
1657893393121,MATH 20B,A01,083756,Briones; Jor-el Thomas Caparas,4,0,36,32
1657893393121,MATH 20B,A02,083757,Briones; Jor-el Thomas Caparas,1,0,36,35
1657893393121,MATH 20B,A03,093475,Briones; Jor-el Thomas Caparas,2,0,36,34
1657893399147,MATH 20C,A01,083760,Briones; Jor-el Thomas Caparas,1,0,35,34
1657893399147,MATH 20C,A02,083761,Briones; Jor-el Thomas Caparas,8,0,35,27
1657893399147,MATH 20C,A03,093476,Briones; Jor-el Thomas Caparas,0,1,36,36
1657893399147,MATH 20C,B01,083762,Bach; Quang Tran,1,0,30,29
1657893405173,MATH 20D,A01,083765,Tran; Brian Kha,5,0,30,25
1657893405173,MATH 20D,A02,083766,Tran; Brian Kha,5,0,30,25
1657893405173,MATH 20D,A03,083767,Tran; Brian Kha,5,0,30,25
1657893411212,MATH 20E,A01,083771,Ganguly; Soumya,10,0,32,22
1657893411212,MATH 20E,A02,083772,Ganguly; Soumya,6,0,32,26
1657893411212,MATH 20E,B01,083773,Ciotti; Benjamin,20,0,35,15
1657893411212,MATH 20E,B02,083774,Ciotti; Benjamin,18,0,35,17
1657893417237,MATH 103A,A01,083777,Greenfeld; Be'Eri,3,0,36,33
1657893417237,MATH 103A,A02,083778,Greenfeld; Be'Eri,5,0,36,31
1657893417237,MATH 103A,A03,093561,Greenfeld; Be'Eri,6,0,36,30
1657893417237,MATH 103A,B01,083779,Greenfeld; Be'Eri,7,0,36,29
1657893417237,MATH 103A,B02,083780,Greenfeld; Be'Eri,4,0,36,32
1657893417237,MATH 103A,B03,093562,Greenfeld; Be'Eri,3,0,36,33
1657893423265,MATH 105,A01,085443,Carter; Anne Toulson,15,0,35,20
1657893423265,MATH 105,A02,093477,Carter; Anne Toulson,20,0,35,15
1657893429296,MATH 109,A01,083213,Ganzberger; Geoffrey Michael,3,0,34,31
1657893429296,MATH 109,A02,083214,Ganzberger; Geoffrey Michael,4,0,34,30
1657893429296,MATH 109,A03,093478,Ganzberger; Geoffrey Michael,2,0,34,32
1657893429296,MATH 109,B01,083215,Ganzberger; Geoffrey Michael,1,0,32,31
1657893429296,MATH 109,B02,083216,Ganzberger; Geoffrey Michael,2,0,32,30
1657893429296,MATH 109,B03,093479,Ganzberger; Geoffrey Michael,8,0,32,24
1657893435331,MATH 142A,A01,083219,Chow; Bennett,7,0,32,25
1657893435331,MATH 142A,A02,083220,Chow; Bennett,10,0,32,22
1657893435331,MATH 142A,A03,093480,Chow; Bennett,9,0,32,23
1657893435331,MATH 142A,B03,093481,Chow; Bennett,8,0,32,24
1657893435331,MATH 142A,B04,093558,Chow; Bennett,13,0,32,19
1657893435331,MATH 142A,B05,093559,Chow; Bennett,7,0,32,25
1657893441357,MATH 193A,A01,083224,Rotar; Vladimir,8,0,34,26
1657893441357,MATH 193A,A02,083225,Rotar; Vladimir,10,0,34,24
1657893441357,MATH 193A,A03,083781,Rotar; Vladimir,5,0,34,29
1657893441357,MATH 193A,A04,083782,Rotar; Vladimir,11,0,34,23
1657893441357,MATH 193A,A05,093482,Rotar; Vladimir,10,0,34,24
1657893447386,MATH 197,001,091859,McAuley; Julian John,9999,0,9999,0
1657893447386,MATH 197,002,095566,Kedlaya; Kiran S.,9997,0,9999,2
1657893447386,MATH 197,003,095567,Xiao; Ming,9999,0,9999,0
1657893447386,MATH 197,004,095571,Perols; Johan Lars,9998,0,9999,1
1657893454449,COGS 9,A01,083615,Shannon; Kyle Michael,10,0,75,65
1657893460475,COGS 11,A01,083617,Boyle; Mary E. T.,23,0,48,25
1657893466509,COGS 13,A01,083071,Bastos; Amalia Pinkusfeld,11,0,71,60
1657893472535,COGS 14A,A01,092681,Semenuks; Arturs,5,1,100,95
1657893478559,COGS 14B,A01,083073,Cheng; Tzu-Han,6,0,63,57
1657893484589,COGS 17,A01,092677,Semenuks; Arturs,6,0,81,75
1657893490619,COGS 100,A01,083619,Allen; Michael Gordon,17,0,70,53
1657893496647,COGS 101A,A01,083621,Davis; Joshua Daniel,9,0,68,59
1657893502674,COGS 101B,A01,091572,Allen; Michael Gordon,13,0,65,52
1657893508699,COGS 101C,A01,083625,Delgado; Tania,17,0,35,18
1657893514723,COGS 107A,A01,083627,Boyle; Mary E. T.,14,0,60,46
1657893520750,COGS 118A,A01,083075,Gupta; Anjum,21,0,76,55
1657893526779,CSE 3,A50,083646,Miranda; Gregory Joseph,24,0,50,26
1657893532802,CSE 8A,A50,083650,Miranda; Gregory Joseph,17,1,56,39
1657893538839,CSE 11,A01,083080,Cao; Yingjun,6,15,40,34
1657893544863,CSE 12,A01,083652,Krause-Levy; Sophia Louisa,30,1,120,90
1657893550887,CSE 15L,A01,083654,Morris; Justin Loren,9,0,50,41
1657893550887,CSE 15L,A02,083655,Morris; Justin Loren,10,0,50,40
1657893556925,CSE 20,A01,083657,Tran; Khoa Dang,39,0,80,41
1657893562949,CSE 21,A01,095574,Bach; Quang Tran,22,0,48,26
1657893568979,CSE 30,A01,083084,Eldon; John,6,0,80,74
1657893568979,CSE 30,B01,095061,Bhaskar; Nishant,9,0,50,41
1657893575002,CSE 100,A01,083659,Cao; Yingjun,5,4,70,65
1657893581031,CSE 134B,A01,083661,Powell; Thomas Allan,24,0,100,76
1657893587053,CSE 140,A01,083663,Gungor; Onat,15,0,85,70
1657893593080,CSE 140L,A01,083088,Eldon; John,23,0,100,77
1657893599116,CSE 175,A01,083665,Kumar; Rakesh,3,0,25,22
1657893605151,CSE 190,A00,092507,Dubnov; Shlomo,8,0,20,12
1657893611178,ECE 45,A01,083139,Congero; Spencer William,6,0,75,69
1657893617205,ECE 65,A50,083695,Saad; Andrew S,12,0,30,18
1657893617205,ECE 65,A51,095125,Saad; Andrew S,24,0,26,2
1657893623229,ECE 109,A01,091882,Touri; Behrouz,20,0,70,50
1657893629256,ECE 180,A00,083140,Abi Samra; Nicholas Camill,1,0,30,29
1657893629256,ECE 180,B00,083141,Abi Samra; Nicholas Camill,0,0,30,30
1657893635283,MATH 10A,A01,083735,Patchell; Gregory David,2,0,30,28
1657893635283,MATH 10A,A02,083736,Patchell; Gregory David,20,0,30,10
1657893635283,MATH 10A,A03,083737,Patchell; Gregory David,16,0,30,14
1657893641316,MATH 10B,A01,083207,Lim; Seonhee,8,0,34,26
1657893641316,MATH 10B,A02,083208,Lim; Seonhee,10,0,35,25
1657893641316,MATH 10B,A03,093472,Lim; Seonhee,7,0,34,27
1657893641316,MATH 10B,B01,083739,Sinha; Shubham,14,0,30,16
1657893647348,MATH 18,A01,083743,Cinel; Cameron Alexander,9,0,30,21
1657893647348,MATH 18,A02,083744,Cinel; Cameron Alexander,18,0,30,12
1657893647348,MATH 18,A03,083745,Cinel; Cameron Alexander,10,0,30,20
1657893647348,MATH 18,B01,083748,Rideout; David Porter,5,0,37,32
1657893647348,MATH 18,B02,083749,Rideout; David Porter,5,0,36,31
1657893647348,MATH 18,B03,083750,Rideout; David Porter,3,0,37,34
1657893647348,MATH 18,B04,083751,Rideout; David Porter,6,0,36,30
1657893647348,MATH 18,B05,093473,Rideout; David Porter,6,0,36,30
1657893647348,MATH 18,B06,093474,Rideout; David Porter,6,0,36,30
1657893653375,MATH 20A,A01,083754,Zheng; Zequn,14,0,40,26
1657893659402,MATH 20B,A01,083756,Briones; Jor-el Thomas Caparas,4,0,36,32
1657893659402,MATH 20B,A02,083757,Briones; Jor-el Thomas Caparas,1,0,36,35
1657893659402,MATH 20B,A03,093475,Briones; Jor-el Thomas Caparas,2,0,36,34
1657893665431,MATH 20C,A01,083760,Briones; Jor-el Thomas Caparas,1,0,35,34
1657893665431,MATH 20C,A02,083761,Briones; Jor-el Thomas Caparas,8,0,35,27
1657893665431,MATH 20C,A03,093476,Briones; Jor-el Thomas Caparas,0,1,36,36
1657893665431,MATH 20C,B01,083762,Bach; Quang Tran,1,0,30,29
1657893671457,MATH 20D,A01,083765,Tran; Brian Kha,5,0,30,25
1657893671457,MATH 20D,A02,083766,Tran; Brian Kha,5,0,30,25
1657893671457,MATH 20D,A03,083767,Tran; Brian Kha,5,0,30,25
1657893677504,MATH 20E,A01,083771,Ganguly; Soumya,10,0,32,22
1657893677504,MATH 20E,A02,083772,Ganguly; Soumya,6,0,32,26
1657893677504,MATH 20E,B01,083773,Ciotti; Benjamin,20,0,35,15
1657893677504,MATH 20E,B02,083774,Ciotti; Benjamin,18,0,35,17
1657893683536,MATH 103A,A01,083777,Greenfeld; Be'Eri,3,0,36,33
1657893683536,MATH 103A,A02,083778,Greenfeld; Be'Eri,5,0,36,31
1657893683536,MATH 103A,A03,093561,Greenfeld; Be'Eri,6,0,36,30
1657893683536,MATH 103A,B01,083779,Greenfeld; Be'Eri,7,0,36,29
1657893683536,MATH 103A,B02,083780,Greenfeld; Be'Eri,4,0,36,32
1657893683536,MATH 103A,B03,093562,Greenfeld; Be'Eri,3,0,36,33
1657893689562,MATH 105,A01,085443,Carter; Anne Toulson,15,0,35,20
1657893689562,MATH 105,A02,093477,Carter; Anne Toulson,20,0,35,15
1657893695586,MATH 109,A01,083213,Ganzberger; Geoffrey Michael,3,0,34,31
1657893695586,MATH 109,A02,083214,Ganzberger; Geoffrey Michael,4,0,34,30
1657893695586,MATH 109,A03,093478,Ganzberger; Geoffrey Michael,2,0,34,32
1657893695586,MATH 109,B01,083215,Ganzberger; Geoffrey Michael,1,0,32,31
1657893695586,MATH 109,B02,083216,Ganzberger; Geoffrey Michael,2,0,32,30
1657893695586,MATH 109,B03,093479,Ganzberger; Geoffrey Michael,8,0,32,24
1657893701620,MATH 142A,A01,083219,Chow; Bennett,7,0,32,25
1657893701620,MATH 142A,A02,083220,Chow; Bennett,10,0,32,22
1657893701620,MATH 142A,A03,093480,Chow; Bennett,9,0,32,23
1657893701620,MATH 142A,B03,093481,Chow; Bennett,8,0,32,24
1657893701620,MATH 142A,B04,093558,Chow; Bennett,13,0,32,19
1657893701620,MATH 142A,B05,093559,Chow; Bennett,7,0,32,25
1657893707649,MATH 193A,A01,083224,Rotar; Vladimir,8,0,34,26
1657893707649,MATH 193A,A02,083225,Rotar; Vladimir,10,0,34,24
1657893707649,MATH 193A,A03,083781,Rotar; Vladimir,5,0,34,29
1657893707649,MATH 193A,A04,083782,Rotar; Vladimir,11,0,34,23
1657893707649,MATH 193A,A05,093482,Rotar; Vladimir,10,0,34,24
1657893713678,MATH 197,001,091859,McAuley; Julian John,9999,0,9999,0
1657893713678,MATH 197,002,095566,Kedlaya; Kiran S.,9997,0,9999,2
1657893713678,MATH 197,003,095567,Xiao; Ming,9999,0,9999,0
1657893713678,MATH 197,004,095571,Perols; Johan Lars,9998,0,9999,1
1657893720741,COGS 9,A01,083615,Shannon; Kyle Michael,10,0,75,65
1657893726768,COGS 11,A01,083617,Boyle; Mary E. T.,23,0,48,25
1657893732802,COGS 13,A01,083071,Bastos; Amalia Pinkusfeld,11,0,71,60
1657893738833,COGS 14A,A01,092681,Semenuks; Arturs,5,1,100,95
1657893744859,COGS 14B,A01,083073,Cheng; Tzu-Han,6,0,63,57
1657893750888,COGS 17,A01,092677,Semenuks; Arturs,6,0,81,75
1657893756923,COGS 100,A01,083619,Allen; Michael Gordon,17,0,70,53
1657893762967,COGS 101A,A01,083621,Davis; Joshua Daniel,9,0,68,59
1657893768994,COGS 101B,A01,091572,Allen; Michael Gordon,13,0,65,52
1657893775018,COGS 101C,A01,083625,Delgado; Tania,17,0,35,18
1657893781046,COGS 107A,A01,083627,Boyle; Mary E. T.,14,0,60,46
1657893787074,COGS 118A,A01,083075,Gupta; Anjum,21,0,76,55
1657893793101,CSE 3,A50,083646,Miranda; Gregory Joseph,24,0,50,26
1657893799133,CSE 8A,A50,083650,Miranda; Gregory Joseph,17,1,56,39
1657893805161,CSE 11,A01,083080,Cao; Yingjun,6,15,40,34
1657893811194,CSE 12,A01,083652,Krause-Levy; Sophia Louisa,30,1,120,90
1657893817223,CSE 15L,A01,083654,Morris; Justin Loren,9,0,50,41
1657893817223,CSE 15L,A02,083655,Morris; Justin Loren,10,0,50,40
1657893823247,CSE 20,A01,083657,Tran; Khoa Dang,39,0,80,41
1657893829276,CSE 21,A01,095574,Bach; Quang Tran,22,0,48,26
1657893835302,CSE 30,A01,083084,Eldon; John,6,0,80,74
1657893835302,CSE 30,B01,095061,Bhaskar; Nishant,9,0,50,41
1657893841334,CSE 100,A01,083659,Cao; Yingjun,5,4,70,65
1657893847360,CSE 134B,A01,083661,Powell; Thomas Allan,24,0,100,76
1657893853390,CSE 140,A01,083663,Gungor; Onat,15,0,85,70
1657893859420,CSE 140L,A01,083088,Eldon; John,23,0,100,77
1657893865450,CSE 175,A01,083665,Kumar; Rakesh,3,0,25,22
1657893871474,CSE 190,A00,092507,Dubnov; Shlomo,8,0,20,12
1657893877500,ECE 45,A01,083139,Congero; Spencer William,6,0,75,69
1657893883533,ECE 65,A50,083695,Saad; Andrew S,12,0,30,18
1657893883533,ECE 65,A51,095125,Saad; Andrew S,24,0,26,2
1657893889558,ECE 109,A01,091882,Touri; Behrouz,20,0,70,50
1657893895582,ECE 180,A00,083140,Abi Samra; Nicholas Camill,1,0,30,29
1657893895582,ECE 180,B00,083141,Abi Samra; Nicholas Camill,0,0,30,30
1657893901604,MATH 10A,A01,083735,Patchell; Gregory David,2,0,30,28
1657893901604,MATH 10A,A02,083736,Patchell; Gregory David,20,0,30,10
1657893901604,MATH 10A,A03,083737,Patchell; Gregory David,16,0,30,14
1657893907644,MATH 10B,A01,083207,Lim; Seonhee,8,0,34,26
1657893907644,MATH 10B,A02,083208,Lim; Seonhee,10,0,35,25
1657893907644,MATH 10B,A03,093472,Lim; Seonhee,7,0,34,27
1657893907644,MATH 10B,B01,083739,Sinha; Shubham,14,0,30,16
1657893913682,MATH 18,A01,083743,Cinel; Cameron Alexander,9,0,30,21
1657893913682,MATH 18,A02,083744,Cinel; Cameron Alexander,18,0,30,12
1657893913682,MATH 18,A03,083745,Cinel; Cameron Alexander,10,0,30,20
1657893913682,MATH 18,B01,083748,Rideout; David Porter,5,0,37,32
1657893913682,MATH 18,B02,083749,Rideout; David Porter,5,0,36,31
1657893913682,MATH 18,B03,083750,Rideout; David Porter,3,0,37,34
1657893913682,MATH 18,B04,083751,Rideout; David Porter,6,0,36,30
1657893913682,MATH 18,B05,093473,Rideout; David Porter,6,0,36,30
1657893913682,MATH 18,B06,093474,Rideout; David Porter,6,0,36,30
1657893919709,MATH 20A,A01,083754,Zheng; Zequn,14,0,40,26
1657893925731,MATH 20B,A01,083756,Briones; Jor-el Thomas Caparas,4,0,36,32
1657893925731,MATH 20B,A02,083757,Briones; Jor-el Thomas Caparas,1,0,36,35
1657893925731,MATH 20B,A03,093475,Briones; Jor-el Thomas Caparas,2,0,36,34
1657893931761,MATH 20C,A01,083760,Briones; Jor-el Thomas Caparas,1,0,35,34
1657893931761,MATH 20C,A02,083761,Briones; Jor-el Thomas Caparas,8,0,35,27
1657893931761,MATH 20C,A03,093476,Briones; Jor-el Thomas Caparas,0,1,36,36
1657893931761,MATH 20C,B01,083762,Bach; Quang Tran,1,0,30,29
1657893937784,MATH 20D,A01,083765,Tran; Brian Kha,5,0,30,25
1657893937784,MATH 20D,A02,083766,Tran; Brian Kha,5,0,30,25
1657893937784,MATH 20D,A03,083767,Tran; Brian Kha,5,0,30,25
1657893943901,MATH 20E,A01,083771,Ganguly; Soumya,10,0,32,22
1657893943901,MATH 20E,A02,083772,Ganguly; Soumya,6,0,32,26
1657893943901,MATH 20E,B01,083773,Ciotti; Benjamin,20,0,35,15
1657893943901,MATH 20E,B02,083774,Ciotti; Benjamin,18,0,35,17
1657893949927,MATH 103A,A01,083777,Greenfeld; Be'Eri,3,0,36,33
1657893949927,MATH 103A,A02,083778,Greenfeld; Be'Eri,5,0,36,31
1657893949927,MATH 103A,A03,093561,Greenfeld; Be'Eri,6,0,36,30
1657893949927,MATH 103A,B01,083779,Greenfeld; Be'Eri,7,0,36,29
1657893949927,MATH 103A,B02,083780,Greenfeld; Be'Eri,4,0,36,32
1657893949927,MATH 103A,B03,093562,Greenfeld; Be'Eri,3,0,36,33
1657893955952,MATH 105,A01,085443,Carter; Anne Toulson,15,0,35,20
1657893955952,MATH 105,A02,093477,Carter; Anne Toulson,20,0,35,15
1657893961978,MATH 109,A01,083213,Ganzberger; Geoffrey Michael,3,0,34,31
1657893961978,MATH 109,A02,083214,Ganzberger; Geoffrey Michael,4,0,34,30
1657893961978,MATH 109,A03,093478,Ganzberger; Geoffrey Michael,2,0,34,32
1657893961978,MATH 109,B01,083215,Ganzberger; Geoffrey Michael,1,0,32,31
1657893961978,MATH 109,B02,083216,Ganzberger; Geoffrey Michael,2,0,32,30
1657893961978,MATH 109,B03,093479,Ganzberger; Geoffrey Michael,8,0,32,24
1657893968002,MATH 142A,A01,083219,Chow; Bennett,7,0,32,25
1657893968002,MATH 142A,A02,083220,Chow; Bennett,10,0,32,22
1657893968002,MATH 142A,A03,093480,Chow; Bennett,9,0,32,23
1657893968002,MATH 142A,B03,093481,Chow; Bennett,8,0,32,24
1657893968002,MATH 142A,B04,093558,Chow; Bennett,13,0,32,19
1657893968002,MATH 142A,B05,093559,Chow; Bennett,7,0,32,25
1657893974026,MATH 193A,A01,083224,Rotar; Vladimir,8,0,34,26
1657893974026,MATH 193A,A02,083225,Rotar; Vladimir,10,0,34,24
1657893974026,MATH 193A,A03,083781,Rotar; Vladimir,5,0,34,29
1657893974026,MATH 193A,A04,083782,Rotar; Vladimir,11,0,34,23
1657893974026,MATH 193A,A05,093482,Rotar; Vladimir,10,0,34,24
1657893980054,MATH 197,001,091859,McAuley; Julian John,9999,0,9999,0
1657893980054,MATH 197,002,095566,Kedlaya; Kiran S.,9997,0,9999,2
1657893980054,MATH 197,003,095567,Xiao; Ming,9999,0,9999,0
1657893980054,MATH 197,004,095571,Perols; Johan Lars,9998,0,9999,1
1657893987116,COGS 9,A01,083615,Shannon; Kyle Michael,10,0,75,65
1657893993141,COGS 11,A01,083617,Boyle; Mary E. T.,23,0,48,25
1657893999171,COGS 13,A01,083071,Bastos; Amalia Pinkusfeld,11,0,71,60
1657894005198,COGS 14A,A01,092681,Semenuks; Arturs,5,1,100,95
1657894011220,COGS 14B,A01,083073,Cheng; Tzu-Han,6,0,63,57
1657894017248,COGS 17,A01,092677,Semenuks; Arturs,6,0,81,75
1657894023274,COGS 100,A01,083619,Allen; Michael Gordon,17,0,70,53
1657894029300,COGS 101A,A01,083621,Davis; Joshua Daniel,9,0,68,59
1657894035328,COGS 101B,A01,091572,Allen; Michael Gordon,13,0,65,52
1657894041351,COGS 101C,A01,083625,Delgado; Tania,17,0,35,18
1657894047374,COGS 107A,A01,083627,Boyle; Mary E. T.,14,0,60,46
1657894053400,COGS 118A,A01,083075,Gupta; Anjum,21,0,76,55
1657894059425,CSE 3,A50,083646,Miranda; Gregory Joseph,24,0,50,26
1657894065449,CSE 8A,A50,083650,Miranda; Gregory Joseph,17,1,56,39
1657894071490,CSE 11,A01,083080,Cao; Yingjun,6,15,40,34
1657894077523,CSE 12,A01,083652,Krause-Levy; Sophia Louisa,30,1,120,90
1657894083552,CSE 15L,A01,083654,Morris; Justin Loren,9,0,50,41
1657894083552,CSE 15L,A02,083655,Morris; Justin Loren,10,0,50,40
1657894089576,CSE 20,A01,083657,Tran; Khoa Dang,39,0,80,41
1657894095608,CSE 21,A01,095574,Bach; Quang Tran,22,0,48,26
1657894101641,CSE 30,A01,083084,Eldon; John,6,0,80,74
1657894101641,CSE 30,B01,095061,Bhaskar; Nishant,9,0,50,41
1657894107664,CSE 100,A01,083659,Cao; Yingjun,5,4,70,65
1657894113699,CSE 134B,A01,083661,Powell; Thomas Allan,24,0,100,76
1657894119724,CSE 140,A01,083663,Gungor; Onat,15,0,85,70
1657894125751,CSE 140L,A01,083088,Eldon; John,23,0,100,77
1657894131777,CSE 175,A01,083665,Kumar; Rakesh,3,0,25,22
1657894137813,CSE 190,A00,092507,Dubnov; Shlomo,8,0,20,12
1657894143840,ECE 45,A01,083139,Congero; Spencer William,6,0,75,69
1657894149864,ECE 65,A50,083695,Saad; Andrew S,12,0,30,18
1657894149864,ECE 65,A51,095125,Saad; Andrew S,24,0,26,2
1657894155891,ECE 109,A01,091882,Touri; Behrouz,20,0,70,50
1657894161919,ECE 180,A00,083140,Abi Samra; Nicholas Camill,1,0,30,29
1657894161919,ECE 180,B00,083141,Abi Samra; Nicholas Camill,0,0,30,30
1657894167941,MATH 10A,A01,083735,Patchell; Gregory David,2,0,30,28
1657894167941,MATH 10A,A02,083736,Patchell; Gregory David,20,0,30,10
1657894167941,MATH 10A,A03,083737,Patchell; Gregory David,16,0,30,14
1657894173973,MATH 10B,A01,083207,Lim; Seonhee,8,0,34,26
1657894173973,MATH 10B,A02,083208,Lim; Seonhee,10,0,35,25
1657894173973,MATH 10B,A03,093472,Lim; Seonhee,7,0,34,27
1657894173973,MATH 10B,B01,083739,Sinha; Shubham,14,0,30,16
1657894180003,MATH 18,A01,083743,Cinel; Cameron Alexander,9,0,30,21
1657894180003,MATH 18,A02,083744,Cinel; Cameron Alexander,18,0,30,12
1657894180003,MATH 18,A03,083745,Cinel; Cameron Alexander,10,0,30,20
1657894180003,MATH 18,B01,083748,Rideout; David Porter,5,0,37,32
1657894180003,MATH 18,B02,083749,Rideout; David Porter,5,0,36,31
1657894180003,MATH 18,B03,083750,Rideout; David Porter,3,0,37,34
1657894180003,MATH 18,B04,083751,Rideout; David Porter,6,0,36,30
1657894180003,MATH 18,B05,093473,Rideout; David Porter,6,0,36,30
1657894180003,MATH 18,B06,093474,Rideout; David Porter,6,0,36,30
1657894186038,MATH 20A,A01,083754,Zheng; Zequn,14,0,40,26
1657894192073,MATH 20B,A01,083756,Briones; Jor-el Thomas Caparas,4,0,36,32
1657894192073,MATH 20B,A02,083757,Briones; Jor-el Thomas Caparas,1,0,36,35
1657894192073,MATH 20B,A03,093475,Briones; Jor-el Thomas Caparas,2,0,36,34
1657894198097,MATH 20C,A01,083760,Briones; Jor-el Thomas Caparas,1,0,35,34
1657894198097,MATH 20C,A02,083761,Briones; Jor-el Thomas Caparas,8,0,35,27
1657894198097,MATH 20C,A03,093476,Briones; Jor-el Thomas Caparas,0,1,36,36
1657894198097,MATH 20C,B01,083762,Bach; Quang Tran,1,0,30,29
1657894204121,MATH 20D,A01,083765,Tran; Brian Kha,5,0,30,25
1657894204121,MATH 20D,A02,083766,Tran; Brian Kha,5,0,30,25
1657894204121,MATH 20D,A03,083767,Tran; Brian Kha,5,0,30,25
1657894210148,MATH 20E,A01,083771,Ganguly; Soumya,10,0,32,22
1657894210148,MATH 20E,A02,083772,Ganguly; Soumya,6,0,32,26
1657894210148,MATH 20E,B01,083773,Ciotti; Benjamin,20,0,35,15
1657894210148,MATH 20E,B02,083774,Ciotti; Benjamin,18,0,35,17
1657894216172,MATH 103A,A01,083777,Greenfeld; Be'Eri,3,0,36,33
1657894216172,MATH 103A,A02,083778,Greenfeld; Be'Eri,5,0,36,31
1657894216172,MATH 103A,A03,093561,Greenfeld; Be'Eri,6,0,36,30
1657894216172,MATH 103A,B01,083779,Greenfeld; Be'Eri,7,0,36,29
1657894216172,MATH 103A,B02,083780,Greenfeld; Be'Eri,4,0,36,32
1657894216172,MATH 103A,B03,093562,Greenfeld; Be'Eri,3,0,36,33
1657894222206,MATH 105,A01,085443,Carter; Anne Toulson,15,0,35,20
1657894222206,MATH 105,A02,093477,Carter; Anne Toulson,20,0,35,15
1657894228230,MATH 109,A01,083213,Ganzberger; Geoffrey Michael,3,0,34,31
1657894228230,MATH 109,A02,083214,Ganzberger; Geoffrey Michael,4,0,34,30
1657894228230,MATH 109,A03,093478,Ganzberger; Geoffrey Michael,2,0,34,32
1657894228230,MATH 109,B01,083215,Ganzberger; Geoffrey Michael,1,0,32,31
1657894228230,MATH 109,B02,083216,Ganzberger; Geoffrey Michael,2,0,32,30
1657894228230,MATH 109,B03,093479,Ganzberger; Geoffrey Michael,8,0,32,24
1657894234254,MATH 142A,A01,083219,Chow; Bennett,7,0,32,25
1657894234254,MATH 142A,A02,083220,Chow; Bennett,10,0,32,22
1657894234254,MATH 142A,A03,093480,Chow; Bennett,9,0,32,23
1657894234254,MATH 142A,B03,093481,Chow; Bennett,8,0,32,24
1657894234254,MATH 142A,B04,093558,Chow; Bennett,13,0,32,19
1657894234254,MATH 142A,B05,093559,Chow; Bennett,7,0,32,25
1657894240277,MATH 193A,A01,083224,Rotar; Vladimir,8,0,34,26
1657894240277,MATH 193A,A02,083225,Rotar; Vladimir,10,0,34,24
1657894240277,MATH 193A,A03,083781,Rotar; Vladimir,5,0,34,29
1657894240277,MATH 193A,A04,083782,Rotar; Vladimir,11,0,34,23
1657894240277,MATH 193A,A05,093482,Rotar; Vladimir,10,0,34,24
1657894246302,MATH 197,001,091859,McAuley; Julian John,9999,0,9999,0
1657894246302,MATH 197,002,095566,Kedlaya; Kiran S.,9997,0,9999,2
1657894246302,MATH 197,003,095567,Xiao; Ming,9999,0,9999,0
1657894246302,MATH 197,004,095571,Perols; Johan Lars,9998,0,9999,1
1657894253377,COGS 9,A01,083615,Shannon; Kyle Michael,10,0,75,65
1657894259407,COGS 11,A01,083617,Boyle; Mary E. T.,23,0,48,25
1657894265430,COGS 13,A01,083071,Bastos; Amalia Pinkusfeld,11,0,71,60
1657894271456,COGS 14A,A01,092681,Semenuks; Arturs,5,1,100,95
1657894277483,COGS 14B,A01,083073,Cheng; Tzu-Han,6,0,63,57
1657894283510,COGS 17,A01,092677,Semenuks; Arturs,6,0,81,75
1657894289534,COGS 100,A01,083619,Allen; Michael Gordon,17,0,70,53
1657894295556,COGS 101A,A01,083621,Davis; Joshua Daniel,9,0,68,59
1657894301582,COGS 101B,A01,091572,Allen; Michael Gordon,13,0,65,52
1657894307608,COGS 101C,A01,083625,Delgado; Tania,17,0,35,18
1657894313632,COGS 107A,A01,083627,Boyle; Mary E. T.,14,0,60,46
1657894319658,COGS 118A,A01,083075,Gupta; Anjum,21,0,76,55
1657894325683,CSE 3,A50,083646,Miranda; Gregory Joseph,24,0,50,26
1657894331708,CSE 8A,A50,083650,Miranda; Gregory Joseph,17,1,56,39
1657894337730,CSE 11,A01,083080,Cao; Yingjun,6,15,40,34
1657894343756,CSE 12,A01,083652,Krause-Levy; Sophia Louisa,30,1,120,90
1657894349780,CSE 15L,A01,083654,Morris; Justin Loren,9,0,50,41
1657894349780,CSE 15L,A02,083655,Morris; Justin Loren,10,0,50,40
1657894355818,CSE 20,A01,083657,Tran; Khoa Dang,39,0,80,41
1657894361843,CSE 21,A01,095574,Bach; Quang Tran,22,0,48,26
1657894367868,CSE 30,A01,083084,Eldon; John,6,0,80,74
1657894367868,CSE 30,B01,095061,Bhaskar; Nishant,9,0,50,41
1657894373894,CSE 100,A01,083659,Cao; Yingjun,5,4,70,65
1657894379918,CSE 134B,A01,083661,Powell; Thomas Allan,24,0,100,76
1657894385942,CSE 140,A01,083663,Gungor; Onat,15,0,85,70
1657894391966,CSE 140L,A01,083088,Eldon; John,23,0,100,77
1657894397993,CSE 175,A01,083665,Kumar; Rakesh,3,0,25,22
1657894404016,CSE 190,A00,092507,Dubnov; Shlomo,8,0,20,12
1657894410046,ECE 45,A01,083139,Congero; Spencer William,6,0,75,69
1657894416075,ECE 65,A50,083695,Saad; Andrew S,12,0,30,18
1657894416075,ECE 65,A51,095125,Saad; Andrew S,24,0,26,2
1657894422099,ECE 109,A01,091882,Touri; Behrouz,20,0,70,50
1657894428121,ECE 180,A00,083140,Abi Samra; Nicholas Camill,1,0,30,29
1657894428121,ECE 180,B00,083141,Abi Samra; Nicholas Camill,0,0,30,30
1657894434145,MATH 10A,A01,083735,Patchell; Gregory David,2,0,30,28
1657894434145,MATH 10A,A02,083736,Patchell; Gregory David,20,0,30,10
1657894434145,MATH 10A,A03,083737,Patchell; Gregory David,16,0,30,14
1657894440173,MATH 10B,A01,083207,Lim; Seonhee,8,0,34,26
1657894440173,MATH 10B,A02,083208,Lim; Seonhee,10,0,35,25
1657894440173,MATH 10B,A03,093472,Lim; Seonhee,7,0,34,27
1657894440173,MATH 10B,B01,083739,Sinha; Shubham,14,0,30,16
1657894446200,MATH 18,A01,083743,Cinel; Cameron Alexander,9,0,30,21
1657894446200,MATH 18,A02,083744,Cinel; Cameron Alexander,18,0,30,12
1657894446200,MATH 18,A03,083745,Cinel; Cameron Alexander,10,0,30,20
1657894446200,MATH 18,B01,083748,Rideout; David Porter,5,0,37,32
1657894446200,MATH 18,B02,083749,Rideout; David Porter,5,0,36,31
1657894446200,MATH 18,B03,083750,Rideout; David Porter,3,0,37,34
1657894446200,MATH 18,B04,083751,Rideout; David Porter,6,0,36,30
1657894446200,MATH 18,B05,093473,Rideout; David Porter,6,0,36,30
1657894446200,MATH 18,B06,093474,Rideout; David Porter,6,0,36,30
1657894452233,MATH 20A,A01,083754,Zheng; Zequn,14,0,40,26
1657894458258,MATH 20B,A01,083756,Briones; Jor-el Thomas Caparas,4,0,36,32
1657894458258,MATH 20B,A02,083757,Briones; Jor-el Thomas Caparas,1,0,36,35
1657894458258,MATH 20B,A03,093475,Briones; Jor-el Thomas Caparas,2,0,36,34
1657894464282,MATH 20C,A01,083760,Briones; Jor-el Thomas Caparas,1,0,35,34
1657894464282,MATH 20C,A02,083761,Briones; Jor-el Thomas Caparas,8,0,35,27
1657894464282,MATH 20C,A03,093476,Briones; Jor-el Thomas Caparas,0,1,36,36
1657894464282,MATH 20C,B01,083762,Bach; Quang Tran,1,0,30,29
1657894470310,MATH 20D,A01,083765,Tran; Brian Kha,5,0,30,25
1657894470310,MATH 20D,A02,083766,Tran; Brian Kha,5,0,30,25
1657894470310,MATH 20D,A03,083767,Tran; Brian Kha,5,0,30,25
1657894476355,MATH 20E,A01,083771,Ganguly; Soumya,10,0,32,22
1657894476355,MATH 20E,A02,083772,Ganguly; Soumya,6,0,32,26
1657894476355,MATH 20E,B01,083773,Ciotti; Benjamin,20,0,35,15
1657894476355,MATH 20E,B02,083774,Ciotti; Benjamin,18,0,35,17
1657894482381,MATH 103A,A01,083777,Greenfeld; Be'Eri,3,0,36,33
1657894482381,MATH 103A,A02,083778,Greenfeld; Be'Eri,5,0,36,31
1657894482381,MATH 103A,A03,093561,Greenfeld; Be'Eri,6,0,36,30
1657894482381,MATH 103A,B01,083779,Greenfeld; Be'Eri,7,0,36,29
1657894482381,MATH 103A,B02,083780,Greenfeld; Be'Eri,4,0,36,32
1657894482381,MATH 103A,B03,093562,Greenfeld; Be'Eri,3,0,36,33
1657894488408,MATH 105,A01,085443,Carter; Anne Toulson,15,0,35,20
1657894488408,MATH 105,A02,093477,Carter; Anne Toulson,20,0,35,15
1657894494444,MATH 109,A01,083213,Ganzberger; Geoffrey Michael,3,0,34,31
1657894494444,MATH 109,A02,083214,Ganzberger; Geoffrey Michael,4,0,34,30
1657894494444,MATH 109,A03,093478,Ganzberger; Geoffrey Michael,2,0,34,32
1657894494444,MATH 109,B01,083215,Ganzberger; Geoffrey Michael,1,0,32,31
1657894494444,MATH 109,B02,083216,Ganzberger; Geoffrey Michael,2,0,32,30
1657894494444,MATH 109,B03,093479,Ganzberger; Geoffrey Michael,8,0,32,24
1657894500468,MATH 142A,A01,083219,Chow; Bennett,7,0,32,25
1657894500468,MATH 142A,A02,083220,Chow; Bennett,10,0,32,22
1657894500468,MATH 142A,A03,093480,Chow; Bennett,9,0,32,23
1657894500468,MATH 142A,B03,093481,Chow; Bennett,8,0,32,24
1657894500468,MATH 142A,B04,093558,Chow; Bennett,13,0,32,19
1657894500468,MATH 142A,B05,093559,Chow; Bennett,7,0,32,25
1657894506492,MATH 193A,A01,083224,Rotar; Vladimir,8,0,34,26
1657894506492,MATH 193A,A02,083225,Rotar; Vladimir,10,0,34,24
1657894506492,MATH 193A,A03,083781,Rotar; Vladimir,5,0,34,29
1657894506492,MATH 193A,A04,083782,Rotar; Vladimir,11,0,34,23
1657894506492,MATH 193A,A05,093482,Rotar; Vladimir,10,0,34,24
1657894512516,MATH 197,001,091859,McAuley; Julian John,9999,0,9999,0
1657894512516,MATH 197,002,095566,Kedlaya; Kiran S.,9997,0,9999,2
1657894512516,MATH 197,003,095567,Xiao; Ming,9999,0,9999,0
1657894512516,MATH 197,004,095571,Perols; Johan Lars,9998,0,9999,1
1657894519590,COGS 9,A01,083615,Shannon; Kyle Michael,10,0,75,65
1657894525613,COGS 11,A01,083617,Boyle; Mary E. T.,23,0,48,25
1657894531641,COGS 13,A01,083071,Bastos; Amalia Pinkusfeld,11,0,71,60
1657894537736,COGS 14A,A01,092681,Semenuks; Arturs,5,1,100,95
1657894543767,COGS 14B,A01,083073,Cheng; Tzu-Han,6,0,63,57
1657894549797,COGS 17,A01,092677,Semenuks; Arturs,6,0,81,75
1657894555826,COGS 100,A01,083619,Allen; Michael Gordon,17,0,70,53
1657894561849,COGS 101A,A01,083621,Davis; Joshua Daniel,9,0,68,59
1657894567877,COGS 101B,A01,091572,Allen; Michael Gordon,13,0,65,52
1657894573901,COGS 101C,A01,083625,Delgado; Tania,17,0,35,18
1657894579932,COGS 107A,A01,083627,Boyle; Mary E. T.,14,0,60,46
1657894585958,COGS 118A,A01,083075,Gupta; Anjum,21,0,76,55
1657894591985,CSE 3,A50,083646,Miranda; Gregory Joseph,24,0,50,26
1657894598014,CSE 8A,A50,083650,Miranda; Gregory Joseph,17,1,56,39
1657894604040,CSE 11,A01,083080,Cao; Yingjun,6,15,40,34
1657894610072,CSE 12,A01,083652,Krause-Levy; Sophia Louisa,30,1,120,90
1657894616106,CSE 15L,A01,083654,Morris; Justin Loren,9,0,50,41
1657894616106,CSE 15L,A02,083655,Morris; Justin Loren,10,0,50,40
1657894622129,CSE 20,A01,083657,Tran; Khoa Dang,39,0,80,41
1657894628156,CSE 21,A01,095574,Bach; Quang Tran,22,0,48,26
1657894634179,CSE 30,A01,083084,Eldon; John,6,0,80,74
1657894634179,CSE 30,B01,095061,Bhaskar; Nishant,9,0,50,41
1657894640206,CSE 100,A01,083659,Cao; Yingjun,5,4,70,65
1657894646230,CSE 134B,A01,083661,Powell; Thomas Allan,24,0,100,76
1657894652257,CSE 140,A01,083663,Gungor; Onat,15,0,85,70
1657894658284,CSE 140L,A01,083088,Eldon; John,23,0,100,77
1657894664308,CSE 175,A01,083665,Kumar; Rakesh,3,0,25,22
1657894670335,CSE 190,A00,092507,Dubnov; Shlomo,8,0,20,12
1657894676358,ECE 45,A01,083139,Congero; Spencer William,6,0,75,69
1657894682389,ECE 65,A50,083695,Saad; Andrew S,12,0,30,18
1657894682389,ECE 65,A51,095125,Saad; Andrew S,24,0,26,2
1657894688413,ECE 109,A01,091882,Touri; Behrouz,20,0,70,50
1657894694437,ECE 180,A00,083140,Abi Samra; Nicholas Camill,1,0,30,29
1657894694437,ECE 180,B00,083141,Abi Samra; Nicholas Camill,0,0,30,30
1657894700462,MATH 10A,A01,083735,Patchell; Gregory David,2,0,30,28
1657894700462,MATH 10A,A02,083736,Patchell; Gregory David,20,0,30,10
1657894700462,MATH 10A,A03,083737,Patchell; Gregory David,16,0,30,14
1657894706500,MATH 10B,A01,083207,Lim; Seonhee,8,0,34,26
1657894706500,MATH 10B,A02,083208,Lim; Seonhee,10,0,35,25
1657894706500,MATH 10B,A03,093472,Lim; Seonhee,7,0,34,27
1657894706500,MATH 10B,B01,083739,Sinha; Shubham,14,0,30,16
1657894712525,MATH 18,A01,083743,Cinel; Cameron Alexander,9,0,30,21
1657894712525,MATH 18,A02,083744,Cinel; Cameron Alexander,18,0,30,12
1657894712525,MATH 18,A03,083745,Cinel; Cameron Alexander,10,0,30,20
1657894712525,MATH 18,B01,083748,Rideout; David Porter,5,0,37,32
1657894712525,MATH 18,B02,083749,Rideout; David Porter,5,0,36,31
1657894712525,MATH 18,B03,083750,Rideout; David Porter,3,0,37,34
1657894712525,MATH 18,B04,083751,Rideout; David Porter,6,0,36,30
1657894712525,MATH 18,B05,093473,Rideout; David Porter,6,0,36,30
1657894712525,MATH 18,B06,093474,Rideout; David Porter,6,0,36,30
1657894718549,MATH 20A,A01,083754,Zheng; Zequn,14,0,40,26
1657894724576,MATH 20B,A01,083756,Briones; Jor-el Thomas Caparas,4,0,36,32
1657894724576,MATH 20B,A02,083757,Briones; Jor-el Thomas Caparas,1,0,36,35
1657894724576,MATH 20B,A03,093475,Briones; Jor-el Thomas Caparas,2,0,36,34
1657894730600,MATH 20C,A01,083760,Briones; Jor-el Thomas Caparas,1,0,35,34
1657894730600,MATH 20C,A02,083761,Briones; Jor-el Thomas Caparas,8,0,35,27
1657894730600,MATH 20C,A03,093476,Briones; Jor-el Thomas Caparas,0,1,36,36
1657894730600,MATH 20C,B01,083762,Bach; Quang Tran,1,0,30,29
1657894736629,MATH 20D,A01,083765,Tran; Brian Kha,5,0,30,25
1657894736629,MATH 20D,A02,083766,Tran; Brian Kha,5,0,30,25
1657894736629,MATH 20D,A03,083767,Tran; Brian Kha,5,0,30,25
1657894742662,MATH 20E,A01,083771,Ganguly; Soumya,10,0,32,22
1657894742662,MATH 20E,A02,083772,Ganguly; Soumya,6,0,32,26
1657894742662,MATH 20E,B01,083773,Ciotti; Benjamin,20,0,35,15
1657894742662,MATH 20E,B02,083774,Ciotti; Benjamin,18,0,35,17
1657894748692,MATH 103A,A01,083777,Greenfeld; Be'Eri,3,0,36,33
1657894748692,MATH 103A,A02,083778,Greenfeld; Be'Eri,5,0,36,31
1657894748692,MATH 103A,A03,093561,Greenfeld; Be'Eri,6,0,36,30
1657894748692,MATH 103A,B01,083779,Greenfeld; Be'Eri,7,0,36,29
1657894748692,MATH 103A,B02,083780,Greenfeld; Be'Eri,4,0,36,32
1657894748692,MATH 103A,B03,093562,Greenfeld; Be'Eri,3,0,36,33
1657894754728,MATH 105,A01,085443,Carter; Anne Toulson,15,0,35,20
1657894754728,MATH 105,A02,093477,Carter; Anne Toulson,20,0,35,15
1657894760754,MATH 109,A01,083213,Ganzberger; Geoffrey Michael,3,0,34,31
1657894760754,MATH 109,A02,083214,Ganzberger; Geoffrey Michael,4,0,34,30
1657894760754,MATH 109,A03,093478,Ganzberger; Geoffrey Michael,2,0,34,32
1657894760754,MATH 109,B01,083215,Ganzberger; Geoffrey Michael,1,0,32,31
1657894760754,MATH 109,B02,083216,Ganzberger; Geoffrey Michael,2,0,32,30
1657894760754,MATH 109,B03,093479,Ganzberger; Geoffrey Michael,8,0,32,24
1657894766777,MATH 142A,A01,083219,Chow; Bennett,7,0,32,25
1657894766777,MATH 142A,A02,083220,Chow; Bennett,10,0,32,22
1657894766777,MATH 142A,A03,093480,Chow; Bennett,9,0,32,23
1657894766777,MATH 142A,B03,093481,Chow; Bennett,8,0,32,24
1657894766777,MATH 142A,B04,093558,Chow; Bennett,13,0,32,19
1657894766777,MATH 142A,B05,093559,Chow; Bennett,7,0,32,25
1657894772800,MATH 193A,A01,083224,Rotar; Vladimir,8,0,34,26
1657894772800,MATH 193A,A02,083225,Rotar; Vladimir,10,0,34,24
1657894772800,MATH 193A,A03,083781,Rotar; Vladimir,5,0,34,29
1657894772800,MATH 193A,A04,083782,Rotar; Vladimir,11,0,34,23
1657894772800,MATH 193A,A05,093482,Rotar; Vladimir,10,0,34,24
1657894778824,MATH 197,001,091859,McAuley; Julian John,9999,0,9999,0
1657894778824,MATH 197,002,095566,Kedlaya; Kiran S.,9997,0,9999,2
1657894778824,MATH 197,003,095567,Xiao; Ming,9999,0,9999,0
1657894778824,MATH 197,004,095571,Perols; Johan Lars,9998,0,9999,1
1657894785876,COGS 9,A01,083615,Shannon; Kyle Michael,10,0,75,65
1657894791900,COGS 11,A01,083617,Boyle; Mary E. T.,23,0,48,25
1657894797924,COGS 13,A01,083071,Bastos; Amalia Pinkusfeld,11,0,71,60
1657894803947,COGS 14A,A01,092681,Semenuks; Arturs,5,1,100,95
1657894809979,COGS 14B,A01,083073,Cheng; Tzu-Han,6,0,63,57
1657894816001,COGS 17,A01,092677,Semenuks; Arturs,6,0,81,75
1657894822024,COGS 100,A01,083619,Allen; Michael Gordon,17,0,70,53
1657894828048,COGS 101A,A01,083621,Davis; Joshua Daniel,9,0,68,59
1657894834075,COGS 101B,A01,091572,Allen; Michael Gordon,13,0,65,52
1657894840103,COGS 101C,A01,083625,Delgado; Tania,17,0,35,18
1657894846129,COGS 107A,A01,083627,Boyle; Mary E. T.,14,0,60,46
1657894852153,COGS 118A,A01,083075,Gupta; Anjum,21,0,76,55
1657894858194,CSE 3,A50,083646,Miranda; Gregory Joseph,24,0,50,26
1657894864222,CSE 8A,A50,083650,Miranda; Gregory Joseph,17,1,56,39
1657894870245,CSE 11,A01,083080,Cao; Yingjun,6,15,40,34
1657894876269,CSE 12,A01,083652,Krause-Levy; Sophia Louisa,30,1,120,90
1657894882296,CSE 15L,A01,083654,Morris; Justin Loren,9,0,50,41
1657894882296,CSE 15L,A02,083655,Morris; Justin Loren,10,0,50,40
1657894888326,CSE 20,A01,083657,Tran; Khoa Dang,39,0,80,41
1657894894362,CSE 21,A01,095574,Bach; Quang Tran,22,0,48,26
1657894900388,CSE 30,A01,083084,Eldon; John,6,0,80,74
1657894900388,CSE 30,B01,095061,Bhaskar; Nishant,9,0,50,41
1657894906415,CSE 100,A01,083659,Cao; Yingjun,5,4,70,65
1657894912442,CSE 134B,A01,083661,Powell; Thomas Allan,24,0,100,76
1657894918465,CSE 140,A01,083663,Gungor; Onat,15,0,85,70
1657894924490,CSE 140L,A01,083088,Eldon; John,23,0,100,77
1657894930513,CSE 175,A01,083665,Kumar; Rakesh,3,0,25,22
1657894936538,CSE 190,A00,092507,Dubnov; Shlomo,8,0,20,12
1657894942560,ECE 45,A01,083139,Congero; Spencer William,6,0,75,69
1657894948585,ECE 65,A50,083695,Saad; Andrew S,12,0,30,18
1657894948585,ECE 65,A51,095125,Saad; Andrew S,24,0,26,2
1657894954611,ECE 109,A01,091882,Touri; Behrouz,20,0,70,50
1657894960640,ECE 180,A00,083140,Abi Samra; Nicholas Camill,1,0,30,29
1657894960640,ECE 180,B00,083141,Abi Samra; Nicholas Camill,0,0,30,30
1657894966676,MATH 10A,A01,083735,Patchell; Gregory David,2,0,30,28
1657894966676,MATH 10A,A02,083736,Patchell; Gregory David,20,0,30,10
1657894966676,MATH 10A,A03,083737,Patchell; Gregory David,16,0,30,14
1657894972701,MATH 10B,A01,083207,Lim; Seonhee,8,0,34,26
1657894972701,MATH 10B,A02,083208,Lim; Seonhee,10,0,35,25
1657894972701,MATH 10B,A03,093472,Lim; Seonhee,7,0,34,27
1657894972701,MATH 10B,B01,083739,Sinha; Shubham,14,0,30,16
1657894978733,MATH 18,A01,083743,Cinel; Cameron Alexander,9,0,30,21
1657894978733,MATH 18,A02,083744,Cinel; Cameron Alexander,18,0,30,12
1657894978733,MATH 18,A03,083745,Cinel; Cameron Alexander,10,0,30,20
1657894978733,MATH 18,B01,083748,Rideout; David Porter,5,0,37,32
1657894978733,MATH 18,B02,083749,Rideout; David Porter,5,0,36,31
1657894978733,MATH 18,B03,083750,Rideout; David Porter,3,0,37,34
1657894978733,MATH 18,B04,083751,Rideout; David Porter,6,0,36,30
1657894978733,MATH 18,B05,093473,Rideout; David Porter,6,0,36,30
1657894978733,MATH 18,B06,093474,Rideout; David Porter,6,0,36,30
1657894984762,MATH 20A,A01,083754,Zheng; Zequn,14,0,40,26
1657894990788,MATH 20B,A01,083756,Briones; Jor-el Thomas Caparas,4,0,36,32
1657894990788,MATH 20B,A02,083757,Briones; Jor-el Thomas Caparas,1,0,36,35
1657894990788,MATH 20B,A03,093475,Briones; Jor-el Thomas Caparas,2,0,36,34
1657894996815,MATH 20C,A01,083760,Briones; Jor-el Thomas Caparas,1,0,35,34
1657894996815,MATH 20C,A02,083761,Briones; Jor-el Thomas Caparas,8,0,35,27
1657894996815,MATH 20C,A03,093476,Briones; Jor-el Thomas Caparas,0,1,36,36
1657894996815,MATH 20C,B01,083762,Bach; Quang Tran,1,0,30,29
1657895002841,MATH 20D,A01,083765,Tran; Brian Kha,5,0,30,25
1657895002841,MATH 20D,A02,083766,Tran; Brian Kha,5,0,30,25
1657895002841,MATH 20D,A03,083767,Tran; Brian Kha,5,0,30,25
1657895008877,MATH 20E,A01,083771,Ganguly; Soumya,10,0,32,22
1657895008877,MATH 20E,A02,083772,Ganguly; Soumya,6,0,32,26
1657895008877,MATH 20E,B01,083773,Ciotti; Benjamin,20,0,35,15
1657895008877,MATH 20E,B02,083774,Ciotti; Benjamin,18,0,35,17
1657895014905,MATH 103A,A01,083777,Greenfeld; Be'Eri,3,0,36,33
1657895014905,MATH 103A,A02,083778,Greenfeld; Be'Eri,5,0,36,31
1657895014905,MATH 103A,A03,093561,Greenfeld; Be'Eri,6,0,36,30
1657895014905,MATH 103A,B01,083779,Greenfeld; Be'Eri,7,0,36,29
1657895014905,MATH 103A,B02,083780,Greenfeld; Be'Eri,4,0,36,32
1657895014905,MATH 103A,B03,093562,Greenfeld; Be'Eri,3,0,36,33
1657895020934,MATH 105,A01,085443,Carter; Anne Toulson,15,0,35,20
1657895020934,MATH 105,A02,093477,Carter; Anne Toulson,20,0,35,15
1657895026958,MATH 109,A01,083213,Ganzberger; Geoffrey Michael,3,0,34,31
1657895026958,MATH 109,A02,083214,Ganzberger; Geoffrey Michael,4,0,34,30
1657895026958,MATH 109,A03,093478,Ganzberger; Geoffrey Michael,2,0,34,32
1657895026958,MATH 109,B01,083215,Ganzberger; Geoffrey Michael,1,0,32,31
1657895026958,MATH 109,B02,083216,Ganzberger; Geoffrey Michael,2,0,32,30
1657895026958,MATH 109,B03,093479,Ganzberger; Geoffrey Michael,8,0,32,24
1657895032988,MATH 142A,A01,083219,Chow; Bennett,7,0,32,25
1657895032988,MATH 142A,A02,083220,Chow; Bennett,10,0,32,22
1657895032988,MATH 142A,A03,093480,Chow; Bennett,9,0,32,23
1657895032988,MATH 142A,B03,093481,Chow; Bennett,8,0,32,24
1657895032988,MATH 142A,B04,093558,Chow; Bennett,13,0,32,19
1657895032988,MATH 142A,B05,093559,Chow; Bennett,7,0,32,25
1657895039027,MATH 193A,A01,083224,Rotar; Vladimir,8,0,34,26
1657895039027,MATH 193A,A02,083225,Rotar; Vladimir,10,0,34,24
1657895039027,MATH 193A,A03,083781,Rotar; Vladimir,5,0,34,29
1657895039027,MATH 193A,A04,083782,Rotar; Vladimir,11,0,34,23
1657895039027,MATH 193A,A05,093482,Rotar; Vladimir,10,0,34,24
1657895045051,MATH 197,001,091859,McAuley; Julian John,9999,0,9999,0
1657895045051,MATH 197,002,095566,Kedlaya; Kiran S.,9997,0,9999,2
1657895045051,MATH 197,003,095567,Xiao; Ming,9999,0,9999,0
1657895045051,MATH 197,004,095571,Perols; Johan Lars,9998,0,9999,1
1657895052115,COGS 9,A01,083615,Shannon; Kyle Michael,10,0,75,65
1657895058138,COGS 11,A01,083617,Boyle; Mary E. T.,23,0,48,25
1657895064166,COGS 13,A01,083071,Bastos; Amalia Pinkusfeld,11,0,71,60
1657895070190,COGS 14A,A01,092681,Semenuks; Arturs,5,1,100,95
1657895076213,COGS 14B,A01,083073,Cheng; Tzu-Han,6,0,63,57
1657895082235,COGS 17,A01,092677,Semenuks; Arturs,6,0,81,75
1657895088259,COGS 100,A01,083619,Allen; Michael Gordon,17,0,70,53
1657895094296,COGS 101A,A01,083621,Davis; Joshua Daniel,9,0,68,59
1657895100331,COGS 101B,A01,091572,Allen; Michael Gordon,13,0,65,52
1657895106359,COGS 101C,A01,083625,Delgado; Tania,17,0,35,18
1657895112385,COGS 107A,A01,083627,Boyle; Mary E. T.,14,0,60,46
1657895118422,COGS 118A,A01,083075,Gupta; Anjum,21,0,76,55
1657895124446,CSE 3,A50,083646,Miranda; Gregory Joseph,24,0,50,26
1657895130473,CSE 8A,A50,083650,Miranda; Gregory Joseph,17,1,56,39
1657895136587,CSE 11,A01,083080,Cao; Yingjun,6,15,40,34
1657895142616,CSE 12,A01,083652,Krause-Levy; Sophia Louisa,30,1,120,90
1657895148638,CSE 15L,A01,083654,Morris; Justin Loren,9,0,50,41
1657895148638,CSE 15L,A02,083655,Morris; Justin Loren,10,0,50,40
1657895154665,CSE 20,A01,083657,Tran; Khoa Dang,39,0,80,41
1657895160693,CSE 21,A01,095574,Bach; Quang Tran,22,0,48,26
1657895166729,CSE 30,A01,083084,Eldon; John,6,0,80,74
1657895166729,CSE 30,B01,095061,Bhaskar; Nishant,9,0,50,41
1657895172757,CSE 100,A01,083659,Cao; Yingjun,5,4,70,65
1657895178780,CSE 134B,A01,083661,Powell; Thomas Allan,24,0,100,76
1657895184805,CSE 140,A01,083663,Gungor; Onat,15,0,85,70
1657895190829,CSE 140L,A01,083088,Eldon; John,23,0,100,77
1657895196853,CSE 175,A01,083665,Kumar; Rakesh,3,0,25,22
1657895202882,CSE 190,A00,092507,Dubnov; Shlomo,8,0,20,12
1657895208904,ECE 45,A01,083139,Congero; Spencer William,6,0,75,69
1657895214927,ECE 65,A50,083695,Saad; Andrew S,12,0,30,18
1657895214927,ECE 65,A51,095125,Saad; Andrew S,24,0,26,2
1657895220955,ECE 109,A01,091882,Touri; Behrouz,20,0,70,50
1657895226977,ECE 180,A00,083140,Abi Samra; Nicholas Camill,1,0,30,29
1657895226977,ECE 180,B00,083141,Abi Samra; Nicholas Camill,0,0,30,30
1657895233003,MATH 10A,A01,083735,Patchell; Gregory David,2,0,30,28
1657895233003,MATH 10A,A02,083736,Patchell; Gregory David,20,0,30,10
1657895233003,MATH 10A,A03,083737,Patchell; Gregory David,16,0,30,14
1657895239029,MATH 10B,A01,083207,Lim; Seonhee,8,0,34,26
1657895239029,MATH 10B,A02,083208,Lim; Seonhee,10,0,35,25
1657895239029,MATH 10B,A03,093472,Lim; Seonhee,7,0,34,27
1657895239029,MATH 10B,B01,083739,Sinha; Shubham,14,0,30,16
1657895245061,MATH 18,A01,083743,Cinel; Cameron Alexander,9,0,30,21
1657895245061,MATH 18,A02,083744,Cinel; Cameron Alexander,18,0,30,12
1657895245061,MATH 18,A03,083745,Cinel; Cameron Alexander,10,0,30,20
1657895245061,MATH 18,B01,083748,Rideout; David Porter,5,0,37,32
1657895245061,MATH 18,B02,083749,Rideout; David Porter,5,0,36,31
1657895245061,MATH 18,B03,083750,Rideout; David Porter,3,0,37,34
1657895245061,MATH 18,B04,083751,Rideout; David Porter,6,0,36,30
1657895245061,MATH 18,B05,093473,Rideout; David Porter,6,0,36,30
1657895245061,MATH 18,B06,093474,Rideout; David Porter,6,0,36,30
1657895251085,MATH 20A,A01,083754,Zheng; Zequn,14,0,40,26
1657895257111,MATH 20B,A01,083756,Briones; Jor-el Thomas Caparas,4,0,36,32
1657895257111,MATH 20B,A02,083757,Briones; Jor-el Thomas Caparas,1,0,36,35
1657895257111,MATH 20B,A03,093475,Briones; Jor-el Thomas Caparas,2,0,36,34
1657895263134,MATH 20C,A01,083760,Briones; Jor-el Thomas Caparas,1,0,35,34
1657895263134,MATH 20C,A02,083761,Briones; Jor-el Thomas Caparas,8,0,35,27
1657895263134,MATH 20C,A03,093476,Briones; Jor-el Thomas Caparas,0,1,36,36
1657895263134,MATH 20C,B01,083762,Bach; Quang Tran,1,0,30,29
1657895269158,MATH 20D,A01,083765,Tran; Brian Kha,5,0,30,25
1657895269158,MATH 20D,A02,083766,Tran; Brian Kha,5,0,30,25
1657895269158,MATH 20D,A03,083767,Tran; Brian Kha,5,0,30,25
1657895275183,MATH 20E,A01,083771,Ganguly; Soumya,10,0,32,22
1657895275183,MATH 20E,A02,083772,Ganguly; Soumya,6,0,32,26
1657895275183,MATH 20E,B01,083773,Ciotti; Benjamin,20,0,35,15
1657895275183,MATH 20E,B02,083774,Ciotti; Benjamin,18,0,35,17
1657895281215,MATH 103A,A01,083777,Greenfeld; Be'Eri,3,0,36,33
1657895281215,MATH 103A,A02,083778,Greenfeld; Be'Eri,5,0,36,31
1657895281215,MATH 103A,A03,093561,Greenfeld; Be'Eri,6,0,36,30
1657895281215,MATH 103A,B01,083779,Greenfeld; Be'Eri,7,0,36,29
1657895281215,MATH 103A,B02,083780,Greenfeld; Be'Eri,4,0,36,32
1657895281215,MATH 103A,B03,093562,Greenfeld; Be'Eri,3,0,36,33
1657895287237,MATH 105,A01,085443,Carter; Anne Toulson,15,0,35,20
1657895287237,MATH 105,A02,093477,Carter; Anne Toulson,20,0,35,15
1657895293260,MATH 109,A01,083213,Ganzberger; Geoffrey Michael,3,0,34,31
1657895293260,MATH 109,A02,083214,Ganzberger; Geoffrey Michael,4,0,34,30
1657895293260,MATH 109,A03,093478,Ganzberger; Geoffrey Michael,2,0,34,32
1657895293260,MATH 109,B01,083215,Ganzberger; Geoffrey Michael,1,0,32,31
1657895293260,MATH 109,B02,083216,Ganzberger; Geoffrey Michael,2,0,32,30
1657895293260,MATH 109,B03,093479,Ganzberger; Geoffrey Michael,8,0,32,24
1657895299285,MATH 142A,A01,083219,Chow; Bennett,7,0,32,25
1657895299285,MATH 142A,A02,083220,Chow; Bennett,10,0,32,22
1657895299285,MATH 142A,A03,093480,Chow; Bennett,9,0,32,23
1657895299285,MATH 142A,B03,093481,Chow; Bennett,8,0,32,24
1657895299285,MATH 142A,B04,093558,Chow; Bennett,13,0,32,19
1657895299285,MATH 142A,B05,093559,Chow; Bennett,7,0,32,25
1657895305315,MATH 193A,A01,083224,Rotar; Vladimir,8,0,34,26
1657895305315,MATH 193A,A02,083225,Rotar; Vladimir,10,0,34,24
1657895305315,MATH 193A,A03,083781,Rotar; Vladimir,5,0,34,29
1657895305315,MATH 193A,A04,083782,Rotar; Vladimir,11,0,34,23
1657895305315,MATH 193A,A05,093482,Rotar; Vladimir,10,0,34,24
1657895311339,MATH 197,001,091859,McAuley; Julian John,9999,0,9999,0
1657895311339,MATH 197,002,095566,Kedlaya; Kiran S.,9997,0,9999,2
1657895311339,MATH 197,003,095567,Xiao; Ming,9999,0,9999,0
1657895311339,MATH 197,004,095571,Perols; Johan Lars,9998,0,9999,1
1657895318393,COGS 9,A01,083615,Shannon; Kyle Michael,10,0,75,65
1657895324416,COGS 11,A01,083617,Boyle; Mary E. T.,23,0,48,25
1657895330443,COGS 13,A01,083071,Bastos; Amalia Pinkusfeld,11,0,71,60
1657895336477,COGS 14A,A01,092681,Semenuks; Arturs,5,1,100,95
1657895342503,COGS 14B,A01,083073,Cheng; Tzu-Han,6,0,63,57
1657895348525,COGS 17,A01,092677,Semenuks; Arturs,6,0,81,75
1657895354548,COGS 100,A01,083619,Allen; Michael Gordon,17,0,70,53
1657895360572,COGS 101A,A01,083621,Davis; Joshua Daniel,9,0,68,59
1657895366600,COGS 101B,A01,091572,Allen; Michael Gordon,13,0,65,52
1657895372621,COGS 101C,A01,083625,Delgado; Tania,17,0,35,18
1657895378646,COGS 107A,A01,083627,Boyle; Mary E. T.,14,0,60,46
1657895384670,COGS 118A,A01,083075,Gupta; Anjum,21,0,76,55
1657895390693,CSE 3,A50,083646,Miranda; Gregory Joseph,24,0,50,26
1657895396715,CSE 8A,A50,083650,Miranda; Gregory Joseph,17,1,56,39
1657895402737,CSE 11,A01,083080,Cao; Yingjun,6,15,40,34
1657895408765,CSE 12,A01,083652,Krause-Levy; Sophia Louisa,30,1,120,90
1657895414791,CSE 15L,A01,083654,Morris; Justin Loren,9,0,50,41
1657895414791,CSE 15L,A02,083655,Morris; Justin Loren,10,0,50,40
1657895420816,CSE 20,A01,083657,Tran; Khoa Dang,39,0,80,41
1657895426841,CSE 21,A01,095574,Bach; Quang Tran,22,0,48,26
1657895432872,CSE 30,A01,083084,Eldon; John,6,0,80,74
1657895432872,CSE 30,B01,095061,Bhaskar; Nishant,9,0,50,41
1657895438894,CSE 100,A01,083659,Cao; Yingjun,5,4,70,65
1657895444917,CSE 134B,A01,083661,Powell; Thomas Allan,24,0,100,76
1657895450940,CSE 140,A01,083663,Gungor; Onat,15,0,85,70
1657895456966,CSE 140L,A01,083088,Eldon; John,23,0,100,77
1657895462992,CSE 175,A01,083665,Kumar; Rakesh,3,0,25,22
1657895469018,CSE 190,A00,092507,Dubnov; Shlomo,8,0,20,12
1657895475042,ECE 45,A01,083139,Congero; Spencer William,6,0,75,69
1657895481065,ECE 65,A50,083695,Saad; Andrew S,12,0,30,18
1657895481065,ECE 65,A51,095125,Saad; Andrew S,24,0,26,2
1657895487086,ECE 109,A01,091882,Touri; Behrouz,20,0,70,50
1657895493110,ECE 180,A00,083140,Abi Samra; Nicholas Camill,1,0,30,29
1657895493110,ECE 180,B00,083141,Abi Samra; Nicholas Camill,0,0,30,30
1657895499133,MATH 10A,A01,083735,Patchell; Gregory David,2,0,30,28
1657895499133,MATH 10A,A02,083736,Patchell; Gregory David,20,0,30,10
1657895499133,MATH 10A,A03,083737,Patchell; Gregory David,16,0,30,14
1657895505156,MATH 10B,A01,083207,Lim; Seonhee,8,0,34,26
1657895505156,MATH 10B,A02,083208,Lim; Seonhee,10,0,35,25
1657895505156,MATH 10B,A03,093472,Lim; Seonhee,7,0,34,27
1657895505156,MATH 10B,B01,083739,Sinha; Shubham,14,0,30,16
1657895511182,MATH 18,A01,083743,Cinel; Cameron Alexander,9,0,30,21
1657895511182,MATH 18,A02,083744,Cinel; Cameron Alexander,18,0,30,12
1657895511182,MATH 18,A03,083745,Cinel; Cameron Alexander,10,0,30,20
1657895511182,MATH 18,B01,083748,Rideout; David Porter,5,0,37,32
1657895511182,MATH 18,B02,083749,Rideout; David Porter,5,0,36,31
1657895511182,MATH 18,B03,083750,Rideout; David Porter,3,0,37,34
1657895511182,MATH 18,B04,083751,Rideout; David Porter,6,0,36,30
1657895511182,MATH 18,B05,093473,Rideout; David Porter,6,0,36,30
1657895511182,MATH 18,B06,093474,Rideout; David Porter,6,0,36,30
1657895517204,MATH 20A,A01,083754,Zheng; Zequn,14,0,40,26
1657895523226,MATH 20B,A01,083756,Briones; Jor-el Thomas Caparas,4,0,36,32
1657895523226,MATH 20B,A02,083757,Briones; Jor-el Thomas Caparas,1,0,36,35
1657895523226,MATH 20B,A03,093475,Briones; Jor-el Thomas Caparas,2,0,36,34
1657895529255,MATH 20C,A01,083760,Briones; Jor-el Thomas Caparas,1,0,35,34
1657895529255,MATH 20C,A02,083761,Briones; Jor-el Thomas Caparas,8,0,35,27
1657895529255,MATH 20C,A03,093476,Briones; Jor-el Thomas Caparas,0,1,36,36
1657895529255,MATH 20C,B01,083762,Bach; Quang Tran,1,0,30,29
1657895535279,MATH 20D,A01,083765,Tran; Brian Kha,5,0,30,25
1657895535279,MATH 20D,A02,083766,Tran; Brian Kha,5,0,30,25
1657895535279,MATH 20D,A03,083767,Tran; Brian Kha,5,0,30,25
1657895541301,MATH 20E,A01,083771,Ganguly; Soumya,10,0,32,22
1657895541301,MATH 20E,A02,083772,Ganguly; Soumya,6,0,32,26
1657895541301,MATH 20E,B01,083773,Ciotti; Benjamin,20,0,35,15
1657895541301,MATH 20E,B02,083774,Ciotti; Benjamin,18,0,35,17
1657895547326,MATH 103A,A01,083777,Greenfeld; Be'Eri,3,0,36,33
1657895547326,MATH 103A,A02,083778,Greenfeld; Be'Eri,5,0,36,31
1657895547326,MATH 103A,A03,093561,Greenfeld; Be'Eri,6,0,36,30
1657895547326,MATH 103A,B01,083779,Greenfeld; Be'Eri,7,0,36,29
1657895547326,MATH 103A,B02,083780,Greenfeld; Be'Eri,4,0,36,32
1657895547326,MATH 103A,B03,093562,Greenfeld; Be'Eri,3,0,36,33
1657895553360,MATH 105,A01,085443,Carter; Anne Toulson,15,0,35,20
1657895553360,MATH 105,A02,093477,Carter; Anne Toulson,20,0,35,15
1657895559389,MATH 109,A01,083213,Ganzberger; Geoffrey Michael,3,0,34,31
1657895559389,MATH 109,A02,083214,Ganzberger; Geoffrey Michael,4,0,34,30
1657895559389,MATH 109,A03,093478,Ganzberger; Geoffrey Michael,2,0,34,32
1657895559389,MATH 109,B01,083215,Ganzberger; Geoffrey Michael,1,0,32,31
1657895559389,MATH 109,B02,083216,Ganzberger; Geoffrey Michael,2,0,32,30
1657895559389,MATH 109,B03,093479,Ganzberger; Geoffrey Michael,8,0,32,24
1657895565419,MATH 142A,A01,083219,Chow; Bennett,7,0,32,25
1657895565419,MATH 142A,A02,083220,Chow; Bennett,10,0,32,22
1657895565419,MATH 142A,A03,093480,Chow; Bennett,9,0,32,23
1657895565419,MATH 142A,B03,093481,Chow; Bennett,8,0,32,24
1657895565419,MATH 142A,B04,093558,Chow; Bennett,13,0,32,19
1657895565419,MATH 142A,B05,093559,Chow; Bennett,7,0,32,25
1657895571443,MATH 193A,A01,083224,Rotar; Vladimir,8,0,34,26
1657895571443,MATH 193A,A02,083225,Rotar; Vladimir,10,0,34,24
1657895571443,MATH 193A,A03,083781,Rotar; Vladimir,5,0,34,29
1657895571443,MATH 193A,A04,083782,Rotar; Vladimir,11,0,34,23
1657895571443,MATH 193A,A05,093482,Rotar; Vladimir,10,0,34,24
1657895577466,MATH 197,001,091859,McAuley; Julian John,9999,0,9999,0
1657895577466,MATH 197,002,095566,Kedlaya; Kiran S.,9997,0,9999,2
1657895577466,MATH 197,003,095567,Xiao; Ming,9999,0,9999,0
1657895577466,MATH 197,004,095571,Perols; Johan Lars,9998,0,9999,1
1657895584518,COGS 9,A01,083615,Shannon; Kyle Michael,10,0,75,65
1657895590543,COGS 11,A01,083617,Boyle; Mary E. T.,23,0,48,25
1657895596568,COGS 13,A01,083071,Bastos; Amalia Pinkusfeld,11,0,71,60
1657895602591,COGS 14A,A01,092681,Semenuks; Arturs,5,1,100,95
1657895608614,COGS 14B,A01,083073,Cheng; Tzu-Han,6,0,63,57
1657895614647,COGS 17,A01,092677,Semenuks; Arturs,6,0,81,75
1657895620672,COGS 100,A01,083619,Allen; Michael Gordon,17,0,70,53
1657895626694,COGS 101A,A01,083621,Davis; Joshua Daniel,9,0,68,59
1657895632726,COGS 101B,A01,091572,Allen; Michael Gordon,13,0,65,52
1657895638751,COGS 101C,A01,083625,Delgado; Tania,17,0,35,18
1657895644780,COGS 107A,A01,083627,Boyle; Mary E. T.,14,0,60,46
1657895650805,COGS 118A,A01,083075,Gupta; Anjum,21,0,76,55
1657895656830,CSE 3,A50,083646,Miranda; Gregory Joseph,24,0,50,26
1657895662858,CSE 8A,A50,083650,Miranda; Gregory Joseph,17,1,56,39
1657895668883,CSE 11,A01,083080,Cao; Yingjun,6,15,40,34
1657895674913,CSE 12,A01,083652,Krause-Levy; Sophia Louisa,30,1,120,90
1657895680947,CSE 15L,A01,083654,Morris; Justin Loren,9,0,50,41
1657895680947,CSE 15L,A02,083655,Morris; Justin Loren,10,0,50,40
1657895686971,CSE 20,A01,083657,Tran; Khoa Dang,39,0,80,41
1657895692995,CSE 21,A01,095574,Bach; Quang Tran,22,0,48,26
1657895699017,CSE 30,A01,083084,Eldon; John,6,0,80,74
1657895699017,CSE 30,B01,095061,Bhaskar; Nishant,9,0,50,41
1657895705042,CSE 100,A01,083659,Cao; Yingjun,5,4,70,65
1657895711068,CSE 134B,A01,083661,Powell; Thomas Allan,24,0,100,76
1657895717093,CSE 140,A01,083663,Gungor; Onat,15,0,85,70
1657895723120,CSE 140L,A01,083088,Eldon; John,23,0,100,77
1657895729144,CSE 175,A01,083665,Kumar; Rakesh,3,0,25,22
1657895735240,CSE 190,A00,092507,Dubnov; Shlomo,8,0,20,12
1657895741262,ECE 45,A01,083139,Congero; Spencer William,6,0,75,69
1657895747284,ECE 65,A50,083695,Saad; Andrew S,12,0,30,18
1657895747284,ECE 65,A51,095125,Saad; Andrew S,24,0,26,2
1657895753308,ECE 109,A01,091882,Touri; Behrouz,20,0,70,50
1657895759333,ECE 180,A00,083140,Abi Samra; Nicholas Camill,1,0,30,29
1657895759333,ECE 180,B00,083141,Abi Samra; Nicholas Camill,0,0,30,30
1657895765357,MATH 10A,A01,083735,Patchell; Gregory David,2,0,30,28
1657895765357,MATH 10A,A02,083736,Patchell; Gregory David,20,0,30,10
1657895765357,MATH 10A,A03,083737,Patchell; Gregory David,16,0,30,14
1657895771384,MATH 10B,A01,083207,Lim; Seonhee,8,0,34,26
1657895771384,MATH 10B,A02,083208,Lim; Seonhee,10,0,35,25
1657895771384,MATH 10B,A03,093472,Lim; Seonhee,7,0,34,27
1657895771384,MATH 10B,B01,083739,Sinha; Shubham,14,0,30,16
1657895777414,MATH 18,A01,083743,Cinel; Cameron Alexander,9,0,30,21
1657895777414,MATH 18,A02,083744,Cinel; Cameron Alexander,18,0,30,12
1657895777414,MATH 18,A03,083745,Cinel; Cameron Alexander,10,0,30,20
1657895777414,MATH 18,B01,083748,Rideout; David Porter,5,0,37,32
1657895777414,MATH 18,B02,083749,Rideout; David Porter,5,0,36,31
1657895777414,MATH 18,B03,083750,Rideout; David Porter,3,0,37,34
1657895777414,MATH 18,B04,083751,Rideout; David Porter,6,0,36,30
1657895777414,MATH 18,B05,093473,Rideout; David Porter,6,0,36,30
1657895777414,MATH 18,B06,093474,Rideout; David Porter,6,0,36,30
1657895783437,MATH 20A,A01,083754,Zheng; Zequn,14,0,40,26
1657895789461,MATH 20B,A01,083756,Briones; Jor-el Thomas Caparas,4,0,36,32
1657895789461,MATH 20B,A02,083757,Briones; Jor-el Thomas Caparas,1,0,36,35
1657895789461,MATH 20B,A03,093475,Briones; Jor-el Thomas Caparas,2,0,36,34
1657895795486,MATH 20C,A01,083760,Briones; Jor-el Thomas Caparas,1,0,35,34
1657895795486,MATH 20C,A02,083761,Briones; Jor-el Thomas Caparas,8,0,35,27
1657895795486,MATH 20C,A03,093476,Briones; Jor-el Thomas Caparas,0,1,36,36
1657895795486,MATH 20C,B01,083762,Bach; Quang Tran,1,0,30,29
1657895801510,MATH 20D,A01,083765,Tran; Brian Kha,5,0,30,25
1657895801510,MATH 20D,A02,083766,Tran; Brian Kha,5,0,30,25
1657895801510,MATH 20D,A03,083767,Tran; Brian Kha,5,0,30,25
1657895807535,MATH 20E,A01,083771,Ganguly; Soumya,10,0,32,22
1657895807535,MATH 20E,A02,083772,Ganguly; Soumya,6,0,32,26
1657895807535,MATH 20E,B01,083773,Ciotti; Benjamin,20,0,35,15
1657895807535,MATH 20E,B02,083774,Ciotti; Benjamin,18,0,35,17
1657895813566,MATH 103A,A01,083777,Greenfeld; Be'Eri,3,0,36,33
1657895813566,MATH 103A,A02,083778,Greenfeld; Be'Eri,5,0,36,31
1657895813566,MATH 103A,A03,093561,Greenfeld; Be'Eri,6,0,36,30
1657895813566,MATH 103A,B01,083779,Greenfeld; Be'Eri,7,0,36,29
1657895813566,MATH 103A,B02,083780,Greenfeld; Be'Eri,4,0,36,32
1657895813566,MATH 103A,B03,093562,Greenfeld; Be'Eri,3,0,36,33
1657895819606,MATH 105,A01,085443,Carter; Anne Toulson,15,0,35,20
1657895819606,MATH 105,A02,093477,Carter; Anne Toulson,20,0,35,15
1657895825630,MATH 109,A01,083213,Ganzberger; Geoffrey Michael,3,0,34,31
1657895825630,MATH 109,A02,083214,Ganzberger; Geoffrey Michael,4,0,34,30
1657895825630,MATH 109,A03,093478,Ganzberger; Geoffrey Michael,2,0,34,32
1657895825630,MATH 109,B01,083215,Ganzberger; Geoffrey Michael,1,0,32,31
1657895825630,MATH 109,B02,083216,Ganzberger; Geoffrey Michael,2,0,32,30
1657895825630,MATH 109,B03,093479,Ganzberger; Geoffrey Michael,8,0,32,24
1657895831660,MATH 142A,A01,083219,Chow; Bennett,7,0,32,25
1657895831660,MATH 142A,A02,083220,Chow; Bennett,10,0,32,22
1657895831660,MATH 142A,A03,093480,Chow; Bennett,9,0,32,23
1657895831660,MATH 142A,B03,093481,Chow; Bennett,8,0,32,24
1657895831660,MATH 142A,B04,093558,Chow; Bennett,13,0,32,19
1657895831660,MATH 142A,B05,093559,Chow; Bennett,7,0,32,25
1657895837688,MATH 193A,A01,083224,Rotar; Vladimir,8,0,34,26
1657895837688,MATH 193A,A02,083225,Rotar; Vladimir,10,0,34,24
1657895837688,MATH 193A,A03,083781,Rotar; Vladimir,5,0,34,29
1657895837688,MATH 193A,A04,083782,Rotar; Vladimir,11,0,34,23
1657895837688,MATH 193A,A05,093482,Rotar; Vladimir,10,0,34,24
1657895843722,MATH 197,001,091859,McAuley; Julian John,9999,0,9999,0
1657895843722,MATH 197,002,095566,Kedlaya; Kiran S.,9997,0,9999,2
1657895843722,MATH 197,003,095567,Xiao; Ming,9999,0,9999,0
1657895843722,MATH 197,004,095571,Perols; Johan Lars,9998,0,9999,1
1657895850792,COGS 9,A01,083615,Shannon; Kyle Michael,10,0,75,65
1657895856840,COGS 11,A01,083617,Boyle; Mary E. T.,23,0,48,25
1657895862868,COGS 13,A01,083071,Bastos; Amalia Pinkusfeld,11,0,71,60
1657895868899,COGS 14A,A01,092681,Semenuks; Arturs,5,1,100,95
1657895874923,COGS 14B,A01,083073,Cheng; Tzu-Han,6,0,63,57
1657895880948,COGS 17,A01,092677,Semenuks; Arturs,6,0,81,75
1657895886971,COGS 100,A01,083619,Allen; Michael Gordon,17,0,70,53
1657895892994,COGS 101A,A01,083621,Davis; Joshua Daniel,9,0,68,59
1657895899020,COGS 101B,A01,091572,Allen; Michael Gordon,13,0,65,52
1657895905044,COGS 101C,A01,083625,Delgado; Tania,17,0,35,18
1657895911071,COGS 107A,A01,083627,Boyle; Mary E. T.,14,0,60,46
1657895917095,COGS 118A,A01,083075,Gupta; Anjum,21,0,76,55
1657895923119,CSE 3,A50,083646,Miranda; Gregory Joseph,24,0,50,26
1657895929141,CSE 8A,A50,083650,Miranda; Gregory Joseph,17,1,56,39
1657895935167,CSE 11,A01,083080,Cao; Yingjun,6,15,40,34
1657895941197,CSE 12,A01,083652,Krause-Levy; Sophia Louisa,30,1,120,90
1657895947225,CSE 15L,A01,083654,Morris; Justin Loren,9,0,50,41
1657895947225,CSE 15L,A02,083655,Morris; Justin Loren,10,0,50,40
1657895953252,CSE 20,A01,083657,Tran; Khoa Dang,39,0,80,41
1657895959278,CSE 21,A01,095574,Bach; Quang Tran,22,0,48,26
1657895965306,CSE 30,A01,083084,Eldon; John,6,0,80,74
1657895965306,CSE 30,B01,095061,Bhaskar; Nishant,9,0,50,41
1657895971330,CSE 100,A01,083659,Cao; Yingjun,5,4,70,65
1657895977355,CSE 134B,A01,083661,Powell; Thomas Allan,24,0,100,76
1657895983378,CSE 140,A01,083663,Gungor; Onat,15,0,85,70
1657895989402,CSE 140L,A01,083088,Eldon; John,23,0,100,77
1657895995427,CSE 175,A01,083665,Kumar; Rakesh,3,0,25,22
1657896001464,CSE 190,A00,092507,Dubnov; Shlomo,8,0,20,12
1657896007489,ECE 45,A01,083139,Congero; Spencer William,6,0,75,69
1657896013513,ECE 65,A50,083695,Saad; Andrew S,12,0,30,18
1657896013513,ECE 65,A51,095125,Saad; Andrew S,24,0,26,2
1657896019537,ECE 109,A01,091882,Touri; Behrouz,20,0,70,50
1657896025559,ECE 180,A00,083140,Abi Samra; Nicholas Camill,1,0,30,29
1657896025559,ECE 180,B00,083141,Abi Samra; Nicholas Camill,0,0,30,30
1657896031584,MATH 10A,A01,083735,Patchell; Gregory David,2,0,30,28
1657896031584,MATH 10A,A02,083736,Patchell; Gregory David,20,0,30,10
1657896031584,MATH 10A,A03,083737,Patchell; Gregory David,16,0,30,14
1657896037611,MATH 10B,A01,083207,Lim; Seonhee,8,0,34,26
1657896037611,MATH 10B,A02,083208,Lim; Seonhee,10,0,35,25
1657896037611,MATH 10B,A03,093472,Lim; Seonhee,7,0,34,27
1657896037611,MATH 10B,B01,083739,Sinha; Shubham,14,0,30,16
1657896043634,MATH 18,A01,083743,Cinel; Cameron Alexander,9,0,30,21
1657896043634,MATH 18,A02,083744,Cinel; Cameron Alexander,18,0,30,12
1657896043634,MATH 18,A03,083745,Cinel; Cameron Alexander,10,0,30,20
1657896043634,MATH 18,B01,083748,Rideout; David Porter,5,0,37,32
1657896043634,MATH 18,B02,083749,Rideout; David Porter,5,0,36,31
1657896043634,MATH 18,B03,083750,Rideout; David Porter,3,0,37,34
1657896043634,MATH 18,B04,083751,Rideout; David Porter,6,0,36,30
1657896043634,MATH 18,B05,093473,Rideout; David Porter,6,0,36,30
1657896043634,MATH 18,B06,093474,Rideout; David Porter,6,0,36,30
1657896049657,MATH 20A,A01,083754,Zheng; Zequn,14,0,40,26
1657896055681,MATH 20B,A01,083756,Briones; Jor-el Thomas Caparas,4,0,36,32
1657896055681,MATH 20B,A02,083757,Briones; Jor-el Thomas Caparas,1,0,36,35
1657896055681,MATH 20B,A03,093475,Briones; Jor-el Thomas Caparas,2,0,36,34
1657896061709,MATH 20C,A01,083760,Briones; Jor-el Thomas Caparas,1,0,35,34
1657896061709,MATH 20C,A02,083761,Briones; Jor-el Thomas Caparas,8,0,35,27
1657896061709,MATH 20C,A03,093476,Briones; Jor-el Thomas Caparas,0,1,36,36
1657896061709,MATH 20C,B01,083762,Bach; Quang Tran,1,0,30,29
1657896067733,MATH 20D,A01,083765,Tran; Brian Kha,5,0,30,25
1657896067733,MATH 20D,A02,083766,Tran; Brian Kha,5,0,30,25
1657896067733,MATH 20D,A03,083767,Tran; Brian Kha,5,0,30,25
1657896074280,MATH 20E,A01,083771,Ganguly; Soumya,10,0,32,22
1657896074280,MATH 20E,A02,083772,Ganguly; Soumya,6,0,32,26
1657896074280,MATH 20E,B01,083773,Ciotti; Benjamin,20,0,35,15
1657896074280,MATH 20E,B02,083774,Ciotti; Benjamin,18,0,35,17
1657896080310,MATH 103A,A01,083777,Greenfeld; Be'Eri,3,0,36,33
1657896080310,MATH 103A,A02,083778,Greenfeld; Be'Eri,5,0,36,31
1657896080310,MATH 103A,A03,093561,Greenfeld; Be'Eri,6,0,36,30
1657896080310,MATH 103A,B01,083779,Greenfeld; Be'Eri,7,0,36,29
1657896080310,MATH 103A,B02,083780,Greenfeld; Be'Eri,4,0,36,32
1657896080310,MATH 103A,B03,093562,Greenfeld; Be'Eri,3,0,36,33
1657896086336,MATH 105,A01,085443,Carter; Anne Toulson,15,0,35,20
1657896086336,MATH 105,A02,093477,Carter; Anne Toulson,20,0,35,15
1657896092362,MATH 109,A01,083213,Ganzberger; Geoffrey Michael,3,0,34,31
1657896092362,MATH 109,A02,083214,Ganzberger; Geoffrey Michael,4,0,34,30
1657896092362,MATH 109,A03,093478,Ganzberger; Geoffrey Michael,2,0,34,32
1657896092362,MATH 109,B01,083215,Ganzberger; Geoffrey Michael,1,0,32,31
1657896092362,MATH 109,B02,083216,Ganzberger; Geoffrey Michael,2,0,32,30
1657896092362,MATH 109,B03,093479,Ganzberger; Geoffrey Michael,8,0,32,24
1657896098391,MATH 142A,A01,083219,Chow; Bennett,7,0,32,25
1657896098391,MATH 142A,A02,083220,Chow; Bennett,10,0,32,22
1657896098391,MATH 142A,A03,093480,Chow; Bennett,9,0,32,23
1657896098391,MATH 142A,B03,093481,Chow; Bennett,8,0,32,24
1657896098391,MATH 142A,B04,093558,Chow; Bennett,13,0,32,19
1657896098391,MATH 142A,B05,093559,Chow; Bennett,7,0,32,25
1657896104414,MATH 193A,A01,083224,Rotar; Vladimir,8,0,34,26
1657896104414,MATH 193A,A02,083225,Rotar; Vladimir,10,0,34,24
1657896104414,MATH 193A,A03,083781,Rotar; Vladimir,5,0,34,29
1657896104414,MATH 193A,A04,083782,Rotar; Vladimir,11,0,34,23
1657896104414,MATH 193A,A05,093482,Rotar; Vladimir,10,0,34,24
1657896110441,MATH 197,001,091859,McAuley; Julian John,9999,0,9999,0
1657896110441,MATH 197,002,095566,Kedlaya; Kiran S.,9997,0,9999,2
1657896110441,MATH 197,003,095567,Xiao; Ming,9999,0,9999,0
1657896110441,MATH 197,004,095571,Perols; Johan Lars,9998,0,9999,1
1657896117503,COGS 9,A01,083615,Shannon; Kyle Michael,10,0,75,65
1657896123535,COGS 11,A01,083617,Boyle; Mary E. T.,23,0,48,25
1657896129563,COGS 13,A01,083071,Bastos; Amalia Pinkusfeld,11,0,71,60
1657896135586,COGS 14A,A01,092681,Semenuks; Arturs,5,1,100,95
1657896141614,COGS 14B,A01,083073,Cheng; Tzu-Han,6,0,63,57
1657896147641,COGS 17,A01,092677,Semenuks; Arturs,6,0,81,75
1657896153719,COGS 100,A01,083619,Allen; Michael Gordon,17,0,70,53
1657896159742,COGS 101A,A01,083621,Davis; Joshua Daniel,9,0,68,59
1657896165768,COGS 101B,A01,091572,Allen; Michael Gordon,13,0,65,52
1657896171795,COGS 101C,A01,083625,Delgado; Tania,17,0,35,18
1657896177826,COGS 107A,A01,083627,Boyle; Mary E. T.,14,0,60,46
1657896183850,COGS 118A,A01,083075,Gupta; Anjum,21,0,76,55
1657896189879,CSE 3,A50,083646,Miranda; Gregory Joseph,24,0,50,26
1657896195904,CSE 8A,A50,083650,Miranda; Gregory Joseph,17,1,56,39
1657896201927,CSE 11,A01,083080,Cao; Yingjun,6,15,40,34
1657896207955,CSE 12,A01,083652,Krause-Levy; Sophia Louisa,30,1,120,90
1657896213986,CSE 15L,A01,083654,Morris; Justin Loren,9,0,50,41
1657896213986,CSE 15L,A02,083655,Morris; Justin Loren,10,0,50,40
1657896220009,CSE 20,A01,083657,Tran; Khoa Dang,39,0,80,41
1657896226038,CSE 21,A01,095574,Bach; Quang Tran,22,0,48,26
1657896232066,CSE 30,A01,083084,Eldon; John,6,0,80,74
1657896232066,CSE 30,B01,095061,Bhaskar; Nishant,9,0,50,41
1657896238092,CSE 100,A01,083659,Cao; Yingjun,5,4,70,65
1657896244115,CSE 134B,A01,083661,Powell; Thomas Allan,24,0,100,76
1657896250139,CSE 140,A01,083663,Gungor; Onat,15,0,85,70
1657896256167,CSE 140L,A01,083088,Eldon; John,23,0,100,77
1657896262194,CSE 175,A01,083665,Kumar; Rakesh,3,0,25,22
1657896268216,CSE 190,A00,092507,Dubnov; Shlomo,8,0,20,12
1657896275810,ECE 45,A01,083139,Congero; Spencer William,6,0,75,69
1657896281838,ECE 65,A50,083695,Saad; Andrew S,12,0,30,18
1657896281838,ECE 65,A51,095125,Saad; Andrew S,24,0,26,2
1657896287866,ECE 109,A01,091882,Touri; Behrouz,20,0,70,50
1657896293893,ECE 180,A00,083140,Abi Samra; Nicholas Camill,1,0,30,29
1657896293893,ECE 180,B00,083141,Abi Samra; Nicholas Camill,0,0,30,30
1657896299922,MATH 10A,A01,083735,Patchell; Gregory David,2,0,30,28
1657896299922,MATH 10A,A02,083736,Patchell; Gregory David,20,0,30,10
1657896299922,MATH 10A,A03,083737,Patchell; Gregory David,16,0,30,14
1657896305951,MATH 10B,A01,083207,Lim; Seonhee,8,0,34,26
1657896305951,MATH 10B,A02,083208,Lim; Seonhee,10,0,35,25
1657896305951,MATH 10B,A03,093472,Lim; Seonhee,7,0,34,27
1657896305951,MATH 10B,B01,083739,Sinha; Shubham,14,0,30,16
1657896311975,MATH 18,A01,083743,Cinel; Cameron Alexander,9,0,30,21
1657896311975,MATH 18,A02,083744,Cinel; Cameron Alexander,18,0,30,12
1657896311975,MATH 18,A03,083745,Cinel; Cameron Alexander,10,0,30,20
1657896311975,MATH 18,B01,083748,Rideout; David Porter,5,0,37,32
1657896311975,MATH 18,B02,083749,Rideout; David Porter,5,0,36,31
1657896311975,MATH 18,B03,083750,Rideout; David Porter,3,0,37,34
1657896311975,MATH 18,B04,083751,Rideout; David Porter,6,0,36,30
1657896311975,MATH 18,B05,093473,Rideout; David Porter,6,0,36,30
1657896311975,MATH 18,B06,093474,Rideout; David Porter,6,0,36,30
1657896318001,MATH 20A,A01,083754,Zheng; Zequn,14,0,40,26
1657896324028,MATH 20B,A01,083756,Briones; Jor-el Thomas Caparas,4,0,36,32
1657896324028,MATH 20B,A02,083757,Briones; Jor-el Thomas Caparas,1,0,36,35
1657896324028,MATH 20B,A03,093475,Briones; Jor-el Thomas Caparas,2,0,36,34
1657896330053,MATH 20C,A01,083760,Briones; Jor-el Thomas Caparas,1,0,35,34
1657896330053,MATH 20C,A02,083761,Briones; Jor-el Thomas Caparas,8,0,35,27
1657896330053,MATH 20C,A03,093476,Briones; Jor-el Thomas Caparas,0,1,36,36
1657896330053,MATH 20C,B01,083762,Bach; Quang Tran,1,0,30,29
1657896336174,MATH 20D,A01,083765,Tran; Brian Kha,5,0,30,25
1657896336174,MATH 20D,A02,083766,Tran; Brian Kha,5,0,30,25
1657896336174,MATH 20D,A03,083767,Tran; Brian Kha,5,0,30,25
1657896342198,MATH 20E,A01,083771,Ganguly; Soumya,10,0,32,22
1657896342198,MATH 20E,A02,083772,Ganguly; Soumya,6,0,32,26
1657896342198,MATH 20E,B01,083773,Ciotti; Benjamin,20,0,35,15
1657896342198,MATH 20E,B02,083774,Ciotti; Benjamin,18,0,35,17
1657896348227,MATH 103A,A01,083777,Greenfeld; Be'Eri,3,0,36,33
1657896348227,MATH 103A,A02,083778,Greenfeld; Be'Eri,5,0,36,31
1657896348227,MATH 103A,A03,093561,Greenfeld; Be'Eri,6,0,36,30
1657896348227,MATH 103A,B01,083779,Greenfeld; Be'Eri,7,0,36,29
1657896348227,MATH 103A,B02,083780,Greenfeld; Be'Eri,4,0,36,32
1657896348227,MATH 103A,B03,093562,Greenfeld; Be'Eri,3,0,36,33
1657896354254,MATH 105,A01,085443,Carter; Anne Toulson,15,0,35,20
1657896354254,MATH 105,A02,093477,Carter; Anne Toulson,20,0,35,15
1657896360284,MATH 109,A01,083213,Ganzberger; Geoffrey Michael,3,0,34,31
1657896360284,MATH 109,A02,083214,Ganzberger; Geoffrey Michael,4,0,34,30
1657896360284,MATH 109,A03,093478,Ganzberger; Geoffrey Michael,2,0,34,32
1657896360284,MATH 109,B01,083215,Ganzberger; Geoffrey Michael,2,0,32,30
1657896360284,MATH 109,B02,083216,Ganzberger; Geoffrey Michael,2,0,32,30
1657896360284,MATH 109,B03,093479,Ganzberger; Geoffrey Michael,8,0,32,24
1657896366313,MATH 142A,A01,083219,Chow; Bennett,7,0,32,25
1657896366313,MATH 142A,A02,083220,Chow; Bennett,10,0,32,22
1657896366313,MATH 142A,A03,093480,Chow; Bennett,9,0,32,23
1657896366313,MATH 142A,B03,093481,Chow; Bennett,8,0,32,24
1657896366313,MATH 142A,B04,093558,Chow; Bennett,13,0,32,19
1657896366313,MATH 142A,B05,093559,Chow; Bennett,7,0,32,25
1657896372339,MATH 193A,A01,083224,Rotar; Vladimir,8,0,34,26
1657896372339,MATH 193A,A02,083225,Rotar; Vladimir,10,0,34,24
1657896372339,MATH 193A,A03,083781,Rotar; Vladimir,5,0,34,29
1657896372339,MATH 193A,A04,083782,Rotar; Vladimir,11,0,34,23
1657896372339,MATH 193A,A05,093482,Rotar; Vladimir,10,0,34,24
1657896378368,MATH 197,001,091859,McAuley; Julian John,9999,0,9999,0
1657896378368,MATH 197,002,095566,Kedlaya; Kiran S.,9997,0,9999,2
1657896378368,MATH 197,003,095567,Xiao; Ming,9999,0,9999,0
1657896378368,MATH 197,004,095571,Perols; Johan Lars,9998,0,9999,1
1657896385424,COGS 9,A01,083615,Shannon; Kyle Michael,10,0,75,65
1657896391449,COGS 11,A01,083617,Boyle; Mary E. T.,23,0,48,25
1657896397476,COGS 13,A01,083071,Bastos; Amalia Pinkusfeld,11,0,71,60
1657896403505,COGS 14A,A01,092681,Semenuks; Arturs,5,1,100,95
1657896409529,COGS 14B,A01,083073,Cheng; Tzu-Han,6,0,63,57
1657896415552,COGS 17,A01,092677,Semenuks; Arturs,6,0,81,75
1657896421584,COGS 100,A01,083619,Allen; Michael Gordon,17,0,70,53
1657896427609,COGS 101A,A01,083621,Davis; Joshua Daniel,9,0,68,59
1657896433635,COGS 101B,A01,091572,Allen; Michael Gordon,13,0,65,52
1657896439666,COGS 101C,A01,083625,Delgado; Tania,17,0,35,18
1657896445691,COGS 107A,A01,083627,Boyle; Mary E. T.,14,0,60,46
1657896451713,COGS 118A,A01,083075,Gupta; Anjum,21,0,76,55
1657896457735,CSE 3,A50,083646,Miranda; Gregory Joseph,24,0,50,26
1657896463771,CSE 8A,A50,083650,Miranda; Gregory Joseph,17,1,56,39
1657896469796,CSE 11,A01,083080,Cao; Yingjun,6,15,40,34
1657896475818,CSE 12,A01,083652,Krause-Levy; Sophia Louisa,30,1,120,90
1657896481840,CSE 15L,A01,083654,Morris; Justin Loren,9,0,50,41
1657896481840,CSE 15L,A02,083655,Morris; Justin Loren,10,0,50,40
1657896487865,CSE 20,A01,083657,Tran; Khoa Dang,39,0,80,41
1657896493892,CSE 21,A01,095574,Bach; Quang Tran,22,0,48,26
1657896499914,CSE 30,A01,083084,Eldon; John,6,0,80,74
1657896499914,CSE 30,B01,095061,Bhaskar; Nishant,9,0,50,41
1657896505941,CSE 100,A01,083659,Cao; Yingjun,5,4,70,65
1657896511967,CSE 134B,A01,083661,Powell; Thomas Allan,24,0,100,76
1657896517991,CSE 140,A01,083663,Gungor; Onat,15,0,85,70
1657896524020,CSE 140L,A01,083088,Eldon; John,23,0,100,77
1657896530043,CSE 175,A01,083665,Kumar; Rakesh,3,0,25,22
1657896536068,CSE 190,A00,092507,Dubnov; Shlomo,8,0,20,12
1657896542092,ECE 45,A01,083139,Congero; Spencer William,6,0,75,69
1657896548122,ECE 65,A50,083695,Saad; Andrew S,12,0,30,18
1657896548122,ECE 65,A51,095125,Saad; Andrew S,24,0,26,2
1657896554146,ECE 109,A01,091882,Touri; Behrouz,20,0,70,50
1657896560169,ECE 180,A00,083140,Abi Samra; Nicholas Camill,1,0,30,29
1657896560169,ECE 180,B00,083141,Abi Samra; Nicholas Camill,0,0,30,30
1657896566194,MATH 10A,A01,083735,Patchell; Gregory David,2,0,30,28
1657896566194,MATH 10A,A02,083736,Patchell; Gregory David,20,0,30,10
1657896566194,MATH 10A,A03,083737,Patchell; Gregory David,16,0,30,14
1657896572218,MATH 10B,A01,083207,Lim; Seonhee,8,0,34,26
1657896572218,MATH 10B,A02,083208,Lim; Seonhee,10,0,35,25
1657896572218,MATH 10B,A03,093472,Lim; Seonhee,7,0,34,27
1657896572218,MATH 10B,B01,083739,Sinha; Shubham,14,0,30,16
1657896578249,MATH 18,A01,083743,Cinel; Cameron Alexander,9,0,30,21
1657896578249,MATH 18,A02,083744,Cinel; Cameron Alexander,18,0,30,12
1657896578249,MATH 18,A03,083745,Cinel; Cameron Alexander,10,0,30,20
1657896578249,MATH 18,B01,083748,Rideout; David Porter,5,0,37,32
1657896578249,MATH 18,B02,083749,Rideout; David Porter,5,0,36,31
1657896578249,MATH 18,B03,083750,Rideout; David Porter,3,0,37,34
1657896578249,MATH 18,B04,083751,Rideout; David Porter,6,0,36,30
1657896578249,MATH 18,B05,093473,Rideout; David Porter,6,0,36,30
1657896578249,MATH 18,B06,093474,Rideout; David Porter,6,0,36,30
1657896584275,MATH 20A,A01,083754,Zheng; Zequn,14,0,40,26
1657896590301,MATH 20B,A01,083756,Briones; Jor-el Thomas Caparas,4,0,36,32
1657896590301,MATH 20B,A02,083757,Briones; Jor-el Thomas Caparas,1,0,36,35
1657896590301,MATH 20B,A03,093475,Briones; Jor-el Thomas Caparas,2,0,36,34
1657896596324,MATH 20C,A01,083760,Briones; Jor-el Thomas Caparas,1,0,35,34
1657896596324,MATH 20C,A02,083761,Briones; Jor-el Thomas Caparas,8,0,35,27
1657896596324,MATH 20C,A03,093476,Briones; Jor-el Thomas Caparas,0,1,36,36
1657896596324,MATH 20C,B01,083762,Bach; Quang Tran,1,0,30,29
1657896602347,MATH 20D,A01,083765,Tran; Brian Kha,5,0,30,25
1657896602347,MATH 20D,A02,083766,Tran; Brian Kha,5,0,30,25
1657896602347,MATH 20D,A03,083767,Tran; Brian Kha,5,0,30,25
1657896608376,MATH 20E,A01,083771,Ganguly; Soumya,10,0,32,22
1657896608376,MATH 20E,A02,083772,Ganguly; Soumya,6,0,32,26
1657896608376,MATH 20E,B01,083773,Ciotti; Benjamin,20,0,35,15
1657896608376,MATH 20E,B02,083774,Ciotti; Benjamin,18,0,35,17
1657896614404,MATH 103A,A01,083777,Greenfeld; Be'Eri,3,0,36,33
1657896614404,MATH 103A,A02,083778,Greenfeld; Be'Eri,5,0,36,31
1657896614404,MATH 103A,A03,093561,Greenfeld; Be'Eri,6,0,36,30
1657896614404,MATH 103A,B01,083779,Greenfeld; Be'Eri,7,0,36,29
1657896614404,MATH 103A,B02,083780,Greenfeld; Be'Eri,4,0,36,32
1657896614404,MATH 103A,B03,093562,Greenfeld; Be'Eri,3,0,36,33
1657896620435,MATH 105,A01,085443,Carter; Anne Toulson,15,0,35,20
1657896620435,MATH 105,A02,093477,Carter; Anne Toulson,20,0,35,15
1657896626459,MATH 109,A01,083213,Ganzberger; Geoffrey Michael,3,0,34,31
1657896626459,MATH 109,A02,083214,Ganzberger; Geoffrey Michael,4,0,34,30
1657896626459,MATH 109,A03,093478,Ganzberger; Geoffrey Michael,2,0,34,32
1657896626459,MATH 109,B01,083215,Ganzberger; Geoffrey Michael,2,0,32,30
1657896626459,MATH 109,B02,083216,Ganzberger; Geoffrey Michael,2,0,32,30
1657896626459,MATH 109,B03,093479,Ganzberger; Geoffrey Michael,8,0,32,24
1657896632485,MATH 142A,A01,083219,Chow; Bennett,7,0,32,25
1657896632485,MATH 142A,A02,083220,Chow; Bennett,10,0,32,22
1657896632485,MATH 142A,A03,093480,Chow; Bennett,9,0,32,23
1657896632485,MATH 142A,B03,093481,Chow; Bennett,8,0,32,24
1657896632485,MATH 142A,B04,093558,Chow; Bennett,13,0,32,19
1657896632485,MATH 142A,B05,093559,Chow; Bennett,7,0,32,25
1657896638510,MATH 193A,A01,083224,Rotar; Vladimir,8,0,34,26
1657896638510,MATH 193A,A02,083225,Rotar; Vladimir,10,0,34,24
1657896638510,MATH 193A,A03,083781,Rotar; Vladimir,5,0,34,29
1657896638510,MATH 193A,A04,083782,Rotar; Vladimir,11,0,34,23
1657896638510,MATH 193A,A05,093482,Rotar; Vladimir,10,0,34,24
1657896644534,MATH 197,001,091859,McAuley; Julian John,9999,0,9999,0
1657896644534,MATH 197,002,095566,Kedlaya; Kiran S.,9997,0,9999,2
1657896644534,MATH 197,003,095567,Xiao; Ming,9999,0,9999,0
1657896644534,MATH 197,004,095571,Perols; Johan Lars,9998,0,9999,1
1657896651606,COGS 9,A01,083615,Shannon; Kyle Michael,10,0,75,65
1657896657633,COGS 11,A01,083617,Boyle; Mary E. T.,23,0,48,25
1657896663659,COGS 13,A01,083071,Bastos; Amalia Pinkusfeld,11,0,71,60
1657896669682,COGS 14A,A01,092681,Semenuks; Arturs,5,1,100,95
1657896675707,COGS 14B,A01,083073,Cheng; Tzu-Han,6,0,63,57
1657896681732,COGS 17,A01,092677,Semenuks; Arturs,6,0,81,75
1657896687757,COGS 100,A01,083619,Allen; Michael Gordon,17,0,70,53
1657896693780,COGS 101A,A01,083621,Davis; Joshua Daniel,9,0,68,59
1657896699803,COGS 101B,A01,091572,Allen; Michael Gordon,13,0,65,52
1657896705835,COGS 101C,A01,083625,Delgado; Tania,17,0,35,18
1657896711862,COGS 107A,A01,083627,Boyle; Mary E. T.,14,0,60,46
1657896717885,COGS 118A,A01,083075,Gupta; Anjum,21,0,76,55
1657896723913,CSE 3,A50,083646,Miranda; Gregory Joseph,24,0,50,26
1657896729937,CSE 8A,A50,083650,Miranda; Gregory Joseph,17,1,56,39
1657896735964,CSE 11,A01,083080,Cao; Yingjun,6,15,40,34
1657896741988,CSE 12,A01,083652,Krause-Levy; Sophia Louisa,30,1,120,90
1657896748010,CSE 15L,A01,083654,Morris; Justin Loren,9,0,50,41
1657896748010,CSE 15L,A02,083655,Morris; Justin Loren,10,0,50,40
1657896754033,CSE 20,A01,083657,Tran; Khoa Dang,39,0,80,41
1657896760057,CSE 21,A01,095574,Bach; Quang Tran,22,0,48,26
1657896766080,CSE 30,A01,083084,Eldon; John,6,0,80,74
1657896766080,CSE 30,B01,095061,Bhaskar; Nishant,9,0,50,41
1657896772106,CSE 100,A01,083659,Cao; Yingjun,5,4,70,65
1657896778131,CSE 134B,A01,083661,Powell; Thomas Allan,24,0,100,76
1657896784164,CSE 140,A01,083663,Gungor; Onat,15,0,85,70
1657896790190,CSE 140L,A01,083088,Eldon; John,23,0,100,77
1657896796214,CSE 175,A01,083665,Kumar; Rakesh,3,0,25,22
1657896802237,CSE 190,A00,092507,Dubnov; Shlomo,8,0,20,12
1657896808260,ECE 45,A01,083139,Congero; Spencer William,6,0,75,69
1657896814294,ECE 65,A50,083695,Saad; Andrew S,12,0,30,18
1657896814294,ECE 65,A51,095125,Saad; Andrew S,24,0,26,2
1657896820320,ECE 109,A01,091882,Touri; Behrouz,20,0,70,50
1657896826343,ECE 180,A00,083140,Abi Samra; Nicholas Camill,1,0,30,29
1657896826343,ECE 180,B00,083141,Abi Samra; Nicholas Camill,0,0,30,30
1657896832371,MATH 10A,A01,083735,Patchell; Gregory David,2,0,30,28
1657896832371,MATH 10A,A02,083736,Patchell; Gregory David,20,0,30,10
1657896832371,MATH 10A,A03,083737,Patchell; Gregory David,16,0,30,14
1657896838396,MATH 10B,A01,083207,Lim; Seonhee,8,0,34,26
1657896838396,MATH 10B,A02,083208,Lim; Seonhee,10,0,35,25
1657896838396,MATH 10B,A03,093472,Lim; Seonhee,7,0,34,27
1657896838396,MATH 10B,B01,083739,Sinha; Shubham,14,0,30,16
1657896844421,MATH 18,A01,083743,Cinel; Cameron Alexander,9,0,30,21
1657896844421,MATH 18,A02,083744,Cinel; Cameron Alexander,18,0,30,12
1657896844421,MATH 18,A03,083745,Cinel; Cameron Alexander,10,0,30,20
1657896844421,MATH 18,B01,083748,Rideout; David Porter,5,0,37,32
1657896844421,MATH 18,B02,083749,Rideout; David Porter,5,0,36,31
1657896844421,MATH 18,B03,083750,Rideout; David Porter,3,0,37,34
1657896844421,MATH 18,B04,083751,Rideout; David Porter,6,0,36,30
1657896844421,MATH 18,B05,093473,Rideout; David Porter,6,0,36,30
1657896844421,MATH 18,B06,093474,Rideout; David Porter,6,0,36,30
1657896850445,MATH 20A,A01,083754,Zheng; Zequn,14,0,40,26
1657896856471,MATH 20B,A01,083756,Briones; Jor-el Thomas Caparas,4,0,36,32
1657896856471,MATH 20B,A02,083757,Briones; Jor-el Thomas Caparas,1,0,36,35
1657896856471,MATH 20B,A03,093475,Briones; Jor-el Thomas Caparas,2,0,36,34
1657896862495,MATH 20C,A01,083760,Briones; Jor-el Thomas Caparas,1,0,35,34
1657896862495,MATH 20C,A02,083761,Briones; Jor-el Thomas Caparas,8,0,35,27
1657896862495,MATH 20C,A03,093476,Briones; Jor-el Thomas Caparas,0,1,36,36
1657896862495,MATH 20C,B01,083762,Bach; Quang Tran,1,0,30,29
1657896868523,MATH 20D,A01,083765,Tran; Brian Kha,5,0,30,25
1657896868523,MATH 20D,A02,083766,Tran; Brian Kha,5,0,30,25
1657896868523,MATH 20D,A03,083767,Tran; Brian Kha,5,0,30,25
1657896874550,MATH 20E,A01,083771,Ganguly; Soumya,10,0,32,22
1657896874550,MATH 20E,A02,083772,Ganguly; Soumya,6,0,32,26
1657896874550,MATH 20E,B01,083773,Ciotti; Benjamin,20,0,35,15
1657896874550,MATH 20E,B02,083774,Ciotti; Benjamin,18,0,35,17
1657896880580,MATH 103A,A01,083777,Greenfeld; Be'Eri,3,0,36,33
1657896880580,MATH 103A,A02,083778,Greenfeld; Be'Eri,5,0,36,31
1657896880580,MATH 103A,A03,093561,Greenfeld; Be'Eri,6,0,36,30
1657896880580,MATH 103A,B01,083779,Greenfeld; Be'Eri,7,0,36,29
1657896880580,MATH 103A,B02,083780,Greenfeld; Be'Eri,4,0,36,32
1657896880580,MATH 103A,B03,093562,Greenfeld; Be'Eri,3,0,36,33
1657896886604,MATH 105,A01,085443,Carter; Anne Toulson,15,0,35,20
1657896886604,MATH 105,A02,093477,Carter; Anne Toulson,20,0,35,15
1657896892627,MATH 109,A01,083213,Ganzberger; Geoffrey Michael,3,0,34,31
1657896892627,MATH 109,A02,083214,Ganzberger; Geoffrey Michael,4,0,34,30
1657896892627,MATH 109,A03,093478,Ganzberger; Geoffrey Michael,2,0,34,32
1657896892627,MATH 109,B01,083215,Ganzberger; Geoffrey Michael,2,0,32,30
1657896892627,MATH 109,B02,083216,Ganzberger; Geoffrey Michael,2,0,32,30
1657896892627,MATH 109,B03,093479,Ganzberger; Geoffrey Michael,8,0,32,24
1657896898650,MATH 142A,A01,083219,Chow; Bennett,7,0,32,25
1657896898650,MATH 142A,A02,083220,Chow; Bennett,10,0,32,22
1657896898650,MATH 142A,A03,093480,Chow; Bennett,9,0,32,23
1657896898650,MATH 142A,B03,093481,Chow; Bennett,8,0,32,24
1657896898650,MATH 142A,B04,093558,Chow; Bennett,13,0,32,19
1657896898650,MATH 142A,B05,093559,Chow; Bennett,7,0,32,25
1657896904684,MATH 193A,A01,083224,Rotar; Vladimir,8,0,34,26
1657896904684,MATH 193A,A02,083225,Rotar; Vladimir,10,0,34,24
1657896904684,MATH 193A,A03,083781,Rotar; Vladimir,5,0,34,29
1657896904684,MATH 193A,A04,083782,Rotar; Vladimir,11,0,34,23
1657896904684,MATH 193A,A05,093482,Rotar; Vladimir,10,0,34,24
1657896910707,MATH 197,001,091859,McAuley; Julian John,9999,0,9999,0
1657896910707,MATH 197,002,095566,Kedlaya; Kiran S.,9997,0,9999,2
1657896910707,MATH 197,003,095567,Xiao; Ming,9999,0,9999,0
1657896910707,MATH 197,004,095571,Perols; Johan Lars,9998,0,9999,1
1657896917764,COGS 9,A01,083615,Shannon; Kyle Michael,10,0,75,65
1657896923790,COGS 11,A01,083617,Boyle; Mary E. T.,23,0,48,25
1657896929907,COGS 13,A01,083071,Bastos; Amalia Pinkusfeld,11,0,71,60
1657896935931,COGS 14A,A01,092681,Semenuks; Arturs,5,1,100,95
1657896941957,COGS 14B,A01,083073,Cheng; Tzu-Han,6,0,63,57
1657896947984,COGS 17,A01,092677,Semenuks; Arturs,6,0,81,75
1657896954010,COGS 100,A01,083619,Allen; Michael Gordon,17,0,70,53
1657896960037,COGS 101A,A01,083621,Davis; Joshua Daniel,9,0,68,59
1657896966064,COGS 101B,A01,091572,Allen; Michael Gordon,13,0,65,52
1657896972091,COGS 101C,A01,083625,Delgado; Tania,17,0,35,18
1657896978119,COGS 107A,A01,083627,Boyle; Mary E. T.,14,0,60,46
1657896984142,COGS 118A,A01,083075,Gupta; Anjum,21,0,76,55
1657896990170,CSE 3,A50,083646,Miranda; Gregory Joseph,24,0,50,26
1657896996197,CSE 8A,A50,083650,Miranda; Gregory Joseph,17,1,56,39
1657897002221,CSE 11,A01,083080,Cao; Yingjun,6,15,40,34
1657897008244,CSE 12,A01,083652,Krause-Levy; Sophia Louisa,30,1,120,90
1657897014271,CSE 15L,A01,083654,Morris; Justin Loren,9,0,50,41
1657897014271,CSE 15L,A02,083655,Morris; Justin Loren,10,0,50,40
1657897020300,CSE 20,A01,083657,Tran; Khoa Dang,39,0,80,41
1657897026335,CSE 21,A01,095574,Bach; Quang Tran,22,0,48,26
1657897032369,CSE 30,A01,083084,Eldon; John,6,0,80,74
1657897032369,CSE 30,B01,095061,Bhaskar; Nishant,9,0,50,41
1657897038397,CSE 100,A01,083659,Cao; Yingjun,5,4,70,65
1657897044436,CSE 134B,A01,083661,Powell; Thomas Allan,24,0,100,76
1657897050464,CSE 140,A01,083663,Gungor; Onat,15,0,85,70
1657897056491,CSE 140L,A01,083088,Eldon; John,23,0,100,77
1657897062517,CSE 175,A01,083665,Kumar; Rakesh,3,0,25,22
1657897068543,CSE 190,A00,092507,Dubnov; Shlomo,8,0,20,12
1657897074568,ECE 45,A01,083139,Congero; Spencer William,6,0,75,69
1657897080592,ECE 65,A50,083695,Saad; Andrew S,12,0,30,18
1657897080592,ECE 65,A51,095125,Saad; Andrew S,24,0,26,2
1657897086620,ECE 109,A01,091882,Touri; Behrouz,20,0,70,50
1657897092645,ECE 180,A00,083140,Abi Samra; Nicholas Camill,1,0,30,29
1657897092645,ECE 180,B00,083141,Abi Samra; Nicholas Camill,0,0,30,30
1657897098667,MATH 10A,A01,083735,Patchell; Gregory David,2,0,30,28
1657897098667,MATH 10A,A02,083736,Patchell; Gregory David,20,0,30,10
1657897098667,MATH 10A,A03,083737,Patchell; Gregory David,16,0,30,14
1657897104705,MATH 10B,A01,083207,Lim; Seonhee,8,0,34,26
1657897104705,MATH 10B,A02,083208,Lim; Seonhee,10,0,35,25
1657897104705,MATH 10B,A03,093472,Lim; Seonhee,7,0,34,27
1657897104705,MATH 10B,B01,083739,Sinha; Shubham,14,0,30,16
1657897110737,MATH 18,A01,083743,Cinel; Cameron Alexander,9,0,30,21
1657897110737,MATH 18,A02,083744,Cinel; Cameron Alexander,18,0,30,12
1657897110737,MATH 18,A03,083745,Cinel; Cameron Alexander,10,0,30,20
1657897110737,MATH 18,B01,083748,Rideout; David Porter,5,0,37,32
1657897110737,MATH 18,B02,083749,Rideout; David Porter,5,0,36,31
1657897110737,MATH 18,B03,083750,Rideout; David Porter,3,0,37,34
1657897110737,MATH 18,B04,083751,Rideout; David Porter,6,0,36,30
1657897110737,MATH 18,B05,093473,Rideout; David Porter,6,0,36,30
1657897110737,MATH 18,B06,093474,Rideout; David Porter,6,0,36,30
1657897116759,MATH 20A,A01,083754,Zheng; Zequn,14,0,40,26
1657897122783,MATH 20B,A01,083756,Briones; Jor-el Thomas Caparas,4,0,36,32
1657897122783,MATH 20B,A02,083757,Briones; Jor-el Thomas Caparas,1,0,36,35
1657897122783,MATH 20B,A03,093475,Briones; Jor-el Thomas Caparas,2,0,36,34
1657897128807,MATH 20C,A01,083760,Briones; Jor-el Thomas Caparas,1,0,35,34
1657897128807,MATH 20C,A02,083761,Briones; Jor-el Thomas Caparas,8,0,35,27
1657897128807,MATH 20C,A03,093476,Briones; Jor-el Thomas Caparas,0,1,36,36
1657897128807,MATH 20C,B01,083762,Bach; Quang Tran,1,0,30,29
1657897134837,MATH 20D,A01,083765,Tran; Brian Kha,5,0,30,25
1657897134837,MATH 20D,A02,083766,Tran; Brian Kha,5,0,30,25
1657897134837,MATH 20D,A03,083767,Tran; Brian Kha,5,0,30,25
1657897140860,MATH 20E,A01,083771,Ganguly; Soumya,10,0,32,22
1657897140860,MATH 20E,A02,083772,Ganguly; Soumya,6,0,32,26
1657897140860,MATH 20E,B01,083773,Ciotti; Benjamin,20,0,35,15
1657897140860,MATH 20E,B02,083774,Ciotti; Benjamin,18,0,35,17
1657897146885,MATH 103A,A01,083777,Greenfeld; Be'Eri,3,0,36,33
1657897146885,MATH 103A,A02,083778,Greenfeld; Be'Eri,5,0,36,31
1657897146885,MATH 103A,A03,093561,Greenfeld; Be'Eri,6,0,36,30
1657897146885,MATH 103A,B01,083779,Greenfeld; Be'Eri,7,0,36,29
1657897146885,MATH 103A,B02,083780,Greenfeld; Be'Eri,4,0,36,32
1657897146885,MATH 103A,B03,093562,Greenfeld; Be'Eri,3,0,36,33
1657897152915,MATH 105,A01,085443,Carter; Anne Toulson,15,0,35,20
1657897152915,MATH 105,A02,093477,Carter; Anne Toulson,20,0,35,15
1657897158941,MATH 109,A01,083213,Ganzberger; Geoffrey Michael,3,0,34,31
1657897158941,MATH 109,A02,083214,Ganzberger; Geoffrey Michael,4,0,34,30
1657897158941,MATH 109,A03,093478,Ganzberger; Geoffrey Michael,2,0,34,32
1657897158941,MATH 109,B01,083215,Ganzberger; Geoffrey Michael,2,0,32,30
1657897158941,MATH 109,B02,083216,Ganzberger; Geoffrey Michael,2,0,32,30
1657897158941,MATH 109,B03,093479,Ganzberger; Geoffrey Michael,8,0,32,24
1657897164965,MATH 142A,A01,083219,Chow; Bennett,7,0,32,25
1657897164965,MATH 142A,A02,083220,Chow; Bennett,10,0,32,22
1657897164965,MATH 142A,A03,093480,Chow; Bennett,9,0,32,23
1657897164965,MATH 142A,B03,093481,Chow; Bennett,8,0,32,24
1657897164965,MATH 142A,B04,093558,Chow; Bennett,13,0,32,19
1657897164965,MATH 142A,B05,093559,Chow; Bennett,7,0,32,25
1657897170988,MATH 193A,A01,083224,Rotar; Vladimir,8,0,34,26
1657897170988,MATH 193A,A02,083225,Rotar; Vladimir,10,0,34,24
1657897170988,MATH 193A,A03,083781,Rotar; Vladimir,5,0,34,29
1657897170988,MATH 193A,A04,083782,Rotar; Vladimir,11,0,34,23
1657897170988,MATH 193A,A05,093482,Rotar; Vladimir,10,0,34,24
1657897177010,MATH 197,001,091859,McAuley; Julian John,9999,0,9999,0
1657897177010,MATH 197,002,095566,Kedlaya; Kiran S.,9997,0,9999,2
1657897177010,MATH 197,003,095567,Xiao; Ming,9999,0,9999,0
1657897177010,MATH 197,004,095571,Perols; Johan Lars,9998,0,9999,1
1657897184073,COGS 9,A01,083615,Shannon; Kyle Michael,10,0,75,65
1657897190096,COGS 11,A01,083617,Boyle; Mary E. T.,23,0,48,25
1657897196122,COGS 13,A01,083071,Bastos; Amalia Pinkusfeld,11,0,71,60
1657897202148,COGS 14A,A01,092681,Semenuks; Arturs,5,1,100,95
1657897208176,COGS 14B,A01,083073,Cheng; Tzu-Han,6,0,63,57
1657897214199,COGS 17,A01,092677,Semenuks; Arturs,6,0,81,75
1657897220223,COGS 100,A01,083619,Allen; Michael Gordon,17,0,70,53
1657897226249,COGS 101A,A01,083621,Davis; Joshua Daniel,9,0,68,59
1657897232272,COGS 101B,A01,091572,Allen; Michael Gordon,13,0,65,52
1657897238296,COGS 101C,A01,083625,Delgado; Tania,17,0,35,18
1657897244319,COGS 107A,A01,083627,Boyle; Mary E. T.,14,0,60,46
1657897250346,COGS 118A,A01,083075,Gupta; Anjum,21,0,76,55
1657897256374,CSE 3,A50,083646,Miranda; Gregory Joseph,24,0,50,26
1657897262413,CSE 8A,A50,083650,Miranda; Gregory Joseph,17,1,56,39
1657897268443,CSE 11,A01,083080,Cao; Yingjun,6,15,40,34
1657897274466,CSE 12,A01,083652,Krause-Levy; Sophia Louisa,30,1,120,90
1657897280488,CSE 15L,A01,083654,Morris; Justin Loren,9,0,50,41
1657897280488,CSE 15L,A02,083655,Morris; Justin Loren,10,0,50,40
1657897286511,CSE 20,A01,083657,Tran; Khoa Dang,39,0,80,41
1657897292533,CSE 21,A01,095574,Bach; Quang Tran,22,0,48,26
1657897298560,CSE 30,A01,083084,Eldon; John,6,0,80,74
1657897298560,CSE 30,B01,095061,Bhaskar; Nishant,9,0,50,41
1657897304587,CSE 100,A01,083659,Cao; Yingjun,5,4,70,65
1657897310612,CSE 134B,A01,083661,Powell; Thomas Allan,24,0,100,76
1657897316638,CSE 140,A01,083663,Gungor; Onat,15,0,85,70
1657897322663,CSE 140L,A01,083088,Eldon; John,23,0,100,77
1657897328689,CSE 175,A01,083665,Kumar; Rakesh,3,0,25,22
1657897334711,CSE 190,A00,092507,Dubnov; Shlomo,8,0,20,12
1657897340734,ECE 45,A01,083139,Congero; Spencer William,6,0,75,69
1657897346760,ECE 65,A50,083695,Saad; Andrew S,12,0,30,18
1657897346760,ECE 65,A51,095125,Saad; Andrew S,24,0,26,2
1657897352789,ECE 109,A01,091882,Touri; Behrouz,20,0,70,50
1657897358811,ECE 180,A00,083140,Abi Samra; Nicholas Camill,1,0,30,29
1657897358811,ECE 180,B00,083141,Abi Samra; Nicholas Camill,0,0,30,30
1657897364837,MATH 10A,A01,083735,Patchell; Gregory David,2,0,30,28
1657897364837,MATH 10A,A02,083736,Patchell; Gregory David,20,0,30,10
1657897364837,MATH 10A,A03,083737,Patchell; Gregory David,16,0,30,14
1657897370862,MATH 10B,A01,083207,Lim; Seonhee,8,0,34,26
1657897370862,MATH 10B,A02,083208,Lim; Seonhee,10,0,35,25
1657897370862,MATH 10B,A03,093472,Lim; Seonhee,7,0,34,27
1657897370862,MATH 10B,B01,083739,Sinha; Shubham,14,0,30,16
1657897376892,MATH 18,A01,083743,Cinel; Cameron Alexander,9,0,30,21
1657897376892,MATH 18,A02,083744,Cinel; Cameron Alexander,18,0,30,12
1657897376892,MATH 18,A03,083745,Cinel; Cameron Alexander,10,0,30,20
1657897376892,MATH 18,B01,083748,Rideout; David Porter,5,0,37,32
1657897376892,MATH 18,B02,083749,Rideout; David Porter,5,0,36,31
1657897376892,MATH 18,B03,083750,Rideout; David Porter,3,0,37,34
1657897376892,MATH 18,B04,083751,Rideout; David Porter,6,0,36,30
1657897376892,MATH 18,B05,093473,Rideout; David Porter,6,0,36,30
1657897376892,MATH 18,B06,093474,Rideout; David Porter,6,0,36,30
1657897382916,MATH 20A,A01,083754,Zheng; Zequn,14,0,40,26
1657897388943,MATH 20B,A01,083756,Briones; Jor-el Thomas Caparas,4,0,36,32
1657897388943,MATH 20B,A02,083757,Briones; Jor-el Thomas Caparas,1,0,36,35
1657897388943,MATH 20B,A03,093475,Briones; Jor-el Thomas Caparas,2,0,36,34
1657897394967,MATH 20C,A01,083760,Briones; Jor-el Thomas Caparas,1,0,35,34
1657897394967,MATH 20C,A02,083761,Briones; Jor-el Thomas Caparas,8,0,35,27
1657897394967,MATH 20C,A03,093476,Briones; Jor-el Thomas Caparas,0,1,36,36
1657897394967,MATH 20C,B01,083762,Bach; Quang Tran,1,0,30,29
1657897400991,MATH 20D,A01,083765,Tran; Brian Kha,5,0,30,25
1657897400991,MATH 20D,A02,083766,Tran; Brian Kha,5,0,30,25
1657897400991,MATH 20D,A03,083767,Tran; Brian Kha,5,0,30,25
1657897407021,MATH 20E,A01,083771,Ganguly; Soumya,10,0,32,22
1657897407021,MATH 20E,A02,083772,Ganguly; Soumya,6,0,32,26
1657897407021,MATH 20E,B01,083773,Ciotti; Benjamin,20,0,35,15
1657897407021,MATH 20E,B02,083774,Ciotti; Benjamin,18,0,35,17
1657897413045,MATH 103A,A01,083777,Greenfeld; Be'Eri,3,0,36,33
1657897413045,MATH 103A,A02,083778,Greenfeld; Be'Eri,5,0,36,31
1657897413045,MATH 103A,A03,093561,Greenfeld; Be'Eri,6,0,36,30
1657897413045,MATH 103A,B01,083779,Greenfeld; Be'Eri,7,0,36,29
1657897413045,MATH 103A,B02,083780,Greenfeld; Be'Eri,4,0,36,32
1657897413045,MATH 103A,B03,093562,Greenfeld; Be'Eri,3,0,36,33
1657897419070,MATH 105,A01,085443,Carter; Anne Toulson,15,0,35,20
1657897419070,MATH 105,A02,093477,Carter; Anne Toulson,20,0,35,15
1657897425098,MATH 109,A01,083213,Ganzberger; Geoffrey Michael,3,0,34,31
1657897425098,MATH 109,A02,083214,Ganzberger; Geoffrey Michael,4,0,34,30
1657897425098,MATH 109,A03,093478,Ganzberger; Geoffrey Michael,2,0,34,32
1657897425098,MATH 109,B01,083215,Ganzberger; Geoffrey Michael,2,0,32,30
1657897425098,MATH 109,B02,083216,Ganzberger; Geoffrey Michael,2,0,32,30
1657897425098,MATH 109,B03,093479,Ganzberger; Geoffrey Michael,8,0,32,24
1657897431138,MATH 142A,A01,083219,Chow; Bennett,7,0,32,25
1657897431138,MATH 142A,A02,083220,Chow; Bennett,10,0,32,22
1657897431138,MATH 142A,A03,093480,Chow; Bennett,9,0,32,23
1657897431138,MATH 142A,B03,093481,Chow; Bennett,8,0,32,24
1657897431138,MATH 142A,B04,093558,Chow; Bennett,13,0,32,19
1657897431138,MATH 142A,B05,093559,Chow; Bennett,7,0,32,25
1657897437162,MATH 193A,A01,083224,Rotar; Vladimir,8,0,34,26
1657897437162,MATH 193A,A02,083225,Rotar; Vladimir,10,0,34,24
1657897437162,MATH 193A,A03,083781,Rotar; Vladimir,5,0,34,29
1657897437162,MATH 193A,A04,083782,Rotar; Vladimir,11,0,34,23
1657897437162,MATH 193A,A05,093482,Rotar; Vladimir,10,0,34,24
1657897443190,MATH 197,001,091859,McAuley; Julian John,9999,0,9999,0
1657897443190,MATH 197,002,095566,Kedlaya; Kiran S.,9997,0,9999,2
1657897443190,MATH 197,003,095567,Xiao; Ming,9999,0,9999,0
1657897443190,MATH 197,004,095571,Perols; Johan Lars,9998,0,9999,1
1657897450244,COGS 9,A01,083615,Shannon; Kyle Michael,10,0,75,65
1657897456271,COGS 11,A01,083617,Boyle; Mary E. T.,23,0,48,25
1657897462305,COGS 13,A01,083071,Bastos; Amalia Pinkusfeld,11,0,71,60
1657897468333,COGS 14A,A01,092681,Semenuks; Arturs,5,1,100,95
1657897474359,COGS 14B,A01,083073,Cheng; Tzu-Han,6,0,63,57
1657897480385,COGS 17,A01,092677,Semenuks; Arturs,6,0,81,75
1657897486410,COGS 100,A01,083619,Allen; Michael Gordon,17,0,70,53
1657897492438,COGS 101A,A01,083621,Davis; Joshua Daniel,9,0,68,59
1657897498463,COGS 101B,A01,091572,Allen; Michael Gordon,13,0,65,52
1657897504487,COGS 101C,A01,083625,Delgado; Tania,17,0,35,18
1657897510514,COGS 107A,A01,083627,Boyle; Mary E. T.,14,0,60,46
1657897516540,COGS 118A,A01,083075,Gupta; Anjum,21,0,76,55
1657897522563,CSE 3,A50,083646,Miranda; Gregory Joseph,24,0,50,26
1657897528661,CSE 8A,A50,083650,Miranda; Gregory Joseph,17,1,56,39
1657897534682,CSE 11,A01,083080,Cao; Yingjun,6,15,40,34
1657897540711,CSE 12,A01,083652,Krause-Levy; Sophia Louisa,30,1,120,90
1657897546734,CSE 15L,A01,083654,Morris; Justin Loren,9,0,50,41
1657897546734,CSE 15L,A02,083655,Morris; Justin Loren,10,0,50,40
1657897552756,CSE 20,A01,083657,Tran; Khoa Dang,39,0,80,41
1657897558780,CSE 21,A01,095574,Bach; Quang Tran,22,0,48,26
1657897564807,CSE 30,A01,083084,Eldon; John,6,0,80,74
1657897564807,CSE 30,B01,095061,Bhaskar; Nishant,9,0,50,41
1657897570846,CSE 100,A01,083659,Cao; Yingjun,5,4,70,65
1657897576875,CSE 134B,A01,083661,Powell; Thomas Allan,24,0,100,76
1657897582909,CSE 140,A01,083663,Gungor; Onat,15,0,85,70
1657897588936,CSE 140L,A01,083088,Eldon; John,23,0,100,77
1657897594969,CSE 175,A01,083665,Kumar; Rakesh,3,0,25,22
1657897600997,CSE 190,A00,092507,Dubnov; Shlomo,8,0,20,12
1657897607021,ECE 45,A01,083139,Congero; Spencer William,6,0,75,69
1657897613049,ECE 65,A50,083695,Saad; Andrew S,12,0,30,18
1657897613049,ECE 65,A51,095125,Saad; Andrew S,24,0,26,2
1657897619075,ECE 109,A01,091882,Touri; Behrouz,20,0,70,50
1657897625114,ECE 180,A00,083140,Abi Samra; Nicholas Camill,1,0,30,29
1657897625114,ECE 180,B00,083141,Abi Samra; Nicholas Camill,0,0,30,30
1657897631143,MATH 10A,A01,083735,Patchell; Gregory David,2,0,30,28
1657897631143,MATH 10A,A02,083736,Patchell; Gregory David,20,0,30,10
1657897631143,MATH 10A,A03,083737,Patchell; Gregory David,16,0,30,14
1657897637172,MATH 10B,A01,083207,Lim; Seonhee,8,0,34,26
1657897637172,MATH 10B,A02,083208,Lim; Seonhee,10,0,35,25
1657897637172,MATH 10B,A03,093472,Lim; Seonhee,7,0,34,27
1657897637172,MATH 10B,B01,083739,Sinha; Shubham,14,0,30,16
1657897643209,MATH 18,A01,083743,Cinel; Cameron Alexander,9,0,30,21
1657897643209,MATH 18,A02,083744,Cinel; Cameron Alexander,18,0,30,12
1657897643209,MATH 18,A03,083745,Cinel; Cameron Alexander,10,0,30,20
1657897643209,MATH 18,B01,083748,Rideout; David Porter,5,0,37,32
1657897643209,MATH 18,B02,083749,Rideout; David Porter,5,0,36,31
1657897643209,MATH 18,B03,083750,Rideout; David Porter,3,0,37,34
1657897643209,MATH 18,B04,083751,Rideout; David Porter,6,0,36,30
1657897643209,MATH 18,B05,093473,Rideout; David Porter,6,0,36,30
1657897643209,MATH 18,B06,093474,Rideout; David Porter,6,0,36,30
1657897649243,MATH 20A,A01,083754,Zheng; Zequn,14,0,40,26
1657897655271,MATH 20B,A01,083756,Briones; Jor-el Thomas Caparas,4,0,36,32
1657897655271,MATH 20B,A02,083757,Briones; Jor-el Thomas Caparas,1,0,36,35
1657897655271,MATH 20B,A03,093475,Briones; Jor-el Thomas Caparas,2,0,36,34
1657897661299,MATH 20C,A01,083760,Briones; Jor-el Thomas Caparas,1,0,35,34
1657897661299,MATH 20C,A02,083761,Briones; Jor-el Thomas Caparas,8,0,35,27
1657897661299,MATH 20C,A03,093476,Briones; Jor-el Thomas Caparas,0,1,36,36
1657897661299,MATH 20C,B01,083762,Bach; Quang Tran,1,0,30,29
1657897667330,MATH 20D,A01,083765,Tran; Brian Kha,5,0,30,25
1657897667330,MATH 20D,A02,083766,Tran; Brian Kha,5,0,30,25
1657897667330,MATH 20D,A03,083767,Tran; Brian Kha,5,0,30,25
1657897673355,MATH 20E,A01,083771,Ganguly; Soumya,10,0,32,22
1657897673355,MATH 20E,A02,083772,Ganguly; Soumya,6,0,32,26
1657897673355,MATH 20E,B01,083773,Ciotti; Benjamin,20,0,35,15
1657897673355,MATH 20E,B02,083774,Ciotti; Benjamin,18,0,35,17
1657897679390,MATH 103A,A01,083777,Greenfeld; Be'Eri,3,0,36,33
1657897679390,MATH 103A,A02,083778,Greenfeld; Be'Eri,5,0,36,31
1657897679390,MATH 103A,A03,093561,Greenfeld; Be'Eri,6,0,36,30
1657897679390,MATH 103A,B01,083779,Greenfeld; Be'Eri,7,0,36,29
1657897679390,MATH 103A,B02,083780,Greenfeld; Be'Eri,4,0,36,32
1657897679390,MATH 103A,B03,093562,Greenfeld; Be'Eri,3,0,36,33
1657897685422,MATH 105,A01,085443,Carter; Anne Toulson,15,0,35,20
1657897685422,MATH 105,A02,093477,Carter; Anne Toulson,20,0,35,15
1657897691451,MATH 109,A01,083213,Ganzberger; Geoffrey Michael,3,0,34,31
1657897691451,MATH 109,A02,083214,Ganzberger; Geoffrey Michael,4,0,34,30
1657897691451,MATH 109,A03,093478,Ganzberger; Geoffrey Michael,2,0,34,32
1657897691451,MATH 109,B01,083215,Ganzberger; Geoffrey Michael,2,0,32,30
1657897691451,MATH 109,B02,083216,Ganzberger; Geoffrey Michael,2,0,32,30
1657897691451,MATH 109,B03,093479,Ganzberger; Geoffrey Michael,8,0,32,24
1657897697479,MATH 142A,A01,083219,Chow; Bennett,7,0,32,25
1657897697479,MATH 142A,A02,083220,Chow; Bennett,10,0,32,22
1657897697479,MATH 142A,A03,093480,Chow; Bennett,9,0,32,23
1657897697479,MATH 142A,B03,093481,Chow; Bennett,8,0,32,24
1657897697479,MATH 142A,B04,093558,Chow; Bennett,13,0,32,19
1657897697479,MATH 142A,B05,093559,Chow; Bennett,7,0,32,25
1657897703503,MATH 193A,A01,083224,Rotar; Vladimir,8,0,34,26
1657897703503,MATH 193A,A02,083225,Rotar; Vladimir,10,0,34,24
1657897703503,MATH 193A,A03,083781,Rotar; Vladimir,5,0,34,29
1657897703503,MATH 193A,A04,083782,Rotar; Vladimir,11,0,34,23
1657897703503,MATH 193A,A05,093482,Rotar; Vladimir,10,0,34,24
1657897709531,MATH 197,001,091859,McAuley; Julian John,9999,0,9999,0
1657897709531,MATH 197,002,095566,Kedlaya; Kiran S.,9997,0,9999,2
1657897709531,MATH 197,003,095567,Xiao; Ming,9999,0,9999,0
1657897709531,MATH 197,004,095571,Perols; Johan Lars,9998,0,9999,1
1657897716585,COGS 9,A01,083615,Shannon; Kyle Michael,10,0,75,65
1657897722633,COGS 11,A01,083617,Boyle; Mary E. T.,23,0,48,25
1657897728656,COGS 13,A01,083071,Bastos; Amalia Pinkusfeld,11,0,71,60
1657897734682,COGS 14A,A01,092681,Semenuks; Arturs,5,1,100,95
1657897740709,COGS 14B,A01,083073,Cheng; Tzu-Han,6,0,63,57
1657897746737,COGS 17,A01,092677,Semenuks; Arturs,6,0,81,75
1657897752763,COGS 100,A01,083619,Allen; Michael Gordon,17,0,70,53
1657897758791,COGS 101A,A01,083621,Davis; Joshua Daniel,9,0,68,59
1657897764818,COGS 101B,A01,091572,Allen; Michael Gordon,13,0,65,52
1657897770841,COGS 101C,A01,083625,Delgado; Tania,17,0,35,18
1657897776865,COGS 107A,A01,083627,Boyle; Mary E. T.,14,0,60,46
1657897782887,COGS 118A,A01,083075,Gupta; Anjum,21,0,76,55
1657897788915,CSE 3,A50,083646,Miranda; Gregory Joseph,24,0,50,26
1657897794948,CSE 8A,A50,083650,Miranda; Gregory Joseph,17,1,56,39
1657897800976,CSE 11,A01,083080,Cao; Yingjun,6,15,40,34
1657897807022,CSE 12,A01,083652,Krause-Levy; Sophia Louisa,30,1,120,90
1657897813047,CSE 15L,A01,083654,Morris; Justin Loren,9,0,50,41
1657897813047,CSE 15L,A02,083655,Morris; Justin Loren,10,0,50,40
1657897819071,CSE 20,A01,083657,Tran; Khoa Dang,39,0,80,41
1657897825098,CSE 21,A01,095574,Bach; Quang Tran,22,0,48,26
1657897831124,CSE 30,A01,083084,Eldon; John,6,0,80,74
1657897831124,CSE 30,B01,095061,Bhaskar; Nishant,9,0,50,41
1657897837156,CSE 100,A01,083659,Cao; Yingjun,5,4,70,65
1657897843186,CSE 134B,A01,083661,Powell; Thomas Allan,24,0,100,76
1657897849210,CSE 140,A01,083663,Gungor; Onat,15,0,85,70
1657897855234,CSE 140L,A01,083088,Eldon; John,23,0,100,77
1657897861267,CSE 175,A01,083665,Kumar; Rakesh,3,0,25,22
1657897867289,CSE 190,A00,092507,Dubnov; Shlomo,8,0,20,12
1657897873314,ECE 45,A01,083139,Congero; Spencer William,6,0,75,69
1657897879337,ECE 65,A50,083695,Saad; Andrew S,12,0,30,18
1657897879337,ECE 65,A51,095125,Saad; Andrew S,24,0,26,2
1657897885359,ECE 109,A01,091882,Touri; Behrouz,20,0,70,50
1657897891386,ECE 180,A00,083140,Abi Samra; Nicholas Camill,1,0,30,29
1657897891386,ECE 180,B00,083141,Abi Samra; Nicholas Camill,0,0,30,30
1657897897423,MATH 10A,A01,083735,Patchell; Gregory David,2,0,30,28
1657897897423,MATH 10A,A02,083736,Patchell; Gregory David,20,0,30,10
1657897897423,MATH 10A,A03,083737,Patchell; Gregory David,16,0,30,14
1657897903452,MATH 10B,A01,083207,Lim; Seonhee,8,0,34,26
1657897903452,MATH 10B,A02,083208,Lim; Seonhee,10,0,35,25
1657897903452,MATH 10B,A03,093472,Lim; Seonhee,7,0,34,27
1657897903452,MATH 10B,B01,083739,Sinha; Shubham,14,0,30,16
1657897909485,MATH 18,A01,083743,Cinel; Cameron Alexander,9,0,30,21
1657897909485,MATH 18,A02,083744,Cinel; Cameron Alexander,18,0,30,12
1657897909485,MATH 18,A03,083745,Cinel; Cameron Alexander,10,0,30,20
1657897909485,MATH 18,B01,083748,Rideout; David Porter,5,0,37,32
1657897909485,MATH 18,B02,083749,Rideout; David Porter,5,0,36,31
1657897909485,MATH 18,B03,083750,Rideout; David Porter,3,0,37,34
1657897909485,MATH 18,B04,083751,Rideout; David Porter,6,0,36,30
1657897909485,MATH 18,B05,093473,Rideout; David Porter,6,0,36,30
1657897909485,MATH 18,B06,093474,Rideout; David Porter,6,0,36,30
1657897915513,MATH 20A,A01,083754,Zheng; Zequn,14,0,40,26
1657897921541,MATH 20B,A01,083756,Briones; Jor-el Thomas Caparas,4,0,36,32
1657897921541,MATH 20B,A02,083757,Briones; Jor-el Thomas Caparas,1,0,36,35
1657897921541,MATH 20B,A03,093475,Briones; Jor-el Thomas Caparas,2,0,36,34
1657897927566,MATH 20C,A01,083760,Briones; Jor-el Thomas Caparas,1,0,35,34
1657897927566,MATH 20C,A02,083761,Briones; Jor-el Thomas Caparas,8,0,35,27
1657897927566,MATH 20C,A03,093476,Briones; Jor-el Thomas Caparas,0,1,36,36
1657897927566,MATH 20C,B01,083762,Bach; Quang Tran,1,0,30,29
1657897933610,MATH 20D,A01,083765,Tran; Brian Kha,5,0,30,25
1657897933610,MATH 20D,A02,083766,Tran; Brian Kha,5,0,30,25
1657897933610,MATH 20D,A03,083767,Tran; Brian Kha,5,0,30,25
1657897939642,MATH 20E,A01,083771,Ganguly; Soumya,10,0,32,22
1657897939642,MATH 20E,A02,083772,Ganguly; Soumya,6,0,32,26
1657897939642,MATH 20E,B01,083773,Ciotti; Benjamin,20,0,35,15
1657897939642,MATH 20E,B02,083774,Ciotti; Benjamin,18,0,35,17
1657897945665,MATH 103A,A01,083777,Greenfeld; Be'Eri,3,0,36,33
1657897945665,MATH 103A,A02,083778,Greenfeld; Be'Eri,5,0,36,31
1657897945665,MATH 103A,A03,093561,Greenfeld; Be'Eri,6,0,36,30
1657897945665,MATH 103A,B01,083779,Greenfeld; Be'Eri,7,0,36,29
1657897945665,MATH 103A,B02,083780,Greenfeld; Be'Eri,4,0,36,32
1657897945665,MATH 103A,B03,093562,Greenfeld; Be'Eri,3,0,36,33
1657897951688,MATH 105,A01,085443,Carter; Anne Toulson,15,0,35,20
1657897951688,MATH 105,A02,093477,Carter; Anne Toulson,20,0,35,15
1657897957725,MATH 109,A01,083213,Ganzberger; Geoffrey Michael,3,0,34,31
1657897957725,MATH 109,A02,083214,Ganzberger; Geoffrey Michael,4,0,34,30
1657897957725,MATH 109,A03,093478,Ganzberger; Geoffrey Michael,2,0,34,32
1657897957725,MATH 109,B01,083215,Ganzberger; Geoffrey Michael,2,0,32,30
1657897957725,MATH 109,B02,083216,Ganzberger; Geoffrey Michael,2,0,32,30
1657897957725,MATH 109,B03,093479,Ganzberger; Geoffrey Michael,8,0,32,24
1657897963747,MATH 142A,A01,083219,Chow; Bennett,7,0,32,25
1657897963747,MATH 142A,A02,083220,Chow; Bennett,10,0,32,22
1657897963747,MATH 142A,A03,093480,Chow; Bennett,9,0,32,23
1657897963747,MATH 142A,B03,093481,Chow; Bennett,8,0,32,24
1657897963747,MATH 142A,B04,093558,Chow; Bennett,13,0,32,19
1657897963747,MATH 142A,B05,093559,Chow; Bennett,7,0,32,25
1657897969771,MATH 193A,A01,083224,Rotar; Vladimir,8,0,34,26
1657897969771,MATH 193A,A02,083225,Rotar; Vladimir,10,0,34,24
1657897969771,MATH 193A,A03,083781,Rotar; Vladimir,5,0,34,29
1657897969771,MATH 193A,A04,083782,Rotar; Vladimir,11,0,34,23
1657897969771,MATH 193A,A05,093482,Rotar; Vladimir,10,0,34,24
1657897975792,MATH 197,001,091859,McAuley; Julian John,9999,0,9999,0
1657897975792,MATH 197,002,095566,Kedlaya; Kiran S.,9997,0,9999,2
1657897975792,MATH 197,003,095567,Xiao; Ming,9999,0,9999,0
1657897975792,MATH 197,004,095571,Perols; Johan Lars,9998,0,9999,1
1657897982853,COGS 9,A01,083615,Shannon; Kyle Michael,10,0,75,65
1657897988876,COGS 11,A01,083617,Boyle; Mary E. T.,23,0,48,25
1657897994898,COGS 13,A01,083071,Bastos; Amalia Pinkusfeld,11,0,71,60
1657898000925,COGS 14A,A01,092681,Semenuks; Arturs,5,1,100,95
1657898006963,COGS 14B,A01,083073,Cheng; Tzu-Han,6,0,63,57
1657898012986,COGS 17,A01,092677,Semenuks; Arturs,6,0,81,75
1657898019013,COGS 100,A01,083619,Allen; Michael Gordon,17,0,70,53
1657898025045,COGS 101A,A01,083621,Davis; Joshua Daniel,9,0,68,59
1657898031072,COGS 101B,A01,091572,Allen; Michael Gordon,13,0,65,52
1657898037094,COGS 101C,A01,083625,Delgado; Tania,17,0,35,18
1657898043117,COGS 107A,A01,083627,Boyle; Mary E. T.,14,0,60,46
1657898049149,COGS 118A,A01,083075,Gupta; Anjum,21,0,76,55
1657898055190,CSE 3,A50,083646,Miranda; Gregory Joseph,24,0,50,26
1657898061213,CSE 8A,A50,083650,Miranda; Gregory Joseph,17,1,56,39
1657898067242,CSE 11,A01,083080,Cao; Yingjun,6,15,40,34
1657898073273,CSE 12,A01,083652,Krause-Levy; Sophia Louisa,30,1,120,90
1657898079307,CSE 15L,A01,083654,Morris; Justin Loren,9,0,50,41
1657898079307,CSE 15L,A02,083655,Morris; Justin Loren,10,0,50,40
1657898085330,CSE 20,A01,083657,Tran; Khoa Dang,39,0,80,41
1657898091354,CSE 21,A01,095574,Bach; Quang Tran,22,0,48,26
1657898097376,CSE 30,A01,083084,Eldon; John,6,0,80,74
1657898097376,CSE 30,B01,095061,Bhaskar; Nishant,9,0,50,41
1657898103405,CSE 100,A01,083659,Cao; Yingjun,5,4,70,65
1657898109432,CSE 134B,A01,083661,Powell; Thomas Allan,24,0,100,76
1657898115459,CSE 140,A01,083663,Gungor; Onat,15,0,85,70
1657898121483,CSE 140L,A01,083088,Eldon; John,23,0,100,77
1657898127579,CSE 175,A01,083665,Kumar; Rakesh,3,0,25,22
1657898133603,CSE 190,A00,092507,Dubnov; Shlomo,8,0,20,12
1657898139634,ECE 45,A01,083139,Congero; Spencer William,6,0,75,69
1657898145657,ECE 65,A50,083695,Saad; Andrew S,12,0,30,18
1657898145657,ECE 65,A51,095125,Saad; Andrew S,24,0,26,2
1657898151705,ECE 109,A01,091882,Touri; Behrouz,20,0,70,50
1657898157732,ECE 180,A00,083140,Abi Samra; Nicholas Camill,1,0,30,29
1657898157732,ECE 180,B00,083141,Abi Samra; Nicholas Camill,0,0,30,30
1657898163756,MATH 10A,A01,083735,Patchell; Gregory David,2,0,30,28
1657898163756,MATH 10A,A02,083736,Patchell; Gregory David,20,0,30,10
1657898163756,MATH 10A,A03,083737,Patchell; Gregory David,16,0,30,14
1657898169788,MATH 10B,A01,083207,Lim; Seonhee,8,0,34,26
1657898169788,MATH 10B,A02,083208,Lim; Seonhee,10,0,35,25
1657898169788,MATH 10B,A03,093472,Lim; Seonhee,7,0,34,27
1657898169788,MATH 10B,B01,083739,Sinha; Shubham,14,0,30,16
1657898175820,MATH 18,A01,083743,Cinel; Cameron Alexander,9,0,30,21
1657898175820,MATH 18,A02,083744,Cinel; Cameron Alexander,18,0,30,12
1657898175820,MATH 18,A03,083745,Cinel; Cameron Alexander,10,0,30,20
1657898175820,MATH 18,B01,083748,Rideout; David Porter,5,0,37,32
1657898175820,MATH 18,B02,083749,Rideout; David Porter,5,0,36,31
1657898175820,MATH 18,B03,083750,Rideout; David Porter,3,0,37,34
1657898175820,MATH 18,B04,083751,Rideout; David Porter,6,0,36,30
1657898175820,MATH 18,B05,093473,Rideout; David Porter,6,0,36,30
1657898175820,MATH 18,B06,093474,Rideout; David Porter,6,0,36,30
1657898181847,MATH 20A,A01,083754,Zheng; Zequn,14,0,40,26
1657898187876,MATH 20B,A01,083756,Briones; Jor-el Thomas Caparas,4,0,36,32
1657898187876,MATH 20B,A02,083757,Briones; Jor-el Thomas Caparas,1,0,36,35
1657898187876,MATH 20B,A03,093475,Briones; Jor-el Thomas Caparas,2,0,36,34
1657898193899,MATH 20C,A01,083760,Briones; Jor-el Thomas Caparas,1,0,35,34
1657898193899,MATH 20C,A02,083761,Briones; Jor-el Thomas Caparas,8,0,35,27
1657898193899,MATH 20C,A03,093476,Briones; Jor-el Thomas Caparas,0,1,36,36
1657898193899,MATH 20C,B01,083762,Bach; Quang Tran,1,0,30,29
1657898199923,MATH 20D,A01,083765,Tran; Brian Kha,5,0,30,25
1657898199923,MATH 20D,A02,083766,Tran; Brian Kha,5,0,30,25
1657898199923,MATH 20D,A03,083767,Tran; Brian Kha,5,0,30,25
1657898205946,MATH 20E,A01,083771,Ganguly; Soumya,10,0,32,22
1657898205946,MATH 20E,A02,083772,Ganguly; Soumya,6,0,32,26
1657898205946,MATH 20E,B01,083773,Ciotti; Benjamin,20,0,35,15
1657898205946,MATH 20E,B02,083774,Ciotti; Benjamin,18,0,35,17
1657898211972,MATH 103A,A01,083777,Greenfeld; Be'Eri,3,0,36,33
1657898211972,MATH 103A,A02,083778,Greenfeld; Be'Eri,5,0,36,31
1657898211972,MATH 103A,A03,093561,Greenfeld; Be'Eri,6,0,36,30
1657898211972,MATH 103A,B01,083779,Greenfeld; Be'Eri,7,0,36,29
1657898211972,MATH 103A,B02,083780,Greenfeld; Be'Eri,4,0,36,32
1657898211972,MATH 103A,B03,093562,Greenfeld; Be'Eri,3,0,36,33
1657898217997,MATH 105,A01,085443,Carter; Anne Toulson,15,0,35,20
1657898217997,MATH 105,A02,093477,Carter; Anne Toulson,20,0,35,15
1657898224022,MATH 109,A01,083213,Ganzberger; Geoffrey Michael,3,0,34,31
1657898224022,MATH 109,A02,083214,Ganzberger; Geoffrey Michael,4,0,34,30
1657898224022,MATH 109,A03,093478,Ganzberger; Geoffrey Michael,2,0,34,32
1657898224022,MATH 109,B01,083215,Ganzberger; Geoffrey Michael,2,0,32,30
1657898224022,MATH 109,B02,083216,Ganzberger; Geoffrey Michael,2,0,32,30
1657898224022,MATH 109,B03,093479,Ganzberger; Geoffrey Michael,8,0,32,24
1657898230047,MATH 142A,A01,083219,Chow; Bennett,7,0,32,25
1657898230047,MATH 142A,A02,083220,Chow; Bennett,10,0,32,22
1657898230047,MATH 142A,A03,093480,Chow; Bennett,9,0,32,23
1657898230047,MATH 142A,B03,093481,Chow; Bennett,8,0,32,24
1657898230047,MATH 142A,B04,093558,Chow; Bennett,13,0,32,19
1657898230047,MATH 142A,B05,093559,Chow; Bennett,7,0,32,25
1657898236075,MATH 193A,A01,083224,Rotar; Vladimir,8,0,34,26
1657898236075,MATH 193A,A02,083225,Rotar; Vladimir,10,0,34,24
1657898236075,MATH 193A,A03,083781,Rotar; Vladimir,5,0,34,29
1657898236075,MATH 193A,A04,083782,Rotar; Vladimir,11,0,34,23
1657898236075,MATH 193A,A05,093482,Rotar; Vladimir,10,0,34,24
1657898242104,MATH 197,001,091859,McAuley; Julian John,9999,0,9999,0
1657898242104,MATH 197,002,095566,Kedlaya; Kiran S.,9997,0,9999,2
1657898242104,MATH 197,003,095567,Xiao; Ming,9999,0,9999,0
1657898242104,MATH 197,004,095571,Perols; Johan Lars,9998,0,9999,1
1657898249166,COGS 9,A01,083615,Shannon; Kyle Michael,10,0,75,65
1657898255189,COGS 11,A01,083617,Boyle; Mary E. T.,23,0,48,25
1657898261224,COGS 13,A01,083071,Bastos; Amalia Pinkusfeld,11,0,71,60
1657898267256,COGS 14A,A01,092681,Semenuks; Arturs,5,1,100,95
1657898273287,COGS 14B,A01,083073,Cheng; Tzu-Han,6,0,63,57
1657898279310,COGS 17,A01,092677,Semenuks; Arturs,6,0,81,75
1657898285334,COGS 100,A01,083619,Allen; Michael Gordon,17,0,70,53
1657898291356,COGS 101A,A01,083621,Davis; Joshua Daniel,9,0,68,59
1657898297379,COGS 101B,A01,091572,Allen; Michael Gordon,13,0,65,52
1657898303401,COGS 101C,A01,083625,Delgado; Tania,17,0,35,18
1657898309433,COGS 107A,A01,083627,Boyle; Mary E. T.,14,0,60,46
1657898315458,COGS 118A,A01,083075,Gupta; Anjum,21,0,76,55
1657898321481,CSE 3,A50,083646,Miranda; Gregory Joseph,24,0,50,26
1657898327506,CSE 8A,A50,083650,Miranda; Gregory Joseph,17,1,56,39
1657898333533,CSE 11,A01,083080,Cao; Yingjun,6,15,40,34
1657898339555,CSE 12,A01,083652,Krause-Levy; Sophia Louisa,30,1,120,90
1657898345581,CSE 15L,A01,083654,Morris; Justin Loren,9,0,50,41
1657898345581,CSE 15L,A02,083655,Morris; Justin Loren,10,0,50,40
1657898351605,CSE 20,A01,083657,Tran; Khoa Dang,39,0,80,41
1657898357629,CSE 21,A01,095574,Bach; Quang Tran,22,0,48,26
1657898363652,CSE 30,A01,083084,Eldon; John,6,0,80,74
1657898363652,CSE 30,B01,095061,Bhaskar; Nishant,9,0,50,41
1657898369678,CSE 100,A01,083659,Cao; Yingjun,5,4,70,65
1657898375700,CSE 134B,A01,083661,Powell; Thomas Allan,25,0,100,75
1657898381727,CSE 140,A01,083663,Gungor; Onat,15,0,85,70
1657898387750,CSE 140L,A01,083088,Eldon; John,23,0,100,77
1657898393772,CSE 175,A01,083665,Kumar; Rakesh,3,0,25,22
1657898399797,CSE 190,A00,092507,Dubnov; Shlomo,8,0,20,12
1657898405819,ECE 45,A01,083139,Congero; Spencer William,6,0,75,69
1657898411847,ECE 65,A50,083695,Saad; Andrew S,12,0,30,18
1657898411847,ECE 65,A51,095125,Saad; Andrew S,24,0,26,2
1657898417870,ECE 109,A01,091882,Touri; Behrouz,20,0,70,50
1657898423892,ECE 180,A00,083140,Abi Samra; Nicholas Camill,1,0,30,29
1657898423892,ECE 180,B00,083141,Abi Samra; Nicholas Camill,0,0,30,30
1657898429919,MATH 10A,A01,083735,Patchell; Gregory David,2,0,30,28
1657898429919,MATH 10A,A02,083736,Patchell; Gregory David,20,0,30,10
1657898429919,MATH 10A,A03,083737,Patchell; Gregory David,16,0,30,14
1657898435949,MATH 10B,A01,083207,Lim; Seonhee,8,0,34,26
1657898435949,MATH 10B,A02,083208,Lim; Seonhee,10,0,35,25
1657898435949,MATH 10B,A03,093472,Lim; Seonhee,7,0,34,27
1657898435949,MATH 10B,B01,083739,Sinha; Shubham,14,0,30,16
1657898441974,MATH 18,A01,083743,Cinel; Cameron Alexander,9,0,30,21
1657898441974,MATH 18,A02,083744,Cinel; Cameron Alexander,18,0,30,12
1657898441974,MATH 18,A03,083745,Cinel; Cameron Alexander,10,0,30,20
1657898441974,MATH 18,B01,083748,Rideout; David Porter,5,0,37,32
1657898441974,MATH 18,B02,083749,Rideout; David Porter,5,0,36,31
1657898441974,MATH 18,B03,083750,Rideout; David Porter,3,0,37,34
1657898441974,MATH 18,B04,083751,Rideout; David Porter,6,0,36,30
1657898441974,MATH 18,B05,093473,Rideout; David Porter,6,0,36,30
1657898441974,MATH 18,B06,093474,Rideout; David Porter,6,0,36,30
1657898448005,MATH 20A,A01,083754,Zheng; Zequn,14,0,40,26
1657898454033,MATH 20B,A01,083756,Briones; Jor-el Thomas Caparas,4,0,36,32
1657898454033,MATH 20B,A02,083757,Briones; Jor-el Thomas Caparas,1,0,36,35
1657898454033,MATH 20B,A03,093475,Briones; Jor-el Thomas Caparas,2,0,36,34
1657898460057,MATH 20C,A01,083760,Briones; Jor-el Thomas Caparas,1,0,35,34
1657898460057,MATH 20C,A02,083761,Briones; Jor-el Thomas Caparas,8,0,35,27
1657898460057,MATH 20C,A03,093476,Briones; Jor-el Thomas Caparas,0,1,36,36
1657898460057,MATH 20C,B01,083762,Bach; Quang Tran,1,0,30,29
1657898466083,MATH 20D,A01,083765,Tran; Brian Kha,5,0,30,25
1657898466083,MATH 20D,A02,083766,Tran; Brian Kha,5,0,30,25
1657898466083,MATH 20D,A03,083767,Tran; Brian Kha,5,0,30,25
1657898472111,MATH 20E,A01,083771,Ganguly; Soumya,10,0,32,22
1657898472111,MATH 20E,A02,083772,Ganguly; Soumya,6,0,32,26
1657898472111,MATH 20E,B01,083773,Ciotti; Benjamin,20,0,35,15
1657898472111,MATH 20E,B02,083774,Ciotti; Benjamin,18,0,35,17
1657898478155,MATH 103A,A01,083777,Greenfeld; Be'Eri,3,0,36,33
1657898478155,MATH 103A,A02,083778,Greenfeld; Be'Eri,5,0,36,31
1657898478155,MATH 103A,A03,093561,Greenfeld; Be'Eri,6,0,36,30
1657898478155,MATH 103A,B01,083779,Greenfeld; Be'Eri,7,0,36,29
1657898478155,MATH 103A,B02,083780,Greenfeld; Be'Eri,4,0,36,32
1657898478155,MATH 103A,B03,093562,Greenfeld; Be'Eri,3,0,36,33
1657898484182,MATH 105,A01,085443,Carter; Anne Toulson,15,0,35,20
1657898484182,MATH 105,A02,093477,Carter; Anne Toulson,20,0,35,15
1657898490211,MATH 109,A01,083213,Ganzberger; Geoffrey Michael,3,0,34,31
1657898490211,MATH 109,A02,083214,Ganzberger; Geoffrey Michael,4,0,34,30
1657898490211,MATH 109,A03,093478,Ganzberger; Geoffrey Michael,2,0,34,32
1657898490211,MATH 109,B01,083215,Ganzberger; Geoffrey Michael,2,0,32,30
1657898490211,MATH 109,B02,083216,Ganzberger; Geoffrey Michael,2,0,32,30
1657898490211,MATH 109,B03,093479,Ganzberger; Geoffrey Michael,8,0,32,24
1657898496239,MATH 142A,A01,083219,Chow; Bennett,7,0,32,25
1657898496239,MATH 142A,A02,083220,Chow; Bennett,10,0,32,22
1657898496239,MATH 142A,A03,093480,Chow; Bennett,9,0,32,23
1657898496239,MATH 142A,B03,093481,Chow; Bennett,8,0,32,24
1657898496239,MATH 142A,B04,093558,Chow; Bennett,13,0,32,19
1657898496239,MATH 142A,B05,093559,Chow; Bennett,7,0,32,25
1657898502274,MATH 193A,A01,083224,Rotar; Vladimir,8,0,34,26
1657898502274,MATH 193A,A02,083225,Rotar; Vladimir,10,0,34,24
1657898502274,MATH 193A,A03,083781,Rotar; Vladimir,5,0,34,29
1657898502274,MATH 193A,A04,083782,Rotar; Vladimir,11,0,34,23
1657898502274,MATH 193A,A05,093482,Rotar; Vladimir,10,0,34,24
1657898508297,MATH 197,001,091859,McAuley; Julian John,9999,0,9999,0
1657898508297,MATH 197,002,095566,Kedlaya; Kiran S.,9997,0,9999,2
1657898508297,MATH 197,003,095567,Xiao; Ming,9999,0,9999,0
1657898508297,MATH 197,004,095571,Perols; Johan Lars,9998,0,9999,1
1657898515364,COGS 9,A01,083615,Shannon; Kyle Michael,10,0,75,65
1657898521392,COGS 11,A01,083617,Boyle; Mary E. T.,23,0,48,25
1657898527415,COGS 13,A01,083071,Bastos; Amalia Pinkusfeld,11,0,71,60
1657898533441,COGS 14A,A01,092681,Semenuks; Arturs,5,1,100,95
1657898539472,COGS 14B,A01,083073,Cheng; Tzu-Han,6,0,63,57
1657898545494,COGS 17,A01,092677,Semenuks; Arturs,6,0,81,75
1657898551517,COGS 100,A01,083619,Allen; Michael Gordon,17,0,70,53
1657898557546,COGS 101A,A01,083621,Davis; Joshua Daniel,9,0,68,59
1657898563570,COGS 101B,A01,091572,Allen; Michael Gordon,13,0,65,52
1657898569596,COGS 101C,A01,083625,Delgado; Tania,17,0,35,18
1657898575619,COGS 107A,A01,083627,Boyle; Mary E. T.,14,0,60,46
1657898581653,COGS 118A,A01,083075,Gupta; Anjum,21,0,76,55
1657898587693,CSE 3,A50,083646,Miranda; Gregory Joseph,24,0,50,26
1657898593718,CSE 8A,A50,083650,Miranda; Gregory Joseph,17,1,56,39
1657898599743,CSE 11,A01,083080,Cao; Yingjun,6,15,40,34
1657898605772,CSE 12,A01,083652,Krause-Levy; Sophia Louisa,30,1,120,90
1657898611796,CSE 15L,A01,083654,Morris; Justin Loren,9,0,50,41
1657898611796,CSE 15L,A02,083655,Morris; Justin Loren,10,0,50,40
1657898617822,CSE 20,A01,083657,Tran; Khoa Dang,39,0,80,41
1657898623849,CSE 21,A01,095574,Bach; Quang Tran,22,0,48,26
1657898629874,CSE 30,A01,083084,Eldon; John,6,0,80,74
1657898629874,CSE 30,B01,095061,Bhaskar; Nishant,9,0,50,41
1657898635897,CSE 100,A01,083659,Cao; Yingjun,5,4,70,65
1657898641919,CSE 134B,A01,083661,Powell; Thomas Allan,25,0,100,75
1657898647947,CSE 140,A01,083663,Gungor; Onat,15,0,85,70
1657898653970,CSE 140L,A01,083088,Eldon; John,23,0,100,77
1657898659995,CSE 175,A01,083665,Kumar; Rakesh,3,0,25,22
1657898666018,CSE 190,A00,092507,Dubnov; Shlomo,8,0,20,12
1657898672042,ECE 45,A01,083139,Congero; Spencer William,6,0,75,69
1657898678069,ECE 65,A50,083695,Saad; Andrew S,12,0,30,18
1657898678069,ECE 65,A51,095125,Saad; Andrew S,24,0,26,2
1657898684095,ECE 109,A01,091882,Touri; Behrouz,20,0,70,50
1657898690119,ECE 180,A00,083140,Abi Samra; Nicholas Camill,1,0,30,29
1657898690119,ECE 180,B00,083141,Abi Samra; Nicholas Camill,0,0,30,30
1657898696148,MATH 10A,A01,083735,Patchell; Gregory David,2,0,30,28
1657898696148,MATH 10A,A02,083736,Patchell; Gregory David,20,0,30,10
1657898696148,MATH 10A,A03,083737,Patchell; Gregory David,16,0,30,14
1657898702181,MATH 10B,A01,083207,Lim; Seonhee,8,0,34,26
1657898702181,MATH 10B,A02,083208,Lim; Seonhee,10,0,35,25
1657898702181,MATH 10B,A03,093472,Lim; Seonhee,7,0,34,27
1657898702181,MATH 10B,B01,083739,Sinha; Shubham,14,0,30,16
1657898708215,MATH 18,A01,083743,Cinel; Cameron Alexander,9,0,30,21
1657898708215,MATH 18,A02,083744,Cinel; Cameron Alexander,18,0,30,12
1657898708215,MATH 18,A03,083745,Cinel; Cameron Alexander,10,0,30,20
1657898708215,MATH 18,B01,083748,Rideout; David Porter,5,0,37,32
1657898708215,MATH 18,B02,083749,Rideout; David Porter,5,0,36,31
1657898708215,MATH 18,B03,083750,Rideout; David Porter,3,0,37,34
1657898708215,MATH 18,B04,083751,Rideout; David Porter,6,0,36,30
1657898708215,MATH 18,B05,093473,Rideout; David Porter,6,0,36,30
1657898708215,MATH 18,B06,093474,Rideout; David Porter,6,0,36,30
1657898714237,MATH 20A,A01,083754,Zheng; Zequn,14,0,40,26
1657898720268,MATH 20B,A01,083756,Briones; Jor-el Thomas Caparas,4,0,36,32
1657898720268,MATH 20B,A02,083757,Briones; Jor-el Thomas Caparas,1,0,36,35
1657898720268,MATH 20B,A03,093475,Briones; Jor-el Thomas Caparas,2,0,36,34
1657898726367,MATH 20C,A01,083760,Briones; Jor-el Thomas Caparas,1,0,35,34
1657898726367,MATH 20C,A02,083761,Briones; Jor-el Thomas Caparas,8,0,35,27
1657898726367,MATH 20C,A03,093476,Briones; Jor-el Thomas Caparas,0,1,36,36
1657898726367,MATH 20C,B01,083762,Bach; Quang Tran,1,0,30,29
1657898732390,MATH 20D,A01,083765,Tran; Brian Kha,5,0,30,25
1657898732390,MATH 20D,A02,083766,Tran; Brian Kha,5,0,30,25
1657898732390,MATH 20D,A03,083767,Tran; Brian Kha,5,0,30,25
1657898738419,MATH 20E,A01,083771,Ganguly; Soumya,10,0,32,22
1657898738419,MATH 20E,A02,083772,Ganguly; Soumya,6,0,32,26
1657898738419,MATH 20E,B01,083773,Ciotti; Benjamin,20,0,35,15
1657898738419,MATH 20E,B02,083774,Ciotti; Benjamin,18,0,35,17
1657898744445,MATH 103A,A01,083777,Greenfeld; Be'Eri,3,0,36,33
1657898744445,MATH 103A,A02,083778,Greenfeld; Be'Eri,5,0,36,31
1657898744445,MATH 103A,A03,093561,Greenfeld; Be'Eri,6,0,36,30
1657898744445,MATH 103A,B01,083779,Greenfeld; Be'Eri,7,0,36,29
1657898744445,MATH 103A,B02,083780,Greenfeld; Be'Eri,4,0,36,32
1657898744445,MATH 103A,B03,093562,Greenfeld; Be'Eri,3,0,36,33
1657898750470,MATH 105,A01,085443,Carter; Anne Toulson,15,0,35,20
1657898750470,MATH 105,A02,093477,Carter; Anne Toulson,20,0,35,15
1657898756500,MATH 109,A01,083213,Ganzberger; Geoffrey Michael,3,0,34,31
1657898756500,MATH 109,A02,083214,Ganzberger; Geoffrey Michael,4,0,34,30
1657898756500,MATH 109,A03,093478,Ganzberger; Geoffrey Michael,2,0,34,32
1657898756500,MATH 109,B01,083215,Ganzberger; Geoffrey Michael,2,0,32,30
1657898756500,MATH 109,B02,083216,Ganzberger; Geoffrey Michael,2,0,32,30
1657898756500,MATH 109,B03,093479,Ganzberger; Geoffrey Michael,8,0,32,24
1657898762532,MATH 142A,A01,083219,Chow; Bennett,7,0,32,25
1657898762532,MATH 142A,A02,083220,Chow; Bennett,10,0,32,22
1657898762532,MATH 142A,A03,093480,Chow; Bennett,9,0,32,23
1657898762532,MATH 142A,B03,093481,Chow; Bennett,8,0,32,24
1657898762532,MATH 142A,B04,093558,Chow; Bennett,13,0,32,19
1657898762532,MATH 142A,B05,093559,Chow; Bennett,7,0,32,25
1657898768560,MATH 193A,A01,083224,Rotar; Vladimir,8,0,34,26
1657898768560,MATH 193A,A02,083225,Rotar; Vladimir,10,0,34,24
1657898768560,MATH 193A,A03,083781,Rotar; Vladimir,5,0,34,29
1657898768560,MATH 193A,A04,083782,Rotar; Vladimir,11,0,34,23
1657898768560,MATH 193A,A05,093482,Rotar; Vladimir,10,0,34,24
1657898774590,MATH 197,001,091859,McAuley; Julian John,9999,0,9999,0
1657898774590,MATH 197,002,095566,Kedlaya; Kiran S.,9997,0,9999,2
1657898774590,MATH 197,003,095567,Xiao; Ming,9999,0,9999,0
1657898774590,MATH 197,004,095571,Perols; Johan Lars,9998,0,9999,1
1657898781645,COGS 9,A01,083615,Shannon; Kyle Michael,10,0,75,65
1657898787685,COGS 11,A01,083617,Boyle; Mary E. T.,23,0,48,25
1657898793708,COGS 13,A01,083071,Bastos; Amalia Pinkusfeld,11,0,71,60
1657898799743,COGS 14A,A01,092681,Semenuks; Arturs,5,1,100,95
1657898805765,COGS 14B,A01,083073,Cheng; Tzu-Han,6,0,63,57
1657898811800,COGS 17,A01,092677,Semenuks; Arturs,6,0,81,75
1657898817823,COGS 100,A01,083619,Allen; Michael Gordon,17,0,70,53
1657898823847,COGS 101A,A01,083621,Davis; Joshua Daniel,9,0,68,59
1657898829871,COGS 101B,A01,091572,Allen; Michael Gordon,13,0,65,52
1657898835902,COGS 101C,A01,083625,Delgado; Tania,17,0,35,18
1657898841930,COGS 107A,A01,083627,Boyle; Mary E. T.,14,0,60,46
1657898847956,COGS 118A,A01,083075,Gupta; Anjum,21,0,76,55
1657898853979,CSE 3,A50,083646,Miranda; Gregory Joseph,24,0,50,26
1657898860009,CSE 8A,A50,083650,Miranda; Gregory Joseph,17,1,56,39
1657898866035,CSE 11,A01,083080,Cao; Yingjun,6,15,40,34
1657898872074,CSE 12,A01,083652,Krause-Levy; Sophia Louisa,30,1,120,90
1657898878097,CSE 15L,A01,083654,Morris; Justin Loren,9,0,50,41
1657898878097,CSE 15L,A02,083655,Morris; Justin Loren,10,0,50,40
1657898884129,CSE 20,A01,083657,Tran; Khoa Dang,39,0,80,41
1657898890162,CSE 21,A01,095574,Bach; Quang Tran,22,0,48,26
1657898896216,CSE 30,A01,083084,Eldon; John,6,0,80,74
1657898896216,CSE 30,B01,095061,Bhaskar; Nishant,9,0,50,41
1657898902242,CSE 100,A01,083659,Cao; Yingjun,5,4,70,65
1657898908271,CSE 134B,A01,083661,Powell; Thomas Allan,25,0,100,75
1657898914306,CSE 140,A01,083663,Gungor; Onat,15,0,85,70
1657898920333,CSE 140L,A01,083088,Eldon; John,23,0,100,77
1657898926356,CSE 175,A01,083665,Kumar; Rakesh,3,0,25,22
1657898932380,CSE 190,A00,092507,Dubnov; Shlomo,8,0,20,12
1657898938407,ECE 45,A01,083139,Congero; Spencer William,6,0,75,69
1657898944432,ECE 65,A50,083695,Saad; Andrew S,12,0,30,18
1657898944432,ECE 65,A51,095125,Saad; Andrew S,24,0,26,2
1657898950453,ECE 109,A01,091882,Touri; Behrouz,20,0,70,50
1657898956475,ECE 180,A00,083140,Abi Samra; Nicholas Camill,1,0,30,29
1657898956475,ECE 180,B00,083141,Abi Samra; Nicholas Camill,0,0,30,30
1657898962500,MATH 10A,A01,083735,Patchell; Gregory David,2,0,30,28
1657898962500,MATH 10A,A02,083736,Patchell; Gregory David,20,0,30,10
1657898962500,MATH 10A,A03,083737,Patchell; Gregory David,16,0,30,14
1657898968529,MATH 10B,A01,083207,Lim; Seonhee,8,0,34,26
1657898968529,MATH 10B,A02,083208,Lim; Seonhee,10,0,35,25
1657898968529,MATH 10B,A03,093472,Lim; Seonhee,7,0,34,27
1657898968529,MATH 10B,B01,083739,Sinha; Shubham,14,0,30,16
1657898974564,MATH 18,A01,083743,Cinel; Cameron Alexander,9,0,30,21
1657898974564,MATH 18,A02,083744,Cinel; Cameron Alexander,18,0,30,12
1657898974564,MATH 18,A03,083745,Cinel; Cameron Alexander,10,0,30,20
1657898974564,MATH 18,B01,083748,Rideout; David Porter,5,0,37,32
1657898974564,MATH 18,B02,083749,Rideout; David Porter,5,0,36,31
1657898974564,MATH 18,B03,083750,Rideout; David Porter,3,0,37,34
1657898974564,MATH 18,B04,083751,Rideout; David Porter,6,0,36,30
1657898974564,MATH 18,B05,093473,Rideout; David Porter,6,0,36,30
1657898974564,MATH 18,B06,093474,Rideout; David Porter,6,0,36,30
1657898980588,MATH 20A,A01,083754,Zheng; Zequn,14,0,40,26
1657898986613,MATH 20B,A01,083756,Briones; Jor-el Thomas Caparas,4,0,36,32
1657898986613,MATH 20B,A02,083757,Briones; Jor-el Thomas Caparas,1,0,36,35
1657898986613,MATH 20B,A03,093475,Briones; Jor-el Thomas Caparas,2,0,36,34
1657898992642,MATH 20C,A01,083760,Briones; Jor-el Thomas Caparas,1,0,35,34
1657898992642,MATH 20C,A02,083761,Briones; Jor-el Thomas Caparas,8,0,35,27
1657898992642,MATH 20C,A03,093476,Briones; Jor-el Thomas Caparas,0,1,36,36
1657898992642,MATH 20C,B01,083762,Bach; Quang Tran,1,0,30,29
1657898998666,MATH 20D,A01,083765,Tran; Brian Kha,5,0,30,25
1657898998666,MATH 20D,A02,083766,Tran; Brian Kha,5,0,30,25
1657898998666,MATH 20D,A03,083767,Tran; Brian Kha,5,0,30,25
1657899004689,MATH 20E,A01,083771,Ganguly; Soumya,10,0,32,22
1657899004689,MATH 20E,A02,083772,Ganguly; Soumya,6,0,32,26
1657899004689,MATH 20E,B01,083773,Ciotti; Benjamin,20,0,35,15
1657899004689,MATH 20E,B02,083774,Ciotti; Benjamin,18,0,35,17
1657899010717,MATH 103A,A01,083777,Greenfeld; Be'Eri,3,0,36,33
1657899010717,MATH 103A,A02,083778,Greenfeld; Be'Eri,5,0,36,31
1657899010717,MATH 103A,A03,093561,Greenfeld; Be'Eri,6,0,36,30
1657899010717,MATH 103A,B01,083779,Greenfeld; Be'Eri,7,0,36,29
1657899010717,MATH 103A,B02,083780,Greenfeld; Be'Eri,4,0,36,32
1657899010717,MATH 103A,B03,093562,Greenfeld; Be'Eri,3,0,36,33
1657899016740,MATH 105,A01,085443,Carter; Anne Toulson,15,0,35,20
1657899016740,MATH 105,A02,093477,Carter; Anne Toulson,20,0,35,15
1657899022775,MATH 109,A01,083213,Ganzberger; Geoffrey Michael,3,0,34,31
1657899022775,MATH 109,A02,083214,Ganzberger; Geoffrey Michael,4,0,34,30
1657899022775,MATH 109,A03,093478,Ganzberger; Geoffrey Michael,2,0,34,32
1657899022775,MATH 109,B01,083215,Ganzberger; Geoffrey Michael,2,0,32,30
1657899022775,MATH 109,B02,083216,Ganzberger; Geoffrey Michael,2,0,32,30
1657899022775,MATH 109,B03,093479,Ganzberger; Geoffrey Michael,8,0,32,24
1657899028799,MATH 142A,A01,083219,Chow; Bennett,7,0,32,25
1657899028799,MATH 142A,A02,083220,Chow; Bennett,10,0,32,22
1657899028799,MATH 142A,A03,093480,Chow; Bennett,9,0,32,23
1657899028799,MATH 142A,B03,093481,Chow; Bennett,8,0,32,24
1657899028799,MATH 142A,B04,093558,Chow; Bennett,13,0,32,19
1657899028799,MATH 142A,B05,093559,Chow; Bennett,7,0,32,25
1657899034840,MATH 193A,A01,083224,Rotar; Vladimir,8,0,34,26
1657899034840,MATH 193A,A02,083225,Rotar; Vladimir,10,0,34,24
1657899034840,MATH 193A,A03,083781,Rotar; Vladimir,5,0,34,29
1657899034840,MATH 193A,A04,083782,Rotar; Vladimir,11,0,34,23
1657899034840,MATH 193A,A05,093482,Rotar; Vladimir,10,0,34,24
1657899040866,MATH 197,001,091859,McAuley; Julian John,9999,0,9999,0
1657899040866,MATH 197,002,095566,Kedlaya; Kiran S.,9997,0,9999,2
1657899040866,MATH 197,003,095567,Xiao; Ming,9999,0,9999,0
1657899040866,MATH 197,004,095571,Perols; Johan Lars,9998,0,9999,1
1657899047936,COGS 9,A01,083615,Shannon; Kyle Michael,10,0,75,65
1657899053959,COGS 11,A01,083617,Boyle; Mary E. T.,23,0,48,25
1657899059985,COGS 13,A01,083071,Bastos; Amalia Pinkusfeld,11,0,71,60
1657899066009,COGS 14A,A01,092681,Semenuks; Arturs,5,1,100,95
1657899072031,COGS 14B,A01,083073,Cheng; Tzu-Han,6,0,63,57
1657899078054,COGS 17,A01,092677,Semenuks; Arturs,6,0,81,75
1657899084076,COGS 100,A01,083619,Allen; Michael Gordon,17,0,70,53
1657899090110,COGS 101A,A01,083621,Davis; Joshua Daniel,9,0,68,59
1657899096137,COGS 101B,A01,091572,Allen; Michael Gordon,13,0,65,52
1657899102162,COGS 101C,A01,083625,Delgado; Tania,17,0,35,18
1657899108188,COGS 107A,A01,083627,Boyle; Mary E. T.,14,0,60,46
1657899114212,COGS 118A,A01,083075,Gupta; Anjum,21,0,76,55
1657899120242,CSE 3,A50,083646,Miranda; Gregory Joseph,24,0,50,26
1657899126265,CSE 8A,A50,083650,Miranda; Gregory Joseph,17,1,56,39
1657899132291,CSE 11,A01,083080,Cao; Yingjun,6,15,40,34
1657899138314,CSE 12,A01,083652,Krause-Levy; Sophia Louisa,30,1,120,90
1657899144349,CSE 15L,A01,083654,Morris; Justin Loren,9,0,50,41
1657899144349,CSE 15L,A02,083655,Morris; Justin Loren,10,0,50,40
1657899150373,CSE 20,A01,083657,Tran; Khoa Dang,39,0,80,41
1657899156397,CSE 21,A01,095574,Bach; Quang Tran,22,0,48,26
1657899162419,CSE 30,A01,083084,Eldon; John,6,0,80,74
1657899162419,CSE 30,B01,095061,Bhaskar; Nishant,9,0,50,41
1657899168449,CSE 100,A01,083659,Cao; Yingjun,5,4,70,65
1657899174472,CSE 134B,A01,083661,Powell; Thomas Allan,25,0,100,75
1657899180503,CSE 140,A01,083663,Gungor; Onat,15,0,85,70
1657899186529,CSE 140L,A01,083088,Eldon; John,23,0,100,77
1657899192553,CSE 175,A01,083665,Kumar; Rakesh,3,0,25,22
1657899198580,CSE 190,A00,092507,Dubnov; Shlomo,8,0,20,12
1657899204603,ECE 45,A01,083139,Congero; Spencer William,6,0,75,69
1657899210629,ECE 65,A50,083695,Saad; Andrew S,12,0,30,18
1657899210629,ECE 65,A51,095125,Saad; Andrew S,24,0,26,2
1657899216657,ECE 109,A01,091882,Touri; Behrouz,20,0,70,50
1657899222690,ECE 180,A00,083140,Abi Samra; Nicholas Camill,1,0,30,29
1657899222690,ECE 180,B00,083141,Abi Samra; Nicholas Camill,0,0,30,30
1657899228714,MATH 10A,A01,083735,Patchell; Gregory David,2,0,30,28
1657899228714,MATH 10A,A02,083736,Patchell; Gregory David,20,0,30,10
1657899228714,MATH 10A,A03,083737,Patchell; Gregory David,16,0,30,14
1657899234743,MATH 10B,A01,083207,Lim; Seonhee,8,0,34,26
1657899234743,MATH 10B,A02,083208,Lim; Seonhee,10,0,35,25
1657899234743,MATH 10B,A03,093472,Lim; Seonhee,7,0,34,27
1657899234743,MATH 10B,B01,083739,Sinha; Shubham,14,0,30,16
1657899240770,MATH 18,A01,083743,Cinel; Cameron Alexander,9,0,30,21
1657899240770,MATH 18,A02,083744,Cinel; Cameron Alexander,18,0,30,12
1657899240770,MATH 18,A03,083745,Cinel; Cameron Alexander,10,0,30,20
1657899240770,MATH 18,B01,083748,Rideout; David Porter,5,0,37,32
1657899240770,MATH 18,B02,083749,Rideout; David Porter,5,0,36,31
1657899240770,MATH 18,B03,083750,Rideout; David Porter,3,0,37,34
1657899240770,MATH 18,B04,083751,Rideout; David Porter,6,0,36,30
1657899240770,MATH 18,B05,093473,Rideout; David Porter,6,0,36,30
1657899240770,MATH 18,B06,093474,Rideout; David Porter,6,0,36,30
1657899246799,MATH 20A,A01,083754,Zheng; Zequn,14,0,40,26
1657899252827,MATH 20B,A01,083756,Briones; Jor-el Thomas Caparas,4,0,36,32
1657899252827,MATH 20B,A02,083757,Briones; Jor-el Thomas Caparas,1,0,36,35
1657899252827,MATH 20B,A03,093475,Briones; Jor-el Thomas Caparas,2,0,36,34
1657899258856,MATH 20C,A01,083760,Briones; Jor-el Thomas Caparas,1,0,35,34
1657899258856,MATH 20C,A02,083761,Briones; Jor-el Thomas Caparas,8,0,35,27
1657899258856,MATH 20C,A03,093476,Briones; Jor-el Thomas Caparas,0,1,36,36
1657899258856,MATH 20C,B01,083762,Bach; Quang Tran,1,0,30,29
1657899264884,MATH 20D,A01,083765,Tran; Brian Kha,5,0,30,25
1657899264884,MATH 20D,A02,083766,Tran; Brian Kha,5,0,30,25
1657899264884,MATH 20D,A03,083767,Tran; Brian Kha,5,0,30,25
1657899270911,MATH 20E,A01,083771,Ganguly; Soumya,10,0,32,22
1657899270911,MATH 20E,A02,083772,Ganguly; Soumya,6,0,32,26
1657899270911,MATH 20E,B01,083773,Ciotti; Benjamin,20,0,35,15
1657899270911,MATH 20E,B02,083774,Ciotti; Benjamin,18,0,35,17
1657899276935,MATH 103A,A01,083777,Greenfeld; Be'Eri,3,0,36,33
1657899276935,MATH 103A,A02,083778,Greenfeld; Be'Eri,5,0,36,31
1657899276935,MATH 103A,A03,093561,Greenfeld; Be'Eri,6,0,36,30
1657899276935,MATH 103A,B01,083779,Greenfeld; Be'Eri,7,0,36,29
1657899276935,MATH 103A,B02,083780,Greenfeld; Be'Eri,4,0,36,32
1657899276935,MATH 103A,B03,093562,Greenfeld; Be'Eri,3,0,36,33
1657899282963,MATH 105,A01,085443,Carter; Anne Toulson,15,0,35,20
1657899282963,MATH 105,A02,093477,Carter; Anne Toulson,20,0,35,15
1657899288992,MATH 109,A01,083213,Ganzberger; Geoffrey Michael,3,0,34,31
1657899288992,MATH 109,A02,083214,Ganzberger; Geoffrey Michael,4,0,34,30
1657899288992,MATH 109,A03,093478,Ganzberger; Geoffrey Michael,2,0,34,32
1657899288992,MATH 109,B01,083215,Ganzberger; Geoffrey Michael,2,0,32,30
1657899288992,MATH 109,B02,083216,Ganzberger; Geoffrey Michael,2,0,32,30
1657899288992,MATH 109,B03,093479,Ganzberger; Geoffrey Michael,8,0,32,24
1657899295017,MATH 142A,A01,083219,Chow; Bennett,7,0,32,25
1657899295017,MATH 142A,A02,083220,Chow; Bennett,10,0,32,22
1657899295017,MATH 142A,A03,093480,Chow; Bennett,9,0,32,23
1657899295017,MATH 142A,B03,093481,Chow; Bennett,8,0,32,24
1657899295017,MATH 142A,B04,093558,Chow; Bennett,13,0,32,19
1657899295017,MATH 142A,B05,093559,Chow; Bennett,7,0,32,25
1657899301045,MATH 193A,A01,083224,Rotar; Vladimir,8,0,34,26
1657899301045,MATH 193A,A02,083225,Rotar; Vladimir,10,0,34,24
1657899301045,MATH 193A,A03,083781,Rotar; Vladimir,5,0,34,29
1657899301045,MATH 193A,A04,083782,Rotar; Vladimir,11,0,34,23
1657899301045,MATH 193A,A05,093482,Rotar; Vladimir,10,0,34,24
1657899307069,MATH 197,001,091859,McAuley; Julian John,9999,0,9999,0
1657899307069,MATH 197,002,095566,Kedlaya; Kiran S.,9997,0,9999,2
1657899307069,MATH 197,003,095567,Xiao; Ming,9999,0,9999,0
1657899307069,MATH 197,004,095571,Perols; Johan Lars,9998,0,9999,1
1657899314129,COGS 9,A01,083615,Shannon; Kyle Michael,10,0,75,65
1657899320230,COGS 11,A01,083617,Boyle; Mary E. T.,23,0,48,25
1657899326271,COGS 13,A01,083071,Bastos; Amalia Pinkusfeld,11,0,71,60
1657899332301,COGS 14A,A01,092681,Semenuks; Arturs,5,1,100,95
1657899338324,COGS 14B,A01,083073,Cheng; Tzu-Han,6,0,63,57
1657899344347,COGS 17,A01,092677,Semenuks; Arturs,6,0,81,75
1657899350384,COGS 100,A01,083619,Allen; Michael Gordon,17,0,70,53
1657899356411,COGS 101A,A01,083621,Davis; Joshua Daniel,9,0,68,59
1657899362436,COGS 101B,A01,091572,Allen; Michael Gordon,13,0,65,52
1657899368459,COGS 101C,A01,083625,Delgado; Tania,17,0,35,18
1657899374483,COGS 107A,A01,083627,Boyle; Mary E. T.,14,0,60,46
1657899380506,COGS 118A,A01,083075,Gupta; Anjum,21,0,76,55
1657899386533,CSE 3,A50,083646,Miranda; Gregory Joseph,24,0,50,26
1657899392556,CSE 8A,A50,083650,Miranda; Gregory Joseph,17,1,56,39
1657899398580,CSE 11,A01,083080,Cao; Yingjun,6,15,40,34
1657899404606,CSE 12,A01,083652,Krause-Levy; Sophia Louisa,30,1,120,90
1657899410632,CSE 15L,A01,083654,Morris; Justin Loren,9,0,50,41
1657899410632,CSE 15L,A02,083655,Morris; Justin Loren,10,0,50,40
1657899416658,CSE 20,A01,083657,Tran; Khoa Dang,39,0,80,41
1657899422686,CSE 21,A01,095574,Bach; Quang Tran,22,0,48,26
1657899428709,CSE 30,A01,083084,Eldon; John,6,0,80,74
1657899428709,CSE 30,B01,095061,Bhaskar; Nishant,9,0,50,41
1657899434731,CSE 100,A01,083659,Cao; Yingjun,5,4,70,65
1657899440755,CSE 134B,A01,083661,Powell; Thomas Allan,25,0,100,75
1657899446777,CSE 140,A01,083663,Gungor; Onat,15,0,85,70
1657899452800,CSE 140L,A01,083088,Eldon; John,23,0,100,77
1657899458826,CSE 175,A01,083665,Kumar; Rakesh,3,0,25,22
1657899464854,CSE 190,A00,092507,Dubnov; Shlomo,8,0,20,12
1657899470880,ECE 45,A01,083139,Congero; Spencer William,6,0,75,69
1657899476913,ECE 65,A50,083695,Saad; Andrew S,12,0,30,18
1657899476913,ECE 65,A51,095125,Saad; Andrew S,24,0,26,2
1657899482961,ECE 109,A01,091882,Touri; Behrouz,20,0,70,50
1657899488988,ECE 180,A00,083140,Abi Samra; Nicholas Camill,1,0,30,29
1657899488988,ECE 180,B00,083141,Abi Samra; Nicholas Camill,0,0,30,30
1657899495012,MATH 10A,A01,083735,Patchell; Gregory David,2,0,30,28
1657899495012,MATH 10A,A02,083736,Patchell; Gregory David,20,0,30,10
1657899495012,MATH 10A,A03,083737,Patchell; Gregory David,16,0,30,14
1657899501036,MATH 10B,A01,083207,Lim; Seonhee,8,0,34,26
1657899501036,MATH 10B,A02,083208,Lim; Seonhee,10,0,35,25
1657899501036,MATH 10B,A03,093472,Lim; Seonhee,7,0,34,27
1657899501036,MATH 10B,B01,083739,Sinha; Shubham,14,0,30,16
1657899507067,MATH 18,A01,083743,Cinel; Cameron Alexander,9,0,30,21
1657899507067,MATH 18,A02,083744,Cinel; Cameron Alexander,18,0,30,12
1657899507067,MATH 18,A03,083745,Cinel; Cameron Alexander,10,0,30,20
1657899507067,MATH 18,B01,083748,Rideout; David Porter,5,0,37,32
1657899507067,MATH 18,B02,083749,Rideout; David Porter,5,0,36,31
1657899507067,MATH 18,B03,083750,Rideout; David Porter,3,0,37,34
1657899507067,MATH 18,B04,083751,Rideout; David Porter,6,0,36,30
1657899507067,MATH 18,B05,093473,Rideout; David Porter,6,0,36,30
1657899507067,MATH 18,B06,093474,Rideout; David Porter,6,0,36,30
1657899513090,MATH 20A,A01,083754,Zheng; Zequn,14,0,40,26
1657899519114,MATH 20B,A01,083756,Briones; Jor-el Thomas Caparas,4,0,36,32
1657899519114,MATH 20B,A02,083757,Briones; Jor-el Thomas Caparas,1,0,36,35
1657899519114,MATH 20B,A03,093475,Briones; Jor-el Thomas Caparas,2,0,36,34
1657899525138,MATH 20C,A01,083760,Briones; Jor-el Thomas Caparas,1,0,35,34
1657899525138,MATH 20C,A02,083761,Briones; Jor-el Thomas Caparas,8,0,35,27
1657899525138,MATH 20C,A03,093476,Briones; Jor-el Thomas Caparas,0,1,36,36
1657899525138,MATH 20C,B01,083762,Bach; Quang Tran,1,0,30,29
1657899531167,MATH 20D,A01,083765,Tran; Brian Kha,5,0,30,25
1657899531167,MATH 20D,A02,083766,Tran; Brian Kha,5,0,30,25
1657899531167,MATH 20D,A03,083767,Tran; Brian Kha,5,0,30,25
1657899537189,MATH 20E,A01,083771,Ganguly; Soumya,10,0,32,22
1657899537189,MATH 20E,A02,083772,Ganguly; Soumya,6,0,32,26
1657899537189,MATH 20E,B01,083773,Ciotti; Benjamin,20,0,35,15
1657899537189,MATH 20E,B02,083774,Ciotti; Benjamin,18,0,35,17
1657899543218,MATH 103A,A01,083777,Greenfeld; Be'Eri,3,0,36,33
1657899543218,MATH 103A,A02,083778,Greenfeld; Be'Eri,5,0,36,31
1657899543218,MATH 103A,A03,093561,Greenfeld; Be'Eri,6,0,36,30
1657899543218,MATH 103A,B01,083779,Greenfeld; Be'Eri,7,0,36,29
1657899543218,MATH 103A,B02,083780,Greenfeld; Be'Eri,4,0,36,32
1657899543218,MATH 103A,B03,093562,Greenfeld; Be'Eri,3,0,36,33
1657899549245,MATH 105,A01,085443,Carter; Anne Toulson,15,0,35,20
1657899549245,MATH 105,A02,093477,Carter; Anne Toulson,20,0,35,15
1657899555295,MATH 109,A01,083213,Ganzberger; Geoffrey Michael,3,0,34,31
1657899555295,MATH 109,A02,083214,Ganzberger; Geoffrey Michael,4,0,34,30
1657899555295,MATH 109,A03,093478,Ganzberger; Geoffrey Michael,2,0,34,32
1657899555295,MATH 109,B01,083215,Ganzberger; Geoffrey Michael,2,0,32,30
1657899555295,MATH 109,B02,083216,Ganzberger; Geoffrey Michael,2,0,32,30
1657899555295,MATH 109,B03,093479,Ganzberger; Geoffrey Michael,8,0,32,24
1657899561317,MATH 142A,A01,083219,Chow; Bennett,7,0,32,25
1657899561317,MATH 142A,A02,083220,Chow; Bennett,10,0,32,22
1657899561317,MATH 142A,A03,093480,Chow; Bennett,9,0,32,23
1657899561317,MATH 142A,B03,093481,Chow; Bennett,8,0,32,24
1657899561317,MATH 142A,B04,093558,Chow; Bennett,13,0,32,19
1657899561317,MATH 142A,B05,093559,Chow; Bennett,7,0,32,25
1657899567339,MATH 193A,A01,083224,Rotar; Vladimir,8,0,34,26
1657899567339,MATH 193A,A02,083225,Rotar; Vladimir,10,0,34,24
1657899567339,MATH 193A,A03,083781,Rotar; Vladimir,5,0,34,29
1657899567339,MATH 193A,A04,083782,Rotar; Vladimir,11,0,34,23
1657899567339,MATH 193A,A05,093482,Rotar; Vladimir,10,0,34,24
1657899573363,MATH 197,001,091859,McAuley; Julian John,9999,0,9999,0
1657899573363,MATH 197,002,095566,Kedlaya; Kiran S.,9997,0,9999,2
1657899573363,MATH 197,003,095567,Xiao; Ming,9999,0,9999,0
1657899573363,MATH 197,004,095571,Perols; Johan Lars,9998,0,9999,1
1657899580433,COGS 9,A01,083615,Shannon; Kyle Michael,10,0,75,65
1657899586460,COGS 11,A01,083617,Boyle; Mary E. T.,23,0,48,25
1657899592482,COGS 13,A01,083071,Bastos; Amalia Pinkusfeld,11,0,71,60
1657899598508,COGS 14A,A01,092681,Semenuks; Arturs,5,1,100,95
1657899604533,COGS 14B,A01,083073,Cheng; Tzu-Han,6,0,63,57
1657899610555,COGS 17,A01,092677,Semenuks; Arturs,6,0,81,75
1657899616583,COGS 100,A01,083619,Allen; Michael Gordon,17,0,70,53
1657899622605,COGS 101A,A01,083621,Davis; Joshua Daniel,9,0,68,59
1657899628628,COGS 101B,A01,091572,Allen; Michael Gordon,13,0,65,52
1657899634655,COGS 101C,A01,083625,Delgado; Tania,17,0,35,18
1657899640677,COGS 107A,A01,083627,Boyle; Mary E. T.,14,0,60,46
1657899646699,COGS 118A,A01,083075,Gupta; Anjum,21,0,76,55
1657899652727,CSE 3,A50,083646,Miranda; Gregory Joseph,24,0,50,26
1657899658749,CSE 8A,A50,083650,Miranda; Gregory Joseph,17,1,56,39
1657899664772,CSE 11,A01,083080,Cao; Yingjun,6,15,40,34
1657899670800,CSE 12,A01,083652,Krause-Levy; Sophia Louisa,30,1,120,90
1657899676836,CSE 15L,A01,083654,Morris; Justin Loren,9,0,50,41
1657899676836,CSE 15L,A02,083655,Morris; Justin Loren,10,0,50,40
1657899682858,CSE 20,A01,083657,Tran; Khoa Dang,39,0,80,41
1657899688881,CSE 21,A01,095574,Bach; Quang Tran,22,0,48,26
1657899694903,CSE 30,A01,083084,Eldon; John,6,0,80,74
1657899694903,CSE 30,B01,095061,Bhaskar; Nishant,9,0,50,41
1657899700926,CSE 100,A01,083659,Cao; Yingjun,5,4,70,65
1657899706949,CSE 134B,A01,083661,Powell; Thomas Allan,25,0,100,75
1657899712975,CSE 140,A01,083663,Gungor; Onat,15,0,85,70
1657899719003,CSE 140L,A01,083088,Eldon; John,23,0,100,77
1657899725027,CSE 175,A01,083665,Kumar; Rakesh,3,0,25,22
1657899731059,CSE 190,A00,092507,Dubnov; Shlomo,8,0,20,12
1657899737088,ECE 45,A01,083139,Congero; Spencer William,6,0,75,69
1657899743113,ECE 65,A50,083695,Saad; Andrew S,12,0,30,18
1657899743113,ECE 65,A51,095125,Saad; Andrew S,24,0,26,2
1657899749135,ECE 109,A01,091882,Touri; Behrouz,20,0,70,50
1657899755158,ECE 180,A00,083140,Abi Samra; Nicholas Camill,1,0,30,29
1657899755158,ECE 180,B00,083141,Abi Samra; Nicholas Camill,0,0,30,30
1657899761180,MATH 10A,A01,083735,Patchell; Gregory David,2,0,30,28
1657899761180,MATH 10A,A02,083736,Patchell; Gregory David,20,0,30,10
1657899761180,MATH 10A,A03,083737,Patchell; Gregory David,16,0,30,14
1657899767210,MATH 10B,A01,083207,Lim; Seonhee,8,0,34,26
1657899767210,MATH 10B,A02,083208,Lim; Seonhee,10,0,35,25
1657899767210,MATH 10B,A03,093472,Lim; Seonhee,7,0,34,27
1657899767210,MATH 10B,B01,083739,Sinha; Shubham,14,0,30,16
1657899773235,MATH 18,A01,083743,Cinel; Cameron Alexander,9,0,30,21
1657899773235,MATH 18,A02,083744,Cinel; Cameron Alexander,18,0,30,12
1657899773235,MATH 18,A03,083745,Cinel; Cameron Alexander,10,0,30,20
1657899773235,MATH 18,B01,083748,Rideout; David Porter,5,0,37,32
1657899773235,MATH 18,B02,083749,Rideout; David Porter,5,0,36,31
1657899773235,MATH 18,B03,083750,Rideout; David Porter,3,0,37,34
1657899773235,MATH 18,B04,083751,Rideout; David Porter,6,0,36,30
1657899773235,MATH 18,B05,093473,Rideout; David Porter,6,0,36,30
1657899773235,MATH 18,B06,093474,Rideout; David Porter,6,0,36,30
1657899779261,MATH 20A,A01,083754,Zheng; Zequn,14,0,40,26
1657899785284,MATH 20B,A01,083756,Briones; Jor-el Thomas Caparas,4,0,36,32
1657899785284,MATH 20B,A02,083757,Briones; Jor-el Thomas Caparas,1,0,36,35
1657899785284,MATH 20B,A03,093475,Briones; Jor-el Thomas Caparas,2,0,36,34
1657899791306,MATH 20C,A01,083760,Briones; Jor-el Thomas Caparas,1,0,35,34
1657899791306,MATH 20C,A02,083761,Briones; Jor-el Thomas Caparas,8,0,35,27
1657899791306,MATH 20C,A03,093476,Briones; Jor-el Thomas Caparas,0,1,36,36
1657899791306,MATH 20C,B01,083762,Bach; Quang Tran,1,0,30,29
1657899797330,MATH 20D,A01,083765,Tran; Brian Kha,5,0,30,25
1657899797330,MATH 20D,A02,083766,Tran; Brian Kha,5,0,30,25
1657899797330,MATH 20D,A03,083767,Tran; Brian Kha,5,0,30,25
1657899803359,MATH 20E,A01,083771,Ganguly; Soumya,10,0,32,22
1657899803359,MATH 20E,A02,083772,Ganguly; Soumya,6,0,32,26
1657899803359,MATH 20E,B01,083773,Ciotti; Benjamin,20,0,35,15
1657899803359,MATH 20E,B02,083774,Ciotti; Benjamin,18,0,35,17
1657899809388,MATH 103A,A01,083777,Greenfeld; Be'Eri,3,0,36,33
1657899809388,MATH 103A,A02,083778,Greenfeld; Be'Eri,5,0,36,31
1657899809388,MATH 103A,A03,093561,Greenfeld; Be'Eri,6,0,36,30
1657899809388,MATH 103A,B01,083779,Greenfeld; Be'Eri,7,0,36,29
1657899809388,MATH 103A,B02,083780,Greenfeld; Be'Eri,4,0,36,32
1657899809388,MATH 103A,B03,093562,Greenfeld; Be'Eri,3,0,36,33
1657899815426,MATH 105,A01,085443,Carter; Anne Toulson,15,0,35,20
1657899815426,MATH 105,A02,093477,Carter; Anne Toulson,20,0,35,15
1657899821449,MATH 109,A01,083213,Ganzberger; Geoffrey Michael,3,0,34,31
1657899821449,MATH 109,A02,083214,Ganzberger; Geoffrey Michael,4,0,34,30
1657899821449,MATH 109,A03,093478,Ganzberger; Geoffrey Michael,2,0,34,32
1657899821449,MATH 109,B01,083215,Ganzberger; Geoffrey Michael,2,0,32,30
1657899821449,MATH 109,B02,083216,Ganzberger; Geoffrey Michael,2,0,32,30
1657899821449,MATH 109,B03,093479,Ganzberger; Geoffrey Michael,8,0,32,24
1657899827474,MATH 142A,A01,083219,Chow; Bennett,7,0,32,25
1657899827474,MATH 142A,A02,083220,Chow; Bennett,10,0,32,22
1657899827474,MATH 142A,A03,093480,Chow; Bennett,9,0,32,23
1657899827474,MATH 142A,B03,093481,Chow; Bennett,8,0,32,24
1657899827474,MATH 142A,B04,093558,Chow; Bennett,13,0,32,19
1657899827474,MATH 142A,B05,093559,Chow; Bennett,7,0,32,25
1657899833506,MATH 193A,A01,083224,Rotar; Vladimir,8,0,34,26
1657899833506,MATH 193A,A02,083225,Rotar; Vladimir,10,0,34,24
1657899833506,MATH 193A,A03,083781,Rotar; Vladimir,5,0,34,29
1657899833506,MATH 193A,A04,083782,Rotar; Vladimir,11,0,34,23
1657899833506,MATH 193A,A05,093482,Rotar; Vladimir,10,0,34,24
1657899839540,MATH 197,001,091859,McAuley; Julian John,9999,0,9999,0
1657899839540,MATH 197,002,095566,Kedlaya; Kiran S.,9997,0,9999,2
1657899839540,MATH 197,003,095567,Xiao; Ming,9999,0,9999,0
1657899839540,MATH 197,004,095571,Perols; Johan Lars,9998,0,9999,1
1657899846588,COGS 9,A01,083615,Shannon; Kyle Michael,10,0,75,65
1657899852615,COGS 11,A01,083617,Boyle; Mary E. T.,23,0,48,25
1657899858637,COGS 13,A01,083071,Bastos; Amalia Pinkusfeld,11,0,71,60
1657899864665,COGS 14A,A01,092681,Semenuks; Arturs,5,1,100,95
1657899870687,COGS 14B,A01,083073,Cheng; Tzu-Han,6,0,63,57
1657899876719,COGS 17,A01,092677,Semenuks; Arturs,6,0,81,75
1657899882750,COGS 100,A01,083619,Allen; Michael Gordon,17,0,70,53
1657899888776,COGS 101A,A01,083621,Davis; Joshua Daniel,9,0,68,59
1657899894799,COGS 101B,A01,091572,Allen; Michael Gordon,13,0,65,52
1657899900829,COGS 101C,A01,083625,Delgado; Tania,17,0,35,18
1657899906852,COGS 107A,A01,083627,Boyle; Mary E. T.,14,0,60,46
1657899912875,COGS 118A,A01,083075,Gupta; Anjum,21,0,76,55
1657899918972,CSE 3,A50,083646,Miranda; Gregory Joseph,24,0,50,26
1657899924994,CSE 8A,A50,083650,Miranda; Gregory Joseph,17,1,56,39
1657899931025,CSE 11,A01,083080,Cao; Yingjun,6,15,40,34
1657899937064,CSE 12,A01,083652,Krause-Levy; Sophia Louisa,30,1,120,90
1657899943087,CSE 15L,A01,083654,Morris; Justin Loren,9,0,50,41
1657899943087,CSE 15L,A02,083655,Morris; Justin Loren,10,0,50,40
1657899949113,CSE 20,A01,083657,Tran; Khoa Dang,39,0,80,41
1657899955141,CSE 21,A01,095574,Bach; Quang Tran,22,0,48,26
1657899961173,CSE 30,A01,083084,Eldon; John,6,0,80,74
1657899961173,CSE 30,B01,095061,Bhaskar; Nishant,9,0,50,41
1657899967204,CSE 100,A01,083659,Cao; Yingjun,5,4,70,65
1657899973228,CSE 134B,A01,083661,Powell; Thomas Allan,25,0,100,75
1657899979251,CSE 140,A01,083663,Gungor; Onat,15,0,85,70
1657899985278,CSE 140L,A01,083088,Eldon; John,23,0,100,77
1657899991299,CSE 175,A01,083665,Kumar; Rakesh,3,0,25,22
1657899997323,CSE 190,A00,092507,Dubnov; Shlomo,8,0,20,12
1657900003353,ECE 45,A01,083139,Congero; Spencer William,6,0,75,69
1657900009377,ECE 65,A50,083695,Saad; Andrew S,12,0,30,18
1657900009377,ECE 65,A51,095125,Saad; Andrew S,24,0,26,2
1657900015418,ECE 109,A01,091882,Touri; Behrouz,20,0,70,50
1657900021441,ECE 180,A00,083140,Abi Samra; Nicholas Camill,1,0,30,29
1657900021441,ECE 180,B00,083141,Abi Samra; Nicholas Camill,0,0,30,30
1657900027467,MATH 10A,A01,083735,Patchell; Gregory David,2,0,30,28
1657900027467,MATH 10A,A02,083736,Patchell; Gregory David,20,0,30,10
1657900027467,MATH 10A,A03,083737,Patchell; Gregory David,16,0,30,14
1657900033496,MATH 10B,A01,083207,Lim; Seonhee,8,0,34,26
1657900033496,MATH 10B,A02,083208,Lim; Seonhee,10,0,35,25
1657900033496,MATH 10B,A03,093472,Lim; Seonhee,7,0,34,27
1657900033496,MATH 10B,B01,083739,Sinha; Shubham,14,0,30,16
1657900039520,MATH 18,A01,083743,Cinel; Cameron Alexander,9,0,30,21
1657900039520,MATH 18,A02,083744,Cinel; Cameron Alexander,18,0,30,12
1657900039520,MATH 18,A03,083745,Cinel; Cameron Alexander,10,0,30,20
1657900039520,MATH 18,B01,083748,Rideout; David Porter,5,0,37,32
1657900039520,MATH 18,B02,083749,Rideout; David Porter,5,0,36,31
1657900039520,MATH 18,B03,083750,Rideout; David Porter,3,0,37,34
1657900039520,MATH 18,B04,083751,Rideout; David Porter,6,0,36,30
1657900039520,MATH 18,B05,093473,Rideout; David Porter,6,0,36,30
1657900039520,MATH 18,B06,093474,Rideout; David Porter,6,0,36,30
1657900045558,MATH 20A,A01,083754,Zheng; Zequn,14,0,40,26
1657900051592,MATH 20B,A01,083756,Briones; Jor-el Thomas Caparas,4,0,36,32
1657900051592,MATH 20B,A02,083757,Briones; Jor-el Thomas Caparas,1,0,36,35
1657900051592,MATH 20B,A03,093475,Briones; Jor-el Thomas Caparas,2,0,36,34
1657900057618,MATH 20C,A01,083760,Briones; Jor-el Thomas Caparas,1,0,35,34
1657900057618,MATH 20C,A02,083761,Briones; Jor-el Thomas Caparas,8,0,35,27
1657900057618,MATH 20C,A03,093476,Briones; Jor-el Thomas Caparas,0,1,36,36
1657900057618,MATH 20C,B01,083762,Bach; Quang Tran,1,0,30,29
1657900063641,MATH 20D,A01,083765,Tran; Brian Kha,5,0,30,25
1657900063641,MATH 20D,A02,083766,Tran; Brian Kha,5,0,30,25
1657900063641,MATH 20D,A03,083767,Tran; Brian Kha,5,0,30,25
1657900069664,MATH 20E,A01,083771,Ganguly; Soumya,10,0,32,22
1657900069664,MATH 20E,A02,083772,Ganguly; Soumya,6,0,32,26
1657900069664,MATH 20E,B01,083773,Ciotti; Benjamin,20,0,35,15
1657900069664,MATH 20E,B02,083774,Ciotti; Benjamin,18,0,35,17
1657900075689,MATH 103A,A01,083777,Greenfeld; Be'Eri,3,0,36,33
1657900075689,MATH 103A,A02,083778,Greenfeld; Be'Eri,5,0,36,31
1657900075689,MATH 103A,A03,093561,Greenfeld; Be'Eri,6,0,36,30
1657900075689,MATH 103A,B01,083779,Greenfeld; Be'Eri,7,0,36,29
1657900075689,MATH 103A,B02,083780,Greenfeld; Be'Eri,4,0,36,32
1657900075689,MATH 103A,B03,093562,Greenfeld; Be'Eri,3,0,36,33
1657900081720,MATH 105,A01,085443,Carter; Anne Toulson,15,0,35,20
1657900081720,MATH 105,A02,093477,Carter; Anne Toulson,20,0,35,15
1657900087741,MATH 109,A01,083213,Ganzberger; Geoffrey Michael,3,0,34,31
1657900087741,MATH 109,A02,083214,Ganzberger; Geoffrey Michael,4,0,34,30
1657900087741,MATH 109,A03,093478,Ganzberger; Geoffrey Michael,2,0,34,32
1657900087741,MATH 109,B01,083215,Ganzberger; Geoffrey Michael,2,0,32,30
1657900087741,MATH 109,B02,083216,Ganzberger; Geoffrey Michael,2,0,32,30
1657900087741,MATH 109,B03,093479,Ganzberger; Geoffrey Michael,8,0,32,24
1657900093765,MATH 142A,A01,083219,Chow; Bennett,7,0,32,25
1657900093765,MATH 142A,A02,083220,Chow; Bennett,10,0,32,22
1657900093765,MATH 142A,A03,093480,Chow; Bennett,9,0,32,23
1657900093765,MATH 142A,B03,093481,Chow; Bennett,8,0,32,24
1657900093765,MATH 142A,B04,093558,Chow; Bennett,13,0,32,19
1657900093765,MATH 142A,B05,093559,Chow; Bennett,7,0,32,25
1657900099788,MATH 193A,A01,083224,Rotar; Vladimir,8,0,34,26
1657900099788,MATH 193A,A02,083225,Rotar; Vladimir,10,0,34,24
1657900099788,MATH 193A,A03,083781,Rotar; Vladimir,5,0,34,29
1657900099788,MATH 193A,A04,083782,Rotar; Vladimir,11,0,34,23
1657900099788,MATH 193A,A05,093482,Rotar; Vladimir,10,0,34,24
1657900105811,MATH 197,001,091859,McAuley; Julian John,9999,0,9999,0
1657900105811,MATH 197,002,095566,Kedlaya; Kiran S.,9997,0,9999,2
1657900105811,MATH 197,003,095567,Xiao; Ming,9999,0,9999,0
1657900105811,MATH 197,004,095571,Perols; Johan Lars,9998,0,9999,1
1657900112865,COGS 9,A01,083615,Shannon; Kyle Michael,10,0,75,65
1657900118889,COGS 11,A01,083617,Boyle; Mary E. T.,23,0,48,25
1657900124920,COGS 13,A01,083071,Bastos; Amalia Pinkusfeld,11,0,71,60
1657900130951,COGS 14A,A01,092681,Semenuks; Arturs,5,1,100,95
1657900136976,COGS 14B,A01,083073,Cheng; Tzu-Han,6,0,63,57
1657900143003,COGS 17,A01,092677,Semenuks; Arturs,6,0,81,75
1657900149036,COGS 100,A01,083619,Allen; Michael Gordon,17,0,70,53
1657900155059,COGS 101A,A01,083621,Davis; Joshua Daniel,9,0,68,59
1657900166637,COGS 101B,A01,091572,Allen; Michael Gordon,13,0,65,52
1657900172664,COGS 101C,A01,083625,Delgado; Tania,17,0,35,18
1657900178688,COGS 107A,A01,083627,Boyle; Mary E. T.,14,0,60,46
1657900184716,COGS 118A,A01,083075,Gupta; Anjum,21,0,76,55
1657900190751,CSE 3,A50,083646,Miranda; Gregory Joseph,24,0,50,26
1657900196778,CSE 8A,A50,083650,Miranda; Gregory Joseph,17,1,56,39
1657900202803,CSE 11,A01,083080,Cao; Yingjun,6,15,40,34
1657900208828,CSE 12,A01,083652,Krause-Levy; Sophia Louisa,30,1,120,90
1657900214854,CSE 15L,A01,083654,Morris; Justin Loren,9,0,50,41
1657900214854,CSE 15L,A02,083655,Morris; Justin Loren,10,0,50,40
1657900220878,CSE 20,A01,083657,Tran; Khoa Dang,39,0,80,41
1657900226900,CSE 21,A01,095574,Bach; Quang Tran,22,0,48,26
1657900232925,CSE 30,A01,083084,Eldon; John,6,0,80,74
1657900232925,CSE 30,B01,095061,Bhaskar; Nishant,9,0,50,41
1657900238948,CSE 100,A01,083659,Cao; Yingjun,5,4,70,65
1657900244972,CSE 134B,A01,083661,Powell; Thomas Allan,25,0,100,75
1657900250999,CSE 140,A01,083663,Gungor; Onat,15,0,85,70
1657900257033,CSE 140L,A01,083088,Eldon; John,23,0,100,77
1657900263061,CSE 175,A01,083665,Kumar; Rakesh,3,0,25,22
1657900269090,CSE 190,A00,092507,Dubnov; Shlomo,8,0,20,12
1657900275114,ECE 45,A01,083139,Congero; Spencer William,6,0,75,69
1657900281136,ECE 65,A50,083695,Saad; Andrew S,12,0,30,18
1657900281136,ECE 65,A51,095125,Saad; Andrew S,24,0,26,2
1657900287167,ECE 109,A01,091882,Touri; Behrouz,20,0,70,50
1657900293193,ECE 180,A00,083140,Abi Samra; Nicholas Camill,1,0,30,29
1657900293193,ECE 180,B00,083141,Abi Samra; Nicholas Camill,0,0,30,30
1657900299226,MATH 10A,A01,083735,Patchell; Gregory David,2,0,30,28
1657900299226,MATH 10A,A02,083736,Patchell; Gregory David,20,0,30,10
1657900299226,MATH 10A,A03,083737,Patchell; Gregory David,16,0,30,14
1657900305255,MATH 10B,A01,083207,Lim; Seonhee,8,0,34,26
1657900305255,MATH 10B,A02,083208,Lim; Seonhee,10,0,35,25
1657900305255,MATH 10B,A03,093472,Lim; Seonhee,7,0,34,27
1657900305255,MATH 10B,B01,083739,Sinha; Shubham,14,0,30,16
1657900311282,MATH 18,A01,083743,Cinel; Cameron Alexander,9,0,30,21
1657900311282,MATH 18,A02,083744,Cinel; Cameron Alexander,18,0,30,12
1657900311282,MATH 18,A03,083745,Cinel; Cameron Alexander,10,0,30,20
1657900311282,MATH 18,B01,083748,Rideout; David Porter,5,0,37,32
1657900311282,MATH 18,B02,083749,Rideout; David Porter,5,0,36,31
1657900311282,MATH 18,B03,083750,Rideout; David Porter,3,0,37,34
1657900311282,MATH 18,B04,083751,Rideout; David Porter,6,0,36,30
1657900311282,MATH 18,B05,093473,Rideout; David Porter,6,0,36,30
1657900311282,MATH 18,B06,093474,Rideout; David Porter,6,0,36,30
1657900317305,MATH 20A,A01,083754,Zheng; Zequn,14,0,40,26
1657900323333,MATH 20B,A01,083756,Briones; Jor-el Thomas Caparas,4,0,36,32
1657900323333,MATH 20B,A02,083757,Briones; Jor-el Thomas Caparas,1,0,36,35
1657900323333,MATH 20B,A03,093475,Briones; Jor-el Thomas Caparas,2,0,36,34
1657900329359,MATH 20C,A01,083760,Briones; Jor-el Thomas Caparas,1,0,35,34
1657900329359,MATH 20C,A02,083761,Briones; Jor-el Thomas Caparas,8,0,35,27
1657900329359,MATH 20C,A03,093476,Briones; Jor-el Thomas Caparas,0,1,36,36
1657900329359,MATH 20C,B01,083762,Bach; Quang Tran,1,0,30,29
1657900335387,MATH 20D,A01,083765,Tran; Brian Kha,5,0,30,25
1657900335387,MATH 20D,A02,083766,Tran; Brian Kha,5,0,30,25
1657900335387,MATH 20D,A03,083767,Tran; Brian Kha,5,0,30,25
1657900341413,MATH 20E,A01,083771,Ganguly; Soumya,10,0,32,22
1657900341413,MATH 20E,A02,083772,Ganguly; Soumya,6,0,32,26
1657900341413,MATH 20E,B01,083773,Ciotti; Benjamin,20,0,35,15
1657900341413,MATH 20E,B02,083774,Ciotti; Benjamin,18,0,35,17
1657900347435,MATH 103A,A01,083777,Greenfeld; Be'Eri,3,0,36,33
1657900347435,MATH 103A,A02,083778,Greenfeld; Be'Eri,5,0,36,31
1657900347435,MATH 103A,A03,093561,Greenfeld; Be'Eri,6,0,36,30
1657900347435,MATH 103A,B01,083779,Greenfeld; Be'Eri,7,0,36,29
1657900347435,MATH 103A,B02,083780,Greenfeld; Be'Eri,4,0,36,32
1657900347435,MATH 103A,B03,093562,Greenfeld; Be'Eri,3,0,36,33
1657900353464,MATH 105,A01,085443,Carter; Anne Toulson,15,0,35,20
1657900353464,MATH 105,A02,093477,Carter; Anne Toulson,20,0,35,15
1657900359494,MATH 109,A01,083213,Ganzberger; Geoffrey Michael,3,0,34,31
1657900359494,MATH 109,A02,083214,Ganzberger; Geoffrey Michael,4,0,34,30
1657900359494,MATH 109,A03,093478,Ganzberger; Geoffrey Michael,2,0,34,32
1657900359494,MATH 109,B01,083215,Ganzberger; Geoffrey Michael,2,0,32,30
1657900359494,MATH 109,B02,083216,Ganzberger; Geoffrey Michael,2,0,32,30
1657900359494,MATH 109,B03,093479,Ganzberger; Geoffrey Michael,8,0,32,24
1657900365518,MATH 142A,A01,083219,Chow; Bennett,7,0,32,25
1657900365518,MATH 142A,A02,083220,Chow; Bennett,10,0,32,22
1657900365518,MATH 142A,A03,093480,Chow; Bennett,9,0,32,23
1657900365518,MATH 142A,B03,093481,Chow; Bennett,8,0,32,24
1657900365518,MATH 142A,B04,093558,Chow; Bennett,13,0,32,19
1657900365518,MATH 142A,B05,093559,Chow; Bennett,7,0,32,25
1657900371542,MATH 193A,A01,083224,Rotar; Vladimir,8,0,34,26
1657900371542,MATH 193A,A02,083225,Rotar; Vladimir,10,0,34,24
1657900371542,MATH 193A,A03,083781,Rotar; Vladimir,5,0,34,29
1657900371542,MATH 193A,A04,083782,Rotar; Vladimir,11,0,34,23
1657900371542,MATH 193A,A05,093482,Rotar; Vladimir,10,0,34,24
1657900377569,MATH 197,001,091859,McAuley; Julian John,9999,0,9999,0
1657900377569,MATH 197,002,095566,Kedlaya; Kiran S.,9997,0,9999,2
1657900377569,MATH 197,003,095567,Xiao; Ming,9999,0,9999,0
1657900377569,MATH 197,004,095571,Perols; Johan Lars,9998,0,9999,1
1657900384618,COGS 9,A01,083615,Shannon; Kyle Michael,10,0,75,65
1657900390642,COGS 11,A01,083617,Boyle; Mary E. T.,23,0,48,25
1657900396672,COGS 13,A01,083071,Bastos; Amalia Pinkusfeld,11,0,71,60
1657900402707,COGS 14A,A01,092681,Semenuks; Arturs,5,1,100,95
1657900408741,COGS 14B,A01,083073,Cheng; Tzu-Han,6,0,63,57
1657900414781,COGS 17,A01,092677,Semenuks; Arturs,6,0,81,75
1657900420817,COGS 100,A01,083619,Allen; Michael Gordon,17,0,70,53
1657900426857,COGS 101A,A01,083621,Davis; Joshua Daniel,9,0,68,59
1657900432883,COGS 101B,A01,091572,Allen; Michael Gordon,13,0,65,52
1657900438906,COGS 101C,A01,083625,Delgado; Tania,17,0,35,18
1657900444929,COGS 107A,A01,083627,Boyle; Mary E. T.,14,0,60,46
1657900450963,COGS 118A,A01,083075,Gupta; Anjum,21,0,76,55
1657900456987,CSE 3,A50,083646,Miranda; Gregory Joseph,24,0,50,26
1657900463010,CSE 8A,A50,083650,Miranda; Gregory Joseph,17,1,56,39
1657900469040,CSE 11,A01,083080,Cao; Yingjun,6,15,40,34
1657900475066,CSE 12,A01,083652,Krause-Levy; Sophia Louisa,30,1,120,90
1657900481089,CSE 15L,A01,083654,Morris; Justin Loren,9,0,50,41
1657900481089,CSE 15L,A02,083655,Morris; Justin Loren,10,0,50,40
1657900487119,CSE 20,A01,083657,Tran; Khoa Dang,39,0,80,41
1657900493142,CSE 21,A01,095574,Bach; Quang Tran,22,0,48,26
1657900499165,CSE 30,A01,083084,Eldon; John,6,0,80,74
1657900499165,CSE 30,B01,095061,Bhaskar; Nishant,9,0,50,41
1657900505192,CSE 100,A01,083659,Cao; Yingjun,5,4,70,65
1657900511214,CSE 134B,A01,083661,Powell; Thomas Allan,25,0,100,75
1657900517246,CSE 140,A01,083663,Gungor; Onat,15,0,85,70
1657900523392,CSE 140L,A01,083088,Eldon; John,23,0,100,77
1657900529418,CSE 175,A01,083665,Kumar; Rakesh,3,0,25,22
1657900535442,CSE 190,A00,092507,Dubnov; Shlomo,8,0,20,12
1657900541466,ECE 45,A01,083139,Congero; Spencer William,6,0,75,69
1657900547493,ECE 65,A50,083695,Saad; Andrew S,12,0,30,18
1657900547493,ECE 65,A51,095125,Saad; Andrew S,24,0,26,2
1657900553517,ECE 109,A01,091882,Touri; Behrouz,20,0,70,50
1657900559541,ECE 180,A00,083140,Abi Samra; Nicholas Camill,1,0,30,29
1657900559541,ECE 180,B00,083141,Abi Samra; Nicholas Camill,0,0,30,30
1657900565568,MATH 10A,A01,083735,Patchell; Gregory David,2,0,30,28
1657900565568,MATH 10A,A02,083736,Patchell; Gregory David,20,0,30,10
1657900565568,MATH 10A,A03,083737,Patchell; Gregory David,16,0,30,14
1657900571595,MATH 10B,A01,083207,Lim; Seonhee,8,0,34,26
1657900571595,MATH 10B,A02,083208,Lim; Seonhee,10,0,35,25
1657900571595,MATH 10B,A03,093472,Lim; Seonhee,7,0,34,27
1657900571595,MATH 10B,B01,083739,Sinha; Shubham,14,0,30,16
1657900577620,MATH 18,A01,083743,Cinel; Cameron Alexander,9,0,30,21
1657900577620,MATH 18,A02,083744,Cinel; Cameron Alexander,18,0,30,12
1657900577620,MATH 18,A03,083745,Cinel; Cameron Alexander,10,0,30,20
1657900577620,MATH 18,B01,083748,Rideout; David Porter,5,0,37,32
1657900577620,MATH 18,B02,083749,Rideout; David Porter,5,0,36,31
1657900577620,MATH 18,B03,083750,Rideout; David Porter,3,0,37,34
1657900577620,MATH 18,B04,083751,Rideout; David Porter,6,0,36,30
1657900577620,MATH 18,B05,093473,Rideout; David Porter,6,0,36,30
1657900577620,MATH 18,B06,093474,Rideout; David Porter,6,0,36,30
1657900583646,MATH 20A,A01,083754,Zheng; Zequn,14,0,40,26
1657900589674,MATH 20B,A01,083756,Briones; Jor-el Thomas Caparas,4,0,36,32
1657900589674,MATH 20B,A02,083757,Briones; Jor-el Thomas Caparas,1,0,36,35
1657900589674,MATH 20B,A03,093475,Briones; Jor-el Thomas Caparas,2,0,36,34
1657900595696,MATH 20C,A01,083760,Briones; Jor-el Thomas Caparas,1,0,35,34
1657900595696,MATH 20C,A02,083761,Briones; Jor-el Thomas Caparas,8,0,35,27
1657900595696,MATH 20C,A03,093476,Briones; Jor-el Thomas Caparas,0,1,36,36
1657900595696,MATH 20C,B01,083762,Bach; Quang Tran,1,0,30,29
1657900601719,MATH 20D,A01,083765,Tran; Brian Kha,5,0,30,25
1657900601719,MATH 20D,A02,083766,Tran; Brian Kha,5,0,30,25
1657900601719,MATH 20D,A03,083767,Tran; Brian Kha,5,0,30,25
1657900607751,MATH 20E,A01,083771,Ganguly; Soumya,10,0,32,22
1657900607751,MATH 20E,A02,083772,Ganguly; Soumya,6,0,32,26
1657900607751,MATH 20E,B01,083773,Ciotti; Benjamin,20,0,35,15
1657900607751,MATH 20E,B02,083774,Ciotti; Benjamin,18,0,35,17
1657900613781,MATH 103A,A01,083777,Greenfeld; Be'Eri,3,0,36,33
1657900613781,MATH 103A,A02,083778,Greenfeld; Be'Eri,5,0,36,31
1657900613781,MATH 103A,A03,093561,Greenfeld; Be'Eri,6,0,36,30
1657900613781,MATH 103A,B01,083779,Greenfeld; Be'Eri,7,0,36,29
1657900613781,MATH 103A,B02,083780,Greenfeld; Be'Eri,4,0,36,32
1657900613781,MATH 103A,B03,093562,Greenfeld; Be'Eri,3,0,36,33
1657900619813,MATH 105,A01,085443,Carter; Anne Toulson,15,0,35,20
1657900619813,MATH 105,A02,093477,Carter; Anne Toulson,20,0,35,15
1657900625840,MATH 109,A01,083213,Ganzberger; Geoffrey Michael,3,0,34,31
1657900625840,MATH 109,A02,083214,Ganzberger; Geoffrey Michael,4,0,34,30
1657900625840,MATH 109,A03,093478,Ganzberger; Geoffrey Michael,2,0,34,32
1657900625840,MATH 109,B01,083215,Ganzberger; Geoffrey Michael,2,0,32,30
1657900625840,MATH 109,B02,083216,Ganzberger; Geoffrey Michael,2,0,32,30
1657900625840,MATH 109,B03,093479,Ganzberger; Geoffrey Michael,8,0,32,24
1657900631870,MATH 142A,A01,083219,Chow; Bennett,7,0,32,25
1657900631870,MATH 142A,A02,083220,Chow; Bennett,10,0,32,22
1657900631870,MATH 142A,A03,093480,Chow; Bennett,9,0,32,23
1657900631870,MATH 142A,B03,093481,Chow; Bennett,8,0,32,24
1657900631870,MATH 142A,B04,093558,Chow; Bennett,13,0,32,19
1657900631870,MATH 142A,B05,093559,Chow; Bennett,7,0,32,25
1657900637914,MATH 193A,A01,083224,Rotar; Vladimir,8,0,34,26
1657900637914,MATH 193A,A02,083225,Rotar; Vladimir,10,0,34,24
1657900637914,MATH 193A,A03,083781,Rotar; Vladimir,5,0,34,29
1657900637914,MATH 193A,A04,083782,Rotar; Vladimir,11,0,34,23
1657900637914,MATH 193A,A05,093482,Rotar; Vladimir,10,0,34,24
1657900643944,MATH 197,001,091859,McAuley; Julian John,9999,0,9999,0
1657900643944,MATH 197,002,095566,Kedlaya; Kiran S.,9997,0,9999,2
1657900643944,MATH 197,003,095567,Xiao; Ming,9999,0,9999,0
1657900643944,MATH 197,004,095571,Perols; Johan Lars,9998,0,9999,1
1657900651000,COGS 9,A01,083615,Shannon; Kyle Michael,10,0,75,65
1657900657024,COGS 11,A01,083617,Boyle; Mary E. T.,23,0,48,25
1657900663051,COGS 13,A01,083071,Bastos; Amalia Pinkusfeld,11,0,71,60
1657900669081,COGS 14A,A01,092681,Semenuks; Arturs,5,1,100,95
1657900675106,COGS 14B,A01,083073,Cheng; Tzu-Han,6,0,63,57
1657900681133,COGS 17,A01,092677,Semenuks; Arturs,6,0,81,75
1657900687157,COGS 100,A01,083619,Allen; Michael Gordon,17,0,70,53
1657900693183,COGS 101A,A01,083621,Davis; Joshua Daniel,9,0,68,59
1657900699206,COGS 101B,A01,091572,Allen; Michael Gordon,13,0,65,52
1657900705234,COGS 101C,A01,083625,Delgado; Tania,17,0,35,18
1657900711257,COGS 107A,A01,083627,Boyle; Mary E. T.,14,0,60,46
1657900717282,COGS 118A,A01,083075,Gupta; Anjum,21,0,76,55
1657900723304,CSE 3,A50,083646,Miranda; Gregory Joseph,24,0,50,26
1657900729337,CSE 8A,A50,083650,Miranda; Gregory Joseph,17,1,56,39
1657900735361,CSE 11,A01,083080,Cao; Yingjun,6,15,40,34
1657900741399,CSE 12,A01,083652,Krause-Levy; Sophia Louisa,30,1,120,90
1657900747427,CSE 15L,A01,083654,Morris; Justin Loren,9,0,50,41
1657900747427,CSE 15L,A02,083655,Morris; Justin Loren,10,0,50,40
1657900753461,CSE 20,A01,083657,Tran; Khoa Dang,39,0,80,41
1657900759492,CSE 21,A01,095574,Bach; Quang Tran,22,0,48,26
1657900765515,CSE 30,A01,083084,Eldon; John,6,0,80,74
1657900765515,CSE 30,B01,095061,Bhaskar; Nishant,9,0,50,41
1657900771546,CSE 100,A01,083659,Cao; Yingjun,5,4,70,65
1657900777570,CSE 134B,A01,083661,Powell; Thomas Allan,25,0,100,75
1657900783594,CSE 140,A01,083663,Gungor; Onat,15,0,85,70
1657900789617,CSE 140L,A01,083088,Eldon; John,23,0,100,77
1657900795646,CSE 175,A01,083665,Kumar; Rakesh,3,0,25,22
1657900801672,CSE 190,A00,092507,Dubnov; Shlomo,8,0,20,12
1657900807704,ECE 45,A01,083139,Congero; Spencer William,6,0,75,69
1657900813726,ECE 65,A50,083695,Saad; Andrew S,12,0,30,18
1657900813726,ECE 65,A51,095125,Saad; Andrew S,24,0,26,2
1657900819748,ECE 109,A01,091882,Touri; Behrouz,20,0,70,50
1657900825776,ECE 180,A00,083140,Abi Samra; Nicholas Camill,1,0,30,29
1657900825776,ECE 180,B00,083141,Abi Samra; Nicholas Camill,0,0,30,30
1657900831799,MATH 10A,A01,083735,Patchell; Gregory David,2,0,30,28
1657900831799,MATH 10A,A02,083736,Patchell; Gregory David,20,0,30,10
1657900831799,MATH 10A,A03,083737,Patchell; Gregory David,16,0,30,14
1657900837835,MATH 10B,A01,083207,Lim; Seonhee,8,0,34,26
1657900837835,MATH 10B,A02,083208,Lim; Seonhee,10,0,35,25
1657900837835,MATH 10B,A03,093472,Lim; Seonhee,7,0,34,27
1657900837835,MATH 10B,B01,083739,Sinha; Shubham,14,0,30,16
1657900843860,MATH 18,A01,083743,Cinel; Cameron Alexander,9,0,30,21
1657900843860,MATH 18,A02,083744,Cinel; Cameron Alexander,18,0,30,12
1657900843860,MATH 18,A03,083745,Cinel; Cameron Alexander,10,0,30,20
1657900843860,MATH 18,B01,083748,Rideout; David Porter,5,0,37,32
1657900843860,MATH 18,B02,083749,Rideout; David Porter,5,0,36,31
1657900843860,MATH 18,B03,083750,Rideout; David Porter,3,0,37,34
1657900843860,MATH 18,B04,083751,Rideout; David Porter,6,0,36,30
1657900843860,MATH 18,B05,093473,Rideout; David Porter,6,0,36,30
1657900843860,MATH 18,B06,093474,Rideout; David Porter,6,0,36,30
1657900849892,MATH 20A,A01,083754,Zheng; Zequn,14,0,40,26
1657900855921,MATH 20B,A01,083756,Briones; Jor-el Thomas Caparas,4,0,36,32
1657900855921,MATH 20B,A02,083757,Briones; Jor-el Thomas Caparas,1,0,36,35
1657900855921,MATH 20B,A03,093475,Briones; Jor-el Thomas Caparas,2,0,36,34
1657900861950,MATH 20C,A01,083760,Briones; Jor-el Thomas Caparas,1,0,35,34
1657900861950,MATH 20C,A02,083761,Briones; Jor-el Thomas Caparas,8,0,35,27
1657900861950,MATH 20C,A03,093476,Briones; Jor-el Thomas Caparas,0,1,36,36
1657900861950,MATH 20C,B01,083762,Bach; Quang Tran,1,0,30,29
1657900867979,MATH 20D,A01,083765,Tran; Brian Kha,5,0,30,25
1657900867979,MATH 20D,A02,083766,Tran; Brian Kha,5,0,30,25
1657900867979,MATH 20D,A03,083767,Tran; Brian Kha,5,0,30,25
1657900874003,MATH 20E,A01,083771,Ganguly; Soumya,10,0,32,22
1657900874003,MATH 20E,A02,083772,Ganguly; Soumya,6,0,32,26
1657900874003,MATH 20E,B01,083773,Ciotti; Benjamin,20,0,35,15
1657900874003,MATH 20E,B02,083774,Ciotti; Benjamin,18,0,35,17
1657900880033,MATH 103A,A01,083777,Greenfeld; Be'Eri,3,0,36,33
1657900880033,MATH 103A,A02,083778,Greenfeld; Be'Eri,5,0,36,31
1657900880033,MATH 103A,A03,093561,Greenfeld; Be'Eri,6,0,36,30
1657900880033,MATH 103A,B01,083779,Greenfeld; Be'Eri,7,0,36,29
1657900880033,MATH 103A,B02,083780,Greenfeld; Be'Eri,4,0,36,32
1657900880033,MATH 103A,B03,093562,Greenfeld; Be'Eri,3,0,36,33
1657900886069,MATH 105,A01,085443,Carter; Anne Toulson,15,0,35,20
1657900886069,MATH 105,A02,093477,Carter; Anne Toulson,20,0,35,15
1657900892102,MATH 109,A01,083213,Ganzberger; Geoffrey Michael,3,0,34,31
1657900892102,MATH 109,A02,083214,Ganzberger; Geoffrey Michael,4,0,34,30
1657900892102,MATH 109,A03,093478,Ganzberger; Geoffrey Michael,2,0,34,32
1657900892102,MATH 109,B01,083215,Ganzberger; Geoffrey Michael,2,0,32,30
1657900892102,MATH 109,B02,083216,Ganzberger; Geoffrey Michael,2,0,32,30
1657900892102,MATH 109,B03,093479,Ganzberger; Geoffrey Michael,8,0,32,24
1657900898144,MATH 142A,A01,083219,Chow; Bennett,7,0,32,25
1657900898144,MATH 142A,A02,083220,Chow; Bennett,10,0,32,22
1657900898144,MATH 142A,A03,093480,Chow; Bennett,9,0,32,23
1657900898144,MATH 142A,B03,093481,Chow; Bennett,8,0,32,24
1657900898144,MATH 142A,B04,093558,Chow; Bennett,13,0,32,19
1657900898144,MATH 142A,B05,093559,Chow; Bennett,7,0,32,25
1657900904167,MATH 193A,A01,083224,Rotar; Vladimir,8,0,34,26
1657900904167,MATH 193A,A02,083225,Rotar; Vladimir,10,0,34,24
1657900904167,MATH 193A,A03,083781,Rotar; Vladimir,5,0,34,29
1657900904167,MATH 193A,A04,083782,Rotar; Vladimir,11,0,34,23
1657900904167,MATH 193A,A05,093482,Rotar; Vladimir,10,0,34,24
1657900910190,MATH 197,001,091859,McAuley; Julian John,9999,0,9999,0
1657900910190,MATH 197,002,095566,Kedlaya; Kiran S.,9997,0,9999,2
1657900910190,MATH 197,003,095567,Xiao; Ming,9999,0,9999,0
1657900910190,MATH 197,004,095571,Perols; Johan Lars,9998,0,9999,1
1657900917271,COGS 9,A01,083615,Shannon; Kyle Michael,10,0,75,65
1657900923297,COGS 11,A01,083617,Boyle; Mary E. T.,23,0,48,25
1657900929323,COGS 13,A01,083071,Bastos; Amalia Pinkusfeld,11,0,71,60
1657900935346,COGS 14A,A01,092681,Semenuks; Arturs,5,1,100,95
1657900941376,COGS 14B,A01,083073,Cheng; Tzu-Han,6,0,63,57
1657900947402,COGS 17,A01,092677,Semenuks; Arturs,6,0,81,75
1657900953425,COGS 100,A01,083619,Allen; Michael Gordon,17,0,70,53
1657900959448,COGS 101A,A01,083621,Davis; Joshua Daniel,9,0,68,59
1657900965475,COGS 101B,A01,091572,Allen; Michael Gordon,13,0,65,52
1657900971501,COGS 101C,A01,083625,Delgado; Tania,17,0,35,18
1657900977524,COGS 107A,A01,083627,Boyle; Mary E. T.,14,0,60,46
1657900983546,COGS 118A,A01,083075,Gupta; Anjum,21,0,76,55
1657900989570,CSE 3,A50,083646,Miranda; Gregory Joseph,24,0,50,26
1657900995596,CSE 8A,A50,083650,Miranda; Gregory Joseph,17,1,56,39
1657901001620,CSE 11,A01,083080,Cao; Yingjun,6,15,40,34
1657901007646,CSE 12,A01,083652,Krause-Levy; Sophia Louisa,30,1,120,90
1657901013668,CSE 15L,A01,083654,Morris; Justin Loren,9,0,50,41
1657901013668,CSE 15L,A02,083655,Morris; Justin Loren,10,0,50,40
1657901019697,CSE 20,A01,083657,Tran; Khoa Dang,39,0,80,41
1657901025722,CSE 21,A01,095574,Bach; Quang Tran,22,0,48,26
1657901031745,CSE 30,A01,083084,Eldon; John,6,0,80,74
1657901031745,CSE 30,B01,095061,Bhaskar; Nishant,9,0,50,41
1657901037768,CSE 100,A01,083659,Cao; Yingjun,5,4,70,65
1657901043795,CSE 134B,A01,083661,Powell; Thomas Allan,25,0,100,75
1657901049820,CSE 140,A01,083663,Gungor; Onat,15,0,85,70
1657901055854,CSE 140L,A01,083088,Eldon; John,23,0,100,77
1657901061880,CSE 175,A01,083665,Kumar; Rakesh,3,0,25,22
1657901067902,CSE 190,A00,092507,Dubnov; Shlomo,8,0,20,12
1657901073932,ECE 45,A01,083139,Congero; Spencer William,6,0,75,69
1657901079960,ECE 65,A50,083695,Saad; Andrew S,12,0,30,18
1657901079960,ECE 65,A51,095125,Saad; Andrew S,24,0,26,2
1657901085989,ECE 109,A01,091882,Touri; Behrouz,20,0,70,50
1657901092015,ECE 180,A00,083140,Abi Samra; Nicholas Camill,1,0,30,29
1657901092015,ECE 180,B00,083141,Abi Samra; Nicholas Camill,0,0,30,30
1657901098043,MATH 10A,A01,083735,Patchell; Gregory David,2,0,30,28
1657901098043,MATH 10A,A02,083736,Patchell; Gregory David,20,0,30,10
1657901098043,MATH 10A,A03,083737,Patchell; Gregory David,16,0,30,14
1657901104067,MATH 10B,A01,083207,Lim; Seonhee,8,0,34,26
1657901104067,MATH 10B,A02,083208,Lim; Seonhee,10,0,35,25
1657901104067,MATH 10B,A03,093472,Lim; Seonhee,7,0,34,27
1657901104067,MATH 10B,B01,083739,Sinha; Shubham,14,0,30,16
1657901110096,MATH 18,A01,083743,Cinel; Cameron Alexander,9,0,30,21
1657901110096,MATH 18,A02,083744,Cinel; Cameron Alexander,18,0,30,12
1657901110096,MATH 18,A03,083745,Cinel; Cameron Alexander,10,0,30,20
1657901110096,MATH 18,B01,083748,Rideout; David Porter,5,0,37,32
1657901110096,MATH 18,B02,083749,Rideout; David Porter,5,0,36,31
1657901110096,MATH 18,B03,083750,Rideout; David Porter,3,0,37,34
1657901110096,MATH 18,B04,083751,Rideout; David Porter,6,0,36,30
1657901110096,MATH 18,B05,093473,Rideout; David Porter,6,0,36,30
1657901110096,MATH 18,B06,093474,Rideout; David Porter,6,0,36,30
1657901116122,MATH 20A,A01,083754,Zheng; Zequn,14,0,40,26
1657901122227,MATH 20B,A01,083756,Briones; Jor-el Thomas Caparas,4,0,36,32
1657901122227,MATH 20B,A02,083757,Briones; Jor-el Thomas Caparas,1,0,36,35
1657901122227,MATH 20B,A03,093475,Briones; Jor-el Thomas Caparas,2,0,36,34
1657901128252,MATH 20C,A01,083760,Briones; Jor-el Thomas Caparas,1,0,35,34
1657901128252,MATH 20C,A02,083761,Briones; Jor-el Thomas Caparas,8,0,35,27
1657901128252,MATH 20C,A03,093476,Briones; Jor-el Thomas Caparas,0,1,36,36
1657901128252,MATH 20C,B01,083762,Bach; Quang Tran,1,0,30,29
1657901134293,MATH 20D,A01,083765,Tran; Brian Kha,5,0,30,25
1657901134293,MATH 20D,A02,083766,Tran; Brian Kha,5,0,30,25
1657901134293,MATH 20D,A03,083767,Tran; Brian Kha,5,0,30,25
1657901140321,MATH 20E,A01,083771,Ganguly; Soumya,10,0,32,22
1657901140321,MATH 20E,A02,083772,Ganguly; Soumya,6,0,32,26
1657901140321,MATH 20E,B01,083773,Ciotti; Benjamin,20,0,35,15
1657901140321,MATH 20E,B02,083774,Ciotti; Benjamin,18,0,35,17
1657901146344,MATH 103A,A01,083777,Greenfeld; Be'Eri,3,0,36,33
1657901146344,MATH 103A,A02,083778,Greenfeld; Be'Eri,5,0,36,31
1657901146344,MATH 103A,A03,093561,Greenfeld; Be'Eri,6,0,36,30
1657901146344,MATH 103A,B01,083779,Greenfeld; Be'Eri,7,0,36,29
1657901146344,MATH 103A,B02,083780,Greenfeld; Be'Eri,4,0,36,32
1657901146344,MATH 103A,B03,093562,Greenfeld; Be'Eri,3,0,36,33
1657901152375,MATH 105,A01,085443,Carter; Anne Toulson,15,0,35,20
1657901152375,MATH 105,A02,093477,Carter; Anne Toulson,20,0,35,15
1657901158409,MATH 109,A01,083213,Ganzberger; Geoffrey Michael,3,0,34,31
1657901158409,MATH 109,A02,083214,Ganzberger; Geoffrey Michael,4,0,34,30
1657901158409,MATH 109,A03,093478,Ganzberger; Geoffrey Michael,2,0,34,32
1657901158409,MATH 109,B01,083215,Ganzberger; Geoffrey Michael,2,0,32,30
1657901158409,MATH 109,B02,083216,Ganzberger; Geoffrey Michael,2,0,32,30
1657901158409,MATH 109,B03,093479,Ganzberger; Geoffrey Michael,8,0,32,24
1657901164440,MATH 142A,A01,083219,Chow; Bennett,7,0,32,25
1657901164440,MATH 142A,A02,083220,Chow; Bennett,10,0,32,22
1657901164440,MATH 142A,A03,093480,Chow; Bennett,9,0,32,23
1657901164440,MATH 142A,B03,093481,Chow; Bennett,8,0,32,24
1657901164440,MATH 142A,B04,093558,Chow; Bennett,13,0,32,19
1657901164440,MATH 142A,B05,093559,Chow; Bennett,7,0,32,25
1657901170464,MATH 193A,A01,083224,Rotar; Vladimir,8,0,34,26
1657901170464,MATH 193A,A02,083225,Rotar; Vladimir,10,0,34,24
1657901170464,MATH 193A,A03,083781,Rotar; Vladimir,5,0,34,29
1657901170464,MATH 193A,A04,083782,Rotar; Vladimir,11,0,34,23
1657901170464,MATH 193A,A05,093482,Rotar; Vladimir,10,0,34,24
1657901176487,MATH 197,001,091859,McAuley; Julian John,9999,0,9999,0
1657901176487,MATH 197,002,095566,Kedlaya; Kiran S.,9997,0,9999,2
1657901176487,MATH 197,003,095567,Xiao; Ming,9999,0,9999,0
1657901176487,MATH 197,004,095571,Perols; Johan Lars,9998,0,9999,1
1657901183550,COGS 9,A01,083615,Shannon; Kyle Michael,10,0,75,65
1657901189580,COGS 11,A01,083617,Boyle; Mary E. T.,23,0,48,25
1657901195604,COGS 13,A01,083071,Bastos; Amalia Pinkusfeld,11,0,71,60
1657901201626,COGS 14A,A01,092681,Semenuks; Arturs,5,1,100,95
1657901207663,COGS 14B,A01,083073,Cheng; Tzu-Han,6,0,63,57
1657901213693,COGS 17,A01,092677,Semenuks; Arturs,6,0,81,75
1657901219725,COGS 100,A01,083619,Allen; Michael Gordon,17,0,70,53
1657901225749,COGS 101A,A01,083621,Davis; Joshua Daniel,9,0,68,59
1657901231780,COGS 101B,A01,091572,Allen; Michael Gordon,13,0,65,52
1657901237803,COGS 101C,A01,083625,Delgado; Tania,17,0,35,18
1657901243837,COGS 107A,A01,083627,Boyle; Mary E. T.,14,0,60,46
1657901249861,COGS 118A,A01,083075,Gupta; Anjum,21,0,76,55
1657901255899,CSE 3,A50,083646,Miranda; Gregory Joseph,24,0,50,26
1657901261924,CSE 8A,A50,083650,Miranda; Gregory Joseph,17,1,56,39
1657901267946,CSE 11,A01,083080,Cao; Yingjun,6,15,40,34
1657901273970,CSE 12,A01,083652,Krause-Levy; Sophia Louisa,30,1,120,90
1657901279996,CSE 15L,A01,083654,Morris; Justin Loren,9,0,50,41
1657901279996,CSE 15L,A02,083655,Morris; Justin Loren,10,0,50,40
1657901286023,CSE 20,A01,083657,Tran; Khoa Dang,39,0,80,41
1657901292045,CSE 21,A01,095574,Bach; Quang Tran,22,0,48,26
1657901298071,CSE 30,A01,083084,Eldon; John,6,0,80,74
1657901298071,CSE 30,B01,095061,Bhaskar; Nishant,9,0,50,41
1657901304093,CSE 100,A01,083659,Cao; Yingjun,5,4,70,65
1657901310115,CSE 134B,A01,083661,Powell; Thomas Allan,25,0,100,75
1657901316149,CSE 140,A01,083663,Gungor; Onat,15,0,85,70
1657901322173,CSE 140L,A01,083088,Eldon; John,23,0,100,77
1657901328197,CSE 175,A01,083665,Kumar; Rakesh,3,0,25,22
1657901334223,CSE 190,A00,092507,Dubnov; Shlomo,8,0,20,12
1657901340253,ECE 45,A01,083139,Congero; Spencer William,6,0,75,69
1657901346277,ECE 65,A50,083695,Saad; Andrew S,12,0,30,18
1657901346277,ECE 65,A51,095125,Saad; Andrew S,24,0,26,2
1657901352304,ECE 109,A01,091882,Touri; Behrouz,20,0,70,50
1657901358329,ECE 180,A00,083140,Abi Samra; Nicholas Camill,1,0,30,29
1657901358329,ECE 180,B00,083141,Abi Samra; Nicholas Camill,0,0,30,30
1657901364352,MATH 10A,A01,083735,Patchell; Gregory David,2,0,30,28
1657901364352,MATH 10A,A02,083736,Patchell; Gregory David,20,0,30,10
1657901364352,MATH 10A,A03,083737,Patchell; Gregory David,16,0,30,14
1657901370376,MATH 10B,A01,083207,Lim; Seonhee,8,0,34,26
1657901370376,MATH 10B,A02,083208,Lim; Seonhee,10,0,35,25
1657901370376,MATH 10B,A03,093472,Lim; Seonhee,7,0,34,27
1657901370376,MATH 10B,B01,083739,Sinha; Shubham,14,0,30,16
1657901376401,MATH 18,A01,083743,Cinel; Cameron Alexander,9,0,30,21
1657901376401,MATH 18,A02,083744,Cinel; Cameron Alexander,18,0,30,12
1657901376401,MATH 18,A03,083745,Cinel; Cameron Alexander,10,0,30,20
1657901376401,MATH 18,B01,083748,Rideout; David Porter,5,0,37,32
1657901376401,MATH 18,B02,083749,Rideout; David Porter,5,0,36,31
1657901376401,MATH 18,B03,083750,Rideout; David Porter,3,0,37,34
1657901376401,MATH 18,B04,083751,Rideout; David Porter,6,0,36,30
1657901376401,MATH 18,B05,093473,Rideout; David Porter,6,0,36,30
1657901376401,MATH 18,B06,093474,Rideout; David Porter,6,0,36,30
1657901382426,MATH 20A,A01,083754,Zheng; Zequn,14,0,40,26
1657901388454,MATH 20B,A01,083756,Briones; Jor-el Thomas Caparas,4,0,36,32
1657901388454,MATH 20B,A02,083757,Briones; Jor-el Thomas Caparas,1,0,36,35
1657901388454,MATH 20B,A03,093475,Briones; Jor-el Thomas Caparas,2,0,36,34
1657901394478,MATH 20C,A01,083760,Briones; Jor-el Thomas Caparas,1,0,35,34
1657901394478,MATH 20C,A02,083761,Briones; Jor-el Thomas Caparas,8,0,35,27
1657901394478,MATH 20C,A03,093476,Briones; Jor-el Thomas Caparas,0,1,36,36
1657901394478,MATH 20C,B01,083762,Bach; Quang Tran,1,0,30,29
1657901400503,MATH 20D,A01,083765,Tran; Brian Kha,5,0,30,25
1657901400503,MATH 20D,A02,083766,Tran; Brian Kha,5,0,30,25
1657901400503,MATH 20D,A03,083767,Tran; Brian Kha,5,0,30,25
1657901406529,MATH 20E,A01,083771,Ganguly; Soumya,10,0,32,22
1657901406529,MATH 20E,A02,083772,Ganguly; Soumya,6,0,32,26
1657901406529,MATH 20E,B01,083773,Ciotti; Benjamin,20,0,35,15
1657901406529,MATH 20E,B02,083774,Ciotti; Benjamin,18,0,35,17
1657901412554,MATH 103A,A01,083777,Greenfeld; Be'Eri,3,0,36,33
1657901412554,MATH 103A,A02,083778,Greenfeld; Be'Eri,5,0,36,31
1657901412554,MATH 103A,A03,093561,Greenfeld; Be'Eri,6,0,36,30
1657901412554,MATH 103A,B01,083779,Greenfeld; Be'Eri,7,0,36,29
1657901412554,MATH 103A,B02,083780,Greenfeld; Be'Eri,4,0,36,32
1657901412554,MATH 103A,B03,093562,Greenfeld; Be'Eri,3,0,36,33
1657901418575,MATH 105,A01,085443,Carter; Anne Toulson,15,0,35,20
1657901418575,MATH 105,A02,093477,Carter; Anne Toulson,20,0,35,15
1657901424602,MATH 109,A01,083213,Ganzberger; Geoffrey Michael,3,0,34,31
1657901424602,MATH 109,A02,083214,Ganzberger; Geoffrey Michael,4,0,34,30
1657901424602,MATH 109,A03,093478,Ganzberger; Geoffrey Michael,2,0,34,32
1657901424602,MATH 109,B01,083215,Ganzberger; Geoffrey Michael,2,0,32,30
1657901424602,MATH 109,B02,083216,Ganzberger; Geoffrey Michael,2,0,32,30
1657901424602,MATH 109,B03,093479,Ganzberger; Geoffrey Michael,8,0,32,24
1657901430632,MATH 142A,A01,083219,Chow; Bennett,7,0,32,25
1657901430632,MATH 142A,A02,083220,Chow; Bennett,10,0,32,22
1657901430632,MATH 142A,A03,093480,Chow; Bennett,9,0,32,23
1657901430632,MATH 142A,B03,093481,Chow; Bennett,8,0,32,24
1657901430632,MATH 142A,B04,093558,Chow; Bennett,13,0,32,19
1657901430632,MATH 142A,B05,093559,Chow; Bennett,7,0,32,25
1657901436659,MATH 193A,A01,083224,Rotar; Vladimir,8,0,34,26
1657901436659,MATH 193A,A02,083225,Rotar; Vladimir,10,0,34,24
1657901436659,MATH 193A,A03,083781,Rotar; Vladimir,5,0,34,29
1657901436659,MATH 193A,A04,083782,Rotar; Vladimir,11,0,34,23
1657901436659,MATH 193A,A05,093482,Rotar; Vladimir,10,0,34,24
1657901442685,MATH 197,001,091859,McAuley; Julian John,9999,0,9999,0
1657901442685,MATH 197,002,095566,Kedlaya; Kiran S.,9997,0,9999,2
1657901442685,MATH 197,003,095567,Xiao; Ming,9999,0,9999,0
1657901442685,MATH 197,004,095571,Perols; Johan Lars,9998,0,9999,1
1657901449743,COGS 9,A01,083615,Shannon; Kyle Michael,10,0,75,65
1657901455767,COGS 11,A01,083617,Boyle; Mary E. T.,23,0,48,25
1657901461792,COGS 13,A01,083071,Bastos; Amalia Pinkusfeld,11,0,71,60
1657901467827,COGS 14A,A01,092681,Semenuks; Arturs,5,1,100,95
1657901473853,COGS 14B,A01,083073,Cheng; Tzu-Han,6,0,63,57
1657901479880,COGS 17,A01,092677,Semenuks; Arturs,6,0,81,75
1657901485902,COGS 100,A01,083619,Allen; Michael Gordon,17,0,70,53
1657901491925,COGS 101A,A01,083621,Davis; Joshua Daniel,9,0,68,59
1657901497950,COGS 101B,A01,091572,Allen; Michael Gordon,13,0,65,52
1657901503972,COGS 101C,A01,083625,Delgado; Tania,17,0,35,18
1657901509999,COGS 107A,A01,083627,Boyle; Mary E. T.,14,0,60,46
1657901516027,COGS 118A,A01,083075,Gupta; Anjum,21,0,76,55
1657901522052,CSE 3,A50,083646,Miranda; Gregory Joseph,24,0,50,26
1657901528081,CSE 8A,A50,083650,Miranda; Gregory Joseph,17,1,56,39
1657901534113,CSE 11,A01,083080,Cao; Yingjun,6,15,40,34
1657901540143,CSE 12,A01,083652,Krause-Levy; Sophia Louisa,30,1,120,90
1657901546166,CSE 15L,A01,083654,Morris; Justin Loren,9,0,50,41
1657901546166,CSE 15L,A02,083655,Morris; Justin Loren,10,0,50,40
1657901552198,CSE 20,A01,083657,Tran; Khoa Dang,39,0,80,41
1657901558225,CSE 21,A01,095574,Bach; Quang Tran,22,0,48,26
1657901564252,CSE 30,A01,083084,Eldon; John,6,0,80,74
1657901564252,CSE 30,B01,095061,Bhaskar; Nishant,9,0,50,41
1657901570280,CSE 100,A01,083659,Cao; Yingjun,5,4,70,65
1657901576305,CSE 134B,A01,083661,Powell; Thomas Allan,25,0,100,75
1657901582334,CSE 140,A01,083663,Gungor; Onat,15,0,85,70
1657901588356,CSE 140L,A01,083088,Eldon; John,23,0,100,77
1657901594391,CSE 175,A01,083665,Kumar; Rakesh,3,0,25,22
1657901600414,CSE 190,A00,092507,Dubnov; Shlomo,8,0,20,12
1657901606442,ECE 45,A01,083139,Congero; Spencer William,6,0,75,69
1657901612482,ECE 65,A50,083695,Saad; Andrew S,12,0,30,18
1657901612482,ECE 65,A51,095125,Saad; Andrew S,24,0,26,2
1657901618516,ECE 109,A01,091882,Touri; Behrouz,20,0,70,50
1657901624546,ECE 180,A00,083140,Abi Samra; Nicholas Camill,1,0,30,29
1657901624546,ECE 180,B00,083141,Abi Samra; Nicholas Camill,0,0,30,30
1657901630574,MATH 10A,A01,083735,Patchell; Gregory David,2,0,30,28
1657901630574,MATH 10A,A02,083736,Patchell; Gregory David,20,0,30,10
1657901630574,MATH 10A,A03,083737,Patchell; Gregory David,16,0,30,14
1657901636602,MATH 10B,A01,083207,Lim; Seonhee,8,0,34,26
1657901636602,MATH 10B,A02,083208,Lim; Seonhee,10,0,35,25
1657901636602,MATH 10B,A03,093472,Lim; Seonhee,7,0,34,27
1657901636602,MATH 10B,B01,083739,Sinha; Shubham,14,0,30,16
1657901642638,MATH 18,A01,083743,Cinel; Cameron Alexander,9,0,30,21
1657901642638,MATH 18,A02,083744,Cinel; Cameron Alexander,18,0,30,12
1657901642638,MATH 18,A03,083745,Cinel; Cameron Alexander,10,0,30,20
1657901642638,MATH 18,B01,083748,Rideout; David Porter,5,0,37,32
1657901642638,MATH 18,B02,083749,Rideout; David Porter,5,0,36,31
1657901642638,MATH 18,B03,083750,Rideout; David Porter,3,0,37,34
1657901642638,MATH 18,B04,083751,Rideout; David Porter,6,0,36,30
1657901642638,MATH 18,B05,093473,Rideout; David Porter,6,0,36,30
1657901642638,MATH 18,B06,093474,Rideout; David Porter,6,0,36,30
1657901648664,MATH 20A,A01,083754,Zheng; Zequn,14,0,40,26
1657901654692,MATH 20B,A01,083756,Briones; Jor-el Thomas Caparas,4,0,36,32
1657901654692,MATH 20B,A02,083757,Briones; Jor-el Thomas Caparas,1,0,36,35
1657901654692,MATH 20B,A03,093475,Briones; Jor-el Thomas Caparas,2,0,36,34
1657901660724,MATH 20C,A01,083760,Briones; Jor-el Thomas Caparas,1,0,35,34
1657901660724,MATH 20C,A02,083761,Briones; Jor-el Thomas Caparas,8,0,35,27
1657901660724,MATH 20C,A03,093476,Briones; Jor-el Thomas Caparas,0,1,36,36
1657901660724,MATH 20C,B01,083762,Bach; Quang Tran,1,0,30,29
1657901666749,MATH 20D,A01,083765,Tran; Brian Kha,5,0,30,25
1657901666749,MATH 20D,A02,083766,Tran; Brian Kha,5,0,30,25
1657901666749,MATH 20D,A03,083767,Tran; Brian Kha,5,0,30,25
1657901672783,MATH 20E,A01,083771,Ganguly; Soumya,10,0,32,22
1657901672783,MATH 20E,A02,083772,Ganguly; Soumya,6,0,32,26
1657901672783,MATH 20E,B01,083773,Ciotti; Benjamin,20,0,35,15
1657901672783,MATH 20E,B02,083774,Ciotti; Benjamin,18,0,35,17
1657901678812,MATH 103A,A01,083777,Greenfeld; Be'Eri,3,0,36,33
1657901678812,MATH 103A,A02,083778,Greenfeld; Be'Eri,5,0,36,31
1657901678812,MATH 103A,A03,093561,Greenfeld; Be'Eri,6,0,36,30
1657901678812,MATH 103A,B01,083779,Greenfeld; Be'Eri,7,0,36,29
1657901678812,MATH 103A,B02,083780,Greenfeld; Be'Eri,4,0,36,32
1657901678812,MATH 103A,B03,093562,Greenfeld; Be'Eri,3,0,36,33
1657901684836,MATH 105,A01,085443,Carter; Anne Toulson,15,0,35,20
1657901684836,MATH 105,A02,093477,Carter; Anne Toulson,20,0,35,15
1657901690860,MATH 109,A01,083213,Ganzberger; Geoffrey Michael,3,0,34,31
1657901690860,MATH 109,A02,083214,Ganzberger; Geoffrey Michael,4,0,34,30
1657901690860,MATH 109,A03,093478,Ganzberger; Geoffrey Michael,2,0,34,32
1657901690860,MATH 109,B01,083215,Ganzberger; Geoffrey Michael,2,0,32,30
1657901690860,MATH 109,B02,083216,Ganzberger; Geoffrey Michael,2,0,32,30
1657901690860,MATH 109,B03,093479,Ganzberger; Geoffrey Michael,8,0,32,24
1657901696884,MATH 142A,A01,083219,Chow; Bennett,7,0,32,25
1657901696884,MATH 142A,A02,083220,Chow; Bennett,10,0,32,22
1657901696884,MATH 142A,A03,093480,Chow; Bennett,9,0,32,23
1657901696884,MATH 142A,B03,093481,Chow; Bennett,8,0,32,24
1657901696884,MATH 142A,B04,093558,Chow; Bennett,13,0,32,19
1657901696884,MATH 142A,B05,093559,Chow; Bennett,7,0,32,25
1657901702909,MATH 193A,A01,083224,Rotar; Vladimir,8,0,34,26
1657901702909,MATH 193A,A02,083225,Rotar; Vladimir,10,0,34,24
1657901702909,MATH 193A,A03,083781,Rotar; Vladimir,5,0,34,29
1657901702909,MATH 193A,A04,083782,Rotar; Vladimir,11,0,34,23
1657901702909,MATH 193A,A05,093482,Rotar; Vladimir,10,0,34,24
1657901708934,MATH 197,001,091859,McAuley; Julian John,9999,0,9999,0
1657901708934,MATH 197,002,095566,Kedlaya; Kiran S.,9997,0,9999,2
1657901708934,MATH 197,003,095567,Xiao; Ming,9999,0,9999,0
1657901708934,MATH 197,004,095571,Perols; Johan Lars,9998,0,9999,1
1657901716065,COGS 9,A01,083615,Shannon; Kyle Michael,10,0,75,65
1657901722124,COGS 11,A01,083617,Boyle; Mary E. T.,23,0,48,25
1657901728149,COGS 13,A01,083071,Bastos; Amalia Pinkusfeld,11,0,71,60
1657901734176,COGS 14A,A01,092681,Semenuks; Arturs,5,1,100,95
1657901740198,COGS 14B,A01,083073,Cheng; Tzu-Han,6,0,63,57
1657901746221,COGS 17,A01,092677,Semenuks; Arturs,6,0,81,75
1657901752247,COGS 100,A01,083619,Allen; Michael Gordon,17,0,70,53
1657901758271,COGS 101A,A01,083621,Davis; Joshua Daniel,9,0,68,59
1657901764295,COGS 101B,A01,091572,Allen; Michael Gordon,13,0,65,52
1657901770322,COGS 101C,A01,083625,Delgado; Tania,17,0,35,18
1657901776344,COGS 107A,A01,083627,Boyle; Mary E. T.,14,0,60,46
1657901782366,COGS 118A,A01,083075,Gupta; Anjum,21,0,76,55
1657901788393,CSE 3,A50,083646,Miranda; Gregory Joseph,24,0,50,26
1657901794428,CSE 8A,A50,083650,Miranda; Gregory Joseph,17,1,56,39
1657901800456,CSE 11,A01,083080,Cao; Yingjun,6,15,40,34
1657901806485,CSE 12,A01,083652,Krause-Levy; Sophia Louisa,30,1,120,90
1657901812507,CSE 15L,A01,083654,Morris; Justin Loren,9,0,50,41
1657901812507,CSE 15L,A02,083655,Morris; Justin Loren,10,0,50,40
1657901818530,CSE 20,A01,083657,Tran; Khoa Dang,39,0,80,41
1657901824570,CSE 21,A01,095574,Bach; Quang Tran,22,0,48,26
1657901830602,CSE 30,A01,083084,Eldon; John,6,0,80,74
1657901830602,CSE 30,B01,095061,Bhaskar; Nishant,9,0,50,41
1657901836628,CSE 100,A01,083659,Cao; Yingjun,5,4,70,65
1657901842656,CSE 134B,A01,083661,Powell; Thomas Allan,25,0,100,75
1657901848678,CSE 140,A01,083663,Gungor; Onat,15,0,85,70
1657901854701,CSE 140L,A01,083088,Eldon; John,23,0,100,77
1657901860723,CSE 175,A01,083665,Kumar; Rakesh,3,0,25,22
1657901866750,CSE 190,A00,092507,Dubnov; Shlomo,8,0,20,12
1657901872779,ECE 45,A01,083139,Congero; Spencer William,6,0,75,69
1657901878805,ECE 65,A50,083695,Saad; Andrew S,12,0,30,18
1657901878805,ECE 65,A51,095125,Saad; Andrew S,24,0,26,2
1657901884836,ECE 109,A01,091882,Touri; Behrouz,20,0,70,50
1657901890859,ECE 180,A00,083140,Abi Samra; Nicholas Camill,1,0,30,29
1657901890859,ECE 180,B00,083141,Abi Samra; Nicholas Camill,0,0,30,30
1657901896887,MATH 10A,A01,083735,Patchell; Gregory David,2,0,30,28
1657901896887,MATH 10A,A02,083736,Patchell; Gregory David,20,0,30,10
1657901896887,MATH 10A,A03,083737,Patchell; Gregory David,16,0,30,14
1657901902911,MATH 10B,A01,083207,Lim; Seonhee,8,0,34,26
1657901902911,MATH 10B,A02,083208,Lim; Seonhee,10,0,35,25
1657901902911,MATH 10B,A03,093472,Lim; Seonhee,7,0,34,27
1657901902911,MATH 10B,B01,083739,Sinha; Shubham,14,0,30,16
1657901908941,MATH 18,A01,083743,Cinel; Cameron Alexander,9,0,30,21
1657901908941,MATH 18,A02,083744,Cinel; Cameron Alexander,18,0,30,12
1657901908941,MATH 18,A03,083745,Cinel; Cameron Alexander,10,0,30,20
1657901908941,MATH 18,B01,083748,Rideout; David Porter,5,0,37,32
1657901908941,MATH 18,B02,083749,Rideout; David Porter,5,0,36,31
1657901908941,MATH 18,B03,083750,Rideout; David Porter,3,0,37,34
1657901908941,MATH 18,B04,083751,Rideout; David Porter,6,0,36,30
1657901908941,MATH 18,B05,093473,Rideout; David Porter,6,0,36,30
1657901908941,MATH 18,B06,093474,Rideout; David Porter,6,0,36,30
1657901914963,MATH 20A,A01,083754,Zheng; Zequn,14,0,40,26
1657901920990,MATH 20B,A01,083756,Briones; Jor-el Thomas Caparas,4,0,36,32
1657901920990,MATH 20B,A02,083757,Briones; Jor-el Thomas Caparas,1,0,36,35
1657901920990,MATH 20B,A03,093475,Briones; Jor-el Thomas Caparas,2,0,36,34
1657901927013,MATH 20C,A01,083760,Briones; Jor-el Thomas Caparas,1,0,35,34
1657901927013,MATH 20C,A02,083761,Briones; Jor-el Thomas Caparas,8,0,35,27
1657901927013,MATH 20C,A03,093476,Briones; Jor-el Thomas Caparas,0,1,36,36
1657901927013,MATH 20C,B01,083762,Bach; Quang Tran,1,0,30,29
1657901933051,MATH 20D,A01,083765,Tran; Brian Kha,5,0,30,25
1657901933051,MATH 20D,A02,083766,Tran; Brian Kha,5,0,30,25
1657901933051,MATH 20D,A03,083767,Tran; Brian Kha,5,0,30,25
1657901939079,MATH 20E,A01,083771,Ganguly; Soumya,10,0,32,22
1657901939079,MATH 20E,A02,083772,Ganguly; Soumya,6,0,32,26
1657901939079,MATH 20E,B01,083773,Ciotti; Benjamin,20,0,35,15
1657901939079,MATH 20E,B02,083774,Ciotti; Benjamin,18,0,35,17
1657901945107,MATH 103A,A01,083777,Greenfeld; Be'Eri,3,0,36,33
1657901945107,MATH 103A,A02,083778,Greenfeld; Be'Eri,5,0,36,31
1657901945107,MATH 103A,A03,093561,Greenfeld; Be'Eri,6,0,36,30
1657901945107,MATH 103A,B01,083779,Greenfeld; Be'Eri,7,0,36,29
1657901945107,MATH 103A,B02,083780,Greenfeld; Be'Eri,4,0,36,32
1657901945107,MATH 103A,B03,093562,Greenfeld; Be'Eri,3,0,36,33
1657901951134,MATH 105,A01,085443,Carter; Anne Toulson,15,0,35,20
1657901951134,MATH 105,A02,093477,Carter; Anne Toulson,20,0,35,15
1657901957158,MATH 109,A01,083213,Ganzberger; Geoffrey Michael,3,0,34,31
1657901957158,MATH 109,A02,083214,Ganzberger; Geoffrey Michael,4,0,34,30
1657901957158,MATH 109,A03,093478,Ganzberger; Geoffrey Michael,2,0,34,32
1657901957158,MATH 109,B01,083215,Ganzberger; Geoffrey Michael,2,0,32,30
1657901957158,MATH 109,B02,083216,Ganzberger; Geoffrey Michael,2,0,32,30
1657901957158,MATH 109,B03,093479,Ganzberger; Geoffrey Michael,8,0,32,24
1657901963191,MATH 142A,A01,083219,Chow; Bennett,7,0,32,25
1657901963191,MATH 142A,A02,083220,Chow; Bennett,10,0,32,22
1657901963191,MATH 142A,A03,093480,Chow; Bennett,9,0,32,23
1657901963191,MATH 142A,B03,093481,Chow; Bennett,8,0,32,24
1657901963191,MATH 142A,B04,093558,Chow; Bennett,13,0,32,19
1657901963191,MATH 142A,B05,093559,Chow; Bennett,7,0,32,25
1657901969216,MATH 193A,A01,083224,Rotar; Vladimir,8,0,34,26
1657901969216,MATH 193A,A02,083225,Rotar; Vladimir,10,0,34,24
1657901969216,MATH 193A,A03,083781,Rotar; Vladimir,5,0,34,29
1657901969216,MATH 193A,A04,083782,Rotar; Vladimir,11,0,34,23
1657901969216,MATH 193A,A05,093482,Rotar; Vladimir,10,0,34,24
1657901975240,MATH 197,001,091859,McAuley; Julian John,9999,0,9999,0
1657901975240,MATH 197,002,095566,Kedlaya; Kiran S.,9997,0,9999,2
1657901975240,MATH 197,003,095567,Xiao; Ming,9999,0,9999,0
1657901975240,MATH 197,004,095571,Perols; Johan Lars,9998,0,9999,1
1657901982312,COGS 9,A01,083615,Shannon; Kyle Michael,10,0,75,65
1657901988337,COGS 11,A01,083617,Boyle; Mary E. T.,23,0,48,25
1657901994362,COGS 13,A01,083071,Bastos; Amalia Pinkusfeld,11,0,71,60
1657902000385,COGS 14A,A01,092681,Semenuks; Arturs,5,1,100,95
1657902006413,COGS 14B,A01,083073,Cheng; Tzu-Han,6,0,63,57
1657902012436,COGS 17,A01,092677,Semenuks; Arturs,6,0,81,75
1657902018467,COGS 100,A01,083619,Allen; Michael Gordon,17,0,70,53
1657902024502,COGS 101A,A01,083621,Davis; Joshua Daniel,9,0,68,59
1657902030529,COGS 101B,A01,091572,Allen; Michael Gordon,13,0,65,52
1657902036561,COGS 101C,A01,083625,Delgado; Tania,17,0,35,18
1657902042591,COGS 107A,A01,083627,Boyle; Mary E. T.,14,0,60,46
1657902048614,COGS 118A,A01,083075,Gupta; Anjum,21,0,76,55
1657902054640,CSE 3,A50,083646,Miranda; Gregory Joseph,24,0,50,26
1657902060672,CSE 8A,A50,083650,Miranda; Gregory Joseph,17,1,56,39
1657902066694,CSE 11,A01,083080,Cao; Yingjun,6,15,40,34
1657902072718,CSE 12,A01,083652,Krause-Levy; Sophia Louisa,30,1,120,90
1657902078740,CSE 15L,A01,083654,Morris; Justin Loren,9,0,50,41
1657902078740,CSE 15L,A02,083655,Morris; Justin Loren,10,0,50,40
1657902084773,CSE 20,A01,083657,Tran; Khoa Dang,39,0,80,41
1657902090799,CSE 21,A01,095574,Bach; Quang Tran,22,0,48,26
1657902096828,CSE 30,A01,083084,Eldon; John,6,0,80,74
1657902096828,CSE 30,B01,095061,Bhaskar; Nishant,9,0,50,41
1657902102854,CSE 100,A01,083659,Cao; Yingjun,5,4,70,65
1657902108878,CSE 134B,A01,083661,Powell; Thomas Allan,25,0,100,75
1657902114905,CSE 140,A01,083663,Gungor; Onat,15,0,85,70
1657902120931,CSE 140L,A01,083088,Eldon; John,23,0,100,77
1657902126958,CSE 175,A01,083665,Kumar; Rakesh,3,0,25,22
1657902132982,CSE 190,A00,092507,Dubnov; Shlomo,8,0,20,12
1657902139007,ECE 45,A01,083139,Congero; Spencer William,6,0,75,69
1657902145035,ECE 65,A50,083695,Saad; Andrew S,12,0,30,18
1657902145035,ECE 65,A51,095125,Saad; Andrew S,24,0,26,2
1657902151059,ECE 109,A01,091882,Touri; Behrouz,20,0,70,50
1657902157085,ECE 180,A00,083140,Abi Samra; Nicholas Camill,1,0,30,29
1657902157085,ECE 180,B00,083141,Abi Samra; Nicholas Camill,0,0,30,30
1657902163110,MATH 10A,A01,083735,Patchell; Gregory David,2,0,30,28
1657902163110,MATH 10A,A02,083736,Patchell; Gregory David,20,0,30,10
1657902163110,MATH 10A,A03,083737,Patchell; Gregory David,16,0,30,14
1657902169134,MATH 10B,A01,083207,Lim; Seonhee,8,0,34,26
1657902169134,MATH 10B,A02,083208,Lim; Seonhee,10,0,35,25
1657902169134,MATH 10B,A03,093472,Lim; Seonhee,7,0,34,27
1657902169134,MATH 10B,B01,083739,Sinha; Shubham,14,0,30,16
1657902175157,MATH 18,A01,083743,Cinel; Cameron Alexander,9,0,30,21
1657902175157,MATH 18,A02,083744,Cinel; Cameron Alexander,18,0,30,12
1657902175157,MATH 18,A03,083745,Cinel; Cameron Alexander,10,0,30,20
1657902175157,MATH 18,B01,083748,Rideout; David Porter,5,0,37,32
1657902175157,MATH 18,B02,083749,Rideout; David Porter,5,0,36,31
1657902175157,MATH 18,B03,083750,Rideout; David Porter,3,0,37,34
1657902175157,MATH 18,B04,083751,Rideout; David Porter,6,0,36,30
1657902175157,MATH 18,B05,093473,Rideout; David Porter,6,0,36,30
1657902175157,MATH 18,B06,093474,Rideout; David Porter,6,0,36,30
1657902181180,MATH 20A,A01,083754,Zheng; Zequn,14,0,40,26
1657902187207,MATH 20B,A01,083756,Briones; Jor-el Thomas Caparas,4,0,36,32
1657902187207,MATH 20B,A02,083757,Briones; Jor-el Thomas Caparas,1,0,36,35
1657902187207,MATH 20B,A03,093475,Briones; Jor-el Thomas Caparas,2,0,36,34
1657902193236,MATH 20C,A01,083760,Briones; Jor-el Thomas Caparas,1,0,35,34
1657902193236,MATH 20C,A02,083761,Briones; Jor-el Thomas Caparas,8,0,35,27
1657902193236,MATH 20C,A03,093476,Briones; Jor-el Thomas Caparas,0,1,36,36
1657902193236,MATH 20C,B01,083762,Bach; Quang Tran,1,0,30,29
1657902199261,MATH 20D,A01,083765,Tran; Brian Kha,5,0,30,25
1657902199261,MATH 20D,A02,083766,Tran; Brian Kha,5,0,30,25
1657902199261,MATH 20D,A03,083767,Tran; Brian Kha,5,0,30,25
1657902205290,MATH 20E,A01,083771,Ganguly; Soumya,10,0,32,22
1657902205290,MATH 20E,A02,083772,Ganguly; Soumya,6,0,32,26
1657902205290,MATH 20E,B01,083773,Ciotti; Benjamin,20,0,35,15
1657902205290,MATH 20E,B02,083774,Ciotti; Benjamin,18,0,35,17
1657902211312,MATH 103A,A01,083777,Greenfeld; Be'Eri,3,0,36,33
1657902211312,MATH 103A,A02,083778,Greenfeld; Be'Eri,5,0,36,31
1657902211312,MATH 103A,A03,093561,Greenfeld; Be'Eri,6,0,36,30
1657902211312,MATH 103A,B01,083779,Greenfeld; Be'Eri,7,0,36,29
1657902211312,MATH 103A,B02,083780,Greenfeld; Be'Eri,4,0,36,32
1657902211312,MATH 103A,B03,093562,Greenfeld; Be'Eri,3,0,36,33
1657902217336,MATH 105,A01,085443,Carter; Anne Toulson,15,0,35,20
1657902217336,MATH 105,A02,093477,Carter; Anne Toulson,20,0,35,15
1657902223367,MATH 109,A01,083213,Ganzberger; Geoffrey Michael,3,0,34,31
1657902223367,MATH 109,A02,083214,Ganzberger; Geoffrey Michael,4,0,34,30
1657902223367,MATH 109,A03,093478,Ganzberger; Geoffrey Michael,2,0,34,32
1657902223367,MATH 109,B01,083215,Ganzberger; Geoffrey Michael,2,0,32,30
1657902223367,MATH 109,B02,083216,Ganzberger; Geoffrey Michael,2,0,32,30
1657902223367,MATH 109,B03,093479,Ganzberger; Geoffrey Michael,8,0,32,24
1657902229394,MATH 142A,A01,083219,Chow; Bennett,7,0,32,25
1657902229394,MATH 142A,A02,083220,Chow; Bennett,10,0,32,22
1657902229394,MATH 142A,A03,093480,Chow; Bennett,9,0,32,23
1657902229394,MATH 142A,B03,093481,Chow; Bennett,8,0,32,24
1657902229394,MATH 142A,B04,093558,Chow; Bennett,13,0,32,19
1657902229394,MATH 142A,B05,093559,Chow; Bennett,7,0,32,25
1657902235419,MATH 193A,A01,083224,Rotar; Vladimir,8,0,34,26
1657902235419,MATH 193A,A02,083225,Rotar; Vladimir,10,0,34,24
1657902235419,MATH 193A,A03,083781,Rotar; Vladimir,5,0,34,29
1657902235419,MATH 193A,A04,083782,Rotar; Vladimir,11,0,34,23
1657902235419,MATH 193A,A05,093482,Rotar; Vladimir,10,0,34,24
1657902241442,MATH 197,001,091859,McAuley; Julian John,9999,0,9999,0
1657902241442,MATH 197,002,095566,Kedlaya; Kiran S.,9997,0,9999,2
1657902241442,MATH 197,003,095567,Xiao; Ming,9999,0,9999,0
1657902241442,MATH 197,004,095571,Perols; Johan Lars,9998,0,9999,1
1657902248503,COGS 9,A01,083615,Shannon; Kyle Michael,10,0,75,65
1657902254529,COGS 11,A01,083617,Boyle; Mary E. T.,23,0,48,25
1657902260552,COGS 13,A01,083071,Bastos; Amalia Pinkusfeld,11,0,71,60
1657902266586,COGS 14A,A01,092681,Semenuks; Arturs,5,1,100,95
1657902272609,COGS 14B,A01,083073,Cheng; Tzu-Han,6,0,63,57
1657902278636,COGS 17,A01,092677,Semenuks; Arturs,6,0,81,75
1657902284659,COGS 100,A01,083619,Allen; Michael Gordon,17,0,70,53
1657902290687,COGS 101A,A01,083621,Davis; Joshua Daniel,9,0,68,59
1657902296710,COGS 101B,A01,091572,Allen; Michael Gordon,13,0,65,52
1657902302742,COGS 101C,A01,083625,Delgado; Tania,17,0,35,18
1657902308768,COGS 107A,A01,083627,Boyle; Mary E. T.,14,0,60,46
1657902314883,COGS 118A,A01,083075,Gupta; Anjum,21,0,76,55
1657902320906,CSE 3,A50,083646,Miranda; Gregory Joseph,24,0,50,26
1657902326934,CSE 8A,A50,083650,Miranda; Gregory Joseph,17,1,56,39
1657902332957,CSE 11,A01,083080,Cao; Yingjun,6,15,40,34
1657902338980,CSE 12,A01,083652,Krause-Levy; Sophia Louisa,30,1,120,90
1657902345005,CSE 15L,A01,083654,Morris; Justin Loren,9,0,50,41
1657902345005,CSE 15L,A02,083655,Morris; Justin Loren,10,0,50,40
1657902351029,CSE 20,A01,083657,Tran; Khoa Dang,39,0,80,41
1657902357053,CSE 21,A01,095574,Bach; Quang Tran,22,0,48,26
1657902363076,CSE 30,A01,083084,Eldon; John,6,0,80,74
1657902363076,CSE 30,B01,095061,Bhaskar; Nishant,9,0,50,41
1657902369101,CSE 100,A01,083659,Cao; Yingjun,5,4,70,65
1657902375123,CSE 134B,A01,083661,Powell; Thomas Allan,25,0,100,75
1657902381147,CSE 140,A01,083663,Gungor; Onat,15,0,85,70
1657902387170,CSE 140L,A01,083088,Eldon; John,23,0,100,77
1657902393198,CSE 175,A01,083665,Kumar; Rakesh,3,0,25,22
1657902399221,CSE 190,A00,092507,Dubnov; Shlomo,8,0,20,12
1657902405245,ECE 45,A01,083139,Congero; Spencer William,6,0,75,69
1657902411272,ECE 65,A50,083695,Saad; Andrew S,12,0,30,18
1657902411272,ECE 65,A51,095125,Saad; Andrew S,24,0,26,2
1657902417298,ECE 109,A01,091882,Touri; Behrouz,20,0,70,50
1657902423321,ECE 180,A00,083140,Abi Samra; Nicholas Camill,1,0,30,29
1657902423321,ECE 180,B00,083141,Abi Samra; Nicholas Camill,0,0,30,30
1657902429353,MATH 10A,A01,083735,Patchell; Gregory David,2,0,30,28
1657902429353,MATH 10A,A02,083736,Patchell; Gregory David,20,0,30,10
1657902429353,MATH 10A,A03,083737,Patchell; Gregory David,16,0,30,14
1657902435389,MATH 10B,A01,083207,Lim; Seonhee,8,0,34,26
1657902435389,MATH 10B,A02,083208,Lim; Seonhee,10,0,35,25
1657902435389,MATH 10B,A03,093472,Lim; Seonhee,7,0,34,27
1657902435389,MATH 10B,B01,083739,Sinha; Shubham,14,0,30,16
1657902441419,MATH 18,A01,083743,Cinel; Cameron Alexander,9,0,30,21
1657902441419,MATH 18,A02,083744,Cinel; Cameron Alexander,18,0,30,12
1657902441419,MATH 18,A03,083745,Cinel; Cameron Alexander,10,0,30,20
1657902441419,MATH 18,B01,083748,Rideout; David Porter,5,0,37,32
1657902441419,MATH 18,B02,083749,Rideout; David Porter,5,0,36,31
1657902441419,MATH 18,B03,083750,Rideout; David Porter,3,0,37,34
1657902441419,MATH 18,B04,083751,Rideout; David Porter,6,0,36,30
1657902441419,MATH 18,B05,093473,Rideout; David Porter,6,0,36,30
1657902441419,MATH 18,B06,093474,Rideout; David Porter,6,0,36,30
1657902447462,MATH 20A,A01,083754,Zheng; Zequn,14,0,40,26
1657902453496,MATH 20B,A01,083756,Briones; Jor-el Thomas Caparas,4,0,36,32
1657902453496,MATH 20B,A02,083757,Briones; Jor-el Thomas Caparas,1,0,36,35
1657902453496,MATH 20B,A03,093475,Briones; Jor-el Thomas Caparas,2,0,36,34
1657902459532,MATH 20C,A01,083760,Briones; Jor-el Thomas Caparas,1,0,35,34
1657902459532,MATH 20C,A02,083761,Briones; Jor-el Thomas Caparas,8,0,35,27
1657902459532,MATH 20C,A03,093476,Briones; Jor-el Thomas Caparas,0,1,36,36
1657902459532,MATH 20C,B01,083762,Bach; Quang Tran,1,0,30,29
1657902465607,MATH 20D,A01,083765,Tran; Brian Kha,5,0,30,25
1657902465607,MATH 20D,A02,083766,Tran; Brian Kha,5,0,30,25
1657902465607,MATH 20D,A03,083767,Tran; Brian Kha,5,0,30,25
1657902471637,MATH 20E,A01,083771,Ganguly; Soumya,10,0,32,22
1657902471637,MATH 20E,A02,083772,Ganguly; Soumya,6,0,32,26
1657902471637,MATH 20E,B01,083773,Ciotti; Benjamin,20,0,35,15
1657902471637,MATH 20E,B02,083774,Ciotti; Benjamin,18,0,35,17
1657902477667,MATH 103A,A01,083777,Greenfeld; Be'Eri,3,0,36,33
1657902477667,MATH 103A,A02,083778,Greenfeld; Be'Eri,5,0,36,31
1657902477667,MATH 103A,A03,093561,Greenfeld; Be'Eri,6,0,36,30
1657902477667,MATH 103A,B01,083779,Greenfeld; Be'Eri,7,0,36,29
1657902477667,MATH 103A,B02,083780,Greenfeld; Be'Eri,4,0,36,32
1657902477667,MATH 103A,B03,093562,Greenfeld; Be'Eri,3,0,36,33
1657902483690,MATH 105,A01,085443,Carter; Anne Toulson,15,0,35,20
1657902483690,MATH 105,A02,093477,Carter; Anne Toulson,20,0,35,15
1657902489719,MATH 109,A01,083213,Ganzberger; Geoffrey Michael,3,0,34,31
1657902489719,MATH 109,A02,083214,Ganzberger; Geoffrey Michael,4,0,34,30
1657902489719,MATH 109,A03,093478,Ganzberger; Geoffrey Michael,2,0,34,32
1657902489719,MATH 109,B01,083215,Ganzberger; Geoffrey Michael,2,0,32,30
1657902489719,MATH 109,B02,083216,Ganzberger; Geoffrey Michael,2,0,32,30
1657902489719,MATH 109,B03,093479,Ganzberger; Geoffrey Michael,8,0,32,24
1657902495743,MATH 142A,A01,083219,Chow; Bennett,7,0,32,25
1657902495743,MATH 142A,A02,083220,Chow; Bennett,10,0,32,22
1657902495743,MATH 142A,A03,093480,Chow; Bennett,9,0,32,23
1657902495743,MATH 142A,B03,093481,Chow; Bennett,8,0,32,24
1657902495743,MATH 142A,B04,093558,Chow; Bennett,13,0,32,19
1657902495743,MATH 142A,B05,093559,Chow; Bennett,7,0,32,25
1657902501770,MATH 193A,A01,083224,Rotar; Vladimir,8,0,34,26
1657902501770,MATH 193A,A02,083225,Rotar; Vladimir,10,0,34,24
1657902501770,MATH 193A,A03,083781,Rotar; Vladimir,5,0,34,29
1657902501770,MATH 193A,A04,083782,Rotar; Vladimir,11,0,34,23
1657902501770,MATH 193A,A05,093482,Rotar; Vladimir,10,0,34,24
1657902507793,MATH 197,001,091859,McAuley; Julian John,9999,0,9999,0
1657902507793,MATH 197,002,095566,Kedlaya; Kiran S.,9997,0,9999,2
1657902507793,MATH 197,003,095567,Xiao; Ming,9999,0,9999,0
1657902507793,MATH 197,004,095571,Perols; Johan Lars,9998,0,9999,1
1657902514850,COGS 9,A01,083615,Shannon; Kyle Michael,10,0,75,65
1657902520874,COGS 11,A01,083617,Boyle; Mary E. T.,23,0,48,25
1657902526900,COGS 13,A01,083071,Bastos; Amalia Pinkusfeld,11,0,71,60
1657902532927,COGS 14A,A01,092681,Semenuks; Arturs,5,1,100,95
1657902538953,COGS 14B,A01,083073,Cheng; Tzu-Han,6,0,63,57
1657902544985,COGS 17,A01,092677,Semenuks; Arturs,6,0,81,75
1657902551009,COGS 100,A01,083619,Allen; Michael Gordon,17,0,70,53
1657902557034,COGS 101A,A01,083621,Davis; Joshua Daniel,9,0,68,59
1657902563058,COGS 101B,A01,091572,Allen; Michael Gordon,13,0,65,52
1657902569095,COGS 101C,A01,083625,Delgado; Tania,17,0,35,18
1657902575121,COGS 107A,A01,083627,Boyle; Mary E. T.,14,0,60,46
1657902581144,COGS 118A,A01,083075,Gupta; Anjum,21,0,76,55
1657902587180,CSE 3,A50,083646,Miranda; Gregory Joseph,24,0,50,26
1657902593205,CSE 8A,A50,083650,Miranda; Gregory Joseph,17,1,56,39
1657902599230,CSE 11,A01,083080,Cao; Yingjun,6,15,40,34
1657902605253,CSE 12,A01,083652,Krause-Levy; Sophia Louisa,30,1,120,90
1657902611277,CSE 15L,A01,083654,Morris; Justin Loren,9,0,50,41
1657902611277,CSE 15L,A02,083655,Morris; Justin Loren,10,0,50,40
1657902617298,CSE 20,A01,083657,Tran; Khoa Dang,39,0,80,41
1657902623320,CSE 21,A01,095574,Bach; Quang Tran,22,0,48,26
1657902629347,CSE 30,A01,083084,Eldon; John,6,0,80,74
1657902629347,CSE 30,B01,095061,Bhaskar; Nishant,9,0,50,41
1657902635372,CSE 100,A01,083659,Cao; Yingjun,5,4,70,65
1657902641395,CSE 134B,A01,083661,Powell; Thomas Allan,25,0,100,75
1657902647417,CSE 140,A01,083663,Gungor; Onat,15,0,85,70
1657902653449,CSE 140L,A01,083088,Eldon; John,23,0,100,77
1657902659472,CSE 175,A01,083665,Kumar; Rakesh,3,0,25,22
1657902665496,CSE 190,A00,092507,Dubnov; Shlomo,8,0,20,12
1657902671523,ECE 45,A01,083139,Congero; Spencer William,6,0,75,69
1657902677547,ECE 65,A50,083695,Saad; Andrew S,12,0,30,18
1657902677547,ECE 65,A51,095125,Saad; Andrew S,24,0,26,2
1657902683570,ECE 109,A01,091882,Touri; Behrouz,20,0,70,50
1657902689596,ECE 180,A00,083140,Abi Samra; Nicholas Camill,1,0,30,29
1657902689596,ECE 180,B00,083141,Abi Samra; Nicholas Camill,0,0,30,30
1657902695620,MATH 10A,A01,083735,Patchell; Gregory David,2,0,30,28
1657902695620,MATH 10A,A02,083736,Patchell; Gregory David,20,0,30,10
1657902695620,MATH 10A,A03,083737,Patchell; Gregory David,16,0,30,14
1657902701644,MATH 10B,A01,083207,Lim; Seonhee,8,0,34,26
1657902701644,MATH 10B,A02,083208,Lim; Seonhee,10,0,35,25
1657902701644,MATH 10B,A03,093472,Lim; Seonhee,7,0,34,27
1657902701644,MATH 10B,B01,083739,Sinha; Shubham,14,0,30,16
1657902707670,MATH 18,A01,083743,Cinel; Cameron Alexander,9,0,30,21
1657902707670,MATH 18,A02,083744,Cinel; Cameron Alexander,18,0,30,12
1657902707670,MATH 18,A03,083745,Cinel; Cameron Alexander,10,0,30,20
1657902707670,MATH 18,B01,083748,Rideout; David Porter,5,0,37,32
1657902707670,MATH 18,B02,083749,Rideout; David Porter,5,0,36,31
1657902707670,MATH 18,B03,083750,Rideout; David Porter,3,0,37,34
1657902707670,MATH 18,B04,083751,Rideout; David Porter,6,0,36,30
1657902707670,MATH 18,B05,093473,Rideout; David Porter,6,0,36,30
1657902707670,MATH 18,B06,093474,Rideout; David Porter,6,0,36,30
1657902713692,MATH 20A,A01,083754,Zheng; Zequn,14,0,40,26
1657902719718,MATH 20B,A01,083756,Briones; Jor-el Thomas Caparas,4,0,36,32
1657902719718,MATH 20B,A02,083757,Briones; Jor-el Thomas Caparas,1,0,36,35
1657902719718,MATH 20B,A03,093475,Briones; Jor-el Thomas Caparas,2,0,36,34
1657902725741,MATH 20C,A01,083760,Briones; Jor-el Thomas Caparas,1,0,35,34
1657902725741,MATH 20C,A02,083761,Briones; Jor-el Thomas Caparas,8,0,35,27
1657902725741,MATH 20C,A03,093476,Briones; Jor-el Thomas Caparas,0,1,36,36
1657902725741,MATH 20C,B01,083762,Bach; Quang Tran,1,0,30,29
1657902731768,MATH 20D,A01,083765,Tran; Brian Kha,5,0,30,25
1657902731768,MATH 20D,A02,083766,Tran; Brian Kha,5,0,30,25
1657902731768,MATH 20D,A03,083767,Tran; Brian Kha,5,0,30,25
1657902737792,MATH 20E,A01,083771,Ganguly; Soumya,10,0,32,22
1657902737792,MATH 20E,A02,083772,Ganguly; Soumya,6,0,32,26
1657902737792,MATH 20E,B01,083773,Ciotti; Benjamin,20,0,35,15
1657902737792,MATH 20E,B02,083774,Ciotti; Benjamin,18,0,35,17
1657902743821,MATH 103A,A01,083777,Greenfeld; Be'Eri,3,0,36,33
1657902743821,MATH 103A,A02,083778,Greenfeld; Be'Eri,5,0,36,31
1657902743821,MATH 103A,A03,093561,Greenfeld; Be'Eri,6,0,36,30
1657902743821,MATH 103A,B01,083779,Greenfeld; Be'Eri,7,0,36,29
1657902743821,MATH 103A,B02,083780,Greenfeld; Be'Eri,4,0,36,32
1657902743821,MATH 103A,B03,093562,Greenfeld; Be'Eri,3,0,36,33
1657902749846,MATH 105,A01,085443,Carter; Anne Toulson,15,0,35,20
1657902749846,MATH 105,A02,093477,Carter; Anne Toulson,20,0,35,15
1657902755874,MATH 109,A01,083213,Ganzberger; Geoffrey Michael,3,0,34,31
1657902755874,MATH 109,A02,083214,Ganzberger; Geoffrey Michael,4,0,34,30
1657902755874,MATH 109,A03,093478,Ganzberger; Geoffrey Michael,2,0,34,32
1657902755874,MATH 109,B01,083215,Ganzberger; Geoffrey Michael,2,0,32,30
1657902755874,MATH 109,B02,083216,Ganzberger; Geoffrey Michael,2,0,32,30
1657902755874,MATH 109,B03,093479,Ganzberger; Geoffrey Michael,8,0,32,24
1657902761904,MATH 142A,A01,083219,Chow; Bennett,7,0,32,25
1657902761904,MATH 142A,A02,083220,Chow; Bennett,10,0,32,22
1657902761904,MATH 142A,A03,093480,Chow; Bennett,9,0,32,23
1657902761904,MATH 142A,B03,093481,Chow; Bennett,8,0,32,24
1657902761904,MATH 142A,B04,093558,Chow; Bennett,13,0,32,19
1657902761904,MATH 142A,B05,093559,Chow; Bennett,7,0,32,25
1657902767933,MATH 193A,A01,083224,Rotar; Vladimir,8,0,34,26
1657902767933,MATH 193A,A02,083225,Rotar; Vladimir,10,0,34,24
1657902767933,MATH 193A,A03,083781,Rotar; Vladimir,5,0,34,29
1657902767933,MATH 193A,A04,083782,Rotar; Vladimir,11,0,34,23
1657902767933,MATH 193A,A05,093482,Rotar; Vladimir,10,0,34,24
1657902773961,MATH 197,001,091859,McAuley; Julian John,9999,0,9999,0
1657902773961,MATH 197,002,095566,Kedlaya; Kiran S.,9997,0,9999,2
1657902773961,MATH 197,003,095567,Xiao; Ming,9999,0,9999,0
1657902773961,MATH 197,004,095571,Perols; Johan Lars,9998,0,9999,1
1657902781036,COGS 9,A01,083615,Shannon; Kyle Michael,10,0,75,65
1657902787071,COGS 11,A01,083617,Boyle; Mary E. T.,23,0,48,25
1657902793107,COGS 13,A01,083071,Bastos; Amalia Pinkusfeld,11,0,71,60
1657902799133,COGS 14A,A01,092681,Semenuks; Arturs,5,1,100,95
1657902805156,COGS 14B,A01,083073,Cheng; Tzu-Han,6,0,63,57
1657902811183,COGS 17,A01,092677,Semenuks; Arturs,6,0,81,75
1657902817209,COGS 100,A01,083619,Allen; Michael Gordon,17,0,70,53
1657902823231,COGS 101A,A01,083621,Davis; Joshua Daniel,9,0,68,59
1657902829253,COGS 101B,A01,091572,Allen; Michael Gordon,13,0,65,52
1657902835281,COGS 101C,A01,083625,Delgado; Tania,17,0,35,18
1657902841308,COGS 107A,A01,083627,Boyle; Mary E. T.,14,0,60,46
1657902847338,COGS 118A,A01,083075,Gupta; Anjum,21,0,76,55
1657902853363,CSE 3,A50,083646,Miranda; Gregory Joseph,24,0,50,26
1657902859386,CSE 8A,A50,083650,Miranda; Gregory Joseph,17,1,56,39
1657902865412,CSE 11,A01,083080,Cao; Yingjun,6,15,40,34
1657902871440,CSE 12,A01,083652,Krause-Levy; Sophia Louisa,30,1,120,90
1657902877464,CSE 15L,A01,083654,Morris; Justin Loren,9,0,50,41
1657902877464,CSE 15L,A02,083655,Morris; Justin Loren,10,0,50,40
1657902883495,CSE 20,A01,083657,Tran; Khoa Dang,39,0,80,41
1657902889516,CSE 21,A01,095574,Bach; Quang Tran,22,0,48,26
1657902895540,CSE 30,A01,083084,Eldon; John,6,0,80,74
1657902895540,CSE 30,B01,095061,Bhaskar; Nishant,9,0,50,41
1657902901566,CSE 100,A01,083659,Cao; Yingjun,5,4,70,65
1657902907592,CSE 134B,A01,083661,Powell; Thomas Allan,25,0,100,75
1657902913709,CSE 140,A01,083663,Gungor; Onat,15,0,85,70
1657902919731,CSE 140L,A01,083088,Eldon; John,23,0,100,77
1657902925768,CSE 175,A01,083665,Kumar; Rakesh,3,0,25,22
1657902931794,CSE 190,A00,092507,Dubnov; Shlomo,8,0,20,12
1657902937816,ECE 45,A01,083139,Congero; Spencer William,6,0,75,69
1657902943840,ECE 65,A50,083695,Saad; Andrew S,12,0,30,18
1657902943840,ECE 65,A51,095125,Saad; Andrew S,24,0,26,2
1657902949876,ECE 109,A01,091882,Touri; Behrouz,20,0,70,50
1657902955903,ECE 180,A00,083140,Abi Samra; Nicholas Camill,1,0,30,29
1657902955903,ECE 180,B00,083141,Abi Samra; Nicholas Camill,0,0,30,30
1657902961938,MATH 10A,A01,083735,Patchell; Gregory David,2,0,30,28
1657902961938,MATH 10A,A02,083736,Patchell; Gregory David,20,0,30,10
1657902961938,MATH 10A,A03,083737,Patchell; Gregory David,16,0,30,14
1657902967963,MATH 10B,A01,083207,Lim; Seonhee,8,0,34,26
1657902967963,MATH 10B,A02,083208,Lim; Seonhee,10,0,35,25
1657902967963,MATH 10B,A03,093472,Lim; Seonhee,7,0,34,27
1657902967963,MATH 10B,B01,083739,Sinha; Shubham,14,0,30,16
1657902973989,MATH 18,A01,083743,Cinel; Cameron Alexander,9,0,30,21
1657902973989,MATH 18,A02,083744,Cinel; Cameron Alexander,18,0,30,12
1657902973989,MATH 18,A03,083745,Cinel; Cameron Alexander,10,0,30,20
1657902973989,MATH 18,B01,083748,Rideout; David Porter,5,0,37,32
1657902973989,MATH 18,B02,083749,Rideout; David Porter,5,0,36,31
1657902973989,MATH 18,B03,083750,Rideout; David Porter,3,0,37,34
1657902973989,MATH 18,B04,083751,Rideout; David Porter,6,0,36,30
1657902973989,MATH 18,B05,093473,Rideout; David Porter,6,0,36,30
1657902973989,MATH 18,B06,093474,Rideout; David Porter,6,0,36,30
1657902980011,MATH 20A,A01,083754,Zheng; Zequn,14,0,40,26
1657902986038,MATH 20B,A01,083756,Briones; Jor-el Thomas Caparas,4,0,36,32
1657902986038,MATH 20B,A02,083757,Briones; Jor-el Thomas Caparas,1,0,36,35
1657902986038,MATH 20B,A03,093475,Briones; Jor-el Thomas Caparas,2,0,36,34
1657902992061,MATH 20C,A01,083760,Briones; Jor-el Thomas Caparas,1,0,35,34
1657902992061,MATH 20C,A02,083761,Briones; Jor-el Thomas Caparas,8,0,35,27
1657902992061,MATH 20C,A03,093476,Briones; Jor-el Thomas Caparas,0,1,36,36
1657902992061,MATH 20C,B01,083762,Bach; Quang Tran,1,0,30,29
1657902998090,MATH 20D,A01,083765,Tran; Brian Kha,5,0,30,25
1657902998090,MATH 20D,A02,083766,Tran; Brian Kha,5,0,30,25
1657902998090,MATH 20D,A03,083767,Tran; Brian Kha,5,0,30,25
1657903004112,MATH 20E,A01,083771,Ganguly; Soumya,10,0,32,22
1657903004112,MATH 20E,A02,083772,Ganguly; Soumya,6,0,32,26
1657903004112,MATH 20E,B01,083773,Ciotti; Benjamin,20,0,35,15
1657903004112,MATH 20E,B02,083774,Ciotti; Benjamin,18,0,35,17
1657903010135,MATH 103A,A01,083777,Greenfeld; Be'Eri,3,0,36,33
1657903010135,MATH 103A,A02,083778,Greenfeld; Be'Eri,5,0,36,31
1657903010135,MATH 103A,A03,093561,Greenfeld; Be'Eri,6,0,36,30
1657903010135,MATH 103A,B01,083779,Greenfeld; Be'Eri,7,0,36,29
1657903010135,MATH 103A,B02,083780,Greenfeld; Be'Eri,4,0,36,32
1657903010135,MATH 103A,B03,093562,Greenfeld; Be'Eri,3,0,36,33
1657903016158,MATH 105,A01,085443,Carter; Anne Toulson,15,0,35,20
1657903016158,MATH 105,A02,093477,Carter; Anne Toulson,20,0,35,15
1657903022182,MATH 109,A01,083213,Ganzberger; Geoffrey Michael,3,0,34,31
1657903022182,MATH 109,A02,083214,Ganzberger; Geoffrey Michael,4,0,34,30
1657903022182,MATH 109,A03,093478,Ganzberger; Geoffrey Michael,2,0,34,32
1657903022182,MATH 109,B01,083215,Ganzberger; Geoffrey Michael,2,0,32,30
1657903022182,MATH 109,B02,083216,Ganzberger; Geoffrey Michael,2,0,32,30
1657903022182,MATH 109,B03,093479,Ganzberger; Geoffrey Michael,8,0,32,24
1657903028218,MATH 142A,A01,083219,Chow; Bennett,7,0,32,25
1657903028218,MATH 142A,A02,083220,Chow; Bennett,10,0,32,22
1657903028218,MATH 142A,A03,093480,Chow; Bennett,9,0,32,23
1657903028218,MATH 142A,B03,093481,Chow; Bennett,8,0,32,24
1657903028218,MATH 142A,B04,093558,Chow; Bennett,13,0,32,19
1657903028218,MATH 142A,B05,093559,Chow; Bennett,7,0,32,25
1657903034248,MATH 193A,A01,083224,Rotar; Vladimir,8,0,34,26
1657903034248,MATH 193A,A02,083225,Rotar; Vladimir,10,0,34,24
1657903034248,MATH 193A,A03,083781,Rotar; Vladimir,5,0,34,29
1657903034248,MATH 193A,A04,083782,Rotar; Vladimir,11,0,34,23
1657903034248,MATH 193A,A05,093482,Rotar; Vladimir,10,0,34,24
1657903040274,MATH 197,001,091859,McAuley; Julian John,9999,0,9999,0
1657903040274,MATH 197,002,095566,Kedlaya; Kiran S.,9997,0,9999,2
1657903040274,MATH 197,003,095567,Xiao; Ming,9999,0,9999,0
1657903040274,MATH 197,004,095571,Perols; Johan Lars,9998,0,9999,1
1657903047331,COGS 9,A01,083615,Shannon; Kyle Michael,10,0,75,65
1657903053353,COGS 11,A01,083617,Boyle; Mary E. T.,23,0,48,25
1657903059382,COGS 13,A01,083071,Bastos; Amalia Pinkusfeld,11,0,71,60
1657903065422,COGS 14A,A01,092681,Semenuks; Arturs,5,1,100,95
1657903071446,COGS 14B,A01,083073,Cheng; Tzu-Han,6,0,63,57
1657903077472,COGS 17,A01,092677,Semenuks; Arturs,6,0,81,75
1657903083499,COGS 100,A01,083619,Allen; Michael Gordon,17,0,70,53
1657903089525,COGS 101A,A01,083621,Davis; Joshua Daniel,9,0,68,59
1657903095557,COGS 101B,A01,091572,Allen; Michael Gordon,13,0,65,52
1657903101580,COGS 101C,A01,083625,Delgado; Tania,17,0,35,18
1657903107605,COGS 107A,A01,083627,Boyle; Mary E. T.,14,0,60,46
1657903113633,COGS 118A,A01,083075,Gupta; Anjum,21,0,76,55
1657903119657,CSE 3,A50,083646,Miranda; Gregory Joseph,24,0,50,26
1657903125685,CSE 8A,A50,083650,Miranda; Gregory Joseph,17,1,56,39
1657903131707,CSE 11,A01,083080,Cao; Yingjun,6,15,40,34
1657903137730,CSE 12,A01,083652,Krause-Levy; Sophia Louisa,30,1,120,90
1657903143755,CSE 15L,A01,083654,Morris; Justin Loren,9,0,50,41
1657903143755,CSE 15L,A02,083655,Morris; Justin Loren,10,0,50,40
1657903149780,CSE 20,A01,083657,Tran; Khoa Dang,39,0,80,41
1657903155802,CSE 21,A01,095574,Bach; Quang Tran,22,0,48,26
1657903161825,CSE 30,A01,083084,Eldon; John,6,0,80,74
1657903161825,CSE 30,B01,095061,Bhaskar; Nishant,9,0,50,41
1657903167848,CSE 100,A01,083659,Cao; Yingjun,5,4,70,65
1657903173870,CSE 134B,A01,083661,Powell; Thomas Allan,25,0,100,75
1657903179892,CSE 140,A01,083663,Gungor; Onat,15,0,85,70
1657903185917,CSE 140L,A01,083088,Eldon; John,23,0,100,77
1657903191942,CSE 175,A01,083665,Kumar; Rakesh,3,0,25,22
1657903197972,CSE 190,A00,092507,Dubnov; Shlomo,8,0,20,12
1657903203994,ECE 45,A01,083139,Congero; Spencer William,6,0,75,69
1657903210017,ECE 65,A50,083695,Saad; Andrew S,12,0,30,18
1657903210017,ECE 65,A51,095125,Saad; Andrew S,24,0,26,2
1657903216039,ECE 109,A01,091882,Touri; Behrouz,20,0,70,50
1657903222061,ECE 180,A00,083140,Abi Samra; Nicholas Camill,1,0,30,29
1657903222061,ECE 180,B00,083141,Abi Samra; Nicholas Camill,0,0,30,30
1657903228095,MATH 10A,A01,083735,Patchell; Gregory David,2,0,30,28
1657903228095,MATH 10A,A02,083736,Patchell; Gregory David,20,0,30,10
1657903228095,MATH 10A,A03,083737,Patchell; Gregory David,16,0,30,14
1657903234117,MATH 10B,A01,083207,Lim; Seonhee,8,0,34,26
1657903234117,MATH 10B,A02,083208,Lim; Seonhee,10,0,35,25
1657903234117,MATH 10B,A03,093472,Lim; Seonhee,7,0,34,27
1657903234117,MATH 10B,B01,083739,Sinha; Shubham,14,0,30,16
1657903240147,MATH 18,A01,083743,Cinel; Cameron Alexander,9,0,30,21
1657903240147,MATH 18,A02,083744,Cinel; Cameron Alexander,18,0,30,12
1657903240147,MATH 18,A03,083745,Cinel; Cameron Alexander,10,0,30,20
1657903240147,MATH 18,B01,083748,Rideout; David Porter,5,0,37,32
1657903240147,MATH 18,B02,083749,Rideout; David Porter,5,0,36,31
1657903240147,MATH 18,B03,083750,Rideout; David Porter,3,0,37,34
1657903240147,MATH 18,B04,083751,Rideout; David Porter,6,0,36,30
1657903240147,MATH 18,B05,093473,Rideout; David Porter,6,0,36,30
1657903240147,MATH 18,B06,093474,Rideout; David Porter,6,0,36,30
1657903246168,MATH 20A,A01,083754,Zheng; Zequn,14,0,40,26
1657903252191,MATH 20B,A01,083756,Briones; Jor-el Thomas Caparas,4,0,36,32
1657903252191,MATH 20B,A02,083757,Briones; Jor-el Thomas Caparas,1,0,36,35
1657903252191,MATH 20B,A03,093475,Briones; Jor-el Thomas Caparas,2,0,36,34
1657903258216,MATH 20C,A01,083760,Briones; Jor-el Thomas Caparas,1,0,35,34
1657903258216,MATH 20C,A02,083761,Briones; Jor-el Thomas Caparas,8,0,35,27
1657903258216,MATH 20C,A03,093476,Briones; Jor-el Thomas Caparas,0,1,36,36
1657903258216,MATH 20C,B01,083762,Bach; Quang Tran,1,0,30,29
1657903264246,MATH 20D,A01,083765,Tran; Brian Kha,5,0,30,25
1657903264246,MATH 20D,A02,083766,Tran; Brian Kha,5,0,30,25
1657903264246,MATH 20D,A03,083767,Tran; Brian Kha,5,0,30,25
1657903270268,MATH 20E,A01,083771,Ganguly; Soumya,10,0,32,22
1657903270268,MATH 20E,A02,083772,Ganguly; Soumya,6,0,32,26
1657903270268,MATH 20E,B01,083773,Ciotti; Benjamin,20,0,35,15
1657903270268,MATH 20E,B02,083774,Ciotti; Benjamin,18,0,35,17
1657903276291,MATH 103A,A01,083777,Greenfeld; Be'Eri,3,0,36,33
1657903276291,MATH 103A,A02,083778,Greenfeld; Be'Eri,5,0,36,31
1657903276291,MATH 103A,A03,093561,Greenfeld; Be'Eri,6,0,36,30
1657903276291,MATH 103A,B01,083779,Greenfeld; Be'Eri,7,0,36,29
1657903276291,MATH 103A,B02,083780,Greenfeld; Be'Eri,4,0,36,32
1657903276291,MATH 103A,B03,093562,Greenfeld; Be'Eri,3,0,36,33
1657903282317,MATH 105,A01,085443,Carter; Anne Toulson,15,0,35,20
1657903282317,MATH 105,A02,093477,Carter; Anne Toulson,20,0,35,15
1657903288345,MATH 109,A01,083213,Ganzberger; Geoffrey Michael,3,0,34,31
1657903288345,MATH 109,A02,083214,Ganzberger; Geoffrey Michael,4,0,34,30
1657903288345,MATH 109,A03,093478,Ganzberger; Geoffrey Michael,2,0,34,32
1657903288345,MATH 109,B01,083215,Ganzberger; Geoffrey Michael,2,0,32,30
1657903288345,MATH 109,B02,083216,Ganzberger; Geoffrey Michael,2,0,32,30
1657903288345,MATH 109,B03,093479,Ganzberger; Geoffrey Michael,8,0,32,24
1657903294368,MATH 142A,A01,083219,Chow; Bennett,7,0,32,25
1657903294368,MATH 142A,A02,083220,Chow; Bennett,10,0,32,22
1657903294368,MATH 142A,A03,093480,Chow; Bennett,9,0,32,23
1657903294368,MATH 142A,B03,093481,Chow; Bennett,8,0,32,24
1657903294368,MATH 142A,B04,093558,Chow; Bennett,13,0,32,19
1657903294368,MATH 142A,B05,093559,Chow; Bennett,7,0,32,25
1657903300396,MATH 193A,A01,083224,Rotar; Vladimir,8,0,34,26
1657903300396,MATH 193A,A02,083225,Rotar; Vladimir,10,0,34,24
1657903300396,MATH 193A,A03,083781,Rotar; Vladimir,5,0,34,29
1657903300396,MATH 193A,A04,083782,Rotar; Vladimir,11,0,34,23
1657903300396,MATH 193A,A05,093482,Rotar; Vladimir,10,0,34,24
1657903306426,MATH 197,001,091859,McAuley; Julian John,9999,0,9999,0
1657903306426,MATH 197,002,095566,Kedlaya; Kiran S.,9997,0,9999,2
1657903306426,MATH 197,003,095567,Xiao; Ming,9999,0,9999,0
1657903306426,MATH 197,004,095571,Perols; Johan Lars,9998,0,9999,1
1657903313499,COGS 9,A01,083615,Shannon; Kyle Michael,10,0,75,65
1657903319527,COGS 11,A01,083617,Boyle; Mary E. T.,23,0,48,25
1657903325550,COGS 13,A01,083071,Bastos; Amalia Pinkusfeld,11,0,71,60
1657903331572,COGS 14A,A01,092681,Semenuks; Arturs,5,1,100,95
1657903337600,COGS 14B,A01,083073,Cheng; Tzu-Han,6,0,63,57
1657903343624,COGS 17,A01,092677,Semenuks; Arturs,6,0,81,75
1657903349647,COGS 100,A01,083619,Allen; Michael Gordon,17,0,70,53
1657903355675,COGS 101A,A01,083621,Davis; Joshua Daniel,9,0,68,59
1657903361699,COGS 101B,A01,091572,Allen; Michael Gordon,13,0,65,52
1657903367735,COGS 101C,A01,083625,Delgado; Tania,17,0,35,18
1657903373762,COGS 107A,A01,083627,Boyle; Mary E. T.,14,0,60,46
1657903379793,COGS 118A,A01,083075,Gupta; Anjum,21,0,76,55
1657903385824,CSE 3,A50,083646,Miranda; Gregory Joseph,24,0,50,26
1657903391852,CSE 8A,A50,083650,Miranda; Gregory Joseph,17,1,56,39
1657903397891,CSE 11,A01,083080,Cao; Yingjun,6,15,40,34
1657903403927,CSE 12,A01,083652,Krause-Levy; Sophia Louisa,30,1,120,90
1657903409955,CSE 15L,A01,083654,Morris; Justin Loren,9,0,50,41
1657903409955,CSE 15L,A02,083655,Morris; Justin Loren,10,0,50,40
1657903415985,CSE 20,A01,083657,Tran; Khoa Dang,39,0,80,41
1657903422012,CSE 21,A01,095574,Bach; Quang Tran,22,0,48,26
1657903428045,CSE 30,A01,083084,Eldon; John,6,0,80,74
1657903428045,CSE 30,B01,095061,Bhaskar; Nishant,9,0,50,41
1657903434078,CSE 100,A01,083659,Cao; Yingjun,5,4,70,65
1657903440103,CSE 134B,A01,083661,Powell; Thomas Allan,25,0,100,75
1657903446128,CSE 140,A01,083663,Gungor; Onat,15,0,85,70
1657903452150,CSE 140L,A01,083088,Eldon; John,23,0,100,77
1657903458184,CSE 175,A01,083665,Kumar; Rakesh,3,0,25,22
1657903464206,CSE 190,A00,092507,Dubnov; Shlomo,8,0,20,12
1657903470228,ECE 45,A01,083139,Congero; Spencer William,6,0,75,69
1657903476250,ECE 65,A50,083695,Saad; Andrew S,12,0,30,18
1657903476250,ECE 65,A51,095125,Saad; Andrew S,24,0,26,2
1657903482276,ECE 109,A01,091882,Touri; Behrouz,20,0,70,50
1657903488298,ECE 180,A00,083140,Abi Samra; Nicholas Camill,1,0,30,29
1657903488298,ECE 180,B00,083141,Abi Samra; Nicholas Camill,0,0,30,30
1657903494320,MATH 10A,A01,083735,Patchell; Gregory David,2,0,30,28
1657903494320,MATH 10A,A02,083736,Patchell; Gregory David,20,0,30,10
1657903494320,MATH 10A,A03,083737,Patchell; Gregory David,16,0,30,14
1657903500354,MATH 10B,A01,083207,Lim; Seonhee,8,0,34,26
1657903500354,MATH 10B,A02,083208,Lim; Seonhee,10,0,35,25
1657903500354,MATH 10B,A03,093472,Lim; Seonhee,7,0,34,27
1657903500354,MATH 10B,B01,083739,Sinha; Shubham,14,0,30,16
1657903506378,MATH 18,A01,083743,Cinel; Cameron Alexander,9,0,30,21
1657903506378,MATH 18,A02,083744,Cinel; Cameron Alexander,18,0,30,12
1657903506378,MATH 18,A03,083745,Cinel; Cameron Alexander,10,0,30,20
1657903506378,MATH 18,B01,083748,Rideout; David Porter,5,0,37,32
1657903506378,MATH 18,B02,083749,Rideout; David Porter,5,0,36,31
1657903506378,MATH 18,B03,083750,Rideout; David Porter,3,0,37,34
1657903506378,MATH 18,B04,083751,Rideout; David Porter,6,0,36,30
1657903506378,MATH 18,B05,093473,Rideout; David Porter,6,0,36,30
1657903506378,MATH 18,B06,093474,Rideout; David Porter,6,0,36,30
1657903512493,MATH 20A,A01,083754,Zheng; Zequn,14,0,40,26
1657903518522,MATH 20B,A01,083756,Briones; Jor-el Thomas Caparas,4,0,36,32
1657903518522,MATH 20B,A02,083757,Briones; Jor-el Thomas Caparas,1,0,36,35
1657903518522,MATH 20B,A03,093475,Briones; Jor-el Thomas Caparas,2,0,36,34
1657903524557,MATH 20C,A01,083760,Briones; Jor-el Thomas Caparas,1,0,35,34
1657903524557,MATH 20C,A02,083761,Briones; Jor-el Thomas Caparas,8,0,35,27
1657903524557,MATH 20C,A03,093476,Briones; Jor-el Thomas Caparas,0,1,36,36
1657903524557,MATH 20C,B01,083762,Bach; Quang Tran,1,0,30,29
1657903530596,MATH 20D,A01,083765,Tran; Brian Kha,5,0,30,25
1657903530596,MATH 20D,A02,083766,Tran; Brian Kha,5,0,30,25
1657903530596,MATH 20D,A03,083767,Tran; Brian Kha,5,0,30,25
1657903536621,MATH 20E,A01,083771,Ganguly; Soumya,10,0,32,22
1657903536621,MATH 20E,A02,083772,Ganguly; Soumya,6,0,32,26
1657903536621,MATH 20E,B01,083773,Ciotti; Benjamin,20,0,35,15
1657903536621,MATH 20E,B02,083774,Ciotti; Benjamin,18,0,35,17
1657903542650,MATH 103A,A01,083777,Greenfeld; Be'Eri,3,0,36,33
1657903542650,MATH 103A,A02,083778,Greenfeld; Be'Eri,5,0,36,31
1657903542650,MATH 103A,A03,093561,Greenfeld; Be'Eri,6,0,36,30
1657903542650,MATH 103A,B01,083779,Greenfeld; Be'Eri,7,0,36,29
1657903542650,MATH 103A,B02,083780,Greenfeld; Be'Eri,4,0,36,32
1657903542650,MATH 103A,B03,093562,Greenfeld; Be'Eri,3,0,36,33
1657903548676,MATH 105,A01,085443,Carter; Anne Toulson,15,0,35,20
1657903548676,MATH 105,A02,093477,Carter; Anne Toulson,20,0,35,15
1657903554699,MATH 109,A01,083213,Ganzberger; Geoffrey Michael,3,0,34,31
1657903554699,MATH 109,A02,083214,Ganzberger; Geoffrey Michael,4,0,34,30
1657903554699,MATH 109,A03,093478,Ganzberger; Geoffrey Michael,2,0,34,32
1657903554699,MATH 109,B01,083215,Ganzberger; Geoffrey Michael,2,0,32,30
1657903554699,MATH 109,B02,083216,Ganzberger; Geoffrey Michael,2,0,32,30
1657903554699,MATH 109,B03,093479,Ganzberger; Geoffrey Michael,8,0,32,24
1657903560722,MATH 142A,A01,083219,Chow; Bennett,7,0,32,25
1657903560722,MATH 142A,A02,083220,Chow; Bennett,10,0,32,22
1657903560722,MATH 142A,A03,093480,Chow; Bennett,9,0,32,23
1657903560722,MATH 142A,B03,093481,Chow; Bennett,8,0,32,24
1657903560722,MATH 142A,B04,093558,Chow; Bennett,13,0,32,19
1657903560722,MATH 142A,B05,093559,Chow; Bennett,7,0,32,25
1657903566748,MATH 193A,A01,083224,Rotar; Vladimir,8,0,34,26
1657903566748,MATH 193A,A02,083225,Rotar; Vladimir,10,0,34,24
1657903566748,MATH 193A,A03,083781,Rotar; Vladimir,5,0,34,29
1657903566748,MATH 193A,A04,083782,Rotar; Vladimir,11,0,34,23
1657903566748,MATH 193A,A05,093482,Rotar; Vladimir,10,0,34,24
1657903572772,MATH 197,001,091859,McAuley; Julian John,9999,0,9999,0
1657903572772,MATH 197,002,095566,Kedlaya; Kiran S.,9997,0,9999,2
1657903572772,MATH 197,003,095567,Xiao; Ming,9999,0,9999,0
1657903572772,MATH 197,004,095571,Perols; Johan Lars,9998,0,9999,1
1657903579836,COGS 9,A01,083615,Shannon; Kyle Michael,10,0,75,65
1657903585863,COGS 11,A01,083617,Boyle; Mary E. T.,23,0,48,25
1657903591902,COGS 13,A01,083071,Bastos; Amalia Pinkusfeld,11,0,71,60
1657903597928,COGS 14A,A01,092681,Semenuks; Arturs,5,1,100,95
1657903603950,COGS 14B,A01,083073,Cheng; Tzu-Han,6,0,63,57
1657903609978,COGS 17,A01,092677,Semenuks; Arturs,6,0,81,75
1657903616006,COGS 100,A01,083619,Allen; Michael Gordon,17,0,70,53
1657903622034,COGS 101A,A01,083621,Davis; Joshua Daniel,9,0,68,59
1657903628057,COGS 101B,A01,091572,Allen; Michael Gordon,13,0,65,52
1657903634094,COGS 101C,A01,083625,Delgado; Tania,17,0,35,18
1657903640116,COGS 107A,A01,083627,Boyle; Mary E. T.,14,0,60,46
1657903646143,COGS 118A,A01,083075,Gupta; Anjum,21,0,76,55
1657903652171,CSE 3,A50,083646,Miranda; Gregory Joseph,24,0,50,26
1657903658198,CSE 8A,A50,083650,Miranda; Gregory Joseph,17,1,56,39
1657903664222,CSE 11,A01,083080,Cao; Yingjun,6,15,40,34
1657903670251,CSE 12,A01,083652,Krause-Levy; Sophia Louisa,30,1,120,90
1657903676277,CSE 15L,A01,083654,Morris; Justin Loren,9,0,50,41
1657903676277,CSE 15L,A02,083655,Morris; Justin Loren,10,0,50,40
1657903682303,CSE 20,A01,083657,Tran; Khoa Dang,39,0,80,41
1657903688327,CSE 21,A01,095574,Bach; Quang Tran,22,0,48,26
1657903694355,CSE 30,A01,083084,Eldon; John,6,0,80,74
1657903694355,CSE 30,B01,095061,Bhaskar; Nishant,9,0,50,41
1657903700381,CSE 100,A01,083659,Cao; Yingjun,5,4,70,65
1657903706407,CSE 134B,A01,083661,Powell; Thomas Allan,25,0,100,75
1657903712437,CSE 140,A01,083663,Gungor; Onat,15,0,85,70
1657903718468,CSE 140L,A01,083088,Eldon; John,23,0,100,77
1657903724501,CSE 175,A01,083665,Kumar; Rakesh,3,0,25,22
1657903730528,CSE 190,A00,092507,Dubnov; Shlomo,8,0,20,12
1657903736553,ECE 45,A01,083139,Congero; Spencer William,6,0,75,69
1657903742577,ECE 65,A50,083695,Saad; Andrew S,12,0,30,18
1657903742577,ECE 65,A51,095125,Saad; Andrew S,24,0,26,2
1657903748599,ECE 109,A01,091882,Touri; Behrouz,20,0,70,50
1657903754622,ECE 180,A00,083140,Abi Samra; Nicholas Camill,1,0,30,29
1657903754622,ECE 180,B00,083141,Abi Samra; Nicholas Camill,0,0,30,30
1657903760645,MATH 10A,A01,083735,Patchell; Gregory David,2,0,30,28
1657903760645,MATH 10A,A02,083736,Patchell; Gregory David,20,0,30,10
1657903760645,MATH 10A,A03,083737,Patchell; Gregory David,16,0,30,14
1657903766669,MATH 10B,A01,083207,Lim; Seonhee,8,0,34,26
1657903766669,MATH 10B,A02,083208,Lim; Seonhee,10,0,35,25
1657903766669,MATH 10B,A03,093472,Lim; Seonhee,7,0,34,27
1657903766669,MATH 10B,B01,083739,Sinha; Shubham,14,0,30,16
1657903772700,MATH 18,A01,083743,Cinel; Cameron Alexander,9,0,30,21
1657903772700,MATH 18,A02,083744,Cinel; Cameron Alexander,18,0,30,12
1657903772700,MATH 18,A03,083745,Cinel; Cameron Alexander,10,0,30,20
1657903772700,MATH 18,B01,083748,Rideout; David Porter,5,0,37,32
1657903772700,MATH 18,B02,083749,Rideout; David Porter,5,0,36,31
1657903772700,MATH 18,B03,083750,Rideout; David Porter,3,0,37,34
1657903772700,MATH 18,B04,083751,Rideout; David Porter,6,0,36,30
1657903772700,MATH 18,B05,093473,Rideout; David Porter,6,0,36,30
1657903772700,MATH 18,B06,093474,Rideout; David Porter,6,0,36,30
1657903778728,MATH 20A,A01,083754,Zheng; Zequn,14,0,40,26
1657903784753,MATH 20B,A01,083756,Briones; Jor-el Thomas Caparas,4,0,36,32
1657903784753,MATH 20B,A02,083757,Briones; Jor-el Thomas Caparas,1,0,36,35
1657903784753,MATH 20B,A03,093475,Briones; Jor-el Thomas Caparas,2,0,36,34
1657903790781,MATH 20C,A01,083760,Briones; Jor-el Thomas Caparas,1,0,35,34
1657903790781,MATH 20C,A02,083761,Briones; Jor-el Thomas Caparas,8,0,35,27
1657903790781,MATH 20C,A03,093476,Briones; Jor-el Thomas Caparas,0,1,36,36
1657903790781,MATH 20C,B01,083762,Bach; Quang Tran,1,0,30,29
1657903796820,MATH 20D,A01,083765,Tran; Brian Kha,5,0,30,25
1657903796820,MATH 20D,A02,083766,Tran; Brian Kha,5,0,30,25
1657903796820,MATH 20D,A03,083767,Tran; Brian Kha,5,0,30,25
1657903802854,MATH 20E,A01,083771,Ganguly; Soumya,10,0,32,22
1657903802854,MATH 20E,A02,083772,Ganguly; Soumya,6,0,32,26
1657903802854,MATH 20E,B01,083773,Ciotti; Benjamin,20,0,35,15
1657903802854,MATH 20E,B02,083774,Ciotti; Benjamin,18,0,35,17
1657903808885,MATH 103A,A01,083777,Greenfeld; Be'Eri,3,0,36,33
1657903808885,MATH 103A,A02,083778,Greenfeld; Be'Eri,5,0,36,31
1657903808885,MATH 103A,A03,093561,Greenfeld; Be'Eri,6,0,36,30
1657903808885,MATH 103A,B01,083779,Greenfeld; Be'Eri,7,0,36,29
1657903808885,MATH 103A,B02,083780,Greenfeld; Be'Eri,4,0,36,32
1657903808885,MATH 103A,B03,093562,Greenfeld; Be'Eri,3,0,36,33
1657903814912,MATH 105,A01,085443,Carter; Anne Toulson,15,0,35,20
1657903814912,MATH 105,A02,093477,Carter; Anne Toulson,20,0,35,15
1657903820941,MATH 109,A01,083213,Ganzberger; Geoffrey Michael,3,0,34,31
1657903820941,MATH 109,A02,083214,Ganzberger; Geoffrey Michael,4,0,34,30
1657903820941,MATH 109,A03,093478,Ganzberger; Geoffrey Michael,2,0,34,32
1657903820941,MATH 109,B01,083215,Ganzberger; Geoffrey Michael,2,0,32,30
1657903820941,MATH 109,B02,083216,Ganzberger; Geoffrey Michael,2,0,32,30
1657903820941,MATH 109,B03,093479,Ganzberger; Geoffrey Michael,8,0,32,24
1657903826965,MATH 142A,A01,083219,Chow; Bennett,7,0,32,25
1657903826965,MATH 142A,A02,083220,Chow; Bennett,10,0,32,22
1657903826965,MATH 142A,A03,093480,Chow; Bennett,9,0,32,23
1657903826965,MATH 142A,B03,093481,Chow; Bennett,8,0,32,24
1657903826965,MATH 142A,B04,093558,Chow; Bennett,13,0,32,19
1657903826965,MATH 142A,B05,093559,Chow; Bennett,7,0,32,25
1657903832992,MATH 193A,A01,083224,Rotar; Vladimir,8,0,34,26
1657903832992,MATH 193A,A02,083225,Rotar; Vladimir,10,0,34,24
1657903832992,MATH 193A,A03,083781,Rotar; Vladimir,5,0,34,29
1657903832992,MATH 193A,A04,083782,Rotar; Vladimir,11,0,34,23
1657903832992,MATH 193A,A05,093482,Rotar; Vladimir,10,0,34,24
1657903839021,MATH 197,001,091859,McAuley; Julian John,9999,0,9999,0
1657903839021,MATH 197,002,095566,Kedlaya; Kiran S.,9997,0,9999,2
1657903839021,MATH 197,003,095567,Xiao; Ming,9999,0,9999,0
1657903839021,MATH 197,004,095571,Perols; Johan Lars,9998,0,9999,1
1657903846096,COGS 9,A01,083615,Shannon; Kyle Michael,10,0,75,65
1657903852117,COGS 11,A01,083617,Boyle; Mary E. T.,23,0,48,25
1657903858141,COGS 13,A01,083071,Bastos; Amalia Pinkusfeld,11,0,71,60
1657903864168,COGS 14A,A01,092681,Semenuks; Arturs,5,1,100,95
1657903870197,COGS 14B,A01,083073,Cheng; Tzu-Han,6,0,63,57
1657903876228,COGS 17,A01,092677,Semenuks; Arturs,6,0,81,75
1657903882255,COGS 100,A01,083619,Allen; Michael Gordon,17,0,70,53
1657903888282,COGS 101A,A01,083621,Davis; Joshua Daniel,9,0,68,59
1657903894308,COGS 101B,A01,091572,Allen; Michael Gordon,13,0,65,52
1657903900340,COGS 101C,A01,083625,Delgado; Tania,17,0,35,18
1657903906365,COGS 107A,A01,083627,Boyle; Mary E. T.,14,0,60,46
1657903912387,COGS 118A,A01,083075,Gupta; Anjum,21,0,76,55
1657903918410,CSE 3,A50,083646,Miranda; Gregory Joseph,24,0,50,26
1657903924433,CSE 8A,A50,083650,Miranda; Gregory Joseph,17,1,56,39
1657903930457,CSE 11,A01,083080,Cao; Yingjun,6,15,40,34
1657903936487,CSE 12,A01,083652,Krause-Levy; Sophia Louisa,30,1,120,90
1657903942511,CSE 15L,A01,083654,Morris; Justin Loren,9,0,50,41
1657903942511,CSE 15L,A02,083655,Morris; Justin Loren,10,0,50,40
1657903948538,CSE 20,A01,083657,Tran; Khoa Dang,39,0,80,41
1657903954561,CSE 21,A01,095574,Bach; Quang Tran,22,0,48,26
1657903960584,CSE 30,A01,083084,Eldon; John,6,0,80,74
1657903960584,CSE 30,B01,095061,Bhaskar; Nishant,9,0,50,41
1657903966608,CSE 100,A01,083659,Cao; Yingjun,5,4,70,65
1657903972633,CSE 134B,A01,083661,Powell; Thomas Allan,25,0,100,75
1657903978666,CSE 140,A01,083663,Gungor; Onat,15,0,85,70
1657903984694,CSE 140L,A01,083088,Eldon; John,23,0,100,77
1657903990719,CSE 175,A01,083665,Kumar; Rakesh,3,0,25,22
1657903996741,CSE 190,A00,092507,Dubnov; Shlomo,8,0,20,12
1657904002767,ECE 45,A01,083139,Congero; Spencer William,6,0,75,69
1657904008793,ECE 65,A50,083695,Saad; Andrew S,12,0,30,18
1657904008793,ECE 65,A51,095125,Saad; Andrew S,24,0,26,2
1657904014816,ECE 109,A01,091882,Touri; Behrouz,20,0,70,50
1657904020839,ECE 180,A00,083140,Abi Samra; Nicholas Camill,1,0,30,29
1657904020839,ECE 180,B00,083141,Abi Samra; Nicholas Camill,0,0,30,30
1657904026870,MATH 10A,A01,083735,Patchell; Gregory David,2,0,30,28
1657904026870,MATH 10A,A02,083736,Patchell; Gregory David,20,0,30,10
1657904026870,MATH 10A,A03,083737,Patchell; Gregory David,16,0,30,14
1657904032898,MATH 10B,A01,083207,Lim; Seonhee,8,0,34,26
1657904032898,MATH 10B,A02,083208,Lim; Seonhee,10,0,35,25
1657904032898,MATH 10B,A03,093472,Lim; Seonhee,7,0,34,27
1657904032898,MATH 10B,B01,083739,Sinha; Shubham,14,0,30,16
1657904038931,MATH 18,A01,083743,Cinel; Cameron Alexander,9,0,30,21
1657904038931,MATH 18,A02,083744,Cinel; Cameron Alexander,18,0,30,12
1657904038931,MATH 18,A03,083745,Cinel; Cameron Alexander,10,0,30,20
1657904038931,MATH 18,B01,083748,Rideout; David Porter,5,0,37,32
1657904038931,MATH 18,B02,083749,Rideout; David Porter,5,0,36,31
1657904038931,MATH 18,B03,083750,Rideout; David Porter,3,0,37,34
1657904038931,MATH 18,B04,083751,Rideout; David Porter,6,0,36,30
1657904038931,MATH 18,B05,093473,Rideout; David Porter,6,0,36,30
1657904038931,MATH 18,B06,093474,Rideout; David Porter,6,0,36,30
1657904044955,MATH 20A,A01,083754,Zheng; Zequn,14,0,40,26
1657904050982,MATH 20B,A01,083756,Briones; Jor-el Thomas Caparas,4,0,36,32
1657904050982,MATH 20B,A02,083757,Briones; Jor-el Thomas Caparas,1,0,36,35
1657904050982,MATH 20B,A03,093475,Briones; Jor-el Thomas Caparas,2,0,36,34
1657904057017,MATH 20C,A01,083760,Briones; Jor-el Thomas Caparas,1,0,35,34
1657904057017,MATH 20C,A02,083761,Briones; Jor-el Thomas Caparas,8,0,35,27
1657904057017,MATH 20C,A03,093476,Briones; Jor-el Thomas Caparas,0,1,36,36
1657904057017,MATH 20C,B01,083762,Bach; Quang Tran,1,0,30,29
1657904063045,MATH 20D,A01,083765,Tran; Brian Kha,5,0,30,25
1657904063045,MATH 20D,A02,083766,Tran; Brian Kha,5,0,30,25
1657904063045,MATH 20D,A03,083767,Tran; Brian Kha,5,0,30,25
1657904069072,MATH 20E,A01,083771,Ganguly; Soumya,10,0,32,22
1657904069072,MATH 20E,A02,083772,Ganguly; Soumya,6,0,32,26
1657904069072,MATH 20E,B01,083773,Ciotti; Benjamin,20,0,35,15
1657904069072,MATH 20E,B02,083774,Ciotti; Benjamin,18,0,35,17
1657904075100,MATH 103A,A01,083777,Greenfeld; Be'Eri,3,0,36,33
1657904075100,MATH 103A,A02,083778,Greenfeld; Be'Eri,5,0,36,31
1657904075100,MATH 103A,A03,093561,Greenfeld; Be'Eri,6,0,36,30
1657904075100,MATH 103A,B01,083779,Greenfeld; Be'Eri,7,0,36,29
1657904075100,MATH 103A,B02,083780,Greenfeld; Be'Eri,4,0,36,32
1657904075100,MATH 103A,B03,093562,Greenfeld; Be'Eri,3,0,36,33
1657904081127,MATH 105,A01,085443,Carter; Anne Toulson,15,0,35,20
1657904081127,MATH 105,A02,093477,Carter; Anne Toulson,20,0,35,15
1657904087155,MATH 109,A01,083213,Ganzberger; Geoffrey Michael,3,0,34,31
1657904087155,MATH 109,A02,083214,Ganzberger; Geoffrey Michael,4,0,34,30
1657904087155,MATH 109,A03,093478,Ganzberger; Geoffrey Michael,2,0,34,32
1657904087155,MATH 109,B01,083215,Ganzberger; Geoffrey Michael,2,0,32,30
1657904087155,MATH 109,B02,083216,Ganzberger; Geoffrey Michael,2,0,32,30
1657904087155,MATH 109,B03,093479,Ganzberger; Geoffrey Michael,8,0,32,24
1657904093183,MATH 142A,A01,083219,Chow; Bennett,7,0,32,25
1657904093183,MATH 142A,A02,083220,Chow; Bennett,10,0,32,22
1657904093183,MATH 142A,A03,093480,Chow; Bennett,9,0,32,23
1657904093183,MATH 142A,B03,093481,Chow; Bennett,8,0,32,24
1657904093183,MATH 142A,B04,093558,Chow; Bennett,13,0,32,19
1657904093183,MATH 142A,B05,093559,Chow; Bennett,7,0,32,25
1657904099223,MATH 193A,A01,083224,Rotar; Vladimir,8,0,34,26
1657904099223,MATH 193A,A02,083225,Rotar; Vladimir,10,0,34,24
1657904099223,MATH 193A,A03,083781,Rotar; Vladimir,5,0,34,29
1657904099223,MATH 193A,A04,083782,Rotar; Vladimir,11,0,34,23
1657904099223,MATH 193A,A05,093482,Rotar; Vladimir,10,0,34,24
1657904105250,MATH 197,001,091859,McAuley; Julian John,9999,0,9999,0
1657904105250,MATH 197,002,095566,Kedlaya; Kiran S.,9997,0,9999,2
1657904105250,MATH 197,003,095567,Xiao; Ming,9999,0,9999,0
1657904105250,MATH 197,004,095571,Perols; Johan Lars,9998,0,9999,1
1657904112385,COGS 9,A01,083615,Shannon; Kyle Michael,10,0,75,65
1657904118406,COGS 11,A01,083617,Boyle; Mary E. T.,23,0,48,25
1657904124432,COGS 13,A01,083071,Bastos; Amalia Pinkusfeld,11,0,71,60
1657904130455,COGS 14A,A01,092681,Semenuks; Arturs,5,1,100,95
1657904136484,COGS 14B,A01,083073,Cheng; Tzu-Han,6,0,63,57
1657904142506,COGS 17,A01,092677,Semenuks; Arturs,6,0,81,75
1657904148538,COGS 100,A01,083619,Allen; Michael Gordon,17,0,70,53
1657904154572,COGS 101A,A01,083621,Davis; Joshua Daniel,9,0,68,59
1657904160601,COGS 101B,A01,091572,Allen; Michael Gordon,13,0,65,52
1657904166622,COGS 101C,A01,083625,Delgado; Tania,17,0,35,18
1657904172645,COGS 107A,A01,083627,Boyle; Mary E. T.,14,0,60,46
1657904178667,COGS 118A,A01,083075,Gupta; Anjum,21,0,76,55
1657904184695,CSE 3,A50,083646,Miranda; Gregory Joseph,24,0,50,26
1657904190722,CSE 8A,A50,083650,Miranda; Gregory Joseph,17,1,56,39
1657904196744,CSE 11,A01,083080,Cao; Yingjun,6,15,40,34
1657904202771,CSE 12,A01,083652,Krause-Levy; Sophia Louisa,30,1,120,90
1657904208797,CSE 15L,A01,083654,Morris; Justin Loren,9,0,50,41
1657904208797,CSE 15L,A02,083655,Morris; Justin Loren,10,0,50,40
1657904214820,CSE 20,A01,083657,Tran; Khoa Dang,39,0,80,41
1657904220842,CSE 21,A01,095574,Bach; Quang Tran,22,0,48,26
1657904226866,CSE 30,A01,083084,Eldon; John,6,0,80,74
1657904226866,CSE 30,B01,095061,Bhaskar; Nishant,9,0,50,41
1657904232891,CSE 100,A01,083659,Cao; Yingjun,5,4,70,65
1657904238917,CSE 134B,A01,083661,Powell; Thomas Allan,25,0,100,75
1657904244940,CSE 140,A01,083663,Gungor; Onat,15,0,85,70
1657904250970,CSE 140L,A01,083088,Eldon; John,23,0,100,77
1657904256995,CSE 175,A01,083665,Kumar; Rakesh,3,0,25,22
1657904263023,CSE 190,A00,092507,Dubnov; Shlomo,8,0,20,12
1657904269052,ECE 45,A01,083139,Congero; Spencer William,6,0,75,69
1657904275080,ECE 65,A50,083695,Saad; Andrew S,12,0,30,18
1657904275080,ECE 65,A51,095125,Saad; Andrew S,24,0,26,2
1657904281110,ECE 109,A01,091882,Touri; Behrouz,20,0,70,50
1657904287134,ECE 180,A00,083140,Abi Samra; Nicholas Camill,1,0,30,29
1657904287134,ECE 180,B00,083141,Abi Samra; Nicholas Camill,0,0,30,30
1657904293163,MATH 10A,A01,083735,Patchell; Gregory David,2,0,30,28
1657904293163,MATH 10A,A02,083736,Patchell; Gregory David,20,0,30,10
1657904293163,MATH 10A,A03,083737,Patchell; Gregory David,16,0,30,14
1657904299192,MATH 10B,A01,083207,Lim; Seonhee,8,0,34,26
1657904299192,MATH 10B,A02,083208,Lim; Seonhee,10,0,35,25
1657904299192,MATH 10B,A03,093472,Lim; Seonhee,7,0,34,27
1657904299192,MATH 10B,B01,083739,Sinha; Shubham,14,0,30,16
1657904305215,MATH 18,A01,083743,Cinel; Cameron Alexander,9,0,30,21
1657904305215,MATH 18,A02,083744,Cinel; Cameron Alexander,18,0,30,12
1657904305215,MATH 18,A03,083745,Cinel; Cameron Alexander,10,0,30,20
1657904305215,MATH 18,B01,083748,Rideout; David Porter,5,0,37,32
1657904305215,MATH 18,B02,083749,Rideout; David Porter,5,0,36,31
1657904305215,MATH 18,B03,083750,Rideout; David Porter,3,0,37,34
1657904305215,MATH 18,B04,083751,Rideout; David Porter,6,0,36,30
1657904305215,MATH 18,B05,093473,Rideout; David Porter,6,0,36,30
1657904305215,MATH 18,B06,093474,Rideout; David Porter,6,0,36,30
1657904311246,MATH 20A,A01,083754,Zheng; Zequn,14,0,40,26
1657904317273,MATH 20B,A01,083756,Briones; Jor-el Thomas Caparas,4,0,36,32
1657904317273,MATH 20B,A02,083757,Briones; Jor-el Thomas Caparas,1,0,36,35
1657904317273,MATH 20B,A03,093475,Briones; Jor-el Thomas Caparas,2,0,36,34
1657904323301,MATH 20C,A01,083760,Briones; Jor-el Thomas Caparas,1,0,35,34
1657904323301,MATH 20C,A02,083761,Briones; Jor-el Thomas Caparas,8,0,35,27
1657904323301,MATH 20C,A03,093476,Briones; Jor-el Thomas Caparas,0,1,36,36
1657904323301,MATH 20C,B01,083762,Bach; Quang Tran,1,0,30,29
1657904329326,MATH 20D,A01,083765,Tran; Brian Kha,5,0,30,25
1657904329326,MATH 20D,A02,083766,Tran; Brian Kha,5,0,30,25
1657904329326,MATH 20D,A03,083767,Tran; Brian Kha,5,0,30,25
1657904335354,MATH 20E,A01,083771,Ganguly; Soumya,10,0,32,22
1657904335354,MATH 20E,A02,083772,Ganguly; Soumya,6,0,32,26
1657904335354,MATH 20E,B01,083773,Ciotti; Benjamin,20,0,35,15
1657904335354,MATH 20E,B02,083774,Ciotti; Benjamin,18,0,35,17
1657904341378,MATH 103A,A01,083777,Greenfeld; Be'Eri,3,0,36,33
1657904341378,MATH 103A,A02,083778,Greenfeld; Be'Eri,5,0,36,31
1657904341378,MATH 103A,A03,093561,Greenfeld; Be'Eri,6,0,36,30
1657904341378,MATH 103A,B01,083779,Greenfeld; Be'Eri,7,0,36,29
1657904341378,MATH 103A,B02,083780,Greenfeld; Be'Eri,4,0,36,32
1657904341378,MATH 103A,B03,093562,Greenfeld; Be'Eri,3,0,36,33
1657904347422,MATH 105,A01,085443,Carter; Anne Toulson,15,0,35,20
1657904347422,MATH 105,A02,093477,Carter; Anne Toulson,20,0,35,15
1657904353446,MATH 109,A01,083213,Ganzberger; Geoffrey Michael,3,0,34,31
1657904353446,MATH 109,A02,083214,Ganzberger; Geoffrey Michael,4,0,34,30
1657904353446,MATH 109,A03,093478,Ganzberger; Geoffrey Michael,2,0,34,32
1657904353446,MATH 109,B01,083215,Ganzberger; Geoffrey Michael,2,0,32,30
1657904353446,MATH 109,B02,083216,Ganzberger; Geoffrey Michael,2,0,32,30
1657904353446,MATH 109,B03,093479,Ganzberger; Geoffrey Michael,8,0,32,24
1657904359480,MATH 142A,A01,083219,Chow; Bennett,7,0,32,25
1657904359480,MATH 142A,A02,083220,Chow; Bennett,10,0,32,22
1657904359480,MATH 142A,A03,093480,Chow; Bennett,9,0,32,23
1657904359480,MATH 142A,B03,093481,Chow; Bennett,8,0,32,24
1657904359480,MATH 142A,B04,093558,Chow; Bennett,13,0,32,19
1657904359480,MATH 142A,B05,093559,Chow; Bennett,7,0,32,25
1657904365510,MATH 193A,A01,083224,Rotar; Vladimir,8,0,34,26
1657904365510,MATH 193A,A02,083225,Rotar; Vladimir,10,0,34,24
1657904365510,MATH 193A,A03,083781,Rotar; Vladimir,5,0,34,29
1657904365510,MATH 193A,A04,083782,Rotar; Vladimir,11,0,34,23
1657904365510,MATH 193A,A05,093482,Rotar; Vladimir,10,0,34,24
1657904371544,MATH 197,001,091859,McAuley; Julian John,9999,0,9999,0
1657904371544,MATH 197,002,095566,Kedlaya; Kiran S.,9997,0,9999,2
1657904371544,MATH 197,003,095567,Xiao; Ming,9999,0,9999,0
1657904371544,MATH 197,004,095571,Perols; Johan Lars,9998,0,9999,1
1657904378609,COGS 9,A01,083615,Shannon; Kyle Michael,10,0,75,65
1657904384630,COGS 11,A01,083617,Boyle; Mary E. T.,23,0,48,25
1657904390655,COGS 13,A01,083071,Bastos; Amalia Pinkusfeld,11,0,71,60
1657904396677,COGS 14A,A01,092681,Semenuks; Arturs,5,1,100,95
1657904402704,COGS 14B,A01,083073,Cheng; Tzu-Han,6,0,63,57
1657904408733,COGS 17,A01,092677,Semenuks; Arturs,6,0,81,75
1657904414754,COGS 100,A01,083619,Allen; Michael Gordon,17,0,70,53
1657904420778,COGS 101A,A01,083621,Davis; Joshua Daniel,9,0,68,59
1657904426801,COGS 101B,A01,091572,Allen; Michael Gordon,13,0,65,52
1657904432823,COGS 101C,A01,083625,Delgado; Tania,17,0,35,18
1657904438846,COGS 107A,A01,083627,Boyle; Mary E. T.,14,0,60,46
1657904444873,COGS 118A,A01,083075,Gupta; Anjum,21,0,76,55
1657904450900,CSE 3,A50,083646,Miranda; Gregory Joseph,24,0,50,26
1657904456928,CSE 8A,A50,083650,Miranda; Gregory Joseph,17,1,56,39
1657904462955,CSE 11,A01,083080,Cao; Yingjun,6,15,40,34
1657904468978,CSE 12,A01,083652,Krause-Levy; Sophia Louisa,30,1,120,90
1657904475001,CSE 15L,A01,083654,Morris; Justin Loren,9,0,50,41
1657904475001,CSE 15L,A02,083655,Morris; Justin Loren,10,0,50,40
1657904481025,CSE 20,A01,083657,Tran; Khoa Dang,39,0,80,41
1657904487058,CSE 21,A01,095574,Bach; Quang Tran,22,0,48,26
1657904493083,CSE 30,A01,083084,Eldon; John,6,0,80,74
1657904493083,CSE 30,B01,095061,Bhaskar; Nishant,9,0,50,41
1657904499107,CSE 100,A01,083659,Cao; Yingjun,5,4,70,65
1657904505134,CSE 134B,A01,083661,Powell; Thomas Allan,25,0,100,75
1657904511170,CSE 140,A01,083663,Gungor; Onat,15,0,85,70
1657904517193,CSE 140L,A01,083088,Eldon; John,23,0,100,77
1657904523215,CSE 175,A01,083665,Kumar; Rakesh,3,0,25,22
1657904529242,CSE 190,A00,092507,Dubnov; Shlomo,8,0,20,12
1657904535288,ECE 45,A01,083139,Congero; Spencer William,6,0,75,69
1657904541312,ECE 65,A50,083695,Saad; Andrew S,12,0,30,18
1657904541312,ECE 65,A51,095125,Saad; Andrew S,24,0,26,2
1657904547337,ECE 109,A01,091882,Touri; Behrouz,20,0,70,50
1657904553365,ECE 180,A00,083140,Abi Samra; Nicholas Camill,1,0,30,29
1657904553365,ECE 180,B00,083141,Abi Samra; Nicholas Camill,0,0,30,30
1657904559393,MATH 10A,A01,083735,Patchell; Gregory David,2,0,30,28
1657904559393,MATH 10A,A02,083736,Patchell; Gregory David,20,0,30,10
1657904559393,MATH 10A,A03,083737,Patchell; Gregory David,16,0,30,14
1657904565421,MATH 10B,A01,083207,Lim; Seonhee,8,0,34,26
1657904565421,MATH 10B,A02,083208,Lim; Seonhee,10,0,35,25
1657904565421,MATH 10B,A03,093472,Lim; Seonhee,7,0,34,27
1657904565421,MATH 10B,B01,083739,Sinha; Shubham,14,0,30,16
1657904571449,MATH 18,A01,083743,Cinel; Cameron Alexander,9,0,30,21
1657904571449,MATH 18,A02,083744,Cinel; Cameron Alexander,18,0,30,12
1657904571449,MATH 18,A03,083745,Cinel; Cameron Alexander,10,0,30,20
1657904571449,MATH 18,B01,083748,Rideout; David Porter,5,0,37,32
1657904571449,MATH 18,B02,083749,Rideout; David Porter,5,0,36,31
1657904571449,MATH 18,B03,083750,Rideout; David Porter,3,0,37,34
1657904571449,MATH 18,B04,083751,Rideout; David Porter,6,0,36,30
1657904571449,MATH 18,B05,093473,Rideout; David Porter,6,0,36,30
1657904571449,MATH 18,B06,093474,Rideout; David Porter,6,0,36,30
1657904577474,MATH 20A,A01,083754,Zheng; Zequn,14,0,40,26
1657904583506,MATH 20B,A01,083756,Briones; Jor-el Thomas Caparas,4,0,36,32
1657904583506,MATH 20B,A02,083757,Briones; Jor-el Thomas Caparas,1,0,36,35
1657904583506,MATH 20B,A03,093475,Briones; Jor-el Thomas Caparas,2,0,36,34
1657904589535,MATH 20C,A01,083760,Briones; Jor-el Thomas Caparas,1,0,35,34
1657904589535,MATH 20C,A02,083761,Briones; Jor-el Thomas Caparas,8,0,35,27
1657904589535,MATH 20C,A03,093476,Briones; Jor-el Thomas Caparas,0,1,36,36
1657904589535,MATH 20C,B01,083762,Bach; Quang Tran,1,0,30,29
1657904595560,MATH 20D,A01,083765,Tran; Brian Kha,5,0,30,25
1657904595560,MATH 20D,A02,083766,Tran; Brian Kha,5,0,30,25
1657904595560,MATH 20D,A03,083767,Tran; Brian Kha,5,0,30,25
1657904601591,MATH 20E,A01,083771,Ganguly; Soumya,10,0,32,22
1657904601591,MATH 20E,A02,083772,Ganguly; Soumya,6,0,32,26
1657904601591,MATH 20E,B01,083773,Ciotti; Benjamin,20,0,35,15
1657904601591,MATH 20E,B02,083774,Ciotti; Benjamin,18,0,35,17
1657904607614,MATH 103A,A01,083777,Greenfeld; Be'Eri,3,0,36,33
1657904607614,MATH 103A,A02,083778,Greenfeld; Be'Eri,5,0,36,31
1657904607614,MATH 103A,A03,093561,Greenfeld; Be'Eri,6,0,36,30
1657904607614,MATH 103A,B01,083779,Greenfeld; Be'Eri,7,0,36,29
1657904607614,MATH 103A,B02,083780,Greenfeld; Be'Eri,4,0,36,32
1657904607614,MATH 103A,B03,093562,Greenfeld; Be'Eri,3,0,36,33
1657904613651,MATH 105,A01,085443,Carter; Anne Toulson,15,0,35,20
1657904613651,MATH 105,A02,093477,Carter; Anne Toulson,20,0,35,15
1657904619676,MATH 109,A01,083213,Ganzberger; Geoffrey Michael,3,0,34,31
1657904619676,MATH 109,A02,083214,Ganzberger; Geoffrey Michael,4,0,34,30
1657904619676,MATH 109,A03,093478,Ganzberger; Geoffrey Michael,2,0,34,32
1657904619676,MATH 109,B01,083215,Ganzberger; Geoffrey Michael,2,0,32,30
1657904619676,MATH 109,B02,083216,Ganzberger; Geoffrey Michael,2,0,32,30
1657904619676,MATH 109,B03,093479,Ganzberger; Geoffrey Michael,8,0,32,24
1657904625701,MATH 142A,A01,083219,Chow; Bennett,7,0,32,25
1657904625701,MATH 142A,A02,083220,Chow; Bennett,10,0,32,22
1657904625701,MATH 142A,A03,093480,Chow; Bennett,9,0,32,23
1657904625701,MATH 142A,B03,093481,Chow; Bennett,8,0,32,24
1657904625701,MATH 142A,B04,093558,Chow; Bennett,13,0,32,19
1657904625701,MATH 142A,B05,093559,Chow; Bennett,7,0,32,25
1657904631731,MATH 193A,A01,083224,Rotar; Vladimir,8,0,34,26
1657904631731,MATH 193A,A02,083225,Rotar; Vladimir,10,0,34,24
1657904631731,MATH 193A,A03,083781,Rotar; Vladimir,5,0,34,29
1657904631731,MATH 193A,A04,083782,Rotar; Vladimir,11,0,34,23
1657904631731,MATH 193A,A05,093482,Rotar; Vladimir,10,0,34,24
1657904637753,MATH 197,001,091859,McAuley; Julian John,9999,0,9999,0
1657904637753,MATH 197,002,095566,Kedlaya; Kiran S.,9997,0,9999,2
1657904637753,MATH 197,003,095567,Xiao; Ming,9999,0,9999,0
1657904637753,MATH 197,004,095571,Perols; Johan Lars,9998,0,9999,1
1657904644809,COGS 9,A01,083615,Shannon; Kyle Michael,10,0,75,65
1657904650833,COGS 11,A01,083617,Boyle; Mary E. T.,23,0,48,25
1657904656859,COGS 13,A01,083071,Bastos; Amalia Pinkusfeld,11,0,71,60
1657904662882,COGS 14A,A01,092681,Semenuks; Arturs,5,1,100,95
1657904668908,COGS 14B,A01,083073,Cheng; Tzu-Han,6,0,63,57
1657904674935,COGS 17,A01,092677,Semenuks; Arturs,6,0,81,75
1657904680958,COGS 100,A01,083619,Allen; Michael Gordon,17,0,70,53
1657904686981,COGS 101A,A01,083621,Davis; Joshua Daniel,9,0,68,59
1657904693004,COGS 101B,A01,091572,Allen; Michael Gordon,13,0,65,52
1657904699027,COGS 101C,A01,083625,Delgado; Tania,17,0,35,18
1657904705129,COGS 107A,A01,083627,Boyle; Mary E. T.,14,0,60,46
1657904711160,COGS 118A,A01,083075,Gupta; Anjum,21,0,76,55
1657904717189,CSE 3,A50,083646,Miranda; Gregory Joseph,24,0,50,26
1657904723216,CSE 8A,A50,083650,Miranda; Gregory Joseph,17,1,56,39
1657904729240,CSE 11,A01,083080,Cao; Yingjun,6,15,40,34
1657904735265,CSE 12,A01,083652,Krause-Levy; Sophia Louisa,30,1,120,90
1657904741294,CSE 15L,A01,083654,Morris; Justin Loren,9,0,50,41
1657904741294,CSE 15L,A02,083655,Morris; Justin Loren,10,0,50,40
1657904747317,CSE 20,A01,083657,Tran; Khoa Dang,39,0,80,41
1657904753340,CSE 21,A01,095574,Bach; Quang Tran,22,0,48,26
1657904759363,CSE 30,A01,083084,Eldon; John,6,0,80,74
1657904759363,CSE 30,B01,095061,Bhaskar; Nishant,9,0,50,41
1657904765392,CSE 100,A01,083659,Cao; Yingjun,5,4,70,65
1657904771417,CSE 134B,A01,083661,Powell; Thomas Allan,25,0,100,75
1657904777443,CSE 140,A01,083663,Gungor; Onat,15,0,85,70
1657904783466,CSE 140L,A01,083088,Eldon; John,23,0,100,77
1657904789501,CSE 175,A01,083665,Kumar; Rakesh,3,0,25,22
1657904795528,CSE 190,A00,092507,Dubnov; Shlomo,8,0,20,12
1657904801553,ECE 45,A01,083139,Congero; Spencer William,6,0,75,69
1657904807589,ECE 65,A50,083695,Saad; Andrew S,12,0,30,18
1657904807589,ECE 65,A51,095125,Saad; Andrew S,24,0,26,2
1657904813612,ECE 109,A01,091882,Touri; Behrouz,20,0,70,50
1657904819639,ECE 180,A00,083140,Abi Samra; Nicholas Camill,1,0,30,29
1657904819639,ECE 180,B00,083141,Abi Samra; Nicholas Camill,0,0,30,30
1657904825662,MATH 10A,A01,083735,Patchell; Gregory David,2,0,30,28
1657904825662,MATH 10A,A02,083736,Patchell; Gregory David,20,0,30,10
1657904825662,MATH 10A,A03,083737,Patchell; Gregory David,16,0,30,14
1657904831690,MATH 10B,A01,083207,Lim; Seonhee,8,0,34,26
1657904831690,MATH 10B,A02,083208,Lim; Seonhee,10,0,35,25
1657904831690,MATH 10B,A03,093472,Lim; Seonhee,7,0,34,27
1657904831690,MATH 10B,B01,083739,Sinha; Shubham,14,0,30,16
1657904837714,MATH 18,A01,083743,Cinel; Cameron Alexander,9,0,30,21
1657904837714,MATH 18,A02,083744,Cinel; Cameron Alexander,18,0,30,12
1657904837714,MATH 18,A03,083745,Cinel; Cameron Alexander,10,0,30,20
1657904837714,MATH 18,B01,083748,Rideout; David Porter,5,0,37,32
1657904837714,MATH 18,B02,083749,Rideout; David Porter,5,0,36,31
1657904837714,MATH 18,B03,083750,Rideout; David Porter,3,0,37,34
1657904837714,MATH 18,B04,083751,Rideout; David Porter,6,0,36,30
1657904837714,MATH 18,B05,093473,Rideout; David Porter,6,0,36,30
1657904837714,MATH 18,B06,093474,Rideout; David Porter,6,0,36,30
1657904843741,MATH 20A,A01,083754,Zheng; Zequn,14,0,40,26
1657904849768,MATH 20B,A01,083756,Briones; Jor-el Thomas Caparas,4,0,36,32
1657904849768,MATH 20B,A02,083757,Briones; Jor-el Thomas Caparas,1,0,36,35
1657904849768,MATH 20B,A03,093475,Briones; Jor-el Thomas Caparas,2,0,36,34
1657904855796,MATH 20C,A01,083760,Briones; Jor-el Thomas Caparas,1,0,35,34
1657904855796,MATH 20C,A02,083761,Briones; Jor-el Thomas Caparas,8,0,35,27
1657904855796,MATH 20C,A03,093476,Briones; Jor-el Thomas Caparas,0,1,36,36
1657904855796,MATH 20C,B01,083762,Bach; Quang Tran,1,0,30,29
1657904861825,MATH 20D,A01,083765,Tran; Brian Kha,5,0,30,25
1657904861825,MATH 20D,A02,083766,Tran; Brian Kha,5,0,30,25
1657904861825,MATH 20D,A03,083767,Tran; Brian Kha,5,0,30,25
1657904867855,MATH 20E,A01,083771,Ganguly; Soumya,10,0,32,22
1657904867855,MATH 20E,A02,083772,Ganguly; Soumya,6,0,32,26
1657904867855,MATH 20E,B01,083773,Ciotti; Benjamin,20,0,35,15
1657904867855,MATH 20E,B02,083774,Ciotti; Benjamin,18,0,35,17
1657904873879,MATH 103A,A01,083777,Greenfeld; Be'Eri,3,0,36,33
1657904873879,MATH 103A,A02,083778,Greenfeld; Be'Eri,5,0,36,31
1657904873879,MATH 103A,A03,093561,Greenfeld; Be'Eri,6,0,36,30
1657904873879,MATH 103A,B01,083779,Greenfeld; Be'Eri,7,0,36,29
1657904873879,MATH 103A,B02,083780,Greenfeld; Be'Eri,4,0,36,32
1657904873879,MATH 103A,B03,093562,Greenfeld; Be'Eri,3,0,36,33
1657904879901,MATH 105,A01,085443,Carter; Anne Toulson,15,0,35,20
1657904879901,MATH 105,A02,093477,Carter; Anne Toulson,20,0,35,15
1657904885924,MATH 109,A01,083213,Ganzberger; Geoffrey Michael,3,0,34,31
1657904885924,MATH 109,A02,083214,Ganzberger; Geoffrey Michael,4,0,34,30
1657904885924,MATH 109,A03,093478,Ganzberger; Geoffrey Michael,2,0,34,32
1657904885924,MATH 109,B01,083215,Ganzberger; Geoffrey Michael,2,0,32,30
1657904885924,MATH 109,B02,083216,Ganzberger; Geoffrey Michael,2,0,32,30
1657904885924,MATH 109,B03,093479,Ganzberger; Geoffrey Michael,8,0,32,24
1657904891947,MATH 142A,A01,083219,Chow; Bennett,7,0,32,25
1657904891947,MATH 142A,A02,083220,Chow; Bennett,10,0,32,22
1657904891947,MATH 142A,A03,093480,Chow; Bennett,9,0,32,23
1657904891947,MATH 142A,B03,093481,Chow; Bennett,8,0,32,24
1657904891947,MATH 142A,B04,093558,Chow; Bennett,13,0,32,19
1657904891947,MATH 142A,B05,093559,Chow; Bennett,7,0,32,25
1657904897975,MATH 193A,A01,083224,Rotar; Vladimir,8,0,34,26
1657904897975,MATH 193A,A02,083225,Rotar; Vladimir,10,0,34,24
1657904897975,MATH 193A,A03,083781,Rotar; Vladimir,5,0,34,29
1657904897975,MATH 193A,A04,083782,Rotar; Vladimir,11,0,34,23
1657904897975,MATH 193A,A05,093482,Rotar; Vladimir,10,0,34,24
1657904903999,MATH 197,001,091859,McAuley; Julian John,9999,0,9999,0
1657904903999,MATH 197,002,095566,Kedlaya; Kiran S.,9997,0,9999,2
1657904903999,MATH 197,003,095567,Xiao; Ming,9999,0,9999,0
1657904903999,MATH 197,004,095571,Perols; Johan Lars,9998,0,9999,1
1657904911053,COGS 9,A01,083615,Shannon; Kyle Michael,10,0,75,65
1657904917081,COGS 11,A01,083617,Boyle; Mary E. T.,23,0,48,25
1657904923107,COGS 13,A01,083071,Bastos; Amalia Pinkusfeld,11,0,71,60
1657904929133,COGS 14A,A01,092681,Semenuks; Arturs,5,1,100,95
1657904935156,COGS 14B,A01,083073,Cheng; Tzu-Han,6,0,63,57
1657904941190,COGS 17,A01,092677,Semenuks; Arturs,6,0,81,75
1657904947212,COGS 100,A01,083619,Allen; Michael Gordon,17,0,70,53
1657904953246,COGS 101A,A01,083621,Davis; Joshua Daniel,9,0,68,59
1657904959273,COGS 101B,A01,091572,Allen; Michael Gordon,13,0,65,52
1657904965301,COGS 101C,A01,083625,Delgado; Tania,17,0,35,18
1657904971325,COGS 107A,A01,083627,Boyle; Mary E. T.,14,0,60,46
1657904977348,COGS 118A,A01,083075,Gupta; Anjum,21,0,76,55
1657904983374,CSE 3,A50,083646,Miranda; Gregory Joseph,24,0,50,26
1657904989402,CSE 8A,A50,083650,Miranda; Gregory Joseph,17,1,56,39
1657904995434,CSE 11,A01,083080,Cao; Yingjun,6,15,40,34
1657905001462,CSE 12,A01,083652,Krause-Levy; Sophia Louisa,30,1,120,90
1657905007489,CSE 15L,A01,083654,Morris; Justin Loren,9,0,50,41
1657905007489,CSE 15L,A02,083655,Morris; Justin Loren,10,0,50,40
1657905013520,CSE 20,A01,083657,Tran; Khoa Dang,39,0,80,41
1657905019543,CSE 21,A01,095574,Bach; Quang Tran,22,0,48,26
1657905025574,CSE 30,A01,083084,Eldon; John,6,0,80,74
1657905025574,CSE 30,B01,095061,Bhaskar; Nishant,9,0,50,41
1657905031596,CSE 100,A01,083659,Cao; Yingjun,5,4,70,65
1657905037619,CSE 134B,A01,083661,Powell; Thomas Allan,25,0,100,75
1657905043641,CSE 140,A01,083663,Gungor; Onat,15,0,85,70
1657905049664,CSE 140L,A01,083088,Eldon; John,23,0,100,77
1657905055687,CSE 175,A01,083665,Kumar; Rakesh,3,0,25,22
1657905061708,CSE 190,A00,092507,Dubnov; Shlomo,8,0,20,12
1657905067733,ECE 45,A01,083139,Congero; Spencer William,6,0,75,69
1657905073769,ECE 65,A50,083695,Saad; Andrew S,12,0,30,18
1657905073769,ECE 65,A51,095125,Saad; Andrew S,24,0,26,2
1657905079794,ECE 109,A01,091882,Touri; Behrouz,20,0,70,50
1657905085823,ECE 180,A00,083140,Abi Samra; Nicholas Camill,1,0,30,29
1657905085823,ECE 180,B00,083141,Abi Samra; Nicholas Camill,0,0,30,30
1657905091847,MATH 10A,A01,083735,Patchell; Gregory David,2,0,30,28
1657905091847,MATH 10A,A02,083736,Patchell; Gregory David,20,0,30,10
1657905091847,MATH 10A,A03,083737,Patchell; Gregory David,16,0,30,14
1657905097879,MATH 10B,A01,083207,Lim; Seonhee,8,0,34,26
1657905097879,MATH 10B,A02,083208,Lim; Seonhee,10,0,35,25
1657905097879,MATH 10B,A03,093472,Lim; Seonhee,7,0,34,27
1657905097879,MATH 10B,B01,083739,Sinha; Shubham,14,0,30,16
1657905103909,MATH 18,A01,083743,Cinel; Cameron Alexander,9,0,30,21
1657905103909,MATH 18,A02,083744,Cinel; Cameron Alexander,18,0,30,12
1657905103909,MATH 18,A03,083745,Cinel; Cameron Alexander,10,0,30,20
1657905103909,MATH 18,B01,083748,Rideout; David Porter,5,0,37,32
1657905103909,MATH 18,B02,083749,Rideout; David Porter,5,0,36,31
1657905103909,MATH 18,B03,083750,Rideout; David Porter,3,0,37,34
1657905103909,MATH 18,B04,083751,Rideout; David Porter,6,0,36,30
1657905103909,MATH 18,B05,093473,Rideout; David Porter,6,0,36,30
1657905103909,MATH 18,B06,093474,Rideout; David Porter,6,0,36,30
1657905109940,MATH 20A,A01,083754,Zheng; Zequn,14,0,40,26
1657905115967,MATH 20B,A01,083756,Briones; Jor-el Thomas Caparas,4,0,36,32
1657905115967,MATH 20B,A02,083757,Briones; Jor-el Thomas Caparas,1,0,36,35
1657905115967,MATH 20B,A03,093475,Briones; Jor-el Thomas Caparas,2,0,36,34
1657905121991,MATH 20C,A01,083760,Briones; Jor-el Thomas Caparas,1,0,35,34
1657905121991,MATH 20C,A02,083761,Briones; Jor-el Thomas Caparas,8,0,35,27
1657905121991,MATH 20C,A03,093476,Briones; Jor-el Thomas Caparas,0,1,36,36
1657905121991,MATH 20C,B01,083762,Bach; Quang Tran,1,0,30,29
1657905128015,MATH 20D,A01,083765,Tran; Brian Kha,5,0,30,25
1657905128015,MATH 20D,A02,083766,Tran; Brian Kha,5,0,30,25
1657905128015,MATH 20D,A03,083767,Tran; Brian Kha,5,0,30,25
1657905134040,MATH 20E,A01,083771,Ganguly; Soumya,10,0,32,22
1657905134040,MATH 20E,A02,083772,Ganguly; Soumya,6,0,32,26
1657905134040,MATH 20E,B01,083773,Ciotti; Benjamin,20,0,35,15
1657905134040,MATH 20E,B02,083774,Ciotti; Benjamin,18,0,35,17
1657905140064,MATH 103A,A01,083777,Greenfeld; Be'Eri,3,0,36,33
1657905140064,MATH 103A,A02,083778,Greenfeld; Be'Eri,5,0,36,31
1657905140064,MATH 103A,A03,093561,Greenfeld; Be'Eri,6,0,36,30
1657905140064,MATH 103A,B01,083779,Greenfeld; Be'Eri,7,0,36,29
1657905140064,MATH 103A,B02,083780,Greenfeld; Be'Eri,4,0,36,32
1657905140064,MATH 103A,B03,093562,Greenfeld; Be'Eri,3,0,36,33
1657905146090,MATH 105,A01,085443,Carter; Anne Toulson,15,0,35,20
1657905146090,MATH 105,A02,093477,Carter; Anne Toulson,20,0,35,15
1657905152114,MATH 109,A01,083213,Ganzberger; Geoffrey Michael,3,0,34,31
1657905152114,MATH 109,A02,083214,Ganzberger; Geoffrey Michael,4,0,34,30
1657905152114,MATH 109,A03,093478,Ganzberger; Geoffrey Michael,2,0,34,32
1657905152114,MATH 109,B01,083215,Ganzberger; Geoffrey Michael,2,0,32,30
1657905152114,MATH 109,B02,083216,Ganzberger; Geoffrey Michael,2,0,32,30
1657905152114,MATH 109,B03,093479,Ganzberger; Geoffrey Michael,8,0,32,24
1657905158137,MATH 142A,A01,083219,Chow; Bennett,7,0,32,25
1657905158137,MATH 142A,A02,083220,Chow; Bennett,10,0,32,22
1657905158137,MATH 142A,A03,093480,Chow; Bennett,9,0,32,23
1657905158137,MATH 142A,B03,093481,Chow; Bennett,8,0,32,24
1657905158137,MATH 142A,B04,093558,Chow; Bennett,13,0,32,19
1657905158137,MATH 142A,B05,093559,Chow; Bennett,7,0,32,25
1657905164166,MATH 193A,A01,083224,Rotar; Vladimir,8,0,34,26
1657905164166,MATH 193A,A02,083225,Rotar; Vladimir,10,0,34,24
1657905164166,MATH 193A,A03,083781,Rotar; Vladimir,5,0,34,29
1657905164166,MATH 193A,A04,083782,Rotar; Vladimir,11,0,34,23
1657905164166,MATH 193A,A05,093482,Rotar; Vladimir,10,0,34,24
1657905170189,MATH 197,001,091859,McAuley; Julian John,9999,0,9999,0
1657905170189,MATH 197,002,095566,Kedlaya; Kiran S.,9997,0,9999,2
1657905170189,MATH 197,003,095567,Xiao; Ming,9999,0,9999,0
1657905170189,MATH 197,004,095571,Perols; Johan Lars,9998,0,9999,1
1657905177259,COGS 9,A01,083615,Shannon; Kyle Michael,10,0,75,65
1657905183284,COGS 11,A01,083617,Boyle; Mary E. T.,23,0,48,25
1657905189309,COGS 13,A01,083071,Bastos; Amalia Pinkusfeld,11,0,71,60
1657905195332,COGS 14A,A01,092681,Semenuks; Arturs,5,1,100,95
1657905201356,COGS 14B,A01,083073,Cheng; Tzu-Han,6,0,63,57
1657905207382,COGS 17,A01,092677,Semenuks; Arturs,6,0,81,75
1657905213410,COGS 100,A01,083619,Allen; Michael Gordon,17,0,70,53
1657905219432,COGS 101A,A01,083621,Davis; Joshua Daniel,9,0,68,59
1657905225454,COGS 101B,A01,091572,Allen; Michael Gordon,13,0,65,52
1657905231480,COGS 101C,A01,083625,Delgado; Tania,17,0,35,18
1657905237503,COGS 107A,A01,083627,Boyle; Mary E. T.,14,0,60,46
1657905243534,COGS 118A,A01,083075,Gupta; Anjum,21,0,76,55
1657905249559,CSE 3,A50,083646,Miranda; Gregory Joseph,24,0,50,26
1657905255583,CSE 8A,A50,083650,Miranda; Gregory Joseph,17,1,56,39
1657905261615,CSE 11,A01,083080,Cao; Yingjun,6,15,40,34
1657905267644,CSE 12,A01,083652,Krause-Levy; Sophia Louisa,30,1,120,90
1657905273667,CSE 15L,A01,083654,Morris; Justin Loren,9,0,50,41
1657905273667,CSE 15L,A02,083655,Morris; Justin Loren,10,0,50,40
1657905279703,CSE 20,A01,083657,Tran; Khoa Dang,39,0,80,41
1657905285733,CSE 21,A01,095574,Bach; Quang Tran,22,0,48,26
1657905291771,CSE 30,A01,083084,Eldon; John,6,0,80,74
1657905291771,CSE 30,B01,095061,Bhaskar; Nishant,9,0,50,41
1657905297794,CSE 100,A01,083659,Cao; Yingjun,5,4,70,65
1657905303906,CSE 134B,A01,083661,Powell; Thomas Allan,25,0,100,75
1657905309929,CSE 140,A01,083663,Gungor; Onat,15,0,85,70
1657905315962,CSE 140L,A01,083088,Eldon; John,23,0,100,77
1657905321991,CSE 175,A01,083665,Kumar; Rakesh,3,0,25,22
1657905328019,CSE 190,A00,092507,Dubnov; Shlomo,8,0,20,12
1657905334042,ECE 45,A01,083139,Congero; Spencer William,6,0,75,69
1657905340065,ECE 65,A50,083695,Saad; Andrew S,12,0,30,18
1657905340065,ECE 65,A51,095125,Saad; Andrew S,24,0,26,2
1657905346091,ECE 109,A01,091882,Touri; Behrouz,20,0,70,50
1657905352118,ECE 180,A00,083140,Abi Samra; Nicholas Camill,1,0,30,29
1657905352118,ECE 180,B00,083141,Abi Samra; Nicholas Camill,0,0,30,30
1657905358147,MATH 10A,A01,083735,Patchell; Gregory David,2,0,30,28
1657905358147,MATH 10A,A02,083736,Patchell; Gregory David,20,0,30,10
1657905358147,MATH 10A,A03,083737,Patchell; Gregory David,16,0,30,14
1657905364175,MATH 10B,A01,083207,Lim; Seonhee,8,0,34,26
1657905364175,MATH 10B,A02,083208,Lim; Seonhee,10,0,35,25
1657905364175,MATH 10B,A03,093472,Lim; Seonhee,7,0,34,27
1657905364175,MATH 10B,B01,083739,Sinha; Shubham,14,0,30,16
1657905370200,MATH 18,A01,083743,Cinel; Cameron Alexander,9,0,30,21
1657905370200,MATH 18,A02,083744,Cinel; Cameron Alexander,18,0,30,12
1657905370200,MATH 18,A03,083745,Cinel; Cameron Alexander,10,0,30,20
1657905370200,MATH 18,B01,083748,Rideout; David Porter,5,0,37,32
1657905370200,MATH 18,B02,083749,Rideout; David Porter,5,0,36,31
1657905370200,MATH 18,B03,083750,Rideout; David Porter,3,0,37,34
1657905370200,MATH 18,B04,083751,Rideout; David Porter,6,0,36,30
1657905370200,MATH 18,B05,093473,Rideout; David Porter,6,0,36,30
1657905370200,MATH 18,B06,093474,Rideout; David Porter,6,0,36,30
1657905376242,MATH 20A,A01,083754,Zheng; Zequn,14,0,40,26
1657905382264,MATH 20B,A01,083756,Briones; Jor-el Thomas Caparas,4,0,36,32
1657905382264,MATH 20B,A02,083757,Briones; Jor-el Thomas Caparas,1,0,36,35
1657905382264,MATH 20B,A03,093475,Briones; Jor-el Thomas Caparas,2,0,36,34
1657905388289,MATH 20C,A01,083760,Briones; Jor-el Thomas Caparas,1,0,35,34
1657905388289,MATH 20C,A02,083761,Briones; Jor-el Thomas Caparas,8,0,35,27
1657905388289,MATH 20C,A03,093476,Briones; Jor-el Thomas Caparas,0,1,36,36
1657905388289,MATH 20C,B01,083762,Bach; Quang Tran,1,0,30,29
1657905394310,MATH 20D,A01,083765,Tran; Brian Kha,5,0,30,25
1657905394310,MATH 20D,A02,083766,Tran; Brian Kha,5,0,30,25
1657905394310,MATH 20D,A03,083767,Tran; Brian Kha,5,0,30,25
1657905400347,MATH 20E,A01,083771,Ganguly; Soumya,10,0,32,22
1657905400347,MATH 20E,A02,083772,Ganguly; Soumya,6,0,32,26
1657905400347,MATH 20E,B01,083773,Ciotti; Benjamin,20,0,35,15
1657905400347,MATH 20E,B02,083774,Ciotti; Benjamin,18,0,35,17
1657905406370,MATH 103A,A01,083777,Greenfeld; Be'Eri,3,0,36,33
1657905406370,MATH 103A,A02,083778,Greenfeld; Be'Eri,5,0,36,31
1657905406370,MATH 103A,A03,093561,Greenfeld; Be'Eri,6,0,36,30
1657905406370,MATH 103A,B01,083779,Greenfeld; Be'Eri,7,0,36,29
1657905406370,MATH 103A,B02,083780,Greenfeld; Be'Eri,4,0,36,32
1657905406370,MATH 103A,B03,093562,Greenfeld; Be'Eri,3,0,36,33
1657905412398,MATH 105,A01,085443,Carter; Anne Toulson,15,0,35,20
1657905412398,MATH 105,A02,093477,Carter; Anne Toulson,20,0,35,15
1657905418426,MATH 109,A01,083213,Ganzberger; Geoffrey Michael,3,0,34,31
1657905418426,MATH 109,A02,083214,Ganzberger; Geoffrey Michael,4,0,34,30
1657905418426,MATH 109,A03,093478,Ganzberger; Geoffrey Michael,2,0,34,32
1657905418426,MATH 109,B01,083215,Ganzberger; Geoffrey Michael,2,0,32,30
1657905418426,MATH 109,B02,083216,Ganzberger; Geoffrey Michael,2,0,32,30
1657905418426,MATH 109,B03,093479,Ganzberger; Geoffrey Michael,8,0,32,24
1657905424456,MATH 142A,A01,083219,Chow; Bennett,7,0,32,25
1657905424456,MATH 142A,A02,083220,Chow; Bennett,10,0,32,22
1657905424456,MATH 142A,A03,093480,Chow; Bennett,9,0,32,23
1657905424456,MATH 142A,B03,093481,Chow; Bennett,8,0,32,24
1657905424456,MATH 142A,B04,093558,Chow; Bennett,13,0,32,19
1657905424456,MATH 142A,B05,093559,Chow; Bennett,7,0,32,25
1657905430480,MATH 193A,A01,083224,Rotar; Vladimir,8,0,34,26
1657905430480,MATH 193A,A02,083225,Rotar; Vladimir,10,0,34,24
1657905430480,MATH 193A,A03,083781,Rotar; Vladimir,5,0,34,29
1657905430480,MATH 193A,A04,083782,Rotar; Vladimir,11,0,34,23
1657905430480,MATH 193A,A05,093482,Rotar; Vladimir,10,0,34,24
1657905436505,MATH 197,001,091859,McAuley; Julian John,9999,0,9999,0
1657905436505,MATH 197,002,095566,Kedlaya; Kiran S.,9997,0,9999,2
1657905436505,MATH 197,003,095567,Xiao; Ming,9999,0,9999,0
1657905436505,MATH 197,004,095571,Perols; Johan Lars,9998,0,9999,1
1657905443565,COGS 9,A01,083615,Shannon; Kyle Michael,10,0,75,65
1657905449594,COGS 11,A01,083617,Boyle; Mary E. T.,23,0,48,25
1657905455627,COGS 13,A01,083071,Bastos; Amalia Pinkusfeld,11,0,71,60
1657905461654,COGS 14A,A01,092681,Semenuks; Arturs,5,1,100,95
1657905467681,COGS 14B,A01,083073,Cheng; Tzu-Han,6,0,63,57
1657905473704,COGS 17,A01,092677,Semenuks; Arturs,6,0,81,75
1657905479730,COGS 100,A01,083619,Allen; Michael Gordon,17,0,70,53
1657905485763,COGS 101A,A01,083621,Davis; Joshua Daniel,9,0,68,59
1657905491786,COGS 101B,A01,091572,Allen; Michael Gordon,13,0,65,52
1657905497823,COGS 101C,A01,083625,Delgado; Tania,17,0,35,18
1657905503847,COGS 107A,A01,083627,Boyle; Mary E. T.,14,0,60,46
1657905509870,COGS 118A,A01,083075,Gupta; Anjum,21,0,76,55
1657905515892,CSE 3,A50,083646,Miranda; Gregory Joseph,24,0,50,26
1657905521916,CSE 8A,A50,083650,Miranda; Gregory Joseph,17,1,56,39
1657905527941,CSE 11,A01,083080,Cao; Yingjun,6,15,40,34
1657905533963,CSE 12,A01,083652,Krause-Levy; Sophia Louisa,30,1,120,90
1657905539996,CSE 15L,A01,083654,Morris; Justin Loren,9,0,50,41
1657905539996,CSE 15L,A02,083655,Morris; Justin Loren,10,0,50,40
1657905546025,CSE 20,A01,083657,Tran; Khoa Dang,39,0,80,41
1657905552052,CSE 21,A01,095574,Bach; Quang Tran,22,0,48,26
1657905558086,CSE 30,A01,083084,Eldon; John,6,0,80,74
1657905558086,CSE 30,B01,095061,Bhaskar; Nishant,9,0,50,41
1657905564121,CSE 100,A01,083659,Cao; Yingjun,5,4,70,65
1657905570143,CSE 134B,A01,083661,Powell; Thomas Allan,25,0,100,75
1657905576178,CSE 140,A01,083663,Gungor; Onat,15,0,85,70
1657905582201,CSE 140L,A01,083088,Eldon; John,23,0,100,77
1657905588229,CSE 175,A01,083665,Kumar; Rakesh,3,0,25,22
1657905594267,CSE 190,A00,092507,Dubnov; Shlomo,8,0,20,12
1657905600298,ECE 45,A01,083139,Congero; Spencer William,6,0,75,69
1657905606320,ECE 65,A50,083695,Saad; Andrew S,12,0,30,18
1657905606320,ECE 65,A51,095125,Saad; Andrew S,24,0,26,2
1657905612343,ECE 109,A01,091882,Touri; Behrouz,20,0,70,50
1657905618366,ECE 180,A00,083140,Abi Samra; Nicholas Camill,1,0,30,29
1657905618366,ECE 180,B00,083141,Abi Samra; Nicholas Camill,0,0,30,30
1657905624389,MATH 10A,A01,083735,Patchell; Gregory David,2,0,30,28
1657905624389,MATH 10A,A02,083736,Patchell; Gregory David,20,0,30,10
1657905624389,MATH 10A,A03,083737,Patchell; Gregory David,16,0,30,14
1657905630412,MATH 10B,A01,083207,Lim; Seonhee,8,0,34,26
1657905630412,MATH 10B,A02,083208,Lim; Seonhee,10,0,35,25
1657905630412,MATH 10B,A03,093472,Lim; Seonhee,7,0,34,27
1657905630412,MATH 10B,B01,083739,Sinha; Shubham,14,0,30,16
1657905636447,MATH 18,A01,083743,Cinel; Cameron Alexander,9,0,30,21
1657905636447,MATH 18,A02,083744,Cinel; Cameron Alexander,18,0,30,12
1657905636447,MATH 18,A03,083745,Cinel; Cameron Alexander,10,0,30,20
1657905636447,MATH 18,B01,083748,Rideout; David Porter,5,0,37,32
1657905636447,MATH 18,B02,083749,Rideout; David Porter,5,0,36,31
1657905636447,MATH 18,B03,083750,Rideout; David Porter,3,0,37,34
1657905636447,MATH 18,B04,083751,Rideout; David Porter,6,0,36,30
1657905636447,MATH 18,B05,093473,Rideout; David Porter,6,0,36,30
1657905636447,MATH 18,B06,093474,Rideout; David Porter,6,0,36,30
1657905642473,MATH 20A,A01,083754,Zheng; Zequn,14,0,40,26
1657905648498,MATH 20B,A01,083756,Briones; Jor-el Thomas Caparas,4,0,36,32
1657905648498,MATH 20B,A02,083757,Briones; Jor-el Thomas Caparas,1,0,36,35
1657905648498,MATH 20B,A03,093475,Briones; Jor-el Thomas Caparas,2,0,36,34
1657905654526,MATH 20C,A01,083760,Briones; Jor-el Thomas Caparas,1,0,35,34
1657905654526,MATH 20C,A02,083761,Briones; Jor-el Thomas Caparas,8,0,35,27
1657905654526,MATH 20C,A03,093476,Briones; Jor-el Thomas Caparas,0,1,36,36
1657905654526,MATH 20C,B01,083762,Bach; Quang Tran,1,0,30,29
1657905660557,MATH 20D,A01,083765,Tran; Brian Kha,5,0,30,25
1657905660557,MATH 20D,A02,083766,Tran; Brian Kha,5,0,30,25
1657905660557,MATH 20D,A03,083767,Tran; Brian Kha,5,0,30,25
1657905666581,MATH 20E,A01,083771,Ganguly; Soumya,10,0,32,22
1657905666581,MATH 20E,A02,083772,Ganguly; Soumya,6,0,32,26
1657905666581,MATH 20E,B01,083773,Ciotti; Benjamin,20,0,35,15
1657905666581,MATH 20E,B02,083774,Ciotti; Benjamin,18,0,35,17
1657905672605,MATH 103A,A01,083777,Greenfeld; Be'Eri,3,0,36,33
1657905672605,MATH 103A,A02,083778,Greenfeld; Be'Eri,5,0,36,31
1657905672605,MATH 103A,A03,093561,Greenfeld; Be'Eri,6,0,36,30
1657905672605,MATH 103A,B01,083779,Greenfeld; Be'Eri,7,0,36,29
1657905672605,MATH 103A,B02,083780,Greenfeld; Be'Eri,4,0,36,32
1657905672605,MATH 103A,B03,093562,Greenfeld; Be'Eri,3,0,36,33
1657905678641,MATH 105,A01,085443,Carter; Anne Toulson,15,0,35,20
1657905678641,MATH 105,A02,093477,Carter; Anne Toulson,20,0,35,15
1657905684670,MATH 109,A01,083213,Ganzberger; Geoffrey Michael,3,0,34,31
1657905684670,MATH 109,A02,083214,Ganzberger; Geoffrey Michael,4,0,34,30
1657905684670,MATH 109,A03,093478,Ganzberger; Geoffrey Michael,2,0,34,32
1657905684670,MATH 109,B01,083215,Ganzberger; Geoffrey Michael,2,0,32,30
1657905684670,MATH 109,B02,083216,Ganzberger; Geoffrey Michael,2,0,32,30
1657905684670,MATH 109,B03,093479,Ganzberger; Geoffrey Michael,8,0,32,24
1657905690694,MATH 142A,A01,083219,Chow; Bennett,7,0,32,25
1657905690694,MATH 142A,A02,083220,Chow; Bennett,10,0,32,22
1657905690694,MATH 142A,A03,093480,Chow; Bennett,9,0,32,23
1657905690694,MATH 142A,B03,093481,Chow; Bennett,8,0,32,24
1657905690694,MATH 142A,B04,093558,Chow; Bennett,13,0,32,19
1657905690694,MATH 142A,B05,093559,Chow; Bennett,7,0,32,25
1657905696723,MATH 193A,A01,083224,Rotar; Vladimir,8,0,34,26
1657905696723,MATH 193A,A02,083225,Rotar; Vladimir,10,0,34,24
1657905696723,MATH 193A,A03,083781,Rotar; Vladimir,5,0,34,29
1657905696723,MATH 193A,A04,083782,Rotar; Vladimir,11,0,34,23
1657905696723,MATH 193A,A05,093482,Rotar; Vladimir,10,0,34,24
1657905702749,MATH 197,001,091859,McAuley; Julian John,9999,0,9999,0
1657905702749,MATH 197,002,095566,Kedlaya; Kiran S.,9997,0,9999,2
1657905702749,MATH 197,003,095567,Xiao; Ming,9999,0,9999,0
1657905702749,MATH 197,004,095571,Perols; Johan Lars,9998,0,9999,1
1657905709804,COGS 9,A01,083615,Shannon; Kyle Michael,10,0,75,65
1657905715836,COGS 11,A01,083617,Boyle; Mary E. T.,23,0,48,25
1657905721861,COGS 13,A01,083071,Bastos; Amalia Pinkusfeld,11,0,71,60
1657905727883,COGS 14A,A01,092681,Semenuks; Arturs,5,1,100,95
1657905733906,COGS 14B,A01,083073,Cheng; Tzu-Han,6,0,63,57
1657905739929,COGS 17,A01,092677,Semenuks; Arturs,6,0,81,75
1657905745956,COGS 100,A01,083619,Allen; Michael Gordon,17,0,70,53
1657905751979,COGS 101A,A01,083621,Davis; Joshua Daniel,9,0,68,59
1657905758006,COGS 101B,A01,091572,Allen; Michael Gordon,13,0,65,52
1657905764037,COGS 101C,A01,083625,Delgado; Tania,17,0,35,18
1657905770073,COGS 107A,A01,083627,Boyle; Mary E. T.,14,0,60,46
1657905776100,COGS 118A,A01,083075,Gupta; Anjum,21,0,76,55
1657905782137,CSE 3,A50,083646,Miranda; Gregory Joseph,24,0,50,26
1657905788167,CSE 8A,A50,083650,Miranda; Gregory Joseph,17,1,56,39
1657905794193,CSE 11,A01,083080,Cao; Yingjun,6,15,40,34
1657905800217,CSE 12,A01,083652,Krause-Levy; Sophia Louisa,30,1,120,90
1657905806240,CSE 15L,A01,083654,Morris; Justin Loren,9,0,50,41
1657905806240,CSE 15L,A02,083655,Morris; Justin Loren,10,0,50,40
1657905812266,CSE 20,A01,083657,Tran; Khoa Dang,39,0,80,41
1657905818288,CSE 21,A01,095574,Bach; Quang Tran,22,0,48,26
1657905824311,CSE 30,A01,083084,Eldon; John,6,0,80,74
1657905824311,CSE 30,B01,095061,Bhaskar; Nishant,9,0,50,41
1657905830337,CSE 100,A01,083659,Cao; Yingjun,5,4,70,65
1657905836365,CSE 134B,A01,083661,Powell; Thomas Allan,25,0,100,75
1657905842389,CSE 140,A01,083663,Gungor; Onat,15,0,85,70
1657905848417,CSE 140L,A01,083088,Eldon; John,23,0,100,77
1657905854444,CSE 175,A01,083665,Kumar; Rakesh,3,0,25,22
1657905860469,CSE 190,A00,092507,Dubnov; Shlomo,8,0,20,12
1657905866492,ECE 45,A01,083139,Congero; Spencer William,6,0,75,69
1657905872522,ECE 65,A50,083695,Saad; Andrew S,12,0,30,18
1657905872522,ECE 65,A51,095125,Saad; Andrew S,24,0,26,2
1657905878545,ECE 109,A01,091882,Touri; Behrouz,20,0,70,50
1657905884580,ECE 180,A00,083140,Abi Samra; Nicholas Camill,1,0,30,29
1657905884580,ECE 180,B00,083141,Abi Samra; Nicholas Camill,0,0,30,30
1657905890608,MATH 10A,A01,083735,Patchell; Gregory David,2,0,30,28
1657905890608,MATH 10A,A02,083736,Patchell; Gregory David,20,0,30,10
1657905890608,MATH 10A,A03,083737,Patchell; Gregory David,16,0,30,14
1657905896631,MATH 10B,A01,083207,Lim; Seonhee,8,0,34,26
1657905896631,MATH 10B,A02,083208,Lim; Seonhee,10,0,35,25
1657905896631,MATH 10B,A03,093472,Lim; Seonhee,7,0,34,27
1657905896631,MATH 10B,B01,083739,Sinha; Shubham,14,0,30,16
1657905902732,MATH 18,A01,083743,Cinel; Cameron Alexander,9,0,30,21
1657905902732,MATH 18,A02,083744,Cinel; Cameron Alexander,18,0,30,12
1657905902732,MATH 18,A03,083745,Cinel; Cameron Alexander,10,0,30,20
1657905902732,MATH 18,B01,083748,Rideout; David Porter,5,0,37,32
1657905902732,MATH 18,B02,083749,Rideout; David Porter,5,0,36,31
1657905902732,MATH 18,B03,083750,Rideout; David Porter,3,0,37,34
1657905902732,MATH 18,B04,083751,Rideout; David Porter,6,0,36,30
1657905902732,MATH 18,B05,093473,Rideout; David Porter,6,0,36,30
1657905902732,MATH 18,B06,093474,Rideout; David Porter,6,0,36,30
1657905908756,MATH 20A,A01,083754,Zheng; Zequn,14,0,40,26
1657905914784,MATH 20B,A01,083756,Briones; Jor-el Thomas Caparas,4,0,36,32
1657905914784,MATH 20B,A02,083757,Briones; Jor-el Thomas Caparas,1,0,36,35
1657905914784,MATH 20B,A03,093475,Briones; Jor-el Thomas Caparas,2,0,36,34
1657905920807,MATH 20C,A01,083760,Briones; Jor-el Thomas Caparas,1,0,35,34
1657905920807,MATH 20C,A02,083761,Briones; Jor-el Thomas Caparas,8,0,35,27
1657905920807,MATH 20C,A03,093476,Briones; Jor-el Thomas Caparas,0,1,36,36
1657905920807,MATH 20C,B01,083762,Bach; Quang Tran,1,0,30,29
1657905926840,MATH 20D,A01,083765,Tran; Brian Kha,5,0,30,25
1657905926840,MATH 20D,A02,083766,Tran; Brian Kha,5,0,30,25
1657905926840,MATH 20D,A03,083767,Tran; Brian Kha,5,0,30,25
1657905932864,MATH 20E,A01,083771,Ganguly; Soumya,10,0,32,22
1657905932864,MATH 20E,A02,083772,Ganguly; Soumya,6,0,32,26
1657905932864,MATH 20E,B01,083773,Ciotti; Benjamin,20,0,35,15
1657905932864,MATH 20E,B02,083774,Ciotti; Benjamin,18,0,35,17
1657905938887,MATH 103A,A01,083777,Greenfeld; Be'Eri,3,0,36,33
1657905938887,MATH 103A,A02,083778,Greenfeld; Be'Eri,5,0,36,31
1657905938887,MATH 103A,A03,093561,Greenfeld; Be'Eri,6,0,36,30
1657905938887,MATH 103A,B01,083779,Greenfeld; Be'Eri,7,0,36,29
1657905938887,MATH 103A,B02,083780,Greenfeld; Be'Eri,4,0,36,32
1657905938887,MATH 103A,B03,093562,Greenfeld; Be'Eri,3,0,36,33
1657905944909,MATH 105,A01,085443,Carter; Anne Toulson,15,0,35,20
1657905944909,MATH 105,A02,093477,Carter; Anne Toulson,20,0,35,15
1657905950944,MATH 109,A01,083213,Ganzberger; Geoffrey Michael,3,0,34,31
1657905950944,MATH 109,A02,083214,Ganzberger; Geoffrey Michael,4,0,34,30
1657905950944,MATH 109,A03,093478,Ganzberger; Geoffrey Michael,2,0,34,32
1657905950944,MATH 109,B01,083215,Ganzberger; Geoffrey Michael,2,0,32,30
1657905950944,MATH 109,B02,083216,Ganzberger; Geoffrey Michael,2,0,32,30
1657905950944,MATH 109,B03,093479,Ganzberger; Geoffrey Michael,8,0,32,24
1657905956972,MATH 142A,A01,083219,Chow; Bennett,7,0,32,25
1657905956972,MATH 142A,A02,083220,Chow; Bennett,10,0,32,22
1657905956972,MATH 142A,A03,093480,Chow; Bennett,9,0,32,23
1657905956972,MATH 142A,B03,093481,Chow; Bennett,8,0,32,24
1657905956972,MATH 142A,B04,093558,Chow; Bennett,13,0,32,19
1657905956972,MATH 142A,B05,093559,Chow; Bennett,7,0,32,25
1657905962997,MATH 193A,A01,083224,Rotar; Vladimir,8,0,34,26
1657905962997,MATH 193A,A02,083225,Rotar; Vladimir,10,0,34,24
1657905962997,MATH 193A,A03,083781,Rotar; Vladimir,5,0,34,29
1657905962997,MATH 193A,A04,083782,Rotar; Vladimir,11,0,34,23
1657905962997,MATH 193A,A05,093482,Rotar; Vladimir,10,0,34,24
1657905969021,MATH 197,001,091859,McAuley; Julian John,9999,0,9999,0
1657905969021,MATH 197,002,095566,Kedlaya; Kiran S.,9997,0,9999,2
1657905969021,MATH 197,003,095567,Xiao; Ming,9999,0,9999,0
1657905969021,MATH 197,004,095571,Perols; Johan Lars,9998,0,9999,1
1657905976092,COGS 9,A01,083615,Shannon; Kyle Michael,10,0,75,65
1657905982130,COGS 11,A01,083617,Boyle; Mary E. T.,23,0,48,25
1657905988152,COGS 13,A01,083071,Bastos; Amalia Pinkusfeld,11,0,71,60
1657905994194,COGS 14A,A01,092681,Semenuks; Arturs,5,1,100,95
1657906000217,COGS 14B,A01,083073,Cheng; Tzu-Han,6,0,63,57
1657906006239,COGS 17,A01,092677,Semenuks; Arturs,6,0,81,75
1657906012263,COGS 100,A01,083619,Allen; Michael Gordon,17,0,70,53
1657906018287,COGS 101A,A01,083621,Davis; Joshua Daniel,9,0,68,59
1657906024311,COGS 101B,A01,091572,Allen; Michael Gordon,13,0,65,52
1657906030338,COGS 101C,A01,083625,Delgado; Tania,17,0,35,18
1657906036359,COGS 107A,A01,083627,Boyle; Mary E. T.,14,0,60,46
1657906042385,COGS 118A,A01,083075,Gupta; Anjum,21,0,76,55
1657906048412,CSE 3,A50,083646,Miranda; Gregory Joseph,24,0,50,26
1657906054442,CSE 8A,A50,083650,Miranda; Gregory Joseph,17,1,56,39
1657906060465,CSE 11,A01,083080,Cao; Yingjun,6,15,40,34
1657906066491,CSE 12,A01,083652,Krause-Levy; Sophia Louisa,30,1,120,90
1657906072524,CSE 15L,A01,083654,Morris; Justin Loren,9,0,50,41
1657906072524,CSE 15L,A02,083655,Morris; Justin Loren,10,0,50,40
1657906078550,CSE 20,A01,083657,Tran; Khoa Dang,39,0,80,41
1657906084585,CSE 21,A01,095574,Bach; Quang Tran,22,0,48,26
1657906090608,CSE 30,A01,083084,Eldon; John,6,0,80,74
1657906090608,CSE 30,B01,095061,Bhaskar; Nishant,9,0,50,41
1657906096636,CSE 100,A01,083659,Cao; Yingjun,5,4,70,65
1657906102659,CSE 134B,A01,083661,Powell; Thomas Allan,25,0,100,75
1657906108681,CSE 140,A01,083663,Gungor; Onat,15,0,85,70
1657906114704,CSE 140L,A01,083088,Eldon; John,23,0,100,77
1657906120726,CSE 175,A01,083665,Kumar; Rakesh,3,0,25,22
1657906126750,CSE 190,A00,092507,Dubnov; Shlomo,8,0,20,12
1657906132785,ECE 45,A01,083139,Congero; Spencer William,6,0,75,69
1657906138808,ECE 65,A50,083695,Saad; Andrew S,12,0,30,18
1657906138808,ECE 65,A51,095125,Saad; Andrew S,24,0,26,2
1657906144833,ECE 109,A01,091882,Touri; Behrouz,20,0,70,50
1657906150859,ECE 180,A00,083140,Abi Samra; Nicholas Camill,1,0,30,29
1657906150859,ECE 180,B00,083141,Abi Samra; Nicholas Camill,0,0,30,30
1657906156882,MATH 10A,A01,083735,Patchell; Gregory David,2,0,30,28
1657906156882,MATH 10A,A02,083736,Patchell; Gregory David,20,0,30,10
1657906156882,MATH 10A,A03,083737,Patchell; Gregory David,16,0,30,14
1657906162904,MATH 10B,A01,083207,Lim; Seonhee,8,0,34,26
1657906162904,MATH 10B,A02,083208,Lim; Seonhee,10,0,35,25
1657906162904,MATH 10B,A03,093472,Lim; Seonhee,7,0,34,27
1657906162904,MATH 10B,B01,083739,Sinha; Shubham,14,0,30,16
1657906168935,MATH 18,A01,083743,Cinel; Cameron Alexander,9,0,30,21
1657906168935,MATH 18,A02,083744,Cinel; Cameron Alexander,18,0,30,12
1657906168935,MATH 18,A03,083745,Cinel; Cameron Alexander,10,0,30,20
1657906168935,MATH 18,B01,083748,Rideout; David Porter,5,0,37,32
1657906168935,MATH 18,B02,083749,Rideout; David Porter,5,0,36,31
1657906168935,MATH 18,B03,083750,Rideout; David Porter,3,0,37,34
1657906168935,MATH 18,B04,083751,Rideout; David Porter,6,0,36,30
1657906168935,MATH 18,B05,093473,Rideout; David Porter,6,0,36,30
1657906168935,MATH 18,B06,093474,Rideout; David Porter,6,0,36,30
1657906174958,MATH 20A,A01,083754,Zheng; Zequn,14,0,40,26
1657906180980,MATH 20B,A01,083756,Briones; Jor-el Thomas Caparas,4,0,36,32
1657906180980,MATH 20B,A02,083757,Briones; Jor-el Thomas Caparas,1,0,36,35
1657906180980,MATH 20B,A03,093475,Briones; Jor-el Thomas Caparas,2,0,36,34
1657906187007,MATH 20C,A01,083760,Briones; Jor-el Thomas Caparas,1,0,35,34
1657906187007,MATH 20C,A02,083761,Briones; Jor-el Thomas Caparas,8,0,35,27
1657906187007,MATH 20C,A03,093476,Briones; Jor-el Thomas Caparas,0,1,36,36
1657906187007,MATH 20C,B01,083762,Bach; Quang Tran,1,0,30,29
1657906193033,MATH 20D,A01,083765,Tran; Brian Kha,5,0,30,25
1657906193033,MATH 20D,A02,083766,Tran; Brian Kha,5,0,30,25
1657906193033,MATH 20D,A03,083767,Tran; Brian Kha,5,0,30,25
1657906199056,MATH 20E,A01,083771,Ganguly; Soumya,10,0,32,22
1657906199056,MATH 20E,A02,083772,Ganguly; Soumya,6,0,32,26
1657906199056,MATH 20E,B01,083773,Ciotti; Benjamin,20,0,35,15
1657906199056,MATH 20E,B02,083774,Ciotti; Benjamin,18,0,35,17
1657906205085,MATH 103A,A01,083777,Greenfeld; Be'Eri,3,0,36,33
1657906205085,MATH 103A,A02,083778,Greenfeld; Be'Eri,5,0,36,31
1657906205085,MATH 103A,A03,093561,Greenfeld; Be'Eri,6,0,36,30
1657906205085,MATH 103A,B01,083779,Greenfeld; Be'Eri,7,0,36,29
1657906205085,MATH 103A,B02,083780,Greenfeld; Be'Eri,4,0,36,32
1657906205085,MATH 103A,B03,093562,Greenfeld; Be'Eri,3,0,36,33
1657906211107,MATH 105,A01,085443,Carter; Anne Toulson,15,0,35,20
1657906211107,MATH 105,A02,093477,Carter; Anne Toulson,20,0,35,15
1657906217137,MATH 109,A01,083213,Ganzberger; Geoffrey Michael,3,0,34,31
1657906217137,MATH 109,A02,083214,Ganzberger; Geoffrey Michael,4,0,34,30
1657906217137,MATH 109,A03,093478,Ganzberger; Geoffrey Michael,2,0,34,32
1657906217137,MATH 109,B01,083215,Ganzberger; Geoffrey Michael,2,0,32,30
1657906217137,MATH 109,B02,083216,Ganzberger; Geoffrey Michael,2,0,32,30
1657906217137,MATH 109,B03,093479,Ganzberger; Geoffrey Michael,8,0,32,24
1657906223159,MATH 142A,A01,083219,Chow; Bennett,7,0,32,25
1657906223159,MATH 142A,A02,083220,Chow; Bennett,10,0,32,22
1657906223159,MATH 142A,A03,093480,Chow; Bennett,9,0,32,23
1657906223159,MATH 142A,B03,093481,Chow; Bennett,8,0,32,24
1657906223159,MATH 142A,B04,093558,Chow; Bennett,13,0,32,19
1657906223159,MATH 142A,B05,093559,Chow; Bennett,7,0,32,25
1657906229182,MATH 193A,A01,083224,Rotar; Vladimir,8,0,34,26
1657906229182,MATH 193A,A02,083225,Rotar; Vladimir,10,0,34,24
1657906229182,MATH 193A,A03,083781,Rotar; Vladimir,5,0,34,29
1657906229182,MATH 193A,A04,083782,Rotar; Vladimir,11,0,34,23
1657906229182,MATH 193A,A05,093482,Rotar; Vladimir,10,0,34,24
1657906235205,MATH 197,001,091859,McAuley; Julian John,9999,0,9999,0
1657906235205,MATH 197,002,095566,Kedlaya; Kiran S.,9997,0,9999,2
1657906235205,MATH 197,003,095567,Xiao; Ming,9999,0,9999,0
1657906235205,MATH 197,004,095571,Perols; Johan Lars,9998,0,9999,1
1657906242264,COGS 9,A01,083615,Shannon; Kyle Michael,10,0,75,65
1657906248287,COGS 11,A01,083617,Boyle; Mary E. T.,23,0,48,25
1657906254310,COGS 13,A01,083071,Bastos; Amalia Pinkusfeld,11,0,71,60
1657906260340,COGS 14A,A01,092681,Semenuks; Arturs,5,1,100,95
1657906266365,COGS 14B,A01,083073,Cheng; Tzu-Han,6,0,63,57
1657906272387,COGS 17,A01,092677,Semenuks; Arturs,6,0,81,75
1657906278417,COGS 100,A01,083619,Allen; Michael Gordon,17,0,70,53
1657906284451,COGS 101A,A01,083621,Davis; Joshua Daniel,9,0,68,59
1657906290476,COGS 101B,A01,091572,Allen; Michael Gordon,13,0,65,52
1657906296499,COGS 101C,A01,083625,Delgado; Tania,17,0,35,18
1657906302523,COGS 107A,A01,083627,Boyle; Mary E. T.,14,0,60,46
1657906308552,COGS 118A,A01,083075,Gupta; Anjum,21,0,76,55
1657906314577,CSE 3,A50,083646,Miranda; Gregory Joseph,24,0,50,26
1657906320603,CSE 8A,A50,083650,Miranda; Gregory Joseph,17,1,56,39
1657906326626,CSE 11,A01,083080,Cao; Yingjun,6,15,40,34
1657906332654,CSE 12,A01,083652,Krause-Levy; Sophia Louisa,30,1,120,90
1657906338675,CSE 15L,A01,083654,Morris; Justin Loren,9,0,50,41
1657906338675,CSE 15L,A02,083655,Morris; Justin Loren,10,0,50,40
1657906344697,CSE 20,A01,083657,Tran; Khoa Dang,39,0,80,41
1657906350722,CSE 21,A01,095574,Bach; Quang Tran,22,0,48,26
1657906356746,CSE 30,A01,083084,Eldon; John,6,0,80,74
1657906356746,CSE 30,B01,095061,Bhaskar; Nishant,9,0,50,41
1657906362772,CSE 100,A01,083659,Cao; Yingjun,5,4,70,65
1657906368799,CSE 134B,A01,083661,Powell; Thomas Allan,25,0,100,75
1657906374826,CSE 140,A01,083663,Gungor; Onat,15,0,85,70
1657906380851,CSE 140L,A01,083088,Eldon; John,23,0,100,77
1657906386881,CSE 175,A01,083665,Kumar; Rakesh,3,0,25,22
1657906392906,CSE 190,A00,092507,Dubnov; Shlomo,8,0,20,12
1657906398928,ECE 45,A01,083139,Congero; Spencer William,6,0,75,69
1657906404956,ECE 65,A50,083695,Saad; Andrew S,12,0,30,18
1657906404956,ECE 65,A51,095125,Saad; Andrew S,24,0,26,2
1657906410990,ECE 109,A01,091882,Touri; Behrouz,20,0,70,50
1657906417013,ECE 180,A00,083140,Abi Samra; Nicholas Camill,1,0,30,29
1657906417013,ECE 180,B00,083141,Abi Samra; Nicholas Camill,0,0,30,30
1657906423042,MATH 10A,A01,083735,Patchell; Gregory David,2,0,30,28
1657906423042,MATH 10A,A02,083736,Patchell; Gregory David,20,0,30,10
1657906423042,MATH 10A,A03,083737,Patchell; Gregory David,16,0,30,14
1657906429064,MATH 10B,A01,083207,Lim; Seonhee,8,0,34,26
1657906429064,MATH 10B,A02,083208,Lim; Seonhee,10,0,35,25
1657906429064,MATH 10B,A03,093472,Lim; Seonhee,7,0,34,27
1657906429064,MATH 10B,B01,083739,Sinha; Shubham,14,0,30,16
1657906435089,MATH 18,A01,083743,Cinel; Cameron Alexander,9,0,30,21
1657906435089,MATH 18,A02,083744,Cinel; Cameron Alexander,18,0,30,12
1657906435089,MATH 18,A03,083745,Cinel; Cameron Alexander,10,0,30,20
1657906435089,MATH 18,B01,083748,Rideout; David Porter,5,0,37,32
1657906435089,MATH 18,B02,083749,Rideout; David Porter,5,0,36,31
1657906435089,MATH 18,B03,083750,Rideout; David Porter,3,0,37,34
1657906435089,MATH 18,B04,083751,Rideout; David Porter,6,0,36,30
1657906435089,MATH 18,B05,093473,Rideout; David Porter,6,0,36,30
1657906435089,MATH 18,B06,093474,Rideout; David Porter,6,0,36,30
1657906441115,MATH 20A,A01,083754,Zheng; Zequn,14,0,40,26
1657906447141,MATH 20B,A01,083756,Briones; Jor-el Thomas Caparas,4,0,36,32
1657906447141,MATH 20B,A02,083757,Briones; Jor-el Thomas Caparas,1,0,36,35
1657906447141,MATH 20B,A03,093475,Briones; Jor-el Thomas Caparas,2,0,36,34
1657906453171,MATH 20C,A01,083760,Briones; Jor-el Thomas Caparas,1,0,35,34
1657906453171,MATH 20C,A02,083761,Briones; Jor-el Thomas Caparas,8,0,35,27
1657906453171,MATH 20C,A03,093476,Briones; Jor-el Thomas Caparas,0,1,36,36
1657906453171,MATH 20C,B01,083762,Bach; Quang Tran,1,0,30,29
1657906459206,MATH 20D,A01,083765,Tran; Brian Kha,5,0,30,25
1657906459206,MATH 20D,A02,083766,Tran; Brian Kha,5,0,30,25
1657906459206,MATH 20D,A03,083767,Tran; Brian Kha,5,0,30,25
1657906465228,MATH 20E,A01,083771,Ganguly; Soumya,10,0,32,22
1657906465228,MATH 20E,A02,083772,Ganguly; Soumya,6,0,32,26
1657906465228,MATH 20E,B01,083773,Ciotti; Benjamin,20,0,35,15
1657906465228,MATH 20E,B02,083774,Ciotti; Benjamin,18,0,35,17
1657906471252,MATH 103A,A01,083777,Greenfeld; Be'Eri,3,0,36,33
1657906471252,MATH 103A,A02,083778,Greenfeld; Be'Eri,5,0,36,31
1657906471252,MATH 103A,A03,093561,Greenfeld; Be'Eri,6,0,36,30
1657906471252,MATH 103A,B01,083779,Greenfeld; Be'Eri,7,0,36,29
1657906471252,MATH 103A,B02,083780,Greenfeld; Be'Eri,4,0,36,32
1657906471252,MATH 103A,B03,093562,Greenfeld; Be'Eri,3,0,36,33
1657906477281,MATH 105,A01,085443,Carter; Anne Toulson,15,0,35,20
1657906477281,MATH 105,A02,093477,Carter; Anne Toulson,20,0,35,15
1657906483304,MATH 109,A01,083213,Ganzberger; Geoffrey Michael,3,0,34,31
1657906483304,MATH 109,A02,083214,Ganzberger; Geoffrey Michael,4,0,34,30
1657906483304,MATH 109,A03,093478,Ganzberger; Geoffrey Michael,2,0,34,32
1657906483304,MATH 109,B01,083215,Ganzberger; Geoffrey Michael,2,0,32,30
1657906483304,MATH 109,B02,083216,Ganzberger; Geoffrey Michael,2,0,32,30
1657906483304,MATH 109,B03,093479,Ganzberger; Geoffrey Michael,8,0,32,24
1657906489328,MATH 142A,A01,083219,Chow; Bennett,7,0,32,25
1657906489328,MATH 142A,A02,083220,Chow; Bennett,10,0,32,22
1657906489328,MATH 142A,A03,093480,Chow; Bennett,9,0,32,23
1657906489328,MATH 142A,B03,093481,Chow; Bennett,8,0,32,24
1657906489328,MATH 142A,B04,093558,Chow; Bennett,13,0,32,19
1657906489328,MATH 142A,B05,093559,Chow; Bennett,7,0,32,25
1657906495353,MATH 193A,A01,083224,Rotar; Vladimir,8,0,34,26
1657906495353,MATH 193A,A02,083225,Rotar; Vladimir,10,0,34,24
1657906495353,MATH 193A,A03,083781,Rotar; Vladimir,5,0,34,29
1657906495353,MATH 193A,A04,083782,Rotar; Vladimir,11,0,34,23
1657906495353,MATH 193A,A05,093482,Rotar; Vladimir,10,0,34,24
1657906501456,MATH 197,001,091859,McAuley; Julian John,9999,0,9999,0
1657906501456,MATH 197,002,095566,Kedlaya; Kiran S.,9997,0,9999,2
1657906501456,MATH 197,003,095567,Xiao; Ming,9999,0,9999,0
1657906501456,MATH 197,004,095571,Perols; Johan Lars,9998,0,9999,1
1657906508521,COGS 9,A01,083615,Shannon; Kyle Michael,10,0,75,65
1657906514543,COGS 11,A01,083617,Boyle; Mary E. T.,23,0,48,25
1657906520564,COGS 13,A01,083071,Bastos; Amalia Pinkusfeld,11,0,71,60
1657906526595,COGS 14A,A01,092681,Semenuks; Arturs,5,1,100,95
1657906532621,COGS 14B,A01,083073,Cheng; Tzu-Han,6,0,63,57
1657906538642,COGS 17,A01,092677,Semenuks; Arturs,6,0,81,75
1657906544680,COGS 100,A01,083619,Allen; Michael Gordon,17,0,70,53
1657906550702,COGS 101A,A01,083621,Davis; Joshua Daniel,9,0,68,59
1657906556725,COGS 101B,A01,091572,Allen; Michael Gordon,13,0,65,52
1657906562747,COGS 101C,A01,083625,Delgado; Tania,17,0,35,18
1657906568773,COGS 107A,A01,083627,Boyle; Mary E. T.,14,0,60,46
1657906574807,COGS 118A,A01,083075,Gupta; Anjum,21,0,76,55
1657906580842,CSE 3,A50,083646,Miranda; Gregory Joseph,24,0,50,26
1657906586878,CSE 8A,A50,083650,Miranda; Gregory Joseph,17,1,56,39
1657906592900,CSE 11,A01,083080,Cao; Yingjun,6,15,40,34
1657906598923,CSE 12,A01,083652,Krause-Levy; Sophia Louisa,30,1,120,90
1657906604947,CSE 15L,A01,083654,Morris; Justin Loren,9,0,50,41
1657906604947,CSE 15L,A02,083655,Morris; Justin Loren,10,0,50,40
1657906610973,CSE 20,A01,083657,Tran; Khoa Dang,39,0,80,41
1657906617000,CSE 21,A01,095574,Bach; Quang Tran,22,0,48,26
1657906623029,CSE 30,A01,083084,Eldon; John,6,0,80,74
1657906623029,CSE 30,B01,095061,Bhaskar; Nishant,9,0,50,41
1657906629054,CSE 100,A01,083659,Cao; Yingjun,5,4,70,65
1657906635084,CSE 134B,A01,083661,Powell; Thomas Allan,25,0,100,75
1657906641107,CSE 140,A01,083663,Gungor; Onat,15,0,85,70
1657906647130,CSE 140L,A01,083088,Eldon; John,23,0,100,77
1657906653153,CSE 175,A01,083665,Kumar; Rakesh,3,0,25,22
1657906659182,CSE 190,A00,092507,Dubnov; Shlomo,8,0,20,12
1657906665205,ECE 45,A01,083139,Congero; Spencer William,6,0,75,69
1657906671231,ECE 65,A50,083695,Saad; Andrew S,12,0,30,18
1657906671231,ECE 65,A51,095125,Saad; Andrew S,24,0,26,2
1657906677254,ECE 109,A01,091882,Touri; Behrouz,20,0,70,50
1657906683276,ECE 180,A00,083140,Abi Samra; Nicholas Camill,1,0,30,29
1657906683276,ECE 180,B00,083141,Abi Samra; Nicholas Camill,0,0,30,30
1657906689300,MATH 10A,A01,083735,Patchell; Gregory David,2,0,30,28
1657906689300,MATH 10A,A02,083736,Patchell; Gregory David,20,0,30,10
1657906689300,MATH 10A,A03,083737,Patchell; Gregory David,16,0,30,14
1657906695335,MATH 10B,A01,083207,Lim; Seonhee,8,0,34,26
1657906695335,MATH 10B,A02,083208,Lim; Seonhee,10,0,35,25
1657906695335,MATH 10B,A03,093472,Lim; Seonhee,7,0,34,27
1657906695335,MATH 10B,B01,083739,Sinha; Shubham,14,0,30,16
1657906701370,MATH 18,A01,083743,Cinel; Cameron Alexander,9,0,30,21
1657906701370,MATH 18,A02,083744,Cinel; Cameron Alexander,18,0,30,12
1657906701370,MATH 18,A03,083745,Cinel; Cameron Alexander,10,0,30,20
1657906701370,MATH 18,B01,083748,Rideout; David Porter,5,0,37,32
1657906701370,MATH 18,B02,083749,Rideout; David Porter,5,0,36,31
1657906701370,MATH 18,B03,083750,Rideout; David Porter,3,0,37,34
1657906701370,MATH 18,B04,083751,Rideout; David Porter,6,0,36,30
1657906701370,MATH 18,B05,093473,Rideout; David Porter,6,0,36,30
1657906701370,MATH 18,B06,093474,Rideout; David Porter,6,0,36,30
1657906707397,MATH 20A,A01,083754,Zheng; Zequn,14,0,40,26
1657906713419,MATH 20B,A01,083756,Briones; Jor-el Thomas Caparas,4,0,36,32
1657906713419,MATH 20B,A02,083757,Briones; Jor-el Thomas Caparas,1,0,36,35
1657906713419,MATH 20B,A03,093475,Briones; Jor-el Thomas Caparas,2,0,36,34
1657906719445,MATH 20C,A01,083760,Briones; Jor-el Thomas Caparas,1,0,35,34
1657906719445,MATH 20C,A02,083761,Briones; Jor-el Thomas Caparas,8,0,35,27
1657906719445,MATH 20C,A03,093476,Briones; Jor-el Thomas Caparas,0,1,36,36
1657906719445,MATH 20C,B01,083762,Bach; Quang Tran,1,0,30,29
1657906725480,MATH 20D,A01,083765,Tran; Brian Kha,5,0,30,25
1657906725480,MATH 20D,A02,083766,Tran; Brian Kha,5,0,30,25
1657906725480,MATH 20D,A03,083767,Tran; Brian Kha,5,0,30,25
1657906731505,MATH 20E,A01,083771,Ganguly; Soumya,10,0,32,22
1657906731505,MATH 20E,A02,083772,Ganguly; Soumya,6,0,32,26
1657906731505,MATH 20E,B01,083773,Ciotti; Benjamin,20,0,35,15
1657906731505,MATH 20E,B02,083774,Ciotti; Benjamin,18,0,35,17
1657906737538,MATH 103A,A01,083777,Greenfeld; Be'Eri,3,0,36,33
1657906737538,MATH 103A,A02,083778,Greenfeld; Be'Eri,5,0,36,31
1657906737538,MATH 103A,A03,093561,Greenfeld; Be'Eri,6,0,36,30
1657906737538,MATH 103A,B01,083779,Greenfeld; Be'Eri,7,0,36,29
1657906737538,MATH 103A,B02,083780,Greenfeld; Be'Eri,4,0,36,32
1657906737538,MATH 103A,B03,093562,Greenfeld; Be'Eri,3,0,36,33
1657906743561,MATH 105,A01,085443,Carter; Anne Toulson,15,0,35,20
1657906743561,MATH 105,A02,093477,Carter; Anne Toulson,20,0,35,15
1657906749595,MATH 109,A01,083213,Ganzberger; Geoffrey Michael,3,0,34,31
1657906749595,MATH 109,A02,083214,Ganzberger; Geoffrey Michael,4,0,34,30
1657906749595,MATH 109,A03,093478,Ganzberger; Geoffrey Michael,2,0,34,32
1657906749595,MATH 109,B01,083215,Ganzberger; Geoffrey Michael,2,0,32,30
1657906749595,MATH 109,B02,083216,Ganzberger; Geoffrey Michael,2,0,32,30
1657906749595,MATH 109,B03,093479,Ganzberger; Geoffrey Michael,8,0,32,24
1657906755638,MATH 142A,A01,083219,Chow; Bennett,7,0,32,25
1657906755638,MATH 142A,A02,083220,Chow; Bennett,10,0,32,22
1657906755638,MATH 142A,A03,093480,Chow; Bennett,9,0,32,23
1657906755638,MATH 142A,B03,093481,Chow; Bennett,8,0,32,24
1657906755638,MATH 142A,B04,093558,Chow; Bennett,13,0,32,19
1657906755638,MATH 142A,B05,093559,Chow; Bennett,7,0,32,25
1657906761660,MATH 193A,A01,083224,Rotar; Vladimir,8,0,34,26
1657906761660,MATH 193A,A02,083225,Rotar; Vladimir,10,0,34,24
1657906761660,MATH 193A,A03,083781,Rotar; Vladimir,5,0,34,29
1657906761660,MATH 193A,A04,083782,Rotar; Vladimir,11,0,34,23
1657906761660,MATH 193A,A05,093482,Rotar; Vladimir,10,0,34,24
1657906767684,MATH 197,001,091859,McAuley; Julian John,9999,0,9999,0
1657906767684,MATH 197,002,095566,Kedlaya; Kiran S.,9997,0,9999,2
1657906767684,MATH 197,003,095567,Xiao; Ming,9999,0,9999,0
1657906767684,MATH 197,004,095571,Perols; Johan Lars,9998,0,9999,1
1657906774740,COGS 9,A01,083615,Shannon; Kyle Michael,10,0,75,65
1657906780765,COGS 11,A01,083617,Boyle; Mary E. T.,23,0,48,25
1657906786788,COGS 13,A01,083071,Bastos; Amalia Pinkusfeld,11,0,71,60
1657906792821,COGS 14A,A01,092681,Semenuks; Arturs,5,1,100,95
1657906798849,COGS 14B,A01,083073,Cheng; Tzu-Han,6,0,63,57
1657906804882,COGS 17,A01,092677,Semenuks; Arturs,6,0,81,75
1657906810910,COGS 100,A01,083619,Allen; Michael Gordon,17,0,70,53
1657906816937,COGS 101A,A01,083621,Davis; Joshua Daniel,9,0,68,59
1657906822960,COGS 101B,A01,091572,Allen; Michael Gordon,13,0,65,52
1657906828987,COGS 101C,A01,083625,Delgado; Tania,17,0,35,18
1657906835019,COGS 107A,A01,083627,Boyle; Mary E. T.,14,0,60,46
1657906841044,COGS 118A,A01,083075,Gupta; Anjum,21,0,76,55
1657906847069,CSE 3,A50,083646,Miranda; Gregory Joseph,24,0,50,26
1657906853093,CSE 8A,A50,083650,Miranda; Gregory Joseph,17,1,56,39
1657906859117,CSE 11,A01,083080,Cao; Yingjun,6,15,40,34
1657906865145,CSE 12,A01,083652,Krause-Levy; Sophia Louisa,30,1,120,90
1657906871182,CSE 15L,A01,083654,Morris; Justin Loren,9,0,50,41
1657906871182,CSE 15L,A02,083655,Morris; Justin Loren,10,0,50,40
1657906877204,CSE 20,A01,083657,Tran; Khoa Dang,39,0,80,41
1657906883228,CSE 21,A01,095574,Bach; Quang Tran,22,0,48,26
1657906889252,CSE 30,A01,083084,Eldon; John,6,0,80,74
1657906889252,CSE 30,B01,095061,Bhaskar; Nishant,9,0,50,41
1657906895275,CSE 100,A01,083659,Cao; Yingjun,5,4,70,65
1657906901302,CSE 134B,A01,083661,Powell; Thomas Allan,25,0,100,75
1657906907328,CSE 140,A01,083663,Gungor; Onat,15,0,85,70
1657906913356,CSE 140L,A01,083088,Eldon; John,23,0,100,77
1657906919379,CSE 175,A01,083665,Kumar; Rakesh,3,0,25,22
1657906925400,CSE 190,A00,092507,Dubnov; Shlomo,8,0,20,12
1657906931424,ECE 45,A01,083139,Congero; Spencer William,6,0,75,69
1657906937447,ECE 65,A50,083695,Saad; Andrew S,12,0,30,18
1657906937447,ECE 65,A51,095125,Saad; Andrew S,24,0,26,2
1657906943479,ECE 109,A01,091882,Touri; Behrouz,20,0,70,50
1657906949506,ECE 180,A00,083140,Abi Samra; Nicholas Camill,1,0,30,29
1657906949506,ECE 180,B00,083141,Abi Samra; Nicholas Camill,0,0,30,30
1657906955535,MATH 10A,A01,083735,Patchell; Gregory David,2,0,30,28
1657906955535,MATH 10A,A02,083736,Patchell; Gregory David,20,0,30,10
1657906955535,MATH 10A,A03,083737,Patchell; Gregory David,16,0,30,14
1657906961563,MATH 10B,A01,083207,Lim; Seonhee,8,0,34,26
1657906961563,MATH 10B,A02,083208,Lim; Seonhee,10,0,35,25
1657906961563,MATH 10B,A03,093472,Lim; Seonhee,7,0,34,27
1657906961563,MATH 10B,B01,083739,Sinha; Shubham,14,0,30,16
1657906967596,MATH 18,A01,083743,Cinel; Cameron Alexander,9,0,30,21
1657906967596,MATH 18,A02,083744,Cinel; Cameron Alexander,18,0,30,12
1657906967596,MATH 18,A03,083745,Cinel; Cameron Alexander,10,0,30,20
1657906967596,MATH 18,B01,083748,Rideout; David Porter,5,0,37,32
1657906967596,MATH 18,B02,083749,Rideout; David Porter,5,0,36,31
1657906967596,MATH 18,B03,083750,Rideout; David Porter,3,0,37,34
1657906967596,MATH 18,B04,083751,Rideout; David Porter,6,0,36,30
1657906967596,MATH 18,B05,093473,Rideout; David Porter,6,0,36,30
1657906967596,MATH 18,B06,093474,Rideout; David Porter,6,0,36,30
1657906973624,MATH 20A,A01,083754,Zheng; Zequn,14,0,40,26
1657906979651,MATH 20B,A01,083756,Briones; Jor-el Thomas Caparas,4,0,36,32
1657906979651,MATH 20B,A02,083757,Briones; Jor-el Thomas Caparas,1,0,36,35
1657906979651,MATH 20B,A03,093475,Briones; Jor-el Thomas Caparas,2,0,36,34
1657906985674,MATH 20C,A01,083760,Briones; Jor-el Thomas Caparas,1,0,35,34
1657906985674,MATH 20C,A02,083761,Briones; Jor-el Thomas Caparas,8,0,35,27
1657906985674,MATH 20C,A03,093476,Briones; Jor-el Thomas Caparas,0,1,36,36
1657906985674,MATH 20C,B01,083762,Bach; Quang Tran,1,0,30,29
1657906991705,MATH 20D,A01,083765,Tran; Brian Kha,5,0,30,25
1657906991705,MATH 20D,A02,083766,Tran; Brian Kha,5,0,30,25
1657906991705,MATH 20D,A03,083767,Tran; Brian Kha,5,0,30,25
1657906997727,MATH 20E,A01,083771,Ganguly; Soumya,10,0,32,22
1657906997727,MATH 20E,A02,083772,Ganguly; Soumya,6,0,32,26
1657906997727,MATH 20E,B01,083773,Ciotti; Benjamin,20,0,35,15
1657906997727,MATH 20E,B02,083774,Ciotti; Benjamin,18,0,35,17
1657907003756,MATH 103A,A01,083777,Greenfeld; Be'Eri,3,0,36,33
1657907003756,MATH 103A,A02,083778,Greenfeld; Be'Eri,5,0,36,31
1657907003756,MATH 103A,A03,093561,Greenfeld; Be'Eri,6,0,36,30
1657907003756,MATH 103A,B01,083779,Greenfeld; Be'Eri,7,0,36,29
1657907003756,MATH 103A,B02,083780,Greenfeld; Be'Eri,4,0,36,32
1657907003756,MATH 103A,B03,093562,Greenfeld; Be'Eri,3,0,36,33
1657907009789,MATH 105,A01,085443,Carter; Anne Toulson,15,0,35,20
1657907009789,MATH 105,A02,093477,Carter; Anne Toulson,20,0,35,15
1657907015819,MATH 109,A01,083213,Ganzberger; Geoffrey Michael,3,0,34,31
1657907015819,MATH 109,A02,083214,Ganzberger; Geoffrey Michael,4,0,34,30
1657907015819,MATH 109,A03,093478,Ganzberger; Geoffrey Michael,2,0,34,32
1657907015819,MATH 109,B01,083215,Ganzberger; Geoffrey Michael,2,0,32,30
1657907015819,MATH 109,B02,083216,Ganzberger; Geoffrey Michael,2,0,32,30
1657907015819,MATH 109,B03,093479,Ganzberger; Geoffrey Michael,8,0,32,24
1657907021844,MATH 142A,A01,083219,Chow; Bennett,7,0,32,25
1657907021844,MATH 142A,A02,083220,Chow; Bennett,10,0,32,22
1657907021844,MATH 142A,A03,093480,Chow; Bennett,9,0,32,23
1657907021844,MATH 142A,B03,093481,Chow; Bennett,8,0,32,24
1657907021844,MATH 142A,B04,093558,Chow; Bennett,13,0,32,19
1657907021844,MATH 142A,B05,093559,Chow; Bennett,7,0,32,25
1657907027868,MATH 193A,A01,083224,Rotar; Vladimir,8,0,34,26
1657907027868,MATH 193A,A02,083225,Rotar; Vladimir,10,0,34,24
1657907027868,MATH 193A,A03,083781,Rotar; Vladimir,5,0,34,29
1657907027868,MATH 193A,A04,083782,Rotar; Vladimir,11,0,34,23
1657907027868,MATH 193A,A05,093482,Rotar; Vladimir,10,0,34,24
1657907033890,MATH 197,001,091859,McAuley; Julian John,9999,0,9999,0
1657907033890,MATH 197,002,095566,Kedlaya; Kiran S.,9997,0,9999,2
1657907033890,MATH 197,003,095567,Xiao; Ming,9999,0,9999,0
1657907033890,MATH 197,004,095571,Perols; Johan Lars,9998,0,9999,1
1657907040943,COGS 9,A01,083615,Shannon; Kyle Michael,10,0,75,65
1657907046968,COGS 11,A01,083617,Boyle; Mary E. T.,23,0,48,25
1657907052991,COGS 13,A01,083071,Bastos; Amalia Pinkusfeld,11,0,71,60
1657907059013,COGS 14A,A01,092681,Semenuks; Arturs,5,1,100,95
1657907065039,COGS 14B,A01,083073,Cheng; Tzu-Han,6,0,63,57
1657907071065,COGS 17,A01,092677,Semenuks; Arturs,6,0,81,75
1657907077105,COGS 100,A01,083619,Allen; Michael Gordon,17,0,70,53
1657907083128,COGS 101A,A01,083621,Davis; Joshua Daniel,9,0,68,59
1657907089151,COGS 101B,A01,091572,Allen; Michael Gordon,13,0,65,52
1657907095254,COGS 101C,A01,083625,Delgado; Tania,17,0,35,18
1657907101277,COGS 107A,A01,083627,Boyle; Mary E. T.,14,0,60,46
1657907107303,COGS 118A,A01,083075,Gupta; Anjum,21,0,76,55
1657907113331,CSE 3,A50,083646,Miranda; Gregory Joseph,24,0,50,26
1657907119354,CSE 8A,A50,083650,Miranda; Gregory Joseph,17,1,56,39
1657907125382,CSE 11,A01,083080,Cao; Yingjun,6,15,40,34
1657907131406,CSE 12,A01,083652,Krause-Levy; Sophia Louisa,30,1,120,90
1657907137438,CSE 15L,A01,083654,Morris; Justin Loren,9,0,50,41
1657907137438,CSE 15L,A02,083655,Morris; Justin Loren,10,0,50,40
1657907143461,CSE 20,A01,083657,Tran; Khoa Dang,39,0,80,41
1657907149484,CSE 21,A01,095574,Bach; Quang Tran,22,0,48,26
1657907155527,CSE 30,A01,083084,Eldon; John,6,0,80,74
1657907155527,CSE 30,B01,095061,Bhaskar; Nishant,9,0,50,41
1657907161549,CSE 100,A01,083659,Cao; Yingjun,5,4,70,65
1657907167579,CSE 134B,A01,083661,Powell; Thomas Allan,25,0,100,75
1657907173603,CSE 140,A01,083663,Gungor; Onat,15,0,85,70
1657907179627,CSE 140L,A01,083088,Eldon; John,23,0,100,77
1657907185648,CSE 175,A01,083665,Kumar; Rakesh,3,0,25,22
1657907191673,CSE 190,A00,092507,Dubnov; Shlomo,8,0,20,12
1657907197694,ECE 45,A01,083139,Congero; Spencer William,6,0,75,69
1657907203718,ECE 65,A50,083695,Saad; Andrew S,12,0,30,18
1657907203718,ECE 65,A51,095125,Saad; Andrew S,24,0,26,2
1657907209740,ECE 109,A01,091882,Touri; Behrouz,20,0,70,50
1657907215762,ECE 180,A00,083140,Abi Samra; Nicholas Camill,1,0,30,29
1657907215762,ECE 180,B00,083141,Abi Samra; Nicholas Camill,0,0,30,30
1657907221784,MATH 10A,A01,083735,Patchell; Gregory David,2,0,30,28
1657907221784,MATH 10A,A02,083736,Patchell; Gregory David,20,0,30,10
1657907221784,MATH 10A,A03,083737,Patchell; Gregory David,16,0,30,14
1657907227812,MATH 10B,A01,083207,Lim; Seonhee,8,0,34,26
1657907227812,MATH 10B,A02,083208,Lim; Seonhee,10,0,35,25
1657907227812,MATH 10B,A03,093472,Lim; Seonhee,7,0,34,27
1657907227812,MATH 10B,B01,083739,Sinha; Shubham,14,0,30,16
1657907233841,MATH 18,A01,083743,Cinel; Cameron Alexander,9,0,30,21
1657907233841,MATH 18,A02,083744,Cinel; Cameron Alexander,18,0,30,12
1657907233841,MATH 18,A03,083745,Cinel; Cameron Alexander,10,0,30,20
1657907233841,MATH 18,B01,083748,Rideout; David Porter,5,0,37,32
1657907233841,MATH 18,B02,083749,Rideout; David Porter,5,0,36,31
1657907233841,MATH 18,B03,083750,Rideout; David Porter,3,0,37,34
1657907233841,MATH 18,B04,083751,Rideout; David Porter,6,0,36,30
1657907233841,MATH 18,B05,093473,Rideout; David Porter,6,0,36,30
1657907233841,MATH 18,B06,093474,Rideout; David Porter,6,0,36,30
1657907239864,MATH 20A,A01,083754,Zheng; Zequn,14,0,40,26
1657907245896,MATH 20B,A01,083756,Briones; Jor-el Thomas Caparas,4,0,36,32
1657907245896,MATH 20B,A02,083757,Briones; Jor-el Thomas Caparas,1,0,36,35
1657907245896,MATH 20B,A03,093475,Briones; Jor-el Thomas Caparas,2,0,36,34
1657907251931,MATH 20C,A01,083760,Briones; Jor-el Thomas Caparas,1,0,35,34
1657907251931,MATH 20C,A02,083761,Briones; Jor-el Thomas Caparas,8,0,35,27
1657907251931,MATH 20C,A03,093476,Briones; Jor-el Thomas Caparas,0,1,36,36
1657907251931,MATH 20C,B01,083762,Bach; Quang Tran,1,0,30,29
1657907257954,MATH 20D,A01,083765,Tran; Brian Kha,5,0,30,25
1657907257954,MATH 20D,A02,083766,Tran; Brian Kha,5,0,30,25
1657907257954,MATH 20D,A03,083767,Tran; Brian Kha,5,0,30,25
1657907263977,MATH 20E,A01,083771,Ganguly; Soumya,10,0,32,22
1657907263977,MATH 20E,A02,083772,Ganguly; Soumya,6,0,32,26
1657907263977,MATH 20E,B01,083773,Ciotti; Benjamin,20,0,35,15
1657907263977,MATH 20E,B02,083774,Ciotti; Benjamin,18,0,35,17
1657907270007,MATH 103A,A01,083777,Greenfeld; Be'Eri,3,0,36,33
1657907270007,MATH 103A,A02,083778,Greenfeld; Be'Eri,5,0,36,31
1657907270007,MATH 103A,A03,093561,Greenfeld; Be'Eri,6,0,36,30
1657907270007,MATH 103A,B01,083779,Greenfeld; Be'Eri,7,0,36,29
1657907270007,MATH 103A,B02,083780,Greenfeld; Be'Eri,4,0,36,32
1657907270007,MATH 103A,B03,093562,Greenfeld; Be'Eri,3,0,36,33
1657907276030,MATH 105,A01,085443,Carter; Anne Toulson,15,0,35,20
1657907276030,MATH 105,A02,093477,Carter; Anne Toulson,20,0,35,15
1657907282060,MATH 109,A01,083213,Ganzberger; Geoffrey Michael,3,0,34,31
1657907282060,MATH 109,A02,083214,Ganzberger; Geoffrey Michael,4,0,34,30
1657907282060,MATH 109,A03,093478,Ganzberger; Geoffrey Michael,2,0,34,32
1657907282060,MATH 109,B01,083215,Ganzberger; Geoffrey Michael,2,0,32,30
1657907282060,MATH 109,B02,083216,Ganzberger; Geoffrey Michael,2,0,32,30
1657907282060,MATH 109,B03,093479,Ganzberger; Geoffrey Michael,8,0,32,24
1657907288094,MATH 142A,A01,083219,Chow; Bennett,7,0,32,25
1657907288094,MATH 142A,A02,083220,Chow; Bennett,10,0,32,22
1657907288094,MATH 142A,A03,093480,Chow; Bennett,9,0,32,23
1657907288094,MATH 142A,B03,093481,Chow; Bennett,8,0,32,24
1657907288094,MATH 142A,B04,093558,Chow; Bennett,13,0,32,19
1657907288094,MATH 142A,B05,093559,Chow; Bennett,7,0,32,25
1657907294119,MATH 193A,A01,083224,Rotar; Vladimir,8,0,34,26
1657907294119,MATH 193A,A02,083225,Rotar; Vladimir,10,0,34,24
1657907294119,MATH 193A,A03,083781,Rotar; Vladimir,5,0,34,29
1657907294119,MATH 193A,A04,083782,Rotar; Vladimir,11,0,34,23
1657907294119,MATH 193A,A05,093482,Rotar; Vladimir,10,0,34,24
1657907300144,MATH 197,001,091859,McAuley; Julian John,9999,0,9999,0
1657907300144,MATH 197,002,095566,Kedlaya; Kiran S.,9997,0,9999,2
1657907300144,MATH 197,003,095567,Xiao; Ming,9999,0,9999,0
1657907300144,MATH 197,004,095571,Perols; Johan Lars,9998,0,9999,1
1657907307201,COGS 9,A01,083615,Shannon; Kyle Michael,10,0,75,65
1657907313228,COGS 11,A01,083617,Boyle; Mary E. T.,23,0,48,25
1657907319262,COGS 13,A01,083071,Bastos; Amalia Pinkusfeld,11,0,71,60
1657907325288,COGS 14A,A01,092681,Semenuks; Arturs,5,1,100,95
1657907331309,COGS 14B,A01,083073,Cheng; Tzu-Han,6,0,63,57
1657907337332,COGS 17,A01,092677,Semenuks; Arturs,6,0,81,75
1657907343364,COGS 100,A01,083619,Allen; Michael Gordon,17,0,70,53
1657907349391,COGS 101A,A01,083621,Davis; Joshua Daniel,9,0,68,59
1657907355413,COGS 101B,A01,091572,Allen; Michael Gordon,13,0,65,52
1657907361439,COGS 101C,A01,083625,Delgado; Tania,17,0,35,18
1657907367460,COGS 107A,A01,083627,Boyle; Mary E. T.,14,0,60,46
1657907373486,COGS 118A,A01,083075,Gupta; Anjum,21,0,76,55
1657907379519,CSE 3,A50,083646,Miranda; Gregory Joseph,24,0,50,26
1657907385542,CSE 8A,A50,083650,Miranda; Gregory Joseph,17,1,56,39
1657907391567,CSE 11,A01,083080,Cao; Yingjun,6,15,40,34
1657907397593,CSE 12,A01,083652,Krause-Levy; Sophia Louisa,30,1,120,90
1657907403616,CSE 15L,A01,083654,Morris; Justin Loren,9,0,50,41
1657907403616,CSE 15L,A02,083655,Morris; Justin Loren,10,0,50,40
1657907409640,CSE 20,A01,083657,Tran; Khoa Dang,39,0,80,41
1657907415672,CSE 21,A01,095574,Bach; Quang Tran,22,0,48,26
1657907421697,CSE 30,A01,083084,Eldon; John,6,0,80,74
1657907421697,CSE 30,B01,095061,Bhaskar; Nishant,9,0,50,41
1657907427720,CSE 100,A01,083659,Cao; Yingjun,5,4,70,65
1657907433748,CSE 134B,A01,083661,Powell; Thomas Allan,25,0,100,75
1657907439771,CSE 140,A01,083663,Gungor; Onat,15,0,85,70
1657907445798,CSE 140L,A01,083088,Eldon; John,23,0,100,77
1657907451834,CSE 175,A01,083665,Kumar; Rakesh,3,0,25,22
1657907457857,CSE 190,A00,092507,Dubnov; Shlomo,8,0,20,12
1657907463885,ECE 45,A01,083139,Congero; Spencer William,6,0,75,69
1657907469909,ECE 65,A50,083695,Saad; Andrew S,12,0,30,18
1657907469909,ECE 65,A51,095125,Saad; Andrew S,24,0,26,2
1657907475931,ECE 109,A01,091882,Touri; Behrouz,20,0,70,50
1657907481953,ECE 180,A00,083140,Abi Samra; Nicholas Camill,1,0,30,29
1657907481953,ECE 180,B00,083141,Abi Samra; Nicholas Camill,0,0,30,30
1657907487979,MATH 10A,A01,083735,Patchell; Gregory David,2,0,30,28
1657907487979,MATH 10A,A02,083736,Patchell; Gregory David,20,0,30,10
1657907487979,MATH 10A,A03,083737,Patchell; Gregory David,16,0,30,14
1657907494008,MATH 10B,A01,083207,Lim; Seonhee,8,0,34,26
1657907494008,MATH 10B,A02,083208,Lim; Seonhee,10,0,35,25
1657907494008,MATH 10B,A03,093472,Lim; Seonhee,7,0,34,27
1657907494008,MATH 10B,B01,083739,Sinha; Shubham,14,0,30,16
1657907500035,MATH 18,A01,083743,Cinel; Cameron Alexander,9,0,30,21
1657907500035,MATH 18,A02,083744,Cinel; Cameron Alexander,18,0,30,12
1657907500035,MATH 18,A03,083745,Cinel; Cameron Alexander,10,0,30,20
1657907500035,MATH 18,B01,083748,Rideout; David Porter,5,0,37,32
1657907500035,MATH 18,B02,083749,Rideout; David Porter,5,0,36,31
1657907500035,MATH 18,B03,083750,Rideout; David Porter,3,0,37,34
1657907500035,MATH 18,B04,083751,Rideout; David Porter,6,0,36,30
1657907500035,MATH 18,B05,093473,Rideout; David Porter,7,0,36,29
1657907500035,MATH 18,B06,093474,Rideout; David Porter,6,0,36,30
1657907506061,MATH 20A,A01,083754,Zheng; Zequn,14,0,40,26
1657907512087,MATH 20B,A01,083756,Briones; Jor-el Thomas Caparas,4,0,36,32
1657907512087,MATH 20B,A02,083757,Briones; Jor-el Thomas Caparas,1,0,36,35
1657907512087,MATH 20B,A03,093475,Briones; Jor-el Thomas Caparas,2,0,36,34
1657907518111,MATH 20C,A01,083760,Briones; Jor-el Thomas Caparas,1,0,35,34
1657907518111,MATH 20C,A02,083761,Briones; Jor-el Thomas Caparas,8,0,35,27
1657907518111,MATH 20C,A03,093476,Briones; Jor-el Thomas Caparas,0,1,36,36
1657907518111,MATH 20C,B01,083762,Bach; Quang Tran,1,0,30,29
1657907524141,MATH 20D,A01,083765,Tran; Brian Kha,5,0,30,25
1657907524141,MATH 20D,A02,083766,Tran; Brian Kha,5,0,30,25
1657907524141,MATH 20D,A03,083767,Tran; Brian Kha,5,0,30,25
1657907530164,MATH 20E,A01,083771,Ganguly; Soumya,10,0,32,22
1657907530164,MATH 20E,A02,083772,Ganguly; Soumya,6,0,32,26
1657907530164,MATH 20E,B01,083773,Ciotti; Benjamin,20,0,35,15
1657907530164,MATH 20E,B02,083774,Ciotti; Benjamin,18,0,35,17
1657907536188,MATH 103A,A01,083777,Greenfeld; Be'Eri,3,0,36,33
1657907536188,MATH 103A,A02,083778,Greenfeld; Be'Eri,5,0,36,31
1657907536188,MATH 103A,A03,093561,Greenfeld; Be'Eri,6,0,36,30
1657907536188,MATH 103A,B01,083779,Greenfeld; Be'Eri,7,0,36,29
1657907536188,MATH 103A,B02,083780,Greenfeld; Be'Eri,4,0,36,32
1657907536188,MATH 103A,B03,093562,Greenfeld; Be'Eri,3,0,36,33
1657907542215,MATH 105,A01,085443,Carter; Anne Toulson,15,0,35,20
1657907542215,MATH 105,A02,093477,Carter; Anne Toulson,20,0,35,15
1657907548252,MATH 109,A01,083213,Ganzberger; Geoffrey Michael,3,0,34,31
1657907548252,MATH 109,A02,083214,Ganzberger; Geoffrey Michael,4,0,34,30
1657907548252,MATH 109,A03,093478,Ganzberger; Geoffrey Michael,2,0,34,32
1657907548252,MATH 109,B01,083215,Ganzberger; Geoffrey Michael,2,0,32,30
1657907548252,MATH 109,B02,083216,Ganzberger; Geoffrey Michael,2,0,32,30
1657907548252,MATH 109,B03,093479,Ganzberger; Geoffrey Michael,8,0,32,24
1657907554277,MATH 142A,A01,083219,Chow; Bennett,7,0,32,25
1657907554277,MATH 142A,A02,083220,Chow; Bennett,10,0,32,22
1657907554277,MATH 142A,A03,093480,Chow; Bennett,9,0,32,23
1657907554277,MATH 142A,B03,093481,Chow; Bennett,8,0,32,24
1657907554277,MATH 142A,B04,093558,Chow; Bennett,13,0,32,19
1657907554277,MATH 142A,B05,093559,Chow; Bennett,7,0,32,25
1657907560311,MATH 193A,A01,083224,Rotar; Vladimir,8,0,34,26
1657907560311,MATH 193A,A02,083225,Rotar; Vladimir,10,0,34,24
1657907560311,MATH 193A,A03,083781,Rotar; Vladimir,5,0,34,29
1657907560311,MATH 193A,A04,083782,Rotar; Vladimir,11,0,34,23
1657907560311,MATH 193A,A05,093482,Rotar; Vladimir,10,0,34,24
1657907566348,MATH 197,001,091859,McAuley; Julian John,9999,0,9999,0
1657907566348,MATH 197,002,095566,Kedlaya; Kiran S.,9997,0,9999,2
1657907566348,MATH 197,003,095567,Xiao; Ming,9999,0,9999,0
1657907566348,MATH 197,004,095571,Perols; Johan Lars,9998,0,9999,1
1657907573400,COGS 9,A01,083615,Shannon; Kyle Michael,10,0,75,65
1657907579433,COGS 11,A01,083617,Boyle; Mary E. T.,23,0,48,25
1657907585456,COGS 13,A01,083071,Bastos; Amalia Pinkusfeld,11,0,71,60
1657907591480,COGS 14A,A01,092681,Semenuks; Arturs,5,1,100,95
1657907597511,COGS 14B,A01,083073,Cheng; Tzu-Han,6,0,63,57
1657907603554,COGS 17,A01,092677,Semenuks; Arturs,6,0,81,75
1657907609576,COGS 100,A01,083619,Allen; Michael Gordon,17,0,70,53
1657907615598,COGS 101A,A01,083621,Davis; Joshua Daniel,9,0,68,59
1657907621624,COGS 101B,A01,091572,Allen; Michael Gordon,13,0,65,52
1657907627662,COGS 101C,A01,083625,Delgado; Tania,17,0,35,18
1657907633688,COGS 107A,A01,083627,Boyle; Mary E. T.,14,0,60,46
1657907639722,COGS 118A,A01,083075,Gupta; Anjum,21,0,76,55
1657907645764,CSE 3,A50,083646,Miranda; Gregory Joseph,24,0,50,26
1657907651794,CSE 8A,A50,083650,Miranda; Gregory Joseph,17,1,56,39
1657907657824,CSE 11,A01,083080,Cao; Yingjun,6,15,40,34
1657907663846,CSE 12,A01,083652,Krause-Levy; Sophia Louisa,30,1,120,90
1657907669870,CSE 15L,A01,083654,Morris; Justin Loren,9,0,50,41
1657907669870,CSE 15L,A02,083655,Morris; Justin Loren,10,0,50,40
1657907675898,CSE 20,A01,083657,Tran; Khoa Dang,39,0,80,41
1657907681939,CSE 21,A01,095574,Bach; Quang Tran,22,0,48,26
1657907687963,CSE 30,A01,083084,Eldon; John,6,0,80,74
1657907687963,CSE 30,B01,095061,Bhaskar; Nishant,9,0,50,41
1657907694058,CSE 100,A01,083659,Cao; Yingjun,5,4,70,65
1657907700080,CSE 134B,A01,083661,Powell; Thomas Allan,25,0,100,75
1657907706111,CSE 140,A01,083663,Gungor; Onat,15,0,85,70
1657907712134,CSE 140L,A01,083088,Eldon; John,23,0,100,77
1657907718160,CSE 175,A01,083665,Kumar; Rakesh,3,0,25,22
1657907724185,CSE 190,A00,092507,Dubnov; Shlomo,8,0,20,12
1657907730219,ECE 45,A01,083139,Congero; Spencer William,6,0,75,69
1657907736243,ECE 65,A50,083695,Saad; Andrew S,12,0,30,18
1657907736243,ECE 65,A51,095125,Saad; Andrew S,24,0,26,2
1657907742270,ECE 109,A01,091882,Touri; Behrouz,20,0,70,50
1657907748294,ECE 180,A00,083140,Abi Samra; Nicholas Camill,1,0,30,29
1657907748294,ECE 180,B00,083141,Abi Samra; Nicholas Camill,0,0,30,30
1657907754321,MATH 10A,A01,083735,Patchell; Gregory David,2,0,30,28
1657907754321,MATH 10A,A02,083736,Patchell; Gregory David,20,0,30,10
1657907754321,MATH 10A,A03,083737,Patchell; Gregory David,16,0,30,14
1657907760352,MATH 10B,A01,083207,Lim; Seonhee,8,0,34,26
1657907760352,MATH 10B,A02,083208,Lim; Seonhee,10,0,35,25
1657907760352,MATH 10B,A03,093472,Lim; Seonhee,7,0,34,27
1657907760352,MATH 10B,B01,083739,Sinha; Shubham,14,0,30,16
1657907766376,MATH 18,A01,083743,Cinel; Cameron Alexander,9,0,30,21
1657907766376,MATH 18,A02,083744,Cinel; Cameron Alexander,18,0,30,12
1657907766376,MATH 18,A03,083745,Cinel; Cameron Alexander,10,0,30,20
1657907766376,MATH 18,B01,083748,Rideout; David Porter,5,0,37,32
1657907766376,MATH 18,B02,083749,Rideout; David Porter,5,0,36,31
1657907766376,MATH 18,B03,083750,Rideout; David Porter,3,0,37,34
1657907766376,MATH 18,B04,083751,Rideout; David Porter,6,0,36,30
1657907766376,MATH 18,B05,093473,Rideout; David Porter,7,0,36,29
1657907766376,MATH 18,B06,093474,Rideout; David Porter,6,0,36,30
1657907772404,MATH 20A,A01,083754,Zheng; Zequn,14,0,40,26
1657907778428,MATH 20B,A01,083756,Briones; Jor-el Thomas Caparas,4,0,36,32
1657907778428,MATH 20B,A02,083757,Briones; Jor-el Thomas Caparas,1,0,36,35
1657907778428,MATH 20B,A03,093475,Briones; Jor-el Thomas Caparas,2,0,36,34
1657907784451,MATH 20C,A01,083760,Briones; Jor-el Thomas Caparas,1,0,35,34
1657907784451,MATH 20C,A02,083761,Briones; Jor-el Thomas Caparas,8,0,35,27
1657907784451,MATH 20C,A03,093476,Briones; Jor-el Thomas Caparas,0,1,36,36
1657907784451,MATH 20C,B01,083762,Bach; Quang Tran,1,0,30,29
1657907790475,MATH 20D,A01,083765,Tran; Brian Kha,5,0,30,25
1657907790475,MATH 20D,A02,083766,Tran; Brian Kha,5,0,30,25
1657907790475,MATH 20D,A03,083767,Tran; Brian Kha,5,0,30,25
1657907796503,MATH 20E,A01,083771,Ganguly; Soumya,10,0,32,22
1657907796503,MATH 20E,A02,083772,Ganguly; Soumya,6,0,32,26
1657907796503,MATH 20E,B01,083773,Ciotti; Benjamin,20,0,35,15
1657907796503,MATH 20E,B02,083774,Ciotti; Benjamin,18,0,35,17
1657907802530,MATH 103A,A01,083777,Greenfeld; Be'Eri,3,0,36,33
1657907802530,MATH 103A,A02,083778,Greenfeld; Be'Eri,5,0,36,31
1657907802530,MATH 103A,A03,093561,Greenfeld; Be'Eri,6,0,36,30
1657907802530,MATH 103A,B01,083779,Greenfeld; Be'Eri,7,0,36,29
1657907802530,MATH 103A,B02,083780,Greenfeld; Be'Eri,4,0,36,32
1657907802530,MATH 103A,B03,093562,Greenfeld; Be'Eri,3,0,36,33
1657907808555,MATH 105,A01,085443,Carter; Anne Toulson,15,0,35,20
1657907808555,MATH 105,A02,093477,Carter; Anne Toulson,20,0,35,15
1657907814582,MATH 109,A01,083213,Ganzberger; Geoffrey Michael,3,0,34,31
1657907814582,MATH 109,A02,083214,Ganzberger; Geoffrey Michael,4,0,34,30
1657907814582,MATH 109,A03,093478,Ganzberger; Geoffrey Michael,2,0,34,32
1657907814582,MATH 109,B01,083215,Ganzberger; Geoffrey Michael,2,0,32,30
1657907814582,MATH 109,B02,083216,Ganzberger; Geoffrey Michael,2,0,32,30
1657907814582,MATH 109,B03,093479,Ganzberger; Geoffrey Michael,8,0,32,24
1657907820610,MATH 142A,A01,083219,Chow; Bennett,7,0,32,25
1657907820610,MATH 142A,A02,083220,Chow; Bennett,10,0,32,22
1657907820610,MATH 142A,A03,093480,Chow; Bennett,9,0,32,23
1657907820610,MATH 142A,B03,093481,Chow; Bennett,8,0,32,24
1657907820610,MATH 142A,B04,093558,Chow; Bennett,13,0,32,19
1657907820610,MATH 142A,B05,093559,Chow; Bennett,7,0,32,25
1657907826632,MATH 193A,A01,083224,Rotar; Vladimir,8,0,34,26
1657907826632,MATH 193A,A02,083225,Rotar; Vladimir,10,0,34,24
1657907826632,MATH 193A,A03,083781,Rotar; Vladimir,5,0,34,29
1657907826632,MATH 193A,A04,083782,Rotar; Vladimir,11,0,34,23
1657907826632,MATH 193A,A05,093482,Rotar; Vladimir,10,0,34,24
1657907832663,MATH 197,001,091859,McAuley; Julian John,9999,0,9999,0
1657907832663,MATH 197,002,095566,Kedlaya; Kiran S.,9997,0,9999,2
1657907832663,MATH 197,003,095567,Xiao; Ming,9999,0,9999,0
1657907832663,MATH 197,004,095571,Perols; Johan Lars,9998,0,9999,1
1657907839713,COGS 9,A01,083615,Shannon; Kyle Michael,10,0,75,65
1657907845735,COGS 11,A01,083617,Boyle; Mary E. T.,23,0,48,25
1657907851763,COGS 13,A01,083071,Bastos; Amalia Pinkusfeld,11,0,71,60
1657907857788,COGS 14A,A01,092681,Semenuks; Arturs,5,1,100,95
1657907863818,COGS 14B,A01,083073,Cheng; Tzu-Han,6,0,63,57
1657907869845,COGS 17,A01,092677,Semenuks; Arturs,6,0,81,75
1657907875869,COGS 100,A01,083619,Allen; Michael Gordon,17,0,70,53
1657907881892,COGS 101A,A01,083621,Davis; Joshua Daniel,9,0,68,59
1657907887918,COGS 101B,A01,091572,Allen; Michael Gordon,13,0,65,52
1657907893944,COGS 101C,A01,083625,Delgado; Tania,17,0,35,18
1657907899966,COGS 107A,A01,083627,Boyle; Mary E. T.,14,0,60,46
1657907905991,COGS 118A,A01,083075,Gupta; Anjum,21,0,76,55
1657907912017,CSE 3,A50,083646,Miranda; Gregory Joseph,24,0,50,26
1657907918039,CSE 8A,A50,083650,Miranda; Gregory Joseph,17,1,56,39
1657907924065,CSE 11,A01,083080,Cao; Yingjun,6,15,40,34
1657907930087,CSE 12,A01,083652,Krause-Levy; Sophia Louisa,30,1,120,90
1657907936111,CSE 15L,A01,083654,Morris; Justin Loren,9,0,50,41
1657907936111,CSE 15L,A02,083655,Morris; Justin Loren,10,0,50,40
1657907942138,CSE 20,A01,083657,Tran; Khoa Dang,39,0,80,41
1657907948161,CSE 21,A01,095574,Bach; Quang Tran,22,0,48,26
1657907954182,CSE 30,A01,083084,Eldon; John,6,0,80,74
1657907954182,CSE 30,B01,095061,Bhaskar; Nishant,9,0,50,41
1657907960206,CSE 100,A01,083659,Cao; Yingjun,5,4,70,65
1657907966228,CSE 134B,A01,083661,Powell; Thomas Allan,25,0,100,75
1657907972255,CSE 140,A01,083663,Gungor; Onat,15,0,85,70
1657907978307,CSE 140L,A01,083088,Eldon; John,23,0,100,77
1657907984337,CSE 175,A01,083665,Kumar; Rakesh,3,0,25,22
1657907990367,CSE 190,A00,092507,Dubnov; Shlomo,8,0,20,12
1657907996389,ECE 45,A01,083139,Congero; Spencer William,6,0,75,69
1657908002412,ECE 65,A50,083695,Saad; Andrew S,12,0,30,18
1657908002412,ECE 65,A51,095125,Saad; Andrew S,24,0,26,2
1657908008434,ECE 109,A01,091882,Touri; Behrouz,20,0,70,50
1657908014459,ECE 180,A00,083140,Abi Samra; Nicholas Camill,1,0,30,29
1657908014459,ECE 180,B00,083141,Abi Samra; Nicholas Camill,0,0,30,30
1657908020483,MATH 10A,A01,083735,Patchell; Gregory David,2,0,30,28
1657908020483,MATH 10A,A02,083736,Patchell; Gregory David,20,0,30,10
1657908020483,MATH 10A,A03,083737,Patchell; Gregory David,16,0,30,14
1657908026505,MATH 10B,A01,083207,Lim; Seonhee,8,0,34,26
1657908026505,MATH 10B,A02,083208,Lim; Seonhee,10,0,35,25
1657908026505,MATH 10B,A03,093472,Lim; Seonhee,7,0,34,27
1657908026505,MATH 10B,B01,083739,Sinha; Shubham,14,0,30,16
1657908032528,MATH 18,A01,083743,Cinel; Cameron Alexander,9,0,30,21
1657908032528,MATH 18,A02,083744,Cinel; Cameron Alexander,18,0,30,12
1657908032528,MATH 18,A03,083745,Cinel; Cameron Alexander,10,0,30,20
1657908032528,MATH 18,B01,083748,Rideout; David Porter,5,0,37,32
1657908032528,MATH 18,B02,083749,Rideout; David Porter,5,0,36,31
1657908032528,MATH 18,B03,083750,Rideout; David Porter,3,0,37,34
1657908032528,MATH 18,B04,083751,Rideout; David Porter,6,0,36,30
1657908032528,MATH 18,B05,093473,Rideout; David Porter,7,0,36,29
1657908032528,MATH 18,B06,093474,Rideout; David Porter,6,0,36,30
1657908038553,MATH 20A,A01,083754,Zheng; Zequn,14,0,40,26
1657908044581,MATH 20B,A01,083756,Briones; Jor-el Thomas Caparas,4,0,36,32
1657908044581,MATH 20B,A02,083757,Briones; Jor-el Thomas Caparas,1,0,36,35
1657908044581,MATH 20B,A03,093475,Briones; Jor-el Thomas Caparas,2,0,36,34
1657908050604,MATH 20C,A01,083760,Briones; Jor-el Thomas Caparas,1,0,35,34
1657908050604,MATH 20C,A02,083761,Briones; Jor-el Thomas Caparas,8,0,35,27
1657908050604,MATH 20C,A03,093476,Briones; Jor-el Thomas Caparas,0,1,36,36
1657908050604,MATH 20C,B01,083762,Bach; Quang Tran,1,0,30,29
1657908056627,MATH 20D,A01,083765,Tran; Brian Kha,5,0,30,25
1657908056627,MATH 20D,A02,083766,Tran; Brian Kha,5,0,30,25
1657908056627,MATH 20D,A03,083767,Tran; Brian Kha,5,0,30,25
1657908062653,MATH 20E,A01,083771,Ganguly; Soumya,10,0,32,22
1657908062653,MATH 20E,A02,083772,Ganguly; Soumya,6,0,32,26
1657908062653,MATH 20E,B01,083773,Ciotti; Benjamin,20,0,35,15
1657908062653,MATH 20E,B02,083774,Ciotti; Benjamin,18,0,35,17
1657908068699,MATH 103A,A01,083777,Greenfeld; Be'Eri,3,0,36,33
1657908068699,MATH 103A,A02,083778,Greenfeld; Be'Eri,5,0,36,31
1657908068699,MATH 103A,A03,093561,Greenfeld; Be'Eri,6,0,36,30
1657908068699,MATH 103A,B01,083779,Greenfeld; Be'Eri,7,0,36,29
1657908068699,MATH 103A,B02,083780,Greenfeld; Be'Eri,4,0,36,32
1657908068699,MATH 103A,B03,093562,Greenfeld; Be'Eri,3,0,36,33
1657908074729,MATH 105,A01,085443,Carter; Anne Toulson,15,0,35,20
1657908074729,MATH 105,A02,093477,Carter; Anne Toulson,20,0,35,15
1657908080753,MATH 109,A01,083213,Ganzberger; Geoffrey Michael,3,0,34,31
1657908080753,MATH 109,A02,083214,Ganzberger; Geoffrey Michael,4,0,34,30
1657908080753,MATH 109,A03,093478,Ganzberger; Geoffrey Michael,2,0,34,32
1657908080753,MATH 109,B01,083215,Ganzberger; Geoffrey Michael,2,0,32,30
1657908080753,MATH 109,B02,083216,Ganzberger; Geoffrey Michael,2,0,32,30
1657908080753,MATH 109,B03,093479,Ganzberger; Geoffrey Michael,8,0,32,24
1657908086776,MATH 142A,A01,083219,Chow; Bennett,7,0,32,25
1657908086776,MATH 142A,A02,083220,Chow; Bennett,10,0,32,22
1657908086776,MATH 142A,A03,093480,Chow; Bennett,9,0,32,23
1657908086776,MATH 142A,B03,093481,Chow; Bennett,8,0,32,24
1657908086776,MATH 142A,B04,093558,Chow; Bennett,13,0,32,19
1657908086776,MATH 142A,B05,093559,Chow; Bennett,7,0,32,25
1657908092798,MATH 193A,A01,083224,Rotar; Vladimir,8,0,34,26
1657908092798,MATH 193A,A02,083225,Rotar; Vladimir,10,0,34,24
1657908092798,MATH 193A,A03,083781,Rotar; Vladimir,5,0,34,29
1657908092798,MATH 193A,A04,083782,Rotar; Vladimir,11,0,34,23
1657908092798,MATH 193A,A05,093482,Rotar; Vladimir,10,0,34,24
1657908098825,MATH 197,001,091859,McAuley; Julian John,9999,0,9999,0
1657908098825,MATH 197,002,095566,Kedlaya; Kiran S.,9997,0,9999,2
1657908098825,MATH 197,003,095567,Xiao; Ming,9999,0,9999,0
1657908098825,MATH 197,004,095571,Perols; Johan Lars,9998,0,9999,1
1657908105893,COGS 9,A01,083615,Shannon; Kyle Michael,10,0,75,65
1657908111920,COGS 11,A01,083617,Boyle; Mary E. T.,23,0,48,25
1657908117941,COGS 13,A01,083071,Bastos; Amalia Pinkusfeld,11,0,71,60
1657908123978,COGS 14A,A01,092681,Semenuks; Arturs,5,1,100,95
1657908130000,COGS 14B,A01,083073,Cheng; Tzu-Han,6,0,63,57
1657908136026,COGS 17,A01,092677,Semenuks; Arturs,6,0,81,75
1657908142047,COGS 100,A01,083619,Allen; Michael Gordon,17,0,70,53
1657908148072,COGS 101A,A01,083621,Davis; Joshua Daniel,9,0,68,59
1657908154098,COGS 101B,A01,091572,Allen; Michael Gordon,13,0,65,52
1657908160123,COGS 101C,A01,083625,Delgado; Tania,17,0,35,18
1657908166148,COGS 107A,A01,083627,Boyle; Mary E. T.,14,0,60,46
1657908172169,COGS 118A,A01,083075,Gupta; Anjum,21,0,76,55
1657908178194,CSE 3,A50,083646,Miranda; Gregory Joseph,24,0,50,26
1657908184219,CSE 8A,A50,083650,Miranda; Gregory Joseph,17,1,56,39
1657908190243,CSE 11,A01,083080,Cao; Yingjun,6,15,40,34
1657908196265,CSE 12,A01,083652,Krause-Levy; Sophia Louisa,30,1,120,90
1657908202294,CSE 15L,A01,083654,Morris; Justin Loren,9,0,50,41
1657908202294,CSE 15L,A02,083655,Morris; Justin Loren,10,0,50,40
1657908208315,CSE 20,A01,083657,Tran; Khoa Dang,39,0,80,41
1657908214366,CSE 21,A01,095574,Bach; Quang Tran,22,0,48,26
1657908220396,CSE 30,A01,083084,Eldon; John,6,0,80,74
1657908220396,CSE 30,B01,095061,Bhaskar; Nishant,9,0,50,41
1657908226429,CSE 100,A01,083659,Cao; Yingjun,5,4,70,65
1657908232466,CSE 134B,A01,083661,Powell; Thomas Allan,25,0,100,75
1657908238493,CSE 140,A01,083663,Gungor; Onat,15,0,85,70
1657908244517,CSE 140L,A01,083088,Eldon; John,23,0,100,77
1657908250545,CSE 175,A01,083665,Kumar; Rakesh,3,0,25,22
1657908256569,CSE 190,A00,092507,Dubnov; Shlomo,8,0,20,12
1657908262591,ECE 45,A01,083139,Congero; Spencer William,6,0,75,69
1657908268616,ECE 65,A50,083695,Saad; Andrew S,12,0,30,18
1657908268616,ECE 65,A51,095125,Saad; Andrew S,24,0,26,2
1657908274643,ECE 109,A01,091882,Touri; Behrouz,20,0,70,50
1657908280667,ECE 180,A00,083140,Abi Samra; Nicholas Camill,1,0,30,29
1657908280667,ECE 180,B00,083141,Abi Samra; Nicholas Camill,0,0,30,30
1657908286690,MATH 10A,A01,083735,Patchell; Gregory David,2,0,30,28
1657908286690,MATH 10A,A02,083736,Patchell; Gregory David,20,0,30,10
1657908286690,MATH 10A,A03,083737,Patchell; Gregory David,16,0,30,14
1657908292812,MATH 10B,A01,083207,Lim; Seonhee,8,0,34,26
1657908292812,MATH 10B,A02,083208,Lim; Seonhee,10,0,35,25
1657908292812,MATH 10B,A03,093472,Lim; Seonhee,7,0,34,27
1657908292812,MATH 10B,B01,083739,Sinha; Shubham,14,0,30,16
1657908298835,MATH 18,A01,083743,Cinel; Cameron Alexander,9,0,30,21
1657908298835,MATH 18,A02,083744,Cinel; Cameron Alexander,18,0,30,12
1657908298835,MATH 18,A03,083745,Cinel; Cameron Alexander,10,0,30,20
1657908298835,MATH 18,B01,083748,Rideout; David Porter,5,0,37,32
1657908298835,MATH 18,B02,083749,Rideout; David Porter,5,0,36,31
1657908298835,MATH 18,B03,083750,Rideout; David Porter,3,0,37,34
1657908298835,MATH 18,B04,083751,Rideout; David Porter,6,0,36,30
1657908298835,MATH 18,B05,093473,Rideout; David Porter,7,0,36,29
1657908298835,MATH 18,B06,093474,Rideout; David Porter,6,0,36,30
1657908304857,MATH 20A,A01,083754,Zheng; Zequn,14,0,40,26
1657908310890,MATH 20B,A01,083756,Briones; Jor-el Thomas Caparas,4,0,36,32
1657908310890,MATH 20B,A02,083757,Briones; Jor-el Thomas Caparas,1,0,36,35
1657908310890,MATH 20B,A03,093475,Briones; Jor-el Thomas Caparas,2,0,36,34
1657908316918,MATH 20C,A01,083760,Briones; Jor-el Thomas Caparas,1,0,35,34
1657908316918,MATH 20C,A02,083761,Briones; Jor-el Thomas Caparas,8,0,35,27
1657908316918,MATH 20C,A03,093476,Briones; Jor-el Thomas Caparas,0,1,36,36
1657908316918,MATH 20C,B01,083762,Bach; Quang Tran,1,0,30,29
1657908322941,MATH 20D,A01,083765,Tran; Brian Kha,5,0,30,25
1657908322941,MATH 20D,A02,083766,Tran; Brian Kha,5,0,30,25
1657908322941,MATH 20D,A03,083767,Tran; Brian Kha,5,0,30,25
1657908328968,MATH 20E,A01,083771,Ganguly; Soumya,10,0,32,22
1657908328968,MATH 20E,A02,083772,Ganguly; Soumya,6,0,32,26
1657908328968,MATH 20E,B01,083773,Ciotti; Benjamin,20,0,35,15
1657908328968,MATH 20E,B02,083774,Ciotti; Benjamin,18,0,35,17
1657908334990,MATH 103A,A01,083777,Greenfeld; Be'Eri,3,0,36,33
1657908334990,MATH 103A,A02,083778,Greenfeld; Be'Eri,5,0,36,31
1657908334990,MATH 103A,A03,093561,Greenfeld; Be'Eri,6,0,36,30
1657908334990,MATH 103A,B01,083779,Greenfeld; Be'Eri,8,0,36,28
1657908334990,MATH 103A,B02,083780,Greenfeld; Be'Eri,4,0,36,32
1657908334990,MATH 103A,B03,093562,Greenfeld; Be'Eri,3,0,36,33
1657908341013,MATH 105,A01,085443,Carter; Anne Toulson,15,0,35,20
1657908341013,MATH 105,A02,093477,Carter; Anne Toulson,20,0,35,15
1657908347051,MATH 109,A01,083213,Ganzberger; Geoffrey Michael,3,0,34,31
1657908347051,MATH 109,A02,083214,Ganzberger; Geoffrey Michael,4,0,34,30
1657908347051,MATH 109,A03,093478,Ganzberger; Geoffrey Michael,2,0,34,32
1657908347051,MATH 109,B01,083215,Ganzberger; Geoffrey Michael,2,0,32,30
1657908347051,MATH 109,B02,083216,Ganzberger; Geoffrey Michael,2,0,32,30
1657908347051,MATH 109,B03,093479,Ganzberger; Geoffrey Michael,8,0,32,24
1657908353084,MATH 142A,A01,083219,Chow; Bennett,7,0,32,25
1657908353084,MATH 142A,A02,083220,Chow; Bennett,10,0,32,22
1657908353084,MATH 142A,A03,093480,Chow; Bennett,9,0,32,23
1657908353084,MATH 142A,B03,093481,Chow; Bennett,8,0,32,24
1657908353084,MATH 142A,B04,093558,Chow; Bennett,13,0,32,19
1657908353084,MATH 142A,B05,093559,Chow; Bennett,7,0,32,25
1657908359117,MATH 193A,A01,083224,Rotar; Vladimir,8,0,34,26
1657908359117,MATH 193A,A02,083225,Rotar; Vladimir,10,0,34,24
1657908359117,MATH 193A,A03,083781,Rotar; Vladimir,5,0,34,29
1657908359117,MATH 193A,A04,083782,Rotar; Vladimir,11,0,34,23
1657908359117,MATH 193A,A05,093482,Rotar; Vladimir,10,0,34,24
1657908365141,MATH 197,001,091859,McAuley; Julian John,9999,0,9999,0
1657908365141,MATH 197,002,095566,Kedlaya; Kiran S.,9997,0,9999,2
1657908365141,MATH 197,003,095567,Xiao; Ming,9999,0,9999,0
1657908365141,MATH 197,004,095571,Perols; Johan Lars,9998,0,9999,1
1657908372194,COGS 9,A01,083615,Shannon; Kyle Michael,10,0,75,65
1657908378225,COGS 11,A01,083617,Boyle; Mary E. T.,23,0,48,25
1657908384251,COGS 13,A01,083071,Bastos; Amalia Pinkusfeld,11,0,71,60
1657908390273,COGS 14A,A01,092681,Semenuks; Arturs,5,1,100,95
1657908396298,COGS 14B,A01,083073,Cheng; Tzu-Han,6,0,63,57
1657908402321,COGS 17,A01,092677,Semenuks; Arturs,6,0,81,75
1657908408353,COGS 100,A01,083619,Allen; Michael Gordon,17,0,70,53
1657908414380,COGS 101A,A01,083621,Davis; Joshua Daniel,9,0,68,59
1657908420403,COGS 101B,A01,091572,Allen; Michael Gordon,13,0,65,52
1657908426431,COGS 101C,A01,083625,Delgado; Tania,17,0,35,18
1657908432468,COGS 107A,A01,083627,Boyle; Mary E. T.,14,0,60,46
1657908438498,COGS 118A,A01,083075,Gupta; Anjum,21,0,76,55
1657908444526,CSE 3,A50,083646,Miranda; Gregory Joseph,24,0,50,26
1657908450551,CSE 8A,A50,083650,Miranda; Gregory Joseph,17,1,56,39
1657908456579,CSE 11,A01,083080,Cao; Yingjun,6,15,40,34
1657908462600,CSE 12,A01,083652,Krause-Levy; Sophia Louisa,30,1,120,90
1657908468627,CSE 15L,A01,083654,Morris; Justin Loren,9,0,50,41
1657908468627,CSE 15L,A02,083655,Morris; Justin Loren,10,0,50,40
1657908474674,CSE 20,A01,083657,Tran; Khoa Dang,39,0,80,41
1657908480700,CSE 21,A01,095574,Bach; Quang Tran,22,0,48,26
1657908486725,CSE 30,A01,083084,Eldon; John,6,0,80,74
1657908486725,CSE 30,B01,095061,Bhaskar; Nishant,9,0,50,41
1657908492750,CSE 100,A01,083659,Cao; Yingjun,5,4,70,65
1657908498776,CSE 134B,A01,083661,Powell; Thomas Allan,25,0,100,75
1657908504799,CSE 140,A01,083663,Gungor; Onat,15,0,85,70
1657908510823,CSE 140L,A01,083088,Eldon; John,23,0,100,77
1657908516862,CSE 175,A01,083665,Kumar; Rakesh,3,0,25,22
1657908522889,CSE 190,A00,092507,Dubnov; Shlomo,8,0,20,12
1657908528918,ECE 45,A01,083139,Congero; Spencer William,6,0,75,69
1657908534941,ECE 65,A50,083695,Saad; Andrew S,12,0,30,18
1657908534941,ECE 65,A51,095125,Saad; Andrew S,24,0,26,2
1657908540964,ECE 109,A01,091882,Touri; Behrouz,20,0,70,50
1657908546991,ECE 180,A00,083140,Abi Samra; Nicholas Camill,1,0,30,29
1657908546991,ECE 180,B00,083141,Abi Samra; Nicholas Camill,0,0,30,30
1657908553015,MATH 10A,A01,083735,Patchell; Gregory David,2,0,30,28
1657908553015,MATH 10A,A02,083736,Patchell; Gregory David,20,0,30,10
1657908553015,MATH 10A,A03,083737,Patchell; Gregory David,16,0,30,14
1657908559040,MATH 10B,A01,083207,Lim; Seonhee,8,0,34,26
1657908559040,MATH 10B,A02,083208,Lim; Seonhee,10,0,35,25
1657908559040,MATH 10B,A03,093472,Lim; Seonhee,7,0,34,27
1657908559040,MATH 10B,B01,083739,Sinha; Shubham,14,0,30,16
1657908565081,MATH 18,A01,083743,Cinel; Cameron Alexander,9,0,30,21
1657908565081,MATH 18,A02,083744,Cinel; Cameron Alexander,18,0,30,12
1657908565081,MATH 18,A03,083745,Cinel; Cameron Alexander,10,0,30,20
1657908565081,MATH 18,B01,083748,Rideout; David Porter,5,0,37,32
1657908565081,MATH 18,B02,083749,Rideout; David Porter,5,0,36,31
1657908565081,MATH 18,B03,083750,Rideout; David Porter,3,0,37,34
1657908565081,MATH 18,B04,083751,Rideout; David Porter,6,0,36,30
1657908565081,MATH 18,B05,093473,Rideout; David Porter,7,0,36,29
1657908565081,MATH 18,B06,093474,Rideout; David Porter,6,0,36,30
1657908571108,MATH 20A,A01,083754,Zheng; Zequn,14,0,40,26
1657908577132,MATH 20B,A01,083756,Briones; Jor-el Thomas Caparas,4,0,36,32
1657908577132,MATH 20B,A02,083757,Briones; Jor-el Thomas Caparas,1,0,36,35
1657908577132,MATH 20B,A03,093475,Briones; Jor-el Thomas Caparas,2,0,36,34
1657908583160,MATH 20C,A01,083760,Briones; Jor-el Thomas Caparas,1,0,35,34
1657908583160,MATH 20C,A02,083761,Briones; Jor-el Thomas Caparas,8,0,35,27
1657908583160,MATH 20C,A03,093476,Briones; Jor-el Thomas Caparas,0,1,36,36
1657908583160,MATH 20C,B01,083762,Bach; Quang Tran,1,0,30,29
1657908589183,MATH 20D,A01,083765,Tran; Brian Kha,5,0,30,25
1657908589183,MATH 20D,A02,083766,Tran; Brian Kha,5,0,30,25
1657908589183,MATH 20D,A03,083767,Tran; Brian Kha,5,0,30,25
1657908595212,MATH 20E,A01,083771,Ganguly; Soumya,10,0,32,22
1657908595212,MATH 20E,A02,083772,Ganguly; Soumya,6,0,32,26
1657908595212,MATH 20E,B01,083773,Ciotti; Benjamin,20,0,35,15
1657908595212,MATH 20E,B02,083774,Ciotti; Benjamin,18,0,35,17
1657908601241,MATH 103A,A01,083777,Greenfeld; Be'Eri,3,0,36,33
1657908601241,MATH 103A,A02,083778,Greenfeld; Be'Eri,5,0,36,31
1657908601241,MATH 103A,A03,093561,Greenfeld; Be'Eri,6,0,36,30
1657908601241,MATH 103A,B01,083779,Greenfeld; Be'Eri,8,0,36,28
1657908601241,MATH 103A,B02,083780,Greenfeld; Be'Eri,4,0,36,32
1657908601241,MATH 103A,B03,093562,Greenfeld; Be'Eri,3,0,36,33
1657908607264,MATH 105,A01,085443,Carter; Anne Toulson,15,0,35,20
1657908607264,MATH 105,A02,093477,Carter; Anne Toulson,20,0,35,15
1657908613285,MATH 109,A01,083213,Ganzberger; Geoffrey Michael,3,0,34,31
1657908613285,MATH 109,A02,083214,Ganzberger; Geoffrey Michael,4,0,34,30
1657908613285,MATH 109,A03,093478,Ganzberger; Geoffrey Michael,2,0,34,32
1657908613285,MATH 109,B01,083215,Ganzberger; Geoffrey Michael,2,0,32,30
1657908613285,MATH 109,B02,083216,Ganzberger; Geoffrey Michael,2,0,32,30
1657908613285,MATH 109,B03,093479,Ganzberger; Geoffrey Michael,8,0,32,24
1657908619314,MATH 142A,A01,083219,Chow; Bennett,7,0,32,25
1657908619314,MATH 142A,A02,083220,Chow; Bennett,10,0,32,22
1657908619314,MATH 142A,A03,093480,Chow; Bennett,9,0,32,23
1657908619314,MATH 142A,B03,093481,Chow; Bennett,8,0,32,24
1657908619314,MATH 142A,B04,093558,Chow; Bennett,13,0,32,19
1657908619314,MATH 142A,B05,093559,Chow; Bennett,7,0,32,25
1657908625337,MATH 193A,A01,083224,Rotar; Vladimir,8,0,34,26
1657908625337,MATH 193A,A02,083225,Rotar; Vladimir,10,0,34,24
1657908625337,MATH 193A,A03,083781,Rotar; Vladimir,5,0,34,29
1657908625337,MATH 193A,A04,083782,Rotar; Vladimir,11,0,34,23
1657908625337,MATH 193A,A05,093482,Rotar; Vladimir,10,0,34,24
1657908631364,MATH 197,001,091859,McAuley; Julian John,9999,0,9999,0
1657908631364,MATH 197,002,095566,Kedlaya; Kiran S.,9997,0,9999,2
1657908631364,MATH 197,003,095567,Xiao; Ming,9999,0,9999,0
1657908631364,MATH 197,004,095571,Perols; Johan Lars,9998,0,9999,1
1657908638425,COGS 9,A01,083615,Shannon; Kyle Michael,10,0,75,65
1657908644452,COGS 11,A01,083617,Boyle; Mary E. T.,23,0,48,25
1657908650479,COGS 13,A01,083071,Bastos; Amalia Pinkusfeld,11,0,71,60
1657908656502,COGS 14A,A01,092681,Semenuks; Arturs,5,1,100,95
1657908662535,COGS 14B,A01,083073,Cheng; Tzu-Han,6,0,63,57
1657908668559,COGS 17,A01,092677,Semenuks; Arturs,6,0,81,75
1657908674585,COGS 100,A01,083619,Allen; Michael Gordon,17,0,70,53
1657908680607,COGS 101A,A01,083621,Davis; Joshua Daniel,9,0,68,59
1657908686639,COGS 101B,A01,091572,Allen; Michael Gordon,13,0,65,52
1657908692663,COGS 101C,A01,083625,Delgado; Tania,17,0,35,18
1657908698690,COGS 107A,A01,083627,Boyle; Mary E. T.,14,0,60,46
1657908704715,COGS 118A,A01,083075,Gupta; Anjum,21,0,76,55
1657908710745,CSE 3,A50,083646,Miranda; Gregory Joseph,24,0,50,26
1657908716772,CSE 8A,A50,083650,Miranda; Gregory Joseph,17,1,56,39
1657908722798,CSE 11,A01,083080,Cao; Yingjun,6,15,40,34
1657908728825,CSE 12,A01,083652,Krause-Levy; Sophia Louisa,30,1,120,90
1657908734850,CSE 15L,A01,083654,Morris; Justin Loren,9,0,50,41
1657908734850,CSE 15L,A02,083655,Morris; Justin Loren,10,0,50,40
1657908740873,CSE 20,A01,083657,Tran; Khoa Dang,39,0,80,41
1657908746899,CSE 21,A01,095574,Bach; Quang Tran,22,0,48,26
1657908752922,CSE 30,A01,083084,Eldon; John,6,0,80,74
1657908752922,CSE 30,B01,095061,Bhaskar; Nishant,9,0,50,41
1657908758950,CSE 100,A01,083659,Cao; Yingjun,5,4,70,65
1657908764973,CSE 134B,A01,083661,Powell; Thomas Allan,25,0,100,75
1657908770998,CSE 140,A01,083663,Gungor; Onat,15,0,85,70
1657908777026,CSE 140L,A01,083088,Eldon; John,23,0,100,77
1657908783059,CSE 175,A01,083665,Kumar; Rakesh,3,0,25,22
1657908789091,CSE 190,A00,092507,Dubnov; Shlomo,8,0,20,12
1657908795112,ECE 45,A01,083139,Congero; Spencer William,6,0,75,69
1657908801138,ECE 65,A50,083695,Saad; Andrew S,12,0,30,18
1657908801138,ECE 65,A51,095125,Saad; Andrew S,24,0,26,2
1657908807170,ECE 109,A01,091882,Touri; Behrouz,20,0,70,50
1657908813192,ECE 180,A00,083140,Abi Samra; Nicholas Camill,1,0,30,29
1657908813192,ECE 180,B00,083141,Abi Samra; Nicholas Camill,0,0,30,30
1657908819229,MATH 10A,A01,083735,Patchell; Gregory David,2,0,30,28
1657908819229,MATH 10A,A02,083736,Patchell; Gregory David,20,0,30,10
1657908819229,MATH 10A,A03,083737,Patchell; Gregory David,16,0,30,14
1657908825258,MATH 10B,A01,083207,Lim; Seonhee,8,0,34,26
1657908825258,MATH 10B,A02,083208,Lim; Seonhee,10,0,35,25
1657908825258,MATH 10B,A03,093472,Lim; Seonhee,7,0,34,27
1657908825258,MATH 10B,B01,083739,Sinha; Shubham,14,0,30,16
1657908831286,MATH 18,A01,083743,Cinel; Cameron Alexander,9,0,30,21
1657908831286,MATH 18,A02,083744,Cinel; Cameron Alexander,18,0,30,12
1657908831286,MATH 18,A03,083745,Cinel; Cameron Alexander,10,0,30,20
1657908831286,MATH 18,B01,083748,Rideout; David Porter,5,0,37,32
1657908831286,MATH 18,B02,083749,Rideout; David Porter,5,0,36,31
1657908831286,MATH 18,B03,083750,Rideout; David Porter,3,0,37,34
1657908831286,MATH 18,B04,083751,Rideout; David Porter,6,0,36,30
1657908831286,MATH 18,B05,093473,Rideout; David Porter,7,0,36,29
1657908831286,MATH 18,B06,093474,Rideout; David Porter,6,0,36,30
1657908837309,MATH 20A,A01,083754,Zheng; Zequn,14,0,40,26
1657908843331,MATH 20B,A01,083756,Briones; Jor-el Thomas Caparas,4,0,36,32
1657908843331,MATH 20B,A02,083757,Briones; Jor-el Thomas Caparas,1,0,36,35
1657908843331,MATH 20B,A03,093475,Briones; Jor-el Thomas Caparas,2,0,36,34
1657908849361,MATH 20C,A01,083760,Briones; Jor-el Thomas Caparas,1,0,35,34
1657908849361,MATH 20C,A02,083761,Briones; Jor-el Thomas Caparas,8,0,35,27
1657908849361,MATH 20C,A03,093476,Briones; Jor-el Thomas Caparas,0,1,36,36
1657908849361,MATH 20C,B01,083762,Bach; Quang Tran,1,0,30,29
1657908855393,MATH 20D,A01,083765,Tran; Brian Kha,5,0,30,25
1657908855393,MATH 20D,A02,083766,Tran; Brian Kha,5,0,30,25
1657908855393,MATH 20D,A03,083767,Tran; Brian Kha,5,0,30,25
1657908861415,MATH 20E,A01,083771,Ganguly; Soumya,10,0,32,22
1657908861415,MATH 20E,A02,083772,Ganguly; Soumya,6,0,32,26
1657908861415,MATH 20E,B01,083773,Ciotti; Benjamin,20,0,35,15
1657908861415,MATH 20E,B02,083774,Ciotti; Benjamin,18,0,35,17
1657908867444,MATH 103A,A01,083777,Greenfeld; Be'Eri,3,0,36,33
1657908867444,MATH 103A,A02,083778,Greenfeld; Be'Eri,5,0,36,31
1657908867444,MATH 103A,A03,093561,Greenfeld; Be'Eri,6,0,36,30
1657908867444,MATH 103A,B01,083779,Greenfeld; Be'Eri,8,0,36,28
1657908867444,MATH 103A,B02,083780,Greenfeld; Be'Eri,4,0,36,32
1657908867444,MATH 103A,B03,093562,Greenfeld; Be'Eri,3,0,36,33
1657908873472,MATH 105,A01,085443,Carter; Anne Toulson,15,0,35,20
1657908873472,MATH 105,A02,093477,Carter; Anne Toulson,20,0,35,15
1657908879511,MATH 109,A01,083213,Ganzberger; Geoffrey Michael,3,0,34,31
1657908879511,MATH 109,A02,083214,Ganzberger; Geoffrey Michael,4,0,34,30
1657908879511,MATH 109,A03,093478,Ganzberger; Geoffrey Michael,2,0,34,32
1657908879511,MATH 109,B01,083215,Ganzberger; Geoffrey Michael,2,0,32,30
1657908879511,MATH 109,B02,083216,Ganzberger; Geoffrey Michael,2,0,32,30
1657908879511,MATH 109,B03,093479,Ganzberger; Geoffrey Michael,8,0,32,24
1657908885559,MATH 142A,A01,083219,Chow; Bennett,7,0,32,25
1657908885559,MATH 142A,A02,083220,Chow; Bennett,10,0,32,22
1657908885559,MATH 142A,A03,093480,Chow; Bennett,9,0,32,23
1657908885559,MATH 142A,B03,093481,Chow; Bennett,8,0,32,24
1657908885559,MATH 142A,B04,093558,Chow; Bennett,13,0,32,19
1657908885559,MATH 142A,B05,093559,Chow; Bennett,7,0,32,25
1657908891656,MATH 193A,A01,083224,Rotar; Vladimir,8,0,34,26
1657908891656,MATH 193A,A02,083225,Rotar; Vladimir,10,0,34,24
1657908891656,MATH 193A,A03,083781,Rotar; Vladimir,5,0,34,29
1657908891656,MATH 193A,A04,083782,Rotar; Vladimir,11,0,34,23
1657908891656,MATH 193A,A05,093482,Rotar; Vladimir,10,0,34,24
1657908897695,MATH 197,001,091859,McAuley; Julian John,9999,0,9999,0
1657908897695,MATH 197,002,095566,Kedlaya; Kiran S.,9997,0,9999,2
1657908897695,MATH 197,003,095567,Xiao; Ming,9999,0,9999,0
1657908897695,MATH 197,004,095571,Perols; Johan Lars,9998,0,9999,1
1657908904773,COGS 9,A01,083615,Shannon; Kyle Michael,10,0,75,65
1657908910805,COGS 11,A01,083617,Boyle; Mary E. T.,23,0,48,25
1657908916835,COGS 13,A01,083071,Bastos; Amalia Pinkusfeld,11,0,71,60
1657908922857,COGS 14A,A01,092681,Semenuks; Arturs,5,1,100,95
1657908928882,COGS 14B,A01,083073,Cheng; Tzu-Han,6,0,63,57
1657908934924,COGS 17,A01,092677,Semenuks; Arturs,6,0,81,75
1657908940949,COGS 100,A01,083619,Allen; Michael Gordon,17,0,70,53
1657908946976,COGS 101A,A01,083621,Davis; Joshua Daniel,9,0,68,59
1657908953002,COGS 101B,A01,091572,Allen; Michael Gordon,13,0,65,52
1657908959031,COGS 101C,A01,083625,Delgado; Tania,17,0,35,18
1657908965054,COGS 107A,A01,083627,Boyle; Mary E. T.,14,0,60,46
1657908971081,COGS 118A,A01,083075,Gupta; Anjum,21,0,76,55
1657908977104,CSE 3,A50,083646,Miranda; Gregory Joseph,24,0,50,26
1657908983127,CSE 8A,A50,083650,Miranda; Gregory Joseph,17,1,56,39
1657908989150,CSE 11,A01,083080,Cao; Yingjun,6,15,40,34
1657908995173,CSE 12,A01,083652,Krause-Levy; Sophia Louisa,30,1,120,90
1657909001194,CSE 15L,A01,083654,Morris; Justin Loren,9,0,50,41
1657909001194,CSE 15L,A02,083655,Morris; Justin Loren,10,0,50,40
1657909007221,CSE 20,A01,083657,Tran; Khoa Dang,39,0,80,41
1657909013261,CSE 21,A01,095574,Bach; Quang Tran,22,0,48,26
1657909019290,CSE 30,A01,083084,Eldon; John,6,0,80,74
1657909019290,CSE 30,B01,095061,Bhaskar; Nishant,9,0,50,41
1657909025322,CSE 100,A01,083659,Cao; Yingjun,5,4,70,65
1657909031349,CSE 134B,A01,083661,Powell; Thomas Allan,25,0,100,75
1657909037375,CSE 140,A01,083663,Gungor; Onat,15,0,85,70
1657909043398,CSE 140L,A01,083088,Eldon; John,23,0,100,77
1657909049430,CSE 175,A01,083665,Kumar; Rakesh,3,0,25,22
1657909055456,CSE 190,A00,092507,Dubnov; Shlomo,8,0,20,12
1657909061479,ECE 45,A01,083139,Congero; Spencer William,6,0,75,69
1657909067501,ECE 65,A50,083695,Saad; Andrew S,12,0,30,18
1657909067501,ECE 65,A51,095125,Saad; Andrew S,24,0,26,2
1657909073524,ECE 109,A01,091882,Touri; Behrouz,20,0,70,50
1657909079547,ECE 180,A00,083140,Abi Samra; Nicholas Camill,1,0,30,29
1657909079547,ECE 180,B00,083141,Abi Samra; Nicholas Camill,0,0,30,30
1657909085575,MATH 10A,A01,083735,Patchell; Gregory David,2,0,30,28
1657909085575,MATH 10A,A02,083736,Patchell; Gregory David,20,0,30,10
1657909085575,MATH 10A,A03,083737,Patchell; Gregory David,16,0,30,14
1657909091604,MATH 10B,A01,083207,Lim; Seonhee,8,0,34,26
1657909091604,MATH 10B,A02,083208,Lim; Seonhee,10,0,35,25
1657909091604,MATH 10B,A03,093472,Lim; Seonhee,7,0,34,27
1657909091604,MATH 10B,B01,083739,Sinha; Shubham,14,0,30,16
1657909097627,MATH 18,A01,083743,Cinel; Cameron Alexander,9,0,30,21
1657909097627,MATH 18,A02,083744,Cinel; Cameron Alexander,18,0,30,12
1657909097627,MATH 18,A03,083745,Cinel; Cameron Alexander,10,0,30,20
1657909097627,MATH 18,B01,083748,Rideout; David Porter,5,0,37,32
1657909097627,MATH 18,B02,083749,Rideout; David Porter,5,0,36,31
1657909097627,MATH 18,B03,083750,Rideout; David Porter,3,0,37,34
1657909097627,MATH 18,B04,083751,Rideout; David Porter,6,0,36,30
1657909097627,MATH 18,B05,093473,Rideout; David Porter,7,0,36,29
1657909097627,MATH 18,B06,093474,Rideout; David Porter,6,0,36,30
1657909103649,MATH 20A,A01,083754,Zheng; Zequn,14,0,40,26
1657909109676,MATH 20B,A01,083756,Briones; Jor-el Thomas Caparas,4,0,36,32
1657909109676,MATH 20B,A02,083757,Briones; Jor-el Thomas Caparas,1,0,36,35
1657909109676,MATH 20B,A03,093475,Briones; Jor-el Thomas Caparas,2,0,36,34
1657909115702,MATH 20C,A01,083760,Briones; Jor-el Thomas Caparas,1,0,35,34
1657909115702,MATH 20C,A02,083761,Briones; Jor-el Thomas Caparas,8,0,35,27
1657909115702,MATH 20C,A03,093476,Briones; Jor-el Thomas Caparas,0,1,36,36
1657909115702,MATH 20C,B01,083762,Bach; Quang Tran,1,0,30,29
1657909121730,MATH 20D,A01,083765,Tran; Brian Kha,5,0,30,25
1657909121730,MATH 20D,A02,083766,Tran; Brian Kha,5,0,30,25
1657909121730,MATH 20D,A03,083767,Tran; Brian Kha,5,0,30,25
1657909127762,MATH 20E,A01,083771,Ganguly; Soumya,10,0,32,22
1657909127762,MATH 20E,A02,083772,Ganguly; Soumya,6,0,32,26
1657909127762,MATH 20E,B01,083773,Ciotti; Benjamin,20,0,35,15
1657909127762,MATH 20E,B02,083774,Ciotti; Benjamin,18,0,35,17
1657909133808,MATH 103A,A01,083777,Greenfeld; Be'Eri,3,0,36,33
1657909133808,MATH 103A,A02,083778,Greenfeld; Be'Eri,5,0,36,31
1657909133808,MATH 103A,A03,093561,Greenfeld; Be'Eri,6,0,36,30
1657909133808,MATH 103A,B01,083779,Greenfeld; Be'Eri,8,0,36,28
1657909133808,MATH 103A,B02,083780,Greenfeld; Be'Eri,4,0,36,32
1657909133808,MATH 103A,B03,093562,Greenfeld; Be'Eri,3,0,36,33
1657909139835,MATH 105,A01,085443,Carter; Anne Toulson,15,0,35,20
1657909139835,MATH 105,A02,093477,Carter; Anne Toulson,20,0,35,15
1657909145860,MATH 109,A01,083213,Ganzberger; Geoffrey Michael,3,0,34,31
1657909145860,MATH 109,A02,083214,Ganzberger; Geoffrey Michael,4,0,34,30
1657909145860,MATH 109,A03,093478,Ganzberger; Geoffrey Michael,2,0,34,32
1657909145860,MATH 109,B01,083215,Ganzberger; Geoffrey Michael,2,0,32,30
1657909145860,MATH 109,B02,083216,Ganzberger; Geoffrey Michael,2,0,32,30
1657909145860,MATH 109,B03,093479,Ganzberger; Geoffrey Michael,8,0,32,24
1657909151882,MATH 142A,A01,083219,Chow; Bennett,7,0,32,25
1657909151882,MATH 142A,A02,083220,Chow; Bennett,10,0,32,22
1657909151882,MATH 142A,A03,093480,Chow; Bennett,9,0,32,23
1657909151882,MATH 142A,B03,093481,Chow; Bennett,8,0,32,24
1657909151882,MATH 142A,B04,093558,Chow; Bennett,13,0,32,19
1657909151882,MATH 142A,B05,093559,Chow; Bennett,7,0,32,25
1657909157904,MATH 193A,A01,083224,Rotar; Vladimir,8,0,34,26
1657909157904,MATH 193A,A02,083225,Rotar; Vladimir,10,0,34,24
1657909157904,MATH 193A,A03,083781,Rotar; Vladimir,5,0,34,29
1657909157904,MATH 193A,A04,083782,Rotar; Vladimir,11,0,34,23
1657909157904,MATH 193A,A05,093482,Rotar; Vladimir,10,0,34,24
1657909163927,MATH 197,001,091859,McAuley; Julian John,9999,0,9999,0
1657909163927,MATH 197,002,095566,Kedlaya; Kiran S.,9997,0,9999,2
1657909163927,MATH 197,003,095567,Xiao; Ming,9999,0,9999,0
1657909163927,MATH 197,004,095571,Perols; Johan Lars,9998,0,9999,1
1657909170988,COGS 9,A01,083615,Shannon; Kyle Michael,10,0,75,65
1657909177014,COGS 11,A01,083617,Boyle; Mary E. T.,23,0,48,25
1657909183050,COGS 13,A01,083071,Bastos; Amalia Pinkusfeld,11,0,71,60
1657909189079,COGS 14A,A01,092681,Semenuks; Arturs,5,1,100,95
1657909195106,COGS 14B,A01,083073,Cheng; Tzu-Han,6,0,63,57
1657909201141,COGS 17,A01,092677,Semenuks; Arturs,6,0,81,75
1657909207167,COGS 100,A01,083619,Allen; Michael Gordon,17,0,70,53
1657909213201,COGS 101A,A01,083621,Davis; Joshua Daniel,9,0,68,59
1657909219230,COGS 101B,A01,091572,Allen; Michael Gordon,13,0,65,52
1657909225254,COGS 101C,A01,083625,Delgado; Tania,17,0,35,18
1657909231276,COGS 107A,A01,083627,Boyle; Mary E. T.,14,0,60,46
1657909237298,COGS 118A,A01,083075,Gupta; Anjum,21,0,76,55
1657909243325,CSE 3,A50,083646,Miranda; Gregory Joseph,24,0,50,26
1657909249350,CSE 8A,A50,083650,Miranda; Gregory Joseph,17,1,56,39
1657909255373,CSE 11,A01,083080,Cao; Yingjun,6,15,40,34
1657909261399,CSE 12,A01,083652,Krause-Levy; Sophia Louisa,30,1,120,90
1657909267434,CSE 15L,A01,083654,Morris; Justin Loren,9,0,50,41
1657909267434,CSE 15L,A02,083655,Morris; Justin Loren,10,0,50,40
1657909273458,CSE 20,A01,083657,Tran; Khoa Dang,39,0,80,41
1657909279482,CSE 21,A01,095574,Bach; Quang Tran,22,0,48,26
1657909285514,CSE 30,A01,083084,Eldon; John,6,0,80,74
1657909285514,CSE 30,B01,095061,Bhaskar; Nishant,9,0,50,41
1657909291537,CSE 100,A01,083659,Cao; Yingjun,5,4,70,65
1657909297559,CSE 134B,A01,083661,Powell; Thomas Allan,25,0,100,75
1657909303588,CSE 140,A01,083663,Gungor; Onat,16,0,85,69
1657909309626,CSE 140L,A01,083088,Eldon; John,23,0,100,77
1657909315651,CSE 175,A01,083665,Kumar; Rakesh,3,0,25,22
1657909321675,CSE 190,A00,092507,Dubnov; Shlomo,8,0,20,12
1657909327709,ECE 45,A01,083139,Congero; Spencer William,6,0,75,69
1657909333731,ECE 65,A50,083695,Saad; Andrew S,12,0,30,18
1657909333731,ECE 65,A51,095125,Saad; Andrew S,24,0,26,2
1657909339757,ECE 109,A01,091882,Touri; Behrouz,20,0,70,50
1657909345779,ECE 180,A00,083140,Abi Samra; Nicholas Camill,1,0,30,29
1657909345779,ECE 180,B00,083141,Abi Samra; Nicholas Camill,0,0,30,30
1657909351805,MATH 10A,A01,083735,Patchell; Gregory David,2,0,30,28
1657909351805,MATH 10A,A02,083736,Patchell; Gregory David,20,0,30,10
1657909351805,MATH 10A,A03,083737,Patchell; Gregory David,16,0,30,14
1657909357832,MATH 10B,A01,083207,Lim; Seonhee,8,0,34,26
1657909357832,MATH 10B,A02,083208,Lim; Seonhee,10,0,35,25
1657909357832,MATH 10B,A03,093472,Lim; Seonhee,7,0,34,27
1657909357832,MATH 10B,B01,083739,Sinha; Shubham,14,0,30,16
1657909363856,MATH 18,A01,083743,Cinel; Cameron Alexander,9,0,30,21
1657909363856,MATH 18,A02,083744,Cinel; Cameron Alexander,18,0,30,12
1657909363856,MATH 18,A03,083745,Cinel; Cameron Alexander,10,0,30,20
1657909363856,MATH 18,B01,083748,Rideout; David Porter,5,0,37,32
1657909363856,MATH 18,B02,083749,Rideout; David Porter,5,0,36,31
1657909363856,MATH 18,B03,083750,Rideout; David Porter,3,0,37,34
1657909363856,MATH 18,B04,083751,Rideout; David Porter,6,0,36,30
1657909363856,MATH 18,B05,093473,Rideout; David Porter,7,0,36,29
1657909363856,MATH 18,B06,093474,Rideout; David Porter,6,0,36,30
1657909369878,MATH 20A,A01,083754,Zheng; Zequn,14,0,40,26
1657909375906,MATH 20B,A01,083756,Briones; Jor-el Thomas Caparas,4,0,36,32
1657909375906,MATH 20B,A02,083757,Briones; Jor-el Thomas Caparas,1,0,36,35
1657909375906,MATH 20B,A03,093475,Briones; Jor-el Thomas Caparas,2,0,36,34
1657909381949,MATH 20C,A01,083760,Briones; Jor-el Thomas Caparas,1,0,35,34
1657909381949,MATH 20C,A02,083761,Briones; Jor-el Thomas Caparas,8,0,35,27
1657909381949,MATH 20C,A03,093476,Briones; Jor-el Thomas Caparas,0,1,36,36
1657909381949,MATH 20C,B01,083762,Bach; Quang Tran,1,0,30,29
1657909387973,MATH 20D,A01,083765,Tran; Brian Kha,5,0,30,25
1657909387973,MATH 20D,A02,083766,Tran; Brian Kha,5,0,30,25
1657909387973,MATH 20D,A03,083767,Tran; Brian Kha,5,0,30,25
1657909393996,MATH 20E,A01,083771,Ganguly; Soumya,10,0,32,22
1657909393996,MATH 20E,A02,083772,Ganguly; Soumya,6,0,32,26
1657909393996,MATH 20E,B01,083773,Ciotti; Benjamin,20,0,35,15
1657909393996,MATH 20E,B02,083774,Ciotti; Benjamin,18,0,35,17
1657909400019,MATH 103A,A01,083777,Greenfeld; Be'Eri,3,0,36,33
1657909400019,MATH 103A,A02,083778,Greenfeld; Be'Eri,5,0,36,31
1657909400019,MATH 103A,A03,093561,Greenfeld; Be'Eri,6,0,36,30
1657909400019,MATH 103A,B01,083779,Greenfeld; Be'Eri,8,0,36,28
1657909400019,MATH 103A,B02,083780,Greenfeld; Be'Eri,4,0,36,32
1657909400019,MATH 103A,B03,093562,Greenfeld; Be'Eri,3,0,36,33
1657909406042,MATH 105,A01,085443,Carter; Anne Toulson,15,0,35,20
1657909406042,MATH 105,A02,093477,Carter; Anne Toulson,20,0,35,15
1657909412066,MATH 109,A01,083213,Ganzberger; Geoffrey Michael,3,0,34,31
1657909412066,MATH 109,A02,083214,Ganzberger; Geoffrey Michael,4,0,34,30
1657909412066,MATH 109,A03,093478,Ganzberger; Geoffrey Michael,2,0,34,32
1657909412066,MATH 109,B01,083215,Ganzberger; Geoffrey Michael,2,0,32,30
1657909412066,MATH 109,B02,083216,Ganzberger; Geoffrey Michael,2,0,32,30
1657909412066,MATH 109,B03,093479,Ganzberger; Geoffrey Michael,8,0,32,24
1657909418104,MATH 142A,A01,083219,Chow; Bennett,7,0,32,25
1657909418104,MATH 142A,A02,083220,Chow; Bennett,10,0,32,22
1657909418104,MATH 142A,A03,093480,Chow; Bennett,9,0,32,23
1657909418104,MATH 142A,B03,093481,Chow; Bennett,8,0,32,24
1657909418104,MATH 142A,B04,093558,Chow; Bennett,13,0,32,19
1657909418104,MATH 142A,B05,093559,Chow; Bennett,7,0,32,25
1657909424131,MATH 193A,A01,083224,Rotar; Vladimir,8,0,34,26
1657909424131,MATH 193A,A02,083225,Rotar; Vladimir,10,0,34,24
1657909424131,MATH 193A,A03,083781,Rotar; Vladimir,5,0,34,29
1657909424131,MATH 193A,A04,083782,Rotar; Vladimir,11,0,34,23
1657909424131,MATH 193A,A05,093482,Rotar; Vladimir,10,0,34,24
1657909430153,MATH 197,001,091859,McAuley; Julian John,9999,0,9999,0
1657909430153,MATH 197,002,095566,Kedlaya; Kiran S.,9997,0,9999,2
1657909430153,MATH 197,003,095567,Xiao; Ming,9999,0,9999,0
1657909430153,MATH 197,004,095571,Perols; Johan Lars,9998,0,9999,1
1657909437233,COGS 9,A01,083615,Shannon; Kyle Michael,10,0,75,65
1657909443254,COGS 11,A01,083617,Boyle; Mary E. T.,23,0,48,25
1657909449287,COGS 13,A01,083071,Bastos; Amalia Pinkusfeld,11,0,71,60
1657909455317,COGS 14A,A01,092681,Semenuks; Arturs,5,1,100,95
1657909461360,COGS 14B,A01,083073,Cheng; Tzu-Han,6,0,63,57
1657909467382,COGS 17,A01,092677,Semenuks; Arturs,6,0,81,75
1657909473419,COGS 100,A01,083619,Allen; Michael Gordon,17,0,70,53
1657909479449,COGS 101A,A01,083621,Davis; Joshua Daniel,9,0,68,59
1657909485545,COGS 101B,A01,091572,Allen; Michael Gordon,13,0,65,52
1657909491569,COGS 101C,A01,083625,Delgado; Tania,17,0,35,18
1657909497592,COGS 107A,A01,083627,Boyle; Mary E. T.,14,0,60,46
1657909503622,COGS 118A,A01,083075,Gupta; Anjum,21,0,76,55
1657909509648,CSE 3,A50,083646,Miranda; Gregory Joseph,24,0,50,26
1657909515670,CSE 8A,A50,083650,Miranda; Gregory Joseph,17,1,56,39
1657909521695,CSE 11,A01,083080,Cao; Yingjun,6,15,40,34
1657909527720,CSE 12,A01,083652,Krause-Levy; Sophia Louisa,30,1,120,90
1657909533743,CSE 15L,A01,083654,Morris; Justin Loren,9,0,50,41
1657909533743,CSE 15L,A02,083655,Morris; Justin Loren,10,0,50,40
1657909539766,CSE 20,A01,083657,Tran; Khoa Dang,39,0,80,41
1657909545796,CSE 21,A01,095574,Bach; Quang Tran,22,0,48,26
1657909551823,CSE 30,A01,083084,Eldon; John,6,0,80,74
1657909551823,CSE 30,B01,095061,Bhaskar; Nishant,9,0,50,41
1657909557847,CSE 100,A01,083659,Cao; Yingjun,5,4,70,65
1657909563869,CSE 134B,A01,083661,Powell; Thomas Allan,25,0,100,75
1657909569893,CSE 140,A01,083663,Gungor; Onat,16,0,85,69
1657909575919,CSE 140L,A01,083088,Eldon; John,23,0,100,77
1657909581941,CSE 175,A01,083665,Kumar; Rakesh,3,0,25,22
1657909587963,CSE 190,A00,092507,Dubnov; Shlomo,8,0,20,12
1657909593986,ECE 45,A01,083139,Congero; Spencer William,6,0,75,69
1657909600012,ECE 65,A50,083695,Saad; Andrew S,12,0,30,18
1657909600012,ECE 65,A51,095125,Saad; Andrew S,24,0,26,2
1657909606040,ECE 109,A01,091882,Touri; Behrouz,20,0,70,50
1657909612065,ECE 180,A00,083140,Abi Samra; Nicholas Camill,1,0,30,29
1657909612065,ECE 180,B00,083141,Abi Samra; Nicholas Camill,0,0,30,30
1657909618092,MATH 10A,A01,083735,Patchell; Gregory David,2,0,30,28
1657909618092,MATH 10A,A02,083736,Patchell; Gregory David,20,0,30,10
1657909618092,MATH 10A,A03,083737,Patchell; Gregory David,16,0,30,14
1657909624120,MATH 10B,A01,083207,Lim; Seonhee,8,0,34,26
1657909624120,MATH 10B,A02,083208,Lim; Seonhee,10,0,35,25
1657909624120,MATH 10B,A03,093472,Lim; Seonhee,7,0,34,27
1657909624120,MATH 10B,B01,083739,Sinha; Shubham,14,0,30,16
1657909630157,MATH 18,A01,083743,Cinel; Cameron Alexander,9,0,30,21
1657909630157,MATH 18,A02,083744,Cinel; Cameron Alexander,18,0,30,12
1657909630157,MATH 18,A03,083745,Cinel; Cameron Alexander,10,0,30,20
1657909630157,MATH 18,B01,083748,Rideout; David Porter,5,0,37,32
1657909630157,MATH 18,B02,083749,Rideout; David Porter,5,0,36,31
1657909630157,MATH 18,B03,083750,Rideout; David Porter,3,0,37,34
1657909630157,MATH 18,B04,083751,Rideout; David Porter,6,0,36,30
1657909630157,MATH 18,B05,093473,Rideout; David Porter,7,0,36,29
1657909630157,MATH 18,B06,093474,Rideout; David Porter,6,0,36,30
1657909636184,MATH 20A,A01,083754,Zheng; Zequn,14,0,40,26
1657909642209,MATH 20B,A01,083756,Briones; Jor-el Thomas Caparas,4,0,36,32
1657909642209,MATH 20B,A02,083757,Briones; Jor-el Thomas Caparas,1,0,36,35
1657909642209,MATH 20B,A03,093475,Briones; Jor-el Thomas Caparas,2,0,36,34
1657909648237,MATH 20C,A01,083760,Briones; Jor-el Thomas Caparas,1,0,35,34
1657909648237,MATH 20C,A02,083761,Briones; Jor-el Thomas Caparas,8,0,35,27
1657909648237,MATH 20C,A03,093476,Briones; Jor-el Thomas Caparas,0,1,36,36
1657909648237,MATH 20C,B01,083762,Bach; Quang Tran,1,0,30,29
1657909654262,MATH 20D,A01,083765,Tran; Brian Kha,5,0,30,25
1657909654262,MATH 20D,A02,083766,Tran; Brian Kha,5,0,30,25
1657909654262,MATH 20D,A03,083767,Tran; Brian Kha,5,0,30,25
1657909660289,MATH 20E,A01,083771,Ganguly; Soumya,10,0,32,22
1657909660289,MATH 20E,A02,083772,Ganguly; Soumya,6,0,32,26
1657909660289,MATH 20E,B01,083773,Ciotti; Benjamin,20,0,35,15
1657909660289,MATH 20E,B02,083774,Ciotti; Benjamin,18,0,35,17
1657909666312,MATH 103A,A01,083777,Greenfeld; Be'Eri,3,0,36,33
1657909666312,MATH 103A,A02,083778,Greenfeld; Be'Eri,5,0,36,31
1657909666312,MATH 103A,A03,093561,Greenfeld; Be'Eri,6,0,36,30
1657909666312,MATH 103A,B01,083779,Greenfeld; Be'Eri,8,0,36,28
1657909666312,MATH 103A,B02,083780,Greenfeld; Be'Eri,4,0,36,32
1657909666312,MATH 103A,B03,093562,Greenfeld; Be'Eri,3,0,36,33
1657909672341,MATH 105,A01,085443,Carter; Anne Toulson,15,0,35,20
1657909672341,MATH 105,A02,093477,Carter; Anne Toulson,20,0,35,15
1657909678372,MATH 109,A01,083213,Ganzberger; Geoffrey Michael,3,0,34,31
1657909678372,MATH 109,A02,083214,Ganzberger; Geoffrey Michael,4,0,34,30
1657909678372,MATH 109,A03,093478,Ganzberger; Geoffrey Michael,2,0,34,32
1657909678372,MATH 109,B01,083215,Ganzberger; Geoffrey Michael,2,0,32,30
1657909678372,MATH 109,B02,083216,Ganzberger; Geoffrey Michael,2,0,32,30
1657909678372,MATH 109,B03,093479,Ganzberger; Geoffrey Michael,8,0,32,24
1657909684400,MATH 142A,A01,083219,Chow; Bennett,7,0,32,25
1657909684400,MATH 142A,A02,083220,Chow; Bennett,10,0,32,22
1657909684400,MATH 142A,A03,093480,Chow; Bennett,9,0,32,23
1657909684400,MATH 142A,B03,093481,Chow; Bennett,8,0,32,24
1657909684400,MATH 142A,B04,093558,Chow; Bennett,13,0,32,19
1657909684400,MATH 142A,B05,093559,Chow; Bennett,7,0,32,25
1657909690427,MATH 193A,A01,083224,Rotar; Vladimir,8,0,34,26
1657909690427,MATH 193A,A02,083225,Rotar; Vladimir,10,0,34,24
1657909690427,MATH 193A,A03,083781,Rotar; Vladimir,5,0,34,29
1657909690427,MATH 193A,A04,083782,Rotar; Vladimir,11,0,34,23
1657909690427,MATH 193A,A05,093482,Rotar; Vladimir,10,0,34,24
1657909696460,MATH 197,001,091859,McAuley; Julian John,9999,0,9999,0
1657909696460,MATH 197,002,095566,Kedlaya; Kiran S.,9997,0,9999,2
1657909696460,MATH 197,003,095567,Xiao; Ming,9999,0,9999,0
1657909696460,MATH 197,004,095571,Perols; Johan Lars,9998,0,9999,1
1657909703522,COGS 9,A01,083615,Shannon; Kyle Michael,10,0,75,65
1657909709545,COGS 11,A01,083617,Boyle; Mary E. T.,23,0,48,25
1657909715567,COGS 13,A01,083071,Bastos; Amalia Pinkusfeld,11,0,71,60
1657909721592,COGS 14A,A01,092681,Semenuks; Arturs,5,1,100,95
1657909727615,COGS 14B,A01,083073,Cheng; Tzu-Han,6,0,63,57
1657909733648,COGS 17,A01,092677,Semenuks; Arturs,6,0,81,75
1657909739684,COGS 100,A01,083619,Allen; Michael Gordon,17,0,70,53
1657909745711,COGS 101A,A01,083621,Davis; Joshua Daniel,9,0,68,59
1657909751741,COGS 101B,A01,091572,Allen; Michael Gordon,13,0,65,52
1657909757774,COGS 101C,A01,083625,Delgado; Tania,17,0,35,18
1657909763808,COGS 107A,A01,083627,Boyle; Mary E. T.,14,0,60,46
1657909769840,COGS 118A,A01,083075,Gupta; Anjum,21,0,76,55
1657909775865,CSE 3,A50,083646,Miranda; Gregory Joseph,24,0,50,26
1657909781892,CSE 8A,A50,083650,Miranda; Gregory Joseph,17,1,56,39
1657909787925,CSE 11,A01,083080,Cao; Yingjun,6,15,40,34
1657909793967,CSE 12,A01,083652,Krause-Levy; Sophia Louisa,30,1,120,90
1657909799995,CSE 15L,A01,083654,Morris; Justin Loren,9,0,50,41
1657909799995,CSE 15L,A02,083655,Morris; Justin Loren,10,0,50,40
1657909806021,CSE 20,A01,083657,Tran; Khoa Dang,39,0,80,41
1657909812047,CSE 21,A01,095574,Bach; Quang Tran,22,0,48,26
1657909818070,CSE 30,A01,083084,Eldon; John,6,0,80,74
1657909818070,CSE 30,B01,095061,Bhaskar; Nishant,9,0,50,41
1657909824094,CSE 100,A01,083659,Cao; Yingjun,5,4,70,65
1657909830122,CSE 134B,A01,083661,Powell; Thomas Allan,25,0,100,75
1657909836153,CSE 140,A01,083663,Gungor; Onat,16,0,85,69
1657909842176,CSE 140L,A01,083088,Eldon; John,23,0,100,77
1657909848205,CSE 175,A01,083665,Kumar; Rakesh,3,0,25,22
1657909854229,CSE 190,A00,092507,Dubnov; Shlomo,8,0,20,12
1657909860254,ECE 45,A01,083139,Congero; Spencer William,6,0,75,69
1657909866280,ECE 65,A50,083695,Saad; Andrew S,12,0,30,18
1657909866280,ECE 65,A51,095125,Saad; Andrew S,24,0,26,2
1657909872303,ECE 109,A01,091882,Touri; Behrouz,20,0,70,50
1657909878346,ECE 180,A00,083140,Abi Samra; Nicholas Camill,1,0,30,29
1657909878346,ECE 180,B00,083141,Abi Samra; Nicholas Camill,0,0,30,30
1657909884372,MATH 10A,A01,083735,Patchell; Gregory David,2,0,30,28
1657909884372,MATH 10A,A02,083736,Patchell; Gregory David,20,0,30,10
1657909884372,MATH 10A,A03,083737,Patchell; Gregory David,16,0,30,14
1657909890396,MATH 10B,A01,083207,Lim; Seonhee,8,0,34,26
1657909890396,MATH 10B,A02,083208,Lim; Seonhee,10,0,35,25
1657909890396,MATH 10B,A03,093472,Lim; Seonhee,7,0,34,27
1657909890396,MATH 10B,B01,083739,Sinha; Shubham,14,0,30,16
1657909896422,MATH 18,A01,083743,Cinel; Cameron Alexander,9,0,30,21
1657909896422,MATH 18,A02,083744,Cinel; Cameron Alexander,18,0,30,12
1657909896422,MATH 18,A03,083745,Cinel; Cameron Alexander,10,0,30,20
1657909896422,MATH 18,B01,083748,Rideout; David Porter,5,0,37,32
1657909896422,MATH 18,B02,083749,Rideout; David Porter,5,0,36,31
1657909896422,MATH 18,B03,083750,Rideout; David Porter,3,0,37,34
1657909896422,MATH 18,B04,083751,Rideout; David Porter,6,0,36,30
1657909896422,MATH 18,B05,093473,Rideout; David Porter,7,0,36,29
1657909896422,MATH 18,B06,093474,Rideout; David Porter,6,0,36,30
1657909902455,MATH 20A,A01,083754,Zheng; Zequn,14,0,40,26
1657909908478,MATH 20B,A01,083756,Briones; Jor-el Thomas Caparas,4,0,36,32
1657909908478,MATH 20B,A02,083757,Briones; Jor-el Thomas Caparas,1,0,36,35
1657909908478,MATH 20B,A03,093475,Briones; Jor-el Thomas Caparas,2,0,36,34
1657909914509,MATH 20C,A01,083760,Briones; Jor-el Thomas Caparas,1,0,35,34
1657909914509,MATH 20C,A02,083761,Briones; Jor-el Thomas Caparas,8,0,35,27
1657909914509,MATH 20C,A03,093476,Briones; Jor-el Thomas Caparas,0,1,36,36
1657909914509,MATH 20C,B01,083762,Bach; Quang Tran,1,0,30,29
1657909920532,MATH 20D,A01,083765,Tran; Brian Kha,5,0,30,25
1657909920532,MATH 20D,A02,083766,Tran; Brian Kha,5,0,30,25
1657909920532,MATH 20D,A03,083767,Tran; Brian Kha,5,0,30,25
1657909926557,MATH 20E,A01,083771,Ganguly; Soumya,10,0,32,22
1657909926557,MATH 20E,A02,083772,Ganguly; Soumya,6,0,32,26
1657909926557,MATH 20E,B01,083773,Ciotti; Benjamin,20,0,35,15
1657909926557,MATH 20E,B02,083774,Ciotti; Benjamin,18,0,35,17
1657909932581,MATH 103A,A01,083777,Greenfeld; Be'Eri,3,0,36,33
1657909932581,MATH 103A,A02,083778,Greenfeld; Be'Eri,5,0,36,31
1657909932581,MATH 103A,A03,093561,Greenfeld; Be'Eri,6,0,36,30
1657909932581,MATH 103A,B01,083779,Greenfeld; Be'Eri,8,0,36,28
1657909932581,MATH 103A,B02,083780,Greenfeld; Be'Eri,4,0,36,32
1657909932581,MATH 103A,B03,093562,Greenfeld; Be'Eri,3,0,36,33
1657909938630,MATH 105,A01,085443,Carter; Anne Toulson,15,0,35,20
1657909938630,MATH 105,A02,093477,Carter; Anne Toulson,20,0,35,15
1657909944664,MATH 109,A01,083213,Ganzberger; Geoffrey Michael,3,0,34,31
1657909944664,MATH 109,A02,083214,Ganzberger; Geoffrey Michael,4,0,34,30
1657909944664,MATH 109,A03,093478,Ganzberger; Geoffrey Michael,2,0,34,32
1657909944664,MATH 109,B01,083215,Ganzberger; Geoffrey Michael,2,0,32,30
1657909944664,MATH 109,B02,083216,Ganzberger; Geoffrey Michael,2,0,32,30
1657909944664,MATH 109,B03,093479,Ganzberger; Geoffrey Michael,8,0,32,24
1657909950687,MATH 142A,A01,083219,Chow; Bennett,7,0,32,25
1657909950687,MATH 142A,A02,083220,Chow; Bennett,10,0,32,22
1657909950687,MATH 142A,A03,093480,Chow; Bennett,9,0,32,23
1657909950687,MATH 142A,B03,093481,Chow; Bennett,8,0,32,24
1657909950687,MATH 142A,B04,093558,Chow; Bennett,13,0,32,19
1657909950687,MATH 142A,B05,093559,Chow; Bennett,7,0,32,25
1657909956712,MATH 193A,A01,083224,Rotar; Vladimir,8,0,34,26
1657909956712,MATH 193A,A02,083225,Rotar; Vladimir,10,0,34,24
1657909956712,MATH 193A,A03,083781,Rotar; Vladimir,5,0,34,29
1657909956712,MATH 193A,A04,083782,Rotar; Vladimir,11,0,34,23
1657909956712,MATH 193A,A05,093482,Rotar; Vladimir,10,0,34,24
1657909962734,MATH 197,001,091859,McAuley; Julian John,9999,0,9999,0
1657909962734,MATH 197,002,095566,Kedlaya; Kiran S.,9997,0,9999,2
1657909962734,MATH 197,003,095567,Xiao; Ming,9999,0,9999,0
1657909962734,MATH 197,004,095571,Perols; Johan Lars,9998,0,9999,1
1657909969802,COGS 9,A01,083615,Shannon; Kyle Michael,10,0,75,65
1657909975832,COGS 11,A01,083617,Boyle; Mary E. T.,23,0,48,25
1657909981862,COGS 13,A01,083071,Bastos; Amalia Pinkusfeld,11,0,71,60
1657909987886,COGS 14A,A01,092681,Semenuks; Arturs,5,1,100,95
1657909993915,COGS 14B,A01,083073,Cheng; Tzu-Han,6,0,63,57
1657909999939,COGS 17,A01,092677,Semenuks; Arturs,6,0,81,75
1657910005965,COGS 100,A01,083619,Allen; Michael Gordon,17,0,70,53
1657910011988,COGS 101A,A01,083621,Davis; Joshua Daniel,9,0,68,59
1657910018012,COGS 101B,A01,091572,Allen; Michael Gordon,13,0,65,52
1657910024039,COGS 101C,A01,083625,Delgado; Tania,17,0,35,18
1657910030073,COGS 107A,A01,083627,Boyle; Mary E. T.,14,0,60,46
1657910036096,COGS 118A,A01,083075,Gupta; Anjum,21,0,76,55
1657910042118,CSE 3,A50,083646,Miranda; Gregory Joseph,24,0,50,26
1657910048140,CSE 8A,A50,083650,Miranda; Gregory Joseph,17,1,56,39
1657910054162,CSE 11,A01,083080,Cao; Yingjun,6,15,40,34
1657910060186,CSE 12,A01,083652,Krause-Levy; Sophia Louisa,30,1,120,90
1657910066209,CSE 15L,A01,083654,Morris; Justin Loren,9,0,50,41
1657910066209,CSE 15L,A02,083655,Morris; Justin Loren,10,0,50,40
1657910072233,CSE 20,A01,083657,Tran; Khoa Dang,39,0,80,41
1657910078257,CSE 21,A01,095574,Bach; Quang Tran,22,0,48,26
1657910084356,CSE 30,A01,083084,Eldon; John,6,0,80,74
1657910084356,CSE 30,B01,095061,Bhaskar; Nishant,9,0,50,41
1657910090382,CSE 100,A01,083659,Cao; Yingjun,5,4,70,65
1657910096409,CSE 134B,A01,083661,Powell; Thomas Allan,25,0,100,75
1657910102435,CSE 140,A01,083663,Gungor; Onat,16,0,85,69
1657910108460,CSE 140L,A01,083088,Eldon; John,23,0,100,77
1657910114485,CSE 175,A01,083665,Kumar; Rakesh,3,0,25,22
1657910120511,CSE 190,A00,092507,Dubnov; Shlomo,8,0,20,12
1657910126537,ECE 45,A01,083139,Congero; Spencer William,6,0,75,69
1657910132564,ECE 65,A50,083695,Saad; Andrew S,12,0,30,18
1657910132564,ECE 65,A51,095125,Saad; Andrew S,24,0,26,2
1657910138589,ECE 109,A01,091882,Touri; Behrouz,20,0,70,50
1657910144615,ECE 180,A00,083140,Abi Samra; Nicholas Camill,1,0,30,29
1657910144615,ECE 180,B00,083141,Abi Samra; Nicholas Camill,0,0,30,30
1657910150653,MATH 10A,A01,083735,Patchell; Gregory David,2,0,30,28
1657910150653,MATH 10A,A02,083736,Patchell; Gregory David,20,0,30,10
1657910150653,MATH 10A,A03,083737,Patchell; Gregory David,16,0,30,14
1657910156688,MATH 10B,A01,083207,Lim; Seonhee,8,0,34,26
1657910156688,MATH 10B,A02,083208,Lim; Seonhee,10,0,35,25
1657910156688,MATH 10B,A03,093472,Lim; Seonhee,7,0,34,27
1657910156688,MATH 10B,B01,083739,Sinha; Shubham,14,0,30,16
1657910162721,MATH 18,A01,083743,Cinel; Cameron Alexander,9,0,30,21
1657910162721,MATH 18,A02,083744,Cinel; Cameron Alexander,18,0,30,12
1657910162721,MATH 18,A03,083745,Cinel; Cameron Alexander,10,0,30,20
1657910162721,MATH 18,B01,083748,Rideout; David Porter,5,0,37,32
1657910162721,MATH 18,B02,083749,Rideout; David Porter,5,0,36,31
1657910162721,MATH 18,B03,083750,Rideout; David Porter,3,0,37,34
1657910162721,MATH 18,B04,083751,Rideout; David Porter,6,0,36,30
1657910162721,MATH 18,B05,093473,Rideout; David Porter,7,0,36,29
1657910162721,MATH 18,B06,093474,Rideout; David Porter,6,0,36,30
1657910168762,MATH 20A,A01,083754,Zheng; Zequn,14,0,40,26
1657910174785,MATH 20B,A01,083756,Briones; Jor-el Thomas Caparas,4,0,36,32
1657910174785,MATH 20B,A02,083757,Briones; Jor-el Thomas Caparas,1,0,36,35
1657910174785,MATH 20B,A03,093475,Briones; Jor-el Thomas Caparas,2,0,36,34
1657910180820,MATH 20C,A01,083760,Briones; Jor-el Thomas Caparas,1,0,35,34
1657910180820,MATH 20C,A02,083761,Briones; Jor-el Thomas Caparas,8,0,35,27
1657910180820,MATH 20C,A03,093476,Briones; Jor-el Thomas Caparas,0,1,36,36
1657910180820,MATH 20C,B01,083762,Bach; Quang Tran,1,0,30,29
1657910186847,MATH 20D,A01,083765,Tran; Brian Kha,5,0,30,25
1657910186847,MATH 20D,A02,083766,Tran; Brian Kha,5,0,30,25
1657910186847,MATH 20D,A03,083767,Tran; Brian Kha,5,0,30,25
1657910192874,MATH 20E,A01,083771,Ganguly; Soumya,10,0,32,22
1657910192874,MATH 20E,A02,083772,Ganguly; Soumya,6,0,32,26
1657910192874,MATH 20E,B01,083773,Ciotti; Benjamin,20,0,35,15
1657910192874,MATH 20E,B02,083774,Ciotti; Benjamin,18,0,35,17
1657910198899,MATH 103A,A01,083777,Greenfeld; Be'Eri,3,0,36,33
1657910198899,MATH 103A,A02,083778,Greenfeld; Be'Eri,5,0,36,31
1657910198899,MATH 103A,A03,093561,Greenfeld; Be'Eri,6,0,36,30
1657910198899,MATH 103A,B01,083779,Greenfeld; Be'Eri,8,0,36,28
1657910198899,MATH 103A,B02,083780,Greenfeld; Be'Eri,4,0,36,32
1657910198899,MATH 103A,B03,093562,Greenfeld; Be'Eri,3,0,36,33
1657910204921,MATH 105,A01,085443,Carter; Anne Toulson,15,0,35,20
1657910204921,MATH 105,A02,093477,Carter; Anne Toulson,20,0,35,15
1657910210943,MATH 109,A01,083213,Ganzberger; Geoffrey Michael,3,0,34,31
1657910210943,MATH 109,A02,083214,Ganzberger; Geoffrey Michael,4,0,34,30
1657910210943,MATH 109,A03,093478,Ganzberger; Geoffrey Michael,2,0,34,32
1657910210943,MATH 109,B01,083215,Ganzberger; Geoffrey Michael,2,0,32,30
1657910210943,MATH 109,B02,083216,Ganzberger; Geoffrey Michael,2,0,32,30
1657910210943,MATH 109,B03,093479,Ganzberger; Geoffrey Michael,8,0,32,24
1657910216978,MATH 142A,A01,083219,Chow; Bennett,7,0,32,25
1657910216978,MATH 142A,A02,083220,Chow; Bennett,10,0,32,22
1657910216978,MATH 142A,A03,093480,Chow; Bennett,9,0,32,23
1657910216978,MATH 142A,B03,093481,Chow; Bennett,8,0,32,24
1657910216978,MATH 142A,B04,093558,Chow; Bennett,13,0,32,19
1657910216978,MATH 142A,B05,093559,Chow; Bennett,7,0,32,25
1657910223008,MATH 193A,A01,083224,Rotar; Vladimir,8,0,34,26
1657910223008,MATH 193A,A02,083225,Rotar; Vladimir,10,0,34,24
1657910223008,MATH 193A,A03,083781,Rotar; Vladimir,5,0,34,29
1657910223008,MATH 193A,A04,083782,Rotar; Vladimir,11,0,34,23
1657910223008,MATH 193A,A05,093482,Rotar; Vladimir,10,0,34,24
1657910229029,MATH 197,001,091859,McAuley; Julian John,9999,0,9999,0
1657910229029,MATH 197,002,095566,Kedlaya; Kiran S.,9997,0,9999,2
1657910229029,MATH 197,003,095567,Xiao; Ming,9999,0,9999,0
1657910229029,MATH 197,004,095571,Perols; Johan Lars,9998,0,9999,1
1657910236094,COGS 9,A01,083615,Shannon; Kyle Michael,10,0,75,65
1657910242122,COGS 11,A01,083617,Boyle; Mary E. T.,23,0,48,25
1657910248144,COGS 13,A01,083071,Bastos; Amalia Pinkusfeld,11,0,71,60
1657910254169,COGS 14A,A01,092681,Semenuks; Arturs,5,1,100,95
1657910260197,COGS 14B,A01,083073,Cheng; Tzu-Han,6,0,63,57
1657910266219,COGS 17,A01,092677,Semenuks; Arturs,6,0,81,75
1657910272258,COGS 100,A01,083619,Allen; Michael Gordon,17,0,70,53
1657910278284,COGS 101A,A01,083621,Davis; Joshua Daniel,9,0,68,59
1657910284311,COGS 101B,A01,091572,Allen; Michael Gordon,13,0,65,52
1657910290347,COGS 101C,A01,083625,Delgado; Tania,17,0,35,18
1657910296373,COGS 107A,A01,083627,Boyle; Mary E. T.,14,0,60,46
1657910302395,COGS 118A,A01,083075,Gupta; Anjum,21,0,76,55
1657910308425,CSE 3,A50,083646,Miranda; Gregory Joseph,24,0,50,26
1657910314447,CSE 8A,A50,083650,Miranda; Gregory Joseph,17,1,56,39
1657910320475,CSE 11,A01,083080,Cao; Yingjun,6,15,40,34
1657910326504,CSE 12,A01,083652,Krause-Levy; Sophia Louisa,30,1,120,90
1657910332530,CSE 15L,A01,083654,Morris; Justin Loren,9,0,50,41
1657910332530,CSE 15L,A02,083655,Morris; Justin Loren,10,0,50,40
1657910338554,CSE 20,A01,083657,Tran; Khoa Dang,39,0,80,41
1657910344581,CSE 21,A01,095574,Bach; Quang Tran,22,0,48,26
1657910350605,CSE 30,A01,083084,Eldon; John,6,0,80,74
1657910350605,CSE 30,B01,095061,Bhaskar; Nishant,9,0,50,41
1657910356631,CSE 100,A01,083659,Cao; Yingjun,5,4,70,65
1657910362659,CSE 134B,A01,083661,Powell; Thomas Allan,25,0,100,75
1657910368680,CSE 140,A01,083663,Gungor; Onat,16,0,85,69
1657910374706,CSE 140L,A01,083088,Eldon; John,23,0,100,77
1657910380746,CSE 175,A01,083665,Kumar; Rakesh,3,0,25,22
1657910386771,CSE 190,A00,092507,Dubnov; Shlomo,8,0,20,12
1657910392799,ECE 45,A01,083139,Congero; Spencer William,6,0,75,69
1657910398826,ECE 65,A50,083695,Saad; Andrew S,12,0,30,18
1657910398826,ECE 65,A51,095125,Saad; Andrew S,24,0,26,2
1657910404848,ECE 109,A01,091882,Touri; Behrouz,20,0,70,50
1657910410874,ECE 180,A00,083140,Abi Samra; Nicholas Camill,1,0,30,29
1657910410874,ECE 180,B00,083141,Abi Samra; Nicholas Camill,0,0,30,30
1657910416902,MATH 10A,A01,083735,Patchell; Gregory David,2,0,30,28
1657910416902,MATH 10A,A02,083736,Patchell; Gregory David,20,0,30,10
1657910416902,MATH 10A,A03,083737,Patchell; Gregory David,16,0,30,14
1657910422925,MATH 10B,A01,083207,Lim; Seonhee,8,0,34,26
1657910422925,MATH 10B,A02,083208,Lim; Seonhee,10,0,35,25
1657910422925,MATH 10B,A03,093472,Lim; Seonhee,7,0,34,27
1657910422925,MATH 10B,B01,083739,Sinha; Shubham,14,0,30,16
1657910428961,MATH 18,A01,083743,Cinel; Cameron Alexander,9,0,30,21
1657910428961,MATH 18,A02,083744,Cinel; Cameron Alexander,18,0,30,12
1657910428961,MATH 18,A03,083745,Cinel; Cameron Alexander,10,0,30,20
1657910428961,MATH 18,B01,083748,Rideout; David Porter,5,0,37,32
1657910428961,MATH 18,B02,083749,Rideout; David Porter,5,0,36,31
1657910428961,MATH 18,B03,083750,Rideout; David Porter,3,0,37,34
1657910428961,MATH 18,B04,083751,Rideout; David Porter,6,0,36,30
1657910428961,MATH 18,B05,093473,Rideout; David Porter,7,0,36,29
1657910428961,MATH 18,B06,093474,Rideout; David Porter,6,0,36,30
1657910434992,MATH 20A,A01,083754,Zheng; Zequn,14,0,40,26
1657910441019,MATH 20B,A01,083756,Briones; Jor-el Thomas Caparas,4,0,36,32
1657910441019,MATH 20B,A02,083757,Briones; Jor-el Thomas Caparas,1,0,36,35
1657910441019,MATH 20B,A03,093475,Briones; Jor-el Thomas Caparas,2,0,36,34
1657910447044,MATH 20C,A01,083760,Briones; Jor-el Thomas Caparas,1,0,35,34
1657910447044,MATH 20C,A02,083761,Briones; Jor-el Thomas Caparas,8,0,35,27
1657910447044,MATH 20C,A03,093476,Briones; Jor-el Thomas Caparas,0,1,36,36
1657910447044,MATH 20C,B01,083762,Bach; Quang Tran,1,0,30,29
1657910453067,MATH 20D,A01,083765,Tran; Brian Kha,5,0,30,25
1657910453067,MATH 20D,A02,083766,Tran; Brian Kha,5,0,30,25
1657910453067,MATH 20D,A03,083767,Tran; Brian Kha,6,0,30,24
1657910459101,MATH 20E,A01,083771,Ganguly; Soumya,10,0,32,22
1657910459101,MATH 20E,A02,083772,Ganguly; Soumya,6,0,32,26
1657910459101,MATH 20E,B01,083773,Ciotti; Benjamin,20,0,35,15
1657910459101,MATH 20E,B02,083774,Ciotti; Benjamin,18,0,35,17
1657910465125,MATH 103A,A01,083777,Greenfeld; Be'Eri,3,0,36,33
1657910465125,MATH 103A,A02,083778,Greenfeld; Be'Eri,5,0,36,31
1657910465125,MATH 103A,A03,093561,Greenfeld; Be'Eri,6,0,36,30
1657910465125,MATH 103A,B01,083779,Greenfeld; Be'Eri,8,0,36,28
1657910465125,MATH 103A,B02,083780,Greenfeld; Be'Eri,4,0,36,32
1657910465125,MATH 103A,B03,093562,Greenfeld; Be'Eri,3,0,36,33
1657910471151,MATH 105,A01,085443,Carter; Anne Toulson,15,0,35,20
1657910471151,MATH 105,A02,093477,Carter; Anne Toulson,20,0,35,15
1657910477179,MATH 109,A01,083213,Ganzberger; Geoffrey Michael,3,0,34,31
1657910477179,MATH 109,A02,083214,Ganzberger; Geoffrey Michael,4,0,34,30
1657910477179,MATH 109,A03,093478,Ganzberger; Geoffrey Michael,2,0,34,32
1657910477179,MATH 109,B01,083215,Ganzberger; Geoffrey Michael,2,0,32,30
1657910477179,MATH 109,B02,083216,Ganzberger; Geoffrey Michael,2,0,32,30
1657910477179,MATH 109,B03,093479,Ganzberger; Geoffrey Michael,8,0,32,24
1657910483207,MATH 142A,A01,083219,Chow; Bennett,7,0,32,25
1657910483207,MATH 142A,A02,083220,Chow; Bennett,10,0,32,22
1657910483207,MATH 142A,A03,093480,Chow; Bennett,9,0,32,23
1657910483207,MATH 142A,B03,093481,Chow; Bennett,8,0,32,24
1657910483207,MATH 142A,B04,093558,Chow; Bennett,13,0,32,19
1657910483207,MATH 142A,B05,093559,Chow; Bennett,7,0,32,25
1657910489231,MATH 193A,A01,083224,Rotar; Vladimir,8,0,34,26
1657910489231,MATH 193A,A02,083225,Rotar; Vladimir,10,0,34,24
1657910489231,MATH 193A,A03,083781,Rotar; Vladimir,5,0,34,29
1657910489231,MATH 193A,A04,083782,Rotar; Vladimir,11,0,34,23
1657910489231,MATH 193A,A05,093482,Rotar; Vladimir,11,0,34,23
1657910495257,MATH 197,001,091859,McAuley; Julian John,9999,0,9999,0
1657910495257,MATH 197,002,095566,Kedlaya; Kiran S.,9997,0,9999,2
1657910495257,MATH 197,003,095567,Xiao; Ming,9999,0,9999,0
1657910495257,MATH 197,004,095571,Perols; Johan Lars,9998,0,9999,1
1657910502330,COGS 9,A01,083615,Shannon; Kyle Michael,10,0,75,65
1657910508354,COGS 11,A01,083617,Boyle; Mary E. T.,23,0,48,25
1657910514380,COGS 13,A01,083071,Bastos; Amalia Pinkusfeld,11,0,71,60
1657910520403,COGS 14A,A01,092681,Semenuks; Arturs,5,1,100,95
1657910526427,COGS 14B,A01,083073,Cheng; Tzu-Han,6,0,63,57
1657910532451,COGS 17,A01,092677,Semenuks; Arturs,6,0,81,75
1657910538475,COGS 100,A01,083619,Allen; Michael Gordon,17,0,70,53
1657910544503,COGS 101A,A01,083621,Davis; Joshua Daniel,9,0,68,59
1657910550528,COGS 101B,A01,091572,Allen; Michael Gordon,13,0,65,52
1657910556555,COGS 101C,A01,083625,Delgado; Tania,17,0,35,18
1657910562580,COGS 107A,A01,083627,Boyle; Mary E. T.,14,0,60,46
1657910568602,COGS 118A,A01,083075,Gupta; Anjum,21,0,76,55
1657910574626,CSE 3,A50,083646,Miranda; Gregory Joseph,24,0,50,26
1657910580653,CSE 8A,A50,083650,Miranda; Gregory Joseph,17,1,56,39
1657910586680,CSE 11,A01,083080,Cao; Yingjun,6,15,40,34
1657910592703,CSE 12,A01,083652,Krause-Levy; Sophia Louisa,30,1,120,90
1657910598727,CSE 15L,A01,083654,Morris; Justin Loren,9,0,50,41
1657910598727,CSE 15L,A02,083655,Morris; Justin Loren,10,0,50,40
1657910604753,CSE 20,A01,083657,Tran; Khoa Dang,39,0,80,41
1657910610777,CSE 21,A01,095574,Bach; Quang Tran,22,0,48,26
1657910616802,CSE 30,A01,083084,Eldon; John,6,0,80,74
1657910616802,CSE 30,B01,095061,Bhaskar; Nishant,9,0,50,41
1657910622826,CSE 100,A01,083659,Cao; Yingjun,5,4,70,65
1657910628853,CSE 134B,A01,083661,Powell; Thomas Allan,25,0,100,75
1657910634882,CSE 140,A01,083663,Gungor; Onat,16,0,85,69
1657910640905,CSE 140L,A01,083088,Eldon; John,23,0,100,77
1657910646930,CSE 175,A01,083665,Kumar; Rakesh,3,0,25,22
1657910652963,CSE 190,A00,092507,Dubnov; Shlomo,8,0,20,12
1657910658988,ECE 45,A01,083139,Congero; Spencer William,6,0,75,69
1657910665014,ECE 65,A50,083695,Saad; Andrew S,12,0,30,18
1657910665014,ECE 65,A51,095125,Saad; Andrew S,24,0,26,2
1657910671037,ECE 109,A01,091882,Touri; Behrouz,20,0,70,50
1657910677066,ECE 180,A00,083140,Abi Samra; Nicholas Camill,1,0,30,29
1657910677066,ECE 180,B00,083141,Abi Samra; Nicholas Camill,0,0,30,30
1657910683162,MATH 10A,A01,083735,Patchell; Gregory David,2,0,30,28
1657910683162,MATH 10A,A02,083736,Patchell; Gregory David,20,0,30,10
1657910683162,MATH 10A,A03,083737,Patchell; Gregory David,16,0,30,14
1657910689197,MATH 10B,A01,083207,Lim; Seonhee,8,0,34,26
1657910689197,MATH 10B,A02,083208,Lim; Seonhee,10,0,35,25
1657910689197,MATH 10B,A03,093472,Lim; Seonhee,7,0,34,27
1657910689197,MATH 10B,B01,083739,Sinha; Shubham,14,0,30,16
1657910695222,MATH 18,A01,083743,Cinel; Cameron Alexander,9,0,30,21
1657910695222,MATH 18,A02,083744,Cinel; Cameron Alexander,18,0,30,12
1657910695222,MATH 18,A03,083745,Cinel; Cameron Alexander,10,0,30,20
1657910695222,MATH 18,B01,083748,Rideout; David Porter,5,0,37,32
1657910695222,MATH 18,B02,083749,Rideout; David Porter,5,0,36,31
1657910695222,MATH 18,B03,083750,Rideout; David Porter,3,0,37,34
1657910695222,MATH 18,B04,083751,Rideout; David Porter,6,0,36,30
1657910695222,MATH 18,B05,093473,Rideout; David Porter,7,0,36,29
1657910695222,MATH 18,B06,093474,Rideout; David Porter,6,0,36,30
1657910701254,MATH 20A,A01,083754,Zheng; Zequn,14,0,40,26
1657910707276,MATH 20B,A01,083756,Briones; Jor-el Thomas Caparas,4,0,36,32
1657910707276,MATH 20B,A02,083757,Briones; Jor-el Thomas Caparas,1,0,36,35
1657910707276,MATH 20B,A03,093475,Briones; Jor-el Thomas Caparas,2,0,36,34
1657910713304,MATH 20C,A01,083760,Briones; Jor-el Thomas Caparas,1,0,35,34
1657910713304,MATH 20C,A02,083761,Briones; Jor-el Thomas Caparas,8,0,35,27
1657910713304,MATH 20C,A03,093476,Briones; Jor-el Thomas Caparas,0,1,36,36
1657910713304,MATH 20C,B01,083762,Bach; Quang Tran,1,0,30,29
1657910719328,MATH 20D,A01,083765,Tran; Brian Kha,5,0,30,25
1657910719328,MATH 20D,A02,083766,Tran; Brian Kha,5,0,30,25
1657910719328,MATH 20D,A03,083767,Tran; Brian Kha,6,0,30,24
1657910725353,MATH 20E,A01,083771,Ganguly; Soumya,10,0,32,22
1657910725353,MATH 20E,A02,083772,Ganguly; Soumya,7,0,32,25
1657910725353,MATH 20E,B01,083773,Ciotti; Benjamin,20,0,35,15
1657910725353,MATH 20E,B02,083774,Ciotti; Benjamin,18,0,35,17
1657910731383,MATH 103A,A01,083777,Greenfeld; Be'Eri,3,0,36,33
1657910731383,MATH 103A,A02,083778,Greenfeld; Be'Eri,5,0,36,31
1657910731383,MATH 103A,A03,093561,Greenfeld; Be'Eri,6,0,36,30
1657910731383,MATH 103A,B01,083779,Greenfeld; Be'Eri,8,0,36,28
1657910731383,MATH 103A,B02,083780,Greenfeld; Be'Eri,4,0,36,32
1657910731383,MATH 103A,B03,093562,Greenfeld; Be'Eri,3,0,36,33
1657910737410,MATH 105,A01,085443,Carter; Anne Toulson,15,0,35,20
1657910737410,MATH 105,A02,093477,Carter; Anne Toulson,20,0,35,15
1657910743451,MATH 109,A01,083213,Ganzberger; Geoffrey Michael,3,0,34,31
1657910743451,MATH 109,A02,083214,Ganzberger; Geoffrey Michael,4,0,34,30
1657910743451,MATH 109,A03,093478,Ganzberger; Geoffrey Michael,2,0,34,32
1657910743451,MATH 109,B01,083215,Ganzberger; Geoffrey Michael,2,0,32,30
1657910743451,MATH 109,B02,083216,Ganzberger; Geoffrey Michael,2,0,32,30
1657910743451,MATH 109,B03,093479,Ganzberger; Geoffrey Michael,8,0,32,24
1657910749477,MATH 142A,A01,083219,Chow; Bennett,7,0,32,25
1657910749477,MATH 142A,A02,083220,Chow; Bennett,10,0,32,22
1657910749477,MATH 142A,A03,093480,Chow; Bennett,9,0,32,23
1657910749477,MATH 142A,B03,093481,Chow; Bennett,8,0,32,24
1657910749477,MATH 142A,B04,093558,Chow; Bennett,13,0,32,19
1657910749477,MATH 142A,B05,093559,Chow; Bennett,7,0,32,25
1657910755499,MATH 193A,A01,083224,Rotar; Vladimir,8,0,34,26
1657910755499,MATH 193A,A02,083225,Rotar; Vladimir,10,0,34,24
1657910755499,MATH 193A,A03,083781,Rotar; Vladimir,5,0,34,29
1657910755499,MATH 193A,A04,083782,Rotar; Vladimir,11,0,34,23
1657910755499,MATH 193A,A05,093482,Rotar; Vladimir,11,0,34,23
1657910761528,MATH 197,001,091859,McAuley; Julian John,9999,0,9999,0
1657910761528,MATH 197,002,095566,Kedlaya; Kiran S.,9997,0,9999,2
1657910761528,MATH 197,003,095567,Xiao; Ming,9999,0,9999,0
1657910761528,MATH 197,004,095571,Perols; Johan Lars,9998,0,9999,1
1657910768595,COGS 9,A01,083615,Shannon; Kyle Michael,10,0,75,65
1657910774621,COGS 11,A01,083617,Boyle; Mary E. T.,23,0,48,25
1657910780644,COGS 13,A01,083071,Bastos; Amalia Pinkusfeld,11,0,71,60
1657910786666,COGS 14A,A01,092681,Semenuks; Arturs,5,1,100,95
1657910792690,COGS 14B,A01,083073,Cheng; Tzu-Han,6,0,63,57
1657910798721,COGS 17,A01,092677,Semenuks; Arturs,6,0,81,75
1657910804762,COGS 100,A01,083619,Allen; Michael Gordon,17,0,70,53
1657910810789,COGS 101A,A01,083621,Davis; Joshua Daniel,9,0,68,59
1657910816814,COGS 101B,A01,091572,Allen; Michael Gordon,13,0,65,52
1657910822841,COGS 101C,A01,083625,Delgado; Tania,17,0,35,18
1657910828876,COGS 107A,A01,083627,Boyle; Mary E. T.,14,0,60,46
1657910834899,COGS 118A,A01,083075,Gupta; Anjum,21,0,76,55
1657910840923,CSE 3,A50,083646,Miranda; Gregory Joseph,24,0,50,26
1657910846954,CSE 8A,A50,083650,Miranda; Gregory Joseph,17,1,56,39
1657910852983,CSE 11,A01,083080,Cao; Yingjun,6,15,40,34
1657910859006,CSE 12,A01,083652,Krause-Levy; Sophia Louisa,30,1,120,90
1657910865033,CSE 15L,A01,083654,Morris; Justin Loren,9,0,50,41
1657910865033,CSE 15L,A02,083655,Morris; Justin Loren,10,0,50,40
1657910871062,CSE 20,A01,083657,Tran; Khoa Dang,39,0,80,41
1657910877102,CSE 21,A01,095574,Bach; Quang Tran,22,0,48,26
1657910883135,CSE 30,A01,083084,Eldon; John,6,0,80,74
1657910883135,CSE 30,B01,095061,Bhaskar; Nishant,9,0,50,41
1657910889168,CSE 100,A01,083659,Cao; Yingjun,5,4,70,65
1657910895198,CSE 134B,A01,083661,Powell; Thomas Allan,25,0,100,75
1657910901226,CSE 140,A01,083663,Gungor; Onat,16,0,85,69
1657910907257,CSE 140L,A01,083088,Eldon; John,23,0,100,77
1657910913281,CSE 175,A01,083665,Kumar; Rakesh,3,0,25,22
1657910919309,CSE 190,A00,092507,Dubnov; Shlomo,8,0,20,12
1657910925334,ECE 45,A01,083139,Congero; Spencer William,6,0,75,69
1657910931362,ECE 65,A50,083695,Saad; Andrew S,12,0,30,18
1657910931362,ECE 65,A51,095125,Saad; Andrew S,24,0,26,2
1657910937387,ECE 109,A01,091882,Touri; Behrouz,20,0,70,50
1657910943412,ECE 180,A00,083140,Abi Samra; Nicholas Camill,1,0,30,29
1657910943412,ECE 180,B00,083141,Abi Samra; Nicholas Camill,0,0,30,30
1657910949437,MATH 10A,A01,083735,Patchell; Gregory David,2,0,30,28
1657910949437,MATH 10A,A02,083736,Patchell; Gregory David,20,0,30,10
1657910949437,MATH 10A,A03,083737,Patchell; Gregory David,16,0,30,14
1657910955465,MATH 10B,A01,083207,Lim; Seonhee,8,0,34,26
1657910955465,MATH 10B,A02,083208,Lim; Seonhee,10,0,35,25
1657910955465,MATH 10B,A03,093472,Lim; Seonhee,7,0,34,27
1657910955465,MATH 10B,B01,083739,Sinha; Shubham,14,0,30,16
1657910961508,MATH 18,A01,083743,Cinel; Cameron Alexander,9,0,30,21
1657910961508,MATH 18,A02,083744,Cinel; Cameron Alexander,18,0,30,12
1657910961508,MATH 18,A03,083745,Cinel; Cameron Alexander,10,0,30,20
1657910961508,MATH 18,B01,083748,Rideout; David Porter,5,0,37,32
1657910961508,MATH 18,B02,083749,Rideout; David Porter,5,0,36,31
1657910961508,MATH 18,B03,083750,Rideout; David Porter,3,0,37,34
1657910961508,MATH 18,B04,083751,Rideout; David Porter,6,0,36,30
1657910961508,MATH 18,B05,093473,Rideout; David Porter,7,0,36,29
1657910961508,MATH 18,B06,093474,Rideout; David Porter,6,0,36,30
1657910967531,MATH 20A,A01,083754,Zheng; Zequn,14,0,40,26
1657910973554,MATH 20B,A01,083756,Briones; Jor-el Thomas Caparas,4,0,36,32
1657910973554,MATH 20B,A02,083757,Briones; Jor-el Thomas Caparas,1,0,36,35
1657910973554,MATH 20B,A03,093475,Briones; Jor-el Thomas Caparas,2,0,36,34
1657910979584,MATH 20C,A01,083760,Briones; Jor-el Thomas Caparas,1,0,35,34
1657910979584,MATH 20C,A02,083761,Briones; Jor-el Thomas Caparas,8,0,35,27
1657910979584,MATH 20C,A03,093476,Briones; Jor-el Thomas Caparas,0,1,36,36
1657910979584,MATH 20C,B01,083762,Bach; Quang Tran,1,0,30,29
1657910985617,MATH 20D,A01,083765,Tran; Brian Kha,5,0,30,25
1657910985617,MATH 20D,A02,083766,Tran; Brian Kha,5,0,30,25
1657910985617,MATH 20D,A03,083767,Tran; Brian Kha,6,0,30,24
1657910991641,MATH 20E,A01,083771,Ganguly; Soumya,10,0,32,22
1657910991641,MATH 20E,A02,083772,Ganguly; Soumya,7,0,32,25
1657910991641,MATH 20E,B01,083773,Ciotti; Benjamin,20,0,35,15
1657910991641,MATH 20E,B02,083774,Ciotti; Benjamin,18,0,35,17
1657910997666,MATH 103A,A01,083777,Greenfeld; Be'Eri,3,0,36,33
1657910997666,MATH 103A,A02,083778,Greenfeld; Be'Eri,5,0,36,31
1657910997666,MATH 103A,A03,093561,Greenfeld; Be'Eri,6,0,36,30
1657910997666,MATH 103A,B01,083779,Greenfeld; Be'Eri,8,0,36,28
1657910997666,MATH 103A,B02,083780,Greenfeld; Be'Eri,4,0,36,32
1657910997666,MATH 103A,B03,093562,Greenfeld; Be'Eri,3,0,36,33
1657911003688,MATH 105,A01,085443,Carter; Anne Toulson,15,0,35,20
1657911003688,MATH 105,A02,093477,Carter; Anne Toulson,20,0,35,15
1657911009717,MATH 109,A01,083213,Ganzberger; Geoffrey Michael,3,0,34,31
1657911009717,MATH 109,A02,083214,Ganzberger; Geoffrey Michael,4,0,34,30
1657911009717,MATH 109,A03,093478,Ganzberger; Geoffrey Michael,2,0,34,32
1657911009717,MATH 109,B01,083215,Ganzberger; Geoffrey Michael,2,0,32,30
1657911009717,MATH 109,B02,083216,Ganzberger; Geoffrey Michael,2,0,32,30
1657911009717,MATH 109,B03,093479,Ganzberger; Geoffrey Michael,8,0,32,24
1657911015745,MATH 142A,A01,083219,Chow; Bennett,7,0,32,25
1657911015745,MATH 142A,A02,083220,Chow; Bennett,10,0,32,22
1657911015745,MATH 142A,A03,093480,Chow; Bennett,9,0,32,23
1657911015745,MATH 142A,B03,093481,Chow; Bennett,8,0,32,24
1657911015745,MATH 142A,B04,093558,Chow; Bennett,13,0,32,19
1657911015745,MATH 142A,B05,093559,Chow; Bennett,7,0,32,25
1657911021772,MATH 193A,A01,083224,Rotar; Vladimir,8,0,34,26
1657911021772,MATH 193A,A02,083225,Rotar; Vladimir,10,0,34,24
1657911021772,MATH 193A,A03,083781,Rotar; Vladimir,5,0,34,29
1657911021772,MATH 193A,A04,083782,Rotar; Vladimir,11,0,34,23
1657911021772,MATH 193A,A05,093482,Rotar; Vladimir,11,0,34,23
1657911027805,MATH 197,001,091859,McAuley; Julian John,9999,0,9999,0
1657911027805,MATH 197,002,095566,Kedlaya; Kiran S.,9997,0,9999,2
1657911027805,MATH 197,003,095567,Xiao; Ming,9999,0,9999,0
1657911027805,MATH 197,004,095571,Perols; Johan Lars,9998,0,9999,1
1657911034869,COGS 9,A01,083615,Shannon; Kyle Michael,10,0,75,65
1657911040903,COGS 11,A01,083617,Boyle; Mary E. T.,23,0,48,25
1657911046925,COGS 13,A01,083071,Bastos; Amalia Pinkusfeld,11,0,71,60
1657911052955,COGS 14A,A01,092681,Semenuks; Arturs,5,1,100,95
1657911058983,COGS 14B,A01,083073,Cheng; Tzu-Han,6,0,63,57
1657911065007,COGS 17,A01,092677,Semenuks; Arturs,6,0,81,75
1657911071038,COGS 100,A01,083619,Allen; Michael Gordon,17,0,70,53
1657911077064,COGS 101A,A01,083621,Davis; Joshua Daniel,9,0,68,59
1657911083089,COGS 101B,A01,091572,Allen; Michael Gordon,13,0,65,52
1657911089112,COGS 101C,A01,083625,Delgado; Tania,17,0,35,18
1657911095137,COGS 107A,A01,083627,Boyle; Mary E. T.,14,0,60,46
1657911101168,COGS 118A,A01,083075,Gupta; Anjum,21,0,76,55
1657911107191,CSE 3,A50,083646,Miranda; Gregory Joseph,24,0,50,26
1657911113214,CSE 8A,A50,083650,Miranda; Gregory Joseph,17,1,56,39
1657911119256,CSE 11,A01,083080,Cao; Yingjun,6,15,40,34
1657911125289,CSE 12,A01,083652,Krause-Levy; Sophia Louisa,30,1,120,90
1657911131320,CSE 15L,A01,083654,Morris; Justin Loren,9,0,50,41
1657911131320,CSE 15L,A02,083655,Morris; Justin Loren,10,0,50,40
1657911137345,CSE 20,A01,083657,Tran; Khoa Dang,39,0,80,41
1657911143368,CSE 21,A01,095574,Bach; Quang Tran,22,0,48,26
1657911149404,CSE 30,A01,083084,Eldon; John,6,0,80,74
1657911149404,CSE 30,B01,095061,Bhaskar; Nishant,9,0,50,41
1657911155439,CSE 100,A01,083659,Cao; Yingjun,5,4,70,65
1657911161462,CSE 134B,A01,083661,Powell; Thomas Allan,25,0,100,75
1657911167490,CSE 140,A01,083663,Gungor; Onat,16,0,85,69
1657911173516,CSE 140L,A01,083088,Eldon; John,23,0,100,77
1657911179539,CSE 175,A01,083665,Kumar; Rakesh,3,0,25,22
1657911185561,CSE 190,A00,092507,Dubnov; Shlomo,8,0,20,12
1657911191586,ECE 45,A01,083139,Congero; Spencer William,6,0,75,69
1657911197609,ECE 65,A50,083695,Saad; Andrew S,12,0,30,18
1657911197609,ECE 65,A51,095125,Saad; Andrew S,24,0,26,2
1657911203632,ECE 109,A01,091882,Touri; Behrouz,20,0,70,50
1657911209656,ECE 180,A00,083140,Abi Samra; Nicholas Camill,1,0,30,29
1657911209656,ECE 180,B00,083141,Abi Samra; Nicholas Camill,0,0,30,30
1657911215681,MATH 10A,A01,083735,Patchell; Gregory David,2,0,30,28
1657911215681,MATH 10A,A02,083736,Patchell; Gregory David,20,0,30,10
1657911215681,MATH 10A,A03,083737,Patchell; Gregory David,16,0,30,14
1657911221705,MATH 10B,A01,083207,Lim; Seonhee,8,0,34,26
1657911221705,MATH 10B,A02,083208,Lim; Seonhee,10,0,35,25
1657911221705,MATH 10B,A03,093472,Lim; Seonhee,7,0,34,27
1657911221705,MATH 10B,B01,083739,Sinha; Shubham,14,0,30,16
1657911227735,MATH 18,A01,083743,Cinel; Cameron Alexander,9,0,30,21
1657911227735,MATH 18,A02,083744,Cinel; Cameron Alexander,18,0,30,12
1657911227735,MATH 18,A03,083745,Cinel; Cameron Alexander,10,0,30,20
1657911227735,MATH 18,B01,083748,Rideout; David Porter,5,0,37,32
1657911227735,MATH 18,B02,083749,Rideout; David Porter,5,0,36,31
1657911227735,MATH 18,B03,083750,Rideout; David Porter,3,0,37,34
1657911227735,MATH 18,B04,083751,Rideout; David Porter,6,0,36,30
1657911227735,MATH 18,B05,093473,Rideout; David Porter,7,0,36,29
1657911227735,MATH 18,B06,093474,Rideout; David Porter,6,0,36,30
1657911233758,MATH 20A,A01,083754,Zheng; Zequn,14,0,40,26
1657911239786,MATH 20B,A01,083756,Briones; Jor-el Thomas Caparas,4,0,36,32
1657911239786,MATH 20B,A02,083757,Briones; Jor-el Thomas Caparas,1,0,36,35
1657911239786,MATH 20B,A03,093475,Briones; Jor-el Thomas Caparas,2,0,36,34
1657911245816,MATH 20C,A01,083760,Briones; Jor-el Thomas Caparas,1,0,35,34
1657911245816,MATH 20C,A02,083761,Briones; Jor-el Thomas Caparas,8,0,35,27
1657911245816,MATH 20C,A03,093476,Briones; Jor-el Thomas Caparas,0,1,36,36
1657911245816,MATH 20C,B01,083762,Bach; Quang Tran,1,0,30,29
1657911251844,MATH 20D,A01,083765,Tran; Brian Kha,5,0,30,25
1657911251844,MATH 20D,A02,083766,Tran; Brian Kha,5,0,30,25
1657911251844,MATH 20D,A03,083767,Tran; Brian Kha,6,0,30,24
1657911257872,MATH 20E,A01,083771,Ganguly; Soumya,10,0,32,22
1657911257872,MATH 20E,A02,083772,Ganguly; Soumya,7,0,32,25
1657911257872,MATH 20E,B01,083773,Ciotti; Benjamin,20,0,35,15
1657911257872,MATH 20E,B02,083774,Ciotti; Benjamin,18,0,35,17
1657911263895,MATH 103A,A01,083777,Greenfeld; Be'Eri,3,0,36,33
1657911263895,MATH 103A,A02,083778,Greenfeld; Be'Eri,5,0,36,31
1657911263895,MATH 103A,A03,093561,Greenfeld; Be'Eri,6,0,36,30
1657911263895,MATH 103A,B01,083779,Greenfeld; Be'Eri,8,0,36,28
1657911263895,MATH 103A,B02,083780,Greenfeld; Be'Eri,4,0,36,32
1657911263895,MATH 103A,B03,093562,Greenfeld; Be'Eri,3,0,36,33
1657911277381,MATH 105,A01,085443,Carter; Anne Toulson,15,0,35,20
1657911277381,MATH 105,A02,093477,Carter; Anne Toulson,20,0,35,15
1657911283408,MATH 109,A01,083213,Ganzberger; Geoffrey Michael,3,0,34,31
1657911283408,MATH 109,A02,083214,Ganzberger; Geoffrey Michael,4,0,34,30
1657911283408,MATH 109,A03,093478,Ganzberger; Geoffrey Michael,2,0,34,32
1657911283408,MATH 109,B01,083215,Ganzberger; Geoffrey Michael,2,0,32,30
1657911283408,MATH 109,B02,083216,Ganzberger; Geoffrey Michael,2,0,32,30
1657911283408,MATH 109,B03,093479,Ganzberger; Geoffrey Michael,8,0,32,24
1657911289556,MATH 142A,A01,083219,Chow; Bennett,7,0,32,25
1657911289556,MATH 142A,A02,083220,Chow; Bennett,10,0,32,22
1657911289556,MATH 142A,A03,093480,Chow; Bennett,9,0,32,23
1657911289556,MATH 142A,B03,093481,Chow; Bennett,8,0,32,24
1657911289556,MATH 142A,B04,093558,Chow; Bennett,13,0,32,19
1657911289556,MATH 142A,B05,093559,Chow; Bennett,7,0,32,25
1657911295581,MATH 193A,A01,083224,Rotar; Vladimir,8,0,34,26
1657911295581,MATH 193A,A02,083225,Rotar; Vladimir,10,0,34,24
1657911295581,MATH 193A,A03,083781,Rotar; Vladimir,5,0,34,29
1657911295581,MATH 193A,A04,083782,Rotar; Vladimir,11,0,34,23
1657911295581,MATH 193A,A05,093482,Rotar; Vladimir,11,0,34,23
1657911301606,MATH 197,001,091859,McAuley; Julian John,9999,0,9999,0
1657911301606,MATH 197,002,095566,Kedlaya; Kiran S.,9997,0,9999,2
1657911301606,MATH 197,003,095567,Xiao; Ming,9999,0,9999,0
1657911301606,MATH 197,004,095571,Perols; Johan Lars,9998,0,9999,1
1657911308664,COGS 9,A01,083615,Shannon; Kyle Michael,10,0,75,65
1657911314685,COGS 11,A01,083617,Boyle; Mary E. T.,23,0,48,25
1657911320709,COGS 13,A01,083071,Bastos; Amalia Pinkusfeld,11,0,71,60
1657911326731,COGS 14A,A01,092681,Semenuks; Arturs,5,1,100,95
1657911332756,COGS 14B,A01,083073,Cheng; Tzu-Han,6,0,63,57
1657911338780,COGS 17,A01,092677,Semenuks; Arturs,6,0,81,75
1657911344804,COGS 100,A01,083619,Allen; Michael Gordon,17,0,70,53
1657911350827,COGS 101A,A01,083621,Davis; Joshua Daniel,9,0,68,59
1657911356859,COGS 101B,A01,091572,Allen; Michael Gordon,13,0,65,52
1657911362882,COGS 101C,A01,083625,Delgado; Tania,17,0,35,18
1657911368909,COGS 107A,A01,083627,Boyle; Mary E. T.,14,0,60,46
1657911374936,COGS 118A,A01,083075,Gupta; Anjum,21,0,76,55
1657911380964,CSE 3,A50,083646,Miranda; Gregory Joseph,24,0,50,26
1657911386999,CSE 8A,A50,083650,Miranda; Gregory Joseph,17,1,56,39
1657911393026,CSE 11,A01,083080,Cao; Yingjun,6,15,40,34
1657911399052,CSE 12,A01,083652,Krause-Levy; Sophia Louisa,30,1,120,90
1657911405083,CSE 15L,A01,083654,Morris; Justin Loren,9,0,50,41
1657911405083,CSE 15L,A02,083655,Morris; Justin Loren,10,0,50,40
1657911411112,CSE 20,A01,083657,Tran; Khoa Dang,39,0,80,41
1657911417145,CSE 21,A01,095574,Bach; Quang Tran,22,0,48,26
1657911423172,CSE 30,A01,083084,Eldon; John,6,0,80,74
1657911423172,CSE 30,B01,095061,Bhaskar; Nishant,9,0,50,41
1657911429197,CSE 100,A01,083659,Cao; Yingjun,5,4,70,65
1657911435223,CSE 134B,A01,083661,Powell; Thomas Allan,25,0,100,75
1657911441246,CSE 140,A01,083663,Gungor; Onat,16,0,85,69
1657911447273,CSE 140L,A01,083088,Eldon; John,23,0,100,77
1657911453307,CSE 175,A01,083665,Kumar; Rakesh,3,0,25,22
1657911459332,CSE 190,A00,092507,Dubnov; Shlomo,8,0,20,12
1657911465359,ECE 45,A01,083139,Congero; Spencer William,6,0,75,69
1657911471389,ECE 65,A50,083695,Saad; Andrew S,12,0,30,18
1657911471389,ECE 65,A51,095125,Saad; Andrew S,24,0,26,2
1657911477420,ECE 109,A01,091882,Touri; Behrouz,20,0,70,50
1657911483447,ECE 180,A00,083140,Abi Samra; Nicholas Camill,1,0,30,29
1657911483447,ECE 180,B00,083141,Abi Samra; Nicholas Camill,0,0,30,30
1657911489473,MATH 10A,A01,083735,Patchell; Gregory David,2,0,30,28
1657911489473,MATH 10A,A02,083736,Patchell; Gregory David,20,0,30,10
1657911489473,MATH 10A,A03,083737,Patchell; Gregory David,16,0,30,14
1657911495505,MATH 10B,A01,083207,Lim; Seonhee,8,0,34,26
1657911495505,MATH 10B,A02,083208,Lim; Seonhee,10,0,35,25
1657911495505,MATH 10B,A03,093472,Lim; Seonhee,7,0,34,27
1657911495505,MATH 10B,B01,083739,Sinha; Shubham,14,0,30,16
1657911501540,MATH 18,A01,083743,Cinel; Cameron Alexander,9,0,30,21
1657911501540,MATH 18,A02,083744,Cinel; Cameron Alexander,18,0,30,12
1657911501540,MATH 18,A03,083745,Cinel; Cameron Alexander,10,0,30,20
1657911501540,MATH 18,B01,083748,Rideout; David Porter,5,0,37,32
1657911501540,MATH 18,B02,083749,Rideout; David Porter,5,0,36,31
1657911501540,MATH 18,B03,083750,Rideout; David Porter,3,0,37,34
1657911501540,MATH 18,B04,083751,Rideout; David Porter,6,0,36,30
1657911501540,MATH 18,B05,093473,Rideout; David Porter,7,0,36,29
1657911501540,MATH 18,B06,093474,Rideout; David Porter,6,0,36,30
1657911507563,MATH 20A,A01,083754,Zheng; Zequn,14,0,40,26
1657911513590,MATH 20B,A01,083756,Briones; Jor-el Thomas Caparas,4,0,36,32
1657911513590,MATH 20B,A02,083757,Briones; Jor-el Thomas Caparas,1,0,36,35
1657911513590,MATH 20B,A03,093475,Briones; Jor-el Thomas Caparas,2,0,36,34
1657911519614,MATH 20C,A01,083760,Briones; Jor-el Thomas Caparas,1,0,35,34
1657911519614,MATH 20C,A02,083761,Briones; Jor-el Thomas Caparas,8,0,35,27
1657911519614,MATH 20C,A03,093476,Briones; Jor-el Thomas Caparas,0,1,36,36
1657911519614,MATH 20C,B01,083762,Bach; Quang Tran,1,0,30,29
1657911525638,MATH 20D,A01,083765,Tran; Brian Kha,5,0,30,25
1657911525638,MATH 20D,A02,083766,Tran; Brian Kha,5,0,30,25
1657911525638,MATH 20D,A03,083767,Tran; Brian Kha,6,0,30,24
1657911531672,MATH 20E,A01,083771,Ganguly; Soumya,10,0,32,22
1657911531672,MATH 20E,A02,083772,Ganguly; Soumya,7,0,32,25
1657911531672,MATH 20E,B01,083773,Ciotti; Benjamin,20,0,35,15
1657911531672,MATH 20E,B02,083774,Ciotti; Benjamin,18,0,35,17
1657911537698,MATH 103A,A01,083777,Greenfeld; Be'Eri,3,0,36,33
1657911537698,MATH 103A,A02,083778,Greenfeld; Be'Eri,5,0,36,31
1657911537698,MATH 103A,A03,093561,Greenfeld; Be'Eri,6,0,36,30
1657911537698,MATH 103A,B01,083779,Greenfeld; Be'Eri,8,0,36,28
1657911537698,MATH 103A,B02,083780,Greenfeld; Be'Eri,4,0,36,32
1657911537698,MATH 103A,B03,093562,Greenfeld; Be'Eri,3,0,36,33
1657911543740,MATH 105,A01,085443,Carter; Anne Toulson,15,0,35,20
1657911543740,MATH 105,A02,093477,Carter; Anne Toulson,20,0,35,15
1657911549771,MATH 109,A01,083213,Ganzberger; Geoffrey Michael,3,0,34,31
1657911549771,MATH 109,A02,083214,Ganzberger; Geoffrey Michael,4,0,34,30
1657911549771,MATH 109,A03,093478,Ganzberger; Geoffrey Michael,2,0,34,32
1657911549771,MATH 109,B01,083215,Ganzberger; Geoffrey Michael,2,0,32,30
1657911549771,MATH 109,B02,083216,Ganzberger; Geoffrey Michael,2,0,32,30
1657911549771,MATH 109,B03,093479,Ganzberger; Geoffrey Michael,8,0,32,24
1657911555795,MATH 142A,A01,083219,Chow; Bennett,7,0,32,25
1657911555795,MATH 142A,A02,083220,Chow; Bennett,10,0,32,22
1657911555795,MATH 142A,A03,093480,Chow; Bennett,9,0,32,23
1657911555795,MATH 142A,B03,093481,Chow; Bennett,8,0,32,24
1657911555795,MATH 142A,B04,093558,Chow; Bennett,13,0,32,19
1657911555795,MATH 142A,B05,093559,Chow; Bennett,7,0,32,25
1657911561819,MATH 193A,A01,083224,Rotar; Vladimir,8,0,34,26
1657911561819,MATH 193A,A02,083225,Rotar; Vladimir,10,0,34,24
1657911561819,MATH 193A,A03,083781,Rotar; Vladimir,5,0,34,29
1657911561819,MATH 193A,A04,083782,Rotar; Vladimir,11,0,34,23
1657911561819,MATH 193A,A05,093482,Rotar; Vladimir,11,0,34,23
1657911567842,MATH 197,001,091859,McAuley; Julian John,9999,0,9999,0
1657911567842,MATH 197,002,095566,Kedlaya; Kiran S.,9997,0,9999,2
1657911567842,MATH 197,003,095567,Xiao; Ming,9999,0,9999,0
1657911567842,MATH 197,004,095571,Perols; Johan Lars,9998,0,9999,1
1657911574907,COGS 9,A01,083615,Shannon; Kyle Michael,10,0,75,65
1657911580931,COGS 11,A01,083617,Boyle; Mary E. T.,23,0,48,25
1657911586958,COGS 13,A01,083071,Bastos; Amalia Pinkusfeld,11,0,71,60
1657911592992,COGS 14A,A01,092681,Semenuks; Arturs,5,1,100,95
1657911599034,COGS 14B,A01,083073,Cheng; Tzu-Han,6,0,63,57
1657911605063,COGS 17,A01,092677,Semenuks; Arturs,6,0,81,75
1657911611085,COGS 100,A01,083619,Allen; Michael Gordon,17,0,70,53
1657911617111,COGS 101A,A01,083621,Davis; Joshua Daniel,9,0,68,59
1657911623140,COGS 101B,A01,091572,Allen; Michael Gordon,13,0,65,52
1657911629167,COGS 101C,A01,083625,Delgado; Tania,17,0,35,18
1657911635193,COGS 107A,A01,083627,Boyle; Mary E. T.,14,0,60,46
1657911641219,COGS 118A,A01,083075,Gupta; Anjum,21,0,76,55
1657911647250,CSE 3,A50,083646,Miranda; Gregory Joseph,24,0,50,26
1657911653273,CSE 8A,A50,083650,Miranda; Gregory Joseph,17,1,56,39
1657911659299,CSE 11,A01,083080,Cao; Yingjun,6,15,40,34
1657911665324,CSE 12,A01,083652,Krause-Levy; Sophia Louisa,30,1,120,90
1657911671349,CSE 15L,A01,083654,Morris; Justin Loren,9,0,50,41
1657911671349,CSE 15L,A02,083655,Morris; Justin Loren,10,0,50,40
1657911677371,CSE 20,A01,083657,Tran; Khoa Dang,39,0,80,41
1657911683392,CSE 21,A01,095574,Bach; Quang Tran,22,0,48,26
1657911689418,CSE 30,A01,083084,Eldon; John,6,0,80,74
1657911689418,CSE 30,B01,095061,Bhaskar; Nishant,9,0,50,41
1657911695444,CSE 100,A01,083659,Cao; Yingjun,5,4,70,65
1657911701476,CSE 134B,A01,083661,Powell; Thomas Allan,25,0,100,75
1657911707498,CSE 140,A01,083663,Gungor; Onat,16,0,85,69
1657911713527,CSE 140L,A01,083088,Eldon; John,23,0,100,77
1657911719560,CSE 175,A01,083665,Kumar; Rakesh,3,0,25,22
1657911725581,CSE 190,A00,092507,Dubnov; Shlomo,8,0,20,12
1657911731610,ECE 45,A01,083139,Congero; Spencer William,6,0,75,69
1657911737639,ECE 65,A50,083695,Saad; Andrew S,12,0,30,18
1657911737639,ECE 65,A51,095125,Saad; Andrew S,24,0,26,2
1657911743661,ECE 109,A01,091882,Touri; Behrouz,20,0,70,50
1657911749685,ECE 180,A00,083140,Abi Samra; Nicholas Camill,1,0,30,29
1657911749685,ECE 180,B00,083141,Abi Samra; Nicholas Camill,0,0,30,30
1657911755708,MATH 10A,A01,083735,Patchell; Gregory David,2,0,30,28
1657911755708,MATH 10A,A02,083736,Patchell; Gregory David,20,0,30,10
1657911755708,MATH 10A,A03,083737,Patchell; Gregory David,16,0,30,14
1657911761736,MATH 10B,A01,083207,Lim; Seonhee,8,0,34,26
1657911761736,MATH 10B,A02,083208,Lim; Seonhee,10,0,35,25
1657911761736,MATH 10B,A03,093472,Lim; Seonhee,7,0,34,27
1657911761736,MATH 10B,B01,083739,Sinha; Shubham,14,0,30,16
1657911767769,MATH 18,A01,083743,Cinel; Cameron Alexander,9,0,30,21
1657911767769,MATH 18,A02,083744,Cinel; Cameron Alexander,18,0,30,12
1657911767769,MATH 18,A03,083745,Cinel; Cameron Alexander,10,0,30,20
1657911767769,MATH 18,B01,083748,Rideout; David Porter,5,0,37,32
1657911767769,MATH 18,B02,083749,Rideout; David Porter,5,0,36,31
1657911767769,MATH 18,B03,083750,Rideout; David Porter,3,0,37,34
1657911767769,MATH 18,B04,083751,Rideout; David Porter,6,0,36,30
1657911767769,MATH 18,B05,093473,Rideout; David Porter,7,0,36,29
1657911767769,MATH 18,B06,093474,Rideout; David Porter,6,0,36,30
1657911773791,MATH 20A,A01,083754,Zheng; Zequn,14,0,40,26
1657911779818,MATH 20B,A01,083756,Briones; Jor-el Thomas Caparas,4,0,36,32
1657911779818,MATH 20B,A02,083757,Briones; Jor-el Thomas Caparas,1,0,36,35
1657911779818,MATH 20B,A03,093475,Briones; Jor-el Thomas Caparas,2,0,36,34
1657911785841,MATH 20C,A01,083760,Briones; Jor-el Thomas Caparas,1,0,35,34
1657911785841,MATH 20C,A02,083761,Briones; Jor-el Thomas Caparas,8,0,35,27
1657911785841,MATH 20C,A03,093476,Briones; Jor-el Thomas Caparas,0,1,36,36
1657911785841,MATH 20C,B01,083762,Bach; Quang Tran,1,0,30,29
1657911791873,MATH 20D,A01,083765,Tran; Brian Kha,5,0,30,25
1657911791873,MATH 20D,A02,083766,Tran; Brian Kha,5,0,30,25
1657911791873,MATH 20D,A03,083767,Tran; Brian Kha,6,0,30,24
1657911797896,MATH 20E,A01,083771,Ganguly; Soumya,10,0,32,22
1657911797896,MATH 20E,A02,083772,Ganguly; Soumya,7,0,32,25
1657911797896,MATH 20E,B01,083773,Ciotti; Benjamin,20,0,35,15
1657911797896,MATH 20E,B02,083774,Ciotti; Benjamin,18,0,35,17
1657911803926,MATH 103A,A01,083777,Greenfeld; Be'Eri,3,0,36,33
1657911803926,MATH 103A,A02,083778,Greenfeld; Be'Eri,5,0,36,31
1657911803926,MATH 103A,A03,093561,Greenfeld; Be'Eri,6,0,36,30
1657911803926,MATH 103A,B01,083779,Greenfeld; Be'Eri,8,0,36,28
1657911803926,MATH 103A,B02,083780,Greenfeld; Be'Eri,4,0,36,32
1657911803926,MATH 103A,B03,093562,Greenfeld; Be'Eri,3,0,36,33
1657911809966,MATH 105,A01,085443,Carter; Anne Toulson,15,0,35,20
1657911809966,MATH 105,A02,093477,Carter; Anne Toulson,20,0,35,15
1657911815988,MATH 109,A01,083213,Ganzberger; Geoffrey Michael,3,0,34,31
1657911815988,MATH 109,A02,083214,Ganzberger; Geoffrey Michael,4,0,34,30
1657911815988,MATH 109,A03,093478,Ganzberger; Geoffrey Michael,2,0,34,32
1657911815988,MATH 109,B01,083215,Ganzberger; Geoffrey Michael,2,0,32,30
1657911815988,MATH 109,B02,083216,Ganzberger; Geoffrey Michael,2,0,32,30
1657911815988,MATH 109,B03,093479,Ganzberger; Geoffrey Michael,8,0,32,24
1657911822012,MATH 142A,A01,083219,Chow; Bennett,7,0,32,25
1657911822012,MATH 142A,A02,083220,Chow; Bennett,10,0,32,22
1657911822012,MATH 142A,A03,093480,Chow; Bennett,9,0,32,23
1657911822012,MATH 142A,B03,093481,Chow; Bennett,8,0,32,24
1657911822012,MATH 142A,B04,093558,Chow; Bennett,13,0,32,19
1657911822012,MATH 142A,B05,093559,Chow; Bennett,7,0,32,25
1657911828037,MATH 193A,A01,083224,Rotar; Vladimir,8,0,34,26
1657911828037,MATH 193A,A02,083225,Rotar; Vladimir,10,0,34,24
1657911828037,MATH 193A,A03,083781,Rotar; Vladimir,5,0,34,29
1657911828037,MATH 193A,A04,083782,Rotar; Vladimir,11,0,34,23
1657911828037,MATH 193A,A05,093482,Rotar; Vladimir,11,0,34,23
1657911834067,MATH 197,001,091859,McAuley; Julian John,9999,0,9999,0
1657911834067,MATH 197,002,095566,Kedlaya; Kiran S.,9997,0,9999,2
1657911834067,MATH 197,003,095567,Xiao; Ming,9999,0,9999,0
1657911834067,MATH 197,004,095571,Perols; Johan Lars,9998,0,9999,1
1657911841120,COGS 9,A01,083615,Shannon; Kyle Michael,10,0,75,65
1657911847143,COGS 11,A01,083617,Boyle; Mary E. T.,23,0,48,25
1657911853167,COGS 13,A01,083071,Bastos; Amalia Pinkusfeld,11,0,71,60
1657911859188,COGS 14A,A01,092681,Semenuks; Arturs,5,1,100,95
1657911865215,COGS 14B,A01,083073,Cheng; Tzu-Han,6,0,63,57
1657911871246,COGS 17,A01,092677,Semenuks; Arturs,6,0,81,75
1657911877268,COGS 100,A01,083619,Allen; Michael Gordon,17,0,70,53
1657911883364,COGS 101A,A01,083621,Davis; Joshua Daniel,9,0,68,59
1657911889386,COGS 101B,A01,091572,Allen; Michael Gordon,13,0,65,52
1657911895411,COGS 101C,A01,083625,Delgado; Tania,17,0,35,18
1657911901435,COGS 107A,A01,083627,Boyle; Mary E. T.,14,0,60,46
1657911907458,COGS 118A,A01,083075,Gupta; Anjum,21,0,76,55
1657911913480,CSE 3,A50,083646,Miranda; Gregory Joseph,24,0,50,26
1657911919506,CSE 8A,A50,083650,Miranda; Gregory Joseph,17,1,56,39
1657911925532,CSE 11,A01,083080,Cao; Yingjun,6,15,40,34
1657911931556,CSE 12,A01,083652,Krause-Levy; Sophia Louisa,30,1,120,90
1657911937581,CSE 15L,A01,083654,Morris; Justin Loren,9,0,50,41
1657911937581,CSE 15L,A02,083655,Morris; Justin Loren,10,0,50,40
1657911943604,CSE 20,A01,083657,Tran; Khoa Dang,39,0,80,41
1657911949639,CSE 21,A01,095574,Bach; Quang Tran,22,0,48,26
1657911955668,CSE 30,A01,083084,Eldon; John,6,0,80,74
1657911955668,CSE 30,B01,095061,Bhaskar; Nishant,9,0,50,41
1657911961693,CSE 100,A01,083659,Cao; Yingjun,5,4,70,65
1657911967718,CSE 134B,A01,083661,Powell; Thomas Allan,25,0,100,75
1657911973744,CSE 140,A01,083663,Gungor; Onat,16,0,85,69
1657911979769,CSE 140L,A01,083088,Eldon; John,23,0,100,77
1657911985795,CSE 175,A01,083665,Kumar; Rakesh,3,0,25,22
1657911991819,CSE 190,A00,092507,Dubnov; Shlomo,8,0,20,12
1657911997841,ECE 45,A01,083139,Congero; Spencer William,6,0,75,69
1657912003868,ECE 65,A50,083695,Saad; Andrew S,12,0,30,18
1657912003868,ECE 65,A51,095125,Saad; Andrew S,24,0,26,2
1657912009894,ECE 109,A01,091882,Touri; Behrouz,20,0,70,50
1657912015917,ECE 180,A00,083140,Abi Samra; Nicholas Camill,1,0,30,29
1657912015917,ECE 180,B00,083141,Abi Samra; Nicholas Camill,0,0,30,30
1657912021939,MATH 10A,A01,083735,Patchell; Gregory David,2,0,30,28
1657912021939,MATH 10A,A02,083736,Patchell; Gregory David,20,0,30,10
1657912021939,MATH 10A,A03,083737,Patchell; Gregory David,16,0,30,14
1657912027999,MATH 10B,A01,083207,Lim; Seonhee,8,0,34,26
1657912027999,MATH 10B,A02,083208,Lim; Seonhee,10,0,35,25
1657912027999,MATH 10B,A03,093472,Lim; Seonhee,7,0,34,27
1657912027999,MATH 10B,B01,083739,Sinha; Shubham,14,0,30,16
1657912034025,MATH 18,A01,083743,Cinel; Cameron Alexander,9,0,30,21
1657912034025,MATH 18,A02,083744,Cinel; Cameron Alexander,18,0,30,12
1657912034025,MATH 18,A03,083745,Cinel; Cameron Alexander,10,0,30,20
1657912034025,MATH 18,B01,083748,Rideout; David Porter,5,0,37,32
1657912034025,MATH 18,B02,083749,Rideout; David Porter,5,0,36,31
1657912034025,MATH 18,B03,083750,Rideout; David Porter,3,0,37,34
1657912034025,MATH 18,B04,083751,Rideout; David Porter,6,0,36,30
1657912034025,MATH 18,B05,093473,Rideout; David Porter,7,0,36,29
1657912034025,MATH 18,B06,093474,Rideout; David Porter,6,0,36,30
1657912040048,MATH 20A,A01,083754,Zheng; Zequn,14,0,40,26
1657912046072,MATH 20B,A01,083756,Briones; Jor-el Thomas Caparas,4,0,36,32
1657912046072,MATH 20B,A02,083757,Briones; Jor-el Thomas Caparas,1,0,36,35
1657912046072,MATH 20B,A03,093475,Briones; Jor-el Thomas Caparas,2,0,36,34
1657912052101,MATH 20C,A01,083760,Briones; Jor-el Thomas Caparas,1,0,35,34
1657912052101,MATH 20C,A02,083761,Briones; Jor-el Thomas Caparas,8,0,35,27
1657912052101,MATH 20C,A03,093476,Briones; Jor-el Thomas Caparas,0,1,36,36
1657912052101,MATH 20C,B01,083762,Bach; Quang Tran,1,0,30,29
1657912058125,MATH 20D,A01,083765,Tran; Brian Kha,5,0,30,25
1657912058125,MATH 20D,A02,083766,Tran; Brian Kha,5,0,30,25
1657912058125,MATH 20D,A03,083767,Tran; Brian Kha,6,0,30,24
1657912064154,MATH 20E,A01,083771,Ganguly; Soumya,10,0,32,22
1657912064154,MATH 20E,A02,083772,Ganguly; Soumya,7,0,32,25
1657912064154,MATH 20E,B01,083773,Ciotti; Benjamin,20,0,35,15
1657912064154,MATH 20E,B02,083774,Ciotti; Benjamin,18,0,35,17
1657912070177,MATH 103A,A01,083777,Greenfeld; Be'Eri,3,0,36,33
1657912070177,MATH 103A,A02,083778,Greenfeld; Be'Eri,5,0,36,31
1657912070177,MATH 103A,A03,093561,Greenfeld; Be'Eri,6,0,36,30
1657912070177,MATH 103A,B01,083779,Greenfeld; Be'Eri,8,0,36,28
1657912070177,MATH 103A,B02,083780,Greenfeld; Be'Eri,4,0,36,32
1657912070177,MATH 103A,B03,093562,Greenfeld; Be'Eri,3,0,36,33
1657912076204,MATH 105,A01,085443,Carter; Anne Toulson,15,0,35,20
1657912076204,MATH 105,A02,093477,Carter; Anne Toulson,20,0,35,15
1657912082229,MATH 109,A01,083213,Ganzberger; Geoffrey Michael,3,0,34,31
1657912082229,MATH 109,A02,083214,Ganzberger; Geoffrey Michael,4,0,34,30
1657912082229,MATH 109,A03,093478,Ganzberger; Geoffrey Michael,2,0,34,32
1657912082229,MATH 109,B01,083215,Ganzberger; Geoffrey Michael,2,0,32,30
1657912082229,MATH 109,B02,083216,Ganzberger; Geoffrey Michael,2,0,32,30
1657912082229,MATH 109,B03,093479,Ganzberger; Geoffrey Michael,8,0,32,24
1657912088254,MATH 142A,A01,083219,Chow; Bennett,7,0,32,25
1657912088254,MATH 142A,A02,083220,Chow; Bennett,10,0,32,22
1657912088254,MATH 142A,A03,093480,Chow; Bennett,9,0,32,23
1657912088254,MATH 142A,B03,093481,Chow; Bennett,8,0,32,24
1657912088254,MATH 142A,B04,093558,Chow; Bennett,13,0,32,19
1657912088254,MATH 142A,B05,093559,Chow; Bennett,7,0,32,25
1657912094283,MATH 193A,A01,083224,Rotar; Vladimir,8,0,34,26
1657912094283,MATH 193A,A02,083225,Rotar; Vladimir,10,0,34,24
1657912094283,MATH 193A,A03,083781,Rotar; Vladimir,5,0,34,29
1657912094283,MATH 193A,A04,083782,Rotar; Vladimir,11,0,34,23
1657912094283,MATH 193A,A05,093482,Rotar; Vladimir,11,0,34,23
1657912100307,MATH 197,001,091859,McAuley; Julian John,9999,0,9999,0
1657912100307,MATH 197,002,095566,Kedlaya; Kiran S.,9997,0,9999,2
1657912100307,MATH 197,003,095567,Xiao; Ming,9999,0,9999,0
1657912100307,MATH 197,004,095571,Perols; Johan Lars,9998,0,9999,1
1657912107374,COGS 9,A01,083615,Shannon; Kyle Michael,10,0,75,65
1657912113401,COGS 11,A01,083617,Boyle; Mary E. T.,23,0,48,25
1657912119427,COGS 13,A01,083071,Bastos; Amalia Pinkusfeld,11,0,71,60
1657912125451,COGS 14A,A01,092681,Semenuks; Arturs,5,1,100,95
1657912131474,COGS 14B,A01,083073,Cheng; Tzu-Han,6,0,63,57
1657912137497,COGS 17,A01,092677,Semenuks; Arturs,6,0,81,75
1657912143519,COGS 100,A01,083619,Allen; Michael Gordon,17,0,70,53
1657912149548,COGS 101A,A01,083621,Davis; Joshua Daniel,9,0,68,59
1657912155577,COGS 101B,A01,091572,Allen; Michael Gordon,13,0,65,52
1657912161605,COGS 101C,A01,083625,Delgado; Tania,17,0,35,18
1657912167632,COGS 107A,A01,083627,Boyle; Mary E. T.,14,0,60,46
1657912173658,COGS 118A,A01,083075,Gupta; Anjum,21,0,76,55
1657912179685,CSE 3,A50,083646,Miranda; Gregory Joseph,24,0,50,26
1657912185708,CSE 8A,A50,083650,Miranda; Gregory Joseph,17,1,56,39
1657912191730,CSE 11,A01,083080,Cao; Yingjun,6,15,40,34
1657912197759,CSE 12,A01,083652,Krause-Levy; Sophia Louisa,30,1,120,90
1657912203785,CSE 15L,A01,083654,Morris; Justin Loren,9,0,50,41
1657912203785,CSE 15L,A02,083655,Morris; Justin Loren,10,0,50,40
1657912209808,CSE 20,A01,083657,Tran; Khoa Dang,39,0,80,41
1657912215832,CSE 21,A01,095574,Bach; Quang Tran,22,0,48,26
1657912221864,CSE 30,A01,083084,Eldon; John,6,0,80,74
1657912221864,CSE 30,B01,095061,Bhaskar; Nishant,9,0,50,41
1657912227889,CSE 100,A01,083659,Cao; Yingjun,5,4,70,65
1657912233912,CSE 134B,A01,083661,Powell; Thomas Allan,25,0,100,75
1657912239955,CSE 140,A01,083663,Gungor; Onat,16,0,85,69
1657912245981,CSE 140L,A01,083088,Eldon; John,23,0,100,77
1657912252012,CSE 175,A01,083665,Kumar; Rakesh,3,0,25,22
1657912258037,CSE 190,A00,092507,Dubnov; Shlomo,8,0,20,12
1657912264063,ECE 45,A01,083139,Congero; Spencer William,6,0,75,69
1657912270089,ECE 65,A50,083695,Saad; Andrew S,12,0,30,18
1657912270089,ECE 65,A51,095125,Saad; Andrew S,24,0,26,2
1657912276123,ECE 109,A01,091882,Touri; Behrouz,20,0,70,50
1657912282144,ECE 180,A00,083140,Abi Samra; Nicholas Camill,1,0,30,29
1657912282144,ECE 180,B00,083141,Abi Samra; Nicholas Camill,0,0,30,30
1657912288165,MATH 10A,A01,083735,Patchell; Gregory David,2,0,30,28
1657912288165,MATH 10A,A02,083736,Patchell; Gregory David,20,0,30,10
1657912288165,MATH 10A,A03,083737,Patchell; Gregory David,16,0,30,14
1657912294195,MATH 10B,A01,083207,Lim; Seonhee,8,0,34,26
1657912294195,MATH 10B,A02,083208,Lim; Seonhee,10,0,35,25
1657912294195,MATH 10B,A03,093472,Lim; Seonhee,7,0,34,27
1657912294195,MATH 10B,B01,083739,Sinha; Shubham,14,0,30,16
1657912300226,MATH 18,A01,083743,Cinel; Cameron Alexander,9,0,30,21
1657912300226,MATH 18,A02,083744,Cinel; Cameron Alexander,18,0,30,12
1657912300226,MATH 18,A03,083745,Cinel; Cameron Alexander,10,0,30,20
1657912300226,MATH 18,B01,083748,Rideout; David Porter,5,0,37,32
1657912300226,MATH 18,B02,083749,Rideout; David Porter,5,0,36,31
1657912300226,MATH 18,B03,083750,Rideout; David Porter,3,0,37,34
1657912300226,MATH 18,B04,083751,Rideout; David Porter,6,0,36,30
1657912300226,MATH 18,B05,093473,Rideout; David Porter,7,0,36,29
1657912300226,MATH 18,B06,093474,Rideout; David Porter,6,0,36,30
1657912306249,MATH 20A,A01,083754,Zheng; Zequn,14,0,40,26
1657912312276,MATH 20B,A01,083756,Briones; Jor-el Thomas Caparas,4,0,36,32
1657912312276,MATH 20B,A02,083757,Briones; Jor-el Thomas Caparas,1,0,36,35
1657912312276,MATH 20B,A03,093475,Briones; Jor-el Thomas Caparas,2,0,36,34
1657912318301,MATH 20C,A01,083760,Briones; Jor-el Thomas Caparas,1,0,35,34
1657912318301,MATH 20C,A02,083761,Briones; Jor-el Thomas Caparas,8,0,35,27
1657912318301,MATH 20C,A03,093476,Briones; Jor-el Thomas Caparas,0,1,36,36
1657912318301,MATH 20C,B01,083762,Bach; Quang Tran,1,0,30,29
1657912324329,MATH 20D,A01,083765,Tran; Brian Kha,5,0,30,25
1657912324329,MATH 20D,A02,083766,Tran; Brian Kha,5,0,30,25
1657912324329,MATH 20D,A03,083767,Tran; Brian Kha,6,0,30,24
1657912330357,MATH 20E,A01,083771,Ganguly; Soumya,10,0,32,22
1657912330357,MATH 20E,A02,083772,Ganguly; Soumya,7,0,32,25
1657912330357,MATH 20E,B01,083773,Ciotti; Benjamin,20,0,35,15
1657912330357,MATH 20E,B02,083774,Ciotti; Benjamin,18,0,35,17
1657912336381,MATH 103A,A01,083777,Greenfeld; Be'Eri,3,0,36,33
1657912336381,MATH 103A,A02,083778,Greenfeld; Be'Eri,5,0,36,31
1657912336381,MATH 103A,A03,093561,Greenfeld; Be'Eri,6,0,36,30
1657912336381,MATH 103A,B01,083779,Greenfeld; Be'Eri,8,0,36,28
1657912336381,MATH 103A,B02,083780,Greenfeld; Be'Eri,4,0,36,32
1657912336381,MATH 103A,B03,093562,Greenfeld; Be'Eri,3,0,36,33
1657912342404,MATH 105,A01,085443,Carter; Anne Toulson,15,0,35,20
1657912342404,MATH 105,A02,093477,Carter; Anne Toulson,20,0,35,15
1657912348441,MATH 109,A01,083213,Ganzberger; Geoffrey Michael,3,0,34,31
1657912348441,MATH 109,A02,083214,Ganzberger; Geoffrey Michael,4,0,34,30
1657912348441,MATH 109,A03,093478,Ganzberger; Geoffrey Michael,2,0,34,32
1657912348441,MATH 109,B01,083215,Ganzberger; Geoffrey Michael,2,0,32,30
1657912348441,MATH 109,B02,083216,Ganzberger; Geoffrey Michael,2,0,32,30
1657912348441,MATH 109,B03,093479,Ganzberger; Geoffrey Michael,8,0,32,24
1657912354470,MATH 142A,A01,083219,Chow; Bennett,7,0,32,25
1657912354470,MATH 142A,A02,083220,Chow; Bennett,10,0,32,22
1657912354470,MATH 142A,A03,093480,Chow; Bennett,9,0,32,23
1657912354470,MATH 142A,B03,093481,Chow; Bennett,8,0,32,24
1657912354470,MATH 142A,B04,093558,Chow; Bennett,13,0,32,19
1657912354470,MATH 142A,B05,093559,Chow; Bennett,7,0,32,25
1657912360498,MATH 193A,A01,083224,Rotar; Vladimir,8,0,34,26
1657912360498,MATH 193A,A02,083225,Rotar; Vladimir,10,0,34,24
1657912360498,MATH 193A,A03,083781,Rotar; Vladimir,5,0,34,29
1657912360498,MATH 193A,A04,083782,Rotar; Vladimir,11,0,34,23
1657912360498,MATH 193A,A05,093482,Rotar; Vladimir,11,0,34,23
1657912366527,MATH 197,001,091859,McAuley; Julian John,9999,0,9999,0
1657912366527,MATH 197,002,095566,Kedlaya; Kiran S.,9997,0,9999,2
1657912366527,MATH 197,003,095567,Xiao; Ming,9999,0,9999,0
1657912366527,MATH 197,004,095571,Perols; Johan Lars,9998,0,9999,1
1657912373585,COGS 9,A01,083615,Shannon; Kyle Michael,10,0,75,65
1657912379609,COGS 11,A01,083617,Boyle; Mary E. T.,23,0,48,25
1657912385634,COGS 13,A01,083071,Bastos; Amalia Pinkusfeld,11,0,71,60
1657912391659,COGS 14A,A01,092681,Semenuks; Arturs,5,1,100,95
1657912397682,COGS 14B,A01,083073,Cheng; Tzu-Han,6,0,63,57
1657912403707,COGS 17,A01,092677,Semenuks; Arturs,6,0,81,75
1657912409734,COGS 100,A01,083619,Allen; Michael Gordon,17,0,70,53
1657912415764,COGS 101A,A01,083621,Davis; Joshua Daniel,9,0,68,59
1657912421788,COGS 101B,A01,091572,Allen; Michael Gordon,13,0,65,52
1657912427818,COGS 101C,A01,083625,Delgado; Tania,17,0,35,18
1657912433843,COGS 107A,A01,083627,Boyle; Mary E. T.,14,0,60,46
1657912439866,COGS 118A,A01,083075,Gupta; Anjum,21,0,76,55
1657912445900,CSE 3,A50,083646,Miranda; Gregory Joseph,24,0,50,26
1657912451925,CSE 8A,A50,083650,Miranda; Gregory Joseph,17,1,56,39
1657912457957,CSE 11,A01,083080,Cao; Yingjun,6,15,40,34
1657912463982,CSE 12,A01,083652,Krause-Levy; Sophia Louisa,30,1,120,90
1657912470006,CSE 15L,A01,083654,Morris; Justin Loren,9,0,50,41
1657912470006,CSE 15L,A02,083655,Morris; Justin Loren,10,0,50,40
1657912476028,CSE 20,A01,083657,Tran; Khoa Dang,39,0,80,41
1657912482123,CSE 21,A01,095574,Bach; Quang Tran,22,0,48,26
1657912488144,CSE 30,A01,083084,Eldon; John,6,0,80,74
1657912488144,CSE 30,B01,095061,Bhaskar; Nishant,9,0,50,41
1657912494174,CSE 100,A01,083659,Cao; Yingjun,5,4,70,65
1657912500203,CSE 134B,A01,083661,Powell; Thomas Allan,25,0,100,75
1657912506237,CSE 140,A01,083663,Gungor; Onat,16,0,85,69
1657912512263,CSE 140L,A01,083088,Eldon; John,23,0,100,77
1657912518286,CSE 175,A01,083665,Kumar; Rakesh,3,0,25,22
1657912524311,CSE 190,A00,092507,Dubnov; Shlomo,8,0,20,12
1657912530337,ECE 45,A01,083139,Congero; Spencer William,6,0,75,69
1657912536362,ECE 65,A50,083695,Saad; Andrew S,12,0,30,18
1657912536362,ECE 65,A51,095125,Saad; Andrew S,24,0,26,2
1657912542388,ECE 109,A01,091882,Touri; Behrouz,20,0,70,50
1657912548410,ECE 180,A00,083140,Abi Samra; Nicholas Camill,1,0,30,29
1657912548410,ECE 180,B00,083141,Abi Samra; Nicholas Camill,0,0,30,30
1657912554444,MATH 10A,A01,083735,Patchell; Gregory David,2,0,30,28
1657912554444,MATH 10A,A02,083736,Patchell; Gregory David,20,0,30,10
1657912554444,MATH 10A,A03,083737,Patchell; Gregory David,16,0,30,14
1657912560479,MATH 10B,A01,083207,Lim; Seonhee,8,0,34,26
1657912560479,MATH 10B,A02,083208,Lim; Seonhee,10,0,35,25
1657912560479,MATH 10B,A03,093472,Lim; Seonhee,7,0,34,27
1657912560479,MATH 10B,B01,083739,Sinha; Shubham,14,0,30,16
1657912566502,MATH 18,A01,083743,Cinel; Cameron Alexander,9,0,30,21
1657912566502,MATH 18,A02,083744,Cinel; Cameron Alexander,18,0,30,12
1657912566502,MATH 18,A03,083745,Cinel; Cameron Alexander,10,0,30,20
1657912566502,MATH 18,B01,083748,Rideout; David Porter,5,0,37,32
1657912566502,MATH 18,B02,083749,Rideout; David Porter,5,0,36,31
1657912566502,MATH 18,B03,083750,Rideout; David Porter,3,0,37,34
1657912566502,MATH 18,B04,083751,Rideout; David Porter,6,0,36,30
1657912566502,MATH 18,B05,093473,Rideout; David Porter,7,0,36,29
1657912566502,MATH 18,B06,093474,Rideout; David Porter,6,0,36,30
1657912572534,MATH 20A,A01,083754,Zheng; Zequn,14,0,40,26
1657912578558,MATH 20B,A01,083756,Briones; Jor-el Thomas Caparas,4,0,36,32
1657912578558,MATH 20B,A02,083757,Briones; Jor-el Thomas Caparas,1,0,36,35
1657912578558,MATH 20B,A03,093475,Briones; Jor-el Thomas Caparas,2,0,36,34
1657912584586,MATH 20C,A01,083760,Briones; Jor-el Thomas Caparas,1,0,35,34
1657912584586,MATH 20C,A02,083761,Briones; Jor-el Thomas Caparas,8,0,35,27
1657912584586,MATH 20C,A03,093476,Briones; Jor-el Thomas Caparas,0,1,36,36
1657912584586,MATH 20C,B01,083762,Bach; Quang Tran,1,0,30,29
1657912590610,MATH 20D,A01,083765,Tran; Brian Kha,5,0,30,25
1657912590610,MATH 20D,A02,083766,Tran; Brian Kha,5,0,30,25
1657912590610,MATH 20D,A03,083767,Tran; Brian Kha,6,0,30,24
1657912596635,MATH 20E,A01,083771,Ganguly; Soumya,10,0,32,22
1657912596635,MATH 20E,A02,083772,Ganguly; Soumya,7,0,32,25
1657912596635,MATH 20E,B01,083773,Ciotti; Benjamin,20,0,35,15
1657912596635,MATH 20E,B02,083774,Ciotti; Benjamin,18,0,35,17
1657912602663,MATH 103A,A01,083777,Greenfeld; Be'Eri,3,0,36,33
1657912602663,MATH 103A,A02,083778,Greenfeld; Be'Eri,5,0,36,31
1657912602663,MATH 103A,A03,093561,Greenfeld; Be'Eri,6,0,36,30
1657912602663,MATH 103A,B01,083779,Greenfeld; Be'Eri,8,0,36,28
1657912602663,MATH 103A,B02,083780,Greenfeld; Be'Eri,4,0,36,32
1657912602663,MATH 103A,B03,093562,Greenfeld; Be'Eri,3,0,36,33
1657912608687,MATH 105,A01,085443,Carter; Anne Toulson,15,0,35,20
1657912608687,MATH 105,A02,093477,Carter; Anne Toulson,20,0,35,15
1657912614712,MATH 109,A01,083213,Ganzberger; Geoffrey Michael,3,0,34,31
1657912614712,MATH 109,A02,083214,Ganzberger; Geoffrey Michael,4,0,34,30
1657912614712,MATH 109,A03,093478,Ganzberger; Geoffrey Michael,2,0,34,32
1657912614712,MATH 109,B01,083215,Ganzberger; Geoffrey Michael,2,0,32,30
1657912614712,MATH 109,B02,083216,Ganzberger; Geoffrey Michael,2,0,32,30
1657912614712,MATH 109,B03,093479,Ganzberger; Geoffrey Michael,8,0,32,24
1657912620742,MATH 142A,A01,083219,Chow; Bennett,7,0,32,25
1657912620742,MATH 142A,A02,083220,Chow; Bennett,10,0,32,22
1657912620742,MATH 142A,A03,093480,Chow; Bennett,9,0,32,23
1657912620742,MATH 142A,B03,093481,Chow; Bennett,8,0,32,24
1657912620742,MATH 142A,B04,093558,Chow; Bennett,13,0,32,19
1657912620742,MATH 142A,B05,093559,Chow; Bennett,7,0,32,25
1657912626771,MATH 193A,A01,083224,Rotar; Vladimir,8,0,34,26
1657912626771,MATH 193A,A02,083225,Rotar; Vladimir,10,0,34,24
1657912626771,MATH 193A,A03,083781,Rotar; Vladimir,5,0,34,29
1657912626771,MATH 193A,A04,083782,Rotar; Vladimir,11,0,34,23
1657912626771,MATH 193A,A05,093482,Rotar; Vladimir,11,0,34,23
1657912632793,MATH 197,001,091859,McAuley; Julian John,9999,0,9999,0
1657912632793,MATH 197,002,095566,Kedlaya; Kiran S.,9997,0,9999,2
1657912632793,MATH 197,003,095567,Xiao; Ming,9999,0,9999,0
1657912632793,MATH 197,004,095571,Perols; Johan Lars,9998,0,9999,1
1657912639851,COGS 9,A01,083615,Shannon; Kyle Michael,10,0,75,65
1657912645874,COGS 11,A01,083617,Boyle; Mary E. T.,23,0,48,25
1657912651901,COGS 13,A01,083071,Bastos; Amalia Pinkusfeld,11,0,71,60
1657912657923,COGS 14A,A01,092681,Semenuks; Arturs,5,1,100,95
1657912663946,COGS 14B,A01,083073,Cheng; Tzu-Han,6,0,63,57
1657912669971,COGS 17,A01,092677,Semenuks; Arturs,6,0,81,75
1657912675998,COGS 100,A01,083619,Allen; Michael Gordon,17,0,70,53
1657912682026,COGS 101A,A01,083621,Davis; Joshua Daniel,9,0,68,59
1657912688050,COGS 101B,A01,091572,Allen; Michael Gordon,13,0,65,52
1657912694073,COGS 101C,A01,083625,Delgado; Tania,17,0,35,18
1657912700096,COGS 107A,A01,083627,Boyle; Mary E. T.,14,0,60,46
1657912706122,COGS 118A,A01,083075,Gupta; Anjum,21,0,76,55
1657912712145,CSE 3,A50,083646,Miranda; Gregory Joseph,24,0,50,26
1657912718181,CSE 8A,A50,083650,Miranda; Gregory Joseph,17,1,56,39
1657912724206,CSE 11,A01,083080,Cao; Yingjun,6,15,40,34
1657912730235,CSE 12,A01,083652,Krause-Levy; Sophia Louisa,30,1,120,90
1657912736266,CSE 15L,A01,083654,Morris; Justin Loren,9,0,50,41
1657912736266,CSE 15L,A02,083655,Morris; Justin Loren,10,0,50,40
1657912742291,CSE 20,A01,083657,Tran; Khoa Dang,39,0,80,41
1657912748315,CSE 21,A01,095574,Bach; Quang Tran,22,0,48,26
1657912754340,CSE 30,A01,083084,Eldon; John,6,0,80,74
1657912754340,CSE 30,B01,095061,Bhaskar; Nishant,9,0,50,41
1657912760363,CSE 100,A01,083659,Cao; Yingjun,5,4,70,65
1657912766388,CSE 134B,A01,083661,Powell; Thomas Allan,25,0,100,75
1657912772412,CSE 140,A01,083663,Gungor; Onat,16,0,85,69
1657912778441,CSE 140L,A01,083088,Eldon; John,23,0,100,77
1657912784467,CSE 175,A01,083665,Kumar; Rakesh,3,0,25,22
1657912790499,CSE 190,A00,092507,Dubnov; Shlomo,8,0,20,12
1657912796521,ECE 45,A01,083139,Congero; Spencer William,6,0,75,69
1657912802561,ECE 65,A50,083695,Saad; Andrew S,12,0,30,18
1657912802561,ECE 65,A51,095125,Saad; Andrew S,24,0,26,2
1657912808589,ECE 109,A01,091882,Touri; Behrouz,20,0,70,50
1657912814617,ECE 180,A00,083140,Abi Samra; Nicholas Camill,1,0,30,29
1657912814617,ECE 180,B00,083141,Abi Samra; Nicholas Camill,0,0,30,30
1657912820641,MATH 10A,A01,083735,Patchell; Gregory David,2,0,30,28
1657912820641,MATH 10A,A02,083736,Patchell; Gregory David,20,0,30,10
1657912820641,MATH 10A,A03,083737,Patchell; Gregory David,16,0,30,14
1657912826663,MATH 10B,A01,083207,Lim; Seonhee,8,0,34,26
1657912826663,MATH 10B,A02,083208,Lim; Seonhee,10,0,35,25
1657912826663,MATH 10B,A03,093472,Lim; Seonhee,7,0,34,27
1657912826663,MATH 10B,B01,083739,Sinha; Shubham,14,0,30,16
1657912832695,MATH 18,A01,083743,Cinel; Cameron Alexander,9,0,30,21
1657912832695,MATH 18,A02,083744,Cinel; Cameron Alexander,18,0,30,12
1657912832695,MATH 18,A03,083745,Cinel; Cameron Alexander,10,0,30,20
1657912832695,MATH 18,B01,083748,Rideout; David Porter,5,0,37,32
1657912832695,MATH 18,B02,083749,Rideout; David Porter,5,0,36,31
1657912832695,MATH 18,B03,083750,Rideout; David Porter,3,0,37,34
1657912832695,MATH 18,B04,083751,Rideout; David Porter,6,0,36,30
1657912832695,MATH 18,B05,093473,Rideout; David Porter,7,0,36,29
1657912832695,MATH 18,B06,093474,Rideout; David Porter,6,0,36,30
1657912838722,MATH 20A,A01,083754,Zheng; Zequn,14,0,40,26
1657912844746,MATH 20B,A01,083756,Briones; Jor-el Thomas Caparas,4,0,36,32
1657912844746,MATH 20B,A02,083757,Briones; Jor-el Thomas Caparas,1,0,36,35
1657912844746,MATH 20B,A03,093475,Briones; Jor-el Thomas Caparas,2,0,36,34
1657912850773,MATH 20C,A01,083760,Briones; Jor-el Thomas Caparas,1,0,35,34
1657912850773,MATH 20C,A02,083761,Briones; Jor-el Thomas Caparas,8,0,35,27
1657912850773,MATH 20C,A03,093476,Briones; Jor-el Thomas Caparas,0,1,36,36
1657912850773,MATH 20C,B01,083762,Bach; Quang Tran,1,0,30,29
1657912856796,MATH 20D,A01,083765,Tran; Brian Kha,5,0,30,25
1657912856796,MATH 20D,A02,083766,Tran; Brian Kha,5,0,30,25
1657912856796,MATH 20D,A03,083767,Tran; Brian Kha,6,0,30,24
1657912862828,MATH 20E,A01,083771,Ganguly; Soumya,10,0,32,22
1657912862828,MATH 20E,A02,083772,Ganguly; Soumya,7,0,32,25
1657912862828,MATH 20E,B01,083773,Ciotti; Benjamin,20,0,35,15
1657912862828,MATH 20E,B02,083774,Ciotti; Benjamin,18,0,35,17
1657912868852,MATH 103A,A01,083777,Greenfeld; Be'Eri,3,0,36,33
1657912868852,MATH 103A,A02,083778,Greenfeld; Be'Eri,5,0,36,31
1657912868852,MATH 103A,A03,093561,Greenfeld; Be'Eri,6,0,36,30
1657912868852,MATH 103A,B01,083779,Greenfeld; Be'Eri,8,0,36,28
1657912868852,MATH 103A,B02,083780,Greenfeld; Be'Eri,4,0,36,32
1657912868852,MATH 103A,B03,093562,Greenfeld; Be'Eri,3,0,36,33
1657912874875,MATH 105,A01,085443,Carter; Anne Toulson,15,0,35,20
1657912874875,MATH 105,A02,093477,Carter; Anne Toulson,20,0,35,15
1657912880898,MATH 109,A01,083213,Ganzberger; Geoffrey Michael,3,0,34,31
1657912880898,MATH 109,A02,083214,Ganzberger; Geoffrey Michael,4,0,34,30
1657912880898,MATH 109,A03,093478,Ganzberger; Geoffrey Michael,2,0,34,32
1657912880898,MATH 109,B01,083215,Ganzberger; Geoffrey Michael,2,0,32,30
1657912880898,MATH 109,B02,083216,Ganzberger; Geoffrey Michael,2,0,32,30
1657912880898,MATH 109,B03,093479,Ganzberger; Geoffrey Michael,8,0,32,24
1657912886929,MATH 142A,A01,083219,Chow; Bennett,7,0,32,25
1657912886929,MATH 142A,A02,083220,Chow; Bennett,10,0,32,22
1657912886929,MATH 142A,A03,093480,Chow; Bennett,9,0,32,23
1657912886929,MATH 142A,B03,093481,Chow; Bennett,8,0,32,24
1657912886929,MATH 142A,B04,093558,Chow; Bennett,13,0,32,19
1657912886929,MATH 142A,B05,093559,Chow; Bennett,7,0,32,25
1657912892959,MATH 193A,A01,083224,Rotar; Vladimir,8,0,34,26
1657912892959,MATH 193A,A02,083225,Rotar; Vladimir,10,0,34,24
1657912892959,MATH 193A,A03,083781,Rotar; Vladimir,5,0,34,29
1657912892959,MATH 193A,A04,083782,Rotar; Vladimir,11,0,34,23
1657912892959,MATH 193A,A05,093482,Rotar; Vladimir,11,0,34,23
1657912898992,MATH 197,001,091859,McAuley; Julian John,9999,0,9999,0
1657912898992,MATH 197,002,095566,Kedlaya; Kiran S.,9997,0,9999,2
1657912898992,MATH 197,003,095567,Xiao; Ming,9999,0,9999,0
1657912898992,MATH 197,004,095571,Perols; Johan Lars,9998,0,9999,1
1657912906054,COGS 9,A01,083615,Shannon; Kyle Michael,10,0,75,65
1657912912081,COGS 11,A01,083617,Boyle; Mary E. T.,23,0,48,25
1657912918117,COGS 13,A01,083071,Bastos; Amalia Pinkusfeld,11,0,71,60
1657912924144,COGS 14A,A01,092681,Semenuks; Arturs,5,1,100,95
1657912930167,COGS 14B,A01,083073,Cheng; Tzu-Han,6,0,63,57
1657912936204,COGS 17,A01,092677,Semenuks; Arturs,6,0,81,75
1657912942227,COGS 100,A01,083619,Allen; Michael Gordon,17,0,70,53
1657912948252,COGS 101A,A01,083621,Davis; Joshua Daniel,9,0,68,59
1657912954277,COGS 101B,A01,091572,Allen; Michael Gordon,13,0,65,52
1657912960301,COGS 101C,A01,083625,Delgado; Tania,17,0,35,18
1657912966328,COGS 107A,A01,083627,Boyle; Mary E. T.,14,0,60,46
1657912972354,COGS 118A,A01,083075,Gupta; Anjum,21,0,76,55
1657912978379,CSE 3,A50,083646,Miranda; Gregory Joseph,24,0,50,26
1657912984410,CSE 8A,A50,083650,Miranda; Gregory Joseph,17,1,56,39
1657912990432,CSE 11,A01,083080,Cao; Yingjun,6,15,40,34
1657912996454,CSE 12,A01,083652,Krause-Levy; Sophia Louisa,30,1,120,90
1657913002482,CSE 15L,A01,083654,Morris; Justin Loren,9,0,50,41
1657913002482,CSE 15L,A02,083655,Morris; Justin Loren,10,0,50,40
1657913008504,CSE 20,A01,083657,Tran; Khoa Dang,39,0,80,41
1657913014528,CSE 21,A01,095574,Bach; Quang Tran,22,0,48,26
1657913020551,CSE 30,A01,083084,Eldon; John,6,0,80,74
1657913020551,CSE 30,B01,095061,Bhaskar; Nishant,9,0,50,41
1657913026575,CSE 100,A01,083659,Cao; Yingjun,5,4,70,65
1657913032607,CSE 134B,A01,083661,Powell; Thomas Allan,25,0,100,75
1657913038632,CSE 140,A01,083663,Gungor; Onat,16,0,85,69
1657913044658,CSE 140L,A01,083088,Eldon; John,23,0,100,77
1657913050737,CSE 175,A01,083665,Kumar; Rakesh,3,0,25,22
1657913056763,CSE 190,A00,092507,Dubnov; Shlomo,8,0,20,12
1657913062785,ECE 45,A01,083139,Congero; Spencer William,6,0,75,69
1657913068822,ECE 65,A50,083695,Saad; Andrew S,12,0,30,18
1657913068822,ECE 65,A51,095125,Saad; Andrew S,24,0,26,2
1657913074853,ECE 109,A01,091882,Touri; Behrouz,20,0,70,50
1657913080978,ECE 180,A00,083140,Abi Samra; Nicholas Camill,1,0,30,29
1657913080978,ECE 180,B00,083141,Abi Samra; Nicholas Camill,0,0,30,30
1657913087009,MATH 10A,A01,083735,Patchell; Gregory David,2,0,30,28
1657913087009,MATH 10A,A02,083736,Patchell; Gregory David,20,0,30,10
1657913087009,MATH 10A,A03,083737,Patchell; Gregory David,16,0,30,14
1657913093034,MATH 10B,A01,083207,Lim; Seonhee,8,0,34,26
1657913093034,MATH 10B,A02,083208,Lim; Seonhee,10,0,35,25
1657913093034,MATH 10B,A03,093472,Lim; Seonhee,7,0,34,27
1657913093034,MATH 10B,B01,083739,Sinha; Shubham,14,0,30,16
1657913099071,MATH 18,A01,083743,Cinel; Cameron Alexander,9,0,30,21
1657913099071,MATH 18,A02,083744,Cinel; Cameron Alexander,18,0,30,12
1657913099071,MATH 18,A03,083745,Cinel; Cameron Alexander,10,0,30,20
1657913099071,MATH 18,B01,083748,Rideout; David Porter,5,0,37,32
1657913099071,MATH 18,B02,083749,Rideout; David Porter,5,0,36,31
1657913099071,MATH 18,B03,083750,Rideout; David Porter,3,0,37,34
1657913099071,MATH 18,B04,083751,Rideout; David Porter,6,0,36,30
1657913099071,MATH 18,B05,093473,Rideout; David Porter,7,0,36,29
1657913099071,MATH 18,B06,093474,Rideout; David Porter,6,0,36,30
1657913105095,MATH 20A,A01,083754,Zheng; Zequn,14,0,40,26
1657913111120,MATH 20B,A01,083756,Briones; Jor-el Thomas Caparas,4,0,36,32
1657913111120,MATH 20B,A02,083757,Briones; Jor-el Thomas Caparas,1,0,36,35
1657913111120,MATH 20B,A03,093475,Briones; Jor-el Thomas Caparas,2,0,36,34
1657913117148,MATH 20C,A01,083760,Briones; Jor-el Thomas Caparas,1,0,35,34
1657913117148,MATH 20C,A02,083761,Briones; Jor-el Thomas Caparas,8,0,35,27
1657913117148,MATH 20C,A03,093476,Briones; Jor-el Thomas Caparas,0,1,36,36
1657913117148,MATH 20C,B01,083762,Bach; Quang Tran,1,0,30,29
1657913123171,MATH 20D,A01,083765,Tran; Brian Kha,5,0,30,25
1657913123171,MATH 20D,A02,083766,Tran; Brian Kha,5,0,30,25
1657913123171,MATH 20D,A03,083767,Tran; Brian Kha,6,0,30,24
1657913129193,MATH 20E,A01,083771,Ganguly; Soumya,10,0,32,22
1657913129193,MATH 20E,A02,083772,Ganguly; Soumya,7,0,32,25
1657913129193,MATH 20E,B01,083773,Ciotti; Benjamin,20,0,35,15
1657913129193,MATH 20E,B02,083774,Ciotti; Benjamin,18,0,35,17
1657913135216,MATH 103A,A01,083777,Greenfeld; Be'Eri,3,0,36,33
1657913135216,MATH 103A,A02,083778,Greenfeld; Be'Eri,5,0,36,31
1657913135216,MATH 103A,A03,093561,Greenfeld; Be'Eri,6,0,36,30
1657913135216,MATH 103A,B01,083779,Greenfeld; Be'Eri,8,0,36,28
1657913135216,MATH 103A,B02,083780,Greenfeld; Be'Eri,4,0,36,32
1657913135216,MATH 103A,B03,093562,Greenfeld; Be'Eri,3,0,36,33
1657913141238,MATH 105,A01,085443,Carter; Anne Toulson,15,0,35,20
1657913141238,MATH 105,A02,093477,Carter; Anne Toulson,20,0,35,15
1657913147267,MATH 109,A01,083213,Ganzberger; Geoffrey Michael,3,0,34,31
1657913147267,MATH 109,A02,083214,Ganzberger; Geoffrey Michael,4,0,34,30
1657913147267,MATH 109,A03,093478,Ganzberger; Geoffrey Michael,2,0,34,32
1657913147267,MATH 109,B01,083215,Ganzberger; Geoffrey Michael,2,0,32,30
1657913147267,MATH 109,B02,083216,Ganzberger; Geoffrey Michael,2,0,32,30
1657913147267,MATH 109,B03,093479,Ganzberger; Geoffrey Michael,8,0,32,24
1657913153290,MATH 142A,A01,083219,Chow; Bennett,7,0,32,25
1657913153290,MATH 142A,A02,083220,Chow; Bennett,10,0,32,22
1657913153290,MATH 142A,A03,093480,Chow; Bennett,9,0,32,23
1657913153290,MATH 142A,B03,093481,Chow; Bennett,8,0,32,24
1657913153290,MATH 142A,B04,093558,Chow; Bennett,13,0,32,19
1657913153290,MATH 142A,B05,093559,Chow; Bennett,7,0,32,25
1657913159319,MATH 193A,A01,083224,Rotar; Vladimir,8,0,34,26
1657913159319,MATH 193A,A02,083225,Rotar; Vladimir,10,0,34,24
1657913159319,MATH 193A,A03,083781,Rotar; Vladimir,5,0,34,29
1657913159319,MATH 193A,A04,083782,Rotar; Vladimir,11,0,34,23
1657913159319,MATH 193A,A05,093482,Rotar; Vladimir,11,0,34,23
1657913165341,MATH 197,001,091859,McAuley; Julian John,9999,0,9999,0
1657913165341,MATH 197,002,095566,Kedlaya; Kiran S.,9997,0,9999,2
1657913165341,MATH 197,003,095567,Xiao; Ming,9999,0,9999,0
1657913165341,MATH 197,004,095571,Perols; Johan Lars,9998,0,9999,1
1657913172398,COGS 9,A01,083615,Shannon; Kyle Michael,10,0,75,65
1657913178419,COGS 11,A01,083617,Boyle; Mary E. T.,23,0,48,25
1657913184443,COGS 13,A01,083071,Bastos; Amalia Pinkusfeld,11,0,71,60
1657913190466,COGS 14A,A01,092681,Semenuks; Arturs,5,1,100,95
1657913196493,COGS 14B,A01,083073,Cheng; Tzu-Han,6,0,63,57
1657913202520,COGS 17,A01,092677,Semenuks; Arturs,6,0,81,75
1657913208543,COGS 100,A01,083619,Allen; Michael Gordon,17,0,70,53
1657913214568,COGS 101A,A01,083621,Davis; Joshua Daniel,9,0,68,59
1657913220593,COGS 101B,A01,091572,Allen; Michael Gordon,13,0,65,52
1657913226619,COGS 101C,A01,083625,Delgado; Tania,17,0,35,18
1657913232645,COGS 107A,A01,083627,Boyle; Mary E. T.,14,0,60,46
1657913238668,COGS 118A,A01,083075,Gupta; Anjum,21,0,76,55
1657913244692,CSE 3,A50,083646,Miranda; Gregory Joseph,24,0,50,26
1657913250723,CSE 8A,A50,083650,Miranda; Gregory Joseph,17,1,56,39
1657913256749,CSE 11,A01,083080,Cao; Yingjun,6,15,40,34
1657913262771,CSE 12,A01,083652,Krause-Levy; Sophia Louisa,30,1,120,90
1657913268799,CSE 15L,A01,083654,Morris; Justin Loren,9,0,50,41
1657913268799,CSE 15L,A02,083655,Morris; Justin Loren,10,0,50,40
1657913274822,CSE 20,A01,083657,Tran; Khoa Dang,39,0,80,41
1657913280845,CSE 21,A01,095574,Bach; Quang Tran,22,0,48,26
1657913286871,CSE 30,A01,083084,Eldon; John,6,0,80,74
1657913286871,CSE 30,B01,095061,Bhaskar; Nishant,9,0,50,41
1657913292895,CSE 100,A01,083659,Cao; Yingjun,5,4,70,65
1657913298922,CSE 134B,A01,083661,Powell; Thomas Allan,25,0,100,75
1657913304948,CSE 140,A01,083663,Gungor; Onat,16,0,85,69
1657913310972,CSE 140L,A01,083088,Eldon; John,23,0,100,77
1657913316998,CSE 175,A01,083665,Kumar; Rakesh,3,0,25,22
1657913323021,CSE 190,A00,092507,Dubnov; Shlomo,8,0,20,12
1657913329042,ECE 45,A01,083139,Congero; Spencer William,6,0,75,69
1657913335066,ECE 65,A50,083695,Saad; Andrew S,12,0,30,18
1657913335066,ECE 65,A51,095125,Saad; Andrew S,24,0,26,2
1657913341112,ECE 109,A01,091882,Touri; Behrouz,20,0,70,50
1657913347134,ECE 180,A00,083140,Abi Samra; Nicholas Camill,1,0,30,29
1657913347134,ECE 180,B00,083141,Abi Samra; Nicholas Camill,0,0,30,30
1657913353160,MATH 10A,A01,083735,Patchell; Gregory David,2,0,30,28
1657913353160,MATH 10A,A02,083736,Patchell; Gregory David,20,0,30,10
1657913353160,MATH 10A,A03,083737,Patchell; Gregory David,16,0,30,14
1657913359187,MATH 10B,A01,083207,Lim; Seonhee,8,0,34,26
1657913359187,MATH 10B,A02,083208,Lim; Seonhee,10,0,35,25
1657913359187,MATH 10B,A03,093472,Lim; Seonhee,7,0,34,27
1657913359187,MATH 10B,B01,083739,Sinha; Shubham,14,0,30,16
1657913365210,MATH 18,A01,083743,Cinel; Cameron Alexander,9,0,30,21
1657913365210,MATH 18,A02,083744,Cinel; Cameron Alexander,18,0,30,12
1657913365210,MATH 18,A03,083745,Cinel; Cameron Alexander,10,0,30,20
1657913365210,MATH 18,B01,083748,Rideout; David Porter,5,0,37,32
1657913365210,MATH 18,B02,083749,Rideout; David Porter,5,0,36,31
1657913365210,MATH 18,B03,083750,Rideout; David Porter,3,0,37,34
1657913365210,MATH 18,B04,083751,Rideout; David Porter,6,0,36,30
1657913365210,MATH 18,B05,093473,Rideout; David Porter,7,0,36,29
1657913365210,MATH 18,B06,093474,Rideout; David Porter,6,0,36,30
1657913371239,MATH 20A,A01,083754,Zheng; Zequn,14,0,40,26
1657913377262,MATH 20B,A01,083756,Briones; Jor-el Thomas Caparas,4,0,36,32
1657913377262,MATH 20B,A02,083757,Briones; Jor-el Thomas Caparas,1,0,36,35
1657913377262,MATH 20B,A03,093475,Briones; Jor-el Thomas Caparas,2,0,36,34
1657913383294,MATH 20C,A01,083760,Briones; Jor-el Thomas Caparas,1,0,35,34
1657913383294,MATH 20C,A02,083761,Briones; Jor-el Thomas Caparas,8,0,35,27
1657913383294,MATH 20C,A03,093476,Briones; Jor-el Thomas Caparas,0,1,36,36
1657913383294,MATH 20C,B01,083762,Bach; Quang Tran,1,0,30,29
1657913389317,MATH 20D,A01,083765,Tran; Brian Kha,5,0,30,25
1657913389317,MATH 20D,A02,083766,Tran; Brian Kha,5,0,30,25
1657913389317,MATH 20D,A03,083767,Tran; Brian Kha,6,0,30,24
1657913395342,MATH 20E,A01,083771,Ganguly; Soumya,10,0,32,22
1657913395342,MATH 20E,A02,083772,Ganguly; Soumya,7,0,32,25
1657913395342,MATH 20E,B01,083773,Ciotti; Benjamin,20,0,35,15
1657913395342,MATH 20E,B02,083774,Ciotti; Benjamin,18,0,35,17
1657913401366,MATH 103A,A01,083777,Greenfeld; Be'Eri,3,0,36,33
1657913401366,MATH 103A,A02,083778,Greenfeld; Be'Eri,5,0,36,31
1657913401366,MATH 103A,A03,093561,Greenfeld; Be'Eri,6,0,36,30
1657913401366,MATH 103A,B01,083779,Greenfeld; Be'Eri,8,0,36,28
1657913401366,MATH 103A,B02,083780,Greenfeld; Be'Eri,4,0,36,32
1657913401366,MATH 103A,B03,093562,Greenfeld; Be'Eri,3,0,36,33
1657913407388,MATH 105,A01,085443,Carter; Anne Toulson,15,0,35,20
1657913407388,MATH 105,A02,093477,Carter; Anne Toulson,20,0,35,15
1657913413415,MATH 109,A01,083213,Ganzberger; Geoffrey Michael,3,0,34,31
1657913413415,MATH 109,A02,083214,Ganzberger; Geoffrey Michael,4,0,34,30
1657913413415,MATH 109,A03,093478,Ganzberger; Geoffrey Michael,2,0,34,32
1657913413415,MATH 109,B01,083215,Ganzberger; Geoffrey Michael,2,0,32,30
1657913413415,MATH 109,B02,083216,Ganzberger; Geoffrey Michael,2,0,32,30
1657913413415,MATH 109,B03,093479,Ganzberger; Geoffrey Michael,8,0,32,24
1657913419440,MATH 142A,A01,083219,Chow; Bennett,7,0,32,25
1657913419440,MATH 142A,A02,083220,Chow; Bennett,10,0,32,22
1657913419440,MATH 142A,A03,093480,Chow; Bennett,9,0,32,23
1657913419440,MATH 142A,B03,093481,Chow; Bennett,8,0,32,24
1657913419440,MATH 142A,B04,093558,Chow; Bennett,13,0,32,19
1657913419440,MATH 142A,B05,093559,Chow; Bennett,7,0,32,25
1657913425468,MATH 193A,A01,083224,Rotar; Vladimir,8,0,34,26
1657913425468,MATH 193A,A02,083225,Rotar; Vladimir,10,0,34,24
1657913425468,MATH 193A,A03,083781,Rotar; Vladimir,5,0,34,29
1657913425468,MATH 193A,A04,083782,Rotar; Vladimir,11,0,34,23
1657913425468,MATH 193A,A05,093482,Rotar; Vladimir,11,0,34,23
1657913431491,MATH 197,001,091859,McAuley; Julian John,9999,0,9999,0
1657913431491,MATH 197,002,095566,Kedlaya; Kiran S.,9997,0,9999,2
1657913431491,MATH 197,003,095567,Xiao; Ming,9999,0,9999,0
1657913431491,MATH 197,004,095571,Perols; Johan Lars,9998,0,9999,1
1657913438554,COGS 9,A01,083615,Shannon; Kyle Michael,10,0,75,65
1657913444580,COGS 11,A01,083617,Boyle; Mary E. T.,23,0,48,25
1657913450603,COGS 13,A01,083071,Bastos; Amalia Pinkusfeld,11,0,71,60
1657913456629,COGS 14A,A01,092681,Semenuks; Arturs,5,1,100,95
1657913462656,COGS 14B,A01,083073,Cheng; Tzu-Han,6,0,63,57
1657913468679,COGS 17,A01,092677,Semenuks; Arturs,6,0,81,75
1657913474702,COGS 100,A01,083619,Allen; Michael Gordon,17,0,70,53
1657913480723,COGS 101A,A01,083621,Davis; Joshua Daniel,9,0,68,59
1657913486747,COGS 101B,A01,091572,Allen; Michael Gordon,13,0,65,52
1657913492774,COGS 101C,A01,083625,Delgado; Tania,17,0,35,18
1657913498797,COGS 107A,A01,083627,Boyle; Mary E. T.,14,0,60,46
1657913504821,COGS 118A,A01,083075,Gupta; Anjum,21,0,76,55
1657913510849,CSE 3,A50,083646,Miranda; Gregory Joseph,24,0,50,26
1657913516875,CSE 8A,A50,083650,Miranda; Gregory Joseph,17,1,56,39
1657913522898,CSE 11,A01,083080,Cao; Yingjun,6,15,40,34
1657913528971,CSE 12,A01,083652,Krause-Levy; Sophia Louisa,30,1,120,90
1657913534993,CSE 15L,A01,083654,Morris; Justin Loren,9,0,50,41
1657913534993,CSE 15L,A02,083655,Morris; Justin Loren,10,0,50,40
1657913541024,CSE 20,A01,083657,Tran; Khoa Dang,39,0,80,41
1657913547047,CSE 21,A01,095574,Bach; Quang Tran,22,0,48,26
1657913553070,CSE 30,A01,083084,Eldon; John,6,0,80,74
1657913553070,CSE 30,B01,095061,Bhaskar; Nishant,9,0,50,41
1657913559092,CSE 100,A01,083659,Cao; Yingjun,5,4,70,65
1657913565116,CSE 134B,A01,083661,Powell; Thomas Allan,25,0,100,75
1657913571138,CSE 140,A01,083663,Gungor; Onat,16,0,85,69
1657913577165,CSE 140L,A01,083088,Eldon; John,23,0,100,77
1657913583188,CSE 175,A01,083665,Kumar; Rakesh,3,0,25,22
1657913589211,CSE 190,A00,092507,Dubnov; Shlomo,8,0,20,12
1657913595234,ECE 45,A01,083139,Congero; Spencer William,6,0,75,69
1657913601266,ECE 65,A50,083695,Saad; Andrew S,12,0,30,18
1657913601266,ECE 65,A51,095125,Saad; Andrew S,24,0,26,2
1657913607290,ECE 109,A01,091882,Touri; Behrouz,20,0,70,50
1657913613312,ECE 180,A00,083140,Abi Samra; Nicholas Camill,1,0,30,29
1657913613312,ECE 180,B00,083141,Abi Samra; Nicholas Camill,0,0,30,30
1657913619347,MATH 10A,A01,083735,Patchell; Gregory David,2,0,30,28
1657913619347,MATH 10A,A02,083736,Patchell; Gregory David,20,0,30,10
1657913619347,MATH 10A,A03,083737,Patchell; Gregory David,16,0,30,14
1657913625376,MATH 10B,A01,083207,Lim; Seonhee,8,0,34,26
1657913625376,MATH 10B,A02,083208,Lim; Seonhee,10,0,35,25
1657913625376,MATH 10B,A03,093472,Lim; Seonhee,7,0,34,27
1657913625376,MATH 10B,B01,083739,Sinha; Shubham,14,0,30,16
1657913631408,MATH 18,A01,083743,Cinel; Cameron Alexander,9,0,30,21
1657913631408,MATH 18,A02,083744,Cinel; Cameron Alexander,18,0,30,12
1657913631408,MATH 18,A03,083745,Cinel; Cameron Alexander,10,0,30,20
1657913631408,MATH 18,B01,083748,Rideout; David Porter,5,0,37,32
1657913631408,MATH 18,B02,083749,Rideout; David Porter,5,0,36,31
1657913631408,MATH 18,B03,083750,Rideout; David Porter,3,0,37,34
1657913631408,MATH 18,B04,083751,Rideout; David Porter,6,0,36,30
1657913631408,MATH 18,B05,093473,Rideout; David Porter,7,0,36,29
1657913631408,MATH 18,B06,093474,Rideout; David Porter,6,0,36,30
1657913637436,MATH 20A,A01,083754,Zheng; Zequn,14,0,40,26
1657913643462,MATH 20B,A01,083756,Briones; Jor-el Thomas Caparas,4,0,36,32
1657913643462,MATH 20B,A02,083757,Briones; Jor-el Thomas Caparas,1,0,36,35
1657913643462,MATH 20B,A03,093475,Briones; Jor-el Thomas Caparas,2,0,36,34
1657913649486,MATH 20C,A01,083760,Briones; Jor-el Thomas Caparas,1,0,35,34
1657913649486,MATH 20C,A02,083761,Briones; Jor-el Thomas Caparas,8,0,35,27
1657913649486,MATH 20C,A03,093476,Briones; Jor-el Thomas Caparas,0,1,36,36
1657913649486,MATH 20C,B01,083762,Bach; Quang Tran,1,0,30,29
1657913655511,MATH 20D,A01,083765,Tran; Brian Kha,5,0,30,25
1657913655511,MATH 20D,A02,083766,Tran; Brian Kha,5,0,30,25
1657913655511,MATH 20D,A03,083767,Tran; Brian Kha,6,0,30,24
1657913661542,MATH 20E,A01,083771,Ganguly; Soumya,10,0,32,22
1657913661542,MATH 20E,A02,083772,Ganguly; Soumya,7,0,32,25
1657913661542,MATH 20E,B01,083773,Ciotti; Benjamin,20,0,35,15
1657913661542,MATH 20E,B02,083774,Ciotti; Benjamin,18,0,35,17
1657913667570,MATH 103A,A01,083777,Greenfeld; Be'Eri,3,0,36,33
1657913667570,MATH 103A,A02,083778,Greenfeld; Be'Eri,5,0,36,31
1657913667570,MATH 103A,A03,093561,Greenfeld; Be'Eri,6,0,36,30
1657913667570,MATH 103A,B01,083779,Greenfeld; Be'Eri,8,0,36,28
1657913667570,MATH 103A,B02,083780,Greenfeld; Be'Eri,4,0,36,32
1657913667570,MATH 103A,B03,093562,Greenfeld; Be'Eri,3,0,36,33
1657913673597,MATH 105,A01,085443,Carter; Anne Toulson,15,0,35,20
1657913673597,MATH 105,A02,093477,Carter; Anne Toulson,20,0,35,15
1657913679691,MATH 109,A01,083213,Ganzberger; Geoffrey Michael,3,0,34,31
1657913679691,MATH 109,A02,083214,Ganzberger; Geoffrey Michael,4,0,34,30
1657913679691,MATH 109,A03,093478,Ganzberger; Geoffrey Michael,2,0,34,32
1657913679691,MATH 109,B01,083215,Ganzberger; Geoffrey Michael,2,0,32,30
1657913679691,MATH 109,B02,083216,Ganzberger; Geoffrey Michael,2,0,32,30
1657913679691,MATH 109,B03,093479,Ganzberger; Geoffrey Michael,8,0,32,24
1657913685716,MATH 142A,A01,083219,Chow; Bennett,7,0,32,25
1657913685716,MATH 142A,A02,083220,Chow; Bennett,10,0,32,22
1657913685716,MATH 142A,A03,093480,Chow; Bennett,9,0,32,23
1657913685716,MATH 142A,B03,093481,Chow; Bennett,8,0,32,24
1657913685716,MATH 142A,B04,093558,Chow; Bennett,13,0,32,19
1657913685716,MATH 142A,B05,093559,Chow; Bennett,7,0,32,25
1657913691738,MATH 193A,A01,083224,Rotar; Vladimir,8,0,34,26
1657913691738,MATH 193A,A02,083225,Rotar; Vladimir,10,0,34,24
1657913691738,MATH 193A,A03,083781,Rotar; Vladimir,5,0,34,29
1657913691738,MATH 193A,A04,083782,Rotar; Vladimir,11,0,34,23
1657913691738,MATH 193A,A05,093482,Rotar; Vladimir,11,0,34,23
1657913697767,MATH 197,001,091859,McAuley; Julian John,9999,0,9999,0
1657913697767,MATH 197,002,095566,Kedlaya; Kiran S.,9997,0,9999,2
1657913697767,MATH 197,003,095567,Xiao; Ming,9999,0,9999,0
1657913697767,MATH 197,004,095571,Perols; Johan Lars,9998,0,9999,1
1657913704835,COGS 9,A01,083615,Shannon; Kyle Michael,10,0,75,65
1657913710861,COGS 11,A01,083617,Boyle; Mary E. T.,23,0,48,25
1657913716900,COGS 13,A01,083071,Bastos; Amalia Pinkusfeld,11,0,71,60
1657913722922,COGS 14A,A01,092681,Semenuks; Arturs,5,1,100,95
1657913728946,COGS 14B,A01,083073,Cheng; Tzu-Han,6,0,63,57
1657913734969,COGS 17,A01,092677,Semenuks; Arturs,6,0,81,75
1657913740997,COGS 100,A01,083619,Allen; Michael Gordon,17,0,70,53
1657913747020,COGS 101A,A01,083621,Davis; Joshua Daniel,9,0,68,59
1657913753044,COGS 101B,A01,091572,Allen; Michael Gordon,13,0,65,52
1657913759067,COGS 101C,A01,083625,Delgado; Tania,17,0,35,18
1657913765094,COGS 107A,A01,083627,Boyle; Mary E. T.,14,0,60,46
1657913771117,COGS 118A,A01,083075,Gupta; Anjum,21,0,76,55
1657913777139,CSE 3,A50,083646,Miranda; Gregory Joseph,24,0,50,26
1657913783165,CSE 8A,A50,083650,Miranda; Gregory Joseph,17,1,56,39
1657913789192,CSE 11,A01,083080,Cao; Yingjun,6,15,40,34
1657913795242,CSE 12,A01,083652,Krause-Levy; Sophia Louisa,30,1,120,90
1657913801267,CSE 15L,A01,083654,Morris; Justin Loren,9,0,50,41
1657913801267,CSE 15L,A02,083655,Morris; Justin Loren,10,0,50,40
1657913807294,CSE 20,A01,083657,Tran; Khoa Dang,39,0,80,41
1657913813320,CSE 21,A01,095574,Bach; Quang Tran,22,0,48,26
1657913819344,CSE 30,A01,083084,Eldon; John,6,0,80,74
1657913819344,CSE 30,B01,095061,Bhaskar; Nishant,9,0,50,41
1657913825370,CSE 100,A01,083659,Cao; Yingjun,5,4,70,65
1657913831396,CSE 134B,A01,083661,Powell; Thomas Allan,25,0,100,75
1657913837419,CSE 140,A01,083663,Gungor; Onat,16,0,85,69
1657913843449,CSE 140L,A01,083088,Eldon; John,23,0,100,77
1657913849473,CSE 175,A01,083665,Kumar; Rakesh,3,0,25,22
1657913855502,CSE 190,A00,092507,Dubnov; Shlomo,8,0,20,12
1657913861524,ECE 45,A01,083139,Congero; Spencer William,6,0,75,69
1657913867551,ECE 65,A50,083695,Saad; Andrew S,12,0,30,18
1657913867551,ECE 65,A51,095125,Saad; Andrew S,24,0,26,2
1657913873573,ECE 109,A01,091882,Touri; Behrouz,20,0,70,50
1657913879609,ECE 180,A00,083140,Abi Samra; Nicholas Camill,1,0,30,29
1657913879609,ECE 180,B00,083141,Abi Samra; Nicholas Camill,0,0,30,30
1657913885645,MATH 10A,A01,083735,Patchell; Gregory David,2,0,30,28
1657913885645,MATH 10A,A02,083736,Patchell; Gregory David,20,0,30,10
1657913885645,MATH 10A,A03,083737,Patchell; Gregory David,16,0,30,14
1657913891685,MATH 10B,A01,083207,Lim; Seonhee,8,0,34,26
1657913891685,MATH 10B,A02,083208,Lim; Seonhee,10,0,35,25
1657913891685,MATH 10B,A03,093472,Lim; Seonhee,7,0,34,27
1657913891685,MATH 10B,B01,083739,Sinha; Shubham,14,0,30,16
1657913897717,MATH 18,A01,083743,Cinel; Cameron Alexander,9,0,30,21
1657913897717,MATH 18,A02,083744,Cinel; Cameron Alexander,18,0,30,12
1657913897717,MATH 18,A03,083745,Cinel; Cameron Alexander,10,0,30,20
1657913897717,MATH 18,B01,083748,Rideout; David Porter,5,0,37,32
1657913897717,MATH 18,B02,083749,Rideout; David Porter,5,0,36,31
1657913897717,MATH 18,B03,083750,Rideout; David Porter,3,0,37,34
1657913897717,MATH 18,B04,083751,Rideout; David Porter,6,0,36,30
1657913897717,MATH 18,B05,093473,Rideout; David Porter,7,0,36,29
1657913897717,MATH 18,B06,093474,Rideout; David Porter,6,0,36,30
1657913903740,MATH 20A,A01,083754,Zheng; Zequn,14,0,40,26
1657913909775,MATH 20B,A01,083756,Briones; Jor-el Thomas Caparas,4,0,36,32
1657913909775,MATH 20B,A02,083757,Briones; Jor-el Thomas Caparas,1,0,36,35
1657913909775,MATH 20B,A03,093475,Briones; Jor-el Thomas Caparas,2,0,36,34
1657913915800,MATH 20C,A01,083760,Briones; Jor-el Thomas Caparas,1,0,35,34
1657913915800,MATH 20C,A02,083761,Briones; Jor-el Thomas Caparas,8,0,35,27
1657913915800,MATH 20C,A03,093476,Briones; Jor-el Thomas Caparas,0,1,36,36
1657913915800,MATH 20C,B01,083762,Bach; Quang Tran,1,0,30,29
1657913921838,MATH 20D,A01,083765,Tran; Brian Kha,5,0,30,25
1657913921838,MATH 20D,A02,083766,Tran; Brian Kha,5,0,30,25
1657913921838,MATH 20D,A03,083767,Tran; Brian Kha,6,0,30,24
1657913927876,MATH 20E,A01,083771,Ganguly; Soumya,10,0,32,22
1657913927876,MATH 20E,A02,083772,Ganguly; Soumya,7,0,32,25
1657913927876,MATH 20E,B01,083773,Ciotti; Benjamin,20,0,35,15
1657913927876,MATH 20E,B02,083774,Ciotti; Benjamin,18,0,35,17
1657913933906,MATH 103A,A01,083777,Greenfeld; Be'Eri,3,0,36,33
1657913933906,MATH 103A,A02,083778,Greenfeld; Be'Eri,5,0,36,31
1657913933906,MATH 103A,A03,093561,Greenfeld; Be'Eri,6,0,36,30
1657913933906,MATH 103A,B01,083779,Greenfeld; Be'Eri,8,0,36,28
1657913933906,MATH 103A,B02,083780,Greenfeld; Be'Eri,4,0,36,32
1657913933906,MATH 103A,B03,093562,Greenfeld; Be'Eri,3,0,36,33
1657913939929,MATH 105,A01,085443,Carter; Anne Toulson,15,0,35,20
1657913939929,MATH 105,A02,093477,Carter; Anne Toulson,20,0,35,15
1657913945958,MATH 109,A01,083213,Ganzberger; Geoffrey Michael,3,0,34,31
1657913945958,MATH 109,A02,083214,Ganzberger; Geoffrey Michael,4,0,34,30
1657913945958,MATH 109,A03,093478,Ganzberger; Geoffrey Michael,2,0,34,32
1657913945958,MATH 109,B01,083215,Ganzberger; Geoffrey Michael,2,0,32,30
1657913945958,MATH 109,B02,083216,Ganzberger; Geoffrey Michael,2,0,32,30
1657913945958,MATH 109,B03,093479,Ganzberger; Geoffrey Michael,8,0,32,24
1657913951985,MATH 142A,A01,083219,Chow; Bennett,7,0,32,25
1657913951985,MATH 142A,A02,083220,Chow; Bennett,10,0,32,22
1657913951985,MATH 142A,A03,093480,Chow; Bennett,9,0,32,23
1657913951985,MATH 142A,B03,093481,Chow; Bennett,8,0,32,24
1657913951985,MATH 142A,B04,093558,Chow; Bennett,13,0,32,19
1657913951985,MATH 142A,B05,093559,Chow; Bennett,7,0,32,25
1657913958008,MATH 193A,A01,083224,Rotar; Vladimir,8,0,34,26
1657913958008,MATH 193A,A02,083225,Rotar; Vladimir,10,0,34,24
1657913958008,MATH 193A,A03,083781,Rotar; Vladimir,5,0,34,29
1657913958008,MATH 193A,A04,083782,Rotar; Vladimir,11,0,34,23
1657913958008,MATH 193A,A05,093482,Rotar; Vladimir,11,0,34,23
1657913964036,MATH 197,001,091859,McAuley; Julian John,9999,0,9999,0
1657913964036,MATH 197,002,095566,Kedlaya; Kiran S.,9997,0,9999,2
1657913964036,MATH 197,003,095567,Xiao; Ming,9999,0,9999,0
1657913964036,MATH 197,004,095571,Perols; Johan Lars,9998,0,9999,1
1657913971094,COGS 9,A01,083615,Shannon; Kyle Michael,10,0,75,65
1657913977116,COGS 11,A01,083617,Boyle; Mary E. T.,23,0,48,25
1657913983138,COGS 13,A01,083071,Bastos; Amalia Pinkusfeld,11,0,71,60
1657913989160,COGS 14A,A01,092681,Semenuks; Arturs,5,1,100,95
1657913995185,COGS 14B,A01,083073,Cheng; Tzu-Han,6,0,63,57
1657914001211,COGS 17,A01,092677,Semenuks; Arturs,6,0,81,75
1657914007237,COGS 100,A01,083619,Allen; Michael Gordon,17,0,70,53
1657914013322,COGS 101A,A01,083621,Davis; Joshua Daniel,9,0,68,59
1657914019354,COGS 101B,A01,091572,Allen; Michael Gordon,13,0,65,52
1657914025377,COGS 101C,A01,083625,Delgado; Tania,17,0,35,18
1657914031401,COGS 107A,A01,083627,Boyle; Mary E. T.,14,0,60,46
1657914037428,COGS 118A,A01,083075,Gupta; Anjum,21,0,76,55
1657914043457,CSE 3,A50,083646,Miranda; Gregory Joseph,24,0,50,26
1657914049480,CSE 8A,A50,083650,Miranda; Gregory Joseph,17,1,56,39
1657914055503,CSE 11,A01,083080,Cao; Yingjun,6,15,40,34
1657914061529,CSE 12,A01,083652,Krause-Levy; Sophia Louisa,30,1,120,90
1657914067554,CSE 15L,A01,083654,Morris; Justin Loren,9,0,50,41
1657914067554,CSE 15L,A02,083655,Morris; Justin Loren,10,0,50,40
1657914073577,CSE 20,A01,083657,Tran; Khoa Dang,39,0,80,41
1657914079604,CSE 21,A01,095574,Bach; Quang Tran,22,0,48,26
1657914085627,CSE 30,A01,083084,Eldon; John,6,0,80,74
1657914085627,CSE 30,B01,095061,Bhaskar; Nishant,9,0,50,41
1657914091650,CSE 100,A01,083659,Cao; Yingjun,5,4,70,65
1657914097683,CSE 134B,A01,083661,Powell; Thomas Allan,25,0,100,75
1657914103706,CSE 140,A01,083663,Gungor; Onat,16,0,85,69
1657914109728,CSE 140L,A01,083088,Eldon; John,23,0,100,77
1657914115751,CSE 175,A01,083665,Kumar; Rakesh,3,0,25,22
1657914121779,CSE 190,A00,092507,Dubnov; Shlomo,8,0,20,12
1657914127804,ECE 45,A01,083139,Congero; Spencer William,6,0,75,69
1657914133827,ECE 65,A50,083695,Saad; Andrew S,12,0,30,18
1657914133827,ECE 65,A51,095125,Saad; Andrew S,24,0,26,2
1657914139862,ECE 109,A01,091882,Touri; Behrouz,20,0,70,50
1657914145889,ECE 180,A00,083140,Abi Samra; Nicholas Camill,1,0,30,29
1657914145889,ECE 180,B00,083141,Abi Samra; Nicholas Camill,0,0,30,30
1657914151914,MATH 10A,A01,083735,Patchell; Gregory David,2,0,30,28
1657914151914,MATH 10A,A02,083736,Patchell; Gregory David,20,0,30,10
1657914151914,MATH 10A,A03,083737,Patchell; Gregory David,16,0,30,14
1657914157936,MATH 10B,A01,083207,Lim; Seonhee,8,0,34,26
1657914157936,MATH 10B,A02,083208,Lim; Seonhee,10,0,35,25
1657914157936,MATH 10B,A03,093472,Lim; Seonhee,7,0,34,27
1657914157936,MATH 10B,B01,083739,Sinha; Shubham,14,0,30,16
1657914163961,MATH 18,A01,083743,Cinel; Cameron Alexander,9,0,30,21
1657914163961,MATH 18,A02,083744,Cinel; Cameron Alexander,18,0,30,12
1657914163961,MATH 18,A03,083745,Cinel; Cameron Alexander,10,0,30,20
1657914163961,MATH 18,B01,083748,Rideout; David Porter,5,0,37,32
1657914163961,MATH 18,B02,083749,Rideout; David Porter,5,0,36,31
1657914163961,MATH 18,B03,083750,Rideout; David Porter,3,0,37,34
1657914163961,MATH 18,B04,083751,Rideout; David Porter,6,0,36,30
1657914163961,MATH 18,B05,093473,Rideout; David Porter,7,0,36,29
1657914163961,MATH 18,B06,093474,Rideout; David Porter,6,0,36,30
1657914169986,MATH 20A,A01,083754,Zheng; Zequn,14,0,40,26
1657914176008,MATH 20B,A01,083756,Briones; Jor-el Thomas Caparas,4,0,36,32
1657914176008,MATH 20B,A02,083757,Briones; Jor-el Thomas Caparas,1,0,36,35
1657914176008,MATH 20B,A03,093475,Briones; Jor-el Thomas Caparas,2,0,36,34
1657914182036,MATH 20C,A01,083760,Briones; Jor-el Thomas Caparas,1,0,35,34
1657914182036,MATH 20C,A02,083761,Briones; Jor-el Thomas Caparas,8,0,35,27
1657914182036,MATH 20C,A03,093476,Briones; Jor-el Thomas Caparas,0,1,36,36
1657914182036,MATH 20C,B01,083762,Bach; Quang Tran,1,0,30,29
1657914188066,MATH 20D,A01,083765,Tran; Brian Kha,5,0,30,25
1657914188066,MATH 20D,A02,083766,Tran; Brian Kha,5,0,30,25
1657914188066,MATH 20D,A03,083767,Tran; Brian Kha,6,0,30,24
1657914194092,MATH 20E,A01,083771,Ganguly; Soumya,10,0,32,22
1657914194092,MATH 20E,A02,083772,Ganguly; Soumya,7,0,32,25
1657914194092,MATH 20E,B01,083773,Ciotti; Benjamin,20,0,35,15
1657914194092,MATH 20E,B02,083774,Ciotti; Benjamin,18,0,35,17
1657914200114,MATH 103A,A01,083777,Greenfeld; Be'Eri,3,0,36,33
1657914200114,MATH 103A,A02,083778,Greenfeld; Be'Eri,5,0,36,31
1657914200114,MATH 103A,A03,093561,Greenfeld; Be'Eri,6,0,36,30
1657914200114,MATH 103A,B01,083779,Greenfeld; Be'Eri,8,0,36,28
1657914200114,MATH 103A,B02,083780,Greenfeld; Be'Eri,4,0,36,32
1657914200114,MATH 103A,B03,093562,Greenfeld; Be'Eri,3,0,36,33
1657914206141,MATH 105,A01,085443,Carter; Anne Toulson,15,0,35,20
1657914206141,MATH 105,A02,093477,Carter; Anne Toulson,20,0,35,15
1657914212167,MATH 109,A01,083213,Ganzberger; Geoffrey Michael,3,0,34,31
1657914212167,MATH 109,A02,083214,Ganzberger; Geoffrey Michael,4,0,34,30
1657914212167,MATH 109,A03,093478,Ganzberger; Geoffrey Michael,2,0,34,32
1657914212167,MATH 109,B01,083215,Ganzberger; Geoffrey Michael,2,0,32,30
1657914212167,MATH 109,B02,083216,Ganzberger; Geoffrey Michael,2,0,32,30
1657914212167,MATH 109,B03,093479,Ganzberger; Geoffrey Michael,8,0,32,24
1657914218200,MATH 142A,A01,083219,Chow; Bennett,7,0,32,25
1657914218200,MATH 142A,A02,083220,Chow; Bennett,10,0,32,22
1657914218200,MATH 142A,A03,093480,Chow; Bennett,9,0,32,23
1657914218200,MATH 142A,B03,093481,Chow; Bennett,8,0,32,24
1657914218200,MATH 142A,B04,093558,Chow; Bennett,13,0,32,19
1657914218200,MATH 142A,B05,093559,Chow; Bennett,7,0,32,25
1657914224225,MATH 193A,A01,083224,Rotar; Vladimir,8,0,34,26
1657914224225,MATH 193A,A02,083225,Rotar; Vladimir,10,0,34,24
1657914224225,MATH 193A,A03,083781,Rotar; Vladimir,5,0,34,29
1657914224225,MATH 193A,A04,083782,Rotar; Vladimir,11,0,34,23
1657914224225,MATH 193A,A05,093482,Rotar; Vladimir,11,0,34,23
1657914230248,MATH 197,001,091859,McAuley; Julian John,9999,0,9999,0
1657914230248,MATH 197,002,095566,Kedlaya; Kiran S.,9997,0,9999,2
1657914230248,MATH 197,003,095567,Xiao; Ming,9999,0,9999,0
1657914230248,MATH 197,004,095571,Perols; Johan Lars,9998,0,9999,1
1657914237304,COGS 9,A01,083615,Shannon; Kyle Michael,10,0,75,65
1657914243329,COGS 11,A01,083617,Boyle; Mary E. T.,23,0,48,25
1657914249361,COGS 13,A01,083071,Bastos; Amalia Pinkusfeld,11,0,71,60
1657914255384,COGS 14A,A01,092681,Semenuks; Arturs,5,1,100,95
1657914261412,COGS 14B,A01,083073,Cheng; Tzu-Han,6,0,63,57
1657914267439,COGS 17,A01,092677,Semenuks; Arturs,6,0,81,75
1657914273554,COGS 100,A01,083619,Allen; Michael Gordon,17,0,70,53
1657914279582,COGS 101A,A01,083621,Davis; Joshua Daniel,9,0,68,59
1657914285603,COGS 101B,A01,091572,Allen; Michael Gordon,13,0,65,52
1657914291636,COGS 101C,A01,083625,Delgado; Tania,17,0,35,18
1657914297659,COGS 107A,A01,083627,Boyle; Mary E. T.,14,0,60,46
1657914303684,COGS 118A,A01,083075,Gupta; Anjum,21,0,76,55
1657914309709,CSE 3,A50,083646,Miranda; Gregory Joseph,24,0,50,26
1657914315737,CSE 8A,A50,083650,Miranda; Gregory Joseph,17,1,56,39
1657914321765,CSE 11,A01,083080,Cao; Yingjun,6,15,40,34
1657914327792,CSE 12,A01,083652,Krause-Levy; Sophia Louisa,30,1,120,90
1657914333815,CSE 15L,A01,083654,Morris; Justin Loren,9,0,50,41
1657914333815,CSE 15L,A02,083655,Morris; Justin Loren,10,0,50,40
1657914339846,CSE 20,A01,083657,Tran; Khoa Dang,39,0,80,41
1657914345869,CSE 21,A01,095574,Bach; Quang Tran,22,0,48,26
1657914351893,CSE 30,A01,083084,Eldon; John,6,0,80,74
1657914351893,CSE 30,B01,095061,Bhaskar; Nishant,9,0,50,41
1657914357921,CSE 100,A01,083659,Cao; Yingjun,5,4,70,65
1657914363954,CSE 134B,A01,083661,Powell; Thomas Allan,25,0,100,75
1657914369981,CSE 140,A01,083663,Gungor; Onat,16,0,85,69
1657914376004,CSE 140L,A01,083088,Eldon; John,23,0,100,77
1657914382028,CSE 175,A01,083665,Kumar; Rakesh,3,0,25,22
1657914388051,CSE 190,A00,092507,Dubnov; Shlomo,8,0,20,12
1657914394074,ECE 45,A01,083139,Congero; Spencer William,6,0,75,69
1657914400098,ECE 65,A50,083695,Saad; Andrew S,12,0,30,18
1657914400098,ECE 65,A51,095125,Saad; Andrew S,24,0,26,2
1657914406122,ECE 109,A01,091882,Touri; Behrouz,20,0,70,50
1657914412145,ECE 180,A00,083140,Abi Samra; Nicholas Camill,1,0,30,29
1657914412145,ECE 180,B00,083141,Abi Samra; Nicholas Camill,0,0,30,30
1657914418172,MATH 10A,A01,083735,Patchell; Gregory David,2,0,30,28
1657914418172,MATH 10A,A02,083736,Patchell; Gregory David,20,0,30,10
1657914418172,MATH 10A,A03,083737,Patchell; Gregory David,16,0,30,14
1657914424199,MATH 10B,A01,083207,Lim; Seonhee,8,0,34,26
1657914424199,MATH 10B,A02,083208,Lim; Seonhee,10,0,35,25
1657914424199,MATH 10B,A03,093472,Lim; Seonhee,7,0,34,27
1657914424199,MATH 10B,B01,083739,Sinha; Shubham,14,0,30,16
1657914430225,MATH 18,A01,083743,Cinel; Cameron Alexander,9,0,30,21
1657914430225,MATH 18,A02,083744,Cinel; Cameron Alexander,18,0,30,12
1657914430225,MATH 18,A03,083745,Cinel; Cameron Alexander,10,0,30,20
1657914430225,MATH 18,B01,083748,Rideout; David Porter,5,0,37,32
1657914430225,MATH 18,B02,083749,Rideout; David Porter,5,0,36,31
1657914430225,MATH 18,B03,083750,Rideout; David Porter,3,0,37,34
1657914430225,MATH 18,B04,083751,Rideout; David Porter,6,0,36,30
1657914430225,MATH 18,B05,093473,Rideout; David Porter,7,0,36,29
1657914430225,MATH 18,B06,093474,Rideout; David Porter,6,0,36,30
1657914436267,MATH 20A,A01,083754,Zheng; Zequn,14,0,40,26
1657914442295,MATH 20B,A01,083756,Briones; Jor-el Thomas Caparas,4,0,36,32
1657914442295,MATH 20B,A02,083757,Briones; Jor-el Thomas Caparas,1,0,36,35
1657914442295,MATH 20B,A03,093475,Briones; Jor-el Thomas Caparas,2,0,36,34
1657914448319,MATH 20C,A01,083760,Briones; Jor-el Thomas Caparas,1,0,35,34
1657914448319,MATH 20C,A02,083761,Briones; Jor-el Thomas Caparas,8,0,35,27
1657914448319,MATH 20C,A03,093476,Briones; Jor-el Thomas Caparas,0,1,36,36
1657914448319,MATH 20C,B01,083762,Bach; Quang Tran,1,0,30,29
1657914454342,MATH 20D,A01,083765,Tran; Brian Kha,5,0,30,25
1657914454342,MATH 20D,A02,083766,Tran; Brian Kha,5,0,30,25
1657914454342,MATH 20D,A03,083767,Tran; Brian Kha,6,0,30,24
1657914460365,MATH 20E,A01,083771,Ganguly; Soumya,10,0,32,22
1657914460365,MATH 20E,A02,083772,Ganguly; Soumya,7,0,32,25
1657914460365,MATH 20E,B01,083773,Ciotti; Benjamin,20,0,35,15
1657914460365,MATH 20E,B02,083774,Ciotti; Benjamin,18,0,35,17
1657914466390,MATH 103A,A01,083777,Greenfeld; Be'Eri,3,0,36,33
1657914466390,MATH 103A,A02,083778,Greenfeld; Be'Eri,5,0,36,31
1657914466390,MATH 103A,A03,093561,Greenfeld; Be'Eri,6,0,36,30
1657914466390,MATH 103A,B01,083779,Greenfeld; Be'Eri,8,0,36,28
1657914466390,MATH 103A,B02,083780,Greenfeld; Be'Eri,4,0,36,32
1657914466390,MATH 103A,B03,093562,Greenfeld; Be'Eri,3,0,36,33
1657914472414,MATH 105,A01,085443,Carter; Anne Toulson,15,0,35,20
1657914472414,MATH 105,A02,093477,Carter; Anne Toulson,20,0,35,15
1657914478442,MATH 109,A01,083213,Ganzberger; Geoffrey Michael,3,0,34,31
1657914478442,MATH 109,A02,083214,Ganzberger; Geoffrey Michael,4,0,34,30
1657914478442,MATH 109,A03,093478,Ganzberger; Geoffrey Michael,2,0,34,32
1657914478442,MATH 109,B01,083215,Ganzberger; Geoffrey Michael,2,0,32,30
1657914478442,MATH 109,B02,083216,Ganzberger; Geoffrey Michael,2,0,32,30
1657914478442,MATH 109,B03,093479,Ganzberger; Geoffrey Michael,8,0,32,24
1657914484467,MATH 142A,A01,083219,Chow; Bennett,7,0,32,25
1657914484467,MATH 142A,A02,083220,Chow; Bennett,10,0,32,22
1657914484467,MATH 142A,A03,093480,Chow; Bennett,9,0,32,23
1657914484467,MATH 142A,B03,093481,Chow; Bennett,8,0,32,24
1657914484467,MATH 142A,B04,093558,Chow; Bennett,13,0,32,19
1657914484467,MATH 142A,B05,093559,Chow; Bennett,7,0,32,25
1657914490495,MATH 193A,A01,083224,Rotar; Vladimir,8,0,34,26
1657914490495,MATH 193A,A02,083225,Rotar; Vladimir,10,0,34,24
1657914490495,MATH 193A,A03,083781,Rotar; Vladimir,5,0,34,29
1657914490495,MATH 193A,A04,083782,Rotar; Vladimir,11,0,34,23
1657914490495,MATH 193A,A05,093482,Rotar; Vladimir,11,0,34,23
1657914496517,MATH 197,001,091859,McAuley; Julian John,9999,0,9999,0
1657914496517,MATH 197,002,095566,Kedlaya; Kiran S.,9997,0,9999,2
1657914496517,MATH 197,003,095567,Xiao; Ming,9999,0,9999,0
1657914496517,MATH 197,004,095571,Perols; Johan Lars,9998,0,9999,1
1657914503572,COGS 9,A01,083615,Shannon; Kyle Michael,10,0,75,65
1657914509595,COGS 11,A01,083617,Boyle; Mary E. T.,23,0,48,25
1657914515624,COGS 13,A01,083071,Bastos; Amalia Pinkusfeld,11,0,71,60
1657914521652,COGS 14A,A01,092681,Semenuks; Arturs,5,1,100,95
1657914527683,COGS 14B,A01,083073,Cheng; Tzu-Han,6,0,63,57
1657914533706,COGS 17,A01,092677,Semenuks; Arturs,6,0,81,75
1657914539731,COGS 100,A01,083619,Allen; Michael Gordon,17,0,70,53
1657914545752,COGS 101A,A01,083621,Davis; Joshua Daniel,9,0,68,59
1657914551780,COGS 101B,A01,091572,Allen; Michael Gordon,13,0,65,52
1657914557808,COGS 101C,A01,083625,Delgado; Tania,17,0,35,18
1657914563831,COGS 107A,A01,083627,Boyle; Mary E. T.,14,0,60,46
1657914569855,COGS 118A,A01,083075,Gupta; Anjum,21,0,76,55
1657914575880,CSE 3,A50,083646,Miranda; Gregory Joseph,24,0,50,26
1657914581904,CSE 8A,A50,083650,Miranda; Gregory Joseph,17,1,56,39
1657914587927,CSE 11,A01,083080,Cao; Yingjun,6,15,40,34
1657914593951,CSE 12,A01,083652,Krause-Levy; Sophia Louisa,30,1,120,90
1657914599973,CSE 15L,A01,083654,Morris; Justin Loren,9,0,50,41
1657914599973,CSE 15L,A02,083655,Morris; Justin Loren,10,0,50,40
1657914605996,CSE 20,A01,083657,Tran; Khoa Dang,39,0,80,41
1657914612022,CSE 21,A01,095574,Bach; Quang Tran,22,0,48,26
1657914618050,CSE 30,A01,083084,Eldon; John,6,0,80,74
1657914618050,CSE 30,B01,095061,Bhaskar; Nishant,9,0,50,41
1657914624076,CSE 100,A01,083659,Cao; Yingjun,5,4,70,65
1657914630098,CSE 134B,A01,083661,Powell; Thomas Allan,25,0,100,75
1657914636123,CSE 140,A01,083663,Gungor; Onat,16,0,85,69
1657914642147,CSE 140L,A01,083088,Eldon; John,23,0,100,77
1657914648172,CSE 175,A01,083665,Kumar; Rakesh,3,0,25,22
1657914654197,CSE 190,A00,092507,Dubnov; Shlomo,8,0,20,12
1657914660231,ECE 45,A01,083139,Congero; Spencer William,6,0,75,69
1657914666273,ECE 65,A50,083695,Saad; Andrew S,12,0,30,18
1657914666273,ECE 65,A51,095125,Saad; Andrew S,24,0,26,2
1657914672295,ECE 109,A01,091882,Touri; Behrouz,20,0,70,50
1657914678319,ECE 180,A00,083140,Abi Samra; Nicholas Camill,1,0,30,29
1657914678319,ECE 180,B00,083141,Abi Samra; Nicholas Camill,0,0,30,30
1657914684340,MATH 10A,A01,083735,Patchell; Gregory David,2,0,30,28
1657914684340,MATH 10A,A02,083736,Patchell; Gregory David,20,0,30,10
1657914684340,MATH 10A,A03,083737,Patchell; Gregory David,16,0,30,14
1657914690364,MATH 10B,A01,083207,Lim; Seonhee,8,0,34,26
1657914690364,MATH 10B,A02,083208,Lim; Seonhee,10,0,35,25
1657914690364,MATH 10B,A03,093472,Lim; Seonhee,7,0,34,27
1657914690364,MATH 10B,B01,083739,Sinha; Shubham,14,0,30,16
1657914696388,MATH 18,A01,083743,Cinel; Cameron Alexander,9,0,30,21
1657914696388,MATH 18,A02,083744,Cinel; Cameron Alexander,18,0,30,12
1657914696388,MATH 18,A03,083745,Cinel; Cameron Alexander,10,0,30,20
1657914696388,MATH 18,B01,083748,Rideout; David Porter,5,0,37,32
1657914696388,MATH 18,B02,083749,Rideout; David Porter,5,0,36,31
1657914696388,MATH 18,B03,083750,Rideout; David Porter,3,0,37,34
1657914696388,MATH 18,B04,083751,Rideout; David Porter,6,0,36,30
1657914696388,MATH 18,B05,093473,Rideout; David Porter,7,0,36,29
1657914696388,MATH 18,B06,093474,Rideout; David Porter,6,0,36,30
1657914702412,MATH 20A,A01,083754,Zheng; Zequn,14,0,40,26
1657914708439,MATH 20B,A01,083756,Briones; Jor-el Thomas Caparas,4,0,36,32
1657914708439,MATH 20B,A02,083757,Briones; Jor-el Thomas Caparas,1,0,36,35
1657914708439,MATH 20B,A03,093475,Briones; Jor-el Thomas Caparas,2,0,36,34
1657914714469,MATH 20C,A01,083760,Briones; Jor-el Thomas Caparas,1,0,35,34
1657914714469,MATH 20C,A02,083761,Briones; Jor-el Thomas Caparas,8,0,35,27
1657914714469,MATH 20C,A03,093476,Briones; Jor-el Thomas Caparas,0,1,36,36
1657914714469,MATH 20C,B01,083762,Bach; Quang Tran,1,0,30,29
1657914720516,MATH 20D,A01,083765,Tran; Brian Kha,5,0,30,25
1657914720516,MATH 20D,A02,083766,Tran; Brian Kha,5,0,30,25
1657914720516,MATH 20D,A03,083767,Tran; Brian Kha,6,0,30,24
1657914726540,MATH 20E,A01,083771,Ganguly; Soumya,10,0,32,22
1657914726540,MATH 20E,A02,083772,Ganguly; Soumya,7,0,32,25
1657914726540,MATH 20E,B01,083773,Ciotti; Benjamin,20,0,35,15
1657914726540,MATH 20E,B02,083774,Ciotti; Benjamin,18,0,35,17
1657914732564,MATH 103A,A01,083777,Greenfeld; Be'Eri,3,0,36,33
1657914732564,MATH 103A,A02,083778,Greenfeld; Be'Eri,5,0,36,31
1657914732564,MATH 103A,A03,093561,Greenfeld; Be'Eri,6,0,36,30
1657914732564,MATH 103A,B01,083779,Greenfeld; Be'Eri,8,0,36,28
1657914732564,MATH 103A,B02,083780,Greenfeld; Be'Eri,4,0,36,32
1657914732564,MATH 103A,B03,093562,Greenfeld; Be'Eri,3,0,36,33
1657914738593,MATH 105,A01,085443,Carter; Anne Toulson,15,0,35,20
1657914738593,MATH 105,A02,093477,Carter; Anne Toulson,20,0,35,15
1657914744618,MATH 109,A01,083213,Ganzberger; Geoffrey Michael,3,0,34,31
1657914744618,MATH 109,A02,083214,Ganzberger; Geoffrey Michael,4,0,34,30
1657914744618,MATH 109,A03,093478,Ganzberger; Geoffrey Michael,2,0,34,32
1657914744618,MATH 109,B01,083215,Ganzberger; Geoffrey Michael,2,0,32,30
1657914744618,MATH 109,B02,083216,Ganzberger; Geoffrey Michael,2,0,32,30
1657914744618,MATH 109,B03,093479,Ganzberger; Geoffrey Michael,8,0,32,24
1657914750648,MATH 142A,A01,083219,Chow; Bennett,7,0,32,25
1657914750648,MATH 142A,A02,083220,Chow; Bennett,10,0,32,22
1657914750648,MATH 142A,A03,093480,Chow; Bennett,9,0,32,23
1657914750648,MATH 142A,B03,093481,Chow; Bennett,8,0,32,24
1657914750648,MATH 142A,B04,093558,Chow; Bennett,13,0,32,19
1657914750648,MATH 142A,B05,093559,Chow; Bennett,7,0,32,25
1657914756677,MATH 193A,A01,083224,Rotar; Vladimir,8,0,34,26
1657914756677,MATH 193A,A02,083225,Rotar; Vladimir,10,0,34,24
1657914756677,MATH 193A,A03,083781,Rotar; Vladimir,5,0,34,29
1657914756677,MATH 193A,A04,083782,Rotar; Vladimir,11,0,34,23
1657914756677,MATH 193A,A05,093482,Rotar; Vladimir,11,0,34,23
1657914762702,MATH 197,001,091859,McAuley; Julian John,9999,0,9999,0
1657914762702,MATH 197,002,095566,Kedlaya; Kiran S.,9997,0,9999,2
1657914762702,MATH 197,003,095567,Xiao; Ming,9999,0,9999,0
1657914762702,MATH 197,004,095571,Perols; Johan Lars,9998,0,9999,1
1657914769756,COGS 9,A01,083615,Shannon; Kyle Michael,10,0,75,65
1657914775778,COGS 11,A01,083617,Boyle; Mary E. T.,23,0,48,25
1657914781806,COGS 13,A01,083071,Bastos; Amalia Pinkusfeld,11,0,71,60
1657914787827,COGS 14A,A01,092681,Semenuks; Arturs,5,1,100,95
1657914793849,COGS 14B,A01,083073,Cheng; Tzu-Han,6,0,63,57
1657914799872,COGS 17,A01,092677,Semenuks; Arturs,6,0,81,75
1657914805895,COGS 100,A01,083619,Allen; Michael Gordon,17,0,70,53
1657914811937,COGS 101A,A01,083621,Davis; Joshua Daniel,9,0,68,59
1657914817960,COGS 101B,A01,091572,Allen; Michael Gordon,13,0,65,52
1657914823986,COGS 101C,A01,083625,Delgado; Tania,17,0,35,18
1657914830019,COGS 107A,A01,083627,Boyle; Mary E. T.,14,0,60,46
1657914836051,COGS 118A,A01,083075,Gupta; Anjum,21,0,76,55
1657914842076,CSE 3,A50,083646,Miranda; Gregory Joseph,24,0,50,26
1657914848107,CSE 8A,A50,083650,Miranda; Gregory Joseph,17,1,56,39
1657914854132,CSE 11,A01,083080,Cao; Yingjun,6,15,40,34
1657914860156,CSE 12,A01,083652,Krause-Levy; Sophia Louisa,30,1,120,90
1657914866179,CSE 15L,A01,083654,Morris; Justin Loren,9,0,50,41
1657914866179,CSE 15L,A02,083655,Morris; Justin Loren,10,0,50,40
1657914872280,CSE 20,A01,083657,Tran; Khoa Dang,39,0,80,41
1657914878304,CSE 21,A01,095574,Bach; Quang Tran,22,0,48,26
1657914884331,CSE 30,A01,083084,Eldon; John,6,0,80,74
1657914884331,CSE 30,B01,095061,Bhaskar; Nishant,9,0,50,41
1657914890354,CSE 100,A01,083659,Cao; Yingjun,5,4,70,65
1657914896377,CSE 134B,A01,083661,Powell; Thomas Allan,25,0,100,75
1657914902400,CSE 140,A01,083663,Gungor; Onat,16,0,85,69
1657914908422,CSE 140L,A01,083088,Eldon; John,23,0,100,77
1657914914456,CSE 175,A01,083665,Kumar; Rakesh,3,0,25,22
1657914920478,CSE 190,A00,092507,Dubnov; Shlomo,8,0,20,12
1657914926504,ECE 45,A01,083139,Congero; Spencer William,6,0,75,69
1657914932529,ECE 65,A50,083695,Saad; Andrew S,12,0,30,18
1657914932529,ECE 65,A51,095125,Saad; Andrew S,24,0,26,2
1657914938553,ECE 109,A01,091882,Touri; Behrouz,20,0,70,50
1657914944587,ECE 180,A00,083140,Abi Samra; Nicholas Camill,1,0,30,29
1657914944587,ECE 180,B00,083141,Abi Samra; Nicholas Camill,0,0,30,30
1657914950623,MATH 10A,A01,083735,Patchell; Gregory David,2,0,30,28
1657914950623,MATH 10A,A02,083736,Patchell; Gregory David,20,0,30,10
1657914950623,MATH 10A,A03,083737,Patchell; Gregory David,16,0,30,14
1657914956649,MATH 10B,A01,083207,Lim; Seonhee,8,0,34,26
1657914956649,MATH 10B,A02,083208,Lim; Seonhee,10,0,35,25
1657914956649,MATH 10B,A03,093472,Lim; Seonhee,7,0,34,27
1657914956649,MATH 10B,B01,083739,Sinha; Shubham,14,0,30,16
1657914962680,MATH 18,A01,083743,Cinel; Cameron Alexander,9,0,30,21
1657914962680,MATH 18,A02,083744,Cinel; Cameron Alexander,18,0,30,12
1657914962680,MATH 18,A03,083745,Cinel; Cameron Alexander,10,0,30,20
1657914962680,MATH 18,B01,083748,Rideout; David Porter,5,0,37,32
1657914962680,MATH 18,B02,083749,Rideout; David Porter,5,0,36,31
1657914962680,MATH 18,B03,083750,Rideout; David Porter,3,0,37,34
1657914962680,MATH 18,B04,083751,Rideout; David Porter,6,0,36,30
1657914962680,MATH 18,B05,093473,Rideout; David Porter,7,0,36,29
1657914962680,MATH 18,B06,093474,Rideout; David Porter,6,0,36,30
1657914968706,MATH 20A,A01,083754,Zheng; Zequn,14,0,40,26
1657914974735,MATH 20B,A01,083756,Briones; Jor-el Thomas Caparas,4,0,36,32
1657914974735,MATH 20B,A02,083757,Briones; Jor-el Thomas Caparas,1,0,36,35
1657914974735,MATH 20B,A03,093475,Briones; Jor-el Thomas Caparas,2,0,36,34
1657914980760,MATH 20C,A01,083760,Briones; Jor-el Thomas Caparas,1,0,35,34
1657914980760,MATH 20C,A02,083761,Briones; Jor-el Thomas Caparas,8,0,35,27
1657914980760,MATH 20C,A03,093476,Briones; Jor-el Thomas Caparas,0,1,36,36
1657914980760,MATH 20C,B01,083762,Bach; Quang Tran,1,0,30,29
1657914986800,MATH 20D,A01,083765,Tran; Brian Kha,5,0,30,25
1657914986800,MATH 20D,A02,083766,Tran; Brian Kha,5,0,30,25
1657914986800,MATH 20D,A03,083767,Tran; Brian Kha,6,0,30,24
1657914992828,MATH 20E,A01,083771,Ganguly; Soumya,10,0,32,22
1657914992828,MATH 20E,A02,083772,Ganguly; Soumya,7,0,32,25
1657914992828,MATH 20E,B01,083773,Ciotti; Benjamin,20,0,35,15
1657914992828,MATH 20E,B02,083774,Ciotti; Benjamin,18,0,35,17
1657914998853,MATH 103A,A01,083777,Greenfeld; Be'Eri,3,0,36,33
1657914998853,MATH 103A,A02,083778,Greenfeld; Be'Eri,5,0,36,31
1657914998853,MATH 103A,A03,093561,Greenfeld; Be'Eri,6,0,36,30
1657914998853,MATH 103A,B01,083779,Greenfeld; Be'Eri,8,0,36,28
1657914998853,MATH 103A,B02,083780,Greenfeld; Be'Eri,4,0,36,32
1657914998853,MATH 103A,B03,093562,Greenfeld; Be'Eri,3,0,36,33
1657915004881,MATH 105,A01,085443,Carter; Anne Toulson,15,0,35,20
1657915004881,MATH 105,A02,093477,Carter; Anne Toulson,20,0,35,15
1657915010910,MATH 109,A01,083213,Ganzberger; Geoffrey Michael,3,0,34,31
1657915010910,MATH 109,A02,083214,Ganzberger; Geoffrey Michael,4,0,34,30
1657915010910,MATH 109,A03,093478,Ganzberger; Geoffrey Michael,2,0,34,32
1657915010910,MATH 109,B01,083215,Ganzberger; Geoffrey Michael,2,0,32,30
1657915010910,MATH 109,B02,083216,Ganzberger; Geoffrey Michael,2,0,32,30
1657915010910,MATH 109,B03,093479,Ganzberger; Geoffrey Michael,8,0,32,24
1657915016937,MATH 142A,A01,083219,Chow; Bennett,7,0,32,25
1657915016937,MATH 142A,A02,083220,Chow; Bennett,10,0,32,22
1657915016937,MATH 142A,A03,093480,Chow; Bennett,9,0,32,23
1657915016937,MATH 142A,B03,093481,Chow; Bennett,8,0,32,24
1657915016937,MATH 142A,B04,093558,Chow; Bennett,13,0,32,19
1657915016937,MATH 142A,B05,093559,Chow; Bennett,7,0,32,25
1657915022960,MATH 193A,A01,083224,Rotar; Vladimir,8,0,34,26
1657915022960,MATH 193A,A02,083225,Rotar; Vladimir,10,0,34,24
1657915022960,MATH 193A,A03,083781,Rotar; Vladimir,5,0,34,29
1657915022960,MATH 193A,A04,083782,Rotar; Vladimir,11,0,34,23
1657915022960,MATH 193A,A05,093482,Rotar; Vladimir,11,0,34,23
1657915028983,MATH 197,001,091859,McAuley; Julian John,9999,0,9999,0
1657915028983,MATH 197,002,095566,Kedlaya; Kiran S.,9997,0,9999,2
1657915028983,MATH 197,003,095567,Xiao; Ming,9999,0,9999,0
1657915028983,MATH 197,004,095571,Perols; Johan Lars,9998,0,9999,1
1657915036040,COGS 9,A01,083615,Shannon; Kyle Michael,10,0,75,65
1657915042078,COGS 11,A01,083617,Boyle; Mary E. T.,23,0,48,25
1657915048110,COGS 13,A01,083071,Bastos; Amalia Pinkusfeld,11,0,71,60
1657915054138,COGS 14A,A01,092681,Semenuks; Arturs,5,1,100,95
1657915060170,COGS 14B,A01,083073,Cheng; Tzu-Han,6,0,63,57
1657915066211,COGS 17,A01,092677,Semenuks; Arturs,6,0,81,75
1657915072241,COGS 100,A01,083619,Allen; Michael Gordon,17,0,70,53
1657915078264,COGS 101A,A01,083621,Davis; Joshua Daniel,9,0,68,59
1657915084292,COGS 101B,A01,091572,Allen; Michael Gordon,13,0,65,52
1657915090314,COGS 101C,A01,083625,Delgado; Tania,17,0,35,18
1657915096337,COGS 107A,A01,083627,Boyle; Mary E. T.,14,0,60,46
1657915102360,COGS 118A,A01,083075,Gupta; Anjum,21,0,76,55
1657915108388,CSE 3,A50,083646,Miranda; Gregory Joseph,24,0,50,26
1657915114415,CSE 8A,A50,083650,Miranda; Gregory Joseph,17,1,56,39
1657915120439,CSE 11,A01,083080,Cao; Yingjun,6,15,40,34
1657915126461,CSE 12,A01,083652,Krause-Levy; Sophia Louisa,30,1,120,90
1657915132484,CSE 15L,A01,083654,Morris; Justin Loren,9,0,50,41
1657915132484,CSE 15L,A02,083655,Morris; Justin Loren,10,0,50,40
1657915138510,CSE 20,A01,083657,Tran; Khoa Dang,39,0,80,41
1657915144533,CSE 21,A01,095574,Bach; Quang Tran,22,0,48,26
1657915150557,CSE 30,A01,083084,Eldon; John,6,0,80,74
1657915150557,CSE 30,B01,095061,Bhaskar; Nishant,9,0,50,41
1657915156578,CSE 100,A01,083659,Cao; Yingjun,5,4,70,65
1657915162601,CSE 134B,A01,083661,Powell; Thomas Allan,25,0,100,75
1657915168625,CSE 140,A01,083663,Gungor; Onat,16,0,85,69
1657915174647,CSE 140L,A01,083088,Eldon; John,23,0,100,77
1657915180669,CSE 175,A01,083665,Kumar; Rakesh,3,0,25,22
1657915186694,CSE 190,A00,092507,Dubnov; Shlomo,8,0,20,12
1657915192717,ECE 45,A01,083139,Congero; Spencer William,6,0,75,69
1657915198738,ECE 65,A50,083695,Saad; Andrew S,12,0,30,18
1657915198738,ECE 65,A51,095125,Saad; Andrew S,24,0,26,2
1657915204767,ECE 109,A01,091882,Touri; Behrouz,20,0,70,50
1657915210792,ECE 180,A00,083140,Abi Samra; Nicholas Camill,1,0,30,29
1657915210792,ECE 180,B00,083141,Abi Samra; Nicholas Camill,0,0,30,30
1657915216835,MATH 10A,A01,083735,Patchell; Gregory David,2,0,30,28
1657915216835,MATH 10A,A02,083736,Patchell; Gregory David,20,0,30,10
1657915216835,MATH 10A,A03,083737,Patchell; Gregory David,16,0,30,14
1657915222858,MATH 10B,A01,083207,Lim; Seonhee,8,0,34,26
1657915222858,MATH 10B,A02,083208,Lim; Seonhee,10,0,35,25
1657915222858,MATH 10B,A03,093472,Lim; Seonhee,7,0,34,27
1657915222858,MATH 10B,B01,083739,Sinha; Shubham,14,0,30,16
1657915228881,MATH 18,A01,083743,Cinel; Cameron Alexander,9,0,30,21
1657915228881,MATH 18,A02,083744,Cinel; Cameron Alexander,18,0,30,12
1657915228881,MATH 18,A03,083745,Cinel; Cameron Alexander,10,0,30,20
1657915228881,MATH 18,B01,083748,Rideout; David Porter,5,0,37,32
1657915228881,MATH 18,B02,083749,Rideout; David Porter,5,0,36,31
1657915228881,MATH 18,B03,083750,Rideout; David Porter,3,0,37,34
1657915228881,MATH 18,B04,083751,Rideout; David Porter,6,0,36,30
1657915228881,MATH 18,B05,093473,Rideout; David Porter,7,0,36,29
1657915228881,MATH 18,B06,093474,Rideout; David Porter,6,0,36,30
1657915234907,MATH 20A,A01,083754,Zheng; Zequn,14,0,40,26
1657915240930,MATH 20B,A01,083756,Briones; Jor-el Thomas Caparas,4,0,36,32
1657915240930,MATH 20B,A02,083757,Briones; Jor-el Thomas Caparas,1,0,36,35
1657915240930,MATH 20B,A03,093475,Briones; Jor-el Thomas Caparas,2,0,36,34
1657915246953,MATH 20C,A01,083760,Briones; Jor-el Thomas Caparas,1,0,35,34
1657915246953,MATH 20C,A02,083761,Briones; Jor-el Thomas Caparas,8,0,35,27
1657915246953,MATH 20C,A03,093476,Briones; Jor-el Thomas Caparas,0,1,36,36
1657915246953,MATH 20C,B01,083762,Bach; Quang Tran,1,0,30,29
1657915252978,MATH 20D,A01,083765,Tran; Brian Kha,5,0,30,25
1657915252978,MATH 20D,A02,083766,Tran; Brian Kha,5,0,30,25
1657915252978,MATH 20D,A03,083767,Tran; Brian Kha,6,0,30,24
1657915259018,MATH 20E,A01,083771,Ganguly; Soumya,10,0,32,22
1657915259018,MATH 20E,A02,083772,Ganguly; Soumya,7,0,32,25
1657915259018,MATH 20E,B01,083773,Ciotti; Benjamin,20,0,35,15
1657915259018,MATH 20E,B02,083774,Ciotti; Benjamin,18,0,35,17
1657915265042,MATH 103A,A01,083777,Greenfeld; Be'Eri,3,0,36,33
1657915265042,MATH 103A,A02,083778,Greenfeld; Be'Eri,5,0,36,31
1657915265042,MATH 103A,A03,093561,Greenfeld; Be'Eri,6,0,36,30
1657915265042,MATH 103A,B01,083779,Greenfeld; Be'Eri,8,0,36,28
1657915265042,MATH 103A,B02,083780,Greenfeld; Be'Eri,4,0,36,32
1657915265042,MATH 103A,B03,093562,Greenfeld; Be'Eri,3,0,36,33
1657915271069,MATH 105,A01,085443,Carter; Anne Toulson,15,0,35,20
1657915271069,MATH 105,A02,093477,Carter; Anne Toulson,20,0,35,15
1657915277092,MATH 109,A01,083213,Ganzberger; Geoffrey Michael,3,0,34,31
1657915277092,MATH 109,A02,083214,Ganzberger; Geoffrey Michael,4,0,34,30
1657915277092,MATH 109,A03,093478,Ganzberger; Geoffrey Michael,2,0,34,32
1657915277092,MATH 109,B01,083215,Ganzberger; Geoffrey Michael,2,0,32,30
1657915277092,MATH 109,B02,083216,Ganzberger; Geoffrey Michael,2,0,32,30
1657915277092,MATH 109,B03,093479,Ganzberger; Geoffrey Michael,8,0,32,24
1657915283117,MATH 142A,A01,083219,Chow; Bennett,7,0,32,25
1657915283117,MATH 142A,A02,083220,Chow; Bennett,10,0,32,22
1657915283117,MATH 142A,A03,093480,Chow; Bennett,9,0,32,23
1657915283117,MATH 142A,B03,093481,Chow; Bennett,8,0,32,24
1657915283117,MATH 142A,B04,093558,Chow; Bennett,13,0,32,19
1657915283117,MATH 142A,B05,093559,Chow; Bennett,7,0,32,25
1657915289146,MATH 193A,A01,083224,Rotar; Vladimir,8,0,34,26
1657915289146,MATH 193A,A02,083225,Rotar; Vladimir,10,0,34,24
1657915289146,MATH 193A,A03,083781,Rotar; Vladimir,5,0,34,29
1657915289146,MATH 193A,A04,083782,Rotar; Vladimir,11,0,34,23
1657915289146,MATH 193A,A05,093482,Rotar; Vladimir,11,0,34,23
1657915295172,MATH 197,001,091859,McAuley; Julian John,9999,0,9999,0
1657915295172,MATH 197,002,095566,Kedlaya; Kiran S.,9997,0,9999,2
1657915295172,MATH 197,003,095567,Xiao; Ming,9999,0,9999,0
1657915295172,MATH 197,004,095571,Perols; Johan Lars,9998,0,9999,1
1657915302238,COGS 9,A01,083615,Shannon; Kyle Michael,10,0,75,65
1657915308261,COGS 11,A01,083617,Boyle; Mary E. T.,23,0,48,25
1657915314288,COGS 13,A01,083071,Bastos; Amalia Pinkusfeld,11,0,71,60
1657915320326,COGS 14A,A01,092681,Semenuks; Arturs,5,1,100,95
1657915326352,COGS 14B,A01,083073,Cheng; Tzu-Han,6,0,63,57
1657915332394,COGS 17,A01,092677,Semenuks; Arturs,6,0,81,75
1657915338421,COGS 100,A01,083619,Allen; Michael Gordon,17,0,70,53
1657915344450,COGS 101A,A01,083621,Davis; Joshua Daniel,9,0,68,59
1657915350472,COGS 101B,A01,091572,Allen; Michael Gordon,13,0,65,52
1657915356504,COGS 101C,A01,083625,Delgado; Tania,17,0,35,18
1657915362529,COGS 107A,A01,083627,Boyle; Mary E. T.,14,0,60,46
1657915368555,COGS 118A,A01,083075,Gupta; Anjum,21,0,76,55
1657915374580,CSE 3,A50,083646,Miranda; Gregory Joseph,24,0,50,26
1657915380602,CSE 8A,A50,083650,Miranda; Gregory Joseph,17,1,56,39
1657915386625,CSE 11,A01,083080,Cao; Yingjun,6,15,40,34
1657915392648,CSE 12,A01,083652,Krause-Levy; Sophia Louisa,30,1,120,90
1657915398677,CSE 15L,A01,083654,Morris; Justin Loren,9,0,50,41
1657915398677,CSE 15L,A02,083655,Morris; Justin Loren,10,0,50,40
1657915404711,CSE 20,A01,083657,Tran; Khoa Dang,39,0,80,41
1657915410737,CSE 21,A01,095574,Bach; Quang Tran,22,0,48,26
1657915416768,CSE 30,A01,083084,Eldon; John,6,0,80,74
1657915416768,CSE 30,B01,095061,Bhaskar; Nishant,9,0,50,41
1657915422790,CSE 100,A01,083659,Cao; Yingjun,5,4,70,65
1657915428813,CSE 134B,A01,083661,Powell; Thomas Allan,25,0,100,75
1657915434846,CSE 140,A01,083663,Gungor; Onat,16,0,85,69
1657915440873,CSE 140L,A01,083088,Eldon; John,23,0,100,77
1657915446899,CSE 175,A01,083665,Kumar; Rakesh,3,0,25,22
1657915452922,CSE 190,A00,092507,Dubnov; Shlomo,8,0,20,12
1657915458945,ECE 45,A01,083139,Congero; Spencer William,6,0,75,69
1657915464974,ECE 65,A50,083695,Saad; Andrew S,12,0,30,18
1657915464974,ECE 65,A51,095125,Saad; Andrew S,24,0,26,2
1657915471086,ECE 109,A01,091882,Touri; Behrouz,20,0,70,50
1657915477113,ECE 180,A00,083140,Abi Samra; Nicholas Camill,1,0,30,29
1657915477113,ECE 180,B00,083141,Abi Samra; Nicholas Camill,0,0,30,30
1657915483140,MATH 10A,A01,083735,Patchell; Gregory David,2,0,30,28
1657915483140,MATH 10A,A02,083736,Patchell; Gregory David,20,0,30,10
1657915483140,MATH 10A,A03,083737,Patchell; Gregory David,16,0,30,14
1657915489165,MATH 10B,A01,083207,Lim; Seonhee,8,0,34,26
1657915489165,MATH 10B,A02,083208,Lim; Seonhee,10,0,35,25
1657915489165,MATH 10B,A03,093472,Lim; Seonhee,7,0,34,27
1657915489165,MATH 10B,B01,083739,Sinha; Shubham,14,0,30,16
1657915495203,MATH 18,A01,083743,Cinel; Cameron Alexander,9,0,30,21
1657915495203,MATH 18,A02,083744,Cinel; Cameron Alexander,18,0,30,12
1657915495203,MATH 18,A03,083745,Cinel; Cameron Alexander,10,0,30,20
1657915495203,MATH 18,B01,083748,Rideout; David Porter,5,0,37,32
1657915495203,MATH 18,B02,083749,Rideout; David Porter,5,0,36,31
1657915495203,MATH 18,B03,083750,Rideout; David Porter,3,0,37,34
1657915495203,MATH 18,B04,083751,Rideout; David Porter,6,0,36,30
1657915495203,MATH 18,B05,093473,Rideout; David Porter,7,0,36,29
1657915495203,MATH 18,B06,093474,Rideout; David Porter,6,0,36,30
1657915501226,MATH 20A,A01,083754,Zheng; Zequn,14,0,40,26
1657915507313,MATH 20B,A01,083756,Briones; Jor-el Thomas Caparas,4,0,36,32
1657915507313,MATH 20B,A02,083757,Briones; Jor-el Thomas Caparas,1,0,36,35
1657915507313,MATH 20B,A03,093475,Briones; Jor-el Thomas Caparas,2,0,36,34
1657915513335,MATH 20C,A01,083760,Briones; Jor-el Thomas Caparas,1,0,35,34
1657915513335,MATH 20C,A02,083761,Briones; Jor-el Thomas Caparas,8,0,35,27
1657915513335,MATH 20C,A03,093476,Briones; Jor-el Thomas Caparas,0,1,36,36
1657915513335,MATH 20C,B01,083762,Bach; Quang Tran,1,0,30,29
1657915519367,MATH 20D,A01,083765,Tran; Brian Kha,5,0,30,25
1657915519367,MATH 20D,A02,083766,Tran; Brian Kha,5,0,30,25
1657915519367,MATH 20D,A03,083767,Tran; Brian Kha,6,0,30,24
1657915525390,MATH 20E,A01,083771,Ganguly; Soumya,10,0,32,22
1657915525390,MATH 20E,A02,083772,Ganguly; Soumya,7,0,32,25
1657915525390,MATH 20E,B01,083773,Ciotti; Benjamin,20,0,35,15
1657915525390,MATH 20E,B02,083774,Ciotti; Benjamin,18,0,35,17
1657915531414,MATH 103A,A01,083777,Greenfeld; Be'Eri,3,0,36,33
1657915531414,MATH 103A,A02,083778,Greenfeld; Be'Eri,5,0,36,31
1657915531414,MATH 103A,A03,093561,Greenfeld; Be'Eri,6,0,36,30
1657915531414,MATH 103A,B01,083779,Greenfeld; Be'Eri,8,0,36,28
1657915531414,MATH 103A,B02,083780,Greenfeld; Be'Eri,4,0,36,32
1657915531414,MATH 103A,B03,093562,Greenfeld; Be'Eri,3,0,36,33
1657915537436,MATH 105,A01,085443,Carter; Anne Toulson,15,0,35,20
1657915537436,MATH 105,A02,093477,Carter; Anne Toulson,20,0,35,15
1657915543460,MATH 109,A01,083213,Ganzberger; Geoffrey Michael,3,0,34,31
1657915543460,MATH 109,A02,083214,Ganzberger; Geoffrey Michael,4,0,34,30
1657915543460,MATH 109,A03,093478,Ganzberger; Geoffrey Michael,2,0,34,32
1657915543460,MATH 109,B01,083215,Ganzberger; Geoffrey Michael,2,0,32,30
1657915543460,MATH 109,B02,083216,Ganzberger; Geoffrey Michael,2,0,32,30
1657915543460,MATH 109,B03,093479,Ganzberger; Geoffrey Michael,8,0,32,24
1657915549482,MATH 142A,A01,083219,Chow; Bennett,7,0,32,25
1657915549482,MATH 142A,A02,083220,Chow; Bennett,10,0,32,22
1657915549482,MATH 142A,A03,093480,Chow; Bennett,9,0,32,23
1657915549482,MATH 142A,B03,093481,Chow; Bennett,8,0,32,24
1657915549482,MATH 142A,B04,093558,Chow; Bennett,13,0,32,19
1657915549482,MATH 142A,B05,093559,Chow; Bennett,7,0,32,25
1657915555506,MATH 193A,A01,083224,Rotar; Vladimir,8,0,34,26
1657915555506,MATH 193A,A02,083225,Rotar; Vladimir,10,0,34,24
1657915555506,MATH 193A,A03,083781,Rotar; Vladimir,5,0,34,29
1657915555506,MATH 193A,A04,083782,Rotar; Vladimir,11,0,34,23
1657915555506,MATH 193A,A05,093482,Rotar; Vladimir,11,0,34,23
1657915561538,MATH 197,001,091859,McAuley; Julian John,9999,0,9999,0
1657915561538,MATH 197,002,095566,Kedlaya; Kiran S.,9997,0,9999,2
1657915561538,MATH 197,003,095567,Xiao; Ming,9999,0,9999,0
1657915561538,MATH 197,004,095571,Perols; Johan Lars,9998,0,9999,1
1657915568611,COGS 9,A01,083615,Shannon; Kyle Michael,10,0,75,65
1657915574634,COGS 11,A01,083617,Boyle; Mary E. T.,23,0,48,25
1657915580662,COGS 13,A01,083071,Bastos; Amalia Pinkusfeld,11,0,71,60
1657915586689,COGS 14A,A01,092681,Semenuks; Arturs,5,1,100,95
1657915592715,COGS 14B,A01,083073,Cheng; Tzu-Han,6,0,63,57
1657915598737,COGS 17,A01,092677,Semenuks; Arturs,6,0,81,75
1657915604761,COGS 100,A01,083619,Allen; Michael Gordon,17,0,70,53
1657915610784,COGS 101A,A01,083621,Davis; Joshua Daniel,9,0,68,59
1657915616806,COGS 101B,A01,091572,Allen; Michael Gordon,13,0,65,52
1657915622830,COGS 101C,A01,083625,Delgado; Tania,17,0,35,18
1657915628857,COGS 107A,A01,083627,Boyle; Mary E. T.,14,0,60,46
1657915634879,COGS 118A,A01,083075,Gupta; Anjum,21,0,76,55
1657915640906,CSE 3,A50,083646,Miranda; Gregory Joseph,24,0,50,26
1657915646939,CSE 8A,A50,083650,Miranda; Gregory Joseph,17,1,56,39
1657915652971,CSE 11,A01,083080,Cao; Yingjun,6,15,40,34
1657915659011,CSE 12,A01,083652,Krause-Levy; Sophia Louisa,30,1,120,90
1657915665037,CSE 15L,A01,083654,Morris; Justin Loren,9,0,50,41
1657915665037,CSE 15L,A02,083655,Morris; Justin Loren,10,0,50,40
1657915671063,CSE 20,A01,083657,Tran; Khoa Dang,39,0,80,41
1657915677089,CSE 21,A01,095574,Bach; Quang Tran,22,0,48,26
1657915683111,CSE 30,A01,083084,Eldon; John,6,0,80,74
1657915683111,CSE 30,B01,095061,Bhaskar; Nishant,9,0,50,41
1657915689133,CSE 100,A01,083659,Cao; Yingjun,5,4,70,65
1657915695155,CSE 134B,A01,083661,Powell; Thomas Allan,25,0,100,75
1657915701180,CSE 140,A01,083663,Gungor; Onat,16,0,85,69
1657915707208,CSE 140L,A01,083088,Eldon; John,23,0,100,77
1657915713238,CSE 175,A01,083665,Kumar; Rakesh,3,0,25,22
1657915719263,CSE 190,A00,092507,Dubnov; Shlomo,8,0,20,12
1657915725287,ECE 45,A01,083139,Congero; Spencer William,6,0,75,69
1657915731319,ECE 65,A50,083695,Saad; Andrew S,12,0,30,18
1657915731319,ECE 65,A51,095125,Saad; Andrew S,24,0,26,2
1657915737349,ECE 109,A01,091882,Touri; Behrouz,20,0,70,50
1657915743372,ECE 180,A00,083140,Abi Samra; Nicholas Camill,1,0,30,29
1657915743372,ECE 180,B00,083141,Abi Samra; Nicholas Camill,0,0,30,30
1657915749399,MATH 10A,A01,083735,Patchell; Gregory David,2,0,30,28
1657915749399,MATH 10A,A02,083736,Patchell; Gregory David,20,0,30,10
1657915749399,MATH 10A,A03,083737,Patchell; Gregory David,16,0,30,14
1657915755427,MATH 10B,A01,083207,Lim; Seonhee,8,0,34,26
1657915755427,MATH 10B,A02,083208,Lim; Seonhee,10,0,35,25
1657915755427,MATH 10B,A03,093472,Lim; Seonhee,7,0,34,27
1657915755427,MATH 10B,B01,083739,Sinha; Shubham,14,0,30,16
1657915761473,MATH 18,A01,083743,Cinel; Cameron Alexander,9,0,30,21
1657915761473,MATH 18,A02,083744,Cinel; Cameron Alexander,18,0,30,12
1657915761473,MATH 18,A03,083745,Cinel; Cameron Alexander,10,0,30,20
1657915761473,MATH 18,B01,083748,Rideout; David Porter,5,0,37,32
1657915761473,MATH 18,B02,083749,Rideout; David Porter,5,0,36,31
1657915761473,MATH 18,B03,083750,Rideout; David Porter,3,0,37,34
1657915761473,MATH 18,B04,083751,Rideout; David Porter,6,0,36,30
1657915761473,MATH 18,B05,093473,Rideout; David Porter,7,0,36,29
1657915761473,MATH 18,B06,093474,Rideout; David Porter,6,0,36,30
1657915767498,MATH 20A,A01,083754,Zheng; Zequn,14,0,40,26
1657915773525,MATH 20B,A01,083756,Briones; Jor-el Thomas Caparas,4,0,36,32
1657915773525,MATH 20B,A02,083757,Briones; Jor-el Thomas Caparas,1,0,36,35
1657915773525,MATH 20B,A03,093475,Briones; Jor-el Thomas Caparas,2,0,36,34
1657915779549,MATH 20C,A01,083760,Briones; Jor-el Thomas Caparas,1,0,35,34
1657915779549,MATH 20C,A02,083761,Briones; Jor-el Thomas Caparas,8,0,35,27
1657915779549,MATH 20C,A03,093476,Briones; Jor-el Thomas Caparas,0,1,36,36
1657915779549,MATH 20C,B01,083762,Bach; Quang Tran,1,0,30,29
1657915785577,MATH 20D,A01,083765,Tran; Brian Kha,5,0,30,25
1657915785577,MATH 20D,A02,083766,Tran; Brian Kha,5,0,30,25
1657915785577,MATH 20D,A03,083767,Tran; Brian Kha,6,0,30,24
1657915791602,MATH 20E,A01,083771,Ganguly; Soumya,10,0,32,22
1657915791602,MATH 20E,A02,083772,Ganguly; Soumya,7,0,32,25
1657915791602,MATH 20E,B01,083773,Ciotti; Benjamin,20,0,35,15
1657915791602,MATH 20E,B02,083774,Ciotti; Benjamin,18,0,35,17
1657915797626,MATH 103A,A01,083777,Greenfeld; Be'Eri,3,0,36,33
1657915797626,MATH 103A,A02,083778,Greenfeld; Be'Eri,5,0,36,31
1657915797626,MATH 103A,A03,093561,Greenfeld; Be'Eri,6,0,36,30
1657915797626,MATH 103A,B01,083779,Greenfeld; Be'Eri,8,0,36,28
1657915797626,MATH 103A,B02,083780,Greenfeld; Be'Eri,4,0,36,32
1657915797626,MATH 103A,B03,093562,Greenfeld; Be'Eri,3,0,36,33
1657915803650,MATH 105,A01,085443,Carter; Anne Toulson,15,0,35,20
1657915803650,MATH 105,A02,093477,Carter; Anne Toulson,20,0,35,15
1657915809676,MATH 109,A01,083213,Ganzberger; Geoffrey Michael,3,0,34,31
1657915809676,MATH 109,A02,083214,Ganzberger; Geoffrey Michael,4,0,34,30
1657915809676,MATH 109,A03,093478,Ganzberger; Geoffrey Michael,2,0,34,32
1657915809676,MATH 109,B01,083215,Ganzberger; Geoffrey Michael,2,0,32,30
1657915809676,MATH 109,B02,083216,Ganzberger; Geoffrey Michael,2,0,32,30
1657915809676,MATH 109,B03,093479,Ganzberger; Geoffrey Michael,8,0,32,24
1657915815700,MATH 142A,A01,083219,Chow; Bennett,7,0,32,25
1657915815700,MATH 142A,A02,083220,Chow; Bennett,10,0,32,22
1657915815700,MATH 142A,A03,093480,Chow; Bennett,9,0,32,23
1657915815700,MATH 142A,B03,093481,Chow; Bennett,8,0,32,24
1657915815700,MATH 142A,B04,093558,Chow; Bennett,13,0,32,19
1657915815700,MATH 142A,B05,093559,Chow; Bennett,7,0,32,25
1657915821723,MATH 193A,A01,083224,Rotar; Vladimir,8,0,34,26
1657915821723,MATH 193A,A02,083225,Rotar; Vladimir,10,0,34,24
1657915821723,MATH 193A,A03,083781,Rotar; Vladimir,5,0,34,29
1657915821723,MATH 193A,A04,083782,Rotar; Vladimir,11,0,34,23
1657915821723,MATH 193A,A05,093482,Rotar; Vladimir,11,0,34,23
1657915827749,MATH 197,001,091859,McAuley; Julian John,9999,0,9999,0
1657915827749,MATH 197,002,095566,Kedlaya; Kiran S.,9997,0,9999,2
1657915827749,MATH 197,003,095567,Xiao; Ming,9999,0,9999,0
1657915827749,MATH 197,004,095571,Perols; Johan Lars,9998,0,9999,1
1657915834809,COGS 9,A01,083615,Shannon; Kyle Michael,10,0,75,65
1657915840835,COGS 11,A01,083617,Boyle; Mary E. T.,23,0,48,25
1657915846856,COGS 13,A01,083071,Bastos; Amalia Pinkusfeld,11,0,71,60
1657915852879,COGS 14A,A01,092681,Semenuks; Arturs,5,1,100,95
1657915858902,COGS 14B,A01,083073,Cheng; Tzu-Han,6,0,63,57
1657915864933,COGS 17,A01,092677,Semenuks; Arturs,6,0,81,75
1657915870959,COGS 100,A01,083619,Allen; Michael Gordon,17,0,70,53
1657915876988,COGS 101A,A01,083621,Davis; Joshua Daniel,9,0,68,59
1657915883013,COGS 101B,A01,091572,Allen; Michael Gordon,13,0,65,52
1657915889039,COGS 101C,A01,083625,Delgado; Tania,17,0,35,18
1657915895066,COGS 107A,A01,083627,Boyle; Mary E. T.,14,0,60,46
1657915901092,COGS 118A,A01,083075,Gupta; Anjum,21,0,76,55
1657915907114,CSE 3,A50,083646,Miranda; Gregory Joseph,24,0,50,26
1657915913136,CSE 8A,A50,083650,Miranda; Gregory Joseph,17,1,56,39
1657915919165,CSE 11,A01,083080,Cao; Yingjun,6,15,40,34
1657915925187,CSE 12,A01,083652,Krause-Levy; Sophia Louisa,30,1,120,90
1657915931213,CSE 15L,A01,083654,Morris; Justin Loren,9,0,50,41
1657915931213,CSE 15L,A02,083655,Morris; Justin Loren,10,0,50,40
1657915937237,CSE 20,A01,083657,Tran; Khoa Dang,39,0,80,41
1657915943259,CSE 21,A01,095574,Bach; Quang Tran,22,0,48,26
1657915949288,CSE 30,A01,083084,Eldon; John,6,0,80,74
1657915949288,CSE 30,B01,095061,Bhaskar; Nishant,9,0,50,41
1657915955311,CSE 100,A01,083659,Cao; Yingjun,5,4,70,65
1657915961333,CSE 134B,A01,083661,Powell; Thomas Allan,25,0,100,75
1657915967360,CSE 140,A01,083663,Gungor; Onat,16,0,85,69
1657915973384,CSE 140L,A01,083088,Eldon; John,23,0,100,77
1657915979415,CSE 175,A01,083665,Kumar; Rakesh,3,0,25,22
1657915985443,CSE 190,A00,092507,Dubnov; Shlomo,8,0,20,12
1657915991469,ECE 45,A01,083139,Congero; Spencer William,6,0,75,69
1657915997494,ECE 65,A50,083695,Saad; Andrew S,12,0,30,18
1657915997494,ECE 65,A51,095125,Saad; Andrew S,24,0,26,2
1657916003520,ECE 109,A01,091882,Touri; Behrouz,20,0,70,50
1657916009548,ECE 180,A00,083140,Abi Samra; Nicholas Camill,1,0,30,29
1657916009548,ECE 180,B00,083141,Abi Samra; Nicholas Camill,0,0,30,30
1657916015572,MATH 10A,A01,083735,Patchell; Gregory David,2,0,30,28
1657916015572,MATH 10A,A02,083736,Patchell; Gregory David,20,0,30,10
1657916015572,MATH 10A,A03,083737,Patchell; Gregory David,16,0,30,14
1657916021596,MATH 10B,A01,083207,Lim; Seonhee,8,0,34,26
1657916021596,MATH 10B,A02,083208,Lim; Seonhee,10,0,35,25
1657916021596,MATH 10B,A03,093472,Lim; Seonhee,7,0,34,27
1657916021596,MATH 10B,B01,083739,Sinha; Shubham,14,0,30,16
1657916027620,MATH 18,A01,083743,Cinel; Cameron Alexander,9,0,30,21
1657916027620,MATH 18,A02,083744,Cinel; Cameron Alexander,18,0,30,12
1657916027620,MATH 18,A03,083745,Cinel; Cameron Alexander,10,0,30,20
1657916027620,MATH 18,B01,083748,Rideout; David Porter,5,0,37,32
1657916027620,MATH 18,B02,083749,Rideout; David Porter,5,0,36,31
1657916027620,MATH 18,B03,083750,Rideout; David Porter,3,0,37,34
1657916027620,MATH 18,B04,083751,Rideout; David Porter,6,0,36,30
1657916027620,MATH 18,B05,093473,Rideout; David Porter,7,0,36,29
1657916027620,MATH 18,B06,093474,Rideout; David Porter,6,0,36,30
1657916033643,MATH 20A,A01,083754,Zheng; Zequn,14,0,40,26
1657916039670,MATH 20B,A01,083756,Briones; Jor-el Thomas Caparas,4,0,36,32
1657916039670,MATH 20B,A02,083757,Briones; Jor-el Thomas Caparas,1,0,36,35
1657916039670,MATH 20B,A03,093475,Briones; Jor-el Thomas Caparas,2,0,36,34
1657916045693,MATH 20C,A01,083760,Briones; Jor-el Thomas Caparas,1,0,35,34
1657916045693,MATH 20C,A02,083761,Briones; Jor-el Thomas Caparas,8,0,35,27
1657916045693,MATH 20C,A03,093476,Briones; Jor-el Thomas Caparas,0,1,36,36
1657916045693,MATH 20C,B01,083762,Bach; Quang Tran,1,0,30,29
1657916051716,MATH 20D,A01,083765,Tran; Brian Kha,5,0,30,25
1657916051716,MATH 20D,A02,083766,Tran; Brian Kha,5,0,30,25
1657916051716,MATH 20D,A03,083767,Tran; Brian Kha,6,0,30,24
1657916057740,MATH 20E,A01,083771,Ganguly; Soumya,10,0,32,22
1657916057740,MATH 20E,A02,083772,Ganguly; Soumya,7,0,32,25
1657916057740,MATH 20E,B01,083773,Ciotti; Benjamin,20,0,35,15
1657916057740,MATH 20E,B02,083774,Ciotti; Benjamin,18,0,35,17
1657916063770,MATH 103A,A01,083777,Greenfeld; Be'Eri,3,0,36,33
1657916063770,MATH 103A,A02,083778,Greenfeld; Be'Eri,5,0,36,31
1657916063770,MATH 103A,A03,093561,Greenfeld; Be'Eri,6,0,36,30
1657916063770,MATH 103A,B01,083779,Greenfeld; Be'Eri,8,0,36,28
1657916063770,MATH 103A,B02,083780,Greenfeld; Be'Eri,4,0,36,32
1657916063770,MATH 103A,B03,093562,Greenfeld; Be'Eri,3,0,36,33
1657916069889,MATH 105,A01,085443,Carter; Anne Toulson,15,0,35,20
1657916069889,MATH 105,A02,093477,Carter; Anne Toulson,20,0,35,15
1657916075916,MATH 109,A01,083213,Ganzberger; Geoffrey Michael,3,0,34,31
1657916075916,MATH 109,A02,083214,Ganzberger; Geoffrey Michael,4,0,34,30
1657916075916,MATH 109,A03,093478,Ganzberger; Geoffrey Michael,2,0,34,32
1657916075916,MATH 109,B01,083215,Ganzberger; Geoffrey Michael,2,0,32,30
1657916075916,MATH 109,B02,083216,Ganzberger; Geoffrey Michael,2,0,32,30
1657916075916,MATH 109,B03,093479,Ganzberger; Geoffrey Michael,8,0,32,24
1657916081956,MATH 142A,A01,083219,Chow; Bennett,7,0,32,25
1657916081956,MATH 142A,A02,083220,Chow; Bennett,10,0,32,22
1657916081956,MATH 142A,A03,093480,Chow; Bennett,9,0,32,23
1657916081956,MATH 142A,B03,093481,Chow; Bennett,8,0,32,24
1657916081956,MATH 142A,B04,093558,Chow; Bennett,13,0,32,19
1657916081956,MATH 142A,B05,093559,Chow; Bennett,7,0,32,25
1657916087988,MATH 193A,A01,083224,Rotar; Vladimir,8,0,34,26
1657916087988,MATH 193A,A02,083225,Rotar; Vladimir,10,0,34,24
1657916087988,MATH 193A,A03,083781,Rotar; Vladimir,5,0,34,29
1657916087988,MATH 193A,A04,083782,Rotar; Vladimir,11,0,34,23
1657916087988,MATH 193A,A05,093482,Rotar; Vladimir,11,0,34,23
1657916094012,MATH 197,001,091859,McAuley; Julian John,9999,0,9999,0
1657916094012,MATH 197,002,095566,Kedlaya; Kiran S.,9997,0,9999,2
1657916094012,MATH 197,003,095567,Xiao; Ming,9999,0,9999,0
1657916094012,MATH 197,004,095571,Perols; Johan Lars,9998,0,9999,1
1657916101083,COGS 9,A01,083615,Shannon; Kyle Michael,10,0,75,65
1657916107107,COGS 11,A01,083617,Boyle; Mary E. T.,23,0,48,25
1657916113128,COGS 13,A01,083071,Bastos; Amalia Pinkusfeld,11,0,71,60
1657916119151,COGS 14A,A01,092681,Semenuks; Arturs,5,1,100,95
1657916125173,COGS 14B,A01,083073,Cheng; Tzu-Han,6,0,63,57
1657916131203,COGS 17,A01,092677,Semenuks; Arturs,6,0,81,75
1657916137232,COGS 100,A01,083619,Allen; Michael Gordon,17,0,70,53
1657916143265,COGS 101A,A01,083621,Davis; Joshua Daniel,9,0,68,59
1657916149289,COGS 101B,A01,091572,Allen; Michael Gordon,13,0,65,52
1657916155315,COGS 101C,A01,083625,Delgado; Tania,17,0,35,18
1657916161341,COGS 107A,A01,083627,Boyle; Mary E. T.,14,0,60,46
1657916167367,COGS 118A,A01,083075,Gupta; Anjum,21,0,76,55
1657916173392,CSE 3,A50,083646,Miranda; Gregory Joseph,24,0,50,26
1657916179419,CSE 8A,A50,083650,Miranda; Gregory Joseph,17,1,56,39
1657916185442,CSE 11,A01,083080,Cao; Yingjun,6,15,40,34
1657916191470,CSE 12,A01,083652,Krause-Levy; Sophia Louisa,30,1,120,90
1657916197491,CSE 15L,A01,083654,Morris; Justin Loren,9,0,50,41
1657916197491,CSE 15L,A02,083655,Morris; Justin Loren,10,0,50,40
1657916203519,CSE 20,A01,083657,Tran; Khoa Dang,39,0,80,41
1657916209541,CSE 21,A01,095574,Bach; Quang Tran,22,0,48,26
1657916215563,CSE 30,A01,083084,Eldon; John,6,0,80,74
1657916215563,CSE 30,B01,095061,Bhaskar; Nishant,9,0,50,41
1657916221588,CSE 100,A01,083659,Cao; Yingjun,5,4,70,65
1657916227611,CSE 134B,A01,083661,Powell; Thomas Allan,25,0,100,75
1657916233634,CSE 140,A01,083663,Gungor; Onat,16,0,85,69
1657916239660,CSE 140L,A01,083088,Eldon; John,23,0,100,77
1657916245691,CSE 175,A01,083665,Kumar; Rakesh,3,0,25,22
1657916251726,CSE 190,A00,092507,Dubnov; Shlomo,8,0,20,12
1657916257752,ECE 45,A01,083139,Congero; Spencer William,6,0,75,69
1657916263773,ECE 65,A50,083695,Saad; Andrew S,12,0,30,18
1657916263773,ECE 65,A51,095125,Saad; Andrew S,24,0,26,2
1657916269796,ECE 109,A01,091882,Touri; Behrouz,20,0,70,50
1657916275823,ECE 180,A00,083140,Abi Samra; Nicholas Camill,1,0,30,29
1657916275823,ECE 180,B00,083141,Abi Samra; Nicholas Camill,0,0,30,30
1657916281851,MATH 10A,A01,083735,Patchell; Gregory David,2,0,30,28
1657916281851,MATH 10A,A02,083736,Patchell; Gregory David,20,0,30,10
1657916281851,MATH 10A,A03,083737,Patchell; Gregory David,16,0,30,14
1657916287879,MATH 10B,A01,083207,Lim; Seonhee,8,0,34,26
1657916287879,MATH 10B,A02,083208,Lim; Seonhee,10,0,35,25
1657916287879,MATH 10B,A03,093472,Lim; Seonhee,7,0,34,27
1657916287879,MATH 10B,B01,083739,Sinha; Shubham,14,0,30,16
1657916293912,MATH 18,A01,083743,Cinel; Cameron Alexander,9,0,30,21
1657916293912,MATH 18,A02,083744,Cinel; Cameron Alexander,18,0,30,12
1657916293912,MATH 18,A03,083745,Cinel; Cameron Alexander,10,0,30,20
1657916293912,MATH 18,B01,083748,Rideout; David Porter,5,0,37,32
1657916293912,MATH 18,B02,083749,Rideout; David Porter,5,0,36,31
1657916293912,MATH 18,B03,083750,Rideout; David Porter,3,0,37,34
1657916293912,MATH 18,B04,083751,Rideout; David Porter,6,0,36,30
1657916293912,MATH 18,B05,093473,Rideout; David Porter,7,0,36,29
1657916293912,MATH 18,B06,093474,Rideout; David Porter,6,0,36,30
1657916299935,MATH 20A,A01,083754,Zheng; Zequn,14,0,40,26
1657916305957,MATH 20B,A01,083756,Briones; Jor-el Thomas Caparas,4,0,36,32
1657916305957,MATH 20B,A02,083757,Briones; Jor-el Thomas Caparas,1,0,36,35
1657916305957,MATH 20B,A03,093475,Briones; Jor-el Thomas Caparas,2,0,36,34
1657916311987,MATH 20C,A01,083760,Briones; Jor-el Thomas Caparas,1,0,35,34
1657916311987,MATH 20C,A02,083761,Briones; Jor-el Thomas Caparas,8,0,35,27
1657916311987,MATH 20C,A03,093476,Briones; Jor-el Thomas Caparas,0,1,36,36
1657916311987,MATH 20C,B01,083762,Bach; Quang Tran,1,0,30,29
1657916318009,MATH 20D,A01,083765,Tran; Brian Kha,5,0,30,25
1657916318009,MATH 20D,A02,083766,Tran; Brian Kha,5,0,30,25
1657916318009,MATH 20D,A03,083767,Tran; Brian Kha,6,0,30,24
1657916324032,MATH 20E,A01,083771,Ganguly; Soumya,10,0,32,22
1657916324032,MATH 20E,A02,083772,Ganguly; Soumya,7,0,32,25
1657916324032,MATH 20E,B01,083773,Ciotti; Benjamin,20,0,35,15
1657916324032,MATH 20E,B02,083774,Ciotti; Benjamin,18,0,35,17
1657916330062,MATH 103A,A01,083777,Greenfeld; Be'Eri,3,0,36,33
1657916330062,MATH 103A,A02,083778,Greenfeld; Be'Eri,5,0,36,31
1657916330062,MATH 103A,A03,093561,Greenfeld; Be'Eri,6,0,36,30
1657916330062,MATH 103A,B01,083779,Greenfeld; Be'Eri,8,0,36,28
1657916330062,MATH 103A,B02,083780,Greenfeld; Be'Eri,4,0,36,32
1657916330062,MATH 103A,B03,093562,Greenfeld; Be'Eri,3,0,36,33
1657916336090,MATH 105,A01,085443,Carter; Anne Toulson,15,0,35,20
1657916336090,MATH 105,A02,093477,Carter; Anne Toulson,20,0,35,15
1657916342112,MATH 109,A01,083213,Ganzberger; Geoffrey Michael,3,0,34,31
1657916342112,MATH 109,A02,083214,Ganzberger; Geoffrey Michael,4,0,34,30
1657916342112,MATH 109,A03,093478,Ganzberger; Geoffrey Michael,2,0,34,32
1657916342112,MATH 109,B01,083215,Ganzberger; Geoffrey Michael,2,0,32,30
1657916342112,MATH 109,B02,083216,Ganzberger; Geoffrey Michael,2,0,32,30
1657916342112,MATH 109,B03,093479,Ganzberger; Geoffrey Michael,8,0,32,24
1657916348142,MATH 142A,A01,083219,Chow; Bennett,7,0,32,25
1657916348142,MATH 142A,A02,083220,Chow; Bennett,10,0,32,22
1657916348142,MATH 142A,A03,093480,Chow; Bennett,9,0,32,23
1657916348142,MATH 142A,B03,093481,Chow; Bennett,8,0,32,24
1657916348142,MATH 142A,B04,093558,Chow; Bennett,13,0,32,19
1657916348142,MATH 142A,B05,093559,Chow; Bennett,7,0,32,25
1657916354172,MATH 193A,A01,083224,Rotar; Vladimir,8,0,34,26
1657916354172,MATH 193A,A02,083225,Rotar; Vladimir,10,0,34,24
1657916354172,MATH 193A,A03,083781,Rotar; Vladimir,5,0,34,29
1657916354172,MATH 193A,A04,083782,Rotar; Vladimir,11,0,34,23
1657916354172,MATH 193A,A05,093482,Rotar; Vladimir,11,0,34,23
1657916360197,MATH 197,001,091859,McAuley; Julian John,9999,0,9999,0
1657916360197,MATH 197,002,095566,Kedlaya; Kiran S.,9997,0,9999,2
1657916360197,MATH 197,003,095567,Xiao; Ming,9999,0,9999,0
1657916360197,MATH 197,004,095571,Perols; Johan Lars,9998,0,9999,1
1657916367252,COGS 9,A01,083615,Shannon; Kyle Michael,10,0,75,65
1657916373278,COGS 11,A01,083617,Boyle; Mary E. T.,23,0,48,25
1657916379325,COGS 13,A01,083071,Bastos; Amalia Pinkusfeld,11,0,71,60
1657916385364,COGS 14A,A01,092681,Semenuks; Arturs,5,1,100,95
1657916391392,COGS 14B,A01,083073,Cheng; Tzu-Han,6,0,63,57
1657916397419,COGS 17,A01,092677,Semenuks; Arturs,6,0,81,75
1657916403441,COGS 100,A01,083619,Allen; Michael Gordon,17,0,70,53
1657916409471,COGS 101A,A01,083621,Davis; Joshua Daniel,9,0,68,59
1657916415498,COGS 101B,A01,091572,Allen; Michael Gordon,13,0,65,52
1657916421521,COGS 101C,A01,083625,Delgado; Tania,17,0,35,18
1657916427545,COGS 107A,A01,083627,Boyle; Mary E. T.,14,0,60,46
1657916433569,COGS 118A,A01,083075,Gupta; Anjum,21,0,76,55
1657916439592,CSE 3,A50,083646,Miranda; Gregory Joseph,24,0,50,26
1657916445614,CSE 8A,A50,083650,Miranda; Gregory Joseph,17,1,56,39
1657916451636,CSE 11,A01,083080,Cao; Yingjun,6,15,40,34
1657916457659,CSE 12,A01,083652,Krause-Levy; Sophia Louisa,30,1,120,90
1657916463682,CSE 15L,A01,083654,Morris; Justin Loren,9,0,50,41
1657916463682,CSE 15L,A02,083655,Morris; Justin Loren,10,0,50,40
1657916469705,CSE 20,A01,083657,Tran; Khoa Dang,39,0,80,41
1657916475726,CSE 21,A01,095574,Bach; Quang Tran,22,0,48,26
1657916481747,CSE 30,A01,083084,Eldon; John,6,0,80,74
1657916481747,CSE 30,B01,095061,Bhaskar; Nishant,9,0,50,41
1657916487773,CSE 100,A01,083659,Cao; Yingjun,5,4,70,65
1657916493801,CSE 134B,A01,083661,Powell; Thomas Allan,25,0,100,75
1657916499828,CSE 140,A01,083663,Gungor; Onat,16,0,85,69
1657916505852,CSE 140L,A01,083088,Eldon; John,23,0,100,77
1657916511875,CSE 175,A01,083665,Kumar; Rakesh,3,0,25,22
1657916517899,CSE 190,A00,092507,Dubnov; Shlomo,8,0,20,12
1657916523924,ECE 45,A01,083139,Congero; Spencer William,7,0,75,68
1657916529950,ECE 65,A50,083695,Saad; Andrew S,12,0,30,18
1657916529950,ECE 65,A51,095125,Saad; Andrew S,24,0,26,2
1657916535976,ECE 109,A01,091882,Touri; Behrouz,20,0,70,50
1657916541998,ECE 180,A00,083140,Abi Samra; Nicholas Camill,1,0,30,29
1657916541998,ECE 180,B00,083141,Abi Samra; Nicholas Camill,0,0,30,30
1657916548025,MATH 10A,A01,083735,Patchell; Gregory David,2,0,30,28
1657916548025,MATH 10A,A02,083736,Patchell; Gregory David,20,0,30,10
1657916548025,MATH 10A,A03,083737,Patchell; Gregory David,16,0,30,14
1657916554053,MATH 10B,A01,083207,Lim; Seonhee,8,0,34,26
1657916554053,MATH 10B,A02,083208,Lim; Seonhee,10,0,35,25
1657916554053,MATH 10B,A03,093472,Lim; Seonhee,7,0,34,27
1657916554053,MATH 10B,B01,083739,Sinha; Shubham,14,0,30,16
1657916560079,MATH 18,A01,083743,Cinel; Cameron Alexander,9,0,30,21
1657916560079,MATH 18,A02,083744,Cinel; Cameron Alexander,18,0,30,12
1657916560079,MATH 18,A03,083745,Cinel; Cameron Alexander,10,0,30,20
1657916560079,MATH 18,B01,083748,Rideout; David Porter,5,0,37,32
1657916560079,MATH 18,B02,083749,Rideout; David Porter,5,0,36,31
1657916560079,MATH 18,B03,083750,Rideout; David Porter,3,0,37,34
1657916560079,MATH 18,B04,083751,Rideout; David Porter,6,0,36,30
1657916560079,MATH 18,B05,093473,Rideout; David Porter,7,0,36,29
1657916560079,MATH 18,B06,093474,Rideout; David Porter,6,0,36,30
1657916566105,MATH 20A,A01,083754,Zheng; Zequn,14,0,40,26
1657916572136,MATH 20B,A01,083756,Briones; Jor-el Thomas Caparas,4,0,36,32
1657916572136,MATH 20B,A02,083757,Briones; Jor-el Thomas Caparas,1,0,36,35
1657916572136,MATH 20B,A03,093475,Briones; Jor-el Thomas Caparas,2,0,36,34
1657916578160,MATH 20C,A01,083760,Briones; Jor-el Thomas Caparas,1,0,35,34
1657916578160,MATH 20C,A02,083761,Briones; Jor-el Thomas Caparas,8,0,35,27
1657916578160,MATH 20C,A03,093476,Briones; Jor-el Thomas Caparas,0,1,36,36
1657916578160,MATH 20C,B01,083762,Bach; Quang Tran,1,0,30,29
1657916584183,MATH 20D,A01,083765,Tran; Brian Kha,5,0,30,25
1657916584183,MATH 20D,A02,083766,Tran; Brian Kha,5,0,30,25
1657916584183,MATH 20D,A03,083767,Tran; Brian Kha,6,0,30,24
1657916590212,MATH 20E,A01,083771,Ganguly; Soumya,10,0,32,22
1657916590212,MATH 20E,A02,083772,Ganguly; Soumya,7,0,32,25
1657916590212,MATH 20E,B01,083773,Ciotti; Benjamin,20,0,35,15
1657916590212,MATH 20E,B02,083774,Ciotti; Benjamin,18,0,35,17
1657916596242,MATH 103A,A01,083777,Greenfeld; Be'Eri,3,0,36,33
1657916596242,MATH 103A,A02,083778,Greenfeld; Be'Eri,5,0,36,31
1657916596242,MATH 103A,A03,093561,Greenfeld; Be'Eri,6,0,36,30
1657916596242,MATH 103A,B01,083779,Greenfeld; Be'Eri,8,0,36,28
1657916596242,MATH 103A,B02,083780,Greenfeld; Be'Eri,4,0,36,32
1657916596242,MATH 103A,B03,093562,Greenfeld; Be'Eri,3,0,36,33
1657916602265,MATH 105,A01,085443,Carter; Anne Toulson,15,0,35,20
1657916602265,MATH 105,A02,093477,Carter; Anne Toulson,20,0,35,15
1657916608301,MATH 109,A01,083213,Ganzberger; Geoffrey Michael,3,0,34,31
1657916608301,MATH 109,A02,083214,Ganzberger; Geoffrey Michael,4,0,34,30
1657916608301,MATH 109,A03,093478,Ganzberger; Geoffrey Michael,2,0,34,32
1657916608301,MATH 109,B01,083215,Ganzberger; Geoffrey Michael,2,0,32,30
1657916608301,MATH 109,B02,083216,Ganzberger; Geoffrey Michael,2,0,32,30
1657916608301,MATH 109,B03,093479,Ganzberger; Geoffrey Michael,8,0,32,24
1657916614324,MATH 142A,A01,083219,Chow; Bennett,7,0,32,25
1657916614324,MATH 142A,A02,083220,Chow; Bennett,10,0,32,22
1657916614324,MATH 142A,A03,093480,Chow; Bennett,9,0,32,23
1657916614324,MATH 142A,B03,093481,Chow; Bennett,8,0,32,24
1657916614324,MATH 142A,B04,093558,Chow; Bennett,13,0,32,19
1657916614324,MATH 142A,B05,093559,Chow; Bennett,7,0,32,25
1657916620348,MATH 193A,A01,083224,Rotar; Vladimir,8,0,34,26
1657916620348,MATH 193A,A02,083225,Rotar; Vladimir,10,0,34,24
1657916620348,MATH 193A,A03,083781,Rotar; Vladimir,5,0,34,29
1657916620348,MATH 193A,A04,083782,Rotar; Vladimir,11,0,34,23
1657916620348,MATH 193A,A05,093482,Rotar; Vladimir,11,0,34,23
1657916626371,MATH 197,001,091859,McAuley; Julian John,9999,0,9999,0
1657916626371,MATH 197,002,095566,Kedlaya; Kiran S.,9997,0,9999,2
1657916626371,MATH 197,003,095567,Xiao; Ming,9999,0,9999,0
1657916626371,MATH 197,004,095571,Perols; Johan Lars,9998,0,9999,1
1657916633436,COGS 9,A01,083615,Shannon; Kyle Michael,10,0,75,65
1657916639476,COGS 11,A01,083617,Boyle; Mary E. T.,23,0,48,25
1657916645498,COGS 13,A01,083071,Bastos; Amalia Pinkusfeld,11,0,71,60
1657916651524,COGS 14A,A01,092681,Semenuks; Arturs,5,1,100,95
1657916657549,COGS 14B,A01,083073,Cheng; Tzu-Han,6,0,63,57
1657916663658,COGS 17,A01,092677,Semenuks; Arturs,6,0,81,75
1657916669681,COGS 100,A01,083619,Allen; Michael Gordon,17,0,70,53
1657916675709,COGS 101A,A01,083621,Davis; Joshua Daniel,9,0,68,59
1657916681730,COGS 101B,A01,091572,Allen; Michael Gordon,13,0,65,52
1657916687756,COGS 101C,A01,083625,Delgado; Tania,17,0,35,18
1657916693792,COGS 107A,A01,083627,Boyle; Mary E. T.,14,0,60,46
1657916699816,COGS 118A,A01,083075,Gupta; Anjum,21,0,76,55
1657916705843,CSE 3,A50,083646,Miranda; Gregory Joseph,24,0,50,26
1657916711866,CSE 8A,A50,083650,Miranda; Gregory Joseph,17,1,56,39
1657916717890,CSE 11,A01,083080,Cao; Yingjun,6,15,40,34
1657916723913,CSE 12,A01,083652,Krause-Levy; Sophia Louisa,30,1,120,90
1657916729935,CSE 15L,A01,083654,Morris; Justin Loren,9,0,50,41
1657916729935,CSE 15L,A02,083655,Morris; Justin Loren,10,0,50,40
1657916735962,CSE 20,A01,083657,Tran; Khoa Dang,39,0,80,41
1657916741988,CSE 21,A01,095574,Bach; Quang Tran,22,0,48,26
1657916748011,CSE 30,A01,083084,Eldon; John,6,0,80,74
1657916748011,CSE 30,B01,095061,Bhaskar; Nishant,9,0,50,41
1657916754037,CSE 100,A01,083659,Cao; Yingjun,5,4,70,65
1657916760064,CSE 134B,A01,083661,Powell; Thomas Allan,25,0,100,75
1657916766090,CSE 140,A01,083663,Gungor; Onat,16,0,85,69
1657916772112,CSE 140L,A01,083088,Eldon; John,23,0,100,77
1657916778142,CSE 175,A01,083665,Kumar; Rakesh,3,0,25,22
1657916784168,CSE 190,A00,092507,Dubnov; Shlomo,8,0,20,12
1657916790196,ECE 45,A01,083139,Congero; Spencer William,7,0,75,68
1657916796222,ECE 65,A50,083695,Saad; Andrew S,12,0,30,18
1657916796222,ECE 65,A51,095125,Saad; Andrew S,24,0,26,2
1657916802257,ECE 109,A01,091882,Touri; Behrouz,20,0,70,50
1657916808283,ECE 180,A00,083140,Abi Samra; Nicholas Camill,1,0,30,29
1657916808283,ECE 180,B00,083141,Abi Samra; Nicholas Camill,0,0,30,30
1657916814311,MATH 10A,A01,083735,Patchell; Gregory David,2,0,30,28
1657916814311,MATH 10A,A02,083736,Patchell; Gregory David,20,0,30,10
1657916814311,MATH 10A,A03,083737,Patchell; Gregory David,16,0,30,14
1657916820334,MATH 10B,A01,083207,Lim; Seonhee,8,0,34,26
1657916820334,MATH 10B,A02,083208,Lim; Seonhee,10,0,35,25
1657916820334,MATH 10B,A03,093472,Lim; Seonhee,7,0,34,27
1657916820334,MATH 10B,B01,083739,Sinha; Shubham,14,0,30,16
1657916826358,MATH 18,A01,083743,Cinel; Cameron Alexander,9,0,30,21
1657916826358,MATH 18,A02,083744,Cinel; Cameron Alexander,18,0,30,12
1657916826358,MATH 18,A03,083745,Cinel; Cameron Alexander,10,0,30,20
1657916826358,MATH 18,B01,083748,Rideout; David Porter,5,0,37,32
1657916826358,MATH 18,B02,083749,Rideout; David Porter,5,0,36,31
1657916826358,MATH 18,B03,083750,Rideout; David Porter,3,0,37,34
1657916826358,MATH 18,B04,083751,Rideout; David Porter,6,0,36,30
1657916826358,MATH 18,B05,093473,Rideout; David Porter,7,0,36,29
1657916826358,MATH 18,B06,093474,Rideout; David Porter,6,0,36,30
1657916832385,MATH 20A,A01,083754,Zheng; Zequn,14,0,40,26
1657916838408,MATH 20B,A01,083756,Briones; Jor-el Thomas Caparas,4,0,36,32
1657916838408,MATH 20B,A02,083757,Briones; Jor-el Thomas Caparas,1,0,36,35
1657916838408,MATH 20B,A03,093475,Briones; Jor-el Thomas Caparas,2,0,36,34
1657916844431,MATH 20C,A01,083760,Briones; Jor-el Thomas Caparas,1,0,35,34
1657916844431,MATH 20C,A02,083761,Briones; Jor-el Thomas Caparas,8,0,35,27
1657916844431,MATH 20C,A03,093476,Briones; Jor-el Thomas Caparas,0,1,36,36
1657916844431,MATH 20C,B01,083762,Bach; Quang Tran,1,0,30,29
1657916850457,MATH 20D,A01,083765,Tran; Brian Kha,5,0,30,25
1657916850457,MATH 20D,A02,083766,Tran; Brian Kha,5,0,30,25
1657916850457,MATH 20D,A03,083767,Tran; Brian Kha,6,0,30,24
1657916856486,MATH 20E,A01,083771,Ganguly; Soumya,10,0,32,22
1657916856486,MATH 20E,A02,083772,Ganguly; Soumya,7,0,32,25
1657916856486,MATH 20E,B01,083773,Ciotti; Benjamin,20,0,35,15
1657916856486,MATH 20E,B02,083774,Ciotti; Benjamin,18,0,35,17
1657916862510,MATH 103A,A01,083777,Greenfeld; Be'Eri,3,0,36,33
1657916862510,MATH 103A,A02,083778,Greenfeld; Be'Eri,5,0,36,31
1657916862510,MATH 103A,A03,093561,Greenfeld; Be'Eri,6,0,36,30
1657916862510,MATH 103A,B01,083779,Greenfeld; Be'Eri,8,0,36,28
1657916862510,MATH 103A,B02,083780,Greenfeld; Be'Eri,4,0,36,32
1657916862510,MATH 103A,B03,093562,Greenfeld; Be'Eri,3,0,36,33
1657916868534,MATH 105,A01,085443,Carter; Anne Toulson,15,0,35,20
1657916868534,MATH 105,A02,093477,Carter; Anne Toulson,20,0,35,15
1657916874573,MATH 109,A01,083213,Ganzberger; Geoffrey Michael,3,0,34,31
1657916874573,MATH 109,A02,083214,Ganzberger; Geoffrey Michael,4,0,34,30
1657916874573,MATH 109,A03,093478,Ganzberger; Geoffrey Michael,2,0,34,32
1657916874573,MATH 109,B01,083215,Ganzberger; Geoffrey Michael,2,0,32,30
1657916874573,MATH 109,B02,083216,Ganzberger; Geoffrey Michael,2,0,32,30
1657916874573,MATH 109,B03,093479,Ganzberger; Geoffrey Michael,8,0,32,24
1657916880599,MATH 142A,A01,083219,Chow; Bennett,7,0,32,25
1657916880599,MATH 142A,A02,083220,Chow; Bennett,10,0,32,22
1657916880599,MATH 142A,A03,093480,Chow; Bennett,9,0,32,23
1657916880599,MATH 142A,B03,093481,Chow; Bennett,8,0,32,24
1657916880599,MATH 142A,B04,093558,Chow; Bennett,13,0,32,19
1657916880599,MATH 142A,B05,093559,Chow; Bennett,7,0,32,25
1657916886623,MATH 193A,A01,083224,Rotar; Vladimir,8,0,34,26
1657916886623,MATH 193A,A02,083225,Rotar; Vladimir,10,0,34,24
1657916886623,MATH 193A,A03,083781,Rotar; Vladimir,5,0,34,29
1657916886623,MATH 193A,A04,083782,Rotar; Vladimir,11,0,34,23
1657916886623,MATH 193A,A05,093482,Rotar; Vladimir,11,0,34,23
1657916892648,MATH 197,001,091859,McAuley; Julian John,9999,0,9999,0
1657916892648,MATH 197,002,095566,Kedlaya; Kiran S.,9997,0,9999,2
1657916892648,MATH 197,003,095567,Xiao; Ming,9999,0,9999,0
1657916892648,MATH 197,004,095571,Perols; Johan Lars,9998,0,9999,1
1657916899703,COGS 9,A01,083615,Shannon; Kyle Michael,10,0,75,65
1657916905725,COGS 11,A01,083617,Boyle; Mary E. T.,23,0,48,25
1657916911748,COGS 13,A01,083071,Bastos; Amalia Pinkusfeld,11,0,71,60
1657916917774,COGS 14A,A01,092681,Semenuks; Arturs,5,1,100,95
1657916923795,COGS 14B,A01,083073,Cheng; Tzu-Han,6,0,63,57
1657916929825,COGS 17,A01,092677,Semenuks; Arturs,6,0,81,75
1657916935860,COGS 100,A01,083619,Allen; Michael Gordon,17,0,70,53
1657916941884,COGS 101A,A01,083621,Davis; Joshua Daniel,9,0,68,59
1657916947906,COGS 101B,A01,091572,Allen; Michael Gordon,13,0,65,52
1657916953928,COGS 101C,A01,083625,Delgado; Tania,17,0,35,18
1657916959955,COGS 107A,A01,083627,Boyle; Mary E. T.,14,0,60,46
1657916965978,COGS 118A,A01,083075,Gupta; Anjum,21,0,76,55
1657916972002,CSE 3,A50,083646,Miranda; Gregory Joseph,24,0,50,26
1657916978029,CSE 8A,A50,083650,Miranda; Gregory Joseph,17,1,56,39
1657916984052,CSE 11,A01,083080,Cao; Yingjun,6,15,40,34
1657916990085,CSE 12,A01,083652,Krause-Levy; Sophia Louisa,30,1,120,90
1657916996107,CSE 15L,A01,083654,Morris; Justin Loren,9,0,50,41
1657916996107,CSE 15L,A02,083655,Morris; Justin Loren,10,0,50,40
1657917002140,CSE 20,A01,083657,Tran; Khoa Dang,39,0,80,41
1657917008163,CSE 21,A01,095574,Bach; Quang Tran,22,0,48,26
1657917014189,CSE 30,A01,083084,Eldon; John,6,0,80,74
1657917014189,CSE 30,B01,095061,Bhaskar; Nishant,9,0,50,41
1657917020216,CSE 100,A01,083659,Cao; Yingjun,5,4,70,65
1657917026240,CSE 134B,A01,083661,Powell; Thomas Allan,25,0,100,75
1657917032262,CSE 140,A01,083663,Gungor; Onat,16,0,85,69
1657917038287,CSE 140L,A01,083088,Eldon; John,23,0,100,77
1657917044311,CSE 175,A01,083665,Kumar; Rakesh,3,0,25,22
1657917050344,CSE 190,A00,092507,Dubnov; Shlomo,8,0,20,12
1657917056370,ECE 45,A01,083139,Congero; Spencer William,7,0,75,68
1657917062401,ECE 65,A50,083695,Saad; Andrew S,12,0,30,18
1657917062401,ECE 65,A51,095125,Saad; Andrew S,24,0,26,2
1657917068432,ECE 109,A01,091882,Touri; Behrouz,20,0,70,50
1657917074455,ECE 180,A00,083140,Abi Samra; Nicholas Camill,1,0,30,29
1657917074455,ECE 180,B00,083141,Abi Samra; Nicholas Camill,0,0,30,30
1657917080489,MATH 10A,A01,083735,Patchell; Gregory David,2,0,30,28
1657917080489,MATH 10A,A02,083736,Patchell; Gregory David,20,0,30,10
1657917080489,MATH 10A,A03,083737,Patchell; Gregory David,16,0,30,14
1657917086526,MATH 10B,A01,083207,Lim; Seonhee,8,0,34,26
1657917086526,MATH 10B,A02,083208,Lim; Seonhee,10,0,35,25
1657917086526,MATH 10B,A03,093472,Lim; Seonhee,7,0,34,27
1657917086526,MATH 10B,B01,083739,Sinha; Shubham,14,0,30,16
1657917092552,MATH 18,A01,083743,Cinel; Cameron Alexander,9,0,30,21
1657917092552,MATH 18,A02,083744,Cinel; Cameron Alexander,18,0,30,12
1657917092552,MATH 18,A03,083745,Cinel; Cameron Alexander,10,0,30,20
1657917092552,MATH 18,B01,083748,Rideout; David Porter,5,0,37,32
1657917092552,MATH 18,B02,083749,Rideout; David Porter,5,0,36,31
1657917092552,MATH 18,B03,083750,Rideout; David Porter,3,0,37,34
1657917092552,MATH 18,B04,083751,Rideout; David Porter,6,0,36,30
1657917092552,MATH 18,B05,093473,Rideout; David Porter,7,0,36,29
1657917092552,MATH 18,B06,093474,Rideout; David Porter,6,0,36,30
1657917098575,MATH 20A,A01,083754,Zheng; Zequn,14,0,40,26
1657917104604,MATH 20B,A01,083756,Briones; Jor-el Thomas Caparas,4,0,36,32
1657917104604,MATH 20B,A02,083757,Briones; Jor-el Thomas Caparas,1,0,36,35
1657917104604,MATH 20B,A03,093475,Briones; Jor-el Thomas Caparas,2,0,36,34
1657917110628,MATH 20C,A01,083760,Briones; Jor-el Thomas Caparas,1,0,35,34
1657917110628,MATH 20C,A02,083761,Briones; Jor-el Thomas Caparas,8,0,35,27
1657917110628,MATH 20C,A03,093476,Briones; Jor-el Thomas Caparas,0,1,36,36
1657917110628,MATH 20C,B01,083762,Bach; Quang Tran,1,0,30,29
1657917116661,MATH 20D,A01,083765,Tran; Brian Kha,5,0,30,25
1657917116661,MATH 20D,A02,083766,Tran; Brian Kha,5,0,30,25
1657917116661,MATH 20D,A03,083767,Tran; Brian Kha,6,0,30,24
1657917122690,MATH 20E,A01,083771,Ganguly; Soumya,10,0,32,22
1657917122690,MATH 20E,A02,083772,Ganguly; Soumya,7,0,32,25
1657917122690,MATH 20E,B01,083773,Ciotti; Benjamin,20,0,35,15
1657917122690,MATH 20E,B02,083774,Ciotti; Benjamin,18,0,35,17
1657917128716,MATH 103A,A01,083777,Greenfeld; Be'Eri,3,0,36,33
1657917128716,MATH 103A,A02,083778,Greenfeld; Be'Eri,5,0,36,31
1657917128716,MATH 103A,A03,093561,Greenfeld; Be'Eri,6,0,36,30
1657917128716,MATH 103A,B01,083779,Greenfeld; Be'Eri,8,0,36,28
1657917128716,MATH 103A,B02,083780,Greenfeld; Be'Eri,4,0,36,32
1657917128716,MATH 103A,B03,093562,Greenfeld; Be'Eri,3,0,36,33
1657917134739,MATH 105,A01,085443,Carter; Anne Toulson,15,0,35,20
1657917134739,MATH 105,A02,093477,Carter; Anne Toulson,20,0,35,15
1657917140768,MATH 109,A01,083213,Ganzberger; Geoffrey Michael,3,0,34,31
1657917140768,MATH 109,A02,083214,Ganzberger; Geoffrey Michael,4,0,34,30
1657917140768,MATH 109,A03,093478,Ganzberger; Geoffrey Michael,2,0,34,32
1657917140768,MATH 109,B01,083215,Ganzberger; Geoffrey Michael,2,0,32,30
1657917140768,MATH 109,B02,083216,Ganzberger; Geoffrey Michael,2,0,32,30
1657917140768,MATH 109,B03,093479,Ganzberger; Geoffrey Michael,8,0,32,24
1657917146792,MATH 142A,A01,083219,Chow; Bennett,7,0,32,25
1657917146792,MATH 142A,A02,083220,Chow; Bennett,10,0,32,22
1657917146792,MATH 142A,A03,093480,Chow; Bennett,9,0,32,23
1657917146792,MATH 142A,B03,093481,Chow; Bennett,8,0,32,24
1657917146792,MATH 142A,B04,093558,Chow; Bennett,13,0,32,19
1657917146792,MATH 142A,B05,093559,Chow; Bennett,7,0,32,25
1657917152826,MATH 193A,A01,083224,Rotar; Vladimir,8,0,34,26
1657917152826,MATH 193A,A02,083225,Rotar; Vladimir,10,0,34,24
1657917152826,MATH 193A,A03,083781,Rotar; Vladimir,5,0,34,29
1657917152826,MATH 193A,A04,083782,Rotar; Vladimir,11,0,34,23
1657917152826,MATH 193A,A05,093482,Rotar; Vladimir,11,0,34,23
1657917158853,MATH 197,001,091859,McAuley; Julian John,9999,0,9999,0
1657917158853,MATH 197,002,095566,Kedlaya; Kiran S.,9997,0,9999,2
1657917158853,MATH 197,003,095567,Xiao; Ming,9999,0,9999,0
1657917158853,MATH 197,004,095571,Perols; Johan Lars,9998,0,9999,1
1657917165916,COGS 9,A01,083615,Shannon; Kyle Michael,10,0,75,65
1657917171941,COGS 11,A01,083617,Boyle; Mary E. T.,23,0,48,25
1657917177965,COGS 13,A01,083071,Bastos; Amalia Pinkusfeld,11,0,71,60
1657917183991,COGS 14A,A01,092681,Semenuks; Arturs,5,1,100,95
1657917190026,COGS 14B,A01,083073,Cheng; Tzu-Han,6,0,63,57
1657917196059,COGS 17,A01,092677,Semenuks; Arturs,6,0,81,75
1657917202081,COGS 100,A01,083619,Allen; Michael Gordon,17,0,70,53
1657917208105,COGS 101A,A01,083621,Davis; Joshua Daniel,9,0,68,59
1657917214127,COGS 101B,A01,091572,Allen; Michael Gordon,13,0,65,52
1657917220149,COGS 101C,A01,083625,Delgado; Tania,17,0,35,18
1657917226172,COGS 107A,A01,083627,Boyle; Mary E. T.,14,0,60,46
1657917232195,COGS 118A,A01,083075,Gupta; Anjum,21,0,76,55
1657917238221,CSE 3,A50,083646,Miranda; Gregory Joseph,24,0,50,26
1657917244247,CSE 8A,A50,083650,Miranda; Gregory Joseph,17,1,56,39
1657917250270,CSE 11,A01,083080,Cao; Yingjun,6,15,40,34
1657917256293,CSE 12,A01,083652,Krause-Levy; Sophia Louisa,30,1,120,90
1657917262389,CSE 15L,A01,083654,Morris; Justin Loren,9,0,50,41
1657917262389,CSE 15L,A02,083655,Morris; Justin Loren,10,0,50,40
1657917268416,CSE 20,A01,083657,Tran; Khoa Dang,39,0,80,41
1657917274438,CSE 21,A01,095574,Bach; Quang Tran,22,0,48,26
1657917280464,CSE 30,A01,083084,Eldon; John,6,0,80,74
1657917280464,CSE 30,B01,095061,Bhaskar; Nishant,9,0,50,41
1657917286487,CSE 100,A01,083659,Cao; Yingjun,5,4,70,65
1657917292510,CSE 134B,A01,083661,Powell; Thomas Allan,25,0,100,75
1657917298532,CSE 140,A01,083663,Gungor; Onat,16,0,85,69
1657917304555,CSE 140L,A01,083088,Eldon; John,23,0,100,77
1657917310592,CSE 175,A01,083665,Kumar; Rakesh,3,0,25,22
1657917316617,CSE 190,A00,092507,Dubnov; Shlomo,8,0,20,12
1657917322638,ECE 45,A01,083139,Congero; Spencer William,7,0,75,68
1657917328666,ECE 65,A50,083695,Saad; Andrew S,12,0,30,18
1657917328666,ECE 65,A51,095125,Saad; Andrew S,24,0,26,2
1657917334692,ECE 109,A01,091882,Touri; Behrouz,20,0,70,50
1657917340714,ECE 180,A00,083140,Abi Samra; Nicholas Camill,1,0,30,29
1657917340714,ECE 180,B00,083141,Abi Samra; Nicholas Camill,0,0,30,30
1657917346745,MATH 10A,A01,083735,Patchell; Gregory David,2,0,30,28
1657917346745,MATH 10A,A02,083736,Patchell; Gregory David,20,0,30,10
1657917346745,MATH 10A,A03,083737,Patchell; Gregory David,16,0,30,14
1657917352769,MATH 10B,A01,083207,Lim; Seonhee,8,0,34,26
1657917352769,MATH 10B,A02,083208,Lim; Seonhee,10,0,35,25
1657917352769,MATH 10B,A03,093472,Lim; Seonhee,7,0,34,27
1657917352769,MATH 10B,B01,083739,Sinha; Shubham,14,0,30,16
1657917358792,MATH 18,A01,083743,Cinel; Cameron Alexander,9,0,30,21
1657917358792,MATH 18,A02,083744,Cinel; Cameron Alexander,18,0,30,12
1657917358792,MATH 18,A03,083745,Cinel; Cameron Alexander,10,0,30,20
1657917358792,MATH 18,B01,083748,Rideout; David Porter,5,0,37,32
1657917358792,MATH 18,B02,083749,Rideout; David Porter,5,0,36,31
1657917358792,MATH 18,B03,083750,Rideout; David Porter,3,0,37,34
1657917358792,MATH 18,B04,083751,Rideout; David Porter,6,0,36,30
1657917358792,MATH 18,B05,093473,Rideout; David Porter,7,0,36,29
1657917358792,MATH 18,B06,093474,Rideout; David Porter,6,0,36,30
1657917364817,MATH 20A,A01,083754,Zheng; Zequn,14,0,40,26
1657917370846,MATH 20B,A01,083756,Briones; Jor-el Thomas Caparas,4,0,36,32
1657917370846,MATH 20B,A02,083757,Briones; Jor-el Thomas Caparas,1,0,36,35
1657917370846,MATH 20B,A03,093475,Briones; Jor-el Thomas Caparas,2,0,36,34
1657917376875,MATH 20C,A01,083760,Briones; Jor-el Thomas Caparas,1,0,35,34
1657917376875,MATH 20C,A02,083761,Briones; Jor-el Thomas Caparas,8,0,35,27
1657917376875,MATH 20C,A03,093476,Briones; Jor-el Thomas Caparas,0,1,36,36
1657917376875,MATH 20C,B01,083762,Bach; Quang Tran,1,0,30,29
1657917382898,MATH 20D,A01,083765,Tran; Brian Kha,5,0,30,25
1657917382898,MATH 20D,A02,083766,Tran; Brian Kha,5,0,30,25
1657917382898,MATH 20D,A03,083767,Tran; Brian Kha,6,0,30,24
1657917388927,MATH 20E,A01,083771,Ganguly; Soumya,10,0,32,22
1657917388927,MATH 20E,A02,083772,Ganguly; Soumya,7,0,32,25
1657917388927,MATH 20E,B01,083773,Ciotti; Benjamin,20,0,35,15
1657917388927,MATH 20E,B02,083774,Ciotti; Benjamin,18,0,35,17
1657917394950,MATH 103A,A01,083777,Greenfeld; Be'Eri,3,0,36,33
1657917394950,MATH 103A,A02,083778,Greenfeld; Be'Eri,5,0,36,31
1657917394950,MATH 103A,A03,093561,Greenfeld; Be'Eri,6,0,36,30
1657917394950,MATH 103A,B01,083779,Greenfeld; Be'Eri,8,0,36,28
1657917394950,MATH 103A,B02,083780,Greenfeld; Be'Eri,4,0,36,32
1657917394950,MATH 103A,B03,093562,Greenfeld; Be'Eri,3,0,36,33
1657917400972,MATH 105,A01,085443,Carter; Anne Toulson,15,0,35,20
1657917400972,MATH 105,A02,093477,Carter; Anne Toulson,20,0,35,15
1657917407001,MATH 109,A01,083213,Ganzberger; Geoffrey Michael,3,0,34,31
1657917407001,MATH 109,A02,083214,Ganzberger; Geoffrey Michael,4,0,34,30
1657917407001,MATH 109,A03,093478,Ganzberger; Geoffrey Michael,2,0,34,32
1657917407001,MATH 109,B01,083215,Ganzberger; Geoffrey Michael,2,0,32,30
1657917407001,MATH 109,B02,083216,Ganzberger; Geoffrey Michael,2,0,32,30
1657917407001,MATH 109,B03,093479,Ganzberger; Geoffrey Michael,8,0,32,24
1657917413024,MATH 142A,A01,083219,Chow; Bennett,7,0,32,25
1657917413024,MATH 142A,A02,083220,Chow; Bennett,10,0,32,22
1657917413024,MATH 142A,A03,093480,Chow; Bennett,9,0,32,23
1657917413024,MATH 142A,B03,093481,Chow; Bennett,8,0,32,24
1657917413024,MATH 142A,B04,093558,Chow; Bennett,13,0,32,19
1657917413024,MATH 142A,B05,093559,Chow; Bennett,7,0,32,25
1657917419064,MATH 193A,A01,083224,Rotar; Vladimir,8,0,34,26
1657917419064,MATH 193A,A02,083225,Rotar; Vladimir,10,0,34,24
1657917419064,MATH 193A,A03,083781,Rotar; Vladimir,5,0,34,29
1657917419064,MATH 193A,A04,083782,Rotar; Vladimir,11,0,34,23
1657917419064,MATH 193A,A05,093482,Rotar; Vladimir,11,0,34,23
1657917425089,MATH 197,001,091859,McAuley; Julian John,9999,0,9999,0
1657917425089,MATH 197,002,095566,Kedlaya; Kiran S.,9997,0,9999,2
1657917425089,MATH 197,003,095567,Xiao; Ming,9999,0,9999,0
1657917425089,MATH 197,004,095571,Perols; Johan Lars,9998,0,9999,1
1657917432155,COGS 9,A01,083615,Shannon; Kyle Michael,10,0,75,65
1657917438178,COGS 11,A01,083617,Boyle; Mary E. T.,23,0,48,25
1657917444208,COGS 13,A01,083071,Bastos; Amalia Pinkusfeld,11,0,71,60
1657917450234,COGS 14A,A01,092681,Semenuks; Arturs,5,1,100,95
1657917456258,COGS 14B,A01,083073,Cheng; Tzu-Han,6,0,63,57
1657917462282,COGS 17,A01,092677,Semenuks; Arturs,6,0,81,75
1657917468308,COGS 100,A01,083619,Allen; Michael Gordon,17,0,70,53
1657917474334,COGS 101A,A01,083621,Davis; Joshua Daniel,9,0,68,59
1657917480359,COGS 101B,A01,091572,Allen; Michael Gordon,13,0,65,52
1657917486380,COGS 101C,A01,083625,Delgado; Tania,17,0,35,18
1657917492406,COGS 107A,A01,083627,Boyle; Mary E. T.,14,0,60,46
1657917498429,COGS 118A,A01,083075,Gupta; Anjum,21,0,76,55
1657917504457,CSE 3,A50,083646,Miranda; Gregory Joseph,24,0,50,26
1657917510480,CSE 8A,A50,083650,Miranda; Gregory Joseph,17,1,56,39
1657917516506,CSE 11,A01,083080,Cao; Yingjun,6,15,40,34
1657917522532,CSE 12,A01,083652,Krause-Levy; Sophia Louisa,30,1,120,90
1657917528557,CSE 15L,A01,083654,Morris; Justin Loren,9,0,50,41
1657917528557,CSE 15L,A02,083655,Morris; Justin Loren,10,0,50,40
1657917534586,CSE 20,A01,083657,Tran; Khoa Dang,39,0,80,41
1657917540611,CSE 21,A01,095574,Bach; Quang Tran,22,0,48,26
1657917546637,CSE 30,A01,083084,Eldon; John,6,0,80,74
1657917546637,CSE 30,B01,095061,Bhaskar; Nishant,9,0,50,41
1657917552661,CSE 100,A01,083659,Cao; Yingjun,5,4,70,65
1657917558687,CSE 134B,A01,083661,Powell; Thomas Allan,25,0,100,75
1657917564713,CSE 140,A01,083663,Gungor; Onat,16,0,85,69
1657917570741,CSE 140L,A01,083088,Eldon; John,23,0,100,77
1657917576767,CSE 175,A01,083665,Kumar; Rakesh,3,0,25,22
1657917582793,CSE 190,A00,092507,Dubnov; Shlomo,8,0,20,12
1657917588823,ECE 45,A01,083139,Congero; Spencer William,7,0,75,68
1657917594849,ECE 65,A50,083695,Saad; Andrew S,12,0,30,18
1657917594849,ECE 65,A51,095125,Saad; Andrew S,24,0,26,2
1657917600877,ECE 109,A01,091882,Touri; Behrouz,20,0,70,50
1657917606902,ECE 180,A00,083140,Abi Samra; Nicholas Camill,1,0,30,29
1657917606902,ECE 180,B00,083141,Abi Samra; Nicholas Camill,0,0,30,30
1657917612939,MATH 10A,A01,083735,Patchell; Gregory David,2,0,30,28
1657917612939,MATH 10A,A02,083736,Patchell; Gregory David,20,0,30,10
1657917612939,MATH 10A,A03,083737,Patchell; Gregory David,16,0,30,14
1657917618963,MATH 10B,A01,083207,Lim; Seonhee,8,0,34,26
1657917618963,MATH 10B,A02,083208,Lim; Seonhee,10,0,35,25
1657917618963,MATH 10B,A03,093472,Lim; Seonhee,7,0,34,27
1657917618963,MATH 10B,B01,083739,Sinha; Shubham,14,0,30,16
1657917624990,MATH 18,A01,083743,Cinel; Cameron Alexander,9,0,30,21
1657917624990,MATH 18,A02,083744,Cinel; Cameron Alexander,18,0,30,12
1657917624990,MATH 18,A03,083745,Cinel; Cameron Alexander,10,0,30,20
1657917624990,MATH 18,B01,083748,Rideout; David Porter,5,0,37,32
1657917624990,MATH 18,B02,083749,Rideout; David Porter,5,0,36,31
1657917624990,MATH 18,B03,083750,Rideout; David Porter,3,0,37,34
1657917624990,MATH 18,B04,083751,Rideout; David Porter,6,0,36,30
1657917624990,MATH 18,B05,093473,Rideout; David Porter,7,0,36,29
1657917624990,MATH 18,B06,093474,Rideout; David Porter,6,0,36,30
1657917631013,MATH 20A,A01,083754,Zheng; Zequn,14,0,40,26
1657917637035,MATH 20B,A01,083756,Briones; Jor-el Thomas Caparas,4,0,36,32
1657917637035,MATH 20B,A02,083757,Briones; Jor-el Thomas Caparas,1,0,36,35
1657917637035,MATH 20B,A03,093475,Briones; Jor-el Thomas Caparas,2,0,36,34
1657917643063,MATH 20C,A01,083760,Briones; Jor-el Thomas Caparas,1,0,35,34
1657917643063,MATH 20C,A02,083761,Briones; Jor-el Thomas Caparas,8,0,35,27
1657917643063,MATH 20C,A03,093476,Briones; Jor-el Thomas Caparas,0,1,36,36
1657917643063,MATH 20C,B01,083762,Bach; Quang Tran,1,0,30,29
1657917649094,MATH 20D,A01,083765,Tran; Brian Kha,5,0,30,25
1657917649094,MATH 20D,A02,083766,Tran; Brian Kha,5,0,30,25
1657917649094,MATH 20D,A03,083767,Tran; Brian Kha,6,0,30,24
1657917655126,MATH 20E,A01,083771,Ganguly; Soumya,10,0,32,22
1657917655126,MATH 20E,A02,083772,Ganguly; Soumya,7,0,32,25
1657917655126,MATH 20E,B01,083773,Ciotti; Benjamin,20,0,35,15
1657917655126,MATH 20E,B02,083774,Ciotti; Benjamin,18,0,35,17
1657917661154,MATH 103A,A01,083777,Greenfeld; Be'Eri,3,0,36,33
1657917661154,MATH 103A,A02,083778,Greenfeld; Be'Eri,5,0,36,31
1657917661154,MATH 103A,A03,093561,Greenfeld; Be'Eri,6,0,36,30
1657917661154,MATH 103A,B01,083779,Greenfeld; Be'Eri,8,0,36,28
1657917661154,MATH 103A,B02,083780,Greenfeld; Be'Eri,4,0,36,32
1657917661154,MATH 103A,B03,093562,Greenfeld; Be'Eri,3,0,36,33
1657917667190,MATH 105,A01,085443,Carter; Anne Toulson,15,0,35,20
1657917667190,MATH 105,A02,093477,Carter; Anne Toulson,20,0,35,15
1657917673221,MATH 109,A01,083213,Ganzberger; Geoffrey Michael,3,0,34,31
1657917673221,MATH 109,A02,083214,Ganzberger; Geoffrey Michael,4,0,34,30
1657917673221,MATH 109,A03,093478,Ganzberger; Geoffrey Michael,2,0,34,32
1657917673221,MATH 109,B01,083215,Ganzberger; Geoffrey Michael,2,0,32,30
1657917673221,MATH 109,B02,083216,Ganzberger; Geoffrey Michael,2,0,32,30
1657917673221,MATH 109,B03,093479,Ganzberger; Geoffrey Michael,8,0,32,24
1657917679255,MATH 142A,A01,083219,Chow; Bennett,7,0,32,25
1657917679255,MATH 142A,A02,083220,Chow; Bennett,10,0,32,22
1657917679255,MATH 142A,A03,093480,Chow; Bennett,9,0,32,23
1657917679255,MATH 142A,B03,093481,Chow; Bennett,8,0,32,24
1657917679255,MATH 142A,B04,093558,Chow; Bennett,13,0,32,19
1657917679255,MATH 142A,B05,093559,Chow; Bennett,7,0,32,25
1657917685279,MATH 193A,A01,083224,Rotar; Vladimir,8,0,34,26
1657917685279,MATH 193A,A02,083225,Rotar; Vladimir,10,0,34,24
1657917685279,MATH 193A,A03,083781,Rotar; Vladimir,5,0,34,29
1657917685279,MATH 193A,A04,083782,Rotar; Vladimir,11,0,34,23
1657917685279,MATH 193A,A05,093482,Rotar; Vladimir,11,0,34,23
1657917691315,MATH 197,001,091859,McAuley; Julian John,9999,0,9999,0
1657917691315,MATH 197,002,095566,Kedlaya; Kiran S.,9997,0,9999,2
1657917691315,MATH 197,003,095567,Xiao; Ming,9999,0,9999,0
1657917691315,MATH 197,004,095571,Perols; Johan Lars,9998,0,9999,1
1657917698381,COGS 9,A01,083615,Shannon; Kyle Michael,10,0,75,65
1657917704404,COGS 11,A01,083617,Boyle; Mary E. T.,23,0,48,25
1657917710430,COGS 13,A01,083071,Bastos; Amalia Pinkusfeld,11,0,71,60
1657917716454,COGS 14A,A01,092681,Semenuks; Arturs,5,1,100,95
1657917722485,COGS 14B,A01,083073,Cheng; Tzu-Han,6,0,63,57
1657917728511,COGS 17,A01,092677,Semenuks; Arturs,6,0,81,75
1657917734535,COGS 100,A01,083619,Allen; Michael Gordon,17,0,70,53
1657917740558,COGS 101A,A01,083621,Davis; Joshua Daniel,9,0,68,59
1657917746583,COGS 101B,A01,091572,Allen; Michael Gordon,13,0,65,52
1657917752606,COGS 101C,A01,083625,Delgado; Tania,17,0,35,18
1657917758634,COGS 107A,A01,083627,Boyle; Mary E. T.,14,0,60,46
1657917764665,COGS 118A,A01,083075,Gupta; Anjum,21,0,76,55
1657917770692,CSE 3,A50,083646,Miranda; Gregory Joseph,24,0,50,26
1657917776718,CSE 8A,A50,083650,Miranda; Gregory Joseph,17,1,56,39
1657917782741,CSE 11,A01,083080,Cao; Yingjun,6,15,40,34
1657917788764,CSE 12,A01,083652,Krause-Levy; Sophia Louisa,30,1,120,90
1657917794798,CSE 15L,A01,083654,Morris; Justin Loren,9,0,50,41
1657917794798,CSE 15L,A02,083655,Morris; Justin Loren,10,0,50,40
1657917800826,CSE 20,A01,083657,Tran; Khoa Dang,39,0,80,41
1657917806848,CSE 21,A01,095574,Bach; Quang Tran,22,0,48,26
1657917812872,CSE 30,A01,083084,Eldon; John,6,0,80,74
1657917812872,CSE 30,B01,095061,Bhaskar; Nishant,9,0,50,41
1657917818901,CSE 100,A01,083659,Cao; Yingjun,5,4,70,65
1657917824926,CSE 134B,A01,083661,Powell; Thomas Allan,25,0,100,75
1657917830949,CSE 140,A01,083663,Gungor; Onat,16,0,85,69
1657917836980,CSE 140L,A01,083088,Eldon; John,23,0,100,77
1657917843004,CSE 175,A01,083665,Kumar; Rakesh,3,0,25,22
1657917849027,CSE 190,A00,092507,Dubnov; Shlomo,8,0,20,12
1657917855050,ECE 45,A01,083139,Congero; Spencer William,7,0,75,68
1657917861148,ECE 65,A50,083695,Saad; Andrew S,12,0,30,18
1657917861148,ECE 65,A51,095125,Saad; Andrew S,24,0,26,2
1657917867172,ECE 109,A01,091882,Touri; Behrouz,20,0,70,50
1657917873208,ECE 180,A00,083140,Abi Samra; Nicholas Camill,1,0,30,29
1657917873208,ECE 180,B00,083141,Abi Samra; Nicholas Camill,0,0,30,30
1657917879241,MATH 10A,A01,083735,Patchell; Gregory David,2,0,30,28
1657917879241,MATH 10A,A02,083736,Patchell; Gregory David,20,0,30,10
1657917879241,MATH 10A,A03,083737,Patchell; Gregory David,16,0,30,14
1657917885263,MATH 10B,A01,083207,Lim; Seonhee,8,0,34,26
1657917885263,MATH 10B,A02,083208,Lim; Seonhee,10,0,35,25
1657917885263,MATH 10B,A03,093472,Lim; Seonhee,7,0,34,27
1657917885263,MATH 10B,B01,083739,Sinha; Shubham,14,0,30,16
1657917891299,MATH 18,A01,083743,Cinel; Cameron Alexander,9,0,30,21
1657917891299,MATH 18,A02,083744,Cinel; Cameron Alexander,18,0,30,12
1657917891299,MATH 18,A03,083745,Cinel; Cameron Alexander,10,0,30,20
1657917891299,MATH 18,B01,083748,Rideout; David Porter,5,0,37,32
1657917891299,MATH 18,B02,083749,Rideout; David Porter,5,0,36,31
1657917891299,MATH 18,B03,083750,Rideout; David Porter,3,0,37,34
1657917891299,MATH 18,B04,083751,Rideout; David Porter,6,0,36,30
1657917891299,MATH 18,B05,093473,Rideout; David Porter,7,0,36,29
1657917891299,MATH 18,B06,093474,Rideout; David Porter,6,0,36,30
1657917897323,MATH 20A,A01,083754,Zheng; Zequn,14,0,40,26
1657917903350,MATH 20B,A01,083756,Briones; Jor-el Thomas Caparas,4,0,36,32
1657917903350,MATH 20B,A02,083757,Briones; Jor-el Thomas Caparas,1,0,36,35
1657917903350,MATH 20B,A03,093475,Briones; Jor-el Thomas Caparas,2,0,36,34
1657917909378,MATH 20C,A01,083760,Briones; Jor-el Thomas Caparas,1,0,35,34
1657917909378,MATH 20C,A02,083761,Briones; Jor-el Thomas Caparas,8,0,35,27
1657917909378,MATH 20C,A03,093476,Briones; Jor-el Thomas Caparas,0,1,36,36
1657917909378,MATH 20C,B01,083762,Bach; Quang Tran,1,0,30,29
1657917915406,MATH 20D,A01,083765,Tran; Brian Kha,5,0,30,25
1657917915406,MATH 20D,A02,083766,Tran; Brian Kha,5,0,30,25
1657917915406,MATH 20D,A03,083767,Tran; Brian Kha,6,0,30,24
1657917921434,MATH 20E,A01,083771,Ganguly; Soumya,10,0,32,22
1657917921434,MATH 20E,A02,083772,Ganguly; Soumya,7,0,32,25
1657917921434,MATH 20E,B01,083773,Ciotti; Benjamin,20,0,35,15
1657917921434,MATH 20E,B02,083774,Ciotti; Benjamin,18,0,35,17
1657917927462,MATH 103A,A01,083777,Greenfeld; Be'Eri,3,0,36,33
1657917927462,MATH 103A,A02,083778,Greenfeld; Be'Eri,5,0,36,31
1657917927462,MATH 103A,A03,093561,Greenfeld; Be'Eri,6,0,36,30
1657917927462,MATH 103A,B01,083779,Greenfeld; Be'Eri,8,0,36,28
1657917927462,MATH 103A,B02,083780,Greenfeld; Be'Eri,4,0,36,32
1657917927462,MATH 103A,B03,093562,Greenfeld; Be'Eri,3,0,36,33
1657917933488,MATH 105,A01,085443,Carter; Anne Toulson,15,0,35,20
1657917933488,MATH 105,A02,093477,Carter; Anne Toulson,20,0,35,15
1657917939520,MATH 109,A01,083213,Ganzberger; Geoffrey Michael,3,0,34,31
1657917939520,MATH 109,A02,083214,Ganzberger; Geoffrey Michael,4,0,34,30
1657917939520,MATH 109,A03,093478,Ganzberger; Geoffrey Michael,2,0,34,32
1657917939520,MATH 109,B01,083215,Ganzberger; Geoffrey Michael,2,0,32,30
1657917939520,MATH 109,B02,083216,Ganzberger; Geoffrey Michael,2,0,32,30
1657917939520,MATH 109,B03,093479,Ganzberger; Geoffrey Michael,8,0,32,24
1657917945544,MATH 142A,A01,083219,Chow; Bennett,7,0,32,25
1657917945544,MATH 142A,A02,083220,Chow; Bennett,10,0,32,22
1657917945544,MATH 142A,A03,093480,Chow; Bennett,9,0,32,23
1657917945544,MATH 142A,B03,093481,Chow; Bennett,8,0,32,24
1657917945544,MATH 142A,B04,093558,Chow; Bennett,13,0,32,19
1657917945544,MATH 142A,B05,093559,Chow; Bennett,7,0,32,25
1657917951577,MATH 193A,A01,083224,Rotar; Vladimir,8,0,34,26
1657917951577,MATH 193A,A02,083225,Rotar; Vladimir,10,0,34,24
1657917951577,MATH 193A,A03,083781,Rotar; Vladimir,5,0,34,29
1657917951577,MATH 193A,A04,083782,Rotar; Vladimir,11,0,34,23
1657917951577,MATH 193A,A05,093482,Rotar; Vladimir,11,0,34,23
1657917957604,MATH 197,001,091859,McAuley; Julian John,9999,0,9999,0
1657917957604,MATH 197,002,095566,Kedlaya; Kiran S.,9997,0,9999,2
1657917957604,MATH 197,003,095567,Xiao; Ming,9999,0,9999,0
1657917957604,MATH 197,004,095571,Perols; Johan Lars,9998,0,9999,1
1657917964658,COGS 9,A01,083615,Shannon; Kyle Michael,10,0,75,65
1657917970684,COGS 11,A01,083617,Boyle; Mary E. T.,23,0,48,25
1657917976709,COGS 13,A01,083071,Bastos; Amalia Pinkusfeld,11,0,71,60
1657917982736,COGS 14A,A01,092681,Semenuks; Arturs,5,1,100,95
1657917988759,COGS 14B,A01,083073,Cheng; Tzu-Han,6,0,63,57
1657917994784,COGS 17,A01,092677,Semenuks; Arturs,6,0,81,75
1657918000807,COGS 100,A01,083619,Allen; Michael Gordon,17,0,70,53
1657918006834,COGS 101A,A01,083621,Davis; Joshua Daniel,9,0,68,59
1657918012857,COGS 101B,A01,091572,Allen; Michael Gordon,13,0,65,52
1657918018881,COGS 101C,A01,083625,Delgado; Tania,17,0,35,18
1657918024905,COGS 107A,A01,083627,Boyle; Mary E. T.,14,0,60,46
1657918030927,COGS 118A,A01,083075,Gupta; Anjum,21,0,76,55
1657918036952,CSE 3,A50,083646,Miranda; Gregory Joseph,24,0,50,26
1657918042981,CSE 8A,A50,083650,Miranda; Gregory Joseph,17,1,56,39
1657918049026,CSE 11,A01,083080,Cao; Yingjun,6,15,40,34
1657918055053,CSE 12,A01,083652,Krause-Levy; Sophia Louisa,30,1,120,90
1657918061085,CSE 15L,A01,083654,Morris; Justin Loren,9,0,50,41
1657918061085,CSE 15L,A02,083655,Morris; Justin Loren,10,0,50,40
1657918067107,CSE 20,A01,083657,Tran; Khoa Dang,39,0,80,41
1657918073133,CSE 21,A01,095574,Bach; Quang Tran,22,0,48,26
1657918079158,CSE 30,A01,083084,Eldon; John,6,0,80,74
1657918079158,CSE 30,B01,095061,Bhaskar; Nishant,9,0,50,41
1657918085182,CSE 100,A01,083659,Cao; Yingjun,5,4,70,65
1657918091203,CSE 134B,A01,083661,Powell; Thomas Allan,25,0,100,75
1657918097230,CSE 140,A01,083663,Gungor; Onat,16,0,85,69
1657918103260,CSE 140L,A01,083088,Eldon; John,23,0,100,77
1657918109284,CSE 175,A01,083665,Kumar; Rakesh,3,0,25,22
1657918115310,CSE 190,A00,092507,Dubnov; Shlomo,8,0,20,12
1657918121336,ECE 45,A01,083139,Congero; Spencer William,7,0,75,68
1657918127364,ECE 65,A50,083695,Saad; Andrew S,12,0,30,18
1657918127364,ECE 65,A51,095125,Saad; Andrew S,24,0,26,2
1657918133388,ECE 109,A01,091882,Touri; Behrouz,20,0,70,50
1657918139415,ECE 180,A00,083140,Abi Samra; Nicholas Camill,1,0,30,29
1657918139415,ECE 180,B00,083141,Abi Samra; Nicholas Camill,0,0,30,30
1657918145437,MATH 10A,A01,083735,Patchell; Gregory David,2,0,30,28
1657918145437,MATH 10A,A02,083736,Patchell; Gregory David,20,0,30,10
1657918145437,MATH 10A,A03,083737,Patchell; Gregory David,16,0,30,14
1657918151459,MATH 10B,A01,083207,Lim; Seonhee,8,0,34,26
1657918151459,MATH 10B,A02,083208,Lim; Seonhee,10,0,35,25
1657918151459,MATH 10B,A03,093472,Lim; Seonhee,7,0,34,27
1657918151459,MATH 10B,B01,083739,Sinha; Shubham,14,0,30,16
1657918157485,MATH 18,A01,083743,Cinel; Cameron Alexander,9,0,30,21
1657918157485,MATH 18,A02,083744,Cinel; Cameron Alexander,18,0,30,12
1657918157485,MATH 18,A03,083745,Cinel; Cameron Alexander,10,0,30,20
1657918157485,MATH 18,B01,083748,Rideout; David Porter,5,0,37,32
1657918157485,MATH 18,B02,083749,Rideout; David Porter,5,0,36,31
1657918157485,MATH 18,B03,083750,Rideout; David Porter,3,0,37,34
1657918157485,MATH 18,B04,083751,Rideout; David Porter,6,0,36,30
1657918157485,MATH 18,B05,093473,Rideout; David Porter,7,0,36,29
1657918157485,MATH 18,B06,093474,Rideout; David Porter,6,0,36,30
1657918163506,MATH 20A,A01,083754,Zheng; Zequn,14,0,40,26
1657918169539,MATH 20B,A01,083756,Briones; Jor-el Thomas Caparas,4,0,36,32
1657918169539,MATH 20B,A02,083757,Briones; Jor-el Thomas Caparas,1,0,36,35
1657918169539,MATH 20B,A03,093475,Briones; Jor-el Thomas Caparas,2,0,36,34
1657918175569,MATH 20C,A01,083760,Briones; Jor-el Thomas Caparas,1,0,35,34
1657918175569,MATH 20C,A02,083761,Briones; Jor-el Thomas Caparas,8,0,35,27
1657918175569,MATH 20C,A03,093476,Briones; Jor-el Thomas Caparas,0,1,36,36
1657918175569,MATH 20C,B01,083762,Bach; Quang Tran,1,0,30,29
1657918181598,MATH 20D,A01,083765,Tran; Brian Kha,5,0,30,25
1657918181598,MATH 20D,A02,083766,Tran; Brian Kha,5,0,30,25
1657918181598,MATH 20D,A03,083767,Tran; Brian Kha,6,0,30,24
1657918187627,MATH 20E,A01,083771,Ganguly; Soumya,10,0,32,22
1657918187627,MATH 20E,A02,083772,Ganguly; Soumya,7,0,32,25
1657918187627,MATH 20E,B01,083773,Ciotti; Benjamin,20,0,35,15
1657918187627,MATH 20E,B02,083774,Ciotti; Benjamin,18,0,35,17
1657918193650,MATH 103A,A01,083777,Greenfeld; Be'Eri,3,0,36,33
1657918193650,MATH 103A,A02,083778,Greenfeld; Be'Eri,5,0,36,31
1657918193650,MATH 103A,A03,093561,Greenfeld; Be'Eri,6,0,36,30
1657918193650,MATH 103A,B01,083779,Greenfeld; Be'Eri,8,0,36,28
1657918193650,MATH 103A,B02,083780,Greenfeld; Be'Eri,4,0,36,32
1657918193650,MATH 103A,B03,093562,Greenfeld; Be'Eri,3,0,36,33
1657918199674,MATH 105,A01,085443,Carter; Anne Toulson,15,0,35,20
1657918199674,MATH 105,A02,093477,Carter; Anne Toulson,20,0,35,15
1657918205709,MATH 109,A01,083213,Ganzberger; Geoffrey Michael,3,0,34,31
1657918205709,MATH 109,A02,083214,Ganzberger; Geoffrey Michael,4,0,34,30
1657918205709,MATH 109,A03,093478,Ganzberger; Geoffrey Michael,2,0,34,32
1657918205709,MATH 109,B01,083215,Ganzberger; Geoffrey Michael,2,0,32,30
1657918205709,MATH 109,B02,083216,Ganzberger; Geoffrey Michael,2,0,32,30
1657918205709,MATH 109,B03,093479,Ganzberger; Geoffrey Michael,8,0,32,24
1657918211740,MATH 142A,A01,083219,Chow; Bennett,7,0,32,25
1657918211740,MATH 142A,A02,083220,Chow; Bennett,10,0,32,22
1657918211740,MATH 142A,A03,093480,Chow; Bennett,9,0,32,23
1657918211740,MATH 142A,B03,093481,Chow; Bennett,8,0,32,24
1657918211740,MATH 142A,B04,093558,Chow; Bennett,13,0,32,19
1657918211740,MATH 142A,B05,093559,Chow; Bennett,7,0,32,25
1657918217768,MATH 193A,A01,083224,Rotar; Vladimir,8,0,34,26
1657918217768,MATH 193A,A02,083225,Rotar; Vladimir,10,0,34,24
1657918217768,MATH 193A,A03,083781,Rotar; Vladimir,5,0,34,29
1657918217768,MATH 193A,A04,083782,Rotar; Vladimir,11,0,34,23
1657918217768,MATH 193A,A05,093482,Rotar; Vladimir,11,0,34,23
1657918223792,MATH 197,001,091859,McAuley; Julian John,9999,0,9999,0
1657918223792,MATH 197,002,095566,Kedlaya; Kiran S.,9997,0,9999,2
1657918223792,MATH 197,003,095567,Xiao; Ming,9999,0,9999,0
1657918223792,MATH 197,004,095571,Perols; Johan Lars,9998,0,9999,1
1657918230852,COGS 9,A01,083615,Shannon; Kyle Michael,10,0,75,65
1657918236874,COGS 11,A01,083617,Boyle; Mary E. T.,23,0,48,25
1657918242900,COGS 13,A01,083071,Bastos; Amalia Pinkusfeld,11,0,71,60
1657918248925,COGS 14A,A01,092681,Semenuks; Arturs,5,1,100,95
1657918254953,COGS 14B,A01,083073,Cheng; Tzu-Han,6,0,63,57
1657918260980,COGS 17,A01,092677,Semenuks; Arturs,6,0,81,75
1657918267007,COGS 100,A01,083619,Allen; Michael Gordon,17,0,70,53
1657918273029,COGS 101A,A01,083621,Davis; Joshua Daniel,9,0,68,59
1657918279055,COGS 101B,A01,091572,Allen; Michael Gordon,13,0,65,52
1657918285082,COGS 101C,A01,083625,Delgado; Tania,17,0,35,18
1657918291104,COGS 107A,A01,083627,Boyle; Mary E. T.,14,0,60,46
1657918297129,COGS 118A,A01,083075,Gupta; Anjum,21,0,76,55
1657918303162,CSE 3,A50,083646,Miranda; Gregory Joseph,24,0,50,26
1657918309186,CSE 8A,A50,083650,Miranda; Gregory Joseph,17,1,56,39
1657918315211,CSE 11,A01,083080,Cao; Yingjun,6,15,40,34
1657918321234,CSE 12,A01,083652,Krause-Levy; Sophia Louisa,30,1,120,90
1657918327260,CSE 15L,A01,083654,Morris; Justin Loren,9,0,50,41
1657918327260,CSE 15L,A02,083655,Morris; Justin Loren,10,0,50,40
1657918333297,CSE 20,A01,083657,Tran; Khoa Dang,39,0,80,41
1657918339321,CSE 21,A01,095574,Bach; Quang Tran,22,0,48,26
1657918345344,CSE 30,A01,083084,Eldon; John,6,0,80,74
1657918345344,CSE 30,B01,095061,Bhaskar; Nishant,9,0,50,41
1657918351370,CSE 100,A01,083659,Cao; Yingjun,5,4,70,65
1657918357398,CSE 134B,A01,083661,Powell; Thomas Allan,25,0,100,75
1657918363423,CSE 140,A01,083663,Gungor; Onat,16,0,85,69
1657918369449,CSE 140L,A01,083088,Eldon; John,23,0,100,77
1657918375474,CSE 175,A01,083665,Kumar; Rakesh,3,0,25,22
1657918381498,CSE 190,A00,092507,Dubnov; Shlomo,8,0,20,12
1657918387520,ECE 45,A01,083139,Congero; Spencer William,7,0,75,68
1657918393547,ECE 65,A50,083695,Saad; Andrew S,12,0,30,18
1657918393547,ECE 65,A51,095125,Saad; Andrew S,24,0,26,2
1657918399575,ECE 109,A01,091882,Touri; Behrouz,20,0,70,50
1657918405599,ECE 180,A00,083140,Abi Samra; Nicholas Camill,1,0,30,29
1657918405599,ECE 180,B00,083141,Abi Samra; Nicholas Camill,0,0,30,30
1657918411636,MATH 10A,A01,083735,Patchell; Gregory David,2,0,30,28
1657918411636,MATH 10A,A02,083736,Patchell; Gregory David,20,0,30,10
1657918411636,MATH 10A,A03,083737,Patchell; Gregory David,16,0,30,14
1657918417663,MATH 10B,A01,083207,Lim; Seonhee,8,0,34,26
1657918417663,MATH 10B,A02,083208,Lim; Seonhee,10,0,35,25
1657918417663,MATH 10B,A03,093472,Lim; Seonhee,7,0,34,27
1657918417663,MATH 10B,B01,083739,Sinha; Shubham,14,0,30,16
1657918423698,MATH 18,A01,083743,Cinel; Cameron Alexander,9,0,30,21
1657918423698,MATH 18,A02,083744,Cinel; Cameron Alexander,18,0,30,12
1657918423698,MATH 18,A03,083745,Cinel; Cameron Alexander,10,0,30,20
1657918423698,MATH 18,B01,083748,Rideout; David Porter,5,0,37,32
1657918423698,MATH 18,B02,083749,Rideout; David Porter,5,0,36,31
1657918423698,MATH 18,B03,083750,Rideout; David Porter,3,0,37,34
1657918423698,MATH 18,B04,083751,Rideout; David Porter,6,0,36,30
1657918423698,MATH 18,B05,093473,Rideout; David Porter,7,0,36,29
1657918423698,MATH 18,B06,093474,Rideout; David Porter,6,0,36,30
1657918429731,MATH 20A,A01,083754,Zheng; Zequn,14,0,40,26
1657918435761,MATH 20B,A01,083756,Briones; Jor-el Thomas Caparas,4,0,36,32
1657918435761,MATH 20B,A02,083757,Briones; Jor-el Thomas Caparas,1,0,36,35
1657918435761,MATH 20B,A03,093475,Briones; Jor-el Thomas Caparas,2,0,36,34
1657918441797,MATH 20C,A01,083760,Briones; Jor-el Thomas Caparas,1,0,35,34
1657918441797,MATH 20C,A02,083761,Briones; Jor-el Thomas Caparas,8,0,35,27
1657918441797,MATH 20C,A03,093476,Briones; Jor-el Thomas Caparas,0,1,36,36
1657918441797,MATH 20C,B01,083762,Bach; Quang Tran,1,0,30,29
1657918447824,MATH 20D,A01,083765,Tran; Brian Kha,5,0,30,25
1657918447824,MATH 20D,A02,083766,Tran; Brian Kha,5,0,30,25
1657918447824,MATH 20D,A03,083767,Tran; Brian Kha,6,0,30,24
1657918453846,MATH 20E,A01,083771,Ganguly; Soumya,10,0,32,22
1657918453846,MATH 20E,A02,083772,Ganguly; Soumya,7,0,32,25
1657918453846,MATH 20E,B01,083773,Ciotti; Benjamin,20,0,35,15
1657918453846,MATH 20E,B02,083774,Ciotti; Benjamin,18,0,35,17
1657918459964,MATH 103A,A01,083777,Greenfeld; Be'Eri,3,0,36,33
1657918459964,MATH 103A,A02,083778,Greenfeld; Be'Eri,5,0,36,31
1657918459964,MATH 103A,A03,093561,Greenfeld; Be'Eri,6,0,36,30
1657918459964,MATH 103A,B01,083779,Greenfeld; Be'Eri,8,0,36,28
1657918459964,MATH 103A,B02,083780,Greenfeld; Be'Eri,4,0,36,32
1657918459964,MATH 103A,B03,093562,Greenfeld; Be'Eri,3,0,36,33
1657918465987,MATH 105,A01,085443,Carter; Anne Toulson,15,0,35,20
1657918465987,MATH 105,A02,093477,Carter; Anne Toulson,20,0,35,15
1657918472014,MATH 109,A01,083213,Ganzberger; Geoffrey Michael,3,0,34,31
1657918472014,MATH 109,A02,083214,Ganzberger; Geoffrey Michael,4,0,34,30
1657918472014,MATH 109,A03,093478,Ganzberger; Geoffrey Michael,2,0,34,32
1657918472014,MATH 109,B01,083215,Ganzberger; Geoffrey Michael,2,0,32,30
1657918472014,MATH 109,B02,083216,Ganzberger; Geoffrey Michael,2,0,32,30
1657918472014,MATH 109,B03,093479,Ganzberger; Geoffrey Michael,8,0,32,24
1657918478037,MATH 142A,A01,083219,Chow; Bennett,7,0,32,25
1657918478037,MATH 142A,A02,083220,Chow; Bennett,10,0,32,22
1657918478037,MATH 142A,A03,093480,Chow; Bennett,9,0,32,23
1657918478037,MATH 142A,B03,093481,Chow; Bennett,8,0,32,24
1657918478037,MATH 142A,B04,093558,Chow; Bennett,13,0,32,19
1657918478037,MATH 142A,B05,093559,Chow; Bennett,7,0,32,25
1657918484064,MATH 193A,A01,083224,Rotar; Vladimir,8,0,34,26
1657918484064,MATH 193A,A02,083225,Rotar; Vladimir,10,0,34,24
1657918484064,MATH 193A,A03,083781,Rotar; Vladimir,5,0,34,29
1657918484064,MATH 193A,A04,083782,Rotar; Vladimir,11,0,34,23
1657918484064,MATH 193A,A05,093482,Rotar; Vladimir,11,0,34,23
1657918490087,MATH 197,001,091859,McAuley; Julian John,9999,0,9999,0
1657918490087,MATH 197,002,095566,Kedlaya; Kiran S.,9997,0,9999,2
1657918490087,MATH 197,003,095567,Xiao; Ming,9999,0,9999,0
1657918490087,MATH 197,004,095571,Perols; Johan Lars,9998,0,9999,1
1657918497151,COGS 9,A01,083615,Shannon; Kyle Michael,10,0,75,65
1657918503174,COGS 11,A01,083617,Boyle; Mary E. T.,23,0,48,25
1657918509202,COGS 13,A01,083071,Bastos; Amalia Pinkusfeld,11,0,71,60
1657918515247,COGS 14A,A01,092681,Semenuks; Arturs,5,1,100,95
1657918521268,COGS 14B,A01,083073,Cheng; Tzu-Han,6,0,63,57
1657918527298,COGS 17,A01,092677,Semenuks; Arturs,6,0,81,75
1657918533333,COGS 100,A01,083619,Allen; Michael Gordon,17,0,70,53
1657918539355,COGS 101A,A01,083621,Davis; Joshua Daniel,9,0,68,59
1657918545385,COGS 101B,A01,091572,Allen; Michael Gordon,14,0,65,51
1657918551411,COGS 101C,A01,083625,Delgado; Tania,17,0,35,18
1657918557437,COGS 107A,A01,083627,Boyle; Mary E. T.,14,0,60,46
1657918563465,COGS 118A,A01,083075,Gupta; Anjum,21,0,76,55
1657918569495,CSE 3,A50,083646,Miranda; Gregory Joseph,24,0,50,26
1657918575517,CSE 8A,A50,083650,Miranda; Gregory Joseph,17,1,56,39
1657918581545,CSE 11,A01,083080,Cao; Yingjun,6,15,40,34
1657918587572,CSE 12,A01,083652,Krause-Levy; Sophia Louisa,30,1,120,90
1657918593600,CSE 15L,A01,083654,Morris; Justin Loren,9,0,50,41
1657918593600,CSE 15L,A02,083655,Morris; Justin Loren,10,0,50,40
1657918599623,CSE 20,A01,083657,Tran; Khoa Dang,39,0,80,41
1657918605650,CSE 21,A01,095574,Bach; Quang Tran,22,0,48,26
1657918611674,CSE 30,A01,083084,Eldon; John,6,0,80,74
1657918611674,CSE 30,B01,095061,Bhaskar; Nishant,9,0,50,41
1657918617696,CSE 100,A01,083659,Cao; Yingjun,5,4,70,65
1657918623728,CSE 134B,A01,083661,Powell; Thomas Allan,25,0,100,75
1657918629754,CSE 140,A01,083663,Gungor; Onat,16,0,85,69
1657918635780,CSE 140L,A01,083088,Eldon; John,23,0,100,77
1657918641806,CSE 175,A01,083665,Kumar; Rakesh,3,0,25,22
1657918647830,CSE 190,A00,092507,Dubnov; Shlomo,8,0,20,12
1657918653854,ECE 45,A01,083139,Congero; Spencer William,7,0,75,68
1657918659877,ECE 65,A50,083695,Saad; Andrew S,12,0,30,18
1657918659877,ECE 65,A51,095125,Saad; Andrew S,24,0,26,2
1657918665908,ECE 109,A01,091882,Touri; Behrouz,20,0,70,50
1657918671942,ECE 180,A00,083140,Abi Samra; Nicholas Camill,1,0,30,29
1657918671942,ECE 180,B00,083141,Abi Samra; Nicholas Camill,0,0,30,30
1657918677971,MATH 10A,A01,083735,Patchell; Gregory David,2,0,30,28
1657918677971,MATH 10A,A02,083736,Patchell; Gregory David,20,0,30,10
1657918677971,MATH 10A,A03,083737,Patchell; Gregory David,16,0,30,14
1657918683995,MATH 10B,A01,083207,Lim; Seonhee,8,0,34,26
1657918683995,MATH 10B,A02,083208,Lim; Seonhee,10,0,35,25
1657918683995,MATH 10B,A03,093472,Lim; Seonhee,7,0,34,27
1657918683995,MATH 10B,B01,083739,Sinha; Shubham,14,0,30,16
1657918690020,MATH 18,A01,083743,Cinel; Cameron Alexander,9,0,30,21
1657918690020,MATH 18,A02,083744,Cinel; Cameron Alexander,18,0,30,12
1657918690020,MATH 18,A03,083745,Cinel; Cameron Alexander,10,0,30,20
1657918690020,MATH 18,B01,083748,Rideout; David Porter,5,0,37,32
1657918690020,MATH 18,B02,083749,Rideout; David Porter,5,0,36,31
1657918690020,MATH 18,B03,083750,Rideout; David Porter,3,0,37,34
1657918690020,MATH 18,B04,083751,Rideout; David Porter,6,0,36,30
1657918690020,MATH 18,B05,093473,Rideout; David Porter,7,0,36,29
1657918690020,MATH 18,B06,093474,Rideout; David Porter,6,0,36,30
1657918696049,MATH 20A,A01,083754,Zheng; Zequn,14,0,40,26
1657918702074,MATH 20B,A01,083756,Briones; Jor-el Thomas Caparas,4,0,36,32
1657918702074,MATH 20B,A02,083757,Briones; Jor-el Thomas Caparas,1,0,36,35
1657918702074,MATH 20B,A03,093475,Briones; Jor-el Thomas Caparas,2,0,36,34
1657918708103,MATH 20C,A01,083760,Briones; Jor-el Thomas Caparas,1,0,35,34
1657918708103,MATH 20C,A02,083761,Briones; Jor-el Thomas Caparas,8,0,35,27
1657918708103,MATH 20C,A03,093476,Briones; Jor-el Thomas Caparas,0,1,36,36
1657918708103,MATH 20C,B01,083762,Bach; Quang Tran,1,0,30,29
1657918714126,MATH 20D,A01,083765,Tran; Brian Kha,5,0,30,25
1657918714126,MATH 20D,A02,083766,Tran; Brian Kha,5,0,30,25
1657918714126,MATH 20D,A03,083767,Tran; Brian Kha,6,0,30,24
1657918720151,MATH 20E,A01,083771,Ganguly; Soumya,10,0,32,22
1657918720151,MATH 20E,A02,083772,Ganguly; Soumya,7,0,32,25
1657918720151,MATH 20E,B01,083773,Ciotti; Benjamin,20,0,35,15
1657918720151,MATH 20E,B02,083774,Ciotti; Benjamin,18,0,35,17
1657918726181,MATH 103A,A01,083777,Greenfeld; Be'Eri,3,0,36,33
1657918726181,MATH 103A,A02,083778,Greenfeld; Be'Eri,5,0,36,31
1657918726181,MATH 103A,A03,093561,Greenfeld; Be'Eri,6,0,36,30
1657918726181,MATH 103A,B01,083779,Greenfeld; Be'Eri,8,0,36,28
1657918726181,MATH 103A,B02,083780,Greenfeld; Be'Eri,4,0,36,32
1657918726181,MATH 103A,B03,093562,Greenfeld; Be'Eri,3,0,36,33
1657918732215,MATH 105,A01,085443,Carter; Anne Toulson,15,0,35,20
1657918732215,MATH 105,A02,093477,Carter; Anne Toulson,20,0,35,15
1657918738244,MATH 109,A01,083213,Ganzberger; Geoffrey Michael,3,0,34,31
1657918738244,MATH 109,A02,083214,Ganzberger; Geoffrey Michael,4,0,34,30
1657918738244,MATH 109,A03,093478,Ganzberger; Geoffrey Michael,2,0,34,32
1657918738244,MATH 109,B01,083215,Ganzberger; Geoffrey Michael,2,0,32,30
1657918738244,MATH 109,B02,083216,Ganzberger; Geoffrey Michael,2,0,32,30
1657918738244,MATH 109,B03,093479,Ganzberger; Geoffrey Michael,8,0,32,24
1657918744281,MATH 142A,A01,083219,Chow; Bennett,7,0,32,25
1657918744281,MATH 142A,A02,083220,Chow; Bennett,10,0,32,22
1657918744281,MATH 142A,A03,093480,Chow; Bennett,9,0,32,23
1657918744281,MATH 142A,B03,093481,Chow; Bennett,8,0,32,24
1657918744281,MATH 142A,B04,093558,Chow; Bennett,13,0,32,19
1657918744281,MATH 142A,B05,093559,Chow; Bennett,7,0,32,25
1657918750305,MATH 193A,A01,083224,Rotar; Vladimir,8,0,34,26
1657918750305,MATH 193A,A02,083225,Rotar; Vladimir,10,0,34,24
1657918750305,MATH 193A,A03,083781,Rotar; Vladimir,5,0,34,29
1657918750305,MATH 193A,A04,083782,Rotar; Vladimir,11,0,34,23
1657918750305,MATH 193A,A05,093482,Rotar; Vladimir,11,0,34,23
1657918756328,MATH 197,001,091859,McAuley; Julian John,9999,0,9999,0
1657918756328,MATH 197,002,095566,Kedlaya; Kiran S.,9997,0,9999,2
1657918756328,MATH 197,003,095567,Xiao; Ming,9999,0,9999,0
1657918756328,MATH 197,004,095571,Perols; Johan Lars,9998,0,9999,1
1657918763396,COGS 9,A01,083615,Shannon; Kyle Michael,10,0,75,65
1657918769427,COGS 11,A01,083617,Boyle; Mary E. T.,23,0,48,25
1657918775453,COGS 13,A01,083071,Bastos; Amalia Pinkusfeld,11,0,71,60
1657918781479,COGS 14A,A01,092681,Semenuks; Arturs,5,1,100,95
1657918787502,COGS 14B,A01,083073,Cheng; Tzu-Han,6,0,63,57
1657918793530,COGS 17,A01,092677,Semenuks; Arturs,6,0,81,75
1657918799559,COGS 100,A01,083619,Allen; Michael Gordon,17,0,70,53
1657918805582,COGS 101A,A01,083621,Davis; Joshua Daniel,9,0,68,59
1657918811611,COGS 101B,A01,091572,Allen; Michael Gordon,14,0,65,51
1657918817646,COGS 101C,A01,083625,Delgado; Tania,17,0,35,18
1657918823672,COGS 107A,A01,083627,Boyle; Mary E. T.,14,0,60,46
1657918829702,COGS 118A,A01,083075,Gupta; Anjum,21,0,76,55
1657918835727,CSE 3,A50,083646,Miranda; Gregory Joseph,24,0,50,26
1657918841753,CSE 8A,A50,083650,Miranda; Gregory Joseph,17,1,56,39
1657918847775,CSE 11,A01,083080,Cao; Yingjun,6,15,40,34
1657918853802,CSE 12,A01,083652,Krause-Levy; Sophia Louisa,30,1,120,90
1657918859840,CSE 15L,A01,083654,Morris; Justin Loren,9,0,50,41
1657918859840,CSE 15L,A02,083655,Morris; Justin Loren,10,0,50,40
1657918865862,CSE 20,A01,083657,Tran; Khoa Dang,39,0,80,41
1657918871885,CSE 21,A01,095574,Bach; Quang Tran,22,0,48,26
1657918877907,CSE 30,A01,083084,Eldon; John,6,0,80,74
1657918877907,CSE 30,B01,095061,Bhaskar; Nishant,9,0,50,41
1657918883930,CSE 100,A01,083659,Cao; Yingjun,5,4,70,65
1657918889953,CSE 134B,A01,083661,Powell; Thomas Allan,25,0,100,75
1657918895980,CSE 140,A01,083663,Gungor; Onat,16,0,85,69
1657918902012,CSE 140L,A01,083088,Eldon; John,23,0,100,77
1657918908035,CSE 175,A01,083665,Kumar; Rakesh,3,0,25,22
1657918914057,CSE 190,A00,092507,Dubnov; Shlomo,8,0,20,12
1657918920081,ECE 45,A01,083139,Congero; Spencer William,7,0,75,68
1657918926110,ECE 65,A50,083695,Saad; Andrew S,12,0,30,18
1657918926110,ECE 65,A51,095125,Saad; Andrew S,24,0,26,2
1657918932139,ECE 109,A01,091882,Touri; Behrouz,20,0,70,50
1657918938164,ECE 180,A00,083140,Abi Samra; Nicholas Camill,1,0,30,29
1657918938164,ECE 180,B00,083141,Abi Samra; Nicholas Camill,0,0,30,30
1657918944196,MATH 10A,A01,083735,Patchell; Gregory David,2,0,30,28
1657918944196,MATH 10A,A02,083736,Patchell; Gregory David,20,0,30,10
1657918944196,MATH 10A,A03,083737,Patchell; Gregory David,16,0,30,14
1657918950223,MATH 10B,A01,083207,Lim; Seonhee,8,0,34,26
1657918950223,MATH 10B,A02,083208,Lim; Seonhee,10,0,35,25
1657918950223,MATH 10B,A03,093472,Lim; Seonhee,7,0,34,27
1657918950223,MATH 10B,B01,083739,Sinha; Shubham,14,0,30,16
1657918956262,MATH 18,A01,083743,Cinel; Cameron Alexander,9,0,30,21
1657918956262,MATH 18,A02,083744,Cinel; Cameron Alexander,18,0,30,12
1657918956262,MATH 18,A03,083745,Cinel; Cameron Alexander,10,0,30,20
1657918956262,MATH 18,B01,083748,Rideout; David Porter,5,0,37,32
1657918956262,MATH 18,B02,083749,Rideout; David Porter,5,0,36,31
1657918956262,MATH 18,B03,083750,Rideout; David Porter,3,0,37,34
1657918956262,MATH 18,B04,083751,Rideout; David Porter,6,0,36,30
1657918956262,MATH 18,B05,093473,Rideout; David Porter,7,0,36,29
1657918956262,MATH 18,B06,093474,Rideout; David Porter,6,0,36,30
1657918962288,MATH 20A,A01,083754,Zheng; Zequn,14,0,40,26
1657918968318,MATH 20B,A01,083756,Briones; Jor-el Thomas Caparas,4,0,36,32
1657918968318,MATH 20B,A02,083757,Briones; Jor-el Thomas Caparas,1,0,36,35
1657918968318,MATH 20B,A03,093475,Briones; Jor-el Thomas Caparas,2,0,36,34
1657918974351,MATH 20C,A01,083760,Briones; Jor-el Thomas Caparas,1,0,35,34
1657918974351,MATH 20C,A02,083761,Briones; Jor-el Thomas Caparas,8,0,35,27
1657918974351,MATH 20C,A03,093476,Briones; Jor-el Thomas Caparas,0,1,36,36
1657918974351,MATH 20C,B01,083762,Bach; Quang Tran,1,0,30,29
1657918980379,MATH 20D,A01,083765,Tran; Brian Kha,5,0,30,25
1657918980379,MATH 20D,A02,083766,Tran; Brian Kha,5,0,30,25
1657918980379,MATH 20D,A03,083767,Tran; Brian Kha,6,0,30,24
1657918986402,MATH 20E,A01,083771,Ganguly; Soumya,10,0,32,22
1657918986402,MATH 20E,A02,083772,Ganguly; Soumya,7,0,32,25
1657918986402,MATH 20E,B01,083773,Ciotti; Benjamin,20,0,35,15
1657918986402,MATH 20E,B02,083774,Ciotti; Benjamin,18,0,35,17
1657918992426,MATH 103A,A01,083777,Greenfeld; Be'Eri,3,0,36,33
1657918992426,MATH 103A,A02,083778,Greenfeld; Be'Eri,5,0,36,31
1657918992426,MATH 103A,A03,093561,Greenfeld; Be'Eri,6,0,36,30
1657918992426,MATH 103A,B01,083779,Greenfeld; Be'Eri,8,0,36,28
1657918992426,MATH 103A,B02,083780,Greenfeld; Be'Eri,4,0,36,32
1657918992426,MATH 103A,B03,093562,Greenfeld; Be'Eri,3,0,36,33
1657918998449,MATH 105,A01,085443,Carter; Anne Toulson,15,0,35,20
1657918998449,MATH 105,A02,093477,Carter; Anne Toulson,20,0,35,15
1657919004472,MATH 109,A01,083213,Ganzberger; Geoffrey Michael,3,0,34,31
1657919004472,MATH 109,A02,083214,Ganzberger; Geoffrey Michael,4,0,34,30
1657919004472,MATH 109,A03,093478,Ganzberger; Geoffrey Michael,2,0,34,32
1657919004472,MATH 109,B01,083215,Ganzberger; Geoffrey Michael,2,0,32,30
1657919004472,MATH 109,B02,083216,Ganzberger; Geoffrey Michael,2,0,32,30
1657919004472,MATH 109,B03,093479,Ganzberger; Geoffrey Michael,8,0,32,24
1657919010497,MATH 142A,A01,083219,Chow; Bennett,7,0,32,25
1657919010497,MATH 142A,A02,083220,Chow; Bennett,10,0,32,22
1657919010497,MATH 142A,A03,093480,Chow; Bennett,9,0,32,23
1657919010497,MATH 142A,B03,093481,Chow; Bennett,8,0,32,24
1657919010497,MATH 142A,B04,093558,Chow; Bennett,13,0,32,19
1657919010497,MATH 142A,B05,093559,Chow; Bennett,7,0,32,25
1657919016533,MATH 193A,A01,083224,Rotar; Vladimir,8,0,34,26
1657919016533,MATH 193A,A02,083225,Rotar; Vladimir,10,0,34,24
1657919016533,MATH 193A,A03,083781,Rotar; Vladimir,5,0,34,29
1657919016533,MATH 193A,A04,083782,Rotar; Vladimir,11,0,34,23
1657919016533,MATH 193A,A05,093482,Rotar; Vladimir,11,0,34,23
1657919022558,MATH 197,001,091859,McAuley; Julian John,9999,0,9999,0
1657919022558,MATH 197,002,095566,Kedlaya; Kiran S.,9997,0,9999,2
1657919022558,MATH 197,003,095567,Xiao; Ming,9999,0,9999,0
1657919022558,MATH 197,004,095571,Perols; Johan Lars,9998,0,9999,1
1657919029628,COGS 9,A01,083615,Shannon; Kyle Michael,10,0,75,65
1657919035651,COGS 11,A01,083617,Boyle; Mary E. T.,23,0,48,25
1657919041673,COGS 13,A01,083071,Bastos; Amalia Pinkusfeld,11,0,71,60
1657919047696,COGS 14A,A01,092681,Semenuks; Arturs,5,1,100,95
1657919053790,COGS 14B,A01,083073,Cheng; Tzu-Han,6,0,63,57
1657919059812,COGS 17,A01,092677,Semenuks; Arturs,6,0,81,75
1657919065844,COGS 100,A01,083619,Allen; Michael Gordon,17,0,70,53
1657919071869,COGS 101A,A01,083621,Davis; Joshua Daniel,9,0,68,59
1657919077899,COGS 101B,A01,091572,Allen; Michael Gordon,14,0,65,51
1657919083926,COGS 101C,A01,083625,Delgado; Tania,17,0,35,18
1657919089953,COGS 107A,A01,083627,Boyle; Mary E. T.,14,0,60,46
1657919095985,COGS 118A,A01,083075,Gupta; Anjum,21,0,76,55
1657919102014,CSE 3,A50,083646,Miranda; Gregory Joseph,24,0,50,26
1657919108036,CSE 8A,A50,083650,Miranda; Gregory Joseph,17,1,56,39
1657919114062,CSE 11,A01,083080,Cao; Yingjun,6,15,40,34
1657919120084,CSE 12,A01,083652,Krause-Levy; Sophia Louisa,30,1,120,90
1657919126114,CSE 15L,A01,083654,Morris; Justin Loren,9,0,50,41
1657919126114,CSE 15L,A02,083655,Morris; Justin Loren,10,0,50,40
1657919132139,CSE 20,A01,083657,Tran; Khoa Dang,39,0,80,41
1657919138165,CSE 21,A01,095574,Bach; Quang Tran,22,0,48,26
1657919144189,CSE 30,A01,083084,Eldon; John,6,0,80,74
1657919144189,CSE 30,B01,095061,Bhaskar; Nishant,9,0,50,41
1657919150223,CSE 100,A01,083659,Cao; Yingjun,5,4,70,65
1657919156251,CSE 134B,A01,083661,Powell; Thomas Allan,25,0,100,75
1657919162276,CSE 140,A01,083663,Gungor; Onat,16,0,85,69
1657919168298,CSE 140L,A01,083088,Eldon; John,23,0,100,77
1657919174326,CSE 175,A01,083665,Kumar; Rakesh,3,0,25,22
1657919180353,CSE 190,A00,092507,Dubnov; Shlomo,8,0,20,12
1657919186380,ECE 45,A01,083139,Congero; Spencer William,7,0,75,68
1657919192406,ECE 65,A50,083695,Saad; Andrew S,12,0,30,18
1657919192406,ECE 65,A51,095125,Saad; Andrew S,24,0,26,2
1657919198430,ECE 109,A01,091882,Touri; Behrouz,20,0,70,50
1657919204451,ECE 180,A00,083140,Abi Samra; Nicholas Camill,1,0,30,29
1657919204451,ECE 180,B00,083141,Abi Samra; Nicholas Camill,0,0,30,30
1657919210480,MATH 10A,A01,083735,Patchell; Gregory David,2,0,30,28
1657919210480,MATH 10A,A02,083736,Patchell; Gregory David,20,0,30,10
1657919210480,MATH 10A,A03,083737,Patchell; Gregory David,16,0,30,14
1657919216508,MATH 10B,A01,083207,Lim; Seonhee,8,0,34,26
1657919216508,MATH 10B,A02,083208,Lim; Seonhee,10,0,35,25
1657919216508,MATH 10B,A03,093472,Lim; Seonhee,7,0,34,27
1657919216508,MATH 10B,B01,083739,Sinha; Shubham,14,0,30,16
1657919222534,MATH 18,A01,083743,Cinel; Cameron Alexander,9,0,30,21
1657919222534,MATH 18,A02,083744,Cinel; Cameron Alexander,18,0,30,12
1657919222534,MATH 18,A03,083745,Cinel; Cameron Alexander,10,0,30,20
1657919222534,MATH 18,B01,083748,Rideout; David Porter,5,0,37,32
1657919222534,MATH 18,B02,083749,Rideout; David Porter,5,0,36,31
1657919222534,MATH 18,B03,083750,Rideout; David Porter,3,0,37,34
1657919222534,MATH 18,B04,083751,Rideout; David Porter,6,0,36,30
1657919222534,MATH 18,B05,093473,Rideout; David Porter,7,0,36,29
1657919222534,MATH 18,B06,093474,Rideout; David Porter,6,0,36,30
1657919228560,MATH 20A,A01,083754,Zheng; Zequn,14,0,40,26
1657919234590,MATH 20B,A01,083756,Briones; Jor-el Thomas Caparas,4,0,36,32
1657919234590,MATH 20B,A02,083757,Briones; Jor-el Thomas Caparas,1,0,36,35
1657919234590,MATH 20B,A03,093475,Briones; Jor-el Thomas Caparas,3,0,36,33
1657919240618,MATH 20C,A01,083760,Briones; Jor-el Thomas Caparas,1,0,35,34
1657919240618,MATH 20C,A02,083761,Briones; Jor-el Thomas Caparas,8,0,35,27
1657919240618,MATH 20C,A03,093476,Briones; Jor-el Thomas Caparas,0,1,36,36
1657919240618,MATH 20C,B01,083762,Bach; Quang Tran,1,0,30,29
1657919246643,MATH 20D,A01,083765,Tran; Brian Kha,5,0,30,25
1657919246643,MATH 20D,A02,083766,Tran; Brian Kha,5,0,30,25
1657919246643,MATH 20D,A03,083767,Tran; Brian Kha,6,0,30,24
1657919252667,MATH 20E,A01,083771,Ganguly; Soumya,10,0,32,22
1657919252667,MATH 20E,A02,083772,Ganguly; Soumya,7,0,32,25
1657919252667,MATH 20E,B01,083773,Ciotti; Benjamin,20,0,35,15
1657919252667,MATH 20E,B02,083774,Ciotti; Benjamin,18,0,35,17
1657919258691,MATH 103A,A01,083777,Greenfeld; Be'Eri,3,0,36,33
1657919258691,MATH 103A,A02,083778,Greenfeld; Be'Eri,5,0,36,31
1657919258691,MATH 103A,A03,093561,Greenfeld; Be'Eri,6,0,36,30
1657919258691,MATH 103A,B01,083779,Greenfeld; Be'Eri,8,0,36,28
1657919258691,MATH 103A,B02,083780,Greenfeld; Be'Eri,4,0,36,32
1657919258691,MATH 103A,B03,093562,Greenfeld; Be'Eri,3,0,36,33
1657919264714,MATH 105,A01,085443,Carter; Anne Toulson,15,0,35,20
1657919264714,MATH 105,A02,093477,Carter; Anne Toulson,20,0,35,15
1657919270744,MATH 109,A01,083213,Ganzberger; Geoffrey Michael,3,0,34,31
1657919270744,MATH 109,A02,083214,Ganzberger; Geoffrey Michael,4,0,34,30
1657919270744,MATH 109,A03,093478,Ganzberger; Geoffrey Michael,2,0,34,32
1657919270744,MATH 109,B01,083215,Ganzberger; Geoffrey Michael,2,0,32,30
1657919270744,MATH 109,B02,083216,Ganzberger; Geoffrey Michael,2,0,32,30
1657919270744,MATH 109,B03,093479,Ganzberger; Geoffrey Michael,8,0,32,24
1657919276769,MATH 142A,A01,083219,Chow; Bennett,7,0,32,25
1657919276769,MATH 142A,A02,083220,Chow; Bennett,10,0,32,22
1657919276769,MATH 142A,A03,093480,Chow; Bennett,9,0,32,23
1657919276769,MATH 142A,B03,093481,Chow; Bennett,8,0,32,24
1657919276769,MATH 142A,B04,093558,Chow; Bennett,13,0,32,19
1657919276769,MATH 142A,B05,093559,Chow; Bennett,7,0,32,25
1657919282794,MATH 193A,A01,083224,Rotar; Vladimir,8,0,34,26
1657919282794,MATH 193A,A02,083225,Rotar; Vladimir,10,0,34,24
1657919282794,MATH 193A,A03,083781,Rotar; Vladimir,5,0,34,29
1657919282794,MATH 193A,A04,083782,Rotar; Vladimir,11,0,34,23
1657919282794,MATH 193A,A05,093482,Rotar; Vladimir,11,0,34,23
1657919288822,MATH 197,001,091859,McAuley; Julian John,9999,0,9999,0
1657919288822,MATH 197,002,095566,Kedlaya; Kiran S.,9997,0,9999,2
1657919288822,MATH 197,003,095567,Xiao; Ming,9999,0,9999,0
1657919288822,MATH 197,004,095571,Perols; Johan Lars,9998,0,9999,1
1657919295889,COGS 9,A01,083615,Shannon; Kyle Michael,10,0,75,65
1657919301915,COGS 11,A01,083617,Boyle; Mary E. T.,23,0,48,25
1657919307950,COGS 13,A01,083071,Bastos; Amalia Pinkusfeld,11,0,71,60
1657919313972,COGS 14A,A01,092681,Semenuks; Arturs,5,1,100,95
1657919320019,COGS 14B,A01,083073,Cheng; Tzu-Han,7,0,63,56
1657919326042,COGS 17,A01,092677,Semenuks; Arturs,6,0,81,75
1657919332070,COGS 100,A01,083619,Allen; Michael Gordon,17,0,70,53
1657919338097,COGS 101A,A01,083621,Davis; Joshua Daniel,9,0,68,59
1657919344118,COGS 101B,A01,091572,Allen; Michael Gordon,14,0,65,51
1657919350144,COGS 101C,A01,083625,Delgado; Tania,17,0,35,18
1657919356170,COGS 107A,A01,083627,Boyle; Mary E. T.,14,0,60,46
1657919362198,COGS 118A,A01,083075,Gupta; Anjum,21,0,76,55
1657919368221,CSE 3,A50,083646,Miranda; Gregory Joseph,24,0,50,26
1657919374244,CSE 8A,A50,083650,Miranda; Gregory Joseph,17,1,56,39
1657919380267,CSE 11,A01,083080,Cao; Yingjun,6,15,40,34
1657919386296,CSE 12,A01,083652,Krause-Levy; Sophia Louisa,30,1,120,90
1657919392320,CSE 15L,A01,083654,Morris; Justin Loren,9,0,50,41
1657919392320,CSE 15L,A02,083655,Morris; Justin Loren,10,0,50,40
1657919398351,CSE 20,A01,083657,Tran; Khoa Dang,39,0,80,41
1657919404382,CSE 21,A01,095574,Bach; Quang Tran,22,0,48,26
1657919410414,CSE 30,A01,083084,Eldon; John,6,0,80,74
1657919410414,CSE 30,B01,095061,Bhaskar; Nishant,9,0,50,41
1657919416440,CSE 100,A01,083659,Cao; Yingjun,5,4,70,65
1657919422467,CSE 134B,A01,083661,Powell; Thomas Allan,25,0,100,75
1657919428493,CSE 140,A01,083663,Gungor; Onat,16,0,85,69
1657919434521,CSE 140L,A01,083088,Eldon; John,23,0,100,77
1657919440545,CSE 175,A01,083665,Kumar; Rakesh,3,0,25,22
1657919446572,CSE 190,A00,092507,Dubnov; Shlomo,8,0,20,12
1657919452594,ECE 45,A01,083139,Congero; Spencer William,7,0,75,68
1657919458622,ECE 65,A50,083695,Saad; Andrew S,12,0,30,18
1657919458622,ECE 65,A51,095125,Saad; Andrew S,24,0,26,2
1657919464648,ECE 109,A01,091882,Touri; Behrouz,20,0,70,50
1657919470672,ECE 180,A00,083140,Abi Samra; Nicholas Camill,1,0,30,29
1657919470672,ECE 180,B00,083141,Abi Samra; Nicholas Camill,0,0,30,30
1657919476700,MATH 10A,A01,083735,Patchell; Gregory David,2,0,30,28
1657919476700,MATH 10A,A02,083736,Patchell; Gregory David,20,0,30,10
1657919476700,MATH 10A,A03,083737,Patchell; Gregory David,16,0,30,14
1657919482724,MATH 10B,A01,083207,Lim; Seonhee,8,0,34,26
1657919482724,MATH 10B,A02,083208,Lim; Seonhee,10,0,35,25
1657919482724,MATH 10B,A03,093472,Lim; Seonhee,7,0,34,27
1657919482724,MATH 10B,B01,083739,Sinha; Shubham,14,0,30,16
1657919488748,MATH 18,A01,083743,Cinel; Cameron Alexander,9,0,30,21
1657919488748,MATH 18,A02,083744,Cinel; Cameron Alexander,18,0,30,12
1657919488748,MATH 18,A03,083745,Cinel; Cameron Alexander,10,0,30,20
1657919488748,MATH 18,B01,083748,Rideout; David Porter,5,0,37,32
1657919488748,MATH 18,B02,083749,Rideout; David Porter,5,0,36,31
1657919488748,MATH 18,B03,083750,Rideout; David Porter,3,0,37,34
1657919488748,MATH 18,B04,083751,Rideout; David Porter,6,0,36,30
1657919488748,MATH 18,B05,093473,Rideout; David Porter,7,0,36,29
1657919488748,MATH 18,B06,093474,Rideout; David Porter,6,0,36,30
1657919494771,MATH 20A,A01,083754,Zheng; Zequn,14,0,40,26
1657919500799,MATH 20B,A01,083756,Briones; Jor-el Thomas Caparas,4,0,36,32
1657919500799,MATH 20B,A02,083757,Briones; Jor-el Thomas Caparas,1,0,36,35
1657919500799,MATH 20B,A03,093475,Briones; Jor-el Thomas Caparas,3,0,36,33
1657919506827,MATH 20C,A01,083760,Briones; Jor-el Thomas Caparas,1,0,35,34
1657919506827,MATH 20C,A02,083761,Briones; Jor-el Thomas Caparas,8,0,35,27
1657919506827,MATH 20C,A03,093476,Briones; Jor-el Thomas Caparas,0,1,36,36
1657919506827,MATH 20C,B01,083762,Bach; Quang Tran,1,0,30,29
1657919512854,MATH 20D,A01,083765,Tran; Brian Kha,5,0,30,25
1657919512854,MATH 20D,A02,083766,Tran; Brian Kha,5,0,30,25
1657919512854,MATH 20D,A03,083767,Tran; Brian Kha,6,0,30,24
1657919518881,MATH 20E,A01,083771,Ganguly; Soumya,10,0,32,22
1657919518881,MATH 20E,A02,083772,Ganguly; Soumya,7,0,32,25
1657919518881,MATH 20E,B01,083773,Ciotti; Benjamin,20,0,35,15
1657919518881,MATH 20E,B02,083774,Ciotti; Benjamin,18,0,35,17
1657919524906,MATH 103A,A01,083777,Greenfeld; Be'Eri,3,0,36,33
1657919524906,MATH 103A,A02,083778,Greenfeld; Be'Eri,5,0,36,31
1657919524906,MATH 103A,A03,093561,Greenfeld; Be'Eri,6,0,36,30
1657919524906,MATH 103A,B01,083779,Greenfeld; Be'Eri,8,0,36,28
1657919524906,MATH 103A,B02,083780,Greenfeld; Be'Eri,4,0,36,32
1657919524906,MATH 103A,B03,093562,Greenfeld; Be'Eri,3,0,36,33
1657919530932,MATH 105,A01,085443,Carter; Anne Toulson,15,0,35,20
1657919530932,MATH 105,A02,093477,Carter; Anne Toulson,20,0,35,15
1657919536957,MATH 109,A01,083213,Ganzberger; Geoffrey Michael,3,0,34,31
1657919536957,MATH 109,A02,083214,Ganzberger; Geoffrey Michael,4,0,34,30
1657919536957,MATH 109,A03,093478,Ganzberger; Geoffrey Michael,2,0,34,32
1657919536957,MATH 109,B01,083215,Ganzberger; Geoffrey Michael,2,0,32,30
1657919536957,MATH 109,B02,083216,Ganzberger; Geoffrey Michael,2,0,32,30
1657919536957,MATH 109,B03,093479,Ganzberger; Geoffrey Michael,8,0,32,24
1657919542986,MATH 142A,A01,083219,Chow; Bennett,7,0,32,25
1657919542986,MATH 142A,A02,083220,Chow; Bennett,10,0,32,22
1657919542986,MATH 142A,A03,093480,Chow; Bennett,9,0,32,23
1657919542986,MATH 142A,B03,093481,Chow; Bennett,8,0,32,24
1657919542986,MATH 142A,B04,093558,Chow; Bennett,13,0,32,19
1657919542986,MATH 142A,B05,093559,Chow; Bennett,7,0,32,25
1657919549013,MATH 193A,A01,083224,Rotar; Vladimir,8,0,34,26
1657919549013,MATH 193A,A02,083225,Rotar; Vladimir,10,0,34,24
1657919549013,MATH 193A,A03,083781,Rotar; Vladimir,5,0,34,29
1657919549013,MATH 193A,A04,083782,Rotar; Vladimir,11,0,34,23
1657919549013,MATH 193A,A05,093482,Rotar; Vladimir,11,0,34,23
1657919555039,MATH 197,001,091859,McAuley; Julian John,9999,0,9999,0
1657919555039,MATH 197,002,095566,Kedlaya; Kiran S.,9997,0,9999,2
1657919555039,MATH 197,003,095567,Xiao; Ming,9999,0,9999,0
1657919555039,MATH 197,004,095571,Perols; Johan Lars,9998,0,9999,1
1657919562111,COGS 9,A01,083615,Shannon; Kyle Michael,10,0,75,65
1657919568138,COGS 11,A01,083617,Boyle; Mary E. T.,23,0,48,25
1657919574159,COGS 13,A01,083071,Bastos; Amalia Pinkusfeld,11,0,71,60
1657919580187,COGS 14A,A01,092681,Semenuks; Arturs,5,1,100,95
1657919586218,COGS 14B,A01,083073,Cheng; Tzu-Han,7,0,63,56
1657919592254,COGS 17,A01,092677,Semenuks; Arturs,6,0,81,75
1657919598280,COGS 100,A01,083619,Allen; Michael Gordon,17,0,70,53
1657919604314,COGS 101A,A01,083621,Davis; Joshua Daniel,9,0,68,59
1657919610342,COGS 101B,A01,091572,Allen; Michael Gordon,14,0,65,51
1657919616368,COGS 101C,A01,083625,Delgado; Tania,17,0,35,18
1657919622402,COGS 107A,A01,083627,Boyle; Mary E. T.,14,0,60,46
1657919628425,COGS 118A,A01,083075,Gupta; Anjum,21,0,76,55
1657919634450,CSE 3,A50,083646,Miranda; Gregory Joseph,24,0,50,26
1657919640479,CSE 8A,A50,083650,Miranda; Gregory Joseph,17,1,56,39
1657919646502,CSE 11,A01,083080,Cao; Yingjun,6,15,40,34
1657919652621,CSE 12,A01,083652,Krause-Levy; Sophia Louisa,30,1,120,90
1657919658656,CSE 15L,A01,083654,Morris; Justin Loren,9,0,50,41
1657919658656,CSE 15L,A02,083655,Morris; Justin Loren,10,0,50,40
1657919664679,CSE 20,A01,083657,Tran; Khoa Dang,39,0,80,41
1657919670703,CSE 21,A01,095574,Bach; Quang Tran,22,0,48,26
1657919676733,CSE 30,A01,083084,Eldon; John,6,0,80,74
1657919676733,CSE 30,B01,095061,Bhaskar; Nishant,9,0,50,41
1657919682756,CSE 100,A01,083659,Cao; Yingjun,5,4,70,65
1657919688783,CSE 134B,A01,083661,Powell; Thomas Allan,25,0,100,75
1657919694824,CSE 140,A01,083663,Gungor; Onat,16,0,85,69
1657919700853,CSE 140L,A01,083088,Eldon; John,23,0,100,77
1657919706882,CSE 175,A01,083665,Kumar; Rakesh,3,0,25,22
1657919712903,CSE 190,A00,092507,Dubnov; Shlomo,8,0,20,12
1657919718927,ECE 45,A01,083139,Congero; Spencer William,7,0,75,68
1657919724950,ECE 65,A50,083695,Saad; Andrew S,12,0,30,18
1657919724950,ECE 65,A51,095125,Saad; Andrew S,24,0,26,2
1657919730974,ECE 109,A01,091882,Touri; Behrouz,20,0,70,50
1657919737001,ECE 180,A00,083140,Abi Samra; Nicholas Camill,1,0,30,29
1657919737001,ECE 180,B00,083141,Abi Samra; Nicholas Camill,0,0,30,30
1657919743026,MATH 10A,A01,083735,Patchell; Gregory David,2,0,30,28
1657919743026,MATH 10A,A02,083736,Patchell; Gregory David,20,0,30,10
1657919743026,MATH 10A,A03,083737,Patchell; Gregory David,16,0,30,14
1657919749054,MATH 10B,A01,083207,Lim; Seonhee,8,0,34,26
1657919749054,MATH 10B,A02,083208,Lim; Seonhee,10,0,35,25
1657919749054,MATH 10B,A03,093472,Lim; Seonhee,7,0,34,27
1657919749054,MATH 10B,B01,083739,Sinha; Shubham,14,0,30,16
1657919755080,MATH 18,A01,083743,Cinel; Cameron Alexander,9,0,30,21
1657919755080,MATH 18,A02,083744,Cinel; Cameron Alexander,18,0,30,12
1657919755080,MATH 18,A03,083745,Cinel; Cameron Alexander,10,0,30,20
1657919755080,MATH 18,B01,083748,Rideout; David Porter,5,0,37,32
1657919755080,MATH 18,B02,083749,Rideout; David Porter,5,0,36,31
1657919755080,MATH 18,B03,083750,Rideout; David Porter,3,0,37,34
1657919755080,MATH 18,B04,083751,Rideout; David Porter,6,0,36,30
1657919755080,MATH 18,B05,093473,Rideout; David Porter,7,0,36,29
1657919755080,MATH 18,B06,093474,Rideout; David Porter,6,0,36,30
1657919761103,MATH 20A,A01,083754,Zheng; Zequn,14,0,40,26
1657919767128,MATH 20B,A01,083756,Briones; Jor-el Thomas Caparas,4,0,36,32
1657919767128,MATH 20B,A02,083757,Briones; Jor-el Thomas Caparas,1,0,36,35
1657919767128,MATH 20B,A03,093475,Briones; Jor-el Thomas Caparas,3,0,36,33
1657919773162,MATH 20C,A01,083760,Briones; Jor-el Thomas Caparas,1,0,35,34
1657919773162,MATH 20C,A02,083761,Briones; Jor-el Thomas Caparas,8,0,35,27
1657919773162,MATH 20C,A03,093476,Briones; Jor-el Thomas Caparas,0,1,36,36
1657919773162,MATH 20C,B01,083762,Bach; Quang Tran,1,0,30,29
1657919779185,MATH 20D,A01,083765,Tran; Brian Kha,5,0,30,25
1657919779185,MATH 20D,A02,083766,Tran; Brian Kha,5,0,30,25
1657919779185,MATH 20D,A03,083767,Tran; Brian Kha,6,0,30,24
1657919785216,MATH 20E,A01,083771,Ganguly; Soumya,10,0,32,22
1657919785216,MATH 20E,A02,083772,Ganguly; Soumya,7,0,32,25
1657919785216,MATH 20E,B01,083773,Ciotti; Benjamin,20,0,35,15
1657919785216,MATH 20E,B02,083774,Ciotti; Benjamin,18,0,35,17
1657919791243,MATH 103A,A01,083777,Greenfeld; Be'Eri,3,0,36,33
1657919791243,MATH 103A,A02,083778,Greenfeld; Be'Eri,5,0,36,31
1657919791243,MATH 103A,A03,093561,Greenfeld; Be'Eri,6,0,36,30
1657919791243,MATH 103A,B01,083779,Greenfeld; Be'Eri,8,0,36,28
1657919791243,MATH 103A,B02,083780,Greenfeld; Be'Eri,4,0,36,32
1657919791243,MATH 103A,B03,093562,Greenfeld; Be'Eri,3,0,36,33
1657919797279,MATH 105,A01,085443,Carter; Anne Toulson,15,0,35,20
1657919797279,MATH 105,A02,093477,Carter; Anne Toulson,20,0,35,15
1657919803306,MATH 109,A01,083213,Ganzberger; Geoffrey Michael,3,0,34,31
1657919803306,MATH 109,A02,083214,Ganzberger; Geoffrey Michael,4,0,34,30
1657919803306,MATH 109,A03,093478,Ganzberger; Geoffrey Michael,2,0,34,32
1657919803306,MATH 109,B01,083215,Ganzberger; Geoffrey Michael,2,0,32,30
1657919803306,MATH 109,B02,083216,Ganzberger; Geoffrey Michael,2,0,32,30
1657919803306,MATH 109,B03,093479,Ganzberger; Geoffrey Michael,8,0,32,24
1657919809330,MATH 142A,A01,083219,Chow; Bennett,7,0,32,25
1657919809330,MATH 142A,A02,083220,Chow; Bennett,10,0,32,22
1657919809330,MATH 142A,A03,093480,Chow; Bennett,9,0,32,23
1657919809330,MATH 142A,B03,093481,Chow; Bennett,8,0,32,24
1657919809330,MATH 142A,B04,093558,Chow; Bennett,13,0,32,19
1657919809330,MATH 142A,B05,093559,Chow; Bennett,7,0,32,25
1657919815357,MATH 193A,A01,083224,Rotar; Vladimir,8,0,34,26
1657919815357,MATH 193A,A02,083225,Rotar; Vladimir,10,0,34,24
1657919815357,MATH 193A,A03,083781,Rotar; Vladimir,5,0,34,29
1657919815357,MATH 193A,A04,083782,Rotar; Vladimir,11,0,34,23
1657919815357,MATH 193A,A05,093482,Rotar; Vladimir,11,0,34,23
1657919821378,MATH 197,001,091859,McAuley; Julian John,9999,0,9999,0
1657919821378,MATH 197,002,095566,Kedlaya; Kiran S.,9997,0,9999,2
1657919821378,MATH 197,003,095567,Xiao; Ming,9999,0,9999,0
1657919821378,MATH 197,004,095571,Perols; Johan Lars,9998,0,9999,1
1657919828443,COGS 9,A01,083615,Shannon; Kyle Michael,10,0,75,65
1657919834469,COGS 11,A01,083617,Boyle; Mary E. T.,23,0,48,25
1657919840493,COGS 13,A01,083071,Bastos; Amalia Pinkusfeld,11,0,71,60
1657919846516,COGS 14A,A01,092681,Semenuks; Arturs,5,1,100,95
1657919852540,COGS 14B,A01,083073,Cheng; Tzu-Han,7,0,63,56
1657919858565,COGS 17,A01,092677,Semenuks; Arturs,6,0,81,75
1657919864592,COGS 100,A01,083619,Allen; Michael Gordon,17,0,70,53
1657919870615,COGS 101A,A01,083621,Davis; Joshua Daniel,9,0,68,59
1657919876643,COGS 101B,A01,091572,Allen; Michael Gordon,14,0,65,51
1657919882671,COGS 101C,A01,083625,Delgado; Tania,17,0,35,18
1657919888703,COGS 107A,A01,083627,Boyle; Mary E. T.,14,0,60,46
1657919894730,COGS 118A,A01,083075,Gupta; Anjum,21,0,76,55
1657919900759,CSE 3,A50,083646,Miranda; Gregory Joseph,24,0,50,26
1657919906783,CSE 8A,A50,083650,Miranda; Gregory Joseph,17,1,56,39
1657919912805,CSE 11,A01,083080,Cao; Yingjun,6,15,40,34
1657919918827,CSE 12,A01,083652,Krause-Levy; Sophia Louisa,30,1,120,90
1657919924855,CSE 15L,A01,083654,Morris; Justin Loren,9,0,50,41
1657919924855,CSE 15L,A02,083655,Morris; Justin Loren,10,0,50,40
1657919930879,CSE 20,A01,083657,Tran; Khoa Dang,39,0,80,41
1657919936904,CSE 21,A01,095574,Bach; Quang Tran,22,0,48,26
1657919942929,CSE 30,A01,083084,Eldon; John,6,0,80,74
1657919942929,CSE 30,B01,095061,Bhaskar; Nishant,9,0,50,41
1657919948954,CSE 100,A01,083659,Cao; Yingjun,5,4,70,65
1657919954978,CSE 134B,A01,083661,Powell; Thomas Allan,25,0,100,75
1657919961003,CSE 140,A01,083663,Gungor; Onat,16,0,85,69
1657919967027,CSE 140L,A01,083088,Eldon; John,23,0,100,77
1657919973055,CSE 175,A01,083665,Kumar; Rakesh,3,0,25,22
1657919979089,CSE 190,A00,092507,Dubnov; Shlomo,8,0,20,12
1657919985117,ECE 45,A01,083139,Congero; Spencer William,7,0,75,68
1657919991144,ECE 65,A50,083695,Saad; Andrew S,12,0,30,18
1657919991144,ECE 65,A51,095125,Saad; Andrew S,24,0,26,2
1657919997180,ECE 109,A01,091882,Touri; Behrouz,20,0,70,50
1657920003204,ECE 180,A00,083140,Abi Samra; Nicholas Camill,1,0,30,29
1657920003204,ECE 180,B00,083141,Abi Samra; Nicholas Camill,0,0,30,30
1657920009227,MATH 10A,A01,083735,Patchell; Gregory David,2,0,30,28
1657920009227,MATH 10A,A02,083736,Patchell; Gregory David,20,0,30,10
1657920009227,MATH 10A,A03,083737,Patchell; Gregory David,16,0,30,14
1657920015269,MATH 10B,A01,083207,Lim; Seonhee,8,0,34,26
1657920015269,MATH 10B,A02,083208,Lim; Seonhee,10,0,35,25
1657920015269,MATH 10B,A03,093472,Lim; Seonhee,7,0,34,27
1657920015269,MATH 10B,B01,083739,Sinha; Shubham,14,0,30,16
1657920021315,MATH 18,A01,083743,Cinel; Cameron Alexander,9,0,30,21
1657920021315,MATH 18,A02,083744,Cinel; Cameron Alexander,18,0,30,12
1657920021315,MATH 18,A03,083745,Cinel; Cameron Alexander,10,0,30,20
1657920021315,MATH 18,B01,083748,Rideout; David Porter,5,0,37,32
1657920021315,MATH 18,B02,083749,Rideout; David Porter,5,0,36,31
1657920021315,MATH 18,B03,083750,Rideout; David Porter,3,0,37,34
1657920021315,MATH 18,B04,083751,Rideout; David Porter,7,0,36,29
1657920021315,MATH 18,B05,093473,Rideout; David Porter,7,0,36,29
1657920021315,MATH 18,B06,093474,Rideout; David Porter,6,0,36,30
1657920027337,MATH 20A,A01,083754,Zheng; Zequn,14,0,40,26
1657920033365,MATH 20B,A01,083756,Briones; Jor-el Thomas Caparas,4,0,36,32
1657920033365,MATH 20B,A02,083757,Briones; Jor-el Thomas Caparas,1,0,36,35
1657920033365,MATH 20B,A03,093475,Briones; Jor-el Thomas Caparas,3,0,36,33
1657920039405,MATH 20C,A01,083760,Briones; Jor-el Thomas Caparas,1,0,35,34
1657920039405,MATH 20C,A02,083761,Briones; Jor-el Thomas Caparas,8,0,35,27
1657920039405,MATH 20C,A03,093476,Briones; Jor-el Thomas Caparas,0,1,36,36
1657920039405,MATH 20C,B01,083762,Bach; Quang Tran,1,0,30,29
1657920045433,MATH 20D,A01,083765,Tran; Brian Kha,5,0,30,25
1657920045433,MATH 20D,A02,083766,Tran; Brian Kha,5,0,30,25
1657920045433,MATH 20D,A03,083767,Tran; Brian Kha,6,0,30,24
1657920051455,MATH 20E,A01,083771,Ganguly; Soumya,10,0,32,22
1657920051455,MATH 20E,A02,083772,Ganguly; Soumya,7,0,32,25
1657920051455,MATH 20E,B01,083773,Ciotti; Benjamin,20,0,35,15
1657920051455,MATH 20E,B02,083774,Ciotti; Benjamin,18,0,35,17
1657920057483,MATH 103A,A01,083777,Greenfeld; Be'Eri,3,0,36,33
1657920057483,MATH 103A,A02,083778,Greenfeld; Be'Eri,5,0,36,31
1657920057483,MATH 103A,A03,093561,Greenfeld; Be'Eri,6,0,36,30
1657920057483,MATH 103A,B01,083779,Greenfeld; Be'Eri,8,0,36,28
1657920057483,MATH 103A,B02,083780,Greenfeld; Be'Eri,4,0,36,32
1657920057483,MATH 103A,B03,093562,Greenfeld; Be'Eri,3,0,36,33
1657920063509,MATH 105,A01,085443,Carter; Anne Toulson,15,0,35,20
1657920063509,MATH 105,A02,093477,Carter; Anne Toulson,20,0,35,15
1657920069540,MATH 109,A01,083213,Ganzberger; Geoffrey Michael,3,0,34,31
1657920069540,MATH 109,A02,083214,Ganzberger; Geoffrey Michael,4,0,34,30
1657920069540,MATH 109,A03,093478,Ganzberger; Geoffrey Michael,2,0,34,32
1657920069540,MATH 109,B01,083215,Ganzberger; Geoffrey Michael,2,0,32,30
1657920069540,MATH 109,B02,083216,Ganzberger; Geoffrey Michael,2,0,32,30
1657920069540,MATH 109,B03,093479,Ganzberger; Geoffrey Michael,8,0,32,24
1657920075570,MATH 142A,A01,083219,Chow; Bennett,7,0,32,25
1657920075570,MATH 142A,A02,083220,Chow; Bennett,10,0,32,22
1657920075570,MATH 142A,A03,093480,Chow; Bennett,9,0,32,23
1657920075570,MATH 142A,B03,093481,Chow; Bennett,8,0,32,24
1657920075570,MATH 142A,B04,093558,Chow; Bennett,13,0,32,19
1657920075570,MATH 142A,B05,093559,Chow; Bennett,7,0,32,25
1657920081597,MATH 193A,A01,083224,Rotar; Vladimir,8,0,34,26
1657920081597,MATH 193A,A02,083225,Rotar; Vladimir,10,0,34,24
1657920081597,MATH 193A,A03,083781,Rotar; Vladimir,5,0,34,29
1657920081597,MATH 193A,A04,083782,Rotar; Vladimir,11,0,34,23
1657920081597,MATH 193A,A05,093482,Rotar; Vladimir,11,0,34,23
1657920087638,MATH 197,001,091859,McAuley; Julian John,9999,0,9999,0
1657920087638,MATH 197,002,095566,Kedlaya; Kiran S.,9997,0,9999,2
1657920087638,MATH 197,003,095567,Xiao; Ming,9999,0,9999,0
1657920087638,MATH 197,004,095571,Perols; Johan Lars,9998,0,9999,1
1657920094705,COGS 9,A01,083615,Shannon; Kyle Michael,10,0,75,65
1657920100727,COGS 11,A01,083617,Boyle; Mary E. T.,23,0,48,25
1657920113417,COGS 13,A01,083071,Bastos; Amalia Pinkusfeld,11,0,71,60
1657920119440,COGS 14A,A01,092681,Semenuks; Arturs,5,1,100,95
1657920125467,COGS 14B,A01,083073,Cheng; Tzu-Han,7,0,63,56
1657920131492,COGS 17,A01,092677,Semenuks; Arturs,7,0,81,74
1657920137520,COGS 100,A01,083619,Allen; Michael Gordon,17,0,70,53
1657920143543,COGS 101A,A01,083621,Davis; Joshua Daniel,9,0,68,59
1657920149566,COGS 101B,A01,091572,Allen; Michael Gordon,14,0,65,51
1657920155600,COGS 101C,A01,083625,Delgado; Tania,17,0,35,18
1657920161627,COGS 107A,A01,083627,Boyle; Mary E. T.,14,0,60,46
1657920167653,COGS 118A,A01,083075,Gupta; Anjum,21,0,76,55
1657920173677,CSE 3,A50,083646,Miranda; Gregory Joseph,24,0,50,26
1657920179701,CSE 8A,A50,083650,Miranda; Gregory Joseph,17,1,56,39
1657920185727,CSE 11,A01,083080,Cao; Yingjun,6,15,40,34
1657920191762,CSE 12,A01,083652,Krause-Levy; Sophia Louisa,30,1,120,90
1657920197788,CSE 15L,A01,083654,Morris; Justin Loren,9,0,50,41
1657920197788,CSE 15L,A02,083655,Morris; Justin Loren,10,0,50,40
1657920203811,CSE 20,A01,083657,Tran; Khoa Dang,39,0,80,41
1657920209838,CSE 21,A01,095574,Bach; Quang Tran,22,0,48,26
1657920215871,CSE 30,A01,083084,Eldon; John,6,0,80,74
1657920215871,CSE 30,B01,095061,Bhaskar; Nishant,9,0,50,41
1657920221897,CSE 100,A01,083659,Cao; Yingjun,5,4,70,65
1657920227922,CSE 134B,A01,083661,Powell; Thomas Allan,25,0,100,75
1657920233946,CSE 140,A01,083663,Gungor; Onat,16,0,85,69
1657920239972,CSE 140L,A01,083088,Eldon; John,23,0,100,77
1657920245999,CSE 175,A01,083665,Kumar; Rakesh,3,0,25,22
1657920252025,CSE 190,A00,092507,Dubnov; Shlomo,8,0,20,12
1657920258121,ECE 45,A01,083139,Congero; Spencer William,7,0,75,68
1657920264148,ECE 65,A50,083695,Saad; Andrew S,12,0,30,18
1657920264148,ECE 65,A51,095125,Saad; Andrew S,24,0,26,2
1657920270176,ECE 109,A01,091882,Touri; Behrouz,20,0,70,50
1657920276198,ECE 180,A00,083140,Abi Samra; Nicholas Camill,1,0,30,29
1657920276198,ECE 180,B00,083141,Abi Samra; Nicholas Camill,0,0,30,30
1657920282223,MATH 10A,A01,083735,Patchell; Gregory David,2,0,30,28
1657920282223,MATH 10A,A02,083736,Patchell; Gregory David,20,0,30,10
1657920282223,MATH 10A,A03,083737,Patchell; Gregory David,16,0,30,14
1657920288246,MATH 10B,A01,083207,Lim; Seonhee,8,0,34,26
1657920288246,MATH 10B,A02,083208,Lim; Seonhee,10,0,35,25
1657920288246,MATH 10B,A03,093472,Lim; Seonhee,7,0,34,27
1657920288246,MATH 10B,B01,083739,Sinha; Shubham,14,0,30,16
1657920294272,MATH 18,A01,083743,Cinel; Cameron Alexander,9,0,30,21
1657920294272,MATH 18,A02,083744,Cinel; Cameron Alexander,18,0,30,12
1657920294272,MATH 18,A03,083745,Cinel; Cameron Alexander,10,0,30,20
1657920294272,MATH 18,B01,083748,Rideout; David Porter,5,0,37,32
1657920294272,MATH 18,B02,083749,Rideout; David Porter,5,0,36,31
1657920294272,MATH 18,B03,083750,Rideout; David Porter,3,0,37,34
1657920294272,MATH 18,B04,083751,Rideout; David Porter,7,0,36,29
1657920294272,MATH 18,B05,093473,Rideout; David Porter,7,0,36,29
1657920294272,MATH 18,B06,093474,Rideout; David Porter,6,0,36,30
1657920300302,MATH 20A,A01,083754,Zheng; Zequn,14,0,40,26
1657920306329,MATH 20B,A01,083756,Briones; Jor-el Thomas Caparas,4,0,36,32
1657920306329,MATH 20B,A02,083757,Briones; Jor-el Thomas Caparas,1,0,36,35
1657920306329,MATH 20B,A03,093475,Briones; Jor-el Thomas Caparas,3,0,36,33
1657920312367,MATH 20C,A01,083760,Briones; Jor-el Thomas Caparas,1,0,35,34
1657920312367,MATH 20C,A02,083761,Briones; Jor-el Thomas Caparas,8,0,35,27
1657920312367,MATH 20C,A03,093476,Briones; Jor-el Thomas Caparas,0,1,36,36
1657920312367,MATH 20C,B01,083762,Bach; Quang Tran,1,0,30,29
1657920318397,MATH 20D,A01,083765,Tran; Brian Kha,5,0,30,25
1657920318397,MATH 20D,A02,083766,Tran; Brian Kha,5,0,30,25
1657920318397,MATH 20D,A03,083767,Tran; Brian Kha,6,0,30,24
1657920324426,MATH 20E,A01,083771,Ganguly; Soumya,11,0,32,21
1657920324426,MATH 20E,A02,083772,Ganguly; Soumya,7,0,32,25
1657920324426,MATH 20E,B01,083773,Ciotti; Benjamin,20,0,35,15
1657920324426,MATH 20E,B02,083774,Ciotti; Benjamin,18,0,35,17
1657920330449,MATH 103A,A01,083777,Greenfeld; Be'Eri,3,0,36,33
1657920330449,MATH 103A,A02,083778,Greenfeld; Be'Eri,5,0,36,31
1657920330449,MATH 103A,A03,093561,Greenfeld; Be'Eri,6,0,36,30
1657920330449,MATH 103A,B01,083779,Greenfeld; Be'Eri,8,0,36,28
1657920330449,MATH 103A,B02,083780,Greenfeld; Be'Eri,4,0,36,32
1657920330449,MATH 103A,B03,093562,Greenfeld; Be'Eri,3,0,36,33
1657920336474,MATH 105,A01,085443,Carter; Anne Toulson,15,0,35,20
1657920336474,MATH 105,A02,093477,Carter; Anne Toulson,20,0,35,15
1657920342498,MATH 109,A01,083213,Ganzberger; Geoffrey Michael,3,0,34,31
1657920342498,MATH 109,A02,083214,Ganzberger; Geoffrey Michael,4,0,34,30
1657920342498,MATH 109,A03,093478,Ganzberger; Geoffrey Michael,2,0,34,32
1657920342498,MATH 109,B01,083215,Ganzberger; Geoffrey Michael,2,0,32,30
1657920342498,MATH 109,B02,083216,Ganzberger; Geoffrey Michael,2,0,32,30
1657920342498,MATH 109,B03,093479,Ganzberger; Geoffrey Michael,8,0,32,24
1657920348520,MATH 142A,A01,083219,Chow; Bennett,7,0,32,25
1657920348520,MATH 142A,A02,083220,Chow; Bennett,10,0,32,22
1657920348520,MATH 142A,A03,093480,Chow; Bennett,9,0,32,23
1657920348520,MATH 142A,B03,093481,Chow; Bennett,8,0,32,24
1657920348520,MATH 142A,B04,093558,Chow; Bennett,13,0,32,19
1657920348520,MATH 142A,B05,093559,Chow; Bennett,7,0,32,25
1657920354547,MATH 193A,A01,083224,Rotar; Vladimir,8,0,34,26
1657920354547,MATH 193A,A02,083225,Rotar; Vladimir,10,0,34,24
1657920354547,MATH 193A,A03,083781,Rotar; Vladimir,5,0,34,29
1657920354547,MATH 193A,A04,083782,Rotar; Vladimir,11,0,34,23
1657920354547,MATH 193A,A05,093482,Rotar; Vladimir,11,0,34,23
1657920360569,MATH 197,001,091859,McAuley; Julian John,9999,0,9999,0
1657920360569,MATH 197,002,095566,Kedlaya; Kiran S.,9997,0,9999,2
1657920360569,MATH 197,003,095567,Xiao; Ming,9999,0,9999,0
1657920360569,MATH 197,004,095571,Perols; Johan Lars,9998,0,9999,1
1657920367636,COGS 9,A01,083615,Shannon; Kyle Michael,10,0,75,65
1657920373663,COGS 11,A01,083617,Boyle; Mary E. T.,23,0,48,25
1657920379688,COGS 13,A01,083071,Bastos; Amalia Pinkusfeld,11,0,71,60
1657920385727,COGS 14A,A01,092681,Semenuks; Arturs,5,1,100,95
1657920391754,COGS 14B,A01,083073,Cheng; Tzu-Han,7,0,63,56
1657920397775,COGS 17,A01,092677,Semenuks; Arturs,7,0,81,74
1657920403805,COGS 100,A01,083619,Allen; Michael Gordon,17,0,70,53
1657920409836,COGS 101A,A01,083621,Davis; Joshua Daniel,9,0,68,59
1657920415866,COGS 101B,A01,091572,Allen; Michael Gordon,14,0,65,51
1657920421896,COGS 101C,A01,083625,Delgado; Tania,17,0,35,18
1657920427927,COGS 107A,A01,083627,Boyle; Mary E. T.,14,0,60,46
1657920433955,COGS 118A,A01,083075,Gupta; Anjum,21,0,76,55
1657920439979,CSE 3,A50,083646,Miranda; Gregory Joseph,24,0,50,26
1657920446006,CSE 8A,A50,083650,Miranda; Gregory Joseph,17,1,56,39
1657920452036,CSE 11,A01,083080,Cao; Yingjun,6,15,40,34
1657920458063,CSE 12,A01,083652,Krause-Levy; Sophia Louisa,30,1,120,90
1657920464087,CSE 15L,A01,083654,Morris; Justin Loren,9,0,50,41
1657920464087,CSE 15L,A02,083655,Morris; Justin Loren,10,0,50,40
1657920470114,CSE 20,A01,083657,Tran; Khoa Dang,39,0,80,41
1657920476142,CSE 21,A01,095574,Bach; Quang Tran,22,0,48,26
1657920482163,CSE 30,A01,083084,Eldon; John,6,0,80,74
1657920482163,CSE 30,B01,095061,Bhaskar; Nishant,9,0,50,41
1657920488187,CSE 100,A01,083659,Cao; Yingjun,5,4,70,65
1657920494214,CSE 134B,A01,083661,Powell; Thomas Allan,25,0,100,75
1657920500236,CSE 140,A01,083663,Gungor; Onat,16,0,85,69
1657920506263,CSE 140L,A01,083088,Eldon; John,23,0,100,77
1657920512289,CSE 175,A01,083665,Kumar; Rakesh,3,0,25,22
1657920518311,CSE 190,A00,092507,Dubnov; Shlomo,8,0,20,12
1657920524333,ECE 45,A01,083139,Congero; Spencer William,7,0,75,68
1657920530362,ECE 65,A50,083695,Saad; Andrew S,12,0,30,18
1657920530362,ECE 65,A51,095125,Saad; Andrew S,24,0,26,2
1657920536385,ECE 109,A01,091882,Touri; Behrouz,20,0,70,50
1657920542412,ECE 180,A00,083140,Abi Samra; Nicholas Camill,1,0,30,29
1657920542412,ECE 180,B00,083141,Abi Samra; Nicholas Camill,0,0,30,30
1657920548454,MATH 10A,A01,083735,Patchell; Gregory David,2,0,30,28
1657920548454,MATH 10A,A02,083736,Patchell; Gregory David,20,0,30,10
1657920548454,MATH 10A,A03,083737,Patchell; Gregory David,16,0,30,14
1657920554483,MATH 10B,A01,083207,Lim; Seonhee,8,0,34,26
1657920554483,MATH 10B,A02,083208,Lim; Seonhee,10,0,35,25
1657920554483,MATH 10B,A03,093472,Lim; Seonhee,7,0,34,27
1657920554483,MATH 10B,B01,083739,Sinha; Shubham,14,0,30,16
1657920560508,MATH 18,A01,083743,Cinel; Cameron Alexander,9,0,30,21
1657920560508,MATH 18,A02,083744,Cinel; Cameron Alexander,18,0,30,12
1657920560508,MATH 18,A03,083745,Cinel; Cameron Alexander,10,0,30,20
1657920560508,MATH 18,B01,083748,Rideout; David Porter,5,0,37,32
1657920560508,MATH 18,B02,083749,Rideout; David Porter,5,0,36,31
1657920560508,MATH 18,B03,083750,Rideout; David Porter,3,0,37,34
1657920560508,MATH 18,B04,083751,Rideout; David Porter,7,0,36,29
1657920560508,MATH 18,B05,093473,Rideout; David Porter,7,0,36,29
1657920560508,MATH 18,B06,093474,Rideout; David Porter,6,0,36,30
1657920566534,MATH 20A,A01,083754,Zheng; Zequn,14,0,40,26
1657920572557,MATH 20B,A01,083756,Briones; Jor-el Thomas Caparas,4,0,36,32
1657920572557,MATH 20B,A02,083757,Briones; Jor-el Thomas Caparas,1,0,36,35
1657920572557,MATH 20B,A03,093475,Briones; Jor-el Thomas Caparas,3,0,36,33
1657920578585,MATH 20C,A01,083760,Briones; Jor-el Thomas Caparas,1,0,35,34
1657920578585,MATH 20C,A02,083761,Briones; Jor-el Thomas Caparas,8,0,35,27
1657920578585,MATH 20C,A03,093476,Briones; Jor-el Thomas Caparas,0,1,36,36
1657920578585,MATH 20C,B01,083762,Bach; Quang Tran,1,0,30,29
1657920584614,MATH 20D,A01,083765,Tran; Brian Kha,5,0,30,25
1657920584614,MATH 20D,A02,083766,Tran; Brian Kha,5,0,30,25
1657920584614,MATH 20D,A03,083767,Tran; Brian Kha,6,0,30,24
1657920590640,MATH 20E,A01,083771,Ganguly; Soumya,11,0,32,21
1657920590640,MATH 20E,A02,083772,Ganguly; Soumya,7,0,32,25
1657920590640,MATH 20E,B01,083773,Ciotti; Benjamin,20,0,35,15
1657920590640,MATH 20E,B02,083774,Ciotti; Benjamin,18,0,35,17
1657920596664,MATH 103A,A01,083777,Greenfeld; Be'Eri,3,0,36,33
1657920596664,MATH 103A,A02,083778,Greenfeld; Be'Eri,5,0,36,31
1657920596664,MATH 103A,A03,093561,Greenfeld; Be'Eri,6,0,36,30
1657920596664,MATH 103A,B01,083779,Greenfeld; Be'Eri,8,0,36,28
1657920596664,MATH 103A,B02,083780,Greenfeld; Be'Eri,4,0,36,32
1657920596664,MATH 103A,B03,093562,Greenfeld; Be'Eri,3,0,36,33
1657920602687,MATH 105,A01,085443,Carter; Anne Toulson,15,0,35,20
1657920602687,MATH 105,A02,093477,Carter; Anne Toulson,20,0,35,15
1657920608711,MATH 109,A01,083213,Ganzberger; Geoffrey Michael,3,0,34,31
1657920608711,MATH 109,A02,083214,Ganzberger; Geoffrey Michael,4,0,34,30
1657920608711,MATH 109,A03,093478,Ganzberger; Geoffrey Michael,2,0,34,32
1657920608711,MATH 109,B01,083215,Ganzberger; Geoffrey Michael,2,0,32,30
1657920608711,MATH 109,B02,083216,Ganzberger; Geoffrey Michael,2,0,32,30
1657920608711,MATH 109,B03,093479,Ganzberger; Geoffrey Michael,8,0,32,24
1657920614734,MATH 142A,A01,083219,Chow; Bennett,7,0,32,25
1657920614734,MATH 142A,A02,083220,Chow; Bennett,10,0,32,22
1657920614734,MATH 142A,A03,093480,Chow; Bennett,9,0,32,23
1657920614734,MATH 142A,B03,093481,Chow; Bennett,8,0,32,24
1657920614734,MATH 142A,B04,093558,Chow; Bennett,13,0,32,19
1657920614734,MATH 142A,B05,093559,Chow; Bennett,7,0,32,25
1657920620758,MATH 193A,A01,083224,Rotar; Vladimir,8,0,34,26
1657920620758,MATH 193A,A02,083225,Rotar; Vladimir,10,0,34,24
1657920620758,MATH 193A,A03,083781,Rotar; Vladimir,5,0,34,29
1657920620758,MATH 193A,A04,083782,Rotar; Vladimir,11,0,34,23
1657920620758,MATH 193A,A05,093482,Rotar; Vladimir,11,0,34,23
1657920626786,MATH 197,001,091859,McAuley; Julian John,9999,0,9999,0
1657920626786,MATH 197,002,095566,Kedlaya; Kiran S.,9997,0,9999,2
1657920626786,MATH 197,003,095567,Xiao; Ming,9999,0,9999,0
1657920626786,MATH 197,004,095571,Perols; Johan Lars,9998,0,9999,1
1657920633858,COGS 9,A01,083615,Shannon; Kyle Michael,10,0,75,65
1657920639880,COGS 11,A01,083617,Boyle; Mary E. T.,23,0,48,25
1657920645903,COGS 13,A01,083071,Bastos; Amalia Pinkusfeld,11,0,71,60
1657920651940,COGS 14A,A01,092681,Semenuks; Arturs,5,1,100,95
1657920657968,COGS 14B,A01,083073,Cheng; Tzu-Han,7,0,63,56
1657920663994,COGS 17,A01,092677,Semenuks; Arturs,7,0,81,74
1657920670018,COGS 100,A01,083619,Allen; Michael Gordon,17,0,70,53
1657920676045,COGS 101A,A01,083621,Davis; Joshua Daniel,9,0,68,59
1657920682074,COGS 101B,A01,091572,Allen; Michael Gordon,14,0,65,51
1657920688097,COGS 101C,A01,083625,Delgado; Tania,17,0,35,18
1657920694125,COGS 107A,A01,083627,Boyle; Mary E. T.,14,0,60,46
1657920700147,COGS 118A,A01,083075,Gupta; Anjum,21,0,76,55
1657920706170,CSE 3,A50,083646,Miranda; Gregory Joseph,24,0,50,26
1657920712197,CSE 8A,A50,083650,Miranda; Gregory Joseph,17,1,56,39
1657920718220,CSE 11,A01,083080,Cao; Yingjun,6,15,40,34
1657920724243,CSE 12,A01,083652,Krause-Levy; Sophia Louisa,30,1,120,90
1657920730274,CSE 15L,A01,083654,Morris; Justin Loren,9,0,50,41
1657920730274,CSE 15L,A02,083655,Morris; Justin Loren,10,0,50,40
1657920736302,CSE 20,A01,083657,Tran; Khoa Dang,39,0,80,41
1657920742329,CSE 21,A01,095574,Bach; Quang Tran,22,0,48,26
1657920748359,CSE 30,A01,083084,Eldon; John,7,0,80,73
1657920748359,CSE 30,B01,095061,Bhaskar; Nishant,9,0,50,41
1657920754382,CSE 100,A01,083659,Cao; Yingjun,5,4,70,65
1657920760407,CSE 134B,A01,083661,Powell; Thomas Allan,25,0,100,75
1657920766439,CSE 140,A01,083663,Gungor; Onat,16,0,85,69
1657920772463,CSE 140L,A01,083088,Eldon; John,23,0,100,77
1657920778490,CSE 175,A01,083665,Kumar; Rakesh,3,0,25,22
1657920784516,CSE 190,A00,092507,Dubnov; Shlomo,8,0,20,12
1657920790539,ECE 45,A01,083139,Congero; Spencer William,7,0,75,68
1657920796562,ECE 65,A50,083695,Saad; Andrew S,12,0,30,18
1657920796562,ECE 65,A51,095125,Saad; Andrew S,24,0,26,2
1657920802599,ECE 109,A01,091882,Touri; Behrouz,20,0,70,50
1657920808624,ECE 180,A00,083140,Abi Samra; Nicholas Camill,1,0,30,29
1657920808624,ECE 180,B00,083141,Abi Samra; Nicholas Camill,0,0,30,30
1657920814646,MATH 10A,A01,083735,Patchell; Gregory David,2,0,30,28
1657920814646,MATH 10A,A02,083736,Patchell; Gregory David,20,0,30,10
1657920814646,MATH 10A,A03,083737,Patchell; Gregory David,16,0,30,14
1657920820677,MATH 10B,A01,083207,Lim; Seonhee,8,0,34,26
1657920820677,MATH 10B,A02,083208,Lim; Seonhee,10,0,35,25
1657920820677,MATH 10B,A03,093472,Lim; Seonhee,7,0,34,27
1657920820677,MATH 10B,B01,083739,Sinha; Shubham,14,0,30,16
1657920826700,MATH 18,A01,083743,Cinel; Cameron Alexander,9,0,30,21
1657920826700,MATH 18,A02,083744,Cinel; Cameron Alexander,18,0,30,12
1657920826700,MATH 18,A03,083745,Cinel; Cameron Alexander,10,0,30,20
1657920826700,MATH 18,B01,083748,Rideout; David Porter,5,0,37,32
1657920826700,MATH 18,B02,083749,Rideout; David Porter,5,0,36,31
1657920826700,MATH 18,B03,083750,Rideout; David Porter,3,0,37,34
1657920826700,MATH 18,B04,083751,Rideout; David Porter,7,0,36,29
1657920826700,MATH 18,B05,093473,Rideout; David Porter,7,0,36,29
1657920826700,MATH 18,B06,093474,Rideout; David Porter,6,0,36,30
1657920832730,MATH 20A,A01,083754,Zheng; Zequn,14,0,40,26
1657920838754,MATH 20B,A01,083756,Briones; Jor-el Thomas Caparas,4,0,36,32
1657920838754,MATH 20B,A02,083757,Briones; Jor-el Thomas Caparas,1,0,36,35
1657920838754,MATH 20B,A03,093475,Briones; Jor-el Thomas Caparas,3,0,36,33
1657920844776,MATH 20C,A01,083760,Briones; Jor-el Thomas Caparas,1,0,35,34
1657920844776,MATH 20C,A02,083761,Briones; Jor-el Thomas Caparas,8,0,35,27
1657920844776,MATH 20C,A03,093476,Briones; Jor-el Thomas Caparas,0,1,36,36
1657920844776,MATH 20C,B01,083762,Bach; Quang Tran,1,0,30,29
1657920850814,MATH 20D,A01,083765,Tran; Brian Kha,5,0,30,25
1657920850814,MATH 20D,A02,083766,Tran; Brian Kha,5,0,30,25
1657920850814,MATH 20D,A03,083767,Tran; Brian Kha,6,0,30,24
1657920856920,MATH 20E,A01,083771,Ganguly; Soumya,11,0,32,21
1657920856920,MATH 20E,A02,083772,Ganguly; Soumya,7,0,32,25
1657920856920,MATH 20E,B01,083773,Ciotti; Benjamin,20,0,35,15
1657920856920,MATH 20E,B02,083774,Ciotti; Benjamin,18,0,35,17
1657920862953,MATH 103A,A01,083777,Greenfeld; Be'Eri,3,0,36,33
1657920862953,MATH 103A,A02,083778,Greenfeld; Be'Eri,5,0,36,31
1657920862953,MATH 103A,A03,093561,Greenfeld; Be'Eri,6,0,36,30
1657920862953,MATH 103A,B01,083779,Greenfeld; Be'Eri,8,0,36,28
1657920862953,MATH 103A,B02,083780,Greenfeld; Be'Eri,4,0,36,32
1657920862953,MATH 103A,B03,093562,Greenfeld; Be'Eri,3,0,36,33
1657920868976,MATH 105,A01,085443,Carter; Anne Toulson,15,0,35,20
1657920868976,MATH 105,A02,093477,Carter; Anne Toulson,20,0,35,15
1657920875005,MATH 109,A01,083213,Ganzberger; Geoffrey Michael,3,0,34,31
1657920875005,MATH 109,A02,083214,Ganzberger; Geoffrey Michael,4,0,34,30
1657920875005,MATH 109,A03,093478,Ganzberger; Geoffrey Michael,2,0,34,32
1657920875005,MATH 109,B01,083215,Ganzberger; Geoffrey Michael,2,0,32,30
1657920875005,MATH 109,B02,083216,Ganzberger; Geoffrey Michael,2,0,32,30
1657920875005,MATH 109,B03,093479,Ganzberger; Geoffrey Michael,8,0,32,24
1657920881034,MATH 142A,A01,083219,Chow; Bennett,7,0,32,25
1657920881034,MATH 142A,A02,083220,Chow; Bennett,10,0,32,22
1657920881034,MATH 142A,A03,093480,Chow; Bennett,9,0,32,23
1657920881034,MATH 142A,B03,093481,Chow; Bennett,8,0,32,24
1657920881034,MATH 142A,B04,093558,Chow; Bennett,13,0,32,19
1657920881034,MATH 142A,B05,093559,Chow; Bennett,7,0,32,25
1657920887068,MATH 193A,A01,083224,Rotar; Vladimir,8,0,34,26
1657920887068,MATH 193A,A02,083225,Rotar; Vladimir,10,0,34,24
1657920887068,MATH 193A,A03,083781,Rotar; Vladimir,5,0,34,29
1657920887068,MATH 193A,A04,083782,Rotar; Vladimir,11,0,34,23
1657920887068,MATH 193A,A05,093482,Rotar; Vladimir,11,0,34,23
1657920893103,MATH 197,001,091859,McAuley; Julian John,9999,0,9999,0
1657920893103,MATH 197,002,095566,Kedlaya; Kiran S.,9997,0,9999,2
1657920893103,MATH 197,003,095567,Xiao; Ming,9999,0,9999,0
1657920893103,MATH 197,004,095571,Perols; Johan Lars,9998,0,9999,1
1657920900154,COGS 9,A01,083615,Shannon; Kyle Michael,10,0,75,65
1657920906179,COGS 11,A01,083617,Boyle; Mary E. T.,23,0,48,25
1657920912201,COGS 13,A01,083071,Bastos; Amalia Pinkusfeld,11,0,71,60
1657920918226,COGS 14A,A01,092681,Semenuks; Arturs,5,1,100,95
1657920924252,COGS 14B,A01,083073,Cheng; Tzu-Han,7,0,63,56
1657920930275,COGS 17,A01,092677,Semenuks; Arturs,7,0,81,74
1657920936302,COGS 100,A01,083619,Allen; Michael Gordon,17,0,70,53
1657920942332,COGS 101A,A01,083621,Davis; Joshua Daniel,9,0,68,59
1657920948354,COGS 101B,A01,091572,Allen; Michael Gordon,14,0,65,51
1657920954381,COGS 101C,A01,083625,Delgado; Tania,17,0,35,18
1657920960406,COGS 107A,A01,083627,Boyle; Mary E. T.,14,0,60,46
1657920966429,COGS 118A,A01,083075,Gupta; Anjum,21,0,76,55
1657920972455,CSE 3,A50,083646,Miranda; Gregory Joseph,24,0,50,26
1657920978478,CSE 8A,A50,083650,Miranda; Gregory Joseph,17,1,56,39
1657920984509,CSE 11,A01,083080,Cao; Yingjun,6,15,40,34
1657920990538,CSE 12,A01,083652,Krause-Levy; Sophia Louisa,30,1,120,90
1657920996562,CSE 15L,A01,083654,Morris; Justin Loren,9,0,50,41
1657920996562,CSE 15L,A02,083655,Morris; Justin Loren,10,0,50,40
1657921002585,CSE 20,A01,083657,Tran; Khoa Dang,39,0,80,41
1657921008608,CSE 21,A01,095574,Bach; Quang Tran,22,0,48,26
1657921014632,CSE 30,A01,083084,Eldon; John,7,0,80,73
1657921014632,CSE 30,B01,095061,Bhaskar; Nishant,9,0,50,41
1657921020658,CSE 100,A01,083659,Cao; Yingjun,5,4,70,65
1657921026690,CSE 134B,A01,083661,Powell; Thomas Allan,25,0,100,75
1657921032712,CSE 140,A01,083663,Gungor; Onat,16,0,85,69
1657921038736,CSE 140L,A01,083088,Eldon; John,23,0,100,77
1657921044762,CSE 175,A01,083665,Kumar; Rakesh,3,0,25,22
1657921050791,CSE 190,A00,092507,Dubnov; Shlomo,8,0,20,12
1657921056818,ECE 45,A01,083139,Congero; Spencer William,7,0,75,68
1657921062845,ECE 65,A50,083695,Saad; Andrew S,12,0,30,18
1657921062845,ECE 65,A51,095125,Saad; Andrew S,24,0,26,2
1657921068873,ECE 109,A01,091882,Touri; Behrouz,20,0,70,50
1657921074898,ECE 180,A00,083140,Abi Samra; Nicholas Camill,1,0,30,29
1657921074898,ECE 180,B00,083141,Abi Samra; Nicholas Camill,0,0,30,30
1657921080923,MATH 10A,A01,083735,Patchell; Gregory David,2,0,30,28
1657921080923,MATH 10A,A02,083736,Patchell; Gregory David,20,0,30,10
1657921080923,MATH 10A,A03,083737,Patchell; Gregory David,16,0,30,14
1657921086951,MATH 10B,A01,083207,Lim; Seonhee,8,0,34,26
1657921086951,MATH 10B,A02,083208,Lim; Seonhee,10,0,35,25
1657921086951,MATH 10B,A03,093472,Lim; Seonhee,7,0,34,27
1657921086951,MATH 10B,B01,083739,Sinha; Shubham,14,0,30,16
1657921092978,MATH 18,A01,083743,Cinel; Cameron Alexander,9,0,30,21
1657921092978,MATH 18,A02,083744,Cinel; Cameron Alexander,18,0,30,12
1657921092978,MATH 18,A03,083745,Cinel; Cameron Alexander,10,0,30,20
1657921092978,MATH 18,B01,083748,Rideout; David Porter,5,0,37,32
1657921092978,MATH 18,B02,083749,Rideout; David Porter,5,0,36,31
1657921092978,MATH 18,B03,083750,Rideout; David Porter,3,0,37,34
1657921092978,MATH 18,B04,083751,Rideout; David Porter,7,0,36,29
1657921092978,MATH 18,B05,093473,Rideout; David Porter,7,0,36,29
1657921092978,MATH 18,B06,093474,Rideout; David Porter,6,0,36,30
1657921099019,MATH 20A,A01,083754,Zheng; Zequn,14,0,40,26
1657921105043,MATH 20B,A01,083756,Briones; Jor-el Thomas Caparas,4,0,36,32
1657921105043,MATH 20B,A02,083757,Briones; Jor-el Thomas Caparas,1,0,36,35
1657921105043,MATH 20B,A03,093475,Briones; Jor-el Thomas Caparas,3,0,36,33
1657921111075,MATH 20C,A01,083760,Briones; Jor-el Thomas Caparas,1,0,35,34
1657921111075,MATH 20C,A02,083761,Briones; Jor-el Thomas Caparas,8,0,35,27
1657921111075,MATH 20C,A03,093476,Briones; Jor-el Thomas Caparas,0,1,36,36
1657921111075,MATH 20C,B01,083762,Bach; Quang Tran,1,0,30,29
1657921117104,MATH 20D,A01,083765,Tran; Brian Kha,5,0,30,25
1657921117104,MATH 20D,A02,083766,Tran; Brian Kha,5,0,30,25
1657921117104,MATH 20D,A03,083767,Tran; Brian Kha,6,0,30,24
1657921123129,MATH 20E,A01,083771,Ganguly; Soumya,11,0,32,21
1657921123129,MATH 20E,A02,083772,Ganguly; Soumya,7,0,32,25
1657921123129,MATH 20E,B01,083773,Ciotti; Benjamin,20,0,35,15
1657921123129,MATH 20E,B02,083774,Ciotti; Benjamin,18,0,35,17
1657921129158,MATH 103A,A01,083777,Greenfeld; Be'Eri,3,0,36,33
1657921129158,MATH 103A,A02,083778,Greenfeld; Be'Eri,5,0,36,31
1657921129158,MATH 103A,A03,093561,Greenfeld; Be'Eri,6,0,36,30
1657921129158,MATH 103A,B01,083779,Greenfeld; Be'Eri,8,0,36,28
1657921129158,MATH 103A,B02,083780,Greenfeld; Be'Eri,4,0,36,32
1657921129158,MATH 103A,B03,093562,Greenfeld; Be'Eri,3,0,36,33
1657921135187,MATH 105,A01,085443,Carter; Anne Toulson,15,0,35,20
1657921135187,MATH 105,A02,093477,Carter; Anne Toulson,20,0,35,15
1657921141211,MATH 109,A01,083213,Ganzberger; Geoffrey Michael,3,0,34,31
1657921141211,MATH 109,A02,083214,Ganzberger; Geoffrey Michael,4,0,34,30
1657921141211,MATH 109,A03,093478,Ganzberger; Geoffrey Michael,2,0,34,32
1657921141211,MATH 109,B01,083215,Ganzberger; Geoffrey Michael,2,0,32,30
1657921141211,MATH 109,B02,083216,Ganzberger; Geoffrey Michael,2,0,32,30
1657921141211,MATH 109,B03,093479,Ganzberger; Geoffrey Michael,8,0,32,24
1657921147242,MATH 142A,A01,083219,Chow; Bennett,7,0,32,25
1657921147242,MATH 142A,A02,083220,Chow; Bennett,10,0,32,22
1657921147242,MATH 142A,A03,093480,Chow; Bennett,9,0,32,23
1657921147242,MATH 142A,B03,093481,Chow; Bennett,8,0,32,24
1657921147242,MATH 142A,B04,093558,Chow; Bennett,13,0,32,19
1657921147242,MATH 142A,B05,093559,Chow; Bennett,7,0,32,25
1657921153280,MATH 193A,A01,083224,Rotar; Vladimir,8,0,34,26
1657921153280,MATH 193A,A02,083225,Rotar; Vladimir,10,0,34,24
1657921153280,MATH 193A,A03,083781,Rotar; Vladimir,5,0,34,29
1657921153280,MATH 193A,A04,083782,Rotar; Vladimir,11,0,34,23
1657921153280,MATH 193A,A05,093482,Rotar; Vladimir,11,0,34,23
1657921159303,MATH 197,001,091859,McAuley; Julian John,9999,0,9999,0
1657921159303,MATH 197,002,095566,Kedlaya; Kiran S.,9997,0,9999,2
1657921159303,MATH 197,003,095567,Xiao; Ming,9999,0,9999,0
1657921159303,MATH 197,004,095571,Perols; Johan Lars,9998,0,9999,1
1657921166362,COGS 9,A01,083615,Shannon; Kyle Michael,10,0,75,65
1657921172388,COGS 11,A01,083617,Boyle; Mary E. T.,23,0,48,25
1657921178420,COGS 13,A01,083071,Bastos; Amalia Pinkusfeld,11,0,71,60
1657921184442,COGS 14A,A01,092681,Semenuks; Arturs,5,1,100,95
1657921190469,COGS 14B,A01,083073,Cheng; Tzu-Han,7,0,63,56
1657921196492,COGS 17,A01,092677,Semenuks; Arturs,7,0,81,74
1657921202519,COGS 100,A01,083619,Allen; Michael Gordon,17,0,70,53
1657921208543,COGS 101A,A01,083621,Davis; Joshua Daniel,9,0,68,59
1657921214570,COGS 101B,A01,091572,Allen; Michael Gordon,14,0,65,51
1657921220594,COGS 101C,A01,083625,Delgado; Tania,17,0,35,18
1657921226622,COGS 107A,A01,083627,Boyle; Mary E. T.,14,0,60,46
1657921232645,COGS 118A,A01,083075,Gupta; Anjum,21,0,76,55
1657921238687,CSE 3,A50,083646,Miranda; Gregory Joseph,24,0,50,26
1657921244710,CSE 8A,A50,083650,Miranda; Gregory Joseph,17,1,56,39
1657921250735,CSE 11,A01,083080,Cao; Yingjun,6,15,40,34
1657921256762,CSE 12,A01,083652,Krause-Levy; Sophia Louisa,30,1,120,90
1657921262798,CSE 15L,A01,083654,Morris; Justin Loren,9,0,50,41
1657921262798,CSE 15L,A02,083655,Morris; Justin Loren,10,0,50,40
1657921268821,CSE 20,A01,083657,Tran; Khoa Dang,39,0,80,41
1657921274844,CSE 21,A01,095574,Bach; Quang Tran,22,0,48,26
1657921280892,CSE 30,A01,083084,Eldon; John,7,0,80,73
1657921280892,CSE 30,B01,095061,Bhaskar; Nishant,9,0,50,41
1657921286924,CSE 100,A01,083659,Cao; Yingjun,5,4,70,65
1657921292955,CSE 134B,A01,083661,Powell; Thomas Allan,25,0,100,75
1657921298979,CSE 140,A01,083663,Gungor; Onat,16,0,85,69
1657921305003,CSE 140L,A01,083088,Eldon; John,23,0,100,77
1657921311032,CSE 175,A01,083665,Kumar; Rakesh,3,0,25,22
1657921317056,CSE 190,A00,092507,Dubnov; Shlomo,8,0,20,12
1657921323083,ECE 45,A01,083139,Congero; Spencer William,7,0,75,68
1657921329108,ECE 65,A50,083695,Saad; Andrew S,12,0,30,18
1657921329108,ECE 65,A51,095125,Saad; Andrew S,24,0,26,2
1657921335135,ECE 109,A01,091882,Touri; Behrouz,20,0,70,50
1657921341166,ECE 180,A00,083140,Abi Samra; Nicholas Camill,1,0,30,29
1657921341166,ECE 180,B00,083141,Abi Samra; Nicholas Camill,0,0,30,30
1657921347193,MATH 10A,A01,083735,Patchell; Gregory David,2,0,30,28
1657921347193,MATH 10A,A02,083736,Patchell; Gregory David,20,0,30,10
1657921347193,MATH 10A,A03,083737,Patchell; Gregory David,16,0,30,14
1657921353217,MATH 10B,A01,083207,Lim; Seonhee,8,0,34,26
1657921353217,MATH 10B,A02,083208,Lim; Seonhee,10,0,35,25
1657921353217,MATH 10B,A03,093472,Lim; Seonhee,7,0,34,27
1657921353217,MATH 10B,B01,083739,Sinha; Shubham,14,0,30,16
1657921359248,MATH 18,A01,083743,Cinel; Cameron Alexander,9,0,30,21
1657921359248,MATH 18,A02,083744,Cinel; Cameron Alexander,18,0,30,12
1657921359248,MATH 18,A03,083745,Cinel; Cameron Alexander,10,0,30,20
1657921359248,MATH 18,B01,083748,Rideout; David Porter,5,0,37,32
1657921359248,MATH 18,B02,083749,Rideout; David Porter,5,0,36,31
1657921359248,MATH 18,B03,083750,Rideout; David Porter,3,0,37,34
1657921359248,MATH 18,B04,083751,Rideout; David Porter,7,0,36,29
1657921359248,MATH 18,B05,093473,Rideout; David Porter,7,0,36,29
1657921359248,MATH 18,B06,093474,Rideout; David Porter,6,0,36,30
1657921365276,MATH 20A,A01,083754,Zheng; Zequn,14,0,40,26
1657921371298,MATH 20B,A01,083756,Briones; Jor-el Thomas Caparas,4,0,36,32
1657921371298,MATH 20B,A02,083757,Briones; Jor-el Thomas Caparas,1,0,36,35
1657921371298,MATH 20B,A03,093475,Briones; Jor-el Thomas Caparas,3,0,36,33
1657921377320,MATH 20C,A01,083760,Briones; Jor-el Thomas Caparas,1,0,35,34
1657921377320,MATH 20C,A02,083761,Briones; Jor-el Thomas Caparas,8,0,35,27
1657921377320,MATH 20C,A03,093476,Briones; Jor-el Thomas Caparas,0,1,36,36
1657921377320,MATH 20C,B01,083762,Bach; Quang Tran,1,0,30,29
1657921383343,MATH 20D,A01,083765,Tran; Brian Kha,5,0,30,25
1657921383343,MATH 20D,A02,083766,Tran; Brian Kha,5,0,30,25
1657921383343,MATH 20D,A03,083767,Tran; Brian Kha,6,0,30,24
1657921389366,MATH 20E,A01,083771,Ganguly; Soumya,11,0,32,21
1657921389366,MATH 20E,A02,083772,Ganguly; Soumya,7,0,32,25
1657921389366,MATH 20E,B01,083773,Ciotti; Benjamin,20,0,35,15
1657921389366,MATH 20E,B02,083774,Ciotti; Benjamin,18,0,35,17
1657921395407,MATH 103A,A01,083777,Greenfeld; Be'Eri,3,0,36,33
1657921395407,MATH 103A,A02,083778,Greenfeld; Be'Eri,5,0,36,31
1657921395407,MATH 103A,A03,093561,Greenfeld; Be'Eri,6,0,36,30
1657921395407,MATH 103A,B01,083779,Greenfeld; Be'Eri,8,0,36,28
1657921395407,MATH 103A,B02,083780,Greenfeld; Be'Eri,4,0,36,32
1657921395407,MATH 103A,B03,093562,Greenfeld; Be'Eri,3,0,36,33
1657921401436,MATH 105,A01,085443,Carter; Anne Toulson,15,0,35,20
1657921401436,MATH 105,A02,093477,Carter; Anne Toulson,20,0,35,15
1657921407464,MATH 109,A01,083213,Ganzberger; Geoffrey Michael,3,0,34,31
1657921407464,MATH 109,A02,083214,Ganzberger; Geoffrey Michael,4,0,34,30
1657921407464,MATH 109,A03,093478,Ganzberger; Geoffrey Michael,2,0,34,32
1657921407464,MATH 109,B01,083215,Ganzberger; Geoffrey Michael,2,0,32,30
1657921407464,MATH 109,B02,083216,Ganzberger; Geoffrey Michael,2,0,32,30
1657921407464,MATH 109,B03,093479,Ganzberger; Geoffrey Michael,8,0,32,24
1657921413488,MATH 142A,A01,083219,Chow; Bennett,7,0,32,25
1657921413488,MATH 142A,A02,083220,Chow; Bennett,10,0,32,22
1657921413488,MATH 142A,A03,093480,Chow; Bennett,9,0,32,23
1657921413488,MATH 142A,B03,093481,Chow; Bennett,8,0,32,24
1657921413488,MATH 142A,B04,093558,Chow; Bennett,13,0,32,19
1657921413488,MATH 142A,B05,093559,Chow; Bennett,7,0,32,25
1657921419512,MATH 193A,A01,083224,Rotar; Vladimir,8,0,34,26
1657921419512,MATH 193A,A02,083225,Rotar; Vladimir,10,0,34,24
1657921419512,MATH 193A,A03,083781,Rotar; Vladimir,5,0,34,29
1657921419512,MATH 193A,A04,083782,Rotar; Vladimir,11,0,34,23
1657921419512,MATH 193A,A05,093482,Rotar; Vladimir,11,0,34,23
1657921425538,MATH 197,001,091859,McAuley; Julian John,9999,0,9999,0
1657921425538,MATH 197,002,095566,Kedlaya; Kiran S.,9997,0,9999,2
1657921425538,MATH 197,003,095567,Xiao; Ming,9999,0,9999,0
1657921425538,MATH 197,004,095571,Perols; Johan Lars,9998,0,9999,1
1657921432609,COGS 9,A01,083615,Shannon; Kyle Michael,10,0,75,65
1657921438630,COGS 11,A01,083617,Boyle; Mary E. T.,23,0,48,25
1657921444655,COGS 13,A01,083071,Bastos; Amalia Pinkusfeld,11,0,71,60
1657921450768,COGS 14A,A01,092681,Semenuks; Arturs,5,1,100,95
1657921456794,COGS 14B,A01,083073,Cheng; Tzu-Han,7,0,63,56
1657921462830,COGS 17,A01,092677,Semenuks; Arturs,7,0,81,74
1657921468855,COGS 100,A01,083619,Allen; Michael Gordon,17,0,70,53
1657921474888,COGS 101A,A01,083621,Davis; Joshua Daniel,9,0,68,59
1657921480910,COGS 101B,A01,091572,Allen; Michael Gordon,14,0,65,51
1657921486935,COGS 101C,A01,083625,Delgado; Tania,17,0,35,18
1657921492958,COGS 107A,A01,083627,Boyle; Mary E. T.,14,0,60,46
1657921498982,COGS 118A,A01,083075,Gupta; Anjum,21,0,76,55
1657921505008,CSE 3,A50,083646,Miranda; Gregory Joseph,24,0,50,26
1657921511043,CSE 8A,A50,083650,Miranda; Gregory Joseph,17,1,56,39
1657921517066,CSE 11,A01,083080,Cao; Yingjun,6,15,40,34
1657921523089,CSE 12,A01,083652,Krause-Levy; Sophia Louisa,30,1,120,90
1657921529112,CSE 15L,A01,083654,Morris; Justin Loren,9,0,50,41
1657921529112,CSE 15L,A02,083655,Morris; Justin Loren,10,0,50,40
1657921535142,CSE 20,A01,083657,Tran; Khoa Dang,39,0,80,41
1657921541179,CSE 21,A01,095574,Bach; Quang Tran,22,0,48,26
1657921547205,CSE 30,A01,083084,Eldon; John,7,0,80,73
1657921547205,CSE 30,B01,095061,Bhaskar; Nishant,9,0,50,41
1657921553240,CSE 100,A01,083659,Cao; Yingjun,5,4,70,65
1657921559273,CSE 134B,A01,083661,Powell; Thomas Allan,25,0,100,75
1657921565300,CSE 140,A01,083663,Gungor; Onat,16,0,85,69
1657921571324,CSE 140L,A01,083088,Eldon; John,23,0,100,77
1657921577347,CSE 175,A01,083665,Kumar; Rakesh,3,0,25,22
1657921583392,CSE 190,A00,092507,Dubnov; Shlomo,8,0,20,12
1657921589416,ECE 45,A01,083139,Congero; Spencer William,7,0,75,68
1657921595441,ECE 65,A50,083695,Saad; Andrew S,12,0,30,18
1657921595441,ECE 65,A51,095125,Saad; Andrew S,24,0,26,2
1657921601463,ECE 109,A01,091882,Touri; Behrouz,20,0,70,50
1657921607486,ECE 180,A00,083140,Abi Samra; Nicholas Camill,1,0,30,29
1657921607486,ECE 180,B00,083141,Abi Samra; Nicholas Camill,0,0,30,30
1657921613513,MATH 10A,A01,083735,Patchell; Gregory David,2,0,30,28
1657921613513,MATH 10A,A02,083736,Patchell; Gregory David,20,0,30,10
1657921613513,MATH 10A,A03,083737,Patchell; Gregory David,16,0,30,14
1657921619550,MATH 10B,A01,083207,Lim; Seonhee,8,0,34,26
1657921619550,MATH 10B,A02,083208,Lim; Seonhee,10,0,35,25
1657921619550,MATH 10B,A03,093472,Lim; Seonhee,7,0,34,27
1657921619550,MATH 10B,B01,083739,Sinha; Shubham,14,0,30,16
1657921625582,MATH 18,A01,083743,Cinel; Cameron Alexander,9,0,30,21
1657921625582,MATH 18,A02,083744,Cinel; Cameron Alexander,18,0,30,12
1657921625582,MATH 18,A03,083745,Cinel; Cameron Alexander,10,0,30,20
1657921625582,MATH 18,B01,083748,Rideout; David Porter,5,0,37,32
1657921625582,MATH 18,B02,083749,Rideout; David Porter,5,0,36,31
1657921625582,MATH 18,B03,083750,Rideout; David Porter,3,0,37,34
1657921625582,MATH 18,B04,083751,Rideout; David Porter,7,0,36,29
1657921625582,MATH 18,B05,093473,Rideout; David Porter,7,0,36,29
1657921625582,MATH 18,B06,093474,Rideout; David Porter,6,0,36,30
1657921631613,MATH 20A,A01,083754,Zheng; Zequn,14,0,40,26
1657921637648,MATH 20B,A01,083756,Briones; Jor-el Thomas Caparas,4,0,36,32
1657921637648,MATH 20B,A02,083757,Briones; Jor-el Thomas Caparas,1,0,36,35
1657921637648,MATH 20B,A03,093475,Briones; Jor-el Thomas Caparas,3,0,36,33
1657921643675,MATH 20C,A01,083760,Briones; Jor-el Thomas Caparas,1,0,35,34
1657921643675,MATH 20C,A02,083761,Briones; Jor-el Thomas Caparas,8,0,35,27
1657921643675,MATH 20C,A03,093476,Briones; Jor-el Thomas Caparas,0,1,36,36
1657921643675,MATH 20C,B01,083762,Bach; Quang Tran,1,0,30,29
1657921649697,MATH 20D,A01,083765,Tran; Brian Kha,5,0,30,25
1657921649697,MATH 20D,A02,083766,Tran; Brian Kha,5,0,30,25
1657921649697,MATH 20D,A03,083767,Tran; Brian Kha,6,0,30,24
1657921655725,MATH 20E,A01,083771,Ganguly; Soumya,11,0,32,21
1657921655725,MATH 20E,A02,083772,Ganguly; Soumya,7,0,32,25
1657921655725,MATH 20E,B01,083773,Ciotti; Benjamin,20,0,35,15
1657921655725,MATH 20E,B02,083774,Ciotti; Benjamin,18,0,35,17
1657921661759,MATH 103A,A01,083777,Greenfeld; Be'Eri,3,0,36,33
1657921661759,MATH 103A,A02,083778,Greenfeld; Be'Eri,5,0,36,31
1657921661759,MATH 103A,A03,093561,Greenfeld; Be'Eri,6,0,36,30
1657921661759,MATH 103A,B01,083779,Greenfeld; Be'Eri,8,0,36,28
1657921661759,MATH 103A,B02,083780,Greenfeld; Be'Eri,4,0,36,32
1657921661759,MATH 103A,B03,093562,Greenfeld; Be'Eri,3,0,36,33
1657921667781,MATH 105,A01,085443,Carter; Anne Toulson,15,0,35,20
1657921667781,MATH 105,A02,093477,Carter; Anne Toulson,20,0,35,15
1657921673808,MATH 109,A01,083213,Ganzberger; Geoffrey Michael,3,0,34,31
1657921673808,MATH 109,A02,083214,Ganzberger; Geoffrey Michael,4,0,34,30
1657921673808,MATH 109,A03,093478,Ganzberger; Geoffrey Michael,2,0,34,32
1657921673808,MATH 109,B01,083215,Ganzberger; Geoffrey Michael,2,0,32,30
1657921673808,MATH 109,B02,083216,Ganzberger; Geoffrey Michael,2,0,32,30
1657921673808,MATH 109,B03,093479,Ganzberger; Geoffrey Michael,8,0,32,24
1657921679831,MATH 142A,A01,083219,Chow; Bennett,7,0,32,25
1657921679831,MATH 142A,A02,083220,Chow; Bennett,10,0,32,22
1657921679831,MATH 142A,A03,093480,Chow; Bennett,9,0,32,23
1657921679831,MATH 142A,B03,093481,Chow; Bennett,8,0,32,24
1657921679831,MATH 142A,B04,093558,Chow; Bennett,13,0,32,19
1657921679831,MATH 142A,B05,093559,Chow; Bennett,7,0,32,25
1657921685853,MATH 193A,A01,083224,Rotar; Vladimir,8,0,34,26
1657921685853,MATH 193A,A02,083225,Rotar; Vladimir,10,0,34,24
1657921685853,MATH 193A,A03,083781,Rotar; Vladimir,5,0,34,29
1657921685853,MATH 193A,A04,083782,Rotar; Vladimir,11,0,34,23
1657921685853,MATH 193A,A05,093482,Rotar; Vladimir,11,0,34,23
1657921691877,MATH 197,001,091859,McAuley; Julian John,9999,0,9999,0
1657921691877,MATH 197,002,095566,Kedlaya; Kiran S.,9997,0,9999,2
1657921691877,MATH 197,003,095567,Xiao; Ming,9999,0,9999,0
1657921691877,MATH 197,004,095571,Perols; Johan Lars,9998,0,9999,1
1657921698944,COGS 9,A01,083615,Shannon; Kyle Michael,10,0,75,65
1657921704967,COGS 11,A01,083617,Boyle; Mary E. T.,23,0,48,25
1657921710998,COGS 13,A01,083071,Bastos; Amalia Pinkusfeld,12,0,71,59
1657921717021,COGS 14A,A01,092681,Semenuks; Arturs,5,1,100,95
1657921723049,COGS 14B,A01,083073,Cheng; Tzu-Han,7,0,63,56
1657921729081,COGS 17,A01,092677,Semenuks; Arturs,7,0,81,74
1657921735105,COGS 100,A01,083619,Allen; Michael Gordon,17,0,70,53
1657921741130,COGS 101A,A01,083621,Davis; Joshua Daniel,9,0,68,59
1657921747154,COGS 101B,A01,091572,Allen; Michael Gordon,14,0,65,51
1657921753180,COGS 101C,A01,083625,Delgado; Tania,17,0,35,18
1657921759204,COGS 107A,A01,083627,Boyle; Mary E. T.,14,0,60,46
1657921765227,COGS 118A,A01,083075,Gupta; Anjum,21,0,76,55
1657921771262,CSE 3,A50,083646,Miranda; Gregory Joseph,24,0,50,26
1657921777286,CSE 8A,A50,083650,Miranda; Gregory Joseph,17,1,56,39
1657921783319,CSE 11,A01,083080,Cao; Yingjun,6,15,40,34
1657921789353,CSE 12,A01,083652,Krause-Levy; Sophia Louisa,30,1,120,90
1657921795377,CSE 15L,A01,083654,Morris; Justin Loren,9,0,50,41
1657921795377,CSE 15L,A02,083655,Morris; Justin Loren,10,0,50,40
1657921801404,CSE 20,A01,083657,Tran; Khoa Dang,39,0,80,41
1657921807431,CSE 21,A01,095574,Bach; Quang Tran,22,0,48,26
1657921813457,CSE 30,A01,083084,Eldon; John,7,0,80,73
1657921813457,CSE 30,B01,095061,Bhaskar; Nishant,9,0,50,41
1657921819482,CSE 100,A01,083659,Cao; Yingjun,5,4,70,65
1657921825505,CSE 134B,A01,083661,Powell; Thomas Allan,25,0,100,75
1657921831528,CSE 140,A01,083663,Gungor; Onat,16,0,85,69
1657921837564,CSE 140L,A01,083088,Eldon; John,23,0,100,77
1657921843593,CSE 175,A01,083665,Kumar; Rakesh,3,0,25,22
1657921849615,CSE 190,A00,092507,Dubnov; Shlomo,8,0,20,12
1657921855637,ECE 45,A01,083139,Congero; Spencer William,7,0,75,68
1657921861663,ECE 65,A50,083695,Saad; Andrew S,12,0,30,18
1657921861663,ECE 65,A51,095125,Saad; Andrew S,24,0,26,2
1657921867686,ECE 109,A01,091882,Touri; Behrouz,20,0,70,50
1657921873713,ECE 180,A00,083140,Abi Samra; Nicholas Camill,1,0,30,29
1657921873713,ECE 180,B00,083141,Abi Samra; Nicholas Camill,0,0,30,30
1657921879741,MATH 10A,A01,083735,Patchell; Gregory David,2,0,30,28
1657921879741,MATH 10A,A02,083736,Patchell; Gregory David,20,0,30,10
1657921879741,MATH 10A,A03,083737,Patchell; Gregory David,16,0,30,14
1657921885767,MATH 10B,A01,083207,Lim; Seonhee,8,0,34,26
1657921885767,MATH 10B,A02,083208,Lim; Seonhee,10,0,35,25
1657921885767,MATH 10B,A03,093472,Lim; Seonhee,7,0,34,27
1657921885767,MATH 10B,B01,083739,Sinha; Shubham,14,0,30,16
1657921891790,MATH 18,A01,083743,Cinel; Cameron Alexander,9,0,30,21
1657921891790,MATH 18,A02,083744,Cinel; Cameron Alexander,18,0,30,12
1657921891790,MATH 18,A03,083745,Cinel; Cameron Alexander,10,0,30,20
1657921891790,MATH 18,B01,083748,Rideout; David Porter,5,0,37,32
1657921891790,MATH 18,B02,083749,Rideout; David Porter,5,0,36,31
1657921891790,MATH 18,B03,083750,Rideout; David Porter,3,0,37,34
1657921891790,MATH 18,B04,083751,Rideout; David Porter,7,0,36,29
1657921891790,MATH 18,B05,093473,Rideout; David Porter,7,0,36,29
1657921891790,MATH 18,B06,093474,Rideout; David Porter,6,0,36,30
1657921897827,MATH 20A,A01,083754,Zheng; Zequn,14,0,40,26
1657921903853,MATH 20B,A01,083756,Briones; Jor-el Thomas Caparas,4,0,36,32
1657921903853,MATH 20B,A02,083757,Briones; Jor-el Thomas Caparas,1,0,36,35
1657921903853,MATH 20B,A03,093475,Briones; Jor-el Thomas Caparas,3,0,36,33
1657921909875,MATH 20C,A01,083760,Briones; Jor-el Thomas Caparas,1,0,35,34
1657921909875,MATH 20C,A02,083761,Briones; Jor-el Thomas Caparas,8,0,35,27
1657921909875,MATH 20C,A03,093476,Briones; Jor-el Thomas Caparas,0,1,36,36
1657921909875,MATH 20C,B01,083762,Bach; Quang Tran,1,0,30,29
1657921915899,MATH 20D,A01,083765,Tran; Brian Kha,5,0,30,25
1657921915899,MATH 20D,A02,083766,Tran; Brian Kha,5,0,30,25
1657921915899,MATH 20D,A03,083767,Tran; Brian Kha,6,0,30,24
1657921921926,MATH 20E,A01,083771,Ganguly; Soumya,11,0,32,21
1657921921926,MATH 20E,A02,083772,Ganguly; Soumya,7,0,32,25
1657921921926,MATH 20E,B01,083773,Ciotti; Benjamin,20,0,35,15
1657921921926,MATH 20E,B02,083774,Ciotti; Benjamin,18,0,35,17
1657921927963,MATH 103A,A01,083777,Greenfeld; Be'Eri,3,0,36,33
1657921927963,MATH 103A,A02,083778,Greenfeld; Be'Eri,5,0,36,31
1657921927963,MATH 103A,A03,093561,Greenfeld; Be'Eri,6,0,36,30
1657921927963,MATH 103A,B01,083779,Greenfeld; Be'Eri,8,0,36,28
1657921927963,MATH 103A,B02,083780,Greenfeld; Be'Eri,4,0,36,32
1657921927963,MATH 103A,B03,093562,Greenfeld; Be'Eri,3,0,36,33
1657921933985,MATH 105,A01,085443,Carter; Anne Toulson,15,0,35,20
1657921933985,MATH 105,A02,093477,Carter; Anne Toulson,20,0,35,15
1657921940007,MATH 109,A01,083213,Ganzberger; Geoffrey Michael,3,0,34,31
1657921940007,MATH 109,A02,083214,Ganzberger; Geoffrey Michael,4,0,34,30
1657921940007,MATH 109,A03,093478,Ganzberger; Geoffrey Michael,2,0,34,32
1657921940007,MATH 109,B01,083215,Ganzberger; Geoffrey Michael,2,0,32,30
1657921940007,MATH 109,B02,083216,Ganzberger; Geoffrey Michael,2,0,32,30
1657921940007,MATH 109,B03,093479,Ganzberger; Geoffrey Michael,8,0,32,24
1657921946032,MATH 142A,A01,083219,Chow; Bennett,7,0,32,25
1657921946032,MATH 142A,A02,083220,Chow; Bennett,10,0,32,22
1657921946032,MATH 142A,A03,093480,Chow; Bennett,9,0,32,23
1657921946032,MATH 142A,B03,093481,Chow; Bennett,8,0,32,24
1657921946032,MATH 142A,B04,093558,Chow; Bennett,13,0,32,19
1657921946032,MATH 142A,B05,093559,Chow; Bennett,7,0,32,25
1657921952062,MATH 193A,A01,083224,Rotar; Vladimir,8,0,34,26
1657921952062,MATH 193A,A02,083225,Rotar; Vladimir,10,0,34,24
1657921952062,MATH 193A,A03,083781,Rotar; Vladimir,5,0,34,29
1657921952062,MATH 193A,A04,083782,Rotar; Vladimir,11,0,34,23
1657921952062,MATH 193A,A05,093482,Rotar; Vladimir,11,0,34,23
1657921958096,MATH 197,001,091859,McAuley; Julian John,9999,0,9999,0
1657921958096,MATH 197,002,095566,Kedlaya; Kiran S.,9997,0,9999,2
1657921958096,MATH 197,003,095567,Xiao; Ming,9999,0,9999,0
1657921958096,MATH 197,004,095571,Perols; Johan Lars,9998,0,9999,1
1657921965159,COGS 9,A01,083615,Shannon; Kyle Michael,10,0,75,65
1657921971181,COGS 11,A01,083617,Boyle; Mary E. T.,23,0,48,25
1657921977209,COGS 13,A01,083071,Bastos; Amalia Pinkusfeld,12,0,71,59
1657921983241,COGS 14A,A01,092681,Semenuks; Arturs,5,1,100,95
1657921989264,COGS 14B,A01,083073,Cheng; Tzu-Han,7,0,63,56
1657921995286,COGS 17,A01,092677,Semenuks; Arturs,7,0,81,74
1657922001309,COGS 100,A01,083619,Allen; Michael Gordon,17,0,70,53
1657922007339,COGS 101A,A01,083621,Davis; Joshua Daniel,9,0,68,59
1657922013374,COGS 101B,A01,091572,Allen; Michael Gordon,14,0,65,51
1657922019401,COGS 101C,A01,083625,Delgado; Tania,17,0,35,18
1657922025425,COGS 107A,A01,083627,Boyle; Mary E. T.,14,0,60,46
1657922031451,COGS 118A,A01,083075,Gupta; Anjum,21,0,76,55
1657922037477,CSE 3,A50,083646,Miranda; Gregory Joseph,24,0,50,26
1657922043510,CSE 8A,A50,083650,Miranda; Gregory Joseph,17,1,56,39
1657922049620,CSE 11,A01,083080,Cao; Yingjun,6,15,40,34
1657922055642,CSE 12,A01,083652,Krause-Levy; Sophia Louisa,30,1,120,90
1657922061664,CSE 15L,A01,083654,Morris; Justin Loren,9,0,50,41
1657922061664,CSE 15L,A02,083655,Morris; Justin Loren,10,0,50,40
1657922067697,CSE 20,A01,083657,Tran; Khoa Dang,39,0,80,41
1657922073723,CSE 21,A01,095574,Bach; Quang Tran,22,0,48,26
1657922079750,CSE 30,A01,083084,Eldon; John,7,0,80,73
1657922079750,CSE 30,B01,095061,Bhaskar; Nishant,9,0,50,41
1657922085772,CSE 100,A01,083659,Cao; Yingjun,5,4,70,65
1657922091800,CSE 134B,A01,083661,Powell; Thomas Allan,25,0,100,75
1657922097827,CSE 140,A01,083663,Gungor; Onat,16,0,85,69
1657922103850,CSE 140L,A01,083088,Eldon; John,23,0,100,77
1657922109876,CSE 175,A01,083665,Kumar; Rakesh,3,0,25,22
1657922115899,CSE 190,A00,092507,Dubnov; Shlomo,8,0,20,12
1657922121922,ECE 45,A01,083139,Congero; Spencer William,7,0,75,68
1657922127949,ECE 65,A50,083695,Saad; Andrew S,12,0,30,18
1657922127949,ECE 65,A51,095125,Saad; Andrew S,24,0,26,2
1657922133974,ECE 109,A01,091882,Touri; Behrouz,20,0,70,50
1657922140000,ECE 180,A00,083140,Abi Samra; Nicholas Camill,1,0,30,29
1657922140000,ECE 180,B00,083141,Abi Samra; Nicholas Camill,0,0,30,30
1657922146027,MATH 10A,A01,083735,Patchell; Gregory David,2,0,30,28
1657922146027,MATH 10A,A02,083736,Patchell; Gregory David,20,0,30,10
1657922146027,MATH 10A,A03,083737,Patchell; Gregory David,16,0,30,14
1657922152051,MATH 10B,A01,083207,Lim; Seonhee,8,0,34,26
1657922152051,MATH 10B,A02,083208,Lim; Seonhee,10,0,35,25
1657922152051,MATH 10B,A03,093472,Lim; Seonhee,7,0,34,27
1657922152051,MATH 10B,B01,083739,Sinha; Shubham,14,0,30,16
1657922158075,MATH 18,A01,083743,Cinel; Cameron Alexander,9,0,30,21
1657922158075,MATH 18,A02,083744,Cinel; Cameron Alexander,18,0,30,12
1657922158075,MATH 18,A03,083745,Cinel; Cameron Alexander,10,0,30,20
1657922158075,MATH 18,B01,083748,Rideout; David Porter,5,0,37,32
1657922158075,MATH 18,B02,083749,Rideout; David Porter,5,0,36,31
1657922158075,MATH 18,B03,083750,Rideout; David Porter,3,0,37,34
1657922158075,MATH 18,B04,083751,Rideout; David Porter,7,0,36,29
1657922158075,MATH 18,B05,093473,Rideout; David Porter,7,0,36,29
1657922158075,MATH 18,B06,093474,Rideout; David Porter,6,0,36,30
1657922164097,MATH 20A,A01,083754,Zheng; Zequn,14,0,40,26
1657922170121,MATH 20B,A01,083756,Briones; Jor-el Thomas Caparas,4,0,36,32
1657922170121,MATH 20B,A02,083757,Briones; Jor-el Thomas Caparas,1,0,36,35
1657922170121,MATH 20B,A03,093475,Briones; Jor-el Thomas Caparas,3,0,36,33
1657922176152,MATH 20C,A01,083760,Briones; Jor-el Thomas Caparas,1,0,35,34
1657922176152,MATH 20C,A02,083761,Briones; Jor-el Thomas Caparas,8,0,35,27
1657922176152,MATH 20C,A03,093476,Briones; Jor-el Thomas Caparas,0,1,36,36
1657922176152,MATH 20C,B01,083762,Bach; Quang Tran,1,0,30,29
1657922182175,MATH 20D,A01,083765,Tran; Brian Kha,5,0,30,25
1657922182175,MATH 20D,A02,083766,Tran; Brian Kha,5,0,30,25
1657922182175,MATH 20D,A03,083767,Tran; Brian Kha,6,0,30,24
1657922188198,MATH 20E,A01,083771,Ganguly; Soumya,11,0,32,21
1657922188198,MATH 20E,A02,083772,Ganguly; Soumya,7,0,32,25
1657922188198,MATH 20E,B01,083773,Ciotti; Benjamin,20,0,35,15
1657922188198,MATH 20E,B02,083774,Ciotti; Benjamin,18,0,35,17
1657922194228,MATH 103A,A01,083777,Greenfeld; Be'Eri,3,0,36,33
1657922194228,MATH 103A,A02,083778,Greenfeld; Be'Eri,5,0,36,31
1657922194228,MATH 103A,A03,093561,Greenfeld; Be'Eri,6,0,36,30
1657922194228,MATH 103A,B01,083779,Greenfeld; Be'Eri,8,0,36,28
1657922194228,MATH 103A,B02,083780,Greenfeld; Be'Eri,4,0,36,32
1657922194228,MATH 103A,B03,093562,Greenfeld; Be'Eri,3,0,36,33
1657922200265,MATH 105,A01,085443,Carter; Anne Toulson,15,0,35,20
1657922200265,MATH 105,A02,093477,Carter; Anne Toulson,20,0,35,15
1657922206307,MATH 109,A01,083213,Ganzberger; Geoffrey Michael,3,0,34,31
1657922206307,MATH 109,A02,083214,Ganzberger; Geoffrey Michael,4,0,34,30
1657922206307,MATH 109,A03,093478,Ganzberger; Geoffrey Michael,2,0,34,32
1657922206307,MATH 109,B01,083215,Ganzberger; Geoffrey Michael,2,0,32,30
1657922206307,MATH 109,B02,083216,Ganzberger; Geoffrey Michael,2,0,32,30
1657922206307,MATH 109,B03,093479,Ganzberger; Geoffrey Michael,8,0,32,24
1657922212331,MATH 142A,A01,083219,Chow; Bennett,7,0,32,25
1657922212331,MATH 142A,A02,083220,Chow; Bennett,10,0,32,22
1657922212331,MATH 142A,A03,093480,Chow; Bennett,9,0,32,23
1657922212331,MATH 142A,B03,093481,Chow; Bennett,8,0,32,24
1657922212331,MATH 142A,B04,093558,Chow; Bennett,13,0,32,19
1657922212331,MATH 142A,B05,093559,Chow; Bennett,7,0,32,25
1657922218355,MATH 193A,A01,083224,Rotar; Vladimir,8,0,34,26
1657922218355,MATH 193A,A02,083225,Rotar; Vladimir,10,0,34,24
1657922218355,MATH 193A,A03,083781,Rotar; Vladimir,5,0,34,29
1657922218355,MATH 193A,A04,083782,Rotar; Vladimir,11,0,34,23
1657922218355,MATH 193A,A05,093482,Rotar; Vladimir,11,0,34,23
1657922224381,MATH 197,001,091859,McAuley; Julian John,9999,0,9999,0
1657922224381,MATH 197,002,095566,Kedlaya; Kiran S.,9997,0,9999,2
1657922224381,MATH 197,003,095567,Xiao; Ming,9999,0,9999,0
1657922224381,MATH 197,004,095571,Perols; Johan Lars,9998,0,9999,1
1657922231435,COGS 9,A01,083615,Shannon; Kyle Michael,10,0,75,65
1657922237461,COGS 11,A01,083617,Boyle; Mary E. T.,23,0,48,25
1657922243484,COGS 13,A01,083071,Bastos; Amalia Pinkusfeld,12,0,71,59
1657922249506,COGS 14A,A01,092681,Semenuks; Arturs,5,1,100,95
1657922255534,COGS 14B,A01,083073,Cheng; Tzu-Han,7,0,63,56
1657922261560,COGS 17,A01,092677,Semenuks; Arturs,7,0,81,74
1657922267597,COGS 100,A01,083619,Allen; Michael Gordon,17,0,70,53
1657922273621,COGS 101A,A01,083621,Davis; Joshua Daniel,9,0,68,59
1657922279653,COGS 101B,A01,091572,Allen; Michael Gordon,14,0,65,51
1657922285676,COGS 101C,A01,083625,Delgado; Tania,17,0,35,18
1657922291702,COGS 107A,A01,083627,Boyle; Mary E. T.,14,0,60,46
1657922297729,COGS 118A,A01,083075,Gupta; Anjum,21,0,76,55
1657922303753,CSE 3,A50,083646,Miranda; Gregory Joseph,24,0,50,26
1657922309784,CSE 8A,A50,083650,Miranda; Gregory Joseph,17,1,56,39
1657922315807,CSE 11,A01,083080,Cao; Yingjun,6,15,40,34
1657922321835,CSE 12,A01,083652,Krause-Levy; Sophia Louisa,30,1,120,90
1657922327865,CSE 15L,A01,083654,Morris; Justin Loren,9,0,50,41
1657922327865,CSE 15L,A02,083655,Morris; Justin Loren,10,0,50,40
1657922333888,CSE 20,A01,083657,Tran; Khoa Dang,39,0,80,41
1657922339914,CSE 21,A01,095574,Bach; Quang Tran,22,0,48,26
1657922345943,CSE 30,A01,083084,Eldon; John,7,0,80,73
1657922345943,CSE 30,B01,095061,Bhaskar; Nishant,9,0,50,41
1657922351969,CSE 100,A01,083659,Cao; Yingjun,5,4,70,65
1657922357991,CSE 134B,A01,083661,Powell; Thomas Allan,25,0,100,75
1657922364015,CSE 140,A01,083663,Gungor; Onat,16,0,85,69
1657922370037,CSE 140L,A01,083088,Eldon; John,23,0,100,77
1657922376059,CSE 175,A01,083665,Kumar; Rakesh,3,0,25,22
1657922382086,CSE 190,A00,092507,Dubnov; Shlomo,8,0,20,12
1657922388113,ECE 45,A01,083139,Congero; Spencer William,7,0,75,68
1657922394136,ECE 65,A50,083695,Saad; Andrew S,12,0,30,18
1657922394136,ECE 65,A51,095125,Saad; Andrew S,24,0,26,2
1657922400164,ECE 109,A01,091882,Touri; Behrouz,20,0,70,50
1657922406187,ECE 180,A00,083140,Abi Samra; Nicholas Camill,1,0,30,29
1657922406187,ECE 180,B00,083141,Abi Samra; Nicholas Camill,0,0,30,30
1657922412213,MATH 10A,A01,083735,Patchell; Gregory David,2,0,30,28
1657922412213,MATH 10A,A02,083736,Patchell; Gregory David,20,0,30,10
1657922412213,MATH 10A,A03,083737,Patchell; Gregory David,16,0,30,14
1657922418237,MATH 10B,A01,083207,Lim; Seonhee,8,0,34,26
1657922418237,MATH 10B,A02,083208,Lim; Seonhee,10,0,35,25
1657922418237,MATH 10B,A03,093472,Lim; Seonhee,7,0,34,27
1657922418237,MATH 10B,B01,083739,Sinha; Shubham,14,0,30,16
1657922424262,MATH 18,A01,083743,Cinel; Cameron Alexander,9,0,30,21
1657922424262,MATH 18,A02,083744,Cinel; Cameron Alexander,18,0,30,12
1657922424262,MATH 18,A03,083745,Cinel; Cameron Alexander,10,0,30,20
1657922424262,MATH 18,B01,083748,Rideout; David Porter,5,0,37,32
1657922424262,MATH 18,B02,083749,Rideout; David Porter,5,0,36,31
1657922424262,MATH 18,B03,083750,Rideout; David Porter,3,0,37,34
1657922424262,MATH 18,B04,083751,Rideout; David Porter,7,0,36,29
1657922424262,MATH 18,B05,093473,Rideout; David Porter,7,0,36,29
1657922424262,MATH 18,B06,093474,Rideout; David Porter,6,0,36,30
1657922430288,MATH 20A,A01,083754,Zheng; Zequn,14,0,40,26
1657922436316,MATH 20B,A01,083756,Briones; Jor-el Thomas Caparas,4,0,36,32
1657922436316,MATH 20B,A02,083757,Briones; Jor-el Thomas Caparas,1,0,36,35
1657922436316,MATH 20B,A03,093475,Briones; Jor-el Thomas Caparas,3,0,36,33
1657922442341,MATH 20C,A01,083760,Briones; Jor-el Thomas Caparas,1,0,35,34
1657922442341,MATH 20C,A02,083761,Briones; Jor-el Thomas Caparas,8,0,35,27
1657922442341,MATH 20C,A03,093476,Briones; Jor-el Thomas Caparas,0,1,36,36
1657922442341,MATH 20C,B01,083762,Bach; Quang Tran,1,0,30,29
1657922448365,MATH 20D,A01,083765,Tran; Brian Kha,5,0,30,25
1657922448365,MATH 20D,A02,083766,Tran; Brian Kha,5,0,30,25
1657922448365,MATH 20D,A03,083767,Tran; Brian Kha,6,0,30,24
1657922454410,MATH 20E,A01,083771,Ganguly; Soumya,11,0,32,21
1657922454410,MATH 20E,A02,083772,Ganguly; Soumya,7,0,32,25
1657922454410,MATH 20E,B01,083773,Ciotti; Benjamin,20,0,35,15
1657922454410,MATH 20E,B02,083774,Ciotti; Benjamin,18,0,35,17
1657922460441,MATH 103A,A01,083777,Greenfeld; Be'Eri,3,0,36,33
1657922460441,MATH 103A,A02,083778,Greenfeld; Be'Eri,5,0,36,31
1657922460441,MATH 103A,A03,093561,Greenfeld; Be'Eri,6,0,36,30
1657922460441,MATH 103A,B01,083779,Greenfeld; Be'Eri,8,0,36,28
1657922460441,MATH 103A,B02,083780,Greenfeld; Be'Eri,4,0,36,32
1657922460441,MATH 103A,B03,093562,Greenfeld; Be'Eri,3,0,36,33
1657922466465,MATH 105,A01,085443,Carter; Anne Toulson,15,0,35,20
1657922466465,MATH 105,A02,093477,Carter; Anne Toulson,20,0,35,15
1657922472494,MATH 109,A01,083213,Ganzberger; Geoffrey Michael,3,0,34,31
1657922472494,MATH 109,A02,083214,Ganzberger; Geoffrey Michael,4,0,34,30
1657922472494,MATH 109,A03,093478,Ganzberger; Geoffrey Michael,2,0,34,32
1657922472494,MATH 109,B01,083215,Ganzberger; Geoffrey Michael,2,0,32,30
1657922472494,MATH 109,B02,083216,Ganzberger; Geoffrey Michael,2,0,32,30
1657922472494,MATH 109,B03,093479,Ganzberger; Geoffrey Michael,8,0,32,24
1657922478522,MATH 142A,A01,083219,Chow; Bennett,7,0,32,25
1657922478522,MATH 142A,A02,083220,Chow; Bennett,10,0,32,22
1657922478522,MATH 142A,A03,093480,Chow; Bennett,9,0,32,23
1657922478522,MATH 142A,B03,093481,Chow; Bennett,8,0,32,24
1657922478522,MATH 142A,B04,093558,Chow; Bennett,13,0,32,19
1657922478522,MATH 142A,B05,093559,Chow; Bennett,7,0,32,25
1657922484544,MATH 193A,A01,083224,Rotar; Vladimir,8,0,34,26
1657922484544,MATH 193A,A02,083225,Rotar; Vladimir,10,0,34,24
1657922484544,MATH 193A,A03,083781,Rotar; Vladimir,5,0,34,29
1657922484544,MATH 193A,A04,083782,Rotar; Vladimir,11,0,34,23
1657922484544,MATH 193A,A05,093482,Rotar; Vladimir,11,0,34,23
1657922490572,MATH 197,001,091859,McAuley; Julian John,9999,0,9999,0
1657922490572,MATH 197,002,095566,Kedlaya; Kiran S.,9997,0,9999,2
1657922490572,MATH 197,003,095567,Xiao; Ming,9999,0,9999,0
1657922490572,MATH 197,004,095571,Perols; Johan Lars,9998,0,9999,1
1657922497635,COGS 9,A01,083615,Shannon; Kyle Michael,10,0,75,65
1657922503659,COGS 11,A01,083617,Boyle; Mary E. T.,23,0,48,25
1657922509680,COGS 13,A01,083071,Bastos; Amalia Pinkusfeld,12,0,71,59
1657922515711,COGS 14A,A01,092681,Semenuks; Arturs,5,1,100,95
1657922521733,COGS 14B,A01,083073,Cheng; Tzu-Han,7,0,63,56
1657922527755,COGS 17,A01,092677,Semenuks; Arturs,7,0,81,74
1657922533780,COGS 100,A01,083619,Allen; Michael Gordon,17,0,70,53
1657922539804,COGS 101A,A01,083621,Davis; Joshua Daniel,9,0,68,59
1657922545827,COGS 101B,A01,091572,Allen; Michael Gordon,14,0,65,51
1657922551854,COGS 101C,A01,083625,Delgado; Tania,17,0,35,18
1657922557888,COGS 107A,A01,083627,Boyle; Mary E. T.,14,0,60,46
1657922563910,COGS 118A,A01,083075,Gupta; Anjum,21,0,76,55
1657922569933,CSE 3,A50,083646,Miranda; Gregory Joseph,24,0,50,26
1657922575961,CSE 8A,A50,083650,Miranda; Gregory Joseph,17,1,56,39
1657922581984,CSE 11,A01,083080,Cao; Yingjun,6,15,40,34
1657922588012,CSE 12,A01,083652,Krause-Levy; Sophia Louisa,30,1,120,90
1657922594041,CSE 15L,A01,083654,Morris; Justin Loren,9,0,50,41
1657922594041,CSE 15L,A02,083655,Morris; Justin Loren,10,0,50,40
1657922600064,CSE 20,A01,083657,Tran; Khoa Dang,39,0,80,41
1657922606092,CSE 21,A01,095574,Bach; Quang Tran,22,0,48,26
1657922612130,CSE 30,A01,083084,Eldon; John,7,0,80,73
1657922612130,CSE 30,B01,095061,Bhaskar; Nishant,9,0,50,41
1657922618156,CSE 100,A01,083659,Cao; Yingjun,5,4,70,65
1657922624182,CSE 134B,A01,083661,Powell; Thomas Allan,25,0,100,75
1657922630204,CSE 140,A01,083663,Gungor; Onat,16,0,85,69
1657922636226,CSE 140L,A01,083088,Eldon; John,23,0,100,77
1657922642249,CSE 175,A01,083665,Kumar; Rakesh,3,0,25,22
1657922648370,CSE 190,A00,092507,Dubnov; Shlomo,8,0,20,12
1657922654417,ECE 45,A01,083139,Congero; Spencer William,7,0,75,68
1657922660440,ECE 65,A50,083695,Saad; Andrew S,12,0,30,18
1657922660440,ECE 65,A51,095125,Saad; Andrew S,24,0,26,2
1657922666481,ECE 109,A01,091882,Touri; Behrouz,20,0,70,50
1657922672510,ECE 180,A00,083140,Abi Samra; Nicholas Camill,1,0,30,29
1657922672510,ECE 180,B00,083141,Abi Samra; Nicholas Camill,0,0,30,30
1657922678535,MATH 10A,A01,083735,Patchell; Gregory David,2,0,30,28
1657922678535,MATH 10A,A02,083736,Patchell; Gregory David,20,0,30,10
1657922678535,MATH 10A,A03,083737,Patchell; Gregory David,16,0,30,14
1657922684559,MATH 10B,A01,083207,Lim; Seonhee,8,0,34,26
1657922684559,MATH 10B,A02,083208,Lim; Seonhee,10,0,35,25
1657922684559,MATH 10B,A03,093472,Lim; Seonhee,7,0,34,27
1657922684559,MATH 10B,B01,083739,Sinha; Shubham,14,0,30,16
1657922690595,MATH 18,A01,083743,Cinel; Cameron Alexander,9,0,30,21
1657922690595,MATH 18,A02,083744,Cinel; Cameron Alexander,18,0,30,12
1657922690595,MATH 18,A03,083745,Cinel; Cameron Alexander,10,0,30,20
1657922690595,MATH 18,B01,083748,Rideout; David Porter,5,0,37,32
1657922690595,MATH 18,B02,083749,Rideout; David Porter,5,0,36,31
1657922690595,MATH 18,B03,083750,Rideout; David Porter,3,0,37,34
1657922690595,MATH 18,B04,083751,Rideout; David Porter,7,0,36,29
1657922690595,MATH 18,B05,093473,Rideout; David Porter,7,0,36,29
1657922690595,MATH 18,B06,093474,Rideout; David Porter,6,0,36,30
1657922696620,MATH 20A,A01,083754,Zheng; Zequn,14,0,40,26
1657922702647,MATH 20B,A01,083756,Briones; Jor-el Thomas Caparas,4,0,36,32
1657922702647,MATH 20B,A02,083757,Briones; Jor-el Thomas Caparas,1,0,36,35
1657922702647,MATH 20B,A03,093475,Briones; Jor-el Thomas Caparas,3,0,36,33
1657922708676,MATH 20C,A01,083760,Briones; Jor-el Thomas Caparas,1,0,35,34
1657922708676,MATH 20C,A02,083761,Briones; Jor-el Thomas Caparas,8,0,35,27
1657922708676,MATH 20C,A03,093476,Briones; Jor-el Thomas Caparas,0,1,36,36
1657922708676,MATH 20C,B01,083762,Bach; Quang Tran,1,0,30,29
1657922714713,MATH 20D,A01,083765,Tran; Brian Kha,5,0,30,25
1657922714713,MATH 20D,A02,083766,Tran; Brian Kha,5,0,30,25
1657922714713,MATH 20D,A03,083767,Tran; Brian Kha,6,0,30,24
1657922720737,MATH 20E,A01,083771,Ganguly; Soumya,11,0,32,21
1657922720737,MATH 20E,A02,083772,Ganguly; Soumya,7,0,32,25
1657922720737,MATH 20E,B01,083773,Ciotti; Benjamin,20,0,35,15
1657922720737,MATH 20E,B02,083774,Ciotti; Benjamin,18,0,35,17
1657922726766,MATH 103A,A01,083777,Greenfeld; Be'Eri,3,0,36,33
1657922726766,MATH 103A,A02,083778,Greenfeld; Be'Eri,5,0,36,31
1657922726766,MATH 103A,A03,093561,Greenfeld; Be'Eri,6,0,36,30
1657922726766,MATH 103A,B01,083779,Greenfeld; Be'Eri,8,0,36,28
1657922726766,MATH 103A,B02,083780,Greenfeld; Be'Eri,4,0,36,32
1657922726766,MATH 103A,B03,093562,Greenfeld; Be'Eri,3,0,36,33
1657922732789,MATH 105,A01,085443,Carter; Anne Toulson,15,0,35,20
1657922732789,MATH 105,A02,093477,Carter; Anne Toulson,20,0,35,15
1657922738826,MATH 109,A01,083213,Ganzberger; Geoffrey Michael,3,0,34,31
1657922738826,MATH 109,A02,083214,Ganzberger; Geoffrey Michael,4,0,34,30
1657922738826,MATH 109,A03,093478,Ganzberger; Geoffrey Michael,2,0,34,32
1657922738826,MATH 109,B01,083215,Ganzberger; Geoffrey Michael,2,0,32,30
1657922738826,MATH 109,B02,083216,Ganzberger; Geoffrey Michael,2,0,32,30
1657922738826,MATH 109,B03,093479,Ganzberger; Geoffrey Michael,8,0,32,24
1657922744858,MATH 142A,A01,083219,Chow; Bennett,7,0,32,25
1657922744858,MATH 142A,A02,083220,Chow; Bennett,10,0,32,22
1657922744858,MATH 142A,A03,093480,Chow; Bennett,9,0,32,23
1657922744858,MATH 142A,B03,093481,Chow; Bennett,8,0,32,24
1657922744858,MATH 142A,B04,093558,Chow; Bennett,13,0,32,19
1657922744858,MATH 142A,B05,093559,Chow; Bennett,7,0,32,25
1657922750881,MATH 193A,A01,083224,Rotar; Vladimir,8,0,34,26
1657922750881,MATH 193A,A02,083225,Rotar; Vladimir,10,0,34,24
1657922750881,MATH 193A,A03,083781,Rotar; Vladimir,5,0,34,29
1657922750881,MATH 193A,A04,083782,Rotar; Vladimir,11,0,34,23
1657922750881,MATH 193A,A05,093482,Rotar; Vladimir,11,0,34,23
1657922756904,MATH 197,001,091859,McAuley; Julian John,9999,0,9999,0
1657922756904,MATH 197,002,095566,Kedlaya; Kiran S.,9997,0,9999,2
1657922756904,MATH 197,003,095567,Xiao; Ming,9999,0,9999,0
1657922756904,MATH 197,004,095571,Perols; Johan Lars,9998,0,9999,1
1657922763956,COGS 9,A01,083615,Shannon; Kyle Michael,10,0,75,65
1657922769980,COGS 11,A01,083617,Boyle; Mary E. T.,23,0,48,25
1657922776005,COGS 13,A01,083071,Bastos; Amalia Pinkusfeld,12,0,71,59
1657922782027,COGS 14A,A01,092681,Semenuks; Arturs,5,1,100,95
1657922788049,COGS 14B,A01,083073,Cheng; Tzu-Han,7,0,63,56
1657922794075,COGS 17,A01,092677,Semenuks; Arturs,7,0,81,74
1657922800106,COGS 100,A01,083619,Allen; Michael Gordon,17,0,70,53
1657922806133,COGS 101A,A01,083621,Davis; Joshua Daniel,9,0,68,59
1657922812160,COGS 101B,A01,091572,Allen; Michael Gordon,14,0,65,51
1657922818186,COGS 101C,A01,083625,Delgado; Tania,17,0,35,18
1657922824220,COGS 107A,A01,083627,Boyle; Mary E. T.,14,0,60,46
1657922830244,COGS 118A,A01,083075,Gupta; Anjum,21,0,76,55
1657922836273,CSE 3,A50,083646,Miranda; Gregory Joseph,24,0,50,26
1657922842297,CSE 8A,A50,083650,Miranda; Gregory Joseph,17,1,56,39
1657922848318,CSE 11,A01,083080,Cao; Yingjun,6,15,40,34
1657922854349,CSE 12,A01,083652,Krause-Levy; Sophia Louisa,30,1,120,90
1657922860376,CSE 15L,A01,083654,Morris; Justin Loren,9,0,50,41
1657922860376,CSE 15L,A02,083655,Morris; Justin Loren,10,0,50,40
1657922866399,CSE 20,A01,083657,Tran; Khoa Dang,39,0,80,41
1657922872427,CSE 21,A01,095574,Bach; Quang Tran,22,0,48,26
1657922878460,CSE 30,A01,083084,Eldon; John,7,0,80,73
1657922878460,CSE 30,B01,095061,Bhaskar; Nishant,9,0,50,41
1657922884485,CSE 100,A01,083659,Cao; Yingjun,5,4,70,65
1657922890509,CSE 134B,A01,083661,Powell; Thomas Allan,25,0,100,75
1657922896538,CSE 140,A01,083663,Gungor; Onat,16,0,85,69
1657922902561,CSE 140L,A01,083088,Eldon; John,23,0,100,77
1657922908588,CSE 175,A01,083665,Kumar; Rakesh,3,0,25,22
1657922914616,CSE 190,A00,092507,Dubnov; Shlomo,8,0,20,12
1657922920642,ECE 45,A01,083139,Congero; Spencer William,7,0,75,68
1657922926679,ECE 65,A50,083695,Saad; Andrew S,12,0,30,18
1657922926679,ECE 65,A51,095125,Saad; Andrew S,24,0,26,2
1657922932713,ECE 109,A01,091882,Touri; Behrouz,20,0,70,50
1657922938737,ECE 180,A00,083140,Abi Samra; Nicholas Camill,1,0,30,29
1657922938737,ECE 180,B00,083141,Abi Samra; Nicholas Camill,0,0,30,30
1657922944768,MATH 10A,A01,083735,Patchell; Gregory David,2,0,30,28
1657922944768,MATH 10A,A02,083736,Patchell; Gregory David,20,0,30,10
1657922944768,MATH 10A,A03,083737,Patchell; Gregory David,16,0,30,14
1657922950799,MATH 10B,A01,083207,Lim; Seonhee,8,0,34,26
1657922950799,MATH 10B,A02,083208,Lim; Seonhee,10,0,35,25
1657922950799,MATH 10B,A03,093472,Lim; Seonhee,7,0,34,27
1657922950799,MATH 10B,B01,083739,Sinha; Shubham,14,0,30,16
1657922956831,MATH 18,A01,083743,Cinel; Cameron Alexander,9,0,30,21
1657922956831,MATH 18,A02,083744,Cinel; Cameron Alexander,18,0,30,12
1657922956831,MATH 18,A03,083745,Cinel; Cameron Alexander,10,0,30,20
1657922956831,MATH 18,B01,083748,Rideout; David Porter,5,0,37,32
1657922956831,MATH 18,B02,083749,Rideout; David Porter,5,0,36,31
1657922956831,MATH 18,B03,083750,Rideout; David Porter,3,0,37,34
1657922956831,MATH 18,B04,083751,Rideout; David Porter,7,0,36,29
1657922956831,MATH 18,B05,093473,Rideout; David Porter,7,0,36,29
1657922956831,MATH 18,B06,093474,Rideout; David Porter,6,0,36,30
1657922962866,MATH 20A,A01,083754,Zheng; Zequn,14,0,40,26
1657922968897,MATH 20B,A01,083756,Briones; Jor-el Thomas Caparas,4,0,36,32
1657922968897,MATH 20B,A02,083757,Briones; Jor-el Thomas Caparas,1,0,36,35
1657922968897,MATH 20B,A03,093475,Briones; Jor-el Thomas Caparas,3,0,36,33
1657922974925,MATH 20C,A01,083760,Briones; Jor-el Thomas Caparas,1,0,35,34
1657922974925,MATH 20C,A02,083761,Briones; Jor-el Thomas Caparas,8,0,35,27
1657922974925,MATH 20C,A03,093476,Briones; Jor-el Thomas Caparas,0,1,36,36
1657922974925,MATH 20C,B01,083762,Bach; Quang Tran,1,0,30,29
1657922980959,MATH 20D,A01,083765,Tran; Brian Kha,5,0,30,25
1657922980959,MATH 20D,A02,083766,Tran; Brian Kha,5,0,30,25
1657922980959,MATH 20D,A03,083767,Tran; Brian Kha,6,0,30,24
1657922986988,MATH 20E,A01,083771,Ganguly; Soumya,11,0,32,21
1657922986988,MATH 20E,A02,083772,Ganguly; Soumya,7,0,32,25
1657922986988,MATH 20E,B01,083773,Ciotti; Benjamin,20,0,35,15
1657922986988,MATH 20E,B02,083774,Ciotti; Benjamin,18,0,35,17
1657922993012,MATH 103A,A01,083777,Greenfeld; Be'Eri,3,0,36,33
1657922993012,MATH 103A,A02,083778,Greenfeld; Be'Eri,5,0,36,31
1657922993012,MATH 103A,A03,093561,Greenfeld; Be'Eri,6,0,36,30
1657922993012,MATH 103A,B01,083779,Greenfeld; Be'Eri,8,0,36,28
1657922993012,MATH 103A,B02,083780,Greenfeld; Be'Eri,4,0,36,32
1657922993012,MATH 103A,B03,093562,Greenfeld; Be'Eri,3,0,36,33
1657922999035,MATH 105,A01,085443,Carter; Anne Toulson,15,0,35,20
1657922999035,MATH 105,A02,093477,Carter; Anne Toulson,20,0,35,15
1657923005060,MATH 109,A01,083213,Ganzberger; Geoffrey Michael,3,0,34,31
1657923005060,MATH 109,A02,083214,Ganzberger; Geoffrey Michael,4,0,34,30
1657923005060,MATH 109,A03,093478,Ganzberger; Geoffrey Michael,2,0,34,32
1657923005060,MATH 109,B01,083215,Ganzberger; Geoffrey Michael,2,0,32,30
1657923005060,MATH 109,B02,083216,Ganzberger; Geoffrey Michael,2,0,32,30
1657923005060,MATH 109,B03,093479,Ganzberger; Geoffrey Michael,8,0,32,24
1657923011090,MATH 142A,A01,083219,Chow; Bennett,7,0,32,25
1657923011090,MATH 142A,A02,083220,Chow; Bennett,10,0,32,22
1657923011090,MATH 142A,A03,093480,Chow; Bennett,9,0,32,23
1657923011090,MATH 142A,B03,093481,Chow; Bennett,8,0,32,24
1657923011090,MATH 142A,B04,093558,Chow; Bennett,13,0,32,19
1657923011090,MATH 142A,B05,093559,Chow; Bennett,7,0,32,25
1657923017112,MATH 193A,A01,083224,Rotar; Vladimir,8,0,34,26
1657923017112,MATH 193A,A02,083225,Rotar; Vladimir,10,0,34,24
1657923017112,MATH 193A,A03,083781,Rotar; Vladimir,5,0,34,29
1657923017112,MATH 193A,A04,083782,Rotar; Vladimir,11,0,34,23
1657923017112,MATH 193A,A05,093482,Rotar; Vladimir,11,0,34,23
1657923023134,MATH 197,001,091859,McAuley; Julian John,9999,0,9999,0
1657923023134,MATH 197,002,095566,Kedlaya; Kiran S.,9997,0,9999,2
1657923023134,MATH 197,003,095567,Xiao; Ming,9999,0,9999,0
1657923023134,MATH 197,004,095571,Perols; Johan Lars,9998,0,9999,1
1657923030196,COGS 9,A01,083615,Shannon; Kyle Michael,10,0,75,65
1657923036219,COGS 11,A01,083617,Boyle; Mary E. T.,23,0,48,25
1657923042242,COGS 13,A01,083071,Bastos; Amalia Pinkusfeld,12,0,71,59
1657923048270,COGS 14A,A01,092681,Semenuks; Arturs,5,1,100,95
1657923054298,COGS 14B,A01,083073,Cheng; Tzu-Han,7,0,63,56
1657923060333,COGS 17,A01,092677,Semenuks; Arturs,7,0,81,74
1657923066361,COGS 100,A01,083619,Allen; Michael Gordon,17,0,70,53
1657923072382,COGS 101A,A01,083621,Davis; Joshua Daniel,9,0,68,59
1657923078410,COGS 101B,A01,091572,Allen; Michael Gordon,14,0,65,51
1657923084439,COGS 101C,A01,083625,Delgado; Tania,17,0,35,18
1657923090465,COGS 107A,A01,083627,Boyle; Mary E. T.,14,0,60,46
1657923096490,COGS 118A,A01,083075,Gupta; Anjum,21,0,76,55
1657923102513,CSE 3,A50,083646,Miranda; Gregory Joseph,24,0,50,26
1657923108542,CSE 8A,A50,083650,Miranda; Gregory Joseph,17,1,56,39
1657923114566,CSE 11,A01,083080,Cao; Yingjun,6,15,40,34
1657923120591,CSE 12,A01,083652,Krause-Levy; Sophia Louisa,30,1,120,90
1657923126641,CSE 15L,A01,083654,Morris; Justin Loren,9,0,50,41
1657923126641,CSE 15L,A02,083655,Morris; Justin Loren,10,0,50,40
1657923132663,CSE 20,A01,083657,Tran; Khoa Dang,39,0,80,41
1657923138685,CSE 21,A01,095574,Bach; Quang Tran,22,0,48,26
1657923144720,CSE 30,A01,083084,Eldon; John,7,0,80,73
1657923144720,CSE 30,B01,095061,Bhaskar; Nishant,9,0,50,41
1657923150748,CSE 100,A01,083659,Cao; Yingjun,5,4,70,65
1657923156774,CSE 134B,A01,083661,Powell; Thomas Allan,25,0,100,75
1657923162803,CSE 140,A01,083663,Gungor; Onat,16,0,85,69
1657923168826,CSE 140L,A01,083088,Eldon; John,23,0,100,77
1657923174851,CSE 175,A01,083665,Kumar; Rakesh,3,0,25,22
1657923180873,CSE 190,A00,092507,Dubnov; Shlomo,8,0,20,12
1657923186896,ECE 45,A01,083139,Congero; Spencer William,7,0,75,68
1657923192923,ECE 65,A50,083695,Saad; Andrew S,12,0,30,18
1657923192923,ECE 65,A51,095125,Saad; Andrew S,24,0,26,2
1657923198950,ECE 109,A01,091882,Touri; Behrouz,20,0,70,50
1657923204973,ECE 180,A00,083140,Abi Samra; Nicholas Camill,1,0,30,29
1657923204973,ECE 180,B00,083141,Abi Samra; Nicholas Camill,0,0,30,30
1657923210998,MATH 10A,A01,083735,Patchell; Gregory David,2,0,30,28
1657923210998,MATH 10A,A02,083736,Patchell; Gregory David,20,0,30,10
1657923210998,MATH 10A,A03,083737,Patchell; Gregory David,16,0,30,14
1657923217024,MATH 10B,A01,083207,Lim; Seonhee,8,0,34,26
1657923217024,MATH 10B,A02,083208,Lim; Seonhee,10,0,35,25
1657923217024,MATH 10B,A03,093472,Lim; Seonhee,7,0,34,27
1657923217024,MATH 10B,B01,083739,Sinha; Shubham,14,0,30,16
1657923223055,MATH 18,A01,083743,Cinel; Cameron Alexander,9,0,30,21
1657923223055,MATH 18,A02,083744,Cinel; Cameron Alexander,18,0,30,12
1657923223055,MATH 18,A03,083745,Cinel; Cameron Alexander,10,0,30,20
1657923223055,MATH 18,B01,083748,Rideout; David Porter,5,0,37,32
1657923223055,MATH 18,B02,083749,Rideout; David Porter,5,0,36,31
1657923223055,MATH 18,B03,083750,Rideout; David Porter,3,0,37,34
1657923223055,MATH 18,B04,083751,Rideout; David Porter,7,0,36,29
1657923223055,MATH 18,B05,093473,Rideout; David Porter,7,0,36,29
1657923223055,MATH 18,B06,093474,Rideout; David Porter,6,0,36,30
1657923229080,MATH 20A,A01,083754,Zheng; Zequn,14,0,40,26
1657923235102,MATH 20B,A01,083756,Briones; Jor-el Thomas Caparas,4,0,36,32
1657923235102,MATH 20B,A02,083757,Briones; Jor-el Thomas Caparas,1,0,36,35
1657923235102,MATH 20B,A03,093475,Briones; Jor-el Thomas Caparas,3,0,36,33
1657923241127,MATH 20C,A01,083760,Briones; Jor-el Thomas Caparas,1,0,35,34
1657923241127,MATH 20C,A02,083761,Briones; Jor-el Thomas Caparas,8,0,35,27
1657923241127,MATH 20C,A03,093476,Briones; Jor-el Thomas Caparas,0,1,36,36
1657923241127,MATH 20C,B01,083762,Bach; Quang Tran,1,0,30,29
1657923247230,MATH 20D,A01,083765,Tran; Brian Kha,5,0,30,25
1657923247230,MATH 20D,A02,083766,Tran; Brian Kha,5,0,30,25
1657923247230,MATH 20D,A03,083767,Tran; Brian Kha,6,0,30,24
1657923253259,MATH 20E,A01,083771,Ganguly; Soumya,11,0,32,21
1657923253259,MATH 20E,A02,083772,Ganguly; Soumya,7,0,32,25
1657923253259,MATH 20E,B01,083773,Ciotti; Benjamin,20,0,35,15
1657923253259,MATH 20E,B02,083774,Ciotti; Benjamin,18,0,35,17
1657923259282,MATH 103A,A01,083777,Greenfeld; Be'Eri,3,0,36,33
1657923259282,MATH 103A,A02,083778,Greenfeld; Be'Eri,5,0,36,31
1657923259282,MATH 103A,A03,093561,Greenfeld; Be'Eri,6,0,36,30
1657923259282,MATH 103A,B01,083779,Greenfeld; Be'Eri,8,0,36,28
1657923259282,MATH 103A,B02,083780,Greenfeld; Be'Eri,4,0,36,32
1657923259282,MATH 103A,B03,093562,Greenfeld; Be'Eri,3,0,36,33
1657923265319,MATH 105,A01,085443,Carter; Anne Toulson,15,0,35,20
1657923265319,MATH 105,A02,093477,Carter; Anne Toulson,20,0,35,15
1657923271348,MATH 109,A01,083213,Ganzberger; Geoffrey Michael,3,0,34,31
1657923271348,MATH 109,A02,083214,Ganzberger; Geoffrey Michael,4,0,34,30
1657923271348,MATH 109,A03,093478,Ganzberger; Geoffrey Michael,2,0,34,32
1657923271348,MATH 109,B01,083215,Ganzberger; Geoffrey Michael,2,0,32,30
1657923271348,MATH 109,B02,083216,Ganzberger; Geoffrey Michael,2,0,32,30
1657923271348,MATH 109,B03,093479,Ganzberger; Geoffrey Michael,8,0,32,24
1657923277377,MATH 142A,A01,083219,Chow; Bennett,7,0,32,25
1657923277377,MATH 142A,A02,083220,Chow; Bennett,10,0,32,22
1657923277377,MATH 142A,A03,093480,Chow; Bennett,9,0,32,23
1657923277377,MATH 142A,B03,093481,Chow; Bennett,8,0,32,24
1657923277377,MATH 142A,B04,093558,Chow; Bennett,13,0,32,19
1657923277377,MATH 142A,B05,093559,Chow; Bennett,7,0,32,25
1657923283406,MATH 193A,A01,083224,Rotar; Vladimir,8,0,34,26
1657923283406,MATH 193A,A02,083225,Rotar; Vladimir,10,0,34,24
1657923283406,MATH 193A,A03,083781,Rotar; Vladimir,5,0,34,29
1657923283406,MATH 193A,A04,083782,Rotar; Vladimir,11,0,34,23
1657923283406,MATH 193A,A05,093482,Rotar; Vladimir,11,0,34,23
1657923289430,MATH 197,001,091859,McAuley; Julian John,9999,0,9999,0
1657923289430,MATH 197,002,095566,Kedlaya; Kiran S.,9997,0,9999,2
1657923289430,MATH 197,003,095567,Xiao; Ming,9999,0,9999,0
1657923289430,MATH 197,004,095571,Perols; Johan Lars,9998,0,9999,1
1657923296486,COGS 9,A01,083615,Shannon; Kyle Michael,10,0,75,65
1657923302512,COGS 11,A01,083617,Boyle; Mary E. T.,23,0,48,25
1657923308540,COGS 13,A01,083071,Bastos; Amalia Pinkusfeld,12,0,71,59
1657923314564,COGS 14A,A01,092681,Semenuks; Arturs,5,1,100,95
1657923320587,COGS 14B,A01,083073,Cheng; Tzu-Han,7,0,63,56
1657923326618,COGS 17,A01,092677,Semenuks; Arturs,7,0,81,74
1657923332648,COGS 100,A01,083619,Allen; Michael Gordon,17,0,70,53
1657923338674,COGS 101A,A01,083621,Davis; Joshua Daniel,9,0,68,59
1657923344698,COGS 101B,A01,091572,Allen; Michael Gordon,14,0,65,51
1657923350721,COGS 101C,A01,083625,Delgado; Tania,17,0,35,18
1657923356749,COGS 107A,A01,083627,Boyle; Mary E. T.,14,0,60,46
1657923362771,COGS 118A,A01,083075,Gupta; Anjum,21,0,76,55
1657923368797,CSE 3,A50,083646,Miranda; Gregory Joseph,24,0,50,26
1657923374826,CSE 8A,A50,083650,Miranda; Gregory Joseph,17,1,56,39
1657923380855,CSE 11,A01,083080,Cao; Yingjun,6,15,40,34
1657923386877,CSE 12,A01,083652,Krause-Levy; Sophia Louisa,30,1,120,90
1657923392900,CSE 15L,A01,083654,Morris; Justin Loren,9,0,50,41
1657923392900,CSE 15L,A02,083655,Morris; Justin Loren,10,0,50,40
1657923398923,CSE 20,A01,083657,Tran; Khoa Dang,39,0,80,41
1657923404950,CSE 21,A01,095574,Bach; Quang Tran,22,0,48,26
1657923410977,CSE 30,A01,083084,Eldon; John,7,0,80,73
1657923410977,CSE 30,B01,095061,Bhaskar; Nishant,9,0,50,41
1657923416999,CSE 100,A01,083659,Cao; Yingjun,5,4,70,65
1657923423026,CSE 134B,A01,083661,Powell; Thomas Allan,25,0,100,75
1657923429058,CSE 140,A01,083663,Gungor; Onat,16,0,85,69
1657923435080,CSE 140L,A01,083088,Eldon; John,23,0,100,77
1657923441105,CSE 175,A01,083665,Kumar; Rakesh,3,0,25,22
1657923447128,CSE 190,A00,092507,Dubnov; Shlomo,8,0,20,12
1657923453152,ECE 45,A01,083139,Congero; Spencer William,7,0,75,68
1657923459193,ECE 65,A50,083695,Saad; Andrew S,12,0,30,18
1657923459193,ECE 65,A51,095125,Saad; Andrew S,24,0,26,2
1657923465218,ECE 109,A01,091882,Touri; Behrouz,20,0,70,50
1657923471243,ECE 180,A00,083140,Abi Samra; Nicholas Camill,1,0,30,29
1657923471243,ECE 180,B00,083141,Abi Samra; Nicholas Camill,0,0,30,30
1657923477267,MATH 10A,A01,083735,Patchell; Gregory David,2,0,30,28
1657923477267,MATH 10A,A02,083736,Patchell; Gregory David,20,0,30,10
1657923477267,MATH 10A,A03,083737,Patchell; Gregory David,16,0,30,14
1657923483290,MATH 10B,A01,083207,Lim; Seonhee,8,0,34,26
1657923483290,MATH 10B,A02,083208,Lim; Seonhee,10,0,35,25
1657923483290,MATH 10B,A03,093472,Lim; Seonhee,7,0,34,27
1657923483290,MATH 10B,B01,083739,Sinha; Shubham,14,0,30,16
1657923489315,MATH 18,A01,083743,Cinel; Cameron Alexander,9,0,30,21
1657923489315,MATH 18,A02,083744,Cinel; Cameron Alexander,18,0,30,12
1657923489315,MATH 18,A03,083745,Cinel; Cameron Alexander,10,0,30,20
1657923489315,MATH 18,B01,083748,Rideout; David Porter,5,0,37,32
1657923489315,MATH 18,B02,083749,Rideout; David Porter,5,0,36,31
1657923489315,MATH 18,B03,083750,Rideout; David Porter,3,0,37,34
1657923489315,MATH 18,B04,083751,Rideout; David Porter,7,0,36,29
1657923489315,MATH 18,B05,093473,Rideout; David Porter,7,0,36,29
1657923489315,MATH 18,B06,093474,Rideout; David Porter,6,0,36,30
1657923495342,MATH 20A,A01,083754,Zheng; Zequn,14,0,40,26
1657923501371,MATH 20B,A01,083756,Briones; Jor-el Thomas Caparas,4,0,36,32
1657923501371,MATH 20B,A02,083757,Briones; Jor-el Thomas Caparas,1,0,36,35
1657923501371,MATH 20B,A03,093475,Briones; Jor-el Thomas Caparas,3,0,36,33
1657923507393,MATH 20C,A01,083760,Briones; Jor-el Thomas Caparas,1,0,35,34
1657923507393,MATH 20C,A02,083761,Briones; Jor-el Thomas Caparas,8,0,35,27
1657923507393,MATH 20C,A03,093476,Briones; Jor-el Thomas Caparas,0,1,36,36
1657923507393,MATH 20C,B01,083762,Bach; Quang Tran,1,0,30,29
1657923513437,MATH 20D,A01,083765,Tran; Brian Kha,5,0,30,25
1657923513437,MATH 20D,A02,083766,Tran; Brian Kha,5,0,30,25
1657923513437,MATH 20D,A03,083767,Tran; Brian Kha,6,0,30,24
1657923519476,MATH 20E,A01,083771,Ganguly; Soumya,11,0,32,21
1657923519476,MATH 20E,A02,083772,Ganguly; Soumya,7,0,32,25
1657923519476,MATH 20E,B01,083773,Ciotti; Benjamin,20,0,35,15
1657923519476,MATH 20E,B02,083774,Ciotti; Benjamin,18,0,35,17
1657923525506,MATH 103A,A01,083777,Greenfeld; Be'Eri,3,0,36,33
1657923525506,MATH 103A,A02,083778,Greenfeld; Be'Eri,5,0,36,31
1657923525506,MATH 103A,A03,093561,Greenfeld; Be'Eri,6,0,36,30
1657923525506,MATH 103A,B01,083779,Greenfeld; Be'Eri,8,0,36,28
1657923525506,MATH 103A,B02,083780,Greenfeld; Be'Eri,4,0,36,32
1657923525506,MATH 103A,B03,093562,Greenfeld; Be'Eri,3,0,36,33
1657923531532,MATH 105,A01,085443,Carter; Anne Toulson,15,0,35,20
1657923531532,MATH 105,A02,093477,Carter; Anne Toulson,20,0,35,15
1657923537563,MATH 109,A01,083213,Ganzberger; Geoffrey Michael,3,0,34,31
1657923537563,MATH 109,A02,083214,Ganzberger; Geoffrey Michael,4,0,34,30
1657923537563,MATH 109,A03,093478,Ganzberger; Geoffrey Michael,2,0,34,32
1657923537563,MATH 109,B01,083215,Ganzberger; Geoffrey Michael,2,0,32,30
1657923537563,MATH 109,B02,083216,Ganzberger; Geoffrey Michael,2,0,32,30
1657923537563,MATH 109,B03,093479,Ganzberger; Geoffrey Michael,8,0,32,24
1657923543586,MATH 142A,A01,083219,Chow; Bennett,7,0,32,25
1657923543586,MATH 142A,A02,083220,Chow; Bennett,10,0,32,22
1657923543586,MATH 142A,A03,093480,Chow; Bennett,9,0,32,23
1657923543586,MATH 142A,B03,093481,Chow; Bennett,8,0,32,24
1657923543586,MATH 142A,B04,093558,Chow; Bennett,13,0,32,19
1657923543586,MATH 142A,B05,093559,Chow; Bennett,7,0,32,25
1657923549611,MATH 193A,A01,083224,Rotar; Vladimir,8,0,34,26
1657923549611,MATH 193A,A02,083225,Rotar; Vladimir,10,0,34,24
1657923549611,MATH 193A,A03,083781,Rotar; Vladimir,5,0,34,29
1657923549611,MATH 193A,A04,083782,Rotar; Vladimir,11,0,34,23
1657923549611,MATH 193A,A05,093482,Rotar; Vladimir,11,0,34,23
1657923555637,MATH 197,001,091859,McAuley; Julian John,9999,0,9999,0
1657923555637,MATH 197,002,095566,Kedlaya; Kiran S.,9997,0,9999,2
1657923555637,MATH 197,003,095567,Xiao; Ming,9999,0,9999,0
1657923555637,MATH 197,004,095571,Perols; Johan Lars,9998,0,9999,1
1657923562690,COGS 9,A01,083615,Shannon; Kyle Michael,10,0,75,65
1657923568715,COGS 11,A01,083617,Boyle; Mary E. T.,23,0,48,25
1657923574737,COGS 13,A01,083071,Bastos; Amalia Pinkusfeld,12,0,71,59
1657923580774,COGS 14A,A01,092681,Semenuks; Arturs,5,1,100,95
1657923586800,COGS 14B,A01,083073,Cheng; Tzu-Han,7,0,63,56
1657923592823,COGS 17,A01,092677,Semenuks; Arturs,7,0,81,74
1657923598854,COGS 100,A01,083619,Allen; Michael Gordon,17,0,70,53
1657923604876,COGS 101A,A01,083621,Davis; Joshua Daniel,9,0,68,59
1657923610906,COGS 101B,A01,091572,Allen; Michael Gordon,14,0,65,51
1657923616930,COGS 101C,A01,083625,Delgado; Tania,17,0,35,18
1657923622956,COGS 107A,A01,083627,Boyle; Mary E. T.,14,0,60,46
1657923628984,COGS 118A,A01,083075,Gupta; Anjum,21,0,76,55
1657923635007,CSE 3,A50,083646,Miranda; Gregory Joseph,24,0,50,26
1657923641032,CSE 8A,A50,083650,Miranda; Gregory Joseph,17,1,56,39
1657923647055,CSE 11,A01,083080,Cao; Yingjun,6,15,40,34
1657923653083,CSE 12,A01,083652,Krause-Levy; Sophia Louisa,30,1,120,90
1657923659108,CSE 15L,A01,083654,Morris; Justin Loren,9,0,50,41
1657923659108,CSE 15L,A02,083655,Morris; Justin Loren,10,0,50,40
1657923665146,CSE 20,A01,083657,Tran; Khoa Dang,39,0,80,41
1657923671173,CSE 21,A01,095574,Bach; Quang Tran,22,0,48,26
1657923677205,CSE 30,A01,083084,Eldon; John,7,0,80,73
1657923677205,CSE 30,B01,095061,Bhaskar; Nishant,9,0,50,41
1657923683233,CSE 100,A01,083659,Cao; Yingjun,5,4,70,65
1657923689262,CSE 134B,A01,083661,Powell; Thomas Allan,25,0,100,75
1657923695291,CSE 140,A01,083663,Gungor; Onat,16,0,85,69
1657923701315,CSE 140L,A01,083088,Eldon; John,23,0,100,77
1657923707339,CSE 175,A01,083665,Kumar; Rakesh,3,0,25,22
1657923713374,CSE 190,A00,092507,Dubnov; Shlomo,8,0,20,12
1657923719401,ECE 45,A01,083139,Congero; Spencer William,7,0,75,68
1657923725442,ECE 65,A50,083695,Saad; Andrew S,12,0,30,18
1657923725442,ECE 65,A51,095125,Saad; Andrew S,24,0,26,2
1657923731469,ECE 109,A01,091882,Touri; Behrouz,20,0,70,50
1657923737502,ECE 180,A00,083140,Abi Samra; Nicholas Camill,1,0,30,29
1657923737502,ECE 180,B00,083141,Abi Samra; Nicholas Camill,0,0,30,30
1657923743526,MATH 10A,A01,083735,Patchell; Gregory David,2,0,30,28
1657923743526,MATH 10A,A02,083736,Patchell; Gregory David,20,0,30,10
1657923743526,MATH 10A,A03,083737,Patchell; Gregory David,16,0,30,14
1657923749561,MATH 10B,A01,083207,Lim; Seonhee,8,0,34,26
1657923749561,MATH 10B,A02,083208,Lim; Seonhee,10,0,35,25
1657923749561,MATH 10B,A03,093472,Lim; Seonhee,7,0,34,27
1657923749561,MATH 10B,B01,083739,Sinha; Shubham,14,0,30,16
1657923755593,MATH 18,A01,083743,Cinel; Cameron Alexander,9,0,30,21
1657923755593,MATH 18,A02,083744,Cinel; Cameron Alexander,18,0,30,12
1657923755593,MATH 18,A03,083745,Cinel; Cameron Alexander,10,0,30,20
1657923755593,MATH 18,B01,083748,Rideout; David Porter,5,0,37,32
1657923755593,MATH 18,B02,083749,Rideout; David Porter,5,0,36,31
1657923755593,MATH 18,B03,083750,Rideout; David Porter,3,0,37,34
1657923755593,MATH 18,B04,083751,Rideout; David Porter,7,0,36,29
1657923755593,MATH 18,B05,093473,Rideout; David Porter,7,0,36,29
1657923755593,MATH 18,B06,093474,Rideout; David Porter,6,0,36,30
1657923761618,MATH 20A,A01,083754,Zheng; Zequn,14,0,40,26
1657923767645,MATH 20B,A01,083756,Briones; Jor-el Thomas Caparas,4,0,36,32
1657923767645,MATH 20B,A02,083757,Briones; Jor-el Thomas Caparas,1,0,36,35
1657923767645,MATH 20B,A03,093475,Briones; Jor-el Thomas Caparas,3,0,36,33
1657923773675,MATH 20C,A01,083760,Briones; Jor-el Thomas Caparas,1,0,35,34
1657923773675,MATH 20C,A02,083761,Briones; Jor-el Thomas Caparas,8,0,35,27
1657923773675,MATH 20C,A03,093476,Briones; Jor-el Thomas Caparas,0,1,36,36
1657923773675,MATH 20C,B01,083762,Bach; Quang Tran,1,0,30,29
1657923779707,MATH 20D,A01,083765,Tran; Brian Kha,5,0,30,25
1657923779707,MATH 20D,A02,083766,Tran; Brian Kha,5,0,30,25
1657923779707,MATH 20D,A03,083767,Tran; Brian Kha,6,0,30,24
1657923785737,MATH 20E,A01,083771,Ganguly; Soumya,11,0,32,21
1657923785737,MATH 20E,A02,083772,Ganguly; Soumya,7,0,32,25
1657923785737,MATH 20E,B01,083773,Ciotti; Benjamin,20,0,35,15
1657923785737,MATH 20E,B02,083774,Ciotti; Benjamin,18,0,35,17
1657923791761,MATH 103A,A01,083777,Greenfeld; Be'Eri,3,0,36,33
1657923791761,MATH 103A,A02,083778,Greenfeld; Be'Eri,5,0,36,31
1657923791761,MATH 103A,A03,093561,Greenfeld; Be'Eri,6,0,36,30
1657923791761,MATH 103A,B01,083779,Greenfeld; Be'Eri,8,0,36,28
1657923791761,MATH 103A,B02,083780,Greenfeld; Be'Eri,4,0,36,32
1657923791761,MATH 103A,B03,093562,Greenfeld; Be'Eri,3,0,36,33
1657923797785,MATH 105,A01,085443,Carter; Anne Toulson,15,0,35,20
1657923797785,MATH 105,A02,093477,Carter; Anne Toulson,20,0,35,15
1657923803809,MATH 109,A01,083213,Ganzberger; Geoffrey Michael,3,0,34,31
1657923803809,MATH 109,A02,083214,Ganzberger; Geoffrey Michael,4,0,34,30
1657923803809,MATH 109,A03,093478,Ganzberger; Geoffrey Michael,2,0,34,32
1657923803809,MATH 109,B01,083215,Ganzberger; Geoffrey Michael,2,0,32,30
1657923803809,MATH 109,B02,083216,Ganzberger; Geoffrey Michael,2,0,32,30
1657923803809,MATH 109,B03,093479,Ganzberger; Geoffrey Michael,8,0,32,24
1657923809843,MATH 142A,A01,083219,Chow; Bennett,7,0,32,25
1657923809843,MATH 142A,A02,083220,Chow; Bennett,10,0,32,22
1657923809843,MATH 142A,A03,093480,Chow; Bennett,9,0,32,23
1657923809843,MATH 142A,B03,093481,Chow; Bennett,8,0,32,24
1657923809843,MATH 142A,B04,093558,Chow; Bennett,13,0,32,19
1657923809843,MATH 142A,B05,093559,Chow; Bennett,7,0,32,25
1657923815866,MATH 193A,A01,083224,Rotar; Vladimir,8,0,34,26
1657923815866,MATH 193A,A02,083225,Rotar; Vladimir,10,0,34,24
1657923815866,MATH 193A,A03,083781,Rotar; Vladimir,5,0,34,29
1657923815866,MATH 193A,A04,083782,Rotar; Vladimir,11,0,34,23
1657923815866,MATH 193A,A05,093482,Rotar; Vladimir,11,0,34,23
1657923821892,MATH 197,001,091859,McAuley; Julian John,9999,0,9999,0
1657923821892,MATH 197,002,095566,Kedlaya; Kiran S.,9997,0,9999,2
1657923821892,MATH 197,003,095567,Xiao; Ming,9999,0,9999,0
1657923821892,MATH 197,004,095571,Perols; Johan Lars,9998,0,9999,1
1657923828960,COGS 9,A01,083615,Shannon; Kyle Michael,10,0,75,65
1657923834986,COGS 11,A01,083617,Boyle; Mary E. T.,23,0,48,25
1657923841100,COGS 13,A01,083071,Bastos; Amalia Pinkusfeld,12,0,71,59
1657923847129,COGS 14A,A01,092681,Semenuks; Arturs,5,1,100,95
1657923853153,COGS 14B,A01,083073,Cheng; Tzu-Han,7,0,63,56
1657923859194,COGS 17,A01,092677,Semenuks; Arturs,7,0,81,74
1657923865223,COGS 100,A01,083619,Allen; Michael Gordon,17,0,70,53
1657923871246,COGS 101A,A01,083621,Davis; Joshua Daniel,9,0,68,59
1657923877273,COGS 101B,A01,091572,Allen; Michael Gordon,14,0,65,51
1657923883297,COGS 101C,A01,083625,Delgado; Tania,17,0,35,18
1657923889321,COGS 107A,A01,083627,Boyle; Mary E. T.,14,0,60,46
1657923895344,COGS 118A,A01,083075,Gupta; Anjum,21,0,76,55
1657923901369,CSE 3,A50,083646,Miranda; Gregory Joseph,24,0,50,26
1657923907406,CSE 8A,A50,083650,Miranda; Gregory Joseph,17,1,56,39
1657923913440,CSE 11,A01,083080,Cao; Yingjun,6,15,40,34
1657923919471,CSE 12,A01,083652,Krause-Levy; Sophia Louisa,30,1,120,90
1657923925532,CSE 15L,A01,083654,Morris; Justin Loren,9,0,50,41
1657923925532,CSE 15L,A02,083655,Morris; Justin Loren,10,0,50,40
1657923931556,CSE 20,A01,083657,Tran; Khoa Dang,39,0,80,41
1657923937583,CSE 21,A01,095574,Bach; Quang Tran,22,0,48,26
1657923943621,CSE 30,A01,083084,Eldon; John,7,0,80,73
1657923943621,CSE 30,B01,095061,Bhaskar; Nishant,9,0,50,41
1657923949650,CSE 100,A01,083659,Cao; Yingjun,5,4,70,65
1657923955677,CSE 134B,A01,083661,Powell; Thomas Allan,25,0,100,75
1657923961698,CSE 140,A01,083663,Gungor; Onat,16,0,85,69
1657923967727,CSE 140L,A01,083088,Eldon; John,23,0,100,77
1657923973768,CSE 175,A01,083665,Kumar; Rakesh,3,0,25,22
1657923979793,CSE 190,A00,092507,Dubnov; Shlomo,8,0,20,12
1657923985822,ECE 45,A01,083139,Congero; Spencer William,7,0,75,68
1657923991845,ECE 65,A50,083695,Saad; Andrew S,12,0,30,18
1657923991845,ECE 65,A51,095125,Saad; Andrew S,24,0,26,2
1657923997878,ECE 109,A01,091882,Touri; Behrouz,20,0,70,50
1657924003907,ECE 180,A00,083140,Abi Samra; Nicholas Camill,1,0,30,29
1657924003907,ECE 180,B00,083141,Abi Samra; Nicholas Camill,0,0,30,30
1657924009931,MATH 10A,A01,083735,Patchell; Gregory David,2,0,30,28
1657924009931,MATH 10A,A02,083736,Patchell; Gregory David,20,0,30,10
1657924009931,MATH 10A,A03,083737,Patchell; Gregory David,16,0,30,14
1657924015954,MATH 10B,A01,083207,Lim; Seonhee,8,0,34,26
1657924015954,MATH 10B,A02,083208,Lim; Seonhee,10,0,35,25
1657924015954,MATH 10B,A03,093472,Lim; Seonhee,7,0,34,27
1657924015954,MATH 10B,B01,083739,Sinha; Shubham,14,0,30,16
1657924021982,MATH 18,A01,083743,Cinel; Cameron Alexander,9,0,30,21
1657924021982,MATH 18,A02,083744,Cinel; Cameron Alexander,18,0,30,12
1657924021982,MATH 18,A03,083745,Cinel; Cameron Alexander,10,0,30,20
1657924021982,MATH 18,B01,083748,Rideout; David Porter,5,0,37,32
1657924021982,MATH 18,B02,083749,Rideout; David Porter,5,0,36,31
1657924021982,MATH 18,B03,083750,Rideout; David Porter,3,0,37,34
1657924021982,MATH 18,B04,083751,Rideout; David Porter,7,0,36,29
1657924021982,MATH 18,B05,093473,Rideout; David Porter,7,0,36,29
1657924021982,MATH 18,B06,093474,Rideout; David Porter,6,0,36,30
1657924028013,MATH 20A,A01,083754,Zheng; Zequn,14,0,40,26
1657924034049,MATH 20B,A01,083756,Briones; Jor-el Thomas Caparas,4,0,36,32
1657924034049,MATH 20B,A02,083757,Briones; Jor-el Thomas Caparas,1,0,36,35
1657924034049,MATH 20B,A03,093475,Briones; Jor-el Thomas Caparas,3,0,36,33
1657924040082,MATH 20C,A01,083760,Briones; Jor-el Thomas Caparas,1,0,35,34
1657924040082,MATH 20C,A02,083761,Briones; Jor-el Thomas Caparas,8,0,35,27
1657924040082,MATH 20C,A03,093476,Briones; Jor-el Thomas Caparas,0,1,36,36
1657924040082,MATH 20C,B01,083762,Bach; Quang Tran,1,0,30,29
1657924046104,MATH 20D,A01,083765,Tran; Brian Kha,5,0,30,25
1657924046104,MATH 20D,A02,083766,Tran; Brian Kha,5,0,30,25
1657924046104,MATH 20D,A03,083767,Tran; Brian Kha,6,0,30,24
1657924052139,MATH 20E,A01,083771,Ganguly; Soumya,11,0,32,21
1657924052139,MATH 20E,A02,083772,Ganguly; Soumya,7,0,32,25
1657924052139,MATH 20E,B01,083773,Ciotti; Benjamin,20,0,35,15
1657924052139,MATH 20E,B02,083774,Ciotti; Benjamin,18,0,35,17
1657924058166,MATH 103A,A01,083777,Greenfeld; Be'Eri,3,0,36,33
1657924058166,MATH 103A,A02,083778,Greenfeld; Be'Eri,5,0,36,31
1657924058166,MATH 103A,A03,093561,Greenfeld; Be'Eri,6,0,36,30
1657924058166,MATH 103A,B01,083779,Greenfeld; Be'Eri,8,0,36,28
1657924058166,MATH 103A,B02,083780,Greenfeld; Be'Eri,4,0,36,32
1657924058166,MATH 103A,B03,093562,Greenfeld; Be'Eri,3,0,36,33
1657924064188,MATH 105,A01,085443,Carter; Anne Toulson,15,0,35,20
1657924064188,MATH 105,A02,093477,Carter; Anne Toulson,20,0,35,15
1657924070212,MATH 109,A01,083213,Ganzberger; Geoffrey Michael,3,0,34,31
1657924070212,MATH 109,A02,083214,Ganzberger; Geoffrey Michael,4,0,34,30
1657924070212,MATH 109,A03,093478,Ganzberger; Geoffrey Michael,2,0,34,32
1657924070212,MATH 109,B01,083215,Ganzberger; Geoffrey Michael,2,0,32,30
1657924070212,MATH 109,B02,083216,Ganzberger; Geoffrey Michael,2,0,32,30
1657924070212,MATH 109,B03,093479,Ganzberger; Geoffrey Michael,8,0,32,24
1657924076241,MATH 142A,A01,083219,Chow; Bennett,7,0,32,25
1657924076241,MATH 142A,A02,083220,Chow; Bennett,10,0,32,22
1657924076241,MATH 142A,A03,093480,Chow; Bennett,9,0,32,23
1657924076241,MATH 142A,B03,093481,Chow; Bennett,8,0,32,24
1657924076241,MATH 142A,B04,093558,Chow; Bennett,13,0,32,19
1657924076241,MATH 142A,B05,093559,Chow; Bennett,7,0,32,25
1657924082275,MATH 193A,A01,083224,Rotar; Vladimir,8,0,34,26
1657924082275,MATH 193A,A02,083225,Rotar; Vladimir,10,0,34,24
1657924082275,MATH 193A,A03,083781,Rotar; Vladimir,5,0,34,29
1657924082275,MATH 193A,A04,083782,Rotar; Vladimir,11,0,34,23
1657924082275,MATH 193A,A05,093482,Rotar; Vladimir,11,0,34,23
1657924088304,MATH 197,001,091859,McAuley; Julian John,9999,0,9999,0
1657924088304,MATH 197,002,095566,Kedlaya; Kiran S.,9997,0,9999,2
1657924088304,MATH 197,003,095567,Xiao; Ming,9999,0,9999,0
1657924088304,MATH 197,004,095571,Perols; Johan Lars,9998,0,9999,1
1657924095356,COGS 9,A01,083615,Shannon; Kyle Michael,10,0,75,65
1657924101404,COGS 11,A01,083617,Boyle; Mary E. T.,23,0,48,25
1657924107429,COGS 13,A01,083071,Bastos; Amalia Pinkusfeld,12,0,71,59
1657924113455,COGS 14A,A01,092681,Semenuks; Arturs,5,1,100,95
1657924119483,COGS 14B,A01,083073,Cheng; Tzu-Han,7,0,63,56
1657924125518,COGS 17,A01,092677,Semenuks; Arturs,7,0,81,74
1657924131542,COGS 100,A01,083619,Allen; Michael Gordon,17,0,70,53
1657924137575,COGS 101A,A01,083621,Davis; Joshua Daniel,9,0,68,59
1657924143601,COGS 101B,A01,091572,Allen; Michael Gordon,14,0,65,51
1657924149626,COGS 101C,A01,083625,Delgado; Tania,17,0,35,18
1657924155649,COGS 107A,A01,083627,Boyle; Mary E. T.,14,0,60,46
1657924161672,COGS 118A,A01,083075,Gupta; Anjum,21,0,76,55
1657924167696,CSE 3,A50,083646,Miranda; Gregory Joseph,24,0,50,26
1657924173727,CSE 8A,A50,083650,Miranda; Gregory Joseph,17,1,56,39
1657924179754,CSE 11,A01,083080,Cao; Yingjun,6,15,40,34
1657924185779,CSE 12,A01,083652,Krause-Levy; Sophia Louisa,30,1,120,90
1657924191806,CSE 15L,A01,083654,Morris; Justin Loren,9,0,50,41
1657924191806,CSE 15L,A02,083655,Morris; Justin Loren,10,0,50,40
1657924197832,CSE 20,A01,083657,Tran; Khoa Dang,39,0,80,41
1657924203855,CSE 21,A01,095574,Bach; Quang Tran,22,0,48,26
1657924209882,CSE 30,A01,083084,Eldon; John,7,0,80,73
1657924209882,CSE 30,B01,095061,Bhaskar; Nishant,9,0,50,41
1657924215905,CSE 100,A01,083659,Cao; Yingjun,5,4,70,65
1657924221933,CSE 134B,A01,083661,Powell; Thomas Allan,25,0,100,75
1657924227958,CSE 140,A01,083663,Gungor; Onat,16,0,85,69
1657924233980,CSE 140L,A01,083088,Eldon; John,23,0,100,77
1657924240003,CSE 175,A01,083665,Kumar; Rakesh,3,0,25,22
1657924246026,CSE 190,A00,092507,Dubnov; Shlomo,8,0,20,12
1657924252058,ECE 45,A01,083139,Congero; Spencer William,7,0,75,68
1657924258083,ECE 65,A50,083695,Saad; Andrew S,12,0,30,18
1657924258083,ECE 65,A51,095125,Saad; Andrew S,24,0,26,2
1657924264114,ECE 109,A01,091882,Touri; Behrouz,20,0,70,50
1657924270138,ECE 180,A00,083140,Abi Samra; Nicholas Camill,1,0,30,29
1657924270138,ECE 180,B00,083141,Abi Samra; Nicholas Camill,0,0,30,30
1657924276171,MATH 10A,A01,083735,Patchell; Gregory David,2,0,30,28
1657924276171,MATH 10A,A02,083736,Patchell; Gregory David,20,0,30,10
1657924276171,MATH 10A,A03,083737,Patchell; Gregory David,16,0,30,14
1657924282195,MATH 10B,A01,083207,Lim; Seonhee,8,0,34,26
1657924282195,MATH 10B,A02,083208,Lim; Seonhee,10,0,35,25
1657924282195,MATH 10B,A03,093472,Lim; Seonhee,7,0,34,27
1657924282195,MATH 10B,B01,083739,Sinha; Shubham,14,0,30,16
1657924288236,MATH 18,A01,083743,Cinel; Cameron Alexander,9,0,30,21
1657924288236,MATH 18,A02,083744,Cinel; Cameron Alexander,18,0,30,12
1657924288236,MATH 18,A03,083745,Cinel; Cameron Alexander,10,0,30,20
1657924288236,MATH 18,B01,083748,Rideout; David Porter,5,0,37,32
1657924288236,MATH 18,B02,083749,Rideout; David Porter,5,0,36,31
1657924288236,MATH 18,B03,083750,Rideout; David Porter,3,0,37,34
1657924288236,MATH 18,B04,083751,Rideout; David Porter,7,0,36,29
1657924288236,MATH 18,B05,093473,Rideout; David Porter,7,0,36,29
1657924288236,MATH 18,B06,093474,Rideout; David Porter,6,0,36,30
1657924294259,MATH 20A,A01,083754,Zheng; Zequn,14,0,40,26
1657924300282,MATH 20B,A01,083756,Briones; Jor-el Thomas Caparas,4,0,36,32
1657924300282,MATH 20B,A02,083757,Briones; Jor-el Thomas Caparas,1,0,36,35
1657924300282,MATH 20B,A03,093475,Briones; Jor-el Thomas Caparas,3,0,36,33
1657924306310,MATH 20C,A01,083760,Briones; Jor-el Thomas Caparas,1,0,35,34
1657924306310,MATH 20C,A02,083761,Briones; Jor-el Thomas Caparas,8,0,35,27
1657924306310,MATH 20C,A03,093476,Briones; Jor-el Thomas Caparas,0,1,36,36
1657924306310,MATH 20C,B01,083762,Bach; Quang Tran,1,0,30,29
1657924312344,MATH 20D,A01,083765,Tran; Brian Kha,5,0,30,25
1657924312344,MATH 20D,A02,083766,Tran; Brian Kha,5,0,30,25
1657924312344,MATH 20D,A03,083767,Tran; Brian Kha,6,0,30,24
1657924318368,MATH 20E,A01,083771,Ganguly; Soumya,11,0,32,21
1657924318368,MATH 20E,A02,083772,Ganguly; Soumya,7,0,32,25
1657924318368,MATH 20E,B01,083773,Ciotti; Benjamin,20,0,35,15
1657924318368,MATH 20E,B02,083774,Ciotti; Benjamin,18,0,35,17
1657924324398,MATH 103A,A01,083777,Greenfeld; Be'Eri,3,0,36,33
1657924324398,MATH 103A,A02,083778,Greenfeld; Be'Eri,5,0,36,31
1657924324398,MATH 103A,A03,093561,Greenfeld; Be'Eri,6,0,36,30
1657924324398,MATH 103A,B01,083779,Greenfeld; Be'Eri,8,0,36,28
1657924324398,MATH 103A,B02,083780,Greenfeld; Be'Eri,4,0,36,32
1657924324398,MATH 103A,B03,093562,Greenfeld; Be'Eri,3,0,36,33
1657924330422,MATH 105,A01,085443,Carter; Anne Toulson,15,0,35,20
1657924330422,MATH 105,A02,093477,Carter; Anne Toulson,20,0,35,15
1657924336447,MATH 109,A01,083213,Ganzberger; Geoffrey Michael,3,0,34,31
1657924336447,MATH 109,A02,083214,Ganzberger; Geoffrey Michael,4,0,34,30
1657924336447,MATH 109,A03,093478,Ganzberger; Geoffrey Michael,2,0,34,32
1657924336447,MATH 109,B01,083215,Ganzberger; Geoffrey Michael,2,0,32,30
1657924336447,MATH 109,B02,083216,Ganzberger; Geoffrey Michael,2,0,32,30
1657924336447,MATH 109,B03,093479,Ganzberger; Geoffrey Michael,8,0,32,24
1657924342478,MATH 142A,A01,083219,Chow; Bennett,7,0,32,25
1657924342478,MATH 142A,A02,083220,Chow; Bennett,10,0,32,22
1657924342478,MATH 142A,A03,093480,Chow; Bennett,9,0,32,23
1657924342478,MATH 142A,B03,093481,Chow; Bennett,8,0,32,24
1657924342478,MATH 142A,B04,093558,Chow; Bennett,13,0,32,19
1657924342478,MATH 142A,B05,093559,Chow; Bennett,7,0,32,25
1657924348500,MATH 193A,A01,083224,Rotar; Vladimir,8,0,34,26
1657924348500,MATH 193A,A02,083225,Rotar; Vladimir,10,0,34,24
1657924348500,MATH 193A,A03,083781,Rotar; Vladimir,5,0,34,29
1657924348500,MATH 193A,A04,083782,Rotar; Vladimir,11,0,34,23
1657924348500,MATH 193A,A05,093482,Rotar; Vladimir,11,0,34,23
1657924354523,MATH 197,001,091859,McAuley; Julian John,9999,0,9999,0
1657924354523,MATH 197,002,095566,Kedlaya; Kiran S.,9997,0,9999,2
1657924354523,MATH 197,003,095567,Xiao; Ming,9999,0,9999,0
1657924354523,MATH 197,004,095571,Perols; Johan Lars,9998,0,9999,1
1657924361579,COGS 9,A01,083615,Shannon; Kyle Michael,10,0,75,65
1657924367602,COGS 11,A01,083617,Boyle; Mary E. T.,23,0,48,25
1657924373629,COGS 13,A01,083071,Bastos; Amalia Pinkusfeld,12,0,71,59
1657924379652,COGS 14A,A01,092681,Semenuks; Arturs,5,1,100,95
1657924385691,COGS 14B,A01,083073,Cheng; Tzu-Han,7,0,63,56
1657924391714,COGS 17,A01,092677,Semenuks; Arturs,7,0,81,74
1657924397754,COGS 100,A01,083619,Allen; Michael Gordon,17,0,70,53
1657924403785,COGS 101A,A01,083621,Davis; Joshua Daniel,9,0,68,59
1657924409808,COGS 101B,A01,091572,Allen; Michael Gordon,14,0,65,51
1657924415832,COGS 101C,A01,083625,Delgado; Tania,17,0,35,18
1657924421859,COGS 107A,A01,083627,Boyle; Mary E. T.,14,0,60,46
1657924427883,COGS 118A,A01,083075,Gupta; Anjum,21,0,76,55
1657924433906,CSE 3,A50,083646,Miranda; Gregory Joseph,24,0,50,26
1657924440003,CSE 8A,A50,083650,Miranda; Gregory Joseph,17,1,56,39
1657924446030,CSE 11,A01,083080,Cao; Yingjun,6,15,40,34
1657924452053,CSE 12,A01,083652,Krause-Levy; Sophia Louisa,30,1,120,90
1657924458084,CSE 15L,A01,083654,Morris; Justin Loren,9,0,50,41
1657924458084,CSE 15L,A02,083655,Morris; Justin Loren,10,0,50,40
1657924464105,CSE 20,A01,083657,Tran; Khoa Dang,39,0,80,41
1657924470133,CSE 21,A01,095574,Bach; Quang Tran,22,0,48,26
1657924476156,CSE 30,A01,083084,Eldon; John,7,0,80,73
1657924476156,CSE 30,B01,095061,Bhaskar; Nishant,9,0,50,41
1657924482179,CSE 100,A01,083659,Cao; Yingjun,5,4,70,65
1657924488206,CSE 134B,A01,083661,Powell; Thomas Allan,25,0,100,75
1657924494231,CSE 140,A01,083663,Gungor; Onat,16,0,85,69
1657924500263,CSE 140L,A01,083088,Eldon; John,23,0,100,77
1657924506292,CSE 175,A01,083665,Kumar; Rakesh,3,0,25,22
1657924512319,CSE 190,A00,092507,Dubnov; Shlomo,8,0,20,12
1657924518343,ECE 45,A01,083139,Congero; Spencer William,7,0,75,68
1657924524365,ECE 65,A50,083695,Saad; Andrew S,12,0,30,18
1657924524365,ECE 65,A51,095125,Saad; Andrew S,24,0,26,2
1657924530390,ECE 109,A01,091882,Touri; Behrouz,20,0,70,50
1657924536415,ECE 180,A00,083140,Abi Samra; Nicholas Camill,1,0,30,29
1657924536415,ECE 180,B00,083141,Abi Samra; Nicholas Camill,0,0,30,30
1657924542449,MATH 10A,A01,083735,Patchell; Gregory David,2,0,30,28
1657924542449,MATH 10A,A02,083736,Patchell; Gregory David,20,0,30,10
1657924542449,MATH 10A,A03,083737,Patchell; Gregory David,16,0,30,14
1657924548480,MATH 10B,A01,083207,Lim; Seonhee,8,0,34,26
1657924548480,MATH 10B,A02,083208,Lim; Seonhee,10,0,35,25
1657924548480,MATH 10B,A03,093472,Lim; Seonhee,7,0,34,27
1657924548480,MATH 10B,B01,083739,Sinha; Shubham,14,0,30,16
1657924554511,MATH 18,A01,083743,Cinel; Cameron Alexander,9,0,30,21
1657924554511,MATH 18,A02,083744,Cinel; Cameron Alexander,18,0,30,12
1657924554511,MATH 18,A03,083745,Cinel; Cameron Alexander,10,0,30,20
1657924554511,MATH 18,B01,083748,Rideout; David Porter,5,0,37,32
1657924554511,MATH 18,B02,083749,Rideout; David Porter,5,0,36,31
1657924554511,MATH 18,B03,083750,Rideout; David Porter,3,0,37,34
1657924554511,MATH 18,B04,083751,Rideout; David Porter,7,0,36,29
1657924554511,MATH 18,B05,093473,Rideout; David Porter,7,0,36,29
1657924554511,MATH 18,B06,093474,Rideout; David Porter,6,0,36,30
1657924560548,MATH 20A,A01,083754,Zheng; Zequn,14,0,40,26
1657924566574,MATH 20B,A01,083756,Briones; Jor-el Thomas Caparas,4,0,36,32
1657924566574,MATH 20B,A02,083757,Briones; Jor-el Thomas Caparas,1,0,36,35
1657924566574,MATH 20B,A03,093475,Briones; Jor-el Thomas Caparas,3,0,36,33
1657924572595,MATH 20C,A01,083760,Briones; Jor-el Thomas Caparas,1,0,35,34
1657924572595,MATH 20C,A02,083761,Briones; Jor-el Thomas Caparas,8,0,35,27
1657924572595,MATH 20C,A03,093476,Briones; Jor-el Thomas Caparas,0,1,36,36
1657924572595,MATH 20C,B01,083762,Bach; Quang Tran,1,0,30,29
1657924578619,MATH 20D,A01,083765,Tran; Brian Kha,5,0,30,25
1657924578619,MATH 20D,A02,083766,Tran; Brian Kha,5,0,30,25
1657924578619,MATH 20D,A03,083767,Tran; Brian Kha,6,0,30,24
1657924584643,MATH 20E,A01,083771,Ganguly; Soumya,11,0,32,21
1657924584643,MATH 20E,A02,083772,Ganguly; Soumya,7,0,32,25
1657924584643,MATH 20E,B01,083773,Ciotti; Benjamin,20,0,35,15
1657924584643,MATH 20E,B02,083774,Ciotti; Benjamin,18,0,35,17
1657924590666,MATH 103A,A01,083777,Greenfeld; Be'Eri,3,0,36,33
1657924590666,MATH 103A,A02,083778,Greenfeld; Be'Eri,5,0,36,31
1657924590666,MATH 103A,A03,093561,Greenfeld; Be'Eri,6,0,36,30
1657924590666,MATH 103A,B01,083779,Greenfeld; Be'Eri,8,0,36,28
1657924590666,MATH 103A,B02,083780,Greenfeld; Be'Eri,4,0,36,32
1657924590666,MATH 103A,B03,093562,Greenfeld; Be'Eri,3,0,36,33
1657924596697,MATH 105,A01,085443,Carter; Anne Toulson,15,0,35,20
1657924596697,MATH 105,A02,093477,Carter; Anne Toulson,20,0,35,15
1657924602727,MATH 109,A01,083213,Ganzberger; Geoffrey Michael,3,0,34,31
1657924602727,MATH 109,A02,083214,Ganzberger; Geoffrey Michael,4,0,34,30
1657924602727,MATH 109,A03,093478,Ganzberger; Geoffrey Michael,2,0,34,32
1657924602727,MATH 109,B01,083215,Ganzberger; Geoffrey Michael,2,0,32,30
1657924602727,MATH 109,B02,083216,Ganzberger; Geoffrey Michael,2,0,32,30
1657924602727,MATH 109,B03,093479,Ganzberger; Geoffrey Michael,8,0,32,24
1657924608751,MATH 142A,A01,083219,Chow; Bennett,7,0,32,25
1657924608751,MATH 142A,A02,083220,Chow; Bennett,10,0,32,22
1657924608751,MATH 142A,A03,093480,Chow; Bennett,9,0,32,23
1657924608751,MATH 142A,B03,093481,Chow; Bennett,8,0,32,24
1657924608751,MATH 142A,B04,093558,Chow; Bennett,13,0,32,19
1657924608751,MATH 142A,B05,093559,Chow; Bennett,7,0,32,25
1657924614778,MATH 193A,A01,083224,Rotar; Vladimir,8,0,34,26
1657924614778,MATH 193A,A02,083225,Rotar; Vladimir,10,0,34,24
1657924614778,MATH 193A,A03,083781,Rotar; Vladimir,5,0,34,29
1657924614778,MATH 193A,A04,083782,Rotar; Vladimir,11,0,34,23
1657924614778,MATH 193A,A05,093482,Rotar; Vladimir,11,0,34,23
1657924620805,MATH 197,001,091859,McAuley; Julian John,9999,0,9999,0
1657924620805,MATH 197,002,095566,Kedlaya; Kiran S.,9997,0,9999,2
1657924620805,MATH 197,003,095567,Xiao; Ming,9999,0,9999,0
1657924620805,MATH 197,004,095571,Perols; Johan Lars,9998,0,9999,1
1657924627869,COGS 9,A01,083615,Shannon; Kyle Michael,10,0,75,65
1657924633895,COGS 11,A01,083617,Boyle; Mary E. T.,23,0,48,25
1657924639926,COGS 13,A01,083071,Bastos; Amalia Pinkusfeld,12,0,71,59
1657924645947,COGS 14A,A01,092681,Semenuks; Arturs,5,1,100,95
1657924651971,COGS 14B,A01,083073,Cheng; Tzu-Han,7,0,63,56
1657924657994,COGS 17,A01,092677,Semenuks; Arturs,7,0,81,74
1657924664015,COGS 100,A01,083619,Allen; Michael Gordon,17,0,70,53
1657924670038,COGS 101A,A01,083621,Davis; Joshua Daniel,9,0,68,59
1657924676060,COGS 101B,A01,091572,Allen; Michael Gordon,14,0,65,51
1657924682088,COGS 101C,A01,083625,Delgado; Tania,17,0,35,18
1657924688111,COGS 107A,A01,083627,Boyle; Mary E. T.,14,0,60,46
1657924694137,COGS 118A,A01,083075,Gupta; Anjum,21,0,76,55
1657924700161,CSE 3,A50,083646,Miranda; Gregory Joseph,24,0,50,26
1657924706193,CSE 8A,A50,083650,Miranda; Gregory Joseph,17,1,56,39
1657924712219,CSE 11,A01,083080,Cao; Yingjun,6,15,40,34
1657924718243,CSE 12,A01,083652,Krause-Levy; Sophia Louisa,30,1,120,90
1657924724266,CSE 15L,A01,083654,Morris; Justin Loren,9,0,50,41
1657924724266,CSE 15L,A02,083655,Morris; Justin Loren,10,0,50,40
1657924730292,CSE 20,A01,083657,Tran; Khoa Dang,39,0,80,41
1657924736318,CSE 21,A01,095574,Bach; Quang Tran,22,0,48,26
1657924742345,CSE 30,A01,083084,Eldon; John,7,0,80,73
1657924742345,CSE 30,B01,095061,Bhaskar; Nishant,9,0,50,41
1657924748384,CSE 100,A01,083659,Cao; Yingjun,5,4,70,65
1657924754407,CSE 134B,A01,083661,Powell; Thomas Allan,25,0,100,75
1657924760431,CSE 140,A01,083663,Gungor; Onat,16,0,85,69
1657924766454,CSE 140L,A01,083088,Eldon; John,23,0,100,77
1657924772481,CSE 175,A01,083665,Kumar; Rakesh,3,0,25,22
1657924778514,CSE 190,A00,092507,Dubnov; Shlomo,8,0,20,12
1657924784541,ECE 45,A01,083139,Congero; Spencer William,7,0,75,68
1657924790564,ECE 65,A50,083695,Saad; Andrew S,12,0,30,18
1657924790564,ECE 65,A51,095125,Saad; Andrew S,24,0,26,2
1657924796587,ECE 109,A01,091882,Touri; Behrouz,20,0,70,50
1657924802615,ECE 180,A00,083140,Abi Samra; Nicholas Camill,1,0,30,29
1657924802615,ECE 180,B00,083141,Abi Samra; Nicholas Camill,0,0,30,30
1657924808643,MATH 10A,A01,083735,Patchell; Gregory David,2,0,30,28
1657924808643,MATH 10A,A02,083736,Patchell; Gregory David,20,0,30,10
1657924808643,MATH 10A,A03,083737,Patchell; Gregory David,16,0,30,14
1657924814672,MATH 10B,A01,083207,Lim; Seonhee,8,0,34,26
1657924814672,MATH 10B,A02,083208,Lim; Seonhee,10,0,35,25
1657924814672,MATH 10B,A03,093472,Lim; Seonhee,7,0,34,27
1657924814672,MATH 10B,B01,083739,Sinha; Shubham,14,0,30,16
1657924820695,MATH 18,A01,083743,Cinel; Cameron Alexander,9,0,30,21
1657924820695,MATH 18,A02,083744,Cinel; Cameron Alexander,18,0,30,12
1657924820695,MATH 18,A03,083745,Cinel; Cameron Alexander,10,0,30,20
1657924820695,MATH 18,B01,083748,Rideout; David Porter,5,0,37,32
1657924820695,MATH 18,B02,083749,Rideout; David Porter,5,0,36,31
1657924820695,MATH 18,B03,083750,Rideout; David Porter,3,0,37,34
1657924820695,MATH 18,B04,083751,Rideout; David Porter,7,0,36,29
1657924820695,MATH 18,B05,093473,Rideout; David Porter,7,0,36,29
1657924820695,MATH 18,B06,093474,Rideout; David Porter,6,0,36,30
1657924826720,MATH 20A,A01,083754,Zheng; Zequn,14,0,40,26
1657924832742,MATH 20B,A01,083756,Briones; Jor-el Thomas Caparas,4,0,36,32
1657924832742,MATH 20B,A02,083757,Briones; Jor-el Thomas Caparas,1,0,36,35
1657924832742,MATH 20B,A03,093475,Briones; Jor-el Thomas Caparas,3,0,36,33
1657924838778,MATH 20C,A01,083760,Briones; Jor-el Thomas Caparas,1,0,35,34
1657924838778,MATH 20C,A02,083761,Briones; Jor-el Thomas Caparas,8,0,35,27
1657924838778,MATH 20C,A03,093476,Briones; Jor-el Thomas Caparas,0,1,36,36
1657924838778,MATH 20C,B01,083762,Bach; Quang Tran,1,0,30,29
1657924844802,MATH 20D,A01,083765,Tran; Brian Kha,5,0,30,25
1657924844802,MATH 20D,A02,083766,Tran; Brian Kha,5,0,30,25
1657924844802,MATH 20D,A03,083767,Tran; Brian Kha,6,0,30,24
1657924850827,MATH 20E,A01,083771,Ganguly; Soumya,12,0,32,20
1657924850827,MATH 20E,A02,083772,Ganguly; Soumya,7,0,32,25
1657924850827,MATH 20E,B01,083773,Ciotti; Benjamin,20,0,35,15
1657924850827,MATH 20E,B02,083774,Ciotti; Benjamin,18,0,35,17
1657924856859,MATH 103A,A01,083777,Greenfeld; Be'Eri,3,0,36,33
1657924856859,MATH 103A,A02,083778,Greenfeld; Be'Eri,5,0,36,31
1657924856859,MATH 103A,A03,093561,Greenfeld; Be'Eri,6,0,36,30
1657924856859,MATH 103A,B01,083779,Greenfeld; Be'Eri,8,0,36,28
1657924856859,MATH 103A,B02,083780,Greenfeld; Be'Eri,4,0,36,32
1657924856859,MATH 103A,B03,093562,Greenfeld; Be'Eri,3,0,36,33
1657924862886,MATH 105,A01,085443,Carter; Anne Toulson,15,0,35,20
1657924862886,MATH 105,A02,093477,Carter; Anne Toulson,20,0,35,15
1657924868914,MATH 109,A01,083213,Ganzberger; Geoffrey Michael,3,0,34,31
1657924868914,MATH 109,A02,083214,Ganzberger; Geoffrey Michael,4,0,34,30
1657924868914,MATH 109,A03,093478,Ganzberger; Geoffrey Michael,2,0,34,32
1657924868914,MATH 109,B01,083215,Ganzberger; Geoffrey Michael,2,0,32,30
1657924868914,MATH 109,B02,083216,Ganzberger; Geoffrey Michael,2,0,32,30
1657924868914,MATH 109,B03,093479,Ganzberger; Geoffrey Michael,8,0,32,24
1657924874942,MATH 142A,A01,083219,Chow; Bennett,7,0,32,25
1657924874942,MATH 142A,A02,083220,Chow; Bennett,10,0,32,22
1657924874942,MATH 142A,A03,093480,Chow; Bennett,9,0,32,23
1657924874942,MATH 142A,B03,093481,Chow; Bennett,8,0,32,24
1657924874942,MATH 142A,B04,093558,Chow; Bennett,13,0,32,19
1657924874942,MATH 142A,B05,093559,Chow; Bennett,7,0,32,25
1657924880972,MATH 193A,A01,083224,Rotar; Vladimir,8,0,34,26
1657924880972,MATH 193A,A02,083225,Rotar; Vladimir,10,0,34,24
1657924880972,MATH 193A,A03,083781,Rotar; Vladimir,5,0,34,29
1657924880972,MATH 193A,A04,083782,Rotar; Vladimir,11,0,34,23
1657924880972,MATH 193A,A05,093482,Rotar; Vladimir,11,0,34,23
1657924886995,MATH 197,001,091859,McAuley; Julian John,9999,0,9999,0
1657924886995,MATH 197,002,095566,Kedlaya; Kiran S.,9997,0,9999,2
1657924886995,MATH 197,003,095567,Xiao; Ming,9999,0,9999,0
1657924886995,MATH 197,004,095571,Perols; Johan Lars,9998,0,9999,1
1657924894068,COGS 9,A01,083615,Shannon; Kyle Michael,10,0,75,65
1657924900089,COGS 11,A01,083617,Boyle; Mary E. T.,23,0,48,25
1657924906116,COGS 13,A01,083071,Bastos; Amalia Pinkusfeld,12,0,71,59
1657924912138,COGS 14A,A01,092681,Semenuks; Arturs,5,1,100,95
1657924918161,COGS 14B,A01,083073,Cheng; Tzu-Han,7,0,63,56
1657924924205,COGS 17,A01,092677,Semenuks; Arturs,7,0,81,74
1657924930231,COGS 100,A01,083619,Allen; Michael Gordon,17,0,70,53
1657924936255,COGS 101A,A01,083621,Davis; Joshua Daniel,9,0,68,59
1657924942281,COGS 101B,A01,091572,Allen; Michael Gordon,14,0,65,51
1657924948305,COGS 101C,A01,083625,Delgado; Tania,17,0,35,18
1657924954326,COGS 107A,A01,083627,Boyle; Mary E. T.,14,0,60,46
1657924960351,COGS 118A,A01,083075,Gupta; Anjum,21,0,76,55
1657924966380,CSE 3,A50,083646,Miranda; Gregory Joseph,24,0,50,26
1657924972402,CSE 8A,A50,083650,Miranda; Gregory Joseph,17,1,56,39
1657924978430,CSE 11,A01,083080,Cao; Yingjun,6,15,40,34
1657924984452,CSE 12,A01,083652,Krause-Levy; Sophia Louisa,30,1,120,90
1657924990475,CSE 15L,A01,083654,Morris; Justin Loren,9,0,50,41
1657924990475,CSE 15L,A02,083655,Morris; Justin Loren,10,0,50,40
1657924996496,CSE 20,A01,083657,Tran; Khoa Dang,39,0,80,41
1657925002519,CSE 21,A01,095574,Bach; Quang Tran,22,0,48,26
1657925008544,CSE 30,A01,083084,Eldon; John,7,0,80,73
1657925008544,CSE 30,B01,095061,Bhaskar; Nishant,9,0,50,41
1657925014570,CSE 100,A01,083659,Cao; Yingjun,5,4,70,65
1657925020596,CSE 134B,A01,083661,Powell; Thomas Allan,25,0,100,75
1657925026620,CSE 140,A01,083663,Gungor; Onat,16,0,85,69
1657925032643,CSE 140L,A01,083088,Eldon; John,23,0,100,77
1657925038753,CSE 175,A01,083665,Kumar; Rakesh,3,0,25,22
1657925044774,CSE 190,A00,092507,Dubnov; Shlomo,8,0,20,12
1657925050813,ECE 45,A01,083139,Congero; Spencer William,7,0,75,68
1657925056842,ECE 65,A50,083695,Saad; Andrew S,12,0,30,18
1657925056842,ECE 65,A51,095125,Saad; Andrew S,24,0,26,2
1657925062877,ECE 109,A01,091882,Touri; Behrouz,20,0,70,50
1657925068901,ECE 180,A00,083140,Abi Samra; Nicholas Camill,1,0,30,29
1657925068901,ECE 180,B00,083141,Abi Samra; Nicholas Camill,0,0,30,30
1657925074928,MATH 10A,A01,083735,Patchell; Gregory David,2,0,30,28
1657925074928,MATH 10A,A02,083736,Patchell; Gregory David,20,0,30,10
1657925074928,MATH 10A,A03,083737,Patchell; Gregory David,16,0,30,14
1657925080960,MATH 10B,A01,083207,Lim; Seonhee,8,0,34,26
1657925080960,MATH 10B,A02,083208,Lim; Seonhee,10,0,35,25
1657925080960,MATH 10B,A03,093472,Lim; Seonhee,7,0,34,27
1657925080960,MATH 10B,B01,083739,Sinha; Shubham,14,0,30,16
1657925086993,MATH 18,A01,083743,Cinel; Cameron Alexander,9,0,30,21
1657925086993,MATH 18,A02,083744,Cinel; Cameron Alexander,18,0,30,12
1657925086993,MATH 18,A03,083745,Cinel; Cameron Alexander,10,0,30,20
1657925086993,MATH 18,B01,083748,Rideout; David Porter,5,0,37,32
1657925086993,MATH 18,B02,083749,Rideout; David Porter,5,0,36,31
1657925086993,MATH 18,B03,083750,Rideout; David Porter,3,0,37,34
1657925086993,MATH 18,B04,083751,Rideout; David Porter,7,0,36,29
1657925086993,MATH 18,B05,093473,Rideout; David Porter,7,0,36,29
1657925086993,MATH 18,B06,093474,Rideout; David Porter,6,0,36,30
1657925093019,MATH 20A,A01,083754,Zheng; Zequn,14,0,40,26
1657925099043,MATH 20B,A01,083756,Briones; Jor-el Thomas Caparas,4,0,36,32
1657925099043,MATH 20B,A02,083757,Briones; Jor-el Thomas Caparas,1,0,36,35
1657925099043,MATH 20B,A03,093475,Briones; Jor-el Thomas Caparas,3,0,36,33
1657925105067,MATH 20C,A01,083760,Briones; Jor-el Thomas Caparas,1,0,35,34
1657925105067,MATH 20C,A02,083761,Briones; Jor-el Thomas Caparas,8,0,35,27
1657925105067,MATH 20C,A03,093476,Briones; Jor-el Thomas Caparas,0,1,36,36
1657925105067,MATH 20C,B01,083762,Bach; Quang Tran,1,0,30,29
1657925111090,MATH 20D,A01,083765,Tran; Brian Kha,5,0,30,25
1657925111090,MATH 20D,A02,083766,Tran; Brian Kha,5,0,30,25
1657925111090,MATH 20D,A03,083767,Tran; Brian Kha,6,0,30,24
1657925117113,MATH 20E,A01,083771,Ganguly; Soumya,12,0,32,20
1657925117113,MATH 20E,A02,083772,Ganguly; Soumya,7,0,32,25
1657925117113,MATH 20E,B01,083773,Ciotti; Benjamin,20,0,35,15
1657925117113,MATH 20E,B02,083774,Ciotti; Benjamin,18,0,35,17
1657925123144,MATH 103A,A01,083777,Greenfeld; Be'Eri,3,0,36,33
1657925123144,MATH 103A,A02,083778,Greenfeld; Be'Eri,5,0,36,31
1657925123144,MATH 103A,A03,093561,Greenfeld; Be'Eri,6,0,36,30
1657925123144,MATH 103A,B01,083779,Greenfeld; Be'Eri,8,0,36,28
1657925123144,MATH 103A,B02,083780,Greenfeld; Be'Eri,4,0,36,32
1657925123144,MATH 103A,B03,093562,Greenfeld; Be'Eri,3,0,36,33
1657925129181,MATH 105,A01,085443,Carter; Anne Toulson,15,0,35,20
1657925129181,MATH 105,A02,093477,Carter; Anne Toulson,20,0,35,15
1657925135219,MATH 109,A01,083213,Ganzberger; Geoffrey Michael,3,0,34,31
1657925135219,MATH 109,A02,083214,Ganzberger; Geoffrey Michael,4,0,34,30
1657925135219,MATH 109,A03,093478,Ganzberger; Geoffrey Michael,2,0,34,32
1657925135219,MATH 109,B01,083215,Ganzberger; Geoffrey Michael,2,0,32,30
1657925135219,MATH 109,B02,083216,Ganzberger; Geoffrey Michael,3,0,32,29
1657925135219,MATH 109,B03,093479,Ganzberger; Geoffrey Michael,8,0,32,24
1657925141243,MATH 142A,A01,083219,Chow; Bennett,7,0,32,25
1657925141243,MATH 142A,A02,083220,Chow; Bennett,10,0,32,22
1657925141243,MATH 142A,A03,093480,Chow; Bennett,9,0,32,23
1657925141243,MATH 142A,B03,093481,Chow; Bennett,8,0,32,24
1657925141243,MATH 142A,B04,093558,Chow; Bennett,13,0,32,19
1657925141243,MATH 142A,B05,093559,Chow; Bennett,7,0,32,25
1657925147273,MATH 193A,A01,083224,Rotar; Vladimir,8,0,34,26
1657925147273,MATH 193A,A02,083225,Rotar; Vladimir,10,0,34,24
1657925147273,MATH 193A,A03,083781,Rotar; Vladimir,5,0,34,29
1657925147273,MATH 193A,A04,083782,Rotar; Vladimir,11,0,34,23
1657925147273,MATH 193A,A05,093482,Rotar; Vladimir,11,0,34,23
1657925153301,MATH 197,001,091859,McAuley; Julian John,9999,0,9999,0
1657925153301,MATH 197,002,095566,Kedlaya; Kiran S.,9997,0,9999,2
1657925153301,MATH 197,003,095567,Xiao; Ming,9999,0,9999,0
1657925153301,MATH 197,004,095571,Perols; Johan Lars,9998,0,9999,1
1657925160365,COGS 9,A01,083615,Shannon; Kyle Michael,10,0,75,65
1657925166386,COGS 11,A01,083617,Boyle; Mary E. T.,23,0,48,25
1657925172410,COGS 13,A01,083071,Bastos; Amalia Pinkusfeld,12,0,71,59
1657925178432,COGS 14A,A01,092681,Semenuks; Arturs,5,1,100,95
1657925184466,COGS 14B,A01,083073,Cheng; Tzu-Han,7,0,63,56
1657925190499,COGS 17,A01,092677,Semenuks; Arturs,7,0,81,74
1657925196521,COGS 100,A01,083619,Allen; Michael Gordon,17,0,70,53
1657925202547,COGS 101A,A01,083621,Davis; Joshua Daniel,9,0,68,59
1657925208578,COGS 101B,A01,091572,Allen; Michael Gordon,14,0,65,51
1657925214606,COGS 101C,A01,083625,Delgado; Tania,17,0,35,18
1657925220630,COGS 107A,A01,083627,Boyle; Mary E. T.,14,0,60,46
1657925226653,COGS 118A,A01,083075,Gupta; Anjum,21,0,76,55
1657925232677,CSE 3,A50,083646,Miranda; Gregory Joseph,24,0,50,26
1657925238717,CSE 8A,A50,083650,Miranda; Gregory Joseph,17,1,56,39
1657925244743,CSE 11,A01,083080,Cao; Yingjun,6,15,40,34
1657925250768,CSE 12,A01,083652,Krause-Levy; Sophia Louisa,30,1,120,90
1657925256796,CSE 15L,A01,083654,Morris; Justin Loren,9,0,50,41
1657925256796,CSE 15L,A02,083655,Morris; Justin Loren,10,0,50,40
1657925262824,CSE 20,A01,083657,Tran; Khoa Dang,39,0,80,41
1657925268847,CSE 21,A01,095574,Bach; Quang Tran,22,0,48,26
1657925274873,CSE 30,A01,083084,Eldon; John,7,0,80,73
1657925274873,CSE 30,B01,095061,Bhaskar; Nishant,9,0,50,41
1657925280897,CSE 100,A01,083659,Cao; Yingjun,5,4,70,65
1657925286935,CSE 134B,A01,083661,Powell; Thomas Allan,25,0,100,75
1657925292962,CSE 140,A01,083663,Gungor; Onat,16,0,85,69
1657925298988,CSE 140L,A01,083088,Eldon; John,23,0,100,77
1657925305013,CSE 175,A01,083665,Kumar; Rakesh,3,0,25,22
1657925311034,CSE 190,A00,092507,Dubnov; Shlomo,8,0,20,12
1657925317073,ECE 45,A01,083139,Congero; Spencer William,7,0,75,68
1657925323097,ECE 65,A50,083695,Saad; Andrew S,12,0,30,18
1657925323097,ECE 65,A51,095125,Saad; Andrew S,24,0,26,2
1657925329120,ECE 109,A01,091882,Touri; Behrouz,20,0,70,50
1657925335143,ECE 180,A00,083140,Abi Samra; Nicholas Camill,1,0,30,29
1657925335143,ECE 180,B00,083141,Abi Samra; Nicholas Camill,0,0,30,30
1657925341165,MATH 10A,A01,083735,Patchell; Gregory David,2,0,30,28
1657925341165,MATH 10A,A02,083736,Patchell; Gregory David,20,0,30,10
1657925341165,MATH 10A,A03,083737,Patchell; Gregory David,16,0,30,14
1657925347190,MATH 10B,A01,083207,Lim; Seonhee,8,0,34,26
1657925347190,MATH 10B,A02,083208,Lim; Seonhee,10,0,35,25
1657925347190,MATH 10B,A03,093472,Lim; Seonhee,7,0,34,27
1657925347190,MATH 10B,B01,083739,Sinha; Shubham,14,0,30,16
1657925353217,MATH 18,A01,083743,Cinel; Cameron Alexander,9,0,30,21
1657925353217,MATH 18,A02,083744,Cinel; Cameron Alexander,18,0,30,12
1657925353217,MATH 18,A03,083745,Cinel; Cameron Alexander,10,0,30,20
1657925353217,MATH 18,B01,083748,Rideout; David Porter,5,0,37,32
1657925353217,MATH 18,B02,083749,Rideout; David Porter,5,0,36,31
1657925353217,MATH 18,B03,083750,Rideout; David Porter,3,0,37,34
1657925353217,MATH 18,B04,083751,Rideout; David Porter,7,0,36,29
1657925353217,MATH 18,B05,093473,Rideout; David Porter,7,0,36,29
1657925353217,MATH 18,B06,093474,Rideout; David Porter,6,0,36,30
1657925359249,MATH 20A,A01,083754,Zheng; Zequn,14,0,40,26
1657925365276,MATH 20B,A01,083756,Briones; Jor-el Thomas Caparas,4,0,36,32
1657925365276,MATH 20B,A02,083757,Briones; Jor-el Thomas Caparas,1,0,36,35
1657925365276,MATH 20B,A03,093475,Briones; Jor-el Thomas Caparas,3,0,36,33
1657925371298,MATH 20C,A01,083760,Briones; Jor-el Thomas Caparas,1,0,35,34
1657925371298,MATH 20C,A02,083761,Briones; Jor-el Thomas Caparas,8,0,35,27
1657925371298,MATH 20C,A03,093476,Briones; Jor-el Thomas Caparas,0,1,36,36
1657925371298,MATH 20C,B01,083762,Bach; Quang Tran,1,0,30,29
1657925377322,MATH 20D,A01,083765,Tran; Brian Kha,5,0,30,25
1657925377322,MATH 20D,A02,083766,Tran; Brian Kha,5,0,30,25
1657925377322,MATH 20D,A03,083767,Tran; Brian Kha,6,0,30,24
1657925383347,MATH 20E,A01,083771,Ganguly; Soumya,12,0,32,20
1657925383347,MATH 20E,A02,083772,Ganguly; Soumya,7,0,32,25
1657925383347,MATH 20E,B01,083773,Ciotti; Benjamin,20,0,35,15
1657925383347,MATH 20E,B02,083774,Ciotti; Benjamin,18,0,35,17
1657925389369,MATH 103A,A01,083777,Greenfeld; Be'Eri,3,0,36,33
1657925389369,MATH 103A,A02,083778,Greenfeld; Be'Eri,5,0,36,31
1657925389369,MATH 103A,A03,093561,Greenfeld; Be'Eri,6,0,36,30
1657925389369,MATH 103A,B01,083779,Greenfeld; Be'Eri,8,0,36,28
1657925389369,MATH 103A,B02,083780,Greenfeld; Be'Eri,4,0,36,32
1657925389369,MATH 103A,B03,093562,Greenfeld; Be'Eri,3,0,36,33
1657925395392,MATH 105,A01,085443,Carter; Anne Toulson,15,0,35,20
1657925395392,MATH 105,A02,093477,Carter; Anne Toulson,20,0,35,15
1657925401419,MATH 109,A01,083213,Ganzberger; Geoffrey Michael,3,0,34,31
1657925401419,MATH 109,A02,083214,Ganzberger; Geoffrey Michael,4,0,34,30
1657925401419,MATH 109,A03,093478,Ganzberger; Geoffrey Michael,2,0,34,32
1657925401419,MATH 109,B01,083215,Ganzberger; Geoffrey Michael,2,0,32,30
1657925401419,MATH 109,B02,083216,Ganzberger; Geoffrey Michael,3,0,32,29
1657925401419,MATH 109,B03,093479,Ganzberger; Geoffrey Michael,8,0,32,24
1657925407444,MATH 142A,A01,083219,Chow; Bennett,7,0,32,25
1657925407444,MATH 142A,A02,083220,Chow; Bennett,10,0,32,22
1657925407444,MATH 142A,A03,093480,Chow; Bennett,9,0,32,23
1657925407444,MATH 142A,B03,093481,Chow; Bennett,8,0,32,24
1657925407444,MATH 142A,B04,093558,Chow; Bennett,13,0,32,19
1657925407444,MATH 142A,B05,093559,Chow; Bennett,7,0,32,25
1657925413473,MATH 193A,A01,083224,Rotar; Vladimir,8,0,34,26
1657925413473,MATH 193A,A02,083225,Rotar; Vladimir,10,0,34,24
1657925413473,MATH 193A,A03,083781,Rotar; Vladimir,5,0,34,29
1657925413473,MATH 193A,A04,083782,Rotar; Vladimir,11,0,34,23
1657925413473,MATH 193A,A05,093482,Rotar; Vladimir,11,0,34,23
1657925419506,MATH 197,001,091859,McAuley; Julian John,9999,0,9999,0
1657925419506,MATH 197,002,095566,Kedlaya; Kiran S.,9997,0,9999,2
1657925419506,MATH 197,003,095567,Xiao; Ming,9999,0,9999,0
1657925419506,MATH 197,004,095571,Perols; Johan Lars,9998,0,9999,1
1657925426577,COGS 9,A01,083615,Shannon; Kyle Michael,10,0,75,65
1657925432608,COGS 11,A01,083617,Boyle; Mary E. T.,23,0,48,25
1657925438635,COGS 13,A01,083071,Bastos; Amalia Pinkusfeld,12,0,71,59
1657925444665,COGS 14A,A01,092681,Semenuks; Arturs,5,1,100,95
1657925450692,COGS 14B,A01,083073,Cheng; Tzu-Han,7,0,63,56
1657925456716,COGS 17,A01,092677,Semenuks; Arturs,7,0,81,74
1657925462742,COGS 100,A01,083619,Allen; Michael Gordon,17,0,70,53
1657925468769,COGS 101A,A01,083621,Davis; Joshua Daniel,9,0,68,59
1657925474791,COGS 101B,A01,091572,Allen; Michael Gordon,14,0,65,51
1657925480819,COGS 101C,A01,083625,Delgado; Tania,17,0,35,18
1657925486841,COGS 107A,A01,083627,Boyle; Mary E. T.,14,0,60,46
1657925492869,COGS 118A,A01,083075,Gupta; Anjum,21,0,76,55
1657925498896,CSE 3,A50,083646,Miranda; Gregory Joseph,24,0,50,26
1657925504922,CSE 8A,A50,083650,Miranda; Gregory Joseph,17,1,56,39
1657925510946,CSE 11,A01,083080,Cao; Yingjun,6,15,40,34
1657925516969,CSE 12,A01,083652,Krause-Levy; Sophia Louisa,30,1,120,90
1657925522999,CSE 15L,A01,083654,Morris; Justin Loren,9,0,50,41
1657925522999,CSE 15L,A02,083655,Morris; Justin Loren,10,0,50,40
1657925529023,CSE 20,A01,083657,Tran; Khoa Dang,39,0,80,41
1657925535047,CSE 21,A01,095574,Bach; Quang Tran,23,0,48,25
1657925541073,CSE 30,A01,083084,Eldon; John,7,0,80,73
1657925541073,CSE 30,B01,095061,Bhaskar; Nishant,9,0,50,41
1657925547102,CSE 100,A01,083659,Cao; Yingjun,5,4,70,65
1657925553132,CSE 134B,A01,083661,Powell; Thomas Allan,25,0,100,75
1657925559154,CSE 140,A01,083663,Gungor; Onat,17,0,85,68
1657925565179,CSE 140L,A01,083088,Eldon; John,23,0,100,77
1657925571212,CSE 175,A01,083665,Kumar; Rakesh,3,0,25,22
1657925577235,CSE 190,A00,092507,Dubnov; Shlomo,8,0,20,12
1657925583262,ECE 45,A01,083139,Congero; Spencer William,7,0,75,68
1657925589286,ECE 65,A50,083695,Saad; Andrew S,12,0,30,18
1657925589286,ECE 65,A51,095125,Saad; Andrew S,24,0,26,2
1657925595320,ECE 109,A01,091882,Touri; Behrouz,20,0,70,50
1657925601344,ECE 180,A00,083140,Abi Samra; Nicholas Camill,1,0,30,29
1657925601344,ECE 180,B00,083141,Abi Samra; Nicholas Camill,0,0,30,30
1657925607373,MATH 10A,A01,083735,Patchell; Gregory David,2,0,30,28
1657925607373,MATH 10A,A02,083736,Patchell; Gregory David,20,0,30,10
1657925607373,MATH 10A,A03,083737,Patchell; Gregory David,16,0,30,14
1657925613399,MATH 10B,A01,083207,Lim; Seonhee,8,0,34,26
1657925613399,MATH 10B,A02,083208,Lim; Seonhee,10,0,35,25
1657925613399,MATH 10B,A03,093472,Lim; Seonhee,7,0,34,27
1657925613399,MATH 10B,B01,083739,Sinha; Shubham,14,0,30,16
1657925619427,MATH 18,A01,083743,Cinel; Cameron Alexander,9,0,30,21
1657925619427,MATH 18,A02,083744,Cinel; Cameron Alexander,18,0,30,12
1657925619427,MATH 18,A03,083745,Cinel; Cameron Alexander,10,0,30,20
1657925619427,MATH 18,B01,083748,Rideout; David Porter,5,0,37,32
1657925619427,MATH 18,B02,083749,Rideout; David Porter,5,0,36,31
1657925619427,MATH 18,B03,083750,Rideout; David Porter,3,0,37,34
1657925619427,MATH 18,B04,083751,Rideout; David Porter,7,0,36,29
1657925619427,MATH 18,B05,093473,Rideout; David Porter,7,0,36,29
1657925619427,MATH 18,B06,093474,Rideout; David Porter,6,0,36,30
1657925625454,MATH 20A,A01,083754,Zheng; Zequn,14,0,40,26
1657925631483,MATH 20B,A01,083756,Briones; Jor-el Thomas Caparas,4,0,36,32
1657925631483,MATH 20B,A02,083757,Briones; Jor-el Thomas Caparas,1,0,36,35
1657925631483,MATH 20B,A03,093475,Briones; Jor-el Thomas Caparas,3,0,36,33
1657925637593,MATH 20C,A01,083760,Briones; Jor-el Thomas Caparas,1,0,35,34
1657925637593,MATH 20C,A02,083761,Briones; Jor-el Thomas Caparas,8,0,35,27
1657925637593,MATH 20C,A03,093476,Briones; Jor-el Thomas Caparas,0,1,36,36
1657925637593,MATH 20C,B01,083762,Bach; Quang Tran,1,0,30,29
1657925643623,MATH 20D,A01,083765,Tran; Brian Kha,5,0,30,25
1657925643623,MATH 20D,A02,083766,Tran; Brian Kha,5,0,30,25
1657925643623,MATH 20D,A03,083767,Tran; Brian Kha,6,0,30,24
1657925649646,MATH 20E,A01,083771,Ganguly; Soumya,12,0,32,20
1657925649646,MATH 20E,A02,083772,Ganguly; Soumya,7,0,32,25
1657925649646,MATH 20E,B01,083773,Ciotti; Benjamin,20,0,35,15
1657925649646,MATH 20E,B02,083774,Ciotti; Benjamin,18,0,35,17
1657925655669,MATH 103A,A01,083777,Greenfeld; Be'Eri,3,0,36,33
1657925655669,MATH 103A,A02,083778,Greenfeld; Be'Eri,5,0,36,31
1657925655669,MATH 103A,A03,093561,Greenfeld; Be'Eri,6,0,36,30
1657925655669,MATH 103A,B01,083779,Greenfeld; Be'Eri,8,0,36,28
1657925655669,MATH 103A,B02,083780,Greenfeld; Be'Eri,4,0,36,32
1657925655669,MATH 103A,B03,093562,Greenfeld; Be'Eri,3,0,36,33
1657925661693,MATH 105,A01,085443,Carter; Anne Toulson,15,0,35,20
1657925661693,MATH 105,A02,093477,Carter; Anne Toulson,20,0,35,15
1657925667723,MATH 109,A01,083213,Ganzberger; Geoffrey Michael,3,0,34,31
1657925667723,MATH 109,A02,083214,Ganzberger; Geoffrey Michael,4,0,34,30
1657925667723,MATH 109,A03,093478,Ganzberger; Geoffrey Michael,2,0,34,32
1657925667723,MATH 109,B01,083215,Ganzberger; Geoffrey Michael,2,0,32,30
1657925667723,MATH 109,B02,083216,Ganzberger; Geoffrey Michael,3,0,32,29
1657925667723,MATH 109,B03,093479,Ganzberger; Geoffrey Michael,8,0,32,24
1657925673747,MATH 142A,A01,083219,Chow; Bennett,7,0,32,25
1657925673747,MATH 142A,A02,083220,Chow; Bennett,10,0,32,22
1657925673747,MATH 142A,A03,093480,Chow; Bennett,9,0,32,23
1657925673747,MATH 142A,B03,093481,Chow; Bennett,8,0,32,24
1657925673747,MATH 142A,B04,093558,Chow; Bennett,13,0,32,19
1657925673747,MATH 142A,B05,093559,Chow; Bennett,7,0,32,25
1657925679770,MATH 193A,A01,083224,Rotar; Vladimir,8,0,34,26
1657925679770,MATH 193A,A02,083225,Rotar; Vladimir,10,0,34,24
1657925679770,MATH 193A,A03,083781,Rotar; Vladimir,5,0,34,29
1657925679770,MATH 193A,A04,083782,Rotar; Vladimir,11,0,34,23
1657925679770,MATH 193A,A05,093482,Rotar; Vladimir,11,0,34,23
1657925685793,MATH 197,001,091859,McAuley; Julian John,9999,0,9999,0
1657925685793,MATH 197,002,095566,Kedlaya; Kiran S.,9997,0,9999,2
1657925685793,MATH 197,003,095567,Xiao; Ming,9999,0,9999,0
1657925685793,MATH 197,004,095571,Perols; Johan Lars,9998,0,9999,1
1657925692859,COGS 9,A01,083615,Shannon; Kyle Michael,10,0,75,65
1657925698885,COGS 11,A01,083617,Boyle; Mary E. T.,23,0,48,25
1657925704911,COGS 13,A01,083071,Bastos; Amalia Pinkusfeld,12,0,71,59
1657925710941,COGS 14A,A01,092681,Semenuks; Arturs,5,1,100,95
1657925716967,COGS 14B,A01,083073,Cheng; Tzu-Han,7,0,63,56
1657925722990,COGS 17,A01,092677,Semenuks; Arturs,7,0,81,74
1657925729016,COGS 100,A01,083619,Allen; Michael Gordon,17,0,70,53
1657925735044,COGS 101A,A01,083621,Davis; Joshua Daniel,9,0,68,59
1657925741067,COGS 101B,A01,091572,Allen; Michael Gordon,14,0,65,51
1657925747094,COGS 101C,A01,083625,Delgado; Tania,17,0,35,18
1657925753123,COGS 107A,A01,083627,Boyle; Mary E. T.,14,0,60,46
1657925759145,COGS 118A,A01,083075,Gupta; Anjum,21,0,76,55
1657925765178,CSE 3,A50,083646,Miranda; Gregory Joseph,24,0,50,26
1657925771202,CSE 8A,A50,083650,Miranda; Gregory Joseph,17,1,56,39
1657925777224,CSE 11,A01,083080,Cao; Yingjun,6,15,40,34
1657925783247,CSE 12,A01,083652,Krause-Levy; Sophia Louisa,30,1,120,90
1657925789273,CSE 15L,A01,083654,Morris; Justin Loren,9,0,50,41
1657925789273,CSE 15L,A02,083655,Morris; Justin Loren,10,0,50,40
1657925795298,CSE 20,A01,083657,Tran; Khoa Dang,39,0,80,41
1657925801323,CSE 21,A01,095574,Bach; Quang Tran,23,0,48,25
1657925807345,CSE 30,A01,083084,Eldon; John,7,0,80,73
1657925807345,CSE 30,B01,095061,Bhaskar; Nishant,9,0,50,41
1657925813370,CSE 100,A01,083659,Cao; Yingjun,5,4,70,65
1657925819401,CSE 134B,A01,083661,Powell; Thomas Allan,25,0,100,75
1657925825424,CSE 140,A01,083663,Gungor; Onat,17,0,85,68
1657925831446,CSE 140L,A01,083088,Eldon; John,23,0,100,77
1657925837476,CSE 175,A01,083665,Kumar; Rakesh,3,0,25,22
1657925843501,CSE 190,A00,092507,Dubnov; Shlomo,8,0,20,12
1657925849524,ECE 45,A01,083139,Congero; Spencer William,7,0,75,68
1657925855548,ECE 65,A50,083695,Saad; Andrew S,12,0,30,18
1657925855548,ECE 65,A51,095125,Saad; Andrew S,24,0,26,2
1657925861570,ECE 109,A01,091882,Touri; Behrouz,20,0,70,50
1657925867597,ECE 180,A00,083140,Abi Samra; Nicholas Camill,1,0,30,29
1657925867597,ECE 180,B00,083141,Abi Samra; Nicholas Camill,0,0,30,30
1657925873619,MATH 10A,A01,083735,Patchell; Gregory David,2,0,30,28
1657925873619,MATH 10A,A02,083736,Patchell; Gregory David,20,0,30,10
1657925873619,MATH 10A,A03,083737,Patchell; Gregory David,16,0,30,14
1657925879663,MATH 10B,A01,083207,Lim; Seonhee,8,0,34,26
1657925879663,MATH 10B,A02,083208,Lim; Seonhee,10,0,35,25
1657925879663,MATH 10B,A03,093472,Lim; Seonhee,7,0,34,27
1657925879663,MATH 10B,B01,083739,Sinha; Shubham,14,0,30,16
1657925885699,MATH 18,A01,083743,Cinel; Cameron Alexander,9,0,30,21
1657925885699,MATH 18,A02,083744,Cinel; Cameron Alexander,18,0,30,12
1657925885699,MATH 18,A03,083745,Cinel; Cameron Alexander,10,0,30,20
1657925885699,MATH 18,B01,083748,Rideout; David Porter,5,0,37,32
1657925885699,MATH 18,B02,083749,Rideout; David Porter,5,0,36,31
1657925885699,MATH 18,B03,083750,Rideout; David Porter,3,0,37,34
1657925885699,MATH 18,B04,083751,Rideout; David Porter,7,0,36,29
1657925885699,MATH 18,B05,093473,Rideout; David Porter,7,0,36,29
1657925885699,MATH 18,B06,093474,Rideout; David Porter,6,0,36,30
1657925891721,MATH 20A,A01,083754,Zheng; Zequn,14,0,40,26
1657925897748,MATH 20B,A01,083756,Briones; Jor-el Thomas Caparas,4,0,36,32
1657925897748,MATH 20B,A02,083757,Briones; Jor-el Thomas Caparas,1,0,36,35
1657925897748,MATH 20B,A03,093475,Briones; Jor-el Thomas Caparas,3,0,36,33
1657925903776,MATH 20C,A01,083760,Briones; Jor-el Thomas Caparas,1,0,35,34
1657925903776,MATH 20C,A02,083761,Briones; Jor-el Thomas Caparas,8,0,35,27
1657925903776,MATH 20C,A03,093476,Briones; Jor-el Thomas Caparas,0,1,36,36
1657925903776,MATH 20C,B01,083762,Bach; Quang Tran,1,0,30,29
1657925909800,MATH 20D,A01,083765,Tran; Brian Kha,5,0,30,25
1657925909800,MATH 20D,A02,083766,Tran; Brian Kha,5,0,30,25
1657925909800,MATH 20D,A03,083767,Tran; Brian Kha,6,0,30,24
1657925915828,MATH 20E,A01,083771,Ganguly; Soumya,12,0,32,20
1657925915828,MATH 20E,A02,083772,Ganguly; Soumya,7,0,32,25
1657925915828,MATH 20E,B01,083773,Ciotti; Benjamin,20,0,35,15
1657925915828,MATH 20E,B02,083774,Ciotti; Benjamin,18,0,35,17
1657925921867,MATH 103A,A01,083777,Greenfeld; Be'Eri,3,0,36,33
1657925921867,MATH 103A,A02,083778,Greenfeld; Be'Eri,5,0,36,31
1657925921867,MATH 103A,A03,093561,Greenfeld; Be'Eri,6,0,36,30
1657925921867,MATH 103A,B01,083779,Greenfeld; Be'Eri,8,0,36,28
1657925921867,MATH 103A,B02,083780,Greenfeld; Be'Eri,4,0,36,32
1657925921867,MATH 103A,B03,093562,Greenfeld; Be'Eri,3,0,36,33
1657925927891,MATH 105,A01,085443,Carter; Anne Toulson,15,0,35,20
1657925927891,MATH 105,A02,093477,Carter; Anne Toulson,20,0,35,15
1657925933913,MATH 109,A01,083213,Ganzberger; Geoffrey Michael,3,0,34,31
1657925933913,MATH 109,A02,083214,Ganzberger; Geoffrey Michael,4,0,34,30
1657925933913,MATH 109,A03,093478,Ganzberger; Geoffrey Michael,2,0,34,32
1657925933913,MATH 109,B01,083215,Ganzberger; Geoffrey Michael,2,0,32,30
1657925933913,MATH 109,B02,083216,Ganzberger; Geoffrey Michael,3,0,32,29
1657925933913,MATH 109,B03,093479,Ganzberger; Geoffrey Michael,8,0,32,24
1657925939943,MATH 142A,A01,083219,Chow; Bennett,7,0,32,25
1657925939943,MATH 142A,A02,083220,Chow; Bennett,10,0,32,22
1657925939943,MATH 142A,A03,093480,Chow; Bennett,9,0,32,23
1657925939943,MATH 142A,B03,093481,Chow; Bennett,8,0,32,24
1657925939943,MATH 142A,B04,093558,Chow; Bennett,13,0,32,19
1657925939943,MATH 142A,B05,093559,Chow; Bennett,7,0,32,25
1657925945972,MATH 193A,A01,083224,Rotar; Vladimir,8,0,34,26
1657925945972,MATH 193A,A02,083225,Rotar; Vladimir,10,0,34,24
1657925945972,MATH 193A,A03,083781,Rotar; Vladimir,5,0,34,29
1657925945972,MATH 193A,A04,083782,Rotar; Vladimir,11,0,34,23
1657925945972,MATH 193A,A05,093482,Rotar; Vladimir,11,0,34,23
1657925951998,MATH 197,001,091859,McAuley; Julian John,9999,0,9999,0
1657925951998,MATH 197,002,095566,Kedlaya; Kiran S.,9997,0,9999,2
1657925951998,MATH 197,003,095567,Xiao; Ming,9999,0,9999,0
1657925951998,MATH 197,004,095571,Perols; Johan Lars,9998,0,9999,1
1657925959052,COGS 9,A01,083615,Shannon; Kyle Michael,10,0,75,65
1657925965074,COGS 11,A01,083617,Boyle; Mary E. T.,23,0,48,25
1657925971097,COGS 13,A01,083071,Bastos; Amalia Pinkusfeld,12,0,71,59
1657925977123,COGS 14A,A01,092681,Semenuks; Arturs,5,1,100,95
1657925983150,COGS 14B,A01,083073,Cheng; Tzu-Han,7,0,63,56
1657925989176,COGS 17,A01,092677,Semenuks; Arturs,7,0,81,74
1657925995197,COGS 100,A01,083619,Allen; Michael Gordon,17,0,70,53
1657926001222,COGS 101A,A01,083621,Davis; Joshua Daniel,9,0,68,59
1657926007250,COGS 101B,A01,091572,Allen; Michael Gordon,14,0,65,51
1657926013272,COGS 101C,A01,083625,Delgado; Tania,17,0,35,18
1657926019293,COGS 107A,A01,083627,Boyle; Mary E. T.,14,0,60,46
1657926025319,COGS 118A,A01,083075,Gupta; Anjum,21,0,76,55
1657926031347,CSE 3,A50,083646,Miranda; Gregory Joseph,24,0,50,26
1657926037379,CSE 8A,A50,083650,Miranda; Gregory Joseph,17,1,56,39
1657926043401,CSE 11,A01,083080,Cao; Yingjun,6,15,40,34
1657926049431,CSE 12,A01,083652,Krause-Levy; Sophia Louisa,30,1,120,90
1657926055470,CSE 15L,A01,083654,Morris; Justin Loren,9,0,50,41
1657926055470,CSE 15L,A02,083655,Morris; Justin Loren,10,0,50,40
1657926061496,CSE 20,A01,083657,Tran; Khoa Dang,39,0,80,41
1657926067525,CSE 21,A01,095574,Bach; Quang Tran,23,0,48,25
1657926073548,CSE 30,A01,083084,Eldon; John,7,0,80,73
1657926073548,CSE 30,B01,095061,Bhaskar; Nishant,9,0,50,41
1657926079585,CSE 100,A01,083659,Cao; Yingjun,5,4,70,65
1657926085610,CSE 134B,A01,083661,Powell; Thomas Allan,25,0,100,75
1657926091633,CSE 140,A01,083663,Gungor; Onat,17,0,85,68
1657926097673,CSE 140L,A01,083088,Eldon; John,23,0,100,77
1657926103694,CSE 175,A01,083665,Kumar; Rakesh,3,0,25,22
1657926109723,CSE 190,A00,092507,Dubnov; Shlomo,8,0,20,12
1657926115745,ECE 45,A01,083139,Congero; Spencer William,7,0,75,68
1657926121771,ECE 65,A50,083695,Saad; Andrew S,12,0,30,18
1657926121771,ECE 65,A51,095125,Saad; Andrew S,24,0,26,2
1657926127796,ECE 109,A01,091882,Touri; Behrouz,20,0,70,50
1657926133819,ECE 180,A00,083140,Abi Samra; Nicholas Camill,1,0,30,29
1657926133819,ECE 180,B00,083141,Abi Samra; Nicholas Camill,0,0,30,30
1657926139843,MATH 10A,A01,083735,Patchell; Gregory David,2,0,30,28
1657926139843,MATH 10A,A02,083736,Patchell; Gregory David,20,0,30,10
1657926139843,MATH 10A,A03,083737,Patchell; Gregory David,16,0,30,14
1657926145872,MATH 10B,A01,083207,Lim; Seonhee,8,0,34,26
1657926145872,MATH 10B,A02,083208,Lim; Seonhee,10,0,35,25
1657926145872,MATH 10B,A03,093472,Lim; Seonhee,7,0,34,27
1657926145872,MATH 10B,B01,083739,Sinha; Shubham,14,0,30,16
1657926151896,MATH 18,A01,083743,Cinel; Cameron Alexander,9,0,30,21
1657926151896,MATH 18,A02,083744,Cinel; Cameron Alexander,18,0,30,12
1657926151896,MATH 18,A03,083745,Cinel; Cameron Alexander,10,0,30,20
1657926151896,MATH 18,B01,083748,Rideout; David Porter,5,0,37,32
1657926151896,MATH 18,B02,083749,Rideout; David Porter,5,0,36,31
1657926151896,MATH 18,B03,083750,Rideout; David Porter,3,0,37,34
1657926151896,MATH 18,B04,083751,Rideout; David Porter,7,0,36,29
1657926151896,MATH 18,B05,093473,Rideout; David Porter,7,0,36,29
1657926151896,MATH 18,B06,093474,Rideout; David Porter,6,0,36,30
1657926157919,MATH 20A,A01,083754,Zheng; Zequn,14,0,40,26
1657926163945,MATH 20B,A01,083756,Briones; Jor-el Thomas Caparas,4,0,36,32
1657926163945,MATH 20B,A02,083757,Briones; Jor-el Thomas Caparas,1,0,36,35
1657926163945,MATH 20B,A03,093475,Briones; Jor-el Thomas Caparas,3,0,36,33
1657926169972,MATH 20C,A01,083760,Briones; Jor-el Thomas Caparas,1,0,35,34
1657926169972,MATH 20C,A02,083761,Briones; Jor-el Thomas Caparas,8,0,35,27
1657926169972,MATH 20C,A03,093476,Briones; Jor-el Thomas Caparas,0,1,36,36
1657926169972,MATH 20C,B01,083762,Bach; Quang Tran,1,0,30,29
1657926175997,MATH 20D,A01,083765,Tran; Brian Kha,5,0,30,25
1657926175997,MATH 20D,A02,083766,Tran; Brian Kha,5,0,30,25
1657926175997,MATH 20D,A03,083767,Tran; Brian Kha,6,0,30,24
1657926182022,MATH 20E,A01,083771,Ganguly; Soumya,12,0,32,20
1657926182022,MATH 20E,A02,083772,Ganguly; Soumya,7,0,32,25
1657926182022,MATH 20E,B01,083773,Ciotti; Benjamin,20,0,35,15
1657926182022,MATH 20E,B02,083774,Ciotti; Benjamin,18,0,35,17
1657926188047,MATH 103A,A01,083777,Greenfeld; Be'Eri,3,0,36,33
1657926188047,MATH 103A,A02,083778,Greenfeld; Be'Eri,5,0,36,31
1657926188047,MATH 103A,A03,093561,Greenfeld; Be'Eri,6,0,36,30
1657926188047,MATH 103A,B01,083779,Greenfeld; Be'Eri,8,0,36,28
1657926188047,MATH 103A,B02,083780,Greenfeld; Be'Eri,4,0,36,32
1657926188047,MATH 103A,B03,093562,Greenfeld; Be'Eri,3,0,36,33
1657926194072,MATH 105,A01,085443,Carter; Anne Toulson,15,0,35,20
1657926194072,MATH 105,A02,093477,Carter; Anne Toulson,20,0,35,15
1657926200100,MATH 109,A01,083213,Ganzberger; Geoffrey Michael,3,0,34,31
1657926200100,MATH 109,A02,083214,Ganzberger; Geoffrey Michael,4,0,34,30
1657926200100,MATH 109,A03,093478,Ganzberger; Geoffrey Michael,2,0,34,32
1657926200100,MATH 109,B01,083215,Ganzberger; Geoffrey Michael,2,0,32,30
1657926200100,MATH 109,B02,083216,Ganzberger; Geoffrey Michael,3,0,32,29
1657926200100,MATH 109,B03,093479,Ganzberger; Geoffrey Michael,8,0,32,24
1657926206139,MATH 142A,A01,083219,Chow; Bennett,7,0,32,25
1657926206139,MATH 142A,A02,083220,Chow; Bennett,10,0,32,22
1657926206139,MATH 142A,A03,093480,Chow; Bennett,9,0,32,23
1657926206139,MATH 142A,B03,093481,Chow; Bennett,8,0,32,24
1657926206139,MATH 142A,B04,093558,Chow; Bennett,13,0,32,19
1657926206139,MATH 142A,B05,093559,Chow; Bennett,7,0,32,25
1657926212163,MATH 193A,A01,083224,Rotar; Vladimir,8,0,34,26
1657926212163,MATH 193A,A02,083225,Rotar; Vladimir,10,0,34,24
1657926212163,MATH 193A,A03,083781,Rotar; Vladimir,5,0,34,29
1657926212163,MATH 193A,A04,083782,Rotar; Vladimir,11,0,34,23
1657926212163,MATH 193A,A05,093482,Rotar; Vladimir,11,0,34,23
1657926218186,MATH 197,001,091859,McAuley; Julian John,9999,0,9999,0
1657926218186,MATH 197,002,095566,Kedlaya; Kiran S.,9997,0,9999,2
1657926218186,MATH 197,003,095567,Xiao; Ming,9999,0,9999,0
1657926218186,MATH 197,004,095571,Perols; Johan Lars,9998,0,9999,1
1657926225250,COGS 9,A01,083615,Shannon; Kyle Michael,10,0,75,65
1657926231366,COGS 11,A01,083617,Boyle; Mary E. T.,23,0,48,25
1657926237395,COGS 13,A01,083071,Bastos; Amalia Pinkusfeld,12,0,71,59
1657926243417,COGS 14A,A01,092681,Semenuks; Arturs,5,1,100,95
1657926249439,COGS 14B,A01,083073,Cheng; Tzu-Han,7,0,63,56
1657926255470,COGS 17,A01,092677,Semenuks; Arturs,7,0,81,74
1657926261503,COGS 100,A01,083619,Allen; Michael Gordon,17,0,70,53
1657926267528,COGS 101A,A01,083621,Davis; Joshua Daniel,9,0,68,59
1657926273556,COGS 101B,A01,091572,Allen; Michael Gordon,14,0,65,51
1657926279582,COGS 101C,A01,083625,Delgado; Tania,17,0,35,18
1657926285612,COGS 107A,A01,083627,Boyle; Mary E. T.,14,0,60,46
1657926291634,COGS 118A,A01,083075,Gupta; Anjum,21,0,76,55
1657926297662,CSE 3,A50,083646,Miranda; Gregory Joseph,24,0,50,26
1657926303685,CSE 8A,A50,083650,Miranda; Gregory Joseph,17,1,56,39
1657926309708,CSE 11,A01,083080,Cao; Yingjun,6,15,40,34
1657926315732,CSE 12,A01,083652,Krause-Levy; Sophia Louisa,30,1,120,90
1657926321756,CSE 15L,A01,083654,Morris; Justin Loren,9,0,50,41
1657926321756,CSE 15L,A02,083655,Morris; Justin Loren,10,0,50,40
1657926327779,CSE 20,A01,083657,Tran; Khoa Dang,39,0,80,41
1657926333805,CSE 21,A01,095574,Bach; Quang Tran,23,0,48,25
1657926339829,CSE 30,A01,083084,Eldon; John,7,0,80,73
1657926339829,CSE 30,B01,095061,Bhaskar; Nishant,9,0,50,41
1657926345853,CSE 100,A01,083659,Cao; Yingjun,5,4,70,65
1657926351885,CSE 134B,A01,083661,Powell; Thomas Allan,25,0,100,75
1657926357909,CSE 140,A01,083663,Gungor; Onat,17,0,85,68
1657926363935,CSE 140L,A01,083088,Eldon; John,23,0,100,77
1657926369962,CSE 175,A01,083665,Kumar; Rakesh,3,0,25,22
1657926375983,CSE 190,A00,092507,Dubnov; Shlomo,8,0,20,12
1657926382006,ECE 45,A01,083139,Congero; Spencer William,7,0,75,68
1657926388035,ECE 65,A50,083695,Saad; Andrew S,12,0,30,18
1657926388035,ECE 65,A51,095125,Saad; Andrew S,24,0,26,2
1657926394061,ECE 109,A01,091882,Touri; Behrouz,20,0,70,50
1657926400087,ECE 180,A00,083140,Abi Samra; Nicholas Camill,1,0,30,29
1657926400087,ECE 180,B00,083141,Abi Samra; Nicholas Camill,0,0,30,30
1657926406110,MATH 10A,A01,083735,Patchell; Gregory David,2,0,30,28
1657926406110,MATH 10A,A02,083736,Patchell; Gregory David,20,0,30,10
1657926406110,MATH 10A,A03,083737,Patchell; Gregory David,16,0,30,14
1657926412140,MATH 10B,A01,083207,Lim; Seonhee,8,0,34,26
1657926412140,MATH 10B,A02,083208,Lim; Seonhee,10,0,35,25
1657926412140,MATH 10B,A03,093472,Lim; Seonhee,7,0,34,27
1657926412140,MATH 10B,B01,083739,Sinha; Shubham,14,0,30,16
1657926418168,MATH 18,A01,083743,Cinel; Cameron Alexander,9,0,30,21
1657926418168,MATH 18,A02,083744,Cinel; Cameron Alexander,18,0,30,12
1657926418168,MATH 18,A03,083745,Cinel; Cameron Alexander,10,0,30,20
1657926418168,MATH 18,B01,083748,Rideout; David Porter,5,0,37,32
1657926418168,MATH 18,B02,083749,Rideout; David Porter,5,0,36,31
1657926418168,MATH 18,B03,083750,Rideout; David Porter,3,0,37,34
1657926418168,MATH 18,B04,083751,Rideout; David Porter,7,0,36,29
1657926418168,MATH 18,B05,093473,Rideout; David Porter,7,0,36,29
1657926418168,MATH 18,B06,093474,Rideout; David Porter,6,0,36,30
1657926424191,MATH 20A,A01,083754,Zheng; Zequn,14,0,40,26
1657926430214,MATH 20B,A01,083756,Briones; Jor-el Thomas Caparas,4,0,36,32
1657926430214,MATH 20B,A02,083757,Briones; Jor-el Thomas Caparas,1,0,36,35
1657926430214,MATH 20B,A03,093475,Briones; Jor-el Thomas Caparas,3,0,36,33
1657926436242,MATH 20C,A01,083760,Briones; Jor-el Thomas Caparas,1,0,35,34
1657926436242,MATH 20C,A02,083761,Briones; Jor-el Thomas Caparas,8,0,35,27
1657926436242,MATH 20C,A03,093476,Briones; Jor-el Thomas Caparas,0,1,36,36
1657926436242,MATH 20C,B01,083762,Bach; Quang Tran,1,0,30,29
1657926442265,MATH 20D,A01,083765,Tran; Brian Kha,5,0,30,25
1657926442265,MATH 20D,A02,083766,Tran; Brian Kha,5,0,30,25
1657926442265,MATH 20D,A03,083767,Tran; Brian Kha,6,0,30,24
1657926448290,MATH 20E,A01,083771,Ganguly; Soumya,12,0,32,20
1657926448290,MATH 20E,A02,083772,Ganguly; Soumya,7,0,32,25
1657926448290,MATH 20E,B01,083773,Ciotti; Benjamin,20,0,35,15
1657926448290,MATH 20E,B02,083774,Ciotti; Benjamin,18,0,35,17
1657926454315,MATH 103A,A01,083777,Greenfeld; Be'Eri,3,0,36,33
1657926454315,MATH 103A,A02,083778,Greenfeld; Be'Eri,5,0,36,31
1657926454315,MATH 103A,A03,093561,Greenfeld; Be'Eri,6,0,36,30
1657926454315,MATH 103A,B01,083779,Greenfeld; Be'Eri,8,0,36,28
1657926454315,MATH 103A,B02,083780,Greenfeld; Be'Eri,4,0,36,32
1657926454315,MATH 103A,B03,093562,Greenfeld; Be'Eri,3,0,36,33
1657926460338,MATH 105,A01,085443,Carter; Anne Toulson,15,0,35,20
1657926460338,MATH 105,A02,093477,Carter; Anne Toulson,20,0,35,15
1657926466367,MATH 109,A01,083213,Ganzberger; Geoffrey Michael,3,0,34,31
1657926466367,MATH 109,A02,083214,Ganzberger; Geoffrey Michael,4,0,34,30
1657926466367,MATH 109,A03,093478,Ganzberger; Geoffrey Michael,2,0,34,32
1657926466367,MATH 109,B01,083215,Ganzberger; Geoffrey Michael,2,0,32,30
1657926466367,MATH 109,B02,083216,Ganzberger; Geoffrey Michael,3,0,32,29
1657926466367,MATH 109,B03,093479,Ganzberger; Geoffrey Michael,8,0,32,24
1657926472403,MATH 142A,A01,083219,Chow; Bennett,7,0,32,25
1657926472403,MATH 142A,A02,083220,Chow; Bennett,10,0,32,22
1657926472403,MATH 142A,A03,093480,Chow; Bennett,9,0,32,23
1657926472403,MATH 142A,B03,093481,Chow; Bennett,8,0,32,24
1657926472403,MATH 142A,B04,093558,Chow; Bennett,13,0,32,19
1657926472403,MATH 142A,B05,093559,Chow; Bennett,7,0,32,25
1657926478427,MATH 193A,A01,083224,Rotar; Vladimir,8,0,34,26
1657926478427,MATH 193A,A02,083225,Rotar; Vladimir,10,0,34,24
1657926478427,MATH 193A,A03,083781,Rotar; Vladimir,5,0,34,29
1657926478427,MATH 193A,A04,083782,Rotar; Vladimir,11,0,34,23
1657926478427,MATH 193A,A05,093482,Rotar; Vladimir,11,0,34,23
1657926484450,MATH 197,001,091859,McAuley; Julian John,9999,0,9999,0
1657926484450,MATH 197,002,095566,Kedlaya; Kiran S.,9997,0,9999,2
1657926484450,MATH 197,003,095567,Xiao; Ming,9999,0,9999,0
1657926484450,MATH 197,004,095571,Perols; Johan Lars,9998,0,9999,1
1657926491505,COGS 9,A01,083615,Shannon; Kyle Michael,10,0,75,65
1657926497532,COGS 11,A01,083617,Boyle; Mary E. T.,23,0,48,25
1657926503557,COGS 13,A01,083071,Bastos; Amalia Pinkusfeld,12,0,71,59
1657926509582,COGS 14A,A01,092681,Semenuks; Arturs,5,1,100,95
1657926515606,COGS 14B,A01,083073,Cheng; Tzu-Han,7,0,63,56
1657926521635,COGS 17,A01,092677,Semenuks; Arturs,7,0,81,74
1657926527658,COGS 100,A01,083619,Allen; Michael Gordon,17,0,70,53
1657926533686,COGS 101A,A01,083621,Davis; Joshua Daniel,9,0,68,59
1657926539709,COGS 101B,A01,091572,Allen; Michael Gordon,14,0,65,51
1657926545735,COGS 101C,A01,083625,Delgado; Tania,17,0,35,18
1657926551757,COGS 107A,A01,083627,Boyle; Mary E. T.,14,0,60,46
1657926557779,COGS 118A,A01,083075,Gupta; Anjum,21,0,76,55
1657926563803,CSE 3,A50,083646,Miranda; Gregory Joseph,24,0,50,26
1657926569826,CSE 8A,A50,083650,Miranda; Gregory Joseph,17,1,56,39
1657926575849,CSE 11,A01,083080,Cao; Yingjun,6,15,40,34
1657926581883,CSE 12,A01,083652,Krause-Levy; Sophia Louisa,30,1,120,90
1657926587906,CSE 15L,A01,083654,Morris; Justin Loren,9,0,50,41
1657926587906,CSE 15L,A02,083655,Morris; Justin Loren,10,0,50,40
1657926593929,CSE 20,A01,083657,Tran; Khoa Dang,39,0,80,41
1657926599952,CSE 21,A01,095574,Bach; Quang Tran,23,0,48,25
1657926605981,CSE 30,A01,083084,Eldon; John,7,0,80,73
1657926605981,CSE 30,B01,095061,Bhaskar; Nishant,9,0,50,41
1657926612006,CSE 100,A01,083659,Cao; Yingjun,5,4,70,65
1657926618028,CSE 134B,A01,083661,Powell; Thomas Allan,25,0,100,75
1657926624052,CSE 140,A01,083663,Gungor; Onat,17,0,85,68
1657926630076,CSE 140L,A01,083088,Eldon; John,23,0,100,77
1657926636103,CSE 175,A01,083665,Kumar; Rakesh,3,0,25,22
1657926642125,CSE 190,A00,092507,Dubnov; Shlomo,8,0,20,12
1657926648159,ECE 45,A01,083139,Congero; Spencer William,7,0,75,68
1657926654183,ECE 65,A50,083695,Saad; Andrew S,12,0,30,18
1657926654183,ECE 65,A51,095125,Saad; Andrew S,24,0,26,2
1657926660213,ECE 109,A01,091882,Touri; Behrouz,20,0,70,50
1657926666239,ECE 180,A00,083140,Abi Samra; Nicholas Camill,1,0,30,29
1657926666239,ECE 180,B00,083141,Abi Samra; Nicholas Camill,0,0,30,30
1657926672271,MATH 10A,A01,083735,Patchell; Gregory David,2,0,30,28
1657926672271,MATH 10A,A02,083736,Patchell; Gregory David,20,0,30,10
1657926672271,MATH 10A,A03,083737,Patchell; Gregory David,16,0,30,14
1657926678299,MATH 10B,A01,083207,Lim; Seonhee,8,0,34,26
1657926678299,MATH 10B,A02,083208,Lim; Seonhee,10,0,35,25
1657926678299,MATH 10B,A03,093472,Lim; Seonhee,7,0,34,27
1657926678299,MATH 10B,B01,083739,Sinha; Shubham,14,0,30,16
1657926684330,MATH 18,A01,083743,Cinel; Cameron Alexander,9,0,30,21
1657926684330,MATH 18,A02,083744,Cinel; Cameron Alexander,18,0,30,12
1657926684330,MATH 18,A03,083745,Cinel; Cameron Alexander,10,0,30,20
1657926684330,MATH 18,B01,083748,Rideout; David Porter,5,0,37,32
1657926684330,MATH 18,B02,083749,Rideout; David Porter,5,0,36,31
1657926684330,MATH 18,B03,083750,Rideout; David Porter,3,0,37,34
1657926684330,MATH 18,B04,083751,Rideout; David Porter,7,0,36,29
1657926684330,MATH 18,B05,093473,Rideout; David Porter,7,0,36,29
1657926684330,MATH 18,B06,093474,Rideout; David Porter,6,0,36,30
1657926690353,MATH 20A,A01,083754,Zheng; Zequn,14,0,40,26
1657926696381,MATH 20B,A01,083756,Briones; Jor-el Thomas Caparas,4,0,36,32
1657926696381,MATH 20B,A02,083757,Briones; Jor-el Thomas Caparas,1,0,36,35
1657926696381,MATH 20B,A03,093475,Briones; Jor-el Thomas Caparas,3,0,36,33
1657926702405,MATH 20C,A01,083760,Briones; Jor-el Thomas Caparas,1,0,35,34
1657926702405,MATH 20C,A02,083761,Briones; Jor-el Thomas Caparas,8,0,35,27
1657926702405,MATH 20C,A03,093476,Briones; Jor-el Thomas Caparas,0,1,36,36
1657926702405,MATH 20C,B01,083762,Bach; Quang Tran,1,0,30,29
1657926708427,MATH 20D,A01,083765,Tran; Brian Kha,5,0,30,25
1657926708427,MATH 20D,A02,083766,Tran; Brian Kha,5,0,30,25
1657926708427,MATH 20D,A03,083767,Tran; Brian Kha,6,0,30,24
1657926714474,MATH 20E,A01,083771,Ganguly; Soumya,12,0,32,20
1657926714474,MATH 20E,A02,083772,Ganguly; Soumya,7,0,32,25
1657926714474,MATH 20E,B01,083773,Ciotti; Benjamin,20,0,35,15
1657926714474,MATH 20E,B02,083774,Ciotti; Benjamin,18,0,35,17
1657926720505,MATH 103A,A01,083777,Greenfeld; Be'Eri,3,0,36,33
1657926720505,MATH 103A,A02,083778,Greenfeld; Be'Eri,5,0,36,31
1657926720505,MATH 103A,A03,093561,Greenfeld; Be'Eri,6,0,36,30
1657926720505,MATH 103A,B01,083779,Greenfeld; Be'Eri,8,0,36,28
1657926720505,MATH 103A,B02,083780,Greenfeld; Be'Eri,4,0,36,32
1657926720505,MATH 103A,B03,093562,Greenfeld; Be'Eri,3,0,36,33
1657926726532,MATH 105,A01,085443,Carter; Anne Toulson,15,0,35,20
1657926726532,MATH 105,A02,093477,Carter; Anne Toulson,20,0,35,15
1657926732557,MATH 109,A01,083213,Ganzberger; Geoffrey Michael,3,0,34,31
1657926732557,MATH 109,A02,083214,Ganzberger; Geoffrey Michael,4,0,34,30
1657926732557,MATH 109,A03,093478,Ganzberger; Geoffrey Michael,2,0,34,32
1657926732557,MATH 109,B01,083215,Ganzberger; Geoffrey Michael,2,0,32,30
1657926732557,MATH 109,B02,083216,Ganzberger; Geoffrey Michael,3,0,32,29
1657926732557,MATH 109,B03,093479,Ganzberger; Geoffrey Michael,8,0,32,24
1657926738581,MATH 142A,A01,083219,Chow; Bennett,7,0,32,25
1657926738581,MATH 142A,A02,083220,Chow; Bennett,10,0,32,22
1657926738581,MATH 142A,A03,093480,Chow; Bennett,9,0,32,23
1657926738581,MATH 142A,B03,093481,Chow; Bennett,8,0,32,24
1657926738581,MATH 142A,B04,093558,Chow; Bennett,13,0,32,19
1657926738581,MATH 142A,B05,093559,Chow; Bennett,7,0,32,25
1657926744617,MATH 193A,A01,083224,Rotar; Vladimir,8,0,34,26
1657926744617,MATH 193A,A02,083225,Rotar; Vladimir,10,0,34,24
1657926744617,MATH 193A,A03,083781,Rotar; Vladimir,5,0,34,29
1657926744617,MATH 193A,A04,083782,Rotar; Vladimir,11,0,34,23
1657926744617,MATH 193A,A05,093482,Rotar; Vladimir,11,0,34,23
1657926750660,MATH 197,001,091859,McAuley; Julian John,9999,0,9999,0
1657926750660,MATH 197,002,095566,Kedlaya; Kiran S.,9997,0,9999,2
1657926750660,MATH 197,003,095567,Xiao; Ming,9999,0,9999,0
1657926750660,MATH 197,004,095571,Perols; Johan Lars,9998,0,9999,1
1657926757724,COGS 9,A01,083615,Shannon; Kyle Michael,10,0,75,65
1657926763750,COGS 11,A01,083617,Boyle; Mary E. T.,23,0,48,25
1657926769774,COGS 13,A01,083071,Bastos; Amalia Pinkusfeld,12,0,71,59
1657926775801,COGS 14A,A01,092681,Semenuks; Arturs,5,1,100,95
1657926781827,COGS 14B,A01,083073,Cheng; Tzu-Han,7,0,63,56
1657926787853,COGS 17,A01,092677,Semenuks; Arturs,7,0,81,74
1657926793880,COGS 100,A01,083619,Allen; Michael Gordon,17,0,70,53
1657926799903,COGS 101A,A01,083621,Davis; Joshua Daniel,9,0,68,59
1657926805926,COGS 101B,A01,091572,Allen; Michael Gordon,14,0,65,51
1657926811949,COGS 101C,A01,083625,Delgado; Tania,17,0,35,18
1657926817985,COGS 107A,A01,083627,Boyle; Mary E. T.,14,0,60,46
1657926824007,COGS 118A,A01,083075,Gupta; Anjum,21,0,76,55
1657926830108,CSE 3,A50,083646,Miranda; Gregory Joseph,24,0,50,26
1657926836134,CSE 8A,A50,083650,Miranda; Gregory Joseph,17,1,56,39
1657926842160,CSE 11,A01,083080,Cao; Yingjun,6,15,40,34
1657926848188,CSE 12,A01,083652,Krause-Levy; Sophia Louisa,30,1,120,90
1657926854211,CSE 15L,A01,083654,Morris; Justin Loren,9,0,50,41
1657926854211,CSE 15L,A02,083655,Morris; Justin Loren,10,0,50,40
1657926860237,CSE 20,A01,083657,Tran; Khoa Dang,39,0,80,41
1657926866261,CSE 21,A01,095574,Bach; Quang Tran,23,0,48,25
1657926872288,CSE 30,A01,083084,Eldon; John,7,0,80,73
1657926872288,CSE 30,B01,095061,Bhaskar; Nishant,9,0,50,41
1657926878310,CSE 100,A01,083659,Cao; Yingjun,5,4,70,65
1657926884339,CSE 134B,A01,083661,Powell; Thomas Allan,25,0,100,75
1657926890365,CSE 140,A01,083663,Gungor; Onat,17,0,85,68
1657926896388,CSE 140L,A01,083088,Eldon; John,23,0,100,77
1657926902411,CSE 175,A01,083665,Kumar; Rakesh,3,0,25,22
1657926908435,CSE 190,A00,092507,Dubnov; Shlomo,8,0,20,12
1657926914458,ECE 45,A01,083139,Congero; Spencer William,7,0,75,68
1657926920486,ECE 65,A50,083695,Saad; Andrew S,12,0,30,18
1657926920486,ECE 65,A51,095125,Saad; Andrew S,24,0,26,2
1657926926509,ECE 109,A01,091882,Touri; Behrouz,20,0,70,50
1657926932532,ECE 180,A00,083140,Abi Samra; Nicholas Camill,1,0,30,29
1657926932532,ECE 180,B00,083141,Abi Samra; Nicholas Camill,0,0,30,30
1657926938562,MATH 10A,A01,083735,Patchell; Gregory David,2,0,30,28
1657926938562,MATH 10A,A02,083736,Patchell; Gregory David,20,0,30,10
1657926938562,MATH 10A,A03,083737,Patchell; Gregory David,16,0,30,14
1657926944586,MATH 10B,A01,083207,Lim; Seonhee,8,0,34,26
1657926944586,MATH 10B,A02,083208,Lim; Seonhee,10,0,35,25
1657926944586,MATH 10B,A03,093472,Lim; Seonhee,7,0,34,27
1657926944586,MATH 10B,B01,083739,Sinha; Shubham,14,0,30,16
1657926950619,MATH 18,A01,083743,Cinel; Cameron Alexander,9,0,30,21
1657926950619,MATH 18,A02,083744,Cinel; Cameron Alexander,18,0,30,12
1657926950619,MATH 18,A03,083745,Cinel; Cameron Alexander,10,0,30,20
1657926950619,MATH 18,B01,083748,Rideout; David Porter,5,0,37,32
1657926950619,MATH 18,B02,083749,Rideout; David Porter,5,0,36,31
1657926950619,MATH 18,B03,083750,Rideout; David Porter,3,0,37,34
1657926950619,MATH 18,B04,083751,Rideout; David Porter,7,0,36,29
1657926950619,MATH 18,B05,093473,Rideout; David Porter,7,0,36,29
1657926950619,MATH 18,B06,093474,Rideout; David Porter,6,0,36,30
1657926956642,MATH 20A,A01,083754,Zheng; Zequn,14,0,40,26
1657926962675,MATH 20B,A01,083756,Briones; Jor-el Thomas Caparas,4,0,36,32
1657926962675,MATH 20B,A02,083757,Briones; Jor-el Thomas Caparas,1,0,36,35
1657926962675,MATH 20B,A03,093475,Briones; Jor-el Thomas Caparas,3,0,36,33
1657926968704,MATH 20C,A01,083760,Briones; Jor-el Thomas Caparas,1,0,35,34
1657926968704,MATH 20C,A02,083761,Briones; Jor-el Thomas Caparas,8,0,35,27
1657926968704,MATH 20C,A03,093476,Briones; Jor-el Thomas Caparas,0,1,36,36
1657926968704,MATH 20C,B01,083762,Bach; Quang Tran,1,0,30,29
1657926974728,MATH 20D,A01,083765,Tran; Brian Kha,5,0,30,25
1657926974728,MATH 20D,A02,083766,Tran; Brian Kha,5,0,30,25
1657926974728,MATH 20D,A03,083767,Tran; Brian Kha,6,0,30,24
1657926980751,MATH 20E,A01,083771,Ganguly; Soumya,12,0,32,20
1657926980751,MATH 20E,A02,083772,Ganguly; Soumya,7,0,32,25
1657926980751,MATH 20E,B01,083773,Ciotti; Benjamin,20,0,35,15
1657926980751,MATH 20E,B02,083774,Ciotti; Benjamin,18,0,35,17
1657926986779,MATH 103A,A01,083777,Greenfeld; Be'Eri,3,0,36,33
1657926986779,MATH 103A,A02,083778,Greenfeld; Be'Eri,5,0,36,31
1657926986779,MATH 103A,A03,093561,Greenfeld; Be'Eri,6,0,36,30
1657926986779,MATH 103A,B01,083779,Greenfeld; Be'Eri,8,0,36,28
1657926986779,MATH 103A,B02,083780,Greenfeld; Be'Eri,4,0,36,32
1657926986779,MATH 103A,B03,093562,Greenfeld; Be'Eri,3,0,36,33
1657926992810,MATH 105,A01,085443,Carter; Anne Toulson,15,0,35,20
1657926992810,MATH 105,A02,093477,Carter; Anne Toulson,20,0,35,15
1657926998834,MATH 109,A01,083213,Ganzberger; Geoffrey Michael,3,0,34,31
1657926998834,MATH 109,A02,083214,Ganzberger; Geoffrey Michael,4,0,34,30
1657926998834,MATH 109,A03,093478,Ganzberger; Geoffrey Michael,2,0,34,32
1657926998834,MATH 109,B01,083215,Ganzberger; Geoffrey Michael,2,0,32,30
1657926998834,MATH 109,B02,083216,Ganzberger; Geoffrey Michael,3,0,32,29
1657926998834,MATH 109,B03,093479,Ganzberger; Geoffrey Michael,8,0,32,24
1657927004858,MATH 142A,A01,083219,Chow; Bennett,7,0,32,25
1657927004858,MATH 142A,A02,083220,Chow; Bennett,10,0,32,22
1657927004858,MATH 142A,A03,093480,Chow; Bennett,9,0,32,23
1657927004858,MATH 142A,B03,093481,Chow; Bennett,8,0,32,24
1657927004858,MATH 142A,B04,093558,Chow; Bennett,13,0,32,19
1657927004858,MATH 142A,B05,093559,Chow; Bennett,7,0,32,25
1657927010886,MATH 193A,A01,083224,Rotar; Vladimir,8,0,34,26
1657927010886,MATH 193A,A02,083225,Rotar; Vladimir,10,0,34,24
1657927010886,MATH 193A,A03,083781,Rotar; Vladimir,5,0,34,29
1657927010886,MATH 193A,A04,083782,Rotar; Vladimir,11,0,34,23
1657927010886,MATH 193A,A05,093482,Rotar; Vladimir,11,0,34,23
1657927016911,MATH 197,001,091859,McAuley; Julian John,9999,0,9999,0
1657927016911,MATH 197,002,095566,Kedlaya; Kiran S.,9997,0,9999,2
1657927016911,MATH 197,003,095567,Xiao; Ming,9999,0,9999,0
1657927016911,MATH 197,004,095571,Perols; Johan Lars,9998,0,9999,1
1657927023980,COGS 9,A01,083615,Shannon; Kyle Michael,10,0,75,65
1657927030004,COGS 11,A01,083617,Boyle; Mary E. T.,23,0,48,25
1657927036029,COGS 13,A01,083071,Bastos; Amalia Pinkusfeld,12,0,71,59
1657927042053,COGS 14A,A01,092681,Semenuks; Arturs,5,1,100,95
1657927048077,COGS 14B,A01,083073,Cheng; Tzu-Han,7,0,63,56
1657927054101,COGS 17,A01,092677,Semenuks; Arturs,7,0,81,74
1657927060124,COGS 100,A01,083619,Allen; Michael Gordon,17,0,70,53
1657927066149,COGS 101A,A01,083621,Davis; Joshua Daniel,9,0,68,59
1657927072174,COGS 101B,A01,091572,Allen; Michael Gordon,14,0,65,51
1657927078201,COGS 101C,A01,083625,Delgado; Tania,17,0,35,18
1657927084228,COGS 107A,A01,083627,Boyle; Mary E. T.,14,0,60,46
1657927090254,COGS 118A,A01,083075,Gupta; Anjum,21,0,76,55
1657927096278,CSE 3,A50,083646,Miranda; Gregory Joseph,24,0,50,26
1657927102305,CSE 8A,A50,083650,Miranda; Gregory Joseph,17,1,56,39
1657927108339,CSE 11,A01,083080,Cao; Yingjun,6,15,40,34
1657927114366,CSE 12,A01,083652,Krause-Levy; Sophia Louisa,30,1,120,90
1657927120390,CSE 15L,A01,083654,Morris; Justin Loren,9,0,50,41
1657927120390,CSE 15L,A02,083655,Morris; Justin Loren,10,0,50,40
1657927126413,CSE 20,A01,083657,Tran; Khoa Dang,39,0,80,41
1657927132437,CSE 21,A01,095574,Bach; Quang Tran,23,0,48,25
1657927138461,CSE 30,A01,083084,Eldon; John,7,0,80,73
1657927138461,CSE 30,B01,095061,Bhaskar; Nishant,9,0,50,41
1657927144487,CSE 100,A01,083659,Cao; Yingjun,5,4,70,65
1657927150515,CSE 134B,A01,083661,Powell; Thomas Allan,25,0,100,75
1657927156539,CSE 140,A01,083663,Gungor; Onat,17,0,85,68
1657927162567,CSE 140L,A01,083088,Eldon; John,23,0,100,77
1657927168591,CSE 175,A01,083665,Kumar; Rakesh,3,0,25,22
1657927174616,CSE 190,A00,092507,Dubnov; Shlomo,8,0,20,12
1657927180641,ECE 45,A01,083139,Congero; Spencer William,7,0,75,68
1657927186666,ECE 65,A50,083695,Saad; Andrew S,12,0,30,18
1657927186666,ECE 65,A51,095125,Saad; Andrew S,24,0,26,2
1657927192689,ECE 109,A01,091882,Touri; Behrouz,20,0,70,50
1657927198710,ECE 180,A00,083140,Abi Samra; Nicholas Camill,1,0,30,29
1657927198710,ECE 180,B00,083141,Abi Samra; Nicholas Camill,0,0,30,30
1657927204742,MATH 10A,A01,083735,Patchell; Gregory David,2,0,30,28
1657927204742,MATH 10A,A02,083736,Patchell; Gregory David,20,0,30,10
1657927204742,MATH 10A,A03,083737,Patchell; Gregory David,16,0,30,14
1657927210785,MATH 10B,A01,083207,Lim; Seonhee,8,0,34,26
1657927210785,MATH 10B,A02,083208,Lim; Seonhee,10,0,35,25
1657927210785,MATH 10B,A03,093472,Lim; Seonhee,7,0,34,27
1657927210785,MATH 10B,B01,083739,Sinha; Shubham,14,0,30,16
1657927216815,MATH 18,A01,083743,Cinel; Cameron Alexander,9,0,30,21
1657927216815,MATH 18,A02,083744,Cinel; Cameron Alexander,18,0,30,12
1657927216815,MATH 18,A03,083745,Cinel; Cameron Alexander,10,0,30,20
1657927216815,MATH 18,B01,083748,Rideout; David Porter,5,0,37,32
1657927216815,MATH 18,B02,083749,Rideout; David Porter,5,0,36,31
1657927216815,MATH 18,B03,083750,Rideout; David Porter,3,0,37,34
1657927216815,MATH 18,B04,083751,Rideout; David Porter,7,0,36,29
1657927216815,MATH 18,B05,093473,Rideout; David Porter,7,0,36,29
1657927216815,MATH 18,B06,093474,Rideout; David Porter,6,0,36,30
1657927222845,MATH 20A,A01,083754,Zheng; Zequn,14,0,40,26
1657927228868,MATH 20B,A01,083756,Briones; Jor-el Thomas Caparas,4,0,36,32
1657927228868,MATH 20B,A02,083757,Briones; Jor-el Thomas Caparas,1,0,36,35
1657927228868,MATH 20B,A03,093475,Briones; Jor-el Thomas Caparas,3,0,36,33
1657927234890,MATH 20C,A01,083760,Briones; Jor-el Thomas Caparas,1,0,35,34
1657927234890,MATH 20C,A02,083761,Briones; Jor-el Thomas Caparas,8,0,35,27
1657927234890,MATH 20C,A03,093476,Briones; Jor-el Thomas Caparas,0,1,36,36
1657927234890,MATH 20C,B01,083762,Bach; Quang Tran,1,0,30,29
1657927240915,MATH 20D,A01,083765,Tran; Brian Kha,5,0,30,25
1657927240915,MATH 20D,A02,083766,Tran; Brian Kha,5,0,30,25
1657927240915,MATH 20D,A03,083767,Tran; Brian Kha,6,0,30,24
1657927246939,MATH 20E,A01,083771,Ganguly; Soumya,12,0,32,20
1657927246939,MATH 20E,A02,083772,Ganguly; Soumya,7,0,32,25
1657927246939,MATH 20E,B01,083773,Ciotti; Benjamin,20,0,35,15
1657927246939,MATH 20E,B02,083774,Ciotti; Benjamin,18,0,35,17
1657927252965,MATH 103A,A01,083777,Greenfeld; Be'Eri,3,0,36,33
1657927252965,MATH 103A,A02,083778,Greenfeld; Be'Eri,5,0,36,31
1657927252965,MATH 103A,A03,093561,Greenfeld; Be'Eri,6,0,36,30
1657927252965,MATH 103A,B01,083779,Greenfeld; Be'Eri,8,0,36,28
1657927252965,MATH 103A,B02,083780,Greenfeld; Be'Eri,4,0,36,32
1657927252965,MATH 103A,B03,093562,Greenfeld; Be'Eri,3,0,36,33
1657927258988,MATH 105,A01,085443,Carter; Anne Toulson,15,0,35,20
1657927258988,MATH 105,A02,093477,Carter; Anne Toulson,20,0,35,15
1657927265017,MATH 109,A01,083213,Ganzberger; Geoffrey Michael,3,0,34,31
1657927265017,MATH 109,A02,083214,Ganzberger; Geoffrey Michael,4,0,34,30
1657927265017,MATH 109,A03,093478,Ganzberger; Geoffrey Michael,2,0,34,32
1657927265017,MATH 109,B01,083215,Ganzberger; Geoffrey Michael,2,0,32,30
1657927265017,MATH 109,B02,083216,Ganzberger; Geoffrey Michael,3,0,32,29
1657927265017,MATH 109,B03,093479,Ganzberger; Geoffrey Michael,8,0,32,24
1657927271046,MATH 142A,A01,083219,Chow; Bennett,7,0,32,25
1657927271046,MATH 142A,A02,083220,Chow; Bennett,10,0,32,22
1657927271046,MATH 142A,A03,093480,Chow; Bennett,9,0,32,23
1657927271046,MATH 142A,B03,093481,Chow; Bennett,8,0,32,24
1657927271046,MATH 142A,B04,093558,Chow; Bennett,13,0,32,19
1657927271046,MATH 142A,B05,093559,Chow; Bennett,7,0,32,25
1657927277069,MATH 193A,A01,083224,Rotar; Vladimir,8,0,34,26
1657927277069,MATH 193A,A02,083225,Rotar; Vladimir,10,0,34,24
1657927277069,MATH 193A,A03,083781,Rotar; Vladimir,5,0,34,29
1657927277069,MATH 193A,A04,083782,Rotar; Vladimir,11,0,34,23
1657927277069,MATH 193A,A05,093482,Rotar; Vladimir,11,0,34,23
1657927283092,MATH 197,001,091859,McAuley; Julian John,9999,0,9999,0
1657927283092,MATH 197,002,095566,Kedlaya; Kiran S.,9997,0,9999,2
1657927283092,MATH 197,003,095567,Xiao; Ming,9999,0,9999,0
1657927283092,MATH 197,004,095571,Perols; Johan Lars,9998,0,9999,1
1657927290150,COGS 9,A01,083615,Shannon; Kyle Michael,10,0,75,65
1657927296180,COGS 11,A01,083617,Boyle; Mary E. T.,23,0,48,25
1657927302256,COGS 13,A01,083071,Bastos; Amalia Pinkusfeld,12,0,71,59
1657927308316,COGS 14A,A01,092681,Semenuks; Arturs,5,1,100,95
1657927314345,COGS 14B,A01,083073,Cheng; Tzu-Han,7,0,63,56
1657927320376,COGS 17,A01,092677,Semenuks; Arturs,7,0,81,74
1657927326400,COGS 100,A01,083619,Allen; Michael Gordon,17,0,70,53
1657927332424,COGS 101A,A01,083621,Davis; Joshua Daniel,9,0,68,59
1657927338448,COGS 101B,A01,091572,Allen; Michael Gordon,14,0,65,51
1657927344471,COGS 101C,A01,083625,Delgado; Tania,17,0,35,18
1657927350499,COGS 107A,A01,083627,Boyle; Mary E. T.,14,0,60,46
1657927356524,COGS 118A,A01,083075,Gupta; Anjum,21,0,76,55
1657927362551,CSE 3,A50,083646,Miranda; Gregory Joseph,24,0,50,26
1657927368573,CSE 8A,A50,083650,Miranda; Gregory Joseph,17,1,56,39
1657927374601,CSE 11,A01,083080,Cao; Yingjun,6,15,40,34
1657927380625,CSE 12,A01,083652,Krause-Levy; Sophia Louisa,30,1,120,90
1657927386652,CSE 15L,A01,083654,Morris; Justin Loren,9,0,50,41
1657927386652,CSE 15L,A02,083655,Morris; Justin Loren,10,0,50,40
1657927392675,CSE 20,A01,083657,Tran; Khoa Dang,39,0,80,41
1657927398701,CSE 21,A01,095574,Bach; Quang Tran,23,0,48,25
1657927404729,CSE 30,A01,083084,Eldon; John,7,0,80,73
1657927404729,CSE 30,B01,095061,Bhaskar; Nishant,9,0,50,41
1657927410752,CSE 100,A01,083659,Cao; Yingjun,5,4,70,65
1657927416780,CSE 134B,A01,083661,Powell; Thomas Allan,25,0,100,75
1657927422803,CSE 140,A01,083663,Gungor; Onat,17,0,85,68
1657927428913,CSE 140L,A01,083088,Eldon; John,23,0,100,77
1657927434949,CSE 175,A01,083665,Kumar; Rakesh,3,0,25,22
1657927440971,CSE 190,A00,092507,Dubnov; Shlomo,8,0,20,12
1657927446996,ECE 45,A01,083139,Congero; Spencer William,7,0,75,68
1657927453020,ECE 65,A50,083695,Saad; Andrew S,12,0,30,18
1657927453020,ECE 65,A51,095125,Saad; Andrew S,24,0,26,2
1657927459053,ECE 109,A01,091882,Touri; Behrouz,20,0,70,50
1657927465082,ECE 180,A00,083140,Abi Samra; Nicholas Camill,1,0,30,29
1657927465082,ECE 180,B00,083141,Abi Samra; Nicholas Camill,0,0,30,30
1657927471105,MATH 10A,A01,083735,Patchell; Gregory David,2,0,30,28
1657927471105,MATH 10A,A02,083736,Patchell; Gregory David,20,0,30,10
1657927471105,MATH 10A,A03,083737,Patchell; Gregory David,16,0,30,14
1657927477134,MATH 10B,A01,083207,Lim; Seonhee,8,0,34,26
1657927477134,MATH 10B,A02,083208,Lim; Seonhee,10,0,35,25
1657927477134,MATH 10B,A03,093472,Lim; Seonhee,7,0,34,27
1657927477134,MATH 10B,B01,083739,Sinha; Shubham,14,0,30,16
1657927483171,MATH 18,A01,083743,Cinel; Cameron Alexander,9,0,30,21
1657927483171,MATH 18,A02,083744,Cinel; Cameron Alexander,18,0,30,12
1657927483171,MATH 18,A03,083745,Cinel; Cameron Alexander,10,0,30,20
1657927483171,MATH 18,B01,083748,Rideout; David Porter,5,0,37,32
1657927483171,MATH 18,B02,083749,Rideout; David Porter,5,0,36,31
1657927483171,MATH 18,B03,083750,Rideout; David Porter,3,0,37,34
1657927483171,MATH 18,B04,083751,Rideout; David Porter,7,0,36,29
1657927483171,MATH 18,B05,093473,Rideout; David Porter,7,0,36,29
1657927483171,MATH 18,B06,093474,Rideout; David Porter,6,0,36,30
1657927489194,MATH 20A,A01,083754,Zheng; Zequn,14,0,40,26
1657927495221,MATH 20B,A01,083756,Briones; Jor-el Thomas Caparas,4,0,36,32
1657927495221,MATH 20B,A02,083757,Briones; Jor-el Thomas Caparas,1,0,36,35
1657927495221,MATH 20B,A03,093475,Briones; Jor-el Thomas Caparas,3,0,36,33
1657927501251,MATH 20C,A01,083760,Briones; Jor-el Thomas Caparas,1,0,35,34
1657927501251,MATH 20C,A02,083761,Briones; Jor-el Thomas Caparas,8,0,35,27
1657927501251,MATH 20C,A03,093476,Briones; Jor-el Thomas Caparas,0,1,36,36
1657927501251,MATH 20C,B01,083762,Bach; Quang Tran,1,0,30,29
1657927507277,MATH 20D,A01,083765,Tran; Brian Kha,5,0,30,25
1657927507277,MATH 20D,A02,083766,Tran; Brian Kha,5,0,30,25
1657927507277,MATH 20D,A03,083767,Tran; Brian Kha,6,0,30,24
1657927513307,MATH 20E,A01,083771,Ganguly; Soumya,12,0,32,20
1657927513307,MATH 20E,A02,083772,Ganguly; Soumya,7,0,32,25
1657927513307,MATH 20E,B01,083773,Ciotti; Benjamin,20,0,35,15
1657927513307,MATH 20E,B02,083774,Ciotti; Benjamin,18,0,35,17
1657927519331,MATH 103A,A01,083777,Greenfeld; Be'Eri,3,0,36,33
1657927519331,MATH 103A,A02,083778,Greenfeld; Be'Eri,5,0,36,31
1657927519331,MATH 103A,A03,093561,Greenfeld; Be'Eri,6,0,36,30
1657927519331,MATH 103A,B01,083779,Greenfeld; Be'Eri,8,0,36,28
1657927519331,MATH 103A,B02,083780,Greenfeld; Be'Eri,4,0,36,32
1657927519331,MATH 103A,B03,093562,Greenfeld; Be'Eri,3,0,36,33
1657927525354,MATH 105,A01,085443,Carter; Anne Toulson,15,0,35,20
1657927525354,MATH 105,A02,093477,Carter; Anne Toulson,20,0,35,15
1657927531385,MATH 109,A01,083213,Ganzberger; Geoffrey Michael,3,0,34,31
1657927531385,MATH 109,A02,083214,Ganzberger; Geoffrey Michael,4,0,34,30
1657927531385,MATH 109,A03,093478,Ganzberger; Geoffrey Michael,2,0,34,32
1657927531385,MATH 109,B01,083215,Ganzberger; Geoffrey Michael,2,0,32,30
1657927531385,MATH 109,B02,083216,Ganzberger; Geoffrey Michael,3,0,32,29
1657927531385,MATH 109,B03,093479,Ganzberger; Geoffrey Michael,8,0,32,24
1657927537416,MATH 142A,A01,083219,Chow; Bennett,7,0,32,25
1657927537416,MATH 142A,A02,083220,Chow; Bennett,10,0,32,22
1657927537416,MATH 142A,A03,093480,Chow; Bennett,9,0,32,23
1657927537416,MATH 142A,B03,093481,Chow; Bennett,8,0,32,24
1657927537416,MATH 142A,B04,093558,Chow; Bennett,13,0,32,19
1657927537416,MATH 142A,B05,093559,Chow; Bennett,7,0,32,25
1657927543445,MATH 193A,A01,083224,Rotar; Vladimir,8,0,34,26
1657927543445,MATH 193A,A02,083225,Rotar; Vladimir,10,0,34,24
1657927543445,MATH 193A,A03,083781,Rotar; Vladimir,5,0,34,29
1657927543445,MATH 193A,A04,083782,Rotar; Vladimir,11,0,34,23
1657927543445,MATH 193A,A05,093482,Rotar; Vladimir,11,0,34,23
1657927549468,MATH 197,001,091859,McAuley; Julian John,9999,0,9999,0
1657927549468,MATH 197,002,095566,Kedlaya; Kiran S.,9997,0,9999,2
1657927549468,MATH 197,003,095567,Xiao; Ming,9999,0,9999,0
1657927549468,MATH 197,004,095571,Perols; Johan Lars,9998,0,9999,1
1657927556530,COGS 9,A01,083615,Shannon; Kyle Michael,10,0,75,65
1657927562567,COGS 11,A01,083617,Boyle; Mary E. T.,23,0,48,25
1657927568590,COGS 13,A01,083071,Bastos; Amalia Pinkusfeld,12,0,71,59
1657927574618,COGS 14A,A01,092681,Semenuks; Arturs,5,1,100,95
1657927580647,COGS 14B,A01,083073,Cheng; Tzu-Han,7,0,63,56
1657927586680,COGS 17,A01,092677,Semenuks; Arturs,7,0,81,74
1657927592707,COGS 100,A01,083619,Allen; Michael Gordon,17,0,70,53
1657927598739,COGS 101A,A01,083621,Davis; Joshua Daniel,9,0,68,59
1657927604762,COGS 101B,A01,091572,Allen; Michael Gordon,14,0,65,51
1657927610789,COGS 101C,A01,083625,Delgado; Tania,17,0,35,18
1657927616811,COGS 107A,A01,083627,Boyle; Mary E. T.,14,0,60,46
1657927622834,COGS 118A,A01,083075,Gupta; Anjum,21,0,76,55
1657927628865,CSE 3,A50,083646,Miranda; Gregory Joseph,24,0,50,26
1657927634893,CSE 8A,A50,083650,Miranda; Gregory Joseph,17,1,56,39
1657927640917,CSE 11,A01,083080,Cao; Yingjun,6,15,40,34
1657927646940,CSE 12,A01,083652,Krause-Levy; Sophia Louisa,30,1,120,90
1657927652966,CSE 15L,A01,083654,Morris; Justin Loren,9,0,50,41
1657927652966,CSE 15L,A02,083655,Morris; Justin Loren,10,0,50,40
1657927658992,CSE 20,A01,083657,Tran; Khoa Dang,39,0,80,41
1657927665027,CSE 21,A01,095574,Bach; Quang Tran,23,0,48,25
1657927671054,CSE 30,A01,083084,Eldon; John,7,0,80,73
1657927671054,CSE 30,B01,095061,Bhaskar; Nishant,9,0,50,41
1657927677077,CSE 100,A01,083659,Cao; Yingjun,5,4,70,65
1657927683099,CSE 134B,A01,083661,Powell; Thomas Allan,25,0,100,75
1657927689123,CSE 140,A01,083663,Gungor; Onat,17,0,85,68
1657927695149,CSE 140L,A01,083088,Eldon; John,23,0,100,77
1657927701171,CSE 175,A01,083665,Kumar; Rakesh,3,0,25,22
1657927707199,CSE 190,A00,092507,Dubnov; Shlomo,8,0,20,12
1657927713223,ECE 45,A01,083139,Congero; Spencer William,7,0,75,68
1657927719247,ECE 65,A50,083695,Saad; Andrew S,12,0,30,18
1657927719247,ECE 65,A51,095125,Saad; Andrew S,24,0,26,2
1657927725289,ECE 109,A01,091882,Touri; Behrouz,20,0,70,50
1657927731315,ECE 180,A00,083140,Abi Samra; Nicholas Camill,1,0,30,29
1657927731315,ECE 180,B00,083141,Abi Samra; Nicholas Camill,0,0,30,30
1657927746421,MATH 10A,A01,083735,Patchell; Gregory David,2,0,30,28
1657927746421,MATH 10A,A02,083736,Patchell; Gregory David,20,0,30,10
1657927746421,MATH 10A,A03,083737,Patchell; Gregory David,16,0,30,14
1657927752452,MATH 10B,A01,083207,Lim; Seonhee,8,0,34,26
1657927752452,MATH 10B,A02,083208,Lim; Seonhee,10,0,35,25
1657927752452,MATH 10B,A03,093472,Lim; Seonhee,7,0,34,27
1657927752452,MATH 10B,B01,083739,Sinha; Shubham,14,0,30,16
1657927758482,MATH 18,A01,083743,Cinel; Cameron Alexander,9,0,30,21
1657927758482,MATH 18,A02,083744,Cinel; Cameron Alexander,18,0,30,12
1657927758482,MATH 18,A03,083745,Cinel; Cameron Alexander,10,0,30,20
1657927758482,MATH 18,B01,083748,Rideout; David Porter,5,0,37,32
1657927758482,MATH 18,B02,083749,Rideout; David Porter,5,0,36,31
1657927758482,MATH 18,B03,083750,Rideout; David Porter,3,0,37,34
1657927758482,MATH 18,B04,083751,Rideout; David Porter,7,0,36,29
1657927758482,MATH 18,B05,093473,Rideout; David Porter,7,0,36,29
1657927758482,MATH 18,B06,093474,Rideout; David Porter,6,0,36,30
1657927764507,MATH 20A,A01,083754,Zheng; Zequn,14,0,40,26
1657927770532,MATH 20B,A01,083756,Briones; Jor-el Thomas Caparas,4,0,36,32
1657927770532,MATH 20B,A02,083757,Briones; Jor-el Thomas Caparas,1,0,36,35
1657927770532,MATH 20B,A03,093475,Briones; Jor-el Thomas Caparas,3,0,36,33
1657927776560,MATH 20C,A01,083760,Briones; Jor-el Thomas Caparas,1,0,35,34
1657927776560,MATH 20C,A02,083761,Briones; Jor-el Thomas Caparas,8,0,35,27
1657927776560,MATH 20C,A03,093476,Briones; Jor-el Thomas Caparas,0,1,36,36
1657927776560,MATH 20C,B01,083762,Bach; Quang Tran,1,0,30,29
1657927782592,MATH 20D,A01,083765,Tran; Brian Kha,5,0,30,25
1657927782592,MATH 20D,A02,083766,Tran; Brian Kha,5,0,30,25
1657927782592,MATH 20D,A03,083767,Tran; Brian Kha,6,0,30,24
1657927788622,MATH 20E,A01,083771,Ganguly; Soumya,12,0,32,20
1657927788622,MATH 20E,A02,083772,Ganguly; Soumya,7,0,32,25
1657927788622,MATH 20E,B01,083773,Ciotti; Benjamin,20,0,35,15
1657927788622,MATH 20E,B02,083774,Ciotti; Benjamin,18,0,35,17
1657927794645,MATH 103A,A01,083777,Greenfeld; Be'Eri,3,0,36,33
1657927794645,MATH 103A,A02,083778,Greenfeld; Be'Eri,5,0,36,31
1657927794645,MATH 103A,A03,093561,Greenfeld; Be'Eri,6,0,36,30
1657927794645,MATH 103A,B01,083779,Greenfeld; Be'Eri,8,0,36,28
1657927794645,MATH 103A,B02,083780,Greenfeld; Be'Eri,4,0,36,32
1657927794645,MATH 103A,B03,093562,Greenfeld; Be'Eri,3,0,36,33
1657927800670,MATH 105,A01,085443,Carter; Anne Toulson,15,0,35,20
1657927800670,MATH 105,A02,093477,Carter; Anne Toulson,20,0,35,15
1657927806704,MATH 109,A01,083213,Ganzberger; Geoffrey Michael,3,0,34,31
1657927806704,MATH 109,A02,083214,Ganzberger; Geoffrey Michael,4,0,34,30
1657927806704,MATH 109,A03,093478,Ganzberger; Geoffrey Michael,2,0,34,32
1657927806704,MATH 109,B01,083215,Ganzberger; Geoffrey Michael,2,0,32,30
1657927806704,MATH 109,B02,083216,Ganzberger; Geoffrey Michael,3,0,32,29
1657927806704,MATH 109,B03,093479,Ganzberger; Geoffrey Michael,8,0,32,24
1657927812727,MATH 142A,A01,083219,Chow; Bennett,7,0,32,25
1657927812727,MATH 142A,A02,083220,Chow; Bennett,10,0,32,22
1657927812727,MATH 142A,A03,093480,Chow; Bennett,9,0,32,23
1657927812727,MATH 142A,B03,093481,Chow; Bennett,8,0,32,24
1657927812727,MATH 142A,B04,093558,Chow; Bennett,13,0,32,19
1657927812727,MATH 142A,B05,093559,Chow; Bennett,7,0,32,25
1657927818757,MATH 193A,A01,083224,Rotar; Vladimir,8,0,34,26
1657927818757,MATH 193A,A02,083225,Rotar; Vladimir,10,0,34,24
1657927818757,MATH 193A,A03,083781,Rotar; Vladimir,5,0,34,29
1657927818757,MATH 193A,A04,083782,Rotar; Vladimir,11,0,34,23
1657927818757,MATH 193A,A05,093482,Rotar; Vladimir,11,0,34,23
1657927824780,MATH 197,001,091859,McAuley; Julian John,9999,0,9999,0
1657927824780,MATH 197,002,095566,Kedlaya; Kiran S.,9997,0,9999,2
1657927824780,MATH 197,003,095567,Xiao; Ming,9999,0,9999,0
1657927824780,MATH 197,004,095571,Perols; Johan Lars,9998,0,9999,1
1657927831846,COGS 9,A01,083615,Shannon; Kyle Michael,10,0,75,65
1657927837873,COGS 11,A01,083617,Boyle; Mary E. T.,23,0,48,25
1657927843897,COGS 13,A01,083071,Bastos; Amalia Pinkusfeld,12,0,71,59
1657927849925,COGS 14A,A01,092681,Semenuks; Arturs,5,1,100,95
1657927855948,COGS 14B,A01,083073,Cheng; Tzu-Han,7,0,63,56
1657927861972,COGS 17,A01,092677,Semenuks; Arturs,7,0,81,74
1657927867995,COGS 100,A01,083619,Allen; Michael Gordon,17,0,70,53
1657927874018,COGS 101A,A01,083621,Davis; Joshua Daniel,9,0,68,59
1657927880044,COGS 101B,A01,091572,Allen; Michael Gordon,14,0,65,51
1657927886073,COGS 101C,A01,083625,Delgado; Tania,17,0,35,18
1657927892103,COGS 107A,A01,083627,Boyle; Mary E. T.,14,0,60,46
1657927898127,COGS 118A,A01,083075,Gupta; Anjum,21,0,76,55
1657927904150,CSE 3,A50,083646,Miranda; Gregory Joseph,24,0,50,26
1657927910180,CSE 8A,A50,083650,Miranda; Gregory Joseph,17,1,56,39
1657927916203,CSE 11,A01,083080,Cao; Yingjun,6,15,40,34
1657927922231,CSE 12,A01,083652,Krause-Levy; Sophia Louisa,30,1,120,90
1657927928255,CSE 15L,A01,083654,Morris; Justin Loren,9,0,50,41
1657927928255,CSE 15L,A02,083655,Morris; Justin Loren,10,0,50,40
1657927934284,CSE 20,A01,083657,Tran; Khoa Dang,39,0,80,41
1657927940316,CSE 21,A01,095574,Bach; Quang Tran,23,0,48,25
1657927946339,CSE 30,A01,083084,Eldon; John,7,0,80,73
1657927946339,CSE 30,B01,095061,Bhaskar; Nishant,9,0,50,41
1657927952373,CSE 100,A01,083659,Cao; Yingjun,5,4,70,65
1657927958397,CSE 134B,A01,083661,Powell; Thomas Allan,25,0,100,75
1657927964419,CSE 140,A01,083663,Gungor; Onat,17,0,85,68
1657927970443,CSE 140L,A01,083088,Eldon; John,23,0,100,77
1657927976469,CSE 175,A01,083665,Kumar; Rakesh,3,0,25,22
1657927982492,CSE 190,A00,092507,Dubnov; Shlomo,8,0,20,12
1657927988514,ECE 45,A01,083139,Congero; Spencer William,7,0,75,68
1657927994544,ECE 65,A50,083695,Saad; Andrew S,12,0,30,18
1657927994544,ECE 65,A51,095125,Saad; Andrew S,24,0,26,2
1657928000566,ECE 109,A01,091882,Touri; Behrouz,20,0,70,50
1657928006589,ECE 180,A00,083140,Abi Samra; Nicholas Camill,1,0,30,29
1657928006589,ECE 180,B00,083141,Abi Samra; Nicholas Camill,0,0,30,30
1657928012611,MATH 10A,A01,083735,Patchell; Gregory David,2,0,30,28
1657928012611,MATH 10A,A02,083736,Patchell; Gregory David,20,0,30,10
1657928012611,MATH 10A,A03,083737,Patchell; Gregory David,16,0,30,14
1657928018635,MATH 10B,A01,083207,Lim; Seonhee,8,0,34,26
1657928018635,MATH 10B,A02,083208,Lim; Seonhee,10,0,35,25
1657928018635,MATH 10B,A03,093472,Lim; Seonhee,7,0,34,27
1657928018635,MATH 10B,B01,083739,Sinha; Shubham,14,0,30,16
1657928024660,MATH 18,A01,083743,Cinel; Cameron Alexander,9,0,30,21
1657928024660,MATH 18,A02,083744,Cinel; Cameron Alexander,18,0,30,12
1657928024660,MATH 18,A03,083745,Cinel; Cameron Alexander,10,0,30,20
1657928024660,MATH 18,B01,083748,Rideout; David Porter,5,0,37,32
1657928024660,MATH 18,B02,083749,Rideout; David Porter,5,0,36,31
1657928024660,MATH 18,B03,083750,Rideout; David Porter,3,0,37,34
1657928024660,MATH 18,B04,083751,Rideout; David Porter,7,0,36,29
1657928024660,MATH 18,B05,093473,Rideout; David Porter,7,0,36,29
1657928024660,MATH 18,B06,093474,Rideout; David Porter,6,0,36,30
1657928030684,MATH 20A,A01,083754,Zheng; Zequn,14,0,40,26
1657928036789,MATH 20B,A01,083756,Briones; Jor-el Thomas Caparas,4,0,36,32
1657928036789,MATH 20B,A02,083757,Briones; Jor-el Thomas Caparas,1,0,36,35
1657928036789,MATH 20B,A03,093475,Briones; Jor-el Thomas Caparas,3,0,36,33
1657928042815,MATH 20C,A01,083760,Briones; Jor-el Thomas Caparas,1,0,35,34
1657928042815,MATH 20C,A02,083761,Briones; Jor-el Thomas Caparas,8,0,35,27
1657928042815,MATH 20C,A03,093476,Briones; Jor-el Thomas Caparas,0,1,36,36
1657928042815,MATH 20C,B01,083762,Bach; Quang Tran,1,0,30,29
1657928048845,MATH 20D,A01,083765,Tran; Brian Kha,5,0,30,25
1657928048845,MATH 20D,A02,083766,Tran; Brian Kha,5,0,30,25
1657928048845,MATH 20D,A03,083767,Tran; Brian Kha,6,0,30,24
1657928054883,MATH 20E,A01,083771,Ganguly; Soumya,12,0,32,20
1657928054883,MATH 20E,A02,083772,Ganguly; Soumya,7,0,32,25
1657928054883,MATH 20E,B01,083773,Ciotti; Benjamin,20,0,35,15
1657928054883,MATH 20E,B02,083774,Ciotti; Benjamin,18,0,35,17
1657928060911,MATH 103A,A01,083777,Greenfeld; Be'Eri,3,0,36,33
1657928060911,MATH 103A,A02,083778,Greenfeld; Be'Eri,5,0,36,31
1657928060911,MATH 103A,A03,093561,Greenfeld; Be'Eri,6,0,36,30
1657928060911,MATH 103A,B01,083779,Greenfeld; Be'Eri,8,0,36,28
1657928060911,MATH 103A,B02,083780,Greenfeld; Be'Eri,4,0,36,32
1657928060911,MATH 103A,B03,093562,Greenfeld; Be'Eri,3,0,36,33
1657928066935,MATH 105,A01,085443,Carter; Anne Toulson,15,0,35,20
1657928066935,MATH 105,A02,093477,Carter; Anne Toulson,20,0,35,15
1657928072963,MATH 109,A01,083213,Ganzberger; Geoffrey Michael,3,0,34,31
1657928072963,MATH 109,A02,083214,Ganzberger; Geoffrey Michael,4,0,34,30
1657928072963,MATH 109,A03,093478,Ganzberger; Geoffrey Michael,2,0,34,32
1657928072963,MATH 109,B01,083215,Ganzberger; Geoffrey Michael,2,0,32,30
1657928072963,MATH 109,B02,083216,Ganzberger; Geoffrey Michael,3,0,32,29
1657928072963,MATH 109,B03,093479,Ganzberger; Geoffrey Michael,8,0,32,24
1657928078987,MATH 142A,A01,083219,Chow; Bennett,7,0,32,25
1657928078987,MATH 142A,A02,083220,Chow; Bennett,10,0,32,22
1657928078987,MATH 142A,A03,093480,Chow; Bennett,9,0,32,23
1657928078987,MATH 142A,B03,093481,Chow; Bennett,8,0,32,24
1657928078987,MATH 142A,B04,093558,Chow; Bennett,13,0,32,19
1657928078987,MATH 142A,B05,093559,Chow; Bennett,7,0,32,25
1657928085015,MATH 193A,A01,083224,Rotar; Vladimir,8,0,34,26
1657928085015,MATH 193A,A02,083225,Rotar; Vladimir,10,0,34,24
1657928085015,MATH 193A,A03,083781,Rotar; Vladimir,5,0,34,29
1657928085015,MATH 193A,A04,083782,Rotar; Vladimir,11,0,34,23
1657928085015,MATH 193A,A05,093482,Rotar; Vladimir,11,0,34,23
1657928091043,MATH 197,001,091859,McAuley; Julian John,9999,0,9999,0
1657928091043,MATH 197,002,095566,Kedlaya; Kiran S.,9997,0,9999,2
1657928091043,MATH 197,003,095567,Xiao; Ming,9999,0,9999,0
1657928091043,MATH 197,004,095571,Perols; Johan Lars,9998,0,9999,1
1657928098110,COGS 9,A01,083615,Shannon; Kyle Michael,10,0,75,65
1657928104133,COGS 11,A01,083617,Boyle; Mary E. T.,23,0,48,25
1657928110159,COGS 13,A01,083071,Bastos; Amalia Pinkusfeld,12,0,71,59
1657928116186,COGS 14A,A01,092681,Semenuks; Arturs,5,1,100,95
1657928122214,COGS 14B,A01,083073,Cheng; Tzu-Han,7,0,63,56
1657928128240,COGS 17,A01,092677,Semenuks; Arturs,7,0,81,74
1657928134263,COGS 100,A01,083619,Allen; Michael Gordon,17,0,70,53
1657928140285,COGS 101A,A01,083621,Davis; Joshua Daniel,9,0,68,59
1657928146307,COGS 101B,A01,091572,Allen; Michael Gordon,14,0,65,51
1657928152336,COGS 101C,A01,083625,Delgado; Tania,17,0,35,18
1657928158371,COGS 107A,A01,083627,Boyle; Mary E. T.,14,0,60,46
1657928164404,COGS 118A,A01,083075,Gupta; Anjum,21,0,76,55
1657928170435,CSE 3,A50,083646,Miranda; Gregory Joseph,24,0,50,26
1657928176463,CSE 8A,A50,083650,Miranda; Gregory Joseph,17,1,56,39
1657928182489,CSE 11,A01,083080,Cao; Yingjun,6,15,40,34
1657928188512,CSE 12,A01,083652,Krause-Levy; Sophia Louisa,30,1,120,90
1657928194550,CSE 15L,A01,083654,Morris; Justin Loren,9,0,50,41
1657928194550,CSE 15L,A02,083655,Morris; Justin Loren,10,0,50,40
1657928200578,CSE 20,A01,083657,Tran; Khoa Dang,39,0,80,41
1657928206606,CSE 21,A01,095574,Bach; Quang Tran,23,0,48,25
1657928212631,CSE 30,A01,083084,Eldon; John,7,0,80,73
1657928212631,CSE 30,B01,095061,Bhaskar; Nishant,9,0,50,41
1657928218657,CSE 100,A01,083659,Cao; Yingjun,5,4,70,65
1657928224683,CSE 134B,A01,083661,Powell; Thomas Allan,25,0,100,75
1657928230705,CSE 140,A01,083663,Gungor; Onat,17,0,85,68
1657928236734,CSE 140L,A01,083088,Eldon; John,23,0,100,77
1657928242757,CSE 175,A01,083665,Kumar; Rakesh,3,0,25,22
1657928248781,CSE 190,A00,092507,Dubnov; Shlomo,8,0,20,12
1657928254812,ECE 45,A01,083139,Congero; Spencer William,7,0,75,68
1657928260836,ECE 65,A50,083695,Saad; Andrew S,12,0,30,18
1657928260836,ECE 65,A51,095125,Saad; Andrew S,24,0,26,2
1657928266868,ECE 109,A01,091882,Touri; Behrouz,20,0,70,50
1657928272897,ECE 180,A00,083140,Abi Samra; Nicholas Camill,1,0,30,29
1657928272897,ECE 180,B00,083141,Abi Samra; Nicholas Camill,0,0,30,30
1657928278924,MATH 10A,A01,083735,Patchell; Gregory David,2,0,30,28
1657928278924,MATH 10A,A02,083736,Patchell; Gregory David,20,0,30,10
1657928278924,MATH 10A,A03,083737,Patchell; Gregory David,16,0,30,14
1657928284948,MATH 10B,A01,083207,Lim; Seonhee,8,0,34,26
1657928284948,MATH 10B,A02,083208,Lim; Seonhee,10,0,35,25
1657928284948,MATH 10B,A03,093472,Lim; Seonhee,7,0,34,27
1657928284948,MATH 10B,B01,083739,Sinha; Shubham,14,0,30,16
1657928290978,MATH 18,A01,083743,Cinel; Cameron Alexander,9,0,30,21
1657928290978,MATH 18,A02,083744,Cinel; Cameron Alexander,18,0,30,12
1657928290978,MATH 18,A03,083745,Cinel; Cameron Alexander,10,0,30,20
1657928290978,MATH 18,B01,083748,Rideout; David Porter,5,0,37,32
1657928290978,MATH 18,B02,083749,Rideout; David Porter,5,0,36,31
1657928290978,MATH 18,B03,083750,Rideout; David Porter,3,0,37,34
1657928290978,MATH 18,B04,083751,Rideout; David Porter,7,0,36,29
1657928290978,MATH 18,B05,093473,Rideout; David Porter,7,0,36,29
1657928290978,MATH 18,B06,093474,Rideout; David Porter,6,0,36,30
1657928297005,MATH 20A,A01,083754,Zheng; Zequn,14,0,40,26
1657928303032,MATH 20B,A01,083756,Briones; Jor-el Thomas Caparas,4,0,36,32
1657928303032,MATH 20B,A02,083757,Briones; Jor-el Thomas Caparas,1,0,36,35
1657928303032,MATH 20B,A03,093475,Briones; Jor-el Thomas Caparas,3,0,36,33
1657928309059,MATH 20C,A01,083760,Briones; Jor-el Thomas Caparas,1,0,35,34
1657928309059,MATH 20C,A02,083761,Briones; Jor-el Thomas Caparas,8,0,35,27
1657928309059,MATH 20C,A03,093476,Briones; Jor-el Thomas Caparas,0,1,36,36
1657928309059,MATH 20C,B01,083762,Bach; Quang Tran,1,0,30,29
1657928315084,MATH 20D,A01,083765,Tran; Brian Kha,5,0,30,25
1657928315084,MATH 20D,A02,083766,Tran; Brian Kha,5,0,30,25
1657928315084,MATH 20D,A03,083767,Tran; Brian Kha,6,0,30,24
1657928321111,MATH 20E,A01,083771,Ganguly; Soumya,12,0,32,20
1657928321111,MATH 20E,A02,083772,Ganguly; Soumya,7,0,32,25
1657928321111,MATH 20E,B01,083773,Ciotti; Benjamin,20,0,35,15
1657928321111,MATH 20E,B02,083774,Ciotti; Benjamin,18,0,35,17
1657928327156,MATH 103A,A01,083777,Greenfeld; Be'Eri,3,0,36,33
1657928327156,MATH 103A,A02,083778,Greenfeld; Be'Eri,5,0,36,31
1657928327156,MATH 103A,A03,093561,Greenfeld; Be'Eri,6,0,36,30
1657928327156,MATH 103A,B01,083779,Greenfeld; Be'Eri,8,0,36,28
1657928327156,MATH 103A,B02,083780,Greenfeld; Be'Eri,4,0,36,32
1657928327156,MATH 103A,B03,093562,Greenfeld; Be'Eri,3,0,36,33
1657928333186,MATH 105,A01,085443,Carter; Anne Toulson,15,0,35,20
1657928333186,MATH 105,A02,093477,Carter; Anne Toulson,20,0,35,15
1657928339218,MATH 109,A01,083213,Ganzberger; Geoffrey Michael,3,0,34,31
1657928339218,MATH 109,A02,083214,Ganzberger; Geoffrey Michael,4,0,34,30
1657928339218,MATH 109,A03,093478,Ganzberger; Geoffrey Michael,2,0,34,32
1657928339218,MATH 109,B01,083215,Ganzberger; Geoffrey Michael,2,0,32,30
1657928339218,MATH 109,B02,083216,Ganzberger; Geoffrey Michael,3,0,32,29
1657928339218,MATH 109,B03,093479,Ganzberger; Geoffrey Michael,8,0,32,24
1657928345241,MATH 142A,A01,083219,Chow; Bennett,7,0,32,25
1657928345241,MATH 142A,A02,083220,Chow; Bennett,10,0,32,22
1657928345241,MATH 142A,A03,093480,Chow; Bennett,9,0,32,23
1657928345241,MATH 142A,B03,093481,Chow; Bennett,8,0,32,24
1657928345241,MATH 142A,B04,093558,Chow; Bennett,13,0,32,19
1657928345241,MATH 142A,B05,093559,Chow; Bennett,7,0,32,25
1657928351265,MATH 193A,A01,083224,Rotar; Vladimir,8,0,34,26
1657928351265,MATH 193A,A02,083225,Rotar; Vladimir,10,0,34,24
1657928351265,MATH 193A,A03,083781,Rotar; Vladimir,5,0,34,29
1657928351265,MATH 193A,A04,083782,Rotar; Vladimir,11,0,34,23
1657928351265,MATH 193A,A05,093482,Rotar; Vladimir,11,0,34,23
1657928357294,MATH 197,001,091859,McAuley; Julian John,9999,0,9999,0
1657928357294,MATH 197,002,095566,Kedlaya; Kiran S.,9997,0,9999,2
1657928357294,MATH 197,003,095567,Xiao; Ming,9999,0,9999,0
1657928357294,MATH 197,004,095571,Perols; Johan Lars,9998,0,9999,1
1657928364343,COGS 9,A01,083615,Shannon; Kyle Michael,10,0,75,65
1657928370367,COGS 11,A01,083617,Boyle; Mary E. T.,23,0,48,25
1657928376392,COGS 13,A01,083071,Bastos; Amalia Pinkusfeld,12,0,71,59
1657928382415,COGS 14A,A01,092681,Semenuks; Arturs,5,1,100,95
1657928388453,COGS 14B,A01,083073,Cheng; Tzu-Han,7,0,63,56
1657928394476,COGS 17,A01,092677,Semenuks; Arturs,7,0,81,74
1657928400500,COGS 100,A01,083619,Allen; Michael Gordon,17,0,70,53
1657928406523,COGS 101A,A01,083621,Davis; Joshua Daniel,9,0,68,59
1657928412550,COGS 101B,A01,091572,Allen; Michael Gordon,14,0,65,51
1657928418580,COGS 101C,A01,083625,Delgado; Tania,17,0,35,18
1657928424606,COGS 107A,A01,083627,Boyle; Mary E. T.,14,0,60,46
1657928430631,COGS 118A,A01,083075,Gupta; Anjum,21,0,76,55
1657928436657,CSE 3,A50,083646,Miranda; Gregory Joseph,24,0,50,26
1657928442681,CSE 8A,A50,083650,Miranda; Gregory Joseph,17,1,56,39
1657928448706,CSE 11,A01,083080,Cao; Yingjun,6,15,40,34
1657928454730,CSE 12,A01,083652,Krause-Levy; Sophia Louisa,30,1,120,90
1657928460757,CSE 15L,A01,083654,Morris; Justin Loren,9,0,50,41
1657928460757,CSE 15L,A02,083655,Morris; Justin Loren,10,0,50,40
1657928466782,CSE 20,A01,083657,Tran; Khoa Dang,39,0,80,41
1657928472809,CSE 21,A01,095574,Bach; Quang Tran,23,0,48,25
1657928478838,CSE 30,A01,083084,Eldon; John,7,0,80,73
1657928478838,CSE 30,B01,095061,Bhaskar; Nishant,9,0,50,41
1657928484867,CSE 100,A01,083659,Cao; Yingjun,5,4,70,65
1657928490895,CSE 134B,A01,083661,Powell; Thomas Allan,25,0,100,75
1657928496917,CSE 140,A01,083663,Gungor; Onat,17,0,85,68
1657928502943,CSE 140L,A01,083088,Eldon; John,23,0,100,77
1657928508965,CSE 175,A01,083665,Kumar; Rakesh,3,0,25,22
1657928514991,CSE 190,A00,092507,Dubnov; Shlomo,8,0,20,12
1657928521018,ECE 45,A01,083139,Congero; Spencer William,7,0,75,68
1657928527042,ECE 65,A50,083695,Saad; Andrew S,12,0,30,18
1657928527042,ECE 65,A51,095125,Saad; Andrew S,24,0,26,2
1657928533070,ECE 109,A01,091882,Touri; Behrouz,20,0,70,50
1657928539095,ECE 180,A00,083140,Abi Samra; Nicholas Camill,1,0,30,29
1657928539095,ECE 180,B00,083141,Abi Samra; Nicholas Camill,0,0,30,30
1657928545121,MATH 10A,A01,083735,Patchell; Gregory David,2,0,30,28
1657928545121,MATH 10A,A02,083736,Patchell; Gregory David,20,0,30,10
1657928545121,MATH 10A,A03,083737,Patchell; Gregory David,16,0,30,14
1657928551149,MATH 10B,A01,083207,Lim; Seonhee,8,0,34,26
1657928551149,MATH 10B,A02,083208,Lim; Seonhee,10,0,35,25
1657928551149,MATH 10B,A03,093472,Lim; Seonhee,7,0,34,27
1657928551149,MATH 10B,B01,083739,Sinha; Shubham,14,0,30,16
1657928557185,MATH 18,A01,083743,Cinel; Cameron Alexander,9,0,30,21
1657928557185,MATH 18,A02,083744,Cinel; Cameron Alexander,18,0,30,12
1657928557185,MATH 18,A03,083745,Cinel; Cameron Alexander,10,0,30,20
1657928557185,MATH 18,B01,083748,Rideout; David Porter,5,0,37,32
1657928557185,MATH 18,B02,083749,Rideout; David Porter,5,0,36,31
1657928557185,MATH 18,B03,083750,Rideout; David Porter,3,0,37,34
1657928557185,MATH 18,B04,083751,Rideout; David Porter,7,0,36,29
1657928557185,MATH 18,B05,093473,Rideout; David Porter,7,0,36,29
1657928557185,MATH 18,B06,093474,Rideout; David Porter,6,0,36,30
1657928563209,MATH 20A,A01,083754,Zheng; Zequn,14,0,40,26
1657928569239,MATH 20B,A01,083756,Briones; Jor-el Thomas Caparas,4,0,36,32
1657928569239,MATH 20B,A02,083757,Briones; Jor-el Thomas Caparas,1,0,36,35
1657928569239,MATH 20B,A03,093475,Briones; Jor-el Thomas Caparas,3,0,36,33
1657928575267,MATH 20C,A01,083760,Briones; Jor-el Thomas Caparas,1,0,35,34
1657928575267,MATH 20C,A02,083761,Briones; Jor-el Thomas Caparas,8,0,35,27
1657928575267,MATH 20C,A03,093476,Briones; Jor-el Thomas Caparas,0,1,36,36
1657928575267,MATH 20C,B01,083762,Bach; Quang Tran,1,0,30,29
1657928581297,MATH 20D,A01,083765,Tran; Brian Kha,5,0,30,25
1657928581297,MATH 20D,A02,083766,Tran; Brian Kha,5,0,30,25
1657928581297,MATH 20D,A03,083767,Tran; Brian Kha,6,0,30,24
1657928587322,MATH 20E,A01,083771,Ganguly; Soumya,12,0,32,20
1657928587322,MATH 20E,A02,083772,Ganguly; Soumya,7,0,32,25
1657928587322,MATH 20E,B01,083773,Ciotti; Benjamin,20,0,35,15
1657928587322,MATH 20E,B02,083774,Ciotti; Benjamin,18,0,35,17
1657928593346,MATH 103A,A01,083777,Greenfeld; Be'Eri,3,0,36,33
1657928593346,MATH 103A,A02,083778,Greenfeld; Be'Eri,5,0,36,31
1657928593346,MATH 103A,A03,093561,Greenfeld; Be'Eri,6,0,36,30
1657928593346,MATH 103A,B01,083779,Greenfeld; Be'Eri,8,0,36,28
1657928593346,MATH 103A,B02,083780,Greenfeld; Be'Eri,4,0,36,32
1657928593346,MATH 103A,B03,093562,Greenfeld; Be'Eri,3,0,36,33
1657928599383,MATH 105,A01,085443,Carter; Anne Toulson,15,0,35,20
1657928599383,MATH 105,A02,093477,Carter; Anne Toulson,20,0,35,15
1657928605408,MATH 109,A01,083213,Ganzberger; Geoffrey Michael,3,0,34,31
1657928605408,MATH 109,A02,083214,Ganzberger; Geoffrey Michael,4,0,34,30
1657928605408,MATH 109,A03,093478,Ganzberger; Geoffrey Michael,2,0,34,32
1657928605408,MATH 109,B01,083215,Ganzberger; Geoffrey Michael,2,0,32,30
1657928605408,MATH 109,B02,083216,Ganzberger; Geoffrey Michael,3,0,32,29
1657928605408,MATH 109,B03,093479,Ganzberger; Geoffrey Michael,8,0,32,24
1657928611432,MATH 142A,A01,083219,Chow; Bennett,7,0,32,25
1657928611432,MATH 142A,A02,083220,Chow; Bennett,10,0,32,22
1657928611432,MATH 142A,A03,093480,Chow; Bennett,9,0,32,23
1657928611432,MATH 142A,B03,093481,Chow; Bennett,8,0,32,24
1657928611432,MATH 142A,B04,093558,Chow; Bennett,13,0,32,19
1657928611432,MATH 142A,B05,093559,Chow; Bennett,7,0,32,25
1657928617454,MATH 193A,A01,083224,Rotar; Vladimir,8,0,34,26
1657928617454,MATH 193A,A02,083225,Rotar; Vladimir,10,0,34,24
1657928617454,MATH 193A,A03,083781,Rotar; Vladimir,5,0,34,29
1657928617454,MATH 193A,A04,083782,Rotar; Vladimir,11,0,34,23
1657928617454,MATH 193A,A05,093482,Rotar; Vladimir,11,0,34,23
1657928623478,MATH 197,001,091859,McAuley; Julian John,9999,0,9999,0
1657928623478,MATH 197,002,095566,Kedlaya; Kiran S.,9997,0,9999,2
1657928623478,MATH 197,003,095567,Xiao; Ming,9999,0,9999,0
1657928623478,MATH 197,004,095571,Perols; Johan Lars,9998,0,9999,1
1657928630630,COGS 9,A01,083615,Shannon; Kyle Michael,10,0,75,65
1657928636666,COGS 11,A01,083617,Boyle; Mary E. T.,23,0,48,25
1657928642693,COGS 13,A01,083071,Bastos; Amalia Pinkusfeld,12,0,71,59
1657928648717,COGS 14A,A01,092681,Semenuks; Arturs,5,1,100,95
1657928654740,COGS 14B,A01,083073,Cheng; Tzu-Han,7,0,63,56
1657928660766,COGS 17,A01,092677,Semenuks; Arturs,7,0,81,74
1657928666788,COGS 100,A01,083619,Allen; Michael Gordon,17,0,70,53
1657928672812,COGS 101A,A01,083621,Davis; Joshua Daniel,9,0,68,59
1657928678838,COGS 101B,A01,091572,Allen; Michael Gordon,14,0,65,51
1657928684863,COGS 101C,A01,083625,Delgado; Tania,17,0,35,18
1657928690889,COGS 107A,A01,083627,Boyle; Mary E. T.,14,0,60,46
1657928696912,COGS 118A,A01,083075,Gupta; Anjum,21,0,76,55
1657928702936,CSE 3,A50,083646,Miranda; Gregory Joseph,24,0,50,26
1657928708963,CSE 8A,A50,083650,Miranda; Gregory Joseph,17,1,56,39
1657928714987,CSE 11,A01,083080,Cao; Yingjun,6,15,40,34
1657928721012,CSE 12,A01,083652,Krause-Levy; Sophia Louisa,30,1,120,90
1657928727039,CSE 15L,A01,083654,Morris; Justin Loren,9,0,50,41
1657928727039,CSE 15L,A02,083655,Morris; Justin Loren,10,0,50,40
1657928733067,CSE 20,A01,083657,Tran; Khoa Dang,39,0,80,41
1657928739098,CSE 21,A01,095574,Bach; Quang Tran,23,0,48,25
1657928745121,CSE 30,A01,083084,Eldon; John,7,0,80,73
1657928745121,CSE 30,B01,095061,Bhaskar; Nishant,9,0,50,41
1657928751145,CSE 100,A01,083659,Cao; Yingjun,5,4,70,65
1657928757171,CSE 134B,A01,083661,Powell; Thomas Allan,25,0,100,75
1657928763198,CSE 140,A01,083663,Gungor; Onat,17,0,85,68
1657928769225,CSE 140L,A01,083088,Eldon; John,23,0,100,77
1657928775247,CSE 175,A01,083665,Kumar; Rakesh,3,0,25,22
1657928781272,CSE 190,A00,092507,Dubnov; Shlomo,8,0,20,12
1657928787298,ECE 45,A01,083139,Congero; Spencer William,7,0,75,68
1657928793321,ECE 65,A50,083695,Saad; Andrew S,12,0,30,18
1657928793321,ECE 65,A51,095125,Saad; Andrew S,24,0,26,2
1657928799343,ECE 109,A01,091882,Touri; Behrouz,20,0,70,50
1657928805366,ECE 180,A00,083140,Abi Samra; Nicholas Camill,1,0,30,29
1657928805366,ECE 180,B00,083141,Abi Samra; Nicholas Camill,0,0,30,30
1657928811388,MATH 10A,A01,083735,Patchell; Gregory David,2,0,30,28
1657928811388,MATH 10A,A02,083736,Patchell; Gregory David,20,0,30,10
1657928811388,MATH 10A,A03,083737,Patchell; Gregory David,16,0,30,14
1657928817415,MATH 10B,A01,083207,Lim; Seonhee,8,0,34,26
1657928817415,MATH 10B,A02,083208,Lim; Seonhee,10,0,35,25
1657928817415,MATH 10B,A03,093472,Lim; Seonhee,7,0,34,27
1657928817415,MATH 10B,B01,083739,Sinha; Shubham,14,0,30,16
1657928823445,MATH 18,A01,083743,Cinel; Cameron Alexander,9,0,30,21
1657928823445,MATH 18,A02,083744,Cinel; Cameron Alexander,18,0,30,12
1657928823445,MATH 18,A03,083745,Cinel; Cameron Alexander,10,0,30,20
1657928823445,MATH 18,B01,083748,Rideout; David Porter,5,0,37,32
1657928823445,MATH 18,B02,083749,Rideout; David Porter,5,0,36,31
1657928823445,MATH 18,B03,083750,Rideout; David Porter,3,0,37,34
1657928823445,MATH 18,B04,083751,Rideout; David Porter,7,0,36,29
1657928823445,MATH 18,B05,093473,Rideout; David Porter,7,0,36,29
1657928823445,MATH 18,B06,093474,Rideout; David Porter,6,0,36,30
1657928829469,MATH 20A,A01,083754,Zheng; Zequn,14,0,40,26
1657928835495,MATH 20B,A01,083756,Briones; Jor-el Thomas Caparas,4,0,36,32
1657928835495,MATH 20B,A02,083757,Briones; Jor-el Thomas Caparas,1,0,36,35
1657928835495,MATH 20B,A03,093475,Briones; Jor-el Thomas Caparas,3,0,36,33
1657928841522,MATH 20C,A01,083760,Briones; Jor-el Thomas Caparas,1,0,35,34
1657928841522,MATH 20C,A02,083761,Briones; Jor-el Thomas Caparas,8,0,35,27
1657928841522,MATH 20C,A03,093476,Briones; Jor-el Thomas Caparas,0,1,36,36
1657928841522,MATH 20C,B01,083762,Bach; Quang Tran,1,0,30,29
1657928847543,MATH 20D,A01,083765,Tran; Brian Kha,5,0,30,25
1657928847543,MATH 20D,A02,083766,Tran; Brian Kha,5,0,30,25
1657928847543,MATH 20D,A03,083767,Tran; Brian Kha,6,0,30,24
1657928853566,MATH 20E,A01,083771,Ganguly; Soumya,12,0,32,20
1657928853566,MATH 20E,A02,083772,Ganguly; Soumya,7,0,32,25
1657928853566,MATH 20E,B01,083773,Ciotti; Benjamin,20,0,35,15
1657928853566,MATH 20E,B02,083774,Ciotti; Benjamin,18,0,35,17
1657928859588,MATH 103A,A01,083777,Greenfeld; Be'Eri,3,0,36,33
1657928859588,MATH 103A,A02,083778,Greenfeld; Be'Eri,5,0,36,31
1657928859588,MATH 103A,A03,093561,Greenfeld; Be'Eri,6,0,36,30
1657928859588,MATH 103A,B01,083779,Greenfeld; Be'Eri,8,0,36,28
1657928859588,MATH 103A,B02,083780,Greenfeld; Be'Eri,4,0,36,32
1657928859588,MATH 103A,B03,093562,Greenfeld; Be'Eri,3,0,36,33
1657928865615,MATH 105,A01,085443,Carter; Anne Toulson,15,0,35,20
1657928865615,MATH 105,A02,093477,Carter; Anne Toulson,20,0,35,15
1657928871642,MATH 109,A01,083213,Ganzberger; Geoffrey Michael,3,0,34,31
1657928871642,MATH 109,A02,083214,Ganzberger; Geoffrey Michael,4,0,34,30
1657928871642,MATH 109,A03,093478,Ganzberger; Geoffrey Michael,2,0,34,32
1657928871642,MATH 109,B01,083215,Ganzberger; Geoffrey Michael,2,0,32,30
1657928871642,MATH 109,B02,083216,Ganzberger; Geoffrey Michael,3,0,32,29
1657928871642,MATH 109,B03,093479,Ganzberger; Geoffrey Michael,8,0,32,24
1657928877672,MATH 142A,A01,083219,Chow; Bennett,7,0,32,25
1657928877672,MATH 142A,A02,083220,Chow; Bennett,10,0,32,22
1657928877672,MATH 142A,A03,093480,Chow; Bennett,9,0,32,23
1657928877672,MATH 142A,B03,093481,Chow; Bennett,8,0,32,24
1657928877672,MATH 142A,B04,093558,Chow; Bennett,13,0,32,19
1657928877672,MATH 142A,B05,093559,Chow; Bennett,7,0,32,25
1657928883704,MATH 193A,A01,083224,Rotar; Vladimir,8,0,34,26
1657928883704,MATH 193A,A02,083225,Rotar; Vladimir,10,0,34,24
1657928883704,MATH 193A,A03,083781,Rotar; Vladimir,5,0,34,29
1657928883704,MATH 193A,A04,083782,Rotar; Vladimir,11,0,34,23
1657928883704,MATH 193A,A05,093482,Rotar; Vladimir,11,0,34,23
1657928889730,MATH 197,001,091859,McAuley; Julian John,9999,0,9999,0
1657928889730,MATH 197,002,095566,Kedlaya; Kiran S.,9997,0,9999,2
1657928889730,MATH 197,003,095567,Xiao; Ming,9999,0,9999,0
1657928889730,MATH 197,004,095571,Perols; Johan Lars,9998,0,9999,1
1657928896793,COGS 9,A01,083615,Shannon; Kyle Michael,10,0,75,65
1657928902827,COGS 11,A01,083617,Boyle; Mary E. T.,23,0,48,25
1657928908861,COGS 13,A01,083071,Bastos; Amalia Pinkusfeld,12,0,71,59
1657928914884,COGS 14A,A01,092681,Semenuks; Arturs,5,1,100,95
1657928920908,COGS 14B,A01,083073,Cheng; Tzu-Han,7,0,63,56
1657928926944,COGS 17,A01,092677,Semenuks; Arturs,7,0,81,74
1657928932971,COGS 100,A01,083619,Allen; Michael Gordon,17,0,70,53
1657928938996,COGS 101A,A01,083621,Davis; Joshua Daniel,9,0,68,59
1657928945018,COGS 101B,A01,091572,Allen; Michael Gordon,14,0,65,51
1657928951040,COGS 101C,A01,083625,Delgado; Tania,17,0,35,18
1657928957064,COGS 107A,A01,083627,Boyle; Mary E. T.,14,0,60,46
1657928963087,COGS 118A,A01,083075,Gupta; Anjum,21,0,76,55
1657928969110,CSE 3,A50,083646,Miranda; Gregory Joseph,24,0,50,26
1657928975137,CSE 8A,A50,083650,Miranda; Gregory Joseph,17,1,56,39
1657928981175,CSE 11,A01,083080,Cao; Yingjun,6,15,40,34
1657928987210,CSE 12,A01,083652,Krause-Levy; Sophia Louisa,30,1,120,90
1657928993236,CSE 15L,A01,083654,Morris; Justin Loren,9,0,50,41
1657928993236,CSE 15L,A02,083655,Morris; Justin Loren,10,0,50,40
1657928999261,CSE 20,A01,083657,Tran; Khoa Dang,39,0,80,41
1657929005293,CSE 21,A01,095574,Bach; Quang Tran,23,0,48,25
1657929011317,CSE 30,A01,083084,Eldon; John,7,0,80,73
1657929011317,CSE 30,B01,095061,Bhaskar; Nishant,9,0,50,41
1657929017341,CSE 100,A01,083659,Cao; Yingjun,5,4,70,65
1657929023367,CSE 134B,A01,083661,Powell; Thomas Allan,25,0,100,75
1657929029390,CSE 140,A01,083663,Gungor; Onat,17,0,85,68
1657929035414,CSE 140L,A01,083088,Eldon; John,23,0,100,77
1657929041436,CSE 175,A01,083665,Kumar; Rakesh,3,0,25,22
1657929047463,CSE 190,A00,092507,Dubnov; Shlomo,8,0,20,12
1657929053486,ECE 45,A01,083139,Congero; Spencer William,7,0,75,68
1657929059510,ECE 65,A50,083695,Saad; Andrew S,12,0,30,18
1657929059510,ECE 65,A51,095125,Saad; Andrew S,24,0,26,2
1657929065532,ECE 109,A01,091882,Touri; Behrouz,20,0,70,50
1657929071554,ECE 180,A00,083140,Abi Samra; Nicholas Camill,1,0,30,29
1657929071554,ECE 180,B00,083141,Abi Samra; Nicholas Camill,0,0,30,30
1657929077602,MATH 10A,A01,083735,Patchell; Gregory David,2,0,30,28
1657929077602,MATH 10A,A02,083736,Patchell; Gregory David,20,0,30,10
1657929077602,MATH 10A,A03,083737,Patchell; Gregory David,16,0,30,14
1657929083629,MATH 10B,A01,083207,Lim; Seonhee,8,0,34,26
1657929083629,MATH 10B,A02,083208,Lim; Seonhee,10,0,35,25
1657929083629,MATH 10B,A03,093472,Lim; Seonhee,7,0,34,27
1657929083629,MATH 10B,B01,083739,Sinha; Shubham,14,0,30,16
1657929089655,MATH 18,A01,083743,Cinel; Cameron Alexander,9,0,30,21
1657929089655,MATH 18,A02,083744,Cinel; Cameron Alexander,18,0,30,12
1657929089655,MATH 18,A03,083745,Cinel; Cameron Alexander,10,0,30,20
1657929089655,MATH 18,B01,083748,Rideout; David Porter,5,0,37,32
1657929089655,MATH 18,B02,083749,Rideout; David Porter,5,0,36,31
1657929089655,MATH 18,B03,083750,Rideout; David Porter,3,0,37,34
1657929089655,MATH 18,B04,083751,Rideout; David Porter,7,0,36,29
1657929089655,MATH 18,B05,093473,Rideout; David Porter,7,0,36,29
1657929089655,MATH 18,B06,093474,Rideout; David Porter,6,0,36,30
1657929095676,MATH 20A,A01,083754,Zheng; Zequn,14,0,40,26
1657929101699,MATH 20B,A01,083756,Briones; Jor-el Thomas Caparas,4,0,36,32
1657929101699,MATH 20B,A02,083757,Briones; Jor-el Thomas Caparas,1,0,36,35
1657929101699,MATH 20B,A03,093475,Briones; Jor-el Thomas Caparas,3,0,36,33
1657929107733,MATH 20C,A01,083760,Briones; Jor-el Thomas Caparas,1,0,35,34
1657929107733,MATH 20C,A02,083761,Briones; Jor-el Thomas Caparas,8,0,35,27
1657929107733,MATH 20C,A03,093476,Briones; Jor-el Thomas Caparas,0,1,36,36
1657929107733,MATH 20C,B01,083762,Bach; Quang Tran,1,0,30,29
1657929113756,MATH 20D,A01,083765,Tran; Brian Kha,5,0,30,25
1657929113756,MATH 20D,A02,083766,Tran; Brian Kha,5,0,30,25
1657929113756,MATH 20D,A03,083767,Tran; Brian Kha,6,0,30,24
1657929119780,MATH 20E,A01,083771,Ganguly; Soumya,12,0,32,20
1657929119780,MATH 20E,A02,083772,Ganguly; Soumya,7,0,32,25
1657929119780,MATH 20E,B01,083773,Ciotti; Benjamin,20,0,35,15
1657929119780,MATH 20E,B02,083774,Ciotti; Benjamin,18,0,35,17
1657929125809,MATH 103A,A01,083777,Greenfeld; Be'Eri,3,0,36,33
1657929125809,MATH 103A,A02,083778,Greenfeld; Be'Eri,5,0,36,31
1657929125809,MATH 103A,A03,093561,Greenfeld; Be'Eri,6,0,36,30
1657929125809,MATH 103A,B01,083779,Greenfeld; Be'Eri,8,0,36,28
1657929125809,MATH 103A,B02,083780,Greenfeld; Be'Eri,4,0,36,32
1657929125809,MATH 103A,B03,093562,Greenfeld; Be'Eri,3,0,36,33
1657929131837,MATH 105,A01,085443,Carter; Anne Toulson,15,0,35,20
1657929131837,MATH 105,A02,093477,Carter; Anne Toulson,20,0,35,15
1657929137861,MATH 109,A01,083213,Ganzberger; Geoffrey Michael,3,0,34,31
1657929137861,MATH 109,A02,083214,Ganzberger; Geoffrey Michael,4,0,34,30
1657929137861,MATH 109,A03,093478,Ganzberger; Geoffrey Michael,2,0,34,32
1657929137861,MATH 109,B01,083215,Ganzberger; Geoffrey Michael,2,0,32,30
1657929137861,MATH 109,B02,083216,Ganzberger; Geoffrey Michael,3,0,32,29
1657929137861,MATH 109,B03,093479,Ganzberger; Geoffrey Michael,8,0,32,24
1657929143886,MATH 142A,A01,083219,Chow; Bennett,7,0,32,25
1657929143886,MATH 142A,A02,083220,Chow; Bennett,10,0,32,22
1657929143886,MATH 142A,A03,093480,Chow; Bennett,9,0,32,23
1657929143886,MATH 142A,B03,093481,Chow; Bennett,8,0,32,24
1657929143886,MATH 142A,B04,093558,Chow; Bennett,13,0,32,19
1657929143886,MATH 142A,B05,093559,Chow; Bennett,7,0,32,25
1657929149918,MATH 193A,A01,083224,Rotar; Vladimir,8,0,34,26
1657929149918,MATH 193A,A02,083225,Rotar; Vladimir,10,0,34,24
1657929149918,MATH 193A,A03,083781,Rotar; Vladimir,5,0,34,29
1657929149918,MATH 193A,A04,083782,Rotar; Vladimir,11,0,34,23
1657929149918,MATH 193A,A05,093482,Rotar; Vladimir,11,0,34,23
1657929155943,MATH 197,001,091859,McAuley; Julian John,9999,0,9999,0
1657929155943,MATH 197,002,095566,Kedlaya; Kiran S.,9997,0,9999,2
1657929155943,MATH 197,003,095567,Xiao; Ming,9999,0,9999,0
1657929155943,MATH 197,004,095571,Perols; Johan Lars,9998,0,9999,1
1657929163004,COGS 9,A01,083615,Shannon; Kyle Michael,10,0,75,65
1657929169027,COGS 11,A01,083617,Boyle; Mary E. T.,23,0,48,25
1657929175050,COGS 13,A01,083071,Bastos; Amalia Pinkusfeld,12,0,71,59
1657929181073,COGS 14A,A01,092681,Semenuks; Arturs,5,1,100,95
1657929187106,COGS 14B,A01,083073,Cheng; Tzu-Han,7,0,63,56
1657929193133,COGS 17,A01,092677,Semenuks; Arturs,7,0,81,74
1657929199158,COGS 100,A01,083619,Allen; Michael Gordon,17,0,70,53
1657929205185,COGS 101A,A01,083621,Davis; Joshua Daniel,9,0,68,59
1657929211215,COGS 101B,A01,091572,Allen; Michael Gordon,14,0,65,51
1657929217242,COGS 101C,A01,083625,Delgado; Tania,17,0,35,18
1657929223271,COGS 107A,A01,083627,Boyle; Mary E. T.,14,0,60,46
1657929229395,COGS 118A,A01,083075,Gupta; Anjum,21,0,76,55
1657929235419,CSE 3,A50,083646,Miranda; Gregory Joseph,24,0,50,26
1657929241449,CSE 8A,A50,083650,Miranda; Gregory Joseph,17,1,56,39
1657929247476,CSE 11,A01,083080,Cao; Yingjun,6,15,40,34
1657929253502,CSE 12,A01,083652,Krause-Levy; Sophia Louisa,30,1,120,90
1657929259529,CSE 15L,A01,083654,Morris; Justin Loren,9,0,50,41
1657929259529,CSE 15L,A02,083655,Morris; Justin Loren,10,0,50,40
1657929265564,CSE 20,A01,083657,Tran; Khoa Dang,39,0,80,41
1657929271586,CSE 21,A01,095574,Bach; Quang Tran,23,0,48,25
1657929277614,CSE 30,A01,083084,Eldon; John,7,0,80,73
1657929277614,CSE 30,B01,095061,Bhaskar; Nishant,9,0,50,41
1657929283637,CSE 100,A01,083659,Cao; Yingjun,5,4,70,65
1657929289674,CSE 134B,A01,083661,Powell; Thomas Allan,25,0,100,75
1657929295697,CSE 140,A01,083663,Gungor; Onat,17,0,85,68
1657929301722,CSE 140L,A01,083088,Eldon; John,23,0,100,77
1657929307746,CSE 175,A01,083665,Kumar; Rakesh,3,0,25,22
1657929313770,CSE 190,A00,092507,Dubnov; Shlomo,8,0,20,12
1657929319796,ECE 45,A01,083139,Congero; Spencer William,7,0,75,68
1657929325820,ECE 65,A50,083695,Saad; Andrew S,12,0,30,18
1657929325820,ECE 65,A51,095125,Saad; Andrew S,24,0,26,2
1657929331854,ECE 109,A01,091882,Touri; Behrouz,20,0,70,50
1657929337886,ECE 180,A00,083140,Abi Samra; Nicholas Camill,1,0,30,29
1657929337886,ECE 180,B00,083141,Abi Samra; Nicholas Camill,0,0,30,30
1657929343908,MATH 10A,A01,083735,Patchell; Gregory David,2,0,30,28
1657929343908,MATH 10A,A02,083736,Patchell; Gregory David,20,0,30,10
1657929343908,MATH 10A,A03,083737,Patchell; Gregory David,16,0,30,14
1657929349939,MATH 10B,A01,083207,Lim; Seonhee,8,0,34,26
1657929349939,MATH 10B,A02,083208,Lim; Seonhee,10,0,35,25
1657929349939,MATH 10B,A03,093472,Lim; Seonhee,7,0,34,27
1657929349939,MATH 10B,B01,083739,Sinha; Shubham,14,0,30,16
1657929355973,MATH 18,A01,083743,Cinel; Cameron Alexander,9,0,30,21
1657929355973,MATH 18,A02,083744,Cinel; Cameron Alexander,18,0,30,12
1657929355973,MATH 18,A03,083745,Cinel; Cameron Alexander,10,0,30,20
1657929355973,MATH 18,B01,083748,Rideout; David Porter,5,0,37,32
1657929355973,MATH 18,B02,083749,Rideout; David Porter,5,0,36,31
1657929355973,MATH 18,B03,083750,Rideout; David Porter,3,0,37,34
1657929355973,MATH 18,B04,083751,Rideout; David Porter,7,0,36,29
1657929355973,MATH 18,B05,093473,Rideout; David Porter,7,0,36,29
1657929355973,MATH 18,B06,093474,Rideout; David Porter,6,0,36,30
1657929362002,MATH 20A,A01,083754,Zheng; Zequn,14,0,40,26
1657929368025,MATH 20B,A01,083756,Briones; Jor-el Thomas Caparas,4,0,36,32
1657929368025,MATH 20B,A02,083757,Briones; Jor-el Thomas Caparas,1,0,36,35
1657929368025,MATH 20B,A03,093475,Briones; Jor-el Thomas Caparas,3,0,36,33
1657929374050,MATH 20C,A01,083760,Briones; Jor-el Thomas Caparas,1,0,35,34
1657929374050,MATH 20C,A02,083761,Briones; Jor-el Thomas Caparas,8,0,35,27
1657929374050,MATH 20C,A03,093476,Briones; Jor-el Thomas Caparas,0,1,36,36
1657929374050,MATH 20C,B01,083762,Bach; Quang Tran,1,0,30,29
1657929380077,MATH 20D,A01,083765,Tran; Brian Kha,5,0,30,25
1657929380077,MATH 20D,A02,083766,Tran; Brian Kha,5,0,30,25
1657929380077,MATH 20D,A03,083767,Tran; Brian Kha,6,0,30,24
1657929386107,MATH 20E,A01,083771,Ganguly; Soumya,12,0,32,20
1657929386107,MATH 20E,A02,083772,Ganguly; Soumya,7,0,32,25
1657929386107,MATH 20E,B01,083773,Ciotti; Benjamin,20,0,35,15
1657929386107,MATH 20E,B02,083774,Ciotti; Benjamin,18,0,35,17
1657929392139,MATH 103A,A01,083777,Greenfeld; Be'Eri,3,0,36,33
1657929392139,MATH 103A,A02,083778,Greenfeld; Be'Eri,5,0,36,31
1657929392139,MATH 103A,A03,093561,Greenfeld; Be'Eri,6,0,36,30
1657929392139,MATH 103A,B01,083779,Greenfeld; Be'Eri,8,0,36,28
1657929392139,MATH 103A,B02,083780,Greenfeld; Be'Eri,4,0,36,32
1657929392139,MATH 103A,B03,093562,Greenfeld; Be'Eri,3,0,36,33
1657929398162,MATH 105,A01,085443,Carter; Anne Toulson,15,0,35,20
1657929398162,MATH 105,A02,093477,Carter; Anne Toulson,20,0,35,15
1657929404184,MATH 109,A01,083213,Ganzberger; Geoffrey Michael,3,0,34,31
1657929404184,MATH 109,A02,083214,Ganzberger; Geoffrey Michael,4,0,34,30
1657929404184,MATH 109,A03,093478,Ganzberger; Geoffrey Michael,2,0,34,32
1657929404184,MATH 109,B01,083215,Ganzberger; Geoffrey Michael,2,0,32,30
1657929404184,MATH 109,B02,083216,Ganzberger; Geoffrey Michael,3,0,32,29
1657929404184,MATH 109,B03,093479,Ganzberger; Geoffrey Michael,8,0,32,24
1657929410207,MATH 142A,A01,083219,Chow; Bennett,7,0,32,25
1657929410207,MATH 142A,A02,083220,Chow; Bennett,10,0,32,22
1657929410207,MATH 142A,A03,093480,Chow; Bennett,9,0,32,23
1657929410207,MATH 142A,B03,093481,Chow; Bennett,8,0,32,24
1657929410207,MATH 142A,B04,093558,Chow; Bennett,13,0,32,19
1657929410207,MATH 142A,B05,093559,Chow; Bennett,7,0,32,25
1657929416234,MATH 193A,A01,083224,Rotar; Vladimir,8,0,34,26
1657929416234,MATH 193A,A02,083225,Rotar; Vladimir,10,0,34,24
1657929416234,MATH 193A,A03,083781,Rotar; Vladimir,5,0,34,29
1657929416234,MATH 193A,A04,083782,Rotar; Vladimir,11,0,34,23
1657929416234,MATH 193A,A05,093482,Rotar; Vladimir,11,0,34,23
1657929422271,MATH 197,001,091859,McAuley; Julian John,9999,0,9999,0
1657929422271,MATH 197,002,095566,Kedlaya; Kiran S.,9997,0,9999,2
1657929422271,MATH 197,003,095567,Xiao; Ming,9999,0,9999,0
1657929422271,MATH 197,004,095571,Perols; Johan Lars,9998,0,9999,1
1657929429326,COGS 9,A01,083615,Shannon; Kyle Michael,10,0,75,65
1657929435351,COGS 11,A01,083617,Boyle; Mary E. T.,23,0,48,25
1657929441380,COGS 13,A01,083071,Bastos; Amalia Pinkusfeld,12,0,71,59
1657929447406,COGS 14A,A01,092681,Semenuks; Arturs,5,1,100,95
1657929453432,COGS 14B,A01,083073,Cheng; Tzu-Han,7,0,63,56
1657929459459,COGS 17,A01,092677,Semenuks; Arturs,7,0,81,74
1657929465482,COGS 100,A01,083619,Allen; Michael Gordon,17,0,70,53
1657929471510,COGS 101A,A01,083621,Davis; Joshua Daniel,9,0,68,59
1657929477536,COGS 101B,A01,091572,Allen; Michael Gordon,14,0,65,51
1657929483563,COGS 101C,A01,083625,Delgado; Tania,17,0,35,18
1657929489589,COGS 107A,A01,083627,Boyle; Mary E. T.,14,0,60,46
1657929495623,COGS 118A,A01,083075,Gupta; Anjum,21,0,76,55
1657929501646,CSE 3,A50,083646,Miranda; Gregory Joseph,24,0,50,26
1657929507669,CSE 8A,A50,083650,Miranda; Gregory Joseph,17,1,56,39
1657929513696,CSE 11,A01,083080,Cao; Yingjun,6,15,40,34
1657929519722,CSE 12,A01,083652,Krause-Levy; Sophia Louisa,30,1,120,90
1657929525744,CSE 15L,A01,083654,Morris; Justin Loren,9,0,50,41
1657929525744,CSE 15L,A02,083655,Morris; Justin Loren,10,0,50,40
1657929531770,CSE 20,A01,083657,Tran; Khoa Dang,39,0,80,41
1657929537797,CSE 21,A01,095574,Bach; Quang Tran,23,0,48,25
1657929543822,CSE 30,A01,083084,Eldon; John,7,0,80,73
1657929543822,CSE 30,B01,095061,Bhaskar; Nishant,9,0,50,41
1657929549845,CSE 100,A01,083659,Cao; Yingjun,5,4,70,65
1657929555869,CSE 134B,A01,083661,Powell; Thomas Allan,25,0,100,75
1657929561892,CSE 140,A01,083663,Gungor; Onat,17,0,85,68
1657929567921,CSE 140L,A01,083088,Eldon; John,23,0,100,77
1657929573959,CSE 175,A01,083665,Kumar; Rakesh,3,0,25,22
1657929579980,CSE 190,A00,092507,Dubnov; Shlomo,8,0,20,12
1657929586005,ECE 45,A01,083139,Congero; Spencer William,7,0,75,68
1657929592033,ECE 65,A50,083695,Saad; Andrew S,12,0,30,18
1657929592033,ECE 65,A51,095125,Saad; Andrew S,24,0,26,2
1657929598057,ECE 109,A01,091882,Touri; Behrouz,20,0,70,50
1657929604085,ECE 180,A00,083140,Abi Samra; Nicholas Camill,1,0,30,29
1657929604085,ECE 180,B00,083141,Abi Samra; Nicholas Camill,0,0,30,30
1657929610113,MATH 10A,A01,083735,Patchell; Gregory David,2,0,30,28
1657929610113,MATH 10A,A02,083736,Patchell; Gregory David,20,0,30,10
1657929610113,MATH 10A,A03,083737,Patchell; Gregory David,16,0,30,14
1657929616136,MATH 10B,A01,083207,Lim; Seonhee,8,0,34,26
1657929616136,MATH 10B,A02,083208,Lim; Seonhee,10,0,35,25
1657929616136,MATH 10B,A03,093472,Lim; Seonhee,7,0,34,27
1657929616136,MATH 10B,B01,083739,Sinha; Shubham,14,0,30,16
1657929622159,MATH 18,A01,083743,Cinel; Cameron Alexander,9,0,30,21
1657929622159,MATH 18,A02,083744,Cinel; Cameron Alexander,18,0,30,12
1657929622159,MATH 18,A03,083745,Cinel; Cameron Alexander,10,0,30,20
1657929622159,MATH 18,B01,083748,Rideout; David Porter,5,0,37,32
1657929622159,MATH 18,B02,083749,Rideout; David Porter,5,0,36,31
1657929622159,MATH 18,B03,083750,Rideout; David Porter,3,0,37,34
1657929622159,MATH 18,B04,083751,Rideout; David Porter,7,0,36,29
1657929622159,MATH 18,B05,093473,Rideout; David Porter,7,0,36,29
1657929622159,MATH 18,B06,093474,Rideout; David Porter,6,0,36,30
1657929628181,MATH 20A,A01,083754,Zheng; Zequn,14,0,40,26
1657929634203,MATH 20B,A01,083756,Briones; Jor-el Thomas Caparas,4,0,36,32
1657929634203,MATH 20B,A02,083757,Briones; Jor-el Thomas Caparas,1,0,36,35
1657929634203,MATH 20B,A03,093475,Briones; Jor-el Thomas Caparas,3,0,36,33
1657929640231,MATH 20C,A01,083760,Briones; Jor-el Thomas Caparas,1,0,35,34
1657929640231,MATH 20C,A02,083761,Briones; Jor-el Thomas Caparas,8,0,35,27
1657929640231,MATH 20C,A03,093476,Briones; Jor-el Thomas Caparas,0,1,36,36
1657929640231,MATH 20C,B01,083762,Bach; Quang Tran,1,0,30,29
1657929646254,MATH 20D,A01,083765,Tran; Brian Kha,5,0,30,25
1657929646254,MATH 20D,A02,083766,Tran; Brian Kha,5,0,30,25
1657929646254,MATH 20D,A03,083767,Tran; Brian Kha,6,0,30,24
1657929652281,MATH 20E,A01,083771,Ganguly; Soumya,12,0,32,20
1657929652281,MATH 20E,A02,083772,Ganguly; Soumya,7,0,32,25
1657929652281,MATH 20E,B01,083773,Ciotti; Benjamin,20,0,35,15
1657929652281,MATH 20E,B02,083774,Ciotti; Benjamin,18,0,35,17
1657929658325,MATH 103A,A01,083777,Greenfeld; Be'Eri,3,0,36,33
1657929658325,MATH 103A,A02,083778,Greenfeld; Be'Eri,5,0,36,31
1657929658325,MATH 103A,A03,093561,Greenfeld; Be'Eri,6,0,36,30
1657929658325,MATH 103A,B01,083779,Greenfeld; Be'Eri,8,0,36,28
1657929658325,MATH 103A,B02,083780,Greenfeld; Be'Eri,4,0,36,32
1657929658325,MATH 103A,B03,093562,Greenfeld; Be'Eri,3,0,36,33
1657929664357,MATH 105,A01,085443,Carter; Anne Toulson,15,0,35,20
1657929664357,MATH 105,A02,093477,Carter; Anne Toulson,20,0,35,15
1657929670391,MATH 109,A01,083213,Ganzberger; Geoffrey Michael,3,0,34,31
1657929670391,MATH 109,A02,083214,Ganzberger; Geoffrey Michael,4,0,34,30
1657929670391,MATH 109,A03,093478,Ganzberger; Geoffrey Michael,2,0,34,32
1657929670391,MATH 109,B01,083215,Ganzberger; Geoffrey Michael,2,0,32,30
1657929670391,MATH 109,B02,083216,Ganzberger; Geoffrey Michael,3,0,32,29
1657929670391,MATH 109,B03,093479,Ganzberger; Geoffrey Michael,8,0,32,24
1657929676415,MATH 142A,A01,083219,Chow; Bennett,7,0,32,25
1657929676415,MATH 142A,A02,083220,Chow; Bennett,10,0,32,22
1657929676415,MATH 142A,A03,093480,Chow; Bennett,9,0,32,23
1657929676415,MATH 142A,B03,093481,Chow; Bennett,8,0,32,24
1657929676415,MATH 142A,B04,093558,Chow; Bennett,13,0,32,19
1657929676415,MATH 142A,B05,093559,Chow; Bennett,7,0,32,25
1657929682439,MATH 193A,A01,083224,Rotar; Vladimir,8,0,34,26
1657929682439,MATH 193A,A02,083225,Rotar; Vladimir,10,0,34,24
1657929682439,MATH 193A,A03,083781,Rotar; Vladimir,5,0,34,29
1657929682439,MATH 193A,A04,083782,Rotar; Vladimir,11,0,34,23
1657929682439,MATH 193A,A05,093482,Rotar; Vladimir,11,0,34,23
1657929688468,MATH 197,001,091859,McAuley; Julian John,9999,0,9999,0
1657929688468,MATH 197,002,095566,Kedlaya; Kiran S.,9997,0,9999,2
1657929688468,MATH 197,003,095567,Xiao; Ming,9999,0,9999,0
1657929688468,MATH 197,004,095571,Perols; Johan Lars,9998,0,9999,1
1657929695523,COGS 9,A01,083615,Shannon; Kyle Michael,10,0,75,65
1657929701546,COGS 11,A01,083617,Boyle; Mary E. T.,23,0,48,25
1657929707573,COGS 13,A01,083071,Bastos; Amalia Pinkusfeld,12,0,71,59
1657929713596,COGS 14A,A01,092681,Semenuks; Arturs,5,1,100,95
1657929719619,COGS 14B,A01,083073,Cheng; Tzu-Han,7,0,63,56
1657929725641,COGS 17,A01,092677,Semenuks; Arturs,7,0,81,74
1657929731663,COGS 100,A01,083619,Allen; Michael Gordon,17,0,70,53
1657929737684,COGS 101A,A01,083621,Davis; Joshua Daniel,9,0,68,59
1657929743711,COGS 101B,A01,091572,Allen; Michael Gordon,14,0,65,51
1657929749733,COGS 101C,A01,083625,Delgado; Tania,17,0,35,18
1657929755756,COGS 107A,A01,083627,Boyle; Mary E. T.,14,0,60,46
1657929761779,COGS 118A,A01,083075,Gupta; Anjum,21,0,76,55
1657929767816,CSE 3,A50,083646,Miranda; Gregory Joseph,24,0,50,26
1657929773844,CSE 8A,A50,083650,Miranda; Gregory Joseph,17,1,56,39
1657929779870,CSE 11,A01,083080,Cao; Yingjun,6,15,40,34
1657929785905,CSE 12,A01,083652,Krause-Levy; Sophia Louisa,30,1,120,90
1657929791926,CSE 15L,A01,083654,Morris; Justin Loren,9,0,50,41
1657929791926,CSE 15L,A02,083655,Morris; Justin Loren,10,0,50,40
1657929797956,CSE 20,A01,083657,Tran; Khoa Dang,39,0,80,41
1657929803982,CSE 21,A01,095574,Bach; Quang Tran,23,0,48,25
1657929810005,CSE 30,A01,083084,Eldon; John,7,0,80,73
1657929810005,CSE 30,B01,095061,Bhaskar; Nishant,9,0,50,41
1657929816032,CSE 100,A01,083659,Cao; Yingjun,5,4,70,65
1657929822061,CSE 134B,A01,083661,Powell; Thomas Allan,25,0,100,75
1657929828177,CSE 140,A01,083663,Gungor; Onat,17,0,85,68
1657929834201,CSE 140L,A01,083088,Eldon; John,23,0,100,77
1657929840231,CSE 175,A01,083665,Kumar; Rakesh,3,0,25,22
1657929846259,CSE 190,A00,092507,Dubnov; Shlomo,8,0,20,12
1657929852289,ECE 45,A01,083139,Congero; Spencer William,7,0,75,68
1657929858315,ECE 65,A50,083695,Saad; Andrew S,12,0,30,18
1657929858315,ECE 65,A51,095125,Saad; Andrew S,24,0,26,2
1657929864342,ECE 109,A01,091882,Touri; Behrouz,20,0,70,50
1657929870365,ECE 180,A00,083140,Abi Samra; Nicholas Camill,1,0,30,29
1657929870365,ECE 180,B00,083141,Abi Samra; Nicholas Camill,0,0,30,30
1657929876392,MATH 10A,A01,083735,Patchell; Gregory David,2,0,30,28
1657929876392,MATH 10A,A02,083736,Patchell; Gregory David,20,0,30,10
1657929876392,MATH 10A,A03,083737,Patchell; Gregory David,16,0,30,14
1657929882420,MATH 10B,A01,083207,Lim; Seonhee,8,0,34,26
1657929882420,MATH 10B,A02,083208,Lim; Seonhee,10,0,35,25
1657929882420,MATH 10B,A03,093472,Lim; Seonhee,7,0,34,27
1657929882420,MATH 10B,B01,083739,Sinha; Shubham,14,0,30,16
1657929888444,MATH 18,A01,083743,Cinel; Cameron Alexander,9,0,30,21
1657929888444,MATH 18,A02,083744,Cinel; Cameron Alexander,18,0,30,12
1657929888444,MATH 18,A03,083745,Cinel; Cameron Alexander,10,0,30,20
1657929888444,MATH 18,B01,083748,Rideout; David Porter,5,0,37,32
1657929888444,MATH 18,B02,083749,Rideout; David Porter,5,0,36,31
1657929888444,MATH 18,B03,083750,Rideout; David Porter,3,0,37,34
1657929888444,MATH 18,B04,083751,Rideout; David Porter,7,0,36,29
1657929888444,MATH 18,B05,093473,Rideout; David Porter,7,0,36,29
1657929888444,MATH 18,B06,093474,Rideout; David Porter,6,0,36,30
1657929894467,MATH 20A,A01,083754,Zheng; Zequn,14,0,40,26
1657929900502,MATH 20B,A01,083756,Briones; Jor-el Thomas Caparas,4,0,36,32
1657929900502,MATH 20B,A02,083757,Briones; Jor-el Thomas Caparas,1,0,36,35
1657929900502,MATH 20B,A03,093475,Briones; Jor-el Thomas Caparas,3,0,36,33
1657929906525,MATH 20C,A01,083760,Briones; Jor-el Thomas Caparas,1,0,35,34
1657929906525,MATH 20C,A02,083761,Briones; Jor-el Thomas Caparas,8,0,35,27
1657929906525,MATH 20C,A03,093476,Briones; Jor-el Thomas Caparas,0,1,36,36
1657929906525,MATH 20C,B01,083762,Bach; Quang Tran,1,0,30,29
1657929912554,MATH 20D,A01,083765,Tran; Brian Kha,5,0,30,25
1657929912554,MATH 20D,A02,083766,Tran; Brian Kha,5,0,30,25
1657929912554,MATH 20D,A03,083767,Tran; Brian Kha,6,0,30,24
1657929918582,MATH 20E,A01,083771,Ganguly; Soumya,12,0,32,20
1657929918582,MATH 20E,A02,083772,Ganguly; Soumya,7,0,32,25
1657929918582,MATH 20E,B01,083773,Ciotti; Benjamin,20,0,35,15
1657929918582,MATH 20E,B02,083774,Ciotti; Benjamin,18,0,35,17
1657929924606,MATH 103A,A01,083777,Greenfeld; Be'Eri,3,0,36,33
1657929924606,MATH 103A,A02,083778,Greenfeld; Be'Eri,5,0,36,31
1657929924606,MATH 103A,A03,093561,Greenfeld; Be'Eri,6,0,36,30
1657929924606,MATH 103A,B01,083779,Greenfeld; Be'Eri,8,0,36,28
1657929924606,MATH 103A,B02,083780,Greenfeld; Be'Eri,4,0,36,32
1657929924606,MATH 103A,B03,093562,Greenfeld; Be'Eri,3,0,36,33
1657929930628,MATH 105,A01,085443,Carter; Anne Toulson,15,0,35,20
1657929930628,MATH 105,A02,093477,Carter; Anne Toulson,20,0,35,15
1657929936657,MATH 109,A01,083213,Ganzberger; Geoffrey Michael,3,0,34,31
1657929936657,MATH 109,A02,083214,Ganzberger; Geoffrey Michael,4,0,34,30
1657929936657,MATH 109,A03,093478,Ganzberger; Geoffrey Michael,2,0,34,32
1657929936657,MATH 109,B01,083215,Ganzberger; Geoffrey Michael,2,0,32,30
1657929936657,MATH 109,B02,083216,Ganzberger; Geoffrey Michael,3,0,32,29
1657929936657,MATH 109,B03,093479,Ganzberger; Geoffrey Michael,8,0,32,24
1657929942682,MATH 142A,A01,083219,Chow; Bennett,7,0,32,25
1657929942682,MATH 142A,A02,083220,Chow; Bennett,10,0,32,22
1657929942682,MATH 142A,A03,093480,Chow; Bennett,9,0,32,23
1657929942682,MATH 142A,B03,093481,Chow; Bennett,8,0,32,24
1657929942682,MATH 142A,B04,093558,Chow; Bennett,13,0,32,19
1657929942682,MATH 142A,B05,093559,Chow; Bennett,7,0,32,25
1657929948710,MATH 193A,A01,083224,Rotar; Vladimir,8,0,34,26
1657929948710,MATH 193A,A02,083225,Rotar; Vladimir,10,0,34,24
1657929948710,MATH 193A,A03,083781,Rotar; Vladimir,5,0,34,29
1657929948710,MATH 193A,A04,083782,Rotar; Vladimir,11,0,34,23
1657929948710,MATH 193A,A05,093482,Rotar; Vladimir,11,0,34,23
1657929954734,MATH 197,001,091859,McAuley; Julian John,9999,0,9999,0
1657929954734,MATH 197,002,095566,Kedlaya; Kiran S.,9997,0,9999,2
1657929954734,MATH 197,003,095567,Xiao; Ming,9999,0,9999,0
1657929954734,MATH 197,004,095571,Perols; Johan Lars,9998,0,9999,1
1657929961791,COGS 9,A01,083615,Shannon; Kyle Michael,10,0,75,65
1657929967816,COGS 11,A01,083617,Boyle; Mary E. T.,23,0,48,25
1657929973839,COGS 13,A01,083071,Bastos; Amalia Pinkusfeld,12,0,71,59
1657929979863,COGS 14A,A01,092681,Semenuks; Arturs,5,1,100,95
1657929985887,COGS 14B,A01,083073,Cheng; Tzu-Han,7,0,63,56
1657929991909,COGS 17,A01,092677,Semenuks; Arturs,7,0,81,74
1657929997931,COGS 100,A01,083619,Allen; Michael Gordon,17,0,70,53
1657930003958,COGS 101A,A01,083621,Davis; Joshua Daniel,9,0,68,59
1657930009983,COGS 101B,A01,091572,Allen; Michael Gordon,14,0,65,51
1657930016007,COGS 101C,A01,083625,Delgado; Tania,17,0,35,18
1657930022030,COGS 107A,A01,083627,Boyle; Mary E. T.,14,0,60,46
1657930028074,COGS 118A,A01,083075,Gupta; Anjum,21,0,76,55
1657930034101,CSE 3,A50,083646,Miranda; Gregory Joseph,24,0,50,26
1657930040128,CSE 8A,A50,083650,Miranda; Gregory Joseph,17,1,56,39
1657930046156,CSE 11,A01,083080,Cao; Yingjun,6,15,40,34
1657930052183,CSE 12,A01,083652,Krause-Levy; Sophia Louisa,30,1,120,90
1657930058209,CSE 15L,A01,083654,Morris; Justin Loren,9,0,50,41
1657930058209,CSE 15L,A02,083655,Morris; Justin Loren,10,0,50,40
1657930064232,CSE 20,A01,083657,Tran; Khoa Dang,39,0,80,41
1657930070262,CSE 21,A01,095574,Bach; Quang Tran,23,0,48,25
1657930076286,CSE 30,A01,083084,Eldon; John,7,0,80,73
1657930076286,CSE 30,B01,095061,Bhaskar; Nishant,9,0,50,41
1657930082309,CSE 100,A01,083659,Cao; Yingjun,5,4,70,65
1657930088332,CSE 134B,A01,083661,Powell; Thomas Allan,25,0,100,75
1657930094356,CSE 140,A01,083663,Gungor; Onat,17,0,85,68
1657930100380,CSE 140L,A01,083088,Eldon; John,23,0,100,77
1657930106405,CSE 175,A01,083665,Kumar; Rakesh,3,0,25,22
1657930112428,CSE 190,A00,092507,Dubnov; Shlomo,8,0,20,12
1657930118454,ECE 45,A01,083139,Congero; Spencer William,7,0,75,68
1657930124479,ECE 65,A50,083695,Saad; Andrew S,12,0,30,18
1657930124479,ECE 65,A51,095125,Saad; Andrew S,24,0,26,2
1657930130502,ECE 109,A01,091882,Touri; Behrouz,20,0,70,50
1657930136529,ECE 180,A00,083140,Abi Samra; Nicholas Camill,1,0,30,29
1657930136529,ECE 180,B00,083141,Abi Samra; Nicholas Camill,0,0,30,30
1657930142552,MATH 10A,A01,083735,Patchell; Gregory David,2,0,30,28
1657930142552,MATH 10A,A02,083736,Patchell; Gregory David,20,0,30,10
1657930142552,MATH 10A,A03,083737,Patchell; Gregory David,16,0,30,14
1657930148580,MATH 10B,A01,083207,Lim; Seonhee,8,0,34,26
1657930148580,MATH 10B,A02,083208,Lim; Seonhee,10,0,35,25
1657930148580,MATH 10B,A03,093472,Lim; Seonhee,7,0,34,27
1657930148580,MATH 10B,B01,083739,Sinha; Shubham,14,0,30,16
1657930154625,MATH 18,A01,083743,Cinel; Cameron Alexander,9,0,30,21
1657930154625,MATH 18,A02,083744,Cinel; Cameron Alexander,18,0,30,12
1657930154625,MATH 18,A03,083745,Cinel; Cameron Alexander,10,0,30,20
1657930154625,MATH 18,B01,083748,Rideout; David Porter,5,0,37,32
1657930154625,MATH 18,B02,083749,Rideout; David Porter,5,0,36,31
1657930154625,MATH 18,B03,083750,Rideout; David Porter,3,0,37,34
1657930154625,MATH 18,B04,083751,Rideout; David Porter,7,0,36,29
1657930154625,MATH 18,B05,093473,Rideout; David Porter,7,0,36,29
1657930154625,MATH 18,B06,093474,Rideout; David Porter,6,0,36,30
1657930160647,MATH 20A,A01,083754,Zheng; Zequn,14,0,40,26
1657930166672,MATH 20B,A01,083756,Briones; Jor-el Thomas Caparas,4,0,36,32
1657930166672,MATH 20B,A02,083757,Briones; Jor-el Thomas Caparas,1,0,36,35
1657930166672,MATH 20B,A03,093475,Briones; Jor-el Thomas Caparas,3,0,36,33
1657930172696,MATH 20C,A01,083760,Briones; Jor-el Thomas Caparas,1,0,35,34
1657930172696,MATH 20C,A02,083761,Briones; Jor-el Thomas Caparas,8,0,35,27
1657930172696,MATH 20C,A03,093476,Briones; Jor-el Thomas Caparas,0,1,36,36
1657930172696,MATH 20C,B01,083762,Bach; Quang Tran,1,0,30,29
1657930178719,MATH 20D,A01,083765,Tran; Brian Kha,5,0,30,25
1657930178719,MATH 20D,A02,083766,Tran; Brian Kha,5,0,30,25
1657930178719,MATH 20D,A03,083767,Tran; Brian Kha,6,0,30,24
1657930184742,MATH 20E,A01,083771,Ganguly; Soumya,12,0,32,20
1657930184742,MATH 20E,A02,083772,Ganguly; Soumya,7,0,32,25
1657930184742,MATH 20E,B01,083773,Ciotti; Benjamin,20,0,35,15
1657930184742,MATH 20E,B02,083774,Ciotti; Benjamin,18,0,35,17
1657930190765,MATH 103A,A01,083777,Greenfeld; Be'Eri,3,0,36,33
1657930190765,MATH 103A,A02,083778,Greenfeld; Be'Eri,5,0,36,31
1657930190765,MATH 103A,A03,093561,Greenfeld; Be'Eri,6,0,36,30
1657930190765,MATH 103A,B01,083779,Greenfeld; Be'Eri,8,0,36,28
1657930190765,MATH 103A,B02,083780,Greenfeld; Be'Eri,4,0,36,32
1657930190765,MATH 103A,B03,093562,Greenfeld; Be'Eri,3,0,36,33
1657930196790,MATH 105,A01,085443,Carter; Anne Toulson,15,0,35,20
1657930196790,MATH 105,A02,093477,Carter; Anne Toulson,20,0,35,15
1657930202814,MATH 109,A01,083213,Ganzberger; Geoffrey Michael,3,0,34,31
1657930202814,MATH 109,A02,083214,Ganzberger; Geoffrey Michael,4,0,34,30
1657930202814,MATH 109,A03,093478,Ganzberger; Geoffrey Michael,2,0,34,32
1657930202814,MATH 109,B01,083215,Ganzberger; Geoffrey Michael,2,0,32,30
1657930202814,MATH 109,B02,083216,Ganzberger; Geoffrey Michael,3,0,32,29
1657930202814,MATH 109,B03,093479,Ganzberger; Geoffrey Michael,8,0,32,24
1657930208848,MATH 142A,A01,083219,Chow; Bennett,7,0,32,25
1657930208848,MATH 142A,A02,083220,Chow; Bennett,10,0,32,22
1657930208848,MATH 142A,A03,093480,Chow; Bennett,9,0,32,23
1657930208848,MATH 142A,B03,093481,Chow; Bennett,8,0,32,24
1657930208848,MATH 142A,B04,093558,Chow; Bennett,13,0,32,19
1657930208848,MATH 142A,B05,093559,Chow; Bennett,7,0,32,25
1657930214872,MATH 193A,A01,083224,Rotar; Vladimir,8,0,34,26
1657930214872,MATH 193A,A02,083225,Rotar; Vladimir,10,0,34,24
1657930214872,MATH 193A,A03,083781,Rotar; Vladimir,5,0,34,29
1657930214872,MATH 193A,A04,083782,Rotar; Vladimir,11,0,34,23
1657930214872,MATH 193A,A05,093482,Rotar; Vladimir,11,0,34,23
1657930220896,MATH 197,001,091859,McAuley; Julian John,9999,0,9999,0
1657930220896,MATH 197,002,095566,Kedlaya; Kiran S.,9997,0,9999,2
1657930220896,MATH 197,003,095567,Xiao; Ming,9999,0,9999,0
1657930220896,MATH 197,004,095571,Perols; Johan Lars,9998,0,9999,1
1657930227952,COGS 9,A01,083615,Shannon; Kyle Michael,11,0,75,64
1657930233975,COGS 11,A01,083617,Boyle; Mary E. T.,23,0,48,25
1657930239999,COGS 13,A01,083071,Bastos; Amalia Pinkusfeld,12,0,71,59
1657930246023,COGS 14A,A01,092681,Semenuks; Arturs,5,1,100,95
1657930252056,COGS 14B,A01,083073,Cheng; Tzu-Han,7,0,63,56
1657930258080,COGS 17,A01,092677,Semenuks; Arturs,7,0,81,74
1657930264103,COGS 100,A01,083619,Allen; Michael Gordon,17,0,70,53
1657930270126,COGS 101A,A01,083621,Davis; Joshua Daniel,9,0,68,59
1657930276152,COGS 101B,A01,091572,Allen; Michael Gordon,14,0,65,51
1657930282175,COGS 101C,A01,083625,Delgado; Tania,17,0,35,18
1657930288198,COGS 107A,A01,083627,Boyle; Mary E. T.,14,0,60,46
1657930294224,COGS 118A,A01,083075,Gupta; Anjum,21,0,76,55
1657930300249,CSE 3,A50,083646,Miranda; Gregory Joseph,24,0,50,26
1657930306279,CSE 8A,A50,083650,Miranda; Gregory Joseph,17,1,56,39
1657930312307,CSE 11,A01,083080,Cao; Yingjun,6,15,40,34
1657930318333,CSE 12,A01,083652,Krause-Levy; Sophia Louisa,30,1,120,90
1657930324363,CSE 15L,A01,083654,Morris; Justin Loren,9,0,50,41
1657930324363,CSE 15L,A02,083655,Morris; Justin Loren,10,0,50,40
1657930330391,CSE 20,A01,083657,Tran; Khoa Dang,39,0,80,41
1657930336419,CSE 21,A01,095574,Bach; Quang Tran,23,0,48,25
1657930342449,CSE 30,A01,083084,Eldon; John,7,0,80,73
1657930342449,CSE 30,B01,095061,Bhaskar; Nishant,9,0,50,41
1657930348473,CSE 100,A01,083659,Cao; Yingjun,5,4,70,65
1657930354502,CSE 134B,A01,083661,Powell; Thomas Allan,25,0,100,75
1657930360529,CSE 140,A01,083663,Gungor; Onat,17,0,85,68
1657930366555,CSE 140L,A01,083088,Eldon; John,23,0,100,77
1657930372578,CSE 175,A01,083665,Kumar; Rakesh,3,0,25,22
1657930378602,CSE 190,A00,092507,Dubnov; Shlomo,8,0,20,12
1657930384633,ECE 45,A01,083139,Congero; Spencer William,7,0,75,68
1657930390656,ECE 65,A50,083695,Saad; Andrew S,12,0,30,18
1657930390656,ECE 65,A51,095125,Saad; Andrew S,24,0,26,2
1657930396679,ECE 109,A01,091882,Touri; Behrouz,20,0,70,50
1657930402706,ECE 180,A00,083140,Abi Samra; Nicholas Camill,1,0,30,29
1657930402706,ECE 180,B00,083141,Abi Samra; Nicholas Camill,0,0,30,30
1657930408733,MATH 10A,A01,083735,Patchell; Gregory David,2,0,30,28
1657930408733,MATH 10A,A02,083736,Patchell; Gregory David,20,0,30,10
1657930408733,MATH 10A,A03,083737,Patchell; Gregory David,16,0,30,14
1657930414756,MATH 10B,A01,083207,Lim; Seonhee,8,0,34,26
1657930414756,MATH 10B,A02,083208,Lim; Seonhee,10,0,35,25
1657930414756,MATH 10B,A03,093472,Lim; Seonhee,7,0,34,27
1657930414756,MATH 10B,B01,083739,Sinha; Shubham,14,0,30,16
1657930420787,MATH 18,A01,083743,Cinel; Cameron Alexander,9,0,30,21
1657930420787,MATH 18,A02,083744,Cinel; Cameron Alexander,18,0,30,12
1657930420787,MATH 18,A03,083745,Cinel; Cameron Alexander,10,0,30,20
1657930420787,MATH 18,B01,083748,Rideout; David Porter,5,0,37,32
1657930420787,MATH 18,B02,083749,Rideout; David Porter,5,0,36,31
1657930420787,MATH 18,B03,083750,Rideout; David Porter,3,0,37,34
1657930420787,MATH 18,B04,083751,Rideout; David Porter,7,0,36,29
1657930420787,MATH 18,B05,093473,Rideout; David Porter,7,0,36,29
1657930420787,MATH 18,B06,093474,Rideout; David Porter,6,0,36,30
1657930426888,MATH 20A,A01,083754,Zheng; Zequn,14,0,40,26
1657930432912,MATH 20B,A01,083756,Briones; Jor-el Thomas Caparas,4,0,36,32
1657930432912,MATH 20B,A02,083757,Briones; Jor-el Thomas Caparas,1,0,36,35
1657930432912,MATH 20B,A03,093475,Briones; Jor-el Thomas Caparas,3,0,36,33
1657930438944,MATH 20C,A01,083760,Briones; Jor-el Thomas Caparas,1,0,35,34
1657930438944,MATH 20C,A02,083761,Briones; Jor-el Thomas Caparas,8,0,35,27
1657930438944,MATH 20C,A03,093476,Briones; Jor-el Thomas Caparas,0,1,36,36
1657930438944,MATH 20C,B01,083762,Bach; Quang Tran,1,0,30,29
1657930444969,MATH 20D,A01,083765,Tran; Brian Kha,5,0,30,25
1657930444969,MATH 20D,A02,083766,Tran; Brian Kha,5,0,30,25
1657930444969,MATH 20D,A03,083767,Tran; Brian Kha,6,0,30,24
1657930450996,MATH 20E,A01,083771,Ganguly; Soumya,12,0,32,20
1657930450996,MATH 20E,A02,083772,Ganguly; Soumya,7,0,32,25
1657930450996,MATH 20E,B01,083773,Ciotti; Benjamin,20,0,35,15
1657930450996,MATH 20E,B02,083774,Ciotti; Benjamin,18,0,35,17
1657930457023,MATH 103A,A01,083777,Greenfeld; Be'Eri,3,0,36,33
1657930457023,MATH 103A,A02,083778,Greenfeld; Be'Eri,5,0,36,31
1657930457023,MATH 103A,A03,093561,Greenfeld; Be'Eri,6,0,36,30
1657930457023,MATH 103A,B01,083779,Greenfeld; Be'Eri,8,0,36,28
1657930457023,MATH 103A,B02,083780,Greenfeld; Be'Eri,4,0,36,32
1657930457023,MATH 103A,B03,093562,Greenfeld; Be'Eri,3,0,36,33
1657930463046,MATH 105,A01,085443,Carter; Anne Toulson,15,0,35,20
1657930463046,MATH 105,A02,093477,Carter; Anne Toulson,20,0,35,15
1657930469074,MATH 109,A01,083213,Ganzberger; Geoffrey Michael,3,0,34,31
1657930469074,MATH 109,A02,083214,Ganzberger; Geoffrey Michael,4,0,34,30
1657930469074,MATH 109,A03,093478,Ganzberger; Geoffrey Michael,2,0,34,32
1657930469074,MATH 109,B01,083215,Ganzberger; Geoffrey Michael,2,0,32,30
1657930469074,MATH 109,B02,083216,Ganzberger; Geoffrey Michael,3,0,32,29
1657930469074,MATH 109,B03,093479,Ganzberger; Geoffrey Michael,8,0,32,24
1657930475097,MATH 142A,A01,083219,Chow; Bennett,7,0,32,25
1657930475097,MATH 142A,A02,083220,Chow; Bennett,10,0,32,22
1657930475097,MATH 142A,A03,093480,Chow; Bennett,9,0,32,23
1657930475097,MATH 142A,B03,093481,Chow; Bennett,8,0,32,24
1657930475097,MATH 142A,B04,093558,Chow; Bennett,13,0,32,19
1657930475097,MATH 142A,B05,093559,Chow; Bennett,7,0,32,25
1657930481121,MATH 193A,A01,083224,Rotar; Vladimir,8,0,34,26
1657930481121,MATH 193A,A02,083225,Rotar; Vladimir,10,0,34,24
1657930481121,MATH 193A,A03,083781,Rotar; Vladimir,5,0,34,29
1657930481121,MATH 193A,A04,083782,Rotar; Vladimir,11,0,34,23
1657930481121,MATH 193A,A05,093482,Rotar; Vladimir,11,0,34,23
1657930487145,MATH 197,001,091859,McAuley; Julian John,9999,0,9999,0
1657930487145,MATH 197,002,095566,Kedlaya; Kiran S.,9997,0,9999,2
1657930487145,MATH 197,003,095567,Xiao; Ming,9999,0,9999,0
1657930487145,MATH 197,004,095571,Perols; Johan Lars,9998,0,9999,1
1657930494209,COGS 9,A01,083615,Shannon; Kyle Michael,11,0,75,64
1657930500240,COGS 11,A01,083617,Boyle; Mary E. T.,23,0,48,25
1657930506268,COGS 13,A01,083071,Bastos; Amalia Pinkusfeld,12,0,71,59
1657930512290,COGS 14A,A01,092681,Semenuks; Arturs,5,1,100,95
1657930518313,COGS 14B,A01,083073,Cheng; Tzu-Han,7,0,63,56
1657930524340,COGS 17,A01,092677,Semenuks; Arturs,7,0,81,74
1657930530366,COGS 100,A01,083619,Allen; Michael Gordon,17,0,70,53
1657930536388,COGS 101A,A01,083621,Davis; Joshua Daniel,9,0,68,59
1657930542413,COGS 101B,A01,091572,Allen; Michael Gordon,14,0,65,51
1657930548442,COGS 101C,A01,083625,Delgado; Tania,17,0,35,18
1657930554465,COGS 107A,A01,083627,Boyle; Mary E. T.,14,0,60,46
1657930560493,COGS 118A,A01,083075,Gupta; Anjum,21,0,76,55
1657930566516,CSE 3,A50,083646,Miranda; Gregory Joseph,24,0,50,26
1657930572543,CSE 8A,A50,083650,Miranda; Gregory Joseph,17,1,56,39
1657930578566,CSE 11,A01,083080,Cao; Yingjun,6,15,40,34
1657930584588,CSE 12,A01,083652,Krause-Levy; Sophia Louisa,30,1,120,90
1657930590614,CSE 15L,A01,083654,Morris; Justin Loren,9,0,50,41
1657930590614,CSE 15L,A02,083655,Morris; Justin Loren,10,0,50,40
1657930596646,CSE 20,A01,083657,Tran; Khoa Dang,39,0,80,41
1657930602671,CSE 21,A01,095574,Bach; Quang Tran,23,0,48,25
1657930608693,CSE 30,A01,083084,Eldon; John,7,0,80,73
1657930608693,CSE 30,B01,095061,Bhaskar; Nishant,9,0,50,41
1657930614716,CSE 100,A01,083659,Cao; Yingjun,5,4,70,65
1657930620742,CSE 134B,A01,083661,Powell; Thomas Allan,25,0,100,75
1657930626775,CSE 140,A01,083663,Gungor; Onat,17,0,85,68
1657930632802,CSE 140L,A01,083088,Eldon; John,23,0,100,77
1657930638832,CSE 175,A01,083665,Kumar; Rakesh,3,0,25,22
1657930644855,CSE 190,A00,092507,Dubnov; Shlomo,8,0,20,12
1657930650885,ECE 45,A01,083139,Congero; Spencer William,7,0,75,68
1657930656909,ECE 65,A50,083695,Saad; Andrew S,12,0,30,18
1657930656909,ECE 65,A51,095125,Saad; Andrew S,24,0,26,2
1657930662932,ECE 109,A01,091882,Touri; Behrouz,20,0,70,50
1657930668959,ECE 180,A00,083140,Abi Samra; Nicholas Camill,1,0,30,29
1657930668959,ECE 180,B00,083141,Abi Samra; Nicholas Camill,0,0,30,30
1657930674981,MATH 10A,A01,083735,Patchell; Gregory David,2,0,30,28
1657930674981,MATH 10A,A02,083736,Patchell; Gregory David,20,0,30,10
1657930674981,MATH 10A,A03,083737,Patchell; Gregory David,16,0,30,14
1657930681008,MATH 10B,A01,083207,Lim; Seonhee,8,0,34,26
1657930681008,MATH 10B,A02,083208,Lim; Seonhee,10,0,35,25
1657930681008,MATH 10B,A03,093472,Lim; Seonhee,7,0,34,27
1657930681008,MATH 10B,B01,083739,Sinha; Shubham,14,0,30,16
1657930687107,MATH 18,A01,083743,Cinel; Cameron Alexander,9,0,30,21
1657930687107,MATH 18,A02,083744,Cinel; Cameron Alexander,18,0,30,12
1657930687107,MATH 18,A03,083745,Cinel; Cameron Alexander,10,0,30,20
1657930687107,MATH 18,B01,083748,Rideout; David Porter,5,0,37,32
1657930687107,MATH 18,B02,083749,Rideout; David Porter,5,0,36,31
1657930687107,MATH 18,B03,083750,Rideout; David Porter,3,0,37,34
1657930687107,MATH 18,B04,083751,Rideout; David Porter,7,0,36,29
1657930687107,MATH 18,B05,093473,Rideout; David Porter,7,0,36,29
1657930687107,MATH 18,B06,093474,Rideout; David Porter,6,0,36,30
1657930693133,MATH 20A,A01,083754,Zheng; Zequn,14,0,40,26
1657930699156,MATH 20B,A01,083756,Briones; Jor-el Thomas Caparas,4,0,36,32
1657930699156,MATH 20B,A02,083757,Briones; Jor-el Thomas Caparas,1,0,36,35
1657930699156,MATH 20B,A03,093475,Briones; Jor-el Thomas Caparas,3,0,36,33
1657930705179,MATH 20C,A01,083760,Briones; Jor-el Thomas Caparas,1,0,35,34
1657930705179,MATH 20C,A02,083761,Briones; Jor-el Thomas Caparas,8,0,35,27
1657930705179,MATH 20C,A03,093476,Briones; Jor-el Thomas Caparas,0,1,36,36
1657930705179,MATH 20C,B01,083762,Bach; Quang Tran,1,0,30,29
1657930711216,MATH 20D,A01,083765,Tran; Brian Kha,5,0,30,25
1657930711216,MATH 20D,A02,083766,Tran; Brian Kha,5,0,30,25
1657930711216,MATH 20D,A03,083767,Tran; Brian Kha,6,0,30,24
1657930717240,MATH 20E,A01,083771,Ganguly; Soumya,12,0,32,20
1657930717240,MATH 20E,A02,083772,Ganguly; Soumya,7,0,32,25
1657930717240,MATH 20E,B01,083773,Ciotti; Benjamin,20,0,35,15
1657930717240,MATH 20E,B02,083774,Ciotti; Benjamin,18,0,35,17
1657930723270,MATH 103A,A01,083777,Greenfeld; Be'Eri,3,0,36,33
1657930723270,MATH 103A,A02,083778,Greenfeld; Be'Eri,5,0,36,31
1657930723270,MATH 103A,A03,093561,Greenfeld; Be'Eri,6,0,36,30
1657930723270,MATH 103A,B01,083779,Greenfeld; Be'Eri,8,0,36,28
1657930723270,MATH 103A,B02,083780,Greenfeld; Be'Eri,4,0,36,32
1657930723270,MATH 103A,B03,093562,Greenfeld; Be'Eri,3,0,36,33
1657930729291,MATH 105,A01,085443,Carter; Anne Toulson,15,0,35,20
1657930729291,MATH 105,A02,093477,Carter; Anne Toulson,20,0,35,15
1657930735314,MATH 109,A01,083213,Ganzberger; Geoffrey Michael,3,0,34,31
1657930735314,MATH 109,A02,083214,Ganzberger; Geoffrey Michael,4,0,34,30
1657930735314,MATH 109,A03,093478,Ganzberger; Geoffrey Michael,2,0,34,32
1657930735314,MATH 109,B01,083215,Ganzberger; Geoffrey Michael,2,0,32,30
1657930735314,MATH 109,B02,083216,Ganzberger; Geoffrey Michael,3,0,32,29
1657930735314,MATH 109,B03,093479,Ganzberger; Geoffrey Michael,8,0,32,24
1657930741339,MATH 142A,A01,083219,Chow; Bennett,7,0,32,25
1657930741339,MATH 142A,A02,083220,Chow; Bennett,10,0,32,22
1657930741339,MATH 142A,A03,093480,Chow; Bennett,9,0,32,23
1657930741339,MATH 142A,B03,093481,Chow; Bennett,8,0,32,24
1657930741339,MATH 142A,B04,093558,Chow; Bennett,13,0,32,19
1657930741339,MATH 142A,B05,093559,Chow; Bennett,7,0,32,25
1657930747368,MATH 193A,A01,083224,Rotar; Vladimir,8,0,34,26
1657930747368,MATH 193A,A02,083225,Rotar; Vladimir,10,0,34,24
1657930747368,MATH 193A,A03,083781,Rotar; Vladimir,5,0,34,29
1657930747368,MATH 193A,A04,083782,Rotar; Vladimir,11,0,34,23
1657930747368,MATH 193A,A05,093482,Rotar; Vladimir,11,0,34,23
1657930753393,MATH 197,001,091859,McAuley; Julian John,9999,0,9999,0
1657930753393,MATH 197,002,095566,Kedlaya; Kiran S.,9997,0,9999,2
1657930753393,MATH 197,003,095567,Xiao; Ming,9999,0,9999,0
1657930753393,MATH 197,004,095571,Perols; Johan Lars,9998,0,9999,1
1657930760448,COGS 9,A01,083615,Shannon; Kyle Michael,11,0,75,64
1657930766477,COGS 11,A01,083617,Boyle; Mary E. T.,23,0,48,25
1657930772498,COGS 13,A01,083071,Bastos; Amalia Pinkusfeld,12,0,71,59
1657930778529,COGS 14A,A01,092681,Semenuks; Arturs,5,1,100,95
1657930784552,COGS 14B,A01,083073,Cheng; Tzu-Han,7,0,63,56
1657930790581,COGS 17,A01,092677,Semenuks; Arturs,7,0,81,74
1657930796603,COGS 100,A01,083619,Allen; Michael Gordon,17,0,70,53
1657930802634,COGS 101A,A01,083621,Davis; Joshua Daniel,9,0,68,59
1657930808658,COGS 101B,A01,091572,Allen; Michael Gordon,14,0,65,51
1657930814682,COGS 101C,A01,083625,Delgado; Tania,17,0,35,18
1657930820707,COGS 107A,A01,083627,Boyle; Mary E. T.,14,0,60,46
1657930826732,COGS 118A,A01,083075,Gupta; Anjum,21,0,76,55
1657930832757,CSE 3,A50,083646,Miranda; Gregory Joseph,24,0,50,26
1657930838781,CSE 8A,A50,083650,Miranda; Gregory Joseph,17,1,56,39
1657930844805,CSE 11,A01,083080,Cao; Yingjun,6,15,40,34
1657930850830,CSE 12,A01,083652,Krause-Levy; Sophia Louisa,30,1,120,90
1657930856854,CSE 15L,A01,083654,Morris; Justin Loren,9,0,50,41
1657930856854,CSE 15L,A02,083655,Morris; Justin Loren,10,0,50,40
1657930862880,CSE 20,A01,083657,Tran; Khoa Dang,39,0,80,41
1657930868906,CSE 21,A01,095574,Bach; Quang Tran,23,0,48,25
1657930874932,CSE 30,A01,083084,Eldon; John,7,0,80,73
1657930874932,CSE 30,B01,095061,Bhaskar; Nishant,9,0,50,41
1657930880955,CSE 100,A01,083659,Cao; Yingjun,5,4,70,65
1657930886976,CSE 134B,A01,083661,Powell; Thomas Allan,25,0,100,75
1657930893000,CSE 140,A01,083663,Gungor; Onat,17,0,85,68
1657930899024,CSE 140L,A01,083088,Eldon; John,23,0,100,77
1657930905050,CSE 175,A01,083665,Kumar; Rakesh,3,0,25,22
1657930911073,CSE 190,A00,092507,Dubnov; Shlomo,8,0,20,12
1657930917097,ECE 45,A01,083139,Congero; Spencer William,7,0,75,68
1657930923119,ECE 65,A50,083695,Saad; Andrew S,12,0,30,18
1657930923119,ECE 65,A51,095125,Saad; Andrew S,24,0,26,2
1657930929154,ECE 109,A01,091882,Touri; Behrouz,20,0,70,50
1657930935180,ECE 180,A00,083140,Abi Samra; Nicholas Camill,1,0,30,29
1657930935180,ECE 180,B00,083141,Abi Samra; Nicholas Camill,0,0,30,30
1657930941208,MATH 10A,A01,083735,Patchell; Gregory David,2,0,30,28
1657930941208,MATH 10A,A02,083736,Patchell; Gregory David,20,0,30,10
1657930941208,MATH 10A,A03,083737,Patchell; Gregory David,16,0,30,14
1657930947239,MATH 10B,A01,083207,Lim; Seonhee,9,0,34,25
1657930947239,MATH 10B,A02,083208,Lim; Seonhee,10,0,35,25
1657930947239,MATH 10B,A03,093472,Lim; Seonhee,7,0,34,27
1657930947239,MATH 10B,B01,083739,Sinha; Shubham,14,0,30,16
1657930953264,MATH 18,A01,083743,Cinel; Cameron Alexander,9,0,30,21
1657930953264,MATH 18,A02,083744,Cinel; Cameron Alexander,18,0,30,12
1657930953264,MATH 18,A03,083745,Cinel; Cameron Alexander,10,0,30,20
1657930953264,MATH 18,B01,083748,Rideout; David Porter,5,0,37,32
1657930953264,MATH 18,B02,083749,Rideout; David Porter,5,0,36,31
1657930953264,MATH 18,B03,083750,Rideout; David Porter,3,0,37,34
1657930953264,MATH 18,B04,083751,Rideout; David Porter,7,0,36,29
1657930953264,MATH 18,B05,093473,Rideout; David Porter,7,0,36,29
1657930953264,MATH 18,B06,093474,Rideout; David Porter,6,0,36,30
1657930959290,MATH 20A,A01,083754,Zheng; Zequn,14,0,40,26
1657930965317,MATH 20B,A01,083756,Briones; Jor-el Thomas Caparas,4,0,36,32
1657930965317,MATH 20B,A02,083757,Briones; Jor-el Thomas Caparas,1,0,36,35
1657930965317,MATH 20B,A03,093475,Briones; Jor-el Thomas Caparas,3,0,36,33
1657930971357,MATH 20C,A01,083760,Briones; Jor-el Thomas Caparas,1,0,35,34
1657930971357,MATH 20C,A02,083761,Briones; Jor-el Thomas Caparas,8,0,35,27
1657930971357,MATH 20C,A03,093476,Briones; Jor-el Thomas Caparas,0,1,36,36
1657930971357,MATH 20C,B01,083762,Bach; Quang Tran,1,0,30,29
1657930977381,MATH 20D,A01,083765,Tran; Brian Kha,5,0,30,25
1657930977381,MATH 20D,A02,083766,Tran; Brian Kha,5,0,30,25
1657930977381,MATH 20D,A03,083767,Tran; Brian Kha,6,0,30,24
1657930983409,MATH 20E,A01,083771,Ganguly; Soumya,12,0,32,20
1657930983409,MATH 20E,A02,083772,Ganguly; Soumya,7,0,32,25
1657930983409,MATH 20E,B01,083773,Ciotti; Benjamin,20,0,35,15
1657930983409,MATH 20E,B02,083774,Ciotti; Benjamin,18,0,35,17
1657930989439,MATH 103A,A01,083777,Greenfeld; Be'Eri,3,0,36,33
1657930989439,MATH 103A,A02,083778,Greenfeld; Be'Eri,5,0,36,31
1657930989439,MATH 103A,A03,093561,Greenfeld; Be'Eri,6,0,36,30
1657930989439,MATH 103A,B01,083779,Greenfeld; Be'Eri,8,0,36,28
1657930989439,MATH 103A,B02,083780,Greenfeld; Be'Eri,4,0,36,32
1657930989439,MATH 103A,B03,093562,Greenfeld; Be'Eri,3,0,36,33
1657930995470,MATH 105,A01,085443,Carter; Anne Toulson,15,0,35,20
1657930995470,MATH 105,A02,093477,Carter; Anne Toulson,20,0,35,15
1657931001493,MATH 109,A01,083213,Ganzberger; Geoffrey Michael,3,0,34,31
1657931001493,MATH 109,A02,083214,Ganzberger; Geoffrey Michael,4,0,34,30
1657931001493,MATH 109,A03,093478,Ganzberger; Geoffrey Michael,2,0,34,32
1657931001493,MATH 109,B01,083215,Ganzberger; Geoffrey Michael,2,0,32,30
1657931001493,MATH 109,B02,083216,Ganzberger; Geoffrey Michael,3,0,32,29
1657931001493,MATH 109,B03,093479,Ganzberger; Geoffrey Michael,8,0,32,24
1657931007517,MATH 142A,A01,083219,Chow; Bennett,7,0,32,25
1657931007517,MATH 142A,A02,083220,Chow; Bennett,10,0,32,22
1657931007517,MATH 142A,A03,093480,Chow; Bennett,9,0,32,23
1657931007517,MATH 142A,B03,093481,Chow; Bennett,8,0,32,24
1657931007517,MATH 142A,B04,093558,Chow; Bennett,13,0,32,19
1657931007517,MATH 142A,B05,093559,Chow; Bennett,7,0,32,25
1657931013543,MATH 193A,A01,083224,Rotar; Vladimir,8,0,34,26
1657931013543,MATH 193A,A02,083225,Rotar; Vladimir,10,0,34,24
1657931013543,MATH 193A,A03,083781,Rotar; Vladimir,5,0,34,29
1657931013543,MATH 193A,A04,083782,Rotar; Vladimir,11,0,34,23
1657931013543,MATH 193A,A05,093482,Rotar; Vladimir,11,0,34,23
1657931019569,MATH 197,001,091859,McAuley; Julian John,9999,0,9999,0
1657931019569,MATH 197,002,095566,Kedlaya; Kiran S.,9997,0,9999,2
1657931019569,MATH 197,003,095567,Xiao; Ming,9999,0,9999,0
1657931019569,MATH 197,004,095571,Perols; Johan Lars,9998,0,9999,1
1657931026702,COGS 9,A01,083615,Shannon; Kyle Michael,11,0,75,64
1657931032724,COGS 11,A01,083617,Boyle; Mary E. T.,23,0,48,25
1657931038748,COGS 13,A01,083071,Bastos; Amalia Pinkusfeld,12,0,71,59
1657931044771,COGS 14A,A01,092681,Semenuks; Arturs,5,1,100,95
1657931050797,COGS 14B,A01,083073,Cheng; Tzu-Han,7,0,63,56
1657931056824,COGS 17,A01,092677,Semenuks; Arturs,7,0,81,74
1657931062849,COGS 100,A01,083619,Allen; Michael Gordon,17,0,70,53
1657931068872,COGS 101A,A01,083621,Davis; Joshua Daniel,9,0,68,59
1657931074894,COGS 101B,A01,091572,Allen; Michael Gordon,14,0,65,51
1657931080918,COGS 101C,A01,083625,Delgado; Tania,17,0,35,18
1657931086944,COGS 107A,A01,083627,Boyle; Mary E. T.,14,0,60,46
1657931092967,COGS 118A,A01,083075,Gupta; Anjum,21,0,76,55
1657931098994,CSE 3,A50,083646,Miranda; Gregory Joseph,24,0,50,26
1657931105020,CSE 8A,A50,083650,Miranda; Gregory Joseph,17,1,56,39
1657931111044,CSE 11,A01,083080,Cao; Yingjun,6,15,40,34
1657931117067,CSE 12,A01,083652,Krause-Levy; Sophia Louisa,30,1,120,90
1657931123093,CSE 15L,A01,083654,Morris; Justin Loren,9,0,50,41
1657931123093,CSE 15L,A02,083655,Morris; Justin Loren,10,0,50,40
1657931129121,CSE 20,A01,083657,Tran; Khoa Dang,39,0,80,41
1657931135145,CSE 21,A01,095574,Bach; Quang Tran,23,0,48,25
1657931141171,CSE 30,A01,083084,Eldon; John,7,0,80,73
1657931141171,CSE 30,B01,095061,Bhaskar; Nishant,9,0,50,41
1657931147193,CSE 100,A01,083659,Cao; Yingjun,5,4,70,65
1657931153216,CSE 134B,A01,083661,Powell; Thomas Allan,25,0,100,75
1657931159245,CSE 140,A01,083663,Gungor; Onat,17,0,85,68
1657931165272,CSE 140L,A01,083088,Eldon; John,23,0,100,77
1657931171300,CSE 175,A01,083665,Kumar; Rakesh,3,0,25,22
1657931177322,CSE 190,A00,092507,Dubnov; Shlomo,8,0,20,12
1657931183347,ECE 45,A01,083139,Congero; Spencer William,7,0,75,68
1657931189372,ECE 65,A50,083695,Saad; Andrew S,12,0,30,18
1657931189372,ECE 65,A51,095125,Saad; Andrew S,24,0,26,2
1657931195398,ECE 109,A01,091882,Touri; Behrouz,20,0,70,50
1657931201426,ECE 180,A00,083140,Abi Samra; Nicholas Camill,1,0,30,29
1657931201426,ECE 180,B00,083141,Abi Samra; Nicholas Camill,0,0,30,30
1657931207461,MATH 10A,A01,083735,Patchell; Gregory David,2,0,30,28
1657931207461,MATH 10A,A02,083736,Patchell; Gregory David,20,0,30,10
1657931207461,MATH 10A,A03,083737,Patchell; Gregory David,16,0,30,14
1657931213491,MATH 10B,A01,083207,Lim; Seonhee,9,0,34,25
1657931213491,MATH 10B,A02,083208,Lim; Seonhee,10,0,35,25
1657931213491,MATH 10B,A03,093472,Lim; Seonhee,7,0,34,27
1657931213491,MATH 10B,B01,083739,Sinha; Shubham,14,0,30,16
1657931219523,MATH 18,A01,083743,Cinel; Cameron Alexander,9,0,30,21
1657931219523,MATH 18,A02,083744,Cinel; Cameron Alexander,18,0,30,12
1657931219523,MATH 18,A03,083745,Cinel; Cameron Alexander,10,0,30,20
1657931219523,MATH 18,B01,083748,Rideout; David Porter,5,0,37,32
1657931219523,MATH 18,B02,083749,Rideout; David Porter,5,0,36,31
1657931219523,MATH 18,B03,083750,Rideout; David Porter,3,0,37,34
1657931219523,MATH 18,B04,083751,Rideout; David Porter,7,0,36,29
1657931219523,MATH 18,B05,093473,Rideout; David Porter,7,0,36,29
1657931219523,MATH 18,B06,093474,Rideout; David Porter,6,0,36,30
1657931225549,MATH 20A,A01,083754,Zheng; Zequn,14,0,40,26
1657931231575,MATH 20B,A01,083756,Briones; Jor-el Thomas Caparas,4,0,36,32
1657931231575,MATH 20B,A02,083757,Briones; Jor-el Thomas Caparas,1,0,36,35
1657931231575,MATH 20B,A03,093475,Briones; Jor-el Thomas Caparas,3,0,36,33
1657931237599,MATH 20C,A01,083760,Briones; Jor-el Thomas Caparas,1,0,35,34
1657931237599,MATH 20C,A02,083761,Briones; Jor-el Thomas Caparas,8,0,35,27
1657931237599,MATH 20C,A03,093476,Briones; Jor-el Thomas Caparas,0,1,36,36
1657931237599,MATH 20C,B01,083762,Bach; Quang Tran,1,0,30,29
1657931243623,MATH 20D,A01,083765,Tran; Brian Kha,5,0,30,25
1657931243623,MATH 20D,A02,083766,Tran; Brian Kha,5,0,30,25
1657931243623,MATH 20D,A03,083767,Tran; Brian Kha,6,0,30,24
1657931249653,MATH 20E,A01,083771,Ganguly; Soumya,12,0,32,20
1657931249653,MATH 20E,A02,083772,Ganguly; Soumya,7,0,32,25
1657931249653,MATH 20E,B01,083773,Ciotti; Benjamin,20,0,35,15
1657931249653,MATH 20E,B02,083774,Ciotti; Benjamin,18,0,35,17
1657931255682,MATH 103A,A01,083777,Greenfeld; Be'Eri,3,0,36,33
1657931255682,MATH 103A,A02,083778,Greenfeld; Be'Eri,5,0,36,31
1657931255682,MATH 103A,A03,093561,Greenfeld; Be'Eri,6,0,36,30
1657931255682,MATH 103A,B01,083779,Greenfeld; Be'Eri,8,0,36,28
1657931255682,MATH 103A,B02,083780,Greenfeld; Be'Eri,4,0,36,32
1657931255682,MATH 103A,B03,093562,Greenfeld; Be'Eri,3,0,36,33
1657931261704,MATH 105,A01,085443,Carter; Anne Toulson,15,0,35,20
1657931261704,MATH 105,A02,093477,Carter; Anne Toulson,20,0,35,15
1657931267729,MATH 109,A01,083213,Ganzberger; Geoffrey Michael,3,0,34,31
1657931267729,MATH 109,A02,083214,Ganzberger; Geoffrey Michael,4,0,34,30
1657931267729,MATH 109,A03,093478,Ganzberger; Geoffrey Michael,2,0,34,32
1657931267729,MATH 109,B01,083215,Ganzberger; Geoffrey Michael,2,0,32,30
1657931267729,MATH 109,B02,083216,Ganzberger; Geoffrey Michael,3,0,32,29
1657931267729,MATH 109,B03,093479,Ganzberger; Geoffrey Michael,8,0,32,24
1657931273753,MATH 142A,A01,083219,Chow; Bennett,7,0,32,25
1657931273753,MATH 142A,A02,083220,Chow; Bennett,10,0,32,22
1657931273753,MATH 142A,A03,093480,Chow; Bennett,9,0,32,23
1657931273753,MATH 142A,B03,093481,Chow; Bennett,8,0,32,24
1657931273753,MATH 142A,B04,093558,Chow; Bennett,13,0,32,19
1657931273753,MATH 142A,B05,093559,Chow; Bennett,7,0,32,25
1657931279782,MATH 193A,A01,083224,Rotar; Vladimir,8,0,34,26
1657931279782,MATH 193A,A02,083225,Rotar; Vladimir,10,0,34,24
1657931279782,MATH 193A,A03,083781,Rotar; Vladimir,5,0,34,29
1657931279782,MATH 193A,A04,083782,Rotar; Vladimir,11,0,34,23
1657931279782,MATH 193A,A05,093482,Rotar; Vladimir,11,0,34,23
1657931285805,MATH 197,001,091859,McAuley; Julian John,9999,0,9999,0
1657931285805,MATH 197,002,095566,Kedlaya; Kiran S.,9997,0,9999,2
1657931285805,MATH 197,003,095567,Xiao; Ming,9999,0,9999,0
1657931285805,MATH 197,004,095571,Perols; Johan Lars,9998,0,9999,1
1657931292866,COGS 9,A01,083615,Shannon; Kyle Michael,11,0,75,64
1657931298889,COGS 11,A01,083617,Boyle; Mary E. T.,23,0,48,25
1657931304912,COGS 13,A01,083071,Bastos; Amalia Pinkusfeld,12,0,71,59
1657931310938,COGS 14A,A01,092681,Semenuks; Arturs,5,1,100,95
1657931316964,COGS 14B,A01,083073,Cheng; Tzu-Han,7,0,63,56
1657931322986,COGS 17,A01,092677,Semenuks; Arturs,7,0,81,74
1657931329010,COGS 100,A01,083619,Allen; Michael Gordon,17,0,70,53
1657931335033,COGS 101A,A01,083621,Davis; Joshua Daniel,9,0,68,59
1657931341056,COGS 101B,A01,091572,Allen; Michael Gordon,14,0,65,51
1657931347085,COGS 101C,A01,083625,Delgado; Tania,17,0,35,18
1657931353108,COGS 107A,A01,083627,Boyle; Mary E. T.,14,0,60,46
1657931359131,COGS 118A,A01,083075,Gupta; Anjum,21,0,76,55
1657931365156,CSE 3,A50,083646,Miranda; Gregory Joseph,24,0,50,26
1657931371196,CSE 8A,A50,083650,Miranda; Gregory Joseph,17,1,56,39
1657931377223,CSE 11,A01,083080,Cao; Yingjun,6,15,40,34
1657931383245,CSE 12,A01,083652,Krause-Levy; Sophia Louisa,30,1,120,90
1657931389269,CSE 15L,A01,083654,Morris; Justin Loren,9,0,50,41
1657931389269,CSE 15L,A02,083655,Morris; Justin Loren,10,0,50,40
1657931395296,CSE 20,A01,083657,Tran; Khoa Dang,39,0,80,41
1657931401321,CSE 21,A01,095574,Bach; Quang Tran,23,0,48,25
1657931407343,CSE 30,A01,083084,Eldon; John,7,0,80,73
1657931407343,CSE 30,B01,095061,Bhaskar; Nishant,9,0,50,41
1657931413366,CSE 100,A01,083659,Cao; Yingjun,5,4,70,65
1657931419394,CSE 134B,A01,083661,Powell; Thomas Allan,25,0,100,75
1657931425420,CSE 140,A01,083663,Gungor; Onat,17,0,85,68
1657931431445,CSE 140L,A01,083088,Eldon; John,23,0,100,77
1657931437470,CSE 175,A01,083665,Kumar; Rakesh,3,0,25,22
1657931443492,CSE 190,A00,092507,Dubnov; Shlomo,8,0,20,12
1657931449518,ECE 45,A01,083139,Congero; Spencer William,7,0,75,68
1657931455542,ECE 65,A50,083695,Saad; Andrew S,12,0,30,18
1657931455542,ECE 65,A51,095125,Saad; Andrew S,24,0,26,2
1657931461564,ECE 109,A01,091882,Touri; Behrouz,20,0,70,50
1657931467588,ECE 180,A00,083140,Abi Samra; Nicholas Camill,1,0,30,29
1657931467588,ECE 180,B00,083141,Abi Samra; Nicholas Camill,0,0,30,30
1657931473612,MATH 10A,A01,083735,Patchell; Gregory David,2,0,30,28
1657931473612,MATH 10A,A02,083736,Patchell; Gregory David,20,0,30,10
1657931473612,MATH 10A,A03,083737,Patchell; Gregory David,16,0,30,14
1657931479636,MATH 10B,A01,083207,Lim; Seonhee,9,0,34,25
1657931479636,MATH 10B,A02,083208,Lim; Seonhee,10,0,35,25
1657931479636,MATH 10B,A03,093472,Lim; Seonhee,7,0,34,27
1657931479636,MATH 10B,B01,083739,Sinha; Shubham,14,0,30,16
1657931485667,MATH 18,A01,083743,Cinel; Cameron Alexander,9,0,30,21
1657931485667,MATH 18,A02,083744,Cinel; Cameron Alexander,18,0,30,12
1657931485667,MATH 18,A03,083745,Cinel; Cameron Alexander,10,0,30,20
1657931485667,MATH 18,B01,083748,Rideout; David Porter,5,0,37,32
1657931485667,MATH 18,B02,083749,Rideout; David Porter,5,0,36,31
1657931485667,MATH 18,B03,083750,Rideout; David Porter,3,0,37,34
1657931485667,MATH 18,B04,083751,Rideout; David Porter,7,0,36,29
1657931485667,MATH 18,B05,093473,Rideout; David Porter,7,0,36,29
1657931485667,MATH 18,B06,093474,Rideout; David Porter,6,0,36,30
1657931491693,MATH 20A,A01,083754,Zheng; Zequn,14,0,40,26
1657931497720,MATH 20B,A01,083756,Briones; Jor-el Thomas Caparas,4,0,36,32
1657931497720,MATH 20B,A02,083757,Briones; Jor-el Thomas Caparas,1,0,36,35
1657931497720,MATH 20B,A03,093475,Briones; Jor-el Thomas Caparas,3,0,36,33
1657931503747,MATH 20C,A01,083760,Briones; Jor-el Thomas Caparas,1,0,35,34
1657931503747,MATH 20C,A02,083761,Briones; Jor-el Thomas Caparas,8,0,35,27
1657931503747,MATH 20C,A03,093476,Briones; Jor-el Thomas Caparas,0,1,36,36
1657931503747,MATH 20C,B01,083762,Bach; Quang Tran,1,0,30,29
1657931509774,MATH 20D,A01,083765,Tran; Brian Kha,5,0,30,25
1657931509774,MATH 20D,A02,083766,Tran; Brian Kha,5,0,30,25
1657931509774,MATH 20D,A03,083767,Tran; Brian Kha,6,0,30,24
1657931515798,MATH 20E,A01,083771,Ganguly; Soumya,12,0,32,20
1657931515798,MATH 20E,A02,083772,Ganguly; Soumya,7,0,32,25
1657931515798,MATH 20E,B01,083773,Ciotti; Benjamin,20,0,35,15
1657931515798,MATH 20E,B02,083774,Ciotti; Benjamin,18,0,35,17
1657931521827,MATH 103A,A01,083777,Greenfeld; Be'Eri,3,0,36,33
1657931521827,MATH 103A,A02,083778,Greenfeld; Be'Eri,5,0,36,31
1657931521827,MATH 103A,A03,093561,Greenfeld; Be'Eri,6,0,36,30
1657931521827,MATH 103A,B01,083779,Greenfeld; Be'Eri,8,0,36,28
1657931521827,MATH 103A,B02,083780,Greenfeld; Be'Eri,4,0,36,32
1657931521827,MATH 103A,B03,093562,Greenfeld; Be'Eri,3,0,36,33
1657931527851,MATH 105,A01,085443,Carter; Anne Toulson,15,0,35,20
1657931527851,MATH 105,A02,093477,Carter; Anne Toulson,20,0,35,15
1657931533874,MATH 109,A01,083213,Ganzberger; Geoffrey Michael,3,0,34,31
1657931533874,MATH 109,A02,083214,Ganzberger; Geoffrey Michael,4,0,34,30
1657931533874,MATH 109,A03,093478,Ganzberger; Geoffrey Michael,2,0,34,32
1657931533874,MATH 109,B01,083215,Ganzberger; Geoffrey Michael,2,0,32,30
1657931533874,MATH 109,B02,083216,Ganzberger; Geoffrey Michael,3,0,32,29
1657931533874,MATH 109,B03,093479,Ganzberger; Geoffrey Michael,8,0,32,24
1657931539898,MATH 142A,A01,083219,Chow; Bennett,7,0,32,25
1657931539898,MATH 142A,A02,083220,Chow; Bennett,10,0,32,22
1657931539898,MATH 142A,A03,093480,Chow; Bennett,9,0,32,23
1657931539898,MATH 142A,B03,093481,Chow; Bennett,8,0,32,24
1657931539898,MATH 142A,B04,093558,Chow; Bennett,13,0,32,19
1657931539898,MATH 142A,B05,093559,Chow; Bennett,7,0,32,25
1657931545921,MATH 193A,A01,083224,Rotar; Vladimir,8,0,34,26
1657931545921,MATH 193A,A02,083225,Rotar; Vladimir,10,0,34,24
1657931545921,MATH 193A,A03,083781,Rotar; Vladimir,5,0,34,29
1657931545921,MATH 193A,A04,083782,Rotar; Vladimir,11,0,34,23
1657931545921,MATH 193A,A05,093482,Rotar; Vladimir,11,0,34,23
1657931551944,MATH 197,001,091859,McAuley; Julian John,9999,0,9999,0
1657931551944,MATH 197,002,095566,Kedlaya; Kiran S.,9997,0,9999,2
1657931551944,MATH 197,003,095567,Xiao; Ming,9999,0,9999,0
1657931551944,MATH 197,004,095571,Perols; Johan Lars,9998,0,9999,1
1657931559007,COGS 9,A01,083615,Shannon; Kyle Michael,11,0,75,64
1657931565035,COGS 11,A01,083617,Boyle; Mary E. T.,23,0,48,25
1657931571057,COGS 13,A01,083071,Bastos; Amalia Pinkusfeld,12,0,71,59
1657931577083,COGS 14A,A01,092681,Semenuks; Arturs,5,1,100,95
1657931583105,COGS 14B,A01,083073,Cheng; Tzu-Han,7,0,63,56
1657931589133,COGS 17,A01,092677,Semenuks; Arturs,7,0,81,74
1657931595155,COGS 100,A01,083619,Allen; Michael Gordon,17,0,70,53
1657931601179,COGS 101A,A01,083621,Davis; Joshua Daniel,9,0,68,59
1657931607202,COGS 101B,A01,091572,Allen; Michael Gordon,14,0,65,51
1657931613225,COGS 101C,A01,083625,Delgado; Tania,17,0,35,18
1657931619325,COGS 107A,A01,083627,Boyle; Mary E. T.,14,0,60,46
1657931625349,COGS 118A,A01,083075,Gupta; Anjum,21,0,76,55
1657931631376,CSE 3,A50,083646,Miranda; Gregory Joseph,24,0,50,26
1657931637402,CSE 8A,A50,083650,Miranda; Gregory Joseph,17,1,56,39
1657931643430,CSE 11,A01,083080,Cao; Yingjun,6,15,40,34
1657931649454,CSE 12,A01,083652,Krause-Levy; Sophia Louisa,30,1,120,90
1657931655477,CSE 15L,A01,083654,Morris; Justin Loren,9,0,50,41
1657931655477,CSE 15L,A02,083655,Morris; Justin Loren,10,0,50,40
1657931661501,CSE 20,A01,083657,Tran; Khoa Dang,39,0,80,41
1657931667531,CSE 21,A01,095574,Bach; Quang Tran,23,0,48,25
1657931673554,CSE 30,A01,083084,Eldon; John,7,0,80,73
1657931673554,CSE 30,B01,095061,Bhaskar; Nishant,9,0,50,41
1657931679576,CSE 100,A01,083659,Cao; Yingjun,5,4,70,65
1657931685604,CSE 134B,A01,083661,Powell; Thomas Allan,25,0,100,75
1657931691627,CSE 140,A01,083663,Gungor; Onat,17,0,85,68
1657931697652,CSE 140L,A01,083088,Eldon; John,23,0,100,77
1657931703676,CSE 175,A01,083665,Kumar; Rakesh,3,0,25,22
1657931709701,CSE 190,A00,092507,Dubnov; Shlomo,8,0,20,12
1657931715728,ECE 45,A01,083139,Congero; Spencer William,7,0,75,68
1657931721751,ECE 65,A50,083695,Saad; Andrew S,12,0,30,18
1657931721751,ECE 65,A51,095125,Saad; Andrew S,24,0,26,2
1657931727782,ECE 109,A01,091882,Touri; Behrouz,20,0,70,50
1657931733806,ECE 180,A00,083140,Abi Samra; Nicholas Camill,1,0,30,29
1657931733806,ECE 180,B00,083141,Abi Samra; Nicholas Camill,0,0,30,30
1657931739834,MATH 10A,A01,083735,Patchell; Gregory David,2,0,30,28
1657931739834,MATH 10A,A02,083736,Patchell; Gregory David,20,0,30,10
1657931739834,MATH 10A,A03,083737,Patchell; Gregory David,16,0,30,14
1657931745856,MATH 10B,A01,083207,Lim; Seonhee,9,0,34,25
1657931745856,MATH 10B,A02,083208,Lim; Seonhee,10,0,35,25
1657931745856,MATH 10B,A03,093472,Lim; Seonhee,7,0,34,27
1657931745856,MATH 10B,B01,083739,Sinha; Shubham,14,0,30,16
1657931751878,MATH 18,A01,083743,Cinel; Cameron Alexander,9,0,30,21
1657931751878,MATH 18,A02,083744,Cinel; Cameron Alexander,18,0,30,12
1657931751878,MATH 18,A03,083745,Cinel; Cameron Alexander,10,0,30,20
1657931751878,MATH 18,B01,083748,Rideout; David Porter,5,0,37,32
1657931751878,MATH 18,B02,083749,Rideout; David Porter,5,0,36,31
1657931751878,MATH 18,B03,083750,Rideout; David Porter,3,0,37,34
1657931751878,MATH 18,B04,083751,Rideout; David Porter,7,0,36,29
1657931751878,MATH 18,B05,093473,Rideout; David Porter,7,0,36,29
1657931751878,MATH 18,B06,093474,Rideout; David Porter,6,0,36,30
1657931757903,MATH 20A,A01,083754,Zheng; Zequn,14,0,40,26
1657931763931,MATH 20B,A01,083756,Briones; Jor-el Thomas Caparas,4,0,36,32
1657931763931,MATH 20B,A02,083757,Briones; Jor-el Thomas Caparas,1,0,36,35
1657931763931,MATH 20B,A03,093475,Briones; Jor-el Thomas Caparas,3,0,36,33
1657931769957,MATH 20C,A01,083760,Briones; Jor-el Thomas Caparas,1,0,35,34
1657931769957,MATH 20C,A02,083761,Briones; Jor-el Thomas Caparas,8,0,35,27
1657931769957,MATH 20C,A03,093476,Briones; Jor-el Thomas Caparas,0,1,36,36
1657931769957,MATH 20C,B01,083762,Bach; Quang Tran,1,0,30,29
1657931775979,MATH 20D,A01,083765,Tran; Brian Kha,5,0,30,25
1657931775979,MATH 20D,A02,083766,Tran; Brian Kha,5,0,30,25
1657931775979,MATH 20D,A03,083767,Tran; Brian Kha,6,0,30,24
1657931782007,MATH 20E,A01,083771,Ganguly; Soumya,12,0,32,20
1657931782007,MATH 20E,A02,083772,Ganguly; Soumya,7,0,32,25
1657931782007,MATH 20E,B01,083773,Ciotti; Benjamin,20,0,35,15
1657931782007,MATH 20E,B02,083774,Ciotti; Benjamin,18,0,35,17
1657931788055,MATH 103A,A01,083777,Greenfeld; Be'Eri,3,0,36,33
1657931788055,MATH 103A,A02,083778,Greenfeld; Be'Eri,5,0,36,31
1657931788055,MATH 103A,A03,093561,Greenfeld; Be'Eri,6,0,36,30
1657931788055,MATH 103A,B01,083779,Greenfeld; Be'Eri,8,0,36,28
1657931788055,MATH 103A,B02,083780,Greenfeld; Be'Eri,4,0,36,32
1657931788055,MATH 103A,B03,093562,Greenfeld; Be'Eri,3,0,36,33
1657931794081,MATH 105,A01,085443,Carter; Anne Toulson,15,0,35,20
1657931794081,MATH 105,A02,093477,Carter; Anne Toulson,20,0,35,15
1657931800109,MATH 109,A01,083213,Ganzberger; Geoffrey Michael,3,0,34,31
1657931800109,MATH 109,A02,083214,Ganzberger; Geoffrey Michael,4,0,34,30
1657931800109,MATH 109,A03,093478,Ganzberger; Geoffrey Michael,2,0,34,32
1657931800109,MATH 109,B01,083215,Ganzberger; Geoffrey Michael,2,0,32,30
1657931800109,MATH 109,B02,083216,Ganzberger; Geoffrey Michael,3,0,32,29
1657931800109,MATH 109,B03,093479,Ganzberger; Geoffrey Michael,8,0,32,24
1657931806138,MATH 142A,A01,083219,Chow; Bennett,7,0,32,25
1657931806138,MATH 142A,A02,083220,Chow; Bennett,10,0,32,22
1657931806138,MATH 142A,A03,093480,Chow; Bennett,9,0,32,23
1657931806138,MATH 142A,B03,093481,Chow; Bennett,8,0,32,24
1657931806138,MATH 142A,B04,093558,Chow; Bennett,13,0,32,19
1657931806138,MATH 142A,B05,093559,Chow; Bennett,7,0,32,25
1657931812168,MATH 193A,A01,083224,Rotar; Vladimir,8,0,34,26
1657931812168,MATH 193A,A02,083225,Rotar; Vladimir,10,0,34,24
1657931812168,MATH 193A,A03,083781,Rotar; Vladimir,5,0,34,29
1657931812168,MATH 193A,A04,083782,Rotar; Vladimir,11,0,34,23
1657931812168,MATH 193A,A05,093482,Rotar; Vladimir,11,0,34,23
1657931818191,MATH 197,001,091859,McAuley; Julian John,9999,0,9999,0
1657931818191,MATH 197,002,095566,Kedlaya; Kiran S.,9997,0,9999,2
1657931818191,MATH 197,003,095567,Xiao; Ming,9999,0,9999,0
1657931818191,MATH 197,004,095571,Perols; Johan Lars,9998,0,9999,1
1657931825244,COGS 9,A01,083615,Shannon; Kyle Michael,11,0,75,64
1657931831266,COGS 11,A01,083617,Boyle; Mary E. T.,23,0,48,25
1657931837293,COGS 13,A01,083071,Bastos; Amalia Pinkusfeld,12,0,71,59
1657931843319,COGS 14A,A01,092681,Semenuks; Arturs,5,1,100,95
1657931849352,COGS 14B,A01,083073,Cheng; Tzu-Han,7,0,63,56
1657931855376,COGS 17,A01,092677,Semenuks; Arturs,7,0,81,74
1657931861400,COGS 100,A01,083619,Allen; Michael Gordon,17,0,70,53
1657931867435,COGS 101A,A01,083621,Davis; Joshua Daniel,9,0,68,59
1657931873457,COGS 101B,A01,091572,Allen; Michael Gordon,14,0,65,51
1657931879484,COGS 101C,A01,083625,Delgado; Tania,17,0,35,18
1657931885507,COGS 107A,A01,083627,Boyle; Mary E. T.,14,0,60,46
1657931891531,COGS 118A,A01,083075,Gupta; Anjum,21,0,76,55
1657931897557,CSE 3,A50,083646,Miranda; Gregory Joseph,24,0,50,26
1657931903588,CSE 8A,A50,083650,Miranda; Gregory Joseph,17,1,56,39
1657931909610,CSE 11,A01,083080,Cao; Yingjun,6,15,40,34
1657931915633,CSE 12,A01,083652,Krause-Levy; Sophia Louisa,30,1,120,90
1657931921657,CSE 15L,A01,083654,Morris; Justin Loren,9,0,50,41
1657931921657,CSE 15L,A02,083655,Morris; Justin Loren,10,0,50,40
1657931927679,CSE 20,A01,083657,Tran; Khoa Dang,39,0,80,41
1657931933702,CSE 21,A01,095574,Bach; Quang Tran,23,0,48,25
1657931939727,CSE 30,A01,083084,Eldon; John,7,0,80,73
1657931939727,CSE 30,B01,095061,Bhaskar; Nishant,9,0,50,41
1657931945753,CSE 100,A01,083659,Cao; Yingjun,5,4,70,65
1657931951776,CSE 134B,A01,083661,Powell; Thomas Allan,25,0,100,75
1657931957800,CSE 140,A01,083663,Gungor; Onat,17,0,85,68
1657931963827,CSE 140L,A01,083088,Eldon; John,23,0,100,77
1657931969854,CSE 175,A01,083665,Kumar; Rakesh,3,0,25,22
1657931975880,CSE 190,A00,092507,Dubnov; Shlomo,8,0,20,12
1657931981902,ECE 45,A01,083139,Congero; Spencer William,7,0,75,68
1657931987923,ECE 65,A50,083695,Saad; Andrew S,12,0,30,18
1657931987923,ECE 65,A51,095125,Saad; Andrew S,24,0,26,2
1657931993949,ECE 109,A01,091882,Touri; Behrouz,20,0,70,50
1657931999978,ECE 180,A00,083140,Abi Samra; Nicholas Camill,1,0,30,29
1657931999978,ECE 180,B00,083141,Abi Samra; Nicholas Camill,0,0,30,30
1657932006000,MATH 10A,A01,083735,Patchell; Gregory David,2,0,30,28
1657932006000,MATH 10A,A02,083736,Patchell; Gregory David,20,0,30,10
1657932006000,MATH 10A,A03,083737,Patchell; Gregory David,16,0,30,14
1657932012023,MATH 10B,A01,083207,Lim; Seonhee,9,0,34,25
1657932012023,MATH 10B,A02,083208,Lim; Seonhee,10,0,35,25
1657932012023,MATH 10B,A03,093472,Lim; Seonhee,7,0,34,27
1657932012023,MATH 10B,B01,083739,Sinha; Shubham,14,0,30,16
1657932018045,MATH 18,A01,083743,Cinel; Cameron Alexander,9,0,30,21
1657932018045,MATH 18,A02,083744,Cinel; Cameron Alexander,18,0,30,12
1657932018045,MATH 18,A03,083745,Cinel; Cameron Alexander,10,0,30,20
1657932018045,MATH 18,B01,083748,Rideout; David Porter,5,0,37,32
1657932018045,MATH 18,B02,083749,Rideout; David Porter,5,0,36,31
1657932018045,MATH 18,B03,083750,Rideout; David Porter,3,0,37,34
1657932018045,MATH 18,B04,083751,Rideout; David Porter,7,0,36,29
1657932018045,MATH 18,B05,093473,Rideout; David Porter,7,0,36,29
1657932018045,MATH 18,B06,093474,Rideout; David Porter,6,0,36,30
1657932024068,MATH 20A,A01,083754,Zheng; Zequn,14,0,40,26
1657932030090,MATH 20B,A01,083756,Briones; Jor-el Thomas Caparas,4,0,36,32
1657932030090,MATH 20B,A02,083757,Briones; Jor-el Thomas Caparas,1,0,36,35
1657932030090,MATH 20B,A03,093475,Briones; Jor-el Thomas Caparas,3,0,36,33
1657932036116,MATH 20C,A01,083760,Briones; Jor-el Thomas Caparas,1,0,35,34
1657932036116,MATH 20C,A02,083761,Briones; Jor-el Thomas Caparas,8,0,35,27
1657932036116,MATH 20C,A03,093476,Briones; Jor-el Thomas Caparas,0,1,36,36
1657932036116,MATH 20C,B01,083762,Bach; Quang Tran,1,0,30,29
1657932042139,MATH 20D,A01,083765,Tran; Brian Kha,5,0,30,25
1657932042139,MATH 20D,A02,083766,Tran; Brian Kha,5,0,30,25
1657932042139,MATH 20D,A03,083767,Tran; Brian Kha,6,0,30,24
1657932048163,MATH 20E,A01,083771,Ganguly; Soumya,12,0,32,20
1657932048163,MATH 20E,A02,083772,Ganguly; Soumya,7,0,32,25
1657932048163,MATH 20E,B01,083773,Ciotti; Benjamin,20,0,35,15
1657932048163,MATH 20E,B02,083774,Ciotti; Benjamin,18,0,35,17
1657932054191,MATH 103A,A01,083777,Greenfeld; Be'Eri,3,0,36,33
1657932054191,MATH 103A,A02,083778,Greenfeld; Be'Eri,5,0,36,31
1657932054191,MATH 103A,A03,093561,Greenfeld; Be'Eri,6,0,36,30
1657932054191,MATH 103A,B01,083779,Greenfeld; Be'Eri,8,0,36,28
1657932054191,MATH 103A,B02,083780,Greenfeld; Be'Eri,4,0,36,32
1657932054191,MATH 103A,B03,093562,Greenfeld; Be'Eri,3,0,36,33
1657932060220,MATH 105,A01,085443,Carter; Anne Toulson,15,0,35,20
1657932060220,MATH 105,A02,093477,Carter; Anne Toulson,20,0,35,15
1657932066242,MATH 109,A01,083213,Ganzberger; Geoffrey Michael,3,0,34,31
1657932066242,MATH 109,A02,083214,Ganzberger; Geoffrey Michael,4,0,34,30
1657932066242,MATH 109,A03,093478,Ganzberger; Geoffrey Michael,2,0,34,32
1657932066242,MATH 109,B01,083215,Ganzberger; Geoffrey Michael,2,0,32,30
1657932066242,MATH 109,B02,083216,Ganzberger; Geoffrey Michael,3,0,32,29
1657932066242,MATH 109,B03,093479,Ganzberger; Geoffrey Michael,8,0,32,24
1657932072271,MATH 142A,A01,083219,Chow; Bennett,7,0,32,25
1657932072271,MATH 142A,A02,083220,Chow; Bennett,10,0,32,22
1657932072271,MATH 142A,A03,093480,Chow; Bennett,9,0,32,23
1657932072271,MATH 142A,B03,093481,Chow; Bennett,8,0,32,24
1657932072271,MATH 142A,B04,093558,Chow; Bennett,13,0,32,19
1657932072271,MATH 142A,B05,093559,Chow; Bennett,7,0,32,25
1657932078295,MATH 193A,A01,083224,Rotar; Vladimir,8,0,34,26
1657932078295,MATH 193A,A02,083225,Rotar; Vladimir,10,0,34,24
1657932078295,MATH 193A,A03,083781,Rotar; Vladimir,5,0,34,29
1657932078295,MATH 193A,A04,083782,Rotar; Vladimir,11,0,34,23
1657932078295,MATH 193A,A05,093482,Rotar; Vladimir,11,0,34,23
1657932084328,MATH 197,001,091859,McAuley; Julian John,9999,0,9999,0
1657932084328,MATH 197,002,095566,Kedlaya; Kiran S.,9997,0,9999,2
1657932084328,MATH 197,003,095567,Xiao; Ming,9999,0,9999,0
1657932084328,MATH 197,004,095571,Perols; Johan Lars,9998,0,9999,1
1657932091384,COGS 9,A01,083615,Shannon; Kyle Michael,11,0,75,64
1657932097413,COGS 11,A01,083617,Boyle; Mary E. T.,23,0,48,25
1657932103435,COGS 13,A01,083071,Bastos; Amalia Pinkusfeld,12,0,71,59
1657932109466,COGS 14A,A01,092681,Semenuks; Arturs,5,1,100,95
1657932115492,COGS 14B,A01,083073,Cheng; Tzu-Han,7,0,63,56
1657932121519,COGS 17,A01,092677,Semenuks; Arturs,7,0,81,74
1657932127541,COGS 100,A01,083619,Allen; Michael Gordon,17,0,70,53
1657932133565,COGS 101A,A01,083621,Davis; Joshua Daniel,9,0,68,59
1657932139590,COGS 101B,A01,091572,Allen; Michael Gordon,14,0,65,51
1657932145613,COGS 101C,A01,083625,Delgado; Tania,17,0,35,18
1657932151642,COGS 107A,A01,083627,Boyle; Mary E. T.,14,0,60,46
1657932157665,COGS 118A,A01,083075,Gupta; Anjum,21,0,76,55
1657932163688,CSE 3,A50,083646,Miranda; Gregory Joseph,24,0,50,26
1657932169715,CSE 8A,A50,083650,Miranda; Gregory Joseph,17,1,56,39
1657932175737,CSE 11,A01,083080,Cao; Yingjun,6,15,40,34
1657932181764,CSE 12,A01,083652,Krause-Levy; Sophia Louisa,30,1,120,90
1657932187792,CSE 15L,A01,083654,Morris; Justin Loren,9,0,50,41
1657932187792,CSE 15L,A02,083655,Morris; Justin Loren,10,0,50,40
1657932193816,CSE 20,A01,083657,Tran; Khoa Dang,39,0,80,41
1657932199839,CSE 21,A01,095574,Bach; Quang Tran,23,0,48,25
1657932205860,CSE 30,A01,083084,Eldon; John,7,0,80,73
1657932205860,CSE 30,B01,095061,Bhaskar; Nishant,9,0,50,41
1657932211889,CSE 100,A01,083659,Cao; Yingjun,5,4,70,65
1657932217985,CSE 134B,A01,083661,Powell; Thomas Allan,25,0,100,75
1657932224008,CSE 140,A01,083663,Gungor; Onat,17,0,85,68
1657932230035,CSE 140L,A01,083088,Eldon; John,23,0,100,77
1657932236060,CSE 175,A01,083665,Kumar; Rakesh,3,0,25,22
1657932242089,CSE 190,A00,092507,Dubnov; Shlomo,8,0,20,12
1657932248114,ECE 45,A01,083139,Congero; Spencer William,7,0,75,68
1657932254160,ECE 65,A50,083695,Saad; Andrew S,12,0,30,18
1657932254160,ECE 65,A51,095125,Saad; Andrew S,24,0,26,2
1657932260188,ECE 109,A01,091882,Touri; Behrouz,20,0,70,50
1657932266216,ECE 180,A00,083140,Abi Samra; Nicholas Camill,1,0,30,29
1657932266216,ECE 180,B00,083141,Abi Samra; Nicholas Camill,0,0,30,30
1657932272239,MATH 10A,A01,083735,Patchell; Gregory David,2,0,30,28
1657932272239,MATH 10A,A02,083736,Patchell; Gregory David,20,0,30,10
1657932272239,MATH 10A,A03,083737,Patchell; Gregory David,16,0,30,14
1657932278263,MATH 10B,A01,083207,Lim; Seonhee,9,0,34,25
1657932278263,MATH 10B,A02,083208,Lim; Seonhee,10,0,35,25
1657932278263,MATH 10B,A03,093472,Lim; Seonhee,7,0,34,27
1657932278263,MATH 10B,B01,083739,Sinha; Shubham,14,0,30,16
1657932284288,MATH 18,A01,083743,Cinel; Cameron Alexander,9,0,30,21
1657932284288,MATH 18,A02,083744,Cinel; Cameron Alexander,18,0,30,12
1657932284288,MATH 18,A03,083745,Cinel; Cameron Alexander,10,0,30,20
1657932284288,MATH 18,B01,083748,Rideout; David Porter,5,0,37,32
1657932284288,MATH 18,B02,083749,Rideout; David Porter,5,0,36,31
1657932284288,MATH 18,B03,083750,Rideout; David Porter,3,0,37,34
1657932284288,MATH 18,B04,083751,Rideout; David Porter,7,0,36,29
1657932284288,MATH 18,B05,093473,Rideout; David Porter,7,0,36,29
1657932284288,MATH 18,B06,093474,Rideout; David Porter,6,0,36,30
1657932290311,MATH 20A,A01,083754,Zheng; Zequn,14,0,40,26
1657932296339,MATH 20B,A01,083756,Briones; Jor-el Thomas Caparas,4,0,36,32
1657932296339,MATH 20B,A02,083757,Briones; Jor-el Thomas Caparas,1,0,36,35
1657932296339,MATH 20B,A03,093475,Briones; Jor-el Thomas Caparas,3,0,36,33
1657932302363,MATH 20C,A01,083760,Briones; Jor-el Thomas Caparas,1,0,35,34
1657932302363,MATH 20C,A02,083761,Briones; Jor-el Thomas Caparas,8,0,35,27
1657932302363,MATH 20C,A03,093476,Briones; Jor-el Thomas Caparas,0,1,36,36
1657932302363,MATH 20C,B01,083762,Bach; Quang Tran,1,0,30,29
1657932308389,MATH 20D,A01,083765,Tran; Brian Kha,5,0,30,25
1657932308389,MATH 20D,A02,083766,Tran; Brian Kha,5,0,30,25
1657932308389,MATH 20D,A03,083767,Tran; Brian Kha,6,0,30,24
1657932314417,MATH 20E,A01,083771,Ganguly; Soumya,12,0,32,20
1657932314417,MATH 20E,A02,083772,Ganguly; Soumya,7,0,32,25
1657932314417,MATH 20E,B01,083773,Ciotti; Benjamin,20,0,35,15
1657932314417,MATH 20E,B02,083774,Ciotti; Benjamin,18,0,35,17
1657932320441,MATH 103A,A01,083777,Greenfeld; Be'Eri,3,0,36,33
1657932320441,MATH 103A,A02,083778,Greenfeld; Be'Eri,5,0,36,31
1657932320441,MATH 103A,A03,093561,Greenfeld; Be'Eri,6,0,36,30
1657932320441,MATH 103A,B01,083779,Greenfeld; Be'Eri,8,0,36,28
1657932320441,MATH 103A,B02,083780,Greenfeld; Be'Eri,4,0,36,32
1657932320441,MATH 103A,B03,093562,Greenfeld; Be'Eri,3,0,36,33
1657932326475,MATH 105,A01,085443,Carter; Anne Toulson,15,0,35,20
1657932326475,MATH 105,A02,093477,Carter; Anne Toulson,20,0,35,15
1657932332503,MATH 109,A01,083213,Ganzberger; Geoffrey Michael,3,0,34,31
1657932332503,MATH 109,A02,083214,Ganzberger; Geoffrey Michael,4,0,34,30
1657932332503,MATH 109,A03,093478,Ganzberger; Geoffrey Michael,2,0,34,32
1657932332503,MATH 109,B01,083215,Ganzberger; Geoffrey Michael,2,0,32,30
1657932332503,MATH 109,B02,083216,Ganzberger; Geoffrey Michael,3,0,32,29
1657932332503,MATH 109,B03,093479,Ganzberger; Geoffrey Michael,8,0,32,24
1657932338526,MATH 142A,A01,083219,Chow; Bennett,7,0,32,25
1657932338526,MATH 142A,A02,083220,Chow; Bennett,10,0,32,22
1657932338526,MATH 142A,A03,093480,Chow; Bennett,9,0,32,23
1657932338526,MATH 142A,B03,093481,Chow; Bennett,8,0,32,24
1657932338526,MATH 142A,B04,093558,Chow; Bennett,13,0,32,19
1657932338526,MATH 142A,B05,093559,Chow; Bennett,7,0,32,25
1657932344555,MATH 193A,A01,083224,Rotar; Vladimir,8,0,34,26
1657932344555,MATH 193A,A02,083225,Rotar; Vladimir,10,0,34,24
1657932344555,MATH 193A,A03,083781,Rotar; Vladimir,5,0,34,29
1657932344555,MATH 193A,A04,083782,Rotar; Vladimir,11,0,34,23
1657932344555,MATH 193A,A05,093482,Rotar; Vladimir,11,0,34,23
1657932350582,MATH 197,001,091859,McAuley; Julian John,9999,0,9999,0
1657932350582,MATH 197,002,095566,Kedlaya; Kiran S.,9997,0,9999,2
1657932350582,MATH 197,003,095567,Xiao; Ming,9999,0,9999,0
1657932350582,MATH 197,004,095571,Perols; Johan Lars,9998,0,9999,1
1657932357637,COGS 9,A01,083615,Shannon; Kyle Michael,11,0,75,64
1657932363660,COGS 11,A01,083617,Boyle; Mary E. T.,23,0,48,25
1657932369682,COGS 13,A01,083071,Bastos; Amalia Pinkusfeld,12,0,71,59
1657932375708,COGS 14A,A01,092681,Semenuks; Arturs,5,1,100,95
1657932381735,COGS 14B,A01,083073,Cheng; Tzu-Han,7,0,63,56
1657932387757,COGS 17,A01,092677,Semenuks; Arturs,7,0,81,74
1657932393781,COGS 100,A01,083619,Allen; Michael Gordon,17,0,70,53
1657932399804,COGS 101A,A01,083621,Davis; Joshua Daniel,9,0,68,59
1657932405827,COGS 101B,A01,091572,Allen; Michael Gordon,14,0,65,51
1657932411850,COGS 101C,A01,083625,Delgado; Tania,17,0,35,18
1657932417874,COGS 107A,A01,083627,Boyle; Mary E. T.,14,0,60,46
1657932423906,COGS 118A,A01,083075,Gupta; Anjum,21,0,76,55
1657932429930,CSE 3,A50,083646,Miranda; Gregory Joseph,24,0,50,26
1657932435959,CSE 8A,A50,083650,Miranda; Gregory Joseph,17,1,56,39
1657932441984,CSE 11,A01,083080,Cao; Yingjun,6,15,40,34
1657932448011,CSE 12,A01,083652,Krause-Levy; Sophia Louisa,30,1,120,90
1657932454034,CSE 15L,A01,083654,Morris; Justin Loren,9,0,50,41
1657932454034,CSE 15L,A02,083655,Morris; Justin Loren,10,0,50,40
1657932460055,CSE 20,A01,083657,Tran; Khoa Dang,39,0,80,41
1657932466079,CSE 21,A01,095574,Bach; Quang Tran,23,0,48,25
1657932472100,CSE 30,A01,083084,Eldon; John,7,0,80,73
1657932472100,CSE 30,B01,095061,Bhaskar; Nishant,9,0,50,41
1657932478123,CSE 100,A01,083659,Cao; Yingjun,5,4,70,65
1657932484150,CSE 134B,A01,083661,Powell; Thomas Allan,25,0,100,75
1657932490174,CSE 140,A01,083663,Gungor; Onat,17,0,85,68
1657932496201,CSE 140L,A01,083088,Eldon; John,23,0,100,77
1657932502225,CSE 175,A01,083665,Kumar; Rakesh,3,0,25,22
1657932508247,CSE 190,A00,092507,Dubnov; Shlomo,8,0,20,12
1657932514269,ECE 45,A01,083139,Congero; Spencer William,7,0,75,68
1657932520293,ECE 65,A50,083695,Saad; Andrew S,12,0,30,18
1657932520293,ECE 65,A51,095125,Saad; Andrew S,24,0,26,2
1657932526319,ECE 109,A01,091882,Touri; Behrouz,20,0,70,50
1657932532349,ECE 180,A00,083140,Abi Samra; Nicholas Camill,1,0,30,29
1657932532349,ECE 180,B00,083141,Abi Samra; Nicholas Camill,0,0,30,30
1657932538375,MATH 10A,A01,083735,Patchell; Gregory David,2,0,30,28
1657932538375,MATH 10A,A02,083736,Patchell; Gregory David,20,0,30,10
1657932538375,MATH 10A,A03,083737,Patchell; Gregory David,16,0,30,14
1657932544407,MATH 10B,A01,083207,Lim; Seonhee,9,0,34,25
1657932544407,MATH 10B,A02,083208,Lim; Seonhee,10,0,35,25
1657932544407,MATH 10B,A03,093472,Lim; Seonhee,7,0,34,27
1657932544407,MATH 10B,B01,083739,Sinha; Shubham,14,0,30,16
1657932550439,MATH 18,A01,083743,Cinel; Cameron Alexander,9,0,30,21
1657932550439,MATH 18,A02,083744,Cinel; Cameron Alexander,18,0,30,12
1657932550439,MATH 18,A03,083745,Cinel; Cameron Alexander,10,0,30,20
1657932550439,MATH 18,B01,083748,Rideout; David Porter,5,0,37,32
1657932550439,MATH 18,B02,083749,Rideout; David Porter,5,0,36,31
1657932550439,MATH 18,B03,083750,Rideout; David Porter,3,0,37,34
1657932550439,MATH 18,B04,083751,Rideout; David Porter,7,0,36,29
1657932550439,MATH 18,B05,093473,Rideout; David Porter,7,0,36,29
1657932550439,MATH 18,B06,093474,Rideout; David Porter,6,0,36,30
1657932556462,MATH 20A,A01,083754,Zheng; Zequn,14,0,40,26
1657932562486,MATH 20B,A01,083756,Briones; Jor-el Thomas Caparas,4,0,36,32
1657932562486,MATH 20B,A02,083757,Briones; Jor-el Thomas Caparas,1,0,36,35
1657932562486,MATH 20B,A03,093475,Briones; Jor-el Thomas Caparas,3,0,36,33
1657932568513,MATH 20C,A01,083760,Briones; Jor-el Thomas Caparas,1,0,35,34
1657932568513,MATH 20C,A02,083761,Briones; Jor-el Thomas Caparas,8,0,35,27
1657932568513,MATH 20C,A03,093476,Briones; Jor-el Thomas Caparas,0,1,36,36
1657932568513,MATH 20C,B01,083762,Bach; Quang Tran,1,0,30,29
1657932574541,MATH 20D,A01,083765,Tran; Brian Kha,5,0,30,25
1657932574541,MATH 20D,A02,083766,Tran; Brian Kha,5,0,30,25
1657932574541,MATH 20D,A03,083767,Tran; Brian Kha,6,0,30,24
1657932580564,MATH 20E,A01,083771,Ganguly; Soumya,12,0,32,20
1657932580564,MATH 20E,A02,083772,Ganguly; Soumya,7,0,32,25
1657932580564,MATH 20E,B01,083773,Ciotti; Benjamin,20,0,35,15
1657932580564,MATH 20E,B02,083774,Ciotti; Benjamin,18,0,35,17
1657932586586,MATH 103A,A01,083777,Greenfeld; Be'Eri,3,0,36,33
1657932586586,MATH 103A,A02,083778,Greenfeld; Be'Eri,5,0,36,31
1657932586586,MATH 103A,A03,093561,Greenfeld; Be'Eri,6,0,36,30
1657932586586,MATH 103A,B01,083779,Greenfeld; Be'Eri,8,0,36,28
1657932586586,MATH 103A,B02,083780,Greenfeld; Be'Eri,4,0,36,32
1657932586586,MATH 103A,B03,093562,Greenfeld; Be'Eri,3,0,36,33
1657932592610,MATH 105,A01,085443,Carter; Anne Toulson,15,0,35,20
1657932592610,MATH 105,A02,093477,Carter; Anne Toulson,20,0,35,15
1657932598633,MATH 109,A01,083213,Ganzberger; Geoffrey Michael,3,0,34,31
1657932598633,MATH 109,A02,083214,Ganzberger; Geoffrey Michael,4,0,34,30
1657932598633,MATH 109,A03,093478,Ganzberger; Geoffrey Michael,2,0,34,32
1657932598633,MATH 109,B01,083215,Ganzberger; Geoffrey Michael,2,0,32,30
1657932598633,MATH 109,B02,083216,Ganzberger; Geoffrey Michael,3,0,32,29
1657932598633,MATH 109,B03,093479,Ganzberger; Geoffrey Michael,8,0,32,24
1657932604669,MATH 142A,A01,083219,Chow; Bennett,7,0,32,25
1657932604669,MATH 142A,A02,083220,Chow; Bennett,10,0,32,22
1657932604669,MATH 142A,A03,093480,Chow; Bennett,9,0,32,23
1657932604669,MATH 142A,B03,093481,Chow; Bennett,8,0,32,24
1657932604669,MATH 142A,B04,093558,Chow; Bennett,13,0,32,19
1657932604669,MATH 142A,B05,093559,Chow; Bennett,7,0,32,25
1657932610697,MATH 193A,A01,083224,Rotar; Vladimir,8,0,34,26
1657932610697,MATH 193A,A02,083225,Rotar; Vladimir,10,0,34,24
1657932610697,MATH 193A,A03,083781,Rotar; Vladimir,5,0,34,29
1657932610697,MATH 193A,A04,083782,Rotar; Vladimir,11,0,34,23
1657932610697,MATH 193A,A05,093482,Rotar; Vladimir,11,0,34,23
1657932616721,MATH 197,001,091859,McAuley; Julian John,9999,0,9999,0
1657932616721,MATH 197,002,095566,Kedlaya; Kiran S.,9997,0,9999,2
1657932616721,MATH 197,003,095567,Xiao; Ming,9999,0,9999,0
1657932616721,MATH 197,004,095571,Perols; Johan Lars,9998,0,9999,1
1657932623784,COGS 9,A01,083615,Shannon; Kyle Michael,11,0,75,64
1657932629812,COGS 11,A01,083617,Boyle; Mary E. T.,23,0,48,25
1657932635836,COGS 13,A01,083071,Bastos; Amalia Pinkusfeld,12,0,71,59
1657932641862,COGS 14A,A01,092681,Semenuks; Arturs,5,1,100,95
1657932647885,COGS 14B,A01,083073,Cheng; Tzu-Han,7,0,63,56
1657932653911,COGS 17,A01,092677,Semenuks; Arturs,7,0,81,74
1657932659934,COGS 100,A01,083619,Allen; Michael Gordon,17,0,70,53
1657932665956,COGS 101A,A01,083621,Davis; Joshua Daniel,9,0,68,59
1657932671980,COGS 101B,A01,091572,Allen; Michael Gordon,14,0,65,51
1657932678006,COGS 101C,A01,083625,Delgado; Tania,17,0,35,18
1657932684033,COGS 107A,A01,083627,Boyle; Mary E. T.,14,0,60,46
1657932690056,COGS 118A,A01,083075,Gupta; Anjum,21,0,76,55
1657932696088,CSE 3,A50,083646,Miranda; Gregory Joseph,24,0,50,26
1657932702110,CSE 8A,A50,083650,Miranda; Gregory Joseph,17,1,56,39
1657932708132,CSE 11,A01,083080,Cao; Yingjun,6,15,40,34
1657932714153,CSE 12,A01,083652,Krause-Levy; Sophia Louisa,30,1,120,90
1657932720178,CSE 15L,A01,083654,Morris; Justin Loren,9,0,50,41
1657932720178,CSE 15L,A02,083655,Morris; Justin Loren,10,0,50,40
1657932726202,CSE 20,A01,083657,Tran; Khoa Dang,39,0,80,41
1657932732228,CSE 21,A01,095574,Bach; Quang Tran,23,0,48,25
1657932738255,CSE 30,A01,083084,Eldon; John,7,0,80,73
1657932738255,CSE 30,B01,095061,Bhaskar; Nishant,9,0,50,41
1657932744280,CSE 100,A01,083659,Cao; Yingjun,5,4,70,65
1657932750304,CSE 134B,A01,083661,Powell; Thomas Allan,25,0,100,75
1657932756327,CSE 140,A01,083663,Gungor; Onat,17,0,85,68
1657932762350,CSE 140L,A01,083088,Eldon; John,23,0,100,77
1657932768380,CSE 175,A01,083665,Kumar; Rakesh,3,0,25,22
1657932774406,CSE 190,A00,092507,Dubnov; Shlomo,8,0,20,12
1657932780428,ECE 45,A01,083139,Congero; Spencer William,7,0,75,68
1657932786456,ECE 65,A50,083695,Saad; Andrew S,12,0,30,18
1657932786456,ECE 65,A51,095125,Saad; Andrew S,24,0,26,2
1657932792478,ECE 109,A01,091882,Touri; Behrouz,20,0,70,50
1657932798501,ECE 180,A00,083140,Abi Samra; Nicholas Camill,1,0,30,29
1657932798501,ECE 180,B00,083141,Abi Samra; Nicholas Camill,0,0,30,30
1657932804523,MATH 10A,A01,083735,Patchell; Gregory David,2,0,30,28
1657932804523,MATH 10A,A02,083736,Patchell; Gregory David,20,0,30,10
1657932804523,MATH 10A,A03,083737,Patchell; Gregory David,16,0,30,14
1657932810546,MATH 10B,A01,083207,Lim; Seonhee,9,0,34,25
1657932810546,MATH 10B,A02,083208,Lim; Seonhee,10,0,35,25
1657932810546,MATH 10B,A03,093472,Lim; Seonhee,7,0,34,27
1657932810546,MATH 10B,B01,083739,Sinha; Shubham,14,0,30,16
1657932816641,MATH 18,A01,083743,Cinel; Cameron Alexander,9,0,30,21
1657932816641,MATH 18,A02,083744,Cinel; Cameron Alexander,18,0,30,12
1657932816641,MATH 18,A03,083745,Cinel; Cameron Alexander,10,0,30,20
1657932816641,MATH 18,B01,083748,Rideout; David Porter,5,0,37,32
1657932816641,MATH 18,B02,083749,Rideout; David Porter,5,0,36,31
1657932816641,MATH 18,B03,083750,Rideout; David Porter,3,0,37,34
1657932816641,MATH 18,B04,083751,Rideout; David Porter,7,0,36,29
1657932816641,MATH 18,B05,093473,Rideout; David Porter,7,0,36,29
1657932816641,MATH 18,B06,093474,Rideout; David Porter,6,0,36,30
1657932822668,MATH 20A,A01,083754,Zheng; Zequn,14,0,40,26
1657932828691,MATH 20B,A01,083756,Briones; Jor-el Thomas Caparas,4,0,36,32
1657932828691,MATH 20B,A02,083757,Briones; Jor-el Thomas Caparas,1,0,36,35
1657932828691,MATH 20B,A03,093475,Briones; Jor-el Thomas Caparas,3,0,36,33
1657932834718,MATH 20C,A01,083760,Briones; Jor-el Thomas Caparas,1,0,35,34
1657932834718,MATH 20C,A02,083761,Briones; Jor-el Thomas Caparas,8,0,35,27
1657932834718,MATH 20C,A03,093476,Briones; Jor-el Thomas Caparas,0,1,36,36
1657932834718,MATH 20C,B01,083762,Bach; Quang Tran,1,0,30,29
1657932840742,MATH 20D,A01,083765,Tran; Brian Kha,5,0,30,25
1657932840742,MATH 20D,A02,083766,Tran; Brian Kha,5,0,30,25
1657932840742,MATH 20D,A03,083767,Tran; Brian Kha,6,0,30,24
1657932846765,MATH 20E,A01,083771,Ganguly; Soumya,12,0,32,20
1657932846765,MATH 20E,A02,083772,Ganguly; Soumya,7,0,32,25
1657932846765,MATH 20E,B01,083773,Ciotti; Benjamin,20,0,35,15
1657932846765,MATH 20E,B02,083774,Ciotti; Benjamin,18,0,35,17
1657932852789,MATH 103A,A01,083777,Greenfeld; Be'Eri,3,0,36,33
1657932852789,MATH 103A,A02,083778,Greenfeld; Be'Eri,5,0,36,31
1657932852789,MATH 103A,A03,093561,Greenfeld; Be'Eri,6,0,36,30
1657932852789,MATH 103A,B01,083779,Greenfeld; Be'Eri,8,0,36,28
1657932852789,MATH 103A,B02,083780,Greenfeld; Be'Eri,4,0,36,32
1657932852789,MATH 103A,B03,093562,Greenfeld; Be'Eri,3,0,36,33
1657932858818,MATH 105,A01,085443,Carter; Anne Toulson,15,0,35,20
1657932858818,MATH 105,A02,093477,Carter; Anne Toulson,20,0,35,15
1657932864839,MATH 109,A01,083213,Ganzberger; Geoffrey Michael,3,0,34,31
1657932864839,MATH 109,A02,083214,Ganzberger; Geoffrey Michael,4,0,34,30
1657932864839,MATH 109,A03,093478,Ganzberger; Geoffrey Michael,2,0,34,32
1657932864839,MATH 109,B01,083215,Ganzberger; Geoffrey Michael,2,0,32,30
1657932864839,MATH 109,B02,083216,Ganzberger; Geoffrey Michael,3,0,32,29
1657932864839,MATH 109,B03,093479,Ganzberger; Geoffrey Michael,8,0,32,24
1657932870862,MATH 142A,A01,083219,Chow; Bennett,7,0,32,25
1657932870862,MATH 142A,A02,083220,Chow; Bennett,10,0,32,22
1657932870862,MATH 142A,A03,093480,Chow; Bennett,9,0,32,23
1657932870862,MATH 142A,B03,093481,Chow; Bennett,8,0,32,24
1657932870862,MATH 142A,B04,093558,Chow; Bennett,13,0,32,19
1657932870862,MATH 142A,B05,093559,Chow; Bennett,7,0,32,25
1657932876889,MATH 193A,A01,083224,Rotar; Vladimir,8,0,34,26
1657932876889,MATH 193A,A02,083225,Rotar; Vladimir,10,0,34,24
1657932876889,MATH 193A,A03,083781,Rotar; Vladimir,5,0,34,29
1657932876889,MATH 193A,A04,083782,Rotar; Vladimir,11,0,34,23
1657932876889,MATH 193A,A05,093482,Rotar; Vladimir,11,0,34,23
1657932882913,MATH 197,001,091859,McAuley; Julian John,9999,0,9999,0
1657932882913,MATH 197,002,095566,Kedlaya; Kiran S.,9997,0,9999,2
1657932882913,MATH 197,003,095567,Xiao; Ming,9999,0,9999,0
1657932882913,MATH 197,004,095571,Perols; Johan Lars,9998,0,9999,1
1657932889969,COGS 9,A01,083615,Shannon; Kyle Michael,11,0,75,64
1657932896005,COGS 11,A01,083617,Boyle; Mary E. T.,23,0,48,25
1657932902030,COGS 13,A01,083071,Bastos; Amalia Pinkusfeld,12,0,71,59
1657932908056,COGS 14A,A01,092681,Semenuks; Arturs,5,1,100,95
1657932914084,COGS 14B,A01,083073,Cheng; Tzu-Han,7,0,63,56
1657932920106,COGS 17,A01,092677,Semenuks; Arturs,7,0,81,74
1657932926136,COGS 100,A01,083619,Allen; Michael Gordon,17,0,70,53
1657932932162,COGS 101A,A01,083621,Davis; Joshua Daniel,9,0,68,59
1657932938184,COGS 101B,A01,091572,Allen; Michael Gordon,14,0,65,51
1657932944211,COGS 101C,A01,083625,Delgado; Tania,17,0,35,18
1657932950241,COGS 107A,A01,083627,Boyle; Mary E. T.,14,0,60,46
1657932956264,COGS 118A,A01,083075,Gupta; Anjum,21,0,76,55
1657932962286,CSE 3,A50,083646,Miranda; Gregory Joseph,24,0,50,26
1657932968316,CSE 8A,A50,083650,Miranda; Gregory Joseph,17,1,56,39
1657932974338,CSE 11,A01,083080,Cao; Yingjun,6,15,40,34
1657932980365,CSE 12,A01,083652,Krause-Levy; Sophia Louisa,30,1,120,90
1657932986393,CSE 15L,A01,083654,Morris; Justin Loren,9,0,50,41
1657932986393,CSE 15L,A02,083655,Morris; Justin Loren,10,0,50,40
1657932992422,CSE 20,A01,083657,Tran; Khoa Dang,39,0,80,41
1657932998449,CSE 21,A01,095574,Bach; Quang Tran,23,0,48,25
1657933004471,CSE 30,A01,083084,Eldon; John,7,0,80,73
1657933004471,CSE 30,B01,095061,Bhaskar; Nishant,9,0,50,41
1657933010498,CSE 100,A01,083659,Cao; Yingjun,5,4,70,65
1657933016522,CSE 134B,A01,083661,Powell; Thomas Allan,25,0,100,75
1657933022549,CSE 140,A01,083663,Gungor; Onat,17,0,85,68
1657933028573,CSE 140L,A01,083088,Eldon; John,23,0,100,77
1657933034596,CSE 175,A01,083665,Kumar; Rakesh,3,0,25,22
1657933040619,CSE 190,A00,092507,Dubnov; Shlomo,8,0,20,12
1657933046643,ECE 45,A01,083139,Congero; Spencer William,7,0,75,68
1657933052666,ECE 65,A50,083695,Saad; Andrew S,12,0,30,18
1657933052666,ECE 65,A51,095125,Saad; Andrew S,24,0,26,2
1657933058696,ECE 109,A01,091882,Touri; Behrouz,20,0,70,50
1657933064720,ECE 180,A00,083140,Abi Samra; Nicholas Camill,1,0,30,29
1657933064720,ECE 180,B00,083141,Abi Samra; Nicholas Camill,0,0,30,30
1657933070743,MATH 10A,A01,083735,Patchell; Gregory David,2,0,30,28
1657933070743,MATH 10A,A02,083736,Patchell; Gregory David,20,0,30,10
1657933070743,MATH 10A,A03,083737,Patchell; Gregory David,16,0,30,14
1657933076767,MATH 10B,A01,083207,Lim; Seonhee,9,0,34,25
1657933076767,MATH 10B,A02,083208,Lim; Seonhee,10,0,35,25
1657933076767,MATH 10B,A03,093472,Lim; Seonhee,7,0,34,27
1657933076767,MATH 10B,B01,083739,Sinha; Shubham,14,0,30,16
1657933082793,MATH 18,A01,083743,Cinel; Cameron Alexander,9,0,30,21
1657933082793,MATH 18,A02,083744,Cinel; Cameron Alexander,18,0,30,12
1657933082793,MATH 18,A03,083745,Cinel; Cameron Alexander,10,0,30,20
1657933082793,MATH 18,B01,083748,Rideout; David Porter,5,0,37,32
1657933082793,MATH 18,B02,083749,Rideout; David Porter,5,0,36,31
1657933082793,MATH 18,B03,083750,Rideout; David Porter,3,0,37,34
1657933082793,MATH 18,B04,083751,Rideout; David Porter,7,0,36,29
1657933082793,MATH 18,B05,093473,Rideout; David Porter,7,0,36,29
1657933082793,MATH 18,B06,093474,Rideout; David Porter,6,0,36,30
1657933088820,MATH 20A,A01,083754,Zheng; Zequn,14,0,40,26
1657933094842,MATH 20B,A01,083756,Briones; Jor-el Thomas Caparas,4,0,36,32
1657933094842,MATH 20B,A02,083757,Briones; Jor-el Thomas Caparas,1,0,36,35
1657933094842,MATH 20B,A03,093475,Briones; Jor-el Thomas Caparas,3,0,36,33
1657933100872,MATH 20C,A01,083760,Briones; Jor-el Thomas Caparas,1,0,35,34
1657933100872,MATH 20C,A02,083761,Briones; Jor-el Thomas Caparas,8,0,35,27
1657933100872,MATH 20C,A03,093476,Briones; Jor-el Thomas Caparas,0,1,36,36
1657933100872,MATH 20C,B01,083762,Bach; Quang Tran,1,0,30,29
1657933106896,MATH 20D,A01,083765,Tran; Brian Kha,5,0,30,25
1657933106896,MATH 20D,A02,083766,Tran; Brian Kha,5,0,30,25
1657933106896,MATH 20D,A03,083767,Tran; Brian Kha,6,0,30,24
1657933112920,MATH 20E,A01,083771,Ganguly; Soumya,12,0,32,20
1657933112920,MATH 20E,A02,083772,Ganguly; Soumya,7,0,32,25
1657933112920,MATH 20E,B01,083773,Ciotti; Benjamin,20,0,35,15
1657933112920,MATH 20E,B02,083774,Ciotti; Benjamin,18,0,35,17
1657933118945,MATH 103A,A01,083777,Greenfeld; Be'Eri,3,0,36,33
1657933118945,MATH 103A,A02,083778,Greenfeld; Be'Eri,5,0,36,31
1657933118945,MATH 103A,A03,093561,Greenfeld; Be'Eri,6,0,36,30
1657933118945,MATH 103A,B01,083779,Greenfeld; Be'Eri,8,0,36,28
1657933118945,MATH 103A,B02,083780,Greenfeld; Be'Eri,4,0,36,32
1657933118945,MATH 103A,B03,093562,Greenfeld; Be'Eri,3,0,36,33
1657933124973,MATH 105,A01,085443,Carter; Anne Toulson,15,0,35,20
1657933124973,MATH 105,A02,093477,Carter; Anne Toulson,20,0,35,15
1657933130997,MATH 109,A01,083213,Ganzberger; Geoffrey Michael,3,0,34,31
1657933130997,MATH 109,A02,083214,Ganzberger; Geoffrey Michael,4,0,34,30
1657933130997,MATH 109,A03,093478,Ganzberger; Geoffrey Michael,2,0,34,32
1657933130997,MATH 109,B01,083215,Ganzberger; Geoffrey Michael,2,0,32,30
1657933130997,MATH 109,B02,083216,Ganzberger; Geoffrey Michael,3,0,32,29
1657933130997,MATH 109,B03,093479,Ganzberger; Geoffrey Michael,8,0,32,24
1657933137021,MATH 142A,A01,083219,Chow; Bennett,7,0,32,25
1657933137021,MATH 142A,A02,083220,Chow; Bennett,10,0,32,22
1657933137021,MATH 142A,A03,093480,Chow; Bennett,9,0,32,23
1657933137021,MATH 142A,B03,093481,Chow; Bennett,8,0,32,24
1657933137021,MATH 142A,B04,093558,Chow; Bennett,13,0,32,19
1657933137021,MATH 142A,B05,093559,Chow; Bennett,7,0,32,25
1657933143050,MATH 193A,A01,083224,Rotar; Vladimir,8,0,34,26
1657933143050,MATH 193A,A02,083225,Rotar; Vladimir,10,0,34,24
1657933143050,MATH 193A,A03,083781,Rotar; Vladimir,5,0,34,29
1657933143050,MATH 193A,A04,083782,Rotar; Vladimir,11,0,34,23
1657933143050,MATH 193A,A05,093482,Rotar; Vladimir,11,0,34,23
1657933149074,MATH 197,001,091859,McAuley; Julian John,9999,0,9999,0
1657933149074,MATH 197,002,095566,Kedlaya; Kiran S.,9997,0,9999,2
1657933149074,MATH 197,003,095567,Xiao; Ming,9999,0,9999,0
1657933149074,MATH 197,004,095571,Perols; Johan Lars,9998,0,9999,1
1657933156124,COGS 9,A01,083615,Shannon; Kyle Michael,11,0,75,64
1657933162147,COGS 11,A01,083617,Boyle; Mary E. T.,23,0,48,25
1657933168168,COGS 13,A01,083071,Bastos; Amalia Pinkusfeld,12,0,71,59
1657933174192,COGS 14A,A01,092681,Semenuks; Arturs,5,1,100,95
1657933180219,COGS 14B,A01,083073,Cheng; Tzu-Han,7,0,63,56
1657933186251,COGS 17,A01,092677,Semenuks; Arturs,7,0,81,74
1657933192275,COGS 100,A01,083619,Allen; Michael Gordon,17,0,70,53
1657933198324,COGS 101A,A01,083621,Davis; Joshua Daniel,9,0,68,59
1657933204352,COGS 101B,A01,091572,Allen; Michael Gordon,14,0,65,51
1657933210376,COGS 101C,A01,083625,Delgado; Tania,17,0,35,18
1657933216404,COGS 107A,A01,083627,Boyle; Mary E. T.,14,0,60,46
1657933222428,COGS 118A,A01,083075,Gupta; Anjum,21,0,76,55
1657933228456,CSE 3,A50,083646,Miranda; Gregory Joseph,24,0,50,26
1657933234480,CSE 8A,A50,083650,Miranda; Gregory Joseph,17,1,56,39
1657933240507,CSE 11,A01,083080,Cao; Yingjun,6,15,40,34
1657933246534,CSE 12,A01,083652,Krause-Levy; Sophia Louisa,30,1,120,90
1657933252559,CSE 15L,A01,083654,Morris; Justin Loren,9,0,50,41
1657933252559,CSE 15L,A02,083655,Morris; Justin Loren,10,0,50,40
1657933258582,CSE 20,A01,083657,Tran; Khoa Dang,39,0,80,41
1657933264621,CSE 21,A01,095574,Bach; Quang Tran,23,0,48,25
1657933270648,CSE 30,A01,083084,Eldon; John,7,0,80,73
1657933270648,CSE 30,B01,095061,Bhaskar; Nishant,9,0,50,41
1657933276676,CSE 100,A01,083659,Cao; Yingjun,5,4,70,65
1657933282700,CSE 134B,A01,083661,Powell; Thomas Allan,25,0,100,75
1657933288725,CSE 140,A01,083663,Gungor; Onat,17,0,85,68
1657933294748,CSE 140L,A01,083088,Eldon; John,23,0,100,77
1657933300773,CSE 175,A01,083665,Kumar; Rakesh,3,0,25,22
1657933306799,CSE 190,A00,092507,Dubnov; Shlomo,8,0,20,12
1657933312821,ECE 45,A01,083139,Congero; Spencer William,7,0,75,68
1657933318849,ECE 65,A50,083695,Saad; Andrew S,12,0,30,18
1657933318849,ECE 65,A51,095125,Saad; Andrew S,24,0,26,2
1657933324876,ECE 109,A01,091882,Touri; Behrouz,20,0,70,50
1657933330898,ECE 180,A00,083140,Abi Samra; Nicholas Camill,1,0,30,29
1657933330898,ECE 180,B00,083141,Abi Samra; Nicholas Camill,0,0,30,30
1657933336922,MATH 10A,A01,083735,Patchell; Gregory David,2,0,30,28
1657933336922,MATH 10A,A02,083736,Patchell; Gregory David,20,0,30,10
1657933336922,MATH 10A,A03,083737,Patchell; Gregory David,16,0,30,14
1657933342951,MATH 10B,A01,083207,Lim; Seonhee,9,0,34,25
1657933342951,MATH 10B,A02,083208,Lim; Seonhee,10,0,35,25
1657933342951,MATH 10B,A03,093472,Lim; Seonhee,7,0,34,27
1657933342951,MATH 10B,B01,083739,Sinha; Shubham,14,0,30,16
1657933348974,MATH 18,A01,083743,Cinel; Cameron Alexander,9,0,30,21
1657933348974,MATH 18,A02,083744,Cinel; Cameron Alexander,18,0,30,12
1657933348974,MATH 18,A03,083745,Cinel; Cameron Alexander,10,0,30,20
1657933348974,MATH 18,B01,083748,Rideout; David Porter,5,0,37,32
1657933348974,MATH 18,B02,083749,Rideout; David Porter,5,0,36,31
1657933348974,MATH 18,B03,083750,Rideout; David Porter,3,0,37,34
1657933348974,MATH 18,B04,083751,Rideout; David Porter,7,0,36,29
1657933348974,MATH 18,B05,093473,Rideout; David Porter,7,0,36,29
1657933348974,MATH 18,B06,093474,Rideout; David Porter,6,0,36,30
1657933354996,MATH 20A,A01,083754,Zheng; Zequn,14,0,40,26
1657933361021,MATH 20B,A01,083756,Briones; Jor-el Thomas Caparas,4,0,36,32
1657933361021,MATH 20B,A02,083757,Briones; Jor-el Thomas Caparas,1,0,36,35
1657933361021,MATH 20B,A03,093475,Briones; Jor-el Thomas Caparas,3,0,36,33
1657933367051,MATH 20C,A01,083760,Briones; Jor-el Thomas Caparas,1,0,35,34
1657933367051,MATH 20C,A02,083761,Briones; Jor-el Thomas Caparas,8,0,35,27
1657933367051,MATH 20C,A03,093476,Briones; Jor-el Thomas Caparas,0,1,36,36
1657933367051,MATH 20C,B01,083762,Bach; Quang Tran,1,0,30,29
1657933373079,MATH 20D,A01,083765,Tran; Brian Kha,5,0,30,25
1657933373079,MATH 20D,A02,083766,Tran; Brian Kha,5,0,30,25
1657933373079,MATH 20D,A03,083767,Tran; Brian Kha,6,0,30,24
1657933379101,MATH 20E,A01,083771,Ganguly; Soumya,12,0,32,20
1657933379101,MATH 20E,A02,083772,Ganguly; Soumya,7,0,32,25
1657933379101,MATH 20E,B01,083773,Ciotti; Benjamin,20,0,35,15
1657933379101,MATH 20E,B02,083774,Ciotti; Benjamin,18,0,35,17
1657933385124,MATH 103A,A01,083777,Greenfeld; Be'Eri,3,0,36,33
1657933385124,MATH 103A,A02,083778,Greenfeld; Be'Eri,5,0,36,31
1657933385124,MATH 103A,A03,093561,Greenfeld; Be'Eri,6,0,36,30
1657933385124,MATH 103A,B01,083779,Greenfeld; Be'Eri,8,0,36,28
1657933385124,MATH 103A,B02,083780,Greenfeld; Be'Eri,4,0,36,32
1657933385124,MATH 103A,B03,093562,Greenfeld; Be'Eri,3,0,36,33
1657933391151,MATH 105,A01,085443,Carter; Anne Toulson,15,0,35,20
1657933391151,MATH 105,A02,093477,Carter; Anne Toulson,20,0,35,15
1657933397178,MATH 109,A01,083213,Ganzberger; Geoffrey Michael,3,0,34,31
1657933397178,MATH 109,A02,083214,Ganzberger; Geoffrey Michael,4,0,34,30
1657933397178,MATH 109,A03,093478,Ganzberger; Geoffrey Michael,2,0,34,32
1657933397178,MATH 109,B01,083215,Ganzberger; Geoffrey Michael,2,0,32,30
1657933397178,MATH 109,B02,083216,Ganzberger; Geoffrey Michael,3,0,32,29
1657933397178,MATH 109,B03,093479,Ganzberger; Geoffrey Michael,8,0,32,24
1657933403207,MATH 142A,A01,083219,Chow; Bennett,7,0,32,25
1657933403207,MATH 142A,A02,083220,Chow; Bennett,10,0,32,22
1657933403207,MATH 142A,A03,093480,Chow; Bennett,9,0,32,23
1657933403207,MATH 142A,B03,093481,Chow; Bennett,8,0,32,24
1657933403207,MATH 142A,B04,093558,Chow; Bennett,13,0,32,19
1657933403207,MATH 142A,B05,093559,Chow; Bennett,7,0,32,25
1657933409234,MATH 193A,A01,083224,Rotar; Vladimir,8,0,34,26
1657933409234,MATH 193A,A02,083225,Rotar; Vladimir,10,0,34,24
1657933409234,MATH 193A,A03,083781,Rotar; Vladimir,5,0,34,29
1657933409234,MATH 193A,A04,083782,Rotar; Vladimir,11,0,34,23
1657933409234,MATH 193A,A05,093482,Rotar; Vladimir,11,0,34,23
1657933415333,MATH 197,001,091859,McAuley; Julian John,9999,0,9999,0
1657933415333,MATH 197,002,095566,Kedlaya; Kiran S.,9997,0,9999,2
1657933415333,MATH 197,003,095567,Xiao; Ming,9999,0,9999,0
1657933415333,MATH 197,004,095571,Perols; Johan Lars,9998,0,9999,1
1657933422398,COGS 9,A01,083615,Shannon; Kyle Michael,11,0,75,64
1657933428445,COGS 11,A01,083617,Boyle; Mary E. T.,23,0,48,25
1657933434471,COGS 13,A01,083071,Bastos; Amalia Pinkusfeld,12,0,71,59
1657933440497,COGS 14A,A01,092681,Semenuks; Arturs,5,1,100,95
1657933446523,COGS 14B,A01,083073,Cheng; Tzu-Han,7,0,63,56
1657933452555,COGS 17,A01,092677,Semenuks; Arturs,7,0,81,74
1657933458579,COGS 100,A01,083619,Allen; Michael Gordon,17,0,70,53
1657933464608,COGS 101A,A01,083621,Davis; Joshua Daniel,9,0,68,59
1657933470635,COGS 101B,A01,091572,Allen; Michael Gordon,14,0,65,51
1657933476657,COGS 101C,A01,083625,Delgado; Tania,17,0,35,18
1657933482681,COGS 107A,A01,083627,Boyle; Mary E. T.,14,0,60,46
1657933488704,COGS 118A,A01,083075,Gupta; Anjum,21,0,76,55
1657933494732,CSE 3,A50,083646,Miranda; Gregory Joseph,24,0,50,26
1657933500760,CSE 8A,A50,083650,Miranda; Gregory Joseph,17,1,56,39
1657933506788,CSE 11,A01,083080,Cao; Yingjun,6,15,40,34
1657933512814,CSE 12,A01,083652,Krause-Levy; Sophia Louisa,30,1,120,90
1657933518837,CSE 15L,A01,083654,Morris; Justin Loren,9,0,50,41
1657933518837,CSE 15L,A02,083655,Morris; Justin Loren,10,0,50,40
1657933524864,CSE 20,A01,083657,Tran; Khoa Dang,39,0,80,41
1657933530887,CSE 21,A01,095574,Bach; Quang Tran,23,0,48,25
1657933536910,CSE 30,A01,083084,Eldon; John,7,0,80,73
1657933536910,CSE 30,B01,095061,Bhaskar; Nishant,9,0,50,41
1657933542933,CSE 100,A01,083659,Cao; Yingjun,5,4,70,65
1657933548968,CSE 134B,A01,083661,Powell; Thomas Allan,25,0,100,75
1657933554995,CSE 140,A01,083663,Gungor; Onat,17,0,85,68
1657933561022,CSE 140L,A01,083088,Eldon; John,23,0,100,77
1657933567057,CSE 175,A01,083665,Kumar; Rakesh,3,0,25,22
1657933573081,CSE 190,A00,092507,Dubnov; Shlomo,8,0,20,12
1657933579107,ECE 45,A01,083139,Congero; Spencer William,7,0,75,68
1657933585134,ECE 65,A50,083695,Saad; Andrew S,12,0,30,18
1657933585134,ECE 65,A51,095125,Saad; Andrew S,24,0,26,2
1657933591156,ECE 109,A01,091882,Touri; Behrouz,20,0,70,50
1657933597180,ECE 180,A00,083140,Abi Samra; Nicholas Camill,1,0,30,29
1657933597180,ECE 180,B00,083141,Abi Samra; Nicholas Camill,0,0,30,30
1657933603223,MATH 10A,A01,083735,Patchell; Gregory David,2,0,30,28
1657933603223,MATH 10A,A02,083736,Patchell; Gregory David,20,0,30,10
1657933603223,MATH 10A,A03,083737,Patchell; Gregory David,16,0,30,14
1657933609247,MATH 10B,A01,083207,Lim; Seonhee,9,0,34,25
1657933609247,MATH 10B,A02,083208,Lim; Seonhee,10,0,35,25
1657933609247,MATH 10B,A03,093472,Lim; Seonhee,7,0,34,27
1657933609247,MATH 10B,B01,083739,Sinha; Shubham,14,0,30,16
1657933615279,MATH 18,A01,083743,Cinel; Cameron Alexander,9,0,30,21
1657933615279,MATH 18,A02,083744,Cinel; Cameron Alexander,18,0,30,12
1657933615279,MATH 18,A03,083745,Cinel; Cameron Alexander,10,0,30,20
1657933615279,MATH 18,B01,083748,Rideout; David Porter,5,0,37,32
1657933615279,MATH 18,B02,083749,Rideout; David Porter,5,0,36,31
1657933615279,MATH 18,B03,083750,Rideout; David Porter,3,0,37,34
1657933615279,MATH 18,B04,083751,Rideout; David Porter,7,0,36,29
1657933615279,MATH 18,B05,093473,Rideout; David Porter,7,0,36,29
1657933615279,MATH 18,B06,093474,Rideout; David Porter,6,0,36,30
1657933621307,MATH 20A,A01,083754,Zheng; Zequn,14,0,40,26
1657933627334,MATH 20B,A01,083756,Briones; Jor-el Thomas Caparas,4,0,36,32
1657933627334,MATH 20B,A02,083757,Briones; Jor-el Thomas Caparas,1,0,36,35
1657933627334,MATH 20B,A03,093475,Briones; Jor-el Thomas Caparas,3,0,36,33
1657933633361,MATH 20C,A01,083760,Briones; Jor-el Thomas Caparas,1,0,35,34
1657933633361,MATH 20C,A02,083761,Briones; Jor-el Thomas Caparas,8,0,35,27
1657933633361,MATH 20C,A03,093476,Briones; Jor-el Thomas Caparas,0,1,36,36
1657933633361,MATH 20C,B01,083762,Bach; Quang Tran,1,0,30,29
1657933639388,MATH 20D,A01,083765,Tran; Brian Kha,5,0,30,25
1657933639388,MATH 20D,A02,083766,Tran; Brian Kha,5,0,30,25
1657933639388,MATH 20D,A03,083767,Tran; Brian Kha,6,0,30,24
1657933645412,MATH 20E,A01,083771,Ganguly; Soumya,12,0,32,20
1657933645412,MATH 20E,A02,083772,Ganguly; Soumya,7,0,32,25
1657933645412,MATH 20E,B01,083773,Ciotti; Benjamin,20,0,35,15
1657933645412,MATH 20E,B02,083774,Ciotti; Benjamin,18,0,35,17
1657933651440,MATH 103A,A01,083777,Greenfeld; Be'Eri,3,0,36,33
1657933651440,MATH 103A,A02,083778,Greenfeld; Be'Eri,5,0,36,31
1657933651440,MATH 103A,A03,093561,Greenfeld; Be'Eri,6,0,36,30
1657933651440,MATH 103A,B01,083779,Greenfeld; Be'Eri,8,0,36,28
1657933651440,MATH 103A,B02,083780,Greenfeld; Be'Eri,4,0,36,32
1657933651440,MATH 103A,B03,093562,Greenfeld; Be'Eri,3,0,36,33
1657933657464,MATH 105,A01,085443,Carter; Anne Toulson,15,0,35,20
1657933657464,MATH 105,A02,093477,Carter; Anne Toulson,20,0,35,15
1657933663491,MATH 109,A01,083213,Ganzberger; Geoffrey Michael,3,0,34,31
1657933663491,MATH 109,A02,083214,Ganzberger; Geoffrey Michael,4,0,34,30
1657933663491,MATH 109,A03,093478,Ganzberger; Geoffrey Michael,2,0,34,32
1657933663491,MATH 109,B01,083215,Ganzberger; Geoffrey Michael,2,0,32,30
1657933663491,MATH 109,B02,083216,Ganzberger; Geoffrey Michael,3,0,32,29
1657933663491,MATH 109,B03,093479,Ganzberger; Geoffrey Michael,8,0,32,24
1657933669513,MATH 142A,A01,083219,Chow; Bennett,7,0,32,25
1657933669513,MATH 142A,A02,083220,Chow; Bennett,10,0,32,22
1657933669513,MATH 142A,A03,093480,Chow; Bennett,9,0,32,23
1657933669513,MATH 142A,B03,093481,Chow; Bennett,8,0,32,24
1657933669513,MATH 142A,B04,093558,Chow; Bennett,13,0,32,19
1657933669513,MATH 142A,B05,093559,Chow; Bennett,7,0,32,25
1657933675538,MATH 193A,A01,083224,Rotar; Vladimir,8,0,34,26
1657933675538,MATH 193A,A02,083225,Rotar; Vladimir,10,0,34,24
1657933675538,MATH 193A,A03,083781,Rotar; Vladimir,5,0,34,29
1657933675538,MATH 193A,A04,083782,Rotar; Vladimir,11,0,34,23
1657933675538,MATH 193A,A05,093482,Rotar; Vladimir,11,0,34,23
1657933681562,MATH 197,001,091859,McAuley; Julian John,9999,0,9999,0
1657933681562,MATH 197,002,095566,Kedlaya; Kiran S.,9997,0,9999,2
1657933681562,MATH 197,003,095567,Xiao; Ming,9999,0,9999,0
1657933681562,MATH 197,004,095571,Perols; Johan Lars,9998,0,9999,1
1657933688624,COGS 9,A01,083615,Shannon; Kyle Michael,11,0,75,64
1657933694648,COGS 11,A01,083617,Boyle; Mary E. T.,23,0,48,25
1657933700677,COGS 13,A01,083071,Bastos; Amalia Pinkusfeld,12,0,71,59
1657933706706,COGS 14A,A01,092681,Semenuks; Arturs,5,1,100,95
1657933712732,COGS 14B,A01,083073,Cheng; Tzu-Han,7,0,63,56
1657933718758,COGS 17,A01,092677,Semenuks; Arturs,7,0,81,74
1657933724781,COGS 100,A01,083619,Allen; Michael Gordon,17,0,70,53
1657933730809,COGS 101A,A01,083621,Davis; Joshua Daniel,9,0,68,59
1657933736831,COGS 101B,A01,091572,Allen; Michael Gordon,14,0,65,51
1657933742853,COGS 101C,A01,083625,Delgado; Tania,17,0,35,18
1657933748881,COGS 107A,A01,083627,Boyle; Mary E. T.,14,0,60,46
1657933754903,COGS 118A,A01,083075,Gupta; Anjum,21,0,76,55
1657933760926,CSE 3,A50,083646,Miranda; Gregory Joseph,24,0,50,26
1657933766953,CSE 8A,A50,083650,Miranda; Gregory Joseph,17,1,56,39
1657933772978,CSE 11,A01,083080,Cao; Yingjun,6,15,40,34
1657933779001,CSE 12,A01,083652,Krause-Levy; Sophia Louisa,30,1,120,90
1657933785024,CSE 15L,A01,083654,Morris; Justin Loren,9,0,50,41
1657933785024,CSE 15L,A02,083655,Morris; Justin Loren,10,0,50,40
1657933791053,CSE 20,A01,083657,Tran; Khoa Dang,39,0,80,41
1657933797079,CSE 21,A01,095574,Bach; Quang Tran,23,0,48,25
1657933803108,CSE 30,A01,083084,Eldon; John,7,0,80,73
1657933803108,CSE 30,B01,095061,Bhaskar; Nishant,9,0,50,41
1657933809134,CSE 100,A01,083659,Cao; Yingjun,5,4,70,65
1657933815160,CSE 134B,A01,083661,Powell; Thomas Allan,25,0,100,75
1657933821182,CSE 140,A01,083663,Gungor; Onat,17,0,85,68
1657933827205,CSE 140L,A01,083088,Eldon; John,23,0,100,77
1657933833228,CSE 175,A01,083665,Kumar; Rakesh,3,0,25,22
1657933839253,CSE 190,A00,092507,Dubnov; Shlomo,8,0,20,12
1657933845277,ECE 45,A01,083139,Congero; Spencer William,7,0,75,68
1657933851300,ECE 65,A50,083695,Saad; Andrew S,12,0,30,18
1657933851300,ECE 65,A51,095125,Saad; Andrew S,24,0,26,2
1657933857333,ECE 109,A01,091882,Touri; Behrouz,20,0,70,50
1657933863362,ECE 180,A00,083140,Abi Samra; Nicholas Camill,1,0,30,29
1657933863362,ECE 180,B00,083141,Abi Samra; Nicholas Camill,0,0,30,30
1657933869385,MATH 10A,A01,083735,Patchell; Gregory David,2,0,30,28
1657933869385,MATH 10A,A02,083736,Patchell; Gregory David,20,0,30,10
1657933869385,MATH 10A,A03,083737,Patchell; Gregory David,16,0,30,14
1657933875408,MATH 10B,A01,083207,Lim; Seonhee,9,0,34,25
1657933875408,MATH 10B,A02,083208,Lim; Seonhee,10,0,35,25
1657933875408,MATH 10B,A03,093472,Lim; Seonhee,7,0,34,27
1657933875408,MATH 10B,B01,083739,Sinha; Shubham,14,0,30,16
1657933881434,MATH 18,A01,083743,Cinel; Cameron Alexander,9,0,30,21
1657933881434,MATH 18,A02,083744,Cinel; Cameron Alexander,18,0,30,12
1657933881434,MATH 18,A03,083745,Cinel; Cameron Alexander,10,0,30,20
1657933881434,MATH 18,B01,083748,Rideout; David Porter,5,0,37,32
1657933881434,MATH 18,B02,083749,Rideout; David Porter,5,0,36,31
1657933881434,MATH 18,B03,083750,Rideout; David Porter,3,0,37,34
1657933881434,MATH 18,B04,083751,Rideout; David Porter,7,0,36,29
1657933881434,MATH 18,B05,093473,Rideout; David Porter,7,0,36,29
1657933881434,MATH 18,B06,093474,Rideout; David Porter,6,0,36,30
1657933887460,MATH 20A,A01,083754,Zheng; Zequn,14,0,40,26
1657933893491,MATH 20B,A01,083756,Briones; Jor-el Thomas Caparas,4,0,36,32
1657933893491,MATH 20B,A02,083757,Briones; Jor-el Thomas Caparas,1,0,36,35
1657933893491,MATH 20B,A03,093475,Briones; Jor-el Thomas Caparas,3,0,36,33
1657933899516,MATH 20C,A01,083760,Briones; Jor-el Thomas Caparas,1,0,35,34
1657933899516,MATH 20C,A02,083761,Briones; Jor-el Thomas Caparas,8,0,35,27
1657933899516,MATH 20C,A03,093476,Briones; Jor-el Thomas Caparas,0,1,36,36
1657933899516,MATH 20C,B01,083762,Bach; Quang Tran,1,0,30,29
1657933905544,MATH 20D,A01,083765,Tran; Brian Kha,5,0,30,25
1657933905544,MATH 20D,A02,083766,Tran; Brian Kha,5,0,30,25
1657933905544,MATH 20D,A03,083767,Tran; Brian Kha,6,0,30,24
1657933911568,MATH 20E,A01,083771,Ganguly; Soumya,12,0,32,20
1657933911568,MATH 20E,A02,083772,Ganguly; Soumya,7,0,32,25
1657933911568,MATH 20E,B01,083773,Ciotti; Benjamin,20,0,35,15
1657933911568,MATH 20E,B02,083774,Ciotti; Benjamin,18,0,35,17
1657933917593,MATH 103A,A01,083777,Greenfeld; Be'Eri,3,0,36,33
1657933917593,MATH 103A,A02,083778,Greenfeld; Be'Eri,5,0,36,31
1657933917593,MATH 103A,A03,093561,Greenfeld; Be'Eri,6,0,36,30
1657933917593,MATH 103A,B01,083779,Greenfeld; Be'Eri,8,0,36,28
1657933917593,MATH 103A,B02,083780,Greenfeld; Be'Eri,4,0,36,32
1657933917593,MATH 103A,B03,093562,Greenfeld; Be'Eri,3,0,36,33
1657933923620,MATH 105,A01,085443,Carter; Anne Toulson,15,0,35,20
1657933923620,MATH 105,A02,093477,Carter; Anne Toulson,20,0,35,15
1657933929644,MATH 109,A01,083213,Ganzberger; Geoffrey Michael,3,0,34,31
1657933929644,MATH 109,A02,083214,Ganzberger; Geoffrey Michael,4,0,34,30
1657933929644,MATH 109,A03,093478,Ganzberger; Geoffrey Michael,2,0,34,32
1657933929644,MATH 109,B01,083215,Ganzberger; Geoffrey Michael,2,0,32,30
1657933929644,MATH 109,B02,083216,Ganzberger; Geoffrey Michael,3,0,32,29
1657933929644,MATH 109,B03,093479,Ganzberger; Geoffrey Michael,8,0,32,24
1657933935674,MATH 142A,A01,083219,Chow; Bennett,7,0,32,25
1657933935674,MATH 142A,A02,083220,Chow; Bennett,10,0,32,22
1657933935674,MATH 142A,A03,093480,Chow; Bennett,9,0,32,23
1657933935674,MATH 142A,B03,093481,Chow; Bennett,8,0,32,24
1657933935674,MATH 142A,B04,093558,Chow; Bennett,13,0,32,19
1657933935674,MATH 142A,B05,093559,Chow; Bennett,7,0,32,25
1657933941698,MATH 193A,A01,083224,Rotar; Vladimir,8,0,34,26
1657933941698,MATH 193A,A02,083225,Rotar; Vladimir,10,0,34,24
1657933941698,MATH 193A,A03,083781,Rotar; Vladimir,5,0,34,29
1657933941698,MATH 193A,A04,083782,Rotar; Vladimir,11,0,34,23
1657933941698,MATH 193A,A05,093482,Rotar; Vladimir,11,0,34,23
1657933947725,MATH 197,001,091859,McAuley; Julian John,9999,0,9999,0
1657933947725,MATH 197,002,095566,Kedlaya; Kiran S.,9997,0,9999,2
1657933947725,MATH 197,003,095567,Xiao; Ming,9999,0,9999,0
1657933947725,MATH 197,004,095571,Perols; Johan Lars,9998,0,9999,1
1657933954782,COGS 9,A01,083615,Shannon; Kyle Michael,11,0,75,64
1657933960805,COGS 11,A01,083617,Boyle; Mary E. T.,23,0,48,25
1657933966831,COGS 13,A01,083071,Bastos; Amalia Pinkusfeld,12,0,71,59
1657933972854,COGS 14A,A01,092681,Semenuks; Arturs,5,1,100,95
1657933978889,COGS 14B,A01,083073,Cheng; Tzu-Han,7,0,63,56
1657933984913,COGS 17,A01,092677,Semenuks; Arturs,7,0,81,74
1657933990939,COGS 100,A01,083619,Allen; Michael Gordon,17,0,70,53
1657933996966,COGS 101A,A01,083621,Davis; Joshua Daniel,9,0,68,59
1657934002990,COGS 101B,A01,091572,Allen; Michael Gordon,14,0,65,51
1657934009119,COGS 101C,A01,083625,Delgado; Tania,17,0,35,18
1657934015153,COGS 107A,A01,083627,Boyle; Mary E. T.,14,0,60,46
1657934021177,COGS 118A,A01,083075,Gupta; Anjum,21,0,76,55
1657934027206,CSE 3,A50,083646,Miranda; Gregory Joseph,24,0,50,26
1657934033232,CSE 8A,A50,083650,Miranda; Gregory Joseph,17,1,56,39
1657934039259,CSE 11,A01,083080,Cao; Yingjun,6,15,40,34
1657934045286,CSE 12,A01,083652,Krause-Levy; Sophia Louisa,30,1,120,90
1657934051319,CSE 15L,A01,083654,Morris; Justin Loren,9,0,50,41
1657934051319,CSE 15L,A02,083655,Morris; Justin Loren,10,0,50,40
1657934057347,CSE 20,A01,083657,Tran; Khoa Dang,39,0,80,41
1657934063378,CSE 21,A01,095574,Bach; Quang Tran,23,0,48,25
1657934069403,CSE 30,A01,083084,Eldon; John,7,0,80,73
1657934069403,CSE 30,B01,095061,Bhaskar; Nishant,9,0,50,41
1657934075425,CSE 100,A01,083659,Cao; Yingjun,5,4,70,65
1657934081453,CSE 134B,A01,083661,Powell; Thomas Allan,25,0,100,75
1657934087480,CSE 140,A01,083663,Gungor; Onat,17,0,85,68
1657934093509,CSE 140L,A01,083088,Eldon; John,23,0,100,77
1657934099536,CSE 175,A01,083665,Kumar; Rakesh,3,0,25,22
1657934105570,CSE 190,A00,092507,Dubnov; Shlomo,8,0,20,12
1657934111598,ECE 45,A01,083139,Congero; Spencer William,7,0,75,68
1657934117626,ECE 65,A50,083695,Saad; Andrew S,12,0,30,18
1657934117626,ECE 65,A51,095125,Saad; Andrew S,24,0,26,2
1657934123661,ECE 109,A01,091882,Touri; Behrouz,20,0,70,50
1657934129684,ECE 180,A00,083140,Abi Samra; Nicholas Camill,1,0,30,29
1657934129684,ECE 180,B00,083141,Abi Samra; Nicholas Camill,0,0,30,30
1657934135706,MATH 10A,A01,083735,Patchell; Gregory David,2,0,30,28
1657934135706,MATH 10A,A02,083736,Patchell; Gregory David,20,0,30,10
1657934135706,MATH 10A,A03,083737,Patchell; Gregory David,16,0,30,14
1657934141730,MATH 10B,A01,083207,Lim; Seonhee,9,0,34,25
1657934141730,MATH 10B,A02,083208,Lim; Seonhee,10,0,35,25
1657934141730,MATH 10B,A03,093472,Lim; Seonhee,7,0,34,27
1657934141730,MATH 10B,B01,083739,Sinha; Shubham,14,0,30,16
1657934147761,MATH 18,A01,083743,Cinel; Cameron Alexander,9,0,30,21
1657934147761,MATH 18,A02,083744,Cinel; Cameron Alexander,18,0,30,12
1657934147761,MATH 18,A03,083745,Cinel; Cameron Alexander,10,0,30,20
1657934147761,MATH 18,B01,083748,Rideout; David Porter,5,0,37,32
1657934147761,MATH 18,B02,083749,Rideout; David Porter,5,0,36,31
1657934147761,MATH 18,B03,083750,Rideout; David Porter,3,0,37,34
1657934147761,MATH 18,B04,083751,Rideout; David Porter,7,0,36,29
1657934147761,MATH 18,B05,093473,Rideout; David Porter,7,0,36,29
1657934147761,MATH 18,B06,093474,Rideout; David Porter,6,0,36,30
1657934153789,MATH 20A,A01,083754,Zheng; Zequn,14,0,40,26
1657934159813,MATH 20B,A01,083756,Briones; Jor-el Thomas Caparas,4,0,36,32
1657934159813,MATH 20B,A02,083757,Briones; Jor-el Thomas Caparas,1,0,36,35
1657934159813,MATH 20B,A03,093475,Briones; Jor-el Thomas Caparas,3,0,36,33
1657934165838,MATH 20C,A01,083760,Briones; Jor-el Thomas Caparas,1,0,35,34
1657934165838,MATH 20C,A02,083761,Briones; Jor-el Thomas Caparas,8,0,35,27
1657934165838,MATH 20C,A03,093476,Briones; Jor-el Thomas Caparas,0,1,36,36
1657934165838,MATH 20C,B01,083762,Bach; Quang Tran,1,0,30,29
1657934171862,MATH 20D,A01,083765,Tran; Brian Kha,5,0,30,25
1657934171862,MATH 20D,A02,083766,Tran; Brian Kha,5,0,30,25
1657934171862,MATH 20D,A03,083767,Tran; Brian Kha,6,0,30,24
1657934177898,MATH 20E,A01,083771,Ganguly; Soumya,12,0,32,20
1657934177898,MATH 20E,A02,083772,Ganguly; Soumya,7,0,32,25
1657934177898,MATH 20E,B01,083773,Ciotti; Benjamin,20,0,35,15
1657934177898,MATH 20E,B02,083774,Ciotti; Benjamin,18,0,35,17
1657934183929,MATH 103A,A01,083777,Greenfeld; Be'Eri,3,0,36,33
1657934183929,MATH 103A,A02,083778,Greenfeld; Be'Eri,5,0,36,31
1657934183929,MATH 103A,A03,093561,Greenfeld; Be'Eri,6,0,36,30
1657934183929,MATH 103A,B01,083779,Greenfeld; Be'Eri,8,0,36,28
1657934183929,MATH 103A,B02,083780,Greenfeld; Be'Eri,4,0,36,32
1657934183929,MATH 103A,B03,093562,Greenfeld; Be'Eri,3,0,36,33
1657934189953,MATH 105,A01,085443,Carter; Anne Toulson,15,0,35,20
1657934189953,MATH 105,A02,093477,Carter; Anne Toulson,20,0,35,15
1657934195978,MATH 109,A01,083213,Ganzberger; Geoffrey Michael,3,0,34,31
1657934195978,MATH 109,A02,083214,Ganzberger; Geoffrey Michael,4,0,34,30
1657934195978,MATH 109,A03,093478,Ganzberger; Geoffrey Michael,2,0,34,32
1657934195978,MATH 109,B01,083215,Ganzberger; Geoffrey Michael,2,0,32,30
1657934195978,MATH 109,B02,083216,Ganzberger; Geoffrey Michael,3,0,32,29
1657934195978,MATH 109,B03,093479,Ganzberger; Geoffrey Michael,8,0,32,24
1657934202008,MATH 142A,A01,083219,Chow; Bennett,7,0,32,25
1657934202008,MATH 142A,A02,083220,Chow; Bennett,10,0,32,22
1657934202008,MATH 142A,A03,093480,Chow; Bennett,9,0,32,23
1657934202008,MATH 142A,B03,093481,Chow; Bennett,8,0,32,24
1657934202008,MATH 142A,B04,093558,Chow; Bennett,13,0,32,19
1657934202008,MATH 142A,B05,093559,Chow; Bennett,7,0,32,25
1657934208036,MATH 193A,A01,083224,Rotar; Vladimir,8,0,34,26
1657934208036,MATH 193A,A02,083225,Rotar; Vladimir,10,0,34,24
1657934208036,MATH 193A,A03,083781,Rotar; Vladimir,5,0,34,29
1657934208036,MATH 193A,A04,083782,Rotar; Vladimir,11,0,34,23
1657934208036,MATH 193A,A05,093482,Rotar; Vladimir,11,0,34,23
1657934214064,MATH 197,001,091859,McAuley; Julian John,9999,0,9999,0
1657934214064,MATH 197,002,095566,Kedlaya; Kiran S.,9997,0,9999,2
1657934214064,MATH 197,003,095567,Xiao; Ming,9999,0,9999,0
1657934214064,MATH 197,004,095571,Perols; Johan Lars,9998,0,9999,1
1657934221135,COGS 9,A01,083615,Shannon; Kyle Michael,11,0,75,64
1657934227164,COGS 11,A01,083617,Boyle; Mary E. T.,23,0,48,25
1657934233189,COGS 13,A01,083071,Bastos; Amalia Pinkusfeld,12,0,71,59
1657934239212,COGS 14A,A01,092681,Semenuks; Arturs,5,1,100,95
1657934245236,COGS 14B,A01,083073,Cheng; Tzu-Han,7,0,63,56
1657934251264,COGS 17,A01,092677,Semenuks; Arturs,7,0,81,74
1657934257288,COGS 100,A01,083619,Allen; Michael Gordon,17,0,70,53
1657934263311,COGS 101A,A01,083621,Davis; Joshua Daniel,9,0,68,59
1657934269339,COGS 101B,A01,091572,Allen; Michael Gordon,14,0,65,51
1657934275367,COGS 101C,A01,083625,Delgado; Tania,17,0,35,18
1657934281413,COGS 107A,A01,083627,Boyle; Mary E. T.,14,0,60,46
1657934287437,COGS 118A,A01,083075,Gupta; Anjum,21,0,76,55
1657934293467,CSE 3,A50,083646,Miranda; Gregory Joseph,24,0,50,26
1657934299497,CSE 8A,A50,083650,Miranda; Gregory Joseph,17,1,56,39
1657934305578,CSE 11,A01,083080,Cao; Yingjun,6,15,40,34
1657934311604,CSE 12,A01,083652,Krause-Levy; Sophia Louisa,30,1,120,90
1657934317633,CSE 15L,A01,083654,Morris; Justin Loren,9,0,50,41
1657934317633,CSE 15L,A02,083655,Morris; Justin Loren,10,0,50,40
1657934323661,CSE 20,A01,083657,Tran; Khoa Dang,39,0,80,41
1657934329685,CSE 21,A01,095574,Bach; Quang Tran,23,0,48,25
1657934335710,CSE 30,A01,083084,Eldon; John,7,0,80,73
1657934335710,CSE 30,B01,095061,Bhaskar; Nishant,9,0,50,41
1657934341739,CSE 100,A01,083659,Cao; Yingjun,5,4,70,65
1657934347760,CSE 134B,A01,083661,Powell; Thomas Allan,25,0,100,75
1657934353786,CSE 140,A01,083663,Gungor; Onat,17,0,85,68
1657934359810,CSE 140L,A01,083088,Eldon; John,23,0,100,77
1657934365836,CSE 175,A01,083665,Kumar; Rakesh,3,0,25,22
1657934371860,CSE 190,A00,092507,Dubnov; Shlomo,8,0,20,12
1657934377886,ECE 45,A01,083139,Congero; Spencer William,7,0,75,68
1657934383918,ECE 65,A50,083695,Saad; Andrew S,12,0,30,18
1657934383918,ECE 65,A51,095125,Saad; Andrew S,24,0,26,2
1657934389949,ECE 109,A01,091882,Touri; Behrouz,20,0,70,50
1657934395976,ECE 180,A00,083140,Abi Samra; Nicholas Camill,1,0,30,29
1657934395976,ECE 180,B00,083141,Abi Samra; Nicholas Camill,0,0,30,30
1657934402000,MATH 10A,A01,083735,Patchell; Gregory David,2,0,30,28
1657934402000,MATH 10A,A02,083736,Patchell; Gregory David,20,0,30,10
1657934402000,MATH 10A,A03,083737,Patchell; Gregory David,16,0,30,14
1657934408021,MATH 10B,A01,083207,Lim; Seonhee,9,0,34,25
1657934408021,MATH 10B,A02,083208,Lim; Seonhee,10,0,35,25
1657934408021,MATH 10B,A03,093472,Lim; Seonhee,7,0,34,27
1657934408021,MATH 10B,B01,083739,Sinha; Shubham,14,0,30,16
1657934414061,MATH 18,A01,083743,Cinel; Cameron Alexander,9,0,30,21
1657934414061,MATH 18,A02,083744,Cinel; Cameron Alexander,18,0,30,12
1657934414061,MATH 18,A03,083745,Cinel; Cameron Alexander,10,0,30,20
1657934414061,MATH 18,B01,083748,Rideout; David Porter,5,0,37,32
1657934414061,MATH 18,B02,083749,Rideout; David Porter,5,0,36,31
1657934414061,MATH 18,B03,083750,Rideout; David Porter,3,0,37,34
1657934414061,MATH 18,B04,083751,Rideout; David Porter,7,0,36,29
1657934414061,MATH 18,B05,093473,Rideout; David Porter,7,0,36,29
1657934414061,MATH 18,B06,093474,Rideout; David Porter,6,0,36,30
1657934420087,MATH 20A,A01,083754,Zheng; Zequn,14,0,40,26
1657934426110,MATH 20B,A01,083756,Briones; Jor-el Thomas Caparas,4,0,36,32
1657934426110,MATH 20B,A02,083757,Briones; Jor-el Thomas Caparas,1,0,36,35
1657934426110,MATH 20B,A03,093475,Briones; Jor-el Thomas Caparas,3,0,36,33
1657934432134,MATH 20C,A01,083760,Briones; Jor-el Thomas Caparas,1,0,35,34
1657934432134,MATH 20C,A02,083761,Briones; Jor-el Thomas Caparas,8,0,35,27
1657934432134,MATH 20C,A03,093476,Briones; Jor-el Thomas Caparas,0,1,36,36
1657934432134,MATH 20C,B01,083762,Bach; Quang Tran,1,0,30,29
1657934438171,MATH 20D,A01,083765,Tran; Brian Kha,5,0,30,25
1657934438171,MATH 20D,A02,083766,Tran; Brian Kha,5,0,30,25
1657934438171,MATH 20D,A03,083767,Tran; Brian Kha,6,0,30,24
1657934444204,MATH 20E,A01,083771,Ganguly; Soumya,12,0,32,20
1657934444204,MATH 20E,A02,083772,Ganguly; Soumya,7,0,32,25
1657934444204,MATH 20E,B01,083773,Ciotti; Benjamin,20,0,35,15
1657934444204,MATH 20E,B02,083774,Ciotti; Benjamin,18,0,35,17
1657934450229,MATH 103A,A01,083777,Greenfeld; Be'Eri,3,0,36,33
1657934450229,MATH 103A,A02,083778,Greenfeld; Be'Eri,5,0,36,31
1657934450229,MATH 103A,A03,093561,Greenfeld; Be'Eri,6,0,36,30
1657934450229,MATH 103A,B01,083779,Greenfeld; Be'Eri,8,0,36,28
1657934450229,MATH 103A,B02,083780,Greenfeld; Be'Eri,4,0,36,32
1657934450229,MATH 103A,B03,093562,Greenfeld; Be'Eri,3,0,36,33
1657934456252,MATH 105,A01,085443,Carter; Anne Toulson,15,0,35,20
1657934456252,MATH 105,A02,093477,Carter; Anne Toulson,20,0,35,15
1657934462282,MATH 109,A01,083213,Ganzberger; Geoffrey Michael,3,0,34,31
1657934462282,MATH 109,A02,083214,Ganzberger; Geoffrey Michael,4,0,34,30
1657934462282,MATH 109,A03,093478,Ganzberger; Geoffrey Michael,2,0,34,32
1657934462282,MATH 109,B01,083215,Ganzberger; Geoffrey Michael,2,0,32,30
1657934462282,MATH 109,B02,083216,Ganzberger; Geoffrey Michael,3,0,32,29
1657934462282,MATH 109,B03,093479,Ganzberger; Geoffrey Michael,8,0,32,24
1657934468311,MATH 142A,A01,083219,Chow; Bennett,7,0,32,25
1657934468311,MATH 142A,A02,083220,Chow; Bennett,10,0,32,22
1657934468311,MATH 142A,A03,093480,Chow; Bennett,9,0,32,23
1657934468311,MATH 142A,B03,093481,Chow; Bennett,8,0,32,24
1657934468311,MATH 142A,B04,093558,Chow; Bennett,13,0,32,19
1657934468311,MATH 142A,B05,093559,Chow; Bennett,7,0,32,25
1657934474343,MATH 193A,A01,083224,Rotar; Vladimir,8,0,34,26
1657934474343,MATH 193A,A02,083225,Rotar; Vladimir,10,0,34,24
1657934474343,MATH 193A,A03,083781,Rotar; Vladimir,5,0,34,29
1657934474343,MATH 193A,A04,083782,Rotar; Vladimir,11,0,34,23
1657934474343,MATH 193A,A05,093482,Rotar; Vladimir,11,0,34,23
1657934480372,MATH 197,001,091859,McAuley; Julian John,9999,0,9999,0
1657934480372,MATH 197,002,095566,Kedlaya; Kiran S.,9997,0,9999,2
1657934480372,MATH 197,003,095567,Xiao; Ming,9999,0,9999,0
1657934480372,MATH 197,004,095571,Perols; Johan Lars,9998,0,9999,1
1657934487437,COGS 9,A01,083615,Shannon; Kyle Michael,11,0,75,64
1657934493462,COGS 11,A01,083617,Boyle; Mary E. T.,23,0,48,25
1657934499488,COGS 13,A01,083071,Bastos; Amalia Pinkusfeld,12,0,71,59
1657934505510,COGS 14A,A01,092681,Semenuks; Arturs,5,1,100,95
1657934511534,COGS 14B,A01,083073,Cheng; Tzu-Han,7,0,63,56
1657934517557,COGS 17,A01,092677,Semenuks; Arturs,7,0,81,74
1657934523579,COGS 100,A01,083619,Allen; Michael Gordon,17,0,70,53
1657934529603,COGS 101A,A01,083621,Davis; Joshua Daniel,9,0,68,59
1657934535641,COGS 101B,A01,091572,Allen; Michael Gordon,14,0,65,51
1657934541666,COGS 101C,A01,083625,Delgado; Tania,17,0,35,18
1657934547693,COGS 107A,A01,083627,Boyle; Mary E. T.,14,0,60,46
1657934553723,COGS 118A,A01,083075,Gupta; Anjum,21,0,76,55
1657934559750,CSE 3,A50,083646,Miranda; Gregory Joseph,24,0,50,26
1657934565777,CSE 8A,A50,083650,Miranda; Gregory Joseph,17,1,56,39
1657934571799,CSE 11,A01,083080,Cao; Yingjun,6,15,40,34
1657934577822,CSE 12,A01,083652,Krause-Levy; Sophia Louisa,30,1,120,90
1657934583846,CSE 15L,A01,083654,Morris; Justin Loren,9,0,50,41
1657934583846,CSE 15L,A02,083655,Morris; Justin Loren,10,0,50,40
1657934589869,CSE 20,A01,083657,Tran; Khoa Dang,39,0,80,41
1657934595890,CSE 21,A01,095574,Bach; Quang Tran,23,0,48,25
1657934601915,CSE 30,A01,083084,Eldon; John,7,0,80,73
1657934601915,CSE 30,B01,095061,Bhaskar; Nishant,9,0,50,41
1657934608033,CSE 100,A01,083659,Cao; Yingjun,5,4,70,65
1657934614063,CSE 134B,A01,083661,Powell; Thomas Allan,25,0,100,75
1657934620099,CSE 140,A01,083663,Gungor; Onat,17,0,85,68
1657934626122,CSE 140L,A01,083088,Eldon; John,23,0,100,77
1657934632146,CSE 175,A01,083665,Kumar; Rakesh,3,0,25,22
1657934638170,CSE 190,A00,092507,Dubnov; Shlomo,8,0,20,12
1657934644193,ECE 45,A01,083139,Congero; Spencer William,7,0,75,68
1657934650218,ECE 65,A50,083695,Saad; Andrew S,12,0,30,18
1657934650218,ECE 65,A51,095125,Saad; Andrew S,24,0,26,2
1657934656241,ECE 109,A01,091882,Touri; Behrouz,20,0,70,50
1657934662373,ECE 180,A00,083140,Abi Samra; Nicholas Camill,1,0,30,29
1657934662373,ECE 180,B00,083141,Abi Samra; Nicholas Camill,0,0,30,30
1657934668397,MATH 10A,A01,083735,Patchell; Gregory David,2,0,30,28
1657934668397,MATH 10A,A02,083736,Patchell; Gregory David,20,0,30,10
1657934668397,MATH 10A,A03,083737,Patchell; Gregory David,16,0,30,14
1657934674422,MATH 10B,A01,083207,Lim; Seonhee,9,0,34,25
1657934674422,MATH 10B,A02,083208,Lim; Seonhee,10,0,35,25
1657934674422,MATH 10B,A03,093472,Lim; Seonhee,7,0,34,27
1657934674422,MATH 10B,B01,083739,Sinha; Shubham,14,0,30,16
1657934680446,MATH 18,A01,083743,Cinel; Cameron Alexander,9,0,30,21
1657934680446,MATH 18,A02,083744,Cinel; Cameron Alexander,18,0,30,12
1657934680446,MATH 18,A03,083745,Cinel; Cameron Alexander,10,0,30,20
1657934680446,MATH 18,B01,083748,Rideout; David Porter,5,0,37,32
1657934680446,MATH 18,B02,083749,Rideout; David Porter,5,0,36,31
1657934680446,MATH 18,B03,083750,Rideout; David Porter,3,0,37,34
1657934680446,MATH 18,B04,083751,Rideout; David Porter,7,0,36,29
1657934680446,MATH 18,B05,093473,Rideout; David Porter,7,0,36,29
1657934680446,MATH 18,B06,093474,Rideout; David Porter,6,0,36,30
1657934686472,MATH 20A,A01,083754,Zheng; Zequn,14,0,40,26
1657934692495,MATH 20B,A01,083756,Briones; Jor-el Thomas Caparas,4,0,36,32
1657934692495,MATH 20B,A02,083757,Briones; Jor-el Thomas Caparas,1,0,36,35
1657934692495,MATH 20B,A03,093475,Briones; Jor-el Thomas Caparas,3,0,36,33
1657934698518,MATH 20C,A01,083760,Briones; Jor-el Thomas Caparas,1,0,35,34
1657934698518,MATH 20C,A02,083761,Briones; Jor-el Thomas Caparas,8,0,35,27
1657934698518,MATH 20C,A03,093476,Briones; Jor-el Thomas Caparas,0,1,36,36
1657934698518,MATH 20C,B01,083762,Bach; Quang Tran,1,0,30,29
1657934704541,MATH 20D,A01,083765,Tran; Brian Kha,5,0,30,25
1657934704541,MATH 20D,A02,083766,Tran; Brian Kha,5,0,30,25
1657934704541,MATH 20D,A03,083767,Tran; Brian Kha,6,0,30,24
1657934710571,MATH 20E,A01,083771,Ganguly; Soumya,12,0,32,20
1657934710571,MATH 20E,A02,083772,Ganguly; Soumya,7,0,32,25
1657934710571,MATH 20E,B01,083773,Ciotti; Benjamin,20,0,35,15
1657934710571,MATH 20E,B02,083774,Ciotti; Benjamin,18,0,35,17
1657934716594,MATH 103A,A01,083777,Greenfeld; Be'Eri,3,0,36,33
1657934716594,MATH 103A,A02,083778,Greenfeld; Be'Eri,5,0,36,31
1657934716594,MATH 103A,A03,093561,Greenfeld; Be'Eri,6,0,36,30
1657934716594,MATH 103A,B01,083779,Greenfeld; Be'Eri,8,0,36,28
1657934716594,MATH 103A,B02,083780,Greenfeld; Be'Eri,4,0,36,32
1657934716594,MATH 103A,B03,093562,Greenfeld; Be'Eri,3,0,36,33
1657934722616,MATH 105,A01,085443,Carter; Anne Toulson,15,0,35,20
1657934722616,MATH 105,A02,093477,Carter; Anne Toulson,20,0,35,15
1657934728651,MATH 109,A01,083213,Ganzberger; Geoffrey Michael,3,0,34,31
1657934728651,MATH 109,A02,083214,Ganzberger; Geoffrey Michael,4,0,34,30
1657934728651,MATH 109,A03,093478,Ganzberger; Geoffrey Michael,2,0,34,32
1657934728651,MATH 109,B01,083215,Ganzberger; Geoffrey Michael,2,0,32,30
1657934728651,MATH 109,B02,083216,Ganzberger; Geoffrey Michael,3,0,32,29
1657934728651,MATH 109,B03,093479,Ganzberger; Geoffrey Michael,8,0,32,24
1657934734674,MATH 142A,A01,083219,Chow; Bennett,7,0,32,25
1657934734674,MATH 142A,A02,083220,Chow; Bennett,10,0,32,22
1657934734674,MATH 142A,A03,093480,Chow; Bennett,9,0,32,23
1657934734674,MATH 142A,B03,093481,Chow; Bennett,8,0,32,24
1657934734674,MATH 142A,B04,093558,Chow; Bennett,13,0,32,19
1657934734674,MATH 142A,B05,093559,Chow; Bennett,7,0,32,25
1657934740695,MATH 193A,A01,083224,Rotar; Vladimir,8,0,34,26
1657934740695,MATH 193A,A02,083225,Rotar; Vladimir,10,0,34,24
1657934740695,MATH 193A,A03,083781,Rotar; Vladimir,5,0,34,29
1657934740695,MATH 193A,A04,083782,Rotar; Vladimir,11,0,34,23
1657934740695,MATH 193A,A05,093482,Rotar; Vladimir,11,0,34,23
1657934746717,MATH 197,001,091859,McAuley; Julian John,9999,0,9999,0
1657934746717,MATH 197,002,095566,Kedlaya; Kiran S.,9997,0,9999,2
1657934746717,MATH 197,003,095567,Xiao; Ming,9999,0,9999,0
1657934746717,MATH 197,004,095571,Perols; Johan Lars,9998,0,9999,1
1657934753783,COGS 9,A01,083615,Shannon; Kyle Michael,11,0,75,64
1657934759809,COGS 11,A01,083617,Boyle; Mary E. T.,23,0,48,25
1657934765836,COGS 13,A01,083071,Bastos; Amalia Pinkusfeld,12,0,71,59
1657934771866,COGS 14A,A01,092681,Semenuks; Arturs,5,1,100,95
1657934777892,COGS 14B,A01,083073,Cheng; Tzu-Han,7,0,63,56
1657934783916,COGS 17,A01,092677,Semenuks; Arturs,7,0,81,74
1657934789938,COGS 100,A01,083619,Allen; Michael Gordon,17,0,70,53
1657934795960,COGS 101A,A01,083621,Davis; Joshua Daniel,9,0,68,59
1657934801985,COGS 101B,A01,091572,Allen; Michael Gordon,14,0,65,51
1657934808012,COGS 101C,A01,083625,Delgado; Tania,17,0,35,18
1657934814039,COGS 107A,A01,083627,Boyle; Mary E. T.,14,0,60,46
1657934820062,COGS 118A,A01,083075,Gupta; Anjum,21,0,76,55
1657934826089,CSE 3,A50,083646,Miranda; Gregory Joseph,24,0,50,26
1657934832111,CSE 8A,A50,083650,Miranda; Gregory Joseph,17,1,56,39
1657934838141,CSE 11,A01,083080,Cao; Yingjun,6,15,40,34
1657934844169,CSE 12,A01,083652,Krause-Levy; Sophia Louisa,30,1,120,90
1657934850203,CSE 15L,A01,083654,Morris; Justin Loren,9,0,50,41
1657934850203,CSE 15L,A02,083655,Morris; Justin Loren,10,0,50,40
1657934856225,CSE 20,A01,083657,Tran; Khoa Dang,39,0,80,41
1657934862248,CSE 21,A01,095574,Bach; Quang Tran,23,0,48,25
1657934868274,CSE 30,A01,083084,Eldon; John,7,0,80,73
1657934868274,CSE 30,B01,095061,Bhaskar; Nishant,9,0,50,41
1657934874297,CSE 100,A01,083659,Cao; Yingjun,5,4,70,65
1657934880319,CSE 134B,A01,083661,Powell; Thomas Allan,25,0,100,75
1657934886341,CSE 140,A01,083663,Gungor; Onat,17,0,85,68
1657934892364,CSE 140L,A01,083088,Eldon; John,23,0,100,77
1657934898389,CSE 175,A01,083665,Kumar; Rakesh,3,0,25,22
1657934904417,CSE 190,A00,092507,Dubnov; Shlomo,8,0,20,12
1657934910443,ECE 45,A01,083139,Congero; Spencer William,7,0,75,68
1657934916467,ECE 65,A50,083695,Saad; Andrew S,12,0,30,18
1657934916467,ECE 65,A51,095125,Saad; Andrew S,24,0,26,2
1657934922496,ECE 109,A01,091882,Touri; Behrouz,20,0,70,50
1657934928519,ECE 180,A00,083140,Abi Samra; Nicholas Camill,1,0,30,29
1657934928519,ECE 180,B00,083141,Abi Samra; Nicholas Camill,0,0,30,30
1657934934544,MATH 10A,A01,083735,Patchell; Gregory David,2,0,30,28
1657934934544,MATH 10A,A02,083736,Patchell; Gregory David,20,0,30,10
1657934934544,MATH 10A,A03,083737,Patchell; Gregory David,16,0,30,14
1657934940569,MATH 10B,A01,083207,Lim; Seonhee,9,0,34,25
1657934940569,MATH 10B,A02,083208,Lim; Seonhee,10,0,35,25
1657934940569,MATH 10B,A03,093472,Lim; Seonhee,7,0,34,27
1657934940569,MATH 10B,B01,083739,Sinha; Shubham,14,0,30,16
1657934946602,MATH 18,A01,083743,Cinel; Cameron Alexander,9,0,30,21
1657934946602,MATH 18,A02,083744,Cinel; Cameron Alexander,18,0,30,12
1657934946602,MATH 18,A03,083745,Cinel; Cameron Alexander,10,0,30,20
1657934946602,MATH 18,B01,083748,Rideout; David Porter,5,0,37,32
1657934946602,MATH 18,B02,083749,Rideout; David Porter,5,0,36,31
1657934946602,MATH 18,B03,083750,Rideout; David Porter,3,0,37,34
1657934946602,MATH 18,B04,083751,Rideout; David Porter,7,0,36,29
1657934946602,MATH 18,B05,093473,Rideout; David Porter,7,0,36,29
1657934946602,MATH 18,B06,093474,Rideout; David Porter,6,0,36,30
1657934952637,MATH 20A,A01,083754,Zheng; Zequn,14,0,40,26
1657934958661,MATH 20B,A01,083756,Briones; Jor-el Thomas Caparas,4,0,36,32
1657934958661,MATH 20B,A02,083757,Briones; Jor-el Thomas Caparas,1,0,36,35
1657934958661,MATH 20B,A03,093475,Briones; Jor-el Thomas Caparas,3,0,36,33
1657934964684,MATH 20C,A01,083760,Briones; Jor-el Thomas Caparas,1,0,35,34
1657934964684,MATH 20C,A02,083761,Briones; Jor-el Thomas Caparas,8,0,35,27
1657934964684,MATH 20C,A03,093476,Briones; Jor-el Thomas Caparas,0,1,36,36
1657934964684,MATH 20C,B01,083762,Bach; Quang Tran,1,0,30,29
1657934970714,MATH 20D,A01,083765,Tran; Brian Kha,5,0,30,25
1657934970714,MATH 20D,A02,083766,Tran; Brian Kha,5,0,30,25
1657934970714,MATH 20D,A03,083767,Tran; Brian Kha,6,0,30,24
1657934976743,MATH 20E,A01,083771,Ganguly; Soumya,12,0,32,20
1657934976743,MATH 20E,A02,083772,Ganguly; Soumya,7,0,32,25
1657934976743,MATH 20E,B01,083773,Ciotti; Benjamin,20,0,35,15
1657934976743,MATH 20E,B02,083774,Ciotti; Benjamin,18,0,35,17
1657934982767,MATH 103A,A01,083777,Greenfeld; Be'Eri,3,0,36,33
1657934982767,MATH 103A,A02,083778,Greenfeld; Be'Eri,5,0,36,31
1657934982767,MATH 103A,A03,093561,Greenfeld; Be'Eri,6,0,36,30
1657934982767,MATH 103A,B01,083779,Greenfeld; Be'Eri,8,0,36,28
1657934982767,MATH 103A,B02,083780,Greenfeld; Be'Eri,4,0,36,32
1657934982767,MATH 103A,B03,093562,Greenfeld; Be'Eri,3,0,36,33
1657934988790,MATH 105,A01,085443,Carter; Anne Toulson,15,0,35,20
1657934988790,MATH 105,A02,093477,Carter; Anne Toulson,20,0,35,15
1657934994813,MATH 109,A01,083213,Ganzberger; Geoffrey Michael,3,0,34,31
1657934994813,MATH 109,A02,083214,Ganzberger; Geoffrey Michael,4,0,34,30
1657934994813,MATH 109,A03,093478,Ganzberger; Geoffrey Michael,2,0,34,32
1657934994813,MATH 109,B01,083215,Ganzberger; Geoffrey Michael,2,0,32,30
1657934994813,MATH 109,B02,083216,Ganzberger; Geoffrey Michael,3,0,32,29
1657934994813,MATH 109,B03,093479,Ganzberger; Geoffrey Michael,8,0,32,24
1657935000844,MATH 142A,A01,083219,Chow; Bennett,7,0,32,25
1657935000844,MATH 142A,A02,083220,Chow; Bennett,10,0,32,22
1657935000844,MATH 142A,A03,093480,Chow; Bennett,9,0,32,23
1657935000844,MATH 142A,B03,093481,Chow; Bennett,8,0,32,24
1657935000844,MATH 142A,B04,093558,Chow; Bennett,13,0,32,19
1657935000844,MATH 142A,B05,093559,Chow; Bennett,7,0,32,25
1657935006868,MATH 193A,A01,083224,Rotar; Vladimir,8,0,34,26
1657935006868,MATH 193A,A02,083225,Rotar; Vladimir,10,0,34,24
1657935006868,MATH 193A,A03,083781,Rotar; Vladimir,5,0,34,29
1657935006868,MATH 193A,A04,083782,Rotar; Vladimir,11,0,34,23
1657935006868,MATH 193A,A05,093482,Rotar; Vladimir,11,0,34,23
1657935012894,MATH 197,001,091859,McAuley; Julian John,9999,0,9999,0
1657935012894,MATH 197,002,095566,Kedlaya; Kiran S.,9997,0,9999,2
1657935012894,MATH 197,003,095567,Xiao; Ming,9999,0,9999,0
1657935012894,MATH 197,004,095571,Perols; Johan Lars,9998,0,9999,1
1657935019946,COGS 9,A01,083615,Shannon; Kyle Michael,11,0,75,64
1657935025969,COGS 11,A01,083617,Boyle; Mary E. T.,23,0,48,25
1657935031993,COGS 13,A01,083071,Bastos; Amalia Pinkusfeld,12,0,71,59
1657935038014,COGS 14A,A01,092681,Semenuks; Arturs,5,1,100,95
1657935044038,COGS 14B,A01,083073,Cheng; Tzu-Han,7,0,63,56
1657935050062,COGS 17,A01,092677,Semenuks; Arturs,7,0,81,74
1657935056089,COGS 100,A01,083619,Allen; Michael Gordon,17,0,70,53
1657935062113,COGS 101A,A01,083621,Davis; Joshua Daniel,9,0,68,59
1657935068136,COGS 101B,A01,091572,Allen; Michael Gordon,14,0,65,51
1657935074160,COGS 101C,A01,083625,Delgado; Tania,17,0,35,18
1657935080183,COGS 107A,A01,083627,Boyle; Mary E. T.,14,0,60,46
1657935086210,COGS 118A,A01,083075,Gupta; Anjum,21,0,76,55
1657935092239,CSE 3,A50,083646,Miranda; Gregory Joseph,24,0,50,26
1657935098263,CSE 8A,A50,083650,Miranda; Gregory Joseph,17,1,56,39
1657935104290,CSE 11,A01,083080,Cao; Yingjun,6,15,40,34
1657935110316,CSE 12,A01,083652,Krause-Levy; Sophia Louisa,30,1,120,90
1657935116344,CSE 15L,A01,083654,Morris; Justin Loren,9,0,50,41
1657935116344,CSE 15L,A02,083655,Morris; Justin Loren,10,0,50,40
1657935122369,CSE 20,A01,083657,Tran; Khoa Dang,39,0,80,41
1657935128394,CSE 21,A01,095574,Bach; Quang Tran,23,0,48,25
1657935134422,CSE 30,A01,083084,Eldon; John,7,0,80,73
1657935134422,CSE 30,B01,095061,Bhaskar; Nishant,9,0,50,41
1657935140460,CSE 100,A01,083659,Cao; Yingjun,5,4,70,65
1657935146483,CSE 134B,A01,083661,Powell; Thomas Allan,25,0,100,75
1657935152507,CSE 140,A01,083663,Gungor; Onat,17,0,85,68
1657935158532,CSE 140L,A01,083088,Eldon; John,23,0,100,77
1657935164555,CSE 175,A01,083665,Kumar; Rakesh,3,0,25,22
1657935170583,CSE 190,A00,092507,Dubnov; Shlomo,8,0,20,12
1657935176609,ECE 45,A01,083139,Congero; Spencer William,7,0,75,68
1657935182633,ECE 65,A50,083695,Saad; Andrew S,12,0,30,18
1657935182633,ECE 65,A51,095125,Saad; Andrew S,24,0,26,2
1657935199512,ECE 109,A01,091882,Touri; Behrouz,20,0,70,50
1657935205541,ECE 180,A00,083140,Abi Samra; Nicholas Camill,1,0,30,29
1657935205541,ECE 180,B00,083141,Abi Samra; Nicholas Camill,0,0,30,30
1657935211571,MATH 10A,A01,083735,Patchell; Gregory David,2,0,30,28
1657935211571,MATH 10A,A02,083736,Patchell; Gregory David,20,0,30,10
1657935211571,MATH 10A,A03,083737,Patchell; Gregory David,16,0,30,14
1657935217685,MATH 10B,A01,083207,Lim; Seonhee,9,0,34,25
1657935217685,MATH 10B,A02,083208,Lim; Seonhee,10,0,35,25
1657935217685,MATH 10B,A03,093472,Lim; Seonhee,7,0,34,27
1657935217685,MATH 10B,B01,083739,Sinha; Shubham,14,0,30,16
1657935223709,MATH 18,A01,083743,Cinel; Cameron Alexander,9,0,30,21
1657935223709,MATH 18,A02,083744,Cinel; Cameron Alexander,18,0,30,12
1657935223709,MATH 18,A03,083745,Cinel; Cameron Alexander,10,0,30,20
1657935223709,MATH 18,B01,083748,Rideout; David Porter,5,0,37,32
1657935223709,MATH 18,B02,083749,Rideout; David Porter,5,0,36,31
1657935223709,MATH 18,B03,083750,Rideout; David Porter,3,0,37,34
1657935223709,MATH 18,B04,083751,Rideout; David Porter,7,0,36,29
1657935223709,MATH 18,B05,093473,Rideout; David Porter,7,0,36,29
1657935223709,MATH 18,B06,093474,Rideout; David Porter,6,0,36,30
1657935229734,MATH 20A,A01,083754,Zheng; Zequn,14,0,40,26
1657935235760,MATH 20B,A01,083756,Briones; Jor-el Thomas Caparas,4,0,36,32
1657935235760,MATH 20B,A02,083757,Briones; Jor-el Thomas Caparas,1,0,36,35
1657935235760,MATH 20B,A03,093475,Briones; Jor-el Thomas Caparas,3,0,36,33
1657935241783,MATH 20C,A01,083760,Briones; Jor-el Thomas Caparas,1,0,35,34
1657935241783,MATH 20C,A02,083761,Briones; Jor-el Thomas Caparas,8,0,35,27
1657935241783,MATH 20C,A03,093476,Briones; Jor-el Thomas Caparas,0,1,36,36
1657935241783,MATH 20C,B01,083762,Bach; Quang Tran,1,0,30,29
1657935247813,MATH 20D,A01,083765,Tran; Brian Kha,5,0,30,25
1657935247813,MATH 20D,A02,083766,Tran; Brian Kha,5,0,30,25
1657935247813,MATH 20D,A03,083767,Tran; Brian Kha,6,0,30,24
1657935253837,MATH 20E,A01,083771,Ganguly; Soumya,12,0,32,20
1657935253837,MATH 20E,A02,083772,Ganguly; Soumya,7,0,32,25
1657935253837,MATH 20E,B01,083773,Ciotti; Benjamin,20,0,35,15
1657935253837,MATH 20E,B02,083774,Ciotti; Benjamin,18,0,35,17
1657935259860,MATH 103A,A01,083777,Greenfeld; Be'Eri,3,0,36,33
1657935259860,MATH 103A,A02,083778,Greenfeld; Be'Eri,5,0,36,31
1657935259860,MATH 103A,A03,093561,Greenfeld; Be'Eri,6,0,36,30
1657935259860,MATH 103A,B01,083779,Greenfeld; Be'Eri,8,0,36,28
1657935259860,MATH 103A,B02,083780,Greenfeld; Be'Eri,4,0,36,32
1657935259860,MATH 103A,B03,093562,Greenfeld; Be'Eri,3,0,36,33
1657935265887,MATH 105,A01,085443,Carter; Anne Toulson,15,0,35,20
1657935265887,MATH 105,A02,093477,Carter; Anne Toulson,20,0,35,15
1657935271923,MATH 109,A01,083213,Ganzberger; Geoffrey Michael,3,0,34,31
1657935271923,MATH 109,A02,083214,Ganzberger; Geoffrey Michael,4,0,34,30
1657935271923,MATH 109,A03,093478,Ganzberger; Geoffrey Michael,2,0,34,32
1657935271923,MATH 109,B01,083215,Ganzberger; Geoffrey Michael,2,0,32,30
1657935271923,MATH 109,B02,083216,Ganzberger; Geoffrey Michael,3,0,32,29
1657935271923,MATH 109,B03,093479,Ganzberger; Geoffrey Michael,8,0,32,24
1657935277957,MATH 142A,A01,083219,Chow; Bennett,7,0,32,25
1657935277957,MATH 142A,A02,083220,Chow; Bennett,10,0,32,22
1657935277957,MATH 142A,A03,093480,Chow; Bennett,9,0,32,23
1657935277957,MATH 142A,B03,093481,Chow; Bennett,8,0,32,24
1657935277957,MATH 142A,B04,093558,Chow; Bennett,13,0,32,19
1657935277957,MATH 142A,B05,093559,Chow; Bennett,7,0,32,25
1657935283981,MATH 193A,A01,083224,Rotar; Vladimir,8,0,34,26
1657935283981,MATH 193A,A02,083225,Rotar; Vladimir,10,0,34,24
1657935283981,MATH 193A,A03,083781,Rotar; Vladimir,5,0,34,29
1657935283981,MATH 193A,A04,083782,Rotar; Vladimir,11,0,34,23
1657935283981,MATH 193A,A05,093482,Rotar; Vladimir,11,0,34,23
1657935290004,MATH 197,001,091859,McAuley; Julian John,9999,0,9999,0
1657935290004,MATH 197,002,095566,Kedlaya; Kiran S.,9997,0,9999,2
1657935290004,MATH 197,003,095567,Xiao; Ming,9999,0,9999,0
1657935290004,MATH 197,004,095571,Perols; Johan Lars,9998,0,9999,1
1657935297058,COGS 9,A01,083615,Shannon; Kyle Michael,11,0,75,64
1657935303089,COGS 11,A01,083617,Boyle; Mary E. T.,23,0,48,25
1657935309115,COGS 13,A01,083071,Bastos; Amalia Pinkusfeld,12,0,71,59
1657935315146,COGS 14A,A01,092681,Semenuks; Arturs,5,1,100,95
1657935321169,COGS 14B,A01,083073,Cheng; Tzu-Han,7,0,63,56
1657935327192,COGS 17,A01,092677,Semenuks; Arturs,7,0,81,74
1657935333217,COGS 100,A01,083619,Allen; Michael Gordon,17,0,70,53
1657935339242,COGS 101A,A01,083621,Davis; Joshua Daniel,9,0,68,59
1657935345268,COGS 101B,A01,091572,Allen; Michael Gordon,14,0,65,51
1657935351291,COGS 101C,A01,083625,Delgado; Tania,17,0,35,18
1657935357316,COGS 107A,A01,083627,Boyle; Mary E. T.,14,0,60,46
1657935363340,COGS 118A,A01,083075,Gupta; Anjum,21,0,76,55
1657935369362,CSE 3,A50,083646,Miranda; Gregory Joseph,24,0,50,26
1657935375389,CSE 8A,A50,083650,Miranda; Gregory Joseph,17,1,56,39
1657935381415,CSE 11,A01,083080,Cao; Yingjun,6,15,40,34
1657935387441,CSE 12,A01,083652,Krause-Levy; Sophia Louisa,30,1,120,90
1657935393463,CSE 15L,A01,083654,Morris; Justin Loren,9,0,50,41
1657935393463,CSE 15L,A02,083655,Morris; Justin Loren,10,0,50,40
1657935399490,CSE 20,A01,083657,Tran; Khoa Dang,39,0,80,41
1657935405518,CSE 21,A01,095574,Bach; Quang Tran,23,0,48,25
1657935411540,CSE 30,A01,083084,Eldon; John,7,0,80,73
1657935411540,CSE 30,B01,095061,Bhaskar; Nishant,9,0,50,41
1657935417563,CSE 100,A01,083659,Cao; Yingjun,5,4,70,65
1657935423586,CSE 134B,A01,083661,Powell; Thomas Allan,25,0,100,75
1657935429610,CSE 140,A01,083663,Gungor; Onat,17,0,85,68
1657935435641,CSE 140L,A01,083088,Eldon; John,23,0,100,77
1657935441663,CSE 175,A01,083665,Kumar; Rakesh,3,0,25,22
1657935447687,CSE 190,A00,092507,Dubnov; Shlomo,8,0,20,12
1657935453714,ECE 45,A01,083139,Congero; Spencer William,7,0,75,68
1657935459736,ECE 65,A50,083695,Saad; Andrew S,12,0,30,18
1657935459736,ECE 65,A51,095125,Saad; Andrew S,24,0,26,2
1657935465760,ECE 109,A01,091882,Touri; Behrouz,20,0,70,50
1657935471786,ECE 180,A00,083140,Abi Samra; Nicholas Camill,1,0,30,29
1657935471786,ECE 180,B00,083141,Abi Samra; Nicholas Camill,0,0,30,30
1657935477813,MATH 10A,A01,083735,Patchell; Gregory David,2,0,30,28
1657935477813,MATH 10A,A02,083736,Patchell; Gregory David,20,0,30,10
1657935477813,MATH 10A,A03,083737,Patchell; Gregory David,16,0,30,14
1657935483837,MATH 10B,A01,083207,Lim; Seonhee,9,0,34,25
1657935483837,MATH 10B,A02,083208,Lim; Seonhee,10,0,35,25
1657935483837,MATH 10B,A03,093472,Lim; Seonhee,7,0,34,27
1657935483837,MATH 10B,B01,083739,Sinha; Shubham,14,0,30,16
1657935489859,MATH 18,A01,083743,Cinel; Cameron Alexander,9,0,30,21
1657935489859,MATH 18,A02,083744,Cinel; Cameron Alexander,18,0,30,12
1657935489859,MATH 18,A03,083745,Cinel; Cameron Alexander,10,0,30,20
1657935489859,MATH 18,B01,083748,Rideout; David Porter,5,0,37,32
1657935489859,MATH 18,B02,083749,Rideout; David Porter,5,0,36,31
1657935489859,MATH 18,B03,083750,Rideout; David Porter,3,0,37,34
1657935489859,MATH 18,B04,083751,Rideout; David Porter,7,0,36,29
1657935489859,MATH 18,B05,093473,Rideout; David Porter,7,0,36,29
1657935489859,MATH 18,B06,093474,Rideout; David Porter,6,0,36,30
1657935495885,MATH 20A,A01,083754,Zheng; Zequn,14,0,40,26
1657935501912,MATH 20B,A01,083756,Briones; Jor-el Thomas Caparas,4,0,36,32
1657935501912,MATH 20B,A02,083757,Briones; Jor-el Thomas Caparas,1,0,36,35
1657935501912,MATH 20B,A03,093475,Briones; Jor-el Thomas Caparas,3,0,36,33
1657935507936,MATH 20C,A01,083760,Briones; Jor-el Thomas Caparas,1,0,35,34
1657935507936,MATH 20C,A02,083761,Briones; Jor-el Thomas Caparas,8,0,35,27
1657935507936,MATH 20C,A03,093476,Briones; Jor-el Thomas Caparas,0,1,36,36
1657935507936,MATH 20C,B01,083762,Bach; Quang Tran,1,0,30,29
1657935513960,MATH 20D,A01,083765,Tran; Brian Kha,5,0,30,25
1657935513960,MATH 20D,A02,083766,Tran; Brian Kha,5,0,30,25
1657935513960,MATH 20D,A03,083767,Tran; Brian Kha,6,0,30,24
1657935519984,MATH 20E,A01,083771,Ganguly; Soumya,12,0,32,20
1657935519984,MATH 20E,A02,083772,Ganguly; Soumya,7,0,32,25
1657935519984,MATH 20E,B01,083773,Ciotti; Benjamin,20,0,35,15
1657935519984,MATH 20E,B02,083774,Ciotti; Benjamin,18,0,35,17
1657935526007,MATH 103A,A01,083777,Greenfeld; Be'Eri,3,0,36,33
1657935526007,MATH 103A,A02,083778,Greenfeld; Be'Eri,5,0,36,31
1657935526007,MATH 103A,A03,093561,Greenfeld; Be'Eri,6,0,36,30
1657935526007,MATH 103A,B01,083779,Greenfeld; Be'Eri,8,0,36,28
1657935526007,MATH 103A,B02,083780,Greenfeld; Be'Eri,4,0,36,32
1657935526007,MATH 103A,B03,093562,Greenfeld; Be'Eri,3,0,36,33
1657935532034,MATH 105,A01,085443,Carter; Anne Toulson,15,0,35,20
1657935532034,MATH 105,A02,093477,Carter; Anne Toulson,20,0,35,15
1657935538057,MATH 109,A01,083213,Ganzberger; Geoffrey Michael,3,0,34,31
1657935538057,MATH 109,A02,083214,Ganzberger; Geoffrey Michael,4,0,34,30
1657935538057,MATH 109,A03,093478,Ganzberger; Geoffrey Michael,2,0,34,32
1657935538057,MATH 109,B01,083215,Ganzberger; Geoffrey Michael,2,0,32,30
1657935538057,MATH 109,B02,083216,Ganzberger; Geoffrey Michael,3,0,32,29
1657935538057,MATH 109,B03,093479,Ganzberger; Geoffrey Michael,8,0,32,24
1657935544086,MATH 142A,A01,083219,Chow; Bennett,7,0,32,25
1657935544086,MATH 142A,A02,083220,Chow; Bennett,10,0,32,22
1657935544086,MATH 142A,A03,093480,Chow; Bennett,9,0,32,23
1657935544086,MATH 142A,B03,093481,Chow; Bennett,8,0,32,24
1657935544086,MATH 142A,B04,093558,Chow; Bennett,13,0,32,19
1657935544086,MATH 142A,B05,093559,Chow; Bennett,7,0,32,25
1657935550113,MATH 193A,A01,083224,Rotar; Vladimir,8,0,34,26
1657935550113,MATH 193A,A02,083225,Rotar; Vladimir,10,0,34,24
1657935550113,MATH 193A,A03,083781,Rotar; Vladimir,5,0,34,29
1657935550113,MATH 193A,A04,083782,Rotar; Vladimir,11,0,34,23
1657935550113,MATH 193A,A05,093482,Rotar; Vladimir,11,0,34,23
1657935556140,MATH 197,001,091859,McAuley; Julian John,9999,0,9999,0
1657935556140,MATH 197,002,095566,Kedlaya; Kiran S.,9997,0,9999,2
1657935556140,MATH 197,003,095567,Xiao; Ming,9999,0,9999,0
1657935556140,MATH 197,004,095571,Perols; Johan Lars,9998,0,9999,1
1657935563204,COGS 9,A01,083615,Shannon; Kyle Michael,11,0,75,64
1657935569231,COGS 11,A01,083617,Boyle; Mary E. T.,23,0,48,25
1657935575257,COGS 13,A01,083071,Bastos; Amalia Pinkusfeld,12,0,71,59
1657935581281,COGS 14A,A01,092681,Semenuks; Arturs,5,1,100,95
1657935587306,COGS 14B,A01,083073,Cheng; Tzu-Han,7,0,63,56
1657935593333,COGS 17,A01,092677,Semenuks; Arturs,7,0,81,74
1657935599358,COGS 100,A01,083619,Allen; Michael Gordon,17,0,70,53
1657935605381,COGS 101A,A01,083621,Davis; Joshua Daniel,9,0,68,59
1657935611406,COGS 101B,A01,091572,Allen; Michael Gordon,14,0,65,51
1657935617430,COGS 101C,A01,083625,Delgado; Tania,17,0,35,18
1657935623453,COGS 107A,A01,083627,Boyle; Mary E. T.,14,0,60,46
1657935629478,COGS 118A,A01,083075,Gupta; Anjum,21,0,76,55
1657935635502,CSE 3,A50,083646,Miranda; Gregory Joseph,24,0,50,26
1657935641526,CSE 8A,A50,083650,Miranda; Gregory Joseph,17,1,56,39
1657935647549,CSE 11,A01,083080,Cao; Yingjun,6,15,40,34
1657935653573,CSE 12,A01,083652,Krause-Levy; Sophia Louisa,30,1,120,90
1657935659600,CSE 15L,A01,083654,Morris; Justin Loren,9,0,50,41
1657935659600,CSE 15L,A02,083655,Morris; Justin Loren,10,0,50,40
1657935665622,CSE 20,A01,083657,Tran; Khoa Dang,39,0,80,41
1657935671645,CSE 21,A01,095574,Bach; Quang Tran,23,0,48,25
1657935677669,CSE 30,A01,083084,Eldon; John,7,0,80,73
1657935677669,CSE 30,B01,095061,Bhaskar; Nishant,9,0,50,41
1657935683695,CSE 100,A01,083659,Cao; Yingjun,5,4,70,65
1657935689719,CSE 134B,A01,083661,Powell; Thomas Allan,25,0,100,75
1657935695742,CSE 140,A01,083663,Gungor; Onat,17,0,85,68
1657935701768,CSE 140L,A01,083088,Eldon; John,23,0,100,77
1657935707792,CSE 175,A01,083665,Kumar; Rakesh,3,0,25,22
1657935713826,CSE 190,A00,092507,Dubnov; Shlomo,8,0,20,12
1657935719854,ECE 45,A01,083139,Congero; Spencer William,7,0,75,68
1657935725878,ECE 65,A50,083695,Saad; Andrew S,12,0,30,18
1657935725878,ECE 65,A51,095125,Saad; Andrew S,24,0,26,2
1657935731901,ECE 109,A01,091882,Touri; Behrouz,20,0,70,50
1657935737923,ECE 180,A00,083140,Abi Samra; Nicholas Camill,1,0,30,29
1657935737923,ECE 180,B00,083141,Abi Samra; Nicholas Camill,0,0,30,30
1657935743946,MATH 10A,A01,083735,Patchell; Gregory David,2,0,30,28
1657935743946,MATH 10A,A02,083736,Patchell; Gregory David,20,0,30,10
1657935743946,MATH 10A,A03,083737,Patchell; Gregory David,16,0,30,14
1657935749972,MATH 10B,A01,083207,Lim; Seonhee,9,0,34,25
1657935749972,MATH 10B,A02,083208,Lim; Seonhee,10,0,35,25
1657935749972,MATH 10B,A03,093472,Lim; Seonhee,7,0,34,27
1657935749972,MATH 10B,B01,083739,Sinha; Shubham,14,0,30,16
1657935756004,MATH 18,A01,083743,Cinel; Cameron Alexander,9,0,30,21
1657935756004,MATH 18,A02,083744,Cinel; Cameron Alexander,18,0,30,12
1657935756004,MATH 18,A03,083745,Cinel; Cameron Alexander,10,0,30,20
1657935756004,MATH 18,B01,083748,Rideout; David Porter,5,0,37,32
1657935756004,MATH 18,B02,083749,Rideout; David Porter,5,0,36,31
1657935756004,MATH 18,B03,083750,Rideout; David Porter,3,0,37,34
1657935756004,MATH 18,B04,083751,Rideout; David Porter,7,0,36,29
1657935756004,MATH 18,B05,093473,Rideout; David Porter,7,0,36,29
1657935756004,MATH 18,B06,093474,Rideout; David Porter,6,0,36,30
1657935762028,MATH 20A,A01,083754,Zheng; Zequn,14,0,40,26
1657935768053,MATH 20B,A01,083756,Briones; Jor-el Thomas Caparas,4,0,36,32
1657935768053,MATH 20B,A02,083757,Briones; Jor-el Thomas Caparas,1,0,36,35
1657935768053,MATH 20B,A03,093475,Briones; Jor-el Thomas Caparas,3,0,36,33
1657935774082,MATH 20C,A01,083760,Briones; Jor-el Thomas Caparas,1,0,35,34
1657935774082,MATH 20C,A02,083761,Briones; Jor-el Thomas Caparas,8,0,35,27
1657935774082,MATH 20C,A03,093476,Briones; Jor-el Thomas Caparas,0,1,36,36
1657935774082,MATH 20C,B01,083762,Bach; Quang Tran,1,0,30,29
1657935780112,MATH 20D,A01,083765,Tran; Brian Kha,5,0,30,25
1657935780112,MATH 20D,A02,083766,Tran; Brian Kha,5,0,30,25
1657935780112,MATH 20D,A03,083767,Tran; Brian Kha,6,0,30,24
1657935786134,MATH 20E,A01,083771,Ganguly; Soumya,12,0,32,20
1657935786134,MATH 20E,A02,083772,Ganguly; Soumya,7,0,32,25
1657935786134,MATH 20E,B01,083773,Ciotti; Benjamin,20,0,35,15
1657935786134,MATH 20E,B02,083774,Ciotti; Benjamin,18,0,35,17
1657935792179,MATH 103A,A01,083777,Greenfeld; Be'Eri,3,0,36,33
1657935792179,MATH 103A,A02,083778,Greenfeld; Be'Eri,5,0,36,31
1657935792179,MATH 103A,A03,093561,Greenfeld; Be'Eri,6,0,36,30
1657935792179,MATH 103A,B01,083779,Greenfeld; Be'Eri,8,0,36,28
1657935792179,MATH 103A,B02,083780,Greenfeld; Be'Eri,4,0,36,32
1657935792179,MATH 103A,B03,093562,Greenfeld; Be'Eri,3,0,36,33
1657935798213,MATH 105,A01,085443,Carter; Anne Toulson,15,0,35,20
1657935798213,MATH 105,A02,093477,Carter; Anne Toulson,20,0,35,15
1657935804236,MATH 109,A01,083213,Ganzberger; Geoffrey Michael,3,0,34,31
1657935804236,MATH 109,A02,083214,Ganzberger; Geoffrey Michael,4,0,34,30
1657935804236,MATH 109,A03,093478,Ganzberger; Geoffrey Michael,2,0,34,32
1657935804236,MATH 109,B01,083215,Ganzberger; Geoffrey Michael,2,0,32,30
1657935804236,MATH 109,B02,083216,Ganzberger; Geoffrey Michael,3,0,32,29
1657935804236,MATH 109,B03,093479,Ganzberger; Geoffrey Michael,8,0,32,24
1657935810260,MATH 142A,A01,083219,Chow; Bennett,7,0,32,25
1657935810260,MATH 142A,A02,083220,Chow; Bennett,10,0,32,22
1657935810260,MATH 142A,A03,093480,Chow; Bennett,9,0,32,23
1657935810260,MATH 142A,B03,093481,Chow; Bennett,8,0,32,24
1657935810260,MATH 142A,B04,093558,Chow; Bennett,13,0,32,19
1657935810260,MATH 142A,B05,093559,Chow; Bennett,7,0,32,25
1657935816378,MATH 193A,A01,083224,Rotar; Vladimir,8,0,34,26
1657935816378,MATH 193A,A02,083225,Rotar; Vladimir,10,0,34,24
1657935816378,MATH 193A,A03,083781,Rotar; Vladimir,5,0,34,29
1657935816378,MATH 193A,A04,083782,Rotar; Vladimir,11,0,34,23
1657935816378,MATH 193A,A05,093482,Rotar; Vladimir,11,0,34,23
1657935822401,MATH 197,001,091859,McAuley; Julian John,9999,0,9999,0
1657935822401,MATH 197,002,095566,Kedlaya; Kiran S.,9997,0,9999,2
1657935822401,MATH 197,003,095567,Xiao; Ming,9999,0,9999,0
1657935822401,MATH 197,004,095571,Perols; Johan Lars,9998,0,9999,1
1657935829452,COGS 9,A01,083615,Shannon; Kyle Michael,11,0,75,64
1657935835474,COGS 11,A01,083617,Boyle; Mary E. T.,23,0,48,25
1657935841502,COGS 13,A01,083071,Bastos; Amalia Pinkusfeld,12,0,71,59
1657935847529,COGS 14A,A01,092681,Semenuks; Arturs,5,1,100,95
1657935853553,COGS 14B,A01,083073,Cheng; Tzu-Han,7,0,63,56
1657935859575,COGS 17,A01,092677,Semenuks; Arturs,7,0,81,74
1657935865605,COGS 100,A01,083619,Allen; Michael Gordon,17,0,70,53
1657935871631,COGS 101A,A01,083621,Davis; Joshua Daniel,9,0,68,59
1657935877652,COGS 101B,A01,091572,Allen; Michael Gordon,14,0,65,51
1657935883679,COGS 101C,A01,083625,Delgado; Tania,17,0,35,18
1657935889701,COGS 107A,A01,083627,Boyle; Mary E. T.,14,0,60,46
1657935895722,COGS 118A,A01,083075,Gupta; Anjum,21,0,76,55
1657935901752,CSE 3,A50,083646,Miranda; Gregory Joseph,24,0,50,26
1657935907786,CSE 8A,A50,083650,Miranda; Gregory Joseph,17,1,56,39
1657935913809,CSE 11,A01,083080,Cao; Yingjun,6,15,40,34
1657935919833,CSE 12,A01,083652,Krause-Levy; Sophia Louisa,30,1,120,90
1657935925864,CSE 15L,A01,083654,Morris; Justin Loren,9,0,50,41
1657935925864,CSE 15L,A02,083655,Morris; Justin Loren,10,0,50,40
1657935931889,CSE 20,A01,083657,Tran; Khoa Dang,39,0,80,41
1657935937911,CSE 21,A01,095574,Bach; Quang Tran,23,0,48,25
1657935943934,CSE 30,A01,083084,Eldon; John,7,0,80,73
1657935943934,CSE 30,B01,095061,Bhaskar; Nishant,9,0,50,41
1657935949961,CSE 100,A01,083659,Cao; Yingjun,5,4,70,65
1657935955993,CSE 134B,A01,083661,Powell; Thomas Allan,25,0,100,75
1657935962019,CSE 140,A01,083663,Gungor; Onat,17,0,85,68
1657935968043,CSE 140L,A01,083088,Eldon; John,23,0,100,77
1657935974065,CSE 175,A01,083665,Kumar; Rakesh,3,0,25,22
1657935980092,CSE 190,A00,092507,Dubnov; Shlomo,8,0,20,12
1657935986115,ECE 45,A01,083139,Congero; Spencer William,7,0,75,68
1657935992142,ECE 65,A50,083695,Saad; Andrew S,12,0,30,18
1657935992142,ECE 65,A51,095125,Saad; Andrew S,24,0,26,2
1657935998170,ECE 109,A01,091882,Touri; Behrouz,20,0,70,50
1657936004198,ECE 180,A00,083140,Abi Samra; Nicholas Camill,1,0,30,29
1657936004198,ECE 180,B00,083141,Abi Samra; Nicholas Camill,0,0,30,30
1657936010220,MATH 10A,A01,083735,Patchell; Gregory David,2,0,30,28
1657936010220,MATH 10A,A02,083736,Patchell; Gregory David,20,0,30,10
1657936010220,MATH 10A,A03,083737,Patchell; Gregory David,16,0,30,14
1657936016244,MATH 10B,A01,083207,Lim; Seonhee,9,0,34,25
1657936016244,MATH 10B,A02,083208,Lim; Seonhee,10,0,35,25
1657936016244,MATH 10B,A03,093472,Lim; Seonhee,7,0,34,27
1657936016244,MATH 10B,B01,083739,Sinha; Shubham,14,0,30,16
1657936022269,MATH 18,A01,083743,Cinel; Cameron Alexander,9,0,30,21
1657936022269,MATH 18,A02,083744,Cinel; Cameron Alexander,18,0,30,12
1657936022269,MATH 18,A03,083745,Cinel; Cameron Alexander,10,0,30,20
1657936022269,MATH 18,B01,083748,Rideout; David Porter,5,0,37,32
1657936022269,MATH 18,B02,083749,Rideout; David Porter,5,0,36,31
1657936022269,MATH 18,B03,083750,Rideout; David Porter,3,0,37,34
1657936022269,MATH 18,B04,083751,Rideout; David Porter,7,0,36,29
1657936022269,MATH 18,B05,093473,Rideout; David Porter,7,0,36,29
1657936022269,MATH 18,B06,093474,Rideout; David Porter,6,0,36,30
1657936028299,MATH 20A,A01,083754,Zheng; Zequn,14,0,40,26
1657936034324,MATH 20B,A01,083756,Briones; Jor-el Thomas Caparas,4,0,36,32
1657936034324,MATH 20B,A02,083757,Briones; Jor-el Thomas Caparas,1,0,36,35
1657936034324,MATH 20B,A03,093475,Briones; Jor-el Thomas Caparas,3,0,36,33
1657936040348,MATH 20C,A01,083760,Briones; Jor-el Thomas Caparas,1,0,35,34
1657936040348,MATH 20C,A02,083761,Briones; Jor-el Thomas Caparas,8,0,35,27
1657936040348,MATH 20C,A03,093476,Briones; Jor-el Thomas Caparas,0,1,36,36
1657936040348,MATH 20C,B01,083762,Bach; Quang Tran,1,0,30,29
1657936046376,MATH 20D,A01,083765,Tran; Brian Kha,5,0,30,25
1657936046376,MATH 20D,A02,083766,Tran; Brian Kha,5,0,30,25
1657936046376,MATH 20D,A03,083767,Tran; Brian Kha,6,0,30,24
1657936052400,MATH 20E,A01,083771,Ganguly; Soumya,12,0,32,20
1657936052400,MATH 20E,A02,083772,Ganguly; Soumya,7,0,32,25
1657936052400,MATH 20E,B01,083773,Ciotti; Benjamin,20,0,35,15
1657936052400,MATH 20E,B02,083774,Ciotti; Benjamin,18,0,35,17
1657936058424,MATH 103A,A01,083777,Greenfeld; Be'Eri,3,0,36,33
1657936058424,MATH 103A,A02,083778,Greenfeld; Be'Eri,5,0,36,31
1657936058424,MATH 103A,A03,093561,Greenfeld; Be'Eri,6,0,36,30
1657936058424,MATH 103A,B01,083779,Greenfeld; Be'Eri,8,0,36,28
1657936058424,MATH 103A,B02,083780,Greenfeld; Be'Eri,4,0,36,32
1657936058424,MATH 103A,B03,093562,Greenfeld; Be'Eri,3,0,36,33
1657936064447,MATH 105,A01,085443,Carter; Anne Toulson,15,0,35,20
1657936064447,MATH 105,A02,093477,Carter; Anne Toulson,20,0,35,15
1657936070476,MATH 109,A01,083213,Ganzberger; Geoffrey Michael,3,0,34,31
1657936070476,MATH 109,A02,083214,Ganzberger; Geoffrey Michael,4,0,34,30
1657936070476,MATH 109,A03,093478,Ganzberger; Geoffrey Michael,2,0,34,32
1657936070476,MATH 109,B01,083215,Ganzberger; Geoffrey Michael,2,0,32,30
1657936070476,MATH 109,B02,083216,Ganzberger; Geoffrey Michael,3,0,32,29
1657936070476,MATH 109,B03,093479,Ganzberger; Geoffrey Michael,8,0,32,24
1657936076504,MATH 142A,A01,083219,Chow; Bennett,7,0,32,25
1657936076504,MATH 142A,A02,083220,Chow; Bennett,10,0,32,22
1657936076504,MATH 142A,A03,093480,Chow; Bennett,9,0,32,23
1657936076504,MATH 142A,B03,093481,Chow; Bennett,8,0,32,24
1657936076504,MATH 142A,B04,093558,Chow; Bennett,13,0,32,19
1657936076504,MATH 142A,B05,093559,Chow; Bennett,7,0,32,25
1657936082529,MATH 193A,A01,083224,Rotar; Vladimir,8,0,34,26
1657936082529,MATH 193A,A02,083225,Rotar; Vladimir,10,0,34,24
1657936082529,MATH 193A,A03,083781,Rotar; Vladimir,5,0,34,29
1657936082529,MATH 193A,A04,083782,Rotar; Vladimir,11,0,34,23
1657936082529,MATH 193A,A05,093482,Rotar; Vladimir,11,0,34,23
1657936088559,MATH 197,001,091859,McAuley; Julian John,9999,0,9999,0
1657936088559,MATH 197,002,095566,Kedlaya; Kiran S.,9997,0,9999,2
1657936088559,MATH 197,003,095567,Xiao; Ming,9999,0,9999,0
1657936088559,MATH 197,004,095571,Perols; Johan Lars,9998,0,9999,1
1657936095610,COGS 9,A01,083615,Shannon; Kyle Michael,11,0,75,64
1657936101635,COGS 11,A01,083617,Boyle; Mary E. T.,23,0,48,25
1657936107662,COGS 13,A01,083071,Bastos; Amalia Pinkusfeld,12,0,71,59
1657936113697,COGS 14A,A01,092681,Semenuks; Arturs,5,1,100,95
1657936119725,COGS 14B,A01,083073,Cheng; Tzu-Han,7,0,63,56
1657936125752,COGS 17,A01,092677,Semenuks; Arturs,7,0,81,74
1657936131784,COGS 100,A01,083619,Allen; Michael Gordon,17,0,70,53
1657936137808,COGS 101A,A01,083621,Davis; Joshua Daniel,9,0,68,59
1657936143830,COGS 101B,A01,091572,Allen; Michael Gordon,14,0,65,51
1657936149852,COGS 101C,A01,083625,Delgado; Tania,17,0,35,18
1657936155875,COGS 107A,A01,083627,Boyle; Mary E. T.,14,0,60,46
1657936161902,COGS 118A,A01,083075,Gupta; Anjum,21,0,76,55
1657936167940,CSE 3,A50,083646,Miranda; Gregory Joseph,24,0,50,26
1657936173964,CSE 8A,A50,083650,Miranda; Gregory Joseph,17,1,56,39
1657936179990,CSE 11,A01,083080,Cao; Yingjun,6,15,40,34
1657936186018,CSE 12,A01,083652,Krause-Levy; Sophia Louisa,30,1,120,90
1657936192044,CSE 15L,A01,083654,Morris; Justin Loren,9,0,50,41
1657936192044,CSE 15L,A02,083655,Morris; Justin Loren,10,0,50,40
1657936198065,CSE 20,A01,083657,Tran; Khoa Dang,39,0,80,41
1657936204094,CSE 21,A01,095574,Bach; Quang Tran,23,0,48,25
1657936210121,CSE 30,A01,083084,Eldon; John,7,0,80,73
1657936210121,CSE 30,B01,095061,Bhaskar; Nishant,9,0,50,41
1657936216143,CSE 100,A01,083659,Cao; Yingjun,5,4,70,65
1657936222180,CSE 134B,A01,083661,Powell; Thomas Allan,25,0,100,75
1657936228208,CSE 140,A01,083663,Gungor; Onat,17,0,85,68
1657936234233,CSE 140L,A01,083088,Eldon; John,23,0,100,77
1657936240259,CSE 175,A01,083665,Kumar; Rakesh,3,0,25,22
1657936246285,CSE 190,A00,092507,Dubnov; Shlomo,8,0,20,12
1657936252308,ECE 45,A01,083139,Congero; Spencer William,7,0,75,68
1657936258334,ECE 65,A50,083695,Saad; Andrew S,12,0,30,18
1657936258334,ECE 65,A51,095125,Saad; Andrew S,24,0,26,2
1657936264359,ECE 109,A01,091882,Touri; Behrouz,20,0,70,50
1657936270387,ECE 180,A00,083140,Abi Samra; Nicholas Camill,1,0,30,29
1657936270387,ECE 180,B00,083141,Abi Samra; Nicholas Camill,0,0,30,30
1657936276410,MATH 10A,A01,083735,Patchell; Gregory David,2,0,30,28
1657936276410,MATH 10A,A02,083736,Patchell; Gregory David,20,0,30,10
1657936276410,MATH 10A,A03,083737,Patchell; Gregory David,16,0,30,14
1657936282434,MATH 10B,A01,083207,Lim; Seonhee,9,0,34,25
1657936282434,MATH 10B,A02,083208,Lim; Seonhee,10,0,35,25
1657936282434,MATH 10B,A03,093472,Lim; Seonhee,7,0,34,27
1657936282434,MATH 10B,B01,083739,Sinha; Shubham,14,0,30,16
1657936288465,MATH 18,A01,083743,Cinel; Cameron Alexander,9,0,30,21
1657936288465,MATH 18,A02,083744,Cinel; Cameron Alexander,18,0,30,12
1657936288465,MATH 18,A03,083745,Cinel; Cameron Alexander,10,0,30,20
1657936288465,MATH 18,B01,083748,Rideout; David Porter,5,0,37,32
1657936288465,MATH 18,B02,083749,Rideout; David Porter,5,0,36,31
1657936288465,MATH 18,B03,083750,Rideout; David Porter,3,0,37,34
1657936288465,MATH 18,B04,083751,Rideout; David Porter,7,0,36,29
1657936288465,MATH 18,B05,093473,Rideout; David Porter,7,0,36,29
1657936288465,MATH 18,B06,093474,Rideout; David Porter,6,0,36,30
1657936294488,MATH 20A,A01,083754,Zheng; Zequn,14,0,40,26
1657936300510,MATH 20B,A01,083756,Briones; Jor-el Thomas Caparas,4,0,36,32
1657936300510,MATH 20B,A02,083757,Briones; Jor-el Thomas Caparas,1,0,36,35
1657936300510,MATH 20B,A03,093475,Briones; Jor-el Thomas Caparas,3,0,36,33
1657936306538,MATH 20C,A01,083760,Briones; Jor-el Thomas Caparas,1,0,35,34
1657936306538,MATH 20C,A02,083761,Briones; Jor-el Thomas Caparas,8,0,35,27
1657936306538,MATH 20C,A03,093476,Briones; Jor-el Thomas Caparas,0,1,36,36
1657936306538,MATH 20C,B01,083762,Bach; Quang Tran,1,0,30,29
1657936312566,MATH 20D,A01,083765,Tran; Brian Kha,5,0,30,25
1657936312566,MATH 20D,A02,083766,Tran; Brian Kha,5,0,30,25
1657936312566,MATH 20D,A03,083767,Tran; Brian Kha,6,0,30,24
1657936318592,MATH 20E,A01,083771,Ganguly; Soumya,12,0,32,20
1657936318592,MATH 20E,A02,083772,Ganguly; Soumya,7,0,32,25
1657936318592,MATH 20E,B01,083773,Ciotti; Benjamin,20,0,35,15
1657936318592,MATH 20E,B02,083774,Ciotti; Benjamin,18,0,35,17
1657936324620,MATH 103A,A01,083777,Greenfeld; Be'Eri,3,0,36,33
1657936324620,MATH 103A,A02,083778,Greenfeld; Be'Eri,5,0,36,31
1657936324620,MATH 103A,A03,093561,Greenfeld; Be'Eri,6,0,36,30
1657936324620,MATH 103A,B01,083779,Greenfeld; Be'Eri,8,0,36,28
1657936324620,MATH 103A,B02,083780,Greenfeld; Be'Eri,4,0,36,32
1657936324620,MATH 103A,B03,093562,Greenfeld; Be'Eri,3,0,36,33
1657936330642,MATH 105,A01,085443,Carter; Anne Toulson,15,0,35,20
1657936330642,MATH 105,A02,093477,Carter; Anne Toulson,20,0,35,15
1657936336670,MATH 109,A01,083213,Ganzberger; Geoffrey Michael,3,0,34,31
1657936336670,MATH 109,A02,083214,Ganzberger; Geoffrey Michael,4,0,34,30
1657936336670,MATH 109,A03,093478,Ganzberger; Geoffrey Michael,2,0,34,32
1657936336670,MATH 109,B01,083215,Ganzberger; Geoffrey Michael,2,0,32,30
1657936336670,MATH 109,B02,083216,Ganzberger; Geoffrey Michael,3,0,32,29
1657936336670,MATH 109,B03,093479,Ganzberger; Geoffrey Michael,8,0,32,24
1657936342696,MATH 142A,A01,083219,Chow; Bennett,7,0,32,25
1657936342696,MATH 142A,A02,083220,Chow; Bennett,10,0,32,22
1657936342696,MATH 142A,A03,093480,Chow; Bennett,9,0,32,23
1657936342696,MATH 142A,B03,093481,Chow; Bennett,8,0,32,24
1657936342696,MATH 142A,B04,093558,Chow; Bennett,13,0,32,19
1657936342696,MATH 142A,B05,093559,Chow; Bennett,7,0,32,25
1657936348724,MATH 193A,A01,083224,Rotar; Vladimir,8,0,34,26
1657936348724,MATH 193A,A02,083225,Rotar; Vladimir,10,0,34,24
1657936348724,MATH 193A,A03,083781,Rotar; Vladimir,5,0,34,29
1657936348724,MATH 193A,A04,083782,Rotar; Vladimir,11,0,34,23
1657936348724,MATH 193A,A05,093482,Rotar; Vladimir,11,0,34,23
1657936354749,MATH 197,001,091859,McAuley; Julian John,9999,0,9999,0
1657936354749,MATH 197,002,095566,Kedlaya; Kiran S.,9997,0,9999,2
1657936354749,MATH 197,003,095567,Xiao; Ming,9999,0,9999,0
1657936354749,MATH 197,004,095571,Perols; Johan Lars,9998,0,9999,1
1657936361806,COGS 9,A01,083615,Shannon; Kyle Michael,11,0,75,64
1657936367828,COGS 11,A01,083617,Boyle; Mary E. T.,23,0,48,25
1657936373851,COGS 13,A01,083071,Bastos; Amalia Pinkusfeld,12,0,71,59
1657936379873,COGS 14A,A01,092681,Semenuks; Arturs,5,1,100,95
1657936385900,COGS 14B,A01,083073,Cheng; Tzu-Han,7,0,63,56
1657936391923,COGS 17,A01,092677,Semenuks; Arturs,7,0,81,74
1657936397951,COGS 100,A01,083619,Allen; Michael Gordon,17,0,70,53
1657936403977,COGS 101A,A01,083621,Davis; Joshua Daniel,9,0,68,59
1657936410073,COGS 101B,A01,091572,Allen; Michael Gordon,14,0,65,51
1657936416101,COGS 101C,A01,083625,Delgado; Tania,17,0,35,18
1657936422123,COGS 107A,A01,083627,Boyle; Mary E. T.,14,0,60,46
1657936428146,COGS 118A,A01,083075,Gupta; Anjum,21,0,76,55
1657936434170,CSE 3,A50,083646,Miranda; Gregory Joseph,24,0,50,26
1657936440193,CSE 8A,A50,083650,Miranda; Gregory Joseph,17,1,56,39
1657936446220,CSE 11,A01,083080,Cao; Yingjun,6,15,40,34
1657936452243,CSE 12,A01,083652,Krause-Levy; Sophia Louisa,30,1,120,90
1657936458267,CSE 15L,A01,083654,Morris; Justin Loren,9,0,50,41
1657936458267,CSE 15L,A02,083655,Morris; Justin Loren,10,0,50,40
1657936464292,CSE 20,A01,083657,Tran; Khoa Dang,39,0,80,41
1657936470315,CSE 21,A01,095574,Bach; Quang Tran,23,0,48,25
1657936476339,CSE 30,A01,083084,Eldon; John,7,0,80,73
1657936476339,CSE 30,B01,095061,Bhaskar; Nishant,9,0,50,41
1657936482361,CSE 100,A01,083659,Cao; Yingjun,5,4,70,65
1657936488383,CSE 134B,A01,083661,Powell; Thomas Allan,25,0,100,75
1657936494408,CSE 140,A01,083663,Gungor; Onat,17,0,85,68
1657936500434,CSE 140L,A01,083088,Eldon; John,23,0,100,77
1657936506458,CSE 175,A01,083665,Kumar; Rakesh,3,0,25,22
1657936512486,CSE 190,A00,092507,Dubnov; Shlomo,8,0,20,12
1657936518513,ECE 45,A01,083139,Congero; Spencer William,7,0,75,68
1657936524535,ECE 65,A50,083695,Saad; Andrew S,12,0,30,18
1657936524535,ECE 65,A51,095125,Saad; Andrew S,24,0,26,2
1657936530562,ECE 109,A01,091882,Touri; Behrouz,20,0,70,50
1657936536585,ECE 180,A00,083140,Abi Samra; Nicholas Camill,1,0,30,29
1657936536585,ECE 180,B00,083141,Abi Samra; Nicholas Camill,0,0,30,30
1657936542619,MATH 10A,A01,083735,Patchell; Gregory David,2,0,30,28
1657936542619,MATH 10A,A02,083736,Patchell; Gregory David,20,0,30,10
1657936542619,MATH 10A,A03,083737,Patchell; Gregory David,16,0,30,14
1657936548642,MATH 10B,A01,083207,Lim; Seonhee,9,0,34,25
1657936548642,MATH 10B,A02,083208,Lim; Seonhee,10,0,35,25
1657936548642,MATH 10B,A03,093472,Lim; Seonhee,7,0,34,27
1657936548642,MATH 10B,B01,083739,Sinha; Shubham,14,0,30,16
1657936554673,MATH 18,A01,083743,Cinel; Cameron Alexander,9,0,30,21
1657936554673,MATH 18,A02,083744,Cinel; Cameron Alexander,18,0,30,12
1657936554673,MATH 18,A03,083745,Cinel; Cameron Alexander,10,0,30,20
1657936554673,MATH 18,B01,083748,Rideout; David Porter,5,0,37,32
1657936554673,MATH 18,B02,083749,Rideout; David Porter,5,0,36,31
1657936554673,MATH 18,B03,083750,Rideout; David Porter,3,0,37,34
1657936554673,MATH 18,B04,083751,Rideout; David Porter,7,0,36,29
1657936554673,MATH 18,B05,093473,Rideout; David Porter,7,0,36,29
1657936554673,MATH 18,B06,093474,Rideout; David Porter,6,0,36,30
1657936560696,MATH 20A,A01,083754,Zheng; Zequn,14,0,40,26
1657936566722,MATH 20B,A01,083756,Briones; Jor-el Thomas Caparas,4,0,36,32
1657936566722,MATH 20B,A02,083757,Briones; Jor-el Thomas Caparas,1,0,36,35
1657936566722,MATH 20B,A03,093475,Briones; Jor-el Thomas Caparas,3,0,36,33
1657936572759,MATH 20C,A01,083760,Briones; Jor-el Thomas Caparas,1,0,35,34
1657936572759,MATH 20C,A02,083761,Briones; Jor-el Thomas Caparas,8,0,35,27
1657936572759,MATH 20C,A03,093476,Briones; Jor-el Thomas Caparas,0,1,36,36
1657936572759,MATH 20C,B01,083762,Bach; Quang Tran,1,0,30,29
1657936578787,MATH 20D,A01,083765,Tran; Brian Kha,5,0,30,25
1657936578787,MATH 20D,A02,083766,Tran; Brian Kha,5,0,30,25
1657936578787,MATH 20D,A03,083767,Tran; Brian Kha,6,0,30,24
1657936584811,MATH 20E,A01,083771,Ganguly; Soumya,12,0,32,20
1657936584811,MATH 20E,A02,083772,Ganguly; Soumya,7,0,32,25
1657936584811,MATH 20E,B01,083773,Ciotti; Benjamin,20,0,35,15
1657936584811,MATH 20E,B02,083774,Ciotti; Benjamin,18,0,35,17
1657936590836,MATH 103A,A01,083777,Greenfeld; Be'Eri,3,0,36,33
1657936590836,MATH 103A,A02,083778,Greenfeld; Be'Eri,5,0,36,31
1657936590836,MATH 103A,A03,093561,Greenfeld; Be'Eri,6,0,36,30
1657936590836,MATH 103A,B01,083779,Greenfeld; Be'Eri,8,0,36,28
1657936590836,MATH 103A,B02,083780,Greenfeld; Be'Eri,4,0,36,32
1657936590836,MATH 103A,B03,093562,Greenfeld; Be'Eri,3,0,36,33
1657936596862,MATH 105,A01,085443,Carter; Anne Toulson,15,0,35,20
1657936596862,MATH 105,A02,093477,Carter; Anne Toulson,20,0,35,15
1657936602890,MATH 109,A01,083213,Ganzberger; Geoffrey Michael,3,0,34,31
1657936602890,MATH 109,A02,083214,Ganzberger; Geoffrey Michael,4,0,34,30
1657936602890,MATH 109,A03,093478,Ganzberger; Geoffrey Michael,2,0,34,32
1657936602890,MATH 109,B01,083215,Ganzberger; Geoffrey Michael,2,0,32,30
1657936602890,MATH 109,B02,083216,Ganzberger; Geoffrey Michael,3,0,32,29
1657936602890,MATH 109,B03,093479,Ganzberger; Geoffrey Michael,8,0,32,24
1657936608926,MATH 142A,A01,083219,Chow; Bennett,7,0,32,25
1657936608926,MATH 142A,A02,083220,Chow; Bennett,10,0,32,22
1657936608926,MATH 142A,A03,093480,Chow; Bennett,9,0,32,23
1657936608926,MATH 142A,B03,093481,Chow; Bennett,8,0,32,24
1657936608926,MATH 142A,B04,093558,Chow; Bennett,13,0,32,19
1657936608926,MATH 142A,B05,093559,Chow; Bennett,7,0,32,25
1657936614950,MATH 193A,A01,083224,Rotar; Vladimir,8,0,34,26
1657936614950,MATH 193A,A02,083225,Rotar; Vladimir,10,0,34,24
1657936614950,MATH 193A,A03,083781,Rotar; Vladimir,5,0,34,29
1657936614950,MATH 193A,A04,083782,Rotar; Vladimir,11,0,34,23
1657936614950,MATH 193A,A05,093482,Rotar; Vladimir,11,0,34,23
1657936620973,MATH 197,001,091859,McAuley; Julian John,9999,0,9999,0
1657936620973,MATH 197,002,095566,Kedlaya; Kiran S.,9997,0,9999,2
1657936620973,MATH 197,003,095567,Xiao; Ming,9999,0,9999,0
1657936620973,MATH 197,004,095571,Perols; Johan Lars,9998,0,9999,1
1657936628033,COGS 9,A01,083615,Shannon; Kyle Michael,11,0,75,64
1657936634055,COGS 11,A01,083617,Boyle; Mary E. T.,23,0,48,25
1657936640082,COGS 13,A01,083071,Bastos; Amalia Pinkusfeld,12,0,71,59
1657936646103,COGS 14A,A01,092681,Semenuks; Arturs,5,1,100,95
1657936652127,COGS 14B,A01,083073,Cheng; Tzu-Han,7,0,63,56
1657936658153,COGS 17,A01,092677,Semenuks; Arturs,7,0,81,74
1657936664179,COGS 100,A01,083619,Allen; Michael Gordon,17,0,70,53
1657936670207,COGS 101A,A01,083621,Davis; Joshua Daniel,9,0,68,59
1657936676233,COGS 101B,A01,091572,Allen; Michael Gordon,14,0,65,51
1657936682257,COGS 101C,A01,083625,Delgado; Tania,17,0,35,18
1657936688288,COGS 107A,A01,083627,Boyle; Mary E. T.,14,0,60,46
1657936694310,COGS 118A,A01,083075,Gupta; Anjum,21,0,76,55
1657936700337,CSE 3,A50,083646,Miranda; Gregory Joseph,24,0,50,26
1657936706360,CSE 8A,A50,083650,Miranda; Gregory Joseph,17,1,56,39
1657936712384,CSE 11,A01,083080,Cao; Yingjun,6,15,40,34
1657936718406,CSE 12,A01,083652,Krause-Levy; Sophia Louisa,30,1,120,90
1657936724429,CSE 15L,A01,083654,Morris; Justin Loren,9,0,50,41
1657936724429,CSE 15L,A02,083655,Morris; Justin Loren,10,0,50,40
1657936730457,CSE 20,A01,083657,Tran; Khoa Dang,39,0,80,41
1657936736489,CSE 21,A01,095574,Bach; Quang Tran,23,0,48,25
1657936742511,CSE 30,A01,083084,Eldon; John,7,0,80,73
1657936742511,CSE 30,B01,095061,Bhaskar; Nishant,9,0,50,41
1657936748536,CSE 100,A01,083659,Cao; Yingjun,5,4,70,65
1657936754563,CSE 134B,A01,083661,Powell; Thomas Allan,25,0,100,75
1657936760596,CSE 140,A01,083663,Gungor; Onat,17,0,85,68
1657936766618,CSE 140L,A01,083088,Eldon; John,23,0,100,77
1657936772643,CSE 175,A01,083665,Kumar; Rakesh,3,0,25,22
1657936778666,CSE 190,A00,092507,Dubnov; Shlomo,8,0,20,12
1657936784695,ECE 45,A01,083139,Congero; Spencer William,7,0,75,68
1657936790737,ECE 65,A50,083695,Saad; Andrew S,12,0,30,18
1657936790737,ECE 65,A51,095125,Saad; Andrew S,24,0,26,2
1657936796760,ECE 109,A01,091882,Touri; Behrouz,20,0,70,50
1657936802783,ECE 180,A00,083140,Abi Samra; Nicholas Camill,1,0,30,29
1657936802783,ECE 180,B00,083141,Abi Samra; Nicholas Camill,0,0,30,30
1657936808807,MATH 10A,A01,083735,Patchell; Gregory David,2,0,30,28
1657936808807,MATH 10A,A02,083736,Patchell; Gregory David,20,0,30,10
1657936808807,MATH 10A,A03,083737,Patchell; Gregory David,16,0,30,14
1657936814830,MATH 10B,A01,083207,Lim; Seonhee,9,0,34,25
1657936814830,MATH 10B,A02,083208,Lim; Seonhee,10,0,35,25
1657936814830,MATH 10B,A03,093472,Lim; Seonhee,7,0,34,27
1657936814830,MATH 10B,B01,083739,Sinha; Shubham,14,0,30,16
1657936820858,MATH 18,A01,083743,Cinel; Cameron Alexander,9,0,30,21
1657936820858,MATH 18,A02,083744,Cinel; Cameron Alexander,18,0,30,12
1657936820858,MATH 18,A03,083745,Cinel; Cameron Alexander,10,0,30,20
1657936820858,MATH 18,B01,083748,Rideout; David Porter,5,0,37,32
1657936820858,MATH 18,B02,083749,Rideout; David Porter,5,0,36,31
1657936820858,MATH 18,B03,083750,Rideout; David Porter,3,0,37,34
1657936820858,MATH 18,B04,083751,Rideout; David Porter,7,0,36,29
1657936820858,MATH 18,B05,093473,Rideout; David Porter,7,0,36,29
1657936820858,MATH 18,B06,093474,Rideout; David Porter,6,0,36,30
1657936826884,MATH 20A,A01,083754,Zheng; Zequn,14,0,40,26
1657936832913,MATH 20B,A01,083756,Briones; Jor-el Thomas Caparas,4,0,36,32
1657936832913,MATH 20B,A02,083757,Briones; Jor-el Thomas Caparas,1,0,36,35
1657936832913,MATH 20B,A03,093475,Briones; Jor-el Thomas Caparas,3,0,36,33
1657936838940,MATH 20C,A01,083760,Briones; Jor-el Thomas Caparas,1,0,35,34
1657936838940,MATH 20C,A02,083761,Briones; Jor-el Thomas Caparas,8,0,35,27
1657936838940,MATH 20C,A03,093476,Briones; Jor-el Thomas Caparas,0,1,36,36
1657936838940,MATH 20C,B01,083762,Bach; Quang Tran,1,0,30,29
1657936844964,MATH 20D,A01,083765,Tran; Brian Kha,5,0,30,25
1657936844964,MATH 20D,A02,083766,Tran; Brian Kha,5,0,30,25
1657936844964,MATH 20D,A03,083767,Tran; Brian Kha,6,0,30,24
1657936850993,MATH 20E,A01,083771,Ganguly; Soumya,12,0,32,20
1657936850993,MATH 20E,A02,083772,Ganguly; Soumya,7,0,32,25
1657936850993,MATH 20E,B01,083773,Ciotti; Benjamin,20,0,35,15
1657936850993,MATH 20E,B02,083774,Ciotti; Benjamin,18,0,35,17
1657936857022,MATH 103A,A01,083777,Greenfeld; Be'Eri,3,0,36,33
1657936857022,MATH 103A,A02,083778,Greenfeld; Be'Eri,5,0,36,31
1657936857022,MATH 103A,A03,093561,Greenfeld; Be'Eri,6,0,36,30
1657936857022,MATH 103A,B01,083779,Greenfeld; Be'Eri,8,0,36,28
1657936857022,MATH 103A,B02,083780,Greenfeld; Be'Eri,4,0,36,32
1657936857022,MATH 103A,B03,093562,Greenfeld; Be'Eri,3,0,36,33
1657936863048,MATH 105,A01,085443,Carter; Anne Toulson,15,0,35,20
1657936863048,MATH 105,A02,093477,Carter; Anne Toulson,20,0,35,15
1657936869071,MATH 109,A01,083213,Ganzberger; Geoffrey Michael,3,0,34,31
1657936869071,MATH 109,A02,083214,Ganzberger; Geoffrey Michael,4,0,34,30
1657936869071,MATH 109,A03,093478,Ganzberger; Geoffrey Michael,2,0,34,32
1657936869071,MATH 109,B01,083215,Ganzberger; Geoffrey Michael,2,0,32,30
1657936869071,MATH 109,B02,083216,Ganzberger; Geoffrey Michael,3,0,32,29
1657936869071,MATH 109,B03,093479,Ganzberger; Geoffrey Michael,8,0,32,24
1657936875101,MATH 142A,A01,083219,Chow; Bennett,7,0,32,25
1657936875101,MATH 142A,A02,083220,Chow; Bennett,10,0,32,22
1657936875101,MATH 142A,A03,093480,Chow; Bennett,9,0,32,23
1657936875101,MATH 142A,B03,093481,Chow; Bennett,8,0,32,24
1657936875101,MATH 142A,B04,093558,Chow; Bennett,13,0,32,19
1657936875101,MATH 142A,B05,093559,Chow; Bennett,7,0,32,25
1657936881131,MATH 193A,A01,083224,Rotar; Vladimir,8,0,34,26
1657936881131,MATH 193A,A02,083225,Rotar; Vladimir,10,0,34,24
1657936881131,MATH 193A,A03,083781,Rotar; Vladimir,5,0,34,29
1657936881131,MATH 193A,A04,083782,Rotar; Vladimir,11,0,34,23
1657936881131,MATH 193A,A05,093482,Rotar; Vladimir,11,0,34,23
1657936887155,MATH 197,001,091859,McAuley; Julian John,9999,0,9999,0
1657936887155,MATH 197,002,095566,Kedlaya; Kiran S.,9997,0,9999,2
1657936887155,MATH 197,003,095567,Xiao; Ming,9999,0,9999,0
1657936887155,MATH 197,004,095571,Perols; Johan Lars,9998,0,9999,1
1657936894215,COGS 9,A01,083615,Shannon; Kyle Michael,11,0,75,64
1657936900238,COGS 11,A01,083617,Boyle; Mary E. T.,23,0,48,25
1657936906265,COGS 13,A01,083071,Bastos; Amalia Pinkusfeld,12,0,71,59
1657936912288,COGS 14A,A01,092681,Semenuks; Arturs,5,1,100,95
1657936918313,COGS 14B,A01,083073,Cheng; Tzu-Han,7,0,63,56
1657936924336,COGS 17,A01,092677,Semenuks; Arturs,7,0,81,74
1657936930362,COGS 100,A01,083619,Allen; Michael Gordon,17,0,70,53
1657936936389,COGS 101A,A01,083621,Davis; Joshua Daniel,9,0,68,59
1657936942413,COGS 101B,A01,091572,Allen; Michael Gordon,14,0,65,51
1657936948436,COGS 101C,A01,083625,Delgado; Tania,17,0,35,18
1657936954460,COGS 107A,A01,083627,Boyle; Mary E. T.,14,0,60,46
1657936960483,COGS 118A,A01,083075,Gupta; Anjum,21,0,76,55
1657936966511,CSE 3,A50,083646,Miranda; Gregory Joseph,24,0,50,26
1657936972538,CSE 8A,A50,083650,Miranda; Gregory Joseph,17,1,56,39
1657936978564,CSE 11,A01,083080,Cao; Yingjun,6,15,40,34
1657936984590,CSE 12,A01,083652,Krause-Levy; Sophia Louisa,30,1,120,90
1657936990615,CSE 15L,A01,083654,Morris; Justin Loren,9,0,50,41
1657936990615,CSE 15L,A02,083655,Morris; Justin Loren,10,0,50,40
1657936996639,CSE 20,A01,083657,Tran; Khoa Dang,39,0,80,41
1657937002662,CSE 21,A01,095574,Bach; Quang Tran,23,0,48,25
1657937008764,CSE 30,A01,083084,Eldon; John,7,0,80,73
1657937008764,CSE 30,B01,095061,Bhaskar; Nishant,9,0,50,41
1657937014788,CSE 100,A01,083659,Cao; Yingjun,5,4,70,65
1657937020814,CSE 134B,A01,083661,Powell; Thomas Allan,25,0,100,75
1657937026841,CSE 140,A01,083663,Gungor; Onat,17,0,85,68
1657937032868,CSE 140L,A01,083088,Eldon; John,23,0,100,77
1657937038891,CSE 175,A01,083665,Kumar; Rakesh,3,0,25,22
1657937044913,CSE 190,A00,092507,Dubnov; Shlomo,8,0,20,12
1657937050936,ECE 45,A01,083139,Congero; Spencer William,7,0,75,68
1657937056961,ECE 65,A50,083695,Saad; Andrew S,12,0,30,18
1657937056961,ECE 65,A51,095125,Saad; Andrew S,24,0,26,2
1657937062989,ECE 109,A01,091882,Touri; Behrouz,20,0,70,50
1657937069019,ECE 180,A00,083140,Abi Samra; Nicholas Camill,1,0,30,29
1657937069019,ECE 180,B00,083141,Abi Samra; Nicholas Camill,0,0,30,30
1657937075045,MATH 10A,A01,083735,Patchell; Gregory David,2,0,30,28
1657937075045,MATH 10A,A02,083736,Patchell; Gregory David,20,0,30,10
1657937075045,MATH 10A,A03,083737,Patchell; Gregory David,16,0,30,14
1657937081069,MATH 10B,A01,083207,Lim; Seonhee,9,0,34,25
1657937081069,MATH 10B,A02,083208,Lim; Seonhee,10,0,35,25
1657937081069,MATH 10B,A03,093472,Lim; Seonhee,7,0,34,27
1657937081069,MATH 10B,B01,083739,Sinha; Shubham,14,0,30,16
1657937087093,MATH 18,A01,083743,Cinel; Cameron Alexander,9,0,30,21
1657937087093,MATH 18,A02,083744,Cinel; Cameron Alexander,18,0,30,12
1657937087093,MATH 18,A03,083745,Cinel; Cameron Alexander,10,0,30,20
1657937087093,MATH 18,B01,083748,Rideout; David Porter,5,0,37,32
1657937087093,MATH 18,B02,083749,Rideout; David Porter,5,0,36,31
1657937087093,MATH 18,B03,083750,Rideout; David Porter,3,0,37,34
1657937087093,MATH 18,B04,083751,Rideout; David Porter,7,0,36,29
1657937087093,MATH 18,B05,093473,Rideout; David Porter,7,0,36,29
1657937087093,MATH 18,B06,093474,Rideout; David Porter,6,0,36,30
1657937093123,MATH 20A,A01,083754,Zheng; Zequn,14,0,40,26
1657937099146,MATH 20B,A01,083756,Briones; Jor-el Thomas Caparas,4,0,36,32
1657937099146,MATH 20B,A02,083757,Briones; Jor-el Thomas Caparas,1,0,36,35
1657937099146,MATH 20B,A03,093475,Briones; Jor-el Thomas Caparas,3,0,36,33
1657937105169,MATH 20C,A01,083760,Briones; Jor-el Thomas Caparas,1,0,35,34
1657937105169,MATH 20C,A02,083761,Briones; Jor-el Thomas Caparas,8,0,35,27
1657937105169,MATH 20C,A03,093476,Briones; Jor-el Thomas Caparas,0,1,36,36
1657937105169,MATH 20C,B01,083762,Bach; Quang Tran,1,0,30,29
1657937111196,MATH 20D,A01,083765,Tran; Brian Kha,5,0,30,25
1657937111196,MATH 20D,A02,083766,Tran; Brian Kha,5,0,30,25
1657937111196,MATH 20D,A03,083767,Tran; Brian Kha,6,0,30,24
1657937117223,MATH 20E,A01,083771,Ganguly; Soumya,12,0,32,20
1657937117223,MATH 20E,A02,083772,Ganguly; Soumya,7,0,32,25
1657937117223,MATH 20E,B01,083773,Ciotti; Benjamin,20,0,35,15
1657937117223,MATH 20E,B02,083774,Ciotti; Benjamin,18,0,35,17
1657937123247,MATH 103A,A01,083777,Greenfeld; Be'Eri,3,0,36,33
1657937123247,MATH 103A,A02,083778,Greenfeld; Be'Eri,5,0,36,31
1657937123247,MATH 103A,A03,093561,Greenfeld; Be'Eri,6,0,36,30
1657937123247,MATH 103A,B01,083779,Greenfeld; Be'Eri,8,0,36,28
1657937123247,MATH 103A,B02,083780,Greenfeld; Be'Eri,4,0,36,32
1657937123247,MATH 103A,B03,093562,Greenfeld; Be'Eri,3,0,36,33
1657937129269,MATH 105,A01,085443,Carter; Anne Toulson,15,0,35,20
1657937129269,MATH 105,A02,093477,Carter; Anne Toulson,20,0,35,15
1657937135293,MATH 109,A01,083213,Ganzberger; Geoffrey Michael,3,0,34,31
1657937135293,MATH 109,A02,083214,Ganzberger; Geoffrey Michael,4,0,34,30
1657937135293,MATH 109,A03,093478,Ganzberger; Geoffrey Michael,2,0,34,32
1657937135293,MATH 109,B01,083215,Ganzberger; Geoffrey Michael,2,0,32,30
1657937135293,MATH 109,B02,083216,Ganzberger; Geoffrey Michael,3,0,32,29
1657937135293,MATH 109,B03,093479,Ganzberger; Geoffrey Michael,8,0,32,24
1657937141334,MATH 142A,A01,083219,Chow; Bennett,7,0,32,25
1657937141334,MATH 142A,A02,083220,Chow; Bennett,10,0,32,22
1657937141334,MATH 142A,A03,093480,Chow; Bennett,9,0,32,23
1657937141334,MATH 142A,B03,093481,Chow; Bennett,8,0,32,24
1657937141334,MATH 142A,B04,093558,Chow; Bennett,13,0,32,19
1657937141334,MATH 142A,B05,093559,Chow; Bennett,7,0,32,25
1657937147358,MATH 193A,A01,083224,Rotar; Vladimir,8,0,34,26
1657937147358,MATH 193A,A02,083225,Rotar; Vladimir,10,0,34,24
1657937147358,MATH 193A,A03,083781,Rotar; Vladimir,5,0,34,29
1657937147358,MATH 193A,A04,083782,Rotar; Vladimir,11,0,34,23
1657937147358,MATH 193A,A05,093482,Rotar; Vladimir,11,0,34,23
1657937153384,MATH 197,001,091859,McAuley; Julian John,9999,0,9999,0
1657937153384,MATH 197,002,095566,Kedlaya; Kiran S.,9997,0,9999,2
1657937153384,MATH 197,003,095567,Xiao; Ming,9999,0,9999,0
1657937153384,MATH 197,004,095571,Perols; Johan Lars,9998,0,9999,1
1657937160447,COGS 9,A01,083615,Shannon; Kyle Michael,11,0,75,64
1657937166473,COGS 11,A01,083617,Boyle; Mary E. T.,23,0,48,25
1657937172508,COGS 13,A01,083071,Bastos; Amalia Pinkusfeld,12,0,71,59
1657937178532,COGS 14A,A01,092681,Semenuks; Arturs,5,1,100,95
1657937184555,COGS 14B,A01,083073,Cheng; Tzu-Han,7,0,63,56
1657937190581,COGS 17,A01,092677,Semenuks; Arturs,7,0,81,74
1657937196604,COGS 100,A01,083619,Allen; Michael Gordon,17,0,70,53
1657937202634,COGS 101A,A01,083621,Davis; Joshua Daniel,9,0,68,59
1657937208662,COGS 101B,A01,091572,Allen; Michael Gordon,14,0,65,51
1657937214703,COGS 101C,A01,083625,Delgado; Tania,17,0,35,18
1657937220728,COGS 107A,A01,083627,Boyle; Mary E. T.,14,0,60,46
1657937226753,COGS 118A,A01,083075,Gupta; Anjum,21,0,76,55
1657937232779,CSE 3,A50,083646,Miranda; Gregory Joseph,24,0,50,26
1657937238803,CSE 8A,A50,083650,Miranda; Gregory Joseph,17,1,56,39
1657937244826,CSE 11,A01,083080,Cao; Yingjun,6,15,40,34
1657937250850,CSE 12,A01,083652,Krause-Levy; Sophia Louisa,30,1,120,90
1657937256879,CSE 15L,A01,083654,Morris; Justin Loren,9,0,50,41
1657937256879,CSE 15L,A02,083655,Morris; Justin Loren,10,0,50,40
1657937262904,CSE 20,A01,083657,Tran; Khoa Dang,39,0,80,41
1657937268929,CSE 21,A01,095574,Bach; Quang Tran,23,0,48,25
1657937274956,CSE 30,A01,083084,Eldon; John,7,0,80,73
1657937274956,CSE 30,B01,095061,Bhaskar; Nishant,9,0,50,41
1657937280983,CSE 100,A01,083659,Cao; Yingjun,5,4,70,65
1657937287006,CSE 134B,A01,083661,Powell; Thomas Allan,25,0,100,75
1657937293029,CSE 140,A01,083663,Gungor; Onat,17,0,85,68
1657937299055,CSE 140L,A01,083088,Eldon; John,23,0,100,77
1657937305082,CSE 175,A01,083665,Kumar; Rakesh,3,0,25,22
1657937311108,CSE 190,A00,092507,Dubnov; Shlomo,8,0,20,12
1657937317131,ECE 45,A01,083139,Congero; Spencer William,7,0,75,68
1657937323160,ECE 65,A50,083695,Saad; Andrew S,12,0,30,18
1657937323160,ECE 65,A51,095125,Saad; Andrew S,24,0,26,2
1657937329184,ECE 109,A01,091882,Touri; Behrouz,20,0,70,50
1657937335211,ECE 180,A00,083140,Abi Samra; Nicholas Camill,1,0,30,29
1657937335211,ECE 180,B00,083141,Abi Samra; Nicholas Camill,0,0,30,30
1657937341235,MATH 10A,A01,083735,Patchell; Gregory David,2,0,30,28
1657937341235,MATH 10A,A02,083736,Patchell; Gregory David,20,0,30,10
1657937341235,MATH 10A,A03,083737,Patchell; Gregory David,16,0,30,14
1657937347259,MATH 10B,A01,083207,Lim; Seonhee,9,0,34,25
1657937347259,MATH 10B,A02,083208,Lim; Seonhee,10,0,35,25
1657937347259,MATH 10B,A03,093472,Lim; Seonhee,7,0,34,27
1657937347259,MATH 10B,B01,083739,Sinha; Shubham,14,0,30,16
1657937353282,MATH 18,A01,083743,Cinel; Cameron Alexander,9,0,30,21
1657937353282,MATH 18,A02,083744,Cinel; Cameron Alexander,18,0,30,12
1657937353282,MATH 18,A03,083745,Cinel; Cameron Alexander,10,0,30,20
1657937353282,MATH 18,B01,083748,Rideout; David Porter,5,0,37,32
1657937353282,MATH 18,B02,083749,Rideout; David Porter,5,0,36,31
1657937353282,MATH 18,B03,083750,Rideout; David Porter,3,0,37,34
1657937353282,MATH 18,B04,083751,Rideout; David Porter,7,0,36,29
1657937353282,MATH 18,B05,093473,Rideout; David Porter,7,0,36,29
1657937353282,MATH 18,B06,093474,Rideout; David Porter,6,0,36,30
1657937359306,MATH 20A,A01,083754,Zheng; Zequn,14,0,40,26
1657937365330,MATH 20B,A01,083756,Briones; Jor-el Thomas Caparas,4,0,36,32
1657937365330,MATH 20B,A02,083757,Briones; Jor-el Thomas Caparas,1,0,36,35
1657937365330,MATH 20B,A03,093475,Briones; Jor-el Thomas Caparas,3,0,36,33
1657937371354,MATH 20C,A01,083760,Briones; Jor-el Thomas Caparas,1,0,35,34
1657937371354,MATH 20C,A02,083761,Briones; Jor-el Thomas Caparas,8,0,35,27
1657937371354,MATH 20C,A03,093476,Briones; Jor-el Thomas Caparas,0,1,36,36
1657937371354,MATH 20C,B01,083762,Bach; Quang Tran,1,0,30,29
1657937377378,MATH 20D,A01,083765,Tran; Brian Kha,5,0,30,25
1657937377378,MATH 20D,A02,083766,Tran; Brian Kha,5,0,30,25
1657937377378,MATH 20D,A03,083767,Tran; Brian Kha,6,0,30,24
1657937383402,MATH 20E,A01,083771,Ganguly; Soumya,12,0,32,20
1657937383402,MATH 20E,A02,083772,Ganguly; Soumya,7,0,32,25
1657937383402,MATH 20E,B01,083773,Ciotti; Benjamin,20,0,35,15
1657937383402,MATH 20E,B02,083774,Ciotti; Benjamin,18,0,35,17
1657937389425,MATH 103A,A01,083777,Greenfeld; Be'Eri,3,0,36,33
1657937389425,MATH 103A,A02,083778,Greenfeld; Be'Eri,5,0,36,31
1657937389425,MATH 103A,A03,093561,Greenfeld; Be'Eri,6,0,36,30
1657937389425,MATH 103A,B01,083779,Greenfeld; Be'Eri,8,0,36,28
1657937389425,MATH 103A,B02,083780,Greenfeld; Be'Eri,4,0,36,32
1657937389425,MATH 103A,B03,093562,Greenfeld; Be'Eri,3,0,36,33
1657937395449,MATH 105,A01,085443,Carter; Anne Toulson,15,0,35,20
1657937395449,MATH 105,A02,093477,Carter; Anne Toulson,20,0,35,15
1657937401476,MATH 109,A01,083213,Ganzberger; Geoffrey Michael,3,0,34,31
1657937401476,MATH 109,A02,083214,Ganzberger; Geoffrey Michael,4,0,34,30
1657937401476,MATH 109,A03,093478,Ganzberger; Geoffrey Michael,2,0,34,32
1657937401476,MATH 109,B01,083215,Ganzberger; Geoffrey Michael,2,0,32,30
1657937401476,MATH 109,B02,083216,Ganzberger; Geoffrey Michael,3,0,32,29
1657937401476,MATH 109,B03,093479,Ganzberger; Geoffrey Michael,8,0,32,24
1657937407500,MATH 142A,A01,083219,Chow; Bennett,7,0,32,25
1657937407500,MATH 142A,A02,083220,Chow; Bennett,10,0,32,22
1657937407500,MATH 142A,A03,093480,Chow; Bennett,9,0,32,23
1657937407500,MATH 142A,B03,093481,Chow; Bennett,8,0,32,24
1657937407500,MATH 142A,B04,093558,Chow; Bennett,13,0,32,19
1657937407500,MATH 142A,B05,093559,Chow; Bennett,7,0,32,25
1657937413530,MATH 193A,A01,083224,Rotar; Vladimir,8,0,34,26
1657937413530,MATH 193A,A02,083225,Rotar; Vladimir,10,0,34,24
1657937413530,MATH 193A,A03,083781,Rotar; Vladimir,5,0,34,29
1657937413530,MATH 193A,A04,083782,Rotar; Vladimir,11,0,34,23
1657937413530,MATH 193A,A05,093482,Rotar; Vladimir,11,0,34,23
1657937419556,MATH 197,001,091859,McAuley; Julian John,9999,0,9999,0
1657937419556,MATH 197,002,095566,Kedlaya; Kiran S.,9997,0,9999,2
1657937419556,MATH 197,003,095567,Xiao; Ming,9999,0,9999,0
1657937419556,MATH 197,004,095571,Perols; Johan Lars,9998,0,9999,1
1657937426615,COGS 9,A01,083615,Shannon; Kyle Michael,11,0,75,64
1657937432637,COGS 11,A01,083617,Boyle; Mary E. T.,23,0,48,25
1657937438663,COGS 13,A01,083071,Bastos; Amalia Pinkusfeld,12,0,71,59
1657937444687,COGS 14A,A01,092681,Semenuks; Arturs,5,1,100,95
1657937450709,COGS 14B,A01,083073,Cheng; Tzu-Han,7,0,63,56
1657937456732,COGS 17,A01,092677,Semenuks; Arturs,7,0,81,74
1657937462757,COGS 100,A01,083619,Allen; Michael Gordon,17,0,70,53
1657937468788,COGS 101A,A01,083621,Davis; Joshua Daniel,9,0,68,59
1657937474811,COGS 101B,A01,091572,Allen; Michael Gordon,14,0,65,51
1657937480844,COGS 101C,A01,083625,Delgado; Tania,17,0,35,18
1657937486868,COGS 107A,A01,083627,Boyle; Mary E. T.,14,0,60,46
1657937492895,COGS 118A,A01,083075,Gupta; Anjum,21,0,76,55
1657937498917,CSE 3,A50,083646,Miranda; Gregory Joseph,24,0,50,26
1657937504944,CSE 8A,A50,083650,Miranda; Gregory Joseph,17,1,56,39
1657937510969,CSE 11,A01,083080,Cao; Yingjun,6,15,40,34
1657937516993,CSE 12,A01,083652,Krause-Levy; Sophia Louisa,30,1,120,90
1657937523030,CSE 15L,A01,083654,Morris; Justin Loren,9,0,50,41
1657937523030,CSE 15L,A02,083655,Morris; Justin Loren,10,0,50,40
1657937529057,CSE 20,A01,083657,Tran; Khoa Dang,39,0,80,41
1657937535083,CSE 21,A01,095574,Bach; Quang Tran,23,0,48,25
1657937541115,CSE 30,A01,083084,Eldon; John,7,0,80,73
1657937541115,CSE 30,B01,095061,Bhaskar; Nishant,9,0,50,41
1657937547141,CSE 100,A01,083659,Cao; Yingjun,5,4,70,65
1657937553164,CSE 134B,A01,083661,Powell; Thomas Allan,25,0,100,75
1657937559190,CSE 140,A01,083663,Gungor; Onat,17,0,85,68
1657937565215,CSE 140L,A01,083088,Eldon; John,23,0,100,77
1657937571242,CSE 175,A01,083665,Kumar; Rakesh,3,0,25,22
1657937577266,CSE 190,A00,092507,Dubnov; Shlomo,8,0,20,12
1657937583289,ECE 45,A01,083139,Congero; Spencer William,7,0,75,68
1657937589312,ECE 65,A50,083695,Saad; Andrew S,12,0,30,18
1657937589312,ECE 65,A51,095125,Saad; Andrew S,24,0,26,2
1657937595347,ECE 109,A01,091882,Touri; Behrouz,20,0,70,50
1657937601375,ECE 180,A00,083140,Abi Samra; Nicholas Camill,1,0,30,29
1657937601375,ECE 180,B00,083141,Abi Samra; Nicholas Camill,0,0,30,30
1657937607493,MATH 10A,A01,083735,Patchell; Gregory David,2,0,30,28
1657937607493,MATH 10A,A02,083736,Patchell; Gregory David,20,0,30,10
1657937607493,MATH 10A,A03,083737,Patchell; Gregory David,16,0,30,14
1657937613515,MATH 10B,A01,083207,Lim; Seonhee,9,0,34,25
1657937613515,MATH 10B,A02,083208,Lim; Seonhee,10,0,35,25
1657937613515,MATH 10B,A03,093472,Lim; Seonhee,7,0,34,27
1657937613515,MATH 10B,B01,083739,Sinha; Shubham,14,0,30,16
1657937619540,MATH 18,A01,083743,Cinel; Cameron Alexander,9,0,30,21
1657937619540,MATH 18,A02,083744,Cinel; Cameron Alexander,18,0,30,12
1657937619540,MATH 18,A03,083745,Cinel; Cameron Alexander,10,0,30,20
1657937619540,MATH 18,B01,083748,Rideout; David Porter,5,0,37,32
1657937619540,MATH 18,B02,083749,Rideout; David Porter,5,0,36,31
1657937619540,MATH 18,B03,083750,Rideout; David Porter,3,0,37,34
1657937619540,MATH 18,B04,083751,Rideout; David Porter,7,0,36,29
1657937619540,MATH 18,B05,093473,Rideout; David Porter,7,0,36,29
1657937619540,MATH 18,B06,093474,Rideout; David Porter,6,0,36,30
1657937625565,MATH 20A,A01,083754,Zheng; Zequn,14,0,40,26
1657937631586,MATH 20B,A01,083756,Briones; Jor-el Thomas Caparas,4,0,36,32
1657937631586,MATH 20B,A02,083757,Briones; Jor-el Thomas Caparas,1,0,36,35
1657937631586,MATH 20B,A03,093475,Briones; Jor-el Thomas Caparas,3,0,36,33
1657937637615,MATH 20C,A01,083760,Briones; Jor-el Thomas Caparas,1,0,35,34
1657937637615,MATH 20C,A02,083761,Briones; Jor-el Thomas Caparas,8,0,35,27
1657937637615,MATH 20C,A03,093476,Briones; Jor-el Thomas Caparas,0,1,36,36
1657937637615,MATH 20C,B01,083762,Bach; Quang Tran,1,0,30,29
1657937643645,MATH 20D,A01,083765,Tran; Brian Kha,5,0,30,25
1657937643645,MATH 20D,A02,083766,Tran; Brian Kha,5,0,30,25
1657937643645,MATH 20D,A03,083767,Tran; Brian Kha,6,0,30,24
1657937649670,MATH 20E,A01,083771,Ganguly; Soumya,12,0,32,20
1657937649670,MATH 20E,A02,083772,Ganguly; Soumya,7,0,32,25
1657937649670,MATH 20E,B01,083773,Ciotti; Benjamin,20,0,35,15
1657937649670,MATH 20E,B02,083774,Ciotti; Benjamin,18,0,35,17
1657937655700,MATH 103A,A01,083777,Greenfeld; Be'Eri,3,0,36,33
1657937655700,MATH 103A,A02,083778,Greenfeld; Be'Eri,5,0,36,31
1657937655700,MATH 103A,A03,093561,Greenfeld; Be'Eri,6,0,36,30
1657937655700,MATH 103A,B01,083779,Greenfeld; Be'Eri,8,0,36,28
1657937655700,MATH 103A,B02,083780,Greenfeld; Be'Eri,4,0,36,32
1657937655700,MATH 103A,B03,093562,Greenfeld; Be'Eri,3,0,36,33
1657937661727,MATH 105,A01,085443,Carter; Anne Toulson,15,0,35,20
1657937661727,MATH 105,A02,093477,Carter; Anne Toulson,20,0,35,15
1657937667755,MATH 109,A01,083213,Ganzberger; Geoffrey Michael,3,0,34,31
1657937667755,MATH 109,A02,083214,Ganzberger; Geoffrey Michael,4,0,34,30
1657937667755,MATH 109,A03,093478,Ganzberger; Geoffrey Michael,2,0,34,32
1657937667755,MATH 109,B01,083215,Ganzberger; Geoffrey Michael,2,0,32,30
1657937667755,MATH 109,B02,083216,Ganzberger; Geoffrey Michael,3,0,32,29
1657937667755,MATH 109,B03,093479,Ganzberger; Geoffrey Michael,8,0,32,24
1657937673781,MATH 142A,A01,083219,Chow; Bennett,7,0,32,25
1657937673781,MATH 142A,A02,083220,Chow; Bennett,10,0,32,22
1657937673781,MATH 142A,A03,093480,Chow; Bennett,9,0,32,23
1657937673781,MATH 142A,B03,093481,Chow; Bennett,8,0,32,24
1657937673781,MATH 142A,B04,093558,Chow; Bennett,13,0,32,19
1657937673781,MATH 142A,B05,093559,Chow; Bennett,7,0,32,25
1657937679808,MATH 193A,A01,083224,Rotar; Vladimir,8,0,34,26
1657937679808,MATH 193A,A02,083225,Rotar; Vladimir,10,0,34,24
1657937679808,MATH 193A,A03,083781,Rotar; Vladimir,5,0,34,29
1657937679808,MATH 193A,A04,083782,Rotar; Vladimir,11,0,34,23
1657937679808,MATH 193A,A05,093482,Rotar; Vladimir,11,0,34,23
1657937685830,MATH 197,001,091859,McAuley; Julian John,9999,0,9999,0
1657937685830,MATH 197,002,095566,Kedlaya; Kiran S.,9997,0,9999,2
1657937685830,MATH 197,003,095567,Xiao; Ming,9999,0,9999,0
1657937685830,MATH 197,004,095571,Perols; Johan Lars,9998,0,9999,1
1657937692892,COGS 9,A01,083615,Shannon; Kyle Michael,11,0,75,64
1657937698919,COGS 11,A01,083617,Boyle; Mary E. T.,23,0,48,25
1657937704945,COGS 13,A01,083071,Bastos; Amalia Pinkusfeld,12,0,71,59
1657937710974,COGS 14A,A01,092681,Semenuks; Arturs,5,1,100,95
1657937717000,COGS 14B,A01,083073,Cheng; Tzu-Han,7,0,63,56
1657937723027,COGS 17,A01,092677,Semenuks; Arturs,7,0,81,74
1657937729053,COGS 100,A01,083619,Allen; Michael Gordon,17,0,70,53
1657937735076,COGS 101A,A01,083621,Davis; Joshua Daniel,9,0,68,59
1657937741103,COGS 101B,A01,091572,Allen; Michael Gordon,14,0,65,51
1657937747125,COGS 101C,A01,083625,Delgado; Tania,17,0,35,18
1657937753151,COGS 107A,A01,083627,Boyle; Mary E. T.,14,0,60,46
1657937759174,COGS 118A,A01,083075,Gupta; Anjum,21,0,76,55
1657937765202,CSE 3,A50,083646,Miranda; Gregory Joseph,24,0,50,26
1657937771229,CSE 8A,A50,083650,Miranda; Gregory Joseph,17,1,56,39
1657937777255,CSE 11,A01,083080,Cao; Yingjun,6,15,40,34
1657937783279,CSE 12,A01,083652,Krause-Levy; Sophia Louisa,30,1,120,90
1657937789306,CSE 15L,A01,083654,Morris; Justin Loren,9,0,50,41
1657937789306,CSE 15L,A02,083655,Morris; Justin Loren,10,0,50,40
1657937795331,CSE 20,A01,083657,Tran; Khoa Dang,39,0,80,41
1657937801361,CSE 21,A01,095574,Bach; Quang Tran,23,0,48,25
1657937807383,CSE 30,A01,083084,Eldon; John,7,0,80,73
1657937807383,CSE 30,B01,095061,Bhaskar; Nishant,9,0,50,41
1657937813413,CSE 100,A01,083659,Cao; Yingjun,5,4,70,65
1657937819437,CSE 134B,A01,083661,Powell; Thomas Allan,25,0,100,75
1657937825460,CSE 140,A01,083663,Gungor; Onat,17,0,85,68
1657937831483,CSE 140L,A01,083088,Eldon; John,23,0,100,77
1657937837505,CSE 175,A01,083665,Kumar; Rakesh,3,0,25,22
1657937843527,CSE 190,A00,092507,Dubnov; Shlomo,8,0,20,12
1657937849549,ECE 45,A01,083139,Congero; Spencer William,7,0,75,68
1657937855574,ECE 65,A50,083695,Saad; Andrew S,12,0,30,18
1657937855574,ECE 65,A51,095125,Saad; Andrew S,24,0,26,2
1657937861600,ECE 109,A01,091882,Touri; Behrouz,20,0,70,50
1657937867624,ECE 180,A00,083140,Abi Samra; Nicholas Camill,1,0,30,29
1657937867624,ECE 180,B00,083141,Abi Samra; Nicholas Camill,0,0,30,30
1657937873648,MATH 10A,A01,083735,Patchell; Gregory David,2,0,30,28
1657937873648,MATH 10A,A02,083736,Patchell; Gregory David,20,0,30,10
1657937873648,MATH 10A,A03,083737,Patchell; Gregory David,16,0,30,14
1657937879684,MATH 10B,A01,083207,Lim; Seonhee,9,0,34,25
1657937879684,MATH 10B,A02,083208,Lim; Seonhee,10,0,35,25
1657937879684,MATH 10B,A03,093472,Lim; Seonhee,7,0,34,27
1657937879684,MATH 10B,B01,083739,Sinha; Shubham,14,0,30,16
1657937885709,MATH 18,A01,083743,Cinel; Cameron Alexander,9,0,30,21
1657937885709,MATH 18,A02,083744,Cinel; Cameron Alexander,18,0,30,12
1657937885709,MATH 18,A03,083745,Cinel; Cameron Alexander,10,0,30,20
1657937885709,MATH 18,B01,083748,Rideout; David Porter,5,0,37,32
1657937885709,MATH 18,B02,083749,Rideout; David Porter,5,0,36,31
1657937885709,MATH 18,B03,083750,Rideout; David Porter,3,0,37,34
1657937885709,MATH 18,B04,083751,Rideout; David Porter,7,0,36,29
1657937885709,MATH 18,B05,093473,Rideout; David Porter,7,0,36,29
1657937885709,MATH 18,B06,093474,Rideout; David Porter,6,0,36,30
1657937891735,MATH 20A,A01,083754,Zheng; Zequn,14,0,40,26
1657937897761,MATH 20B,A01,083756,Briones; Jor-el Thomas Caparas,4,0,36,32
1657937897761,MATH 20B,A02,083757,Briones; Jor-el Thomas Caparas,1,0,36,35
1657937897761,MATH 20B,A03,093475,Briones; Jor-el Thomas Caparas,3,0,36,33
1657937903789,MATH 20C,A01,083760,Briones; Jor-el Thomas Caparas,1,0,35,34
1657937903789,MATH 20C,A02,083761,Briones; Jor-el Thomas Caparas,8,0,35,27
1657937903789,MATH 20C,A03,093476,Briones; Jor-el Thomas Caparas,0,1,36,36
1657937903789,MATH 20C,B01,083762,Bach; Quang Tran,1,0,30,29
1657937909818,MATH 20D,A01,083765,Tran; Brian Kha,5,0,30,25
1657937909818,MATH 20D,A02,083766,Tran; Brian Kha,5,0,30,25
1657937909818,MATH 20D,A03,083767,Tran; Brian Kha,6,0,30,24
1657937915847,MATH 20E,A01,083771,Ganguly; Soumya,12,0,32,20
1657937915847,MATH 20E,A02,083772,Ganguly; Soumya,7,0,32,25
1657937915847,MATH 20E,B01,083773,Ciotti; Benjamin,20,0,35,15
1657937915847,MATH 20E,B02,083774,Ciotti; Benjamin,18,0,35,17
1657937921883,MATH 103A,A01,083777,Greenfeld; Be'Eri,3,0,36,33
1657937921883,MATH 103A,A02,083778,Greenfeld; Be'Eri,5,0,36,31
1657937921883,MATH 103A,A03,093561,Greenfeld; Be'Eri,6,0,36,30
1657937921883,MATH 103A,B01,083779,Greenfeld; Be'Eri,8,0,36,28
1657937921883,MATH 103A,B02,083780,Greenfeld; Be'Eri,4,0,36,32
1657937921883,MATH 103A,B03,093562,Greenfeld; Be'Eri,3,0,36,33
1657937927905,MATH 105,A01,085443,Carter; Anne Toulson,15,0,35,20
1657937927905,MATH 105,A02,093477,Carter; Anne Toulson,20,0,35,15
1657937933931,MATH 109,A01,083213,Ganzberger; Geoffrey Michael,3,0,34,31
1657937933931,MATH 109,A02,083214,Ganzberger; Geoffrey Michael,4,0,34,30
1657937933931,MATH 109,A03,093478,Ganzberger; Geoffrey Michael,2,0,34,32
1657937933931,MATH 109,B01,083215,Ganzberger; Geoffrey Michael,2,0,32,30
1657937933931,MATH 109,B02,083216,Ganzberger; Geoffrey Michael,3,0,32,29
1657937933931,MATH 109,B03,093479,Ganzberger; Geoffrey Michael,8,0,32,24
1657937939955,MATH 142A,A01,083219,Chow; Bennett,7,0,32,25
1657937939955,MATH 142A,A02,083220,Chow; Bennett,10,0,32,22
1657937939955,MATH 142A,A03,093480,Chow; Bennett,9,0,32,23
1657937939955,MATH 142A,B03,093481,Chow; Bennett,8,0,32,24
1657937939955,MATH 142A,B04,093558,Chow; Bennett,13,0,32,19
1657937939955,MATH 142A,B05,093559,Chow; Bennett,7,0,32,25
1657937945976,MATH 193A,A01,083224,Rotar; Vladimir,8,0,34,26
1657937945976,MATH 193A,A02,083225,Rotar; Vladimir,10,0,34,24
1657937945976,MATH 193A,A03,083781,Rotar; Vladimir,5,0,34,29
1657937945976,MATH 193A,A04,083782,Rotar; Vladimir,11,0,34,23
1657937945976,MATH 193A,A05,093482,Rotar; Vladimir,11,0,34,23
1657937951999,MATH 197,001,091859,McAuley; Julian John,9999,0,9999,0
1657937951999,MATH 197,002,095566,Kedlaya; Kiran S.,9997,0,9999,2
1657937951999,MATH 197,003,095567,Xiao; Ming,9999,0,9999,0
1657937951999,MATH 197,004,095571,Perols; Johan Lars,9998,0,9999,1
1657937959050,COGS 9,A01,083615,Shannon; Kyle Michael,11,0,75,64
1657937965074,COGS 11,A01,083617,Boyle; Mary E. T.,23,0,48,25
1657937971102,COGS 13,A01,083071,Bastos; Amalia Pinkusfeld,12,0,71,59
1657937977126,COGS 14A,A01,092681,Semenuks; Arturs,5,1,100,95
1657937983152,COGS 14B,A01,083073,Cheng; Tzu-Han,7,0,63,56
1657937989178,COGS 17,A01,092677,Semenuks; Arturs,7,0,81,74
1657937995206,COGS 100,A01,083619,Allen; Michael Gordon,17,0,70,53
1657938001238,COGS 101A,A01,083621,Davis; Joshua Daniel,9,0,68,59
1657938007262,COGS 101B,A01,091572,Allen; Michael Gordon,14,0,65,51
1657938013286,COGS 101C,A01,083625,Delgado; Tania,17,0,35,18
1657938019315,COGS 107A,A01,083627,Boyle; Mary E. T.,14,0,60,46
1657938025342,COGS 118A,A01,083075,Gupta; Anjum,21,0,76,55
1657938031371,CSE 3,A50,083646,Miranda; Gregory Joseph,24,0,50,26
1657938037398,CSE 8A,A50,083650,Miranda; Gregory Joseph,17,1,56,39
1657938043426,CSE 11,A01,083080,Cao; Yingjun,6,15,40,34
1657938049450,CSE 12,A01,083652,Krause-Levy; Sophia Louisa,30,1,120,90
1657938055474,CSE 15L,A01,083654,Morris; Justin Loren,9,0,50,41
1657938055474,CSE 15L,A02,083655,Morris; Justin Loren,10,0,50,40
1657938061501,CSE 20,A01,083657,Tran; Khoa Dang,39,0,80,41
1657938067524,CSE 21,A01,095574,Bach; Quang Tran,23,0,48,25
1657938073547,CSE 30,A01,083084,Eldon; John,7,0,80,73
1657938073547,CSE 30,B01,095061,Bhaskar; Nishant,9,0,50,41
1657938079572,CSE 100,A01,083659,Cao; Yingjun,5,4,70,65
1657938085596,CSE 134B,A01,083661,Powell; Thomas Allan,25,0,100,75
1657938091620,CSE 140,A01,083663,Gungor; Onat,17,0,85,68
1657938097646,CSE 140L,A01,083088,Eldon; John,23,0,100,77
1657938103671,CSE 175,A01,083665,Kumar; Rakesh,3,0,25,22
1657938109697,CSE 190,A00,092507,Dubnov; Shlomo,8,0,20,12
1657938115726,ECE 45,A01,083139,Congero; Spencer William,7,0,75,68
1657938121750,ECE 65,A50,083695,Saad; Andrew S,12,0,30,18
1657938121750,ECE 65,A51,095125,Saad; Andrew S,24,0,26,2
1657938127772,ECE 109,A01,091882,Touri; Behrouz,20,0,70,50
1657938133795,ECE 180,A00,083140,Abi Samra; Nicholas Camill,1,0,30,29
1657938133795,ECE 180,B00,083141,Abi Samra; Nicholas Camill,0,0,30,30
1657938139820,MATH 10A,A01,083735,Patchell; Gregory David,2,0,30,28
1657938139820,MATH 10A,A02,083736,Patchell; Gregory David,20,0,30,10
1657938139820,MATH 10A,A03,083737,Patchell; Gregory David,16,0,30,14
1657938145845,MATH 10B,A01,083207,Lim; Seonhee,9,0,34,25
1657938145845,MATH 10B,A02,083208,Lim; Seonhee,10,0,35,25
1657938145845,MATH 10B,A03,093472,Lim; Seonhee,7,0,34,27
1657938145845,MATH 10B,B01,083739,Sinha; Shubham,14,0,30,16
1657938151872,MATH 18,A01,083743,Cinel; Cameron Alexander,9,0,30,21
1657938151872,MATH 18,A02,083744,Cinel; Cameron Alexander,18,0,30,12
1657938151872,MATH 18,A03,083745,Cinel; Cameron Alexander,10,0,30,20
1657938151872,MATH 18,B01,083748,Rideout; David Porter,5,0,37,32
1657938151872,MATH 18,B02,083749,Rideout; David Porter,5,0,36,31
1657938151872,MATH 18,B03,083750,Rideout; David Porter,3,0,37,34
1657938151872,MATH 18,B04,083751,Rideout; David Porter,7,0,36,29
1657938151872,MATH 18,B05,093473,Rideout; David Porter,7,0,36,29
1657938151872,MATH 18,B06,093474,Rideout; David Porter,6,0,36,30
1657938157893,MATH 20A,A01,083754,Zheng; Zequn,14,0,40,26
1657938163922,MATH 20B,A01,083756,Briones; Jor-el Thomas Caparas,4,0,36,32
1657938163922,MATH 20B,A02,083757,Briones; Jor-el Thomas Caparas,1,0,36,35
1657938163922,MATH 20B,A03,093475,Briones; Jor-el Thomas Caparas,3,0,36,33
1657938169944,MATH 20C,A01,083760,Briones; Jor-el Thomas Caparas,1,0,35,34
1657938169944,MATH 20C,A02,083761,Briones; Jor-el Thomas Caparas,8,0,35,27
1657938169944,MATH 20C,A03,093476,Briones; Jor-el Thomas Caparas,0,1,36,36
1657938169944,MATH 20C,B01,083762,Bach; Quang Tran,1,0,30,29
1657938175974,MATH 20D,A01,083765,Tran; Brian Kha,5,0,30,25
1657938175974,MATH 20D,A02,083766,Tran; Brian Kha,5,0,30,25
1657938175974,MATH 20D,A03,083767,Tran; Brian Kha,6,0,30,24
1657938181999,MATH 20E,A01,083771,Ganguly; Soumya,12,0,32,20
1657938181999,MATH 20E,A02,083772,Ganguly; Soumya,7,0,32,25
1657938181999,MATH 20E,B01,083773,Ciotti; Benjamin,20,0,35,15
1657938181999,MATH 20E,B02,083774,Ciotti; Benjamin,18,0,35,17
1657938188022,MATH 103A,A01,083777,Greenfeld; Be'Eri,3,0,36,33
1657938188022,MATH 103A,A02,083778,Greenfeld; Be'Eri,5,0,36,31
1657938188022,MATH 103A,A03,093561,Greenfeld; Be'Eri,6,0,36,30
1657938188022,MATH 103A,B01,083779,Greenfeld; Be'Eri,8,0,36,28
1657938188022,MATH 103A,B02,083780,Greenfeld; Be'Eri,4,0,36,32
1657938188022,MATH 103A,B03,093562,Greenfeld; Be'Eri,3,0,36,33
1657938194050,MATH 105,A01,085443,Carter; Anne Toulson,15,0,35,20
1657938194050,MATH 105,A02,093477,Carter; Anne Toulson,20,0,35,15
1657938200081,MATH 109,A01,083213,Ganzberger; Geoffrey Michael,3,0,34,31
1657938200081,MATH 109,A02,083214,Ganzberger; Geoffrey Michael,4,0,34,30
1657938200081,MATH 109,A03,093478,Ganzberger; Geoffrey Michael,2,0,34,32
1657938200081,MATH 109,B01,083215,Ganzberger; Geoffrey Michael,2,0,32,30
1657938200081,MATH 109,B02,083216,Ganzberger; Geoffrey Michael,3,0,32,29
1657938200081,MATH 109,B03,093479,Ganzberger; Geoffrey Michael,8,0,32,24
1657938206182,MATH 142A,A01,083219,Chow; Bennett,7,0,32,25
1657938206182,MATH 142A,A02,083220,Chow; Bennett,10,0,32,22
1657938206182,MATH 142A,A03,093480,Chow; Bennett,9,0,32,23
1657938206182,MATH 142A,B03,093481,Chow; Bennett,8,0,32,24
1657938206182,MATH 142A,B04,093558,Chow; Bennett,13,0,32,19
1657938206182,MATH 142A,B05,093559,Chow; Bennett,7,0,32,25
1657938212211,MATH 193A,A01,083224,Rotar; Vladimir,8,0,34,26
1657938212211,MATH 193A,A02,083225,Rotar; Vladimir,10,0,34,24
1657938212211,MATH 193A,A03,083781,Rotar; Vladimir,5,0,34,29
1657938212211,MATH 193A,A04,083782,Rotar; Vladimir,11,0,34,23
1657938212211,MATH 193A,A05,093482,Rotar; Vladimir,11,0,34,23
1657938218239,MATH 197,001,091859,McAuley; Julian John,9999,0,9999,0
1657938218239,MATH 197,002,095566,Kedlaya; Kiran S.,9997,0,9999,2
1657938218239,MATH 197,003,095567,Xiao; Ming,9999,0,9999,0
1657938218239,MATH 197,004,095571,Perols; Johan Lars,9998,0,9999,1
1657938225303,COGS 9,A01,083615,Shannon; Kyle Michael,11,0,75,64
1657938231332,COGS 11,A01,083617,Boyle; Mary E. T.,23,0,48,25
1657938237359,COGS 13,A01,083071,Bastos; Amalia Pinkusfeld,12,0,71,59
1657938243380,COGS 14A,A01,092681,Semenuks; Arturs,5,1,100,95
1657938249410,COGS 14B,A01,083073,Cheng; Tzu-Han,7,0,63,56
1657938255433,COGS 17,A01,092677,Semenuks; Arturs,7,0,81,74
1657938261455,COGS 100,A01,083619,Allen; Michael Gordon,17,0,70,53
1657938267483,COGS 101A,A01,083621,Davis; Joshua Daniel,9,0,68,59
1657938273508,COGS 101B,A01,091572,Allen; Michael Gordon,14,0,65,51
1657938279531,COGS 101C,A01,083625,Delgado; Tania,17,0,35,18
1657938285553,COGS 107A,A01,083627,Boyle; Mary E. T.,14,0,60,46
1657938291583,COGS 118A,A01,083075,Gupta; Anjum,21,0,76,55
1657938297613,CSE 3,A50,083646,Miranda; Gregory Joseph,24,0,50,26
1657938303636,CSE 8A,A50,083650,Miranda; Gregory Joseph,17,1,56,39
1657938309663,CSE 11,A01,083080,Cao; Yingjun,6,15,40,34
1657938315689,CSE 12,A01,083652,Krause-Levy; Sophia Louisa,30,1,120,90
1657938321713,CSE 15L,A01,083654,Morris; Justin Loren,9,0,50,41
1657938321713,CSE 15L,A02,083655,Morris; Justin Loren,10,0,50,40
1657938327742,CSE 20,A01,083657,Tran; Khoa Dang,39,0,80,41
1657938333765,CSE 21,A01,095574,Bach; Quang Tran,23,0,48,25
1657938339790,CSE 30,A01,083084,Eldon; John,7,0,80,73
1657938339790,CSE 30,B01,095061,Bhaskar; Nishant,9,0,50,41
1657938345816,CSE 100,A01,083659,Cao; Yingjun,5,4,70,65
1657938351840,CSE 134B,A01,083661,Powell; Thomas Allan,25,0,100,75
1657938357863,CSE 140,A01,083663,Gungor; Onat,17,0,85,68
1657938363889,CSE 140L,A01,083088,Eldon; John,23,0,100,77
1657938369916,CSE 175,A01,083665,Kumar; Rakesh,3,0,25,22
1657938375941,CSE 190,A00,092507,Dubnov; Shlomo,8,0,20,12
1657938381966,ECE 45,A01,083139,Congero; Spencer William,7,0,75,68
1657938387990,ECE 65,A50,083695,Saad; Andrew S,12,0,30,18
1657938387990,ECE 65,A51,095125,Saad; Andrew S,24,0,26,2
1657938394013,ECE 109,A01,091882,Touri; Behrouz,20,0,70,50
1657938400035,ECE 180,A00,083140,Abi Samra; Nicholas Camill,1,0,30,29
1657938400035,ECE 180,B00,083141,Abi Samra; Nicholas Camill,0,0,30,30
1657938406062,MATH 10A,A01,083735,Patchell; Gregory David,2,0,30,28
1657938406062,MATH 10A,A02,083736,Patchell; Gregory David,20,0,30,10
1657938406062,MATH 10A,A03,083737,Patchell; Gregory David,16,0,30,14
1657938412085,MATH 10B,A01,083207,Lim; Seonhee,9,0,34,25
1657938412085,MATH 10B,A02,083208,Lim; Seonhee,10,0,35,25
1657938412085,MATH 10B,A03,093472,Lim; Seonhee,7,0,34,27
1657938412085,MATH 10B,B01,083739,Sinha; Shubham,14,0,30,16
1657938418115,MATH 18,A01,083743,Cinel; Cameron Alexander,9,0,30,21
1657938418115,MATH 18,A02,083744,Cinel; Cameron Alexander,18,0,30,12
1657938418115,MATH 18,A03,083745,Cinel; Cameron Alexander,10,0,30,20
1657938418115,MATH 18,B01,083748,Rideout; David Porter,5,0,37,32
1657938418115,MATH 18,B02,083749,Rideout; David Porter,5,0,36,31
1657938418115,MATH 18,B03,083750,Rideout; David Porter,3,0,37,34
1657938418115,MATH 18,B04,083751,Rideout; David Porter,7,0,36,29
1657938418115,MATH 18,B05,093473,Rideout; David Porter,7,0,36,29
1657938418115,MATH 18,B06,093474,Rideout; David Porter,6,0,36,30
1657938424138,MATH 20A,A01,083754,Zheng; Zequn,14,0,40,26
1657938430167,MATH 20B,A01,083756,Briones; Jor-el Thomas Caparas,4,0,36,32
1657938430167,MATH 20B,A02,083757,Briones; Jor-el Thomas Caparas,1,0,36,35
1657938430167,MATH 20B,A03,093475,Briones; Jor-el Thomas Caparas,3,0,36,33
1657938436202,MATH 20C,A01,083760,Briones; Jor-el Thomas Caparas,1,0,35,34
1657938436202,MATH 20C,A02,083761,Briones; Jor-el Thomas Caparas,8,0,35,27
1657938436202,MATH 20C,A03,093476,Briones; Jor-el Thomas Caparas,0,1,36,36
1657938436202,MATH 20C,B01,083762,Bach; Quang Tran,1,0,30,29
1657938442232,MATH 20D,A01,083765,Tran; Brian Kha,5,0,30,25
1657938442232,MATH 20D,A02,083766,Tran; Brian Kha,5,0,30,25
1657938442232,MATH 20D,A03,083767,Tran; Brian Kha,6,0,30,24
1657938448255,MATH 20E,A01,083771,Ganguly; Soumya,12,0,32,20
1657938448255,MATH 20E,A02,083772,Ganguly; Soumya,7,0,32,25
1657938448255,MATH 20E,B01,083773,Ciotti; Benjamin,20,0,35,15
1657938448255,MATH 20E,B02,083774,Ciotti; Benjamin,18,0,35,17
1657938454284,MATH 103A,A01,083777,Greenfeld; Be'Eri,3,0,36,33
1657938454284,MATH 103A,A02,083778,Greenfeld; Be'Eri,5,0,36,31
1657938454284,MATH 103A,A03,093561,Greenfeld; Be'Eri,6,0,36,30
1657938454284,MATH 103A,B01,083779,Greenfeld; Be'Eri,8,0,36,28
1657938454284,MATH 103A,B02,083780,Greenfeld; Be'Eri,4,0,36,32
1657938454284,MATH 103A,B03,093562,Greenfeld; Be'Eri,3,0,36,33
1657938460307,MATH 105,A01,085443,Carter; Anne Toulson,15,0,35,20
1657938460307,MATH 105,A02,093477,Carter; Anne Toulson,20,0,35,15
1657938466336,MATH 109,A01,083213,Ganzberger; Geoffrey Michael,3,0,34,31
1657938466336,MATH 109,A02,083214,Ganzberger; Geoffrey Michael,4,0,34,30
1657938466336,MATH 109,A03,093478,Ganzberger; Geoffrey Michael,2,0,34,32
1657938466336,MATH 109,B01,083215,Ganzberger; Geoffrey Michael,2,0,32,30
1657938466336,MATH 109,B02,083216,Ganzberger; Geoffrey Michael,3,0,32,29
1657938466336,MATH 109,B03,093479,Ganzberger; Geoffrey Michael,8,0,32,24
1657938472375,MATH 142A,A01,083219,Chow; Bennett,7,0,32,25
1657938472375,MATH 142A,A02,083220,Chow; Bennett,10,0,32,22
1657938472375,MATH 142A,A03,093480,Chow; Bennett,9,0,32,23
1657938472375,MATH 142A,B03,093481,Chow; Bennett,8,0,32,24
1657938472375,MATH 142A,B04,093558,Chow; Bennett,13,0,32,19
1657938472375,MATH 142A,B05,093559,Chow; Bennett,7,0,32,25
1657938478401,MATH 193A,A01,083224,Rotar; Vladimir,8,0,34,26
1657938478401,MATH 193A,A02,083225,Rotar; Vladimir,10,0,34,24
1657938478401,MATH 193A,A03,083781,Rotar; Vladimir,5,0,34,29
1657938478401,MATH 193A,A04,083782,Rotar; Vladimir,11,0,34,23
1657938478401,MATH 193A,A05,093482,Rotar; Vladimir,11,0,34,23
1657938484424,MATH 197,001,091859,McAuley; Julian John,9999,0,9999,0
1657938484424,MATH 197,002,095566,Kedlaya; Kiran S.,9997,0,9999,2
1657938484424,MATH 197,003,095567,Xiao; Ming,9999,0,9999,0
1657938484424,MATH 197,004,095571,Perols; Johan Lars,9998,0,9999,1
1657938491488,COGS 9,A01,083615,Shannon; Kyle Michael,11,0,75,64
1657938497515,COGS 11,A01,083617,Boyle; Mary E. T.,23,0,48,25
1657938503537,COGS 13,A01,083071,Bastos; Amalia Pinkusfeld,12,0,71,59
1657938509563,COGS 14A,A01,092681,Semenuks; Arturs,5,1,100,95
1657938515587,COGS 14B,A01,083073,Cheng; Tzu-Han,7,0,63,56
1657938521609,COGS 17,A01,092677,Semenuks; Arturs,7,0,81,74
1657938527630,COGS 100,A01,083619,Allen; Michael Gordon,17,0,70,53
1657938533654,COGS 101A,A01,083621,Davis; Joshua Daniel,9,0,68,59
1657938539680,COGS 101B,A01,091572,Allen; Michael Gordon,14,0,65,51
1657938545702,COGS 101C,A01,083625,Delgado; Tania,17,0,35,18
1657938551734,COGS 107A,A01,083627,Boyle; Mary E. T.,14,0,60,46
1657938557762,COGS 118A,A01,083075,Gupta; Anjum,21,0,76,55
1657938563795,CSE 3,A50,083646,Miranda; Gregory Joseph,24,0,50,26
1657938569822,CSE 8A,A50,083650,Miranda; Gregory Joseph,17,1,56,39
1657938575850,CSE 11,A01,083080,Cao; Yingjun,6,15,40,34
1657938581876,CSE 12,A01,083652,Krause-Levy; Sophia Louisa,30,1,120,90
1657938587906,CSE 15L,A01,083654,Morris; Justin Loren,9,0,50,41
1657938587906,CSE 15L,A02,083655,Morris; Justin Loren,10,0,50,40
1657938593931,CSE 20,A01,083657,Tran; Khoa Dang,39,0,80,41
1657938599956,CSE 21,A01,095574,Bach; Quang Tran,23,0,48,25
1657938605979,CSE 30,A01,083084,Eldon; John,7,0,80,73
1657938605979,CSE 30,B01,095061,Bhaskar; Nishant,9,0,50,41
1657938612001,CSE 100,A01,083659,Cao; Yingjun,5,4,70,65
1657938618026,CSE 134B,A01,083661,Powell; Thomas Allan,25,0,100,75
1657938624048,CSE 140,A01,083663,Gungor; Onat,17,0,85,68
1657938630071,CSE 140L,A01,083088,Eldon; John,23,0,100,77
1657938636093,CSE 175,A01,083665,Kumar; Rakesh,3,0,25,22
1657938642118,CSE 190,A00,092507,Dubnov; Shlomo,8,0,20,12
1657938648147,ECE 45,A01,083139,Congero; Spencer William,7,0,75,68
1657938654174,ECE 65,A50,083695,Saad; Andrew S,12,0,30,18
1657938654174,ECE 65,A51,095125,Saad; Andrew S,24,0,26,2
1657938660208,ECE 109,A01,091882,Touri; Behrouz,20,0,70,50
1657938666231,ECE 180,A00,083140,Abi Samra; Nicholas Camill,1,0,30,29
1657938666231,ECE 180,B00,083141,Abi Samra; Nicholas Camill,0,0,30,30
1657938672254,MATH 10A,A01,083735,Patchell; Gregory David,2,0,30,28
1657938672254,MATH 10A,A02,083736,Patchell; Gregory David,20,0,30,10
1657938672254,MATH 10A,A03,083737,Patchell; Gregory David,16,0,30,14
1657938678284,MATH 10B,A01,083207,Lim; Seonhee,9,0,34,25
1657938678284,MATH 10B,A02,083208,Lim; Seonhee,10,0,35,25
1657938678284,MATH 10B,A03,093472,Lim; Seonhee,7,0,34,27
1657938678284,MATH 10B,B01,083739,Sinha; Shubham,14,0,30,16
1657938684311,MATH 18,A01,083743,Cinel; Cameron Alexander,9,0,30,21
1657938684311,MATH 18,A02,083744,Cinel; Cameron Alexander,18,0,30,12
1657938684311,MATH 18,A03,083745,Cinel; Cameron Alexander,10,0,30,20
1657938684311,MATH 18,B01,083748,Rideout; David Porter,5,0,37,32
1657938684311,MATH 18,B02,083749,Rideout; David Porter,5,0,36,31
1657938684311,MATH 18,B03,083750,Rideout; David Porter,3,0,37,34
1657938684311,MATH 18,B04,083751,Rideout; David Porter,7,0,36,29
1657938684311,MATH 18,B05,093473,Rideout; David Porter,7,0,36,29
1657938684311,MATH 18,B06,093474,Rideout; David Porter,6,0,36,30
1657938690337,MATH 20A,A01,083754,Zheng; Zequn,14,0,40,26
1657938696360,MATH 20B,A01,083756,Briones; Jor-el Thomas Caparas,4,0,36,32
1657938696360,MATH 20B,A02,083757,Briones; Jor-el Thomas Caparas,1,0,36,35
1657938696360,MATH 20B,A03,093475,Briones; Jor-el Thomas Caparas,3,0,36,33
1657938702389,MATH 20C,A01,083760,Briones; Jor-el Thomas Caparas,1,0,35,34
1657938702389,MATH 20C,A02,083761,Briones; Jor-el Thomas Caparas,8,0,35,27
1657938702389,MATH 20C,A03,093476,Briones; Jor-el Thomas Caparas,0,1,36,36
1657938702389,MATH 20C,B01,083762,Bach; Quang Tran,1,0,30,29
1657938708413,MATH 20D,A01,083765,Tran; Brian Kha,5,0,30,25
1657938708413,MATH 20D,A02,083766,Tran; Brian Kha,5,0,30,25
1657938708413,MATH 20D,A03,083767,Tran; Brian Kha,6,0,30,24
1657938714442,MATH 20E,A01,083771,Ganguly; Soumya,12,0,32,20
1657938714442,MATH 20E,A02,083772,Ganguly; Soumya,7,0,32,25
1657938714442,MATH 20E,B01,083773,Ciotti; Benjamin,20,0,35,15
1657938714442,MATH 20E,B02,083774,Ciotti; Benjamin,18,0,35,17
1657938720470,MATH 103A,A01,083777,Greenfeld; Be'Eri,3,0,36,33
1657938720470,MATH 103A,A02,083778,Greenfeld; Be'Eri,5,0,36,31
1657938720470,MATH 103A,A03,093561,Greenfeld; Be'Eri,6,0,36,30
1657938720470,MATH 103A,B01,083779,Greenfeld; Be'Eri,8,0,36,28
1657938720470,MATH 103A,B02,083780,Greenfeld; Be'Eri,4,0,36,32
1657938720470,MATH 103A,B03,093562,Greenfeld; Be'Eri,3,0,36,33
1657938726497,MATH 105,A01,085443,Carter; Anne Toulson,15,0,35,20
1657938726497,MATH 105,A02,093477,Carter; Anne Toulson,20,0,35,15
1657938732521,MATH 109,A01,083213,Ganzberger; Geoffrey Michael,3,0,34,31
1657938732521,MATH 109,A02,083214,Ganzberger; Geoffrey Michael,4,0,34,30
1657938732521,MATH 109,A03,093478,Ganzberger; Geoffrey Michael,2,0,34,32
1657938732521,MATH 109,B01,083215,Ganzberger; Geoffrey Michael,2,0,32,30
1657938732521,MATH 109,B02,083216,Ganzberger; Geoffrey Michael,3,0,32,29
1657938732521,MATH 109,B03,093479,Ganzberger; Geoffrey Michael,8,0,32,24
1657938738546,MATH 142A,A01,083219,Chow; Bennett,7,0,32,25
1657938738546,MATH 142A,A02,083220,Chow; Bennett,10,0,32,22
1657938738546,MATH 142A,A03,093480,Chow; Bennett,9,0,32,23
1657938738546,MATH 142A,B03,093481,Chow; Bennett,8,0,32,24
1657938738546,MATH 142A,B04,093558,Chow; Bennett,13,0,32,19
1657938738546,MATH 142A,B05,093559,Chow; Bennett,7,0,32,25
1657938744575,MATH 193A,A01,083224,Rotar; Vladimir,8,0,34,26
1657938744575,MATH 193A,A02,083225,Rotar; Vladimir,10,0,34,24
1657938744575,MATH 193A,A03,083781,Rotar; Vladimir,5,0,34,29
1657938744575,MATH 193A,A04,083782,Rotar; Vladimir,11,0,34,23
1657938744575,MATH 193A,A05,093482,Rotar; Vladimir,11,0,34,23
1657938750601,MATH 197,001,091859,McAuley; Julian John,9999,0,9999,0
1657938750601,MATH 197,002,095566,Kedlaya; Kiran S.,9997,0,9999,2
1657938750601,MATH 197,003,095567,Xiao; Ming,9999,0,9999,0
1657938750601,MATH 197,004,095571,Perols; Johan Lars,9998,0,9999,1
1657938757658,COGS 9,A01,083615,Shannon; Kyle Michael,11,0,75,64
1657938763685,COGS 11,A01,083617,Boyle; Mary E. T.,23,0,48,25
1657938769716,COGS 13,A01,083071,Bastos; Amalia Pinkusfeld,12,0,71,59
1657938775739,COGS 14A,A01,092681,Semenuks; Arturs,5,1,100,95
1657938781763,COGS 14B,A01,083073,Cheng; Tzu-Han,7,0,63,56
1657938787791,COGS 17,A01,092677,Semenuks; Arturs,7,0,81,74
1657938793815,COGS 100,A01,083619,Allen; Michael Gordon,17,0,70,53
1657938799910,COGS 101A,A01,083621,Davis; Joshua Daniel,9,0,68,59
1657938805934,COGS 101B,A01,091572,Allen; Michael Gordon,14,0,65,51
1657938811966,COGS 101C,A01,083625,Delgado; Tania,17,0,35,18
1657938817989,COGS 107A,A01,083627,Boyle; Mary E. T.,14,0,60,46
1657938824013,COGS 118A,A01,083075,Gupta; Anjum,21,0,76,55
1657938830041,CSE 3,A50,083646,Miranda; Gregory Joseph,24,0,50,26
1657938836066,CSE 8A,A50,083650,Miranda; Gregory Joseph,17,1,56,39
1657938842090,CSE 11,A01,083080,Cao; Yingjun,6,15,40,34
1657938848117,CSE 12,A01,083652,Krause-Levy; Sophia Louisa,30,1,120,90
1657938854139,CSE 15L,A01,083654,Morris; Justin Loren,9,0,50,41
1657938854139,CSE 15L,A02,083655,Morris; Justin Loren,10,0,50,40
1657938860162,CSE 20,A01,083657,Tran; Khoa Dang,39,0,80,41
1657938866188,CSE 21,A01,095574,Bach; Quang Tran,23,0,48,25
1657938872216,CSE 30,A01,083084,Eldon; John,7,0,80,73
1657938872216,CSE 30,B01,095061,Bhaskar; Nishant,9,0,50,41
1657938878238,CSE 100,A01,083659,Cao; Yingjun,5,4,70,65
1657938884265,CSE 134B,A01,083661,Powell; Thomas Allan,25,0,100,75
1657938890293,CSE 140,A01,083663,Gungor; Onat,17,0,85,68
1657938896316,CSE 140L,A01,083088,Eldon; John,23,0,100,77
1657938902340,CSE 175,A01,083665,Kumar; Rakesh,3,0,25,22
1657938908362,CSE 190,A00,092507,Dubnov; Shlomo,8,0,20,12
1657938914389,ECE 45,A01,083139,Congero; Spencer William,7,0,75,68
1657938920417,ECE 65,A50,083695,Saad; Andrew S,12,0,30,18
1657938920417,ECE 65,A51,095125,Saad; Andrew S,24,0,26,2
1657938926444,ECE 109,A01,091882,Touri; Behrouz,20,0,70,50
1657938932466,ECE 180,A00,083140,Abi Samra; Nicholas Camill,1,0,30,29
1657938932466,ECE 180,B00,083141,Abi Samra; Nicholas Camill,0,0,30,30
1657938938494,MATH 10A,A01,083735,Patchell; Gregory David,2,0,30,28
1657938938494,MATH 10A,A02,083736,Patchell; Gregory David,20,0,30,10
1657938938494,MATH 10A,A03,083737,Patchell; Gregory David,16,0,30,14
1657938944525,MATH 10B,A01,083207,Lim; Seonhee,9,0,34,25
1657938944525,MATH 10B,A02,083208,Lim; Seonhee,10,0,35,25
1657938944525,MATH 10B,A03,093472,Lim; Seonhee,7,0,34,27
1657938944525,MATH 10B,B01,083739,Sinha; Shubham,14,0,30,16
1657938950555,MATH 18,A01,083743,Cinel; Cameron Alexander,9,0,30,21
1657938950555,MATH 18,A02,083744,Cinel; Cameron Alexander,18,0,30,12
1657938950555,MATH 18,A03,083745,Cinel; Cameron Alexander,10,0,30,20
1657938950555,MATH 18,B01,083748,Rideout; David Porter,5,0,37,32
1657938950555,MATH 18,B02,083749,Rideout; David Porter,5,0,36,31
1657938950555,MATH 18,B03,083750,Rideout; David Porter,3,0,37,34
1657938950555,MATH 18,B04,083751,Rideout; David Porter,7,0,36,29
1657938950555,MATH 18,B05,093473,Rideout; David Porter,7,0,36,29
1657938950555,MATH 18,B06,093474,Rideout; David Porter,6,0,36,30
1657938956582,MATH 20A,A01,083754,Zheng; Zequn,14,0,40,26
1657938962610,MATH 20B,A01,083756,Briones; Jor-el Thomas Caparas,4,0,36,32
1657938962610,MATH 20B,A02,083757,Briones; Jor-el Thomas Caparas,1,0,36,35
1657938962610,MATH 20B,A03,093475,Briones; Jor-el Thomas Caparas,3,0,36,33
1657938968645,MATH 20C,A01,083760,Briones; Jor-el Thomas Caparas,1,0,35,34
1657938968645,MATH 20C,A02,083761,Briones; Jor-el Thomas Caparas,8,0,35,27
1657938968645,MATH 20C,A03,093476,Briones; Jor-el Thomas Caparas,0,1,36,36
1657938968645,MATH 20C,B01,083762,Bach; Quang Tran,1,0,30,29
1657938974673,MATH 20D,A01,083765,Tran; Brian Kha,5,0,30,25
1657938974673,MATH 20D,A02,083766,Tran; Brian Kha,5,0,30,25
1657938974673,MATH 20D,A03,083767,Tran; Brian Kha,6,0,30,24
1657938980700,MATH 20E,A01,083771,Ganguly; Soumya,12,0,32,20
1657938980700,MATH 20E,A02,083772,Ganguly; Soumya,7,0,32,25
1657938980700,MATH 20E,B01,083773,Ciotti; Benjamin,20,0,35,15
1657938980700,MATH 20E,B02,083774,Ciotti; Benjamin,18,0,35,17
1657938986724,MATH 103A,A01,083777,Greenfeld; Be'Eri,3,0,36,33
1657938986724,MATH 103A,A02,083778,Greenfeld; Be'Eri,5,0,36,31
1657938986724,MATH 103A,A03,093561,Greenfeld; Be'Eri,6,0,36,30
1657938986724,MATH 103A,B01,083779,Greenfeld; Be'Eri,8,0,36,28
1657938986724,MATH 103A,B02,083780,Greenfeld; Be'Eri,4,0,36,32
1657938986724,MATH 103A,B03,093562,Greenfeld; Be'Eri,3,0,36,33
1657938992754,MATH 105,A01,085443,Carter; Anne Toulson,15,0,35,20
1657938992754,MATH 105,A02,093477,Carter; Anne Toulson,20,0,35,15
1657938998778,MATH 109,A01,083213,Ganzberger; Geoffrey Michael,3,0,34,31
1657938998778,MATH 109,A02,083214,Ganzberger; Geoffrey Michael,4,0,34,30
1657938998778,MATH 109,A03,093478,Ganzberger; Geoffrey Michael,2,0,34,32
1657938998778,MATH 109,B01,083215,Ganzberger; Geoffrey Michael,2,0,32,30
1657938998778,MATH 109,B02,083216,Ganzberger; Geoffrey Michael,3,0,32,29
1657938998778,MATH 109,B03,093479,Ganzberger; Geoffrey Michael,8,0,32,24
1657939004802,MATH 142A,A01,083219,Chow; Bennett,7,0,32,25
1657939004802,MATH 142A,A02,083220,Chow; Bennett,10,0,32,22
1657939004802,MATH 142A,A03,093480,Chow; Bennett,9,0,32,23
1657939004802,MATH 142A,B03,093481,Chow; Bennett,8,0,32,24
1657939004802,MATH 142A,B04,093558,Chow; Bennett,13,0,32,19
1657939004802,MATH 142A,B05,093559,Chow; Bennett,7,0,32,25
1657939010827,MATH 193A,A01,083224,Rotar; Vladimir,8,0,34,26
1657939010827,MATH 193A,A02,083225,Rotar; Vladimir,10,0,34,24
1657939010827,MATH 193A,A03,083781,Rotar; Vladimir,5,0,34,29
1657939010827,MATH 193A,A04,083782,Rotar; Vladimir,11,0,34,23
1657939010827,MATH 193A,A05,093482,Rotar; Vladimir,11,0,34,23
1657939016849,MATH 197,001,091859,McAuley; Julian John,9999,0,9999,0
1657939016849,MATH 197,002,095566,Kedlaya; Kiran S.,9997,0,9999,2
1657939016849,MATH 197,003,095567,Xiao; Ming,9999,0,9999,0
1657939016849,MATH 197,004,095571,Perols; Johan Lars,9998,0,9999,1
1657939023902,COGS 9,A01,083615,Shannon; Kyle Michael,11,0,75,64
1657939029925,COGS 11,A01,083617,Boyle; Mary E. T.,23,0,48,25
1657939035951,COGS 13,A01,083071,Bastos; Amalia Pinkusfeld,12,0,71,59
1657939041974,COGS 14A,A01,092681,Semenuks; Arturs,5,1,100,95
1657939048001,COGS 14B,A01,083073,Cheng; Tzu-Han,7,0,63,56
1657939054028,COGS 17,A01,092677,Semenuks; Arturs,7,0,81,74
1657939060051,COGS 100,A01,083619,Allen; Michael Gordon,17,0,70,53
1657939066075,COGS 101A,A01,083621,Davis; Joshua Daniel,9,0,68,59
1657939072097,COGS 101B,A01,091572,Allen; Michael Gordon,14,0,65,51
1657939078119,COGS 101C,A01,083625,Delgado; Tania,17,0,35,18
1657939084142,COGS 107A,A01,083627,Boyle; Mary E. T.,14,0,60,46
1657939090169,COGS 118A,A01,083075,Gupta; Anjum,21,0,76,55
1657939096196,CSE 3,A50,083646,Miranda; Gregory Joseph,24,0,50,26
1657939102219,CSE 8A,A50,083650,Miranda; Gregory Joseph,17,1,56,39
1657939108247,CSE 11,A01,083080,Cao; Yingjun,6,15,40,34
1657939114269,CSE 12,A01,083652,Krause-Levy; Sophia Louisa,30,1,120,90
1657939120290,CSE 15L,A01,083654,Morris; Justin Loren,9,0,50,41
1657939120290,CSE 15L,A02,083655,Morris; Justin Loren,10,0,50,40
1657939126314,CSE 20,A01,083657,Tran; Khoa Dang,39,0,80,41
1657939132340,CSE 21,A01,095574,Bach; Quang Tran,23,0,48,25
1657939138371,CSE 30,A01,083084,Eldon; John,7,0,80,73
1657939138371,CSE 30,B01,095061,Bhaskar; Nishant,9,0,50,41
1657939144394,CSE 100,A01,083659,Cao; Yingjun,5,4,70,65
1657939150422,CSE 134B,A01,083661,Powell; Thomas Allan,25,0,100,75
1657939156448,CSE 140,A01,083663,Gungor; Onat,17,0,85,68
1657939162471,CSE 140L,A01,083088,Eldon; John,23,0,100,77
1657939168498,CSE 175,A01,083665,Kumar; Rakesh,3,0,25,22
1657939174524,CSE 190,A00,092507,Dubnov; Shlomo,8,0,20,12
1657939180546,ECE 45,A01,083139,Congero; Spencer William,7,0,75,68
1657939186585,ECE 65,A50,083695,Saad; Andrew S,12,0,30,18
1657939186585,ECE 65,A51,095125,Saad; Andrew S,24,0,26,2
1657939192608,ECE 109,A01,091882,Touri; Behrouz,20,0,70,50
1657939198632,ECE 180,A00,083140,Abi Samra; Nicholas Camill,1,0,30,29
1657939198632,ECE 180,B00,083141,Abi Samra; Nicholas Camill,0,0,30,30
1657939204661,MATH 10A,A01,083735,Patchell; Gregory David,2,0,30,28
1657939204661,MATH 10A,A02,083736,Patchell; Gregory David,20,0,30,10
1657939204661,MATH 10A,A03,083737,Patchell; Gregory David,16,0,30,14
1657939210689,MATH 10B,A01,083207,Lim; Seonhee,9,0,34,25
1657939210689,MATH 10B,A02,083208,Lim; Seonhee,10,0,35,25
1657939210689,MATH 10B,A03,093472,Lim; Seonhee,7,0,34,27
1657939210689,MATH 10B,B01,083739,Sinha; Shubham,14,0,30,16
1657939216714,MATH 18,A01,083743,Cinel; Cameron Alexander,9,0,30,21
1657939216714,MATH 18,A02,083744,Cinel; Cameron Alexander,18,0,30,12
1657939216714,MATH 18,A03,083745,Cinel; Cameron Alexander,10,0,30,20
1657939216714,MATH 18,B01,083748,Rideout; David Porter,5,0,37,32
1657939216714,MATH 18,B02,083749,Rideout; David Porter,5,0,36,31
1657939216714,MATH 18,B03,083750,Rideout; David Porter,3,0,37,34
1657939216714,MATH 18,B04,083751,Rideout; David Porter,7,0,36,29
1657939216714,MATH 18,B05,093473,Rideout; David Porter,7,0,36,29
1657939216714,MATH 18,B06,093474,Rideout; David Porter,6,0,36,30
1657939222740,MATH 20A,A01,083754,Zheng; Zequn,14,0,40,26
1657939228776,MATH 20B,A01,083756,Briones; Jor-el Thomas Caparas,4,0,36,32
1657939228776,MATH 20B,A02,083757,Briones; Jor-el Thomas Caparas,1,0,36,35
1657939228776,MATH 20B,A03,093475,Briones; Jor-el Thomas Caparas,3,0,36,33
1657939234798,MATH 20C,A01,083760,Briones; Jor-el Thomas Caparas,1,0,35,34
1657939234798,MATH 20C,A02,083761,Briones; Jor-el Thomas Caparas,8,0,35,27
1657939234798,MATH 20C,A03,093476,Briones; Jor-el Thomas Caparas,0,1,36,36
1657939234798,MATH 20C,B01,083762,Bach; Quang Tran,1,0,30,29
1657939240822,MATH 20D,A01,083765,Tran; Brian Kha,5,0,30,25
1657939240822,MATH 20D,A02,083766,Tran; Brian Kha,5,0,30,25
1657939240822,MATH 20D,A03,083767,Tran; Brian Kha,6,0,30,24
1657939246846,MATH 20E,A01,083771,Ganguly; Soumya,12,0,32,20
1657939246846,MATH 20E,A02,083772,Ganguly; Soumya,7,0,32,25
1657939246846,MATH 20E,B01,083773,Ciotti; Benjamin,20,0,35,15
1657939246846,MATH 20E,B02,083774,Ciotti; Benjamin,18,0,35,17
1657939252876,MATH 103A,A01,083777,Greenfeld; Be'Eri,3,0,36,33
1657939252876,MATH 103A,A02,083778,Greenfeld; Be'Eri,5,0,36,31
1657939252876,MATH 103A,A03,093561,Greenfeld; Be'Eri,6,0,36,30
1657939252876,MATH 103A,B01,083779,Greenfeld; Be'Eri,8,0,36,28
1657939252876,MATH 103A,B02,083780,Greenfeld; Be'Eri,4,0,36,32
1657939252876,MATH 103A,B03,093562,Greenfeld; Be'Eri,3,0,36,33
1657939258899,MATH 105,A01,085443,Carter; Anne Toulson,15,0,35,20
1657939258899,MATH 105,A02,093477,Carter; Anne Toulson,20,0,35,15
1657939264923,MATH 109,A01,083213,Ganzberger; Geoffrey Michael,3,0,34,31
1657939264923,MATH 109,A02,083214,Ganzberger; Geoffrey Michael,4,0,34,30
1657939264923,MATH 109,A03,093478,Ganzberger; Geoffrey Michael,2,0,34,32
1657939264923,MATH 109,B01,083215,Ganzberger; Geoffrey Michael,2,0,32,30
1657939264923,MATH 109,B02,083216,Ganzberger; Geoffrey Michael,3,0,32,29
1657939264923,MATH 109,B03,093479,Ganzberger; Geoffrey Michael,8,0,32,24
1657939270948,MATH 142A,A01,083219,Chow; Bennett,7,0,32,25
1657939270948,MATH 142A,A02,083220,Chow; Bennett,10,0,32,22
1657939270948,MATH 142A,A03,093480,Chow; Bennett,9,0,32,23
1657939270948,MATH 142A,B03,093481,Chow; Bennett,8,0,32,24
1657939270948,MATH 142A,B04,093558,Chow; Bennett,13,0,32,19
1657939270948,MATH 142A,B05,093559,Chow; Bennett,7,0,32,25
1657939276974,MATH 193A,A01,083224,Rotar; Vladimir,8,0,34,26
1657939276974,MATH 193A,A02,083225,Rotar; Vladimir,10,0,34,24
1657939276974,MATH 193A,A03,083781,Rotar; Vladimir,5,0,34,29
1657939276974,MATH 193A,A04,083782,Rotar; Vladimir,11,0,34,23
1657939276974,MATH 193A,A05,093482,Rotar; Vladimir,11,0,34,23
1657939282997,MATH 197,001,091859,McAuley; Julian John,9999,0,9999,0
1657939282997,MATH 197,002,095566,Kedlaya; Kiran S.,9997,0,9999,2
1657939282997,MATH 197,003,095567,Xiao; Ming,9999,0,9999,0
1657939282997,MATH 197,004,095571,Perols; Johan Lars,9998,0,9999,1
1657939290066,COGS 9,A01,083615,Shannon; Kyle Michael,11,0,75,64
1657939296087,COGS 11,A01,083617,Boyle; Mary E. T.,23,0,48,25
1657939302112,COGS 13,A01,083071,Bastos; Amalia Pinkusfeld,12,0,71,59
1657939308134,COGS 14A,A01,092681,Semenuks; Arturs,5,1,100,95
1657939314157,COGS 14B,A01,083073,Cheng; Tzu-Han,7,0,63,56
1657939320186,COGS 17,A01,092677,Semenuks; Arturs,7,0,81,74
1657939326209,COGS 100,A01,083619,Allen; Michael Gordon,17,0,70,53
1657939332232,COGS 101A,A01,083621,Davis; Joshua Daniel,9,0,68,59
1657939338255,COGS 101B,A01,091572,Allen; Michael Gordon,14,0,65,51
1657939344282,COGS 101C,A01,083625,Delgado; Tania,17,0,35,18
1657939350305,COGS 107A,A01,083627,Boyle; Mary E. T.,14,0,60,46
1657939356331,COGS 118A,A01,083075,Gupta; Anjum,21,0,76,55
1657939362354,CSE 3,A50,083646,Miranda; Gregory Joseph,24,0,50,26
1657939368383,CSE 8A,A50,083650,Miranda; Gregory Joseph,17,1,56,39
1657939374408,CSE 11,A01,083080,Cao; Yingjun,6,15,40,34
1657939380432,CSE 12,A01,083652,Krause-Levy; Sophia Louisa,30,1,120,90
1657939386455,CSE 15L,A01,083654,Morris; Justin Loren,9,0,50,41
1657939386455,CSE 15L,A02,083655,Morris; Justin Loren,10,0,50,40
1657939392481,CSE 20,A01,083657,Tran; Khoa Dang,39,0,80,41
1657939398573,CSE 21,A01,095574,Bach; Quang Tran,23,0,48,25
1657939404599,CSE 30,A01,083084,Eldon; John,7,0,80,73
1657939404599,CSE 30,B01,095061,Bhaskar; Nishant,9,0,50,41
1657939410623,CSE 100,A01,083659,Cao; Yingjun,5,4,70,65
1657939416650,CSE 134B,A01,083661,Powell; Thomas Allan,25,0,100,75
1657939422673,CSE 140,A01,083663,Gungor; Onat,17,0,85,68
1657939428695,CSE 140L,A01,083088,Eldon; John,23,0,100,77
1657939434720,CSE 175,A01,083665,Kumar; Rakesh,3,0,25,22
1657939440745,CSE 190,A00,092507,Dubnov; Shlomo,8,0,20,12
1657939446774,ECE 45,A01,083139,Congero; Spencer William,7,0,75,68
1657939452797,ECE 65,A50,083695,Saad; Andrew S,12,0,30,18
1657939452797,ECE 65,A51,095125,Saad; Andrew S,24,0,26,2
1657939458820,ECE 109,A01,091882,Touri; Behrouz,20,0,70,50
1657939464846,ECE 180,A00,083140,Abi Samra; Nicholas Camill,1,0,30,29
1657939464846,ECE 180,B00,083141,Abi Samra; Nicholas Camill,0,0,30,30
1657939470871,MATH 10A,A01,083735,Patchell; Gregory David,2,0,30,28
1657939470871,MATH 10A,A02,083736,Patchell; Gregory David,20,0,30,10
1657939470871,MATH 10A,A03,083737,Patchell; Gregory David,16,0,30,14
1657939476895,MATH 10B,A01,083207,Lim; Seonhee,9,0,34,25
1657939476895,MATH 10B,A02,083208,Lim; Seonhee,10,0,35,25
1657939476895,MATH 10B,A03,093472,Lim; Seonhee,7,0,34,27
1657939476895,MATH 10B,B01,083739,Sinha; Shubham,14,0,30,16
1657939482925,MATH 18,A01,083743,Cinel; Cameron Alexander,9,0,30,21
1657939482925,MATH 18,A02,083744,Cinel; Cameron Alexander,18,0,30,12
1657939482925,MATH 18,A03,083745,Cinel; Cameron Alexander,10,0,30,20
1657939482925,MATH 18,B01,083748,Rideout; David Porter,5,0,37,32
1657939482925,MATH 18,B02,083749,Rideout; David Porter,5,0,36,31
1657939482925,MATH 18,B03,083750,Rideout; David Porter,3,0,37,34
1657939482925,MATH 18,B04,083751,Rideout; David Porter,7,0,36,29
1657939482925,MATH 18,B05,093473,Rideout; David Porter,7,0,36,29
1657939482925,MATH 18,B06,093474,Rideout; David Porter,6,0,36,30
1657939488951,MATH 20A,A01,083754,Zheng; Zequn,14,0,40,26
1657939494978,MATH 20B,A01,083756,Briones; Jor-el Thomas Caparas,4,0,36,32
1657939494978,MATH 20B,A02,083757,Briones; Jor-el Thomas Caparas,1,0,36,35
1657939494978,MATH 20B,A03,093475,Briones; Jor-el Thomas Caparas,3,0,36,33
1657939501007,MATH 20C,A01,083760,Briones; Jor-el Thomas Caparas,1,0,35,34
1657939501007,MATH 20C,A02,083761,Briones; Jor-el Thomas Caparas,8,0,35,27
1657939501007,MATH 20C,A03,093476,Briones; Jor-el Thomas Caparas,0,1,36,36
1657939501007,MATH 20C,B01,083762,Bach; Quang Tran,1,0,30,29
1657939507033,MATH 20D,A01,083765,Tran; Brian Kha,5,0,30,25
1657939507033,MATH 20D,A02,083766,Tran; Brian Kha,5,0,30,25
1657939507033,MATH 20D,A03,083767,Tran; Brian Kha,6,0,30,24
1657939513060,MATH 20E,A01,083771,Ganguly; Soumya,12,0,32,20
1657939513060,MATH 20E,A02,083772,Ganguly; Soumya,7,0,32,25
1657939513060,MATH 20E,B01,083773,Ciotti; Benjamin,20,0,35,15
1657939513060,MATH 20E,B02,083774,Ciotti; Benjamin,18,0,35,17
1657939519083,MATH 103A,A01,083777,Greenfeld; Be'Eri,3,0,36,33
1657939519083,MATH 103A,A02,083778,Greenfeld; Be'Eri,5,0,36,31
1657939519083,MATH 103A,A03,093561,Greenfeld; Be'Eri,6,0,36,30
1657939519083,MATH 103A,B01,083779,Greenfeld; Be'Eri,8,0,36,28
1657939519083,MATH 103A,B02,083780,Greenfeld; Be'Eri,4,0,36,32
1657939519083,MATH 103A,B03,093562,Greenfeld; Be'Eri,3,0,36,33
1657939525109,MATH 105,A01,085443,Carter; Anne Toulson,15,0,35,20
1657939525109,MATH 105,A02,093477,Carter; Anne Toulson,20,0,35,15
1657939531131,MATH 109,A01,083213,Ganzberger; Geoffrey Michael,3,0,34,31
1657939531131,MATH 109,A02,083214,Ganzberger; Geoffrey Michael,4,0,34,30
1657939531131,MATH 109,A03,093478,Ganzberger; Geoffrey Michael,2,0,34,32
1657939531131,MATH 109,B01,083215,Ganzberger; Geoffrey Michael,2,0,32,30
1657939531131,MATH 109,B02,083216,Ganzberger; Geoffrey Michael,3,0,32,29
1657939531131,MATH 109,B03,093479,Ganzberger; Geoffrey Michael,8,0,32,24
1657939537153,MATH 142A,A01,083219,Chow; Bennett,7,0,32,25
1657939537153,MATH 142A,A02,083220,Chow; Bennett,10,0,32,22
1657939537153,MATH 142A,A03,093480,Chow; Bennett,9,0,32,23
1657939537153,MATH 142A,B03,093481,Chow; Bennett,8,0,32,24
1657939537153,MATH 142A,B04,093558,Chow; Bennett,13,0,32,19
1657939537153,MATH 142A,B05,093559,Chow; Bennett,7,0,32,25
1657939543182,MATH 193A,A01,083224,Rotar; Vladimir,8,0,34,26
1657939543182,MATH 193A,A02,083225,Rotar; Vladimir,10,0,34,24
1657939543182,MATH 193A,A03,083781,Rotar; Vladimir,5,0,34,29
1657939543182,MATH 193A,A04,083782,Rotar; Vladimir,11,0,34,23
1657939543182,MATH 193A,A05,093482,Rotar; Vladimir,11,0,34,23
1657939549204,MATH 197,001,091859,McAuley; Julian John,9999,0,9999,0
1657939549204,MATH 197,002,095566,Kedlaya; Kiran S.,9997,0,9999,2
1657939549204,MATH 197,003,095567,Xiao; Ming,9999,0,9999,0
1657939549204,MATH 197,004,095571,Perols; Johan Lars,9998,0,9999,1
1657939556258,COGS 9,A01,083615,Shannon; Kyle Michael,11,0,75,64
1657939562286,COGS 11,A01,083617,Boyle; Mary E. T.,23,0,48,25
1657939568309,COGS 13,A01,083071,Bastos; Amalia Pinkusfeld,12,0,71,59
1657939574331,COGS 14A,A01,092681,Semenuks; Arturs,5,1,100,95
1657939580355,COGS 14B,A01,083073,Cheng; Tzu-Han,7,0,63,56
1657939586378,COGS 17,A01,092677,Semenuks; Arturs,7,0,81,74
1657939592406,COGS 100,A01,083619,Allen; Michael Gordon,17,0,70,53
1657939598428,COGS 101A,A01,083621,Davis; Joshua Daniel,9,0,68,59
1657939604455,COGS 101B,A01,091572,Allen; Michael Gordon,14,0,65,51
1657939610478,COGS 101C,A01,083625,Delgado; Tania,17,0,35,18
1657939616502,COGS 107A,A01,083627,Boyle; Mary E. T.,14,0,60,46
1657939622526,COGS 118A,A01,083075,Gupta; Anjum,21,0,76,55
1657939628549,CSE 3,A50,083646,Miranda; Gregory Joseph,24,0,50,26
1657939634573,CSE 8A,A50,083650,Miranda; Gregory Joseph,17,1,56,39
1657939640595,CSE 11,A01,083080,Cao; Yingjun,6,15,40,34
1657939646618,CSE 12,A01,083652,Krause-Levy; Sophia Louisa,30,1,120,90
1657939652641,CSE 15L,A01,083654,Morris; Justin Loren,9,0,50,41
1657939652641,CSE 15L,A02,083655,Morris; Justin Loren,10,0,50,40
1657939658663,CSE 20,A01,083657,Tran; Khoa Dang,39,0,80,41
1657939664688,CSE 21,A01,095574,Bach; Quang Tran,23,0,48,25
1657939670711,CSE 30,A01,083084,Eldon; John,7,0,80,73
1657939670711,CSE 30,B01,095061,Bhaskar; Nishant,9,0,50,41
1657939676735,CSE 100,A01,083659,Cao; Yingjun,5,4,70,65
1657939682758,CSE 134B,A01,083661,Powell; Thomas Allan,25,0,100,75
1657939688779,CSE 140,A01,083663,Gungor; Onat,17,0,85,68
1657939694805,CSE 140L,A01,083088,Eldon; John,23,0,100,77
1657939700833,CSE 175,A01,083665,Kumar; Rakesh,3,0,25,22
1657939706854,CSE 190,A00,092507,Dubnov; Shlomo,8,0,20,12
1657939712883,ECE 45,A01,083139,Congero; Spencer William,7,0,75,68
1657939718906,ECE 65,A50,083695,Saad; Andrew S,12,0,30,18
1657939718906,ECE 65,A51,095125,Saad; Andrew S,24,0,26,2
1657939724932,ECE 109,A01,091882,Touri; Behrouz,20,0,70,50
1657939730959,ECE 180,A00,083140,Abi Samra; Nicholas Camill,1,0,30,29
1657939730959,ECE 180,B00,083141,Abi Samra; Nicholas Camill,0,0,30,30
1657939737001,MATH 10A,A01,083735,Patchell; Gregory David,2,0,30,28
1657939737001,MATH 10A,A02,083736,Patchell; Gregory David,20,0,30,10
1657939737001,MATH 10A,A03,083737,Patchell; Gregory David,16,0,30,14
1657939743029,MATH 10B,A01,083207,Lim; Seonhee,9,0,34,25
1657939743029,MATH 10B,A02,083208,Lim; Seonhee,10,0,35,25
1657939743029,MATH 10B,A03,093472,Lim; Seonhee,7,0,34,27
1657939743029,MATH 10B,B01,083739,Sinha; Shubham,14,0,30,16
1657939749052,MATH 18,A01,083743,Cinel; Cameron Alexander,9,0,30,21
1657939749052,MATH 18,A02,083744,Cinel; Cameron Alexander,18,0,30,12
1657939749052,MATH 18,A03,083745,Cinel; Cameron Alexander,10,0,30,20
1657939749052,MATH 18,B01,083748,Rideout; David Porter,5,0,37,32
1657939749052,MATH 18,B02,083749,Rideout; David Porter,5,0,36,31
1657939749052,MATH 18,B03,083750,Rideout; David Porter,3,0,37,34
1657939749052,MATH 18,B04,083751,Rideout; David Porter,7,0,36,29
1657939749052,MATH 18,B05,093473,Rideout; David Porter,7,0,36,29
1657939749052,MATH 18,B06,093474,Rideout; David Porter,6,0,36,30
1657939755076,MATH 20A,A01,083754,Zheng; Zequn,14,0,40,26
1657939761099,MATH 20B,A01,083756,Briones; Jor-el Thomas Caparas,4,0,36,32
1657939761099,MATH 20B,A02,083757,Briones; Jor-el Thomas Caparas,1,0,36,35
1657939761099,MATH 20B,A03,093475,Briones; Jor-el Thomas Caparas,3,0,36,33
1657939767121,MATH 20C,A01,083760,Briones; Jor-el Thomas Caparas,1,0,35,34
1657939767121,MATH 20C,A02,083761,Briones; Jor-el Thomas Caparas,8,0,35,27
1657939767121,MATH 20C,A03,093476,Briones; Jor-el Thomas Caparas,0,1,36,36
1657939767121,MATH 20C,B01,083762,Bach; Quang Tran,1,0,30,29
1657939773145,MATH 20D,A01,083765,Tran; Brian Kha,5,0,30,25
1657939773145,MATH 20D,A02,083766,Tran; Brian Kha,5,0,30,25
1657939773145,MATH 20D,A03,083767,Tran; Brian Kha,6,0,30,24
1657939779171,MATH 20E,A01,083771,Ganguly; Soumya,12,0,32,20
1657939779171,MATH 20E,A02,083772,Ganguly; Soumya,7,0,32,25
1657939779171,MATH 20E,B01,083773,Ciotti; Benjamin,20,0,35,15
1657939779171,MATH 20E,B02,083774,Ciotti; Benjamin,18,0,35,17
1657939785200,MATH 103A,A01,083777,Greenfeld; Be'Eri,3,0,36,33
1657939785200,MATH 103A,A02,083778,Greenfeld; Be'Eri,5,0,36,31
1657939785200,MATH 103A,A03,093561,Greenfeld; Be'Eri,6,0,36,30
1657939785200,MATH 103A,B01,083779,Greenfeld; Be'Eri,8,0,36,28
1657939785200,MATH 103A,B02,083780,Greenfeld; Be'Eri,4,0,36,32
1657939785200,MATH 103A,B03,093562,Greenfeld; Be'Eri,3,0,36,33
1657939791226,MATH 105,A01,085443,Carter; Anne Toulson,15,0,35,20
1657939791226,MATH 105,A02,093477,Carter; Anne Toulson,20,0,35,15
1657939797260,MATH 109,A01,083213,Ganzberger; Geoffrey Michael,3,0,34,31
1657939797260,MATH 109,A02,083214,Ganzberger; Geoffrey Michael,4,0,34,30
1657939797260,MATH 109,A03,093478,Ganzberger; Geoffrey Michael,2,0,34,32
1657939797260,MATH 109,B01,083215,Ganzberger; Geoffrey Michael,2,0,32,30
1657939797260,MATH 109,B02,083216,Ganzberger; Geoffrey Michael,3,0,32,29
1657939797260,MATH 109,B03,093479,Ganzberger; Geoffrey Michael,8,0,32,24
1657939803285,MATH 142A,A01,083219,Chow; Bennett,7,0,32,25
1657939803285,MATH 142A,A02,083220,Chow; Bennett,10,0,32,22
1657939803285,MATH 142A,A03,093480,Chow; Bennett,9,0,32,23
1657939803285,MATH 142A,B03,093481,Chow; Bennett,8,0,32,24
1657939803285,MATH 142A,B04,093558,Chow; Bennett,13,0,32,19
1657939803285,MATH 142A,B05,093559,Chow; Bennett,7,0,32,25
1657939809309,MATH 193A,A01,083224,Rotar; Vladimir,8,0,34,26
1657939809309,MATH 193A,A02,083225,Rotar; Vladimir,10,0,34,24
1657939809309,MATH 193A,A03,083781,Rotar; Vladimir,5,0,34,29
1657939809309,MATH 193A,A04,083782,Rotar; Vladimir,11,0,34,23
1657939809309,MATH 193A,A05,093482,Rotar; Vladimir,11,0,34,23
1657939815333,MATH 197,001,091859,McAuley; Julian John,9999,0,9999,0
1657939815333,MATH 197,002,095566,Kedlaya; Kiran S.,9997,0,9999,2
1657939815333,MATH 197,003,095567,Xiao; Ming,9999,0,9999,0
1657939815333,MATH 197,004,095571,Perols; Johan Lars,9998,0,9999,1
1657939822392,COGS 9,A01,083615,Shannon; Kyle Michael,11,0,75,64
1657939828415,COGS 11,A01,083617,Boyle; Mary E. T.,23,0,48,25
1657939834443,COGS 13,A01,083071,Bastos; Amalia Pinkusfeld,12,0,71,59
1657939840466,COGS 14A,A01,092681,Semenuks; Arturs,5,1,100,95
1657939846497,COGS 14B,A01,083073,Cheng; Tzu-Han,7,0,63,56
1657939852524,COGS 17,A01,092677,Semenuks; Arturs,7,0,81,74
1657939858547,COGS 100,A01,083619,Allen; Michael Gordon,17,0,70,53
1657939864573,COGS 101A,A01,083621,Davis; Joshua Daniel,9,0,68,59
1657939870597,COGS 101B,A01,091572,Allen; Michael Gordon,14,0,65,51
1657939876633,COGS 101C,A01,083625,Delgado; Tania,17,0,35,18
1657939882655,COGS 107A,A01,083627,Boyle; Mary E. T.,14,0,60,46
1657939888680,COGS 118A,A01,083075,Gupta; Anjum,21,0,76,55
1657939894707,CSE 3,A50,083646,Miranda; Gregory Joseph,24,0,50,26
1657939900729,CSE 8A,A50,083650,Miranda; Gregory Joseph,17,1,56,39
1657939906760,CSE 11,A01,083080,Cao; Yingjun,6,15,40,34
1657939912782,CSE 12,A01,083652,Krause-Levy; Sophia Louisa,30,1,120,90
1657939918803,CSE 15L,A01,083654,Morris; Justin Loren,9,0,50,41
1657939918803,CSE 15L,A02,083655,Morris; Justin Loren,10,0,50,40
1657939924835,CSE 20,A01,083657,Tran; Khoa Dang,39,0,80,41
1657939930858,CSE 21,A01,095574,Bach; Quang Tran,23,0,48,25
1657939936886,CSE 30,A01,083084,Eldon; John,7,0,80,73
1657939936886,CSE 30,B01,095061,Bhaskar; Nishant,9,0,50,41
1657939942909,CSE 100,A01,083659,Cao; Yingjun,5,4,70,65
1657939948932,CSE 134B,A01,083661,Powell; Thomas Allan,25,0,100,75
1657939954955,CSE 140,A01,083663,Gungor; Onat,17,0,85,68
1657939960978,CSE 140L,A01,083088,Eldon; John,23,0,100,77
1657939967005,CSE 175,A01,083665,Kumar; Rakesh,3,0,25,22
1657939973031,CSE 190,A00,092507,Dubnov; Shlomo,8,0,20,12
1657939979057,ECE 45,A01,083139,Congero; Spencer William,7,0,75,68
1657939985086,ECE 65,A50,083695,Saad; Andrew S,12,0,30,18
1657939985086,ECE 65,A51,095125,Saad; Andrew S,24,0,26,2
1657939991112,ECE 109,A01,091882,Touri; Behrouz,20,0,70,50
1657939997212,ECE 180,A00,083140,Abi Samra; Nicholas Camill,1,0,30,29
1657939997212,ECE 180,B00,083141,Abi Samra; Nicholas Camill,0,0,30,30
1657940003237,MATH 10A,A01,083735,Patchell; Gregory David,2,0,30,28
1657940003237,MATH 10A,A02,083736,Patchell; Gregory David,20,0,30,10
1657940003237,MATH 10A,A03,083737,Patchell; Gregory David,16,0,30,14
1657940009262,MATH 10B,A01,083207,Lim; Seonhee,9,0,34,25
1657940009262,MATH 10B,A02,083208,Lim; Seonhee,10,0,35,25
1657940009262,MATH 10B,A03,093472,Lim; Seonhee,7,0,34,27
1657940009262,MATH 10B,B01,083739,Sinha; Shubham,14,0,30,16
1657940015288,MATH 18,A01,083743,Cinel; Cameron Alexander,9,0,30,21
1657940015288,MATH 18,A02,083744,Cinel; Cameron Alexander,18,0,30,12
1657940015288,MATH 18,A03,083745,Cinel; Cameron Alexander,10,0,30,20
1657940015288,MATH 18,B01,083748,Rideout; David Porter,5,0,37,32
1657940015288,MATH 18,B02,083749,Rideout; David Porter,5,0,36,31
1657940015288,MATH 18,B03,083750,Rideout; David Porter,3,0,37,34
1657940015288,MATH 18,B04,083751,Rideout; David Porter,7,0,36,29
1657940015288,MATH 18,B05,093473,Rideout; David Porter,7,0,36,29
1657940015288,MATH 18,B06,093474,Rideout; David Porter,6,0,36,30
1657940021311,MATH 20A,A01,083754,Zheng; Zequn,14,0,40,26
1657940027334,MATH 20B,A01,083756,Briones; Jor-el Thomas Caparas,4,0,36,32
1657940027334,MATH 20B,A02,083757,Briones; Jor-el Thomas Caparas,1,0,36,35
1657940027334,MATH 20B,A03,093475,Briones; Jor-el Thomas Caparas,3,0,36,33
1657940033359,MATH 20C,A01,083760,Briones; Jor-el Thomas Caparas,1,0,35,34
1657940033359,MATH 20C,A02,083761,Briones; Jor-el Thomas Caparas,8,0,35,27
1657940033359,MATH 20C,A03,093476,Briones; Jor-el Thomas Caparas,0,1,36,36
1657940033359,MATH 20C,B01,083762,Bach; Quang Tran,1,0,30,29
1657940039390,MATH 20D,A01,083765,Tran; Brian Kha,5,0,30,25
1657940039390,MATH 20D,A02,083766,Tran; Brian Kha,5,0,30,25
1657940039390,MATH 20D,A03,083767,Tran; Brian Kha,6,0,30,24
1657940045414,MATH 20E,A01,083771,Ganguly; Soumya,12,0,32,20
1657940045414,MATH 20E,A02,083772,Ganguly; Soumya,7,0,32,25
1657940045414,MATH 20E,B01,083773,Ciotti; Benjamin,20,0,35,15
1657940045414,MATH 20E,B02,083774,Ciotti; Benjamin,18,0,35,17
1657940051439,MATH 103A,A01,083777,Greenfeld; Be'Eri,3,0,36,33
1657940051439,MATH 103A,A02,083778,Greenfeld; Be'Eri,5,0,36,31
1657940051439,MATH 103A,A03,093561,Greenfeld; Be'Eri,6,0,36,30
1657940051439,MATH 103A,B01,083779,Greenfeld; Be'Eri,8,0,36,28
1657940051439,MATH 103A,B02,083780,Greenfeld; Be'Eri,4,0,36,32
1657940051439,MATH 103A,B03,093562,Greenfeld; Be'Eri,3,0,36,33
1657940057462,MATH 105,A01,085443,Carter; Anne Toulson,15,0,35,20
1657940057462,MATH 105,A02,093477,Carter; Anne Toulson,20,0,35,15
1657940063487,MATH 109,A01,083213,Ganzberger; Geoffrey Michael,3,0,34,31
1657940063487,MATH 109,A02,083214,Ganzberger; Geoffrey Michael,4,0,34,30
1657940063487,MATH 109,A03,093478,Ganzberger; Geoffrey Michael,2,0,34,32
1657940063487,MATH 109,B01,083215,Ganzberger; Geoffrey Michael,2,0,32,30
1657940063487,MATH 109,B02,083216,Ganzberger; Geoffrey Michael,3,0,32,29
1657940063487,MATH 109,B03,093479,Ganzberger; Geoffrey Michael,8,0,32,24
1657940069515,MATH 142A,A01,083219,Chow; Bennett,7,0,32,25
1657940069515,MATH 142A,A02,083220,Chow; Bennett,10,0,32,22
1657940069515,MATH 142A,A03,093480,Chow; Bennett,9,0,32,23
1657940069515,MATH 142A,B03,093481,Chow; Bennett,8,0,32,24
1657940069515,MATH 142A,B04,093558,Chow; Bennett,13,0,32,19
1657940069515,MATH 142A,B05,093559,Chow; Bennett,7,0,32,25
1657940075539,MATH 193A,A01,083224,Rotar; Vladimir,8,0,34,26
1657940075539,MATH 193A,A02,083225,Rotar; Vladimir,10,0,34,24
1657940075539,MATH 193A,A03,083781,Rotar; Vladimir,5,0,34,29
1657940075539,MATH 193A,A04,083782,Rotar; Vladimir,11,0,34,23
1657940075539,MATH 193A,A05,093482,Rotar; Vladimir,11,0,34,23
1657940081560,MATH 197,001,091859,McAuley; Julian John,9999,0,9999,0
1657940081560,MATH 197,002,095566,Kedlaya; Kiran S.,9997,0,9999,2
1657940081560,MATH 197,003,095567,Xiao; Ming,9999,0,9999,0
1657940081560,MATH 197,004,095571,Perols; Johan Lars,9998,0,9999,1
1657940088623,COGS 9,A01,083615,Shannon; Kyle Michael,11,0,75,64
1657940094646,COGS 11,A01,083617,Boyle; Mary E. T.,23,0,48,25
1657940100670,COGS 13,A01,083071,Bastos; Amalia Pinkusfeld,12,0,71,59
1657940106696,COGS 14A,A01,092681,Semenuks; Arturs,5,1,100,95
1657940112718,COGS 14B,A01,083073,Cheng; Tzu-Han,7,0,63,56
1657940118739,COGS 17,A01,092677,Semenuks; Arturs,7,0,81,74
1657940124762,COGS 100,A01,083619,Allen; Michael Gordon,17,0,70,53
1657940130786,COGS 101A,A01,083621,Davis; Joshua Daniel,9,0,68,59
1657940136813,COGS 101B,A01,091572,Allen; Michael Gordon,14,0,65,51
1657940142837,COGS 101C,A01,083625,Delgado; Tania,17,0,35,18
1657940148865,COGS 107A,A01,083627,Boyle; Mary E. T.,14,0,60,46
1657940154891,COGS 118A,A01,083075,Gupta; Anjum,21,0,76,55
1657940160918,CSE 3,A50,083646,Miranda; Gregory Joseph,24,0,50,26
1657940166944,CSE 8A,A50,083650,Miranda; Gregory Joseph,17,1,56,39
1657940172970,CSE 11,A01,083080,Cao; Yingjun,6,15,40,34
1657940178994,CSE 12,A01,083652,Krause-Levy; Sophia Louisa,30,1,120,90
1657940185017,CSE 15L,A01,083654,Morris; Justin Loren,9,0,50,41
1657940185017,CSE 15L,A02,083655,Morris; Justin Loren,10,0,50,40
1657940191039,CSE 20,A01,083657,Tran; Khoa Dang,39,0,80,41
1657940197069,CSE 21,A01,095574,Bach; Quang Tran,23,0,48,25
1657940203092,CSE 30,A01,083084,Eldon; John,7,0,80,73
1657940203092,CSE 30,B01,095061,Bhaskar; Nishant,9,0,50,41
1657940209116,CSE 100,A01,083659,Cao; Yingjun,5,4,70,65
1657940215138,CSE 134B,A01,083661,Powell; Thomas Allan,25,0,100,75
1657940221166,CSE 140,A01,083663,Gungor; Onat,17,0,85,68
1657940227188,CSE 140L,A01,083088,Eldon; John,23,0,100,77
1657940233213,CSE 175,A01,083665,Kumar; Rakesh,3,0,25,22
1657940239237,CSE 190,A00,092507,Dubnov; Shlomo,8,0,20,12
1657940245261,ECE 45,A01,083139,Congero; Spencer William,7,0,75,68
1657940251285,ECE 65,A50,083695,Saad; Andrew S,12,0,30,18
1657940251285,ECE 65,A51,095125,Saad; Andrew S,24,0,26,2
1657940257307,ECE 109,A01,091882,Touri; Behrouz,20,0,70,50
1657940263333,ECE 180,A00,083140,Abi Samra; Nicholas Camill,1,0,30,29
1657940263333,ECE 180,B00,083141,Abi Samra; Nicholas Camill,0,0,30,30
1657940269358,MATH 10A,A01,083735,Patchell; Gregory David,2,0,30,28
1657940269358,MATH 10A,A02,083736,Patchell; Gregory David,20,0,30,10
1657940269358,MATH 10A,A03,083737,Patchell; Gregory David,16,0,30,14
1657940275387,MATH 10B,A01,083207,Lim; Seonhee,9,0,34,25
1657940275387,MATH 10B,A02,083208,Lim; Seonhee,10,0,35,25
1657940275387,MATH 10B,A03,093472,Lim; Seonhee,7,0,34,27
1657940275387,MATH 10B,B01,083739,Sinha; Shubham,14,0,30,16
1657940281423,MATH 18,A01,083743,Cinel; Cameron Alexander,9,0,30,21
1657940281423,MATH 18,A02,083744,Cinel; Cameron Alexander,18,0,30,12
1657940281423,MATH 18,A03,083745,Cinel; Cameron Alexander,10,0,30,20
1657940281423,MATH 18,B01,083748,Rideout; David Porter,5,0,37,32
1657940281423,MATH 18,B02,083749,Rideout; David Porter,5,0,36,31
1657940281423,MATH 18,B03,083750,Rideout; David Porter,3,0,37,34
1657940281423,MATH 18,B04,083751,Rideout; David Porter,7,0,36,29
1657940281423,MATH 18,B05,093473,Rideout; David Porter,7,0,36,29
1657940281423,MATH 18,B06,093474,Rideout; David Porter,6,0,36,30
1657940287457,MATH 20A,A01,083754,Zheng; Zequn,14,0,40,26
1657940293481,MATH 20B,A01,083756,Briones; Jor-el Thomas Caparas,4,0,36,32
1657940293481,MATH 20B,A02,083757,Briones; Jor-el Thomas Caparas,1,0,36,35
1657940293481,MATH 20B,A03,093475,Briones; Jor-el Thomas Caparas,3,0,36,33
1657940299505,MATH 20C,A01,083760,Briones; Jor-el Thomas Caparas,1,0,35,34
1657940299505,MATH 20C,A02,083761,Briones; Jor-el Thomas Caparas,8,0,35,27
1657940299505,MATH 20C,A03,093476,Briones; Jor-el Thomas Caparas,0,1,36,36
1657940299505,MATH 20C,B01,083762,Bach; Quang Tran,1,0,30,29
1657940305531,MATH 20D,A01,083765,Tran; Brian Kha,5,0,30,25
1657940305531,MATH 20D,A02,083766,Tran; Brian Kha,5,0,30,25
1657940305531,MATH 20D,A03,083767,Tran; Brian Kha,6,0,30,24
1657940311556,MATH 20E,A01,083771,Ganguly; Soumya,12,0,32,20
1657940311556,MATH 20E,A02,083772,Ganguly; Soumya,7,0,32,25
1657940311556,MATH 20E,B01,083773,Ciotti; Benjamin,20,0,35,15
1657940311556,MATH 20E,B02,083774,Ciotti; Benjamin,18,0,35,17
1657940317586,MATH 103A,A01,083777,Greenfeld; Be'Eri,3,0,36,33
1657940317586,MATH 103A,A02,083778,Greenfeld; Be'Eri,5,0,36,31
1657940317586,MATH 103A,A03,093561,Greenfeld; Be'Eri,6,0,36,30
1657940317586,MATH 103A,B01,083779,Greenfeld; Be'Eri,8,0,36,28
1657940317586,MATH 103A,B02,083780,Greenfeld; Be'Eri,4,0,36,32
1657940317586,MATH 103A,B03,093562,Greenfeld; Be'Eri,3,0,36,33
1657940323614,MATH 105,A01,085443,Carter; Anne Toulson,15,0,35,20
1657940323614,MATH 105,A02,093477,Carter; Anne Toulson,20,0,35,15
1657940329647,MATH 109,A01,083213,Ganzberger; Geoffrey Michael,3,0,34,31
1657940329647,MATH 109,A02,083214,Ganzberger; Geoffrey Michael,4,0,34,30
1657940329647,MATH 109,A03,093478,Ganzberger; Geoffrey Michael,2,0,34,32
1657940329647,MATH 109,B01,083215,Ganzberger; Geoffrey Michael,2,0,32,30
1657940329647,MATH 109,B02,083216,Ganzberger; Geoffrey Michael,3,0,32,29
1657940329647,MATH 109,B03,093479,Ganzberger; Geoffrey Michael,8,0,32,24
1657940335677,MATH 142A,A01,083219,Chow; Bennett,7,0,32,25
1657940335677,MATH 142A,A02,083220,Chow; Bennett,10,0,32,22
1657940335677,MATH 142A,A03,093480,Chow; Bennett,9,0,32,23
1657940335677,MATH 142A,B03,093481,Chow; Bennett,8,0,32,24
1657940335677,MATH 142A,B04,093558,Chow; Bennett,13,0,32,19
1657940335677,MATH 142A,B05,093559,Chow; Bennett,7,0,32,25
1657940341703,MATH 193A,A01,083224,Rotar; Vladimir,8,0,34,26
1657940341703,MATH 193A,A02,083225,Rotar; Vladimir,10,0,34,24
1657940341703,MATH 193A,A03,083781,Rotar; Vladimir,5,0,34,29
1657940341703,MATH 193A,A04,083782,Rotar; Vladimir,11,0,34,23
1657940341703,MATH 193A,A05,093482,Rotar; Vladimir,11,0,34,23
1657940347732,MATH 197,001,091859,McAuley; Julian John,9999,0,9999,0
1657940347732,MATH 197,002,095566,Kedlaya; Kiran S.,9997,0,9999,2
1657940347732,MATH 197,003,095567,Xiao; Ming,9999,0,9999,0
1657940347732,MATH 197,004,095571,Perols; Johan Lars,9998,0,9999,1
1657940354788,COGS 9,A01,083615,Shannon; Kyle Michael,11,0,75,64
1657940360813,COGS 11,A01,083617,Boyle; Mary E. T.,23,0,48,25
1657940366835,COGS 13,A01,083071,Bastos; Amalia Pinkusfeld,12,0,71,59
1657940372860,COGS 14A,A01,092681,Semenuks; Arturs,5,1,100,95
1657940378884,COGS 14B,A01,083073,Cheng; Tzu-Han,7,0,63,56
1657940384911,COGS 17,A01,092677,Semenuks; Arturs,7,0,81,74
1657940390934,COGS 100,A01,083619,Allen; Michael Gordon,17,0,70,53
1657940396957,COGS 101A,A01,083621,Davis; Joshua Daniel,9,0,68,59
1657940402982,COGS 101B,A01,091572,Allen; Michael Gordon,14,0,65,51
1657940409005,COGS 101C,A01,083625,Delgado; Tania,17,0,35,18
1657940415027,COGS 107A,A01,083627,Boyle; Mary E. T.,14,0,60,46
1657940421052,COGS 118A,A01,083075,Gupta; Anjum,21,0,76,55
1657940427075,CSE 3,A50,083646,Miranda; Gregory Joseph,24,0,50,26
1657940433097,CSE 8A,A50,083650,Miranda; Gregory Joseph,17,1,56,39
1657940439119,CSE 11,A01,083080,Cao; Yingjun,6,15,40,34
1657940445141,CSE 12,A01,083652,Krause-Levy; Sophia Louisa,30,1,120,90
1657940451165,CSE 15L,A01,083654,Morris; Justin Loren,9,0,50,41
1657940451165,CSE 15L,A02,083655,Morris; Justin Loren,10,0,50,40
1657940457188,CSE 20,A01,083657,Tran; Khoa Dang,39,0,80,41
1657940463218,CSE 21,A01,095574,Bach; Quang Tran,23,0,48,25
1657940469240,CSE 30,A01,083084,Eldon; John,7,0,80,73
1657940469240,CSE 30,B01,095061,Bhaskar; Nishant,9,0,50,41
1657940475271,CSE 100,A01,083659,Cao; Yingjun,5,4,70,65
1657940481293,CSE 134B,A01,083661,Powell; Thomas Allan,25,0,100,75
1657940487319,CSE 140,A01,083663,Gungor; Onat,17,0,85,68
1657940493346,CSE 140L,A01,083088,Eldon; John,23,0,100,77
1657940499370,CSE 175,A01,083665,Kumar; Rakesh,3,0,25,22
1657940505393,CSE 190,A00,092507,Dubnov; Shlomo,8,0,20,12
1657940511418,ECE 45,A01,083139,Congero; Spencer William,7,0,75,68
1657940517441,ECE 65,A50,083695,Saad; Andrew S,12,0,30,18
1657940517441,ECE 65,A51,095125,Saad; Andrew S,24,0,26,2
1657940523467,ECE 109,A01,091882,Touri; Behrouz,20,0,70,50
1657940529495,ECE 180,A00,083140,Abi Samra; Nicholas Camill,1,0,30,29
1657940529495,ECE 180,B00,083141,Abi Samra; Nicholas Camill,0,0,30,30
1657940535519,MATH 10A,A01,083735,Patchell; Gregory David,2,0,30,28
1657940535519,MATH 10A,A02,083736,Patchell; Gregory David,20,0,30,10
1657940535519,MATH 10A,A03,083737,Patchell; Gregory David,16,0,30,14
1657940541544,MATH 10B,A01,083207,Lim; Seonhee,9,0,34,25
1657940541544,MATH 10B,A02,083208,Lim; Seonhee,10,0,35,25
1657940541544,MATH 10B,A03,093472,Lim; Seonhee,7,0,34,27
1657940541544,MATH 10B,B01,083739,Sinha; Shubham,14,0,30,16
1657940547567,MATH 18,A01,083743,Cinel; Cameron Alexander,9,0,30,21
1657940547567,MATH 18,A02,083744,Cinel; Cameron Alexander,18,0,30,12
1657940547567,MATH 18,A03,083745,Cinel; Cameron Alexander,10,0,30,20
1657940547567,MATH 18,B01,083748,Rideout; David Porter,5,0,37,32
1657940547567,MATH 18,B02,083749,Rideout; David Porter,5,0,36,31
1657940547567,MATH 18,B03,083750,Rideout; David Porter,3,0,37,34
1657940547567,MATH 18,B04,083751,Rideout; David Porter,7,0,36,29
1657940547567,MATH 18,B05,093473,Rideout; David Porter,7,0,36,29
1657940547567,MATH 18,B06,093474,Rideout; David Porter,6,0,36,30
1657940553606,MATH 20A,A01,083754,Zheng; Zequn,14,0,40,26
1657940559630,MATH 20B,A01,083756,Briones; Jor-el Thomas Caparas,4,0,36,32
1657940559630,MATH 20B,A02,083757,Briones; Jor-el Thomas Caparas,1,0,36,35
1657940559630,MATH 20B,A03,093475,Briones; Jor-el Thomas Caparas,3,0,36,33
1657940565655,MATH 20C,A01,083760,Briones; Jor-el Thomas Caparas,1,0,35,34
1657940565655,MATH 20C,A02,083761,Briones; Jor-el Thomas Caparas,8,0,35,27
1657940565655,MATH 20C,A03,093476,Briones; Jor-el Thomas Caparas,0,1,36,36
1657940565655,MATH 20C,B01,083762,Bach; Quang Tran,1,0,30,29
1657940571677,MATH 20D,A01,083765,Tran; Brian Kha,5,0,30,25
1657940571677,MATH 20D,A02,083766,Tran; Brian Kha,5,0,30,25
1657940571677,MATH 20D,A03,083767,Tran; Brian Kha,6,0,30,24
1657940577706,MATH 20E,A01,083771,Ganguly; Soumya,12,0,32,20
1657940577706,MATH 20E,A02,083772,Ganguly; Soumya,7,0,32,25
1657940577706,MATH 20E,B01,083773,Ciotti; Benjamin,20,0,35,15
1657940577706,MATH 20E,B02,083774,Ciotti; Benjamin,18,0,35,17
1657940583735,MATH 103A,A01,083777,Greenfeld; Be'Eri,3,0,36,33
1657940583735,MATH 103A,A02,083778,Greenfeld; Be'Eri,5,0,36,31
1657940583735,MATH 103A,A03,093561,Greenfeld; Be'Eri,6,0,36,30
1657940583735,MATH 103A,B01,083779,Greenfeld; Be'Eri,8,0,36,28
1657940583735,MATH 103A,B02,083780,Greenfeld; Be'Eri,4,0,36,32
1657940583735,MATH 103A,B03,093562,Greenfeld; Be'Eri,3,0,36,33
1657940589759,MATH 105,A01,085443,Carter; Anne Toulson,15,0,35,20
1657940589759,MATH 105,A02,093477,Carter; Anne Toulson,20,0,35,15
1657940595855,MATH 109,A01,083213,Ganzberger; Geoffrey Michael,3,0,34,31
1657940595855,MATH 109,A02,083214,Ganzberger; Geoffrey Michael,4,0,34,30
1657940595855,MATH 109,A03,093478,Ganzberger; Geoffrey Michael,2,0,34,32
1657940595855,MATH 109,B01,083215,Ganzberger; Geoffrey Michael,2,0,32,30
1657940595855,MATH 109,B02,083216,Ganzberger; Geoffrey Michael,3,0,32,29
1657940595855,MATH 109,B03,093479,Ganzberger; Geoffrey Michael,8,0,32,24
1657940601879,MATH 142A,A01,083219,Chow; Bennett,7,0,32,25
1657940601879,MATH 142A,A02,083220,Chow; Bennett,10,0,32,22
1657940601879,MATH 142A,A03,093480,Chow; Bennett,9,0,32,23
1657940601879,MATH 142A,B03,093481,Chow; Bennett,8,0,32,24
1657940601879,MATH 142A,B04,093558,Chow; Bennett,13,0,32,19
1657940601879,MATH 142A,B05,093559,Chow; Bennett,7,0,32,25
1657940607904,MATH 193A,A01,083224,Rotar; Vladimir,8,0,34,26
1657940607904,MATH 193A,A02,083225,Rotar; Vladimir,10,0,34,24
1657940607904,MATH 193A,A03,083781,Rotar; Vladimir,5,0,34,29
1657940607904,MATH 193A,A04,083782,Rotar; Vladimir,11,0,34,23
1657940607904,MATH 193A,A05,093482,Rotar; Vladimir,11,0,34,23
1657940613932,MATH 197,001,091859,McAuley; Julian John,9999,0,9999,0
1657940613932,MATH 197,002,095566,Kedlaya; Kiran S.,9997,0,9999,2
1657940613932,MATH 197,003,095567,Xiao; Ming,9999,0,9999,0
1657940613932,MATH 197,004,095571,Perols; Johan Lars,9998,0,9999,1
1657940620992,COGS 9,A01,083615,Shannon; Kyle Michael,11,0,75,64
1657940627020,COGS 11,A01,083617,Boyle; Mary E. T.,23,0,48,25
1657940633044,COGS 13,A01,083071,Bastos; Amalia Pinkusfeld,12,0,71,59
1657940639072,COGS 14A,A01,092681,Semenuks; Arturs,5,1,100,95
1657940645117,COGS 14B,A01,083073,Cheng; Tzu-Han,7,0,63,56
1657940651138,COGS 17,A01,092677,Semenuks; Arturs,7,0,81,74
1657940657161,COGS 100,A01,083619,Allen; Michael Gordon,17,0,70,53
1657940663188,COGS 101A,A01,083621,Davis; Joshua Daniel,9,0,68,59
1657940669215,COGS 101B,A01,091572,Allen; Michael Gordon,14,0,65,51
1657940675242,COGS 101C,A01,083625,Delgado; Tania,17,0,35,18
1657940681268,COGS 107A,A01,083627,Boyle; Mary E. T.,14,0,60,46
1657940687291,COGS 118A,A01,083075,Gupta; Anjum,21,0,76,55
1657940693315,CSE 3,A50,083646,Miranda; Gregory Joseph,24,0,50,26
1657940699348,CSE 8A,A50,083650,Miranda; Gregory Joseph,17,1,56,39
1657940705370,CSE 11,A01,083080,Cao; Yingjun,6,15,40,34
1657940711393,CSE 12,A01,083652,Krause-Levy; Sophia Louisa,30,1,120,90
1657940717420,CSE 15L,A01,083654,Morris; Justin Loren,9,0,50,41
1657940717420,CSE 15L,A02,083655,Morris; Justin Loren,10,0,50,40
1657940723441,CSE 20,A01,083657,Tran; Khoa Dang,39,0,80,41
1657940729464,CSE 21,A01,095574,Bach; Quang Tran,23,0,48,25
1657940735497,CSE 30,A01,083084,Eldon; John,7,0,80,73
1657940735497,CSE 30,B01,095061,Bhaskar; Nishant,9,0,50,41
1657940741522,CSE 100,A01,083659,Cao; Yingjun,5,4,70,65
1657940747549,CSE 134B,A01,083661,Powell; Thomas Allan,25,0,100,75
1657940753576,CSE 140,A01,083663,Gungor; Onat,17,0,85,68
1657940759597,CSE 140L,A01,083088,Eldon; John,23,0,100,77
1657940765621,CSE 175,A01,083665,Kumar; Rakesh,3,0,25,22
1657940771647,CSE 190,A00,092507,Dubnov; Shlomo,8,0,20,12
1657940777673,ECE 45,A01,083139,Congero; Spencer William,7,0,75,68
1657940783696,ECE 65,A50,083695,Saad; Andrew S,12,0,30,18
1657940783696,ECE 65,A51,095125,Saad; Andrew S,24,0,26,2
1657940789723,ECE 109,A01,091882,Touri; Behrouz,20,0,70,50
1657940795751,ECE 180,A00,083140,Abi Samra; Nicholas Camill,1,0,30,29
1657940795751,ECE 180,B00,083141,Abi Samra; Nicholas Camill,0,0,30,30
1657940801775,MATH 10A,A01,083735,Patchell; Gregory David,2,0,30,28
1657940801775,MATH 10A,A02,083736,Patchell; Gregory David,20,0,30,10
1657940801775,MATH 10A,A03,083737,Patchell; Gregory David,16,0,30,14
1657940807803,MATH 10B,A01,083207,Lim; Seonhee,9,0,34,25
1657940807803,MATH 10B,A02,083208,Lim; Seonhee,10,0,35,25
1657940807803,MATH 10B,A03,093472,Lim; Seonhee,7,0,34,27
1657940807803,MATH 10B,B01,083739,Sinha; Shubham,14,0,30,16
1657940813836,MATH 18,A01,083743,Cinel; Cameron Alexander,9,0,30,21
1657940813836,MATH 18,A02,083744,Cinel; Cameron Alexander,18,0,30,12
1657940813836,MATH 18,A03,083745,Cinel; Cameron Alexander,10,0,30,20
1657940813836,MATH 18,B01,083748,Rideout; David Porter,5,0,37,32
1657940813836,MATH 18,B02,083749,Rideout; David Porter,5,0,36,31
1657940813836,MATH 18,B03,083750,Rideout; David Porter,3,0,37,34
1657940813836,MATH 18,B04,083751,Rideout; David Porter,7,0,36,29
1657940813836,MATH 18,B05,093473,Rideout; David Porter,7,0,36,29
1657940813836,MATH 18,B06,093474,Rideout; David Porter,6,0,36,30
1657940819862,MATH 20A,A01,083754,Zheng; Zequn,14,0,40,26
1657940825885,MATH 20B,A01,083756,Briones; Jor-el Thomas Caparas,4,0,36,32
1657940825885,MATH 20B,A02,083757,Briones; Jor-el Thomas Caparas,1,0,36,35
1657940825885,MATH 20B,A03,093475,Briones; Jor-el Thomas Caparas,3,0,36,33
1657940831907,MATH 20C,A01,083760,Briones; Jor-el Thomas Caparas,1,0,35,34
1657940831907,MATH 20C,A02,083761,Briones; Jor-el Thomas Caparas,8,0,35,27
1657940831907,MATH 20C,A03,093476,Briones; Jor-el Thomas Caparas,0,1,36,36
1657940831907,MATH 20C,B01,083762,Bach; Quang Tran,1,0,30,29
1657940837934,MATH 20D,A01,083765,Tran; Brian Kha,5,0,30,25
1657940837934,MATH 20D,A02,083766,Tran; Brian Kha,5,0,30,25
1657940837934,MATH 20D,A03,083767,Tran; Brian Kha,6,0,30,24
1657940843960,MATH 20E,A01,083771,Ganguly; Soumya,12,0,32,20
1657940843960,MATH 20E,A02,083772,Ganguly; Soumya,7,0,32,25
1657940843960,MATH 20E,B01,083773,Ciotti; Benjamin,20,0,35,15
1657940843960,MATH 20E,B02,083774,Ciotti; Benjamin,18,0,35,17
1657940849984,MATH 103A,A01,083777,Greenfeld; Be'Eri,3,0,36,33
1657940849984,MATH 103A,A02,083778,Greenfeld; Be'Eri,5,0,36,31
1657940849984,MATH 103A,A03,093561,Greenfeld; Be'Eri,6,0,36,30
1657940849984,MATH 103A,B01,083779,Greenfeld; Be'Eri,8,0,36,28
1657940849984,MATH 103A,B02,083780,Greenfeld; Be'Eri,4,0,36,32
1657940849984,MATH 103A,B03,093562,Greenfeld; Be'Eri,3,0,36,33
1657940856012,MATH 105,A01,085443,Carter; Anne Toulson,15,0,35,20
1657940856012,MATH 105,A02,093477,Carter; Anne Toulson,20,0,35,15
1657940862041,MATH 109,A01,083213,Ganzberger; Geoffrey Michael,3,0,34,31
1657940862041,MATH 109,A02,083214,Ganzberger; Geoffrey Michael,4,0,34,30
1657940862041,MATH 109,A03,093478,Ganzberger; Geoffrey Michael,2,0,34,32
1657940862041,MATH 109,B01,083215,Ganzberger; Geoffrey Michael,2,0,32,30
1657940862041,MATH 109,B02,083216,Ganzberger; Geoffrey Michael,3,0,32,29
1657940862041,MATH 109,B03,093479,Ganzberger; Geoffrey Michael,8,0,32,24
1657940868070,MATH 142A,A01,083219,Chow; Bennett,7,0,32,25
1657940868070,MATH 142A,A02,083220,Chow; Bennett,10,0,32,22
1657940868070,MATH 142A,A03,093480,Chow; Bennett,9,0,32,23
1657940868070,MATH 142A,B03,093481,Chow; Bennett,8,0,32,24
1657940868070,MATH 142A,B04,093558,Chow; Bennett,14,0,32,18
1657940868070,MATH 142A,B05,093559,Chow; Bennett,7,0,32,25
1657940874098,MATH 193A,A01,083224,Rotar; Vladimir,8,0,34,26
1657940874098,MATH 193A,A02,083225,Rotar; Vladimir,10,0,34,24
1657940874098,MATH 193A,A03,083781,Rotar; Vladimir,5,0,34,29
1657940874098,MATH 193A,A04,083782,Rotar; Vladimir,11,0,34,23
1657940874098,MATH 193A,A05,093482,Rotar; Vladimir,11,0,34,23
1657940880120,MATH 197,001,091859,McAuley; Julian John,9999,0,9999,0
1657940880120,MATH 197,002,095566,Kedlaya; Kiran S.,9997,0,9999,2
1657940880120,MATH 197,003,095567,Xiao; Ming,9999,0,9999,0
1657940880120,MATH 197,004,095571,Perols; Johan Lars,9998,0,9999,1
1657940887194,COGS 9,A01,083615,Shannon; Kyle Michael,11,0,75,64
1657940893216,COGS 11,A01,083617,Boyle; Mary E. T.,23,0,48,25
1657940899244,COGS 13,A01,083071,Bastos; Amalia Pinkusfeld,12,0,71,59
1657940905266,COGS 14A,A01,092681,Semenuks; Arturs,5,1,100,95
1657940911289,COGS 14B,A01,083073,Cheng; Tzu-Han,7,0,63,56
1657940917317,COGS 17,A01,092677,Semenuks; Arturs,7,0,81,74
1657940923341,COGS 100,A01,083619,Allen; Michael Gordon,17,0,70,53
1657940929363,COGS 101A,A01,083621,Davis; Joshua Daniel,9,0,68,59
1657940935392,COGS 101B,A01,091572,Allen; Michael Gordon,14,0,65,51
1657940941416,COGS 101C,A01,083625,Delgado; Tania,17,0,35,18
1657940947439,COGS 107A,A01,083627,Boyle; Mary E. T.,14,0,60,46
1657940953462,COGS 118A,A01,083075,Gupta; Anjum,21,0,76,55
1657940959489,CSE 3,A50,083646,Miranda; Gregory Joseph,24,0,50,26
1657940965512,CSE 8A,A50,083650,Miranda; Gregory Joseph,17,1,56,39
1657940971537,CSE 11,A01,083080,Cao; Yingjun,6,15,40,34
1657940977561,CSE 12,A01,083652,Krause-Levy; Sophia Louisa,30,1,120,90
1657940983587,CSE 15L,A01,083654,Morris; Justin Loren,9,0,50,41
1657940983587,CSE 15L,A02,083655,Morris; Justin Loren,10,0,50,40
1657940989613,CSE 20,A01,083657,Tran; Khoa Dang,39,0,80,41
1657940995643,CSE 21,A01,095574,Bach; Quang Tran,23,0,48,25
1657941001669,CSE 30,A01,083084,Eldon; John,7,0,80,73
1657941001669,CSE 30,B01,095061,Bhaskar; Nishant,9,0,50,41
1657941007690,CSE 100,A01,083659,Cao; Yingjun,5,4,70,65
1657941013714,CSE 134B,A01,083661,Powell; Thomas Allan,25,0,100,75
1657941019737,CSE 140,A01,083663,Gungor; Onat,17,0,85,68
1657941025760,CSE 140L,A01,083088,Eldon; John,23,0,100,77
1657941031782,CSE 175,A01,083665,Kumar; Rakesh,3,0,25,22
1657941037803,CSE 190,A00,092507,Dubnov; Shlomo,8,0,20,12
1657941043835,ECE 45,A01,083139,Congero; Spencer William,7,0,75,68
1657941049862,ECE 65,A50,083695,Saad; Andrew S,12,0,30,18
1657941049862,ECE 65,A51,095125,Saad; Andrew S,24,0,26,2
1657941055885,ECE 109,A01,091882,Touri; Behrouz,20,0,70,50
1657941061908,ECE 180,A00,083140,Abi Samra; Nicholas Camill,1,0,30,29
1657941061908,ECE 180,B00,083141,Abi Samra; Nicholas Camill,0,0,30,30
1657941067934,MATH 10A,A01,083735,Patchell; Gregory David,2,0,30,28
1657941067934,MATH 10A,A02,083736,Patchell; Gregory David,20,0,30,10
1657941067934,MATH 10A,A03,083737,Patchell; Gregory David,16,0,30,14
1657941073962,MATH 10B,A01,083207,Lim; Seonhee,9,0,34,25
1657941073962,MATH 10B,A02,083208,Lim; Seonhee,10,0,35,25
1657941073962,MATH 10B,A03,093472,Lim; Seonhee,7,0,34,27
1657941073962,MATH 10B,B01,083739,Sinha; Shubham,14,0,30,16
1657941079988,MATH 18,A01,083743,Cinel; Cameron Alexander,9,0,30,21
1657941079988,MATH 18,A02,083744,Cinel; Cameron Alexander,18,0,30,12
1657941079988,MATH 18,A03,083745,Cinel; Cameron Alexander,10,0,30,20
1657941079988,MATH 18,B01,083748,Rideout; David Porter,5,0,37,32
1657941079988,MATH 18,B02,083749,Rideout; David Porter,5,0,36,31
1657941079988,MATH 18,B03,083750,Rideout; David Porter,3,0,37,34
1657941079988,MATH 18,B04,083751,Rideout; David Porter,7,0,36,29
1657941079988,MATH 18,B05,093473,Rideout; David Porter,7,0,36,29
1657941079988,MATH 18,B06,093474,Rideout; David Porter,6,0,36,30
1657941086015,MATH 20A,A01,083754,Zheng; Zequn,14,0,40,26
1657941092039,MATH 20B,A01,083756,Briones; Jor-el Thomas Caparas,4,0,36,32
1657941092039,MATH 20B,A02,083757,Briones; Jor-el Thomas Caparas,1,0,36,35
1657941092039,MATH 20B,A03,093475,Briones; Jor-el Thomas Caparas,3,0,36,33
1657941098064,MATH 20C,A01,083760,Briones; Jor-el Thomas Caparas,1,0,35,34
1657941098064,MATH 20C,A02,083761,Briones; Jor-el Thomas Caparas,8,0,35,27
1657941098064,MATH 20C,A03,093476,Briones; Jor-el Thomas Caparas,0,1,36,36
1657941098064,MATH 20C,B01,083762,Bach; Quang Tran,1,0,30,29
1657941104089,MATH 20D,A01,083765,Tran; Brian Kha,5,0,30,25
1657941104089,MATH 20D,A02,083766,Tran; Brian Kha,5,0,30,25
1657941104089,MATH 20D,A03,083767,Tran; Brian Kha,6,0,30,24
1657941110111,MATH 20E,A01,083771,Ganguly; Soumya,12,0,32,20
1657941110111,MATH 20E,A02,083772,Ganguly; Soumya,7,0,32,25
1657941110111,MATH 20E,B01,083773,Ciotti; Benjamin,20,0,35,15
1657941110111,MATH 20E,B02,083774,Ciotti; Benjamin,18,0,35,17
1657941116142,MATH 103A,A01,083777,Greenfeld; Be'Eri,3,0,36,33
1657941116142,MATH 103A,A02,083778,Greenfeld; Be'Eri,5,0,36,31
1657941116142,MATH 103A,A03,093561,Greenfeld; Be'Eri,6,0,36,30
1657941116142,MATH 103A,B01,083779,Greenfeld; Be'Eri,8,0,36,28
1657941116142,MATH 103A,B02,083780,Greenfeld; Be'Eri,4,0,36,32
1657941116142,MATH 103A,B03,093562,Greenfeld; Be'Eri,3,0,36,33
1657941122168,MATH 105,A01,085443,Carter; Anne Toulson,15,0,35,20
1657941122168,MATH 105,A02,093477,Carter; Anne Toulson,20,0,35,15
1657941128191,MATH 109,A01,083213,Ganzberger; Geoffrey Michael,3,0,34,31
1657941128191,MATH 109,A02,083214,Ganzberger; Geoffrey Michael,4,0,34,30
1657941128191,MATH 109,A03,093478,Ganzberger; Geoffrey Michael,2,0,34,32
1657941128191,MATH 109,B01,083215,Ganzberger; Geoffrey Michael,2,0,32,30
1657941128191,MATH 109,B02,083216,Ganzberger; Geoffrey Michael,3,0,32,29
1657941128191,MATH 109,B03,093479,Ganzberger; Geoffrey Michael,8,0,32,24
1657941134220,MATH 142A,A01,083219,Chow; Bennett,7,0,32,25
1657941134220,MATH 142A,A02,083220,Chow; Bennett,10,0,32,22
1657941134220,MATH 142A,A03,093480,Chow; Bennett,9,0,32,23
1657941134220,MATH 142A,B03,093481,Chow; Bennett,8,0,32,24
1657941134220,MATH 142A,B04,093558,Chow; Bennett,14,0,32,18
1657941134220,MATH 142A,B05,093559,Chow; Bennett,7,0,32,25
1657941140249,MATH 193A,A01,083224,Rotar; Vladimir,8,0,34,26
1657941140249,MATH 193A,A02,083225,Rotar; Vladimir,10,0,34,24
1657941140249,MATH 193A,A03,083781,Rotar; Vladimir,5,0,34,29
1657941140249,MATH 193A,A04,083782,Rotar; Vladimir,11,0,34,23
1657941140249,MATH 193A,A05,093482,Rotar; Vladimir,11,0,34,23
1657941146276,MATH 197,001,091859,McAuley; Julian John,9999,0,9999,0
1657941146276,MATH 197,002,095566,Kedlaya; Kiran S.,9997,0,9999,2
1657941146276,MATH 197,003,095567,Xiao; Ming,9999,0,9999,0
1657941146276,MATH 197,004,095571,Perols; Johan Lars,9998,0,9999,1
1657941153344,COGS 9,A01,083615,Shannon; Kyle Michael,11,0,75,64
1657941159369,COGS 11,A01,083617,Boyle; Mary E. T.,23,0,48,25
1657941165392,COGS 13,A01,083071,Bastos; Amalia Pinkusfeld,12,0,71,59
1657941171419,COGS 14A,A01,092681,Semenuks; Arturs,5,1,100,95
1657941177444,COGS 14B,A01,083073,Cheng; Tzu-Han,7,0,63,56
1657941183467,COGS 17,A01,092677,Semenuks; Arturs,7,0,81,74
1657941189580,COGS 100,A01,083619,Allen; Michael Gordon,17,0,70,53
1657941195606,COGS 101A,A01,083621,Davis; Joshua Daniel,9,0,68,59
1657941201628,COGS 101B,A01,091572,Allen; Michael Gordon,14,0,65,51
1657941207655,COGS 101C,A01,083625,Delgado; Tania,17,0,35,18
1657941213677,COGS 107A,A01,083627,Boyle; Mary E. T.,14,0,60,46
1657941219706,COGS 118A,A01,083075,Gupta; Anjum,21,0,76,55
1657941225733,CSE 3,A50,083646,Miranda; Gregory Joseph,24,0,50,26
1657941231761,CSE 8A,A50,083650,Miranda; Gregory Joseph,17,1,56,39
1657941237788,CSE 11,A01,083080,Cao; Yingjun,6,15,40,34
1657941243810,CSE 12,A01,083652,Krause-Levy; Sophia Louisa,30,1,120,90
1657941249834,CSE 15L,A01,083654,Morris; Justin Loren,9,0,50,41
1657941249834,CSE 15L,A02,083655,Morris; Justin Loren,10,0,50,40
1657941255859,CSE 20,A01,083657,Tran; Khoa Dang,39,0,80,41
1657941261888,CSE 21,A01,095574,Bach; Quang Tran,23,0,48,25
1657941267916,CSE 30,A01,083084,Eldon; John,7,0,80,73
1657941267916,CSE 30,B01,095061,Bhaskar; Nishant,9,0,50,41
1657941273942,CSE 100,A01,083659,Cao; Yingjun,5,4,70,65
1657941279967,CSE 134B,A01,083661,Powell; Thomas Allan,25,0,100,75
1657941285994,CSE 140,A01,083663,Gungor; Onat,17,0,85,68
1657941292018,CSE 140L,A01,083088,Eldon; John,23,0,100,77
1657941298044,CSE 175,A01,083665,Kumar; Rakesh,3,0,25,22
1657941304070,CSE 190,A00,092507,Dubnov; Shlomo,8,0,20,12
1657941310094,ECE 45,A01,083139,Congero; Spencer William,7,0,75,68
1657941316116,ECE 65,A50,083695,Saad; Andrew S,12,0,30,18
1657941316116,ECE 65,A51,095125,Saad; Andrew S,24,0,26,2
1657941322142,ECE 109,A01,091882,Touri; Behrouz,20,0,70,50
1657941328168,ECE 180,A00,083140,Abi Samra; Nicholas Camill,1,0,30,29
1657941328168,ECE 180,B00,083141,Abi Samra; Nicholas Camill,0,0,30,30
1657941334194,MATH 10A,A01,083735,Patchell; Gregory David,2,0,30,28
1657941334194,MATH 10A,A02,083736,Patchell; Gregory David,20,0,30,10
1657941334194,MATH 10A,A03,083737,Patchell; Gregory David,16,0,30,14
1657941340219,MATH 10B,A01,083207,Lim; Seonhee,9,0,34,25
1657941340219,MATH 10B,A02,083208,Lim; Seonhee,10,0,35,25
1657941340219,MATH 10B,A03,093472,Lim; Seonhee,7,0,34,27
1657941340219,MATH 10B,B01,083739,Sinha; Shubham,14,0,30,16
1657941346242,MATH 18,A01,083743,Cinel; Cameron Alexander,9,0,30,21
1657941346242,MATH 18,A02,083744,Cinel; Cameron Alexander,18,0,30,12
1657941346242,MATH 18,A03,083745,Cinel; Cameron Alexander,10,0,30,20
1657941346242,MATH 18,B01,083748,Rideout; David Porter,5,0,37,32
1657941346242,MATH 18,B02,083749,Rideout; David Porter,5,0,36,31
1657941346242,MATH 18,B03,083750,Rideout; David Porter,3,0,37,34
1657941346242,MATH 18,B04,083751,Rideout; David Porter,7,0,36,29
1657941346242,MATH 18,B05,093473,Rideout; David Porter,7,0,36,29
1657941346242,MATH 18,B06,093474,Rideout; David Porter,6,0,36,30
1657941352267,MATH 20A,A01,083754,Zheng; Zequn,14,0,40,26
1657941358291,MATH 20B,A01,083756,Briones; Jor-el Thomas Caparas,4,0,36,32
1657941358291,MATH 20B,A02,083757,Briones; Jor-el Thomas Caparas,1,0,36,35
1657941358291,MATH 20B,A03,093475,Briones; Jor-el Thomas Caparas,3,0,36,33
1657941364319,MATH 20C,A01,083760,Briones; Jor-el Thomas Caparas,1,0,35,34
1657941364319,MATH 20C,A02,083761,Briones; Jor-el Thomas Caparas,8,0,35,27
1657941364319,MATH 20C,A03,093476,Briones; Jor-el Thomas Caparas,0,1,36,36
1657941364319,MATH 20C,B01,083762,Bach; Quang Tran,1,0,30,29
1657941370348,MATH 20D,A01,083765,Tran; Brian Kha,5,0,30,25
1657941370348,MATH 20D,A02,083766,Tran; Brian Kha,5,0,30,25
1657941370348,MATH 20D,A03,083767,Tran; Brian Kha,6,0,30,24
1657941376413,MATH 20E,A01,083771,Ganguly; Soumya,12,0,32,20
1657941376413,MATH 20E,A02,083772,Ganguly; Soumya,7,0,32,25
1657941376413,MATH 20E,B01,083773,Ciotti; Benjamin,20,0,35,15
1657941376413,MATH 20E,B02,083774,Ciotti; Benjamin,18,0,35,17
1657941382444,MATH 103A,A01,083777,Greenfeld; Be'Eri,3,0,36,33
1657941382444,MATH 103A,A02,083778,Greenfeld; Be'Eri,5,0,36,31
1657941382444,MATH 103A,A03,093561,Greenfeld; Be'Eri,6,0,36,30
1657941382444,MATH 103A,B01,083779,Greenfeld; Be'Eri,8,0,36,28
1657941382444,MATH 103A,B02,083780,Greenfeld; Be'Eri,4,0,36,32
1657941382444,MATH 103A,B03,093562,Greenfeld; Be'Eri,3,0,36,33
1657941388467,MATH 105,A01,085443,Carter; Anne Toulson,15,0,35,20
1657941388467,MATH 105,A02,093477,Carter; Anne Toulson,20,0,35,15
1657941394491,MATH 109,A01,083213,Ganzberger; Geoffrey Michael,3,0,34,31
1657941394491,MATH 109,A02,083214,Ganzberger; Geoffrey Michael,4,0,34,30
1657941394491,MATH 109,A03,093478,Ganzberger; Geoffrey Michael,2,0,34,32
1657941394491,MATH 109,B01,083215,Ganzberger; Geoffrey Michael,2,0,32,30
1657941394491,MATH 109,B02,083216,Ganzberger; Geoffrey Michael,3,0,32,29
1657941394491,MATH 109,B03,093479,Ganzberger; Geoffrey Michael,8,0,32,24
1657941400515,MATH 142A,A01,083219,Chow; Bennett,7,0,32,25
1657941400515,MATH 142A,A02,083220,Chow; Bennett,10,0,32,22
1657941400515,MATH 142A,A03,093480,Chow; Bennett,9,0,32,23
1657941400515,MATH 142A,B03,093481,Chow; Bennett,8,0,32,24
1657941400515,MATH 142A,B04,093558,Chow; Bennett,14,0,32,18
1657941400515,MATH 142A,B05,093559,Chow; Bennett,7,0,32,25
1657941406538,MATH 193A,A01,083224,Rotar; Vladimir,8,0,34,26
1657941406538,MATH 193A,A02,083225,Rotar; Vladimir,10,0,34,24
1657941406538,MATH 193A,A03,083781,Rotar; Vladimir,5,0,34,29
1657941406538,MATH 193A,A04,083782,Rotar; Vladimir,11,0,34,23
1657941406538,MATH 193A,A05,093482,Rotar; Vladimir,11,0,34,23
1657941412561,MATH 197,001,091859,McAuley; Julian John,9999,0,9999,0
1657941412561,MATH 197,002,095566,Kedlaya; Kiran S.,9997,0,9999,2
1657941412561,MATH 197,003,095567,Xiao; Ming,9999,0,9999,0
1657941412561,MATH 197,004,095571,Perols; Johan Lars,9998,0,9999,1
1657941419616,COGS 9,A01,083615,Shannon; Kyle Michael,11,0,75,64
1657941425639,COGS 11,A01,083617,Boyle; Mary E. T.,23,0,48,25
1657941431666,COGS 13,A01,083071,Bastos; Amalia Pinkusfeld,12,0,71,59
1657941437689,COGS 14A,A01,092681,Semenuks; Arturs,5,1,100,95
1657941443717,COGS 14B,A01,083073,Cheng; Tzu-Han,7,0,63,56
1657941449740,COGS 17,A01,092677,Semenuks; Arturs,7,0,81,74
1657941455762,COGS 100,A01,083619,Allen; Michael Gordon,17,0,70,53
1657941461786,COGS 101A,A01,083621,Davis; Joshua Daniel,9,0,68,59
1657941467810,COGS 101B,A01,091572,Allen; Michael Gordon,14,0,65,51
1657941473837,COGS 101C,A01,083625,Delgado; Tania,17,0,35,18
1657941479861,COGS 107A,A01,083627,Boyle; Mary E. T.,14,0,60,46
1657941485888,COGS 118A,A01,083075,Gupta; Anjum,21,0,76,55
1657941491912,CSE 3,A50,083646,Miranda; Gregory Joseph,24,0,50,26
1657941497935,CSE 8A,A50,083650,Miranda; Gregory Joseph,17,1,56,39
1657941503959,CSE 11,A01,083080,Cao; Yingjun,6,15,40,34
1657941509982,CSE 12,A01,083652,Krause-Levy; Sophia Louisa,30,1,120,90
1657941516009,CSE 15L,A01,083654,Morris; Justin Loren,9,0,50,41
1657941516009,CSE 15L,A02,083655,Morris; Justin Loren,10,0,50,40
1657941522033,CSE 20,A01,083657,Tran; Khoa Dang,39,0,80,41
1657941528073,CSE 21,A01,095574,Bach; Quang Tran,23,0,48,25
1657941534095,CSE 30,A01,083084,Eldon; John,7,0,80,73
1657941534095,CSE 30,B01,095061,Bhaskar; Nishant,9,0,50,41
1657941540119,CSE 100,A01,083659,Cao; Yingjun,5,4,70,65
1657941546144,CSE 134B,A01,083661,Powell; Thomas Allan,25,0,100,75
1657941552167,CSE 140,A01,083663,Gungor; Onat,17,0,85,68
1657941558194,CSE 140L,A01,083088,Eldon; John,23,0,100,77
1657941564216,CSE 175,A01,083665,Kumar; Rakesh,3,0,25,22
1657941570239,CSE 190,A00,092507,Dubnov; Shlomo,8,0,20,12
1657941576267,ECE 45,A01,083139,Congero; Spencer William,7,0,75,68
1657941582290,ECE 65,A50,083695,Saad; Andrew S,12,0,30,18
1657941582290,ECE 65,A51,095125,Saad; Andrew S,24,0,26,2
1657941588317,ECE 109,A01,091882,Touri; Behrouz,20,0,70,50
1657941594340,ECE 180,A00,083140,Abi Samra; Nicholas Camill,1,0,30,29
1657941594340,ECE 180,B00,083141,Abi Samra; Nicholas Camill,0,0,30,30
1657941600371,MATH 10A,A01,083735,Patchell; Gregory David,2,0,30,28
1657941600371,MATH 10A,A02,083736,Patchell; Gregory David,20,0,30,10
1657941600371,MATH 10A,A03,083737,Patchell; Gregory David,16,0,30,14
1657941606399,MATH 10B,A01,083207,Lim; Seonhee,9,0,34,25
1657941606399,MATH 10B,A02,083208,Lim; Seonhee,10,0,35,25
1657941606399,MATH 10B,A03,093472,Lim; Seonhee,7,0,34,27
1657941606399,MATH 10B,B01,083739,Sinha; Shubham,14,0,30,16
1657941612430,MATH 18,A01,083743,Cinel; Cameron Alexander,9,0,30,21
1657941612430,MATH 18,A02,083744,Cinel; Cameron Alexander,18,0,30,12
1657941612430,MATH 18,A03,083745,Cinel; Cameron Alexander,10,0,30,20
1657941612430,MATH 18,B01,083748,Rideout; David Porter,5,0,37,32
1657941612430,MATH 18,B02,083749,Rideout; David Porter,5,0,36,31
1657941612430,MATH 18,B03,083750,Rideout; David Porter,3,0,37,34
1657941612430,MATH 18,B04,083751,Rideout; David Porter,7,0,36,29
1657941612430,MATH 18,B05,093473,Rideout; David Porter,7,0,36,29
1657941612430,MATH 18,B06,093474,Rideout; David Porter,6,0,36,30
1657941618452,MATH 20A,A01,083754,Zheng; Zequn,14,0,40,26
1657941624476,MATH 20B,A01,083756,Briones; Jor-el Thomas Caparas,4,0,36,32
1657941624476,MATH 20B,A02,083757,Briones; Jor-el Thomas Caparas,1,0,36,35
1657941624476,MATH 20B,A03,093475,Briones; Jor-el Thomas Caparas,3,0,36,33
1657941630505,MATH 20C,A01,083760,Briones; Jor-el Thomas Caparas,1,0,35,34
1657941630505,MATH 20C,A02,083761,Briones; Jor-el Thomas Caparas,8,0,35,27
1657941630505,MATH 20C,A03,093476,Briones; Jor-el Thomas Caparas,0,1,36,36
1657941630505,MATH 20C,B01,083762,Bach; Quang Tran,1,0,30,29
1657941636529,MATH 20D,A01,083765,Tran; Brian Kha,5,0,30,25
1657941636529,MATH 20D,A02,083766,Tran; Brian Kha,5,0,30,25
1657941636529,MATH 20D,A03,083767,Tran; Brian Kha,6,0,30,24
1657941642551,MATH 20E,A01,083771,Ganguly; Soumya,12,0,32,20
1657941642551,MATH 20E,A02,083772,Ganguly; Soumya,7,0,32,25
1657941642551,MATH 20E,B01,083773,Ciotti; Benjamin,20,0,35,15
1657941642551,MATH 20E,B02,083774,Ciotti; Benjamin,18,0,35,17
1657941648575,MATH 103A,A01,083777,Greenfeld; Be'Eri,3,0,36,33
1657941648575,MATH 103A,A02,083778,Greenfeld; Be'Eri,5,0,36,31
1657941648575,MATH 103A,A03,093561,Greenfeld; Be'Eri,6,0,36,30
1657941648575,MATH 103A,B01,083779,Greenfeld; Be'Eri,8,0,36,28
1657941648575,MATH 103A,B02,083780,Greenfeld; Be'Eri,4,0,36,32
1657941648575,MATH 103A,B03,093562,Greenfeld; Be'Eri,3,0,36,33
1657941654600,MATH 105,A01,085443,Carter; Anne Toulson,15,0,35,20
1657941654600,MATH 105,A02,093477,Carter; Anne Toulson,20,0,35,15
1657941660628,MATH 109,A01,083213,Ganzberger; Geoffrey Michael,3,0,34,31
1657941660628,MATH 109,A02,083214,Ganzberger; Geoffrey Michael,4,0,34,30
1657941660628,MATH 109,A03,093478,Ganzberger; Geoffrey Michael,2,0,34,32
1657941660628,MATH 109,B01,083215,Ganzberger; Geoffrey Michael,2,0,32,30
1657941660628,MATH 109,B02,083216,Ganzberger; Geoffrey Michael,3,0,32,29
1657941660628,MATH 109,B03,093479,Ganzberger; Geoffrey Michael,8,0,32,24
1657941666658,MATH 142A,A01,083219,Chow; Bennett,7,0,32,25
1657941666658,MATH 142A,A02,083220,Chow; Bennett,10,0,32,22
1657941666658,MATH 142A,A03,093480,Chow; Bennett,9,0,32,23
1657941666658,MATH 142A,B03,093481,Chow; Bennett,8,0,32,24
1657941666658,MATH 142A,B04,093558,Chow; Bennett,14,0,32,18
1657941666658,MATH 142A,B05,093559,Chow; Bennett,7,0,32,25
1657941672686,MATH 193A,A01,083224,Rotar; Vladimir,8,0,34,26
1657941672686,MATH 193A,A02,083225,Rotar; Vladimir,10,0,34,24
1657941672686,MATH 193A,A03,083781,Rotar; Vladimir,5,0,34,29
1657941672686,MATH 193A,A04,083782,Rotar; Vladimir,11,0,34,23
1657941672686,MATH 193A,A05,093482,Rotar; Vladimir,11,0,34,23
1657941678710,MATH 197,001,091859,McAuley; Julian John,9999,0,9999,0
1657941678710,MATH 197,002,095566,Kedlaya; Kiran S.,9997,0,9999,2
1657941678710,MATH 197,003,095567,Xiao; Ming,9999,0,9999,0
1657941678710,MATH 197,004,095571,Perols; Johan Lars,9998,0,9999,1
1657941685771,COGS 9,A01,083615,Shannon; Kyle Michael,11,0,75,64
1657941691793,COGS 11,A01,083617,Boyle; Mary E. T.,23,0,48,25
1657941697820,COGS 13,A01,083071,Bastos; Amalia Pinkusfeld,12,0,71,59
1657941703844,COGS 14A,A01,092681,Semenuks; Arturs,5,1,100,95
1657941709870,COGS 14B,A01,083073,Cheng; Tzu-Han,7,0,63,56
1657941715894,COGS 17,A01,092677,Semenuks; Arturs,7,0,81,74
1657941721920,COGS 100,A01,083619,Allen; Michael Gordon,17,0,70,53
1657941727946,COGS 101A,A01,083621,Davis; Joshua Daniel,9,0,68,59
1657941733973,COGS 101B,A01,091572,Allen; Michael Gordon,14,0,65,51
1657941740001,COGS 101C,A01,083625,Delgado; Tania,17,0,35,18
1657941746028,COGS 107A,A01,083627,Boyle; Mary E. T.,14,0,60,46
1657941752056,COGS 118A,A01,083075,Gupta; Anjum,21,0,76,55
1657941758081,CSE 3,A50,083646,Miranda; Gregory Joseph,24,0,50,26
1657941764109,CSE 8A,A50,083650,Miranda; Gregory Joseph,17,1,56,39
1657941770133,CSE 11,A01,083080,Cao; Yingjun,6,15,40,34
1657941776169,CSE 12,A01,083652,Krause-Levy; Sophia Louisa,30,1,120,90
1657941782197,CSE 15L,A01,083654,Morris; Justin Loren,9,0,50,41
1657941782197,CSE 15L,A02,083655,Morris; Justin Loren,10,0,50,40
1657941788308,CSE 20,A01,083657,Tran; Khoa Dang,39,0,80,41
1657941794332,CSE 21,A01,095574,Bach; Quang Tran,23,0,48,25
1657941800355,CSE 30,A01,083084,Eldon; John,7,0,80,73
1657941800355,CSE 30,B01,095061,Bhaskar; Nishant,9,0,50,41
1657941806382,CSE 100,A01,083659,Cao; Yingjun,5,4,70,65
1657941812406,CSE 134B,A01,083661,Powell; Thomas Allan,25,0,100,75
1657941818432,CSE 140,A01,083663,Gungor; Onat,17,0,85,68
1657941824458,CSE 140L,A01,083088,Eldon; John,23,0,100,77
1657941830492,CSE 175,A01,083665,Kumar; Rakesh,3,0,25,22
1657941836530,CSE 190,A00,092507,Dubnov; Shlomo,8,0,20,12
1657941842554,ECE 45,A01,083139,Congero; Spencer William,7,0,75,68
1657941848576,ECE 65,A50,083695,Saad; Andrew S,12,0,30,18
1657941848576,ECE 65,A51,095125,Saad; Andrew S,24,0,26,2
1657941854600,ECE 109,A01,091882,Touri; Behrouz,20,0,70,50
1657941860627,ECE 180,A00,083140,Abi Samra; Nicholas Camill,1,0,30,29
1657941860627,ECE 180,B00,083141,Abi Samra; Nicholas Camill,0,0,30,30
1657941866654,MATH 10A,A01,083735,Patchell; Gregory David,2,0,30,28
1657941866654,MATH 10A,A02,083736,Patchell; Gregory David,20,0,30,10
1657941866654,MATH 10A,A03,083737,Patchell; Gregory David,16,0,30,14
1657941872677,MATH 10B,A01,083207,Lim; Seonhee,9,0,34,25
1657941872677,MATH 10B,A02,083208,Lim; Seonhee,10,0,35,25
1657941872677,MATH 10B,A03,093472,Lim; Seonhee,7,0,34,27
1657941872677,MATH 10B,B01,083739,Sinha; Shubham,14,0,30,16
1657941878702,MATH 18,A01,083743,Cinel; Cameron Alexander,9,0,30,21
1657941878702,MATH 18,A02,083744,Cinel; Cameron Alexander,18,0,30,12
1657941878702,MATH 18,A03,083745,Cinel; Cameron Alexander,10,0,30,20
1657941878702,MATH 18,B01,083748,Rideout; David Porter,5,0,37,32
1657941878702,MATH 18,B02,083749,Rideout; David Porter,5,0,36,31
1657941878702,MATH 18,B03,083750,Rideout; David Porter,3,0,37,34
1657941878702,MATH 18,B04,083751,Rideout; David Porter,7,0,36,29
1657941878702,MATH 18,B05,093473,Rideout; David Porter,7,0,36,29
1657941878702,MATH 18,B06,093474,Rideout; David Porter,6,0,36,30
1657941884729,MATH 20A,A01,083754,Zheng; Zequn,14,0,40,26
1657941890752,MATH 20B,A01,083756,Briones; Jor-el Thomas Caparas,4,0,36,32
1657941890752,MATH 20B,A02,083757,Briones; Jor-el Thomas Caparas,1,0,36,35
1657941890752,MATH 20B,A03,093475,Briones; Jor-el Thomas Caparas,3,0,36,33
1657941896781,MATH 20C,A01,083760,Briones; Jor-el Thomas Caparas,1,0,35,34
1657941896781,MATH 20C,A02,083761,Briones; Jor-el Thomas Caparas,8,0,35,27
1657941896781,MATH 20C,A03,093476,Briones; Jor-el Thomas Caparas,0,1,36,36
1657941896781,MATH 20C,B01,083762,Bach; Quang Tran,1,0,30,29
1657941902810,MATH 20D,A01,083765,Tran; Brian Kha,5,0,30,25
1657941902810,MATH 20D,A02,083766,Tran; Brian Kha,5,0,30,25
1657941902810,MATH 20D,A03,083767,Tran; Brian Kha,6,0,30,24
1657941908832,MATH 20E,A01,083771,Ganguly; Soumya,12,0,32,20
1657941908832,MATH 20E,A02,083772,Ganguly; Soumya,7,0,32,25
1657941908832,MATH 20E,B01,083773,Ciotti; Benjamin,20,0,35,15
1657941908832,MATH 20E,B02,083774,Ciotti; Benjamin,18,0,35,17
1657941914862,MATH 103A,A01,083777,Greenfeld; Be'Eri,3,0,36,33
1657941914862,MATH 103A,A02,083778,Greenfeld; Be'Eri,5,0,36,31
1657941914862,MATH 103A,A03,093561,Greenfeld; Be'Eri,6,0,36,30
1657941914862,MATH 103A,B01,083779,Greenfeld; Be'Eri,8,0,36,28
1657941914862,MATH 103A,B02,083780,Greenfeld; Be'Eri,4,0,36,32
1657941914862,MATH 103A,B03,093562,Greenfeld; Be'Eri,3,0,36,33
1657941920889,MATH 105,A01,085443,Carter; Anne Toulson,15,0,35,20
1657941920889,MATH 105,A02,093477,Carter; Anne Toulson,20,0,35,15
1657941926920,MATH 109,A01,083213,Ganzberger; Geoffrey Michael,3,0,34,31
1657941926920,MATH 109,A02,083214,Ganzberger; Geoffrey Michael,4,0,34,30
1657941926920,MATH 109,A03,093478,Ganzberger; Geoffrey Michael,2,0,34,32
1657941926920,MATH 109,B01,083215,Ganzberger; Geoffrey Michael,2,0,32,30
1657941926920,MATH 109,B02,083216,Ganzberger; Geoffrey Michael,3,0,32,29
1657941926920,MATH 109,B03,093479,Ganzberger; Geoffrey Michael,8,0,32,24
1657941932951,MATH 142A,A01,083219,Chow; Bennett,7,0,32,25
1657941932951,MATH 142A,A02,083220,Chow; Bennett,10,0,32,22
1657941932951,MATH 142A,A03,093480,Chow; Bennett,9,0,32,23
1657941932951,MATH 142A,B03,093481,Chow; Bennett,8,0,32,24
1657941932951,MATH 142A,B04,093558,Chow; Bennett,14,0,32,18
1657941932951,MATH 142A,B05,093559,Chow; Bennett,7,0,32,25
1657941938980,MATH 193A,A01,083224,Rotar; Vladimir,8,0,34,26
1657941938980,MATH 193A,A02,083225,Rotar; Vladimir,10,0,34,24
1657941938980,MATH 193A,A03,083781,Rotar; Vladimir,5,0,34,29
1657941938980,MATH 193A,A04,083782,Rotar; Vladimir,11,0,34,23
1657941938980,MATH 193A,A05,093482,Rotar; Vladimir,11,0,34,23
1657941945004,MATH 197,001,091859,McAuley; Julian John,9999,0,9999,0
1657941945004,MATH 197,002,095566,Kedlaya; Kiran S.,9997,0,9999,2
1657941945004,MATH 197,003,095567,Xiao; Ming,9999,0,9999,0
1657941945004,MATH 197,004,095571,Perols; Johan Lars,9998,0,9999,1
1657941952071,COGS 9,A01,083615,Shannon; Kyle Michael,11,0,75,64
1657941958096,COGS 11,A01,083617,Boyle; Mary E. T.,23,0,48,25
1657941964124,COGS 13,A01,083071,Bastos; Amalia Pinkusfeld,12,0,71,59
1657941970149,COGS 14A,A01,092681,Semenuks; Arturs,5,1,100,95
1657941976172,COGS 14B,A01,083073,Cheng; Tzu-Han,7,0,63,56
1657941982193,COGS 17,A01,092677,Semenuks; Arturs,7,0,81,74
1657941988219,COGS 100,A01,083619,Allen; Michael Gordon,17,0,70,53
1657941994248,COGS 101A,A01,083621,Davis; Joshua Daniel,9,0,68,59
1657942000271,COGS 101B,A01,091572,Allen; Michael Gordon,14,0,65,51
1657942006295,COGS 101C,A01,083625,Delgado; Tania,17,0,35,18
1657942012317,COGS 107A,A01,083627,Boyle; Mary E. T.,14,0,60,46
1657942018341,COGS 118A,A01,083075,Gupta; Anjum,21,0,76,55
1657942024365,CSE 3,A50,083646,Miranda; Gregory Joseph,24,0,50,26
1657942030393,CSE 8A,A50,083650,Miranda; Gregory Joseph,17,1,56,39
1657942036416,CSE 11,A01,083080,Cao; Yingjun,6,15,40,34
1657942042440,CSE 12,A01,083652,Krause-Levy; Sophia Louisa,30,1,120,90
1657942048474,CSE 15L,A01,083654,Morris; Justin Loren,9,0,50,41
1657942048474,CSE 15L,A02,083655,Morris; Justin Loren,10,0,50,40
1657942054502,CSE 20,A01,083657,Tran; Khoa Dang,39,0,80,41
1657942060525,CSE 21,A01,095574,Bach; Quang Tran,23,0,48,25
1657942066549,CSE 30,A01,083084,Eldon; John,7,0,80,73
1657942066549,CSE 30,B01,095061,Bhaskar; Nishant,9,0,50,41
1657942072576,CSE 100,A01,083659,Cao; Yingjun,5,4,70,65
1657942078599,CSE 134B,A01,083661,Powell; Thomas Allan,25,0,100,75
1657942084622,CSE 140,A01,083663,Gungor; Onat,17,0,85,68
1657942090647,CSE 140L,A01,083088,Eldon; John,23,0,100,77
1657942096674,CSE 175,A01,083665,Kumar; Rakesh,3,0,25,22
1657942102698,CSE 190,A00,092507,Dubnov; Shlomo,8,0,20,12
1657942108736,ECE 45,A01,083139,Congero; Spencer William,7,0,75,68
1657942114759,ECE 65,A50,083695,Saad; Andrew S,12,0,30,18
1657942114759,ECE 65,A51,095125,Saad; Andrew S,24,0,26,2
1657942120786,ECE 109,A01,091882,Touri; Behrouz,20,0,70,50
1657942126808,ECE 180,A00,083140,Abi Samra; Nicholas Camill,1,0,30,29
1657942126808,ECE 180,B00,083141,Abi Samra; Nicholas Camill,0,0,30,30
1657942132831,MATH 10A,A01,083735,Patchell; Gregory David,2,0,30,28
1657942132831,MATH 10A,A02,083736,Patchell; Gregory David,20,0,30,10
1657942132831,MATH 10A,A03,083737,Patchell; Gregory David,16,0,30,14
1657942138859,MATH 10B,A01,083207,Lim; Seonhee,9,0,34,25
1657942138859,MATH 10B,A02,083208,Lim; Seonhee,10,0,35,25
1657942138859,MATH 10B,A03,093472,Lim; Seonhee,7,0,34,27
1657942138859,MATH 10B,B01,083739,Sinha; Shubham,14,0,30,16
1657942144886,MATH 18,A01,083743,Cinel; Cameron Alexander,9,0,30,21
1657942144886,MATH 18,A02,083744,Cinel; Cameron Alexander,18,0,30,12
1657942144886,MATH 18,A03,083745,Cinel; Cameron Alexander,10,0,30,20
1657942144886,MATH 18,B01,083748,Rideout; David Porter,5,0,37,32
1657942144886,MATH 18,B02,083749,Rideout; David Porter,5,0,36,31
1657942144886,MATH 18,B03,083750,Rideout; David Porter,3,0,37,34
1657942144886,MATH 18,B04,083751,Rideout; David Porter,7,0,36,29
1657942144886,MATH 18,B05,093473,Rideout; David Porter,7,0,36,29
1657942144886,MATH 18,B06,093474,Rideout; David Porter,6,0,36,30
1657942150908,MATH 20A,A01,083754,Zheng; Zequn,14,0,40,26
1657942156931,MATH 20B,A01,083756,Briones; Jor-el Thomas Caparas,4,0,36,32
1657942156931,MATH 20B,A02,083757,Briones; Jor-el Thomas Caparas,1,0,36,35
1657942156931,MATH 20B,A03,093475,Briones; Jor-el Thomas Caparas,3,0,36,33
1657942162954,MATH 20C,A01,083760,Briones; Jor-el Thomas Caparas,1,0,35,34
1657942162954,MATH 20C,A02,083761,Briones; Jor-el Thomas Caparas,8,0,35,27
1657942162954,MATH 20C,A03,093476,Briones; Jor-el Thomas Caparas,0,1,36,36
1657942162954,MATH 20C,B01,083762,Bach; Quang Tran,1,0,30,29
1657942168986,MATH 20D,A01,083765,Tran; Brian Kha,5,0,30,25
1657942168986,MATH 20D,A02,083766,Tran; Brian Kha,5,0,30,25
1657942168986,MATH 20D,A03,083767,Tran; Brian Kha,6,0,30,24
1657942175008,MATH 20E,A01,083771,Ganguly; Soumya,12,0,32,20
1657942175008,MATH 20E,A02,083772,Ganguly; Soumya,7,0,32,25
1657942175008,MATH 20E,B01,083773,Ciotti; Benjamin,20,0,35,15
1657942175008,MATH 20E,B02,083774,Ciotti; Benjamin,18,0,35,17
1657942181036,MATH 103A,A01,083777,Greenfeld; Be'Eri,3,0,36,33
1657942181036,MATH 103A,A02,083778,Greenfeld; Be'Eri,5,0,36,31
1657942181036,MATH 103A,A03,093561,Greenfeld; Be'Eri,6,0,36,30
1657942181036,MATH 103A,B01,083779,Greenfeld; Be'Eri,8,0,36,28
1657942181036,MATH 103A,B02,083780,Greenfeld; Be'Eri,4,0,36,32
1657942181036,MATH 103A,B03,093562,Greenfeld; Be'Eri,3,0,36,33
1657942187064,MATH 105,A01,085443,Carter; Anne Toulson,15,0,35,20
1657942187064,MATH 105,A02,093477,Carter; Anne Toulson,20,0,35,15
1657942193091,MATH 109,A01,083213,Ganzberger; Geoffrey Michael,3,0,34,31
1657942193091,MATH 109,A02,083214,Ganzberger; Geoffrey Michael,4,0,34,30
1657942193091,MATH 109,A03,093478,Ganzberger; Geoffrey Michael,2,0,34,32
1657942193091,MATH 109,B01,083215,Ganzberger; Geoffrey Michael,2,0,32,30
1657942193091,MATH 109,B02,083216,Ganzberger; Geoffrey Michael,3,0,32,29
1657942193091,MATH 109,B03,093479,Ganzberger; Geoffrey Michael,8,0,32,24
1657942199115,MATH 142A,A01,083219,Chow; Bennett,7,0,32,25
1657942199115,MATH 142A,A02,083220,Chow; Bennett,10,0,32,22
1657942199115,MATH 142A,A03,093480,Chow; Bennett,9,0,32,23
1657942199115,MATH 142A,B03,093481,Chow; Bennett,8,0,32,24
1657942199115,MATH 142A,B04,093558,Chow; Bennett,14,0,32,18
1657942199115,MATH 142A,B05,093559,Chow; Bennett,7,0,32,25
1657942205160,MATH 193A,A01,083224,Rotar; Vladimir,8,0,34,26
1657942205160,MATH 193A,A02,083225,Rotar; Vladimir,10,0,34,24
1657942205160,MATH 193A,A03,083781,Rotar; Vladimir,5,0,34,29
1657942205160,MATH 193A,A04,083782,Rotar; Vladimir,11,0,34,23
1657942205160,MATH 193A,A05,093482,Rotar; Vladimir,11,0,34,23
1657942211187,MATH 197,001,091859,McAuley; Julian John,9999,0,9999,0
1657942211187,MATH 197,002,095566,Kedlaya; Kiran S.,9997,0,9999,2
1657942211187,MATH 197,003,095567,Xiao; Ming,9999,0,9999,0
1657942211187,MATH 197,004,095571,Perols; Johan Lars,9998,0,9999,1
1657942218234,COGS 9,A01,083615,Shannon; Kyle Michael,11,0,75,64
1657942224260,COGS 11,A01,083617,Boyle; Mary E. T.,23,0,48,25
1657942230288,COGS 13,A01,083071,Bastos; Amalia Pinkusfeld,12,0,71,59
1657942236311,COGS 14A,A01,092681,Semenuks; Arturs,5,1,100,95
1657942242334,COGS 14B,A01,083073,Cheng; Tzu-Han,7,0,63,56
1657942248356,COGS 17,A01,092677,Semenuks; Arturs,7,0,81,74
1657942254382,COGS 100,A01,083619,Allen; Michael Gordon,17,0,70,53
1657942260406,COGS 101A,A01,083621,Davis; Joshua Daniel,9,0,68,59
1657942266430,COGS 101B,A01,091572,Allen; Michael Gordon,14,0,65,51
1657942272456,COGS 101C,A01,083625,Delgado; Tania,17,0,35,18
1657942278483,COGS 107A,A01,083627,Boyle; Mary E. T.,14,0,60,46
1657942284508,COGS 118A,A01,083075,Gupta; Anjum,21,0,76,55
1657942290539,CSE 3,A50,083646,Miranda; Gregory Joseph,24,0,50,26
1657942296566,CSE 8A,A50,083650,Miranda; Gregory Joseph,17,1,56,39
1657942302590,CSE 11,A01,083080,Cao; Yingjun,6,15,40,34
1657942308612,CSE 12,A01,083652,Krause-Levy; Sophia Louisa,30,1,120,90
1657942314635,CSE 15L,A01,083654,Morris; Justin Loren,9,0,50,41
1657942314635,CSE 15L,A02,083655,Morris; Justin Loren,10,0,50,40
1657942320661,CSE 20,A01,083657,Tran; Khoa Dang,39,0,80,41
1657942326684,CSE 21,A01,095574,Bach; Quang Tran,23,0,48,25
1657942332707,CSE 30,A01,083084,Eldon; John,7,0,80,73
1657942332707,CSE 30,B01,095061,Bhaskar; Nishant,9,0,50,41
1657942338739,CSE 100,A01,083659,Cao; Yingjun,5,4,70,65
1657942344761,CSE 134B,A01,083661,Powell; Thomas Allan,25,0,100,75
1657942350785,CSE 140,A01,083663,Gungor; Onat,17,0,85,68
1657942356811,CSE 140L,A01,083088,Eldon; John,23,0,100,77
1657942362834,CSE 175,A01,083665,Kumar; Rakesh,3,0,25,22
1657942368857,CSE 190,A00,092507,Dubnov; Shlomo,8,0,20,12
1657942374882,ECE 45,A01,083139,Congero; Spencer William,7,0,75,68
1657942380908,ECE 65,A50,083695,Saad; Andrew S,12,0,30,18
1657942380908,ECE 65,A51,095125,Saad; Andrew S,24,0,26,2
1657942387008,ECE 109,A01,091882,Touri; Behrouz,20,0,70,50
1657942393034,ECE 180,A00,083140,Abi Samra; Nicholas Camill,1,0,30,29
1657942393034,ECE 180,B00,083141,Abi Samra; Nicholas Camill,0,0,30,30
1657942399062,MATH 10A,A01,083735,Patchell; Gregory David,2,0,30,28
1657942399062,MATH 10A,A02,083736,Patchell; Gregory David,20,0,30,10
1657942399062,MATH 10A,A03,083737,Patchell; Gregory David,16,0,30,14
1657942405089,MATH 10B,A01,083207,Lim; Seonhee,9,0,34,25
1657942405089,MATH 10B,A02,083208,Lim; Seonhee,10,0,35,25
1657942405089,MATH 10B,A03,093472,Lim; Seonhee,7,0,34,27
1657942405089,MATH 10B,B01,083739,Sinha; Shubham,14,0,30,16
1657942411120,MATH 18,A01,083743,Cinel; Cameron Alexander,9,0,30,21
1657942411120,MATH 18,A02,083744,Cinel; Cameron Alexander,18,0,30,12
1657942411120,MATH 18,A03,083745,Cinel; Cameron Alexander,10,0,30,20
1657942411120,MATH 18,B01,083748,Rideout; David Porter,5,0,37,32
1657942411120,MATH 18,B02,083749,Rideout; David Porter,5,0,36,31
1657942411120,MATH 18,B03,083750,Rideout; David Porter,3,0,37,34
1657942411120,MATH 18,B04,083751,Rideout; David Porter,7,0,36,29
1657942411120,MATH 18,B05,093473,Rideout; David Porter,7,0,36,29
1657942411120,MATH 18,B06,093474,Rideout; David Porter,6,0,36,30
1657942417143,MATH 20A,A01,083754,Zheng; Zequn,14,0,40,26
1657942423166,MATH 20B,A01,083756,Briones; Jor-el Thomas Caparas,4,0,36,32
1657942423166,MATH 20B,A02,083757,Briones; Jor-el Thomas Caparas,1,0,36,35
1657942423166,MATH 20B,A03,093475,Briones; Jor-el Thomas Caparas,3,0,36,33
1657942429191,MATH 20C,A01,083760,Briones; Jor-el Thomas Caparas,1,0,35,34
1657942429191,MATH 20C,A02,083761,Briones; Jor-el Thomas Caparas,8,0,35,27
1657942429191,MATH 20C,A03,093476,Briones; Jor-el Thomas Caparas,0,1,36,36
1657942429191,MATH 20C,B01,083762,Bach; Quang Tran,1,0,30,29
1657942435213,MATH 20D,A01,083765,Tran; Brian Kha,5,0,30,25
1657942435213,MATH 20D,A02,083766,Tran; Brian Kha,5,0,30,25
1657942435213,MATH 20D,A03,083767,Tran; Brian Kha,6,0,30,24
1657942441242,MATH 20E,A01,083771,Ganguly; Soumya,12,0,32,20
1657942441242,MATH 20E,A02,083772,Ganguly; Soumya,7,0,32,25
1657942441242,MATH 20E,B01,083773,Ciotti; Benjamin,20,0,35,15
1657942441242,MATH 20E,B02,083774,Ciotti; Benjamin,18,0,35,17
1657942447270,MATH 103A,A01,083777,Greenfeld; Be'Eri,3,0,36,33
1657942447270,MATH 103A,A02,083778,Greenfeld; Be'Eri,5,0,36,31
1657942447270,MATH 103A,A03,093561,Greenfeld; Be'Eri,6,0,36,30
1657942447270,MATH 103A,B01,083779,Greenfeld; Be'Eri,8,0,36,28
1657942447270,MATH 103A,B02,083780,Greenfeld; Be'Eri,4,0,36,32
1657942447270,MATH 103A,B03,093562,Greenfeld; Be'Eri,3,0,36,33
1657942453295,MATH 105,A01,085443,Carter; Anne Toulson,15,0,35,20
1657942453295,MATH 105,A02,093477,Carter; Anne Toulson,20,0,35,15
1657942459327,MATH 109,A01,083213,Ganzberger; Geoffrey Michael,3,0,34,31
1657942459327,MATH 109,A02,083214,Ganzberger; Geoffrey Michael,4,0,34,30
1657942459327,MATH 109,A03,093478,Ganzberger; Geoffrey Michael,2,0,34,32
1657942459327,MATH 109,B01,083215,Ganzberger; Geoffrey Michael,2,0,32,30
1657942459327,MATH 109,B02,083216,Ganzberger; Geoffrey Michael,3,0,32,29
1657942459327,MATH 109,B03,093479,Ganzberger; Geoffrey Michael,8,0,32,24
1657942465354,MATH 142A,A01,083219,Chow; Bennett,7,0,32,25
1657942465354,MATH 142A,A02,083220,Chow; Bennett,10,0,32,22
1657942465354,MATH 142A,A03,093480,Chow; Bennett,9,0,32,23
1657942465354,MATH 142A,B03,093481,Chow; Bennett,8,0,32,24
1657942465354,MATH 142A,B04,093558,Chow; Bennett,14,0,32,18
1657942465354,MATH 142A,B05,093559,Chow; Bennett,7,0,32,25
1657942471382,MATH 193A,A01,083224,Rotar; Vladimir,8,0,34,26
1657942471382,MATH 193A,A02,083225,Rotar; Vladimir,10,0,34,24
1657942471382,MATH 193A,A03,083781,Rotar; Vladimir,5,0,34,29
1657942471382,MATH 193A,A04,083782,Rotar; Vladimir,11,0,34,23
1657942471382,MATH 193A,A05,093482,Rotar; Vladimir,11,0,34,23
1657942477405,MATH 197,001,091859,McAuley; Julian John,9999,0,9999,0
1657942477405,MATH 197,002,095566,Kedlaya; Kiran S.,9997,0,9999,2
1657942477405,MATH 197,003,095567,Xiao; Ming,9999,0,9999,0
1657942477405,MATH 197,004,095571,Perols; Johan Lars,9998,0,9999,1
1657942484461,COGS 9,A01,083615,Shannon; Kyle Michael,11,0,75,64
1657942490484,COGS 11,A01,083617,Boyle; Mary E. T.,23,0,48,25
1657942496512,COGS 13,A01,083071,Bastos; Amalia Pinkusfeld,12,0,71,59
1657942502538,COGS 14A,A01,092681,Semenuks; Arturs,5,1,100,95
1657942508559,COGS 14B,A01,083073,Cheng; Tzu-Han,7,0,63,56
1657942514586,COGS 17,A01,092677,Semenuks; Arturs,7,0,81,74
1657942520612,COGS 100,A01,083619,Allen; Michael Gordon,17,0,70,53
1657942526638,COGS 101A,A01,083621,Davis; Joshua Daniel,9,0,68,59
1657942532662,COGS 101B,A01,091572,Allen; Michael Gordon,14,0,65,51
1657942538684,COGS 101C,A01,083625,Delgado; Tania,17,0,35,18
1657942544706,COGS 107A,A01,083627,Boyle; Mary E. T.,14,0,60,46
1657942550730,COGS 118A,A01,083075,Gupta; Anjum,21,0,76,55
1657942556756,CSE 3,A50,083646,Miranda; Gregory Joseph,24,0,50,26
1657942562780,CSE 8A,A50,083650,Miranda; Gregory Joseph,17,1,56,39
1657942568807,CSE 11,A01,083080,Cao; Yingjun,6,15,40,34
1657942574830,CSE 12,A01,083652,Krause-Levy; Sophia Louisa,30,1,120,90
1657942580856,CSE 15L,A01,083654,Morris; Justin Loren,9,0,50,41
1657942580856,CSE 15L,A02,083655,Morris; Justin Loren,10,0,50,40
1657942586878,CSE 20,A01,083657,Tran; Khoa Dang,39,0,80,41
1657942592901,CSE 21,A01,095574,Bach; Quang Tran,23,0,48,25
1657942598925,CSE 30,A01,083084,Eldon; John,7,0,80,73
1657942598925,CSE 30,B01,095061,Bhaskar; Nishant,9,0,50,41
1657942604949,CSE 100,A01,083659,Cao; Yingjun,5,4,70,65
1657942610972,CSE 134B,A01,083661,Powell; Thomas Allan,25,0,100,75
1657942616999,CSE 140,A01,083663,Gungor; Onat,17,0,85,68
1657942623023,CSE 140L,A01,083088,Eldon; John,23,0,100,77
1657942629044,CSE 175,A01,083665,Kumar; Rakesh,3,0,25,22
1657942635076,CSE 190,A00,092507,Dubnov; Shlomo,8,0,20,12
1657942641099,ECE 45,A01,083139,Congero; Spencer William,7,0,75,68
1657942647126,ECE 65,A50,083695,Saad; Andrew S,12,0,30,18
1657942647126,ECE 65,A51,095125,Saad; Andrew S,24,0,26,2
1657942653161,ECE 109,A01,091882,Touri; Behrouz,20,0,70,50
1657942659185,ECE 180,A00,083140,Abi Samra; Nicholas Camill,1,0,30,29
1657942659185,ECE 180,B00,083141,Abi Samra; Nicholas Camill,0,0,30,30
1657942665208,MATH 10A,A01,083735,Patchell; Gregory David,2,0,30,28
1657942665208,MATH 10A,A02,083736,Patchell; Gregory David,20,0,30,10
1657942665208,MATH 10A,A03,083737,Patchell; Gregory David,16,0,30,14
1657942671230,MATH 10B,A01,083207,Lim; Seonhee,9,0,34,25
1657942671230,MATH 10B,A02,083208,Lim; Seonhee,10,0,35,25
1657942671230,MATH 10B,A03,093472,Lim; Seonhee,7,0,34,27
1657942671230,MATH 10B,B01,083739,Sinha; Shubham,14,0,30,16
1657942677260,MATH 18,A01,083743,Cinel; Cameron Alexander,9,0,30,21
1657942677260,MATH 18,A02,083744,Cinel; Cameron Alexander,18,0,30,12
1657942677260,MATH 18,A03,083745,Cinel; Cameron Alexander,10,0,30,20
1657942677260,MATH 18,B01,083748,Rideout; David Porter,5,0,37,32
1657942677260,MATH 18,B02,083749,Rideout; David Porter,5,0,36,31
1657942677260,MATH 18,B03,083750,Rideout; David Porter,3,0,37,34
1657942677260,MATH 18,B04,083751,Rideout; David Porter,7,0,36,29
1657942677260,MATH 18,B05,093473,Rideout; David Porter,7,0,36,29
1657942677260,MATH 18,B06,093474,Rideout; David Porter,6,0,36,30
1657942683286,MATH 20A,A01,083754,Zheng; Zequn,14,0,40,26
1657942689315,MATH 20B,A01,083756,Briones; Jor-el Thomas Caparas,4,0,36,32
1657942689315,MATH 20B,A02,083757,Briones; Jor-el Thomas Caparas,1,0,36,35
1657942689315,MATH 20B,A03,093475,Briones; Jor-el Thomas Caparas,3,0,36,33
1657942695338,MATH 20C,A01,083760,Briones; Jor-el Thomas Caparas,1,0,35,34
1657942695338,MATH 20C,A02,083761,Briones; Jor-el Thomas Caparas,8,0,35,27
1657942695338,MATH 20C,A03,093476,Briones; Jor-el Thomas Caparas,0,1,36,36
1657942695338,MATH 20C,B01,083762,Bach; Quang Tran,1,0,30,29
1657942701365,MATH 20D,A01,083765,Tran; Brian Kha,5,0,30,25
1657942701365,MATH 20D,A02,083766,Tran; Brian Kha,5,0,30,25
1657942701365,MATH 20D,A03,083767,Tran; Brian Kha,6,0,30,24
1657942707389,MATH 20E,A01,083771,Ganguly; Soumya,12,0,32,20
1657942707389,MATH 20E,A02,083772,Ganguly; Soumya,7,0,32,25
1657942707389,MATH 20E,B01,083773,Ciotti; Benjamin,20,0,35,15
1657942707389,MATH 20E,B02,083774,Ciotti; Benjamin,18,0,35,17
1657942713416,MATH 103A,A01,083777,Greenfeld; Be'Eri,3,0,36,33
1657942713416,MATH 103A,A02,083778,Greenfeld; Be'Eri,5,0,36,31
1657942713416,MATH 103A,A03,093561,Greenfeld; Be'Eri,6,0,36,30
1657942713416,MATH 103A,B01,083779,Greenfeld; Be'Eri,8,0,36,28
1657942713416,MATH 103A,B02,083780,Greenfeld; Be'Eri,4,0,36,32
1657942713416,MATH 103A,B03,093562,Greenfeld; Be'Eri,3,0,36,33
1657942719449,MATH 105,A01,085443,Carter; Anne Toulson,15,0,35,20
1657942719449,MATH 105,A02,093477,Carter; Anne Toulson,20,0,35,15
1657942725481,MATH 109,A01,083213,Ganzberger; Geoffrey Michael,3,0,34,31
1657942725481,MATH 109,A02,083214,Ganzberger; Geoffrey Michael,4,0,34,30
1657942725481,MATH 109,A03,093478,Ganzberger; Geoffrey Michael,2,0,34,32
1657942725481,MATH 109,B01,083215,Ganzberger; Geoffrey Michael,2,0,32,30
1657942725481,MATH 109,B02,083216,Ganzberger; Geoffrey Michael,3,0,32,29
1657942725481,MATH 109,B03,093479,Ganzberger; Geoffrey Michael,8,0,32,24
1657942731509,MATH 142A,A01,083219,Chow; Bennett,7,0,32,25
1657942731509,MATH 142A,A02,083220,Chow; Bennett,10,0,32,22
1657942731509,MATH 142A,A03,093480,Chow; Bennett,9,0,32,23
1657942731509,MATH 142A,B03,093481,Chow; Bennett,8,0,32,24
1657942731509,MATH 142A,B04,093558,Chow; Bennett,14,0,32,18
1657942731509,MATH 142A,B05,093559,Chow; Bennett,7,0,32,25
1657942737532,MATH 193A,A01,083224,Rotar; Vladimir,8,0,34,26
1657942737532,MATH 193A,A02,083225,Rotar; Vladimir,10,0,34,24
1657942737532,MATH 193A,A03,083781,Rotar; Vladimir,5,0,34,29
1657942737532,MATH 193A,A04,083782,Rotar; Vladimir,11,0,34,23
1657942737532,MATH 193A,A05,093482,Rotar; Vladimir,11,0,34,23
1657942743556,MATH 197,001,091859,McAuley; Julian John,9999,0,9999,0
1657942743556,MATH 197,002,095566,Kedlaya; Kiran S.,9997,0,9999,2
1657942743556,MATH 197,003,095567,Xiao; Ming,9999,0,9999,0
1657942743556,MATH 197,004,095571,Perols; Johan Lars,9998,0,9999,1
1657942750606,COGS 9,A01,083615,Shannon; Kyle Michael,11,0,75,64
1657942756628,COGS 11,A01,083617,Boyle; Mary E. T.,23,0,48,25
1657942762654,COGS 13,A01,083071,Bastos; Amalia Pinkusfeld,12,0,71,59
1657942768679,COGS 14A,A01,092681,Semenuks; Arturs,5,1,100,95
1657942774701,COGS 14B,A01,083073,Cheng; Tzu-Han,7,0,63,56
1657942780724,COGS 17,A01,092677,Semenuks; Arturs,7,0,81,74
1657942786746,COGS 100,A01,083619,Allen; Michael Gordon,17,0,70,53
1657942792787,COGS 101A,A01,083621,Davis; Joshua Daniel,9,0,68,59
1657942798813,COGS 101B,A01,091572,Allen; Michael Gordon,14,0,65,51
1657942804838,COGS 101C,A01,083625,Delgado; Tania,17,0,35,18
1657942810863,COGS 107A,A01,083627,Boyle; Mary E. T.,14,0,60,46
1657942816888,COGS 118A,A01,083075,Gupta; Anjum,21,0,76,55
1657942822910,CSE 3,A50,083646,Miranda; Gregory Joseph,24,0,50,26
1657942828933,CSE 8A,A50,083650,Miranda; Gregory Joseph,17,1,56,39
1657942834956,CSE 11,A01,083080,Cao; Yingjun,6,15,40,34
1657942840978,CSE 12,A01,083652,Krause-Levy; Sophia Louisa,30,1,120,90
1657942846999,CSE 15L,A01,083654,Morris; Justin Loren,9,0,50,41
1657942846999,CSE 15L,A02,083655,Morris; Justin Loren,10,0,50,40
1657942853034,CSE 20,A01,083657,Tran; Khoa Dang,39,0,80,41
1657942859058,CSE 21,A01,095574,Bach; Quang Tran,23,0,48,25
1657942865086,CSE 30,A01,083084,Eldon; John,7,0,80,73
1657942865086,CSE 30,B01,095061,Bhaskar; Nishant,9,0,50,41
1657942871112,CSE 100,A01,083659,Cao; Yingjun,5,4,70,65
1657942877134,CSE 134B,A01,083661,Powell; Thomas Allan,25,0,100,75
1657942883159,CSE 140,A01,083663,Gungor; Onat,17,0,85,68
1657942889185,CSE 140L,A01,083088,Eldon; John,23,0,100,77
1657942895209,CSE 175,A01,083665,Kumar; Rakesh,3,0,25,22
1657942901232,CSE 190,A00,092507,Dubnov; Shlomo,8,0,20,12
1657942907256,ECE 45,A01,083139,Congero; Spencer William,7,0,75,68
1657942913278,ECE 65,A50,083695,Saad; Andrew S,12,0,30,18
1657942913278,ECE 65,A51,095125,Saad; Andrew S,24,0,26,2
1657942919301,ECE 109,A01,091882,Touri; Behrouz,20,0,70,50
1657942925324,ECE 180,A00,083140,Abi Samra; Nicholas Camill,1,0,30,29
1657942925324,ECE 180,B00,083141,Abi Samra; Nicholas Camill,0,0,30,30
1657942931346,MATH 10A,A01,083735,Patchell; Gregory David,2,0,30,28
1657942931346,MATH 10A,A02,083736,Patchell; Gregory David,20,0,30,10
1657942931346,MATH 10A,A03,083737,Patchell; Gregory David,16,0,30,14
1657942937373,MATH 10B,A01,083207,Lim; Seonhee,9,0,34,25
1657942937373,MATH 10B,A02,083208,Lim; Seonhee,10,0,35,25
1657942937373,MATH 10B,A03,093472,Lim; Seonhee,7,0,34,27
1657942937373,MATH 10B,B01,083739,Sinha; Shubham,14,0,30,16
1657942943400,MATH 18,A01,083743,Cinel; Cameron Alexander,9,0,30,21
1657942943400,MATH 18,A02,083744,Cinel; Cameron Alexander,18,0,30,12
1657942943400,MATH 18,A03,083745,Cinel; Cameron Alexander,10,0,30,20
1657942943400,MATH 18,B01,083748,Rideout; David Porter,5,0,37,32
1657942943400,MATH 18,B02,083749,Rideout; David Porter,5,0,36,31
1657942943400,MATH 18,B03,083750,Rideout; David Porter,3,0,37,34
1657942943400,MATH 18,B04,083751,Rideout; David Porter,7,0,36,29
1657942943400,MATH 18,B05,093473,Rideout; David Porter,7,0,36,29
1657942943400,MATH 18,B06,093474,Rideout; David Porter,6,0,36,30
1657942949437,MATH 20A,A01,083754,Zheng; Zequn,14,0,40,26
1657942955462,MATH 20B,A01,083756,Briones; Jor-el Thomas Caparas,4,0,36,32
1657942955462,MATH 20B,A02,083757,Briones; Jor-el Thomas Caparas,1,0,36,35
1657942955462,MATH 20B,A03,093475,Briones; Jor-el Thomas Caparas,3,0,36,33
1657942961491,MATH 20C,A01,083760,Briones; Jor-el Thomas Caparas,1,0,35,34
1657942961491,MATH 20C,A02,083761,Briones; Jor-el Thomas Caparas,8,0,35,27
1657942961491,MATH 20C,A03,093476,Briones; Jor-el Thomas Caparas,0,1,36,36
1657942961491,MATH 20C,B01,083762,Bach; Quang Tran,1,0,30,29
1657942967515,MATH 20D,A01,083765,Tran; Brian Kha,5,0,30,25
1657942967515,MATH 20D,A02,083766,Tran; Brian Kha,5,0,30,25
1657942967515,MATH 20D,A03,083767,Tran; Brian Kha,6,0,30,24
1657942973546,MATH 20E,A01,083771,Ganguly; Soumya,12,0,32,20
1657942973546,MATH 20E,A02,083772,Ganguly; Soumya,7,0,32,25
1657942973546,MATH 20E,B01,083773,Ciotti; Benjamin,20,0,35,15
1657942973546,MATH 20E,B02,083774,Ciotti; Benjamin,18,0,35,17
1657942979592,MATH 103A,A01,083777,Greenfeld; Be'Eri,3,0,36,33
1657942979592,MATH 103A,A02,083778,Greenfeld; Be'Eri,5,0,36,31
1657942979592,MATH 103A,A03,093561,Greenfeld; Be'Eri,6,0,36,30
1657942979592,MATH 103A,B01,083779,Greenfeld; Be'Eri,8,0,36,28
1657942979592,MATH 103A,B02,083780,Greenfeld; Be'Eri,4,0,36,32
1657942979592,MATH 103A,B03,093562,Greenfeld; Be'Eri,3,0,36,33
1657942985690,MATH 105,A01,085443,Carter; Anne Toulson,15,0,35,20
1657942985690,MATH 105,A02,093477,Carter; Anne Toulson,20,0,35,15
1657942991716,MATH 109,A01,083213,Ganzberger; Geoffrey Michael,3,0,34,31
1657942991716,MATH 109,A02,083214,Ganzberger; Geoffrey Michael,4,0,34,30
1657942991716,MATH 109,A03,093478,Ganzberger; Geoffrey Michael,2,0,34,32
1657942991716,MATH 109,B01,083215,Ganzberger; Geoffrey Michael,2,0,32,30
1657942991716,MATH 109,B02,083216,Ganzberger; Geoffrey Michael,3,0,32,29
1657942991716,MATH 109,B03,093479,Ganzberger; Geoffrey Michael,8,0,32,24
1657942997744,MATH 142A,A01,083219,Chow; Bennett,7,0,32,25
1657942997744,MATH 142A,A02,083220,Chow; Bennett,10,0,32,22
1657942997744,MATH 142A,A03,093480,Chow; Bennett,9,0,32,23
1657942997744,MATH 142A,B03,093481,Chow; Bennett,8,0,32,24
1657942997744,MATH 142A,B04,093558,Chow; Bennett,14,0,32,18
1657942997744,MATH 142A,B05,093559,Chow; Bennett,7,0,32,25
1657943003767,MATH 193A,A01,083224,Rotar; Vladimir,8,0,34,26
1657943003767,MATH 193A,A02,083225,Rotar; Vladimir,10,0,34,24
1657943003767,MATH 193A,A03,083781,Rotar; Vladimir,5,0,34,29
1657943003767,MATH 193A,A04,083782,Rotar; Vladimir,11,0,34,23
1657943003767,MATH 193A,A05,093482,Rotar; Vladimir,11,0,34,23
1657943009794,MATH 197,001,091859,McAuley; Julian John,9999,0,9999,0
1657943009794,MATH 197,002,095566,Kedlaya; Kiran S.,9997,0,9999,2
1657943009794,MATH 197,003,095567,Xiao; Ming,9999,0,9999,0
1657943009794,MATH 197,004,095571,Perols; Johan Lars,9998,0,9999,1
1657943016845,COGS 9,A01,083615,Shannon; Kyle Michael,11,0,75,64
1657943022869,COGS 11,A01,083617,Boyle; Mary E. T.,23,0,48,25
1657943028892,COGS 13,A01,083071,Bastos; Amalia Pinkusfeld,12,0,71,59
1657943034914,COGS 14A,A01,092681,Semenuks; Arturs,5,1,100,95
1657943040937,COGS 14B,A01,083073,Cheng; Tzu-Han,7,0,63,56
1657943046960,COGS 17,A01,092677,Semenuks; Arturs,7,0,81,74
1657943052983,COGS 100,A01,083619,Allen; Michael Gordon,17,0,70,53
1657943059013,COGS 101A,A01,083621,Davis; Joshua Daniel,9,0,68,59
1657943065041,COGS 101B,A01,091572,Allen; Michael Gordon,14,0,65,51
1657943071064,COGS 101C,A01,083625,Delgado; Tania,17,0,35,18
1657943077087,COGS 107A,A01,083627,Boyle; Mary E. T.,14,0,60,46
1657943083112,COGS 118A,A01,083075,Gupta; Anjum,21,0,76,55
1657943089136,CSE 3,A50,083646,Miranda; Gregory Joseph,24,0,50,26
1657943095163,CSE 8A,A50,083650,Miranda; Gregory Joseph,17,1,56,39
1657943101189,CSE 11,A01,083080,Cao; Yingjun,6,15,40,34
1657943107214,CSE 12,A01,083652,Krause-Levy; Sophia Louisa,30,1,120,90
1657943113238,CSE 15L,A01,083654,Morris; Justin Loren,9,0,50,41
1657943113238,CSE 15L,A02,083655,Morris; Justin Loren,10,0,50,40
1657943119261,CSE 20,A01,083657,Tran; Khoa Dang,39,0,80,41
1657943125287,CSE 21,A01,095574,Bach; Quang Tran,23,0,48,25
1657943131311,CSE 30,A01,083084,Eldon; John,7,0,80,73
1657943131311,CSE 30,B01,095061,Bhaskar; Nishant,9,0,50,41
1657943137337,CSE 100,A01,083659,Cao; Yingjun,5,4,70,65
1657943143364,CSE 134B,A01,083661,Powell; Thomas Allan,25,0,100,75
1657943149390,CSE 140,A01,083663,Gungor; Onat,17,0,85,68
1657943155412,CSE 140L,A01,083088,Eldon; John,23,0,100,77
1657943161439,CSE 175,A01,083665,Kumar; Rakesh,3,0,25,22
1657943167464,CSE 190,A00,092507,Dubnov; Shlomo,8,0,20,12
1657943173492,ECE 45,A01,083139,Congero; Spencer William,7,0,75,68
1657943179522,ECE 65,A50,083695,Saad; Andrew S,12,0,30,18
1657943179522,ECE 65,A51,095125,Saad; Andrew S,24,0,26,2
1657943185546,ECE 109,A01,091882,Touri; Behrouz,20,0,70,50
1657943191578,ECE 180,A00,083140,Abi Samra; Nicholas Camill,1,0,30,29
1657943191578,ECE 180,B00,083141,Abi Samra; Nicholas Camill,0,0,30,30
1657943197600,MATH 10A,A01,083735,Patchell; Gregory David,2,0,30,28
1657943197600,MATH 10A,A02,083736,Patchell; Gregory David,20,0,30,10
1657943197600,MATH 10A,A03,083737,Patchell; Gregory David,16,0,30,14
1657943203629,MATH 10B,A01,083207,Lim; Seonhee,9,0,34,25
1657943203629,MATH 10B,A02,083208,Lim; Seonhee,10,0,35,25
1657943203629,MATH 10B,A03,093472,Lim; Seonhee,7,0,34,27
1657943203629,MATH 10B,B01,083739,Sinha; Shubham,14,0,30,16
1657943209654,MATH 18,A01,083743,Cinel; Cameron Alexander,9,0,30,21
1657943209654,MATH 18,A02,083744,Cinel; Cameron Alexander,18,0,30,12
1657943209654,MATH 18,A03,083745,Cinel; Cameron Alexander,10,0,30,20
1657943209654,MATH 18,B01,083748,Rideout; David Porter,5,0,37,32
1657943209654,MATH 18,B02,083749,Rideout; David Porter,5,0,36,31
1657943209654,MATH 18,B03,083750,Rideout; David Porter,3,0,37,34
1657943209654,MATH 18,B04,083751,Rideout; David Porter,7,0,36,29
1657943209654,MATH 18,B05,093473,Rideout; David Porter,7,0,36,29
1657943209654,MATH 18,B06,093474,Rideout; David Porter,6,0,36,30
1657943215682,MATH 20A,A01,083754,Zheng; Zequn,14,0,40,26
1657943221703,MATH 20B,A01,083756,Briones; Jor-el Thomas Caparas,4,0,36,32
1657943221703,MATH 20B,A02,083757,Briones; Jor-el Thomas Caparas,1,0,36,35
1657943221703,MATH 20B,A03,093475,Briones; Jor-el Thomas Caparas,3,0,36,33
1657943227731,MATH 20C,A01,083760,Briones; Jor-el Thomas Caparas,1,0,35,34
1657943227731,MATH 20C,A02,083761,Briones; Jor-el Thomas Caparas,8,0,35,27
1657943227731,MATH 20C,A03,093476,Briones; Jor-el Thomas Caparas,0,1,36,36
1657943227731,MATH 20C,B01,083762,Bach; Quang Tran,1,0,30,29
1657943233755,MATH 20D,A01,083765,Tran; Brian Kha,5,0,30,25
1657943233755,MATH 20D,A02,083766,Tran; Brian Kha,5,0,30,25
1657943233755,MATH 20D,A03,083767,Tran; Brian Kha,6,0,30,24
1657943239783,MATH 20E,A01,083771,Ganguly; Soumya,12,0,32,20
1657943239783,MATH 20E,A02,083772,Ganguly; Soumya,7,0,32,25
1657943239783,MATH 20E,B01,083773,Ciotti; Benjamin,20,0,35,15
1657943239783,MATH 20E,B02,083774,Ciotti; Benjamin,18,0,35,17
1657943245831,MATH 103A,A01,083777,Greenfeld; Be'Eri,3,0,36,33
1657943245831,MATH 103A,A02,083778,Greenfeld; Be'Eri,5,0,36,31
1657943245831,MATH 103A,A03,093561,Greenfeld; Be'Eri,6,0,36,30
1657943245831,MATH 103A,B01,083779,Greenfeld; Be'Eri,8,0,36,28
1657943245831,MATH 103A,B02,083780,Greenfeld; Be'Eri,4,0,36,32
1657943245831,MATH 103A,B03,093562,Greenfeld; Be'Eri,3,0,36,33
1657943251854,MATH 105,A01,085443,Carter; Anne Toulson,15,0,35,20
1657943251854,MATH 105,A02,093477,Carter; Anne Toulson,20,0,35,15
1657943257881,MATH 109,A01,083213,Ganzberger; Geoffrey Michael,3,0,34,31
1657943257881,MATH 109,A02,083214,Ganzberger; Geoffrey Michael,4,0,34,30
1657943257881,MATH 109,A03,093478,Ganzberger; Geoffrey Michael,2,0,34,32
1657943257881,MATH 109,B01,083215,Ganzberger; Geoffrey Michael,2,0,32,30
1657943257881,MATH 109,B02,083216,Ganzberger; Geoffrey Michael,3,0,32,29
1657943257881,MATH 109,B03,093479,Ganzberger; Geoffrey Michael,8,0,32,24
1657943263905,MATH 142A,A01,083219,Chow; Bennett,7,0,32,25
1657943263905,MATH 142A,A02,083220,Chow; Bennett,10,0,32,22
1657943263905,MATH 142A,A03,093480,Chow; Bennett,9,0,32,23
1657943263905,MATH 142A,B03,093481,Chow; Bennett,8,0,32,24
1657943263905,MATH 142A,B04,093558,Chow; Bennett,14,0,32,18
1657943263905,MATH 142A,B05,093559,Chow; Bennett,7,0,32,25
1657943269945,MATH 193A,A01,083224,Rotar; Vladimir,8,0,34,26
1657943269945,MATH 193A,A02,083225,Rotar; Vladimir,10,0,34,24
1657943269945,MATH 193A,A03,083781,Rotar; Vladimir,5,0,34,29
1657943269945,MATH 193A,A04,083782,Rotar; Vladimir,11,0,34,23
1657943269945,MATH 193A,A05,093482,Rotar; Vladimir,11,0,34,23
1657943275974,MATH 197,001,091859,McAuley; Julian John,9999,0,9999,0
1657943275974,MATH 197,002,095566,Kedlaya; Kiran S.,9997,0,9999,2
1657943275974,MATH 197,003,095567,Xiao; Ming,9999,0,9999,0
1657943275974,MATH 197,004,095571,Perols; Johan Lars,9998,0,9999,1
1657943283061,COGS 9,A01,083615,Shannon; Kyle Michael,11,0,75,64
1657943289094,COGS 11,A01,083617,Boyle; Mary E. T.,23,0,48,25
1657943295116,COGS 13,A01,083071,Bastos; Amalia Pinkusfeld,12,0,71,59
1657943301139,COGS 14A,A01,092681,Semenuks; Arturs,5,1,100,95
1657943307163,COGS 14B,A01,083073,Cheng; Tzu-Han,7,0,63,56
1657943313188,COGS 17,A01,092677,Semenuks; Arturs,7,0,81,74
1657943319218,COGS 100,A01,083619,Allen; Michael Gordon,17,0,70,53
1657943325244,COGS 101A,A01,083621,Davis; Joshua Daniel,9,0,68,59
1657943331271,COGS 101B,A01,091572,Allen; Michael Gordon,14,0,65,51
1657943337293,COGS 101C,A01,083625,Delgado; Tania,17,0,35,18
1657943343321,COGS 107A,A01,083627,Boyle; Mary E. T.,14,0,60,46
1657943349343,COGS 118A,A01,083075,Gupta; Anjum,21,0,76,55
1657943355378,CSE 3,A50,083646,Miranda; Gregory Joseph,24,0,50,26
1657943361402,CSE 8A,A50,083650,Miranda; Gregory Joseph,17,1,56,39
1657943367425,CSE 11,A01,083080,Cao; Yingjun,6,15,40,34
1657943373446,CSE 12,A01,083652,Krause-Levy; Sophia Louisa,30,1,120,90
1657943379475,CSE 15L,A01,083654,Morris; Justin Loren,9,0,50,41
1657943379475,CSE 15L,A02,083655,Morris; Justin Loren,10,0,50,40
1657943385503,CSE 20,A01,083657,Tran; Khoa Dang,39,0,80,41
1657943391532,CSE 21,A01,095574,Bach; Quang Tran,23,0,48,25
1657943397561,CSE 30,A01,083084,Eldon; John,7,0,80,73
1657943397561,CSE 30,B01,095061,Bhaskar; Nishant,9,0,50,41
1657943403584,CSE 100,A01,083659,Cao; Yingjun,5,4,70,65
1657943409609,CSE 134B,A01,083661,Powell; Thomas Allan,25,0,100,75
1657943415639,CSE 140,A01,083663,Gungor; Onat,17,0,85,68
1657943421665,CSE 140L,A01,083088,Eldon; John,23,0,100,77
1657943427691,CSE 175,A01,083665,Kumar; Rakesh,3,0,25,22
1657943433717,CSE 190,A00,092507,Dubnov; Shlomo,8,0,20,12
1657943439741,ECE 45,A01,083139,Congero; Spencer William,7,0,75,68
1657943445767,ECE 65,A50,083695,Saad; Andrew S,12,0,30,18
1657943445767,ECE 65,A51,095125,Saad; Andrew S,24,0,26,2
1657943451791,ECE 109,A01,091882,Touri; Behrouz,20,0,70,50
1657943457817,ECE 180,A00,083140,Abi Samra; Nicholas Camill,1,0,30,29
1657943457817,ECE 180,B00,083141,Abi Samra; Nicholas Camill,0,0,30,30
1657943463844,MATH 10A,A01,083735,Patchell; Gregory David,2,0,30,28
1657943463844,MATH 10A,A02,083736,Patchell; Gregory David,20,0,30,10
1657943463844,MATH 10A,A03,083737,Patchell; Gregory David,16,0,30,14
1657943469868,MATH 10B,A01,083207,Lim; Seonhee,9,0,34,25
1657943469868,MATH 10B,A02,083208,Lim; Seonhee,10,0,35,25
1657943469868,MATH 10B,A03,093472,Lim; Seonhee,7,0,34,27
1657943469868,MATH 10B,B01,083739,Sinha; Shubham,14,0,30,16
1657943475893,MATH 18,A01,083743,Cinel; Cameron Alexander,9,0,30,21
1657943475893,MATH 18,A02,083744,Cinel; Cameron Alexander,18,0,30,12
1657943475893,MATH 18,A03,083745,Cinel; Cameron Alexander,10,0,30,20
1657943475893,MATH 18,B01,083748,Rideout; David Porter,5,0,37,32
1657943475893,MATH 18,B02,083749,Rideout; David Porter,5,0,36,31
1657943475893,MATH 18,B03,083750,Rideout; David Porter,3,0,37,34
1657943475893,MATH 18,B04,083751,Rideout; David Porter,7,0,36,29
1657943475893,MATH 18,B05,093473,Rideout; David Porter,7,0,36,29
1657943475893,MATH 18,B06,093474,Rideout; David Porter,6,0,36,30
1657943481915,MATH 20A,A01,083754,Zheng; Zequn,14,0,40,26
1657943487939,MATH 20B,A01,083756,Briones; Jor-el Thomas Caparas,4,0,36,32
1657943487939,MATH 20B,A02,083757,Briones; Jor-el Thomas Caparas,1,0,36,35
1657943487939,MATH 20B,A03,093475,Briones; Jor-el Thomas Caparas,3,0,36,33
1657943493967,MATH 20C,A01,083760,Briones; Jor-el Thomas Caparas,1,0,35,34
1657943493967,MATH 20C,A02,083761,Briones; Jor-el Thomas Caparas,8,0,35,27
1657943493967,MATH 20C,A03,093476,Briones; Jor-el Thomas Caparas,0,1,36,36
1657943493967,MATH 20C,B01,083762,Bach; Quang Tran,1,0,30,29
1657943499996,MATH 20D,A01,083765,Tran; Brian Kha,5,0,30,25
1657943499996,MATH 20D,A02,083766,Tran; Brian Kha,5,0,30,25
1657943499996,MATH 20D,A03,083767,Tran; Brian Kha,6,0,30,24
1657943506021,MATH 20E,A01,083771,Ganguly; Soumya,12,0,32,20
1657943506021,MATH 20E,A02,083772,Ganguly; Soumya,7,0,32,25
1657943506021,MATH 20E,B01,083773,Ciotti; Benjamin,20,0,35,15
1657943506021,MATH 20E,B02,083774,Ciotti; Benjamin,18,0,35,17
1657943512050,MATH 103A,A01,083777,Greenfeld; Be'Eri,3,0,36,33
1657943512050,MATH 103A,A02,083778,Greenfeld; Be'Eri,5,0,36,31
1657943512050,MATH 103A,A03,093561,Greenfeld; Be'Eri,6,0,36,30
1657943512050,MATH 103A,B01,083779,Greenfeld; Be'Eri,8,0,36,28
1657943512050,MATH 103A,B02,083780,Greenfeld; Be'Eri,4,0,36,32
1657943512050,MATH 103A,B03,093562,Greenfeld; Be'Eri,3,0,36,33
1657943518080,MATH 105,A01,085443,Carter; Anne Toulson,15,0,35,20
1657943518080,MATH 105,A02,093477,Carter; Anne Toulson,20,0,35,15
1657943524103,MATH 109,A01,083213,Ganzberger; Geoffrey Michael,3,0,34,31
1657943524103,MATH 109,A02,083214,Ganzberger; Geoffrey Michael,4,0,34,30
1657943524103,MATH 109,A03,093478,Ganzberger; Geoffrey Michael,2,0,34,32
1657943524103,MATH 109,B01,083215,Ganzberger; Geoffrey Michael,2,0,32,30
1657943524103,MATH 109,B02,083216,Ganzberger; Geoffrey Michael,3,0,32,29
1657943524103,MATH 109,B03,093479,Ganzberger; Geoffrey Michael,8,0,32,24
1657943530136,MATH 142A,A01,083219,Chow; Bennett,7,0,32,25
1657943530136,MATH 142A,A02,083220,Chow; Bennett,10,0,32,22
1657943530136,MATH 142A,A03,093480,Chow; Bennett,9,0,32,23
1657943530136,MATH 142A,B03,093481,Chow; Bennett,8,0,32,24
1657943530136,MATH 142A,B04,093558,Chow; Bennett,14,0,32,18
1657943530136,MATH 142A,B05,093559,Chow; Bennett,7,0,32,25
1657943536160,MATH 193A,A01,083224,Rotar; Vladimir,8,0,34,26
1657943536160,MATH 193A,A02,083225,Rotar; Vladimir,10,0,34,24
1657943536160,MATH 193A,A03,083781,Rotar; Vladimir,5,0,34,29
1657943536160,MATH 193A,A04,083782,Rotar; Vladimir,11,0,34,23
1657943536160,MATH 193A,A05,093482,Rotar; Vladimir,11,0,34,23
1657943542184,MATH 197,001,091859,McAuley; Julian John,9999,0,9999,0
1657943542184,MATH 197,002,095566,Kedlaya; Kiran S.,9997,0,9999,2
1657943542184,MATH 197,003,095567,Xiao; Ming,9999,0,9999,0
1657943542184,MATH 197,004,095571,Perols; Johan Lars,9998,0,9999,1
1657943549254,COGS 9,A01,083615,Shannon; Kyle Michael,11,0,75,64
1657943555277,COGS 11,A01,083617,Boyle; Mary E. T.,23,0,48,25
1657943561300,COGS 13,A01,083071,Bastos; Amalia Pinkusfeld,12,0,71,59
1657943567322,COGS 14A,A01,092681,Semenuks; Arturs,5,1,100,95
1657943573357,COGS 14B,A01,083073,Cheng; Tzu-Han,7,0,63,56
1657943579451,COGS 17,A01,092677,Semenuks; Arturs,7,0,81,74
1657943585483,COGS 100,A01,083619,Allen; Michael Gordon,17,0,70,53
1657943591506,COGS 101A,A01,083621,Davis; Joshua Daniel,9,0,68,59
1657943597528,COGS 101B,A01,091572,Allen; Michael Gordon,14,0,65,51
1657943603553,COGS 101C,A01,083625,Delgado; Tania,17,0,35,18
1657943609593,COGS 107A,A01,083627,Boyle; Mary E. T.,14,0,60,46
1657943615616,COGS 118A,A01,083075,Gupta; Anjum,21,0,76,55
1657943621640,CSE 3,A50,083646,Miranda; Gregory Joseph,24,0,50,26
1657943627664,CSE 8A,A50,083650,Miranda; Gregory Joseph,17,1,56,39
1657943633691,CSE 11,A01,083080,Cao; Yingjun,6,15,40,34
1657943639718,CSE 12,A01,083652,Krause-Levy; Sophia Louisa,30,1,120,90
1657943645739,CSE 15L,A01,083654,Morris; Justin Loren,9,0,50,41
1657943645739,CSE 15L,A02,083655,Morris; Justin Loren,10,0,50,40
1657943651762,CSE 20,A01,083657,Tran; Khoa Dang,39,0,80,41
1657943657790,CSE 21,A01,095574,Bach; Quang Tran,23,0,48,25
1657943663813,CSE 30,A01,083084,Eldon; John,7,0,80,73
1657943663813,CSE 30,B01,095061,Bhaskar; Nishant,9,0,50,41
1657943669836,CSE 100,A01,083659,Cao; Yingjun,5,4,70,65
1657943675860,CSE 134B,A01,083661,Powell; Thomas Allan,25,0,100,75
1657943681886,CSE 140,A01,083663,Gungor; Onat,17,0,85,68
1657943687909,CSE 140L,A01,083088,Eldon; John,23,0,100,77
1657943693933,CSE 175,A01,083665,Kumar; Rakesh,3,0,25,22
1657943699960,CSE 190,A00,092507,Dubnov; Shlomo,8,0,20,12
1657943705984,ECE 45,A01,083139,Congero; Spencer William,7,0,75,68
1657943712007,ECE 65,A50,083695,Saad; Andrew S,12,0,30,18
1657943712007,ECE 65,A51,095125,Saad; Andrew S,24,0,26,2
1657943718030,ECE 109,A01,091882,Touri; Behrouz,20,0,70,50
1657943724052,ECE 180,A00,083140,Abi Samra; Nicholas Camill,1,0,30,29
1657943724052,ECE 180,B00,083141,Abi Samra; Nicholas Camill,0,0,30,30
1657943730076,MATH 10A,A01,083735,Patchell; Gregory David,2,0,30,28
1657943730076,MATH 10A,A02,083736,Patchell; Gregory David,20,0,30,10
1657943730076,MATH 10A,A03,083737,Patchell; Gregory David,16,0,30,14
1657943736108,MATH 10B,A01,083207,Lim; Seonhee,9,0,34,25
1657943736108,MATH 10B,A02,083208,Lim; Seonhee,10,0,35,25
1657943736108,MATH 10B,A03,093472,Lim; Seonhee,7,0,34,27
1657943736108,MATH 10B,B01,083739,Sinha; Shubham,14,0,30,16
1657943742133,MATH 18,A01,083743,Cinel; Cameron Alexander,9,0,30,21
1657943742133,MATH 18,A02,083744,Cinel; Cameron Alexander,18,0,30,12
1657943742133,MATH 18,A03,083745,Cinel; Cameron Alexander,10,0,30,20
1657943742133,MATH 18,B01,083748,Rideout; David Porter,5,0,37,32
1657943742133,MATH 18,B02,083749,Rideout; David Porter,5,0,36,31
1657943742133,MATH 18,B03,083750,Rideout; David Porter,3,0,37,34
1657943742133,MATH 18,B04,083751,Rideout; David Porter,7,0,36,29
1657943742133,MATH 18,B05,093473,Rideout; David Porter,7,0,36,29
1657943742133,MATH 18,B06,093474,Rideout; David Porter,6,0,36,30
1657943748159,MATH 20A,A01,083754,Zheng; Zequn,14,0,40,26
1657943754187,MATH 20B,A01,083756,Briones; Jor-el Thomas Caparas,4,0,36,32
1657943754187,MATH 20B,A02,083757,Briones; Jor-el Thomas Caparas,1,0,36,35
1657943754187,MATH 20B,A03,093475,Briones; Jor-el Thomas Caparas,3,0,36,33
1657943760210,MATH 20C,A01,083760,Briones; Jor-el Thomas Caparas,1,0,35,34
1657943760210,MATH 20C,A02,083761,Briones; Jor-el Thomas Caparas,8,0,35,27
1657943760210,MATH 20C,A03,093476,Briones; Jor-el Thomas Caparas,0,1,36,36
1657943760210,MATH 20C,B01,083762,Bach; Quang Tran,1,0,30,29
1657943766236,MATH 20D,A01,083765,Tran; Brian Kha,5,0,30,25
1657943766236,MATH 20D,A02,083766,Tran; Brian Kha,5,0,30,25
1657943766236,MATH 20D,A03,083767,Tran; Brian Kha,6,0,30,24
1657943772265,MATH 20E,A01,083771,Ganguly; Soumya,12,0,32,20
1657943772265,MATH 20E,A02,083772,Ganguly; Soumya,7,0,32,25
1657943772265,MATH 20E,B01,083773,Ciotti; Benjamin,20,0,35,15
1657943772265,MATH 20E,B02,083774,Ciotti; Benjamin,18,0,35,17
1657943778290,MATH 103A,A01,083777,Greenfeld; Be'Eri,3,0,36,33
1657943778290,MATH 103A,A02,083778,Greenfeld; Be'Eri,5,0,36,31
1657943778290,MATH 103A,A03,093561,Greenfeld; Be'Eri,6,0,36,30
1657943778290,MATH 103A,B01,083779,Greenfeld; Be'Eri,8,0,36,28
1657943778290,MATH 103A,B02,083780,Greenfeld; Be'Eri,4,0,36,32
1657943778290,MATH 103A,B03,093562,Greenfeld; Be'Eri,3,0,36,33
1657943784313,MATH 105,A01,085443,Carter; Anne Toulson,15,0,35,20
1657943784313,MATH 105,A02,093477,Carter; Anne Toulson,20,0,35,15
1657943790337,MATH 109,A01,083213,Ganzberger; Geoffrey Michael,3,0,34,31
1657943790337,MATH 109,A02,083214,Ganzberger; Geoffrey Michael,4,0,34,30
1657943790337,MATH 109,A03,093478,Ganzberger; Geoffrey Michael,2,0,34,32
1657943790337,MATH 109,B01,083215,Ganzberger; Geoffrey Michael,2,0,32,30
1657943790337,MATH 109,B02,083216,Ganzberger; Geoffrey Michael,3,0,32,29
1657943790337,MATH 109,B03,093479,Ganzberger; Geoffrey Michael,8,0,32,24
1657943796359,MATH 142A,A01,083219,Chow; Bennett,7,0,32,25
1657943796359,MATH 142A,A02,083220,Chow; Bennett,10,0,32,22
1657943796359,MATH 142A,A03,093480,Chow; Bennett,9,0,32,23
1657943796359,MATH 142A,B03,093481,Chow; Bennett,8,0,32,24
1657943796359,MATH 142A,B04,093558,Chow; Bennett,14,0,32,18
1657943796359,MATH 142A,B05,093559,Chow; Bennett,7,0,32,25
1657943802383,MATH 193A,A01,083224,Rotar; Vladimir,8,0,34,26
1657943802383,MATH 193A,A02,083225,Rotar; Vladimir,10,0,34,24
1657943802383,MATH 193A,A03,083781,Rotar; Vladimir,5,0,34,29
1657943802383,MATH 193A,A04,083782,Rotar; Vladimir,11,0,34,23
1657943802383,MATH 193A,A05,093482,Rotar; Vladimir,11,0,34,23
1657943808409,MATH 197,001,091859,McAuley; Julian John,9999,0,9999,0
1657943808409,MATH 197,002,095566,Kedlaya; Kiran S.,9997,0,9999,2
1657943808409,MATH 197,003,095567,Xiao; Ming,9999,0,9999,0
1657943808409,MATH 197,004,095571,Perols; Johan Lars,9998,0,9999,1
1657943815461,COGS 9,A01,083615,Shannon; Kyle Michael,11,0,75,64
1657943821486,COGS 11,A01,083617,Boyle; Mary E. T.,23,0,48,25
1657943827522,COGS 13,A01,083071,Bastos; Amalia Pinkusfeld,12,0,71,59
1657943833546,COGS 14A,A01,092681,Semenuks; Arturs,5,1,100,95
1657943839576,COGS 14B,A01,083073,Cheng; Tzu-Han,7,0,63,56
1657943845611,COGS 17,A01,092677,Semenuks; Arturs,7,0,81,74
1657943851635,COGS 100,A01,083619,Allen; Michael Gordon,17,0,70,53
1657943857660,COGS 101A,A01,083621,Davis; Joshua Daniel,9,0,68,59
1657943863687,COGS 101B,A01,091572,Allen; Michael Gordon,14,0,65,51
1657943869708,COGS 101C,A01,083625,Delgado; Tania,17,0,35,18
1657943875736,COGS 107A,A01,083627,Boyle; Mary E. T.,14,0,60,46
1657943881762,COGS 118A,A01,083075,Gupta; Anjum,21,0,76,55
1657943887788,CSE 3,A50,083646,Miranda; Gregory Joseph,24,0,50,26
1657943893811,CSE 8A,A50,083650,Miranda; Gregory Joseph,17,1,56,39
1657943899835,CSE 11,A01,083080,Cao; Yingjun,6,15,40,34
1657943905862,CSE 12,A01,083652,Krause-Levy; Sophia Louisa,30,1,120,90
1657943911889,CSE 15L,A01,083654,Morris; Justin Loren,9,0,50,41
1657943911889,CSE 15L,A02,083655,Morris; Justin Loren,10,0,50,40
1657943917916,CSE 20,A01,083657,Tran; Khoa Dang,39,0,80,41
1657943923943,CSE 21,A01,095574,Bach; Quang Tran,23,0,48,25
1657943929968,CSE 30,A01,083084,Eldon; John,7,0,80,73
1657943929968,CSE 30,B01,095061,Bhaskar; Nishant,9,0,50,41
1657943935992,CSE 100,A01,083659,Cao; Yingjun,5,4,70,65
1657943942015,CSE 134B,A01,083661,Powell; Thomas Allan,25,0,100,75
1657943948042,CSE 140,A01,083663,Gungor; Onat,17,0,85,68
1657943954072,CSE 140L,A01,083088,Eldon; John,23,0,100,77
1657943960095,CSE 175,A01,083665,Kumar; Rakesh,3,0,25,22
1657943966117,CSE 190,A00,092507,Dubnov; Shlomo,8,0,20,12
1657943972140,ECE 45,A01,083139,Congero; Spencer William,7,0,75,68
1657943978167,ECE 65,A50,083695,Saad; Andrew S,12,0,30,18
1657943978167,ECE 65,A51,095125,Saad; Andrew S,24,0,26,2
1657943984193,ECE 109,A01,091882,Touri; Behrouz,20,0,70,50
1657943990218,ECE 180,A00,083140,Abi Samra; Nicholas Camill,1,0,30,29
1657943990218,ECE 180,B00,083141,Abi Samra; Nicholas Camill,0,0,30,30
1657943996252,MATH 10A,A01,083735,Patchell; Gregory David,2,0,30,28
1657943996252,MATH 10A,A02,083736,Patchell; Gregory David,20,0,30,10
1657943996252,MATH 10A,A03,083737,Patchell; Gregory David,16,0,30,14
1657944002280,MATH 10B,A01,083207,Lim; Seonhee,9,0,34,25
1657944002280,MATH 10B,A02,083208,Lim; Seonhee,10,0,35,25
1657944002280,MATH 10B,A03,093472,Lim; Seonhee,7,0,34,27
1657944002280,MATH 10B,B01,083739,Sinha; Shubham,14,0,30,16
1657944008308,MATH 18,A01,083743,Cinel; Cameron Alexander,9,0,30,21
1657944008308,MATH 18,A02,083744,Cinel; Cameron Alexander,18,0,30,12
1657944008308,MATH 18,A03,083745,Cinel; Cameron Alexander,10,0,30,20
1657944008308,MATH 18,B01,083748,Rideout; David Porter,5,0,37,32
1657944008308,MATH 18,B02,083749,Rideout; David Porter,5,0,36,31
1657944008308,MATH 18,B03,083750,Rideout; David Porter,3,0,37,34
1657944008308,MATH 18,B04,083751,Rideout; David Porter,7,0,36,29
1657944008308,MATH 18,B05,093473,Rideout; David Porter,7,0,36,29
1657944008308,MATH 18,B06,093474,Rideout; David Porter,6,0,36,30
1657944014348,MATH 20A,A01,083754,Zheng; Zequn,14,0,40,26
1657944020376,MATH 20B,A01,083756,Briones; Jor-el Thomas Caparas,4,0,36,32
1657944020376,MATH 20B,A02,083757,Briones; Jor-el Thomas Caparas,1,0,36,35
1657944020376,MATH 20B,A03,093475,Briones; Jor-el Thomas Caparas,3,0,36,33
1657944026402,MATH 20C,A01,083760,Briones; Jor-el Thomas Caparas,1,0,35,34
1657944026402,MATH 20C,A02,083761,Briones; Jor-el Thomas Caparas,8,0,35,27
1657944026402,MATH 20C,A03,093476,Briones; Jor-el Thomas Caparas,0,1,36,36
1657944026402,MATH 20C,B01,083762,Bach; Quang Tran,1,0,30,29
1657944032426,MATH 20D,A01,083765,Tran; Brian Kha,5,0,30,25
1657944032426,MATH 20D,A02,083766,Tran; Brian Kha,5,0,30,25
1657944032426,MATH 20D,A03,083767,Tran; Brian Kha,6,0,30,24
1657944038450,MATH 20E,A01,083771,Ganguly; Soumya,12,0,32,20
1657944038450,MATH 20E,A02,083772,Ganguly; Soumya,7,0,32,25
1657944038450,MATH 20E,B01,083773,Ciotti; Benjamin,20,0,35,15
1657944038450,MATH 20E,B02,083774,Ciotti; Benjamin,18,0,35,17
1657944044479,MATH 103A,A01,083777,Greenfeld; Be'Eri,3,0,36,33
1657944044479,MATH 103A,A02,083778,Greenfeld; Be'Eri,5,0,36,31
1657944044479,MATH 103A,A03,093561,Greenfeld; Be'Eri,6,0,36,30
1657944044479,MATH 103A,B01,083779,Greenfeld; Be'Eri,8,0,36,28
1657944044479,MATH 103A,B02,083780,Greenfeld; Be'Eri,4,0,36,32
1657944044479,MATH 103A,B03,093562,Greenfeld; Be'Eri,3,0,36,33
1657944050504,MATH 105,A01,085443,Carter; Anne Toulson,15,0,35,20
1657944050504,MATH 105,A02,093477,Carter; Anne Toulson,20,0,35,15
1657944056529,MATH 109,A01,083213,Ganzberger; Geoffrey Michael,3,0,34,31
1657944056529,MATH 109,A02,083214,Ganzberger; Geoffrey Michael,4,0,34,30
1657944056529,MATH 109,A03,093478,Ganzberger; Geoffrey Michael,2,0,34,32
1657944056529,MATH 109,B01,083215,Ganzberger; Geoffrey Michael,2,0,32,30
1657944056529,MATH 109,B02,083216,Ganzberger; Geoffrey Michael,3,0,32,29
1657944056529,MATH 109,B03,093479,Ganzberger; Geoffrey Michael,8,0,32,24
1657944062558,MATH 142A,A01,083219,Chow; Bennett,7,0,32,25
1657944062558,MATH 142A,A02,083220,Chow; Bennett,10,0,32,22
1657944062558,MATH 142A,A03,093480,Chow; Bennett,9,0,32,23
1657944062558,MATH 142A,B03,093481,Chow; Bennett,8,0,32,24
1657944062558,MATH 142A,B04,093558,Chow; Bennett,14,0,32,18
1657944062558,MATH 142A,B05,093559,Chow; Bennett,7,0,32,25
1657944068581,MATH 193A,A01,083224,Rotar; Vladimir,8,0,34,26
1657944068581,MATH 193A,A02,083225,Rotar; Vladimir,10,0,34,24
1657944068581,MATH 193A,A03,083781,Rotar; Vladimir,5,0,34,29
1657944068581,MATH 193A,A04,083782,Rotar; Vladimir,11,0,34,23
1657944068581,MATH 193A,A05,093482,Rotar; Vladimir,11,0,34,23
1657944074608,MATH 197,001,091859,McAuley; Julian John,9999,0,9999,0
1657944074608,MATH 197,002,095566,Kedlaya; Kiran S.,9997,0,9999,2
1657944074608,MATH 197,003,095567,Xiao; Ming,9999,0,9999,0
1657944074608,MATH 197,004,095571,Perols; Johan Lars,9998,0,9999,1
1657944081659,COGS 9,A01,083615,Shannon; Kyle Michael,11,0,75,64
1657944087685,COGS 11,A01,083617,Boyle; Mary E. T.,23,0,48,25
1657944093709,COGS 13,A01,083071,Bastos; Amalia Pinkusfeld,12,0,71,59
1657944099740,COGS 14A,A01,092681,Semenuks; Arturs,5,1,100,95
1657944105762,COGS 14B,A01,083073,Cheng; Tzu-Han,7,0,63,56
1657944111785,COGS 17,A01,092677,Semenuks; Arturs,7,0,81,74
1657944117809,COGS 100,A01,083619,Allen; Michael Gordon,17,0,70,53
1657944123832,COGS 101A,A01,083621,Davis; Joshua Daniel,9,0,68,59
1657944129857,COGS 101B,A01,091572,Allen; Michael Gordon,14,0,65,51
1657944135883,COGS 101C,A01,083625,Delgado; Tania,17,0,35,18
1657944141905,COGS 107A,A01,083627,Boyle; Mary E. T.,14,0,60,46
1657944147927,COGS 118A,A01,083075,Gupta; Anjum,21,0,76,55
1657944153954,CSE 3,A50,083646,Miranda; Gregory Joseph,24,0,50,26
1657944159978,CSE 8A,A50,083650,Miranda; Gregory Joseph,17,1,56,39
1657944165999,CSE 11,A01,083080,Cao; Yingjun,6,15,40,34
1657944172025,CSE 12,A01,083652,Krause-Levy; Sophia Louisa,30,1,120,90
1657944178135,CSE 15L,A01,083654,Morris; Justin Loren,9,0,50,41
1657944178135,CSE 15L,A02,083655,Morris; Justin Loren,10,0,50,40
1657944184159,CSE 20,A01,083657,Tran; Khoa Dang,39,0,80,41
1657944190186,CSE 21,A01,095574,Bach; Quang Tran,23,0,48,25
1657944196210,CSE 30,A01,083084,Eldon; John,7,0,80,73
1657944196210,CSE 30,B01,095061,Bhaskar; Nishant,9,0,50,41
1657944202231,CSE 100,A01,083659,Cao; Yingjun,5,4,70,65
1657944208254,CSE 134B,A01,083661,Powell; Thomas Allan,25,0,100,75
1657944214276,CSE 140,A01,083663,Gungor; Onat,17,0,85,68
1657944220301,CSE 140L,A01,083088,Eldon; John,23,0,100,77
1657944226328,CSE 175,A01,083665,Kumar; Rakesh,3,0,25,22
1657944232350,CSE 190,A00,092507,Dubnov; Shlomo,8,0,20,12
1657944238378,ECE 45,A01,083139,Congero; Spencer William,7,0,75,68
1657944244407,ECE 65,A50,083695,Saad; Andrew S,12,0,30,18
1657944244407,ECE 65,A51,095125,Saad; Andrew S,24,0,26,2
1657944250433,ECE 109,A01,091882,Touri; Behrouz,20,0,70,50
1657944256454,ECE 180,A00,083140,Abi Samra; Nicholas Camill,1,0,30,29
1657944256454,ECE 180,B00,083141,Abi Samra; Nicholas Camill,0,0,30,30
1657944262477,MATH 10A,A01,083735,Patchell; Gregory David,2,0,30,28
1657944262477,MATH 10A,A02,083736,Patchell; Gregory David,20,0,30,10
1657944262477,MATH 10A,A03,083737,Patchell; Gregory David,16,0,30,14
1657944268500,MATH 10B,A01,083207,Lim; Seonhee,9,0,34,25
1657944268500,MATH 10B,A02,083208,Lim; Seonhee,10,0,35,25
1657944268500,MATH 10B,A03,093472,Lim; Seonhee,7,0,34,27
1657944268500,MATH 10B,B01,083739,Sinha; Shubham,14,0,30,16
1657944274531,MATH 18,A01,083743,Cinel; Cameron Alexander,9,0,30,21
1657944274531,MATH 18,A02,083744,Cinel; Cameron Alexander,18,0,30,12
1657944274531,MATH 18,A03,083745,Cinel; Cameron Alexander,10,0,30,20
1657944274531,MATH 18,B01,083748,Rideout; David Porter,5,0,37,32
1657944274531,MATH 18,B02,083749,Rideout; David Porter,5,0,36,31
1657944274531,MATH 18,B03,083750,Rideout; David Porter,3,0,37,34
1657944274531,MATH 18,B04,083751,Rideout; David Porter,7,0,36,29
1657944274531,MATH 18,B05,093473,Rideout; David Porter,7,0,36,29
1657944274531,MATH 18,B06,093474,Rideout; David Porter,6,0,36,30
1657944280554,MATH 20A,A01,083754,Zheng; Zequn,14,0,40,26
1657944286582,MATH 20B,A01,083756,Briones; Jor-el Thomas Caparas,4,0,36,32
1657944286582,MATH 20B,A02,083757,Briones; Jor-el Thomas Caparas,1,0,36,35
1657944286582,MATH 20B,A03,093475,Briones; Jor-el Thomas Caparas,3,0,36,33
1657944292614,MATH 20C,A01,083760,Briones; Jor-el Thomas Caparas,1,0,35,34
1657944292614,MATH 20C,A02,083761,Briones; Jor-el Thomas Caparas,8,0,35,27
1657944292614,MATH 20C,A03,093476,Briones; Jor-el Thomas Caparas,0,1,36,36
1657944292614,MATH 20C,B01,083762,Bach; Quang Tran,1,0,30,29
1657944298635,MATH 20D,A01,083765,Tran; Brian Kha,5,0,30,25
1657944298635,MATH 20D,A02,083766,Tran; Brian Kha,5,0,30,25
1657944298635,MATH 20D,A03,083767,Tran; Brian Kha,6,0,30,24
1657944304658,MATH 20E,A01,083771,Ganguly; Soumya,12,0,32,20
1657944304658,MATH 20E,A02,083772,Ganguly; Soumya,7,0,32,25
1657944304658,MATH 20E,B01,083773,Ciotti; Benjamin,20,0,35,15
1657944304658,MATH 20E,B02,083774,Ciotti; Benjamin,18,0,35,17
1657944310680,MATH 103A,A01,083777,Greenfeld; Be'Eri,3,0,36,33
1657944310680,MATH 103A,A02,083778,Greenfeld; Be'Eri,5,0,36,31
1657944310680,MATH 103A,A03,093561,Greenfeld; Be'Eri,6,0,36,30
1657944310680,MATH 103A,B01,083779,Greenfeld; Be'Eri,8,0,36,28
1657944310680,MATH 103A,B02,083780,Greenfeld; Be'Eri,4,0,36,32
1657944310680,MATH 103A,B03,093562,Greenfeld; Be'Eri,3,0,36,33
1657944316709,MATH 105,A01,085443,Carter; Anne Toulson,15,0,35,20
1657944316709,MATH 105,A02,093477,Carter; Anne Toulson,20,0,35,15
1657944322731,MATH 109,A01,083213,Ganzberger; Geoffrey Michael,3,0,34,31
1657944322731,MATH 109,A02,083214,Ganzberger; Geoffrey Michael,4,0,34,30
1657944322731,MATH 109,A03,093478,Ganzberger; Geoffrey Michael,2,0,34,32
1657944322731,MATH 109,B01,083215,Ganzberger; Geoffrey Michael,2,0,32,30
1657944322731,MATH 109,B02,083216,Ganzberger; Geoffrey Michael,3,0,32,29
1657944322731,MATH 109,B03,093479,Ganzberger; Geoffrey Michael,8,0,32,24
1657944328758,MATH 142A,A01,083219,Chow; Bennett,7,0,32,25
1657944328758,MATH 142A,A02,083220,Chow; Bennett,10,0,32,22
1657944328758,MATH 142A,A03,093480,Chow; Bennett,9,0,32,23
1657944328758,MATH 142A,B03,093481,Chow; Bennett,8,0,32,24
1657944328758,MATH 142A,B04,093558,Chow; Bennett,14,0,32,18
1657944328758,MATH 142A,B05,093559,Chow; Bennett,7,0,32,25
1657944334780,MATH 193A,A01,083224,Rotar; Vladimir,8,0,34,26
1657944334780,MATH 193A,A02,083225,Rotar; Vladimir,10,0,34,24
1657944334780,MATH 193A,A03,083781,Rotar; Vladimir,5,0,34,29
1657944334780,MATH 193A,A04,083782,Rotar; Vladimir,11,0,34,23
1657944334780,MATH 193A,A05,093482,Rotar; Vladimir,11,0,34,23
1657944340802,MATH 197,001,091859,McAuley; Julian John,9999,0,9999,0
1657944340802,MATH 197,002,095566,Kedlaya; Kiran S.,9997,0,9999,2
1657944340802,MATH 197,003,095567,Xiao; Ming,9999,0,9999,0
1657944340802,MATH 197,004,095571,Perols; Johan Lars,9998,0,9999,1
1657944347864,COGS 9,A01,083615,Shannon; Kyle Michael,11,0,75,64
1657944353885,COGS 11,A01,083617,Boyle; Mary E. T.,23,0,48,25
1657944359908,COGS 13,A01,083071,Bastos; Amalia Pinkusfeld,12,0,71,59
1657944365930,COGS 14A,A01,092681,Semenuks; Arturs,5,1,100,95
1657944371953,COGS 14B,A01,083073,Cheng; Tzu-Han,7,0,63,56
1657944377975,COGS 17,A01,092677,Semenuks; Arturs,7,0,81,74
1657944384002,COGS 100,A01,083619,Allen; Michael Gordon,17,0,70,53
1657944390023,COGS 101A,A01,083621,Davis; Joshua Daniel,9,0,68,59
1657944396048,COGS 101B,A01,091572,Allen; Michael Gordon,14,0,65,51
1657944402073,COGS 101C,A01,083625,Delgado; Tania,17,0,35,18
1657944408095,COGS 107A,A01,083627,Boyle; Mary E. T.,14,0,60,46
1657944414117,COGS 118A,A01,083075,Gupta; Anjum,21,0,76,55
1657944420141,CSE 3,A50,083646,Miranda; Gregory Joseph,24,0,50,26
1657944426164,CSE 8A,A50,083650,Miranda; Gregory Joseph,17,1,56,39
1657944432186,CSE 11,A01,083080,Cao; Yingjun,6,15,40,34
1657944438212,CSE 12,A01,083652,Krause-Levy; Sophia Louisa,30,1,120,90
1657944444236,CSE 15L,A01,083654,Morris; Justin Loren,9,0,50,41
1657944444236,CSE 15L,A02,083655,Morris; Justin Loren,10,0,50,40
1657944450263,CSE 20,A01,083657,Tran; Khoa Dang,39,0,80,41
1657944456290,CSE 21,A01,095574,Bach; Quang Tran,23,0,48,25
1657944462316,CSE 30,A01,083084,Eldon; John,7,0,80,73
1657944462316,CSE 30,B01,095061,Bhaskar; Nishant,9,0,50,41
1657944468342,CSE 100,A01,083659,Cao; Yingjun,5,4,70,65
1657944474369,CSE 134B,A01,083661,Powell; Thomas Allan,25,0,100,75
1657944480391,CSE 140,A01,083663,Gungor; Onat,17,0,85,68
1657944486415,CSE 140L,A01,083088,Eldon; John,23,0,100,77
1657944492438,CSE 175,A01,083665,Kumar; Rakesh,3,0,25,22
1657944498461,CSE 190,A00,092507,Dubnov; Shlomo,8,0,20,12
1657944504487,ECE 45,A01,083139,Congero; Spencer William,7,0,75,68
1657944510513,ECE 65,A50,083695,Saad; Andrew S,12,0,30,18
1657944510513,ECE 65,A51,095125,Saad; Andrew S,24,0,26,2
1657944516536,ECE 109,A01,091882,Touri; Behrouz,20,0,70,50
1657944522562,ECE 180,A00,083140,Abi Samra; Nicholas Camill,1,0,30,29
1657944522562,ECE 180,B00,083141,Abi Samra; Nicholas Camill,0,0,30,30
1657944528585,MATH 10A,A01,083735,Patchell; Gregory David,2,0,30,28
1657944528585,MATH 10A,A02,083736,Patchell; Gregory David,20,0,30,10
1657944528585,MATH 10A,A03,083737,Patchell; Gregory David,16,0,30,14
1657944534610,MATH 10B,A01,083207,Lim; Seonhee,9,0,34,25
1657944534610,MATH 10B,A02,083208,Lim; Seonhee,10,0,35,25
1657944534610,MATH 10B,A03,093472,Lim; Seonhee,7,0,34,27
1657944534610,MATH 10B,B01,083739,Sinha; Shubham,14,0,30,16
1657944540633,MATH 18,A01,083743,Cinel; Cameron Alexander,9,0,30,21
1657944540633,MATH 18,A02,083744,Cinel; Cameron Alexander,18,0,30,12
1657944540633,MATH 18,A03,083745,Cinel; Cameron Alexander,10,0,30,20
1657944540633,MATH 18,B01,083748,Rideout; David Porter,5,0,37,32
1657944540633,MATH 18,B02,083749,Rideout; David Porter,5,0,36,31
1657944540633,MATH 18,B03,083750,Rideout; David Porter,3,0,37,34
1657944540633,MATH 18,B04,083751,Rideout; David Porter,7,0,36,29
1657944540633,MATH 18,B05,093473,Rideout; David Porter,7,0,36,29
1657944540633,MATH 18,B06,093474,Rideout; David Porter,6,0,36,30
1657944546667,MATH 20A,A01,083754,Zheng; Zequn,14,0,40,26
1657944552693,MATH 20B,A01,083756,Briones; Jor-el Thomas Caparas,4,0,36,32
1657944552693,MATH 20B,A02,083757,Briones; Jor-el Thomas Caparas,1,0,36,35
1657944552693,MATH 20B,A03,093475,Briones; Jor-el Thomas Caparas,3,0,36,33
1657944558721,MATH 20C,A01,083760,Briones; Jor-el Thomas Caparas,1,0,35,34
1657944558721,MATH 20C,A02,083761,Briones; Jor-el Thomas Caparas,8,0,35,27
1657944558721,MATH 20C,A03,093476,Briones; Jor-el Thomas Caparas,0,1,36,36
1657944558721,MATH 20C,B01,083762,Bach; Quang Tran,1,0,30,29
1657944564744,MATH 20D,A01,083765,Tran; Brian Kha,5,0,30,25
1657944564744,MATH 20D,A02,083766,Tran; Brian Kha,5,0,30,25
1657944564744,MATH 20D,A03,083767,Tran; Brian Kha,6,0,30,24
1657944570773,MATH 20E,A01,083771,Ganguly; Soumya,12,0,32,20
1657944570773,MATH 20E,A02,083772,Ganguly; Soumya,7,0,32,25
1657944570773,MATH 20E,B01,083773,Ciotti; Benjamin,20,0,35,15
1657944570773,MATH 20E,B02,083774,Ciotti; Benjamin,18,0,35,17
1657944576802,MATH 103A,A01,083777,Greenfeld; Be'Eri,3,0,36,33
1657944576802,MATH 103A,A02,083778,Greenfeld; Be'Eri,5,0,36,31
1657944576802,MATH 103A,A03,093561,Greenfeld; Be'Eri,6,0,36,30
1657944576802,MATH 103A,B01,083779,Greenfeld; Be'Eri,8,0,36,28
1657944576802,MATH 103A,B02,083780,Greenfeld; Be'Eri,4,0,36,32
1657944576802,MATH 103A,B03,093562,Greenfeld; Be'Eri,3,0,36,33
1657944582829,MATH 105,A01,085443,Carter; Anne Toulson,15,0,35,20
1657944582829,MATH 105,A02,093477,Carter; Anne Toulson,20,0,35,15
1657944588852,MATH 109,A01,083213,Ganzberger; Geoffrey Michael,3,0,34,31
1657944588852,MATH 109,A02,083214,Ganzberger; Geoffrey Michael,4,0,34,30
1657944588852,MATH 109,A03,093478,Ganzberger; Geoffrey Michael,2,0,34,32
1657944588852,MATH 109,B01,083215,Ganzberger; Geoffrey Michael,3,0,32,29
1657944588852,MATH 109,B02,083216,Ganzberger; Geoffrey Michael,3,0,32,29
1657944588852,MATH 109,B03,093479,Ganzberger; Geoffrey Michael,8,0,32,24
1657944594875,MATH 142A,A01,083219,Chow; Bennett,7,0,32,25
1657944594875,MATH 142A,A02,083220,Chow; Bennett,10,0,32,22
1657944594875,MATH 142A,A03,093480,Chow; Bennett,9,0,32,23
1657944594875,MATH 142A,B03,093481,Chow; Bennett,8,0,32,24
1657944594875,MATH 142A,B04,093558,Chow; Bennett,14,0,32,18
1657944594875,MATH 142A,B05,093559,Chow; Bennett,7,0,32,25
1657944600898,MATH 193A,A01,083224,Rotar; Vladimir,8,0,34,26
1657944600898,MATH 193A,A02,083225,Rotar; Vladimir,10,0,34,24
1657944600898,MATH 193A,A03,083781,Rotar; Vladimir,5,0,34,29
1657944600898,MATH 193A,A04,083782,Rotar; Vladimir,11,0,34,23
1657944600898,MATH 193A,A05,093482,Rotar; Vladimir,11,0,34,23
1657944606922,MATH 197,001,091859,McAuley; Julian John,9999,0,9999,0
1657944606922,MATH 197,002,095566,Kedlaya; Kiran S.,9997,0,9999,2
1657944606922,MATH 197,003,095567,Xiao; Ming,9999,0,9999,0
1657944606922,MATH 197,004,095571,Perols; Johan Lars,9998,0,9999,1
1657944613984,COGS 9,A01,083615,Shannon; Kyle Michael,11,0,75,64
1657944620007,COGS 11,A01,083617,Boyle; Mary E. T.,23,0,48,25
1657944626034,COGS 13,A01,083071,Bastos; Amalia Pinkusfeld,12,0,71,59
1657944632057,COGS 14A,A01,092681,Semenuks; Arturs,5,1,100,95
1657944638103,COGS 14B,A01,083073,Cheng; Tzu-Han,7,0,63,56
1657944644126,COGS 17,A01,092677,Semenuks; Arturs,7,0,81,74
1657944650152,COGS 100,A01,083619,Allen; Michael Gordon,17,0,70,53
1657944656178,COGS 101A,A01,083621,Davis; Joshua Daniel,9,0,68,59
1657944662203,COGS 101B,A01,091572,Allen; Michael Gordon,14,0,65,51
1657944668229,COGS 101C,A01,083625,Delgado; Tania,17,0,35,18
1657944674255,COGS 107A,A01,083627,Boyle; Mary E. T.,14,0,60,46
1657944680281,COGS 118A,A01,083075,Gupta; Anjum,21,0,76,55
1657944686307,CSE 3,A50,083646,Miranda; Gregory Joseph,24,0,50,26
1657944692332,CSE 8A,A50,083650,Miranda; Gregory Joseph,17,1,56,39
1657944698364,CSE 11,A01,083080,Cao; Yingjun,6,15,40,34
1657944704388,CSE 12,A01,083652,Krause-Levy; Sophia Louisa,30,1,120,90
1657944710430,CSE 15L,A01,083654,Morris; Justin Loren,9,0,50,41
1657944710430,CSE 15L,A02,083655,Morris; Justin Loren,10,0,50,40
1657944716456,CSE 20,A01,083657,Tran; Khoa Dang,39,0,80,41
1657944722483,CSE 21,A01,095574,Bach; Quang Tran,23,0,48,25
1657944728506,CSE 30,A01,083084,Eldon; John,7,0,80,73
1657944728506,CSE 30,B01,095061,Bhaskar; Nishant,9,0,50,41
1657944734529,CSE 100,A01,083659,Cao; Yingjun,5,4,70,65
1657944740551,CSE 134B,A01,083661,Powell; Thomas Allan,25,0,100,75
1657944746583,CSE 140,A01,083663,Gungor; Onat,17,0,85,68
1657944752606,CSE 140L,A01,083088,Eldon; John,23,0,100,77
1657944758632,CSE 175,A01,083665,Kumar; Rakesh,3,0,25,22
1657944764656,CSE 190,A00,092507,Dubnov; Shlomo,8,0,20,12
1657944770694,ECE 45,A01,083139,Congero; Spencer William,7,0,75,68
1657944776791,ECE 65,A50,083695,Saad; Andrew S,12,0,30,18
1657944776791,ECE 65,A51,095125,Saad; Andrew S,24,0,26,2
1657944782814,ECE 109,A01,091882,Touri; Behrouz,20,0,70,50
1657944788842,ECE 180,A00,083140,Abi Samra; Nicholas Camill,1,0,30,29
1657944788842,ECE 180,B00,083141,Abi Samra; Nicholas Camill,0,0,30,30
1657944794868,MATH 10A,A01,083735,Patchell; Gregory David,2,0,30,28
1657944794868,MATH 10A,A02,083736,Patchell; Gregory David,20,0,30,10
1657944794868,MATH 10A,A03,083737,Patchell; Gregory David,16,0,30,14
1657944800898,MATH 10B,A01,083207,Lim; Seonhee,9,0,34,25
1657944800898,MATH 10B,A02,083208,Lim; Seonhee,10,0,35,25
1657944800898,MATH 10B,A03,093472,Lim; Seonhee,7,0,34,27
1657944800898,MATH 10B,B01,083739,Sinha; Shubham,14,0,30,16
1657944806929,MATH 18,A01,083743,Cinel; Cameron Alexander,9,0,30,21
1657944806929,MATH 18,A02,083744,Cinel; Cameron Alexander,18,0,30,12
1657944806929,MATH 18,A03,083745,Cinel; Cameron Alexander,10,0,30,20
1657944806929,MATH 18,B01,083748,Rideout; David Porter,5,0,37,32
1657944806929,MATH 18,B02,083749,Rideout; David Porter,5,0,36,31
1657944806929,MATH 18,B03,083750,Rideout; David Porter,3,0,37,34
1657944806929,MATH 18,B04,083751,Rideout; David Porter,7,0,36,29
1657944806929,MATH 18,B05,093473,Rideout; David Porter,7,0,36,29
1657944806929,MATH 18,B06,093474,Rideout; David Porter,6,0,36,30
1657944812955,MATH 20A,A01,083754,Zheng; Zequn,14,0,40,26
1657944818977,MATH 20B,A01,083756,Briones; Jor-el Thomas Caparas,4,0,36,32
1657944818977,MATH 20B,A02,083757,Briones; Jor-el Thomas Caparas,1,0,36,35
1657944818977,MATH 20B,A03,093475,Briones; Jor-el Thomas Caparas,3,0,36,33
1657944825001,MATH 20C,A01,083760,Briones; Jor-el Thomas Caparas,1,0,35,34
1657944825001,MATH 20C,A02,083761,Briones; Jor-el Thomas Caparas,8,0,35,27
1657944825001,MATH 20C,A03,093476,Briones; Jor-el Thomas Caparas,0,1,36,36
1657944825001,MATH 20C,B01,083762,Bach; Quang Tran,1,0,30,29
1657944831029,MATH 20D,A01,083765,Tran; Brian Kha,5,0,30,25
1657944831029,MATH 20D,A02,083766,Tran; Brian Kha,5,0,30,25
1657944831029,MATH 20D,A03,083767,Tran; Brian Kha,6,0,30,24
1657944837058,MATH 20E,A01,083771,Ganguly; Soumya,12,0,32,20
1657944837058,MATH 20E,A02,083772,Ganguly; Soumya,7,0,32,25
1657944837058,MATH 20E,B01,083773,Ciotti; Benjamin,20,0,35,15
1657944837058,MATH 20E,B02,083774,Ciotti; Benjamin,18,0,35,17
1657944843088,MATH 103A,A01,083777,Greenfeld; Be'Eri,3,0,36,33
1657944843088,MATH 103A,A02,083778,Greenfeld; Be'Eri,5,0,36,31
1657944843088,MATH 103A,A03,093561,Greenfeld; Be'Eri,6,0,36,30
1657944843088,MATH 103A,B01,083779,Greenfeld; Be'Eri,8,0,36,28
1657944843088,MATH 103A,B02,083780,Greenfeld; Be'Eri,4,0,36,32
1657944843088,MATH 103A,B03,093562,Greenfeld; Be'Eri,3,0,36,33
1657944849113,MATH 105,A01,085443,Carter; Anne Toulson,15,0,35,20
1657944849113,MATH 105,A02,093477,Carter; Anne Toulson,20,0,35,15
1657944855135,MATH 109,A01,083213,Ganzberger; Geoffrey Michael,3,0,34,31
1657944855135,MATH 109,A02,083214,Ganzberger; Geoffrey Michael,4,0,34,30
1657944855135,MATH 109,A03,093478,Ganzberger; Geoffrey Michael,2,0,34,32
1657944855135,MATH 109,B01,083215,Ganzberger; Geoffrey Michael,3,0,32,29
1657944855135,MATH 109,B02,083216,Ganzberger; Geoffrey Michael,3,0,32,29
1657944855135,MATH 109,B03,093479,Ganzberger; Geoffrey Michael,8,0,32,24
1657944861164,MATH 142A,A01,083219,Chow; Bennett,7,0,32,25
1657944861164,MATH 142A,A02,083220,Chow; Bennett,10,0,32,22
1657944861164,MATH 142A,A03,093480,Chow; Bennett,9,0,32,23
1657944861164,MATH 142A,B03,093481,Chow; Bennett,8,0,32,24
1657944861164,MATH 142A,B04,093558,Chow; Bennett,14,0,32,18
1657944861164,MATH 142A,B05,093559,Chow; Bennett,7,0,32,25
1657944867194,MATH 193A,A01,083224,Rotar; Vladimir,9,0,34,25
1657944867194,MATH 193A,A02,083225,Rotar; Vladimir,10,0,34,24
1657944867194,MATH 193A,A03,083781,Rotar; Vladimir,5,0,34,29
1657944867194,MATH 193A,A04,083782,Rotar; Vladimir,11,0,34,23
1657944867194,MATH 193A,A05,093482,Rotar; Vladimir,11,0,34,23
1657944873216,MATH 197,001,091859,McAuley; Julian John,9999,0,9999,0
1657944873216,MATH 197,002,095566,Kedlaya; Kiran S.,9997,0,9999,2
1657944873216,MATH 197,003,095567,Xiao; Ming,9999,0,9999,0
1657944873216,MATH 197,004,095571,Perols; Johan Lars,9998,0,9999,1
1657944880278,COGS 9,A01,083615,Shannon; Kyle Michael,11,0,75,64
1657944886300,COGS 11,A01,083617,Boyle; Mary E. T.,23,0,48,25
1657944892327,COGS 13,A01,083071,Bastos; Amalia Pinkusfeld,12,0,71,59
1657944898355,COGS 14A,A01,092681,Semenuks; Arturs,5,1,100,95
1657944904382,COGS 14B,A01,083073,Cheng; Tzu-Han,7,0,63,56
1657944910412,COGS 17,A01,092677,Semenuks; Arturs,7,0,81,74
1657944916441,COGS 100,A01,083619,Allen; Michael Gordon,17,0,70,53
1657944922468,COGS 101A,A01,083621,Davis; Joshua Daniel,9,0,68,59
1657944928490,COGS 101B,A01,091572,Allen; Michael Gordon,14,0,65,51
1657944934513,COGS 101C,A01,083625,Delgado; Tania,17,0,35,18
1657944940539,COGS 107A,A01,083627,Boyle; Mary E. T.,14,0,60,46
1657944946562,COGS 118A,A01,083075,Gupta; Anjum,21,0,76,55
1657944952585,CSE 3,A50,083646,Miranda; Gregory Joseph,24,0,50,26
1657944958607,CSE 8A,A50,083650,Miranda; Gregory Joseph,17,1,56,39
1657944964633,CSE 11,A01,083080,Cao; Yingjun,6,15,40,34
1657944970659,CSE 12,A01,083652,Krause-Levy; Sophia Louisa,30,1,120,90
1657944976680,CSE 15L,A01,083654,Morris; Justin Loren,9,0,50,41
1657944976680,CSE 15L,A02,083655,Morris; Justin Loren,10,0,50,40
1657944982708,CSE 20,A01,083657,Tran; Khoa Dang,39,0,80,41
1657944988736,CSE 21,A01,095574,Bach; Quang Tran,23,0,48,25
1657944994758,CSE 30,A01,083084,Eldon; John,7,0,80,73
1657944994758,CSE 30,B01,095061,Bhaskar; Nishant,9,0,50,41
1657945000781,CSE 100,A01,083659,Cao; Yingjun,5,4,70,65
1657945006806,CSE 134B,A01,083661,Powell; Thomas Allan,25,0,100,75
1657945012829,CSE 140,A01,083663,Gungor; Onat,17,0,85,68
1657945018857,CSE 140L,A01,083088,Eldon; John,23,0,100,77
1657945024879,CSE 175,A01,083665,Kumar; Rakesh,3,0,25,22
1657945030906,CSE 190,A00,092507,Dubnov; Shlomo,8,0,20,12
1657945036939,ECE 45,A01,083139,Congero; Spencer William,7,0,75,68
1657945042967,ECE 65,A50,083695,Saad; Andrew S,12,0,30,18
1657945042967,ECE 65,A51,095125,Saad; Andrew S,24,0,26,2
1657945048990,ECE 109,A01,091882,Touri; Behrouz,20,0,70,50
1657945055013,ECE 180,A00,083140,Abi Samra; Nicholas Camill,1,0,30,29
1657945055013,ECE 180,B00,083141,Abi Samra; Nicholas Camill,0,0,30,30
1657945061037,MATH 10A,A01,083735,Patchell; Gregory David,2,0,30,28
1657945061037,MATH 10A,A02,083736,Patchell; Gregory David,20,0,30,10
1657945061037,MATH 10A,A03,083737,Patchell; Gregory David,16,0,30,14
1657945067063,MATH 10B,A01,083207,Lim; Seonhee,9,0,34,25
1657945067063,MATH 10B,A02,083208,Lim; Seonhee,10,0,35,25
1657945067063,MATH 10B,A03,093472,Lim; Seonhee,7,0,34,27
1657945067063,MATH 10B,B01,083739,Sinha; Shubham,14,0,30,16
1657945073094,MATH 18,A01,083743,Cinel; Cameron Alexander,9,0,30,21
1657945073094,MATH 18,A02,083744,Cinel; Cameron Alexander,18,0,30,12
1657945073094,MATH 18,A03,083745,Cinel; Cameron Alexander,10,0,30,20
1657945073094,MATH 18,B01,083748,Rideout; David Porter,5,0,37,32
1657945073094,MATH 18,B02,083749,Rideout; David Porter,5,0,36,31
1657945073094,MATH 18,B03,083750,Rideout; David Porter,3,0,37,34
1657945073094,MATH 18,B04,083751,Rideout; David Porter,7,0,36,29
1657945073094,MATH 18,B05,093473,Rideout; David Porter,7,0,36,29
1657945073094,MATH 18,B06,093474,Rideout; David Porter,6,0,36,30
1657945079128,MATH 20A,A01,083754,Zheng; Zequn,14,0,40,26
1657945085151,MATH 20B,A01,083756,Briones; Jor-el Thomas Caparas,4,0,36,32
1657945085151,MATH 20B,A02,083757,Briones; Jor-el Thomas Caparas,1,0,36,35
1657945085151,MATH 20B,A03,093475,Briones; Jor-el Thomas Caparas,3,0,36,33
1657945091180,MATH 20C,A01,083760,Briones; Jor-el Thomas Caparas,1,0,35,34
1657945091180,MATH 20C,A02,083761,Briones; Jor-el Thomas Caparas,8,0,35,27
1657945091180,MATH 20C,A03,093476,Briones; Jor-el Thomas Caparas,0,1,36,36
1657945091180,MATH 20C,B01,083762,Bach; Quang Tran,1,0,30,29
1657945097207,MATH 20D,A01,083765,Tran; Brian Kha,5,0,30,25
1657945097207,MATH 20D,A02,083766,Tran; Brian Kha,5,0,30,25
1657945097207,MATH 20D,A03,083767,Tran; Brian Kha,6,0,30,24
1657945103233,MATH 20E,A01,083771,Ganguly; Soumya,12,0,32,20
1657945103233,MATH 20E,A02,083772,Ganguly; Soumya,7,0,32,25
1657945103233,MATH 20E,B01,083773,Ciotti; Benjamin,20,0,35,15
1657945103233,MATH 20E,B02,083774,Ciotti; Benjamin,18,0,35,17
1657945109258,MATH 103A,A01,083777,Greenfeld; Be'Eri,3,0,36,33
1657945109258,MATH 103A,A02,083778,Greenfeld; Be'Eri,5,0,36,31
1657945109258,MATH 103A,A03,093561,Greenfeld; Be'Eri,6,0,36,30
1657945109258,MATH 103A,B01,083779,Greenfeld; Be'Eri,8,0,36,28
1657945109258,MATH 103A,B02,083780,Greenfeld; Be'Eri,4,0,36,32
1657945109258,MATH 103A,B03,093562,Greenfeld; Be'Eri,3,0,36,33
1657945115281,MATH 105,A01,085443,Carter; Anne Toulson,15,0,35,20
1657945115281,MATH 105,A02,093477,Carter; Anne Toulson,20,0,35,15
1657945121308,MATH 109,A01,083213,Ganzberger; Geoffrey Michael,3,0,34,31
1657945121308,MATH 109,A02,083214,Ganzberger; Geoffrey Michael,4,0,34,30
1657945121308,MATH 109,A03,093478,Ganzberger; Geoffrey Michael,2,0,34,32
1657945121308,MATH 109,B01,083215,Ganzberger; Geoffrey Michael,3,0,32,29
1657945121308,MATH 109,B02,083216,Ganzberger; Geoffrey Michael,3,0,32,29
1657945121308,MATH 109,B03,093479,Ganzberger; Geoffrey Michael,8,0,32,24
1657945127338,MATH 142A,A01,083219,Chow; Bennett,7,0,32,25
1657945127338,MATH 142A,A02,083220,Chow; Bennett,10,0,32,22
1657945127338,MATH 142A,A03,093480,Chow; Bennett,9,0,32,23
1657945127338,MATH 142A,B03,093481,Chow; Bennett,8,0,32,24
1657945127338,MATH 142A,B04,093558,Chow; Bennett,14,0,32,18
1657945127338,MATH 142A,B05,093559,Chow; Bennett,7,0,32,25
1657945133366,MATH 193A,A01,083224,Rotar; Vladimir,9,0,34,25
1657945133366,MATH 193A,A02,083225,Rotar; Vladimir,10,0,34,24
1657945133366,MATH 193A,A03,083781,Rotar; Vladimir,5,0,34,29
1657945133366,MATH 193A,A04,083782,Rotar; Vladimir,11,0,34,23
1657945133366,MATH 193A,A05,093482,Rotar; Vladimir,11,0,34,23
1657945139399,MATH 197,001,091859,McAuley; Julian John,9999,0,9999,0
1657945139399,MATH 197,002,095566,Kedlaya; Kiran S.,9997,0,9999,2
1657945139399,MATH 197,003,095567,Xiao; Ming,9999,0,9999,0
1657945139399,MATH 197,004,095571,Perols; Johan Lars,9998,0,9999,1
1657945146462,COGS 9,A01,083615,Shannon; Kyle Michael,11,0,75,64
1657945152485,COGS 11,A01,083617,Boyle; Mary E. T.,23,0,48,25
1657945158514,COGS 13,A01,083071,Bastos; Amalia Pinkusfeld,12,0,71,59
1657945164537,COGS 14A,A01,092681,Semenuks; Arturs,5,1,100,95
1657945170562,COGS 14B,A01,083073,Cheng; Tzu-Han,7,0,63,56
1657945176597,COGS 17,A01,092677,Semenuks; Arturs,7,0,81,74
1657945182624,COGS 100,A01,083619,Allen; Michael Gordon,17,0,70,53
1657945188647,COGS 101A,A01,083621,Davis; Joshua Daniel,9,0,68,59
1657945194674,COGS 101B,A01,091572,Allen; Michael Gordon,14,0,65,51
1657945200700,COGS 101C,A01,083625,Delgado; Tania,17,0,35,18
1657945206725,COGS 107A,A01,083627,Boyle; Mary E. T.,14,0,60,46
1657945212748,COGS 118A,A01,083075,Gupta; Anjum,21,0,76,55
1657945218780,CSE 3,A50,083646,Miranda; Gregory Joseph,24,0,50,26
1657945224804,CSE 8A,A50,083650,Miranda; Gregory Joseph,17,1,56,39
1657945230830,CSE 11,A01,083080,Cao; Yingjun,6,15,40,34
1657945236855,CSE 12,A01,083652,Krause-Levy; Sophia Louisa,30,1,120,90
1657945242881,CSE 15L,A01,083654,Morris; Justin Loren,9,0,50,41
1657945242881,CSE 15L,A02,083655,Morris; Justin Loren,10,0,50,40
1657945248907,CSE 20,A01,083657,Tran; Khoa Dang,39,0,80,41
1657945254934,CSE 21,A01,095574,Bach; Quang Tran,23,0,48,25
1657945260960,CSE 30,A01,083084,Eldon; John,7,0,80,73
1657945260960,CSE 30,B01,095061,Bhaskar; Nishant,9,0,50,41
1657945266985,CSE 100,A01,083659,Cao; Yingjun,5,4,70,65
1657945273008,CSE 134B,A01,083661,Powell; Thomas Allan,25,0,100,75
1657945279049,CSE 140,A01,083663,Gungor; Onat,17,0,85,68
1657945285073,CSE 140L,A01,083088,Eldon; John,23,0,100,77
1657945291106,CSE 175,A01,083665,Kumar; Rakesh,3,0,25,22
1657945297129,CSE 190,A00,092507,Dubnov; Shlomo,8,0,20,12
1657945303152,ECE 45,A01,083139,Congero; Spencer William,7,0,75,68
1657945309175,ECE 65,A50,083695,Saad; Andrew S,12,0,30,18
1657945309175,ECE 65,A51,095125,Saad; Andrew S,24,0,26,2
1657945315198,ECE 109,A01,091882,Touri; Behrouz,20,0,70,50
1657945321228,ECE 180,A00,083140,Abi Samra; Nicholas Camill,1,0,30,29
1657945321228,ECE 180,B00,083141,Abi Samra; Nicholas Camill,0,0,30,30
1657945327250,MATH 10A,A01,083735,Patchell; Gregory David,2,0,30,28
1657945327250,MATH 10A,A02,083736,Patchell; Gregory David,20,0,30,10
1657945327250,MATH 10A,A03,083737,Patchell; Gregory David,16,0,30,14
1657945333279,MATH 10B,A01,083207,Lim; Seonhee,9,0,34,25
1657945333279,MATH 10B,A02,083208,Lim; Seonhee,10,0,35,25
1657945333279,MATH 10B,A03,093472,Lim; Seonhee,7,0,34,27
1657945333279,MATH 10B,B01,083739,Sinha; Shubham,14,0,30,16
1657945339302,MATH 18,A01,083743,Cinel; Cameron Alexander,9,0,30,21
1657945339302,MATH 18,A02,083744,Cinel; Cameron Alexander,18,0,30,12
1657945339302,MATH 18,A03,083745,Cinel; Cameron Alexander,10,0,30,20
1657945339302,MATH 18,B01,083748,Rideout; David Porter,5,0,37,32
1657945339302,MATH 18,B02,083749,Rideout; David Porter,5,0,36,31
1657945339302,MATH 18,B03,083750,Rideout; David Porter,3,0,37,34
1657945339302,MATH 18,B04,083751,Rideout; David Porter,7,0,36,29
1657945339302,MATH 18,B05,093473,Rideout; David Porter,7,0,36,29
1657945339302,MATH 18,B06,093474,Rideout; David Porter,6,0,36,30
1657945345330,MATH 20A,A01,083754,Zheng; Zequn,14,0,40,26
1657945351355,MATH 20B,A01,083756,Briones; Jor-el Thomas Caparas,4,0,36,32
1657945351355,MATH 20B,A02,083757,Briones; Jor-el Thomas Caparas,1,0,36,35
1657945351355,MATH 20B,A03,093475,Briones; Jor-el Thomas Caparas,3,0,36,33
1657945357383,MATH 20C,A01,083760,Briones; Jor-el Thomas Caparas,1,0,35,34
1657945357383,MATH 20C,A02,083761,Briones; Jor-el Thomas Caparas,8,0,35,27
1657945357383,MATH 20C,A03,093476,Briones; Jor-el Thomas Caparas,0,1,36,36
1657945357383,MATH 20C,B01,083762,Bach; Quang Tran,1,0,30,29
1657945363408,MATH 20D,A01,083765,Tran; Brian Kha,5,0,30,25
1657945363408,MATH 20D,A02,083766,Tran; Brian Kha,5,0,30,25
1657945363408,MATH 20D,A03,083767,Tran; Brian Kha,6,0,30,24
1657945369436,MATH 20E,A01,083771,Ganguly; Soumya,12,0,32,20
1657945369436,MATH 20E,A02,083772,Ganguly; Soumya,7,0,32,25
1657945369436,MATH 20E,B01,083773,Ciotti; Benjamin,20,0,35,15
1657945369436,MATH 20E,B02,083774,Ciotti; Benjamin,18,0,35,17
1657945375540,MATH 103A,A01,083777,Greenfeld; Be'Eri,3,0,36,33
1657945375540,MATH 103A,A02,083778,Greenfeld; Be'Eri,5,0,36,31
1657945375540,MATH 103A,A03,093561,Greenfeld; Be'Eri,7,0,36,29
1657945375540,MATH 103A,B01,083779,Greenfeld; Be'Eri,8,0,36,28
1657945375540,MATH 103A,B02,083780,Greenfeld; Be'Eri,4,0,36,32
1657945375540,MATH 103A,B03,093562,Greenfeld; Be'Eri,3,0,36,33
1657945381568,MATH 105,A01,085443,Carter; Anne Toulson,15,0,35,20
1657945381568,MATH 105,A02,093477,Carter; Anne Toulson,20,0,35,15
1657945387592,MATH 109,A01,083213,Ganzberger; Geoffrey Michael,3,0,34,31
1657945387592,MATH 109,A02,083214,Ganzberger; Geoffrey Michael,4,0,34,30
1657945387592,MATH 109,A03,093478,Ganzberger; Geoffrey Michael,2,0,34,32
1657945387592,MATH 109,B01,083215,Ganzberger; Geoffrey Michael,3,0,32,29
1657945387592,MATH 109,B02,083216,Ganzberger; Geoffrey Michael,3,0,32,29
1657945387592,MATH 109,B03,093479,Ganzberger; Geoffrey Michael,8,0,32,24
1657945393615,MATH 142A,A01,083219,Chow; Bennett,7,0,32,25
1657945393615,MATH 142A,A02,083220,Chow; Bennett,10,0,32,22
1657945393615,MATH 142A,A03,093480,Chow; Bennett,9,0,32,23
1657945393615,MATH 142A,B03,093481,Chow; Bennett,8,0,32,24
1657945393615,MATH 142A,B04,093558,Chow; Bennett,14,0,32,18
1657945393615,MATH 142A,B05,093559,Chow; Bennett,7,0,32,25
1657945399642,MATH 193A,A01,083224,Rotar; Vladimir,9,0,34,25
1657945399642,MATH 193A,A02,083225,Rotar; Vladimir,10,0,34,24
1657945399642,MATH 193A,A03,083781,Rotar; Vladimir,5,0,34,29
1657945399642,MATH 193A,A04,083782,Rotar; Vladimir,11,0,34,23
1657945399642,MATH 193A,A05,093482,Rotar; Vladimir,11,0,34,23
1657945405668,MATH 197,001,091859,McAuley; Julian John,9999,0,9999,0
1657945405668,MATH 197,002,095566,Kedlaya; Kiran S.,9997,0,9999,2
1657945405668,MATH 197,003,095567,Xiao; Ming,9999,0,9999,0
1657945405668,MATH 197,004,095571,Perols; Johan Lars,9998,0,9999,1
1657945412725,COGS 9,A01,083615,Shannon; Kyle Michael,11,0,75,64
1657945418751,COGS 11,A01,083617,Boyle; Mary E. T.,23,0,48,25
1657945424778,COGS 13,A01,083071,Bastos; Amalia Pinkusfeld,12,0,71,59
1657945430804,COGS 14A,A01,092681,Semenuks; Arturs,5,1,100,95
1657945436835,COGS 14B,A01,083073,Cheng; Tzu-Han,7,0,63,56
1657945442872,COGS 17,A01,092677,Semenuks; Arturs,7,0,81,74
1657945448899,COGS 100,A01,083619,Allen; Michael Gordon,17,0,70,53
1657945454921,COGS 101A,A01,083621,Davis; Joshua Daniel,9,0,68,59
1657945460945,COGS 101B,A01,091572,Allen; Michael Gordon,14,0,65,51
1657945466971,COGS 101C,A01,083625,Delgado; Tania,17,0,35,18
1657945472994,COGS 107A,A01,083627,Boyle; Mary E. T.,14,0,60,46
1657945479020,COGS 118A,A01,083075,Gupta; Anjum,21,0,76,55
1657945485048,CSE 3,A50,083646,Miranda; Gregory Joseph,24,0,50,26
1657945491072,CSE 8A,A50,083650,Miranda; Gregory Joseph,17,1,56,39
1657945497099,CSE 11,A01,083080,Cao; Yingjun,6,15,40,34
1657945503122,CSE 12,A01,083652,Krause-Levy; Sophia Louisa,30,1,120,90
1657945509145,CSE 15L,A01,083654,Morris; Justin Loren,9,0,50,41
1657945509145,CSE 15L,A02,083655,Morris; Justin Loren,10,0,50,40
1657945515167,CSE 20,A01,083657,Tran; Khoa Dang,39,0,80,41
1657945521193,CSE 21,A01,095574,Bach; Quang Tran,23,0,48,25
1657945527216,CSE 30,A01,083084,Eldon; John,7,0,80,73
1657945527216,CSE 30,B01,095061,Bhaskar; Nishant,9,0,50,41
1657945533248,CSE 100,A01,083659,Cao; Yingjun,5,4,70,65
1657945539269,CSE 134B,A01,083661,Powell; Thomas Allan,25,0,100,75
1657945545292,CSE 140,A01,083663,Gungor; Onat,17,0,85,68
1657945551315,CSE 140L,A01,083088,Eldon; John,23,0,100,77
1657945557341,CSE 175,A01,083665,Kumar; Rakesh,3,0,25,22
1657945563364,CSE 190,A00,092507,Dubnov; Shlomo,8,0,20,12
1657945569388,ECE 45,A01,083139,Congero; Spencer William,7,0,75,68
1657945575411,ECE 65,A50,083695,Saad; Andrew S,12,0,30,18
1657945575411,ECE 65,A51,095125,Saad; Andrew S,24,0,26,2
1657945581432,ECE 109,A01,091882,Touri; Behrouz,20,0,70,50
1657945587463,ECE 180,A00,083140,Abi Samra; Nicholas Camill,1,0,30,29
1657945587463,ECE 180,B00,083141,Abi Samra; Nicholas Camill,0,0,30,30
1657945593489,MATH 10A,A01,083735,Patchell; Gregory David,2,0,30,28
1657945593489,MATH 10A,A02,083736,Patchell; Gregory David,20,0,30,10
1657945593489,MATH 10A,A03,083737,Patchell; Gregory David,16,0,30,14
1657945599534,MATH 10B,A01,083207,Lim; Seonhee,9,0,34,25
1657945599534,MATH 10B,A02,083208,Lim; Seonhee,10,0,35,25
1657945599534,MATH 10B,A03,093472,Lim; Seonhee,7,0,34,27
1657945599534,MATH 10B,B01,083739,Sinha; Shubham,14,0,30,16
1657945605559,MATH 18,A01,083743,Cinel; Cameron Alexander,9,0,30,21
1657945605559,MATH 18,A02,083744,Cinel; Cameron Alexander,18,0,30,12
1657945605559,MATH 18,A03,083745,Cinel; Cameron Alexander,10,0,30,20
1657945605559,MATH 18,B01,083748,Rideout; David Porter,5,0,37,32
1657945605559,MATH 18,B02,083749,Rideout; David Porter,5,0,36,31
1657945605559,MATH 18,B03,083750,Rideout; David Porter,3,0,37,34
1657945605559,MATH 18,B04,083751,Rideout; David Porter,7,0,36,29
1657945605559,MATH 18,B05,093473,Rideout; David Porter,7,0,36,29
1657945605559,MATH 18,B06,093474,Rideout; David Porter,6,0,36,30
1657945611583,MATH 20A,A01,083754,Zheng; Zequn,14,0,40,26
1657945617621,MATH 20B,A01,083756,Briones; Jor-el Thomas Caparas,4,0,36,32
1657945617621,MATH 20B,A02,083757,Briones; Jor-el Thomas Caparas,1,0,36,35
1657945617621,MATH 20B,A03,093475,Briones; Jor-el Thomas Caparas,3,0,36,33
1657945623646,MATH 20C,A01,083760,Briones; Jor-el Thomas Caparas,1,0,35,34
1657945623646,MATH 20C,A02,083761,Briones; Jor-el Thomas Caparas,8,0,35,27
1657945623646,MATH 20C,A03,093476,Briones; Jor-el Thomas Caparas,0,1,36,36
1657945623646,MATH 20C,B01,083762,Bach; Quang Tran,1,0,30,29
1657945629674,MATH 20D,A01,083765,Tran; Brian Kha,5,0,30,25
1657945629674,MATH 20D,A02,083766,Tran; Brian Kha,5,0,30,25
1657945629674,MATH 20D,A03,083767,Tran; Brian Kha,6,0,30,24
1657945635698,MATH 20E,A01,083771,Ganguly; Soumya,12,0,32,20
1657945635698,MATH 20E,A02,083772,Ganguly; Soumya,7,0,32,25
1657945635698,MATH 20E,B01,083773,Ciotti; Benjamin,20,0,35,15
1657945635698,MATH 20E,B02,083774,Ciotti; Benjamin,18,0,35,17
1657945641723,MATH 103A,A01,083777,Greenfeld; Be'Eri,3,0,36,33
1657945641723,MATH 103A,A02,083778,Greenfeld; Be'Eri,5,0,36,31
1657945641723,MATH 103A,A03,093561,Greenfeld; Be'Eri,7,0,36,29
1657945641723,MATH 103A,B01,083779,Greenfeld; Be'Eri,8,0,36,28
1657945641723,MATH 103A,B02,083780,Greenfeld; Be'Eri,4,0,36,32
1657945641723,MATH 103A,B03,093562,Greenfeld; Be'Eri,3,0,36,33
1657945647745,MATH 105,A01,085443,Carter; Anne Toulson,15,0,35,20
1657945647745,MATH 105,A02,093477,Carter; Anne Toulson,20,0,35,15
1657945653775,MATH 109,A01,083213,Ganzberger; Geoffrey Michael,3,0,34,31
1657945653775,MATH 109,A02,083214,Ganzberger; Geoffrey Michael,4,0,34,30
1657945653775,MATH 109,A03,093478,Ganzberger; Geoffrey Michael,2,0,34,32
1657945653775,MATH 109,B01,083215,Ganzberger; Geoffrey Michael,3,0,32,29
1657945653775,MATH 109,B02,083216,Ganzberger; Geoffrey Michael,3,0,32,29
1657945653775,MATH 109,B03,093479,Ganzberger; Geoffrey Michael,8,0,32,24
1657945659804,MATH 142A,A01,083219,Chow; Bennett,7,0,32,25
1657945659804,MATH 142A,A02,083220,Chow; Bennett,10,0,32,22
1657945659804,MATH 142A,A03,093480,Chow; Bennett,9,0,32,23
1657945659804,MATH 142A,B03,093481,Chow; Bennett,8,0,32,24
1657945659804,MATH 142A,B04,093558,Chow; Bennett,14,0,32,18
1657945659804,MATH 142A,B05,093559,Chow; Bennett,7,0,32,25
1657945665833,MATH 193A,A01,083224,Rotar; Vladimir,9,0,34,25
1657945665833,MATH 193A,A02,083225,Rotar; Vladimir,10,0,34,24
1657945665833,MATH 193A,A03,083781,Rotar; Vladimir,5,0,34,29
1657945665833,MATH 193A,A04,083782,Rotar; Vladimir,11,0,34,23
1657945665833,MATH 193A,A05,093482,Rotar; Vladimir,11,0,34,23
1657945671859,MATH 197,001,091859,McAuley; Julian John,9999,0,9999,0
1657945671859,MATH 197,002,095566,Kedlaya; Kiran S.,9997,0,9999,2
1657945671859,MATH 197,003,095567,Xiao; Ming,9999,0,9999,0
1657945671859,MATH 197,004,095571,Perols; Johan Lars,9998,0,9999,1
1657945678921,COGS 9,A01,083615,Shannon; Kyle Michael,11,0,75,64
1657945684948,COGS 11,A01,083617,Boyle; Mary E. T.,23,0,48,25
1657945690999,COGS 13,A01,083071,Bastos; Amalia Pinkusfeld,12,0,71,59
1657945697025,COGS 14A,A01,092681,Semenuks; Arturs,5,1,100,95
1657945703048,COGS 14B,A01,083073,Cheng; Tzu-Han,7,0,63,56
1657945709071,COGS 17,A01,092677,Semenuks; Arturs,7,0,81,74
1657945715097,COGS 100,A01,083619,Allen; Michael Gordon,17,0,70,53
1657945721119,COGS 101A,A01,083621,Davis; Joshua Daniel,9,0,68,59
1657945727145,COGS 101B,A01,091572,Allen; Michael Gordon,14,0,65,51
1657945733170,COGS 101C,A01,083625,Delgado; Tania,17,0,35,18
1657945739192,COGS 107A,A01,083627,Boyle; Mary E. T.,14,0,60,46
1657945745221,COGS 118A,A01,083075,Gupta; Anjum,21,0,76,55
1657945751256,CSE 3,A50,083646,Miranda; Gregory Joseph,24,0,50,26
1657945757279,CSE 8A,A50,083650,Miranda; Gregory Joseph,17,1,56,39
1657945763304,CSE 11,A01,083080,Cao; Yingjun,6,15,40,34
1657945769336,CSE 12,A01,083652,Krause-Levy; Sophia Louisa,30,1,120,90
1657945775363,CSE 15L,A01,083654,Morris; Justin Loren,9,0,50,41
1657945775363,CSE 15L,A02,083655,Morris; Justin Loren,10,0,50,40
1657945781386,CSE 20,A01,083657,Tran; Khoa Dang,39,0,80,41
1657945787413,CSE 21,A01,095574,Bach; Quang Tran,23,0,48,25
1657945793437,CSE 30,A01,083084,Eldon; John,7,0,80,73
1657945793437,CSE 30,B01,095061,Bhaskar; Nishant,9,0,50,41
1657945799460,CSE 100,A01,083659,Cao; Yingjun,5,4,70,65
1657945805482,CSE 134B,A01,083661,Powell; Thomas Allan,25,0,100,75
1657945811504,CSE 140,A01,083663,Gungor; Onat,17,0,85,68
1657945817529,CSE 140L,A01,083088,Eldon; John,23,0,100,77
1657945823556,CSE 175,A01,083665,Kumar; Rakesh,3,0,25,22
1657945829579,CSE 190,A00,092507,Dubnov; Shlomo,8,0,20,12
1657945835603,ECE 45,A01,083139,Congero; Spencer William,7,0,75,68
1657945841627,ECE 65,A50,083695,Saad; Andrew S,12,0,30,18
1657945841627,ECE 65,A51,095125,Saad; Andrew S,24,0,26,2
1657945847654,ECE 109,A01,091882,Touri; Behrouz,20,0,70,50
1657945853678,ECE 180,A00,083140,Abi Samra; Nicholas Camill,1,0,30,29
1657945853678,ECE 180,B00,083141,Abi Samra; Nicholas Camill,0,0,30,30
1657945859703,MATH 10A,A01,083735,Patchell; Gregory David,2,0,30,28
1657945859703,MATH 10A,A02,083736,Patchell; Gregory David,20,0,30,10
1657945859703,MATH 10A,A03,083737,Patchell; Gregory David,16,0,30,14
1657945865728,MATH 10B,A01,083207,Lim; Seonhee,9,0,34,25
1657945865728,MATH 10B,A02,083208,Lim; Seonhee,10,0,35,25
1657945865728,MATH 10B,A03,093472,Lim; Seonhee,7,0,34,27
1657945865728,MATH 10B,B01,083739,Sinha; Shubham,14,0,30,16
1657945871752,MATH 18,A01,083743,Cinel; Cameron Alexander,9,0,30,21
1657945871752,MATH 18,A02,083744,Cinel; Cameron Alexander,18,0,30,12
1657945871752,MATH 18,A03,083745,Cinel; Cameron Alexander,10,0,30,20
1657945871752,MATH 18,B01,083748,Rideout; David Porter,5,0,37,32
1657945871752,MATH 18,B02,083749,Rideout; David Porter,5,0,36,31
1657945871752,MATH 18,B03,083750,Rideout; David Porter,3,0,37,34
1657945871752,MATH 18,B04,083751,Rideout; David Porter,7,0,36,29
1657945871752,MATH 18,B05,093473,Rideout; David Porter,7,0,36,29
1657945871752,MATH 18,B06,093474,Rideout; David Porter,6,0,36,30
1657945877780,MATH 20A,A01,083754,Zheng; Zequn,14,0,40,26
1657945883809,MATH 20B,A01,083756,Briones; Jor-el Thomas Caparas,4,0,36,32
1657945883809,MATH 20B,A02,083757,Briones; Jor-el Thomas Caparas,1,0,36,35
1657945883809,MATH 20B,A03,093475,Briones; Jor-el Thomas Caparas,3,0,36,33
1657945889835,MATH 20C,A01,083760,Briones; Jor-el Thomas Caparas,1,0,35,34
1657945889835,MATH 20C,A02,083761,Briones; Jor-el Thomas Caparas,8,0,35,27
1657945889835,MATH 20C,A03,093476,Briones; Jor-el Thomas Caparas,0,1,36,36
1657945889835,MATH 20C,B01,083762,Bach; Quang Tran,1,0,30,29
1657945895861,MATH 20D,A01,083765,Tran; Brian Kha,5,0,30,25
1657945895861,MATH 20D,A02,083766,Tran; Brian Kha,5,0,30,25
1657945895861,MATH 20D,A03,083767,Tran; Brian Kha,6,0,30,24
1657945901891,MATH 20E,A01,083771,Ganguly; Soumya,12,0,32,20
1657945901891,MATH 20E,A02,083772,Ganguly; Soumya,7,0,32,25
1657945901891,MATH 20E,B01,083773,Ciotti; Benjamin,20,0,35,15
1657945901891,MATH 20E,B02,083774,Ciotti; Benjamin,18,0,35,17
1657945907915,MATH 103A,A01,083777,Greenfeld; Be'Eri,3,0,36,33
1657945907915,MATH 103A,A02,083778,Greenfeld; Be'Eri,5,0,36,31
1657945907915,MATH 103A,A03,093561,Greenfeld; Be'Eri,7,0,36,29
1657945907915,MATH 103A,B01,083779,Greenfeld; Be'Eri,8,0,36,28
1657945907915,MATH 103A,B02,083780,Greenfeld; Be'Eri,4,0,36,32
1657945907915,MATH 103A,B03,093562,Greenfeld; Be'Eri,3,0,36,33
1657945913943,MATH 105,A01,085443,Carter; Anne Toulson,15,0,35,20
1657945913943,MATH 105,A02,093477,Carter; Anne Toulson,20,0,35,15
1657945919970,MATH 109,A01,083213,Ganzberger; Geoffrey Michael,3,0,34,31
1657945919970,MATH 109,A02,083214,Ganzberger; Geoffrey Michael,4,0,34,30
1657945919970,MATH 109,A03,093478,Ganzberger; Geoffrey Michael,2,0,34,32
1657945919970,MATH 109,B01,083215,Ganzberger; Geoffrey Michael,3,0,32,29
1657945919970,MATH 109,B02,083216,Ganzberger; Geoffrey Michael,3,0,32,29
1657945919970,MATH 109,B03,093479,Ganzberger; Geoffrey Michael,8,0,32,24
1657945926003,MATH 142A,A01,083219,Chow; Bennett,7,0,32,25
1657945926003,MATH 142A,A02,083220,Chow; Bennett,10,0,32,22
1657945926003,MATH 142A,A03,093480,Chow; Bennett,9,0,32,23
1657945926003,MATH 142A,B03,093481,Chow; Bennett,8,0,32,24
1657945926003,MATH 142A,B04,093558,Chow; Bennett,14,0,32,18
1657945926003,MATH 142A,B05,093559,Chow; Bennett,7,0,32,25
1657945932028,MATH 193A,A01,083224,Rotar; Vladimir,9,0,34,25
1657945932028,MATH 193A,A02,083225,Rotar; Vladimir,10,0,34,24
1657945932028,MATH 193A,A03,083781,Rotar; Vladimir,5,0,34,29
1657945932028,MATH 193A,A04,083782,Rotar; Vladimir,11,0,34,23
1657945932028,MATH 193A,A05,093482,Rotar; Vladimir,11,0,34,23
1657945938053,MATH 197,001,091859,McAuley; Julian John,9999,0,9999,0
1657945938053,MATH 197,002,095566,Kedlaya; Kiran S.,9997,0,9999,2
1657945938053,MATH 197,003,095567,Xiao; Ming,9999,0,9999,0
1657945938053,MATH 197,004,095571,Perols; Johan Lars,9998,0,9999,1
1657945954410,COGS 9,A01,083615,Shannon; Kyle Michael,11,0,75,64
1657945960438,COGS 11,A01,083617,Boyle; Mary E. T.,23,0,48,25
1657945966463,COGS 13,A01,083071,Bastos; Amalia Pinkusfeld,12,0,71,59
1657945972492,COGS 14A,A01,092681,Semenuks; Arturs,5,1,100,95
1657945978589,COGS 14B,A01,083073,Cheng; Tzu-Han,7,0,63,56
1657945984612,COGS 17,A01,092677,Semenuks; Arturs,7,0,81,74
1657945990637,COGS 100,A01,083619,Allen; Michael Gordon,17,0,70,53
1657945996669,COGS 101A,A01,083621,Davis; Joshua Daniel,9,0,68,59
1657946002691,COGS 101B,A01,091572,Allen; Michael Gordon,14,0,65,51
1657946008715,COGS 101C,A01,083625,Delgado; Tania,17,0,35,18
1657946014739,COGS 107A,A01,083627,Boyle; Mary E. T.,14,0,60,46
1657946020766,COGS 118A,A01,083075,Gupta; Anjum,21,0,76,55
1657946026789,CSE 3,A50,083646,Miranda; Gregory Joseph,24,0,50,26
1657946032816,CSE 8A,A50,083650,Miranda; Gregory Joseph,17,1,56,39
1657946038844,CSE 11,A01,083080,Cao; Yingjun,6,15,40,34
1657946044870,CSE 12,A01,083652,Krause-Levy; Sophia Louisa,30,1,120,90
1657946050893,CSE 15L,A01,083654,Morris; Justin Loren,9,0,50,41
1657946050893,CSE 15L,A02,083655,Morris; Justin Loren,10,0,50,40
1657946056916,CSE 20,A01,083657,Tran; Khoa Dang,39,0,80,41
1657946062939,CSE 21,A01,095574,Bach; Quang Tran,23,0,48,25
1657946068964,CSE 30,A01,083084,Eldon; John,7,0,80,73
1657946068964,CSE 30,B01,095061,Bhaskar; Nishant,9,0,50,41
1657946074989,CSE 100,A01,083659,Cao; Yingjun,5,4,70,65
1657946081013,CSE 134B,A01,083661,Powell; Thomas Allan,25,0,100,75
1657946087037,CSE 140,A01,083663,Gungor; Onat,17,0,85,68
1657946093060,CSE 140L,A01,083088,Eldon; John,23,0,100,77
1657946099084,CSE 175,A01,083665,Kumar; Rakesh,3,0,25,22
1657946105112,CSE 190,A00,092507,Dubnov; Shlomo,8,0,20,12
1657946111134,ECE 45,A01,083139,Congero; Spencer William,7,0,75,68
1657946117157,ECE 65,A50,083695,Saad; Andrew S,12,0,30,18
1657946117157,ECE 65,A51,095125,Saad; Andrew S,24,0,26,2
1657946123190,ECE 109,A01,091882,Touri; Behrouz,20,0,70,50
1657946129213,ECE 180,A00,083140,Abi Samra; Nicholas Camill,1,0,30,29
1657946129213,ECE 180,B00,083141,Abi Samra; Nicholas Camill,0,0,30,30
1657946135237,MATH 10A,A01,083735,Patchell; Gregory David,2,0,30,28
1657946135237,MATH 10A,A02,083736,Patchell; Gregory David,20,0,30,10
1657946135237,MATH 10A,A03,083737,Patchell; Gregory David,16,0,30,14
1657946141263,MATH 10B,A01,083207,Lim; Seonhee,9,0,34,25
1657946141263,MATH 10B,A02,083208,Lim; Seonhee,10,0,35,25
1657946141263,MATH 10B,A03,093472,Lim; Seonhee,7,0,34,27
1657946141263,MATH 10B,B01,083739,Sinha; Shubham,14,0,30,16
1657946147299,MATH 18,A01,083743,Cinel; Cameron Alexander,9,0,30,21
1657946147299,MATH 18,A02,083744,Cinel; Cameron Alexander,18,0,30,12
1657946147299,MATH 18,A03,083745,Cinel; Cameron Alexander,10,0,30,20
1657946147299,MATH 18,B01,083748,Rideout; David Porter,5,0,37,32
1657946147299,MATH 18,B02,083749,Rideout; David Porter,5,0,36,31
1657946147299,MATH 18,B03,083750,Rideout; David Porter,3,0,37,34
1657946147299,MATH 18,B04,083751,Rideout; David Porter,7,0,36,29
1657946147299,MATH 18,B05,093473,Rideout; David Porter,7,0,36,29
1657946147299,MATH 18,B06,093474,Rideout; David Porter,6,0,36,30
1657946153322,MATH 20A,A01,083754,Zheng; Zequn,14,0,40,26
1657946159351,MATH 20B,A01,083756,Briones; Jor-el Thomas Caparas,4,0,36,32
1657946159351,MATH 20B,A02,083757,Briones; Jor-el Thomas Caparas,1,0,36,35
1657946159351,MATH 20B,A03,093475,Briones; Jor-el Thomas Caparas,3,0,36,33
1657946165375,MATH 20C,A01,083760,Briones; Jor-el Thomas Caparas,1,0,35,34
1657946165375,MATH 20C,A02,083761,Briones; Jor-el Thomas Caparas,8,0,35,27
1657946165375,MATH 20C,A03,093476,Briones; Jor-el Thomas Caparas,0,1,36,36
1657946165375,MATH 20C,B01,083762,Bach; Quang Tran,1,0,30,29
1657946171405,MATH 20D,A01,083765,Tran; Brian Kha,5,0,30,25
1657946171405,MATH 20D,A02,083766,Tran; Brian Kha,5,0,30,25
1657946171405,MATH 20D,A03,083767,Tran; Brian Kha,6,0,30,24
1657946177432,MATH 20E,A01,083771,Ganguly; Soumya,12,0,32,20
1657946177432,MATH 20E,A02,083772,Ganguly; Soumya,7,0,32,25
1657946177432,MATH 20E,B01,083773,Ciotti; Benjamin,20,0,35,15
1657946177432,MATH 20E,B02,083774,Ciotti; Benjamin,18,0,35,17
1657946183462,MATH 103A,A01,083777,Greenfeld; Be'Eri,3,0,36,33
1657946183462,MATH 103A,A02,083778,Greenfeld; Be'Eri,5,0,36,31
1657946183462,MATH 103A,A03,093561,Greenfeld; Be'Eri,7,0,36,29
1657946183462,MATH 103A,B01,083779,Greenfeld; Be'Eri,8,0,36,28
1657946183462,MATH 103A,B02,083780,Greenfeld; Be'Eri,4,0,36,32
1657946183462,MATH 103A,B03,093562,Greenfeld; Be'Eri,3,0,36,33
1657946189487,MATH 105,A01,085443,Carter; Anne Toulson,15,0,35,20
1657946189487,MATH 105,A02,093477,Carter; Anne Toulson,20,0,35,15
1657946195517,MATH 109,A01,083213,Ganzberger; Geoffrey Michael,3,0,34,31
1657946195517,MATH 109,A02,083214,Ganzberger; Geoffrey Michael,4,0,34,30
1657946195517,MATH 109,A03,093478,Ganzberger; Geoffrey Michael,2,0,34,32
1657946195517,MATH 109,B01,083215,Ganzberger; Geoffrey Michael,3,0,32,29
1657946195517,MATH 109,B02,083216,Ganzberger; Geoffrey Michael,3,0,32,29
1657946195517,MATH 109,B03,093479,Ganzberger; Geoffrey Michael,8,0,32,24
1657946201547,MATH 142A,A01,083219,Chow; Bennett,7,0,32,25
1657946201547,MATH 142A,A02,083220,Chow; Bennett,10,0,32,22
1657946201547,MATH 142A,A03,093480,Chow; Bennett,9,0,32,23
1657946201547,MATH 142A,B03,093481,Chow; Bennett,8,0,32,24
1657946201547,MATH 142A,B04,093558,Chow; Bennett,14,0,32,18
1657946201547,MATH 142A,B05,093559,Chow; Bennett,7,0,32,25
1657946207569,MATH 193A,A01,083224,Rotar; Vladimir,9,0,34,25
1657946207569,MATH 193A,A02,083225,Rotar; Vladimir,10,0,34,24
1657946207569,MATH 193A,A03,083781,Rotar; Vladimir,5,0,34,29
1657946207569,MATH 193A,A04,083782,Rotar; Vladimir,11,0,34,23
1657946207569,MATH 193A,A05,093482,Rotar; Vladimir,11,0,34,23
1657946213594,MATH 197,001,091859,McAuley; Julian John,9999,0,9999,0
1657946213594,MATH 197,002,095566,Kedlaya; Kiran S.,9997,0,9999,2
1657946213594,MATH 197,003,095567,Xiao; Ming,9999,0,9999,0
1657946213594,MATH 197,004,095571,Perols; Johan Lars,9998,0,9999,1
1657946220647,COGS 9,A01,083615,Shannon; Kyle Michael,11,0,75,64
1657946226670,COGS 11,A01,083617,Boyle; Mary E. T.,23,0,48,25
1657946232694,COGS 13,A01,083071,Bastos; Amalia Pinkusfeld,12,0,71,59
1657946238717,COGS 14A,A01,092681,Semenuks; Arturs,5,1,100,95
1657946244744,COGS 14B,A01,083073,Cheng; Tzu-Han,7,0,63,56
1657946250767,COGS 17,A01,092677,Semenuks; Arturs,7,0,81,74
1657946256791,COGS 100,A01,083619,Allen; Michael Gordon,17,0,70,53
1657946262814,COGS 101A,A01,083621,Davis; Joshua Daniel,9,0,68,59
1657946268838,COGS 101B,A01,091572,Allen; Michael Gordon,14,0,65,51
1657946274867,COGS 101C,A01,083625,Delgado; Tania,17,0,35,18
1657946280891,COGS 107A,A01,083627,Boyle; Mary E. T.,14,0,60,46
1657946286916,COGS 118A,A01,083075,Gupta; Anjum,21,0,76,55
1657946292940,CSE 3,A50,083646,Miranda; Gregory Joseph,24,0,50,26
1657946298966,CSE 8A,A50,083650,Miranda; Gregory Joseph,17,1,56,39
1657946304990,CSE 11,A01,083080,Cao; Yingjun,6,15,40,34
1657946311013,CSE 12,A01,083652,Krause-Levy; Sophia Louisa,30,1,120,90
1657946317035,CSE 15L,A01,083654,Morris; Justin Loren,9,0,50,41
1657946317035,CSE 15L,A02,083655,Morris; Justin Loren,10,0,50,40
1657946323061,CSE 20,A01,083657,Tran; Khoa Dang,39,0,80,41
1657946329088,CSE 21,A01,095574,Bach; Quang Tran,23,0,48,25
1657946335115,CSE 30,A01,083084,Eldon; John,7,0,80,73
1657946335115,CSE 30,B01,095061,Bhaskar; Nishant,9,0,50,41
1657946341139,CSE 100,A01,083659,Cao; Yingjun,5,4,70,65
1657946347161,CSE 134B,A01,083661,Powell; Thomas Allan,25,0,100,75
1657946353188,CSE 140,A01,083663,Gungor; Onat,17,0,85,68
1657946359225,CSE 140L,A01,083088,Eldon; John,23,0,100,77
1657946365249,CSE 175,A01,083665,Kumar; Rakesh,3,0,25,22
1657946371277,CSE 190,A00,092507,Dubnov; Shlomo,8,0,20,12
1657946377309,ECE 45,A01,083139,Congero; Spencer William,7,0,75,68
1657946383332,ECE 65,A50,083695,Saad; Andrew S,12,0,30,18
1657946383332,ECE 65,A51,095125,Saad; Andrew S,24,0,26,2
1657946389356,ECE 109,A01,091882,Touri; Behrouz,20,0,70,50
1657946395379,ECE 180,A00,083140,Abi Samra; Nicholas Camill,1,0,30,29
1657946395379,ECE 180,B00,083141,Abi Samra; Nicholas Camill,0,0,30,30
1657946401404,MATH 10A,A01,083735,Patchell; Gregory David,2,0,30,28
1657946401404,MATH 10A,A02,083736,Patchell; Gregory David,20,0,30,10
1657946401404,MATH 10A,A03,083737,Patchell; Gregory David,16,0,30,14
1657946407432,MATH 10B,A01,083207,Lim; Seonhee,9,0,34,25
1657946407432,MATH 10B,A02,083208,Lim; Seonhee,10,0,35,25
1657946407432,MATH 10B,A03,093472,Lim; Seonhee,7,0,34,27
1657946407432,MATH 10B,B01,083739,Sinha; Shubham,14,0,30,16
1657946413463,MATH 18,A01,083743,Cinel; Cameron Alexander,9,0,30,21
1657946413463,MATH 18,A02,083744,Cinel; Cameron Alexander,18,0,30,12
1657946413463,MATH 18,A03,083745,Cinel; Cameron Alexander,10,0,30,20
1657946413463,MATH 18,B01,083748,Rideout; David Porter,5,0,37,32
1657946413463,MATH 18,B02,083749,Rideout; David Porter,5,0,36,31
1657946413463,MATH 18,B03,083750,Rideout; David Porter,3,0,37,34
1657946413463,MATH 18,B04,083751,Rideout; David Porter,7,0,36,29
1657946413463,MATH 18,B05,093473,Rideout; David Porter,7,0,36,29
1657946413463,MATH 18,B06,093474,Rideout; David Porter,6,0,36,30
1657946419489,MATH 20A,A01,083754,Zheng; Zequn,14,0,40,26
1657946425515,MATH 20B,A01,083756,Briones; Jor-el Thomas Caparas,4,0,36,32
1657946425515,MATH 20B,A02,083757,Briones; Jor-el Thomas Caparas,1,0,36,35
1657946425515,MATH 20B,A03,093475,Briones; Jor-el Thomas Caparas,3,0,36,33
1657946431543,MATH 20C,A01,083760,Briones; Jor-el Thomas Caparas,1,0,35,34
1657946431543,MATH 20C,A02,083761,Briones; Jor-el Thomas Caparas,8,0,35,27
1657946431543,MATH 20C,A03,093476,Briones; Jor-el Thomas Caparas,0,1,36,36
1657946431543,MATH 20C,B01,083762,Bach; Quang Tran,1,0,30,29
1657946437572,MATH 20D,A01,083765,Tran; Brian Kha,5,0,30,25
1657946437572,MATH 20D,A02,083766,Tran; Brian Kha,5,0,30,25
1657946437572,MATH 20D,A03,083767,Tran; Brian Kha,6,0,30,24
1657946443595,MATH 20E,A01,083771,Ganguly; Soumya,12,0,32,20
1657946443595,MATH 20E,A02,083772,Ganguly; Soumya,7,0,32,25
1657946443595,MATH 20E,B01,083773,Ciotti; Benjamin,20,0,35,15
1657946443595,MATH 20E,B02,083774,Ciotti; Benjamin,18,0,35,17
1657946449618,MATH 103A,A01,083777,Greenfeld; Be'Eri,3,0,36,33
1657946449618,MATH 103A,A02,083778,Greenfeld; Be'Eri,5,0,36,31
1657946449618,MATH 103A,A03,093561,Greenfeld; Be'Eri,7,0,36,29
1657946449618,MATH 103A,B01,083779,Greenfeld; Be'Eri,8,0,36,28
1657946449618,MATH 103A,B02,083780,Greenfeld; Be'Eri,4,0,36,32
1657946449618,MATH 103A,B03,093562,Greenfeld; Be'Eri,3,0,36,33
1657946455642,MATH 105,A01,085443,Carter; Anne Toulson,15,0,35,20
1657946455642,MATH 105,A02,093477,Carter; Anne Toulson,20,0,35,15
1657946461665,MATH 109,A01,083213,Ganzberger; Geoffrey Michael,3,0,34,31
1657946461665,MATH 109,A02,083214,Ganzberger; Geoffrey Michael,4,0,34,30
1657946461665,MATH 109,A03,093478,Ganzberger; Geoffrey Michael,2,0,34,32
1657946461665,MATH 109,B01,083215,Ganzberger; Geoffrey Michael,3,0,32,29
1657946461665,MATH 109,B02,083216,Ganzberger; Geoffrey Michael,3,0,32,29
1657946461665,MATH 109,B03,093479,Ganzberger; Geoffrey Michael,8,0,32,24
1657946467688,MATH 142A,A01,083219,Chow; Bennett,7,0,32,25
1657946467688,MATH 142A,A02,083220,Chow; Bennett,10,0,32,22
1657946467688,MATH 142A,A03,093480,Chow; Bennett,9,0,32,23
1657946467688,MATH 142A,B03,093481,Chow; Bennett,8,0,32,24
1657946467688,MATH 142A,B04,093558,Chow; Bennett,14,0,32,18
1657946467688,MATH 142A,B05,093559,Chow; Bennett,7,0,32,25
1657946473719,MATH 193A,A01,083224,Rotar; Vladimir,9,0,34,25
1657946473719,MATH 193A,A02,083225,Rotar; Vladimir,10,0,34,24
1657946473719,MATH 193A,A03,083781,Rotar; Vladimir,5,0,34,29
1657946473719,MATH 193A,A04,083782,Rotar; Vladimir,11,0,34,23
1657946473719,MATH 193A,A05,093482,Rotar; Vladimir,11,0,34,23
1657946479740,MATH 197,001,091859,McAuley; Julian John,9999,0,9999,0
1657946479740,MATH 197,002,095566,Kedlaya; Kiran S.,9997,0,9999,2
1657946479740,MATH 197,003,095567,Xiao; Ming,9999,0,9999,0
1657946479740,MATH 197,004,095571,Perols; Johan Lars,9998,0,9999,1
1657946486810,COGS 9,A01,083615,Shannon; Kyle Michael,11,0,75,64
1657946492834,COGS 11,A01,083617,Boyle; Mary E. T.,23,0,48,25
1657946498858,COGS 13,A01,083071,Bastos; Amalia Pinkusfeld,12,0,71,59
1657946504882,COGS 14A,A01,092681,Semenuks; Arturs,5,1,100,95
1657946510910,COGS 14B,A01,083073,Cheng; Tzu-Han,7,0,63,56
1657946516934,COGS 17,A01,092677,Semenuks; Arturs,7,0,81,74
1657946522956,COGS 100,A01,083619,Allen; Michael Gordon,17,0,70,53
1657946528980,COGS 101A,A01,083621,Davis; Joshua Daniel,9,0,68,59
1657946535006,COGS 101B,A01,091572,Allen; Michael Gordon,14,0,65,51
1657946541038,COGS 101C,A01,083625,Delgado; Tania,17,0,35,18
1657946547060,COGS 107A,A01,083627,Boyle; Mary E. T.,14,0,60,46
1657946553082,COGS 118A,A01,083075,Gupta; Anjum,21,0,76,55
1657946559106,CSE 3,A50,083646,Miranda; Gregory Joseph,24,0,50,26
1657946565130,CSE 8A,A50,083650,Miranda; Gregory Joseph,17,1,56,39
1657946571154,CSE 11,A01,083080,Cao; Yingjun,6,15,40,34
1657946577249,CSE 12,A01,083652,Krause-Levy; Sophia Louisa,30,1,120,90
1657946583277,CSE 15L,A01,083654,Morris; Justin Loren,9,0,50,41
1657946583277,CSE 15L,A02,083655,Morris; Justin Loren,10,0,50,40
1657946589299,CSE 20,A01,083657,Tran; Khoa Dang,39,0,80,41
1657946595322,CSE 21,A01,095574,Bach; Quang Tran,23,0,48,25
1657946601353,CSE 30,A01,083084,Eldon; John,7,0,80,73
1657946601353,CSE 30,B01,095061,Bhaskar; Nishant,9,0,50,41
1657946607379,CSE 100,A01,083659,Cao; Yingjun,5,4,70,65
1657946613402,CSE 134B,A01,083661,Powell; Thomas Allan,25,0,100,75
1657946619427,CSE 140,A01,083663,Gungor; Onat,17,0,85,68
1657946625452,CSE 140L,A01,083088,Eldon; John,23,0,100,77
1657946631475,CSE 175,A01,083665,Kumar; Rakesh,3,0,25,22
1657946637501,CSE 190,A00,092507,Dubnov; Shlomo,8,0,20,12
1657946643523,ECE 45,A01,083139,Congero; Spencer William,7,0,75,68
1657946649546,ECE 65,A50,083695,Saad; Andrew S,12,0,30,18
1657946649546,ECE 65,A51,095125,Saad; Andrew S,24,0,26,2
1657946655568,ECE 109,A01,091882,Touri; Behrouz,20,0,70,50
1657946661591,ECE 180,A00,083140,Abi Samra; Nicholas Camill,1,0,30,29
1657946661591,ECE 180,B00,083141,Abi Samra; Nicholas Camill,0,0,30,30
1657946667620,MATH 10A,A01,083735,Patchell; Gregory David,2,0,30,28
1657946667620,MATH 10A,A02,083736,Patchell; Gregory David,20,0,30,10
1657946667620,MATH 10A,A03,083737,Patchell; Gregory David,16,0,30,14
1657946673642,MATH 10B,A01,083207,Lim; Seonhee,9,0,34,25
1657946673642,MATH 10B,A02,083208,Lim; Seonhee,10,0,35,25
1657946673642,MATH 10B,A03,093472,Lim; Seonhee,7,0,34,27
1657946673642,MATH 10B,B01,083739,Sinha; Shubham,14,0,30,16
1657946679667,MATH 18,A01,083743,Cinel; Cameron Alexander,9,0,30,21
1657946679667,MATH 18,A02,083744,Cinel; Cameron Alexander,18,0,30,12
1657946679667,MATH 18,A03,083745,Cinel; Cameron Alexander,10,0,30,20
1657946679667,MATH 18,B01,083748,Rideout; David Porter,5,0,37,32
1657946679667,MATH 18,B02,083749,Rideout; David Porter,5,0,36,31
1657946679667,MATH 18,B03,083750,Rideout; David Porter,3,0,37,34
1657946679667,MATH 18,B04,083751,Rideout; David Porter,7,0,36,29
1657946679667,MATH 18,B05,093473,Rideout; David Porter,7,0,36,29
1657946679667,MATH 18,B06,093474,Rideout; David Porter,6,0,36,30
1657946685689,MATH 20A,A01,083754,Zheng; Zequn,14,0,40,26
1657946691716,MATH 20B,A01,083756,Briones; Jor-el Thomas Caparas,4,0,36,32
1657946691716,MATH 20B,A02,083757,Briones; Jor-el Thomas Caparas,1,0,36,35
1657946691716,MATH 20B,A03,093475,Briones; Jor-el Thomas Caparas,3,0,36,33
1657946697758,MATH 20C,A01,083760,Briones; Jor-el Thomas Caparas,1,0,35,34
1657946697758,MATH 20C,A02,083761,Briones; Jor-el Thomas Caparas,8,0,35,27
1657946697758,MATH 20C,A03,093476,Briones; Jor-el Thomas Caparas,0,1,36,36
1657946697758,MATH 20C,B01,083762,Bach; Quang Tran,1,0,30,29
1657946703780,MATH 20D,A01,083765,Tran; Brian Kha,5,0,30,25
1657946703780,MATH 20D,A02,083766,Tran; Brian Kha,5,0,30,25
1657946703780,MATH 20D,A03,083767,Tran; Brian Kha,6,0,30,24
1657946709807,MATH 20E,A01,083771,Ganguly; Soumya,12,0,32,20
1657946709807,MATH 20E,A02,083772,Ganguly; Soumya,7,0,32,25
1657946709807,MATH 20E,B01,083773,Ciotti; Benjamin,20,0,35,15
1657946709807,MATH 20E,B02,083774,Ciotti; Benjamin,18,0,35,17
1657946715830,MATH 103A,A01,083777,Greenfeld; Be'Eri,3,0,36,33
1657946715830,MATH 103A,A02,083778,Greenfeld; Be'Eri,5,0,36,31
1657946715830,MATH 103A,A03,093561,Greenfeld; Be'Eri,7,0,36,29
1657946715830,MATH 103A,B01,083779,Greenfeld; Be'Eri,8,0,36,28
1657946715830,MATH 103A,B02,083780,Greenfeld; Be'Eri,4,0,36,32
1657946715830,MATH 103A,B03,093562,Greenfeld; Be'Eri,3,0,36,33
1657946721858,MATH 105,A01,085443,Carter; Anne Toulson,15,0,35,20
1657946721858,MATH 105,A02,093477,Carter; Anne Toulson,20,0,35,15
1657946727882,MATH 109,A01,083213,Ganzberger; Geoffrey Michael,3,0,34,31
1657946727882,MATH 109,A02,083214,Ganzberger; Geoffrey Michael,4,0,34,30
1657946727882,MATH 109,A03,093478,Ganzberger; Geoffrey Michael,2,0,34,32
1657946727882,MATH 109,B01,083215,Ganzberger; Geoffrey Michael,3,0,32,29
1657946727882,MATH 109,B02,083216,Ganzberger; Geoffrey Michael,3,0,32,29
1657946727882,MATH 109,B03,093479,Ganzberger; Geoffrey Michael,8,0,32,24
1657946733905,MATH 142A,A01,083219,Chow; Bennett,7,0,32,25
1657946733905,MATH 142A,A02,083220,Chow; Bennett,10,0,32,22
1657946733905,MATH 142A,A03,093480,Chow; Bennett,9,0,32,23
1657946733905,MATH 142A,B03,093481,Chow; Bennett,8,0,32,24
1657946733905,MATH 142A,B04,093558,Chow; Bennett,14,0,32,18
1657946733905,MATH 142A,B05,093559,Chow; Bennett,7,0,32,25
1657946739927,MATH 193A,A01,083224,Rotar; Vladimir,9,0,34,25
1657946739927,MATH 193A,A02,083225,Rotar; Vladimir,11,0,34,23
1657946739927,MATH 193A,A03,083781,Rotar; Vladimir,5,0,34,29
1657946739927,MATH 193A,A04,083782,Rotar; Vladimir,11,0,34,23
1657946739927,MATH 193A,A05,093482,Rotar; Vladimir,11,0,34,23
1657946745949,MATH 197,001,091859,McAuley; Julian John,9999,0,9999,0
1657946745949,MATH 197,002,095566,Kedlaya; Kiran S.,9997,0,9999,2
1657946745949,MATH 197,003,095567,Xiao; Ming,9999,0,9999,0
1657946745949,MATH 197,004,095571,Perols; Johan Lars,9998,0,9999,1
1657946753011,COGS 9,A01,083615,Shannon; Kyle Michael,11,0,75,64
1657946759034,COGS 11,A01,083617,Boyle; Mary E. T.,23,0,48,25
1657946765070,COGS 13,A01,083071,Bastos; Amalia Pinkusfeld,12,0,71,59
1657946771093,COGS 14A,A01,092681,Semenuks; Arturs,5,1,100,95
1657946777115,COGS 14B,A01,083073,Cheng; Tzu-Han,7,0,63,56
1657946783143,COGS 17,A01,092677,Semenuks; Arturs,7,0,81,74
1657946789166,COGS 100,A01,083619,Allen; Michael Gordon,17,0,70,53
1657946795188,COGS 101A,A01,083621,Davis; Joshua Daniel,9,0,68,59
1657946801215,COGS 101B,A01,091572,Allen; Michael Gordon,14,0,65,51
1657946807241,COGS 101C,A01,083625,Delgado; Tania,17,0,35,18
1657946813267,COGS 107A,A01,083627,Boyle; Mary E. T.,14,0,60,46
1657946819293,COGS 118A,A01,083075,Gupta; Anjum,21,0,76,55
1657946825317,CSE 3,A50,083646,Miranda; Gregory Joseph,24,0,50,26
1657946831340,CSE 8A,A50,083650,Miranda; Gregory Joseph,17,1,56,39
1657946837364,CSE 11,A01,083080,Cao; Yingjun,6,15,40,34
1657946843391,CSE 12,A01,083652,Krause-Levy; Sophia Louisa,30,1,120,90
1657946849418,CSE 15L,A01,083654,Morris; Justin Loren,9,0,50,41
1657946849418,CSE 15L,A02,083655,Morris; Justin Loren,10,0,50,40
1657946855452,CSE 20,A01,083657,Tran; Khoa Dang,39,0,80,41
1657946861479,CSE 21,A01,095574,Bach; Quang Tran,23,0,48,25
1657946867502,CSE 30,A01,083084,Eldon; John,7,0,80,73
1657946867502,CSE 30,B01,095061,Bhaskar; Nishant,9,0,50,41
1657946873525,CSE 100,A01,083659,Cao; Yingjun,5,4,70,65
1657946879548,CSE 134B,A01,083661,Powell; Thomas Allan,25,0,100,75
1657946885573,CSE 140,A01,083663,Gungor; Onat,17,0,85,68
1657946891599,CSE 140L,A01,083088,Eldon; John,23,0,100,77
1657946897623,CSE 175,A01,083665,Kumar; Rakesh,3,0,25,22
1657946903645,CSE 190,A00,092507,Dubnov; Shlomo,8,0,20,12
1657946909669,ECE 45,A01,083139,Congero; Spencer William,7,0,75,68
1657946915693,ECE 65,A50,083695,Saad; Andrew S,12,0,30,18
1657946915693,ECE 65,A51,095125,Saad; Andrew S,24,0,26,2
1657946921715,ECE 109,A01,091882,Touri; Behrouz,20,0,70,50
1657946927739,ECE 180,A00,083140,Abi Samra; Nicholas Camill,1,0,30,29
1657946927739,ECE 180,B00,083141,Abi Samra; Nicholas Camill,0,0,30,30
1657946933774,MATH 10A,A01,083735,Patchell; Gregory David,2,0,30,28
1657946933774,MATH 10A,A02,083736,Patchell; Gregory David,20,0,30,10
1657946933774,MATH 10A,A03,083737,Patchell; Gregory David,16,0,30,14
1657946939802,MATH 10B,A01,083207,Lim; Seonhee,9,0,34,25
1657946939802,MATH 10B,A02,083208,Lim; Seonhee,10,0,35,25
1657946939802,MATH 10B,A03,093472,Lim; Seonhee,7,0,34,27
1657946939802,MATH 10B,B01,083739,Sinha; Shubham,14,0,30,16
1657946945834,MATH 18,A01,083743,Cinel; Cameron Alexander,9,0,30,21
1657946945834,MATH 18,A02,083744,Cinel; Cameron Alexander,18,0,30,12
1657946945834,MATH 18,A03,083745,Cinel; Cameron Alexander,10,0,30,20
1657946945834,MATH 18,B01,083748,Rideout; David Porter,5,0,37,32
1657946945834,MATH 18,B02,083749,Rideout; David Porter,5,0,36,31
1657946945834,MATH 18,B03,083750,Rideout; David Porter,3,0,37,34
1657946945834,MATH 18,B04,083751,Rideout; David Porter,7,0,36,29
1657946945834,MATH 18,B05,093473,Rideout; David Porter,7,0,36,29
1657946945834,MATH 18,B06,093474,Rideout; David Porter,6,0,36,30
1657946951857,MATH 20A,A01,083754,Zheng; Zequn,14,0,40,26
1657946957893,MATH 20B,A01,083756,Briones; Jor-el Thomas Caparas,4,0,36,32
1657946957893,MATH 20B,A02,083757,Briones; Jor-el Thomas Caparas,1,0,36,35
1657946957893,MATH 20B,A03,093475,Briones; Jor-el Thomas Caparas,3,0,36,33
1657946963917,MATH 20C,A01,083760,Briones; Jor-el Thomas Caparas,1,0,35,34
1657946963917,MATH 20C,A02,083761,Briones; Jor-el Thomas Caparas,8,0,35,27
1657946963917,MATH 20C,A03,093476,Briones; Jor-el Thomas Caparas,0,1,36,36
1657946963917,MATH 20C,B01,083762,Bach; Quang Tran,1,0,30,29
1657946969942,MATH 20D,A01,083765,Tran; Brian Kha,5,0,30,25
1657946969942,MATH 20D,A02,083766,Tran; Brian Kha,5,0,30,25
1657946969942,MATH 20D,A03,083767,Tran; Brian Kha,6,0,30,24
1657946975965,MATH 20E,A01,083771,Ganguly; Soumya,12,0,32,20
1657946975965,MATH 20E,A02,083772,Ganguly; Soumya,7,0,32,25
1657946975965,MATH 20E,B01,083773,Ciotti; Benjamin,20,0,35,15
1657946975965,MATH 20E,B02,083774,Ciotti; Benjamin,18,0,35,17
1657946981997,MATH 103A,A01,083777,Greenfeld; Be'Eri,3,0,36,33
1657946981997,MATH 103A,A02,083778,Greenfeld; Be'Eri,5,0,36,31
1657946981997,MATH 103A,A03,093561,Greenfeld; Be'Eri,7,0,36,29
1657946981997,MATH 103A,B01,083779,Greenfeld; Be'Eri,8,0,36,28
1657946981997,MATH 103A,B02,083780,Greenfeld; Be'Eri,4,0,36,32
1657946981997,MATH 103A,B03,093562,Greenfeld; Be'Eri,3,0,36,33
1657946988019,MATH 105,A01,085443,Carter; Anne Toulson,15,0,35,20
1657946988019,MATH 105,A02,093477,Carter; Anne Toulson,20,0,35,15
1657946994043,MATH 109,A01,083213,Ganzberger; Geoffrey Michael,3,0,34,31
1657946994043,MATH 109,A02,083214,Ganzberger; Geoffrey Michael,4,0,34,30
1657946994043,MATH 109,A03,093478,Ganzberger; Geoffrey Michael,2,0,34,32
1657946994043,MATH 109,B01,083215,Ganzberger; Geoffrey Michael,3,0,32,29
1657946994043,MATH 109,B02,083216,Ganzberger; Geoffrey Michael,3,0,32,29
1657946994043,MATH 109,B03,093479,Ganzberger; Geoffrey Michael,8,0,32,24
1657947000066,MATH 142A,A01,083219,Chow; Bennett,7,0,32,25
1657947000066,MATH 142A,A02,083220,Chow; Bennett,10,0,32,22
1657947000066,MATH 142A,A03,093480,Chow; Bennett,9,0,32,23
1657947000066,MATH 142A,B03,093481,Chow; Bennett,8,0,32,24
1657947000066,MATH 142A,B04,093558,Chow; Bennett,14,0,32,18
1657947000066,MATH 142A,B05,093559,Chow; Bennett,7,0,32,25
1657947006094,MATH 193A,A01,083224,Rotar; Vladimir,9,0,34,25
1657947006094,MATH 193A,A02,083225,Rotar; Vladimir,11,0,34,23
1657947006094,MATH 193A,A03,083781,Rotar; Vladimir,5,0,34,29
1657947006094,MATH 193A,A04,083782,Rotar; Vladimir,11,0,34,23
1657947006094,MATH 193A,A05,093482,Rotar; Vladimir,11,0,34,23
1657947012120,MATH 197,001,091859,McAuley; Julian John,9999,0,9999,0
1657947012120,MATH 197,002,095566,Kedlaya; Kiran S.,9997,0,9999,2
1657947012120,MATH 197,003,095567,Xiao; Ming,9999,0,9999,0
1657947012120,MATH 197,004,095571,Perols; Johan Lars,9998,0,9999,1
1657947019181,COGS 9,A01,083615,Shannon; Kyle Michael,11,0,75,64
1657947025205,COGS 11,A01,083617,Boyle; Mary E. T.,23,0,48,25
1657947031228,COGS 13,A01,083071,Bastos; Amalia Pinkusfeld,12,0,71,59
1657947037251,COGS 14A,A01,092681,Semenuks; Arturs,5,1,100,95
1657947043274,COGS 14B,A01,083073,Cheng; Tzu-Han,7,0,63,56
1657947049297,COGS 17,A01,092677,Semenuks; Arturs,7,0,81,74
1657947055320,COGS 100,A01,083619,Allen; Michael Gordon,17,0,70,53
1657947061347,COGS 101A,A01,083621,Davis; Joshua Daniel,9,0,68,59
1657947067374,COGS 101B,A01,091572,Allen; Michael Gordon,14,0,65,51
1657947073401,COGS 101C,A01,083625,Delgado; Tania,17,0,35,18
1657947079424,COGS 107A,A01,083627,Boyle; Mary E. T.,14,0,60,46
1657947085451,COGS 118A,A01,083075,Gupta; Anjum,21,0,76,55
1657947091475,CSE 3,A50,083646,Miranda; Gregory Joseph,24,0,50,26
1657947097503,CSE 8A,A50,083650,Miranda; Gregory Joseph,17,1,56,39
1657947103529,CSE 11,A01,083080,Cao; Yingjun,6,15,40,34
1657947109554,CSE 12,A01,083652,Krause-Levy; Sophia Louisa,30,1,120,90
1657947115578,CSE 15L,A01,083654,Morris; Justin Loren,9,0,50,41
1657947115578,CSE 15L,A02,083655,Morris; Justin Loren,10,0,50,40
1657947121603,CSE 20,A01,083657,Tran; Khoa Dang,39,0,80,41
1657947127625,CSE 21,A01,095574,Bach; Quang Tran,23,0,48,25
1657947133655,CSE 30,A01,083084,Eldon; John,7,0,80,73
1657947133655,CSE 30,B01,095061,Bhaskar; Nishant,9,0,50,41
1657947139679,CSE 100,A01,083659,Cao; Yingjun,5,4,70,65
1657947145712,CSE 134B,A01,083661,Powell; Thomas Allan,25,0,100,75
1657947151735,CSE 140,A01,083663,Gungor; Onat,17,0,85,68
1657947157760,CSE 140L,A01,083088,Eldon; John,23,0,100,77
1657947163783,CSE 175,A01,083665,Kumar; Rakesh,3,0,25,22
1657947169812,CSE 190,A00,092507,Dubnov; Shlomo,8,0,20,12
1657947175913,ECE 45,A01,083139,Congero; Spencer William,7,0,75,68
1657947181940,ECE 65,A50,083695,Saad; Andrew S,12,0,30,18
1657947181940,ECE 65,A51,095125,Saad; Andrew S,24,0,26,2
1657947187962,ECE 109,A01,091882,Touri; Behrouz,20,0,70,50
1657947193988,ECE 180,A00,083140,Abi Samra; Nicholas Camill,1,0,30,29
1657947193988,ECE 180,B00,083141,Abi Samra; Nicholas Camill,0,0,30,30
1657947200033,MATH 10A,A01,083735,Patchell; Gregory David,2,0,30,28
1657947200033,MATH 10A,A02,083736,Patchell; Gregory David,20,0,30,10
1657947200033,MATH 10A,A03,083737,Patchell; Gregory David,16,0,30,14
1657947206061,MATH 10B,A01,083207,Lim; Seonhee,9,0,34,25
1657947206061,MATH 10B,A02,083208,Lim; Seonhee,10,0,35,25
1657947206061,MATH 10B,A03,093472,Lim; Seonhee,7,0,34,27
1657947206061,MATH 10B,B01,083739,Sinha; Shubham,14,0,30,16
1657947212088,MATH 18,A01,083743,Cinel; Cameron Alexander,9,0,30,21
1657947212088,MATH 18,A02,083744,Cinel; Cameron Alexander,18,0,30,12
1657947212088,MATH 18,A03,083745,Cinel; Cameron Alexander,10,0,30,20
1657947212088,MATH 18,B01,083748,Rideout; David Porter,5,0,37,32
1657947212088,MATH 18,B02,083749,Rideout; David Porter,5,0,36,31
1657947212088,MATH 18,B03,083750,Rideout; David Porter,3,0,37,34
1657947212088,MATH 18,B04,083751,Rideout; David Porter,7,0,36,29
1657947212088,MATH 18,B05,093473,Rideout; David Porter,7,0,36,29
1657947212088,MATH 18,B06,093474,Rideout; David Porter,6,0,36,30
1657947218120,MATH 20A,A01,083754,Zheng; Zequn,14,0,40,26
1657947224148,MATH 20B,A01,083756,Briones; Jor-el Thomas Caparas,4,0,36,32
1657947224148,MATH 20B,A02,083757,Briones; Jor-el Thomas Caparas,1,0,36,35
1657947224148,MATH 20B,A03,093475,Briones; Jor-el Thomas Caparas,3,0,36,33
1657947230177,MATH 20C,A01,083760,Briones; Jor-el Thomas Caparas,1,0,35,34
1657947230177,MATH 20C,A02,083761,Briones; Jor-el Thomas Caparas,8,0,35,27
1657947230177,MATH 20C,A03,093476,Briones; Jor-el Thomas Caparas,0,1,36,36
1657947230177,MATH 20C,B01,083762,Bach; Quang Tran,1,0,30,29
1657947236206,MATH 20D,A01,083765,Tran; Brian Kha,5,0,30,25
1657947236206,MATH 20D,A02,083766,Tran; Brian Kha,5,0,30,25
1657947236206,MATH 20D,A03,083767,Tran; Brian Kha,6,0,30,24
1657947242231,MATH 20E,A01,083771,Ganguly; Soumya,12,0,32,20
1657947242231,MATH 20E,A02,083772,Ganguly; Soumya,7,0,32,25
1657947242231,MATH 20E,B01,083773,Ciotti; Benjamin,20,0,35,15
1657947242231,MATH 20E,B02,083774,Ciotti; Benjamin,18,0,35,17
1657947248256,MATH 103A,A01,083777,Greenfeld; Be'Eri,3,0,36,33
1657947248256,MATH 103A,A02,083778,Greenfeld; Be'Eri,5,0,36,31
1657947248256,MATH 103A,A03,093561,Greenfeld; Be'Eri,7,0,36,29
1657947248256,MATH 103A,B01,083779,Greenfeld; Be'Eri,8,0,36,28
1657947248256,MATH 103A,B02,083780,Greenfeld; Be'Eri,4,0,36,32
1657947248256,MATH 103A,B03,093562,Greenfeld; Be'Eri,3,0,36,33
1657947254282,MATH 105,A01,085443,Carter; Anne Toulson,15,0,35,20
1657947254282,MATH 105,A02,093477,Carter; Anne Toulson,20,0,35,15
1657947260310,MATH 109,A01,083213,Ganzberger; Geoffrey Michael,3,0,34,31
1657947260310,MATH 109,A02,083214,Ganzberger; Geoffrey Michael,4,0,34,30
1657947260310,MATH 109,A03,093478,Ganzberger; Geoffrey Michael,2,0,34,32
1657947260310,MATH 109,B01,083215,Ganzberger; Geoffrey Michael,3,0,32,29
1657947260310,MATH 109,B02,083216,Ganzberger; Geoffrey Michael,3,0,32,29
1657947260310,MATH 109,B03,093479,Ganzberger; Geoffrey Michael,8,0,32,24
1657947266338,MATH 142A,A01,083219,Chow; Bennett,7,0,32,25
1657947266338,MATH 142A,A02,083220,Chow; Bennett,10,0,32,22
1657947266338,MATH 142A,A03,093480,Chow; Bennett,9,0,32,23
1657947266338,MATH 142A,B03,093481,Chow; Bennett,8,0,32,24
1657947266338,MATH 142A,B04,093558,Chow; Bennett,14,0,32,18
1657947266338,MATH 142A,B05,093559,Chow; Bennett,7,0,32,25
1657947272366,MATH 193A,A01,083224,Rotar; Vladimir,9,0,34,25
1657947272366,MATH 193A,A02,083225,Rotar; Vladimir,11,0,34,23
1657947272366,MATH 193A,A03,083781,Rotar; Vladimir,5,0,34,29
1657947272366,MATH 193A,A04,083782,Rotar; Vladimir,12,0,34,22
1657947272366,MATH 193A,A05,093482,Rotar; Vladimir,11,0,34,23
1657947278391,MATH 197,001,091859,McAuley; Julian John,9999,0,9999,0
1657947278391,MATH 197,002,095566,Kedlaya; Kiran S.,9997,0,9999,2
1657947278391,MATH 197,003,095567,Xiao; Ming,9999,0,9999,0
1657947278391,MATH 197,004,095571,Perols; Johan Lars,9998,0,9999,1
1657947285446,COGS 9,A01,083615,Shannon; Kyle Michael,11,0,75,64
1657947291469,COGS 11,A01,083617,Boyle; Mary E. T.,23,0,48,25
1657947297496,COGS 13,A01,083071,Bastos; Amalia Pinkusfeld,12,0,71,59
1657947303523,COGS 14A,A01,092681,Semenuks; Arturs,5,1,100,95
1657947309545,COGS 14B,A01,083073,Cheng; Tzu-Han,7,0,63,56
1657947315578,COGS 17,A01,092677,Semenuks; Arturs,7,0,81,74
1657947321605,COGS 100,A01,083619,Allen; Michael Gordon,17,0,70,53
1657947327632,COGS 101A,A01,083621,Davis; Joshua Daniel,9,0,68,59
1657947333660,COGS 101B,A01,091572,Allen; Michael Gordon,14,0,65,51
1657947339688,COGS 101C,A01,083625,Delgado; Tania,17,0,35,18
1657947345710,COGS 107A,A01,083627,Boyle; Mary E. T.,14,0,60,46
1657947351734,COGS 118A,A01,083075,Gupta; Anjum,21,0,76,55
1657947357759,CSE 3,A50,083646,Miranda; Gregory Joseph,24,0,50,26
1657947363787,CSE 8A,A50,083650,Miranda; Gregory Joseph,17,1,56,39
1657947369813,CSE 11,A01,083080,Cao; Yingjun,7,15,40,33
1657947375839,CSE 12,A01,083652,Krause-Levy; Sophia Louisa,30,1,120,90
1657947381863,CSE 15L,A01,083654,Morris; Justin Loren,9,0,50,41
1657947381863,CSE 15L,A02,083655,Morris; Justin Loren,11,0,50,39
1657947387891,CSE 20,A01,083657,Tran; Khoa Dang,39,0,80,41
1657947393914,CSE 21,A01,095574,Bach; Quang Tran,23,0,48,25
1657947399937,CSE 30,A01,083084,Eldon; John,7,0,80,73
1657947399937,CSE 30,B01,095061,Bhaskar; Nishant,9,0,50,41
1657947405958,CSE 100,A01,083659,Cao; Yingjun,5,4,70,65
1657947411990,CSE 134B,A01,083661,Powell; Thomas Allan,25,0,100,75
1657947418017,CSE 140,A01,083663,Gungor; Onat,17,0,85,68
1657947424041,CSE 140L,A01,083088,Eldon; John,23,0,100,77
1657947430065,CSE 175,A01,083665,Kumar; Rakesh,3,0,25,22
1657947436089,CSE 190,A00,092507,Dubnov; Shlomo,8,0,20,12
1657947442116,ECE 45,A01,083139,Congero; Spencer William,7,0,75,68
1657947448142,ECE 65,A50,083695,Saad; Andrew S,12,0,30,18
1657947448142,ECE 65,A51,095125,Saad; Andrew S,24,0,26,2
1657947454166,ECE 109,A01,091882,Touri; Behrouz,20,0,70,50
1657947460190,ECE 180,A00,083140,Abi Samra; Nicholas Camill,1,0,30,29
1657947460190,ECE 180,B00,083141,Abi Samra; Nicholas Camill,0,0,30,30
1657947466213,MATH 10A,A01,083735,Patchell; Gregory David,2,0,30,28
1657947466213,MATH 10A,A02,083736,Patchell; Gregory David,20,0,30,10
1657947466213,MATH 10A,A03,083737,Patchell; Gregory David,16,0,30,14
1657947472242,MATH 10B,A01,083207,Lim; Seonhee,9,0,34,25
1657947472242,MATH 10B,A02,083208,Lim; Seonhee,10,0,35,25
1657947472242,MATH 10B,A03,093472,Lim; Seonhee,7,0,34,27
1657947472242,MATH 10B,B01,083739,Sinha; Shubham,14,0,30,16
1657947478281,MATH 18,A01,083743,Cinel; Cameron Alexander,9,0,30,21
1657947478281,MATH 18,A02,083744,Cinel; Cameron Alexander,18,0,30,12
1657947478281,MATH 18,A03,083745,Cinel; Cameron Alexander,10,0,30,20
1657947478281,MATH 18,B01,083748,Rideout; David Porter,5,0,37,32
1657947478281,MATH 18,B02,083749,Rideout; David Porter,5,0,36,31
1657947478281,MATH 18,B03,083750,Rideout; David Porter,3,0,37,34
1657947478281,MATH 18,B04,083751,Rideout; David Porter,7,0,36,29
1657947478281,MATH 18,B05,093473,Rideout; David Porter,7,0,36,29
1657947478281,MATH 18,B06,093474,Rideout; David Porter,6,0,36,30
1657947484304,MATH 20A,A01,083754,Zheng; Zequn,14,0,40,26
1657947490328,MATH 20B,A01,083756,Briones; Jor-el Thomas Caparas,4,0,36,32
1657947490328,MATH 20B,A02,083757,Briones; Jor-el Thomas Caparas,1,0,36,35
1657947490328,MATH 20B,A03,093475,Briones; Jor-el Thomas Caparas,3,0,36,33
1657947496352,MATH 20C,A01,083760,Briones; Jor-el Thomas Caparas,1,0,35,34
1657947496352,MATH 20C,A02,083761,Briones; Jor-el Thomas Caparas,8,0,35,27
1657947496352,MATH 20C,A03,093476,Briones; Jor-el Thomas Caparas,0,1,36,36
1657947496352,MATH 20C,B01,083762,Bach; Quang Tran,1,0,30,29
1657947502381,MATH 20D,A01,083765,Tran; Brian Kha,5,0,30,25
1657947502381,MATH 20D,A02,083766,Tran; Brian Kha,5,0,30,25
1657947502381,MATH 20D,A03,083767,Tran; Brian Kha,6,0,30,24
1657947508412,MATH 20E,A01,083771,Ganguly; Soumya,12,0,32,20
1657947508412,MATH 20E,A02,083772,Ganguly; Soumya,7,0,32,25
1657947508412,MATH 20E,B01,083773,Ciotti; Benjamin,20,0,35,15
1657947508412,MATH 20E,B02,083774,Ciotti; Benjamin,18,0,35,17
1657947514443,MATH 103A,A01,083777,Greenfeld; Be'Eri,4,0,36,32
1657947514443,MATH 103A,A02,083778,Greenfeld; Be'Eri,5,0,36,31
1657947514443,MATH 103A,A03,093561,Greenfeld; Be'Eri,7,0,36,29
1657947514443,MATH 103A,B01,083779,Greenfeld; Be'Eri,8,0,36,28
1657947514443,MATH 103A,B02,083780,Greenfeld; Be'Eri,4,0,36,32
1657947514443,MATH 103A,B03,093562,Greenfeld; Be'Eri,3,0,36,33
1657947520469,MATH 105,A01,085443,Carter; Anne Toulson,15,0,35,20
1657947520469,MATH 105,A02,093477,Carter; Anne Toulson,20,0,35,15
1657947526493,MATH 109,A01,083213,Ganzberger; Geoffrey Michael,3,0,34,31
1657947526493,MATH 109,A02,083214,Ganzberger; Geoffrey Michael,4,0,34,30
1657947526493,MATH 109,A03,093478,Ganzberger; Geoffrey Michael,2,0,34,32
1657947526493,MATH 109,B01,083215,Ganzberger; Geoffrey Michael,3,0,32,29
1657947526493,MATH 109,B02,083216,Ganzberger; Geoffrey Michael,3,0,32,29
1657947526493,MATH 109,B03,093479,Ganzberger; Geoffrey Michael,8,0,32,24
1657947532517,MATH 142A,A01,083219,Chow; Bennett,7,0,32,25
1657947532517,MATH 142A,A02,083220,Chow; Bennett,10,0,32,22
1657947532517,MATH 142A,A03,093480,Chow; Bennett,9,0,32,23
1657947532517,MATH 142A,B03,093481,Chow; Bennett,8,0,32,24
1657947532517,MATH 142A,B04,093558,Chow; Bennett,14,0,32,18
1657947532517,MATH 142A,B05,093559,Chow; Bennett,7,0,32,25
1657947538540,MATH 193A,A01,083224,Rotar; Vladimir,9,0,34,25
1657947538540,MATH 193A,A02,083225,Rotar; Vladimir,11,0,34,23
1657947538540,MATH 193A,A03,083781,Rotar; Vladimir,5,0,34,29
1657947538540,MATH 193A,A04,083782,Rotar; Vladimir,12,0,34,22
1657947538540,MATH 193A,A05,093482,Rotar; Vladimir,11,0,34,23
1657947544564,MATH 197,001,091859,McAuley; Julian John,9999,0,9999,0
1657947544564,MATH 197,002,095566,Kedlaya; Kiran S.,9997,0,9999,2
1657947544564,MATH 197,003,095567,Xiao; Ming,9999,0,9999,0
1657947544564,MATH 197,004,095571,Perols; Johan Lars,9998,0,9999,1
1657947551628,COGS 9,A01,083615,Shannon; Kyle Michael,11,0,75,64
1657947557650,COGS 11,A01,083617,Boyle; Mary E. T.,23,0,48,25
1657947563678,COGS 13,A01,083071,Bastos; Amalia Pinkusfeld,12,0,71,59
1657947569703,COGS 14A,A01,092681,Semenuks; Arturs,5,1,100,95
1657947575730,COGS 14B,A01,083073,Cheng; Tzu-Han,7,0,63,56
1657947581762,COGS 17,A01,092677,Semenuks; Arturs,7,0,81,74
1657947587787,COGS 100,A01,083619,Allen; Michael Gordon,17,0,70,53
1657947593811,COGS 101A,A01,083621,Davis; Joshua Daniel,9,0,68,59
1657947599835,COGS 101B,A01,091572,Allen; Michael Gordon,14,0,65,51
1657947605858,COGS 101C,A01,083625,Delgado; Tania,17,0,35,18
1657947611883,COGS 107A,A01,083627,Boyle; Mary E. T.,14,0,60,46
1657947617906,COGS 118A,A01,083075,Gupta; Anjum,21,0,76,55
1657947623928,CSE 3,A50,083646,Miranda; Gregory Joseph,24,0,50,26
1657947629957,CSE 8A,A50,083650,Miranda; Gregory Joseph,17,1,56,39
1657947635981,CSE 11,A01,083080,Cao; Yingjun,7,15,40,33
1657947642003,CSE 12,A01,083652,Krause-Levy; Sophia Louisa,30,1,120,90
1657947648040,CSE 15L,A01,083654,Morris; Justin Loren,9,0,50,41
1657947648040,CSE 15L,A02,083655,Morris; Justin Loren,11,0,50,39
1657947654065,CSE 20,A01,083657,Tran; Khoa Dang,39,0,80,41
1657947660091,CSE 21,A01,095574,Bach; Quang Tran,23,0,48,25
1657947666114,CSE 30,A01,083084,Eldon; John,7,0,80,73
1657947666114,CSE 30,B01,095061,Bhaskar; Nishant,9,0,50,41
1657947672139,CSE 100,A01,083659,Cao; Yingjun,5,4,70,65
1657947678162,CSE 134B,A01,083661,Powell; Thomas Allan,25,0,100,75
1657947684187,CSE 140,A01,083663,Gungor; Onat,17,0,85,68
1657947690210,CSE 140L,A01,083088,Eldon; John,23,0,100,77
1657947696232,CSE 175,A01,083665,Kumar; Rakesh,3,0,25,22
1657947702255,CSE 190,A00,092507,Dubnov; Shlomo,8,0,20,12
1657947708278,ECE 45,A01,083139,Congero; Spencer William,7,0,75,68
1657947714304,ECE 65,A50,083695,Saad; Andrew S,12,0,30,18
1657947714304,ECE 65,A51,095125,Saad; Andrew S,24,0,26,2
1657947720327,ECE 109,A01,091882,Touri; Behrouz,20,0,70,50
1657947726349,ECE 180,A00,083140,Abi Samra; Nicholas Camill,1,0,30,29
1657947726349,ECE 180,B00,083141,Abi Samra; Nicholas Camill,0,0,30,30
1657947732376,MATH 10A,A01,083735,Patchell; Gregory David,2,0,30,28
1657947732376,MATH 10A,A02,083736,Patchell; Gregory David,20,0,30,10
1657947732376,MATH 10A,A03,083737,Patchell; Gregory David,16,0,30,14
1657947738418,MATH 10B,A01,083207,Lim; Seonhee,9,0,34,25
1657947738418,MATH 10B,A02,083208,Lim; Seonhee,10,0,35,25
1657947738418,MATH 10B,A03,093472,Lim; Seonhee,7,0,34,27
1657947738418,MATH 10B,B01,083739,Sinha; Shubham,14,0,30,16
1657947744441,MATH 18,A01,083743,Cinel; Cameron Alexander,9,0,30,21
1657947744441,MATH 18,A02,083744,Cinel; Cameron Alexander,18,0,30,12
1657947744441,MATH 18,A03,083745,Cinel; Cameron Alexander,10,0,30,20
1657947744441,MATH 18,B01,083748,Rideout; David Porter,5,0,37,32
1657947744441,MATH 18,B02,083749,Rideout; David Porter,5,0,36,31
1657947744441,MATH 18,B03,083750,Rideout; David Porter,3,0,37,34
1657947744441,MATH 18,B04,083751,Rideout; David Porter,7,0,36,29
1657947744441,MATH 18,B05,093473,Rideout; David Porter,7,0,36,29
1657947744441,MATH 18,B06,093474,Rideout; David Porter,6,0,36,30
1657947750468,MATH 20A,A01,083754,Zheng; Zequn,14,0,40,26
1657947756495,MATH 20B,A01,083756,Briones; Jor-el Thomas Caparas,4,0,36,32
1657947756495,MATH 20B,A02,083757,Briones; Jor-el Thomas Caparas,1,0,36,35
1657947756495,MATH 20B,A03,093475,Briones; Jor-el Thomas Caparas,3,0,36,33
1657947762518,MATH 20C,A01,083760,Briones; Jor-el Thomas Caparas,1,0,35,34
1657947762518,MATH 20C,A02,083761,Briones; Jor-el Thomas Caparas,8,0,35,27
1657947762518,MATH 20C,A03,093476,Briones; Jor-el Thomas Caparas,0,1,36,36
1657947762518,MATH 20C,B01,083762,Bach; Quang Tran,1,0,30,29
1657947768547,MATH 20D,A01,083765,Tran; Brian Kha,5,0,30,25
1657947768547,MATH 20D,A02,083766,Tran; Brian Kha,5,0,30,25
1657947768547,MATH 20D,A03,083767,Tran; Brian Kha,6,0,30,24
1657947774664,MATH 20E,A01,083771,Ganguly; Soumya,12,0,32,20
1657947774664,MATH 20E,A02,083772,Ganguly; Soumya,7,0,32,25
1657947774664,MATH 20E,B01,083773,Ciotti; Benjamin,20,0,35,15
1657947774664,MATH 20E,B02,083774,Ciotti; Benjamin,18,0,35,17
1657947780688,MATH 103A,A01,083777,Greenfeld; Be'Eri,4,0,36,32
1657947780688,MATH 103A,A02,083778,Greenfeld; Be'Eri,5,0,36,31
1657947780688,MATH 103A,A03,093561,Greenfeld; Be'Eri,7,0,36,29
1657947780688,MATH 103A,B01,083779,Greenfeld; Be'Eri,8,0,36,28
1657947780688,MATH 103A,B02,083780,Greenfeld; Be'Eri,4,0,36,32
1657947780688,MATH 103A,B03,093562,Greenfeld; Be'Eri,3,0,36,33
1657947786715,MATH 105,A01,085443,Carter; Anne Toulson,15,0,35,20
1657947786715,MATH 105,A02,093477,Carter; Anne Toulson,20,0,35,15
1657947792739,MATH 109,A01,083213,Ganzberger; Geoffrey Michael,3,0,34,31
1657947792739,MATH 109,A02,083214,Ganzberger; Geoffrey Michael,4,0,34,30
1657947792739,MATH 109,A03,093478,Ganzberger; Geoffrey Michael,2,0,34,32
1657947792739,MATH 109,B01,083215,Ganzberger; Geoffrey Michael,3,0,32,29
1657947792739,MATH 109,B02,083216,Ganzberger; Geoffrey Michael,3,0,32,29
1657947792739,MATH 109,B03,093479,Ganzberger; Geoffrey Michael,8,0,32,24
1657947798769,MATH 142A,A01,083219,Chow; Bennett,7,0,32,25
1657947798769,MATH 142A,A02,083220,Chow; Bennett,10,0,32,22
1657947798769,MATH 142A,A03,093480,Chow; Bennett,9,0,32,23
1657947798769,MATH 142A,B03,093481,Chow; Bennett,8,0,32,24
1657947798769,MATH 142A,B04,093558,Chow; Bennett,14,0,32,18
1657947798769,MATH 142A,B05,093559,Chow; Bennett,7,0,32,25
1657947804793,MATH 193A,A01,083224,Rotar; Vladimir,9,0,34,25
1657947804793,MATH 193A,A02,083225,Rotar; Vladimir,11,0,34,23
1657947804793,MATH 193A,A03,083781,Rotar; Vladimir,5,0,34,29
1657947804793,MATH 193A,A04,083782,Rotar; Vladimir,12,0,34,22
1657947804793,MATH 193A,A05,093482,Rotar; Vladimir,11,0,34,23
1657947810815,MATH 197,001,091859,McAuley; Julian John,9999,0,9999,0
1657947810815,MATH 197,002,095566,Kedlaya; Kiran S.,9997,0,9999,2
1657947810815,MATH 197,003,095567,Xiao; Ming,9999,0,9999,0
1657947810815,MATH 197,004,095571,Perols; Johan Lars,9998,0,9999,1
1657947817873,COGS 9,A01,083615,Shannon; Kyle Michael,11,0,75,64
1657947823899,COGS 11,A01,083617,Boyle; Mary E. T.,23,0,48,25
1657947829924,COGS 13,A01,083071,Bastos; Amalia Pinkusfeld,12,0,71,59
1657947835946,COGS 14A,A01,092681,Semenuks; Arturs,5,1,100,95
1657947841970,COGS 14B,A01,083073,Cheng; Tzu-Han,7,0,63,56
1657947847996,COGS 17,A01,092677,Semenuks; Arturs,7,0,81,74
1657947854019,COGS 100,A01,083619,Allen; Michael Gordon,17,0,70,53
1657947860042,COGS 101A,A01,083621,Davis; Joshua Daniel,9,0,68,59
1657947866065,COGS 101B,A01,091572,Allen; Michael Gordon,14,0,65,51
1657947872090,COGS 101C,A01,083625,Delgado; Tania,17,0,35,18
1657947878117,COGS 107A,A01,083627,Boyle; Mary E. T.,14,0,60,46
1657947884143,COGS 118A,A01,083075,Gupta; Anjum,21,0,76,55
1657947890170,CSE 3,A50,083646,Miranda; Gregory Joseph,24,0,50,26
1657947896193,CSE 8A,A50,083650,Miranda; Gregory Joseph,17,1,56,39
1657947902216,CSE 11,A01,083080,Cao; Yingjun,7,15,40,33
1657947908242,CSE 12,A01,083652,Krause-Levy; Sophia Louisa,30,1,120,90
1657947914269,CSE 15L,A01,083654,Morris; Justin Loren,9,0,50,41
1657947914269,CSE 15L,A02,083655,Morris; Justin Loren,11,0,50,39
1657947920292,CSE 20,A01,083657,Tran; Khoa Dang,39,0,80,41
1657947926319,CSE 21,A01,095574,Bach; Quang Tran,23,0,48,25
1657947932346,CSE 30,A01,083084,Eldon; John,7,0,80,73
1657947932346,CSE 30,B01,095061,Bhaskar; Nishant,9,0,50,41
1657947938374,CSE 100,A01,083659,Cao; Yingjun,5,4,70,65
1657947944401,CSE 134B,A01,083661,Powell; Thomas Allan,25,0,100,75
1657947950428,CSE 140,A01,083663,Gungor; Onat,17,0,85,68
1657947956459,CSE 140L,A01,083088,Eldon; John,23,0,100,77
1657947962487,CSE 175,A01,083665,Kumar; Rakesh,3,0,25,22
1657947968518,CSE 190,A00,092507,Dubnov; Shlomo,8,0,20,12
1657947974541,ECE 45,A01,083139,Congero; Spencer William,7,0,75,68
1657947980579,ECE 65,A50,083695,Saad; Andrew S,12,0,30,18
1657947980579,ECE 65,A51,095125,Saad; Andrew S,24,0,26,2
1657947986605,ECE 109,A01,091882,Touri; Behrouz,20,0,70,50
1657947992629,ECE 180,A00,083140,Abi Samra; Nicholas Camill,1,0,30,29
1657947992629,ECE 180,B00,083141,Abi Samra; Nicholas Camill,0,0,30,30
1657947998656,MATH 10A,A01,083735,Patchell; Gregory David,2,0,30,28
1657947998656,MATH 10A,A02,083736,Patchell; Gregory David,20,0,30,10
1657947998656,MATH 10A,A03,083737,Patchell; Gregory David,16,0,30,14
1657948004681,MATH 10B,A01,083207,Lim; Seonhee,9,0,34,25
1657948004681,MATH 10B,A02,083208,Lim; Seonhee,10,0,35,25
1657948004681,MATH 10B,A03,093472,Lim; Seonhee,7,0,34,27
1657948004681,MATH 10B,B01,083739,Sinha; Shubham,14,0,30,16
1657948010705,MATH 18,A01,083743,Cinel; Cameron Alexander,9,0,30,21
1657948010705,MATH 18,A02,083744,Cinel; Cameron Alexander,18,0,30,12
1657948010705,MATH 18,A03,083745,Cinel; Cameron Alexander,10,0,30,20
1657948010705,MATH 18,B01,083748,Rideout; David Porter,5,0,37,32
1657948010705,MATH 18,B02,083749,Rideout; David Porter,5,0,36,31
1657948010705,MATH 18,B03,083750,Rideout; David Porter,3,0,37,34
1657948010705,MATH 18,B04,083751,Rideout; David Porter,7,0,36,29
1657948010705,MATH 18,B05,093473,Rideout; David Porter,7,0,36,29
1657948010705,MATH 18,B06,093474,Rideout; David Porter,6,0,36,30
1657948016730,MATH 20A,A01,083754,Zheng; Zequn,14,0,40,26
1657948022758,MATH 20B,A01,083756,Briones; Jor-el Thomas Caparas,4,0,36,32
1657948022758,MATH 20B,A02,083757,Briones; Jor-el Thomas Caparas,1,0,36,35
1657948022758,MATH 20B,A03,093475,Briones; Jor-el Thomas Caparas,3,0,36,33
1657948028784,MATH 20C,A01,083760,Briones; Jor-el Thomas Caparas,1,0,35,34
1657948028784,MATH 20C,A02,083761,Briones; Jor-el Thomas Caparas,8,0,35,27
1657948028784,MATH 20C,A03,093476,Briones; Jor-el Thomas Caparas,0,1,36,36
1657948028784,MATH 20C,B01,083762,Bach; Quang Tran,1,0,30,29
1657948034812,MATH 20D,A01,083765,Tran; Brian Kha,5,0,30,25
1657948034812,MATH 20D,A02,083766,Tran; Brian Kha,5,0,30,25
1657948034812,MATH 20D,A03,083767,Tran; Brian Kha,6,0,30,24
1657948040835,MATH 20E,A01,083771,Ganguly; Soumya,12,0,32,20
1657948040835,MATH 20E,A02,083772,Ganguly; Soumya,7,0,32,25
1657948040835,MATH 20E,B01,083773,Ciotti; Benjamin,20,0,35,15
1657948040835,MATH 20E,B02,083774,Ciotti; Benjamin,18,0,35,17
1657948046859,MATH 103A,A01,083777,Greenfeld; Be'Eri,4,0,36,32
1657948046859,MATH 103A,A02,083778,Greenfeld; Be'Eri,5,0,36,31
1657948046859,MATH 103A,A03,093561,Greenfeld; Be'Eri,7,0,36,29
1657948046859,MATH 103A,B01,083779,Greenfeld; Be'Eri,8,0,36,28
1657948046859,MATH 103A,B02,083780,Greenfeld; Be'Eri,4,0,36,32
1657948046859,MATH 103A,B03,093562,Greenfeld; Be'Eri,3,0,36,33
1657948052887,MATH 105,A01,085443,Carter; Anne Toulson,15,0,35,20
1657948052887,MATH 105,A02,093477,Carter; Anne Toulson,20,0,35,15
1657948058913,MATH 109,A01,083213,Ganzberger; Geoffrey Michael,3,0,34,31
1657948058913,MATH 109,A02,083214,Ganzberger; Geoffrey Michael,4,0,34,30
1657948058913,MATH 109,A03,093478,Ganzberger; Geoffrey Michael,2,0,34,32
1657948058913,MATH 109,B01,083215,Ganzberger; Geoffrey Michael,3,0,32,29
1657948058913,MATH 109,B02,083216,Ganzberger; Geoffrey Michael,3,0,32,29
1657948058913,MATH 109,B03,093479,Ganzberger; Geoffrey Michael,8,0,32,24
1657948064937,MATH 142A,A01,083219,Chow; Bennett,7,0,32,25
1657948064937,MATH 142A,A02,083220,Chow; Bennett,10,0,32,22
1657948064937,MATH 142A,A03,093480,Chow; Bennett,9,0,32,23
1657948064937,MATH 142A,B03,093481,Chow; Bennett,8,0,32,24
1657948064937,MATH 142A,B04,093558,Chow; Bennett,14,0,32,18
1657948064937,MATH 142A,B05,093559,Chow; Bennett,7,0,32,25
1657948070961,MATH 193A,A01,083224,Rotar; Vladimir,9,0,34,25
1657948070961,MATH 193A,A02,083225,Rotar; Vladimir,11,0,34,23
1657948070961,MATH 193A,A03,083781,Rotar; Vladimir,5,0,34,29
1657948070961,MATH 193A,A04,083782,Rotar; Vladimir,12,0,34,22
1657948070961,MATH 193A,A05,093482,Rotar; Vladimir,11,0,34,23
1657948076984,MATH 197,001,091859,McAuley; Julian John,9999,0,9999,0
1657948076984,MATH 197,002,095566,Kedlaya; Kiran S.,9997,0,9999,2
1657948076984,MATH 197,003,095567,Xiao; Ming,9999,0,9999,0
1657948076984,MATH 197,004,095571,Perols; Johan Lars,9998,0,9999,1
1657948084033,COGS 9,A01,083615,Shannon; Kyle Michael,11,0,75,64
1657948090060,COGS 11,A01,083617,Boyle; Mary E. T.,23,0,48,25
1657948096086,COGS 13,A01,083071,Bastos; Amalia Pinkusfeld,12,0,71,59
1657948102110,COGS 14A,A01,092681,Semenuks; Arturs,5,1,100,95
1657948108139,COGS 14B,A01,083073,Cheng; Tzu-Han,7,0,63,56
1657948114162,COGS 17,A01,092677,Semenuks; Arturs,7,0,81,74
1657948120189,COGS 100,A01,083619,Allen; Michael Gordon,17,0,70,53
1657948126219,COGS 101A,A01,083621,Davis; Joshua Daniel,9,0,68,59
1657948132240,COGS 101B,A01,091572,Allen; Michael Gordon,14,0,65,51
1657948138268,COGS 101C,A01,083625,Delgado; Tania,17,0,35,18
1657948144293,COGS 107A,A01,083627,Boyle; Mary E. T.,14,0,60,46
1657948150314,COGS 118A,A01,083075,Gupta; Anjum,21,0,76,55
1657948156343,CSE 3,A50,083646,Miranda; Gregory Joseph,24,0,50,26
1657948162368,CSE 8A,A50,083650,Miranda; Gregory Joseph,17,1,56,39
1657948168392,CSE 11,A01,083080,Cao; Yingjun,7,15,40,33
1657948174415,CSE 12,A01,083652,Krause-Levy; Sophia Louisa,30,1,120,90
1657948180438,CSE 15L,A01,083654,Morris; Justin Loren,9,0,50,41
1657948180438,CSE 15L,A02,083655,Morris; Justin Loren,11,0,50,39
1657948186461,CSE 20,A01,083657,Tran; Khoa Dang,39,0,80,41
1657948192491,CSE 21,A01,095574,Bach; Quang Tran,23,0,48,25
1657948198515,CSE 30,A01,083084,Eldon; John,7,0,80,73
1657948198515,CSE 30,B01,095061,Bhaskar; Nishant,9,0,50,41
1657948204541,CSE 100,A01,083659,Cao; Yingjun,5,4,70,65
1657948210564,CSE 134B,A01,083661,Powell; Thomas Allan,25,0,100,75
1657948216595,CSE 140,A01,083663,Gungor; Onat,17,0,85,68
1657948222620,CSE 140L,A01,083088,Eldon; John,23,0,100,77
1657948228653,CSE 175,A01,083665,Kumar; Rakesh,3,0,25,22
1657948234677,CSE 190,A00,092507,Dubnov; Shlomo,8,0,20,12
1657948240701,ECE 45,A01,083139,Congero; Spencer William,7,0,75,68
1657948246724,ECE 65,A50,083695,Saad; Andrew S,12,0,30,18
1657948246724,ECE 65,A51,095125,Saad; Andrew S,24,0,26,2
1657948252750,ECE 109,A01,091882,Touri; Behrouz,20,0,70,50
1657948258773,ECE 180,A00,083140,Abi Samra; Nicholas Camill,1,0,30,29
1657948258773,ECE 180,B00,083141,Abi Samra; Nicholas Camill,0,0,30,30
1657948264797,MATH 10A,A01,083735,Patchell; Gregory David,2,0,30,28
1657948264797,MATH 10A,A02,083736,Patchell; Gregory David,20,0,30,10
1657948264797,MATH 10A,A03,083737,Patchell; Gregory David,16,0,30,14
1657948270825,MATH 10B,A01,083207,Lim; Seonhee,9,0,34,25
1657948270825,MATH 10B,A02,083208,Lim; Seonhee,10,0,35,25
1657948270825,MATH 10B,A03,093472,Lim; Seonhee,7,0,34,27
1657948270825,MATH 10B,B01,083739,Sinha; Shubham,14,0,30,16
1657948276855,MATH 18,A01,083743,Cinel; Cameron Alexander,9,0,30,21
1657948276855,MATH 18,A02,083744,Cinel; Cameron Alexander,18,0,30,12
1657948276855,MATH 18,A03,083745,Cinel; Cameron Alexander,10,0,30,20
1657948276855,MATH 18,B01,083748,Rideout; David Porter,5,0,37,32
1657948276855,MATH 18,B02,083749,Rideout; David Porter,5,0,36,31
1657948276855,MATH 18,B03,083750,Rideout; David Porter,3,0,37,34
1657948276855,MATH 18,B04,083751,Rideout; David Porter,7,0,36,29
1657948276855,MATH 18,B05,093473,Rideout; David Porter,7,0,36,29
1657948276855,MATH 18,B06,093474,Rideout; David Porter,6,0,36,30
1657948282878,MATH 20A,A01,083754,Zheng; Zequn,14,0,40,26
1657948288902,MATH 20B,A01,083756,Briones; Jor-el Thomas Caparas,4,0,36,32
1657948288902,MATH 20B,A02,083757,Briones; Jor-el Thomas Caparas,1,0,36,35
1657948288902,MATH 20B,A03,093475,Briones; Jor-el Thomas Caparas,3,0,36,33
1657948294924,MATH 20C,A01,083760,Briones; Jor-el Thomas Caparas,1,0,35,34
1657948294924,MATH 20C,A02,083761,Briones; Jor-el Thomas Caparas,8,0,35,27
1657948294924,MATH 20C,A03,093476,Briones; Jor-el Thomas Caparas,0,1,36,36
1657948294924,MATH 20C,B01,083762,Bach; Quang Tran,1,0,30,29
1657948300949,MATH 20D,A01,083765,Tran; Brian Kha,5,0,30,25
1657948300949,MATH 20D,A02,083766,Tran; Brian Kha,5,0,30,25
1657948300949,MATH 20D,A03,083767,Tran; Brian Kha,6,0,30,24
1657948306978,MATH 20E,A01,083771,Ganguly; Soumya,12,0,32,20
1657948306978,MATH 20E,A02,083772,Ganguly; Soumya,7,0,32,25
1657948306978,MATH 20E,B01,083773,Ciotti; Benjamin,20,0,35,15
1657948306978,MATH 20E,B02,083774,Ciotti; Benjamin,18,0,35,17
1657948313007,MATH 103A,A01,083777,Greenfeld; Be'Eri,4,0,36,32
1657948313007,MATH 103A,A02,083778,Greenfeld; Be'Eri,5,0,36,31
1657948313007,MATH 103A,A03,093561,Greenfeld; Be'Eri,7,0,36,29
1657948313007,MATH 103A,B01,083779,Greenfeld; Be'Eri,8,0,36,28
1657948313007,MATH 103A,B02,083780,Greenfeld; Be'Eri,4,0,36,32
1657948313007,MATH 103A,B03,093562,Greenfeld; Be'Eri,3,0,36,33
1657948319034,MATH 105,A01,085443,Carter; Anne Toulson,15,0,35,20
1657948319034,MATH 105,A02,093477,Carter; Anne Toulson,20,0,35,15
1657948325057,MATH 109,A01,083213,Ganzberger; Geoffrey Michael,3,0,34,31
1657948325057,MATH 109,A02,083214,Ganzberger; Geoffrey Michael,4,0,34,30
1657948325057,MATH 109,A03,093478,Ganzberger; Geoffrey Michael,2,0,34,32
1657948325057,MATH 109,B01,083215,Ganzberger; Geoffrey Michael,3,0,32,29
1657948325057,MATH 109,B02,083216,Ganzberger; Geoffrey Michael,3,0,32,29
1657948325057,MATH 109,B03,093479,Ganzberger; Geoffrey Michael,8,0,32,24
1657948331086,MATH 142A,A01,083219,Chow; Bennett,7,0,32,25
1657948331086,MATH 142A,A02,083220,Chow; Bennett,10,0,32,22
1657948331086,MATH 142A,A03,093480,Chow; Bennett,9,0,32,23
1657948331086,MATH 142A,B03,093481,Chow; Bennett,8,0,32,24
1657948331086,MATH 142A,B04,093558,Chow; Bennett,14,0,32,18
1657948331086,MATH 142A,B05,093559,Chow; Bennett,7,0,32,25
1657948337111,MATH 193A,A01,083224,Rotar; Vladimir,9,0,34,25
1657948337111,MATH 193A,A02,083225,Rotar; Vladimir,11,0,34,23
1657948337111,MATH 193A,A03,083781,Rotar; Vladimir,5,0,34,29
1657948337111,MATH 193A,A04,083782,Rotar; Vladimir,12,0,34,22
1657948337111,MATH 193A,A05,093482,Rotar; Vladimir,11,0,34,23
1657948343133,MATH 197,001,091859,McAuley; Julian John,9999,0,9999,0
1657948343133,MATH 197,002,095566,Kedlaya; Kiran S.,9997,0,9999,2
1657948343133,MATH 197,003,095567,Xiao; Ming,9999,0,9999,0
1657948343133,MATH 197,004,095571,Perols; Johan Lars,9998,0,9999,1
1657948350197,COGS 9,A01,083615,Shannon; Kyle Michael,11,0,75,64
1657948356221,COGS 11,A01,083617,Boyle; Mary E. T.,23,0,48,25
1657948362244,COGS 13,A01,083071,Bastos; Amalia Pinkusfeld,12,0,71,59
1657948368338,COGS 14A,A01,092681,Semenuks; Arturs,5,1,100,95
1657948374360,COGS 14B,A01,083073,Cheng; Tzu-Han,7,0,63,56
1657948380387,COGS 17,A01,092677,Semenuks; Arturs,7,0,81,74
1657948386414,COGS 100,A01,083619,Allen; Michael Gordon,17,0,70,53
1657948392438,COGS 101A,A01,083621,Davis; Joshua Daniel,9,0,68,59
1657948398472,COGS 101B,A01,091572,Allen; Michael Gordon,14,0,65,51
1657948404503,COGS 101C,A01,083625,Delgado; Tania,17,0,35,18
1657948410526,COGS 107A,A01,083627,Boyle; Mary E. T.,14,0,60,46
1657948416553,COGS 118A,A01,083075,Gupta; Anjum,21,0,76,55
1657948422579,CSE 3,A50,083646,Miranda; Gregory Joseph,24,0,50,26
1657948428614,CSE 8A,A50,083650,Miranda; Gregory Joseph,17,1,56,39
1657948434641,CSE 11,A01,083080,Cao; Yingjun,7,15,40,33
1657948440669,CSE 12,A01,083652,Krause-Levy; Sophia Louisa,30,1,120,90
1657948446692,CSE 15L,A01,083654,Morris; Justin Loren,9,0,50,41
1657948446692,CSE 15L,A02,083655,Morris; Justin Loren,11,0,50,39
1657948452720,CSE 20,A01,083657,Tran; Khoa Dang,39,0,80,41
1657948458744,CSE 21,A01,095574,Bach; Quang Tran,23,0,48,25
1657948464773,CSE 30,A01,083084,Eldon; John,7,0,80,73
1657948464773,CSE 30,B01,095061,Bhaskar; Nishant,9,0,50,41
1657948470796,CSE 100,A01,083659,Cao; Yingjun,5,4,70,65
1657948476826,CSE 134B,A01,083661,Powell; Thomas Allan,25,0,100,75
1657948482854,CSE 140,A01,083663,Gungor; Onat,17,0,85,68
1657948488877,CSE 140L,A01,083088,Eldon; John,23,0,100,77
1657948494901,CSE 175,A01,083665,Kumar; Rakesh,3,0,25,22
1657948500925,CSE 190,A00,092507,Dubnov; Shlomo,8,0,20,12
1657948506950,ECE 45,A01,083139,Congero; Spencer William,7,0,75,68
1657948512973,ECE 65,A50,083695,Saad; Andrew S,12,0,30,18
1657948512973,ECE 65,A51,095125,Saad; Andrew S,24,0,26,2
1657948518998,ECE 109,A01,091882,Touri; Behrouz,20,0,70,50
1657948525020,ECE 180,A00,083140,Abi Samra; Nicholas Camill,1,0,30,29
1657948525020,ECE 180,B00,083141,Abi Samra; Nicholas Camill,0,0,30,30
1657948531043,MATH 10A,A01,083735,Patchell; Gregory David,2,0,30,28
1657948531043,MATH 10A,A02,083736,Patchell; Gregory David,20,0,30,10
1657948531043,MATH 10A,A03,083737,Patchell; Gregory David,16,0,30,14
1657948537080,MATH 10B,A01,083207,Lim; Seonhee,9,0,34,25
1657948537080,MATH 10B,A02,083208,Lim; Seonhee,10,0,35,25
1657948537080,MATH 10B,A03,093472,Lim; Seonhee,7,0,34,27
1657948537080,MATH 10B,B01,083739,Sinha; Shubham,14,0,30,16
1657948543105,MATH 18,A01,083743,Cinel; Cameron Alexander,9,0,30,21
1657948543105,MATH 18,A02,083744,Cinel; Cameron Alexander,18,0,30,12
1657948543105,MATH 18,A03,083745,Cinel; Cameron Alexander,10,0,30,20
1657948543105,MATH 18,B01,083748,Rideout; David Porter,5,0,37,32
1657948543105,MATH 18,B02,083749,Rideout; David Porter,5,0,36,31
1657948543105,MATH 18,B03,083750,Rideout; David Porter,3,0,37,34
1657948543105,MATH 18,B04,083751,Rideout; David Porter,7,0,36,29
1657948543105,MATH 18,B05,093473,Rideout; David Porter,7,0,36,29
1657948543105,MATH 18,B06,093474,Rideout; David Porter,6,0,36,30
1657948549129,MATH 20A,A01,083754,Zheng; Zequn,14,0,40,26
1657948555151,MATH 20B,A01,083756,Briones; Jor-el Thomas Caparas,4,0,36,32
1657948555151,MATH 20B,A02,083757,Briones; Jor-el Thomas Caparas,1,0,36,35
1657948555151,MATH 20B,A03,093475,Briones; Jor-el Thomas Caparas,3,0,36,33
1657948561182,MATH 20C,A01,083760,Briones; Jor-el Thomas Caparas,1,0,35,34
1657948561182,MATH 20C,A02,083761,Briones; Jor-el Thomas Caparas,8,0,35,27
1657948561182,MATH 20C,A03,093476,Briones; Jor-el Thomas Caparas,0,1,36,36
1657948561182,MATH 20C,B01,083762,Bach; Quang Tran,1,0,30,29
1657948567205,MATH 20D,A01,083765,Tran; Brian Kha,5,0,30,25
1657948567205,MATH 20D,A02,083766,Tran; Brian Kha,5,0,30,25
1657948567205,MATH 20D,A03,083767,Tran; Brian Kha,6,0,30,24
1657948573232,MATH 20E,A01,083771,Ganguly; Soumya,12,0,32,20
1657948573232,MATH 20E,A02,083772,Ganguly; Soumya,7,0,32,25
1657948573232,MATH 20E,B01,083773,Ciotti; Benjamin,20,0,35,15
1657948573232,MATH 20E,B02,083774,Ciotti; Benjamin,18,0,35,17
1657948579266,MATH 103A,A01,083777,Greenfeld; Be'Eri,4,0,36,32
1657948579266,MATH 103A,A02,083778,Greenfeld; Be'Eri,5,0,36,31
1657948579266,MATH 103A,A03,093561,Greenfeld; Be'Eri,7,0,36,29
1657948579266,MATH 103A,B01,083779,Greenfeld; Be'Eri,8,0,36,28
1657948579266,MATH 103A,B02,083780,Greenfeld; Be'Eri,4,0,36,32
1657948579266,MATH 103A,B03,093562,Greenfeld; Be'Eri,3,0,36,33
1657948585293,MATH 105,A01,085443,Carter; Anne Toulson,15,0,35,20
1657948585293,MATH 105,A02,093477,Carter; Anne Toulson,20,0,35,15
1657948591317,MATH 109,A01,083213,Ganzberger; Geoffrey Michael,3,0,34,31
1657948591317,MATH 109,A02,083214,Ganzberger; Geoffrey Michael,4,0,34,30
1657948591317,MATH 109,A03,093478,Ganzberger; Geoffrey Michael,2,0,34,32
1657948591317,MATH 109,B01,083215,Ganzberger; Geoffrey Michael,3,0,32,29
1657948591317,MATH 109,B02,083216,Ganzberger; Geoffrey Michael,3,0,32,29
1657948591317,MATH 109,B03,093479,Ganzberger; Geoffrey Michael,8,0,32,24
1657948597341,MATH 142A,A01,083219,Chow; Bennett,7,0,32,25
1657948597341,MATH 142A,A02,083220,Chow; Bennett,10,0,32,22
1657948597341,MATH 142A,A03,093480,Chow; Bennett,9,0,32,23
1657948597341,MATH 142A,B03,093481,Chow; Bennett,8,0,32,24
1657948597341,MATH 142A,B04,093558,Chow; Bennett,14,0,32,18
1657948597341,MATH 142A,B05,093559,Chow; Bennett,7,0,32,25
1657948603369,MATH 193A,A01,083224,Rotar; Vladimir,9,0,34,25
1657948603369,MATH 193A,A02,083225,Rotar; Vladimir,11,0,34,23
1657948603369,MATH 193A,A03,083781,Rotar; Vladimir,5,0,34,29
1657948603369,MATH 193A,A04,083782,Rotar; Vladimir,12,0,34,22
1657948603369,MATH 193A,A05,093482,Rotar; Vladimir,11,0,34,23
1657948609392,MATH 197,001,091859,McAuley; Julian John,9999,0,9999,0
1657948609392,MATH 197,002,095566,Kedlaya; Kiran S.,9997,0,9999,2
1657948609392,MATH 197,003,095567,Xiao; Ming,9999,0,9999,0
1657948609392,MATH 197,004,095571,Perols; Johan Lars,9998,0,9999,1
1657948616452,COGS 9,A01,083615,Shannon; Kyle Michael,11,0,75,64
1657948622479,COGS 11,A01,083617,Boyle; Mary E. T.,23,0,48,25
1657948628503,COGS 13,A01,083071,Bastos; Amalia Pinkusfeld,12,0,71,59
1657948634538,COGS 14A,A01,092681,Semenuks; Arturs,5,1,100,95
1657948640562,COGS 14B,A01,083073,Cheng; Tzu-Han,7,0,63,56
1657948646585,COGS 17,A01,092677,Semenuks; Arturs,7,0,81,74
1657948652608,COGS 100,A01,083619,Allen; Michael Gordon,17,0,70,53
1657948658632,COGS 101A,A01,083621,Davis; Joshua Daniel,9,0,68,59
1657948664657,COGS 101B,A01,091572,Allen; Michael Gordon,14,0,65,51
1657948670684,COGS 101C,A01,083625,Delgado; Tania,17,0,35,18
1657948676711,COGS 107A,A01,083627,Boyle; Mary E. T.,14,0,60,46
1657948682746,COGS 118A,A01,083075,Gupta; Anjum,21,0,76,55
1657948688774,CSE 3,A50,083646,Miranda; Gregory Joseph,24,0,50,26
1657948694800,CSE 8A,A50,083650,Miranda; Gregory Joseph,17,1,56,39
1657948700822,CSE 11,A01,083080,Cao; Yingjun,7,15,40,33
1657948706846,CSE 12,A01,083652,Krause-Levy; Sophia Louisa,30,1,120,90
1657948712869,CSE 15L,A01,083654,Morris; Justin Loren,9,0,50,41
1657948712869,CSE 15L,A02,083655,Morris; Justin Loren,11,0,50,39
1657948718897,CSE 20,A01,083657,Tran; Khoa Dang,39,0,80,41
1657948724924,CSE 21,A01,095574,Bach; Quang Tran,23,0,48,25
1657948730951,CSE 30,A01,083084,Eldon; John,7,0,80,73
1657948730951,CSE 30,B01,095061,Bhaskar; Nishant,9,0,50,41
1657948736976,CSE 100,A01,083659,Cao; Yingjun,5,4,70,65
1657948742999,CSE 134B,A01,083661,Powell; Thomas Allan,25,0,100,75
1657948749022,CSE 140,A01,083663,Gungor; Onat,17,0,85,68
1657948755049,CSE 140L,A01,083088,Eldon; John,23,0,100,77
1657948761071,CSE 175,A01,083665,Kumar; Rakesh,3,0,25,22
1657948767097,CSE 190,A00,092507,Dubnov; Shlomo,8,0,20,12
1657948773120,ECE 45,A01,083139,Congero; Spencer William,7,0,75,68
1657948779147,ECE 65,A50,083695,Saad; Andrew S,12,0,30,18
1657948779147,ECE 65,A51,095125,Saad; Andrew S,24,0,26,2
1657948785171,ECE 109,A01,091882,Touri; Behrouz,20,0,70,50
1657948791194,ECE 180,A00,083140,Abi Samra; Nicholas Camill,1,0,30,29
1657948791194,ECE 180,B00,083141,Abi Samra; Nicholas Camill,0,0,30,30
1657948797217,MATH 10A,A01,083735,Patchell; Gregory David,2,0,30,28
1657948797217,MATH 10A,A02,083736,Patchell; Gregory David,20,0,30,10
1657948797217,MATH 10A,A03,083737,Patchell; Gregory David,16,0,30,14
1657948803241,MATH 10B,A01,083207,Lim; Seonhee,9,0,34,25
1657948803241,MATH 10B,A02,083208,Lim; Seonhee,10,0,35,25
1657948803241,MATH 10B,A03,093472,Lim; Seonhee,7,0,34,27
1657948803241,MATH 10B,B01,083739,Sinha; Shubham,14,0,30,16
1657948809264,MATH 18,A01,083743,Cinel; Cameron Alexander,9,0,30,21
1657948809264,MATH 18,A02,083744,Cinel; Cameron Alexander,18,0,30,12
1657948809264,MATH 18,A03,083745,Cinel; Cameron Alexander,10,0,30,20
1657948809264,MATH 18,B01,083748,Rideout; David Porter,5,0,37,32
1657948809264,MATH 18,B02,083749,Rideout; David Porter,5,0,36,31
1657948809264,MATH 18,B03,083750,Rideout; David Porter,3,0,37,34
1657948809264,MATH 18,B04,083751,Rideout; David Porter,7,0,36,29
1657948809264,MATH 18,B05,093473,Rideout; David Porter,7,0,36,29
1657948809264,MATH 18,B06,093474,Rideout; David Porter,6,0,36,30
1657948815286,MATH 20A,A01,083754,Zheng; Zequn,14,0,40,26
1657948821313,MATH 20B,A01,083756,Briones; Jor-el Thomas Caparas,4,0,36,32
1657948821313,MATH 20B,A02,083757,Briones; Jor-el Thomas Caparas,1,0,36,35
1657948821313,MATH 20B,A03,093475,Briones; Jor-el Thomas Caparas,3,0,36,33
1657948827336,MATH 20C,A01,083760,Briones; Jor-el Thomas Caparas,1,0,35,34
1657948827336,MATH 20C,A02,083761,Briones; Jor-el Thomas Caparas,8,0,35,27
1657948827336,MATH 20C,A03,093476,Briones; Jor-el Thomas Caparas,0,1,36,36
1657948827336,MATH 20C,B01,083762,Bach; Quang Tran,1,0,30,29
1657948833359,MATH 20D,A01,083765,Tran; Brian Kha,5,0,30,25
1657948833359,MATH 20D,A02,083766,Tran; Brian Kha,5,0,30,25
1657948833359,MATH 20D,A03,083767,Tran; Brian Kha,6,0,30,24
1657948839384,MATH 20E,A01,083771,Ganguly; Soumya,12,0,32,20
1657948839384,MATH 20E,A02,083772,Ganguly; Soumya,7,0,32,25
1657948839384,MATH 20E,B01,083773,Ciotti; Benjamin,20,0,35,15
1657948839384,MATH 20E,B02,083774,Ciotti; Benjamin,18,0,35,17
1657948845408,MATH 103A,A01,083777,Greenfeld; Be'Eri,4,0,36,32
1657948845408,MATH 103A,A02,083778,Greenfeld; Be'Eri,5,0,36,31
1657948845408,MATH 103A,A03,093561,Greenfeld; Be'Eri,7,0,36,29
1657948845408,MATH 103A,B01,083779,Greenfeld; Be'Eri,8,0,36,28
1657948845408,MATH 103A,B02,083780,Greenfeld; Be'Eri,4,0,36,32
1657948845408,MATH 103A,B03,093562,Greenfeld; Be'Eri,3,0,36,33
1657948851457,MATH 105,A01,085443,Carter; Anne Toulson,15,0,35,20
1657948851457,MATH 105,A02,093477,Carter; Anne Toulson,20,0,35,15
1657948857482,MATH 109,A01,083213,Ganzberger; Geoffrey Michael,3,0,34,31
1657948857482,MATH 109,A02,083214,Ganzberger; Geoffrey Michael,4,0,34,30
1657948857482,MATH 109,A03,093478,Ganzberger; Geoffrey Michael,2,0,34,32
1657948857482,MATH 109,B01,083215,Ganzberger; Geoffrey Michael,3,0,32,29
1657948857482,MATH 109,B02,083216,Ganzberger; Geoffrey Michael,3,0,32,29
1657948857482,MATH 109,B03,093479,Ganzberger; Geoffrey Michael,8,0,32,24
1657948863506,MATH 142A,A01,083219,Chow; Bennett,7,0,32,25
1657948863506,MATH 142A,A02,083220,Chow; Bennett,10,0,32,22
1657948863506,MATH 142A,A03,093480,Chow; Bennett,9,0,32,23
1657948863506,MATH 142A,B03,093481,Chow; Bennett,8,0,32,24
1657948863506,MATH 142A,B04,093558,Chow; Bennett,14,0,32,18
1657948863506,MATH 142A,B05,093559,Chow; Bennett,7,0,32,25
1657948869536,MATH 193A,A01,083224,Rotar; Vladimir,9,0,34,25
1657948869536,MATH 193A,A02,083225,Rotar; Vladimir,11,0,34,23
1657948869536,MATH 193A,A03,083781,Rotar; Vladimir,5,0,34,29
1657948869536,MATH 193A,A04,083782,Rotar; Vladimir,12,0,34,22
1657948869536,MATH 193A,A05,093482,Rotar; Vladimir,11,0,34,23
1657948875560,MATH 197,001,091859,McAuley; Julian John,9999,0,9999,0
1657948875560,MATH 197,002,095566,Kedlaya; Kiran S.,9997,0,9999,2
1657948875560,MATH 197,003,095567,Xiao; Ming,9999,0,9999,0
1657948875560,MATH 197,004,095571,Perols; Johan Lars,9998,0,9999,1
1657948882616,COGS 9,A01,083615,Shannon; Kyle Michael,11,0,75,64
1657948888650,COGS 11,A01,083617,Boyle; Mary E. T.,23,0,48,25
1657948894672,COGS 13,A01,083071,Bastos; Amalia Pinkusfeld,12,0,71,59
1657948900694,COGS 14A,A01,092681,Semenuks; Arturs,5,1,100,95
1657948906717,COGS 14B,A01,083073,Cheng; Tzu-Han,7,0,63,56
1657948912739,COGS 17,A01,092677,Semenuks; Arturs,7,0,81,74
1657948918764,COGS 100,A01,083619,Allen; Michael Gordon,17,0,70,53
1657948924786,COGS 101A,A01,083621,Davis; Joshua Daniel,9,0,68,59
1657948930812,COGS 101B,A01,091572,Allen; Michael Gordon,14,0,65,51
1657948936840,COGS 101C,A01,083625,Delgado; Tania,17,0,35,18
1657948942862,COGS 107A,A01,083627,Boyle; Mary E. T.,14,0,60,46
1657948948887,COGS 118A,A01,083075,Gupta; Anjum,21,0,76,55
1657948954910,CSE 3,A50,083646,Miranda; Gregory Joseph,24,0,50,26
1657948960937,CSE 8A,A50,083650,Miranda; Gregory Joseph,17,1,56,39
1657948967034,CSE 11,A01,083080,Cao; Yingjun,7,15,40,33
1657948973056,CSE 12,A01,083652,Krause-Levy; Sophia Louisa,30,1,120,90
1657948979080,CSE 15L,A01,083654,Morris; Justin Loren,9,0,50,41
1657948979080,CSE 15L,A02,083655,Morris; Justin Loren,11,0,50,39
1657948985114,CSE 20,A01,083657,Tran; Khoa Dang,39,0,80,41
1657948991137,CSE 21,A01,095574,Bach; Quang Tran,23,0,48,25
1657948997169,CSE 30,A01,083084,Eldon; John,7,0,80,73
1657948997169,CSE 30,B01,095061,Bhaskar; Nishant,9,0,50,41
1657949003195,CSE 100,A01,083659,Cao; Yingjun,5,4,70,65
1657949009219,CSE 134B,A01,083661,Powell; Thomas Allan,25,0,100,75
1657949015240,CSE 140,A01,083663,Gungor; Onat,17,0,85,68
1657949021263,CSE 140L,A01,083088,Eldon; John,23,0,100,77
1657949027285,CSE 175,A01,083665,Kumar; Rakesh,3,0,25,22
1657949033312,CSE 190,A00,092507,Dubnov; Shlomo,8,0,20,12
1657949039335,ECE 45,A01,083139,Congero; Spencer William,7,0,75,68
1657949045359,ECE 65,A50,083695,Saad; Andrew S,12,0,30,18
1657949045359,ECE 65,A51,095125,Saad; Andrew S,24,0,26,2
1657949051385,ECE 109,A01,091882,Touri; Behrouz,20,0,70,50
1657949057412,ECE 180,A00,083140,Abi Samra; Nicholas Camill,1,0,30,29
1657949057412,ECE 180,B00,083141,Abi Samra; Nicholas Camill,0,0,30,30
1657949063436,MATH 10A,A01,083735,Patchell; Gregory David,2,0,30,28
1657949063436,MATH 10A,A02,083736,Patchell; Gregory David,20,0,30,10
1657949063436,MATH 10A,A03,083737,Patchell; Gregory David,16,0,30,14
1657949069473,MATH 10B,A01,083207,Lim; Seonhee,9,0,34,25
1657949069473,MATH 10B,A02,083208,Lim; Seonhee,10,0,35,25
1657949069473,MATH 10B,A03,093472,Lim; Seonhee,7,0,34,27
1657949069473,MATH 10B,B01,083739,Sinha; Shubham,14,0,30,16
1657949075518,MATH 18,A01,083743,Cinel; Cameron Alexander,9,0,30,21
1657949075518,MATH 18,A02,083744,Cinel; Cameron Alexander,18,0,30,12
1657949075518,MATH 18,A03,083745,Cinel; Cameron Alexander,10,0,30,20
1657949075518,MATH 18,B01,083748,Rideout; David Porter,5,0,37,32
1657949075518,MATH 18,B02,083749,Rideout; David Porter,5,0,36,31
1657949075518,MATH 18,B03,083750,Rideout; David Porter,3,0,37,34
1657949075518,MATH 18,B04,083751,Rideout; David Porter,7,0,36,29
1657949075518,MATH 18,B05,093473,Rideout; David Porter,7,0,36,29
1657949075518,MATH 18,B06,093474,Rideout; David Porter,6,0,36,30
1657949081541,MATH 20A,A01,083754,Zheng; Zequn,14,0,40,26
1657949087566,MATH 20B,A01,083756,Briones; Jor-el Thomas Caparas,4,0,36,32
1657949087566,MATH 20B,A02,083757,Briones; Jor-el Thomas Caparas,1,0,36,35
1657949087566,MATH 20B,A03,093475,Briones; Jor-el Thomas Caparas,3,0,36,33
1657949093590,MATH 20C,A01,083760,Briones; Jor-el Thomas Caparas,1,0,35,34
1657949093590,MATH 20C,A02,083761,Briones; Jor-el Thomas Caparas,8,0,35,27
1657949093590,MATH 20C,A03,093476,Briones; Jor-el Thomas Caparas,0,1,36,36
1657949093590,MATH 20C,B01,083762,Bach; Quang Tran,1,0,30,29
1657949099624,MATH 20D,A01,083765,Tran; Brian Kha,5,0,30,25
1657949099624,MATH 20D,A02,083766,Tran; Brian Kha,5,0,30,25
1657949099624,MATH 20D,A03,083767,Tran; Brian Kha,6,0,30,24
1657949105651,MATH 20E,A01,083771,Ganguly; Soumya,12,0,32,20
1657949105651,MATH 20E,A02,083772,Ganguly; Soumya,7,0,32,25
1657949105651,MATH 20E,B01,083773,Ciotti; Benjamin,20,0,35,15
1657949105651,MATH 20E,B02,083774,Ciotti; Benjamin,18,0,35,17
1657949111676,MATH 103A,A01,083777,Greenfeld; Be'Eri,5,0,36,31
1657949111676,MATH 103A,A02,083778,Greenfeld; Be'Eri,5,0,36,31
1657949111676,MATH 103A,A03,093561,Greenfeld; Be'Eri,7,0,36,29
1657949111676,MATH 103A,B01,083779,Greenfeld; Be'Eri,8,0,36,28
1657949111676,MATH 103A,B02,083780,Greenfeld; Be'Eri,4,0,36,32
1657949111676,MATH 103A,B03,093562,Greenfeld; Be'Eri,3,0,36,33
1657949117701,MATH 105,A01,085443,Carter; Anne Toulson,15,0,35,20
1657949117701,MATH 105,A02,093477,Carter; Anne Toulson,20,0,35,15
1657949123724,MATH 109,A01,083213,Ganzberger; Geoffrey Michael,3,0,34,31
1657949123724,MATH 109,A02,083214,Ganzberger; Geoffrey Michael,4,0,34,30
1657949123724,MATH 109,A03,093478,Ganzberger; Geoffrey Michael,2,0,34,32
1657949123724,MATH 109,B01,083215,Ganzberger; Geoffrey Michael,3,0,32,29
1657949123724,MATH 109,B02,083216,Ganzberger; Geoffrey Michael,3,0,32,29
1657949123724,MATH 109,B03,093479,Ganzberger; Geoffrey Michael,8,0,32,24
1657949129749,MATH 142A,A01,083219,Chow; Bennett,7,0,32,25
1657949129749,MATH 142A,A02,083220,Chow; Bennett,10,0,32,22
1657949129749,MATH 142A,A03,093480,Chow; Bennett,9,0,32,23
1657949129749,MATH 142A,B03,093481,Chow; Bennett,8,0,32,24
1657949129749,MATH 142A,B04,093558,Chow; Bennett,14,0,32,18
1657949129749,MATH 142A,B05,093559,Chow; Bennett,7,0,32,25
1657949135773,MATH 193A,A01,083224,Rotar; Vladimir,9,0,34,25
1657949135773,MATH 193A,A02,083225,Rotar; Vladimir,11,0,34,23
1657949135773,MATH 193A,A03,083781,Rotar; Vladimir,5,0,34,29
1657949135773,MATH 193A,A04,083782,Rotar; Vladimir,12,0,34,22
1657949135773,MATH 193A,A05,093482,Rotar; Vladimir,11,0,34,23
1657949141797,MATH 197,001,091859,McAuley; Julian John,9999,0,9999,0
1657949141797,MATH 197,002,095566,Kedlaya; Kiran S.,9997,0,9999,2
1657949141797,MATH 197,003,095567,Xiao; Ming,9999,0,9999,0
1657949141797,MATH 197,004,095571,Perols; Johan Lars,9998,0,9999,1
1657949148847,COGS 9,A01,083615,Shannon; Kyle Michael,11,0,75,64
1657949154876,COGS 11,A01,083617,Boyle; Mary E. T.,23,0,48,25
1657949160898,COGS 13,A01,083071,Bastos; Amalia Pinkusfeld,12,0,71,59
1657949166928,COGS 14A,A01,092681,Semenuks; Arturs,5,1,100,95
1657949172954,COGS 14B,A01,083073,Cheng; Tzu-Han,7,0,63,56
1657949178982,COGS 17,A01,092677,Semenuks; Arturs,7,0,81,74
1657949185008,COGS 100,A01,083619,Allen; Michael Gordon,17,0,70,53
1657949191035,COGS 101A,A01,083621,Davis; Joshua Daniel,9,0,68,59
1657949197058,COGS 101B,A01,091572,Allen; Michael Gordon,14,0,65,51
1657949203086,COGS 101C,A01,083625,Delgado; Tania,17,0,35,18
1657949209113,COGS 107A,A01,083627,Boyle; Mary E. T.,14,0,60,46
1657949215140,COGS 118A,A01,083075,Gupta; Anjum,21,0,76,55
1657949221163,CSE 3,A50,083646,Miranda; Gregory Joseph,24,0,50,26
1657949227187,CSE 8A,A50,083650,Miranda; Gregory Joseph,17,1,56,39
1657949233211,CSE 11,A01,083080,Cao; Yingjun,7,15,40,33
1657949239237,CSE 12,A01,083652,Krause-Levy; Sophia Louisa,30,1,120,90
1657949245261,CSE 15L,A01,083654,Morris; Justin Loren,9,0,50,41
1657949245261,CSE 15L,A02,083655,Morris; Justin Loren,11,0,50,39
1657949251291,CSE 20,A01,083657,Tran; Khoa Dang,39,0,80,41
1657949257318,CSE 21,A01,095574,Bach; Quang Tran,23,0,48,25
1657949263340,CSE 30,A01,083084,Eldon; John,7,0,80,73
1657949263340,CSE 30,B01,095061,Bhaskar; Nishant,9,0,50,41
1657949269364,CSE 100,A01,083659,Cao; Yingjun,5,4,70,65
1657949275391,CSE 134B,A01,083661,Powell; Thomas Allan,25,0,100,75
1657949281415,CSE 140,A01,083663,Gungor; Onat,17,0,85,68
1657949287440,CSE 140L,A01,083088,Eldon; John,23,0,100,77
1657949293464,CSE 175,A01,083665,Kumar; Rakesh,3,0,25,22
1657949299488,CSE 190,A00,092507,Dubnov; Shlomo,8,0,20,12
1657949305516,ECE 45,A01,083139,Congero; Spencer William,7,0,75,68
1657949311537,ECE 65,A50,083695,Saad; Andrew S,12,0,30,18
1657949311537,ECE 65,A51,095125,Saad; Andrew S,24,0,26,2
1657949317561,ECE 109,A01,091882,Touri; Behrouz,20,0,70,50
1657949323590,ECE 180,A00,083140,Abi Samra; Nicholas Camill,1,0,30,29
1657949323590,ECE 180,B00,083141,Abi Samra; Nicholas Camill,0,0,30,30
1657949329614,MATH 10A,A01,083735,Patchell; Gregory David,2,0,30,28
1657949329614,MATH 10A,A02,083736,Patchell; Gregory David,20,0,30,10
1657949329614,MATH 10A,A03,083737,Patchell; Gregory David,16,0,30,14
1657949335639,MATH 10B,A01,083207,Lim; Seonhee,9,0,34,25
1657949335639,MATH 10B,A02,083208,Lim; Seonhee,10,0,35,25
1657949335639,MATH 10B,A03,093472,Lim; Seonhee,7,0,34,27
1657949335639,MATH 10B,B01,083739,Sinha; Shubham,14,0,30,16
1657949341671,MATH 18,A01,083743,Cinel; Cameron Alexander,9,0,30,21
1657949341671,MATH 18,A02,083744,Cinel; Cameron Alexander,18,0,30,12
1657949341671,MATH 18,A03,083745,Cinel; Cameron Alexander,10,0,30,20
1657949341671,MATH 18,B01,083748,Rideout; David Porter,5,0,37,32
1657949341671,MATH 18,B02,083749,Rideout; David Porter,5,0,36,31
1657949341671,MATH 18,B03,083750,Rideout; David Porter,3,0,37,34
1657949341671,MATH 18,B04,083751,Rideout; David Porter,7,0,36,29
1657949341671,MATH 18,B05,093473,Rideout; David Porter,7,0,36,29
1657949341671,MATH 18,B06,093474,Rideout; David Porter,6,0,36,30
1657949347692,MATH 20A,A01,083754,Zheng; Zequn,14,0,40,26
1657949353719,MATH 20B,A01,083756,Briones; Jor-el Thomas Caparas,4,0,36,32
1657949353719,MATH 20B,A02,083757,Briones; Jor-el Thomas Caparas,1,0,36,35
1657949353719,MATH 20B,A03,093475,Briones; Jor-el Thomas Caparas,3,0,36,33
1657949359747,MATH 20C,A01,083760,Briones; Jor-el Thomas Caparas,1,0,35,34
1657949359747,MATH 20C,A02,083761,Briones; Jor-el Thomas Caparas,8,0,35,27
1657949359747,MATH 20C,A03,093476,Briones; Jor-el Thomas Caparas,0,1,36,36
1657949359747,MATH 20C,B01,083762,Bach; Quang Tran,1,0,30,29
1657949365786,MATH 20D,A01,083765,Tran; Brian Kha,5,0,30,25
1657949365786,MATH 20D,A02,083766,Tran; Brian Kha,5,0,30,25
1657949365786,MATH 20D,A03,083767,Tran; Brian Kha,6,0,30,24
1657949371826,MATH 20E,A01,083771,Ganguly; Soumya,12,0,32,20
1657949371826,MATH 20E,A02,083772,Ganguly; Soumya,7,0,32,25
1657949371826,MATH 20E,B01,083773,Ciotti; Benjamin,20,0,35,15
1657949371826,MATH 20E,B02,083774,Ciotti; Benjamin,18,0,35,17
1657949377861,MATH 103A,A01,083777,Greenfeld; Be'Eri,5,0,36,31
1657949377861,MATH 103A,A02,083778,Greenfeld; Be'Eri,5,0,36,31
1657949377861,MATH 103A,A03,093561,Greenfeld; Be'Eri,7,0,36,29
1657949377861,MATH 103A,B01,083779,Greenfeld; Be'Eri,8,0,36,28
1657949377861,MATH 103A,B02,083780,Greenfeld; Be'Eri,4,0,36,32
1657949377861,MATH 103A,B03,093562,Greenfeld; Be'Eri,3,0,36,33
1657949383887,MATH 105,A01,085443,Carter; Anne Toulson,15,0,35,20
1657949383887,MATH 105,A02,093477,Carter; Anne Toulson,20,0,35,15
1657949389915,MATH 109,A01,083213,Ganzberger; Geoffrey Michael,3,0,34,31
1657949389915,MATH 109,A02,083214,Ganzberger; Geoffrey Michael,4,0,34,30
1657949389915,MATH 109,A03,093478,Ganzberger; Geoffrey Michael,2,0,34,32
1657949389915,MATH 109,B01,083215,Ganzberger; Geoffrey Michael,3,0,32,29
1657949389915,MATH 109,B02,083216,Ganzberger; Geoffrey Michael,3,0,32,29
1657949389915,MATH 109,B03,093479,Ganzberger; Geoffrey Michael,8,0,32,24
1657949395944,MATH 142A,A01,083219,Chow; Bennett,7,0,32,25
1657949395944,MATH 142A,A02,083220,Chow; Bennett,10,0,32,22
1657949395944,MATH 142A,A03,093480,Chow; Bennett,9,0,32,23
1657949395944,MATH 142A,B03,093481,Chow; Bennett,8,0,32,24
1657949395944,MATH 142A,B04,093558,Chow; Bennett,14,0,32,18
1657949395944,MATH 142A,B05,093559,Chow; Bennett,7,0,32,25
1657949401977,MATH 193A,A01,083224,Rotar; Vladimir,9,0,34,25
1657949401977,MATH 193A,A02,083225,Rotar; Vladimir,11,0,34,23
1657949401977,MATH 193A,A03,083781,Rotar; Vladimir,5,0,34,29
1657949401977,MATH 193A,A04,083782,Rotar; Vladimir,12,0,34,22
1657949401977,MATH 193A,A05,093482,Rotar; Vladimir,11,0,34,23
1657949408009,MATH 197,001,091859,McAuley; Julian John,9999,0,9999,0
1657949408009,MATH 197,002,095566,Kedlaya; Kiran S.,9997,0,9999,2
1657949408009,MATH 197,003,095567,Xiao; Ming,9999,0,9999,0
1657949408009,MATH 197,004,095571,Perols; Johan Lars,9998,0,9999,1
1657949415067,COGS 9,A01,083615,Shannon; Kyle Michael,11,0,75,64
1657949421089,COGS 11,A01,083617,Boyle; Mary E. T.,23,0,48,25
1657949427111,COGS 13,A01,083071,Bastos; Amalia Pinkusfeld,12,0,71,59
1657949433134,COGS 14A,A01,092681,Semenuks; Arturs,5,1,100,95
1657949439159,COGS 14B,A01,083073,Cheng; Tzu-Han,7,0,63,56
1657949445182,COGS 17,A01,092677,Semenuks; Arturs,7,0,81,74
1657949451209,COGS 100,A01,083619,Allen; Michael Gordon,17,0,70,53
1657949457234,COGS 101A,A01,083621,Davis; Joshua Daniel,9,0,68,59
1657949463258,COGS 101B,A01,091572,Allen; Michael Gordon,14,0,65,51
1657949469283,COGS 101C,A01,083625,Delgado; Tania,17,0,35,18
1657949475308,COGS 107A,A01,083627,Boyle; Mary E. T.,14,0,60,46
1657949481332,COGS 118A,A01,083075,Gupta; Anjum,21,0,76,55
1657949487357,CSE 3,A50,083646,Miranda; Gregory Joseph,24,0,50,26
1657949493381,CSE 8A,A50,083650,Miranda; Gregory Joseph,17,1,56,39
1657949499405,CSE 11,A01,083080,Cao; Yingjun,7,15,40,33
1657949505429,CSE 12,A01,083652,Krause-Levy; Sophia Louisa,30,1,120,90
1657949511456,CSE 15L,A01,083654,Morris; Justin Loren,9,0,50,41
1657949511456,CSE 15L,A02,083655,Morris; Justin Loren,11,0,50,39
1657949517480,CSE 20,A01,083657,Tran; Khoa Dang,39,0,80,41
1657949523506,CSE 21,A01,095574,Bach; Quang Tran,23,0,48,25
1657949529529,CSE 30,A01,083084,Eldon; John,7,0,80,73
1657949529529,CSE 30,B01,095061,Bhaskar; Nishant,9,0,50,41
1657949535555,CSE 100,A01,083659,Cao; Yingjun,5,4,70,65
1657949541581,CSE 134B,A01,083661,Powell; Thomas Allan,25,0,100,75
1657949547604,CSE 140,A01,083663,Gungor; Onat,17,0,85,68
1657949553631,CSE 140L,A01,083088,Eldon; John,23,0,100,77
1657949559665,CSE 175,A01,083665,Kumar; Rakesh,3,0,25,22
1657949565769,CSE 190,A00,092507,Dubnov; Shlomo,8,0,20,12
1657949571792,ECE 45,A01,083139,Congero; Spencer William,7,0,75,68
1657949577816,ECE 65,A50,083695,Saad; Andrew S,12,0,30,18
1657949577816,ECE 65,A51,095125,Saad; Andrew S,24,0,26,2
1657949583839,ECE 109,A01,091882,Touri; Behrouz,20,0,70,50
1657949589864,ECE 180,A00,083140,Abi Samra; Nicholas Camill,1,0,30,29
1657949589864,ECE 180,B00,083141,Abi Samra; Nicholas Camill,0,0,30,30
1657949595890,MATH 10A,A01,083735,Patchell; Gregory David,2,0,30,28
1657949595890,MATH 10A,A02,083736,Patchell; Gregory David,20,0,30,10
1657949595890,MATH 10A,A03,083737,Patchell; Gregory David,16,0,30,14
1657949601914,MATH 10B,A01,083207,Lim; Seonhee,9,0,34,25
1657949601914,MATH 10B,A02,083208,Lim; Seonhee,10,0,35,25
1657949601914,MATH 10B,A03,093472,Lim; Seonhee,7,0,34,27
1657949601914,MATH 10B,B01,083739,Sinha; Shubham,14,0,30,16
1657949607939,MATH 18,A01,083743,Cinel; Cameron Alexander,9,0,30,21
1657949607939,MATH 18,A02,083744,Cinel; Cameron Alexander,18,0,30,12
1657949607939,MATH 18,A03,083745,Cinel; Cameron Alexander,10,0,30,20
1657949607939,MATH 18,B01,083748,Rideout; David Porter,5,0,37,32
1657949607939,MATH 18,B02,083749,Rideout; David Porter,5,0,36,31
1657949607939,MATH 18,B03,083750,Rideout; David Porter,3,0,37,34
1657949607939,MATH 18,B04,083751,Rideout; David Porter,7,0,36,29
1657949607939,MATH 18,B05,093473,Rideout; David Porter,7,0,36,29
1657949607939,MATH 18,B06,093474,Rideout; David Porter,6,0,36,30
1657949613966,MATH 20A,A01,083754,Zheng; Zequn,14,0,40,26
1657949619990,MATH 20B,A01,083756,Briones; Jor-el Thomas Caparas,4,0,36,32
1657949619990,MATH 20B,A02,083757,Briones; Jor-el Thomas Caparas,1,0,36,35
1657949619990,MATH 20B,A03,093475,Briones; Jor-el Thomas Caparas,3,0,36,33
1657949626015,MATH 20C,A01,083760,Briones; Jor-el Thomas Caparas,1,0,35,34
1657949626015,MATH 20C,A02,083761,Briones; Jor-el Thomas Caparas,8,0,35,27
1657949626015,MATH 20C,A03,093476,Briones; Jor-el Thomas Caparas,0,1,36,36
1657949626015,MATH 20C,B01,083762,Bach; Quang Tran,1,0,30,29
1657949632040,MATH 20D,A01,083765,Tran; Brian Kha,5,0,30,25
1657949632040,MATH 20D,A02,083766,Tran; Brian Kha,5,0,30,25
1657949632040,MATH 20D,A03,083767,Tran; Brian Kha,6,0,30,24
1657949638066,MATH 20E,A01,083771,Ganguly; Soumya,12,0,32,20
1657949638066,MATH 20E,A02,083772,Ganguly; Soumya,7,0,32,25
1657949638066,MATH 20E,B01,083773,Ciotti; Benjamin,20,0,35,15
1657949638066,MATH 20E,B02,083774,Ciotti; Benjamin,18,0,35,17
1657949644090,MATH 103A,A01,083777,Greenfeld; Be'Eri,5,0,36,31
1657949644090,MATH 103A,A02,083778,Greenfeld; Be'Eri,5,0,36,31
1657949644090,MATH 103A,A03,093561,Greenfeld; Be'Eri,7,0,36,29
1657949644090,MATH 103A,B01,083779,Greenfeld; Be'Eri,8,0,36,28
1657949644090,MATH 103A,B02,083780,Greenfeld; Be'Eri,4,0,36,32
1657949644090,MATH 103A,B03,093562,Greenfeld; Be'Eri,3,0,36,33
1657949650112,MATH 105,A01,085443,Carter; Anne Toulson,15,0,35,20
1657949650112,MATH 105,A02,093477,Carter; Anne Toulson,20,0,35,15
1657949656138,MATH 109,A01,083213,Ganzberger; Geoffrey Michael,3,0,34,31
1657949656138,MATH 109,A02,083214,Ganzberger; Geoffrey Michael,4,0,34,30
1657949656138,MATH 109,A03,093478,Ganzberger; Geoffrey Michael,2,0,34,32
1657949656138,MATH 109,B01,083215,Ganzberger; Geoffrey Michael,3,0,32,29
1657949656138,MATH 109,B02,083216,Ganzberger; Geoffrey Michael,3,0,32,29
1657949656138,MATH 109,B03,093479,Ganzberger; Geoffrey Michael,8,0,32,24
1657949662162,MATH 142A,A01,083219,Chow; Bennett,7,0,32,25
1657949662162,MATH 142A,A02,083220,Chow; Bennett,10,0,32,22
1657949662162,MATH 142A,A03,093480,Chow; Bennett,9,0,32,23
1657949662162,MATH 142A,B03,093481,Chow; Bennett,8,0,32,24
1657949662162,MATH 142A,B04,093558,Chow; Bennett,14,0,32,18
1657949662162,MATH 142A,B05,093559,Chow; Bennett,7,0,32,25
1657949668194,MATH 193A,A01,083224,Rotar; Vladimir,9,0,34,25
1657949668194,MATH 193A,A02,083225,Rotar; Vladimir,11,0,34,23
1657949668194,MATH 193A,A03,083781,Rotar; Vladimir,5,0,34,29
1657949668194,MATH 193A,A04,083782,Rotar; Vladimir,12,0,34,22
1657949668194,MATH 193A,A05,093482,Rotar; Vladimir,11,0,34,23
1657949674217,MATH 197,001,091859,McAuley; Julian John,9999,0,9999,0
1657949674217,MATH 197,002,095566,Kedlaya; Kiran S.,9997,0,9999,2
1657949674217,MATH 197,003,095567,Xiao; Ming,9999,0,9999,0
1657949674217,MATH 197,004,095571,Perols; Johan Lars,9998,0,9999,1
1657949681284,COGS 9,A01,083615,Shannon; Kyle Michael,11,0,75,64
1657949687311,COGS 11,A01,083617,Boyle; Mary E. T.,23,0,48,25
1657949693334,COGS 13,A01,083071,Bastos; Amalia Pinkusfeld,12,0,71,59
1657949699360,COGS 14A,A01,092681,Semenuks; Arturs,5,1,100,95
1657949705388,COGS 14B,A01,083073,Cheng; Tzu-Han,7,0,63,56
1657949711413,COGS 17,A01,092677,Semenuks; Arturs,7,0,81,74
1657949717441,COGS 100,A01,083619,Allen; Michael Gordon,17,0,70,53
1657949723463,COGS 101A,A01,083621,Davis; Joshua Daniel,9,0,68,59
1657949729488,COGS 101B,A01,091572,Allen; Michael Gordon,14,0,65,51
1657949735511,COGS 101C,A01,083625,Delgado; Tania,17,0,35,18
1657949741535,COGS 107A,A01,083627,Boyle; Mary E. T.,14,0,60,46
1657949747562,COGS 118A,A01,083075,Gupta; Anjum,21,0,76,55
1657949753583,CSE 3,A50,083646,Miranda; Gregory Joseph,24,0,50,26
1657949759614,CSE 8A,A50,083650,Miranda; Gregory Joseph,17,1,56,39
1657949765645,CSE 11,A01,083080,Cao; Yingjun,7,15,40,33
1657949771671,CSE 12,A01,083652,Krause-Levy; Sophia Louisa,30,1,120,90
1657949777700,CSE 15L,A01,083654,Morris; Justin Loren,9,0,50,41
1657949777700,CSE 15L,A02,083655,Morris; Justin Loren,11,0,50,39
1657949783727,CSE 20,A01,083657,Tran; Khoa Dang,39,0,80,41
1657949789749,CSE 21,A01,095574,Bach; Quang Tran,23,0,48,25
1657949795772,CSE 30,A01,083084,Eldon; John,7,0,80,73
1657949795772,CSE 30,B01,095061,Bhaskar; Nishant,9,0,50,41
1657949801798,CSE 100,A01,083659,Cao; Yingjun,5,4,70,65
1657949807824,CSE 134B,A01,083661,Powell; Thomas Allan,25,0,100,75
1657949813846,CSE 140,A01,083663,Gungor; Onat,17,0,85,68
1657949819868,CSE 140L,A01,083088,Eldon; John,23,0,100,77
1657949825894,CSE 175,A01,083665,Kumar; Rakesh,3,0,25,22
1657949831916,CSE 190,A00,092507,Dubnov; Shlomo,8,0,20,12
1657949837940,ECE 45,A01,083139,Congero; Spencer William,7,0,75,68
1657949843968,ECE 65,A50,083695,Saad; Andrew S,12,0,30,18
1657949843968,ECE 65,A51,095125,Saad; Andrew S,24,0,26,2
1657949849991,ECE 109,A01,091882,Touri; Behrouz,20,0,70,50
1657949856013,ECE 180,A00,083140,Abi Samra; Nicholas Camill,1,0,30,29
1657949856013,ECE 180,B00,083141,Abi Samra; Nicholas Camill,0,0,30,30
1657949862038,MATH 10A,A01,083735,Patchell; Gregory David,2,0,30,28
1657949862038,MATH 10A,A02,083736,Patchell; Gregory David,20,0,30,10
1657949862038,MATH 10A,A03,083737,Patchell; Gregory David,16,0,30,14
1657949868066,MATH 10B,A01,083207,Lim; Seonhee,9,0,34,25
1657949868066,MATH 10B,A02,083208,Lim; Seonhee,10,0,35,25
1657949868066,MATH 10B,A03,093472,Lim; Seonhee,7,0,34,27
1657949868066,MATH 10B,B01,083739,Sinha; Shubham,14,0,30,16
1657949874089,MATH 18,A01,083743,Cinel; Cameron Alexander,9,0,30,21
1657949874089,MATH 18,A02,083744,Cinel; Cameron Alexander,18,0,30,12
1657949874089,MATH 18,A03,083745,Cinel; Cameron Alexander,10,0,30,20
1657949874089,MATH 18,B01,083748,Rideout; David Porter,5,0,37,32
1657949874089,MATH 18,B02,083749,Rideout; David Porter,5,0,36,31
1657949874089,MATH 18,B03,083750,Rideout; David Porter,3,0,37,34
1657949874089,MATH 18,B04,083751,Rideout; David Porter,7,0,36,29
1657949874089,MATH 18,B05,093473,Rideout; David Porter,7,0,36,29
1657949874089,MATH 18,B06,093474,Rideout; David Porter,6,0,36,30
1657949880119,MATH 20A,A01,083754,Zheng; Zequn,14,0,40,26
1657949886141,MATH 20B,A01,083756,Briones; Jor-el Thomas Caparas,4,0,36,32
1657949886141,MATH 20B,A02,083757,Briones; Jor-el Thomas Caparas,1,0,36,35
1657949886141,MATH 20B,A03,093475,Briones; Jor-el Thomas Caparas,3,0,36,33
1657949892167,MATH 20C,A01,083760,Briones; Jor-el Thomas Caparas,1,0,35,34
1657949892167,MATH 20C,A02,083761,Briones; Jor-el Thomas Caparas,8,0,35,27
1657949892167,MATH 20C,A03,093476,Briones; Jor-el Thomas Caparas,0,1,36,36
1657949892167,MATH 20C,B01,083762,Bach; Quang Tran,1,0,30,29
1657949898193,MATH 20D,A01,083765,Tran; Brian Kha,5,0,30,25
1657949898193,MATH 20D,A02,083766,Tran; Brian Kha,5,0,30,25
1657949898193,MATH 20D,A03,083767,Tran; Brian Kha,6,0,30,24
1657949904220,MATH 20E,A01,083771,Ganguly; Soumya,12,0,32,20
1657949904220,MATH 20E,A02,083772,Ganguly; Soumya,7,0,32,25
1657949904220,MATH 20E,B01,083773,Ciotti; Benjamin,20,0,35,15
1657949904220,MATH 20E,B02,083774,Ciotti; Benjamin,18,0,35,17
1657949910243,MATH 103A,A01,083777,Greenfeld; Be'Eri,5,0,36,31
1657949910243,MATH 103A,A02,083778,Greenfeld; Be'Eri,5,0,36,31
1657949910243,MATH 103A,A03,093561,Greenfeld; Be'Eri,7,0,36,29
1657949910243,MATH 103A,B01,083779,Greenfeld; Be'Eri,8,0,36,28
1657949910243,MATH 103A,B02,083780,Greenfeld; Be'Eri,4,0,36,32
1657949910243,MATH 103A,B03,093562,Greenfeld; Be'Eri,3,0,36,33
1657949916265,MATH 105,A01,085443,Carter; Anne Toulson,15,0,35,20
1657949916265,MATH 105,A02,093477,Carter; Anne Toulson,20,0,35,15
1657949922286,MATH 109,A01,083213,Ganzberger; Geoffrey Michael,3,0,34,31
1657949922286,MATH 109,A02,083214,Ganzberger; Geoffrey Michael,4,0,34,30
1657949922286,MATH 109,A03,093478,Ganzberger; Geoffrey Michael,2,0,34,32
1657949922286,MATH 109,B01,083215,Ganzberger; Geoffrey Michael,3,0,32,29
1657949922286,MATH 109,B02,083216,Ganzberger; Geoffrey Michael,3,0,32,29
1657949922286,MATH 109,B03,093479,Ganzberger; Geoffrey Michael,8,0,32,24
1657949928314,MATH 142A,A01,083219,Chow; Bennett,7,0,32,25
1657949928314,MATH 142A,A02,083220,Chow; Bennett,10,0,32,22
1657949928314,MATH 142A,A03,093480,Chow; Bennett,9,0,32,23
1657949928314,MATH 142A,B03,093481,Chow; Bennett,8,0,32,24
1657949928314,MATH 142A,B04,093558,Chow; Bennett,14,0,32,18
1657949928314,MATH 142A,B05,093559,Chow; Bennett,7,0,32,25
1657949934342,MATH 193A,A01,083224,Rotar; Vladimir,9,0,34,25
1657949934342,MATH 193A,A02,083225,Rotar; Vladimir,11,0,34,23
1657949934342,MATH 193A,A03,083781,Rotar; Vladimir,5,0,34,29
1657949934342,MATH 193A,A04,083782,Rotar; Vladimir,12,0,34,22
1657949934342,MATH 193A,A05,093482,Rotar; Vladimir,11,0,34,23
1657949940368,MATH 197,001,091859,McAuley; Julian John,9999,0,9999,0
1657949940368,MATH 197,002,095566,Kedlaya; Kiran S.,9997,0,9999,2
1657949940368,MATH 197,003,095567,Xiao; Ming,9999,0,9999,0
1657949940368,MATH 197,004,095571,Perols; Johan Lars,9998,0,9999,1
1657949947424,COGS 9,A01,083615,Shannon; Kyle Michael,11,0,75,64
1657949953447,COGS 11,A01,083617,Boyle; Mary E. T.,23,0,48,25
1657949959469,COGS 13,A01,083071,Bastos; Amalia Pinkusfeld,12,0,71,59
1657949965496,COGS 14A,A01,092681,Semenuks; Arturs,5,1,100,95
1657949971527,COGS 14B,A01,083073,Cheng; Tzu-Han,7,0,63,56
1657949977549,COGS 17,A01,092677,Semenuks; Arturs,7,0,81,74
1657949983570,COGS 100,A01,083619,Allen; Michael Gordon,17,0,70,53
1657949989593,COGS 101A,A01,083621,Davis; Joshua Daniel,9,0,68,59
1657949995619,COGS 101B,A01,091572,Allen; Michael Gordon,14,0,65,51
1657950001650,COGS 101C,A01,083625,Delgado; Tania,17,0,35,18
1657950007674,COGS 107A,A01,083627,Boyle; Mary E. T.,14,0,60,46
1657950013711,COGS 118A,A01,083075,Gupta; Anjum,21,0,76,55
1657950019737,CSE 3,A50,083646,Miranda; Gregory Joseph,24,0,50,26
1657950025764,CSE 8A,A50,083650,Miranda; Gregory Joseph,17,1,56,39
1657950031791,CSE 11,A01,083080,Cao; Yingjun,7,15,40,33
1657950037815,CSE 12,A01,083652,Krause-Levy; Sophia Louisa,30,1,120,90
1657950043840,CSE 15L,A01,083654,Morris; Justin Loren,9,0,50,41
1657950043840,CSE 15L,A02,083655,Morris; Justin Loren,11,0,50,39
1657950049862,CSE 20,A01,083657,Tran; Khoa Dang,39,0,80,41
1657950055892,CSE 21,A01,095574,Bach; Quang Tran,23,0,48,25
1657950061915,CSE 30,A01,083084,Eldon; John,7,0,80,73
1657950061915,CSE 30,B01,095061,Bhaskar; Nishant,9,0,50,41
1657950067938,CSE 100,A01,083659,Cao; Yingjun,5,4,70,65
1657950073965,CSE 134B,A01,083661,Powell; Thomas Allan,25,0,100,75
1657950079988,CSE 140,A01,083663,Gungor; Onat,17,0,85,68
1657950086013,CSE 140L,A01,083088,Eldon; John,23,0,100,77
1657950092038,CSE 175,A01,083665,Kumar; Rakesh,3,0,25,22
1657950098060,CSE 190,A00,092507,Dubnov; Shlomo,8,0,20,12
1657950104081,ECE 45,A01,083139,Congero; Spencer William,7,0,75,68
1657950110106,ECE 65,A50,083695,Saad; Andrew S,12,0,30,18
1657950110106,ECE 65,A51,095125,Saad; Andrew S,24,0,26,2
1657950116129,ECE 109,A01,091882,Touri; Behrouz,20,0,70,50
1657950122153,ECE 180,A00,083140,Abi Samra; Nicholas Camill,1,0,30,29
1657950122153,ECE 180,B00,083141,Abi Samra; Nicholas Camill,0,0,30,30
1657950128176,MATH 10A,A01,083735,Patchell; Gregory David,2,0,30,28
1657950128176,MATH 10A,A02,083736,Patchell; Gregory David,20,0,30,10
1657950128176,MATH 10A,A03,083737,Patchell; Gregory David,16,0,30,14
1657950134200,MATH 10B,A01,083207,Lim; Seonhee,9,0,34,25
1657950134200,MATH 10B,A02,083208,Lim; Seonhee,10,0,35,25
1657950134200,MATH 10B,A03,093472,Lim; Seonhee,7,0,34,27
1657950134200,MATH 10B,B01,083739,Sinha; Shubham,14,0,30,16
1657950140233,MATH 18,A01,083743,Cinel; Cameron Alexander,9,0,30,21
1657950140233,MATH 18,A02,083744,Cinel; Cameron Alexander,18,0,30,12
1657950140233,MATH 18,A03,083745,Cinel; Cameron Alexander,10,0,30,20
1657950140233,MATH 18,B01,083748,Rideout; David Porter,5,0,37,32
1657950140233,MATH 18,B02,083749,Rideout; David Porter,5,0,36,31
1657950140233,MATH 18,B03,083750,Rideout; David Porter,3,0,37,34
1657950140233,MATH 18,B04,083751,Rideout; David Porter,7,0,36,29
1657950140233,MATH 18,B05,093473,Rideout; David Porter,7,0,36,29
1657950140233,MATH 18,B06,093474,Rideout; David Porter,6,0,36,30
1657950146260,MATH 20A,A01,083754,Zheng; Zequn,14,0,40,26
1657950152288,MATH 20B,A01,083756,Briones; Jor-el Thomas Caparas,4,0,36,32
1657950152288,MATH 20B,A02,083757,Briones; Jor-el Thomas Caparas,1,0,36,35
1657950152288,MATH 20B,A03,093475,Briones; Jor-el Thomas Caparas,3,0,36,33
1657950158322,MATH 20C,A01,083760,Briones; Jor-el Thomas Caparas,1,0,35,34
1657950158322,MATH 20C,A02,083761,Briones; Jor-el Thomas Caparas,8,0,35,27
1657950158322,MATH 20C,A03,093476,Briones; Jor-el Thomas Caparas,0,1,36,36
1657950158322,MATH 20C,B01,083762,Bach; Quang Tran,1,0,30,29
1657950164435,MATH 20D,A01,083765,Tran; Brian Kha,5,0,30,25
1657950164435,MATH 20D,A02,083766,Tran; Brian Kha,5,0,30,25
1657950164435,MATH 20D,A03,083767,Tran; Brian Kha,6,0,30,24
1657950170458,MATH 20E,A01,083771,Ganguly; Soumya,12,0,32,20
1657950170458,MATH 20E,A02,083772,Ganguly; Soumya,7,0,32,25
1657950170458,MATH 20E,B01,083773,Ciotti; Benjamin,20,0,35,15
1657950170458,MATH 20E,B02,083774,Ciotti; Benjamin,18,0,35,17
1657950176487,MATH 103A,A01,083777,Greenfeld; Be'Eri,5,0,36,31
1657950176487,MATH 103A,A02,083778,Greenfeld; Be'Eri,5,0,36,31
1657950176487,MATH 103A,A03,093561,Greenfeld; Be'Eri,7,0,36,29
1657950176487,MATH 103A,B01,083779,Greenfeld; Be'Eri,8,0,36,28
1657950176487,MATH 103A,B02,083780,Greenfeld; Be'Eri,4,0,36,32
1657950176487,MATH 103A,B03,093562,Greenfeld; Be'Eri,3,0,36,33
1657950182516,MATH 105,A01,085443,Carter; Anne Toulson,15,0,35,20
1657950182516,MATH 105,A02,093477,Carter; Anne Toulson,20,0,35,15
1657950188539,MATH 109,A01,083213,Ganzberger; Geoffrey Michael,3,0,34,31
1657950188539,MATH 109,A02,083214,Ganzberger; Geoffrey Michael,4,0,34,30
1657950188539,MATH 109,A03,093478,Ganzberger; Geoffrey Michael,2,0,34,32
1657950188539,MATH 109,B01,083215,Ganzberger; Geoffrey Michael,3,0,32,29
1657950188539,MATH 109,B02,083216,Ganzberger; Geoffrey Michael,3,0,32,29
1657950188539,MATH 109,B03,093479,Ganzberger; Geoffrey Michael,8,0,32,24
1657950194568,MATH 142A,A01,083219,Chow; Bennett,7,0,32,25
1657950194568,MATH 142A,A02,083220,Chow; Bennett,10,0,32,22
1657950194568,MATH 142A,A03,093480,Chow; Bennett,9,0,32,23
1657950194568,MATH 142A,B03,093481,Chow; Bennett,8,0,32,24
1657950194568,MATH 142A,B04,093558,Chow; Bennett,14,0,32,18
1657950194568,MATH 142A,B05,093559,Chow; Bennett,7,0,32,25
1657950200591,MATH 193A,A01,083224,Rotar; Vladimir,9,0,34,25
1657950200591,MATH 193A,A02,083225,Rotar; Vladimir,11,0,34,23
1657950200591,MATH 193A,A03,083781,Rotar; Vladimir,5,0,34,29
1657950200591,MATH 193A,A04,083782,Rotar; Vladimir,12,0,34,22
1657950200591,MATH 193A,A05,093482,Rotar; Vladimir,11,0,34,23
1657950206613,MATH 197,001,091859,McAuley; Julian John,9999,0,9999,0
1657950206613,MATH 197,002,095566,Kedlaya; Kiran S.,9997,0,9999,2
1657950206613,MATH 197,003,095567,Xiao; Ming,9999,0,9999,0
1657950206613,MATH 197,004,095571,Perols; Johan Lars,9998,0,9999,1
1657950213664,COGS 9,A01,083615,Shannon; Kyle Michael,11,0,75,64
1657950219692,COGS 11,A01,083617,Boyle; Mary E. T.,23,0,48,25
1657950225717,COGS 13,A01,083071,Bastos; Amalia Pinkusfeld,12,0,71,59
1657950231744,COGS 14A,A01,092681,Semenuks; Arturs,5,1,100,95
1657950237772,COGS 14B,A01,083073,Cheng; Tzu-Han,7,0,63,56
1657950243796,COGS 17,A01,092677,Semenuks; Arturs,7,0,81,74
1657950249819,COGS 100,A01,083619,Allen; Michael Gordon,17,0,70,53
1657950255845,COGS 101A,A01,083621,Davis; Joshua Daniel,9,0,68,59
1657950261869,COGS 101B,A01,091572,Allen; Michael Gordon,14,0,65,51
1657950267895,COGS 101C,A01,083625,Delgado; Tania,17,0,35,18
1657950273920,COGS 107A,A01,083627,Boyle; Mary E. T.,14,0,60,46
1657950279951,COGS 118A,A01,083075,Gupta; Anjum,21,0,76,55
1657950285979,CSE 3,A50,083646,Miranda; Gregory Joseph,24,0,50,26
1657950292002,CSE 8A,A50,083650,Miranda; Gregory Joseph,17,1,56,39
1657950298024,CSE 11,A01,083080,Cao; Yingjun,7,15,40,33
1657950304051,CSE 12,A01,083652,Krause-Levy; Sophia Louisa,30,1,120,90
1657950310074,CSE 15L,A01,083654,Morris; Justin Loren,9,0,50,41
1657950310074,CSE 15L,A02,083655,Morris; Justin Loren,11,0,50,39
1657950316098,CSE 20,A01,083657,Tran; Khoa Dang,39,0,80,41
1657950322122,CSE 21,A01,095574,Bach; Quang Tran,23,0,48,25
1657950328144,CSE 30,A01,083084,Eldon; John,7,0,80,73
1657950328144,CSE 30,B01,095061,Bhaskar; Nishant,9,0,50,41
1657950334170,CSE 100,A01,083659,Cao; Yingjun,5,4,70,65
1657950340197,CSE 134B,A01,083661,Powell; Thomas Allan,25,0,100,75
1657950346219,CSE 140,A01,083663,Gungor; Onat,17,0,85,68
1657950352242,CSE 140L,A01,083088,Eldon; John,23,0,100,77
1657950358269,CSE 175,A01,083665,Kumar; Rakesh,3,0,25,22
1657950364292,CSE 190,A00,092507,Dubnov; Shlomo,8,0,20,12
1657950370315,ECE 45,A01,083139,Congero; Spencer William,7,0,75,68
1657950376341,ECE 65,A50,083695,Saad; Andrew S,12,0,30,18
1657950376341,ECE 65,A51,095125,Saad; Andrew S,24,0,26,2
1657950382365,ECE 109,A01,091882,Touri; Behrouz,21,0,70,49
1657950388387,ECE 180,A00,083140,Abi Samra; Nicholas Camill,1,0,30,29
1657950388387,ECE 180,B00,083141,Abi Samra; Nicholas Camill,0,0,30,30
1657950394415,MATH 10A,A01,083735,Patchell; Gregory David,2,0,30,28
1657950394415,MATH 10A,A02,083736,Patchell; Gregory David,20,0,30,10
1657950394415,MATH 10A,A03,083737,Patchell; Gregory David,16,0,30,14
1657950400443,MATH 10B,A01,083207,Lim; Seonhee,9,0,34,25
1657950400443,MATH 10B,A02,083208,Lim; Seonhee,10,0,35,25
1657950400443,MATH 10B,A03,093472,Lim; Seonhee,7,0,34,27
1657950400443,MATH 10B,B01,083739,Sinha; Shubham,14,0,30,16
1657950406478,MATH 18,A01,083743,Cinel; Cameron Alexander,9,0,30,21
1657950406478,MATH 18,A02,083744,Cinel; Cameron Alexander,18,0,30,12
1657950406478,MATH 18,A03,083745,Cinel; Cameron Alexander,10,0,30,20
1657950406478,MATH 18,B01,083748,Rideout; David Porter,5,0,37,32
1657950406478,MATH 18,B02,083749,Rideout; David Porter,5,0,36,31
1657950406478,MATH 18,B03,083750,Rideout; David Porter,3,0,37,34
1657950406478,MATH 18,B04,083751,Rideout; David Porter,7,0,36,29
1657950406478,MATH 18,B05,093473,Rideout; David Porter,7,0,36,29
1657950406478,MATH 18,B06,093474,Rideout; David Porter,6,0,36,30
1657950412504,MATH 20A,A01,083754,Zheng; Zequn,14,0,40,26
1657950418527,MATH 20B,A01,083756,Briones; Jor-el Thomas Caparas,4,0,36,32
1657950418527,MATH 20B,A02,083757,Briones; Jor-el Thomas Caparas,1,0,36,35
1657950418527,MATH 20B,A03,093475,Briones; Jor-el Thomas Caparas,3,0,36,33
1657950424552,MATH 20C,A01,083760,Briones; Jor-el Thomas Caparas,1,0,35,34
1657950424552,MATH 20C,A02,083761,Briones; Jor-el Thomas Caparas,8,0,35,27
1657950424552,MATH 20C,A03,093476,Briones; Jor-el Thomas Caparas,0,1,36,36
1657950424552,MATH 20C,B01,083762,Bach; Quang Tran,1,0,30,29
1657950430577,MATH 20D,A01,083765,Tran; Brian Kha,5,0,30,25
1657950430577,MATH 20D,A02,083766,Tran; Brian Kha,5,0,30,25
1657950430577,MATH 20D,A03,083767,Tran; Brian Kha,6,0,30,24
1657950436609,MATH 20E,A01,083771,Ganguly; Soumya,12,0,32,20
1657950436609,MATH 20E,A02,083772,Ganguly; Soumya,7,0,32,25
1657950436609,MATH 20E,B01,083773,Ciotti; Benjamin,20,0,35,15
1657950436609,MATH 20E,B02,083774,Ciotti; Benjamin,18,0,35,17
1657950442636,MATH 103A,A01,083777,Greenfeld; Be'Eri,5,0,36,31
1657950442636,MATH 103A,A02,083778,Greenfeld; Be'Eri,5,0,36,31
1657950442636,MATH 103A,A03,093561,Greenfeld; Be'Eri,7,0,36,29
1657950442636,MATH 103A,B01,083779,Greenfeld; Be'Eri,8,0,36,28
1657950442636,MATH 103A,B02,083780,Greenfeld; Be'Eri,4,0,36,32
1657950442636,MATH 103A,B03,093562,Greenfeld; Be'Eri,3,0,36,33
1657950448658,MATH 105,A01,085443,Carter; Anne Toulson,15,0,35,20
1657950448658,MATH 105,A02,093477,Carter; Anne Toulson,20,0,35,15
1657950454682,MATH 109,A01,083213,Ganzberger; Geoffrey Michael,3,0,34,31
1657950454682,MATH 109,A02,083214,Ganzberger; Geoffrey Michael,4,0,34,30
1657950454682,MATH 109,A03,093478,Ganzberger; Geoffrey Michael,2,0,34,32
1657950454682,MATH 109,B01,083215,Ganzberger; Geoffrey Michael,3,0,32,29
1657950454682,MATH 109,B02,083216,Ganzberger; Geoffrey Michael,3,0,32,29
1657950454682,MATH 109,B03,093479,Ganzberger; Geoffrey Michael,8,0,32,24
1657950460706,MATH 142A,A01,083219,Chow; Bennett,7,0,32,25
1657950460706,MATH 142A,A02,083220,Chow; Bennett,10,0,32,22
1657950460706,MATH 142A,A03,093480,Chow; Bennett,9,0,32,23
1657950460706,MATH 142A,B03,093481,Chow; Bennett,8,0,32,24
1657950460706,MATH 142A,B04,093558,Chow; Bennett,14,0,32,18
1657950460706,MATH 142A,B05,093559,Chow; Bennett,7,0,32,25
1657950466733,MATH 193A,A01,083224,Rotar; Vladimir,9,0,34,25
1657950466733,MATH 193A,A02,083225,Rotar; Vladimir,11,0,34,23
1657950466733,MATH 193A,A03,083781,Rotar; Vladimir,5,0,34,29
1657950466733,MATH 193A,A04,083782,Rotar; Vladimir,12,0,34,22
1657950466733,MATH 193A,A05,093482,Rotar; Vladimir,11,0,34,23
1657950472754,MATH 197,001,091859,McAuley; Julian John,9999,0,9999,0
1657950472754,MATH 197,002,095566,Kedlaya; Kiran S.,9997,0,9999,2
1657950472754,MATH 197,003,095567,Xiao; Ming,9999,0,9999,0
1657950472754,MATH 197,004,095571,Perols; Johan Lars,9998,0,9999,1
1657950479813,COGS 9,A01,083615,Shannon; Kyle Michael,11,0,75,64
1657950485838,COGS 11,A01,083617,Boyle; Mary E. T.,23,0,48,25
1657950491864,COGS 13,A01,083071,Bastos; Amalia Pinkusfeld,12,0,71,59
1657950497891,COGS 14A,A01,092681,Semenuks; Arturs,5,1,100,95
1657950503918,COGS 14B,A01,083073,Cheng; Tzu-Han,7,0,63,56
1657950509944,COGS 17,A01,092677,Semenuks; Arturs,7,0,81,74
1657950515975,COGS 100,A01,083619,Allen; Michael Gordon,17,0,70,53
1657950521997,COGS 101A,A01,083621,Davis; Joshua Daniel,9,0,68,59
1657950528022,COGS 101B,A01,091572,Allen; Michael Gordon,14,0,65,51
1657950534048,COGS 101C,A01,083625,Delgado; Tania,17,0,35,18
1657950540070,COGS 107A,A01,083627,Boyle; Mary E. T.,14,0,60,46
1657950546093,COGS 118A,A01,083075,Gupta; Anjum,21,0,76,55
1657950552117,CSE 3,A50,083646,Miranda; Gregory Joseph,24,0,50,26
1657950558142,CSE 8A,A50,083650,Miranda; Gregory Joseph,17,1,56,39
1657950564164,CSE 11,A01,083080,Cao; Yingjun,7,15,40,33
1657950570193,CSE 12,A01,083652,Krause-Levy; Sophia Louisa,30,1,120,90
1657950576219,CSE 15L,A01,083654,Morris; Justin Loren,9,0,50,41
1657950576219,CSE 15L,A02,083655,Morris; Justin Loren,11,0,50,39
1657950582246,CSE 20,A01,083657,Tran; Khoa Dang,39,0,80,41
1657950588269,CSE 21,A01,095574,Bach; Quang Tran,23,0,48,25
1657950594296,CSE 30,A01,083084,Eldon; John,7,0,80,73
1657950594296,CSE 30,B01,095061,Bhaskar; Nishant,9,0,50,41
1657950600320,CSE 100,A01,083659,Cao; Yingjun,5,4,70,65
1657950606342,CSE 134B,A01,083661,Powell; Thomas Allan,25,0,100,75
1657950612367,CSE 140,A01,083663,Gungor; Onat,17,0,85,68
1657950618390,CSE 140L,A01,083088,Eldon; John,23,0,100,77
1657950624413,CSE 175,A01,083665,Kumar; Rakesh,3,0,25,22
1657950630435,CSE 190,A00,092507,Dubnov; Shlomo,8,0,20,12
1657950636463,ECE 45,A01,083139,Congero; Spencer William,7,0,75,68
1657950642495,ECE 65,A50,083695,Saad; Andrew S,12,0,30,18
1657950642495,ECE 65,A51,095125,Saad; Andrew S,24,0,26,2
1657950648518,ECE 109,A01,091882,Touri; Behrouz,21,0,70,49
1657950654543,ECE 180,A00,083140,Abi Samra; Nicholas Camill,1,0,30,29
1657950654543,ECE 180,B00,083141,Abi Samra; Nicholas Camill,0,0,30,30
1657950660569,MATH 10A,A01,083735,Patchell; Gregory David,2,0,30,28
1657950660569,MATH 10A,A02,083736,Patchell; Gregory David,20,0,30,10
1657950660569,MATH 10A,A03,083737,Patchell; Gregory David,16,0,30,14
1657950666597,MATH 10B,A01,083207,Lim; Seonhee,9,0,34,25
1657950666597,MATH 10B,A02,083208,Lim; Seonhee,10,0,35,25
1657950666597,MATH 10B,A03,093472,Lim; Seonhee,7,0,34,27
1657950666597,MATH 10B,B01,083739,Sinha; Shubham,14,0,30,16
1657950672628,MATH 18,A01,083743,Cinel; Cameron Alexander,9,0,30,21
1657950672628,MATH 18,A02,083744,Cinel; Cameron Alexander,18,0,30,12
1657950672628,MATH 18,A03,083745,Cinel; Cameron Alexander,10,0,30,20
1657950672628,MATH 18,B01,083748,Rideout; David Porter,5,0,37,32
1657950672628,MATH 18,B02,083749,Rideout; David Porter,5,0,36,31
1657950672628,MATH 18,B03,083750,Rideout; David Porter,3,0,37,34
1657950672628,MATH 18,B04,083751,Rideout; David Porter,7,0,36,29
1657950672628,MATH 18,B05,093473,Rideout; David Porter,7,0,36,29
1657950672628,MATH 18,B06,093474,Rideout; David Porter,6,0,36,30
1657950678651,MATH 20A,A01,083754,Zheng; Zequn,14,0,40,26
1657950684675,MATH 20B,A01,083756,Briones; Jor-el Thomas Caparas,4,0,36,32
1657950684675,MATH 20B,A02,083757,Briones; Jor-el Thomas Caparas,1,0,36,35
1657950684675,MATH 20B,A03,093475,Briones; Jor-el Thomas Caparas,3,0,36,33
1657950690699,MATH 20C,A01,083760,Briones; Jor-el Thomas Caparas,1,0,35,34
1657950690699,MATH 20C,A02,083761,Briones; Jor-el Thomas Caparas,8,0,35,27
1657950690699,MATH 20C,A03,093476,Briones; Jor-el Thomas Caparas,0,1,36,36
1657950690699,MATH 20C,B01,083762,Bach; Quang Tran,1,0,30,29
1657950696723,MATH 20D,A01,083765,Tran; Brian Kha,5,0,30,25
1657950696723,MATH 20D,A02,083766,Tran; Brian Kha,5,0,30,25
1657950696723,MATH 20D,A03,083767,Tran; Brian Kha,6,0,30,24
1657950702747,MATH 20E,A01,083771,Ganguly; Soumya,12,0,32,20
1657950702747,MATH 20E,A02,083772,Ganguly; Soumya,7,0,32,25
1657950702747,MATH 20E,B01,083773,Ciotti; Benjamin,20,0,35,15
1657950702747,MATH 20E,B02,083774,Ciotti; Benjamin,18,0,35,17
1657950708779,MATH 103A,A01,083777,Greenfeld; Be'Eri,5,0,36,31
1657950708779,MATH 103A,A02,083778,Greenfeld; Be'Eri,5,0,36,31
1657950708779,MATH 103A,A03,093561,Greenfeld; Be'Eri,7,0,36,29
1657950708779,MATH 103A,B01,083779,Greenfeld; Be'Eri,8,0,36,28
1657950708779,MATH 103A,B02,083780,Greenfeld; Be'Eri,4,0,36,32
1657950708779,MATH 103A,B03,093562,Greenfeld; Be'Eri,3,0,36,33
1657950714807,MATH 105,A01,085443,Carter; Anne Toulson,15,0,35,20
1657950714807,MATH 105,A02,093477,Carter; Anne Toulson,20,0,35,15
1657950720831,MATH 109,A01,083213,Ganzberger; Geoffrey Michael,3,0,34,31
1657950720831,MATH 109,A02,083214,Ganzberger; Geoffrey Michael,4,0,34,30
1657950720831,MATH 109,A03,093478,Ganzberger; Geoffrey Michael,2,0,34,32
1657950720831,MATH 109,B01,083215,Ganzberger; Geoffrey Michael,3,0,32,29
1657950720831,MATH 109,B02,083216,Ganzberger; Geoffrey Michael,3,0,32,29
1657950720831,MATH 109,B03,093479,Ganzberger; Geoffrey Michael,8,0,32,24
1657950726854,MATH 142A,A01,083219,Chow; Bennett,7,0,32,25
1657950726854,MATH 142A,A02,083220,Chow; Bennett,10,0,32,22
1657950726854,MATH 142A,A03,093480,Chow; Bennett,9,0,32,23
1657950726854,MATH 142A,B03,093481,Chow; Bennett,8,0,32,24
1657950726854,MATH 142A,B04,093558,Chow; Bennett,14,0,32,18
1657950726854,MATH 142A,B05,093559,Chow; Bennett,7,0,32,25
1657950732883,MATH 193A,A01,083224,Rotar; Vladimir,9,0,34,25
1657950732883,MATH 193A,A02,083225,Rotar; Vladimir,11,0,34,23
1657950732883,MATH 193A,A03,083781,Rotar; Vladimir,5,0,34,29
1657950732883,MATH 193A,A04,083782,Rotar; Vladimir,12,0,34,22
1657950732883,MATH 193A,A05,093482,Rotar; Vladimir,11,0,34,23
1657950738906,MATH 197,001,091859,McAuley; Julian John,9999,0,9999,0
1657950738906,MATH 197,002,095566,Kedlaya; Kiran S.,9997,0,9999,2
1657950738906,MATH 197,003,095567,Xiao; Ming,9999,0,9999,0
1657950738906,MATH 197,004,095571,Perols; Johan Lars,9998,0,9999,1
1657950745958,COGS 9,A01,083615,Shannon; Kyle Michael,11,0,75,64
1657950751982,COGS 11,A01,083617,Boyle; Mary E. T.,23,0,48,25
1657950758085,COGS 13,A01,083071,Bastos; Amalia Pinkusfeld,12,0,71,59
1657950764112,COGS 14A,A01,092681,Semenuks; Arturs,5,1,100,95
1657950770135,COGS 14B,A01,083073,Cheng; Tzu-Han,7,0,63,56
1657950776158,COGS 17,A01,092677,Semenuks; Arturs,7,0,81,74
1657950782190,COGS 100,A01,083619,Allen; Michael Gordon,17,0,70,53
1657950788216,COGS 101A,A01,083621,Davis; Joshua Daniel,9,0,68,59
1657950794239,COGS 101B,A01,091572,Allen; Michael Gordon,14,0,65,51
1657950800262,COGS 101C,A01,083625,Delgado; Tania,17,0,35,18
1657950806290,COGS 107A,A01,083627,Boyle; Mary E. T.,14,0,60,46
1657950812316,COGS 118A,A01,083075,Gupta; Anjum,21,0,76,55
1657950818338,CSE 3,A50,083646,Miranda; Gregory Joseph,24,0,50,26
1657950824362,CSE 8A,A50,083650,Miranda; Gregory Joseph,17,1,56,39
1657950830385,CSE 11,A01,083080,Cao; Yingjun,7,15,40,33
1657950836410,CSE 12,A01,083652,Krause-Levy; Sophia Louisa,30,1,120,90
1657950842434,CSE 15L,A01,083654,Morris; Justin Loren,9,0,50,41
1657950842434,CSE 15L,A02,083655,Morris; Justin Loren,11,0,50,39
1657950848458,CSE 20,A01,083657,Tran; Khoa Dang,39,0,80,41
1657950854486,CSE 21,A01,095574,Bach; Quang Tran,23,0,48,25
1657950860510,CSE 30,A01,083084,Eldon; John,7,0,80,73
1657950860510,CSE 30,B01,095061,Bhaskar; Nishant,9,0,50,41
1657950866536,CSE 100,A01,083659,Cao; Yingjun,5,4,70,65
1657950872560,CSE 134B,A01,083661,Powell; Thomas Allan,25,0,100,75
1657950878582,CSE 140,A01,083663,Gungor; Onat,17,0,85,68
1657950884605,CSE 140L,A01,083088,Eldon; John,23,0,100,77
1657950890637,CSE 175,A01,083665,Kumar; Rakesh,3,0,25,22
1657950896660,CSE 190,A00,092507,Dubnov; Shlomo,8,0,20,12
1657950902685,ECE 45,A01,083139,Congero; Spencer William,7,0,75,68
1657950908713,ECE 65,A50,083695,Saad; Andrew S,12,0,30,18
1657950908713,ECE 65,A51,095125,Saad; Andrew S,24,0,26,2
1657950914735,ECE 109,A01,091882,Touri; Behrouz,21,0,70,49
1657950920757,ECE 180,A00,083140,Abi Samra; Nicholas Camill,1,0,30,29
1657950920757,ECE 180,B00,083141,Abi Samra; Nicholas Camill,0,0,30,30
1657950926781,MATH 10A,A01,083735,Patchell; Gregory David,2,0,30,28
1657950926781,MATH 10A,A02,083736,Patchell; Gregory David,20,0,30,10
1657950926781,MATH 10A,A03,083737,Patchell; Gregory David,16,0,30,14
1657950932811,MATH 10B,A01,083207,Lim; Seonhee,9,0,34,25
1657950932811,MATH 10B,A02,083208,Lim; Seonhee,10,0,35,25
1657950932811,MATH 10B,A03,093472,Lim; Seonhee,7,0,34,27
1657950932811,MATH 10B,B01,083739,Sinha; Shubham,14,0,30,16
1657950938842,MATH 18,A01,083743,Cinel; Cameron Alexander,9,0,30,21
1657950938842,MATH 18,A02,083744,Cinel; Cameron Alexander,18,0,30,12
1657950938842,MATH 18,A03,083745,Cinel; Cameron Alexander,10,0,30,20
1657950938842,MATH 18,B01,083748,Rideout; David Porter,5,0,37,32
1657950938842,MATH 18,B02,083749,Rideout; David Porter,5,0,36,31
1657950938842,MATH 18,B03,083750,Rideout; David Porter,3,0,37,34
1657950938842,MATH 18,B04,083751,Rideout; David Porter,7,0,36,29
1657950938842,MATH 18,B05,093473,Rideout; David Porter,7,0,36,29
1657950938842,MATH 18,B06,093474,Rideout; David Porter,6,0,36,30
1657950944866,MATH 20A,A01,083754,Zheng; Zequn,14,0,40,26
1657950950889,MATH 20B,A01,083756,Briones; Jor-el Thomas Caparas,4,0,36,32
1657950950889,MATH 20B,A02,083757,Briones; Jor-el Thomas Caparas,1,0,36,35
1657950950889,MATH 20B,A03,093475,Briones; Jor-el Thomas Caparas,3,0,36,33
1657950956913,MATH 20C,A01,083760,Briones; Jor-el Thomas Caparas,1,0,35,34
1657950956913,MATH 20C,A02,083761,Briones; Jor-el Thomas Caparas,8,0,35,27
1657950956913,MATH 20C,A03,093476,Briones; Jor-el Thomas Caparas,0,1,36,36
1657950956913,MATH 20C,B01,083762,Bach; Quang Tran,1,0,30,29
1657950962937,MATH 20D,A01,083765,Tran; Brian Kha,5,0,30,25
1657950962937,MATH 20D,A02,083766,Tran; Brian Kha,5,0,30,25
1657950962937,MATH 20D,A03,083767,Tran; Brian Kha,6,0,30,24
1657950968964,MATH 20E,A01,083771,Ganguly; Soumya,12,0,32,20
1657950968964,MATH 20E,A02,083772,Ganguly; Soumya,7,0,32,25
1657950968964,MATH 20E,B01,083773,Ciotti; Benjamin,20,0,35,15
1657950968964,MATH 20E,B02,083774,Ciotti; Benjamin,18,0,35,17
1657950974989,MATH 103A,A01,083777,Greenfeld; Be'Eri,5,0,36,31
1657950974989,MATH 103A,A02,083778,Greenfeld; Be'Eri,5,0,36,31
1657950974989,MATH 103A,A03,093561,Greenfeld; Be'Eri,7,0,36,29
1657950974989,MATH 103A,B01,083779,Greenfeld; Be'Eri,8,0,36,28
1657950974989,MATH 103A,B02,083780,Greenfeld; Be'Eri,4,0,36,32
1657950974989,MATH 103A,B03,093562,Greenfeld; Be'Eri,3,0,36,33
1657950981017,MATH 105,A01,085443,Carter; Anne Toulson,15,0,35,20
1657950981017,MATH 105,A02,093477,Carter; Anne Toulson,20,0,35,15
1657950987041,MATH 109,A01,083213,Ganzberger; Geoffrey Michael,3,0,34,31
1657950987041,MATH 109,A02,083214,Ganzberger; Geoffrey Michael,4,0,34,30
1657950987041,MATH 109,A03,093478,Ganzberger; Geoffrey Michael,2,0,34,32
1657950987041,MATH 109,B01,083215,Ganzberger; Geoffrey Michael,3,0,32,29
1657950987041,MATH 109,B02,083216,Ganzberger; Geoffrey Michael,3,0,32,29
1657950987041,MATH 109,B03,093479,Ganzberger; Geoffrey Michael,8,0,32,24
1657950993071,MATH 142A,A01,083219,Chow; Bennett,7,0,32,25
1657950993071,MATH 142A,A02,083220,Chow; Bennett,10,0,32,22
1657950993071,MATH 142A,A03,093480,Chow; Bennett,9,0,32,23
1657950993071,MATH 142A,B03,093481,Chow; Bennett,8,0,32,24
1657950993071,MATH 142A,B04,093558,Chow; Bennett,14,0,32,18
1657950993071,MATH 142A,B05,093559,Chow; Bennett,7,0,32,25
1657950999095,MATH 193A,A01,083224,Rotar; Vladimir,9,0,34,25
1657950999095,MATH 193A,A02,083225,Rotar; Vladimir,11,0,34,23
1657950999095,MATH 193A,A03,083781,Rotar; Vladimir,5,0,34,29
1657950999095,MATH 193A,A04,083782,Rotar; Vladimir,12,0,34,22
1657950999095,MATH 193A,A05,093482,Rotar; Vladimir,11,0,34,23
1657951005119,MATH 197,001,091859,McAuley; Julian John,9999,0,9999,0
1657951005119,MATH 197,002,095566,Kedlaya; Kiran S.,9997,0,9999,2
1657951005119,MATH 197,003,095567,Xiao; Ming,9999,0,9999,0
1657951005119,MATH 197,004,095571,Perols; Johan Lars,9998,0,9999,1
1657951012188,COGS 9,A01,083615,Shannon; Kyle Michael,11,0,75,64
1657951018211,COGS 11,A01,083617,Boyle; Mary E. T.,23,0,48,25
1657951024233,COGS 13,A01,083071,Bastos; Amalia Pinkusfeld,12,0,71,59
1657951030262,COGS 14A,A01,092681,Semenuks; Arturs,5,1,100,95
1657951036287,COGS 14B,A01,083073,Cheng; Tzu-Han,7,0,63,56
1657951042314,COGS 17,A01,092677,Semenuks; Arturs,7,0,81,74
1657951048336,COGS 100,A01,083619,Allen; Michael Gordon,17,0,70,53
1657951054363,COGS 101A,A01,083621,Davis; Joshua Daniel,9,0,68,59
1657951060390,COGS 101B,A01,091572,Allen; Michael Gordon,14,0,65,51
1657951066414,COGS 101C,A01,083625,Delgado; Tania,17,0,35,18
1657951072440,COGS 107A,A01,083627,Boyle; Mary E. T.,14,0,60,46
1657951078467,COGS 118A,A01,083075,Gupta; Anjum,21,0,76,55
1657951084493,CSE 3,A50,083646,Miranda; Gregory Joseph,24,0,50,26
1657951090521,CSE 8A,A50,083650,Miranda; Gregory Joseph,17,1,56,39
1657951096543,CSE 11,A01,083080,Cao; Yingjun,7,15,40,33
1657951102568,CSE 12,A01,083652,Krause-Levy; Sophia Louisa,30,1,120,90
1657951108594,CSE 15L,A01,083654,Morris; Justin Loren,9,0,50,41
1657951108594,CSE 15L,A02,083655,Morris; Justin Loren,11,0,50,39
1657951114617,CSE 20,A01,083657,Tran; Khoa Dang,39,0,80,41
1657951120642,CSE 21,A01,095574,Bach; Quang Tran,23,0,48,25
1657951126669,CSE 30,A01,083084,Eldon; John,7,0,80,73
1657951126669,CSE 30,B01,095061,Bhaskar; Nishant,9,0,50,41
1657951132694,CSE 100,A01,083659,Cao; Yingjun,5,4,70,65
1657951138717,CSE 134B,A01,083661,Powell; Thomas Allan,25,0,100,75
1657951144739,CSE 140,A01,083663,Gungor; Onat,17,0,85,68
1657951150771,CSE 140L,A01,083088,Eldon; John,23,0,100,77
1657951156795,CSE 175,A01,083665,Kumar; Rakesh,3,0,25,22
1657951162822,CSE 190,A00,092507,Dubnov; Shlomo,8,0,20,12
1657951168845,ECE 45,A01,083139,Congero; Spencer William,7,0,75,68
1657951174869,ECE 65,A50,083695,Saad; Andrew S,12,0,30,18
1657951174869,ECE 65,A51,095125,Saad; Andrew S,24,0,26,2
1657951180897,ECE 109,A01,091882,Touri; Behrouz,21,0,70,49
1657951186921,ECE 180,A00,083140,Abi Samra; Nicholas Camill,1,0,30,29
1657951186921,ECE 180,B00,083141,Abi Samra; Nicholas Camill,0,0,30,30
1657951192944,MATH 10A,A01,083735,Patchell; Gregory David,2,0,30,28
1657951192944,MATH 10A,A02,083736,Patchell; Gregory David,20,0,30,10
1657951192944,MATH 10A,A03,083737,Patchell; Gregory David,16,0,30,14
1657951198967,MATH 10B,A01,083207,Lim; Seonhee,9,0,34,25
1657951198967,MATH 10B,A02,083208,Lim; Seonhee,10,0,35,25
1657951198967,MATH 10B,A03,093472,Lim; Seonhee,7,0,34,27
1657951198967,MATH 10B,B01,083739,Sinha; Shubham,14,0,30,16
1657951204992,MATH 18,A01,083743,Cinel; Cameron Alexander,9,0,30,21
1657951204992,MATH 18,A02,083744,Cinel; Cameron Alexander,18,0,30,12
1657951204992,MATH 18,A03,083745,Cinel; Cameron Alexander,10,0,30,20
1657951204992,MATH 18,B01,083748,Rideout; David Porter,5,0,37,32
1657951204992,MATH 18,B02,083749,Rideout; David Porter,5,0,36,31
1657951204992,MATH 18,B03,083750,Rideout; David Porter,3,0,37,34
1657951204992,MATH 18,B04,083751,Rideout; David Porter,7,0,36,29
1657951204992,MATH 18,B05,093473,Rideout; David Porter,7,0,36,29
1657951204992,MATH 18,B06,093474,Rideout; David Porter,6,0,36,30
1657951211018,MATH 20A,A01,083754,Zheng; Zequn,14,0,40,26
1657951217044,MATH 20B,A01,083756,Briones; Jor-el Thomas Caparas,4,0,36,32
1657951217044,MATH 20B,A02,083757,Briones; Jor-el Thomas Caparas,1,0,36,35
1657951217044,MATH 20B,A03,093475,Briones; Jor-el Thomas Caparas,3,0,36,33
1657951223072,MATH 20C,A01,083760,Briones; Jor-el Thomas Caparas,1,0,35,34
1657951223072,MATH 20C,A02,083761,Briones; Jor-el Thomas Caparas,8,0,35,27
1657951223072,MATH 20C,A03,093476,Briones; Jor-el Thomas Caparas,0,1,36,36
1657951223072,MATH 20C,B01,083762,Bach; Quang Tran,1,0,30,29
1657951229094,MATH 20D,A01,083765,Tran; Brian Kha,5,0,30,25
1657951229094,MATH 20D,A02,083766,Tran; Brian Kha,5,0,30,25
1657951229094,MATH 20D,A03,083767,Tran; Brian Kha,6,0,30,24
1657951235118,MATH 20E,A01,083771,Ganguly; Soumya,12,0,32,20
1657951235118,MATH 20E,A02,083772,Ganguly; Soumya,7,0,32,25
1657951235118,MATH 20E,B01,083773,Ciotti; Benjamin,20,0,35,15
1657951235118,MATH 20E,B02,083774,Ciotti; Benjamin,18,0,35,17
1657951241142,MATH 103A,A01,083777,Greenfeld; Be'Eri,5,0,36,31
1657951241142,MATH 103A,A02,083778,Greenfeld; Be'Eri,5,0,36,31
1657951241142,MATH 103A,A03,093561,Greenfeld; Be'Eri,7,0,36,29
1657951241142,MATH 103A,B01,083779,Greenfeld; Be'Eri,8,0,36,28
1657951241142,MATH 103A,B02,083780,Greenfeld; Be'Eri,4,0,36,32
1657951241142,MATH 103A,B03,093562,Greenfeld; Be'Eri,3,0,36,33
1657951247172,MATH 105,A01,085443,Carter; Anne Toulson,15,0,35,20
1657951247172,MATH 105,A02,093477,Carter; Anne Toulson,20,0,35,15
1657951253202,MATH 109,A01,083213,Ganzberger; Geoffrey Michael,3,0,34,31
1657951253202,MATH 109,A02,083214,Ganzberger; Geoffrey Michael,4,0,34,30
1657951253202,MATH 109,A03,093478,Ganzberger; Geoffrey Michael,2,0,34,32
1657951253202,MATH 109,B01,083215,Ganzberger; Geoffrey Michael,3,0,32,29
1657951253202,MATH 109,B02,083216,Ganzberger; Geoffrey Michael,3,0,32,29
1657951253202,MATH 109,B03,093479,Ganzberger; Geoffrey Michael,8,0,32,24
1657951259230,MATH 142A,A01,083219,Chow; Bennett,7,0,32,25
1657951259230,MATH 142A,A02,083220,Chow; Bennett,10,0,32,22
1657951259230,MATH 142A,A03,093480,Chow; Bennett,9,0,32,23
1657951259230,MATH 142A,B03,093481,Chow; Bennett,8,0,32,24
1657951259230,MATH 142A,B04,093558,Chow; Bennett,14,0,32,18
1657951259230,MATH 142A,B05,093559,Chow; Bennett,7,0,32,25
1657951265256,MATH 193A,A01,083224,Rotar; Vladimir,9,0,34,25
1657951265256,MATH 193A,A02,083225,Rotar; Vladimir,11,0,34,23
1657951265256,MATH 193A,A03,083781,Rotar; Vladimir,5,0,34,29
1657951265256,MATH 193A,A04,083782,Rotar; Vladimir,12,0,34,22
1657951265256,MATH 193A,A05,093482,Rotar; Vladimir,11,0,34,23
1657951271284,MATH 197,001,091859,McAuley; Julian John,9999,0,9999,0
1657951271284,MATH 197,002,095566,Kedlaya; Kiran S.,9997,0,9999,2
1657951271284,MATH 197,003,095567,Xiao; Ming,9999,0,9999,0
1657951271284,MATH 197,004,095571,Perols; Johan Lars,9998,0,9999,1
1657951278361,COGS 9,A01,083615,Shannon; Kyle Michael,11,0,75,64
1657951284401,COGS 11,A01,083617,Boyle; Mary E. T.,23,0,48,25
1657951290442,COGS 13,A01,083071,Bastos; Amalia Pinkusfeld,12,0,71,59
1657951296468,COGS 14A,A01,092681,Semenuks; Arturs,5,1,100,95
1657951302491,COGS 14B,A01,083073,Cheng; Tzu-Han,7,0,63,56
1657951308515,COGS 17,A01,092677,Semenuks; Arturs,7,0,81,74
1657951314542,COGS 100,A01,083619,Allen; Michael Gordon,17,0,70,53
1657951320570,COGS 101A,A01,083621,Davis; Joshua Daniel,9,0,68,59
1657951326598,COGS 101B,A01,091572,Allen; Michael Gordon,14,0,65,51
1657951332622,COGS 101C,A01,083625,Delgado; Tania,17,0,35,18
1657951338645,COGS 107A,A01,083627,Boyle; Mary E. T.,14,0,60,46
1657951344668,COGS 118A,A01,083075,Gupta; Anjum,21,0,76,55
1657951350698,CSE 3,A50,083646,Miranda; Gregory Joseph,24,0,50,26
1657951356795,CSE 8A,A50,083650,Miranda; Gregory Joseph,17,1,56,39
1657951362821,CSE 11,A01,083080,Cao; Yingjun,7,15,40,33
1657951368849,CSE 12,A01,083652,Krause-Levy; Sophia Louisa,30,1,120,90
1657951374872,CSE 15L,A01,083654,Morris; Justin Loren,9,0,50,41
1657951374872,CSE 15L,A02,083655,Morris; Justin Loren,11,0,50,39
1657951380900,CSE 20,A01,083657,Tran; Khoa Dang,39,0,80,41
1657951386927,CSE 21,A01,095574,Bach; Quang Tran,23,0,48,25
1657951392952,CSE 30,A01,083084,Eldon; John,7,0,80,73
1657951392952,CSE 30,B01,095061,Bhaskar; Nishant,9,0,50,41
1657951398979,CSE 100,A01,083659,Cao; Yingjun,5,4,70,65
1657951405014,CSE 134B,A01,083661,Powell; Thomas Allan,25,0,100,75
1657951411038,CSE 140,A01,083663,Gungor; Onat,17,0,85,68
1657951417061,CSE 140L,A01,083088,Eldon; John,23,0,100,77
1657951423084,CSE 175,A01,083665,Kumar; Rakesh,3,0,25,22
1657951429110,CSE 190,A00,092507,Dubnov; Shlomo,8,0,20,12
1657951435135,ECE 45,A01,083139,Congero; Spencer William,7,0,75,68
1657951441159,ECE 65,A50,083695,Saad; Andrew S,12,0,30,18
1657951441159,ECE 65,A51,095125,Saad; Andrew S,24,0,26,2
1657951447184,ECE 109,A01,091882,Touri; Behrouz,21,0,70,49
1657951453212,ECE 180,A00,083140,Abi Samra; Nicholas Camill,1,0,30,29
1657951453212,ECE 180,B00,083141,Abi Samra; Nicholas Camill,0,0,30,30
1657951459241,MATH 10A,A01,083735,Patchell; Gregory David,2,0,30,28
1657951459241,MATH 10A,A02,083736,Patchell; Gregory David,20,0,30,10
1657951459241,MATH 10A,A03,083737,Patchell; Gregory David,16,0,30,14
1657951465266,MATH 10B,A01,083207,Lim; Seonhee,9,0,34,25
1657951465266,MATH 10B,A02,083208,Lim; Seonhee,10,0,35,25
1657951465266,MATH 10B,A03,093472,Lim; Seonhee,7,0,34,27
1657951465266,MATH 10B,B01,083739,Sinha; Shubham,14,0,30,16
1657951471302,MATH 18,A01,083743,Cinel; Cameron Alexander,9,0,30,21
1657951471302,MATH 18,A02,083744,Cinel; Cameron Alexander,18,0,30,12
1657951471302,MATH 18,A03,083745,Cinel; Cameron Alexander,10,0,30,20
1657951471302,MATH 18,B01,083748,Rideout; David Porter,5,0,37,32
1657951471302,MATH 18,B02,083749,Rideout; David Porter,5,0,36,31
1657951471302,MATH 18,B03,083750,Rideout; David Porter,3,0,37,34
1657951471302,MATH 18,B04,083751,Rideout; David Porter,7,0,36,29
1657951471302,MATH 18,B05,093473,Rideout; David Porter,7,0,36,29
1657951471302,MATH 18,B06,093474,Rideout; David Porter,6,0,36,30
1657951477332,MATH 20A,A01,083754,Zheng; Zequn,14,0,40,26
1657951483363,MATH 20B,A01,083756,Briones; Jor-el Thomas Caparas,4,0,36,32
1657951483363,MATH 20B,A02,083757,Briones; Jor-el Thomas Caparas,1,0,36,35
1657951483363,MATH 20B,A03,093475,Briones; Jor-el Thomas Caparas,3,0,36,33
1657951489394,MATH 20C,A01,083760,Briones; Jor-el Thomas Caparas,1,0,35,34
1657951489394,MATH 20C,A02,083761,Briones; Jor-el Thomas Caparas,8,0,35,27
1657951489394,MATH 20C,A03,093476,Briones; Jor-el Thomas Caparas,0,1,36,36
1657951489394,MATH 20C,B01,083762,Bach; Quang Tran,1,0,30,29
1657951495417,MATH 20D,A01,083765,Tran; Brian Kha,5,0,30,25
1657951495417,MATH 20D,A02,083766,Tran; Brian Kha,5,0,30,25
1657951495417,MATH 20D,A03,083767,Tran; Brian Kha,6,0,30,24
1657951501442,MATH 20E,A01,083771,Ganguly; Soumya,12,0,32,20
1657951501442,MATH 20E,A02,083772,Ganguly; Soumya,7,0,32,25
1657951501442,MATH 20E,B01,083773,Ciotti; Benjamin,20,0,35,15
1657951501442,MATH 20E,B02,083774,Ciotti; Benjamin,18,0,35,17
1657951507467,MATH 103A,A01,083777,Greenfeld; Be'Eri,5,0,36,31
1657951507467,MATH 103A,A02,083778,Greenfeld; Be'Eri,5,0,36,31
1657951507467,MATH 103A,A03,093561,Greenfeld; Be'Eri,7,0,36,29
1657951507467,MATH 103A,B01,083779,Greenfeld; Be'Eri,8,0,36,28
1657951507467,MATH 103A,B02,083780,Greenfeld; Be'Eri,4,0,36,32
1657951507467,MATH 103A,B03,093562,Greenfeld; Be'Eri,3,0,36,33
1657951513494,MATH 105,A01,085443,Carter; Anne Toulson,15,0,35,20
1657951513494,MATH 105,A02,093477,Carter; Anne Toulson,20,0,35,15
1657951519520,MATH 109,A01,083213,Ganzberger; Geoffrey Michael,3,0,34,31
1657951519520,MATH 109,A02,083214,Ganzberger; Geoffrey Michael,4,0,34,30
1657951519520,MATH 109,A03,093478,Ganzberger; Geoffrey Michael,2,0,34,32
1657951519520,MATH 109,B01,083215,Ganzberger; Geoffrey Michael,3,0,32,29
1657951519520,MATH 109,B02,083216,Ganzberger; Geoffrey Michael,3,0,32,29
1657951519520,MATH 109,B03,093479,Ganzberger; Geoffrey Michael,8,0,32,24
1657951525546,MATH 142A,A01,083219,Chow; Bennett,7,0,32,25
1657951525546,MATH 142A,A02,083220,Chow; Bennett,10,0,32,22
1657951525546,MATH 142A,A03,093480,Chow; Bennett,9,0,32,23
1657951525546,MATH 142A,B03,093481,Chow; Bennett,8,0,32,24
1657951525546,MATH 142A,B04,093558,Chow; Bennett,14,0,32,18
1657951525546,MATH 142A,B05,093559,Chow; Bennett,7,0,32,25
1657951531580,MATH 193A,A01,083224,Rotar; Vladimir,9,0,34,25
1657951531580,MATH 193A,A02,083225,Rotar; Vladimir,11,0,34,23
1657951531580,MATH 193A,A03,083781,Rotar; Vladimir,5,0,34,29
1657951531580,MATH 193A,A04,083782,Rotar; Vladimir,12,0,34,22
1657951531580,MATH 193A,A05,093482,Rotar; Vladimir,11,0,34,23
1657951537614,MATH 197,001,091859,McAuley; Julian John,9999,0,9999,0
1657951537614,MATH 197,002,095566,Kedlaya; Kiran S.,9997,0,9999,2
1657951537614,MATH 197,003,095567,Xiao; Ming,9999,0,9999,0
1657951537614,MATH 197,004,095571,Perols; Johan Lars,9998,0,9999,1
1657951544678,COGS 9,A01,083615,Shannon; Kyle Michael,11,0,75,64
1657951550704,COGS 11,A01,083617,Boyle; Mary E. T.,23,0,48,25
1657951556731,COGS 13,A01,083071,Bastos; Amalia Pinkusfeld,12,0,71,59
1657951562756,COGS 14A,A01,092681,Semenuks; Arturs,5,1,100,95
1657951568783,COGS 14B,A01,083073,Cheng; Tzu-Han,7,0,63,56
1657951574806,COGS 17,A01,092677,Semenuks; Arturs,7,0,81,74
1657951580829,COGS 100,A01,083619,Allen; Michael Gordon,17,0,70,53
1657951586852,COGS 101A,A01,083621,Davis; Joshua Daniel,9,0,68,59
1657951592880,COGS 101B,A01,091572,Allen; Michael Gordon,14,0,65,51
1657951598908,COGS 101C,A01,083625,Delgado; Tania,17,0,35,18
1657951604936,COGS 107A,A01,083627,Boyle; Mary E. T.,14,0,60,46
1657951610963,COGS 118A,A01,083075,Gupta; Anjum,21,0,76,55
1657951616988,CSE 3,A50,083646,Miranda; Gregory Joseph,24,0,50,26
1657951623011,CSE 8A,A50,083650,Miranda; Gregory Joseph,17,1,56,39
1657951629035,CSE 11,A01,083080,Cao; Yingjun,7,15,40,33
1657951635061,CSE 12,A01,083652,Krause-Levy; Sophia Louisa,30,1,120,90
1657951641087,CSE 15L,A01,083654,Morris; Justin Loren,9,0,50,41
1657951641087,CSE 15L,A02,083655,Morris; Justin Loren,11,0,50,39
1657951647110,CSE 20,A01,083657,Tran; Khoa Dang,39,0,80,41
1657951653138,CSE 21,A01,095574,Bach; Quang Tran,23,0,48,25
1657951659162,CSE 30,A01,083084,Eldon; John,7,0,80,73
1657951659162,CSE 30,B01,095061,Bhaskar; Nishant,9,0,50,41
1657951665186,CSE 100,A01,083659,Cao; Yingjun,5,4,70,65
1657951671215,CSE 134B,A01,083661,Powell; Thomas Allan,25,0,100,75
1657951677251,CSE 140,A01,083663,Gungor; Onat,17,0,85,68
1657951683277,CSE 140L,A01,083088,Eldon; John,23,0,100,77
1657951689310,CSE 175,A01,083665,Kumar; Rakesh,3,0,25,22
1657951695335,CSE 190,A00,092507,Dubnov; Shlomo,8,0,20,12
1657951701359,ECE 45,A01,083139,Congero; Spencer William,7,0,75,68
1657951707381,ECE 65,A50,083695,Saad; Andrew S,12,0,30,18
1657951707381,ECE 65,A51,095125,Saad; Andrew S,24,0,26,2
1657951713404,ECE 109,A01,091882,Touri; Behrouz,21,0,70,49
1657951719432,ECE 180,A00,083140,Abi Samra; Nicholas Camill,1,0,30,29
1657951719432,ECE 180,B00,083141,Abi Samra; Nicholas Camill,0,0,30,30
1657951725455,MATH 10A,A01,083735,Patchell; Gregory David,2,0,30,28
1657951725455,MATH 10A,A02,083736,Patchell; Gregory David,20,0,30,10
1657951725455,MATH 10A,A03,083737,Patchell; Gregory David,16,0,30,14
1657951731479,MATH 10B,A01,083207,Lim; Seonhee,9,0,34,25
1657951731479,MATH 10B,A02,083208,Lim; Seonhee,10,0,35,25
1657951731479,MATH 10B,A03,093472,Lim; Seonhee,7,0,34,27
1657951731479,MATH 10B,B01,083739,Sinha; Shubham,14,0,30,16
1657951737512,MATH 18,A01,083743,Cinel; Cameron Alexander,9,0,30,21
1657951737512,MATH 18,A02,083744,Cinel; Cameron Alexander,18,0,30,12
1657951737512,MATH 18,A03,083745,Cinel; Cameron Alexander,10,0,30,20
1657951737512,MATH 18,B01,083748,Rideout; David Porter,5,0,37,32
1657951737512,MATH 18,B02,083749,Rideout; David Porter,5,0,36,31
1657951737512,MATH 18,B03,083750,Rideout; David Porter,3,0,37,34
1657951737512,MATH 18,B04,083751,Rideout; David Porter,7,0,36,29
1657951737512,MATH 18,B05,093473,Rideout; David Porter,7,0,36,29
1657951737512,MATH 18,B06,093474,Rideout; David Porter,6,0,36,30
1657951743537,MATH 20A,A01,083754,Zheng; Zequn,14,0,40,26
1657951749560,MATH 20B,A01,083756,Briones; Jor-el Thomas Caparas,4,0,36,32
1657951749560,MATH 20B,A02,083757,Briones; Jor-el Thomas Caparas,1,0,36,35
1657951749560,MATH 20B,A03,093475,Briones; Jor-el Thomas Caparas,3,0,36,33
1657951755587,MATH 20C,A01,083760,Briones; Jor-el Thomas Caparas,1,0,35,34
1657951755587,MATH 20C,A02,083761,Briones; Jor-el Thomas Caparas,8,0,35,27
1657951755587,MATH 20C,A03,093476,Briones; Jor-el Thomas Caparas,0,1,36,36
1657951755587,MATH 20C,B01,083762,Bach; Quang Tran,1,0,30,29
1657951761610,MATH 20D,A01,083765,Tran; Brian Kha,5,0,30,25
1657951761610,MATH 20D,A02,083766,Tran; Brian Kha,5,0,30,25
1657951761610,MATH 20D,A03,083767,Tran; Brian Kha,6,0,30,24
1657951767638,MATH 20E,A01,083771,Ganguly; Soumya,12,0,32,20
1657951767638,MATH 20E,A02,083772,Ganguly; Soumya,7,0,32,25
1657951767638,MATH 20E,B01,083773,Ciotti; Benjamin,20,0,35,15
1657951767638,MATH 20E,B02,083774,Ciotti; Benjamin,18,0,35,17
1657951773665,MATH 103A,A01,083777,Greenfeld; Be'Eri,5,0,36,31
1657951773665,MATH 103A,A02,083778,Greenfeld; Be'Eri,5,0,36,31
1657951773665,MATH 103A,A03,093561,Greenfeld; Be'Eri,7,0,36,29
1657951773665,MATH 103A,B01,083779,Greenfeld; Be'Eri,8,0,36,28
1657951773665,MATH 103A,B02,083780,Greenfeld; Be'Eri,4,0,36,32
1657951773665,MATH 103A,B03,093562,Greenfeld; Be'Eri,3,0,36,33
1657951779687,MATH 105,A01,085443,Carter; Anne Toulson,15,0,35,20
1657951779687,MATH 105,A02,093477,Carter; Anne Toulson,20,0,35,15
1657951785713,MATH 109,A01,083213,Ganzberger; Geoffrey Michael,3,0,34,31
1657951785713,MATH 109,A02,083214,Ganzberger; Geoffrey Michael,4,0,34,30
1657951785713,MATH 109,A03,093478,Ganzberger; Geoffrey Michael,2,0,34,32
1657951785713,MATH 109,B01,083215,Ganzberger; Geoffrey Michael,3,0,32,29
1657951785713,MATH 109,B02,083216,Ganzberger; Geoffrey Michael,3,0,32,29
1657951785713,MATH 109,B03,093479,Ganzberger; Geoffrey Michael,8,0,32,24
1657951791744,MATH 142A,A01,083219,Chow; Bennett,7,0,32,25
1657951791744,MATH 142A,A02,083220,Chow; Bennett,10,0,32,22
1657951791744,MATH 142A,A03,093480,Chow; Bennett,9,0,32,23
1657951791744,MATH 142A,B03,093481,Chow; Bennett,8,0,32,24
1657951791744,MATH 142A,B04,093558,Chow; Bennett,14,0,32,18
1657951791744,MATH 142A,B05,093559,Chow; Bennett,7,0,32,25
1657951797774,MATH 193A,A01,083224,Rotar; Vladimir,9,0,34,25
1657951797774,MATH 193A,A02,083225,Rotar; Vladimir,11,0,34,23
1657951797774,MATH 193A,A03,083781,Rotar; Vladimir,5,0,34,29
1657951797774,MATH 193A,A04,083782,Rotar; Vladimir,12,0,34,22
1657951797774,MATH 193A,A05,093482,Rotar; Vladimir,11,0,34,23
1657951803797,MATH 197,001,091859,McAuley; Julian John,9999,0,9999,0
1657951803797,MATH 197,002,095566,Kedlaya; Kiran S.,9997,0,9999,2
1657951803797,MATH 197,003,095567,Xiao; Ming,9999,0,9999,0
1657951803797,MATH 197,004,095571,Perols; Johan Lars,9998,0,9999,1
1657951810865,COGS 9,A01,083615,Shannon; Kyle Michael,11,0,75,64
1657951816887,COGS 11,A01,083617,Boyle; Mary E. T.,23,0,48,25
1657951822911,COGS 13,A01,083071,Bastos; Amalia Pinkusfeld,12,0,71,59
1657951828935,COGS 14A,A01,092681,Semenuks; Arturs,5,1,100,95
1657951834957,COGS 14B,A01,083073,Cheng; Tzu-Han,7,0,63,56
1657951840981,COGS 17,A01,092677,Semenuks; Arturs,7,0,81,74
1657951847005,COGS 100,A01,083619,Allen; Michael Gordon,17,0,70,53
1657951853046,COGS 101A,A01,083621,Davis; Joshua Daniel,9,0,68,59
1657951859071,COGS 101B,A01,091572,Allen; Michael Gordon,14,0,65,51
1657951865100,COGS 101C,A01,083625,Delgado; Tania,17,0,35,18
1657951871123,COGS 107A,A01,083627,Boyle; Mary E. T.,14,0,60,46
1657951877159,COGS 118A,A01,083075,Gupta; Anjum,21,0,76,55
1657951883185,CSE 3,A50,083646,Miranda; Gregory Joseph,24,0,50,26
1657951889211,CSE 8A,A50,083650,Miranda; Gregory Joseph,17,1,56,39
1657951895238,CSE 11,A01,083080,Cao; Yingjun,7,15,40,33
1657951901267,CSE 12,A01,083652,Krause-Levy; Sophia Louisa,30,1,120,90
1657951907294,CSE 15L,A01,083654,Morris; Justin Loren,9,0,50,41
1657951907294,CSE 15L,A02,083655,Morris; Justin Loren,11,0,50,39
1657951913320,CSE 20,A01,083657,Tran; Khoa Dang,39,0,80,41
1657951919354,CSE 21,A01,095574,Bach; Quang Tran,23,0,48,25
1657951925377,CSE 30,A01,083084,Eldon; John,7,0,80,73
1657951925377,CSE 30,B01,095061,Bhaskar; Nishant,9,0,50,41
1657951931400,CSE 100,A01,083659,Cao; Yingjun,5,4,70,65
1657951937423,CSE 134B,A01,083661,Powell; Thomas Allan,25,0,100,75
1657951943460,CSE 140,A01,083663,Gungor; Onat,17,0,85,68
1657951949483,CSE 140L,A01,083088,Eldon; John,23,0,100,77
1657951955588,CSE 175,A01,083665,Kumar; Rakesh,3,0,25,22
1657951961612,CSE 190,A00,092507,Dubnov; Shlomo,8,0,20,12
1657951967639,ECE 45,A01,083139,Congero; Spencer William,7,0,75,68
1657951973667,ECE 65,A50,083695,Saad; Andrew S,12,0,30,18
1657951973667,ECE 65,A51,095125,Saad; Andrew S,24,0,26,2
1657951979698,ECE 109,A01,091882,Touri; Behrouz,21,0,70,49
1657951985721,ECE 180,A00,083140,Abi Samra; Nicholas Camill,1,0,30,29
1657951985721,ECE 180,B00,083141,Abi Samra; Nicholas Camill,0,0,30,30
1657951991750,MATH 10A,A01,083735,Patchell; Gregory David,2,0,30,28
1657951991750,MATH 10A,A02,083736,Patchell; Gregory David,20,0,30,10
1657951991750,MATH 10A,A03,083737,Patchell; Gregory David,16,0,30,14
1657951997779,MATH 10B,A01,083207,Lim; Seonhee,9,0,34,25
1657951997779,MATH 10B,A02,083208,Lim; Seonhee,10,0,35,25
1657951997779,MATH 10B,A03,093472,Lim; Seonhee,7,0,34,27
1657951997779,MATH 10B,B01,083739,Sinha; Shubham,14,0,30,16
1657952003811,MATH 18,A01,083743,Cinel; Cameron Alexander,9,0,30,21
1657952003811,MATH 18,A02,083744,Cinel; Cameron Alexander,18,0,30,12
1657952003811,MATH 18,A03,083745,Cinel; Cameron Alexander,10,0,30,20
1657952003811,MATH 18,B01,083748,Rideout; David Porter,5,0,37,32
1657952003811,MATH 18,B02,083749,Rideout; David Porter,5,0,36,31
1657952003811,MATH 18,B03,083750,Rideout; David Porter,3,0,37,34
1657952003811,MATH 18,B04,083751,Rideout; David Porter,7,0,36,29
1657952003811,MATH 18,B05,093473,Rideout; David Porter,7,0,36,29
1657952003811,MATH 18,B06,093474,Rideout; David Porter,6,0,36,30
1657952009835,MATH 20A,A01,083754,Zheng; Zequn,14,0,40,26
1657952015858,MATH 20B,A01,083756,Briones; Jor-el Thomas Caparas,4,0,36,32
1657952015858,MATH 20B,A02,083757,Briones; Jor-el Thomas Caparas,1,0,36,35
1657952015858,MATH 20B,A03,093475,Briones; Jor-el Thomas Caparas,3,0,36,33
1657952021883,MATH 20C,A01,083760,Briones; Jor-el Thomas Caparas,1,0,35,34
1657952021883,MATH 20C,A02,083761,Briones; Jor-el Thomas Caparas,8,0,35,27
1657952021883,MATH 20C,A03,093476,Briones; Jor-el Thomas Caparas,0,1,36,36
1657952021883,MATH 20C,B01,083762,Bach; Quang Tran,1,0,30,29
1657952027906,MATH 20D,A01,083765,Tran; Brian Kha,5,0,30,25
1657952027906,MATH 20D,A02,083766,Tran; Brian Kha,5,0,30,25
1657952027906,MATH 20D,A03,083767,Tran; Brian Kha,6,0,30,24
1657952033931,MATH 20E,A01,083771,Ganguly; Soumya,12,0,32,20
1657952033931,MATH 20E,A02,083772,Ganguly; Soumya,7,0,32,25
1657952033931,MATH 20E,B01,083773,Ciotti; Benjamin,20,0,35,15
1657952033931,MATH 20E,B02,083774,Ciotti; Benjamin,18,0,35,17
1657952039955,MATH 103A,A01,083777,Greenfeld; Be'Eri,5,0,36,31
1657952039955,MATH 103A,A02,083778,Greenfeld; Be'Eri,5,0,36,31
1657952039955,MATH 103A,A03,093561,Greenfeld; Be'Eri,7,0,36,29
1657952039955,MATH 103A,B01,083779,Greenfeld; Be'Eri,8,0,36,28
1657952039955,MATH 103A,B02,083780,Greenfeld; Be'Eri,4,0,36,32
1657952039955,MATH 103A,B03,093562,Greenfeld; Be'Eri,3,0,36,33
1657952045984,MATH 105,A01,085443,Carter; Anne Toulson,15,0,35,20
1657952045984,MATH 105,A02,093477,Carter; Anne Toulson,20,0,35,15
1657952052015,MATH 109,A01,083213,Ganzberger; Geoffrey Michael,3,0,34,31
1657952052015,MATH 109,A02,083214,Ganzberger; Geoffrey Michael,4,0,34,30
1657952052015,MATH 109,A03,093478,Ganzberger; Geoffrey Michael,2,0,34,32
1657952052015,MATH 109,B01,083215,Ganzberger; Geoffrey Michael,3,0,32,29
1657952052015,MATH 109,B02,083216,Ganzberger; Geoffrey Michael,3,0,32,29
1657952052015,MATH 109,B03,093479,Ganzberger; Geoffrey Michael,8,0,32,24
1657952058037,MATH 142A,A01,083219,Chow; Bennett,7,0,32,25
1657952058037,MATH 142A,A02,083220,Chow; Bennett,10,0,32,22
1657952058037,MATH 142A,A03,093480,Chow; Bennett,9,0,32,23
1657952058037,MATH 142A,B03,093481,Chow; Bennett,8,0,32,24
1657952058037,MATH 142A,B04,093558,Chow; Bennett,14,0,32,18
1657952058037,MATH 142A,B05,093559,Chow; Bennett,7,0,32,25
1657952064073,MATH 193A,A01,083224,Rotar; Vladimir,9,0,34,25
1657952064073,MATH 193A,A02,083225,Rotar; Vladimir,11,0,34,23
1657952064073,MATH 193A,A03,083781,Rotar; Vladimir,5,0,34,29
1657952064073,MATH 193A,A04,083782,Rotar; Vladimir,12,0,34,22
1657952064073,MATH 193A,A05,093482,Rotar; Vladimir,11,0,34,23
1657952070109,MATH 197,001,091859,McAuley; Julian John,9999,0,9999,0
1657952070109,MATH 197,002,095566,Kedlaya; Kiran S.,9997,0,9999,2
1657952070109,MATH 197,003,095567,Xiao; Ming,9999,0,9999,0
1657952070109,MATH 197,004,095571,Perols; Johan Lars,9998,0,9999,1
1657952077188,COGS 9,A01,083615,Shannon; Kyle Michael,11,0,75,64
1657952083212,COGS 11,A01,083617,Boyle; Mary E. T.,23,0,48,25
1657952089240,COGS 13,A01,083071,Bastos; Amalia Pinkusfeld,12,0,71,59
1657952095264,COGS 14A,A01,092681,Semenuks; Arturs,5,1,100,95
1657952101307,COGS 14B,A01,083073,Cheng; Tzu-Han,7,0,63,56
1657952107330,COGS 17,A01,092677,Semenuks; Arturs,7,0,81,74
1657952113351,COGS 100,A01,083619,Allen; Michael Gordon,17,0,70,53
1657952119378,COGS 101A,A01,083621,Davis; Joshua Daniel,9,0,68,59
1657952125406,COGS 101B,A01,091572,Allen; Michael Gordon,14,0,65,51
1657952131430,COGS 101C,A01,083625,Delgado; Tania,17,0,35,18
1657952137457,COGS 107A,A01,083627,Boyle; Mary E. T.,14,0,60,46
1657952143482,COGS 118A,A01,083075,Gupta; Anjum,21,0,76,55
1657952149509,CSE 3,A50,083646,Miranda; Gregory Joseph,24,0,50,26
1657952155535,CSE 8A,A50,083650,Miranda; Gregory Joseph,17,1,56,39
1657952161561,CSE 11,A01,083080,Cao; Yingjun,7,15,40,33
1657952167584,CSE 12,A01,083652,Krause-Levy; Sophia Louisa,30,1,120,90
1657952173610,CSE 15L,A01,083654,Morris; Justin Loren,9,0,50,41
1657952173610,CSE 15L,A02,083655,Morris; Justin Loren,11,0,50,39
1657952179633,CSE 20,A01,083657,Tran; Khoa Dang,39,0,80,41
1657952185657,CSE 21,A01,095574,Bach; Quang Tran,23,0,48,25
1657952191691,CSE 30,A01,083084,Eldon; John,7,0,80,73
1657952191691,CSE 30,B01,095061,Bhaskar; Nishant,9,0,50,41
1657952197713,CSE 100,A01,083659,Cao; Yingjun,5,4,70,65
1657952203749,CSE 134B,A01,083661,Powell; Thomas Allan,25,0,100,75
1657952209770,CSE 140,A01,083663,Gungor; Onat,17,0,85,68
1657952215801,CSE 140L,A01,083088,Eldon; John,23,0,100,77
1657952221826,CSE 175,A01,083665,Kumar; Rakesh,3,0,25,22
1657952227848,CSE 190,A00,092507,Dubnov; Shlomo,8,0,20,12
1657952233874,ECE 45,A01,083139,Congero; Spencer William,7,0,75,68
1657952239903,ECE 65,A50,083695,Saad; Andrew S,12,0,30,18
1657952239903,ECE 65,A51,095125,Saad; Andrew S,24,0,26,2
1657952245927,ECE 109,A01,091882,Touri; Behrouz,21,0,70,49
1657952251956,ECE 180,A00,083140,Abi Samra; Nicholas Camill,1,0,30,29
1657952251956,ECE 180,B00,083141,Abi Samra; Nicholas Camill,0,0,30,30
1657952257982,MATH 10A,A01,083735,Patchell; Gregory David,2,0,30,28
1657952257982,MATH 10A,A02,083736,Patchell; Gregory David,20,0,30,10
1657952257982,MATH 10A,A03,083737,Patchell; Gregory David,16,0,30,14
1657952264008,MATH 10B,A01,083207,Lim; Seonhee,9,0,34,25
1657952264008,MATH 10B,A02,083208,Lim; Seonhee,10,0,35,25
1657952264008,MATH 10B,A03,093472,Lim; Seonhee,7,0,34,27
1657952264008,MATH 10B,B01,083739,Sinha; Shubham,14,0,30,16
1657952270038,MATH 18,A01,083743,Cinel; Cameron Alexander,9,0,30,21
1657952270038,MATH 18,A02,083744,Cinel; Cameron Alexander,18,0,30,12
1657952270038,MATH 18,A03,083745,Cinel; Cameron Alexander,10,0,30,20
1657952270038,MATH 18,B01,083748,Rideout; David Porter,5,0,37,32
1657952270038,MATH 18,B02,083749,Rideout; David Porter,5,0,36,31
1657952270038,MATH 18,B03,083750,Rideout; David Porter,3,0,37,34
1657952270038,MATH 18,B04,083751,Rideout; David Porter,7,0,36,29
1657952270038,MATH 18,B05,093473,Rideout; David Porter,7,0,36,29
1657952270038,MATH 18,B06,093474,Rideout; David Porter,6,0,36,30
1657952276063,MATH 20A,A01,083754,Zheng; Zequn,14,0,40,26
1657952282099,MATH 20B,A01,083756,Briones; Jor-el Thomas Caparas,4,0,36,32
1657952282099,MATH 20B,A02,083757,Briones; Jor-el Thomas Caparas,1,0,36,35
1657952282099,MATH 20B,A03,093475,Briones; Jor-el Thomas Caparas,3,0,36,33
1657952288128,MATH 20C,A01,083760,Briones; Jor-el Thomas Caparas,1,0,35,34
1657952288128,MATH 20C,A02,083761,Briones; Jor-el Thomas Caparas,8,0,35,27
1657952288128,MATH 20C,A03,093476,Briones; Jor-el Thomas Caparas,0,1,36,36
1657952288128,MATH 20C,B01,083762,Bach; Quang Tran,1,0,30,29
1657952294162,MATH 20D,A01,083765,Tran; Brian Kha,5,0,30,25
1657952294162,MATH 20D,A02,083766,Tran; Brian Kha,5,0,30,25
1657952294162,MATH 20D,A03,083767,Tran; Brian Kha,6,0,30,24
1657952300185,MATH 20E,A01,083771,Ganguly; Soumya,12,0,32,20
1657952300185,MATH 20E,A02,083772,Ganguly; Soumya,7,0,32,25
1657952300185,MATH 20E,B01,083773,Ciotti; Benjamin,20,0,35,15
1657952300185,MATH 20E,B02,083774,Ciotti; Benjamin,18,0,35,17
1657952306209,MATH 103A,A01,083777,Greenfeld; Be'Eri,5,0,36,31
1657952306209,MATH 103A,A02,083778,Greenfeld; Be'Eri,5,0,36,31
1657952306209,MATH 103A,A03,093561,Greenfeld; Be'Eri,7,0,36,29
1657952306209,MATH 103A,B01,083779,Greenfeld; Be'Eri,8,0,36,28
1657952306209,MATH 103A,B02,083780,Greenfeld; Be'Eri,4,0,36,32
1657952306209,MATH 103A,B03,093562,Greenfeld; Be'Eri,3,0,36,33
1657952312232,MATH 105,A01,085443,Carter; Anne Toulson,15,0,35,20
1657952312232,MATH 105,A02,093477,Carter; Anne Toulson,20,0,35,15
1657952318259,MATH 109,A01,083213,Ganzberger; Geoffrey Michael,3,0,34,31
1657952318259,MATH 109,A02,083214,Ganzberger; Geoffrey Michael,4,0,34,30
1657952318259,MATH 109,A03,093478,Ganzberger; Geoffrey Michael,2,0,34,32
1657952318259,MATH 109,B01,083215,Ganzberger; Geoffrey Michael,3,0,32,29
1657952318259,MATH 109,B02,083216,Ganzberger; Geoffrey Michael,3,0,32,29
1657952318259,MATH 109,B03,093479,Ganzberger; Geoffrey Michael,8,0,32,24
1657952324290,MATH 142A,A01,083219,Chow; Bennett,7,0,32,25
1657952324290,MATH 142A,A02,083220,Chow; Bennett,10,0,32,22
1657952324290,MATH 142A,A03,093480,Chow; Bennett,9,0,32,23
1657952324290,MATH 142A,B03,093481,Chow; Bennett,8,0,32,24
1657952324290,MATH 142A,B04,093558,Chow; Bennett,14,0,32,18
1657952324290,MATH 142A,B05,093559,Chow; Bennett,7,0,32,25
1657952330318,MATH 193A,A01,083224,Rotar; Vladimir,9,0,34,25
1657952330318,MATH 193A,A02,083225,Rotar; Vladimir,11,0,34,23
1657952330318,MATH 193A,A03,083781,Rotar; Vladimir,5,0,34,29
1657952330318,MATH 193A,A04,083782,Rotar; Vladimir,12,0,34,22
1657952330318,MATH 193A,A05,093482,Rotar; Vladimir,11,0,34,23
1657952336341,MATH 197,001,091859,McAuley; Julian John,9999,0,9999,0
1657952336341,MATH 197,002,095566,Kedlaya; Kiran S.,9997,0,9999,2
1657952336341,MATH 197,003,095567,Xiao; Ming,9999,0,9999,0
1657952336341,MATH 197,004,095571,Perols; Johan Lars,9998,0,9999,1
1657952343402,COGS 9,A01,083615,Shannon; Kyle Michael,11,0,75,64
1657952349430,COGS 11,A01,083617,Boyle; Mary E. T.,23,0,48,25
1657952355457,COGS 13,A01,083071,Bastos; Amalia Pinkusfeld,12,0,71,59
1657952361483,COGS 14A,A01,092681,Semenuks; Arturs,5,1,100,95
1657952367505,COGS 14B,A01,083073,Cheng; Tzu-Han,7,0,63,56
1657952373531,COGS 17,A01,092677,Semenuks; Arturs,7,0,81,74
1657952379557,COGS 100,A01,083619,Allen; Michael Gordon,17,0,70,53
1657952385581,COGS 101A,A01,083621,Davis; Joshua Daniel,9,0,68,59
1657952391611,COGS 101B,A01,091572,Allen; Michael Gordon,14,0,65,51
1657952397634,COGS 101C,A01,083625,Delgado; Tania,17,0,35,18
1657952403672,COGS 107A,A01,083627,Boyle; Mary E. T.,14,0,60,46
1657952409713,COGS 118A,A01,083075,Gupta; Anjum,21,0,76,55
1657952415740,CSE 3,A50,083646,Miranda; Gregory Joseph,24,0,50,26
1657952421769,CSE 8A,A50,083650,Miranda; Gregory Joseph,17,1,56,39
1657952427794,CSE 11,A01,083080,Cao; Yingjun,7,15,40,33
1657952433818,CSE 12,A01,083652,Krause-Levy; Sophia Louisa,30,1,120,90
1657952439843,CSE 15L,A01,083654,Morris; Justin Loren,9,0,50,41
1657952439843,CSE 15L,A02,083655,Morris; Justin Loren,11,0,50,39
1657952445866,CSE 20,A01,083657,Tran; Khoa Dang,39,0,80,41
1657952451894,CSE 21,A01,095574,Bach; Quang Tran,23,0,48,25
1657952457922,CSE 30,A01,083084,Eldon; John,7,0,80,73
1657952457922,CSE 30,B01,095061,Bhaskar; Nishant,9,0,50,41
1657952463950,CSE 100,A01,083659,Cao; Yingjun,5,4,70,65
1657952469972,CSE 134B,A01,083661,Powell; Thomas Allan,25,0,100,75
1657952475997,CSE 140,A01,083663,Gungor; Onat,17,0,85,68
1657952482024,CSE 140L,A01,083088,Eldon; John,23,0,100,77
1657952488047,CSE 175,A01,083665,Kumar; Rakesh,3,0,25,22
1657952494072,CSE 190,A00,092507,Dubnov; Shlomo,8,0,20,12
1657952500115,ECE 45,A01,083139,Congero; Spencer William,7,0,75,68
1657952506142,ECE 65,A50,083695,Saad; Andrew S,12,0,30,18
1657952506142,ECE 65,A51,095125,Saad; Andrew S,24,0,26,2
1657952512166,ECE 109,A01,091882,Touri; Behrouz,21,0,70,49
1657952518188,ECE 180,A00,083140,Abi Samra; Nicholas Camill,1,0,30,29
1657952518188,ECE 180,B00,083141,Abi Samra; Nicholas Camill,0,0,30,30
1657952524212,MATH 10A,A01,083735,Patchell; Gregory David,2,0,30,28
1657952524212,MATH 10A,A02,083736,Patchell; Gregory David,20,0,30,10
1657952524212,MATH 10A,A03,083737,Patchell; Gregory David,16,0,30,14
1657952530239,MATH 10B,A01,083207,Lim; Seonhee,9,0,34,25
1657952530239,MATH 10B,A02,083208,Lim; Seonhee,10,0,35,25
1657952530239,MATH 10B,A03,093472,Lim; Seonhee,7,0,34,27
1657952530239,MATH 10B,B01,083739,Sinha; Shubham,14,0,30,16
1657952536270,MATH 18,A01,083743,Cinel; Cameron Alexander,9,0,30,21
1657952536270,MATH 18,A02,083744,Cinel; Cameron Alexander,18,0,30,12
1657952536270,MATH 18,A03,083745,Cinel; Cameron Alexander,10,0,30,20
1657952536270,MATH 18,B01,083748,Rideout; David Porter,5,0,37,32
1657952536270,MATH 18,B02,083749,Rideout; David Porter,5,0,36,31
1657952536270,MATH 18,B03,083750,Rideout; David Porter,3,0,37,34
1657952536270,MATH 18,B04,083751,Rideout; David Porter,7,0,36,29
1657952536270,MATH 18,B05,093473,Rideout; David Porter,7,0,36,29
1657952536270,MATH 18,B06,093474,Rideout; David Porter,6,0,36,30
1657952542298,MATH 20A,A01,083754,Zheng; Zequn,14,0,40,26
1657952548326,MATH 20B,A01,083756,Briones; Jor-el Thomas Caparas,4,0,36,32
1657952548326,MATH 20B,A02,083757,Briones; Jor-el Thomas Caparas,1,0,36,35
1657952548326,MATH 20B,A03,093475,Briones; Jor-el Thomas Caparas,3,0,36,33
1657952554422,MATH 20C,A01,083760,Briones; Jor-el Thomas Caparas,1,0,35,34
1657952554422,MATH 20C,A02,083761,Briones; Jor-el Thomas Caparas,8,0,35,27
1657952554422,MATH 20C,A03,093476,Briones; Jor-el Thomas Caparas,0,1,36,36
1657952554422,MATH 20C,B01,083762,Bach; Quang Tran,1,0,30,29
1657952560447,MATH 20D,A01,083765,Tran; Brian Kha,5,0,30,25
1657952560447,MATH 20D,A02,083766,Tran; Brian Kha,5,0,30,25
1657952560447,MATH 20D,A03,083767,Tran; Brian Kha,6,0,30,24
1657952566471,MATH 20E,A01,083771,Ganguly; Soumya,12,0,32,20
1657952566471,MATH 20E,A02,083772,Ganguly; Soumya,7,0,32,25
1657952566471,MATH 20E,B01,083773,Ciotti; Benjamin,20,0,35,15
1657952566471,MATH 20E,B02,083774,Ciotti; Benjamin,18,0,35,17
1657952572514,MATH 103A,A01,083777,Greenfeld; Be'Eri,5,0,36,31
1657952572514,MATH 103A,A02,083778,Greenfeld; Be'Eri,5,0,36,31
1657952572514,MATH 103A,A03,093561,Greenfeld; Be'Eri,7,0,36,29
1657952572514,MATH 103A,B01,083779,Greenfeld; Be'Eri,8,0,36,28
1657952572514,MATH 103A,B02,083780,Greenfeld; Be'Eri,4,0,36,32
1657952572514,MATH 103A,B03,093562,Greenfeld; Be'Eri,3,0,36,33
1657952578542,MATH 105,A01,085443,Carter; Anne Toulson,15,0,35,20
1657952578542,MATH 105,A02,093477,Carter; Anne Toulson,20,0,35,15
1657952584566,MATH 109,A01,083213,Ganzberger; Geoffrey Michael,3,0,34,31
1657952584566,MATH 109,A02,083214,Ganzberger; Geoffrey Michael,4,0,34,30
1657952584566,MATH 109,A03,093478,Ganzberger; Geoffrey Michael,2,0,34,32
1657952584566,MATH 109,B01,083215,Ganzberger; Geoffrey Michael,3,0,32,29
1657952584566,MATH 109,B02,083216,Ganzberger; Geoffrey Michael,3,0,32,29
1657952584566,MATH 109,B03,093479,Ganzberger; Geoffrey Michael,8,0,32,24
1657952590595,MATH 142A,A01,083219,Chow; Bennett,7,0,32,25
1657952590595,MATH 142A,A02,083220,Chow; Bennett,10,0,32,22
1657952590595,MATH 142A,A03,093480,Chow; Bennett,9,0,32,23
1657952590595,MATH 142A,B03,093481,Chow; Bennett,8,0,32,24
1657952590595,MATH 142A,B04,093558,Chow; Bennett,14,0,32,18
1657952590595,MATH 142A,B05,093559,Chow; Bennett,7,0,32,25
1657952596624,MATH 193A,A01,083224,Rotar; Vladimir,9,0,34,25
1657952596624,MATH 193A,A02,083225,Rotar; Vladimir,11,0,34,23
1657952596624,MATH 193A,A03,083781,Rotar; Vladimir,5,0,34,29
1657952596624,MATH 193A,A04,083782,Rotar; Vladimir,12,0,34,22
1657952596624,MATH 193A,A05,093482,Rotar; Vladimir,11,0,34,23
1657952602650,MATH 197,001,091859,McAuley; Julian John,9999,0,9999,0
1657952602650,MATH 197,002,095566,Kedlaya; Kiran S.,9997,0,9999,2
1657952602650,MATH 197,003,095567,Xiao; Ming,9999,0,9999,0
1657952602650,MATH 197,004,095571,Perols; Johan Lars,9998,0,9999,1
1657952609720,COGS 9,A01,083615,Shannon; Kyle Michael,11,0,75,64
1657952615743,COGS 11,A01,083617,Boyle; Mary E. T.,23,0,48,25
1657952621768,COGS 13,A01,083071,Bastos; Amalia Pinkusfeld,12,0,71,59
1657952627793,COGS 14A,A01,092681,Semenuks; Arturs,5,1,100,95
1657952633815,COGS 14B,A01,083073,Cheng; Tzu-Han,7,0,63,56
1657952639838,COGS 17,A01,092677,Semenuks; Arturs,7,0,81,74
1657952645862,COGS 100,A01,083619,Allen; Michael Gordon,17,0,70,53
1657952651885,COGS 101A,A01,083621,Davis; Joshua Daniel,9,0,68,59
1657952657907,COGS 101B,A01,091572,Allen; Michael Gordon,14,0,65,51
1657952663935,COGS 101C,A01,083625,Delgado; Tania,17,0,35,18
1657952669963,COGS 107A,A01,083627,Boyle; Mary E. T.,14,0,60,46
1657952675989,COGS 118A,A01,083075,Gupta; Anjum,21,0,76,55
1657952682016,CSE 3,A50,083646,Miranda; Gregory Joseph,24,0,50,26
1657952688039,CSE 8A,A50,083650,Miranda; Gregory Joseph,17,1,56,39
1657952694074,CSE 11,A01,083080,Cao; Yingjun,7,15,40,33
1657952700103,CSE 12,A01,083652,Krause-Levy; Sophia Louisa,30,1,120,90
1657952706131,CSE 15L,A01,083654,Morris; Justin Loren,9,0,50,41
1657952706131,CSE 15L,A02,083655,Morris; Justin Loren,11,0,50,39
1657952712154,CSE 20,A01,083657,Tran; Khoa Dang,39,0,80,41
1657952718176,CSE 21,A01,095574,Bach; Quang Tran,23,0,48,25
1657952724198,CSE 30,A01,083084,Eldon; John,7,0,80,73
1657952724198,CSE 30,B01,095061,Bhaskar; Nishant,9,0,50,41
1657952730222,CSE 100,A01,083659,Cao; Yingjun,5,4,70,65
1657952736246,CSE 134B,A01,083661,Powell; Thomas Allan,25,0,100,75
1657952742274,CSE 140,A01,083663,Gungor; Onat,17,0,85,68
1657952748310,CSE 140L,A01,083088,Eldon; John,23,0,100,77
1657952754337,CSE 175,A01,083665,Kumar; Rakesh,3,0,25,22
1657952760361,CSE 190,A00,092507,Dubnov; Shlomo,8,0,20,12
1657952766385,ECE 45,A01,083139,Congero; Spencer William,7,0,75,68
1657952772413,ECE 65,A50,083695,Saad; Andrew S,12,0,30,18
1657952772413,ECE 65,A51,095125,Saad; Andrew S,24,0,26,2
1657952778440,ECE 109,A01,091882,Touri; Behrouz,21,0,70,49
1657952784464,ECE 180,A00,083140,Abi Samra; Nicholas Camill,1,0,30,29
1657952784464,ECE 180,B00,083141,Abi Samra; Nicholas Camill,0,0,30,30
1657952790488,MATH 10A,A01,083735,Patchell; Gregory David,2,0,30,28
1657952790488,MATH 10A,A02,083736,Patchell; Gregory David,20,0,30,10
1657952790488,MATH 10A,A03,083737,Patchell; Gregory David,16,0,30,14
1657952796515,MATH 10B,A01,083207,Lim; Seonhee,9,0,34,25
1657952796515,MATH 10B,A02,083208,Lim; Seonhee,10,0,35,25
1657952796515,MATH 10B,A03,093472,Lim; Seonhee,7,0,34,27
1657952796515,MATH 10B,B01,083739,Sinha; Shubham,14,0,30,16
1657952802540,MATH 18,A01,083743,Cinel; Cameron Alexander,9,0,30,21
1657952802540,MATH 18,A02,083744,Cinel; Cameron Alexander,18,0,30,12
1657952802540,MATH 18,A03,083745,Cinel; Cameron Alexander,10,0,30,20
1657952802540,MATH 18,B01,083748,Rideout; David Porter,5,0,37,32
1657952802540,MATH 18,B02,083749,Rideout; David Porter,5,0,36,31
1657952802540,MATH 18,B03,083750,Rideout; David Porter,3,0,37,34
1657952802540,MATH 18,B04,083751,Rideout; David Porter,7,0,36,29
1657952802540,MATH 18,B05,093473,Rideout; David Porter,7,0,36,29
1657952802540,MATH 18,B06,093474,Rideout; David Porter,6,0,36,30
1657952808566,MATH 20A,A01,083754,Zheng; Zequn,14,0,40,26
1657952814594,MATH 20B,A01,083756,Briones; Jor-el Thomas Caparas,4,0,36,32
1657952814594,MATH 20B,A02,083757,Briones; Jor-el Thomas Caparas,1,0,36,35
1657952814594,MATH 20B,A03,093475,Briones; Jor-el Thomas Caparas,3,0,36,33
1657952820626,MATH 20C,A01,083760,Briones; Jor-el Thomas Caparas,1,0,35,34
1657952820626,MATH 20C,A02,083761,Briones; Jor-el Thomas Caparas,8,0,35,27
1657952820626,MATH 20C,A03,093476,Briones; Jor-el Thomas Caparas,0,1,36,36
1657952820626,MATH 20C,B01,083762,Bach; Quang Tran,1,0,30,29
1657952826651,MATH 20D,A01,083765,Tran; Brian Kha,5,0,30,25
1657952826651,MATH 20D,A02,083766,Tran; Brian Kha,5,0,30,25
1657952826651,MATH 20D,A03,083767,Tran; Brian Kha,6,0,30,24
1657952832678,MATH 20E,A01,083771,Ganguly; Soumya,12,0,32,20
1657952832678,MATH 20E,A02,083772,Ganguly; Soumya,7,0,32,25
1657952832678,MATH 20E,B01,083773,Ciotti; Benjamin,20,0,35,15
1657952832678,MATH 20E,B02,083774,Ciotti; Benjamin,18,0,35,17
1657952838709,MATH 103A,A01,083777,Greenfeld; Be'Eri,5,0,36,31
1657952838709,MATH 103A,A02,083778,Greenfeld; Be'Eri,5,0,36,31
1657952838709,MATH 103A,A03,093561,Greenfeld; Be'Eri,7,0,36,29
1657952838709,MATH 103A,B01,083779,Greenfeld; Be'Eri,8,0,36,28
1657952838709,MATH 103A,B02,083780,Greenfeld; Be'Eri,4,0,36,32
1657952838709,MATH 103A,B03,093562,Greenfeld; Be'Eri,3,0,36,33
1657952844736,MATH 105,A01,085443,Carter; Anne Toulson,15,0,35,20
1657952844736,MATH 105,A02,093477,Carter; Anne Toulson,20,0,35,15
1657952850764,MATH 109,A01,083213,Ganzberger; Geoffrey Michael,3,0,34,31
1657952850764,MATH 109,A02,083214,Ganzberger; Geoffrey Michael,4,0,34,30
1657952850764,MATH 109,A03,093478,Ganzberger; Geoffrey Michael,2,0,34,32
1657952850764,MATH 109,B01,083215,Ganzberger; Geoffrey Michael,3,0,32,29
1657952850764,MATH 109,B02,083216,Ganzberger; Geoffrey Michael,3,0,32,29
1657952850764,MATH 109,B03,093479,Ganzberger; Geoffrey Michael,8,0,32,24
1657952856799,MATH 142A,A01,083219,Chow; Bennett,7,0,32,25
1657952856799,MATH 142A,A02,083220,Chow; Bennett,10,0,32,22
1657952856799,MATH 142A,A03,093480,Chow; Bennett,9,0,32,23
1657952856799,MATH 142A,B03,093481,Chow; Bennett,8,0,32,24
1657952856799,MATH 142A,B04,093558,Chow; Bennett,14,0,32,18
1657952856799,MATH 142A,B05,093559,Chow; Bennett,7,0,32,25
1657952862830,MATH 193A,A01,083224,Rotar; Vladimir,9,0,34,25
1657952862830,MATH 193A,A02,083225,Rotar; Vladimir,11,0,34,23
1657952862830,MATH 193A,A03,083781,Rotar; Vladimir,5,0,34,29
1657952862830,MATH 193A,A04,083782,Rotar; Vladimir,12,0,34,22
1657952862830,MATH 193A,A05,093482,Rotar; Vladimir,11,0,34,23
1657952868858,MATH 197,001,091859,McAuley; Julian John,9999,0,9999,0
1657952868858,MATH 197,002,095566,Kedlaya; Kiran S.,9997,0,9999,2
1657952868858,MATH 197,003,095567,Xiao; Ming,9999,0,9999,0
1657952868858,MATH 197,004,095571,Perols; Johan Lars,9998,0,9999,1
1657952875914,COGS 9,A01,083615,Shannon; Kyle Michael,11,0,75,64
1657952881963,COGS 11,A01,083617,Boyle; Mary E. T.,23,0,48,25
1657952887995,COGS 13,A01,083071,Bastos; Amalia Pinkusfeld,12,0,71,59
1657952894032,COGS 14A,A01,092681,Semenuks; Arturs,5,1,100,95
1657952900054,COGS 14B,A01,083073,Cheng; Tzu-Han,7,0,63,56
1657952906090,COGS 17,A01,092677,Semenuks; Arturs,7,0,81,74
1657952912128,COGS 100,A01,083619,Allen; Michael Gordon,17,0,70,53
1657952918152,COGS 101A,A01,083621,Davis; Joshua Daniel,9,0,68,59
1657952924181,COGS 101B,A01,091572,Allen; Michael Gordon,14,0,65,51
1657952930204,COGS 101C,A01,083625,Delgado; Tania,17,0,35,18
1657952936244,COGS 107A,A01,083627,Boyle; Mary E. T.,14,0,60,46
1657952942278,COGS 118A,A01,083075,Gupta; Anjum,21,0,76,55
1657952948302,CSE 3,A50,083646,Miranda; Gregory Joseph,24,0,50,26
1657952954337,CSE 8A,A50,083650,Miranda; Gregory Joseph,17,1,56,39
1657952960362,CSE 11,A01,083080,Cao; Yingjun,7,15,40,33
1657952966386,CSE 12,A01,083652,Krause-Levy; Sophia Louisa,30,1,120,90
1657952972415,CSE 15L,A01,083654,Morris; Justin Loren,9,0,50,41
1657952972415,CSE 15L,A02,083655,Morris; Justin Loren,11,0,50,39
1657952978438,CSE 20,A01,083657,Tran; Khoa Dang,39,0,80,41
1657952984461,CSE 21,A01,095574,Bach; Quang Tran,23,0,48,25
1657952990488,CSE 30,A01,083084,Eldon; John,7,0,80,73
1657952990488,CSE 30,B01,095061,Bhaskar; Nishant,9,0,50,41
1657952996521,CSE 100,A01,083659,Cao; Yingjun,5,4,70,65
1657953002548,CSE 134B,A01,083661,Powell; Thomas Allan,25,0,100,75
1657953008574,CSE 140,A01,083663,Gungor; Onat,17,0,85,68
1657953014596,CSE 140L,A01,083088,Eldon; John,23,0,100,77
1657953020618,CSE 175,A01,083665,Kumar; Rakesh,3,0,25,22
1657953026648,CSE 190,A00,092507,Dubnov; Shlomo,8,0,20,12
1657953032672,ECE 45,A01,083139,Congero; Spencer William,7,0,75,68
1657953038698,ECE 65,A50,083695,Saad; Andrew S,12,0,30,18
1657953038698,ECE 65,A51,095125,Saad; Andrew S,24,0,26,2
1657953044724,ECE 109,A01,091882,Touri; Behrouz,21,0,70,49
1657953050748,ECE 180,A00,083140,Abi Samra; Nicholas Camill,1,0,30,29
1657953050748,ECE 180,B00,083141,Abi Samra; Nicholas Camill,0,0,30,30
1657953056776,MATH 10A,A01,083735,Patchell; Gregory David,2,0,30,28
1657953056776,MATH 10A,A02,083736,Patchell; Gregory David,20,0,30,10
1657953056776,MATH 10A,A03,083737,Patchell; Gregory David,16,0,30,14
1657953062808,MATH 10B,A01,083207,Lim; Seonhee,9,0,34,25
1657953062808,MATH 10B,A02,083208,Lim; Seonhee,10,0,35,25
1657953062808,MATH 10B,A03,093472,Lim; Seonhee,7,0,34,27
1657953062808,MATH 10B,B01,083739,Sinha; Shubham,14,0,30,16
1657953068833,MATH 18,A01,083743,Cinel; Cameron Alexander,9,0,30,21
1657953068833,MATH 18,A02,083744,Cinel; Cameron Alexander,18,0,30,12
1657953068833,MATH 18,A03,083745,Cinel; Cameron Alexander,10,0,30,20
1657953068833,MATH 18,B01,083748,Rideout; David Porter,5,0,37,32
1657953068833,MATH 18,B02,083749,Rideout; David Porter,5,0,36,31
1657953068833,MATH 18,B03,083750,Rideout; David Porter,3,0,37,34
1657953068833,MATH 18,B04,083751,Rideout; David Porter,7,0,36,29
1657953068833,MATH 18,B05,093473,Rideout; David Porter,7,0,36,29
1657953068833,MATH 18,B06,093474,Rideout; David Porter,6,0,36,30
1657953074859,MATH 20A,A01,083754,Zheng; Zequn,14,0,40,26
1657953080890,MATH 20B,A01,083756,Briones; Jor-el Thomas Caparas,4,0,36,32
1657953080890,MATH 20B,A02,083757,Briones; Jor-el Thomas Caparas,1,0,36,35
1657953080890,MATH 20B,A03,093475,Briones; Jor-el Thomas Caparas,3,0,36,33
1657953086913,MATH 20C,A01,083760,Briones; Jor-el Thomas Caparas,1,0,35,34
1657953086913,MATH 20C,A02,083761,Briones; Jor-el Thomas Caparas,8,0,35,27
1657953086913,MATH 20C,A03,093476,Briones; Jor-el Thomas Caparas,0,1,36,36
1657953086913,MATH 20C,B01,083762,Bach; Quang Tran,1,0,30,29
1657953092937,MATH 20D,A01,083765,Tran; Brian Kha,5,0,30,25
1657953092937,MATH 20D,A02,083766,Tran; Brian Kha,5,0,30,25
1657953092937,MATH 20D,A03,083767,Tran; Brian Kha,6,0,30,24
1657953098964,MATH 20E,A01,083771,Ganguly; Soumya,12,0,32,20
1657953098964,MATH 20E,A02,083772,Ganguly; Soumya,7,0,32,25
1657953098964,MATH 20E,B01,083773,Ciotti; Benjamin,20,0,35,15
1657953098964,MATH 20E,B02,083774,Ciotti; Benjamin,18,0,35,17
1657953104988,MATH 103A,A01,083777,Greenfeld; Be'Eri,5,0,36,31
1657953104988,MATH 103A,A02,083778,Greenfeld; Be'Eri,5,0,36,31
1657953104988,MATH 103A,A03,093561,Greenfeld; Be'Eri,7,0,36,29
1657953104988,MATH 103A,B01,083779,Greenfeld; Be'Eri,8,0,36,28
1657953104988,MATH 103A,B02,083780,Greenfeld; Be'Eri,4,0,36,32
1657953104988,MATH 103A,B03,093562,Greenfeld; Be'Eri,3,0,36,33
1657953111012,MATH 105,A01,085443,Carter; Anne Toulson,15,0,35,20
1657953111012,MATH 105,A02,093477,Carter; Anne Toulson,20,0,35,15
1657953117050,MATH 109,A01,083213,Ganzberger; Geoffrey Michael,3,0,34,31
1657953117050,MATH 109,A02,083214,Ganzberger; Geoffrey Michael,4,0,34,30
1657953117050,MATH 109,A03,093478,Ganzberger; Geoffrey Michael,2,0,34,32
1657953117050,MATH 109,B01,083215,Ganzberger; Geoffrey Michael,3,0,32,29
1657953117050,MATH 109,B02,083216,Ganzberger; Geoffrey Michael,3,0,32,29
1657953117050,MATH 109,B03,093479,Ganzberger; Geoffrey Michael,8,0,32,24
1657953123079,MATH 142A,A01,083219,Chow; Bennett,7,0,32,25
1657953123079,MATH 142A,A02,083220,Chow; Bennett,10,0,32,22
1657953123079,MATH 142A,A03,093480,Chow; Bennett,9,0,32,23
1657953123079,MATH 142A,B03,093481,Chow; Bennett,8,0,32,24
1657953123079,MATH 142A,B04,093558,Chow; Bennett,14,0,32,18
1657953123079,MATH 142A,B05,093559,Chow; Bennett,7,0,32,25
1657953129108,MATH 193A,A01,083224,Rotar; Vladimir,9,0,34,25
1657953129108,MATH 193A,A02,083225,Rotar; Vladimir,11,0,34,23
1657953129108,MATH 193A,A03,083781,Rotar; Vladimir,5,0,34,29
1657953129108,MATH 193A,A04,083782,Rotar; Vladimir,12,0,34,22
1657953129108,MATH 193A,A05,093482,Rotar; Vladimir,11,0,34,23
1657953135135,MATH 197,001,091859,McAuley; Julian John,9999,0,9999,0
1657953135135,MATH 197,002,095566,Kedlaya; Kiran S.,9997,0,9999,2
1657953135135,MATH 197,003,095567,Xiao; Ming,9999,0,9999,0
1657953135135,MATH 197,004,095571,Perols; Johan Lars,9998,0,9999,1
1657953142198,COGS 9,A01,083615,Shannon; Kyle Michael,11,0,75,64
1657953148298,COGS 11,A01,083617,Boyle; Mary E. T.,23,0,48,25
1657953154322,COGS 13,A01,083071,Bastos; Amalia Pinkusfeld,12,0,71,59
1657953160350,COGS 14A,A01,092681,Semenuks; Arturs,5,1,100,95
1657953166372,COGS 14B,A01,083073,Cheng; Tzu-Han,7,0,63,56
1657953172394,COGS 17,A01,092677,Semenuks; Arturs,7,0,81,74
1657953178420,COGS 100,A01,083619,Allen; Michael Gordon,17,0,70,53
1657953184445,COGS 101A,A01,083621,Davis; Joshua Daniel,9,0,68,59
1657953190469,COGS 101B,A01,091572,Allen; Michael Gordon,14,0,65,51
1657953196492,COGS 101C,A01,083625,Delgado; Tania,17,0,35,18
1657953202519,COGS 107A,A01,083627,Boyle; Mary E. T.,14,0,60,46
1657953208542,COGS 118A,A01,083075,Gupta; Anjum,21,0,76,55
1657953214569,CSE 3,A50,083646,Miranda; Gregory Joseph,24,0,50,26
1657953220591,CSE 8A,A50,083650,Miranda; Gregory Joseph,17,1,56,39
1657953226618,CSE 11,A01,083080,Cao; Yingjun,7,15,40,33
1657953232646,CSE 12,A01,083652,Krause-Levy; Sophia Louisa,30,1,120,90
1657953238669,CSE 15L,A01,083654,Morris; Justin Loren,9,0,50,41
1657953238669,CSE 15L,A02,083655,Morris; Justin Loren,11,0,50,39
1657953244693,CSE 20,A01,083657,Tran; Khoa Dang,39,0,80,41
1657953250717,CSE 21,A01,095574,Bach; Quang Tran,23,0,48,25
1657953256739,CSE 30,A01,083084,Eldon; John,7,0,80,73
1657953256739,CSE 30,B01,095061,Bhaskar; Nishant,9,0,50,41
1657953262764,CSE 100,A01,083659,Cao; Yingjun,5,4,70,65
1657953268788,CSE 134B,A01,083661,Powell; Thomas Allan,25,0,100,75
1657953274811,CSE 140,A01,083663,Gungor; Onat,17,0,85,68
1657953280835,CSE 140L,A01,083088,Eldon; John,23,0,100,77
1657953286866,CSE 175,A01,083665,Kumar; Rakesh,3,0,25,22
1657953292891,CSE 190,A00,092507,Dubnov; Shlomo,8,0,20,12
1657953298914,ECE 45,A01,083139,Congero; Spencer William,7,0,75,68
1657953304943,ECE 65,A50,083695,Saad; Andrew S,12,0,30,18
1657953304943,ECE 65,A51,095125,Saad; Andrew S,24,0,26,2
1657953310965,ECE 109,A01,091882,Touri; Behrouz,21,0,70,49
1657953316994,ECE 180,A00,083140,Abi Samra; Nicholas Camill,1,0,30,29
1657953316994,ECE 180,B00,083141,Abi Samra; Nicholas Camill,0,0,30,30
1657953323021,MATH 10A,A01,083735,Patchell; Gregory David,2,0,30,28
1657953323021,MATH 10A,A02,083736,Patchell; Gregory David,20,0,30,10
1657953323021,MATH 10A,A03,083737,Patchell; Gregory David,16,0,30,14
1657953329045,MATH 10B,A01,083207,Lim; Seonhee,9,0,34,25
1657953329045,MATH 10B,A02,083208,Lim; Seonhee,10,0,35,25
1657953329045,MATH 10B,A03,093472,Lim; Seonhee,7,0,34,27
1657953329045,MATH 10B,B01,083739,Sinha; Shubham,14,0,30,16
1657953335077,MATH 18,A01,083743,Cinel; Cameron Alexander,9,0,30,21
1657953335077,MATH 18,A02,083744,Cinel; Cameron Alexander,18,0,30,12
1657953335077,MATH 18,A03,083745,Cinel; Cameron Alexander,10,0,30,20
1657953335077,MATH 18,B01,083748,Rideout; David Porter,5,0,37,32
1657953335077,MATH 18,B02,083749,Rideout; David Porter,5,0,36,31
1657953335077,MATH 18,B03,083750,Rideout; David Porter,3,0,37,34
1657953335077,MATH 18,B04,083751,Rideout; David Porter,7,0,36,29
1657953335077,MATH 18,B05,093473,Rideout; David Porter,7,0,36,29
1657953335077,MATH 18,B06,093474,Rideout; David Porter,6,0,36,30
1657953341102,MATH 20A,A01,083754,Zheng; Zequn,14,0,40,26
1657953347127,MATH 20B,A01,083756,Briones; Jor-el Thomas Caparas,4,0,36,32
1657953347127,MATH 20B,A02,083757,Briones; Jor-el Thomas Caparas,1,0,36,35
1657953347127,MATH 20B,A03,093475,Briones; Jor-el Thomas Caparas,3,0,36,33
1657953353158,MATH 20C,A01,083760,Briones; Jor-el Thomas Caparas,1,0,35,34
1657953353158,MATH 20C,A02,083761,Briones; Jor-el Thomas Caparas,8,0,35,27
1657953353158,MATH 20C,A03,093476,Briones; Jor-el Thomas Caparas,0,1,36,36
1657953353158,MATH 20C,B01,083762,Bach; Quang Tran,1,0,30,29
1657953359195,MATH 20D,A01,083765,Tran; Brian Kha,5,0,30,25
1657953359195,MATH 20D,A02,083766,Tran; Brian Kha,5,0,30,25
1657953359195,MATH 20D,A03,083767,Tran; Brian Kha,6,0,30,24
1657953365224,MATH 20E,A01,083771,Ganguly; Soumya,12,0,32,20
1657953365224,MATH 20E,A02,083772,Ganguly; Soumya,7,0,32,25
1657953365224,MATH 20E,B01,083773,Ciotti; Benjamin,20,0,35,15
1657953365224,MATH 20E,B02,083774,Ciotti; Benjamin,18,0,35,17
1657953371247,MATH 103A,A01,083777,Greenfeld; Be'Eri,6,0,36,30
1657953371247,MATH 103A,A02,083778,Greenfeld; Be'Eri,5,0,36,31
1657953371247,MATH 103A,A03,093561,Greenfeld; Be'Eri,7,0,36,29
1657953371247,MATH 103A,B01,083779,Greenfeld; Be'Eri,8,0,36,28
1657953371247,MATH 103A,B02,083780,Greenfeld; Be'Eri,4,0,36,32
1657953371247,MATH 103A,B03,093562,Greenfeld; Be'Eri,3,0,36,33
1657953377277,MATH 105,A01,085443,Carter; Anne Toulson,15,0,35,20
1657953377277,MATH 105,A02,093477,Carter; Anne Toulson,20,0,35,15
1657953383300,MATH 109,A01,083213,Ganzberger; Geoffrey Michael,3,0,34,31
1657953383300,MATH 109,A02,083214,Ganzberger; Geoffrey Michael,4,0,34,30
1657953383300,MATH 109,A03,093478,Ganzberger; Geoffrey Michael,2,0,34,32
1657953383300,MATH 109,B01,083215,Ganzberger; Geoffrey Michael,3,0,32,29
1657953383300,MATH 109,B02,083216,Ganzberger; Geoffrey Michael,3,0,32,29
1657953383300,MATH 109,B03,093479,Ganzberger; Geoffrey Michael,8,0,32,24
1657953389330,MATH 142A,A01,083219,Chow; Bennett,7,0,32,25
1657953389330,MATH 142A,A02,083220,Chow; Bennett,10,0,32,22
1657953389330,MATH 142A,A03,093480,Chow; Bennett,9,0,32,23
1657953389330,MATH 142A,B03,093481,Chow; Bennett,8,0,32,24
1657953389330,MATH 142A,B04,093558,Chow; Bennett,14,0,32,18
1657953389330,MATH 142A,B05,093559,Chow; Bennett,7,0,32,25
1657953395360,MATH 193A,A01,083224,Rotar; Vladimir,9,0,34,25
1657953395360,MATH 193A,A02,083225,Rotar; Vladimir,11,0,34,23
1657953395360,MATH 193A,A03,083781,Rotar; Vladimir,5,0,34,29
1657953395360,MATH 193A,A04,083782,Rotar; Vladimir,12,0,34,22
1657953395360,MATH 193A,A05,093482,Rotar; Vladimir,11,0,34,23
1657953401386,MATH 197,001,091859,McAuley; Julian John,9999,0,9999,0
1657953401386,MATH 197,002,095566,Kedlaya; Kiran S.,9997,0,9999,2
1657953401386,MATH 197,003,095567,Xiao; Ming,9999,0,9999,0
1657953401386,MATH 197,004,095571,Perols; Johan Lars,9998,0,9999,1
1657953408442,COGS 9,A01,083615,Shannon; Kyle Michael,11,0,75,64
1657953414469,COGS 11,A01,083617,Boyle; Mary E. T.,23,0,48,25
1657953420501,COGS 13,A01,083071,Bastos; Amalia Pinkusfeld,12,0,71,59
1657953426524,COGS 14A,A01,092681,Semenuks; Arturs,5,1,100,95
1657953432555,COGS 14B,A01,083073,Cheng; Tzu-Han,7,0,63,56
1657953438578,COGS 17,A01,092677,Semenuks; Arturs,7,0,81,74
1657953444601,COGS 100,A01,083619,Allen; Michael Gordon,17,0,70,53
1657953450624,COGS 101A,A01,083621,Davis; Joshua Daniel,9,0,68,59
1657953456649,COGS 101B,A01,091572,Allen; Michael Gordon,14,0,65,51
1657953462677,COGS 101C,A01,083625,Delgado; Tania,17,0,35,18
1657953468703,COGS 107A,A01,083627,Boyle; Mary E. T.,14,0,60,46
1657953474726,COGS 118A,A01,083075,Gupta; Anjum,21,0,76,55
1657953480763,CSE 3,A50,083646,Miranda; Gregory Joseph,24,0,50,26
1657953486797,CSE 8A,A50,083650,Miranda; Gregory Joseph,17,1,56,39
1657953492820,CSE 11,A01,083080,Cao; Yingjun,7,15,40,33
1657953498846,CSE 12,A01,083652,Krause-Levy; Sophia Louisa,30,1,120,90
1657953504874,CSE 15L,A01,083654,Morris; Justin Loren,9,0,50,41
1657953504874,CSE 15L,A02,083655,Morris; Justin Loren,11,0,50,39
1657953510901,CSE 20,A01,083657,Tran; Khoa Dang,39,0,80,41
1657953516925,CSE 21,A01,095574,Bach; Quang Tran,23,0,48,25
1657953522952,CSE 30,A01,083084,Eldon; John,7,0,80,73
1657953522952,CSE 30,B01,095061,Bhaskar; Nishant,9,0,50,41
1657953528975,CSE 100,A01,083659,Cao; Yingjun,5,4,70,65
1657953535002,CSE 134B,A01,083661,Powell; Thomas Allan,25,0,100,75
1657953541025,CSE 140,A01,083663,Gungor; Onat,17,0,85,68
1657953547053,CSE 140L,A01,083088,Eldon; John,23,0,100,77
1657953553076,CSE 175,A01,083665,Kumar; Rakesh,3,0,25,22
1657953559103,CSE 190,A00,092507,Dubnov; Shlomo,8,0,20,12
1657953565140,ECE 45,A01,083139,Congero; Spencer William,7,0,75,68
1657953571166,ECE 65,A50,083695,Saad; Andrew S,12,0,30,18
1657953571166,ECE 65,A51,095125,Saad; Andrew S,24,0,26,2
1657953577190,ECE 109,A01,091882,Touri; Behrouz,21,0,70,49
1657953583213,ECE 180,A00,083140,Abi Samra; Nicholas Camill,1,0,30,29
1657953583213,ECE 180,B00,083141,Abi Samra; Nicholas Camill,0,0,30,30
1657953589240,MATH 10A,A01,083735,Patchell; Gregory David,2,0,30,28
1657953589240,MATH 10A,A02,083736,Patchell; Gregory David,20,0,30,10
1657953589240,MATH 10A,A03,083737,Patchell; Gregory David,16,0,30,14
1657953595266,MATH 10B,A01,083207,Lim; Seonhee,9,0,34,25
1657953595266,MATH 10B,A02,083208,Lim; Seonhee,10,0,35,25
1657953595266,MATH 10B,A03,093472,Lim; Seonhee,7,0,34,27
1657953595266,MATH 10B,B01,083739,Sinha; Shubham,14,0,30,16
1657953601298,MATH 18,A01,083743,Cinel; Cameron Alexander,9,0,30,21
1657953601298,MATH 18,A02,083744,Cinel; Cameron Alexander,18,0,30,12
1657953601298,MATH 18,A03,083745,Cinel; Cameron Alexander,10,0,30,20
1657953601298,MATH 18,B01,083748,Rideout; David Porter,5,0,37,32
1657953601298,MATH 18,B02,083749,Rideout; David Porter,5,0,36,31
1657953601298,MATH 18,B03,083750,Rideout; David Porter,3,0,37,34
1657953601298,MATH 18,B04,083751,Rideout; David Porter,7,0,36,29
1657953601298,MATH 18,B05,093473,Rideout; David Porter,7,0,36,29
1657953601298,MATH 18,B06,093474,Rideout; David Porter,6,0,36,30
1657953607323,MATH 20A,A01,083754,Zheng; Zequn,14,0,40,26
1657953613353,MATH 20B,A01,083756,Briones; Jor-el Thomas Caparas,4,0,36,32
1657953613353,MATH 20B,A02,083757,Briones; Jor-el Thomas Caparas,1,0,36,35
1657953613353,MATH 20B,A03,093475,Briones; Jor-el Thomas Caparas,3,0,36,33
1657953619383,MATH 20C,A01,083760,Briones; Jor-el Thomas Caparas,1,0,35,34
1657953619383,MATH 20C,A02,083761,Briones; Jor-el Thomas Caparas,8,0,35,27
1657953619383,MATH 20C,A03,093476,Briones; Jor-el Thomas Caparas,0,1,36,36
1657953619383,MATH 20C,B01,083762,Bach; Quang Tran,1,0,30,29
1657953625413,MATH 20D,A01,083765,Tran; Brian Kha,5,0,30,25
1657953625413,MATH 20D,A02,083766,Tran; Brian Kha,5,0,30,25
1657953625413,MATH 20D,A03,083767,Tran; Brian Kha,6,0,30,24
1657953631440,MATH 20E,A01,083771,Ganguly; Soumya,12,0,32,20
1657953631440,MATH 20E,A02,083772,Ganguly; Soumya,7,0,32,25
1657953631440,MATH 20E,B01,083773,Ciotti; Benjamin,20,0,35,15
1657953631440,MATH 20E,B02,083774,Ciotti; Benjamin,18,0,35,17
1657953637470,MATH 103A,A01,083777,Greenfeld; Be'Eri,6,0,36,30
1657953637470,MATH 103A,A02,083778,Greenfeld; Be'Eri,5,0,36,31
1657953637470,MATH 103A,A03,093561,Greenfeld; Be'Eri,7,0,36,29
1657953637470,MATH 103A,B01,083779,Greenfeld; Be'Eri,8,0,36,28
1657953637470,MATH 103A,B02,083780,Greenfeld; Be'Eri,4,0,36,32
1657953637470,MATH 103A,B03,093562,Greenfeld; Be'Eri,3,0,36,33
1657953643498,MATH 105,A01,085443,Carter; Anne Toulson,15,0,35,20
1657953643498,MATH 105,A02,093477,Carter; Anne Toulson,20,0,35,15
1657953649524,MATH 109,A01,083213,Ganzberger; Geoffrey Michael,3,0,34,31
1657953649524,MATH 109,A02,083214,Ganzberger; Geoffrey Michael,4,0,34,30
1657953649524,MATH 109,A03,093478,Ganzberger; Geoffrey Michael,2,0,34,32
1657953649524,MATH 109,B01,083215,Ganzberger; Geoffrey Michael,3,0,32,29
1657953649524,MATH 109,B02,083216,Ganzberger; Geoffrey Michael,3,0,32,29
1657953649524,MATH 109,B03,093479,Ganzberger; Geoffrey Michael,8,0,32,24
1657953655552,MATH 142A,A01,083219,Chow; Bennett,7,0,32,25
1657953655552,MATH 142A,A02,083220,Chow; Bennett,10,0,32,22
1657953655552,MATH 142A,A03,093480,Chow; Bennett,9,0,32,23
1657953655552,MATH 142A,B03,093481,Chow; Bennett,8,0,32,24
1657953655552,MATH 142A,B04,093558,Chow; Bennett,14,0,32,18
1657953655552,MATH 142A,B05,093559,Chow; Bennett,7,0,32,25
1657953661583,MATH 193A,A01,083224,Rotar; Vladimir,9,0,34,25
1657953661583,MATH 193A,A02,083225,Rotar; Vladimir,11,0,34,23
1657953661583,MATH 193A,A03,083781,Rotar; Vladimir,5,0,34,29
1657953661583,MATH 193A,A04,083782,Rotar; Vladimir,12,0,34,22
1657953661583,MATH 193A,A05,093482,Rotar; Vladimir,11,0,34,23
1657953667607,MATH 197,001,091859,McAuley; Julian John,9999,0,9999,0
1657953667607,MATH 197,002,095566,Kedlaya; Kiran S.,9997,0,9999,2
1657953667607,MATH 197,003,095567,Xiao; Ming,9999,0,9999,0
1657953667607,MATH 197,004,095571,Perols; Johan Lars,9998,0,9999,1
1657953674668,COGS 9,A01,083615,Shannon; Kyle Michael,11,0,75,64
1657953680691,COGS 11,A01,083617,Boyle; Mary E. T.,23,0,48,25
1657953686714,COGS 13,A01,083071,Bastos; Amalia Pinkusfeld,12,0,71,59
1657953692736,COGS 14A,A01,092681,Semenuks; Arturs,5,1,100,95
1657953698772,COGS 14B,A01,083073,Cheng; Tzu-Han,7,0,63,56
1657953704795,COGS 17,A01,092677,Semenuks; Arturs,7,0,81,74
1657953710822,COGS 100,A01,083619,Allen; Michael Gordon,17,0,70,53
1657953716845,COGS 101A,A01,083621,Davis; Joshua Daniel,9,0,68,59
1657953722871,COGS 101B,A01,091572,Allen; Michael Gordon,14,0,65,51
1657953728894,COGS 101C,A01,083625,Delgado; Tania,17,0,35,18
1657953734922,COGS 107A,A01,083627,Boyle; Mary E. T.,14,0,60,46
1657953740945,COGS 118A,A01,083075,Gupta; Anjum,21,0,76,55
1657953747050,CSE 3,A50,083646,Miranda; Gregory Joseph,24,0,50,26
1657953753074,CSE 8A,A50,083650,Miranda; Gregory Joseph,17,1,56,39
1657953759102,CSE 11,A01,083080,Cao; Yingjun,7,15,40,33
1657953765139,CSE 12,A01,083652,Krause-Levy; Sophia Louisa,30,1,120,90
1657953771162,CSE 15L,A01,083654,Morris; Justin Loren,9,0,50,41
1657953771162,CSE 15L,A02,083655,Morris; Justin Loren,11,0,50,39
1657953777190,CSE 20,A01,083657,Tran; Khoa Dang,39,0,80,41
1657953783212,CSE 21,A01,095574,Bach; Quang Tran,23,0,48,25
1657953789238,CSE 30,A01,083084,Eldon; John,7,0,80,73
1657953789238,CSE 30,B01,095061,Bhaskar; Nishant,9,0,50,41
1657953795260,CSE 100,A01,083659,Cao; Yingjun,5,4,70,65
1657953801283,CSE 134B,A01,083661,Powell; Thomas Allan,25,0,100,75
1657953807307,CSE 140,A01,083663,Gungor; Onat,17,0,85,68
1657953813331,CSE 140L,A01,083088,Eldon; John,23,0,100,77
1657953819356,CSE 175,A01,083665,Kumar; Rakesh,3,0,25,22
1657953825380,CSE 190,A00,092507,Dubnov; Shlomo,8,0,20,12
1657953831403,ECE 45,A01,083139,Congero; Spencer William,7,0,75,68
1657953837427,ECE 65,A50,083695,Saad; Andrew S,12,0,30,18
1657953837427,ECE 65,A51,095125,Saad; Andrew S,24,0,26,2
1657953843455,ECE 109,A01,091882,Touri; Behrouz,21,0,70,49
1657953849479,ECE 180,A00,083140,Abi Samra; Nicholas Camill,1,0,30,29
1657953849479,ECE 180,B00,083141,Abi Samra; Nicholas Camill,0,0,30,30
1657953855501,MATH 10A,A01,083735,Patchell; Gregory David,2,0,30,28
1657953855501,MATH 10A,A02,083736,Patchell; Gregory David,20,0,30,10
1657953855501,MATH 10A,A03,083737,Patchell; Gregory David,16,0,30,14
1657953861526,MATH 10B,A01,083207,Lim; Seonhee,9,0,34,25
1657953861526,MATH 10B,A02,083208,Lim; Seonhee,10,0,35,25
1657953861526,MATH 10B,A03,093472,Lim; Seonhee,7,0,34,27
1657953861526,MATH 10B,B01,083739,Sinha; Shubham,14,0,30,16
1657953867549,MATH 18,A01,083743,Cinel; Cameron Alexander,9,0,30,21
1657953867549,MATH 18,A02,083744,Cinel; Cameron Alexander,18,0,30,12
1657953867549,MATH 18,A03,083745,Cinel; Cameron Alexander,10,0,30,20
1657953867549,MATH 18,B01,083748,Rideout; David Porter,5,0,37,32
1657953867549,MATH 18,B02,083749,Rideout; David Porter,5,0,36,31
1657953867549,MATH 18,B03,083750,Rideout; David Porter,3,0,37,34
1657953867549,MATH 18,B04,083751,Rideout; David Porter,7,0,36,29
1657953867549,MATH 18,B05,093473,Rideout; David Porter,7,0,36,29
1657953867549,MATH 18,B06,093474,Rideout; David Porter,6,0,36,30
1657953873575,MATH 20A,A01,083754,Zheng; Zequn,14,0,40,26
1657953879602,MATH 20B,A01,083756,Briones; Jor-el Thomas Caparas,4,0,36,32
1657953879602,MATH 20B,A02,083757,Briones; Jor-el Thomas Caparas,1,0,36,35
1657953879602,MATH 20B,A03,093475,Briones; Jor-el Thomas Caparas,3,0,36,33
1657953885630,MATH 20C,A01,083760,Briones; Jor-el Thomas Caparas,1,0,35,34
1657953885630,MATH 20C,A02,083761,Briones; Jor-el Thomas Caparas,8,0,35,27
1657953885630,MATH 20C,A03,093476,Briones; Jor-el Thomas Caparas,0,1,36,36
1657953885630,MATH 20C,B01,083762,Bach; Quang Tran,1,0,30,29
1657953891655,MATH 20D,A01,083765,Tran; Brian Kha,5,0,30,25
1657953891655,MATH 20D,A02,083766,Tran; Brian Kha,5,0,30,25
1657953891655,MATH 20D,A03,083767,Tran; Brian Kha,6,0,30,24
1657953897684,MATH 20E,A01,083771,Ganguly; Soumya,12,0,32,20
1657953897684,MATH 20E,A02,083772,Ganguly; Soumya,7,0,32,25
1657953897684,MATH 20E,B01,083773,Ciotti; Benjamin,20,0,35,15
1657953897684,MATH 20E,B02,083774,Ciotti; Benjamin,18,0,35,17
1657953903714,MATH 103A,A01,083777,Greenfeld; Be'Eri,6,0,36,30
1657953903714,MATH 103A,A02,083778,Greenfeld; Be'Eri,5,0,36,31
1657953903714,MATH 103A,A03,093561,Greenfeld; Be'Eri,7,0,36,29
1657953903714,MATH 103A,B01,083779,Greenfeld; Be'Eri,8,0,36,28
1657953903714,MATH 103A,B02,083780,Greenfeld; Be'Eri,4,0,36,32
1657953903714,MATH 103A,B03,093562,Greenfeld; Be'Eri,3,0,36,33
1657953909739,MATH 105,A01,085443,Carter; Anne Toulson,15,0,35,20
1657953909739,MATH 105,A02,093477,Carter; Anne Toulson,20,0,35,15
1657953915770,MATH 109,A01,083213,Ganzberger; Geoffrey Michael,3,0,34,31
1657953915770,MATH 109,A02,083214,Ganzberger; Geoffrey Michael,4,0,34,30
1657953915770,MATH 109,A03,093478,Ganzberger; Geoffrey Michael,2,0,34,32
1657953915770,MATH 109,B01,083215,Ganzberger; Geoffrey Michael,3,0,32,29
1657953915770,MATH 109,B02,083216,Ganzberger; Geoffrey Michael,3,0,32,29
1657953915770,MATH 109,B03,093479,Ganzberger; Geoffrey Michael,8,0,32,24
1657953921794,MATH 142A,A01,083219,Chow; Bennett,7,0,32,25
1657953921794,MATH 142A,A02,083220,Chow; Bennett,10,0,32,22
1657953921794,MATH 142A,A03,093480,Chow; Bennett,9,0,32,23
1657953921794,MATH 142A,B03,093481,Chow; Bennett,8,0,32,24
1657953921794,MATH 142A,B04,093558,Chow; Bennett,14,0,32,18
1657953921794,MATH 142A,B05,093559,Chow; Bennett,7,0,32,25
1657953927817,MATH 193A,A01,083224,Rotar; Vladimir,9,0,34,25
1657953927817,MATH 193A,A02,083225,Rotar; Vladimir,11,0,34,23
1657953927817,MATH 193A,A03,083781,Rotar; Vladimir,5,0,34,29
1657953927817,MATH 193A,A04,083782,Rotar; Vladimir,12,0,34,22
1657953927817,MATH 193A,A05,093482,Rotar; Vladimir,11,0,34,23
1657953933839,MATH 197,001,091859,McAuley; Julian John,9999,0,9999,0
1657953933839,MATH 197,002,095566,Kedlaya; Kiran S.,9997,0,9999,2
1657953933839,MATH 197,003,095567,Xiao; Ming,9999,0,9999,0
1657953933839,MATH 197,004,095571,Perols; Johan Lars,9998,0,9999,1
1657953940895,COGS 9,A01,083615,Shannon; Kyle Michael,11,0,75,64
1657953946921,COGS 11,A01,083617,Boyle; Mary E. T.,23,0,48,25
1657953952949,COGS 13,A01,083071,Bastos; Amalia Pinkusfeld,12,0,71,59
1657953958976,COGS 14A,A01,092681,Semenuks; Arturs,5,1,100,95
1657953965000,COGS 14B,A01,083073,Cheng; Tzu-Han,7,0,63,56
1657953971027,COGS 17,A01,092677,Semenuks; Arturs,7,0,81,74
1657953977053,COGS 100,A01,083619,Allen; Michael Gordon,17,0,70,53
1657953983082,COGS 101A,A01,083621,Davis; Joshua Daniel,9,0,68,59
1657953989106,COGS 101B,A01,091572,Allen; Michael Gordon,14,0,65,51
1657953995135,COGS 101C,A01,083625,Delgado; Tania,17,0,35,18
1657954001159,COGS 107A,A01,083627,Boyle; Mary E. T.,14,0,60,46
1657954007185,COGS 118A,A01,083075,Gupta; Anjum,21,0,76,55
1657954013210,CSE 3,A50,083646,Miranda; Gregory Joseph,24,0,50,26
1657954019234,CSE 8A,A50,083650,Miranda; Gregory Joseph,17,1,56,39
1657954025259,CSE 11,A01,083080,Cao; Yingjun,7,15,40,33
1657954031283,CSE 12,A01,083652,Krause-Levy; Sophia Louisa,30,1,120,90
1657954037310,CSE 15L,A01,083654,Morris; Justin Loren,9,0,50,41
1657954037310,CSE 15L,A02,083655,Morris; Justin Loren,11,0,50,39
1657954043337,CSE 20,A01,083657,Tran; Khoa Dang,39,0,80,41
1657954049364,CSE 21,A01,095574,Bach; Quang Tran,23,0,48,25
1657954055392,CSE 30,A01,083084,Eldon; John,8,0,80,72
1657954055392,CSE 30,B01,095061,Bhaskar; Nishant,9,0,50,41
1657954061416,CSE 100,A01,083659,Cao; Yingjun,5,4,70,65
1657954067437,CSE 134B,A01,083661,Powell; Thomas Allan,25,0,100,75
1657954073464,CSE 140,A01,083663,Gungor; Onat,17,0,85,68
1657954079488,CSE 140L,A01,083088,Eldon; John,23,0,100,77
1657954085514,CSE 175,A01,083665,Kumar; Rakesh,3,0,25,22
1657954091536,CSE 190,A00,092507,Dubnov; Shlomo,8,0,20,12
1657954097560,ECE 45,A01,083139,Congero; Spencer William,7,0,75,68
1657954103584,ECE 65,A50,083695,Saad; Andrew S,12,0,30,18
1657954103584,ECE 65,A51,095125,Saad; Andrew S,24,0,26,2
1657954109610,ECE 109,A01,091882,Touri; Behrouz,21,0,70,49
1657954115633,ECE 180,A00,083140,Abi Samra; Nicholas Camill,1,0,30,29
1657954115633,ECE 180,B00,083141,Abi Samra; Nicholas Camill,0,0,30,30
1657954121661,MATH 10A,A01,083735,Patchell; Gregory David,2,0,30,28
1657954121661,MATH 10A,A02,083736,Patchell; Gregory David,20,0,30,10
1657954121661,MATH 10A,A03,083737,Patchell; Gregory David,16,0,30,14
1657954127689,MATH 10B,A01,083207,Lim; Seonhee,9,0,34,25
1657954127689,MATH 10B,A02,083208,Lim; Seonhee,10,0,35,25
1657954127689,MATH 10B,A03,093472,Lim; Seonhee,7,0,34,27
1657954127689,MATH 10B,B01,083739,Sinha; Shubham,14,0,30,16
1657954133713,MATH 18,A01,083743,Cinel; Cameron Alexander,9,0,30,21
1657954133713,MATH 18,A02,083744,Cinel; Cameron Alexander,18,0,30,12
1657954133713,MATH 18,A03,083745,Cinel; Cameron Alexander,10,0,30,20
1657954133713,MATH 18,B01,083748,Rideout; David Porter,5,0,37,32
1657954133713,MATH 18,B02,083749,Rideout; David Porter,5,0,36,31
1657954133713,MATH 18,B03,083750,Rideout; David Porter,3,0,37,34
1657954133713,MATH 18,B04,083751,Rideout; David Porter,7,0,36,29
1657954133713,MATH 18,B05,093473,Rideout; David Porter,7,0,36,29
1657954133713,MATH 18,B06,093474,Rideout; David Porter,6,0,36,30
1657954139739,MATH 20A,A01,083754,Zheng; Zequn,14,0,40,26
1657954145769,MATH 20B,A01,083756,Briones; Jor-el Thomas Caparas,4,0,36,32
1657954145769,MATH 20B,A02,083757,Briones; Jor-el Thomas Caparas,1,0,36,35
1657954145769,MATH 20B,A03,093475,Briones; Jor-el Thomas Caparas,3,0,36,33
1657954151793,MATH 20C,A01,083760,Briones; Jor-el Thomas Caparas,1,0,35,34
1657954151793,MATH 20C,A02,083761,Briones; Jor-el Thomas Caparas,8,0,35,27
1657954151793,MATH 20C,A03,093476,Briones; Jor-el Thomas Caparas,0,1,36,36
1657954151793,MATH 20C,B01,083762,Bach; Quang Tran,1,0,30,29
1657954157824,MATH 20D,A01,083765,Tran; Brian Kha,5,0,30,25
1657954157824,MATH 20D,A02,083766,Tran; Brian Kha,5,0,30,25
1657954157824,MATH 20D,A03,083767,Tran; Brian Kha,6,0,30,24
1657954163852,MATH 20E,A01,083771,Ganguly; Soumya,12,0,32,20
1657954163852,MATH 20E,A02,083772,Ganguly; Soumya,7,0,32,25
1657954163852,MATH 20E,B01,083773,Ciotti; Benjamin,20,0,35,15
1657954163852,MATH 20E,B02,083774,Ciotti; Benjamin,18,0,35,17
1657954169881,MATH 103A,A01,083777,Greenfeld; Be'Eri,6,0,36,30
1657954169881,MATH 103A,A02,083778,Greenfeld; Be'Eri,5,0,36,31
1657954169881,MATH 103A,A03,093561,Greenfeld; Be'Eri,7,0,36,29
1657954169881,MATH 103A,B01,083779,Greenfeld; Be'Eri,8,0,36,28
1657954169881,MATH 103A,B02,083780,Greenfeld; Be'Eri,4,0,36,32
1657954169881,MATH 103A,B03,093562,Greenfeld; Be'Eri,3,0,36,33
1657954175904,MATH 105,A01,085443,Carter; Anne Toulson,15,0,35,20
1657954175904,MATH 105,A02,093477,Carter; Anne Toulson,20,0,35,15
1657954181927,MATH 109,A01,083213,Ganzberger; Geoffrey Michael,3,0,34,31
1657954181927,MATH 109,A02,083214,Ganzberger; Geoffrey Michael,4,0,34,30
1657954181927,MATH 109,A03,093478,Ganzberger; Geoffrey Michael,2,0,34,32
1657954181927,MATH 109,B01,083215,Ganzberger; Geoffrey Michael,3,0,32,29
1657954181927,MATH 109,B02,083216,Ganzberger; Geoffrey Michael,3,0,32,29
1657954181927,MATH 109,B03,093479,Ganzberger; Geoffrey Michael,8,0,32,24
1657954187951,MATH 142A,A01,083219,Chow; Bennett,7,0,32,25
1657954187951,MATH 142A,A02,083220,Chow; Bennett,10,0,32,22
1657954187951,MATH 142A,A03,093480,Chow; Bennett,9,0,32,23
1657954187951,MATH 142A,B03,093481,Chow; Bennett,8,0,32,24
1657954187951,MATH 142A,B04,093558,Chow; Bennett,14,0,32,18
1657954187951,MATH 142A,B05,093559,Chow; Bennett,7,0,32,25
1657954193981,MATH 193A,A01,083224,Rotar; Vladimir,9,0,34,25
1657954193981,MATH 193A,A02,083225,Rotar; Vladimir,11,0,34,23
1657954193981,MATH 193A,A03,083781,Rotar; Vladimir,5,0,34,29
1657954193981,MATH 193A,A04,083782,Rotar; Vladimir,12,0,34,22
1657954193981,MATH 193A,A05,093482,Rotar; Vladimir,11,0,34,23
1657954200005,MATH 197,001,091859,McAuley; Julian John,9999,0,9999,0
1657954200005,MATH 197,002,095566,Kedlaya; Kiran S.,9997,0,9999,2
1657954200005,MATH 197,003,095567,Xiao; Ming,9999,0,9999,0
1657954200005,MATH 197,004,095571,Perols; Johan Lars,9998,0,9999,1
1657954207056,COGS 9,A01,083615,Shannon; Kyle Michael,11,0,75,64
1657954213080,COGS 11,A01,083617,Boyle; Mary E. T.,23,0,48,25
1657954219105,COGS 13,A01,083071,Bastos; Amalia Pinkusfeld,12,0,71,59
1657954225132,COGS 14A,A01,092681,Semenuks; Arturs,5,1,100,95
1657954231155,COGS 14B,A01,083073,Cheng; Tzu-Han,7,0,63,56
1657954237178,COGS 17,A01,092677,Semenuks; Arturs,7,0,81,74
1657954243202,COGS 100,A01,083619,Allen; Michael Gordon,17,0,70,53
1657954249225,COGS 101A,A01,083621,Davis; Joshua Daniel,9,0,68,59
1657954255252,COGS 101B,A01,091572,Allen; Michael Gordon,14,0,65,51
1657954261280,COGS 101C,A01,083625,Delgado; Tania,17,0,35,18
1657954267307,COGS 107A,A01,083627,Boyle; Mary E. T.,14,0,60,46
1657954273332,COGS 118A,A01,083075,Gupta; Anjum,21,0,76,55
1657954279360,CSE 3,A50,083646,Miranda; Gregory Joseph,24,0,50,26
1657954285383,CSE 8A,A50,083650,Miranda; Gregory Joseph,17,1,56,39
1657954291406,CSE 11,A01,083080,Cao; Yingjun,7,15,40,33
1657954297429,CSE 12,A01,083652,Krause-Levy; Sophia Louisa,30,1,120,90
1657954303456,CSE 15L,A01,083654,Morris; Justin Loren,9,0,50,41
1657954303456,CSE 15L,A02,083655,Morris; Justin Loren,11,0,50,39
1657954309482,CSE 20,A01,083657,Tran; Khoa Dang,39,0,80,41
1657954315506,CSE 21,A01,095574,Bach; Quang Tran,23,0,48,25
1657954321530,CSE 30,A01,083084,Eldon; John,8,0,80,72
1657954321530,CSE 30,B01,095061,Bhaskar; Nishant,9,0,50,41
1657954327557,CSE 100,A01,083659,Cao; Yingjun,5,4,70,65
1657954333588,CSE 134B,A01,083661,Powell; Thomas Allan,25,0,100,75
1657954339612,CSE 140,A01,083663,Gungor; Onat,17,0,85,68
1657954345725,CSE 140L,A01,083088,Eldon; John,23,0,100,77
1657954351747,CSE 175,A01,083665,Kumar; Rakesh,3,0,25,22
1657954357773,CSE 190,A00,092507,Dubnov; Shlomo,8,0,20,12
1657954363799,ECE 45,A01,083139,Congero; Spencer William,7,0,75,68
1657954369823,ECE 65,A50,083695,Saad; Andrew S,12,0,30,18
1657954369823,ECE 65,A51,095125,Saad; Andrew S,24,0,26,2
1657954375846,ECE 109,A01,091882,Touri; Behrouz,21,0,70,49
1657954381869,ECE 180,A00,083140,Abi Samra; Nicholas Camill,1,0,30,29
1657954381869,ECE 180,B00,083141,Abi Samra; Nicholas Camill,0,0,30,30
1657954387892,MATH 10A,A01,083735,Patchell; Gregory David,2,0,30,28
1657954387892,MATH 10A,A02,083736,Patchell; Gregory David,20,0,30,10
1657954387892,MATH 10A,A03,083737,Patchell; Gregory David,16,0,30,14
1657954393914,MATH 10B,A01,083207,Lim; Seonhee,9,0,34,25
1657954393914,MATH 10B,A02,083208,Lim; Seonhee,10,0,35,25
1657954393914,MATH 10B,A03,093472,Lim; Seonhee,7,0,34,27
1657954393914,MATH 10B,B01,083739,Sinha; Shubham,14,0,30,16
1657954399939,MATH 18,A01,083743,Cinel; Cameron Alexander,9,0,30,21
1657954399939,MATH 18,A02,083744,Cinel; Cameron Alexander,18,0,30,12
1657954399939,MATH 18,A03,083745,Cinel; Cameron Alexander,10,0,30,20
1657954399939,MATH 18,B01,083748,Rideout; David Porter,5,0,37,32
1657954399939,MATH 18,B02,083749,Rideout; David Porter,5,0,36,31
1657954399939,MATH 18,B03,083750,Rideout; David Porter,3,0,37,34
1657954399939,MATH 18,B04,083751,Rideout; David Porter,7,0,36,29
1657954399939,MATH 18,B05,093473,Rideout; David Porter,7,0,36,29
1657954399939,MATH 18,B06,093474,Rideout; David Porter,6,0,36,30
1657954405966,MATH 20A,A01,083754,Zheng; Zequn,14,0,40,26
1657954411989,MATH 20B,A01,083756,Briones; Jor-el Thomas Caparas,4,0,36,32
1657954411989,MATH 20B,A02,083757,Briones; Jor-el Thomas Caparas,1,0,36,35
1657954411989,MATH 20B,A03,093475,Briones; Jor-el Thomas Caparas,3,0,36,33
1657954418019,MATH 20C,A01,083760,Briones; Jor-el Thomas Caparas,1,0,35,34
1657954418019,MATH 20C,A02,083761,Briones; Jor-el Thomas Caparas,8,0,35,27
1657954418019,MATH 20C,A03,093476,Briones; Jor-el Thomas Caparas,0,1,36,36
1657954418019,MATH 20C,B01,083762,Bach; Quang Tran,1,0,30,29
1657954424046,MATH 20D,A01,083765,Tran; Brian Kha,5,0,30,25
1657954424046,MATH 20D,A02,083766,Tran; Brian Kha,5,0,30,25
1657954424046,MATH 20D,A03,083767,Tran; Brian Kha,6,0,30,24
1657954430069,MATH 20E,A01,083771,Ganguly; Soumya,12,0,32,20
1657954430069,MATH 20E,A02,083772,Ganguly; Soumya,7,0,32,25
1657954430069,MATH 20E,B01,083773,Ciotti; Benjamin,20,0,35,15
1657954430069,MATH 20E,B02,083774,Ciotti; Benjamin,18,0,35,17
1657954436094,MATH 103A,A01,083777,Greenfeld; Be'Eri,6,0,36,30
1657954436094,MATH 103A,A02,083778,Greenfeld; Be'Eri,5,0,36,31
1657954436094,MATH 103A,A03,093561,Greenfeld; Be'Eri,7,0,36,29
1657954436094,MATH 103A,B01,083779,Greenfeld; Be'Eri,8,0,36,28
1657954436094,MATH 103A,B02,083780,Greenfeld; Be'Eri,4,0,36,32
1657954436094,MATH 103A,B03,093562,Greenfeld; Be'Eri,3,0,36,33
1657954442116,MATH 105,A01,085443,Carter; Anne Toulson,15,0,35,20
1657954442116,MATH 105,A02,093477,Carter; Anne Toulson,20,0,35,15
1657954448145,MATH 109,A01,083213,Ganzberger; Geoffrey Michael,3,0,34,31
1657954448145,MATH 109,A02,083214,Ganzberger; Geoffrey Michael,4,0,34,30
1657954448145,MATH 109,A03,093478,Ganzberger; Geoffrey Michael,2,0,34,32
1657954448145,MATH 109,B01,083215,Ganzberger; Geoffrey Michael,3,0,32,29
1657954448145,MATH 109,B02,083216,Ganzberger; Geoffrey Michael,3,0,32,29
1657954448145,MATH 109,B03,093479,Ganzberger; Geoffrey Michael,8,0,32,24
1657954454170,MATH 142A,A01,083219,Chow; Bennett,7,0,32,25
1657954454170,MATH 142A,A02,083220,Chow; Bennett,10,0,32,22
1657954454170,MATH 142A,A03,093480,Chow; Bennett,9,0,32,23
1657954454170,MATH 142A,B03,093481,Chow; Bennett,8,0,32,24
1657954454170,MATH 142A,B04,093558,Chow; Bennett,14,0,32,18
1657954454170,MATH 142A,B05,093559,Chow; Bennett,7,0,32,25
1657954460193,MATH 193A,A01,083224,Rotar; Vladimir,9,0,34,25
1657954460193,MATH 193A,A02,083225,Rotar; Vladimir,11,0,34,23
1657954460193,MATH 193A,A03,083781,Rotar; Vladimir,5,0,34,29
1657954460193,MATH 193A,A04,083782,Rotar; Vladimir,12,0,34,22
1657954460193,MATH 193A,A05,093482,Rotar; Vladimir,11,0,34,23
1657954466218,MATH 197,001,091859,McAuley; Julian John,9999,0,9999,0
1657954466218,MATH 197,002,095566,Kedlaya; Kiran S.,9997,0,9999,2
1657954466218,MATH 197,003,095567,Xiao; Ming,9999,0,9999,0
1657954466218,MATH 197,004,095571,Perols; Johan Lars,9998,0,9999,1
1657954473283,COGS 9,A01,083615,Shannon; Kyle Michael,11,0,75,64
1657954479307,COGS 11,A01,083617,Boyle; Mary E. T.,23,0,48,25
1657954485330,COGS 13,A01,083071,Bastos; Amalia Pinkusfeld,12,0,71,59
1657954491356,COGS 14A,A01,092681,Semenuks; Arturs,5,1,100,95
1657954497382,COGS 14B,A01,083073,Cheng; Tzu-Han,7,0,63,56
1657954503408,COGS 17,A01,092677,Semenuks; Arturs,7,0,81,74
1657954509432,COGS 100,A01,083619,Allen; Michael Gordon,17,0,70,53
1657954515453,COGS 101A,A01,083621,Davis; Joshua Daniel,9,0,68,59
1657954521476,COGS 101B,A01,091572,Allen; Michael Gordon,14,0,65,51
1657954527499,COGS 101C,A01,083625,Delgado; Tania,17,0,35,18
1657954533522,COGS 107A,A01,083627,Boyle; Mary E. T.,14,0,60,46
1657954539549,COGS 118A,A01,083075,Gupta; Anjum,21,0,76,55
1657954545573,CSE 3,A50,083646,Miranda; Gregory Joseph,24,0,50,26
1657954551601,CSE 8A,A50,083650,Miranda; Gregory Joseph,17,1,56,39
1657954557623,CSE 11,A01,083080,Cao; Yingjun,7,15,40,33
1657954563647,CSE 12,A01,083652,Krause-Levy; Sophia Louisa,30,1,120,90
1657954569673,CSE 15L,A01,083654,Morris; Justin Loren,9,0,50,41
1657954569673,CSE 15L,A02,083655,Morris; Justin Loren,11,0,50,39
1657954575697,CSE 20,A01,083657,Tran; Khoa Dang,39,0,80,41
1657954581724,CSE 21,A01,095574,Bach; Quang Tran,23,0,48,25
1657954587746,CSE 30,A01,083084,Eldon; John,8,0,80,72
1657954587746,CSE 30,B01,095061,Bhaskar; Nishant,9,0,50,41
1657954593769,CSE 100,A01,083659,Cao; Yingjun,5,4,70,65
1657954599791,CSE 134B,A01,083661,Powell; Thomas Allan,25,0,100,75
1657954605818,CSE 140,A01,083663,Gungor; Onat,17,0,85,68
1657954611844,CSE 140L,A01,083088,Eldon; John,23,0,100,77
1657954617867,CSE 175,A01,083665,Kumar; Rakesh,3,0,25,22
1657954623894,CSE 190,A00,092507,Dubnov; Shlomo,8,0,20,12
1657954629919,ECE 45,A01,083139,Congero; Spencer William,7,0,75,68
1657954635942,ECE 65,A50,083695,Saad; Andrew S,12,0,30,18
1657954635942,ECE 65,A51,095125,Saad; Andrew S,24,0,26,2
1657954641965,ECE 109,A01,091882,Touri; Behrouz,21,0,70,49
1657954647991,ECE 180,A00,083140,Abi Samra; Nicholas Camill,1,0,30,29
1657954647991,ECE 180,B00,083141,Abi Samra; Nicholas Camill,0,0,30,30
1657954654021,MATH 10A,A01,083735,Patchell; Gregory David,2,0,30,28
1657954654021,MATH 10A,A02,083736,Patchell; Gregory David,20,0,30,10
1657954654021,MATH 10A,A03,083737,Patchell; Gregory David,16,0,30,14
1657954660050,MATH 10B,A01,083207,Lim; Seonhee,9,0,34,25
1657954660050,MATH 10B,A02,083208,Lim; Seonhee,10,0,35,25
1657954660050,MATH 10B,A03,093472,Lim; Seonhee,7,0,34,27
1657954660050,MATH 10B,B01,083739,Sinha; Shubham,14,0,30,16
1657954666083,MATH 18,A01,083743,Cinel; Cameron Alexander,9,0,30,21
1657954666083,MATH 18,A02,083744,Cinel; Cameron Alexander,18,0,30,12
1657954666083,MATH 18,A03,083745,Cinel; Cameron Alexander,10,0,30,20
1657954666083,MATH 18,B01,083748,Rideout; David Porter,5,0,37,32
1657954666083,MATH 18,B02,083749,Rideout; David Porter,5,0,36,31
1657954666083,MATH 18,B03,083750,Rideout; David Porter,3,0,37,34
1657954666083,MATH 18,B04,083751,Rideout; David Porter,7,0,36,29
1657954666083,MATH 18,B05,093473,Rideout; David Porter,7,0,36,29
1657954666083,MATH 18,B06,093474,Rideout; David Porter,6,0,36,30
1657954672107,MATH 20A,A01,083754,Zheng; Zequn,14,0,40,26
1657954678132,MATH 20B,A01,083756,Briones; Jor-el Thomas Caparas,4,0,36,32
1657954678132,MATH 20B,A02,083757,Briones; Jor-el Thomas Caparas,1,0,36,35
1657954678132,MATH 20B,A03,093475,Briones; Jor-el Thomas Caparas,3,0,36,33
1657954684157,MATH 20C,A01,083760,Briones; Jor-el Thomas Caparas,1,0,35,34
1657954684157,MATH 20C,A02,083761,Briones; Jor-el Thomas Caparas,8,0,35,27
1657954684157,MATH 20C,A03,093476,Briones; Jor-el Thomas Caparas,0,1,36,36
1657954684157,MATH 20C,B01,083762,Bach; Quang Tran,1,0,30,29
1657954690184,MATH 20D,A01,083765,Tran; Brian Kha,5,0,30,25
1657954690184,MATH 20D,A02,083766,Tran; Brian Kha,5,0,30,25
1657954690184,MATH 20D,A03,083767,Tran; Brian Kha,6,0,30,24
1657954696217,MATH 20E,A01,083771,Ganguly; Soumya,12,0,32,20
1657954696217,MATH 20E,A02,083772,Ganguly; Soumya,7,0,32,25
1657954696217,MATH 20E,B01,083773,Ciotti; Benjamin,20,0,35,15
1657954696217,MATH 20E,B02,083774,Ciotti; Benjamin,18,0,35,17
1657954702246,MATH 103A,A01,083777,Greenfeld; Be'Eri,6,0,36,30
1657954702246,MATH 103A,A02,083778,Greenfeld; Be'Eri,5,0,36,31
1657954702246,MATH 103A,A03,093561,Greenfeld; Be'Eri,7,0,36,29
1657954702246,MATH 103A,B01,083779,Greenfeld; Be'Eri,8,0,36,28
1657954702246,MATH 103A,B02,083780,Greenfeld; Be'Eri,4,0,36,32
1657954702246,MATH 103A,B03,093562,Greenfeld; Be'Eri,3,0,36,33
1657954708270,MATH 105,A01,085443,Carter; Anne Toulson,15,0,35,20
1657954708270,MATH 105,A02,093477,Carter; Anne Toulson,20,0,35,15
1657954714294,MATH 109,A01,083213,Ganzberger; Geoffrey Michael,3,0,34,31
1657954714294,MATH 109,A02,083214,Ganzberger; Geoffrey Michael,4,0,34,30
1657954714294,MATH 109,A03,093478,Ganzberger; Geoffrey Michael,2,0,34,32
1657954714294,MATH 109,B01,083215,Ganzberger; Geoffrey Michael,3,0,32,29
1657954714294,MATH 109,B02,083216,Ganzberger; Geoffrey Michael,3,0,32,29
1657954714294,MATH 109,B03,093479,Ganzberger; Geoffrey Michael,8,0,32,24
1657954720324,MATH 142A,A01,083219,Chow; Bennett,7,0,32,25
1657954720324,MATH 142A,A02,083220,Chow; Bennett,10,0,32,22
1657954720324,MATH 142A,A03,093480,Chow; Bennett,9,0,32,23
1657954720324,MATH 142A,B03,093481,Chow; Bennett,8,0,32,24
1657954720324,MATH 142A,B04,093558,Chow; Bennett,14,0,32,18
1657954720324,MATH 142A,B05,093559,Chow; Bennett,7,0,32,25
1657954726349,MATH 193A,A01,083224,Rotar; Vladimir,9,0,34,25
1657954726349,MATH 193A,A02,083225,Rotar; Vladimir,11,0,34,23
1657954726349,MATH 193A,A03,083781,Rotar; Vladimir,5,0,34,29
1657954726349,MATH 193A,A04,083782,Rotar; Vladimir,12,0,34,22
1657954726349,MATH 193A,A05,093482,Rotar; Vladimir,11,0,34,23
1657954732375,MATH 197,001,091859,McAuley; Julian John,9999,0,9999,0
1657954732375,MATH 197,002,095566,Kedlaya; Kiran S.,9997,0,9999,2
1657954732375,MATH 197,003,095567,Xiao; Ming,9999,0,9999,0
1657954732375,MATH 197,004,095571,Perols; Johan Lars,9998,0,9999,1
1657954739436,COGS 9,A01,083615,Shannon; Kyle Michael,11,0,75,64
1657954745463,COGS 11,A01,083617,Boyle; Mary E. T.,23,0,48,25
1657954751487,COGS 13,A01,083071,Bastos; Amalia Pinkusfeld,12,0,71,59
1657954757513,COGS 14A,A01,092681,Semenuks; Arturs,5,1,100,95
1657954763541,COGS 14B,A01,083073,Cheng; Tzu-Han,7,0,63,56
1657954769569,COGS 17,A01,092677,Semenuks; Arturs,7,0,81,74
1657954775593,COGS 100,A01,083619,Allen; Michael Gordon,17,0,70,53
1657954781617,COGS 101A,A01,083621,Davis; Joshua Daniel,9,0,68,59
1657954787640,COGS 101B,A01,091572,Allen; Michael Gordon,14,0,65,51
1657954793664,COGS 101C,A01,083625,Delgado; Tania,17,0,35,18
1657954799693,COGS 107A,A01,083627,Boyle; Mary E. T.,14,0,60,46
1657954805716,COGS 118A,A01,083075,Gupta; Anjum,21,0,76,55
1657954811746,CSE 3,A50,083646,Miranda; Gregory Joseph,24,0,50,26
1657954817769,CSE 8A,A50,083650,Miranda; Gregory Joseph,17,1,56,39
1657954823792,CSE 11,A01,083080,Cao; Yingjun,7,15,40,33
1657954829825,CSE 12,A01,083652,Krause-Levy; Sophia Louisa,30,1,120,90
1657954835852,CSE 15L,A01,083654,Morris; Justin Loren,9,0,50,41
1657954835852,CSE 15L,A02,083655,Morris; Justin Loren,11,0,50,39
1657954841878,CSE 20,A01,083657,Tran; Khoa Dang,39,0,80,41
1657954847900,CSE 21,A01,095574,Bach; Quang Tran,23,0,48,25
1657954853924,CSE 30,A01,083084,Eldon; John,8,0,80,72
1657954853924,CSE 30,B01,095061,Bhaskar; Nishant,9,0,50,41
1657954859951,CSE 100,A01,083659,Cao; Yingjun,5,4,70,65
1657954865981,CSE 134B,A01,083661,Powell; Thomas Allan,25,0,100,75
1657954872013,CSE 140,A01,083663,Gungor; Onat,17,0,85,68
1657954878035,CSE 140L,A01,083088,Eldon; John,23,0,100,77
1657954884058,CSE 175,A01,083665,Kumar; Rakesh,3,0,25,22
1657954890087,CSE 190,A00,092507,Dubnov; Shlomo,8,0,20,12
1657954896110,ECE 45,A01,083139,Congero; Spencer William,7,0,75,68
1657954902133,ECE 65,A50,083695,Saad; Andrew S,12,0,30,18
1657954902133,ECE 65,A51,095125,Saad; Andrew S,24,0,26,2
1657954908157,ECE 109,A01,091882,Touri; Behrouz,21,0,70,49
1657954914181,ECE 180,A00,083140,Abi Samra; Nicholas Camill,1,0,30,29
1657954914181,ECE 180,B00,083141,Abi Samra; Nicholas Camill,0,0,30,30
1657954920206,MATH 10A,A01,083735,Patchell; Gregory David,2,0,30,28
1657954920206,MATH 10A,A02,083736,Patchell; Gregory David,20,0,30,10
1657954920206,MATH 10A,A03,083737,Patchell; Gregory David,16,0,30,14
1657954926247,MATH 10B,A01,083207,Lim; Seonhee,9,0,34,25
1657954926247,MATH 10B,A02,083208,Lim; Seonhee,10,0,35,25
1657954926247,MATH 10B,A03,093472,Lim; Seonhee,7,0,34,27
1657954926247,MATH 10B,B01,083739,Sinha; Shubham,14,0,30,16
1657954932272,MATH 18,A01,083743,Cinel; Cameron Alexander,9,0,30,21
1657954932272,MATH 18,A02,083744,Cinel; Cameron Alexander,18,0,30,12
1657954932272,MATH 18,A03,083745,Cinel; Cameron Alexander,10,0,30,20
1657954932272,MATH 18,B01,083748,Rideout; David Porter,5,0,37,32
1657954932272,MATH 18,B02,083749,Rideout; David Porter,5,0,36,31
1657954932272,MATH 18,B03,083750,Rideout; David Porter,3,0,37,34
1657954932272,MATH 18,B04,083751,Rideout; David Porter,7,0,36,29
1657954932272,MATH 18,B05,093473,Rideout; David Porter,7,0,36,29
1657954932272,MATH 18,B06,093474,Rideout; David Porter,6,0,36,30
1657954938321,MATH 20A,A01,083754,Zheng; Zequn,14,0,40,26
1657954944440,MATH 20B,A01,083756,Briones; Jor-el Thomas Caparas,4,0,36,32
1657954944440,MATH 20B,A02,083757,Briones; Jor-el Thomas Caparas,1,0,36,35
1657954944440,MATH 20B,A03,093475,Briones; Jor-el Thomas Caparas,3,0,36,33
1657954950466,MATH 20C,A01,083760,Briones; Jor-el Thomas Caparas,1,0,35,34
1657954950466,MATH 20C,A02,083761,Briones; Jor-el Thomas Caparas,8,0,35,27
1657954950466,MATH 20C,A03,093476,Briones; Jor-el Thomas Caparas,0,1,36,36
1657954950466,MATH 20C,B01,083762,Bach; Quang Tran,1,0,30,29
1657954956491,MATH 20D,A01,083765,Tran; Brian Kha,5,0,30,25
1657954956491,MATH 20D,A02,083766,Tran; Brian Kha,5,0,30,25
1657954956491,MATH 20D,A03,083767,Tran; Brian Kha,6,0,30,24
1657954962516,MATH 20E,A01,083771,Ganguly; Soumya,12,0,32,20
1657954962516,MATH 20E,A02,083772,Ganguly; Soumya,7,0,32,25
1657954962516,MATH 20E,B01,083773,Ciotti; Benjamin,20,0,35,15
1657954962516,MATH 20E,B02,083774,Ciotti; Benjamin,18,0,35,17
1657954968541,MATH 103A,A01,083777,Greenfeld; Be'Eri,6,0,36,30
1657954968541,MATH 103A,A02,083778,Greenfeld; Be'Eri,5,0,36,31
1657954968541,MATH 103A,A03,093561,Greenfeld; Be'Eri,7,0,36,29
1657954968541,MATH 103A,B01,083779,Greenfeld; Be'Eri,8,0,36,28
1657954968541,MATH 103A,B02,083780,Greenfeld; Be'Eri,4,0,36,32
1657954968541,MATH 103A,B03,093562,Greenfeld; Be'Eri,3,0,36,33
1657954974567,MATH 105,A01,085443,Carter; Anne Toulson,15,0,35,20
1657954974567,MATH 105,A02,093477,Carter; Anne Toulson,20,0,35,15
1657954980592,MATH 109,A01,083213,Ganzberger; Geoffrey Michael,3,0,34,31
1657954980592,MATH 109,A02,083214,Ganzberger; Geoffrey Michael,4,0,34,30
1657954980592,MATH 109,A03,093478,Ganzberger; Geoffrey Michael,2,0,34,32
1657954980592,MATH 109,B01,083215,Ganzberger; Geoffrey Michael,3,0,32,29
1657954980592,MATH 109,B02,083216,Ganzberger; Geoffrey Michael,3,0,32,29
1657954980592,MATH 109,B03,093479,Ganzberger; Geoffrey Michael,8,0,32,24
1657954986626,MATH 142A,A01,083219,Chow; Bennett,7,0,32,25
1657954986626,MATH 142A,A02,083220,Chow; Bennett,10,0,32,22
1657954986626,MATH 142A,A03,093480,Chow; Bennett,9,0,32,23
1657954986626,MATH 142A,B03,093481,Chow; Bennett,8,0,32,24
1657954986626,MATH 142A,B04,093558,Chow; Bennett,14,0,32,18
1657954986626,MATH 142A,B05,093559,Chow; Bennett,7,0,32,25
1657954992663,MATH 193A,A01,083224,Rotar; Vladimir,9,0,34,25
1657954992663,MATH 193A,A02,083225,Rotar; Vladimir,11,0,34,23
1657954992663,MATH 193A,A03,083781,Rotar; Vladimir,5,0,34,29
1657954992663,MATH 193A,A04,083782,Rotar; Vladimir,12,0,34,22
1657954992663,MATH 193A,A05,093482,Rotar; Vladimir,11,0,34,23
1657954998685,MATH 197,001,091859,McAuley; Julian John,9999,0,9999,0
1657954998685,MATH 197,002,095566,Kedlaya; Kiran S.,9997,0,9999,2
1657954998685,MATH 197,003,095567,Xiao; Ming,9999,0,9999,0
1657954998685,MATH 197,004,095571,Perols; Johan Lars,9998,0,9999,1
1657955005754,COGS 9,A01,083615,Shannon; Kyle Michael,11,0,75,64
1657955011776,COGS 11,A01,083617,Boyle; Mary E. T.,23,0,48,25
1657955017799,COGS 13,A01,083071,Bastos; Amalia Pinkusfeld,12,0,71,59
1657955023821,COGS 14A,A01,092681,Semenuks; Arturs,5,1,100,95
1657955029844,COGS 14B,A01,083073,Cheng; Tzu-Han,7,0,63,56
1657955035867,COGS 17,A01,092677,Semenuks; Arturs,7,0,81,74
1657955041891,COGS 100,A01,083619,Allen; Michael Gordon,17,0,70,53
1657955047915,COGS 101A,A01,083621,Davis; Joshua Daniel,9,0,68,59
1657955053940,COGS 101B,A01,091572,Allen; Michael Gordon,14,0,65,51
1657955059967,COGS 101C,A01,083625,Delgado; Tania,17,0,35,18
1657955065991,COGS 107A,A01,083627,Boyle; Mary E. T.,14,0,60,46
1657955072018,COGS 118A,A01,083075,Gupta; Anjum,21,0,76,55
1657955078042,CSE 3,A50,083646,Miranda; Gregory Joseph,24,0,50,26
1657955084070,CSE 8A,A50,083650,Miranda; Gregory Joseph,17,1,56,39
1657955090094,CSE 11,A01,083080,Cao; Yingjun,7,15,40,33
1657955096124,CSE 12,A01,083652,Krause-Levy; Sophia Louisa,30,1,120,90
1657955102148,CSE 15L,A01,083654,Morris; Justin Loren,9,0,50,41
1657955102148,CSE 15L,A02,083655,Morris; Justin Loren,11,0,50,39
1657955108170,CSE 20,A01,083657,Tran; Khoa Dang,39,0,80,41
1657955114198,CSE 21,A01,095574,Bach; Quang Tran,23,0,48,25
1657955120226,CSE 30,A01,083084,Eldon; John,8,0,80,72
1657955120226,CSE 30,B01,095061,Bhaskar; Nishant,9,0,50,41
1657955126252,CSE 100,A01,083659,Cao; Yingjun,5,4,70,65
1657955132276,CSE 134B,A01,083661,Powell; Thomas Allan,25,0,100,75
1657955138303,CSE 140,A01,083663,Gungor; Onat,17,0,85,68
1657955144333,CSE 140L,A01,083088,Eldon; John,23,0,100,77
1657955150361,CSE 175,A01,083665,Kumar; Rakesh,3,0,25,22
1657955156390,CSE 190,A00,092507,Dubnov; Shlomo,8,0,20,12
1657955162415,ECE 45,A01,083139,Congero; Spencer William,7,0,75,68
1657955168439,ECE 65,A50,083695,Saad; Andrew S,12,0,30,18
1657955168439,ECE 65,A51,095125,Saad; Andrew S,24,0,26,2
1657955174465,ECE 109,A01,091882,Touri; Behrouz,21,0,70,49
1657955180487,ECE 180,A00,083140,Abi Samra; Nicholas Camill,1,0,30,29
1657955180487,ECE 180,B00,083141,Abi Samra; Nicholas Camill,0,0,30,30
1657955186511,MATH 10A,A01,083735,Patchell; Gregory David,2,0,30,28
1657955186511,MATH 10A,A02,083736,Patchell; Gregory David,20,0,30,10
1657955186511,MATH 10A,A03,083737,Patchell; Gregory David,16,0,30,14
1657955192537,MATH 10B,A01,083207,Lim; Seonhee,9,0,34,25
1657955192537,MATH 10B,A02,083208,Lim; Seonhee,10,0,35,25
1657955192537,MATH 10B,A03,093472,Lim; Seonhee,7,0,34,27
1657955192537,MATH 10B,B01,083739,Sinha; Shubham,14,0,30,16
1657955198570,MATH 18,A01,083743,Cinel; Cameron Alexander,9,0,30,21
1657955198570,MATH 18,A02,083744,Cinel; Cameron Alexander,18,0,30,12
1657955198570,MATH 18,A03,083745,Cinel; Cameron Alexander,10,0,30,20
1657955198570,MATH 18,B01,083748,Rideout; David Porter,5,0,37,32
1657955198570,MATH 18,B02,083749,Rideout; David Porter,5,0,36,31
1657955198570,MATH 18,B03,083750,Rideout; David Porter,3,0,37,34
1657955198570,MATH 18,B04,083751,Rideout; David Porter,7,0,36,29
1657955198570,MATH 18,B05,093473,Rideout; David Porter,7,0,36,29
1657955198570,MATH 18,B06,093474,Rideout; David Porter,6,0,36,30
1657955204592,MATH 20A,A01,083754,Zheng; Zequn,14,0,40,26
1657955210621,MATH 20B,A01,083756,Briones; Jor-el Thomas Caparas,4,0,36,32
1657955210621,MATH 20B,A02,083757,Briones; Jor-el Thomas Caparas,1,0,36,35
1657955210621,MATH 20B,A03,093475,Briones; Jor-el Thomas Caparas,3,0,36,33
1657955216644,MATH 20C,A01,083760,Briones; Jor-el Thomas Caparas,1,0,35,34
1657955216644,MATH 20C,A02,083761,Briones; Jor-el Thomas Caparas,8,0,35,27
1657955216644,MATH 20C,A03,093476,Briones; Jor-el Thomas Caparas,0,1,36,36
1657955216644,MATH 20C,B01,083762,Bach; Quang Tran,1,0,30,29
1657955222669,MATH 20D,A01,083765,Tran; Brian Kha,5,0,30,25
1657955222669,MATH 20D,A02,083766,Tran; Brian Kha,5,0,30,25
1657955222669,MATH 20D,A03,083767,Tran; Brian Kha,6,0,30,24
1657955228700,MATH 20E,A01,083771,Ganguly; Soumya,12,0,32,20
1657955228700,MATH 20E,A02,083772,Ganguly; Soumya,7,0,32,25
1657955228700,MATH 20E,B01,083773,Ciotti; Benjamin,20,0,35,15
1657955228700,MATH 20E,B02,083774,Ciotti; Benjamin,18,0,35,17
1657955234731,MATH 103A,A01,083777,Greenfeld; Be'Eri,6,0,36,30
1657955234731,MATH 103A,A02,083778,Greenfeld; Be'Eri,5,0,36,31
1657955234731,MATH 103A,A03,093561,Greenfeld; Be'Eri,7,0,36,29
1657955234731,MATH 103A,B01,083779,Greenfeld; Be'Eri,8,0,36,28
1657955234731,MATH 103A,B02,083780,Greenfeld; Be'Eri,4,0,36,32
1657955234731,MATH 103A,B03,093562,Greenfeld; Be'Eri,3,0,36,33
1657955240754,MATH 105,A01,085443,Carter; Anne Toulson,15,0,35,20
1657955240754,MATH 105,A02,093477,Carter; Anne Toulson,20,0,35,15
1657955246778,MATH 109,A01,083213,Ganzberger; Geoffrey Michael,3,0,34,31
1657955246778,MATH 109,A02,083214,Ganzberger; Geoffrey Michael,4,0,34,30
1657955246778,MATH 109,A03,093478,Ganzberger; Geoffrey Michael,2,0,34,32
1657955246778,MATH 109,B01,083215,Ganzberger; Geoffrey Michael,3,0,32,29
1657955246778,MATH 109,B02,083216,Ganzberger; Geoffrey Michael,3,0,32,29
1657955246778,MATH 109,B03,093479,Ganzberger; Geoffrey Michael,8,0,32,24
1657955252803,MATH 142A,A01,083219,Chow; Bennett,7,0,32,25
1657955252803,MATH 142A,A02,083220,Chow; Bennett,10,0,32,22
1657955252803,MATH 142A,A03,093480,Chow; Bennett,9,0,32,23
1657955252803,MATH 142A,B03,093481,Chow; Bennett,8,0,32,24
1657955252803,MATH 142A,B04,093558,Chow; Bennett,14,0,32,18
1657955252803,MATH 142A,B05,093559,Chow; Bennett,7,0,32,25
1657955258834,MATH 193A,A01,083224,Rotar; Vladimir,9,0,34,25
1657955258834,MATH 193A,A02,083225,Rotar; Vladimir,11,0,34,23
1657955258834,MATH 193A,A03,083781,Rotar; Vladimir,5,0,34,29
1657955258834,MATH 193A,A04,083782,Rotar; Vladimir,12,0,34,22
1657955258834,MATH 193A,A05,093482,Rotar; Vladimir,11,0,34,23
1657955264858,MATH 197,001,091859,McAuley; Julian John,9999,0,9999,0
1657955264858,MATH 197,002,095566,Kedlaya; Kiran S.,9997,0,9999,2
1657955264858,MATH 197,003,095567,Xiao; Ming,9999,0,9999,0
1657955264858,MATH 197,004,095571,Perols; Johan Lars,9998,0,9999,1
1657955271912,COGS 9,A01,083615,Shannon; Kyle Michael,11,0,75,64
1657955277936,COGS 11,A01,083617,Boyle; Mary E. T.,23,0,48,25
1657955283963,COGS 13,A01,083071,Bastos; Amalia Pinkusfeld,12,0,71,59
1657955289991,COGS 14A,A01,092681,Semenuks; Arturs,5,1,100,95
1657955296020,COGS 14B,A01,083073,Cheng; Tzu-Han,7,0,63,56
1657955302054,COGS 17,A01,092677,Semenuks; Arturs,7,0,81,74
1657955308082,COGS 100,A01,083619,Allen; Michael Gordon,17,0,70,53
1657955314106,COGS 101A,A01,083621,Davis; Joshua Daniel,9,0,68,59
1657955320129,COGS 101B,A01,091572,Allen; Michael Gordon,14,0,65,51
1657955326152,COGS 101C,A01,083625,Delgado; Tania,17,0,35,18
1657955332179,COGS 107A,A01,083627,Boyle; Mary E. T.,14,0,60,46
1657955338206,COGS 118A,A01,083075,Gupta; Anjum,21,0,76,55
1657955344231,CSE 3,A50,083646,Miranda; Gregory Joseph,24,0,50,26
1657955350254,CSE 8A,A50,083650,Miranda; Gregory Joseph,17,1,56,39
1657955356281,CSE 11,A01,083080,Cao; Yingjun,7,15,40,33
1657955362310,CSE 12,A01,083652,Krause-Levy; Sophia Louisa,30,1,120,90
1657955368333,CSE 15L,A01,083654,Morris; Justin Loren,9,0,50,41
1657955368333,CSE 15L,A02,083655,Morris; Justin Loren,11,0,50,39
1657955374362,CSE 20,A01,083657,Tran; Khoa Dang,39,0,80,41
1657955380386,CSE 21,A01,095574,Bach; Quang Tran,23,0,48,25
1657955386415,CSE 30,A01,083084,Eldon; John,8,0,80,72
1657955386415,CSE 30,B01,095061,Bhaskar; Nishant,9,0,50,41
1657955392438,CSE 100,A01,083659,Cao; Yingjun,5,4,70,65
1657955398461,CSE 134B,A01,083661,Powell; Thomas Allan,25,0,100,75
1657955404486,CSE 140,A01,083663,Gungor; Onat,17,0,85,68
1657955410513,CSE 140L,A01,083088,Eldon; John,23,0,100,77
1657955416539,CSE 175,A01,083665,Kumar; Rakesh,3,0,25,22
1657955422570,CSE 190,A00,092507,Dubnov; Shlomo,8,0,20,12
1657955428592,ECE 45,A01,083139,Congero; Spencer William,7,0,75,68
1657955434614,ECE 65,A50,083695,Saad; Andrew S,12,0,30,18
1657955434614,ECE 65,A51,095125,Saad; Andrew S,24,0,26,2
1657955440636,ECE 109,A01,091882,Touri; Behrouz,21,0,70,49
1657955446663,ECE 180,A00,083140,Abi Samra; Nicholas Camill,1,0,30,29
1657955446663,ECE 180,B00,083141,Abi Samra; Nicholas Camill,0,0,30,30
1657955452688,MATH 10A,A01,083735,Patchell; Gregory David,2,0,30,28
1657955452688,MATH 10A,A02,083736,Patchell; Gregory David,20,0,30,10
1657955452688,MATH 10A,A03,083737,Patchell; Gregory David,16,0,30,14
1657955458718,MATH 10B,A01,083207,Lim; Seonhee,9,0,34,25
1657955458718,MATH 10B,A02,083208,Lim; Seonhee,10,0,35,25
1657955458718,MATH 10B,A03,093472,Lim; Seonhee,7,0,34,27
1657955458718,MATH 10B,B01,083739,Sinha; Shubham,14,0,30,16
1657955464790,MATH 18,A01,083743,Cinel; Cameron Alexander,9,0,30,21
1657955464790,MATH 18,A02,083744,Cinel; Cameron Alexander,18,0,30,12
1657955464790,MATH 18,A03,083745,Cinel; Cameron Alexander,10,0,30,20
1657955464790,MATH 18,B01,083748,Rideout; David Porter,5,0,37,32
1657955464790,MATH 18,B02,083749,Rideout; David Porter,5,0,36,31
1657955464790,MATH 18,B03,083750,Rideout; David Porter,3,0,37,34
1657955464790,MATH 18,B04,083751,Rideout; David Porter,7,0,36,29
1657955464790,MATH 18,B05,093473,Rideout; David Porter,7,0,36,29
1657955464790,MATH 18,B06,093474,Rideout; David Porter,6,0,36,30
1657955470821,MATH 20A,A01,083754,Zheng; Zequn,14,0,40,26
1657955476863,MATH 20B,A01,083756,Briones; Jor-el Thomas Caparas,4,0,36,32
1657955476863,MATH 20B,A02,083757,Briones; Jor-el Thomas Caparas,1,0,36,35
1657955476863,MATH 20B,A03,093475,Briones; Jor-el Thomas Caparas,3,0,36,33
1657955482886,MATH 20C,A01,083760,Briones; Jor-el Thomas Caparas,1,0,35,34
1657955482886,MATH 20C,A02,083761,Briones; Jor-el Thomas Caparas,8,0,35,27
1657955482886,MATH 20C,A03,093476,Briones; Jor-el Thomas Caparas,0,1,36,36
1657955482886,MATH 20C,B01,083762,Bach; Quang Tran,1,0,30,29
1657955488911,MATH 20D,A01,083765,Tran; Brian Kha,5,0,30,25
1657955488911,MATH 20D,A02,083766,Tran; Brian Kha,5,0,30,25
1657955488911,MATH 20D,A03,083767,Tran; Brian Kha,6,0,30,24
1657955494942,MATH 20E,A01,083771,Ganguly; Soumya,12,0,32,20
1657955494942,MATH 20E,A02,083772,Ganguly; Soumya,7,0,32,25
1657955494942,MATH 20E,B01,083773,Ciotti; Benjamin,20,0,35,15
1657955494942,MATH 20E,B02,083774,Ciotti; Benjamin,18,0,35,17
1657955500975,MATH 103A,A01,083777,Greenfeld; Be'Eri,6,0,36,30
1657955500975,MATH 103A,A02,083778,Greenfeld; Be'Eri,5,0,36,31
1657955500975,MATH 103A,A03,093561,Greenfeld; Be'Eri,7,0,36,29
1657955500975,MATH 103A,B01,083779,Greenfeld; Be'Eri,8,0,36,28
1657955500975,MATH 103A,B02,083780,Greenfeld; Be'Eri,4,0,36,32
1657955500975,MATH 103A,B03,093562,Greenfeld; Be'Eri,3,0,36,33
1657955507005,MATH 105,A01,085443,Carter; Anne Toulson,15,0,35,20
1657955507005,MATH 105,A02,093477,Carter; Anne Toulson,20,0,35,15
1657955513031,MATH 109,A01,083213,Ganzberger; Geoffrey Michael,3,0,34,31
1657955513031,MATH 109,A02,083214,Ganzberger; Geoffrey Michael,4,0,34,30
1657955513031,MATH 109,A03,093478,Ganzberger; Geoffrey Michael,2,0,34,32
1657955513031,MATH 109,B01,083215,Ganzberger; Geoffrey Michael,3,0,32,29
1657955513031,MATH 109,B02,083216,Ganzberger; Geoffrey Michael,3,0,32,29
1657955513031,MATH 109,B03,093479,Ganzberger; Geoffrey Michael,8,0,32,24
1657955519069,MATH 142A,A01,083219,Chow; Bennett,7,0,32,25
1657955519069,MATH 142A,A02,083220,Chow; Bennett,10,0,32,22
1657955519069,MATH 142A,A03,093480,Chow; Bennett,9,0,32,23
1657955519069,MATH 142A,B03,093481,Chow; Bennett,8,0,32,24
1657955519069,MATH 142A,B04,093558,Chow; Bennett,14,0,32,18
1657955519069,MATH 142A,B05,093559,Chow; Bennett,7,0,32,25
1657955525103,MATH 193A,A01,083224,Rotar; Vladimir,9,0,34,25
1657955525103,MATH 193A,A02,083225,Rotar; Vladimir,11,0,34,23
1657955525103,MATH 193A,A03,083781,Rotar; Vladimir,5,0,34,29
1657955525103,MATH 193A,A04,083782,Rotar; Vladimir,12,0,34,22
1657955525103,MATH 193A,A05,093482,Rotar; Vladimir,11,0,34,23
1657955531128,MATH 197,001,091859,McAuley; Julian John,9999,0,9999,0
1657955531128,MATH 197,002,095566,Kedlaya; Kiran S.,9997,0,9999,2
1657955531128,MATH 197,003,095567,Xiao; Ming,9999,0,9999,0
1657955531128,MATH 197,004,095571,Perols; Johan Lars,9998,0,9999,1
1657955538292,COGS 9,A01,083615,Shannon; Kyle Michael,11,0,75,64
1657955544321,COGS 11,A01,083617,Boyle; Mary E. T.,23,0,48,25
1657955550348,COGS 13,A01,083071,Bastos; Amalia Pinkusfeld,12,0,71,59
1657955556386,COGS 14A,A01,092681,Semenuks; Arturs,5,1,100,95
1657955562411,COGS 14B,A01,083073,Cheng; Tzu-Han,7,0,63,56
1657955568436,COGS 17,A01,092677,Semenuks; Arturs,7,0,81,74
1657955574464,COGS 100,A01,083619,Allen; Michael Gordon,17,0,70,53
1657955580494,COGS 101A,A01,083621,Davis; Joshua Daniel,9,0,68,59
1657955586518,COGS 101B,A01,091572,Allen; Michael Gordon,14,0,65,51
1657955592548,COGS 101C,A01,083625,Delgado; Tania,17,0,35,18
1657955598573,COGS 107A,A01,083627,Boyle; Mary E. T.,14,0,60,46
1657955604603,COGS 118A,A01,083075,Gupta; Anjum,21,0,76,55
1657955610628,CSE 3,A50,083646,Miranda; Gregory Joseph,24,0,50,26
1657955616657,CSE 8A,A50,083650,Miranda; Gregory Joseph,17,1,56,39
1657955622682,CSE 11,A01,083080,Cao; Yingjun,7,15,40,33
1657955628711,CSE 12,A01,083652,Krause-Levy; Sophia Louisa,30,1,120,90
1657955634735,CSE 15L,A01,083654,Morris; Justin Loren,9,0,50,41
1657955634735,CSE 15L,A02,083655,Morris; Justin Loren,11,0,50,39
1657955640760,CSE 20,A01,083657,Tran; Khoa Dang,39,0,80,41
1657955646784,CSE 21,A01,095574,Bach; Quang Tran,23,0,48,25
1657955652814,CSE 30,A01,083084,Eldon; John,8,0,80,72
1657955652814,CSE 30,B01,095061,Bhaskar; Nishant,9,0,50,41
1657955658836,CSE 100,A01,083659,Cao; Yingjun,5,4,70,65
1657955664860,CSE 134B,A01,083661,Powell; Thomas Allan,25,0,100,75
1657955670888,CSE 140,A01,083663,Gungor; Onat,17,0,85,68
1657955676923,CSE 140L,A01,083088,Eldon; John,23,0,100,77
1657955682952,CSE 175,A01,083665,Kumar; Rakesh,3,0,25,22
1657955688975,CSE 190,A00,092507,Dubnov; Shlomo,8,0,20,12
1657955694999,ECE 45,A01,083139,Congero; Spencer William,7,0,75,68
1657955701033,ECE 65,A50,083695,Saad; Andrew S,12,0,30,18
1657955701033,ECE 65,A51,095125,Saad; Andrew S,24,0,26,2
1657955707066,ECE 109,A01,091882,Touri; Behrouz,21,0,70,49
1657955713089,ECE 180,A00,083140,Abi Samra; Nicholas Camill,1,0,30,29
1657955713089,ECE 180,B00,083141,Abi Samra; Nicholas Camill,0,0,30,30
1657955719112,MATH 10A,A01,083735,Patchell; Gregory David,2,0,30,28
1657955719112,MATH 10A,A02,083736,Patchell; Gregory David,20,0,30,10
1657955719112,MATH 10A,A03,083737,Patchell; Gregory David,16,0,30,14
1657955725138,MATH 10B,A01,083207,Lim; Seonhee,9,0,34,25
1657955725138,MATH 10B,A02,083208,Lim; Seonhee,10,0,35,25
1657955725138,MATH 10B,A03,093472,Lim; Seonhee,7,0,34,27
1657955725138,MATH 10B,B01,083739,Sinha; Shubham,14,0,30,16
1657955731164,MATH 18,A01,083743,Cinel; Cameron Alexander,9,0,30,21
1657955731164,MATH 18,A02,083744,Cinel; Cameron Alexander,18,0,30,12
1657955731164,MATH 18,A03,083745,Cinel; Cameron Alexander,10,0,30,20
1657955731164,MATH 18,B01,083748,Rideout; David Porter,5,0,37,32
1657955731164,MATH 18,B02,083749,Rideout; David Porter,5,0,36,31
1657955731164,MATH 18,B03,083750,Rideout; David Porter,3,0,37,34
1657955731164,MATH 18,B04,083751,Rideout; David Porter,7,0,36,29
1657955731164,MATH 18,B05,093473,Rideout; David Porter,7,0,36,29
1657955731164,MATH 18,B06,093474,Rideout; David Porter,6,0,36,30
1657955737195,MATH 20A,A01,083754,Zheng; Zequn,14,0,40,26
1657955743219,MATH 20B,A01,083756,Briones; Jor-el Thomas Caparas,4,0,36,32
1657955743219,MATH 20B,A02,083757,Briones; Jor-el Thomas Caparas,1,0,36,35
1657955743219,MATH 20B,A03,093475,Briones; Jor-el Thomas Caparas,3,0,36,33
1657955749253,MATH 20C,A01,083760,Briones; Jor-el Thomas Caparas,1,0,35,34
1657955749253,MATH 20C,A02,083761,Briones; Jor-el Thomas Caparas,8,0,35,27
1657955749253,MATH 20C,A03,093476,Briones; Jor-el Thomas Caparas,0,1,36,36
1657955749253,MATH 20C,B01,083762,Bach; Quang Tran,1,0,30,29
1657955755279,MATH 20D,A01,083765,Tran; Brian Kha,5,0,30,25
1657955755279,MATH 20D,A02,083766,Tran; Brian Kha,5,0,30,25
1657955755279,MATH 20D,A03,083767,Tran; Brian Kha,6,0,30,24
1657955761320,MATH 20E,A01,083771,Ganguly; Soumya,12,0,32,20
1657955761320,MATH 20E,A02,083772,Ganguly; Soumya,7,0,32,25
1657955761320,MATH 20E,B01,083773,Ciotti; Benjamin,20,0,35,15
1657955761320,MATH 20E,B02,083774,Ciotti; Benjamin,18,0,35,17
1657955767347,MATH 103A,A01,083777,Greenfeld; Be'Eri,6,0,36,30
1657955767347,MATH 103A,A02,083778,Greenfeld; Be'Eri,5,0,36,31
1657955767347,MATH 103A,A03,093561,Greenfeld; Be'Eri,7,0,36,29
1657955767347,MATH 103A,B01,083779,Greenfeld; Be'Eri,8,0,36,28
1657955767347,MATH 103A,B02,083780,Greenfeld; Be'Eri,4,0,36,32
1657955767347,MATH 103A,B03,093562,Greenfeld; Be'Eri,3,0,36,33
1657955773380,MATH 105,A01,085443,Carter; Anne Toulson,15,0,35,20
1657955773380,MATH 105,A02,093477,Carter; Anne Toulson,20,0,35,15
1657955779407,MATH 109,A01,083213,Ganzberger; Geoffrey Michael,3,0,34,31
1657955779407,MATH 109,A02,083214,Ganzberger; Geoffrey Michael,4,0,34,30
1657955779407,MATH 109,A03,093478,Ganzberger; Geoffrey Michael,2,0,34,32
1657955779407,MATH 109,B01,083215,Ganzberger; Geoffrey Michael,3,0,32,29
1657955779407,MATH 109,B02,083216,Ganzberger; Geoffrey Michael,3,0,32,29
1657955779407,MATH 109,B03,093479,Ganzberger; Geoffrey Michael,8,0,32,24
1657955785452,MATH 142A,A01,083219,Chow; Bennett,7,0,32,25
1657955785452,MATH 142A,A02,083220,Chow; Bennett,10,0,32,22
1657955785452,MATH 142A,A03,093480,Chow; Bennett,9,0,32,23
1657955785452,MATH 142A,B03,093481,Chow; Bennett,8,0,32,24
1657955785452,MATH 142A,B04,093558,Chow; Bennett,14,0,32,18
1657955785452,MATH 142A,B05,093559,Chow; Bennett,7,0,32,25
1657955791478,MATH 193A,A01,083224,Rotar; Vladimir,9,0,34,25
1657955791478,MATH 193A,A02,083225,Rotar; Vladimir,11,0,34,23
1657955791478,MATH 193A,A03,083781,Rotar; Vladimir,5,0,34,29
1657955791478,MATH 193A,A04,083782,Rotar; Vladimir,12,0,34,22
1657955791478,MATH 193A,A05,093482,Rotar; Vladimir,11,0,34,23
1657955797503,MATH 197,001,091859,McAuley; Julian John,9999,0,9999,0
1657955797503,MATH 197,002,095566,Kedlaya; Kiran S.,9997,0,9999,2
1657955797503,MATH 197,003,095567,Xiao; Ming,9999,0,9999,0
1657955797503,MATH 197,004,095571,Perols; Johan Lars,9998,0,9999,1
1657955804565,COGS 9,A01,083615,Shannon; Kyle Michael,11,0,75,64
1657955810595,COGS 11,A01,083617,Boyle; Mary E. T.,23,0,48,25
1657955816618,COGS 13,A01,083071,Bastos; Amalia Pinkusfeld,12,0,71,59
1657955822643,COGS 14A,A01,092681,Semenuks; Arturs,5,1,100,95
1657955828669,COGS 14B,A01,083073,Cheng; Tzu-Han,7,0,63,56
1657955834698,COGS 17,A01,092677,Semenuks; Arturs,7,0,81,74
1657955840722,COGS 100,A01,083619,Allen; Michael Gordon,17,0,70,53
1657955846748,COGS 101A,A01,083621,Davis; Joshua Daniel,9,0,68,59
1657955852783,COGS 101B,A01,091572,Allen; Michael Gordon,14,0,65,51
1657955862871,COGS 101C,A01,083625,Delgado; Tania,17,0,35,18
1657955868894,COGS 107A,A01,083627,Boyle; Mary E. T.,14,0,60,46
1657955874917,COGS 118A,A01,083075,Gupta; Anjum,21,0,76,55
1657955880943,CSE 3,A50,083646,Miranda; Gregory Joseph,24,0,50,26
1657955886967,CSE 8A,A50,083650,Miranda; Gregory Joseph,17,1,56,39
1657955892995,CSE 11,A01,083080,Cao; Yingjun,7,15,40,33
1657955899026,CSE 12,A01,083652,Krause-Levy; Sophia Louisa,30,1,120,90
1657955905058,CSE 15L,A01,083654,Morris; Justin Loren,9,0,50,41
1657955905058,CSE 15L,A02,083655,Morris; Justin Loren,11,0,50,39
1657955911088,CSE 20,A01,083657,Tran; Khoa Dang,39,0,80,41
1657955917121,CSE 21,A01,095574,Bach; Quang Tran,23,0,48,25
1657955923147,CSE 30,A01,083084,Eldon; John,8,0,80,72
1657955923147,CSE 30,B01,095061,Bhaskar; Nishant,9,0,50,41
1657955929178,CSE 100,A01,083659,Cao; Yingjun,5,4,70,65
1657955935208,CSE 134B,A01,083661,Powell; Thomas Allan,25,0,100,75
1657955941239,CSE 140,A01,083663,Gungor; Onat,17,0,85,68
1657955947265,CSE 140L,A01,083088,Eldon; John,23,0,100,77
1657955953291,CSE 175,A01,083665,Kumar; Rakesh,3,0,25,22
1657955959325,CSE 190,A00,092507,Dubnov; Shlomo,8,0,20,12
1657955965353,ECE 45,A01,083139,Congero; Spencer William,7,0,75,68
1657955971444,ECE 65,A50,083695,Saad; Andrew S,12,0,30,18
1657955971444,ECE 65,A51,095125,Saad; Andrew S,24,0,26,2
1657955977623,ECE 109,A01,091882,Touri; Behrouz,21,0,70,49
1657955983740,ECE 180,A00,083140,Abi Samra; Nicholas Camill,1,0,30,29
1657955983740,ECE 180,B00,083141,Abi Samra; Nicholas Camill,0,0,30,30
1657955990559,MATH 10A,A01,083735,Patchell; Gregory David,2,0,30,28
1657955990559,MATH 10A,A02,083736,Patchell; Gregory David,20,0,30,10
1657955990559,MATH 10A,A03,083737,Patchell; Gregory David,16,0,30,14
1657955996619,MATH 10B,A01,083207,Lim; Seonhee,9,0,34,25
1657955996619,MATH 10B,A02,083208,Lim; Seonhee,10,0,35,25
1657955996619,MATH 10B,A03,093472,Lim; Seonhee,7,0,34,27
1657955996619,MATH 10B,B01,083739,Sinha; Shubham,14,0,30,16
1657956002692,MATH 18,A01,083743,Cinel; Cameron Alexander,9,0,30,21
1657956002692,MATH 18,A02,083744,Cinel; Cameron Alexander,18,0,30,12
1657956002692,MATH 18,A03,083745,Cinel; Cameron Alexander,10,0,30,20
1657956002692,MATH 18,B01,083748,Rideout; David Porter,5,0,37,32
1657956002692,MATH 18,B02,083749,Rideout; David Porter,5,0,36,31
1657956002692,MATH 18,B03,083750,Rideout; David Porter,3,0,37,34
1657956002692,MATH 18,B04,083751,Rideout; David Porter,7,0,36,29
1657956002692,MATH 18,B05,093473,Rideout; David Porter,7,0,36,29
1657956002692,MATH 18,B06,093474,Rideout; David Porter,6,0,36,30
1657956008735,MATH 20A,A01,083754,Zheng; Zequn,14,0,40,26
1657956014767,MATH 20B,A01,083756,Briones; Jor-el Thomas Caparas,4,0,36,32
1657956014767,MATH 20B,A02,083757,Briones; Jor-el Thomas Caparas,1,0,36,35
1657956014767,MATH 20B,A03,093475,Briones; Jor-el Thomas Caparas,3,0,36,33
1657956020794,MATH 20C,A01,083760,Briones; Jor-el Thomas Caparas,1,0,35,34
1657956020794,MATH 20C,A02,083761,Briones; Jor-el Thomas Caparas,8,0,35,27
1657956020794,MATH 20C,A03,093476,Briones; Jor-el Thomas Caparas,0,1,36,36
1657956020794,MATH 20C,B01,083762,Bach; Quang Tran,1,0,30,29
1657956026837,MATH 20D,A01,083765,Tran; Brian Kha,5,0,30,25
1657956026837,MATH 20D,A02,083766,Tran; Brian Kha,5,0,30,25
1657956026837,MATH 20D,A03,083767,Tran; Brian Kha,6,0,30,24
1657956032888,MATH 20E,A01,083771,Ganguly; Soumya,12,0,32,20
1657956032888,MATH 20E,A02,083772,Ganguly; Soumya,7,0,32,25
1657956032888,MATH 20E,B01,083773,Ciotti; Benjamin,20,0,35,15
1657956032888,MATH 20E,B02,083774,Ciotti; Benjamin,18,0,35,17
1657956038927,MATH 103A,A01,083777,Greenfeld; Be'Eri,6,0,36,30
1657956038927,MATH 103A,A02,083778,Greenfeld; Be'Eri,5,0,36,31
1657956038927,MATH 103A,A03,093561,Greenfeld; Be'Eri,7,0,36,29
1657956038927,MATH 103A,B01,083779,Greenfeld; Be'Eri,8,0,36,28
1657956038927,MATH 103A,B02,083780,Greenfeld; Be'Eri,4,0,36,32
1657956038927,MATH 103A,B03,093562,Greenfeld; Be'Eri,3,0,36,33
1657956044966,MATH 105,A01,085443,Carter; Anne Toulson,15,0,35,20
1657956044966,MATH 105,A02,093477,Carter; Anne Toulson,20,0,35,15
1657956051021,MATH 109,A01,083213,Ganzberger; Geoffrey Michael,3,0,34,31
1657956051021,MATH 109,A02,083214,Ganzberger; Geoffrey Michael,4,0,34,30
1657956051021,MATH 109,A03,093478,Ganzberger; Geoffrey Michael,2,0,34,32
1657956051021,MATH 109,B01,083215,Ganzberger; Geoffrey Michael,3,0,32,29
1657956051021,MATH 109,B02,083216,Ganzberger; Geoffrey Michael,3,0,32,29
1657956051021,MATH 109,B03,093479,Ganzberger; Geoffrey Michael,8,0,32,24
1657956057061,MATH 142A,A01,083219,Chow; Bennett,7,0,32,25
1657956057061,MATH 142A,A02,083220,Chow; Bennett,10,0,32,22
1657956057061,MATH 142A,A03,093480,Chow; Bennett,9,0,32,23
1657956057061,MATH 142A,B03,093481,Chow; Bennett,8,0,32,24
1657956057061,MATH 142A,B04,093558,Chow; Bennett,14,0,32,18
1657956057061,MATH 142A,B05,093559,Chow; Bennett,7,0,32,25
1657956063110,MATH 193A,A01,083224,Rotar; Vladimir,9,0,34,25
1657956063110,MATH 193A,A02,083225,Rotar; Vladimir,11,0,34,23
1657956063110,MATH 193A,A03,083781,Rotar; Vladimir,5,0,34,29
1657956063110,MATH 193A,A04,083782,Rotar; Vladimir,12,0,34,22
1657956063110,MATH 193A,A05,093482,Rotar; Vladimir,11,0,34,23
1657956069151,MATH 197,001,091859,McAuley; Julian John,9999,0,9999,0
1657956069151,MATH 197,002,095566,Kedlaya; Kiran S.,9997,0,9999,2
1657956069151,MATH 197,003,095567,Xiao; Ming,9999,0,9999,0
1657956069151,MATH 197,004,095571,Perols; Johan Lars,9998,0,9999,1
1657956076231,COGS 9,A01,083615,Shannon; Kyle Michael,11,0,75,64
1657956082266,COGS 11,A01,083617,Boyle; Mary E. T.,23,0,48,25
1657956088290,COGS 13,A01,083071,Bastos; Amalia Pinkusfeld,12,0,71,59
1657956094334,COGS 14A,A01,092681,Semenuks; Arturs,5,1,100,95
1657956100377,COGS 14B,A01,083073,Cheng; Tzu-Han,7,0,63,56
1657956106425,COGS 17,A01,092677,Semenuks; Arturs,7,0,81,74
1657956112470,COGS 100,A01,083619,Allen; Michael Gordon,17,0,70,53
1657956118507,COGS 101A,A01,083621,Davis; Joshua Daniel,9,0,68,59
1657956124547,COGS 101B,A01,091572,Allen; Michael Gordon,14,0,65,51
1657956130594,COGS 101C,A01,083625,Delgado; Tania,17,0,35,18
1657956136645,COGS 107A,A01,083627,Boyle; Mary E. T.,14,0,60,46
1657956142797,COGS 118A,A01,083075,Gupta; Anjum,21,0,76,55
1657956148850,CSE 3,A50,083646,Miranda; Gregory Joseph,24,0,50,26
1657956154887,CSE 8A,A50,083650,Miranda; Gregory Joseph,17,1,56,39
1657956160932,CSE 11,A01,083080,Cao; Yingjun,7,15,40,33
1657956166976,CSE 12,A01,083652,Krause-Levy; Sophia Louisa,30,1,120,90
1657956173004,CSE 15L,A01,083654,Morris; Justin Loren,9,0,50,41
1657956173004,CSE 15L,A02,083655,Morris; Justin Loren,11,0,50,39
1657956179051,CSE 20,A01,083657,Tran; Khoa Dang,39,0,80,41
1657956185109,CSE 21,A01,095574,Bach; Quang Tran,23,0,48,25
1657956191160,CSE 30,A01,083084,Eldon; John,8,0,80,72
1657956191160,CSE 30,B01,095061,Bhaskar; Nishant,9,0,50,41
1657956197204,CSE 100,A01,083659,Cao; Yingjun,5,4,70,65
1657956203249,CSE 134B,A01,083661,Powell; Thomas Allan,25,0,100,75
1657956209289,CSE 140,A01,083663,Gungor; Onat,17,0,85,68
1657956215337,CSE 140L,A01,083088,Eldon; John,23,0,100,77
1657956221382,CSE 175,A01,083665,Kumar; Rakesh,3,0,25,22
1657956227420,CSE 190,A00,092507,Dubnov; Shlomo,8,0,20,12
1657956233462,ECE 45,A01,083139,Congero; Spencer William,7,0,75,68
1657956239502,ECE 65,A50,083695,Saad; Andrew S,12,0,30,18
1657956239502,ECE 65,A51,095125,Saad; Andrew S,24,0,26,2
1657956245543,ECE 109,A01,091882,Touri; Behrouz,21,0,70,49
1657956251573,ECE 180,A00,083140,Abi Samra; Nicholas Camill,1,0,30,29
1657956251573,ECE 180,B00,083141,Abi Samra; Nicholas Camill,0,0,30,30
1657956257621,MATH 10A,A01,083735,Patchell; Gregory David,2,0,30,28
1657956257621,MATH 10A,A02,083736,Patchell; Gregory David,20,0,30,10
1657956257621,MATH 10A,A03,083737,Patchell; Gregory David,16,0,30,14
1657956263661,MATH 10B,A01,083207,Lim; Seonhee,9,0,34,25
1657956263661,MATH 10B,A02,083208,Lim; Seonhee,10,0,35,25
1657956263661,MATH 10B,A03,093472,Lim; Seonhee,7,0,34,27
1657956263661,MATH 10B,B01,083739,Sinha; Shubham,14,0,30,16
1657956269686,MATH 18,A01,083743,Cinel; Cameron Alexander,9,0,30,21
1657956269686,MATH 18,A02,083744,Cinel; Cameron Alexander,18,0,30,12
1657956269686,MATH 18,A03,083745,Cinel; Cameron Alexander,10,0,30,20
1657956269686,MATH 18,B01,083748,Rideout; David Porter,5,0,37,32
1657956269686,MATH 18,B02,083749,Rideout; David Porter,5,0,36,31
1657956269686,MATH 18,B03,083750,Rideout; David Porter,3,0,37,34
1657956269686,MATH 18,B04,083751,Rideout; David Porter,7,0,36,29
1657956269686,MATH 18,B05,093473,Rideout; David Porter,7,0,36,29
1657956269686,MATH 18,B06,093474,Rideout; David Porter,6,0,36,30
1657956275724,MATH 20A,A01,083754,Zheng; Zequn,14,0,40,26
1657956281765,MATH 20B,A01,083756,Briones; Jor-el Thomas Caparas,4,0,36,32
1657956281765,MATH 20B,A02,083757,Briones; Jor-el Thomas Caparas,1,0,36,35
1657956281765,MATH 20B,A03,093475,Briones; Jor-el Thomas Caparas,3,0,36,33
1657956287813,MATH 20C,A01,083760,Briones; Jor-el Thomas Caparas,1,0,35,34
1657956287813,MATH 20C,A02,083761,Briones; Jor-el Thomas Caparas,8,0,35,27
1657956287813,MATH 20C,A03,093476,Briones; Jor-el Thomas Caparas,0,1,36,36
1657956287813,MATH 20C,B01,083762,Bach; Quang Tran,1,0,30,29
1657956293842,MATH 20D,A01,083765,Tran; Brian Kha,5,0,30,25
1657956293842,MATH 20D,A02,083766,Tran; Brian Kha,5,0,30,25
1657956293842,MATH 20D,A03,083767,Tran; Brian Kha,6,0,30,24
1657956299873,MATH 20E,A01,083771,Ganguly; Soumya,12,0,32,20
1657956299873,MATH 20E,A02,083772,Ganguly; Soumya,7,0,32,25
1657956299873,MATH 20E,B01,083773,Ciotti; Benjamin,20,0,35,15
1657956299873,MATH 20E,B02,083774,Ciotti; Benjamin,18,0,35,17
1657956305898,MATH 103A,A01,083777,Greenfeld; Be'Eri,6,0,36,30
1657956305898,MATH 103A,A02,083778,Greenfeld; Be'Eri,5,0,36,31
1657956305898,MATH 103A,A03,093561,Greenfeld; Be'Eri,7,0,36,29
1657956305898,MATH 103A,B01,083779,Greenfeld; Be'Eri,8,0,36,28
1657956305898,MATH 103A,B02,083780,Greenfeld; Be'Eri,4,0,36,32
1657956305898,MATH 103A,B03,093562,Greenfeld; Be'Eri,3,0,36,33
1657956311926,MATH 105,A01,085443,Carter; Anne Toulson,15,0,35,20
1657956311926,MATH 105,A02,093477,Carter; Anne Toulson,20,0,35,15
1657956317949,MATH 109,A01,083213,Ganzberger; Geoffrey Michael,3,0,34,31
1657956317949,MATH 109,A02,083214,Ganzberger; Geoffrey Michael,4,0,34,30
1657956317949,MATH 109,A03,093478,Ganzberger; Geoffrey Michael,2,0,34,32
1657956317949,MATH 109,B01,083215,Ganzberger; Geoffrey Michael,3,0,32,29
1657956317949,MATH 109,B02,083216,Ganzberger; Geoffrey Michael,3,0,32,29
1657956317949,MATH 109,B03,093479,Ganzberger; Geoffrey Michael,8,0,32,24
1657956323980,MATH 142A,A01,083219,Chow; Bennett,7,0,32,25
1657956323980,MATH 142A,A02,083220,Chow; Bennett,10,0,32,22
1657956323980,MATH 142A,A03,093480,Chow; Bennett,9,0,32,23
1657956323980,MATH 142A,B03,093481,Chow; Bennett,8,0,32,24
1657956323980,MATH 142A,B04,093558,Chow; Bennett,14,0,32,18
1657956323980,MATH 142A,B05,093559,Chow; Bennett,7,0,32,25
1657956330003,MATH 193A,A01,083224,Rotar; Vladimir,9,0,34,25
1657956330003,MATH 193A,A02,083225,Rotar; Vladimir,11,0,34,23
1657956330003,MATH 193A,A03,083781,Rotar; Vladimir,5,0,34,29
1657956330003,MATH 193A,A04,083782,Rotar; Vladimir,12,0,34,22
1657956330003,MATH 193A,A05,093482,Rotar; Vladimir,11,0,34,23
1657956336030,MATH 197,001,091859,McAuley; Julian John,9999,0,9999,0
1657956336030,MATH 197,002,095566,Kedlaya; Kiran S.,9997,0,9999,2
1657956336030,MATH 197,003,095567,Xiao; Ming,9999,0,9999,0
1657956336030,MATH 197,004,095571,Perols; Johan Lars,9998,0,9999,1
1657956343095,COGS 9,A01,083615,Shannon; Kyle Michael,11,0,75,64
1657956349120,COGS 11,A01,083617,Boyle; Mary E. T.,23,0,48,25
1657956355147,COGS 13,A01,083071,Bastos; Amalia Pinkusfeld,12,0,71,59
1657956361174,COGS 14A,A01,092681,Semenuks; Arturs,5,1,100,95
1657956367197,COGS 14B,A01,083073,Cheng; Tzu-Han,7,0,63,56
1657956373219,COGS 17,A01,092677,Semenuks; Arturs,7,0,81,74
1657956379247,COGS 100,A01,083619,Allen; Michael Gordon,17,0,70,53
1657956385272,COGS 101A,A01,083621,Davis; Joshua Daniel,9,0,68,59
1657956391300,COGS 101B,A01,091572,Allen; Michael Gordon,14,0,65,51
1657956397329,COGS 101C,A01,083625,Delgado; Tania,17,0,35,18
1657956403355,COGS 107A,A01,083627,Boyle; Mary E. T.,14,0,60,46
1657956409379,COGS 118A,A01,083075,Gupta; Anjum,21,0,76,55
1657956415408,CSE 3,A50,083646,Miranda; Gregory Joseph,24,0,50,26
1657956421432,CSE 8A,A50,083650,Miranda; Gregory Joseph,17,1,56,39
1657956427456,CSE 11,A01,083080,Cao; Yingjun,7,15,40,33
1657956433483,CSE 12,A01,083652,Krause-Levy; Sophia Louisa,30,1,120,90
1657956439512,CSE 15L,A01,083654,Morris; Justin Loren,9,0,50,41
1657956439512,CSE 15L,A02,083655,Morris; Justin Loren,11,0,50,39
1657956445542,CSE 20,A01,083657,Tran; Khoa Dang,39,0,80,41
1657956451570,CSE 21,A01,095574,Bach; Quang Tran,23,0,48,25
1657956457594,CSE 30,A01,083084,Eldon; John,8,0,80,72
1657956457594,CSE 30,B01,095061,Bhaskar; Nishant,9,0,50,41
1657956463617,CSE 100,A01,083659,Cao; Yingjun,5,4,70,65
1657956469638,CSE 134B,A01,083661,Powell; Thomas Allan,25,0,100,75
1657956475662,CSE 140,A01,083663,Gungor; Onat,17,0,85,68
1657956481688,CSE 140L,A01,083088,Eldon; John,23,0,100,77
1657956487712,CSE 175,A01,083665,Kumar; Rakesh,3,0,25,22
1657956493735,CSE 190,A00,092507,Dubnov; Shlomo,8,0,20,12
1657956499759,ECE 45,A01,083139,Congero; Spencer William,7,0,75,68
1657956505783,ECE 65,A50,083695,Saad; Andrew S,12,0,30,18
1657956505783,ECE 65,A51,095125,Saad; Andrew S,24,0,26,2
1657956511809,ECE 109,A01,091882,Touri; Behrouz,21,0,70,49
1657956517835,ECE 180,A00,083140,Abi Samra; Nicholas Camill,1,0,30,29
1657956517835,ECE 180,B00,083141,Abi Samra; Nicholas Camill,0,0,30,30
1657956523863,MATH 10A,A01,083735,Patchell; Gregory David,2,0,30,28
1657956523863,MATH 10A,A02,083736,Patchell; Gregory David,20,0,30,10
1657956523863,MATH 10A,A03,083737,Patchell; Gregory David,16,0,30,14
1657956529892,MATH 10B,A01,083207,Lim; Seonhee,9,0,34,25
1657956529892,MATH 10B,A02,083208,Lim; Seonhee,10,0,35,25
1657956529892,MATH 10B,A03,093472,Lim; Seonhee,7,0,34,27
1657956529892,MATH 10B,B01,083739,Sinha; Shubham,14,0,30,16
1657956535917,MATH 18,A01,083743,Cinel; Cameron Alexander,9,0,30,21
1657956535917,MATH 18,A02,083744,Cinel; Cameron Alexander,18,0,30,12
1657956535917,MATH 18,A03,083745,Cinel; Cameron Alexander,10,0,30,20
1657956535917,MATH 18,B01,083748,Rideout; David Porter,5,0,37,32
1657956535917,MATH 18,B02,083749,Rideout; David Porter,5,0,36,31
1657956535917,MATH 18,B03,083750,Rideout; David Porter,3,0,37,34
1657956535917,MATH 18,B04,083751,Rideout; David Porter,7,0,36,29
1657956535917,MATH 18,B05,093473,Rideout; David Porter,7,0,36,29
1657956535917,MATH 18,B06,093474,Rideout; David Porter,6,0,36,30
1657956541940,MATH 20A,A01,083754,Zheng; Zequn,14,0,40,26
1657956547968,MATH 20B,A01,083756,Briones; Jor-el Thomas Caparas,4,0,36,32
1657956547968,MATH 20B,A02,083757,Briones; Jor-el Thomas Caparas,1,0,36,35
1657956547968,MATH 20B,A03,093475,Briones; Jor-el Thomas Caparas,3,0,36,33
1657956553994,MATH 20C,A01,083760,Briones; Jor-el Thomas Caparas,1,0,35,34
1657956553994,MATH 20C,A02,083761,Briones; Jor-el Thomas Caparas,8,0,35,27
1657956553994,MATH 20C,A03,093476,Briones; Jor-el Thomas Caparas,0,1,36,36
1657956553994,MATH 20C,B01,083762,Bach; Quang Tran,1,0,30,29
1657956560018,MATH 20D,A01,083765,Tran; Brian Kha,5,0,30,25
1657956560018,MATH 20D,A02,083766,Tran; Brian Kha,5,0,30,25
1657956560018,MATH 20D,A03,083767,Tran; Brian Kha,6,0,30,24
1657956566046,MATH 20E,A01,083771,Ganguly; Soumya,12,0,32,20
1657956566046,MATH 20E,A02,083772,Ganguly; Soumya,7,0,32,25
1657956566046,MATH 20E,B01,083773,Ciotti; Benjamin,20,0,35,15
1657956566046,MATH 20E,B02,083774,Ciotti; Benjamin,18,0,35,17
1657956572074,MATH 103A,A01,083777,Greenfeld; Be'Eri,6,0,36,30
1657956572074,MATH 103A,A02,083778,Greenfeld; Be'Eri,5,0,36,31
1657956572074,MATH 103A,A03,093561,Greenfeld; Be'Eri,7,0,36,29
1657956572074,MATH 103A,B01,083779,Greenfeld; Be'Eri,8,0,36,28
1657956572074,MATH 103A,B02,083780,Greenfeld; Be'Eri,4,0,36,32
1657956572074,MATH 103A,B03,093562,Greenfeld; Be'Eri,3,0,36,33
1657956578107,MATH 105,A01,085443,Carter; Anne Toulson,15,0,35,20
1657956578107,MATH 105,A02,093477,Carter; Anne Toulson,20,0,35,15
1657956584131,MATH 109,A01,083213,Ganzberger; Geoffrey Michael,3,0,34,31
1657956584131,MATH 109,A02,083214,Ganzberger; Geoffrey Michael,4,0,34,30
1657956584131,MATH 109,A03,093478,Ganzberger; Geoffrey Michael,2,0,34,32
1657956584131,MATH 109,B01,083215,Ganzberger; Geoffrey Michael,3,0,32,29
1657956584131,MATH 109,B02,083216,Ganzberger; Geoffrey Michael,3,0,32,29
1657956584131,MATH 109,B03,093479,Ganzberger; Geoffrey Michael,8,0,32,24
1657956590155,MATH 142A,A01,083219,Chow; Bennett,7,0,32,25
1657956590155,MATH 142A,A02,083220,Chow; Bennett,10,0,32,22
1657956590155,MATH 142A,A03,093480,Chow; Bennett,9,0,32,23
1657956590155,MATH 142A,B03,093481,Chow; Bennett,8,0,32,24
1657956590155,MATH 142A,B04,093558,Chow; Bennett,14,0,32,18
1657956590155,MATH 142A,B05,093559,Chow; Bennett,7,0,32,25
1657956596181,MATH 193A,A01,083224,Rotar; Vladimir,9,0,34,25
1657956596181,MATH 193A,A02,083225,Rotar; Vladimir,11,0,34,23
1657956596181,MATH 193A,A03,083781,Rotar; Vladimir,5,0,34,29
1657956596181,MATH 193A,A04,083782,Rotar; Vladimir,12,0,34,22
1657956596181,MATH 193A,A05,093482,Rotar; Vladimir,11,0,34,23
1657956602203,MATH 197,001,091859,McAuley; Julian John,9999,0,9999,0
1657956602203,MATH 197,002,095566,Kedlaya; Kiran S.,9997,0,9999,2
1657956602203,MATH 197,003,095567,Xiao; Ming,9999,0,9999,0
1657956602203,MATH 197,004,095571,Perols; Johan Lars,9998,0,9999,1
1657956609275,COGS 9,A01,083615,Shannon; Kyle Michael,11,0,75,64
1657956615302,COGS 11,A01,083617,Boyle; Mary E. T.,23,0,48,25
1657956621335,COGS 13,A01,083071,Bastos; Amalia Pinkusfeld,12,0,71,59
1657956627363,COGS 14A,A01,092681,Semenuks; Arturs,5,1,100,95
1657956633388,COGS 14B,A01,083073,Cheng; Tzu-Han,7,0,63,56
1657956639411,COGS 17,A01,092677,Semenuks; Arturs,7,0,81,74
1657956645440,COGS 100,A01,083619,Allen; Michael Gordon,17,0,70,53
1657956651463,COGS 101A,A01,083621,Davis; Joshua Daniel,9,0,68,59
1657956657489,COGS 101B,A01,091572,Allen; Michael Gordon,14,0,65,51
1657956663513,COGS 101C,A01,083625,Delgado; Tania,17,0,35,18
1657956669547,COGS 107A,A01,083627,Boyle; Mary E. T.,14,0,60,46
1657956675574,COGS 118A,A01,083075,Gupta; Anjum,21,0,76,55
1657956681608,CSE 3,A50,083646,Miranda; Gregory Joseph,24,0,50,26
1657956687632,CSE 8A,A50,083650,Miranda; Gregory Joseph,17,1,56,39
1657956693659,CSE 11,A01,083080,Cao; Yingjun,7,15,40,33
1657956699685,CSE 12,A01,083652,Krause-Levy; Sophia Louisa,30,1,120,90
1657956705713,CSE 15L,A01,083654,Morris; Justin Loren,9,0,50,41
1657956705713,CSE 15L,A02,083655,Morris; Justin Loren,11,0,50,39
1657956711736,CSE 20,A01,083657,Tran; Khoa Dang,39,0,80,41
1657956717765,CSE 21,A01,095574,Bach; Quang Tran,23,0,48,25
1657956723789,CSE 30,A01,083084,Eldon; John,8,0,80,72
1657956723789,CSE 30,B01,095061,Bhaskar; Nishant,9,0,50,41
1657956729821,CSE 100,A01,083659,Cao; Yingjun,5,4,70,65
1657956735847,CSE 134B,A01,083661,Powell; Thomas Allan,25,0,100,75
1657956741944,CSE 140,A01,083663,Gungor; Onat,17,0,85,68
1657956747972,CSE 140L,A01,083088,Eldon; John,23,0,100,77
1657956754003,CSE 175,A01,083665,Kumar; Rakesh,3,0,25,22
1657956760029,CSE 190,A00,092507,Dubnov; Shlomo,8,0,20,12
1657956766061,ECE 45,A01,083139,Congero; Spencer William,7,0,75,68
1657956772087,ECE 65,A50,083695,Saad; Andrew S,12,0,30,18
1657956772087,ECE 65,A51,095125,Saad; Andrew S,24,0,26,2
1657956778113,ECE 109,A01,091882,Touri; Behrouz,21,0,70,49
1657956784138,ECE 180,A00,083140,Abi Samra; Nicholas Camill,1,0,30,29
1657956784138,ECE 180,B00,083141,Abi Samra; Nicholas Camill,0,0,30,30
1657956790179,MATH 10A,A01,083735,Patchell; Gregory David,2,0,30,28
1657956790179,MATH 10A,A02,083736,Patchell; Gregory David,20,0,30,10
1657956790179,MATH 10A,A03,083737,Patchell; Gregory David,16,0,30,14
1657956796221,MATH 10B,A01,083207,Lim; Seonhee,9,0,34,25
1657956796221,MATH 10B,A02,083208,Lim; Seonhee,10,0,35,25
1657956796221,MATH 10B,A03,093472,Lim; Seonhee,7,0,34,27
1657956796221,MATH 10B,B01,083739,Sinha; Shubham,14,0,30,16
1657956802261,MATH 18,A01,083743,Cinel; Cameron Alexander,9,0,30,21
1657956802261,MATH 18,A02,083744,Cinel; Cameron Alexander,18,0,30,12
1657956802261,MATH 18,A03,083745,Cinel; Cameron Alexander,10,0,30,20
1657956802261,MATH 18,B01,083748,Rideout; David Porter,5,0,37,32
1657956802261,MATH 18,B02,083749,Rideout; David Porter,5,0,36,31
1657956802261,MATH 18,B03,083750,Rideout; David Porter,3,0,37,34
1657956802261,MATH 18,B04,083751,Rideout; David Porter,7,0,36,29
1657956802261,MATH 18,B05,093473,Rideout; David Porter,7,0,36,29
1657956802261,MATH 18,B06,093474,Rideout; David Porter,6,0,36,30
1657956808286,MATH 20A,A01,083754,Zheng; Zequn,14,0,40,26
1657956814311,MATH 20B,A01,083756,Briones; Jor-el Thomas Caparas,4,0,36,32
1657956814311,MATH 20B,A02,083757,Briones; Jor-el Thomas Caparas,1,0,36,35
1657956814311,MATH 20B,A03,093475,Briones; Jor-el Thomas Caparas,3,0,36,33
1657956820341,MATH 20C,A01,083760,Briones; Jor-el Thomas Caparas,1,0,35,34
1657956820341,MATH 20C,A02,083761,Briones; Jor-el Thomas Caparas,8,0,35,27
1657956820341,MATH 20C,A03,093476,Briones; Jor-el Thomas Caparas,0,1,36,36
1657956820341,MATH 20C,B01,083762,Bach; Quang Tran,1,0,30,29
1657956826364,MATH 20D,A01,083765,Tran; Brian Kha,5,0,30,25
1657956826364,MATH 20D,A02,083766,Tran; Brian Kha,5,0,30,25
1657956826364,MATH 20D,A03,083767,Tran; Brian Kha,6,0,30,24
1657956832403,MATH 20E,A01,083771,Ganguly; Soumya,12,0,32,20
1657956832403,MATH 20E,A02,083772,Ganguly; Soumya,7,0,32,25
1657956832403,MATH 20E,B01,083773,Ciotti; Benjamin,20,0,35,15
1657956832403,MATH 20E,B02,083774,Ciotti; Benjamin,18,0,35,17
1657956838433,MATH 103A,A01,083777,Greenfeld; Be'Eri,6,0,36,30
1657956838433,MATH 103A,A02,083778,Greenfeld; Be'Eri,5,0,36,31
1657956838433,MATH 103A,A03,093561,Greenfeld; Be'Eri,7,0,36,29
1657956838433,MATH 103A,B01,083779,Greenfeld; Be'Eri,8,0,36,28
1657956838433,MATH 103A,B02,083780,Greenfeld; Be'Eri,4,0,36,32
1657956838433,MATH 103A,B03,093562,Greenfeld; Be'Eri,3,0,36,33
1657956844465,MATH 105,A01,085443,Carter; Anne Toulson,15,0,35,20
1657956844465,MATH 105,A02,093477,Carter; Anne Toulson,20,0,35,15
1657956850499,MATH 109,A01,083213,Ganzberger; Geoffrey Michael,3,0,34,31
1657956850499,MATH 109,A02,083214,Ganzberger; Geoffrey Michael,4,0,34,30
1657956850499,MATH 109,A03,093478,Ganzberger; Geoffrey Michael,2,0,34,32
1657956850499,MATH 109,B01,083215,Ganzberger; Geoffrey Michael,3,0,32,29
1657956850499,MATH 109,B02,083216,Ganzberger; Geoffrey Michael,3,0,32,29
1657956850499,MATH 109,B03,093479,Ganzberger; Geoffrey Michael,8,0,32,24
1657956856527,MATH 142A,A01,083219,Chow; Bennett,7,0,32,25
1657956856527,MATH 142A,A02,083220,Chow; Bennett,10,0,32,22
1657956856527,MATH 142A,A03,093480,Chow; Bennett,9,0,32,23
1657956856527,MATH 142A,B03,093481,Chow; Bennett,8,0,32,24
1657956856527,MATH 142A,B04,093558,Chow; Bennett,14,0,32,18
1657956856527,MATH 142A,B05,093559,Chow; Bennett,7,0,32,25
1657956862557,MATH 193A,A01,083224,Rotar; Vladimir,9,0,34,25
1657956862557,MATH 193A,A02,083225,Rotar; Vladimir,11,0,34,23
1657956862557,MATH 193A,A03,083781,Rotar; Vladimir,5,0,34,29
1657956862557,MATH 193A,A04,083782,Rotar; Vladimir,12,0,34,22
1657956862557,MATH 193A,A05,093482,Rotar; Vladimir,11,0,34,23
1657956868589,MATH 197,001,091859,McAuley; Julian John,9999,0,9999,0
1657956868589,MATH 197,002,095566,Kedlaya; Kiran S.,9997,0,9999,2
1657956868589,MATH 197,003,095567,Xiao; Ming,9999,0,9999,0
1657956868589,MATH 197,004,095571,Perols; Johan Lars,9998,0,9999,1
1657956875688,COGS 9,A01,083615,Shannon; Kyle Michael,11,0,75,64
1657956881717,COGS 11,A01,083617,Boyle; Mary E. T.,23,0,48,25
1657956887744,COGS 13,A01,083071,Bastos; Amalia Pinkusfeld,12,0,71,59
1657956893768,COGS 14A,A01,092681,Semenuks; Arturs,5,1,100,95
1657956899797,COGS 14B,A01,083073,Cheng; Tzu-Han,7,0,63,56
1657956905830,COGS 17,A01,092677,Semenuks; Arturs,7,0,81,74
1657956911856,COGS 100,A01,083619,Allen; Michael Gordon,17,0,70,53
1657956917882,COGS 101A,A01,083621,Davis; Joshua Daniel,9,0,68,59
1657956923908,COGS 101B,A01,091572,Allen; Michael Gordon,14,0,65,51
1657956929939,COGS 101C,A01,083625,Delgado; Tania,17,0,35,18
1657956935969,COGS 107A,A01,083627,Boyle; Mary E. T.,14,0,60,46
1657956941993,COGS 118A,A01,083075,Gupta; Anjum,21,0,76,55
1657956948019,CSE 3,A50,083646,Miranda; Gregory Joseph,24,0,50,26
1657956954042,CSE 8A,A50,083650,Miranda; Gregory Joseph,17,1,56,39
1657956960067,CSE 11,A01,083080,Cao; Yingjun,7,15,40,33
1657956966091,CSE 12,A01,083652,Krause-Levy; Sophia Louisa,30,1,120,90
1657956972120,CSE 15L,A01,083654,Morris; Justin Loren,9,0,50,41
1657956972120,CSE 15L,A02,083655,Morris; Justin Loren,11,0,50,39
1657956978151,CSE 20,A01,083657,Tran; Khoa Dang,39,0,80,41
1657956984175,CSE 21,A01,095574,Bach; Quang Tran,23,0,48,25
1657956990211,CSE 30,A01,083084,Eldon; John,8,0,80,72
1657956990211,CSE 30,B01,095061,Bhaskar; Nishant,9,0,50,41
1657956996242,CSE 100,A01,083659,Cao; Yingjun,5,4,70,65
1657957002267,CSE 134B,A01,083661,Powell; Thomas Allan,25,0,100,75
1657957008292,CSE 140,A01,083663,Gungor; Onat,17,0,85,68
1657957014316,CSE 140L,A01,083088,Eldon; John,23,0,100,77
1657957020355,CSE 175,A01,083665,Kumar; Rakesh,3,0,25,22
1657957026381,CSE 190,A00,092507,Dubnov; Shlomo,8,0,20,12
1657957032416,ECE 45,A01,083139,Congero; Spencer William,7,0,75,68
1657957038443,ECE 65,A50,083695,Saad; Andrew S,12,0,30,18
1657957038443,ECE 65,A51,095125,Saad; Andrew S,24,0,26,2
1657957044469,ECE 109,A01,091882,Touri; Behrouz,21,0,70,49
1657957050502,ECE 180,A00,083140,Abi Samra; Nicholas Camill,1,0,30,29
1657957050502,ECE 180,B00,083141,Abi Samra; Nicholas Camill,0,0,30,30
1657957056539,MATH 10A,A01,083735,Patchell; Gregory David,2,0,30,28
1657957056539,MATH 10A,A02,083736,Patchell; Gregory David,20,0,30,10
1657957056539,MATH 10A,A03,083737,Patchell; Gregory David,16,0,30,14
1657957062567,MATH 10B,A01,083207,Lim; Seonhee,9,0,34,25
1657957062567,MATH 10B,A02,083208,Lim; Seonhee,10,0,35,25
1657957062567,MATH 10B,A03,093472,Lim; Seonhee,7,0,34,27
1657957062567,MATH 10B,B01,083739,Sinha; Shubham,14,0,30,16
1657957068595,MATH 18,A01,083743,Cinel; Cameron Alexander,9,0,30,21
1657957068595,MATH 18,A02,083744,Cinel; Cameron Alexander,18,0,30,12
1657957068595,MATH 18,A03,083745,Cinel; Cameron Alexander,10,0,30,20
1657957068595,MATH 18,B01,083748,Rideout; David Porter,5,0,37,32
1657957068595,MATH 18,B02,083749,Rideout; David Porter,5,0,36,31
1657957068595,MATH 18,B03,083750,Rideout; David Porter,3,0,37,34
1657957068595,MATH 18,B04,083751,Rideout; David Porter,7,0,36,29
1657957068595,MATH 18,B05,093473,Rideout; David Porter,7,0,36,29
1657957068595,MATH 18,B06,093474,Rideout; David Porter,6,0,36,30
1657957074620,MATH 20A,A01,083754,Zheng; Zequn,14,0,40,26
1657957080647,MATH 20B,A01,083756,Briones; Jor-el Thomas Caparas,4,0,36,32
1657957080647,MATH 20B,A02,083757,Briones; Jor-el Thomas Caparas,1,0,36,35
1657957080647,MATH 20B,A03,093475,Briones; Jor-el Thomas Caparas,3,0,36,33
1657957086683,MATH 20C,A01,083760,Briones; Jor-el Thomas Caparas,1,0,35,34
1657957086683,MATH 20C,A02,083761,Briones; Jor-el Thomas Caparas,8,0,35,27
1657957086683,MATH 20C,A03,093476,Briones; Jor-el Thomas Caparas,0,1,36,36
1657957086683,MATH 20C,B01,083762,Bach; Quang Tran,1,0,30,29
1657957092710,MATH 20D,A01,083765,Tran; Brian Kha,5,0,30,25
1657957092710,MATH 20D,A02,083766,Tran; Brian Kha,5,0,30,25
1657957092710,MATH 20D,A03,083767,Tran; Brian Kha,6,0,30,24
1657957098737,MATH 20E,A01,083771,Ganguly; Soumya,12,0,32,20
1657957098737,MATH 20E,A02,083772,Ganguly; Soumya,7,0,32,25
1657957098737,MATH 20E,B01,083773,Ciotti; Benjamin,20,0,35,15
1657957098737,MATH 20E,B02,083774,Ciotti; Benjamin,18,0,35,17
1657957104770,MATH 103A,A01,083777,Greenfeld; Be'Eri,6,0,36,30
1657957104770,MATH 103A,A02,083778,Greenfeld; Be'Eri,5,0,36,31
1657957104770,MATH 103A,A03,093561,Greenfeld; Be'Eri,7,0,36,29
1657957104770,MATH 103A,B01,083779,Greenfeld; Be'Eri,8,0,36,28
1657957104770,MATH 103A,B02,083780,Greenfeld; Be'Eri,4,0,36,32
1657957104770,MATH 103A,B03,093562,Greenfeld; Be'Eri,3,0,36,33
1657957110802,MATH 105,A01,085443,Carter; Anne Toulson,15,0,35,20
1657957110802,MATH 105,A02,093477,Carter; Anne Toulson,20,0,35,15
1657957116826,MATH 109,A01,083213,Ganzberger; Geoffrey Michael,3,0,34,31
1657957116826,MATH 109,A02,083214,Ganzberger; Geoffrey Michael,4,0,34,30
1657957116826,MATH 109,A03,093478,Ganzberger; Geoffrey Michael,2,0,34,32
1657957116826,MATH 109,B01,083215,Ganzberger; Geoffrey Michael,3,0,32,29
1657957116826,MATH 109,B02,083216,Ganzberger; Geoffrey Michael,3,0,32,29
1657957116826,MATH 109,B03,093479,Ganzberger; Geoffrey Michael,8,0,32,24
1657957122853,MATH 142A,A01,083219,Chow; Bennett,7,0,32,25
1657957122853,MATH 142A,A02,083220,Chow; Bennett,10,0,32,22
1657957122853,MATH 142A,A03,093480,Chow; Bennett,9,0,32,23
1657957122853,MATH 142A,B03,093481,Chow; Bennett,8,0,32,24
1657957122853,MATH 142A,B04,093558,Chow; Bennett,14,0,32,18
1657957122853,MATH 142A,B05,093559,Chow; Bennett,7,0,32,25
1657957128886,MATH 193A,A01,083224,Rotar; Vladimir,9,0,34,25
1657957128886,MATH 193A,A02,083225,Rotar; Vladimir,11,0,34,23
1657957128886,MATH 193A,A03,083781,Rotar; Vladimir,5,0,34,29
1657957128886,MATH 193A,A04,083782,Rotar; Vladimir,12,0,34,22
1657957128886,MATH 193A,A05,093482,Rotar; Vladimir,11,0,34,23
1657957134914,MATH 197,001,091859,McAuley; Julian John,9999,0,9999,0
1657957134914,MATH 197,002,095566,Kedlaya; Kiran S.,9997,0,9999,2
1657957134914,MATH 197,003,095567,Xiao; Ming,9999,0,9999,0
1657957134914,MATH 197,004,095571,Perols; Johan Lars,9998,0,9999,1
1657957142023,COGS 9,A01,083615,Shannon; Kyle Michael,11,0,75,64
1657957148048,COGS 11,A01,083617,Boyle; Mary E. T.,23,0,48,25
1657957154076,COGS 13,A01,083071,Bastos; Amalia Pinkusfeld,12,0,71,59
1657957160103,COGS 14A,A01,092681,Semenuks; Arturs,5,1,100,95
1657957166139,COGS 14B,A01,083073,Cheng; Tzu-Han,7,0,63,56
1657957172168,COGS 17,A01,092677,Semenuks; Arturs,7,0,81,74
1657957178200,COGS 100,A01,083619,Allen; Michael Gordon,17,0,70,53
1657957184225,COGS 101A,A01,083621,Davis; Joshua Daniel,9,0,68,59
1657957190256,COGS 101B,A01,091572,Allen; Michael Gordon,14,0,65,51
1657957196282,COGS 101C,A01,083625,Delgado; Tania,17,0,35,18
1657957202312,COGS 107A,A01,083627,Boyle; Mary E. T.,14,0,60,46
1657957208337,COGS 118A,A01,083075,Gupta; Anjum,21,0,76,55
1657957214376,CSE 3,A50,083646,Miranda; Gregory Joseph,24,0,50,26
1657957220405,CSE 8A,A50,083650,Miranda; Gregory Joseph,17,1,56,39
1657957226430,CSE 11,A01,083080,Cao; Yingjun,7,15,40,33
1657957232456,CSE 12,A01,083652,Krause-Levy; Sophia Louisa,30,1,120,90
1657957238481,CSE 15L,A01,083654,Morris; Justin Loren,9,0,50,41
1657957238481,CSE 15L,A02,083655,Morris; Justin Loren,11,0,50,39
1657957244506,CSE 20,A01,083657,Tran; Khoa Dang,39,0,80,41
1657957250531,CSE 21,A01,095574,Bach; Quang Tran,23,0,48,25
1657957256559,CSE 30,A01,083084,Eldon; John,8,0,80,72
1657957256559,CSE 30,B01,095061,Bhaskar; Nishant,9,0,50,41
1657957262586,CSE 100,A01,083659,Cao; Yingjun,5,4,70,65
1657957268611,CSE 134B,A01,083661,Powell; Thomas Allan,25,0,100,75
1657957274637,CSE 140,A01,083663,Gungor; Onat,17,0,85,68
1657957280665,CSE 140L,A01,083088,Eldon; John,23,0,100,77
1657957286696,CSE 175,A01,083665,Kumar; Rakesh,3,0,25,22
1657957292722,CSE 190,A00,092507,Dubnov; Shlomo,8,0,20,12
1657957298749,ECE 45,A01,083139,Congero; Spencer William,7,0,75,68
1657957304784,ECE 65,A50,083695,Saad; Andrew S,12,0,30,18
1657957304784,ECE 65,A51,095125,Saad; Andrew S,24,0,26,2
1657957310809,ECE 109,A01,091882,Touri; Behrouz,21,0,70,49
1657957316848,ECE 180,A00,083140,Abi Samra; Nicholas Camill,1,0,30,29
1657957316848,ECE 180,B00,083141,Abi Samra; Nicholas Camill,0,0,30,30
1657957322889,MATH 10A,A01,083735,Patchell; Gregory David,2,0,30,28
1657957322889,MATH 10A,A02,083736,Patchell; Gregory David,20,0,30,10
1657957322889,MATH 10A,A03,083737,Patchell; Gregory David,16,0,30,14
1657957328928,MATH 10B,A01,083207,Lim; Seonhee,9,0,34,25
1657957328928,MATH 10B,A02,083208,Lim; Seonhee,10,0,35,25
1657957328928,MATH 10B,A03,093472,Lim; Seonhee,7,0,34,27
1657957328928,MATH 10B,B01,083739,Sinha; Shubham,14,0,30,16
1657957334966,MATH 18,A01,083743,Cinel; Cameron Alexander,9,0,30,21
1657957334966,MATH 18,A02,083744,Cinel; Cameron Alexander,18,0,30,12
1657957334966,MATH 18,A03,083745,Cinel; Cameron Alexander,10,0,30,20
1657957334966,MATH 18,B01,083748,Rideout; David Porter,5,0,37,32
1657957334966,MATH 18,B02,083749,Rideout; David Porter,5,0,36,31
1657957334966,MATH 18,B03,083750,Rideout; David Porter,3,0,37,34
1657957334966,MATH 18,B04,083751,Rideout; David Porter,7,0,36,29
1657957334966,MATH 18,B05,093473,Rideout; David Porter,7,0,36,29
1657957334966,MATH 18,B06,093474,Rideout; David Porter,6,0,36,30
1657957341081,MATH 20A,A01,083754,Zheng; Zequn,14,0,40,26
1657957347115,MATH 20B,A01,083756,Briones; Jor-el Thomas Caparas,4,0,36,32
1657957347115,MATH 20B,A02,083757,Briones; Jor-el Thomas Caparas,1,0,36,35
1657957347115,MATH 20B,A03,093475,Briones; Jor-el Thomas Caparas,3,0,36,33
1657957353143,MATH 20C,A01,083760,Briones; Jor-el Thomas Caparas,1,0,35,34
1657957353143,MATH 20C,A02,083761,Briones; Jor-el Thomas Caparas,8,0,35,27
1657957353143,MATH 20C,A03,093476,Briones; Jor-el Thomas Caparas,0,1,36,36
1657957353143,MATH 20C,B01,083762,Bach; Quang Tran,1,0,30,29
1657957359169,MATH 20D,A01,083765,Tran; Brian Kha,5,0,30,25
1657957359169,MATH 20D,A02,083766,Tran; Brian Kha,5,0,30,25
1657957359169,MATH 20D,A03,083767,Tran; Brian Kha,6,0,30,24
1657957365204,MATH 20E,A01,083771,Ganguly; Soumya,12,0,32,20
1657957365204,MATH 20E,A02,083772,Ganguly; Soumya,7,0,32,25
1657957365204,MATH 20E,B01,083773,Ciotti; Benjamin,20,0,35,15
1657957365204,MATH 20E,B02,083774,Ciotti; Benjamin,18,0,35,17
1657957371243,MATH 103A,A01,083777,Greenfeld; Be'Eri,6,0,36,30
1657957371243,MATH 103A,A02,083778,Greenfeld; Be'Eri,5,0,36,31
1657957371243,MATH 103A,A03,093561,Greenfeld; Be'Eri,7,0,36,29
1657957371243,MATH 103A,B01,083779,Greenfeld; Be'Eri,8,0,36,28
1657957371243,MATH 103A,B02,083780,Greenfeld; Be'Eri,4,0,36,32
1657957371243,MATH 103A,B03,093562,Greenfeld; Be'Eri,3,0,36,33
1657957377270,MATH 105,A01,085443,Carter; Anne Toulson,15,0,35,20
1657957377270,MATH 105,A02,093477,Carter; Anne Toulson,20,0,35,15
1657957383308,MATH 109,A01,083213,Ganzberger; Geoffrey Michael,3,0,34,31
1657957383308,MATH 109,A02,083214,Ganzberger; Geoffrey Michael,4,0,34,30
1657957383308,MATH 109,A03,093478,Ganzberger; Geoffrey Michael,2,0,34,32
1657957383308,MATH 109,B01,083215,Ganzberger; Geoffrey Michael,3,0,32,29
1657957383308,MATH 109,B02,083216,Ganzberger; Geoffrey Michael,3,0,32,29
1657957383308,MATH 109,B03,093479,Ganzberger; Geoffrey Michael,8,0,32,24
1657957389343,MATH 142A,A01,083219,Chow; Bennett,7,0,32,25
1657957389343,MATH 142A,A02,083220,Chow; Bennett,10,0,32,22
1657957389343,MATH 142A,A03,093480,Chow; Bennett,9,0,32,23
1657957389343,MATH 142A,B03,093481,Chow; Bennett,8,0,32,24
1657957389343,MATH 142A,B04,093558,Chow; Bennett,14,0,32,18
1657957389343,MATH 142A,B05,093559,Chow; Bennett,7,0,32,25
1657957395376,MATH 193A,A01,083224,Rotar; Vladimir,9,0,34,25
1657957395376,MATH 193A,A02,083225,Rotar; Vladimir,11,0,34,23
1657957395376,MATH 193A,A03,083781,Rotar; Vladimir,5,0,34,29
1657957395376,MATH 193A,A04,083782,Rotar; Vladimir,12,0,34,22
1657957395376,MATH 193A,A05,093482,Rotar; Vladimir,11,0,34,23
1657957401400,MATH 197,001,091859,McAuley; Julian John,9999,0,9999,0
1657957401400,MATH 197,002,095566,Kedlaya; Kiran S.,9997,0,9999,2
1657957401400,MATH 197,003,095567,Xiao; Ming,9999,0,9999,0
1657957401400,MATH 197,004,095571,Perols; Johan Lars,9998,0,9999,1
1657957408487,COGS 9,A01,083615,Shannon; Kyle Michael,11,0,75,64
1657957414540,COGS 11,A01,083617,Boyle; Mary E. T.,23,0,48,25
1657957420571,COGS 13,A01,083071,Bastos; Amalia Pinkusfeld,12,0,71,59
1657957426596,COGS 14A,A01,092681,Semenuks; Arturs,5,1,100,95
1657957432620,COGS 14B,A01,083073,Cheng; Tzu-Han,7,0,63,56
1657957438647,COGS 17,A01,092677,Semenuks; Arturs,7,0,81,74
1657957444672,COGS 100,A01,083619,Allen; Michael Gordon,17,0,70,53
1657957450697,COGS 101A,A01,083621,Davis; Joshua Daniel,9,0,68,59
1657957456721,COGS 101B,A01,091572,Allen; Michael Gordon,14,0,65,51
1657957462750,COGS 101C,A01,083625,Delgado; Tania,17,0,35,18
1657957468780,COGS 107A,A01,083627,Boyle; Mary E. T.,14,0,60,46
1657957474805,COGS 118A,A01,083075,Gupta; Anjum,21,0,76,55
1657957480831,CSE 3,A50,083646,Miranda; Gregory Joseph,24,0,50,26
1657957486856,CSE 8A,A50,083650,Miranda; Gregory Joseph,17,1,56,39
1657957492880,CSE 11,A01,083080,Cao; Yingjun,7,15,40,33
1657957498909,CSE 12,A01,083652,Krause-Levy; Sophia Louisa,30,1,120,90
1657957504937,CSE 15L,A01,083654,Morris; Justin Loren,9,0,50,41
1657957504937,CSE 15L,A02,083655,Morris; Justin Loren,11,0,50,39
1657957510966,CSE 20,A01,083657,Tran; Khoa Dang,39,0,80,41
1657957516995,CSE 21,A01,095574,Bach; Quang Tran,23,0,48,25
1657957523021,CSE 30,A01,083084,Eldon; John,8,0,80,72
1657957523021,CSE 30,B01,095061,Bhaskar; Nishant,9,0,50,41
1657957529056,CSE 100,A01,083659,Cao; Yingjun,5,4,70,65
1657957535081,CSE 134B,A01,083661,Powell; Thomas Allan,25,0,100,75
1657957541106,CSE 140,A01,083663,Gungor; Onat,17,0,85,68
1657957547137,CSE 140L,A01,083088,Eldon; John,23,0,100,77
1657957553161,CSE 175,A01,083665,Kumar; Rakesh,3,0,25,22
1657957559187,CSE 190,A00,092507,Dubnov; Shlomo,8,0,20,12
1657957565222,ECE 45,A01,083139,Congero; Spencer William,7,0,75,68
1657957571247,ECE 65,A50,083695,Saad; Andrew S,12,0,30,18
1657957571247,ECE 65,A51,095125,Saad; Andrew S,24,0,26,2
1657957577279,ECE 109,A01,091882,Touri; Behrouz,21,0,70,49
1657957583315,ECE 180,A00,083140,Abi Samra; Nicholas Camill,1,0,30,29
1657957583315,ECE 180,B00,083141,Abi Samra; Nicholas Camill,0,0,30,30
1657957589354,MATH 10A,A01,083735,Patchell; Gregory David,2,0,30,28
1657957589354,MATH 10A,A02,083736,Patchell; Gregory David,20,0,30,10
1657957589354,MATH 10A,A03,083737,Patchell; Gregory David,16,0,30,14
1657957595404,MATH 10B,A01,083207,Lim; Seonhee,9,0,34,25
1657957595404,MATH 10B,A02,083208,Lim; Seonhee,10,0,35,25
1657957595404,MATH 10B,A03,093472,Lim; Seonhee,7,0,34,27
1657957595404,MATH 10B,B01,083739,Sinha; Shubham,14,0,30,16
1657957601440,MATH 18,A01,083743,Cinel; Cameron Alexander,9,0,30,21
1657957601440,MATH 18,A02,083744,Cinel; Cameron Alexander,18,0,30,12
1657957601440,MATH 18,A03,083745,Cinel; Cameron Alexander,10,0,30,20
1657957601440,MATH 18,B01,083748,Rideout; David Porter,5,0,37,32
1657957601440,MATH 18,B02,083749,Rideout; David Porter,5,0,36,31
1657957601440,MATH 18,B03,083750,Rideout; David Porter,3,0,37,34
1657957601440,MATH 18,B04,083751,Rideout; David Porter,7,0,36,29
1657957601440,MATH 18,B05,093473,Rideout; David Porter,7,0,36,29
1657957601440,MATH 18,B06,093474,Rideout; David Porter,6,0,36,30
1657957607465,MATH 20A,A01,083754,Zheng; Zequn,14,0,40,26
1657957613493,MATH 20B,A01,083756,Briones; Jor-el Thomas Caparas,4,0,36,32
1657957613493,MATH 20B,A02,083757,Briones; Jor-el Thomas Caparas,1,0,36,35
1657957613493,MATH 20B,A03,093475,Briones; Jor-el Thomas Caparas,3,0,36,33
1657957619538,MATH 20C,A01,083760,Briones; Jor-el Thomas Caparas,1,0,35,34
1657957619538,MATH 20C,A02,083761,Briones; Jor-el Thomas Caparas,8,0,35,27
1657957619538,MATH 20C,A03,093476,Briones; Jor-el Thomas Caparas,0,1,36,36
1657957619538,MATH 20C,B01,083762,Bach; Quang Tran,1,0,30,29
1657957625564,MATH 20D,A01,083765,Tran; Brian Kha,5,0,30,25
1657957625564,MATH 20D,A02,083766,Tran; Brian Kha,5,0,30,25
1657957625564,MATH 20D,A03,083767,Tran; Brian Kha,6,0,30,24
1657957631590,MATH 20E,A01,083771,Ganguly; Soumya,12,0,32,20
1657957631590,MATH 20E,A02,083772,Ganguly; Soumya,7,0,32,25
1657957631590,MATH 20E,B01,083773,Ciotti; Benjamin,20,0,35,15
1657957631590,MATH 20E,B02,083774,Ciotti; Benjamin,18,0,35,17
1657957637619,MATH 103A,A01,083777,Greenfeld; Be'Eri,6,0,36,30
1657957637619,MATH 103A,A02,083778,Greenfeld; Be'Eri,5,0,36,31
1657957637619,MATH 103A,A03,093561,Greenfeld; Be'Eri,7,0,36,29
1657957637619,MATH 103A,B01,083779,Greenfeld; Be'Eri,8,0,36,28
1657957637619,MATH 103A,B02,083780,Greenfeld; Be'Eri,4,0,36,32
1657957637619,MATH 103A,B03,093562,Greenfeld; Be'Eri,3,0,36,33
1657957643646,MATH 105,A01,085443,Carter; Anne Toulson,15,0,35,20
1657957643646,MATH 105,A02,093477,Carter; Anne Toulson,20,0,35,15
1657957649687,MATH 109,A01,083213,Ganzberger; Geoffrey Michael,3,0,34,31
1657957649687,MATH 109,A02,083214,Ganzberger; Geoffrey Michael,4,0,34,30
1657957649687,MATH 109,A03,093478,Ganzberger; Geoffrey Michael,2,0,34,32
1657957649687,MATH 109,B01,083215,Ganzberger; Geoffrey Michael,3,0,32,29
1657957649687,MATH 109,B02,083216,Ganzberger; Geoffrey Michael,3,0,32,29
1657957649687,MATH 109,B03,093479,Ganzberger; Geoffrey Michael,8,0,32,24
1657957655714,MATH 142A,A01,083219,Chow; Bennett,7,0,32,25
1657957655714,MATH 142A,A02,083220,Chow; Bennett,10,0,32,22
1657957655714,MATH 142A,A03,093480,Chow; Bennett,9,0,32,23
1657957655714,MATH 142A,B03,093481,Chow; Bennett,8,0,32,24
1657957655714,MATH 142A,B04,093558,Chow; Bennett,14,0,32,18
1657957655714,MATH 142A,B05,093559,Chow; Bennett,7,0,32,25
1657957661741,MATH 193A,A01,083224,Rotar; Vladimir,9,0,34,25
1657957661741,MATH 193A,A02,083225,Rotar; Vladimir,11,0,34,23
1657957661741,MATH 193A,A03,083781,Rotar; Vladimir,5,0,34,29
1657957661741,MATH 193A,A04,083782,Rotar; Vladimir,12,0,34,22
1657957661741,MATH 193A,A05,093482,Rotar; Vladimir,11,0,34,23
1657957667772,MATH 197,001,091859,McAuley; Julian John,9999,0,9999,0
1657957667772,MATH 197,002,095566,Kedlaya; Kiran S.,9997,0,9999,2
1657957667772,MATH 197,003,095567,Xiao; Ming,9999,0,9999,0
1657957667772,MATH 197,004,095571,Perols; Johan Lars,9998,0,9999,1
1657957674876,COGS 9,A01,083615,Shannon; Kyle Michael,11,0,75,64
1657957680908,COGS 11,A01,083617,Boyle; Mary E. T.,23,0,48,25
1657957686937,COGS 13,A01,083071,Bastos; Amalia Pinkusfeld,12,0,71,59
1657957692962,COGS 14A,A01,092681,Semenuks; Arturs,5,1,100,95
1657957699009,COGS 14B,A01,083073,Cheng; Tzu-Han,7,0,63,56
1657957705037,COGS 17,A01,092677,Semenuks; Arturs,7,0,81,74
1657957711069,COGS 100,A01,083619,Allen; Michael Gordon,17,0,70,53
1657957717095,COGS 101A,A01,083621,Davis; Joshua Daniel,9,0,68,59
1657957723122,COGS 101B,A01,091572,Allen; Michael Gordon,14,0,65,51
1657957729153,COGS 101C,A01,083625,Delgado; Tania,17,0,35,18
1657957735179,COGS 107A,A01,083627,Boyle; Mary E. T.,14,0,60,46
1657957741204,COGS 118A,A01,083075,Gupta; Anjum,21,0,76,55
1657957747229,CSE 3,A50,083646,Miranda; Gregory Joseph,24,0,50,26
1657957753258,CSE 8A,A50,083650,Miranda; Gregory Joseph,17,1,56,39
1657957759284,CSE 11,A01,083080,Cao; Yingjun,7,15,40,33
1657957765314,CSE 12,A01,083652,Krause-Levy; Sophia Louisa,30,1,120,90
1657957771346,CSE 15L,A01,083654,Morris; Justin Loren,9,0,50,41
1657957771346,CSE 15L,A02,083655,Morris; Justin Loren,11,0,50,39
1657957777373,CSE 20,A01,083657,Tran; Khoa Dang,39,0,80,41
1657957783406,CSE 21,A01,095574,Bach; Quang Tran,23,0,48,25
1657957789433,CSE 30,A01,083084,Eldon; John,8,0,80,72
1657957789433,CSE 30,B01,095061,Bhaskar; Nishant,9,0,50,41
1657957795465,CSE 100,A01,083659,Cao; Yingjun,5,4,70,65
1657957801494,CSE 134B,A01,083661,Powell; Thomas Allan,25,0,100,75
1657957807523,CSE 140,A01,083663,Gungor; Onat,17,0,85,68
1657957813554,CSE 140L,A01,083088,Eldon; John,23,0,100,77
1657957819580,CSE 175,A01,083665,Kumar; Rakesh,3,0,25,22
1657957825604,CSE 190,A00,092507,Dubnov; Shlomo,8,0,20,12
1657957831631,ECE 45,A01,083139,Congero; Spencer William,7,0,75,68
1657957837657,ECE 65,A50,083695,Saad; Andrew S,12,0,30,18
1657957837657,ECE 65,A51,095125,Saad; Andrew S,24,0,26,2
1657957843682,ECE 109,A01,091882,Touri; Behrouz,21,0,70,49
1657957849709,ECE 180,A00,083140,Abi Samra; Nicholas Camill,1,0,30,29
1657957849709,ECE 180,B00,083141,Abi Samra; Nicholas Camill,0,0,30,30
1657957855741,MATH 10A,A01,083735,Patchell; Gregory David,2,0,30,28
1657957855741,MATH 10A,A02,083736,Patchell; Gregory David,20,0,30,10
1657957855741,MATH 10A,A03,083737,Patchell; Gregory David,16,0,30,14
1657957861771,MATH 10B,A01,083207,Lim; Seonhee,9,0,34,25
1657957861771,MATH 10B,A02,083208,Lim; Seonhee,10,0,35,25
1657957861771,MATH 10B,A03,093472,Lim; Seonhee,7,0,34,27
1657957861771,MATH 10B,B01,083739,Sinha; Shubham,14,0,30,16
1657957867812,MATH 18,A01,083743,Cinel; Cameron Alexander,9,0,30,21
1657957867812,MATH 18,A02,083744,Cinel; Cameron Alexander,18,0,30,12
1657957867812,MATH 18,A03,083745,Cinel; Cameron Alexander,10,0,30,20
1657957867812,MATH 18,B01,083748,Rideout; David Porter,5,0,37,32
1657957867812,MATH 18,B02,083749,Rideout; David Porter,5,0,36,31
1657957867812,MATH 18,B03,083750,Rideout; David Porter,3,0,37,34
1657957867812,MATH 18,B04,083751,Rideout; David Porter,7,0,36,29
1657957867812,MATH 18,B05,093473,Rideout; David Porter,7,0,36,29
1657957867812,MATH 18,B06,093474,Rideout; David Porter,6,0,36,30
1657957873836,MATH 20A,A01,083754,Zheng; Zequn,14,0,40,26
1657957879872,MATH 20B,A01,083756,Briones; Jor-el Thomas Caparas,4,0,36,32
1657957879872,MATH 20B,A02,083757,Briones; Jor-el Thomas Caparas,1,0,36,35
1657957879872,MATH 20B,A03,093475,Briones; Jor-el Thomas Caparas,3,0,36,33
1657957885903,MATH 20C,A01,083760,Briones; Jor-el Thomas Caparas,1,0,35,34
1657957885903,MATH 20C,A02,083761,Briones; Jor-el Thomas Caparas,8,0,35,27
1657957885903,MATH 20C,A03,093476,Briones; Jor-el Thomas Caparas,0,1,36,36
1657957885903,MATH 20C,B01,083762,Bach; Quang Tran,1,0,30,29
1657957891929,MATH 20D,A01,083765,Tran; Brian Kha,5,0,30,25
1657957891929,MATH 20D,A02,083766,Tran; Brian Kha,5,0,30,25
1657957891929,MATH 20D,A03,083767,Tran; Brian Kha,6,0,30,24
1657957897960,MATH 20E,A01,083771,Ganguly; Soumya,12,0,32,20
1657957897960,MATH 20E,A02,083772,Ganguly; Soumya,7,0,32,25
1657957897960,MATH 20E,B01,083773,Ciotti; Benjamin,20,0,35,15
1657957897960,MATH 20E,B02,083774,Ciotti; Benjamin,18,0,35,17
1657957903991,MATH 103A,A01,083777,Greenfeld; Be'Eri,6,0,36,30
1657957903991,MATH 103A,A02,083778,Greenfeld; Be'Eri,5,0,36,31
1657957903991,MATH 103A,A03,093561,Greenfeld; Be'Eri,7,0,36,29
1657957903991,MATH 103A,B01,083779,Greenfeld; Be'Eri,8,0,36,28
1657957903991,MATH 103A,B02,083780,Greenfeld; Be'Eri,4,0,36,32
1657957903991,MATH 103A,B03,093562,Greenfeld; Be'Eri,3,0,36,33
1657957910018,MATH 105,A01,085443,Carter; Anne Toulson,15,0,35,20
1657957910018,MATH 105,A02,093477,Carter; Anne Toulson,20,0,35,15
1657957916043,MATH 109,A01,083213,Ganzberger; Geoffrey Michael,3,0,34,31
1657957916043,MATH 109,A02,083214,Ganzberger; Geoffrey Michael,4,0,34,30
1657957916043,MATH 109,A03,093478,Ganzberger; Geoffrey Michael,2,0,34,32
1657957916043,MATH 109,B01,083215,Ganzberger; Geoffrey Michael,3,0,32,29
1657957916043,MATH 109,B02,083216,Ganzberger; Geoffrey Michael,3,0,32,29
1657957916043,MATH 109,B03,093479,Ganzberger; Geoffrey Michael,8,0,32,24
1657957922070,MATH 142A,A01,083219,Chow; Bennett,7,0,32,25
1657957922070,MATH 142A,A02,083220,Chow; Bennett,10,0,32,22
1657957922070,MATH 142A,A03,093480,Chow; Bennett,9,0,32,23
1657957922070,MATH 142A,B03,093481,Chow; Bennett,8,0,32,24
1657957922070,MATH 142A,B04,093558,Chow; Bennett,14,0,32,18
1657957922070,MATH 142A,B05,093559,Chow; Bennett,7,0,32,25
1657957928104,MATH 193A,A01,083224,Rotar; Vladimir,9,0,34,25
1657957928104,MATH 193A,A02,083225,Rotar; Vladimir,11,0,34,23
1657957928104,MATH 193A,A03,083781,Rotar; Vladimir,5,0,34,29
1657957928104,MATH 193A,A04,083782,Rotar; Vladimir,12,0,34,22
1657957928104,MATH 193A,A05,093482,Rotar; Vladimir,11,0,34,23
1657957934135,MATH 197,001,091859,McAuley; Julian John,9999,0,9999,0
1657957934135,MATH 197,002,095566,Kedlaya; Kiran S.,9997,0,9999,2
1657957934135,MATH 197,003,095567,Xiao; Ming,9999,0,9999,0
1657957934135,MATH 197,004,095571,Perols; Johan Lars,9998,0,9999,1
1657957941298,COGS 9,A01,083615,Shannon; Kyle Michael,11,0,75,64
1657957947322,COGS 11,A01,083617,Boyle; Mary E. T.,23,0,48,25
1657957953347,COGS 13,A01,083071,Bastos; Amalia Pinkusfeld,12,0,71,59
1657957959372,COGS 14A,A01,092681,Semenuks; Arturs,5,1,100,95
1657957965397,COGS 14B,A01,083073,Cheng; Tzu-Han,7,0,63,56
1657957971423,COGS 17,A01,092677,Semenuks; Arturs,7,0,81,74
1657957977449,COGS 100,A01,083619,Allen; Michael Gordon,17,0,70,53
1657957983486,COGS 101A,A01,083621,Davis; Joshua Daniel,9,0,68,59
1657957989516,COGS 101B,A01,091572,Allen; Michael Gordon,14,0,65,51
1657957995549,COGS 101C,A01,083625,Delgado; Tania,17,0,35,18
1657958001580,COGS 107A,A01,083627,Boyle; Mary E. T.,14,0,60,46
1657958007606,COGS 118A,A01,083075,Gupta; Anjum,21,0,76,55
1657958013635,CSE 3,A50,083646,Miranda; Gregory Joseph,24,0,50,26
1657958019659,CSE 8A,A50,083650,Miranda; Gregory Joseph,17,1,56,39
1657958025684,CSE 11,A01,083080,Cao; Yingjun,7,15,40,33
1657958031710,CSE 12,A01,083652,Krause-Levy; Sophia Louisa,30,1,120,90
1657958037735,CSE 15L,A01,083654,Morris; Justin Loren,9,0,50,41
1657958037735,CSE 15L,A02,083655,Morris; Justin Loren,11,0,50,39
1657958043765,CSE 20,A01,083657,Tran; Khoa Dang,39,0,80,41
1657958049795,CSE 21,A01,095574,Bach; Quang Tran,23,0,48,25
1657958055823,CSE 30,A01,083084,Eldon; John,8,0,80,72
1657958055823,CSE 30,B01,095061,Bhaskar; Nishant,9,0,50,41
1657958061857,CSE 100,A01,083659,Cao; Yingjun,5,4,70,65
1657958067887,CSE 134B,A01,083661,Powell; Thomas Allan,25,0,100,75
1657958073913,CSE 140,A01,083663,Gungor; Onat,17,0,85,68
1657958079937,CSE 140L,A01,083088,Eldon; John,23,0,100,77
1657958085967,CSE 175,A01,083665,Kumar; Rakesh,3,0,25,22
1657958091994,CSE 190,A00,092507,Dubnov; Shlomo,8,0,20,12
1657958098019,ECE 45,A01,083139,Congero; Spencer William,7,0,75,68
1657958104043,ECE 65,A50,083695,Saad; Andrew S,12,0,30,18
1657958104043,ECE 65,A51,095125,Saad; Andrew S,24,0,26,2
1657958110068,ECE 109,A01,091882,Touri; Behrouz,21,0,70,49
1657958116091,ECE 180,A00,083140,Abi Samra; Nicholas Camill,1,0,30,29
1657958116091,ECE 180,B00,083141,Abi Samra; Nicholas Camill,0,0,30,30
1657958122122,MATH 10A,A01,083735,Patchell; Gregory David,2,0,30,28
1657958122122,MATH 10A,A02,083736,Patchell; Gregory David,20,0,30,10
1657958122122,MATH 10A,A03,083737,Patchell; Gregory David,16,0,30,14
1657958128149,MATH 10B,A01,083207,Lim; Seonhee,9,0,34,25
1657958128149,MATH 10B,A02,083208,Lim; Seonhee,10,0,35,25
1657958128149,MATH 10B,A03,093472,Lim; Seonhee,7,0,34,27
1657958128149,MATH 10B,B01,083739,Sinha; Shubham,14,0,30,16
1657958134184,MATH 18,A01,083743,Cinel; Cameron Alexander,9,0,30,21
1657958134184,MATH 18,A02,083744,Cinel; Cameron Alexander,18,0,30,12
1657958134184,MATH 18,A03,083745,Cinel; Cameron Alexander,10,0,30,20
1657958134184,MATH 18,B01,083748,Rideout; David Porter,5,0,37,32
1657958134184,MATH 18,B02,083749,Rideout; David Porter,5,0,36,31
1657958134184,MATH 18,B03,083750,Rideout; David Porter,3,0,37,34
1657958134184,MATH 18,B04,083751,Rideout; David Porter,7,0,36,29
1657958134184,MATH 18,B05,093473,Rideout; David Porter,7,0,36,29
1657958134184,MATH 18,B06,093474,Rideout; David Porter,6,0,36,30
1657958140213,MATH 20A,A01,083754,Zheng; Zequn,14,0,40,26
1657958146244,MATH 20B,A01,083756,Briones; Jor-el Thomas Caparas,4,0,36,32
1657958146244,MATH 20B,A02,083757,Briones; Jor-el Thomas Caparas,1,0,36,35
1657958146244,MATH 20B,A03,093475,Briones; Jor-el Thomas Caparas,3,0,36,33
1657958152282,MATH 20C,A01,083760,Briones; Jor-el Thomas Caparas,1,0,35,34
1657958152282,MATH 20C,A02,083761,Briones; Jor-el Thomas Caparas,8,0,35,27
1657958152282,MATH 20C,A03,093476,Briones; Jor-el Thomas Caparas,0,1,36,36
1657958152282,MATH 20C,B01,083762,Bach; Quang Tran,1,0,30,29
1657958158306,MATH 20D,A01,083765,Tran; Brian Kha,5,0,30,25
1657958158306,MATH 20D,A02,083766,Tran; Brian Kha,5,0,30,25
1657958158306,MATH 20D,A03,083767,Tran; Brian Kha,6,0,30,24
1657958164333,MATH 20E,A01,083771,Ganguly; Soumya,12,0,32,20
1657958164333,MATH 20E,A02,083772,Ganguly; Soumya,7,0,32,25
1657958164333,MATH 20E,B01,083773,Ciotti; Benjamin,20,0,35,15
1657958164333,MATH 20E,B02,083774,Ciotti; Benjamin,18,0,35,17
1657958170357,MATH 103A,A01,083777,Greenfeld; Be'Eri,6,0,36,30
1657958170357,MATH 103A,A02,083778,Greenfeld; Be'Eri,5,0,36,31
1657958170357,MATH 103A,A03,093561,Greenfeld; Be'Eri,7,0,36,29
1657958170357,MATH 103A,B01,083779,Greenfeld; Be'Eri,8,0,36,28
1657958170357,MATH 103A,B02,083780,Greenfeld; Be'Eri,4,0,36,32
1657958170357,MATH 103A,B03,093562,Greenfeld; Be'Eri,3,0,36,33
1657958176383,MATH 105,A01,085443,Carter; Anne Toulson,15,0,35,20
1657958176383,MATH 105,A02,093477,Carter; Anne Toulson,20,0,35,15
1657958182408,MATH 109,A01,083213,Ganzberger; Geoffrey Michael,3,0,34,31
1657958182408,MATH 109,A02,083214,Ganzberger; Geoffrey Michael,4,0,34,30
1657958182408,MATH 109,A03,093478,Ganzberger; Geoffrey Michael,2,0,34,32
1657958182408,MATH 109,B01,083215,Ganzberger; Geoffrey Michael,3,0,32,29
1657958182408,MATH 109,B02,083216,Ganzberger; Geoffrey Michael,3,0,32,29
1657958182408,MATH 109,B03,093479,Ganzberger; Geoffrey Michael,8,0,32,24
1657958188439,MATH 142A,A01,083219,Chow; Bennett,7,0,32,25
1657958188439,MATH 142A,A02,083220,Chow; Bennett,10,0,32,22
1657958188439,MATH 142A,A03,093480,Chow; Bennett,9,0,32,23
1657958188439,MATH 142A,B03,093481,Chow; Bennett,8,0,32,24
1657958188439,MATH 142A,B04,093558,Chow; Bennett,14,0,32,18
1657958188439,MATH 142A,B05,093559,Chow; Bennett,7,0,32,25
1657958194465,MATH 193A,A01,083224,Rotar; Vladimir,9,0,34,25
1657958194465,MATH 193A,A02,083225,Rotar; Vladimir,11,0,34,23
1657958194465,MATH 193A,A03,083781,Rotar; Vladimir,5,0,34,29
1657958194465,MATH 193A,A04,083782,Rotar; Vladimir,12,0,34,22
1657958194465,MATH 193A,A05,093482,Rotar; Vladimir,11,0,34,23
1657958200488,MATH 197,001,091859,McAuley; Julian John,9999,0,9999,0
1657958200488,MATH 197,002,095566,Kedlaya; Kiran S.,9997,0,9999,2
1657958200488,MATH 197,003,095567,Xiao; Ming,9999,0,9999,0
1657958200488,MATH 197,004,095571,Perols; Johan Lars,9998,0,9999,1
1657958207548,COGS 9,A01,083615,Shannon; Kyle Michael,11,0,75,64
1657958213573,COGS 11,A01,083617,Boyle; Mary E. T.,23,0,48,25
1657958219599,COGS 13,A01,083071,Bastos; Amalia Pinkusfeld,12,0,71,59
1657958225624,COGS 14A,A01,092681,Semenuks; Arturs,5,1,100,95
1657958231650,COGS 14B,A01,083073,Cheng; Tzu-Han,7,0,63,56
1657958237676,COGS 17,A01,092677,Semenuks; Arturs,7,0,81,74
1657958243706,COGS 100,A01,083619,Allen; Michael Gordon,17,0,70,53
1657958249735,COGS 101A,A01,083621,Davis; Joshua Daniel,9,0,68,59
1657958255763,COGS 101B,A01,091572,Allen; Michael Gordon,14,0,65,51
1657958261788,COGS 101C,A01,083625,Delgado; Tania,17,0,35,18
1657958267811,COGS 107A,A01,083627,Boyle; Mary E. T.,14,0,60,46
1657958273841,COGS 118A,A01,083075,Gupta; Anjum,21,0,76,55
1657958279876,CSE 3,A50,083646,Miranda; Gregory Joseph,24,0,50,26
1657958285901,CSE 8A,A50,083650,Miranda; Gregory Joseph,17,1,56,39
1657958291927,CSE 11,A01,083080,Cao; Yingjun,7,15,40,33
1657958297951,CSE 12,A01,083652,Krause-Levy; Sophia Louisa,30,1,120,90
1657958303974,CSE 15L,A01,083654,Morris; Justin Loren,9,0,50,41
1657958303974,CSE 15L,A02,083655,Morris; Justin Loren,11,0,50,39
1657958310003,CSE 20,A01,083657,Tran; Khoa Dang,39,0,80,41
1657958316034,CSE 21,A01,095574,Bach; Quang Tran,23,0,48,25
1657958322059,CSE 30,A01,083084,Eldon; John,8,0,80,72
1657958322059,CSE 30,B01,095061,Bhaskar; Nishant,9,0,50,41
1657958328082,CSE 100,A01,083659,Cao; Yingjun,5,4,70,65
1657958334111,CSE 134B,A01,083661,Powell; Thomas Allan,25,0,100,75
1657958340138,CSE 140,A01,083663,Gungor; Onat,17,0,85,68
1657958346163,CSE 140L,A01,083088,Eldon; John,23,0,100,77
1657958352186,CSE 175,A01,083665,Kumar; Rakesh,3,0,25,22
1657958358210,CSE 190,A00,092507,Dubnov; Shlomo,8,0,20,12
1657958364236,ECE 45,A01,083139,Congero; Spencer William,7,0,75,68
1657958370259,ECE 65,A50,083695,Saad; Andrew S,12,0,30,18
1657958370259,ECE 65,A51,095125,Saad; Andrew S,24,0,26,2
1657958376288,ECE 109,A01,091882,Touri; Behrouz,21,0,70,49
1657958382317,ECE 180,A00,083140,Abi Samra; Nicholas Camill,1,0,30,29
1657958382317,ECE 180,B00,083141,Abi Samra; Nicholas Camill,0,0,30,30
1657958388347,MATH 10A,A01,083735,Patchell; Gregory David,2,0,30,28
1657958388347,MATH 10A,A02,083736,Patchell; Gregory David,20,0,30,10
1657958388347,MATH 10A,A03,083737,Patchell; Gregory David,16,0,30,14
1657958394380,MATH 10B,A01,083207,Lim; Seonhee,9,0,34,25
1657958394380,MATH 10B,A02,083208,Lim; Seonhee,10,0,35,25
1657958394380,MATH 10B,A03,093472,Lim; Seonhee,7,0,34,27
1657958394380,MATH 10B,B01,083739,Sinha; Shubham,14,0,30,16
1657958400407,MATH 18,A01,083743,Cinel; Cameron Alexander,9,0,30,21
1657958400407,MATH 18,A02,083744,Cinel; Cameron Alexander,18,0,30,12
1657958400407,MATH 18,A03,083745,Cinel; Cameron Alexander,10,0,30,20
1657958400407,MATH 18,B01,083748,Rideout; David Porter,5,0,37,32
1657958400407,MATH 18,B02,083749,Rideout; David Porter,5,0,36,31
1657958400407,MATH 18,B03,083750,Rideout; David Porter,3,0,37,34
1657958400407,MATH 18,B04,083751,Rideout; David Porter,7,0,36,29
1657958400407,MATH 18,B05,093473,Rideout; David Porter,7,0,36,29
1657958400407,MATH 18,B06,093474,Rideout; David Porter,6,0,36,30
1657958406433,MATH 20A,A01,083754,Zheng; Zequn,14,0,40,26
1657958412458,MATH 20B,A01,083756,Briones; Jor-el Thomas Caparas,4,0,36,32
1657958412458,MATH 20B,A02,083757,Briones; Jor-el Thomas Caparas,1,0,36,35
1657958412458,MATH 20B,A03,093475,Briones; Jor-el Thomas Caparas,3,0,36,33
1657958418487,MATH 20C,A01,083760,Briones; Jor-el Thomas Caparas,1,0,35,34
1657958418487,MATH 20C,A02,083761,Briones; Jor-el Thomas Caparas,8,0,35,27
1657958418487,MATH 20C,A03,093476,Briones; Jor-el Thomas Caparas,0,1,36,36
1657958418487,MATH 20C,B01,083762,Bach; Quang Tran,1,0,30,29
1657958424513,MATH 20D,A01,083765,Tran; Brian Kha,5,0,30,25
1657958424513,MATH 20D,A02,083766,Tran; Brian Kha,5,0,30,25
1657958424513,MATH 20D,A03,083767,Tran; Brian Kha,6,0,30,24
1657958430540,MATH 20E,A01,083771,Ganguly; Soumya,12,0,32,20
1657958430540,MATH 20E,A02,083772,Ganguly; Soumya,7,0,32,25
1657958430540,MATH 20E,B01,083773,Ciotti; Benjamin,20,0,35,15
1657958430540,MATH 20E,B02,083774,Ciotti; Benjamin,18,0,35,17
1657958436570,MATH 103A,A01,083777,Greenfeld; Be'Eri,6,0,36,30
1657958436570,MATH 103A,A02,083778,Greenfeld; Be'Eri,5,0,36,31
1657958436570,MATH 103A,A03,093561,Greenfeld; Be'Eri,7,0,36,29
1657958436570,MATH 103A,B01,083779,Greenfeld; Be'Eri,8,0,36,28
1657958436570,MATH 103A,B02,083780,Greenfeld; Be'Eri,4,0,36,32
1657958436570,MATH 103A,B03,093562,Greenfeld; Be'Eri,3,0,36,33
1657958442604,MATH 105,A01,085443,Carter; Anne Toulson,15,0,35,20
1657958442604,MATH 105,A02,093477,Carter; Anne Toulson,20,0,35,15
1657958448630,MATH 109,A01,083213,Ganzberger; Geoffrey Michael,3,0,34,31
1657958448630,MATH 109,A02,083214,Ganzberger; Geoffrey Michael,4,0,34,30
1657958448630,MATH 109,A03,093478,Ganzberger; Geoffrey Michael,2,0,34,32
1657958448630,MATH 109,B01,083215,Ganzberger; Geoffrey Michael,3,0,32,29
1657958448630,MATH 109,B02,083216,Ganzberger; Geoffrey Michael,3,0,32,29
1657958448630,MATH 109,B03,093479,Ganzberger; Geoffrey Michael,8,0,32,24
1657958454691,MATH 142A,A01,083219,Chow; Bennett,7,0,32,25
1657958454691,MATH 142A,A02,083220,Chow; Bennett,10,0,32,22
1657958454691,MATH 142A,A03,093480,Chow; Bennett,9,0,32,23
1657958454691,MATH 142A,B03,093481,Chow; Bennett,8,0,32,24
1657958454691,MATH 142A,B04,093558,Chow; Bennett,14,0,32,18
1657958454691,MATH 142A,B05,093559,Chow; Bennett,7,0,32,25
1657958460725,MATH 193A,A01,083224,Rotar; Vladimir,9,0,34,25
1657958460725,MATH 193A,A02,083225,Rotar; Vladimir,11,0,34,23
1657958460725,MATH 193A,A03,083781,Rotar; Vladimir,5,0,34,29
1657958460725,MATH 193A,A04,083782,Rotar; Vladimir,12,0,34,22
1657958460725,MATH 193A,A05,093482,Rotar; Vladimir,11,0,34,23
1657958466763,MATH 197,001,091859,McAuley; Julian John,9999,0,9999,0
1657958466763,MATH 197,002,095566,Kedlaya; Kiran S.,9997,0,9999,2
1657958466763,MATH 197,003,095567,Xiao; Ming,9999,0,9999,0
1657958466763,MATH 197,004,095571,Perols; Johan Lars,9998,0,9999,1
1657958473854,COGS 9,A01,083615,Shannon; Kyle Michael,11,0,75,64
1657958479878,COGS 11,A01,083617,Boyle; Mary E. T.,23,0,48,25
1657958485903,COGS 13,A01,083071,Bastos; Amalia Pinkusfeld,12,0,71,59
1657958491929,COGS 14A,A01,092681,Semenuks; Arturs,5,1,100,95
1657958497952,COGS 14B,A01,083073,Cheng; Tzu-Han,7,0,63,56
1657958503978,COGS 17,A01,092677,Semenuks; Arturs,7,0,81,74
1657958510002,COGS 100,A01,083619,Allen; Michael Gordon,17,0,70,53
1657958516025,COGS 101A,A01,083621,Davis; Joshua Daniel,9,0,68,59
1657958522050,COGS 101B,A01,091572,Allen; Michael Gordon,14,0,65,51
1657958528093,COGS 101C,A01,083625,Delgado; Tania,17,0,35,18
1657958534222,COGS 107A,A01,083627,Boyle; Mary E. T.,14,0,60,46
1657958540246,COGS 118A,A01,083075,Gupta; Anjum,21,0,76,55
1657958546270,CSE 3,A50,083646,Miranda; Gregory Joseph,24,0,50,26
1657958552293,CSE 8A,A50,083650,Miranda; Gregory Joseph,17,1,56,39
1657958558317,CSE 11,A01,083080,Cao; Yingjun,7,15,40,33
1657958564342,CSE 12,A01,083652,Krause-Levy; Sophia Louisa,30,1,120,90
1657958570366,CSE 15L,A01,083654,Morris; Justin Loren,9,0,50,41
1657958570366,CSE 15L,A02,083655,Morris; Justin Loren,11,0,50,39
1657958576400,CSE 20,A01,083657,Tran; Khoa Dang,39,0,80,41
1657958582439,CSE 21,A01,095574,Bach; Quang Tran,23,0,48,25
1657958588500,CSE 30,A01,083084,Eldon; John,8,0,80,72
1657958588500,CSE 30,B01,095061,Bhaskar; Nishant,9,0,50,41
1657958594524,CSE 100,A01,083659,Cao; Yingjun,5,4,70,65
1657958600550,CSE 134B,A01,083661,Powell; Thomas Allan,25,0,100,75
1657958606575,CSE 140,A01,083663,Gungor; Onat,17,0,85,68
1657958612598,CSE 140L,A01,083088,Eldon; John,23,0,100,77
1657958618631,CSE 175,A01,083665,Kumar; Rakesh,3,0,25,22
1657958624658,CSE 190,A00,092507,Dubnov; Shlomo,8,0,20,12
1657958630683,ECE 45,A01,083139,Congero; Spencer William,7,0,75,68
1657958636709,ECE 65,A50,083695,Saad; Andrew S,12,0,30,18
1657958636709,ECE 65,A51,095125,Saad; Andrew S,24,0,26,2
1657958642734,ECE 109,A01,091882,Touri; Behrouz,21,0,70,49
1657958648762,ECE 180,A00,083140,Abi Samra; Nicholas Camill,1,0,30,29
1657958648762,ECE 180,B00,083141,Abi Samra; Nicholas Camill,0,0,30,30
1657958654792,MATH 10A,A01,083735,Patchell; Gregory David,2,0,30,28
1657958654792,MATH 10A,A02,083736,Patchell; Gregory David,20,0,30,10
1657958654792,MATH 10A,A03,083737,Patchell; Gregory David,16,0,30,14
1657958660824,MATH 10B,A01,083207,Lim; Seonhee,9,0,34,25
1657958660824,MATH 10B,A02,083208,Lim; Seonhee,10,0,35,25
1657958660824,MATH 10B,A03,093472,Lim; Seonhee,7,0,34,27
1657958660824,MATH 10B,B01,083739,Sinha; Shubham,14,0,30,16
1657958666861,MATH 18,A01,083743,Cinel; Cameron Alexander,9,0,30,21
1657958666861,MATH 18,A02,083744,Cinel; Cameron Alexander,18,0,30,12
1657958666861,MATH 18,A03,083745,Cinel; Cameron Alexander,10,0,30,20
1657958666861,MATH 18,B01,083748,Rideout; David Porter,5,0,37,32
1657958666861,MATH 18,B02,083749,Rideout; David Porter,5,0,36,31
1657958666861,MATH 18,B03,083750,Rideout; David Porter,3,0,37,34
1657958666861,MATH 18,B04,083751,Rideout; David Porter,7,0,36,29
1657958666861,MATH 18,B05,093473,Rideout; David Porter,7,0,36,29
1657958666861,MATH 18,B06,093474,Rideout; David Porter,6,0,36,30
1657958672884,MATH 20A,A01,083754,Zheng; Zequn,14,0,40,26
1657958678910,MATH 20B,A01,083756,Briones; Jor-el Thomas Caparas,4,0,36,32
1657958678910,MATH 20B,A02,083757,Briones; Jor-el Thomas Caparas,1,0,36,35
1657958678910,MATH 20B,A03,093475,Briones; Jor-el Thomas Caparas,3,0,36,33
1657958684944,MATH 20C,A01,083760,Briones; Jor-el Thomas Caparas,1,0,35,34
1657958684944,MATH 20C,A02,083761,Briones; Jor-el Thomas Caparas,8,0,35,27
1657958684944,MATH 20C,A03,093476,Briones; Jor-el Thomas Caparas,0,1,36,36
1657958684944,MATH 20C,B01,083762,Bach; Quang Tran,1,0,30,29
1657958690967,MATH 20D,A01,083765,Tran; Brian Kha,5,0,30,25
1657958690967,MATH 20D,A02,083766,Tran; Brian Kha,5,0,30,25
1657958690967,MATH 20D,A03,083767,Tran; Brian Kha,6,0,30,24
1657958697002,MATH 20E,A01,083771,Ganguly; Soumya,12,0,32,20
1657958697002,MATH 20E,A02,083772,Ganguly; Soumya,7,0,32,25
1657958697002,MATH 20E,B01,083773,Ciotti; Benjamin,20,0,35,15
1657958697002,MATH 20E,B02,083774,Ciotti; Benjamin,18,0,35,17
1657958703036,MATH 103A,A01,083777,Greenfeld; Be'Eri,6,0,36,30
1657958703036,MATH 103A,A02,083778,Greenfeld; Be'Eri,5,0,36,31
1657958703036,MATH 103A,A03,093561,Greenfeld; Be'Eri,7,0,36,29
1657958703036,MATH 103A,B01,083779,Greenfeld; Be'Eri,8,0,36,28
1657958703036,MATH 103A,B02,083780,Greenfeld; Be'Eri,4,0,36,32
1657958703036,MATH 103A,B03,093562,Greenfeld; Be'Eri,3,0,36,33
1657958709069,MATH 105,A01,085443,Carter; Anne Toulson,15,0,35,20
1657958709069,MATH 105,A02,093477,Carter; Anne Toulson,20,0,35,15
1657958715095,MATH 109,A01,083213,Ganzberger; Geoffrey Michael,3,0,34,31
1657958715095,MATH 109,A02,083214,Ganzberger; Geoffrey Michael,4,0,34,30
1657958715095,MATH 109,A03,093478,Ganzberger; Geoffrey Michael,2,0,34,32
1657958715095,MATH 109,B01,083215,Ganzberger; Geoffrey Michael,3,0,32,29
1657958715095,MATH 109,B02,083216,Ganzberger; Geoffrey Michael,3,0,32,29
1657958715095,MATH 109,B03,093479,Ganzberger; Geoffrey Michael,8,0,32,24
1657958721129,MATH 142A,A01,083219,Chow; Bennett,7,0,32,25
1657958721129,MATH 142A,A02,083220,Chow; Bennett,10,0,32,22
1657958721129,MATH 142A,A03,093480,Chow; Bennett,9,0,32,23
1657958721129,MATH 142A,B03,093481,Chow; Bennett,8,0,32,24
1657958721129,MATH 142A,B04,093558,Chow; Bennett,14,0,32,18
1657958721129,MATH 142A,B05,093559,Chow; Bennett,7,0,32,25
1657958727173,MATH 193A,A01,083224,Rotar; Vladimir,9,0,34,25
1657958727173,MATH 193A,A02,083225,Rotar; Vladimir,11,0,34,23
1657958727173,MATH 193A,A03,083781,Rotar; Vladimir,5,0,34,29
1657958727173,MATH 193A,A04,083782,Rotar; Vladimir,12,0,34,22
1657958727173,MATH 193A,A05,093482,Rotar; Vladimir,11,0,34,23
1657958733201,MATH 197,001,091859,McAuley; Julian John,9999,0,9999,0
1657958733201,MATH 197,002,095566,Kedlaya; Kiran S.,9997,0,9999,2
1657958733201,MATH 197,003,095567,Xiao; Ming,9999,0,9999,0
1657958733201,MATH 197,004,095571,Perols; Johan Lars,9998,0,9999,1
1657958740282,COGS 9,A01,083615,Shannon; Kyle Michael,11,0,75,64
1657958746321,COGS 11,A01,083617,Boyle; Mary E. T.,23,0,48,25
1657958752351,COGS 13,A01,083071,Bastos; Amalia Pinkusfeld,12,0,71,59
1657958758377,COGS 14A,A01,092681,Semenuks; Arturs,5,1,100,95
1657958764404,COGS 14B,A01,083073,Cheng; Tzu-Han,7,0,63,56
1657958770430,COGS 17,A01,092677,Semenuks; Arturs,7,0,81,74
1657958776465,COGS 100,A01,083619,Allen; Michael Gordon,17,0,70,53
1657958782493,COGS 101A,A01,083621,Davis; Joshua Daniel,9,0,68,59
1657958788539,COGS 101B,A01,091572,Allen; Michael Gordon,14,0,65,51
1657958794564,COGS 101C,A01,083625,Delgado; Tania,17,0,35,18
1657958800597,COGS 107A,A01,083627,Boyle; Mary E. T.,14,0,60,46
1657958806626,COGS 118A,A01,083075,Gupta; Anjum,21,0,76,55
1657958812657,CSE 3,A50,083646,Miranda; Gregory Joseph,24,0,50,26
1657958818687,CSE 8A,A50,083650,Miranda; Gregory Joseph,17,1,56,39
1657958824715,CSE 11,A01,083080,Cao; Yingjun,7,15,40,33
1657958830738,CSE 12,A01,083652,Krause-Levy; Sophia Louisa,30,1,120,90
1657958836762,CSE 15L,A01,083654,Morris; Justin Loren,9,0,50,41
1657958836762,CSE 15L,A02,083655,Morris; Justin Loren,11,0,50,39
1657958842789,CSE 20,A01,083657,Tran; Khoa Dang,39,0,80,41
1657958848824,CSE 21,A01,095574,Bach; Quang Tran,23,0,48,25
1657958854850,CSE 30,A01,083084,Eldon; John,8,0,80,72
1657958854850,CSE 30,B01,095061,Bhaskar; Nishant,9,0,50,41
1657958860878,CSE 100,A01,083659,Cao; Yingjun,5,4,70,65
1657958866901,CSE 134B,A01,083661,Powell; Thomas Allan,25,0,100,75
1657958872925,CSE 140,A01,083663,Gungor; Onat,17,0,85,68
1657958878953,CSE 140L,A01,083088,Eldon; John,23,0,100,77
1657958884981,CSE 175,A01,083665,Kumar; Rakesh,3,0,25,22
1657958891021,CSE 190,A00,092507,Dubnov; Shlomo,8,0,20,12
1657958897050,ECE 45,A01,083139,Congero; Spencer William,7,0,75,68
1657958903072,ECE 65,A50,083695,Saad; Andrew S,12,0,30,18
1657958903072,ECE 65,A51,095125,Saad; Andrew S,24,0,26,2
1657958909101,ECE 109,A01,091882,Touri; Behrouz,21,0,70,49
1657958915129,ECE 180,A00,083140,Abi Samra; Nicholas Camill,1,0,30,29
1657958915129,ECE 180,B00,083141,Abi Samra; Nicholas Camill,0,0,30,30
1657958921166,MATH 10A,A01,083735,Patchell; Gregory David,2,0,30,28
1657958921166,MATH 10A,A02,083736,Patchell; Gregory David,20,0,30,10
1657958921166,MATH 10A,A03,083737,Patchell; Gregory David,16,0,30,14
1657958927199,MATH 10B,A01,083207,Lim; Seonhee,9,0,34,25
1657958927199,MATH 10B,A02,083208,Lim; Seonhee,10,0,35,25
1657958927199,MATH 10B,A03,093472,Lim; Seonhee,7,0,34,27
1657958927199,MATH 10B,B01,083739,Sinha; Shubham,14,0,30,16
1657958933236,MATH 18,A01,083743,Cinel; Cameron Alexander,9,0,30,21
1657958933236,MATH 18,A02,083744,Cinel; Cameron Alexander,18,0,30,12
1657958933236,MATH 18,A03,083745,Cinel; Cameron Alexander,10,0,30,20
1657958933236,MATH 18,B01,083748,Rideout; David Porter,5,0,37,32
1657958933236,MATH 18,B02,083749,Rideout; David Porter,5,0,36,31
1657958933236,MATH 18,B03,083750,Rideout; David Porter,3,0,37,34
1657958933236,MATH 18,B04,083751,Rideout; David Porter,7,0,36,29
1657958933236,MATH 18,B05,093473,Rideout; David Porter,7,0,36,29
1657958933236,MATH 18,B06,093474,Rideout; David Porter,6,0,36,30
1657958939259,MATH 20A,A01,083754,Zheng; Zequn,14,0,40,26
1657958945284,MATH 20B,A01,083756,Briones; Jor-el Thomas Caparas,4,0,36,32
1657958945284,MATH 20B,A02,083757,Briones; Jor-el Thomas Caparas,1,0,36,35
1657958945284,MATH 20B,A03,093475,Briones; Jor-el Thomas Caparas,3,0,36,33
1657958951315,MATH 20C,A01,083760,Briones; Jor-el Thomas Caparas,1,0,35,34
1657958951315,MATH 20C,A02,083761,Briones; Jor-el Thomas Caparas,8,0,35,27
1657958951315,MATH 20C,A03,093476,Briones; Jor-el Thomas Caparas,0,1,36,36
1657958951315,MATH 20C,B01,083762,Bach; Quang Tran,1,0,30,29
1657958957338,MATH 20D,A01,083765,Tran; Brian Kha,5,0,30,25
1657958957338,MATH 20D,A02,083766,Tran; Brian Kha,5,0,30,25
1657958957338,MATH 20D,A03,083767,Tran; Brian Kha,6,0,30,24
1657958963362,MATH 20E,A01,083771,Ganguly; Soumya,12,0,32,20
1657958963362,MATH 20E,A02,083772,Ganguly; Soumya,7,0,32,25
1657958963362,MATH 20E,B01,083773,Ciotti; Benjamin,20,0,35,15
1657958963362,MATH 20E,B02,083774,Ciotti; Benjamin,18,0,35,17
1657958969391,MATH 103A,A01,083777,Greenfeld; Be'Eri,6,0,36,30
1657958969391,MATH 103A,A02,083778,Greenfeld; Be'Eri,5,0,36,31
1657958969391,MATH 103A,A03,093561,Greenfeld; Be'Eri,7,0,36,29
1657958969391,MATH 103A,B01,083779,Greenfeld; Be'Eri,8,0,36,28
1657958969391,MATH 103A,B02,083780,Greenfeld; Be'Eri,4,0,36,32
1657958969391,MATH 103A,B03,093562,Greenfeld; Be'Eri,3,0,36,33
1657958975420,MATH 105,A01,085443,Carter; Anne Toulson,15,0,35,20
1657958975420,MATH 105,A02,093477,Carter; Anne Toulson,20,0,35,15
1657958981456,MATH 109,A01,083213,Ganzberger; Geoffrey Michael,3,0,34,31
1657958981456,MATH 109,A02,083214,Ganzberger; Geoffrey Michael,4,0,34,30
1657958981456,MATH 109,A03,093478,Ganzberger; Geoffrey Michael,2,0,34,32
1657958981456,MATH 109,B01,083215,Ganzberger; Geoffrey Michael,3,0,32,29
1657958981456,MATH 109,B02,083216,Ganzberger; Geoffrey Michael,3,0,32,29
1657958981456,MATH 109,B03,093479,Ganzberger; Geoffrey Michael,8,0,32,24
1657958987482,MATH 142A,A01,083219,Chow; Bennett,7,0,32,25
1657958987482,MATH 142A,A02,083220,Chow; Bennett,10,0,32,22
1657958987482,MATH 142A,A03,093480,Chow; Bennett,9,0,32,23
1657958987482,MATH 142A,B03,093481,Chow; Bennett,8,0,32,24
1657958987482,MATH 142A,B04,093558,Chow; Bennett,14,0,32,18
1657958987482,MATH 142A,B05,093559,Chow; Bennett,7,0,32,25
1657958993517,MATH 193A,A01,083224,Rotar; Vladimir,9,0,34,25
1657958993517,MATH 193A,A02,083225,Rotar; Vladimir,11,0,34,23
1657958993517,MATH 193A,A03,083781,Rotar; Vladimir,5,0,34,29
1657958993517,MATH 193A,A04,083782,Rotar; Vladimir,12,0,34,22
1657958993517,MATH 193A,A05,093482,Rotar; Vladimir,11,0,34,23
1657958999566,MATH 197,001,091859,McAuley; Julian John,9999,0,9999,0
1657958999566,MATH 197,002,095566,Kedlaya; Kiran S.,9997,0,9999,2
1657958999566,MATH 197,003,095567,Xiao; Ming,9999,0,9999,0
1657958999566,MATH 197,004,095571,Perols; Johan Lars,9998,0,9999,1
1657959006628,COGS 9,A01,083615,Shannon; Kyle Michael,11,0,75,64
1657959012653,COGS 11,A01,083617,Boyle; Mary E. T.,23,0,48,25
1657959018684,COGS 13,A01,083071,Bastos; Amalia Pinkusfeld,12,0,71,59
1657959024714,COGS 14A,A01,092681,Semenuks; Arturs,5,1,100,95
1657959030739,COGS 14B,A01,083073,Cheng; Tzu-Han,7,0,63,56
1657959036766,COGS 17,A01,092677,Semenuks; Arturs,7,0,81,74
1657959042791,COGS 100,A01,083619,Allen; Michael Gordon,17,0,70,53
1657959048815,COGS 101A,A01,083621,Davis; Joshua Daniel,9,0,68,59
1657959054845,COGS 101B,A01,091572,Allen; Michael Gordon,14,0,65,51
1657959060871,COGS 101C,A01,083625,Delgado; Tania,17,0,35,18
1657959066894,COGS 107A,A01,083627,Boyle; Mary E. T.,14,0,60,46
1657959072923,COGS 118A,A01,083075,Gupta; Anjum,21,0,76,55
1657959078955,CSE 3,A50,083646,Miranda; Gregory Joseph,24,0,50,26
1657959084985,CSE 8A,A50,083650,Miranda; Gregory Joseph,17,1,56,39
1657959091009,CSE 11,A01,083080,Cao; Yingjun,7,15,40,33
1657959097033,CSE 12,A01,083652,Krause-Levy; Sophia Louisa,30,1,120,90
1657959103061,CSE 15L,A01,083654,Morris; Justin Loren,9,0,50,41
1657959103061,CSE 15L,A02,083655,Morris; Justin Loren,11,0,50,39
1657959109086,CSE 20,A01,083657,Tran; Khoa Dang,39,0,80,41
1657959115121,CSE 21,A01,095574,Bach; Quang Tran,23,0,48,25
1657959121146,CSE 30,A01,083084,Eldon; John,8,0,80,72
1657959121146,CSE 30,B01,095061,Bhaskar; Nishant,9,0,50,41
1657959127174,CSE 100,A01,083659,Cao; Yingjun,5,4,70,65
1657959133270,CSE 134B,A01,083661,Powell; Thomas Allan,25,0,100,75
1657959139300,CSE 140,A01,083663,Gungor; Onat,17,0,85,68
1657959145330,CSE 140L,A01,083088,Eldon; John,23,0,100,77
1657959151355,CSE 175,A01,083665,Kumar; Rakesh,3,0,25,22
1657959157399,CSE 190,A00,092507,Dubnov; Shlomo,8,0,20,12
1657959163425,ECE 45,A01,083139,Congero; Spencer William,7,0,75,68
1657959169449,ECE 65,A50,083695,Saad; Andrew S,12,0,30,18
1657959169449,ECE 65,A51,095125,Saad; Andrew S,24,0,26,2
1657959175525,ECE 109,A01,091882,Touri; Behrouz,21,0,70,49
1657959181550,ECE 180,A00,083140,Abi Samra; Nicholas Camill,1,0,30,29
1657959181550,ECE 180,B00,083141,Abi Samra; Nicholas Camill,0,0,30,30
1657959187587,MATH 10A,A01,083735,Patchell; Gregory David,2,0,30,28
1657959187587,MATH 10A,A02,083736,Patchell; Gregory David,20,0,30,10
1657959187587,MATH 10A,A03,083737,Patchell; Gregory David,16,0,30,14
1657959193616,MATH 10B,A01,083207,Lim; Seonhee,9,0,34,25
1657959193616,MATH 10B,A02,083208,Lim; Seonhee,10,0,35,25
1657959193616,MATH 10B,A03,093472,Lim; Seonhee,7,0,34,27
1657959193616,MATH 10B,B01,083739,Sinha; Shubham,14,0,30,16
1657959199658,MATH 18,A01,083743,Cinel; Cameron Alexander,9,0,30,21
1657959199658,MATH 18,A02,083744,Cinel; Cameron Alexander,18,0,30,12
1657959199658,MATH 18,A03,083745,Cinel; Cameron Alexander,10,0,30,20
1657959199658,MATH 18,B01,083748,Rideout; David Porter,5,0,37,32
1657959199658,MATH 18,B02,083749,Rideout; David Porter,5,0,36,31
1657959199658,MATH 18,B03,083750,Rideout; David Porter,3,0,37,34
1657959199658,MATH 18,B04,083751,Rideout; David Porter,7,0,36,29
1657959199658,MATH 18,B05,093473,Rideout; David Porter,7,0,36,29
1657959199658,MATH 18,B06,093474,Rideout; David Porter,6,0,36,30
1657959205728,MATH 20A,A01,083754,Zheng; Zequn,14,0,40,26
1657959211754,MATH 20B,A01,083756,Briones; Jor-el Thomas Caparas,4,0,36,32
1657959211754,MATH 20B,A02,083757,Briones; Jor-el Thomas Caparas,1,0,36,35
1657959211754,MATH 20B,A03,093475,Briones; Jor-el Thomas Caparas,3,0,36,33
1657959217779,MATH 20C,A01,083760,Briones; Jor-el Thomas Caparas,1,0,35,34
1657959217779,MATH 20C,A02,083761,Briones; Jor-el Thomas Caparas,8,0,35,27
1657959217779,MATH 20C,A03,093476,Briones; Jor-el Thomas Caparas,0,1,36,36
1657959217779,MATH 20C,B01,083762,Bach; Quang Tran,1,0,30,29
1657959223816,MATH 20D,A01,083765,Tran; Brian Kha,5,0,30,25
1657959223816,MATH 20D,A02,083766,Tran; Brian Kha,5,0,30,25
1657959223816,MATH 20D,A03,083767,Tran; Brian Kha,6,0,30,24
1657959229843,MATH 20E,A01,083771,Ganguly; Soumya,12,0,32,20
1657959229843,MATH 20E,A02,083772,Ganguly; Soumya,7,0,32,25
1657959229843,MATH 20E,B01,083773,Ciotti; Benjamin,20,0,35,15
1657959229843,MATH 20E,B02,083774,Ciotti; Benjamin,18,0,35,17
1657959235925,MATH 103A,A01,083777,Greenfeld; Be'Eri,6,0,36,30
1657959235925,MATH 103A,A02,083778,Greenfeld; Be'Eri,5,0,36,31
1657959235925,MATH 103A,A03,093561,Greenfeld; Be'Eri,7,0,36,29
1657959235925,MATH 103A,B01,083779,Greenfeld; Be'Eri,8,0,36,28
1657959235925,MATH 103A,B02,083780,Greenfeld; Be'Eri,4,0,36,32
1657959235925,MATH 103A,B03,093562,Greenfeld; Be'Eri,3,0,36,33
1657959241955,MATH 105,A01,085443,Carter; Anne Toulson,15,0,35,20
1657959241955,MATH 105,A02,093477,Carter; Anne Toulson,20,0,35,15
1657959247978,MATH 109,A01,083213,Ganzberger; Geoffrey Michael,3,0,34,31
1657959247978,MATH 109,A02,083214,Ganzberger; Geoffrey Michael,4,0,34,30
1657959247978,MATH 109,A03,093478,Ganzberger; Geoffrey Michael,2,0,34,32
1657959247978,MATH 109,B01,083215,Ganzberger; Geoffrey Michael,3,0,32,29
1657959247978,MATH 109,B02,083216,Ganzberger; Geoffrey Michael,3,0,32,29
1657959247978,MATH 109,B03,093479,Ganzberger; Geoffrey Michael,8,0,32,24
1657959254019,MATH 142A,A01,083219,Chow; Bennett,7,0,32,25
1657959254019,MATH 142A,A02,083220,Chow; Bennett,10,0,32,22
1657959254019,MATH 142A,A03,093480,Chow; Bennett,9,0,32,23
1657959254019,MATH 142A,B03,093481,Chow; Bennett,8,0,32,24
1657959254019,MATH 142A,B04,093558,Chow; Bennett,14,0,32,18
1657959254019,MATH 142A,B05,093559,Chow; Bennett,7,0,32,25
1657959260050,MATH 193A,A01,083224,Rotar; Vladimir,9,0,34,25
1657959260050,MATH 193A,A02,083225,Rotar; Vladimir,11,0,34,23
1657959260050,MATH 193A,A03,083781,Rotar; Vladimir,5,0,34,29
1657959260050,MATH 193A,A04,083782,Rotar; Vladimir,12,0,34,22
1657959260050,MATH 193A,A05,093482,Rotar; Vladimir,11,0,34,23
1657959266076,MATH 197,001,091859,McAuley; Julian John,9999,0,9999,0
1657959266076,MATH 197,002,095566,Kedlaya; Kiran S.,9997,0,9999,2
1657959266076,MATH 197,003,095567,Xiao; Ming,9999,0,9999,0
1657959266076,MATH 197,004,095571,Perols; Johan Lars,9998,0,9999,1
1657959273141,COGS 9,A01,083615,Shannon; Kyle Michael,11,0,75,64
1657959279169,COGS 11,A01,083617,Boyle; Mary E. T.,23,0,48,25
1657959285201,COGS 13,A01,083071,Bastos; Amalia Pinkusfeld,12,0,71,59
1657959291224,COGS 14A,A01,092681,Semenuks; Arturs,5,1,100,95
1657959297248,COGS 14B,A01,083073,Cheng; Tzu-Han,7,0,63,56
1657959303272,COGS 17,A01,092677,Semenuks; Arturs,7,0,81,74
1657959309295,COGS 100,A01,083619,Allen; Michael Gordon,17,0,70,53
1657959315319,COGS 101A,A01,083621,Davis; Joshua Daniel,9,0,68,59
1657959321359,COGS 101B,A01,091572,Allen; Michael Gordon,14,0,65,51
1657959327395,COGS 101C,A01,083625,Delgado; Tania,17,0,35,18
1657959333421,COGS 107A,A01,083627,Boyle; Mary E. T.,14,0,60,46
1657959339453,COGS 118A,A01,083075,Gupta; Anjum,21,0,76,55
1657959345477,CSE 3,A50,083646,Miranda; Gregory Joseph,24,0,50,26
1657959351505,CSE 8A,A50,083650,Miranda; Gregory Joseph,17,1,56,39
1657959357529,CSE 11,A01,083080,Cao; Yingjun,7,15,40,33
1657959363557,CSE 12,A01,083652,Krause-Levy; Sophia Louisa,30,1,120,90
1657959369581,CSE 15L,A01,083654,Morris; Justin Loren,9,0,50,41
1657959369581,CSE 15L,A02,083655,Morris; Justin Loren,11,0,50,39
1657959375608,CSE 20,A01,083657,Tran; Khoa Dang,39,0,80,41
1657959381631,CSE 21,A01,095574,Bach; Quang Tran,23,0,48,25
1657959387665,CSE 30,A01,083084,Eldon; John,8,0,80,72
1657959387665,CSE 30,B01,095061,Bhaskar; Nishant,9,0,50,41
1657959393693,CSE 100,A01,083659,Cao; Yingjun,5,4,70,65
1657959399720,CSE 134B,A01,083661,Powell; Thomas Allan,25,0,100,75
1657959405744,CSE 140,A01,083663,Gungor; Onat,17,0,85,68
1657959411770,CSE 140L,A01,083088,Eldon; John,23,0,100,77
1657959417793,CSE 175,A01,083665,Kumar; Rakesh,3,0,25,22
1657959423817,CSE 190,A00,092507,Dubnov; Shlomo,8,0,20,12
1657959429842,ECE 45,A01,083139,Congero; Spencer William,7,0,75,68
1657959435872,ECE 65,A50,083695,Saad; Andrew S,12,0,30,18
1657959435872,ECE 65,A51,095125,Saad; Andrew S,24,0,26,2
1657959441898,ECE 109,A01,091882,Touri; Behrouz,21,0,70,49
1657959447928,ECE 180,A00,083140,Abi Samra; Nicholas Camill,1,0,30,29
1657959447928,ECE 180,B00,083141,Abi Samra; Nicholas Camill,0,0,30,30
1657959453957,MATH 10A,A01,083735,Patchell; Gregory David,2,0,30,28
1657959453957,MATH 10A,A02,083736,Patchell; Gregory David,20,0,30,10
1657959453957,MATH 10A,A03,083737,Patchell; Gregory David,16,0,30,14
1657959459981,MATH 10B,A01,083207,Lim; Seonhee,9,0,34,25
1657959459981,MATH 10B,A02,083208,Lim; Seonhee,10,0,35,25
1657959459981,MATH 10B,A03,093472,Lim; Seonhee,7,0,34,27
1657959459981,MATH 10B,B01,083739,Sinha; Shubham,14,0,30,16
1657959466019,MATH 18,A01,083743,Cinel; Cameron Alexander,9,0,30,21
1657959466019,MATH 18,A02,083744,Cinel; Cameron Alexander,18,0,30,12
1657959466019,MATH 18,A03,083745,Cinel; Cameron Alexander,10,0,30,20
1657959466019,MATH 18,B01,083748,Rideout; David Porter,5,0,37,32
1657959466019,MATH 18,B02,083749,Rideout; David Porter,5,0,36,31
1657959466019,MATH 18,B03,083750,Rideout; David Porter,3,0,37,34
1657959466019,MATH 18,B04,083751,Rideout; David Porter,7,0,36,29
1657959466019,MATH 18,B05,093473,Rideout; David Porter,7,0,36,29
1657959466019,MATH 18,B06,093474,Rideout; David Porter,6,0,36,30
1657959472046,MATH 20A,A01,083754,Zheng; Zequn,14,0,40,26
1657959478070,MATH 20B,A01,083756,Briones; Jor-el Thomas Caparas,4,0,36,32
1657959478070,MATH 20B,A02,083757,Briones; Jor-el Thomas Caparas,1,0,36,35
1657959478070,MATH 20B,A03,093475,Briones; Jor-el Thomas Caparas,3,0,36,33
1657959484099,MATH 20C,A01,083760,Briones; Jor-el Thomas Caparas,1,0,35,34
1657959484099,MATH 20C,A02,083761,Briones; Jor-el Thomas Caparas,8,0,35,27
1657959484099,MATH 20C,A03,093476,Briones; Jor-el Thomas Caparas,0,1,36,36
1657959484099,MATH 20C,B01,083762,Bach; Quang Tran,1,0,30,29
1657959490128,MATH 20D,A01,083765,Tran; Brian Kha,5,0,30,25
1657959490128,MATH 20D,A02,083766,Tran; Brian Kha,5,0,30,25
1657959490128,MATH 20D,A03,083767,Tran; Brian Kha,6,0,30,24
1657959496162,MATH 20E,A01,083771,Ganguly; Soumya,12,0,32,20
1657959496162,MATH 20E,A02,083772,Ganguly; Soumya,7,0,32,25
1657959496162,MATH 20E,B01,083773,Ciotti; Benjamin,20,0,35,15
1657959496162,MATH 20E,B02,083774,Ciotti; Benjamin,18,0,35,17
1657959502191,MATH 103A,A01,083777,Greenfeld; Be'Eri,6,0,36,30
1657959502191,MATH 103A,A02,083778,Greenfeld; Be'Eri,5,0,36,31
1657959502191,MATH 103A,A03,093561,Greenfeld; Be'Eri,7,0,36,29
1657959502191,MATH 103A,B01,083779,Greenfeld; Be'Eri,8,0,36,28
1657959502191,MATH 103A,B02,083780,Greenfeld; Be'Eri,4,0,36,32
1657959502191,MATH 103A,B03,093562,Greenfeld; Be'Eri,3,0,36,33
1657959508220,MATH 105,A01,085443,Carter; Anne Toulson,15,0,35,20
1657959508220,MATH 105,A02,093477,Carter; Anne Toulson,20,0,35,15
1657959514245,MATH 109,A01,083213,Ganzberger; Geoffrey Michael,3,0,34,31
1657959514245,MATH 109,A02,083214,Ganzberger; Geoffrey Michael,4,0,34,30
1657959514245,MATH 109,A03,093478,Ganzberger; Geoffrey Michael,2,0,34,32
1657959514245,MATH 109,B01,083215,Ganzberger; Geoffrey Michael,3,0,32,29
1657959514245,MATH 109,B02,083216,Ganzberger; Geoffrey Michael,3,0,32,29
1657959514245,MATH 109,B03,093479,Ganzberger; Geoffrey Michael,8,0,32,24
1657959520269,MATH 142A,A01,083219,Chow; Bennett,7,0,32,25
1657959520269,MATH 142A,A02,083220,Chow; Bennett,10,0,32,22
1657959520269,MATH 142A,A03,093480,Chow; Bennett,9,0,32,23
1657959520269,MATH 142A,B03,093481,Chow; Bennett,8,0,32,24
1657959520269,MATH 142A,B04,093558,Chow; Bennett,14,0,32,18
1657959520269,MATH 142A,B05,093559,Chow; Bennett,7,0,32,25
1657959526293,MATH 193A,A01,083224,Rotar; Vladimir,9,0,34,25
1657959526293,MATH 193A,A02,083225,Rotar; Vladimir,11,0,34,23
1657959526293,MATH 193A,A03,083781,Rotar; Vladimir,5,0,34,29
1657959526293,MATH 193A,A04,083782,Rotar; Vladimir,12,0,34,22
1657959526293,MATH 193A,A05,093482,Rotar; Vladimir,11,0,34,23
1657959532322,MATH 197,001,091859,McAuley; Julian John,9999,0,9999,0
1657959532322,MATH 197,002,095566,Kedlaya; Kiran S.,9997,0,9999,2
1657959532322,MATH 197,003,095567,Xiao; Ming,9999,0,9999,0
1657959532322,MATH 197,004,095571,Perols; Johan Lars,9998,0,9999,1
1657959539391,COGS 9,A01,083615,Shannon; Kyle Michael,11,0,75,64
1657959545419,COGS 11,A01,083617,Boyle; Mary E. T.,23,0,48,25
1657959551441,COGS 13,A01,083071,Bastos; Amalia Pinkusfeld,12,0,71,59
1657959557468,COGS 14A,A01,092681,Semenuks; Arturs,5,1,100,95
1657959563493,COGS 14B,A01,083073,Cheng; Tzu-Han,7,0,63,56
1657959569516,COGS 17,A01,092677,Semenuks; Arturs,7,0,81,74
1657959575538,COGS 100,A01,083619,Allen; Michael Gordon,17,0,70,53
1657959581563,COGS 101A,A01,083621,Davis; Joshua Daniel,9,0,68,59
1657959587589,COGS 101B,A01,091572,Allen; Michael Gordon,14,0,65,51
1657959593614,COGS 101C,A01,083625,Delgado; Tania,17,0,35,18
1657959599638,COGS 107A,A01,083627,Boyle; Mary E. T.,14,0,60,46
1657959605666,COGS 118A,A01,083075,Gupta; Anjum,21,0,76,55
1657959611694,CSE 3,A50,083646,Miranda; Gregory Joseph,24,0,50,26
1657959617716,CSE 8A,A50,083650,Miranda; Gregory Joseph,17,1,56,39
1657959623743,CSE 11,A01,083080,Cao; Yingjun,7,15,40,33
1657959629790,CSE 12,A01,083652,Krause-Levy; Sophia Louisa,30,1,120,90
1657959635816,CSE 15L,A01,083654,Morris; Justin Loren,9,0,50,41
1657959635816,CSE 15L,A02,083655,Morris; Justin Loren,11,0,50,39
1657959641843,CSE 20,A01,083657,Tran; Khoa Dang,39,0,80,41
1657959647869,CSE 21,A01,095574,Bach; Quang Tran,23,0,48,25
1657959653914,CSE 30,A01,083084,Eldon; John,8,0,80,72
1657959653914,CSE 30,B01,095061,Bhaskar; Nishant,9,0,50,41
1657959659938,CSE 100,A01,083659,Cao; Yingjun,5,4,70,65
1657959665971,CSE 134B,A01,083661,Powell; Thomas Allan,25,0,100,75
1657959672000,CSE 140,A01,083663,Gungor; Onat,17,0,85,68
1657959678028,CSE 140L,A01,083088,Eldon; John,23,0,100,77
1657959684054,CSE 175,A01,083665,Kumar; Rakesh,3,0,25,22
1657959690081,CSE 190,A00,092507,Dubnov; Shlomo,8,0,20,12
1657959696107,ECE 45,A01,083139,Congero; Spencer William,7,0,75,68
1657959702139,ECE 65,A50,083695,Saad; Andrew S,12,0,30,18
1657959702139,ECE 65,A51,095125,Saad; Andrew S,24,0,26,2
1657959708165,ECE 109,A01,091882,Touri; Behrouz,21,0,70,49
1657959714192,ECE 180,A00,083140,Abi Samra; Nicholas Camill,1,0,30,29
1657959714192,ECE 180,B00,083141,Abi Samra; Nicholas Camill,0,0,30,30
1657959720219,MATH 10A,A01,083735,Patchell; Gregory David,2,0,30,28
1657959720219,MATH 10A,A02,083736,Patchell; Gregory David,20,0,30,10
1657959720219,MATH 10A,A03,083737,Patchell; Gregory David,16,0,30,14
1657959726269,MATH 10B,A01,083207,Lim; Seonhee,9,0,34,25
1657959726269,MATH 10B,A02,083208,Lim; Seonhee,10,0,35,25
1657959726269,MATH 10B,A03,093472,Lim; Seonhee,7,0,34,27
1657959726269,MATH 10B,B01,083739,Sinha; Shubham,14,0,30,16
1657959732423,MATH 18,A01,083743,Cinel; Cameron Alexander,9,0,30,21
1657959732423,MATH 18,A02,083744,Cinel; Cameron Alexander,18,0,30,12
1657959732423,MATH 18,A03,083745,Cinel; Cameron Alexander,10,0,30,20
1657959732423,MATH 18,B01,083748,Rideout; David Porter,5,0,37,32
1657959732423,MATH 18,B02,083749,Rideout; David Porter,5,0,36,31
1657959732423,MATH 18,B03,083750,Rideout; David Porter,3,0,37,34
1657959732423,MATH 18,B04,083751,Rideout; David Porter,7,0,36,29
1657959732423,MATH 18,B05,093473,Rideout; David Porter,7,0,36,29
1657959732423,MATH 18,B06,093474,Rideout; David Porter,6,0,36,30
1657959738454,MATH 20A,A01,083754,Zheng; Zequn,14,0,40,26
1657959744480,MATH 20B,A01,083756,Briones; Jor-el Thomas Caparas,4,0,36,32
1657959744480,MATH 20B,A02,083757,Briones; Jor-el Thomas Caparas,1,0,36,35
1657959744480,MATH 20B,A03,093475,Briones; Jor-el Thomas Caparas,3,0,36,33
1657959750513,MATH 20C,A01,083760,Briones; Jor-el Thomas Caparas,1,0,35,34
1657959750513,MATH 20C,A02,083761,Briones; Jor-el Thomas Caparas,8,0,35,27
1657959750513,MATH 20C,A03,093476,Briones; Jor-el Thomas Caparas,0,1,36,36
1657959750513,MATH 20C,B01,083762,Bach; Quang Tran,1,0,30,29
1657959756539,MATH 20D,A01,083765,Tran; Brian Kha,5,0,30,25
1657959756539,MATH 20D,A02,083766,Tran; Brian Kha,5,0,30,25
1657959756539,MATH 20D,A03,083767,Tran; Brian Kha,6,0,30,24
1657959762572,MATH 20E,A01,083771,Ganguly; Soumya,12,0,32,20
1657959762572,MATH 20E,A02,083772,Ganguly; Soumya,7,0,32,25
1657959762572,MATH 20E,B01,083773,Ciotti; Benjamin,20,0,35,15
1657959762572,MATH 20E,B02,083774,Ciotti; Benjamin,18,0,35,17
1657959768601,MATH 103A,A01,083777,Greenfeld; Be'Eri,6,0,36,30
1657959768601,MATH 103A,A02,083778,Greenfeld; Be'Eri,5,0,36,31
1657959768601,MATH 103A,A03,093561,Greenfeld; Be'Eri,7,0,36,29
1657959768601,MATH 103A,B01,083779,Greenfeld; Be'Eri,8,0,36,28
1657959768601,MATH 103A,B02,083780,Greenfeld; Be'Eri,4,0,36,32
1657959768601,MATH 103A,B03,093562,Greenfeld; Be'Eri,3,0,36,33
1657959774646,MATH 105,A01,085443,Carter; Anne Toulson,15,0,35,20
1657959774646,MATH 105,A02,093477,Carter; Anne Toulson,20,0,35,15
1657959780672,MATH 109,A01,083213,Ganzberger; Geoffrey Michael,3,0,34,31
1657959780672,MATH 109,A02,083214,Ganzberger; Geoffrey Michael,4,0,34,30
1657959780672,MATH 109,A03,093478,Ganzberger; Geoffrey Michael,2,0,34,32
1657959780672,MATH 109,B01,083215,Ganzberger; Geoffrey Michael,3,0,32,29
1657959780672,MATH 109,B02,083216,Ganzberger; Geoffrey Michael,3,0,32,29
1657959780672,MATH 109,B03,093479,Ganzberger; Geoffrey Michael,8,0,32,24
1657959786698,MATH 142A,A01,083219,Chow; Bennett,7,0,32,25
1657959786698,MATH 142A,A02,083220,Chow; Bennett,10,0,32,22
1657959786698,MATH 142A,A03,093480,Chow; Bennett,9,0,32,23
1657959786698,MATH 142A,B03,093481,Chow; Bennett,8,0,32,24
1657959786698,MATH 142A,B04,093558,Chow; Bennett,14,0,32,18
1657959786698,MATH 142A,B05,093559,Chow; Bennett,7,0,32,25
1657959792743,MATH 193A,A01,083224,Rotar; Vladimir,9,0,34,25
1657959792743,MATH 193A,A02,083225,Rotar; Vladimir,11,0,34,23
1657959792743,MATH 193A,A03,083781,Rotar; Vladimir,5,0,34,29
1657959792743,MATH 193A,A04,083782,Rotar; Vladimir,12,0,34,22
1657959792743,MATH 193A,A05,093482,Rotar; Vladimir,11,0,34,23
1657959798767,MATH 197,001,091859,McAuley; Julian John,9999,0,9999,0
1657959798767,MATH 197,002,095566,Kedlaya; Kiran S.,9997,0,9999,2
1657959798767,MATH 197,003,095567,Xiao; Ming,9999,0,9999,0
1657959798767,MATH 197,004,095571,Perols; Johan Lars,9998,0,9999,1
1657959805838,COGS 9,A01,083615,Shannon; Kyle Michael,11,0,75,64
1657959811867,COGS 11,A01,083617,Boyle; Mary E. T.,23,0,48,25
1657959817892,COGS 13,A01,083071,Bastos; Amalia Pinkusfeld,12,0,71,59
1657959823921,COGS 14A,A01,092681,Semenuks; Arturs,5,1,100,95
1657959829948,COGS 14B,A01,083073,Cheng; Tzu-Han,7,0,63,56
1657959835971,COGS 17,A01,092677,Semenuks; Arturs,7,0,81,74
1657959842005,COGS 100,A01,083619,Allen; Michael Gordon,17,0,70,53
1657959848031,COGS 101A,A01,083621,Davis; Joshua Daniel,9,0,68,59
1657959854061,COGS 101B,A01,091572,Allen; Michael Gordon,14,0,65,51
1657959860092,COGS 101C,A01,083625,Delgado; Tania,17,0,35,18
1657959866116,COGS 107A,A01,083627,Boyle; Mary E. T.,14,0,60,46
1657959872145,COGS 118A,A01,083075,Gupta; Anjum,21,0,76,55
1657959878179,CSE 3,A50,083646,Miranda; Gregory Joseph,24,0,50,26
1657959884211,CSE 8A,A50,083650,Miranda; Gregory Joseph,17,1,56,39
1657959890246,CSE 11,A01,083080,Cao; Yingjun,7,15,40,33
1657959896280,CSE 12,A01,083652,Krause-Levy; Sophia Louisa,30,1,120,90
1657959902304,CSE 15L,A01,083654,Morris; Justin Loren,9,0,50,41
1657959902304,CSE 15L,A02,083655,Morris; Justin Loren,11,0,50,39
1657959908334,CSE 20,A01,083657,Tran; Khoa Dang,39,0,80,41
1657959914359,CSE 21,A01,095574,Bach; Quang Tran,23,0,48,25
1657959920402,CSE 30,A01,083084,Eldon; John,8,0,80,72
1657959920402,CSE 30,B01,095061,Bhaskar; Nishant,9,0,50,41
1657959926428,CSE 100,A01,083659,Cao; Yingjun,5,4,70,65
1657959932452,CSE 134B,A01,083661,Powell; Thomas Allan,25,0,100,75
1657959938481,CSE 140,A01,083663,Gungor; Onat,17,0,85,68
1657959944505,CSE 140L,A01,083088,Eldon; John,23,0,100,77
1657959950537,CSE 175,A01,083665,Kumar; Rakesh,3,0,25,22
1657959956563,CSE 190,A00,092507,Dubnov; Shlomo,8,0,20,12
1657959962599,ECE 45,A01,083139,Congero; Spencer William,7,0,75,68
1657959968626,ECE 65,A50,083695,Saad; Andrew S,12,0,30,18
1657959968626,ECE 65,A51,095125,Saad; Andrew S,24,0,26,2
1657959974651,ECE 109,A01,091882,Touri; Behrouz,21,0,70,49
1657959980682,ECE 180,A00,083140,Abi Samra; Nicholas Camill,1,0,30,29
1657959980682,ECE 180,B00,083141,Abi Samra; Nicholas Camill,0,0,30,30
1657959986717,MATH 10A,A01,083735,Patchell; Gregory David,2,0,30,28
1657959986717,MATH 10A,A02,083736,Patchell; Gregory David,20,0,30,10
1657959986717,MATH 10A,A03,083737,Patchell; Gregory David,16,0,30,14
1657959992755,MATH 10B,A01,083207,Lim; Seonhee,9,0,34,25
1657959992755,MATH 10B,A02,083208,Lim; Seonhee,10,0,35,25
1657959992755,MATH 10B,A03,093472,Lim; Seonhee,7,0,34,27
1657959992755,MATH 10B,B01,083739,Sinha; Shubham,14,0,30,16
1657959998800,MATH 18,A01,083743,Cinel; Cameron Alexander,9,0,30,21
1657959998800,MATH 18,A02,083744,Cinel; Cameron Alexander,18,0,30,12
1657959998800,MATH 18,A03,083745,Cinel; Cameron Alexander,10,0,30,20
1657959998800,MATH 18,B01,083748,Rideout; David Porter,5,0,37,32
1657959998800,MATH 18,B02,083749,Rideout; David Porter,5,0,36,31
1657959998800,MATH 18,B03,083750,Rideout; David Porter,3,0,37,34
1657959998800,MATH 18,B04,083751,Rideout; David Porter,7,0,36,29
1657959998800,MATH 18,B05,093473,Rideout; David Porter,7,0,36,29
1657959998800,MATH 18,B06,093474,Rideout; David Porter,6,0,36,30
1657960004825,MATH 20A,A01,083754,Zheng; Zequn,14,0,40,26
1657960010852,MATH 20B,A01,083756,Briones; Jor-el Thomas Caparas,4,0,36,32
1657960010852,MATH 20B,A02,083757,Briones; Jor-el Thomas Caparas,1,0,36,35
1657960010852,MATH 20B,A03,093475,Briones; Jor-el Thomas Caparas,3,0,36,33
1657960016880,MATH 20C,A01,083760,Briones; Jor-el Thomas Caparas,1,0,35,34
1657960016880,MATH 20C,A02,083761,Briones; Jor-el Thomas Caparas,8,0,35,27
1657960016880,MATH 20C,A03,093476,Briones; Jor-el Thomas Caparas,0,1,36,36
1657960016880,MATH 20C,B01,083762,Bach; Quang Tran,1,0,30,29
1657960022912,MATH 20D,A01,083765,Tran; Brian Kha,5,0,30,25
1657960022912,MATH 20D,A02,083766,Tran; Brian Kha,5,0,30,25
1657960022912,MATH 20D,A03,083767,Tran; Brian Kha,6,0,30,24
1657960028943,MATH 20E,A01,083771,Ganguly; Soumya,12,0,32,20
1657960028943,MATH 20E,A02,083772,Ganguly; Soumya,7,0,32,25
1657960028943,MATH 20E,B01,083773,Ciotti; Benjamin,20,0,35,15
1657960028943,MATH 20E,B02,083774,Ciotti; Benjamin,18,0,35,17
1657960034972,MATH 103A,A01,083777,Greenfeld; Be'Eri,6,0,36,30
1657960034972,MATH 103A,A02,083778,Greenfeld; Be'Eri,5,0,36,31
1657960034972,MATH 103A,A03,093561,Greenfeld; Be'Eri,7,0,36,29
1657960034972,MATH 103A,B01,083779,Greenfeld; Be'Eri,8,0,36,28
1657960034972,MATH 103A,B02,083780,Greenfeld; Be'Eri,4,0,36,32
1657960034972,MATH 103A,B03,093562,Greenfeld; Be'Eri,3,0,36,33
1657960040999,MATH 105,A01,085443,Carter; Anne Toulson,15,0,35,20
1657960040999,MATH 105,A02,093477,Carter; Anne Toulson,20,0,35,15
1657960047026,MATH 109,A01,083213,Ganzberger; Geoffrey Michael,3,0,34,31
1657960047026,MATH 109,A02,083214,Ganzberger; Geoffrey Michael,4,0,34,30
1657960047026,MATH 109,A03,093478,Ganzberger; Geoffrey Michael,2,0,34,32
1657960047026,MATH 109,B01,083215,Ganzberger; Geoffrey Michael,3,0,32,29
1657960047026,MATH 109,B02,083216,Ganzberger; Geoffrey Michael,3,0,32,29
1657960047026,MATH 109,B03,093479,Ganzberger; Geoffrey Michael,8,0,32,24
1657960053055,MATH 142A,A01,083219,Chow; Bennett,7,0,32,25
1657960053055,MATH 142A,A02,083220,Chow; Bennett,10,0,32,22
1657960053055,MATH 142A,A03,093480,Chow; Bennett,9,0,32,23
1657960053055,MATH 142A,B03,093481,Chow; Bennett,8,0,32,24
1657960053055,MATH 142A,B04,093558,Chow; Bennett,14,0,32,18
1657960053055,MATH 142A,B05,093559,Chow; Bennett,7,0,32,25
1657960059089,MATH 193A,A01,083224,Rotar; Vladimir,9,0,34,25
1657960059089,MATH 193A,A02,083225,Rotar; Vladimir,11,0,34,23
1657960059089,MATH 193A,A03,083781,Rotar; Vladimir,5,0,34,29
1657960059089,MATH 193A,A04,083782,Rotar; Vladimir,12,0,34,22
1657960059089,MATH 193A,A05,093482,Rotar; Vladimir,11,0,34,23
1657960065114,MATH 197,001,091859,McAuley; Julian John,9999,0,9999,0
1657960065114,MATH 197,002,095566,Kedlaya; Kiran S.,9997,0,9999,2
1657960065114,MATH 197,003,095567,Xiao; Ming,9999,0,9999,0
1657960065114,MATH 197,004,095571,Perols; Johan Lars,9998,0,9999,1
1657960072201,COGS 9,A01,083615,Shannon; Kyle Michael,11,0,75,64
1657960078225,COGS 11,A01,083617,Boyle; Mary E. T.,23,0,48,25
1657960084254,COGS 13,A01,083071,Bastos; Amalia Pinkusfeld,12,0,71,59
1657960090279,COGS 14A,A01,092681,Semenuks; Arturs,5,1,100,95
1657960096308,COGS 14B,A01,083073,Cheng; Tzu-Han,7,0,63,56
1657960102338,COGS 17,A01,092677,Semenuks; Arturs,7,0,81,74
1657960108363,COGS 100,A01,083619,Allen; Michael Gordon,17,0,70,53
1657960114394,COGS 101A,A01,083621,Davis; Joshua Daniel,9,0,68,59
1657960120426,COGS 101B,A01,091572,Allen; Michael Gordon,14,0,65,51
1657960126456,COGS 101C,A01,083625,Delgado; Tania,17,0,35,18
1657960132479,COGS 107A,A01,083627,Boyle; Mary E. T.,14,0,60,46
1657960138503,COGS 118A,A01,083075,Gupta; Anjum,21,0,76,55
1657960144528,CSE 3,A50,083646,Miranda; Gregory Joseph,24,0,50,26
1657960150557,CSE 8A,A50,083650,Miranda; Gregory Joseph,17,1,56,39
1657960156585,CSE 11,A01,083080,Cao; Yingjun,7,15,40,33
1657960162610,CSE 12,A01,083652,Krause-Levy; Sophia Louisa,30,1,120,90
1657960168635,CSE 15L,A01,083654,Morris; Justin Loren,9,0,50,41
1657960168635,CSE 15L,A02,083655,Morris; Justin Loren,11,0,50,39
1657960174666,CSE 20,A01,083657,Tran; Khoa Dang,39,0,80,41
1657960180695,CSE 21,A01,095574,Bach; Quang Tran,23,0,48,25
1657960186730,CSE 30,A01,083084,Eldon; John,8,0,80,72
1657960186730,CSE 30,B01,095061,Bhaskar; Nishant,9,0,50,41
1657960192756,CSE 100,A01,083659,Cao; Yingjun,5,4,70,65
1657960198780,CSE 134B,A01,083661,Powell; Thomas Allan,25,0,100,75
1657960204803,CSE 140,A01,083663,Gungor; Onat,17,0,85,68
1657960210827,CSE 140L,A01,083088,Eldon; John,23,0,100,77
1657960216856,CSE 175,A01,083665,Kumar; Rakesh,3,0,25,22
1657960222884,CSE 190,A00,092507,Dubnov; Shlomo,8,0,20,12
1657960228909,ECE 45,A01,083139,Congero; Spencer William,7,0,75,68
1657960234941,ECE 65,A50,083695,Saad; Andrew S,12,0,30,18
1657960234941,ECE 65,A51,095125,Saad; Andrew S,24,0,26,2
1657960240964,ECE 109,A01,091882,Touri; Behrouz,21,0,70,49
1657960246994,ECE 180,A00,083140,Abi Samra; Nicholas Camill,1,0,30,29
1657960246994,ECE 180,B00,083141,Abi Samra; Nicholas Camill,0,0,30,30
1657960253022,MATH 10A,A01,083735,Patchell; Gregory David,2,0,30,28
1657960253022,MATH 10A,A02,083736,Patchell; Gregory David,20,0,30,10
1657960253022,MATH 10A,A03,083737,Patchell; Gregory David,16,0,30,14
1657960259051,MATH 10B,A01,083207,Lim; Seonhee,9,0,34,25
1657960259051,MATH 10B,A02,083208,Lim; Seonhee,10,0,35,25
1657960259051,MATH 10B,A03,093472,Lim; Seonhee,7,0,34,27
1657960259051,MATH 10B,B01,083739,Sinha; Shubham,14,0,30,16
1657960265079,MATH 18,A01,083743,Cinel; Cameron Alexander,9,0,30,21
1657960265079,MATH 18,A02,083744,Cinel; Cameron Alexander,18,0,30,12
1657960265079,MATH 18,A03,083745,Cinel; Cameron Alexander,10,0,30,20
1657960265079,MATH 18,B01,083748,Rideout; David Porter,5,0,37,32
1657960265079,MATH 18,B02,083749,Rideout; David Porter,5,0,36,31
1657960265079,MATH 18,B03,083750,Rideout; David Porter,3,0,37,34
1657960265079,MATH 18,B04,083751,Rideout; David Porter,7,0,36,29
1657960265079,MATH 18,B05,093473,Rideout; David Porter,7,0,36,29
1657960265079,MATH 18,B06,093474,Rideout; David Porter,6,0,36,30
1657960271104,MATH 20A,A01,083754,Zheng; Zequn,14,0,40,26
1657960277140,MATH 20B,A01,083756,Briones; Jor-el Thomas Caparas,4,0,36,32
1657960277140,MATH 20B,A02,083757,Briones; Jor-el Thomas Caparas,1,0,36,35
1657960277140,MATH 20B,A03,093475,Briones; Jor-el Thomas Caparas,3,0,36,33
1657960283171,MATH 20C,A01,083760,Briones; Jor-el Thomas Caparas,1,0,35,34
1657960283171,MATH 20C,A02,083761,Briones; Jor-el Thomas Caparas,8,0,35,27
1657960283171,MATH 20C,A03,093476,Briones; Jor-el Thomas Caparas,0,1,36,36
1657960283171,MATH 20C,B01,083762,Bach; Quang Tran,1,0,30,29
1657960289196,MATH 20D,A01,083765,Tran; Brian Kha,5,0,30,25
1657960289196,MATH 20D,A02,083766,Tran; Brian Kha,5,0,30,25
1657960289196,MATH 20D,A03,083767,Tran; Brian Kha,6,0,30,24
1657960295232,MATH 20E,A01,083771,Ganguly; Soumya,12,0,32,20
1657960295232,MATH 20E,A02,083772,Ganguly; Soumya,7,0,32,25
1657960295232,MATH 20E,B01,083773,Ciotti; Benjamin,20,0,35,15
1657960295232,MATH 20E,B02,083774,Ciotti; Benjamin,18,0,35,17
1657960301260,MATH 103A,A01,083777,Greenfeld; Be'Eri,6,0,36,30
1657960301260,MATH 103A,A02,083778,Greenfeld; Be'Eri,5,0,36,31
1657960301260,MATH 103A,A03,093561,Greenfeld; Be'Eri,7,0,36,29
1657960301260,MATH 103A,B01,083779,Greenfeld; Be'Eri,8,0,36,28
1657960301260,MATH 103A,B02,083780,Greenfeld; Be'Eri,4,0,36,32
1657960301260,MATH 103A,B03,093562,Greenfeld; Be'Eri,3,0,36,33
1657960307293,MATH 105,A01,085443,Carter; Anne Toulson,15,0,35,20
1657960307293,MATH 105,A02,093477,Carter; Anne Toulson,20,0,35,15
1657960313320,MATH 109,A01,083213,Ganzberger; Geoffrey Michael,3,0,34,31
1657960313320,MATH 109,A02,083214,Ganzberger; Geoffrey Michael,4,0,34,30
1657960313320,MATH 109,A03,093478,Ganzberger; Geoffrey Michael,2,0,34,32
1657960313320,MATH 109,B01,083215,Ganzberger; Geoffrey Michael,3,0,32,29
1657960313320,MATH 109,B02,083216,Ganzberger; Geoffrey Michael,3,0,32,29
1657960313320,MATH 109,B03,093479,Ganzberger; Geoffrey Michael,8,0,32,24
1657960319354,MATH 142A,A01,083219,Chow; Bennett,7,0,32,25
1657960319354,MATH 142A,A02,083220,Chow; Bennett,10,0,32,22
1657960319354,MATH 142A,A03,093480,Chow; Bennett,9,0,32,23
1657960319354,MATH 142A,B03,093481,Chow; Bennett,8,0,32,24
1657960319354,MATH 142A,B04,093558,Chow; Bennett,14,0,32,18
1657960319354,MATH 142A,B05,093559,Chow; Bennett,7,0,32,25
1657960325388,MATH 193A,A01,083224,Rotar; Vladimir,9,0,34,25
1657960325388,MATH 193A,A02,083225,Rotar; Vladimir,11,0,34,23
1657960325388,MATH 193A,A03,083781,Rotar; Vladimir,5,0,34,29
1657960325388,MATH 193A,A04,083782,Rotar; Vladimir,12,0,34,22
1657960325388,MATH 193A,A05,093482,Rotar; Vladimir,11,0,34,23
1657960331491,MATH 197,001,091859,McAuley; Julian John,9999,0,9999,0
1657960331491,MATH 197,002,095566,Kedlaya; Kiran S.,9997,0,9999,2
1657960331491,MATH 197,003,095567,Xiao; Ming,9999,0,9999,0
1657960331491,MATH 197,004,095571,Perols; Johan Lars,9998,0,9999,1
1657960338557,COGS 9,A01,083615,Shannon; Kyle Michael,11,0,75,64
1657960344587,COGS 11,A01,083617,Boyle; Mary E. T.,23,0,48,25
1657960350614,COGS 13,A01,083071,Bastos; Amalia Pinkusfeld,12,0,71,59
1657960356638,COGS 14A,A01,092681,Semenuks; Arturs,5,1,100,95
1657960362668,COGS 14B,A01,083073,Cheng; Tzu-Han,7,0,63,56
1657960368691,COGS 17,A01,092677,Semenuks; Arturs,7,0,81,74
1657960374720,COGS 100,A01,083619,Allen; Michael Gordon,17,0,70,53
1657960380744,COGS 101A,A01,083621,Davis; Joshua Daniel,9,0,68,59
1657960386768,COGS 101B,A01,091572,Allen; Michael Gordon,14,0,65,51
1657960392800,COGS 101C,A01,083625,Delgado; Tania,17,0,35,18
1657960398826,COGS 107A,A01,083627,Boyle; Mary E. T.,14,0,60,46
1657960404848,COGS 118A,A01,083075,Gupta; Anjum,21,0,76,55
1657960410877,CSE 3,A50,083646,Miranda; Gregory Joseph,24,0,50,26
1657960416904,CSE 8A,A50,083650,Miranda; Gregory Joseph,17,1,56,39
1657960422935,CSE 11,A01,083080,Cao; Yingjun,7,15,40,33
1657960428959,CSE 12,A01,083652,Krause-Levy; Sophia Louisa,30,1,120,90
1657960434988,CSE 15L,A01,083654,Morris; Justin Loren,9,0,50,41
1657960434988,CSE 15L,A02,083655,Morris; Justin Loren,11,0,50,39
1657960441015,CSE 20,A01,083657,Tran; Khoa Dang,39,0,80,41
1657960447038,CSE 21,A01,095574,Bach; Quang Tran,23,0,48,25
1657960453063,CSE 30,A01,083084,Eldon; John,8,0,80,72
1657960453063,CSE 30,B01,095061,Bhaskar; Nishant,9,0,50,41
1657960459086,CSE 100,A01,083659,Cao; Yingjun,5,4,70,65
1657960465109,CSE 134B,A01,083661,Powell; Thomas Allan,25,0,100,75
1657960471133,CSE 140,A01,083663,Gungor; Onat,17,0,85,68
1657960477161,CSE 140L,A01,083088,Eldon; John,23,0,100,77
1657960483192,CSE 175,A01,083665,Kumar; Rakesh,3,0,25,22
1657960489220,CSE 190,A00,092507,Dubnov; Shlomo,8,0,20,12
1657960495252,ECE 45,A01,083139,Congero; Spencer William,7,0,75,68
1657960501287,ECE 65,A50,083695,Saad; Andrew S,12,0,30,18
1657960501287,ECE 65,A51,095125,Saad; Andrew S,24,0,26,2
1657960507314,ECE 109,A01,091882,Touri; Behrouz,21,0,70,49
1657960513338,ECE 180,A00,083140,Abi Samra; Nicholas Camill,1,0,30,29
1657960513338,ECE 180,B00,083141,Abi Samra; Nicholas Camill,0,0,30,30
1657960519362,MATH 10A,A01,083735,Patchell; Gregory David,2,0,30,28
1657960519362,MATH 10A,A02,083736,Patchell; Gregory David,20,0,30,10
1657960519362,MATH 10A,A03,083737,Patchell; Gregory David,16,0,30,14
1657960525396,MATH 10B,A01,083207,Lim; Seonhee,9,0,34,25
1657960525396,MATH 10B,A02,083208,Lim; Seonhee,10,0,35,25
1657960525396,MATH 10B,A03,093472,Lim; Seonhee,7,0,34,27
1657960525396,MATH 10B,B01,083739,Sinha; Shubham,14,0,30,16
1657960531426,MATH 18,A01,083743,Cinel; Cameron Alexander,9,0,30,21
1657960531426,MATH 18,A02,083744,Cinel; Cameron Alexander,18,0,30,12
1657960531426,MATH 18,A03,083745,Cinel; Cameron Alexander,10,0,30,20
1657960531426,MATH 18,B01,083748,Rideout; David Porter,5,0,37,32
1657960531426,MATH 18,B02,083749,Rideout; David Porter,5,0,36,31
1657960531426,MATH 18,B03,083750,Rideout; David Porter,3,0,37,34
1657960531426,MATH 18,B04,083751,Rideout; David Porter,7,0,36,29
1657960531426,MATH 18,B05,093473,Rideout; David Porter,7,0,36,29
1657960531426,MATH 18,B06,093474,Rideout; David Porter,6,0,36,30
1657960537455,MATH 20A,A01,083754,Zheng; Zequn,14,0,40,26
1657960543493,MATH 20B,A01,083756,Briones; Jor-el Thomas Caparas,4,0,36,32
1657960543493,MATH 20B,A02,083757,Briones; Jor-el Thomas Caparas,1,0,36,35
1657960543493,MATH 20B,A03,093475,Briones; Jor-el Thomas Caparas,3,0,36,33
1657960549519,MATH 20C,A01,083760,Briones; Jor-el Thomas Caparas,1,0,35,34
1657960549519,MATH 20C,A02,083761,Briones; Jor-el Thomas Caparas,8,0,35,27
1657960549519,MATH 20C,A03,093476,Briones; Jor-el Thomas Caparas,0,1,36,36
1657960549519,MATH 20C,B01,083762,Bach; Quang Tran,1,0,30,29
1657960555544,MATH 20D,A01,083765,Tran; Brian Kha,5,0,30,25
1657960555544,MATH 20D,A02,083766,Tran; Brian Kha,5,0,30,25
1657960555544,MATH 20D,A03,083767,Tran; Brian Kha,6,0,30,24
1657960561584,MATH 20E,A01,083771,Ganguly; Soumya,12,0,32,20
1657960561584,MATH 20E,A02,083772,Ganguly; Soumya,7,0,32,25
1657960561584,MATH 20E,B01,083773,Ciotti; Benjamin,20,0,35,15
1657960561584,MATH 20E,B02,083774,Ciotti; Benjamin,18,0,35,17
1657960567608,MATH 103A,A01,083777,Greenfeld; Be'Eri,6,0,36,30
1657960567608,MATH 103A,A02,083778,Greenfeld; Be'Eri,5,0,36,31
1657960567608,MATH 103A,A03,093561,Greenfeld; Be'Eri,7,0,36,29
1657960567608,MATH 103A,B01,083779,Greenfeld; Be'Eri,8,0,36,28
1657960567608,MATH 103A,B02,083780,Greenfeld; Be'Eri,4,0,36,32
1657960567608,MATH 103A,B03,093562,Greenfeld; Be'Eri,3,0,36,33
1657960573632,MATH 105,A01,085443,Carter; Anne Toulson,15,0,35,20
1657960573632,MATH 105,A02,093477,Carter; Anne Toulson,20,0,35,15
1657960579681,MATH 109,A01,083213,Ganzberger; Geoffrey Michael,3,0,34,31
1657960579681,MATH 109,A02,083214,Ganzberger; Geoffrey Michael,4,0,34,30
1657960579681,MATH 109,A03,093478,Ganzberger; Geoffrey Michael,2,0,34,32
1657960579681,MATH 109,B01,083215,Ganzberger; Geoffrey Michael,3,0,32,29
1657960579681,MATH 109,B02,083216,Ganzberger; Geoffrey Michael,3,0,32,29
1657960579681,MATH 109,B03,093479,Ganzberger; Geoffrey Michael,8,0,32,24
1657960585711,MATH 142A,A01,083219,Chow; Bennett,7,0,32,25
1657960585711,MATH 142A,A02,083220,Chow; Bennett,10,0,32,22
1657960585711,MATH 142A,A03,093480,Chow; Bennett,9,0,32,23
1657960585711,MATH 142A,B03,093481,Chow; Bennett,8,0,32,24
1657960585711,MATH 142A,B04,093558,Chow; Bennett,14,0,32,18
1657960585711,MATH 142A,B05,093559,Chow; Bennett,7,0,32,25
1657960591736,MATH 193A,A01,083224,Rotar; Vladimir,9,0,34,25
1657960591736,MATH 193A,A02,083225,Rotar; Vladimir,11,0,34,23
1657960591736,MATH 193A,A03,083781,Rotar; Vladimir,5,0,34,29
1657960591736,MATH 193A,A04,083782,Rotar; Vladimir,12,0,34,22
1657960591736,MATH 193A,A05,093482,Rotar; Vladimir,11,0,34,23
1657960597760,MATH 197,001,091859,McAuley; Julian John,9999,0,9999,0
1657960597760,MATH 197,002,095566,Kedlaya; Kiran S.,9997,0,9999,2
1657960597760,MATH 197,003,095567,Xiao; Ming,9999,0,9999,0
1657960597760,MATH 197,004,095571,Perols; Johan Lars,9998,0,9999,1
1657960604832,COGS 9,A01,083615,Shannon; Kyle Michael,11,0,75,64
1657960610856,COGS 11,A01,083617,Boyle; Mary E. T.,23,0,48,25
1657960616879,COGS 13,A01,083071,Bastos; Amalia Pinkusfeld,12,0,71,59
1657960622904,COGS 14A,A01,092681,Semenuks; Arturs,5,1,100,95
1657960628935,COGS 14B,A01,083073,Cheng; Tzu-Han,7,0,63,56
1657960634974,COGS 17,A01,092677,Semenuks; Arturs,7,0,81,74
1657960641008,COGS 100,A01,083619,Allen; Michael Gordon,17,0,70,53
1657960647043,COGS 101A,A01,083621,Davis; Joshua Daniel,9,0,68,59
1657960653078,COGS 101B,A01,091572,Allen; Michael Gordon,14,0,65,51
1657960659106,COGS 101C,A01,083625,Delgado; Tania,17,0,35,18
1657960665150,COGS 107A,A01,083627,Boyle; Mary E. T.,14,0,60,46
1657960671178,COGS 118A,A01,083075,Gupta; Anjum,21,0,76,55
1657960677203,CSE 3,A50,083646,Miranda; Gregory Joseph,24,0,50,26
1657960683228,CSE 8A,A50,083650,Miranda; Gregory Joseph,17,1,56,39
1657960689254,CSE 11,A01,083080,Cao; Yingjun,7,15,40,33
1657960695277,CSE 12,A01,083652,Krause-Levy; Sophia Louisa,30,1,120,90
1657960701306,CSE 15L,A01,083654,Morris; Justin Loren,9,0,50,41
1657960701306,CSE 15L,A02,083655,Morris; Justin Loren,11,0,50,39
1657960707330,CSE 20,A01,083657,Tran; Khoa Dang,39,0,80,41
1657960713357,CSE 21,A01,095574,Bach; Quang Tran,23,0,48,25
1657960719387,CSE 30,A01,083084,Eldon; John,8,0,80,72
1657960719387,CSE 30,B01,095061,Bhaskar; Nishant,9,0,50,41
1657960725411,CSE 100,A01,083659,Cao; Yingjun,5,4,70,65
1657960731439,CSE 134B,A01,083661,Powell; Thomas Allan,25,0,100,75
1657960737467,CSE 140,A01,083663,Gungor; Onat,17,0,85,68
1657960743502,CSE 140L,A01,083088,Eldon; John,23,0,100,77
1657960749530,CSE 175,A01,083665,Kumar; Rakesh,3,0,25,22
1657960755554,CSE 190,A00,092507,Dubnov; Shlomo,8,0,20,12
1657960761579,ECE 45,A01,083139,Congero; Spencer William,7,0,75,68
1657960767616,ECE 65,A50,083695,Saad; Andrew S,12,0,30,18
1657960767616,ECE 65,A51,095125,Saad; Andrew S,24,0,26,2
1657960773648,ECE 109,A01,091882,Touri; Behrouz,21,0,70,49
1657960779674,ECE 180,A00,083140,Abi Samra; Nicholas Camill,1,0,30,29
1657960779674,ECE 180,B00,083141,Abi Samra; Nicholas Camill,0,0,30,30
1657960785716,MATH 10A,A01,083735,Patchell; Gregory David,2,0,30,28
1657960785716,MATH 10A,A02,083736,Patchell; Gregory David,20,0,30,10
1657960785716,MATH 10A,A03,083737,Patchell; Gregory David,16,0,30,14
1657960791741,MATH 10B,A01,083207,Lim; Seonhee,9,0,34,25
1657960791741,MATH 10B,A02,083208,Lim; Seonhee,10,0,35,25
1657960791741,MATH 10B,A03,093472,Lim; Seonhee,7,0,34,27
1657960791741,MATH 10B,B01,083739,Sinha; Shubham,14,0,30,16
1657960797769,MATH 18,A01,083743,Cinel; Cameron Alexander,9,0,30,21
1657960797769,MATH 18,A02,083744,Cinel; Cameron Alexander,18,0,30,12
1657960797769,MATH 18,A03,083745,Cinel; Cameron Alexander,10,0,30,20
1657960797769,MATH 18,B01,083748,Rideout; David Porter,5,0,37,32
1657960797769,MATH 18,B02,083749,Rideout; David Porter,5,0,36,31
1657960797769,MATH 18,B03,083750,Rideout; David Porter,3,0,37,34
1657960797769,MATH 18,B04,083751,Rideout; David Porter,7,0,36,29
1657960797769,MATH 18,B05,093473,Rideout; David Porter,7,0,36,29
1657960797769,MATH 18,B06,093474,Rideout; David Porter,6,0,36,30
1657960803793,MATH 20A,A01,083754,Zheng; Zequn,14,0,40,26
1657960809821,MATH 20B,A01,083756,Briones; Jor-el Thomas Caparas,4,0,36,32
1657960809821,MATH 20B,A02,083757,Briones; Jor-el Thomas Caparas,1,0,36,35
1657960809821,MATH 20B,A03,093475,Briones; Jor-el Thomas Caparas,3,0,36,33
1657960815845,MATH 20C,A01,083760,Briones; Jor-el Thomas Caparas,1,0,35,34
1657960815845,MATH 20C,A02,083761,Briones; Jor-el Thomas Caparas,8,0,35,27
1657960815845,MATH 20C,A03,093476,Briones; Jor-el Thomas Caparas,0,1,36,36
1657960815845,MATH 20C,B01,083762,Bach; Quang Tran,1,0,30,29
1657960821874,MATH 20D,A01,083765,Tran; Brian Kha,5,0,30,25
1657960821874,MATH 20D,A02,083766,Tran; Brian Kha,5,0,30,25
1657960821874,MATH 20D,A03,083767,Tran; Brian Kha,6,0,30,24
1657960827907,MATH 20E,A01,083771,Ganguly; Soumya,12,0,32,20
1657960827907,MATH 20E,A02,083772,Ganguly; Soumya,7,0,32,25
1657960827907,MATH 20E,B01,083773,Ciotti; Benjamin,20,0,35,15
1657960827907,MATH 20E,B02,083774,Ciotti; Benjamin,18,0,35,17
1657960833931,MATH 103A,A01,083777,Greenfeld; Be'Eri,6,0,36,30
1657960833931,MATH 103A,A02,083778,Greenfeld; Be'Eri,5,0,36,31
1657960833931,MATH 103A,A03,093561,Greenfeld; Be'Eri,7,0,36,29
1657960833931,MATH 103A,B01,083779,Greenfeld; Be'Eri,8,0,36,28
1657960833931,MATH 103A,B02,083780,Greenfeld; Be'Eri,4,0,36,32
1657960833931,MATH 103A,B03,093562,Greenfeld; Be'Eri,3,0,36,33
1657960839956,MATH 105,A01,085443,Carter; Anne Toulson,15,0,35,20
1657960839956,MATH 105,A02,093477,Carter; Anne Toulson,20,0,35,15
1657960845987,MATH 109,A01,083213,Ganzberger; Geoffrey Michael,3,0,34,31
1657960845987,MATH 109,A02,083214,Ganzberger; Geoffrey Michael,4,0,34,30
1657960845987,MATH 109,A03,093478,Ganzberger; Geoffrey Michael,2,0,34,32
1657960845987,MATH 109,B01,083215,Ganzberger; Geoffrey Michael,3,0,32,29
1657960845987,MATH 109,B02,083216,Ganzberger; Geoffrey Michael,3,0,32,29
1657960845987,MATH 109,B03,093479,Ganzberger; Geoffrey Michael,8,0,32,24
1657960852013,MATH 142A,A01,083219,Chow; Bennett,7,0,32,25
1657960852013,MATH 142A,A02,083220,Chow; Bennett,10,0,32,22
1657960852013,MATH 142A,A03,093480,Chow; Bennett,9,0,32,23
1657960852013,MATH 142A,B03,093481,Chow; Bennett,8,0,32,24
1657960852013,MATH 142A,B04,093558,Chow; Bennett,14,0,32,18
1657960852013,MATH 142A,B05,093559,Chow; Bennett,7,0,32,25
1657960858035,MATH 193A,A01,083224,Rotar; Vladimir,9,0,34,25
1657960858035,MATH 193A,A02,083225,Rotar; Vladimir,11,0,34,23
1657960858035,MATH 193A,A03,083781,Rotar; Vladimir,5,0,34,29
1657960858035,MATH 193A,A04,083782,Rotar; Vladimir,12,0,34,22
1657960858035,MATH 193A,A05,093482,Rotar; Vladimir,11,0,34,23
1657960864063,MATH 197,001,091859,McAuley; Julian John,9999,0,9999,0
1657960864063,MATH 197,002,095566,Kedlaya; Kiran S.,9997,0,9999,2
1657960864063,MATH 197,003,095567,Xiao; Ming,9999,0,9999,0
1657960864063,MATH 197,004,095571,Perols; Johan Lars,9998,0,9999,1
1657960871170,COGS 9,A01,083615,Shannon; Kyle Michael,11,0,75,64
1657960877253,COGS 11,A01,083617,Boyle; Mary E. T.,23,0,48,25
1657960883278,COGS 13,A01,083071,Bastos; Amalia Pinkusfeld,12,0,71,59
1657960889313,COGS 14A,A01,092681,Semenuks; Arturs,5,1,100,95
1657960895338,COGS 14B,A01,083073,Cheng; Tzu-Han,7,0,63,56
1657960901366,COGS 17,A01,092677,Semenuks; Arturs,7,0,81,74
1657960907403,COGS 100,A01,083619,Allen; Michael Gordon,17,0,70,53
1657960913445,COGS 101A,A01,083621,Davis; Joshua Daniel,9,0,68,59
1657960919469,COGS 101B,A01,091572,Allen; Michael Gordon,14,0,65,51
1657960925599,COGS 101C,A01,083625,Delgado; Tania,17,0,35,18
1657960931649,COGS 107A,A01,083627,Boyle; Mary E. T.,14,0,60,46
1657960937680,COGS 118A,A01,083075,Gupta; Anjum,21,0,76,55
1657960943705,CSE 3,A50,083646,Miranda; Gregory Joseph,24,0,50,26
1657960949731,CSE 8A,A50,083650,Miranda; Gregory Joseph,17,1,56,39
1657960955772,CSE 11,A01,083080,Cao; Yingjun,7,15,40,33
1657960961818,CSE 12,A01,083652,Krause-Levy; Sophia Louisa,30,1,120,90
1657960967847,CSE 15L,A01,083654,Morris; Justin Loren,9,0,50,41
1657960967847,CSE 15L,A02,083655,Morris; Justin Loren,11,0,50,39
1657960973871,CSE 20,A01,083657,Tran; Khoa Dang,39,0,80,41
1657960979896,CSE 21,A01,095574,Bach; Quang Tran,23,0,48,25
1657960985922,CSE 30,A01,083084,Eldon; John,8,0,80,72
1657960985922,CSE 30,B01,095061,Bhaskar; Nishant,9,0,50,41
1657960991946,CSE 100,A01,083659,Cao; Yingjun,5,4,70,65
1657960997971,CSE 134B,A01,083661,Powell; Thomas Allan,25,0,100,75
1657961004002,CSE 140,A01,083663,Gungor; Onat,17,0,85,68
1657961010043,CSE 140L,A01,083088,Eldon; John,23,0,100,77
1657961016070,CSE 175,A01,083665,Kumar; Rakesh,3,0,25,22
1657961022101,CSE 190,A00,092507,Dubnov; Shlomo,8,0,20,12
1657961028144,ECE 45,A01,083139,Congero; Spencer William,7,0,75,68
1657961034170,ECE 65,A50,083695,Saad; Andrew S,12,0,30,18
1657961034170,ECE 65,A51,095125,Saad; Andrew S,24,0,26,2
1657961040207,ECE 109,A01,091882,Touri; Behrouz,21,0,70,49
1657961046247,ECE 180,A00,083140,Abi Samra; Nicholas Camill,1,0,30,29
1657961046247,ECE 180,B00,083141,Abi Samra; Nicholas Camill,0,0,30,30
1657961052282,MATH 10A,A01,083735,Patchell; Gregory David,2,0,30,28
1657961052282,MATH 10A,A02,083736,Patchell; Gregory David,20,0,30,10
1657961052282,MATH 10A,A03,083737,Patchell; Gregory David,16,0,30,14
1657961058327,MATH 10B,A01,083207,Lim; Seonhee,9,0,34,25
1657961058327,MATH 10B,A02,083208,Lim; Seonhee,10,0,35,25
1657961058327,MATH 10B,A03,093472,Lim; Seonhee,7,0,34,27
1657961058327,MATH 10B,B01,083739,Sinha; Shubham,14,0,30,16
1657961064375,MATH 18,A01,083743,Cinel; Cameron Alexander,9,0,30,21
1657961064375,MATH 18,A02,083744,Cinel; Cameron Alexander,18,0,30,12
1657961064375,MATH 18,A03,083745,Cinel; Cameron Alexander,10,0,30,20
1657961064375,MATH 18,B01,083748,Rideout; David Porter,5,0,37,32
1657961064375,MATH 18,B02,083749,Rideout; David Porter,5,0,36,31
1657961064375,MATH 18,B03,083750,Rideout; David Porter,3,0,37,34
1657961064375,MATH 18,B04,083751,Rideout; David Porter,7,0,36,29
1657961064375,MATH 18,B05,093473,Rideout; David Porter,7,0,36,29
1657961064375,MATH 18,B06,093474,Rideout; David Porter,6,0,36,30
1657961070398,MATH 20A,A01,083754,Zheng; Zequn,14,0,40,26
1657961076448,MATH 20B,A01,083756,Briones; Jor-el Thomas Caparas,4,0,36,32
1657961076448,MATH 20B,A02,083757,Briones; Jor-el Thomas Caparas,1,0,36,35
1657961076448,MATH 20B,A03,093475,Briones; Jor-el Thomas Caparas,3,0,36,33
1657961082475,MATH 20C,A01,083760,Briones; Jor-el Thomas Caparas,1,0,35,34
1657961082475,MATH 20C,A02,083761,Briones; Jor-el Thomas Caparas,8,0,35,27
1657961082475,MATH 20C,A03,093476,Briones; Jor-el Thomas Caparas,0,1,36,36
1657961082475,MATH 20C,B01,083762,Bach; Quang Tran,1,0,30,29
1657961088518,MATH 20D,A01,083765,Tran; Brian Kha,5,0,30,25
1657961088518,MATH 20D,A02,083766,Tran; Brian Kha,5,0,30,25
1657961088518,MATH 20D,A03,083767,Tran; Brian Kha,6,0,30,24
1657961094543,MATH 20E,A01,083771,Ganguly; Soumya,12,0,32,20
1657961094543,MATH 20E,A02,083772,Ganguly; Soumya,7,0,32,25
1657961094543,MATH 20E,B01,083773,Ciotti; Benjamin,20,0,35,15
1657961094543,MATH 20E,B02,083774,Ciotti; Benjamin,18,0,35,17
1657961100581,MATH 103A,A01,083777,Greenfeld; Be'Eri,6,0,36,30
1657961100581,MATH 103A,A02,083778,Greenfeld; Be'Eri,5,0,36,31
1657961100581,MATH 103A,A03,093561,Greenfeld; Be'Eri,7,0,36,29
1657961100581,MATH 103A,B01,083779,Greenfeld; Be'Eri,8,0,36,28
1657961100581,MATH 103A,B02,083780,Greenfeld; Be'Eri,4,0,36,32
1657961100581,MATH 103A,B03,093562,Greenfeld; Be'Eri,3,0,36,33
1657961106625,MATH 105,A01,085443,Carter; Anne Toulson,15,0,35,20
1657961106625,MATH 105,A02,093477,Carter; Anne Toulson,20,0,35,15
1657961112651,MATH 109,A01,083213,Ganzberger; Geoffrey Michael,3,0,34,31
1657961112651,MATH 109,A02,083214,Ganzberger; Geoffrey Michael,4,0,34,30
1657961112651,MATH 109,A03,093478,Ganzberger; Geoffrey Michael,2,0,34,32
1657961112651,MATH 109,B01,083215,Ganzberger; Geoffrey Michael,3,0,32,29
1657961112651,MATH 109,B02,083216,Ganzberger; Geoffrey Michael,3,0,32,29
1657961112651,MATH 109,B03,093479,Ganzberger; Geoffrey Michael,8,0,32,24
1657961118678,MATH 142A,A01,083219,Chow; Bennett,7,0,32,25
1657961118678,MATH 142A,A02,083220,Chow; Bennett,10,0,32,22
1657961118678,MATH 142A,A03,093480,Chow; Bennett,9,0,32,23
1657961118678,MATH 142A,B03,093481,Chow; Bennett,8,0,32,24
1657961118678,MATH 142A,B04,093558,Chow; Bennett,14,0,32,18
1657961118678,MATH 142A,B05,093559,Chow; Bennett,7,0,32,25
1657961124725,MATH 193A,A01,083224,Rotar; Vladimir,9,0,34,25
1657961124725,MATH 193A,A02,083225,Rotar; Vladimir,11,0,34,23
1657961124725,MATH 193A,A03,083781,Rotar; Vladimir,5,0,34,29
1657961124725,MATH 193A,A04,083782,Rotar; Vladimir,12,0,34,22
1657961124725,MATH 193A,A05,093482,Rotar; Vladimir,11,0,34,23
1657961130753,MATH 197,001,091859,McAuley; Julian John,9999,0,9999,0
1657961130753,MATH 197,002,095566,Kedlaya; Kiran S.,9997,0,9999,2
1657961130753,MATH 197,003,095567,Xiao; Ming,9999,0,9999,0
1657961130753,MATH 197,004,095571,Perols; Johan Lars,9998,0,9999,1
1657961137814,COGS 9,A01,083615,Shannon; Kyle Michael,11,0,75,64
1657961143838,COGS 11,A01,083617,Boyle; Mary E. T.,23,0,48,25
1657961149866,COGS 13,A01,083071,Bastos; Amalia Pinkusfeld,12,0,71,59
1657961155902,COGS 14A,A01,092681,Semenuks; Arturs,5,1,100,95
1657961161932,COGS 14B,A01,083073,Cheng; Tzu-Han,7,0,63,56
1657961167959,COGS 17,A01,092677,Semenuks; Arturs,7,0,81,74
1657961174005,COGS 100,A01,083619,Allen; Michael Gordon,17,0,70,53
1657961180029,COGS 101A,A01,083621,Davis; Joshua Daniel,9,0,68,59
1657961186051,COGS 101B,A01,091572,Allen; Michael Gordon,14,0,65,51
1657961192093,COGS 101C,A01,083625,Delgado; Tania,17,0,35,18
1657961198123,COGS 107A,A01,083627,Boyle; Mary E. T.,14,0,60,46
1657961204163,COGS 118A,A01,083075,Gupta; Anjum,21,0,76,55
1657961210192,CSE 3,A50,083646,Miranda; Gregory Joseph,24,0,50,26
1657961216223,CSE 8A,A50,083650,Miranda; Gregory Joseph,17,1,56,39
1657961222261,CSE 11,A01,083080,Cao; Yingjun,7,15,40,33
1657961228286,CSE 12,A01,083652,Krause-Levy; Sophia Louisa,30,1,120,90
1657961234335,CSE 15L,A01,083654,Morris; Justin Loren,9,0,50,41
1657961234335,CSE 15L,A02,083655,Morris; Justin Loren,11,0,50,39
1657961240358,CSE 20,A01,083657,Tran; Khoa Dang,39,0,80,41
1657961246383,CSE 21,A01,095574,Bach; Quang Tran,23,0,48,25
1657961252417,CSE 30,A01,083084,Eldon; John,8,0,80,72
1657961252417,CSE 30,B01,095061,Bhaskar; Nishant,9,0,50,41
1657961258445,CSE 100,A01,083659,Cao; Yingjun,5,4,70,65
1657961264472,CSE 134B,A01,083661,Powell; Thomas Allan,25,0,100,75
1657961270497,CSE 140,A01,083663,Gungor; Onat,17,0,85,68
1657961276525,CSE 140L,A01,083088,Eldon; John,23,0,100,77
1657961282550,CSE 175,A01,083665,Kumar; Rakesh,3,0,25,22
1657961288593,CSE 190,A00,092507,Dubnov; Shlomo,8,0,20,12
1657961294617,ECE 45,A01,083139,Congero; Spencer William,7,0,75,68
1657961300642,ECE 65,A50,083695,Saad; Andrew S,12,0,30,18
1657961300642,ECE 65,A51,095125,Saad; Andrew S,24,0,26,2
1657961306669,ECE 109,A01,091882,Touri; Behrouz,21,0,70,49
1657961312701,ECE 180,A00,083140,Abi Samra; Nicholas Camill,1,0,30,29
1657961312701,ECE 180,B00,083141,Abi Samra; Nicholas Camill,0,0,30,30
1657961318728,MATH 10A,A01,083735,Patchell; Gregory David,2,0,30,28
1657961318728,MATH 10A,A02,083736,Patchell; Gregory David,20,0,30,10
1657961318728,MATH 10A,A03,083737,Patchell; Gregory David,16,0,30,14
1657961324763,MATH 10B,A01,083207,Lim; Seonhee,9,0,34,25
1657961324763,MATH 10B,A02,083208,Lim; Seonhee,10,0,35,25
1657961324763,MATH 10B,A03,093472,Lim; Seonhee,7,0,34,27
1657961324763,MATH 10B,B01,083739,Sinha; Shubham,14,0,30,16
1657961330799,MATH 18,A01,083743,Cinel; Cameron Alexander,9,0,30,21
1657961330799,MATH 18,A02,083744,Cinel; Cameron Alexander,18,0,30,12
1657961330799,MATH 18,A03,083745,Cinel; Cameron Alexander,10,0,30,20
1657961330799,MATH 18,B01,083748,Rideout; David Porter,5,0,37,32
1657961330799,MATH 18,B02,083749,Rideout; David Porter,5,0,36,31
1657961330799,MATH 18,B03,083750,Rideout; David Porter,3,0,37,34
1657961330799,MATH 18,B04,083751,Rideout; David Porter,7,0,36,29
1657961330799,MATH 18,B05,093473,Rideout; David Porter,7,0,36,29
1657961330799,MATH 18,B06,093474,Rideout; David Porter,6,0,36,30
1657961336829,MATH 20A,A01,083754,Zheng; Zequn,14,0,40,26
1657961342867,MATH 20B,A01,083756,Briones; Jor-el Thomas Caparas,4,0,36,32
1657961342867,MATH 20B,A02,083757,Briones; Jor-el Thomas Caparas,1,0,36,35
1657961342867,MATH 20B,A03,093475,Briones; Jor-el Thomas Caparas,3,0,36,33
1657961348893,MATH 20C,A01,083760,Briones; Jor-el Thomas Caparas,1,0,35,34
1657961348893,MATH 20C,A02,083761,Briones; Jor-el Thomas Caparas,8,0,35,27
1657961348893,MATH 20C,A03,093476,Briones; Jor-el Thomas Caparas,0,1,36,36
1657961348893,MATH 20C,B01,083762,Bach; Quang Tran,1,0,30,29
1657961354919,MATH 20D,A01,083765,Tran; Brian Kha,5,0,30,25
1657961354919,MATH 20D,A02,083766,Tran; Brian Kha,5,0,30,25
1657961354919,MATH 20D,A03,083767,Tran; Brian Kha,6,0,30,24
1657961360952,MATH 20E,A01,083771,Ganguly; Soumya,12,0,32,20
1657961360952,MATH 20E,A02,083772,Ganguly; Soumya,7,0,32,25
1657961360952,MATH 20E,B01,083773,Ciotti; Benjamin,20,0,35,15
1657961360952,MATH 20E,B02,083774,Ciotti; Benjamin,18,0,35,17
1657961366985,MATH 103A,A01,083777,Greenfeld; Be'Eri,6,0,36,30
1657961366985,MATH 103A,A02,083778,Greenfeld; Be'Eri,5,0,36,31
1657961366985,MATH 103A,A03,093561,Greenfeld; Be'Eri,7,0,36,29
1657961366985,MATH 103A,B01,083779,Greenfeld; Be'Eri,8,0,36,28
1657961366985,MATH 103A,B02,083780,Greenfeld; Be'Eri,4,0,36,32
1657961366985,MATH 103A,B03,093562,Greenfeld; Be'Eri,3,0,36,33
1657961373013,MATH 105,A01,085443,Carter; Anne Toulson,15,0,35,20
1657961373013,MATH 105,A02,093477,Carter; Anne Toulson,20,0,35,15
1657961379036,MATH 109,A01,083213,Ganzberger; Geoffrey Michael,3,0,34,31
1657961379036,MATH 109,A02,083214,Ganzberger; Geoffrey Michael,4,0,34,30
1657961379036,MATH 109,A03,093478,Ganzberger; Geoffrey Michael,2,0,34,32
1657961379036,MATH 109,B01,083215,Ganzberger; Geoffrey Michael,3,0,32,29
1657961379036,MATH 109,B02,083216,Ganzberger; Geoffrey Michael,3,0,32,29
1657961379036,MATH 109,B03,093479,Ganzberger; Geoffrey Michael,8,0,32,24
1657961385070,MATH 142A,A01,083219,Chow; Bennett,7,0,32,25
1657961385070,MATH 142A,A02,083220,Chow; Bennett,10,0,32,22
1657961385070,MATH 142A,A03,093480,Chow; Bennett,9,0,32,23
1657961385070,MATH 142A,B03,093481,Chow; Bennett,8,0,32,24
1657961385070,MATH 142A,B04,093558,Chow; Bennett,14,0,32,18
1657961385070,MATH 142A,B05,093559,Chow; Bennett,7,0,32,25
1657961391103,MATH 193A,A01,083224,Rotar; Vladimir,9,0,34,25
1657961391103,MATH 193A,A02,083225,Rotar; Vladimir,11,0,34,23
1657961391103,MATH 193A,A03,083781,Rotar; Vladimir,5,0,34,29
1657961391103,MATH 193A,A04,083782,Rotar; Vladimir,12,0,34,22
1657961391103,MATH 193A,A05,093482,Rotar; Vladimir,11,0,34,23
1657961397145,MATH 197,001,091859,McAuley; Julian John,9999,0,9999,0
1657961397145,MATH 197,002,095566,Kedlaya; Kiran S.,9997,0,9999,2
1657961397145,MATH 197,003,095567,Xiao; Ming,9999,0,9999,0
1657961397145,MATH 197,004,095571,Perols; Johan Lars,9998,0,9999,1
1657961404211,COGS 9,A01,083615,Shannon; Kyle Michael,11,0,75,64
1657961410238,COGS 11,A01,083617,Boyle; Mary E. T.,23,0,48,25
1657961416269,COGS 13,A01,083071,Bastos; Amalia Pinkusfeld,12,0,71,59
1657961422317,COGS 14A,A01,092681,Semenuks; Arturs,5,1,100,95
1657961428342,COGS 14B,A01,083073,Cheng; Tzu-Han,7,0,63,56
1657961434369,COGS 17,A01,092677,Semenuks; Arturs,7,0,81,74
1657961440391,COGS 100,A01,083619,Allen; Michael Gordon,17,0,70,53
1657961446417,COGS 101A,A01,083621,Davis; Joshua Daniel,9,0,68,59
1657961452442,COGS 101B,A01,091572,Allen; Michael Gordon,14,0,65,51
1657961458467,COGS 101C,A01,083625,Delgado; Tania,17,0,35,18
1657961464491,COGS 107A,A01,083627,Boyle; Mary E. T.,14,0,60,46
1657961470515,COGS 118A,A01,083075,Gupta; Anjum,21,0,76,55
1657961476544,CSE 3,A50,083646,Miranda; Gregory Joseph,24,0,50,26
1657961482576,CSE 8A,A50,083650,Miranda; Gregory Joseph,17,1,56,39
1657961488599,CSE 11,A01,083080,Cao; Yingjun,7,15,40,33
1657961494628,CSE 12,A01,083652,Krause-Levy; Sophia Louisa,30,1,120,90
1657961500656,CSE 15L,A01,083654,Morris; Justin Loren,9,0,50,41
1657961500656,CSE 15L,A02,083655,Morris; Justin Loren,11,0,50,39
1657961506680,CSE 20,A01,083657,Tran; Khoa Dang,39,0,80,41
1657961512703,CSE 21,A01,095574,Bach; Quang Tran,23,0,48,25
1657961518728,CSE 30,A01,083084,Eldon; John,8,0,80,72
1657961518728,CSE 30,B01,095061,Bhaskar; Nishant,9,0,50,41
1657961524853,CSE 100,A01,083659,Cao; Yingjun,5,4,70,65
1657961530876,CSE 134B,A01,083661,Powell; Thomas Allan,25,0,100,75
1657961536899,CSE 140,A01,083663,Gungor; Onat,17,0,85,68
1657961542922,CSE 140L,A01,083088,Eldon; John,23,0,100,77
1657961548947,CSE 175,A01,083665,Kumar; Rakesh,3,0,25,22
1657961554992,CSE 190,A00,092507,Dubnov; Shlomo,8,0,20,12
1657961561032,ECE 45,A01,083139,Congero; Spencer William,7,0,75,68
1657961567060,ECE 65,A50,083695,Saad; Andrew S,12,0,30,18
1657961567060,ECE 65,A51,095125,Saad; Andrew S,24,0,26,2
1657961573101,ECE 109,A01,091882,Touri; Behrouz,21,0,70,49
1657961579138,ECE 180,A00,083140,Abi Samra; Nicholas Camill,1,0,30,29
1657961579138,ECE 180,B00,083141,Abi Samra; Nicholas Camill,0,0,30,30
1657961585179,MATH 10A,A01,083735,Patchell; Gregory David,2,0,30,28
1657961585179,MATH 10A,A02,083736,Patchell; Gregory David,20,0,30,10
1657961585179,MATH 10A,A03,083737,Patchell; Gregory David,16,0,30,14
1657961591214,MATH 10B,A01,083207,Lim; Seonhee,9,0,34,25
1657961591214,MATH 10B,A02,083208,Lim; Seonhee,10,0,35,25
1657961591214,MATH 10B,A03,093472,Lim; Seonhee,7,0,34,27
1657961591214,MATH 10B,B01,083739,Sinha; Shubham,14,0,30,16
1657961597240,MATH 18,A01,083743,Cinel; Cameron Alexander,9,0,30,21
1657961597240,MATH 18,A02,083744,Cinel; Cameron Alexander,18,0,30,12
1657961597240,MATH 18,A03,083745,Cinel; Cameron Alexander,10,0,30,20
1657961597240,MATH 18,B01,083748,Rideout; David Porter,5,0,37,32
1657961597240,MATH 18,B02,083749,Rideout; David Porter,5,0,36,31
1657961597240,MATH 18,B03,083750,Rideout; David Porter,3,0,37,34
1657961597240,MATH 18,B04,083751,Rideout; David Porter,7,0,36,29
1657961597240,MATH 18,B05,093473,Rideout; David Porter,7,0,36,29
1657961597240,MATH 18,B06,093474,Rideout; David Porter,6,0,36,30
1657961603283,MATH 20A,A01,083754,Zheng; Zequn,14,0,40,26
1657961609332,MATH 20B,A01,083756,Briones; Jor-el Thomas Caparas,4,0,36,32
1657961609332,MATH 20B,A02,083757,Briones; Jor-el Thomas Caparas,1,0,36,35
1657961609332,MATH 20B,A03,093475,Briones; Jor-el Thomas Caparas,3,0,36,33
1657961615363,MATH 20C,A01,083760,Briones; Jor-el Thomas Caparas,1,0,35,34
1657961615363,MATH 20C,A02,083761,Briones; Jor-el Thomas Caparas,8,0,35,27
1657961615363,MATH 20C,A03,093476,Briones; Jor-el Thomas Caparas,0,1,36,36
1657961615363,MATH 20C,B01,083762,Bach; Quang Tran,1,0,30,29
1657961621409,MATH 20D,A01,083765,Tran; Brian Kha,5,0,30,25
1657961621409,MATH 20D,A02,083766,Tran; Brian Kha,5,0,30,25
1657961621409,MATH 20D,A03,083767,Tran; Brian Kha,6,0,30,24
1657961627455,MATH 20E,A01,083771,Ganguly; Soumya,12,0,32,20
1657961627455,MATH 20E,A02,083772,Ganguly; Soumya,7,0,32,25
1657961627455,MATH 20E,B01,083773,Ciotti; Benjamin,20,0,35,15
1657961627455,MATH 20E,B02,083774,Ciotti; Benjamin,18,0,35,17
1657961633492,MATH 103A,A01,083777,Greenfeld; Be'Eri,6,0,36,30
1657961633492,MATH 103A,A02,083778,Greenfeld; Be'Eri,5,0,36,31
1657961633492,MATH 103A,A03,093561,Greenfeld; Be'Eri,7,0,36,29
1657961633492,MATH 103A,B01,083779,Greenfeld; Be'Eri,8,0,36,28
1657961633492,MATH 103A,B02,083780,Greenfeld; Be'Eri,4,0,36,32
1657961633492,MATH 103A,B03,093562,Greenfeld; Be'Eri,3,0,36,33
1657961639529,MATH 105,A01,085443,Carter; Anne Toulson,15,0,35,20
1657961639529,MATH 105,A02,093477,Carter; Anne Toulson,20,0,35,15
1657961645558,MATH 109,A01,083213,Ganzberger; Geoffrey Michael,3,0,34,31
1657961645558,MATH 109,A02,083214,Ganzberger; Geoffrey Michael,4,0,34,30
1657961645558,MATH 109,A03,093478,Ganzberger; Geoffrey Michael,2,0,34,32
1657961645558,MATH 109,B01,083215,Ganzberger; Geoffrey Michael,3,0,32,29
1657961645558,MATH 109,B02,083216,Ganzberger; Geoffrey Michael,3,0,32,29
1657961645558,MATH 109,B03,093479,Ganzberger; Geoffrey Michael,8,0,32,24
1657961651593,MATH 142A,A01,083219,Chow; Bennett,7,0,32,25
1657961651593,MATH 142A,A02,083220,Chow; Bennett,10,0,32,22
1657961651593,MATH 142A,A03,093480,Chow; Bennett,9,0,32,23
1657961651593,MATH 142A,B03,093481,Chow; Bennett,8,0,32,24
1657961651593,MATH 142A,B04,093558,Chow; Bennett,14,0,32,18
1657961651593,MATH 142A,B05,093559,Chow; Bennett,7,0,32,25
1657961657623,MATH 193A,A01,083224,Rotar; Vladimir,9,0,34,25
1657961657623,MATH 193A,A02,083225,Rotar; Vladimir,11,0,34,23
1657961657623,MATH 193A,A03,083781,Rotar; Vladimir,5,0,34,29
1657961657623,MATH 193A,A04,083782,Rotar; Vladimir,12,0,34,22
1657961657623,MATH 193A,A05,093482,Rotar; Vladimir,11,0,34,23
1657961663672,MATH 197,001,091859,McAuley; Julian John,9999,0,9999,0
1657961663672,MATH 197,002,095566,Kedlaya; Kiran S.,9997,0,9999,2
1657961663672,MATH 197,003,095567,Xiao; Ming,9999,0,9999,0
1657961663672,MATH 197,004,095571,Perols; Johan Lars,9998,0,9999,1
1657961670754,COGS 9,A01,083615,Shannon; Kyle Michael,11,0,75,64
1657961676779,COGS 11,A01,083617,Boyle; Mary E. T.,23,0,48,25
1657961682835,COGS 13,A01,083071,Bastos; Amalia Pinkusfeld,12,0,71,59
1657961688864,COGS 14A,A01,092681,Semenuks; Arturs,5,1,100,95
1657961694901,COGS 14B,A01,083073,Cheng; Tzu-Han,7,0,63,56
1657961700942,COGS 17,A01,092677,Semenuks; Arturs,7,0,81,74
1657961706966,COGS 100,A01,083619,Allen; Michael Gordon,17,0,70,53
1657961712994,COGS 101A,A01,083621,Davis; Joshua Daniel,9,0,68,59
1657961719019,COGS 101B,A01,091572,Allen; Michael Gordon,14,0,65,51
1657961725042,COGS 101C,A01,083625,Delgado; Tania,17,0,35,18
1657961731079,COGS 107A,A01,083627,Boyle; Mary E. T.,14,0,60,46
1657961737118,COGS 118A,A01,083075,Gupta; Anjum,21,0,76,55
1657961743154,CSE 3,A50,083646,Miranda; Gregory Joseph,24,0,50,26
1657961749198,CSE 8A,A50,083650,Miranda; Gregory Joseph,17,1,56,39
1657961755222,CSE 11,A01,083080,Cao; Yingjun,7,15,40,33
1657961761252,CSE 12,A01,083652,Krause-Levy; Sophia Louisa,30,1,120,90
1657961767277,CSE 15L,A01,083654,Morris; Justin Loren,9,0,50,41
1657961767277,CSE 15L,A02,083655,Morris; Justin Loren,11,0,50,39
1657961773302,CSE 20,A01,083657,Tran; Khoa Dang,39,0,80,41
1657961779350,CSE 21,A01,095574,Bach; Quang Tran,23,0,48,25
1657961785402,CSE 30,A01,083084,Eldon; John,8,0,80,72
1657961785402,CSE 30,B01,095061,Bhaskar; Nishant,9,0,50,41
1657961791429,CSE 100,A01,083659,Cao; Yingjun,5,4,70,65
1657961797454,CSE 134B,A01,083661,Powell; Thomas Allan,25,0,100,75
1657961803480,CSE 140,A01,083663,Gungor; Onat,17,0,85,68
1657961809513,CSE 140L,A01,083088,Eldon; John,23,0,100,77
1657961815544,CSE 175,A01,083665,Kumar; Rakesh,3,0,25,22
1657961821569,CSE 190,A00,092507,Dubnov; Shlomo,8,0,20,12
1657961827595,ECE 45,A01,083139,Congero; Spencer William,7,0,75,68
1657961833655,ECE 65,A50,083695,Saad; Andrew S,12,0,30,18
1657961833655,ECE 65,A51,095125,Saad; Andrew S,24,0,26,2
1657961839705,ECE 109,A01,091882,Touri; Behrouz,21,0,70,49
1657961845729,ECE 180,A00,083140,Abi Samra; Nicholas Camill,1,0,30,29
1657961845729,ECE 180,B00,083141,Abi Samra; Nicholas Camill,0,0,30,30
1657961851753,MATH 10A,A01,083735,Patchell; Gregory David,2,0,30,28
1657961851753,MATH 10A,A02,083736,Patchell; Gregory David,20,0,30,10
1657961851753,MATH 10A,A03,083737,Patchell; Gregory David,16,0,30,14
1657961857795,MATH 10B,A01,083207,Lim; Seonhee,9,0,34,25
1657961857795,MATH 10B,A02,083208,Lim; Seonhee,10,0,35,25
1657961857795,MATH 10B,A03,093472,Lim; Seonhee,7,0,34,27
1657961857795,MATH 10B,B01,083739,Sinha; Shubham,14,0,30,16
1657961863840,MATH 18,A01,083743,Cinel; Cameron Alexander,9,0,30,21
1657961863840,MATH 18,A02,083744,Cinel; Cameron Alexander,18,0,30,12
1657961863840,MATH 18,A03,083745,Cinel; Cameron Alexander,10,0,30,20
1657961863840,MATH 18,B01,083748,Rideout; David Porter,5,0,37,32
1657961863840,MATH 18,B02,083749,Rideout; David Porter,5,0,36,31
1657961863840,MATH 18,B03,083750,Rideout; David Porter,3,0,37,34
1657961863840,MATH 18,B04,083751,Rideout; David Porter,7,0,36,29
1657961863840,MATH 18,B05,093473,Rideout; David Porter,7,0,36,29
1657961863840,MATH 18,B06,093474,Rideout; David Porter,6,0,36,30
1657961869882,MATH 20A,A01,083754,Zheng; Zequn,14,0,40,26
1657961875910,MATH 20B,A01,083756,Briones; Jor-el Thomas Caparas,4,0,36,32
1657961875910,MATH 20B,A02,083757,Briones; Jor-el Thomas Caparas,1,0,36,35
1657961875910,MATH 20B,A03,093475,Briones; Jor-el Thomas Caparas,3,0,36,33
1657961881966,MATH 20C,A01,083760,Briones; Jor-el Thomas Caparas,1,0,35,34
1657961881966,MATH 20C,A02,083761,Briones; Jor-el Thomas Caparas,8,0,35,27
1657961881966,MATH 20C,A03,093476,Briones; Jor-el Thomas Caparas,0,1,36,36
1657961881966,MATH 20C,B01,083762,Bach; Quang Tran,1,0,30,29
1657961887989,MATH 20D,A01,083765,Tran; Brian Kha,5,0,30,25
1657961887989,MATH 20D,A02,083766,Tran; Brian Kha,5,0,30,25
1657961887989,MATH 20D,A03,083767,Tran; Brian Kha,6,0,30,24
1657961894023,MATH 20E,A01,083771,Ganguly; Soumya,12,0,32,20
1657961894023,MATH 20E,A02,083772,Ganguly; Soumya,7,0,32,25
1657961894023,MATH 20E,B01,083773,Ciotti; Benjamin,20,0,35,15
1657961894023,MATH 20E,B02,083774,Ciotti; Benjamin,18,0,35,17
1657961900057,MATH 103A,A01,083777,Greenfeld; Be'Eri,6,0,36,30
1657961900057,MATH 103A,A02,083778,Greenfeld; Be'Eri,5,0,36,31
1657961900057,MATH 103A,A03,093561,Greenfeld; Be'Eri,7,0,36,29
1657961900057,MATH 103A,B01,083779,Greenfeld; Be'Eri,8,0,36,28
1657961900057,MATH 103A,B02,083780,Greenfeld; Be'Eri,4,0,36,32
1657961900057,MATH 103A,B03,093562,Greenfeld; Be'Eri,3,0,36,33
1657961906080,MATH 105,A01,085443,Carter; Anne Toulson,15,0,35,20
1657961906080,MATH 105,A02,093477,Carter; Anne Toulson,20,0,35,15
1657961912117,MATH 109,A01,083213,Ganzberger; Geoffrey Michael,3,0,34,31
1657961912117,MATH 109,A02,083214,Ganzberger; Geoffrey Michael,4,0,34,30
1657961912117,MATH 109,A03,093478,Ganzberger; Geoffrey Michael,2,0,34,32
1657961912117,MATH 109,B01,083215,Ganzberger; Geoffrey Michael,3,0,32,29
1657961912117,MATH 109,B02,083216,Ganzberger; Geoffrey Michael,3,0,32,29
1657961912117,MATH 109,B03,093479,Ganzberger; Geoffrey Michael,8,0,32,24
1657961918149,MATH 142A,A01,083219,Chow; Bennett,7,0,32,25
1657961918149,MATH 142A,A02,083220,Chow; Bennett,10,0,32,22
1657961918149,MATH 142A,A03,093480,Chow; Bennett,9,0,32,23
1657961918149,MATH 142A,B03,093481,Chow; Bennett,8,0,32,24
1657961918149,MATH 142A,B04,093558,Chow; Bennett,14,0,32,18
1657961918149,MATH 142A,B05,093559,Chow; Bennett,7,0,32,25
1657961924174,MATH 193A,A01,083224,Rotar; Vladimir,9,0,34,25
1657961924174,MATH 193A,A02,083225,Rotar; Vladimir,11,0,34,23
1657961924174,MATH 193A,A03,083781,Rotar; Vladimir,5,0,34,29
1657961924174,MATH 193A,A04,083782,Rotar; Vladimir,12,0,34,22
1657961924174,MATH 193A,A05,093482,Rotar; Vladimir,11,0,34,23
1657961930202,MATH 197,001,091859,McAuley; Julian John,9999,0,9999,0
1657961930202,MATH 197,002,095566,Kedlaya; Kiran S.,9997,0,9999,2
1657961930202,MATH 197,003,095567,Xiao; Ming,9999,0,9999,0
1657961930202,MATH 197,004,095571,Perols; Johan Lars,9998,0,9999,1
1657961937286,COGS 9,A01,083615,Shannon; Kyle Michael,11,0,75,64
1657961943309,COGS 11,A01,083617,Boyle; Mary E. T.,23,0,48,25
1657961949337,COGS 13,A01,083071,Bastos; Amalia Pinkusfeld,12,0,71,59
1657961955385,COGS 14A,A01,092681,Semenuks; Arturs,5,1,100,95
1657961961413,COGS 14B,A01,083073,Cheng; Tzu-Han,7,0,63,56
1657961967442,COGS 17,A01,092677,Semenuks; Arturs,7,0,81,74
1657961973466,COGS 100,A01,083619,Allen; Michael Gordon,17,0,70,53
1657961979503,COGS 101A,A01,083621,Davis; Joshua Daniel,9,0,68,59
1657961985531,COGS 101B,A01,091572,Allen; Michael Gordon,14,0,65,51
1657961991561,COGS 101C,A01,083625,Delgado; Tania,17,0,35,18
1657961997618,COGS 107A,A01,083627,Boyle; Mary E. T.,14,0,60,46
1657962003643,COGS 118A,A01,083075,Gupta; Anjum,21,0,76,55
1657962009697,CSE 3,A50,083646,Miranda; Gregory Joseph,24,0,50,26
1657962015720,CSE 8A,A50,083650,Miranda; Gregory Joseph,17,1,56,39
1657962021760,CSE 11,A01,083080,Cao; Yingjun,7,15,40,33
1657962027782,CSE 12,A01,083652,Krause-Levy; Sophia Louisa,30,1,120,90
1657962033820,CSE 15L,A01,083654,Morris; Justin Loren,9,0,50,41
1657962033820,CSE 15L,A02,083655,Morris; Justin Loren,11,0,50,39
1657962039843,CSE 20,A01,083657,Tran; Khoa Dang,39,0,80,41
1657962045880,CSE 21,A01,095574,Bach; Quang Tran,23,0,48,25
1657962051905,CSE 30,A01,083084,Eldon; John,8,0,80,72
1657962051905,CSE 30,B01,095061,Bhaskar; Nishant,9,0,50,41
1657962057929,CSE 100,A01,083659,Cao; Yingjun,5,4,70,65
1657962063967,CSE 134B,A01,083661,Powell; Thomas Allan,25,0,100,75
1657962069992,CSE 140,A01,083663,Gungor; Onat,17,0,85,68
1657962076026,CSE 140L,A01,083088,Eldon; John,23,0,100,77
1657962082053,CSE 175,A01,083665,Kumar; Rakesh,3,0,25,22
1657962088098,CSE 190,A00,092507,Dubnov; Shlomo,8,0,20,12
1657962094132,ECE 45,A01,083139,Congero; Spencer William,7,0,75,68
1657962100158,ECE 65,A50,083695,Saad; Andrew S,12,0,30,18
1657962100158,ECE 65,A51,095125,Saad; Andrew S,24,0,26,2
1657962106191,ECE 109,A01,091882,Touri; Behrouz,21,0,70,49
1657962112217,ECE 180,A00,083140,Abi Samra; Nicholas Camill,1,0,30,29
1657962112217,ECE 180,B00,083141,Abi Samra; Nicholas Camill,0,0,30,30
1657962118247,MATH 10A,A01,083735,Patchell; Gregory David,2,0,30,28
1657962118247,MATH 10A,A02,083736,Patchell; Gregory David,20,0,30,10
1657962118247,MATH 10A,A03,083737,Patchell; Gregory David,16,0,30,14
1657962124392,MATH 10B,A01,083207,Lim; Seonhee,9,0,34,25
1657962124392,MATH 10B,A02,083208,Lim; Seonhee,10,0,35,25
1657962124392,MATH 10B,A03,093472,Lim; Seonhee,7,0,34,27
1657962124392,MATH 10B,B01,083739,Sinha; Shubham,14,0,30,16
1657962130421,MATH 18,A01,083743,Cinel; Cameron Alexander,9,0,30,21
1657962130421,MATH 18,A02,083744,Cinel; Cameron Alexander,18,0,30,12
1657962130421,MATH 18,A03,083745,Cinel; Cameron Alexander,10,0,30,20
1657962130421,MATH 18,B01,083748,Rideout; David Porter,5,0,37,32
1657962130421,MATH 18,B02,083749,Rideout; David Porter,5,0,36,31
1657962130421,MATH 18,B03,083750,Rideout; David Porter,3,0,37,34
1657962130421,MATH 18,B04,083751,Rideout; David Porter,7,0,36,29
1657962130421,MATH 18,B05,093473,Rideout; David Porter,7,0,36,29
1657962130421,MATH 18,B06,093474,Rideout; David Porter,6,0,36,30
1657962136455,MATH 20A,A01,083754,Zheng; Zequn,14,0,40,26
1657962142508,MATH 20B,A01,083756,Briones; Jor-el Thomas Caparas,4,0,36,32
1657962142508,MATH 20B,A02,083757,Briones; Jor-el Thomas Caparas,1,0,36,35
1657962142508,MATH 20B,A03,093475,Briones; Jor-el Thomas Caparas,3,0,36,33
1657962148559,MATH 20C,A01,083760,Briones; Jor-el Thomas Caparas,1,0,35,34
1657962148559,MATH 20C,A02,083761,Briones; Jor-el Thomas Caparas,8,0,35,27
1657962148559,MATH 20C,A03,093476,Briones; Jor-el Thomas Caparas,0,1,36,36
1657962148559,MATH 20C,B01,083762,Bach; Quang Tran,1,0,30,29
1657962154589,MATH 20D,A01,083765,Tran; Brian Kha,5,0,30,25
1657962154589,MATH 20D,A02,083766,Tran; Brian Kha,5,0,30,25
1657962154589,MATH 20D,A03,083767,Tran; Brian Kha,6,0,30,24
1657962160615,MATH 20E,A01,083771,Ganguly; Soumya,12,0,32,20
1657962160615,MATH 20E,A02,083772,Ganguly; Soumya,7,0,32,25
1657962160615,MATH 20E,B01,083773,Ciotti; Benjamin,20,0,35,15
1657962160615,MATH 20E,B02,083774,Ciotti; Benjamin,18,0,35,17
1657962166652,MATH 103A,A01,083777,Greenfeld; Be'Eri,6,0,36,30
1657962166652,MATH 103A,A02,083778,Greenfeld; Be'Eri,5,0,36,31
1657962166652,MATH 103A,A03,093561,Greenfeld; Be'Eri,7,0,36,29
1657962166652,MATH 103A,B01,083779,Greenfeld; Be'Eri,8,0,36,28
1657962166652,MATH 103A,B02,083780,Greenfeld; Be'Eri,4,0,36,32
1657962166652,MATH 103A,B03,093562,Greenfeld; Be'Eri,3,0,36,33
1657962172676,MATH 105,A01,085443,Carter; Anne Toulson,15,0,35,20
1657962172676,MATH 105,A02,093477,Carter; Anne Toulson,20,0,35,15
1657962178700,MATH 109,A01,083213,Ganzberger; Geoffrey Michael,3,0,34,31
1657962178700,MATH 109,A02,083214,Ganzberger; Geoffrey Michael,4,0,34,30
1657962178700,MATH 109,A03,093478,Ganzberger; Geoffrey Michael,2,0,34,32
1657962178700,MATH 109,B01,083215,Ganzberger; Geoffrey Michael,3,0,32,29
1657962178700,MATH 109,B02,083216,Ganzberger; Geoffrey Michael,3,0,32,29
1657962178700,MATH 109,B03,093479,Ganzberger; Geoffrey Michael,8,0,32,24
1657962184742,MATH 142A,A01,083219,Chow; Bennett,7,0,32,25
1657962184742,MATH 142A,A02,083220,Chow; Bennett,10,0,32,22
1657962184742,MATH 142A,A03,093480,Chow; Bennett,9,0,32,23
1657962184742,MATH 142A,B03,093481,Chow; Bennett,8,0,32,24
1657962184742,MATH 142A,B04,093558,Chow; Bennett,14,0,32,18
1657962184742,MATH 142A,B05,093559,Chow; Bennett,7,0,32,25
1657962190791,MATH 193A,A01,083224,Rotar; Vladimir,9,0,34,25
1657962190791,MATH 193A,A02,083225,Rotar; Vladimir,11,0,34,23
1657962190791,MATH 193A,A03,083781,Rotar; Vladimir,5,0,34,29
1657962190791,MATH 193A,A04,083782,Rotar; Vladimir,12,0,34,22
1657962190791,MATH 193A,A05,093482,Rotar; Vladimir,11,0,34,23
1657962196824,MATH 197,001,091859,McAuley; Julian John,9999,0,9999,0
1657962196824,MATH 197,002,095566,Kedlaya; Kiran S.,9997,0,9999,2
1657962196824,MATH 197,003,095567,Xiao; Ming,9999,0,9999,0
1657962196824,MATH 197,004,095571,Perols; Johan Lars,9998,0,9999,1
1657962203914,COGS 9,A01,083615,Shannon; Kyle Michael,11,0,75,64
1657962209963,COGS 11,A01,083617,Boyle; Mary E. T.,23,0,48,25
1657962215987,COGS 13,A01,083071,Bastos; Amalia Pinkusfeld,12,0,71,59
1657962222013,COGS 14A,A01,092681,Semenuks; Arturs,5,1,100,95
1657962228036,COGS 14B,A01,083073,Cheng; Tzu-Han,7,0,63,56
1657962234084,COGS 17,A01,092677,Semenuks; Arturs,7,0,81,74
1657962240108,COGS 100,A01,083619,Allen; Michael Gordon,17,0,70,53
1657962246133,COGS 101A,A01,083621,Davis; Joshua Daniel,9,0,68,59
1657962252178,COGS 101B,A01,091572,Allen; Michael Gordon,14,0,65,51
1657962258201,COGS 101C,A01,083625,Delgado; Tania,17,0,35,18
1657962264233,COGS 107A,A01,083627,Boyle; Mary E. T.,14,0,60,46
1657962270257,COGS 118A,A01,083075,Gupta; Anjum,21,0,76,55
1657962276281,CSE 3,A50,083646,Miranda; Gregory Joseph,24,0,50,26
1657962282316,CSE 8A,A50,083650,Miranda; Gregory Joseph,17,1,56,39
1657962288359,CSE 11,A01,083080,Cao; Yingjun,7,15,40,33
1657962294383,CSE 12,A01,083652,Krause-Levy; Sophia Louisa,30,1,120,90
1657962300408,CSE 15L,A01,083654,Morris; Justin Loren,9,0,50,41
1657962300408,CSE 15L,A02,083655,Morris; Justin Loren,11,0,50,39
1657962306431,CSE 20,A01,083657,Tran; Khoa Dang,39,0,80,41
1657962312475,CSE 21,A01,095574,Bach; Quang Tran,23,0,48,25
1657962318501,CSE 30,A01,083084,Eldon; John,8,0,80,72
1657962318501,CSE 30,B01,095061,Bhaskar; Nishant,9,0,50,41
1657962324535,CSE 100,A01,083659,Cao; Yingjun,5,4,70,65
1657962330564,CSE 134B,A01,083661,Powell; Thomas Allan,25,0,100,75
1657962336592,CSE 140,A01,083663,Gungor; Onat,17,0,85,68
1657962342616,CSE 140L,A01,083088,Eldon; John,23,0,100,77
1657962348639,CSE 175,A01,083665,Kumar; Rakesh,3,0,25,22
1657962354675,CSE 190,A00,092507,Dubnov; Shlomo,8,0,20,12
1657962360714,ECE 45,A01,083139,Congero; Spencer William,7,0,75,68
1657962366739,ECE 65,A50,083695,Saad; Andrew S,12,0,30,18
1657962366739,ECE 65,A51,095125,Saad; Andrew S,24,0,26,2
1657962372776,ECE 109,A01,091882,Touri; Behrouz,21,0,70,49
1657962378800,ECE 180,A00,083140,Abi Samra; Nicholas Camill,1,0,30,29
1657962378800,ECE 180,B00,083141,Abi Samra; Nicholas Camill,0,0,30,30
1657962384835,MATH 10A,A01,083735,Patchell; Gregory David,2,0,30,28
1657962384835,MATH 10A,A02,083736,Patchell; Gregory David,20,0,30,10
1657962384835,MATH 10A,A03,083737,Patchell; Gregory David,16,0,30,14
1657962390868,MATH 10B,A01,083207,Lim; Seonhee,9,0,34,25
1657962390868,MATH 10B,A02,083208,Lim; Seonhee,10,0,35,25
1657962390868,MATH 10B,A03,093472,Lim; Seonhee,7,0,34,27
1657962390868,MATH 10B,B01,083739,Sinha; Shubham,14,0,30,16
1657962396891,MATH 18,A01,083743,Cinel; Cameron Alexander,9,0,30,21
1657962396891,MATH 18,A02,083744,Cinel; Cameron Alexander,18,0,30,12
1657962396891,MATH 18,A03,083745,Cinel; Cameron Alexander,10,0,30,20
1657962396891,MATH 18,B01,083748,Rideout; David Porter,5,0,37,32
1657962396891,MATH 18,B02,083749,Rideout; David Porter,5,0,36,31
1657962396891,MATH 18,B03,083750,Rideout; David Porter,3,0,37,34
1657962396891,MATH 18,B04,083751,Rideout; David Porter,7,0,36,29
1657962396891,MATH 18,B05,093473,Rideout; David Porter,7,0,36,29
1657962396891,MATH 18,B06,093474,Rideout; David Porter,6,0,36,30
1657962402923,MATH 20A,A01,083754,Zheng; Zequn,14,0,40,26
1657962408959,MATH 20B,A01,083756,Briones; Jor-el Thomas Caparas,4,0,36,32
1657962408959,MATH 20B,A02,083757,Briones; Jor-el Thomas Caparas,1,0,36,35
1657962408959,MATH 20B,A03,093475,Briones; Jor-el Thomas Caparas,3,0,36,33
1657962414986,MATH 20C,A01,083760,Briones; Jor-el Thomas Caparas,1,0,35,34
1657962414986,MATH 20C,A02,083761,Briones; Jor-el Thomas Caparas,8,0,35,27
1657962414986,MATH 20C,A03,093476,Briones; Jor-el Thomas Caparas,0,1,36,36
1657962414986,MATH 20C,B01,083762,Bach; Quang Tran,1,0,30,29
1657962421015,MATH 20D,A01,083765,Tran; Brian Kha,5,0,30,25
1657962421015,MATH 20D,A02,083766,Tran; Brian Kha,5,0,30,25
1657962421015,MATH 20D,A03,083767,Tran; Brian Kha,6,0,30,24
1657962427047,MATH 20E,A01,083771,Ganguly; Soumya,12,0,32,20
1657962427047,MATH 20E,A02,083772,Ganguly; Soumya,7,0,32,25
1657962427047,MATH 20E,B01,083773,Ciotti; Benjamin,20,0,35,15
1657962427047,MATH 20E,B02,083774,Ciotti; Benjamin,18,0,35,17
1657962433090,MATH 103A,A01,083777,Greenfeld; Be'Eri,6,0,36,30
1657962433090,MATH 103A,A02,083778,Greenfeld; Be'Eri,5,0,36,31
1657962433090,MATH 103A,A03,093561,Greenfeld; Be'Eri,7,0,36,29
1657962433090,MATH 103A,B01,083779,Greenfeld; Be'Eri,8,0,36,28
1657962433090,MATH 103A,B02,083780,Greenfeld; Be'Eri,4,0,36,32
1657962433090,MATH 103A,B03,093562,Greenfeld; Be'Eri,3,0,36,33
1657962439126,MATH 105,A01,085443,Carter; Anne Toulson,15,0,35,20
1657962439126,MATH 105,A02,093477,Carter; Anne Toulson,20,0,35,15
1657962445152,MATH 109,A01,083213,Ganzberger; Geoffrey Michael,3,0,34,31
1657962445152,MATH 109,A02,083214,Ganzberger; Geoffrey Michael,4,0,34,30
1657962445152,MATH 109,A03,093478,Ganzberger; Geoffrey Michael,2,0,34,32
1657962445152,MATH 109,B01,083215,Ganzberger; Geoffrey Michael,3,0,32,29
1657962445152,MATH 109,B02,083216,Ganzberger; Geoffrey Michael,3,0,32,29
1657962445152,MATH 109,B03,093479,Ganzberger; Geoffrey Michael,8,0,32,24
1657962451182,MATH 142A,A01,083219,Chow; Bennett,7,0,32,25
1657962451182,MATH 142A,A02,083220,Chow; Bennett,10,0,32,22
1657962451182,MATH 142A,A03,093480,Chow; Bennett,9,0,32,23
1657962451182,MATH 142A,B03,093481,Chow; Bennett,8,0,32,24
1657962451182,MATH 142A,B04,093558,Chow; Bennett,14,0,32,18
1657962451182,MATH 142A,B05,093559,Chow; Bennett,7,0,32,25
1657962457211,MATH 193A,A01,083224,Rotar; Vladimir,9,0,34,25
1657962457211,MATH 193A,A02,083225,Rotar; Vladimir,11,0,34,23
1657962457211,MATH 193A,A03,083781,Rotar; Vladimir,5,0,34,29
1657962457211,MATH 193A,A04,083782,Rotar; Vladimir,12,0,34,22
1657962457211,MATH 193A,A05,093482,Rotar; Vladimir,11,0,34,23
1657962463236,MATH 197,001,091859,McAuley; Julian John,9999,0,9999,0
1657962463236,MATH 197,002,095566,Kedlaya; Kiran S.,9997,0,9999,2
1657962463236,MATH 197,003,095567,Xiao; Ming,9999,0,9999,0
1657962463236,MATH 197,004,095571,Perols; Johan Lars,9998,0,9999,1
1657962470302,COGS 9,A01,083615,Shannon; Kyle Michael,11,0,75,64
1657962476331,COGS 11,A01,083617,Boyle; Mary E. T.,23,0,48,25
1657962482359,COGS 13,A01,083071,Bastos; Amalia Pinkusfeld,12,0,71,59
1657962488384,COGS 14A,A01,092681,Semenuks; Arturs,5,1,100,95
1657962494418,COGS 14B,A01,083073,Cheng; Tzu-Han,7,0,63,56
1657962500453,COGS 17,A01,092677,Semenuks; Arturs,7,0,81,74
1657962506508,COGS 100,A01,083619,Allen; Michael Gordon,17,0,70,53
1657962512532,COGS 101A,A01,083621,Davis; Joshua Daniel,9,0,68,59
1657962518576,COGS 101B,A01,091572,Allen; Michael Gordon,14,0,65,51
1657962524601,COGS 101C,A01,083625,Delgado; Tania,17,0,35,18
1657962530632,COGS 107A,A01,083627,Boyle; Mary E. T.,14,0,60,46
1657962536665,COGS 118A,A01,083075,Gupta; Anjum,21,0,76,55
1657962542694,CSE 3,A50,083646,Miranda; Gregory Joseph,24,0,50,26
1657962548723,CSE 8A,A50,083650,Miranda; Gregory Joseph,17,1,56,39
1657962554752,CSE 11,A01,083080,Cao; Yingjun,7,15,40,33
1657962560777,CSE 12,A01,083652,Krause-Levy; Sophia Louisa,30,1,120,90
1657962566803,CSE 15L,A01,083654,Morris; Justin Loren,9,0,50,41
1657962566803,CSE 15L,A02,083655,Morris; Justin Loren,11,0,50,39
1657962572829,CSE 20,A01,083657,Tran; Khoa Dang,39,0,80,41
1657962578869,CSE 21,A01,095574,Bach; Quang Tran,23,0,48,25
1657962584912,CSE 30,A01,083084,Eldon; John,8,0,80,72
1657962584912,CSE 30,B01,095061,Bhaskar; Nishant,9,0,50,41
1657962590944,CSE 100,A01,083659,Cao; Yingjun,5,4,70,65
1657962596983,CSE 134B,A01,083661,Powell; Thomas Allan,25,0,100,75
1657962603005,CSE 140,A01,083663,Gungor; Onat,17,0,85,68
1657962609033,CSE 140L,A01,083088,Eldon; John,23,0,100,77
1657962615058,CSE 175,A01,083665,Kumar; Rakesh,3,0,25,22
1657962621083,CSE 190,A00,092507,Dubnov; Shlomo,8,0,20,12
1657962627108,ECE 45,A01,083139,Congero; Spencer William,7,0,75,68
1657962633140,ECE 65,A50,083695,Saad; Andrew S,12,0,30,18
1657962633140,ECE 65,A51,095125,Saad; Andrew S,24,0,26,2
1657962639182,ECE 109,A01,091882,Touri; Behrouz,21,0,70,49
1657962645206,ECE 180,A00,083140,Abi Samra; Nicholas Camill,1,0,30,29
1657962645206,ECE 180,B00,083141,Abi Samra; Nicholas Camill,0,0,30,30
1657962651257,MATH 10A,A01,083735,Patchell; Gregory David,2,0,30,28
1657962651257,MATH 10A,A02,083736,Patchell; Gregory David,20,0,30,10
1657962651257,MATH 10A,A03,083737,Patchell; Gregory David,16,0,30,14
1657962657288,MATH 10B,A01,083207,Lim; Seonhee,9,0,34,25
1657962657288,MATH 10B,A02,083208,Lim; Seonhee,10,0,35,25
1657962657288,MATH 10B,A03,093472,Lim; Seonhee,7,0,34,27
1657962657288,MATH 10B,B01,083739,Sinha; Shubham,14,0,30,16
1657962663330,MATH 18,A01,083743,Cinel; Cameron Alexander,9,0,30,21
1657962663330,MATH 18,A02,083744,Cinel; Cameron Alexander,18,0,30,12
1657962663330,MATH 18,A03,083745,Cinel; Cameron Alexander,10,0,30,20
1657962663330,MATH 18,B01,083748,Rideout; David Porter,5,0,37,32
1657962663330,MATH 18,B02,083749,Rideout; David Porter,5,0,36,31
1657962663330,MATH 18,B03,083750,Rideout; David Porter,3,0,37,34
1657962663330,MATH 18,B04,083751,Rideout; David Porter,7,0,36,29
1657962663330,MATH 18,B05,093473,Rideout; David Porter,7,0,36,29
1657962663330,MATH 18,B06,093474,Rideout; David Porter,6,0,36,30
1657962669377,MATH 20A,A01,083754,Zheng; Zequn,14,0,40,26
1657962675413,MATH 20B,A01,083756,Briones; Jor-el Thomas Caparas,4,0,36,32
1657962675413,MATH 20B,A02,083757,Briones; Jor-el Thomas Caparas,1,0,36,35
1657962675413,MATH 20B,A03,093475,Briones; Jor-el Thomas Caparas,3,0,36,33
1657962681458,MATH 20C,A01,083760,Briones; Jor-el Thomas Caparas,1,0,35,34
1657962681458,MATH 20C,A02,083761,Briones; Jor-el Thomas Caparas,8,0,35,27
1657962681458,MATH 20C,A03,093476,Briones; Jor-el Thomas Caparas,0,1,36,36
1657962681458,MATH 20C,B01,083762,Bach; Quang Tran,1,0,30,29
1657962687494,MATH 20D,A01,083765,Tran; Brian Kha,5,0,30,25
1657962687494,MATH 20D,A02,083766,Tran; Brian Kha,5,0,30,25
1657962687494,MATH 20D,A03,083767,Tran; Brian Kha,6,0,30,24
1657962693524,MATH 20E,A01,083771,Ganguly; Soumya,12,0,32,20
1657962693524,MATH 20E,A02,083772,Ganguly; Soumya,7,0,32,25
1657962693524,MATH 20E,B01,083773,Ciotti; Benjamin,20,0,35,15
1657962693524,MATH 20E,B02,083774,Ciotti; Benjamin,18,0,35,17
1657962699558,MATH 103A,A01,083777,Greenfeld; Be'Eri,6,0,36,30
1657962699558,MATH 103A,A02,083778,Greenfeld; Be'Eri,5,0,36,31
1657962699558,MATH 103A,A03,093561,Greenfeld; Be'Eri,7,0,36,29
1657962699558,MATH 103A,B01,083779,Greenfeld; Be'Eri,8,0,36,28
1657962699558,MATH 103A,B02,083780,Greenfeld; Be'Eri,4,0,36,32
1657962699558,MATH 103A,B03,093562,Greenfeld; Be'Eri,3,0,36,33
1657962705600,MATH 105,A01,085443,Carter; Anne Toulson,15,0,35,20
1657962705600,MATH 105,A02,093477,Carter; Anne Toulson,20,0,35,15
1657962711636,MATH 109,A01,083213,Ganzberger; Geoffrey Michael,3,0,34,31
1657962711636,MATH 109,A02,083214,Ganzberger; Geoffrey Michael,4,0,34,30
1657962711636,MATH 109,A03,093478,Ganzberger; Geoffrey Michael,2,0,34,32
1657962711636,MATH 109,B01,083215,Ganzberger; Geoffrey Michael,3,0,32,29
1657962711636,MATH 109,B02,083216,Ganzberger; Geoffrey Michael,3,0,32,29
1657962711636,MATH 109,B03,093479,Ganzberger; Geoffrey Michael,8,0,32,24
1657962717662,MATH 142A,A01,083219,Chow; Bennett,7,0,32,25
1657962717662,MATH 142A,A02,083220,Chow; Bennett,10,0,32,22
1657962717662,MATH 142A,A03,093480,Chow; Bennett,9,0,32,23
1657962717662,MATH 142A,B03,093481,Chow; Bennett,8,0,32,24
1657962717662,MATH 142A,B04,093558,Chow; Bennett,14,0,32,18
1657962717662,MATH 142A,B05,093559,Chow; Bennett,7,0,32,25
1657962723763,MATH 193A,A01,083224,Rotar; Vladimir,9,0,34,25
1657962723763,MATH 193A,A02,083225,Rotar; Vladimir,11,0,34,23
1657962723763,MATH 193A,A03,083781,Rotar; Vladimir,5,0,34,29
1657962723763,MATH 193A,A04,083782,Rotar; Vladimir,12,0,34,22
1657962723763,MATH 193A,A05,093482,Rotar; Vladimir,11,0,34,23
1657962729808,MATH 197,001,091859,McAuley; Julian John,9999,0,9999,0
1657962729808,MATH 197,002,095566,Kedlaya; Kiran S.,9997,0,9999,2
1657962729808,MATH 197,003,095567,Xiao; Ming,9999,0,9999,0
1657962729808,MATH 197,004,095571,Perols; Johan Lars,9998,0,9999,1
1657962736931,COGS 9,A01,083615,Shannon; Kyle Michael,11,0,75,64
1657962742981,COGS 11,A01,083617,Boyle; Mary E. T.,23,0,48,25
1657962749005,COGS 13,A01,083071,Bastos; Amalia Pinkusfeld,12,0,71,59
1657962755050,COGS 14A,A01,092681,Semenuks; Arturs,5,1,100,95
1657962761082,COGS 14B,A01,083073,Cheng; Tzu-Han,7,0,63,56
1657962767106,COGS 17,A01,092677,Semenuks; Arturs,7,0,81,74
1657962773129,COGS 100,A01,083619,Allen; Michael Gordon,17,0,70,53
1657962779152,COGS 101A,A01,083621,Davis; Joshua Daniel,9,0,68,59
1657962785198,COGS 101B,A01,091572,Allen; Michael Gordon,14,0,65,51
1657962791235,COGS 101C,A01,083625,Delgado; Tania,17,0,35,18
1657962797256,COGS 107A,A01,083627,Boyle; Mary E. T.,14,0,60,46
1657962803289,COGS 118A,A01,083075,Gupta; Anjum,21,0,76,55
1657962809321,CSE 3,A50,083646,Miranda; Gregory Joseph,24,0,50,26
1657962815350,CSE 8A,A50,083650,Miranda; Gregory Joseph,17,1,56,39
1657962821381,CSE 11,A01,083080,Cao; Yingjun,7,15,40,33
1657962827430,CSE 12,A01,083652,Krause-Levy; Sophia Louisa,30,1,120,90
1657962833452,CSE 15L,A01,083654,Morris; Justin Loren,9,0,50,41
1657962833452,CSE 15L,A02,083655,Morris; Justin Loren,11,0,50,39
1657962839489,CSE 20,A01,083657,Tran; Khoa Dang,39,0,80,41
1657962845511,CSE 21,A01,095574,Bach; Quang Tran,23,0,48,25
1657962851534,CSE 30,A01,083084,Eldon; John,8,0,80,72
1657962851534,CSE 30,B01,095061,Bhaskar; Nishant,9,0,50,41
1657962857578,CSE 100,A01,083659,Cao; Yingjun,5,4,70,65
1657962863634,CSE 134B,A01,083661,Powell; Thomas Allan,25,0,100,75
1657962869663,CSE 140,A01,083663,Gungor; Onat,17,0,85,68
1657962875694,CSE 140L,A01,083088,Eldon; John,23,0,100,77
1657962881734,CSE 175,A01,083665,Kumar; Rakesh,3,0,25,22
1657962887769,CSE 190,A00,092507,Dubnov; Shlomo,8,0,20,12
1657962893797,ECE 45,A01,083139,Congero; Spencer William,7,0,75,68
1657962899837,ECE 65,A50,083695,Saad; Andrew S,12,0,30,18
1657962899837,ECE 65,A51,095125,Saad; Andrew S,24,0,26,2
1657962905859,ECE 109,A01,091882,Touri; Behrouz,21,0,70,49
1657962911913,ECE 180,A00,083140,Abi Samra; Nicholas Camill,1,0,30,29
1657962911913,ECE 180,B00,083141,Abi Samra; Nicholas Camill,0,0,30,30
1657962917957,MATH 10A,A01,083735,Patchell; Gregory David,2,0,30,28
1657962917957,MATH 10A,A02,083736,Patchell; Gregory David,20,0,30,10
1657962917957,MATH 10A,A03,083737,Patchell; Gregory David,16,0,30,14
1657962923999,MATH 10B,A01,083207,Lim; Seonhee,9,0,34,25
1657962923999,MATH 10B,A02,083208,Lim; Seonhee,10,0,35,25
1657962923999,MATH 10B,A03,093472,Lim; Seonhee,7,0,34,27
1657962923999,MATH 10B,B01,083739,Sinha; Shubham,14,0,30,16
1657962930025,MATH 18,A01,083743,Cinel; Cameron Alexander,9,0,30,21
1657962930025,MATH 18,A02,083744,Cinel; Cameron Alexander,18,0,30,12
1657962930025,MATH 18,A03,083745,Cinel; Cameron Alexander,10,0,30,20
1657962930025,MATH 18,B01,083748,Rideout; David Porter,5,0,37,32
1657962930025,MATH 18,B02,083749,Rideout; David Porter,5,0,36,31
1657962930025,MATH 18,B03,083750,Rideout; David Porter,3,0,37,34
1657962930025,MATH 18,B04,083751,Rideout; David Porter,7,0,36,29
1657962930025,MATH 18,B05,093473,Rideout; David Porter,7,0,36,29
1657962930025,MATH 18,B06,093474,Rideout; David Porter,6,0,36,30
1657962936048,MATH 20A,A01,083754,Zheng; Zequn,14,0,40,26
1657962942070,MATH 20B,A01,083756,Briones; Jor-el Thomas Caparas,4,0,36,32
1657962942070,MATH 20B,A02,083757,Briones; Jor-el Thomas Caparas,1,0,36,35
1657962942070,MATH 20B,A03,093475,Briones; Jor-el Thomas Caparas,3,0,36,33
1657962948113,MATH 20C,A01,083760,Briones; Jor-el Thomas Caparas,1,0,35,34
1657962948113,MATH 20C,A02,083761,Briones; Jor-el Thomas Caparas,8,0,35,27
1657962948113,MATH 20C,A03,093476,Briones; Jor-el Thomas Caparas,0,1,36,36
1657962948113,MATH 20C,B01,083762,Bach; Quang Tran,1,0,30,29
1657962954138,MATH 20D,A01,083765,Tran; Brian Kha,5,0,30,25
1657962954138,MATH 20D,A02,083766,Tran; Brian Kha,5,0,30,25
1657962954138,MATH 20D,A03,083767,Tran; Brian Kha,6,0,30,24
1657962960166,MATH 20E,A01,083771,Ganguly; Soumya,12,0,32,20
1657962960166,MATH 20E,A02,083772,Ganguly; Soumya,7,0,32,25
1657962960166,MATH 20E,B01,083773,Ciotti; Benjamin,20,0,35,15
1657962960166,MATH 20E,B02,083774,Ciotti; Benjamin,18,0,35,17
1657962966190,MATH 103A,A01,083777,Greenfeld; Be'Eri,6,0,36,30
1657962966190,MATH 103A,A02,083778,Greenfeld; Be'Eri,5,0,36,31
1657962966190,MATH 103A,A03,093561,Greenfeld; Be'Eri,7,0,36,29
1657962966190,MATH 103A,B01,083779,Greenfeld; Be'Eri,8,0,36,28
1657962966190,MATH 103A,B02,083780,Greenfeld; Be'Eri,4,0,36,32
1657962966190,MATH 103A,B03,093562,Greenfeld; Be'Eri,3,0,36,33
1657962972221,MATH 105,A01,085443,Carter; Anne Toulson,15,0,35,20
1657962972221,MATH 105,A02,093477,Carter; Anne Toulson,20,0,35,15
1657962978276,MATH 109,A01,083213,Ganzberger; Geoffrey Michael,3,0,34,31
1657962978276,MATH 109,A02,083214,Ganzberger; Geoffrey Michael,4,0,34,30
1657962978276,MATH 109,A03,093478,Ganzberger; Geoffrey Michael,2,0,34,32
1657962978276,MATH 109,B01,083215,Ganzberger; Geoffrey Michael,3,0,32,29
1657962978276,MATH 109,B02,083216,Ganzberger; Geoffrey Michael,3,0,32,29
1657962978276,MATH 109,B03,093479,Ganzberger; Geoffrey Michael,8,0,32,24
1657962984298,MATH 142A,A01,083219,Chow; Bennett,7,0,32,25
1657962984298,MATH 142A,A02,083220,Chow; Bennett,10,0,32,22
1657962984298,MATH 142A,A03,093480,Chow; Bennett,9,0,32,23
1657962984298,MATH 142A,B03,093481,Chow; Bennett,8,0,32,24
1657962984298,MATH 142A,B04,093558,Chow; Bennett,14,0,32,18
1657962984298,MATH 142A,B05,093559,Chow; Bennett,7,0,32,25
1657962990350,MATH 193A,A01,083224,Rotar; Vladimir,9,0,34,25
1657962990350,MATH 193A,A02,083225,Rotar; Vladimir,11,0,34,23
1657962990350,MATH 193A,A03,083781,Rotar; Vladimir,5,0,34,29
1657962990350,MATH 193A,A04,083782,Rotar; Vladimir,12,0,34,22
1657962990350,MATH 193A,A05,093482,Rotar; Vladimir,11,0,34,23
1657962996372,MATH 197,001,091859,McAuley; Julian John,9999,0,9999,0
1657962996372,MATH 197,002,095566,Kedlaya; Kiran S.,9997,0,9999,2
1657962996372,MATH 197,003,095567,Xiao; Ming,9999,0,9999,0
1657962996372,MATH 197,004,095571,Perols; Johan Lars,9998,0,9999,1
1657963003422,COGS 9,A01,083615,Shannon; Kyle Michael,11,0,75,64
1657963009463,COGS 11,A01,083617,Boyle; Mary E. T.,23,0,48,25
1657963015497,COGS 13,A01,083071,Bastos; Amalia Pinkusfeld,12,0,71,59
1657963021547,COGS 14A,A01,092681,Semenuks; Arturs,5,1,100,95
1657963027571,COGS 14B,A01,083073,Cheng; Tzu-Han,7,0,63,56
1657963033605,COGS 17,A01,092677,Semenuks; Arturs,7,0,81,74
1657963039630,COGS 100,A01,083619,Allen; Michael Gordon,17,0,70,53
1657963045663,COGS 101A,A01,083621,Davis; Joshua Daniel,9,0,68,59
1657963051708,COGS 101B,A01,091572,Allen; Michael Gordon,14,0,65,51
1657963057733,COGS 101C,A01,083625,Delgado; Tania,17,0,35,18
1657963063754,COGS 107A,A01,083627,Boyle; Mary E. T.,14,0,60,46
1657963069786,COGS 118A,A01,083075,Gupta; Anjum,21,0,76,55
1657963075814,CSE 3,A50,083646,Miranda; Gregory Joseph,24,0,50,26
1657963081837,CSE 8A,A50,083650,Miranda; Gregory Joseph,17,1,56,39
1657963087864,CSE 11,A01,083080,Cao; Yingjun,7,15,40,33
1657963093912,CSE 12,A01,083652,Krause-Levy; Sophia Louisa,30,1,120,90
1657963099941,CSE 15L,A01,083654,Morris; Justin Loren,9,0,50,41
1657963099941,CSE 15L,A02,083655,Morris; Justin Loren,11,0,50,39
1657963105967,CSE 20,A01,083657,Tran; Khoa Dang,39,0,80,41
1657963111994,CSE 21,A01,095574,Bach; Quang Tran,23,0,48,25
1657963118018,CSE 30,A01,083084,Eldon; John,8,0,80,72
1657963118018,CSE 30,B01,095061,Bhaskar; Nishant,9,0,50,41
1657963124053,CSE 100,A01,083659,Cao; Yingjun,5,4,70,65
1657963130085,CSE 134B,A01,083661,Powell; Thomas Allan,25,0,100,75
1657963136109,CSE 140,A01,083663,Gungor; Onat,17,0,85,68
1657963142133,CSE 140L,A01,083088,Eldon; John,23,0,100,77
1657963148159,CSE 175,A01,083665,Kumar; Rakesh,3,0,25,22
1657963154194,CSE 190,A00,092507,Dubnov; Shlomo,8,0,20,12
1657963160238,ECE 45,A01,083139,Congero; Spencer William,7,0,75,68
1657963166272,ECE 65,A50,083695,Saad; Andrew S,12,0,30,18
1657963166272,ECE 65,A51,095125,Saad; Andrew S,24,0,26,2
1657963172311,ECE 109,A01,091882,Touri; Behrouz,21,0,70,49
1657963178336,ECE 180,A00,083140,Abi Samra; Nicholas Camill,1,0,30,29
1657963178336,ECE 180,B00,083141,Abi Samra; Nicholas Camill,0,0,30,30
1657963184359,MATH 10A,A01,083735,Patchell; Gregory David,2,0,30,28
1657963184359,MATH 10A,A02,083736,Patchell; Gregory David,20,0,30,10
1657963184359,MATH 10A,A03,083737,Patchell; Gregory David,16,0,30,14
1657963190392,MATH 10B,A01,083207,Lim; Seonhee,9,0,34,25
1657963190392,MATH 10B,A02,083208,Lim; Seonhee,10,0,35,25
1657963190392,MATH 10B,A03,093472,Lim; Seonhee,7,0,34,27
1657963190392,MATH 10B,B01,083739,Sinha; Shubham,14,0,30,16
1657963196417,MATH 18,A01,083743,Cinel; Cameron Alexander,9,0,30,21
1657963196417,MATH 18,A02,083744,Cinel; Cameron Alexander,18,0,30,12
1657963196417,MATH 18,A03,083745,Cinel; Cameron Alexander,10,0,30,20
1657963196417,MATH 18,B01,083748,Rideout; David Porter,5,0,37,32
1657963196417,MATH 18,B02,083749,Rideout; David Porter,5,0,36,31
1657963196417,MATH 18,B03,083750,Rideout; David Porter,3,0,37,34
1657963196417,MATH 18,B04,083751,Rideout; David Porter,7,0,36,29
1657963196417,MATH 18,B05,093473,Rideout; David Porter,7,0,36,29
1657963196417,MATH 18,B06,093474,Rideout; David Porter,6,0,36,30
1657963202441,MATH 20A,A01,083754,Zheng; Zequn,14,0,40,26
1657963208473,MATH 20B,A01,083756,Briones; Jor-el Thomas Caparas,4,0,36,32
1657963208473,MATH 20B,A02,083757,Briones; Jor-el Thomas Caparas,1,0,36,35
1657963208473,MATH 20B,A03,093475,Briones; Jor-el Thomas Caparas,3,0,36,33
1657963214522,MATH 20C,A01,083760,Briones; Jor-el Thomas Caparas,1,0,35,34
1657963214522,MATH 20C,A02,083761,Briones; Jor-el Thomas Caparas,8,0,35,27
1657963214522,MATH 20C,A03,093476,Briones; Jor-el Thomas Caparas,0,1,36,36
1657963214522,MATH 20C,B01,083762,Bach; Quang Tran,1,0,30,29
1657963220557,MATH 20D,A01,083765,Tran; Brian Kha,5,0,30,25
1657963220557,MATH 20D,A02,083766,Tran; Brian Kha,5,0,30,25
1657963220557,MATH 20D,A03,083767,Tran; Brian Kha,6,0,30,24
1657963226585,MATH 20E,A01,083771,Ganguly; Soumya,12,0,32,20
1657963226585,MATH 20E,A02,083772,Ganguly; Soumya,7,0,32,25
1657963226585,MATH 20E,B01,083773,Ciotti; Benjamin,20,0,35,15
1657963226585,MATH 20E,B02,083774,Ciotti; Benjamin,18,0,35,17
1657963232615,MATH 103A,A01,083777,Greenfeld; Be'Eri,6,0,36,30
1657963232615,MATH 103A,A02,083778,Greenfeld; Be'Eri,5,0,36,31
1657963232615,MATH 103A,A03,093561,Greenfeld; Be'Eri,7,0,36,29
1657963232615,MATH 103A,B01,083779,Greenfeld; Be'Eri,8,0,36,28
1657963232615,MATH 103A,B02,083780,Greenfeld; Be'Eri,4,0,36,32
1657963232615,MATH 103A,B03,093562,Greenfeld; Be'Eri,3,0,36,33
1657963238654,MATH 105,A01,085443,Carter; Anne Toulson,15,0,35,20
1657963238654,MATH 105,A02,093477,Carter; Anne Toulson,20,0,35,15
1657963244678,MATH 109,A01,083213,Ganzberger; Geoffrey Michael,3,0,34,31
1657963244678,MATH 109,A02,083214,Ganzberger; Geoffrey Michael,4,0,34,30
1657963244678,MATH 109,A03,093478,Ganzberger; Geoffrey Michael,2,0,34,32
1657963244678,MATH 109,B01,083215,Ganzberger; Geoffrey Michael,3,0,32,29
1657963244678,MATH 109,B02,083216,Ganzberger; Geoffrey Michael,3,0,32,29
1657963244678,MATH 109,B03,093479,Ganzberger; Geoffrey Michael,8,0,32,24
1657963250708,MATH 142A,A01,083219,Chow; Bennett,7,0,32,25
1657963250708,MATH 142A,A02,083220,Chow; Bennett,10,0,32,22
1657963250708,MATH 142A,A03,093480,Chow; Bennett,9,0,32,23
1657963250708,MATH 142A,B03,093481,Chow; Bennett,8,0,32,24
1657963250708,MATH 142A,B04,093558,Chow; Bennett,14,0,32,18
1657963250708,MATH 142A,B05,093559,Chow; Bennett,7,0,32,25
1657963256747,MATH 193A,A01,083224,Rotar; Vladimir,9,0,34,25
1657963256747,MATH 193A,A02,083225,Rotar; Vladimir,11,0,34,23
1657963256747,MATH 193A,A03,083781,Rotar; Vladimir,5,0,34,29
1657963256747,MATH 193A,A04,083782,Rotar; Vladimir,12,0,34,22
1657963256747,MATH 193A,A05,093482,Rotar; Vladimir,11,0,34,23
1657963262777,MATH 197,001,091859,McAuley; Julian John,9999,0,9999,0
1657963262777,MATH 197,002,095566,Kedlaya; Kiran S.,9997,0,9999,2
1657963262777,MATH 197,003,095567,Xiao; Ming,9999,0,9999,0
1657963262777,MATH 197,004,095571,Perols; Johan Lars,9998,0,9999,1
1657963269881,COGS 9,A01,083615,Shannon; Kyle Michael,11,0,75,64
1657963275904,COGS 11,A01,083617,Boyle; Mary E. T.,23,0,48,25
1657963281931,COGS 13,A01,083071,Bastos; Amalia Pinkusfeld,12,0,71,59
1657963287966,COGS 14A,A01,092681,Semenuks; Arturs,5,1,100,95
1657963294002,COGS 14B,A01,083073,Cheng; Tzu-Han,7,0,63,56
1657963300040,COGS 17,A01,092677,Semenuks; Arturs,7,0,81,74
1657963306062,COGS 100,A01,083619,Allen; Michael Gordon,17,0,70,53
1657963312097,COGS 101A,A01,083621,Davis; Joshua Daniel,9,0,68,59
1657963318202,COGS 101B,A01,091572,Allen; Michael Gordon,14,0,65,51
1657963324228,COGS 101C,A01,083625,Delgado; Tania,17,0,35,18
1657963330265,COGS 107A,A01,083627,Boyle; Mary E. T.,14,0,60,46
1657963336312,COGS 118A,A01,083075,Gupta; Anjum,21,0,76,55
1657963342361,CSE 3,A50,083646,Miranda; Gregory Joseph,24,0,50,26
1657963348395,CSE 8A,A50,083650,Miranda; Gregory Joseph,17,1,56,39
1657963354421,CSE 11,A01,083080,Cao; Yingjun,7,15,40,33
1657963360445,CSE 12,A01,083652,Krause-Levy; Sophia Louisa,30,1,120,90
1657963366467,CSE 15L,A01,083654,Morris; Justin Loren,9,0,50,41
1657963366467,CSE 15L,A02,083655,Morris; Justin Loren,11,0,50,39
1657963372497,CSE 20,A01,083657,Tran; Khoa Dang,39,0,80,41
1657963378550,CSE 21,A01,095574,Bach; Quang Tran,23,0,48,25
1657963384581,CSE 30,A01,083084,Eldon; John,8,0,80,72
1657963384581,CSE 30,B01,095061,Bhaskar; Nishant,9,0,50,41
1657963390614,CSE 100,A01,083659,Cao; Yingjun,5,4,70,65
1657963396656,CSE 134B,A01,083661,Powell; Thomas Allan,25,0,100,75
1657963402680,CSE 140,A01,083663,Gungor; Onat,17,0,85,68
1657963408733,CSE 140L,A01,083088,Eldon; John,23,0,100,77
1657963414756,CSE 175,A01,083665,Kumar; Rakesh,3,0,25,22
1657963420778,CSE 190,A00,092507,Dubnov; Shlomo,8,0,20,12
1657963426834,ECE 45,A01,083139,Congero; Spencer William,7,0,75,68
1657963432875,ECE 65,A50,083695,Saad; Andrew S,12,0,30,18
1657963432875,ECE 65,A51,095125,Saad; Andrew S,24,0,26,2
1657963438917,ECE 109,A01,091882,Touri; Behrouz,21,0,70,49
1657963444941,ECE 180,A00,083140,Abi Samra; Nicholas Camill,1,0,30,29
1657963444941,ECE 180,B00,083141,Abi Samra; Nicholas Camill,0,0,30,30
1657963450992,MATH 10A,A01,083735,Patchell; Gregory David,2,0,30,28
1657963450992,MATH 10A,A02,083736,Patchell; Gregory David,20,0,30,10
1657963450992,MATH 10A,A03,083737,Patchell; Gregory David,16,0,30,14
1657963457030,MATH 10B,A01,083207,Lim; Seonhee,9,0,34,25
1657963457030,MATH 10B,A02,083208,Lim; Seonhee,10,0,35,25
1657963457030,MATH 10B,A03,093472,Lim; Seonhee,7,0,34,27
1657963457030,MATH 10B,B01,083739,Sinha; Shubham,14,0,30,16
1657963463053,MATH 18,A01,083743,Cinel; Cameron Alexander,9,0,30,21
1657963463053,MATH 18,A02,083744,Cinel; Cameron Alexander,18,0,30,12
1657963463053,MATH 18,A03,083745,Cinel; Cameron Alexander,10,0,30,20
1657963463053,MATH 18,B01,083748,Rideout; David Porter,5,0,37,32
1657963463053,MATH 18,B02,083749,Rideout; David Porter,5,0,36,31
1657963463053,MATH 18,B03,083750,Rideout; David Porter,3,0,37,34
1657963463053,MATH 18,B04,083751,Rideout; David Porter,7,0,36,29
1657963463053,MATH 18,B05,093473,Rideout; David Porter,7,0,36,29
1657963463053,MATH 18,B06,093474,Rideout; David Porter,6,0,36,30
1657963469081,MATH 20A,A01,083754,Zheng; Zequn,14,0,40,26
1657963475105,MATH 20B,A01,083756,Briones; Jor-el Thomas Caparas,4,0,36,32
1657963475105,MATH 20B,A02,083757,Briones; Jor-el Thomas Caparas,1,0,36,35
1657963475105,MATH 20B,A03,093475,Briones; Jor-el Thomas Caparas,3,0,36,33
1657963481129,MATH 20C,A01,083760,Briones; Jor-el Thomas Caparas,1,0,35,34
1657963481129,MATH 20C,A02,083761,Briones; Jor-el Thomas Caparas,8,0,35,27
1657963481129,MATH 20C,A03,093476,Briones; Jor-el Thomas Caparas,0,1,36,36
1657963481129,MATH 20C,B01,083762,Bach; Quang Tran,1,0,30,29
1657963487165,MATH 20D,A01,083765,Tran; Brian Kha,5,0,30,25
1657963487165,MATH 20D,A02,083766,Tran; Brian Kha,5,0,30,25
1657963487165,MATH 20D,A03,083767,Tran; Brian Kha,6,0,30,24
1657963493201,MATH 20E,A01,083771,Ganguly; Soumya,12,0,32,20
1657963493201,MATH 20E,A02,083772,Ganguly; Soumya,7,0,32,25
1657963493201,MATH 20E,B01,083773,Ciotti; Benjamin,20,0,35,15
1657963493201,MATH 20E,B02,083774,Ciotti; Benjamin,18,0,35,17
1657963499230,MATH 103A,A01,083777,Greenfeld; Be'Eri,6,0,36,30
1657963499230,MATH 103A,A02,083778,Greenfeld; Be'Eri,5,0,36,31
1657963499230,MATH 103A,A03,093561,Greenfeld; Be'Eri,7,0,36,29
1657963499230,MATH 103A,B01,083779,Greenfeld; Be'Eri,8,0,36,28
1657963499230,MATH 103A,B02,083780,Greenfeld; Be'Eri,4,0,36,32
1657963499230,MATH 103A,B03,093562,Greenfeld; Be'Eri,3,0,36,33
1657963505287,MATH 105,A01,085443,Carter; Anne Toulson,15,0,35,20
1657963505287,MATH 105,A02,093477,Carter; Anne Toulson,20,0,35,15
1657963511324,MATH 109,A01,083213,Ganzberger; Geoffrey Michael,3,0,34,31
1657963511324,MATH 109,A02,083214,Ganzberger; Geoffrey Michael,4,0,34,30
1657963511324,MATH 109,A03,093478,Ganzberger; Geoffrey Michael,2,0,34,32
1657963511324,MATH 109,B01,083215,Ganzberger; Geoffrey Michael,3,0,32,29
1657963511324,MATH 109,B02,083216,Ganzberger; Geoffrey Michael,3,0,32,29
1657963511324,MATH 109,B03,093479,Ganzberger; Geoffrey Michael,8,0,32,24
1657963517348,MATH 142A,A01,083219,Chow; Bennett,7,0,32,25
1657963517348,MATH 142A,A02,083220,Chow; Bennett,10,0,32,22
1657963517348,MATH 142A,A03,093480,Chow; Bennett,9,0,32,23
1657963517348,MATH 142A,B03,093481,Chow; Bennett,8,0,32,24
1657963517348,MATH 142A,B04,093558,Chow; Bennett,14,0,32,18
1657963517348,MATH 142A,B05,093559,Chow; Bennett,7,0,32,25
1657963523371,MATH 193A,A01,083224,Rotar; Vladimir,9,0,34,25
1657963523371,MATH 193A,A02,083225,Rotar; Vladimir,11,0,34,23
1657963523371,MATH 193A,A03,083781,Rotar; Vladimir,5,0,34,29
1657963523371,MATH 193A,A04,083782,Rotar; Vladimir,12,0,34,22
1657963523371,MATH 193A,A05,093482,Rotar; Vladimir,11,0,34,23
1657963529417,MATH 197,001,091859,McAuley; Julian John,9999,0,9999,0
1657963529417,MATH 197,002,095566,Kedlaya; Kiran S.,9997,0,9999,2
1657963529417,MATH 197,003,095567,Xiao; Ming,9999,0,9999,0
1657963529417,MATH 197,004,095571,Perols; Johan Lars,9998,0,9999,1
1657963536492,COGS 9,A01,083615,Shannon; Kyle Michael,11,0,75,64
1657963542515,COGS 11,A01,083617,Boyle; Mary E. T.,23,0,48,25
1657963548539,COGS 13,A01,083071,Bastos; Amalia Pinkusfeld,12,0,71,59
1657963554570,COGS 14A,A01,092681,Semenuks; Arturs,5,1,100,95
1657963560597,COGS 14B,A01,083073,Cheng; Tzu-Han,7,0,63,56
1657963566622,COGS 17,A01,092677,Semenuks; Arturs,7,0,81,74
1657963572645,COGS 100,A01,083619,Allen; Michael Gordon,17,0,70,53
1657963578696,COGS 101A,A01,083621,Davis; Joshua Daniel,9,0,68,59
1657963584749,COGS 101B,A01,091572,Allen; Michael Gordon,14,0,65,51
1657963590793,COGS 101C,A01,083625,Delgado; Tania,17,0,35,18
1657963596825,COGS 107A,A01,083627,Boyle; Mary E. T.,14,0,60,46
1657963602857,COGS 118A,A01,083075,Gupta; Anjum,21,0,76,55
1657963608884,CSE 3,A50,083646,Miranda; Gregory Joseph,24,0,50,26
1657963614908,CSE 8A,A50,083650,Miranda; Gregory Joseph,17,1,56,39
1657963620930,CSE 11,A01,083080,Cao; Yingjun,7,15,40,33
1657963626953,CSE 12,A01,083652,Krause-Levy; Sophia Louisa,30,1,120,90
1657963632988,CSE 15L,A01,083654,Morris; Justin Loren,9,0,50,41
1657963632988,CSE 15L,A02,083655,Morris; Justin Loren,11,0,50,39
1657963639016,CSE 20,A01,083657,Tran; Khoa Dang,39,0,80,41
1657963645043,CSE 21,A01,095574,Bach; Quang Tran,23,0,48,25
1657963651071,CSE 30,A01,083084,Eldon; John,8,0,80,72
1657963651071,CSE 30,B01,095061,Bhaskar; Nishant,9,0,50,41
1657963657093,CSE 100,A01,083659,Cao; Yingjun,5,4,70,65
1657963663121,CSE 134B,A01,083661,Powell; Thomas Allan,25,0,100,75
1657963669170,CSE 140,A01,083663,Gungor; Onat,17,0,85,68
1657963675220,CSE 140L,A01,083088,Eldon; John,23,0,100,77
1657963681245,CSE 175,A01,083665,Kumar; Rakesh,3,0,25,22
1657963687269,CSE 190,A00,092507,Dubnov; Shlomo,8,0,20,12
1657963693300,ECE 45,A01,083139,Congero; Spencer William,7,0,75,68
1657963699326,ECE 65,A50,083695,Saad; Andrew S,12,0,30,18
1657963699326,ECE 65,A51,095125,Saad; Andrew S,24,0,26,2
1657963705351,ECE 109,A01,091882,Touri; Behrouz,21,0,70,49
1657963711375,ECE 180,A00,083140,Abi Samra; Nicholas Camill,1,0,30,29
1657963711375,ECE 180,B00,083141,Abi Samra; Nicholas Camill,0,0,30,30
1657963717424,MATH 10A,A01,083735,Patchell; Gregory David,2,0,30,28
1657963717424,MATH 10A,A02,083736,Patchell; Gregory David,20,0,30,10
1657963717424,MATH 10A,A03,083737,Patchell; Gregory David,16,0,30,14
1657963723468,MATH 10B,A01,083207,Lim; Seonhee,9,0,34,25
1657963723468,MATH 10B,A02,083208,Lim; Seonhee,10,0,35,25
1657963723468,MATH 10B,A03,093472,Lim; Seonhee,7,0,34,27
1657963723468,MATH 10B,B01,083739,Sinha; Shubham,14,0,30,16
1657963729492,MATH 18,A01,083743,Cinel; Cameron Alexander,9,0,30,21
1657963729492,MATH 18,A02,083744,Cinel; Cameron Alexander,18,0,30,12
1657963729492,MATH 18,A03,083745,Cinel; Cameron Alexander,10,0,30,20
1657963729492,MATH 18,B01,083748,Rideout; David Porter,5,0,37,32
1657963729492,MATH 18,B02,083749,Rideout; David Porter,5,0,36,31
1657963729492,MATH 18,B03,083750,Rideout; David Porter,3,0,37,34
1657963729492,MATH 18,B04,083751,Rideout; David Porter,7,0,36,29
1657963729492,MATH 18,B05,093473,Rideout; David Porter,7,0,36,29
1657963729492,MATH 18,B06,093474,Rideout; David Porter,6,0,36,30
1657963735541,MATH 20A,A01,083754,Zheng; Zequn,14,0,40,26
1657963741568,MATH 20B,A01,083756,Briones; Jor-el Thomas Caparas,4,0,36,32
1657963741568,MATH 20B,A02,083757,Briones; Jor-el Thomas Caparas,1,0,36,35
1657963741568,MATH 20B,A03,093475,Briones; Jor-el Thomas Caparas,3,0,36,33
1657963747600,MATH 20C,A01,083760,Briones; Jor-el Thomas Caparas,1,0,35,34
1657963747600,MATH 20C,A02,083761,Briones; Jor-el Thomas Caparas,8,0,35,27
1657963747600,MATH 20C,A03,093476,Briones; Jor-el Thomas Caparas,0,1,36,36
1657963747600,MATH 20C,B01,083762,Bach; Quang Tran,1,0,30,29
1657963753634,MATH 20D,A01,083765,Tran; Brian Kha,5,0,30,25
1657963753634,MATH 20D,A02,083766,Tran; Brian Kha,5,0,30,25
1657963753634,MATH 20D,A03,083767,Tran; Brian Kha,6,0,30,24
1657963759658,MATH 20E,A01,083771,Ganguly; Soumya,12,0,32,20
1657963759658,MATH 20E,A02,083772,Ganguly; Soumya,7,0,32,25
1657963759658,MATH 20E,B01,083773,Ciotti; Benjamin,20,0,35,15
1657963759658,MATH 20E,B02,083774,Ciotti; Benjamin,18,0,35,17
1657963765682,MATH 103A,A01,083777,Greenfeld; Be'Eri,6,0,36,30
1657963765682,MATH 103A,A02,083778,Greenfeld; Be'Eri,5,0,36,31
1657963765682,MATH 103A,A03,093561,Greenfeld; Be'Eri,7,0,36,29
1657963765682,MATH 103A,B01,083779,Greenfeld; Be'Eri,8,0,36,28
1657963765682,MATH 103A,B02,083780,Greenfeld; Be'Eri,4,0,36,32
1657963765682,MATH 103A,B03,093562,Greenfeld; Be'Eri,3,0,36,33
1657963771713,MATH 105,A01,085443,Carter; Anne Toulson,15,0,35,20
1657963771713,MATH 105,A02,093477,Carter; Anne Toulson,20,0,35,15
1657963777736,MATH 109,A01,083213,Ganzberger; Geoffrey Michael,3,0,34,31
1657963777736,MATH 109,A02,083214,Ganzberger; Geoffrey Michael,4,0,34,30
1657963777736,MATH 109,A03,093478,Ganzberger; Geoffrey Michael,2,0,34,32
1657963777736,MATH 109,B01,083215,Ganzberger; Geoffrey Michael,3,0,32,29
1657963777736,MATH 109,B02,083216,Ganzberger; Geoffrey Michael,3,0,32,29
1657963777736,MATH 109,B03,093479,Ganzberger; Geoffrey Michael,8,0,32,24
1657963783776,MATH 142A,A01,083219,Chow; Bennett,7,0,32,25
1657963783776,MATH 142A,A02,083220,Chow; Bennett,10,0,32,22
1657963783776,MATH 142A,A03,093480,Chow; Bennett,9,0,32,23
1657963783776,MATH 142A,B03,093481,Chow; Bennett,8,0,32,24
1657963783776,MATH 142A,B04,093558,Chow; Bennett,14,0,32,18
1657963783776,MATH 142A,B05,093559,Chow; Bennett,7,0,32,25
1657963789798,MATH 193A,A01,083224,Rotar; Vladimir,9,0,34,25
1657963789798,MATH 193A,A02,083225,Rotar; Vladimir,11,0,34,23
1657963789798,MATH 193A,A03,083781,Rotar; Vladimir,5,0,34,29
1657963789798,MATH 193A,A04,083782,Rotar; Vladimir,12,0,34,22
1657963789798,MATH 193A,A05,093482,Rotar; Vladimir,11,0,34,23
1657963795836,MATH 197,001,091859,McAuley; Julian John,9999,0,9999,0
1657963795836,MATH 197,002,095566,Kedlaya; Kiran S.,9997,0,9999,2
1657963795836,MATH 197,003,095567,Xiao; Ming,9999,0,9999,0
1657963795836,MATH 197,004,095571,Perols; Johan Lars,9998,0,9999,1
1657963802907,COGS 9,A01,083615,Shannon; Kyle Michael,11,0,75,64
1657963808956,COGS 11,A01,083617,Boyle; Mary E. T.,23,0,48,25
1657963815013,COGS 13,A01,083071,Bastos; Amalia Pinkusfeld,12,0,71,59
1657963821038,COGS 14A,A01,092681,Semenuks; Arturs,5,1,100,95
1657963827062,COGS 14B,A01,083073,Cheng; Tzu-Han,7,0,63,56
1657963833085,COGS 17,A01,092677,Semenuks; Arturs,7,0,81,74
1657963839117,COGS 100,A01,083619,Allen; Michael Gordon,17,0,70,53
1657963845141,COGS 101A,A01,083621,Davis; Joshua Daniel,9,0,68,59
1657963851177,COGS 101B,A01,091572,Allen; Michael Gordon,14,0,65,51
1657963857205,COGS 101C,A01,083625,Delgado; Tania,17,0,35,18
1657963863228,COGS 107A,A01,083627,Boyle; Mary E. T.,14,0,60,46
1657963869284,COGS 118A,A01,083075,Gupta; Anjum,21,0,76,55
1657963875316,CSE 3,A50,083646,Miranda; Gregory Joseph,24,0,50,26
1657963881340,CSE 8A,A50,083650,Miranda; Gregory Joseph,17,1,56,39
1657963887391,CSE 11,A01,083080,Cao; Yingjun,7,15,40,33
1657963893424,CSE 12,A01,083652,Krause-Levy; Sophia Louisa,30,1,120,90
1657963899448,CSE 15L,A01,083654,Morris; Justin Loren,9,0,50,41
1657963899448,CSE 15L,A02,083655,Morris; Justin Loren,11,0,50,39
1657963905489,CSE 20,A01,083657,Tran; Khoa Dang,39,0,80,41
1657963911521,CSE 21,A01,095574,Bach; Quang Tran,23,0,48,25
1657963917644,CSE 30,A01,083084,Eldon; John,8,0,80,72
1657963917644,CSE 30,B01,095061,Bhaskar; Nishant,9,0,50,41
1657963923681,CSE 100,A01,083659,Cao; Yingjun,5,4,70,65
1657963929703,CSE 134B,A01,083661,Powell; Thomas Allan,25,0,100,75
1657963935741,CSE 140,A01,083663,Gungor; Onat,17,0,85,68
1657963941773,CSE 140L,A01,083088,Eldon; John,23,0,100,77
1657963947794,CSE 175,A01,083665,Kumar; Rakesh,3,0,25,22
1657963953840,CSE 190,A00,092507,Dubnov; Shlomo,8,0,20,12
1657963959869,ECE 45,A01,083139,Congero; Spencer William,7,0,75,68
1657963965900,ECE 65,A50,083695,Saad; Andrew S,12,0,30,18
1657963965900,ECE 65,A51,095125,Saad; Andrew S,24,0,26,2
1657963971945,ECE 109,A01,091882,Touri; Behrouz,21,0,70,49
1657963977991,ECE 180,A00,083140,Abi Samra; Nicholas Camill,1,0,30,29
1657963977991,ECE 180,B00,083141,Abi Samra; Nicholas Camill,0,0,30,30
1657963984016,MATH 10A,A01,083735,Patchell; Gregory David,2,0,30,28
1657963984016,MATH 10A,A02,083736,Patchell; Gregory David,20,0,30,10
1657963984016,MATH 10A,A03,083737,Patchell; Gregory David,16,0,30,14
1657963990042,MATH 10B,A01,083207,Lim; Seonhee,9,0,34,25
1657963990042,MATH 10B,A02,083208,Lim; Seonhee,10,0,35,25
1657963990042,MATH 10B,A03,093472,Lim; Seonhee,7,0,34,27
1657963990042,MATH 10B,B01,083739,Sinha; Shubham,14,0,30,16
1657963996067,MATH 18,A01,083743,Cinel; Cameron Alexander,9,0,30,21
1657963996067,MATH 18,A02,083744,Cinel; Cameron Alexander,18,0,30,12
1657963996067,MATH 18,A03,083745,Cinel; Cameron Alexander,10,0,30,20
1657963996067,MATH 18,B01,083748,Rideout; David Porter,5,0,37,32
1657963996067,MATH 18,B02,083749,Rideout; David Porter,5,0,36,31
1657963996067,MATH 18,B03,083750,Rideout; David Porter,3,0,37,34
1657963996067,MATH 18,B04,083751,Rideout; David Porter,7,0,36,29
1657963996067,MATH 18,B05,093473,Rideout; David Porter,7,0,36,29
1657963996067,MATH 18,B06,093474,Rideout; David Porter,6,0,36,30
1657964002090,MATH 20A,A01,083754,Zheng; Zequn,14,0,40,26
1657964008114,MATH 20B,A01,083756,Briones; Jor-el Thomas Caparas,4,0,36,32
1657964008114,MATH 20B,A02,083757,Briones; Jor-el Thomas Caparas,1,0,36,35
1657964008114,MATH 20B,A03,093475,Briones; Jor-el Thomas Caparas,3,0,36,33
1657964014168,MATH 20C,A01,083760,Briones; Jor-el Thomas Caparas,1,0,35,34
1657964014168,MATH 20C,A02,083761,Briones; Jor-el Thomas Caparas,8,0,35,27
1657964014168,MATH 20C,A03,093476,Briones; Jor-el Thomas Caparas,0,1,36,36
1657964014168,MATH 20C,B01,083762,Bach; Quang Tran,1,0,30,29
1657964020198,MATH 20D,A01,083765,Tran; Brian Kha,5,0,30,25
1657964020198,MATH 20D,A02,083766,Tran; Brian Kha,5,0,30,25
1657964020198,MATH 20D,A03,083767,Tran; Brian Kha,6,0,30,24
1657964026230,MATH 20E,A01,083771,Ganguly; Soumya,12,0,32,20
1657964026230,MATH 20E,A02,083772,Ganguly; Soumya,7,0,32,25
1657964026230,MATH 20E,B01,083773,Ciotti; Benjamin,20,0,35,15
1657964026230,MATH 20E,B02,083774,Ciotti; Benjamin,18,0,35,17
1657964032281,MATH 103A,A01,083777,Greenfeld; Be'Eri,6,0,36,30
1657964032281,MATH 103A,A02,083778,Greenfeld; Be'Eri,5,0,36,31
1657964032281,MATH 103A,A03,093561,Greenfeld; Be'Eri,7,0,36,29
1657964032281,MATH 103A,B01,083779,Greenfeld; Be'Eri,8,0,36,28
1657964032281,MATH 103A,B02,083780,Greenfeld; Be'Eri,4,0,36,32
1657964032281,MATH 103A,B03,093562,Greenfeld; Be'Eri,3,0,36,33
1657964038314,MATH 105,A01,085443,Carter; Anne Toulson,15,0,35,20
1657964038314,MATH 105,A02,093477,Carter; Anne Toulson,20,0,35,15
1657964044354,MATH 109,A01,083213,Ganzberger; Geoffrey Michael,3,0,34,31
1657964044354,MATH 109,A02,083214,Ganzberger; Geoffrey Michael,4,0,34,30
1657964044354,MATH 109,A03,093478,Ganzberger; Geoffrey Michael,2,0,34,32
1657964044354,MATH 109,B01,083215,Ganzberger; Geoffrey Michael,3,0,32,29
1657964044354,MATH 109,B02,083216,Ganzberger; Geoffrey Michael,3,0,32,29
1657964044354,MATH 109,B03,093479,Ganzberger; Geoffrey Michael,8,0,32,24
1657964050384,MATH 142A,A01,083219,Chow; Bennett,7,0,32,25
1657964050384,MATH 142A,A02,083220,Chow; Bennett,10,0,32,22
1657964050384,MATH 142A,A03,093480,Chow; Bennett,9,0,32,23
1657964050384,MATH 142A,B03,093481,Chow; Bennett,8,0,32,24
1657964050384,MATH 142A,B04,093558,Chow; Bennett,14,0,32,18
1657964050384,MATH 142A,B05,093559,Chow; Bennett,7,0,32,25
1657964056414,MATH 193A,A01,083224,Rotar; Vladimir,9,0,34,25
1657964056414,MATH 193A,A02,083225,Rotar; Vladimir,11,0,34,23
1657964056414,MATH 193A,A03,083781,Rotar; Vladimir,5,0,34,29
1657964056414,MATH 193A,A04,083782,Rotar; Vladimir,12,0,34,22
1657964056414,MATH 193A,A05,093482,Rotar; Vladimir,11,0,34,23
1657964062438,MATH 197,001,091859,McAuley; Julian John,9999,0,9999,0
1657964062438,MATH 197,002,095566,Kedlaya; Kiran S.,9997,0,9999,2
1657964062438,MATH 197,003,095567,Xiao; Ming,9999,0,9999,0
1657964062438,MATH 197,004,095571,Perols; Johan Lars,9998,0,9999,1
1657964069518,COGS 9,A01,083615,Shannon; Kyle Michael,11,0,75,64
1657964075551,COGS 11,A01,083617,Boyle; Mary E. T.,23,0,48,25
1657964081577,COGS 13,A01,083071,Bastos; Amalia Pinkusfeld,12,0,71,59
1657964087600,COGS 14A,A01,092681,Semenuks; Arturs,5,1,100,95
1657964093631,COGS 14B,A01,083073,Cheng; Tzu-Han,7,0,63,56
1657964099657,COGS 17,A01,092677,Semenuks; Arturs,7,0,81,74
1657964105684,COGS 100,A01,083619,Allen; Michael Gordon,17,0,70,53
1657964111707,COGS 101A,A01,083621,Davis; Joshua Daniel,9,0,68,59
1657964117749,COGS 101B,A01,091572,Allen; Michael Gordon,14,0,65,51
1657964123791,COGS 101C,A01,083625,Delgado; Tania,17,0,35,18
1657964129834,COGS 107A,A01,083627,Boyle; Mary E. T.,14,0,60,46
1657964135870,COGS 118A,A01,083075,Gupta; Anjum,21,0,76,55
1657964141903,CSE 3,A50,083646,Miranda; Gregory Joseph,24,0,50,26
1657964147930,CSE 8A,A50,083650,Miranda; Gregory Joseph,17,1,56,39
1657964153965,CSE 11,A01,083080,Cao; Yingjun,7,15,40,33
1657964159989,CSE 12,A01,083652,Krause-Levy; Sophia Louisa,30,1,120,90
1657964166013,CSE 15L,A01,083654,Morris; Justin Loren,9,0,50,41
1657964166013,CSE 15L,A02,083655,Morris; Justin Loren,11,0,50,39
1657964172042,CSE 20,A01,083657,Tran; Khoa Dang,39,0,80,41
1657964178083,CSE 21,A01,095574,Bach; Quang Tran,23,0,48,25
1657964184111,CSE 30,A01,083084,Eldon; John,8,0,80,72
1657964184111,CSE 30,B01,095061,Bhaskar; Nishant,9,0,50,41
1657964190162,CSE 100,A01,083659,Cao; Yingjun,5,4,70,65
1657964196184,CSE 134B,A01,083661,Powell; Thomas Allan,25,0,100,75
1657964202219,CSE 140,A01,083663,Gungor; Onat,17,0,85,68
1657964208241,CSE 140L,A01,083088,Eldon; John,23,0,100,77
1657964214264,CSE 175,A01,083665,Kumar; Rakesh,3,0,25,22
1657964220296,CSE 190,A00,092507,Dubnov; Shlomo,8,0,20,12
1657964226331,ECE 45,A01,083139,Congero; Spencer William,7,0,75,68
1657964232384,ECE 65,A50,083695,Saad; Andrew S,12,0,30,18
1657964232384,ECE 65,A51,095125,Saad; Andrew S,24,0,26,2
1657964238419,ECE 109,A01,091882,Touri; Behrouz,21,0,70,49
1657964244444,ECE 180,A00,083140,Abi Samra; Nicholas Camill,1,0,30,29
1657964244444,ECE 180,B00,083141,Abi Samra; Nicholas Camill,0,0,30,30
1657964250468,MATH 10A,A01,083735,Patchell; Gregory David,2,0,30,28
1657964250468,MATH 10A,A02,083736,Patchell; Gregory David,20,0,30,10
1657964250468,MATH 10A,A03,083737,Patchell; Gregory David,16,0,30,14
1657964256494,MATH 10B,A01,083207,Lim; Seonhee,9,0,34,25
1657964256494,MATH 10B,A02,083208,Lim; Seonhee,10,0,35,25
1657964256494,MATH 10B,A03,093472,Lim; Seonhee,7,0,34,27
1657964256494,MATH 10B,B01,083739,Sinha; Shubham,14,0,30,16
1657964262519,MATH 18,A01,083743,Cinel; Cameron Alexander,9,0,30,21
1657964262519,MATH 18,A02,083744,Cinel; Cameron Alexander,18,0,30,12
1657964262519,MATH 18,A03,083745,Cinel; Cameron Alexander,10,0,30,20
1657964262519,MATH 18,B01,083748,Rideout; David Porter,5,0,37,32
1657964262519,MATH 18,B02,083749,Rideout; David Porter,5,0,36,31
1657964262519,MATH 18,B03,083750,Rideout; David Porter,3,0,37,34
1657964262519,MATH 18,B04,083751,Rideout; David Porter,7,0,36,29
1657964262519,MATH 18,B05,093473,Rideout; David Porter,7,0,36,29
1657964262519,MATH 18,B06,093474,Rideout; David Porter,6,0,36,30
1657964268569,MATH 20A,A01,083754,Zheng; Zequn,14,0,40,26
1657964274593,MATH 20B,A01,083756,Briones; Jor-el Thomas Caparas,4,0,36,32
1657964274593,MATH 20B,A02,083757,Briones; Jor-el Thomas Caparas,1,0,36,35
1657964274593,MATH 20B,A03,093475,Briones; Jor-el Thomas Caparas,3,0,36,33
1657964280643,MATH 20C,A01,083760,Briones; Jor-el Thomas Caparas,1,0,35,34
1657964280643,MATH 20C,A02,083761,Briones; Jor-el Thomas Caparas,8,0,35,27
1657964280643,MATH 20C,A03,093476,Briones; Jor-el Thomas Caparas,0,1,36,36
1657964280643,MATH 20C,B01,083762,Bach; Quang Tran,1,0,30,29
1657964286667,MATH 20D,A01,083765,Tran; Brian Kha,5,0,30,25
1657964286667,MATH 20D,A02,083766,Tran; Brian Kha,5,0,30,25
1657964286667,MATH 20D,A03,083767,Tran; Brian Kha,6,0,30,24
1657964292711,MATH 20E,A01,083771,Ganguly; Soumya,12,0,32,20
1657964292711,MATH 20E,A02,083772,Ganguly; Soumya,7,0,32,25
1657964292711,MATH 20E,B01,083773,Ciotti; Benjamin,20,0,35,15
1657964292711,MATH 20E,B02,083774,Ciotti; Benjamin,18,0,35,17
1657964298735,MATH 103A,A01,083777,Greenfeld; Be'Eri,6,0,36,30
1657964298735,MATH 103A,A02,083778,Greenfeld; Be'Eri,5,0,36,31
1657964298735,MATH 103A,A03,093561,Greenfeld; Be'Eri,7,0,36,29
1657964298735,MATH 103A,B01,083779,Greenfeld; Be'Eri,8,0,36,28
1657964298735,MATH 103A,B02,083780,Greenfeld; Be'Eri,4,0,36,32
1657964298735,MATH 103A,B03,093562,Greenfeld; Be'Eri,3,0,36,33
1657964304769,MATH 105,A01,085443,Carter; Anne Toulson,15,0,35,20
1657964304769,MATH 105,A02,093477,Carter; Anne Toulson,20,0,35,15
1657964310795,MATH 109,A01,083213,Ganzberger; Geoffrey Michael,3,0,34,31
1657964310795,MATH 109,A02,083214,Ganzberger; Geoffrey Michael,4,0,34,30
1657964310795,MATH 109,A03,093478,Ganzberger; Geoffrey Michael,2,0,34,32
1657964310795,MATH 109,B01,083215,Ganzberger; Geoffrey Michael,3,0,32,29
1657964310795,MATH 109,B02,083216,Ganzberger; Geoffrey Michael,3,0,32,29
1657964310795,MATH 109,B03,093479,Ganzberger; Geoffrey Michael,8,0,32,24
1657964316837,MATH 142A,A01,083219,Chow; Bennett,7,0,32,25
1657964316837,MATH 142A,A02,083220,Chow; Bennett,10,0,32,22
1657964316837,MATH 142A,A03,093480,Chow; Bennett,9,0,32,23
1657964316837,MATH 142A,B03,093481,Chow; Bennett,8,0,32,24
1657964316837,MATH 142A,B04,093558,Chow; Bennett,14,0,32,18
1657964316837,MATH 142A,B05,093559,Chow; Bennett,7,0,32,25
1657964322885,MATH 193A,A01,083224,Rotar; Vladimir,9,0,34,25
1657964322885,MATH 193A,A02,083225,Rotar; Vladimir,11,0,34,23
1657964322885,MATH 193A,A03,083781,Rotar; Vladimir,5,0,34,29
1657964322885,MATH 193A,A04,083782,Rotar; Vladimir,12,0,34,22
1657964322885,MATH 193A,A05,093482,Rotar; Vladimir,11,0,34,23
1657964328908,MATH 197,001,091859,McAuley; Julian John,9999,0,9999,0
1657964328908,MATH 197,002,095566,Kedlaya; Kiran S.,9997,0,9999,2
1657964328908,MATH 197,003,095567,Xiao; Ming,9999,0,9999,0
1657964328908,MATH 197,004,095571,Perols; Johan Lars,9998,0,9999,1
1657964335998,COGS 9,A01,083615,Shannon; Kyle Michael,11,0,75,64
1657964342057,COGS 11,A01,083617,Boyle; Mary E. T.,23,0,48,25
1657964348079,COGS 13,A01,083071,Bastos; Amalia Pinkusfeld,12,0,71,59
1657964354101,COGS 14A,A01,092681,Semenuks; Arturs,5,1,100,95
1657964360123,COGS 14B,A01,083073,Cheng; Tzu-Han,7,0,63,56
1657964366166,COGS 17,A01,092677,Semenuks; Arturs,7,0,81,74
1657964372189,COGS 100,A01,083619,Allen; Michael Gordon,17,0,70,53
1657964378232,COGS 101A,A01,083621,Davis; Joshua Daniel,9,0,68,59
1657964384277,COGS 101B,A01,091572,Allen; Michael Gordon,14,0,65,51
1657964390300,COGS 101C,A01,083625,Delgado; Tania,17,0,35,18
1657964396332,COGS 107A,A01,083627,Boyle; Mary E. T.,14,0,60,46
1657964402358,COGS 118A,A01,083075,Gupta; Anjum,21,0,76,55
1657964408381,CSE 3,A50,083646,Miranda; Gregory Joseph,24,0,50,26
1657964414428,CSE 8A,A50,083650,Miranda; Gregory Joseph,17,1,56,39
1657964420453,CSE 11,A01,083080,Cao; Yingjun,7,15,40,33
1657964426475,CSE 12,A01,083652,Krause-Levy; Sophia Louisa,30,1,120,90
1657964432501,CSE 15L,A01,083654,Morris; Justin Loren,9,0,50,41
1657964432501,CSE 15L,A02,083655,Morris; Justin Loren,11,0,50,39
1657964438562,CSE 20,A01,083657,Tran; Khoa Dang,39,0,80,41
1657964444610,CSE 21,A01,095574,Bach; Quang Tran,23,0,48,25
1657964450633,CSE 30,A01,083084,Eldon; John,8,0,80,72
1657964450633,CSE 30,B01,095061,Bhaskar; Nishant,9,0,50,41
1657964456673,CSE 100,A01,083659,Cao; Yingjun,5,4,70,65
1657964462720,CSE 134B,A01,083661,Powell; Thomas Allan,25,0,100,75
1657964468754,CSE 140,A01,083663,Gungor; Onat,17,0,85,68
1657964474778,CSE 140L,A01,083088,Eldon; John,23,0,100,77
1657964480807,CSE 175,A01,083665,Kumar; Rakesh,3,0,25,22
1657964486842,CSE 190,A00,092507,Dubnov; Shlomo,8,0,20,12
1657964492865,ECE 45,A01,083139,Congero; Spencer William,7,0,75,68
1657964498916,ECE 65,A50,083695,Saad; Andrew S,12,0,30,18
1657964498916,ECE 65,A51,095125,Saad; Andrew S,24,0,26,2
1657964504960,ECE 109,A01,091882,Touri; Behrouz,21,0,70,49
1657964510985,ECE 180,A00,083140,Abi Samra; Nicholas Camill,1,0,30,29
1657964510985,ECE 180,B00,083141,Abi Samra; Nicholas Camill,0,0,30,30
1657964517124,MATH 10A,A01,083735,Patchell; Gregory David,2,0,30,28
1657964517124,MATH 10A,A02,083736,Patchell; Gregory David,20,0,30,10
1657964517124,MATH 10A,A03,083737,Patchell; Gregory David,16,0,30,14
1657964523162,MATH 10B,A01,083207,Lim; Seonhee,9,0,34,25
1657964523162,MATH 10B,A02,083208,Lim; Seonhee,10,0,35,25
1657964523162,MATH 10B,A03,093472,Lim; Seonhee,7,0,34,27
1657964523162,MATH 10B,B01,083739,Sinha; Shubham,14,0,30,16
1657964529187,MATH 18,A01,083743,Cinel; Cameron Alexander,9,0,30,21
1657964529187,MATH 18,A02,083744,Cinel; Cameron Alexander,18,0,30,12
1657964529187,MATH 18,A03,083745,Cinel; Cameron Alexander,10,0,30,20
1657964529187,MATH 18,B01,083748,Rideout; David Porter,5,0,37,32
1657964529187,MATH 18,B02,083749,Rideout; David Porter,5,0,36,31
1657964529187,MATH 18,B03,083750,Rideout; David Porter,3,0,37,34
1657964529187,MATH 18,B04,083751,Rideout; David Porter,7,0,36,29
1657964529187,MATH 18,B05,093473,Rideout; David Porter,7,0,36,29
1657964529187,MATH 18,B06,093474,Rideout; David Porter,6,0,36,30
1657964535215,MATH 20A,A01,083754,Zheng; Zequn,14,0,40,26
1657964541238,MATH 20B,A01,083756,Briones; Jor-el Thomas Caparas,4,0,36,32
1657964541238,MATH 20B,A02,083757,Briones; Jor-el Thomas Caparas,1,0,36,35
1657964541238,MATH 20B,A03,093475,Briones; Jor-el Thomas Caparas,3,0,36,33
1657964547300,MATH 20C,A01,083760,Briones; Jor-el Thomas Caparas,1,0,35,34
1657964547300,MATH 20C,A02,083761,Briones; Jor-el Thomas Caparas,8,0,35,27
1657964547300,MATH 20C,A03,093476,Briones; Jor-el Thomas Caparas,0,1,36,36
1657964547300,MATH 20C,B01,083762,Bach; Quang Tran,1,0,30,29
1657964553356,MATH 20D,A01,083765,Tran; Brian Kha,5,0,30,25
1657964553356,MATH 20D,A02,083766,Tran; Brian Kha,5,0,30,25
1657964553356,MATH 20D,A03,083767,Tran; Brian Kha,6,0,30,24
1657964559379,MATH 20E,A01,083771,Ganguly; Soumya,12,0,32,20
1657964559379,MATH 20E,A02,083772,Ganguly; Soumya,7,0,32,25
1657964559379,MATH 20E,B01,083773,Ciotti; Benjamin,20,0,35,15
1657964559379,MATH 20E,B02,083774,Ciotti; Benjamin,18,0,35,17
1657964565402,MATH 103A,A01,083777,Greenfeld; Be'Eri,6,0,36,30
1657964565402,MATH 103A,A02,083778,Greenfeld; Be'Eri,5,0,36,31
1657964565402,MATH 103A,A03,093561,Greenfeld; Be'Eri,7,0,36,29
1657964565402,MATH 103A,B01,083779,Greenfeld; Be'Eri,8,0,36,28
1657964565402,MATH 103A,B02,083780,Greenfeld; Be'Eri,4,0,36,32
1657964565402,MATH 103A,B03,093562,Greenfeld; Be'Eri,3,0,36,33
1657964571447,MATH 105,A01,085443,Carter; Anne Toulson,15,0,35,20
1657964571447,MATH 105,A02,093477,Carter; Anne Toulson,20,0,35,15
1657964577475,MATH 109,A01,083213,Ganzberger; Geoffrey Michael,3,0,34,31
1657964577475,MATH 109,A02,083214,Ganzberger; Geoffrey Michael,4,0,34,30
1657964577475,MATH 109,A03,093478,Ganzberger; Geoffrey Michael,2,0,34,32
1657964577475,MATH 109,B01,083215,Ganzberger; Geoffrey Michael,3,0,32,29
1657964577475,MATH 109,B02,083216,Ganzberger; Geoffrey Michael,3,0,32,29
1657964577475,MATH 109,B03,093479,Ganzberger; Geoffrey Michael,8,0,32,24
1657964583521,MATH 142A,A01,083219,Chow; Bennett,7,0,32,25
1657964583521,MATH 142A,A02,083220,Chow; Bennett,10,0,32,22
1657964583521,MATH 142A,A03,093480,Chow; Bennett,9,0,32,23
1657964583521,MATH 142A,B03,093481,Chow; Bennett,8,0,32,24
1657964583521,MATH 142A,B04,093558,Chow; Bennett,14,0,32,18
1657964583521,MATH 142A,B05,093559,Chow; Bennett,7,0,32,25
1657964589543,MATH 193A,A01,083224,Rotar; Vladimir,9,0,34,25
1657964589543,MATH 193A,A02,083225,Rotar; Vladimir,11,0,34,23
1657964589543,MATH 193A,A03,083781,Rotar; Vladimir,5,0,34,29
1657964589543,MATH 193A,A04,083782,Rotar; Vladimir,12,0,34,22
1657964589543,MATH 193A,A05,093482,Rotar; Vladimir,11,0,34,23
1657964595565,MATH 197,001,091859,McAuley; Julian John,9999,0,9999,0
1657964595565,MATH 197,002,095566,Kedlaya; Kiran S.,9997,0,9999,2
1657964595565,MATH 197,003,095567,Xiao; Ming,9999,0,9999,0
1657964595565,MATH 197,004,095571,Perols; Johan Lars,9998,0,9999,1
1657964602622,COGS 9,A01,083615,Shannon; Kyle Michael,11,0,75,64
1657964608665,COGS 11,A01,083617,Boyle; Mary E. T.,23,0,48,25
1657964614702,COGS 13,A01,083071,Bastos; Amalia Pinkusfeld,12,0,71,59
1657964620727,COGS 14A,A01,092681,Semenuks; Arturs,5,1,100,95
1657964626773,COGS 14B,A01,083073,Cheng; Tzu-Han,7,0,63,56
1657964632824,COGS 17,A01,092677,Semenuks; Arturs,7,0,81,74
1657964638846,COGS 100,A01,083619,Allen; Michael Gordon,17,0,70,53
1657964644899,COGS 101A,A01,083621,Davis; Joshua Daniel,9,0,68,59
1657964650954,COGS 101B,A01,091572,Allen; Michael Gordon,14,0,65,51
1657964657006,COGS 101C,A01,083625,Delgado; Tania,17,0,35,18
1657964663031,COGS 107A,A01,083627,Boyle; Mary E. T.,14,0,60,46
1657964669090,COGS 118A,A01,083075,Gupta; Anjum,21,0,76,55
1657964675130,CSE 3,A50,083646,Miranda; Gregory Joseph,24,0,50,26
1657964681157,CSE 8A,A50,083650,Miranda; Gregory Joseph,17,1,56,39
1657964687183,CSE 11,A01,083080,Cao; Yingjun,7,15,40,33
1657964693221,CSE 12,A01,083652,Krause-Levy; Sophia Louisa,30,1,120,90
1657964699244,CSE 15L,A01,083654,Morris; Justin Loren,9,0,50,41
1657964699244,CSE 15L,A02,083655,Morris; Justin Loren,11,0,50,39
1657964705280,CSE 20,A01,083657,Tran; Khoa Dang,39,0,80,41
1657964711314,CSE 21,A01,095574,Bach; Quang Tran,23,0,48,25
1657964717340,CSE 30,A01,083084,Eldon; John,8,0,80,72
1657964717340,CSE 30,B01,095061,Bhaskar; Nishant,9,0,50,41
1657964723366,CSE 100,A01,083659,Cao; Yingjun,5,4,70,65
1657964729412,CSE 134B,A01,083661,Powell; Thomas Allan,25,0,100,75
1657964735439,CSE 140,A01,083663,Gungor; Onat,17,0,85,68
1657964741467,CSE 140L,A01,083088,Eldon; John,23,0,100,77
1657964747490,CSE 175,A01,083665,Kumar; Rakesh,3,0,25,22
1657964753526,CSE 190,A00,092507,Dubnov; Shlomo,8,0,20,12
1657964759553,ECE 45,A01,083139,Congero; Spencer William,7,0,75,68
1657964765576,ECE 65,A50,083695,Saad; Andrew S,12,0,30,18
1657964765576,ECE 65,A51,095125,Saad; Andrew S,24,0,26,2
1657964771616,ECE 109,A01,091882,Touri; Behrouz,21,0,70,49
1657964777661,ECE 180,A00,083140,Abi Samra; Nicholas Camill,1,0,30,29
1657964777661,ECE 180,B00,083141,Abi Samra; Nicholas Camill,0,0,30,30
1657964783684,MATH 10A,A01,083735,Patchell; Gregory David,2,0,30,28
1657964783684,MATH 10A,A02,083736,Patchell; Gregory David,20,0,30,10
1657964783684,MATH 10A,A03,083737,Patchell; Gregory David,16,0,30,14
1657964789714,MATH 10B,A01,083207,Lim; Seonhee,9,0,34,25
1657964789714,MATH 10B,A02,083208,Lim; Seonhee,10,0,35,25
1657964789714,MATH 10B,A03,093472,Lim; Seonhee,7,0,34,27
1657964789714,MATH 10B,B01,083739,Sinha; Shubham,14,0,30,16
1657964795744,MATH 18,A01,083743,Cinel; Cameron Alexander,9,0,30,21
1657964795744,MATH 18,A02,083744,Cinel; Cameron Alexander,18,0,30,12
1657964795744,MATH 18,A03,083745,Cinel; Cameron Alexander,10,0,30,20
1657964795744,MATH 18,B01,083748,Rideout; David Porter,5,0,37,32
1657964795744,MATH 18,B02,083749,Rideout; David Porter,5,0,36,31
1657964795744,MATH 18,B03,083750,Rideout; David Porter,3,0,37,34
1657964795744,MATH 18,B04,083751,Rideout; David Porter,7,0,36,29
1657964795744,MATH 18,B05,093473,Rideout; David Porter,7,0,36,29
1657964795744,MATH 18,B06,093474,Rideout; David Porter,6,0,36,30
1657964801773,MATH 20A,A01,083754,Zheng; Zequn,14,0,40,26
1657964807805,MATH 20B,A01,083756,Briones; Jor-el Thomas Caparas,4,0,36,32
1657964807805,MATH 20B,A02,083757,Briones; Jor-el Thomas Caparas,1,0,36,35
1657964807805,MATH 20B,A03,093475,Briones; Jor-el Thomas Caparas,3,0,36,33
1657964813859,MATH 20C,A01,083760,Briones; Jor-el Thomas Caparas,1,0,35,34
1657964813859,MATH 20C,A02,083761,Briones; Jor-el Thomas Caparas,8,0,35,27
1657964813859,MATH 20C,A03,093476,Briones; Jor-el Thomas Caparas,0,1,36,36
1657964813859,MATH 20C,B01,083762,Bach; Quang Tran,1,0,30,29
1657964819884,MATH 20D,A01,083765,Tran; Brian Kha,5,0,30,25
1657964819884,MATH 20D,A02,083766,Tran; Brian Kha,5,0,30,25
1657964819884,MATH 20D,A03,083767,Tran; Brian Kha,6,0,30,24
1657964825908,MATH 20E,A01,083771,Ganguly; Soumya,12,0,32,20
1657964825908,MATH 20E,A02,083772,Ganguly; Soumya,7,0,32,25
1657964825908,MATH 20E,B01,083773,Ciotti; Benjamin,20,0,35,15
1657964825908,MATH 20E,B02,083774,Ciotti; Benjamin,18,0,35,17
1657964831962,MATH 103A,A01,083777,Greenfeld; Be'Eri,6,0,36,30
1657964831962,MATH 103A,A02,083778,Greenfeld; Be'Eri,5,0,36,31
1657964831962,MATH 103A,A03,093561,Greenfeld; Be'Eri,7,0,36,29
1657964831962,MATH 103A,B01,083779,Greenfeld; Be'Eri,8,0,36,28
1657964831962,MATH 103A,B02,083780,Greenfeld; Be'Eri,4,0,36,32
1657964831962,MATH 103A,B03,093562,Greenfeld; Be'Eri,3,0,36,33
1657964837995,MATH 105,A01,085443,Carter; Anne Toulson,15,0,35,20
1657964837995,MATH 105,A02,093477,Carter; Anne Toulson,20,0,35,15
1657964844020,MATH 109,A01,083213,Ganzberger; Geoffrey Michael,3,0,34,31
1657964844020,MATH 109,A02,083214,Ganzberger; Geoffrey Michael,4,0,34,30
1657964844020,MATH 109,A03,093478,Ganzberger; Geoffrey Michael,2,0,34,32
1657964844020,MATH 109,B01,083215,Ganzberger; Geoffrey Michael,3,0,32,29
1657964844020,MATH 109,B02,083216,Ganzberger; Geoffrey Michael,3,0,32,29
1657964844020,MATH 109,B03,093479,Ganzberger; Geoffrey Michael,8,0,32,24
1657964850058,MATH 142A,A01,083219,Chow; Bennett,7,0,32,25
1657964850058,MATH 142A,A02,083220,Chow; Bennett,10,0,32,22
1657964850058,MATH 142A,A03,093480,Chow; Bennett,9,0,32,23
1657964850058,MATH 142A,B03,093481,Chow; Bennett,8,0,32,24
1657964850058,MATH 142A,B04,093558,Chow; Bennett,14,0,32,18
1657964850058,MATH 142A,B05,093559,Chow; Bennett,7,0,32,25
1657964856087,MATH 193A,A01,083224,Rotar; Vladimir,9,0,34,25
1657964856087,MATH 193A,A02,083225,Rotar; Vladimir,11,0,34,23
1657964856087,MATH 193A,A03,083781,Rotar; Vladimir,5,0,34,29
1657964856087,MATH 193A,A04,083782,Rotar; Vladimir,12,0,34,22
1657964856087,MATH 193A,A05,093482,Rotar; Vladimir,11,0,34,23
1657964862124,MATH 197,001,091859,McAuley; Julian John,9999,0,9999,0
1657964862124,MATH 197,002,095566,Kedlaya; Kiran S.,9997,0,9999,2
1657964862124,MATH 197,003,095567,Xiao; Ming,9999,0,9999,0
1657964862124,MATH 197,004,095571,Perols; Johan Lars,9998,0,9999,1
1657964869184,COGS 9,A01,083615,Shannon; Kyle Michael,11,0,75,64
1657964875232,COGS 11,A01,083617,Boyle; Mary E. T.,23,0,48,25
1657964881270,COGS 13,A01,083071,Bastos; Amalia Pinkusfeld,12,0,71,59
1657964887292,COGS 14A,A01,092681,Semenuks; Arturs,5,1,100,95
1657964893317,COGS 14B,A01,083073,Cheng; Tzu-Han,7,0,63,56
1657964899342,COGS 17,A01,092677,Semenuks; Arturs,7,0,81,74
1657964905376,COGS 100,A01,083619,Allen; Michael Gordon,17,0,70,53
1657964911417,COGS 101A,A01,083621,Davis; Joshua Daniel,9,0,68,59
1657964917440,COGS 101B,A01,091572,Allen; Michael Gordon,14,0,65,51
1657964923473,COGS 101C,A01,083625,Delgado; Tania,17,0,35,18
1657964929496,COGS 107A,A01,083627,Boyle; Mary E. T.,14,0,60,46
1657964935526,COGS 118A,A01,083075,Gupta; Anjum,21,0,76,55
1657964941582,CSE 3,A50,083646,Miranda; Gregory Joseph,24,0,50,26
1657964947610,CSE 8A,A50,083650,Miranda; Gregory Joseph,17,1,56,39
1657964953645,CSE 11,A01,083080,Cao; Yingjun,7,15,40,33
1657964959682,CSE 12,A01,083652,Krause-Levy; Sophia Louisa,30,1,120,90
1657964965731,CSE 15L,A01,083654,Morris; Justin Loren,9,0,50,41
1657964965731,CSE 15L,A02,083655,Morris; Justin Loren,11,0,50,39
1657964971765,CSE 20,A01,083657,Tran; Khoa Dang,39,0,80,41
1657964977795,CSE 21,A01,095574,Bach; Quang Tran,23,0,48,25
1657964983830,CSE 30,A01,083084,Eldon; John,8,0,80,72
1657964983830,CSE 30,B01,095061,Bhaskar; Nishant,9,0,50,41
1657964989881,CSE 100,A01,083659,Cao; Yingjun,5,4,70,65
1657964995915,CSE 134B,A01,083661,Powell; Thomas Allan,25,0,100,75
1657965001970,CSE 140,A01,083663,Gungor; Onat,17,0,85,68
1657965008004,CSE 140L,A01,083088,Eldon; John,23,0,100,77
1657965014039,CSE 175,A01,083665,Kumar; Rakesh,3,0,25,22
1657965020078,CSE 190,A00,092507,Dubnov; Shlomo,8,0,20,12
1657965026111,ECE 45,A01,083139,Congero; Spencer William,7,0,75,68
1657965032155,ECE 65,A50,083695,Saad; Andrew S,12,0,30,18
1657965032155,ECE 65,A51,095125,Saad; Andrew S,24,0,26,2
1657965038179,ECE 109,A01,091882,Touri; Behrouz,21,0,70,49
1657965044202,ECE 180,A00,083140,Abi Samra; Nicholas Camill,1,0,30,29
1657965044202,ECE 180,B00,083141,Abi Samra; Nicholas Camill,0,0,30,30
1657965050253,MATH 10A,A01,083735,Patchell; Gregory David,2,0,30,28
1657965050253,MATH 10A,A02,083736,Patchell; Gregory David,20,0,30,10
1657965050253,MATH 10A,A03,083737,Patchell; Gregory David,16,0,30,14
1657965056283,MATH 10B,A01,083207,Lim; Seonhee,9,0,34,25
1657965056283,MATH 10B,A02,083208,Lim; Seonhee,10,0,35,25
1657965056283,MATH 10B,A03,093472,Lim; Seonhee,7,0,34,27
1657965056283,MATH 10B,B01,083739,Sinha; Shubham,14,0,30,16
1657965062348,MATH 18,A01,083743,Cinel; Cameron Alexander,9,0,30,21
1657965062348,MATH 18,A02,083744,Cinel; Cameron Alexander,18,0,30,12
1657965062348,MATH 18,A03,083745,Cinel; Cameron Alexander,10,0,30,20
1657965062348,MATH 18,B01,083748,Rideout; David Porter,5,0,37,32
1657965062348,MATH 18,B02,083749,Rideout; David Porter,5,0,36,31
1657965062348,MATH 18,B03,083750,Rideout; David Porter,3,0,37,34
1657965062348,MATH 18,B04,083751,Rideout; David Porter,7,0,36,29
1657965062348,MATH 18,B05,093473,Rideout; David Porter,7,0,36,29
1657965062348,MATH 18,B06,093474,Rideout; David Porter,6,0,36,30
1657965068375,MATH 20A,A01,083754,Zheng; Zequn,14,0,40,26
1657965074398,MATH 20B,A01,083756,Briones; Jor-el Thomas Caparas,4,0,36,32
1657965074398,MATH 20B,A02,083757,Briones; Jor-el Thomas Caparas,1,0,36,35
1657965074398,MATH 20B,A03,093475,Briones; Jor-el Thomas Caparas,3,0,36,33
1657965080434,MATH 20C,A01,083760,Briones; Jor-el Thomas Caparas,1,0,35,34
1657965080434,MATH 20C,A02,083761,Briones; Jor-el Thomas Caparas,8,0,35,27
1657965080434,MATH 20C,A03,093476,Briones; Jor-el Thomas Caparas,0,1,36,36
1657965080434,MATH 20C,B01,083762,Bach; Quang Tran,1,0,30,29
1657965086480,MATH 20D,A01,083765,Tran; Brian Kha,5,0,30,25
1657965086480,MATH 20D,A02,083766,Tran; Brian Kha,5,0,30,25
1657965086480,MATH 20D,A03,083767,Tran; Brian Kha,6,0,30,24
1657965092509,MATH 20E,A01,083771,Ganguly; Soumya,12,0,32,20
1657965092509,MATH 20E,A02,083772,Ganguly; Soumya,7,0,32,25
1657965092509,MATH 20E,B01,083773,Ciotti; Benjamin,20,0,35,15
1657965092509,MATH 20E,B02,083774,Ciotti; Benjamin,18,0,35,17
1657965098531,MATH 103A,A01,083777,Greenfeld; Be'Eri,6,0,36,30
1657965098531,MATH 103A,A02,083778,Greenfeld; Be'Eri,5,0,36,31
1657965098531,MATH 103A,A03,093561,Greenfeld; Be'Eri,7,0,36,29
1657965098531,MATH 103A,B01,083779,Greenfeld; Be'Eri,8,0,36,28
1657965098531,MATH 103A,B02,083780,Greenfeld; Be'Eri,4,0,36,32
1657965098531,MATH 103A,B03,093562,Greenfeld; Be'Eri,3,0,36,33
1657965104583,MATH 105,A01,085443,Carter; Anne Toulson,15,0,35,20
1657965104583,MATH 105,A02,093477,Carter; Anne Toulson,20,0,35,15
1657965110621,MATH 109,A01,083213,Ganzberger; Geoffrey Michael,3,0,34,31
1657965110621,MATH 109,A02,083214,Ganzberger; Geoffrey Michael,4,0,34,30
1657965110621,MATH 109,A03,093478,Ganzberger; Geoffrey Michael,2,0,34,32
1657965110621,MATH 109,B01,083215,Ganzberger; Geoffrey Michael,3,0,32,29
1657965110621,MATH 109,B02,083216,Ganzberger; Geoffrey Michael,3,0,32,29
1657965110621,MATH 109,B03,093479,Ganzberger; Geoffrey Michael,8,0,32,24
1657965116742,MATH 142A,A01,083219,Chow; Bennett,7,0,32,25
1657965116742,MATH 142A,A02,083220,Chow; Bennett,10,0,32,22
1657965116742,MATH 142A,A03,093480,Chow; Bennett,9,0,32,23
1657965116742,MATH 142A,B03,093481,Chow; Bennett,8,0,32,24
1657965116742,MATH 142A,B04,093558,Chow; Bennett,14,0,32,18
1657965116742,MATH 142A,B05,093559,Chow; Bennett,7,0,32,25
1657965122794,MATH 193A,A01,083224,Rotar; Vladimir,9,0,34,25
1657965122794,MATH 193A,A02,083225,Rotar; Vladimir,11,0,34,23
1657965122794,MATH 193A,A03,083781,Rotar; Vladimir,5,0,34,29
1657965122794,MATH 193A,A04,083782,Rotar; Vladimir,12,0,34,22
1657965122794,MATH 193A,A05,093482,Rotar; Vladimir,11,0,34,23
1657965128835,MATH 197,001,091859,McAuley; Julian John,9999,0,9999,0
1657965128835,MATH 197,002,095566,Kedlaya; Kiran S.,9997,0,9999,2
1657965128835,MATH 197,003,095567,Xiao; Ming,9999,0,9999,0
1657965128835,MATH 197,004,095571,Perols; Johan Lars,9998,0,9999,1
1657965135943,COGS 9,A01,083615,Shannon; Kyle Michael,11,0,75,64
1657965141965,COGS 11,A01,083617,Boyle; Mary E. T.,23,0,48,25
1657965147999,COGS 13,A01,083071,Bastos; Amalia Pinkusfeld,12,0,71,59
1657965154051,COGS 14A,A01,092681,Semenuks; Arturs,5,1,100,95
1657965160096,COGS 14B,A01,083073,Cheng; Tzu-Han,7,0,63,56
1657965166140,COGS 17,A01,092677,Semenuks; Arturs,7,0,81,74
1657965172189,COGS 100,A01,083619,Allen; Michael Gordon,17,0,70,53
1657965178222,COGS 101A,A01,083621,Davis; Joshua Daniel,9,0,68,59
1657965184244,COGS 101B,A01,091572,Allen; Michael Gordon,14,0,65,51
1657965190268,COGS 101C,A01,083625,Delgado; Tania,17,0,35,18
1657965196299,COGS 107A,A01,083627,Boyle; Mary E. T.,14,0,60,46
1657965202338,COGS 118A,A01,083075,Gupta; Anjum,21,0,76,55
1657965208375,CSE 3,A50,083646,Miranda; Gregory Joseph,24,0,50,26
1657965214422,CSE 8A,A50,083650,Miranda; Gregory Joseph,17,1,56,39
1657965220459,CSE 11,A01,083080,Cao; Yingjun,7,15,40,33
1657965226483,CSE 12,A01,083652,Krause-Levy; Sophia Louisa,30,1,120,90
1657965232514,CSE 15L,A01,083654,Morris; Justin Loren,9,0,50,41
1657965232514,CSE 15L,A02,083655,Morris; Justin Loren,11,0,50,39
1657965238542,CSE 20,A01,083657,Tran; Khoa Dang,39,0,80,41
1657965244582,CSE 21,A01,095574,Bach; Quang Tran,23,0,48,25
1657965250604,CSE 30,A01,083084,Eldon; John,8,0,80,72
1657965250604,CSE 30,B01,095061,Bhaskar; Nishant,9,0,50,41
1657965256628,CSE 100,A01,083659,Cao; Yingjun,5,4,70,65
1657965262653,CSE 134B,A01,083661,Powell; Thomas Allan,25,0,100,75
1657965268678,CSE 140,A01,083663,Gungor; Onat,17,0,85,68
1657965274699,CSE 140L,A01,083088,Eldon; John,23,0,100,77
1657965280727,CSE 175,A01,083665,Kumar; Rakesh,3,0,25,22
1657965286761,CSE 190,A00,092507,Dubnov; Shlomo,8,0,20,12
1657965292802,ECE 45,A01,083139,Congero; Spencer William,7,0,75,68
1657965298858,ECE 65,A50,083695,Saad; Andrew S,12,0,30,18
1657965298858,ECE 65,A51,095125,Saad; Andrew S,24,0,26,2
1657965304886,ECE 109,A01,091882,Touri; Behrouz,21,0,70,49
1657965310908,ECE 180,A00,083140,Abi Samra; Nicholas Camill,1,0,30,29
1657965310908,ECE 180,B00,083141,Abi Samra; Nicholas Camill,0,0,30,30
1657965316937,MATH 10A,A01,083735,Patchell; Gregory David,2,0,30,28
1657965316937,MATH 10A,A02,083736,Patchell; Gregory David,20,0,30,10
1657965316937,MATH 10A,A03,083737,Patchell; Gregory David,16,0,30,14
1657965322965,MATH 10B,A01,083207,Lim; Seonhee,9,0,34,25
1657965322965,MATH 10B,A02,083208,Lim; Seonhee,10,0,35,25
1657965322965,MATH 10B,A03,093472,Lim; Seonhee,7,0,34,27
1657965322965,MATH 10B,B01,083739,Sinha; Shubham,14,0,30,16
1657965329005,MATH 18,A01,083743,Cinel; Cameron Alexander,9,0,30,21
1657965329005,MATH 18,A02,083744,Cinel; Cameron Alexander,18,0,30,12
1657965329005,MATH 18,A03,083745,Cinel; Cameron Alexander,10,0,30,20
1657965329005,MATH 18,B01,083748,Rideout; David Porter,5,0,37,32
1657965329005,MATH 18,B02,083749,Rideout; David Porter,5,0,36,31
1657965329005,MATH 18,B03,083750,Rideout; David Porter,3,0,37,34
1657965329005,MATH 18,B04,083751,Rideout; David Porter,7,0,36,29
1657965329005,MATH 18,B05,093473,Rideout; David Porter,7,0,36,29
1657965329005,MATH 18,B06,093474,Rideout; David Porter,6,0,36,30
1657965335060,MATH 20A,A01,083754,Zheng; Zequn,14,0,40,26
1657965341083,MATH 20B,A01,083756,Briones; Jor-el Thomas Caparas,4,0,36,32
1657965341083,MATH 20B,A02,083757,Briones; Jor-el Thomas Caparas,1,0,36,35
1657965341083,MATH 20B,A03,093475,Briones; Jor-el Thomas Caparas,3,0,36,33
1657965347130,MATH 20C,A01,083760,Briones; Jor-el Thomas Caparas,1,0,35,34
1657965347130,MATH 20C,A02,083761,Briones; Jor-el Thomas Caparas,8,0,35,27
1657965347130,MATH 20C,A03,093476,Briones; Jor-el Thomas Caparas,0,1,36,36
1657965347130,MATH 20C,B01,083762,Bach; Quang Tran,1,0,30,29
1657965353167,MATH 20D,A01,083765,Tran; Brian Kha,5,0,30,25
1657965353167,MATH 20D,A02,083766,Tran; Brian Kha,5,0,30,25
1657965353167,MATH 20D,A03,083767,Tran; Brian Kha,6,0,30,24
1657965359202,MATH 20E,A01,083771,Ganguly; Soumya,12,0,32,20
1657965359202,MATH 20E,A02,083772,Ganguly; Soumya,7,0,32,25
1657965359202,MATH 20E,B01,083773,Ciotti; Benjamin,20,0,35,15
1657965359202,MATH 20E,B02,083774,Ciotti; Benjamin,18,0,35,17
1657965365254,MATH 103A,A01,083777,Greenfeld; Be'Eri,6,0,36,30
1657965365254,MATH 103A,A02,083778,Greenfeld; Be'Eri,5,0,36,31
1657965365254,MATH 103A,A03,093561,Greenfeld; Be'Eri,7,0,36,29
1657965365254,MATH 103A,B01,083779,Greenfeld; Be'Eri,8,0,36,28
1657965365254,MATH 103A,B02,083780,Greenfeld; Be'Eri,4,0,36,32
1657965365254,MATH 103A,B03,093562,Greenfeld; Be'Eri,3,0,36,33
1657965371289,MATH 105,A01,085443,Carter; Anne Toulson,15,0,35,20
1657965371289,MATH 105,A02,093477,Carter; Anne Toulson,20,0,35,15
1657965377314,MATH 109,A01,083213,Ganzberger; Geoffrey Michael,3,0,34,31
1657965377314,MATH 109,A02,083214,Ganzberger; Geoffrey Michael,4,0,34,30
1657965377314,MATH 109,A03,093478,Ganzberger; Geoffrey Michael,2,0,34,32
1657965377314,MATH 109,B01,083215,Ganzberger; Geoffrey Michael,3,0,32,29
1657965377314,MATH 109,B02,083216,Ganzberger; Geoffrey Michael,3,0,32,29
1657965377314,MATH 109,B03,093479,Ganzberger; Geoffrey Michael,8,0,32,24
1657965383345,MATH 142A,A01,083219,Chow; Bennett,7,0,32,25
1657965383345,MATH 142A,A02,083220,Chow; Bennett,10,0,32,22
1657965383345,MATH 142A,A03,093480,Chow; Bennett,9,0,32,23
1657965383345,MATH 142A,B03,093481,Chow; Bennett,8,0,32,24
1657965383345,MATH 142A,B04,093558,Chow; Bennett,14,0,32,18
1657965383345,MATH 142A,B05,093559,Chow; Bennett,7,0,32,25
1657965389398,MATH 193A,A01,083224,Rotar; Vladimir,9,0,34,25
1657965389398,MATH 193A,A02,083225,Rotar; Vladimir,11,0,34,23
1657965389398,MATH 193A,A03,083781,Rotar; Vladimir,5,0,34,29
1657965389398,MATH 193A,A04,083782,Rotar; Vladimir,12,0,34,22
1657965389398,MATH 193A,A05,093482,Rotar; Vladimir,11,0,34,23
1657965395425,MATH 197,001,091859,McAuley; Julian John,9999,0,9999,0
1657965395425,MATH 197,002,095566,Kedlaya; Kiran S.,9997,0,9999,2
1657965395425,MATH 197,003,095567,Xiao; Ming,9999,0,9999,0
1657965395425,MATH 197,004,095571,Perols; Johan Lars,9998,0,9999,1
1657965402506,COGS 9,A01,083615,Shannon; Kyle Michael,11,0,75,64
1657965408540,COGS 11,A01,083617,Boyle; Mary E. T.,23,0,48,25
1657965414597,COGS 13,A01,083071,Bastos; Amalia Pinkusfeld,12,0,71,59
1657965420653,COGS 14A,A01,092681,Semenuks; Arturs,5,1,100,95
1657965426686,COGS 14B,A01,083073,Cheng; Tzu-Han,7,0,63,56
1657965432723,COGS 17,A01,092677,Semenuks; Arturs,7,0,81,74
1657965438759,COGS 100,A01,083619,Allen; Michael Gordon,17,0,70,53
1657965444781,COGS 101A,A01,083621,Davis; Joshua Daniel,9,0,68,59
1657965450836,COGS 101B,A01,091572,Allen; Michael Gordon,14,0,65,51
1657965456860,COGS 101C,A01,083625,Delgado; Tania,17,0,35,18
1657965462886,COGS 107A,A01,083627,Boyle; Mary E. T.,14,0,60,46
1657965468943,COGS 118A,A01,083075,Gupta; Anjum,21,0,76,55
1657965474987,CSE 3,A50,083646,Miranda; Gregory Joseph,24,0,50,26
1657965481014,CSE 8A,A50,083650,Miranda; Gregory Joseph,17,1,56,39
1657965487036,CSE 11,A01,083080,Cao; Yingjun,7,15,40,33
1657965493083,CSE 12,A01,083652,Krause-Levy; Sophia Louisa,30,1,120,90
1657965499112,CSE 15L,A01,083654,Morris; Justin Loren,9,0,50,41
1657965499112,CSE 15L,A02,083655,Morris; Justin Loren,11,0,50,39
1657965505152,CSE 20,A01,083657,Tran; Khoa Dang,39,0,80,41
1657965511174,CSE 21,A01,095574,Bach; Quang Tran,23,0,48,25
1657965517199,CSE 30,A01,083084,Eldon; John,8,0,80,72
1657965517199,CSE 30,B01,095061,Bhaskar; Nishant,9,0,50,41
1657965523236,CSE 100,A01,083659,Cao; Yingjun,5,4,70,65
1657965529287,CSE 134B,A01,083661,Powell; Thomas Allan,25,0,100,75
1657965535326,CSE 140,A01,083663,Gungor; Onat,17,0,85,68
1657965541374,CSE 140L,A01,083088,Eldon; John,23,0,100,77
1657965547395,CSE 175,A01,083665,Kumar; Rakesh,3,0,25,22
1657965553431,CSE 190,A00,092507,Dubnov; Shlomo,8,0,20,12
1657965559460,ECE 45,A01,083139,Congero; Spencer William,7,0,75,68
1657965565487,ECE 65,A50,083695,Saad; Andrew S,12,0,30,18
1657965565487,ECE 65,A51,095125,Saad; Andrew S,24,0,26,2
1657965571518,ECE 109,A01,091882,Touri; Behrouz,21,0,70,49
1657965577554,ECE 180,A00,083140,Abi Samra; Nicholas Camill,1,0,30,29
1657965577554,ECE 180,B00,083141,Abi Samra; Nicholas Camill,0,0,30,30
1657965583585,MATH 10A,A01,083735,Patchell; Gregory David,2,0,30,28
1657965583585,MATH 10A,A02,083736,Patchell; Gregory David,20,0,30,10
1657965583585,MATH 10A,A03,083737,Patchell; Gregory David,16,0,30,14
1657965589608,MATH 10B,A01,083207,Lim; Seonhee,9,0,34,25
1657965589608,MATH 10B,A02,083208,Lim; Seonhee,10,0,35,25
1657965589608,MATH 10B,A03,093472,Lim; Seonhee,7,0,34,27
1657965589608,MATH 10B,B01,083739,Sinha; Shubham,14,0,30,16
1657965595655,MATH 18,A01,083743,Cinel; Cameron Alexander,9,0,30,21
1657965595655,MATH 18,A02,083744,Cinel; Cameron Alexander,18,0,30,12
1657965595655,MATH 18,A03,083745,Cinel; Cameron Alexander,10,0,30,20
1657965595655,MATH 18,B01,083748,Rideout; David Porter,5,0,37,32
1657965595655,MATH 18,B02,083749,Rideout; David Porter,5,0,36,31
1657965595655,MATH 18,B03,083750,Rideout; David Porter,3,0,37,34
1657965595655,MATH 18,B04,083751,Rideout; David Porter,7,0,36,29
1657965595655,MATH 18,B05,093473,Rideout; David Porter,7,0,36,29
1657965595655,MATH 18,B06,093474,Rideout; David Porter,6,0,36,30
1657965601681,MATH 20A,A01,083754,Zheng; Zequn,14,0,40,26
1657965607711,MATH 20B,A01,083756,Briones; Jor-el Thomas Caparas,4,0,36,32
1657965607711,MATH 20B,A02,083757,Briones; Jor-el Thomas Caparas,1,0,36,35
1657965607711,MATH 20B,A03,093475,Briones; Jor-el Thomas Caparas,3,0,36,33
1657965613733,MATH 20C,A01,083760,Briones; Jor-el Thomas Caparas,1,0,35,34
1657965613733,MATH 20C,A02,083761,Briones; Jor-el Thomas Caparas,8,0,35,27
1657965613733,MATH 20C,A03,093476,Briones; Jor-el Thomas Caparas,0,1,36,36
1657965613733,MATH 20C,B01,083762,Bach; Quang Tran,1,0,30,29
1657965619764,MATH 20D,A01,083765,Tran; Brian Kha,5,0,30,25
1657965619764,MATH 20D,A02,083766,Tran; Brian Kha,5,0,30,25
1657965619764,MATH 20D,A03,083767,Tran; Brian Kha,6,0,30,24
1657965625799,MATH 20E,A01,083771,Ganguly; Soumya,12,0,32,20
1657965625799,MATH 20E,A02,083772,Ganguly; Soumya,7,0,32,25
1657965625799,MATH 20E,B01,083773,Ciotti; Benjamin,20,0,35,15
1657965625799,MATH 20E,B02,083774,Ciotti; Benjamin,18,0,35,17
1657965631840,MATH 103A,A01,083777,Greenfeld; Be'Eri,6,0,36,30
1657965631840,MATH 103A,A02,083778,Greenfeld; Be'Eri,5,0,36,31
1657965631840,MATH 103A,A03,093561,Greenfeld; Be'Eri,7,0,36,29
1657965631840,MATH 103A,B01,083779,Greenfeld; Be'Eri,8,0,36,28
1657965631840,MATH 103A,B02,083780,Greenfeld; Be'Eri,4,0,36,32
1657965631840,MATH 103A,B03,093562,Greenfeld; Be'Eri,3,0,36,33
1657965637888,MATH 105,A01,085443,Carter; Anne Toulson,15,0,35,20
1657965637888,MATH 105,A02,093477,Carter; Anne Toulson,20,0,35,15
1657965643923,MATH 109,A01,083213,Ganzberger; Geoffrey Michael,3,0,34,31
1657965643923,MATH 109,A02,083214,Ganzberger; Geoffrey Michael,4,0,34,30
1657965643923,MATH 109,A03,093478,Ganzberger; Geoffrey Michael,2,0,34,32
1657965643923,MATH 109,B01,083215,Ganzberger; Geoffrey Michael,3,0,32,29
1657965643923,MATH 109,B02,083216,Ganzberger; Geoffrey Michael,3,0,32,29
1657965643923,MATH 109,B03,093479,Ganzberger; Geoffrey Michael,8,0,32,24
1657965649956,MATH 142A,A01,083219,Chow; Bennett,7,0,32,25
1657965649956,MATH 142A,A02,083220,Chow; Bennett,10,0,32,22
1657965649956,MATH 142A,A03,093480,Chow; Bennett,9,0,32,23
1657965649956,MATH 142A,B03,093481,Chow; Bennett,8,0,32,24
1657965649956,MATH 142A,B04,093558,Chow; Bennett,14,0,32,18
1657965649956,MATH 142A,B05,093559,Chow; Bennett,7,0,32,25
1657965655992,MATH 193A,A01,083224,Rotar; Vladimir,9,0,34,25
1657965655992,MATH 193A,A02,083225,Rotar; Vladimir,11,0,34,23
1657965655992,MATH 193A,A03,083781,Rotar; Vladimir,5,0,34,29
1657965655992,MATH 193A,A04,083782,Rotar; Vladimir,12,0,34,22
1657965655992,MATH 193A,A05,093482,Rotar; Vladimir,11,0,34,23
1657965662014,MATH 197,001,091859,McAuley; Julian John,9999,0,9999,0
1657965662014,MATH 197,002,095566,Kedlaya; Kiran S.,9997,0,9999,2
1657965662014,MATH 197,003,095567,Xiao; Ming,9999,0,9999,0
1657965662014,MATH 197,004,095571,Perols; Johan Lars,9998,0,9999,1
1657965669072,COGS 9,A01,083615,Shannon; Kyle Michael,11,0,75,64
1657965675108,COGS 11,A01,083617,Boyle; Mary E. T.,23,0,48,25
1657965681145,COGS 13,A01,083071,Bastos; Amalia Pinkusfeld,12,0,71,59
1657965687171,COGS 14A,A01,092681,Semenuks; Arturs,5,1,100,95
1657965693193,COGS 14B,A01,083073,Cheng; Tzu-Han,7,0,63,56
1657965699225,COGS 17,A01,092677,Semenuks; Arturs,7,0,81,74
1657965705262,COGS 100,A01,083619,Allen; Michael Gordon,17,0,70,53
1657965711361,COGS 101A,A01,083621,Davis; Joshua Daniel,9,0,68,59
1657965717388,COGS 101B,A01,091572,Allen; Michael Gordon,14,0,65,51
1657965723416,COGS 101C,A01,083625,Delgado; Tania,17,0,35,18
1657965729444,COGS 107A,A01,083627,Boyle; Mary E. T.,14,0,60,46
1657965735468,COGS 118A,A01,083075,Gupta; Anjum,21,0,76,55
1657965741507,CSE 3,A50,083646,Miranda; Gregory Joseph,24,0,50,26
1657965747529,CSE 8A,A50,083650,Miranda; Gregory Joseph,17,1,56,39
1657965753552,CSE 11,A01,083080,Cao; Yingjun,7,15,40,33
1657965759586,CSE 12,A01,083652,Krause-Levy; Sophia Louisa,30,1,120,90
1657965765610,CSE 15L,A01,083654,Morris; Justin Loren,9,0,50,41
1657965765610,CSE 15L,A02,083655,Morris; Justin Loren,11,0,50,39
1657965771633,CSE 20,A01,083657,Tran; Khoa Dang,39,0,80,41
1657965777660,CSE 21,A01,095574,Bach; Quang Tran,23,0,48,25
1657965783685,CSE 30,A01,083084,Eldon; John,8,0,80,72
1657965783685,CSE 30,B01,095061,Bhaskar; Nishant,9,0,50,41
1657965789731,CSE 100,A01,083659,Cao; Yingjun,5,4,70,65
1657965795765,CSE 134B,A01,083661,Powell; Thomas Allan,25,0,100,75
1657965801790,CSE 140,A01,083663,Gungor; Onat,17,0,85,68
1657965807816,CSE 140L,A01,083088,Eldon; John,23,0,100,77
1657965813864,CSE 175,A01,083665,Kumar; Rakesh,3,0,25,22
1657965819900,CSE 190,A00,092507,Dubnov; Shlomo,8,0,20,12
1657965825924,ECE 45,A01,083139,Congero; Spencer William,7,0,75,68
1657965831948,ECE 65,A50,083695,Saad; Andrew S,12,0,30,18
1657965831948,ECE 65,A51,095125,Saad; Andrew S,24,0,26,2
1657965837974,ECE 109,A01,091882,Touri; Behrouz,21,0,70,49
1657965843998,ECE 180,A00,083140,Abi Samra; Nicholas Camill,1,0,30,29
1657965843998,ECE 180,B00,083141,Abi Samra; Nicholas Camill,0,0,30,30
1657965850025,MATH 10A,A01,083735,Patchell; Gregory David,2,0,30,28
1657965850025,MATH 10A,A02,083736,Patchell; Gregory David,20,0,30,10
1657965850025,MATH 10A,A03,083737,Patchell; Gregory David,16,0,30,14
1657965856049,MATH 10B,A01,083207,Lim; Seonhee,9,0,34,25
1657965856049,MATH 10B,A02,083208,Lim; Seonhee,10,0,35,25
1657965856049,MATH 10B,A03,093472,Lim; Seonhee,7,0,34,27
1657965856049,MATH 10B,B01,083739,Sinha; Shubham,14,0,30,16
1657965862096,MATH 18,A01,083743,Cinel; Cameron Alexander,9,0,30,21
1657965862096,MATH 18,A02,083744,Cinel; Cameron Alexander,18,0,30,12
1657965862096,MATH 18,A03,083745,Cinel; Cameron Alexander,10,0,30,20
1657965862096,MATH 18,B01,083748,Rideout; David Porter,5,0,37,32
1657965862096,MATH 18,B02,083749,Rideout; David Porter,5,0,36,31
1657965862096,MATH 18,B03,083750,Rideout; David Porter,3,0,37,34
1657965862096,MATH 18,B04,083751,Rideout; David Porter,7,0,36,29
1657965862096,MATH 18,B05,093473,Rideout; David Porter,7,0,36,29
1657965862096,MATH 18,B06,093474,Rideout; David Porter,6,0,36,30
1657965868119,MATH 20A,A01,083754,Zheng; Zequn,14,0,40,26
1657965874143,MATH 20B,A01,083756,Briones; Jor-el Thomas Caparas,4,0,36,32
1657965874143,MATH 20B,A02,083757,Briones; Jor-el Thomas Caparas,1,0,36,35
1657965874143,MATH 20B,A03,093475,Briones; Jor-el Thomas Caparas,3,0,36,33
1657965880172,MATH 20C,A01,083760,Briones; Jor-el Thomas Caparas,1,0,35,34
1657965880172,MATH 20C,A02,083761,Briones; Jor-el Thomas Caparas,8,0,35,27
1657965880172,MATH 20C,A03,093476,Briones; Jor-el Thomas Caparas,0,1,36,36
1657965880172,MATH 20C,B01,083762,Bach; Quang Tran,1,0,30,29
1657965886212,MATH 20D,A01,083765,Tran; Brian Kha,5,0,30,25
1657965886212,MATH 20D,A02,083766,Tran; Brian Kha,5,0,30,25
1657965886212,MATH 20D,A03,083767,Tran; Brian Kha,6,0,30,24
1657965892245,MATH 20E,A01,083771,Ganguly; Soumya,12,0,32,20
1657965892245,MATH 20E,A02,083772,Ganguly; Soumya,7,0,32,25
1657965892245,MATH 20E,B01,083773,Ciotti; Benjamin,20,0,35,15
1657965892245,MATH 20E,B02,083774,Ciotti; Benjamin,18,0,35,17
1657965898278,MATH 103A,A01,083777,Greenfeld; Be'Eri,6,0,36,30
1657965898278,MATH 103A,A02,083778,Greenfeld; Be'Eri,5,0,36,31
1657965898278,MATH 103A,A03,093561,Greenfeld; Be'Eri,7,0,36,29
1657965898278,MATH 103A,B01,083779,Greenfeld; Be'Eri,8,0,36,28
1657965898278,MATH 103A,B02,083780,Greenfeld; Be'Eri,4,0,36,32
1657965898278,MATH 103A,B03,093562,Greenfeld; Be'Eri,3,0,36,33
1657965904310,MATH 105,A01,085443,Carter; Anne Toulson,15,0,35,20
1657965904310,MATH 105,A02,093477,Carter; Anne Toulson,20,0,35,15
1657965910349,MATH 109,A01,083213,Ganzberger; Geoffrey Michael,3,0,34,31
1657965910349,MATH 109,A02,083214,Ganzberger; Geoffrey Michael,4,0,34,30
1657965910349,MATH 109,A03,093478,Ganzberger; Geoffrey Michael,2,0,34,32
1657965910349,MATH 109,B01,083215,Ganzberger; Geoffrey Michael,3,0,32,29
1657965910349,MATH 109,B02,083216,Ganzberger; Geoffrey Michael,3,0,32,29
1657965910349,MATH 109,B03,093479,Ganzberger; Geoffrey Michael,8,0,32,24
1657965916394,MATH 142A,A01,083219,Chow; Bennett,7,0,32,25
1657965916394,MATH 142A,A02,083220,Chow; Bennett,10,0,32,22
1657965916394,MATH 142A,A03,093480,Chow; Bennett,9,0,32,23
1657965916394,MATH 142A,B03,093481,Chow; Bennett,8,0,32,24
1657965916394,MATH 142A,B04,093558,Chow; Bennett,14,0,32,18
1657965916394,MATH 142A,B05,093559,Chow; Bennett,7,0,32,25
1657965922440,MATH 193A,A01,083224,Rotar; Vladimir,9,0,34,25
1657965922440,MATH 193A,A02,083225,Rotar; Vladimir,11,0,34,23
1657965922440,MATH 193A,A03,083781,Rotar; Vladimir,5,0,34,29
1657965922440,MATH 193A,A04,083782,Rotar; Vladimir,12,0,34,22
1657965922440,MATH 193A,A05,093482,Rotar; Vladimir,11,0,34,23
1657965928470,MATH 197,001,091859,McAuley; Julian John,9999,0,9999,0
1657965928470,MATH 197,002,095566,Kedlaya; Kiran S.,9997,0,9999,2
1657965928470,MATH 197,003,095567,Xiao; Ming,9999,0,9999,0
1657965928470,MATH 197,004,095571,Perols; Johan Lars,9998,0,9999,1
1657965935555,COGS 9,A01,083615,Shannon; Kyle Michael,11,0,75,64
1657965941582,COGS 11,A01,083617,Boyle; Mary E. T.,23,0,48,25
1657965947607,COGS 13,A01,083071,Bastos; Amalia Pinkusfeld,12,0,71,59
1657965953641,COGS 14A,A01,092681,Semenuks; Arturs,5,1,100,95
1657965959664,COGS 14B,A01,083073,Cheng; Tzu-Han,7,0,63,56
1657965965725,COGS 17,A01,092677,Semenuks; Arturs,7,0,81,74
1657965971754,COGS 100,A01,083619,Allen; Michael Gordon,17,0,70,53
1657965977778,COGS 101A,A01,083621,Davis; Joshua Daniel,9,0,68,59
1657965983806,COGS 101B,A01,091572,Allen; Michael Gordon,14,0,65,51
1657965989847,COGS 101C,A01,083625,Delgado; Tania,17,0,35,18
1657965995874,COGS 107A,A01,083627,Boyle; Mary E. T.,14,0,60,46
1657966001898,COGS 118A,A01,083075,Gupta; Anjum,21,0,76,55
1657966007947,CSE 3,A50,083646,Miranda; Gregory Joseph,24,0,50,26
1657966013975,CSE 8A,A50,083650,Miranda; Gregory Joseph,17,1,56,39
1657966019999,CSE 11,A01,083080,Cao; Yingjun,7,15,40,33
1657966026024,CSE 12,A01,083652,Krause-Levy; Sophia Louisa,30,1,120,90
1657966032057,CSE 15L,A01,083654,Morris; Justin Loren,9,0,50,41
1657966032057,CSE 15L,A02,083655,Morris; Justin Loren,11,0,50,39
1657966038083,CSE 20,A01,083657,Tran; Khoa Dang,39,0,80,41
1657966044107,CSE 21,A01,095574,Bach; Quang Tran,23,0,48,25
1657966050141,CSE 30,A01,083084,Eldon; John,8,0,80,72
1657966050141,CSE 30,B01,095061,Bhaskar; Nishant,9,0,50,41
1657966056164,CSE 100,A01,083659,Cao; Yingjun,5,4,70,65
1657966062202,CSE 134B,A01,083661,Powell; Thomas Allan,25,0,100,75
1657966068247,CSE 140,A01,083663,Gungor; Onat,17,0,85,68
1657966074274,CSE 140L,A01,083088,Eldon; John,23,0,100,77
1657966080295,CSE 175,A01,083665,Kumar; Rakesh,3,0,25,22
1657966086319,CSE 190,A00,092507,Dubnov; Shlomo,8,0,20,12
1657966092345,ECE 45,A01,083139,Congero; Spencer William,7,0,75,68
1657966098379,ECE 65,A50,083695,Saad; Andrew S,12,0,30,18
1657966098379,ECE 65,A51,095125,Saad; Andrew S,24,0,26,2
1657966104424,ECE 109,A01,091882,Touri; Behrouz,21,0,70,49
1657966110445,ECE 180,A00,083140,Abi Samra; Nicholas Camill,1,0,30,29
1657966110445,ECE 180,B00,083141,Abi Samra; Nicholas Camill,0,0,30,30
1657966116484,MATH 10A,A01,083735,Patchell; Gregory David,2,0,30,28
1657966116484,MATH 10A,A02,083736,Patchell; Gregory David,20,0,30,10
1657966116484,MATH 10A,A03,083737,Patchell; Gregory David,16,0,30,14
1657966122521,MATH 10B,A01,083207,Lim; Seonhee,9,0,34,25
1657966122521,MATH 10B,A02,083208,Lim; Seonhee,10,0,35,25
1657966122521,MATH 10B,A03,093472,Lim; Seonhee,7,0,34,27
1657966122521,MATH 10B,B01,083739,Sinha; Shubham,14,0,30,16
1657966128548,MATH 18,A01,083743,Cinel; Cameron Alexander,9,0,30,21
1657966128548,MATH 18,A02,083744,Cinel; Cameron Alexander,18,0,30,12
1657966128548,MATH 18,A03,083745,Cinel; Cameron Alexander,10,0,30,20
1657966128548,MATH 18,B01,083748,Rideout; David Porter,5,0,37,32
1657966128548,MATH 18,B02,083749,Rideout; David Porter,5,0,36,31
1657966128548,MATH 18,B03,083750,Rideout; David Porter,3,0,37,34
1657966128548,MATH 18,B04,083751,Rideout; David Porter,7,0,36,29
1657966128548,MATH 18,B05,093473,Rideout; David Porter,7,0,36,29
1657966128548,MATH 18,B06,093474,Rideout; David Porter,6,0,36,30
1657966134571,MATH 20A,A01,083754,Zheng; Zequn,14,0,40,26
1657966140600,MATH 20B,A01,083756,Briones; Jor-el Thomas Caparas,4,0,36,32
1657966140600,MATH 20B,A02,083757,Briones; Jor-el Thomas Caparas,1,0,36,35
1657966140600,MATH 20B,A03,093475,Briones; Jor-el Thomas Caparas,3,0,36,33
1657966146630,MATH 20C,A01,083760,Briones; Jor-el Thomas Caparas,1,0,35,34
1657966146630,MATH 20C,A02,083761,Briones; Jor-el Thomas Caparas,8,0,35,27
1657966146630,MATH 20C,A03,093476,Briones; Jor-el Thomas Caparas,0,1,36,36
1657966146630,MATH 20C,B01,083762,Bach; Quang Tran,1,0,30,29
1657966152655,MATH 20D,A01,083765,Tran; Brian Kha,5,0,30,25
1657966152655,MATH 20D,A02,083766,Tran; Brian Kha,5,0,30,25
1657966152655,MATH 20D,A03,083767,Tran; Brian Kha,6,0,30,24
1657966158692,MATH 20E,A01,083771,Ganguly; Soumya,12,0,32,20
1657966158692,MATH 20E,A02,083772,Ganguly; Soumya,7,0,32,25
1657966158692,MATH 20E,B01,083773,Ciotti; Benjamin,20,0,35,15
1657966158692,MATH 20E,B02,083774,Ciotti; Benjamin,18,0,35,17
1657966164724,MATH 103A,A01,083777,Greenfeld; Be'Eri,6,0,36,30
1657966164724,MATH 103A,A02,083778,Greenfeld; Be'Eri,5,0,36,31
1657966164724,MATH 103A,A03,093561,Greenfeld; Be'Eri,7,0,36,29
1657966164724,MATH 103A,B01,083779,Greenfeld; Be'Eri,8,0,36,28
1657966164724,MATH 103A,B02,083780,Greenfeld; Be'Eri,4,0,36,32
1657966164724,MATH 103A,B03,093562,Greenfeld; Be'Eri,3,0,36,33
1657966170751,MATH 105,A01,085443,Carter; Anne Toulson,15,0,35,20
1657966170751,MATH 105,A02,093477,Carter; Anne Toulson,20,0,35,15
1657966176780,MATH 109,A01,083213,Ganzberger; Geoffrey Michael,3,0,34,31
1657966176780,MATH 109,A02,083214,Ganzberger; Geoffrey Michael,4,0,34,30
1657966176780,MATH 109,A03,093478,Ganzberger; Geoffrey Michael,2,0,34,32
1657966176780,MATH 109,B01,083215,Ganzberger; Geoffrey Michael,3,0,32,29
1657966176780,MATH 109,B02,083216,Ganzberger; Geoffrey Michael,3,0,32,29
1657966176780,MATH 109,B03,093479,Ganzberger; Geoffrey Michael,8,0,32,24
1657966182808,MATH 142A,A01,083219,Chow; Bennett,7,0,32,25
1657966182808,MATH 142A,A02,083220,Chow; Bennett,10,0,32,22
1657966182808,MATH 142A,A03,093480,Chow; Bennett,9,0,32,23
1657966182808,MATH 142A,B03,093481,Chow; Bennett,8,0,32,24
1657966182808,MATH 142A,B04,093558,Chow; Bennett,14,0,32,18
1657966182808,MATH 142A,B05,093559,Chow; Bennett,7,0,32,25
1657966188833,MATH 193A,A01,083224,Rotar; Vladimir,9,0,34,25
1657966188833,MATH 193A,A02,083225,Rotar; Vladimir,11,0,34,23
1657966188833,MATH 193A,A03,083781,Rotar; Vladimir,5,0,34,29
1657966188833,MATH 193A,A04,083782,Rotar; Vladimir,12,0,34,22
1657966188833,MATH 193A,A05,093482,Rotar; Vladimir,11,0,34,23
1657966194859,MATH 197,001,091859,McAuley; Julian John,9999,0,9999,0
1657966194859,MATH 197,002,095566,Kedlaya; Kiran S.,9997,0,9999,2
1657966194859,MATH 197,003,095567,Xiao; Ming,9999,0,9999,0
1657966194859,MATH 197,004,095571,Perols; Johan Lars,9998,0,9999,1
1657966201922,COGS 9,A01,083615,Shannon; Kyle Michael,11,0,75,64
1657966207945,COGS 11,A01,083617,Boyle; Mary E. T.,23,0,48,25
1657966213969,COGS 13,A01,083071,Bastos; Amalia Pinkusfeld,12,0,71,59
1657966219995,COGS 14A,A01,092681,Semenuks; Arturs,5,1,100,95
1657966226021,COGS 14B,A01,083073,Cheng; Tzu-Han,7,0,63,56
1657966232043,COGS 17,A01,092677,Semenuks; Arturs,7,0,81,74
1657966238070,COGS 100,A01,083619,Allen; Michael Gordon,17,0,70,53
1657966244094,COGS 101A,A01,083621,Davis; Joshua Daniel,9,0,68,59
1657966250117,COGS 101B,A01,091572,Allen; Michael Gordon,14,0,65,51
1657966256146,COGS 101C,A01,083625,Delgado; Tania,17,0,35,18
1657966262174,COGS 107A,A01,083627,Boyle; Mary E. T.,14,0,60,46
1657966268197,COGS 118A,A01,083075,Gupta; Anjum,21,0,76,55
1657966274223,CSE 3,A50,083646,Miranda; Gregory Joseph,24,0,50,26
1657966280250,CSE 8A,A50,083650,Miranda; Gregory Joseph,17,1,56,39
1657966286273,CSE 11,A01,083080,Cao; Yingjun,7,15,40,33
1657966292313,CSE 12,A01,083652,Krause-Levy; Sophia Louisa,30,1,120,90
1657966298335,CSE 15L,A01,083654,Morris; Justin Loren,9,0,50,41
1657966298335,CSE 15L,A02,083655,Morris; Justin Loren,11,0,50,39
1657966304359,CSE 20,A01,083657,Tran; Khoa Dang,39,0,80,41
1657966310493,CSE 21,A01,095574,Bach; Quang Tran,23,0,48,25
1657966316522,CSE 30,A01,083084,Eldon; John,8,0,80,72
1657966316522,CSE 30,B01,095061,Bhaskar; Nishant,9,0,50,41
1657966322545,CSE 100,A01,083659,Cao; Yingjun,5,4,70,65
1657966328581,CSE 134B,A01,083661,Powell; Thomas Allan,25,0,100,75
1657966334605,CSE 140,A01,083663,Gungor; Onat,17,0,85,68
1657966340629,CSE 140L,A01,083088,Eldon; John,23,0,100,77
1657966346656,CSE 175,A01,083665,Kumar; Rakesh,3,0,25,22
1657966352686,CSE 190,A00,092507,Dubnov; Shlomo,8,0,20,12
1657966358721,ECE 45,A01,083139,Congero; Spencer William,7,0,75,68
1657966364745,ECE 65,A50,083695,Saad; Andrew S,12,0,30,18
1657966364745,ECE 65,A51,095125,Saad; Andrew S,24,0,26,2
1657966370773,ECE 109,A01,091882,Touri; Behrouz,21,0,70,49
1657966376817,ECE 180,A00,083140,Abi Samra; Nicholas Camill,1,0,30,29
1657966376817,ECE 180,B00,083141,Abi Samra; Nicholas Camill,0,0,30,30
1657966382841,MATH 10A,A01,083735,Patchell; Gregory David,2,0,30,28
1657966382841,MATH 10A,A02,083736,Patchell; Gregory David,20,0,30,10
1657966382841,MATH 10A,A03,083737,Patchell; Gregory David,16,0,30,14
1657966388866,MATH 10B,A01,083207,Lim; Seonhee,9,0,34,25
1657966388866,MATH 10B,A02,083208,Lim; Seonhee,10,0,35,25
1657966388866,MATH 10B,A03,093472,Lim; Seonhee,7,0,34,27
1657966388866,MATH 10B,B01,083739,Sinha; Shubham,14,0,30,16
1657966394895,MATH 18,A01,083743,Cinel; Cameron Alexander,9,0,30,21
1657966394895,MATH 18,A02,083744,Cinel; Cameron Alexander,18,0,30,12
1657966394895,MATH 18,A03,083745,Cinel; Cameron Alexander,10,0,30,20
1657966394895,MATH 18,B01,083748,Rideout; David Porter,5,0,37,32
1657966394895,MATH 18,B02,083749,Rideout; David Porter,5,0,36,31
1657966394895,MATH 18,B03,083750,Rideout; David Porter,3,0,37,34
1657966394895,MATH 18,B04,083751,Rideout; David Porter,7,0,36,29
1657966394895,MATH 18,B05,093473,Rideout; David Porter,7,0,36,29
1657966394895,MATH 18,B06,093474,Rideout; David Porter,6,0,36,30
1657966400922,MATH 20A,A01,083754,Zheng; Zequn,14,0,40,26
1657966406950,MATH 20B,A01,083756,Briones; Jor-el Thomas Caparas,4,0,36,32
1657966406950,MATH 20B,A02,083757,Briones; Jor-el Thomas Caparas,1,0,36,35
1657966406950,MATH 20B,A03,093475,Briones; Jor-el Thomas Caparas,3,0,36,33
1657966412974,MATH 20C,A01,083760,Briones; Jor-el Thomas Caparas,1,0,35,34
1657966412974,MATH 20C,A02,083761,Briones; Jor-el Thomas Caparas,8,0,35,27
1657966412974,MATH 20C,A03,093476,Briones; Jor-el Thomas Caparas,0,1,36,36
1657966412974,MATH 20C,B01,083762,Bach; Quang Tran,1,0,30,29
1657966419023,MATH 20D,A01,083765,Tran; Brian Kha,5,0,30,25
1657966419023,MATH 20D,A02,083766,Tran; Brian Kha,5,0,30,25
1657966419023,MATH 20D,A03,083767,Tran; Brian Kha,6,0,30,24
1657966425047,MATH 20E,A01,083771,Ganguly; Soumya,12,0,32,20
1657966425047,MATH 20E,A02,083772,Ganguly; Soumya,7,0,32,25
1657966425047,MATH 20E,B01,083773,Ciotti; Benjamin,20,0,35,15
1657966425047,MATH 20E,B02,083774,Ciotti; Benjamin,18,0,35,17
1657966431090,MATH 103A,A01,083777,Greenfeld; Be'Eri,6,0,36,30
1657966431090,MATH 103A,A02,083778,Greenfeld; Be'Eri,5,0,36,31
1657966431090,MATH 103A,A03,093561,Greenfeld; Be'Eri,7,0,36,29
1657966431090,MATH 103A,B01,083779,Greenfeld; Be'Eri,8,0,36,28
1657966431090,MATH 103A,B02,083780,Greenfeld; Be'Eri,4,0,36,32
1657966431090,MATH 103A,B03,093562,Greenfeld; Be'Eri,3,0,36,33
1657966437123,MATH 105,A01,085443,Carter; Anne Toulson,15,0,35,20
1657966437123,MATH 105,A02,093477,Carter; Anne Toulson,20,0,35,15
1657966443150,MATH 109,A01,083213,Ganzberger; Geoffrey Michael,3,0,34,31
1657966443150,MATH 109,A02,083214,Ganzberger; Geoffrey Michael,4,0,34,30
1657966443150,MATH 109,A03,093478,Ganzberger; Geoffrey Michael,2,0,34,32
1657966443150,MATH 109,B01,083215,Ganzberger; Geoffrey Michael,3,0,32,29
1657966443150,MATH 109,B02,083216,Ganzberger; Geoffrey Michael,3,0,32,29
1657966443150,MATH 109,B03,093479,Ganzberger; Geoffrey Michael,8,0,32,24
1657966449177,MATH 142A,A01,083219,Chow; Bennett,7,0,32,25
1657966449177,MATH 142A,A02,083220,Chow; Bennett,10,0,32,22
1657966449177,MATH 142A,A03,093480,Chow; Bennett,9,0,32,23
1657966449177,MATH 142A,B03,093481,Chow; Bennett,8,0,32,24
1657966449177,MATH 142A,B04,093558,Chow; Bennett,14,0,32,18
1657966449177,MATH 142A,B05,093559,Chow; Bennett,7,0,32,25
1657966455204,MATH 193A,A01,083224,Rotar; Vladimir,9,0,34,25
1657966455204,MATH 193A,A02,083225,Rotar; Vladimir,11,0,34,23
1657966455204,MATH 193A,A03,083781,Rotar; Vladimir,5,0,34,29
1657966455204,MATH 193A,A04,083782,Rotar; Vladimir,12,0,34,22
1657966455204,MATH 193A,A05,093482,Rotar; Vladimir,11,0,34,23
1657966461226,MATH 197,001,091859,McAuley; Julian John,9999,0,9999,0
1657966461226,MATH 197,002,095566,Kedlaya; Kiran S.,9997,0,9999,2
1657966461226,MATH 197,003,095567,Xiao; Ming,9999,0,9999,0
1657966461226,MATH 197,004,095571,Perols; Johan Lars,9998,0,9999,1
1657966468296,COGS 9,A01,083615,Shannon; Kyle Michael,11,0,75,64
1657966474318,COGS 11,A01,083617,Boyle; Mary E. T.,23,0,48,25
1657966480378,COGS 13,A01,083071,Bastos; Amalia Pinkusfeld,12,0,71,59
1657966486406,COGS 14A,A01,092681,Semenuks; Arturs,5,1,100,95
1657966492428,COGS 14B,A01,083073,Cheng; Tzu-Han,7,0,63,56
1657966498451,COGS 17,A01,092677,Semenuks; Arturs,7,0,81,74
1657966504475,COGS 100,A01,083619,Allen; Michael Gordon,17,0,70,53
1657966510503,COGS 101A,A01,083621,Davis; Joshua Daniel,9,0,68,59
1657966516530,COGS 101B,A01,091572,Allen; Michael Gordon,14,0,65,51
1657966522552,COGS 101C,A01,083625,Delgado; Tania,17,0,35,18
1657966528574,COGS 107A,A01,083627,Boyle; Mary E. T.,14,0,60,46
1657966534600,COGS 118A,A01,083075,Gupta; Anjum,21,0,76,55
1657966540628,CSE 3,A50,083646,Miranda; Gregory Joseph,24,0,50,26
1657966546662,CSE 8A,A50,083650,Miranda; Gregory Joseph,17,1,56,39
1657966552696,CSE 11,A01,083080,Cao; Yingjun,7,15,40,33
1657966558717,CSE 12,A01,083652,Krause-Levy; Sophia Louisa,30,1,120,90
1657966564766,CSE 15L,A01,083654,Morris; Justin Loren,9,0,50,41
1657966564766,CSE 15L,A02,083655,Morris; Justin Loren,11,0,50,39
1657966570794,CSE 20,A01,083657,Tran; Khoa Dang,39,0,80,41
1657966576825,CSE 21,A01,095574,Bach; Quang Tran,23,0,48,25
1657966582848,CSE 30,A01,083084,Eldon; John,8,0,80,72
1657966582848,CSE 30,B01,095061,Bhaskar; Nishant,9,0,50,41
1657966588871,CSE 100,A01,083659,Cao; Yingjun,5,4,70,65
1657966594893,CSE 134B,A01,083661,Powell; Thomas Allan,25,0,100,75
1657966600919,CSE 140,A01,083663,Gungor; Onat,17,0,85,68
1657966606942,CSE 140L,A01,083088,Eldon; John,23,0,100,77
1657966612980,CSE 175,A01,083665,Kumar; Rakesh,3,0,25,22
1657966619006,CSE 190,A00,092507,Dubnov; Shlomo,8,0,20,12
1657966625033,ECE 45,A01,083139,Congero; Spencer William,7,0,75,68
1657966631061,ECE 65,A50,083695,Saad; Andrew S,12,0,30,18
1657966631061,ECE 65,A51,095125,Saad; Andrew S,24,0,26,2
1657966637083,ECE 109,A01,091882,Touri; Behrouz,21,0,70,49
1657966643111,ECE 180,A00,083140,Abi Samra; Nicholas Camill,1,0,30,29
1657966643111,ECE 180,B00,083141,Abi Samra; Nicholas Camill,0,0,30,30
1657966649138,MATH 10A,A01,083735,Patchell; Gregory David,2,0,30,28
1657966649138,MATH 10A,A02,083736,Patchell; Gregory David,20,0,30,10
1657966649138,MATH 10A,A03,083737,Patchell; Gregory David,16,0,30,14
1657966655200,MATH 10B,A01,083207,Lim; Seonhee,9,0,34,25
1657966655200,MATH 10B,A02,083208,Lim; Seonhee,10,0,35,25
1657966655200,MATH 10B,A03,093472,Lim; Seonhee,7,0,34,27
1657966655200,MATH 10B,B01,083739,Sinha; Shubham,14,0,30,16
1657966661233,MATH 18,A01,083743,Cinel; Cameron Alexander,9,0,30,21
1657966661233,MATH 18,A02,083744,Cinel; Cameron Alexander,18,0,30,12
1657966661233,MATH 18,A03,083745,Cinel; Cameron Alexander,10,0,30,20
1657966661233,MATH 18,B01,083748,Rideout; David Porter,5,0,37,32
1657966661233,MATH 18,B02,083749,Rideout; David Porter,5,0,36,31
1657966661233,MATH 18,B03,083750,Rideout; David Porter,3,0,37,34
1657966661233,MATH 18,B04,083751,Rideout; David Porter,7,0,36,29
1657966661233,MATH 18,B05,093473,Rideout; David Porter,7,0,36,29
1657966661233,MATH 18,B06,093474,Rideout; David Porter,6,0,36,30
1657966667259,MATH 20A,A01,083754,Zheng; Zequn,14,0,40,26
1657966673282,MATH 20B,A01,083756,Briones; Jor-el Thomas Caparas,4,0,36,32
1657966673282,MATH 20B,A02,083757,Briones; Jor-el Thomas Caparas,1,0,36,35
1657966673282,MATH 20B,A03,093475,Briones; Jor-el Thomas Caparas,3,0,36,33
1657966679317,MATH 20C,A01,083760,Briones; Jor-el Thomas Caparas,1,0,35,34
1657966679317,MATH 20C,A02,083761,Briones; Jor-el Thomas Caparas,8,0,35,27
1657966679317,MATH 20C,A03,093476,Briones; Jor-el Thomas Caparas,0,1,36,36
1657966679317,MATH 20C,B01,083762,Bach; Quang Tran,1,0,30,29
1657966685339,MATH 20D,A01,083765,Tran; Brian Kha,5,0,30,25
1657966685339,MATH 20D,A02,083766,Tran; Brian Kha,5,0,30,25
1657966685339,MATH 20D,A03,083767,Tran; Brian Kha,6,0,30,24
1657966691361,MATH 20E,A01,083771,Ganguly; Soumya,12,0,32,20
1657966691361,MATH 20E,A02,083772,Ganguly; Soumya,7,0,32,25
1657966691361,MATH 20E,B01,083773,Ciotti; Benjamin,20,0,35,15
1657966691361,MATH 20E,B02,083774,Ciotti; Benjamin,18,0,35,17
1657966697382,MATH 103A,A01,083777,Greenfeld; Be'Eri,6,0,36,30
1657966697382,MATH 103A,A02,083778,Greenfeld; Be'Eri,5,0,36,31
1657966697382,MATH 103A,A03,093561,Greenfeld; Be'Eri,7,0,36,29
1657966697382,MATH 103A,B01,083779,Greenfeld; Be'Eri,8,0,36,28
1657966697382,MATH 103A,B02,083780,Greenfeld; Be'Eri,4,0,36,32
1657966697382,MATH 103A,B03,093562,Greenfeld; Be'Eri,3,0,36,33
1657966703404,MATH 105,A01,085443,Carter; Anne Toulson,15,0,35,20
1657966703404,MATH 105,A02,093477,Carter; Anne Toulson,20,0,35,15
1657966709434,MATH 109,A01,083213,Ganzberger; Geoffrey Michael,3,0,34,31
1657966709434,MATH 109,A02,083214,Ganzberger; Geoffrey Michael,4,0,34,30
1657966709434,MATH 109,A03,093478,Ganzberger; Geoffrey Michael,2,0,34,32
1657966709434,MATH 109,B01,083215,Ganzberger; Geoffrey Michael,3,0,32,29
1657966709434,MATH 109,B02,083216,Ganzberger; Geoffrey Michael,3,0,32,29
1657966709434,MATH 109,B03,093479,Ganzberger; Geoffrey Michael,8,0,32,24
1657966715461,MATH 142A,A01,083219,Chow; Bennett,7,0,32,25
1657966715461,MATH 142A,A02,083220,Chow; Bennett,10,0,32,22
1657966715461,MATH 142A,A03,093480,Chow; Bennett,9,0,32,23
1657966715461,MATH 142A,B03,093481,Chow; Bennett,8,0,32,24
1657966715461,MATH 142A,B04,093558,Chow; Bennett,14,0,32,18
1657966715461,MATH 142A,B05,093559,Chow; Bennett,7,0,32,25
1657966721485,MATH 193A,A01,083224,Rotar; Vladimir,9,0,34,25
1657966721485,MATH 193A,A02,083225,Rotar; Vladimir,11,0,34,23
1657966721485,MATH 193A,A03,083781,Rotar; Vladimir,5,0,34,29
1657966721485,MATH 193A,A04,083782,Rotar; Vladimir,12,0,34,22
1657966721485,MATH 193A,A05,093482,Rotar; Vladimir,11,0,34,23
1657966727511,MATH 197,001,091859,McAuley; Julian John,9999,0,9999,0
1657966727511,MATH 197,002,095566,Kedlaya; Kiran S.,9997,0,9999,2
1657966727511,MATH 197,003,095567,Xiao; Ming,9999,0,9999,0
1657966727511,MATH 197,004,095571,Perols; Johan Lars,9998,0,9999,1
1657966734575,COGS 9,A01,083615,Shannon; Kyle Michael,11,0,75,64
1657966740603,COGS 11,A01,083617,Boyle; Mary E. T.,23,0,48,25
1657966746626,COGS 13,A01,083071,Bastos; Amalia Pinkusfeld,12,0,71,59
1657966752653,COGS 14A,A01,092681,Semenuks; Arturs,5,1,100,95
1657966758689,COGS 14B,A01,083073,Cheng; Tzu-Han,7,0,63,56
1657966764712,COGS 17,A01,092677,Semenuks; Arturs,7,0,81,74
1657966770739,COGS 100,A01,083619,Allen; Michael Gordon,17,0,70,53
1657966776766,COGS 101A,A01,083621,Davis; Joshua Daniel,9,0,68,59
1657966782791,COGS 101B,A01,091572,Allen; Michael Gordon,14,0,65,51
1657966788813,COGS 101C,A01,083625,Delgado; Tania,17,0,35,18
1657966794838,COGS 107A,A01,083627,Boyle; Mary E. T.,14,0,60,46
1657966800864,COGS 118A,A01,083075,Gupta; Anjum,21,0,76,55
1657966806892,CSE 3,A50,083646,Miranda; Gregory Joseph,24,0,50,26
1657966812925,CSE 8A,A50,083650,Miranda; Gregory Joseph,17,1,56,39
1657966818952,CSE 11,A01,083080,Cao; Yingjun,7,15,40,33
1657966824974,CSE 12,A01,083652,Krause-Levy; Sophia Louisa,30,1,120,90
1657966831011,CSE 15L,A01,083654,Morris; Justin Loren,9,0,50,41
1657966831011,CSE 15L,A02,083655,Morris; Justin Loren,11,0,50,39
1657966837045,CSE 20,A01,083657,Tran; Khoa Dang,39,0,80,41
1657966843068,CSE 21,A01,095574,Bach; Quang Tran,23,0,48,25
1657966849108,CSE 30,A01,083084,Eldon; John,8,0,80,72
1657966849108,CSE 30,B01,095061,Bhaskar; Nishant,9,0,50,41
1657966855135,CSE 100,A01,083659,Cao; Yingjun,5,4,70,65
1657966861157,CSE 134B,A01,083661,Powell; Thomas Allan,25,0,100,75
1657966867184,CSE 140,A01,083663,Gungor; Onat,17,0,85,68
1657966873205,CSE 140L,A01,083088,Eldon; John,23,0,100,77
1657966879243,CSE 175,A01,083665,Kumar; Rakesh,3,0,25,22
1657966885268,CSE 190,A00,092507,Dubnov; Shlomo,8,0,20,12
1657966891295,ECE 45,A01,083139,Congero; Spencer William,7,0,75,68
1657966897330,ECE 65,A50,083695,Saad; Andrew S,12,0,30,18
1657966897330,ECE 65,A51,095125,Saad; Andrew S,24,0,26,2
1657966903354,ECE 109,A01,091882,Touri; Behrouz,21,0,70,49
1657966909470,ECE 180,A00,083140,Abi Samra; Nicholas Camill,1,0,30,29
1657966909470,ECE 180,B00,083141,Abi Samra; Nicholas Camill,0,0,30,30
1657966915501,MATH 10A,A01,083735,Patchell; Gregory David,2,0,30,28
1657966915501,MATH 10A,A02,083736,Patchell; Gregory David,20,0,30,10
1657966915501,MATH 10A,A03,083737,Patchell; Gregory David,16,0,30,14
1657966921524,MATH 10B,A01,083207,Lim; Seonhee,9,0,34,25
1657966921524,MATH 10B,A02,083208,Lim; Seonhee,10,0,35,25
1657966921524,MATH 10B,A03,093472,Lim; Seonhee,7,0,34,27
1657966921524,MATH 10B,B01,083739,Sinha; Shubham,14,0,30,16
1657966927560,MATH 18,A01,083743,Cinel; Cameron Alexander,9,0,30,21
1657966927560,MATH 18,A02,083744,Cinel; Cameron Alexander,18,0,30,12
1657966927560,MATH 18,A03,083745,Cinel; Cameron Alexander,10,0,30,20
1657966927560,MATH 18,B01,083748,Rideout; David Porter,5,0,37,32
1657966927560,MATH 18,B02,083749,Rideout; David Porter,5,0,36,31
1657966927560,MATH 18,B03,083750,Rideout; David Porter,3,0,37,34
1657966927560,MATH 18,B04,083751,Rideout; David Porter,7,0,36,29
1657966927560,MATH 18,B05,093473,Rideout; David Porter,7,0,36,29
1657966927560,MATH 18,B06,093474,Rideout; David Porter,6,0,36,30
1657966933584,MATH 20A,A01,083754,Zheng; Zequn,14,0,40,26
1657966939631,MATH 20B,A01,083756,Briones; Jor-el Thomas Caparas,4,0,36,32
1657966939631,MATH 20B,A02,083757,Briones; Jor-el Thomas Caparas,1,0,36,35
1657966939631,MATH 20B,A03,093475,Briones; Jor-el Thomas Caparas,3,0,36,33
1657966945659,MATH 20C,A01,083760,Briones; Jor-el Thomas Caparas,1,0,35,34
1657966945659,MATH 20C,A02,083761,Briones; Jor-el Thomas Caparas,8,0,35,27
1657966945659,MATH 20C,A03,093476,Briones; Jor-el Thomas Caparas,0,1,36,36
1657966945659,MATH 20C,B01,083762,Bach; Quang Tran,1,0,30,29
1657966951686,MATH 20D,A01,083765,Tran; Brian Kha,5,0,30,25
1657966951686,MATH 20D,A02,083766,Tran; Brian Kha,5,0,30,25
1657966951686,MATH 20D,A03,083767,Tran; Brian Kha,6,0,30,24
1657966957712,MATH 20E,A01,083771,Ganguly; Soumya,12,0,32,20
1657966957712,MATH 20E,A02,083772,Ganguly; Soumya,7,0,32,25
1657966957712,MATH 20E,B01,083773,Ciotti; Benjamin,20,0,35,15
1657966957712,MATH 20E,B02,083774,Ciotti; Benjamin,18,0,35,17
1657966963735,MATH 103A,A01,083777,Greenfeld; Be'Eri,6,0,36,30
1657966963735,MATH 103A,A02,083778,Greenfeld; Be'Eri,5,0,36,31
1657966963735,MATH 103A,A03,093561,Greenfeld; Be'Eri,7,0,36,29
1657966963735,MATH 103A,B01,083779,Greenfeld; Be'Eri,8,0,36,28
1657966963735,MATH 103A,B02,083780,Greenfeld; Be'Eri,4,0,36,32
1657966963735,MATH 103A,B03,093562,Greenfeld; Be'Eri,3,0,36,33
1657966969760,MATH 105,A01,085443,Carter; Anne Toulson,15,0,35,20
1657966969760,MATH 105,A02,093477,Carter; Anne Toulson,20,0,35,15
1657966975797,MATH 109,A01,083213,Ganzberger; Geoffrey Michael,3,0,34,31
1657966975797,MATH 109,A02,083214,Ganzberger; Geoffrey Michael,4,0,34,30
1657966975797,MATH 109,A03,093478,Ganzberger; Geoffrey Michael,2,0,34,32
1657966975797,MATH 109,B01,083215,Ganzberger; Geoffrey Michael,3,0,32,29
1657966975797,MATH 109,B02,083216,Ganzberger; Geoffrey Michael,3,0,32,29
1657966975797,MATH 109,B03,093479,Ganzberger; Geoffrey Michael,8,0,32,24
1657966981820,MATH 142A,A01,083219,Chow; Bennett,7,0,32,25
1657966981820,MATH 142A,A02,083220,Chow; Bennett,10,0,32,22
1657966981820,MATH 142A,A03,093480,Chow; Bennett,9,0,32,23
1657966981820,MATH 142A,B03,093481,Chow; Bennett,8,0,32,24
1657966981820,MATH 142A,B04,093558,Chow; Bennett,14,0,32,18
1657966981820,MATH 142A,B05,093559,Chow; Bennett,7,0,32,25
1657966987842,MATH 193A,A01,083224,Rotar; Vladimir,9,0,34,25
1657966987842,MATH 193A,A02,083225,Rotar; Vladimir,11,0,34,23
1657966987842,MATH 193A,A03,083781,Rotar; Vladimir,5,0,34,29
1657966987842,MATH 193A,A04,083782,Rotar; Vladimir,12,0,34,22
1657966987842,MATH 193A,A05,093482,Rotar; Vladimir,11,0,34,23
1657966993863,MATH 197,001,091859,McAuley; Julian John,9999,0,9999,0
1657966993863,MATH 197,002,095566,Kedlaya; Kiran S.,9997,0,9999,2
1657966993863,MATH 197,003,095567,Xiao; Ming,9999,0,9999,0
1657966993863,MATH 197,004,095571,Perols; Johan Lars,9998,0,9999,1
1657967000927,COGS 9,A01,083615,Shannon; Kyle Michael,11,0,75,64
1657967006949,COGS 11,A01,083617,Boyle; Mary E. T.,23,0,48,25
1657967012971,COGS 13,A01,083071,Bastos; Amalia Pinkusfeld,12,0,71,59
1657967018994,COGS 14A,A01,092681,Semenuks; Arturs,5,1,100,95
1657967025020,COGS 14B,A01,083073,Cheng; Tzu-Han,7,0,63,56
1657967031046,COGS 17,A01,092677,Semenuks; Arturs,7,0,81,74
1657967037068,COGS 100,A01,083619,Allen; Michael Gordon,17,0,70,53
1657967043093,COGS 101A,A01,083621,Davis; Joshua Daniel,9,0,68,59
1657967049119,COGS 101B,A01,091572,Allen; Michael Gordon,14,0,65,51
1657967055142,COGS 101C,A01,083625,Delgado; Tania,17,0,35,18
1657967061165,COGS 107A,A01,083627,Boyle; Mary E. T.,14,0,60,46
1657967067189,COGS 118A,A01,083075,Gupta; Anjum,21,0,76,55
1657967073212,CSE 3,A50,083646,Miranda; Gregory Joseph,24,0,50,26
1657967079252,CSE 8A,A50,083650,Miranda; Gregory Joseph,17,1,56,39
1657967085276,CSE 11,A01,083080,Cao; Yingjun,7,15,40,33
1657967091299,CSE 12,A01,083652,Krause-Levy; Sophia Louisa,30,1,120,90
1657967097322,CSE 15L,A01,083654,Morris; Justin Loren,9,0,50,41
1657967097322,CSE 15L,A02,083655,Morris; Justin Loren,11,0,50,39
1657967103370,CSE 20,A01,083657,Tran; Khoa Dang,39,0,80,41
1657967109395,CSE 21,A01,095574,Bach; Quang Tran,23,0,48,25
1657967115417,CSE 30,A01,083084,Eldon; John,8,0,80,72
1657967115417,CSE 30,B01,095061,Bhaskar; Nishant,9,0,50,41
1657967121440,CSE 100,A01,083659,Cao; Yingjun,5,4,70,65
1657967127465,CSE 134B,A01,083661,Powell; Thomas Allan,25,0,100,75
1657967133487,CSE 140,A01,083663,Gungor; Onat,17,0,85,68
1657967139509,CSE 140L,A01,083088,Eldon; John,23,0,100,77
1657967145536,CSE 175,A01,083665,Kumar; Rakesh,3,0,25,22
1657967151557,CSE 190,A00,092507,Dubnov; Shlomo,8,0,20,12
1657967157589,ECE 45,A01,083139,Congero; Spencer William,7,0,75,68
1657967163624,ECE 65,A50,083695,Saad; Andrew S,12,0,30,18
1657967163624,ECE 65,A51,095125,Saad; Andrew S,24,0,26,2
1657967169648,ECE 109,A01,091882,Touri; Behrouz,21,0,70,49
1657967175684,ECE 180,A00,083140,Abi Samra; Nicholas Camill,1,0,30,29
1657967175684,ECE 180,B00,083141,Abi Samra; Nicholas Camill,0,0,30,30
1657967181712,MATH 10A,A01,083735,Patchell; Gregory David,2,0,30,28
1657967181712,MATH 10A,A02,083736,Patchell; Gregory David,20,0,30,10
1657967181712,MATH 10A,A03,083737,Patchell; Gregory David,16,0,30,14
1657967187741,MATH 10B,A01,083207,Lim; Seonhee,9,0,34,25
1657967187741,MATH 10B,A02,083208,Lim; Seonhee,10,0,35,25
1657967187741,MATH 10B,A03,093472,Lim; Seonhee,7,0,34,27
1657967187741,MATH 10B,B01,083739,Sinha; Shubham,14,0,30,16
1657967193773,MATH 18,A01,083743,Cinel; Cameron Alexander,9,0,30,21
1657967193773,MATH 18,A02,083744,Cinel; Cameron Alexander,18,0,30,12
1657967193773,MATH 18,A03,083745,Cinel; Cameron Alexander,10,0,30,20
1657967193773,MATH 18,B01,083748,Rideout; David Porter,5,0,37,32
1657967193773,MATH 18,B02,083749,Rideout; David Porter,5,0,36,31
1657967193773,MATH 18,B03,083750,Rideout; David Porter,3,0,37,34
1657967193773,MATH 18,B04,083751,Rideout; David Porter,7,0,36,29
1657967193773,MATH 18,B05,093473,Rideout; David Porter,7,0,36,29
1657967193773,MATH 18,B06,093474,Rideout; David Porter,6,0,36,30
1657967199797,MATH 20A,A01,083754,Zheng; Zequn,14,0,40,26
1657967205821,MATH 20B,A01,083756,Briones; Jor-el Thomas Caparas,4,0,36,32
1657967205821,MATH 20B,A02,083757,Briones; Jor-el Thomas Caparas,1,0,36,35
1657967205821,MATH 20B,A03,093475,Briones; Jor-el Thomas Caparas,3,0,36,33
1657967211845,MATH 20C,A01,083760,Briones; Jor-el Thomas Caparas,1,0,35,34
1657967211845,MATH 20C,A02,083761,Briones; Jor-el Thomas Caparas,8,0,35,27
1657967211845,MATH 20C,A03,093476,Briones; Jor-el Thomas Caparas,0,1,36,36
1657967211845,MATH 20C,B01,083762,Bach; Quang Tran,1,0,30,29
1657967217873,MATH 20D,A01,083765,Tran; Brian Kha,5,0,30,25
1657967217873,MATH 20D,A02,083766,Tran; Brian Kha,5,0,30,25
1657967217873,MATH 20D,A03,083767,Tran; Brian Kha,6,0,30,24
1657967223896,MATH 20E,A01,083771,Ganguly; Soumya,12,0,32,20
1657967223896,MATH 20E,A02,083772,Ganguly; Soumya,7,0,32,25
1657967223896,MATH 20E,B01,083773,Ciotti; Benjamin,20,0,35,15
1657967223896,MATH 20E,B02,083774,Ciotti; Benjamin,18,0,35,17
1657967229924,MATH 103A,A01,083777,Greenfeld; Be'Eri,6,0,36,30
1657967229924,MATH 103A,A02,083778,Greenfeld; Be'Eri,5,0,36,31
1657967229924,MATH 103A,A03,093561,Greenfeld; Be'Eri,7,0,36,29
1657967229924,MATH 103A,B01,083779,Greenfeld; Be'Eri,8,0,36,28
1657967229924,MATH 103A,B02,083780,Greenfeld; Be'Eri,4,0,36,32
1657967229924,MATH 103A,B03,093562,Greenfeld; Be'Eri,3,0,36,33
1657967235954,MATH 105,A01,085443,Carter; Anne Toulson,15,0,35,20
1657967235954,MATH 105,A02,093477,Carter; Anne Toulson,20,0,35,15
1657967241990,MATH 109,A01,083213,Ganzberger; Geoffrey Michael,3,0,34,31
1657967241990,MATH 109,A02,083214,Ganzberger; Geoffrey Michael,4,0,34,30
1657967241990,MATH 109,A03,093478,Ganzberger; Geoffrey Michael,2,0,34,32
1657967241990,MATH 109,B01,083215,Ganzberger; Geoffrey Michael,3,0,32,29
1657967241990,MATH 109,B02,083216,Ganzberger; Geoffrey Michael,3,0,32,29
1657967241990,MATH 109,B03,093479,Ganzberger; Geoffrey Michael,8,0,32,24
1657967248015,MATH 142A,A01,083219,Chow; Bennett,7,0,32,25
1657967248015,MATH 142A,A02,083220,Chow; Bennett,10,0,32,22
1657967248015,MATH 142A,A03,093480,Chow; Bennett,9,0,32,23
1657967248015,MATH 142A,B03,093481,Chow; Bennett,8,0,32,24
1657967248015,MATH 142A,B04,093558,Chow; Bennett,14,0,32,18
1657967248015,MATH 142A,B05,093559,Chow; Bennett,7,0,32,25
1657967254043,MATH 193A,A01,083224,Rotar; Vladimir,9,0,34,25
1657967254043,MATH 193A,A02,083225,Rotar; Vladimir,11,0,34,23
1657967254043,MATH 193A,A03,083781,Rotar; Vladimir,5,0,34,29
1657967254043,MATH 193A,A04,083782,Rotar; Vladimir,12,0,34,22
1657967254043,MATH 193A,A05,093482,Rotar; Vladimir,11,0,34,23
1657967260066,MATH 197,001,091859,McAuley; Julian John,9999,0,9999,0
1657967260066,MATH 197,002,095566,Kedlaya; Kiran S.,9997,0,9999,2
1657967260066,MATH 197,003,095567,Xiao; Ming,9999,0,9999,0
1657967260066,MATH 197,004,095571,Perols; Johan Lars,9998,0,9999,1
1657967267130,COGS 9,A01,083615,Shannon; Kyle Michael,11,0,75,64
1657967273152,COGS 11,A01,083617,Boyle; Mary E. T.,23,0,48,25
1657967279191,COGS 13,A01,083071,Bastos; Amalia Pinkusfeld,12,0,71,59
1657967285217,COGS 14A,A01,092681,Semenuks; Arturs,5,1,100,95
1657967291252,COGS 14B,A01,083073,Cheng; Tzu-Han,7,0,63,56
1657967297301,COGS 17,A01,092677,Semenuks; Arturs,7,0,81,74
1657967303331,COGS 100,A01,083619,Allen; Michael Gordon,17,0,70,53
1657967309359,COGS 101A,A01,083621,Davis; Joshua Daniel,9,0,68,59
1657967315398,COGS 101B,A01,091572,Allen; Michael Gordon,14,0,65,51
1657967321422,COGS 101C,A01,083625,Delgado; Tania,17,0,35,18
1657967327446,COGS 107A,A01,083627,Boyle; Mary E. T.,14,0,60,46
1657967333489,COGS 118A,A01,083075,Gupta; Anjum,21,0,76,55
1657967339517,CSE 3,A50,083646,Miranda; Gregory Joseph,24,0,50,26
1657967345566,CSE 8A,A50,083650,Miranda; Gregory Joseph,17,1,56,39
1657967351591,CSE 11,A01,083080,Cao; Yingjun,7,15,40,33
1657967357615,CSE 12,A01,083652,Krause-Levy; Sophia Louisa,30,1,120,90
1657967363644,CSE 15L,A01,083654,Morris; Justin Loren,9,0,50,41
1657967363644,CSE 15L,A02,083655,Morris; Justin Loren,11,0,50,39
1657967369678,CSE 20,A01,083657,Tran; Khoa Dang,39,0,80,41
1657967375711,CSE 21,A01,095574,Bach; Quang Tran,23,0,48,25
1657967381755,CSE 30,A01,083084,Eldon; John,8,0,80,72
1657967381755,CSE 30,B01,095061,Bhaskar; Nishant,9,0,50,41
1657967387777,CSE 100,A01,083659,Cao; Yingjun,5,4,70,65
1657967393802,CSE 134B,A01,083661,Powell; Thomas Allan,25,0,100,75
1657967399827,CSE 140,A01,083663,Gungor; Onat,17,0,85,68
1657967405849,CSE 140L,A01,083088,Eldon; John,23,0,100,77
1657967411871,CSE 175,A01,083665,Kumar; Rakesh,3,0,25,22
1657967417902,CSE 190,A00,092507,Dubnov; Shlomo,8,0,20,12
1657967423941,ECE 45,A01,083139,Congero; Spencer William,7,0,75,68
1657967429979,ECE 65,A50,083695,Saad; Andrew S,12,0,30,18
1657967429979,ECE 65,A51,095125,Saad; Andrew S,24,0,26,2
1657967436039,ECE 109,A01,091882,Touri; Behrouz,21,0,70,49
1657967442062,ECE 180,A00,083140,Abi Samra; Nicholas Camill,1,0,30,29
1657967442062,ECE 180,B00,083141,Abi Samra; Nicholas Camill,0,0,30,30
1657967448084,MATH 10A,A01,083735,Patchell; Gregory David,2,0,30,28
1657967448084,MATH 10A,A02,083736,Patchell; Gregory David,20,0,30,10
1657967448084,MATH 10A,A03,083737,Patchell; Gregory David,16,0,30,14
1657967454106,MATH 10B,A01,083207,Lim; Seonhee,9,0,34,25
1657967454106,MATH 10B,A02,083208,Lim; Seonhee,10,0,35,25
1657967454106,MATH 10B,A03,093472,Lim; Seonhee,7,0,34,27
1657967454106,MATH 10B,B01,083739,Sinha; Shubham,14,0,30,16
1657967460138,MATH 18,A01,083743,Cinel; Cameron Alexander,9,0,30,21
1657967460138,MATH 18,A02,083744,Cinel; Cameron Alexander,18,0,30,12
1657967460138,MATH 18,A03,083745,Cinel; Cameron Alexander,10,0,30,20
1657967460138,MATH 18,B01,083748,Rideout; David Porter,5,0,37,32
1657967460138,MATH 18,B02,083749,Rideout; David Porter,5,0,36,31
1657967460138,MATH 18,B03,083750,Rideout; David Porter,3,0,37,34
1657967460138,MATH 18,B04,083751,Rideout; David Porter,7,0,36,29
1657967460138,MATH 18,B05,093473,Rideout; David Porter,7,0,36,29
1657967460138,MATH 18,B06,093474,Rideout; David Porter,6,0,36,30
1657967466163,MATH 20A,A01,083754,Zheng; Zequn,14,0,40,26
1657967472190,MATH 20B,A01,083756,Briones; Jor-el Thomas Caparas,4,0,36,32
1657967472190,MATH 20B,A02,083757,Briones; Jor-el Thomas Caparas,1,0,36,35
1657967472190,MATH 20B,A03,093475,Briones; Jor-el Thomas Caparas,3,0,36,33
1657967478213,MATH 20C,A01,083760,Briones; Jor-el Thomas Caparas,1,0,35,34
1657967478213,MATH 20C,A02,083761,Briones; Jor-el Thomas Caparas,8,0,35,27
1657967478213,MATH 20C,A03,093476,Briones; Jor-el Thomas Caparas,0,1,36,36
1657967478213,MATH 20C,B01,083762,Bach; Quang Tran,1,0,30,29
1657967484237,MATH 20D,A01,083765,Tran; Brian Kha,5,0,30,25
1657967484237,MATH 20D,A02,083766,Tran; Brian Kha,5,0,30,25
1657967484237,MATH 20D,A03,083767,Tran; Brian Kha,6,0,30,24
1657967490262,MATH 20E,A01,083771,Ganguly; Soumya,12,0,32,20
1657967490262,MATH 20E,A02,083772,Ganguly; Soumya,7,0,32,25
1657967490262,MATH 20E,B01,083773,Ciotti; Benjamin,20,0,35,15
1657967490262,MATH 20E,B02,083774,Ciotti; Benjamin,18,0,35,17
1657967496286,MATH 103A,A01,083777,Greenfeld; Be'Eri,6,0,36,30
1657967496286,MATH 103A,A02,083778,Greenfeld; Be'Eri,5,0,36,31
1657967496286,MATH 103A,A03,093561,Greenfeld; Be'Eri,7,0,36,29
1657967496286,MATH 103A,B01,083779,Greenfeld; Be'Eri,8,0,36,28
1657967496286,MATH 103A,B02,083780,Greenfeld; Be'Eri,4,0,36,32
1657967496286,MATH 103A,B03,093562,Greenfeld; Be'Eri,3,0,36,33
1657967502321,MATH 105,A01,085443,Carter; Anne Toulson,15,0,35,20
1657967502321,MATH 105,A02,093477,Carter; Anne Toulson,20,0,35,15
1657967508418,MATH 109,A01,083213,Ganzberger; Geoffrey Michael,3,0,34,31
1657967508418,MATH 109,A02,083214,Ganzberger; Geoffrey Michael,4,0,34,30
1657967508418,MATH 109,A03,093478,Ganzberger; Geoffrey Michael,2,0,34,32
1657967508418,MATH 109,B01,083215,Ganzberger; Geoffrey Michael,3,0,32,29
1657967508418,MATH 109,B02,083216,Ganzberger; Geoffrey Michael,3,0,32,29
1657967508418,MATH 109,B03,093479,Ganzberger; Geoffrey Michael,8,0,32,24
1657967514443,MATH 142A,A01,083219,Chow; Bennett,7,0,32,25
1657967514443,MATH 142A,A02,083220,Chow; Bennett,10,0,32,22
1657967514443,MATH 142A,A03,093480,Chow; Bennett,9,0,32,23
1657967514443,MATH 142A,B03,093481,Chow; Bennett,8,0,32,24
1657967514443,MATH 142A,B04,093558,Chow; Bennett,14,0,32,18
1657967514443,MATH 142A,B05,093559,Chow; Bennett,7,0,32,25
1657967520471,MATH 193A,A01,083224,Rotar; Vladimir,9,0,34,25
1657967520471,MATH 193A,A02,083225,Rotar; Vladimir,11,0,34,23
1657967520471,MATH 193A,A03,083781,Rotar; Vladimir,5,0,34,29
1657967520471,MATH 193A,A04,083782,Rotar; Vladimir,12,0,34,22
1657967520471,MATH 193A,A05,093482,Rotar; Vladimir,11,0,34,23
1657967526495,MATH 197,001,091859,McAuley; Julian John,9999,0,9999,0
1657967526495,MATH 197,002,095566,Kedlaya; Kiran S.,9997,0,9999,2
1657967526495,MATH 197,003,095567,Xiao; Ming,9999,0,9999,0
1657967526495,MATH 197,004,095571,Perols; Johan Lars,9998,0,9999,1
1657967533564,COGS 9,A01,083615,Shannon; Kyle Michael,11,0,75,64
1657967539587,COGS 11,A01,083617,Boyle; Mary E. T.,23,0,48,25
1657967545609,COGS 13,A01,083071,Bastos; Amalia Pinkusfeld,12,0,71,59
1657967551632,COGS 14A,A01,092681,Semenuks; Arturs,5,1,100,95
1657967557654,COGS 14B,A01,083073,Cheng; Tzu-Han,7,0,63,56
1657967563678,COGS 17,A01,092677,Semenuks; Arturs,7,0,81,74
1657967569701,COGS 100,A01,083619,Allen; Michael Gordon,17,0,70,53
1657967575729,COGS 101A,A01,083621,Davis; Joshua Daniel,9,0,68,59
1657967581755,COGS 101B,A01,091572,Allen; Michael Gordon,14,0,65,51
1657967587782,COGS 101C,A01,083625,Delgado; Tania,17,0,35,18
1657967593805,COGS 107A,A01,083627,Boyle; Mary E. T.,14,0,60,46
1657967599829,COGS 118A,A01,083075,Gupta; Anjum,21,0,76,55
1657967605854,CSE 3,A50,083646,Miranda; Gregory Joseph,24,0,50,26
1657967611906,CSE 8A,A50,083650,Miranda; Gregory Joseph,17,1,56,39
1657967617932,CSE 11,A01,083080,Cao; Yingjun,7,15,40,33
1657967623958,CSE 12,A01,083652,Krause-Levy; Sophia Louisa,30,1,120,90
1657967629999,CSE 15L,A01,083654,Morris; Justin Loren,9,0,50,41
1657967629999,CSE 15L,A02,083655,Morris; Justin Loren,11,0,50,39
1657967636022,CSE 20,A01,083657,Tran; Khoa Dang,39,0,80,41
1657967642048,CSE 21,A01,095574,Bach; Quang Tran,23,0,48,25
1657967648072,CSE 30,A01,083084,Eldon; John,8,0,80,72
1657967648072,CSE 30,B01,095061,Bhaskar; Nishant,9,0,50,41
1657967654097,CSE 100,A01,083659,Cao; Yingjun,5,4,70,65
1657967660121,CSE 134B,A01,083661,Powell; Thomas Allan,25,0,100,75
1657967666154,CSE 140,A01,083663,Gungor; Onat,17,0,85,68
1657967672179,CSE 140L,A01,083088,Eldon; John,23,0,100,77
1657967678201,CSE 175,A01,083665,Kumar; Rakesh,3,0,25,22
1657967684225,CSE 190,A00,092507,Dubnov; Shlomo,8,0,20,12
1657967690255,ECE 45,A01,083139,Congero; Spencer William,7,0,75,68
1657967696282,ECE 65,A50,083695,Saad; Andrew S,12,0,30,18
1657967696282,ECE 65,A51,095125,Saad; Andrew S,24,0,26,2
1657967702305,ECE 109,A01,091882,Touri; Behrouz,21,0,70,49
1657967708328,ECE 180,A00,083140,Abi Samra; Nicholas Camill,1,0,30,29
1657967708328,ECE 180,B00,083141,Abi Samra; Nicholas Camill,0,0,30,30
1657967714352,MATH 10A,A01,083735,Patchell; Gregory David,2,0,30,28
1657967714352,MATH 10A,A02,083736,Patchell; Gregory David,20,0,30,10
1657967714352,MATH 10A,A03,083737,Patchell; Gregory David,16,0,30,14
1657967720380,MATH 10B,A01,083207,Lim; Seonhee,9,0,34,25
1657967720380,MATH 10B,A02,083208,Lim; Seonhee,10,0,35,25
1657967720380,MATH 10B,A03,093472,Lim; Seonhee,7,0,34,27
1657967720380,MATH 10B,B01,083739,Sinha; Shubham,14,0,30,16
1657967726405,MATH 18,A01,083743,Cinel; Cameron Alexander,9,0,30,21
1657967726405,MATH 18,A02,083744,Cinel; Cameron Alexander,18,0,30,12
1657967726405,MATH 18,A03,083745,Cinel; Cameron Alexander,10,0,30,20
1657967726405,MATH 18,B01,083748,Rideout; David Porter,5,0,37,32
1657967726405,MATH 18,B02,083749,Rideout; David Porter,5,0,36,31
1657967726405,MATH 18,B03,083750,Rideout; David Porter,3,0,37,34
1657967726405,MATH 18,B04,083751,Rideout; David Porter,7,0,36,29
1657967726405,MATH 18,B05,093473,Rideout; David Porter,7,0,36,29
1657967726405,MATH 18,B06,093474,Rideout; David Porter,6,0,36,30
1657967732428,MATH 20A,A01,083754,Zheng; Zequn,14,0,40,26
1657967738454,MATH 20B,A01,083756,Briones; Jor-el Thomas Caparas,4,0,36,32
1657967738454,MATH 20B,A02,083757,Briones; Jor-el Thomas Caparas,1,0,36,35
1657967738454,MATH 20B,A03,093475,Briones; Jor-el Thomas Caparas,3,0,36,33
1657967744476,MATH 20C,A01,083760,Briones; Jor-el Thomas Caparas,1,0,35,34
1657967744476,MATH 20C,A02,083761,Briones; Jor-el Thomas Caparas,8,0,35,27
1657967744476,MATH 20C,A03,093476,Briones; Jor-el Thomas Caparas,0,1,36,36
1657967744476,MATH 20C,B01,083762,Bach; Quang Tran,1,0,30,29
1657967750501,MATH 20D,A01,083765,Tran; Brian Kha,5,0,30,25
1657967750501,MATH 20D,A02,083766,Tran; Brian Kha,5,0,30,25
1657967750501,MATH 20D,A03,083767,Tran; Brian Kha,6,0,30,24
1657967756525,MATH 20E,A01,083771,Ganguly; Soumya,12,0,32,20
1657967756525,MATH 20E,A02,083772,Ganguly; Soumya,7,0,32,25
1657967756525,MATH 20E,B01,083773,Ciotti; Benjamin,20,0,35,15
1657967756525,MATH 20E,B02,083774,Ciotti; Benjamin,18,0,35,17
1657967762549,MATH 103A,A01,083777,Greenfeld; Be'Eri,6,0,36,30
1657967762549,MATH 103A,A02,083778,Greenfeld; Be'Eri,5,0,36,31
1657967762549,MATH 103A,A03,093561,Greenfeld; Be'Eri,7,0,36,29
1657967762549,MATH 103A,B01,083779,Greenfeld; Be'Eri,8,0,36,28
1657967762549,MATH 103A,B02,083780,Greenfeld; Be'Eri,4,0,36,32
1657967762549,MATH 103A,B03,093562,Greenfeld; Be'Eri,3,0,36,33
1657967768578,MATH 105,A01,085443,Carter; Anne Toulson,15,0,35,20
1657967768578,MATH 105,A02,093477,Carter; Anne Toulson,20,0,35,15
1657967774607,MATH 109,A01,083213,Ganzberger; Geoffrey Michael,3,0,34,31
1657967774607,MATH 109,A02,083214,Ganzberger; Geoffrey Michael,4,0,34,30
1657967774607,MATH 109,A03,093478,Ganzberger; Geoffrey Michael,2,0,34,32
1657967774607,MATH 109,B01,083215,Ganzberger; Geoffrey Michael,3,0,32,29
1657967774607,MATH 109,B02,083216,Ganzberger; Geoffrey Michael,3,0,32,29
1657967774607,MATH 109,B03,093479,Ganzberger; Geoffrey Michael,8,0,32,24
1657967780633,MATH 142A,A01,083219,Chow; Bennett,7,0,32,25
1657967780633,MATH 142A,A02,083220,Chow; Bennett,10,0,32,22
1657967780633,MATH 142A,A03,093480,Chow; Bennett,9,0,32,23
1657967780633,MATH 142A,B03,093481,Chow; Bennett,8,0,32,24
1657967780633,MATH 142A,B04,093558,Chow; Bennett,14,0,32,18
1657967780633,MATH 142A,B05,093559,Chow; Bennett,7,0,32,25
1657967786662,MATH 193A,A01,083224,Rotar; Vladimir,9,0,34,25
1657967786662,MATH 193A,A02,083225,Rotar; Vladimir,11,0,34,23
1657967786662,MATH 193A,A03,083781,Rotar; Vladimir,5,0,34,29
1657967786662,MATH 193A,A04,083782,Rotar; Vladimir,12,0,34,22
1657967786662,MATH 193A,A05,093482,Rotar; Vladimir,11,0,34,23
1657967792690,MATH 197,001,091859,McAuley; Julian John,9999,0,9999,0
1657967792690,MATH 197,002,095566,Kedlaya; Kiran S.,9997,0,9999,2
1657967792690,MATH 197,003,095567,Xiao; Ming,9999,0,9999,0
1657967792690,MATH 197,004,095571,Perols; Johan Lars,9998,0,9999,1
1657967799761,COGS 9,A01,083615,Shannon; Kyle Michael,11,0,75,64
1657967805786,COGS 11,A01,083617,Boyle; Mary E. T.,23,0,48,25
1657967811810,COGS 13,A01,083071,Bastos; Amalia Pinkusfeld,12,0,71,59
1657967817836,COGS 14A,A01,092681,Semenuks; Arturs,5,1,100,95
1657967823866,COGS 14B,A01,083073,Cheng; Tzu-Han,7,0,63,56
1657967829893,COGS 17,A01,092677,Semenuks; Arturs,7,0,81,74
1657967835919,COGS 100,A01,083619,Allen; Michael Gordon,17,0,70,53
1657967841944,COGS 101A,A01,083621,Davis; Joshua Daniel,9,0,68,59
1657967847972,COGS 101B,A01,091572,Allen; Michael Gordon,14,0,65,51
1657967853996,COGS 101C,A01,083625,Delgado; Tania,17,0,35,18
1657967860018,COGS 107A,A01,083627,Boyle; Mary E. T.,14,0,60,46
1657967866040,COGS 118A,A01,083075,Gupta; Anjum,21,0,76,55
1657967872071,CSE 3,A50,083646,Miranda; Gregory Joseph,24,0,50,26
1657967878101,CSE 8A,A50,083650,Miranda; Gregory Joseph,17,1,56,39
1657967884129,CSE 11,A01,083080,Cao; Yingjun,7,15,40,33
1657967890151,CSE 12,A01,083652,Krause-Levy; Sophia Louisa,30,1,120,90
1657967896174,CSE 15L,A01,083654,Morris; Justin Loren,9,0,50,41
1657967896174,CSE 15L,A02,083655,Morris; Justin Loren,11,0,50,39
1657967902197,CSE 20,A01,083657,Tran; Khoa Dang,39,0,80,41
1657967908222,CSE 21,A01,095574,Bach; Quang Tran,23,0,48,25
1657967914246,CSE 30,A01,083084,Eldon; John,8,0,80,72
1657967914246,CSE 30,B01,095061,Bhaskar; Nishant,9,0,50,41
1657967920269,CSE 100,A01,083659,Cao; Yingjun,5,4,70,65
1657967926293,CSE 134B,A01,083661,Powell; Thomas Allan,25,0,100,75
1657967932315,CSE 140,A01,083663,Gungor; Onat,17,0,85,68
1657967938340,CSE 140L,A01,083088,Eldon; John,23,0,100,77
1657967944366,CSE 175,A01,083665,Kumar; Rakesh,3,0,25,22
1657967950391,CSE 190,A00,092507,Dubnov; Shlomo,8,0,20,12
1657967956424,ECE 45,A01,083139,Congero; Spencer William,7,0,75,68
1657967962449,ECE 65,A50,083695,Saad; Andrew S,12,0,30,18
1657967962449,ECE 65,A51,095125,Saad; Andrew S,24,0,26,2
1657967968478,ECE 109,A01,091882,Touri; Behrouz,21,0,70,49
1657967974507,ECE 180,A00,083140,Abi Samra; Nicholas Camill,1,0,30,29
1657967974507,ECE 180,B00,083141,Abi Samra; Nicholas Camill,0,0,30,30
1657967980531,MATH 10A,A01,083735,Patchell; Gregory David,2,0,30,28
1657967980531,MATH 10A,A02,083736,Patchell; Gregory David,20,0,30,10
1657967980531,MATH 10A,A03,083737,Patchell; Gregory David,16,0,30,14
1657967986558,MATH 10B,A01,083207,Lim; Seonhee,9,0,34,25
1657967986558,MATH 10B,A02,083208,Lim; Seonhee,10,0,35,25
1657967986558,MATH 10B,A03,093472,Lim; Seonhee,7,0,34,27
1657967986558,MATH 10B,B01,083739,Sinha; Shubham,14,0,30,16
1657967992594,MATH 18,A01,083743,Cinel; Cameron Alexander,9,0,30,21
1657967992594,MATH 18,A02,083744,Cinel; Cameron Alexander,18,0,30,12
1657967992594,MATH 18,A03,083745,Cinel; Cameron Alexander,10,0,30,20
1657967992594,MATH 18,B01,083748,Rideout; David Porter,5,0,37,32
1657967992594,MATH 18,B02,083749,Rideout; David Porter,5,0,36,31
1657967992594,MATH 18,B03,083750,Rideout; David Porter,3,0,37,34
1657967992594,MATH 18,B04,083751,Rideout; David Porter,7,0,36,29
1657967992594,MATH 18,B05,093473,Rideout; David Porter,7,0,36,29
1657967992594,MATH 18,B06,093474,Rideout; David Porter,6,0,36,30
1657967998617,MATH 20A,A01,083754,Zheng; Zequn,14,0,40,26
1657968004641,MATH 20B,A01,083756,Briones; Jor-el Thomas Caparas,4,0,36,32
1657968004641,MATH 20B,A02,083757,Briones; Jor-el Thomas Caparas,1,0,36,35
1657968004641,MATH 20B,A03,093475,Briones; Jor-el Thomas Caparas,3,0,36,33
1657968010665,MATH 20C,A01,083760,Briones; Jor-el Thomas Caparas,1,0,35,34
1657968010665,MATH 20C,A02,083761,Briones; Jor-el Thomas Caparas,8,0,35,27
1657968010665,MATH 20C,A03,093476,Briones; Jor-el Thomas Caparas,0,1,36,36
1657968010665,MATH 20C,B01,083762,Bach; Quang Tran,1,0,30,29
1657968016695,MATH 20D,A01,083765,Tran; Brian Kha,5,0,30,25
1657968016695,MATH 20D,A02,083766,Tran; Brian Kha,5,0,30,25
1657968016695,MATH 20D,A03,083767,Tran; Brian Kha,6,0,30,24
1657968022720,MATH 20E,A01,083771,Ganguly; Soumya,12,0,32,20
1657968022720,MATH 20E,A02,083772,Ganguly; Soumya,7,0,32,25
1657968022720,MATH 20E,B01,083773,Ciotti; Benjamin,20,0,35,15
1657968022720,MATH 20E,B02,083774,Ciotti; Benjamin,18,0,35,17
1657968028754,MATH 103A,A01,083777,Greenfeld; Be'Eri,6,0,36,30
1657968028754,MATH 103A,A02,083778,Greenfeld; Be'Eri,5,0,36,31
1657968028754,MATH 103A,A03,093561,Greenfeld; Be'Eri,7,0,36,29
1657968028754,MATH 103A,B01,083779,Greenfeld; Be'Eri,8,0,36,28
1657968028754,MATH 103A,B02,083780,Greenfeld; Be'Eri,4,0,36,32
1657968028754,MATH 103A,B03,093562,Greenfeld; Be'Eri,3,0,36,33
1657968034785,MATH 105,A01,085443,Carter; Anne Toulson,15,0,35,20
1657968034785,MATH 105,A02,093477,Carter; Anne Toulson,20,0,35,15
1657968040810,MATH 109,A01,083213,Ganzberger; Geoffrey Michael,3,0,34,31
1657968040810,MATH 109,A02,083214,Ganzberger; Geoffrey Michael,4,0,34,30
1657968040810,MATH 109,A03,093478,Ganzberger; Geoffrey Michael,2,0,34,32
1657968040810,MATH 109,B01,083215,Ganzberger; Geoffrey Michael,3,0,32,29
1657968040810,MATH 109,B02,083216,Ganzberger; Geoffrey Michael,3,0,32,29
1657968040810,MATH 109,B03,093479,Ganzberger; Geoffrey Michael,8,0,32,24
1657968046835,MATH 142A,A01,083219,Chow; Bennett,7,0,32,25
1657968046835,MATH 142A,A02,083220,Chow; Bennett,10,0,32,22
1657968046835,MATH 142A,A03,093480,Chow; Bennett,9,0,32,23
1657968046835,MATH 142A,B03,093481,Chow; Bennett,8,0,32,24
1657968046835,MATH 142A,B04,093558,Chow; Bennett,14,0,32,18
1657968046835,MATH 142A,B05,093559,Chow; Bennett,7,0,32,25
1657968052865,MATH 193A,A01,083224,Rotar; Vladimir,9,0,34,25
1657968052865,MATH 193A,A02,083225,Rotar; Vladimir,11,0,34,23
1657968052865,MATH 193A,A03,083781,Rotar; Vladimir,5,0,34,29
1657968052865,MATH 193A,A04,083782,Rotar; Vladimir,12,0,34,22
1657968052865,MATH 193A,A05,093482,Rotar; Vladimir,11,0,34,23
1657968058889,MATH 197,001,091859,McAuley; Julian John,9999,0,9999,0
1657968058889,MATH 197,002,095566,Kedlaya; Kiran S.,9997,0,9999,2
1657968058889,MATH 197,003,095567,Xiao; Ming,9999,0,9999,0
1657968058889,MATH 197,004,095571,Perols; Johan Lars,9998,0,9999,1
1657968065942,COGS 9,A01,083615,Shannon; Kyle Michael,11,0,75,64
1657968071969,COGS 11,A01,083617,Boyle; Mary E. T.,23,0,48,25
1657968077995,COGS 13,A01,083071,Bastos; Amalia Pinkusfeld,12,0,71,59
1657968084020,COGS 14A,A01,092681,Semenuks; Arturs,5,1,100,95
1657968090048,COGS 14B,A01,083073,Cheng; Tzu-Han,7,0,63,56
1657968096072,COGS 17,A01,092677,Semenuks; Arturs,7,0,81,74
1657968102191,COGS 100,A01,083619,Allen; Michael Gordon,17,0,70,53
1657968108220,COGS 101A,A01,083621,Davis; Joshua Daniel,9,0,68,59
1657968114245,COGS 101B,A01,091572,Allen; Michael Gordon,14,0,65,51
1657968120278,COGS 101C,A01,083625,Delgado; Tania,17,0,35,18
1657968126303,COGS 107A,A01,083627,Boyle; Mary E. T.,14,0,60,46
1657968132328,COGS 118A,A01,083075,Gupta; Anjum,21,0,76,55
1657968138352,CSE 3,A50,083646,Miranda; Gregory Joseph,24,0,50,26
1657968144376,CSE 8A,A50,083650,Miranda; Gregory Joseph,17,1,56,39
1657968150404,CSE 11,A01,083080,Cao; Yingjun,7,15,40,33
1657968156427,CSE 12,A01,083652,Krause-Levy; Sophia Louisa,30,1,120,90
1657968162453,CSE 15L,A01,083654,Morris; Justin Loren,9,0,50,41
1657968162453,CSE 15L,A02,083655,Morris; Justin Loren,11,0,50,39
1657968168478,CSE 20,A01,083657,Tran; Khoa Dang,39,0,80,41
1657968174502,CSE 21,A01,095574,Bach; Quang Tran,23,0,48,25
1657968180548,CSE 30,A01,083084,Eldon; John,8,0,80,72
1657968180548,CSE 30,B01,095061,Bhaskar; Nishant,9,0,50,41
1657968186571,CSE 100,A01,083659,Cao; Yingjun,5,4,70,65
1657968192595,CSE 134B,A01,083661,Powell; Thomas Allan,25,0,100,75
1657968198621,CSE 140,A01,083663,Gungor; Onat,17,0,85,68
1657968204644,CSE 140L,A01,083088,Eldon; John,23,0,100,77
1657968210669,CSE 175,A01,083665,Kumar; Rakesh,3,0,25,22
1657968216698,CSE 190,A00,092507,Dubnov; Shlomo,8,0,20,12
1657968222729,ECE 45,A01,083139,Congero; Spencer William,7,0,75,68
1657968228771,ECE 65,A50,083695,Saad; Andrew S,12,0,30,18
1657968228771,ECE 65,A51,095125,Saad; Andrew S,24,0,26,2
1657968234801,ECE 109,A01,091882,Touri; Behrouz,21,0,70,49
1657968240825,ECE 180,A00,083140,Abi Samra; Nicholas Camill,1,0,30,29
1657968240825,ECE 180,B00,083141,Abi Samra; Nicholas Camill,0,0,30,30
1657968246859,MATH 10A,A01,083735,Patchell; Gregory David,2,0,30,28
1657968246859,MATH 10A,A02,083736,Patchell; Gregory David,20,0,30,10
1657968246859,MATH 10A,A03,083737,Patchell; Gregory David,16,0,30,14
1657968252886,MATH 10B,A01,083207,Lim; Seonhee,9,0,34,25
1657968252886,MATH 10B,A02,083208,Lim; Seonhee,10,0,35,25
1657968252886,MATH 10B,A03,093472,Lim; Seonhee,7,0,34,27
1657968252886,MATH 10B,B01,083739,Sinha; Shubham,14,0,30,16
1657968258915,MATH 18,A01,083743,Cinel; Cameron Alexander,9,0,30,21
1657968258915,MATH 18,A02,083744,Cinel; Cameron Alexander,18,0,30,12
1657968258915,MATH 18,A03,083745,Cinel; Cameron Alexander,10,0,30,20
1657968258915,MATH 18,B01,083748,Rideout; David Porter,5,0,37,32
1657968258915,MATH 18,B02,083749,Rideout; David Porter,5,0,36,31
1657968258915,MATH 18,B03,083750,Rideout; David Porter,3,0,37,34
1657968258915,MATH 18,B04,083751,Rideout; David Porter,7,0,36,29
1657968258915,MATH 18,B05,093473,Rideout; David Porter,7,0,36,29
1657968258915,MATH 18,B06,093474,Rideout; David Porter,6,0,36,30
1657968264938,MATH 20A,A01,083754,Zheng; Zequn,14,0,40,26
1657968270970,MATH 20B,A01,083756,Briones; Jor-el Thomas Caparas,4,0,36,32
1657968270970,MATH 20B,A02,083757,Briones; Jor-el Thomas Caparas,1,0,36,35
1657968270970,MATH 20B,A03,093475,Briones; Jor-el Thomas Caparas,3,0,36,33
1657968277001,MATH 20C,A01,083760,Briones; Jor-el Thomas Caparas,1,0,35,34
1657968277001,MATH 20C,A02,083761,Briones; Jor-el Thomas Caparas,8,0,35,27
1657968277001,MATH 20C,A03,093476,Briones; Jor-el Thomas Caparas,0,1,36,36
1657968277001,MATH 20C,B01,083762,Bach; Quang Tran,1,0,30,29
1657968283034,MATH 20D,A01,083765,Tran; Brian Kha,5,0,30,25
1657968283034,MATH 20D,A02,083766,Tran; Brian Kha,5,0,30,25
1657968283034,MATH 20D,A03,083767,Tran; Brian Kha,6,0,30,24
1657968289059,MATH 20E,A01,083771,Ganguly; Soumya,12,0,32,20
1657968289059,MATH 20E,A02,083772,Ganguly; Soumya,7,0,32,25
1657968289059,MATH 20E,B01,083773,Ciotti; Benjamin,20,0,35,15
1657968289059,MATH 20E,B02,083774,Ciotti; Benjamin,18,0,35,17
1657968295084,MATH 103A,A01,083777,Greenfeld; Be'Eri,6,0,36,30
1657968295084,MATH 103A,A02,083778,Greenfeld; Be'Eri,5,0,36,31
1657968295084,MATH 103A,A03,093561,Greenfeld; Be'Eri,7,0,36,29
1657968295084,MATH 103A,B01,083779,Greenfeld; Be'Eri,8,0,36,28
1657968295084,MATH 103A,B02,083780,Greenfeld; Be'Eri,4,0,36,32
1657968295084,MATH 103A,B03,093562,Greenfeld; Be'Eri,3,0,36,33
1657968301110,MATH 105,A01,085443,Carter; Anne Toulson,15,0,35,20
1657968301110,MATH 105,A02,093477,Carter; Anne Toulson,20,0,35,15
1657968307134,MATH 109,A01,083213,Ganzberger; Geoffrey Michael,3,0,34,31
1657968307134,MATH 109,A02,083214,Ganzberger; Geoffrey Michael,4,0,34,30
1657968307134,MATH 109,A03,093478,Ganzberger; Geoffrey Michael,2,0,34,32
1657968307134,MATH 109,B01,083215,Ganzberger; Geoffrey Michael,3,0,32,29
1657968307134,MATH 109,B02,083216,Ganzberger; Geoffrey Michael,3,0,32,29
1657968307134,MATH 109,B03,093479,Ganzberger; Geoffrey Michael,8,0,32,24
1657968313159,MATH 142A,A01,083219,Chow; Bennett,7,0,32,25
1657968313159,MATH 142A,A02,083220,Chow; Bennett,10,0,32,22
1657968313159,MATH 142A,A03,093480,Chow; Bennett,9,0,32,23
1657968313159,MATH 142A,B03,093481,Chow; Bennett,8,0,32,24
1657968313159,MATH 142A,B04,093558,Chow; Bennett,14,0,32,18
1657968313159,MATH 142A,B05,093559,Chow; Bennett,7,0,32,25
1657968319187,MATH 193A,A01,083224,Rotar; Vladimir,9,0,34,25
1657968319187,MATH 193A,A02,083225,Rotar; Vladimir,11,0,34,23
1657968319187,MATH 193A,A03,083781,Rotar; Vladimir,5,0,34,29
1657968319187,MATH 193A,A04,083782,Rotar; Vladimir,12,0,34,22
1657968319187,MATH 193A,A05,093482,Rotar; Vladimir,11,0,34,23
1657968325218,MATH 197,001,091859,McAuley; Julian John,9999,0,9999,0
1657968325218,MATH 197,002,095566,Kedlaya; Kiran S.,9997,0,9999,2
1657968325218,MATH 197,003,095567,Xiao; Ming,9999,0,9999,0
1657968325218,MATH 197,004,095571,Perols; Johan Lars,9998,0,9999,1
1657968332304,COGS 9,A01,083615,Shannon; Kyle Michael,11,0,75,64
1657968338329,COGS 11,A01,083617,Boyle; Mary E. T.,23,0,48,25
1657968344354,COGS 13,A01,083071,Bastos; Amalia Pinkusfeld,12,0,71,59
1657968350378,COGS 14A,A01,092681,Semenuks; Arturs,5,1,100,95
1657968356408,COGS 14B,A01,083073,Cheng; Tzu-Han,7,0,63,56
1657968362438,COGS 17,A01,092677,Semenuks; Arturs,7,0,81,74
1657968368462,COGS 100,A01,083619,Allen; Michael Gordon,17,0,70,53
1657968374488,COGS 101A,A01,083621,Davis; Joshua Daniel,9,0,68,59
1657968380513,COGS 101B,A01,091572,Allen; Michael Gordon,14,0,65,51
1657968386539,COGS 101C,A01,083625,Delgado; Tania,17,0,35,18
1657968392566,COGS 107A,A01,083627,Boyle; Mary E. T.,14,0,60,46
1657968398589,COGS 118A,A01,083075,Gupta; Anjum,21,0,76,55
1657968404619,CSE 3,A50,083646,Miranda; Gregory Joseph,24,0,50,26
1657968410649,CSE 8A,A50,083650,Miranda; Gregory Joseph,17,1,56,39
1657968416673,CSE 11,A01,083080,Cao; Yingjun,7,15,40,33
1657968431768,CSE 12,A01,083652,Krause-Levy; Sophia Louisa,30,1,120,90
1657968437793,CSE 15L,A01,083654,Morris; Justin Loren,9,0,50,41
1657968437793,CSE 15L,A02,083655,Morris; Justin Loren,11,0,50,39
1657968454592,CSE 20,A01,083657,Tran; Khoa Dang,39,0,80,41
1657968460617,CSE 21,A01,095574,Bach; Quang Tran,23,0,48,25
1657968477054,CSE 30,A01,083084,Eldon; John,8,0,80,72
1657968477054,CSE 30,B01,095061,Bhaskar; Nishant,9,0,50,41
1657968483080,CSE 100,A01,083659,Cao; Yingjun,5,4,70,65
1657968500082,CSE 134B,A01,083661,Powell; Thomas Allan,25,0,100,75
1657968506111,CSE 140,A01,083663,Gungor; Onat,17,0,85,68
1657968522427,CSE 140L,A01,083088,Eldon; John,23,0,100,77
1657968528463,CSE 175,A01,083665,Kumar; Rakesh,3,0,25,22
1657968544629,CSE 190,A00,092507,Dubnov; Shlomo,8,0,20,12
1657968550653,ECE 45,A01,083139,Congero; Spencer William,7,0,75,68
1657968566952,ECE 65,A50,083695,Saad; Andrew S,12,0,30,18
1657968566952,ECE 65,A51,095125,Saad; Andrew S,24,0,26,2
1657968572981,ECE 109,A01,091882,Touri; Behrouz,21,0,70,49
1657968589443,ECE 180,A00,083140,Abi Samra; Nicholas Camill,1,0,30,29
1657968589443,ECE 180,B00,083141,Abi Samra; Nicholas Camill,0,0,30,30
1657968595468,MATH 10A,A01,083735,Patchell; Gregory David,2,0,30,28
1657968595468,MATH 10A,A02,083736,Patchell; Gregory David,20,0,30,10
1657968595468,MATH 10A,A03,083737,Patchell; Gregory David,16,0,30,14
1657968612903,MATH 10B,A01,083207,Lim; Seonhee,9,0,34,25
1657968612903,MATH 10B,A02,083208,Lim; Seonhee,10,0,35,25
1657968612903,MATH 10B,A03,093472,Lim; Seonhee,7,0,34,27
1657968612903,MATH 10B,B01,083739,Sinha; Shubham,14,0,30,16
1657968618953,MATH 18,A01,083743,Cinel; Cameron Alexander,9,0,30,21
1657968618953,MATH 18,A02,083744,Cinel; Cameron Alexander,18,0,30,12
1657968618953,MATH 18,A03,083745,Cinel; Cameron Alexander,10,0,30,20
1657968618953,MATH 18,B01,083748,Rideout; David Porter,5,0,37,32
1657968618953,MATH 18,B02,083749,Rideout; David Porter,5,0,36,31
1657968618953,MATH 18,B03,083750,Rideout; David Porter,3,0,37,34
1657968618953,MATH 18,B04,083751,Rideout; David Porter,7,0,36,29
1657968618953,MATH 18,B05,093473,Rideout; David Porter,7,0,36,29
1657968618953,MATH 18,B06,093474,Rideout; David Porter,6,0,36,30
1657968633712,MATH 20A,A01,083754,Zheng; Zequn,14,0,40,26
1657968639753,MATH 20B,A01,083756,Briones; Jor-el Thomas Caparas,4,0,36,32
1657968639753,MATH 20B,A02,083757,Briones; Jor-el Thomas Caparas,1,0,36,35
1657968639753,MATH 20B,A03,093475,Briones; Jor-el Thomas Caparas,3,0,36,33
1657968645778,MATH 20C,A01,083760,Briones; Jor-el Thomas Caparas,1,0,35,34
1657968645778,MATH 20C,A02,083761,Briones; Jor-el Thomas Caparas,8,0,35,27
1657968645778,MATH 20C,A03,093476,Briones; Jor-el Thomas Caparas,0,1,36,36
1657968645778,MATH 20C,B01,083762,Bach; Quang Tran,1,0,30,29
1657968651803,MATH 20D,A01,083765,Tran; Brian Kha,5,0,30,25
1657968651803,MATH 20D,A02,083766,Tran; Brian Kha,5,0,30,25
1657968651803,MATH 20D,A03,083767,Tran; Brian Kha,6,0,30,24
1657968657840,MATH 20E,A01,083771,Ganguly; Soumya,12,0,32,20
1657968657840,MATH 20E,A02,083772,Ganguly; Soumya,7,0,32,25
1657968657840,MATH 20E,B01,083773,Ciotti; Benjamin,20,0,35,15
1657968657840,MATH 20E,B02,083774,Ciotti; Benjamin,18,0,35,17
1657968663866,MATH 103A,A01,083777,Greenfeld; Be'Eri,6,0,36,30
1657968663866,MATH 103A,A02,083778,Greenfeld; Be'Eri,5,0,36,31
1657968663866,MATH 103A,A03,093561,Greenfeld; Be'Eri,7,0,36,29
1657968663866,MATH 103A,B01,083779,Greenfeld; Be'Eri,8,0,36,28
1657968663866,MATH 103A,B02,083780,Greenfeld; Be'Eri,4,0,36,32
1657968663866,MATH 103A,B03,093562,Greenfeld; Be'Eri,3,0,36,33
1657968669899,MATH 105,A01,085443,Carter; Anne Toulson,15,0,35,20
1657968669899,MATH 105,A02,093477,Carter; Anne Toulson,20,0,35,15
1657968675924,MATH 109,A01,083213,Ganzberger; Geoffrey Michael,3,0,34,31
1657968675924,MATH 109,A02,083214,Ganzberger; Geoffrey Michael,4,0,34,30
1657968675924,MATH 109,A03,093478,Ganzberger; Geoffrey Michael,2,0,34,32
1657968675924,MATH 109,B01,083215,Ganzberger; Geoffrey Michael,3,0,32,29
1657968675924,MATH 109,B02,083216,Ganzberger; Geoffrey Michael,3,0,32,29
1657968675924,MATH 109,B03,093479,Ganzberger; Geoffrey Michael,8,0,32,24
1657968681952,MATH 142A,A01,083219,Chow; Bennett,7,0,32,25
1657968681952,MATH 142A,A02,083220,Chow; Bennett,10,0,32,22
1657968681952,MATH 142A,A03,093480,Chow; Bennett,9,0,32,23
1657968681952,MATH 142A,B03,093481,Chow; Bennett,8,0,32,24
1657968681952,MATH 142A,B04,093558,Chow; Bennett,14,0,32,18
1657968681952,MATH 142A,B05,093559,Chow; Bennett,7,0,32,25
1657968687983,MATH 193A,A01,083224,Rotar; Vladimir,9,0,34,25
1657968687983,MATH 193A,A02,083225,Rotar; Vladimir,11,0,34,23
1657968687983,MATH 193A,A03,083781,Rotar; Vladimir,5,0,34,29
1657968687983,MATH 193A,A04,083782,Rotar; Vladimir,12,0,34,22
1657968687983,MATH 193A,A05,093482,Rotar; Vladimir,11,0,34,23
1657968694008,MATH 197,001,091859,McAuley; Julian John,9999,0,9999,0
1657968694008,MATH 197,002,095566,Kedlaya; Kiran S.,9997,0,9999,2
1657968694008,MATH 197,003,095567,Xiao; Ming,9999,0,9999,0
1657968694008,MATH 197,004,095571,Perols; Johan Lars,9998,0,9999,1
1657968701102,COGS 9,A01,083615,Shannon; Kyle Michael,11,0,75,64
1657968707131,COGS 11,A01,083617,Boyle; Mary E. T.,23,0,48,25
1657968713168,COGS 13,A01,083071,Bastos; Amalia Pinkusfeld,12,0,71,59
1657968719197,COGS 14A,A01,092681,Semenuks; Arturs,5,1,100,95
1657968725222,COGS 14B,A01,083073,Cheng; Tzu-Han,7,0,63,56
1657968731250,COGS 17,A01,092677,Semenuks; Arturs,7,0,81,74
1657968737279,COGS 100,A01,083619,Allen; Michael Gordon,17,0,70,53
1657968743308,COGS 101A,A01,083621,Davis; Joshua Daniel,9,0,68,59
1657968749332,COGS 101B,A01,091572,Allen; Michael Gordon,14,0,65,51
1657968755361,COGS 101C,A01,083625,Delgado; Tania,17,0,35,18
1657968761389,COGS 107A,A01,083627,Boyle; Mary E. T.,14,0,60,46
1657968767415,COGS 118A,A01,083075,Gupta; Anjum,21,0,76,55
1657968773442,CSE 3,A50,083646,Miranda; Gregory Joseph,24,0,50,26
1657968779469,CSE 8A,A50,083650,Miranda; Gregory Joseph,17,1,56,39
1657968785497,CSE 11,A01,083080,Cao; Yingjun,7,15,40,33
1657968791527,CSE 12,A01,083652,Krause-Levy; Sophia Louisa,30,1,120,90
1657968797549,CSE 15L,A01,083654,Morris; Justin Loren,9,0,50,41
1657968797549,CSE 15L,A02,083655,Morris; Justin Loren,11,0,50,39
1657968803649,CSE 20,A01,083657,Tran; Khoa Dang,39,0,80,41
1657968809679,CSE 21,A01,095574,Bach; Quang Tran,23,0,48,25
1657968815710,CSE 30,A01,083084,Eldon; John,8,0,80,72
1657968815710,CSE 30,B01,095061,Bhaskar; Nishant,9,0,50,41
1657968821734,CSE 100,A01,083659,Cao; Yingjun,5,4,70,65
1657968835509,CSE 134B,A01,083661,Powell; Thomas Allan,25,0,100,75
1657968841535,CSE 140,A01,083663,Gungor; Onat,17,0,85,68
1657968848459,CSE 140L,A01,083088,Eldon; John,23,0,100,77
1657968854492,CSE 175,A01,083665,Kumar; Rakesh,3,0,25,22
1657968860533,CSE 190,A00,092507,Dubnov; Shlomo,8,0,20,12
1657968866565,ECE 45,A01,083139,Congero; Spencer William,7,0,75,68
1657968872588,ECE 65,A50,083695,Saad; Andrew S,12,0,30,18
1657968872588,ECE 65,A51,095125,Saad; Andrew S,24,0,26,2
1657968878613,ECE 109,A01,091882,Touri; Behrouz,21,0,70,49
1657968884641,ECE 180,A00,083140,Abi Samra; Nicholas Camill,1,0,30,29
1657968884641,ECE 180,B00,083141,Abi Samra; Nicholas Camill,0,0,30,30
1657968890669,MATH 10A,A01,083735,Patchell; Gregory David,2,0,30,28
1657968890669,MATH 10A,A02,083736,Patchell; Gregory David,20,0,30,10
1657968890669,MATH 10A,A03,083737,Patchell; Gregory David,16,0,30,14
1657968896708,MATH 10B,A01,083207,Lim; Seonhee,9,0,34,25
1657968896708,MATH 10B,A02,083208,Lim; Seonhee,10,0,35,25
1657968896708,MATH 10B,A03,093472,Lim; Seonhee,7,0,34,27
1657968896708,MATH 10B,B01,083739,Sinha; Shubham,14,0,30,16
1657968902756,MATH 18,A01,083743,Cinel; Cameron Alexander,9,0,30,21
1657968902756,MATH 18,A02,083744,Cinel; Cameron Alexander,18,0,30,12
1657968902756,MATH 18,A03,083745,Cinel; Cameron Alexander,10,0,30,20
1657968902756,MATH 18,B01,083748,Rideout; David Porter,5,0,37,32
1657968902756,MATH 18,B02,083749,Rideout; David Porter,5,0,36,31
1657968902756,MATH 18,B03,083750,Rideout; David Porter,3,0,37,34
1657968902756,MATH 18,B04,083751,Rideout; David Porter,7,0,36,29
1657968902756,MATH 18,B05,093473,Rideout; David Porter,7,0,36,29
1657968902756,MATH 18,B06,093474,Rideout; David Porter,6,0,36,30
1657968908780,MATH 20A,A01,083754,Zheng; Zequn,14,0,40,26
1657968914812,MATH 20B,A01,083756,Briones; Jor-el Thomas Caparas,4,0,36,32
1657968914812,MATH 20B,A02,083757,Briones; Jor-el Thomas Caparas,1,0,36,35
1657968914812,MATH 20B,A03,093475,Briones; Jor-el Thomas Caparas,3,0,36,33
1657968920848,MATH 20C,A01,083760,Briones; Jor-el Thomas Caparas,1,0,35,34
1657968920848,MATH 20C,A02,083761,Briones; Jor-el Thomas Caparas,8,0,35,27
1657968920848,MATH 20C,A03,093476,Briones; Jor-el Thomas Caparas,0,1,36,36
1657968920848,MATH 20C,B01,083762,Bach; Quang Tran,1,0,30,29
1657968926879,MATH 20D,A01,083765,Tran; Brian Kha,5,0,30,25
1657968926879,MATH 20D,A02,083766,Tran; Brian Kha,5,0,30,25
1657968926879,MATH 20D,A03,083767,Tran; Brian Kha,6,0,30,24
1657968932905,MATH 20E,A01,083771,Ganguly; Soumya,12,0,32,20
1657968932905,MATH 20E,A02,083772,Ganguly; Soumya,7,0,32,25
1657968932905,MATH 20E,B01,083773,Ciotti; Benjamin,20,0,35,15
1657968932905,MATH 20E,B02,083774,Ciotti; Benjamin,18,0,35,17
1657968938938,MATH 103A,A01,083777,Greenfeld; Be'Eri,6,0,36,30
1657968938938,MATH 103A,A02,083778,Greenfeld; Be'Eri,5,0,36,31
1657968938938,MATH 103A,A03,093561,Greenfeld; Be'Eri,7,0,36,29
1657968938938,MATH 103A,B01,083779,Greenfeld; Be'Eri,8,0,36,28
1657968938938,MATH 103A,B02,083780,Greenfeld; Be'Eri,4,0,36,32
1657968938938,MATH 103A,B03,093562,Greenfeld; Be'Eri,3,0,36,33
1657968944962,MATH 105,A01,085443,Carter; Anne Toulson,15,0,35,20
1657968944962,MATH 105,A02,093477,Carter; Anne Toulson,20,0,35,15
1657968950995,MATH 109,A01,083213,Ganzberger; Geoffrey Michael,3,0,34,31
1657968950995,MATH 109,A02,083214,Ganzberger; Geoffrey Michael,4,0,34,30
1657968950995,MATH 109,A03,093478,Ganzberger; Geoffrey Michael,2,0,34,32
1657968950995,MATH 109,B01,083215,Ganzberger; Geoffrey Michael,3,0,32,29
1657968950995,MATH 109,B02,083216,Ganzberger; Geoffrey Michael,3,0,32,29
1657968950995,MATH 109,B03,093479,Ganzberger; Geoffrey Michael,8,0,32,24
1657968957027,MATH 142A,A01,083219,Chow; Bennett,7,0,32,25
1657968957027,MATH 142A,A02,083220,Chow; Bennett,10,0,32,22
1657968957027,MATH 142A,A03,093480,Chow; Bennett,9,0,32,23
1657968957027,MATH 142A,B03,093481,Chow; Bennett,8,0,32,24
1657968957027,MATH 142A,B04,093558,Chow; Bennett,14,0,32,18
1657968957027,MATH 142A,B05,093559,Chow; Bennett,7,0,32,25
1657968963051,MATH 193A,A01,083224,Rotar; Vladimir,9,0,34,25
1657968963051,MATH 193A,A02,083225,Rotar; Vladimir,11,0,34,23
1657968963051,MATH 193A,A03,083781,Rotar; Vladimir,5,0,34,29
1657968963051,MATH 193A,A04,083782,Rotar; Vladimir,12,0,34,22
1657968963051,MATH 193A,A05,093482,Rotar; Vladimir,11,0,34,23
1657968969078,MATH 197,001,091859,McAuley; Julian John,9999,0,9999,0
1657968969078,MATH 197,002,095566,Kedlaya; Kiran S.,9997,0,9999,2
1657968969078,MATH 197,003,095567,Xiao; Ming,9999,0,9999,0
1657968969078,MATH 197,004,095571,Perols; Johan Lars,9998,0,9999,1
1657968976148,COGS 9,A01,083615,Shannon; Kyle Michael,11,0,75,64
1657968982173,COGS 11,A01,083617,Boyle; Mary E. T.,23,0,48,25
1657968988196,COGS 13,A01,083071,Bastos; Amalia Pinkusfeld,12,0,71,59
1657968994220,COGS 14A,A01,092681,Semenuks; Arturs,5,1,100,95
1657969000248,COGS 14B,A01,083073,Cheng; Tzu-Han,7,0,63,56
1657969006275,COGS 17,A01,092677,Semenuks; Arturs,7,0,81,74
1657969012300,COGS 100,A01,083619,Allen; Michael Gordon,17,0,70,53
1657969018329,COGS 101A,A01,083621,Davis; Joshua Daniel,9,0,68,59
1657969024368,COGS 101B,A01,091572,Allen; Michael Gordon,14,0,65,51
1657969030394,COGS 101C,A01,083625,Delgado; Tania,17,0,35,18
1657969036431,COGS 107A,A01,083627,Boyle; Mary E. T.,14,0,60,46
1657969042455,COGS 118A,A01,083075,Gupta; Anjum,21,0,76,55
1657969048480,CSE 3,A50,083646,Miranda; Gregory Joseph,24,0,50,26
1657969054510,CSE 8A,A50,083650,Miranda; Gregory Joseph,17,1,56,39
1657969060535,CSE 11,A01,083080,Cao; Yingjun,7,15,40,33
1657969066562,CSE 12,A01,083652,Krause-Levy; Sophia Louisa,30,1,120,90
1657969078653,CSE 15L,A01,083654,Morris; Justin Loren,9,0,50,41
1657969078653,CSE 15L,A02,083655,Morris; Justin Loren,11,0,50,39
1657969084680,CSE 20,A01,083657,Tran; Khoa Dang,39,0,80,41
1657969090706,CSE 21,A01,095574,Bach; Quang Tran,23,0,48,25
1657969096738,CSE 30,A01,083084,Eldon; John,8,0,80,72
1657969096738,CSE 30,B01,095061,Bhaskar; Nishant,9,0,50,41
1657969102762,CSE 100,A01,083659,Cao; Yingjun,5,4,70,65
1657969108790,CSE 134B,A01,083661,Powell; Thomas Allan,25,0,100,75
1657969114825,CSE 140,A01,083663,Gungor; Onat,17,0,85,68
1657969120849,CSE 140L,A01,083088,Eldon; John,23,0,100,77
1657969126880,CSE 175,A01,083665,Kumar; Rakesh,3,0,25,22
1657969132910,CSE 190,A00,092507,Dubnov; Shlomo,8,0,20,12
1657969138935,ECE 45,A01,083139,Congero; Spencer William,7,0,75,68
1657969144966,ECE 65,A50,083695,Saad; Andrew S,12,0,30,18
1657969144966,ECE 65,A51,095125,Saad; Andrew S,24,0,26,2
1657969150995,ECE 109,A01,091882,Touri; Behrouz,21,0,70,49
1657969157023,ECE 180,A00,083140,Abi Samra; Nicholas Camill,1,0,30,29
1657969157023,ECE 180,B00,083141,Abi Samra; Nicholas Camill,0,0,30,30
1657969163050,MATH 10A,A01,083735,Patchell; Gregory David,2,0,30,28
1657969163050,MATH 10A,A02,083736,Patchell; Gregory David,20,0,30,10
1657969163050,MATH 10A,A03,083737,Patchell; Gregory David,16,0,30,14
1657969169077,MATH 10B,A01,083207,Lim; Seonhee,9,0,34,25
1657969169077,MATH 10B,A02,083208,Lim; Seonhee,10,0,35,25
1657969169077,MATH 10B,A03,093472,Lim; Seonhee,7,0,34,27
1657969169077,MATH 10B,B01,083739,Sinha; Shubham,14,0,30,16
1657969175108,MATH 18,A01,083743,Cinel; Cameron Alexander,9,0,30,21
1657969175108,MATH 18,A02,083744,Cinel; Cameron Alexander,18,0,30,12
1657969175108,MATH 18,A03,083745,Cinel; Cameron Alexander,10,0,30,20
1657969175108,MATH 18,B01,083748,Rideout; David Porter,5,0,37,32
1657969175108,MATH 18,B02,083749,Rideout; David Porter,5,0,36,31
1657969175108,MATH 18,B03,083750,Rideout; David Porter,3,0,37,34
1657969175108,MATH 18,B04,083751,Rideout; David Porter,7,0,36,29
1657969175108,MATH 18,B05,093473,Rideout; David Porter,7,0,36,29
1657969175108,MATH 18,B06,093474,Rideout; David Porter,6,0,36,30
1657969181138,MATH 20A,A01,083754,Zheng; Zequn,14,0,40,26
1657969187175,MATH 20B,A01,083756,Briones; Jor-el Thomas Caparas,4,0,36,32
1657969187175,MATH 20B,A02,083757,Briones; Jor-el Thomas Caparas,1,0,36,35
1657969187175,MATH 20B,A03,093475,Briones; Jor-el Thomas Caparas,3,0,36,33
1657969193202,MATH 20C,A01,083760,Briones; Jor-el Thomas Caparas,1,0,35,34
1657969193202,MATH 20C,A02,083761,Briones; Jor-el Thomas Caparas,8,0,35,27
1657969193202,MATH 20C,A03,093476,Briones; Jor-el Thomas Caparas,0,1,36,36
1657969193202,MATH 20C,B01,083762,Bach; Quang Tran,1,0,30,29
1657969199237,MATH 20D,A01,083765,Tran; Brian Kha,5,0,30,25
1657969199237,MATH 20D,A02,083766,Tran; Brian Kha,5,0,30,25
1657969199237,MATH 20D,A03,083767,Tran; Brian Kha,6,0,30,24
1657969205265,MATH 20E,A01,083771,Ganguly; Soumya,12,0,32,20
1657969205265,MATH 20E,A02,083772,Ganguly; Soumya,7,0,32,25
1657969205265,MATH 20E,B01,083773,Ciotti; Benjamin,20,0,35,15
1657969205265,MATH 20E,B02,083774,Ciotti; Benjamin,18,0,35,17
1657969211297,MATH 103A,A01,083777,Greenfeld; Be'Eri,6,0,36,30
1657969211297,MATH 103A,A02,083778,Greenfeld; Be'Eri,5,0,36,31
1657969211297,MATH 103A,A03,093561,Greenfeld; Be'Eri,7,0,36,29
1657969211297,MATH 103A,B01,083779,Greenfeld; Be'Eri,8,0,36,28
1657969211297,MATH 103A,B02,083780,Greenfeld; Be'Eri,4,0,36,32
1657969211297,MATH 103A,B03,093562,Greenfeld; Be'Eri,3,0,36,33
1657969217322,MATH 105,A01,085443,Carter; Anne Toulson,15,0,35,20
1657969217322,MATH 105,A02,093477,Carter; Anne Toulson,20,0,35,15
1657969223348,MATH 109,A01,083213,Ganzberger; Geoffrey Michael,3,0,34,31
1657969223348,MATH 109,A02,083214,Ganzberger; Geoffrey Michael,4,0,34,30
1657969223348,MATH 109,A03,093478,Ganzberger; Geoffrey Michael,2,0,34,32
1657969223348,MATH 109,B01,083215,Ganzberger; Geoffrey Michael,3,0,32,29
1657969223348,MATH 109,B02,083216,Ganzberger; Geoffrey Michael,3,0,32,29
1657969223348,MATH 109,B03,093479,Ganzberger; Geoffrey Michael,8,0,32,24
1657969229371,MATH 142A,A01,083219,Chow; Bennett,7,0,32,25
1657969229371,MATH 142A,A02,083220,Chow; Bennett,10,0,32,22
1657969229371,MATH 142A,A03,093480,Chow; Bennett,9,0,32,23
1657969229371,MATH 142A,B03,093481,Chow; Bennett,8,0,32,24
1657969229371,MATH 142A,B04,093558,Chow; Bennett,14,0,32,18
1657969229371,MATH 142A,B05,093559,Chow; Bennett,7,0,32,25
1657969235402,MATH 193A,A01,083224,Rotar; Vladimir,9,0,34,25
1657969235402,MATH 193A,A02,083225,Rotar; Vladimir,11,0,34,23
1657969235402,MATH 193A,A03,083781,Rotar; Vladimir,5,0,34,29
1657969235402,MATH 193A,A04,083782,Rotar; Vladimir,12,0,34,22
1657969235402,MATH 193A,A05,093482,Rotar; Vladimir,11,0,34,23
1657969241434,MATH 197,001,091859,McAuley; Julian John,9999,0,9999,0
1657969241434,MATH 197,002,095566,Kedlaya; Kiran S.,9997,0,9999,2
1657969241434,MATH 197,003,095567,Xiao; Ming,9999,0,9999,0
1657969241434,MATH 197,004,095571,Perols; Johan Lars,9998,0,9999,1
1657969248507,COGS 9,A01,083615,Shannon; Kyle Michael,11,0,75,64
1657969254531,COGS 11,A01,083617,Boyle; Mary E. T.,23,0,48,25
1657969260555,COGS 13,A01,083071,Bastos; Amalia Pinkusfeld,12,0,71,59
1657969266579,COGS 14A,A01,092681,Semenuks; Arturs,5,1,100,95
1657969272610,COGS 14B,A01,083073,Cheng; Tzu-Han,7,0,63,56
1657969278633,COGS 17,A01,092677,Semenuks; Arturs,7,0,81,74
1657969284681,COGS 100,A01,083619,Allen; Michael Gordon,17,0,70,53
1657969290711,COGS 101A,A01,083621,Davis; Joshua Daniel,9,0,68,59
1657969296753,COGS 101B,A01,091572,Allen; Michael Gordon,14,0,65,51
1657969302777,COGS 101C,A01,083625,Delgado; Tania,17,0,35,18
1657969308804,COGS 107A,A01,083627,Boyle; Mary E. T.,14,0,60,46
1657969314827,COGS 118A,A01,083075,Gupta; Anjum,21,0,76,55
1657969320854,CSE 3,A50,083646,Miranda; Gregory Joseph,24,0,50,26
1657969326877,CSE 8A,A50,083650,Miranda; Gregory Joseph,17,1,56,39
1657969332906,CSE 11,A01,083080,Cao; Yingjun,7,15,40,33
1657969338933,CSE 12,A01,083652,Krause-Levy; Sophia Louisa,30,1,120,90
1657969344957,CSE 15L,A01,083654,Morris; Justin Loren,9,0,50,41
1657969344957,CSE 15L,A02,083655,Morris; Justin Loren,11,0,50,39
1657969350979,CSE 20,A01,083657,Tran; Khoa Dang,39,0,80,41
1657969357008,CSE 21,A01,095574,Bach; Quang Tran,23,0,48,25
1657969363037,CSE 30,A01,083084,Eldon; John,8,0,80,72
1657969363037,CSE 30,B01,095061,Bhaskar; Nishant,9,0,50,41
1657969369061,CSE 100,A01,083659,Cao; Yingjun,5,4,70,65
1657969375088,CSE 134B,A01,083661,Powell; Thomas Allan,25,0,100,75
1657969381113,CSE 140,A01,083663,Gungor; Onat,17,0,85,68
1657969387141,CSE 140L,A01,083088,Eldon; John,23,0,100,77
1657969393171,CSE 175,A01,083665,Kumar; Rakesh,3,0,25,22
1657969399198,CSE 190,A00,092507,Dubnov; Shlomo,8,0,20,12
1657969405309,ECE 45,A01,083139,Congero; Spencer William,7,0,75,68
1657969411339,ECE 65,A50,083695,Saad; Andrew S,12,0,30,18
1657969411339,ECE 65,A51,095125,Saad; Andrew S,24,0,26,2
1657969417365,ECE 109,A01,091882,Touri; Behrouz,21,0,70,49
1657969423393,ECE 180,A00,083140,Abi Samra; Nicholas Camill,1,0,30,29
1657969423393,ECE 180,B00,083141,Abi Samra; Nicholas Camill,0,0,30,30
1657969429421,MATH 10A,A01,083735,Patchell; Gregory David,2,0,30,28
1657969429421,MATH 10A,A02,083736,Patchell; Gregory David,20,0,30,10
1657969429421,MATH 10A,A03,083737,Patchell; Gregory David,16,0,30,14
1657969435456,MATH 10B,A01,083207,Lim; Seonhee,9,0,34,25
1657969435456,MATH 10B,A02,083208,Lim; Seonhee,10,0,35,25
1657969435456,MATH 10B,A03,093472,Lim; Seonhee,7,0,34,27
1657969435456,MATH 10B,B01,083739,Sinha; Shubham,14,0,30,16
1657969441488,MATH 18,A01,083743,Cinel; Cameron Alexander,9,0,30,21
1657969441488,MATH 18,A02,083744,Cinel; Cameron Alexander,18,0,30,12
1657969441488,MATH 18,A03,083745,Cinel; Cameron Alexander,10,0,30,20
1657969441488,MATH 18,B01,083748,Rideout; David Porter,5,0,37,32
1657969441488,MATH 18,B02,083749,Rideout; David Porter,5,0,36,31
1657969441488,MATH 18,B03,083750,Rideout; David Porter,3,0,37,34
1657969441488,MATH 18,B04,083751,Rideout; David Porter,7,0,36,29
1657969441488,MATH 18,B05,093473,Rideout; David Porter,7,0,36,29
1657969441488,MATH 18,B06,093474,Rideout; David Porter,6,0,36,30
1657969447519,MATH 20A,A01,083754,Zheng; Zequn,14,0,40,26
1657969453551,MATH 20B,A01,083756,Briones; Jor-el Thomas Caparas,4,0,36,32
1657969453551,MATH 20B,A02,083757,Briones; Jor-el Thomas Caparas,1,0,36,35
1657969453551,MATH 20B,A03,093475,Briones; Jor-el Thomas Caparas,3,0,36,33
1657969459580,MATH 20C,A01,083760,Briones; Jor-el Thomas Caparas,1,0,35,34
1657969459580,MATH 20C,A02,083761,Briones; Jor-el Thomas Caparas,8,0,35,27
1657969459580,MATH 20C,A03,093476,Briones; Jor-el Thomas Caparas,0,1,36,36
1657969459580,MATH 20C,B01,083762,Bach; Quang Tran,1,0,30,29
1657969465606,MATH 20D,A01,083765,Tran; Brian Kha,5,0,30,25
1657969465606,MATH 20D,A02,083766,Tran; Brian Kha,5,0,30,25
1657969465606,MATH 20D,A03,083767,Tran; Brian Kha,6,0,30,24
1657969471649,MATH 20E,A01,083771,Ganguly; Soumya,12,0,32,20
1657969471649,MATH 20E,A02,083772,Ganguly; Soumya,7,0,32,25
1657969471649,MATH 20E,B01,083773,Ciotti; Benjamin,20,0,35,15
1657969471649,MATH 20E,B02,083774,Ciotti; Benjamin,18,0,35,17
1657969477687,MATH 103A,A01,083777,Greenfeld; Be'Eri,6,0,36,30
1657969477687,MATH 103A,A02,083778,Greenfeld; Be'Eri,5,0,36,31
1657969477687,MATH 103A,A03,093561,Greenfeld; Be'Eri,7,0,36,29
1657969477687,MATH 103A,B01,083779,Greenfeld; Be'Eri,8,0,36,28
1657969477687,MATH 103A,B02,083780,Greenfeld; Be'Eri,4,0,36,32
1657969477687,MATH 103A,B03,093562,Greenfeld; Be'Eri,3,0,36,33
1657969483711,MATH 105,A01,085443,Carter; Anne Toulson,15,0,35,20
1657969483711,MATH 105,A02,093477,Carter; Anne Toulson,20,0,35,15
1657969489735,MATH 109,A01,083213,Ganzberger; Geoffrey Michael,3,0,34,31
1657969489735,MATH 109,A02,083214,Ganzberger; Geoffrey Michael,4,0,34,30
1657969489735,MATH 109,A03,093478,Ganzberger; Geoffrey Michael,2,0,34,32
1657969489735,MATH 109,B01,083215,Ganzberger; Geoffrey Michael,3,0,32,29
1657969489735,MATH 109,B02,083216,Ganzberger; Geoffrey Michael,3,0,32,29
1657969489735,MATH 109,B03,093479,Ganzberger; Geoffrey Michael,8,0,32,24
1657969495772,MATH 142A,A01,083219,Chow; Bennett,7,0,32,25
1657969495772,MATH 142A,A02,083220,Chow; Bennett,10,0,32,22
1657969495772,MATH 142A,A03,093480,Chow; Bennett,9,0,32,23
1657969495772,MATH 142A,B03,093481,Chow; Bennett,8,0,32,24
1657969495772,MATH 142A,B04,093558,Chow; Bennett,14,0,32,18
1657969495772,MATH 142A,B05,093559,Chow; Bennett,7,0,32,25
1657969501798,MATH 193A,A01,083224,Rotar; Vladimir,9,0,34,25
1657969501798,MATH 193A,A02,083225,Rotar; Vladimir,11,0,34,23
1657969501798,MATH 193A,A03,083781,Rotar; Vladimir,5,0,34,29
1657969501798,MATH 193A,A04,083782,Rotar; Vladimir,12,0,34,22
1657969501798,MATH 193A,A05,093482,Rotar; Vladimir,11,0,34,23
1657969507822,MATH 197,001,091859,McAuley; Julian John,9999,0,9999,0
1657969507822,MATH 197,002,095566,Kedlaya; Kiran S.,9997,0,9999,2
1657969507822,MATH 197,003,095567,Xiao; Ming,9999,0,9999,0
1657969507822,MATH 197,004,095571,Perols; Johan Lars,9998,0,9999,1
1657969514896,COGS 9,A01,083615,Shannon; Kyle Michael,11,0,75,64
1657969520926,COGS 11,A01,083617,Boyle; Mary E. T.,23,0,48,25
1657969526958,COGS 13,A01,083071,Bastos; Amalia Pinkusfeld,12,0,71,59
1657969532982,COGS 14A,A01,092681,Semenuks; Arturs,5,1,100,95
1657969539011,COGS 14B,A01,083073,Cheng; Tzu-Han,7,0,63,56
1657969545035,COGS 17,A01,092677,Semenuks; Arturs,7,0,81,74
1657969551060,COGS 100,A01,083619,Allen; Michael Gordon,17,0,70,53
1657969557088,COGS 101A,A01,083621,Davis; Joshua Daniel,9,0,68,59
1657969563112,COGS 101B,A01,091572,Allen; Michael Gordon,14,0,65,51
1657969569137,COGS 101C,A01,083625,Delgado; Tania,17,0,35,18
1657969575162,COGS 107A,A01,083627,Boyle; Mary E. T.,14,0,60,46
1657969581187,COGS 118A,A01,083075,Gupta; Anjum,21,0,76,55
1657969587212,CSE 3,A50,083646,Miranda; Gregory Joseph,24,0,50,26
1657969593242,CSE 8A,A50,083650,Miranda; Gregory Joseph,17,1,56,39
1657969599265,CSE 11,A01,083080,Cao; Yingjun,7,15,40,33
1657969605294,CSE 12,A01,083652,Krause-Levy; Sophia Louisa,30,1,120,90
1657969611320,CSE 15L,A01,083654,Morris; Justin Loren,9,0,50,41
1657969611320,CSE 15L,A02,083655,Morris; Justin Loren,11,0,50,39
1657969617344,CSE 20,A01,083657,Tran; Khoa Dang,39,0,80,41
1657969623373,CSE 21,A01,095574,Bach; Quang Tran,23,0,48,25
1657969629405,CSE 30,A01,083084,Eldon; John,8,0,80,72
1657969629405,CSE 30,B01,095061,Bhaskar; Nishant,9,0,50,41
1657969635431,CSE 100,A01,083659,Cao; Yingjun,5,4,70,65
1657969641454,CSE 134B,A01,083661,Powell; Thomas Allan,25,0,100,75
1657969647479,CSE 140,A01,083663,Gungor; Onat,17,0,85,68
1657969653505,CSE 140L,A01,083088,Eldon; John,23,0,100,77
1657969659529,CSE 175,A01,083665,Kumar; Rakesh,3,0,25,22
1657969665554,CSE 190,A00,092507,Dubnov; Shlomo,8,0,20,12
1657969671580,ECE 45,A01,083139,Congero; Spencer William,7,0,75,68
1657969677613,ECE 65,A50,083695,Saad; Andrew S,12,0,30,18
1657969677613,ECE 65,A51,095125,Saad; Andrew S,24,0,26,2
1657969683642,ECE 109,A01,091882,Touri; Behrouz,21,0,70,49
1657969689670,ECE 180,A00,083140,Abi Samra; Nicholas Camill,1,0,30,29
1657969689670,ECE 180,B00,083141,Abi Samra; Nicholas Camill,0,0,30,30
1657969695701,MATH 10A,A01,083735,Patchell; Gregory David,2,0,30,28
1657969695701,MATH 10A,A02,083736,Patchell; Gregory David,20,0,30,10
1657969695701,MATH 10A,A03,083737,Patchell; Gregory David,16,0,30,14
1657969701729,MATH 10B,A01,083207,Lim; Seonhee,9,0,34,25
1657969701729,MATH 10B,A02,083208,Lim; Seonhee,10,0,35,25
1657969701729,MATH 10B,A03,093472,Lim; Seonhee,7,0,34,27
1657969701729,MATH 10B,B01,083739,Sinha; Shubham,14,0,30,16
1657969707757,MATH 18,A01,083743,Cinel; Cameron Alexander,9,0,30,21
1657969707757,MATH 18,A02,083744,Cinel; Cameron Alexander,18,0,30,12
1657969707757,MATH 18,A03,083745,Cinel; Cameron Alexander,10,0,30,20
1657969707757,MATH 18,B01,083748,Rideout; David Porter,5,0,37,32
1657969707757,MATH 18,B02,083749,Rideout; David Porter,5,0,36,31
1657969707757,MATH 18,B03,083750,Rideout; David Porter,3,0,37,34
1657969707757,MATH 18,B04,083751,Rideout; David Porter,7,0,36,29
1657969707757,MATH 18,B05,093473,Rideout; David Porter,7,0,36,29
1657969707757,MATH 18,B06,093474,Rideout; David Porter,6,0,36,30
1657969713786,MATH 20A,A01,083754,Zheng; Zequn,14,0,40,26
1657969719816,MATH 20B,A01,083756,Briones; Jor-el Thomas Caparas,4,0,36,32
1657969719816,MATH 20B,A02,083757,Briones; Jor-el Thomas Caparas,1,0,36,35
1657969719816,MATH 20B,A03,093475,Briones; Jor-el Thomas Caparas,3,0,36,33
1657969725852,MATH 20C,A01,083760,Briones; Jor-el Thomas Caparas,1,0,35,34
1657969725852,MATH 20C,A02,083761,Briones; Jor-el Thomas Caparas,8,0,35,27
1657969725852,MATH 20C,A03,093476,Briones; Jor-el Thomas Caparas,0,1,36,36
1657969725852,MATH 20C,B01,083762,Bach; Quang Tran,1,0,30,29
1657969731876,MATH 20D,A01,083765,Tran; Brian Kha,5,0,30,25
1657969731876,MATH 20D,A02,083766,Tran; Brian Kha,5,0,30,25
1657969731876,MATH 20D,A03,083767,Tran; Brian Kha,6,0,30,24
1657969737904,MATH 20E,A01,083771,Ganguly; Soumya,12,0,32,20
1657969737904,MATH 20E,A02,083772,Ganguly; Soumya,7,0,32,25
1657969737904,MATH 20E,B01,083773,Ciotti; Benjamin,20,0,35,15
1657969737904,MATH 20E,B02,083774,Ciotti; Benjamin,18,0,35,17
1657969743937,MATH 103A,A01,083777,Greenfeld; Be'Eri,6,0,36,30
1657969743937,MATH 103A,A02,083778,Greenfeld; Be'Eri,5,0,36,31
1657969743937,MATH 103A,A03,093561,Greenfeld; Be'Eri,7,0,36,29
1657969743937,MATH 103A,B01,083779,Greenfeld; Be'Eri,8,0,36,28
1657969743937,MATH 103A,B02,083780,Greenfeld; Be'Eri,4,0,36,32
1657969743937,MATH 103A,B03,093562,Greenfeld; Be'Eri,3,0,36,33
1657969749966,MATH 105,A01,085443,Carter; Anne Toulson,15,0,35,20
1657969749966,MATH 105,A02,093477,Carter; Anne Toulson,20,0,35,15
1657969755990,MATH 109,A01,083213,Ganzberger; Geoffrey Michael,3,0,34,31
1657969755990,MATH 109,A02,083214,Ganzberger; Geoffrey Michael,4,0,34,30
1657969755990,MATH 109,A03,093478,Ganzberger; Geoffrey Michael,2,0,34,32
1657969755990,MATH 109,B01,083215,Ganzberger; Geoffrey Michael,3,0,32,29
1657969755990,MATH 109,B02,083216,Ganzberger; Geoffrey Michael,3,0,32,29
1657969755990,MATH 109,B03,093479,Ganzberger; Geoffrey Michael,8,0,32,24
1657969762023,MATH 142A,A01,083219,Chow; Bennett,7,0,32,25
1657969762023,MATH 142A,A02,083220,Chow; Bennett,10,0,32,22
1657969762023,MATH 142A,A03,093480,Chow; Bennett,9,0,32,23
1657969762023,MATH 142A,B03,093481,Chow; Bennett,8,0,32,24
1657969762023,MATH 142A,B04,093558,Chow; Bennett,14,0,32,18
1657969762023,MATH 142A,B05,093559,Chow; Bennett,7,0,32,25
1657969768047,MATH 193A,A01,083224,Rotar; Vladimir,9,0,34,25
1657969768047,MATH 193A,A02,083225,Rotar; Vladimir,11,0,34,23
1657969768047,MATH 193A,A03,083781,Rotar; Vladimir,5,0,34,29
1657969768047,MATH 193A,A04,083782,Rotar; Vladimir,12,0,34,22
1657969768047,MATH 193A,A05,093482,Rotar; Vladimir,11,0,34,23
1657969774069,MATH 197,001,091859,McAuley; Julian John,9999,0,9999,0
1657969774069,MATH 197,002,095566,Kedlaya; Kiran S.,9997,0,9999,2
1657969774069,MATH 197,003,095567,Xiao; Ming,9999,0,9999,0
1657969774069,MATH 197,004,095571,Perols; Johan Lars,9998,0,9999,1
1657969781133,COGS 9,A01,083615,Shannon; Kyle Michael,11,0,75,64
1657969787177,COGS 11,A01,083617,Boyle; Mary E. T.,23,0,48,25
1657969793218,COGS 13,A01,083071,Bastos; Amalia Pinkusfeld,12,0,71,59
1657969799244,COGS 14A,A01,092681,Semenuks; Arturs,5,1,100,95
1657969805269,COGS 14B,A01,083073,Cheng; Tzu-Han,7,0,63,56
1657969811292,COGS 17,A01,092677,Semenuks; Arturs,7,0,81,74
1657969817320,COGS 100,A01,083619,Allen; Michael Gordon,17,0,70,53
1657969823349,COGS 101A,A01,083621,Davis; Joshua Daniel,9,0,68,59
1657969829372,COGS 101B,A01,091572,Allen; Michael Gordon,14,0,65,51
1657969835397,COGS 101C,A01,083625,Delgado; Tania,17,0,35,18
1657969841424,COGS 107A,A01,083627,Boyle; Mary E. T.,14,0,60,46
1657969847449,COGS 118A,A01,083075,Gupta; Anjum,21,0,76,55
1657969853475,CSE 3,A50,083646,Miranda; Gregory Joseph,24,0,50,26
1657969859505,CSE 8A,A50,083650,Miranda; Gregory Joseph,17,1,56,39
1657969865540,CSE 11,A01,083080,Cao; Yingjun,7,15,40,33
1657969871566,CSE 12,A01,083652,Krause-Levy; Sophia Louisa,30,1,120,90
1657969877591,CSE 15L,A01,083654,Morris; Justin Loren,9,0,50,41
1657969877591,CSE 15L,A02,083655,Morris; Justin Loren,11,0,50,39
1657969883618,CSE 20,A01,083657,Tran; Khoa Dang,39,0,80,41
1657969889642,CSE 21,A01,095574,Bach; Quang Tran,23,0,48,25
1657969895667,CSE 30,A01,083084,Eldon; John,8,0,80,72
1657969895667,CSE 30,B01,095061,Bhaskar; Nishant,9,0,50,41
1657969901691,CSE 100,A01,083659,Cao; Yingjun,5,4,70,65
1657969907715,CSE 134B,A01,083661,Powell; Thomas Allan,25,0,100,75
1657969917773,CSE 140,A01,083663,Gungor; Onat,17,0,85,68
1657969923803,CSE 140L,A01,083088,Eldon; John,23,0,100,77
1657969929833,CSE 175,A01,083665,Kumar; Rakesh,3,0,25,22
1657969935858,CSE 190,A00,092507,Dubnov; Shlomo,8,0,20,12
1657969941885,ECE 45,A01,083139,Congero; Spencer William,7,0,75,68
1657969947917,ECE 65,A50,083695,Saad; Andrew S,12,0,30,18
1657969947917,ECE 65,A51,095125,Saad; Andrew S,24,0,26,2
