time,subj_course_id,sec_code,sec_id,prof,available,waitlist,total,enrolled_ct
1657106063749,COGS 9,A01,083615,Shannon; Kyle Michael,7,0,75,68
1657106069783,COGS 11,A01,083617,Boyle; Mary E. T.,21,0,48,27
1657106075811,COGS 13,A01,083071,Bastos; Amalia Pinkusfeld,9,0,71,62
1657106081841,COGS 14A,A01,092681,Semenuks; Arturs,1,1,100,99
1657106087871,COGS 14B,A01,083073,Cheng; Tzu-Han,6,0,63,57
1657106093903,COGS 17,A01,092677,Semenuks; Arturs,4,0,81,77
1657106099933,COGS 100,A01,083619,Allen; Michael Gordon,15,0,70,55
1657106105962,COGS 101A,A01,083621,Davis; Joshua Daniel,9,0,68,59
1657106111994,COGS 101B,A01,091572,Allen; Michael Gordon,8,0,65,57
1657106118025,COGS 101C,A01,083625,Delgado; Tania,17,0,35,18
1657106124056,COGS 107A,A01,083627,Boyle; Mary E. T.,13,0,60,47
1657106130090,COGS 118A,A01,083075,Gupta; Anjum,15,0,76,61
1657106136121,CSE 3,A50,083646,Miranda; Gregory Joseph,22,0,50,28
1657106142152,CSE 8A,A50,083650,Miranda; Gregory Joseph,17,1,56,39
1657106148181,CSE 11,A01,083080,Cao; Yingjun,4,15,40,36
1657106154219,CSE 12,A01,083652,Krause-Levy; Sophia Louisa,23,1,120,97
1657106160247,CSE 15L,A01,083654,Morris; Justin Loren,9,0,50,41
1657106160247,CSE 15L,A02,083655,Morris; Justin Loren,9,0,50,41
1657106166279,CSE 20,A01,083657,Tran; Khoa Dang,37,0,80,43
1657106172305,CSE 21,A01,095574,Bach; Quang Tran,21,0,48,27
1657106178345,CSE 30,A01,083084,Eldon; John,4,0,80,76
1657106178345,CSE 30,B01,095061,Bhaskar; Nishant,6,0,50,44
1657106184381,CSE 100,A01,083659,Cao; Yingjun,4,4,70,66
1657106190410,CSE 134B,A01,083661,Powell; Thomas Allan,19,0,100,81
1657106196439,CSE 140,A01,083663,Gungor; Onat,14,0,85,71
1657106202469,CSE 140L,A01,083088,Eldon; John,16,0,100,84
1657106208511,CSE 175,A01,083665,Kumar; Rakesh,3,0,25,22
1657106214548,CSE 190,A00,092507,Dubnov; Shlomo,7,0,20,13
1657106220583,ECE 45,A01,083139,Congero; Spencer William,5,0,75,70
1657106226620,ECE 65,A50,083695,Saad; Andrew S,12,0,30,18
1657106226620,ECE 65,A51,095125,Saad; Andrew S,25,0,26,1
1657106232654,ECE 109,A01,091882,Touri; Behrouz,16,0,70,54
1657106238683,ECE 180,A00,083140,Abi Samra; Nicholas Camill,1,0,30,29
1657106238683,ECE 180,B00,083141,Abi Samra; Nicholas Camill,0,0,30,30
1657106244715,MATH 10A,A01,083735,Patchell; Gregory David,1,0,30,29
1657106244715,MATH 10A,A02,083736,Patchell; Gregory David,20,0,30,10
1657106244715,MATH 10A,A03,083737,Patchell; Gregory David,16,0,30,14
1657106250760,MATH 10B,A01,083207,Lim; Seonhee,7,0,34,27
1657106250760,MATH 10B,A02,083208,Lim; Seonhee,9,0,35,26
1657106250760,MATH 10B,A03,093472,Lim; Seonhee,5,0,34,29
1657106250760,MATH 10B,B01,083739,Sinha; Shubham,9,0,30,21
1657106256795,MATH 18,A01,083743,Cinel; Cameron Alexander,6,0,30,24
1657106256795,MATH 18,A02,083744,Cinel; Cameron Alexander,15,0,30,15
1657106256795,MATH 18,A03,083745,Cinel; Cameron Alexander,8,0,30,22
1657106256795,MATH 18,B01,083748,Rideout; David Porter,4,0,37,33
1657106256795,MATH 18,B02,083749,Rideout; David Porter,3,0,36,33
1657106256795,MATH 18,B03,083750,Rideout; David Porter,2,0,37,35
1657106256795,MATH 18,B04,083751,Rideout; David Porter,5,0,36,31
1657106256795,MATH 18,B05,093473,Rideout; David Porter,4,0,36,32
1657106256795,MATH 18,B06,093474,Rideout; David Porter,5,0,36,31
1657106262821,MATH 20A,A01,083754,Zheng; Zequn,12,0,40,28
1657106268859,MATH 20B,A01,083756,Briones; Jor-el Thomas Caparas,1,0,36,35
1657106268859,MATH 20B,A02,083757,Briones; Jor-el Thomas Caparas,1,0,36,35
1657106268859,MATH 20B,A03,093475,Briones; Jor-el Thomas Caparas,0,0,36,36
1657106274895,MATH 20C,A01,083760,Briones; Jor-el Thomas Caparas,1,0,35,34
1657106274895,MATH 20C,A02,083761,Briones; Jor-el Thomas Caparas,8,0,35,27
1657106274895,MATH 20C,A03,093476,Briones; Jor-el Thomas Caparas,0,1,36,36
1657106274895,MATH 20C,B01,083762,Bach; Quang Tran,0,0,30,30
1657106280926,MATH 20D,A01,083765,Tran; Brian Kha,4,0,30,26
1657106280926,MATH 20D,A02,083766,Tran; Brian Kha,5,0,30,25
1657106280926,MATH 20D,A03,083767,Tran; Brian Kha,3,0,30,27
1657106286959,MATH 20E,A01,083771,Ganguly; Soumya,6,0,32,26
1657106286959,MATH 20E,A02,083772,Ganguly; Soumya,6,0,32,26
1657106286959,MATH 20E,B01,083773,Ciotti; Benjamin,18,0,35,17
1657106286959,MATH 20E,B02,083774,Ciotti; Benjamin,17,0,35,18
1657106292999,MATH 103A,A01,083777,Greenfeld; Be'Eri,2,0,36,34
1657106292999,MATH 103A,A02,083778,Greenfeld; Be'Eri,5,0,36,31
1657106292999,MATH 103A,A03,093561,Greenfeld; Be'Eri,4,0,36,32
1657106292999,MATH 103A,B01,083779,Greenfeld; Be'Eri,6,0,36,30
1657106292999,MATH 103A,B02,083780,Greenfeld; Be'Eri,2,0,36,34
1657106292999,MATH 103A,B03,093562,Greenfeld; Be'Eri,3,0,36,33
1657106299027,MATH 105,A01,085443,Carter; Anne Toulson,14,0,35,21
1657106299027,MATH 105,A02,093477,Carter; Anne Toulson,20,0,35,15
1657106305056,MATH 109,A01,083213,Ganzberger; Geoffrey Michael,2,0,34,32
1657106305056,MATH 109,A02,083214,Ganzberger; Geoffrey Michael,3,0,34,31
1657106305056,MATH 109,A03,093478,Ganzberger; Geoffrey Michael,1,0,34,33
1657106305056,MATH 109,B01,083215,Ganzberger; Geoffrey Michael,1,0,32,31
1657106305056,MATH 109,B02,083216,Ganzberger; Geoffrey Michael,1,0,32,31
1657106305056,MATH 109,B03,093479,Ganzberger; Geoffrey Michael,6,0,32,26
1657106311088,MATH 142A,A01,083219,Chow; Bennett,6,0,32,26
1657106311088,MATH 142A,A02,083220,Chow; Bennett,10,0,32,22
1657106311088,MATH 142A,A03,093480,Chow; Bennett,7,0,32,25
1657106311088,MATH 142A,B03,093481,Chow; Bennett,8,0,32,24
1657106311088,MATH 142A,B04,093558,Chow; Bennett,11,0,32,21
1657106311088,MATH 142A,B05,093559,Chow; Bennett,6,0,32,26
1657106317118,MATH 193A,A01,083224,Rotar; Vladimir,7,0,34,27
1657106317118,MATH 193A,A02,083225,Rotar; Vladimir,5,0,34,29
1657106317118,MATH 193A,A03,083781,Rotar; Vladimir,1,0,34,33
1657106317118,MATH 193A,A04,083782,Rotar; Vladimir,6,0,34,28
1657106317118,MATH 193A,A05,093482,Rotar; Vladimir,6,0,34,28
1657106323150,MATH 197,001,091859,McAuley; Julian John,9999,0,9999,0
1657106323150,MATH 197,002,095566,Kedlaya; Kiran S.,9997,0,9999,2
1657106323150,MATH 197,003,095567,Xiao; Ming,9999,0,9999,0
1657106323150,MATH 197,004,095571,Perols; Johan Lars,9998,0,9999,1
1657106330235,COGS 9,A01,083615,Shannon; Kyle Michael,7,0,75,68
1657106336263,COGS 11,A01,083617,Boyle; Mary E. T.,21,0,48,27
1657106342293,COGS 13,A01,083071,Bastos; Amalia Pinkusfeld,9,0,71,62
1657106348322,COGS 14A,A01,092681,Semenuks; Arturs,1,1,100,99
1657106354351,COGS 14B,A01,083073,Cheng; Tzu-Han,6,0,63,57
1657106360376,COGS 17,A01,092677,Semenuks; Arturs,4,0,81,77
1657106366415,COGS 100,A01,083619,Allen; Michael Gordon,15,0,70,55
1657106372441,COGS 101A,A01,083621,Davis; Joshua Daniel,9,0,68,59
1657106378475,COGS 101B,A01,091572,Allen; Michael Gordon,8,0,65,57
1657106384506,COGS 101C,A01,083625,Delgado; Tania,17,0,35,18
1657106390534,COGS 107A,A01,083627,Boyle; Mary E. T.,13,0,60,47
1657106396564,COGS 118A,A01,083075,Gupta; Anjum,15,0,76,61
1657106402595,CSE 3,A50,083646,Miranda; Gregory Joseph,22,0,50,28
1657106408630,CSE 8A,A50,083650,Miranda; Gregory Joseph,17,1,56,39
1657106414665,CSE 11,A01,083080,Cao; Yingjun,4,15,40,36
1657106420696,CSE 12,A01,083652,Krause-Levy; Sophia Louisa,23,1,120,97
1657106426728,CSE 15L,A01,083654,Morris; Justin Loren,9,0,50,41
1657106426728,CSE 15L,A02,083655,Morris; Justin Loren,9,0,50,41
1657106432758,CSE 20,A01,083657,Tran; Khoa Dang,37,0,80,43
1657106438790,CSE 21,A01,095574,Bach; Quang Tran,21,0,48,27
1657106444821,CSE 30,A01,083084,Eldon; John,4,0,80,76
1657106444821,CSE 30,B01,095061,Bhaskar; Nishant,6,0,50,44
1657106450853,CSE 100,A01,083659,Cao; Yingjun,4,4,70,66
1657106456883,CSE 134B,A01,083661,Powell; Thomas Allan,19,0,100,81
1657106462911,CSE 140,A01,083663,Gungor; Onat,14,0,85,71
1657106468942,CSE 140L,A01,083088,Eldon; John,16,0,100,84
1657106474968,CSE 175,A01,083665,Kumar; Rakesh,3,0,25,22
1657106480998,CSE 190,A00,092507,Dubnov; Shlomo,7,0,20,13
1657106487029,ECE 45,A01,083139,Congero; Spencer William,5,0,75,70
1657106493065,ECE 65,A50,083695,Saad; Andrew S,12,0,30,18
1657106493065,ECE 65,A51,095125,Saad; Andrew S,25,0,26,1
1657106499093,ECE 109,A01,091882,Touri; Behrouz,16,0,70,54
1657106505132,ECE 180,A00,083140,Abi Samra; Nicholas Camill,1,0,30,29
1657106505132,ECE 180,B00,083141,Abi Samra; Nicholas Camill,0,0,30,30
1657106511164,MATH 10A,A01,083735,Patchell; Gregory David,1,0,30,29
1657106511164,MATH 10A,A02,083736,Patchell; Gregory David,20,0,30,10
1657106511164,MATH 10A,A03,083737,Patchell; Gregory David,16,0,30,14
1657106517197,MATH 10B,A01,083207,Lim; Seonhee,7,0,34,27
1657106517197,MATH 10B,A02,083208,Lim; Seonhee,9,0,35,26
1657106517197,MATH 10B,A03,093472,Lim; Seonhee,5,0,34,29
1657106517197,MATH 10B,B01,083739,Sinha; Shubham,9,0,30,21
1657106523244,MATH 18,A01,083743,Cinel; Cameron Alexander,6,0,30,24
1657106523244,MATH 18,A02,083744,Cinel; Cameron Alexander,15,0,30,15
1657106523244,MATH 18,A03,083745,Cinel; Cameron Alexander,8,0,30,22
1657106523244,MATH 18,B01,083748,Rideout; David Porter,4,0,37,33
1657106523244,MATH 18,B02,083749,Rideout; David Porter,3,0,36,33
1657106523244,MATH 18,B03,083750,Rideout; David Porter,2,0,37,35
1657106523244,MATH 18,B04,083751,Rideout; David Porter,5,0,36,31
1657106523244,MATH 18,B05,093473,Rideout; David Porter,4,0,36,32
1657106523244,MATH 18,B06,093474,Rideout; David Porter,5,0,36,31
1657106529278,MATH 20A,A01,083754,Zheng; Zequn,12,0,40,28
1657106535306,MATH 20B,A01,083756,Briones; Jor-el Thomas Caparas,1,0,36,35
1657106535306,MATH 20B,A02,083757,Briones; Jor-el Thomas Caparas,1,0,36,35
1657106535306,MATH 20B,A03,093475,Briones; Jor-el Thomas Caparas,0,0,36,36
1657106541336,MATH 20C,A01,083760,Briones; Jor-el Thomas Caparas,1,0,35,34
1657106541336,MATH 20C,A02,083761,Briones; Jor-el Thomas Caparas,8,0,35,27
1657106541336,MATH 20C,A03,093476,Briones; Jor-el Thomas Caparas,0,1,36,36
1657106541336,MATH 20C,B01,083762,Bach; Quang Tran,0,0,30,30
1657106547361,MATH 20D,A01,083765,Tran; Brian Kha,4,0,30,26
1657106547361,MATH 20D,A02,083766,Tran; Brian Kha,5,0,30,25
1657106547361,MATH 20D,A03,083767,Tran; Brian Kha,3,0,30,27
1657106553397,MATH 20E,A01,083771,Ganguly; Soumya,6,0,32,26
1657106553397,MATH 20E,A02,083772,Ganguly; Soumya,6,0,32,26
1657106553397,MATH 20E,B01,083773,Ciotti; Benjamin,18,0,35,17
1657106553397,MATH 20E,B02,083774,Ciotti; Benjamin,17,0,35,18
1657106559429,MATH 103A,A01,083777,Greenfeld; Be'Eri,2,0,36,34
1657106559429,MATH 103A,A02,083778,Greenfeld; Be'Eri,5,0,36,31
1657106559429,MATH 103A,A03,093561,Greenfeld; Be'Eri,4,0,36,32
1657106559429,MATH 103A,B01,083779,Greenfeld; Be'Eri,6,0,36,30
1657106559429,MATH 103A,B02,083780,Greenfeld; Be'Eri,2,0,36,34
1657106559429,MATH 103A,B03,093562,Greenfeld; Be'Eri,3,0,36,33
1657106565456,MATH 105,A01,085443,Carter; Anne Toulson,14,0,35,21
1657106565456,MATH 105,A02,093477,Carter; Anne Toulson,20,0,35,15
1657106571493,MATH 109,A01,083213,Ganzberger; Geoffrey Michael,2,0,34,32
1657106571493,MATH 109,A02,083214,Ganzberger; Geoffrey Michael,3,0,34,31
1657106571493,MATH 109,A03,093478,Ganzberger; Geoffrey Michael,1,0,34,33
1657106571493,MATH 109,B01,083215,Ganzberger; Geoffrey Michael,1,0,32,31
1657106571493,MATH 109,B02,083216,Ganzberger; Geoffrey Michael,1,0,32,31
1657106571493,MATH 109,B03,093479,Ganzberger; Geoffrey Michael,6,0,32,26
1657106577521,MATH 142A,A01,083219,Chow; Bennett,6,0,32,26
1657106577521,MATH 142A,A02,083220,Chow; Bennett,10,0,32,22
1657106577521,MATH 142A,A03,093480,Chow; Bennett,7,0,32,25
1657106577521,MATH 142A,B03,093481,Chow; Bennett,8,0,32,24
1657106577521,MATH 142A,B04,093558,Chow; Bennett,11,0,32,21
1657106577521,MATH 142A,B05,093559,Chow; Bennett,6,0,32,26
1657106583551,MATH 193A,A01,083224,Rotar; Vladimir,7,0,34,27
1657106583551,MATH 193A,A02,083225,Rotar; Vladimir,5,0,34,29
1657106583551,MATH 193A,A03,083781,Rotar; Vladimir,1,0,34,33
1657106583551,MATH 193A,A04,083782,Rotar; Vladimir,6,0,34,28
1657106583551,MATH 193A,A05,093482,Rotar; Vladimir,6,0,34,28
1657106589580,MATH 197,001,091859,McAuley; Julian John,9999,0,9999,0
1657106589580,MATH 197,002,095566,Kedlaya; Kiran S.,9997,0,9999,2
1657106589580,MATH 197,003,095567,Xiao; Ming,9999,0,9999,0
1657106589580,MATH 197,004,095571,Perols; Johan Lars,9998,0,9999,1
1657106596675,COGS 9,A01,083615,Shannon; Kyle Michael,7,0,75,68
1657106602707,COGS 11,A01,083617,Boyle; Mary E. T.,21,0,48,27
1657106608734,COGS 13,A01,083071,Bastos; Amalia Pinkusfeld,9,0,71,62
1657106614764,COGS 14A,A01,092681,Semenuks; Arturs,1,1,100,99
1657106620794,COGS 14B,A01,083073,Cheng; Tzu-Han,6,0,63,57
1657106626827,COGS 17,A01,092677,Semenuks; Arturs,4,0,81,77
1657106632861,COGS 100,A01,083619,Allen; Michael Gordon,15,0,70,55
1657106638967,COGS 101A,A01,083621,Davis; Joshua Daniel,9,0,68,59
1657106644996,COGS 101B,A01,091572,Allen; Michael Gordon,8,0,65,57
1657106651026,COGS 101C,A01,083625,Delgado; Tania,17,0,35,18
1657106657059,COGS 107A,A01,083627,Boyle; Mary E. T.,13,0,60,47
1657106663089,COGS 118A,A01,083075,Gupta; Anjum,15,0,76,61
1657106669126,CSE 3,A50,083646,Miranda; Gregory Joseph,22,0,50,28
1657106675158,CSE 8A,A50,083650,Miranda; Gregory Joseph,17,1,56,39
1657106681186,CSE 11,A01,083080,Cao; Yingjun,4,15,40,36
1657106687220,CSE 12,A01,083652,Krause-Levy; Sophia Louisa,23,1,120,97
1657106693254,CSE 15L,A01,083654,Morris; Justin Loren,9,0,50,41
1657106693254,CSE 15L,A02,083655,Morris; Justin Loren,9,0,50,41
1657106699285,CSE 20,A01,083657,Tran; Khoa Dang,37,0,80,43
1657106705332,CSE 21,A01,095574,Bach; Quang Tran,21,0,48,27
1657106711372,CSE 30,A01,083084,Eldon; John,4,0,80,76
1657106711372,CSE 30,B01,095061,Bhaskar; Nishant,6,0,50,44
1657106717405,CSE 100,A01,083659,Cao; Yingjun,4,4,70,66
1657106723432,CSE 134B,A01,083661,Powell; Thomas Allan,19,0,100,81
1657106729461,CSE 140,A01,083663,Gungor; Onat,14,0,85,71
1657106735488,CSE 140L,A01,083088,Eldon; John,16,0,100,84
1657106741521,CSE 175,A01,083665,Kumar; Rakesh,3,0,25,22
1657106747551,CSE 190,A00,092507,Dubnov; Shlomo,7,0,20,13
1657106753581,ECE 45,A01,083139,Congero; Spencer William,5,0,75,70
1657106759616,ECE 65,A50,083695,Saad; Andrew S,12,0,30,18
1657106759616,ECE 65,A51,095125,Saad; Andrew S,25,0,26,1
1657106765649,ECE 109,A01,091882,Touri; Behrouz,16,0,70,54
1657106771678,ECE 180,A00,083140,Abi Samra; Nicholas Camill,1,0,30,29
1657106771678,ECE 180,B00,083141,Abi Samra; Nicholas Camill,0,0,30,30
1657106777709,MATH 10A,A01,083735,Patchell; Gregory David,1,0,30,29
1657106777709,MATH 10A,A02,083736,Patchell; Gregory David,20,0,30,10
1657106777709,MATH 10A,A03,083737,Patchell; Gregory David,16,0,30,14
1657106783746,MATH 10B,A01,083207,Lim; Seonhee,7,0,34,27
1657106783746,MATH 10B,A02,083208,Lim; Seonhee,9,0,35,26
1657106783746,MATH 10B,A03,093472,Lim; Seonhee,5,0,34,29
1657106783746,MATH 10B,B01,083739,Sinha; Shubham,9,0,30,21
1657106789784,MATH 18,A01,083743,Cinel; Cameron Alexander,6,0,30,24
1657106789784,MATH 18,A02,083744,Cinel; Cameron Alexander,15,0,30,15
1657106789784,MATH 18,A03,083745,Cinel; Cameron Alexander,8,0,30,22
1657106789784,MATH 18,B01,083748,Rideout; David Porter,4,0,37,33
1657106789784,MATH 18,B02,083749,Rideout; David Porter,3,0,36,33
1657106789784,MATH 18,B03,083750,Rideout; David Porter,2,0,37,35
1657106789784,MATH 18,B04,083751,Rideout; David Porter,5,0,36,31
1657106789784,MATH 18,B05,093473,Rideout; David Porter,4,0,36,32
1657106789784,MATH 18,B06,093474,Rideout; David Porter,5,0,36,31
1657106795828,MATH 20A,A01,083754,Zheng; Zequn,12,0,40,28
1657106801859,MATH 20B,A01,083756,Briones; Jor-el Thomas Caparas,1,0,36,35
1657106801859,MATH 20B,A02,083757,Briones; Jor-el Thomas Caparas,1,0,36,35
1657106801859,MATH 20B,A03,093475,Briones; Jor-el Thomas Caparas,0,0,36,36
1657106807892,MATH 20C,A01,083760,Briones; Jor-el Thomas Caparas,1,0,35,34
1657106807892,MATH 20C,A02,083761,Briones; Jor-el Thomas Caparas,8,0,35,27
1657106807892,MATH 20C,A03,093476,Briones; Jor-el Thomas Caparas,0,1,36,36
1657106807892,MATH 20C,B01,083762,Bach; Quang Tran,0,0,30,30
1657106813922,MATH 20D,A01,083765,Tran; Brian Kha,4,0,30,26
1657106813922,MATH 20D,A02,083766,Tran; Brian Kha,5,0,30,25
1657106813922,MATH 20D,A03,083767,Tran; Brian Kha,3,0,30,27
1657106819952,MATH 20E,A01,083771,Ganguly; Soumya,6,0,32,26
1657106819952,MATH 20E,A02,083772,Ganguly; Soumya,6,0,32,26
1657106819952,MATH 20E,B01,083773,Ciotti; Benjamin,18,0,35,17
1657106819952,MATH 20E,B02,083774,Ciotti; Benjamin,17,0,35,18
1657106825981,MATH 103A,A01,083777,Greenfeld; Be'Eri,2,0,36,34
1657106825981,MATH 103A,A02,083778,Greenfeld; Be'Eri,5,0,36,31
1657106825981,MATH 103A,A03,093561,Greenfeld; Be'Eri,4,0,36,32
1657106825981,MATH 103A,B01,083779,Greenfeld; Be'Eri,6,0,36,30
1657106825981,MATH 103A,B02,083780,Greenfeld; Be'Eri,2,0,36,34
1657106825981,MATH 103A,B03,093562,Greenfeld; Be'Eri,3,0,36,33
1657106832017,MATH 105,A01,085443,Carter; Anne Toulson,14,0,35,21
1657106832017,MATH 105,A02,093477,Carter; Anne Toulson,20,0,35,15
1657106838050,MATH 109,A01,083213,Ganzberger; Geoffrey Michael,2,0,34,32
1657106838050,MATH 109,A02,083214,Ganzberger; Geoffrey Michael,3,0,34,31
1657106838050,MATH 109,A03,093478,Ganzberger; Geoffrey Michael,1,0,34,33
1657106838050,MATH 109,B01,083215,Ganzberger; Geoffrey Michael,1,0,32,31
1657106838050,MATH 109,B02,083216,Ganzberger; Geoffrey Michael,1,0,32,31
1657106838050,MATH 109,B03,093479,Ganzberger; Geoffrey Michael,6,0,32,26
1657106844083,MATH 142A,A01,083219,Chow; Bennett,6,0,32,26
1657106844083,MATH 142A,A02,083220,Chow; Bennett,10,0,32,22
1657106844083,MATH 142A,A03,093480,Chow; Bennett,7,0,32,25
1657106844083,MATH 142A,B03,093481,Chow; Bennett,8,0,32,24
1657106844083,MATH 142A,B04,093558,Chow; Bennett,11,0,32,21
1657106844083,MATH 142A,B05,093559,Chow; Bennett,6,0,32,26
1657106850114,MATH 193A,A01,083224,Rotar; Vladimir,7,0,34,27
1657106850114,MATH 193A,A02,083225,Rotar; Vladimir,5,0,34,29
1657106850114,MATH 193A,A03,083781,Rotar; Vladimir,1,0,34,33
1657106850114,MATH 193A,A04,083782,Rotar; Vladimir,6,0,34,28
1657106850114,MATH 193A,A05,093482,Rotar; Vladimir,6,0,34,28
1657106856140,MATH 197,001,091859,McAuley; Julian John,9999,0,9999,0
1657106856140,MATH 197,002,095566,Kedlaya; Kiran S.,9997,0,9999,2
1657106856140,MATH 197,003,095567,Xiao; Ming,9999,0,9999,0
1657106856140,MATH 197,004,095571,Perols; Johan Lars,9998,0,9999,1
1657106863221,COGS 9,A01,083615,Shannon; Kyle Michael,7,0,75,68
1657106869247,COGS 11,A01,083617,Boyle; Mary E. T.,21,0,48,27
1657106875281,COGS 13,A01,083071,Bastos; Amalia Pinkusfeld,9,0,71,62
1657106881309,COGS 14A,A01,092681,Semenuks; Arturs,1,1,100,99
1657106887337,COGS 14B,A01,083073,Cheng; Tzu-Han,6,0,63,57
1657106893366,COGS 17,A01,092677,Semenuks; Arturs,4,0,81,77
1657106899395,COGS 100,A01,083619,Allen; Michael Gordon,15,0,70,55
1657106905424,COGS 101A,A01,083621,Davis; Joshua Daniel,9,0,68,59
1657106911449,COGS 101B,A01,091572,Allen; Michael Gordon,8,0,65,57
1657106917481,COGS 101C,A01,083625,Delgado; Tania,17,0,35,18
1657106923525,COGS 107A,A01,083627,Boyle; Mary E. T.,13,0,60,47
1657106929555,COGS 118A,A01,083075,Gupta; Anjum,15,0,76,61
1657106935591,CSE 3,A50,083646,Miranda; Gregory Joseph,22,0,50,28
1657106941615,CSE 8A,A50,083650,Miranda; Gregory Joseph,17,1,56,39
1657106947647,CSE 11,A01,083080,Cao; Yingjun,4,15,40,36
1657106953674,CSE 12,A01,083652,Krause-Levy; Sophia Louisa,23,1,120,97
1657106959705,CSE 15L,A01,083654,Morris; Justin Loren,9,0,50,41
1657106959705,CSE 15L,A02,083655,Morris; Justin Loren,9,0,50,41
1657106965732,CSE 20,A01,083657,Tran; Khoa Dang,37,0,80,43
1657106971762,CSE 21,A01,095574,Bach; Quang Tran,21,0,48,27
1657106977789,CSE 30,A01,083084,Eldon; John,4,0,80,76
1657106977789,CSE 30,B01,095061,Bhaskar; Nishant,6,0,50,44
1657106983820,CSE 100,A01,083659,Cao; Yingjun,4,4,70,66
1657106989851,CSE 134B,A01,083661,Powell; Thomas Allan,19,0,100,81
1657106995876,CSE 140,A01,083663,Gungor; Onat,14,0,85,71
1657107001913,CSE 140L,A01,083088,Eldon; John,16,0,100,84
1657107007955,CSE 175,A01,083665,Kumar; Rakesh,3,0,25,22
1657107013987,CSE 190,A00,092507,Dubnov; Shlomo,7,0,20,13
1657107020017,ECE 45,A01,083139,Congero; Spencer William,5,0,75,70
1657107026043,ECE 65,A50,083695,Saad; Andrew S,12,0,30,18
1657107026043,ECE 65,A51,095125,Saad; Andrew S,25,0,26,1
1657107032070,ECE 109,A01,091882,Touri; Behrouz,16,0,70,54
1657107038098,ECE 180,A00,083140,Abi Samra; Nicholas Camill,1,0,30,29
1657107038098,ECE 180,B00,083141,Abi Samra; Nicholas Camill,0,0,30,30
1657107044128,MATH 10A,A01,083735,Patchell; Gregory David,1,0,30,29
1657107044128,MATH 10A,A02,083736,Patchell; Gregory David,20,0,30,10
1657107044128,MATH 10A,A03,083737,Patchell; Gregory David,16,0,30,14
1657107050157,MATH 10B,A01,083207,Lim; Seonhee,7,0,34,27
1657107050157,MATH 10B,A02,083208,Lim; Seonhee,9,0,35,26
1657107050157,MATH 10B,A03,093472,Lim; Seonhee,5,0,34,29
1657107050157,MATH 10B,B01,083739,Sinha; Shubham,9,0,30,21
1657107056187,MATH 18,A01,083743,Cinel; Cameron Alexander,6,0,30,24
1657107056187,MATH 18,A02,083744,Cinel; Cameron Alexander,15,0,30,15
1657107056187,MATH 18,A03,083745,Cinel; Cameron Alexander,8,0,30,22
1657107056187,MATH 18,B01,083748,Rideout; David Porter,4,0,37,33
1657107056187,MATH 18,B02,083749,Rideout; David Porter,3,0,36,33
1657107056187,MATH 18,B03,083750,Rideout; David Porter,2,0,37,35
1657107056187,MATH 18,B04,083751,Rideout; David Porter,5,0,36,31
1657107056187,MATH 18,B05,093473,Rideout; David Porter,4,0,36,32
1657107056187,MATH 18,B06,093474,Rideout; David Porter,5,0,36,31
1657107062214,MATH 20A,A01,083754,Zheng; Zequn,12,0,40,28
1657107068247,MATH 20B,A01,083756,Briones; Jor-el Thomas Caparas,1,0,36,35
1657107068247,MATH 20B,A02,083757,Briones; Jor-el Thomas Caparas,1,0,36,35
1657107068247,MATH 20B,A03,093475,Briones; Jor-el Thomas Caparas,0,0,36,36
1657107074277,MATH 20C,A01,083760,Briones; Jor-el Thomas Caparas,1,0,35,34
1657107074277,MATH 20C,A02,083761,Briones; Jor-el Thomas Caparas,8,0,35,27
1657107074277,MATH 20C,A03,093476,Briones; Jor-el Thomas Caparas,0,1,36,36
1657107074277,MATH 20C,B01,083762,Bach; Quang Tran,0,0,30,30
1657107080311,MATH 20D,A01,083765,Tran; Brian Kha,4,0,30,26
1657107080311,MATH 20D,A02,083766,Tran; Brian Kha,5,0,30,25
1657107080311,MATH 20D,A03,083767,Tran; Brian Kha,3,0,30,27
1657107086337,MATH 20E,A01,083771,Ganguly; Soumya,6,0,32,26
1657107086337,MATH 20E,A02,083772,Ganguly; Soumya,6,0,32,26
1657107086337,MATH 20E,B01,083773,Ciotti; Benjamin,18,0,35,17
1657107086337,MATH 20E,B02,083774,Ciotti; Benjamin,17,0,35,18
1657107092375,MATH 103A,A01,083777,Greenfeld; Be'Eri,2,0,36,34
1657107092375,MATH 103A,A02,083778,Greenfeld; Be'Eri,5,0,36,31
1657107092375,MATH 103A,A03,093561,Greenfeld; Be'Eri,4,0,36,32
1657107092375,MATH 103A,B01,083779,Greenfeld; Be'Eri,6,0,36,30
1657107092375,MATH 103A,B02,083780,Greenfeld; Be'Eri,2,0,36,34
1657107092375,MATH 103A,B03,093562,Greenfeld; Be'Eri,3,0,36,33
1657107098408,MATH 105,A01,085443,Carter; Anne Toulson,14,0,35,21
1657107098408,MATH 105,A02,093477,Carter; Anne Toulson,20,0,35,15
1657107104440,MATH 109,A01,083213,Ganzberger; Geoffrey Michael,2,0,34,32
1657107104440,MATH 109,A02,083214,Ganzberger; Geoffrey Michael,3,0,34,31
1657107104440,MATH 109,A03,093478,Ganzberger; Geoffrey Michael,1,0,34,33
1657107104440,MATH 109,B01,083215,Ganzberger; Geoffrey Michael,1,0,32,31
1657107104440,MATH 109,B02,083216,Ganzberger; Geoffrey Michael,1,0,32,31
1657107104440,MATH 109,B03,093479,Ganzberger; Geoffrey Michael,6,0,32,26
1657107110476,MATH 142A,A01,083219,Chow; Bennett,6,0,32,26
1657107110476,MATH 142A,A02,083220,Chow; Bennett,10,0,32,22
1657107110476,MATH 142A,A03,093480,Chow; Bennett,7,0,32,25
1657107110476,MATH 142A,B03,093481,Chow; Bennett,8,0,32,24
1657107110476,MATH 142A,B04,093558,Chow; Bennett,11,0,32,21
1657107110476,MATH 142A,B05,093559,Chow; Bennett,6,0,32,26
1657107116513,MATH 193A,A01,083224,Rotar; Vladimir,7,0,34,27
1657107116513,MATH 193A,A02,083225,Rotar; Vladimir,5,0,34,29
1657107116513,MATH 193A,A03,083781,Rotar; Vladimir,1,0,34,33
1657107116513,MATH 193A,A04,083782,Rotar; Vladimir,6,0,34,28
1657107116513,MATH 193A,A05,093482,Rotar; Vladimir,6,0,34,28
1657107122541,MATH 197,001,091859,McAuley; Julian John,9999,0,9999,0
1657107122541,MATH 197,002,095566,Kedlaya; Kiran S.,9997,0,9999,2
1657107122541,MATH 197,003,095567,Xiao; Ming,9999,0,9999,0
1657107122541,MATH 197,004,095571,Perols; Johan Lars,9998,0,9999,1
1657107129620,COGS 9,A01,083615,Shannon; Kyle Michael,7,0,75,68
1657107135648,COGS 11,A01,083617,Boyle; Mary E. T.,21,0,48,27
1657107141676,COGS 13,A01,083071,Bastos; Amalia Pinkusfeld,9,0,71,62
1657107147710,COGS 14A,A01,092681,Semenuks; Arturs,1,1,100,99
1657107153747,COGS 14B,A01,083073,Cheng; Tzu-Han,6,0,63,57
1657107159774,COGS 17,A01,092677,Semenuks; Arturs,4,0,81,77
1657107165801,COGS 100,A01,083619,Allen; Michael Gordon,15,0,70,55
1657107171833,COGS 101A,A01,083621,Davis; Joshua Daniel,9,0,68,59
1657107177861,COGS 101B,A01,091572,Allen; Michael Gordon,8,0,65,57
1657107183890,COGS 101C,A01,083625,Delgado; Tania,17,0,35,18
1657107189916,COGS 107A,A01,083627,Boyle; Mary E. T.,13,0,60,47
1657107195941,COGS 118A,A01,083075,Gupta; Anjum,15,0,76,61
1657107201974,CSE 3,A50,083646,Miranda; Gregory Joseph,22,0,50,28
1657107208005,CSE 8A,A50,083650,Miranda; Gregory Joseph,17,1,56,39
1657107214036,CSE 11,A01,083080,Cao; Yingjun,4,15,40,36
1657107220064,CSE 12,A01,083652,Krause-Levy; Sophia Louisa,23,1,120,97
1657107226089,CSE 15L,A01,083654,Morris; Justin Loren,9,0,50,41
1657107226089,CSE 15L,A02,083655,Morris; Justin Loren,9,0,50,41
1657107232115,CSE 20,A01,083657,Tran; Khoa Dang,37,0,80,43
1657107238214,CSE 21,A01,095574,Bach; Quang Tran,21,0,48,27
1657107244251,CSE 30,A01,083084,Eldon; John,4,0,80,76
1657107244251,CSE 30,B01,095061,Bhaskar; Nishant,6,0,50,44
1657107250280,CSE 100,A01,083659,Cao; Yingjun,4,4,70,66
1657107256310,CSE 134B,A01,083661,Powell; Thomas Allan,19,0,100,81
1657107262343,CSE 140,A01,083663,Gungor; Onat,14,0,85,71
1657107268373,CSE 140L,A01,083088,Eldon; John,16,0,100,84
1657107274404,CSE 175,A01,083665,Kumar; Rakesh,3,0,25,22
1657107280432,CSE 190,A00,092507,Dubnov; Shlomo,7,0,20,13
1657107286475,ECE 45,A01,083139,Congero; Spencer William,5,0,75,70
1657107292503,ECE 65,A50,083695,Saad; Andrew S,12,0,30,18
1657107292503,ECE 65,A51,095125,Saad; Andrew S,25,0,26,1
1657107298531,ECE 109,A01,091882,Touri; Behrouz,16,0,70,54
1657107304561,ECE 180,A00,083140,Abi Samra; Nicholas Camill,1,0,30,29
1657107304561,ECE 180,B00,083141,Abi Samra; Nicholas Camill,0,0,30,30
1657107310594,MATH 10A,A01,083735,Patchell; Gregory David,1,0,30,29
1657107310594,MATH 10A,A02,083736,Patchell; Gregory David,20,0,30,10
1657107310594,MATH 10A,A03,083737,Patchell; Gregory David,16,0,30,14
1657107316634,MATH 10B,A01,083207,Lim; Seonhee,7,0,34,27
1657107316634,MATH 10B,A02,083208,Lim; Seonhee,9,0,35,26
1657107316634,MATH 10B,A03,093472,Lim; Seonhee,5,0,34,29
1657107316634,MATH 10B,B01,083739,Sinha; Shubham,9,0,30,21
1657107322667,MATH 18,A01,083743,Cinel; Cameron Alexander,6,0,30,24
1657107322667,MATH 18,A02,083744,Cinel; Cameron Alexander,15,0,30,15
1657107322667,MATH 18,A03,083745,Cinel; Cameron Alexander,8,0,30,22
1657107322667,MATH 18,B01,083748,Rideout; David Porter,4,0,37,33
1657107322667,MATH 18,B02,083749,Rideout; David Porter,3,0,36,33
1657107322667,MATH 18,B03,083750,Rideout; David Porter,2,0,37,35
1657107322667,MATH 18,B04,083751,Rideout; David Porter,5,0,36,31
1657107322667,MATH 18,B05,093473,Rideout; David Porter,4,0,36,32
1657107322667,MATH 18,B06,093474,Rideout; David Porter,5,0,36,31
1657107328694,MATH 20A,A01,083754,Zheng; Zequn,12,0,40,28
1657107334729,MATH 20B,A01,083756,Briones; Jor-el Thomas Caparas,1,0,36,35
1657107334729,MATH 20B,A02,083757,Briones; Jor-el Thomas Caparas,1,0,36,35
1657107334729,MATH 20B,A03,093475,Briones; Jor-el Thomas Caparas,0,0,36,36
1657107340758,MATH 20C,A01,083760,Briones; Jor-el Thomas Caparas,1,0,35,34
1657107340758,MATH 20C,A02,083761,Briones; Jor-el Thomas Caparas,8,0,35,27
1657107340758,MATH 20C,A03,093476,Briones; Jor-el Thomas Caparas,0,1,36,36
1657107340758,MATH 20C,B01,083762,Bach; Quang Tran,0,0,30,30
1657107346784,MATH 20D,A01,083765,Tran; Brian Kha,4,0,30,26
1657107346784,MATH 20D,A02,083766,Tran; Brian Kha,5,0,30,25
1657107346784,MATH 20D,A03,083767,Tran; Brian Kha,3,0,30,27
1657107352818,MATH 20E,A01,083771,Ganguly; Soumya,6,0,32,26
1657107352818,MATH 20E,A02,083772,Ganguly; Soumya,6,0,32,26
1657107352818,MATH 20E,B01,083773,Ciotti; Benjamin,18,0,35,17
1657107352818,MATH 20E,B02,083774,Ciotti; Benjamin,17,0,35,18
1657107358848,MATH 103A,A01,083777,Greenfeld; Be'Eri,2,0,36,34
1657107358848,MATH 103A,A02,083778,Greenfeld; Be'Eri,5,0,36,31
1657107358848,MATH 103A,A03,093561,Greenfeld; Be'Eri,4,0,36,32
1657107358848,MATH 103A,B01,083779,Greenfeld; Be'Eri,6,0,36,30
1657107358848,MATH 103A,B02,083780,Greenfeld; Be'Eri,2,0,36,34
1657107358848,MATH 103A,B03,093562,Greenfeld; Be'Eri,3,0,36,33
1657107364881,MATH 105,A01,085443,Carter; Anne Toulson,14,0,35,21
1657107364881,MATH 105,A02,093477,Carter; Anne Toulson,20,0,35,15
1657107370915,MATH 109,A01,083213,Ganzberger; Geoffrey Michael,2,0,34,32
1657107370915,MATH 109,A02,083214,Ganzberger; Geoffrey Michael,3,0,34,31
1657107370915,MATH 109,A03,093478,Ganzberger; Geoffrey Michael,1,0,34,33
1657107370915,MATH 109,B01,083215,Ganzberger; Geoffrey Michael,1,0,32,31
1657107370915,MATH 109,B02,083216,Ganzberger; Geoffrey Michael,1,0,32,31
1657107370915,MATH 109,B03,093479,Ganzberger; Geoffrey Michael,6,0,32,26
1657107376948,MATH 142A,A01,083219,Chow; Bennett,6,0,32,26
1657107376948,MATH 142A,A02,083220,Chow; Bennett,10,0,32,22
1657107376948,MATH 142A,A03,093480,Chow; Bennett,7,0,32,25
1657107376948,MATH 142A,B03,093481,Chow; Bennett,8,0,32,24
1657107376948,MATH 142A,B04,093558,Chow; Bennett,11,0,32,21
1657107376948,MATH 142A,B05,093559,Chow; Bennett,6,0,32,26
1657107382983,MATH 193A,A01,083224,Rotar; Vladimir,7,0,34,27
1657107382983,MATH 193A,A02,083225,Rotar; Vladimir,5,0,34,29
1657107382983,MATH 193A,A03,083781,Rotar; Vladimir,1,0,34,33
1657107382983,MATH 193A,A04,083782,Rotar; Vladimir,6,0,34,28
1657107382983,MATH 193A,A05,093482,Rotar; Vladimir,6,0,34,28
1657107389012,MATH 197,001,091859,McAuley; Julian John,9999,0,9999,0
1657107389012,MATH 197,002,095566,Kedlaya; Kiran S.,9997,0,9999,2
1657107389012,MATH 197,003,095567,Xiao; Ming,9999,0,9999,0
1657107389012,MATH 197,004,095571,Perols; Johan Lars,9998,0,9999,1
1657107396089,COGS 9,A01,083615,Shannon; Kyle Michael,7,0,75,68
1657107402115,COGS 11,A01,083617,Boyle; Mary E. T.,21,0,48,27
1657107408142,COGS 13,A01,083071,Bastos; Amalia Pinkusfeld,9,0,71,62
1657107414174,COGS 14A,A01,092681,Semenuks; Arturs,1,1,100,99
1657107420204,COGS 14B,A01,083073,Cheng; Tzu-Han,6,0,63,57
1657107426231,COGS 17,A01,092677,Semenuks; Arturs,4,0,81,77
1657107432275,COGS 100,A01,083619,Allen; Michael Gordon,15,0,70,55
1657107438305,COGS 101A,A01,083621,Davis; Joshua Daniel,9,0,68,59
1657107444337,COGS 101B,A01,091572,Allen; Michael Gordon,8,0,65,57
1657107450365,COGS 101C,A01,083625,Delgado; Tania,17,0,35,18
1657107456391,COGS 107A,A01,083627,Boyle; Mary E. T.,13,0,60,47
1657107462420,COGS 118A,A01,083075,Gupta; Anjum,15,0,76,61
1657107468450,CSE 3,A50,083646,Miranda; Gregory Joseph,22,0,50,28
1657107474479,CSE 8A,A50,083650,Miranda; Gregory Joseph,17,1,56,39
1657107480508,CSE 11,A01,083080,Cao; Yingjun,4,15,40,36
1657107486541,CSE 12,A01,083652,Krause-Levy; Sophia Louisa,23,1,120,97
1657107492570,CSE 15L,A01,083654,Morris; Justin Loren,9,0,50,41
1657107492570,CSE 15L,A02,083655,Morris; Justin Loren,9,0,50,41
1657107498596,CSE 20,A01,083657,Tran; Khoa Dang,37,0,80,43
1657107504629,CSE 21,A01,095574,Bach; Quang Tran,21,0,48,27
1657107510667,CSE 30,A01,083084,Eldon; John,4,0,80,76
1657107510667,CSE 30,B01,095061,Bhaskar; Nishant,6,0,50,44
1657107516694,CSE 100,A01,083659,Cao; Yingjun,4,4,70,66
1657107522725,CSE 134B,A01,083661,Powell; Thomas Allan,19,0,100,81
1657107528754,CSE 140,A01,083663,Gungor; Onat,14,0,85,71
1657107534786,CSE 140L,A01,083088,Eldon; John,16,0,100,84
1657107540819,CSE 175,A01,083665,Kumar; Rakesh,3,0,25,22
1657107546848,CSE 190,A00,092507,Dubnov; Shlomo,7,0,20,13
1657107552876,ECE 45,A01,083139,Congero; Spencer William,5,0,75,70
1657107558903,ECE 65,A50,083695,Saad; Andrew S,12,0,30,18
1657107558903,ECE 65,A51,095125,Saad; Andrew S,25,0,26,1
1657107564936,ECE 109,A01,091882,Touri; Behrouz,16,0,70,54
1657107570968,ECE 180,A00,083140,Abi Samra; Nicholas Camill,1,0,30,29
1657107570968,ECE 180,B00,083141,Abi Samra; Nicholas Camill,0,0,30,30
1657107576996,MATH 10A,A01,083735,Patchell; Gregory David,1,0,30,29
1657107576996,MATH 10A,A02,083736,Patchell; Gregory David,20,0,30,10
1657107576996,MATH 10A,A03,083737,Patchell; Gregory David,16,0,30,14
1657107583028,MATH 10B,A01,083207,Lim; Seonhee,7,0,34,27
1657107583028,MATH 10B,A02,083208,Lim; Seonhee,9,0,35,26
1657107583028,MATH 10B,A03,093472,Lim; Seonhee,5,0,34,29
1657107583028,MATH 10B,B01,083739,Sinha; Shubham,9,0,30,21
1657107589059,MATH 18,A01,083743,Cinel; Cameron Alexander,6,0,30,24
1657107589059,MATH 18,A02,083744,Cinel; Cameron Alexander,15,0,30,15
1657107589059,MATH 18,A03,083745,Cinel; Cameron Alexander,8,0,30,22
1657107589059,MATH 18,B01,083748,Rideout; David Porter,4,0,37,33
1657107589059,MATH 18,B02,083749,Rideout; David Porter,3,0,36,33
1657107589059,MATH 18,B03,083750,Rideout; David Porter,2,0,37,35
1657107589059,MATH 18,B04,083751,Rideout; David Porter,5,0,36,31
1657107589059,MATH 18,B05,093473,Rideout; David Porter,4,0,36,32
1657107589059,MATH 18,B06,093474,Rideout; David Porter,5,0,36,31
1657107595087,MATH 20A,A01,083754,Zheng; Zequn,12,0,40,28
1657107601122,MATH 20B,A01,083756,Briones; Jor-el Thomas Caparas,1,0,36,35
1657107601122,MATH 20B,A02,083757,Briones; Jor-el Thomas Caparas,1,0,36,35
1657107601122,MATH 20B,A03,093475,Briones; Jor-el Thomas Caparas,0,0,36,36
1657107607155,MATH 20C,A01,083760,Briones; Jor-el Thomas Caparas,1,0,35,34
1657107607155,MATH 20C,A02,083761,Briones; Jor-el Thomas Caparas,8,0,35,27
1657107607155,MATH 20C,A03,093476,Briones; Jor-el Thomas Caparas,0,1,36,36
1657107607155,MATH 20C,B01,083762,Bach; Quang Tran,0,0,30,30
1657107613186,MATH 20D,A01,083765,Tran; Brian Kha,4,0,30,26
1657107613186,MATH 20D,A02,083766,Tran; Brian Kha,5,0,30,25
1657107613186,MATH 20D,A03,083767,Tran; Brian Kha,3,0,30,27
1657107619213,MATH 20E,A01,083771,Ganguly; Soumya,6,0,32,26
1657107619213,MATH 20E,A02,083772,Ganguly; Soumya,6,0,32,26
1657107619213,MATH 20E,B01,083773,Ciotti; Benjamin,18,0,35,17
1657107619213,MATH 20E,B02,083774,Ciotti; Benjamin,17,0,35,18
1657107625243,MATH 103A,A01,083777,Greenfeld; Be'Eri,2,0,36,34
1657107625243,MATH 103A,A02,083778,Greenfeld; Be'Eri,5,0,36,31
1657107625243,MATH 103A,A03,093561,Greenfeld; Be'Eri,4,0,36,32
1657107625243,MATH 103A,B01,083779,Greenfeld; Be'Eri,6,0,36,30
1657107625243,MATH 103A,B02,083780,Greenfeld; Be'Eri,2,0,36,34
1657107625243,MATH 103A,B03,093562,Greenfeld; Be'Eri,3,0,36,33
1657107631279,MATH 105,A01,085443,Carter; Anne Toulson,14,0,35,21
1657107631279,MATH 105,A02,093477,Carter; Anne Toulson,20,0,35,15
1657107637322,MATH 109,A01,083213,Ganzberger; Geoffrey Michael,2,0,34,32
1657107637322,MATH 109,A02,083214,Ganzberger; Geoffrey Michael,3,0,34,31
1657107637322,MATH 109,A03,093478,Ganzberger; Geoffrey Michael,1,0,34,33
1657107637322,MATH 109,B01,083215,Ganzberger; Geoffrey Michael,1,0,32,31
1657107637322,MATH 109,B02,083216,Ganzberger; Geoffrey Michael,1,0,32,31
1657107637322,MATH 109,B03,093479,Ganzberger; Geoffrey Michael,6,0,32,26
1657107643359,MATH 142A,A01,083219,Chow; Bennett,6,0,32,26
1657107643359,MATH 142A,A02,083220,Chow; Bennett,10,0,32,22
1657107643359,MATH 142A,A03,093480,Chow; Bennett,7,0,32,25
1657107643359,MATH 142A,B03,093481,Chow; Bennett,8,0,32,24
1657107643359,MATH 142A,B04,093558,Chow; Bennett,11,0,32,21
1657107643359,MATH 142A,B05,093559,Chow; Bennett,6,0,32,26
1657107649392,MATH 193A,A01,083224,Rotar; Vladimir,7,0,34,27
1657107649392,MATH 193A,A02,083225,Rotar; Vladimir,5,0,34,29
1657107649392,MATH 193A,A03,083781,Rotar; Vladimir,1,0,34,33
1657107649392,MATH 193A,A04,083782,Rotar; Vladimir,6,0,34,28
1657107649392,MATH 193A,A05,093482,Rotar; Vladimir,6,0,34,28
1657107655423,MATH 197,001,091859,McAuley; Julian John,9999,0,9999,0
1657107655423,MATH 197,002,095566,Kedlaya; Kiran S.,9997,0,9999,2
1657107655423,MATH 197,003,095567,Xiao; Ming,9999,0,9999,0
1657107655423,MATH 197,004,095571,Perols; Johan Lars,9998,0,9999,1
1657107662488,COGS 9,A01,083615,Shannon; Kyle Michael,7,0,75,68
1657107668514,COGS 11,A01,083617,Boyle; Mary E. T.,21,0,48,27
1657107674547,COGS 13,A01,083071,Bastos; Amalia Pinkusfeld,9,0,71,62
1657107680580,COGS 14A,A01,092681,Semenuks; Arturs,1,1,100,99
1657107686613,COGS 14B,A01,083073,Cheng; Tzu-Han,6,0,63,57
1657107692642,COGS 17,A01,092677,Semenuks; Arturs,4,0,81,77
1657107698676,COGS 100,A01,083619,Allen; Michael Gordon,15,0,70,55
1657107704709,COGS 101A,A01,083621,Davis; Joshua Daniel,9,0,68,59
1657107710736,COGS 101B,A01,091572,Allen; Michael Gordon,8,0,65,57
1657107716768,COGS 101C,A01,083625,Delgado; Tania,17,0,35,18
1657107722810,COGS 107A,A01,083627,Boyle; Mary E. T.,13,0,60,47
1657107728837,COGS 118A,A01,083075,Gupta; Anjum,15,0,76,61
1657107734867,CSE 3,A50,083646,Miranda; Gregory Joseph,22,0,50,28
1657107740893,CSE 8A,A50,083650,Miranda; Gregory Joseph,17,1,56,39
1657107746918,CSE 11,A01,083080,Cao; Yingjun,4,15,40,36
1657107752949,CSE 12,A01,083652,Krause-Levy; Sophia Louisa,23,1,120,97
1657107758974,CSE 15L,A01,083654,Morris; Justin Loren,9,0,50,41
1657107758974,CSE 15L,A02,083655,Morris; Justin Loren,9,0,50,41
1657107765002,CSE 20,A01,083657,Tran; Khoa Dang,37,0,80,43
1657107771029,CSE 21,A01,095574,Bach; Quang Tran,21,0,48,27
1657107777060,CSE 30,A01,083084,Eldon; John,4,0,80,76
1657107777060,CSE 30,B01,095061,Bhaskar; Nishant,6,0,50,44
1657107783090,CSE 100,A01,083659,Cao; Yingjun,4,4,70,66
1657107789121,CSE 134B,A01,083661,Powell; Thomas Allan,19,0,100,81
1657107795149,CSE 140,A01,083663,Gungor; Onat,14,0,85,71
1657107801175,CSE 140L,A01,083088,Eldon; John,16,0,100,84
1657107807200,CSE 175,A01,083665,Kumar; Rakesh,3,0,25,22
1657107813225,CSE 190,A00,092507,Dubnov; Shlomo,7,0,20,13
1657107819263,ECE 45,A01,083139,Congero; Spencer William,5,0,75,70
1657107825298,ECE 65,A50,083695,Saad; Andrew S,12,0,30,18
1657107825298,ECE 65,A51,095125,Saad; Andrew S,25,0,26,1
1657107831333,ECE 109,A01,091882,Touri; Behrouz,16,0,70,54
1657107837437,ECE 180,A00,083140,Abi Samra; Nicholas Camill,1,0,30,29
1657107837437,ECE 180,B00,083141,Abi Samra; Nicholas Camill,0,0,30,30
1657107843465,MATH 10A,A01,083735,Patchell; Gregory David,1,0,30,29
1657107843465,MATH 10A,A02,083736,Patchell; Gregory David,20,0,30,10
1657107843465,MATH 10A,A03,083737,Patchell; Gregory David,16,0,30,14
1657107849494,MATH 10B,A01,083207,Lim; Seonhee,7,0,34,27
1657107849494,MATH 10B,A02,083208,Lim; Seonhee,9,0,35,26
1657107849494,MATH 10B,A03,093472,Lim; Seonhee,5,0,34,29
1657107849494,MATH 10B,B01,083739,Sinha; Shubham,9,0,30,21
1657107855526,MATH 18,A01,083743,Cinel; Cameron Alexander,6,0,30,24
1657107855526,MATH 18,A02,083744,Cinel; Cameron Alexander,15,0,30,15
1657107855526,MATH 18,A03,083745,Cinel; Cameron Alexander,8,0,30,22
1657107855526,MATH 18,B01,083748,Rideout; David Porter,4,0,37,33
1657107855526,MATH 18,B02,083749,Rideout; David Porter,3,0,36,33
1657107855526,MATH 18,B03,083750,Rideout; David Porter,2,0,37,35
1657107855526,MATH 18,B04,083751,Rideout; David Porter,5,0,36,31
1657107855526,MATH 18,B05,093473,Rideout; David Porter,4,0,36,32
1657107855526,MATH 18,B06,093474,Rideout; David Porter,5,0,36,31
1657107861554,MATH 20A,A01,083754,Zheng; Zequn,12,0,40,28
1657107867582,MATH 20B,A01,083756,Briones; Jor-el Thomas Caparas,1,0,36,35
1657107867582,MATH 20B,A02,083757,Briones; Jor-el Thomas Caparas,1,0,36,35
1657107867582,MATH 20B,A03,093475,Briones; Jor-el Thomas Caparas,0,0,36,36
1657107873609,MATH 20C,A01,083760,Briones; Jor-el Thomas Caparas,1,0,35,34
1657107873609,MATH 20C,A02,083761,Briones; Jor-el Thomas Caparas,8,0,35,27
1657107873609,MATH 20C,A03,093476,Briones; Jor-el Thomas Caparas,0,1,36,36
1657107873609,MATH 20C,B01,083762,Bach; Quang Tran,0,0,30,30
1657107879636,MATH 20D,A01,083765,Tran; Brian Kha,4,0,30,26
1657107879636,MATH 20D,A02,083766,Tran; Brian Kha,5,0,30,25
1657107879636,MATH 20D,A03,083767,Tran; Brian Kha,3,0,30,27
1657107885665,MATH 20E,A01,083771,Ganguly; Soumya,6,0,32,26
1657107885665,MATH 20E,A02,083772,Ganguly; Soumya,6,0,32,26
1657107885665,MATH 20E,B01,083773,Ciotti; Benjamin,18,0,35,17
1657107885665,MATH 20E,B02,083774,Ciotti; Benjamin,17,0,35,18
1657107891694,MATH 103A,A01,083777,Greenfeld; Be'Eri,2,0,36,34
1657107891694,MATH 103A,A02,083778,Greenfeld; Be'Eri,5,0,36,31
1657107891694,MATH 103A,A03,093561,Greenfeld; Be'Eri,4,0,36,32
1657107891694,MATH 103A,B01,083779,Greenfeld; Be'Eri,6,0,36,30
1657107891694,MATH 103A,B02,083780,Greenfeld; Be'Eri,2,0,36,34
1657107891694,MATH 103A,B03,093562,Greenfeld; Be'Eri,3,0,36,33
1657107897728,MATH 105,A01,085443,Carter; Anne Toulson,14,0,35,21
1657107897728,MATH 105,A02,093477,Carter; Anne Toulson,20,0,35,15
1657107903755,MATH 109,A01,083213,Ganzberger; Geoffrey Michael,2,0,34,32
1657107903755,MATH 109,A02,083214,Ganzberger; Geoffrey Michael,3,0,34,31
1657107903755,MATH 109,A03,093478,Ganzberger; Geoffrey Michael,1,0,34,33
1657107903755,MATH 109,B01,083215,Ganzberger; Geoffrey Michael,1,0,32,31
1657107903755,MATH 109,B02,083216,Ganzberger; Geoffrey Michael,1,0,32,31
1657107903755,MATH 109,B03,093479,Ganzberger; Geoffrey Michael,6,0,32,26
1657107909783,MATH 142A,A01,083219,Chow; Bennett,6,0,32,26
1657107909783,MATH 142A,A02,083220,Chow; Bennett,10,0,32,22
1657107909783,MATH 142A,A03,093480,Chow; Bennett,7,0,32,25
1657107909783,MATH 142A,B03,093481,Chow; Bennett,8,0,32,24
1657107909783,MATH 142A,B04,093558,Chow; Bennett,11,0,32,21
1657107909783,MATH 142A,B05,093559,Chow; Bennett,6,0,32,26
1657107915813,MATH 193A,A01,083224,Rotar; Vladimir,7,0,34,27
1657107915813,MATH 193A,A02,083225,Rotar; Vladimir,5,0,34,29
1657107915813,MATH 193A,A03,083781,Rotar; Vladimir,1,0,34,33
1657107915813,MATH 193A,A04,083782,Rotar; Vladimir,6,0,34,28
1657107915813,MATH 193A,A05,093482,Rotar; Vladimir,6,0,34,28
1657107921838,MATH 197,001,091859,McAuley; Julian John,9999,0,9999,0
1657107921838,MATH 197,002,095566,Kedlaya; Kiran S.,9997,0,9999,2
1657107921838,MATH 197,003,095567,Xiao; Ming,9999,0,9999,0
1657107921838,MATH 197,004,095571,Perols; Johan Lars,9998,0,9999,1
1657107928907,COGS 9,A01,083615,Shannon; Kyle Michael,7,0,75,68
1657107934933,COGS 11,A01,083617,Boyle; Mary E. T.,21,0,48,27
1657107940959,COGS 13,A01,083071,Bastos; Amalia Pinkusfeld,9,0,71,62
1657107946984,COGS 14A,A01,092681,Semenuks; Arturs,1,1,100,99
1657107953012,COGS 14B,A01,083073,Cheng; Tzu-Han,6,0,63,57
1657107959039,COGS 17,A01,092677,Semenuks; Arturs,4,0,81,77
1657107965076,COGS 100,A01,083619,Allen; Michael Gordon,15,0,70,55
1657107971101,COGS 101A,A01,083621,Davis; Joshua Daniel,9,0,68,59
1657107977132,COGS 101B,A01,091572,Allen; Michael Gordon,8,0,65,57
1657107983162,COGS 101C,A01,083625,Delgado; Tania,17,0,35,18
1657107989189,COGS 107A,A01,083627,Boyle; Mary E. T.,13,0,60,47
1657107995216,COGS 118A,A01,083075,Gupta; Anjum,15,0,76,61
1657108001252,CSE 3,A50,083646,Miranda; Gregory Joseph,22,0,50,28
1657108007294,CSE 8A,A50,083650,Miranda; Gregory Joseph,17,1,56,39
1657108013322,CSE 11,A01,083080,Cao; Yingjun,4,15,40,36
1657108019347,CSE 12,A01,083652,Krause-Levy; Sophia Louisa,23,1,120,97
1657108025378,CSE 15L,A01,083654,Morris; Justin Loren,9,0,50,41
1657108025378,CSE 15L,A02,083655,Morris; Justin Loren,9,0,50,41
1657108031414,CSE 20,A01,083657,Tran; Khoa Dang,37,0,80,43
1657108037443,CSE 21,A01,095574,Bach; Quang Tran,21,0,48,27
1657108043471,CSE 30,A01,083084,Eldon; John,4,0,80,76
1657108043471,CSE 30,B01,095061,Bhaskar; Nishant,6,0,50,44
1657108049505,CSE 100,A01,083659,Cao; Yingjun,4,4,70,66
1657108055530,CSE 134B,A01,083661,Powell; Thomas Allan,19,0,100,81
1657108061559,CSE 140,A01,083663,Gungor; Onat,14,0,85,71
1657108067589,CSE 140L,A01,083088,Eldon; John,17,0,100,83
1657108073618,CSE 175,A01,083665,Kumar; Rakesh,3,0,25,22
1657108079645,CSE 190,A00,092507,Dubnov; Shlomo,7,0,20,13
1657108085679,ECE 45,A01,083139,Congero; Spencer William,5,0,75,70
1657108091710,ECE 65,A50,083695,Saad; Andrew S,12,0,30,18
1657108091710,ECE 65,A51,095125,Saad; Andrew S,25,0,26,1
1657108097735,ECE 109,A01,091882,Touri; Behrouz,16,0,70,54
1657108103762,ECE 180,A00,083140,Abi Samra; Nicholas Camill,1,0,30,29
1657108103762,ECE 180,B00,083141,Abi Samra; Nicholas Camill,0,0,30,30
1657108109795,MATH 10A,A01,083735,Patchell; Gregory David,1,0,30,29
1657108109795,MATH 10A,A02,083736,Patchell; Gregory David,20,0,30,10
1657108109795,MATH 10A,A03,083737,Patchell; Gregory David,16,0,30,14
1657108115823,MATH 10B,A01,083207,Lim; Seonhee,7,0,34,27
1657108115823,MATH 10B,A02,083208,Lim; Seonhee,9,0,35,26
1657108115823,MATH 10B,A03,093472,Lim; Seonhee,5,0,34,29
1657108115823,MATH 10B,B01,083739,Sinha; Shubham,9,0,30,21
1657108121864,MATH 18,A01,083743,Cinel; Cameron Alexander,6,0,30,24
1657108121864,MATH 18,A02,083744,Cinel; Cameron Alexander,15,0,30,15
1657108121864,MATH 18,A03,083745,Cinel; Cameron Alexander,8,0,30,22
1657108121864,MATH 18,B01,083748,Rideout; David Porter,4,0,37,33
1657108121864,MATH 18,B02,083749,Rideout; David Porter,3,0,36,33
1657108121864,MATH 18,B03,083750,Rideout; David Porter,2,0,37,35
1657108121864,MATH 18,B04,083751,Rideout; David Porter,5,0,36,31
1657108121864,MATH 18,B05,093473,Rideout; David Porter,4,0,36,32
1657108121864,MATH 18,B06,093474,Rideout; David Porter,5,0,36,31
1657108127891,MATH 20A,A01,083754,Zheng; Zequn,12,0,40,28
1657108133924,MATH 20B,A01,083756,Briones; Jor-el Thomas Caparas,1,0,36,35
1657108133924,MATH 20B,A02,083757,Briones; Jor-el Thomas Caparas,1,0,36,35
1657108133924,MATH 20B,A03,093475,Briones; Jor-el Thomas Caparas,0,0,36,36
1657108139961,MATH 20C,A01,083760,Briones; Jor-el Thomas Caparas,1,0,35,34
1657108139961,MATH 20C,A02,083761,Briones; Jor-el Thomas Caparas,8,0,35,27
1657108139961,MATH 20C,A03,093476,Briones; Jor-el Thomas Caparas,0,1,36,36
1657108139961,MATH 20C,B01,083762,Bach; Quang Tran,0,0,30,30
1657108145990,MATH 20D,A01,083765,Tran; Brian Kha,4,0,30,26
1657108145990,MATH 20D,A02,083766,Tran; Brian Kha,5,0,30,25
1657108145990,MATH 20D,A03,083767,Tran; Brian Kha,3,0,30,27
1657108152018,MATH 20E,A01,083771,Ganguly; Soumya,6,0,32,26
1657108152018,MATH 20E,A02,083772,Ganguly; Soumya,6,0,32,26
1657108152018,MATH 20E,B01,083773,Ciotti; Benjamin,18,0,35,17
1657108152018,MATH 20E,B02,083774,Ciotti; Benjamin,17,0,35,18
1657108158059,MATH 103A,A01,083777,Greenfeld; Be'Eri,2,0,36,34
1657108158059,MATH 103A,A02,083778,Greenfeld; Be'Eri,5,0,36,31
1657108158059,MATH 103A,A03,093561,Greenfeld; Be'Eri,4,0,36,32
1657108158059,MATH 103A,B01,083779,Greenfeld; Be'Eri,6,0,36,30
1657108158059,MATH 103A,B02,083780,Greenfeld; Be'Eri,2,0,36,34
1657108158059,MATH 103A,B03,093562,Greenfeld; Be'Eri,3,0,36,33
1657108164090,MATH 105,A01,085443,Carter; Anne Toulson,14,0,35,21
1657108164090,MATH 105,A02,093477,Carter; Anne Toulson,20,0,35,15
1657108170125,MATH 109,A01,083213,Ganzberger; Geoffrey Michael,2,0,34,32
1657108170125,MATH 109,A02,083214,Ganzberger; Geoffrey Michael,3,0,34,31
1657108170125,MATH 109,A03,093478,Ganzberger; Geoffrey Michael,1,0,34,33
1657108170125,MATH 109,B01,083215,Ganzberger; Geoffrey Michael,1,0,32,31
1657108170125,MATH 109,B02,083216,Ganzberger; Geoffrey Michael,1,0,32,31
1657108170125,MATH 109,B03,093479,Ganzberger; Geoffrey Michael,6,0,32,26
1657108176154,MATH 142A,A01,083219,Chow; Bennett,6,0,32,26
1657108176154,MATH 142A,A02,083220,Chow; Bennett,10,0,32,22
1657108176154,MATH 142A,A03,093480,Chow; Bennett,7,0,32,25
1657108176154,MATH 142A,B03,093481,Chow; Bennett,8,0,32,24
1657108176154,MATH 142A,B04,093558,Chow; Bennett,11,0,32,21
1657108176154,MATH 142A,B05,093559,Chow; Bennett,6,0,32,26
1657108182179,MATH 193A,A01,083224,Rotar; Vladimir,7,0,34,27
1657108182179,MATH 193A,A02,083225,Rotar; Vladimir,5,0,34,29
1657108182179,MATH 193A,A03,083781,Rotar; Vladimir,1,0,34,33
1657108182179,MATH 193A,A04,083782,Rotar; Vladimir,6,0,34,28
1657108182179,MATH 193A,A05,093482,Rotar; Vladimir,6,0,34,28
1657108188204,MATH 197,001,091859,McAuley; Julian John,9999,0,9999,0
1657108188204,MATH 197,002,095566,Kedlaya; Kiran S.,9997,0,9999,2
1657108188204,MATH 197,003,095567,Xiao; Ming,9999,0,9999,0
1657108188204,MATH 197,004,095571,Perols; Johan Lars,9998,0,9999,1
1657108195262,COGS 9,A01,083615,Shannon; Kyle Michael,7,0,75,68
1657108201289,COGS 11,A01,083617,Boyle; Mary E. T.,21,0,48,27
1657108207315,COGS 13,A01,083071,Bastos; Amalia Pinkusfeld,9,0,71,62
1657108213347,COGS 14A,A01,092681,Semenuks; Arturs,1,1,100,99
1657108219373,COGS 14B,A01,083073,Cheng; Tzu-Han,6,0,63,57
1657108225400,COGS 17,A01,092677,Semenuks; Arturs,4,0,81,77
1657108231432,COGS 100,A01,083619,Allen; Michael Gordon,15,0,70,55
1657108237462,COGS 101A,A01,083621,Davis; Joshua Daniel,9,0,68,59
1657108243487,COGS 101B,A01,091572,Allen; Michael Gordon,8,0,65,57
1657108249512,COGS 101C,A01,083625,Delgado; Tania,17,0,35,18
1657108255543,COGS 107A,A01,083627,Boyle; Mary E. T.,13,0,60,47
1657108261573,COGS 118A,A01,083075,Gupta; Anjum,15,0,76,61
1657108267599,CSE 3,A50,083646,Miranda; Gregory Joseph,22,0,50,28
1657108273622,CSE 8A,A50,083650,Miranda; Gregory Joseph,17,1,56,39
1657108279647,CSE 11,A01,083080,Cao; Yingjun,4,15,40,36
1657108285673,CSE 12,A01,083652,Krause-Levy; Sophia Louisa,23,1,120,97
1657108291700,CSE 15L,A01,083654,Morris; Justin Loren,9,0,50,41
1657108291700,CSE 15L,A02,083655,Morris; Justin Loren,9,0,50,41
1657108297727,CSE 20,A01,083657,Tran; Khoa Dang,37,0,80,43
1657108303751,CSE 21,A01,095574,Bach; Quang Tran,21,0,48,27
1657108309784,CSE 30,A01,083084,Eldon; John,4,0,80,76
1657108309784,CSE 30,B01,095061,Bhaskar; Nishant,6,0,50,44
1657108315809,CSE 100,A01,083659,Cao; Yingjun,4,4,70,66
1657108321835,CSE 134B,A01,083661,Powell; Thomas Allan,19,0,100,81
1657108327859,CSE 140,A01,083663,Gungor; Onat,14,0,85,71
1657108333885,CSE 140L,A01,083088,Eldon; John,17,0,100,83
1657108345640,CSE 175,A01,083665,Kumar; Rakesh,3,0,25,22
1657108351667,CSE 190,A00,092507,Dubnov; Shlomo,7,0,20,13
1657108366815,ECE 45,A01,083139,Congero; Spencer William,5,0,75,70
1657108372841,ECE 65,A50,083695,Saad; Andrew S,12,0,30,18
1657108372841,ECE 65,A51,095125,Saad; Andrew S,25,0,26,1
1657108388007,ECE 109,A01,091882,Touri; Behrouz,16,0,70,54
1657108394035,ECE 180,A00,083140,Abi Samra; Nicholas Camill,1,0,30,29
1657108394035,ECE 180,B00,083141,Abi Samra; Nicholas Camill,0,0,30,30
1657108409345,MATH 10A,A01,083735,Patchell; Gregory David,1,0,30,29
1657108409345,MATH 10A,A02,083736,Patchell; Gregory David,20,0,30,10
1657108409345,MATH 10A,A03,083737,Patchell; Gregory David,16,0,30,14
1657108415375,MATH 10B,A01,083207,Lim; Seonhee,7,0,34,27
1657108415375,MATH 10B,A02,083208,Lim; Seonhee,9,0,35,26
1657108415375,MATH 10B,A03,093472,Lim; Seonhee,5,0,34,29
1657108415375,MATH 10B,B01,083739,Sinha; Shubham,9,0,30,21
1657108431059,MATH 18,A01,083743,Cinel; Cameron Alexander,6,0,30,24
1657108431059,MATH 18,A02,083744,Cinel; Cameron Alexander,15,0,30,15
1657108431059,MATH 18,A03,083745,Cinel; Cameron Alexander,8,0,30,22
1657108431059,MATH 18,B01,083748,Rideout; David Porter,4,0,37,33
1657108431059,MATH 18,B02,083749,Rideout; David Porter,3,0,36,33
1657108431059,MATH 18,B03,083750,Rideout; David Porter,2,0,37,35
1657108431059,MATH 18,B04,083751,Rideout; David Porter,5,0,36,31
1657108431059,MATH 18,B05,093473,Rideout; David Porter,4,0,36,32
1657108431059,MATH 18,B06,093474,Rideout; David Porter,5,0,36,31
1657108437100,MATH 20A,A01,083754,Zheng; Zequn,12,0,40,28
1657108452075,MATH 20B,A01,083756,Briones; Jor-el Thomas Caparas,1,0,36,35
1657108452075,MATH 20B,A02,083757,Briones; Jor-el Thomas Caparas,1,0,36,35
1657108452075,MATH 20B,A03,093475,Briones; Jor-el Thomas Caparas,0,0,36,36
1657108458103,MATH 20C,A01,083760,Briones; Jor-el Thomas Caparas,1,0,35,34
1657108458103,MATH 20C,A02,083761,Briones; Jor-el Thomas Caparas,8,0,35,27
1657108458103,MATH 20C,A03,093476,Briones; Jor-el Thomas Caparas,0,1,36,36
1657108458103,MATH 20C,B01,083762,Bach; Quang Tran,0,0,30,30
1657108466962,MATH 20D,A01,083765,Tran; Brian Kha,4,0,30,26
1657108466962,MATH 20D,A02,083766,Tran; Brian Kha,5,0,30,25
1657108466962,MATH 20D,A03,083767,Tran; Brian Kha,3,0,30,27
1657108472991,MATH 20E,A01,083771,Ganguly; Soumya,6,0,32,26
1657108472991,MATH 20E,A02,083772,Ganguly; Soumya,6,0,32,26
1657108472991,MATH 20E,B01,083773,Ciotti; Benjamin,18,0,35,17
1657108472991,MATH 20E,B02,083774,Ciotti; Benjamin,17,0,35,18
1657108479031,MATH 103A,A01,083777,Greenfeld; Be'Eri,2,0,36,34
1657108479031,MATH 103A,A02,083778,Greenfeld; Be'Eri,5,0,36,31
1657108479031,MATH 103A,A03,093561,Greenfeld; Be'Eri,4,0,36,32
1657108479031,MATH 103A,B01,083779,Greenfeld; Be'Eri,6,0,36,30
1657108479031,MATH 103A,B02,083780,Greenfeld; Be'Eri,2,0,36,34
1657108479031,MATH 103A,B03,093562,Greenfeld; Be'Eri,3,0,36,33
1657108485059,MATH 105,A01,085443,Carter; Anne Toulson,14,0,35,21
1657108485059,MATH 105,A02,093477,Carter; Anne Toulson,20,0,35,15
1657108491187,MATH 109,A01,083213,Ganzberger; Geoffrey Michael,2,0,34,32
1657108491187,MATH 109,A02,083214,Ganzberger; Geoffrey Michael,3,0,34,31
1657108491187,MATH 109,A03,093478,Ganzberger; Geoffrey Michael,1,0,34,33
1657108491187,MATH 109,B01,083215,Ganzberger; Geoffrey Michael,1,0,32,31
1657108491187,MATH 109,B02,083216,Ganzberger; Geoffrey Michael,1,0,32,31
1657108491187,MATH 109,B03,093479,Ganzberger; Geoffrey Michael,6,0,32,26
1657108497216,MATH 142A,A01,083219,Chow; Bennett,6,0,32,26
1657108497216,MATH 142A,A02,083220,Chow; Bennett,10,0,32,22
1657108497216,MATH 142A,A03,093480,Chow; Bennett,7,0,32,25
1657108497216,MATH 142A,B03,093481,Chow; Bennett,8,0,32,24
1657108497216,MATH 142A,B04,093558,Chow; Bennett,11,0,32,21
1657108497216,MATH 142A,B05,093559,Chow; Bennett,6,0,32,26
1657108503242,MATH 193A,A01,083224,Rotar; Vladimir,7,0,34,27
1657108503242,MATH 193A,A02,083225,Rotar; Vladimir,5,0,34,29
1657108503242,MATH 193A,A03,083781,Rotar; Vladimir,1,0,34,33
1657108503242,MATH 193A,A04,083782,Rotar; Vladimir,6,0,34,28
1657108503242,MATH 193A,A05,093482,Rotar; Vladimir,6,0,34,28
1657108509270,MATH 197,001,091859,McAuley; Julian John,9999,0,9999,0
1657108509270,MATH 197,002,095566,Kedlaya; Kiran S.,9997,0,9999,2
1657108509270,MATH 197,003,095567,Xiao; Ming,9999,0,9999,0
1657108509270,MATH 197,004,095571,Perols; Johan Lars,9998,0,9999,1
1657108516419,COGS 9,A01,083615,Shannon; Kyle Michael,7,0,75,68
1657108522446,COGS 11,A01,083617,Boyle; Mary E. T.,21,0,48,27
1657108528478,COGS 13,A01,083071,Bastos; Amalia Pinkusfeld,9,0,71,62
1657108534505,COGS 14A,A01,092681,Semenuks; Arturs,1,1,100,99
1657108540533,COGS 14B,A01,083073,Cheng; Tzu-Han,6,0,63,57
1657108546558,COGS 17,A01,092677,Semenuks; Arturs,4,0,81,77
1657108552585,COGS 100,A01,083619,Allen; Michael Gordon,15,0,70,55
1657108558614,COGS 101A,A01,083621,Davis; Joshua Daniel,9,0,68,59
1657108564642,COGS 101B,A01,091572,Allen; Michael Gordon,8,0,65,57
1657108570676,COGS 101C,A01,083625,Delgado; Tania,17,0,35,18
1657108576702,COGS 107A,A01,083627,Boyle; Mary E. T.,13,0,60,47
1657108582727,COGS 118A,A01,083075,Gupta; Anjum,15,0,76,61
1657108588753,CSE 3,A50,083646,Miranda; Gregory Joseph,22,0,50,28
1657108594778,CSE 8A,A50,083650,Miranda; Gregory Joseph,17,1,56,39
1657108600805,CSE 11,A01,083080,Cao; Yingjun,4,15,40,36
1657108606833,CSE 12,A01,083652,Krause-Levy; Sophia Louisa,23,1,120,97
1657108612866,CSE 15L,A01,083654,Morris; Justin Loren,9,0,50,41
1657108612866,CSE 15L,A02,083655,Morris; Justin Loren,9,0,50,41
1657108618893,CSE 20,A01,083657,Tran; Khoa Dang,37,0,80,43
1657108624927,CSE 21,A01,095574,Bach; Quang Tran,21,0,48,27
1657108630955,CSE 30,A01,083084,Eldon; John,4,0,80,76
1657108630955,CSE 30,B01,095061,Bhaskar; Nishant,6,0,50,44
1657108636989,CSE 100,A01,083659,Cao; Yingjun,4,4,70,66
1657108643016,CSE 134B,A01,083661,Powell; Thomas Allan,19,0,100,81
1657108649060,CSE 140,A01,083663,Gungor; Onat,14,0,85,71
1657108655085,CSE 140L,A01,083088,Eldon; John,17,0,100,83
1657108661111,CSE 175,A01,083665,Kumar; Rakesh,3,0,25,22
1657108667144,CSE 190,A00,092507,Dubnov; Shlomo,7,0,20,13
1657108673174,ECE 45,A01,083139,Congero; Spencer William,5,0,75,70
1657108679205,ECE 65,A50,083695,Saad; Andrew S,12,0,30,18
1657108679205,ECE 65,A51,095125,Saad; Andrew S,25,0,26,1
1657108685232,ECE 109,A01,091882,Touri; Behrouz,16,0,70,54
1657108691261,ECE 180,A00,083140,Abi Samra; Nicholas Camill,1,0,30,29
1657108691261,ECE 180,B00,083141,Abi Samra; Nicholas Camill,0,0,30,30
1657108697288,MATH 10A,A01,083735,Patchell; Gregory David,1,0,30,29
1657108697288,MATH 10A,A02,083736,Patchell; Gregory David,20,0,30,10
1657108697288,MATH 10A,A03,083737,Patchell; Gregory David,16,0,30,14
1657108703328,MATH 10B,A01,083207,Lim; Seonhee,7,0,34,27
1657108703328,MATH 10B,A02,083208,Lim; Seonhee,9,0,35,26
1657108703328,MATH 10B,A03,093472,Lim; Seonhee,5,0,34,29
1657108703328,MATH 10B,B01,083739,Sinha; Shubham,9,0,30,21
1657108709371,MATH 18,A01,083743,Cinel; Cameron Alexander,6,0,30,24
1657108709371,MATH 18,A02,083744,Cinel; Cameron Alexander,15,0,30,15
1657108709371,MATH 18,A03,083745,Cinel; Cameron Alexander,8,0,30,22
1657108709371,MATH 18,B01,083748,Rideout; David Porter,4,0,37,33
1657108709371,MATH 18,B02,083749,Rideout; David Porter,3,0,36,33
1657108709371,MATH 18,B03,083750,Rideout; David Porter,2,0,37,35
1657108709371,MATH 18,B04,083751,Rideout; David Porter,5,0,36,31
1657108709371,MATH 18,B05,093473,Rideout; David Porter,4,0,36,32
1657108709371,MATH 18,B06,093474,Rideout; David Porter,5,0,36,31
1657108715402,MATH 20A,A01,083754,Zheng; Zequn,12,0,40,28
1657108721439,MATH 20B,A01,083756,Briones; Jor-el Thomas Caparas,1,0,36,35
1657108721439,MATH 20B,A02,083757,Briones; Jor-el Thomas Caparas,1,0,36,35
1657108721439,MATH 20B,A03,093475,Briones; Jor-el Thomas Caparas,0,0,36,36
1657108727467,MATH 20C,A01,083760,Briones; Jor-el Thomas Caparas,1,0,35,34
1657108727467,MATH 20C,A02,083761,Briones; Jor-el Thomas Caparas,8,0,35,27
1657108727467,MATH 20C,A03,093476,Briones; Jor-el Thomas Caparas,0,1,36,36
1657108727467,MATH 20C,B01,083762,Bach; Quang Tran,0,0,30,30
1657108733496,MATH 20D,A01,083765,Tran; Brian Kha,4,0,30,26
1657108733496,MATH 20D,A02,083766,Tran; Brian Kha,5,0,30,25
1657108733496,MATH 20D,A03,083767,Tran; Brian Kha,3,0,30,27
1657108739533,MATH 20E,A01,083771,Ganguly; Soumya,6,0,32,26
1657108739533,MATH 20E,A02,083772,Ganguly; Soumya,6,0,32,26
1657108739533,MATH 20E,B01,083773,Ciotti; Benjamin,18,0,35,17
1657108739533,MATH 20E,B02,083774,Ciotti; Benjamin,17,0,35,18
1657108745583,MATH 103A,A01,083777,Greenfeld; Be'Eri,2,0,36,34
1657108745583,MATH 103A,A02,083778,Greenfeld; Be'Eri,5,0,36,31
1657108745583,MATH 103A,A03,093561,Greenfeld; Be'Eri,4,0,36,32
1657108745583,MATH 103A,B01,083779,Greenfeld; Be'Eri,6,0,36,30
1657108745583,MATH 103A,B02,083780,Greenfeld; Be'Eri,2,0,36,34
1657108745583,MATH 103A,B03,093562,Greenfeld; Be'Eri,3,0,36,33
1657108751616,MATH 105,A01,085443,Carter; Anne Toulson,14,0,35,21
1657108751616,MATH 105,A02,093477,Carter; Anne Toulson,20,0,35,15
1657108757643,MATH 109,A01,083213,Ganzberger; Geoffrey Michael,2,0,34,32
1657108757643,MATH 109,A02,083214,Ganzberger; Geoffrey Michael,3,0,34,31
1657108757643,MATH 109,A03,093478,Ganzberger; Geoffrey Michael,1,0,34,33
1657108757643,MATH 109,B01,083215,Ganzberger; Geoffrey Michael,1,0,32,31
1657108757643,MATH 109,B02,083216,Ganzberger; Geoffrey Michael,1,0,32,31
1657108757643,MATH 109,B03,093479,Ganzberger; Geoffrey Michael,6,0,32,26
1657108763674,MATH 142A,A01,083219,Chow; Bennett,6,0,32,26
1657108763674,MATH 142A,A02,083220,Chow; Bennett,10,0,32,22
1657108763674,MATH 142A,A03,093480,Chow; Bennett,7,0,32,25
1657108763674,MATH 142A,B03,093481,Chow; Bennett,8,0,32,24
1657108763674,MATH 142A,B04,093558,Chow; Bennett,11,0,32,21
1657108763674,MATH 142A,B05,093559,Chow; Bennett,6,0,32,26
1657108769704,MATH 193A,A01,083224,Rotar; Vladimir,7,0,34,27
1657108769704,MATH 193A,A02,083225,Rotar; Vladimir,5,0,34,29
1657108769704,MATH 193A,A03,083781,Rotar; Vladimir,1,0,34,33
1657108769704,MATH 193A,A04,083782,Rotar; Vladimir,6,0,34,28
1657108769704,MATH 193A,A05,093482,Rotar; Vladimir,6,0,34,28
1657108783515,MATH 197,001,091859,McAuley; Julian John,9999,0,9999,0
1657108783515,MATH 197,002,095566,Kedlaya; Kiran S.,9997,0,9999,2
1657108783515,MATH 197,003,095567,Xiao; Ming,9999,0,9999,0
1657108783515,MATH 197,004,095571,Perols; Johan Lars,9998,0,9999,1
1657108790593,COGS 9,A01,083615,Shannon; Kyle Michael,7,0,75,68
1657108799132,COGS 11,A01,083617,Boyle; Mary E. T.,21,0,48,27
1657108805162,COGS 13,A01,083071,Bastos; Amalia Pinkusfeld,9,0,71,62
1657108811190,COGS 14A,A01,092681,Semenuks; Arturs,1,1,100,99
1657108817220,COGS 14B,A01,083073,Cheng; Tzu-Han,6,0,63,57
1657108823254,COGS 17,A01,092677,Semenuks; Arturs,4,0,81,77
1657108829284,COGS 100,A01,083619,Allen; Michael Gordon,15,0,70,55
1657108835316,COGS 101A,A01,083621,Davis; Joshua Daniel,9,0,68,59
1657108841346,COGS 101B,A01,091572,Allen; Michael Gordon,8,0,65,57
1657108847378,COGS 101C,A01,083625,Delgado; Tania,17,0,35,18
1657108853417,COGS 107A,A01,083627,Boyle; Mary E. T.,13,0,60,47
1657108859450,COGS 118A,A01,083075,Gupta; Anjum,15,0,76,61
1657108865476,CSE 3,A50,083646,Miranda; Gregory Joseph,22,0,50,28
1657108871502,CSE 8A,A50,083650,Miranda; Gregory Joseph,17,1,56,39
1657108877532,CSE 11,A01,083080,Cao; Yingjun,4,15,40,36
1657108883562,CSE 12,A01,083652,Krause-Levy; Sophia Louisa,23,1,120,97
1657108889592,CSE 15L,A01,083654,Morris; Justin Loren,9,0,50,41
1657108889592,CSE 15L,A02,083655,Morris; Justin Loren,9,0,50,41
1657108895618,CSE 20,A01,083657,Tran; Khoa Dang,37,0,80,43
1657108901647,CSE 21,A01,095574,Bach; Quang Tran,21,0,48,27
1657108907674,CSE 30,A01,083084,Eldon; John,4,0,80,76
1657108907674,CSE 30,B01,095061,Bhaskar; Nishant,6,0,50,44
1657108913699,CSE 100,A01,083659,Cao; Yingjun,4,4,70,66
1657108919730,CSE 134B,A01,083661,Powell; Thomas Allan,19,0,100,81
1657108925757,CSE 140,A01,083663,Gungor; Onat,14,0,85,71
1657108931787,CSE 140L,A01,083088,Eldon; John,17,0,100,83
1657108937813,CSE 175,A01,083665,Kumar; Rakesh,3,0,25,22
1657108943844,CSE 190,A00,092507,Dubnov; Shlomo,7,0,20,13
1657108949879,ECE 45,A01,083139,Congero; Spencer William,5,0,75,70
1657108955913,ECE 65,A50,083695,Saad; Andrew S,12,0,30,18
1657108955913,ECE 65,A51,095125,Saad; Andrew S,25,0,26,1
1657108961940,ECE 109,A01,091882,Touri; Behrouz,16,0,70,54
1657108967969,ECE 180,A00,083140,Abi Samra; Nicholas Camill,1,0,30,29
1657108967969,ECE 180,B00,083141,Abi Samra; Nicholas Camill,0,0,30,30
1657108974003,MATH 10A,A01,083735,Patchell; Gregory David,1,0,30,29
1657108974003,MATH 10A,A02,083736,Patchell; Gregory David,20,0,30,10
1657108974003,MATH 10A,A03,083737,Patchell; Gregory David,16,0,30,14
1657108980043,MATH 10B,A01,083207,Lim; Seonhee,7,0,34,27
1657108980043,MATH 10B,A02,083208,Lim; Seonhee,9,0,35,26
1657108980043,MATH 10B,A03,093472,Lim; Seonhee,5,0,34,29
1657108980043,MATH 10B,B01,083739,Sinha; Shubham,9,0,30,21
1657108986073,MATH 18,A01,083743,Cinel; Cameron Alexander,6,0,30,24
1657108986073,MATH 18,A02,083744,Cinel; Cameron Alexander,15,0,30,15
1657108986073,MATH 18,A03,083745,Cinel; Cameron Alexander,8,0,30,22
1657108986073,MATH 18,B01,083748,Rideout; David Porter,4,0,37,33
1657108986073,MATH 18,B02,083749,Rideout; David Porter,3,0,36,33
1657108986073,MATH 18,B03,083750,Rideout; David Porter,2,0,37,35
1657108986073,MATH 18,B04,083751,Rideout; David Porter,5,0,36,31
1657108986073,MATH 18,B05,093473,Rideout; David Porter,4,0,36,32
1657108986073,MATH 18,B06,093474,Rideout; David Porter,5,0,36,31
1657108992100,MATH 20A,A01,083754,Zheng; Zequn,12,0,40,28
1657108998133,MATH 20B,A01,083756,Briones; Jor-el Thomas Caparas,1,0,36,35
1657108998133,MATH 20B,A02,083757,Briones; Jor-el Thomas Caparas,1,0,36,35
1657108998133,MATH 20B,A03,093475,Briones; Jor-el Thomas Caparas,0,0,36,36
1657109004170,MATH 20C,A01,083760,Briones; Jor-el Thomas Caparas,1,0,35,34
1657109004170,MATH 20C,A02,083761,Briones; Jor-el Thomas Caparas,8,0,35,27
1657109004170,MATH 20C,A03,093476,Briones; Jor-el Thomas Caparas,0,1,36,36
1657109004170,MATH 20C,B01,083762,Bach; Quang Tran,0,0,30,30
1657109010204,MATH 20D,A01,083765,Tran; Brian Kha,4,0,30,26
1657109010204,MATH 20D,A02,083766,Tran; Brian Kha,5,0,30,25
1657109010204,MATH 20D,A03,083767,Tran; Brian Kha,3,0,30,27
1657109016243,MATH 20E,A01,083771,Ganguly; Soumya,6,0,32,26
1657109016243,MATH 20E,A02,083772,Ganguly; Soumya,6,0,32,26
1657109016243,MATH 20E,B01,083773,Ciotti; Benjamin,18,0,35,17
1657109016243,MATH 20E,B02,083774,Ciotti; Benjamin,17,0,35,18
1657109022321,MATH 103A,A01,083777,Greenfeld; Be'Eri,2,0,36,34
1657109022321,MATH 103A,A02,083778,Greenfeld; Be'Eri,5,0,36,31
1657109022321,MATH 103A,A03,093561,Greenfeld; Be'Eri,4,0,36,32
1657109022321,MATH 103A,B01,083779,Greenfeld; Be'Eri,6,0,36,30
1657109022321,MATH 103A,B02,083780,Greenfeld; Be'Eri,2,0,36,34
1657109022321,MATH 103A,B03,093562,Greenfeld; Be'Eri,3,0,36,33
1657109028347,MATH 105,A01,085443,Carter; Anne Toulson,14,0,35,21
1657109028347,MATH 105,A02,093477,Carter; Anne Toulson,20,0,35,15
1657109034375,MATH 109,A01,083213,Ganzberger; Geoffrey Michael,2,0,34,32
1657109034375,MATH 109,A02,083214,Ganzberger; Geoffrey Michael,3,0,34,31
1657109034375,MATH 109,A03,093478,Ganzberger; Geoffrey Michael,1,0,34,33
1657109034375,MATH 109,B01,083215,Ganzberger; Geoffrey Michael,1,0,32,31
1657109034375,MATH 109,B02,083216,Ganzberger; Geoffrey Michael,1,0,32,31
1657109034375,MATH 109,B03,093479,Ganzberger; Geoffrey Michael,6,0,32,26
1657109040403,MATH 142A,A01,083219,Chow; Bennett,6,0,32,26
1657109040403,MATH 142A,A02,083220,Chow; Bennett,10,0,32,22
1657109040403,MATH 142A,A03,093480,Chow; Bennett,7,0,32,25
1657109040403,MATH 142A,B03,093481,Chow; Bennett,8,0,32,24
1657109040403,MATH 142A,B04,093558,Chow; Bennett,11,0,32,21
1657109040403,MATH 142A,B05,093559,Chow; Bennett,6,0,32,26
1657109046433,MATH 193A,A01,083224,Rotar; Vladimir,7,0,34,27
1657109046433,MATH 193A,A02,083225,Rotar; Vladimir,5,0,34,29
1657109046433,MATH 193A,A03,083781,Rotar; Vladimir,1,0,34,33
1657109046433,MATH 193A,A04,083782,Rotar; Vladimir,6,0,34,28
1657109046433,MATH 193A,A05,093482,Rotar; Vladimir,6,0,34,28
1657109052460,MATH 197,001,091859,McAuley; Julian John,9999,0,9999,0
1657109052460,MATH 197,002,095566,Kedlaya; Kiran S.,9997,0,9999,2
1657109052460,MATH 197,003,095567,Xiao; Ming,9999,0,9999,0
1657109052460,MATH 197,004,095571,Perols; Johan Lars,9998,0,9999,1
1657109059529,COGS 9,A01,083615,Shannon; Kyle Michael,7,0,75,68
1657109065560,COGS 11,A01,083617,Boyle; Mary E. T.,21,0,48,27
1657109071595,COGS 13,A01,083071,Bastos; Amalia Pinkusfeld,9,0,71,62
1657109077624,COGS 14A,A01,092681,Semenuks; Arturs,1,1,100,99
1657109083653,COGS 14B,A01,083073,Cheng; Tzu-Han,6,0,63,57
1657109089683,COGS 17,A01,092677,Semenuks; Arturs,4,0,81,77
1657109095801,COGS 100,A01,083619,Allen; Michael Gordon,15,0,70,55
1657109101829,COGS 101A,A01,083621,Davis; Joshua Daniel,9,0,68,59
1657109107863,COGS 101B,A01,091572,Allen; Michael Gordon,8,0,65,57
1657109113892,COGS 101C,A01,083625,Delgado; Tania,17,0,35,18
1657109119927,COGS 107A,A01,083627,Boyle; Mary E. T.,13,0,60,47
1657109125955,COGS 118A,A01,083075,Gupta; Anjum,15,0,76,61
1657109131986,CSE 3,A50,083646,Miranda; Gregory Joseph,22,0,50,28
1657109138030,CSE 8A,A50,083650,Miranda; Gregory Joseph,17,1,56,39
1657109144058,CSE 11,A01,083080,Cao; Yingjun,4,15,40,36
1657109150091,CSE 12,A01,083652,Krause-Levy; Sophia Louisa,23,1,120,97
1657109156121,CSE 15L,A01,083654,Morris; Justin Loren,9,0,50,41
1657109156121,CSE 15L,A02,083655,Morris; Justin Loren,9,0,50,41
1657109162152,CSE 20,A01,083657,Tran; Khoa Dang,37,0,80,43
1657109168187,CSE 21,A01,095574,Bach; Quang Tran,21,0,48,27
1657109174224,CSE 30,A01,083084,Eldon; John,4,0,80,76
1657109174224,CSE 30,B01,095061,Bhaskar; Nishant,6,0,50,44
1657109180252,CSE 100,A01,083659,Cao; Yingjun,4,4,70,66
1657109186288,CSE 134B,A01,083661,Powell; Thomas Allan,19,0,100,81
1657109192314,CSE 140,A01,083663,Gungor; Onat,14,0,85,71
1657109198347,CSE 140L,A01,083088,Eldon; John,17,0,100,83
1657109204379,CSE 175,A01,083665,Kumar; Rakesh,3,0,25,22
1657109210412,CSE 190,A00,092507,Dubnov; Shlomo,7,0,20,13
1657109216443,ECE 45,A01,083139,Congero; Spencer William,5,0,75,70
1657109222478,ECE 65,A50,083695,Saad; Andrew S,12,0,30,18
1657109222478,ECE 65,A51,095125,Saad; Andrew S,25,0,26,1
1657109228506,ECE 109,A01,091882,Touri; Behrouz,16,0,70,54
1657109234537,ECE 180,A00,083140,Abi Samra; Nicholas Camill,1,0,30,29
1657109234537,ECE 180,B00,083141,Abi Samra; Nicholas Camill,0,0,30,30
1657109240577,MATH 10A,A01,083735,Patchell; Gregory David,1,0,30,29
1657109240577,MATH 10A,A02,083736,Patchell; Gregory David,20,0,30,10
1657109240577,MATH 10A,A03,083737,Patchell; Gregory David,16,0,30,14
1657109246627,MATH 10B,A01,083207,Lim; Seonhee,7,0,34,27
1657109246627,MATH 10B,A02,083208,Lim; Seonhee,9,0,35,26
1657109246627,MATH 10B,A03,093472,Lim; Seonhee,5,0,34,29
1657109246627,MATH 10B,B01,083739,Sinha; Shubham,9,0,30,21
1657109252659,MATH 18,A01,083743,Cinel; Cameron Alexander,6,0,30,24
1657109252659,MATH 18,A02,083744,Cinel; Cameron Alexander,15,0,30,15
1657109252659,MATH 18,A03,083745,Cinel; Cameron Alexander,8,0,30,22
1657109252659,MATH 18,B01,083748,Rideout; David Porter,4,0,37,33
1657109252659,MATH 18,B02,083749,Rideout; David Porter,3,0,36,33
1657109252659,MATH 18,B03,083750,Rideout; David Porter,2,0,37,35
1657109252659,MATH 18,B04,083751,Rideout; David Porter,5,0,36,31
1657109252659,MATH 18,B05,093473,Rideout; David Porter,4,0,36,32
1657109252659,MATH 18,B06,093474,Rideout; David Porter,5,0,36,31
1657109258683,MATH 20A,A01,083754,Zheng; Zequn,12,0,40,28
1657109264715,MATH 20B,A01,083756,Briones; Jor-el Thomas Caparas,1,0,36,35
1657109264715,MATH 20B,A02,083757,Briones; Jor-el Thomas Caparas,1,0,36,35
1657109264715,MATH 20B,A03,093475,Briones; Jor-el Thomas Caparas,0,0,36,36
1657109270747,MATH 20C,A01,083760,Briones; Jor-el Thomas Caparas,1,0,35,34
1657109270747,MATH 20C,A02,083761,Briones; Jor-el Thomas Caparas,8,0,35,27
1657109270747,MATH 20C,A03,093476,Briones; Jor-el Thomas Caparas,0,1,36,36
1657109270747,MATH 20C,B01,083762,Bach; Quang Tran,0,0,30,30
1657109276774,MATH 20D,A01,083765,Tran; Brian Kha,4,0,30,26
1657109276774,MATH 20D,A02,083766,Tran; Brian Kha,5,0,30,25
1657109276774,MATH 20D,A03,083767,Tran; Brian Kha,3,0,30,27
1657109282803,MATH 20E,A01,083771,Ganguly; Soumya,6,0,32,26
1657109282803,MATH 20E,A02,083772,Ganguly; Soumya,6,0,32,26
1657109282803,MATH 20E,B01,083773,Ciotti; Benjamin,18,0,35,17
1657109282803,MATH 20E,B02,083774,Ciotti; Benjamin,17,0,35,18
1657109288830,MATH 103A,A01,083777,Greenfeld; Be'Eri,2,0,36,34
1657109288830,MATH 103A,A02,083778,Greenfeld; Be'Eri,5,0,36,31
1657109288830,MATH 103A,A03,093561,Greenfeld; Be'Eri,4,0,36,32
1657109288830,MATH 103A,B01,083779,Greenfeld; Be'Eri,6,0,36,30
1657109288830,MATH 103A,B02,083780,Greenfeld; Be'Eri,2,0,36,34
1657109288830,MATH 103A,B03,093562,Greenfeld; Be'Eri,3,0,36,33
1657109294862,MATH 105,A01,085443,Carter; Anne Toulson,14,0,35,21
1657109294862,MATH 105,A02,093477,Carter; Anne Toulson,20,0,35,15
1657109300887,MATH 109,A01,083213,Ganzberger; Geoffrey Michael,2,0,34,32
1657109300887,MATH 109,A02,083214,Ganzberger; Geoffrey Michael,3,0,34,31
1657109300887,MATH 109,A03,093478,Ganzberger; Geoffrey Michael,1,0,34,33
1657109300887,MATH 109,B01,083215,Ganzberger; Geoffrey Michael,1,0,32,31
1657109300887,MATH 109,B02,083216,Ganzberger; Geoffrey Michael,1,0,32,31
1657109300887,MATH 109,B03,093479,Ganzberger; Geoffrey Michael,6,0,32,26
1657109306920,MATH 142A,A01,083219,Chow; Bennett,6,0,32,26
1657109306920,MATH 142A,A02,083220,Chow; Bennett,10,0,32,22
1657109306920,MATH 142A,A03,093480,Chow; Bennett,7,0,32,25
1657109306920,MATH 142A,B03,093481,Chow; Bennett,8,0,32,24
1657109306920,MATH 142A,B04,093558,Chow; Bennett,11,0,32,21
1657109306920,MATH 142A,B05,093559,Chow; Bennett,6,0,32,26
1657109312955,MATH 193A,A01,083224,Rotar; Vladimir,7,0,34,27
1657109312955,MATH 193A,A02,083225,Rotar; Vladimir,5,0,34,29
1657109312955,MATH 193A,A03,083781,Rotar; Vladimir,1,0,34,33
1657109312955,MATH 193A,A04,083782,Rotar; Vladimir,6,0,34,28
1657109312955,MATH 193A,A05,093482,Rotar; Vladimir,6,0,34,28
1657109318985,MATH 197,001,091859,McAuley; Julian John,9999,0,9999,0
1657109318985,MATH 197,002,095566,Kedlaya; Kiran S.,9997,0,9999,2
1657109318985,MATH 197,003,095567,Xiao; Ming,9999,0,9999,0
1657109318985,MATH 197,004,095571,Perols; Johan Lars,9998,0,9999,1
1657109326070,COGS 9,A01,083615,Shannon; Kyle Michael,7,0,75,68
1657109332100,COGS 11,A01,083617,Boyle; Mary E. T.,21,0,48,27
1657109338131,COGS 13,A01,083071,Bastos; Amalia Pinkusfeld,9,0,71,62
1657109344159,COGS 14A,A01,092681,Semenuks; Arturs,1,1,100,99
1657109350186,COGS 14B,A01,083073,Cheng; Tzu-Han,6,0,63,57
1657109356213,COGS 17,A01,092677,Semenuks; Arturs,4,0,81,77
1657109362244,COGS 100,A01,083619,Allen; Michael Gordon,15,0,70,55
1657109368276,COGS 101A,A01,083621,Davis; Joshua Daniel,9,0,68,59
1657109374306,COGS 101B,A01,091572,Allen; Michael Gordon,8,0,65,57
1657109380336,COGS 101C,A01,083625,Delgado; Tania,17,0,35,18
1657109386369,COGS 107A,A01,083627,Boyle; Mary E. T.,13,0,60,47
1657109392409,COGS 118A,A01,083075,Gupta; Anjum,15,0,76,61
1657109398436,CSE 3,A50,083646,Miranda; Gregory Joseph,22,0,50,28
1657109404462,CSE 8A,A50,083650,Miranda; Gregory Joseph,17,1,56,39
1657109410491,CSE 11,A01,083080,Cao; Yingjun,4,15,40,36
1657109416524,CSE 12,A01,083652,Krause-Levy; Sophia Louisa,23,1,120,97
1657109422550,CSE 15L,A01,083654,Morris; Justin Loren,9,0,50,41
1657109422550,CSE 15L,A02,083655,Morris; Justin Loren,9,0,50,41
1657109428577,CSE 20,A01,083657,Tran; Khoa Dang,37,0,80,43
1657109434600,CSE 21,A01,095574,Bach; Quang Tran,21,0,48,27
1657109440635,CSE 30,A01,083084,Eldon; John,4,0,80,76
1657109440635,CSE 30,B01,095061,Bhaskar; Nishant,6,0,50,44
1657109446664,CSE 100,A01,083659,Cao; Yingjun,4,4,70,66
1657109452687,CSE 134B,A01,083661,Powell; Thomas Allan,19,0,100,81
1657109458716,CSE 140,A01,083663,Gungor; Onat,14,0,85,71
1657109464741,CSE 140L,A01,083088,Eldon; John,17,0,100,83
1657109470768,CSE 175,A01,083665,Kumar; Rakesh,3,0,25,22
1657109476794,CSE 190,A00,092507,Dubnov; Shlomo,7,0,20,13
1657109482828,ECE 45,A01,083139,Congero; Spencer William,5,0,75,70
1657109488856,ECE 65,A50,083695,Saad; Andrew S,12,0,30,18
1657109488856,ECE 65,A51,095125,Saad; Andrew S,25,0,26,1
1657109494883,ECE 109,A01,091882,Touri; Behrouz,16,0,70,54
1657109500911,ECE 180,A00,083140,Abi Samra; Nicholas Camill,1,0,30,29
1657109500911,ECE 180,B00,083141,Abi Samra; Nicholas Camill,0,0,30,30
1657109506939,MATH 10A,A01,083735,Patchell; Gregory David,1,0,30,29
1657109506939,MATH 10A,A02,083736,Patchell; Gregory David,20,0,30,10
1657109506939,MATH 10A,A03,083737,Patchell; Gregory David,16,0,30,14
1657109512967,MATH 10B,A01,083207,Lim; Seonhee,7,0,34,27
1657109512967,MATH 10B,A02,083208,Lim; Seonhee,9,0,35,26
1657109512967,MATH 10B,A03,093472,Lim; Seonhee,5,0,34,29
1657109512967,MATH 10B,B01,083739,Sinha; Shubham,9,0,30,21
1657109519001,MATH 18,A01,083743,Cinel; Cameron Alexander,6,0,30,24
1657109519001,MATH 18,A02,083744,Cinel; Cameron Alexander,15,0,30,15
1657109519001,MATH 18,A03,083745,Cinel; Cameron Alexander,8,0,30,22
1657109519001,MATH 18,B01,083748,Rideout; David Porter,4,0,37,33
1657109519001,MATH 18,B02,083749,Rideout; David Porter,3,0,36,33
1657109519001,MATH 18,B03,083750,Rideout; David Porter,2,0,37,35
1657109519001,MATH 18,B04,083751,Rideout; David Porter,5,0,36,31
1657109519001,MATH 18,B05,093473,Rideout; David Porter,4,0,36,32
1657109519001,MATH 18,B06,093474,Rideout; David Porter,5,0,36,31
1657109525031,MATH 20A,A01,083754,Zheng; Zequn,12,0,40,28
1657109531062,MATH 20B,A01,083756,Briones; Jor-el Thomas Caparas,1,0,36,35
1657109531062,MATH 20B,A02,083757,Briones; Jor-el Thomas Caparas,1,0,36,35
1657109531062,MATH 20B,A03,093475,Briones; Jor-el Thomas Caparas,0,0,36,36
1657109537090,MATH 20C,A01,083760,Briones; Jor-el Thomas Caparas,1,0,35,34
1657109537090,MATH 20C,A02,083761,Briones; Jor-el Thomas Caparas,8,0,35,27
1657109537090,MATH 20C,A03,093476,Briones; Jor-el Thomas Caparas,0,1,36,36
1657109537090,MATH 20C,B01,083762,Bach; Quang Tran,0,0,30,30
1657109543115,MATH 20D,A01,083765,Tran; Brian Kha,4,0,30,26
1657109543115,MATH 20D,A02,083766,Tran; Brian Kha,5,0,30,25
1657109543115,MATH 20D,A03,083767,Tran; Brian Kha,3,0,30,27
1657109549152,MATH 20E,A01,083771,Ganguly; Soumya,6,0,32,26
1657109549152,MATH 20E,A02,083772,Ganguly; Soumya,6,0,32,26
1657109549152,MATH 20E,B01,083773,Ciotti; Benjamin,18,0,35,17
1657109549152,MATH 20E,B02,083774,Ciotti; Benjamin,17,0,35,18
1657109555191,MATH 103A,A01,083777,Greenfeld; Be'Eri,2,0,36,34
1657109555191,MATH 103A,A02,083778,Greenfeld; Be'Eri,5,0,36,31
1657109555191,MATH 103A,A03,093561,Greenfeld; Be'Eri,4,0,36,32
1657109555191,MATH 103A,B01,083779,Greenfeld; Be'Eri,6,0,36,30
1657109555191,MATH 103A,B02,083780,Greenfeld; Be'Eri,2,0,36,34
1657109555191,MATH 103A,B03,093562,Greenfeld; Be'Eri,3,0,36,33
1657109561225,MATH 105,A01,085443,Carter; Anne Toulson,14,0,35,21
1657109561225,MATH 105,A02,093477,Carter; Anne Toulson,20,0,35,15
1657109567257,MATH 109,A01,083213,Ganzberger; Geoffrey Michael,2,0,34,32
1657109567257,MATH 109,A02,083214,Ganzberger; Geoffrey Michael,3,0,34,31
1657109567257,MATH 109,A03,093478,Ganzberger; Geoffrey Michael,1,0,34,33
1657109567257,MATH 109,B01,083215,Ganzberger; Geoffrey Michael,1,0,32,31
1657109567257,MATH 109,B02,083216,Ganzberger; Geoffrey Michael,1,0,32,31
1657109567257,MATH 109,B03,093479,Ganzberger; Geoffrey Michael,6,0,32,26
1657109573285,MATH 142A,A01,083219,Chow; Bennett,6,0,32,26
1657109573285,MATH 142A,A02,083220,Chow; Bennett,10,0,32,22
1657109573285,MATH 142A,A03,093480,Chow; Bennett,7,0,32,25
1657109573285,MATH 142A,B03,093481,Chow; Bennett,8,0,32,24
1657109573285,MATH 142A,B04,093558,Chow; Bennett,11,0,32,21
1657109573285,MATH 142A,B05,093559,Chow; Bennett,6,0,32,26
1657109579314,MATH 193A,A01,083224,Rotar; Vladimir,7,0,34,27
1657109579314,MATH 193A,A02,083225,Rotar; Vladimir,5,0,34,29
1657109579314,MATH 193A,A03,083781,Rotar; Vladimir,1,0,34,33
1657109579314,MATH 193A,A04,083782,Rotar; Vladimir,6,0,34,28
1657109579314,MATH 193A,A05,093482,Rotar; Vladimir,6,0,34,28
1657109585341,MATH 197,001,091859,McAuley; Julian John,9999,0,9999,0
1657109585341,MATH 197,002,095566,Kedlaya; Kiran S.,9997,0,9999,2
1657109585341,MATH 197,003,095567,Xiao; Ming,9999,0,9999,0
1657109585341,MATH 197,004,095571,Perols; Johan Lars,9998,0,9999,1
1657109592449,COGS 9,A01,083615,Shannon; Kyle Michael,7,0,75,68
1657109598477,COGS 11,A01,083617,Boyle; Mary E. T.,21,0,48,27
1657109604510,COGS 13,A01,083071,Bastos; Amalia Pinkusfeld,9,0,71,62
1657109610546,COGS 14A,A01,092681,Semenuks; Arturs,1,1,100,99
1657109616580,COGS 14B,A01,083073,Cheng; Tzu-Han,6,0,63,57
1657109622608,COGS 17,A01,092677,Semenuks; Arturs,4,0,81,77
1657109628642,COGS 100,A01,083619,Allen; Michael Gordon,15,0,70,55
1657109634672,COGS 101A,A01,083621,Davis; Joshua Daniel,9,0,68,59
1657109640700,COGS 101B,A01,091572,Allen; Michael Gordon,8,0,65,57
1657109646727,COGS 101C,A01,083625,Delgado; Tania,17,0,35,18
1657109652764,COGS 107A,A01,083627,Boyle; Mary E. T.,13,0,60,47
1657109658795,COGS 118A,A01,083075,Gupta; Anjum,15,0,76,61
1657109664837,CSE 3,A50,083646,Miranda; Gregory Joseph,22,0,50,28
1657109670864,CSE 8A,A50,083650,Miranda; Gregory Joseph,17,1,56,39
1657109676896,CSE 11,A01,083080,Cao; Yingjun,4,15,40,36
1657109682929,CSE 12,A01,083652,Krause-Levy; Sophia Louisa,23,1,120,97
1657109688955,CSE 15L,A01,083654,Morris; Justin Loren,9,0,50,41
1657109688955,CSE 15L,A02,083655,Morris; Justin Loren,9,0,50,41
1657109695065,CSE 20,A01,083657,Tran; Khoa Dang,37,0,80,43
1657109701097,CSE 21,A01,095574,Bach; Quang Tran,21,0,48,27
1657109707127,CSE 30,A01,083084,Eldon; John,4,0,80,76
1657109707127,CSE 30,B01,095061,Bhaskar; Nishant,6,0,50,44
1657109713158,CSE 100,A01,083659,Cao; Yingjun,4,4,70,66
1657109719188,CSE 134B,A01,083661,Powell; Thomas Allan,19,0,100,81
1657109725220,CSE 140,A01,083663,Gungor; Onat,14,0,85,71
1657109731246,CSE 140L,A01,083088,Eldon; John,17,0,100,83
1657109737273,CSE 175,A01,083665,Kumar; Rakesh,3,0,25,22
1657109743301,CSE 190,A00,092507,Dubnov; Shlomo,7,0,20,13
1657109749329,ECE 45,A01,083139,Congero; Spencer William,5,0,75,70
1657109755358,ECE 65,A50,083695,Saad; Andrew S,12,0,30,18
1657109755358,ECE 65,A51,095125,Saad; Andrew S,25,0,26,1
1657109761395,ECE 109,A01,091882,Touri; Behrouz,16,0,70,54
1657109767427,ECE 180,A00,083140,Abi Samra; Nicholas Camill,1,0,30,29
1657109767427,ECE 180,B00,083141,Abi Samra; Nicholas Camill,0,0,30,30
1657109773473,MATH 10A,A01,083735,Patchell; Gregory David,1,0,30,29
1657109773473,MATH 10A,A02,083736,Patchell; Gregory David,20,0,30,10
1657109773473,MATH 10A,A03,083737,Patchell; Gregory David,16,0,30,14
1657109779513,MATH 10B,A01,083207,Lim; Seonhee,7,0,34,27
1657109779513,MATH 10B,A02,083208,Lim; Seonhee,9,0,35,26
1657109779513,MATH 10B,A03,093472,Lim; Seonhee,5,0,34,29
1657109779513,MATH 10B,B01,083739,Sinha; Shubham,9,0,30,21
1657109785545,MATH 18,A01,083743,Cinel; Cameron Alexander,6,0,30,24
1657109785545,MATH 18,A02,083744,Cinel; Cameron Alexander,15,0,30,15
1657109785545,MATH 18,A03,083745,Cinel; Cameron Alexander,8,0,30,22
1657109785545,MATH 18,B01,083748,Rideout; David Porter,4,0,37,33
1657109785545,MATH 18,B02,083749,Rideout; David Porter,3,0,36,33
1657109785545,MATH 18,B03,083750,Rideout; David Porter,2,0,37,35
1657109785545,MATH 18,B04,083751,Rideout; David Porter,5,0,36,31
1657109785545,MATH 18,B05,093473,Rideout; David Porter,4,0,36,32
1657109785545,MATH 18,B06,093474,Rideout; David Porter,5,0,36,31
1657109791573,MATH 20A,A01,083754,Zheng; Zequn,12,0,40,28
1657109797602,MATH 20B,A01,083756,Briones; Jor-el Thomas Caparas,1,0,36,35
1657109797602,MATH 20B,A02,083757,Briones; Jor-el Thomas Caparas,1,0,36,35
1657109797602,MATH 20B,A03,093475,Briones; Jor-el Thomas Caparas,0,0,36,36
1657109803630,MATH 20C,A01,083760,Briones; Jor-el Thomas Caparas,1,0,35,34
1657109803630,MATH 20C,A02,083761,Briones; Jor-el Thomas Caparas,8,0,35,27
1657109803630,MATH 20C,A03,093476,Briones; Jor-el Thomas Caparas,0,1,36,36
1657109803630,MATH 20C,B01,083762,Bach; Quang Tran,0,0,30,30
1657109809661,MATH 20D,A01,083765,Tran; Brian Kha,4,0,30,26
1657109809661,MATH 20D,A02,083766,Tran; Brian Kha,5,0,30,25
1657109809661,MATH 20D,A03,083767,Tran; Brian Kha,3,0,30,27
1657109815692,MATH 20E,A01,083771,Ganguly; Soumya,6,0,32,26
1657109815692,MATH 20E,A02,083772,Ganguly; Soumya,6,0,32,26
1657109815692,MATH 20E,B01,083773,Ciotti; Benjamin,18,0,35,17
1657109815692,MATH 20E,B02,083774,Ciotti; Benjamin,17,0,35,18
1657109821719,MATH 103A,A01,083777,Greenfeld; Be'Eri,2,0,36,34
1657109821719,MATH 103A,A02,083778,Greenfeld; Be'Eri,5,0,36,31
1657109821719,MATH 103A,A03,093561,Greenfeld; Be'Eri,4,0,36,32
1657109821719,MATH 103A,B01,083779,Greenfeld; Be'Eri,6,0,36,30
1657109821719,MATH 103A,B02,083780,Greenfeld; Be'Eri,2,0,36,34
1657109821719,MATH 103A,B03,093562,Greenfeld; Be'Eri,3,0,36,33
1657109827755,MATH 105,A01,085443,Carter; Anne Toulson,14,0,35,21
1657109827755,MATH 105,A02,093477,Carter; Anne Toulson,20,0,35,15
1657109833787,MATH 109,A01,083213,Ganzberger; Geoffrey Michael,2,0,34,32
1657109833787,MATH 109,A02,083214,Ganzberger; Geoffrey Michael,3,0,34,31
1657109833787,MATH 109,A03,093478,Ganzberger; Geoffrey Michael,1,0,34,33
1657109833787,MATH 109,B01,083215,Ganzberger; Geoffrey Michael,1,0,32,31
1657109833787,MATH 109,B02,083216,Ganzberger; Geoffrey Michael,1,0,32,31
1657109833787,MATH 109,B03,093479,Ganzberger; Geoffrey Michael,6,0,32,26
1657109839819,MATH 142A,A01,083219,Chow; Bennett,6,0,32,26
1657109839819,MATH 142A,A02,083220,Chow; Bennett,10,0,32,22
1657109839819,MATH 142A,A03,093480,Chow; Bennett,7,0,32,25
1657109839819,MATH 142A,B03,093481,Chow; Bennett,8,0,32,24
1657109839819,MATH 142A,B04,093558,Chow; Bennett,11,0,32,21
1657109839819,MATH 142A,B05,093559,Chow; Bennett,6,0,32,26
1657109845851,MATH 193A,A01,083224,Rotar; Vladimir,7,0,34,27
1657109845851,MATH 193A,A02,083225,Rotar; Vladimir,5,0,34,29
1657109845851,MATH 193A,A03,083781,Rotar; Vladimir,1,0,34,33
1657109845851,MATH 193A,A04,083782,Rotar; Vladimir,6,0,34,28
1657109845851,MATH 193A,A05,093482,Rotar; Vladimir,6,0,34,28
1657109851887,MATH 197,001,091859,McAuley; Julian John,9999,0,9999,0
1657109851887,MATH 197,002,095566,Kedlaya; Kiran S.,9997,0,9999,2
1657109851887,MATH 197,003,095567,Xiao; Ming,9999,0,9999,0
1657109851887,MATH 197,004,095571,Perols; Johan Lars,9998,0,9999,1
1657109858956,COGS 9,A01,083615,Shannon; Kyle Michael,7,0,75,68
1657109864981,COGS 11,A01,083617,Boyle; Mary E. T.,21,0,48,27
1657109871006,COGS 13,A01,083071,Bastos; Amalia Pinkusfeld,9,0,71,62
1657109877043,COGS 14A,A01,092681,Semenuks; Arturs,1,1,100,99
1657109883069,COGS 14B,A01,083073,Cheng; Tzu-Han,6,0,63,57
1657109889093,COGS 17,A01,092677,Semenuks; Arturs,4,0,81,77
1657109895130,COGS 100,A01,083619,Allen; Michael Gordon,15,0,70,55
1657109901160,COGS 101A,A01,083621,Davis; Joshua Daniel,9,0,68,59
1657109907190,COGS 101B,A01,091572,Allen; Michael Gordon,8,0,65,57
1657109913220,COGS 101C,A01,083625,Delgado; Tania,17,0,35,18
1657109919255,COGS 107A,A01,083627,Boyle; Mary E. T.,13,0,60,47
1657109925282,COGS 118A,A01,083075,Gupta; Anjum,15,0,76,61
1657109931310,CSE 3,A50,083646,Miranda; Gregory Joseph,22,0,50,28
1657109937341,CSE 8A,A50,083650,Miranda; Gregory Joseph,17,1,56,39
1657109943368,CSE 11,A01,083080,Cao; Yingjun,4,15,40,36
1657109949400,CSE 12,A01,083652,Krause-Levy; Sophia Louisa,23,1,120,97
1657109955427,CSE 15L,A01,083654,Morris; Justin Loren,9,0,50,41
1657109955427,CSE 15L,A02,083655,Morris; Justin Loren,9,0,50,41
1657109961455,CSE 20,A01,083657,Tran; Khoa Dang,37,0,80,43
1657109967482,CSE 21,A01,095574,Bach; Quang Tran,21,0,48,27
1657109973513,CSE 30,A01,083084,Eldon; John,4,0,80,76
1657109973513,CSE 30,B01,095061,Bhaskar; Nishant,6,0,50,44
1657109979546,CSE 100,A01,083659,Cao; Yingjun,4,4,70,66
1657109985572,CSE 134B,A01,083661,Powell; Thomas Allan,19,0,100,81
1657109991598,CSE 140,A01,083663,Gungor; Onat,14,0,85,71
1657109997628,CSE 140L,A01,083088,Eldon; John,17,0,100,83
1657110003658,CSE 175,A01,083665,Kumar; Rakesh,3,0,25,22
1657110009690,CSE 190,A00,092507,Dubnov; Shlomo,7,0,20,13
1657110015730,ECE 45,A01,083139,Congero; Spencer William,5,0,75,70
1657110021758,ECE 65,A50,083695,Saad; Andrew S,12,0,30,18
1657110021758,ECE 65,A51,095125,Saad; Andrew S,25,0,26,1
1657110027785,ECE 109,A01,091882,Touri; Behrouz,16,0,70,54
1657110033810,ECE 180,A00,083140,Abi Samra; Nicholas Camill,1,0,30,29
1657110033810,ECE 180,B00,083141,Abi Samra; Nicholas Camill,0,0,30,30
1657110041339,MATH 10A,A01,083735,Patchell; Gregory David,1,0,30,29
1657110041339,MATH 10A,A02,083736,Patchell; Gregory David,20,0,30,10
1657110041339,MATH 10A,A03,083737,Patchell; Gregory David,16,0,30,14
1657110047367,MATH 10B,A01,083207,Lim; Seonhee,7,0,34,27
1657110047367,MATH 10B,A02,083208,Lim; Seonhee,9,0,35,26
1657110047367,MATH 10B,A03,093472,Lim; Seonhee,5,0,34,29
1657110047367,MATH 10B,B01,083739,Sinha; Shubham,9,0,30,21
1657110053404,MATH 18,A01,083743,Cinel; Cameron Alexander,6,0,30,24
1657110053404,MATH 18,A02,083744,Cinel; Cameron Alexander,15,0,30,15
1657110053404,MATH 18,A03,083745,Cinel; Cameron Alexander,8,0,30,22
1657110053404,MATH 18,B01,083748,Rideout; David Porter,4,0,37,33
1657110053404,MATH 18,B02,083749,Rideout; David Porter,3,0,36,33
1657110053404,MATH 18,B03,083750,Rideout; David Porter,2,0,37,35
1657110053404,MATH 18,B04,083751,Rideout; David Porter,5,0,36,31
1657110053404,MATH 18,B05,093473,Rideout; David Porter,4,0,36,32
1657110053404,MATH 18,B06,093474,Rideout; David Porter,5,0,36,31
1657110059437,MATH 20A,A01,083754,Zheng; Zequn,12,0,40,28
1657110065463,MATH 20B,A01,083756,Briones; Jor-el Thomas Caparas,1,0,36,35
1657110065463,MATH 20B,A02,083757,Briones; Jor-el Thomas Caparas,1,0,36,35
1657110065463,MATH 20B,A03,093475,Briones; Jor-el Thomas Caparas,0,0,36,36
1657110071496,MATH 20C,A01,083760,Briones; Jor-el Thomas Caparas,1,0,35,34
1657110071496,MATH 20C,A02,083761,Briones; Jor-el Thomas Caparas,8,0,35,27
1657110071496,MATH 20C,A03,093476,Briones; Jor-el Thomas Caparas,0,1,36,36
1657110071496,MATH 20C,B01,083762,Bach; Quang Tran,0,0,30,30
1657110077524,MATH 20D,A01,083765,Tran; Brian Kha,4,0,30,26
1657110077524,MATH 20D,A02,083766,Tran; Brian Kha,5,0,30,25
1657110077524,MATH 20D,A03,083767,Tran; Brian Kha,3,0,30,27
1657110083567,MATH 20E,A01,083771,Ganguly; Soumya,6,0,32,26
1657110083567,MATH 20E,A02,083772,Ganguly; Soumya,6,0,32,26
1657110083567,MATH 20E,B01,083773,Ciotti; Benjamin,18,0,35,17
1657110083567,MATH 20E,B02,083774,Ciotti; Benjamin,17,0,35,18
1657110089601,MATH 103A,A01,083777,Greenfeld; Be'Eri,2,0,36,34
1657110089601,MATH 103A,A02,083778,Greenfeld; Be'Eri,5,0,36,31
1657110089601,MATH 103A,A03,093561,Greenfeld; Be'Eri,4,0,36,32
1657110089601,MATH 103A,B01,083779,Greenfeld; Be'Eri,6,0,36,30
1657110089601,MATH 103A,B02,083780,Greenfeld; Be'Eri,2,0,36,34
1657110089601,MATH 103A,B03,093562,Greenfeld; Be'Eri,3,0,36,33
1657110095631,MATH 105,A01,085443,Carter; Anne Toulson,14,0,35,21
1657110095631,MATH 105,A02,093477,Carter; Anne Toulson,20,0,35,15
1657110101660,MATH 109,A01,083213,Ganzberger; Geoffrey Michael,2,0,34,32
1657110101660,MATH 109,A02,083214,Ganzberger; Geoffrey Michael,3,0,34,31
1657110101660,MATH 109,A03,093478,Ganzberger; Geoffrey Michael,1,0,34,33
1657110101660,MATH 109,B01,083215,Ganzberger; Geoffrey Michael,1,0,32,31
1657110101660,MATH 109,B02,083216,Ganzberger; Geoffrey Michael,1,0,32,31
1657110101660,MATH 109,B03,093479,Ganzberger; Geoffrey Michael,6,0,32,26
1657110107695,MATH 142A,A01,083219,Chow; Bennett,6,0,32,26
1657110107695,MATH 142A,A02,083220,Chow; Bennett,10,0,32,22
1657110107695,MATH 142A,A03,093480,Chow; Bennett,7,0,32,25
1657110107695,MATH 142A,B03,093481,Chow; Bennett,8,0,32,24
1657110107695,MATH 142A,B04,093558,Chow; Bennett,11,0,32,21
1657110107695,MATH 142A,B05,093559,Chow; Bennett,6,0,32,26
1657110113723,MATH 193A,A01,083224,Rotar; Vladimir,7,0,34,27
1657110113723,MATH 193A,A02,083225,Rotar; Vladimir,5,0,34,29
1657110113723,MATH 193A,A03,083781,Rotar; Vladimir,1,0,34,33
1657110113723,MATH 193A,A04,083782,Rotar; Vladimir,6,0,34,28
1657110113723,MATH 193A,A05,093482,Rotar; Vladimir,6,0,34,28
1657110119748,MATH 197,001,091859,McAuley; Julian John,9999,0,9999,0
1657110119748,MATH 197,002,095566,Kedlaya; Kiran S.,9997,0,9999,2
1657110119748,MATH 197,003,095567,Xiao; Ming,9999,0,9999,0
1657110119748,MATH 197,004,095571,Perols; Johan Lars,9998,0,9999,1
1657110126833,COGS 9,A01,083615,Shannon; Kyle Michael,7,0,75,68
1657110132866,COGS 11,A01,083617,Boyle; Mary E. T.,21,0,48,27
1657110138897,COGS 13,A01,083071,Bastos; Amalia Pinkusfeld,9,0,71,62
1657110144934,COGS 14A,A01,092681,Semenuks; Arturs,1,1,100,99
1657110150963,COGS 14B,A01,083073,Cheng; Tzu-Han,6,0,63,57
1657110157009,COGS 17,A01,092677,Semenuks; Arturs,4,0,81,77
1657110163037,COGS 100,A01,083619,Allen; Michael Gordon,15,0,70,55
1657110169068,COGS 101A,A01,083621,Davis; Joshua Daniel,9,0,68,59
1657110175095,COGS 101B,A01,091572,Allen; Michael Gordon,8,0,65,57
1657110181119,COGS 101C,A01,083625,Delgado; Tania,17,0,35,18
1657110187143,COGS 107A,A01,083627,Boyle; Mary E. T.,13,0,60,47
1657110193171,COGS 118A,A01,083075,Gupta; Anjum,15,0,76,61
1657110199200,CSE 3,A50,083646,Miranda; Gregory Joseph,22,0,50,28
1657110205234,CSE 8A,A50,083650,Miranda; Gregory Joseph,17,1,56,39
1657110211259,CSE 11,A01,083080,Cao; Yingjun,4,15,40,36
1657110217284,CSE 12,A01,083652,Krause-Levy; Sophia Louisa,23,1,120,97
1657110223309,CSE 15L,A01,083654,Morris; Justin Loren,9,0,50,41
1657110223309,CSE 15L,A02,083655,Morris; Justin Loren,9,0,50,41
1657110229340,CSE 20,A01,083657,Tran; Khoa Dang,37,0,80,43
1657110235371,CSE 21,A01,095574,Bach; Quang Tran,21,0,48,27
1657110241397,CSE 30,A01,083084,Eldon; John,4,0,80,76
1657110241397,CSE 30,B01,095061,Bhaskar; Nishant,6,0,50,44
1657110247423,CSE 100,A01,083659,Cao; Yingjun,4,4,70,66
1657110253466,CSE 134B,A01,083661,Powell; Thomas Allan,19,0,100,81
1657110259506,CSE 140,A01,083663,Gungor; Onat,14,0,85,71
1657110265535,CSE 140L,A01,083088,Eldon; John,17,0,100,83
1657110271564,CSE 175,A01,083665,Kumar; Rakesh,3,0,25,22
1657110277587,CSE 190,A00,092507,Dubnov; Shlomo,7,0,20,13
1657110283612,ECE 45,A01,083139,Congero; Spencer William,5,0,75,70
1657110289644,ECE 65,A50,083695,Saad; Andrew S,12,0,30,18
1657110289644,ECE 65,A51,095125,Saad; Andrew S,25,0,26,1
1657110295741,ECE 109,A01,091882,Touri; Behrouz,16,0,70,54
1657110301764,ECE 180,A00,083140,Abi Samra; Nicholas Camill,1,0,30,29
1657110301764,ECE 180,B00,083141,Abi Samra; Nicholas Camill,0,0,30,30
1657110307799,MATH 10A,A01,083735,Patchell; Gregory David,1,0,30,29
1657110307799,MATH 10A,A02,083736,Patchell; Gregory David,20,0,30,10
1657110307799,MATH 10A,A03,083737,Patchell; Gregory David,16,0,30,14
1657110313827,MATH 10B,A01,083207,Lim; Seonhee,7,0,34,27
1657110313827,MATH 10B,A02,083208,Lim; Seonhee,9,0,35,26
1657110313827,MATH 10B,A03,093472,Lim; Seonhee,5,0,34,29
1657110313827,MATH 10B,B01,083739,Sinha; Shubham,9,0,30,21
1657110319899,MATH 18,A01,083743,Cinel; Cameron Alexander,6,0,30,24
1657110319899,MATH 18,A02,083744,Cinel; Cameron Alexander,15,0,30,15
1657110319899,MATH 18,A03,083745,Cinel; Cameron Alexander,8,0,30,22
1657110319899,MATH 18,B01,083748,Rideout; David Porter,4,0,37,33
1657110319899,MATH 18,B02,083749,Rideout; David Porter,3,0,36,33
1657110319899,MATH 18,B03,083750,Rideout; David Porter,2,0,37,35
1657110319899,MATH 18,B04,083751,Rideout; David Porter,5,0,36,31
1657110319899,MATH 18,B05,093473,Rideout; David Porter,4,0,36,32
1657110319899,MATH 18,B06,093474,Rideout; David Porter,5,0,36,31
1657110325924,MATH 20A,A01,083754,Zheng; Zequn,12,0,40,28
1657110331948,MATH 20B,A01,083756,Briones; Jor-el Thomas Caparas,1,0,36,35
1657110331948,MATH 20B,A02,083757,Briones; Jor-el Thomas Caparas,1,0,36,35
1657110331948,MATH 20B,A03,093475,Briones; Jor-el Thomas Caparas,0,0,36,36
1657110337972,MATH 20C,A01,083760,Briones; Jor-el Thomas Caparas,1,0,35,34
1657110337972,MATH 20C,A02,083761,Briones; Jor-el Thomas Caparas,8,0,35,27
1657110337972,MATH 20C,A03,093476,Briones; Jor-el Thomas Caparas,0,1,36,36
1657110337972,MATH 20C,B01,083762,Bach; Quang Tran,0,0,30,30
1657110344004,MATH 20D,A01,083765,Tran; Brian Kha,4,0,30,26
1657110344004,MATH 20D,A02,083766,Tran; Brian Kha,5,0,30,25
1657110344004,MATH 20D,A03,083767,Tran; Brian Kha,3,0,30,27
1657110350035,MATH 20E,A01,083771,Ganguly; Soumya,6,0,32,26
1657110350035,MATH 20E,A02,083772,Ganguly; Soumya,6,0,32,26
1657110350035,MATH 20E,B01,083773,Ciotti; Benjamin,18,0,35,17
1657110350035,MATH 20E,B02,083774,Ciotti; Benjamin,17,0,35,18
1657110356066,MATH 103A,A01,083777,Greenfeld; Be'Eri,2,0,36,34
1657110356066,MATH 103A,A02,083778,Greenfeld; Be'Eri,5,0,36,31
1657110356066,MATH 103A,A03,093561,Greenfeld; Be'Eri,4,0,36,32
1657110356066,MATH 103A,B01,083779,Greenfeld; Be'Eri,6,0,36,30
1657110356066,MATH 103A,B02,083780,Greenfeld; Be'Eri,2,0,36,34
1657110356066,MATH 103A,B03,093562,Greenfeld; Be'Eri,3,0,36,33
1657110362096,MATH 105,A01,085443,Carter; Anne Toulson,14,0,35,21
1657110362096,MATH 105,A02,093477,Carter; Anne Toulson,20,0,35,15
1657110368120,MATH 109,A01,083213,Ganzberger; Geoffrey Michael,2,0,34,32
1657110368120,MATH 109,A02,083214,Ganzberger; Geoffrey Michael,3,0,34,31
1657110368120,MATH 109,A03,093478,Ganzberger; Geoffrey Michael,1,0,34,33
1657110368120,MATH 109,B01,083215,Ganzberger; Geoffrey Michael,1,0,32,31
1657110368120,MATH 109,B02,083216,Ganzberger; Geoffrey Michael,1,0,32,31
1657110368120,MATH 109,B03,093479,Ganzberger; Geoffrey Michael,6,0,32,26
1657110374150,MATH 142A,A01,083219,Chow; Bennett,6,0,32,26
1657110374150,MATH 142A,A02,083220,Chow; Bennett,10,0,32,22
1657110374150,MATH 142A,A03,093480,Chow; Bennett,7,0,32,25
1657110374150,MATH 142A,B03,093481,Chow; Bennett,8,0,32,24
1657110374150,MATH 142A,B04,093558,Chow; Bennett,11,0,32,21
1657110374150,MATH 142A,B05,093559,Chow; Bennett,6,0,32,26
1657110380176,MATH 193A,A01,083224,Rotar; Vladimir,7,0,34,27
1657110380176,MATH 193A,A02,083225,Rotar; Vladimir,5,0,34,29
1657110380176,MATH 193A,A03,083781,Rotar; Vladimir,1,0,34,33
1657110380176,MATH 193A,A04,083782,Rotar; Vladimir,6,0,34,28
1657110380176,MATH 193A,A05,093482,Rotar; Vladimir,6,0,34,28
1657110386204,MATH 197,001,091859,McAuley; Julian John,9999,0,9999,0
1657110386204,MATH 197,002,095566,Kedlaya; Kiran S.,9997,0,9999,2
1657110386204,MATH 197,003,095567,Xiao; Ming,9999,0,9999,0
1657110386204,MATH 197,004,095571,Perols; Johan Lars,9998,0,9999,1
1657110393277,COGS 9,A01,083615,Shannon; Kyle Michael,7,0,75,68
1657110399310,COGS 11,A01,083617,Boyle; Mary E. T.,21,0,48,27
1657110405334,COGS 13,A01,083071,Bastos; Amalia Pinkusfeld,9,0,71,62
1657110411359,COGS 14A,A01,092681,Semenuks; Arturs,1,1,100,99
1657110417389,COGS 14B,A01,083073,Cheng; Tzu-Han,6,0,63,57
1657110423415,COGS 17,A01,092677,Semenuks; Arturs,4,0,81,77
1657110429444,COGS 100,A01,083619,Allen; Michael Gordon,15,0,70,55
1657110435470,COGS 101A,A01,083621,Davis; Joshua Daniel,9,0,68,59
1657110441500,COGS 101B,A01,091572,Allen; Michael Gordon,8,0,65,57
1657110447527,COGS 101C,A01,083625,Delgado; Tania,17,0,35,18
1657110453556,COGS 107A,A01,083627,Boyle; Mary E. T.,13,0,60,47
1657110459588,COGS 118A,A01,083075,Gupta; Anjum,15,0,76,61
1657110465616,CSE 3,A50,083646,Miranda; Gregory Joseph,22,0,50,28
1657110471645,CSE 8A,A50,083650,Miranda; Gregory Joseph,17,1,56,39
1657110477672,CSE 11,A01,083080,Cao; Yingjun,4,15,40,36
1657110483702,CSE 12,A01,083652,Krause-Levy; Sophia Louisa,23,1,120,97
1657110489725,CSE 15L,A01,083654,Morris; Justin Loren,9,0,50,41
1657110489725,CSE 15L,A02,083655,Morris; Justin Loren,9,0,50,41
1657110495754,CSE 20,A01,083657,Tran; Khoa Dang,37,0,80,43
1657110501779,CSE 21,A01,095574,Bach; Quang Tran,21,0,48,27
1657110507805,CSE 30,A01,083084,Eldon; John,4,0,80,76
1657110507805,CSE 30,B01,095061,Bhaskar; Nishant,6,0,50,44
1657110513832,CSE 100,A01,083659,Cao; Yingjun,4,4,70,66
1657110519858,CSE 134B,A01,083661,Powell; Thomas Allan,19,0,100,81
1657110525887,CSE 140,A01,083663,Gungor; Onat,14,0,85,71
1657110531917,CSE 140L,A01,083088,Eldon; John,17,0,100,83
1657110537942,CSE 175,A01,083665,Kumar; Rakesh,3,0,25,22
1657110543972,CSE 190,A00,092507,Dubnov; Shlomo,7,0,20,13
1657110549998,ECE 45,A01,083139,Congero; Spencer William,5,0,75,70
1657110556028,ECE 65,A50,083695,Saad; Andrew S,12,0,30,18
1657110556028,ECE 65,A51,095125,Saad; Andrew S,25,0,26,1
1657110562051,ECE 109,A01,091882,Touri; Behrouz,16,0,70,54
1657110568077,ECE 180,A00,083140,Abi Samra; Nicholas Camill,1,0,30,29
1657110568077,ECE 180,B00,083141,Abi Samra; Nicholas Camill,0,0,30,30
1657110574105,MATH 10A,A01,083735,Patchell; Gregory David,1,0,30,29
1657110574105,MATH 10A,A02,083736,Patchell; Gregory David,20,0,30,10
1657110574105,MATH 10A,A03,083737,Patchell; Gregory David,16,0,30,14
1657110580130,MATH 10B,A01,083207,Lim; Seonhee,7,0,34,27
1657110580130,MATH 10B,A02,083208,Lim; Seonhee,9,0,35,26
1657110580130,MATH 10B,A03,093472,Lim; Seonhee,5,0,34,29
1657110580130,MATH 10B,B01,083739,Sinha; Shubham,9,0,30,21
1657110586158,MATH 18,A01,083743,Cinel; Cameron Alexander,6,0,30,24
1657110586158,MATH 18,A02,083744,Cinel; Cameron Alexander,15,0,30,15
1657110586158,MATH 18,A03,083745,Cinel; Cameron Alexander,8,0,30,22
1657110586158,MATH 18,B01,083748,Rideout; David Porter,4,0,37,33
1657110586158,MATH 18,B02,083749,Rideout; David Porter,3,0,36,33
1657110586158,MATH 18,B03,083750,Rideout; David Porter,2,0,37,35
1657110586158,MATH 18,B04,083751,Rideout; David Porter,5,0,36,31
1657110586158,MATH 18,B05,093473,Rideout; David Porter,4,0,36,32
1657110586158,MATH 18,B06,093474,Rideout; David Porter,5,0,36,31
1657110592185,MATH 20A,A01,083754,Zheng; Zequn,12,0,40,28
1657110598211,MATH 20B,A01,083756,Briones; Jor-el Thomas Caparas,1,0,36,35
1657110598211,MATH 20B,A02,083757,Briones; Jor-el Thomas Caparas,1,0,36,35
1657110598211,MATH 20B,A03,093475,Briones; Jor-el Thomas Caparas,0,0,36,36
1657110604244,MATH 20C,A01,083760,Briones; Jor-el Thomas Caparas,1,0,35,34
1657110604244,MATH 20C,A02,083761,Briones; Jor-el Thomas Caparas,8,0,35,27
1657110604244,MATH 20C,A03,093476,Briones; Jor-el Thomas Caparas,0,1,36,36
1657110604244,MATH 20C,B01,083762,Bach; Quang Tran,0,0,30,30
1657110610278,MATH 20D,A01,083765,Tran; Brian Kha,4,0,30,26
1657110610278,MATH 20D,A02,083766,Tran; Brian Kha,5,0,30,25
1657110610278,MATH 20D,A03,083767,Tran; Brian Kha,3,0,30,27
1657110616322,MATH 20E,A01,083771,Ganguly; Soumya,6,0,32,26
1657110616322,MATH 20E,A02,083772,Ganguly; Soumya,6,0,32,26
1657110616322,MATH 20E,B01,083773,Ciotti; Benjamin,18,0,35,17
1657110616322,MATH 20E,B02,083774,Ciotti; Benjamin,17,0,35,18
1657110622351,MATH 103A,A01,083777,Greenfeld; Be'Eri,2,0,36,34
1657110622351,MATH 103A,A02,083778,Greenfeld; Be'Eri,5,0,36,31
1657110622351,MATH 103A,A03,093561,Greenfeld; Be'Eri,4,0,36,32
1657110622351,MATH 103A,B01,083779,Greenfeld; Be'Eri,6,0,36,30
1657110622351,MATH 103A,B02,083780,Greenfeld; Be'Eri,2,0,36,34
1657110622351,MATH 103A,B03,093562,Greenfeld; Be'Eri,3,0,36,33
1657110628378,MATH 105,A01,085443,Carter; Anne Toulson,14,0,35,21
1657110628378,MATH 105,A02,093477,Carter; Anne Toulson,20,0,35,15
1657110634404,MATH 109,A01,083213,Ganzberger; Geoffrey Michael,2,0,34,32
1657110634404,MATH 109,A02,083214,Ganzberger; Geoffrey Michael,3,0,34,31
1657110634404,MATH 109,A03,093478,Ganzberger; Geoffrey Michael,1,0,34,33
1657110634404,MATH 109,B01,083215,Ganzberger; Geoffrey Michael,1,0,32,31
1657110634404,MATH 109,B02,083216,Ganzberger; Geoffrey Michael,1,0,32,31
1657110634404,MATH 109,B03,093479,Ganzberger; Geoffrey Michael,6,0,32,26
1657110640441,MATH 142A,A01,083219,Chow; Bennett,6,0,32,26
1657110640441,MATH 142A,A02,083220,Chow; Bennett,10,0,32,22
1657110640441,MATH 142A,A03,093480,Chow; Bennett,7,0,32,25
1657110640441,MATH 142A,B03,093481,Chow; Bennett,8,0,32,24
1657110640441,MATH 142A,B04,093558,Chow; Bennett,11,0,32,21
1657110640441,MATH 142A,B05,093559,Chow; Bennett,6,0,32,26
1657110646473,MATH 193A,A01,083224,Rotar; Vladimir,7,0,34,27
1657110646473,MATH 193A,A02,083225,Rotar; Vladimir,5,0,34,29
1657110646473,MATH 193A,A03,083781,Rotar; Vladimir,1,0,34,33
1657110646473,MATH 193A,A04,083782,Rotar; Vladimir,6,0,34,28
1657110646473,MATH 193A,A05,093482,Rotar; Vladimir,6,0,34,28
1657110652511,MATH 197,001,091859,McAuley; Julian John,9999,0,9999,0
1657110652511,MATH 197,002,095566,Kedlaya; Kiran S.,9997,0,9999,2
1657110652511,MATH 197,003,095567,Xiao; Ming,9999,0,9999,0
1657110652511,MATH 197,004,095571,Perols; Johan Lars,9998,0,9999,1
1657110659604,COGS 9,A01,083615,Shannon; Kyle Michael,7,0,75,68
1657110665630,COGS 11,A01,083617,Boyle; Mary E. T.,21,0,48,27
1657110671659,COGS 13,A01,083071,Bastos; Amalia Pinkusfeld,9,0,71,62
1657110677692,COGS 14A,A01,092681,Semenuks; Arturs,1,1,100,99
1657110683718,COGS 14B,A01,083073,Cheng; Tzu-Han,6,0,63,57
1657110689759,COGS 17,A01,092677,Semenuks; Arturs,4,0,81,77
1657110695793,COGS 100,A01,083619,Allen; Michael Gordon,15,0,70,55
1657110701829,COGS 101A,A01,083621,Davis; Joshua Daniel,9,0,68,59
1657110707862,COGS 101B,A01,091572,Allen; Michael Gordon,8,0,65,57
1657110713896,COGS 101C,A01,083625,Delgado; Tania,17,0,35,18
1657110719922,COGS 107A,A01,083627,Boyle; Mary E. T.,13,0,60,47
1657110725946,COGS 118A,A01,083075,Gupta; Anjum,15,0,76,61
1657110731989,CSE 3,A50,083646,Miranda; Gregory Joseph,22,0,50,28
1657110738017,CSE 8A,A50,083650,Miranda; Gregory Joseph,17,1,56,39
1657110744045,CSE 11,A01,083080,Cao; Yingjun,4,15,40,36
1657110750071,CSE 12,A01,083652,Krause-Levy; Sophia Louisa,23,1,120,97
1657110756098,CSE 15L,A01,083654,Morris; Justin Loren,9,0,50,41
1657110756098,CSE 15L,A02,083655,Morris; Justin Loren,9,0,50,41
1657110762123,CSE 20,A01,083657,Tran; Khoa Dang,37,0,80,43
1657110768155,CSE 21,A01,095574,Bach; Quang Tran,21,0,48,27
1657110774190,CSE 30,A01,083084,Eldon; John,4,0,80,76
1657110774190,CSE 30,B01,095061,Bhaskar; Nishant,6,0,50,44
1657110780217,CSE 100,A01,083659,Cao; Yingjun,4,4,70,66
1657110786242,CSE 134B,A01,083661,Powell; Thomas Allan,19,0,100,81
1657110792268,CSE 140,A01,083663,Gungor; Onat,14,0,85,71
1657110798297,CSE 140L,A01,083088,Eldon; John,17,0,100,83
1657110804338,CSE 175,A01,083665,Kumar; Rakesh,3,0,25,22
1657110810369,CSE 190,A00,092507,Dubnov; Shlomo,7,0,20,13
1657110816398,ECE 45,A01,083139,Congero; Spencer William,5,0,75,70
1657110822434,ECE 65,A50,083695,Saad; Andrew S,12,0,30,18
1657110822434,ECE 65,A51,095125,Saad; Andrew S,25,0,26,1
1657110828472,ECE 109,A01,091882,Touri; Behrouz,16,0,70,54
1657110834502,ECE 180,A00,083140,Abi Samra; Nicholas Camill,1,0,30,29
1657110834502,ECE 180,B00,083141,Abi Samra; Nicholas Camill,0,0,30,30
1657110840541,MATH 10A,A01,083735,Patchell; Gregory David,1,0,30,29
1657110840541,MATH 10A,A02,083736,Patchell; Gregory David,20,0,30,10
1657110840541,MATH 10A,A03,083737,Patchell; Gregory David,16,0,30,14
1657110846570,MATH 10B,A01,083207,Lim; Seonhee,7,0,34,27
1657110846570,MATH 10B,A02,083208,Lim; Seonhee,9,0,35,26
1657110846570,MATH 10B,A03,093472,Lim; Seonhee,5,0,34,29
1657110846570,MATH 10B,B01,083739,Sinha; Shubham,9,0,30,21
1657110852616,MATH 18,A01,083743,Cinel; Cameron Alexander,6,0,30,24
1657110852616,MATH 18,A02,083744,Cinel; Cameron Alexander,15,0,30,15
1657110852616,MATH 18,A03,083745,Cinel; Cameron Alexander,8,0,30,22
1657110852616,MATH 18,B01,083748,Rideout; David Porter,4,0,37,33
1657110852616,MATH 18,B02,083749,Rideout; David Porter,3,0,36,33
1657110852616,MATH 18,B03,083750,Rideout; David Porter,2,0,37,35
1657110852616,MATH 18,B04,083751,Rideout; David Porter,5,0,36,31
1657110852616,MATH 18,B05,093473,Rideout; David Porter,4,0,36,32
1657110852616,MATH 18,B06,093474,Rideout; David Porter,5,0,36,31
1657110858649,MATH 20A,A01,083754,Zheng; Zequn,12,0,40,28
1657110864681,MATH 20B,A01,083756,Briones; Jor-el Thomas Caparas,1,0,36,35
1657110864681,MATH 20B,A02,083757,Briones; Jor-el Thomas Caparas,1,0,36,35
1657110864681,MATH 20B,A03,093475,Briones; Jor-el Thomas Caparas,0,0,36,36
1657110870729,MATH 20C,A01,083760,Briones; Jor-el Thomas Caparas,1,0,35,34
1657110870729,MATH 20C,A02,083761,Briones; Jor-el Thomas Caparas,8,0,35,27
1657110870729,MATH 20C,A03,093476,Briones; Jor-el Thomas Caparas,0,1,36,36
1657110870729,MATH 20C,B01,083762,Bach; Quang Tran,0,0,30,30
1657110876758,MATH 20D,A01,083765,Tran; Brian Kha,4,0,30,26
1657110876758,MATH 20D,A02,083766,Tran; Brian Kha,5,0,30,25
1657110876758,MATH 20D,A03,083767,Tran; Brian Kha,3,0,30,27
1657110882783,MATH 20E,A01,083771,Ganguly; Soumya,6,0,32,26
1657110882783,MATH 20E,A02,083772,Ganguly; Soumya,6,0,32,26
1657110882783,MATH 20E,B01,083773,Ciotti; Benjamin,18,0,35,17
1657110882783,MATH 20E,B02,083774,Ciotti; Benjamin,17,0,35,18
1657110888818,MATH 103A,A01,083777,Greenfeld; Be'Eri,2,0,36,34
1657110888818,MATH 103A,A02,083778,Greenfeld; Be'Eri,5,0,36,31
1657110888818,MATH 103A,A03,093561,Greenfeld; Be'Eri,4,0,36,32
1657110888818,MATH 103A,B01,083779,Greenfeld; Be'Eri,6,0,36,30
1657110888818,MATH 103A,B02,083780,Greenfeld; Be'Eri,2,0,36,34
1657110888818,MATH 103A,B03,093562,Greenfeld; Be'Eri,3,0,36,33
1657110894924,MATH 105,A01,085443,Carter; Anne Toulson,14,0,35,21
1657110894924,MATH 105,A02,093477,Carter; Anne Toulson,20,0,35,15
1657110900949,MATH 109,A01,083213,Ganzberger; Geoffrey Michael,2,0,34,32
1657110900949,MATH 109,A02,083214,Ganzberger; Geoffrey Michael,3,0,34,31
1657110900949,MATH 109,A03,093478,Ganzberger; Geoffrey Michael,1,0,34,33
1657110900949,MATH 109,B01,083215,Ganzberger; Geoffrey Michael,1,0,32,31
1657110900949,MATH 109,B02,083216,Ganzberger; Geoffrey Michael,1,0,32,31
1657110900949,MATH 109,B03,093479,Ganzberger; Geoffrey Michael,6,0,32,26
1657110906982,MATH 142A,A01,083219,Chow; Bennett,6,0,32,26
1657110906982,MATH 142A,A02,083220,Chow; Bennett,10,0,32,22
1657110906982,MATH 142A,A03,093480,Chow; Bennett,7,0,32,25
1657110906982,MATH 142A,B03,093481,Chow; Bennett,8,0,32,24
1657110906982,MATH 142A,B04,093558,Chow; Bennett,11,0,32,21
1657110906982,MATH 142A,B05,093559,Chow; Bennett,6,0,32,26
1657110913015,MATH 193A,A01,083224,Rotar; Vladimir,7,0,34,27
1657110913015,MATH 193A,A02,083225,Rotar; Vladimir,5,0,34,29
1657110913015,MATH 193A,A03,083781,Rotar; Vladimir,1,0,34,33
1657110913015,MATH 193A,A04,083782,Rotar; Vladimir,6,0,34,28
1657110913015,MATH 193A,A05,093482,Rotar; Vladimir,6,0,34,28
1657110919045,MATH 197,001,091859,McAuley; Julian John,9999,0,9999,0
1657110919045,MATH 197,002,095566,Kedlaya; Kiran S.,9997,0,9999,2
1657110919045,MATH 197,003,095567,Xiao; Ming,9999,0,9999,0
1657110919045,MATH 197,004,095571,Perols; Johan Lars,9998,0,9999,1
1657110926132,COGS 9,A01,083615,Shannon; Kyle Michael,7,0,75,68
1657110932163,COGS 11,A01,083617,Boyle; Mary E. T.,21,0,48,27
1657110938192,COGS 13,A01,083071,Bastos; Amalia Pinkusfeld,9,0,71,62
1657110944218,COGS 14A,A01,092681,Semenuks; Arturs,1,1,100,99
1657110950247,COGS 14B,A01,083073,Cheng; Tzu-Han,6,0,63,57
1657110956275,COGS 17,A01,092677,Semenuks; Arturs,4,0,81,77
1657110962299,COGS 100,A01,083619,Allen; Michael Gordon,15,0,70,55
1657110968326,COGS 101A,A01,083621,Davis; Joshua Daniel,9,0,68,59
1657110974354,COGS 101B,A01,091572,Allen; Michael Gordon,8,0,65,57
1657110980385,COGS 101C,A01,083625,Delgado; Tania,17,0,35,18
1657110986410,COGS 107A,A01,083627,Boyle; Mary E. T.,13,0,60,47
1657110992436,COGS 118A,A01,083075,Gupta; Anjum,15,0,76,61
1657110998464,CSE 3,A50,083646,Miranda; Gregory Joseph,22,0,50,28
1657111004498,CSE 8A,A50,083650,Miranda; Gregory Joseph,17,1,56,39
1657111010523,CSE 11,A01,083080,Cao; Yingjun,4,15,40,36
1657111016550,CSE 12,A01,083652,Krause-Levy; Sophia Louisa,23,1,120,97
1657111022580,CSE 15L,A01,083654,Morris; Justin Loren,9,0,50,41
1657111022580,CSE 15L,A02,083655,Morris; Justin Loren,9,0,50,41
1657111028605,CSE 20,A01,083657,Tran; Khoa Dang,37,0,80,43
1657111034632,CSE 21,A01,095574,Bach; Quang Tran,21,0,48,27
1657111040659,CSE 30,A01,083084,Eldon; John,4,0,80,76
1657111040659,CSE 30,B01,095061,Bhaskar; Nishant,6,0,50,44
1657111046689,CSE 100,A01,083659,Cao; Yingjun,4,4,70,66
1657111052716,CSE 134B,A01,083661,Powell; Thomas Allan,19,0,100,81
1657111058752,CSE 140,A01,083663,Gungor; Onat,14,0,85,71
1657111064777,CSE 140L,A01,083088,Eldon; John,17,0,100,83
1657111070807,CSE 175,A01,083665,Kumar; Rakesh,3,0,25,22
1657111076837,CSE 190,A00,092507,Dubnov; Shlomo,7,0,20,13
1657111082864,ECE 45,A01,083139,Congero; Spencer William,5,0,75,70
1657111088889,ECE 65,A50,083695,Saad; Andrew S,12,0,30,18
1657111088889,ECE 65,A51,095125,Saad; Andrew S,25,0,26,1
1657111094920,ECE 109,A01,091882,Touri; Behrouz,16,0,70,54
1657111100946,ECE 180,A00,083140,Abi Samra; Nicholas Camill,1,0,30,29
1657111100946,ECE 180,B00,083141,Abi Samra; Nicholas Camill,0,0,30,30
1657111106973,MATH 10A,A01,083735,Patchell; Gregory David,1,0,30,29
1657111106973,MATH 10A,A02,083736,Patchell; Gregory David,20,0,30,10
1657111106973,MATH 10A,A03,083737,Patchell; Gregory David,16,0,30,14
1657111113000,MATH 10B,A01,083207,Lim; Seonhee,7,0,34,27
1657111113000,MATH 10B,A02,083208,Lim; Seonhee,9,0,35,26
1657111113000,MATH 10B,A03,093472,Lim; Seonhee,5,0,34,29
1657111113000,MATH 10B,B01,083739,Sinha; Shubham,9,0,30,21
1657111119029,MATH 18,A01,083743,Cinel; Cameron Alexander,6,0,30,24
1657111119029,MATH 18,A02,083744,Cinel; Cameron Alexander,15,0,30,15
1657111119029,MATH 18,A03,083745,Cinel; Cameron Alexander,8,0,30,22
1657111119029,MATH 18,B01,083748,Rideout; David Porter,4,0,37,33
1657111119029,MATH 18,B02,083749,Rideout; David Porter,3,0,36,33
1657111119029,MATH 18,B03,083750,Rideout; David Porter,2,0,37,35
1657111119029,MATH 18,B04,083751,Rideout; David Porter,5,0,36,31
1657111119029,MATH 18,B05,093473,Rideout; David Porter,4,0,36,32
1657111119029,MATH 18,B06,093474,Rideout; David Porter,5,0,36,31
1657111125061,MATH 20A,A01,083754,Zheng; Zequn,12,0,40,28
1657111131091,MATH 20B,A01,083756,Briones; Jor-el Thomas Caparas,1,0,36,35
1657111131091,MATH 20B,A02,083757,Briones; Jor-el Thomas Caparas,1,0,36,35
1657111131091,MATH 20B,A03,093475,Briones; Jor-el Thomas Caparas,0,0,36,36
1657111137116,MATH 20C,A01,083760,Briones; Jor-el Thomas Caparas,1,0,35,34
1657111137116,MATH 20C,A02,083761,Briones; Jor-el Thomas Caparas,8,0,35,27
1657111137116,MATH 20C,A03,093476,Briones; Jor-el Thomas Caparas,0,1,36,36
1657111137116,MATH 20C,B01,083762,Bach; Quang Tran,0,0,30,30
1657111143140,MATH 20D,A01,083765,Tran; Brian Kha,4,0,30,26
1657111143140,MATH 20D,A02,083766,Tran; Brian Kha,5,0,30,25
1657111143140,MATH 20D,A03,083767,Tran; Brian Kha,3,0,30,27
1657111149166,MATH 20E,A01,083771,Ganguly; Soumya,6,0,32,26
1657111149166,MATH 20E,A02,083772,Ganguly; Soumya,6,0,32,26
1657111149166,MATH 20E,B01,083773,Ciotti; Benjamin,18,0,35,17
1657111149166,MATH 20E,B02,083774,Ciotti; Benjamin,17,0,35,18
1657111155195,MATH 103A,A01,083777,Greenfeld; Be'Eri,2,0,36,34
1657111155195,MATH 103A,A02,083778,Greenfeld; Be'Eri,5,0,36,31
1657111155195,MATH 103A,A03,093561,Greenfeld; Be'Eri,4,0,36,32
1657111155195,MATH 103A,B01,083779,Greenfeld; Be'Eri,6,0,36,30
1657111155195,MATH 103A,B02,083780,Greenfeld; Be'Eri,2,0,36,34
1657111155195,MATH 103A,B03,093562,Greenfeld; Be'Eri,3,0,36,33
1657111161221,MATH 105,A01,085443,Carter; Anne Toulson,14,0,35,21
1657111161221,MATH 105,A02,093477,Carter; Anne Toulson,20,0,35,15
1657111167248,MATH 109,A01,083213,Ganzberger; Geoffrey Michael,2,0,34,32
1657111167248,MATH 109,A02,083214,Ganzberger; Geoffrey Michael,3,0,34,31
1657111167248,MATH 109,A03,093478,Ganzberger; Geoffrey Michael,1,0,34,33
1657111167248,MATH 109,B01,083215,Ganzberger; Geoffrey Michael,1,0,32,31
1657111167248,MATH 109,B02,083216,Ganzberger; Geoffrey Michael,1,0,32,31
1657111167248,MATH 109,B03,093479,Ganzberger; Geoffrey Michael,6,0,32,26
1657111173281,MATH 142A,A01,083219,Chow; Bennett,6,0,32,26
1657111173281,MATH 142A,A02,083220,Chow; Bennett,10,0,32,22
1657111173281,MATH 142A,A03,093480,Chow; Bennett,7,0,32,25
1657111173281,MATH 142A,B03,093481,Chow; Bennett,8,0,32,24
1657111173281,MATH 142A,B04,093558,Chow; Bennett,11,0,32,21
1657111173281,MATH 142A,B05,093559,Chow; Bennett,6,0,32,26
1657111179304,MATH 193A,A01,083224,Rotar; Vladimir,7,0,34,27
1657111179304,MATH 193A,A02,083225,Rotar; Vladimir,5,0,34,29
1657111179304,MATH 193A,A03,083781,Rotar; Vladimir,1,0,34,33
1657111179304,MATH 193A,A04,083782,Rotar; Vladimir,6,0,34,28
1657111179304,MATH 193A,A05,093482,Rotar; Vladimir,6,0,34,28
1657111185335,MATH 197,001,091859,McAuley; Julian John,9999,0,9999,0
1657111185335,MATH 197,002,095566,Kedlaya; Kiran S.,9997,0,9999,2
1657111185335,MATH 197,003,095567,Xiao; Ming,9999,0,9999,0
1657111185335,MATH 197,004,095571,Perols; Johan Lars,9998,0,9999,1
1657111192396,COGS 9,A01,083615,Shannon; Kyle Michael,7,0,75,68
1657111198420,COGS 11,A01,083617,Boyle; Mary E. T.,21,0,48,27
1657111204451,COGS 13,A01,083071,Bastos; Amalia Pinkusfeld,9,0,71,62
1657111210476,COGS 14A,A01,092681,Semenuks; Arturs,1,1,100,99
1657111216507,COGS 14B,A01,083073,Cheng; Tzu-Han,6,0,63,57
1657111222535,COGS 17,A01,092677,Semenuks; Arturs,4,0,81,77
1657111228559,COGS 100,A01,083619,Allen; Michael Gordon,15,0,70,55
1657111234596,COGS 101A,A01,083621,Davis; Joshua Daniel,9,0,68,59
1657111240620,COGS 101B,A01,091572,Allen; Michael Gordon,8,0,65,57
1657111246649,COGS 101C,A01,083625,Delgado; Tania,17,0,35,18
1657111252681,COGS 107A,A01,083627,Boyle; Mary E. T.,13,0,60,47
1657111258711,COGS 118A,A01,083075,Gupta; Anjum,15,0,76,61
1657111264738,CSE 3,A50,083646,Miranda; Gregory Joseph,22,0,50,28
1657111270763,CSE 8A,A50,083650,Miranda; Gregory Joseph,17,1,56,39
1657111276788,CSE 11,A01,083080,Cao; Yingjun,4,15,40,36
1657111282811,CSE 12,A01,083652,Krause-Levy; Sophia Louisa,23,1,120,97
1657111288835,CSE 15L,A01,083654,Morris; Justin Loren,9,0,50,41
1657111288835,CSE 15L,A02,083655,Morris; Justin Loren,9,0,50,41
1657111294866,CSE 20,A01,083657,Tran; Khoa Dang,37,0,80,43
1657111300891,CSE 21,A01,095574,Bach; Quang Tran,21,0,48,27
1657111306917,CSE 30,A01,083084,Eldon; John,4,0,80,76
1657111306917,CSE 30,B01,095061,Bhaskar; Nishant,6,0,50,44
1657111312946,CSE 100,A01,083659,Cao; Yingjun,4,4,70,66
1657111318972,CSE 134B,A01,083661,Powell; Thomas Allan,19,0,100,81
1657111325001,CSE 140,A01,083663,Gungor; Onat,14,0,85,71
1657111331030,CSE 140L,A01,083088,Eldon; John,17,0,100,83
1657111337060,CSE 175,A01,083665,Kumar; Rakesh,3,0,25,22
1657111343090,CSE 190,A00,092507,Dubnov; Shlomo,7,0,20,13
1657111349118,ECE 45,A01,083139,Congero; Spencer William,5,0,75,70
1657111355150,ECE 65,A50,083695,Saad; Andrew S,12,0,30,18
1657111355150,ECE 65,A51,095125,Saad; Andrew S,25,0,26,1
1657111361173,ECE 109,A01,091882,Touri; Behrouz,16,0,70,54
1657111367198,ECE 180,A00,083140,Abi Samra; Nicholas Camill,1,0,30,29
1657111367198,ECE 180,B00,083141,Abi Samra; Nicholas Camill,0,0,30,30
1657111373222,MATH 10A,A01,083735,Patchell; Gregory David,1,0,30,29
1657111373222,MATH 10A,A02,083736,Patchell; Gregory David,20,0,30,10
1657111373222,MATH 10A,A03,083737,Patchell; Gregory David,16,0,30,14
1657111379250,MATH 10B,A01,083207,Lim; Seonhee,7,0,34,27
1657111379250,MATH 10B,A02,083208,Lim; Seonhee,9,0,35,26
1657111379250,MATH 10B,A03,093472,Lim; Seonhee,5,0,34,29
1657111379250,MATH 10B,B01,083739,Sinha; Shubham,9,0,30,21
1657111385288,MATH 18,A01,083743,Cinel; Cameron Alexander,6,0,30,24
1657111385288,MATH 18,A02,083744,Cinel; Cameron Alexander,15,0,30,15
1657111385288,MATH 18,A03,083745,Cinel; Cameron Alexander,8,0,30,22
1657111385288,MATH 18,B01,083748,Rideout; David Porter,4,0,37,33
1657111385288,MATH 18,B02,083749,Rideout; David Porter,3,0,36,33
1657111385288,MATH 18,B03,083750,Rideout; David Porter,2,0,37,35
1657111385288,MATH 18,B04,083751,Rideout; David Porter,5,0,36,31
1657111385288,MATH 18,B05,093473,Rideout; David Porter,4,0,36,32
1657111385288,MATH 18,B06,093474,Rideout; David Porter,5,0,36,31
1657111391315,MATH 20A,A01,083754,Zheng; Zequn,12,0,40,28
1657111397346,MATH 20B,A01,083756,Briones; Jor-el Thomas Caparas,1,0,36,35
1657111397346,MATH 20B,A02,083757,Briones; Jor-el Thomas Caparas,1,0,36,35
1657111397346,MATH 20B,A03,093475,Briones; Jor-el Thomas Caparas,0,0,36,36
1657111403374,MATH 20C,A01,083760,Briones; Jor-el Thomas Caparas,1,0,35,34
1657111403374,MATH 20C,A02,083761,Briones; Jor-el Thomas Caparas,8,0,35,27
1657111403374,MATH 20C,A03,093476,Briones; Jor-el Thomas Caparas,0,1,36,36
1657111403374,MATH 20C,B01,083762,Bach; Quang Tran,0,0,30,30
1657111409401,MATH 20D,A01,083765,Tran; Brian Kha,4,0,30,26
1657111409401,MATH 20D,A02,083766,Tran; Brian Kha,5,0,30,25
1657111409401,MATH 20D,A03,083767,Tran; Brian Kha,3,0,30,27
1657111415437,MATH 20E,A01,083771,Ganguly; Soumya,6,0,32,26
1657111415437,MATH 20E,A02,083772,Ganguly; Soumya,6,0,32,26
1657111415437,MATH 20E,B01,083773,Ciotti; Benjamin,18,0,35,17
1657111415437,MATH 20E,B02,083774,Ciotti; Benjamin,17,0,35,18
1657111421473,MATH 103A,A01,083777,Greenfeld; Be'Eri,2,0,36,34
1657111421473,MATH 103A,A02,083778,Greenfeld; Be'Eri,5,0,36,31
1657111421473,MATH 103A,A03,093561,Greenfeld; Be'Eri,4,0,36,32
1657111421473,MATH 103A,B01,083779,Greenfeld; Be'Eri,6,0,36,30
1657111421473,MATH 103A,B02,083780,Greenfeld; Be'Eri,2,0,36,34
1657111421473,MATH 103A,B03,093562,Greenfeld; Be'Eri,3,0,36,33
1657111427518,MATH 105,A01,085443,Carter; Anne Toulson,14,0,35,21
1657111427518,MATH 105,A02,093477,Carter; Anne Toulson,20,0,35,15
1657111433546,MATH 109,A01,083213,Ganzberger; Geoffrey Michael,2,0,34,32
1657111433546,MATH 109,A02,083214,Ganzberger; Geoffrey Michael,3,0,34,31
1657111433546,MATH 109,A03,093478,Ganzberger; Geoffrey Michael,1,0,34,33
1657111433546,MATH 109,B01,083215,Ganzberger; Geoffrey Michael,1,0,32,31
1657111433546,MATH 109,B02,083216,Ganzberger; Geoffrey Michael,1,0,32,31
1657111433546,MATH 109,B03,093479,Ganzberger; Geoffrey Michael,6,0,32,26
1657111439571,MATH 142A,A01,083219,Chow; Bennett,6,0,32,26
1657111439571,MATH 142A,A02,083220,Chow; Bennett,10,0,32,22
1657111439571,MATH 142A,A03,093480,Chow; Bennett,7,0,32,25
1657111439571,MATH 142A,B03,093481,Chow; Bennett,8,0,32,24
1657111439571,MATH 142A,B04,093558,Chow; Bennett,11,0,32,21
1657111439571,MATH 142A,B05,093559,Chow; Bennett,6,0,32,26
1657111445605,MATH 193A,A01,083224,Rotar; Vladimir,7,0,34,27
1657111445605,MATH 193A,A02,083225,Rotar; Vladimir,5,0,34,29
1657111445605,MATH 193A,A03,083781,Rotar; Vladimir,1,0,34,33
1657111445605,MATH 193A,A04,083782,Rotar; Vladimir,6,0,34,28
1657111445605,MATH 193A,A05,093482,Rotar; Vladimir,6,0,34,28
1657111451630,MATH 197,001,091859,McAuley; Julian John,9999,0,9999,0
1657111451630,MATH 197,002,095566,Kedlaya; Kiran S.,9997,0,9999,2
1657111451630,MATH 197,003,095567,Xiao; Ming,9999,0,9999,0
1657111451630,MATH 197,004,095571,Perols; Johan Lars,9998,0,9999,1
1657111458696,COGS 9,A01,083615,Shannon; Kyle Michael,7,0,75,68
1657111464730,COGS 11,A01,083617,Boyle; Mary E. T.,21,0,48,27
1657111470755,COGS 13,A01,083071,Bastos; Amalia Pinkusfeld,9,0,71,62
1657111476780,COGS 14A,A01,092681,Semenuks; Arturs,1,1,100,99
1657111482804,COGS 14B,A01,083073,Cheng; Tzu-Han,6,0,63,57
1657111488905,COGS 17,A01,092677,Semenuks; Arturs,4,0,81,77
1657111494934,COGS 100,A01,083619,Allen; Michael Gordon,15,0,70,55
1657111500963,COGS 101A,A01,083621,Davis; Joshua Daniel,9,0,68,59
1657111506989,COGS 101B,A01,091572,Allen; Michael Gordon,8,0,65,57
1657111513012,COGS 101C,A01,083625,Delgado; Tania,17,0,35,18
1657111519038,COGS 107A,A01,083627,Boyle; Mary E. T.,13,0,60,47
1657111525066,COGS 118A,A01,083075,Gupta; Anjum,15,0,76,61
1657111531091,CSE 3,A50,083646,Miranda; Gregory Joseph,22,0,50,28
1657111537114,CSE 8A,A50,083650,Miranda; Gregory Joseph,17,1,56,39
1657111543139,CSE 11,A01,083080,Cao; Yingjun,4,15,40,36
1657111549169,CSE 12,A01,083652,Krause-Levy; Sophia Louisa,23,1,120,97
1657111555201,CSE 15L,A01,083654,Morris; Justin Loren,9,0,50,41
1657111555201,CSE 15L,A02,083655,Morris; Justin Loren,9,0,50,41
1657111561224,CSE 20,A01,083657,Tran; Khoa Dang,37,0,80,43
1657111567256,CSE 21,A01,095574,Bach; Quang Tran,21,0,48,27
1657111573279,CSE 30,A01,083084,Eldon; John,4,0,80,76
1657111573279,CSE 30,B01,095061,Bhaskar; Nishant,6,0,50,44
1657111579306,CSE 100,A01,083659,Cao; Yingjun,4,4,70,66
1657111585330,CSE 134B,A01,083661,Powell; Thomas Allan,19,0,100,81
1657111591360,CSE 140,A01,083663,Gungor; Onat,14,0,85,71
1657111597382,CSE 140L,A01,083088,Eldon; John,17,0,100,83
1657111603405,CSE 175,A01,083665,Kumar; Rakesh,3,0,25,22
1657111609436,CSE 190,A00,092507,Dubnov; Shlomo,7,0,20,13
1657111615464,ECE 45,A01,083139,Congero; Spencer William,5,0,75,70
1657111621495,ECE 65,A50,083695,Saad; Andrew S,12,0,30,18
1657111621495,ECE 65,A51,095125,Saad; Andrew S,25,0,26,1
1657111627521,ECE 109,A01,091882,Touri; Behrouz,16,0,70,54
1657111633546,ECE 180,A00,083140,Abi Samra; Nicholas Camill,1,0,30,29
1657111633546,ECE 180,B00,083141,Abi Samra; Nicholas Camill,0,0,30,30
1657111639578,MATH 10A,A01,083735,Patchell; Gregory David,1,0,30,29
1657111639578,MATH 10A,A02,083736,Patchell; Gregory David,20,0,30,10
1657111639578,MATH 10A,A03,083737,Patchell; Gregory David,16,0,30,14
1657111645606,MATH 10B,A01,083207,Lim; Seonhee,7,0,34,27
1657111645606,MATH 10B,A02,083208,Lim; Seonhee,9,0,35,26
1657111645606,MATH 10B,A03,093472,Lim; Seonhee,5,0,34,29
1657111645606,MATH 10B,B01,083739,Sinha; Shubham,9,0,30,21
1657111651644,MATH 18,A01,083743,Cinel; Cameron Alexander,6,0,30,24
1657111651644,MATH 18,A02,083744,Cinel; Cameron Alexander,15,0,30,15
1657111651644,MATH 18,A03,083745,Cinel; Cameron Alexander,8,0,30,22
1657111651644,MATH 18,B01,083748,Rideout; David Porter,4,0,37,33
1657111651644,MATH 18,B02,083749,Rideout; David Porter,3,0,36,33
1657111651644,MATH 18,B03,083750,Rideout; David Porter,2,0,37,35
1657111651644,MATH 18,B04,083751,Rideout; David Porter,5,0,36,31
1657111651644,MATH 18,B05,093473,Rideout; David Porter,4,0,36,32
1657111651644,MATH 18,B06,093474,Rideout; David Porter,5,0,36,31
1657111657689,MATH 20A,A01,083754,Zheng; Zequn,12,0,40,28
1657111663720,MATH 20B,A01,083756,Briones; Jor-el Thomas Caparas,1,0,36,35
1657111663720,MATH 20B,A02,083757,Briones; Jor-el Thomas Caparas,1,0,36,35
1657111663720,MATH 20B,A03,093475,Briones; Jor-el Thomas Caparas,0,0,36,36
1657111669745,MATH 20C,A01,083760,Briones; Jor-el Thomas Caparas,1,0,35,34
1657111669745,MATH 20C,A02,083761,Briones; Jor-el Thomas Caparas,8,0,35,27
1657111669745,MATH 20C,A03,093476,Briones; Jor-el Thomas Caparas,0,1,36,36
1657111669745,MATH 20C,B01,083762,Bach; Quang Tran,0,0,30,30
1657111675769,MATH 20D,A01,083765,Tran; Brian Kha,4,0,30,26
1657111675769,MATH 20D,A02,083766,Tran; Brian Kha,5,0,30,25
1657111675769,MATH 20D,A03,083767,Tran; Brian Kha,3,0,30,27
1657111681794,MATH 20E,A01,083771,Ganguly; Soumya,6,0,32,26
1657111681794,MATH 20E,A02,083772,Ganguly; Soumya,6,0,32,26
1657111681794,MATH 20E,B01,083773,Ciotti; Benjamin,18,0,35,17
1657111681794,MATH 20E,B02,083774,Ciotti; Benjamin,17,0,35,18
1657111687820,MATH 103A,A01,083777,Greenfeld; Be'Eri,2,0,36,34
1657111687820,MATH 103A,A02,083778,Greenfeld; Be'Eri,5,0,36,31
1657111687820,MATH 103A,A03,093561,Greenfeld; Be'Eri,4,0,36,32
1657111687820,MATH 103A,B01,083779,Greenfeld; Be'Eri,6,0,36,30
1657111687820,MATH 103A,B02,083780,Greenfeld; Be'Eri,2,0,36,34
1657111687820,MATH 103A,B03,093562,Greenfeld; Be'Eri,3,0,36,33
1657111693845,MATH 105,A01,085443,Carter; Anne Toulson,14,0,35,21
1657111693845,MATH 105,A02,093477,Carter; Anne Toulson,20,0,35,15
1657111699877,MATH 109,A01,083213,Ganzberger; Geoffrey Michael,2,0,34,32
1657111699877,MATH 109,A02,083214,Ganzberger; Geoffrey Michael,3,0,34,31
1657111699877,MATH 109,A03,093478,Ganzberger; Geoffrey Michael,1,0,34,33
1657111699877,MATH 109,B01,083215,Ganzberger; Geoffrey Michael,1,0,32,31
1657111699877,MATH 109,B02,083216,Ganzberger; Geoffrey Michael,1,0,32,31
1657111699877,MATH 109,B03,093479,Ganzberger; Geoffrey Michael,6,0,32,26
1657111705904,MATH 142A,A01,083219,Chow; Bennett,6,0,32,26
1657111705904,MATH 142A,A02,083220,Chow; Bennett,10,0,32,22
1657111705904,MATH 142A,A03,093480,Chow; Bennett,7,0,32,25
1657111705904,MATH 142A,B03,093481,Chow; Bennett,8,0,32,24
1657111705904,MATH 142A,B04,093558,Chow; Bennett,11,0,32,21
1657111705904,MATH 142A,B05,093559,Chow; Bennett,6,0,32,26
1657111711929,MATH 193A,A01,083224,Rotar; Vladimir,7,0,34,27
1657111711929,MATH 193A,A02,083225,Rotar; Vladimir,5,0,34,29
1657111711929,MATH 193A,A03,083781,Rotar; Vladimir,1,0,34,33
1657111711929,MATH 193A,A04,083782,Rotar; Vladimir,6,0,34,28
1657111711929,MATH 193A,A05,093482,Rotar; Vladimir,6,0,34,28
1657111717954,MATH 197,001,091859,McAuley; Julian John,9999,0,9999,0
1657111717954,MATH 197,002,095566,Kedlaya; Kiran S.,9997,0,9999,2
1657111717954,MATH 197,003,095567,Xiao; Ming,9999,0,9999,0
1657111717954,MATH 197,004,095571,Perols; Johan Lars,9998,0,9999,1
1657111725049,COGS 9,A01,083615,Shannon; Kyle Michael,7,0,75,68
1657111731075,COGS 11,A01,083617,Boyle; Mary E. T.,21,0,48,27
1657111737100,COGS 13,A01,083071,Bastos; Amalia Pinkusfeld,9,0,71,62
1657111743133,COGS 14A,A01,092681,Semenuks; Arturs,1,1,100,99
1657111749162,COGS 14B,A01,083073,Cheng; Tzu-Han,6,0,63,57
1657111755192,COGS 17,A01,092677,Semenuks; Arturs,4,0,81,77
1657111761223,COGS 100,A01,083619,Allen; Michael Gordon,15,0,70,55
1657111767247,COGS 101A,A01,083621,Davis; Joshua Daniel,9,0,68,59
1657111773274,COGS 101B,A01,091572,Allen; Michael Gordon,8,0,65,57
1657111779300,COGS 101C,A01,083625,Delgado; Tania,17,0,35,18
1657111785326,COGS 107A,A01,083627,Boyle; Mary E. T.,13,0,60,47
1657111791354,COGS 118A,A01,083075,Gupta; Anjum,15,0,76,61
1657111797383,CSE 3,A50,083646,Miranda; Gregory Joseph,22,0,50,28
1657111803411,CSE 8A,A50,083650,Miranda; Gregory Joseph,17,1,56,39
1657111809444,CSE 11,A01,083080,Cao; Yingjun,4,15,40,36
1657111815478,CSE 12,A01,083652,Krause-Levy; Sophia Louisa,23,1,120,97
1657111821504,CSE 15L,A01,083654,Morris; Justin Loren,9,0,50,41
1657111821504,CSE 15L,A02,083655,Morris; Justin Loren,9,0,50,41
1657111827539,CSE 20,A01,083657,Tran; Khoa Dang,37,0,80,43
1657111833573,CSE 21,A01,095574,Bach; Quang Tran,21,0,48,27
1657111839604,CSE 30,A01,083084,Eldon; John,4,0,80,76
1657111839604,CSE 30,B01,095061,Bhaskar; Nishant,6,0,50,44
1657111845637,CSE 100,A01,083659,Cao; Yingjun,4,4,70,66
1657111851662,CSE 134B,A01,083661,Powell; Thomas Allan,19,0,100,81
1657111857695,CSE 140,A01,083663,Gungor; Onat,14,0,85,71
1657111863721,CSE 140L,A01,083088,Eldon; John,17,0,100,83
1657111869748,CSE 175,A01,083665,Kumar; Rakesh,3,0,25,22
1657111875772,CSE 190,A00,092507,Dubnov; Shlomo,7,0,20,13
1657111881802,ECE 45,A01,083139,Congero; Spencer William,5,0,75,70
1657111887838,ECE 65,A50,083695,Saad; Andrew S,12,0,30,18
1657111887838,ECE 65,A51,095125,Saad; Andrew S,25,0,26,1
1657111893867,ECE 109,A01,091882,Touri; Behrouz,16,0,70,54
1657111899890,ECE 180,A00,083140,Abi Samra; Nicholas Camill,1,0,30,29
1657111899890,ECE 180,B00,083141,Abi Samra; Nicholas Camill,0,0,30,30
1657111905925,MATH 10A,A01,083735,Patchell; Gregory David,1,0,30,29
1657111905925,MATH 10A,A02,083736,Patchell; Gregory David,20,0,30,10
1657111905925,MATH 10A,A03,083737,Patchell; Gregory David,16,0,30,14
1657111911957,MATH 10B,A01,083207,Lim; Seonhee,7,0,34,27
1657111911957,MATH 10B,A02,083208,Lim; Seonhee,9,0,35,26
1657111911957,MATH 10B,A03,093472,Lim; Seonhee,5,0,34,29
1657111911957,MATH 10B,B01,083739,Sinha; Shubham,9,0,30,21
1657111917999,MATH 18,A01,083743,Cinel; Cameron Alexander,6,0,30,24
1657111917999,MATH 18,A02,083744,Cinel; Cameron Alexander,15,0,30,15
1657111917999,MATH 18,A03,083745,Cinel; Cameron Alexander,8,0,30,22
1657111917999,MATH 18,B01,083748,Rideout; David Porter,4,0,37,33
1657111917999,MATH 18,B02,083749,Rideout; David Porter,3,0,36,33
1657111917999,MATH 18,B03,083750,Rideout; David Porter,2,0,37,35
1657111917999,MATH 18,B04,083751,Rideout; David Porter,5,0,36,31
1657111917999,MATH 18,B05,093473,Rideout; David Porter,4,0,36,32
1657111917999,MATH 18,B06,093474,Rideout; David Porter,5,0,36,31
1657111924054,MATH 20A,A01,083754,Zheng; Zequn,12,0,40,28
1657111930100,MATH 20B,A01,083756,Briones; Jor-el Thomas Caparas,1,0,36,35
1657111930100,MATH 20B,A02,083757,Briones; Jor-el Thomas Caparas,1,0,36,35
1657111930100,MATH 20B,A03,093475,Briones; Jor-el Thomas Caparas,0,0,36,36
1657111936127,MATH 20C,A01,083760,Briones; Jor-el Thomas Caparas,1,0,35,34
1657111936127,MATH 20C,A02,083761,Briones; Jor-el Thomas Caparas,8,0,35,27
1657111936127,MATH 20C,A03,093476,Briones; Jor-el Thomas Caparas,0,1,36,36
1657111936127,MATH 20C,B01,083762,Bach; Quang Tran,0,0,30,30
1657111942155,MATH 20D,A01,083765,Tran; Brian Kha,4,0,30,26
1657111942155,MATH 20D,A02,083766,Tran; Brian Kha,5,0,30,25
1657111942155,MATH 20D,A03,083767,Tran; Brian Kha,3,0,30,27
1657111948191,MATH 20E,A01,083771,Ganguly; Soumya,6,0,32,26
1657111948191,MATH 20E,A02,083772,Ganguly; Soumya,6,0,32,26
1657111948191,MATH 20E,B01,083773,Ciotti; Benjamin,18,0,35,17
1657111948191,MATH 20E,B02,083774,Ciotti; Benjamin,17,0,35,18
1657111954219,MATH 103A,A01,083777,Greenfeld; Be'Eri,2,0,36,34
1657111954219,MATH 103A,A02,083778,Greenfeld; Be'Eri,5,0,36,31
1657111954219,MATH 103A,A03,093561,Greenfeld; Be'Eri,4,0,36,32
1657111954219,MATH 103A,B01,083779,Greenfeld; Be'Eri,6,0,36,30
1657111954219,MATH 103A,B02,083780,Greenfeld; Be'Eri,2,0,36,34
1657111954219,MATH 103A,B03,093562,Greenfeld; Be'Eri,3,0,36,33
1657111960244,MATH 105,A01,085443,Carter; Anne Toulson,14,0,35,21
1657111960244,MATH 105,A02,093477,Carter; Anne Toulson,20,0,35,15
1657111966279,MATH 109,A01,083213,Ganzberger; Geoffrey Michael,2,0,34,32
1657111966279,MATH 109,A02,083214,Ganzberger; Geoffrey Michael,3,0,34,31
1657111966279,MATH 109,A03,093478,Ganzberger; Geoffrey Michael,1,0,34,33
1657111966279,MATH 109,B01,083215,Ganzberger; Geoffrey Michael,1,0,32,31
1657111966279,MATH 109,B02,083216,Ganzberger; Geoffrey Michael,1,0,32,31
1657111966279,MATH 109,B03,093479,Ganzberger; Geoffrey Michael,6,0,32,26
1657111972306,MATH 142A,A01,083219,Chow; Bennett,6,0,32,26
1657111972306,MATH 142A,A02,083220,Chow; Bennett,10,0,32,22
1657111972306,MATH 142A,A03,093480,Chow; Bennett,7,0,32,25
1657111972306,MATH 142A,B03,093481,Chow; Bennett,8,0,32,24
1657111972306,MATH 142A,B04,093558,Chow; Bennett,11,0,32,21
1657111972306,MATH 142A,B05,093559,Chow; Bennett,6,0,32,26
1657111978331,MATH 193A,A01,083224,Rotar; Vladimir,7,0,34,27
1657111978331,MATH 193A,A02,083225,Rotar; Vladimir,5,0,34,29
1657111978331,MATH 193A,A03,083781,Rotar; Vladimir,1,0,34,33
1657111978331,MATH 193A,A04,083782,Rotar; Vladimir,6,0,34,28
1657111978331,MATH 193A,A05,093482,Rotar; Vladimir,6,0,34,28
1657111984367,MATH 197,001,091859,McAuley; Julian John,9999,0,9999,0
1657111984367,MATH 197,002,095566,Kedlaya; Kiran S.,9997,0,9999,2
1657111984367,MATH 197,003,095567,Xiao; Ming,9999,0,9999,0
1657111984367,MATH 197,004,095571,Perols; Johan Lars,9998,0,9999,1
1657111991446,COGS 9,A01,083615,Shannon; Kyle Michael,7,0,75,68
1657111997471,COGS 11,A01,083617,Boyle; Mary E. T.,21,0,48,27
1657112003496,COGS 13,A01,083071,Bastos; Amalia Pinkusfeld,9,0,71,62
1657112009523,COGS 14A,A01,092681,Semenuks; Arturs,1,1,100,99
1657112015549,COGS 14B,A01,083073,Cheng; Tzu-Han,6,0,63,57
1657112021577,COGS 17,A01,092677,Semenuks; Arturs,4,0,81,77
1657112027607,COGS 100,A01,083619,Allen; Michael Gordon,15,0,70,55
1657112033640,COGS 101A,A01,083621,Davis; Joshua Daniel,9,0,68,59
1657112039667,COGS 101B,A01,091572,Allen; Michael Gordon,8,0,65,57
1657112045700,COGS 101C,A01,083625,Delgado; Tania,17,0,35,18
1657112051729,COGS 107A,A01,083627,Boyle; Mary E. T.,13,0,60,47
1657112057755,COGS 118A,A01,083075,Gupta; Anjum,15,0,76,61
1657112063785,CSE 3,A50,083646,Miranda; Gregory Joseph,22,0,50,28
1657112069816,CSE 8A,A50,083650,Miranda; Gregory Joseph,17,1,56,39
1657112075842,CSE 11,A01,083080,Cao; Yingjun,4,15,40,36
1657112081869,CSE 12,A01,083652,Krause-Levy; Sophia Louisa,23,1,120,97
1657112087969,CSE 15L,A01,083654,Morris; Justin Loren,9,0,50,41
1657112087969,CSE 15L,A02,083655,Morris; Justin Loren,9,0,50,41
1657112094001,CSE 20,A01,083657,Tran; Khoa Dang,37,0,80,43
1657112100034,CSE 21,A01,095574,Bach; Quang Tran,21,0,48,27
1657112106075,CSE 30,A01,083084,Eldon; John,4,0,80,76
1657112106075,CSE 30,B01,095061,Bhaskar; Nishant,6,0,50,44
1657112112104,CSE 100,A01,083659,Cao; Yingjun,4,4,70,66
1657112118135,CSE 134B,A01,083661,Powell; Thomas Allan,19,0,100,81
1657112124160,CSE 140,A01,083663,Gungor; Onat,14,0,85,71
1657112130190,CSE 140L,A01,083088,Eldon; John,17,0,100,83
1657112136217,CSE 175,A01,083665,Kumar; Rakesh,3,0,25,22
1657112142245,CSE 190,A00,092507,Dubnov; Shlomo,7,0,20,13
1657112148275,ECE 45,A01,083139,Congero; Spencer William,5,0,75,70
1657112154305,ECE 65,A50,083695,Saad; Andrew S,12,0,30,18
1657112154305,ECE 65,A51,095125,Saad; Andrew S,25,0,26,1
1657112160339,ECE 109,A01,091882,Touri; Behrouz,16,0,70,54
1657112166363,ECE 180,A00,083140,Abi Samra; Nicholas Camill,1,0,30,29
1657112166363,ECE 180,B00,083141,Abi Samra; Nicholas Camill,0,0,30,30
1657112172390,MATH 10A,A01,083735,Patchell; Gregory David,1,0,30,29
1657112172390,MATH 10A,A02,083736,Patchell; Gregory David,20,0,30,10
1657112172390,MATH 10A,A03,083737,Patchell; Gregory David,16,0,30,14
1657112178419,MATH 10B,A01,083207,Lim; Seonhee,7,0,34,27
1657112178419,MATH 10B,A02,083208,Lim; Seonhee,9,0,35,26
1657112178419,MATH 10B,A03,093472,Lim; Seonhee,5,0,34,29
1657112178419,MATH 10B,B01,083739,Sinha; Shubham,9,0,30,21
1657112184460,MATH 18,A01,083743,Cinel; Cameron Alexander,6,0,30,24
1657112184460,MATH 18,A02,083744,Cinel; Cameron Alexander,15,0,30,15
1657112184460,MATH 18,A03,083745,Cinel; Cameron Alexander,8,0,30,22
1657112184460,MATH 18,B01,083748,Rideout; David Porter,4,0,37,33
1657112184460,MATH 18,B02,083749,Rideout; David Porter,3,0,36,33
1657112184460,MATH 18,B03,083750,Rideout; David Porter,2,0,37,35
1657112184460,MATH 18,B04,083751,Rideout; David Porter,5,0,36,31
1657112184460,MATH 18,B05,093473,Rideout; David Porter,4,0,36,32
1657112184460,MATH 18,B06,093474,Rideout; David Porter,5,0,36,31
1657112190487,MATH 20A,A01,083754,Zheng; Zequn,12,0,40,28
1657112196519,MATH 20B,A01,083756,Briones; Jor-el Thomas Caparas,1,0,36,35
1657112196519,MATH 20B,A02,083757,Briones; Jor-el Thomas Caparas,1,0,36,35
1657112196519,MATH 20B,A03,093475,Briones; Jor-el Thomas Caparas,0,0,36,36
1657112202552,MATH 20C,A01,083760,Briones; Jor-el Thomas Caparas,1,0,35,34
1657112202552,MATH 20C,A02,083761,Briones; Jor-el Thomas Caparas,8,0,35,27
1657112202552,MATH 20C,A03,093476,Briones; Jor-el Thomas Caparas,0,1,36,36
1657112202552,MATH 20C,B01,083762,Bach; Quang Tran,0,0,30,30
1657112208588,MATH 20D,A01,083765,Tran; Brian Kha,4,0,30,26
1657112208588,MATH 20D,A02,083766,Tran; Brian Kha,5,0,30,25
1657112208588,MATH 20D,A03,083767,Tran; Brian Kha,3,0,30,27
1657112214625,MATH 20E,A01,083771,Ganguly; Soumya,6,0,32,26
1657112214625,MATH 20E,A02,083772,Ganguly; Soumya,6,0,32,26
1657112214625,MATH 20E,B01,083773,Ciotti; Benjamin,18,0,35,17
1657112214625,MATH 20E,B02,083774,Ciotti; Benjamin,17,0,35,18
1657112220667,MATH 103A,A01,083777,Greenfeld; Be'Eri,2,0,36,34
1657112220667,MATH 103A,A02,083778,Greenfeld; Be'Eri,5,0,36,31
1657112220667,MATH 103A,A03,093561,Greenfeld; Be'Eri,4,0,36,32
1657112220667,MATH 103A,B01,083779,Greenfeld; Be'Eri,6,0,36,30
1657112220667,MATH 103A,B02,083780,Greenfeld; Be'Eri,2,0,36,34
1657112220667,MATH 103A,B03,093562,Greenfeld; Be'Eri,3,0,36,33
1657112226694,MATH 105,A01,085443,Carter; Anne Toulson,14,0,35,21
1657112226694,MATH 105,A02,093477,Carter; Anne Toulson,20,0,35,15
1657112232726,MATH 109,A01,083213,Ganzberger; Geoffrey Michael,2,0,34,32
1657112232726,MATH 109,A02,083214,Ganzberger; Geoffrey Michael,3,0,34,31
1657112232726,MATH 109,A03,093478,Ganzberger; Geoffrey Michael,1,0,34,33
1657112232726,MATH 109,B01,083215,Ganzberger; Geoffrey Michael,1,0,32,31
1657112232726,MATH 109,B02,083216,Ganzberger; Geoffrey Michael,1,0,32,31
1657112232726,MATH 109,B03,093479,Ganzberger; Geoffrey Michael,6,0,32,26
1657112238754,MATH 142A,A01,083219,Chow; Bennett,6,0,32,26
1657112238754,MATH 142A,A02,083220,Chow; Bennett,10,0,32,22
1657112238754,MATH 142A,A03,093480,Chow; Bennett,7,0,32,25
1657112238754,MATH 142A,B03,093481,Chow; Bennett,8,0,32,24
1657112238754,MATH 142A,B04,093558,Chow; Bennett,11,0,32,21
1657112238754,MATH 142A,B05,093559,Chow; Bennett,6,0,32,26
1657112244785,MATH 193A,A01,083224,Rotar; Vladimir,7,0,34,27
1657112244785,MATH 193A,A02,083225,Rotar; Vladimir,5,0,34,29
1657112244785,MATH 193A,A03,083781,Rotar; Vladimir,1,0,34,33
1657112244785,MATH 193A,A04,083782,Rotar; Vladimir,6,0,34,28
1657112244785,MATH 193A,A05,093482,Rotar; Vladimir,6,0,34,28
1657112250819,MATH 197,001,091859,McAuley; Julian John,9999,0,9999,0
1657112250819,MATH 197,002,095566,Kedlaya; Kiran S.,9997,0,9999,2
1657112250819,MATH 197,003,095567,Xiao; Ming,9999,0,9999,0
1657112250819,MATH 197,004,095571,Perols; Johan Lars,9998,0,9999,1
1657112257881,COGS 9,A01,083615,Shannon; Kyle Michael,7,0,75,68
1657112263908,COGS 11,A01,083617,Boyle; Mary E. T.,21,0,48,27
1657112269939,COGS 13,A01,083071,Bastos; Amalia Pinkusfeld,9,0,71,62
1657112275973,COGS 14A,A01,092681,Semenuks; Arturs,1,1,100,99
1657112282004,COGS 14B,A01,083073,Cheng; Tzu-Han,6,0,63,57
1657112288035,COGS 17,A01,092677,Semenuks; Arturs,4,0,81,77
1657112294068,COGS 100,A01,083619,Allen; Michael Gordon,15,0,70,55
1657112300098,COGS 101A,A01,083621,Davis; Joshua Daniel,9,0,68,59
1657112306125,COGS 101B,A01,091572,Allen; Michael Gordon,8,0,65,57
1657112312156,COGS 101C,A01,083625,Delgado; Tania,17,0,35,18
1657112318186,COGS 107A,A01,083627,Boyle; Mary E. T.,13,0,60,47
1657112324210,COGS 118A,A01,083075,Gupta; Anjum,15,0,76,61
1657112330236,CSE 3,A50,083646,Miranda; Gregory Joseph,22,0,50,28
1657112336261,CSE 8A,A50,083650,Miranda; Gregory Joseph,17,1,56,39
1657112342285,CSE 11,A01,083080,Cao; Yingjun,4,15,40,36
1657112348328,CSE 12,A01,083652,Krause-Levy; Sophia Louisa,23,1,120,97
1657112354360,CSE 15L,A01,083654,Morris; Justin Loren,9,0,50,41
1657112354360,CSE 15L,A02,083655,Morris; Justin Loren,9,0,50,41
1657112360388,CSE 20,A01,083657,Tran; Khoa Dang,37,0,80,43
1657112366417,CSE 21,A01,095574,Bach; Quang Tran,21,0,48,27
1657112372443,CSE 30,A01,083084,Eldon; John,4,0,80,76
1657112372443,CSE 30,B01,095061,Bhaskar; Nishant,6,0,50,44
1657112378477,CSE 100,A01,083659,Cao; Yingjun,4,4,70,66
1657112384507,CSE 134B,A01,083661,Powell; Thomas Allan,19,0,100,81
1657112390531,CSE 140,A01,083663,Gungor; Onat,14,0,85,71
1657112396561,CSE 140L,A01,083088,Eldon; John,17,0,100,83
1657112402587,CSE 175,A01,083665,Kumar; Rakesh,3,0,25,22
1657112408613,CSE 190,A00,092507,Dubnov; Shlomo,7,0,20,13
1657112414640,ECE 45,A01,083139,Congero; Spencer William,5,0,75,70
1657112420671,ECE 65,A50,083695,Saad; Andrew S,12,0,30,18
1657112420671,ECE 65,A51,095125,Saad; Andrew S,25,0,26,1
1657112426702,ECE 109,A01,091882,Touri; Behrouz,16,0,70,54
1657112432728,ECE 180,A00,083140,Abi Samra; Nicholas Camill,1,0,30,29
1657112432728,ECE 180,B00,083141,Abi Samra; Nicholas Camill,0,0,30,30
1657112438768,MATH 10A,A01,083735,Patchell; Gregory David,1,0,30,29
1657112438768,MATH 10A,A02,083736,Patchell; Gregory David,20,0,30,10
1657112438768,MATH 10A,A03,083737,Patchell; Gregory David,16,0,30,14
1657112444795,MATH 10B,A01,083207,Lim; Seonhee,7,0,34,27
1657112444795,MATH 10B,A02,083208,Lim; Seonhee,9,0,35,26
1657112444795,MATH 10B,A03,093472,Lim; Seonhee,5,0,34,29
1657112444795,MATH 10B,B01,083739,Sinha; Shubham,9,0,30,21
1657112450824,MATH 18,A01,083743,Cinel; Cameron Alexander,6,0,30,24
1657112450824,MATH 18,A02,083744,Cinel; Cameron Alexander,15,0,30,15
1657112450824,MATH 18,A03,083745,Cinel; Cameron Alexander,8,0,30,22
1657112450824,MATH 18,B01,083748,Rideout; David Porter,4,0,37,33
1657112450824,MATH 18,B02,083749,Rideout; David Porter,3,0,36,33
1657112450824,MATH 18,B03,083750,Rideout; David Porter,2,0,37,35
1657112450824,MATH 18,B04,083751,Rideout; David Porter,5,0,36,31
1657112450824,MATH 18,B05,093473,Rideout; David Porter,4,0,36,32
1657112450824,MATH 18,B06,093474,Rideout; David Porter,5,0,36,31
1657112456851,MATH 20A,A01,083754,Zheng; Zequn,12,0,40,28
1657112462885,MATH 20B,A01,083756,Briones; Jor-el Thomas Caparas,1,0,36,35
1657112462885,MATH 20B,A02,083757,Briones; Jor-el Thomas Caparas,1,0,36,35
1657112462885,MATH 20B,A03,093475,Briones; Jor-el Thomas Caparas,0,0,36,36
1657112468911,MATH 20C,A01,083760,Briones; Jor-el Thomas Caparas,1,0,35,34
1657112468911,MATH 20C,A02,083761,Briones; Jor-el Thomas Caparas,8,0,35,27
1657112468911,MATH 20C,A03,093476,Briones; Jor-el Thomas Caparas,0,1,36,36
1657112468911,MATH 20C,B01,083762,Bach; Quang Tran,0,0,30,30
1657112474948,MATH 20D,A01,083765,Tran; Brian Kha,4,0,30,26
1657112474948,MATH 20D,A02,083766,Tran; Brian Kha,5,0,30,25
1657112474948,MATH 20D,A03,083767,Tran; Brian Kha,3,0,30,27
1657112480981,MATH 20E,A01,083771,Ganguly; Soumya,6,0,32,26
1657112480981,MATH 20E,A02,083772,Ganguly; Soumya,6,0,32,26
1657112480981,MATH 20E,B01,083773,Ciotti; Benjamin,18,0,35,17
1657112480981,MATH 20E,B02,083774,Ciotti; Benjamin,17,0,35,18
1657112487010,MATH 103A,A01,083777,Greenfeld; Be'Eri,2,0,36,34
1657112487010,MATH 103A,A02,083778,Greenfeld; Be'Eri,5,0,36,31
1657112487010,MATH 103A,A03,093561,Greenfeld; Be'Eri,4,0,36,32
1657112487010,MATH 103A,B01,083779,Greenfeld; Be'Eri,6,0,36,30
1657112487010,MATH 103A,B02,083780,Greenfeld; Be'Eri,2,0,36,34
1657112487010,MATH 103A,B03,093562,Greenfeld; Be'Eri,3,0,36,33
1657112493036,MATH 105,A01,085443,Carter; Anne Toulson,14,0,35,21
1657112493036,MATH 105,A02,093477,Carter; Anne Toulson,20,0,35,15
1657112499067,MATH 109,A01,083213,Ganzberger; Geoffrey Michael,2,0,34,32
1657112499067,MATH 109,A02,083214,Ganzberger; Geoffrey Michael,3,0,34,31
1657112499067,MATH 109,A03,093478,Ganzberger; Geoffrey Michael,1,0,34,33
1657112499067,MATH 109,B01,083215,Ganzberger; Geoffrey Michael,1,0,32,31
1657112499067,MATH 109,B02,083216,Ganzberger; Geoffrey Michael,1,0,32,31
1657112499067,MATH 109,B03,093479,Ganzberger; Geoffrey Michael,6,0,32,26
1657112505095,MATH 142A,A01,083219,Chow; Bennett,6,0,32,26
1657112505095,MATH 142A,A02,083220,Chow; Bennett,10,0,32,22
1657112505095,MATH 142A,A03,093480,Chow; Bennett,7,0,32,25
1657112505095,MATH 142A,B03,093481,Chow; Bennett,8,0,32,24
1657112505095,MATH 142A,B04,093558,Chow; Bennett,11,0,32,21
1657112505095,MATH 142A,B05,093559,Chow; Bennett,6,0,32,26
1657112511122,MATH 193A,A01,083224,Rotar; Vladimir,7,0,34,27
1657112511122,MATH 193A,A02,083225,Rotar; Vladimir,5,0,34,29
1657112511122,MATH 193A,A03,083781,Rotar; Vladimir,1,0,34,33
1657112511122,MATH 193A,A04,083782,Rotar; Vladimir,6,0,34,28
1657112511122,MATH 193A,A05,093482,Rotar; Vladimir,6,0,34,28
1657112517153,MATH 197,001,091859,McAuley; Julian John,9999,0,9999,0
1657112517153,MATH 197,002,095566,Kedlaya; Kiran S.,9997,0,9999,2
1657112517153,MATH 197,003,095567,Xiao; Ming,9999,0,9999,0
1657112517153,MATH 197,004,095571,Perols; Johan Lars,9998,0,9999,1
1657112524239,COGS 9,A01,083615,Shannon; Kyle Michael,7,0,75,68
1657112530266,COGS 11,A01,083617,Boyle; Mary E. T.,21,0,48,27
1657112536297,COGS 13,A01,083071,Bastos; Amalia Pinkusfeld,9,0,71,62
1657112542330,COGS 14A,A01,092681,Semenuks; Arturs,1,1,100,99
1657112548354,COGS 14B,A01,083073,Cheng; Tzu-Han,6,0,63,57
1657112554386,COGS 17,A01,092677,Semenuks; Arturs,4,0,81,77
1657112560413,COGS 100,A01,083619,Allen; Michael Gordon,15,0,70,55
1657112566438,COGS 101A,A01,083621,Davis; Joshua Daniel,9,0,68,59
1657112572471,COGS 101B,A01,091572,Allen; Michael Gordon,8,0,65,57
1657112578499,COGS 101C,A01,083625,Delgado; Tania,17,0,35,18
1657112584530,COGS 107A,A01,083627,Boyle; Mary E. T.,13,0,60,47
1657112590555,COGS 118A,A01,083075,Gupta; Anjum,15,0,76,61
1657112596581,CSE 3,A50,083646,Miranda; Gregory Joseph,22,0,50,28
1657112602615,CSE 8A,A50,083650,Miranda; Gregory Joseph,17,1,56,39
1657112608646,CSE 11,A01,083080,Cao; Yingjun,4,15,40,36
1657112614673,CSE 12,A01,083652,Krause-Levy; Sophia Louisa,23,1,120,97
1657112620700,CSE 15L,A01,083654,Morris; Justin Loren,9,0,50,41
1657112620700,CSE 15L,A02,083655,Morris; Justin Loren,9,0,50,41
1657112626725,CSE 20,A01,083657,Tran; Khoa Dang,37,0,80,43
1657112632755,CSE 21,A01,095574,Bach; Quang Tran,21,0,48,27
1657112638780,CSE 30,A01,083084,Eldon; John,4,0,80,76
1657112638780,CSE 30,B01,095061,Bhaskar; Nishant,6,0,50,44
1657112644803,CSE 100,A01,083659,Cao; Yingjun,4,4,70,66
1657112650828,CSE 134B,A01,083661,Powell; Thomas Allan,19,0,100,81
1657112656858,CSE 140,A01,083663,Gungor; Onat,14,0,85,71
1657112662883,CSE 140L,A01,083088,Eldon; John,17,0,100,83
1657112668914,CSE 175,A01,083665,Kumar; Rakesh,3,0,25,22
1657112674947,CSE 190,A00,092507,Dubnov; Shlomo,7,0,20,13
1657112680979,ECE 45,A01,083139,Congero; Spencer William,5,0,75,70
1657112687084,ECE 65,A50,083695,Saad; Andrew S,12,0,30,18
1657112687084,ECE 65,A51,095125,Saad; Andrew S,25,0,26,1
1657112693110,ECE 109,A01,091882,Touri; Behrouz,16,0,70,54
1657112699145,ECE 180,A00,083140,Abi Samra; Nicholas Camill,1,0,30,29
1657112699145,ECE 180,B00,083141,Abi Samra; Nicholas Camill,0,0,30,30
1657112705173,MATH 10A,A01,083735,Patchell; Gregory David,1,0,30,29
1657112705173,MATH 10A,A02,083736,Patchell; Gregory David,20,0,30,10
1657112705173,MATH 10A,A03,083737,Patchell; Gregory David,16,0,30,14
1657112711203,MATH 10B,A01,083207,Lim; Seonhee,7,0,34,27
1657112711203,MATH 10B,A02,083208,Lim; Seonhee,9,0,35,26
1657112711203,MATH 10B,A03,093472,Lim; Seonhee,5,0,34,29
1657112711203,MATH 10B,B01,083739,Sinha; Shubham,9,0,30,21
1657112717242,MATH 18,A01,083743,Cinel; Cameron Alexander,6,0,30,24
1657112717242,MATH 18,A02,083744,Cinel; Cameron Alexander,15,0,30,15
1657112717242,MATH 18,A03,083745,Cinel; Cameron Alexander,8,0,30,22
1657112717242,MATH 18,B01,083748,Rideout; David Porter,4,0,37,33
1657112717242,MATH 18,B02,083749,Rideout; David Porter,3,0,36,33
1657112717242,MATH 18,B03,083750,Rideout; David Porter,2,0,37,35
1657112717242,MATH 18,B04,083751,Rideout; David Porter,5,0,36,31
1657112717242,MATH 18,B05,093473,Rideout; David Porter,4,0,36,32
1657112717242,MATH 18,B06,093474,Rideout; David Porter,5,0,36,31
1657112723273,MATH 20A,A01,083754,Zheng; Zequn,12,0,40,28
1657112729298,MATH 20B,A01,083756,Briones; Jor-el Thomas Caparas,1,0,36,35
1657112729298,MATH 20B,A02,083757,Briones; Jor-el Thomas Caparas,1,0,36,35
1657112729298,MATH 20B,A03,093475,Briones; Jor-el Thomas Caparas,0,0,36,36
1657112735332,MATH 20C,A01,083760,Briones; Jor-el Thomas Caparas,1,0,35,34
1657112735332,MATH 20C,A02,083761,Briones; Jor-el Thomas Caparas,8,0,35,27
1657112735332,MATH 20C,A03,093476,Briones; Jor-el Thomas Caparas,0,1,36,36
1657112735332,MATH 20C,B01,083762,Bach; Quang Tran,0,0,30,30
1657112741359,MATH 20D,A01,083765,Tran; Brian Kha,4,0,30,26
1657112741359,MATH 20D,A02,083766,Tran; Brian Kha,5,0,30,25
1657112741359,MATH 20D,A03,083767,Tran; Brian Kha,3,0,30,27
1657112747388,MATH 20E,A01,083771,Ganguly; Soumya,6,0,32,26
1657112747388,MATH 20E,A02,083772,Ganguly; Soumya,6,0,32,26
1657112747388,MATH 20E,B01,083773,Ciotti; Benjamin,18,0,35,17
1657112747388,MATH 20E,B02,083774,Ciotti; Benjamin,17,0,35,18
1657112753415,MATH 103A,A01,083777,Greenfeld; Be'Eri,2,0,36,34
1657112753415,MATH 103A,A02,083778,Greenfeld; Be'Eri,5,0,36,31
1657112753415,MATH 103A,A03,093561,Greenfeld; Be'Eri,4,0,36,32
1657112753415,MATH 103A,B01,083779,Greenfeld; Be'Eri,6,0,36,30
1657112753415,MATH 103A,B02,083780,Greenfeld; Be'Eri,2,0,36,34
1657112753415,MATH 103A,B03,093562,Greenfeld; Be'Eri,3,0,36,33
1657112759441,MATH 105,A01,085443,Carter; Anne Toulson,14,0,35,21
1657112759441,MATH 105,A02,093477,Carter; Anne Toulson,20,0,35,15
1657112765476,MATH 109,A01,083213,Ganzberger; Geoffrey Michael,2,0,34,32
1657112765476,MATH 109,A02,083214,Ganzberger; Geoffrey Michael,3,0,34,31
1657112765476,MATH 109,A03,093478,Ganzberger; Geoffrey Michael,1,0,34,33
1657112765476,MATH 109,B01,083215,Ganzberger; Geoffrey Michael,1,0,32,31
1657112765476,MATH 109,B02,083216,Ganzberger; Geoffrey Michael,1,0,32,31
1657112765476,MATH 109,B03,093479,Ganzberger; Geoffrey Michael,6,0,32,26
1657112771502,MATH 142A,A01,083219,Chow; Bennett,6,0,32,26
1657112771502,MATH 142A,A02,083220,Chow; Bennett,10,0,32,22
1657112771502,MATH 142A,A03,093480,Chow; Bennett,7,0,32,25
1657112771502,MATH 142A,B03,093481,Chow; Bennett,8,0,32,24
1657112771502,MATH 142A,B04,093558,Chow; Bennett,11,0,32,21
1657112771502,MATH 142A,B05,093559,Chow; Bennett,6,0,32,26
1657112777547,MATH 193A,A01,083224,Rotar; Vladimir,7,0,34,27
1657112777547,MATH 193A,A02,083225,Rotar; Vladimir,5,0,34,29
1657112777547,MATH 193A,A03,083781,Rotar; Vladimir,1,0,34,33
1657112777547,MATH 193A,A04,083782,Rotar; Vladimir,6,0,34,28
1657112777547,MATH 193A,A05,093482,Rotar; Vladimir,6,0,34,28
1657112783578,MATH 197,001,091859,McAuley; Julian John,9999,0,9999,0
1657112783578,MATH 197,002,095566,Kedlaya; Kiran S.,9997,0,9999,2
1657112783578,MATH 197,003,095567,Xiao; Ming,9999,0,9999,0
1657112783578,MATH 197,004,095571,Perols; Johan Lars,9998,0,9999,1
1657112790662,COGS 9,A01,083615,Shannon; Kyle Michael,7,0,75,68
1657112796696,COGS 11,A01,083617,Boyle; Mary E. T.,21,0,48,27
1657112802740,COGS 13,A01,083071,Bastos; Amalia Pinkusfeld,9,0,71,62
1657112808767,COGS 14A,A01,092681,Semenuks; Arturs,1,1,100,99
1657112814797,COGS 14B,A01,083073,Cheng; Tzu-Han,6,0,63,57
1657112820822,COGS 17,A01,092677,Semenuks; Arturs,4,0,81,77
1657112826848,COGS 100,A01,083619,Allen; Michael Gordon,15,0,70,55
1657112832873,COGS 101A,A01,083621,Davis; Joshua Daniel,9,0,68,59
1657112838898,COGS 101B,A01,091572,Allen; Michael Gordon,8,0,65,57
1657112844933,COGS 101C,A01,083625,Delgado; Tania,17,0,35,18
1657112850964,COGS 107A,A01,083627,Boyle; Mary E. T.,13,0,60,47
1657112856990,COGS 118A,A01,083075,Gupta; Anjum,15,0,76,61
1657112863024,CSE 3,A50,083646,Miranda; Gregory Joseph,22,0,50,28
1657112869049,CSE 8A,A50,083650,Miranda; Gregory Joseph,17,1,56,39
1657112875073,CSE 11,A01,083080,Cao; Yingjun,4,15,40,36
1657112881103,CSE 12,A01,083652,Krause-Levy; Sophia Louisa,23,1,120,97
1657112887135,CSE 15L,A01,083654,Morris; Justin Loren,9,0,50,41
1657112887135,CSE 15L,A02,083655,Morris; Justin Loren,9,0,50,41
1657112893171,CSE 20,A01,083657,Tran; Khoa Dang,37,0,80,43
1657112899196,CSE 21,A01,095574,Bach; Quang Tran,21,0,48,27
1657112905223,CSE 30,A01,083084,Eldon; John,4,0,80,76
1657112905223,CSE 30,B01,095061,Bhaskar; Nishant,6,0,50,44
1657112911248,CSE 100,A01,083659,Cao; Yingjun,4,4,70,66
1657112917273,CSE 134B,A01,083661,Powell; Thomas Allan,19,0,100,81
1657112923303,CSE 140,A01,083663,Gungor; Onat,14,0,85,71
1657112929328,CSE 140L,A01,083088,Eldon; John,17,0,100,83
1657112935355,CSE 175,A01,083665,Kumar; Rakesh,3,0,25,22
1657112941383,CSE 190,A00,092507,Dubnov; Shlomo,7,0,20,13
1657112947410,ECE 45,A01,083139,Congero; Spencer William,5,0,75,70
1657112953443,ECE 65,A50,083695,Saad; Andrew S,12,0,30,18
1657112953443,ECE 65,A51,095125,Saad; Andrew S,25,0,26,1
1657112959477,ECE 109,A01,091882,Touri; Behrouz,16,0,70,54
1657112965509,ECE 180,A00,083140,Abi Samra; Nicholas Camill,1,0,30,29
1657112965509,ECE 180,B00,083141,Abi Samra; Nicholas Camill,0,0,30,30
1657112971547,MATH 10A,A01,083735,Patchell; Gregory David,1,0,30,29
1657112971547,MATH 10A,A02,083736,Patchell; Gregory David,20,0,30,10
1657112971547,MATH 10A,A03,083737,Patchell; Gregory David,16,0,30,14
1657112977578,MATH 10B,A01,083207,Lim; Seonhee,7,0,34,27
1657112977578,MATH 10B,A02,083208,Lim; Seonhee,9,0,35,26
1657112977578,MATH 10B,A03,093472,Lim; Seonhee,5,0,34,29
1657112977578,MATH 10B,B01,083739,Sinha; Shubham,9,0,30,21
1657112983605,MATH 18,A01,083743,Cinel; Cameron Alexander,6,0,30,24
1657112983605,MATH 18,A02,083744,Cinel; Cameron Alexander,15,0,30,15
1657112983605,MATH 18,A03,083745,Cinel; Cameron Alexander,8,0,30,22
1657112983605,MATH 18,B01,083748,Rideout; David Porter,4,0,37,33
1657112983605,MATH 18,B02,083749,Rideout; David Porter,3,0,36,33
1657112983605,MATH 18,B03,083750,Rideout; David Porter,2,0,37,35
1657112983605,MATH 18,B04,083751,Rideout; David Porter,5,0,36,31
1657112983605,MATH 18,B05,093473,Rideout; David Porter,4,0,36,32
1657112983605,MATH 18,B06,093474,Rideout; David Porter,5,0,36,31
1657112989630,MATH 20A,A01,083754,Zheng; Zequn,12,0,40,28
1657112995661,MATH 20B,A01,083756,Briones; Jor-el Thomas Caparas,1,0,36,35
1657112995661,MATH 20B,A02,083757,Briones; Jor-el Thomas Caparas,1,0,36,35
1657112995661,MATH 20B,A03,093475,Briones; Jor-el Thomas Caparas,0,0,36,36
1657113001715,MATH 20C,A01,083760,Briones; Jor-el Thomas Caparas,1,0,35,34
1657113001715,MATH 20C,A02,083761,Briones; Jor-el Thomas Caparas,8,0,35,27
1657113001715,MATH 20C,A03,093476,Briones; Jor-el Thomas Caparas,0,1,36,36
1657113001715,MATH 20C,B01,083762,Bach; Quang Tran,0,0,30,30
1657113007746,MATH 20D,A01,083765,Tran; Brian Kha,4,0,30,26
1657113007746,MATH 20D,A02,083766,Tran; Brian Kha,5,0,30,25
1657113007746,MATH 20D,A03,083767,Tran; Brian Kha,3,0,30,27
1657113013774,MATH 20E,A01,083771,Ganguly; Soumya,6,0,32,26
1657113013774,MATH 20E,A02,083772,Ganguly; Soumya,6,0,32,26
1657113013774,MATH 20E,B01,083773,Ciotti; Benjamin,18,0,35,17
1657113013774,MATH 20E,B02,083774,Ciotti; Benjamin,17,0,35,18
1657113019813,MATH 103A,A01,083777,Greenfeld; Be'Eri,2,0,36,34
1657113019813,MATH 103A,A02,083778,Greenfeld; Be'Eri,5,0,36,31
1657113019813,MATH 103A,A03,093561,Greenfeld; Be'Eri,4,0,36,32
1657113019813,MATH 103A,B01,083779,Greenfeld; Be'Eri,6,0,36,30
1657113019813,MATH 103A,B02,083780,Greenfeld; Be'Eri,2,0,36,34
1657113019813,MATH 103A,B03,093562,Greenfeld; Be'Eri,3,0,36,33
1657113025841,MATH 105,A01,085443,Carter; Anne Toulson,14,0,35,21
1657113025841,MATH 105,A02,093477,Carter; Anne Toulson,20,0,35,15
1657113031879,MATH 109,A01,083213,Ganzberger; Geoffrey Michael,2,0,34,32
1657113031879,MATH 109,A02,083214,Ganzberger; Geoffrey Michael,3,0,34,31
1657113031879,MATH 109,A03,093478,Ganzberger; Geoffrey Michael,1,0,34,33
1657113031879,MATH 109,B01,083215,Ganzberger; Geoffrey Michael,1,0,32,31
1657113031879,MATH 109,B02,083216,Ganzberger; Geoffrey Michael,1,0,32,31
1657113031879,MATH 109,B03,093479,Ganzberger; Geoffrey Michael,6,0,32,26
1657113037906,MATH 142A,A01,083219,Chow; Bennett,6,0,32,26
1657113037906,MATH 142A,A02,083220,Chow; Bennett,10,0,32,22
1657113037906,MATH 142A,A03,093480,Chow; Bennett,7,0,32,25
1657113037906,MATH 142A,B03,093481,Chow; Bennett,8,0,32,24
1657113037906,MATH 142A,B04,093558,Chow; Bennett,11,0,32,21
1657113037906,MATH 142A,B05,093559,Chow; Bennett,6,0,32,26
1657113043939,MATH 193A,A01,083224,Rotar; Vladimir,7,0,34,27
1657113043939,MATH 193A,A02,083225,Rotar; Vladimir,5,0,34,29
1657113043939,MATH 193A,A03,083781,Rotar; Vladimir,1,0,34,33
1657113043939,MATH 193A,A04,083782,Rotar; Vladimir,6,0,34,28
1657113043939,MATH 193A,A05,093482,Rotar; Vladimir,6,0,34,28
1657113049970,MATH 197,001,091859,McAuley; Julian John,9999,0,9999,0
1657113049970,MATH 197,002,095566,Kedlaya; Kiran S.,9997,0,9999,2
1657113049970,MATH 197,003,095567,Xiao; Ming,9999,0,9999,0
1657113049970,MATH 197,004,095571,Perols; Johan Lars,9998,0,9999,1
1657113057046,COGS 9,A01,083615,Shannon; Kyle Michael,7,0,75,68
1657113063078,COGS 11,A01,083617,Boyle; Mary E. T.,21,0,48,27
1657113069111,COGS 13,A01,083071,Bastos; Amalia Pinkusfeld,9,0,71,62
1657113075149,COGS 14A,A01,092681,Semenuks; Arturs,1,1,100,99
1657113081178,COGS 14B,A01,083073,Cheng; Tzu-Han,6,0,63,57
1657113087202,COGS 17,A01,092677,Semenuks; Arturs,4,0,81,77
1657113093230,COGS 100,A01,083619,Allen; Michael Gordon,15,0,70,55
1657113099264,COGS 101A,A01,083621,Davis; Joshua Daniel,9,0,68,59
1657113105299,COGS 101B,A01,091572,Allen; Michael Gordon,8,0,65,57
1657113111324,COGS 101C,A01,083625,Delgado; Tania,17,0,35,18
1657113117349,COGS 107A,A01,083627,Boyle; Mary E. T.,13,0,60,47
1657113123387,COGS 118A,A01,083075,Gupta; Anjum,15,0,76,61
1657113129422,CSE 3,A50,083646,Miranda; Gregory Joseph,22,0,50,28
1657113135448,CSE 8A,A50,083650,Miranda; Gregory Joseph,17,1,56,39
1657113141477,CSE 11,A01,083080,Cao; Yingjun,4,15,40,36
1657113147506,CSE 12,A01,083652,Krause-Levy; Sophia Louisa,23,1,120,97
1657113153536,CSE 15L,A01,083654,Morris; Justin Loren,9,0,50,41
1657113153536,CSE 15L,A02,083655,Morris; Justin Loren,9,0,50,41
1657113159568,CSE 20,A01,083657,Tran; Khoa Dang,37,0,80,43
1657113165599,CSE 21,A01,095574,Bach; Quang Tran,21,0,48,27
1657113171626,CSE 30,A01,083084,Eldon; John,4,0,80,76
1657113171626,CSE 30,B01,095061,Bhaskar; Nishant,6,0,50,44
1657113177652,CSE 100,A01,083659,Cao; Yingjun,4,4,70,66
1657113183679,CSE 134B,A01,083661,Powell; Thomas Allan,19,0,100,81
1657113189708,CSE 140,A01,083663,Gungor; Onat,14,0,85,71
1657113195732,CSE 140L,A01,083088,Eldon; John,17,0,100,83
1657113201758,CSE 175,A01,083665,Kumar; Rakesh,3,0,25,22
1657113207785,CSE 190,A00,092507,Dubnov; Shlomo,7,0,20,13
1657113213815,ECE 45,A01,083139,Congero; Spencer William,5,0,75,70
1657113219841,ECE 65,A50,083695,Saad; Andrew S,12,0,30,18
1657113219841,ECE 65,A51,095125,Saad; Andrew S,25,0,26,1
1657113225865,ECE 109,A01,091882,Touri; Behrouz,16,0,70,54
1657113231897,ECE 180,A00,083140,Abi Samra; Nicholas Camill,1,0,30,29
1657113231897,ECE 180,B00,083141,Abi Samra; Nicholas Camill,0,0,30,30
1657113237934,MATH 10A,A01,083735,Patchell; Gregory David,1,0,30,29
1657113237934,MATH 10A,A02,083736,Patchell; Gregory David,20,0,30,10
1657113237934,MATH 10A,A03,083737,Patchell; Gregory David,16,0,30,14
1657113243972,MATH 10B,A01,083207,Lim; Seonhee,7,0,34,27
1657113243972,MATH 10B,A02,083208,Lim; Seonhee,9,0,35,26
1657113243972,MATH 10B,A03,093472,Lim; Seonhee,5,0,34,29
1657113243972,MATH 10B,B01,083739,Sinha; Shubham,9,0,30,21
1657113250001,MATH 18,A01,083743,Cinel; Cameron Alexander,6,0,30,24
1657113250001,MATH 18,A02,083744,Cinel; Cameron Alexander,15,0,30,15
1657113250001,MATH 18,A03,083745,Cinel; Cameron Alexander,8,0,30,22
1657113250001,MATH 18,B01,083748,Rideout; David Porter,4,0,37,33
1657113250001,MATH 18,B02,083749,Rideout; David Porter,3,0,36,33
1657113250001,MATH 18,B03,083750,Rideout; David Porter,2,0,37,35
1657113250001,MATH 18,B04,083751,Rideout; David Porter,5,0,36,31
1657113250001,MATH 18,B05,093473,Rideout; David Porter,4,0,36,32
1657113250001,MATH 18,B06,093474,Rideout; David Porter,5,0,36,31
1657113256026,MATH 20A,A01,083754,Zheng; Zequn,12,0,40,28
1657113262054,MATH 20B,A01,083756,Briones; Jor-el Thomas Caparas,1,0,36,35
1657113262054,MATH 20B,A02,083757,Briones; Jor-el Thomas Caparas,1,0,36,35
1657113262054,MATH 20B,A03,093475,Briones; Jor-el Thomas Caparas,0,0,36,36
1657113268081,MATH 20C,A01,083760,Briones; Jor-el Thomas Caparas,1,0,35,34
1657113268081,MATH 20C,A02,083761,Briones; Jor-el Thomas Caparas,8,0,35,27
1657113268081,MATH 20C,A03,093476,Briones; Jor-el Thomas Caparas,0,1,36,36
1657113268081,MATH 20C,B01,083762,Bach; Quang Tran,0,0,30,30
1657113274106,MATH 20D,A01,083765,Tran; Brian Kha,4,0,30,26
1657113274106,MATH 20D,A02,083766,Tran; Brian Kha,5,0,30,25
1657113274106,MATH 20D,A03,083767,Tran; Brian Kha,3,0,30,27
1657113280140,MATH 20E,A01,083771,Ganguly; Soumya,6,0,32,26
1657113280140,MATH 20E,A02,083772,Ganguly; Soumya,6,0,32,26
1657113280140,MATH 20E,B01,083773,Ciotti; Benjamin,18,0,35,17
1657113280140,MATH 20E,B02,083774,Ciotti; Benjamin,17,0,35,18
1657113286245,MATH 103A,A01,083777,Greenfeld; Be'Eri,2,0,36,34
1657113286245,MATH 103A,A02,083778,Greenfeld; Be'Eri,5,0,36,31
1657113286245,MATH 103A,A03,093561,Greenfeld; Be'Eri,4,0,36,32
1657113286245,MATH 103A,B01,083779,Greenfeld; Be'Eri,6,0,36,30
1657113286245,MATH 103A,B02,083780,Greenfeld; Be'Eri,2,0,36,34
1657113286245,MATH 103A,B03,093562,Greenfeld; Be'Eri,3,0,36,33
1657113292274,MATH 105,A01,085443,Carter; Anne Toulson,14,0,35,21
1657113292274,MATH 105,A02,093477,Carter; Anne Toulson,20,0,35,15
1657113298307,MATH 109,A01,083213,Ganzberger; Geoffrey Michael,2,0,34,32
1657113298307,MATH 109,A02,083214,Ganzberger; Geoffrey Michael,3,0,34,31
1657113298307,MATH 109,A03,093478,Ganzberger; Geoffrey Michael,1,0,34,33
1657113298307,MATH 109,B01,083215,Ganzberger; Geoffrey Michael,1,0,32,31
1657113298307,MATH 109,B02,083216,Ganzberger; Geoffrey Michael,1,0,32,31
1657113298307,MATH 109,B03,093479,Ganzberger; Geoffrey Michael,6,0,32,26
1657113304332,MATH 142A,A01,083219,Chow; Bennett,6,0,32,26
1657113304332,MATH 142A,A02,083220,Chow; Bennett,10,0,32,22
1657113304332,MATH 142A,A03,093480,Chow; Bennett,7,0,32,25
1657113304332,MATH 142A,B03,093481,Chow; Bennett,8,0,32,24
1657113304332,MATH 142A,B04,093558,Chow; Bennett,11,0,32,21
1657113304332,MATH 142A,B05,093559,Chow; Bennett,6,0,32,26
1657113310369,MATH 193A,A01,083224,Rotar; Vladimir,7,0,34,27
1657113310369,MATH 193A,A02,083225,Rotar; Vladimir,5,0,34,29
1657113310369,MATH 193A,A03,083781,Rotar; Vladimir,1,0,34,33
1657113310369,MATH 193A,A04,083782,Rotar; Vladimir,6,0,34,28
1657113310369,MATH 193A,A05,093482,Rotar; Vladimir,6,0,34,28
1657113316393,MATH 197,001,091859,McAuley; Julian John,9999,0,9999,0
1657113316393,MATH 197,002,095566,Kedlaya; Kiran S.,9997,0,9999,2
1657113316393,MATH 197,003,095567,Xiao; Ming,9999,0,9999,0
1657113316393,MATH 197,004,095571,Perols; Johan Lars,9998,0,9999,1
1657113323460,COGS 9,A01,083615,Shannon; Kyle Michael,7,0,75,68
1657113329490,COGS 11,A01,083617,Boyle; Mary E. T.,21,0,48,27
1657113335519,COGS 13,A01,083071,Bastos; Amalia Pinkusfeld,9,0,71,62
1657113341547,COGS 14A,A01,092681,Semenuks; Arturs,1,1,100,99
1657113347572,COGS 14B,A01,083073,Cheng; Tzu-Han,6,0,63,57
1657113353598,COGS 17,A01,092677,Semenuks; Arturs,4,0,81,77
1657113359624,COGS 100,A01,083619,Allen; Michael Gordon,15,0,70,55
1657113365650,COGS 101A,A01,083621,Davis; Joshua Daniel,9,0,68,59
1657113371684,COGS 101B,A01,091572,Allen; Michael Gordon,8,0,65,57
1657113377709,COGS 101C,A01,083625,Delgado; Tania,17,0,35,18
1657113383732,COGS 107A,A01,083627,Boyle; Mary E. T.,13,0,60,47
1657113389758,COGS 118A,A01,083075,Gupta; Anjum,15,0,76,61
1657113395786,CSE 3,A50,083646,Miranda; Gregory Joseph,22,0,50,28
1657113401811,CSE 8A,A50,083650,Miranda; Gregory Joseph,17,1,56,39
1657113407843,CSE 11,A01,083080,Cao; Yingjun,4,15,40,36
1657113413868,CSE 12,A01,083652,Krause-Levy; Sophia Louisa,23,1,120,97
1657113419895,CSE 15L,A01,083654,Morris; Justin Loren,9,0,50,41
1657113419895,CSE 15L,A02,083655,Morris; Justin Loren,9,0,50,41
1657113425921,CSE 20,A01,083657,Tran; Khoa Dang,37,0,80,43
1657113431945,CSE 21,A01,095574,Bach; Quang Tran,21,0,48,27
1657113437971,CSE 30,A01,083084,Eldon; John,4,0,80,76
1657113437971,CSE 30,B01,095061,Bhaskar; Nishant,6,0,50,44
1657113443998,CSE 100,A01,083659,Cao; Yingjun,4,4,70,66
1657113450023,CSE 134B,A01,083661,Powell; Thomas Allan,19,0,100,81
1657113456047,CSE 140,A01,083663,Gungor; Onat,14,0,85,71
1657113462070,CSE 140L,A01,083088,Eldon; John,17,0,100,83
1657113468097,CSE 175,A01,083665,Kumar; Rakesh,3,0,25,22
1657113474122,CSE 190,A00,092507,Dubnov; Shlomo,7,0,20,13
1657113480150,ECE 45,A01,083139,Congero; Spencer William,5,0,75,70
1657113486175,ECE 65,A50,083695,Saad; Andrew S,12,0,30,18
1657113486175,ECE 65,A51,095125,Saad; Andrew S,25,0,26,1
1657113492206,ECE 109,A01,091882,Touri; Behrouz,16,0,70,54
1657113498233,ECE 180,A00,083140,Abi Samra; Nicholas Camill,1,0,30,29
1657113498233,ECE 180,B00,083141,Abi Samra; Nicholas Camill,0,0,30,30
1657113504260,MATH 10A,A01,083735,Patchell; Gregory David,1,0,30,29
1657113504260,MATH 10A,A02,083736,Patchell; Gregory David,20,0,30,10
1657113504260,MATH 10A,A03,083737,Patchell; Gregory David,16,0,30,14
1657113510296,MATH 10B,A01,083207,Lim; Seonhee,7,0,34,27
1657113510296,MATH 10B,A02,083208,Lim; Seonhee,9,0,35,26
1657113510296,MATH 10B,A03,093472,Lim; Seonhee,5,0,34,29
1657113510296,MATH 10B,B01,083739,Sinha; Shubham,9,0,30,21
1657113516346,MATH 18,A01,083743,Cinel; Cameron Alexander,6,0,30,24
1657113516346,MATH 18,A02,083744,Cinel; Cameron Alexander,15,0,30,15
1657113516346,MATH 18,A03,083745,Cinel; Cameron Alexander,8,0,30,22
1657113516346,MATH 18,B01,083748,Rideout; David Porter,4,0,37,33
1657113516346,MATH 18,B02,083749,Rideout; David Porter,3,0,36,33
1657113516346,MATH 18,B03,083750,Rideout; David Porter,2,0,37,35
1657113516346,MATH 18,B04,083751,Rideout; David Porter,5,0,36,31
1657113516346,MATH 18,B05,093473,Rideout; David Porter,4,0,36,32
1657113516346,MATH 18,B06,093474,Rideout; David Porter,5,0,36,31
1657113522380,MATH 20A,A01,083754,Zheng; Zequn,12,0,40,28
1657113528415,MATH 20B,A01,083756,Briones; Jor-el Thomas Caparas,1,0,36,35
1657113528415,MATH 20B,A02,083757,Briones; Jor-el Thomas Caparas,1,0,36,35
1657113528415,MATH 20B,A03,093475,Briones; Jor-el Thomas Caparas,0,0,36,36
1657113534450,MATH 20C,A01,083760,Briones; Jor-el Thomas Caparas,1,0,35,34
1657113534450,MATH 20C,A02,083761,Briones; Jor-el Thomas Caparas,8,0,35,27
1657113534450,MATH 20C,A03,093476,Briones; Jor-el Thomas Caparas,0,1,36,36
1657113534450,MATH 20C,B01,083762,Bach; Quang Tran,0,0,30,30
1657113540481,MATH 20D,A01,083765,Tran; Brian Kha,4,0,30,26
1657113540481,MATH 20D,A02,083766,Tran; Brian Kha,5,0,30,25
1657113540481,MATH 20D,A03,083767,Tran; Brian Kha,3,0,30,27
1657113546510,MATH 20E,A01,083771,Ganguly; Soumya,6,0,32,26
1657113546510,MATH 20E,A02,083772,Ganguly; Soumya,6,0,32,26
1657113546510,MATH 20E,B01,083773,Ciotti; Benjamin,18,0,35,17
1657113546510,MATH 20E,B02,083774,Ciotti; Benjamin,17,0,35,18
1657113552555,MATH 103A,A01,083777,Greenfeld; Be'Eri,2,0,36,34
1657113552555,MATH 103A,A02,083778,Greenfeld; Be'Eri,5,0,36,31
1657113552555,MATH 103A,A03,093561,Greenfeld; Be'Eri,4,0,36,32
1657113552555,MATH 103A,B01,083779,Greenfeld; Be'Eri,6,0,36,30
1657113552555,MATH 103A,B02,083780,Greenfeld; Be'Eri,2,0,36,34
1657113552555,MATH 103A,B03,093562,Greenfeld; Be'Eri,3,0,36,33
1657113558583,MATH 105,A01,085443,Carter; Anne Toulson,14,0,35,21
1657113558583,MATH 105,A02,093477,Carter; Anne Toulson,20,0,35,15
1657113564612,MATH 109,A01,083213,Ganzberger; Geoffrey Michael,2,0,34,32
1657113564612,MATH 109,A02,083214,Ganzberger; Geoffrey Michael,3,0,34,31
1657113564612,MATH 109,A03,093478,Ganzberger; Geoffrey Michael,1,0,34,33
1657113564612,MATH 109,B01,083215,Ganzberger; Geoffrey Michael,1,0,32,31
1657113564612,MATH 109,B02,083216,Ganzberger; Geoffrey Michael,1,0,32,31
1657113564612,MATH 109,B03,093479,Ganzberger; Geoffrey Michael,6,0,32,26
1657113570641,MATH 142A,A01,083219,Chow; Bennett,6,0,32,26
1657113570641,MATH 142A,A02,083220,Chow; Bennett,10,0,32,22
1657113570641,MATH 142A,A03,093480,Chow; Bennett,7,0,32,25
1657113570641,MATH 142A,B03,093481,Chow; Bennett,8,0,32,24
1657113570641,MATH 142A,B04,093558,Chow; Bennett,11,0,32,21
1657113570641,MATH 142A,B05,093559,Chow; Bennett,6,0,32,26
1657113576673,MATH 193A,A01,083224,Rotar; Vladimir,7,0,34,27
1657113576673,MATH 193A,A02,083225,Rotar; Vladimir,5,0,34,29
1657113576673,MATH 193A,A03,083781,Rotar; Vladimir,1,0,34,33
1657113576673,MATH 193A,A04,083782,Rotar; Vladimir,6,0,34,28
1657113576673,MATH 193A,A05,093482,Rotar; Vladimir,6,0,34,28
1657113582714,MATH 197,001,091859,McAuley; Julian John,9999,0,9999,0
1657113582714,MATH 197,002,095566,Kedlaya; Kiran S.,9997,0,9999,2
1657113582714,MATH 197,003,095567,Xiao; Ming,9999,0,9999,0
1657113582714,MATH 197,004,095571,Perols; Johan Lars,9998,0,9999,1
1657113589777,COGS 9,A01,083615,Shannon; Kyle Michael,7,0,75,68
1657113595802,COGS 11,A01,083617,Boyle; Mary E. T.,21,0,48,27
1657113601837,COGS 13,A01,083071,Bastos; Amalia Pinkusfeld,9,0,71,62
1657113607870,COGS 14A,A01,092681,Semenuks; Arturs,1,1,100,99
1657113613896,COGS 14B,A01,083073,Cheng; Tzu-Han,6,0,63,57
1657113619922,COGS 17,A01,092677,Semenuks; Arturs,4,0,81,77
1657113625952,COGS 100,A01,083619,Allen; Michael Gordon,15,0,70,55
1657113631980,COGS 101A,A01,083621,Davis; Joshua Daniel,9,0,68,59
1657113638005,COGS 101B,A01,091572,Allen; Michael Gordon,8,0,65,57
1657113644030,COGS 101C,A01,083625,Delgado; Tania,17,0,35,18
1657113650064,COGS 107A,A01,083627,Boyle; Mary E. T.,13,0,60,47
1657113656094,COGS 118A,A01,083075,Gupta; Anjum,15,0,76,61
1657113662122,CSE 3,A50,083646,Miranda; Gregory Joseph,22,0,50,28
1657113668151,CSE 8A,A50,083650,Miranda; Gregory Joseph,17,1,56,39
1657113674181,CSE 11,A01,083080,Cao; Yingjun,4,15,40,36
1657113680212,CSE 12,A01,083652,Krause-Levy; Sophia Louisa,23,1,120,97
1657113686244,CSE 15L,A01,083654,Morris; Justin Loren,9,0,50,41
1657113686244,CSE 15L,A02,083655,Morris; Justin Loren,9,0,50,41
1657113692275,CSE 20,A01,083657,Tran; Khoa Dang,37,0,80,43
1657113698308,CSE 21,A01,095574,Bach; Quang Tran,21,0,48,27
1657113704333,CSE 30,A01,083084,Eldon; John,4,0,80,76
1657113704333,CSE 30,B01,095061,Bhaskar; Nishant,6,0,50,44
1657113710364,CSE 100,A01,083659,Cao; Yingjun,4,4,70,66
1657113716389,CSE 134B,A01,083661,Powell; Thomas Allan,19,0,100,81
1657113722420,CSE 140,A01,083663,Gungor; Onat,14,0,85,71
1657113728447,CSE 140L,A01,083088,Eldon; John,17,0,100,83
1657113734477,CSE 175,A01,083665,Kumar; Rakesh,3,0,25,22
1657113740508,CSE 190,A00,092507,Dubnov; Shlomo,7,0,20,13
1657113746535,ECE 45,A01,083139,Congero; Spencer William,5,0,75,70
1657113752562,ECE 65,A50,083695,Saad; Andrew S,12,0,30,18
1657113752562,ECE 65,A51,095125,Saad; Andrew S,25,0,26,1
1657113758588,ECE 109,A01,091882,Touri; Behrouz,16,0,70,54
1657113764628,ECE 180,A00,083140,Abi Samra; Nicholas Camill,1,0,30,29
1657113764628,ECE 180,B00,083141,Abi Samra; Nicholas Camill,0,0,30,30
1657113770656,MATH 10A,A01,083735,Patchell; Gregory David,1,0,30,29
1657113770656,MATH 10A,A02,083736,Patchell; Gregory David,20,0,30,10
1657113770656,MATH 10A,A03,083737,Patchell; Gregory David,16,0,30,14
1657113776685,MATH 10B,A01,083207,Lim; Seonhee,7,0,34,27
1657113776685,MATH 10B,A02,083208,Lim; Seonhee,9,0,35,26
1657113776685,MATH 10B,A03,093472,Lim; Seonhee,5,0,34,29
1657113776685,MATH 10B,B01,083739,Sinha; Shubham,9,0,30,21
1657113782724,MATH 18,A01,083743,Cinel; Cameron Alexander,6,0,30,24
1657113782724,MATH 18,A02,083744,Cinel; Cameron Alexander,15,0,30,15
1657113782724,MATH 18,A03,083745,Cinel; Cameron Alexander,8,0,30,22
1657113782724,MATH 18,B01,083748,Rideout; David Porter,4,0,37,33
1657113782724,MATH 18,B02,083749,Rideout; David Porter,3,0,36,33
1657113782724,MATH 18,B03,083750,Rideout; David Porter,2,0,37,35
1657113782724,MATH 18,B04,083751,Rideout; David Porter,5,0,36,31
1657113782724,MATH 18,B05,093473,Rideout; David Porter,4,0,36,32
1657113782724,MATH 18,B06,093474,Rideout; David Porter,5,0,36,31
1657113788757,MATH 20A,A01,083754,Zheng; Zequn,12,0,40,28
1657113794785,MATH 20B,A01,083756,Briones; Jor-el Thomas Caparas,1,0,36,35
1657113794785,MATH 20B,A02,083757,Briones; Jor-el Thomas Caparas,1,0,36,35
1657113794785,MATH 20B,A03,093475,Briones; Jor-el Thomas Caparas,0,0,36,36
1657113800812,MATH 20C,A01,083760,Briones; Jor-el Thomas Caparas,1,0,35,34
1657113800812,MATH 20C,A02,083761,Briones; Jor-el Thomas Caparas,8,0,35,27
1657113800812,MATH 20C,A03,093476,Briones; Jor-el Thomas Caparas,0,1,36,36
1657113800812,MATH 20C,B01,083762,Bach; Quang Tran,0,0,30,30
1657113806844,MATH 20D,A01,083765,Tran; Brian Kha,4,0,30,26
1657113806844,MATH 20D,A02,083766,Tran; Brian Kha,5,0,30,25
1657113806844,MATH 20D,A03,083767,Tran; Brian Kha,3,0,30,27
1657113812873,MATH 20E,A01,083771,Ganguly; Soumya,6,0,32,26
1657113812873,MATH 20E,A02,083772,Ganguly; Soumya,6,0,32,26
1657113812873,MATH 20E,B01,083773,Ciotti; Benjamin,18,0,35,17
1657113812873,MATH 20E,B02,083774,Ciotti; Benjamin,17,0,35,18
1657113818902,MATH 103A,A01,083777,Greenfeld; Be'Eri,2,0,36,34
1657113818902,MATH 103A,A02,083778,Greenfeld; Be'Eri,5,0,36,31
1657113818902,MATH 103A,A03,093561,Greenfeld; Be'Eri,4,0,36,32
1657113818902,MATH 103A,B01,083779,Greenfeld; Be'Eri,6,0,36,30
1657113818902,MATH 103A,B02,083780,Greenfeld; Be'Eri,2,0,36,34
1657113818902,MATH 103A,B03,093562,Greenfeld; Be'Eri,3,0,36,33
1657113824930,MATH 105,A01,085443,Carter; Anne Toulson,14,0,35,21
1657113824930,MATH 105,A02,093477,Carter; Anne Toulson,20,0,35,15
1657113830956,MATH 109,A01,083213,Ganzberger; Geoffrey Michael,2,0,34,32
1657113830956,MATH 109,A02,083214,Ganzberger; Geoffrey Michael,3,0,34,31
1657113830956,MATH 109,A03,093478,Ganzberger; Geoffrey Michael,1,0,34,33
1657113830956,MATH 109,B01,083215,Ganzberger; Geoffrey Michael,1,0,32,31
1657113830956,MATH 109,B02,083216,Ganzberger; Geoffrey Michael,1,0,32,31
1657113830956,MATH 109,B03,093479,Ganzberger; Geoffrey Michael,6,0,32,26
1657113836991,MATH 142A,A01,083219,Chow; Bennett,6,0,32,26
1657113836991,MATH 142A,A02,083220,Chow; Bennett,10,0,32,22
1657113836991,MATH 142A,A03,093480,Chow; Bennett,7,0,32,25
1657113836991,MATH 142A,B03,093481,Chow; Bennett,8,0,32,24
1657113836991,MATH 142A,B04,093558,Chow; Bennett,11,0,32,21
1657113836991,MATH 142A,B05,093559,Chow; Bennett,6,0,32,26
1657113843017,MATH 193A,A01,083224,Rotar; Vladimir,7,0,34,27
1657113843017,MATH 193A,A02,083225,Rotar; Vladimir,5,0,34,29
1657113843017,MATH 193A,A03,083781,Rotar; Vladimir,1,0,34,33
1657113843017,MATH 193A,A04,083782,Rotar; Vladimir,6,0,34,28
1657113843017,MATH 193A,A05,093482,Rotar; Vladimir,6,0,34,28
1657113849050,MATH 197,001,091859,McAuley; Julian John,9999,0,9999,0
1657113849050,MATH 197,002,095566,Kedlaya; Kiran S.,9997,0,9999,2
1657113849050,MATH 197,003,095567,Xiao; Ming,9999,0,9999,0
1657113849050,MATH 197,004,095571,Perols; Johan Lars,9998,0,9999,1
1657113856135,COGS 9,A01,083615,Shannon; Kyle Michael,7,0,75,68
1657113862167,COGS 11,A01,083617,Boyle; Mary E. T.,21,0,48,27
1657113868201,COGS 13,A01,083071,Bastos; Amalia Pinkusfeld,9,0,71,62
1657113874227,COGS 14A,A01,092681,Semenuks; Arturs,1,1,100,99
1657113880328,COGS 14B,A01,083073,Cheng; Tzu-Han,6,0,63,57
1657113886357,COGS 17,A01,092677,Semenuks; Arturs,4,0,81,77
1657113892400,COGS 100,A01,083619,Allen; Michael Gordon,15,0,70,55
1657113898434,COGS 101A,A01,083621,Davis; Joshua Daniel,9,0,68,59
1657113904462,COGS 101B,A01,091572,Allen; Michael Gordon,8,0,65,57
1657113910488,COGS 101C,A01,083625,Delgado; Tania,17,0,35,18
1657113916517,COGS 107A,A01,083627,Boyle; Mary E. T.,13,0,60,47
1657113922552,COGS 118A,A01,083075,Gupta; Anjum,15,0,76,61
1657113928578,CSE 3,A50,083646,Miranda; Gregory Joseph,22,0,50,28
1657113934601,CSE 8A,A50,083650,Miranda; Gregory Joseph,17,1,56,39
1657113940631,CSE 11,A01,083080,Cao; Yingjun,4,15,40,36
1657113946657,CSE 12,A01,083652,Krause-Levy; Sophia Louisa,23,1,120,97
1657113952685,CSE 15L,A01,083654,Morris; Justin Loren,9,0,50,41
1657113952685,CSE 15L,A02,083655,Morris; Justin Loren,9,0,50,41
1657113958714,CSE 20,A01,083657,Tran; Khoa Dang,37,0,80,43
1657113964741,CSE 21,A01,095574,Bach; Quang Tran,21,0,48,27
1657113970767,CSE 30,A01,083084,Eldon; John,4,0,80,76
1657113970767,CSE 30,B01,095061,Bhaskar; Nishant,6,0,50,44
1657113976793,CSE 100,A01,083659,Cao; Yingjun,4,4,70,66
1657113982824,CSE 134B,A01,083661,Powell; Thomas Allan,19,0,100,81
1657113988848,CSE 140,A01,083663,Gungor; Onat,14,0,85,71
1657113994877,CSE 140L,A01,083088,Eldon; John,17,0,100,83
1657114000902,CSE 175,A01,083665,Kumar; Rakesh,3,0,25,22
1657114006927,CSE 190,A00,092507,Dubnov; Shlomo,7,0,20,13
1657114012953,ECE 45,A01,083139,Congero; Spencer William,5,0,75,70
1657114018980,ECE 65,A50,083695,Saad; Andrew S,12,0,30,18
1657114018980,ECE 65,A51,095125,Saad; Andrew S,25,0,26,1
1657114025004,ECE 109,A01,091882,Touri; Behrouz,16,0,70,54
1657114031030,ECE 180,A00,083140,Abi Samra; Nicholas Camill,1,0,30,29
1657114031030,ECE 180,B00,083141,Abi Samra; Nicholas Camill,0,0,30,30
1657114037063,MATH 10A,A01,083735,Patchell; Gregory David,1,0,30,29
1657114037063,MATH 10A,A02,083736,Patchell; Gregory David,20,0,30,10
1657114037063,MATH 10A,A03,083737,Patchell; Gregory David,16,0,30,14
1657114043095,MATH 10B,A01,083207,Lim; Seonhee,7,0,34,27
1657114043095,MATH 10B,A02,083208,Lim; Seonhee,9,0,35,26
1657114043095,MATH 10B,A03,093472,Lim; Seonhee,5,0,34,29
1657114043095,MATH 10B,B01,083739,Sinha; Shubham,9,0,30,21
1657114049140,MATH 18,A01,083743,Cinel; Cameron Alexander,6,0,30,24
1657114049140,MATH 18,A02,083744,Cinel; Cameron Alexander,15,0,30,15
1657114049140,MATH 18,A03,083745,Cinel; Cameron Alexander,8,0,30,22
1657114049140,MATH 18,B01,083748,Rideout; David Porter,4,0,37,33
1657114049140,MATH 18,B02,083749,Rideout; David Porter,3,0,36,33
1657114049140,MATH 18,B03,083750,Rideout; David Porter,2,0,37,35
1657114049140,MATH 18,B04,083751,Rideout; David Porter,5,0,36,31
1657114049140,MATH 18,B05,093473,Rideout; David Porter,4,0,36,32
1657114049140,MATH 18,B06,093474,Rideout; David Porter,5,0,36,31
1657114055169,MATH 20A,A01,083754,Zheng; Zequn,12,0,40,28
1657114061203,MATH 20B,A01,083756,Briones; Jor-el Thomas Caparas,1,0,36,35
1657114061203,MATH 20B,A02,083757,Briones; Jor-el Thomas Caparas,1,0,36,35
1657114061203,MATH 20B,A03,093475,Briones; Jor-el Thomas Caparas,0,0,36,36
1657114067229,MATH 20C,A01,083760,Briones; Jor-el Thomas Caparas,1,0,35,34
1657114067229,MATH 20C,A02,083761,Briones; Jor-el Thomas Caparas,8,0,35,27
1657114067229,MATH 20C,A03,093476,Briones; Jor-el Thomas Caparas,0,1,36,36
1657114067229,MATH 20C,B01,083762,Bach; Quang Tran,0,0,30,30
1657114073254,MATH 20D,A01,083765,Tran; Brian Kha,4,0,30,26
1657114073254,MATH 20D,A02,083766,Tran; Brian Kha,5,0,30,25
1657114073254,MATH 20D,A03,083767,Tran; Brian Kha,3,0,30,27
1657114079280,MATH 20E,A01,083771,Ganguly; Soumya,6,0,32,26
1657114079280,MATH 20E,A02,083772,Ganguly; Soumya,6,0,32,26
1657114079280,MATH 20E,B01,083773,Ciotti; Benjamin,18,0,35,17
1657114079280,MATH 20E,B02,083774,Ciotti; Benjamin,17,0,35,18
1657114085315,MATH 103A,A01,083777,Greenfeld; Be'Eri,2,0,36,34
1657114085315,MATH 103A,A02,083778,Greenfeld; Be'Eri,5,0,36,31
1657114085315,MATH 103A,A03,093561,Greenfeld; Be'Eri,4,0,36,32
1657114085315,MATH 103A,B01,083779,Greenfeld; Be'Eri,6,0,36,30
1657114085315,MATH 103A,B02,083780,Greenfeld; Be'Eri,2,0,36,34
1657114085315,MATH 103A,B03,093562,Greenfeld; Be'Eri,3,0,36,33
1657114091339,MATH 105,A01,085443,Carter; Anne Toulson,14,0,35,21
1657114091339,MATH 105,A02,093477,Carter; Anne Toulson,20,0,35,15
1657114097374,MATH 109,A01,083213,Ganzberger; Geoffrey Michael,2,0,34,32
1657114097374,MATH 109,A02,083214,Ganzberger; Geoffrey Michael,3,0,34,31
1657114097374,MATH 109,A03,093478,Ganzberger; Geoffrey Michael,1,0,34,33
1657114097374,MATH 109,B01,083215,Ganzberger; Geoffrey Michael,1,0,32,31
1657114097374,MATH 109,B02,083216,Ganzberger; Geoffrey Michael,1,0,32,31
1657114097374,MATH 109,B03,093479,Ganzberger; Geoffrey Michael,6,0,32,26
1657114103400,MATH 142A,A01,083219,Chow; Bennett,6,0,32,26
1657114103400,MATH 142A,A02,083220,Chow; Bennett,10,0,32,22
1657114103400,MATH 142A,A03,093480,Chow; Bennett,7,0,32,25
1657114103400,MATH 142A,B03,093481,Chow; Bennett,8,0,32,24
1657114103400,MATH 142A,B04,093558,Chow; Bennett,11,0,32,21
1657114103400,MATH 142A,B05,093559,Chow; Bennett,6,0,32,26
1657114109432,MATH 193A,A01,083224,Rotar; Vladimir,7,0,34,27
1657114109432,MATH 193A,A02,083225,Rotar; Vladimir,5,0,34,29
1657114109432,MATH 193A,A03,083781,Rotar; Vladimir,1,0,34,33
1657114109432,MATH 193A,A04,083782,Rotar; Vladimir,6,0,34,28
1657114109432,MATH 193A,A05,093482,Rotar; Vladimir,6,0,34,28
1657114115460,MATH 197,001,091859,McAuley; Julian John,9999,0,9999,0
1657114115460,MATH 197,002,095566,Kedlaya; Kiran S.,9997,0,9999,2
1657114115460,MATH 197,003,095567,Xiao; Ming,9999,0,9999,0
1657114115460,MATH 197,004,095571,Perols; Johan Lars,9998,0,9999,1
1657114122543,COGS 9,A01,083615,Shannon; Kyle Michael,7,0,75,68
1657114128567,COGS 11,A01,083617,Boyle; Mary E. T.,21,0,48,27
1657114134593,COGS 13,A01,083071,Bastos; Amalia Pinkusfeld,9,0,71,62
1657114140620,COGS 14A,A01,092681,Semenuks; Arturs,1,1,100,99
1657114146647,COGS 14B,A01,083073,Cheng; Tzu-Han,6,0,63,57
1657114152675,COGS 17,A01,092677,Semenuks; Arturs,4,0,81,77
1657114158701,COGS 100,A01,083619,Allen; Michael Gordon,15,0,70,55
1657114164733,COGS 101A,A01,083621,Davis; Joshua Daniel,9,0,68,59
1657114170757,COGS 101B,A01,091572,Allen; Michael Gordon,8,0,65,57
1657114176787,COGS 101C,A01,083625,Delgado; Tania,17,0,35,18
1657114182812,COGS 107A,A01,083627,Boyle; Mary E. T.,13,0,60,47
1657114188841,COGS 118A,A01,083075,Gupta; Anjum,15,0,76,61
1657114194867,CSE 3,A50,083646,Miranda; Gregory Joseph,22,0,50,28
1657114200896,CSE 8A,A50,083650,Miranda; Gregory Joseph,17,1,56,39
1657114206926,CSE 11,A01,083080,Cao; Yingjun,4,15,40,36
1657114212958,CSE 12,A01,083652,Krause-Levy; Sophia Louisa,23,1,120,97
1657114218987,CSE 15L,A01,083654,Morris; Justin Loren,9,0,50,41
1657114218987,CSE 15L,A02,083655,Morris; Justin Loren,9,0,50,41
1657114225015,CSE 20,A01,083657,Tran; Khoa Dang,37,0,80,43
1657114231040,CSE 21,A01,095574,Bach; Quang Tran,21,0,48,27
1657114237066,CSE 30,A01,083084,Eldon; John,4,0,80,76
1657114237066,CSE 30,B01,095061,Bhaskar; Nishant,6,0,50,44
1657114243092,CSE 100,A01,083659,Cao; Yingjun,4,4,70,66
1657114249120,CSE 134B,A01,083661,Powell; Thomas Allan,19,0,100,81
1657114255145,CSE 140,A01,083663,Gungor; Onat,14,0,85,71
1657114261173,CSE 140L,A01,083088,Eldon; John,17,0,100,83
1657114267195,CSE 175,A01,083665,Kumar; Rakesh,3,0,25,22
1657114273219,CSE 190,A00,092507,Dubnov; Shlomo,7,0,20,13
1657114279250,ECE 45,A01,083139,Congero; Spencer William,5,0,75,70
1657114285291,ECE 65,A50,083695,Saad; Andrew S,12,0,30,18
1657114285291,ECE 65,A51,095125,Saad; Andrew S,25,0,26,1
1657114291317,ECE 109,A01,091882,Touri; Behrouz,16,0,70,54
1657114297347,ECE 180,A00,083140,Abi Samra; Nicholas Camill,1,0,30,29
1657114297347,ECE 180,B00,083141,Abi Samra; Nicholas Camill,0,0,30,30
1657114303371,MATH 10A,A01,083735,Patchell; Gregory David,1,0,30,29
1657114303371,MATH 10A,A02,083736,Patchell; Gregory David,20,0,30,10
1657114303371,MATH 10A,A03,083737,Patchell; Gregory David,16,0,30,14
1657114309399,MATH 10B,A01,083207,Lim; Seonhee,7,0,34,27
1657114309399,MATH 10B,A02,083208,Lim; Seonhee,9,0,35,26
1657114309399,MATH 10B,A03,093472,Lim; Seonhee,5,0,34,29
1657114309399,MATH 10B,B01,083739,Sinha; Shubham,9,0,30,21
1657114315436,MATH 18,A01,083743,Cinel; Cameron Alexander,6,0,30,24
1657114315436,MATH 18,A02,083744,Cinel; Cameron Alexander,15,0,30,15
1657114315436,MATH 18,A03,083745,Cinel; Cameron Alexander,8,0,30,22
1657114315436,MATH 18,B01,083748,Rideout; David Porter,4,0,37,33
1657114315436,MATH 18,B02,083749,Rideout; David Porter,3,0,36,33
1657114315436,MATH 18,B03,083750,Rideout; David Porter,2,0,37,35
1657114315436,MATH 18,B04,083751,Rideout; David Porter,5,0,36,31
1657114315436,MATH 18,B05,093473,Rideout; David Porter,4,0,36,32
1657114315436,MATH 18,B06,093474,Rideout; David Porter,5,0,36,31
1657114321462,MATH 20A,A01,083754,Zheng; Zequn,12,0,40,28
1657114327489,MATH 20B,A01,083756,Briones; Jor-el Thomas Caparas,1,0,36,35
1657114327489,MATH 20B,A02,083757,Briones; Jor-el Thomas Caparas,1,0,36,35
1657114327489,MATH 20B,A03,093475,Briones; Jor-el Thomas Caparas,0,0,36,36
1657114333522,MATH 20C,A01,083760,Briones; Jor-el Thomas Caparas,1,0,35,34
1657114333522,MATH 20C,A02,083761,Briones; Jor-el Thomas Caparas,8,0,35,27
1657114333522,MATH 20C,A03,093476,Briones; Jor-el Thomas Caparas,0,1,36,36
1657114333522,MATH 20C,B01,083762,Bach; Quang Tran,0,0,30,30
1657114339551,MATH 20D,A01,083765,Tran; Brian Kha,4,0,30,26
1657114339551,MATH 20D,A02,083766,Tran; Brian Kha,5,0,30,25
1657114339551,MATH 20D,A03,083767,Tran; Brian Kha,3,0,30,27
1657114345578,MATH 20E,A01,083771,Ganguly; Soumya,6,0,32,26
1657114345578,MATH 20E,A02,083772,Ganguly; Soumya,6,0,32,26
1657114345578,MATH 20E,B01,083773,Ciotti; Benjamin,18,0,35,17
1657114345578,MATH 20E,B02,083774,Ciotti; Benjamin,17,0,35,18
1657114351609,MATH 103A,A01,083777,Greenfeld; Be'Eri,2,0,36,34
1657114351609,MATH 103A,A02,083778,Greenfeld; Be'Eri,5,0,36,31
1657114351609,MATH 103A,A03,093561,Greenfeld; Be'Eri,4,0,36,32
1657114351609,MATH 103A,B01,083779,Greenfeld; Be'Eri,6,0,36,30
1657114351609,MATH 103A,B02,083780,Greenfeld; Be'Eri,2,0,36,34
1657114351609,MATH 103A,B03,093562,Greenfeld; Be'Eri,3,0,36,33
1657114357637,MATH 105,A01,085443,Carter; Anne Toulson,14,0,35,21
1657114357637,MATH 105,A02,093477,Carter; Anne Toulson,20,0,35,15
1657114363661,MATH 109,A01,083213,Ganzberger; Geoffrey Michael,2,0,34,32
1657114363661,MATH 109,A02,083214,Ganzberger; Geoffrey Michael,3,0,34,31
1657114363661,MATH 109,A03,093478,Ganzberger; Geoffrey Michael,1,0,34,33
1657114363661,MATH 109,B01,083215,Ganzberger; Geoffrey Michael,1,0,32,31
1657114363661,MATH 109,B02,083216,Ganzberger; Geoffrey Michael,1,0,32,31
1657114363661,MATH 109,B03,093479,Ganzberger; Geoffrey Michael,6,0,32,26
1657114369688,MATH 142A,A01,083219,Chow; Bennett,6,0,32,26
1657114369688,MATH 142A,A02,083220,Chow; Bennett,10,0,32,22
1657114369688,MATH 142A,A03,093480,Chow; Bennett,7,0,32,25
1657114369688,MATH 142A,B03,093481,Chow; Bennett,8,0,32,24
1657114369688,MATH 142A,B04,093558,Chow; Bennett,11,0,32,21
1657114369688,MATH 142A,B05,093559,Chow; Bennett,6,0,32,26
1657114375715,MATH 193A,A01,083224,Rotar; Vladimir,7,0,34,27
1657114375715,MATH 193A,A02,083225,Rotar; Vladimir,5,0,34,29
1657114375715,MATH 193A,A03,083781,Rotar; Vladimir,1,0,34,33
1657114375715,MATH 193A,A04,083782,Rotar; Vladimir,6,0,34,28
1657114375715,MATH 193A,A05,093482,Rotar; Vladimir,6,0,34,28
1657114381757,MATH 197,001,091859,McAuley; Julian John,9999,0,9999,0
1657114381757,MATH 197,002,095566,Kedlaya; Kiran S.,9997,0,9999,2
1657114381757,MATH 197,003,095567,Xiao; Ming,9999,0,9999,0
1657114381757,MATH 197,004,095571,Perols; Johan Lars,9998,0,9999,1
1657114388816,COGS 9,A01,083615,Shannon; Kyle Michael,7,0,75,68
1657114394842,COGS 11,A01,083617,Boyle; Mary E. T.,21,0,48,27
1657114400872,COGS 13,A01,083071,Bastos; Amalia Pinkusfeld,9,0,71,62
1657114406897,COGS 14A,A01,092681,Semenuks; Arturs,1,1,100,99
1657114412925,COGS 14B,A01,083073,Cheng; Tzu-Han,6,0,63,57
1657114418950,COGS 17,A01,092677,Semenuks; Arturs,4,0,81,77
1657114424979,COGS 100,A01,083619,Allen; Michael Gordon,15,0,70,55
1657114431007,COGS 101A,A01,083621,Davis; Joshua Daniel,9,0,68,59
1657114437036,COGS 101B,A01,091572,Allen; Michael Gordon,8,0,65,57
1657114443062,COGS 101C,A01,083625,Delgado; Tania,17,0,35,18
1657114449086,COGS 107A,A01,083627,Boyle; Mary E. T.,13,0,60,47
1657114455111,COGS 118A,A01,083075,Gupta; Anjum,15,0,76,61
1657114461144,CSE 3,A50,083646,Miranda; Gregory Joseph,22,0,50,28
1657114467179,CSE 8A,A50,083650,Miranda; Gregory Joseph,17,1,56,39
1657114473204,CSE 11,A01,083080,Cao; Yingjun,4,15,40,36
1657114479307,CSE 12,A01,083652,Krause-Levy; Sophia Louisa,23,1,120,97
1657114485332,CSE 15L,A01,083654,Morris; Justin Loren,9,0,50,41
1657114485332,CSE 15L,A02,083655,Morris; Justin Loren,9,0,50,41
1657114491358,CSE 20,A01,083657,Tran; Khoa Dang,37,0,80,43
1657114497387,CSE 21,A01,095574,Bach; Quang Tran,21,0,48,27
1657114503411,CSE 30,A01,083084,Eldon; John,4,0,80,76
1657114503411,CSE 30,B01,095061,Bhaskar; Nishant,6,0,50,44
1657114509440,CSE 100,A01,083659,Cao; Yingjun,4,4,70,66
1657114515466,CSE 134B,A01,083661,Powell; Thomas Allan,19,0,100,81
1657114521490,CSE 140,A01,083663,Gungor; Onat,14,0,85,71
1657114527520,CSE 140L,A01,083088,Eldon; John,17,0,100,83
1657114533546,CSE 175,A01,083665,Kumar; Rakesh,3,0,25,22
1657114539572,CSE 190,A00,092507,Dubnov; Shlomo,7,0,20,13
1657114545598,ECE 45,A01,083139,Congero; Spencer William,5,0,75,70
1657114551624,ECE 65,A50,083695,Saad; Andrew S,12,0,30,18
1657114551624,ECE 65,A51,095125,Saad; Andrew S,25,0,26,1
1657114557651,ECE 109,A01,091882,Touri; Behrouz,16,0,70,54
1657114563675,ECE 180,A00,083140,Abi Samra; Nicholas Camill,1,0,30,29
1657114563675,ECE 180,B00,083141,Abi Samra; Nicholas Camill,0,0,30,30
1657114569706,MATH 10A,A01,083735,Patchell; Gregory David,1,0,30,29
1657114569706,MATH 10A,A02,083736,Patchell; Gregory David,20,0,30,10
1657114569706,MATH 10A,A03,083737,Patchell; Gregory David,16,0,30,14
1657114575740,MATH 10B,A01,083207,Lim; Seonhee,7,0,34,27
1657114575740,MATH 10B,A02,083208,Lim; Seonhee,9,0,35,26
1657114575740,MATH 10B,A03,093472,Lim; Seonhee,5,0,34,29
1657114575740,MATH 10B,B01,083739,Sinha; Shubham,9,0,30,21
1657114581771,MATH 18,A01,083743,Cinel; Cameron Alexander,6,0,30,24
1657114581771,MATH 18,A02,083744,Cinel; Cameron Alexander,15,0,30,15
1657114581771,MATH 18,A03,083745,Cinel; Cameron Alexander,8,0,30,22
1657114581771,MATH 18,B01,083748,Rideout; David Porter,4,0,37,33
1657114581771,MATH 18,B02,083749,Rideout; David Porter,3,0,36,33
1657114581771,MATH 18,B03,083750,Rideout; David Porter,2,0,37,35
1657114581771,MATH 18,B04,083751,Rideout; David Porter,5,0,36,31
1657114581771,MATH 18,B05,093473,Rideout; David Porter,4,0,36,32
1657114581771,MATH 18,B06,093474,Rideout; David Porter,5,0,36,31
1657114587800,MATH 20A,A01,083754,Zheng; Zequn,12,0,40,28
1657114593827,MATH 20B,A01,083756,Briones; Jor-el Thomas Caparas,1,0,36,35
1657114593827,MATH 20B,A02,083757,Briones; Jor-el Thomas Caparas,1,0,36,35
1657114593827,MATH 20B,A03,093475,Briones; Jor-el Thomas Caparas,0,0,36,36
1657114599852,MATH 20C,A01,083760,Briones; Jor-el Thomas Caparas,1,0,35,34
1657114599852,MATH 20C,A02,083761,Briones; Jor-el Thomas Caparas,8,0,35,27
1657114599852,MATH 20C,A03,093476,Briones; Jor-el Thomas Caparas,0,1,36,36
1657114599852,MATH 20C,B01,083762,Bach; Quang Tran,0,0,30,30
1657114605878,MATH 20D,A01,083765,Tran; Brian Kha,4,0,30,26
1657114605878,MATH 20D,A02,083766,Tran; Brian Kha,5,0,30,25
1657114605878,MATH 20D,A03,083767,Tran; Brian Kha,3,0,30,27
1657114611911,MATH 20E,A01,083771,Ganguly; Soumya,6,0,32,26
1657114611911,MATH 20E,A02,083772,Ganguly; Soumya,6,0,32,26
1657114611911,MATH 20E,B01,083773,Ciotti; Benjamin,18,0,35,17
1657114611911,MATH 20E,B02,083774,Ciotti; Benjamin,17,0,35,18
1657114617937,MATH 103A,A01,083777,Greenfeld; Be'Eri,2,0,36,34
1657114617937,MATH 103A,A02,083778,Greenfeld; Be'Eri,5,0,36,31
1657114617937,MATH 103A,A03,093561,Greenfeld; Be'Eri,4,0,36,32
1657114617937,MATH 103A,B01,083779,Greenfeld; Be'Eri,6,0,36,30
1657114617937,MATH 103A,B02,083780,Greenfeld; Be'Eri,2,0,36,34
1657114617937,MATH 103A,B03,093562,Greenfeld; Be'Eri,3,0,36,33
1657114623968,MATH 105,A01,085443,Carter; Anne Toulson,14,0,35,21
1657114623968,MATH 105,A02,093477,Carter; Anne Toulson,20,0,35,15
1657114629994,MATH 109,A01,083213,Ganzberger; Geoffrey Michael,2,0,34,32
1657114629994,MATH 109,A02,083214,Ganzberger; Geoffrey Michael,3,0,34,31
1657114629994,MATH 109,A03,093478,Ganzberger; Geoffrey Michael,1,0,34,33
1657114629994,MATH 109,B01,083215,Ganzberger; Geoffrey Michael,1,0,32,31
1657114629994,MATH 109,B02,083216,Ganzberger; Geoffrey Michael,1,0,32,31
1657114629994,MATH 109,B03,093479,Ganzberger; Geoffrey Michael,6,0,32,26
1657114636018,MATH 142A,A01,083219,Chow; Bennett,6,0,32,26
1657114636018,MATH 142A,A02,083220,Chow; Bennett,10,0,32,22
1657114636018,MATH 142A,A03,093480,Chow; Bennett,7,0,32,25
1657114636018,MATH 142A,B03,093481,Chow; Bennett,8,0,32,24
1657114636018,MATH 142A,B04,093558,Chow; Bennett,11,0,32,21
1657114636018,MATH 142A,B05,093559,Chow; Bennett,6,0,32,26
1657114642043,MATH 193A,A01,083224,Rotar; Vladimir,7,0,34,27
1657114642043,MATH 193A,A02,083225,Rotar; Vladimir,5,0,34,29
1657114642043,MATH 193A,A03,083781,Rotar; Vladimir,1,0,34,33
1657114642043,MATH 193A,A04,083782,Rotar; Vladimir,6,0,34,28
1657114642043,MATH 193A,A05,093482,Rotar; Vladimir,6,0,34,28
1657114648069,MATH 197,001,091859,McAuley; Julian John,9999,0,9999,0
1657114648069,MATH 197,002,095566,Kedlaya; Kiran S.,9997,0,9999,2
1657114648069,MATH 197,003,095567,Xiao; Ming,9999,0,9999,0
1657114648069,MATH 197,004,095571,Perols; Johan Lars,9998,0,9999,1
1657114655144,COGS 9,A01,083615,Shannon; Kyle Michael,7,0,75,68
1657114661174,COGS 11,A01,083617,Boyle; Mary E. T.,21,0,48,27
1657114667210,COGS 13,A01,083071,Bastos; Amalia Pinkusfeld,9,0,71,62
1657114673235,COGS 14A,A01,092681,Semenuks; Arturs,1,1,100,99
1657114679261,COGS 14B,A01,083073,Cheng; Tzu-Han,6,0,63,57
1657114685287,COGS 17,A01,092677,Semenuks; Arturs,4,0,81,77
1657114691314,COGS 100,A01,083619,Allen; Michael Gordon,15,0,70,55
1657114697341,COGS 101A,A01,083621,Davis; Joshua Daniel,9,0,68,59
1657114703369,COGS 101B,A01,091572,Allen; Michael Gordon,8,0,65,57
1657114709406,COGS 101C,A01,083625,Delgado; Tania,17,0,35,18
1657114715429,COGS 107A,A01,083627,Boyle; Mary E. T.,13,0,60,47
1657114721455,COGS 118A,A01,083075,Gupta; Anjum,15,0,76,61
1657114727479,CSE 3,A50,083646,Miranda; Gregory Joseph,22,0,50,28
1657114733503,CSE 8A,A50,083650,Miranda; Gregory Joseph,17,1,56,39
1657114739527,CSE 11,A01,083080,Cao; Yingjun,4,15,40,36
1657114745558,CSE 12,A01,083652,Krause-Levy; Sophia Louisa,23,1,120,97
1657114751589,CSE 15L,A01,083654,Morris; Justin Loren,9,0,50,41
1657114751589,CSE 15L,A02,083655,Morris; Justin Loren,9,0,50,41
1657114757612,CSE 20,A01,083657,Tran; Khoa Dang,37,0,80,43
1657114763640,CSE 21,A01,095574,Bach; Quang Tran,21,0,48,27
1657114769669,CSE 30,A01,083084,Eldon; John,4,0,80,76
1657114769669,CSE 30,B01,095061,Bhaskar; Nishant,6,0,50,44
1657114775702,CSE 100,A01,083659,Cao; Yingjun,4,4,70,66
1657114781728,CSE 134B,A01,083661,Powell; Thomas Allan,19,0,100,81
1657114787754,CSE 140,A01,083663,Gungor; Onat,14,0,85,71
1657114793781,CSE 140L,A01,083088,Eldon; John,17,0,100,83
1657114799809,CSE 175,A01,083665,Kumar; Rakesh,3,0,25,22
1657114805833,CSE 190,A00,092507,Dubnov; Shlomo,7,0,20,13
1657114811861,ECE 45,A01,083139,Congero; Spencer William,5,0,75,70
1657114817887,ECE 65,A50,083695,Saad; Andrew S,12,0,30,18
1657114817887,ECE 65,A51,095125,Saad; Andrew S,25,0,26,1
1657114823915,ECE 109,A01,091882,Touri; Behrouz,16,0,70,54
1657114829943,ECE 180,A00,083140,Abi Samra; Nicholas Camill,1,0,30,29
1657114829943,ECE 180,B00,083141,Abi Samra; Nicholas Camill,0,0,30,30
1657114835987,MATH 10A,A01,083735,Patchell; Gregory David,1,0,30,29
1657114835987,MATH 10A,A02,083736,Patchell; Gregory David,20,0,30,10
1657114835987,MATH 10A,A03,083737,Patchell; Gregory David,16,0,30,14
1657114842020,MATH 10B,A01,083207,Lim; Seonhee,7,0,34,27
1657114842020,MATH 10B,A02,083208,Lim; Seonhee,9,0,35,26
1657114842020,MATH 10B,A03,093472,Lim; Seonhee,5,0,34,29
1657114842020,MATH 10B,B01,083739,Sinha; Shubham,9,0,30,21
1657114848047,MATH 18,A01,083743,Cinel; Cameron Alexander,6,0,30,24
1657114848047,MATH 18,A02,083744,Cinel; Cameron Alexander,15,0,30,15
1657114848047,MATH 18,A03,083745,Cinel; Cameron Alexander,8,0,30,22
1657114848047,MATH 18,B01,083748,Rideout; David Porter,4,0,37,33
1657114848047,MATH 18,B02,083749,Rideout; David Porter,3,0,36,33
1657114848047,MATH 18,B03,083750,Rideout; David Porter,2,0,37,35
1657114848047,MATH 18,B04,083751,Rideout; David Porter,5,0,36,31
1657114848047,MATH 18,B05,093473,Rideout; David Porter,4,0,36,32
1657114848047,MATH 18,B06,093474,Rideout; David Porter,5,0,36,31
1657114854077,MATH 20A,A01,083754,Zheng; Zequn,12,0,40,28
1657114860106,MATH 20B,A01,083756,Briones; Jor-el Thomas Caparas,1,0,36,35
1657114860106,MATH 20B,A02,083757,Briones; Jor-el Thomas Caparas,1,0,36,35
1657114860106,MATH 20B,A03,093475,Briones; Jor-el Thomas Caparas,0,0,36,36
1657114866137,MATH 20C,A01,083760,Briones; Jor-el Thomas Caparas,1,0,35,34
1657114866137,MATH 20C,A02,083761,Briones; Jor-el Thomas Caparas,8,0,35,27
1657114866137,MATH 20C,A03,093476,Briones; Jor-el Thomas Caparas,0,1,36,36
1657114866137,MATH 20C,B01,083762,Bach; Quang Tran,0,0,30,30
1657114872166,MATH 20D,A01,083765,Tran; Brian Kha,4,0,30,26
1657114872166,MATH 20D,A02,083766,Tran; Brian Kha,5,0,30,25
1657114872166,MATH 20D,A03,083767,Tran; Brian Kha,3,0,30,27
1657114878192,MATH 20E,A01,083771,Ganguly; Soumya,6,0,32,26
1657114878192,MATH 20E,A02,083772,Ganguly; Soumya,6,0,32,26
1657114878192,MATH 20E,B01,083773,Ciotti; Benjamin,18,0,35,17
1657114878192,MATH 20E,B02,083774,Ciotti; Benjamin,17,0,35,18
1657114884216,MATH 103A,A01,083777,Greenfeld; Be'Eri,2,0,36,34
1657114884216,MATH 103A,A02,083778,Greenfeld; Be'Eri,5,0,36,31
1657114884216,MATH 103A,A03,093561,Greenfeld; Be'Eri,4,0,36,32
1657114884216,MATH 103A,B01,083779,Greenfeld; Be'Eri,6,0,36,30
1657114884216,MATH 103A,B02,083780,Greenfeld; Be'Eri,2,0,36,34
1657114884216,MATH 103A,B03,093562,Greenfeld; Be'Eri,3,0,36,33
1657114890241,MATH 105,A01,085443,Carter; Anne Toulson,14,0,35,21
1657114890241,MATH 105,A02,093477,Carter; Anne Toulson,20,0,35,15
1657114896268,MATH 109,A01,083213,Ganzberger; Geoffrey Michael,2,0,34,32
1657114896268,MATH 109,A02,083214,Ganzberger; Geoffrey Michael,3,0,34,31
1657114896268,MATH 109,A03,093478,Ganzberger; Geoffrey Michael,1,0,34,33
1657114896268,MATH 109,B01,083215,Ganzberger; Geoffrey Michael,1,0,32,31
1657114896268,MATH 109,B02,083216,Ganzberger; Geoffrey Michael,1,0,32,31
1657114896268,MATH 109,B03,093479,Ganzberger; Geoffrey Michael,6,0,32,26
1657114902298,MATH 142A,A01,083219,Chow; Bennett,6,0,32,26
1657114902298,MATH 142A,A02,083220,Chow; Bennett,10,0,32,22
1657114902298,MATH 142A,A03,093480,Chow; Bennett,7,0,32,25
1657114902298,MATH 142A,B03,093481,Chow; Bennett,8,0,32,24
1657114902298,MATH 142A,B04,093558,Chow; Bennett,11,0,32,21
1657114902298,MATH 142A,B05,093559,Chow; Bennett,6,0,32,26
1657114908328,MATH 193A,A01,083224,Rotar; Vladimir,7,0,34,27
1657114908328,MATH 193A,A02,083225,Rotar; Vladimir,5,0,34,29
1657114908328,MATH 193A,A03,083781,Rotar; Vladimir,1,0,34,33
1657114908328,MATH 193A,A04,083782,Rotar; Vladimir,6,0,34,28
1657114908328,MATH 193A,A05,093482,Rotar; Vladimir,6,0,34,28
1657114914353,MATH 197,001,091859,McAuley; Julian John,9999,0,9999,0
1657114914353,MATH 197,002,095566,Kedlaya; Kiran S.,9997,0,9999,2
1657114914353,MATH 197,003,095567,Xiao; Ming,9999,0,9999,0
1657114914353,MATH 197,004,095571,Perols; Johan Lars,9998,0,9999,1
1657114921429,COGS 9,A01,083615,Shannon; Kyle Michael,7,0,75,68
1657114927457,COGS 11,A01,083617,Boyle; Mary E. T.,21,0,48,27
1657114933481,COGS 13,A01,083071,Bastos; Amalia Pinkusfeld,9,0,71,62
1657114939510,COGS 14A,A01,092681,Semenuks; Arturs,1,1,100,99
1657114945536,COGS 14B,A01,083073,Cheng; Tzu-Han,6,0,63,57
1657114951563,COGS 17,A01,092677,Semenuks; Arturs,4,0,81,77
1657114957591,COGS 100,A01,083619,Allen; Michael Gordon,15,0,70,55
1657114963615,COGS 101A,A01,083621,Davis; Joshua Daniel,9,0,68,59
1657114969642,COGS 101B,A01,091572,Allen; Michael Gordon,8,0,65,57
1657114975667,COGS 101C,A01,083625,Delgado; Tania,17,0,35,18
1657114981699,COGS 107A,A01,083627,Boyle; Mary E. T.,13,0,60,47
1657114987722,COGS 118A,A01,083075,Gupta; Anjum,15,0,76,61
1657114993753,CSE 3,A50,083646,Miranda; Gregory Joseph,22,0,50,28
1657114999780,CSE 8A,A50,083650,Miranda; Gregory Joseph,17,1,56,39
1657115005803,CSE 11,A01,083080,Cao; Yingjun,4,15,40,36
1657115011829,CSE 12,A01,083652,Krause-Levy; Sophia Louisa,23,1,120,97
1657115017855,CSE 15L,A01,083654,Morris; Justin Loren,9,0,50,41
1657115017855,CSE 15L,A02,083655,Morris; Justin Loren,9,0,50,41
1657115023883,CSE 20,A01,083657,Tran; Khoa Dang,37,0,80,43
1657115029911,CSE 21,A01,095574,Bach; Quang Tran,21,0,48,27
1657115035938,CSE 30,A01,083084,Eldon; John,4,0,80,76
1657115035938,CSE 30,B01,095061,Bhaskar; Nishant,6,0,50,44
1657115041965,CSE 100,A01,083659,Cao; Yingjun,4,4,70,66
1657115047988,CSE 134B,A01,083661,Powell; Thomas Allan,19,0,100,81
1657115054017,CSE 140,A01,083663,Gungor; Onat,14,0,85,71
1657115060041,CSE 140L,A01,083088,Eldon; John,17,0,100,83
1657115066068,CSE 175,A01,083665,Kumar; Rakesh,3,0,25,22
1657115072092,CSE 190,A00,092507,Dubnov; Shlomo,7,0,20,13
1657115078211,ECE 45,A01,083139,Congero; Spencer William,5,0,75,70
1657115084241,ECE 65,A50,083695,Saad; Andrew S,12,0,30,18
1657115084241,ECE 65,A51,095125,Saad; Andrew S,25,0,26,1
1657115090269,ECE 109,A01,091882,Touri; Behrouz,16,0,70,54
1657115096292,ECE 180,A00,083140,Abi Samra; Nicholas Camill,1,0,30,29
1657115096292,ECE 180,B00,083141,Abi Samra; Nicholas Camill,0,0,30,30
1657115102317,MATH 10A,A01,083735,Patchell; Gregory David,1,0,30,29
1657115102317,MATH 10A,A02,083736,Patchell; Gregory David,20,0,30,10
1657115102317,MATH 10A,A03,083737,Patchell; Gregory David,16,0,30,14
1657115108340,MATH 10B,A01,083207,Lim; Seonhee,7,0,34,27
1657115108340,MATH 10B,A02,083208,Lim; Seonhee,9,0,35,26
1657115108340,MATH 10B,A03,093472,Lim; Seonhee,5,0,34,29
1657115108340,MATH 10B,B01,083739,Sinha; Shubham,9,0,30,21
1657115114369,MATH 18,A01,083743,Cinel; Cameron Alexander,6,0,30,24
1657115114369,MATH 18,A02,083744,Cinel; Cameron Alexander,15,0,30,15
1657115114369,MATH 18,A03,083745,Cinel; Cameron Alexander,8,0,30,22
1657115114369,MATH 18,B01,083748,Rideout; David Porter,4,0,37,33
1657115114369,MATH 18,B02,083749,Rideout; David Porter,3,0,36,33
1657115114369,MATH 18,B03,083750,Rideout; David Porter,2,0,37,35
1657115114369,MATH 18,B04,083751,Rideout; David Porter,5,0,36,31
1657115114369,MATH 18,B05,093473,Rideout; David Porter,4,0,36,32
1657115114369,MATH 18,B06,093474,Rideout; David Porter,5,0,36,31
1657115120396,MATH 20A,A01,083754,Zheng; Zequn,12,0,40,28
1657115126423,MATH 20B,A01,083756,Briones; Jor-el Thomas Caparas,1,0,36,35
1657115126423,MATH 20B,A02,083757,Briones; Jor-el Thomas Caparas,1,0,36,35
1657115126423,MATH 20B,A03,093475,Briones; Jor-el Thomas Caparas,0,0,36,36
1657115132462,MATH 20C,A01,083760,Briones; Jor-el Thomas Caparas,1,0,35,34
1657115132462,MATH 20C,A02,083761,Briones; Jor-el Thomas Caparas,8,0,35,27
1657115132462,MATH 20C,A03,093476,Briones; Jor-el Thomas Caparas,0,1,36,36
1657115132462,MATH 20C,B01,083762,Bach; Quang Tran,0,0,30,30
1657115138491,MATH 20D,A01,083765,Tran; Brian Kha,4,0,30,26
1657115138491,MATH 20D,A02,083766,Tran; Brian Kha,5,0,30,25
1657115138491,MATH 20D,A03,083767,Tran; Brian Kha,3,0,30,27
1657115144521,MATH 20E,A01,083771,Ganguly; Soumya,6,0,32,26
1657115144521,MATH 20E,A02,083772,Ganguly; Soumya,6,0,32,26
1657115144521,MATH 20E,B01,083773,Ciotti; Benjamin,18,0,35,17
1657115144521,MATH 20E,B02,083774,Ciotti; Benjamin,17,0,35,18
1657115150546,MATH 103A,A01,083777,Greenfeld; Be'Eri,2,0,36,34
1657115150546,MATH 103A,A02,083778,Greenfeld; Be'Eri,5,0,36,31
1657115150546,MATH 103A,A03,093561,Greenfeld; Be'Eri,4,0,36,32
1657115150546,MATH 103A,B01,083779,Greenfeld; Be'Eri,6,0,36,30
1657115150546,MATH 103A,B02,083780,Greenfeld; Be'Eri,2,0,36,34
1657115150546,MATH 103A,B03,093562,Greenfeld; Be'Eri,3,0,36,33
1657115156575,MATH 105,A01,085443,Carter; Anne Toulson,14,0,35,21
1657115156575,MATH 105,A02,093477,Carter; Anne Toulson,20,0,35,15
1657115162600,MATH 109,A01,083213,Ganzberger; Geoffrey Michael,2,0,34,32
1657115162600,MATH 109,A02,083214,Ganzberger; Geoffrey Michael,3,0,34,31
1657115162600,MATH 109,A03,093478,Ganzberger; Geoffrey Michael,1,0,34,33
1657115162600,MATH 109,B01,083215,Ganzberger; Geoffrey Michael,1,0,32,31
1657115162600,MATH 109,B02,083216,Ganzberger; Geoffrey Michael,1,0,32,31
1657115162600,MATH 109,B03,093479,Ganzberger; Geoffrey Michael,6,0,32,26
1657115168627,MATH 142A,A01,083219,Chow; Bennett,6,0,32,26
1657115168627,MATH 142A,A02,083220,Chow; Bennett,10,0,32,22
1657115168627,MATH 142A,A03,093480,Chow; Bennett,7,0,32,25
1657115168627,MATH 142A,B03,093481,Chow; Bennett,8,0,32,24
1657115168627,MATH 142A,B04,093558,Chow; Bennett,11,0,32,21
1657115168627,MATH 142A,B05,093559,Chow; Bennett,6,0,32,26
1657115174655,MATH 193A,A01,083224,Rotar; Vladimir,7,0,34,27
1657115174655,MATH 193A,A02,083225,Rotar; Vladimir,5,0,34,29
1657115174655,MATH 193A,A03,083781,Rotar; Vladimir,1,0,34,33
1657115174655,MATH 193A,A04,083782,Rotar; Vladimir,6,0,34,28
1657115174655,MATH 193A,A05,093482,Rotar; Vladimir,6,0,34,28
1657115180681,MATH 197,001,091859,McAuley; Julian John,9999,0,9999,0
1657115180681,MATH 197,002,095566,Kedlaya; Kiran S.,9997,0,9999,2
1657115180681,MATH 197,003,095567,Xiao; Ming,9999,0,9999,0
1657115180681,MATH 197,004,095571,Perols; Johan Lars,9998,0,9999,1
1657115187739,COGS 9,A01,083615,Shannon; Kyle Michael,7,0,75,68
1657115193766,COGS 11,A01,083617,Boyle; Mary E. T.,21,0,48,27
1657115199796,COGS 13,A01,083071,Bastos; Amalia Pinkusfeld,9,0,71,62
1657115205822,COGS 14A,A01,092681,Semenuks; Arturs,1,1,100,99
1657115211847,COGS 14B,A01,083073,Cheng; Tzu-Han,6,0,63,57
1657115217875,COGS 17,A01,092677,Semenuks; Arturs,4,0,81,77
1657115223901,COGS 100,A01,083619,Allen; Michael Gordon,15,0,70,55
1657115229928,COGS 101A,A01,083621,Davis; Joshua Daniel,9,0,68,59
1657115235952,COGS 101B,A01,091572,Allen; Michael Gordon,8,0,65,57
1657115241978,COGS 101C,A01,083625,Delgado; Tania,17,0,35,18
1657115248007,COGS 107A,A01,083627,Boyle; Mary E. T.,13,0,60,47
1657115254037,COGS 118A,A01,083075,Gupta; Anjum,15,0,76,61
1657115260064,CSE 3,A50,083646,Miranda; Gregory Joseph,22,0,50,28
1657115266094,CSE 8A,A50,083650,Miranda; Gregory Joseph,17,1,56,39
1657115272121,CSE 11,A01,083080,Cao; Yingjun,4,15,40,36
1657115278147,CSE 12,A01,083652,Krause-Levy; Sophia Louisa,23,1,120,97
1657115284176,CSE 15L,A01,083654,Morris; Justin Loren,9,0,50,41
1657115284176,CSE 15L,A02,083655,Morris; Justin Loren,9,0,50,41
1657115290202,CSE 20,A01,083657,Tran; Khoa Dang,37,0,80,43
1657115296232,CSE 21,A01,095574,Bach; Quang Tran,21,0,48,27
1657115302263,CSE 30,A01,083084,Eldon; John,4,0,80,76
1657115302263,CSE 30,B01,095061,Bhaskar; Nishant,6,0,50,44
1657115308288,CSE 100,A01,083659,Cao; Yingjun,4,4,70,66
1657115314313,CSE 134B,A01,083661,Powell; Thomas Allan,19,0,100,81
1657115320343,CSE 140,A01,083663,Gungor; Onat,14,0,85,71
1657115326372,CSE 140L,A01,083088,Eldon; John,17,0,100,83
1657115332395,CSE 175,A01,083665,Kumar; Rakesh,3,0,25,22
1657115338421,CSE 190,A00,092507,Dubnov; Shlomo,7,0,20,13
1657115344452,ECE 45,A01,083139,Congero; Spencer William,5,0,75,70
1657115350474,ECE 65,A50,083695,Saad; Andrew S,12,0,30,18
1657115350474,ECE 65,A51,095125,Saad; Andrew S,25,0,26,1
1657115356498,ECE 109,A01,091882,Touri; Behrouz,16,0,70,54
1657115362526,ECE 180,A00,083140,Abi Samra; Nicholas Camill,1,0,30,29
1657115362526,ECE 180,B00,083141,Abi Samra; Nicholas Camill,0,0,30,30
1657115368554,MATH 10A,A01,083735,Patchell; Gregory David,1,0,30,29
1657115368554,MATH 10A,A02,083736,Patchell; Gregory David,20,0,30,10
1657115368554,MATH 10A,A03,083737,Patchell; Gregory David,16,0,30,14
1657115374577,MATH 10B,A01,083207,Lim; Seonhee,7,0,34,27
1657115374577,MATH 10B,A02,083208,Lim; Seonhee,9,0,35,26
1657115374577,MATH 10B,A03,093472,Lim; Seonhee,5,0,34,29
1657115374577,MATH 10B,B01,083739,Sinha; Shubham,9,0,30,21
1657115380602,MATH 18,A01,083743,Cinel; Cameron Alexander,6,0,30,24
1657115380602,MATH 18,A02,083744,Cinel; Cameron Alexander,15,0,30,15
1657115380602,MATH 18,A03,083745,Cinel; Cameron Alexander,8,0,30,22
1657115380602,MATH 18,B01,083748,Rideout; David Porter,4,0,37,33
1657115380602,MATH 18,B02,083749,Rideout; David Porter,3,0,36,33
1657115380602,MATH 18,B03,083750,Rideout; David Porter,2,0,37,35
1657115380602,MATH 18,B04,083751,Rideout; David Porter,5,0,36,31
1657115380602,MATH 18,B05,093473,Rideout; David Porter,4,0,36,32
1657115380602,MATH 18,B06,093474,Rideout; David Porter,5,0,36,31
1657115386625,MATH 20A,A01,083754,Zheng; Zequn,12,0,40,28
1657115392648,MATH 20B,A01,083756,Briones; Jor-el Thomas Caparas,1,0,36,35
1657115392648,MATH 20B,A02,083757,Briones; Jor-el Thomas Caparas,1,0,36,35
1657115392648,MATH 20B,A03,093475,Briones; Jor-el Thomas Caparas,0,0,36,36
1657115398676,MATH 20C,A01,083760,Briones; Jor-el Thomas Caparas,1,0,35,34
1657115398676,MATH 20C,A02,083761,Briones; Jor-el Thomas Caparas,8,0,35,27
1657115398676,MATH 20C,A03,093476,Briones; Jor-el Thomas Caparas,0,1,36,36
1657115398676,MATH 20C,B01,083762,Bach; Quang Tran,0,0,30,30
1657115404701,MATH 20D,A01,083765,Tran; Brian Kha,4,0,30,26
1657115404701,MATH 20D,A02,083766,Tran; Brian Kha,5,0,30,25
1657115404701,MATH 20D,A03,083767,Tran; Brian Kha,3,0,30,27
1657115410803,MATH 20E,A01,083771,Ganguly; Soumya,6,0,32,26
1657115410803,MATH 20E,A02,083772,Ganguly; Soumya,6,0,32,26
1657115410803,MATH 20E,B01,083773,Ciotti; Benjamin,18,0,35,17
1657115410803,MATH 20E,B02,083774,Ciotti; Benjamin,17,0,35,18
1657115416830,MATH 103A,A01,083777,Greenfeld; Be'Eri,2,0,36,34
1657115416830,MATH 103A,A02,083778,Greenfeld; Be'Eri,5,0,36,31
1657115416830,MATH 103A,A03,093561,Greenfeld; Be'Eri,4,0,36,32
1657115416830,MATH 103A,B01,083779,Greenfeld; Be'Eri,6,0,36,30
1657115416830,MATH 103A,B02,083780,Greenfeld; Be'Eri,2,0,36,34
1657115416830,MATH 103A,B03,093562,Greenfeld; Be'Eri,3,0,36,33
1657115422854,MATH 105,A01,085443,Carter; Anne Toulson,14,0,35,21
1657115422854,MATH 105,A02,093477,Carter; Anne Toulson,20,0,35,15
1657115428881,MATH 109,A01,083213,Ganzberger; Geoffrey Michael,2,0,34,32
1657115428881,MATH 109,A02,083214,Ganzberger; Geoffrey Michael,3,0,34,31
1657115428881,MATH 109,A03,093478,Ganzberger; Geoffrey Michael,1,0,34,33
1657115428881,MATH 109,B01,083215,Ganzberger; Geoffrey Michael,1,0,32,31
1657115428881,MATH 109,B02,083216,Ganzberger; Geoffrey Michael,1,0,32,31
1657115428881,MATH 109,B03,093479,Ganzberger; Geoffrey Michael,6,0,32,26
1657115434904,MATH 142A,A01,083219,Chow; Bennett,6,0,32,26
1657115434904,MATH 142A,A02,083220,Chow; Bennett,10,0,32,22
1657115434904,MATH 142A,A03,093480,Chow; Bennett,7,0,32,25
1657115434904,MATH 142A,B03,093481,Chow; Bennett,8,0,32,24
1657115434904,MATH 142A,B04,093558,Chow; Bennett,11,0,32,21
1657115434904,MATH 142A,B05,093559,Chow; Bennett,6,0,32,26
1657115440938,MATH 193A,A01,083224,Rotar; Vladimir,7,0,34,27
1657115440938,MATH 193A,A02,083225,Rotar; Vladimir,5,0,34,29
1657115440938,MATH 193A,A03,083781,Rotar; Vladimir,1,0,34,33
1657115440938,MATH 193A,A04,083782,Rotar; Vladimir,6,0,34,28
1657115440938,MATH 193A,A05,093482,Rotar; Vladimir,6,0,34,28
1657115446972,MATH 197,001,091859,McAuley; Julian John,9999,0,9999,0
1657115446972,MATH 197,002,095566,Kedlaya; Kiran S.,9997,0,9999,2
1657115446972,MATH 197,003,095567,Xiao; Ming,9999,0,9999,0
1657115446972,MATH 197,004,095571,Perols; Johan Lars,9998,0,9999,1
1657115454028,COGS 9,A01,083615,Shannon; Kyle Michael,7,0,75,68
1657115460053,COGS 11,A01,083617,Boyle; Mary E. T.,21,0,48,27
1657115466082,COGS 13,A01,083071,Bastos; Amalia Pinkusfeld,9,0,71,62
1657115472110,COGS 14A,A01,092681,Semenuks; Arturs,1,1,100,99
1657115478134,COGS 14B,A01,083073,Cheng; Tzu-Han,6,0,63,57
1657115484159,COGS 17,A01,092677,Semenuks; Arturs,4,0,81,77
1657115490182,COGS 100,A01,083619,Allen; Michael Gordon,15,0,70,55
1657115496209,COGS 101A,A01,083621,Davis; Joshua Daniel,9,0,68,59
1657115502232,COGS 101B,A01,091572,Allen; Michael Gordon,8,0,65,57
1657115508256,COGS 101C,A01,083625,Delgado; Tania,17,0,35,18
1657115514283,COGS 107A,A01,083627,Boyle; Mary E. T.,13,0,60,47
1657115520310,COGS 118A,A01,083075,Gupta; Anjum,15,0,76,61
1657115526340,CSE 3,A50,083646,Miranda; Gregory Joseph,22,0,50,28
1657115532369,CSE 8A,A50,083650,Miranda; Gregory Joseph,17,1,56,39
1657115538393,CSE 11,A01,083080,Cao; Yingjun,4,15,40,36
1657115544417,CSE 12,A01,083652,Krause-Levy; Sophia Louisa,23,1,120,97
1657115550443,CSE 15L,A01,083654,Morris; Justin Loren,9,0,50,41
1657115550443,CSE 15L,A02,083655,Morris; Justin Loren,9,0,50,41
1657115556473,CSE 20,A01,083657,Tran; Khoa Dang,37,0,80,43
1657115562500,CSE 21,A01,095574,Bach; Quang Tran,21,0,48,27
1657115568529,CSE 30,A01,083084,Eldon; John,4,0,80,76
1657115568529,CSE 30,B01,095061,Bhaskar; Nishant,6,0,50,44
1657115574557,CSE 100,A01,083659,Cao; Yingjun,4,4,70,66
1657115580581,CSE 134B,A01,083661,Powell; Thomas Allan,19,0,100,81
1657115586612,CSE 140,A01,083663,Gungor; Onat,14,0,85,71
1657115592635,CSE 140L,A01,083088,Eldon; John,17,0,100,83
1657115598658,CSE 175,A01,083665,Kumar; Rakesh,3,0,25,22
1657115604683,CSE 190,A00,092507,Dubnov; Shlomo,7,0,20,13
1657115610710,ECE 45,A01,083139,Congero; Spencer William,5,0,75,70
1657115616737,ECE 65,A50,083695,Saad; Andrew S,12,0,30,18
1657115616737,ECE 65,A51,095125,Saad; Andrew S,25,0,26,1
1657115622765,ECE 109,A01,091882,Touri; Behrouz,16,0,70,54
1657115628791,ECE 180,A00,083140,Abi Samra; Nicholas Camill,1,0,30,29
1657115628791,ECE 180,B00,083141,Abi Samra; Nicholas Camill,0,0,30,30
1657115634815,MATH 10A,A01,083735,Patchell; Gregory David,1,0,30,29
1657115634815,MATH 10A,A02,083736,Patchell; Gregory David,20,0,30,10
1657115634815,MATH 10A,A03,083737,Patchell; Gregory David,16,0,30,14
1657115640845,MATH 10B,A01,083207,Lim; Seonhee,7,0,34,27
1657115640845,MATH 10B,A02,083208,Lim; Seonhee,9,0,35,26
1657115640845,MATH 10B,A03,093472,Lim; Seonhee,5,0,34,29
1657115640845,MATH 10B,B01,083739,Sinha; Shubham,9,0,30,21
1657115646871,MATH 18,A01,083743,Cinel; Cameron Alexander,6,0,30,24
1657115646871,MATH 18,A02,083744,Cinel; Cameron Alexander,15,0,30,15
1657115646871,MATH 18,A03,083745,Cinel; Cameron Alexander,8,0,30,22
1657115646871,MATH 18,B01,083748,Rideout; David Porter,4,0,37,33
1657115646871,MATH 18,B02,083749,Rideout; David Porter,3,0,36,33
1657115646871,MATH 18,B03,083750,Rideout; David Porter,2,0,37,35
1657115646871,MATH 18,B04,083751,Rideout; David Porter,5,0,36,31
1657115646871,MATH 18,B05,093473,Rideout; David Porter,4,0,36,32
1657115646871,MATH 18,B06,093474,Rideout; David Porter,5,0,36,31
1657115652898,MATH 20A,A01,083754,Zheng; Zequn,12,0,40,28
1657115658925,MATH 20B,A01,083756,Briones; Jor-el Thomas Caparas,1,0,36,35
1657115658925,MATH 20B,A02,083757,Briones; Jor-el Thomas Caparas,1,0,36,35
1657115658925,MATH 20B,A03,093475,Briones; Jor-el Thomas Caparas,0,0,36,36
1657115664956,MATH 20C,A01,083760,Briones; Jor-el Thomas Caparas,1,0,35,34
1657115664956,MATH 20C,A02,083761,Briones; Jor-el Thomas Caparas,8,0,35,27
1657115664956,MATH 20C,A03,093476,Briones; Jor-el Thomas Caparas,0,1,36,36
1657115664956,MATH 20C,B01,083762,Bach; Quang Tran,0,0,30,30
1657115670982,MATH 20D,A01,083765,Tran; Brian Kha,4,0,30,26
1657115670982,MATH 20D,A02,083766,Tran; Brian Kha,5,0,30,25
1657115670982,MATH 20D,A03,083767,Tran; Brian Kha,3,0,30,27
1657115677089,MATH 20E,A01,083771,Ganguly; Soumya,6,0,32,26
1657115677089,MATH 20E,A02,083772,Ganguly; Soumya,6,0,32,26
1657115677089,MATH 20E,B01,083773,Ciotti; Benjamin,18,0,35,17
1657115677089,MATH 20E,B02,083774,Ciotti; Benjamin,17,0,35,18
1657115683113,MATH 103A,A01,083777,Greenfeld; Be'Eri,2,0,36,34
1657115683113,MATH 103A,A02,083778,Greenfeld; Be'Eri,5,0,36,31
1657115683113,MATH 103A,A03,093561,Greenfeld; Be'Eri,4,0,36,32
1657115683113,MATH 103A,B01,083779,Greenfeld; Be'Eri,6,0,36,30
1657115683113,MATH 103A,B02,083780,Greenfeld; Be'Eri,2,0,36,34
1657115683113,MATH 103A,B03,093562,Greenfeld; Be'Eri,3,0,36,33
1657115689141,MATH 105,A01,085443,Carter; Anne Toulson,14,0,35,21
1657115689141,MATH 105,A02,093477,Carter; Anne Toulson,20,0,35,15
1657115695167,MATH 109,A01,083213,Ganzberger; Geoffrey Michael,2,0,34,32
1657115695167,MATH 109,A02,083214,Ganzberger; Geoffrey Michael,3,0,34,31
1657115695167,MATH 109,A03,093478,Ganzberger; Geoffrey Michael,1,0,34,33
1657115695167,MATH 109,B01,083215,Ganzberger; Geoffrey Michael,1,0,32,31
1657115695167,MATH 109,B02,083216,Ganzberger; Geoffrey Michael,1,0,32,31
1657115695167,MATH 109,B03,093479,Ganzberger; Geoffrey Michael,6,0,32,26
1657115701197,MATH 142A,A01,083219,Chow; Bennett,6,0,32,26
1657115701197,MATH 142A,A02,083220,Chow; Bennett,10,0,32,22
1657115701197,MATH 142A,A03,093480,Chow; Bennett,7,0,32,25
1657115701197,MATH 142A,B03,093481,Chow; Bennett,8,0,32,24
1657115701197,MATH 142A,B04,093558,Chow; Bennett,11,0,32,21
1657115701197,MATH 142A,B05,093559,Chow; Bennett,6,0,32,26
1657115707223,MATH 193A,A01,083224,Rotar; Vladimir,7,0,34,27
1657115707223,MATH 193A,A02,083225,Rotar; Vladimir,5,0,34,29
1657115707223,MATH 193A,A03,083781,Rotar; Vladimir,1,0,34,33
1657115707223,MATH 193A,A04,083782,Rotar; Vladimir,6,0,34,28
1657115707223,MATH 193A,A05,093482,Rotar; Vladimir,6,0,34,28
1657115713250,MATH 197,001,091859,McAuley; Julian John,9999,0,9999,0
1657115713250,MATH 197,002,095566,Kedlaya; Kiran S.,9997,0,9999,2
1657115713250,MATH 197,003,095567,Xiao; Ming,9999,0,9999,0
1657115713250,MATH 197,004,095571,Perols; Johan Lars,9998,0,9999,1
1657115720312,COGS 9,A01,083615,Shannon; Kyle Michael,7,0,75,68
1657115726340,COGS 11,A01,083617,Boyle; Mary E. T.,21,0,48,27
1657115732365,COGS 13,A01,083071,Bastos; Amalia Pinkusfeld,9,0,71,62
1657115738391,COGS 14A,A01,092681,Semenuks; Arturs,1,1,100,99
1657115744417,COGS 14B,A01,083073,Cheng; Tzu-Han,6,0,63,57
1657115750440,COGS 17,A01,092677,Semenuks; Arturs,4,0,81,77
1657115756466,COGS 100,A01,083619,Allen; Michael Gordon,15,0,70,55
1657115762495,COGS 101A,A01,083621,Davis; Joshua Daniel,9,0,68,59
1657115768523,COGS 101B,A01,091572,Allen; Michael Gordon,8,0,65,57
1657115774551,COGS 101C,A01,083625,Delgado; Tania,17,0,35,18
1657115780579,COGS 107A,A01,083627,Boyle; Mary E. T.,13,0,60,47
1657115786607,COGS 118A,A01,083075,Gupta; Anjum,15,0,76,61
1657115792635,CSE 3,A50,083646,Miranda; Gregory Joseph,22,0,50,28
1657115798660,CSE 8A,A50,083650,Miranda; Gregory Joseph,17,1,56,39
1657115804683,CSE 11,A01,083080,Cao; Yingjun,4,15,40,36
1657115810710,CSE 12,A01,083652,Krause-Levy; Sophia Louisa,23,1,120,97
1657115816739,CSE 15L,A01,083654,Morris; Justin Loren,9,0,50,41
1657115816739,CSE 15L,A02,083655,Morris; Justin Loren,9,0,50,41
1657115822764,CSE 20,A01,083657,Tran; Khoa Dang,37,0,80,43
1657115828789,CSE 21,A01,095574,Bach; Quang Tran,21,0,48,27
1657115834818,CSE 30,A01,083084,Eldon; John,4,0,80,76
1657115834818,CSE 30,B01,095061,Bhaskar; Nishant,6,0,50,44
1657115840845,CSE 100,A01,083659,Cao; Yingjun,4,4,70,66
1657115846874,CSE 134B,A01,083661,Powell; Thomas Allan,19,0,100,81
1657115852901,CSE 140,A01,083663,Gungor; Onat,14,0,85,71
1657115858930,CSE 140L,A01,083088,Eldon; John,17,0,100,83
1657115864962,CSE 175,A01,083665,Kumar; Rakesh,3,0,25,22
1657115870987,CSE 190,A00,092507,Dubnov; Shlomo,7,0,20,13
1657115877013,ECE 45,A01,083139,Congero; Spencer William,5,0,75,70
1657115883042,ECE 65,A50,083695,Saad; Andrew S,12,0,30,18
1657115883042,ECE 65,A51,095125,Saad; Andrew S,25,0,26,1
1657115889064,ECE 109,A01,091882,Touri; Behrouz,16,0,70,54
1657115895087,ECE 180,A00,083140,Abi Samra; Nicholas Camill,1,0,30,29
1657115895087,ECE 180,B00,083141,Abi Samra; Nicholas Camill,0,0,30,30
1657115901111,MATH 10A,A01,083735,Patchell; Gregory David,1,0,30,29
1657115901111,MATH 10A,A02,083736,Patchell; Gregory David,20,0,30,10
1657115901111,MATH 10A,A03,083737,Patchell; Gregory David,16,0,30,14
1657115907135,MATH 10B,A01,083207,Lim; Seonhee,7,0,34,27
1657115907135,MATH 10B,A02,083208,Lim; Seonhee,9,0,35,26
1657115907135,MATH 10B,A03,093472,Lim; Seonhee,5,0,34,29
1657115907135,MATH 10B,B01,083739,Sinha; Shubham,9,0,30,21
1657115913162,MATH 18,A01,083743,Cinel; Cameron Alexander,6,0,30,24
1657115913162,MATH 18,A02,083744,Cinel; Cameron Alexander,15,0,30,15
1657115913162,MATH 18,A03,083745,Cinel; Cameron Alexander,8,0,30,22
1657115913162,MATH 18,B01,083748,Rideout; David Porter,4,0,37,33
1657115913162,MATH 18,B02,083749,Rideout; David Porter,3,0,36,33
1657115913162,MATH 18,B03,083750,Rideout; David Porter,2,0,37,35
1657115913162,MATH 18,B04,083751,Rideout; David Porter,5,0,36,31
1657115913162,MATH 18,B05,093473,Rideout; David Porter,4,0,36,32
1657115913162,MATH 18,B06,093474,Rideout; David Porter,5,0,36,31
1657115919184,MATH 20A,A01,083754,Zheng; Zequn,12,0,40,28
1657115925207,MATH 20B,A01,083756,Briones; Jor-el Thomas Caparas,1,0,36,35
1657115925207,MATH 20B,A02,083757,Briones; Jor-el Thomas Caparas,1,0,36,35
1657115925207,MATH 20B,A03,093475,Briones; Jor-el Thomas Caparas,0,0,36,36
1657115931231,MATH 20C,A01,083760,Briones; Jor-el Thomas Caparas,1,0,35,34
1657115931231,MATH 20C,A02,083761,Briones; Jor-el Thomas Caparas,8,0,35,27
1657115931231,MATH 20C,A03,093476,Briones; Jor-el Thomas Caparas,0,1,36,36
1657115931231,MATH 20C,B01,083762,Bach; Quang Tran,0,0,30,30
1657115937260,MATH 20D,A01,083765,Tran; Brian Kha,4,0,30,26
1657115937260,MATH 20D,A02,083766,Tran; Brian Kha,5,0,30,25
1657115937260,MATH 20D,A03,083767,Tran; Brian Kha,3,0,30,27
1657115943298,MATH 20E,A01,083771,Ganguly; Soumya,6,0,32,26
1657115943298,MATH 20E,A02,083772,Ganguly; Soumya,6,0,32,26
1657115943298,MATH 20E,B01,083773,Ciotti; Benjamin,18,0,35,17
1657115943298,MATH 20E,B02,083774,Ciotti; Benjamin,17,0,35,18
1657115949327,MATH 103A,A01,083777,Greenfeld; Be'Eri,2,0,36,34
1657115949327,MATH 103A,A02,083778,Greenfeld; Be'Eri,5,0,36,31
1657115949327,MATH 103A,A03,093561,Greenfeld; Be'Eri,4,0,36,32
1657115949327,MATH 103A,B01,083779,Greenfeld; Be'Eri,6,0,36,30
1657115949327,MATH 103A,B02,083780,Greenfeld; Be'Eri,2,0,36,34
1657115949327,MATH 103A,B03,093562,Greenfeld; Be'Eri,3,0,36,33
1657115955356,MATH 105,A01,085443,Carter; Anne Toulson,14,0,35,21
1657115955356,MATH 105,A02,093477,Carter; Anne Toulson,20,0,35,15
1657115961380,MATH 109,A01,083213,Ganzberger; Geoffrey Michael,2,0,34,32
1657115961380,MATH 109,A02,083214,Ganzberger; Geoffrey Michael,3,0,34,31
1657115961380,MATH 109,A03,093478,Ganzberger; Geoffrey Michael,1,0,34,33
1657115961380,MATH 109,B01,083215,Ganzberger; Geoffrey Michael,1,0,32,31
1657115961380,MATH 109,B02,083216,Ganzberger; Geoffrey Michael,1,0,32,31
1657115961380,MATH 109,B03,093479,Ganzberger; Geoffrey Michael,6,0,32,26
1657115967412,MATH 142A,A01,083219,Chow; Bennett,6,0,32,26
1657115967412,MATH 142A,A02,083220,Chow; Bennett,10,0,32,22
1657115967412,MATH 142A,A03,093480,Chow; Bennett,7,0,32,25
1657115967412,MATH 142A,B03,093481,Chow; Bennett,8,0,32,24
1657115967412,MATH 142A,B04,093558,Chow; Bennett,11,0,32,21
1657115967412,MATH 142A,B05,093559,Chow; Bennett,6,0,32,26
1657115973441,MATH 193A,A01,083224,Rotar; Vladimir,7,0,34,27
1657115973441,MATH 193A,A02,083225,Rotar; Vladimir,5,0,34,29
1657115973441,MATH 193A,A03,083781,Rotar; Vladimir,1,0,34,33
1657115973441,MATH 193A,A04,083782,Rotar; Vladimir,6,0,34,28
1657115973441,MATH 193A,A05,093482,Rotar; Vladimir,6,0,34,28
1657115979471,MATH 197,001,091859,McAuley; Julian John,9999,0,9999,0
1657115979471,MATH 197,002,095566,Kedlaya; Kiran S.,9997,0,9999,2
1657115979471,MATH 197,003,095567,Xiao; Ming,9999,0,9999,0
1657115979471,MATH 197,004,095571,Perols; Johan Lars,9998,0,9999,1
1657115986528,COGS 9,A01,083615,Shannon; Kyle Michael,7,0,75,68
1657115992556,COGS 11,A01,083617,Boyle; Mary E. T.,21,0,48,27
1657115998581,COGS 13,A01,083071,Bastos; Amalia Pinkusfeld,9,0,71,62
1657116004608,COGS 14A,A01,092681,Semenuks; Arturs,1,1,100,99
1657116010636,COGS 14B,A01,083073,Cheng; Tzu-Han,6,0,63,57
1657116016661,COGS 17,A01,092677,Semenuks; Arturs,4,0,81,77
1657116022686,COGS 100,A01,083619,Allen; Michael Gordon,15,0,70,55
1657116028711,COGS 101A,A01,083621,Davis; Joshua Daniel,9,0,68,59
1657116034740,COGS 101B,A01,091572,Allen; Michael Gordon,8,0,65,57
1657116040766,COGS 101C,A01,083625,Delgado; Tania,17,0,35,18
1657116046790,COGS 107A,A01,083627,Boyle; Mary E. T.,13,0,60,47
1657116052813,COGS 118A,A01,083075,Gupta; Anjum,15,0,76,61
1657116058838,CSE 3,A50,083646,Miranda; Gregory Joseph,22,0,50,28
1657116064869,CSE 8A,A50,083650,Miranda; Gregory Joseph,17,1,56,39
1657116070893,CSE 11,A01,083080,Cao; Yingjun,4,15,40,36
1657116076928,CSE 12,A01,083652,Krause-Levy; Sophia Louisa,23,1,120,97
1657116082953,CSE 15L,A01,083654,Morris; Justin Loren,9,0,50,41
1657116082953,CSE 15L,A02,083655,Morris; Justin Loren,9,0,50,41
1657116088977,CSE 20,A01,083657,Tran; Khoa Dang,37,0,80,43
1657116095004,CSE 21,A01,095574,Bach; Quang Tran,21,0,48,27
1657116101038,CSE 30,A01,083084,Eldon; John,4,0,80,76
1657116101038,CSE 30,B01,095061,Bhaskar; Nishant,6,0,50,44
1657116107073,CSE 100,A01,083659,Cao; Yingjun,4,4,70,66
1657116113097,CSE 134B,A01,083661,Powell; Thomas Allan,19,0,100,81
1657116119122,CSE 140,A01,083663,Gungor; Onat,14,0,85,71
1657116125157,CSE 140L,A01,083088,Eldon; John,17,0,100,83
1657116131187,CSE 175,A01,083665,Kumar; Rakesh,3,0,25,22
1657116137211,CSE 190,A00,092507,Dubnov; Shlomo,7,0,20,13
1657116143234,ECE 45,A01,083139,Congero; Spencer William,5,0,75,70
1657116149266,ECE 65,A50,083695,Saad; Andrew S,12,0,30,18
1657116149266,ECE 65,A51,095125,Saad; Andrew S,25,0,26,1
1657116155305,ECE 109,A01,091882,Touri; Behrouz,16,0,70,54
1657116161330,ECE 180,A00,083140,Abi Samra; Nicholas Camill,1,0,30,29
1657116161330,ECE 180,B00,083141,Abi Samra; Nicholas Camill,0,0,30,30
1657116167356,MATH 10A,A01,083735,Patchell; Gregory David,1,0,30,29
1657116167356,MATH 10A,A02,083736,Patchell; Gregory David,20,0,30,10
1657116167356,MATH 10A,A03,083737,Patchell; Gregory David,16,0,30,14
1657116173381,MATH 10B,A01,083207,Lim; Seonhee,7,0,34,27
1657116173381,MATH 10B,A02,083208,Lim; Seonhee,9,0,35,26
1657116173381,MATH 10B,A03,093472,Lim; Seonhee,5,0,34,29
1657116173381,MATH 10B,B01,083739,Sinha; Shubham,9,0,30,21
1657116179419,MATH 18,A01,083743,Cinel; Cameron Alexander,6,0,30,24
1657116179419,MATH 18,A02,083744,Cinel; Cameron Alexander,15,0,30,15
1657116179419,MATH 18,A03,083745,Cinel; Cameron Alexander,8,0,30,22
1657116179419,MATH 18,B01,083748,Rideout; David Porter,4,0,37,33
1657116179419,MATH 18,B02,083749,Rideout; David Porter,3,0,36,33
1657116179419,MATH 18,B03,083750,Rideout; David Porter,2,0,37,35
1657116179419,MATH 18,B04,083751,Rideout; David Porter,5,0,36,31
1657116179419,MATH 18,B05,093473,Rideout; David Porter,4,0,36,32
1657116179419,MATH 18,B06,093474,Rideout; David Porter,5,0,36,31
1657116185452,MATH 20A,A01,083754,Zheng; Zequn,12,0,40,28
1657116191478,MATH 20B,A01,083756,Briones; Jor-el Thomas Caparas,1,0,36,35
1657116191478,MATH 20B,A02,083757,Briones; Jor-el Thomas Caparas,1,0,36,35
1657116191478,MATH 20B,A03,093475,Briones; Jor-el Thomas Caparas,0,0,36,36
1657116197509,MATH 20C,A01,083760,Briones; Jor-el Thomas Caparas,1,0,35,34
1657116197509,MATH 20C,A02,083761,Briones; Jor-el Thomas Caparas,8,0,35,27
1657116197509,MATH 20C,A03,093476,Briones; Jor-el Thomas Caparas,0,1,36,36
1657116197509,MATH 20C,B01,083762,Bach; Quang Tran,0,0,30,30
1657116203543,MATH 20D,A01,083765,Tran; Brian Kha,4,0,30,26
1657116203543,MATH 20D,A02,083766,Tran; Brian Kha,5,0,30,25
1657116203543,MATH 20D,A03,083767,Tran; Brian Kha,3,0,30,27
1657116209570,MATH 20E,A01,083771,Ganguly; Soumya,6,0,32,26
1657116209570,MATH 20E,A02,083772,Ganguly; Soumya,6,0,32,26
1657116209570,MATH 20E,B01,083773,Ciotti; Benjamin,18,0,35,17
1657116209570,MATH 20E,B02,083774,Ciotti; Benjamin,17,0,35,18
1657116215622,MATH 103A,A01,083777,Greenfeld; Be'Eri,2,0,36,34
1657116215622,MATH 103A,A02,083778,Greenfeld; Be'Eri,5,0,36,31
1657116215622,MATH 103A,A03,093561,Greenfeld; Be'Eri,4,0,36,32
1657116215622,MATH 103A,B01,083779,Greenfeld; Be'Eri,6,0,36,30
1657116215622,MATH 103A,B02,083780,Greenfeld; Be'Eri,2,0,36,34
1657116215622,MATH 103A,B03,093562,Greenfeld; Be'Eri,3,0,36,33
1657116221654,MATH 105,A01,085443,Carter; Anne Toulson,14,0,35,21
1657116221654,MATH 105,A02,093477,Carter; Anne Toulson,20,0,35,15
1657116227678,MATH 109,A01,083213,Ganzberger; Geoffrey Michael,2,0,34,32
1657116227678,MATH 109,A02,083214,Ganzberger; Geoffrey Michael,3,0,34,31
1657116227678,MATH 109,A03,093478,Ganzberger; Geoffrey Michael,1,0,34,33
1657116227678,MATH 109,B01,083215,Ganzberger; Geoffrey Michael,1,0,32,31
1657116227678,MATH 109,B02,083216,Ganzberger; Geoffrey Michael,1,0,32,31
1657116227678,MATH 109,B03,093479,Ganzberger; Geoffrey Michael,6,0,32,26
1657116233707,MATH 142A,A01,083219,Chow; Bennett,6,0,32,26
1657116233707,MATH 142A,A02,083220,Chow; Bennett,10,0,32,22
1657116233707,MATH 142A,A03,093480,Chow; Bennett,7,0,32,25
1657116233707,MATH 142A,B03,093481,Chow; Bennett,8,0,32,24
1657116233707,MATH 142A,B04,093558,Chow; Bennett,11,0,32,21
1657116233707,MATH 142A,B05,093559,Chow; Bennett,6,0,32,26
1657116239739,MATH 193A,A01,083224,Rotar; Vladimir,7,0,34,27
1657116239739,MATH 193A,A02,083225,Rotar; Vladimir,5,0,34,29
1657116239739,MATH 193A,A03,083781,Rotar; Vladimir,1,0,34,33
1657116239739,MATH 193A,A04,083782,Rotar; Vladimir,6,0,34,28
1657116239739,MATH 193A,A05,093482,Rotar; Vladimir,6,0,34,28
1657116245768,MATH 197,001,091859,McAuley; Julian John,9999,0,9999,0
1657116245768,MATH 197,002,095566,Kedlaya; Kiran S.,9997,0,9999,2
1657116245768,MATH 197,003,095567,Xiao; Ming,9999,0,9999,0
1657116245768,MATH 197,004,095571,Perols; Johan Lars,9998,0,9999,1
1657116252833,COGS 9,A01,083615,Shannon; Kyle Michael,7,0,75,68
1657116258870,COGS 11,A01,083617,Boyle; Mary E. T.,21,0,48,27
1657116264904,COGS 13,A01,083071,Bastos; Amalia Pinkusfeld,9,0,71,62
1657116271004,COGS 14A,A01,092681,Semenuks; Arturs,1,1,100,99
1657116277033,COGS 14B,A01,083073,Cheng; Tzu-Han,6,0,63,57
1657116283061,COGS 17,A01,092677,Semenuks; Arturs,4,0,81,77
1657116289089,COGS 100,A01,083619,Allen; Michael Gordon,15,0,70,55
1657116295122,COGS 101A,A01,083621,Davis; Joshua Daniel,9,0,68,59
1657116301149,COGS 101B,A01,091572,Allen; Michael Gordon,8,0,65,57
1657116307177,COGS 101C,A01,083625,Delgado; Tania,17,0,35,18
1657116313203,COGS 107A,A01,083627,Boyle; Mary E. T.,13,0,60,47
1657116319231,COGS 118A,A01,083075,Gupta; Anjum,15,0,76,61
1657116325260,CSE 3,A50,083646,Miranda; Gregory Joseph,22,0,50,28
1657116331285,CSE 8A,A50,083650,Miranda; Gregory Joseph,17,1,56,39
1657116337309,CSE 11,A01,083080,Cao; Yingjun,4,15,40,36
1657116343336,CSE 12,A01,083652,Krause-Levy; Sophia Louisa,23,1,120,97
1657116349363,CSE 15L,A01,083654,Morris; Justin Loren,9,0,50,41
1657116349363,CSE 15L,A02,083655,Morris; Justin Loren,9,0,50,41
1657116355387,CSE 20,A01,083657,Tran; Khoa Dang,37,0,80,43
1657116361411,CSE 21,A01,095574,Bach; Quang Tran,21,0,48,27
1657116367440,CSE 30,A01,083084,Eldon; John,4,0,80,76
1657116367440,CSE 30,B01,095061,Bhaskar; Nishant,6,0,50,44
1657116373466,CSE 100,A01,083659,Cao; Yingjun,4,4,70,66
1657116379501,CSE 134B,A01,083661,Powell; Thomas Allan,19,0,100,81
1657116385532,CSE 140,A01,083663,Gungor; Onat,14,0,85,71
1657116391560,CSE 140L,A01,083088,Eldon; John,17,0,100,83
1657116397587,CSE 175,A01,083665,Kumar; Rakesh,3,0,25,22
1657116403613,CSE 190,A00,092507,Dubnov; Shlomo,7,0,20,13
1657116409636,ECE 45,A01,083139,Congero; Spencer William,5,0,75,70
1657116415659,ECE 65,A50,083695,Saad; Andrew S,12,0,30,18
1657116415659,ECE 65,A51,095125,Saad; Andrew S,25,0,26,1
1657116421682,ECE 109,A01,091882,Touri; Behrouz,16,0,70,54
1657116427705,ECE 180,A00,083140,Abi Samra; Nicholas Camill,1,0,30,29
1657116427705,ECE 180,B00,083141,Abi Samra; Nicholas Camill,0,0,30,30
1657116433733,MATH 10A,A01,083735,Patchell; Gregory David,1,0,30,29
1657116433733,MATH 10A,A02,083736,Patchell; Gregory David,20,0,30,10
1657116433733,MATH 10A,A03,083737,Patchell; Gregory David,16,0,30,14
1657116439762,MATH 10B,A01,083207,Lim; Seonhee,7,0,34,27
1657116439762,MATH 10B,A02,083208,Lim; Seonhee,9,0,35,26
1657116439762,MATH 10B,A03,093472,Lim; Seonhee,5,0,34,29
1657116439762,MATH 10B,B01,083739,Sinha; Shubham,9,0,30,21
1657116445787,MATH 18,A01,083743,Cinel; Cameron Alexander,6,0,30,24
1657116445787,MATH 18,A02,083744,Cinel; Cameron Alexander,15,0,30,15
1657116445787,MATH 18,A03,083745,Cinel; Cameron Alexander,8,0,30,22
1657116445787,MATH 18,B01,083748,Rideout; David Porter,4,0,37,33
1657116445787,MATH 18,B02,083749,Rideout; David Porter,3,0,36,33
1657116445787,MATH 18,B03,083750,Rideout; David Porter,2,0,37,35
1657116445787,MATH 18,B04,083751,Rideout; David Porter,5,0,36,31
1657116445787,MATH 18,B05,093473,Rideout; David Porter,4,0,36,32
1657116445787,MATH 18,B06,093474,Rideout; David Porter,5,0,36,31
1657116451822,MATH 20A,A01,083754,Zheng; Zequn,12,0,40,28
1657116457853,MATH 20B,A01,083756,Briones; Jor-el Thomas Caparas,1,0,36,35
1657116457853,MATH 20B,A02,083757,Briones; Jor-el Thomas Caparas,1,0,36,35
1657116457853,MATH 20B,A03,093475,Briones; Jor-el Thomas Caparas,0,0,36,36
1657116463882,MATH 20C,A01,083760,Briones; Jor-el Thomas Caparas,1,0,35,34
1657116463882,MATH 20C,A02,083761,Briones; Jor-el Thomas Caparas,8,0,35,27
1657116463882,MATH 20C,A03,093476,Briones; Jor-el Thomas Caparas,0,1,36,36
1657116463882,MATH 20C,B01,083762,Bach; Quang Tran,0,0,30,30
1657116469909,MATH 20D,A01,083765,Tran; Brian Kha,4,0,30,26
1657116469909,MATH 20D,A02,083766,Tran; Brian Kha,5,0,30,25
1657116469909,MATH 20D,A03,083767,Tran; Brian Kha,3,0,30,27
1657116475939,MATH 20E,A01,083771,Ganguly; Soumya,6,0,32,26
1657116475939,MATH 20E,A02,083772,Ganguly; Soumya,6,0,32,26
1657116475939,MATH 20E,B01,083773,Ciotti; Benjamin,18,0,35,17
1657116475939,MATH 20E,B02,083774,Ciotti; Benjamin,17,0,35,18
1657116481975,MATH 103A,A01,083777,Greenfeld; Be'Eri,2,0,36,34
1657116481975,MATH 103A,A02,083778,Greenfeld; Be'Eri,5,0,36,31
1657116481975,MATH 103A,A03,093561,Greenfeld; Be'Eri,4,0,36,32
1657116481975,MATH 103A,B01,083779,Greenfeld; Be'Eri,6,0,36,30
1657116481975,MATH 103A,B02,083780,Greenfeld; Be'Eri,2,0,36,34
1657116481975,MATH 103A,B03,093562,Greenfeld; Be'Eri,3,0,36,33
1657116488001,MATH 105,A01,085443,Carter; Anne Toulson,14,0,35,21
1657116488001,MATH 105,A02,093477,Carter; Anne Toulson,20,0,35,15
1657116494030,MATH 109,A01,083213,Ganzberger; Geoffrey Michael,2,0,34,32
1657116494030,MATH 109,A02,083214,Ganzberger; Geoffrey Michael,3,0,34,31
1657116494030,MATH 109,A03,093478,Ganzberger; Geoffrey Michael,1,0,34,33
1657116494030,MATH 109,B01,083215,Ganzberger; Geoffrey Michael,1,0,32,31
1657116494030,MATH 109,B02,083216,Ganzberger; Geoffrey Michael,1,0,32,31
1657116494030,MATH 109,B03,093479,Ganzberger; Geoffrey Michael,6,0,32,26
1657116500054,MATH 142A,A01,083219,Chow; Bennett,6,0,32,26
1657116500054,MATH 142A,A02,083220,Chow; Bennett,10,0,32,22
1657116500054,MATH 142A,A03,093480,Chow; Bennett,7,0,32,25
1657116500054,MATH 142A,B03,093481,Chow; Bennett,8,0,32,24
1657116500054,MATH 142A,B04,093558,Chow; Bennett,11,0,32,21
1657116500054,MATH 142A,B05,093559,Chow; Bennett,6,0,32,26
1657116506083,MATH 193A,A01,083224,Rotar; Vladimir,7,0,34,27
1657116506083,MATH 193A,A02,083225,Rotar; Vladimir,5,0,34,29
1657116506083,MATH 193A,A03,083781,Rotar; Vladimir,1,0,34,33
1657116506083,MATH 193A,A04,083782,Rotar; Vladimir,6,0,34,28
1657116506083,MATH 193A,A05,093482,Rotar; Vladimir,6,0,34,28
1657116512111,MATH 197,001,091859,McAuley; Julian John,9999,0,9999,0
1657116512111,MATH 197,002,095566,Kedlaya; Kiran S.,9997,0,9999,2
1657116512111,MATH 197,003,095567,Xiao; Ming,9999,0,9999,0
1657116512111,MATH 197,004,095571,Perols; Johan Lars,9998,0,9999,1
1657116519176,COGS 9,A01,083615,Shannon; Kyle Michael,7,0,75,68
1657116525205,COGS 11,A01,083617,Boyle; Mary E. T.,21,0,48,27
1657116531232,COGS 13,A01,083071,Bastos; Amalia Pinkusfeld,9,0,71,62
1657116537258,COGS 14A,A01,092681,Semenuks; Arturs,1,1,100,99
1657116543287,COGS 14B,A01,083073,Cheng; Tzu-Han,6,0,63,57
1657116549319,COGS 17,A01,092677,Semenuks; Arturs,4,0,81,77
1657116555348,COGS 100,A01,083619,Allen; Michael Gordon,15,0,70,55
1657116561376,COGS 101A,A01,083621,Davis; Joshua Daniel,9,0,68,59
1657116567405,COGS 101B,A01,091572,Allen; Michael Gordon,8,0,65,57
1657116573430,COGS 101C,A01,083625,Delgado; Tania,17,0,35,18
1657116579462,COGS 107A,A01,083627,Boyle; Mary E. T.,13,0,60,47
1657116585491,COGS 118A,A01,083075,Gupta; Anjum,15,0,76,61
1657116591515,CSE 3,A50,083646,Miranda; Gregory Joseph,22,0,50,28
1657116597553,CSE 8A,A50,083650,Miranda; Gregory Joseph,17,1,56,39
1657116603579,CSE 11,A01,083080,Cao; Yingjun,4,15,40,36
1657116609603,CSE 12,A01,083652,Krause-Levy; Sophia Louisa,23,1,120,97
1657116615631,CSE 15L,A01,083654,Morris; Justin Loren,9,0,50,41
1657116615631,CSE 15L,A02,083655,Morris; Justin Loren,9,0,50,41
1657116621655,CSE 20,A01,083657,Tran; Khoa Dang,37,0,80,43
1657116627690,CSE 21,A01,095574,Bach; Quang Tran,21,0,48,27
1657116633719,CSE 30,A01,083084,Eldon; John,4,0,80,76
1657116633719,CSE 30,B01,095061,Bhaskar; Nishant,6,0,50,44
1657116639741,CSE 100,A01,083659,Cao; Yingjun,4,4,70,66
1657116645769,CSE 134B,A01,083661,Powell; Thomas Allan,19,0,100,81
1657116651793,CSE 140,A01,083663,Gungor; Onat,14,0,85,71
1657116657830,CSE 140L,A01,083088,Eldon; John,17,0,100,83
1657116663856,CSE 175,A01,083665,Kumar; Rakesh,3,0,25,22
1657116669880,CSE 190,A00,092507,Dubnov; Shlomo,7,0,20,13
1657116675907,ECE 45,A01,083139,Congero; Spencer William,5,0,75,70
1657116681938,ECE 65,A50,083695,Saad; Andrew S,12,0,30,18
1657116681938,ECE 65,A51,095125,Saad; Andrew S,25,0,26,1
1657116687964,ECE 109,A01,091882,Touri; Behrouz,16,0,70,54
1657116693992,ECE 180,A00,083140,Abi Samra; Nicholas Camill,1,0,30,29
1657116693992,ECE 180,B00,083141,Abi Samra; Nicholas Camill,0,0,30,30
1657116700017,MATH 10A,A01,083735,Patchell; Gregory David,1,0,30,29
1657116700017,MATH 10A,A02,083736,Patchell; Gregory David,20,0,30,10
1657116700017,MATH 10A,A03,083737,Patchell; Gregory David,16,0,30,14
1657116706045,MATH 10B,A01,083207,Lim; Seonhee,7,0,34,27
1657116706045,MATH 10B,A02,083208,Lim; Seonhee,9,0,35,26
1657116706045,MATH 10B,A03,093472,Lim; Seonhee,5,0,34,29
1657116706045,MATH 10B,B01,083739,Sinha; Shubham,9,0,30,21
1657116712071,MATH 18,A01,083743,Cinel; Cameron Alexander,6,0,30,24
1657116712071,MATH 18,A02,083744,Cinel; Cameron Alexander,15,0,30,15
1657116712071,MATH 18,A03,083745,Cinel; Cameron Alexander,8,0,30,22
1657116712071,MATH 18,B01,083748,Rideout; David Porter,4,0,37,33
1657116712071,MATH 18,B02,083749,Rideout; David Porter,3,0,36,33
1657116712071,MATH 18,B03,083750,Rideout; David Porter,2,0,37,35
1657116712071,MATH 18,B04,083751,Rideout; David Porter,5,0,36,31
1657116712071,MATH 18,B05,093473,Rideout; David Porter,4,0,36,32
1657116712071,MATH 18,B06,093474,Rideout; David Porter,5,0,36,31
1657116718095,MATH 20A,A01,083754,Zheng; Zequn,12,0,40,28
1657116724120,MATH 20B,A01,083756,Briones; Jor-el Thomas Caparas,1,0,36,35
1657116724120,MATH 20B,A02,083757,Briones; Jor-el Thomas Caparas,1,0,36,35
1657116724120,MATH 20B,A03,093475,Briones; Jor-el Thomas Caparas,0,0,36,36
1657116730146,MATH 20C,A01,083760,Briones; Jor-el Thomas Caparas,1,0,35,34
1657116730146,MATH 20C,A02,083761,Briones; Jor-el Thomas Caparas,8,0,35,27
1657116730146,MATH 20C,A03,093476,Briones; Jor-el Thomas Caparas,0,1,36,36
1657116730146,MATH 20C,B01,083762,Bach; Quang Tran,0,0,30,30
1657116736172,MATH 20D,A01,083765,Tran; Brian Kha,4,0,30,26
1657116736172,MATH 20D,A02,083766,Tran; Brian Kha,5,0,30,25
1657116736172,MATH 20D,A03,083767,Tran; Brian Kha,3,0,30,27
1657116742198,MATH 20E,A01,083771,Ganguly; Soumya,6,0,32,26
1657116742198,MATH 20E,A02,083772,Ganguly; Soumya,6,0,32,26
1657116742198,MATH 20E,B01,083773,Ciotti; Benjamin,18,0,35,17
1657116742198,MATH 20E,B02,083774,Ciotti; Benjamin,17,0,35,18
1657116748230,MATH 103A,A01,083777,Greenfeld; Be'Eri,2,0,36,34
1657116748230,MATH 103A,A02,083778,Greenfeld; Be'Eri,5,0,36,31
1657116748230,MATH 103A,A03,093561,Greenfeld; Be'Eri,4,0,36,32
1657116748230,MATH 103A,B01,083779,Greenfeld; Be'Eri,6,0,36,30
1657116748230,MATH 103A,B02,083780,Greenfeld; Be'Eri,2,0,36,34
1657116748230,MATH 103A,B03,093562,Greenfeld; Be'Eri,3,0,36,33
1657116754259,MATH 105,A01,085443,Carter; Anne Toulson,14,0,35,21
1657116754259,MATH 105,A02,093477,Carter; Anne Toulson,20,0,35,15
1657116760291,MATH 109,A01,083213,Ganzberger; Geoffrey Michael,2,0,34,32
1657116760291,MATH 109,A02,083214,Ganzberger; Geoffrey Michael,3,0,34,31
1657116760291,MATH 109,A03,093478,Ganzberger; Geoffrey Michael,1,0,34,33
1657116760291,MATH 109,B01,083215,Ganzberger; Geoffrey Michael,1,0,32,31
1657116760291,MATH 109,B02,083216,Ganzberger; Geoffrey Michael,1,0,32,31
1657116760291,MATH 109,B03,093479,Ganzberger; Geoffrey Michael,6,0,32,26
1657116766317,MATH 142A,A01,083219,Chow; Bennett,6,0,32,26
1657116766317,MATH 142A,A02,083220,Chow; Bennett,10,0,32,22
1657116766317,MATH 142A,A03,093480,Chow; Bennett,7,0,32,25
1657116766317,MATH 142A,B03,093481,Chow; Bennett,8,0,32,24
1657116766317,MATH 142A,B04,093558,Chow; Bennett,11,0,32,21
1657116766317,MATH 142A,B05,093559,Chow; Bennett,6,0,32,26
1657116772347,MATH 193A,A01,083224,Rotar; Vladimir,7,0,34,27
1657116772347,MATH 193A,A02,083225,Rotar; Vladimir,5,0,34,29
1657116772347,MATH 193A,A03,083781,Rotar; Vladimir,1,0,34,33
1657116772347,MATH 193A,A04,083782,Rotar; Vladimir,6,0,34,28
1657116772347,MATH 193A,A05,093482,Rotar; Vladimir,6,0,34,28
1657116778372,MATH 197,001,091859,McAuley; Julian John,9999,0,9999,0
1657116778372,MATH 197,002,095566,Kedlaya; Kiran S.,9997,0,9999,2
1657116778372,MATH 197,003,095567,Xiao; Ming,9999,0,9999,0
1657116778372,MATH 197,004,095571,Perols; Johan Lars,9998,0,9999,1
1657116785449,COGS 9,A01,083615,Shannon; Kyle Michael,7,0,75,68
1657116791486,COGS 11,A01,083617,Boyle; Mary E. T.,21,0,48,27
1657116797511,COGS 13,A01,083071,Bastos; Amalia Pinkusfeld,9,0,71,62
1657116803538,COGS 14A,A01,092681,Semenuks; Arturs,1,1,100,99
1657116809567,COGS 14B,A01,083073,Cheng; Tzu-Han,6,0,63,57
1657116815590,COGS 17,A01,092677,Semenuks; Arturs,4,0,81,77
1657116821624,COGS 100,A01,083619,Allen; Michael Gordon,15,0,70,55
1657116827653,COGS 101A,A01,083621,Davis; Joshua Daniel,9,0,68,59
1657116833678,COGS 101B,A01,091572,Allen; Michael Gordon,8,0,65,57
1657116839707,COGS 101C,A01,083625,Delgado; Tania,17,0,35,18
1657116845732,COGS 107A,A01,083627,Boyle; Mary E. T.,13,0,60,47
1657116851759,COGS 118A,A01,083075,Gupta; Anjum,15,0,76,61
1657116857796,CSE 3,A50,083646,Miranda; Gregory Joseph,22,0,50,28
1657116863821,CSE 8A,A50,083650,Miranda; Gregory Joseph,17,1,56,39
1657116869947,CSE 11,A01,083080,Cao; Yingjun,4,15,40,36
1657116875969,CSE 12,A01,083652,Krause-Levy; Sophia Louisa,23,1,120,97
1657116881996,CSE 15L,A01,083654,Morris; Justin Loren,9,0,50,41
1657116881996,CSE 15L,A02,083655,Morris; Justin Loren,9,0,50,41
1657116888022,CSE 20,A01,083657,Tran; Khoa Dang,37,0,80,43
1657116894054,CSE 21,A01,095574,Bach; Quang Tran,21,0,48,27
1657116900077,CSE 30,A01,083084,Eldon; John,4,0,80,76
1657116900077,CSE 30,B01,095061,Bhaskar; Nishant,6,0,50,44
1657116906099,CSE 100,A01,083659,Cao; Yingjun,4,4,70,66
1657116912122,CSE 134B,A01,083661,Powell; Thomas Allan,19,0,100,81
1657116918145,CSE 140,A01,083663,Gungor; Onat,14,0,85,71
1657116924171,CSE 140L,A01,083088,Eldon; John,17,0,100,83
1657116930195,CSE 175,A01,083665,Kumar; Rakesh,3,0,25,22
1657116936218,CSE 190,A00,092507,Dubnov; Shlomo,7,0,20,13
1657116942246,ECE 45,A01,083139,Congero; Spencer William,5,0,75,70
1657116948281,ECE 65,A50,083695,Saad; Andrew S,12,0,30,18
1657116948281,ECE 65,A51,095125,Saad; Andrew S,25,0,26,1
1657116954311,ECE 109,A01,091882,Touri; Behrouz,16,0,70,54
1657116960341,ECE 180,A00,083140,Abi Samra; Nicholas Camill,1,0,30,29
1657116960341,ECE 180,B00,083141,Abi Samra; Nicholas Camill,0,0,30,30
1657116966367,MATH 10A,A01,083735,Patchell; Gregory David,1,0,30,29
1657116966367,MATH 10A,A02,083736,Patchell; Gregory David,20,0,30,10
1657116966367,MATH 10A,A03,083737,Patchell; Gregory David,16,0,30,14
1657116972394,MATH 10B,A01,083207,Lim; Seonhee,7,0,34,27
1657116972394,MATH 10B,A02,083208,Lim; Seonhee,9,0,35,26
1657116972394,MATH 10B,A03,093472,Lim; Seonhee,5,0,34,29
1657116972394,MATH 10B,B01,083739,Sinha; Shubham,9,0,30,21
1657116978421,MATH 18,A01,083743,Cinel; Cameron Alexander,6,0,30,24
1657116978421,MATH 18,A02,083744,Cinel; Cameron Alexander,15,0,30,15
1657116978421,MATH 18,A03,083745,Cinel; Cameron Alexander,8,0,30,22
1657116978421,MATH 18,B01,083748,Rideout; David Porter,4,0,37,33
1657116978421,MATH 18,B02,083749,Rideout; David Porter,3,0,36,33
1657116978421,MATH 18,B03,083750,Rideout; David Porter,2,0,37,35
1657116978421,MATH 18,B04,083751,Rideout; David Porter,5,0,36,31
1657116978421,MATH 18,B05,093473,Rideout; David Porter,4,0,36,32
1657116978421,MATH 18,B06,093474,Rideout; David Porter,5,0,36,31
1657116984448,MATH 20A,A01,083754,Zheng; Zequn,12,0,40,28
1657116990471,MATH 20B,A01,083756,Briones; Jor-el Thomas Caparas,1,0,36,35
1657116990471,MATH 20B,A02,083757,Briones; Jor-el Thomas Caparas,1,0,36,35
1657116990471,MATH 20B,A03,093475,Briones; Jor-el Thomas Caparas,0,0,36,36
1657116996496,MATH 20C,A01,083760,Briones; Jor-el Thomas Caparas,1,0,35,34
1657116996496,MATH 20C,A02,083761,Briones; Jor-el Thomas Caparas,8,0,35,27
1657116996496,MATH 20C,A03,093476,Briones; Jor-el Thomas Caparas,0,1,36,36
1657116996496,MATH 20C,B01,083762,Bach; Quang Tran,0,0,30,30
1657117002527,MATH 20D,A01,083765,Tran; Brian Kha,4,0,30,26
1657117002527,MATH 20D,A02,083766,Tran; Brian Kha,5,0,30,25
1657117002527,MATH 20D,A03,083767,Tran; Brian Kha,3,0,30,27
1657117008553,MATH 20E,A01,083771,Ganguly; Soumya,6,0,32,26
1657117008553,MATH 20E,A02,083772,Ganguly; Soumya,6,0,32,26
1657117008553,MATH 20E,B01,083773,Ciotti; Benjamin,18,0,35,17
1657117008553,MATH 20E,B02,083774,Ciotti; Benjamin,17,0,35,18
1657117014579,MATH 103A,A01,083777,Greenfeld; Be'Eri,2,0,36,34
1657117014579,MATH 103A,A02,083778,Greenfeld; Be'Eri,5,0,36,31
1657117014579,MATH 103A,A03,093561,Greenfeld; Be'Eri,4,0,36,32
1657117014579,MATH 103A,B01,083779,Greenfeld; Be'Eri,6,0,36,30
1657117014579,MATH 103A,B02,083780,Greenfeld; Be'Eri,2,0,36,34
1657117014579,MATH 103A,B03,093562,Greenfeld; Be'Eri,3,0,36,33
1657117020613,MATH 105,A01,085443,Carter; Anne Toulson,14,0,35,21
1657117020613,MATH 105,A02,093477,Carter; Anne Toulson,20,0,35,15
1657117026638,MATH 109,A01,083213,Ganzberger; Geoffrey Michael,2,0,34,32
1657117026638,MATH 109,A02,083214,Ganzberger; Geoffrey Michael,3,0,34,31
1657117026638,MATH 109,A03,093478,Ganzberger; Geoffrey Michael,1,0,34,33
1657117026638,MATH 109,B01,083215,Ganzberger; Geoffrey Michael,1,0,32,31
1657117026638,MATH 109,B02,083216,Ganzberger; Geoffrey Michael,1,0,32,31
1657117026638,MATH 109,B03,093479,Ganzberger; Geoffrey Michael,6,0,32,26
1657117032663,MATH 142A,A01,083219,Chow; Bennett,6,0,32,26
1657117032663,MATH 142A,A02,083220,Chow; Bennett,10,0,32,22
1657117032663,MATH 142A,A03,093480,Chow; Bennett,7,0,32,25
1657117032663,MATH 142A,B03,093481,Chow; Bennett,8,0,32,24
1657117032663,MATH 142A,B04,093558,Chow; Bennett,11,0,32,21
1657117032663,MATH 142A,B05,093559,Chow; Bennett,6,0,32,26
1657117038689,MATH 193A,A01,083224,Rotar; Vladimir,7,0,34,27
1657117038689,MATH 193A,A02,083225,Rotar; Vladimir,5,0,34,29
1657117038689,MATH 193A,A03,083781,Rotar; Vladimir,1,0,34,33
1657117038689,MATH 193A,A04,083782,Rotar; Vladimir,6,0,34,28
1657117038689,MATH 193A,A05,093482,Rotar; Vladimir,6,0,34,28
1657117044713,MATH 197,001,091859,McAuley; Julian John,9999,0,9999,0
1657117044713,MATH 197,002,095566,Kedlaya; Kiran S.,9997,0,9999,2
1657117044713,MATH 197,003,095567,Xiao; Ming,9999,0,9999,0
1657117044713,MATH 197,004,095571,Perols; Johan Lars,9998,0,9999,1
1657117051770,COGS 9,A01,083615,Shannon; Kyle Michael,7,0,75,68
1657117057795,COGS 11,A01,083617,Boyle; Mary E. T.,21,0,48,27
1657117063828,COGS 13,A01,083071,Bastos; Amalia Pinkusfeld,9,0,71,62
1657117069858,COGS 14A,A01,092681,Semenuks; Arturs,1,1,100,99
1657117075888,COGS 14B,A01,083073,Cheng; Tzu-Han,6,0,63,57
1657117081912,COGS 17,A01,092677,Semenuks; Arturs,4,0,81,77
1657117087944,COGS 100,A01,083619,Allen; Michael Gordon,15,0,70,55
1657117093966,COGS 101A,A01,083621,Davis; Joshua Daniel,9,0,68,59
1657117100001,COGS 101B,A01,091572,Allen; Michael Gordon,8,0,65,57
1657117106024,COGS 101C,A01,083625,Delgado; Tania,17,0,35,18
1657117112052,COGS 107A,A01,083627,Boyle; Mary E. T.,13,0,60,47
1657117118076,COGS 118A,A01,083075,Gupta; Anjum,15,0,76,61
1657117124105,CSE 3,A50,083646,Miranda; Gregory Joseph,22,0,50,28
1657117130131,CSE 8A,A50,083650,Miranda; Gregory Joseph,17,1,56,39
1657117136160,CSE 11,A01,083080,Cao; Yingjun,4,15,40,36
1657117142186,CSE 12,A01,083652,Krause-Levy; Sophia Louisa,23,1,120,97
1657117148219,CSE 15L,A01,083654,Morris; Justin Loren,9,0,50,41
1657117148219,CSE 15L,A02,083655,Morris; Justin Loren,9,0,50,41
1657117154244,CSE 20,A01,083657,Tran; Khoa Dang,37,0,80,43
1657117160269,CSE 21,A01,095574,Bach; Quang Tran,21,0,48,27
1657117166296,CSE 30,A01,083084,Eldon; John,4,0,80,76
1657117166296,CSE 30,B01,095061,Bhaskar; Nishant,6,0,50,44
1657117172323,CSE 100,A01,083659,Cao; Yingjun,4,4,70,66
1657117178351,CSE 134B,A01,083661,Powell; Thomas Allan,19,0,100,81
1657117184379,CSE 140,A01,083663,Gungor; Onat,14,0,85,71
1657117190408,CSE 140L,A01,083088,Eldon; John,17,0,100,83
1657117196432,CSE 175,A01,083665,Kumar; Rakesh,3,0,25,22
1657117202457,CSE 190,A00,092507,Dubnov; Shlomo,7,0,20,13
1657117208485,ECE 45,A01,083139,Congero; Spencer William,5,0,75,70
1657117214511,ECE 65,A50,083695,Saad; Andrew S,12,0,30,18
1657117214511,ECE 65,A51,095125,Saad; Andrew S,25,0,26,1
1657117220534,ECE 109,A01,091882,Touri; Behrouz,16,0,70,54
1657117226557,ECE 180,A00,083140,Abi Samra; Nicholas Camill,1,0,30,29
1657117226557,ECE 180,B00,083141,Abi Samra; Nicholas Camill,0,0,30,30
1657117232584,MATH 10A,A01,083735,Patchell; Gregory David,1,0,30,29
1657117232584,MATH 10A,A02,083736,Patchell; Gregory David,20,0,30,10
1657117232584,MATH 10A,A03,083737,Patchell; Gregory David,16,0,30,14
1657117238610,MATH 10B,A01,083207,Lim; Seonhee,7,0,34,27
1657117238610,MATH 10B,A02,083208,Lim; Seonhee,9,0,35,26
1657117238610,MATH 10B,A03,093472,Lim; Seonhee,5,0,34,29
1657117238610,MATH 10B,B01,083739,Sinha; Shubham,9,0,30,21
1657117244636,MATH 18,A01,083743,Cinel; Cameron Alexander,6,0,30,24
1657117244636,MATH 18,A02,083744,Cinel; Cameron Alexander,15,0,30,15
1657117244636,MATH 18,A03,083745,Cinel; Cameron Alexander,8,0,30,22
1657117244636,MATH 18,B01,083748,Rideout; David Porter,4,0,37,33
1657117244636,MATH 18,B02,083749,Rideout; David Porter,3,0,36,33
1657117244636,MATH 18,B03,083750,Rideout; David Porter,2,0,37,35
1657117244636,MATH 18,B04,083751,Rideout; David Porter,5,0,36,31
1657117244636,MATH 18,B05,093473,Rideout; David Porter,4,0,36,32
1657117244636,MATH 18,B06,093474,Rideout; David Porter,5,0,36,31
1657117250661,MATH 20A,A01,083754,Zheng; Zequn,12,0,40,28
1657117256683,MATH 20B,A01,083756,Briones; Jor-el Thomas Caparas,1,0,36,35
1657117256683,MATH 20B,A02,083757,Briones; Jor-el Thomas Caparas,1,0,36,35
1657117256683,MATH 20B,A03,093475,Briones; Jor-el Thomas Caparas,0,0,36,36
1657117262709,MATH 20C,A01,083760,Briones; Jor-el Thomas Caparas,1,0,35,34
1657117262709,MATH 20C,A02,083761,Briones; Jor-el Thomas Caparas,8,0,35,27
1657117262709,MATH 20C,A03,093476,Briones; Jor-el Thomas Caparas,0,1,36,36
1657117262709,MATH 20C,B01,083762,Bach; Quang Tran,0,0,30,30
1657117268736,MATH 20D,A01,083765,Tran; Brian Kha,4,0,30,26
1657117268736,MATH 20D,A02,083766,Tran; Brian Kha,5,0,30,25
1657117268736,MATH 20D,A03,083767,Tran; Brian Kha,3,0,30,27
1657117274762,MATH 20E,A01,083771,Ganguly; Soumya,6,0,32,26
1657117274762,MATH 20E,A02,083772,Ganguly; Soumya,6,0,32,26
1657117274762,MATH 20E,B01,083773,Ciotti; Benjamin,18,0,35,17
1657117274762,MATH 20E,B02,083774,Ciotti; Benjamin,17,0,35,18
1657117280790,MATH 103A,A01,083777,Greenfeld; Be'Eri,2,0,36,34
1657117280790,MATH 103A,A02,083778,Greenfeld; Be'Eri,5,0,36,31
1657117280790,MATH 103A,A03,093561,Greenfeld; Be'Eri,4,0,36,32
1657117280790,MATH 103A,B01,083779,Greenfeld; Be'Eri,6,0,36,30
1657117280790,MATH 103A,B02,083780,Greenfeld; Be'Eri,2,0,36,34
1657117280790,MATH 103A,B03,093562,Greenfeld; Be'Eri,3,0,36,33
1657117286819,MATH 105,A01,085443,Carter; Anne Toulson,14,0,35,21
1657117286819,MATH 105,A02,093477,Carter; Anne Toulson,20,0,35,15
1657117292846,MATH 109,A01,083213,Ganzberger; Geoffrey Michael,2,0,34,32
1657117292846,MATH 109,A02,083214,Ganzberger; Geoffrey Michael,3,0,34,31
1657117292846,MATH 109,A03,093478,Ganzberger; Geoffrey Michael,1,0,34,33
1657117292846,MATH 109,B01,083215,Ganzberger; Geoffrey Michael,1,0,32,31
1657117292846,MATH 109,B02,083216,Ganzberger; Geoffrey Michael,1,0,32,31
1657117292846,MATH 109,B03,093479,Ganzberger; Geoffrey Michael,6,0,32,26
1657117298877,MATH 142A,A01,083219,Chow; Bennett,6,0,32,26
1657117298877,MATH 142A,A02,083220,Chow; Bennett,10,0,32,22
1657117298877,MATH 142A,A03,093480,Chow; Bennett,7,0,32,25
1657117298877,MATH 142A,B03,093481,Chow; Bennett,8,0,32,24
1657117298877,MATH 142A,B04,093558,Chow; Bennett,11,0,32,21
1657117298877,MATH 142A,B05,093559,Chow; Bennett,6,0,32,26
1657117304908,MATH 193A,A01,083224,Rotar; Vladimir,7,0,34,27
1657117304908,MATH 193A,A02,083225,Rotar; Vladimir,5,0,34,29
1657117304908,MATH 193A,A03,083781,Rotar; Vladimir,1,0,34,33
1657117304908,MATH 193A,A04,083782,Rotar; Vladimir,6,0,34,28
1657117304908,MATH 193A,A05,093482,Rotar; Vladimir,6,0,34,28
1657117310935,MATH 197,001,091859,McAuley; Julian John,9999,0,9999,0
1657117310935,MATH 197,002,095566,Kedlaya; Kiran S.,9997,0,9999,2
1657117310935,MATH 197,003,095567,Xiao; Ming,9999,0,9999,0
1657117310935,MATH 197,004,095571,Perols; Johan Lars,9998,0,9999,1
1657117317996,COGS 9,A01,083615,Shannon; Kyle Michael,7,0,75,68
1657117324020,COGS 11,A01,083617,Boyle; Mary E. T.,21,0,48,27
1657117330045,COGS 13,A01,083071,Bastos; Amalia Pinkusfeld,9,0,71,62
1657117336073,COGS 14A,A01,092681,Semenuks; Arturs,1,1,100,99
1657117342101,COGS 14B,A01,083073,Cheng; Tzu-Han,6,0,63,57
1657117348125,COGS 17,A01,092677,Semenuks; Arturs,4,0,81,77
1657117354154,COGS 100,A01,083619,Allen; Michael Gordon,15,0,70,55
1657117360182,COGS 101A,A01,083621,Davis; Joshua Daniel,9,0,68,59
1657117366209,COGS 101B,A01,091572,Allen; Michael Gordon,8,0,65,57
1657117372237,COGS 101C,A01,083625,Delgado; Tania,17,0,35,18
1657117378266,COGS 107A,A01,083627,Boyle; Mary E. T.,13,0,60,47
1657117384293,COGS 118A,A01,083075,Gupta; Anjum,15,0,76,61
1657117390317,CSE 3,A50,083646,Miranda; Gregory Joseph,22,0,50,28
1657117396341,CSE 8A,A50,083650,Miranda; Gregory Joseph,17,1,56,39
1657117402367,CSE 11,A01,083080,Cao; Yingjun,4,15,40,36
1657117408390,CSE 12,A01,083652,Krause-Levy; Sophia Louisa,23,1,120,97
1657117414419,CSE 15L,A01,083654,Morris; Justin Loren,9,0,50,41
1657117414419,CSE 15L,A02,083655,Morris; Justin Loren,9,0,50,41
1657117420458,CSE 20,A01,083657,Tran; Khoa Dang,37,0,80,43
1657117426485,CSE 21,A01,095574,Bach; Quang Tran,21,0,48,27
1657117432516,CSE 30,A01,083084,Eldon; John,4,0,80,76
1657117432516,CSE 30,B01,095061,Bhaskar; Nishant,6,0,50,44
1657117438548,CSE 100,A01,083659,Cao; Yingjun,4,4,70,66
1657117444579,CSE 134B,A01,083661,Powell; Thomas Allan,19,0,100,81
1657117450605,CSE 140,A01,083663,Gungor; Onat,14,0,85,71
1657117456632,CSE 140L,A01,083088,Eldon; John,17,0,100,83
1657117462662,CSE 175,A01,083665,Kumar; Rakesh,3,0,25,22
1657117468775,CSE 190,A00,092507,Dubnov; Shlomo,7,0,20,13
1657117474804,ECE 45,A01,083139,Congero; Spencer William,5,0,75,70
1657117480836,ECE 65,A50,083695,Saad; Andrew S,12,0,30,18
1657117480836,ECE 65,A51,095125,Saad; Andrew S,25,0,26,1
1657117486860,ECE 109,A01,091882,Touri; Behrouz,16,0,70,54
1657117492886,ECE 180,A00,083140,Abi Samra; Nicholas Camill,1,0,30,29
1657117492886,ECE 180,B00,083141,Abi Samra; Nicholas Camill,0,0,30,30
1657117498911,MATH 10A,A01,083735,Patchell; Gregory David,1,0,30,29
1657117498911,MATH 10A,A02,083736,Patchell; Gregory David,20,0,30,10
1657117498911,MATH 10A,A03,083737,Patchell; Gregory David,16,0,30,14
1657117504935,MATH 10B,A01,083207,Lim; Seonhee,7,0,34,27
1657117504935,MATH 10B,A02,083208,Lim; Seonhee,9,0,35,26
1657117504935,MATH 10B,A03,093472,Lim; Seonhee,5,0,34,29
1657117504935,MATH 10B,B01,083739,Sinha; Shubham,9,0,30,21
1657117510959,MATH 18,A01,083743,Cinel; Cameron Alexander,6,0,30,24
1657117510959,MATH 18,A02,083744,Cinel; Cameron Alexander,15,0,30,15
1657117510959,MATH 18,A03,083745,Cinel; Cameron Alexander,8,0,30,22
1657117510959,MATH 18,B01,083748,Rideout; David Porter,4,0,37,33
1657117510959,MATH 18,B02,083749,Rideout; David Porter,3,0,36,33
1657117510959,MATH 18,B03,083750,Rideout; David Porter,2,0,37,35
1657117510959,MATH 18,B04,083751,Rideout; David Porter,5,0,36,31
1657117510959,MATH 18,B05,093473,Rideout; David Porter,4,0,36,32
1657117510959,MATH 18,B06,093474,Rideout; David Porter,5,0,36,31
1657117516984,MATH 20A,A01,083754,Zheng; Zequn,12,0,40,28
1657117523008,MATH 20B,A01,083756,Briones; Jor-el Thomas Caparas,1,0,36,35
1657117523008,MATH 20B,A02,083757,Briones; Jor-el Thomas Caparas,1,0,36,35
1657117523008,MATH 20B,A03,093475,Briones; Jor-el Thomas Caparas,0,0,36,36
1657117529034,MATH 20C,A01,083760,Briones; Jor-el Thomas Caparas,1,0,35,34
1657117529034,MATH 20C,A02,083761,Briones; Jor-el Thomas Caparas,8,0,35,27
1657117529034,MATH 20C,A03,093476,Briones; Jor-el Thomas Caparas,0,1,36,36
1657117529034,MATH 20C,B01,083762,Bach; Quang Tran,0,0,30,30
1657117535060,MATH 20D,A01,083765,Tran; Brian Kha,4,0,30,26
1657117535060,MATH 20D,A02,083766,Tran; Brian Kha,5,0,30,25
1657117535060,MATH 20D,A03,083767,Tran; Brian Kha,3,0,30,27
1657117541090,MATH 20E,A01,083771,Ganguly; Soumya,6,0,32,26
1657117541090,MATH 20E,A02,083772,Ganguly; Soumya,6,0,32,26
1657117541090,MATH 20E,B01,083773,Ciotti; Benjamin,18,0,35,17
1657117541090,MATH 20E,B02,083774,Ciotti; Benjamin,17,0,35,18
1657117547115,MATH 103A,A01,083777,Greenfeld; Be'Eri,2,0,36,34
1657117547115,MATH 103A,A02,083778,Greenfeld; Be'Eri,5,0,36,31
1657117547115,MATH 103A,A03,093561,Greenfeld; Be'Eri,4,0,36,32
1657117547115,MATH 103A,B01,083779,Greenfeld; Be'Eri,6,0,36,30
1657117547115,MATH 103A,B02,083780,Greenfeld; Be'Eri,2,0,36,34
1657117547115,MATH 103A,B03,093562,Greenfeld; Be'Eri,3,0,36,33
1657117553147,MATH 105,A01,085443,Carter; Anne Toulson,14,0,35,21
1657117553147,MATH 105,A02,093477,Carter; Anne Toulson,20,0,35,15
1657117559171,MATH 109,A01,083213,Ganzberger; Geoffrey Michael,2,0,34,32
1657117559171,MATH 109,A02,083214,Ganzberger; Geoffrey Michael,3,0,34,31
1657117559171,MATH 109,A03,093478,Ganzberger; Geoffrey Michael,1,0,34,33
1657117559171,MATH 109,B01,083215,Ganzberger; Geoffrey Michael,1,0,32,31
1657117559171,MATH 109,B02,083216,Ganzberger; Geoffrey Michael,1,0,32,31
1657117559171,MATH 109,B03,093479,Ganzberger; Geoffrey Michael,6,0,32,26
1657117565212,MATH 142A,A01,083219,Chow; Bennett,6,0,32,26
1657117565212,MATH 142A,A02,083220,Chow; Bennett,10,0,32,22
1657117565212,MATH 142A,A03,093480,Chow; Bennett,7,0,32,25
1657117565212,MATH 142A,B03,093481,Chow; Bennett,8,0,32,24
1657117565212,MATH 142A,B04,093558,Chow; Bennett,11,0,32,21
1657117565212,MATH 142A,B05,093559,Chow; Bennett,6,0,32,26
1657117571236,MATH 193A,A01,083224,Rotar; Vladimir,7,0,34,27
1657117571236,MATH 193A,A02,083225,Rotar; Vladimir,5,0,34,29
1657117571236,MATH 193A,A03,083781,Rotar; Vladimir,1,0,34,33
1657117571236,MATH 193A,A04,083782,Rotar; Vladimir,6,0,34,28
1657117571236,MATH 193A,A05,093482,Rotar; Vladimir,6,0,34,28
1657117577265,MATH 197,001,091859,McAuley; Julian John,9999,0,9999,0
1657117577265,MATH 197,002,095566,Kedlaya; Kiran S.,9997,0,9999,2
1657117577265,MATH 197,003,095567,Xiao; Ming,9999,0,9999,0
1657117577265,MATH 197,004,095571,Perols; Johan Lars,9998,0,9999,1
1657117584336,COGS 9,A01,083615,Shannon; Kyle Michael,7,0,75,68
1657117590363,COGS 11,A01,083617,Boyle; Mary E. T.,21,0,48,27
1657117596391,COGS 13,A01,083071,Bastos; Amalia Pinkusfeld,9,0,71,62
1657117602414,COGS 14A,A01,092681,Semenuks; Arturs,1,1,100,99
1657117608449,COGS 14B,A01,083073,Cheng; Tzu-Han,6,0,63,57
1657117614473,COGS 17,A01,092677,Semenuks; Arturs,4,0,81,77
1657117620500,COGS 100,A01,083619,Allen; Michael Gordon,15,0,70,55
1657117626523,COGS 101A,A01,083621,Davis; Joshua Daniel,9,0,68,59
1657117632552,COGS 101B,A01,091572,Allen; Michael Gordon,8,0,65,57
1657117638580,COGS 101C,A01,083625,Delgado; Tania,17,0,35,18
1657117644608,COGS 107A,A01,083627,Boyle; Mary E. T.,13,0,60,47
1657117650630,COGS 118A,A01,083075,Gupta; Anjum,15,0,76,61
1657117656658,CSE 3,A50,083646,Miranda; Gregory Joseph,22,0,50,28
1657117662682,CSE 8A,A50,083650,Miranda; Gregory Joseph,17,1,56,39
1657117668706,CSE 11,A01,083080,Cao; Yingjun,4,15,40,36
1657117674731,CSE 12,A01,083652,Krause-Levy; Sophia Louisa,23,1,120,97
1657117680755,CSE 15L,A01,083654,Morris; Justin Loren,9,0,50,41
1657117680755,CSE 15L,A02,083655,Morris; Justin Loren,9,0,50,41
1657117686785,CSE 20,A01,083657,Tran; Khoa Dang,37,0,80,43
1657117692813,CSE 21,A01,095574,Bach; Quang Tran,21,0,48,27
1657117698842,CSE 30,A01,083084,Eldon; John,4,0,80,76
1657117698842,CSE 30,B01,095061,Bhaskar; Nishant,6,0,50,44
1657117704864,CSE 100,A01,083659,Cao; Yingjun,4,4,70,66
1657117710890,CSE 134B,A01,083661,Powell; Thomas Allan,19,0,100,81
1657117716924,CSE 140,A01,083663,Gungor; Onat,14,0,85,71
1657117722958,CSE 140L,A01,083088,Eldon; John,17,0,100,83
1657117728989,CSE 175,A01,083665,Kumar; Rakesh,3,0,25,22
1657117735013,CSE 190,A00,092507,Dubnov; Shlomo,7,0,20,13
1657117741042,ECE 45,A01,083139,Congero; Spencer William,5,0,75,70
1657117747066,ECE 65,A50,083695,Saad; Andrew S,12,0,30,18
1657117747066,ECE 65,A51,095125,Saad; Andrew S,25,0,26,1
1657117753090,ECE 109,A01,091882,Touri; Behrouz,16,0,70,54
1657117759119,ECE 180,A00,083140,Abi Samra; Nicholas Camill,1,0,30,29
1657117759119,ECE 180,B00,083141,Abi Samra; Nicholas Camill,0,0,30,30
1657117765143,MATH 10A,A01,083735,Patchell; Gregory David,1,0,30,29
1657117765143,MATH 10A,A02,083736,Patchell; Gregory David,20,0,30,10
1657117765143,MATH 10A,A03,083737,Patchell; Gregory David,16,0,30,14
1657117771171,MATH 10B,A01,083207,Lim; Seonhee,7,0,34,27
1657117771171,MATH 10B,A02,083208,Lim; Seonhee,9,0,35,26
1657117771171,MATH 10B,A03,093472,Lim; Seonhee,5,0,34,29
1657117771171,MATH 10B,B01,083739,Sinha; Shubham,9,0,30,21
1657117777202,MATH 18,A01,083743,Cinel; Cameron Alexander,6,0,30,24
1657117777202,MATH 18,A02,083744,Cinel; Cameron Alexander,15,0,30,15
1657117777202,MATH 18,A03,083745,Cinel; Cameron Alexander,8,0,30,22
1657117777202,MATH 18,B01,083748,Rideout; David Porter,4,0,37,33
1657117777202,MATH 18,B02,083749,Rideout; David Porter,3,0,36,33
1657117777202,MATH 18,B03,083750,Rideout; David Porter,2,0,37,35
1657117777202,MATH 18,B04,083751,Rideout; David Porter,5,0,36,31
1657117777202,MATH 18,B05,093473,Rideout; David Porter,4,0,36,32
1657117777202,MATH 18,B06,093474,Rideout; David Porter,5,0,36,31
1657117783225,MATH 20A,A01,083754,Zheng; Zequn,12,0,40,28
1657117789248,MATH 20B,A01,083756,Briones; Jor-el Thomas Caparas,1,0,36,35
1657117789248,MATH 20B,A02,083757,Briones; Jor-el Thomas Caparas,1,0,36,35
1657117789248,MATH 20B,A03,093475,Briones; Jor-el Thomas Caparas,0,0,36,36
1657117797327,MATH 20C,A01,083760,Briones; Jor-el Thomas Caparas,1,0,35,34
1657117797327,MATH 20C,A02,083761,Briones; Jor-el Thomas Caparas,8,0,35,27
1657117797327,MATH 20C,A03,093476,Briones; Jor-el Thomas Caparas,0,1,36,36
1657117797327,MATH 20C,B01,083762,Bach; Quang Tran,0,0,30,30
1657117803356,MATH 20D,A01,083765,Tran; Brian Kha,4,0,30,26
1657117803356,MATH 20D,A02,083766,Tran; Brian Kha,5,0,30,25
1657117803356,MATH 20D,A03,083767,Tran; Brian Kha,3,0,30,27
1657117809383,MATH 20E,A01,083771,Ganguly; Soumya,6,0,32,26
1657117809383,MATH 20E,A02,083772,Ganguly; Soumya,6,0,32,26
1657117809383,MATH 20E,B01,083773,Ciotti; Benjamin,18,0,35,17
1657117809383,MATH 20E,B02,083774,Ciotti; Benjamin,17,0,35,18
1657117815423,MATH 103A,A01,083777,Greenfeld; Be'Eri,2,0,36,34
1657117815423,MATH 103A,A02,083778,Greenfeld; Be'Eri,5,0,36,31
1657117815423,MATH 103A,A03,093561,Greenfeld; Be'Eri,4,0,36,32
1657117815423,MATH 103A,B01,083779,Greenfeld; Be'Eri,6,0,36,30
1657117815423,MATH 103A,B02,083780,Greenfeld; Be'Eri,2,0,36,34
1657117815423,MATH 103A,B03,093562,Greenfeld; Be'Eri,3,0,36,33
1657117821446,MATH 105,A01,085443,Carter; Anne Toulson,14,0,35,21
1657117821446,MATH 105,A02,093477,Carter; Anne Toulson,20,0,35,15
1657117827475,MATH 109,A01,083213,Ganzberger; Geoffrey Michael,2,0,34,32
1657117827475,MATH 109,A02,083214,Ganzberger; Geoffrey Michael,3,0,34,31
1657117827475,MATH 109,A03,093478,Ganzberger; Geoffrey Michael,1,0,34,33
1657117827475,MATH 109,B01,083215,Ganzberger; Geoffrey Michael,1,0,32,31
1657117827475,MATH 109,B02,083216,Ganzberger; Geoffrey Michael,1,0,32,31
1657117827475,MATH 109,B03,093479,Ganzberger; Geoffrey Michael,6,0,32,26
1657117833499,MATH 142A,A01,083219,Chow; Bennett,6,0,32,26
1657117833499,MATH 142A,A02,083220,Chow; Bennett,10,0,32,22
1657117833499,MATH 142A,A03,093480,Chow; Bennett,7,0,32,25
1657117833499,MATH 142A,B03,093481,Chow; Bennett,8,0,32,24
1657117833499,MATH 142A,B04,093558,Chow; Bennett,11,0,32,21
1657117833499,MATH 142A,B05,093559,Chow; Bennett,6,0,32,26
1657117839530,MATH 193A,A01,083224,Rotar; Vladimir,7,0,34,27
1657117839530,MATH 193A,A02,083225,Rotar; Vladimir,5,0,34,29
1657117839530,MATH 193A,A03,083781,Rotar; Vladimir,1,0,34,33
1657117839530,MATH 193A,A04,083782,Rotar; Vladimir,6,0,34,28
1657117839530,MATH 193A,A05,093482,Rotar; Vladimir,6,0,34,28
1657117845560,MATH 197,001,091859,McAuley; Julian John,9999,0,9999,0
1657117845560,MATH 197,002,095566,Kedlaya; Kiran S.,9997,0,9999,2
1657117845560,MATH 197,003,095567,Xiao; Ming,9999,0,9999,0
1657117845560,MATH 197,004,095571,Perols; Johan Lars,9998,0,9999,1
1657117852621,COGS 9,A01,083615,Shannon; Kyle Michael,7,0,75,68
1657117858645,COGS 11,A01,083617,Boyle; Mary E. T.,21,0,48,27
1657117864673,COGS 13,A01,083071,Bastos; Amalia Pinkusfeld,9,0,71,62
1657117870695,COGS 14A,A01,092681,Semenuks; Arturs,1,1,100,99
1657117876717,COGS 14B,A01,083073,Cheng; Tzu-Han,6,0,63,57
1657117882740,COGS 17,A01,092677,Semenuks; Arturs,4,0,81,77
1657117888763,COGS 100,A01,083619,Allen; Michael Gordon,15,0,70,55
1657117894792,COGS 101A,A01,083621,Davis; Joshua Daniel,9,0,68,59
1657117900828,COGS 101B,A01,091572,Allen; Michael Gordon,8,0,65,57
1657117906856,COGS 101C,A01,083625,Delgado; Tania,17,0,35,18
1657117912881,COGS 107A,A01,083627,Boyle; Mary E. T.,13,0,60,47
1657117918909,COGS 118A,A01,083075,Gupta; Anjum,15,0,76,61
1657117924933,CSE 3,A50,083646,Miranda; Gregory Joseph,22,0,50,28
1657117930961,CSE 8A,A50,083650,Miranda; Gregory Joseph,17,1,56,39
1657117936985,CSE 11,A01,083080,Cao; Yingjun,4,15,40,36
1657117943009,CSE 12,A01,083652,Krause-Levy; Sophia Louisa,23,1,120,97
1657117949039,CSE 15L,A01,083654,Morris; Justin Loren,9,0,50,41
1657117949039,CSE 15L,A02,083655,Morris; Justin Loren,9,0,50,41
1657117955068,CSE 20,A01,083657,Tran; Khoa Dang,37,0,80,43
1657117961090,CSE 21,A01,095574,Bach; Quang Tran,21,0,48,27
1657117967118,CSE 30,A01,083084,Eldon; John,4,0,80,76
1657117967118,CSE 30,B01,095061,Bhaskar; Nishant,6,0,50,44
1657117973143,CSE 100,A01,083659,Cao; Yingjun,4,4,70,66
1657117979168,CSE 134B,A01,083661,Powell; Thomas Allan,19,0,100,81
1657117985194,CSE 140,A01,083663,Gungor; Onat,14,0,85,71
1657117991222,CSE 140L,A01,083088,Eldon; John,17,0,100,83
1657117997252,CSE 175,A01,083665,Kumar; Rakesh,3,0,25,22
1657118003279,CSE 190,A00,092507,Dubnov; Shlomo,7,0,20,13
1657118009303,ECE 45,A01,083139,Congero; Spencer William,5,0,75,70
1657118015326,ECE 65,A50,083695,Saad; Andrew S,12,0,30,18
1657118015326,ECE 65,A51,095125,Saad; Andrew S,25,0,26,1
1657118021350,ECE 109,A01,091882,Touri; Behrouz,16,0,70,54
1657118027379,ECE 180,A00,083140,Abi Samra; Nicholas Camill,1,0,30,29
1657118027379,ECE 180,B00,083141,Abi Samra; Nicholas Camill,0,0,30,30
1657118033402,MATH 10A,A01,083735,Patchell; Gregory David,1,0,30,29
1657118033402,MATH 10A,A02,083736,Patchell; Gregory David,20,0,30,10
1657118033402,MATH 10A,A03,083737,Patchell; Gregory David,16,0,30,14
1657118039432,MATH 10B,A01,083207,Lim; Seonhee,7,0,34,27
1657118039432,MATH 10B,A02,083208,Lim; Seonhee,9,0,35,26
1657118039432,MATH 10B,A03,093472,Lim; Seonhee,5,0,34,29
1657118039432,MATH 10B,B01,083739,Sinha; Shubham,9,0,30,21
1657118045462,MATH 18,A01,083743,Cinel; Cameron Alexander,6,0,30,24
1657118045462,MATH 18,A02,083744,Cinel; Cameron Alexander,15,0,30,15
1657118045462,MATH 18,A03,083745,Cinel; Cameron Alexander,8,0,30,22
1657118045462,MATH 18,B01,083748,Rideout; David Porter,4,0,37,33
1657118045462,MATH 18,B02,083749,Rideout; David Porter,3,0,36,33
1657118045462,MATH 18,B03,083750,Rideout; David Porter,2,0,37,35
1657118045462,MATH 18,B04,083751,Rideout; David Porter,5,0,36,31
1657118045462,MATH 18,B05,093473,Rideout; David Porter,4,0,36,32
1657118045462,MATH 18,B06,093474,Rideout; David Porter,5,0,36,31
1657118051485,MATH 20A,A01,083754,Zheng; Zequn,12,0,40,28
1657118057509,MATH 20B,A01,083756,Briones; Jor-el Thomas Caparas,1,0,36,35
1657118057509,MATH 20B,A02,083757,Briones; Jor-el Thomas Caparas,1,0,36,35
1657118057509,MATH 20B,A03,093475,Briones; Jor-el Thomas Caparas,0,0,36,36
1657118063534,MATH 20C,A01,083760,Briones; Jor-el Thomas Caparas,1,0,35,34
1657118063534,MATH 20C,A02,083761,Briones; Jor-el Thomas Caparas,8,0,35,27
1657118063534,MATH 20C,A03,093476,Briones; Jor-el Thomas Caparas,0,1,36,36
1657118063534,MATH 20C,B01,083762,Bach; Quang Tran,0,0,30,30
1657118069635,MATH 20D,A01,083765,Tran; Brian Kha,4,0,30,26
1657118069635,MATH 20D,A02,083766,Tran; Brian Kha,5,0,30,25
1657118069635,MATH 20D,A03,083767,Tran; Brian Kha,3,0,30,27
1657118075659,MATH 20E,A01,083771,Ganguly; Soumya,6,0,32,26
1657118075659,MATH 20E,A02,083772,Ganguly; Soumya,6,0,32,26
1657118075659,MATH 20E,B01,083773,Ciotti; Benjamin,18,0,35,17
1657118075659,MATH 20E,B02,083774,Ciotti; Benjamin,17,0,35,18
1657118081716,MATH 103A,A01,083777,Greenfeld; Be'Eri,2,0,36,34
1657118081716,MATH 103A,A02,083778,Greenfeld; Be'Eri,5,0,36,31
1657118081716,MATH 103A,A03,093561,Greenfeld; Be'Eri,4,0,36,32
1657118081716,MATH 103A,B01,083779,Greenfeld; Be'Eri,6,0,36,30
1657118081716,MATH 103A,B02,083780,Greenfeld; Be'Eri,2,0,36,34
1657118081716,MATH 103A,B03,093562,Greenfeld; Be'Eri,3,0,36,33
1657118087743,MATH 105,A01,085443,Carter; Anne Toulson,14,0,35,21
1657118087743,MATH 105,A02,093477,Carter; Anne Toulson,20,0,35,15
1657118093765,MATH 109,A01,083213,Ganzberger; Geoffrey Michael,2,0,34,32
1657118093765,MATH 109,A02,083214,Ganzberger; Geoffrey Michael,3,0,34,31
1657118093765,MATH 109,A03,093478,Ganzberger; Geoffrey Michael,1,0,34,33
1657118093765,MATH 109,B01,083215,Ganzberger; Geoffrey Michael,1,0,32,31
1657118093765,MATH 109,B02,083216,Ganzberger; Geoffrey Michael,1,0,32,31
1657118093765,MATH 109,B03,093479,Ganzberger; Geoffrey Michael,6,0,32,26
1657118099794,MATH 142A,A01,083219,Chow; Bennett,6,0,32,26
1657118099794,MATH 142A,A02,083220,Chow; Bennett,10,0,32,22
1657118099794,MATH 142A,A03,093480,Chow; Bennett,7,0,32,25
1657118099794,MATH 142A,B03,093481,Chow; Bennett,8,0,32,24
1657118099794,MATH 142A,B04,093558,Chow; Bennett,11,0,32,21
1657118099794,MATH 142A,B05,093559,Chow; Bennett,6,0,32,26
1657118105820,MATH 193A,A01,083224,Rotar; Vladimir,7,0,34,27
1657118105820,MATH 193A,A02,083225,Rotar; Vladimir,5,0,34,29
1657118105820,MATH 193A,A03,083781,Rotar; Vladimir,1,0,34,33
1657118105820,MATH 193A,A04,083782,Rotar; Vladimir,6,0,34,28
1657118105820,MATH 193A,A05,093482,Rotar; Vladimir,6,0,34,28
1657118111851,MATH 197,001,091859,McAuley; Julian John,9999,0,9999,0
1657118111851,MATH 197,002,095566,Kedlaya; Kiran S.,9997,0,9999,2
1657118111851,MATH 197,003,095567,Xiao; Ming,9999,0,9999,0
1657118111851,MATH 197,004,095571,Perols; Johan Lars,9998,0,9999,1
1657118118907,COGS 9,A01,083615,Shannon; Kyle Michael,7,0,75,68
1657118124929,COGS 11,A01,083617,Boyle; Mary E. T.,21,0,48,27
1657118131001,COGS 13,A01,083071,Bastos; Amalia Pinkusfeld,9,0,71,62
1657118137028,COGS 14A,A01,092681,Semenuks; Arturs,1,1,100,99
1657118143056,COGS 14B,A01,083073,Cheng; Tzu-Han,6,0,63,57
1657118149084,COGS 17,A01,092677,Semenuks; Arturs,4,0,81,77
1657118155113,COGS 100,A01,083619,Allen; Michael Gordon,15,0,70,55
1657118161144,COGS 101A,A01,083621,Davis; Joshua Daniel,9,0,68,59
1657118167170,COGS 101B,A01,091572,Allen; Michael Gordon,8,0,65,57
1657118173192,COGS 101C,A01,083625,Delgado; Tania,17,0,35,18
1657118179218,COGS 107A,A01,083627,Boyle; Mary E. T.,13,0,60,47
1657118185244,COGS 118A,A01,083075,Gupta; Anjum,15,0,76,61
1657118191267,CSE 3,A50,083646,Miranda; Gregory Joseph,22,0,50,28
1657118197294,CSE 8A,A50,083650,Miranda; Gregory Joseph,17,1,56,39
1657118203324,CSE 11,A01,083080,Cao; Yingjun,4,15,40,36
1657118209348,CSE 12,A01,083652,Krause-Levy; Sophia Louisa,23,1,120,97
1657118215374,CSE 15L,A01,083654,Morris; Justin Loren,9,0,50,41
1657118215374,CSE 15L,A02,083655,Morris; Justin Loren,9,0,50,41
1657118221407,CSE 20,A01,083657,Tran; Khoa Dang,37,0,80,43
1657118227437,CSE 21,A01,095574,Bach; Quang Tran,21,0,48,27
1657118233465,CSE 30,A01,083084,Eldon; John,4,0,80,76
1657118233465,CSE 30,B01,095061,Bhaskar; Nishant,6,0,50,44
1657118239491,CSE 100,A01,083659,Cao; Yingjun,4,4,70,66
1657118245513,CSE 134B,A01,083661,Powell; Thomas Allan,19,0,100,81
1657118251540,CSE 140,A01,083663,Gungor; Onat,14,0,85,71
1657118257564,CSE 140L,A01,083088,Eldon; John,17,0,100,83
1657118263586,CSE 175,A01,083665,Kumar; Rakesh,3,0,25,22
1657118269608,CSE 190,A00,092507,Dubnov; Shlomo,7,0,20,13
1657118275640,ECE 45,A01,083139,Congero; Spencer William,5,0,75,70
1657118281670,ECE 65,A50,083695,Saad; Andrew S,12,0,30,18
1657118281670,ECE 65,A51,095125,Saad; Andrew S,25,0,26,1
1657118287704,ECE 109,A01,091882,Touri; Behrouz,16,0,70,54
1657118293725,ECE 180,A00,083140,Abi Samra; Nicholas Camill,1,0,30,29
1657118293725,ECE 180,B00,083141,Abi Samra; Nicholas Camill,0,0,30,30
1657118299748,MATH 10A,A01,083735,Patchell; Gregory David,1,0,30,29
1657118299748,MATH 10A,A02,083736,Patchell; Gregory David,20,0,30,10
1657118299748,MATH 10A,A03,083737,Patchell; Gregory David,16,0,30,14
1657118305785,MATH 10B,A01,083207,Lim; Seonhee,7,0,34,27
1657118305785,MATH 10B,A02,083208,Lim; Seonhee,9,0,35,26
1657118305785,MATH 10B,A03,093472,Lim; Seonhee,5,0,34,29
1657118305785,MATH 10B,B01,083739,Sinha; Shubham,9,0,30,21
1657118311809,MATH 18,A01,083743,Cinel; Cameron Alexander,6,0,30,24
1657118311809,MATH 18,A02,083744,Cinel; Cameron Alexander,15,0,30,15
1657118311809,MATH 18,A03,083745,Cinel; Cameron Alexander,8,0,30,22
1657118311809,MATH 18,B01,083748,Rideout; David Porter,4,0,37,33
1657118311809,MATH 18,B02,083749,Rideout; David Porter,3,0,36,33
1657118311809,MATH 18,B03,083750,Rideout; David Porter,2,0,37,35
1657118311809,MATH 18,B04,083751,Rideout; David Porter,5,0,36,31
1657118311809,MATH 18,B05,093473,Rideout; David Porter,4,0,36,32
1657118311809,MATH 18,B06,093474,Rideout; David Porter,5,0,36,31
1657118317839,MATH 20A,A01,083754,Zheng; Zequn,12,0,40,28
1657118323863,MATH 20B,A01,083756,Briones; Jor-el Thomas Caparas,1,0,36,35
1657118323863,MATH 20B,A02,083757,Briones; Jor-el Thomas Caparas,1,0,36,35
1657118323863,MATH 20B,A03,093475,Briones; Jor-el Thomas Caparas,0,0,36,36
1657118329895,MATH 20C,A01,083760,Briones; Jor-el Thomas Caparas,1,0,35,34
1657118329895,MATH 20C,A02,083761,Briones; Jor-el Thomas Caparas,8,0,35,27
1657118329895,MATH 20C,A03,093476,Briones; Jor-el Thomas Caparas,0,1,36,36
1657118329895,MATH 20C,B01,083762,Bach; Quang Tran,0,0,30,30
1657118335919,MATH 20D,A01,083765,Tran; Brian Kha,4,0,30,26
1657118335919,MATH 20D,A02,083766,Tran; Brian Kha,5,0,30,25
1657118335919,MATH 20D,A03,083767,Tran; Brian Kha,3,0,30,27
1657118341948,MATH 20E,A01,083771,Ganguly; Soumya,6,0,32,26
1657118341948,MATH 20E,A02,083772,Ganguly; Soumya,6,0,32,26
1657118341948,MATH 20E,B01,083773,Ciotti; Benjamin,18,0,35,17
1657118341948,MATH 20E,B02,083774,Ciotti; Benjamin,17,0,35,18
1657118347975,MATH 103A,A01,083777,Greenfeld; Be'Eri,2,0,36,34
1657118347975,MATH 103A,A02,083778,Greenfeld; Be'Eri,5,0,36,31
1657118347975,MATH 103A,A03,093561,Greenfeld; Be'Eri,4,0,36,32
1657118347975,MATH 103A,B01,083779,Greenfeld; Be'Eri,6,0,36,30
1657118347975,MATH 103A,B02,083780,Greenfeld; Be'Eri,2,0,36,34
1657118347975,MATH 103A,B03,093562,Greenfeld; Be'Eri,3,0,36,33
1657118353999,MATH 105,A01,085443,Carter; Anne Toulson,14,0,35,21
1657118353999,MATH 105,A02,093477,Carter; Anne Toulson,20,0,35,15
1657118360030,MATH 109,A01,083213,Ganzberger; Geoffrey Michael,2,0,34,32
1657118360030,MATH 109,A02,083214,Ganzberger; Geoffrey Michael,3,0,34,31
1657118360030,MATH 109,A03,093478,Ganzberger; Geoffrey Michael,1,0,34,33
1657118360030,MATH 109,B01,083215,Ganzberger; Geoffrey Michael,1,0,32,31
1657118360030,MATH 109,B02,083216,Ganzberger; Geoffrey Michael,1,0,32,31
1657118360030,MATH 109,B03,093479,Ganzberger; Geoffrey Michael,6,0,32,26
1657118366053,MATH 142A,A01,083219,Chow; Bennett,6,0,32,26
1657118366053,MATH 142A,A02,083220,Chow; Bennett,10,0,32,22
1657118366053,MATH 142A,A03,093480,Chow; Bennett,7,0,32,25
1657118366053,MATH 142A,B03,093481,Chow; Bennett,8,0,32,24
1657118366053,MATH 142A,B04,093558,Chow; Bennett,11,0,32,21
1657118366053,MATH 142A,B05,093559,Chow; Bennett,6,0,32,26
1657118372084,MATH 193A,A01,083224,Rotar; Vladimir,7,0,34,27
1657118372084,MATH 193A,A02,083225,Rotar; Vladimir,5,0,34,29
1657118372084,MATH 193A,A03,083781,Rotar; Vladimir,1,0,34,33
1657118372084,MATH 193A,A04,083782,Rotar; Vladimir,6,0,34,28
1657118372084,MATH 193A,A05,093482,Rotar; Vladimir,6,0,34,28
1657118378106,MATH 197,001,091859,McAuley; Julian John,9999,0,9999,0
1657118378106,MATH 197,002,095566,Kedlaya; Kiran S.,9997,0,9999,2
1657118378106,MATH 197,003,095567,Xiao; Ming,9999,0,9999,0
1657118378106,MATH 197,004,095571,Perols; Johan Lars,9998,0,9999,1
1657118385173,COGS 9,A01,083615,Shannon; Kyle Michael,7,0,75,68
1657118391202,COGS 11,A01,083617,Boyle; Mary E. T.,21,0,48,27
1657118397224,COGS 13,A01,083071,Bastos; Amalia Pinkusfeld,9,0,71,62
1657118403258,COGS 14A,A01,092681,Semenuks; Arturs,1,1,100,99
1657118409280,COGS 14B,A01,083073,Cheng; Tzu-Han,6,0,63,57
1657118415304,COGS 17,A01,092677,Semenuks; Arturs,4,0,81,77
1657118421332,COGS 100,A01,083619,Allen; Michael Gordon,15,0,70,55
1657118427359,COGS 101A,A01,083621,Davis; Joshua Daniel,9,0,68,59
1657118433384,COGS 101B,A01,091572,Allen; Michael Gordon,8,0,65,57
1657118439413,COGS 101C,A01,083625,Delgado; Tania,17,0,35,18
1657118445439,COGS 107A,A01,083627,Boyle; Mary E. T.,13,0,60,47
1657118451462,COGS 118A,A01,083075,Gupta; Anjum,15,0,76,61
1657118457489,CSE 3,A50,083646,Miranda; Gregory Joseph,22,0,50,28
1657118463521,CSE 8A,A50,083650,Miranda; Gregory Joseph,17,1,56,39
1657118469549,CSE 11,A01,083080,Cao; Yingjun,4,15,40,36
1657118475573,CSE 12,A01,083652,Krause-Levy; Sophia Louisa,23,1,120,97
1657118481597,CSE 15L,A01,083654,Morris; Justin Loren,9,0,50,41
1657118481597,CSE 15L,A02,083655,Morris; Justin Loren,9,0,50,41
1657118487625,CSE 20,A01,083657,Tran; Khoa Dang,37,0,80,43
1657118493649,CSE 21,A01,095574,Bach; Quang Tran,21,0,48,27
1657118499677,CSE 30,A01,083084,Eldon; John,4,0,80,76
1657118499677,CSE 30,B01,095061,Bhaskar; Nishant,6,0,50,44
1657118505700,CSE 100,A01,083659,Cao; Yingjun,4,4,70,66
1657118511726,CSE 134B,A01,083661,Powell; Thomas Allan,19,0,100,81
1657118517756,CSE 140,A01,083663,Gungor; Onat,14,0,85,71
1657118523778,CSE 140L,A01,083088,Eldon; John,17,0,100,83
1657118529802,CSE 175,A01,083665,Kumar; Rakesh,3,0,25,22
1657118535824,CSE 190,A00,092507,Dubnov; Shlomo,7,0,20,13
1657118541850,ECE 45,A01,083139,Congero; Spencer William,5,0,75,70
1657118547872,ECE 65,A50,083695,Saad; Andrew S,12,0,30,18
1657118547872,ECE 65,A51,095125,Saad; Andrew S,25,0,26,1
1657118553900,ECE 109,A01,091882,Touri; Behrouz,16,0,70,54
1657118559923,ECE 180,A00,083140,Abi Samra; Nicholas Camill,1,0,30,29
1657118559923,ECE 180,B00,083141,Abi Samra; Nicholas Camill,0,0,30,30
1657118565946,MATH 10A,A01,083735,Patchell; Gregory David,1,0,30,29
1657118565946,MATH 10A,A02,083736,Patchell; Gregory David,20,0,30,10
1657118565946,MATH 10A,A03,083737,Patchell; Gregory David,16,0,30,14
1657118571972,MATH 10B,A01,083207,Lim; Seonhee,7,0,34,27
1657118571972,MATH 10B,A02,083208,Lim; Seonhee,9,0,35,26
1657118571972,MATH 10B,A03,093472,Lim; Seonhee,5,0,34,29
1657118571972,MATH 10B,B01,083739,Sinha; Shubham,9,0,30,21
1657118578005,MATH 18,A01,083743,Cinel; Cameron Alexander,6,0,30,24
1657118578005,MATH 18,A02,083744,Cinel; Cameron Alexander,15,0,30,15
1657118578005,MATH 18,A03,083745,Cinel; Cameron Alexander,8,0,30,22
1657118578005,MATH 18,B01,083748,Rideout; David Porter,4,0,37,33
1657118578005,MATH 18,B02,083749,Rideout; David Porter,3,0,36,33
1657118578005,MATH 18,B03,083750,Rideout; David Porter,2,0,37,35
1657118578005,MATH 18,B04,083751,Rideout; David Porter,5,0,36,31
1657118578005,MATH 18,B05,093473,Rideout; David Porter,4,0,36,32
1657118578005,MATH 18,B06,093474,Rideout; David Porter,5,0,36,31
1657118584044,MATH 20A,A01,083754,Zheng; Zequn,12,0,40,28
1657118590068,MATH 20B,A01,083756,Briones; Jor-el Thomas Caparas,1,0,36,35
1657118590068,MATH 20B,A02,083757,Briones; Jor-el Thomas Caparas,1,0,36,35
1657118590068,MATH 20B,A03,093475,Briones; Jor-el Thomas Caparas,0,0,36,36
1657118596091,MATH 20C,A01,083760,Briones; Jor-el Thomas Caparas,1,0,35,34
1657118596091,MATH 20C,A02,083761,Briones; Jor-el Thomas Caparas,8,0,35,27
1657118596091,MATH 20C,A03,093476,Briones; Jor-el Thomas Caparas,0,1,36,36
1657118596091,MATH 20C,B01,083762,Bach; Quang Tran,0,0,30,30
1657118602120,MATH 20D,A01,083765,Tran; Brian Kha,4,0,30,26
1657118602120,MATH 20D,A02,083766,Tran; Brian Kha,5,0,30,25
1657118602120,MATH 20D,A03,083767,Tran; Brian Kha,3,0,30,27
1657118608151,MATH 20E,A01,083771,Ganguly; Soumya,6,0,32,26
1657118608151,MATH 20E,A02,083772,Ganguly; Soumya,6,0,32,26
1657118608151,MATH 20E,B01,083773,Ciotti; Benjamin,18,0,35,17
1657118608151,MATH 20E,B02,083774,Ciotti; Benjamin,17,0,35,18
1657118614184,MATH 103A,A01,083777,Greenfeld; Be'Eri,2,0,36,34
1657118614184,MATH 103A,A02,083778,Greenfeld; Be'Eri,5,0,36,31
1657118614184,MATH 103A,A03,093561,Greenfeld; Be'Eri,4,0,36,32
1657118614184,MATH 103A,B01,083779,Greenfeld; Be'Eri,6,0,36,30
1657118614184,MATH 103A,B02,083780,Greenfeld; Be'Eri,2,0,36,34
1657118614184,MATH 103A,B03,093562,Greenfeld; Be'Eri,3,0,36,33
1657118620210,MATH 105,A01,085443,Carter; Anne Toulson,14,0,35,21
1657118620210,MATH 105,A02,093477,Carter; Anne Toulson,20,0,35,15
1657118626234,MATH 109,A01,083213,Ganzberger; Geoffrey Michael,2,0,34,32
1657118626234,MATH 109,A02,083214,Ganzberger; Geoffrey Michael,3,0,34,31
1657118626234,MATH 109,A03,093478,Ganzberger; Geoffrey Michael,1,0,34,33
1657118626234,MATH 109,B01,083215,Ganzberger; Geoffrey Michael,1,0,32,31
1657118626234,MATH 109,B02,083216,Ganzberger; Geoffrey Michael,1,0,32,31
1657118626234,MATH 109,B03,093479,Ganzberger; Geoffrey Michael,6,0,32,26
1657118632262,MATH 142A,A01,083219,Chow; Bennett,6,0,32,26
1657118632262,MATH 142A,A02,083220,Chow; Bennett,10,0,32,22
1657118632262,MATH 142A,A03,093480,Chow; Bennett,7,0,32,25
1657118632262,MATH 142A,B03,093481,Chow; Bennett,8,0,32,24
1657118632262,MATH 142A,B04,093558,Chow; Bennett,11,0,32,21
1657118632262,MATH 142A,B05,093559,Chow; Bennett,6,0,32,26
1657118638288,MATH 193A,A01,083224,Rotar; Vladimir,7,0,34,27
1657118638288,MATH 193A,A02,083225,Rotar; Vladimir,5,0,34,29
1657118638288,MATH 193A,A03,083781,Rotar; Vladimir,1,0,34,33
1657118638288,MATH 193A,A04,083782,Rotar; Vladimir,6,0,34,28
1657118638288,MATH 193A,A05,093482,Rotar; Vladimir,6,0,34,28
1657118644315,MATH 197,001,091859,McAuley; Julian John,9999,0,9999,0
1657118644315,MATH 197,002,095566,Kedlaya; Kiran S.,9997,0,9999,2
1657118644315,MATH 197,003,095567,Xiao; Ming,9999,0,9999,0
1657118644315,MATH 197,004,095571,Perols; Johan Lars,9998,0,9999,1
1657118651384,COGS 9,A01,083615,Shannon; Kyle Michael,7,0,75,68
1657118657413,COGS 11,A01,083617,Boyle; Mary E. T.,21,0,48,27
1657118663532,COGS 13,A01,083071,Bastos; Amalia Pinkusfeld,9,0,71,62
1657118669562,COGS 14A,A01,092681,Semenuks; Arturs,1,1,100,99
1657118675586,COGS 14B,A01,083073,Cheng; Tzu-Han,6,0,63,57
1657118681614,COGS 17,A01,092677,Semenuks; Arturs,4,0,81,77
1657118687644,COGS 100,A01,083619,Allen; Michael Gordon,15,0,70,55
1657118693669,COGS 101A,A01,083621,Davis; Joshua Daniel,9,0,68,59
1657118699706,COGS 101B,A01,091572,Allen; Michael Gordon,8,0,65,57
1657118705737,COGS 101C,A01,083625,Delgado; Tania,17,0,35,18
1657118711765,COGS 107A,A01,083627,Boyle; Mary E. T.,13,0,60,47
1657118717788,COGS 118A,A01,083075,Gupta; Anjum,15,0,76,61
1657118723818,CSE 3,A50,083646,Miranda; Gregory Joseph,22,0,50,28
1657118729846,CSE 8A,A50,083650,Miranda; Gregory Joseph,17,1,56,39
1657118735872,CSE 11,A01,083080,Cao; Yingjun,4,15,40,36
1657118741896,CSE 12,A01,083652,Krause-Levy; Sophia Louisa,23,1,120,97
1657118747919,CSE 15L,A01,083654,Morris; Justin Loren,9,0,50,41
1657118747919,CSE 15L,A02,083655,Morris; Justin Loren,9,0,50,41
1657118753946,CSE 20,A01,083657,Tran; Khoa Dang,37,0,80,43
1657118759987,CSE 21,A01,095574,Bach; Quang Tran,21,0,48,27
1657118766016,CSE 30,A01,083084,Eldon; John,4,0,80,76
1657118766016,CSE 30,B01,095061,Bhaskar; Nishant,6,0,50,44
1657118772039,CSE 100,A01,083659,Cao; Yingjun,4,4,70,66
1657118778064,CSE 134B,A01,083661,Powell; Thomas Allan,19,0,100,81
1657118784091,CSE 140,A01,083663,Gungor; Onat,14,0,85,71
1657118790122,CSE 140L,A01,083088,Eldon; John,17,0,100,83
1657118796150,CSE 175,A01,083665,Kumar; Rakesh,3,0,25,22
1657118802175,CSE 190,A00,092507,Dubnov; Shlomo,7,0,20,13
1657118808203,ECE 45,A01,083139,Congero; Spencer William,5,0,75,70
1657118814227,ECE 65,A50,083695,Saad; Andrew S,12,0,30,18
1657118814227,ECE 65,A51,095125,Saad; Andrew S,25,0,26,1
1657118820255,ECE 109,A01,091882,Touri; Behrouz,16,0,70,54
1657118826281,ECE 180,A00,083140,Abi Samra; Nicholas Camill,1,0,30,29
1657118826281,ECE 180,B00,083141,Abi Samra; Nicholas Camill,0,0,30,30
1657118832310,MATH 10A,A01,083735,Patchell; Gregory David,1,0,30,29
1657118832310,MATH 10A,A02,083736,Patchell; Gregory David,20,0,30,10
1657118832310,MATH 10A,A03,083737,Patchell; Gregory David,16,0,30,14
1657118838339,MATH 10B,A01,083207,Lim; Seonhee,7,0,34,27
1657118838339,MATH 10B,A02,083208,Lim; Seonhee,9,0,35,26
1657118838339,MATH 10B,A03,093472,Lim; Seonhee,5,0,34,29
1657118838339,MATH 10B,B01,083739,Sinha; Shubham,9,0,30,21
1657118844373,MATH 18,A01,083743,Cinel; Cameron Alexander,6,0,30,24
1657118844373,MATH 18,A02,083744,Cinel; Cameron Alexander,15,0,30,15
1657118844373,MATH 18,A03,083745,Cinel; Cameron Alexander,8,0,30,22
1657118844373,MATH 18,B01,083748,Rideout; David Porter,4,0,37,33
1657118844373,MATH 18,B02,083749,Rideout; David Porter,3,0,36,33
1657118844373,MATH 18,B03,083750,Rideout; David Porter,2,0,37,35
1657118844373,MATH 18,B04,083751,Rideout; David Porter,5,0,36,31
1657118844373,MATH 18,B05,093473,Rideout; David Porter,4,0,36,32
1657118844373,MATH 18,B06,093474,Rideout; David Porter,5,0,36,31
1657118850396,MATH 20A,A01,083754,Zheng; Zequn,12,0,40,28
1657118856420,MATH 20B,A01,083756,Briones; Jor-el Thomas Caparas,1,0,36,35
1657118856420,MATH 20B,A02,083757,Briones; Jor-el Thomas Caparas,1,0,36,35
1657118856420,MATH 20B,A03,093475,Briones; Jor-el Thomas Caparas,0,0,36,36
1657118862448,MATH 20C,A01,083760,Briones; Jor-el Thomas Caparas,1,0,35,34
1657118862448,MATH 20C,A02,083761,Briones; Jor-el Thomas Caparas,8,0,35,27
1657118862448,MATH 20C,A03,093476,Briones; Jor-el Thomas Caparas,0,1,36,36
1657118862448,MATH 20C,B01,083762,Bach; Quang Tran,0,0,30,30
1657118868476,MATH 20D,A01,083765,Tran; Brian Kha,4,0,30,26
1657118868476,MATH 20D,A02,083766,Tran; Brian Kha,5,0,30,25
1657118868476,MATH 20D,A03,083767,Tran; Brian Kha,3,0,30,27
1657118874501,MATH 20E,A01,083771,Ganguly; Soumya,6,0,32,26
1657118874501,MATH 20E,A02,083772,Ganguly; Soumya,6,0,32,26
1657118874501,MATH 20E,B01,083773,Ciotti; Benjamin,18,0,35,17
1657118874501,MATH 20E,B02,083774,Ciotti; Benjamin,17,0,35,18
1657118880532,MATH 103A,A01,083777,Greenfeld; Be'Eri,2,0,36,34
1657118880532,MATH 103A,A02,083778,Greenfeld; Be'Eri,5,0,36,31
1657118880532,MATH 103A,A03,093561,Greenfeld; Be'Eri,4,0,36,32
1657118880532,MATH 103A,B01,083779,Greenfeld; Be'Eri,6,0,36,30
1657118880532,MATH 103A,B02,083780,Greenfeld; Be'Eri,2,0,36,34
1657118880532,MATH 103A,B03,093562,Greenfeld; Be'Eri,3,0,36,33
1657118886565,MATH 105,A01,085443,Carter; Anne Toulson,14,0,35,21
1657118886565,MATH 105,A02,093477,Carter; Anne Toulson,20,0,35,15
1657118892593,MATH 109,A01,083213,Ganzberger; Geoffrey Michael,2,0,34,32
1657118892593,MATH 109,A02,083214,Ganzberger; Geoffrey Michael,3,0,34,31
1657118892593,MATH 109,A03,093478,Ganzberger; Geoffrey Michael,1,0,34,33
1657118892593,MATH 109,B01,083215,Ganzberger; Geoffrey Michael,1,0,32,31
1657118892593,MATH 109,B02,083216,Ganzberger; Geoffrey Michael,1,0,32,31
1657118892593,MATH 109,B03,093479,Ganzberger; Geoffrey Michael,6,0,32,26
1657118898618,MATH 142A,A01,083219,Chow; Bennett,6,0,32,26
1657118898618,MATH 142A,A02,083220,Chow; Bennett,10,0,32,22
1657118898618,MATH 142A,A03,093480,Chow; Bennett,7,0,32,25
1657118898618,MATH 142A,B03,093481,Chow; Bennett,8,0,32,24
1657118898618,MATH 142A,B04,093558,Chow; Bennett,11,0,32,21
1657118898618,MATH 142A,B05,093559,Chow; Bennett,6,0,32,26
1657118904643,MATH 193A,A01,083224,Rotar; Vladimir,7,0,34,27
1657118904643,MATH 193A,A02,083225,Rotar; Vladimir,5,0,34,29
1657118904643,MATH 193A,A03,083781,Rotar; Vladimir,1,0,34,33
1657118904643,MATH 193A,A04,083782,Rotar; Vladimir,6,0,34,28
1657118904643,MATH 193A,A05,093482,Rotar; Vladimir,6,0,34,28
1657118910667,MATH 197,001,091859,McAuley; Julian John,9999,0,9999,0
1657118910667,MATH 197,002,095566,Kedlaya; Kiran S.,9997,0,9999,2
1657118910667,MATH 197,003,095567,Xiao; Ming,9999,0,9999,0
1657118910667,MATH 197,004,095571,Perols; Johan Lars,9998,0,9999,1
1657118917727,COGS 9,A01,083615,Shannon; Kyle Michael,7,0,75,68
1657118923753,COGS 11,A01,083617,Boyle; Mary E. T.,21,0,48,27
1657118929776,COGS 13,A01,083071,Bastos; Amalia Pinkusfeld,9,0,71,62
1657118935800,COGS 14A,A01,092681,Semenuks; Arturs,1,1,100,99
1657118941824,COGS 14B,A01,083073,Cheng; Tzu-Han,6,0,63,57
1657118947847,COGS 17,A01,092677,Semenuks; Arturs,4,0,81,77
1657118953873,COGS 100,A01,083619,Allen; Michael Gordon,15,0,70,55
1657118959899,COGS 101A,A01,083621,Davis; Joshua Daniel,9,0,68,59
1657118965926,COGS 101B,A01,091572,Allen; Michael Gordon,8,0,65,57
1657118971953,COGS 101C,A01,083625,Delgado; Tania,17,0,35,18
1657118977981,COGS 107A,A01,083627,Boyle; Mary E. T.,13,0,60,47
1657118984017,COGS 118A,A01,083075,Gupta; Anjum,15,0,76,61
1657118990042,CSE 3,A50,083646,Miranda; Gregory Joseph,22,0,50,28
1657118996068,CSE 8A,A50,083650,Miranda; Gregory Joseph,17,1,56,39
1657119002094,CSE 11,A01,083080,Cao; Yingjun,4,15,40,36
1657119008117,CSE 12,A01,083652,Krause-Levy; Sophia Louisa,23,1,120,97
1657119014145,CSE 15L,A01,083654,Morris; Justin Loren,9,0,50,41
1657119014145,CSE 15L,A02,083655,Morris; Justin Loren,9,0,50,41
1657119020172,CSE 20,A01,083657,Tran; Khoa Dang,37,0,80,43
1657119026204,CSE 21,A01,095574,Bach; Quang Tran,21,0,48,27
1657119032228,CSE 30,A01,083084,Eldon; John,4,0,80,76
1657119032228,CSE 30,B01,095061,Bhaskar; Nishant,6,0,50,44
1657119038251,CSE 100,A01,083659,Cao; Yingjun,4,4,70,66
1657119044285,CSE 134B,A01,083661,Powell; Thomas Allan,19,0,100,81
1657119050309,CSE 140,A01,083663,Gungor; Onat,14,0,85,71
1657119056336,CSE 140L,A01,083088,Eldon; John,17,0,100,83
1657119062372,CSE 175,A01,083665,Kumar; Rakesh,3,0,25,22
1657119068398,CSE 190,A00,092507,Dubnov; Shlomo,7,0,20,13
1657119074422,ECE 45,A01,083139,Congero; Spencer William,5,0,75,70
1657119080465,ECE 65,A50,083695,Saad; Andrew S,12,0,30,18
1657119080465,ECE 65,A51,095125,Saad; Andrew S,25,0,26,1
1657119086489,ECE 109,A01,091882,Touri; Behrouz,16,0,70,54
1657119092513,ECE 180,A00,083140,Abi Samra; Nicholas Camill,1,0,30,29
1657119092513,ECE 180,B00,083141,Abi Samra; Nicholas Camill,0,0,30,30
1657119098537,MATH 10A,A01,083735,Patchell; Gregory David,1,0,30,29
1657119098537,MATH 10A,A02,083736,Patchell; Gregory David,20,0,30,10
1657119098537,MATH 10A,A03,083737,Patchell; Gregory David,16,0,30,14
1657119104565,MATH 10B,A01,083207,Lim; Seonhee,7,0,34,27
1657119104565,MATH 10B,A02,083208,Lim; Seonhee,9,0,35,26
1657119104565,MATH 10B,A03,093472,Lim; Seonhee,5,0,34,29
1657119104565,MATH 10B,B01,083739,Sinha; Shubham,9,0,30,21
1657119110591,MATH 18,A01,083743,Cinel; Cameron Alexander,6,0,30,24
1657119110591,MATH 18,A02,083744,Cinel; Cameron Alexander,15,0,30,15
1657119110591,MATH 18,A03,083745,Cinel; Cameron Alexander,8,0,30,22
1657119110591,MATH 18,B01,083748,Rideout; David Porter,4,0,37,33
1657119110591,MATH 18,B02,083749,Rideout; David Porter,3,0,36,33
1657119110591,MATH 18,B03,083750,Rideout; David Porter,2,0,37,35
1657119110591,MATH 18,B04,083751,Rideout; David Porter,5,0,36,31
1657119110591,MATH 18,B05,093473,Rideout; David Porter,4,0,36,32
1657119110591,MATH 18,B06,093474,Rideout; David Porter,5,0,36,31
1657119116618,MATH 20A,A01,083754,Zheng; Zequn,12,0,40,28
1657119122646,MATH 20B,A01,083756,Briones; Jor-el Thomas Caparas,1,0,36,35
1657119122646,MATH 20B,A02,083757,Briones; Jor-el Thomas Caparas,1,0,36,35
1657119122646,MATH 20B,A03,093475,Briones; Jor-el Thomas Caparas,0,0,36,36
1657119128679,MATH 20C,A01,083760,Briones; Jor-el Thomas Caparas,1,0,35,34
1657119128679,MATH 20C,A02,083761,Briones; Jor-el Thomas Caparas,8,0,35,27
1657119128679,MATH 20C,A03,093476,Briones; Jor-el Thomas Caparas,0,1,36,36
1657119128679,MATH 20C,B01,083762,Bach; Quang Tran,0,0,30,30
1657119134712,MATH 20D,A01,083765,Tran; Brian Kha,4,0,30,26
1657119134712,MATH 20D,A02,083766,Tran; Brian Kha,5,0,30,25
1657119134712,MATH 20D,A03,083767,Tran; Brian Kha,3,0,30,27
1657119140736,MATH 20E,A01,083771,Ganguly; Soumya,6,0,32,26
1657119140736,MATH 20E,A02,083772,Ganguly; Soumya,6,0,32,26
1657119140736,MATH 20E,B01,083773,Ciotti; Benjamin,18,0,35,17
1657119140736,MATH 20E,B02,083774,Ciotti; Benjamin,17,0,35,18
1657119146761,MATH 103A,A01,083777,Greenfeld; Be'Eri,2,0,36,34
1657119146761,MATH 103A,A02,083778,Greenfeld; Be'Eri,5,0,36,31
1657119146761,MATH 103A,A03,093561,Greenfeld; Be'Eri,4,0,36,32
1657119146761,MATH 103A,B01,083779,Greenfeld; Be'Eri,6,0,36,30
1657119146761,MATH 103A,B02,083780,Greenfeld; Be'Eri,2,0,36,34
1657119146761,MATH 103A,B03,093562,Greenfeld; Be'Eri,3,0,36,33
1657119152790,MATH 105,A01,085443,Carter; Anne Toulson,14,0,35,21
1657119152790,MATH 105,A02,093477,Carter; Anne Toulson,20,0,35,15
1657119158814,MATH 109,A01,083213,Ganzberger; Geoffrey Michael,2,0,34,32
1657119158814,MATH 109,A02,083214,Ganzberger; Geoffrey Michael,3,0,34,31
1657119158814,MATH 109,A03,093478,Ganzberger; Geoffrey Michael,1,0,34,33
1657119158814,MATH 109,B01,083215,Ganzberger; Geoffrey Michael,1,0,32,31
1657119158814,MATH 109,B02,083216,Ganzberger; Geoffrey Michael,1,0,32,31
1657119158814,MATH 109,B03,093479,Ganzberger; Geoffrey Michael,6,0,32,26
1657119164840,MATH 142A,A01,083219,Chow; Bennett,6,0,32,26
1657119164840,MATH 142A,A02,083220,Chow; Bennett,10,0,32,22
1657119164840,MATH 142A,A03,093480,Chow; Bennett,7,0,32,25
1657119164840,MATH 142A,B03,093481,Chow; Bennett,8,0,32,24
1657119164840,MATH 142A,B04,093558,Chow; Bennett,11,0,32,21
1657119164840,MATH 142A,B05,093559,Chow; Bennett,6,0,32,26
1657119170869,MATH 193A,A01,083224,Rotar; Vladimir,7,0,34,27
1657119170869,MATH 193A,A02,083225,Rotar; Vladimir,5,0,34,29
1657119170869,MATH 193A,A03,083781,Rotar; Vladimir,1,0,34,33
1657119170869,MATH 193A,A04,083782,Rotar; Vladimir,6,0,34,28
1657119170869,MATH 193A,A05,093482,Rotar; Vladimir,6,0,34,28
1657119176891,MATH 197,001,091859,McAuley; Julian John,9999,0,9999,0
1657119176891,MATH 197,002,095566,Kedlaya; Kiran S.,9997,0,9999,2
1657119176891,MATH 197,003,095567,Xiao; Ming,9999,0,9999,0
1657119176891,MATH 197,004,095571,Perols; Johan Lars,9998,0,9999,1
1657119183954,COGS 9,A01,083615,Shannon; Kyle Michael,7,0,75,68
1657119189978,COGS 11,A01,083617,Boyle; Mary E. T.,21,0,48,27
1657119196001,COGS 13,A01,083071,Bastos; Amalia Pinkusfeld,9,0,71,62
1657119202027,COGS 14A,A01,092681,Semenuks; Arturs,1,1,100,99
1657119208050,COGS 14B,A01,083073,Cheng; Tzu-Han,6,0,63,57
1657119214082,COGS 17,A01,092677,Semenuks; Arturs,4,0,81,77
1657119220107,COGS 100,A01,083619,Allen; Michael Gordon,15,0,70,55
1657119226135,COGS 101A,A01,083621,Davis; Joshua Daniel,9,0,68,59
1657119232158,COGS 101B,A01,091572,Allen; Michael Gordon,8,0,65,57
1657119238185,COGS 101C,A01,083625,Delgado; Tania,17,0,35,18
1657119244208,COGS 107A,A01,083627,Boyle; Mary E. T.,13,0,60,47
1657119250233,COGS 118A,A01,083075,Gupta; Anjum,15,0,76,61
1657119256259,CSE 3,A50,083646,Miranda; Gregory Joseph,22,0,50,28
1657119262371,CSE 8A,A50,083650,Miranda; Gregory Joseph,17,1,56,39
1657119268394,CSE 11,A01,083080,Cao; Yingjun,4,15,40,36
1657119274421,CSE 12,A01,083652,Krause-Levy; Sophia Louisa,23,1,120,97
1657119280456,CSE 15L,A01,083654,Morris; Justin Loren,9,0,50,41
1657119280456,CSE 15L,A02,083655,Morris; Justin Loren,9,0,50,41
1657119286481,CSE 20,A01,083657,Tran; Khoa Dang,37,0,80,43
1657119292515,CSE 21,A01,095574,Bach; Quang Tran,21,0,48,27
1657119298539,CSE 30,A01,083084,Eldon; John,4,0,80,76
1657119298539,CSE 30,B01,095061,Bhaskar; Nishant,6,0,50,44
1657119304562,CSE 100,A01,083659,Cao; Yingjun,4,4,70,66
1657119310590,CSE 134B,A01,083661,Powell; Thomas Allan,19,0,100,81
1657119316614,CSE 140,A01,083663,Gungor; Onat,14,0,85,71
1657119322642,CSE 140L,A01,083088,Eldon; John,17,0,100,83
1657119328675,CSE 175,A01,083665,Kumar; Rakesh,3,0,25,22
1657119334701,CSE 190,A00,092507,Dubnov; Shlomo,7,0,20,13
1657119340728,ECE 45,A01,083139,Congero; Spencer William,5,0,75,70
1657119346762,ECE 65,A50,083695,Saad; Andrew S,12,0,30,18
1657119346762,ECE 65,A51,095125,Saad; Andrew S,25,0,26,1
1657119352783,ECE 109,A01,091882,Touri; Behrouz,16,0,70,54
1657119358807,ECE 180,A00,083140,Abi Samra; Nicholas Camill,1,0,30,29
1657119358807,ECE 180,B00,083141,Abi Samra; Nicholas Camill,0,0,30,30
1657119364834,MATH 10A,A01,083735,Patchell; Gregory David,1,0,30,29
1657119364834,MATH 10A,A02,083736,Patchell; Gregory David,20,0,30,10
1657119364834,MATH 10A,A03,083737,Patchell; Gregory David,16,0,30,14
1657119370858,MATH 10B,A01,083207,Lim; Seonhee,7,0,34,27
1657119370858,MATH 10B,A02,083208,Lim; Seonhee,9,0,35,26
1657119370858,MATH 10B,A03,093472,Lim; Seonhee,5,0,34,29
1657119370858,MATH 10B,B01,083739,Sinha; Shubham,9,0,30,21
1657119376891,MATH 18,A01,083743,Cinel; Cameron Alexander,6,0,30,24
1657119376891,MATH 18,A02,083744,Cinel; Cameron Alexander,15,0,30,15
1657119376891,MATH 18,A03,083745,Cinel; Cameron Alexander,8,0,30,22
1657119376891,MATH 18,B01,083748,Rideout; David Porter,4,0,37,33
1657119376891,MATH 18,B02,083749,Rideout; David Porter,3,0,36,33
1657119376891,MATH 18,B03,083750,Rideout; David Porter,2,0,37,35
1657119376891,MATH 18,B04,083751,Rideout; David Porter,5,0,36,31
1657119376891,MATH 18,B05,093473,Rideout; David Porter,4,0,36,32
1657119376891,MATH 18,B06,093474,Rideout; David Porter,5,0,36,31
1657119382915,MATH 20A,A01,083754,Zheng; Zequn,12,0,40,28
1657119388940,MATH 20B,A01,083756,Briones; Jor-el Thomas Caparas,1,0,36,35
1657119388940,MATH 20B,A02,083757,Briones; Jor-el Thomas Caparas,1,0,36,35
1657119388940,MATH 20B,A03,093475,Briones; Jor-el Thomas Caparas,0,0,36,36
1657119394970,MATH 20C,A01,083760,Briones; Jor-el Thomas Caparas,1,0,35,34
1657119394970,MATH 20C,A02,083761,Briones; Jor-el Thomas Caparas,8,0,35,27
1657119394970,MATH 20C,A03,093476,Briones; Jor-el Thomas Caparas,0,1,36,36
1657119394970,MATH 20C,B01,083762,Bach; Quang Tran,0,0,30,30
1657119400995,MATH 20D,A01,083765,Tran; Brian Kha,4,0,30,26
1657119400995,MATH 20D,A02,083766,Tran; Brian Kha,5,0,30,25
1657119400995,MATH 20D,A03,083767,Tran; Brian Kha,3,0,30,27
1657119407032,MATH 20E,A01,083771,Ganguly; Soumya,6,0,32,26
1657119407032,MATH 20E,A02,083772,Ganguly; Soumya,6,0,32,26
1657119407032,MATH 20E,B01,083773,Ciotti; Benjamin,18,0,35,17
1657119407032,MATH 20E,B02,083774,Ciotti; Benjamin,17,0,35,18
1657119413063,MATH 103A,A01,083777,Greenfeld; Be'Eri,2,0,36,34
1657119413063,MATH 103A,A02,083778,Greenfeld; Be'Eri,5,0,36,31
1657119413063,MATH 103A,A03,093561,Greenfeld; Be'Eri,4,0,36,32
1657119413063,MATH 103A,B01,083779,Greenfeld; Be'Eri,6,0,36,30
1657119413063,MATH 103A,B02,083780,Greenfeld; Be'Eri,2,0,36,34
1657119413063,MATH 103A,B03,093562,Greenfeld; Be'Eri,3,0,36,33
1657119419085,MATH 105,A01,085443,Carter; Anne Toulson,14,0,35,21
1657119419085,MATH 105,A02,093477,Carter; Anne Toulson,20,0,35,15
1657119425110,MATH 109,A01,083213,Ganzberger; Geoffrey Michael,2,0,34,32
1657119425110,MATH 109,A02,083214,Ganzberger; Geoffrey Michael,3,0,34,31
1657119425110,MATH 109,A03,093478,Ganzberger; Geoffrey Michael,1,0,34,33
1657119425110,MATH 109,B01,083215,Ganzberger; Geoffrey Michael,1,0,32,31
1657119425110,MATH 109,B02,083216,Ganzberger; Geoffrey Michael,1,0,32,31
1657119425110,MATH 109,B03,093479,Ganzberger; Geoffrey Michael,6,0,32,26
1657119431133,MATH 142A,A01,083219,Chow; Bennett,6,0,32,26
1657119431133,MATH 142A,A02,083220,Chow; Bennett,10,0,32,22
1657119431133,MATH 142A,A03,093480,Chow; Bennett,7,0,32,25
1657119431133,MATH 142A,B03,093481,Chow; Bennett,8,0,32,24
1657119431133,MATH 142A,B04,093558,Chow; Bennett,11,0,32,21
1657119431133,MATH 142A,B05,093559,Chow; Bennett,6,0,32,26
1657119437158,MATH 193A,A01,083224,Rotar; Vladimir,7,0,34,27
1657119437158,MATH 193A,A02,083225,Rotar; Vladimir,5,0,34,29
1657119437158,MATH 193A,A03,083781,Rotar; Vladimir,1,0,34,33
1657119437158,MATH 193A,A04,083782,Rotar; Vladimir,6,0,34,28
1657119437158,MATH 193A,A05,093482,Rotar; Vladimir,6,0,34,28
1657119443182,MATH 197,001,091859,McAuley; Julian John,9999,0,9999,0
1657119443182,MATH 197,002,095566,Kedlaya; Kiran S.,9997,0,9999,2
1657119443182,MATH 197,003,095567,Xiao; Ming,9999,0,9999,0
1657119443182,MATH 197,004,095571,Perols; Johan Lars,9998,0,9999,1
1657119450238,COGS 9,A01,083615,Shannon; Kyle Michael,7,0,75,68
1657119456263,COGS 11,A01,083617,Boyle; Mary E. T.,21,0,48,27
1657119462286,COGS 13,A01,083071,Bastos; Amalia Pinkusfeld,9,0,71,62
1657119468310,COGS 14A,A01,092681,Semenuks; Arturs,1,1,100,99
1657119474336,COGS 14B,A01,083073,Cheng; Tzu-Han,6,0,63,57
1657119480360,COGS 17,A01,092677,Semenuks; Arturs,4,0,81,77
1657119486382,COGS 100,A01,083619,Allen; Michael Gordon,15,0,70,55
1657119492405,COGS 101A,A01,083621,Davis; Joshua Daniel,9,0,68,59
1657119498428,COGS 101B,A01,091572,Allen; Michael Gordon,8,0,65,57
1657119504455,COGS 101C,A01,083625,Delgado; Tania,17,0,35,18
1657119510479,COGS 107A,A01,083627,Boyle; Mary E. T.,13,0,60,47
1657119516506,COGS 118A,A01,083075,Gupta; Anjum,15,0,76,61
1657119522534,CSE 3,A50,083646,Miranda; Gregory Joseph,22,0,50,28
1657119528557,CSE 8A,A50,083650,Miranda; Gregory Joseph,17,1,56,39
1657119534585,CSE 11,A01,083080,Cao; Yingjun,4,15,40,36
1657119540620,CSE 12,A01,083652,Krause-Levy; Sophia Louisa,23,1,120,97
1657119546651,CSE 15L,A01,083654,Morris; Justin Loren,9,0,50,41
1657119546651,CSE 15L,A02,083655,Morris; Justin Loren,9,0,50,41
1657119552687,CSE 20,A01,083657,Tran; Khoa Dang,37,0,80,43
1657119558711,CSE 21,A01,095574,Bach; Quang Tran,21,0,48,27
1657119564739,CSE 30,A01,083084,Eldon; John,4,0,80,76
1657119564739,CSE 30,B01,095061,Bhaskar; Nishant,6,0,50,44
1657119570764,CSE 100,A01,083659,Cao; Yingjun,4,4,70,66
1657119576793,CSE 134B,A01,083661,Powell; Thomas Allan,19,0,100,81
1657119582821,CSE 140,A01,083663,Gungor; Onat,14,0,85,71
1657119588845,CSE 140L,A01,083088,Eldon; John,17,0,100,83
1657119594867,CSE 175,A01,083665,Kumar; Rakesh,3,0,25,22
1657119600903,CSE 190,A00,092507,Dubnov; Shlomo,7,0,20,13
1657119606944,ECE 45,A01,083139,Congero; Spencer William,5,0,75,70
1657119612966,ECE 65,A50,083695,Saad; Andrew S,12,0,30,18
1657119612966,ECE 65,A51,095125,Saad; Andrew S,25,0,26,1
1657119618990,ECE 109,A01,091882,Touri; Behrouz,16,0,70,54
1657119625014,ECE 180,A00,083140,Abi Samra; Nicholas Camill,1,0,30,29
1657119625014,ECE 180,B00,083141,Abi Samra; Nicholas Camill,0,0,30,30
1657119631038,MATH 10A,A01,083735,Patchell; Gregory David,1,0,30,29
1657119631038,MATH 10A,A02,083736,Patchell; Gregory David,20,0,30,10
1657119631038,MATH 10A,A03,083737,Patchell; Gregory David,16,0,30,14
1657119637063,MATH 10B,A01,083207,Lim; Seonhee,7,0,34,27
1657119637063,MATH 10B,A02,083208,Lim; Seonhee,9,0,35,26
1657119637063,MATH 10B,A03,093472,Lim; Seonhee,5,0,34,29
1657119637063,MATH 10B,B01,083739,Sinha; Shubham,9,0,30,21
1657119643088,MATH 18,A01,083743,Cinel; Cameron Alexander,6,0,30,24
1657119643088,MATH 18,A02,083744,Cinel; Cameron Alexander,15,0,30,15
1657119643088,MATH 18,A03,083745,Cinel; Cameron Alexander,8,0,30,22
1657119643088,MATH 18,B01,083748,Rideout; David Porter,4,0,37,33
1657119643088,MATH 18,B02,083749,Rideout; David Porter,3,0,36,33
1657119643088,MATH 18,B03,083750,Rideout; David Porter,2,0,37,35
1657119643088,MATH 18,B04,083751,Rideout; David Porter,5,0,36,31
1657119643088,MATH 18,B05,093473,Rideout; David Porter,4,0,36,32
1657119643088,MATH 18,B06,093474,Rideout; David Porter,5,0,36,31
1657119649110,MATH 20A,A01,083754,Zheng; Zequn,12,0,40,28
1657119655133,MATH 20B,A01,083756,Briones; Jor-el Thomas Caparas,1,0,36,35
1657119655133,MATH 20B,A02,083757,Briones; Jor-el Thomas Caparas,1,0,36,35
1657119655133,MATH 20B,A03,093475,Briones; Jor-el Thomas Caparas,0,0,36,36
1657119661161,MATH 20C,A01,083760,Briones; Jor-el Thomas Caparas,1,0,35,34
1657119661161,MATH 20C,A02,083761,Briones; Jor-el Thomas Caparas,8,0,35,27
1657119661161,MATH 20C,A03,093476,Briones; Jor-el Thomas Caparas,0,1,36,36
1657119661161,MATH 20C,B01,083762,Bach; Quang Tran,0,0,30,30
1657119667249,MATH 20D,A01,083765,Tran; Brian Kha,4,0,30,26
1657119667249,MATH 20D,A02,083766,Tran; Brian Kha,5,0,30,25
1657119667249,MATH 20D,A03,083767,Tran; Brian Kha,3,0,30,27
1657119673278,MATH 20E,A01,083771,Ganguly; Soumya,6,0,32,26
1657119673278,MATH 20E,A02,083772,Ganguly; Soumya,6,0,32,26
1657119673278,MATH 20E,B01,083773,Ciotti; Benjamin,18,0,35,17
1657119673278,MATH 20E,B02,083774,Ciotti; Benjamin,17,0,35,18
1657119679301,MATH 103A,A01,083777,Greenfeld; Be'Eri,2,0,36,34
1657119679301,MATH 103A,A02,083778,Greenfeld; Be'Eri,5,0,36,31
1657119679301,MATH 103A,A03,093561,Greenfeld; Be'Eri,4,0,36,32
1657119679301,MATH 103A,B01,083779,Greenfeld; Be'Eri,6,0,36,30
1657119679301,MATH 103A,B02,083780,Greenfeld; Be'Eri,2,0,36,34
1657119679301,MATH 103A,B03,093562,Greenfeld; Be'Eri,3,0,36,33
1657119685324,MATH 105,A01,085443,Carter; Anne Toulson,14,0,35,21
1657119685324,MATH 105,A02,093477,Carter; Anne Toulson,20,0,35,15
1657119691348,MATH 109,A01,083213,Ganzberger; Geoffrey Michael,2,0,34,32
1657119691348,MATH 109,A02,083214,Ganzberger; Geoffrey Michael,3,0,34,31
1657119691348,MATH 109,A03,093478,Ganzberger; Geoffrey Michael,1,0,34,33
1657119691348,MATH 109,B01,083215,Ganzberger; Geoffrey Michael,1,0,32,31
1657119691348,MATH 109,B02,083216,Ganzberger; Geoffrey Michael,1,0,32,31
1657119691348,MATH 109,B03,093479,Ganzberger; Geoffrey Michael,6,0,32,26
1657119697373,MATH 142A,A01,083219,Chow; Bennett,6,0,32,26
1657119697373,MATH 142A,A02,083220,Chow; Bennett,10,0,32,22
1657119697373,MATH 142A,A03,093480,Chow; Bennett,7,0,32,25
1657119697373,MATH 142A,B03,093481,Chow; Bennett,8,0,32,24
1657119697373,MATH 142A,B04,093558,Chow; Bennett,11,0,32,21
1657119697373,MATH 142A,B05,093559,Chow; Bennett,6,0,32,26
1657119703397,MATH 193A,A01,083224,Rotar; Vladimir,7,0,34,27
1657119703397,MATH 193A,A02,083225,Rotar; Vladimir,5,0,34,29
1657119703397,MATH 193A,A03,083781,Rotar; Vladimir,1,0,34,33
1657119703397,MATH 193A,A04,083782,Rotar; Vladimir,6,0,34,28
1657119703397,MATH 193A,A05,093482,Rotar; Vladimir,6,0,34,28
1657119709423,MATH 197,001,091859,McAuley; Julian John,9999,0,9999,0
1657119709423,MATH 197,002,095566,Kedlaya; Kiran S.,9997,0,9999,2
1657119709423,MATH 197,003,095567,Xiao; Ming,9999,0,9999,0
1657119709423,MATH 197,004,095571,Perols; Johan Lars,9998,0,9999,1
1657119716483,COGS 9,A01,083615,Shannon; Kyle Michael,7,0,75,68
1657119722510,COGS 11,A01,083617,Boyle; Mary E. T.,21,0,48,27
1657119728537,COGS 13,A01,083071,Bastos; Amalia Pinkusfeld,9,0,71,62
1657119734577,COGS 14A,A01,092681,Semenuks; Arturs,1,1,100,99
1657119740600,COGS 14B,A01,083073,Cheng; Tzu-Han,6,0,63,57
1657119746630,COGS 17,A01,092677,Semenuks; Arturs,4,0,81,77
1657119752662,COGS 100,A01,083619,Allen; Michael Gordon,15,0,70,55
1657119758696,COGS 101A,A01,083621,Davis; Joshua Daniel,9,0,68,59
1657119764721,COGS 101B,A01,091572,Allen; Michael Gordon,8,0,65,57
1657119770748,COGS 101C,A01,083625,Delgado; Tania,17,0,35,18
1657119776772,COGS 107A,A01,083627,Boyle; Mary E. T.,13,0,60,47
1657119782794,COGS 118A,A01,083075,Gupta; Anjum,15,0,76,61
1657119788822,CSE 3,A50,083646,Miranda; Gregory Joseph,22,0,50,28
1657119794845,CSE 8A,A50,083650,Miranda; Gregory Joseph,17,1,56,39
1657119800870,CSE 11,A01,083080,Cao; Yingjun,4,15,40,36
1657119806896,CSE 12,A01,083652,Krause-Levy; Sophia Louisa,23,1,120,97
1657119812919,CSE 15L,A01,083654,Morris; Justin Loren,9,0,50,41
1657119812919,CSE 15L,A02,083655,Morris; Justin Loren,9,0,50,41
1657119818947,CSE 20,A01,083657,Tran; Khoa Dang,37,0,80,43
1657119824971,CSE 21,A01,095574,Bach; Quang Tran,21,0,48,27
1657119831007,CSE 30,A01,083084,Eldon; John,4,0,80,76
1657119831007,CSE 30,B01,095061,Bhaskar; Nishant,6,0,50,44
1657119837034,CSE 100,A01,083659,Cao; Yingjun,4,4,70,66
1657119843070,CSE 134B,A01,083661,Powell; Thomas Allan,19,0,100,81
1657119849093,CSE 140,A01,083663,Gungor; Onat,14,0,85,71
1657119855117,CSE 140L,A01,083088,Eldon; John,17,0,100,83
1657119861231,CSE 175,A01,083665,Kumar; Rakesh,3,0,25,22
1657119867256,CSE 190,A00,092507,Dubnov; Shlomo,7,0,20,13
1657119873280,ECE 45,A01,083139,Congero; Spencer William,5,0,75,70
1657119879318,ECE 65,A50,083695,Saad; Andrew S,12,0,30,18
1657119879318,ECE 65,A51,095125,Saad; Andrew S,25,0,26,1
1657119885343,ECE 109,A01,091882,Touri; Behrouz,16,0,70,54
1657119891367,ECE 180,A00,083140,Abi Samra; Nicholas Camill,1,0,30,29
1657119891367,ECE 180,B00,083141,Abi Samra; Nicholas Camill,0,0,30,30
1657119897391,MATH 10A,A01,083735,Patchell; Gregory David,1,0,30,29
1657119897391,MATH 10A,A02,083736,Patchell; Gregory David,20,0,30,10
1657119897391,MATH 10A,A03,083737,Patchell; Gregory David,16,0,30,14
1657119903425,MATH 10B,A01,083207,Lim; Seonhee,7,0,34,27
1657119903425,MATH 10B,A02,083208,Lim; Seonhee,9,0,35,26
1657119903425,MATH 10B,A03,093472,Lim; Seonhee,5,0,34,29
1657119903425,MATH 10B,B01,083739,Sinha; Shubham,9,0,30,21
1657119909458,MATH 18,A01,083743,Cinel; Cameron Alexander,6,0,30,24
1657119909458,MATH 18,A02,083744,Cinel; Cameron Alexander,15,0,30,15
1657119909458,MATH 18,A03,083745,Cinel; Cameron Alexander,8,0,30,22
1657119909458,MATH 18,B01,083748,Rideout; David Porter,4,0,37,33
1657119909458,MATH 18,B02,083749,Rideout; David Porter,3,0,36,33
1657119909458,MATH 18,B03,083750,Rideout; David Porter,2,0,37,35
1657119909458,MATH 18,B04,083751,Rideout; David Porter,5,0,36,31
1657119909458,MATH 18,B05,093473,Rideout; David Porter,4,0,36,32
1657119909458,MATH 18,B06,093474,Rideout; David Porter,5,0,36,31
1657119915485,MATH 20A,A01,083754,Zheng; Zequn,12,0,40,28
1657119921518,MATH 20B,A01,083756,Briones; Jor-el Thomas Caparas,1,0,36,35
1657119921518,MATH 20B,A02,083757,Briones; Jor-el Thomas Caparas,1,0,36,35
1657119921518,MATH 20B,A03,093475,Briones; Jor-el Thomas Caparas,0,0,36,36
1657119927546,MATH 20C,A01,083760,Briones; Jor-el Thomas Caparas,1,0,35,34
1657119927546,MATH 20C,A02,083761,Briones; Jor-el Thomas Caparas,8,0,35,27
1657119927546,MATH 20C,A03,093476,Briones; Jor-el Thomas Caparas,0,1,36,36
1657119927546,MATH 20C,B01,083762,Bach; Quang Tran,0,0,30,30
1657119933569,MATH 20D,A01,083765,Tran; Brian Kha,4,0,30,26
1657119933569,MATH 20D,A02,083766,Tran; Brian Kha,5,0,30,25
1657119933569,MATH 20D,A03,083767,Tran; Brian Kha,3,0,30,27
1657119939594,MATH 20E,A01,083771,Ganguly; Soumya,6,0,32,26
1657119939594,MATH 20E,A02,083772,Ganguly; Soumya,6,0,32,26
1657119939594,MATH 20E,B01,083773,Ciotti; Benjamin,18,0,35,17
1657119939594,MATH 20E,B02,083774,Ciotti; Benjamin,17,0,35,18
1657119945627,MATH 103A,A01,083777,Greenfeld; Be'Eri,2,0,36,34
1657119945627,MATH 103A,A02,083778,Greenfeld; Be'Eri,5,0,36,31
1657119945627,MATH 103A,A03,093561,Greenfeld; Be'Eri,4,0,36,32
1657119945627,MATH 103A,B01,083779,Greenfeld; Be'Eri,6,0,36,30
1657119945627,MATH 103A,B02,083780,Greenfeld; Be'Eri,2,0,36,34
1657119945627,MATH 103A,B03,093562,Greenfeld; Be'Eri,3,0,36,33
1657119951650,MATH 105,A01,085443,Carter; Anne Toulson,14,0,35,21
1657119951650,MATH 105,A02,093477,Carter; Anne Toulson,20,0,35,15
1657119957674,MATH 109,A01,083213,Ganzberger; Geoffrey Michael,2,0,34,32
1657119957674,MATH 109,A02,083214,Ganzberger; Geoffrey Michael,3,0,34,31
1657119957674,MATH 109,A03,093478,Ganzberger; Geoffrey Michael,1,0,34,33
1657119957674,MATH 109,B01,083215,Ganzberger; Geoffrey Michael,1,0,32,31
1657119957674,MATH 109,B02,083216,Ganzberger; Geoffrey Michael,1,0,32,31
1657119957674,MATH 109,B03,093479,Ganzberger; Geoffrey Michael,6,0,32,26
1657119963707,MATH 142A,A01,083219,Chow; Bennett,6,0,32,26
1657119963707,MATH 142A,A02,083220,Chow; Bennett,10,0,32,22
1657119963707,MATH 142A,A03,093480,Chow; Bennett,7,0,32,25
1657119963707,MATH 142A,B03,093481,Chow; Bennett,8,0,32,24
1657119963707,MATH 142A,B04,093558,Chow; Bennett,11,0,32,21
1657119963707,MATH 142A,B05,093559,Chow; Bennett,6,0,32,26
1657119969733,MATH 193A,A01,083224,Rotar; Vladimir,7,0,34,27
1657119969733,MATH 193A,A02,083225,Rotar; Vladimir,5,0,34,29
1657119969733,MATH 193A,A03,083781,Rotar; Vladimir,1,0,34,33
1657119969733,MATH 193A,A04,083782,Rotar; Vladimir,6,0,34,28
1657119969733,MATH 193A,A05,093482,Rotar; Vladimir,6,0,34,28
1657119975757,MATH 197,001,091859,McAuley; Julian John,9999,0,9999,0
1657119975757,MATH 197,002,095566,Kedlaya; Kiran S.,9997,0,9999,2
1657119975757,MATH 197,003,095567,Xiao; Ming,9999,0,9999,0
1657119975757,MATH 197,004,095571,Perols; Johan Lars,9998,0,9999,1
1657119982824,COGS 9,A01,083615,Shannon; Kyle Michael,7,0,75,68
1657119988849,COGS 11,A01,083617,Boyle; Mary E. T.,21,0,48,27
1657119994883,COGS 13,A01,083071,Bastos; Amalia Pinkusfeld,9,0,71,62
1657120000907,COGS 14A,A01,092681,Semenuks; Arturs,1,1,100,99
1657120006935,COGS 14B,A01,083073,Cheng; Tzu-Han,6,0,63,57
1657120012958,COGS 17,A01,092677,Semenuks; Arturs,4,0,81,77
1657120018983,COGS 100,A01,083619,Allen; Michael Gordon,15,0,70,55
1657120025023,COGS 101A,A01,083621,Davis; Joshua Daniel,9,0,68,59
1657120031058,COGS 101B,A01,091572,Allen; Michael Gordon,8,0,65,57
1657120037082,COGS 101C,A01,083625,Delgado; Tania,17,0,35,18
1657120043110,COGS 107A,A01,083627,Boyle; Mary E. T.,13,0,60,47
1657120049137,COGS 118A,A01,083075,Gupta; Anjum,15,0,76,61
1657120055163,CSE 3,A50,083646,Miranda; Gregory Joseph,22,0,50,28
1657120061196,CSE 8A,A50,083650,Miranda; Gregory Joseph,17,1,56,39
1657120067220,CSE 11,A01,083080,Cao; Yingjun,4,15,40,36
1657120073257,CSE 12,A01,083652,Krause-Levy; Sophia Louisa,23,1,120,97
1657120079284,CSE 15L,A01,083654,Morris; Justin Loren,9,0,50,41
1657120079284,CSE 15L,A02,083655,Morris; Justin Loren,9,0,50,41
1657120085316,CSE 20,A01,083657,Tran; Khoa Dang,37,0,80,43
1657120091344,CSE 21,A01,095574,Bach; Quang Tran,21,0,48,27
1657120097369,CSE 30,A01,083084,Eldon; John,4,0,80,76
1657120097369,CSE 30,B01,095061,Bhaskar; Nishant,6,0,50,44
1657120103392,CSE 100,A01,083659,Cao; Yingjun,4,4,70,66
1657120109435,CSE 134B,A01,083661,Powell; Thomas Allan,19,0,100,81
1657120115461,CSE 140,A01,083663,Gungor; Onat,14,0,85,71
1657120121485,CSE 140L,A01,083088,Eldon; John,17,0,100,83
1657120127520,CSE 175,A01,083665,Kumar; Rakesh,3,0,25,22
1657120133541,CSE 190,A00,092507,Dubnov; Shlomo,7,0,20,13
1657120139570,ECE 45,A01,083139,Congero; Spencer William,5,0,75,70
1657120145594,ECE 65,A50,083695,Saad; Andrew S,12,0,30,18
1657120145594,ECE 65,A51,095125,Saad; Andrew S,25,0,26,1
1657120151624,ECE 109,A01,091882,Touri; Behrouz,16,0,70,54
1657120157649,ECE 180,A00,083140,Abi Samra; Nicholas Camill,1,0,30,29
1657120157649,ECE 180,B00,083141,Abi Samra; Nicholas Camill,0,0,30,30
1657120163678,MATH 10A,A01,083735,Patchell; Gregory David,1,0,30,29
1657120163678,MATH 10A,A02,083736,Patchell; Gregory David,20,0,30,10
1657120163678,MATH 10A,A03,083737,Patchell; Gregory David,16,0,30,14
1657120169703,MATH 10B,A01,083207,Lim; Seonhee,7,0,34,27
1657120169703,MATH 10B,A02,083208,Lim; Seonhee,9,0,35,26
1657120169703,MATH 10B,A03,093472,Lim; Seonhee,5,0,34,29
1657120169703,MATH 10B,B01,083739,Sinha; Shubham,9,0,30,21
1657120175728,MATH 18,A01,083743,Cinel; Cameron Alexander,6,0,30,24
1657120175728,MATH 18,A02,083744,Cinel; Cameron Alexander,15,0,30,15
1657120175728,MATH 18,A03,083745,Cinel; Cameron Alexander,8,0,30,22
1657120175728,MATH 18,B01,083748,Rideout; David Porter,4,0,37,33
1657120175728,MATH 18,B02,083749,Rideout; David Porter,3,0,36,33
1657120175728,MATH 18,B03,083750,Rideout; David Porter,2,0,37,35
1657120175728,MATH 18,B04,083751,Rideout; David Porter,5,0,36,31
1657120175728,MATH 18,B05,093473,Rideout; David Porter,4,0,36,32
1657120175728,MATH 18,B06,093474,Rideout; David Porter,5,0,36,31
1657120181752,MATH 20A,A01,083754,Zheng; Zequn,12,0,40,28
1657120187782,MATH 20B,A01,083756,Briones; Jor-el Thomas Caparas,1,0,36,35
1657120187782,MATH 20B,A02,083757,Briones; Jor-el Thomas Caparas,1,0,36,35
1657120187782,MATH 20B,A03,093475,Briones; Jor-el Thomas Caparas,0,0,36,36
1657120193830,MATH 20C,A01,083760,Briones; Jor-el Thomas Caparas,1,0,35,34
1657120193830,MATH 20C,A02,083761,Briones; Jor-el Thomas Caparas,8,0,35,27
1657120193830,MATH 20C,A03,093476,Briones; Jor-el Thomas Caparas,0,1,36,36
1657120193830,MATH 20C,B01,083762,Bach; Quang Tran,0,0,30,30
1657120199855,MATH 20D,A01,083765,Tran; Brian Kha,4,0,30,26
1657120199855,MATH 20D,A02,083766,Tran; Brian Kha,5,0,30,25
1657120199855,MATH 20D,A03,083767,Tran; Brian Kha,3,0,30,27
1657120205883,MATH 20E,A01,083771,Ganguly; Soumya,6,0,32,26
1657120205883,MATH 20E,A02,083772,Ganguly; Soumya,6,0,32,26
1657120205883,MATH 20E,B01,083773,Ciotti; Benjamin,18,0,35,17
1657120205883,MATH 20E,B02,083774,Ciotti; Benjamin,17,0,35,18
1657120211914,MATH 103A,A01,083777,Greenfeld; Be'Eri,2,0,36,34
1657120211914,MATH 103A,A02,083778,Greenfeld; Be'Eri,5,0,36,31
1657120211914,MATH 103A,A03,093561,Greenfeld; Be'Eri,4,0,36,32
1657120211914,MATH 103A,B01,083779,Greenfeld; Be'Eri,6,0,36,30
1657120211914,MATH 103A,B02,083780,Greenfeld; Be'Eri,2,0,36,34
1657120211914,MATH 103A,B03,093562,Greenfeld; Be'Eri,3,0,36,33
1657120217938,MATH 105,A01,085443,Carter; Anne Toulson,14,0,35,21
1657120217938,MATH 105,A02,093477,Carter; Anne Toulson,20,0,35,15
1657120223963,MATH 109,A01,083213,Ganzberger; Geoffrey Michael,2,0,34,32
1657120223963,MATH 109,A02,083214,Ganzberger; Geoffrey Michael,3,0,34,31
1657120223963,MATH 109,A03,093478,Ganzberger; Geoffrey Michael,1,0,34,33
1657120223963,MATH 109,B01,083215,Ganzberger; Geoffrey Michael,1,0,32,31
1657120223963,MATH 109,B02,083216,Ganzberger; Geoffrey Michael,1,0,32,31
1657120223963,MATH 109,B03,093479,Ganzberger; Geoffrey Michael,6,0,32,26
1657120229988,MATH 142A,A01,083219,Chow; Bennett,6,0,32,26
1657120229988,MATH 142A,A02,083220,Chow; Bennett,10,0,32,22
1657120229988,MATH 142A,A03,093480,Chow; Bennett,7,0,32,25
1657120229988,MATH 142A,B03,093481,Chow; Bennett,8,0,32,24
1657120229988,MATH 142A,B04,093558,Chow; Bennett,11,0,32,21
1657120229988,MATH 142A,B05,093559,Chow; Bennett,6,0,32,26
1657120236012,MATH 193A,A01,083224,Rotar; Vladimir,7,0,34,27
1657120236012,MATH 193A,A02,083225,Rotar; Vladimir,5,0,34,29
1657120236012,MATH 193A,A03,083781,Rotar; Vladimir,1,0,34,33
1657120236012,MATH 193A,A04,083782,Rotar; Vladimir,6,0,34,28
1657120236012,MATH 193A,A05,093482,Rotar; Vladimir,6,0,34,28
1657120242038,MATH 197,001,091859,McAuley; Julian John,9999,0,9999,0
1657120242038,MATH 197,002,095566,Kedlaya; Kiran S.,9997,0,9999,2
1657120242038,MATH 197,003,095567,Xiao; Ming,9999,0,9999,0
1657120242038,MATH 197,004,095571,Perols; Johan Lars,9998,0,9999,1
1657120249106,COGS 9,A01,083615,Shannon; Kyle Michael,7,0,75,68
1657120255128,COGS 11,A01,083617,Boyle; Mary E. T.,21,0,48,27
1657120261156,COGS 13,A01,083071,Bastos; Amalia Pinkusfeld,9,0,71,62
1657120267184,COGS 14A,A01,092681,Semenuks; Arturs,1,1,100,99
1657120273208,COGS 14B,A01,083073,Cheng; Tzu-Han,6,0,63,57
1657120279236,COGS 17,A01,092677,Semenuks; Arturs,4,0,81,77
1657120285263,COGS 100,A01,083619,Allen; Michael Gordon,15,0,70,55
1657120291287,COGS 101A,A01,083621,Davis; Joshua Daniel,9,0,68,59
1657120297310,COGS 101B,A01,091572,Allen; Michael Gordon,8,0,65,57
1657120303341,COGS 101C,A01,083625,Delgado; Tania,17,0,35,18
1657120309368,COGS 107A,A01,083627,Boyle; Mary E. T.,13,0,60,47
1657120315390,COGS 118A,A01,083075,Gupta; Anjum,15,0,76,61
1657120321425,CSE 3,A50,083646,Miranda; Gregory Joseph,22,0,50,28
1657120327448,CSE 8A,A50,083650,Miranda; Gregory Joseph,17,1,56,39
1657120333473,CSE 11,A01,083080,Cao; Yingjun,4,15,40,36
1657120339497,CSE 12,A01,083652,Krause-Levy; Sophia Louisa,23,1,120,97
1657120345523,CSE 15L,A01,083654,Morris; Justin Loren,9,0,50,41
1657120345523,CSE 15L,A02,083655,Morris; Justin Loren,9,0,50,41
1657120351548,CSE 20,A01,083657,Tran; Khoa Dang,37,0,80,43
1657120357571,CSE 21,A01,095574,Bach; Quang Tran,21,0,48,27
1657120363594,CSE 30,A01,083084,Eldon; John,4,0,80,76
1657120363594,CSE 30,B01,095061,Bhaskar; Nishant,6,0,50,44
1657120369619,CSE 100,A01,083659,Cao; Yingjun,4,4,70,66
1657120375644,CSE 134B,A01,083661,Powell; Thomas Allan,19,0,100,81
1657120381669,CSE 140,A01,083663,Gungor; Onat,14,0,85,71
1657120387691,CSE 140L,A01,083088,Eldon; John,17,0,100,83
1657120393719,CSE 175,A01,083665,Kumar; Rakesh,3,0,25,22
1657120399744,CSE 190,A00,092507,Dubnov; Shlomo,7,0,20,13
1657120405767,ECE 45,A01,083139,Congero; Spencer William,5,0,75,70
1657120411791,ECE 65,A50,083695,Saad; Andrew S,12,0,30,18
1657120411791,ECE 65,A51,095125,Saad; Andrew S,25,0,26,1
1657120417818,ECE 109,A01,091882,Touri; Behrouz,16,0,70,54
1657120423843,ECE 180,A00,083140,Abi Samra; Nicholas Camill,1,0,30,29
1657120423843,ECE 180,B00,083141,Abi Samra; Nicholas Camill,0,0,30,30
1657120429870,MATH 10A,A01,083735,Patchell; Gregory David,1,0,30,29
1657120429870,MATH 10A,A02,083736,Patchell; Gregory David,20,0,30,10
1657120429870,MATH 10A,A03,083737,Patchell; Gregory David,16,0,30,14
1657120435899,MATH 10B,A01,083207,Lim; Seonhee,7,0,34,27
1657120435899,MATH 10B,A02,083208,Lim; Seonhee,9,0,35,26
1657120435899,MATH 10B,A03,093472,Lim; Seonhee,5,0,34,29
1657120435899,MATH 10B,B01,083739,Sinha; Shubham,9,0,30,21
1657120441927,MATH 18,A01,083743,Cinel; Cameron Alexander,6,0,30,24
1657120441927,MATH 18,A02,083744,Cinel; Cameron Alexander,15,0,30,15
1657120441927,MATH 18,A03,083745,Cinel; Cameron Alexander,8,0,30,22
1657120441927,MATH 18,B01,083748,Rideout; David Porter,4,0,37,33
1657120441927,MATH 18,B02,083749,Rideout; David Porter,3,0,36,33
1657120441927,MATH 18,B03,083750,Rideout; David Porter,2,0,37,35
1657120441927,MATH 18,B04,083751,Rideout; David Porter,5,0,36,31
1657120441927,MATH 18,B05,093473,Rideout; David Porter,4,0,36,32
1657120441927,MATH 18,B06,093474,Rideout; David Porter,5,0,36,31
1657120447948,MATH 20A,A01,083754,Zheng; Zequn,12,0,40,28
1657120453972,MATH 20B,A01,083756,Briones; Jor-el Thomas Caparas,1,0,36,35
1657120453972,MATH 20B,A02,083757,Briones; Jor-el Thomas Caparas,1,0,36,35
1657120453972,MATH 20B,A03,093475,Briones; Jor-el Thomas Caparas,0,0,36,36
1657120460071,MATH 20C,A01,083760,Briones; Jor-el Thomas Caparas,1,0,35,34
1657120460071,MATH 20C,A02,083761,Briones; Jor-el Thomas Caparas,8,0,35,27
1657120460071,MATH 20C,A03,093476,Briones; Jor-el Thomas Caparas,0,1,36,36
1657120460071,MATH 20C,B01,083762,Bach; Quang Tran,0,0,30,30
1657120466095,MATH 20D,A01,083765,Tran; Brian Kha,4,0,30,26
1657120466095,MATH 20D,A02,083766,Tran; Brian Kha,5,0,30,25
1657120466095,MATH 20D,A03,083767,Tran; Brian Kha,3,0,30,27
1657120472121,MATH 20E,A01,083771,Ganguly; Soumya,6,0,32,26
1657120472121,MATH 20E,A02,083772,Ganguly; Soumya,6,0,32,26
1657120472121,MATH 20E,B01,083773,Ciotti; Benjamin,18,0,35,17
1657120472121,MATH 20E,B02,083774,Ciotti; Benjamin,17,0,35,18
1657120478143,MATH 103A,A01,083777,Greenfeld; Be'Eri,2,0,36,34
1657120478143,MATH 103A,A02,083778,Greenfeld; Be'Eri,5,0,36,31
1657120478143,MATH 103A,A03,093561,Greenfeld; Be'Eri,4,0,36,32
1657120478143,MATH 103A,B01,083779,Greenfeld; Be'Eri,6,0,36,30
1657120478143,MATH 103A,B02,083780,Greenfeld; Be'Eri,2,0,36,34
1657120478143,MATH 103A,B03,093562,Greenfeld; Be'Eri,3,0,36,33
1657120484167,MATH 105,A01,085443,Carter; Anne Toulson,14,0,35,21
1657120484167,MATH 105,A02,093477,Carter; Anne Toulson,20,0,35,15
1657120490196,MATH 109,A01,083213,Ganzberger; Geoffrey Michael,2,0,34,32
1657120490196,MATH 109,A02,083214,Ganzberger; Geoffrey Michael,3,0,34,31
1657120490196,MATH 109,A03,093478,Ganzberger; Geoffrey Michael,1,0,34,33
1657120490196,MATH 109,B01,083215,Ganzberger; Geoffrey Michael,1,0,32,31
1657120490196,MATH 109,B02,083216,Ganzberger; Geoffrey Michael,1,0,32,31
1657120490196,MATH 109,B03,093479,Ganzberger; Geoffrey Michael,6,0,32,26
1657120496234,MATH 142A,A01,083219,Chow; Bennett,6,0,32,26
1657120496234,MATH 142A,A02,083220,Chow; Bennett,10,0,32,22
1657120496234,MATH 142A,A03,093480,Chow; Bennett,7,0,32,25
1657120496234,MATH 142A,B03,093481,Chow; Bennett,8,0,32,24
1657120496234,MATH 142A,B04,093558,Chow; Bennett,11,0,32,21
1657120496234,MATH 142A,B05,093559,Chow; Bennett,6,0,32,26
1657120502263,MATH 193A,A01,083224,Rotar; Vladimir,7,0,34,27
1657120502263,MATH 193A,A02,083225,Rotar; Vladimir,5,0,34,29
1657120502263,MATH 193A,A03,083781,Rotar; Vladimir,1,0,34,33
1657120502263,MATH 193A,A04,083782,Rotar; Vladimir,6,0,34,28
1657120502263,MATH 193A,A05,093482,Rotar; Vladimir,6,0,34,28
1657120508289,MATH 197,001,091859,McAuley; Julian John,9999,0,9999,0
1657120508289,MATH 197,002,095566,Kedlaya; Kiran S.,9997,0,9999,2
1657120508289,MATH 197,003,095567,Xiao; Ming,9999,0,9999,0
1657120508289,MATH 197,004,095571,Perols; Johan Lars,9998,0,9999,1
1657120515362,COGS 9,A01,083615,Shannon; Kyle Michael,7,0,75,68
1657120521385,COGS 11,A01,083617,Boyle; Mary E. T.,21,0,48,27
1657120527409,COGS 13,A01,083071,Bastos; Amalia Pinkusfeld,9,0,71,62
1657120533434,COGS 14A,A01,092681,Semenuks; Arturs,1,1,100,99
1657120539460,COGS 14B,A01,083073,Cheng; Tzu-Han,6,0,63,57
1657120545486,COGS 17,A01,092677,Semenuks; Arturs,4,0,81,77
1657120551512,COGS 100,A01,083619,Allen; Michael Gordon,15,0,70,55
1657120557538,COGS 101A,A01,083621,Davis; Joshua Daniel,9,0,68,59
1657120563566,COGS 101B,A01,091572,Allen; Michael Gordon,8,0,65,57
1657120569600,COGS 101C,A01,083625,Delgado; Tania,17,0,35,18
1657120575627,COGS 107A,A01,083627,Boyle; Mary E. T.,13,0,60,47
1657120581653,COGS 118A,A01,083075,Gupta; Anjum,15,0,76,61
1657120587684,CSE 3,A50,083646,Miranda; Gregory Joseph,22,0,50,28
1657120593707,CSE 8A,A50,083650,Miranda; Gregory Joseph,17,1,56,39
1657120599734,CSE 11,A01,083080,Cao; Yingjun,4,15,40,36
1657120605775,CSE 12,A01,083652,Krause-Levy; Sophia Louisa,23,1,120,97
1657120611799,CSE 15L,A01,083654,Morris; Justin Loren,9,0,50,41
1657120611799,CSE 15L,A02,083655,Morris; Justin Loren,9,0,50,41
1657120617823,CSE 20,A01,083657,Tran; Khoa Dang,37,0,80,43
1657120623850,CSE 21,A01,095574,Bach; Quang Tran,21,0,48,27
1657120629879,CSE 30,A01,083084,Eldon; John,4,0,80,76
1657120629879,CSE 30,B01,095061,Bhaskar; Nishant,6,0,50,44
1657120635903,CSE 100,A01,083659,Cao; Yingjun,4,4,70,66
1657120641927,CSE 134B,A01,083661,Powell; Thomas Allan,19,0,100,81
1657120647951,CSE 140,A01,083663,Gungor; Onat,14,0,85,71
1657120653981,CSE 140L,A01,083088,Eldon; John,17,0,100,83
1657120660005,CSE 175,A01,083665,Kumar; Rakesh,3,0,25,22
1657120666029,CSE 190,A00,092507,Dubnov; Shlomo,7,0,20,13
1657120672054,ECE 45,A01,083139,Congero; Spencer William,5,0,75,70
1657120678081,ECE 65,A50,083695,Saad; Andrew S,12,0,30,18
1657120678081,ECE 65,A51,095125,Saad; Andrew S,25,0,26,1
1657120684113,ECE 109,A01,091882,Touri; Behrouz,16,0,70,54
1657120690139,ECE 180,A00,083140,Abi Samra; Nicholas Camill,1,0,30,29
1657120690139,ECE 180,B00,083141,Abi Samra; Nicholas Camill,0,0,30,30
1657120696167,MATH 10A,A01,083735,Patchell; Gregory David,1,0,30,29
1657120696167,MATH 10A,A02,083736,Patchell; Gregory David,20,0,30,10
1657120696167,MATH 10A,A03,083737,Patchell; Gregory David,16,0,30,14
1657120702191,MATH 10B,A01,083207,Lim; Seonhee,7,0,34,27
1657120702191,MATH 10B,A02,083208,Lim; Seonhee,9,0,35,26
1657120702191,MATH 10B,A03,093472,Lim; Seonhee,5,0,34,29
1657120702191,MATH 10B,B01,083739,Sinha; Shubham,9,0,30,21
1657120708214,MATH 18,A01,083743,Cinel; Cameron Alexander,6,0,30,24
1657120708214,MATH 18,A02,083744,Cinel; Cameron Alexander,15,0,30,15
1657120708214,MATH 18,A03,083745,Cinel; Cameron Alexander,8,0,30,22
1657120708214,MATH 18,B01,083748,Rideout; David Porter,4,0,37,33
1657120708214,MATH 18,B02,083749,Rideout; David Porter,3,0,36,33
1657120708214,MATH 18,B03,083750,Rideout; David Porter,2,0,37,35
1657120708214,MATH 18,B04,083751,Rideout; David Porter,5,0,36,31
1657120708214,MATH 18,B05,093473,Rideout; David Porter,4,0,36,32
1657120708214,MATH 18,B06,093474,Rideout; David Porter,5,0,36,31
1657120714244,MATH 20A,A01,083754,Zheng; Zequn,12,0,40,28
1657120720268,MATH 20B,A01,083756,Briones; Jor-el Thomas Caparas,1,0,36,35
1657120720268,MATH 20B,A02,083757,Briones; Jor-el Thomas Caparas,1,0,36,35
1657120720268,MATH 20B,A03,093475,Briones; Jor-el Thomas Caparas,0,0,36,36
1657120726293,MATH 20C,A01,083760,Briones; Jor-el Thomas Caparas,1,0,35,34
1657120726293,MATH 20C,A02,083761,Briones; Jor-el Thomas Caparas,8,0,35,27
1657120726293,MATH 20C,A03,093476,Briones; Jor-el Thomas Caparas,0,1,36,36
1657120726293,MATH 20C,B01,083762,Bach; Quang Tran,0,0,30,30
1657120732321,MATH 20D,A01,083765,Tran; Brian Kha,4,0,30,26
1657120732321,MATH 20D,A02,083766,Tran; Brian Kha,5,0,30,25
1657120732321,MATH 20D,A03,083767,Tran; Brian Kha,3,0,30,27
1657120738342,MATH 20E,A01,083771,Ganguly; Soumya,6,0,32,26
1657120738342,MATH 20E,A02,083772,Ganguly; Soumya,6,0,32,26
1657120738342,MATH 20E,B01,083773,Ciotti; Benjamin,18,0,35,17
1657120738342,MATH 20E,B02,083774,Ciotti; Benjamin,17,0,35,18
1657120744366,MATH 103A,A01,083777,Greenfeld; Be'Eri,2,0,36,34
1657120744366,MATH 103A,A02,083778,Greenfeld; Be'Eri,5,0,36,31
1657120744366,MATH 103A,A03,093561,Greenfeld; Be'Eri,4,0,36,32
1657120744366,MATH 103A,B01,083779,Greenfeld; Be'Eri,6,0,36,30
1657120744366,MATH 103A,B02,083780,Greenfeld; Be'Eri,2,0,36,34
1657120744366,MATH 103A,B03,093562,Greenfeld; Be'Eri,3,0,36,33
1657120750393,MATH 105,A01,085443,Carter; Anne Toulson,14,0,35,21
1657120750393,MATH 105,A02,093477,Carter; Anne Toulson,20,0,35,15
1657120756417,MATH 109,A01,083213,Ganzberger; Geoffrey Michael,2,0,34,32
1657120756417,MATH 109,A02,083214,Ganzberger; Geoffrey Michael,3,0,34,31
1657120756417,MATH 109,A03,093478,Ganzberger; Geoffrey Michael,1,0,34,33
1657120756417,MATH 109,B01,083215,Ganzberger; Geoffrey Michael,1,0,32,31
1657120756417,MATH 109,B02,083216,Ganzberger; Geoffrey Michael,1,0,32,31
1657120756417,MATH 109,B03,093479,Ganzberger; Geoffrey Michael,6,0,32,26
1657120762449,MATH 142A,A01,083219,Chow; Bennett,6,0,32,26
1657120762449,MATH 142A,A02,083220,Chow; Bennett,10,0,32,22
1657120762449,MATH 142A,A03,093480,Chow; Bennett,7,0,32,25
1657120762449,MATH 142A,B03,093481,Chow; Bennett,8,0,32,24
1657120762449,MATH 142A,B04,093558,Chow; Bennett,11,0,32,21
1657120762449,MATH 142A,B05,093559,Chow; Bennett,6,0,32,26
1657120768478,MATH 193A,A01,083224,Rotar; Vladimir,7,0,34,27
1657120768478,MATH 193A,A02,083225,Rotar; Vladimir,5,0,34,29
1657120768478,MATH 193A,A03,083781,Rotar; Vladimir,1,0,34,33
1657120768478,MATH 193A,A04,083782,Rotar; Vladimir,6,0,34,28
1657120768478,MATH 193A,A05,093482,Rotar; Vladimir,6,0,34,28
1657120774505,MATH 197,001,091859,McAuley; Julian John,9999,0,9999,0
1657120774505,MATH 197,002,095566,Kedlaya; Kiran S.,9997,0,9999,2
1657120774505,MATH 197,003,095567,Xiao; Ming,9999,0,9999,0
1657120774505,MATH 197,004,095571,Perols; Johan Lars,9998,0,9999,1
1657120781565,COGS 9,A01,083615,Shannon; Kyle Michael,7,0,75,68
1657120787589,COGS 11,A01,083617,Boyle; Mary E. T.,21,0,48,27
1657120793614,COGS 13,A01,083071,Bastos; Amalia Pinkusfeld,9,0,71,62
1657120799640,COGS 14A,A01,092681,Semenuks; Arturs,1,1,100,99
1657120805662,COGS 14B,A01,083073,Cheng; Tzu-Han,6,0,63,57
1657120811687,COGS 17,A01,092677,Semenuks; Arturs,4,0,81,77
1657120817716,COGS 100,A01,083619,Allen; Michael Gordon,15,0,70,55
1657120823738,COGS 101A,A01,083621,Davis; Joshua Daniel,9,0,68,59
1657120829763,COGS 101B,A01,091572,Allen; Michael Gordon,8,0,65,57
1657120835790,COGS 101C,A01,083625,Delgado; Tania,17,0,35,18
1657120841817,COGS 107A,A01,083627,Boyle; Mary E. T.,13,0,60,47
1657120847842,COGS 118A,A01,083075,Gupta; Anjum,15,0,76,61
1657120853866,CSE 3,A50,083646,Miranda; Gregory Joseph,22,0,50,28
1657120859892,CSE 8A,A50,083650,Miranda; Gregory Joseph,17,1,56,39
1657120865916,CSE 11,A01,083080,Cao; Yingjun,4,15,40,36
1657120871942,CSE 12,A01,083652,Krause-Levy; Sophia Louisa,23,1,120,97
1657120877974,CSE 15L,A01,083654,Morris; Justin Loren,9,0,50,41
1657120877974,CSE 15L,A02,083655,Morris; Justin Loren,9,0,50,41
1657120884042,CSE 20,A01,083657,Tran; Khoa Dang,37,0,80,43
1657120890071,CSE 21,A01,095574,Bach; Quang Tran,21,0,48,27
1657120896097,CSE 30,A01,083084,Eldon; John,4,0,80,76
1657120896097,CSE 30,B01,095061,Bhaskar; Nishant,6,0,50,44
1657120902124,CSE 100,A01,083659,Cao; Yingjun,4,4,70,66
1657120908166,CSE 134B,A01,083661,Powell; Thomas Allan,19,0,100,81
1657120914193,CSE 140,A01,083663,Gungor; Onat,14,0,85,71
1657120920222,CSE 140L,A01,083088,Eldon; John,17,0,100,83
1657120926247,CSE 175,A01,083665,Kumar; Rakesh,3,0,25,22
1657120932273,CSE 190,A00,092507,Dubnov; Shlomo,7,0,20,13
1657120938301,ECE 45,A01,083139,Congero; Spencer William,5,0,75,70
1657120944324,ECE 65,A50,083695,Saad; Andrew S,12,0,30,18
1657120944324,ECE 65,A51,095125,Saad; Andrew S,25,0,26,1
1657120950353,ECE 109,A01,091882,Touri; Behrouz,16,0,70,54
1657120956381,ECE 180,A00,083140,Abi Samra; Nicholas Camill,1,0,30,29
1657120956381,ECE 180,B00,083141,Abi Samra; Nicholas Camill,0,0,30,30
1657120962414,MATH 10A,A01,083735,Patchell; Gregory David,1,0,30,29
1657120962414,MATH 10A,A02,083736,Patchell; Gregory David,20,0,30,10
1657120962414,MATH 10A,A03,083737,Patchell; Gregory David,16,0,30,14
1657120968450,MATH 10B,A01,083207,Lim; Seonhee,7,0,34,27
1657120968450,MATH 10B,A02,083208,Lim; Seonhee,9,0,35,26
1657120968450,MATH 10B,A03,093472,Lim; Seonhee,5,0,34,29
1657120968450,MATH 10B,B01,083739,Sinha; Shubham,9,0,30,21
1657120974475,MATH 18,A01,083743,Cinel; Cameron Alexander,6,0,30,24
1657120974475,MATH 18,A02,083744,Cinel; Cameron Alexander,15,0,30,15
1657120974475,MATH 18,A03,083745,Cinel; Cameron Alexander,8,0,30,22
1657120974475,MATH 18,B01,083748,Rideout; David Porter,4,0,37,33
1657120974475,MATH 18,B02,083749,Rideout; David Porter,3,0,36,33
1657120974475,MATH 18,B03,083750,Rideout; David Porter,2,0,37,35
1657120974475,MATH 18,B04,083751,Rideout; David Porter,5,0,36,31
1657120974475,MATH 18,B05,093473,Rideout; David Porter,4,0,36,32
1657120974475,MATH 18,B06,093474,Rideout; David Porter,5,0,36,31
1657120980512,MATH 20A,A01,083754,Zheng; Zequn,12,0,40,28
1657120986537,MATH 20B,A01,083756,Briones; Jor-el Thomas Caparas,1,0,36,35
1657120986537,MATH 20B,A02,083757,Briones; Jor-el Thomas Caparas,1,0,36,35
1657120986537,MATH 20B,A03,093475,Briones; Jor-el Thomas Caparas,0,0,36,36
1657120992569,MATH 20C,A01,083760,Briones; Jor-el Thomas Caparas,1,0,35,34
1657120992569,MATH 20C,A02,083761,Briones; Jor-el Thomas Caparas,8,0,35,27
1657120992569,MATH 20C,A03,093476,Briones; Jor-el Thomas Caparas,0,1,36,36
1657120992569,MATH 20C,B01,083762,Bach; Quang Tran,0,0,30,30
1657120998598,MATH 20D,A01,083765,Tran; Brian Kha,4,0,30,26
1657120998598,MATH 20D,A02,083766,Tran; Brian Kha,5,0,30,25
1657120998598,MATH 20D,A03,083767,Tran; Brian Kha,3,0,30,27
1657121004631,MATH 20E,A01,083771,Ganguly; Soumya,6,0,32,26
1657121004631,MATH 20E,A02,083772,Ganguly; Soumya,6,0,32,26
1657121004631,MATH 20E,B01,083773,Ciotti; Benjamin,18,0,35,17
1657121004631,MATH 20E,B02,083774,Ciotti; Benjamin,17,0,35,18
1657121010662,MATH 103A,A01,083777,Greenfeld; Be'Eri,2,0,36,34
1657121010662,MATH 103A,A02,083778,Greenfeld; Be'Eri,5,0,36,31
1657121010662,MATH 103A,A03,093561,Greenfeld; Be'Eri,4,0,36,32
1657121010662,MATH 103A,B01,083779,Greenfeld; Be'Eri,6,0,36,30
1657121010662,MATH 103A,B02,083780,Greenfeld; Be'Eri,2,0,36,34
1657121010662,MATH 103A,B03,093562,Greenfeld; Be'Eri,3,0,36,33
1657121016687,MATH 105,A01,085443,Carter; Anne Toulson,14,0,35,21
1657121016687,MATH 105,A02,093477,Carter; Anne Toulson,20,0,35,15
1657121022716,MATH 109,A01,083213,Ganzberger; Geoffrey Michael,2,0,34,32
1657121022716,MATH 109,A02,083214,Ganzberger; Geoffrey Michael,3,0,34,31
1657121022716,MATH 109,A03,093478,Ganzberger; Geoffrey Michael,1,0,34,33
1657121022716,MATH 109,B01,083215,Ganzberger; Geoffrey Michael,1,0,32,31
1657121022716,MATH 109,B02,083216,Ganzberger; Geoffrey Michael,1,0,32,31
1657121022716,MATH 109,B03,093479,Ganzberger; Geoffrey Michael,6,0,32,26
1657121028747,MATH 142A,A01,083219,Chow; Bennett,6,0,32,26
1657121028747,MATH 142A,A02,083220,Chow; Bennett,10,0,32,22
1657121028747,MATH 142A,A03,093480,Chow; Bennett,7,0,32,25
1657121028747,MATH 142A,B03,093481,Chow; Bennett,8,0,32,24
1657121028747,MATH 142A,B04,093558,Chow; Bennett,11,0,32,21
1657121028747,MATH 142A,B05,093559,Chow; Bennett,6,0,32,26
1657121034775,MATH 193A,A01,083224,Rotar; Vladimir,7,0,34,27
1657121034775,MATH 193A,A02,083225,Rotar; Vladimir,5,0,34,29
1657121034775,MATH 193A,A03,083781,Rotar; Vladimir,1,0,34,33
1657121034775,MATH 193A,A04,083782,Rotar; Vladimir,6,0,34,28
1657121034775,MATH 193A,A05,093482,Rotar; Vladimir,6,0,34,28
1657121040813,MATH 197,001,091859,McAuley; Julian John,9999,0,9999,0
1657121040813,MATH 197,002,095566,Kedlaya; Kiran S.,9997,0,9999,2
1657121040813,MATH 197,003,095567,Xiao; Ming,9999,0,9999,0
1657121040813,MATH 197,004,095571,Perols; Johan Lars,9998,0,9999,1
1657121047873,COGS 9,A01,083615,Shannon; Kyle Michael,7,0,75,68
1657121053970,COGS 11,A01,083617,Boyle; Mary E. T.,21,0,48,27
1657121059995,COGS 13,A01,083071,Bastos; Amalia Pinkusfeld,9,0,71,62
1657121066019,COGS 14A,A01,092681,Semenuks; Arturs,1,1,100,99
1657121072043,COGS 14B,A01,083073,Cheng; Tzu-Han,6,0,63,57
1657121078067,COGS 17,A01,092677,Semenuks; Arturs,4,0,81,77
1657121084103,COGS 100,A01,083619,Allen; Michael Gordon,15,0,70,55
1657121090131,COGS 101A,A01,083621,Davis; Joshua Daniel,9,0,68,59
1657121096156,COGS 101B,A01,091572,Allen; Michael Gordon,8,0,65,57
1657121102180,COGS 101C,A01,083625,Delgado; Tania,17,0,35,18
1657121108205,COGS 107A,A01,083627,Boyle; Mary E. T.,13,0,60,47
1657121114232,COGS 118A,A01,083075,Gupta; Anjum,15,0,76,61
1657121120257,CSE 3,A50,083646,Miranda; Gregory Joseph,22,0,50,28
1657121126289,CSE 8A,A50,083650,Miranda; Gregory Joseph,17,1,56,39
1657121132313,CSE 11,A01,083080,Cao; Yingjun,4,15,40,36
1657121138340,CSE 12,A01,083652,Krause-Levy; Sophia Louisa,23,1,120,97
1657121144371,CSE 15L,A01,083654,Morris; Justin Loren,9,0,50,41
1657121144371,CSE 15L,A02,083655,Morris; Justin Loren,9,0,50,41
1657121150395,CSE 20,A01,083657,Tran; Khoa Dang,37,0,80,43
1657121156437,CSE 21,A01,095574,Bach; Quang Tran,21,0,48,27
1657121162463,CSE 30,A01,083084,Eldon; John,4,0,80,76
1657121162463,CSE 30,B01,095061,Bhaskar; Nishant,6,0,50,44
1657121168499,CSE 100,A01,083659,Cao; Yingjun,4,4,70,66
1657121174526,CSE 134B,A01,083661,Powell; Thomas Allan,19,0,100,81
1657121180550,CSE 140,A01,083663,Gungor; Onat,14,0,85,71
1657121186575,CSE 140L,A01,083088,Eldon; John,17,0,100,83
1657121192599,CSE 175,A01,083665,Kumar; Rakesh,3,0,25,22
1657121198625,CSE 190,A00,092507,Dubnov; Shlomo,7,0,20,13
1657121204648,ECE 45,A01,083139,Congero; Spencer William,5,0,75,70
1657121210673,ECE 65,A50,083695,Saad; Andrew S,12,0,30,18
1657121210673,ECE 65,A51,095125,Saad; Andrew S,25,0,26,1
1657121216699,ECE 109,A01,091882,Touri; Behrouz,16,0,70,54
1657121222724,ECE 180,A00,083140,Abi Samra; Nicholas Camill,1,0,30,29
1657121222724,ECE 180,B00,083141,Abi Samra; Nicholas Camill,0,0,30,30
1657121228749,MATH 10A,A01,083735,Patchell; Gregory David,1,0,30,29
1657121228749,MATH 10A,A02,083736,Patchell; Gregory David,20,0,30,10
1657121228749,MATH 10A,A03,083737,Patchell; Gregory David,16,0,30,14
1657121234779,MATH 10B,A01,083207,Lim; Seonhee,7,0,34,27
1657121234779,MATH 10B,A02,083208,Lim; Seonhee,9,0,35,26
1657121234779,MATH 10B,A03,093472,Lim; Seonhee,5,0,34,29
1657121234779,MATH 10B,B01,083739,Sinha; Shubham,9,0,30,21
1657121240812,MATH 18,A01,083743,Cinel; Cameron Alexander,6,0,30,24
1657121240812,MATH 18,A02,083744,Cinel; Cameron Alexander,15,0,30,15
1657121240812,MATH 18,A03,083745,Cinel; Cameron Alexander,8,0,30,22
1657121240812,MATH 18,B01,083748,Rideout; David Porter,4,0,37,33
1657121240812,MATH 18,B02,083749,Rideout; David Porter,3,0,36,33
1657121240812,MATH 18,B03,083750,Rideout; David Porter,2,0,37,35
1657121240812,MATH 18,B04,083751,Rideout; David Porter,5,0,36,31
1657121240812,MATH 18,B05,093473,Rideout; David Porter,4,0,36,32
1657121240812,MATH 18,B06,093474,Rideout; David Porter,5,0,36,31
1657121246838,MATH 20A,A01,083754,Zheng; Zequn,12,0,40,28
1657121252867,MATH 20B,A01,083756,Briones; Jor-el Thomas Caparas,1,0,36,35
1657121252867,MATH 20B,A02,083757,Briones; Jor-el Thomas Caparas,1,0,36,35
1657121252867,MATH 20B,A03,093475,Briones; Jor-el Thomas Caparas,0,0,36,36
1657121258890,MATH 20C,A01,083760,Briones; Jor-el Thomas Caparas,1,0,35,34
1657121258890,MATH 20C,A02,083761,Briones; Jor-el Thomas Caparas,8,0,35,27
1657121258890,MATH 20C,A03,093476,Briones; Jor-el Thomas Caparas,0,1,36,36
1657121258890,MATH 20C,B01,083762,Bach; Quang Tran,0,0,30,30
1657121264917,MATH 20D,A01,083765,Tran; Brian Kha,4,0,30,26
1657121264917,MATH 20D,A02,083766,Tran; Brian Kha,5,0,30,25
1657121264917,MATH 20D,A03,083767,Tran; Brian Kha,3,0,30,27
1657121270945,MATH 20E,A01,083771,Ganguly; Soumya,6,0,32,26
1657121270945,MATH 20E,A02,083772,Ganguly; Soumya,6,0,32,26
1657121270945,MATH 20E,B01,083773,Ciotti; Benjamin,18,0,35,17
1657121270945,MATH 20E,B02,083774,Ciotti; Benjamin,17,0,35,18
1657121276974,MATH 103A,A01,083777,Greenfeld; Be'Eri,2,0,36,34
1657121276974,MATH 103A,A02,083778,Greenfeld; Be'Eri,5,0,36,31
1657121276974,MATH 103A,A03,093561,Greenfeld; Be'Eri,4,0,36,32
1657121276974,MATH 103A,B01,083779,Greenfeld; Be'Eri,6,0,36,30
1657121276974,MATH 103A,B02,083780,Greenfeld; Be'Eri,2,0,36,34
1657121276974,MATH 103A,B03,093562,Greenfeld; Be'Eri,3,0,36,33
1657121282996,MATH 105,A01,085443,Carter; Anne Toulson,14,0,35,21
1657121282996,MATH 105,A02,093477,Carter; Anne Toulson,20,0,35,15
1657121289019,MATH 109,A01,083213,Ganzberger; Geoffrey Michael,2,0,34,32
1657121289019,MATH 109,A02,083214,Ganzberger; Geoffrey Michael,3,0,34,31
1657121289019,MATH 109,A03,093478,Ganzberger; Geoffrey Michael,1,0,34,33
1657121289019,MATH 109,B01,083215,Ganzberger; Geoffrey Michael,1,0,32,31
1657121289019,MATH 109,B02,083216,Ganzberger; Geoffrey Michael,1,0,32,31
1657121289019,MATH 109,B03,093479,Ganzberger; Geoffrey Michael,6,0,32,26
1657121295053,MATH 142A,A01,083219,Chow; Bennett,6,0,32,26
1657121295053,MATH 142A,A02,083220,Chow; Bennett,10,0,32,22
1657121295053,MATH 142A,A03,093480,Chow; Bennett,7,0,32,25
1657121295053,MATH 142A,B03,093481,Chow; Bennett,8,0,32,24
1657121295053,MATH 142A,B04,093558,Chow; Bennett,11,0,32,21
1657121295053,MATH 142A,B05,093559,Chow; Bennett,6,0,32,26
1657121301081,MATH 193A,A01,083224,Rotar; Vladimir,7,0,34,27
1657121301081,MATH 193A,A02,083225,Rotar; Vladimir,5,0,34,29
1657121301081,MATH 193A,A03,083781,Rotar; Vladimir,1,0,34,33
1657121301081,MATH 193A,A04,083782,Rotar; Vladimir,6,0,34,28
1657121301081,MATH 193A,A05,093482,Rotar; Vladimir,6,0,34,28
1657121307106,MATH 197,001,091859,McAuley; Julian John,9999,0,9999,0
1657121307106,MATH 197,002,095566,Kedlaya; Kiran S.,9997,0,9999,2
1657121307106,MATH 197,003,095567,Xiao; Ming,9999,0,9999,0
1657121307106,MATH 197,004,095571,Perols; Johan Lars,9998,0,9999,1
1657121314184,COGS 9,A01,083615,Shannon; Kyle Michael,7,0,75,68
1657121320207,COGS 11,A01,083617,Boyle; Mary E. T.,21,0,48,27
1657121326231,COGS 13,A01,083071,Bastos; Amalia Pinkusfeld,9,0,71,62
1657121332257,COGS 14A,A01,092681,Semenuks; Arturs,1,1,100,99
1657121338284,COGS 14B,A01,083073,Cheng; Tzu-Han,6,0,63,57
1657121344316,COGS 17,A01,092677,Semenuks; Arturs,4,0,81,77
1657121350340,COGS 100,A01,083619,Allen; Michael Gordon,15,0,70,55
1657121356365,COGS 101A,A01,083621,Davis; Joshua Daniel,9,0,68,59
1657121362394,COGS 101B,A01,091572,Allen; Michael Gordon,8,0,65,57
1657121368417,COGS 101C,A01,083625,Delgado; Tania,17,0,35,18
1657121374442,COGS 107A,A01,083627,Boyle; Mary E. T.,13,0,60,47
1657121380470,COGS 118A,A01,083075,Gupta; Anjum,15,0,76,61
1657121386495,CSE 3,A50,083646,Miranda; Gregory Joseph,22,0,50,28
1657121392519,CSE 8A,A50,083650,Miranda; Gregory Joseph,17,1,56,39
1657121398554,CSE 11,A01,083080,Cao; Yingjun,4,15,40,36
1657121404580,CSE 12,A01,083652,Krause-Levy; Sophia Louisa,23,1,120,97
1657121410603,CSE 15L,A01,083654,Morris; Justin Loren,9,0,50,41
1657121410603,CSE 15L,A02,083655,Morris; Justin Loren,9,0,50,41
1657121416630,CSE 20,A01,083657,Tran; Khoa Dang,37,0,80,43
1657121422662,CSE 21,A01,095574,Bach; Quang Tran,21,0,48,27
1657121428687,CSE 30,A01,083084,Eldon; John,4,0,80,76
1657121428687,CSE 30,B01,095061,Bhaskar; Nishant,6,0,50,44
1657121434712,CSE 100,A01,083659,Cao; Yingjun,4,4,70,66
1657121440740,CSE 134B,A01,083661,Powell; Thomas Allan,19,0,100,81
1657121446767,CSE 140,A01,083663,Gungor; Onat,14,0,85,71
1657121452790,CSE 140L,A01,083088,Eldon; John,17,0,100,83
1657121458816,CSE 175,A01,083665,Kumar; Rakesh,3,0,25,22
1657121464840,CSE 190,A00,092507,Dubnov; Shlomo,7,0,20,13
1657121470863,ECE 45,A01,083139,Congero; Spencer William,5,0,75,70
1657121476898,ECE 65,A50,083695,Saad; Andrew S,12,0,30,18
1657121476898,ECE 65,A51,095125,Saad; Andrew S,25,0,26,1
1657121482921,ECE 109,A01,091882,Touri; Behrouz,16,0,70,54
1657121488944,ECE 180,A00,083140,Abi Samra; Nicholas Camill,1,0,30,29
1657121488944,ECE 180,B00,083141,Abi Samra; Nicholas Camill,0,0,30,30
1657121494969,MATH 10A,A01,083735,Patchell; Gregory David,1,0,30,29
1657121494969,MATH 10A,A02,083736,Patchell; Gregory David,20,0,30,10
1657121494969,MATH 10A,A03,083737,Patchell; Gregory David,16,0,30,14
1657121500999,MATH 10B,A01,083207,Lim; Seonhee,7,0,34,27
1657121500999,MATH 10B,A02,083208,Lim; Seonhee,9,0,35,26
1657121500999,MATH 10B,A03,093472,Lim; Seonhee,5,0,34,29
1657121500999,MATH 10B,B01,083739,Sinha; Shubham,9,0,30,21
1657121507030,MATH 18,A01,083743,Cinel; Cameron Alexander,6,0,30,24
1657121507030,MATH 18,A02,083744,Cinel; Cameron Alexander,15,0,30,15
1657121507030,MATH 18,A03,083745,Cinel; Cameron Alexander,8,0,30,22
1657121507030,MATH 18,B01,083748,Rideout; David Porter,4,0,37,33
1657121507030,MATH 18,B02,083749,Rideout; David Porter,3,0,36,33
1657121507030,MATH 18,B03,083750,Rideout; David Porter,2,0,37,35
1657121507030,MATH 18,B04,083751,Rideout; David Porter,5,0,36,31
1657121507030,MATH 18,B05,093473,Rideout; David Porter,4,0,36,32
1657121507030,MATH 18,B06,093474,Rideout; David Porter,5,0,36,31
1657121513056,MATH 20A,A01,083754,Zheng; Zequn,12,0,40,28
1657121519084,MATH 20B,A01,083756,Briones; Jor-el Thomas Caparas,1,0,36,35
1657121519084,MATH 20B,A02,083757,Briones; Jor-el Thomas Caparas,1,0,36,35
1657121519084,MATH 20B,A03,093475,Briones; Jor-el Thomas Caparas,0,0,36,36
1657121525108,MATH 20C,A01,083760,Briones; Jor-el Thomas Caparas,1,0,35,34
1657121525108,MATH 20C,A02,083761,Briones; Jor-el Thomas Caparas,8,0,35,27
1657121525108,MATH 20C,A03,093476,Briones; Jor-el Thomas Caparas,0,1,36,36
1657121525108,MATH 20C,B01,083762,Bach; Quang Tran,0,0,30,30
1657121531133,MATH 20D,A01,083765,Tran; Brian Kha,4,0,30,26
1657121531133,MATH 20D,A02,083766,Tran; Brian Kha,5,0,30,25
1657121531133,MATH 20D,A03,083767,Tran; Brian Kha,3,0,30,27
1657121537157,MATH 20E,A01,083771,Ganguly; Soumya,6,0,32,26
1657121537157,MATH 20E,A02,083772,Ganguly; Soumya,6,0,32,26
1657121537157,MATH 20E,B01,083773,Ciotti; Benjamin,18,0,35,17
1657121537157,MATH 20E,B02,083774,Ciotti; Benjamin,17,0,35,18
1657121543185,MATH 103A,A01,083777,Greenfeld; Be'Eri,2,0,36,34
1657121543185,MATH 103A,A02,083778,Greenfeld; Be'Eri,5,0,36,31
1657121543185,MATH 103A,A03,093561,Greenfeld; Be'Eri,4,0,36,32
1657121543185,MATH 103A,B01,083779,Greenfeld; Be'Eri,6,0,36,30
1657121543185,MATH 103A,B02,083780,Greenfeld; Be'Eri,2,0,36,34
1657121543185,MATH 103A,B03,093562,Greenfeld; Be'Eri,3,0,36,33
1657121549213,MATH 105,A01,085443,Carter; Anne Toulson,14,0,35,21
1657121549213,MATH 105,A02,093477,Carter; Anne Toulson,20,0,35,15
1657121555235,MATH 109,A01,083213,Ganzberger; Geoffrey Michael,2,0,34,32
1657121555235,MATH 109,A02,083214,Ganzberger; Geoffrey Michael,3,0,34,31
1657121555235,MATH 109,A03,093478,Ganzberger; Geoffrey Michael,1,0,34,33
1657121555235,MATH 109,B01,083215,Ganzberger; Geoffrey Michael,1,0,32,31
1657121555235,MATH 109,B02,083216,Ganzberger; Geoffrey Michael,1,0,32,31
1657121555235,MATH 109,B03,093479,Ganzberger; Geoffrey Michael,6,0,32,26
1657121561260,MATH 142A,A01,083219,Chow; Bennett,6,0,32,26
1657121561260,MATH 142A,A02,083220,Chow; Bennett,10,0,32,22
1657121561260,MATH 142A,A03,093480,Chow; Bennett,7,0,32,25
1657121561260,MATH 142A,B03,093481,Chow; Bennett,8,0,32,24
1657121561260,MATH 142A,B04,093558,Chow; Bennett,11,0,32,21
1657121561260,MATH 142A,B05,093559,Chow; Bennett,6,0,32,26
1657121567292,MATH 193A,A01,083224,Rotar; Vladimir,7,0,34,27
1657121567292,MATH 193A,A02,083225,Rotar; Vladimir,5,0,34,29
1657121567292,MATH 193A,A03,083781,Rotar; Vladimir,1,0,34,33
1657121567292,MATH 193A,A04,083782,Rotar; Vladimir,6,0,34,28
1657121567292,MATH 193A,A05,093482,Rotar; Vladimir,6,0,34,28
1657121573327,MATH 197,001,091859,McAuley; Julian John,9999,0,9999,0
1657121573327,MATH 197,002,095566,Kedlaya; Kiran S.,9997,0,9999,2
1657121573327,MATH 197,003,095567,Xiao; Ming,9999,0,9999,0
1657121573327,MATH 197,004,095571,Perols; Johan Lars,9998,0,9999,1
1657121580389,COGS 9,A01,083615,Shannon; Kyle Michael,7,0,75,68
1657121586411,COGS 11,A01,083617,Boyle; Mary E. T.,21,0,48,27
1657121592433,COGS 13,A01,083071,Bastos; Amalia Pinkusfeld,9,0,71,62
1657121598459,COGS 14A,A01,092681,Semenuks; Arturs,1,1,100,99
1657121604484,COGS 14B,A01,083073,Cheng; Tzu-Han,6,0,63,57
1657121610508,COGS 17,A01,092677,Semenuks; Arturs,4,0,81,77
1657121616535,COGS 100,A01,083619,Allen; Michael Gordon,15,0,70,55
1657121622584,COGS 101A,A01,083621,Davis; Joshua Daniel,9,0,68,59
1657121628616,COGS 101B,A01,091572,Allen; Michael Gordon,8,0,65,57
1657121634642,COGS 101C,A01,083625,Delgado; Tania,17,0,35,18
1657121640676,COGS 107A,A01,083627,Boyle; Mary E. T.,13,0,60,47
1657121646699,COGS 118A,A01,083075,Gupta; Anjum,15,0,76,61
1657121652795,CSE 3,A50,083646,Miranda; Gregory Joseph,22,0,50,28
1657121658821,CSE 8A,A50,083650,Miranda; Gregory Joseph,17,1,56,39
1657121664847,CSE 11,A01,083080,Cao; Yingjun,4,15,40,36
1657121670874,CSE 12,A01,083652,Krause-Levy; Sophia Louisa,23,1,120,97
1657121676902,CSE 15L,A01,083654,Morris; Justin Loren,9,0,50,41
1657121676902,CSE 15L,A02,083655,Morris; Justin Loren,9,0,50,41
1657121682928,CSE 20,A01,083657,Tran; Khoa Dang,37,0,80,43
1657121688954,CSE 21,A01,095574,Bach; Quang Tran,21,0,48,27
1657121694977,CSE 30,A01,083084,Eldon; John,4,0,80,76
1657121694977,CSE 30,B01,095061,Bhaskar; Nishant,6,0,50,44
1657121701007,CSE 100,A01,083659,Cao; Yingjun,4,4,70,66
1657121707029,CSE 134B,A01,083661,Powell; Thomas Allan,19,0,100,81
1657121713068,CSE 140,A01,083663,Gungor; Onat,14,0,85,71
1657121719092,CSE 140L,A01,083088,Eldon; John,17,0,100,83
1657121725116,CSE 175,A01,083665,Kumar; Rakesh,3,0,25,22
1657121731145,CSE 190,A00,092507,Dubnov; Shlomo,7,0,20,13
1657121737170,ECE 45,A01,083139,Congero; Spencer William,5,0,75,70
1657121743213,ECE 65,A50,083695,Saad; Andrew S,12,0,30,18
1657121743213,ECE 65,A51,095125,Saad; Andrew S,25,0,26,1
1657121749236,ECE 109,A01,091882,Touri; Behrouz,16,0,70,54
1657121755259,ECE 180,A00,083140,Abi Samra; Nicholas Camill,1,0,30,29
1657121755259,ECE 180,B00,083141,Abi Samra; Nicholas Camill,0,0,30,30
1657121761295,MATH 10A,A01,083735,Patchell; Gregory David,1,0,30,29
1657121761295,MATH 10A,A02,083736,Patchell; Gregory David,20,0,30,10
1657121761295,MATH 10A,A03,083737,Patchell; Gregory David,16,0,30,14
1657121767322,MATH 10B,A01,083207,Lim; Seonhee,7,0,34,27
1657121767322,MATH 10B,A02,083208,Lim; Seonhee,9,0,35,26
1657121767322,MATH 10B,A03,093472,Lim; Seonhee,5,0,34,29
1657121767322,MATH 10B,B01,083739,Sinha; Shubham,9,0,30,21
1657121773356,MATH 18,A01,083743,Cinel; Cameron Alexander,6,0,30,24
1657121773356,MATH 18,A02,083744,Cinel; Cameron Alexander,15,0,30,15
1657121773356,MATH 18,A03,083745,Cinel; Cameron Alexander,8,0,30,22
1657121773356,MATH 18,B01,083748,Rideout; David Porter,4,0,37,33
1657121773356,MATH 18,B02,083749,Rideout; David Porter,3,0,36,33
1657121773356,MATH 18,B03,083750,Rideout; David Porter,2,0,37,35
1657121773356,MATH 18,B04,083751,Rideout; David Porter,5,0,36,31
1657121773356,MATH 18,B05,093473,Rideout; David Porter,4,0,36,32
1657121773356,MATH 18,B06,093474,Rideout; David Porter,5,0,36,31
1657121779379,MATH 20A,A01,083754,Zheng; Zequn,12,0,40,28
1657121785409,MATH 20B,A01,083756,Briones; Jor-el Thomas Caparas,1,0,36,35
1657121785409,MATH 20B,A02,083757,Briones; Jor-el Thomas Caparas,1,0,36,35
1657121785409,MATH 20B,A03,093475,Briones; Jor-el Thomas Caparas,0,0,36,36
1657121791435,MATH 20C,A01,083760,Briones; Jor-el Thomas Caparas,1,0,35,34
1657121791435,MATH 20C,A02,083761,Briones; Jor-el Thomas Caparas,8,0,35,27
1657121791435,MATH 20C,A03,093476,Briones; Jor-el Thomas Caparas,0,1,36,36
1657121791435,MATH 20C,B01,083762,Bach; Quang Tran,0,0,30,30
1657121797460,MATH 20D,A01,083765,Tran; Brian Kha,4,0,30,26
1657121797460,MATH 20D,A02,083766,Tran; Brian Kha,5,0,30,25
1657121797460,MATH 20D,A03,083767,Tran; Brian Kha,3,0,30,27
1657121803485,MATH 20E,A01,083771,Ganguly; Soumya,6,0,32,26
1657121803485,MATH 20E,A02,083772,Ganguly; Soumya,6,0,32,26
1657121803485,MATH 20E,B01,083773,Ciotti; Benjamin,18,0,35,17
1657121803485,MATH 20E,B02,083774,Ciotti; Benjamin,17,0,35,18
1657121809509,MATH 103A,A01,083777,Greenfeld; Be'Eri,2,0,36,34
1657121809509,MATH 103A,A02,083778,Greenfeld; Be'Eri,5,0,36,31
1657121809509,MATH 103A,A03,093561,Greenfeld; Be'Eri,4,0,36,32
1657121809509,MATH 103A,B01,083779,Greenfeld; Be'Eri,6,0,36,30
1657121809509,MATH 103A,B02,083780,Greenfeld; Be'Eri,2,0,36,34
1657121809509,MATH 103A,B03,093562,Greenfeld; Be'Eri,3,0,36,33
1657121815556,MATH 105,A01,085443,Carter; Anne Toulson,14,0,35,21
1657121815556,MATH 105,A02,093477,Carter; Anne Toulson,20,0,35,15
1657121821586,MATH 109,A01,083213,Ganzberger; Geoffrey Michael,2,0,34,32
1657121821586,MATH 109,A02,083214,Ganzberger; Geoffrey Michael,3,0,34,31
1657121821586,MATH 109,A03,093478,Ganzberger; Geoffrey Michael,1,0,34,33
1657121821586,MATH 109,B01,083215,Ganzberger; Geoffrey Michael,1,0,32,31
1657121821586,MATH 109,B02,083216,Ganzberger; Geoffrey Michael,1,0,32,31
1657121821586,MATH 109,B03,093479,Ganzberger; Geoffrey Michael,6,0,32,26
1657121827614,MATH 142A,A01,083219,Chow; Bennett,6,0,32,26
1657121827614,MATH 142A,A02,083220,Chow; Bennett,10,0,32,22
1657121827614,MATH 142A,A03,093480,Chow; Bennett,7,0,32,25
1657121827614,MATH 142A,B03,093481,Chow; Bennett,8,0,32,24
1657121827614,MATH 142A,B04,093558,Chow; Bennett,11,0,32,21
1657121827614,MATH 142A,B05,093559,Chow; Bennett,6,0,32,26
1657121833640,MATH 193A,A01,083224,Rotar; Vladimir,7,0,34,27
1657121833640,MATH 193A,A02,083225,Rotar; Vladimir,5,0,34,29
1657121833640,MATH 193A,A03,083781,Rotar; Vladimir,1,0,34,33
1657121833640,MATH 193A,A04,083782,Rotar; Vladimir,6,0,34,28
1657121833640,MATH 193A,A05,093482,Rotar; Vladimir,6,0,34,28
1657121839664,MATH 197,001,091859,McAuley; Julian John,9999,0,9999,0
1657121839664,MATH 197,002,095566,Kedlaya; Kiran S.,9997,0,9999,2
1657121839664,MATH 197,003,095567,Xiao; Ming,9999,0,9999,0
1657121839664,MATH 197,004,095571,Perols; Johan Lars,9998,0,9999,1
1657121846720,COGS 9,A01,083615,Shannon; Kyle Michael,7,0,75,68
1657121852745,COGS 11,A01,083617,Boyle; Mary E. T.,21,0,48,27
1657121858774,COGS 13,A01,083071,Bastos; Amalia Pinkusfeld,9,0,71,62
1657121864801,COGS 14A,A01,092681,Semenuks; Arturs,1,1,100,99
1657121870825,COGS 14B,A01,083073,Cheng; Tzu-Han,6,0,63,57
1657121876848,COGS 17,A01,092677,Semenuks; Arturs,4,0,81,77
1657121882872,COGS 100,A01,083619,Allen; Michael Gordon,15,0,70,55
1657121888895,COGS 101A,A01,083621,Davis; Joshua Daniel,9,0,68,59
1657121894921,COGS 101B,A01,091572,Allen; Michael Gordon,8,0,65,57
1657121900945,COGS 101C,A01,083625,Delgado; Tania,17,0,35,18
1657121906972,COGS 107A,A01,083627,Boyle; Mary E. T.,13,0,60,47
1657121912994,COGS 118A,A01,083075,Gupta; Anjum,15,0,76,61
1657121919025,CSE 3,A50,083646,Miranda; Gregory Joseph,22,0,50,28
1657121925051,CSE 8A,A50,083650,Miranda; Gregory Joseph,17,1,56,39
1657121931075,CSE 11,A01,083080,Cao; Yingjun,4,15,40,36
1657121937098,CSE 12,A01,083652,Krause-Levy; Sophia Louisa,23,1,120,97
1657121943121,CSE 15L,A01,083654,Morris; Justin Loren,9,0,50,41
1657121943121,CSE 15L,A02,083655,Morris; Justin Loren,9,0,50,41
1657121949144,CSE 20,A01,083657,Tran; Khoa Dang,37,0,80,43
1657121955167,CSE 21,A01,095574,Bach; Quang Tran,21,0,48,27
1657121961195,CSE 30,A01,083084,Eldon; John,4,0,80,76
1657121961195,CSE 30,B01,095061,Bhaskar; Nishant,6,0,50,44
1657121967232,CSE 100,A01,083659,Cao; Yingjun,4,4,70,66
1657121973255,CSE 134B,A01,083661,Powell; Thomas Allan,19,0,100,81
1657121979341,CSE 140,A01,083663,Gungor; Onat,14,0,85,71
1657121985368,CSE 140L,A01,083088,Eldon; John,17,0,100,83
1657121991397,CSE 175,A01,083665,Kumar; Rakesh,3,0,25,22
1657121997430,CSE 190,A00,092507,Dubnov; Shlomo,7,0,20,13
1657122003462,ECE 45,A01,083139,Congero; Spencer William,5,0,75,70
1657122009492,ECE 65,A50,083695,Saad; Andrew S,12,0,30,18
1657122009492,ECE 65,A51,095125,Saad; Andrew S,25,0,26,1
1657122015516,ECE 109,A01,091882,Touri; Behrouz,16,0,70,54
1657122021546,ECE 180,A00,083140,Abi Samra; Nicholas Camill,1,0,30,29
1657122021546,ECE 180,B00,083141,Abi Samra; Nicholas Camill,0,0,30,30
1657122027571,MATH 10A,A01,083735,Patchell; Gregory David,1,0,30,29
1657122027571,MATH 10A,A02,083736,Patchell; Gregory David,20,0,30,10
1657122027571,MATH 10A,A03,083737,Patchell; Gregory David,16,0,30,14
1657122033596,MATH 10B,A01,083207,Lim; Seonhee,7,0,34,27
1657122033596,MATH 10B,A02,083208,Lim; Seonhee,9,0,35,26
1657122033596,MATH 10B,A03,093472,Lim; Seonhee,5,0,34,29
1657122033596,MATH 10B,B01,083739,Sinha; Shubham,9,0,30,21
1657122039623,MATH 18,A01,083743,Cinel; Cameron Alexander,6,0,30,24
1657122039623,MATH 18,A02,083744,Cinel; Cameron Alexander,15,0,30,15
1657122039623,MATH 18,A03,083745,Cinel; Cameron Alexander,8,0,30,22
1657122039623,MATH 18,B01,083748,Rideout; David Porter,4,0,37,33
1657122039623,MATH 18,B02,083749,Rideout; David Porter,3,0,36,33
1657122039623,MATH 18,B03,083750,Rideout; David Porter,2,0,37,35
1657122039623,MATH 18,B04,083751,Rideout; David Porter,5,0,36,31
1657122039623,MATH 18,B05,093473,Rideout; David Porter,4,0,36,32
1657122039623,MATH 18,B06,093474,Rideout; David Porter,5,0,36,31
1657122045655,MATH 20A,A01,083754,Zheng; Zequn,12,0,40,28
1657122051677,MATH 20B,A01,083756,Briones; Jor-el Thomas Caparas,1,0,36,35
1657122051677,MATH 20B,A02,083757,Briones; Jor-el Thomas Caparas,1,0,36,35
1657122051677,MATH 20B,A03,093475,Briones; Jor-el Thomas Caparas,0,0,36,36
1657122057707,MATH 20C,A01,083760,Briones; Jor-el Thomas Caparas,1,0,35,34
1657122057707,MATH 20C,A02,083761,Briones; Jor-el Thomas Caparas,8,0,35,27
1657122057707,MATH 20C,A03,093476,Briones; Jor-el Thomas Caparas,0,1,36,36
1657122057707,MATH 20C,B01,083762,Bach; Quang Tran,0,0,30,30
1657122063736,MATH 20D,A01,083765,Tran; Brian Kha,4,0,30,26
1657122063736,MATH 20D,A02,083766,Tran; Brian Kha,5,0,30,25
1657122063736,MATH 20D,A03,083767,Tran; Brian Kha,3,0,30,27
1657122069764,MATH 20E,A01,083771,Ganguly; Soumya,6,0,32,26
1657122069764,MATH 20E,A02,083772,Ganguly; Soumya,6,0,32,26
1657122069764,MATH 20E,B01,083773,Ciotti; Benjamin,18,0,35,17
1657122069764,MATH 20E,B02,083774,Ciotti; Benjamin,17,0,35,18
1657122075796,MATH 103A,A01,083777,Greenfeld; Be'Eri,2,0,36,34
1657122075796,MATH 103A,A02,083778,Greenfeld; Be'Eri,5,0,36,31
1657122075796,MATH 103A,A03,093561,Greenfeld; Be'Eri,4,0,36,32
1657122075796,MATH 103A,B01,083779,Greenfeld; Be'Eri,6,0,36,30
1657122075796,MATH 103A,B02,083780,Greenfeld; Be'Eri,2,0,36,34
1657122075796,MATH 103A,B03,093562,Greenfeld; Be'Eri,3,0,36,33
1657122081819,MATH 105,A01,085443,Carter; Anne Toulson,14,0,35,21
1657122081819,MATH 105,A02,093477,Carter; Anne Toulson,20,0,35,15
1657122087844,MATH 109,A01,083213,Ganzberger; Geoffrey Michael,2,0,34,32
1657122087844,MATH 109,A02,083214,Ganzberger; Geoffrey Michael,3,0,34,31
1657122087844,MATH 109,A03,093478,Ganzberger; Geoffrey Michael,1,0,34,33
1657122087844,MATH 109,B01,083215,Ganzberger; Geoffrey Michael,1,0,32,31
1657122087844,MATH 109,B02,083216,Ganzberger; Geoffrey Michael,1,0,32,31
1657122087844,MATH 109,B03,093479,Ganzberger; Geoffrey Michael,6,0,32,26
1657122093869,MATH 142A,A01,083219,Chow; Bennett,6,0,32,26
1657122093869,MATH 142A,A02,083220,Chow; Bennett,10,0,32,22
1657122093869,MATH 142A,A03,093480,Chow; Bennett,7,0,32,25
1657122093869,MATH 142A,B03,093481,Chow; Bennett,8,0,32,24
1657122093869,MATH 142A,B04,093558,Chow; Bennett,11,0,32,21
1657122093869,MATH 142A,B05,093559,Chow; Bennett,6,0,32,26
1657122099899,MATH 193A,A01,083224,Rotar; Vladimir,7,0,34,27
1657122099899,MATH 193A,A02,083225,Rotar; Vladimir,5,0,34,29
1657122099899,MATH 193A,A03,083781,Rotar; Vladimir,1,0,34,33
1657122099899,MATH 193A,A04,083782,Rotar; Vladimir,6,0,34,28
1657122099899,MATH 193A,A05,093482,Rotar; Vladimir,6,0,34,28
1657122105922,MATH 197,001,091859,McAuley; Julian John,9999,0,9999,0
1657122105922,MATH 197,002,095566,Kedlaya; Kiran S.,9997,0,9999,2
1657122105922,MATH 197,003,095567,Xiao; Ming,9999,0,9999,0
1657122105922,MATH 197,004,095571,Perols; Johan Lars,9998,0,9999,1
1657122112986,COGS 9,A01,083615,Shannon; Kyle Michael,7,0,75,68
1657122119010,COGS 11,A01,083617,Boyle; Mary E. T.,21,0,48,27
1657122125040,COGS 13,A01,083071,Bastos; Amalia Pinkusfeld,9,0,71,62
1657122131064,COGS 14A,A01,092681,Semenuks; Arturs,1,1,100,99
1657122137091,COGS 14B,A01,083073,Cheng; Tzu-Han,6,0,63,57
1657122143114,COGS 17,A01,092677,Semenuks; Arturs,4,0,81,77
1657122149137,COGS 100,A01,083619,Allen; Michael Gordon,15,0,70,55
1657122155160,COGS 101A,A01,083621,Davis; Joshua Daniel,9,0,68,59
1657122161257,COGS 101B,A01,091572,Allen; Michael Gordon,8,0,65,57
1657122167282,COGS 101C,A01,083625,Delgado; Tania,17,0,35,18
1657122173308,COGS 107A,A01,083627,Boyle; Mary E. T.,13,0,60,47
1657122179332,COGS 118A,A01,083075,Gupta; Anjum,15,0,76,61
1657122185360,CSE 3,A50,083646,Miranda; Gregory Joseph,22,0,50,28
1657122191383,CSE 8A,A50,083650,Miranda; Gregory Joseph,17,1,56,39
1657122197406,CSE 11,A01,083080,Cao; Yingjun,4,15,40,36
1657122203432,CSE 12,A01,083652,Krause-Levy; Sophia Louisa,23,1,120,97
1657122209460,CSE 15L,A01,083654,Morris; Justin Loren,9,0,50,41
1657122209460,CSE 15L,A02,083655,Morris; Justin Loren,9,0,50,41
1657122215487,CSE 20,A01,083657,Tran; Khoa Dang,37,0,80,43
1657122221513,CSE 21,A01,095574,Bach; Quang Tran,21,0,48,27
1657122227535,CSE 30,A01,083084,Eldon; John,4,0,80,76
1657122227535,CSE 30,B01,095061,Bhaskar; Nishant,6,0,50,44
1657122233574,CSE 100,A01,083659,Cao; Yingjun,4,4,70,66
1657122239598,CSE 134B,A01,083661,Powell; Thomas Allan,19,0,100,81
1657122245624,CSE 140,A01,083663,Gungor; Onat,14,0,85,71
1657122251740,CSE 140L,A01,083088,Eldon; John,17,0,100,83
1657122257764,CSE 175,A01,083665,Kumar; Rakesh,3,0,25,22
1657122263796,CSE 190,A00,092507,Dubnov; Shlomo,7,0,20,13
1657122269820,ECE 45,A01,083139,Congero; Spencer William,5,0,75,70
1657122275844,ECE 65,A50,083695,Saad; Andrew S,12,0,30,18
1657122275844,ECE 65,A51,095125,Saad; Andrew S,25,0,26,1
1657122281868,ECE 109,A01,091882,Touri; Behrouz,16,0,70,54
1657122287900,ECE 180,A00,083140,Abi Samra; Nicholas Camill,1,0,30,29
1657122287900,ECE 180,B00,083141,Abi Samra; Nicholas Camill,0,0,30,30
1657122293936,MATH 10A,A01,083735,Patchell; Gregory David,1,0,30,29
1657122293936,MATH 10A,A02,083736,Patchell; Gregory David,20,0,30,10
1657122293936,MATH 10A,A03,083737,Patchell; Gregory David,16,0,30,14
1657122299966,MATH 10B,A01,083207,Lim; Seonhee,7,0,34,27
1657122299966,MATH 10B,A02,083208,Lim; Seonhee,9,0,35,26
1657122299966,MATH 10B,A03,093472,Lim; Seonhee,5,0,34,29
1657122299966,MATH 10B,B01,083739,Sinha; Shubham,9,0,30,21
1657122305989,MATH 18,A01,083743,Cinel; Cameron Alexander,6,0,30,24
1657122305989,MATH 18,A02,083744,Cinel; Cameron Alexander,15,0,30,15
1657122305989,MATH 18,A03,083745,Cinel; Cameron Alexander,8,0,30,22
1657122305989,MATH 18,B01,083748,Rideout; David Porter,4,0,37,33
1657122305989,MATH 18,B02,083749,Rideout; David Porter,3,0,36,33
1657122305989,MATH 18,B03,083750,Rideout; David Porter,2,0,37,35
1657122305989,MATH 18,B04,083751,Rideout; David Porter,5,0,36,31
1657122305989,MATH 18,B05,093473,Rideout; David Porter,4,0,36,32
1657122305989,MATH 18,B06,093474,Rideout; David Porter,5,0,36,31
1657122312011,MATH 20A,A01,083754,Zheng; Zequn,12,0,40,28
1657122318038,MATH 20B,A01,083756,Briones; Jor-el Thomas Caparas,1,0,36,35
1657122318038,MATH 20B,A02,083757,Briones; Jor-el Thomas Caparas,1,0,36,35
1657122318038,MATH 20B,A03,093475,Briones; Jor-el Thomas Caparas,0,0,36,36
1657122324064,MATH 20C,A01,083760,Briones; Jor-el Thomas Caparas,1,0,35,34
1657122324064,MATH 20C,A02,083761,Briones; Jor-el Thomas Caparas,8,0,35,27
1657122324064,MATH 20C,A03,093476,Briones; Jor-el Thomas Caparas,0,1,36,36
1657122324064,MATH 20C,B01,083762,Bach; Quang Tran,0,0,30,30
1657122330096,MATH 20D,A01,083765,Tran; Brian Kha,4,0,30,26
1657122330096,MATH 20D,A02,083766,Tran; Brian Kha,5,0,30,25
1657122330096,MATH 20D,A03,083767,Tran; Brian Kha,3,0,30,27
1657122336123,MATH 20E,A01,083771,Ganguly; Soumya,6,0,32,26
1657122336123,MATH 20E,A02,083772,Ganguly; Soumya,6,0,32,26
1657122336123,MATH 20E,B01,083773,Ciotti; Benjamin,18,0,35,17
1657122336123,MATH 20E,B02,083774,Ciotti; Benjamin,17,0,35,18
1657122342156,MATH 103A,A01,083777,Greenfeld; Be'Eri,2,0,36,34
1657122342156,MATH 103A,A02,083778,Greenfeld; Be'Eri,5,0,36,31
1657122342156,MATH 103A,A03,093561,Greenfeld; Be'Eri,4,0,36,32
1657122342156,MATH 103A,B01,083779,Greenfeld; Be'Eri,6,0,36,30
1657122342156,MATH 103A,B02,083780,Greenfeld; Be'Eri,2,0,36,34
1657122342156,MATH 103A,B03,093562,Greenfeld; Be'Eri,3,0,36,33
1657122348179,MATH 105,A01,085443,Carter; Anne Toulson,14,0,35,21
1657122348179,MATH 105,A02,093477,Carter; Anne Toulson,20,0,35,15
1657122354204,MATH 109,A01,083213,Ganzberger; Geoffrey Michael,2,0,34,32
1657122354204,MATH 109,A02,083214,Ganzberger; Geoffrey Michael,3,0,34,31
1657122354204,MATH 109,A03,093478,Ganzberger; Geoffrey Michael,1,0,34,33
1657122354204,MATH 109,B01,083215,Ganzberger; Geoffrey Michael,1,0,32,31
1657122354204,MATH 109,B02,083216,Ganzberger; Geoffrey Michael,1,0,32,31
1657122354204,MATH 109,B03,093479,Ganzberger; Geoffrey Michael,6,0,32,26
1657122360230,MATH 142A,A01,083219,Chow; Bennett,6,0,32,26
1657122360230,MATH 142A,A02,083220,Chow; Bennett,10,0,32,22
1657122360230,MATH 142A,A03,093480,Chow; Bennett,7,0,32,25
1657122360230,MATH 142A,B03,093481,Chow; Bennett,8,0,32,24
1657122360230,MATH 142A,B04,093558,Chow; Bennett,11,0,32,21
1657122360230,MATH 142A,B05,093559,Chow; Bennett,6,0,32,26
1657122366253,MATH 193A,A01,083224,Rotar; Vladimir,7,0,34,27
1657122366253,MATH 193A,A02,083225,Rotar; Vladimir,5,0,34,29
1657122366253,MATH 193A,A03,083781,Rotar; Vladimir,1,0,34,33
1657122366253,MATH 193A,A04,083782,Rotar; Vladimir,6,0,34,28
1657122366253,MATH 193A,A05,093482,Rotar; Vladimir,6,0,34,28
1657122372277,MATH 197,001,091859,McAuley; Julian John,9999,0,9999,0
1657122372277,MATH 197,002,095566,Kedlaya; Kiran S.,9997,0,9999,2
1657122372277,MATH 197,003,095567,Xiao; Ming,9999,0,9999,0
1657122372277,MATH 197,004,095571,Perols; Johan Lars,9998,0,9999,1
1657122379330,COGS 9,A01,083615,Shannon; Kyle Michael,7,0,75,68
1657122385359,COGS 11,A01,083617,Boyle; Mary E. T.,21,0,48,27
1657122391387,COGS 13,A01,083071,Bastos; Amalia Pinkusfeld,9,0,71,62
1657122397414,COGS 14A,A01,092681,Semenuks; Arturs,1,1,100,99
1657122403438,COGS 14B,A01,083073,Cheng; Tzu-Han,6,0,63,57
1657122409470,COGS 17,A01,092677,Semenuks; Arturs,4,0,81,77
1657122415497,COGS 100,A01,083619,Allen; Michael Gordon,15,0,70,55
1657122421521,COGS 101A,A01,083621,Davis; Joshua Daniel,9,0,68,59
1657122427551,COGS 101B,A01,091572,Allen; Michael Gordon,8,0,65,57
1657122433573,COGS 101C,A01,083625,Delgado; Tania,17,0,35,18
1657122439600,COGS 107A,A01,083627,Boyle; Mary E. T.,13,0,60,47
1657122445622,COGS 118A,A01,083075,Gupta; Anjum,15,0,76,61
1657122451648,CSE 3,A50,083646,Miranda; Gregory Joseph,22,0,50,28
1657122457676,CSE 8A,A50,083650,Miranda; Gregory Joseph,17,1,56,39
1657122463699,CSE 11,A01,083080,Cao; Yingjun,4,15,40,36
1657122469727,CSE 12,A01,083652,Krause-Levy; Sophia Louisa,23,1,120,97
1657122475755,CSE 15L,A01,083654,Morris; Justin Loren,9,0,50,41
1657122475755,CSE 15L,A02,083655,Morris; Justin Loren,9,0,50,41
1657122481777,CSE 20,A01,083657,Tran; Khoa Dang,37,0,80,43
1657122487800,CSE 21,A01,095574,Bach; Quang Tran,21,0,48,27
1657122493823,CSE 30,A01,083084,Eldon; John,4,0,80,76
1657122493823,CSE 30,B01,095061,Bhaskar; Nishant,6,0,50,44
1657122499847,CSE 100,A01,083659,Cao; Yingjun,4,4,70,66
1657122505871,CSE 134B,A01,083661,Powell; Thomas Allan,19,0,100,81
1657122511898,CSE 140,A01,083663,Gungor; Onat,14,0,85,71
1657122517920,CSE 140L,A01,083088,Eldon; John,17,0,100,83
1657122523947,CSE 175,A01,083665,Kumar; Rakesh,3,0,25,22
1657122529970,CSE 190,A00,092507,Dubnov; Shlomo,7,0,20,13
1657122535997,ECE 45,A01,083139,Congero; Spencer William,5,0,75,70
1657122542020,ECE 65,A50,083695,Saad; Andrew S,12,0,30,18
1657122542020,ECE 65,A51,095125,Saad; Andrew S,25,0,26,1
1657122548046,ECE 109,A01,091882,Touri; Behrouz,16,0,70,54
1657122554077,ECE 180,A00,083140,Abi Samra; Nicholas Camill,1,0,30,29
1657122554077,ECE 180,B00,083141,Abi Samra; Nicholas Camill,0,0,30,30
1657122560108,MATH 10A,A01,083735,Patchell; Gregory David,1,0,30,29
1657122560108,MATH 10A,A02,083736,Patchell; Gregory David,20,0,30,10
1657122560108,MATH 10A,A03,083737,Patchell; Gregory David,16,0,30,14
1657122566131,MATH 10B,A01,083207,Lim; Seonhee,7,0,34,27
1657122566131,MATH 10B,A02,083208,Lim; Seonhee,9,0,35,26
1657122566131,MATH 10B,A03,093472,Lim; Seonhee,5,0,34,29
1657122566131,MATH 10B,B01,083739,Sinha; Shubham,9,0,30,21
1657122572159,MATH 18,A01,083743,Cinel; Cameron Alexander,6,0,30,24
1657122572159,MATH 18,A02,083744,Cinel; Cameron Alexander,15,0,30,15
1657122572159,MATH 18,A03,083745,Cinel; Cameron Alexander,8,0,30,22
1657122572159,MATH 18,B01,083748,Rideout; David Porter,4,0,37,33
1657122572159,MATH 18,B02,083749,Rideout; David Porter,3,0,36,33
1657122572159,MATH 18,B03,083750,Rideout; David Porter,2,0,37,35
1657122572159,MATH 18,B04,083751,Rideout; David Porter,5,0,36,31
1657122572159,MATH 18,B05,093473,Rideout; David Porter,4,0,36,32
1657122572159,MATH 18,B06,093474,Rideout; David Porter,5,0,36,31
1657122578183,MATH 20A,A01,083754,Zheng; Zequn,12,0,40,28
1657122584212,MATH 20B,A01,083756,Briones; Jor-el Thomas Caparas,1,0,36,35
1657122584212,MATH 20B,A02,083757,Briones; Jor-el Thomas Caparas,1,0,36,35
1657122584212,MATH 20B,A03,093475,Briones; Jor-el Thomas Caparas,0,0,36,36
1657122590237,MATH 20C,A01,083760,Briones; Jor-el Thomas Caparas,1,0,35,34
1657122590237,MATH 20C,A02,083761,Briones; Jor-el Thomas Caparas,8,0,35,27
1657122590237,MATH 20C,A03,093476,Briones; Jor-el Thomas Caparas,0,1,36,36
1657122590237,MATH 20C,B01,083762,Bach; Quang Tran,0,0,30,30
1657122596267,MATH 20D,A01,083765,Tran; Brian Kha,4,0,30,26
1657122596267,MATH 20D,A02,083766,Tran; Brian Kha,5,0,30,25
1657122596267,MATH 20D,A03,083767,Tran; Brian Kha,3,0,30,27
1657122602295,MATH 20E,A01,083771,Ganguly; Soumya,6,0,32,26
1657122602295,MATH 20E,A02,083772,Ganguly; Soumya,6,0,32,26
1657122602295,MATH 20E,B01,083773,Ciotti; Benjamin,18,0,35,17
1657122602295,MATH 20E,B02,083774,Ciotti; Benjamin,17,0,35,18
1657122608323,MATH 103A,A01,083777,Greenfeld; Be'Eri,2,0,36,34
1657122608323,MATH 103A,A02,083778,Greenfeld; Be'Eri,5,0,36,31
1657122608323,MATH 103A,A03,093561,Greenfeld; Be'Eri,4,0,36,32
1657122608323,MATH 103A,B01,083779,Greenfeld; Be'Eri,6,0,36,30
1657122608323,MATH 103A,B02,083780,Greenfeld; Be'Eri,2,0,36,34
1657122608323,MATH 103A,B03,093562,Greenfeld; Be'Eri,3,0,36,33
1657122614353,MATH 105,A01,085443,Carter; Anne Toulson,14,0,35,21
1657122614353,MATH 105,A02,093477,Carter; Anne Toulson,20,0,35,15
1657122620377,MATH 109,A01,083213,Ganzberger; Geoffrey Michael,2,0,34,32
1657122620377,MATH 109,A02,083214,Ganzberger; Geoffrey Michael,3,0,34,31
1657122620377,MATH 109,A03,093478,Ganzberger; Geoffrey Michael,1,0,34,33
1657122620377,MATH 109,B01,083215,Ganzberger; Geoffrey Michael,1,0,32,31
1657122620377,MATH 109,B02,083216,Ganzberger; Geoffrey Michael,1,0,32,31
1657122620377,MATH 109,B03,093479,Ganzberger; Geoffrey Michael,6,0,32,26
1657122626400,MATH 142A,A01,083219,Chow; Bennett,6,0,32,26
1657122626400,MATH 142A,A02,083220,Chow; Bennett,10,0,32,22
1657122626400,MATH 142A,A03,093480,Chow; Bennett,7,0,32,25
1657122626400,MATH 142A,B03,093481,Chow; Bennett,8,0,32,24
1657122626400,MATH 142A,B04,093558,Chow; Bennett,11,0,32,21
1657122626400,MATH 142A,B05,093559,Chow; Bennett,6,0,32,26
1657122632422,MATH 193A,A01,083224,Rotar; Vladimir,7,0,34,27
1657122632422,MATH 193A,A02,083225,Rotar; Vladimir,5,0,34,29
1657122632422,MATH 193A,A03,083781,Rotar; Vladimir,1,0,34,33
1657122632422,MATH 193A,A04,083782,Rotar; Vladimir,6,0,34,28
1657122632422,MATH 193A,A05,093482,Rotar; Vladimir,6,0,34,28
1657122638450,MATH 197,001,091859,McAuley; Julian John,9999,0,9999,0
1657122638450,MATH 197,002,095566,Kedlaya; Kiran S.,9997,0,9999,2
1657122638450,MATH 197,003,095567,Xiao; Ming,9999,0,9999,0
1657122638450,MATH 197,004,095571,Perols; Johan Lars,9998,0,9999,1
1657122645505,COGS 9,A01,083615,Shannon; Kyle Michael,7,0,75,68
1657122651539,COGS 11,A01,083617,Boyle; Mary E. T.,21,0,48,27
1657122657572,COGS 13,A01,083071,Bastos; Amalia Pinkusfeld,9,0,71,62
1657122663596,COGS 14A,A01,092681,Semenuks; Arturs,1,1,100,99
1657122669618,COGS 14B,A01,083073,Cheng; Tzu-Han,6,0,63,57
1657122675645,COGS 17,A01,092677,Semenuks; Arturs,4,0,81,77
1657122681669,COGS 100,A01,083619,Allen; Michael Gordon,15,0,70,55
1657122687701,COGS 101A,A01,083621,Davis; Joshua Daniel,9,0,68,59
1657122693728,COGS 101B,A01,091572,Allen; Michael Gordon,8,0,65,57
1657122699755,COGS 101C,A01,083625,Delgado; Tania,17,0,35,18
1657122705786,COGS 107A,A01,083627,Boyle; Mary E. T.,13,0,60,47
1657122711812,COGS 118A,A01,083075,Gupta; Anjum,15,0,76,61
1657122717835,CSE 3,A50,083646,Miranda; Gregory Joseph,22,0,50,28
1657122723873,CSE 8A,A50,083650,Miranda; Gregory Joseph,17,1,56,39
1657122729897,CSE 11,A01,083080,Cao; Yingjun,4,15,40,36
1657122735921,CSE 12,A01,083652,Krause-Levy; Sophia Louisa,23,1,120,97
1657122741946,CSE 15L,A01,083654,Morris; Justin Loren,9,0,50,41
1657122741946,CSE 15L,A02,083655,Morris; Justin Loren,9,0,50,41
1657122747975,CSE 20,A01,083657,Tran; Khoa Dang,37,0,80,43
1657122753997,CSE 21,A01,095574,Bach; Quang Tran,21,0,48,27
1657122760020,CSE 30,A01,083084,Eldon; John,4,0,80,76
1657122760020,CSE 30,B01,095061,Bhaskar; Nishant,6,0,50,44
1657122766047,CSE 100,A01,083659,Cao; Yingjun,4,4,70,66
1657122772070,CSE 134B,A01,083661,Powell; Thomas Allan,19,0,100,81
1657122778097,CSE 140,A01,083663,Gungor; Onat,14,0,85,71
1657122784123,CSE 140L,A01,083088,Eldon; John,17,0,100,83
1657122790148,CSE 175,A01,083665,Kumar; Rakesh,3,0,25,22
1657122796171,CSE 190,A00,092507,Dubnov; Shlomo,7,0,20,13
1657122802195,ECE 45,A01,083139,Congero; Spencer William,5,0,75,70
1657122808225,ECE 65,A50,083695,Saad; Andrew S,12,0,30,18
1657122808225,ECE 65,A51,095125,Saad; Andrew S,25,0,26,1
1657122814252,ECE 109,A01,091882,Touri; Behrouz,16,0,70,54
1657122820276,ECE 180,A00,083140,Abi Samra; Nicholas Camill,1,0,30,29
1657122820276,ECE 180,B00,083141,Abi Samra; Nicholas Camill,0,0,30,30
1657122826310,MATH 10A,A01,083735,Patchell; Gregory David,1,0,30,29
1657122826310,MATH 10A,A02,083736,Patchell; Gregory David,20,0,30,10
1657122826310,MATH 10A,A03,083737,Patchell; Gregory David,16,0,30,14
1657122832332,MATH 10B,A01,083207,Lim; Seonhee,7,0,34,27
1657122832332,MATH 10B,A02,083208,Lim; Seonhee,9,0,35,26
1657122832332,MATH 10B,A03,093472,Lim; Seonhee,5,0,34,29
1657122832332,MATH 10B,B01,083739,Sinha; Shubham,9,0,30,21
1657122838355,MATH 18,A01,083743,Cinel; Cameron Alexander,6,0,30,24
1657122838355,MATH 18,A02,083744,Cinel; Cameron Alexander,15,0,30,15
1657122838355,MATH 18,A03,083745,Cinel; Cameron Alexander,8,0,30,22
1657122838355,MATH 18,B01,083748,Rideout; David Porter,4,0,37,33
1657122838355,MATH 18,B02,083749,Rideout; David Porter,3,0,36,33
1657122838355,MATH 18,B03,083750,Rideout; David Porter,2,0,37,35
1657122838355,MATH 18,B04,083751,Rideout; David Porter,5,0,36,31
1657122838355,MATH 18,B05,093473,Rideout; David Porter,4,0,36,32
1657122838355,MATH 18,B06,093474,Rideout; David Porter,5,0,36,31
1657122844379,MATH 20A,A01,083754,Zheng; Zequn,12,0,40,28
1657122850484,MATH 20B,A01,083756,Briones; Jor-el Thomas Caparas,1,0,36,35
1657122850484,MATH 20B,A02,083757,Briones; Jor-el Thomas Caparas,1,0,36,35
1657122850484,MATH 20B,A03,093475,Briones; Jor-el Thomas Caparas,0,0,36,36
1657122856508,MATH 20C,A01,083760,Briones; Jor-el Thomas Caparas,1,0,35,34
1657122856508,MATH 20C,A02,083761,Briones; Jor-el Thomas Caparas,8,0,35,27
1657122856508,MATH 20C,A03,093476,Briones; Jor-el Thomas Caparas,0,1,36,36
1657122856508,MATH 20C,B01,083762,Bach; Quang Tran,0,0,30,30
1657122862540,MATH 20D,A01,083765,Tran; Brian Kha,4,0,30,26
1657122862540,MATH 20D,A02,083766,Tran; Brian Kha,5,0,30,25
1657122862540,MATH 20D,A03,083767,Tran; Brian Kha,3,0,30,27
1657122868568,MATH 20E,A01,083771,Ganguly; Soumya,6,0,32,26
1657122868568,MATH 20E,A02,083772,Ganguly; Soumya,6,0,32,26
1657122868568,MATH 20E,B01,083773,Ciotti; Benjamin,18,0,35,17
1657122868568,MATH 20E,B02,083774,Ciotti; Benjamin,17,0,35,18
1657122874592,MATH 103A,A01,083777,Greenfeld; Be'Eri,2,0,36,34
1657122874592,MATH 103A,A02,083778,Greenfeld; Be'Eri,5,0,36,31
1657122874592,MATH 103A,A03,093561,Greenfeld; Be'Eri,4,0,36,32
1657122874592,MATH 103A,B01,083779,Greenfeld; Be'Eri,6,0,36,30
1657122874592,MATH 103A,B02,083780,Greenfeld; Be'Eri,2,0,36,34
1657122874592,MATH 103A,B03,093562,Greenfeld; Be'Eri,3,0,36,33
1657122880621,MATH 105,A01,085443,Carter; Anne Toulson,14,0,35,21
1657122880621,MATH 105,A02,093477,Carter; Anne Toulson,20,0,35,15
1657122886664,MATH 109,A01,083213,Ganzberger; Geoffrey Michael,2,0,34,32
1657122886664,MATH 109,A02,083214,Ganzberger; Geoffrey Michael,3,0,34,31
1657122886664,MATH 109,A03,093478,Ganzberger; Geoffrey Michael,1,0,34,33
1657122886664,MATH 109,B01,083215,Ganzberger; Geoffrey Michael,1,0,32,31
1657122886664,MATH 109,B02,083216,Ganzberger; Geoffrey Michael,1,0,32,31
1657122886664,MATH 109,B03,093479,Ganzberger; Geoffrey Michael,6,0,32,26
1657122892691,MATH 142A,A01,083219,Chow; Bennett,6,0,32,26
1657122892691,MATH 142A,A02,083220,Chow; Bennett,10,0,32,22
1657122892691,MATH 142A,A03,093480,Chow; Bennett,7,0,32,25
1657122892691,MATH 142A,B03,093481,Chow; Bennett,8,0,32,24
1657122892691,MATH 142A,B04,093558,Chow; Bennett,11,0,32,21
1657122892691,MATH 142A,B05,093559,Chow; Bennett,6,0,32,26
1657122898719,MATH 193A,A01,083224,Rotar; Vladimir,7,0,34,27
1657122898719,MATH 193A,A02,083225,Rotar; Vladimir,5,0,34,29
1657122898719,MATH 193A,A03,083781,Rotar; Vladimir,1,0,34,33
1657122898719,MATH 193A,A04,083782,Rotar; Vladimir,6,0,34,28
1657122898719,MATH 193A,A05,093482,Rotar; Vladimir,6,0,34,28
1657122904743,MATH 197,001,091859,McAuley; Julian John,9999,0,9999,0
1657122904743,MATH 197,002,095566,Kedlaya; Kiran S.,9997,0,9999,2
1657122904743,MATH 197,003,095567,Xiao; Ming,9999,0,9999,0
1657122904743,MATH 197,004,095571,Perols; Johan Lars,9998,0,9999,1
1657122911807,COGS 9,A01,083615,Shannon; Kyle Michael,7,0,75,68
1657122917831,COGS 11,A01,083617,Boyle; Mary E. T.,21,0,48,27
1657122923860,COGS 13,A01,083071,Bastos; Amalia Pinkusfeld,9,0,71,62
1657122929885,COGS 14A,A01,092681,Semenuks; Arturs,1,1,100,99
1657122935909,COGS 14B,A01,083073,Cheng; Tzu-Han,6,0,63,57
1657122941933,COGS 17,A01,092677,Semenuks; Arturs,4,0,81,77
1657122947961,COGS 100,A01,083619,Allen; Michael Gordon,15,0,70,55
1657122953996,COGS 101A,A01,083621,Davis; Joshua Daniel,9,0,68,59
1657122960034,COGS 101B,A01,091572,Allen; Michael Gordon,8,0,65,57
1657122966055,COGS 101C,A01,083625,Delgado; Tania,17,0,35,18
1657122972083,COGS 107A,A01,083627,Boyle; Mary E. T.,13,0,60,47
1657122978104,COGS 118A,A01,083075,Gupta; Anjum,15,0,76,61
1657122984131,CSE 3,A50,083646,Miranda; Gregory Joseph,22,0,50,28
1657122990163,CSE 8A,A50,083650,Miranda; Gregory Joseph,17,1,56,39
1657122996190,CSE 11,A01,083080,Cao; Yingjun,4,15,40,36
1657123002222,CSE 12,A01,083652,Krause-Levy; Sophia Louisa,23,1,120,97
1657123008253,CSE 15L,A01,083654,Morris; Justin Loren,9,0,50,41
1657123008253,CSE 15L,A02,083655,Morris; Justin Loren,9,0,50,41
1657123014276,CSE 20,A01,083657,Tran; Khoa Dang,37,0,80,43
1657123020300,CSE 21,A01,095574,Bach; Quang Tran,21,0,48,27
1657123026323,CSE 30,A01,083084,Eldon; John,4,0,80,76
1657123026323,CSE 30,B01,095061,Bhaskar; Nishant,6,0,50,44
1657123032353,CSE 100,A01,083659,Cao; Yingjun,4,4,70,66
1657123038380,CSE 134B,A01,083661,Powell; Thomas Allan,19,0,100,81
1657123044407,CSE 140,A01,083663,Gungor; Onat,14,0,85,71
1657123050431,CSE 140L,A01,083088,Eldon; John,17,0,100,83
1657123056457,CSE 175,A01,083665,Kumar; Rakesh,3,0,25,22
1657123062484,CSE 190,A00,092507,Dubnov; Shlomo,7,0,20,13
1657123068507,ECE 45,A01,083139,Congero; Spencer William,5,0,75,70
1657123074542,ECE 65,A50,083695,Saad; Andrew S,12,0,30,18
1657123074542,ECE 65,A51,095125,Saad; Andrew S,25,0,26,1
1657123080565,ECE 109,A01,091882,Touri; Behrouz,16,0,70,54
1657123086591,ECE 180,A00,083140,Abi Samra; Nicholas Camill,1,0,30,29
1657123086591,ECE 180,B00,083141,Abi Samra; Nicholas Camill,0,0,30,30
1657123092628,MATH 10A,A01,083735,Patchell; Gregory David,1,0,30,29
1657123092628,MATH 10A,A02,083736,Patchell; Gregory David,20,0,30,10
1657123092628,MATH 10A,A03,083737,Patchell; Gregory David,16,0,30,14
1657123098658,MATH 10B,A01,083207,Lim; Seonhee,7,0,34,27
1657123098658,MATH 10B,A02,083208,Lim; Seonhee,9,0,35,26
1657123098658,MATH 10B,A03,093472,Lim; Seonhee,5,0,34,29
1657123098658,MATH 10B,B01,083739,Sinha; Shubham,9,0,30,21
1657123104694,MATH 18,A01,083743,Cinel; Cameron Alexander,6,0,30,24
1657123104694,MATH 18,A02,083744,Cinel; Cameron Alexander,15,0,30,15
1657123104694,MATH 18,A03,083745,Cinel; Cameron Alexander,8,0,30,22
1657123104694,MATH 18,B01,083748,Rideout; David Porter,4,0,37,33
1657123104694,MATH 18,B02,083749,Rideout; David Porter,3,0,36,33
1657123104694,MATH 18,B03,083750,Rideout; David Porter,2,0,37,35
1657123104694,MATH 18,B04,083751,Rideout; David Porter,5,0,36,31
1657123104694,MATH 18,B05,093473,Rideout; David Porter,4,0,36,32
1657123104694,MATH 18,B06,093474,Rideout; David Porter,5,0,36,31
1657123110721,MATH 20A,A01,083754,Zheng; Zequn,12,0,40,28
1657123116745,MATH 20B,A01,083756,Briones; Jor-el Thomas Caparas,1,0,36,35
1657123116745,MATH 20B,A02,083757,Briones; Jor-el Thomas Caparas,1,0,36,35
1657123116745,MATH 20B,A03,093475,Briones; Jor-el Thomas Caparas,0,0,36,36
1657123122773,MATH 20C,A01,083760,Briones; Jor-el Thomas Caparas,1,0,35,34
1657123122773,MATH 20C,A02,083761,Briones; Jor-el Thomas Caparas,8,0,35,27
1657123122773,MATH 20C,A03,093476,Briones; Jor-el Thomas Caparas,0,1,36,36
1657123122773,MATH 20C,B01,083762,Bach; Quang Tran,0,0,30,30
1657123128802,MATH 20D,A01,083765,Tran; Brian Kha,4,0,30,26
1657123128802,MATH 20D,A02,083766,Tran; Brian Kha,5,0,30,25
1657123128802,MATH 20D,A03,083767,Tran; Brian Kha,3,0,30,27
1657123134831,MATH 20E,A01,083771,Ganguly; Soumya,6,0,32,26
1657123134831,MATH 20E,A02,083772,Ganguly; Soumya,6,0,32,26
1657123134831,MATH 20E,B01,083773,Ciotti; Benjamin,18,0,35,17
1657123134831,MATH 20E,B02,083774,Ciotti; Benjamin,17,0,35,18
1657123140862,MATH 103A,A01,083777,Greenfeld; Be'Eri,2,0,36,34
1657123140862,MATH 103A,A02,083778,Greenfeld; Be'Eri,5,0,36,31
1657123140862,MATH 103A,A03,093561,Greenfeld; Be'Eri,4,0,36,32
1657123140862,MATH 103A,B01,083779,Greenfeld; Be'Eri,6,0,36,30
1657123140862,MATH 103A,B02,083780,Greenfeld; Be'Eri,2,0,36,34
1657123140862,MATH 103A,B03,093562,Greenfeld; Be'Eri,3,0,36,33
1657123146893,MATH 105,A01,085443,Carter; Anne Toulson,14,0,35,21
1657123146893,MATH 105,A02,093477,Carter; Anne Toulson,20,0,35,15
1657123152920,MATH 109,A01,083213,Ganzberger; Geoffrey Michael,2,0,34,32
1657123152920,MATH 109,A02,083214,Ganzberger; Geoffrey Michael,3,0,34,31
1657123152920,MATH 109,A03,093478,Ganzberger; Geoffrey Michael,1,0,34,33
1657123152920,MATH 109,B01,083215,Ganzberger; Geoffrey Michael,1,0,32,31
1657123152920,MATH 109,B02,083216,Ganzberger; Geoffrey Michael,1,0,32,31
1657123152920,MATH 109,B03,093479,Ganzberger; Geoffrey Michael,6,0,32,26
1657123158944,MATH 142A,A01,083219,Chow; Bennett,6,0,32,26
1657123158944,MATH 142A,A02,083220,Chow; Bennett,10,0,32,22
1657123158944,MATH 142A,A03,093480,Chow; Bennett,7,0,32,25
1657123158944,MATH 142A,B03,093481,Chow; Bennett,8,0,32,24
1657123158944,MATH 142A,B04,093558,Chow; Bennett,11,0,32,21
1657123158944,MATH 142A,B05,093559,Chow; Bennett,6,0,32,26
1657123164968,MATH 193A,A01,083224,Rotar; Vladimir,7,0,34,27
1657123164968,MATH 193A,A02,083225,Rotar; Vladimir,5,0,34,29
1657123164968,MATH 193A,A03,083781,Rotar; Vladimir,1,0,34,33
1657123164968,MATH 193A,A04,083782,Rotar; Vladimir,6,0,34,28
1657123164968,MATH 193A,A05,093482,Rotar; Vladimir,6,0,34,28
1657123170995,MATH 197,001,091859,McAuley; Julian John,9999,0,9999,0
1657123170995,MATH 197,002,095566,Kedlaya; Kiran S.,9997,0,9999,2
1657123170995,MATH 197,003,095567,Xiao; Ming,9999,0,9999,0
1657123170995,MATH 197,004,095571,Perols; Johan Lars,9998,0,9999,1
1657123178047,COGS 9,A01,083615,Shannon; Kyle Michael,7,0,75,68
1657123184069,COGS 11,A01,083617,Boyle; Mary E. T.,21,0,48,27
1657123190093,COGS 13,A01,083071,Bastos; Amalia Pinkusfeld,9,0,71,62
1657123196114,COGS 14A,A01,092681,Semenuks; Arturs,1,1,100,99
1657123202139,COGS 14B,A01,083073,Cheng; Tzu-Han,6,0,63,57
1657123208168,COGS 17,A01,092677,Semenuks; Arturs,4,0,81,77
1657123214195,COGS 100,A01,083619,Allen; Michael Gordon,15,0,70,55
1657123220218,COGS 101A,A01,083621,Davis; Joshua Daniel,9,0,68,59
1657123226239,COGS 101B,A01,091572,Allen; Michael Gordon,8,0,65,57
1657123232274,COGS 101C,A01,083625,Delgado; Tania,17,0,35,18
1657123238296,COGS 107A,A01,083627,Boyle; Mary E. T.,13,0,60,47
1657123244319,COGS 118A,A01,083075,Gupta; Anjum,15,0,76,61
1657123250343,CSE 3,A50,083646,Miranda; Gregory Joseph,22,0,50,28
1657123256370,CSE 8A,A50,083650,Miranda; Gregory Joseph,17,1,56,39
1657123262431,CSE 11,A01,083080,Cao; Yingjun,4,15,40,36
1657123268454,CSE 12,A01,083652,Krause-Levy; Sophia Louisa,23,1,120,97
1657123274489,CSE 15L,A01,083654,Morris; Justin Loren,9,0,50,41
1657123274489,CSE 15L,A02,083655,Morris; Justin Loren,9,0,50,41
1657123280511,CSE 20,A01,083657,Tran; Khoa Dang,37,0,80,43
1657123286539,CSE 21,A01,095574,Bach; Quang Tran,21,0,48,27
1657123292571,CSE 30,A01,083084,Eldon; John,4,0,80,76
1657123292571,CSE 30,B01,095061,Bhaskar; Nishant,6,0,50,44
1657123298604,CSE 100,A01,083659,Cao; Yingjun,4,4,70,66
1657123304627,CSE 134B,A01,083661,Powell; Thomas Allan,19,0,100,81
1657123310651,CSE 140,A01,083663,Gungor; Onat,14,0,85,71
1657123316675,CSE 140L,A01,083088,Eldon; John,17,0,100,83
1657123322699,CSE 175,A01,083665,Kumar; Rakesh,3,0,25,22
1657123328722,CSE 190,A00,092507,Dubnov; Shlomo,7,0,20,13
1657123334763,ECE 45,A01,083139,Congero; Spencer William,5,0,75,70
1657123340787,ECE 65,A50,083695,Saad; Andrew S,12,0,30,18
1657123340787,ECE 65,A51,095125,Saad; Andrew S,25,0,26,1
1657123346811,ECE 109,A01,091882,Touri; Behrouz,16,0,70,54
1657123352837,ECE 180,A00,083140,Abi Samra; Nicholas Camill,1,0,30,29
1657123352837,ECE 180,B00,083141,Abi Samra; Nicholas Camill,0,0,30,30
1657123358861,MATH 10A,A01,083735,Patchell; Gregory David,1,0,30,29
1657123358861,MATH 10A,A02,083736,Patchell; Gregory David,20,0,30,10
1657123358861,MATH 10A,A03,083737,Patchell; Gregory David,16,0,30,14
1657123364886,MATH 10B,A01,083207,Lim; Seonhee,7,0,34,27
1657123364886,MATH 10B,A02,083208,Lim; Seonhee,9,0,35,26
1657123364886,MATH 10B,A03,093472,Lim; Seonhee,5,0,34,29
1657123364886,MATH 10B,B01,083739,Sinha; Shubham,9,0,30,21
1657123370918,MATH 18,A01,083743,Cinel; Cameron Alexander,6,0,30,24
1657123370918,MATH 18,A02,083744,Cinel; Cameron Alexander,15,0,30,15
1657123370918,MATH 18,A03,083745,Cinel; Cameron Alexander,8,0,30,22
1657123370918,MATH 18,B01,083748,Rideout; David Porter,4,0,37,33
1657123370918,MATH 18,B02,083749,Rideout; David Porter,3,0,36,33
1657123370918,MATH 18,B03,083750,Rideout; David Porter,2,0,37,35
1657123370918,MATH 18,B04,083751,Rideout; David Porter,5,0,36,31
1657123370918,MATH 18,B05,093473,Rideout; David Porter,4,0,36,32
1657123370918,MATH 18,B06,093474,Rideout; David Porter,5,0,36,31
1657123376944,MATH 20A,A01,083754,Zheng; Zequn,12,0,40,28
1657123382971,MATH 20B,A01,083756,Briones; Jor-el Thomas Caparas,1,0,36,35
1657123382971,MATH 20B,A02,083757,Briones; Jor-el Thomas Caparas,1,0,36,35
1657123382971,MATH 20B,A03,093475,Briones; Jor-el Thomas Caparas,0,0,36,36
1657123388996,MATH 20C,A01,083760,Briones; Jor-el Thomas Caparas,1,0,35,34
1657123388996,MATH 20C,A02,083761,Briones; Jor-el Thomas Caparas,8,0,35,27
1657123388996,MATH 20C,A03,093476,Briones; Jor-el Thomas Caparas,0,1,36,36
1657123388996,MATH 20C,B01,083762,Bach; Quang Tran,0,0,30,30
1657123395023,MATH 20D,A01,083765,Tran; Brian Kha,4,0,30,26
1657123395023,MATH 20D,A02,083766,Tran; Brian Kha,5,0,30,25
1657123395023,MATH 20D,A03,083767,Tran; Brian Kha,3,0,30,27
1657123401046,MATH 20E,A01,083771,Ganguly; Soumya,6,0,32,26
1657123401046,MATH 20E,A02,083772,Ganguly; Soumya,6,0,32,26
1657123401046,MATH 20E,B01,083773,Ciotti; Benjamin,18,0,35,17
1657123401046,MATH 20E,B02,083774,Ciotti; Benjamin,17,0,35,18
1657123407076,MATH 103A,A01,083777,Greenfeld; Be'Eri,2,0,36,34
1657123407076,MATH 103A,A02,083778,Greenfeld; Be'Eri,5,0,36,31
1657123407076,MATH 103A,A03,093561,Greenfeld; Be'Eri,4,0,36,32
1657123407076,MATH 103A,B01,083779,Greenfeld; Be'Eri,6,0,36,30
1657123407076,MATH 103A,B02,083780,Greenfeld; Be'Eri,2,0,36,34
1657123407076,MATH 103A,B03,093562,Greenfeld; Be'Eri,3,0,36,33
1657123413109,MATH 105,A01,085443,Carter; Anne Toulson,14,0,35,21
1657123413109,MATH 105,A02,093477,Carter; Anne Toulson,20,0,35,15
1657123419133,MATH 109,A01,083213,Ganzberger; Geoffrey Michael,2,0,34,32
1657123419133,MATH 109,A02,083214,Ganzberger; Geoffrey Michael,3,0,34,31
1657123419133,MATH 109,A03,093478,Ganzberger; Geoffrey Michael,1,0,34,33
1657123419133,MATH 109,B01,083215,Ganzberger; Geoffrey Michael,1,0,32,31
1657123419133,MATH 109,B02,083216,Ganzberger; Geoffrey Michael,1,0,32,31
1657123419133,MATH 109,B03,093479,Ganzberger; Geoffrey Michael,6,0,32,26
1657123425162,MATH 142A,A01,083219,Chow; Bennett,6,0,32,26
1657123425162,MATH 142A,A02,083220,Chow; Bennett,10,0,32,22
1657123425162,MATH 142A,A03,093480,Chow; Bennett,7,0,32,25
1657123425162,MATH 142A,B03,093481,Chow; Bennett,8,0,32,24
1657123425162,MATH 142A,B04,093558,Chow; Bennett,11,0,32,21
1657123425162,MATH 142A,B05,093559,Chow; Bennett,6,0,32,26
1657123431191,MATH 193A,A01,083224,Rotar; Vladimir,7,0,34,27
1657123431191,MATH 193A,A02,083225,Rotar; Vladimir,5,0,34,29
1657123431191,MATH 193A,A03,083781,Rotar; Vladimir,1,0,34,33
1657123431191,MATH 193A,A04,083782,Rotar; Vladimir,6,0,34,28
1657123431191,MATH 193A,A05,093482,Rotar; Vladimir,6,0,34,28
1657123437216,MATH 197,001,091859,McAuley; Julian John,9999,0,9999,0
1657123437216,MATH 197,002,095566,Kedlaya; Kiran S.,9997,0,9999,2
1657123437216,MATH 197,003,095567,Xiao; Ming,9999,0,9999,0
1657123437216,MATH 197,004,095571,Perols; Johan Lars,9998,0,9999,1
1657123444363,COGS 9,A01,083615,Shannon; Kyle Michael,7,0,75,68
1657123450396,COGS 11,A01,083617,Boyle; Mary E. T.,21,0,48,27
1657123456432,COGS 13,A01,083071,Bastos; Amalia Pinkusfeld,9,0,71,62
1657123462466,COGS 14A,A01,092681,Semenuks; Arturs,1,1,100,99
1657123468489,COGS 14B,A01,083073,Cheng; Tzu-Han,6,0,63,57
1657123474517,COGS 17,A01,092677,Semenuks; Arturs,4,0,81,77
1657123480544,COGS 100,A01,083619,Allen; Michael Gordon,15,0,70,55
1657123486575,COGS 101A,A01,083621,Davis; Joshua Daniel,9,0,68,59
1657123492597,COGS 101B,A01,091572,Allen; Michael Gordon,8,0,65,57
1657123498623,COGS 101C,A01,083625,Delgado; Tania,17,0,35,18
1657123504645,COGS 107A,A01,083627,Boyle; Mary E. T.,13,0,60,47
1657123510668,COGS 118A,A01,083075,Gupta; Anjum,15,0,76,61
1657123516699,CSE 3,A50,083646,Miranda; Gregory Joseph,23,0,50,27
1657123522726,CSE 8A,A50,083650,Miranda; Gregory Joseph,17,1,56,39
1657123528749,CSE 11,A01,083080,Cao; Yingjun,4,15,40,36
1657123534775,CSE 12,A01,083652,Krause-Levy; Sophia Louisa,23,1,120,97
1657123540801,CSE 15L,A01,083654,Morris; Justin Loren,9,0,50,41
1657123540801,CSE 15L,A02,083655,Morris; Justin Loren,9,0,50,41
1657123546828,CSE 20,A01,083657,Tran; Khoa Dang,37,0,80,43
1657123552851,CSE 21,A01,095574,Bach; Quang Tran,21,0,48,27
1657123558873,CSE 30,A01,083084,Eldon; John,4,0,80,76
1657123558873,CSE 30,B01,095061,Bhaskar; Nishant,6,0,50,44
1657123564896,CSE 100,A01,083659,Cao; Yingjun,4,4,70,66
1657123570923,CSE 134B,A01,083661,Powell; Thomas Allan,19,0,100,81
1657123576959,CSE 140,A01,083663,Gungor; Onat,14,0,85,71
1657123582991,CSE 140L,A01,083088,Eldon; John,17,0,100,83
1657123589016,CSE 175,A01,083665,Kumar; Rakesh,3,0,25,22
1657123595039,CSE 190,A00,092507,Dubnov; Shlomo,7,0,20,13
1657123601067,ECE 45,A01,083139,Congero; Spencer William,5,0,75,70
1657123607094,ECE 65,A50,083695,Saad; Andrew S,12,0,30,18
1657123607094,ECE 65,A51,095125,Saad; Andrew S,25,0,26,1
1657123613116,ECE 109,A01,091882,Touri; Behrouz,16,0,70,54
1657123619139,ECE 180,A00,083140,Abi Samra; Nicholas Camill,1,0,30,29
1657123619139,ECE 180,B00,083141,Abi Samra; Nicholas Camill,0,0,30,30
1657123625162,MATH 10A,A01,083735,Patchell; Gregory David,1,0,30,29
1657123625162,MATH 10A,A02,083736,Patchell; Gregory David,20,0,30,10
1657123625162,MATH 10A,A03,083737,Patchell; Gregory David,16,0,30,14
1657123631191,MATH 10B,A01,083207,Lim; Seonhee,7,0,34,27
1657123631191,MATH 10B,A02,083208,Lim; Seonhee,9,0,35,26
1657123631191,MATH 10B,A03,093472,Lim; Seonhee,5,0,34,29
1657123631191,MATH 10B,B01,083739,Sinha; Shubham,9,0,30,21
1657123637217,MATH 18,A01,083743,Cinel; Cameron Alexander,6,0,30,24
1657123637217,MATH 18,A02,083744,Cinel; Cameron Alexander,15,0,30,15
1657123637217,MATH 18,A03,083745,Cinel; Cameron Alexander,8,0,30,22
1657123637217,MATH 18,B01,083748,Rideout; David Porter,4,0,37,33
1657123637217,MATH 18,B02,083749,Rideout; David Porter,3,0,36,33
1657123637217,MATH 18,B03,083750,Rideout; David Porter,2,0,37,35
1657123637217,MATH 18,B04,083751,Rideout; David Porter,5,0,36,31
1657123637217,MATH 18,B05,093473,Rideout; David Porter,4,0,36,32
1657123637217,MATH 18,B06,093474,Rideout; David Porter,5,0,36,31
1657123643241,MATH 20A,A01,083754,Zheng; Zequn,12,0,40,28
1657123649271,MATH 20B,A01,083756,Briones; Jor-el Thomas Caparas,1,0,36,35
1657123649271,MATH 20B,A02,083757,Briones; Jor-el Thomas Caparas,1,0,36,35
1657123649271,MATH 20B,A03,093475,Briones; Jor-el Thomas Caparas,0,0,36,36
1657123655296,MATH 20C,A01,083760,Briones; Jor-el Thomas Caparas,1,0,35,34
1657123655296,MATH 20C,A02,083761,Briones; Jor-el Thomas Caparas,8,0,35,27
1657123655296,MATH 20C,A03,093476,Briones; Jor-el Thomas Caparas,0,1,36,36
1657123655296,MATH 20C,B01,083762,Bach; Quang Tran,0,0,30,30
1657123661324,MATH 20D,A01,083765,Tran; Brian Kha,4,0,30,26
1657123661324,MATH 20D,A02,083766,Tran; Brian Kha,5,0,30,25
1657123661324,MATH 20D,A03,083767,Tran; Brian Kha,3,0,30,27
1657123667348,MATH 20E,A01,083771,Ganguly; Soumya,6,0,32,26
1657123667348,MATH 20E,A02,083772,Ganguly; Soumya,6,0,32,26
1657123667348,MATH 20E,B01,083773,Ciotti; Benjamin,18,0,35,17
1657123667348,MATH 20E,B02,083774,Ciotti; Benjamin,17,0,35,18
1657123673372,MATH 103A,A01,083777,Greenfeld; Be'Eri,2,0,36,34
1657123673372,MATH 103A,A02,083778,Greenfeld; Be'Eri,5,0,36,31
1657123673372,MATH 103A,A03,093561,Greenfeld; Be'Eri,4,0,36,32
1657123673372,MATH 103A,B01,083779,Greenfeld; Be'Eri,6,0,36,30
1657123673372,MATH 103A,B02,083780,Greenfeld; Be'Eri,3,0,36,33
1657123673372,MATH 103A,B03,093562,Greenfeld; Be'Eri,3,0,36,33
1657123679399,MATH 105,A01,085443,Carter; Anne Toulson,14,0,35,21
1657123679399,MATH 105,A02,093477,Carter; Anne Toulson,20,0,35,15
1657123685422,MATH 109,A01,083213,Ganzberger; Geoffrey Michael,2,0,34,32
1657123685422,MATH 109,A02,083214,Ganzberger; Geoffrey Michael,3,0,34,31
1657123685422,MATH 109,A03,093478,Ganzberger; Geoffrey Michael,1,0,34,33
1657123685422,MATH 109,B01,083215,Ganzberger; Geoffrey Michael,1,0,32,31
1657123685422,MATH 109,B02,083216,Ganzberger; Geoffrey Michael,1,0,32,31
1657123685422,MATH 109,B03,093479,Ganzberger; Geoffrey Michael,6,0,32,26
1657123691450,MATH 142A,A01,083219,Chow; Bennett,6,0,32,26
1657123691450,MATH 142A,A02,083220,Chow; Bennett,10,0,32,22
1657123691450,MATH 142A,A03,093480,Chow; Bennett,7,0,32,25
1657123691450,MATH 142A,B03,093481,Chow; Bennett,8,0,32,24
1657123691450,MATH 142A,B04,093558,Chow; Bennett,11,0,32,21
1657123691450,MATH 142A,B05,093559,Chow; Bennett,6,0,32,26
1657123697482,MATH 193A,A01,083224,Rotar; Vladimir,7,0,34,27
1657123697482,MATH 193A,A02,083225,Rotar; Vladimir,5,0,34,29
1657123697482,MATH 193A,A03,083781,Rotar; Vladimir,1,0,34,33
1657123697482,MATH 193A,A04,083782,Rotar; Vladimir,6,0,34,28
1657123697482,MATH 193A,A05,093482,Rotar; Vladimir,6,0,34,28
1657123703514,MATH 197,001,091859,McAuley; Julian John,9999,0,9999,0
1657123703514,MATH 197,002,095566,Kedlaya; Kiran S.,9997,0,9999,2
1657123703514,MATH 197,003,095567,Xiao; Ming,9999,0,9999,0
1657123703514,MATH 197,004,095571,Perols; Johan Lars,9998,0,9999,1
1657123710571,COGS 9,A01,083615,Shannon; Kyle Michael,7,0,75,68
1657123716595,COGS 11,A01,083617,Boyle; Mary E. T.,21,0,48,27
1657123722619,COGS 13,A01,083071,Bastos; Amalia Pinkusfeld,9,0,71,62
1657123728641,COGS 14A,A01,092681,Semenuks; Arturs,1,1,100,99
1657123734665,COGS 14B,A01,083073,Cheng; Tzu-Han,6,0,63,57
1657123740688,COGS 17,A01,092677,Semenuks; Arturs,4,0,81,77
1657123746712,COGS 100,A01,083619,Allen; Michael Gordon,15,0,70,55
1657123752741,COGS 101A,A01,083621,Davis; Joshua Daniel,9,0,68,59
1657123758769,COGS 101B,A01,091572,Allen; Michael Gordon,8,0,65,57
1657123764796,COGS 101C,A01,083625,Delgado; Tania,17,0,35,18
1657123770818,COGS 107A,A01,083627,Boyle; Mary E. T.,13,0,60,47
1657123776847,COGS 118A,A01,083075,Gupta; Anjum,15,0,76,61
1657123782891,CSE 3,A50,083646,Miranda; Gregory Joseph,23,0,50,27
1657123788915,CSE 8A,A50,083650,Miranda; Gregory Joseph,17,1,56,39
1657123794941,CSE 11,A01,083080,Cao; Yingjun,4,15,40,36
1657123800966,CSE 12,A01,083652,Krause-Levy; Sophia Louisa,23,1,120,97
1657123806989,CSE 15L,A01,083654,Morris; Justin Loren,9,0,50,41
1657123806989,CSE 15L,A02,083655,Morris; Justin Loren,9,0,50,41
1657123813013,CSE 20,A01,083657,Tran; Khoa Dang,37,0,80,43
1657123819041,CSE 21,A01,095574,Bach; Quang Tran,21,0,48,27
1657123825066,CSE 30,A01,083084,Eldon; John,4,0,80,76
1657123825066,CSE 30,B01,095061,Bhaskar; Nishant,6,0,50,44
1657123831090,CSE 100,A01,083659,Cao; Yingjun,4,4,70,66
1657123837112,CSE 134B,A01,083661,Powell; Thomas Allan,19,0,100,81
1657123843138,CSE 140,A01,083663,Gungor; Onat,14,0,85,71
1657123849164,CSE 140L,A01,083088,Eldon; John,17,0,100,83
1657123855187,CSE 175,A01,083665,Kumar; Rakesh,3,0,25,22
1657123861218,CSE 190,A00,092507,Dubnov; Shlomo,7,0,20,13
1657123867254,ECE 45,A01,083139,Congero; Spencer William,5,0,75,70
1657123873276,ECE 65,A50,083695,Saad; Andrew S,12,0,30,18
1657123873276,ECE 65,A51,095125,Saad; Andrew S,25,0,26,1
1657123879300,ECE 109,A01,091882,Touri; Behrouz,16,0,70,54
1657123885329,ECE 180,A00,083140,Abi Samra; Nicholas Camill,1,0,30,29
1657123885329,ECE 180,B00,083141,Abi Samra; Nicholas Camill,0,0,30,30
1657123891353,MATH 10A,A01,083735,Patchell; Gregory David,1,0,30,29
1657123891353,MATH 10A,A02,083736,Patchell; Gregory David,20,0,30,10
1657123891353,MATH 10A,A03,083737,Patchell; Gregory David,16,0,30,14
1657123897376,MATH 10B,A01,083207,Lim; Seonhee,7,0,34,27
1657123897376,MATH 10B,A02,083208,Lim; Seonhee,9,0,35,26
1657123897376,MATH 10B,A03,093472,Lim; Seonhee,5,0,34,29
1657123897376,MATH 10B,B01,083739,Sinha; Shubham,9,0,30,21
1657123903407,MATH 18,A01,083743,Cinel; Cameron Alexander,6,0,30,24
1657123903407,MATH 18,A02,083744,Cinel; Cameron Alexander,15,0,30,15
1657123903407,MATH 18,A03,083745,Cinel; Cameron Alexander,8,0,30,22
1657123903407,MATH 18,B01,083748,Rideout; David Porter,4,0,37,33
1657123903407,MATH 18,B02,083749,Rideout; David Porter,3,0,36,33
1657123903407,MATH 18,B03,083750,Rideout; David Porter,2,0,37,35
1657123903407,MATH 18,B04,083751,Rideout; David Porter,5,0,36,31
1657123903407,MATH 18,B05,093473,Rideout; David Porter,4,0,36,32
1657123903407,MATH 18,B06,093474,Rideout; David Porter,5,0,36,31
1657123909438,MATH 20A,A01,083754,Zheng; Zequn,12,0,40,28
1657123915469,MATH 20B,A01,083756,Briones; Jor-el Thomas Caparas,1,0,36,35
1657123915469,MATH 20B,A02,083757,Briones; Jor-el Thomas Caparas,1,0,36,35
1657123915469,MATH 20B,A03,093475,Briones; Jor-el Thomas Caparas,0,0,36,36
1657123921496,MATH 20C,A01,083760,Briones; Jor-el Thomas Caparas,1,0,35,34
1657123921496,MATH 20C,A02,083761,Briones; Jor-el Thomas Caparas,8,0,35,27
1657123921496,MATH 20C,A03,093476,Briones; Jor-el Thomas Caparas,0,1,36,36
1657123921496,MATH 20C,B01,083762,Bach; Quang Tran,0,0,30,30
1657123927549,MATH 20D,A01,083765,Tran; Brian Kha,4,0,30,26
1657123927549,MATH 20D,A02,083766,Tran; Brian Kha,5,0,30,25
1657123927549,MATH 20D,A03,083767,Tran; Brian Kha,3,0,30,27
1657123933576,MATH 20E,A01,083771,Ganguly; Soumya,6,0,32,26
1657123933576,MATH 20E,A02,083772,Ganguly; Soumya,6,0,32,26
1657123933576,MATH 20E,B01,083773,Ciotti; Benjamin,18,0,35,17
1657123933576,MATH 20E,B02,083774,Ciotti; Benjamin,17,0,35,18
1657123939608,MATH 103A,A01,083777,Greenfeld; Be'Eri,2,0,36,34
1657123939608,MATH 103A,A02,083778,Greenfeld; Be'Eri,5,0,36,31
1657123939608,MATH 103A,A03,093561,Greenfeld; Be'Eri,4,0,36,32
1657123939608,MATH 103A,B01,083779,Greenfeld; Be'Eri,6,0,36,30
1657123939608,MATH 103A,B02,083780,Greenfeld; Be'Eri,3,0,36,33
1657123939608,MATH 103A,B03,093562,Greenfeld; Be'Eri,3,0,36,33
1657123945631,MATH 105,A01,085443,Carter; Anne Toulson,14,0,35,21
1657123945631,MATH 105,A02,093477,Carter; Anne Toulson,20,0,35,15
1657123951657,MATH 109,A01,083213,Ganzberger; Geoffrey Michael,2,0,34,32
1657123951657,MATH 109,A02,083214,Ganzberger; Geoffrey Michael,3,0,34,31
1657123951657,MATH 109,A03,093478,Ganzberger; Geoffrey Michael,1,0,34,33
1657123951657,MATH 109,B01,083215,Ganzberger; Geoffrey Michael,1,0,32,31
1657123951657,MATH 109,B02,083216,Ganzberger; Geoffrey Michael,1,0,32,31
1657123951657,MATH 109,B03,093479,Ganzberger; Geoffrey Michael,6,0,32,26
1657123957681,MATH 142A,A01,083219,Chow; Bennett,6,0,32,26
1657123957681,MATH 142A,A02,083220,Chow; Bennett,10,0,32,22
1657123957681,MATH 142A,A03,093480,Chow; Bennett,7,0,32,25
1657123957681,MATH 142A,B03,093481,Chow; Bennett,8,0,32,24
1657123957681,MATH 142A,B04,093558,Chow; Bennett,11,0,32,21
1657123957681,MATH 142A,B05,093559,Chow; Bennett,6,0,32,26
1657123963705,MATH 193A,A01,083224,Rotar; Vladimir,7,0,34,27
1657123963705,MATH 193A,A02,083225,Rotar; Vladimir,5,0,34,29
1657123963705,MATH 193A,A03,083781,Rotar; Vladimir,1,0,34,33
1657123963705,MATH 193A,A04,083782,Rotar; Vladimir,6,0,34,28
1657123963705,MATH 193A,A05,093482,Rotar; Vladimir,6,0,34,28
1657123969728,MATH 197,001,091859,McAuley; Julian John,9999,0,9999,0
1657123969728,MATH 197,002,095566,Kedlaya; Kiran S.,9997,0,9999,2
1657123969728,MATH 197,003,095567,Xiao; Ming,9999,0,9999,0
1657123969728,MATH 197,004,095571,Perols; Johan Lars,9998,0,9999,1
1657123976796,COGS 9,A01,083615,Shannon; Kyle Michael,7,0,75,68
1657123982832,COGS 11,A01,083617,Boyle; Mary E. T.,21,0,48,27
1657123988856,COGS 13,A01,083071,Bastos; Amalia Pinkusfeld,9,0,71,62
1657123994878,COGS 14A,A01,092681,Semenuks; Arturs,1,1,100,99
1657124000905,COGS 14B,A01,083073,Cheng; Tzu-Han,6,0,63,57
1657124006930,COGS 17,A01,092677,Semenuks; Arturs,4,0,81,77
1657124012954,COGS 100,A01,083619,Allen; Michael Gordon,15,0,70,55
1657124018980,COGS 101A,A01,083621,Davis; Joshua Daniel,9,0,68,59
1657124025007,COGS 101B,A01,091572,Allen; Michael Gordon,8,0,65,57
1657124031044,COGS 101C,A01,083625,Delgado; Tania,17,0,35,18
1657124037072,COGS 107A,A01,083627,Boyle; Mary E. T.,13,0,60,47
1657124043183,COGS 118A,A01,083075,Gupta; Anjum,15,0,76,61
1657124049205,CSE 3,A50,083646,Miranda; Gregory Joseph,23,0,50,27
1657124055229,CSE 8A,A50,083650,Miranda; Gregory Joseph,17,1,56,39
1657124061255,CSE 11,A01,083080,Cao; Yingjun,4,15,40,36
1657124067279,CSE 12,A01,083652,Krause-Levy; Sophia Louisa,23,1,120,97
1657124073302,CSE 15L,A01,083654,Morris; Justin Loren,9,0,50,41
1657124073302,CSE 15L,A02,083655,Morris; Justin Loren,9,0,50,41
1657124079324,CSE 20,A01,083657,Tran; Khoa Dang,37,0,80,43
1657124085348,CSE 21,A01,095574,Bach; Quang Tran,21,0,48,27
1657124091372,CSE 30,A01,083084,Eldon; John,4,0,80,76
1657124091372,CSE 30,B01,095061,Bhaskar; Nishant,6,0,50,44
1657124097395,CSE 100,A01,083659,Cao; Yingjun,4,4,70,66
1657124103417,CSE 134B,A01,083661,Powell; Thomas Allan,19,0,100,81
1657124109444,CSE 140,A01,083663,Gungor; Onat,14,0,85,71
1657124115467,CSE 140L,A01,083088,Eldon; John,17,0,100,83
1657124121491,CSE 175,A01,083665,Kumar; Rakesh,3,0,25,22
1657124127518,CSE 190,A00,092507,Dubnov; Shlomo,7,0,20,13
1657124133542,ECE 45,A01,083139,Congero; Spencer William,5,0,75,70
1657124139569,ECE 65,A50,083695,Saad; Andrew S,12,0,30,18
1657124139569,ECE 65,A51,095125,Saad; Andrew S,25,0,26,1
1657124145592,ECE 109,A01,091882,Touri; Behrouz,16,0,70,54
1657124151621,ECE 180,A00,083140,Abi Samra; Nicholas Camill,1,0,30,29
1657124151621,ECE 180,B00,083141,Abi Samra; Nicholas Camill,0,0,30,30
1657124157648,MATH 10A,A01,083735,Patchell; Gregory David,1,0,30,29
1657124157648,MATH 10A,A02,083736,Patchell; Gregory David,20,0,30,10
1657124157648,MATH 10A,A03,083737,Patchell; Gregory David,16,0,30,14
1657124163679,MATH 10B,A01,083207,Lim; Seonhee,7,0,34,27
1657124163679,MATH 10B,A02,083208,Lim; Seonhee,9,0,35,26
1657124163679,MATH 10B,A03,093472,Lim; Seonhee,5,0,34,29
1657124163679,MATH 10B,B01,083739,Sinha; Shubham,9,0,30,21
1657124169715,MATH 18,A01,083743,Cinel; Cameron Alexander,6,0,30,24
1657124169715,MATH 18,A02,083744,Cinel; Cameron Alexander,15,0,30,15
1657124169715,MATH 18,A03,083745,Cinel; Cameron Alexander,8,0,30,22
1657124169715,MATH 18,B01,083748,Rideout; David Porter,4,0,37,33
1657124169715,MATH 18,B02,083749,Rideout; David Porter,3,0,36,33
1657124169715,MATH 18,B03,083750,Rideout; David Porter,2,0,37,35
1657124169715,MATH 18,B04,083751,Rideout; David Porter,5,0,36,31
1657124169715,MATH 18,B05,093473,Rideout; David Porter,4,0,36,32
1657124169715,MATH 18,B06,093474,Rideout; David Porter,5,0,36,31
1657124175740,MATH 20A,A01,083754,Zheng; Zequn,12,0,40,28
1657124181764,MATH 20B,A01,083756,Briones; Jor-el Thomas Caparas,1,0,36,35
1657124181764,MATH 20B,A02,083757,Briones; Jor-el Thomas Caparas,1,0,36,35
1657124181764,MATH 20B,A03,093475,Briones; Jor-el Thomas Caparas,0,0,36,36
1657124187787,MATH 20C,A01,083760,Briones; Jor-el Thomas Caparas,1,0,35,34
1657124187787,MATH 20C,A02,083761,Briones; Jor-el Thomas Caparas,8,0,35,27
1657124187787,MATH 20C,A03,093476,Briones; Jor-el Thomas Caparas,0,1,36,36
1657124187787,MATH 20C,B01,083762,Bach; Quang Tran,0,0,30,30
1657124193813,MATH 20D,A01,083765,Tran; Brian Kha,4,0,30,26
1657124193813,MATH 20D,A02,083766,Tran; Brian Kha,5,0,30,25
1657124193813,MATH 20D,A03,083767,Tran; Brian Kha,3,0,30,27
1657124199843,MATH 20E,A01,083771,Ganguly; Soumya,6,0,32,26
1657124199843,MATH 20E,A02,083772,Ganguly; Soumya,6,0,32,26
1657124199843,MATH 20E,B01,083773,Ciotti; Benjamin,18,0,35,17
1657124199843,MATH 20E,B02,083774,Ciotti; Benjamin,17,0,35,18
1657124205868,MATH 103A,A01,083777,Greenfeld; Be'Eri,2,0,36,34
1657124205868,MATH 103A,A02,083778,Greenfeld; Be'Eri,5,0,36,31
1657124205868,MATH 103A,A03,093561,Greenfeld; Be'Eri,4,0,36,32
1657124205868,MATH 103A,B01,083779,Greenfeld; Be'Eri,6,0,36,30
1657124205868,MATH 103A,B02,083780,Greenfeld; Be'Eri,3,0,36,33
1657124205868,MATH 103A,B03,093562,Greenfeld; Be'Eri,3,0,36,33
1657124211899,MATH 105,A01,085443,Carter; Anne Toulson,14,0,35,21
1657124211899,MATH 105,A02,093477,Carter; Anne Toulson,20,0,35,15
1657124217939,MATH 109,A01,083213,Ganzberger; Geoffrey Michael,2,0,34,32
1657124217939,MATH 109,A02,083214,Ganzberger; Geoffrey Michael,3,0,34,31
1657124217939,MATH 109,A03,093478,Ganzberger; Geoffrey Michael,1,0,34,33
1657124217939,MATH 109,B01,083215,Ganzberger; Geoffrey Michael,1,0,32,31
1657124217939,MATH 109,B02,083216,Ganzberger; Geoffrey Michael,1,0,32,31
1657124217939,MATH 109,B03,093479,Ganzberger; Geoffrey Michael,6,0,32,26
1657124223975,MATH 142A,A01,083219,Chow; Bennett,6,0,32,26
1657124223975,MATH 142A,A02,083220,Chow; Bennett,10,0,32,22
1657124223975,MATH 142A,A03,093480,Chow; Bennett,7,0,32,25
1657124223975,MATH 142A,B03,093481,Chow; Bennett,8,0,32,24
1657124223975,MATH 142A,B04,093558,Chow; Bennett,11,0,32,21
1657124223975,MATH 142A,B05,093559,Chow; Bennett,6,0,32,26
1657124229999,MATH 193A,A01,083224,Rotar; Vladimir,7,0,34,27
1657124229999,MATH 193A,A02,083225,Rotar; Vladimir,5,0,34,29
1657124229999,MATH 193A,A03,083781,Rotar; Vladimir,1,0,34,33
1657124229999,MATH 193A,A04,083782,Rotar; Vladimir,6,0,34,28
1657124229999,MATH 193A,A05,093482,Rotar; Vladimir,6,0,34,28
1657124236038,MATH 197,001,091859,McAuley; Julian John,9999,0,9999,0
1657124236038,MATH 197,002,095566,Kedlaya; Kiran S.,9997,0,9999,2
1657124236038,MATH 197,003,095567,Xiao; Ming,9999,0,9999,0
1657124236038,MATH 197,004,095571,Perols; Johan Lars,9998,0,9999,1
1657124243107,COGS 9,A01,083615,Shannon; Kyle Michael,7,0,75,68
1657124249131,COGS 11,A01,083617,Boyle; Mary E. T.,21,0,48,27
1657124255156,COGS 13,A01,083071,Bastos; Amalia Pinkusfeld,9,0,71,62
1657124261180,COGS 14A,A01,092681,Semenuks; Arturs,1,1,100,99
1657124267211,COGS 14B,A01,083073,Cheng; Tzu-Han,6,0,63,57
1657124273235,COGS 17,A01,092677,Semenuks; Arturs,4,0,81,77
1657124279267,COGS 100,A01,083619,Allen; Michael Gordon,15,0,70,55
1657124285296,COGS 101A,A01,083621,Davis; Joshua Daniel,9,0,68,59
1657124291319,COGS 101B,A01,091572,Allen; Michael Gordon,8,0,65,57
1657124297343,COGS 101C,A01,083625,Delgado; Tania,17,0,35,18
1657124303365,COGS 107A,A01,083627,Boyle; Mary E. T.,13,0,60,47
1657124309389,COGS 118A,A01,083075,Gupta; Anjum,15,0,76,61
1657124315414,CSE 3,A50,083646,Miranda; Gregory Joseph,23,0,50,27
1657124321438,CSE 8A,A50,083650,Miranda; Gregory Joseph,17,1,56,39
1657124327463,CSE 11,A01,083080,Cao; Yingjun,4,15,40,36
1657124333485,CSE 12,A01,083652,Krause-Levy; Sophia Louisa,23,1,120,97
1657124339510,CSE 15L,A01,083654,Morris; Justin Loren,9,0,50,41
1657124339510,CSE 15L,A02,083655,Morris; Justin Loren,9,0,50,41
1657124345537,CSE 20,A01,083657,Tran; Khoa Dang,37,0,80,43
1657124351561,CSE 21,A01,095574,Bach; Quang Tran,21,0,48,27
1657124357585,CSE 30,A01,083084,Eldon; John,4,0,80,76
1657124357585,CSE 30,B01,095061,Bhaskar; Nishant,6,0,50,44
1657124363612,CSE 100,A01,083659,Cao; Yingjun,4,4,70,66
1657124369650,CSE 134B,A01,083661,Powell; Thomas Allan,19,0,100,81
1657124375672,CSE 140,A01,083663,Gungor; Onat,14,0,85,71
1657124381696,CSE 140L,A01,083088,Eldon; John,17,0,100,83
1657124387723,CSE 175,A01,083665,Kumar; Rakesh,3,0,25,22
1657124393745,CSE 190,A00,092507,Dubnov; Shlomo,7,0,20,13
1657124399774,ECE 45,A01,083139,Congero; Spencer William,5,0,75,70
1657124405802,ECE 65,A50,083695,Saad; Andrew S,12,0,30,18
1657124405802,ECE 65,A51,095125,Saad; Andrew S,25,0,26,1
1657124411827,ECE 109,A01,091882,Touri; Behrouz,16,0,70,54
1657124417851,ECE 180,A00,083140,Abi Samra; Nicholas Camill,1,0,30,29
1657124417851,ECE 180,B00,083141,Abi Samra; Nicholas Camill,0,0,30,30
1657124423881,MATH 10A,A01,083735,Patchell; Gregory David,1,0,30,29
1657124423881,MATH 10A,A02,083736,Patchell; Gregory David,20,0,30,10
1657124423881,MATH 10A,A03,083737,Patchell; Gregory David,16,0,30,14
1657124429906,MATH 10B,A01,083207,Lim; Seonhee,7,0,34,27
1657124429906,MATH 10B,A02,083208,Lim; Seonhee,9,0,35,26
1657124429906,MATH 10B,A03,093472,Lim; Seonhee,5,0,34,29
1657124429906,MATH 10B,B01,083739,Sinha; Shubham,9,0,30,21
1657124435945,MATH 18,A01,083743,Cinel; Cameron Alexander,6,0,30,24
1657124435945,MATH 18,A02,083744,Cinel; Cameron Alexander,15,0,30,15
1657124435945,MATH 18,A03,083745,Cinel; Cameron Alexander,8,0,30,22
1657124435945,MATH 18,B01,083748,Rideout; David Porter,4,0,37,33
1657124435945,MATH 18,B02,083749,Rideout; David Porter,3,0,36,33
1657124435945,MATH 18,B03,083750,Rideout; David Porter,2,0,37,35
1657124435945,MATH 18,B04,083751,Rideout; David Porter,5,0,36,31
1657124435945,MATH 18,B05,093473,Rideout; David Porter,4,0,36,32
1657124435945,MATH 18,B06,093474,Rideout; David Porter,5,0,36,31
1657124441968,MATH 20A,A01,083754,Zheng; Zequn,12,0,40,28
1657124447992,MATH 20B,A01,083756,Briones; Jor-el Thomas Caparas,1,0,36,35
1657124447992,MATH 20B,A02,083757,Briones; Jor-el Thomas Caparas,1,0,36,35
1657124447992,MATH 20B,A03,093475,Briones; Jor-el Thomas Caparas,0,0,36,36
1657124454020,MATH 20C,A01,083760,Briones; Jor-el Thomas Caparas,1,0,35,34
1657124454020,MATH 20C,A02,083761,Briones; Jor-el Thomas Caparas,8,0,35,27
1657124454020,MATH 20C,A03,093476,Briones; Jor-el Thomas Caparas,0,1,36,36
1657124454020,MATH 20C,B01,083762,Bach; Quang Tran,0,0,30,30
1657124460048,MATH 20D,A01,083765,Tran; Brian Kha,4,0,30,26
1657124460048,MATH 20D,A02,083766,Tran; Brian Kha,5,0,30,25
1657124460048,MATH 20D,A03,083767,Tran; Brian Kha,3,0,30,27
1657124466072,MATH 20E,A01,083771,Ganguly; Soumya,6,0,32,26
1657124466072,MATH 20E,A02,083772,Ganguly; Soumya,6,0,32,26
1657124466072,MATH 20E,B01,083773,Ciotti; Benjamin,18,0,35,17
1657124466072,MATH 20E,B02,083774,Ciotti; Benjamin,17,0,35,18
1657124472101,MATH 103A,A01,083777,Greenfeld; Be'Eri,2,0,36,34
1657124472101,MATH 103A,A02,083778,Greenfeld; Be'Eri,5,0,36,31
1657124472101,MATH 103A,A03,093561,Greenfeld; Be'Eri,4,0,36,32
1657124472101,MATH 103A,B01,083779,Greenfeld; Be'Eri,6,0,36,30
1657124472101,MATH 103A,B02,083780,Greenfeld; Be'Eri,3,0,36,33
1657124472101,MATH 103A,B03,093562,Greenfeld; Be'Eri,3,0,36,33
1657124478132,MATH 105,A01,085443,Carter; Anne Toulson,14,0,35,21
1657124478132,MATH 105,A02,093477,Carter; Anne Toulson,20,0,35,15
1657124484161,MATH 109,A01,083213,Ganzberger; Geoffrey Michael,2,0,34,32
1657124484161,MATH 109,A02,083214,Ganzberger; Geoffrey Michael,3,0,34,31
1657124484161,MATH 109,A03,093478,Ganzberger; Geoffrey Michael,1,0,34,33
1657124484161,MATH 109,B01,083215,Ganzberger; Geoffrey Michael,1,0,32,31
1657124484161,MATH 109,B02,083216,Ganzberger; Geoffrey Michael,1,0,32,31
1657124484161,MATH 109,B03,093479,Ganzberger; Geoffrey Michael,6,0,32,26
1657124490191,MATH 142A,A01,083219,Chow; Bennett,6,0,32,26
1657124490191,MATH 142A,A02,083220,Chow; Bennett,10,0,32,22
1657124490191,MATH 142A,A03,093480,Chow; Bennett,7,0,32,25
1657124490191,MATH 142A,B03,093481,Chow; Bennett,8,0,32,24
1657124490191,MATH 142A,B04,093558,Chow; Bennett,11,0,32,21
1657124490191,MATH 142A,B05,093559,Chow; Bennett,6,0,32,26
1657124496218,MATH 193A,A01,083224,Rotar; Vladimir,7,0,34,27
1657124496218,MATH 193A,A02,083225,Rotar; Vladimir,5,0,34,29
1657124496218,MATH 193A,A03,083781,Rotar; Vladimir,1,0,34,33
1657124496218,MATH 193A,A04,083782,Rotar; Vladimir,6,0,34,28
1657124496218,MATH 193A,A05,093482,Rotar; Vladimir,6,0,34,28
1657124502256,MATH 197,001,091859,McAuley; Julian John,9999,0,9999,0
1657124502256,MATH 197,002,095566,Kedlaya; Kiran S.,9997,0,9999,2
1657124502256,MATH 197,003,095567,Xiao; Ming,9999,0,9999,0
1657124502256,MATH 197,004,095571,Perols; Johan Lars,9998,0,9999,1
1657124509313,COGS 9,A01,083615,Shannon; Kyle Michael,7,0,75,68
1657124515351,COGS 11,A01,083617,Boyle; Mary E. T.,21,0,48,27
1657124521377,COGS 13,A01,083071,Bastos; Amalia Pinkusfeld,9,0,71,62
1657124527399,COGS 14A,A01,092681,Semenuks; Arturs,1,1,100,99
1657124533426,COGS 14B,A01,083073,Cheng; Tzu-Han,6,0,63,57
1657124539459,COGS 17,A01,092677,Semenuks; Arturs,4,0,81,77
1657124545491,COGS 100,A01,083619,Allen; Michael Gordon,15,0,70,55
1657124551518,COGS 101A,A01,083621,Davis; Joshua Daniel,9,0,68,59
1657124557548,COGS 101B,A01,091572,Allen; Michael Gordon,8,0,65,57
1657124563574,COGS 101C,A01,083625,Delgado; Tania,17,0,35,18
1657124569600,COGS 107A,A01,083627,Boyle; Mary E. T.,13,0,60,47
1657124575628,COGS 118A,A01,083075,Gupta; Anjum,15,0,76,61
1657124581652,CSE 3,A50,083646,Miranda; Gregory Joseph,23,0,50,27
1657124587678,CSE 8A,A50,083650,Miranda; Gregory Joseph,17,1,56,39
1657124593702,CSE 11,A01,083080,Cao; Yingjun,4,15,40,36
1657124599728,CSE 12,A01,083652,Krause-Levy; Sophia Louisa,23,1,120,97
1657124605765,CSE 15L,A01,083654,Morris; Justin Loren,9,0,50,41
1657124605765,CSE 15L,A02,083655,Morris; Justin Loren,9,0,50,41
1657124611802,CSE 20,A01,083657,Tran; Khoa Dang,37,0,80,43
1657124617829,CSE 21,A01,095574,Bach; Quang Tran,21,0,48,27
1657124623857,CSE 30,A01,083084,Eldon; John,4,0,80,76
1657124623857,CSE 30,B01,095061,Bhaskar; Nishant,6,0,50,44
1657124629886,CSE 100,A01,083659,Cao; Yingjun,4,4,70,66
1657124635909,CSE 134B,A01,083661,Powell; Thomas Allan,19,0,100,81
1657124642022,CSE 140,A01,083663,Gungor; Onat,14,0,85,71
1657124648044,CSE 140L,A01,083088,Eldon; John,17,0,100,83
1657124654068,CSE 175,A01,083665,Kumar; Rakesh,3,0,25,22
1657124660116,CSE 190,A00,092507,Dubnov; Shlomo,7,0,20,13
1657124666151,ECE 45,A01,083139,Congero; Spencer William,5,0,75,70
1657124672173,ECE 65,A50,083695,Saad; Andrew S,12,0,30,18
1657124672173,ECE 65,A51,095125,Saad; Andrew S,25,0,26,1
1657124678200,ECE 109,A01,091882,Touri; Behrouz,16,0,70,54
1657124684222,ECE 180,A00,083140,Abi Samra; Nicholas Camill,1,0,30,29
1657124684222,ECE 180,B00,083141,Abi Samra; Nicholas Camill,0,0,30,30
1657124690247,MATH 10A,A01,083735,Patchell; Gregory David,1,0,30,29
1657124690247,MATH 10A,A02,083736,Patchell; Gregory David,20,0,30,10
1657124690247,MATH 10A,A03,083737,Patchell; Gregory David,16,0,30,14
1657124696280,MATH 10B,A01,083207,Lim; Seonhee,7,0,34,27
1657124696280,MATH 10B,A02,083208,Lim; Seonhee,9,0,35,26
1657124696280,MATH 10B,A03,093472,Lim; Seonhee,5,0,34,29
1657124696280,MATH 10B,B01,083739,Sinha; Shubham,9,0,30,21
1657124702312,MATH 18,A01,083743,Cinel; Cameron Alexander,6,0,30,24
1657124702312,MATH 18,A02,083744,Cinel; Cameron Alexander,15,0,30,15
1657124702312,MATH 18,A03,083745,Cinel; Cameron Alexander,8,0,30,22
1657124702312,MATH 18,B01,083748,Rideout; David Porter,4,0,37,33
1657124702312,MATH 18,B02,083749,Rideout; David Porter,3,0,36,33
1657124702312,MATH 18,B03,083750,Rideout; David Porter,2,0,37,35
1657124702312,MATH 18,B04,083751,Rideout; David Porter,5,0,36,31
1657124702312,MATH 18,B05,093473,Rideout; David Porter,4,0,36,32
1657124702312,MATH 18,B06,093474,Rideout; David Porter,5,0,36,31
1657124708346,MATH 20A,A01,083754,Zheng; Zequn,12,0,40,28
1657124714378,MATH 20B,A01,083756,Briones; Jor-el Thomas Caparas,1,0,36,35
1657124714378,MATH 20B,A02,083757,Briones; Jor-el Thomas Caparas,1,0,36,35
1657124714378,MATH 20B,A03,093475,Briones; Jor-el Thomas Caparas,0,0,36,36
1657124720417,MATH 20C,A01,083760,Briones; Jor-el Thomas Caparas,1,0,35,34
1657124720417,MATH 20C,A02,083761,Briones; Jor-el Thomas Caparas,8,0,35,27
1657124720417,MATH 20C,A03,093476,Briones; Jor-el Thomas Caparas,0,1,36,36
1657124720417,MATH 20C,B01,083762,Bach; Quang Tran,0,0,30,30
1657124726439,MATH 20D,A01,083765,Tran; Brian Kha,4,0,30,26
1657124726439,MATH 20D,A02,083766,Tran; Brian Kha,5,0,30,25
1657124726439,MATH 20D,A03,083767,Tran; Brian Kha,3,0,30,27
1657124732485,MATH 20E,A01,083771,Ganguly; Soumya,6,0,32,26
1657124732485,MATH 20E,A02,083772,Ganguly; Soumya,6,0,32,26
1657124732485,MATH 20E,B01,083773,Ciotti; Benjamin,18,0,35,17
1657124732485,MATH 20E,B02,083774,Ciotti; Benjamin,17,0,35,18
1657124738508,MATH 103A,A01,083777,Greenfeld; Be'Eri,2,0,36,34
1657124738508,MATH 103A,A02,083778,Greenfeld; Be'Eri,5,0,36,31
1657124738508,MATH 103A,A03,093561,Greenfeld; Be'Eri,4,0,36,32
1657124738508,MATH 103A,B01,083779,Greenfeld; Be'Eri,6,0,36,30
1657124738508,MATH 103A,B02,083780,Greenfeld; Be'Eri,3,0,36,33
1657124738508,MATH 103A,B03,093562,Greenfeld; Be'Eri,3,0,36,33
1657124744536,MATH 105,A01,085443,Carter; Anne Toulson,14,0,35,21
1657124744536,MATH 105,A02,093477,Carter; Anne Toulson,20,0,35,15
1657124750566,MATH 109,A01,083213,Ganzberger; Geoffrey Michael,2,0,34,32
1657124750566,MATH 109,A02,083214,Ganzberger; Geoffrey Michael,3,0,34,31
1657124750566,MATH 109,A03,093478,Ganzberger; Geoffrey Michael,1,0,34,33
1657124750566,MATH 109,B01,083215,Ganzberger; Geoffrey Michael,1,0,32,31
1657124750566,MATH 109,B02,083216,Ganzberger; Geoffrey Michael,1,0,32,31
1657124750566,MATH 109,B03,093479,Ganzberger; Geoffrey Michael,6,0,32,26
1657124756600,MATH 142A,A01,083219,Chow; Bennett,6,0,32,26
1657124756600,MATH 142A,A02,083220,Chow; Bennett,10,0,32,22
1657124756600,MATH 142A,A03,093480,Chow; Bennett,7,0,32,25
1657124756600,MATH 142A,B03,093481,Chow; Bennett,8,0,32,24
1657124756600,MATH 142A,B04,093558,Chow; Bennett,11,0,32,21
1657124756600,MATH 142A,B05,093559,Chow; Bennett,6,0,32,26
1657124762629,MATH 193A,A01,083224,Rotar; Vladimir,7,0,34,27
1657124762629,MATH 193A,A02,083225,Rotar; Vladimir,5,0,34,29
1657124762629,MATH 193A,A03,083781,Rotar; Vladimir,1,0,34,33
1657124762629,MATH 193A,A04,083782,Rotar; Vladimir,6,0,34,28
1657124762629,MATH 193A,A05,093482,Rotar; Vladimir,6,0,34,28
1657124768653,MATH 197,001,091859,McAuley; Julian John,9999,0,9999,0
1657124768653,MATH 197,002,095566,Kedlaya; Kiran S.,9997,0,9999,2
1657124768653,MATH 197,003,095567,Xiao; Ming,9999,0,9999,0
1657124768653,MATH 197,004,095571,Perols; Johan Lars,9998,0,9999,1
1657124775724,COGS 9,A01,083615,Shannon; Kyle Michael,7,0,75,68
1657124781751,COGS 11,A01,083617,Boyle; Mary E. T.,21,0,48,27
1657124787774,COGS 13,A01,083071,Bastos; Amalia Pinkusfeld,9,0,71,62
1657124793805,COGS 14A,A01,092681,Semenuks; Arturs,1,1,100,99
1657124799833,COGS 14B,A01,083073,Cheng; Tzu-Han,6,0,63,57
1657124805856,COGS 17,A01,092677,Semenuks; Arturs,4,0,81,77
1657124811890,COGS 100,A01,083619,Allen; Michael Gordon,15,0,70,55
1657124817913,COGS 101A,A01,083621,Davis; Joshua Daniel,9,0,68,59
1657124823935,COGS 101B,A01,091572,Allen; Michael Gordon,8,0,65,57
1657124829963,COGS 101C,A01,083625,Delgado; Tania,17,0,35,18
1657124835988,COGS 107A,A01,083627,Boyle; Mary E. T.,13,0,60,47
1657124842012,COGS 118A,A01,083075,Gupta; Anjum,15,0,76,61
1657124848047,CSE 3,A50,083646,Miranda; Gregory Joseph,23,0,50,27
1657124854081,CSE 8A,A50,083650,Miranda; Gregory Joseph,17,1,56,39
1657124860113,CSE 11,A01,083080,Cao; Yingjun,4,15,40,36
1657124866135,CSE 12,A01,083652,Krause-Levy; Sophia Louisa,23,1,120,97
1657124872157,CSE 15L,A01,083654,Morris; Justin Loren,9,0,50,41
1657124872157,CSE 15L,A02,083655,Morris; Justin Loren,9,0,50,41
1657124878182,CSE 20,A01,083657,Tran; Khoa Dang,37,0,80,43
1657124884209,CSE 21,A01,095574,Bach; Quang Tran,21,0,48,27
1657124890231,CSE 30,A01,083084,Eldon; John,4,0,80,76
1657124890231,CSE 30,B01,095061,Bhaskar; Nishant,6,0,50,44
1657124896254,CSE 100,A01,083659,Cao; Yingjun,4,4,70,66
1657124902276,CSE 134B,A01,083661,Powell; Thomas Allan,19,0,100,81
1657124908298,CSE 140,A01,083663,Gungor; Onat,14,0,85,71
1657124914325,CSE 140L,A01,083088,Eldon; John,17,0,100,83
1657124920348,CSE 175,A01,083665,Kumar; Rakesh,3,0,25,22
1657124926384,CSE 190,A00,092507,Dubnov; Shlomo,7,0,20,13
1657124932407,ECE 45,A01,083139,Congero; Spencer William,5,0,75,70
1657124938434,ECE 65,A50,083695,Saad; Andrew S,12,0,30,18
1657124938434,ECE 65,A51,095125,Saad; Andrew S,25,0,26,1
1657124944457,ECE 109,A01,091882,Touri; Behrouz,16,0,70,54
1657124950479,ECE 180,A00,083140,Abi Samra; Nicholas Camill,1,0,30,29
1657124950479,ECE 180,B00,083141,Abi Samra; Nicholas Camill,0,0,30,30
1657124956515,MATH 10A,A01,083735,Patchell; Gregory David,1,0,30,29
1657124956515,MATH 10A,A02,083736,Patchell; Gregory David,20,0,30,10
1657124956515,MATH 10A,A03,083737,Patchell; Gregory David,16,0,30,14
1657124962550,MATH 10B,A01,083207,Lim; Seonhee,7,0,34,27
1657124962550,MATH 10B,A02,083208,Lim; Seonhee,9,0,35,26
1657124962550,MATH 10B,A03,093472,Lim; Seonhee,5,0,34,29
1657124962550,MATH 10B,B01,083739,Sinha; Shubham,9,0,30,21
1657124968582,MATH 18,A01,083743,Cinel; Cameron Alexander,6,0,30,24
1657124968582,MATH 18,A02,083744,Cinel; Cameron Alexander,15,0,30,15
1657124968582,MATH 18,A03,083745,Cinel; Cameron Alexander,8,0,30,22
1657124968582,MATH 18,B01,083748,Rideout; David Porter,4,0,37,33
1657124968582,MATH 18,B02,083749,Rideout; David Porter,3,0,36,33
1657124968582,MATH 18,B03,083750,Rideout; David Porter,2,0,37,35
1657124968582,MATH 18,B04,083751,Rideout; David Porter,5,0,36,31
1657124968582,MATH 18,B05,093473,Rideout; David Porter,4,0,36,32
1657124968582,MATH 18,B06,093474,Rideout; David Porter,5,0,36,31
1657124974605,MATH 20A,A01,083754,Zheng; Zequn,12,0,40,28
1657124980626,MATH 20B,A01,083756,Briones; Jor-el Thomas Caparas,1,0,36,35
1657124980626,MATH 20B,A02,083757,Briones; Jor-el Thomas Caparas,1,0,36,35
1657124980626,MATH 20B,A03,093475,Briones; Jor-el Thomas Caparas,0,0,36,36
1657124986650,MATH 20C,A01,083760,Briones; Jor-el Thomas Caparas,1,0,35,34
1657124986650,MATH 20C,A02,083761,Briones; Jor-el Thomas Caparas,8,0,35,27
1657124986650,MATH 20C,A03,093476,Briones; Jor-el Thomas Caparas,0,1,36,36
1657124986650,MATH 20C,B01,083762,Bach; Quang Tran,0,0,30,30
1657124992683,MATH 20D,A01,083765,Tran; Brian Kha,4,0,30,26
1657124992683,MATH 20D,A02,083766,Tran; Brian Kha,5,0,30,25
1657124992683,MATH 20D,A03,083767,Tran; Brian Kha,3,0,30,27
1657124998708,MATH 20E,A01,083771,Ganguly; Soumya,6,0,32,26
1657124998708,MATH 20E,A02,083772,Ganguly; Soumya,6,0,32,26
1657124998708,MATH 20E,B01,083773,Ciotti; Benjamin,18,0,35,17
1657124998708,MATH 20E,B02,083774,Ciotti; Benjamin,17,0,35,18
1657125004738,MATH 103A,A01,083777,Greenfeld; Be'Eri,2,0,36,34
1657125004738,MATH 103A,A02,083778,Greenfeld; Be'Eri,5,0,36,31
1657125004738,MATH 103A,A03,093561,Greenfeld; Be'Eri,4,0,36,32
1657125004738,MATH 103A,B01,083779,Greenfeld; Be'Eri,6,0,36,30
1657125004738,MATH 103A,B02,083780,Greenfeld; Be'Eri,3,0,36,33
1657125004738,MATH 103A,B03,093562,Greenfeld; Be'Eri,3,0,36,33
1657125010762,MATH 105,A01,085443,Carter; Anne Toulson,14,0,35,21
1657125010762,MATH 105,A02,093477,Carter; Anne Toulson,20,0,35,15
1657125016794,MATH 109,A01,083213,Ganzberger; Geoffrey Michael,2,0,34,32
1657125016794,MATH 109,A02,083214,Ganzberger; Geoffrey Michael,3,0,34,31
1657125016794,MATH 109,A03,093478,Ganzberger; Geoffrey Michael,1,0,34,33
1657125016794,MATH 109,B01,083215,Ganzberger; Geoffrey Michael,1,0,32,31
1657125016794,MATH 109,B02,083216,Ganzberger; Geoffrey Michael,1,0,32,31
1657125016794,MATH 109,B03,093479,Ganzberger; Geoffrey Michael,6,0,32,26
1657125022824,MATH 142A,A01,083219,Chow; Bennett,6,0,32,26
1657125022824,MATH 142A,A02,083220,Chow; Bennett,10,0,32,22
1657125022824,MATH 142A,A03,093480,Chow; Bennett,7,0,32,25
1657125022824,MATH 142A,B03,093481,Chow; Bennett,8,0,32,24
1657125022824,MATH 142A,B04,093558,Chow; Bennett,11,0,32,21
1657125022824,MATH 142A,B05,093559,Chow; Bennett,6,0,32,26
1657125028846,MATH 193A,A01,083224,Rotar; Vladimir,7,0,34,27
1657125028846,MATH 193A,A02,083225,Rotar; Vladimir,5,0,34,29
1657125028846,MATH 193A,A03,083781,Rotar; Vladimir,1,0,34,33
1657125028846,MATH 193A,A04,083782,Rotar; Vladimir,6,0,34,28
1657125028846,MATH 193A,A05,093482,Rotar; Vladimir,6,0,34,28
1657125034871,MATH 197,001,091859,McAuley; Julian John,9999,0,9999,0
1657125034871,MATH 197,002,095566,Kedlaya; Kiran S.,9997,0,9999,2
1657125034871,MATH 197,003,095567,Xiao; Ming,9999,0,9999,0
1657125034871,MATH 197,004,095571,Perols; Johan Lars,9998,0,9999,1
1657125041942,COGS 9,A01,083615,Shannon; Kyle Michael,7,0,75,68
1657125047964,COGS 11,A01,083617,Boyle; Mary E. T.,21,0,48,27
1657125053991,COGS 13,A01,083071,Bastos; Amalia Pinkusfeld,9,0,71,62
1657125060018,COGS 14A,A01,092681,Semenuks; Arturs,1,1,100,99
1657125066053,COGS 14B,A01,083073,Cheng; Tzu-Han,6,0,63,57
1657125072075,COGS 17,A01,092677,Semenuks; Arturs,4,0,81,77
1657125078107,COGS 100,A01,083619,Allen; Michael Gordon,15,0,70,55
1657125084129,COGS 101A,A01,083621,Davis; Joshua Daniel,9,0,68,59
1657125090159,COGS 101B,A01,091572,Allen; Michael Gordon,8,0,65,57
1657125096198,COGS 101C,A01,083625,Delgado; Tania,17,0,35,18
1657125102220,COGS 107A,A01,083627,Boyle; Mary E. T.,13,0,60,47
1657125108253,COGS 118A,A01,083075,Gupta; Anjum,15,0,76,61
1657125114277,CSE 3,A50,083646,Miranda; Gregory Joseph,23,0,50,27
1657125120300,CSE 8A,A50,083650,Miranda; Gregory Joseph,17,1,56,39
1657125126324,CSE 11,A01,083080,Cao; Yingjun,4,15,40,36
1657125132348,CSE 12,A01,083652,Krause-Levy; Sophia Louisa,23,1,120,97
1657125138371,CSE 15L,A01,083654,Morris; Justin Loren,9,0,50,41
1657125138371,CSE 15L,A02,083655,Morris; Justin Loren,9,0,50,41
1657125144394,CSE 20,A01,083657,Tran; Khoa Dang,37,0,80,43
1657125150416,CSE 21,A01,095574,Bach; Quang Tran,21,0,48,27
1657125156440,CSE 30,A01,083084,Eldon; John,4,0,80,76
1657125156440,CSE 30,B01,095061,Bhaskar; Nishant,6,0,50,44
1657125162466,CSE 100,A01,083659,Cao; Yingjun,4,4,70,66
1657125168489,CSE 134B,A01,083661,Powell; Thomas Allan,19,0,100,81
1657125174510,CSE 140,A01,083663,Gungor; Onat,14,0,85,71
1657125180538,CSE 140L,A01,083088,Eldon; John,17,0,100,83
1657125186567,CSE 175,A01,083665,Kumar; Rakesh,3,0,25,22
1657125192593,CSE 190,A00,092507,Dubnov; Shlomo,7,0,20,13
1657125198617,ECE 45,A01,083139,Congero; Spencer William,5,0,75,70
1657125204646,ECE 65,A50,083695,Saad; Andrew S,12,0,30,18
1657125204646,ECE 65,A51,095125,Saad; Andrew S,25,0,26,1
1657125210671,ECE 109,A01,091882,Touri; Behrouz,16,0,70,54
1657125216695,ECE 180,A00,083140,Abi Samra; Nicholas Camill,1,0,30,29
1657125216695,ECE 180,B00,083141,Abi Samra; Nicholas Camill,0,0,30,30
1657125222723,MATH 10A,A01,083735,Patchell; Gregory David,1,0,30,29
1657125222723,MATH 10A,A02,083736,Patchell; Gregory David,20,0,30,10
1657125222723,MATH 10A,A03,083737,Patchell; Gregory David,16,0,30,14
1657125228757,MATH 10B,A01,083207,Lim; Seonhee,7,0,34,27
1657125228757,MATH 10B,A02,083208,Lim; Seonhee,9,0,35,26
1657125228757,MATH 10B,A03,093472,Lim; Seonhee,5,0,34,29
1657125228757,MATH 10B,B01,083739,Sinha; Shubham,9,0,30,21
1657125234789,MATH 18,A01,083743,Cinel; Cameron Alexander,6,0,30,24
1657125234789,MATH 18,A02,083744,Cinel; Cameron Alexander,15,0,30,15
1657125234789,MATH 18,A03,083745,Cinel; Cameron Alexander,8,0,30,22
1657125234789,MATH 18,B01,083748,Rideout; David Porter,4,0,37,33
1657125234789,MATH 18,B02,083749,Rideout; David Porter,3,0,36,33
1657125234789,MATH 18,B03,083750,Rideout; David Porter,2,0,37,35
1657125234789,MATH 18,B04,083751,Rideout; David Porter,5,0,36,31
1657125234789,MATH 18,B05,093473,Rideout; David Porter,4,0,36,32
1657125234789,MATH 18,B06,093474,Rideout; David Porter,5,0,36,31
1657125240885,MATH 20A,A01,083754,Zheng; Zequn,12,0,40,28
1657125246915,MATH 20B,A01,083756,Briones; Jor-el Thomas Caparas,1,0,36,35
1657125246915,MATH 20B,A02,083757,Briones; Jor-el Thomas Caparas,1,0,36,35
1657125246915,MATH 20B,A03,093475,Briones; Jor-el Thomas Caparas,0,0,36,36
1657125252941,MATH 20C,A01,083760,Briones; Jor-el Thomas Caparas,1,0,35,34
1657125252941,MATH 20C,A02,083761,Briones; Jor-el Thomas Caparas,8,0,35,27
1657125252941,MATH 20C,A03,093476,Briones; Jor-el Thomas Caparas,0,1,36,36
1657125252941,MATH 20C,B01,083762,Bach; Quang Tran,0,0,30,30
1657125258967,MATH 20D,A01,083765,Tran; Brian Kha,4,0,30,26
1657125258967,MATH 20D,A02,083766,Tran; Brian Kha,5,0,30,25
1657125258967,MATH 20D,A03,083767,Tran; Brian Kha,3,0,30,27
1657125265003,MATH 20E,A01,083771,Ganguly; Soumya,6,0,32,26
1657125265003,MATH 20E,A02,083772,Ganguly; Soumya,6,0,32,26
1657125265003,MATH 20E,B01,083773,Ciotti; Benjamin,18,0,35,17
1657125265003,MATH 20E,B02,083774,Ciotti; Benjamin,17,0,35,18
1657125271036,MATH 103A,A01,083777,Greenfeld; Be'Eri,2,0,36,34
1657125271036,MATH 103A,A02,083778,Greenfeld; Be'Eri,5,0,36,31
1657125271036,MATH 103A,A03,093561,Greenfeld; Be'Eri,4,0,36,32
1657125271036,MATH 103A,B01,083779,Greenfeld; Be'Eri,6,0,36,30
1657125271036,MATH 103A,B02,083780,Greenfeld; Be'Eri,3,0,36,33
1657125271036,MATH 103A,B03,093562,Greenfeld; Be'Eri,3,0,36,33
1657125277070,MATH 105,A01,085443,Carter; Anne Toulson,14,0,35,21
1657125277070,MATH 105,A02,093477,Carter; Anne Toulson,20,0,35,15
1657125283099,MATH 109,A01,083213,Ganzberger; Geoffrey Michael,2,0,34,32
1657125283099,MATH 109,A02,083214,Ganzberger; Geoffrey Michael,3,0,34,31
1657125283099,MATH 109,A03,093478,Ganzberger; Geoffrey Michael,1,0,34,33
1657125283099,MATH 109,B01,083215,Ganzberger; Geoffrey Michael,1,0,32,31
1657125283099,MATH 109,B02,083216,Ganzberger; Geoffrey Michael,1,0,32,31
1657125283099,MATH 109,B03,093479,Ganzberger; Geoffrey Michael,6,0,32,26
1657125289134,MATH 142A,A01,083219,Chow; Bennett,6,0,32,26
1657125289134,MATH 142A,A02,083220,Chow; Bennett,10,0,32,22
1657125289134,MATH 142A,A03,093480,Chow; Bennett,7,0,32,25
1657125289134,MATH 142A,B03,093481,Chow; Bennett,8,0,32,24
1657125289134,MATH 142A,B04,093558,Chow; Bennett,11,0,32,21
1657125289134,MATH 142A,B05,093559,Chow; Bennett,6,0,32,26
1657125295162,MATH 193A,A01,083224,Rotar; Vladimir,7,0,34,27
1657125295162,MATH 193A,A02,083225,Rotar; Vladimir,5,0,34,29
1657125295162,MATH 193A,A03,083781,Rotar; Vladimir,1,0,34,33
1657125295162,MATH 193A,A04,083782,Rotar; Vladimir,6,0,34,28
1657125295162,MATH 193A,A05,093482,Rotar; Vladimir,6,0,34,28
1657125301185,MATH 197,001,091859,McAuley; Julian John,9999,0,9999,0
1657125301185,MATH 197,002,095566,Kedlaya; Kiran S.,9997,0,9999,2
1657125301185,MATH 197,003,095567,Xiao; Ming,9999,0,9999,0
1657125301185,MATH 197,004,095571,Perols; Johan Lars,9998,0,9999,1
1657125308251,COGS 9,A01,083615,Shannon; Kyle Michael,7,0,75,68
1657125314276,COGS 11,A01,083617,Boyle; Mary E. T.,21,0,48,27
1657125320311,COGS 13,A01,083071,Bastos; Amalia Pinkusfeld,9,0,71,62
1657125326338,COGS 14A,A01,092681,Semenuks; Arturs,1,1,100,99
1657125332361,COGS 14B,A01,083073,Cheng; Tzu-Han,6,0,63,57
1657125338384,COGS 17,A01,092677,Semenuks; Arturs,4,0,81,77
1657125344406,COGS 100,A01,083619,Allen; Michael Gordon,15,0,70,55
1657125350433,COGS 101A,A01,083621,Davis; Joshua Daniel,9,0,68,59
1657125356466,COGS 101B,A01,091572,Allen; Michael Gordon,8,0,65,57
1657125362493,COGS 101C,A01,083625,Delgado; Tania,17,0,35,18
1657125368518,COGS 107A,A01,083627,Boyle; Mary E. T.,13,0,60,47
1657125374543,COGS 118A,A01,083075,Gupta; Anjum,15,0,76,61
1657125380567,CSE 3,A50,083646,Miranda; Gregory Joseph,23,0,50,27
1657125386590,CSE 8A,A50,083650,Miranda; Gregory Joseph,17,1,56,39
1657125392619,CSE 11,A01,083080,Cao; Yingjun,4,15,40,36
1657125398646,CSE 12,A01,083652,Krause-Levy; Sophia Louisa,23,1,120,97
1657125404673,CSE 15L,A01,083654,Morris; Justin Loren,9,0,50,41
1657125404673,CSE 15L,A02,083655,Morris; Justin Loren,9,0,50,41
1657125410699,CSE 20,A01,083657,Tran; Khoa Dang,37,0,80,43
1657125416722,CSE 21,A01,095574,Bach; Quang Tran,21,0,48,27
1657125422760,CSE 30,A01,083084,Eldon; John,4,0,80,76
1657125422760,CSE 30,B01,095061,Bhaskar; Nishant,6,0,50,44
1657125428790,CSE 100,A01,083659,Cao; Yingjun,4,4,70,66
1657125434816,CSE 134B,A01,083661,Powell; Thomas Allan,19,0,100,81
1657125440837,CSE 140,A01,083663,Gungor; Onat,13,0,85,72
1657125446861,CSE 140L,A01,083088,Eldon; John,17,0,100,83
1657125462722,CSE 175,A01,083665,Kumar; Rakesh,3,0,25,22
1657125468755,CSE 190,A00,092507,Dubnov; Shlomo,7,0,20,13
1657125474782,ECE 45,A01,083139,Congero; Spencer William,5,0,75,70
1657125480807,ECE 65,A50,083695,Saad; Andrew S,12,0,30,18
1657125480807,ECE 65,A51,095125,Saad; Andrew S,25,0,26,1
1657125486835,ECE 109,A01,091882,Touri; Behrouz,16,0,70,54
1657125492858,ECE 180,A00,083140,Abi Samra; Nicholas Camill,1,0,30,29
1657125492858,ECE 180,B00,083141,Abi Samra; Nicholas Camill,0,0,30,30
1657125498890,MATH 10A,A01,083735,Patchell; Gregory David,1,0,30,29
1657125498890,MATH 10A,A02,083736,Patchell; Gregory David,20,0,30,10
1657125498890,MATH 10A,A03,083737,Patchell; Gregory David,16,0,30,14
1657125504918,MATH 10B,A01,083207,Lim; Seonhee,7,0,34,27
1657125504918,MATH 10B,A02,083208,Lim; Seonhee,9,0,35,26
1657125504918,MATH 10B,A03,093472,Lim; Seonhee,5,0,34,29
1657125504918,MATH 10B,B01,083739,Sinha; Shubham,9,0,30,21
1657125510942,MATH 18,A01,083743,Cinel; Cameron Alexander,6,0,30,24
1657125510942,MATH 18,A02,083744,Cinel; Cameron Alexander,15,0,30,15
1657125510942,MATH 18,A03,083745,Cinel; Cameron Alexander,8,0,30,22
1657125510942,MATH 18,B01,083748,Rideout; David Porter,4,0,37,33
1657125510942,MATH 18,B02,083749,Rideout; David Porter,3,0,36,33
1657125510942,MATH 18,B03,083750,Rideout; David Porter,2,0,37,35
1657125510942,MATH 18,B04,083751,Rideout; David Porter,5,0,36,31
1657125510942,MATH 18,B05,093473,Rideout; David Porter,4,0,36,32
1657125510942,MATH 18,B06,093474,Rideout; David Porter,5,0,36,31
1657125516965,MATH 20A,A01,083754,Zheng; Zequn,12,0,40,28
1657125522994,MATH 20B,A01,083756,Briones; Jor-el Thomas Caparas,1,0,36,35
1657125522994,MATH 20B,A02,083757,Briones; Jor-el Thomas Caparas,1,0,36,35
1657125522994,MATH 20B,A03,093475,Briones; Jor-el Thomas Caparas,0,0,36,36
1657125529023,MATH 20C,A01,083760,Briones; Jor-el Thomas Caparas,1,0,35,34
1657125529023,MATH 20C,A02,083761,Briones; Jor-el Thomas Caparas,8,0,35,27
1657125529023,MATH 20C,A03,093476,Briones; Jor-el Thomas Caparas,0,1,36,36
1657125529023,MATH 20C,B01,083762,Bach; Quang Tran,0,0,30,30
1657125535055,MATH 20D,A01,083765,Tran; Brian Kha,4,0,30,26
1657125535055,MATH 20D,A02,083766,Tran; Brian Kha,5,0,30,25
1657125535055,MATH 20D,A03,083767,Tran; Brian Kha,3,0,30,27
1657125541082,MATH 20E,A01,083771,Ganguly; Soumya,6,0,32,26
1657125541082,MATH 20E,A02,083772,Ganguly; Soumya,6,0,32,26
1657125541082,MATH 20E,B01,083773,Ciotti; Benjamin,18,0,35,17
1657125541082,MATH 20E,B02,083774,Ciotti; Benjamin,17,0,35,18
1657125547107,MATH 103A,A01,083777,Greenfeld; Be'Eri,2,0,36,34
1657125547107,MATH 103A,A02,083778,Greenfeld; Be'Eri,5,0,36,31
1657125547107,MATH 103A,A03,093561,Greenfeld; Be'Eri,4,0,36,32
1657125547107,MATH 103A,B01,083779,Greenfeld; Be'Eri,6,0,36,30
1657125547107,MATH 103A,B02,083780,Greenfeld; Be'Eri,3,0,36,33
1657125547107,MATH 103A,B03,093562,Greenfeld; Be'Eri,3,0,36,33
1657125553129,MATH 105,A01,085443,Carter; Anne Toulson,14,0,35,21
1657125553129,MATH 105,A02,093477,Carter; Anne Toulson,20,0,35,15
1657125559154,MATH 109,A01,083213,Ganzberger; Geoffrey Michael,2,0,34,32
1657125559154,MATH 109,A02,083214,Ganzberger; Geoffrey Michael,3,0,34,31
1657125559154,MATH 109,A03,093478,Ganzberger; Geoffrey Michael,1,0,34,33
1657125559154,MATH 109,B01,083215,Ganzberger; Geoffrey Michael,1,0,32,31
1657125559154,MATH 109,B02,083216,Ganzberger; Geoffrey Michael,1,0,32,31
1657125559154,MATH 109,B03,093479,Ganzberger; Geoffrey Michael,6,0,32,26
1657125565177,MATH 142A,A01,083219,Chow; Bennett,6,0,32,26
1657125565177,MATH 142A,A02,083220,Chow; Bennett,10,0,32,22
1657125565177,MATH 142A,A03,093480,Chow; Bennett,7,0,32,25
1657125565177,MATH 142A,B03,093481,Chow; Bennett,8,0,32,24
1657125565177,MATH 142A,B04,093558,Chow; Bennett,11,0,32,21
1657125565177,MATH 142A,B05,093559,Chow; Bennett,6,0,32,26
1657125571202,MATH 193A,A01,083224,Rotar; Vladimir,7,0,34,27
1657125571202,MATH 193A,A02,083225,Rotar; Vladimir,5,0,34,29
1657125571202,MATH 193A,A03,083781,Rotar; Vladimir,1,0,34,33
1657125571202,MATH 193A,A04,083782,Rotar; Vladimir,6,0,34,28
1657125571202,MATH 193A,A05,093482,Rotar; Vladimir,6,0,34,28
1657125577225,MATH 197,001,091859,McAuley; Julian John,9999,0,9999,0
1657125577225,MATH 197,002,095566,Kedlaya; Kiran S.,9997,0,9999,2
1657125577225,MATH 197,003,095567,Xiao; Ming,9999,0,9999,0
1657125577225,MATH 197,004,095571,Perols; Johan Lars,9998,0,9999,1
1657125584293,COGS 9,A01,083615,Shannon; Kyle Michael,7,0,75,68
1657125590318,COGS 11,A01,083617,Boyle; Mary E. T.,21,0,48,27
1657125596349,COGS 13,A01,083071,Bastos; Amalia Pinkusfeld,9,0,71,62
1657125602377,COGS 14A,A01,092681,Semenuks; Arturs,1,1,100,99
1657125608403,COGS 14B,A01,083073,Cheng; Tzu-Han,6,0,63,57
1657125614437,COGS 17,A01,092677,Semenuks; Arturs,4,0,81,77
1657125620460,COGS 100,A01,083619,Allen; Michael Gordon,15,0,70,55
1657125626488,COGS 101A,A01,083621,Davis; Joshua Daniel,9,0,68,59
1657125632511,COGS 101B,A01,091572,Allen; Michael Gordon,8,0,65,57
1657125638535,COGS 101C,A01,083625,Delgado; Tania,17,0,35,18
1657125644558,COGS 107A,A01,083627,Boyle; Mary E. T.,13,0,60,47
1657125650589,COGS 118A,A01,083075,Gupta; Anjum,15,0,76,61
1657125656611,CSE 3,A50,083646,Miranda; Gregory Joseph,23,0,50,27
1657125662633,CSE 8A,A50,083650,Miranda; Gregory Joseph,17,1,56,39
1657125668660,CSE 11,A01,083080,Cao; Yingjun,4,15,40,36
1657125674691,CSE 12,A01,083652,Krause-Levy; Sophia Louisa,23,1,120,97
1657125680720,CSE 15L,A01,083654,Morris; Justin Loren,9,0,50,41
1657125680720,CSE 15L,A02,083655,Morris; Justin Loren,9,0,50,41
1657125686744,CSE 20,A01,083657,Tran; Khoa Dang,37,0,80,43
1657125692773,CSE 21,A01,095574,Bach; Quang Tran,21,0,48,27
1657125698803,CSE 30,A01,083084,Eldon; John,4,0,80,76
1657125698803,CSE 30,B01,095061,Bhaskar; Nishant,6,0,50,44
1657125704827,CSE 100,A01,083659,Cao; Yingjun,4,4,70,66
1657125710853,CSE 134B,A01,083661,Powell; Thomas Allan,19,0,100,81
1657125716877,CSE 140,A01,083663,Gungor; Onat,13,0,85,72
1657125722903,CSE 140L,A01,083088,Eldon; John,17,0,100,83
1657125728927,CSE 175,A01,083665,Kumar; Rakesh,3,0,25,22
1657125734954,CSE 190,A00,092507,Dubnov; Shlomo,7,0,20,13
1657125740983,ECE 45,A01,083139,Congero; Spencer William,5,0,75,70
1657125747008,ECE 65,A50,083695,Saad; Andrew S,12,0,30,18
1657125747008,ECE 65,A51,095125,Saad; Andrew S,25,0,26,1
1657125753034,ECE 109,A01,091882,Touri; Behrouz,16,0,70,54
1657125759060,ECE 180,A00,083140,Abi Samra; Nicholas Camill,1,0,30,29
1657125759060,ECE 180,B00,083141,Abi Samra; Nicholas Camill,0,0,30,30
1657125765090,MATH 10A,A01,083735,Patchell; Gregory David,1,0,30,29
1657125765090,MATH 10A,A02,083736,Patchell; Gregory David,20,0,30,10
1657125765090,MATH 10A,A03,083737,Patchell; Gregory David,16,0,30,14
1657125771130,MATH 10B,A01,083207,Lim; Seonhee,7,0,34,27
1657125771130,MATH 10B,A02,083208,Lim; Seonhee,9,0,35,26
1657125771130,MATH 10B,A03,093472,Lim; Seonhee,5,0,34,29
1657125771130,MATH 10B,B01,083739,Sinha; Shubham,9,0,30,21
1657125777172,MATH 18,A01,083743,Cinel; Cameron Alexander,6,0,30,24
1657125777172,MATH 18,A02,083744,Cinel; Cameron Alexander,15,0,30,15
1657125777172,MATH 18,A03,083745,Cinel; Cameron Alexander,8,0,30,22
1657125777172,MATH 18,B01,083748,Rideout; David Porter,4,0,37,33
1657125777172,MATH 18,B02,083749,Rideout; David Porter,3,0,36,33
1657125777172,MATH 18,B03,083750,Rideout; David Porter,2,0,37,35
1657125777172,MATH 18,B04,083751,Rideout; David Porter,5,0,36,31
1657125777172,MATH 18,B05,093473,Rideout; David Porter,4,0,36,32
1657125777172,MATH 18,B06,093474,Rideout; David Porter,5,0,36,31
1657125783198,MATH 20A,A01,083754,Zheng; Zequn,12,0,40,28
1657125789220,MATH 20B,A01,083756,Briones; Jor-el Thomas Caparas,1,0,36,35
1657125789220,MATH 20B,A02,083757,Briones; Jor-el Thomas Caparas,1,0,36,35
1657125789220,MATH 20B,A03,093475,Briones; Jor-el Thomas Caparas,0,0,36,36
1657125795250,MATH 20C,A01,083760,Briones; Jor-el Thomas Caparas,1,0,35,34
1657125795250,MATH 20C,A02,083761,Briones; Jor-el Thomas Caparas,8,0,35,27
1657125795250,MATH 20C,A03,093476,Briones; Jor-el Thomas Caparas,0,1,36,36
1657125795250,MATH 20C,B01,083762,Bach; Quang Tran,0,0,30,30
1657125801272,MATH 20D,A01,083765,Tran; Brian Kha,4,0,30,26
1657125801272,MATH 20D,A02,083766,Tran; Brian Kha,5,0,30,25
1657125801272,MATH 20D,A03,083767,Tran; Brian Kha,3,0,30,27
1657125807301,MATH 20E,A01,083771,Ganguly; Soumya,6,0,32,26
1657125807301,MATH 20E,A02,083772,Ganguly; Soumya,6,0,32,26
1657125807301,MATH 20E,B01,083773,Ciotti; Benjamin,18,0,35,17
1657125807301,MATH 20E,B02,083774,Ciotti; Benjamin,17,0,35,18
1657125813325,MATH 103A,A01,083777,Greenfeld; Be'Eri,2,0,36,34
1657125813325,MATH 103A,A02,083778,Greenfeld; Be'Eri,5,0,36,31
1657125813325,MATH 103A,A03,093561,Greenfeld; Be'Eri,4,0,36,32
1657125813325,MATH 103A,B01,083779,Greenfeld; Be'Eri,6,0,36,30
1657125813325,MATH 103A,B02,083780,Greenfeld; Be'Eri,3,0,36,33
1657125813325,MATH 103A,B03,093562,Greenfeld; Be'Eri,3,0,36,33
1657125819382,MATH 105,A01,085443,Carter; Anne Toulson,14,0,35,21
1657125819382,MATH 105,A02,093477,Carter; Anne Toulson,20,0,35,15
1657125825411,MATH 109,A01,083213,Ganzberger; Geoffrey Michael,2,0,34,32
1657125825411,MATH 109,A02,083214,Ganzberger; Geoffrey Michael,3,0,34,31
1657125825411,MATH 109,A03,093478,Ganzberger; Geoffrey Michael,1,0,34,33
1657125825411,MATH 109,B01,083215,Ganzberger; Geoffrey Michael,1,0,32,31
1657125825411,MATH 109,B02,083216,Ganzberger; Geoffrey Michael,1,0,32,31
1657125825411,MATH 109,B03,093479,Ganzberger; Geoffrey Michael,6,0,32,26
1657125831453,MATH 142A,A01,083219,Chow; Bennett,6,0,32,26
1657125831453,MATH 142A,A02,083220,Chow; Bennett,10,0,32,22
1657125831453,MATH 142A,A03,093480,Chow; Bennett,7,0,32,25
1657125831453,MATH 142A,B03,093481,Chow; Bennett,8,0,32,24
1657125831453,MATH 142A,B04,093558,Chow; Bennett,11,0,32,21
1657125831453,MATH 142A,B05,093559,Chow; Bennett,6,0,32,26
1657125837481,MATH 193A,A01,083224,Rotar; Vladimir,7,0,34,27
1657125837481,MATH 193A,A02,083225,Rotar; Vladimir,5,0,34,29
1657125837481,MATH 193A,A03,083781,Rotar; Vladimir,1,0,34,33
1657125837481,MATH 193A,A04,083782,Rotar; Vladimir,6,0,34,28
1657125837481,MATH 193A,A05,093482,Rotar; Vladimir,6,0,34,28
1657125843511,MATH 197,001,091859,McAuley; Julian John,9999,0,9999,0
1657125843511,MATH 197,002,095566,Kedlaya; Kiran S.,9997,0,9999,2
1657125843511,MATH 197,003,095567,Xiao; Ming,9999,0,9999,0
1657125843511,MATH 197,004,095571,Perols; Johan Lars,9998,0,9999,1
1657125850638,COGS 9,A01,083615,Shannon; Kyle Michael,7,0,75,68
1657125856660,COGS 11,A01,083617,Boyle; Mary E. T.,21,0,48,27
1657125862691,COGS 13,A01,083071,Bastos; Amalia Pinkusfeld,9,0,71,62
1657125868720,COGS 14A,A01,092681,Semenuks; Arturs,1,1,100,99
1657125874749,COGS 14B,A01,083073,Cheng; Tzu-Han,6,0,63,57
1657125880773,COGS 17,A01,092677,Semenuks; Arturs,4,0,81,77
1657125886800,COGS 100,A01,083619,Allen; Michael Gordon,15,0,70,55
1657125892834,COGS 101A,A01,083621,Davis; Joshua Daniel,9,0,68,59
1657125898861,COGS 101B,A01,091572,Allen; Michael Gordon,8,0,65,57
1657125904882,COGS 101C,A01,083625,Delgado; Tania,17,0,35,18
1657125910905,COGS 107A,A01,083627,Boyle; Mary E. T.,13,0,60,47
1657125916931,COGS 118A,A01,083075,Gupta; Anjum,15,0,76,61
1657125922957,CSE 3,A50,083646,Miranda; Gregory Joseph,23,0,50,27
1657125928988,CSE 8A,A50,083650,Miranda; Gregory Joseph,17,1,56,39
1657125935017,CSE 11,A01,083080,Cao; Yingjun,4,15,40,36
1657125941049,CSE 12,A01,083652,Krause-Levy; Sophia Louisa,23,1,120,97
1657125947076,CSE 15L,A01,083654,Morris; Justin Loren,9,0,50,41
1657125947076,CSE 15L,A02,083655,Morris; Justin Loren,9,0,50,41
1657125953106,CSE 20,A01,083657,Tran; Khoa Dang,37,0,80,43
1657125959137,CSE 21,A01,095574,Bach; Quang Tran,21,0,48,27
1657125965165,CSE 30,A01,083084,Eldon; John,4,0,80,76
1657125965165,CSE 30,B01,095061,Bhaskar; Nishant,6,0,50,44
1657125971189,CSE 100,A01,083659,Cao; Yingjun,4,4,70,66
1657125977212,CSE 134B,A01,083661,Powell; Thomas Allan,19,0,100,81
1657125983240,CSE 140,A01,083663,Gungor; Onat,13,0,85,72
1657125989266,CSE 140L,A01,083088,Eldon; John,17,0,100,83
1657125995290,CSE 175,A01,083665,Kumar; Rakesh,3,0,25,22
1657126001324,CSE 190,A00,092507,Dubnov; Shlomo,7,0,20,13
1657126007350,ECE 45,A01,083139,Congero; Spencer William,5,0,75,70
1657126013382,ECE 65,A50,083695,Saad; Andrew S,12,0,30,18
1657126013382,ECE 65,A51,095125,Saad; Andrew S,25,0,26,1
1657126019406,ECE 109,A01,091882,Touri; Behrouz,16,0,70,54
1657126025436,ECE 180,A00,083140,Abi Samra; Nicholas Camill,1,0,30,29
1657126025436,ECE 180,B00,083141,Abi Samra; Nicholas Camill,0,0,30,30
1657126031471,MATH 10A,A01,083735,Patchell; Gregory David,1,0,30,29
1657126031471,MATH 10A,A02,083736,Patchell; Gregory David,20,0,30,10
1657126031471,MATH 10A,A03,083737,Patchell; Gregory David,16,0,30,14
1657126037496,MATH 10B,A01,083207,Lim; Seonhee,7,0,34,27
1657126037496,MATH 10B,A02,083208,Lim; Seonhee,9,0,35,26
1657126037496,MATH 10B,A03,093472,Lim; Seonhee,5,0,34,29
1657126037496,MATH 10B,B01,083739,Sinha; Shubham,9,0,30,21
1657126043521,MATH 18,A01,083743,Cinel; Cameron Alexander,6,0,30,24
1657126043521,MATH 18,A02,083744,Cinel; Cameron Alexander,15,0,30,15
1657126043521,MATH 18,A03,083745,Cinel; Cameron Alexander,8,0,30,22
1657126043521,MATH 18,B01,083748,Rideout; David Porter,4,0,37,33
1657126043521,MATH 18,B02,083749,Rideout; David Porter,3,0,36,33
1657126043521,MATH 18,B03,083750,Rideout; David Porter,2,0,37,35
1657126043521,MATH 18,B04,083751,Rideout; David Porter,5,0,36,31
1657126043521,MATH 18,B05,093473,Rideout; David Porter,4,0,36,32
1657126043521,MATH 18,B06,093474,Rideout; David Porter,5,0,36,31
1657126049544,MATH 20A,A01,083754,Zheng; Zequn,12,0,40,28
1657126055571,MATH 20B,A01,083756,Briones; Jor-el Thomas Caparas,1,0,36,35
1657126055571,MATH 20B,A02,083757,Briones; Jor-el Thomas Caparas,1,0,36,35
1657126055571,MATH 20B,A03,093475,Briones; Jor-el Thomas Caparas,0,0,36,36
1657126061600,MATH 20C,A01,083760,Briones; Jor-el Thomas Caparas,1,0,35,34
1657126061600,MATH 20C,A02,083761,Briones; Jor-el Thomas Caparas,8,0,35,27
1657126061600,MATH 20C,A03,093476,Briones; Jor-el Thomas Caparas,0,1,36,36
1657126061600,MATH 20C,B01,083762,Bach; Quang Tran,0,0,30,30
1657126067622,MATH 20D,A01,083765,Tran; Brian Kha,4,0,30,26
1657126067622,MATH 20D,A02,083766,Tran; Brian Kha,5,0,30,25
1657126067622,MATH 20D,A03,083767,Tran; Brian Kha,3,0,30,27
1657126073671,MATH 20E,A01,083771,Ganguly; Soumya,6,0,32,26
1657126073671,MATH 20E,A02,083772,Ganguly; Soumya,6,0,32,26
1657126073671,MATH 20E,B01,083773,Ciotti; Benjamin,18,0,35,17
1657126073671,MATH 20E,B02,083774,Ciotti; Benjamin,17,0,35,18
1657126079694,MATH 103A,A01,083777,Greenfeld; Be'Eri,2,0,36,34
1657126079694,MATH 103A,A02,083778,Greenfeld; Be'Eri,5,0,36,31
1657126079694,MATH 103A,A03,093561,Greenfeld; Be'Eri,4,0,36,32
1657126079694,MATH 103A,B01,083779,Greenfeld; Be'Eri,6,0,36,30
1657126079694,MATH 103A,B02,083780,Greenfeld; Be'Eri,3,0,36,33
1657126079694,MATH 103A,B03,093562,Greenfeld; Be'Eri,3,0,36,33
1657126085729,MATH 105,A01,085443,Carter; Anne Toulson,14,0,35,21
1657126085729,MATH 105,A02,093477,Carter; Anne Toulson,20,0,35,15
1657126091755,MATH 109,A01,083213,Ganzberger; Geoffrey Michael,2,0,34,32
1657126091755,MATH 109,A02,083214,Ganzberger; Geoffrey Michael,3,0,34,31
1657126091755,MATH 109,A03,093478,Ganzberger; Geoffrey Michael,1,0,34,33
1657126091755,MATH 109,B01,083215,Ganzberger; Geoffrey Michael,1,0,32,31
1657126091755,MATH 109,B02,083216,Ganzberger; Geoffrey Michael,1,0,32,31
1657126091755,MATH 109,B03,093479,Ganzberger; Geoffrey Michael,6,0,32,26
1657126097801,MATH 142A,A01,083219,Chow; Bennett,6,0,32,26
1657126097801,MATH 142A,A02,083220,Chow; Bennett,10,0,32,22
1657126097801,MATH 142A,A03,093480,Chow; Bennett,7,0,32,25
1657126097801,MATH 142A,B03,093481,Chow; Bennett,8,0,32,24
1657126097801,MATH 142A,B04,093558,Chow; Bennett,11,0,32,21
1657126097801,MATH 142A,B05,093559,Chow; Bennett,6,0,32,26
1657126103824,MATH 193A,A01,083224,Rotar; Vladimir,7,0,34,27
1657126103824,MATH 193A,A02,083225,Rotar; Vladimir,5,0,34,29
1657126103824,MATH 193A,A03,083781,Rotar; Vladimir,1,0,34,33
1657126103824,MATH 193A,A04,083782,Rotar; Vladimir,6,0,34,28
1657126103824,MATH 193A,A05,093482,Rotar; Vladimir,6,0,34,28
1657126109847,MATH 197,001,091859,McAuley; Julian John,9999,0,9999,0
1657126109847,MATH 197,002,095566,Kedlaya; Kiran S.,9997,0,9999,2
1657126109847,MATH 197,003,095567,Xiao; Ming,9999,0,9999,0
1657126109847,MATH 197,004,095571,Perols; Johan Lars,9998,0,9999,1
1657126116901,COGS 9,A01,083615,Shannon; Kyle Michael,7,0,75,68
1657126122925,COGS 11,A01,083617,Boyle; Mary E. T.,21,0,48,27
1657126128948,COGS 13,A01,083071,Bastos; Amalia Pinkusfeld,9,0,71,62
1657126134974,COGS 14A,A01,092681,Semenuks; Arturs,1,1,100,99
1657126141002,COGS 14B,A01,083073,Cheng; Tzu-Han,6,0,63,57
1657126147025,COGS 17,A01,092677,Semenuks; Arturs,4,0,81,77
1657126153050,COGS 100,A01,083619,Allen; Michael Gordon,15,0,70,55
1657126159072,COGS 101A,A01,083621,Davis; Joshua Daniel,9,0,68,59
1657126165094,COGS 101B,A01,091572,Allen; Michael Gordon,8,0,65,57
1657126171123,COGS 101C,A01,083625,Delgado; Tania,17,0,35,18
1657126177151,COGS 107A,A01,083627,Boyle; Mary E. T.,13,0,60,47
1657126183181,COGS 118A,A01,083075,Gupta; Anjum,15,0,76,61
1657126189205,CSE 3,A50,083646,Miranda; Gregory Joseph,23,0,50,27
1657126195229,CSE 8A,A50,083650,Miranda; Gregory Joseph,17,1,56,39
1657126201256,CSE 11,A01,083080,Cao; Yingjun,4,15,40,36
1657126207278,CSE 12,A01,083652,Krause-Levy; Sophia Louisa,23,1,120,97
1657126213304,CSE 15L,A01,083654,Morris; Justin Loren,9,0,50,41
1657126213304,CSE 15L,A02,083655,Morris; Justin Loren,9,0,50,41
1657126219327,CSE 20,A01,083657,Tran; Khoa Dang,37,0,80,43
1657126225351,CSE 21,A01,095574,Bach; Quang Tran,21,0,48,27
1657126231390,CSE 30,A01,083084,Eldon; John,4,0,80,76
1657126231390,CSE 30,B01,095061,Bhaskar; Nishant,6,0,50,44
1657126237412,CSE 100,A01,083659,Cao; Yingjun,4,4,70,66
1657126243441,CSE 134B,A01,083661,Powell; Thomas Allan,20,0,100,80
1657126249468,CSE 140,A01,083663,Gungor; Onat,13,0,85,72
1657126255494,CSE 140L,A01,083088,Eldon; John,17,0,100,83
1657126261523,CSE 175,A01,083665,Kumar; Rakesh,3,0,25,22
1657126267545,CSE 190,A00,092507,Dubnov; Shlomo,7,0,20,13
1657126273572,ECE 45,A01,083139,Congero; Spencer William,5,0,75,70
1657126279594,ECE 65,A50,083695,Saad; Andrew S,12,0,30,18
1657126279594,ECE 65,A51,095125,Saad; Andrew S,25,0,26,1
1657126285617,ECE 109,A01,091882,Touri; Behrouz,17,0,70,53
1657126291640,ECE 180,A00,083140,Abi Samra; Nicholas Camill,1,0,30,29
1657126291640,ECE 180,B00,083141,Abi Samra; Nicholas Camill,0,0,30,30
1657126297677,MATH 10A,A01,083735,Patchell; Gregory David,1,0,30,29
1657126297677,MATH 10A,A02,083736,Patchell; Gregory David,20,0,30,10
1657126297677,MATH 10A,A03,083737,Patchell; Gregory David,16,0,30,14
1657126303706,MATH 10B,A01,083207,Lim; Seonhee,7,0,34,27
1657126303706,MATH 10B,A02,083208,Lim; Seonhee,9,0,35,26
1657126303706,MATH 10B,A03,093472,Lim; Seonhee,5,0,34,29
1657126303706,MATH 10B,B01,083739,Sinha; Shubham,9,0,30,21
1657126309735,MATH 18,A01,083743,Cinel; Cameron Alexander,6,0,30,24
1657126309735,MATH 18,A02,083744,Cinel; Cameron Alexander,15,0,30,15
1657126309735,MATH 18,A03,083745,Cinel; Cameron Alexander,8,0,30,22
1657126309735,MATH 18,B01,083748,Rideout; David Porter,4,0,37,33
1657126309735,MATH 18,B02,083749,Rideout; David Porter,3,0,36,33
1657126309735,MATH 18,B03,083750,Rideout; David Porter,2,0,37,35
1657126309735,MATH 18,B04,083751,Rideout; David Porter,5,0,36,31
1657126309735,MATH 18,B05,093473,Rideout; David Porter,4,0,36,32
1657126309735,MATH 18,B06,093474,Rideout; David Porter,5,0,36,31
1657126315757,MATH 20A,A01,083754,Zheng; Zequn,12,0,40,28
1657126321794,MATH 20B,A01,083756,Briones; Jor-el Thomas Caparas,1,0,36,35
1657126321794,MATH 20B,A02,083757,Briones; Jor-el Thomas Caparas,1,0,36,35
1657126321794,MATH 20B,A03,093475,Briones; Jor-el Thomas Caparas,0,0,36,36
1657126327815,MATH 20C,A01,083760,Briones; Jor-el Thomas Caparas,1,0,35,34
1657126327815,MATH 20C,A02,083761,Briones; Jor-el Thomas Caparas,8,0,35,27
1657126327815,MATH 20C,A03,093476,Briones; Jor-el Thomas Caparas,0,1,36,36
1657126327815,MATH 20C,B01,083762,Bach; Quang Tran,0,0,30,30
1657126333840,MATH 20D,A01,083765,Tran; Brian Kha,4,0,30,26
1657126333840,MATH 20D,A02,083766,Tran; Brian Kha,5,0,30,25
1657126333840,MATH 20D,A03,083767,Tran; Brian Kha,3,0,30,27
1657126339864,MATH 20E,A01,083771,Ganguly; Soumya,6,0,32,26
1657126339864,MATH 20E,A02,083772,Ganguly; Soumya,6,0,32,26
1657126339864,MATH 20E,B01,083773,Ciotti; Benjamin,18,0,35,17
1657126339864,MATH 20E,B02,083774,Ciotti; Benjamin,17,0,35,18
1657126345894,MATH 103A,A01,083777,Greenfeld; Be'Eri,2,0,36,34
1657126345894,MATH 103A,A02,083778,Greenfeld; Be'Eri,5,0,36,31
1657126345894,MATH 103A,A03,093561,Greenfeld; Be'Eri,4,0,36,32
1657126345894,MATH 103A,B01,083779,Greenfeld; Be'Eri,6,0,36,30
1657126345894,MATH 103A,B02,083780,Greenfeld; Be'Eri,3,0,36,33
1657126345894,MATH 103A,B03,093562,Greenfeld; Be'Eri,3,0,36,33
1657126351921,MATH 105,A01,085443,Carter; Anne Toulson,14,0,35,21
1657126351921,MATH 105,A02,093477,Carter; Anne Toulson,20,0,35,15
1657126357950,MATH 109,A01,083213,Ganzberger; Geoffrey Michael,2,0,34,32
1657126357950,MATH 109,A02,083214,Ganzberger; Geoffrey Michael,3,0,34,31
1657126357950,MATH 109,A03,093478,Ganzberger; Geoffrey Michael,1,0,34,33
1657126357950,MATH 109,B01,083215,Ganzberger; Geoffrey Michael,1,0,32,31
1657126357950,MATH 109,B02,083216,Ganzberger; Geoffrey Michael,1,0,32,31
1657126357950,MATH 109,B03,093479,Ganzberger; Geoffrey Michael,6,0,32,26
1657126363973,MATH 142A,A01,083219,Chow; Bennett,6,0,32,26
1657126363973,MATH 142A,A02,083220,Chow; Bennett,10,0,32,22
1657126363973,MATH 142A,A03,093480,Chow; Bennett,7,0,32,25
1657126363973,MATH 142A,B03,093481,Chow; Bennett,8,0,32,24
1657126363973,MATH 142A,B04,093558,Chow; Bennett,11,0,32,21
1657126363973,MATH 142A,B05,093559,Chow; Bennett,6,0,32,26
1657126369999,MATH 193A,A01,083224,Rotar; Vladimir,7,0,34,27
1657126369999,MATH 193A,A02,083225,Rotar; Vladimir,5,0,34,29
1657126369999,MATH 193A,A03,083781,Rotar; Vladimir,1,0,34,33
1657126369999,MATH 193A,A04,083782,Rotar; Vladimir,6,0,34,28
1657126369999,MATH 193A,A05,093482,Rotar; Vladimir,6,0,34,28
1657126376025,MATH 197,001,091859,McAuley; Julian John,9999,0,9999,0
1657126376025,MATH 197,002,095566,Kedlaya; Kiran S.,9997,0,9999,2
1657126376025,MATH 197,003,095567,Xiao; Ming,9999,0,9999,0
1657126376025,MATH 197,004,095571,Perols; Johan Lars,9998,0,9999,1
1657126383095,COGS 9,A01,083615,Shannon; Kyle Michael,7,0,75,68
1657126389131,COGS 11,A01,083617,Boyle; Mary E. T.,21,0,48,27
1657126395160,COGS 13,A01,083071,Bastos; Amalia Pinkusfeld,9,0,71,62
1657126401183,COGS 14A,A01,092681,Semenuks; Arturs,1,1,100,99
1657126407209,COGS 14B,A01,083073,Cheng; Tzu-Han,6,0,63,57
1657126413242,COGS 17,A01,092677,Semenuks; Arturs,4,0,81,77
1657126419277,COGS 100,A01,083619,Allen; Michael Gordon,15,0,70,55
1657126425306,COGS 101A,A01,083621,Davis; Joshua Daniel,9,0,68,59
1657126431328,COGS 101B,A01,091572,Allen; Michael Gordon,8,0,65,57
1657126437363,COGS 101C,A01,083625,Delgado; Tania,17,0,35,18
1657126443479,COGS 107A,A01,083627,Boyle; Mary E. T.,13,0,60,47
1657126449505,COGS 118A,A01,083075,Gupta; Anjum,15,0,76,61
1657126455534,CSE 3,A50,083646,Miranda; Gregory Joseph,23,0,50,27
1657126461557,CSE 8A,A50,083650,Miranda; Gregory Joseph,17,1,56,39
1657126467582,CSE 11,A01,083080,Cao; Yingjun,4,15,40,36
1657126473605,CSE 12,A01,083652,Krause-Levy; Sophia Louisa,23,1,120,97
1657126479632,CSE 15L,A01,083654,Morris; Justin Loren,9,0,50,41
1657126479632,CSE 15L,A02,083655,Morris; Justin Loren,9,0,50,41
1657126485658,CSE 20,A01,083657,Tran; Khoa Dang,37,0,80,43
1657126491690,CSE 21,A01,095574,Bach; Quang Tran,21,0,48,27
1657126497724,CSE 30,A01,083084,Eldon; John,4,0,80,76
1657126497724,CSE 30,B01,095061,Bhaskar; Nishant,6,0,50,44
1657126503746,CSE 100,A01,083659,Cao; Yingjun,4,4,70,66
1657126509770,CSE 134B,A01,083661,Powell; Thomas Allan,20,0,100,80
1657126515794,CSE 140,A01,083663,Gungor; Onat,13,0,85,72
1657126521816,CSE 140L,A01,083088,Eldon; John,17,0,100,83
1657126527841,CSE 175,A01,083665,Kumar; Rakesh,3,0,25,22
1657126533865,CSE 190,A00,092507,Dubnov; Shlomo,7,0,20,13
1657126539887,ECE 45,A01,083139,Congero; Spencer William,5,0,75,70
1657126545915,ECE 65,A50,083695,Saad; Andrew S,12,0,30,18
1657126545915,ECE 65,A51,095125,Saad; Andrew S,25,0,26,1
1657126551944,ECE 109,A01,091882,Touri; Behrouz,17,0,70,53
1657126557971,ECE 180,A00,083140,Abi Samra; Nicholas Camill,1,0,30,29
1657126557971,ECE 180,B00,083141,Abi Samra; Nicholas Camill,0,0,30,30
1657126563994,MATH 10A,A01,083735,Patchell; Gregory David,1,0,30,29
1657126563994,MATH 10A,A02,083736,Patchell; Gregory David,20,0,30,10
1657126563994,MATH 10A,A03,083737,Patchell; Gregory David,16,0,30,14
1657126570019,MATH 10B,A01,083207,Lim; Seonhee,7,0,34,27
1657126570019,MATH 10B,A02,083208,Lim; Seonhee,9,0,35,26
1657126570019,MATH 10B,A03,093472,Lim; Seonhee,5,0,34,29
1657126570019,MATH 10B,B01,083739,Sinha; Shubham,9,0,30,21
1657126576055,MATH 18,A01,083743,Cinel; Cameron Alexander,6,0,30,24
1657126576055,MATH 18,A02,083744,Cinel; Cameron Alexander,15,0,30,15
1657126576055,MATH 18,A03,083745,Cinel; Cameron Alexander,8,0,30,22
1657126576055,MATH 18,B01,083748,Rideout; David Porter,4,0,37,33
1657126576055,MATH 18,B02,083749,Rideout; David Porter,3,0,36,33
1657126576055,MATH 18,B03,083750,Rideout; David Porter,2,0,37,35
1657126576055,MATH 18,B04,083751,Rideout; David Porter,5,0,36,31
1657126576055,MATH 18,B05,093473,Rideout; David Porter,4,0,36,32
1657126576055,MATH 18,B06,093474,Rideout; David Porter,5,0,36,31
1657126582081,MATH 20A,A01,083754,Zheng; Zequn,12,0,40,28
1657126588128,MATH 20B,A01,083756,Briones; Jor-el Thomas Caparas,1,0,36,35
1657126588128,MATH 20B,A02,083757,Briones; Jor-el Thomas Caparas,1,0,36,35
1657126588128,MATH 20B,A03,093475,Briones; Jor-el Thomas Caparas,0,0,36,36
1657126594161,MATH 20C,A01,083760,Briones; Jor-el Thomas Caparas,1,0,35,34
1657126594161,MATH 20C,A02,083761,Briones; Jor-el Thomas Caparas,8,0,35,27
1657126594161,MATH 20C,A03,093476,Briones; Jor-el Thomas Caparas,0,1,36,36
1657126594161,MATH 20C,B01,083762,Bach; Quang Tran,0,0,30,30
1657126600196,MATH 20D,A01,083765,Tran; Brian Kha,4,0,30,26
1657126600196,MATH 20D,A02,083766,Tran; Brian Kha,5,0,30,25
1657126600196,MATH 20D,A03,083767,Tran; Brian Kha,3,0,30,27
1657126606221,MATH 20E,A01,083771,Ganguly; Soumya,6,0,32,26
1657126606221,MATH 20E,A02,083772,Ganguly; Soumya,6,0,32,26
1657126606221,MATH 20E,B01,083773,Ciotti; Benjamin,18,0,35,17
1657126606221,MATH 20E,B02,083774,Ciotti; Benjamin,17,0,35,18
1657126612266,MATH 103A,A01,083777,Greenfeld; Be'Eri,2,0,36,34
1657126612266,MATH 103A,A02,083778,Greenfeld; Be'Eri,5,0,36,31
1657126612266,MATH 103A,A03,093561,Greenfeld; Be'Eri,4,0,36,32
1657126612266,MATH 103A,B01,083779,Greenfeld; Be'Eri,6,0,36,30
1657126612266,MATH 103A,B02,083780,Greenfeld; Be'Eri,3,0,36,33
1657126612266,MATH 103A,B03,093562,Greenfeld; Be'Eri,3,0,36,33
1657126618296,MATH 105,A01,085443,Carter; Anne Toulson,14,0,35,21
1657126618296,MATH 105,A02,093477,Carter; Anne Toulson,20,0,35,15
1657126624325,MATH 109,A01,083213,Ganzberger; Geoffrey Michael,2,0,34,32
1657126624325,MATH 109,A02,083214,Ganzberger; Geoffrey Michael,3,0,34,31
1657126624325,MATH 109,A03,093478,Ganzberger; Geoffrey Michael,1,0,34,33
1657126624325,MATH 109,B01,083215,Ganzberger; Geoffrey Michael,1,0,32,31
1657126624325,MATH 109,B02,083216,Ganzberger; Geoffrey Michael,1,0,32,31
1657126624325,MATH 109,B03,093479,Ganzberger; Geoffrey Michael,6,0,32,26
1657126630354,MATH 142A,A01,083219,Chow; Bennett,6,0,32,26
1657126630354,MATH 142A,A02,083220,Chow; Bennett,10,0,32,22
1657126630354,MATH 142A,A03,093480,Chow; Bennett,7,0,32,25
1657126630354,MATH 142A,B03,093481,Chow; Bennett,8,0,32,24
1657126630354,MATH 142A,B04,093558,Chow; Bennett,11,0,32,21
1657126630354,MATH 142A,B05,093559,Chow; Bennett,6,0,32,26
1657126636378,MATH 193A,A01,083224,Rotar; Vladimir,7,0,34,27
1657126636378,MATH 193A,A02,083225,Rotar; Vladimir,5,0,34,29
1657126636378,MATH 193A,A03,083781,Rotar; Vladimir,1,0,34,33
1657126636378,MATH 193A,A04,083782,Rotar; Vladimir,6,0,34,28
1657126636378,MATH 193A,A05,093482,Rotar; Vladimir,6,0,34,28
1657126642401,MATH 197,001,091859,McAuley; Julian John,9999,0,9999,0
1657126642401,MATH 197,002,095566,Kedlaya; Kiran S.,9997,0,9999,2
1657126642401,MATH 197,003,095567,Xiao; Ming,9999,0,9999,0
1657126642401,MATH 197,004,095571,Perols; Johan Lars,9998,0,9999,1
1657126649465,COGS 9,A01,083615,Shannon; Kyle Michael,7,0,75,68
1657126655491,COGS 11,A01,083617,Boyle; Mary E. T.,21,0,48,27
1657126661515,COGS 13,A01,083071,Bastos; Amalia Pinkusfeld,9,0,71,62
1657126667551,COGS 14A,A01,092681,Semenuks; Arturs,1,1,100,99
1657126673589,COGS 14B,A01,083073,Cheng; Tzu-Han,6,0,63,57
1657126679614,COGS 17,A01,092677,Semenuks; Arturs,4,0,81,77
1657126685645,COGS 100,A01,083619,Allen; Michael Gordon,15,0,70,55
1657126691671,COGS 101A,A01,083621,Davis; Joshua Daniel,9,0,68,59
1657126697699,COGS 101B,A01,091572,Allen; Michael Gordon,8,0,65,57
1657126703726,COGS 101C,A01,083625,Delgado; Tania,17,0,35,18
1657126709751,COGS 107A,A01,083627,Boyle; Mary E. T.,13,0,60,47
1657126715774,COGS 118A,A01,083075,Gupta; Anjum,15,0,76,61
1657126721799,CSE 3,A50,083646,Miranda; Gregory Joseph,23,0,50,27
1657126727821,CSE 8A,A50,083650,Miranda; Gregory Joseph,17,1,56,39
1657126733844,CSE 11,A01,083080,Cao; Yingjun,4,15,40,36
1657126739873,CSE 12,A01,083652,Krause-Levy; Sophia Louisa,23,1,120,97
1657126745906,CSE 15L,A01,083654,Morris; Justin Loren,9,0,50,41
1657126745906,CSE 15L,A02,083655,Morris; Justin Loren,9,0,50,41
1657126751931,CSE 20,A01,083657,Tran; Khoa Dang,37,0,80,43
1657126757954,CSE 21,A01,095574,Bach; Quang Tran,21,0,48,27
1657126763987,CSE 30,A01,083084,Eldon; John,4,0,80,76
1657126763987,CSE 30,B01,095061,Bhaskar; Nishant,6,0,50,44
1657126770013,CSE 100,A01,083659,Cao; Yingjun,4,4,70,66
1657126776040,CSE 134B,A01,083661,Powell; Thomas Allan,20,0,100,80
1657126782063,CSE 140,A01,083663,Gungor; Onat,13,0,85,72
1657126788091,CSE 140L,A01,083088,Eldon; John,17,0,100,83
1657126794118,CSE 175,A01,083665,Kumar; Rakesh,3,0,25,22
1657126800139,CSE 190,A00,092507,Dubnov; Shlomo,7,0,20,13
1657126806167,ECE 45,A01,083139,Congero; Spencer William,5,0,75,70
1657126812193,ECE 65,A50,083695,Saad; Andrew S,12,0,30,18
1657126812193,ECE 65,A51,095125,Saad; Andrew S,25,0,26,1
1657126818214,ECE 109,A01,091882,Touri; Behrouz,17,0,70,53
1657126824238,ECE 180,A00,083140,Abi Samra; Nicholas Camill,1,0,30,29
1657126824238,ECE 180,B00,083141,Abi Samra; Nicholas Camill,0,0,30,30
1657126830272,MATH 10A,A01,083735,Patchell; Gregory David,1,0,30,29
1657126830272,MATH 10A,A02,083736,Patchell; Gregory David,20,0,30,10
1657126830272,MATH 10A,A03,083737,Patchell; Gregory David,16,0,30,14
1657126836302,MATH 10B,A01,083207,Lim; Seonhee,7,0,34,27
1657126836302,MATH 10B,A02,083208,Lim; Seonhee,9,0,35,26
1657126836302,MATH 10B,A03,093472,Lim; Seonhee,5,0,34,29
1657126836302,MATH 10B,B01,083739,Sinha; Shubham,9,0,30,21
1657126842327,MATH 18,A01,083743,Cinel; Cameron Alexander,6,0,30,24
1657126842327,MATH 18,A02,083744,Cinel; Cameron Alexander,15,0,30,15
1657126842327,MATH 18,A03,083745,Cinel; Cameron Alexander,8,0,30,22
1657126842327,MATH 18,B01,083748,Rideout; David Porter,4,0,37,33
1657126842327,MATH 18,B02,083749,Rideout; David Porter,3,0,36,33
1657126842327,MATH 18,B03,083750,Rideout; David Porter,2,0,37,35
1657126842327,MATH 18,B04,083751,Rideout; David Porter,5,0,36,31
1657126842327,MATH 18,B05,093473,Rideout; David Porter,4,0,36,32
1657126842327,MATH 18,B06,093474,Rideout; David Porter,5,0,36,31
1657126848351,MATH 20A,A01,083754,Zheng; Zequn,12,0,40,28
1657126854375,MATH 20B,A01,083756,Briones; Jor-el Thomas Caparas,1,0,36,35
1657126854375,MATH 20B,A02,083757,Briones; Jor-el Thomas Caparas,1,0,36,35
1657126854375,MATH 20B,A03,093475,Briones; Jor-el Thomas Caparas,0,0,36,36
1657126860399,MATH 20C,A01,083760,Briones; Jor-el Thomas Caparas,1,0,35,34
1657126860399,MATH 20C,A02,083761,Briones; Jor-el Thomas Caparas,8,0,35,27
1657126860399,MATH 20C,A03,093476,Briones; Jor-el Thomas Caparas,0,1,36,36
1657126860399,MATH 20C,B01,083762,Bach; Quang Tran,0,0,30,30
1657126866427,MATH 20D,A01,083765,Tran; Brian Kha,4,0,30,26
1657126866427,MATH 20D,A02,083766,Tran; Brian Kha,5,0,30,25
1657126866427,MATH 20D,A03,083767,Tran; Brian Kha,3,0,30,27
1657126872455,MATH 20E,A01,083771,Ganguly; Soumya,6,0,32,26
1657126872455,MATH 20E,A02,083772,Ganguly; Soumya,6,0,32,26
1657126872455,MATH 20E,B01,083773,Ciotti; Benjamin,18,0,35,17
1657126872455,MATH 20E,B02,083774,Ciotti; Benjamin,17,0,35,18
1657126878482,MATH 103A,A01,083777,Greenfeld; Be'Eri,2,0,36,34
1657126878482,MATH 103A,A02,083778,Greenfeld; Be'Eri,5,0,36,31
1657126878482,MATH 103A,A03,093561,Greenfeld; Be'Eri,4,0,36,32
1657126878482,MATH 103A,B01,083779,Greenfeld; Be'Eri,6,0,36,30
1657126878482,MATH 103A,B02,083780,Greenfeld; Be'Eri,3,0,36,33
1657126878482,MATH 103A,B03,093562,Greenfeld; Be'Eri,3,0,36,33
1657126884506,MATH 105,A01,085443,Carter; Anne Toulson,14,0,35,21
1657126884506,MATH 105,A02,093477,Carter; Anne Toulson,20,0,35,15
1657126890531,MATH 109,A01,083213,Ganzberger; Geoffrey Michael,2,0,34,32
1657126890531,MATH 109,A02,083214,Ganzberger; Geoffrey Michael,3,0,34,31
1657126890531,MATH 109,A03,093478,Ganzberger; Geoffrey Michael,1,0,34,33
1657126890531,MATH 109,B01,083215,Ganzberger; Geoffrey Michael,1,0,32,31
1657126890531,MATH 109,B02,083216,Ganzberger; Geoffrey Michael,1,0,32,31
1657126890531,MATH 109,B03,093479,Ganzberger; Geoffrey Michael,6,0,32,26
1657126896555,MATH 142A,A01,083219,Chow; Bennett,6,0,32,26
1657126896555,MATH 142A,A02,083220,Chow; Bennett,10,0,32,22
1657126896555,MATH 142A,A03,093480,Chow; Bennett,7,0,32,25
1657126896555,MATH 142A,B03,093481,Chow; Bennett,8,0,32,24
1657126896555,MATH 142A,B04,093558,Chow; Bennett,11,0,32,21
1657126896555,MATH 142A,B05,093559,Chow; Bennett,6,0,32,26
1657126902579,MATH 193A,A01,083224,Rotar; Vladimir,7,0,34,27
1657126902579,MATH 193A,A02,083225,Rotar; Vladimir,5,0,34,29
1657126902579,MATH 193A,A03,083781,Rotar; Vladimir,1,0,34,33
1657126902579,MATH 193A,A04,083782,Rotar; Vladimir,6,0,34,28
1657126902579,MATH 193A,A05,093482,Rotar; Vladimir,6,0,34,28
1657126908607,MATH 197,001,091859,McAuley; Julian John,9999,0,9999,0
1657126908607,MATH 197,002,095566,Kedlaya; Kiran S.,9997,0,9999,2
1657126908607,MATH 197,003,095567,Xiao; Ming,9999,0,9999,0
1657126908607,MATH 197,004,095571,Perols; Johan Lars,9998,0,9999,1
1657126915665,COGS 9,A01,083615,Shannon; Kyle Michael,7,0,75,68
1657126921691,COGS 11,A01,083617,Boyle; Mary E. T.,21,0,48,27
1657126927719,COGS 13,A01,083071,Bastos; Amalia Pinkusfeld,9,0,71,62
1657126933754,COGS 14A,A01,092681,Semenuks; Arturs,1,1,100,99
1657126939779,COGS 14B,A01,083073,Cheng; Tzu-Han,6,0,63,57
1657126945816,COGS 17,A01,092677,Semenuks; Arturs,4,0,81,77
1657126951840,COGS 100,A01,083619,Allen; Michael Gordon,15,0,70,55
1657126957862,COGS 101A,A01,083621,Davis; Joshua Daniel,9,0,68,59
1657126963895,COGS 101B,A01,091572,Allen; Michael Gordon,8,0,65,57
1657126969923,COGS 101C,A01,083625,Delgado; Tania,17,0,35,18
1657126975946,COGS 107A,A01,083627,Boyle; Mary E. T.,13,0,60,47
1657126981973,COGS 118A,A01,083075,Gupta; Anjum,15,0,76,61
1657126987999,CSE 3,A50,083646,Miranda; Gregory Joseph,23,0,50,27
1657126994027,CSE 8A,A50,083650,Miranda; Gregory Joseph,17,1,56,39
1657127000055,CSE 11,A01,083080,Cao; Yingjun,4,15,40,36
1657127006081,CSE 12,A01,083652,Krause-Levy; Sophia Louisa,23,1,120,97
1657127012107,CSE 15L,A01,083654,Morris; Justin Loren,9,0,50,41
1657127012107,CSE 15L,A02,083655,Morris; Justin Loren,9,0,50,41
1657127018130,CSE 20,A01,083657,Tran; Khoa Dang,37,0,80,43
1657127024152,CSE 21,A01,095574,Bach; Quang Tran,21,0,48,27
1657127030177,CSE 30,A01,083084,Eldon; John,4,0,80,76
1657127030177,CSE 30,B01,095061,Bhaskar; Nishant,6,0,50,44
1657127036200,CSE 100,A01,083659,Cao; Yingjun,4,4,70,66
1657127042334,CSE 134B,A01,083661,Powell; Thomas Allan,20,0,100,80
1657127048371,CSE 140,A01,083663,Gungor; Onat,13,0,85,72
1657127054398,CSE 140L,A01,083088,Eldon; John,17,0,100,83
1657127060422,CSE 175,A01,083665,Kumar; Rakesh,3,0,25,22
1657127066446,CSE 190,A00,092507,Dubnov; Shlomo,7,0,20,13
1657127072480,ECE 45,A01,083139,Congero; Spencer William,5,0,75,70
1657127078504,ECE 65,A50,083695,Saad; Andrew S,12,0,30,18
1657127078504,ECE 65,A51,095125,Saad; Andrew S,25,0,26,1
1657127084527,ECE 109,A01,091882,Touri; Behrouz,17,0,70,53
1657127090550,ECE 180,A00,083140,Abi Samra; Nicholas Camill,1,0,30,29
1657127090550,ECE 180,B00,083141,Abi Samra; Nicholas Camill,0,0,30,30
1657127096579,MATH 10A,A01,083735,Patchell; Gregory David,2,0,30,28
1657127096579,MATH 10A,A02,083736,Patchell; Gregory David,20,0,30,10
1657127096579,MATH 10A,A03,083737,Patchell; Gregory David,16,0,30,14
1657127102619,MATH 10B,A01,083207,Lim; Seonhee,7,0,34,27
1657127102619,MATH 10B,A02,083208,Lim; Seonhee,9,0,35,26
1657127102619,MATH 10B,A03,093472,Lim; Seonhee,5,0,34,29
1657127102619,MATH 10B,B01,083739,Sinha; Shubham,9,0,30,21
1657127108665,MATH 18,A01,083743,Cinel; Cameron Alexander,6,0,30,24
1657127108665,MATH 18,A02,083744,Cinel; Cameron Alexander,15,0,30,15
1657127108665,MATH 18,A03,083745,Cinel; Cameron Alexander,8,0,30,22
1657127108665,MATH 18,B01,083748,Rideout; David Porter,4,0,37,33
1657127108665,MATH 18,B02,083749,Rideout; David Porter,3,0,36,33
1657127108665,MATH 18,B03,083750,Rideout; David Porter,2,0,37,35
1657127108665,MATH 18,B04,083751,Rideout; David Porter,5,0,36,31
1657127108665,MATH 18,B05,093473,Rideout; David Porter,4,0,36,32
1657127108665,MATH 18,B06,093474,Rideout; David Porter,5,0,36,31
1657127114688,MATH 20A,A01,083754,Zheng; Zequn,12,0,40,28
1657127120717,MATH 20B,A01,083756,Briones; Jor-el Thomas Caparas,1,0,36,35
1657127120717,MATH 20B,A02,083757,Briones; Jor-el Thomas Caparas,1,0,36,35
1657127120717,MATH 20B,A03,093475,Briones; Jor-el Thomas Caparas,0,0,36,36
1657127126747,MATH 20C,A01,083760,Briones; Jor-el Thomas Caparas,1,0,35,34
1657127126747,MATH 20C,A02,083761,Briones; Jor-el Thomas Caparas,8,0,35,27
1657127126747,MATH 20C,A03,093476,Briones; Jor-el Thomas Caparas,0,1,36,36
1657127126747,MATH 20C,B01,083762,Bach; Quang Tran,0,0,30,30
1657127132785,MATH 20D,A01,083765,Tran; Brian Kha,4,0,30,26
1657127132785,MATH 20D,A02,083766,Tran; Brian Kha,5,0,30,25
1657127132785,MATH 20D,A03,083767,Tran; Brian Kha,3,0,30,27
1657127138813,MATH 20E,A01,083771,Ganguly; Soumya,6,0,32,26
1657127138813,MATH 20E,A02,083772,Ganguly; Soumya,6,0,32,26
1657127138813,MATH 20E,B01,083773,Ciotti; Benjamin,18,0,35,17
1657127138813,MATH 20E,B02,083774,Ciotti; Benjamin,17,0,35,18
1657127144852,MATH 103A,A01,083777,Greenfeld; Be'Eri,2,0,36,34
1657127144852,MATH 103A,A02,083778,Greenfeld; Be'Eri,5,0,36,31
1657127144852,MATH 103A,A03,093561,Greenfeld; Be'Eri,4,0,36,32
1657127144852,MATH 103A,B01,083779,Greenfeld; Be'Eri,6,0,36,30
1657127144852,MATH 103A,B02,083780,Greenfeld; Be'Eri,3,0,36,33
1657127144852,MATH 103A,B03,093562,Greenfeld; Be'Eri,3,0,36,33
1657127150875,MATH 105,A01,085443,Carter; Anne Toulson,14,0,35,21
1657127150875,MATH 105,A02,093477,Carter; Anne Toulson,20,0,35,15
1657127156903,MATH 109,A01,083213,Ganzberger; Geoffrey Michael,2,0,34,32
1657127156903,MATH 109,A02,083214,Ganzberger; Geoffrey Michael,3,0,34,31
1657127156903,MATH 109,A03,093478,Ganzberger; Geoffrey Michael,1,0,34,33
1657127156903,MATH 109,B01,083215,Ganzberger; Geoffrey Michael,1,0,32,31
1657127156903,MATH 109,B02,083216,Ganzberger; Geoffrey Michael,1,0,32,31
1657127156903,MATH 109,B03,093479,Ganzberger; Geoffrey Michael,6,0,32,26
1657127162944,MATH 142A,A01,083219,Chow; Bennett,6,0,32,26
1657127162944,MATH 142A,A02,083220,Chow; Bennett,10,0,32,22
1657127162944,MATH 142A,A03,093480,Chow; Bennett,7,0,32,25
1657127162944,MATH 142A,B03,093481,Chow; Bennett,8,0,32,24
1657127162944,MATH 142A,B04,093558,Chow; Bennett,11,0,32,21
1657127162944,MATH 142A,B05,093559,Chow; Bennett,6,0,32,26
1657127168973,MATH 193A,A01,083224,Rotar; Vladimir,7,0,34,27
1657127168973,MATH 193A,A02,083225,Rotar; Vladimir,5,0,34,29
1657127168973,MATH 193A,A03,083781,Rotar; Vladimir,1,0,34,33
1657127168973,MATH 193A,A04,083782,Rotar; Vladimir,6,0,34,28
1657127168973,MATH 193A,A05,093482,Rotar; Vladimir,6,0,34,28
1657127174999,MATH 197,001,091859,McAuley; Julian John,9999,0,9999,0
1657127174999,MATH 197,002,095566,Kedlaya; Kiran S.,9997,0,9999,2
1657127174999,MATH 197,003,095567,Xiao; Ming,9999,0,9999,0
1657127174999,MATH 197,004,095571,Perols; Johan Lars,9998,0,9999,1
1657127182053,COGS 9,A01,083615,Shannon; Kyle Michael,7,0,75,68
1657127188075,COGS 11,A01,083617,Boyle; Mary E. T.,21,0,48,27
1657127194113,COGS 13,A01,083071,Bastos; Amalia Pinkusfeld,9,0,71,62
1657127200139,COGS 14A,A01,092681,Semenuks; Arturs,1,1,100,99
1657127206165,COGS 14B,A01,083073,Cheng; Tzu-Han,6,0,63,57
1657127212189,COGS 17,A01,092677,Semenuks; Arturs,4,0,81,77
1657127218211,COGS 100,A01,083619,Allen; Michael Gordon,15,0,70,55
1657127224235,COGS 101A,A01,083621,Davis; Joshua Daniel,9,0,68,59
1657127230264,COGS 101B,A01,091572,Allen; Michael Gordon,8,0,65,57
1657127236290,COGS 101C,A01,083625,Delgado; Tania,17,0,35,18
1657127242315,COGS 107A,A01,083627,Boyle; Mary E. T.,13,0,60,47
1657127248338,COGS 118A,A01,083075,Gupta; Anjum,15,0,76,61
1657127254372,CSE 3,A50,083646,Miranda; Gregory Joseph,23,0,50,27
1657127260397,CSE 8A,A50,083650,Miranda; Gregory Joseph,17,1,56,39
1657127266419,CSE 11,A01,083080,Cao; Yingjun,4,15,40,36
1657127272443,CSE 12,A01,083652,Krause-Levy; Sophia Louisa,23,1,120,97
1657127278470,CSE 15L,A01,083654,Morris; Justin Loren,9,0,50,41
1657127278470,CSE 15L,A02,083655,Morris; Justin Loren,9,0,50,41
1657127284494,CSE 20,A01,083657,Tran; Khoa Dang,37,0,80,43
1657127290520,CSE 21,A01,095574,Bach; Quang Tran,21,0,48,27
1657127296543,CSE 30,A01,083084,Eldon; John,4,0,80,76
1657127296543,CSE 30,B01,095061,Bhaskar; Nishant,6,0,50,44
1657127302568,CSE 100,A01,083659,Cao; Yingjun,4,4,70,66
1657127308615,CSE 134B,A01,083661,Powell; Thomas Allan,20,0,100,80
1657127314642,CSE 140,A01,083663,Gungor; Onat,13,0,85,72
1657127320664,CSE 140L,A01,083088,Eldon; John,17,0,100,83
1657127326696,CSE 175,A01,083665,Kumar; Rakesh,3,0,25,22
1657127332725,CSE 190,A00,092507,Dubnov; Shlomo,7,0,20,13
1657127338746,ECE 45,A01,083139,Congero; Spencer William,5,0,75,70
1657127344774,ECE 65,A50,083695,Saad; Andrew S,12,0,30,18
1657127344774,ECE 65,A51,095125,Saad; Andrew S,25,0,26,1
1657127350797,ECE 109,A01,091882,Touri; Behrouz,17,0,70,53
1657127356820,ECE 180,A00,083140,Abi Samra; Nicholas Camill,1,0,30,29
1657127356820,ECE 180,B00,083141,Abi Samra; Nicholas Camill,0,0,30,30
1657127362846,MATH 10A,A01,083735,Patchell; Gregory David,2,0,30,28
1657127362846,MATH 10A,A02,083736,Patchell; Gregory David,20,0,30,10
1657127362846,MATH 10A,A03,083737,Patchell; Gregory David,16,0,30,14
1657127368871,MATH 10B,A01,083207,Lim; Seonhee,7,0,34,27
1657127368871,MATH 10B,A02,083208,Lim; Seonhee,9,0,35,26
1657127368871,MATH 10B,A03,093472,Lim; Seonhee,5,0,34,29
1657127368871,MATH 10B,B01,083739,Sinha; Shubham,9,0,30,21
1657127374896,MATH 18,A01,083743,Cinel; Cameron Alexander,6,0,30,24
1657127374896,MATH 18,A02,083744,Cinel; Cameron Alexander,15,0,30,15
1657127374896,MATH 18,A03,083745,Cinel; Cameron Alexander,8,0,30,22
1657127374896,MATH 18,B01,083748,Rideout; David Porter,4,0,37,33
1657127374896,MATH 18,B02,083749,Rideout; David Porter,3,0,36,33
1657127374896,MATH 18,B03,083750,Rideout; David Porter,2,0,37,35
1657127374896,MATH 18,B04,083751,Rideout; David Porter,5,0,36,31
1657127374896,MATH 18,B05,093473,Rideout; David Porter,4,0,36,32
1657127374896,MATH 18,B06,093474,Rideout; David Porter,5,0,36,31
1657127380919,MATH 20A,A01,083754,Zheng; Zequn,12,0,40,28
1657127386943,MATH 20B,A01,083756,Briones; Jor-el Thomas Caparas,1,0,36,35
1657127386943,MATH 20B,A02,083757,Briones; Jor-el Thomas Caparas,1,0,36,35
1657127386943,MATH 20B,A03,093475,Briones; Jor-el Thomas Caparas,0,0,36,36
1657127392974,MATH 20C,A01,083760,Briones; Jor-el Thomas Caparas,1,0,35,34
1657127392974,MATH 20C,A02,083761,Briones; Jor-el Thomas Caparas,8,0,35,27
1657127392974,MATH 20C,A03,093476,Briones; Jor-el Thomas Caparas,0,1,36,36
1657127392974,MATH 20C,B01,083762,Bach; Quang Tran,0,0,30,30
1657127399013,MATH 20D,A01,083765,Tran; Brian Kha,4,0,30,26
1657127399013,MATH 20D,A02,083766,Tran; Brian Kha,5,0,30,25
1657127399013,MATH 20D,A03,083767,Tran; Brian Kha,3,0,30,27
1657127405043,MATH 20E,A01,083771,Ganguly; Soumya,6,0,32,26
1657127405043,MATH 20E,A02,083772,Ganguly; Soumya,6,0,32,26
1657127405043,MATH 20E,B01,083773,Ciotti; Benjamin,18,0,35,17
1657127405043,MATH 20E,B02,083774,Ciotti; Benjamin,17,0,35,18
1657127411067,MATH 103A,A01,083777,Greenfeld; Be'Eri,2,0,36,34
1657127411067,MATH 103A,A02,083778,Greenfeld; Be'Eri,5,0,36,31
1657127411067,MATH 103A,A03,093561,Greenfeld; Be'Eri,4,0,36,32
1657127411067,MATH 103A,B01,083779,Greenfeld; Be'Eri,6,0,36,30
1657127411067,MATH 103A,B02,083780,Greenfeld; Be'Eri,3,0,36,33
1657127411067,MATH 103A,B03,093562,Greenfeld; Be'Eri,3,0,36,33
1657127417095,MATH 105,A01,085443,Carter; Anne Toulson,14,0,35,21
1657127417095,MATH 105,A02,093477,Carter; Anne Toulson,20,0,35,15
1657127423126,MATH 109,A01,083213,Ganzberger; Geoffrey Michael,2,0,34,32
1657127423126,MATH 109,A02,083214,Ganzberger; Geoffrey Michael,3,0,34,31
1657127423126,MATH 109,A03,093478,Ganzberger; Geoffrey Michael,1,0,34,33
1657127423126,MATH 109,B01,083215,Ganzberger; Geoffrey Michael,1,0,32,31
1657127423126,MATH 109,B02,083216,Ganzberger; Geoffrey Michael,1,0,32,31
1657127423126,MATH 109,B03,093479,Ganzberger; Geoffrey Michael,6,0,32,26
1657127429156,MATH 142A,A01,083219,Chow; Bennett,6,0,32,26
1657127429156,MATH 142A,A02,083220,Chow; Bennett,10,0,32,22
1657127429156,MATH 142A,A03,093480,Chow; Bennett,7,0,32,25
1657127429156,MATH 142A,B03,093481,Chow; Bennett,8,0,32,24
1657127429156,MATH 142A,B04,093558,Chow; Bennett,11,0,32,21
1657127429156,MATH 142A,B05,093559,Chow; Bennett,6,0,32,26
1657127435191,MATH 193A,A01,083224,Rotar; Vladimir,7,0,34,27
1657127435191,MATH 193A,A02,083225,Rotar; Vladimir,5,0,34,29
1657127435191,MATH 193A,A03,083781,Rotar; Vladimir,1,0,34,33
1657127435191,MATH 193A,A04,083782,Rotar; Vladimir,6,0,34,28
1657127435191,MATH 193A,A05,093482,Rotar; Vladimir,6,0,34,28
1657127441222,MATH 197,001,091859,McAuley; Julian John,9999,0,9999,0
1657127441222,MATH 197,002,095566,Kedlaya; Kiran S.,9997,0,9999,2
1657127441222,MATH 197,003,095567,Xiao; Ming,9999,0,9999,0
1657127441222,MATH 197,004,095571,Perols; Johan Lars,9998,0,9999,1
1657127448302,COGS 9,A01,083615,Shannon; Kyle Michael,7,0,75,68
1657127454325,COGS 11,A01,083617,Boyle; Mary E. T.,21,0,48,27
1657127460356,COGS 13,A01,083071,Bastos; Amalia Pinkusfeld,9,0,71,62
1657127466379,COGS 14A,A01,092681,Semenuks; Arturs,1,1,100,99
1657127472402,COGS 14B,A01,083073,Cheng; Tzu-Han,6,0,63,57
1657127478425,COGS 17,A01,092677,Semenuks; Arturs,4,0,81,77
1657127484454,COGS 100,A01,083619,Allen; Michael Gordon,15,0,70,55
1657127490483,COGS 101A,A01,083621,Davis; Joshua Daniel,9,0,68,59
1657127496506,COGS 101B,A01,091572,Allen; Michael Gordon,8,0,65,57
1657127502532,COGS 101C,A01,083625,Delgado; Tania,17,0,35,18
1657127508556,COGS 107A,A01,083627,Boyle; Mary E. T.,13,0,60,47
1657127514591,COGS 118A,A01,083075,Gupta; Anjum,15,0,76,61
1657127520616,CSE 3,A50,083646,Miranda; Gregory Joseph,23,0,50,27
1657127526638,CSE 8A,A50,083650,Miranda; Gregory Joseph,17,1,56,39
1657127532676,CSE 11,A01,083080,Cao; Yingjun,4,15,40,36
1657127538701,CSE 12,A01,083652,Krause-Levy; Sophia Louisa,23,1,120,97
1657127544730,CSE 15L,A01,083654,Morris; Justin Loren,9,0,50,41
1657127544730,CSE 15L,A02,083655,Morris; Justin Loren,9,0,50,41
1657127550757,CSE 20,A01,083657,Tran; Khoa Dang,38,0,80,42
1657127556780,CSE 21,A01,095574,Bach; Quang Tran,21,0,48,27
1657127562818,CSE 30,A01,083084,Eldon; John,4,0,80,76
1657127562818,CSE 30,B01,095061,Bhaskar; Nishant,7,0,50,43
1657127568848,CSE 100,A01,083659,Cao; Yingjun,4,4,70,66
1657127574871,CSE 134B,A01,083661,Powell; Thomas Allan,20,0,100,80
1657127580896,CSE 140,A01,083663,Gungor; Onat,13,0,85,72
1657127586937,CSE 140L,A01,083088,Eldon; John,17,0,100,83
1657127592959,CSE 175,A01,083665,Kumar; Rakesh,3,0,25,22
1657127598984,CSE 190,A00,092507,Dubnov; Shlomo,7,0,20,13
1657127605008,ECE 45,A01,083139,Congero; Spencer William,5,0,75,70
1657127611037,ECE 65,A50,083695,Saad; Andrew S,12,0,30,18
1657127611037,ECE 65,A51,095125,Saad; Andrew S,25,0,26,1
1657127617065,ECE 109,A01,091882,Touri; Behrouz,17,0,70,53
1657127623088,ECE 180,A00,083140,Abi Samra; Nicholas Camill,1,0,30,29
1657127623088,ECE 180,B00,083141,Abi Samra; Nicholas Camill,0,0,30,30
1657127629110,MATH 10A,A01,083735,Patchell; Gregory David,2,0,30,28
1657127629110,MATH 10A,A02,083736,Patchell; Gregory David,20,0,30,10
1657127629110,MATH 10A,A03,083737,Patchell; Gregory David,16,0,30,14
1657127635132,MATH 10B,A01,083207,Lim; Seonhee,7,0,34,27
1657127635132,MATH 10B,A02,083208,Lim; Seonhee,9,0,35,26
1657127635132,MATH 10B,A03,093472,Lim; Seonhee,5,0,34,29
1657127635132,MATH 10B,B01,083739,Sinha; Shubham,9,0,30,21
1657127641229,MATH 18,A01,083743,Cinel; Cameron Alexander,6,0,30,24
1657127641229,MATH 18,A02,083744,Cinel; Cameron Alexander,15,0,30,15
1657127641229,MATH 18,A03,083745,Cinel; Cameron Alexander,8,0,30,22
1657127641229,MATH 18,B01,083748,Rideout; David Porter,4,0,37,33
1657127641229,MATH 18,B02,083749,Rideout; David Porter,3,0,36,33
1657127641229,MATH 18,B03,083750,Rideout; David Porter,2,0,37,35
1657127641229,MATH 18,B04,083751,Rideout; David Porter,5,0,36,31
1657127641229,MATH 18,B05,093473,Rideout; David Porter,4,0,36,32
1657127641229,MATH 18,B06,093474,Rideout; David Porter,5,0,36,31
1657127647256,MATH 20A,A01,083754,Zheng; Zequn,12,0,40,28
1657127653280,MATH 20B,A01,083756,Briones; Jor-el Thomas Caparas,1,0,36,35
1657127653280,MATH 20B,A02,083757,Briones; Jor-el Thomas Caparas,1,0,36,35
1657127653280,MATH 20B,A03,093475,Briones; Jor-el Thomas Caparas,0,0,36,36
1657127659310,MATH 20C,A01,083760,Briones; Jor-el Thomas Caparas,1,0,35,34
1657127659310,MATH 20C,A02,083761,Briones; Jor-el Thomas Caparas,8,0,35,27
1657127659310,MATH 20C,A03,093476,Briones; Jor-el Thomas Caparas,0,1,36,36
1657127659310,MATH 20C,B01,083762,Bach; Quang Tran,0,0,30,30
1657127665335,MATH 20D,A01,083765,Tran; Brian Kha,4,0,30,26
1657127665335,MATH 20D,A02,083766,Tran; Brian Kha,5,0,30,25
1657127665335,MATH 20D,A03,083767,Tran; Brian Kha,3,0,30,27
1657127671371,MATH 20E,A01,083771,Ganguly; Soumya,6,0,32,26
1657127671371,MATH 20E,A02,083772,Ganguly; Soumya,6,0,32,26
1657127671371,MATH 20E,B01,083773,Ciotti; Benjamin,18,0,35,17
1657127671371,MATH 20E,B02,083774,Ciotti; Benjamin,17,0,35,18
1657127677401,MATH 103A,A01,083777,Greenfeld; Be'Eri,2,0,36,34
1657127677401,MATH 103A,A02,083778,Greenfeld; Be'Eri,5,0,36,31
1657127677401,MATH 103A,A03,093561,Greenfeld; Be'Eri,4,0,36,32
1657127677401,MATH 103A,B01,083779,Greenfeld; Be'Eri,6,0,36,30
1657127677401,MATH 103A,B02,083780,Greenfeld; Be'Eri,3,0,36,33
1657127677401,MATH 103A,B03,093562,Greenfeld; Be'Eri,3,0,36,33
1657127683440,MATH 105,A01,085443,Carter; Anne Toulson,14,0,35,21
1657127683440,MATH 105,A02,093477,Carter; Anne Toulson,20,0,35,15
1657127689471,MATH 109,A01,083213,Ganzberger; Geoffrey Michael,2,0,34,32
1657127689471,MATH 109,A02,083214,Ganzberger; Geoffrey Michael,3,0,34,31
1657127689471,MATH 109,A03,093478,Ganzberger; Geoffrey Michael,1,0,34,33
1657127689471,MATH 109,B01,083215,Ganzberger; Geoffrey Michael,1,0,32,31
1657127689471,MATH 109,B02,083216,Ganzberger; Geoffrey Michael,1,0,32,31
1657127689471,MATH 109,B03,093479,Ganzberger; Geoffrey Michael,6,0,32,26
1657127695500,MATH 142A,A01,083219,Chow; Bennett,6,0,32,26
1657127695500,MATH 142A,A02,083220,Chow; Bennett,10,0,32,22
1657127695500,MATH 142A,A03,093480,Chow; Bennett,7,0,32,25
1657127695500,MATH 142A,B03,093481,Chow; Bennett,8,0,32,24
1657127695500,MATH 142A,B04,093558,Chow; Bennett,11,0,32,21
1657127695500,MATH 142A,B05,093559,Chow; Bennett,6,0,32,26
1657127701524,MATH 193A,A01,083224,Rotar; Vladimir,7,0,34,27
1657127701524,MATH 193A,A02,083225,Rotar; Vladimir,5,0,34,29
1657127701524,MATH 193A,A03,083781,Rotar; Vladimir,1,0,34,33
1657127701524,MATH 193A,A04,083782,Rotar; Vladimir,6,0,34,28
1657127701524,MATH 193A,A05,093482,Rotar; Vladimir,6,0,34,28
1657127707554,MATH 197,001,091859,McAuley; Julian John,9999,0,9999,0
1657127707554,MATH 197,002,095566,Kedlaya; Kiran S.,9997,0,9999,2
1657127707554,MATH 197,003,095567,Xiao; Ming,9999,0,9999,0
1657127707554,MATH 197,004,095571,Perols; Johan Lars,9998,0,9999,1
1657127714609,COGS 9,A01,083615,Shannon; Kyle Michael,7,0,75,68
1657127720637,COGS 11,A01,083617,Boyle; Mary E. T.,21,0,48,27
1657127726660,COGS 13,A01,083071,Bastos; Amalia Pinkusfeld,9,0,71,62
1657127732687,COGS 14A,A01,092681,Semenuks; Arturs,1,1,100,99
1657127738711,COGS 14B,A01,083073,Cheng; Tzu-Han,6,0,63,57
1657127744738,COGS 17,A01,092677,Semenuks; Arturs,4,0,81,77
1657127750760,COGS 100,A01,083619,Allen; Michael Gordon,15,0,70,55
1657127756789,COGS 101A,A01,083621,Davis; Joshua Daniel,9,0,68,59
1657127762816,COGS 101B,A01,091572,Allen; Michael Gordon,8,0,65,57
1657127768839,COGS 101C,A01,083625,Delgado; Tania,17,0,35,18
1657127774864,COGS 107A,A01,083627,Boyle; Mary E. T.,13,0,60,47
1657127780891,COGS 118A,A01,083075,Gupta; Anjum,15,0,76,61
1657127786918,CSE 3,A50,083646,Miranda; Gregory Joseph,23,0,50,27
1657127792945,CSE 8A,A50,083650,Miranda; Gregory Joseph,17,1,56,39
1657127798972,CSE 11,A01,083080,Cao; Yingjun,4,15,40,36
1657127804998,CSE 12,A01,083652,Krause-Levy; Sophia Louisa,23,1,120,97
1657127811021,CSE 15L,A01,083654,Morris; Justin Loren,9,0,50,41
1657127811021,CSE 15L,A02,083655,Morris; Justin Loren,9,0,50,41
1657127817049,CSE 20,A01,083657,Tran; Khoa Dang,38,0,80,42
1657127823076,CSE 21,A01,095574,Bach; Quang Tran,21,0,48,27
1657127829109,CSE 30,A01,083084,Eldon; John,4,0,80,76
1657127829109,CSE 30,B01,095061,Bhaskar; Nishant,7,0,50,43
1657127835146,CSE 100,A01,083659,Cao; Yingjun,4,4,70,66
1657127841174,CSE 134B,A01,083661,Powell; Thomas Allan,20,0,100,80
1657127847196,CSE 140,A01,083663,Gungor; Onat,13,0,85,72
1657127853223,CSE 140L,A01,083088,Eldon; John,17,0,100,83
1657127859248,CSE 175,A01,083665,Kumar; Rakesh,3,0,25,22
1657127865281,CSE 190,A00,092507,Dubnov; Shlomo,7,0,20,13
1657127871304,ECE 45,A01,083139,Congero; Spencer William,5,0,75,70
1657127877328,ECE 65,A50,083695,Saad; Andrew S,12,0,30,18
1657127877328,ECE 65,A51,095125,Saad; Andrew S,25,0,26,1
1657127883362,ECE 109,A01,091882,Touri; Behrouz,17,0,70,53
1657127889389,ECE 180,A00,083140,Abi Samra; Nicholas Camill,1,0,30,29
1657127889389,ECE 180,B00,083141,Abi Samra; Nicholas Camill,0,0,30,30
1657127895417,MATH 10A,A01,083735,Patchell; Gregory David,2,0,30,28
1657127895417,MATH 10A,A02,083736,Patchell; Gregory David,20,0,30,10
1657127895417,MATH 10A,A03,083737,Patchell; Gregory David,16,0,30,14
1657127901445,MATH 10B,A01,083207,Lim; Seonhee,7,0,34,27
1657127901445,MATH 10B,A02,083208,Lim; Seonhee,9,0,35,26
1657127901445,MATH 10B,A03,093472,Lim; Seonhee,5,0,34,29
1657127901445,MATH 10B,B01,083739,Sinha; Shubham,9,0,30,21
1657127907471,MATH 18,A01,083743,Cinel; Cameron Alexander,6,0,30,24
1657127907471,MATH 18,A02,083744,Cinel; Cameron Alexander,15,0,30,15
1657127907471,MATH 18,A03,083745,Cinel; Cameron Alexander,8,0,30,22
1657127907471,MATH 18,B01,083748,Rideout; David Porter,4,0,37,33
1657127907471,MATH 18,B02,083749,Rideout; David Porter,3,0,36,33
1657127907471,MATH 18,B03,083750,Rideout; David Porter,2,0,37,35
1657127907471,MATH 18,B04,083751,Rideout; David Porter,5,0,36,31
1657127907471,MATH 18,B05,093473,Rideout; David Porter,4,0,36,32
1657127907471,MATH 18,B06,093474,Rideout; David Porter,5,0,36,31
1657127913499,MATH 20A,A01,083754,Zheng; Zequn,12,0,40,28
1657127919532,MATH 20B,A01,083756,Briones; Jor-el Thomas Caparas,1,0,36,35
1657127919532,MATH 20B,A02,083757,Briones; Jor-el Thomas Caparas,1,0,36,35
1657127919532,MATH 20B,A03,093475,Briones; Jor-el Thomas Caparas,0,0,36,36
1657127925561,MATH 20C,A01,083760,Briones; Jor-el Thomas Caparas,1,0,35,34
1657127925561,MATH 20C,A02,083761,Briones; Jor-el Thomas Caparas,8,0,35,27
1657127925561,MATH 20C,A03,093476,Briones; Jor-el Thomas Caparas,0,1,36,36
1657127925561,MATH 20C,B01,083762,Bach; Quang Tran,0,0,30,30
1657127931588,MATH 20D,A01,083765,Tran; Brian Kha,4,0,30,26
1657127931588,MATH 20D,A02,083766,Tran; Brian Kha,5,0,30,25
1657127931588,MATH 20D,A03,083767,Tran; Brian Kha,3,0,30,27
1657127937616,MATH 20E,A01,083771,Ganguly; Soumya,6,0,32,26
1657127937616,MATH 20E,A02,083772,Ganguly; Soumya,6,0,32,26
1657127937616,MATH 20E,B01,083773,Ciotti; Benjamin,18,0,35,17
1657127937616,MATH 20E,B02,083774,Ciotti; Benjamin,17,0,35,18
1657127943650,MATH 103A,A01,083777,Greenfeld; Be'Eri,2,0,36,34
1657127943650,MATH 103A,A02,083778,Greenfeld; Be'Eri,5,0,36,31
1657127943650,MATH 103A,A03,093561,Greenfeld; Be'Eri,4,0,36,32
1657127943650,MATH 103A,B01,083779,Greenfeld; Be'Eri,6,0,36,30
1657127943650,MATH 103A,B02,083780,Greenfeld; Be'Eri,3,0,36,33
1657127943650,MATH 103A,B03,093562,Greenfeld; Be'Eri,3,0,36,33
1657127949677,MATH 105,A01,085443,Carter; Anne Toulson,14,0,35,21
1657127949677,MATH 105,A02,093477,Carter; Anne Toulson,20,0,35,15
1657127955699,MATH 109,A01,083213,Ganzberger; Geoffrey Michael,2,0,34,32
1657127955699,MATH 109,A02,083214,Ganzberger; Geoffrey Michael,3,0,34,31
1657127955699,MATH 109,A03,093478,Ganzberger; Geoffrey Michael,1,0,34,33
1657127955699,MATH 109,B01,083215,Ganzberger; Geoffrey Michael,1,0,32,31
1657127955699,MATH 109,B02,083216,Ganzberger; Geoffrey Michael,1,0,32,31
1657127955699,MATH 109,B03,093479,Ganzberger; Geoffrey Michael,6,0,32,26
1657127961724,MATH 142A,A01,083219,Chow; Bennett,6,0,32,26
1657127961724,MATH 142A,A02,083220,Chow; Bennett,10,0,32,22
1657127961724,MATH 142A,A03,093480,Chow; Bennett,7,0,32,25
1657127961724,MATH 142A,B03,093481,Chow; Bennett,8,0,32,24
1657127961724,MATH 142A,B04,093558,Chow; Bennett,11,0,32,21
1657127961724,MATH 142A,B05,093559,Chow; Bennett,6,0,32,26
1657127967746,MATH 193A,A01,083224,Rotar; Vladimir,7,0,34,27
1657127967746,MATH 193A,A02,083225,Rotar; Vladimir,5,0,34,29
1657127967746,MATH 193A,A03,083781,Rotar; Vladimir,1,0,34,33
1657127967746,MATH 193A,A04,083782,Rotar; Vladimir,7,0,34,27
1657127967746,MATH 193A,A05,093482,Rotar; Vladimir,6,0,34,28
1657127973771,MATH 197,001,091859,McAuley; Julian John,9999,0,9999,0
1657127973771,MATH 197,002,095566,Kedlaya; Kiran S.,9997,0,9999,2
1657127973771,MATH 197,003,095567,Xiao; Ming,9999,0,9999,0
1657127973771,MATH 197,004,095571,Perols; Johan Lars,9998,0,9999,1
1657127980838,COGS 9,A01,083615,Shannon; Kyle Michael,7,0,75,68
1657127986862,COGS 11,A01,083617,Boyle; Mary E. T.,21,0,48,27
1657127992887,COGS 13,A01,083071,Bastos; Amalia Pinkusfeld,9,0,71,62
1657127998914,COGS 14A,A01,092681,Semenuks; Arturs,1,1,100,99
1657128004941,COGS 14B,A01,083073,Cheng; Tzu-Han,6,0,63,57
1657128010969,COGS 17,A01,092677,Semenuks; Arturs,4,0,81,77
1657128016992,COGS 100,A01,083619,Allen; Michael Gordon,15,0,70,55
1657128023015,COGS 101A,A01,083621,Davis; Joshua Daniel,9,0,68,59
1657128029042,COGS 101B,A01,091572,Allen; Michael Gordon,8,0,65,57
1657128035074,COGS 101C,A01,083625,Delgado; Tania,17,0,35,18
1657128041100,COGS 107A,A01,083627,Boyle; Mary E. T.,13,0,60,47
1657128047123,COGS 118A,A01,083075,Gupta; Anjum,15,0,76,61
1657128053149,CSE 3,A50,083646,Miranda; Gregory Joseph,23,0,50,27
1657128059177,CSE 8A,A50,083650,Miranda; Gregory Joseph,17,1,56,39
1657128065212,CSE 11,A01,083080,Cao; Yingjun,4,15,40,36
1657128071235,CSE 12,A01,083652,Krause-Levy; Sophia Louisa,23,1,120,97
1657128077259,CSE 15L,A01,083654,Morris; Justin Loren,9,0,50,41
1657128077259,CSE 15L,A02,083655,Morris; Justin Loren,9,0,50,41
1657128083294,CSE 20,A01,083657,Tran; Khoa Dang,38,0,80,42
1657128089318,CSE 21,A01,095574,Bach; Quang Tran,21,0,48,27
1657128095342,CSE 30,A01,083084,Eldon; John,4,0,80,76
1657128095342,CSE 30,B01,095061,Bhaskar; Nishant,7,0,50,43
1657128101368,CSE 100,A01,083659,Cao; Yingjun,4,4,70,66
1657128107395,CSE 134B,A01,083661,Powell; Thomas Allan,20,0,100,80
1657128113425,CSE 140,A01,083663,Gungor; Onat,13,0,85,72
1657128119451,CSE 140L,A01,083088,Eldon; John,17,0,100,83
1657128125483,CSE 175,A01,083665,Kumar; Rakesh,3,0,25,22
1657128131509,CSE 190,A00,092507,Dubnov; Shlomo,7,0,20,13
1657128137538,ECE 45,A01,083139,Congero; Spencer William,5,0,75,70
1657128143568,ECE 65,A50,083695,Saad; Andrew S,12,0,30,18
1657128143568,ECE 65,A51,095125,Saad; Andrew S,25,0,26,1
1657128149595,ECE 109,A01,091882,Touri; Behrouz,17,0,70,53
1657128155623,ECE 180,A00,083140,Abi Samra; Nicholas Camill,1,0,30,29
1657128155623,ECE 180,B00,083141,Abi Samra; Nicholas Camill,0,0,30,30
1657128161650,MATH 10A,A01,083735,Patchell; Gregory David,2,0,30,28
1657128161650,MATH 10A,A02,083736,Patchell; Gregory David,20,0,30,10
1657128161650,MATH 10A,A03,083737,Patchell; Gregory David,16,0,30,14
1657128167675,MATH 10B,A01,083207,Lim; Seonhee,7,0,34,27
1657128167675,MATH 10B,A02,083208,Lim; Seonhee,9,0,35,26
1657128167675,MATH 10B,A03,093472,Lim; Seonhee,5,0,34,29
1657128167675,MATH 10B,B01,083739,Sinha; Shubham,9,0,30,21
1657128173703,MATH 18,A01,083743,Cinel; Cameron Alexander,6,0,30,24
1657128173703,MATH 18,A02,083744,Cinel; Cameron Alexander,15,0,30,15
1657128173703,MATH 18,A03,083745,Cinel; Cameron Alexander,8,0,30,22
1657128173703,MATH 18,B01,083748,Rideout; David Porter,4,0,37,33
1657128173703,MATH 18,B02,083749,Rideout; David Porter,3,0,36,33
1657128173703,MATH 18,B03,083750,Rideout; David Porter,2,0,37,35
1657128173703,MATH 18,B04,083751,Rideout; David Porter,5,0,36,31
1657128173703,MATH 18,B05,093473,Rideout; David Porter,4,0,36,32
1657128173703,MATH 18,B06,093474,Rideout; David Porter,5,0,36,31
1657128179726,MATH 20A,A01,083754,Zheng; Zequn,12,0,40,28
1657128185750,MATH 20B,A01,083756,Briones; Jor-el Thomas Caparas,1,0,36,35
1657128185750,MATH 20B,A02,083757,Briones; Jor-el Thomas Caparas,1,0,36,35
1657128185750,MATH 20B,A03,093475,Briones; Jor-el Thomas Caparas,0,0,36,36
1657128191773,MATH 20C,A01,083760,Briones; Jor-el Thomas Caparas,1,0,35,34
1657128191773,MATH 20C,A02,083761,Briones; Jor-el Thomas Caparas,8,0,35,27
1657128191773,MATH 20C,A03,093476,Briones; Jor-el Thomas Caparas,0,1,36,36
1657128191773,MATH 20C,B01,083762,Bach; Quang Tran,0,0,30,30
1657128197804,MATH 20D,A01,083765,Tran; Brian Kha,4,0,30,26
1657128197804,MATH 20D,A02,083766,Tran; Brian Kha,5,0,30,25
1657128197804,MATH 20D,A03,083767,Tran; Brian Kha,3,0,30,27
1657128203828,MATH 20E,A01,083771,Ganguly; Soumya,6,0,32,26
1657128203828,MATH 20E,A02,083772,Ganguly; Soumya,6,0,32,26
1657128203828,MATH 20E,B01,083773,Ciotti; Benjamin,18,0,35,17
1657128203828,MATH 20E,B02,083774,Ciotti; Benjamin,17,0,35,18
1657128209852,MATH 103A,A01,083777,Greenfeld; Be'Eri,2,0,36,34
1657128209852,MATH 103A,A02,083778,Greenfeld; Be'Eri,5,0,36,31
1657128209852,MATH 103A,A03,093561,Greenfeld; Be'Eri,4,0,36,32
1657128209852,MATH 103A,B01,083779,Greenfeld; Be'Eri,6,0,36,30
1657128209852,MATH 103A,B02,083780,Greenfeld; Be'Eri,3,0,36,33
1657128209852,MATH 103A,B03,093562,Greenfeld; Be'Eri,3,0,36,33
1657128215888,MATH 105,A01,085443,Carter; Anne Toulson,14,0,35,21
1657128215888,MATH 105,A02,093477,Carter; Anne Toulson,20,0,35,15
1657128221915,MATH 109,A01,083213,Ganzberger; Geoffrey Michael,2,0,34,32
1657128221915,MATH 109,A02,083214,Ganzberger; Geoffrey Michael,3,0,34,31
1657128221915,MATH 109,A03,093478,Ganzberger; Geoffrey Michael,1,0,34,33
1657128221915,MATH 109,B01,083215,Ganzberger; Geoffrey Michael,1,0,32,31
1657128221915,MATH 109,B02,083216,Ganzberger; Geoffrey Michael,1,0,32,31
1657128221915,MATH 109,B03,093479,Ganzberger; Geoffrey Michael,6,0,32,26
1657128227938,MATH 142A,A01,083219,Chow; Bennett,6,0,32,26
1657128227938,MATH 142A,A02,083220,Chow; Bennett,10,0,32,22
1657128227938,MATH 142A,A03,093480,Chow; Bennett,7,0,32,25
1657128227938,MATH 142A,B03,093481,Chow; Bennett,8,0,32,24
1657128227938,MATH 142A,B04,093558,Chow; Bennett,11,0,32,21
1657128227938,MATH 142A,B05,093559,Chow; Bennett,6,0,32,26
1657128233973,MATH 193A,A01,083224,Rotar; Vladimir,7,0,34,27
1657128233973,MATH 193A,A02,083225,Rotar; Vladimir,5,0,34,29
1657128233973,MATH 193A,A03,083781,Rotar; Vladimir,1,0,34,33
1657128233973,MATH 193A,A04,083782,Rotar; Vladimir,7,0,34,27
1657128233973,MATH 193A,A05,093482,Rotar; Vladimir,6,0,34,28
1657128240101,MATH 197,001,091859,McAuley; Julian John,9999,0,9999,0
1657128240101,MATH 197,002,095566,Kedlaya; Kiran S.,9997,0,9999,2
1657128240101,MATH 197,003,095567,Xiao; Ming,9999,0,9999,0
1657128240101,MATH 197,004,095571,Perols; Johan Lars,9998,0,9999,1
1657128247155,COGS 9,A01,083615,Shannon; Kyle Michael,7,0,75,68
1657128253182,COGS 11,A01,083617,Boyle; Mary E. T.,21,0,48,27
1657128259212,COGS 13,A01,083071,Bastos; Amalia Pinkusfeld,9,0,71,62
1657128265245,COGS 14A,A01,092681,Semenuks; Arturs,1,1,100,99
1657128271278,COGS 14B,A01,083073,Cheng; Tzu-Han,6,0,63,57
1657128277310,COGS 17,A01,092677,Semenuks; Arturs,4,0,81,77
1657128283336,COGS 100,A01,083619,Allen; Michael Gordon,15,0,70,55
1657128289363,COGS 101A,A01,083621,Davis; Joshua Daniel,9,0,68,59
1657128295389,COGS 101B,A01,091572,Allen; Michael Gordon,8,0,65,57
1657128301412,COGS 101C,A01,083625,Delgado; Tania,17,0,35,18
1657128307443,COGS 107A,A01,083627,Boyle; Mary E. T.,13,0,60,47
1657128313467,COGS 118A,A01,083075,Gupta; Anjum,15,0,76,61
1657128319496,CSE 3,A50,083646,Miranda; Gregory Joseph,23,0,50,27
1657128325519,CSE 8A,A50,083650,Miranda; Gregory Joseph,17,1,56,39
1657128331543,CSE 11,A01,083080,Cao; Yingjun,4,15,40,36
1657128337567,CSE 12,A01,083652,Krause-Levy; Sophia Louisa,23,1,120,97
1657128343594,CSE 15L,A01,083654,Morris; Justin Loren,9,0,50,41
1657128343594,CSE 15L,A02,083655,Morris; Justin Loren,9,0,50,41
1657128349617,CSE 20,A01,083657,Tran; Khoa Dang,38,0,80,42
1657128355649,CSE 21,A01,095574,Bach; Quang Tran,21,0,48,27
1657128361674,CSE 30,A01,083084,Eldon; John,4,0,80,76
1657128361674,CSE 30,B01,095061,Bhaskar; Nishant,7,0,50,43
1657128367700,CSE 100,A01,083659,Cao; Yingjun,4,4,70,66
1657128373729,CSE 134B,A01,083661,Powell; Thomas Allan,20,0,100,80
1657128379760,CSE 140,A01,083663,Gungor; Onat,13,0,85,72
1657128385785,CSE 140L,A01,083088,Eldon; John,17,0,100,83
1657128391808,CSE 175,A01,083665,Kumar; Rakesh,3,0,25,22
1657128397831,CSE 190,A00,092507,Dubnov; Shlomo,7,0,20,13
1657128403858,ECE 45,A01,083139,Congero; Spencer William,5,0,75,70
1657128409894,ECE 65,A50,083695,Saad; Andrew S,12,0,30,18
1657128409894,ECE 65,A51,095125,Saad; Andrew S,25,0,26,1
1657128415935,ECE 109,A01,091882,Touri; Behrouz,17,0,70,53
1657128421963,ECE 180,A00,083140,Abi Samra; Nicholas Camill,1,0,30,29
1657128421963,ECE 180,B00,083141,Abi Samra; Nicholas Camill,0,0,30,30
1657128427987,MATH 10A,A01,083735,Patchell; Gregory David,2,0,30,28
1657128427987,MATH 10A,A02,083736,Patchell; Gregory David,20,0,30,10
1657128427987,MATH 10A,A03,083737,Patchell; Gregory David,16,0,30,14
1657128434018,MATH 10B,A01,083207,Lim; Seonhee,7,0,34,27
1657128434018,MATH 10B,A02,083208,Lim; Seonhee,9,0,35,26
1657128434018,MATH 10B,A03,093472,Lim; Seonhee,5,0,34,29
1657128434018,MATH 10B,B01,083739,Sinha; Shubham,9,0,30,21
1657128440042,MATH 18,A01,083743,Cinel; Cameron Alexander,6,0,30,24
1657128440042,MATH 18,A02,083744,Cinel; Cameron Alexander,15,0,30,15
1657128440042,MATH 18,A03,083745,Cinel; Cameron Alexander,8,0,30,22
1657128440042,MATH 18,B01,083748,Rideout; David Porter,4,0,37,33
1657128440042,MATH 18,B02,083749,Rideout; David Porter,3,0,36,33
1657128440042,MATH 18,B03,083750,Rideout; David Porter,2,0,37,35
1657128440042,MATH 18,B04,083751,Rideout; David Porter,5,0,36,31
1657128440042,MATH 18,B05,093473,Rideout; David Porter,4,0,36,32
1657128440042,MATH 18,B06,093474,Rideout; David Porter,5,0,36,31
1657128446068,MATH 20A,A01,083754,Zheng; Zequn,12,0,40,28
1657128452095,MATH 20B,A01,083756,Briones; Jor-el Thomas Caparas,1,0,36,35
1657128452095,MATH 20B,A02,083757,Briones; Jor-el Thomas Caparas,1,0,36,35
1657128452095,MATH 20B,A03,093475,Briones; Jor-el Thomas Caparas,0,0,36,36
1657128458118,MATH 20C,A01,083760,Briones; Jor-el Thomas Caparas,1,0,35,34
1657128458118,MATH 20C,A02,083761,Briones; Jor-el Thomas Caparas,8,0,35,27
1657128458118,MATH 20C,A03,093476,Briones; Jor-el Thomas Caparas,0,1,36,36
1657128458118,MATH 20C,B01,083762,Bach; Quang Tran,0,0,30,30
1657128464149,MATH 20D,A01,083765,Tran; Brian Kha,4,0,30,26
1657128464149,MATH 20D,A02,083766,Tran; Brian Kha,5,0,30,25
1657128464149,MATH 20D,A03,083767,Tran; Brian Kha,3,0,30,27
1657128470180,MATH 20E,A01,083771,Ganguly; Soumya,6,0,32,26
1657128470180,MATH 20E,A02,083772,Ganguly; Soumya,6,0,32,26
1657128470180,MATH 20E,B01,083773,Ciotti; Benjamin,18,0,35,17
1657128470180,MATH 20E,B02,083774,Ciotti; Benjamin,17,0,35,18
1657128476208,MATH 103A,A01,083777,Greenfeld; Be'Eri,2,0,36,34
1657128476208,MATH 103A,A02,083778,Greenfeld; Be'Eri,5,0,36,31
1657128476208,MATH 103A,A03,093561,Greenfeld; Be'Eri,4,0,36,32
1657128476208,MATH 103A,B01,083779,Greenfeld; Be'Eri,6,0,36,30
1657128476208,MATH 103A,B02,083780,Greenfeld; Be'Eri,3,0,36,33
1657128476208,MATH 103A,B03,093562,Greenfeld; Be'Eri,3,0,36,33
1657128482242,MATH 105,A01,085443,Carter; Anne Toulson,14,0,35,21
1657128482242,MATH 105,A02,093477,Carter; Anne Toulson,20,0,35,15
1657128488266,MATH 109,A01,083213,Ganzberger; Geoffrey Michael,2,0,34,32
1657128488266,MATH 109,A02,083214,Ganzberger; Geoffrey Michael,3,0,34,31
1657128488266,MATH 109,A03,093478,Ganzberger; Geoffrey Michael,1,0,34,33
1657128488266,MATH 109,B01,083215,Ganzberger; Geoffrey Michael,1,0,32,31
1657128488266,MATH 109,B02,083216,Ganzberger; Geoffrey Michael,1,0,32,31
1657128488266,MATH 109,B03,093479,Ganzberger; Geoffrey Michael,6,0,32,26
1657128494303,MATH 142A,A01,083219,Chow; Bennett,6,0,32,26
1657128494303,MATH 142A,A02,083220,Chow; Bennett,10,0,32,22
1657128494303,MATH 142A,A03,093480,Chow; Bennett,7,0,32,25
1657128494303,MATH 142A,B03,093481,Chow; Bennett,8,0,32,24
1657128494303,MATH 142A,B04,093558,Chow; Bennett,11,0,32,21
1657128494303,MATH 142A,B05,093559,Chow; Bennett,6,0,32,26
1657128500326,MATH 193A,A01,083224,Rotar; Vladimir,7,0,34,27
1657128500326,MATH 193A,A02,083225,Rotar; Vladimir,5,0,34,29
1657128500326,MATH 193A,A03,083781,Rotar; Vladimir,1,0,34,33
1657128500326,MATH 193A,A04,083782,Rotar; Vladimir,7,0,34,27
1657128500326,MATH 193A,A05,093482,Rotar; Vladimir,6,0,34,28
1657128506348,MATH 197,001,091859,McAuley; Julian John,9999,0,9999,0
1657128506348,MATH 197,002,095566,Kedlaya; Kiran S.,9997,0,9999,2
1657128506348,MATH 197,003,095567,Xiao; Ming,9999,0,9999,0
1657128506348,MATH 197,004,095571,Perols; Johan Lars,9998,0,9999,1
1657128513402,COGS 9,A01,083615,Shannon; Kyle Michael,7,0,75,68
1657128519428,COGS 11,A01,083617,Boyle; Mary E. T.,21,0,48,27
1657128525456,COGS 13,A01,083071,Bastos; Amalia Pinkusfeld,9,0,71,62
1657128531484,COGS 14A,A01,092681,Semenuks; Arturs,1,1,100,99
1657128537515,COGS 14B,A01,083073,Cheng; Tzu-Han,6,0,63,57
1657128543539,COGS 17,A01,092677,Semenuks; Arturs,4,0,81,77
1657128549561,COGS 100,A01,083619,Allen; Michael Gordon,15,0,70,55
1657128555583,COGS 101A,A01,083621,Davis; Joshua Daniel,9,0,68,59
1657128561609,COGS 101B,A01,091572,Allen; Michael Gordon,8,0,65,57
1657128567639,COGS 101C,A01,083625,Delgado; Tania,17,0,35,18
1657128573672,COGS 107A,A01,083627,Boyle; Mary E. T.,13,0,60,47
1657128579699,COGS 118A,A01,083075,Gupta; Anjum,15,0,76,61
1657128585726,CSE 3,A50,083646,Miranda; Gregory Joseph,23,0,50,27
1657128591768,CSE 8A,A50,083650,Miranda; Gregory Joseph,17,1,56,39
1657128597794,CSE 11,A01,083080,Cao; Yingjun,4,15,40,36
1657128603819,CSE 12,A01,083652,Krause-Levy; Sophia Louisa,23,1,120,97
1657128609847,CSE 15L,A01,083654,Morris; Justin Loren,9,0,50,41
1657128609847,CSE 15L,A02,083655,Morris; Justin Loren,9,0,50,41
1657128615869,CSE 20,A01,083657,Tran; Khoa Dang,38,0,80,42
1657128621893,CSE 21,A01,095574,Bach; Quang Tran,21,0,48,27
1657128627918,CSE 30,A01,083084,Eldon; John,4,0,80,76
1657128627918,CSE 30,B01,095061,Bhaskar; Nishant,7,0,50,43
1657128633944,CSE 100,A01,083659,Cao; Yingjun,4,4,70,66
1657128639968,CSE 134B,A01,083661,Powell; Thomas Allan,20,0,100,80
1657128645994,CSE 140,A01,083663,Gungor; Onat,13,0,85,72
1657128652025,CSE 140L,A01,083088,Eldon; John,17,0,100,83
1657128658050,CSE 175,A01,083665,Kumar; Rakesh,3,0,25,22
1657128664085,CSE 190,A00,092507,Dubnov; Shlomo,7,0,20,13
1657128670107,ECE 45,A01,083139,Congero; Spencer William,5,0,75,70
1657128676143,ECE 65,A50,083695,Saad; Andrew S,12,0,30,18
1657128676143,ECE 65,A51,095125,Saad; Andrew S,25,0,26,1
1657128682167,ECE 109,A01,091882,Touri; Behrouz,17,0,70,53
1657128688198,ECE 180,A00,083140,Abi Samra; Nicholas Camill,1,0,30,29
1657128688198,ECE 180,B00,083141,Abi Samra; Nicholas Camill,0,0,30,30
1657128694227,MATH 10A,A01,083735,Patchell; Gregory David,2,0,30,28
1657128694227,MATH 10A,A02,083736,Patchell; Gregory David,20,0,30,10
1657128694227,MATH 10A,A03,083737,Patchell; Gregory David,16,0,30,14
1657128700264,MATH 10B,A01,083207,Lim; Seonhee,7,0,34,27
1657128700264,MATH 10B,A02,083208,Lim; Seonhee,9,0,35,26
1657128700264,MATH 10B,A03,093472,Lim; Seonhee,5,0,34,29
1657128700264,MATH 10B,B01,083739,Sinha; Shubham,9,0,30,21
1657128706309,MATH 18,A01,083743,Cinel; Cameron Alexander,6,0,30,24
1657128706309,MATH 18,A02,083744,Cinel; Cameron Alexander,15,0,30,15
1657128706309,MATH 18,A03,083745,Cinel; Cameron Alexander,8,0,30,22
1657128706309,MATH 18,B01,083748,Rideout; David Porter,4,0,37,33
1657128706309,MATH 18,B02,083749,Rideout; David Porter,3,0,36,33
1657128706309,MATH 18,B03,083750,Rideout; David Porter,2,0,37,35
1657128706309,MATH 18,B04,083751,Rideout; David Porter,5,0,36,31
1657128706309,MATH 18,B05,093473,Rideout; David Porter,4,0,36,32
1657128706309,MATH 18,B06,093474,Rideout; David Porter,5,0,36,31
1657128712336,MATH 20A,A01,083754,Zheng; Zequn,12,0,40,28
1657128718358,MATH 20B,A01,083756,Briones; Jor-el Thomas Caparas,1,0,36,35
1657128718358,MATH 20B,A02,083757,Briones; Jor-el Thomas Caparas,1,0,36,35
1657128718358,MATH 20B,A03,093475,Briones; Jor-el Thomas Caparas,0,0,36,36
1657128724383,MATH 20C,A01,083760,Briones; Jor-el Thomas Caparas,1,0,35,34
1657128724383,MATH 20C,A02,083761,Briones; Jor-el Thomas Caparas,8,0,35,27
1657128724383,MATH 20C,A03,093476,Briones; Jor-el Thomas Caparas,0,1,36,36
1657128724383,MATH 20C,B01,083762,Bach; Quang Tran,0,0,30,30
1657128730405,MATH 20D,A01,083765,Tran; Brian Kha,4,0,30,26
1657128730405,MATH 20D,A02,083766,Tran; Brian Kha,5,0,30,25
1657128730405,MATH 20D,A03,083767,Tran; Brian Kha,3,0,30,27
1657128736429,MATH 20E,A01,083771,Ganguly; Soumya,6,0,32,26
1657128736429,MATH 20E,A02,083772,Ganguly; Soumya,6,0,32,26
1657128736429,MATH 20E,B01,083773,Ciotti; Benjamin,18,0,35,17
1657128736429,MATH 20E,B02,083774,Ciotti; Benjamin,17,0,35,18
1657128742466,MATH 103A,A01,083777,Greenfeld; Be'Eri,2,0,36,34
1657128742466,MATH 103A,A02,083778,Greenfeld; Be'Eri,5,0,36,31
1657128742466,MATH 103A,A03,093561,Greenfeld; Be'Eri,4,0,36,32
1657128742466,MATH 103A,B01,083779,Greenfeld; Be'Eri,6,0,36,30
1657128742466,MATH 103A,B02,083780,Greenfeld; Be'Eri,3,0,36,33
1657128742466,MATH 103A,B03,093562,Greenfeld; Be'Eri,3,0,36,33
1657128748495,MATH 105,A01,085443,Carter; Anne Toulson,14,0,35,21
1657128748495,MATH 105,A02,093477,Carter; Anne Toulson,20,0,35,15
1657128754519,MATH 109,A01,083213,Ganzberger; Geoffrey Michael,2,0,34,32
1657128754519,MATH 109,A02,083214,Ganzberger; Geoffrey Michael,3,0,34,31
1657128754519,MATH 109,A03,093478,Ganzberger; Geoffrey Michael,1,0,34,33
1657128754519,MATH 109,B01,083215,Ganzberger; Geoffrey Michael,1,0,32,31
1657128754519,MATH 109,B02,083216,Ganzberger; Geoffrey Michael,1,0,32,31
1657128754519,MATH 109,B03,093479,Ganzberger; Geoffrey Michael,6,0,32,26
1657128760548,MATH 142A,A01,083219,Chow; Bennett,6,0,32,26
1657128760548,MATH 142A,A02,083220,Chow; Bennett,10,0,32,22
1657128760548,MATH 142A,A03,093480,Chow; Bennett,7,0,32,25
1657128760548,MATH 142A,B03,093481,Chow; Bennett,8,0,32,24
1657128760548,MATH 142A,B04,093558,Chow; Bennett,11,0,32,21
1657128760548,MATH 142A,B05,093559,Chow; Bennett,6,0,32,26
1657128766570,MATH 193A,A01,083224,Rotar; Vladimir,7,0,34,27
1657128766570,MATH 193A,A02,083225,Rotar; Vladimir,5,0,34,29
1657128766570,MATH 193A,A03,083781,Rotar; Vladimir,1,0,34,33
1657128766570,MATH 193A,A04,083782,Rotar; Vladimir,7,0,34,27
1657128766570,MATH 193A,A05,093482,Rotar; Vladimir,6,0,34,28
1657128772616,MATH 197,001,091859,McAuley; Julian John,9999,0,9999,0
1657128772616,MATH 197,002,095566,Kedlaya; Kiran S.,9997,0,9999,2
1657128772616,MATH 197,003,095567,Xiao; Ming,9999,0,9999,0
1657128772616,MATH 197,004,095571,Perols; Johan Lars,9998,0,9999,1
1657128779667,COGS 9,A01,083615,Shannon; Kyle Michael,7,0,75,68
1657128785703,COGS 11,A01,083617,Boyle; Mary E. T.,21,0,48,27
1657128791726,COGS 13,A01,083071,Bastos; Amalia Pinkusfeld,9,0,71,62
1657128797748,COGS 14A,A01,092681,Semenuks; Arturs,1,1,100,99
1657128803771,COGS 14B,A01,083073,Cheng; Tzu-Han,6,0,63,57
1657128809792,COGS 17,A01,092677,Semenuks; Arturs,4,0,81,77
1657128815817,COGS 100,A01,083619,Allen; Michael Gordon,15,0,70,55
1657128821859,COGS 101A,A01,083621,Davis; Joshua Daniel,9,0,68,59
1657128827884,COGS 101B,A01,091572,Allen; Michael Gordon,8,0,65,57
1657128834027,COGS 101C,A01,083625,Delgado; Tania,17,0,35,18
1657128840053,COGS 107A,A01,083627,Boyle; Mary E. T.,13,0,60,47
1657128846092,COGS 118A,A01,083075,Gupta; Anjum,15,0,76,61
1657128852130,CSE 3,A50,083646,Miranda; Gregory Joseph,23,0,50,27
1657128858157,CSE 8A,A50,083650,Miranda; Gregory Joseph,17,1,56,39
1657128864179,CSE 11,A01,083080,Cao; Yingjun,4,15,40,36
1657128870202,CSE 12,A01,083652,Krause-Levy; Sophia Louisa,23,1,120,97
1657128876238,CSE 15L,A01,083654,Morris; Justin Loren,9,0,50,41
1657128876238,CSE 15L,A02,083655,Morris; Justin Loren,9,0,50,41
1657128882272,CSE 20,A01,083657,Tran; Khoa Dang,38,0,80,42
1657128888295,CSE 21,A01,095574,Bach; Quang Tran,21,0,48,27
1657128894322,CSE 30,A01,083084,Eldon; John,4,0,80,76
1657128894322,CSE 30,B01,095061,Bhaskar; Nishant,7,0,50,43
1657128900351,CSE 100,A01,083659,Cao; Yingjun,4,4,70,66
1657128906373,CSE 134B,A01,083661,Powell; Thomas Allan,20,0,100,80
1657128912402,CSE 140,A01,083663,Gungor; Onat,13,0,85,72
1657128918429,CSE 140L,A01,083088,Eldon; John,17,0,100,83
1657128924455,CSE 175,A01,083665,Kumar; Rakesh,3,0,25,22
1657128930481,CSE 190,A00,092507,Dubnov; Shlomo,7,0,20,13
1657128936507,ECE 45,A01,083139,Congero; Spencer William,5,0,75,70
1657128942533,ECE 65,A50,083695,Saad; Andrew S,12,0,30,18
1657128942533,ECE 65,A51,095125,Saad; Andrew S,25,0,26,1
1657128948559,ECE 109,A01,091882,Touri; Behrouz,17,0,70,53
1657128954585,ECE 180,A00,083140,Abi Samra; Nicholas Camill,1,0,30,29
1657128954585,ECE 180,B00,083141,Abi Samra; Nicholas Camill,0,0,30,30
1657128960608,MATH 10A,A01,083735,Patchell; Gregory David,2,0,30,28
1657128960608,MATH 10A,A02,083736,Patchell; Gregory David,20,0,30,10
1657128960608,MATH 10A,A03,083737,Patchell; Gregory David,16,0,30,14
1657128966638,MATH 10B,A01,083207,Lim; Seonhee,7,0,34,27
1657128966638,MATH 10B,A02,083208,Lim; Seonhee,9,0,35,26
1657128966638,MATH 10B,A03,093472,Lim; Seonhee,5,0,34,29
1657128966638,MATH 10B,B01,083739,Sinha; Shubham,9,0,30,21
1657128972662,MATH 18,A01,083743,Cinel; Cameron Alexander,6,0,30,24
1657128972662,MATH 18,A02,083744,Cinel; Cameron Alexander,15,0,30,15
1657128972662,MATH 18,A03,083745,Cinel; Cameron Alexander,8,0,30,22
1657128972662,MATH 18,B01,083748,Rideout; David Porter,4,0,37,33
1657128972662,MATH 18,B02,083749,Rideout; David Porter,3,0,36,33
1657128972662,MATH 18,B03,083750,Rideout; David Porter,2,0,37,35
1657128972662,MATH 18,B04,083751,Rideout; David Porter,5,0,36,31
1657128972662,MATH 18,B05,093473,Rideout; David Porter,4,0,36,32
1657128972662,MATH 18,B06,093474,Rideout; David Porter,5,0,36,31
1657128978689,MATH 20A,A01,083754,Zheng; Zequn,12,0,40,28
1657128984713,MATH 20B,A01,083756,Briones; Jor-el Thomas Caparas,1,0,36,35
1657128984713,MATH 20B,A02,083757,Briones; Jor-el Thomas Caparas,1,0,36,35
1657128984713,MATH 20B,A03,093475,Briones; Jor-el Thomas Caparas,0,0,36,36
1657128990736,MATH 20C,A01,083760,Briones; Jor-el Thomas Caparas,1,0,35,34
1657128990736,MATH 20C,A02,083761,Briones; Jor-el Thomas Caparas,8,0,35,27
1657128990736,MATH 20C,A03,093476,Briones; Jor-el Thomas Caparas,0,1,36,36
1657128990736,MATH 20C,B01,083762,Bach; Quang Tran,0,0,30,30
1657128996764,MATH 20D,A01,083765,Tran; Brian Kha,4,0,30,26
1657128996764,MATH 20D,A02,083766,Tran; Brian Kha,5,0,30,25
1657128996764,MATH 20D,A03,083767,Tran; Brian Kha,3,0,30,27
1657129002797,MATH 20E,A01,083771,Ganguly; Soumya,6,0,32,26
1657129002797,MATH 20E,A02,083772,Ganguly; Soumya,6,0,32,26
1657129002797,MATH 20E,B01,083773,Ciotti; Benjamin,18,0,35,17
1657129002797,MATH 20E,B02,083774,Ciotti; Benjamin,17,0,35,18
1657129008831,MATH 103A,A01,083777,Greenfeld; Be'Eri,2,0,36,34
1657129008831,MATH 103A,A02,083778,Greenfeld; Be'Eri,5,0,36,31
1657129008831,MATH 103A,A03,093561,Greenfeld; Be'Eri,4,0,36,32
1657129008831,MATH 103A,B01,083779,Greenfeld; Be'Eri,6,0,36,30
1657129008831,MATH 103A,B02,083780,Greenfeld; Be'Eri,3,0,36,33
1657129008831,MATH 103A,B03,093562,Greenfeld; Be'Eri,3,0,36,33
1657129014858,MATH 105,A01,085443,Carter; Anne Toulson,14,0,35,21
1657129014858,MATH 105,A02,093477,Carter; Anne Toulson,20,0,35,15
1657129020885,MATH 109,A01,083213,Ganzberger; Geoffrey Michael,2,0,34,32
1657129020885,MATH 109,A02,083214,Ganzberger; Geoffrey Michael,3,0,34,31
1657129020885,MATH 109,A03,093478,Ganzberger; Geoffrey Michael,1,0,34,33
1657129020885,MATH 109,B01,083215,Ganzberger; Geoffrey Michael,1,0,32,31
1657129020885,MATH 109,B02,083216,Ganzberger; Geoffrey Michael,1,0,32,31
1657129020885,MATH 109,B03,093479,Ganzberger; Geoffrey Michael,6,0,32,26
1657129026907,MATH 142A,A01,083219,Chow; Bennett,6,0,32,26
1657129026907,MATH 142A,A02,083220,Chow; Bennett,10,0,32,22
1657129026907,MATH 142A,A03,093480,Chow; Bennett,7,0,32,25
1657129026907,MATH 142A,B03,093481,Chow; Bennett,8,0,32,24
1657129026907,MATH 142A,B04,093558,Chow; Bennett,11,0,32,21
1657129026907,MATH 142A,B05,093559,Chow; Bennett,6,0,32,26
1657129032931,MATH 193A,A01,083224,Rotar; Vladimir,7,0,34,27
1657129032931,MATH 193A,A02,083225,Rotar; Vladimir,5,0,34,29
1657129032931,MATH 193A,A03,083781,Rotar; Vladimir,1,0,34,33
1657129032931,MATH 193A,A04,083782,Rotar; Vladimir,7,0,34,27
1657129032931,MATH 193A,A05,093482,Rotar; Vladimir,6,0,34,28
1657129038957,MATH 197,001,091859,McAuley; Julian John,9999,0,9999,0
1657129038957,MATH 197,002,095566,Kedlaya; Kiran S.,9997,0,9999,2
1657129038957,MATH 197,003,095567,Xiao; Ming,9999,0,9999,0
1657129038957,MATH 197,004,095571,Perols; Johan Lars,9998,0,9999,1
1657129046039,COGS 9,A01,083615,Shannon; Kyle Michael,7,0,75,68
1657129052066,COGS 11,A01,083617,Boyle; Mary E. T.,21,0,48,27
1657129058088,COGS 13,A01,083071,Bastos; Amalia Pinkusfeld,9,0,71,62
1657129064111,COGS 14A,A01,092681,Semenuks; Arturs,1,1,100,99
1657129070134,COGS 14B,A01,083073,Cheng; Tzu-Han,6,0,63,57
1657129076159,COGS 17,A01,092677,Semenuks; Arturs,4,0,81,77
1657129082192,COGS 100,A01,083619,Allen; Michael Gordon,15,0,70,55
1657129088230,COGS 101A,A01,083621,Davis; Joshua Daniel,9,0,68,59
1657129094253,COGS 101B,A01,091572,Allen; Michael Gordon,8,0,65,57
1657129100274,COGS 101C,A01,083625,Delgado; Tania,17,0,35,18
1657129106307,COGS 107A,A01,083627,Boyle; Mary E. T.,13,0,60,47
1657129112330,COGS 118A,A01,083075,Gupta; Anjum,15,0,76,61
1657129118370,CSE 3,A50,083646,Miranda; Gregory Joseph,23,0,50,27
1657129124393,CSE 8A,A50,083650,Miranda; Gregory Joseph,17,1,56,39
1657129130417,CSE 11,A01,083080,Cao; Yingjun,4,15,40,36
1657129136455,CSE 12,A01,083652,Krause-Levy; Sophia Louisa,23,1,120,97
1657129142477,CSE 15L,A01,083654,Morris; Justin Loren,9,0,50,41
1657129142477,CSE 15L,A02,083655,Morris; Justin Loren,9,0,50,41
1657129148501,CSE 20,A01,083657,Tran; Khoa Dang,38,0,80,42
1657129154528,CSE 21,A01,095574,Bach; Quang Tran,21,0,48,27
1657129160553,CSE 30,A01,083084,Eldon; John,4,0,80,76
1657129160553,CSE 30,B01,095061,Bhaskar; Nishant,7,0,50,43
1657129166584,CSE 100,A01,083659,Cao; Yingjun,4,4,70,66
1657129172607,CSE 134B,A01,083661,Powell; Thomas Allan,20,0,100,80
1657129178631,CSE 140,A01,083663,Gungor; Onat,13,0,85,72
1657129184665,CSE 140L,A01,083088,Eldon; John,17,0,100,83
1657129190690,CSE 175,A01,083665,Kumar; Rakesh,3,0,25,22
1657129196716,CSE 190,A00,092507,Dubnov; Shlomo,7,0,20,13
1657129202753,ECE 45,A01,083139,Congero; Spencer William,5,0,75,70
1657129208786,ECE 65,A50,083695,Saad; Andrew S,12,0,30,18
1657129208786,ECE 65,A51,095125,Saad; Andrew S,25,0,26,1
1657129214819,ECE 109,A01,091882,Touri; Behrouz,17,0,70,53
1657129220853,ECE 180,A00,083140,Abi Samra; Nicholas Camill,1,0,30,29
1657129220853,ECE 180,B00,083141,Abi Samra; Nicholas Camill,0,0,30,30
1657129226888,MATH 10A,A01,083735,Patchell; Gregory David,2,0,30,28
1657129226888,MATH 10A,A02,083736,Patchell; Gregory David,20,0,30,10
1657129226888,MATH 10A,A03,083737,Patchell; Gregory David,16,0,30,14
1657129232911,MATH 10B,A01,083207,Lim; Seonhee,7,0,34,27
1657129232911,MATH 10B,A02,083208,Lim; Seonhee,9,0,35,26
1657129232911,MATH 10B,A03,093472,Lim; Seonhee,5,0,34,29
1657129232911,MATH 10B,B01,083739,Sinha; Shubham,9,0,30,21
1657129238937,MATH 18,A01,083743,Cinel; Cameron Alexander,6,0,30,24
1657129238937,MATH 18,A02,083744,Cinel; Cameron Alexander,15,0,30,15
1657129238937,MATH 18,A03,083745,Cinel; Cameron Alexander,8,0,30,22
1657129238937,MATH 18,B01,083748,Rideout; David Porter,4,0,37,33
1657129238937,MATH 18,B02,083749,Rideout; David Porter,3,0,36,33
1657129238937,MATH 18,B03,083750,Rideout; David Porter,2,0,37,35
1657129238937,MATH 18,B04,083751,Rideout; David Porter,5,0,36,31
1657129238937,MATH 18,B05,093473,Rideout; David Porter,4,0,36,32
1657129238937,MATH 18,B06,093474,Rideout; David Porter,5,0,36,31
1657129244968,MATH 20A,A01,083754,Zheng; Zequn,12,0,40,28
1657129250990,MATH 20B,A01,083756,Briones; Jor-el Thomas Caparas,1,0,36,35
1657129250990,MATH 20B,A02,083757,Briones; Jor-el Thomas Caparas,1,0,36,35
1657129250990,MATH 20B,A03,093475,Briones; Jor-el Thomas Caparas,0,0,36,36
1657129257028,MATH 20C,A01,083760,Briones; Jor-el Thomas Caparas,1,0,35,34
1657129257028,MATH 20C,A02,083761,Briones; Jor-el Thomas Caparas,8,0,35,27
1657129257028,MATH 20C,A03,093476,Briones; Jor-el Thomas Caparas,0,1,36,36
1657129257028,MATH 20C,B01,083762,Bach; Quang Tran,0,0,30,30
1657129263051,MATH 20D,A01,083765,Tran; Brian Kha,4,0,30,26
1657129263051,MATH 20D,A02,083766,Tran; Brian Kha,5,0,30,25
1657129263051,MATH 20D,A03,083767,Tran; Brian Kha,3,0,30,27
1657129269075,MATH 20E,A01,083771,Ganguly; Soumya,6,0,32,26
1657129269075,MATH 20E,A02,083772,Ganguly; Soumya,6,0,32,26
1657129269075,MATH 20E,B01,083773,Ciotti; Benjamin,18,0,35,17
1657129269075,MATH 20E,B02,083774,Ciotti; Benjamin,17,0,35,18
1657129275098,MATH 103A,A01,083777,Greenfeld; Be'Eri,2,0,36,34
1657129275098,MATH 103A,A02,083778,Greenfeld; Be'Eri,5,0,36,31
1657129275098,MATH 103A,A03,093561,Greenfeld; Be'Eri,4,0,36,32
1657129275098,MATH 103A,B01,083779,Greenfeld; Be'Eri,6,0,36,30
1657129275098,MATH 103A,B02,083780,Greenfeld; Be'Eri,3,0,36,33
1657129275098,MATH 103A,B03,093562,Greenfeld; Be'Eri,3,0,36,33
1657129281124,MATH 105,A01,085443,Carter; Anne Toulson,14,0,35,21
1657129281124,MATH 105,A02,093477,Carter; Anne Toulson,20,0,35,15
1657129287155,MATH 109,A01,083213,Ganzberger; Geoffrey Michael,2,0,34,32
1657129287155,MATH 109,A02,083214,Ganzberger; Geoffrey Michael,3,0,34,31
1657129287155,MATH 109,A03,093478,Ganzberger; Geoffrey Michael,1,0,34,33
1657129287155,MATH 109,B01,083215,Ganzberger; Geoffrey Michael,1,0,32,31
1657129287155,MATH 109,B02,083216,Ganzberger; Geoffrey Michael,1,0,32,31
1657129287155,MATH 109,B03,093479,Ganzberger; Geoffrey Michael,6,0,32,26
1657129293184,MATH 142A,A01,083219,Chow; Bennett,6,0,32,26
1657129293184,MATH 142A,A02,083220,Chow; Bennett,10,0,32,22
1657129293184,MATH 142A,A03,093480,Chow; Bennett,7,0,32,25
1657129293184,MATH 142A,B03,093481,Chow; Bennett,8,0,32,24
1657129293184,MATH 142A,B04,093558,Chow; Bennett,11,0,32,21
1657129293184,MATH 142A,B05,093559,Chow; Bennett,6,0,32,26
1657129299208,MATH 193A,A01,083224,Rotar; Vladimir,7,0,34,27
1657129299208,MATH 193A,A02,083225,Rotar; Vladimir,5,0,34,29
1657129299208,MATH 193A,A03,083781,Rotar; Vladimir,1,0,34,33
1657129299208,MATH 193A,A04,083782,Rotar; Vladimir,7,0,34,27
1657129299208,MATH 193A,A05,093482,Rotar; Vladimir,6,0,34,28
1657129305231,MATH 197,001,091859,McAuley; Julian John,9999,0,9999,0
1657129305231,MATH 197,002,095566,Kedlaya; Kiran S.,9997,0,9999,2
1657129305231,MATH 197,003,095567,Xiao; Ming,9999,0,9999,0
1657129305231,MATH 197,004,095571,Perols; Johan Lars,9998,0,9999,1
1657129312296,COGS 9,A01,083615,Shannon; Kyle Michael,7,0,75,68
1657129318326,COGS 11,A01,083617,Boyle; Mary E. T.,21,0,48,27
1657129324355,COGS 13,A01,083071,Bastos; Amalia Pinkusfeld,9,0,71,62
1657129330378,COGS 14A,A01,092681,Semenuks; Arturs,1,1,100,99
1657129336407,COGS 14B,A01,083073,Cheng; Tzu-Han,6,0,63,57
1657129342430,COGS 17,A01,092677,Semenuks; Arturs,4,0,81,77
1657129348461,COGS 100,A01,083619,Allen; Michael Gordon,15,0,70,55
1657129354488,COGS 101A,A01,083621,Davis; Joshua Daniel,9,0,68,59
1657129360510,COGS 101B,A01,091572,Allen; Michael Gordon,8,0,65,57
1657129366537,COGS 101C,A01,083625,Delgado; Tania,17,0,35,18
1657129372564,COGS 107A,A01,083627,Boyle; Mary E. T.,13,0,60,47
1657129378593,COGS 118A,A01,083075,Gupta; Anjum,15,0,76,61
1657129384619,CSE 3,A50,083646,Miranda; Gregory Joseph,23,0,50,27
1657129390648,CSE 8A,A50,083650,Miranda; Gregory Joseph,17,1,56,39
1657129396678,CSE 11,A01,083080,Cao; Yingjun,4,15,40,36
1657129402704,CSE 12,A01,083652,Krause-Levy; Sophia Louisa,23,1,120,97
1657129408726,CSE 15L,A01,083654,Morris; Justin Loren,9,0,50,41
1657129408726,CSE 15L,A02,083655,Morris; Justin Loren,9,0,50,41
1657129414749,CSE 20,A01,083657,Tran; Khoa Dang,38,0,80,42
1657129420787,CSE 21,A01,095574,Bach; Quang Tran,21,0,48,27
1657129426815,CSE 30,A01,083084,Eldon; John,4,0,80,76
1657129426815,CSE 30,B01,095061,Bhaskar; Nishant,7,0,50,43
1657129432919,CSE 100,A01,083659,Cao; Yingjun,4,4,70,66
1657129438941,CSE 134B,A01,083661,Powell; Thomas Allan,20,0,100,80
1657129444972,CSE 140,A01,083663,Gungor; Onat,13,0,85,72
1657129451012,CSE 140L,A01,083088,Eldon; John,17,0,100,83
1657129457037,CSE 175,A01,083665,Kumar; Rakesh,3,0,25,22
1657129463059,CSE 190,A00,092507,Dubnov; Shlomo,7,0,20,13
1657129469086,ECE 45,A01,083139,Congero; Spencer William,5,0,75,70
1657129475114,ECE 65,A50,083695,Saad; Andrew S,12,0,30,18
1657129475114,ECE 65,A51,095125,Saad; Andrew S,25,0,26,1
1657129481137,ECE 109,A01,091882,Touri; Behrouz,17,0,70,53
1657129487163,ECE 180,A00,083140,Abi Samra; Nicholas Camill,1,0,30,29
1657129487163,ECE 180,B00,083141,Abi Samra; Nicholas Camill,0,0,30,30
1657129493187,MATH 10A,A01,083735,Patchell; Gregory David,2,0,30,28
1657129493187,MATH 10A,A02,083736,Patchell; Gregory David,20,0,30,10
1657129493187,MATH 10A,A03,083737,Patchell; Gregory David,16,0,30,14
1657129499212,MATH 10B,A01,083207,Lim; Seonhee,7,0,34,27
1657129499212,MATH 10B,A02,083208,Lim; Seonhee,9,0,35,26
1657129499212,MATH 10B,A03,093472,Lim; Seonhee,5,0,34,29
1657129499212,MATH 10B,B01,083739,Sinha; Shubham,9,0,30,21
1657129505236,MATH 18,A01,083743,Cinel; Cameron Alexander,6,0,30,24
1657129505236,MATH 18,A02,083744,Cinel; Cameron Alexander,15,0,30,15
1657129505236,MATH 18,A03,083745,Cinel; Cameron Alexander,8,0,30,22
1657129505236,MATH 18,B01,083748,Rideout; David Porter,4,0,37,33
1657129505236,MATH 18,B02,083749,Rideout; David Porter,3,0,36,33
1657129505236,MATH 18,B03,083750,Rideout; David Porter,2,0,37,35
1657129505236,MATH 18,B04,083751,Rideout; David Porter,5,0,36,31
1657129505236,MATH 18,B05,093473,Rideout; David Porter,4,0,36,32
1657129505236,MATH 18,B06,093474,Rideout; David Porter,5,0,36,31
1657129511276,MATH 20A,A01,083754,Zheng; Zequn,12,0,40,28
1657129517310,MATH 20B,A01,083756,Briones; Jor-el Thomas Caparas,1,0,36,35
1657129517310,MATH 20B,A02,083757,Briones; Jor-el Thomas Caparas,1,0,36,35
1657129517310,MATH 20B,A03,093475,Briones; Jor-el Thomas Caparas,0,0,36,36
1657129523338,MATH 20C,A01,083760,Briones; Jor-el Thomas Caparas,1,0,35,34
1657129523338,MATH 20C,A02,083761,Briones; Jor-el Thomas Caparas,8,0,35,27
1657129523338,MATH 20C,A03,093476,Briones; Jor-el Thomas Caparas,0,1,36,36
1657129523338,MATH 20C,B01,083762,Bach; Quang Tran,0,0,30,30
1657129529363,MATH 20D,A01,083765,Tran; Brian Kha,4,0,30,26
1657129529363,MATH 20D,A02,083766,Tran; Brian Kha,5,0,30,25
1657129529363,MATH 20D,A03,083767,Tran; Brian Kha,3,0,30,27
1657129535391,MATH 20E,A01,083771,Ganguly; Soumya,6,0,32,26
1657129535391,MATH 20E,A02,083772,Ganguly; Soumya,6,0,32,26
1657129535391,MATH 20E,B01,083773,Ciotti; Benjamin,18,0,35,17
1657129535391,MATH 20E,B02,083774,Ciotti; Benjamin,17,0,35,18
1657129541416,MATH 103A,A01,083777,Greenfeld; Be'Eri,2,0,36,34
1657129541416,MATH 103A,A02,083778,Greenfeld; Be'Eri,5,0,36,31
1657129541416,MATH 103A,A03,093561,Greenfeld; Be'Eri,4,0,36,32
1657129541416,MATH 103A,B01,083779,Greenfeld; Be'Eri,6,0,36,30
1657129541416,MATH 103A,B02,083780,Greenfeld; Be'Eri,3,0,36,33
1657129541416,MATH 103A,B03,093562,Greenfeld; Be'Eri,3,0,36,33
1657129547457,MATH 105,A01,085443,Carter; Anne Toulson,14,0,35,21
1657129547457,MATH 105,A02,093477,Carter; Anne Toulson,20,0,35,15
1657129553486,MATH 109,A01,083213,Ganzberger; Geoffrey Michael,2,0,34,32
1657129553486,MATH 109,A02,083214,Ganzberger; Geoffrey Michael,3,0,34,31
1657129553486,MATH 109,A03,093478,Ganzberger; Geoffrey Michael,1,0,34,33
1657129553486,MATH 109,B01,083215,Ganzberger; Geoffrey Michael,1,0,32,31
1657129553486,MATH 109,B02,083216,Ganzberger; Geoffrey Michael,1,0,32,31
1657129553486,MATH 109,B03,093479,Ganzberger; Geoffrey Michael,6,0,32,26
1657129559510,MATH 142A,A01,083219,Chow; Bennett,6,0,32,26
1657129559510,MATH 142A,A02,083220,Chow; Bennett,10,0,32,22
1657129559510,MATH 142A,A03,093480,Chow; Bennett,7,0,32,25
1657129559510,MATH 142A,B03,093481,Chow; Bennett,8,0,32,24
1657129559510,MATH 142A,B04,093558,Chow; Bennett,11,0,32,21
1657129559510,MATH 142A,B05,093559,Chow; Bennett,6,0,32,26
1657129565532,MATH 193A,A01,083224,Rotar; Vladimir,7,0,34,27
1657129565532,MATH 193A,A02,083225,Rotar; Vladimir,5,0,34,29
1657129565532,MATH 193A,A03,083781,Rotar; Vladimir,1,0,34,33
1657129565532,MATH 193A,A04,083782,Rotar; Vladimir,7,0,34,27
1657129565532,MATH 193A,A05,093482,Rotar; Vladimir,6,0,34,28
1657129571563,MATH 197,001,091859,McAuley; Julian John,9999,0,9999,0
1657129571563,MATH 197,002,095566,Kedlaya; Kiran S.,9997,0,9999,2
1657129571563,MATH 197,003,095567,Xiao; Ming,9999,0,9999,0
1657129571563,MATH 197,004,095571,Perols; Johan Lars,9998,0,9999,1
1657129578634,COGS 9,A01,083615,Shannon; Kyle Michael,7,0,75,68
1657129584662,COGS 11,A01,083617,Boyle; Mary E. T.,21,0,48,27
1657129590685,COGS 13,A01,083071,Bastos; Amalia Pinkusfeld,9,0,71,62
1657129596710,COGS 14A,A01,092681,Semenuks; Arturs,1,1,100,99
1657129602744,COGS 14B,A01,083073,Cheng; Tzu-Han,6,0,63,57
1657129608772,COGS 17,A01,092677,Semenuks; Arturs,4,0,81,77
1657129614794,COGS 100,A01,083619,Allen; Michael Gordon,15,0,70,55
1657129620817,COGS 101A,A01,083621,Davis; Joshua Daniel,9,0,68,59
1657129626844,COGS 101B,A01,091572,Allen; Michael Gordon,8,0,65,57
1657129632869,COGS 101C,A01,083625,Delgado; Tania,17,0,35,18
1657129638895,COGS 107A,A01,083627,Boyle; Mary E. T.,13,0,60,47
1657129644918,COGS 118A,A01,083075,Gupta; Anjum,15,0,76,61
1657129650940,CSE 3,A50,083646,Miranda; Gregory Joseph,23,0,50,27
1657129656969,CSE 8A,A50,083650,Miranda; Gregory Joseph,17,1,56,39
1657129662992,CSE 11,A01,083080,Cao; Yingjun,4,15,40,36
1657129669022,CSE 12,A01,083652,Krause-Levy; Sophia Louisa,23,1,120,97
1657129675046,CSE 15L,A01,083654,Morris; Justin Loren,9,0,50,41
1657129675046,CSE 15L,A02,083655,Morris; Justin Loren,9,0,50,41
1657129681070,CSE 20,A01,083657,Tran; Khoa Dang,38,0,80,42
1657129687093,CSE 21,A01,095574,Bach; Quang Tran,21,0,48,27
1657129693117,CSE 30,A01,083084,Eldon; John,4,0,80,76
1657129693117,CSE 30,B01,095061,Bhaskar; Nishant,7,0,50,43
1657129699143,CSE 100,A01,083659,Cao; Yingjun,4,4,70,66
1657129705179,CSE 134B,A01,083661,Powell; Thomas Allan,20,0,100,80
1657129711206,CSE 140,A01,083663,Gungor; Onat,13,0,85,72
1657129717230,CSE 140L,A01,083088,Eldon; John,17,0,100,83
1657129723256,CSE 175,A01,083665,Kumar; Rakesh,3,0,25,22
1657129729287,CSE 190,A00,092507,Dubnov; Shlomo,7,0,20,13
1657129735317,ECE 45,A01,083139,Congero; Spencer William,5,0,75,70
1657129741341,ECE 65,A50,083695,Saad; Andrew S,12,0,30,18
1657129741341,ECE 65,A51,095125,Saad; Andrew S,25,0,26,1
1657129747376,ECE 109,A01,091882,Touri; Behrouz,17,0,70,53
1657129753403,ECE 180,A00,083140,Abi Samra; Nicholas Camill,1,0,30,29
1657129753403,ECE 180,B00,083141,Abi Samra; Nicholas Camill,0,0,30,30
1657129759435,MATH 10A,A01,083735,Patchell; Gregory David,2,0,30,28
1657129759435,MATH 10A,A02,083736,Patchell; Gregory David,20,0,30,10
1657129759435,MATH 10A,A03,083737,Patchell; Gregory David,16,0,30,14
1657129765464,MATH 10B,A01,083207,Lim; Seonhee,7,0,34,27
1657129765464,MATH 10B,A02,083208,Lim; Seonhee,9,0,35,26
1657129765464,MATH 10B,A03,093472,Lim; Seonhee,5,0,34,29
1657129765464,MATH 10B,B01,083739,Sinha; Shubham,9,0,30,21
1657129771494,MATH 18,A01,083743,Cinel; Cameron Alexander,6,0,30,24
1657129771494,MATH 18,A02,083744,Cinel; Cameron Alexander,15,0,30,15
1657129771494,MATH 18,A03,083745,Cinel; Cameron Alexander,8,0,30,22
1657129771494,MATH 18,B01,083748,Rideout; David Porter,4,0,37,33
1657129771494,MATH 18,B02,083749,Rideout; David Porter,3,0,36,33
1657129771494,MATH 18,B03,083750,Rideout; David Porter,2,0,37,35
1657129771494,MATH 18,B04,083751,Rideout; David Porter,5,0,36,31
1657129771494,MATH 18,B05,093473,Rideout; David Porter,4,0,36,32
1657129771494,MATH 18,B06,093474,Rideout; David Porter,5,0,36,31
1657129777521,MATH 20A,A01,083754,Zheng; Zequn,12,0,40,28
1657129783555,MATH 20B,A01,083756,Briones; Jor-el Thomas Caparas,1,0,36,35
1657129783555,MATH 20B,A02,083757,Briones; Jor-el Thomas Caparas,1,0,36,35
1657129783555,MATH 20B,A03,093475,Briones; Jor-el Thomas Caparas,0,0,36,36
1657129789583,MATH 20C,A01,083760,Briones; Jor-el Thomas Caparas,1,0,35,34
1657129789583,MATH 20C,A02,083761,Briones; Jor-el Thomas Caparas,8,0,35,27
1657129789583,MATH 20C,A03,093476,Briones; Jor-el Thomas Caparas,0,1,36,36
1657129789583,MATH 20C,B01,083762,Bach; Quang Tran,0,0,30,30
1657129795609,MATH 20D,A01,083765,Tran; Brian Kha,4,0,30,26
1657129795609,MATH 20D,A02,083766,Tran; Brian Kha,5,0,30,25
1657129795609,MATH 20D,A03,083767,Tran; Brian Kha,3,0,30,27
1657129801644,MATH 20E,A01,083771,Ganguly; Soumya,6,0,32,26
1657129801644,MATH 20E,A02,083772,Ganguly; Soumya,6,0,32,26
1657129801644,MATH 20E,B01,083773,Ciotti; Benjamin,18,0,35,17
1657129801644,MATH 20E,B02,083774,Ciotti; Benjamin,17,0,35,18
1657129807673,MATH 103A,A01,083777,Greenfeld; Be'Eri,2,0,36,34
1657129807673,MATH 103A,A02,083778,Greenfeld; Be'Eri,5,0,36,31
1657129807673,MATH 103A,A03,093561,Greenfeld; Be'Eri,4,0,36,32
1657129807673,MATH 103A,B01,083779,Greenfeld; Be'Eri,6,0,36,30
1657129807673,MATH 103A,B02,083780,Greenfeld; Be'Eri,3,0,36,33
1657129807673,MATH 103A,B03,093562,Greenfeld; Be'Eri,3,0,36,33
1657129813699,MATH 105,A01,085443,Carter; Anne Toulson,14,0,35,21
1657129813699,MATH 105,A02,093477,Carter; Anne Toulson,20,0,35,15
1657129819724,MATH 109,A01,083213,Ganzberger; Geoffrey Michael,2,0,34,32
1657129819724,MATH 109,A02,083214,Ganzberger; Geoffrey Michael,3,0,34,31
1657129819724,MATH 109,A03,093478,Ganzberger; Geoffrey Michael,1,0,34,33
1657129819724,MATH 109,B01,083215,Ganzberger; Geoffrey Michael,1,0,32,31
1657129819724,MATH 109,B02,083216,Ganzberger; Geoffrey Michael,1,0,32,31
1657129819724,MATH 109,B03,093479,Ganzberger; Geoffrey Michael,6,0,32,26
1657129825747,MATH 142A,A01,083219,Chow; Bennett,6,0,32,26
1657129825747,MATH 142A,A02,083220,Chow; Bennett,10,0,32,22
1657129825747,MATH 142A,A03,093480,Chow; Bennett,7,0,32,25
1657129825747,MATH 142A,B03,093481,Chow; Bennett,8,0,32,24
1657129825747,MATH 142A,B04,093558,Chow; Bennett,11,0,32,21
1657129825747,MATH 142A,B05,093559,Chow; Bennett,6,0,32,26
1657129831771,MATH 193A,A01,083224,Rotar; Vladimir,7,0,34,27
1657129831771,MATH 193A,A02,083225,Rotar; Vladimir,5,0,34,29
1657129831771,MATH 193A,A03,083781,Rotar; Vladimir,1,0,34,33
1657129831771,MATH 193A,A04,083782,Rotar; Vladimir,7,0,34,27
1657129831771,MATH 193A,A05,093482,Rotar; Vladimir,6,0,34,28
1657129837793,MATH 197,001,091859,McAuley; Julian John,9999,0,9999,0
1657129837793,MATH 197,002,095566,Kedlaya; Kiran S.,9997,0,9999,2
1657129837793,MATH 197,003,095567,Xiao; Ming,9999,0,9999,0
1657129837793,MATH 197,004,095571,Perols; Johan Lars,9998,0,9999,1
1657129844847,COGS 9,A01,083615,Shannon; Kyle Michael,7,0,75,68
1657129850874,COGS 11,A01,083617,Boyle; Mary E. T.,21,0,48,27
1657129856896,COGS 13,A01,083071,Bastos; Amalia Pinkusfeld,9,0,71,62
1657129862930,COGS 14A,A01,092681,Semenuks; Arturs,1,1,100,99
1657129868967,COGS 14B,A01,083073,Cheng; Tzu-Han,6,0,63,57
1657129874988,COGS 17,A01,092677,Semenuks; Arturs,4,0,81,77
1657129881011,COGS 100,A01,083619,Allen; Michael Gordon,15,0,70,55
1657129887038,COGS 101A,A01,083621,Davis; Joshua Daniel,9,0,68,59
1657129893061,COGS 101B,A01,091572,Allen; Michael Gordon,8,0,65,57
1657129899088,COGS 101C,A01,083625,Delgado; Tania,17,0,35,18
1657129905114,COGS 107A,A01,083627,Boyle; Mary E. T.,13,0,60,47
1657129911144,COGS 118A,A01,083075,Gupta; Anjum,15,0,76,61
1657129917168,CSE 3,A50,083646,Miranda; Gregory Joseph,23,0,50,27
1657129923198,CSE 8A,A50,083650,Miranda; Gregory Joseph,17,1,56,39
1657129929224,CSE 11,A01,083080,Cao; Yingjun,4,15,40,36
1657129935248,CSE 12,A01,083652,Krause-Levy; Sophia Louisa,23,1,120,97
1657129941286,CSE 15L,A01,083654,Morris; Justin Loren,9,0,50,41
1657129941286,CSE 15L,A02,083655,Morris; Justin Loren,9,0,50,41
1657129947310,CSE 20,A01,083657,Tran; Khoa Dang,38,0,80,42
1657129953361,CSE 21,A01,095574,Bach; Quang Tran,21,0,48,27
1657129959386,CSE 30,A01,083084,Eldon; John,4,0,80,76
1657129959386,CSE 30,B01,095061,Bhaskar; Nishant,7,0,50,43
1657129965409,CSE 100,A01,083659,Cao; Yingjun,4,4,70,66
1657129971440,CSE 134B,A01,083661,Powell; Thomas Allan,20,0,100,80
1657129977463,CSE 140,A01,083663,Gungor; Onat,13,0,85,72
1657129983488,CSE 140L,A01,083088,Eldon; John,17,0,100,83
1657129989512,CSE 175,A01,083665,Kumar; Rakesh,3,0,25,22
1657129995539,CSE 190,A00,092507,Dubnov; Shlomo,7,0,20,13
1657130001564,ECE 45,A01,083139,Congero; Spencer William,5,0,75,70
1657130007597,ECE 65,A50,083695,Saad; Andrew S,12,0,30,18
1657130007597,ECE 65,A51,095125,Saad; Andrew S,25,0,26,1
1657130013631,ECE 109,A01,091882,Touri; Behrouz,17,0,70,53
1657130019653,ECE 180,A00,083140,Abi Samra; Nicholas Camill,1,0,30,29
1657130019653,ECE 180,B00,083141,Abi Samra; Nicholas Camill,0,0,30,30
1657130025682,MATH 10A,A01,083735,Patchell; Gregory David,2,0,30,28
1657130025682,MATH 10A,A02,083736,Patchell; Gregory David,20,0,30,10
1657130025682,MATH 10A,A03,083737,Patchell; Gregory David,16,0,30,14
1657130031792,MATH 10B,A01,083207,Lim; Seonhee,7,0,34,27
1657130031792,MATH 10B,A02,083208,Lim; Seonhee,9,0,35,26
1657130031792,MATH 10B,A03,093472,Lim; Seonhee,5,0,34,29
1657130031792,MATH 10B,B01,083739,Sinha; Shubham,9,0,30,21
1657130037823,MATH 18,A01,083743,Cinel; Cameron Alexander,6,0,30,24
1657130037823,MATH 18,A02,083744,Cinel; Cameron Alexander,15,0,30,15
1657130037823,MATH 18,A03,083745,Cinel; Cameron Alexander,8,0,30,22
1657130037823,MATH 18,B01,083748,Rideout; David Porter,4,0,37,33
1657130037823,MATH 18,B02,083749,Rideout; David Porter,3,0,36,33
1657130037823,MATH 18,B03,083750,Rideout; David Porter,2,0,37,35
1657130037823,MATH 18,B04,083751,Rideout; David Porter,5,0,36,31
1657130037823,MATH 18,B05,093473,Rideout; David Porter,4,0,36,32
1657130037823,MATH 18,B06,093474,Rideout; David Porter,5,0,36,31
1657130043856,MATH 20A,A01,083754,Zheng; Zequn,12,0,40,28
1657130049884,MATH 20B,A01,083756,Briones; Jor-el Thomas Caparas,1,0,36,35
1657130049884,MATH 20B,A02,083757,Briones; Jor-el Thomas Caparas,1,0,36,35
1657130049884,MATH 20B,A03,093475,Briones; Jor-el Thomas Caparas,0,0,36,36
1657130055907,MATH 20C,A01,083760,Briones; Jor-el Thomas Caparas,1,0,35,34
1657130055907,MATH 20C,A02,083761,Briones; Jor-el Thomas Caparas,8,0,35,27
1657130055907,MATH 20C,A03,093476,Briones; Jor-el Thomas Caparas,0,1,36,36
1657130055907,MATH 20C,B01,083762,Bach; Quang Tran,0,0,30,30
1657130061930,MATH 20D,A01,083765,Tran; Brian Kha,4,0,30,26
1657130061930,MATH 20D,A02,083766,Tran; Brian Kha,5,0,30,25
1657130061930,MATH 20D,A03,083767,Tran; Brian Kha,3,0,30,27
1657130067964,MATH 20E,A01,083771,Ganguly; Soumya,6,0,32,26
1657130067964,MATH 20E,A02,083772,Ganguly; Soumya,6,0,32,26
1657130067964,MATH 20E,B01,083773,Ciotti; Benjamin,18,0,35,17
1657130067964,MATH 20E,B02,083774,Ciotti; Benjamin,17,0,35,18
1657130073989,MATH 103A,A01,083777,Greenfeld; Be'Eri,2,0,36,34
1657130073989,MATH 103A,A02,083778,Greenfeld; Be'Eri,5,0,36,31
1657130073989,MATH 103A,A03,093561,Greenfeld; Be'Eri,4,0,36,32
1657130073989,MATH 103A,B01,083779,Greenfeld; Be'Eri,6,0,36,30
1657130073989,MATH 103A,B02,083780,Greenfeld; Be'Eri,3,0,36,33
1657130073989,MATH 103A,B03,093562,Greenfeld; Be'Eri,3,0,36,33
1657130080018,MATH 105,A01,085443,Carter; Anne Toulson,14,0,35,21
1657130080018,MATH 105,A02,093477,Carter; Anne Toulson,20,0,35,15
1657130086042,MATH 109,A01,083213,Ganzberger; Geoffrey Michael,2,0,34,32
1657130086042,MATH 109,A02,083214,Ganzberger; Geoffrey Michael,3,0,34,31
1657130086042,MATH 109,A03,093478,Ganzberger; Geoffrey Michael,1,0,34,33
1657130086042,MATH 109,B01,083215,Ganzberger; Geoffrey Michael,1,0,32,31
1657130086042,MATH 109,B02,083216,Ganzberger; Geoffrey Michael,1,0,32,31
1657130086042,MATH 109,B03,093479,Ganzberger; Geoffrey Michael,6,0,32,26
1657130092070,MATH 142A,A01,083219,Chow; Bennett,6,0,32,26
1657130092070,MATH 142A,A02,083220,Chow; Bennett,10,0,32,22
1657130092070,MATH 142A,A03,093480,Chow; Bennett,7,0,32,25
1657130092070,MATH 142A,B03,093481,Chow; Bennett,8,0,32,24
1657130092070,MATH 142A,B04,093558,Chow; Bennett,11,0,32,21
1657130092070,MATH 142A,B05,093559,Chow; Bennett,6,0,32,26
1657130098093,MATH 193A,A01,083224,Rotar; Vladimir,7,0,34,27
1657130098093,MATH 193A,A02,083225,Rotar; Vladimir,5,0,34,29
1657130098093,MATH 193A,A03,083781,Rotar; Vladimir,1,0,34,33
1657130098093,MATH 193A,A04,083782,Rotar; Vladimir,7,0,34,27
1657130098093,MATH 193A,A05,093482,Rotar; Vladimir,6,0,34,28
1657130104116,MATH 197,001,091859,McAuley; Julian John,9999,0,9999,0
1657130104116,MATH 197,002,095566,Kedlaya; Kiran S.,9997,0,9999,2
1657130104116,MATH 197,003,095567,Xiao; Ming,9999,0,9999,0
1657130104116,MATH 197,004,095571,Perols; Johan Lars,9998,0,9999,1
1657130111189,COGS 9,A01,083615,Shannon; Kyle Michael,7,0,75,68
1657130117230,COGS 11,A01,083617,Boyle; Mary E. T.,21,0,48,27
1657130123269,COGS 13,A01,083071,Bastos; Amalia Pinkusfeld,9,0,71,62
1657130129292,COGS 14A,A01,092681,Semenuks; Arturs,1,1,100,99
1657130135326,COGS 14B,A01,083073,Cheng; Tzu-Han,6,0,63,57
1657130141354,COGS 17,A01,092677,Semenuks; Arturs,4,0,81,77
1657130147376,COGS 100,A01,083619,Allen; Michael Gordon,15,0,70,55
1657130153403,COGS 101A,A01,083621,Davis; Joshua Daniel,9,0,68,59
1657130159428,COGS 101B,A01,091572,Allen; Michael Gordon,9,0,65,56
1657130165451,COGS 101C,A01,083625,Delgado; Tania,17,0,35,18
1657130171480,COGS 107A,A01,083627,Boyle; Mary E. T.,13,0,60,47
1657130177508,COGS 118A,A01,083075,Gupta; Anjum,15,0,76,61
1657130183533,CSE 3,A50,083646,Miranda; Gregory Joseph,23,0,50,27
1657130189564,CSE 8A,A50,083650,Miranda; Gregory Joseph,17,1,56,39
1657130195586,CSE 11,A01,083080,Cao; Yingjun,4,15,40,36
1657130201609,CSE 12,A01,083652,Krause-Levy; Sophia Louisa,23,1,120,97
1657130207636,CSE 15L,A01,083654,Morris; Justin Loren,9,0,50,41
1657130207636,CSE 15L,A02,083655,Morris; Justin Loren,9,0,50,41
1657130213663,CSE 20,A01,083657,Tran; Khoa Dang,38,0,80,42
1657130219686,CSE 21,A01,095574,Bach; Quang Tran,21,0,48,27
1657130225709,CSE 30,A01,083084,Eldon; John,4,0,80,76
1657130225709,CSE 30,B01,095061,Bhaskar; Nishant,7,0,50,43
1657130231737,CSE 100,A01,083659,Cao; Yingjun,4,4,70,66
1657130237760,CSE 134B,A01,083661,Powell; Thomas Allan,20,0,100,80
1657130243786,CSE 140,A01,083663,Gungor; Onat,13,0,85,72
1657130249811,CSE 140L,A01,083088,Eldon; John,17,0,100,83
1657130255847,CSE 175,A01,083665,Kumar; Rakesh,3,0,25,22
1657130261870,CSE 190,A00,092507,Dubnov; Shlomo,7,0,20,13
1657130267898,ECE 45,A01,083139,Congero; Spencer William,5,0,75,70
1657130273930,ECE 65,A50,083695,Saad; Andrew S,12,0,30,18
1657130273930,ECE 65,A51,095125,Saad; Andrew S,25,0,26,1
1657130279954,ECE 109,A01,091882,Touri; Behrouz,17,0,70,53
1657130285981,ECE 180,A00,083140,Abi Samra; Nicholas Camill,1,0,30,29
1657130285981,ECE 180,B00,083141,Abi Samra; Nicholas Camill,0,0,30,30
1657130292005,MATH 10A,A01,083735,Patchell; Gregory David,2,0,30,28
1657130292005,MATH 10A,A02,083736,Patchell; Gregory David,20,0,30,10
1657130292005,MATH 10A,A03,083737,Patchell; Gregory David,16,0,30,14
1657130298035,MATH 10B,A01,083207,Lim; Seonhee,7,0,34,27
1657130298035,MATH 10B,A02,083208,Lim; Seonhee,9,0,35,26
1657130298035,MATH 10B,A03,093472,Lim; Seonhee,5,0,34,29
1657130298035,MATH 10B,B01,083739,Sinha; Shubham,9,0,30,21
1657130304065,MATH 18,A01,083743,Cinel; Cameron Alexander,6,0,30,24
1657130304065,MATH 18,A02,083744,Cinel; Cameron Alexander,15,0,30,15
1657130304065,MATH 18,A03,083745,Cinel; Cameron Alexander,8,0,30,22
1657130304065,MATH 18,B01,083748,Rideout; David Porter,4,0,37,33
1657130304065,MATH 18,B02,083749,Rideout; David Porter,3,0,36,33
1657130304065,MATH 18,B03,083750,Rideout; David Porter,2,0,37,35
1657130304065,MATH 18,B04,083751,Rideout; David Porter,5,0,36,31
1657130304065,MATH 18,B05,093473,Rideout; David Porter,4,0,36,32
1657130304065,MATH 18,B06,093474,Rideout; David Porter,5,0,36,31
1657130310091,MATH 20A,A01,083754,Zheng; Zequn,12,0,40,28
1657130316118,MATH 20B,A01,083756,Briones; Jor-el Thomas Caparas,1,0,36,35
1657130316118,MATH 20B,A02,083757,Briones; Jor-el Thomas Caparas,1,0,36,35
1657130316118,MATH 20B,A03,093475,Briones; Jor-el Thomas Caparas,0,0,36,36
1657130322141,MATH 20C,A01,083760,Briones; Jor-el Thomas Caparas,1,0,35,34
1657130322141,MATH 20C,A02,083761,Briones; Jor-el Thomas Caparas,8,0,35,27
1657130322141,MATH 20C,A03,093476,Briones; Jor-el Thomas Caparas,0,1,36,36
1657130322141,MATH 20C,B01,083762,Bach; Quang Tran,0,0,30,30
1657130328169,MATH 20D,A01,083765,Tran; Brian Kha,4,0,30,26
1657130328169,MATH 20D,A02,083766,Tran; Brian Kha,5,0,30,25
1657130328169,MATH 20D,A03,083767,Tran; Brian Kha,3,0,30,27
1657130334196,MATH 20E,A01,083771,Ganguly; Soumya,6,0,32,26
1657130334196,MATH 20E,A02,083772,Ganguly; Soumya,6,0,32,26
1657130334196,MATH 20E,B01,083773,Ciotti; Benjamin,18,0,35,17
1657130334196,MATH 20E,B02,083774,Ciotti; Benjamin,17,0,35,18
1657130340236,MATH 103A,A01,083777,Greenfeld; Be'Eri,2,0,36,34
1657130340236,MATH 103A,A02,083778,Greenfeld; Be'Eri,5,0,36,31
1657130340236,MATH 103A,A03,093561,Greenfeld; Be'Eri,4,0,36,32
1657130340236,MATH 103A,B01,083779,Greenfeld; Be'Eri,6,0,36,30
1657130340236,MATH 103A,B02,083780,Greenfeld; Be'Eri,3,0,36,33
1657130340236,MATH 103A,B03,093562,Greenfeld; Be'Eri,3,0,36,33
1657130346264,MATH 105,A01,085443,Carter; Anne Toulson,14,0,35,21
1657130346264,MATH 105,A02,093477,Carter; Anne Toulson,20,0,35,15
1657130352295,MATH 109,A01,083213,Ganzberger; Geoffrey Michael,2,0,34,32
1657130352295,MATH 109,A02,083214,Ganzberger; Geoffrey Michael,3,0,34,31
1657130352295,MATH 109,A03,093478,Ganzberger; Geoffrey Michael,1,0,34,33
1657130352295,MATH 109,B01,083215,Ganzberger; Geoffrey Michael,1,0,32,31
1657130352295,MATH 109,B02,083216,Ganzberger; Geoffrey Michael,1,0,32,31
1657130352295,MATH 109,B03,093479,Ganzberger; Geoffrey Michael,6,0,32,26
1657130358320,MATH 142A,A01,083219,Chow; Bennett,6,0,32,26
1657130358320,MATH 142A,A02,083220,Chow; Bennett,10,0,32,22
1657130358320,MATH 142A,A03,093480,Chow; Bennett,7,0,32,25
1657130358320,MATH 142A,B03,093481,Chow; Bennett,8,0,32,24
1657130358320,MATH 142A,B04,093558,Chow; Bennett,11,0,32,21
1657130358320,MATH 142A,B05,093559,Chow; Bennett,6,0,32,26
1657130364374,MATH 193A,A01,083224,Rotar; Vladimir,7,0,34,27
1657130364374,MATH 193A,A02,083225,Rotar; Vladimir,5,0,34,29
1657130364374,MATH 193A,A03,083781,Rotar; Vladimir,1,0,34,33
1657130364374,MATH 193A,A04,083782,Rotar; Vladimir,7,0,34,27
1657130364374,MATH 193A,A05,093482,Rotar; Vladimir,6,0,34,28
1657130370396,MATH 197,001,091859,McAuley; Julian John,9999,0,9999,0
1657130370396,MATH 197,002,095566,Kedlaya; Kiran S.,9997,0,9999,2
1657130370396,MATH 197,003,095567,Xiao; Ming,9999,0,9999,0
1657130370396,MATH 197,004,095571,Perols; Johan Lars,9998,0,9999,1
1657130377456,COGS 9,A01,083615,Shannon; Kyle Michael,7,0,75,68
1657130383480,COGS 11,A01,083617,Boyle; Mary E. T.,21,0,48,27
1657130389503,COGS 13,A01,083071,Bastos; Amalia Pinkusfeld,9,0,71,62
1657130395530,COGS 14A,A01,092681,Semenuks; Arturs,1,1,100,99
1657130401556,COGS 14B,A01,083073,Cheng; Tzu-Han,6,0,63,57
1657130407581,COGS 17,A01,092677,Semenuks; Arturs,4,0,81,77
1657130413606,COGS 100,A01,083619,Allen; Michael Gordon,15,0,70,55
1657130419628,COGS 101A,A01,083621,Davis; Joshua Daniel,9,0,68,59
1657130425663,COGS 101B,A01,091572,Allen; Michael Gordon,9,0,65,56
1657130431688,COGS 101C,A01,083625,Delgado; Tania,17,0,35,18
1657130437715,COGS 107A,A01,083627,Boyle; Mary E. T.,13,0,60,47
1657130443743,COGS 118A,A01,083075,Gupta; Anjum,15,0,76,61
1657130449765,CSE 3,A50,083646,Miranda; Gregory Joseph,23,0,50,27
1657130455788,CSE 8A,A50,083650,Miranda; Gregory Joseph,17,1,56,39
1657130461810,CSE 11,A01,083080,Cao; Yingjun,4,15,40,36
1657130467832,CSE 12,A01,083652,Krause-Levy; Sophia Louisa,23,1,120,97
1657130473855,CSE 15L,A01,083654,Morris; Justin Loren,9,0,50,41
1657130473855,CSE 15L,A02,083655,Morris; Justin Loren,9,0,50,41
1657130479882,CSE 20,A01,083657,Tran; Khoa Dang,38,0,80,42
1657130485911,CSE 21,A01,095574,Bach; Quang Tran,21,0,48,27
1657130491938,CSE 30,A01,083084,Eldon; John,4,0,80,76
1657130491938,CSE 30,B01,095061,Bhaskar; Nishant,7,0,50,43
1657130497961,CSE 100,A01,083659,Cao; Yingjun,4,4,70,66
1657130503991,CSE 134B,A01,083661,Powell; Thomas Allan,20,0,100,80
1657130510032,CSE 140,A01,083663,Gungor; Onat,13,0,85,72
1657130516065,CSE 140L,A01,083088,Eldon; John,17,0,100,83
1657130522094,CSE 175,A01,083665,Kumar; Rakesh,3,0,25,22
1657130528122,CSE 190,A00,092507,Dubnov; Shlomo,7,0,20,13
1657130534147,ECE 45,A01,083139,Congero; Spencer William,5,0,75,70
1657130540171,ECE 65,A50,083695,Saad; Andrew S,12,0,30,18
1657130540171,ECE 65,A51,095125,Saad; Andrew S,25,0,26,1
1657130546205,ECE 109,A01,091882,Touri; Behrouz,17,0,70,53
1657130552230,ECE 180,A00,083140,Abi Samra; Nicholas Camill,1,0,30,29
1657130552230,ECE 180,B00,083141,Abi Samra; Nicholas Camill,0,0,30,30
1657130558263,MATH 10A,A01,083735,Patchell; Gregory David,2,0,30,28
1657130558263,MATH 10A,A02,083736,Patchell; Gregory David,20,0,30,10
1657130558263,MATH 10A,A03,083737,Patchell; Gregory David,16,0,30,14
1657130564291,MATH 10B,A01,083207,Lim; Seonhee,7,0,34,27
1657130564291,MATH 10B,A02,083208,Lim; Seonhee,9,0,35,26
1657130564291,MATH 10B,A03,093472,Lim; Seonhee,5,0,34,29
1657130564291,MATH 10B,B01,083739,Sinha; Shubham,9,0,30,21
1657130570320,MATH 18,A01,083743,Cinel; Cameron Alexander,6,0,30,24
1657130570320,MATH 18,A02,083744,Cinel; Cameron Alexander,15,0,30,15
1657130570320,MATH 18,A03,083745,Cinel; Cameron Alexander,8,0,30,22
1657130570320,MATH 18,B01,083748,Rideout; David Porter,4,0,37,33
1657130570320,MATH 18,B02,083749,Rideout; David Porter,3,0,36,33
1657130570320,MATH 18,B03,083750,Rideout; David Porter,2,0,37,35
1657130570320,MATH 18,B04,083751,Rideout; David Porter,5,0,36,31
1657130570320,MATH 18,B05,093473,Rideout; David Porter,4,0,36,32
1657130570320,MATH 18,B06,093474,Rideout; David Porter,5,0,36,31
1657130576350,MATH 20A,A01,083754,Zheng; Zequn,12,0,40,28
1657130582375,MATH 20B,A01,083756,Briones; Jor-el Thomas Caparas,1,0,36,35
1657130582375,MATH 20B,A02,083757,Briones; Jor-el Thomas Caparas,1,0,36,35
1657130582375,MATH 20B,A03,093475,Briones; Jor-el Thomas Caparas,0,0,36,36
1657130588405,MATH 20C,A01,083760,Briones; Jor-el Thomas Caparas,1,0,35,34
1657130588405,MATH 20C,A02,083761,Briones; Jor-el Thomas Caparas,8,0,35,27
1657130588405,MATH 20C,A03,093476,Briones; Jor-el Thomas Caparas,0,1,36,36
1657130588405,MATH 20C,B01,083762,Bach; Quang Tran,0,0,30,30
1657130594428,MATH 20D,A01,083765,Tran; Brian Kha,4,0,30,26
1657130594428,MATH 20D,A02,083766,Tran; Brian Kha,5,0,30,25
1657130594428,MATH 20D,A03,083767,Tran; Brian Kha,3,0,30,27
1657130600450,MATH 20E,A01,083771,Ganguly; Soumya,6,0,32,26
1657130600450,MATH 20E,A02,083772,Ganguly; Soumya,6,0,32,26
1657130600450,MATH 20E,B01,083773,Ciotti; Benjamin,18,0,35,17
1657130600450,MATH 20E,B02,083774,Ciotti; Benjamin,17,0,35,18
1657130606479,MATH 103A,A01,083777,Greenfeld; Be'Eri,2,0,36,34
1657130606479,MATH 103A,A02,083778,Greenfeld; Be'Eri,5,0,36,31
1657130606479,MATH 103A,A03,093561,Greenfeld; Be'Eri,4,0,36,32
1657130606479,MATH 103A,B01,083779,Greenfeld; Be'Eri,6,0,36,30
1657130606479,MATH 103A,B02,083780,Greenfeld; Be'Eri,3,0,36,33
1657130606479,MATH 103A,B03,093562,Greenfeld; Be'Eri,3,0,36,33
1657130612502,MATH 105,A01,085443,Carter; Anne Toulson,14,0,35,21
1657130612502,MATH 105,A02,093477,Carter; Anne Toulson,20,0,35,15
1657130618531,MATH 109,A01,083213,Ganzberger; Geoffrey Michael,2,0,34,32
1657130618531,MATH 109,A02,083214,Ganzberger; Geoffrey Michael,3,0,34,31
1657130618531,MATH 109,A03,093478,Ganzberger; Geoffrey Michael,1,0,34,33
1657130618531,MATH 109,B01,083215,Ganzberger; Geoffrey Michael,1,0,32,31
1657130618531,MATH 109,B02,083216,Ganzberger; Geoffrey Michael,1,0,32,31
1657130618531,MATH 109,B03,093479,Ganzberger; Geoffrey Michael,6,0,32,26
1657130624556,MATH 142A,A01,083219,Chow; Bennett,6,0,32,26
1657130624556,MATH 142A,A02,083220,Chow; Bennett,10,0,32,22
1657130624556,MATH 142A,A03,093480,Chow; Bennett,7,0,32,25
1657130624556,MATH 142A,B03,093481,Chow; Bennett,8,0,32,24
1657130624556,MATH 142A,B04,093558,Chow; Bennett,11,0,32,21
1657130624556,MATH 142A,B05,093559,Chow; Bennett,6,0,32,26
1657130630658,MATH 193A,A01,083224,Rotar; Vladimir,7,0,34,27
1657130630658,MATH 193A,A02,083225,Rotar; Vladimir,5,0,34,29
1657130630658,MATH 193A,A03,083781,Rotar; Vladimir,1,0,34,33
1657130630658,MATH 193A,A04,083782,Rotar; Vladimir,7,0,34,27
1657130630658,MATH 193A,A05,093482,Rotar; Vladimir,6,0,34,28
1657130636680,MATH 197,001,091859,McAuley; Julian John,9999,0,9999,0
1657130636680,MATH 197,002,095566,Kedlaya; Kiran S.,9997,0,9999,2
1657130636680,MATH 197,003,095567,Xiao; Ming,9999,0,9999,0
1657130636680,MATH 197,004,095571,Perols; Johan Lars,9998,0,9999,1
1657130643732,COGS 9,A01,083615,Shannon; Kyle Michael,7,0,75,68
1657130649756,COGS 11,A01,083617,Boyle; Mary E. T.,21,0,48,27
1657130655786,COGS 13,A01,083071,Bastos; Amalia Pinkusfeld,9,0,71,62
1657130661813,COGS 14A,A01,092681,Semenuks; Arturs,1,1,100,99
1657130667837,COGS 14B,A01,083073,Cheng; Tzu-Han,6,0,63,57
1657130673860,COGS 17,A01,092677,Semenuks; Arturs,4,0,81,77
1657130679884,COGS 100,A01,083619,Allen; Michael Gordon,15,0,70,55
1657130685911,COGS 101A,A01,083621,Davis; Joshua Daniel,9,0,68,59
1657130691937,COGS 101B,A01,091572,Allen; Michael Gordon,9,0,65,56
1657130697959,COGS 101C,A01,083625,Delgado; Tania,17,0,35,18
1657130703985,COGS 107A,A01,083627,Boyle; Mary E. T.,13,0,60,47
1657130710007,COGS 118A,A01,083075,Gupta; Anjum,15,0,76,61
1657130716041,CSE 3,A50,083646,Miranda; Gregory Joseph,23,0,50,27
1657130722069,CSE 8A,A50,083650,Miranda; Gregory Joseph,17,1,56,39
1657130728096,CSE 11,A01,083080,Cao; Yingjun,4,15,40,36
1657130734126,CSE 12,A01,083652,Krause-Levy; Sophia Louisa,23,1,120,97
1657130740168,CSE 15L,A01,083654,Morris; Justin Loren,9,0,50,41
1657130740168,CSE 15L,A02,083655,Morris; Justin Loren,9,0,50,41
1657130746198,CSE 20,A01,083657,Tran; Khoa Dang,38,0,80,42
1657130752222,CSE 21,A01,095574,Bach; Quang Tran,21,0,48,27
1657130758246,CSE 30,A01,083084,Eldon; John,4,0,80,76
1657130758246,CSE 30,B01,095061,Bhaskar; Nishant,7,0,50,43
1657130764272,CSE 100,A01,083659,Cao; Yingjun,4,4,70,66
1657130770302,CSE 134B,A01,083661,Powell; Thomas Allan,20,0,100,80
1657130776328,CSE 140,A01,083663,Gungor; Onat,13,0,85,72
1657130782354,CSE 140L,A01,083088,Eldon; John,17,0,100,83
1657130788381,CSE 175,A01,083665,Kumar; Rakesh,3,0,25,22
1657130794406,CSE 190,A00,092507,Dubnov; Shlomo,7,0,20,13
1657130800435,ECE 45,A01,083139,Congero; Spencer William,5,0,75,70
1657130806466,ECE 65,A50,083695,Saad; Andrew S,12,0,30,18
1657130806466,ECE 65,A51,095125,Saad; Andrew S,25,0,26,1
1657130812499,ECE 109,A01,091882,Touri; Behrouz,17,0,70,53
1657130818523,ECE 180,A00,083140,Abi Samra; Nicholas Camill,1,0,30,29
1657130818523,ECE 180,B00,083141,Abi Samra; Nicholas Camill,0,0,30,30
1657130824547,MATH 10A,A01,083735,Patchell; Gregory David,2,0,30,28
1657130824547,MATH 10A,A02,083736,Patchell; Gregory David,20,0,30,10
1657130824547,MATH 10A,A03,083737,Patchell; Gregory David,16,0,30,14
1657130830569,MATH 10B,A01,083207,Lim; Seonhee,7,0,34,27
1657130830569,MATH 10B,A02,083208,Lim; Seonhee,9,0,35,26
1657130830569,MATH 10B,A03,093472,Lim; Seonhee,5,0,34,29
1657130830569,MATH 10B,B01,083739,Sinha; Shubham,9,0,30,21
1657130836593,MATH 18,A01,083743,Cinel; Cameron Alexander,6,0,30,24
1657130836593,MATH 18,A02,083744,Cinel; Cameron Alexander,15,0,30,15
1657130836593,MATH 18,A03,083745,Cinel; Cameron Alexander,8,0,30,22
1657130836593,MATH 18,B01,083748,Rideout; David Porter,4,0,37,33
1657130836593,MATH 18,B02,083749,Rideout; David Porter,3,0,36,33
1657130836593,MATH 18,B03,083750,Rideout; David Porter,2,0,37,35
1657130836593,MATH 18,B04,083751,Rideout; David Porter,5,0,36,31
1657130836593,MATH 18,B05,093473,Rideout; David Porter,4,0,36,32
1657130836593,MATH 18,B06,093474,Rideout; David Porter,5,0,36,31
1657130842620,MATH 20A,A01,083754,Zheng; Zequn,12,0,40,28
1657130848646,MATH 20B,A01,083756,Briones; Jor-el Thomas Caparas,1,0,36,35
1657130848646,MATH 20B,A02,083757,Briones; Jor-el Thomas Caparas,1,0,36,35
1657130848646,MATH 20B,A03,093475,Briones; Jor-el Thomas Caparas,0,0,36,36
1657130854669,MATH 20C,A01,083760,Briones; Jor-el Thomas Caparas,1,0,35,34
1657130854669,MATH 20C,A02,083761,Briones; Jor-el Thomas Caparas,8,0,35,27
1657130854669,MATH 20C,A03,093476,Briones; Jor-el Thomas Caparas,0,1,36,36
1657130854669,MATH 20C,B01,083762,Bach; Quang Tran,0,0,30,30
1657130860702,MATH 20D,A01,083765,Tran; Brian Kha,4,0,30,26
1657130860702,MATH 20D,A02,083766,Tran; Brian Kha,5,0,30,25
1657130860702,MATH 20D,A03,083767,Tran; Brian Kha,3,0,30,27
1657130866740,MATH 20E,A01,083771,Ganguly; Soumya,6,0,32,26
1657130866740,MATH 20E,A02,083772,Ganguly; Soumya,6,0,32,26
1657130866740,MATH 20E,B01,083773,Ciotti; Benjamin,18,0,35,17
1657130866740,MATH 20E,B02,083774,Ciotti; Benjamin,17,0,35,18
1657130872772,MATH 103A,A01,083777,Greenfeld; Be'Eri,2,0,36,34
1657130872772,MATH 103A,A02,083778,Greenfeld; Be'Eri,5,0,36,31
1657130872772,MATH 103A,A03,093561,Greenfeld; Be'Eri,4,0,36,32
1657130872772,MATH 103A,B01,083779,Greenfeld; Be'Eri,6,0,36,30
1657130872772,MATH 103A,B02,083780,Greenfeld; Be'Eri,3,0,36,33
1657130872772,MATH 103A,B03,093562,Greenfeld; Be'Eri,3,0,36,33
1657130878794,MATH 105,A01,085443,Carter; Anne Toulson,14,0,35,21
1657130878794,MATH 105,A02,093477,Carter; Anne Toulson,20,0,35,15
1657130884830,MATH 109,A01,083213,Ganzberger; Geoffrey Michael,2,0,34,32
1657130884830,MATH 109,A02,083214,Ganzberger; Geoffrey Michael,3,0,34,31
1657130884830,MATH 109,A03,093478,Ganzberger; Geoffrey Michael,1,0,34,33
1657130884830,MATH 109,B01,083215,Ganzberger; Geoffrey Michael,1,0,32,31
1657130884830,MATH 109,B02,083216,Ganzberger; Geoffrey Michael,1,0,32,31
1657130884830,MATH 109,B03,093479,Ganzberger; Geoffrey Michael,6,0,32,26
1657130890862,MATH 142A,A01,083219,Chow; Bennett,6,0,32,26
1657130890862,MATH 142A,A02,083220,Chow; Bennett,10,0,32,22
1657130890862,MATH 142A,A03,093480,Chow; Bennett,7,0,32,25
1657130890862,MATH 142A,B03,093481,Chow; Bennett,8,0,32,24
1657130890862,MATH 142A,B04,093558,Chow; Bennett,11,0,32,21
1657130890862,MATH 142A,B05,093559,Chow; Bennett,6,0,32,26
1657130896890,MATH 193A,A01,083224,Rotar; Vladimir,7,0,34,27
1657130896890,MATH 193A,A02,083225,Rotar; Vladimir,5,0,34,29
1657130896890,MATH 193A,A03,083781,Rotar; Vladimir,1,0,34,33
1657130896890,MATH 193A,A04,083782,Rotar; Vladimir,7,0,34,27
1657130896890,MATH 193A,A05,093482,Rotar; Vladimir,6,0,34,28
1657130902912,MATH 197,001,091859,McAuley; Julian John,9999,0,9999,0
1657130902912,MATH 197,002,095566,Kedlaya; Kiran S.,9997,0,9999,2
1657130902912,MATH 197,003,095567,Xiao; Ming,9999,0,9999,0
1657130902912,MATH 197,004,095571,Perols; Johan Lars,9998,0,9999,1
1657130909968,COGS 9,A01,083615,Shannon; Kyle Michael,7,0,75,68
1657130915994,COGS 11,A01,083617,Boyle; Mary E. T.,21,0,48,27
1657130922023,COGS 13,A01,083071,Bastos; Amalia Pinkusfeld,9,0,71,62
1657130928044,COGS 14A,A01,092681,Semenuks; Arturs,1,1,100,99
1657130934072,COGS 14B,A01,083073,Cheng; Tzu-Han,6,0,63,57
1657130940116,COGS 17,A01,092677,Semenuks; Arturs,4,0,81,77
1657130946141,COGS 100,A01,083619,Allen; Michael Gordon,15,0,70,55
1657130952166,COGS 101A,A01,083621,Davis; Joshua Daniel,9,0,68,59
1657130958193,COGS 101B,A01,091572,Allen; Michael Gordon,9,0,65,56
1657130964215,COGS 101C,A01,083625,Delgado; Tania,17,0,35,18
1657130970239,COGS 107A,A01,083627,Boyle; Mary E. T.,13,0,60,47
1657130976262,COGS 118A,A01,083075,Gupta; Anjum,15,0,76,61
1657130982302,CSE 3,A50,083646,Miranda; Gregory Joseph,23,0,50,27
1657130988334,CSE 8A,A50,083650,Miranda; Gregory Joseph,17,1,56,39
1657130994360,CSE 11,A01,083080,Cao; Yingjun,4,15,40,36
1657131000396,CSE 12,A01,083652,Krause-Levy; Sophia Louisa,23,1,120,97
1657131006419,CSE 15L,A01,083654,Morris; Justin Loren,9,0,50,41
1657131006419,CSE 15L,A02,083655,Morris; Justin Loren,9,0,50,41
1657131012446,CSE 20,A01,083657,Tran; Khoa Dang,38,0,80,42
1657131018474,CSE 21,A01,095574,Bach; Quang Tran,21,0,48,27
1657131024499,CSE 30,A01,083084,Eldon; John,4,0,80,76
1657131024499,CSE 30,B01,095061,Bhaskar; Nishant,7,0,50,43
1657131030531,CSE 100,A01,083659,Cao; Yingjun,4,4,70,66
1657131036567,CSE 134B,A01,083661,Powell; Thomas Allan,20,0,100,80
1657131042590,CSE 140,A01,083663,Gungor; Onat,13,0,85,72
1657131048617,CSE 140L,A01,083088,Eldon; John,17,0,100,83
1657131054640,CSE 175,A01,083665,Kumar; Rakesh,3,0,25,22
1657131060676,CSE 190,A00,092507,Dubnov; Shlomo,7,0,20,13
1657131066705,ECE 45,A01,083139,Congero; Spencer William,5,0,75,70
1657131072734,ECE 65,A50,083695,Saad; Andrew S,12,0,30,18
1657131072734,ECE 65,A51,095125,Saad; Andrew S,25,0,26,1
1657131078759,ECE 109,A01,091882,Touri; Behrouz,17,0,70,53
1657131084782,ECE 180,A00,083140,Abi Samra; Nicholas Camill,1,0,30,29
1657131084782,ECE 180,B00,083141,Abi Samra; Nicholas Camill,0,0,30,30
1657131090807,MATH 10A,A01,083735,Patchell; Gregory David,2,0,30,28
1657131090807,MATH 10A,A02,083736,Patchell; Gregory David,20,0,30,10
1657131090807,MATH 10A,A03,083737,Patchell; Gregory David,16,0,30,14
1657131096838,MATH 10B,A01,083207,Lim; Seonhee,7,0,34,27
1657131096838,MATH 10B,A02,083208,Lim; Seonhee,9,0,35,26
1657131096838,MATH 10B,A03,093472,Lim; Seonhee,5,0,34,29
1657131096838,MATH 10B,B01,083739,Sinha; Shubham,9,0,30,21
1657131102864,MATH 18,A01,083743,Cinel; Cameron Alexander,6,0,30,24
1657131102864,MATH 18,A02,083744,Cinel; Cameron Alexander,15,0,30,15
1657131102864,MATH 18,A03,083745,Cinel; Cameron Alexander,8,0,30,22
1657131102864,MATH 18,B01,083748,Rideout; David Porter,4,0,37,33
1657131102864,MATH 18,B02,083749,Rideout; David Porter,3,0,36,33
1657131102864,MATH 18,B03,083750,Rideout; David Porter,2,0,37,35
1657131102864,MATH 18,B04,083751,Rideout; David Porter,5,0,36,31
1657131102864,MATH 18,B05,093473,Rideout; David Porter,4,0,36,32
1657131102864,MATH 18,B06,093474,Rideout; David Porter,5,0,36,31
1657131108886,MATH 20A,A01,083754,Zheng; Zequn,12,0,40,28
1657131114934,MATH 20B,A01,083756,Briones; Jor-el Thomas Caparas,1,0,36,35
1657131114934,MATH 20B,A02,083757,Briones; Jor-el Thomas Caparas,1,0,36,35
1657131114934,MATH 20B,A03,093475,Briones; Jor-el Thomas Caparas,0,0,36,36
1657131120966,MATH 20C,A01,083760,Briones; Jor-el Thomas Caparas,1,0,35,34
1657131120966,MATH 20C,A02,083761,Briones; Jor-el Thomas Caparas,8,0,35,27
1657131120966,MATH 20C,A03,093476,Briones; Jor-el Thomas Caparas,0,1,36,36
1657131120966,MATH 20C,B01,083762,Bach; Quang Tran,0,0,30,30
1657131126995,MATH 20D,A01,083765,Tran; Brian Kha,4,0,30,26
1657131126995,MATH 20D,A02,083766,Tran; Brian Kha,5,0,30,25
1657131126995,MATH 20D,A03,083767,Tran; Brian Kha,3,0,30,27
1657131133019,MATH 20E,A01,083771,Ganguly; Soumya,6,0,32,26
1657131133019,MATH 20E,A02,083772,Ganguly; Soumya,6,0,32,26
1657131133019,MATH 20E,B01,083773,Ciotti; Benjamin,18,0,35,17
1657131133019,MATH 20E,B02,083774,Ciotti; Benjamin,17,0,35,18
1657131139060,MATH 103A,A01,083777,Greenfeld; Be'Eri,2,0,36,34
1657131139060,MATH 103A,A02,083778,Greenfeld; Be'Eri,5,0,36,31
1657131139060,MATH 103A,A03,093561,Greenfeld; Be'Eri,4,0,36,32
1657131139060,MATH 103A,B01,083779,Greenfeld; Be'Eri,6,0,36,30
1657131139060,MATH 103A,B02,083780,Greenfeld; Be'Eri,3,0,36,33
1657131139060,MATH 103A,B03,093562,Greenfeld; Be'Eri,3,0,36,33
1657131145088,MATH 105,A01,085443,Carter; Anne Toulson,14,0,35,21
1657131145088,MATH 105,A02,093477,Carter; Anne Toulson,20,0,35,15
1657131151111,MATH 109,A01,083213,Ganzberger; Geoffrey Michael,2,0,34,32
1657131151111,MATH 109,A02,083214,Ganzberger; Geoffrey Michael,3,0,34,31
1657131151111,MATH 109,A03,093478,Ganzberger; Geoffrey Michael,1,0,34,33
1657131151111,MATH 109,B01,083215,Ganzberger; Geoffrey Michael,1,0,32,31
1657131151111,MATH 109,B02,083216,Ganzberger; Geoffrey Michael,1,0,32,31
1657131151111,MATH 109,B03,093479,Ganzberger; Geoffrey Michael,6,0,32,26
1657131157141,MATH 142A,A01,083219,Chow; Bennett,6,0,32,26
1657131157141,MATH 142A,A02,083220,Chow; Bennett,10,0,32,22
1657131157141,MATH 142A,A03,093480,Chow; Bennett,7,0,32,25
1657131157141,MATH 142A,B03,093481,Chow; Bennett,8,0,32,24
1657131157141,MATH 142A,B04,093558,Chow; Bennett,11,0,32,21
1657131157141,MATH 142A,B05,093559,Chow; Bennett,6,0,32,26
1657131163169,MATH 193A,A01,083224,Rotar; Vladimir,7,0,34,27
1657131163169,MATH 193A,A02,083225,Rotar; Vladimir,5,0,34,29
1657131163169,MATH 193A,A03,083781,Rotar; Vladimir,1,0,34,33
1657131163169,MATH 193A,A04,083782,Rotar; Vladimir,7,0,34,27
1657131163169,MATH 193A,A05,093482,Rotar; Vladimir,6,0,34,28
1657131169192,MATH 197,001,091859,McAuley; Julian John,9999,0,9999,0
1657131169192,MATH 197,002,095566,Kedlaya; Kiran S.,9997,0,9999,2
1657131169192,MATH 197,003,095567,Xiao; Ming,9999,0,9999,0
1657131169192,MATH 197,004,095571,Perols; Johan Lars,9998,0,9999,1
1657131176245,COGS 9,A01,083615,Shannon; Kyle Michael,7,0,75,68
1657131182267,COGS 11,A01,083617,Boyle; Mary E. T.,21,0,48,27
1657131188297,COGS 13,A01,083071,Bastos; Amalia Pinkusfeld,9,0,71,62
1657131194323,COGS 14A,A01,092681,Semenuks; Arturs,1,1,100,99
1657131200349,COGS 14B,A01,083073,Cheng; Tzu-Han,6,0,63,57
1657131206382,COGS 17,A01,092677,Semenuks; Arturs,4,0,81,77
1657131212409,COGS 100,A01,083619,Allen; Michael Gordon,15,0,70,55
1657131218436,COGS 101A,A01,083621,Davis; Joshua Daniel,9,0,68,59
1657131224538,COGS 101B,A01,091572,Allen; Michael Gordon,9,0,65,56
1657131230561,COGS 101C,A01,083625,Delgado; Tania,17,0,35,18
1657131236584,COGS 107A,A01,083627,Boyle; Mary E. T.,13,0,60,47
1657131242611,COGS 118A,A01,083075,Gupta; Anjum,15,0,76,61
1657131248656,CSE 3,A50,083646,Miranda; Gregory Joseph,23,0,50,27
1657131254684,CSE 8A,A50,083650,Miranda; Gregory Joseph,17,1,56,39
1657131260711,CSE 11,A01,083080,Cao; Yingjun,4,15,40,36
1657131266749,CSE 12,A01,083652,Krause-Levy; Sophia Louisa,23,1,120,97
1657131272773,CSE 15L,A01,083654,Morris; Justin Loren,9,0,50,41
1657131272773,CSE 15L,A02,083655,Morris; Justin Loren,9,0,50,41
1657131278803,CSE 20,A01,083657,Tran; Khoa Dang,38,0,80,42
1657131284830,CSE 21,A01,095574,Bach; Quang Tran,21,0,48,27
1657131290862,CSE 30,A01,083084,Eldon; John,4,0,80,76
1657131290862,CSE 30,B01,095061,Bhaskar; Nishant,7,0,50,43
1657131296888,CSE 100,A01,083659,Cao; Yingjun,4,4,70,66
1657131302913,CSE 134B,A01,083661,Powell; Thomas Allan,20,0,100,80
1657131308934,CSE 140,A01,083663,Gungor; Onat,13,0,85,72
1657131314961,CSE 140L,A01,083088,Eldon; John,17,0,100,83
1657131320987,CSE 175,A01,083665,Kumar; Rakesh,3,0,25,22
1657131327012,CSE 190,A00,092507,Dubnov; Shlomo,7,0,20,13
1657131333036,ECE 45,A01,083139,Congero; Spencer William,5,0,75,70
1657131339059,ECE 65,A50,083695,Saad; Andrew S,12,0,30,18
1657131339059,ECE 65,A51,095125,Saad; Andrew S,25,0,26,1
1657131345085,ECE 109,A01,091882,Touri; Behrouz,17,0,70,53
1657131351112,ECE 180,A00,083140,Abi Samra; Nicholas Camill,1,0,30,29
1657131351112,ECE 180,B00,083141,Abi Samra; Nicholas Camill,0,0,30,30
1657131357143,MATH 10A,A01,083735,Patchell; Gregory David,2,0,30,28
1657131357143,MATH 10A,A02,083736,Patchell; Gregory David,20,0,30,10
1657131357143,MATH 10A,A03,083737,Patchell; Gregory David,16,0,30,14
1657131363167,MATH 10B,A01,083207,Lim; Seonhee,7,0,34,27
1657131363167,MATH 10B,A02,083208,Lim; Seonhee,9,0,35,26
1657131363167,MATH 10B,A03,093472,Lim; Seonhee,5,0,34,29
1657131363167,MATH 10B,B01,083739,Sinha; Shubham,9,0,30,21
1657131369212,MATH 18,A01,083743,Cinel; Cameron Alexander,6,0,30,24
1657131369212,MATH 18,A02,083744,Cinel; Cameron Alexander,15,0,30,15
1657131369212,MATH 18,A03,083745,Cinel; Cameron Alexander,8,0,30,22
1657131369212,MATH 18,B01,083748,Rideout; David Porter,4,0,37,33
1657131369212,MATH 18,B02,083749,Rideout; David Porter,3,0,36,33
1657131369212,MATH 18,B03,083750,Rideout; David Porter,2,0,37,35
1657131369212,MATH 18,B04,083751,Rideout; David Porter,5,0,36,31
1657131369212,MATH 18,B05,093473,Rideout; David Porter,4,0,36,32
1657131369212,MATH 18,B06,093474,Rideout; David Porter,5,0,36,31
1657131375235,MATH 20A,A01,083754,Zheng; Zequn,12,0,40,28
1657131381259,MATH 20B,A01,083756,Briones; Jor-el Thomas Caparas,1,0,36,35
1657131381259,MATH 20B,A02,083757,Briones; Jor-el Thomas Caparas,1,0,36,35
1657131381259,MATH 20B,A03,093475,Briones; Jor-el Thomas Caparas,0,0,36,36
1657131387287,MATH 20C,A01,083760,Briones; Jor-el Thomas Caparas,1,0,35,34
1657131387287,MATH 20C,A02,083761,Briones; Jor-el Thomas Caparas,8,0,35,27
1657131387287,MATH 20C,A03,093476,Briones; Jor-el Thomas Caparas,0,1,36,36
1657131387287,MATH 20C,B01,083762,Bach; Quang Tran,0,0,30,30
1657131393316,MATH 20D,A01,083765,Tran; Brian Kha,4,0,30,26
1657131393316,MATH 20D,A02,083766,Tran; Brian Kha,5,0,30,25
1657131393316,MATH 20D,A03,083767,Tran; Brian Kha,3,0,30,27
1657131399352,MATH 20E,A01,083771,Ganguly; Soumya,6,0,32,26
1657131399352,MATH 20E,A02,083772,Ganguly; Soumya,6,0,32,26
1657131399352,MATH 20E,B01,083773,Ciotti; Benjamin,18,0,35,17
1657131399352,MATH 20E,B02,083774,Ciotti; Benjamin,17,0,35,18
1657131405381,MATH 103A,A01,083777,Greenfeld; Be'Eri,2,0,36,34
1657131405381,MATH 103A,A02,083778,Greenfeld; Be'Eri,5,0,36,31
1657131405381,MATH 103A,A03,093561,Greenfeld; Be'Eri,4,0,36,32
1657131405381,MATH 103A,B01,083779,Greenfeld; Be'Eri,6,0,36,30
1657131405381,MATH 103A,B02,083780,Greenfeld; Be'Eri,3,0,36,33
1657131405381,MATH 103A,B03,093562,Greenfeld; Be'Eri,3,0,36,33
1657131411405,MATH 105,A01,085443,Carter; Anne Toulson,14,0,35,21
1657131411405,MATH 105,A02,093477,Carter; Anne Toulson,20,0,35,15
1657131417433,MATH 109,A01,083213,Ganzberger; Geoffrey Michael,2,0,34,32
1657131417433,MATH 109,A02,083214,Ganzberger; Geoffrey Michael,3,0,34,31
1657131417433,MATH 109,A03,093478,Ganzberger; Geoffrey Michael,1,0,34,33
1657131417433,MATH 109,B01,083215,Ganzberger; Geoffrey Michael,1,0,32,31
1657131417433,MATH 109,B02,083216,Ganzberger; Geoffrey Michael,1,0,32,31
1657131417433,MATH 109,B03,093479,Ganzberger; Geoffrey Michael,6,0,32,26
1657131423463,MATH 142A,A01,083219,Chow; Bennett,6,0,32,26
1657131423463,MATH 142A,A02,083220,Chow; Bennett,10,0,32,22
1657131423463,MATH 142A,A03,093480,Chow; Bennett,7,0,32,25
1657131423463,MATH 142A,B03,093481,Chow; Bennett,8,0,32,24
1657131423463,MATH 142A,B04,093558,Chow; Bennett,11,0,32,21
1657131423463,MATH 142A,B05,093559,Chow; Bennett,6,0,32,26
1657131429511,MATH 193A,A01,083224,Rotar; Vladimir,7,0,34,27
1657131429511,MATH 193A,A02,083225,Rotar; Vladimir,5,0,34,29
1657131429511,MATH 193A,A03,083781,Rotar; Vladimir,1,0,34,33
1657131429511,MATH 193A,A04,083782,Rotar; Vladimir,7,0,34,27
1657131429511,MATH 193A,A05,093482,Rotar; Vladimir,6,0,34,28
1657131435535,MATH 197,001,091859,McAuley; Julian John,9999,0,9999,0
1657131435535,MATH 197,002,095566,Kedlaya; Kiran S.,9997,0,9999,2
1657131435535,MATH 197,003,095567,Xiao; Ming,9999,0,9999,0
1657131435535,MATH 197,004,095571,Perols; Johan Lars,9998,0,9999,1
1657131442590,COGS 9,A01,083615,Shannon; Kyle Michael,7,0,75,68
1657131448629,COGS 11,A01,083617,Boyle; Mary E. T.,21,0,48,27
1657131454651,COGS 13,A01,083071,Bastos; Amalia Pinkusfeld,9,0,71,62
1657131460675,COGS 14A,A01,092681,Semenuks; Arturs,1,1,100,99
1657131466704,COGS 14B,A01,083073,Cheng; Tzu-Han,6,0,63,57
1657131472731,COGS 17,A01,092677,Semenuks; Arturs,4,0,81,77
1657131478752,COGS 100,A01,083619,Allen; Michael Gordon,15,0,70,55
1657131484774,COGS 101A,A01,083621,Davis; Joshua Daniel,9,0,68,59
1657131490796,COGS 101B,A01,091572,Allen; Michael Gordon,9,0,65,56
1657131496819,COGS 101C,A01,083625,Delgado; Tania,17,0,35,18
1657131502848,COGS 107A,A01,083627,Boyle; Mary E. T.,13,0,60,47
1657131508882,COGS 118A,A01,083075,Gupta; Anjum,15,0,76,61
1657131514910,CSE 3,A50,083646,Miranda; Gregory Joseph,23,0,50,27
1657131520946,CSE 8A,A50,083650,Miranda; Gregory Joseph,17,1,56,39
1657131526978,CSE 11,A01,083080,Cao; Yingjun,4,15,40,36
1657131533002,CSE 12,A01,083652,Krause-Levy; Sophia Louisa,23,1,120,97
1657131539024,CSE 15L,A01,083654,Morris; Justin Loren,9,0,50,41
1657131539024,CSE 15L,A02,083655,Morris; Justin Loren,9,0,50,41
1657131545050,CSE 20,A01,083657,Tran; Khoa Dang,38,0,80,42
1657131551077,CSE 21,A01,095574,Bach; Quang Tran,21,0,48,27
1657131557106,CSE 30,A01,083084,Eldon; John,4,0,80,76
1657131557106,CSE 30,B01,095061,Bhaskar; Nishant,7,0,50,43
1657131563133,CSE 100,A01,083659,Cao; Yingjun,4,4,70,66
1657131569160,CSE 134B,A01,083661,Powell; Thomas Allan,20,0,100,80
1657131575189,CSE 140,A01,083663,Gungor; Onat,13,0,85,72
1657131581212,CSE 140L,A01,083088,Eldon; John,17,0,100,83
1657131587234,CSE 175,A01,083665,Kumar; Rakesh,3,0,25,22
1657131593259,CSE 190,A00,092507,Dubnov; Shlomo,7,0,20,13
1657131599287,ECE 45,A01,083139,Congero; Spencer William,5,0,75,70
1657131605310,ECE 65,A50,083695,Saad; Andrew S,12,0,30,18
1657131605310,ECE 65,A51,095125,Saad; Andrew S,25,0,26,1
1657131611346,ECE 109,A01,091882,Touri; Behrouz,17,0,70,53
1657131617376,ECE 180,A00,083140,Abi Samra; Nicholas Camill,1,0,30,29
1657131617376,ECE 180,B00,083141,Abi Samra; Nicholas Camill,0,0,30,30
1657131623409,MATH 10A,A01,083735,Patchell; Gregory David,2,0,30,28
1657131623409,MATH 10A,A02,083736,Patchell; Gregory David,20,0,30,10
1657131623409,MATH 10A,A03,083737,Patchell; Gregory David,16,0,30,14
1657131629438,MATH 10B,A01,083207,Lim; Seonhee,7,0,34,27
1657131629438,MATH 10B,A02,083208,Lim; Seonhee,9,0,35,26
1657131629438,MATH 10B,A03,093472,Lim; Seonhee,5,0,34,29
1657131629438,MATH 10B,B01,083739,Sinha; Shubham,9,0,30,21
1657131635464,MATH 18,A01,083743,Cinel; Cameron Alexander,6,0,30,24
1657131635464,MATH 18,A02,083744,Cinel; Cameron Alexander,15,0,30,15
1657131635464,MATH 18,A03,083745,Cinel; Cameron Alexander,8,0,30,22
1657131635464,MATH 18,B01,083748,Rideout; David Porter,4,0,37,33
1657131635464,MATH 18,B02,083749,Rideout; David Porter,3,0,36,33
1657131635464,MATH 18,B03,083750,Rideout; David Porter,2,0,37,35
1657131635464,MATH 18,B04,083751,Rideout; David Porter,5,0,36,31
1657131635464,MATH 18,B05,093473,Rideout; David Porter,4,0,36,32
1657131635464,MATH 18,B06,093474,Rideout; David Porter,5,0,36,31
1657131641490,MATH 20A,A01,083754,Zheng; Zequn,12,0,40,28
1657131647532,MATH 20B,A01,083756,Briones; Jor-el Thomas Caparas,1,0,36,35
1657131647532,MATH 20B,A02,083757,Briones; Jor-el Thomas Caparas,1,0,36,35
1657131647532,MATH 20B,A03,093475,Briones; Jor-el Thomas Caparas,0,0,36,36
1657131653563,MATH 20C,A01,083760,Briones; Jor-el Thomas Caparas,1,0,35,34
1657131653563,MATH 20C,A02,083761,Briones; Jor-el Thomas Caparas,8,0,35,27
1657131653563,MATH 20C,A03,093476,Briones; Jor-el Thomas Caparas,0,1,36,36
1657131653563,MATH 20C,B01,083762,Bach; Quang Tran,0,0,30,30
1657131659591,MATH 20D,A01,083765,Tran; Brian Kha,4,0,30,26
1657131659591,MATH 20D,A02,083766,Tran; Brian Kha,5,0,30,25
1657131659591,MATH 20D,A03,083767,Tran; Brian Kha,3,0,30,27
1657131665624,MATH 20E,A01,083771,Ganguly; Soumya,6,0,32,26
1657131665624,MATH 20E,A02,083772,Ganguly; Soumya,6,0,32,26
1657131665624,MATH 20E,B01,083773,Ciotti; Benjamin,18,0,35,17
1657131665624,MATH 20E,B02,083774,Ciotti; Benjamin,17,0,35,18
1657131671654,MATH 103A,A01,083777,Greenfeld; Be'Eri,2,0,36,34
1657131671654,MATH 103A,A02,083778,Greenfeld; Be'Eri,5,0,36,31
1657131671654,MATH 103A,A03,093561,Greenfeld; Be'Eri,4,0,36,32
1657131671654,MATH 103A,B01,083779,Greenfeld; Be'Eri,6,0,36,30
1657131671654,MATH 103A,B02,083780,Greenfeld; Be'Eri,3,0,36,33
1657131671654,MATH 103A,B03,093562,Greenfeld; Be'Eri,3,0,36,33
1657131677685,MATH 105,A01,085443,Carter; Anne Toulson,14,0,35,21
1657131677685,MATH 105,A02,093477,Carter; Anne Toulson,20,0,35,15
1657131683709,MATH 109,A01,083213,Ganzberger; Geoffrey Michael,2,0,34,32
1657131683709,MATH 109,A02,083214,Ganzberger; Geoffrey Michael,3,0,34,31
1657131683709,MATH 109,A03,093478,Ganzberger; Geoffrey Michael,1,0,34,33
1657131683709,MATH 109,B01,083215,Ganzberger; Geoffrey Michael,1,0,32,31
1657131683709,MATH 109,B02,083216,Ganzberger; Geoffrey Michael,1,0,32,31
1657131683709,MATH 109,B03,093479,Ganzberger; Geoffrey Michael,6,0,32,26
1657131689733,MATH 142A,A01,083219,Chow; Bennett,6,0,32,26
1657131689733,MATH 142A,A02,083220,Chow; Bennett,10,0,32,22
1657131689733,MATH 142A,A03,093480,Chow; Bennett,7,0,32,25
1657131689733,MATH 142A,B03,093481,Chow; Bennett,8,0,32,24
1657131689733,MATH 142A,B04,093558,Chow; Bennett,11,0,32,21
1657131689733,MATH 142A,B05,093559,Chow; Bennett,6,0,32,26
1657131695761,MATH 193A,A01,083224,Rotar; Vladimir,7,0,34,27
1657131695761,MATH 193A,A02,083225,Rotar; Vladimir,5,0,34,29
1657131695761,MATH 193A,A03,083781,Rotar; Vladimir,1,0,34,33
1657131695761,MATH 193A,A04,083782,Rotar; Vladimir,7,0,34,27
1657131695761,MATH 193A,A05,093482,Rotar; Vladimir,6,0,34,28
1657131701783,MATH 197,001,091859,McAuley; Julian John,9999,0,9999,0
1657131701783,MATH 197,002,095566,Kedlaya; Kiran S.,9997,0,9999,2
1657131701783,MATH 197,003,095567,Xiao; Ming,9999,0,9999,0
1657131701783,MATH 197,004,095571,Perols; Johan Lars,9998,0,9999,1
1657131708853,COGS 9,A01,083615,Shannon; Kyle Michael,7,0,75,68
1657131714880,COGS 11,A01,083617,Boyle; Mary E. T.,21,0,48,27
1657131720912,COGS 13,A01,083071,Bastos; Amalia Pinkusfeld,9,0,71,62
1657131726939,COGS 14A,A01,092681,Semenuks; Arturs,1,1,100,99
1657131732962,COGS 14B,A01,083073,Cheng; Tzu-Han,6,0,63,57
1657131738998,COGS 17,A01,092677,Semenuks; Arturs,4,0,81,77
1657131745028,COGS 100,A01,083619,Allen; Michael Gordon,15,0,70,55
1657131751050,COGS 101A,A01,083621,Davis; Joshua Daniel,9,0,68,59
1657131757075,COGS 101B,A01,091572,Allen; Michael Gordon,9,0,65,56
1657131763096,COGS 101C,A01,083625,Delgado; Tania,17,0,35,18
1657131769119,COGS 107A,A01,083627,Boyle; Mary E. T.,13,0,60,47
1657131775144,COGS 118A,A01,083075,Gupta; Anjum,15,0,76,61
1657131781184,CSE 3,A50,083646,Miranda; Gregory Joseph,23,0,50,27
1657131787208,CSE 8A,A50,083650,Miranda; Gregory Joseph,17,1,56,39
1657131793233,CSE 11,A01,083080,Cao; Yingjun,4,15,40,36
1657131799257,CSE 12,A01,083652,Krause-Levy; Sophia Louisa,23,1,120,97
1657131805283,CSE 15L,A01,083654,Morris; Justin Loren,9,0,50,41
1657131805283,CSE 15L,A02,083655,Morris; Justin Loren,9,0,50,41
1657131811312,CSE 20,A01,083657,Tran; Khoa Dang,38,0,80,42
1657131817346,CSE 21,A01,095574,Bach; Quang Tran,21,0,48,27
1657131823465,CSE 30,A01,083084,Eldon; John,4,0,80,76
1657131823465,CSE 30,B01,095061,Bhaskar; Nishant,7,0,50,43
1657131829490,CSE 100,A01,083659,Cao; Yingjun,4,4,70,66
1657131835516,CSE 134B,A01,083661,Powell; Thomas Allan,20,0,100,80
1657131841546,CSE 140,A01,083663,Gungor; Onat,13,0,85,72
1657131847570,CSE 140L,A01,083088,Eldon; John,17,0,100,83
1657131853596,CSE 175,A01,083665,Kumar; Rakesh,3,0,25,22
1657131859618,CSE 190,A00,092507,Dubnov; Shlomo,7,0,20,13
1657131865642,ECE 45,A01,083139,Congero; Spencer William,5,0,75,70
1657131871669,ECE 65,A50,083695,Saad; Andrew S,12,0,30,18
1657131871669,ECE 65,A51,095125,Saad; Andrew S,25,0,26,1
1657131877699,ECE 109,A01,091882,Touri; Behrouz,17,0,70,53
1657131883724,ECE 180,A00,083140,Abi Samra; Nicholas Camill,1,0,30,29
1657131883724,ECE 180,B00,083141,Abi Samra; Nicholas Camill,0,0,30,30
1657131889747,MATH 10A,A01,083735,Patchell; Gregory David,2,0,30,28
1657131889747,MATH 10A,A02,083736,Patchell; Gregory David,20,0,30,10
1657131889747,MATH 10A,A03,083737,Patchell; Gregory David,16,0,30,14
1657131895769,MATH 10B,A01,083207,Lim; Seonhee,7,0,34,27
1657131895769,MATH 10B,A02,083208,Lim; Seonhee,9,0,35,26
1657131895769,MATH 10B,A03,093472,Lim; Seonhee,5,0,34,29
1657131895769,MATH 10B,B01,083739,Sinha; Shubham,9,0,30,21
1657131901794,MATH 18,A01,083743,Cinel; Cameron Alexander,6,0,30,24
1657131901794,MATH 18,A02,083744,Cinel; Cameron Alexander,15,0,30,15
1657131901794,MATH 18,A03,083745,Cinel; Cameron Alexander,8,0,30,22
1657131901794,MATH 18,B01,083748,Rideout; David Porter,4,0,37,33
1657131901794,MATH 18,B02,083749,Rideout; David Porter,3,0,36,33
1657131901794,MATH 18,B03,083750,Rideout; David Porter,2,0,37,35
1657131901794,MATH 18,B04,083751,Rideout; David Porter,5,0,36,31
1657131901794,MATH 18,B05,093473,Rideout; David Porter,4,0,36,32
1657131901794,MATH 18,B06,093474,Rideout; David Porter,5,0,36,31
1657131907824,MATH 20A,A01,083754,Zheng; Zequn,12,0,40,28
1657131913850,MATH 20B,A01,083756,Briones; Jor-el Thomas Caparas,1,0,36,35
1657131913850,MATH 20B,A02,083757,Briones; Jor-el Thomas Caparas,1,0,36,35
1657131913850,MATH 20B,A03,093475,Briones; Jor-el Thomas Caparas,0,0,36,36
1657131919874,MATH 20C,A01,083760,Briones; Jor-el Thomas Caparas,1,0,35,34
1657131919874,MATH 20C,A02,083761,Briones; Jor-el Thomas Caparas,8,0,35,27
1657131919874,MATH 20C,A03,093476,Briones; Jor-el Thomas Caparas,0,1,36,36
1657131919874,MATH 20C,B01,083762,Bach; Quang Tran,0,0,30,30
1657131925902,MATH 20D,A01,083765,Tran; Brian Kha,4,0,30,26
1657131925902,MATH 20D,A02,083766,Tran; Brian Kha,5,0,30,25
1657131925902,MATH 20D,A03,083767,Tran; Brian Kha,3,0,30,27
1657131931941,MATH 20E,A01,083771,Ganguly; Soumya,6,0,32,26
1657131931941,MATH 20E,A02,083772,Ganguly; Soumya,6,0,32,26
1657131931941,MATH 20E,B01,083773,Ciotti; Benjamin,18,0,35,17
1657131931941,MATH 20E,B02,083774,Ciotti; Benjamin,17,0,35,18
1657131937969,MATH 103A,A01,083777,Greenfeld; Be'Eri,2,0,36,34
1657131937969,MATH 103A,A02,083778,Greenfeld; Be'Eri,5,0,36,31
1657131937969,MATH 103A,A03,093561,Greenfeld; Be'Eri,4,0,36,32
1657131937969,MATH 103A,B01,083779,Greenfeld; Be'Eri,6,0,36,30
1657131937969,MATH 103A,B02,083780,Greenfeld; Be'Eri,3,0,36,33
1657131937969,MATH 103A,B03,093562,Greenfeld; Be'Eri,3,0,36,33
1657131943999,MATH 105,A01,085443,Carter; Anne Toulson,14,0,35,21
1657131943999,MATH 105,A02,093477,Carter; Anne Toulson,20,0,35,15
1657131950031,MATH 109,A01,083213,Ganzberger; Geoffrey Michael,2,0,34,32
1657131950031,MATH 109,A02,083214,Ganzberger; Geoffrey Michael,3,0,34,31
1657131950031,MATH 109,A03,093478,Ganzberger; Geoffrey Michael,1,0,34,33
1657131950031,MATH 109,B01,083215,Ganzberger; Geoffrey Michael,1,0,32,31
1657131950031,MATH 109,B02,083216,Ganzberger; Geoffrey Michael,1,0,32,31
1657131950031,MATH 109,B03,093479,Ganzberger; Geoffrey Michael,6,0,32,26
1657131956053,MATH 142A,A01,083219,Chow; Bennett,6,0,32,26
1657131956053,MATH 142A,A02,083220,Chow; Bennett,10,0,32,22
1657131956053,MATH 142A,A03,093480,Chow; Bennett,7,0,32,25
1657131956053,MATH 142A,B03,093481,Chow; Bennett,8,0,32,24
1657131956053,MATH 142A,B04,093558,Chow; Bennett,11,0,32,21
1657131956053,MATH 142A,B05,093559,Chow; Bennett,6,0,32,26
1657131962080,MATH 193A,A01,083224,Rotar; Vladimir,7,0,34,27
1657131962080,MATH 193A,A02,083225,Rotar; Vladimir,5,0,34,29
1657131962080,MATH 193A,A03,083781,Rotar; Vladimir,1,0,34,33
1657131962080,MATH 193A,A04,083782,Rotar; Vladimir,7,0,34,27
1657131962080,MATH 193A,A05,093482,Rotar; Vladimir,6,0,34,28
1657131968117,MATH 197,001,091859,McAuley; Julian John,9999,0,9999,0
1657131968117,MATH 197,002,095566,Kedlaya; Kiran S.,9997,0,9999,2
1657131968117,MATH 197,003,095567,Xiao; Ming,9999,0,9999,0
1657131968117,MATH 197,004,095571,Perols; Johan Lars,9998,0,9999,1
1657131975175,COGS 9,A01,083615,Shannon; Kyle Michael,7,0,75,68
1657131981201,COGS 11,A01,083617,Boyle; Mary E. T.,21,0,48,27
1657131987227,COGS 13,A01,083071,Bastos; Amalia Pinkusfeld,9,0,71,62
1657131993251,COGS 14A,A01,092681,Semenuks; Arturs,1,1,100,99
1657131999277,COGS 14B,A01,083073,Cheng; Tzu-Han,6,0,63,57
1657132005300,COGS 17,A01,092677,Semenuks; Arturs,4,0,81,77
1657132011325,COGS 100,A01,083619,Allen; Michael Gordon,15,0,70,55
1657132017348,COGS 101A,A01,083621,Davis; Joshua Daniel,9,0,68,59
1657132023374,COGS 101B,A01,091572,Allen; Michael Gordon,9,0,65,56
1657132029420,COGS 101C,A01,083625,Delgado; Tania,17,0,35,18
1657132035451,COGS 107A,A01,083627,Boyle; Mary E. T.,13,0,60,47
1657132041478,COGS 118A,A01,083075,Gupta; Anjum,15,0,76,61
1657132047505,CSE 3,A50,083646,Miranda; Gregory Joseph,23,0,50,27
1657132053528,CSE 8A,A50,083650,Miranda; Gregory Joseph,17,1,56,39
1657132059550,CSE 11,A01,083080,Cao; Yingjun,4,15,40,36
1657132065574,CSE 12,A01,083652,Krause-Levy; Sophia Louisa,23,1,120,97
1657132071599,CSE 15L,A01,083654,Morris; Justin Loren,9,0,50,41
1657132071599,CSE 15L,A02,083655,Morris; Justin Loren,9,0,50,41
1657132077623,CSE 20,A01,083657,Tran; Khoa Dang,38,0,80,42
1657132083652,CSE 21,A01,095574,Bach; Quang Tran,21,0,48,27
1657132089696,CSE 30,A01,083084,Eldon; John,4,0,80,76
1657132089696,CSE 30,B01,095061,Bhaskar; Nishant,7,0,50,43
1657132095721,CSE 100,A01,083659,Cao; Yingjun,4,4,70,66
1657132101748,CSE 134B,A01,083661,Powell; Thomas Allan,20,0,100,80
1657132107772,CSE 140,A01,083663,Gungor; Onat,13,0,85,72
1657132113795,CSE 140L,A01,083088,Eldon; John,17,0,100,83
1657132119831,CSE 175,A01,083665,Kumar; Rakesh,3,0,25,22
1657132125864,CSE 190,A00,092507,Dubnov; Shlomo,7,0,20,13
1657132131893,ECE 45,A01,083139,Congero; Spencer William,5,0,75,70
1657132137919,ECE 65,A50,083695,Saad; Andrew S,12,0,30,18
1657132137919,ECE 65,A51,095125,Saad; Andrew S,25,0,26,1
1657132143963,ECE 109,A01,091882,Touri; Behrouz,17,0,70,53
1657132149990,ECE 180,A00,083140,Abi Samra; Nicholas Camill,1,0,30,29
1657132149990,ECE 180,B00,083141,Abi Samra; Nicholas Camill,0,0,30,30
1657132156015,MATH 10A,A01,083735,Patchell; Gregory David,2,0,30,28
1657132156015,MATH 10A,A02,083736,Patchell; Gregory David,20,0,30,10
1657132156015,MATH 10A,A03,083737,Patchell; Gregory David,16,0,30,14
1657132162039,MATH 10B,A01,083207,Lim; Seonhee,7,0,34,27
1657132162039,MATH 10B,A02,083208,Lim; Seonhee,9,0,35,26
1657132162039,MATH 10B,A03,093472,Lim; Seonhee,5,0,34,29
1657132162039,MATH 10B,B01,083739,Sinha; Shubham,9,0,30,21
1657132168063,MATH 18,A01,083743,Cinel; Cameron Alexander,6,0,30,24
1657132168063,MATH 18,A02,083744,Cinel; Cameron Alexander,15,0,30,15
1657132168063,MATH 18,A03,083745,Cinel; Cameron Alexander,8,0,30,22
1657132168063,MATH 18,B01,083748,Rideout; David Porter,4,0,37,33
1657132168063,MATH 18,B02,083749,Rideout; David Porter,3,0,36,33
1657132168063,MATH 18,B03,083750,Rideout; David Porter,2,0,37,35
1657132168063,MATH 18,B04,083751,Rideout; David Porter,5,0,36,31
1657132168063,MATH 18,B05,093473,Rideout; David Porter,4,0,36,32
1657132168063,MATH 18,B06,093474,Rideout; David Porter,5,0,36,31
1657132174087,MATH 20A,A01,083754,Zheng; Zequn,12,0,40,28
1657132180112,MATH 20B,A01,083756,Briones; Jor-el Thomas Caparas,1,0,36,35
1657132180112,MATH 20B,A02,083757,Briones; Jor-el Thomas Caparas,1,0,36,35
1657132180112,MATH 20B,A03,093475,Briones; Jor-el Thomas Caparas,0,0,36,36
1657132186140,MATH 20C,A01,083760,Briones; Jor-el Thomas Caparas,1,0,35,34
1657132186140,MATH 20C,A02,083761,Briones; Jor-el Thomas Caparas,8,0,35,27
1657132186140,MATH 20C,A03,093476,Briones; Jor-el Thomas Caparas,0,1,36,36
1657132186140,MATH 20C,B01,083762,Bach; Quang Tran,0,0,30,30
1657132192178,MATH 20D,A01,083765,Tran; Brian Kha,4,0,30,26
1657132192178,MATH 20D,A02,083766,Tran; Brian Kha,5,0,30,25
1657132192178,MATH 20D,A03,083767,Tran; Brian Kha,3,0,30,27
1657132198202,MATH 20E,A01,083771,Ganguly; Soumya,6,0,32,26
1657132198202,MATH 20E,A02,083772,Ganguly; Soumya,6,0,32,26
1657132198202,MATH 20E,B01,083773,Ciotti; Benjamin,18,0,35,17
1657132198202,MATH 20E,B02,083774,Ciotti; Benjamin,17,0,35,18
1657132204229,MATH 103A,A01,083777,Greenfeld; Be'Eri,2,0,36,34
1657132204229,MATH 103A,A02,083778,Greenfeld; Be'Eri,5,0,36,31
1657132204229,MATH 103A,A03,093561,Greenfeld; Be'Eri,4,0,36,32
1657132204229,MATH 103A,B01,083779,Greenfeld; Be'Eri,6,0,36,30
1657132204229,MATH 103A,B02,083780,Greenfeld; Be'Eri,3,0,36,33
1657132204229,MATH 103A,B03,093562,Greenfeld; Be'Eri,3,0,36,33
1657132210253,MATH 105,A01,085443,Carter; Anne Toulson,14,0,35,21
1657132210253,MATH 105,A02,093477,Carter; Anne Toulson,20,0,35,15
1657132216276,MATH 109,A01,083213,Ganzberger; Geoffrey Michael,2,0,34,32
1657132216276,MATH 109,A02,083214,Ganzberger; Geoffrey Michael,3,0,34,31
1657132216276,MATH 109,A03,093478,Ganzberger; Geoffrey Michael,1,0,34,33
1657132216276,MATH 109,B01,083215,Ganzberger; Geoffrey Michael,1,0,32,31
1657132216276,MATH 109,B02,083216,Ganzberger; Geoffrey Michael,1,0,32,31
1657132216276,MATH 109,B03,093479,Ganzberger; Geoffrey Michael,6,0,32,26
1657132222301,MATH 142A,A01,083219,Chow; Bennett,6,0,32,26
1657132222301,MATH 142A,A02,083220,Chow; Bennett,10,0,32,22
1657132222301,MATH 142A,A03,093480,Chow; Bennett,7,0,32,25
1657132222301,MATH 142A,B03,093481,Chow; Bennett,8,0,32,24
1657132222301,MATH 142A,B04,093558,Chow; Bennett,11,0,32,21
1657132222301,MATH 142A,B05,093559,Chow; Bennett,6,0,32,26
1657132228331,MATH 193A,A01,083224,Rotar; Vladimir,7,0,34,27
1657132228331,MATH 193A,A02,083225,Rotar; Vladimir,5,0,34,29
1657132228331,MATH 193A,A03,083781,Rotar; Vladimir,1,0,34,33
1657132228331,MATH 193A,A04,083782,Rotar; Vladimir,8,0,34,26
1657132228331,MATH 193A,A05,093482,Rotar; Vladimir,6,0,34,28
1657132234357,MATH 197,001,091859,McAuley; Julian John,9999,0,9999,0
1657132234357,MATH 197,002,095566,Kedlaya; Kiran S.,9997,0,9999,2
1657132234357,MATH 197,003,095567,Xiao; Ming,9999,0,9999,0
1657132234357,MATH 197,004,095571,Perols; Johan Lars,9998,0,9999,1
1657132241426,COGS 9,A01,083615,Shannon; Kyle Michael,7,0,75,68
1657132247450,COGS 11,A01,083617,Boyle; Mary E. T.,21,0,48,27
1657132253482,COGS 13,A01,083071,Bastos; Amalia Pinkusfeld,9,0,71,62
1657132259509,COGS 14A,A01,092681,Semenuks; Arturs,1,1,100,99
1657132265531,COGS 14B,A01,083073,Cheng; Tzu-Han,6,0,63,57
1657132271555,COGS 17,A01,092677,Semenuks; Arturs,4,0,81,77
1657132277579,COGS 100,A01,083619,Allen; Michael Gordon,15,0,70,55
1657132283607,COGS 101A,A01,083621,Davis; Joshua Daniel,9,0,68,59
1657132289635,COGS 101B,A01,091572,Allen; Michael Gordon,9,0,65,56
1657132295658,COGS 101C,A01,083625,Delgado; Tania,17,0,35,18
1657132301691,COGS 107A,A01,083627,Boyle; Mary E. T.,13,0,60,47
1657132307719,COGS 118A,A01,083075,Gupta; Anjum,15,0,76,61
1657132313742,CSE 3,A50,083646,Miranda; Gregory Joseph,23,0,50,27
1657132319767,CSE 8A,A50,083650,Miranda; Gregory Joseph,17,1,56,39
1657132325792,CSE 11,A01,083080,Cao; Yingjun,4,15,40,36
1657132331816,CSE 12,A01,083652,Krause-Levy; Sophia Louisa,23,1,120,97
1657132337838,CSE 15L,A01,083654,Morris; Justin Loren,9,0,50,41
1657132337838,CSE 15L,A02,083655,Morris; Justin Loren,9,0,50,41
1657132343860,CSE 20,A01,083657,Tran; Khoa Dang,38,0,80,42
1657132349894,CSE 21,A01,095574,Bach; Quang Tran,21,0,48,27
1657132355918,CSE 30,A01,083084,Eldon; John,4,0,80,76
1657132355918,CSE 30,B01,095061,Bhaskar; Nishant,7,0,50,43
1657132361941,CSE 100,A01,083659,Cao; Yingjun,4,4,70,66
1657132367973,CSE 134B,A01,083661,Powell; Thomas Allan,20,0,100,80
1657132374009,CSE 140,A01,083663,Gungor; Onat,13,0,85,72
1657132380033,CSE 140L,A01,083088,Eldon; John,17,0,100,83
1657132386059,CSE 175,A01,083665,Kumar; Rakesh,3,0,25,22
1657132392089,CSE 190,A00,092507,Dubnov; Shlomo,7,0,20,13
1657132398120,ECE 45,A01,083139,Congero; Spencer William,5,0,75,70
1657132404144,ECE 65,A50,083695,Saad; Andrew S,12,0,30,18
1657132404144,ECE 65,A51,095125,Saad; Andrew S,25,0,26,1
1657132410169,ECE 109,A01,091882,Touri; Behrouz,17,0,70,53
1657132416214,ECE 180,A00,083140,Abi Samra; Nicholas Camill,1,0,30,29
1657132416214,ECE 180,B00,083141,Abi Samra; Nicholas Camill,0,0,30,30
1657132422341,MATH 10A,A01,083735,Patchell; Gregory David,2,0,30,28
1657132422341,MATH 10A,A02,083736,Patchell; Gregory David,20,0,30,10
1657132422341,MATH 10A,A03,083737,Patchell; Gregory David,16,0,30,14
1657132428364,MATH 10B,A01,083207,Lim; Seonhee,7,0,34,27
1657132428364,MATH 10B,A02,083208,Lim; Seonhee,9,0,35,26
1657132428364,MATH 10B,A03,093472,Lim; Seonhee,5,0,34,29
1657132428364,MATH 10B,B01,083739,Sinha; Shubham,9,0,30,21
1657132434397,MATH 18,A01,083743,Cinel; Cameron Alexander,6,0,30,24
1657132434397,MATH 18,A02,083744,Cinel; Cameron Alexander,15,0,30,15
1657132434397,MATH 18,A03,083745,Cinel; Cameron Alexander,8,0,30,22
1657132434397,MATH 18,B01,083748,Rideout; David Porter,4,0,37,33
1657132434397,MATH 18,B02,083749,Rideout; David Porter,3,0,36,33
1657132434397,MATH 18,B03,083750,Rideout; David Porter,2,0,37,35
1657132434397,MATH 18,B04,083751,Rideout; David Porter,5,0,36,31
1657132434397,MATH 18,B05,093473,Rideout; David Porter,4,0,36,32
1657132434397,MATH 18,B06,093474,Rideout; David Porter,5,0,36,31
1657132440434,MATH 20A,A01,083754,Zheng; Zequn,12,0,40,28
1657132446470,MATH 20B,A01,083756,Briones; Jor-el Thomas Caparas,1,0,36,35
1657132446470,MATH 20B,A02,083757,Briones; Jor-el Thomas Caparas,1,0,36,35
1657132446470,MATH 20B,A03,093475,Briones; Jor-el Thomas Caparas,0,0,36,36
1657132452502,MATH 20C,A01,083760,Briones; Jor-el Thomas Caparas,1,0,35,34
1657132452502,MATH 20C,A02,083761,Briones; Jor-el Thomas Caparas,8,0,35,27
1657132452502,MATH 20C,A03,093476,Briones; Jor-el Thomas Caparas,0,1,36,36
1657132452502,MATH 20C,B01,083762,Bach; Quang Tran,0,0,30,30
1657132458530,MATH 20D,A01,083765,Tran; Brian Kha,4,0,30,26
1657132458530,MATH 20D,A02,083766,Tran; Brian Kha,5,0,30,25
1657132458530,MATH 20D,A03,083767,Tran; Brian Kha,3,0,30,27
1657132464552,MATH 20E,A01,083771,Ganguly; Soumya,6,0,32,26
1657132464552,MATH 20E,A02,083772,Ganguly; Soumya,6,0,32,26
1657132464552,MATH 20E,B01,083773,Ciotti; Benjamin,18,0,35,17
1657132464552,MATH 20E,B02,083774,Ciotti; Benjamin,17,0,35,18
1657132470575,MATH 103A,A01,083777,Greenfeld; Be'Eri,2,0,36,34
1657132470575,MATH 103A,A02,083778,Greenfeld; Be'Eri,5,0,36,31
1657132470575,MATH 103A,A03,093561,Greenfeld; Be'Eri,4,0,36,32
1657132470575,MATH 103A,B01,083779,Greenfeld; Be'Eri,6,0,36,30
1657132470575,MATH 103A,B02,083780,Greenfeld; Be'Eri,3,0,36,33
1657132470575,MATH 103A,B03,093562,Greenfeld; Be'Eri,3,0,36,33
1657132476599,MATH 105,A01,085443,Carter; Anne Toulson,14,0,35,21
1657132476599,MATH 105,A02,093477,Carter; Anne Toulson,20,0,35,15
1657132482631,MATH 109,A01,083213,Ganzberger; Geoffrey Michael,2,0,34,32
1657132482631,MATH 109,A02,083214,Ganzberger; Geoffrey Michael,3,0,34,31
1657132482631,MATH 109,A03,093478,Ganzberger; Geoffrey Michael,1,0,34,33
1657132482631,MATH 109,B01,083215,Ganzberger; Geoffrey Michael,1,0,32,31
1657132482631,MATH 109,B02,083216,Ganzberger; Geoffrey Michael,1,0,32,31
1657132482631,MATH 109,B03,093479,Ganzberger; Geoffrey Michael,6,0,32,26
1657132488658,MATH 142A,A01,083219,Chow; Bennett,6,0,32,26
1657132488658,MATH 142A,A02,083220,Chow; Bennett,10,0,32,22
1657132488658,MATH 142A,A03,093480,Chow; Bennett,7,0,32,25
1657132488658,MATH 142A,B03,093481,Chow; Bennett,8,0,32,24
1657132488658,MATH 142A,B04,093558,Chow; Bennett,11,0,32,21
1657132488658,MATH 142A,B05,093559,Chow; Bennett,6,0,32,26
1657132494687,MATH 193A,A01,083224,Rotar; Vladimir,7,0,34,27
1657132494687,MATH 193A,A02,083225,Rotar; Vladimir,5,0,34,29
1657132494687,MATH 193A,A03,083781,Rotar; Vladimir,1,0,34,33
1657132494687,MATH 193A,A04,083782,Rotar; Vladimir,8,0,34,26
1657132494687,MATH 193A,A05,093482,Rotar; Vladimir,6,0,34,28
1657132500714,MATH 197,001,091859,McAuley; Julian John,9999,0,9999,0
1657132500714,MATH 197,002,095566,Kedlaya; Kiran S.,9997,0,9999,2
1657132500714,MATH 197,003,095567,Xiao; Ming,9999,0,9999,0
1657132500714,MATH 197,004,095571,Perols; Johan Lars,9998,0,9999,1
1657132507776,COGS 9,A01,083615,Shannon; Kyle Michael,7,0,75,68
1657132513802,COGS 11,A01,083617,Boyle; Mary E. T.,21,0,48,27
1657132519830,COGS 13,A01,083071,Bastos; Amalia Pinkusfeld,9,0,71,62
1657132525856,COGS 14A,A01,092681,Semenuks; Arturs,1,1,100,99
1657132531884,COGS 14B,A01,083073,Cheng; Tzu-Han,6,0,63,57
1657132537916,COGS 17,A01,092677,Semenuks; Arturs,4,0,81,77
1657132543938,COGS 100,A01,083619,Allen; Michael Gordon,15,0,70,55
1657132549964,COGS 101A,A01,083621,Davis; Joshua Daniel,9,0,68,59
1657132555989,COGS 101B,A01,091572,Allen; Michael Gordon,9,0,65,56
1657132562022,COGS 101C,A01,083625,Delgado; Tania,17,0,35,18
1657132568047,COGS 107A,A01,083627,Boyle; Mary E. T.,13,0,60,47
1657132574071,COGS 118A,A01,083075,Gupta; Anjum,15,0,76,61
1657132580098,CSE 3,A50,083646,Miranda; Gregory Joseph,23,0,50,27
1657132586125,CSE 8A,A50,083650,Miranda; Gregory Joseph,17,1,56,39
1657132592152,CSE 11,A01,083080,Cao; Yingjun,4,15,40,36
1657132598175,CSE 12,A01,083652,Krause-Levy; Sophia Louisa,23,1,120,97
1657132604200,CSE 15L,A01,083654,Morris; Justin Loren,9,0,50,41
1657132604200,CSE 15L,A02,083655,Morris; Justin Loren,9,0,50,41
1657132610224,CSE 20,A01,083657,Tran; Khoa Dang,38,0,80,42
1657132616247,CSE 21,A01,095574,Bach; Quang Tran,21,0,48,27
1657132622274,CSE 30,A01,083084,Eldon; John,4,0,80,76
1657132622274,CSE 30,B01,095061,Bhaskar; Nishant,7,0,50,43
1657132628297,CSE 100,A01,083659,Cao; Yingjun,4,4,70,66
1657132634323,CSE 134B,A01,083661,Powell; Thomas Allan,20,0,100,80
1657132640346,CSE 140,A01,083663,Gungor; Onat,13,0,85,72
1657132646373,CSE 140L,A01,083088,Eldon; John,17,0,100,83
1657132652396,CSE 175,A01,083665,Kumar; Rakesh,3,0,25,22
1657132658420,CSE 190,A00,092507,Dubnov; Shlomo,7,0,20,13
1657132664446,ECE 45,A01,083139,Congero; Spencer William,5,0,75,70
1657132670471,ECE 65,A50,083695,Saad; Andrew S,12,0,30,18
1657132670471,ECE 65,A51,095125,Saad; Andrew S,25,0,26,1
1657132676495,ECE 109,A01,091882,Touri; Behrouz,17,0,70,53
1657132682524,ECE 180,A00,083140,Abi Samra; Nicholas Camill,1,0,30,29
1657132682524,ECE 180,B00,083141,Abi Samra; Nicholas Camill,0,0,30,30
1657132688552,MATH 10A,A01,083735,Patchell; Gregory David,2,0,30,28
1657132688552,MATH 10A,A02,083736,Patchell; Gregory David,20,0,30,10
1657132688552,MATH 10A,A03,083737,Patchell; Gregory David,16,0,30,14
1657132694580,MATH 10B,A01,083207,Lim; Seonhee,7,0,34,27
1657132694580,MATH 10B,A02,083208,Lim; Seonhee,9,0,35,26
1657132694580,MATH 10B,A03,093472,Lim; Seonhee,5,0,34,29
1657132694580,MATH 10B,B01,083739,Sinha; Shubham,9,0,30,21
1657132700610,MATH 18,A01,083743,Cinel; Cameron Alexander,6,0,30,24
1657132700610,MATH 18,A02,083744,Cinel; Cameron Alexander,15,0,30,15
1657132700610,MATH 18,A03,083745,Cinel; Cameron Alexander,8,0,30,22
1657132700610,MATH 18,B01,083748,Rideout; David Porter,4,0,37,33
1657132700610,MATH 18,B02,083749,Rideout; David Porter,3,0,36,33
1657132700610,MATH 18,B03,083750,Rideout; David Porter,2,0,37,35
1657132700610,MATH 18,B04,083751,Rideout; David Porter,5,0,36,31
1657132700610,MATH 18,B05,093473,Rideout; David Porter,4,0,36,32
1657132700610,MATH 18,B06,093474,Rideout; David Porter,5,0,36,31
1657132706638,MATH 20A,A01,083754,Zheng; Zequn,12,0,40,28
1657132712660,MATH 20B,A01,083756,Briones; Jor-el Thomas Caparas,1,0,36,35
1657132712660,MATH 20B,A02,083757,Briones; Jor-el Thomas Caparas,1,0,36,35
1657132712660,MATH 20B,A03,093475,Briones; Jor-el Thomas Caparas,0,0,36,36
1657132718685,MATH 20C,A01,083760,Briones; Jor-el Thomas Caparas,1,0,35,34
1657132718685,MATH 20C,A02,083761,Briones; Jor-el Thomas Caparas,8,0,35,27
1657132718685,MATH 20C,A03,093476,Briones; Jor-el Thomas Caparas,0,1,36,36
1657132718685,MATH 20C,B01,083762,Bach; Quang Tran,0,0,30,30
1657132724714,MATH 20D,A01,083765,Tran; Brian Kha,4,0,30,26
1657132724714,MATH 20D,A02,083766,Tran; Brian Kha,5,0,30,25
1657132724714,MATH 20D,A03,083767,Tran; Brian Kha,3,0,30,27
1657132730738,MATH 20E,A01,083771,Ganguly; Soumya,6,0,32,26
1657132730738,MATH 20E,A02,083772,Ganguly; Soumya,6,0,32,26
1657132730738,MATH 20E,B01,083773,Ciotti; Benjamin,18,0,35,17
1657132730738,MATH 20E,B02,083774,Ciotti; Benjamin,17,0,35,18
1657132736761,MATH 103A,A01,083777,Greenfeld; Be'Eri,2,0,36,34
1657132736761,MATH 103A,A02,083778,Greenfeld; Be'Eri,5,0,36,31
1657132736761,MATH 103A,A03,093561,Greenfeld; Be'Eri,4,0,36,32
1657132736761,MATH 103A,B01,083779,Greenfeld; Be'Eri,6,0,36,30
1657132736761,MATH 103A,B02,083780,Greenfeld; Be'Eri,3,0,36,33
1657132736761,MATH 103A,B03,093562,Greenfeld; Be'Eri,3,0,36,33
1657132742797,MATH 105,A01,085443,Carter; Anne Toulson,14,0,35,21
1657132742797,MATH 105,A02,093477,Carter; Anne Toulson,20,0,35,15
1657132748820,MATH 109,A01,083213,Ganzberger; Geoffrey Michael,2,0,34,32
1657132748820,MATH 109,A02,083214,Ganzberger; Geoffrey Michael,3,0,34,31
1657132748820,MATH 109,A03,093478,Ganzberger; Geoffrey Michael,1,0,34,33
1657132748820,MATH 109,B01,083215,Ganzberger; Geoffrey Michael,1,0,32,31
1657132748820,MATH 109,B02,083216,Ganzberger; Geoffrey Michael,1,0,32,31
1657132748820,MATH 109,B03,093479,Ganzberger; Geoffrey Michael,6,0,32,26
1657132754849,MATH 142A,A01,083219,Chow; Bennett,6,0,32,26
1657132754849,MATH 142A,A02,083220,Chow; Bennett,10,0,32,22
1657132754849,MATH 142A,A03,093480,Chow; Bennett,7,0,32,25
1657132754849,MATH 142A,B03,093481,Chow; Bennett,8,0,32,24
1657132754849,MATH 142A,B04,093558,Chow; Bennett,11,0,32,21
1657132754849,MATH 142A,B05,093559,Chow; Bennett,6,0,32,26
1657132760877,MATH 193A,A01,083224,Rotar; Vladimir,7,0,34,27
1657132760877,MATH 193A,A02,083225,Rotar; Vladimir,5,0,34,29
1657132760877,MATH 193A,A03,083781,Rotar; Vladimir,1,0,34,33
1657132760877,MATH 193A,A04,083782,Rotar; Vladimir,8,0,34,26
1657132760877,MATH 193A,A05,093482,Rotar; Vladimir,6,0,34,28
1657132766900,MATH 197,001,091859,McAuley; Julian John,9999,0,9999,0
1657132766900,MATH 197,002,095566,Kedlaya; Kiran S.,9997,0,9999,2
1657132766900,MATH 197,003,095567,Xiao; Ming,9999,0,9999,0
1657132766900,MATH 197,004,095571,Perols; Johan Lars,9998,0,9999,1
1657132773979,COGS 9,A01,083615,Shannon; Kyle Michael,7,0,75,68
1657132780003,COGS 11,A01,083617,Boyle; Mary E. T.,21,0,48,27
1657132786041,COGS 13,A01,083071,Bastos; Amalia Pinkusfeld,9,0,71,62
1657132792063,COGS 14A,A01,092681,Semenuks; Arturs,1,1,100,99
1657132798092,COGS 14B,A01,083073,Cheng; Tzu-Han,6,0,63,57
1657132804119,COGS 17,A01,092677,Semenuks; Arturs,4,0,81,77
1657132810141,COGS 100,A01,083619,Allen; Michael Gordon,15,0,70,55
1657132816173,COGS 101A,A01,083621,Davis; Joshua Daniel,9,0,68,59
1657132822201,COGS 101B,A01,091572,Allen; Michael Gordon,9,0,65,56
1657132828223,COGS 101C,A01,083625,Delgado; Tania,17,0,35,18
1657132834245,COGS 107A,A01,083627,Boyle; Mary E. T.,13,0,60,47
1657132840273,COGS 118A,A01,083075,Gupta; Anjum,15,0,76,61
1657132846294,CSE 3,A50,083646,Miranda; Gregory Joseph,23,0,50,27
1657132852319,CSE 8A,A50,083650,Miranda; Gregory Joseph,17,1,56,39
1657132858341,CSE 11,A01,083080,Cao; Yingjun,4,15,40,36
1657132864366,CSE 12,A01,083652,Krause-Levy; Sophia Louisa,23,1,120,97
1657132870400,CSE 15L,A01,083654,Morris; Justin Loren,9,0,50,41
1657132870400,CSE 15L,A02,083655,Morris; Justin Loren,9,0,50,41
1657132876426,CSE 20,A01,083657,Tran; Khoa Dang,38,0,80,42
1657132882461,CSE 21,A01,095574,Bach; Quang Tran,21,0,48,27
1657132888485,CSE 30,A01,083084,Eldon; John,4,0,80,76
1657132888485,CSE 30,B01,095061,Bhaskar; Nishant,7,0,50,43
1657132894511,CSE 100,A01,083659,Cao; Yingjun,4,4,70,66
1657132900534,CSE 134B,A01,083661,Powell; Thomas Allan,20,0,100,80
1657132906563,CSE 140,A01,083663,Gungor; Onat,13,0,85,72
1657132912595,CSE 140L,A01,083088,Eldon; John,17,0,100,83
1657132918619,CSE 175,A01,083665,Kumar; Rakesh,3,0,25,22
1657132924642,CSE 190,A00,092507,Dubnov; Shlomo,7,0,20,13
1657132930677,ECE 45,A01,083139,Congero; Spencer William,5,0,75,70
1657132936708,ECE 65,A50,083695,Saad; Andrew S,12,0,30,18
1657132936708,ECE 65,A51,095125,Saad; Andrew S,25,0,26,1
1657132942731,ECE 109,A01,091882,Touri; Behrouz,17,0,70,53
1657132948753,ECE 180,A00,083140,Abi Samra; Nicholas Camill,1,0,30,29
1657132948753,ECE 180,B00,083141,Abi Samra; Nicholas Camill,0,0,30,30
1657132954775,MATH 10A,A01,083735,Patchell; Gregory David,2,0,30,28
1657132954775,MATH 10A,A02,083736,Patchell; Gregory David,20,0,30,10
1657132954775,MATH 10A,A03,083737,Patchell; Gregory David,16,0,30,14
1657132960798,MATH 10B,A01,083207,Lim; Seonhee,7,0,34,27
1657132960798,MATH 10B,A02,083208,Lim; Seonhee,9,0,35,26
1657132960798,MATH 10B,A03,093472,Lim; Seonhee,5,0,34,29
1657132960798,MATH 10B,B01,083739,Sinha; Shubham,9,0,30,21
1657132966832,MATH 18,A01,083743,Cinel; Cameron Alexander,6,0,30,24
1657132966832,MATH 18,A02,083744,Cinel; Cameron Alexander,15,0,30,15
1657132966832,MATH 18,A03,083745,Cinel; Cameron Alexander,8,0,30,22
1657132966832,MATH 18,B01,083748,Rideout; David Porter,4,0,37,33
1657132966832,MATH 18,B02,083749,Rideout; David Porter,3,0,36,33
1657132966832,MATH 18,B03,083750,Rideout; David Porter,2,0,37,35
1657132966832,MATH 18,B04,083751,Rideout; David Porter,5,0,36,31
1657132966832,MATH 18,B05,093473,Rideout; David Porter,4,0,36,32
1657132966832,MATH 18,B06,093474,Rideout; David Porter,5,0,36,31
1657132972877,MATH 20A,A01,083754,Zheng; Zequn,12,0,40,28
1657132978910,MATH 20B,A01,083756,Briones; Jor-el Thomas Caparas,1,0,36,35
1657132978910,MATH 20B,A02,083757,Briones; Jor-el Thomas Caparas,1,0,36,35
1657132978910,MATH 20B,A03,093475,Briones; Jor-el Thomas Caparas,0,0,36,36
1657132984934,MATH 20C,A01,083760,Briones; Jor-el Thomas Caparas,1,0,35,34
1657132984934,MATH 20C,A02,083761,Briones; Jor-el Thomas Caparas,8,0,35,27
1657132984934,MATH 20C,A03,093476,Briones; Jor-el Thomas Caparas,0,1,36,36
1657132984934,MATH 20C,B01,083762,Bach; Quang Tran,0,0,30,30
1657132990956,MATH 20D,A01,083765,Tran; Brian Kha,4,0,30,26
1657132990956,MATH 20D,A02,083766,Tran; Brian Kha,5,0,30,25
1657132990956,MATH 20D,A03,083767,Tran; Brian Kha,3,0,30,27
1657132996979,MATH 20E,A01,083771,Ganguly; Soumya,6,0,32,26
1657132996979,MATH 20E,A02,083772,Ganguly; Soumya,6,0,32,26
1657132996979,MATH 20E,B01,083773,Ciotti; Benjamin,18,0,35,17
1657132996979,MATH 20E,B02,083774,Ciotti; Benjamin,17,0,35,18
1657133003008,MATH 103A,A01,083777,Greenfeld; Be'Eri,2,0,36,34
1657133003008,MATH 103A,A02,083778,Greenfeld; Be'Eri,5,0,36,31
1657133003008,MATH 103A,A03,093561,Greenfeld; Be'Eri,4,0,36,32
1657133003008,MATH 103A,B01,083779,Greenfeld; Be'Eri,6,0,36,30
1657133003008,MATH 103A,B02,083780,Greenfeld; Be'Eri,3,0,36,33
1657133003008,MATH 103A,B03,093562,Greenfeld; Be'Eri,3,0,36,33
1657133009031,MATH 105,A01,085443,Carter; Anne Toulson,14,0,35,21
1657133009031,MATH 105,A02,093477,Carter; Anne Toulson,20,0,35,15
1657133015061,MATH 109,A01,083213,Ganzberger; Geoffrey Michael,2,0,34,32
1657133015061,MATH 109,A02,083214,Ganzberger; Geoffrey Michael,3,0,34,31
1657133015061,MATH 109,A03,093478,Ganzberger; Geoffrey Michael,1,0,34,33
1657133015061,MATH 109,B01,083215,Ganzberger; Geoffrey Michael,1,0,32,31
1657133015061,MATH 109,B02,083216,Ganzberger; Geoffrey Michael,1,0,32,31
1657133015061,MATH 109,B03,093479,Ganzberger; Geoffrey Michael,6,0,32,26
1657133021181,MATH 142A,A01,083219,Chow; Bennett,6,0,32,26
1657133021181,MATH 142A,A02,083220,Chow; Bennett,10,0,32,22
1657133021181,MATH 142A,A03,093480,Chow; Bennett,7,0,32,25
1657133021181,MATH 142A,B03,093481,Chow; Bennett,8,0,32,24
1657133021181,MATH 142A,B04,093558,Chow; Bennett,11,0,32,21
1657133021181,MATH 142A,B05,093559,Chow; Bennett,6,0,32,26
1657133027207,MATH 193A,A01,083224,Rotar; Vladimir,7,0,34,27
1657133027207,MATH 193A,A02,083225,Rotar; Vladimir,5,0,34,29
1657133027207,MATH 193A,A03,083781,Rotar; Vladimir,1,0,34,33
1657133027207,MATH 193A,A04,083782,Rotar; Vladimir,8,0,34,26
1657133027207,MATH 193A,A05,093482,Rotar; Vladimir,6,0,34,28
1657133033235,MATH 197,001,091859,McAuley; Julian John,9999,0,9999,0
1657133033235,MATH 197,002,095566,Kedlaya; Kiran S.,9997,0,9999,2
1657133033235,MATH 197,003,095567,Xiao; Ming,9999,0,9999,0
1657133033235,MATH 197,004,095571,Perols; Johan Lars,9998,0,9999,1
1657133040298,COGS 9,A01,083615,Shannon; Kyle Michael,7,0,75,68
1657133046324,COGS 11,A01,083617,Boyle; Mary E. T.,21,0,48,27
1657133052352,COGS 13,A01,083071,Bastos; Amalia Pinkusfeld,9,0,71,62
1657133058375,COGS 14A,A01,092681,Semenuks; Arturs,1,1,100,99
1657133064399,COGS 14B,A01,083073,Cheng; Tzu-Han,6,0,63,57
1657133070424,COGS 17,A01,092677,Semenuks; Arturs,4,0,81,77
1657133076460,COGS 100,A01,083619,Allen; Michael Gordon,15,0,70,55
1657133082495,COGS 101A,A01,083621,Davis; Joshua Daniel,9,0,68,59
1657133088535,COGS 101B,A01,091572,Allen; Michael Gordon,9,0,65,56
1657133094567,COGS 101C,A01,083625,Delgado; Tania,17,0,35,18
1657133100590,COGS 107A,A01,083627,Boyle; Mary E. T.,13,0,60,47
1657133106624,COGS 118A,A01,083075,Gupta; Anjum,15,0,76,61
1657133112659,CSE 3,A50,083646,Miranda; Gregory Joseph,23,0,50,27
1657133118687,CSE 8A,A50,083650,Miranda; Gregory Joseph,17,1,56,39
1657133124709,CSE 11,A01,083080,Cao; Yingjun,4,15,40,36
1657133130735,CSE 12,A01,083652,Krause-Levy; Sophia Louisa,23,1,120,97
1657133136758,CSE 15L,A01,083654,Morris; Justin Loren,9,0,50,41
1657133136758,CSE 15L,A02,083655,Morris; Justin Loren,9,0,50,41
1657133142785,CSE 20,A01,083657,Tran; Khoa Dang,38,0,80,42
1657133148810,CSE 21,A01,095574,Bach; Quang Tran,21,0,48,27
1657133154840,CSE 30,A01,083084,Eldon; John,4,0,80,76
1657133154840,CSE 30,B01,095061,Bhaskar; Nishant,7,0,50,43
1657133160864,CSE 100,A01,083659,Cao; Yingjun,4,4,70,66
1657133166886,CSE 134B,A01,083661,Powell; Thomas Allan,20,0,100,80
1657133172918,CSE 140,A01,083663,Gungor; Onat,13,0,85,72
1657133178945,CSE 140L,A01,083088,Eldon; John,17,0,100,83
1657133184972,CSE 175,A01,083665,Kumar; Rakesh,3,0,25,22
1657133190998,CSE 190,A00,092507,Dubnov; Shlomo,7,0,20,13
1657133197020,ECE 45,A01,083139,Congero; Spencer William,5,0,75,70
1657133203048,ECE 65,A50,083695,Saad; Andrew S,12,0,30,18
1657133203048,ECE 65,A51,095125,Saad; Andrew S,25,0,26,1
1657133209073,ECE 109,A01,091882,Touri; Behrouz,17,0,70,53
1657133215103,ECE 180,A00,083140,Abi Samra; Nicholas Camill,1,0,30,29
1657133215103,ECE 180,B00,083141,Abi Samra; Nicholas Camill,0,0,30,30
1657133221137,MATH 10A,A01,083735,Patchell; Gregory David,2,0,30,28
1657133221137,MATH 10A,A02,083736,Patchell; Gregory David,20,0,30,10
1657133221137,MATH 10A,A03,083737,Patchell; Gregory David,16,0,30,14
1657133227166,MATH 10B,A01,083207,Lim; Seonhee,6,0,34,28
1657133227166,MATH 10B,A02,083208,Lim; Seonhee,9,0,35,26
1657133227166,MATH 10B,A03,093472,Lim; Seonhee,5,0,34,29
1657133227166,MATH 10B,B01,083739,Sinha; Shubham,9,0,30,21
1657133233190,MATH 18,A01,083743,Cinel; Cameron Alexander,6,0,30,24
1657133233190,MATH 18,A02,083744,Cinel; Cameron Alexander,15,0,30,15
1657133233190,MATH 18,A03,083745,Cinel; Cameron Alexander,8,0,30,22
1657133233190,MATH 18,B01,083748,Rideout; David Porter,4,0,37,33
1657133233190,MATH 18,B02,083749,Rideout; David Porter,3,0,36,33
1657133233190,MATH 18,B03,083750,Rideout; David Porter,2,0,37,35
1657133233190,MATH 18,B04,083751,Rideout; David Porter,5,0,36,31
1657133233190,MATH 18,B05,093473,Rideout; David Porter,4,0,36,32
1657133233190,MATH 18,B06,093474,Rideout; David Porter,5,0,36,31
1657133239217,MATH 20A,A01,083754,Zheng; Zequn,12,0,40,28
1657133245251,MATH 20B,A01,083756,Briones; Jor-el Thomas Caparas,1,0,36,35
1657133245251,MATH 20B,A02,083757,Briones; Jor-el Thomas Caparas,1,0,36,35
1657133245251,MATH 20B,A03,093475,Briones; Jor-el Thomas Caparas,0,0,36,36
1657133251286,MATH 20C,A01,083760,Briones; Jor-el Thomas Caparas,1,0,35,34
1657133251286,MATH 20C,A02,083761,Briones; Jor-el Thomas Caparas,8,0,35,27
1657133251286,MATH 20C,A03,093476,Briones; Jor-el Thomas Caparas,0,1,36,36
1657133251286,MATH 20C,B01,083762,Bach; Quang Tran,0,0,30,30
1657133257309,MATH 20D,A01,083765,Tran; Brian Kha,4,0,30,26
1657133257309,MATH 20D,A02,083766,Tran; Brian Kha,5,0,30,25
1657133257309,MATH 20D,A03,083767,Tran; Brian Kha,3,0,30,27
1657133263338,MATH 20E,A01,083771,Ganguly; Soumya,6,0,32,26
1657133263338,MATH 20E,A02,083772,Ganguly; Soumya,6,0,32,26
1657133263338,MATH 20E,B01,083773,Ciotti; Benjamin,18,0,35,17
1657133263338,MATH 20E,B02,083774,Ciotti; Benjamin,17,0,35,18
1657133269378,MATH 103A,A01,083777,Greenfeld; Be'Eri,2,0,36,34
1657133269378,MATH 103A,A02,083778,Greenfeld; Be'Eri,5,0,36,31
1657133269378,MATH 103A,A03,093561,Greenfeld; Be'Eri,4,0,36,32
1657133269378,MATH 103A,B01,083779,Greenfeld; Be'Eri,6,0,36,30
1657133269378,MATH 103A,B02,083780,Greenfeld; Be'Eri,3,0,36,33
1657133269378,MATH 103A,B03,093562,Greenfeld; Be'Eri,3,0,36,33
1657133275399,MATH 105,A01,085443,Carter; Anne Toulson,14,0,35,21
1657133275399,MATH 105,A02,093477,Carter; Anne Toulson,20,0,35,15
1657133281427,MATH 109,A01,083213,Ganzberger; Geoffrey Michael,2,0,34,32
1657133281427,MATH 109,A02,083214,Ganzberger; Geoffrey Michael,3,0,34,31
1657133281427,MATH 109,A03,093478,Ganzberger; Geoffrey Michael,1,0,34,33
1657133281427,MATH 109,B01,083215,Ganzberger; Geoffrey Michael,1,0,32,31
1657133281427,MATH 109,B02,083216,Ganzberger; Geoffrey Michael,1,0,32,31
1657133281427,MATH 109,B03,093479,Ganzberger; Geoffrey Michael,6,0,32,26
1657133287457,MATH 142A,A01,083219,Chow; Bennett,6,0,32,26
1657133287457,MATH 142A,A02,083220,Chow; Bennett,10,0,32,22
1657133287457,MATH 142A,A03,093480,Chow; Bennett,7,0,32,25
1657133287457,MATH 142A,B03,093481,Chow; Bennett,8,0,32,24
1657133287457,MATH 142A,B04,093558,Chow; Bennett,11,0,32,21
1657133287457,MATH 142A,B05,093559,Chow; Bennett,6,0,32,26
1657133293484,MATH 193A,A01,083224,Rotar; Vladimir,7,0,34,27
1657133293484,MATH 193A,A02,083225,Rotar; Vladimir,5,0,34,29
1657133293484,MATH 193A,A03,083781,Rotar; Vladimir,1,0,34,33
1657133293484,MATH 193A,A04,083782,Rotar; Vladimir,8,0,34,26
1657133293484,MATH 193A,A05,093482,Rotar; Vladimir,6,0,34,28
1657133299510,MATH 197,001,091859,McAuley; Julian John,9999,0,9999,0
1657133299510,MATH 197,002,095566,Kedlaya; Kiran S.,9997,0,9999,2
1657133299510,MATH 197,003,095567,Xiao; Ming,9999,0,9999,0
1657133299510,MATH 197,004,095571,Perols; Johan Lars,9998,0,9999,1
1657133306572,COGS 9,A01,083615,Shannon; Kyle Michael,7,0,75,68
1657133312595,COGS 11,A01,083617,Boyle; Mary E. T.,21,0,48,27
1657133318617,COGS 13,A01,083071,Bastos; Amalia Pinkusfeld,9,0,71,62
1657133324646,COGS 14A,A01,092681,Semenuks; Arturs,1,1,100,99
1657133330672,COGS 14B,A01,083073,Cheng; Tzu-Han,6,0,63,57
1657133336695,COGS 17,A01,092677,Semenuks; Arturs,4,0,81,77
1657133342718,COGS 100,A01,083619,Allen; Michael Gordon,15,0,70,55
1657133348742,COGS 101A,A01,083621,Davis; Joshua Daniel,9,0,68,59
1657133354772,COGS 101B,A01,091572,Allen; Michael Gordon,9,0,65,56
1657133360796,COGS 101C,A01,083625,Delgado; Tania,17,0,35,18
1657133366824,COGS 107A,A01,083627,Boyle; Mary E. T.,13,0,60,47
1657133372845,COGS 118A,A01,083075,Gupta; Anjum,15,0,76,61
1657133378869,CSE 3,A50,083646,Miranda; Gregory Joseph,23,0,50,27
1657133384892,CSE 8A,A50,083650,Miranda; Gregory Joseph,17,1,56,39
1657133390928,CSE 11,A01,083080,Cao; Yingjun,4,15,40,36
1657133396959,CSE 12,A01,083652,Krause-Levy; Sophia Louisa,23,1,120,97
1657133402983,CSE 15L,A01,083654,Morris; Justin Loren,9,0,50,41
1657133402983,CSE 15L,A02,083655,Morris; Justin Loren,9,0,50,41
1657133409011,CSE 20,A01,083657,Tran; Khoa Dang,38,0,80,42
1657133415048,CSE 21,A01,095574,Bach; Quang Tran,21,0,48,27
1657133421076,CSE 30,A01,083084,Eldon; John,4,0,80,76
1657133421076,CSE 30,B01,095061,Bhaskar; Nishant,7,0,50,43
1657133427101,CSE 100,A01,083659,Cao; Yingjun,4,4,70,66
1657133433139,CSE 134B,A01,083661,Powell; Thomas Allan,20,0,100,80
1657133439166,CSE 140,A01,083663,Gungor; Onat,13,0,85,72
1657133445193,CSE 140L,A01,083088,Eldon; John,17,0,100,83
1657133451221,CSE 175,A01,083665,Kumar; Rakesh,3,0,25,22
1657133457248,CSE 190,A00,092507,Dubnov; Shlomo,7,0,20,13
1657133463284,ECE 45,A01,083139,Congero; Spencer William,5,0,75,70
1657133469312,ECE 65,A50,083695,Saad; Andrew S,12,0,30,18
1657133469312,ECE 65,A51,095125,Saad; Andrew S,25,0,26,1
1657133475335,ECE 109,A01,091882,Touri; Behrouz,17,0,70,53
1657133481358,ECE 180,A00,083140,Abi Samra; Nicholas Camill,1,0,30,29
1657133481358,ECE 180,B00,083141,Abi Samra; Nicholas Camill,0,0,30,30
1657133487388,MATH 10A,A01,083735,Patchell; Gregory David,2,0,30,28
1657133487388,MATH 10A,A02,083736,Patchell; Gregory David,20,0,30,10
1657133487388,MATH 10A,A03,083737,Patchell; Gregory David,16,0,30,14
1657133493411,MATH 10B,A01,083207,Lim; Seonhee,6,0,34,28
1657133493411,MATH 10B,A02,083208,Lim; Seonhee,9,0,35,26
1657133493411,MATH 10B,A03,093472,Lim; Seonhee,5,0,34,29
1657133493411,MATH 10B,B01,083739,Sinha; Shubham,9,0,30,21
1657133499445,MATH 18,A01,083743,Cinel; Cameron Alexander,6,0,30,24
1657133499445,MATH 18,A02,083744,Cinel; Cameron Alexander,15,0,30,15
1657133499445,MATH 18,A03,083745,Cinel; Cameron Alexander,8,0,30,22
1657133499445,MATH 18,B01,083748,Rideout; David Porter,4,0,37,33
1657133499445,MATH 18,B02,083749,Rideout; David Porter,3,0,36,33
1657133499445,MATH 18,B03,083750,Rideout; David Porter,2,0,37,35
1657133499445,MATH 18,B04,083751,Rideout; David Porter,5,0,36,31
1657133499445,MATH 18,B05,093473,Rideout; David Porter,4,0,36,32
1657133499445,MATH 18,B06,093474,Rideout; David Porter,5,0,36,31
1657133505469,MATH 20A,A01,083754,Zheng; Zequn,12,0,40,28
1657133511493,MATH 20B,A01,083756,Briones; Jor-el Thomas Caparas,1,0,36,35
1657133511493,MATH 20B,A02,083757,Briones; Jor-el Thomas Caparas,1,0,36,35
1657133511493,MATH 20B,A03,093475,Briones; Jor-el Thomas Caparas,0,0,36,36
1657133517520,MATH 20C,A01,083760,Briones; Jor-el Thomas Caparas,1,0,35,34
1657133517520,MATH 20C,A02,083761,Briones; Jor-el Thomas Caparas,8,0,35,27
1657133517520,MATH 20C,A03,093476,Briones; Jor-el Thomas Caparas,0,1,36,36
1657133517520,MATH 20C,B01,083762,Bach; Quang Tran,0,0,30,30
1657133523543,MATH 20D,A01,083765,Tran; Brian Kha,4,0,30,26
1657133523543,MATH 20D,A02,083766,Tran; Brian Kha,5,0,30,25
1657133523543,MATH 20D,A03,083767,Tran; Brian Kha,3,0,30,27
1657133529571,MATH 20E,A01,083771,Ganguly; Soumya,6,0,32,26
1657133529571,MATH 20E,A02,083772,Ganguly; Soumya,6,0,32,26
1657133529571,MATH 20E,B01,083773,Ciotti; Benjamin,18,0,35,17
1657133529571,MATH 20E,B02,083774,Ciotti; Benjamin,17,0,35,18
1657133535597,MATH 103A,A01,083777,Greenfeld; Be'Eri,2,0,36,34
1657133535597,MATH 103A,A02,083778,Greenfeld; Be'Eri,5,0,36,31
1657133535597,MATH 103A,A03,093561,Greenfeld; Be'Eri,4,0,36,32
1657133535597,MATH 103A,B01,083779,Greenfeld; Be'Eri,6,0,36,30
1657133535597,MATH 103A,B02,083780,Greenfeld; Be'Eri,3,0,36,33
1657133535597,MATH 103A,B03,093562,Greenfeld; Be'Eri,3,0,36,33
1657133541622,MATH 105,A01,085443,Carter; Anne Toulson,14,0,35,21
1657133541622,MATH 105,A02,093477,Carter; Anne Toulson,20,0,35,15
1657133547659,MATH 109,A01,083213,Ganzberger; Geoffrey Michael,2,0,34,32
1657133547659,MATH 109,A02,083214,Ganzberger; Geoffrey Michael,3,0,34,31
1657133547659,MATH 109,A03,093478,Ganzberger; Geoffrey Michael,1,0,34,33
1657133547659,MATH 109,B01,083215,Ganzberger; Geoffrey Michael,1,0,32,31
1657133547659,MATH 109,B02,083216,Ganzberger; Geoffrey Michael,1,0,32,31
1657133547659,MATH 109,B03,093479,Ganzberger; Geoffrey Michael,6,0,32,26
1657133553683,MATH 142A,A01,083219,Chow; Bennett,6,0,32,26
1657133553683,MATH 142A,A02,083220,Chow; Bennett,10,0,32,22
1657133553683,MATH 142A,A03,093480,Chow; Bennett,7,0,32,25
1657133553683,MATH 142A,B03,093481,Chow; Bennett,8,0,32,24
1657133553683,MATH 142A,B04,093558,Chow; Bennett,11,0,32,21
1657133553683,MATH 142A,B05,093559,Chow; Bennett,6,0,32,26
1657133559716,MATH 193A,A01,083224,Rotar; Vladimir,7,0,34,27
1657133559716,MATH 193A,A02,083225,Rotar; Vladimir,5,0,34,29
1657133559716,MATH 193A,A03,083781,Rotar; Vladimir,1,0,34,33
1657133559716,MATH 193A,A04,083782,Rotar; Vladimir,8,0,34,26
1657133559716,MATH 193A,A05,093482,Rotar; Vladimir,6,0,34,28
1657133565739,MATH 197,001,091859,McAuley; Julian John,9999,0,9999,0
1657133565739,MATH 197,002,095566,Kedlaya; Kiran S.,9997,0,9999,2
1657133565739,MATH 197,003,095567,Xiao; Ming,9999,0,9999,0
1657133565739,MATH 197,004,095571,Perols; Johan Lars,9998,0,9999,1
1657133572809,COGS 9,A01,083615,Shannon; Kyle Michael,7,0,75,68
1657133578840,COGS 11,A01,083617,Boyle; Mary E. T.,21,0,48,27
1657133584867,COGS 13,A01,083071,Bastos; Amalia Pinkusfeld,9,0,71,62
1657133590889,COGS 14A,A01,092681,Semenuks; Arturs,1,1,100,99
1657133596917,COGS 14B,A01,083073,Cheng; Tzu-Han,6,0,63,57
1657133602943,COGS 17,A01,092677,Semenuks; Arturs,4,0,81,77
1657133608972,COGS 100,A01,083619,Allen; Michael Gordon,15,0,70,55
1657133615071,COGS 101A,A01,083621,Davis; Joshua Daniel,9,0,68,59
1657133621093,COGS 101B,A01,091572,Allen; Michael Gordon,9,0,65,56
1657133627124,COGS 101C,A01,083625,Delgado; Tania,17,0,35,18
1657133633149,COGS 107A,A01,083627,Boyle; Mary E. T.,13,0,60,47
1657133639174,COGS 118A,A01,083075,Gupta; Anjum,15,0,76,61
1657133645200,CSE 3,A50,083646,Miranda; Gregory Joseph,23,0,50,27
1657133651227,CSE 8A,A50,083650,Miranda; Gregory Joseph,17,1,56,39
1657133657249,CSE 11,A01,083080,Cao; Yingjun,4,15,40,36
1657133663276,CSE 12,A01,083652,Krause-Levy; Sophia Louisa,23,1,120,97
1657133669302,CSE 15L,A01,083654,Morris; Justin Loren,9,0,50,41
1657133669302,CSE 15L,A02,083655,Morris; Justin Loren,9,0,50,41
1657133675326,CSE 20,A01,083657,Tran; Khoa Dang,38,0,80,42
1657133681348,CSE 21,A01,095574,Bach; Quang Tran,21,0,48,27
1657133687376,CSE 30,A01,083084,Eldon; John,4,0,80,76
1657133687376,CSE 30,B01,095061,Bhaskar; Nishant,7,0,50,43
1657133693400,CSE 100,A01,083659,Cao; Yingjun,4,4,70,66
1657133699424,CSE 134B,A01,083661,Powell; Thomas Allan,20,0,100,80
1657133705449,CSE 140,A01,083663,Gungor; Onat,13,0,85,72
1657133711475,CSE 140L,A01,083088,Eldon; John,17,0,100,83
1657133717502,CSE 175,A01,083665,Kumar; Rakesh,3,0,25,22
1657133723527,CSE 190,A00,092507,Dubnov; Shlomo,7,0,20,13
1657133729554,ECE 45,A01,083139,Congero; Spencer William,5,0,75,70
1657133735579,ECE 65,A50,083695,Saad; Andrew S,12,0,30,18
1657133735579,ECE 65,A51,095125,Saad; Andrew S,25,0,26,1
1657133741602,ECE 109,A01,091882,Touri; Behrouz,17,0,70,53
1657133747632,ECE 180,A00,083140,Abi Samra; Nicholas Camill,1,0,30,29
1657133747632,ECE 180,B00,083141,Abi Samra; Nicholas Camill,0,0,30,30
1657133753665,MATH 10A,A01,083735,Patchell; Gregory David,2,0,30,28
1657133753665,MATH 10A,A02,083736,Patchell; Gregory David,20,0,30,10
1657133753665,MATH 10A,A03,083737,Patchell; Gregory David,16,0,30,14
1657133759688,MATH 10B,A01,083207,Lim; Seonhee,7,0,34,27
1657133759688,MATH 10B,A02,083208,Lim; Seonhee,9,0,35,26
1657133759688,MATH 10B,A03,093472,Lim; Seonhee,5,0,34,29
1657133759688,MATH 10B,B01,083739,Sinha; Shubham,9,0,30,21
1657133765721,MATH 18,A01,083743,Cinel; Cameron Alexander,6,0,30,24
1657133765721,MATH 18,A02,083744,Cinel; Cameron Alexander,15,0,30,15
1657133765721,MATH 18,A03,083745,Cinel; Cameron Alexander,8,0,30,22
1657133765721,MATH 18,B01,083748,Rideout; David Porter,4,0,37,33
1657133765721,MATH 18,B02,083749,Rideout; David Porter,3,0,36,33
1657133765721,MATH 18,B03,083750,Rideout; David Porter,2,0,37,35
1657133765721,MATH 18,B04,083751,Rideout; David Porter,5,0,36,31
1657133765721,MATH 18,B05,093473,Rideout; David Porter,4,0,36,32
1657133765721,MATH 18,B06,093474,Rideout; David Porter,5,0,36,31
1657133771745,MATH 20A,A01,083754,Zheng; Zequn,12,0,40,28
1657133777780,MATH 20B,A01,083756,Briones; Jor-el Thomas Caparas,1,0,36,35
1657133777780,MATH 20B,A02,083757,Briones; Jor-el Thomas Caparas,1,0,36,35
1657133777780,MATH 20B,A03,093475,Briones; Jor-el Thomas Caparas,0,0,36,36
1657133783808,MATH 20C,A01,083760,Briones; Jor-el Thomas Caparas,1,0,35,34
1657133783808,MATH 20C,A02,083761,Briones; Jor-el Thomas Caparas,8,0,35,27
1657133783808,MATH 20C,A03,093476,Briones; Jor-el Thomas Caparas,0,1,36,36
1657133783808,MATH 20C,B01,083762,Bach; Quang Tran,0,0,30,30
1657133789837,MATH 20D,A01,083765,Tran; Brian Kha,4,0,30,26
1657133789837,MATH 20D,A02,083766,Tran; Brian Kha,5,0,30,25
1657133789837,MATH 20D,A03,083767,Tran; Brian Kha,3,0,30,27
1657133795862,MATH 20E,A01,083771,Ganguly; Soumya,6,0,32,26
1657133795862,MATH 20E,A02,083772,Ganguly; Soumya,6,0,32,26
1657133795862,MATH 20E,B01,083773,Ciotti; Benjamin,18,0,35,17
1657133795862,MATH 20E,B02,083774,Ciotti; Benjamin,17,0,35,18
1657133801887,MATH 103A,A01,083777,Greenfeld; Be'Eri,2,0,36,34
1657133801887,MATH 103A,A02,083778,Greenfeld; Be'Eri,5,0,36,31
1657133801887,MATH 103A,A03,093561,Greenfeld; Be'Eri,4,0,36,32
1657133801887,MATH 103A,B01,083779,Greenfeld; Be'Eri,6,0,36,30
1657133801887,MATH 103A,B02,083780,Greenfeld; Be'Eri,3,0,36,33
1657133801887,MATH 103A,B03,093562,Greenfeld; Be'Eri,3,0,36,33
1657133807923,MATH 105,A01,085443,Carter; Anne Toulson,14,0,35,21
1657133807923,MATH 105,A02,093477,Carter; Anne Toulson,20,0,35,15
1657133813947,MATH 109,A01,083213,Ganzberger; Geoffrey Michael,2,0,34,32
1657133813947,MATH 109,A02,083214,Ganzberger; Geoffrey Michael,3,0,34,31
1657133813947,MATH 109,A03,093478,Ganzberger; Geoffrey Michael,1,0,34,33
1657133813947,MATH 109,B01,083215,Ganzberger; Geoffrey Michael,1,0,32,31
1657133813947,MATH 109,B02,083216,Ganzberger; Geoffrey Michael,1,0,32,31
1657133813947,MATH 109,B03,093479,Ganzberger; Geoffrey Michael,6,0,32,26
1657133819972,MATH 142A,A01,083219,Chow; Bennett,6,0,32,26
1657133819972,MATH 142A,A02,083220,Chow; Bennett,10,0,32,22
1657133819972,MATH 142A,A03,093480,Chow; Bennett,7,0,32,25
1657133819972,MATH 142A,B03,093481,Chow; Bennett,8,0,32,24
1657133819972,MATH 142A,B04,093558,Chow; Bennett,11,0,32,21
1657133819972,MATH 142A,B05,093559,Chow; Bennett,6,0,32,26
1657133825995,MATH 193A,A01,083224,Rotar; Vladimir,7,0,34,27
1657133825995,MATH 193A,A02,083225,Rotar; Vladimir,5,0,34,29
1657133825995,MATH 193A,A03,083781,Rotar; Vladimir,1,0,34,33
1657133825995,MATH 193A,A04,083782,Rotar; Vladimir,8,0,34,26
1657133825995,MATH 193A,A05,093482,Rotar; Vladimir,6,0,34,28
1657133832025,MATH 197,001,091859,McAuley; Julian John,9999,0,9999,0
1657133832025,MATH 197,002,095566,Kedlaya; Kiran S.,9997,0,9999,2
1657133832025,MATH 197,003,095567,Xiao; Ming,9999,0,9999,0
1657133832025,MATH 197,004,095571,Perols; Johan Lars,9998,0,9999,1
1657133839082,COGS 9,A01,083615,Shannon; Kyle Michael,7,0,75,68
1657133845104,COGS 11,A01,083617,Boyle; Mary E. T.,21,0,48,27
1657133851128,COGS 13,A01,083071,Bastos; Amalia Pinkusfeld,9,0,71,62
1657133857151,COGS 14A,A01,092681,Semenuks; Arturs,1,1,100,99
1657133863176,COGS 14B,A01,083073,Cheng; Tzu-Han,6,0,63,57
1657133869232,COGS 17,A01,092677,Semenuks; Arturs,4,0,81,77
1657133875263,COGS 100,A01,083619,Allen; Michael Gordon,15,0,70,55
1657133881287,COGS 101A,A01,083621,Davis; Joshua Daniel,9,0,68,59
1657133887314,COGS 101B,A01,091572,Allen; Michael Gordon,9,0,65,56
1657133893342,COGS 101C,A01,083625,Delgado; Tania,17,0,35,18
1657133899373,COGS 107A,A01,083627,Boyle; Mary E. T.,13,0,60,47
1657133905397,COGS 118A,A01,083075,Gupta; Anjum,15,0,76,61
1657133911420,CSE 3,A50,083646,Miranda; Gregory Joseph,23,0,50,27
1657133917443,CSE 8A,A50,083650,Miranda; Gregory Joseph,17,1,56,39
1657133923470,CSE 11,A01,083080,Cao; Yingjun,5,15,40,35
1657133929503,CSE 12,A01,083652,Krause-Levy; Sophia Louisa,24,1,120,96
1657133935531,CSE 15L,A01,083654,Morris; Justin Loren,9,0,50,41
1657133935531,CSE 15L,A02,083655,Morris; Justin Loren,9,0,50,41
1657133941563,CSE 20,A01,083657,Tran; Khoa Dang,38,0,80,42
1657133947587,CSE 21,A01,095574,Bach; Quang Tran,21,0,48,27
1657133953620,CSE 30,A01,083084,Eldon; John,4,0,80,76
1657133953620,CSE 30,B01,095061,Bhaskar; Nishant,7,0,50,43
1657133959644,CSE 100,A01,083659,Cao; Yingjun,4,4,70,66
1657133965674,CSE 134B,A01,083661,Powell; Thomas Allan,20,0,100,80
1657133971698,CSE 140,A01,083663,Gungor; Onat,13,0,85,72
1657133977720,CSE 140L,A01,083088,Eldon; John,17,0,100,83
1657133983746,CSE 175,A01,083665,Kumar; Rakesh,3,0,25,22
1657133989768,CSE 190,A00,092507,Dubnov; Shlomo,7,0,20,13
1657133995796,ECE 45,A01,083139,Congero; Spencer William,5,0,75,70
1657134001822,ECE 65,A50,083695,Saad; Andrew S,12,0,30,18
1657134001822,ECE 65,A51,095125,Saad; Andrew S,25,0,26,1
1657134007850,ECE 109,A01,091882,Touri; Behrouz,17,0,70,53
1657134013875,ECE 180,A00,083140,Abi Samra; Nicholas Camill,1,0,30,29
1657134013875,ECE 180,B00,083141,Abi Samra; Nicholas Camill,0,0,30,30
1657134019898,MATH 10A,A01,083735,Patchell; Gregory David,2,0,30,28
1657134019898,MATH 10A,A02,083736,Patchell; Gregory David,20,0,30,10
1657134019898,MATH 10A,A03,083737,Patchell; Gregory David,16,0,30,14
1657134025920,MATH 10B,A01,083207,Lim; Seonhee,7,0,34,27
1657134025920,MATH 10B,A02,083208,Lim; Seonhee,9,0,35,26
1657134025920,MATH 10B,A03,093472,Lim; Seonhee,5,0,34,29
1657134025920,MATH 10B,B01,083739,Sinha; Shubham,9,0,30,21
1657134031945,MATH 18,A01,083743,Cinel; Cameron Alexander,6,0,30,24
1657134031945,MATH 18,A02,083744,Cinel; Cameron Alexander,15,0,30,15
1657134031945,MATH 18,A03,083745,Cinel; Cameron Alexander,8,0,30,22
1657134031945,MATH 18,B01,083748,Rideout; David Porter,4,0,37,33
1657134031945,MATH 18,B02,083749,Rideout; David Porter,3,0,36,33
1657134031945,MATH 18,B03,083750,Rideout; David Porter,2,0,37,35
1657134031945,MATH 18,B04,083751,Rideout; David Porter,5,0,36,31
1657134031945,MATH 18,B05,093473,Rideout; David Porter,4,0,36,32
1657134031945,MATH 18,B06,093474,Rideout; David Porter,5,0,36,31
1657134037975,MATH 20A,A01,083754,Zheng; Zequn,12,0,40,28
1657134044001,MATH 20B,A01,083756,Briones; Jor-el Thomas Caparas,1,0,36,35
1657134044001,MATH 20B,A02,083757,Briones; Jor-el Thomas Caparas,1,0,36,35
1657134044001,MATH 20B,A03,093475,Briones; Jor-el Thomas Caparas,0,0,36,36
1657134050028,MATH 20C,A01,083760,Briones; Jor-el Thomas Caparas,1,0,35,34
1657134050028,MATH 20C,A02,083761,Briones; Jor-el Thomas Caparas,8,0,35,27
1657134050028,MATH 20C,A03,093476,Briones; Jor-el Thomas Caparas,0,1,36,36
1657134050028,MATH 20C,B01,083762,Bach; Quang Tran,0,0,30,30
1657134056057,MATH 20D,A01,083765,Tran; Brian Kha,4,0,30,26
1657134056057,MATH 20D,A02,083766,Tran; Brian Kha,5,0,30,25
1657134056057,MATH 20D,A03,083767,Tran; Brian Kha,3,0,30,27
1657134062080,MATH 20E,A01,083771,Ganguly; Soumya,7,0,32,25
1657134062080,MATH 20E,A02,083772,Ganguly; Soumya,6,0,32,26
1657134062080,MATH 20E,B01,083773,Ciotti; Benjamin,18,0,35,17
1657134062080,MATH 20E,B02,083774,Ciotti; Benjamin,17,0,35,18
1657134068105,MATH 103A,A01,083777,Greenfeld; Be'Eri,2,0,36,34
1657134068105,MATH 103A,A02,083778,Greenfeld; Be'Eri,5,0,36,31
1657134068105,MATH 103A,A03,093561,Greenfeld; Be'Eri,4,0,36,32
1657134068105,MATH 103A,B01,083779,Greenfeld; Be'Eri,6,0,36,30
1657134068105,MATH 103A,B02,083780,Greenfeld; Be'Eri,3,0,36,33
1657134068105,MATH 103A,B03,093562,Greenfeld; Be'Eri,3,0,36,33
1657134074127,MATH 105,A01,085443,Carter; Anne Toulson,14,0,35,21
1657134074127,MATH 105,A02,093477,Carter; Anne Toulson,20,0,35,15
1657134080151,MATH 109,A01,083213,Ganzberger; Geoffrey Michael,2,0,34,32
1657134080151,MATH 109,A02,083214,Ganzberger; Geoffrey Michael,3,0,34,31
1657134080151,MATH 109,A03,093478,Ganzberger; Geoffrey Michael,1,0,34,33
1657134080151,MATH 109,B01,083215,Ganzberger; Geoffrey Michael,1,0,32,31
1657134080151,MATH 109,B02,083216,Ganzberger; Geoffrey Michael,1,0,32,31
1657134080151,MATH 109,B03,093479,Ganzberger; Geoffrey Michael,6,0,32,26
1657134086180,MATH 142A,A01,083219,Chow; Bennett,6,0,32,26
1657134086180,MATH 142A,A02,083220,Chow; Bennett,10,0,32,22
1657134086180,MATH 142A,A03,093480,Chow; Bennett,7,0,32,25
1657134086180,MATH 142A,B03,093481,Chow; Bennett,8,0,32,24
1657134086180,MATH 142A,B04,093558,Chow; Bennett,11,0,32,21
1657134086180,MATH 142A,B05,093559,Chow; Bennett,6,0,32,26
1657134092203,MATH 193A,A01,083224,Rotar; Vladimir,7,0,34,27
1657134092203,MATH 193A,A02,083225,Rotar; Vladimir,5,0,34,29
1657134092203,MATH 193A,A03,083781,Rotar; Vladimir,1,0,34,33
1657134092203,MATH 193A,A04,083782,Rotar; Vladimir,8,0,34,26
1657134092203,MATH 193A,A05,093482,Rotar; Vladimir,6,0,34,28
1657134098225,MATH 197,001,091859,McAuley; Julian John,9999,0,9999,0
1657134098225,MATH 197,002,095566,Kedlaya; Kiran S.,9997,0,9999,2
1657134098225,MATH 197,003,095567,Xiao; Ming,9999,0,9999,0
1657134098225,MATH 197,004,095571,Perols; Johan Lars,9998,0,9999,1
1657134125601,COGS 9,A01,083615,Shannon; Kyle Michael,7,0,75,68
1657134131632,COGS 11,A01,083617,Boyle; Mary E. T.,21,0,48,27
1657134137662,COGS 13,A01,083071,Bastos; Amalia Pinkusfeld,9,0,71,62
1657134143684,COGS 14A,A01,092681,Semenuks; Arturs,1,1,100,99
1657134149714,COGS 14B,A01,083073,Cheng; Tzu-Han,6,0,63,57
1657134155751,COGS 17,A01,092677,Semenuks; Arturs,4,0,81,77
1657134161778,COGS 100,A01,083619,Allen; Michael Gordon,15,0,70,55
1657134167807,COGS 101A,A01,083621,Davis; Joshua Daniel,9,0,68,59
1657134173833,COGS 101B,A01,091572,Allen; Michael Gordon,9,0,65,56
1657134179858,COGS 101C,A01,083625,Delgado; Tania,17,0,35,18
1657134185884,COGS 107A,A01,083627,Boyle; Mary E. T.,13,0,60,47
1657134191907,COGS 118A,A01,083075,Gupta; Anjum,15,0,76,61
1657134197931,CSE 3,A50,083646,Miranda; Gregory Joseph,23,0,50,27
1657134203954,CSE 8A,A50,083650,Miranda; Gregory Joseph,17,1,56,39
1657134209995,CSE 11,A01,083080,Cao; Yingjun,5,15,40,35
1657134216017,CSE 12,A01,083652,Krause-Levy; Sophia Louisa,24,1,120,96
1657134222039,CSE 15L,A01,083654,Morris; Justin Loren,9,0,50,41
1657134222039,CSE 15L,A02,083655,Morris; Justin Loren,9,0,50,41
1657134228064,CSE 20,A01,083657,Tran; Khoa Dang,38,0,80,42
1657134234176,CSE 21,A01,095574,Bach; Quang Tran,21,0,48,27
1657134240206,CSE 30,A01,083084,Eldon; John,4,0,80,76
1657134240206,CSE 30,B01,095061,Bhaskar; Nishant,7,0,50,43
1657134246234,CSE 100,A01,083659,Cao; Yingjun,4,4,70,66
1657134252261,CSE 134B,A01,083661,Powell; Thomas Allan,20,0,100,80
1657134258283,CSE 140,A01,083663,Gungor; Onat,13,0,85,72
1657134264308,CSE 140L,A01,083088,Eldon; John,17,0,100,83
1657134270331,CSE 175,A01,083665,Kumar; Rakesh,3,0,25,22
1657134276353,CSE 190,A00,092507,Dubnov; Shlomo,7,0,20,13
1657134282377,ECE 45,A01,083139,Congero; Spencer William,5,0,75,70
1657134288400,ECE 65,A50,083695,Saad; Andrew S,12,0,30,18
1657134288400,ECE 65,A51,095125,Saad; Andrew S,25,0,26,1
1657134294426,ECE 109,A01,091882,Touri; Behrouz,17,0,70,53
1657134300457,ECE 180,A00,083140,Abi Samra; Nicholas Camill,1,0,30,29
1657134300457,ECE 180,B00,083141,Abi Samra; Nicholas Camill,0,0,30,30
1657134306485,MATH 10A,A01,083735,Patchell; Gregory David,2,0,30,28
1657134306485,MATH 10A,A02,083736,Patchell; Gregory David,20,0,30,10
1657134306485,MATH 10A,A03,083737,Patchell; Gregory David,16,0,30,14
1657134312514,MATH 10B,A01,083207,Lim; Seonhee,7,0,34,27
1657134312514,MATH 10B,A02,083208,Lim; Seonhee,9,0,35,26
1657134312514,MATH 10B,A03,093472,Lim; Seonhee,5,0,34,29
1657134312514,MATH 10B,B01,083739,Sinha; Shubham,9,0,30,21
1657134318543,MATH 18,A01,083743,Cinel; Cameron Alexander,6,0,30,24
1657134318543,MATH 18,A02,083744,Cinel; Cameron Alexander,15,0,30,15
1657134318543,MATH 18,A03,083745,Cinel; Cameron Alexander,8,0,30,22
1657134318543,MATH 18,B01,083748,Rideout; David Porter,4,0,37,33
1657134318543,MATH 18,B02,083749,Rideout; David Porter,3,0,36,33
1657134318543,MATH 18,B03,083750,Rideout; David Porter,2,0,37,35
1657134318543,MATH 18,B04,083751,Rideout; David Porter,5,0,36,31
1657134318543,MATH 18,B05,093473,Rideout; David Porter,4,0,36,32
1657134318543,MATH 18,B06,093474,Rideout; David Porter,5,0,36,31
1657134324567,MATH 20A,A01,083754,Zheng; Zequn,12,0,40,28
1657134330595,MATH 20B,A01,083756,Briones; Jor-el Thomas Caparas,1,0,36,35
1657134330595,MATH 20B,A02,083757,Briones; Jor-el Thomas Caparas,1,0,36,35
1657134330595,MATH 20B,A03,093475,Briones; Jor-el Thomas Caparas,0,0,36,36
1657134336639,MATH 20C,A01,083760,Briones; Jor-el Thomas Caparas,1,0,35,34
1657134336639,MATH 20C,A02,083761,Briones; Jor-el Thomas Caparas,8,0,35,27
1657134336639,MATH 20C,A03,093476,Briones; Jor-el Thomas Caparas,0,1,36,36
1657134336639,MATH 20C,B01,083762,Bach; Quang Tran,0,0,30,30
1657134342661,MATH 20D,A01,083765,Tran; Brian Kha,4,0,30,26
1657134342661,MATH 20D,A02,083766,Tran; Brian Kha,5,0,30,25
1657134342661,MATH 20D,A03,083767,Tran; Brian Kha,3,0,30,27
1657134348690,MATH 20E,A01,083771,Ganguly; Soumya,7,0,32,25
1657134348690,MATH 20E,A02,083772,Ganguly; Soumya,6,0,32,26
1657134348690,MATH 20E,B01,083773,Ciotti; Benjamin,18,0,35,17
1657134348690,MATH 20E,B02,083774,Ciotti; Benjamin,17,0,35,18
1657134354713,MATH 103A,A01,083777,Greenfeld; Be'Eri,2,0,36,34
1657134354713,MATH 103A,A02,083778,Greenfeld; Be'Eri,5,0,36,31
1657134354713,MATH 103A,A03,093561,Greenfeld; Be'Eri,4,0,36,32
1657134354713,MATH 103A,B01,083779,Greenfeld; Be'Eri,6,0,36,30
1657134354713,MATH 103A,B02,083780,Greenfeld; Be'Eri,3,0,36,33
1657134354713,MATH 103A,B03,093562,Greenfeld; Be'Eri,3,0,36,33
1657134360736,MATH 105,A01,085443,Carter; Anne Toulson,14,0,35,21
1657134360736,MATH 105,A02,093477,Carter; Anne Toulson,20,0,35,15
1657134366758,MATH 109,A01,083213,Ganzberger; Geoffrey Michael,2,0,34,32
1657134366758,MATH 109,A02,083214,Ganzberger; Geoffrey Michael,3,0,34,31
1657134366758,MATH 109,A03,093478,Ganzberger; Geoffrey Michael,1,0,34,33
1657134366758,MATH 109,B01,083215,Ganzberger; Geoffrey Michael,1,0,32,31
1657134366758,MATH 109,B02,083216,Ganzberger; Geoffrey Michael,1,0,32,31
1657134366758,MATH 109,B03,093479,Ganzberger; Geoffrey Michael,6,0,32,26
1657134372780,MATH 142A,A01,083219,Chow; Bennett,6,0,32,26
1657134372780,MATH 142A,A02,083220,Chow; Bennett,10,0,32,22
1657134372780,MATH 142A,A03,093480,Chow; Bennett,7,0,32,25
1657134372780,MATH 142A,B03,093481,Chow; Bennett,8,0,32,24
1657134372780,MATH 142A,B04,093558,Chow; Bennett,11,0,32,21
1657134372780,MATH 142A,B05,093559,Chow; Bennett,6,0,32,26
1657134378802,MATH 193A,A01,083224,Rotar; Vladimir,7,0,34,27
1657134378802,MATH 193A,A02,083225,Rotar; Vladimir,5,0,34,29
1657134378802,MATH 193A,A03,083781,Rotar; Vladimir,1,0,34,33
1657134378802,MATH 193A,A04,083782,Rotar; Vladimir,8,0,34,26
1657134378802,MATH 193A,A05,093482,Rotar; Vladimir,6,0,34,28
1657134384836,MATH 197,001,091859,McAuley; Julian John,9999,0,9999,0
1657134384836,MATH 197,002,095566,Kedlaya; Kiran S.,9997,0,9999,2
1657134384836,MATH 197,003,095567,Xiao; Ming,9999,0,9999,0
1657134384836,MATH 197,004,095571,Perols; Johan Lars,9998,0,9999,1
1657134391890,COGS 9,A01,083615,Shannon; Kyle Michael,7,0,75,68
1657134397912,COGS 11,A01,083617,Boyle; Mary E. T.,21,0,48,27
1657134403942,COGS 13,A01,083071,Bastos; Amalia Pinkusfeld,9,0,71,62
1657134409964,COGS 14A,A01,092681,Semenuks; Arturs,1,1,100,99
1657134415988,COGS 14B,A01,083073,Cheng; Tzu-Han,6,0,63,57
1657134422015,COGS 17,A01,092677,Semenuks; Arturs,4,0,81,77
1657134428041,COGS 100,A01,083619,Allen; Michael Gordon,15,0,70,55
1657134434068,COGS 101A,A01,083621,Davis; Joshua Daniel,9,0,68,59
1657134440099,COGS 101B,A01,091572,Allen; Michael Gordon,9,0,65,56
1657134446121,COGS 101C,A01,083625,Delgado; Tania,17,0,35,18
1657134452146,COGS 107A,A01,083627,Boyle; Mary E. T.,13,0,60,47
1657134458183,COGS 118A,A01,083075,Gupta; Anjum,15,0,76,61
1657134464216,CSE 3,A50,083646,Miranda; Gregory Joseph,23,0,50,27
1657134470242,CSE 8A,A50,083650,Miranda; Gregory Joseph,17,1,56,39
1657134476276,CSE 11,A01,083080,Cao; Yingjun,5,15,40,35
1657134482304,CSE 12,A01,083652,Krause-Levy; Sophia Louisa,24,1,120,96
1657134488329,CSE 15L,A01,083654,Morris; Justin Loren,9,0,50,41
1657134488329,CSE 15L,A02,083655,Morris; Justin Loren,9,0,50,41
1657134494356,CSE 20,A01,083657,Tran; Khoa Dang,38,0,80,42
1657134500395,CSE 21,A01,095574,Bach; Quang Tran,21,0,48,27
1657134506430,CSE 30,A01,083084,Eldon; John,4,0,80,76
1657134506430,CSE 30,B01,095061,Bhaskar; Nishant,7,0,50,43
1657134512453,CSE 100,A01,083659,Cao; Yingjun,4,4,70,66
1657134518491,CSE 134B,A01,083661,Powell; Thomas Allan,20,0,100,80
1657134524518,CSE 140,A01,083663,Gungor; Onat,13,0,85,72
1657134530541,CSE 140L,A01,083088,Eldon; John,17,0,100,83
1657134536568,CSE 175,A01,083665,Kumar; Rakesh,3,0,25,22
1657134542599,CSE 190,A00,092507,Dubnov; Shlomo,7,0,20,13
1657134548622,ECE 45,A01,083139,Congero; Spencer William,5,0,75,70
1657134554652,ECE 65,A50,083695,Saad; Andrew S,12,0,30,18
1657134554652,ECE 65,A51,095125,Saad; Andrew S,25,0,26,1
1657134560677,ECE 109,A01,091882,Touri; Behrouz,17,0,70,53
1657134566704,ECE 180,A00,083140,Abi Samra; Nicholas Camill,1,0,30,29
1657134566704,ECE 180,B00,083141,Abi Samra; Nicholas Camill,0,0,30,30
1657134572728,MATH 10A,A01,083735,Patchell; Gregory David,2,0,30,28
1657134572728,MATH 10A,A02,083736,Patchell; Gregory David,20,0,30,10
1657134572728,MATH 10A,A03,083737,Patchell; Gregory David,16,0,30,14
1657134578751,MATH 10B,A01,083207,Lim; Seonhee,7,0,34,27
1657134578751,MATH 10B,A02,083208,Lim; Seonhee,9,0,35,26
1657134578751,MATH 10B,A03,093472,Lim; Seonhee,5,0,34,29
1657134578751,MATH 10B,B01,083739,Sinha; Shubham,9,0,30,21
1657134584774,MATH 18,A01,083743,Cinel; Cameron Alexander,6,0,30,24
1657134584774,MATH 18,A02,083744,Cinel; Cameron Alexander,15,0,30,15
1657134584774,MATH 18,A03,083745,Cinel; Cameron Alexander,8,0,30,22
1657134584774,MATH 18,B01,083748,Rideout; David Porter,4,0,37,33
1657134584774,MATH 18,B02,083749,Rideout; David Porter,3,0,36,33
1657134584774,MATH 18,B03,083750,Rideout; David Porter,2,0,37,35
1657134584774,MATH 18,B04,083751,Rideout; David Porter,5,0,36,31
1657134584774,MATH 18,B05,093473,Rideout; David Porter,4,0,36,32
1657134584774,MATH 18,B06,093474,Rideout; David Porter,5,0,36,31
1657134590799,MATH 20A,A01,083754,Zheng; Zequn,12,0,40,28
1657134596836,MATH 20B,A01,083756,Briones; Jor-el Thomas Caparas,1,0,36,35
1657134596836,MATH 20B,A02,083757,Briones; Jor-el Thomas Caparas,1,0,36,35
1657134596836,MATH 20B,A03,093475,Briones; Jor-el Thomas Caparas,0,0,36,36
1657134602863,MATH 20C,A01,083760,Briones; Jor-el Thomas Caparas,1,0,35,34
1657134602863,MATH 20C,A02,083761,Briones; Jor-el Thomas Caparas,8,0,35,27
1657134602863,MATH 20C,A03,093476,Briones; Jor-el Thomas Caparas,0,1,36,36
1657134602863,MATH 20C,B01,083762,Bach; Quang Tran,0,0,30,30
1657134608885,MATH 20D,A01,083765,Tran; Brian Kha,4,0,30,26
1657134608885,MATH 20D,A02,083766,Tran; Brian Kha,5,0,30,25
1657134608885,MATH 20D,A03,083767,Tran; Brian Kha,3,0,30,27
1657134614913,MATH 20E,A01,083771,Ganguly; Soumya,7,0,32,25
1657134614913,MATH 20E,A02,083772,Ganguly; Soumya,6,0,32,26
1657134614913,MATH 20E,B01,083773,Ciotti; Benjamin,18,0,35,17
1657134614913,MATH 20E,B02,083774,Ciotti; Benjamin,17,0,35,18
1657134620950,MATH 103A,A01,083777,Greenfeld; Be'Eri,2,0,36,34
1657134620950,MATH 103A,A02,083778,Greenfeld; Be'Eri,5,0,36,31
1657134620950,MATH 103A,A03,093561,Greenfeld; Be'Eri,4,0,36,32
1657134620950,MATH 103A,B01,083779,Greenfeld; Be'Eri,6,0,36,30
1657134620950,MATH 103A,B02,083780,Greenfeld; Be'Eri,3,0,36,33
1657134620950,MATH 103A,B03,093562,Greenfeld; Be'Eri,3,0,36,33
1657134626974,MATH 105,A01,085443,Carter; Anne Toulson,14,0,35,21
1657134626974,MATH 105,A02,093477,Carter; Anne Toulson,20,0,35,15
1657134632998,MATH 109,A01,083213,Ganzberger; Geoffrey Michael,2,0,34,32
1657134632998,MATH 109,A02,083214,Ganzberger; Geoffrey Michael,3,0,34,31
1657134632998,MATH 109,A03,093478,Ganzberger; Geoffrey Michael,1,0,34,33
1657134632998,MATH 109,B01,083215,Ganzberger; Geoffrey Michael,1,0,32,31
1657134632998,MATH 109,B02,083216,Ganzberger; Geoffrey Michael,1,0,32,31
1657134632998,MATH 109,B03,093479,Ganzberger; Geoffrey Michael,6,0,32,26
1657134639037,MATH 142A,A01,083219,Chow; Bennett,6,0,32,26
1657134639037,MATH 142A,A02,083220,Chow; Bennett,10,0,32,22
1657134639037,MATH 142A,A03,093480,Chow; Bennett,7,0,32,25
1657134639037,MATH 142A,B03,093481,Chow; Bennett,8,0,32,24
1657134639037,MATH 142A,B04,093558,Chow; Bennett,11,0,32,21
1657134639037,MATH 142A,B05,093559,Chow; Bennett,6,0,32,26
1657134645075,MATH 193A,A01,083224,Rotar; Vladimir,7,0,34,27
1657134645075,MATH 193A,A02,083225,Rotar; Vladimir,5,0,34,29
1657134645075,MATH 193A,A03,083781,Rotar; Vladimir,1,0,34,33
1657134645075,MATH 193A,A04,083782,Rotar; Vladimir,8,0,34,26
1657134645075,MATH 193A,A05,093482,Rotar; Vladimir,6,0,34,28
1657134651100,MATH 197,001,091859,McAuley; Julian John,9999,0,9999,0
1657134651100,MATH 197,002,095566,Kedlaya; Kiran S.,9997,0,9999,2
1657134651100,MATH 197,003,095567,Xiao; Ming,9999,0,9999,0
1657134651100,MATH 197,004,095571,Perols; Johan Lars,9998,0,9999,1
1657134658176,COGS 9,A01,083615,Shannon; Kyle Michael,7,0,75,68
1657134664198,COGS 11,A01,083617,Boyle; Mary E. T.,21,0,48,27
1657134670222,COGS 13,A01,083071,Bastos; Amalia Pinkusfeld,9,0,71,62
1657134676246,COGS 14A,A01,092681,Semenuks; Arturs,1,1,100,99
1657134682268,COGS 14B,A01,083073,Cheng; Tzu-Han,6,0,63,57
1657134688292,COGS 17,A01,092677,Semenuks; Arturs,4,0,81,77
1657134694314,COGS 100,A01,083619,Allen; Michael Gordon,15,0,70,55
1657134700347,COGS 101A,A01,083621,Davis; Joshua Daniel,9,0,68,59
1657134706374,COGS 101B,A01,091572,Allen; Michael Gordon,9,0,65,56
1657134712406,COGS 101C,A01,083625,Delgado; Tania,17,0,35,18
1657134718429,COGS 107A,A01,083627,Boyle; Mary E. T.,13,0,60,47
1657134724453,COGS 118A,A01,083075,Gupta; Anjum,15,0,76,61
1657134730490,CSE 3,A50,083646,Miranda; Gregory Joseph,23,0,50,27
1657134736526,CSE 8A,A50,083650,Miranda; Gregory Joseph,17,1,56,39
1657134742548,CSE 11,A01,083080,Cao; Yingjun,5,15,40,35
1657134748576,CSE 12,A01,083652,Krause-Levy; Sophia Louisa,24,1,120,96
1657134754598,CSE 15L,A01,083654,Morris; Justin Loren,9,0,50,41
1657134754598,CSE 15L,A02,083655,Morris; Justin Loren,9,0,50,41
1657134760625,CSE 20,A01,083657,Tran; Khoa Dang,38,0,80,42
1657134766661,CSE 21,A01,095574,Bach; Quang Tran,21,0,48,27
1657134772696,CSE 30,A01,083084,Eldon; John,4,0,80,76
1657134772696,CSE 30,B01,095061,Bhaskar; Nishant,7,0,50,43
1657134778716,CSE 100,A01,083659,Cao; Yingjun,4,4,70,66
1657134784739,CSE 134B,A01,083661,Powell; Thomas Allan,20,0,100,80
1657134790767,CSE 140,A01,083663,Gungor; Onat,13,0,85,72
1657134796793,CSE 140L,A01,083088,Eldon; John,17,0,100,83
1657134802818,CSE 175,A01,083665,Kumar; Rakesh,3,0,25,22
1657134808840,CSE 190,A00,092507,Dubnov; Shlomo,7,0,20,13
1657134814863,ECE 45,A01,083139,Congero; Spencer William,5,0,75,70
1657134820888,ECE 65,A50,083695,Saad; Andrew S,12,0,30,18
1657134820888,ECE 65,A51,095125,Saad; Andrew S,25,0,26,1
1657134826916,ECE 109,A01,091882,Touri; Behrouz,17,0,70,53
1657134833023,ECE 180,A00,083140,Abi Samra; Nicholas Camill,1,0,30,29
1657134833023,ECE 180,B00,083141,Abi Samra; Nicholas Camill,0,0,30,30
1657134839054,MATH 10A,A01,083735,Patchell; Gregory David,2,0,30,28
1657134839054,MATH 10A,A02,083736,Patchell; Gregory David,20,0,30,10
1657134839054,MATH 10A,A03,083737,Patchell; Gregory David,16,0,30,14
1657134845082,MATH 10B,A01,083207,Lim; Seonhee,7,0,34,27
1657134845082,MATH 10B,A02,083208,Lim; Seonhee,9,0,35,26
1657134845082,MATH 10B,A03,093472,Lim; Seonhee,5,0,34,29
1657134845082,MATH 10B,B01,083739,Sinha; Shubham,9,0,30,21
1657134851127,MATH 18,A01,083743,Cinel; Cameron Alexander,6,0,30,24
1657134851127,MATH 18,A02,083744,Cinel; Cameron Alexander,15,0,30,15
1657134851127,MATH 18,A03,083745,Cinel; Cameron Alexander,8,0,30,22
1657134851127,MATH 18,B01,083748,Rideout; David Porter,4,0,37,33
1657134851127,MATH 18,B02,083749,Rideout; David Porter,3,0,36,33
1657134851127,MATH 18,B03,083750,Rideout; David Porter,2,0,37,35
1657134851127,MATH 18,B04,083751,Rideout; David Porter,5,0,36,31
1657134851127,MATH 18,B05,093473,Rideout; David Porter,4,0,36,32
1657134851127,MATH 18,B06,093474,Rideout; David Porter,5,0,36,31
1657134857154,MATH 20A,A01,083754,Zheng; Zequn,12,0,40,28
1657134863184,MATH 20B,A01,083756,Briones; Jor-el Thomas Caparas,1,0,36,35
1657134863184,MATH 20B,A02,083757,Briones; Jor-el Thomas Caparas,1,0,36,35
1657134863184,MATH 20B,A03,093475,Briones; Jor-el Thomas Caparas,0,0,36,36
1657134869212,MATH 20C,A01,083760,Briones; Jor-el Thomas Caparas,1,0,35,34
1657134869212,MATH 20C,A02,083761,Briones; Jor-el Thomas Caparas,8,0,35,27
1657134869212,MATH 20C,A03,093476,Briones; Jor-el Thomas Caparas,0,1,36,36
1657134869212,MATH 20C,B01,083762,Bach; Quang Tran,0,0,30,30
1657134875236,MATH 20D,A01,083765,Tran; Brian Kha,4,0,30,26
1657134875236,MATH 20D,A02,083766,Tran; Brian Kha,5,0,30,25
1657134875236,MATH 20D,A03,083767,Tran; Brian Kha,3,0,30,27
1657134881267,MATH 20E,A01,083771,Ganguly; Soumya,7,0,32,25
1657134881267,MATH 20E,A02,083772,Ganguly; Soumya,6,0,32,26
1657134881267,MATH 20E,B01,083773,Ciotti; Benjamin,18,0,35,17
1657134881267,MATH 20E,B02,083774,Ciotti; Benjamin,17,0,35,18
1657134887290,MATH 103A,A01,083777,Greenfeld; Be'Eri,2,0,36,34
1657134887290,MATH 103A,A02,083778,Greenfeld; Be'Eri,5,0,36,31
1657134887290,MATH 103A,A03,093561,Greenfeld; Be'Eri,4,0,36,32
1657134887290,MATH 103A,B01,083779,Greenfeld; Be'Eri,6,0,36,30
1657134887290,MATH 103A,B02,083780,Greenfeld; Be'Eri,3,0,36,33
1657134887290,MATH 103A,B03,093562,Greenfeld; Be'Eri,3,0,36,33
1657134893327,MATH 105,A01,085443,Carter; Anne Toulson,14,0,35,21
1657134893327,MATH 105,A02,093477,Carter; Anne Toulson,20,0,35,15
1657134899351,MATH 109,A01,083213,Ganzberger; Geoffrey Michael,2,0,34,32
1657134899351,MATH 109,A02,083214,Ganzberger; Geoffrey Michael,3,0,34,31
1657134899351,MATH 109,A03,093478,Ganzberger; Geoffrey Michael,1,0,34,33
1657134899351,MATH 109,B01,083215,Ganzberger; Geoffrey Michael,1,0,32,31
1657134899351,MATH 109,B02,083216,Ganzberger; Geoffrey Michael,1,0,32,31
1657134899351,MATH 109,B03,093479,Ganzberger; Geoffrey Michael,6,0,32,26
1657134905383,MATH 142A,A01,083219,Chow; Bennett,6,0,32,26
1657134905383,MATH 142A,A02,083220,Chow; Bennett,10,0,32,22
1657134905383,MATH 142A,A03,093480,Chow; Bennett,7,0,32,25
1657134905383,MATH 142A,B03,093481,Chow; Bennett,8,0,32,24
1657134905383,MATH 142A,B04,093558,Chow; Bennett,11,0,32,21
1657134905383,MATH 142A,B05,093559,Chow; Bennett,6,0,32,26
1657134911415,MATH 193A,A01,083224,Rotar; Vladimir,7,0,34,27
1657134911415,MATH 193A,A02,083225,Rotar; Vladimir,5,0,34,29
1657134911415,MATH 193A,A03,083781,Rotar; Vladimir,1,0,34,33
1657134911415,MATH 193A,A04,083782,Rotar; Vladimir,8,0,34,26
1657134911415,MATH 193A,A05,093482,Rotar; Vladimir,6,0,34,28
1657134917442,MATH 197,001,091859,McAuley; Julian John,9999,0,9999,0
1657134917442,MATH 197,002,095566,Kedlaya; Kiran S.,9997,0,9999,2
1657134917442,MATH 197,003,095567,Xiao; Ming,9999,0,9999,0
1657134917442,MATH 197,004,095571,Perols; Johan Lars,9998,0,9999,1
1657134924497,COGS 9,A01,083615,Shannon; Kyle Michael,7,0,75,68
1657134930538,COGS 11,A01,083617,Boyle; Mary E. T.,21,0,48,27
1657134936560,COGS 13,A01,083071,Bastos; Amalia Pinkusfeld,9,0,71,62
1657134942585,COGS 14A,A01,092681,Semenuks; Arturs,1,1,100,99
1657134948609,COGS 14B,A01,083073,Cheng; Tzu-Han,6,0,63,57
1657134954632,COGS 17,A01,092677,Semenuks; Arturs,4,0,81,77
1657134960660,COGS 100,A01,083619,Allen; Michael Gordon,15,0,70,55
1657134966689,COGS 101A,A01,083621,Davis; Joshua Daniel,9,0,68,59
1657134972719,COGS 101B,A01,091572,Allen; Michael Gordon,9,0,65,56
1657134978748,COGS 101C,A01,083625,Delgado; Tania,17,0,35,18
1657134984775,COGS 107A,A01,083627,Boyle; Mary E. T.,13,0,60,47
1657134990811,COGS 118A,A01,083075,Gupta; Anjum,15,0,76,61
1657134996839,CSE 3,A50,083646,Miranda; Gregory Joseph,23,0,50,27
1657135002869,CSE 8A,A50,083650,Miranda; Gregory Joseph,17,1,56,39
1657135008897,CSE 11,A01,083080,Cao; Yingjun,5,15,40,35
1657135014921,CSE 12,A01,083652,Krause-Levy; Sophia Louisa,24,1,120,96
1657135020945,CSE 15L,A01,083654,Morris; Justin Loren,9,0,50,41
1657135020945,CSE 15L,A02,083655,Morris; Justin Loren,9,0,50,41
1657135026973,CSE 20,A01,083657,Tran; Khoa Dang,38,0,80,42
1657135033000,CSE 21,A01,095574,Bach; Quang Tran,21,0,48,27
1657135039031,CSE 30,A01,083084,Eldon; John,4,0,80,76
1657135039031,CSE 30,B01,095061,Bhaskar; Nishant,7,0,50,43
1657135045056,CSE 100,A01,083659,Cao; Yingjun,4,4,70,66
1657135051080,CSE 134B,A01,083661,Powell; Thomas Allan,20,0,100,80
1657135057104,CSE 140,A01,083663,Gungor; Onat,13,0,85,72
1657135063130,CSE 140L,A01,083088,Eldon; John,17,0,100,83
1657135069153,CSE 175,A01,083665,Kumar; Rakesh,3,0,25,22
1657135075180,CSE 190,A00,092507,Dubnov; Shlomo,7,0,20,13
1657135081210,ECE 45,A01,083139,Congero; Spencer William,5,0,75,70
1657135087234,ECE 65,A50,083695,Saad; Andrew S,12,0,30,18
1657135087234,ECE 65,A51,095125,Saad; Andrew S,25,0,26,1
1657135093258,ECE 109,A01,091882,Touri; Behrouz,17,0,70,53
1657135099282,ECE 180,A00,083140,Abi Samra; Nicholas Camill,1,0,30,29
1657135099282,ECE 180,B00,083141,Abi Samra; Nicholas Camill,0,0,30,30
1657135105305,MATH 10A,A01,083735,Patchell; Gregory David,2,0,30,28
1657135105305,MATH 10A,A02,083736,Patchell; Gregory David,20,0,30,10
1657135105305,MATH 10A,A03,083737,Patchell; Gregory David,16,0,30,14
1657135111331,MATH 10B,A01,083207,Lim; Seonhee,7,0,34,27
1657135111331,MATH 10B,A02,083208,Lim; Seonhee,9,0,35,26
1657135111331,MATH 10B,A03,093472,Lim; Seonhee,5,0,34,29
1657135111331,MATH 10B,B01,083739,Sinha; Shubham,9,0,30,21
1657135117363,MATH 18,A01,083743,Cinel; Cameron Alexander,6,0,30,24
1657135117363,MATH 18,A02,083744,Cinel; Cameron Alexander,15,0,30,15
1657135117363,MATH 18,A03,083745,Cinel; Cameron Alexander,8,0,30,22
1657135117363,MATH 18,B01,083748,Rideout; David Porter,4,0,37,33
1657135117363,MATH 18,B02,083749,Rideout; David Porter,3,0,36,33
1657135117363,MATH 18,B03,083750,Rideout; David Porter,2,0,37,35
1657135117363,MATH 18,B04,083751,Rideout; David Porter,5,0,36,31
1657135117363,MATH 18,B05,093473,Rideout; David Porter,4,0,36,32
1657135117363,MATH 18,B06,093474,Rideout; David Porter,5,0,36,31
1657135123387,MATH 20A,A01,083754,Zheng; Zequn,12,0,40,28
1657135129421,MATH 20B,A01,083756,Briones; Jor-el Thomas Caparas,1,0,36,35
1657135129421,MATH 20B,A02,083757,Briones; Jor-el Thomas Caparas,1,0,36,35
1657135129421,MATH 20B,A03,093475,Briones; Jor-el Thomas Caparas,0,0,36,36
1657135135445,MATH 20C,A01,083760,Briones; Jor-el Thomas Caparas,1,0,35,34
1657135135445,MATH 20C,A02,083761,Briones; Jor-el Thomas Caparas,8,0,35,27
1657135135445,MATH 20C,A03,093476,Briones; Jor-el Thomas Caparas,0,1,36,36
1657135135445,MATH 20C,B01,083762,Bach; Quang Tran,0,0,30,30
1657135141480,MATH 20D,A01,083765,Tran; Brian Kha,4,0,30,26
1657135141480,MATH 20D,A02,083766,Tran; Brian Kha,5,0,30,25
1657135141480,MATH 20D,A03,083767,Tran; Brian Kha,3,0,30,27
1657135147510,MATH 20E,A01,083771,Ganguly; Soumya,7,0,32,25
1657135147510,MATH 20E,A02,083772,Ganguly; Soumya,6,0,32,26
1657135147510,MATH 20E,B01,083773,Ciotti; Benjamin,18,0,35,17
1657135147510,MATH 20E,B02,083774,Ciotti; Benjamin,17,0,35,18
1657135153540,MATH 103A,A01,083777,Greenfeld; Be'Eri,2,0,36,34
1657135153540,MATH 103A,A02,083778,Greenfeld; Be'Eri,5,0,36,31
1657135153540,MATH 103A,A03,093561,Greenfeld; Be'Eri,4,0,36,32
1657135153540,MATH 103A,B01,083779,Greenfeld; Be'Eri,6,0,36,30
1657135153540,MATH 103A,B02,083780,Greenfeld; Be'Eri,3,0,36,33
1657135153540,MATH 103A,B03,093562,Greenfeld; Be'Eri,3,0,36,33
1657135159568,MATH 105,A01,085443,Carter; Anne Toulson,14,0,35,21
1657135159568,MATH 105,A02,093477,Carter; Anne Toulson,20,0,35,15
1657135165600,MATH 109,A01,083213,Ganzberger; Geoffrey Michael,2,0,34,32
1657135165600,MATH 109,A02,083214,Ganzberger; Geoffrey Michael,3,0,34,31
1657135165600,MATH 109,A03,093478,Ganzberger; Geoffrey Michael,1,0,34,33
1657135165600,MATH 109,B01,083215,Ganzberger; Geoffrey Michael,1,0,32,31
1657135165600,MATH 109,B02,083216,Ganzberger; Geoffrey Michael,1,0,32,31
1657135165600,MATH 109,B03,093479,Ganzberger; Geoffrey Michael,6,0,32,26
1657135171631,MATH 142A,A01,083219,Chow; Bennett,6,0,32,26
1657135171631,MATH 142A,A02,083220,Chow; Bennett,10,0,32,22
1657135171631,MATH 142A,A03,093480,Chow; Bennett,7,0,32,25
1657135171631,MATH 142A,B03,093481,Chow; Bennett,8,0,32,24
1657135171631,MATH 142A,B04,093558,Chow; Bennett,11,0,32,21
1657135171631,MATH 142A,B05,093559,Chow; Bennett,6,0,32,26
1657135177667,MATH 193A,A01,083224,Rotar; Vladimir,7,0,34,27
1657135177667,MATH 193A,A02,083225,Rotar; Vladimir,5,0,34,29
1657135177667,MATH 193A,A03,083781,Rotar; Vladimir,1,0,34,33
1657135177667,MATH 193A,A04,083782,Rotar; Vladimir,8,0,34,26
1657135177667,MATH 193A,A05,093482,Rotar; Vladimir,6,0,34,28
1657135183691,MATH 197,001,091859,McAuley; Julian John,9999,0,9999,0
1657135183691,MATH 197,002,095566,Kedlaya; Kiran S.,9997,0,9999,2
1657135183691,MATH 197,003,095567,Xiao; Ming,9999,0,9999,0
1657135183691,MATH 197,004,095571,Perols; Johan Lars,9998,0,9999,1
1657135190745,COGS 9,A01,083615,Shannon; Kyle Michael,7,0,75,68
1657135196779,COGS 11,A01,083617,Boyle; Mary E. T.,21,0,48,27
1657135202806,COGS 13,A01,083071,Bastos; Amalia Pinkusfeld,9,0,71,62
1657135208829,COGS 14A,A01,092681,Semenuks; Arturs,1,1,100,99
1657135214853,COGS 14B,A01,083073,Cheng; Tzu-Han,6,0,63,57
1657135220898,COGS 17,A01,092677,Semenuks; Arturs,4,0,81,77
1657135226933,COGS 100,A01,083619,Allen; Michael Gordon,15,0,70,55
1657135232961,COGS 101A,A01,083621,Davis; Joshua Daniel,9,0,68,59
1657135238985,COGS 101B,A01,091572,Allen; Michael Gordon,9,0,65,56
1657135245008,COGS 101C,A01,083625,Delgado; Tania,17,0,35,18
1657135251032,COGS 107A,A01,083627,Boyle; Mary E. T.,13,0,60,47
1657135257058,COGS 118A,A01,083075,Gupta; Anjum,15,0,76,61
1657135263093,CSE 3,A50,083646,Miranda; Gregory Joseph,23,0,50,27
1657135269120,CSE 8A,A50,083650,Miranda; Gregory Joseph,17,1,56,39
1657135275141,CSE 11,A01,083080,Cao; Yingjun,5,15,40,35
1657135281163,CSE 12,A01,083652,Krause-Levy; Sophia Louisa,24,1,120,96
1657135287186,CSE 15L,A01,083654,Morris; Justin Loren,9,0,50,41
1657135287186,CSE 15L,A02,083655,Morris; Justin Loren,9,0,50,41
1657135293214,CSE 20,A01,083657,Tran; Khoa Dang,38,0,80,42
1657135299236,CSE 21,A01,095574,Bach; Quang Tran,21,0,48,27
1657135305267,CSE 30,A01,083084,Eldon; John,4,0,80,76
1657135305267,CSE 30,B01,095061,Bhaskar; Nishant,7,0,50,43
1657135311289,CSE 100,A01,083659,Cao; Yingjun,4,4,70,66
1657135317316,CSE 134B,A01,083661,Powell; Thomas Allan,20,0,100,80
1657135323340,CSE 140,A01,083663,Gungor; Onat,13,0,85,72
1657135329381,CSE 140L,A01,083088,Eldon; John,17,0,100,83
1657135335407,CSE 175,A01,083665,Kumar; Rakesh,3,0,25,22
1657135341432,CSE 190,A00,092507,Dubnov; Shlomo,7,0,20,13
1657135347458,ECE 45,A01,083139,Congero; Spencer William,5,0,75,70
1657135353495,ECE 65,A50,083695,Saad; Andrew S,12,0,30,18
1657135353495,ECE 65,A51,095125,Saad; Andrew S,25,0,26,1
1657135359517,ECE 109,A01,091882,Touri; Behrouz,17,0,70,53
1657135365547,ECE 180,A00,083140,Abi Samra; Nicholas Camill,1,0,30,29
1657135365547,ECE 180,B00,083141,Abi Samra; Nicholas Camill,0,0,30,30
1657135371570,MATH 10A,A01,083735,Patchell; Gregory David,2,0,30,28
1657135371570,MATH 10A,A02,083736,Patchell; Gregory David,20,0,30,10
1657135371570,MATH 10A,A03,083737,Patchell; Gregory David,16,0,30,14
1657135377599,MATH 10B,A01,083207,Lim; Seonhee,7,0,34,27
1657135377599,MATH 10B,A02,083208,Lim; Seonhee,9,0,35,26
1657135377599,MATH 10B,A03,093472,Lim; Seonhee,5,0,34,29
1657135377599,MATH 10B,B01,083739,Sinha; Shubham,9,0,30,21
1657135383623,MATH 18,A01,083743,Cinel; Cameron Alexander,6,0,30,24
1657135383623,MATH 18,A02,083744,Cinel; Cameron Alexander,15,0,30,15
1657135383623,MATH 18,A03,083745,Cinel; Cameron Alexander,8,0,30,22
1657135383623,MATH 18,B01,083748,Rideout; David Porter,4,0,37,33
1657135383623,MATH 18,B02,083749,Rideout; David Porter,3,0,36,33
1657135383623,MATH 18,B03,083750,Rideout; David Porter,2,0,37,35
1657135383623,MATH 18,B04,083751,Rideout; David Porter,5,0,36,31
1657135383623,MATH 18,B05,093473,Rideout; David Porter,4,0,36,32
1657135383623,MATH 18,B06,093474,Rideout; David Porter,5,0,36,31
1657135389648,MATH 20A,A01,083754,Zheng; Zequn,12,0,40,28
1657135395672,MATH 20B,A01,083756,Briones; Jor-el Thomas Caparas,1,0,36,35
1657135395672,MATH 20B,A02,083757,Briones; Jor-el Thomas Caparas,1,0,36,35
1657135395672,MATH 20B,A03,093475,Briones; Jor-el Thomas Caparas,0,0,36,36
1657135401701,MATH 20C,A01,083760,Briones; Jor-el Thomas Caparas,1,0,35,34
1657135401701,MATH 20C,A02,083761,Briones; Jor-el Thomas Caparas,8,0,35,27
1657135401701,MATH 20C,A03,093476,Briones; Jor-el Thomas Caparas,0,1,36,36
1657135401701,MATH 20C,B01,083762,Bach; Quang Tran,0,0,30,30
1657135407729,MATH 20D,A01,083765,Tran; Brian Kha,4,0,30,26
1657135407729,MATH 20D,A02,083766,Tran; Brian Kha,5,0,30,25
1657135407729,MATH 20D,A03,083767,Tran; Brian Kha,3,0,30,27
1657135413767,MATH 20E,A01,083771,Ganguly; Soumya,7,0,32,25
1657135413767,MATH 20E,A02,083772,Ganguly; Soumya,6,0,32,26
1657135413767,MATH 20E,B01,083773,Ciotti; Benjamin,18,0,35,17
1657135413767,MATH 20E,B02,083774,Ciotti; Benjamin,17,0,35,18
1657135419799,MATH 103A,A01,083777,Greenfeld; Be'Eri,2,0,36,34
1657135419799,MATH 103A,A02,083778,Greenfeld; Be'Eri,5,0,36,31
1657135419799,MATH 103A,A03,093561,Greenfeld; Be'Eri,4,0,36,32
1657135419799,MATH 103A,B01,083779,Greenfeld; Be'Eri,6,0,36,30
1657135419799,MATH 103A,B02,083780,Greenfeld; Be'Eri,3,0,36,33
1657135419799,MATH 103A,B03,093562,Greenfeld; Be'Eri,3,0,36,33
1657135425827,MATH 105,A01,085443,Carter; Anne Toulson,14,0,35,21
1657135425827,MATH 105,A02,093477,Carter; Anne Toulson,20,0,35,15
1657135431928,MATH 109,A01,083213,Ganzberger; Geoffrey Michael,2,0,34,32
1657135431928,MATH 109,A02,083214,Ganzberger; Geoffrey Michael,3,0,34,31
1657135431928,MATH 109,A03,093478,Ganzberger; Geoffrey Michael,1,0,34,33
1657135431928,MATH 109,B01,083215,Ganzberger; Geoffrey Michael,1,0,32,31
1657135431928,MATH 109,B02,083216,Ganzberger; Geoffrey Michael,1,0,32,31
1657135431928,MATH 109,B03,093479,Ganzberger; Geoffrey Michael,6,0,32,26
1657135437951,MATH 142A,A01,083219,Chow; Bennett,6,0,32,26
1657135437951,MATH 142A,A02,083220,Chow; Bennett,10,0,32,22
1657135437951,MATH 142A,A03,093480,Chow; Bennett,7,0,32,25
1657135437951,MATH 142A,B03,093481,Chow; Bennett,8,0,32,24
1657135437951,MATH 142A,B04,093558,Chow; Bennett,11,0,32,21
1657135437951,MATH 142A,B05,093559,Chow; Bennett,6,0,32,26
1657135443978,MATH 193A,A01,083224,Rotar; Vladimir,7,0,34,27
1657135443978,MATH 193A,A02,083225,Rotar; Vladimir,5,0,34,29
1657135443978,MATH 193A,A03,083781,Rotar; Vladimir,1,0,34,33
1657135443978,MATH 193A,A04,083782,Rotar; Vladimir,8,0,34,26
1657135443978,MATH 193A,A05,093482,Rotar; Vladimir,6,0,34,28
1657135450000,MATH 197,001,091859,McAuley; Julian John,9999,0,9999,0
1657135450000,MATH 197,002,095566,Kedlaya; Kiran S.,9997,0,9999,2
1657135450000,MATH 197,003,095567,Xiao; Ming,9999,0,9999,0
1657135450000,MATH 197,004,095571,Perols; Johan Lars,9998,0,9999,1
1657135457068,COGS 9,A01,083615,Shannon; Kyle Michael,7,0,75,68
1657135463092,COGS 11,A01,083617,Boyle; Mary E. T.,21,0,48,27
1657135469114,COGS 13,A01,083071,Bastos; Amalia Pinkusfeld,9,0,71,62
1657135475148,COGS 14A,A01,092681,Semenuks; Arturs,1,1,100,99
1657135481171,COGS 14B,A01,083073,Cheng; Tzu-Han,6,0,63,57
1657135487204,COGS 17,A01,092677,Semenuks; Arturs,4,0,81,77
1657135493228,COGS 100,A01,083619,Allen; Michael Gordon,15,0,70,55
1657135499255,COGS 101A,A01,083621,Davis; Joshua Daniel,9,0,68,59
1657135505277,COGS 101B,A01,091572,Allen; Michael Gordon,9,0,65,56
1657135511301,COGS 101C,A01,083625,Delgado; Tania,17,0,35,18
1657135517324,COGS 107A,A01,083627,Boyle; Mary E. T.,13,0,60,47
1657135523354,COGS 118A,A01,083075,Gupta; Anjum,15,0,76,61
1657135529383,CSE 3,A50,083646,Miranda; Gregory Joseph,23,0,50,27
1657135535407,CSE 8A,A50,083650,Miranda; Gregory Joseph,17,1,56,39
1657135541435,CSE 11,A01,083080,Cao; Yingjun,5,15,40,35
1657135547457,CSE 12,A01,083652,Krause-Levy; Sophia Louisa,24,1,120,96
1657135553486,CSE 15L,A01,083654,Morris; Justin Loren,9,0,50,41
1657135553486,CSE 15L,A02,083655,Morris; Justin Loren,9,0,50,41
1657135559512,CSE 20,A01,083657,Tran; Khoa Dang,38,0,80,42
1657135565544,CSE 21,A01,095574,Bach; Quang Tran,21,0,48,27
1657135571575,CSE 30,A01,083084,Eldon; John,4,0,80,76
1657135571575,CSE 30,B01,095061,Bhaskar; Nishant,7,0,50,43
1657135577600,CSE 100,A01,083659,Cao; Yingjun,4,4,70,66
1657135583623,CSE 134B,A01,083661,Powell; Thomas Allan,20,0,100,80
1657135589652,CSE 140,A01,083663,Gungor; Onat,13,0,85,72
1657135595674,CSE 140L,A01,083088,Eldon; John,17,0,100,83
1657135601698,CSE 175,A01,083665,Kumar; Rakesh,3,0,25,22
1657135607730,CSE 190,A00,092507,Dubnov; Shlomo,7,0,20,13
1657135613757,ECE 45,A01,083139,Congero; Spencer William,5,0,75,70
1657135619780,ECE 65,A50,083695,Saad; Andrew S,12,0,30,18
1657135619780,ECE 65,A51,095125,Saad; Andrew S,25,0,26,1
1657135625815,ECE 109,A01,091882,Touri; Behrouz,17,0,70,53
1657135631839,ECE 180,A00,083140,Abi Samra; Nicholas Camill,1,0,30,29
1657135631839,ECE 180,B00,083141,Abi Samra; Nicholas Camill,0,0,30,30
1657135637866,MATH 10A,A01,083735,Patchell; Gregory David,2,0,30,28
1657135637866,MATH 10A,A02,083736,Patchell; Gregory David,20,0,30,10
1657135637866,MATH 10A,A03,083737,Patchell; Gregory David,16,0,30,14
1657135643890,MATH 10B,A01,083207,Lim; Seonhee,7,0,34,27
1657135643890,MATH 10B,A02,083208,Lim; Seonhee,9,0,35,26
1657135643890,MATH 10B,A03,093472,Lim; Seonhee,5,0,34,29
1657135643890,MATH 10B,B01,083739,Sinha; Shubham,9,0,30,21
1657135649921,MATH 18,A01,083743,Cinel; Cameron Alexander,6,0,30,24
1657135649921,MATH 18,A02,083744,Cinel; Cameron Alexander,15,0,30,15
1657135649921,MATH 18,A03,083745,Cinel; Cameron Alexander,8,0,30,22
1657135649921,MATH 18,B01,083748,Rideout; David Porter,4,0,37,33
1657135649921,MATH 18,B02,083749,Rideout; David Porter,3,0,36,33
1657135649921,MATH 18,B03,083750,Rideout; David Porter,2,0,37,35
1657135649921,MATH 18,B04,083751,Rideout; David Porter,5,0,36,31
1657135649921,MATH 18,B05,093473,Rideout; David Porter,4,0,36,32
1657135649921,MATH 18,B06,093474,Rideout; David Porter,5,0,36,31
1657135655952,MATH 20A,A01,083754,Zheng; Zequn,12,0,40,28
1657135661981,MATH 20B,A01,083756,Briones; Jor-el Thomas Caparas,1,0,36,35
1657135661981,MATH 20B,A02,083757,Briones; Jor-el Thomas Caparas,1,0,36,35
1657135661981,MATH 20B,A03,093475,Briones; Jor-el Thomas Caparas,0,0,36,36
1657135668015,MATH 20C,A01,083760,Briones; Jor-el Thomas Caparas,1,0,35,34
1657135668015,MATH 20C,A02,083761,Briones; Jor-el Thomas Caparas,8,0,35,27
1657135668015,MATH 20C,A03,093476,Briones; Jor-el Thomas Caparas,0,1,36,36
1657135668015,MATH 20C,B01,083762,Bach; Quang Tran,0,0,30,30
1657135674037,MATH 20D,A01,083765,Tran; Brian Kha,4,0,30,26
1657135674037,MATH 20D,A02,083766,Tran; Brian Kha,5,0,30,25
1657135674037,MATH 20D,A03,083767,Tran; Brian Kha,3,0,30,27
1657135680068,MATH 20E,A01,083771,Ganguly; Soumya,7,0,32,25
1657135680068,MATH 20E,A02,083772,Ganguly; Soumya,6,0,32,26
1657135680068,MATH 20E,B01,083773,Ciotti; Benjamin,18,0,35,17
1657135680068,MATH 20E,B02,083774,Ciotti; Benjamin,17,0,35,18
1657135686096,MATH 103A,A01,083777,Greenfeld; Be'Eri,2,0,36,34
1657135686096,MATH 103A,A02,083778,Greenfeld; Be'Eri,5,0,36,31
1657135686096,MATH 103A,A03,093561,Greenfeld; Be'Eri,4,0,36,32
1657135686096,MATH 103A,B01,083779,Greenfeld; Be'Eri,6,0,36,30
1657135686096,MATH 103A,B02,083780,Greenfeld; Be'Eri,3,0,36,33
1657135686096,MATH 103A,B03,093562,Greenfeld; Be'Eri,3,0,36,33
1657135692120,MATH 105,A01,085443,Carter; Anne Toulson,14,0,35,21
1657135692120,MATH 105,A02,093477,Carter; Anne Toulson,20,0,35,15
1657135698148,MATH 109,A01,083213,Ganzberger; Geoffrey Michael,2,0,34,32
1657135698148,MATH 109,A02,083214,Ganzberger; Geoffrey Michael,3,0,34,31
1657135698148,MATH 109,A03,093478,Ganzberger; Geoffrey Michael,1,0,34,33
1657135698148,MATH 109,B01,083215,Ganzberger; Geoffrey Michael,1,0,32,31
1657135698148,MATH 109,B02,083216,Ganzberger; Geoffrey Michael,1,0,32,31
1657135698148,MATH 109,B03,093479,Ganzberger; Geoffrey Michael,6,0,32,26
1657135704177,MATH 142A,A01,083219,Chow; Bennett,6,0,32,26
1657135704177,MATH 142A,A02,083220,Chow; Bennett,10,0,32,22
1657135704177,MATH 142A,A03,093480,Chow; Bennett,7,0,32,25
1657135704177,MATH 142A,B03,093481,Chow; Bennett,8,0,32,24
1657135704177,MATH 142A,B04,093558,Chow; Bennett,11,0,32,21
1657135704177,MATH 142A,B05,093559,Chow; Bennett,6,0,32,26
1657135710202,MATH 193A,A01,083224,Rotar; Vladimir,7,0,34,27
1657135710202,MATH 193A,A02,083225,Rotar; Vladimir,5,0,34,29
1657135710202,MATH 193A,A03,083781,Rotar; Vladimir,1,0,34,33
1657135710202,MATH 193A,A04,083782,Rotar; Vladimir,8,0,34,26
1657135710202,MATH 193A,A05,093482,Rotar; Vladimir,6,0,34,28
1657135716229,MATH 197,001,091859,McAuley; Julian John,9999,0,9999,0
1657135716229,MATH 197,002,095566,Kedlaya; Kiran S.,9997,0,9999,2
1657135716229,MATH 197,003,095567,Xiao; Ming,9999,0,9999,0
1657135716229,MATH 197,004,095571,Perols; Johan Lars,9998,0,9999,1
1657135723282,COGS 9,A01,083615,Shannon; Kyle Michael,7,0,75,68
1657135729306,COGS 11,A01,083617,Boyle; Mary E. T.,21,0,48,27
1657135735339,COGS 13,A01,083071,Bastos; Amalia Pinkusfeld,9,0,71,62
1657135741366,COGS 14A,A01,092681,Semenuks; Arturs,1,1,100,99
1657135747393,COGS 14B,A01,083073,Cheng; Tzu-Han,6,0,63,57
1657135753420,COGS 17,A01,092677,Semenuks; Arturs,4,0,81,77
1657135759442,COGS 100,A01,083619,Allen; Michael Gordon,15,0,70,55
1657135765465,COGS 101A,A01,083621,Davis; Joshua Daniel,9,0,68,59
1657135771495,COGS 101B,A01,091572,Allen; Michael Gordon,9,0,65,56
1657135777525,COGS 101C,A01,083625,Delgado; Tania,17,0,35,18
1657135783555,COGS 107A,A01,083627,Boyle; Mary E. T.,13,0,60,47
1657135789579,COGS 118A,A01,083075,Gupta; Anjum,15,0,76,61
1657135795601,CSE 3,A50,083646,Miranda; Gregory Joseph,23,0,50,27
1657135801629,CSE 8A,A50,083650,Miranda; Gregory Joseph,17,1,56,39
1657135807651,CSE 11,A01,083080,Cao; Yingjun,5,15,40,35
1657135813678,CSE 12,A01,083652,Krause-Levy; Sophia Louisa,24,1,120,96
1657135819701,CSE 15L,A01,083654,Morris; Justin Loren,9,0,50,41
1657135819701,CSE 15L,A02,083655,Morris; Justin Loren,9,0,50,41
1657135825724,CSE 20,A01,083657,Tran; Khoa Dang,38,0,80,42
1657135831747,CSE 21,A01,095574,Bach; Quang Tran,21,0,48,27
1657135837770,CSE 30,A01,083084,Eldon; John,4,0,80,76
1657135837770,CSE 30,B01,095061,Bhaskar; Nishant,7,0,50,43
1657135843794,CSE 100,A01,083659,Cao; Yingjun,4,4,70,66
1657135849816,CSE 134B,A01,083661,Powell; Thomas Allan,20,0,100,80
1657135855842,CSE 140,A01,083663,Gungor; Onat,13,0,85,72
1657135861870,CSE 140L,A01,083088,Eldon; John,17,0,100,83
1657135867892,CSE 175,A01,083665,Kumar; Rakesh,3,0,25,22
1657135873916,CSE 190,A00,092507,Dubnov; Shlomo,7,0,20,13
1657135879940,ECE 45,A01,083139,Congero; Spencer William,5,0,75,70
1657135885969,ECE 65,A50,083695,Saad; Andrew S,12,0,30,18
1657135885969,ECE 65,A51,095125,Saad; Andrew S,25,0,26,1
1657135891996,ECE 109,A01,091882,Touri; Behrouz,17,0,70,53
1657135898020,ECE 180,A00,083140,Abi Samra; Nicholas Camill,1,0,30,29
1657135898020,ECE 180,B00,083141,Abi Samra; Nicholas Camill,0,0,30,30
1657135904042,MATH 10A,A01,083735,Patchell; Gregory David,2,0,30,28
1657135904042,MATH 10A,A02,083736,Patchell; Gregory David,20,0,30,10
1657135904042,MATH 10A,A03,083737,Patchell; Gregory David,16,0,30,14
1657135910071,MATH 10B,A01,083207,Lim; Seonhee,7,0,34,27
1657135910071,MATH 10B,A02,083208,Lim; Seonhee,9,0,35,26
1657135910071,MATH 10B,A03,093472,Lim; Seonhee,5,0,34,29
1657135910071,MATH 10B,B01,083739,Sinha; Shubham,9,0,30,21
1657135916104,MATH 18,A01,083743,Cinel; Cameron Alexander,6,0,30,24
1657135916104,MATH 18,A02,083744,Cinel; Cameron Alexander,15,0,30,15
1657135916104,MATH 18,A03,083745,Cinel; Cameron Alexander,8,0,30,22
1657135916104,MATH 18,B01,083748,Rideout; David Porter,4,0,37,33
1657135916104,MATH 18,B02,083749,Rideout; David Porter,3,0,36,33
1657135916104,MATH 18,B03,083750,Rideout; David Porter,2,0,37,35
1657135916104,MATH 18,B04,083751,Rideout; David Porter,5,0,36,31
1657135916104,MATH 18,B05,093473,Rideout; David Porter,4,0,36,32
1657135916104,MATH 18,B06,093474,Rideout; David Porter,5,0,36,31
1657135922128,MATH 20A,A01,083754,Zheng; Zequn,12,0,40,28
1657135928150,MATH 20B,A01,083756,Briones; Jor-el Thomas Caparas,1,0,36,35
1657135928150,MATH 20B,A02,083757,Briones; Jor-el Thomas Caparas,1,0,36,35
1657135928150,MATH 20B,A03,093475,Briones; Jor-el Thomas Caparas,0,0,36,36
1657135934179,MATH 20C,A01,083760,Briones; Jor-el Thomas Caparas,1,0,35,34
1657135934179,MATH 20C,A02,083761,Briones; Jor-el Thomas Caparas,8,0,35,27
1657135934179,MATH 20C,A03,093476,Briones; Jor-el Thomas Caparas,0,1,36,36
1657135934179,MATH 20C,B01,083762,Bach; Quang Tran,0,0,30,30
1657135940203,MATH 20D,A01,083765,Tran; Brian Kha,4,0,30,26
1657135940203,MATH 20D,A02,083766,Tran; Brian Kha,5,0,30,25
1657135940203,MATH 20D,A03,083767,Tran; Brian Kha,3,0,30,27
1657135946236,MATH 20E,A01,083771,Ganguly; Soumya,7,0,32,25
1657135946236,MATH 20E,A02,083772,Ganguly; Soumya,6,0,32,26
1657135946236,MATH 20E,B01,083773,Ciotti; Benjamin,18,0,35,17
1657135946236,MATH 20E,B02,083774,Ciotti; Benjamin,17,0,35,18
1657135952280,MATH 103A,A01,083777,Greenfeld; Be'Eri,2,0,36,34
1657135952280,MATH 103A,A02,083778,Greenfeld; Be'Eri,5,0,36,31
1657135952280,MATH 103A,A03,093561,Greenfeld; Be'Eri,4,0,36,32
1657135952280,MATH 103A,B01,083779,Greenfeld; Be'Eri,6,0,36,30
1657135952280,MATH 103A,B02,083780,Greenfeld; Be'Eri,3,0,36,33
1657135952280,MATH 103A,B03,093562,Greenfeld; Be'Eri,3,0,36,33
1657135958306,MATH 105,A01,085443,Carter; Anne Toulson,14,0,35,21
1657135958306,MATH 105,A02,093477,Carter; Anne Toulson,20,0,35,15
1657135964335,MATH 109,A01,083213,Ganzberger; Geoffrey Michael,2,0,34,32
1657135964335,MATH 109,A02,083214,Ganzberger; Geoffrey Michael,3,0,34,31
1657135964335,MATH 109,A03,093478,Ganzberger; Geoffrey Michael,1,0,34,33
1657135964335,MATH 109,B01,083215,Ganzberger; Geoffrey Michael,1,0,32,31
1657135964335,MATH 109,B02,083216,Ganzberger; Geoffrey Michael,1,0,32,31
1657135964335,MATH 109,B03,093479,Ganzberger; Geoffrey Michael,6,0,32,26
1657135970359,MATH 142A,A01,083219,Chow; Bennett,6,0,32,26
1657135970359,MATH 142A,A02,083220,Chow; Bennett,10,0,32,22
1657135970359,MATH 142A,A03,093480,Chow; Bennett,7,0,32,25
1657135970359,MATH 142A,B03,093481,Chow; Bennett,8,0,32,24
1657135970359,MATH 142A,B04,093558,Chow; Bennett,11,0,32,21
1657135970359,MATH 142A,B05,093559,Chow; Bennett,6,0,32,26
1657135976384,MATH 193A,A01,083224,Rotar; Vladimir,7,0,34,27
1657135976384,MATH 193A,A02,083225,Rotar; Vladimir,5,0,34,29
1657135976384,MATH 193A,A03,083781,Rotar; Vladimir,1,0,34,33
1657135976384,MATH 193A,A04,083782,Rotar; Vladimir,8,0,34,26
1657135976384,MATH 193A,A05,093482,Rotar; Vladimir,6,0,34,28
1657135982413,MATH 197,001,091859,McAuley; Julian John,9999,0,9999,0
1657135982413,MATH 197,002,095566,Kedlaya; Kiran S.,9997,0,9999,2
1657135982413,MATH 197,003,095567,Xiao; Ming,9999,0,9999,0
1657135982413,MATH 197,004,095571,Perols; Johan Lars,9998,0,9999,1
1657135989480,COGS 9,A01,083615,Shannon; Kyle Michael,7,0,75,68
1657135995503,COGS 11,A01,083617,Boyle; Mary E. T.,21,0,48,27
1657136001525,COGS 13,A01,083071,Bastos; Amalia Pinkusfeld,9,0,71,62
1657136007548,COGS 14A,A01,092681,Semenuks; Arturs,1,1,100,99
1657136013577,COGS 14B,A01,083073,Cheng; Tzu-Han,6,0,63,57
1657136019606,COGS 17,A01,092677,Semenuks; Arturs,4,0,81,77
1657136025718,COGS 100,A01,083619,Allen; Michael Gordon,15,0,70,55
1657136031743,COGS 101A,A01,083621,Davis; Joshua Daniel,9,0,68,59
1657136037769,COGS 101B,A01,091572,Allen; Michael Gordon,9,0,65,56
1657136043802,COGS 101C,A01,083625,Delgado; Tania,17,0,35,18
1657136049830,COGS 107A,A01,083627,Boyle; Mary E. T.,13,0,60,47
1657136055862,COGS 118A,A01,083075,Gupta; Anjum,15,0,76,61
1657136061888,CSE 3,A50,083646,Miranda; Gregory Joseph,23,0,50,27
1657136067918,CSE 8A,A50,083650,Miranda; Gregory Joseph,17,1,56,39
1657136073947,CSE 11,A01,083080,Cao; Yingjun,5,15,40,35
1657136079970,CSE 12,A01,083652,Krause-Levy; Sophia Louisa,24,1,120,96
1657136086009,CSE 15L,A01,083654,Morris; Justin Loren,9,0,50,41
1657136086009,CSE 15L,A02,083655,Morris; Justin Loren,9,0,50,41
1657136092033,CSE 20,A01,083657,Tran; Khoa Dang,38,0,80,42
1657136098056,CSE 21,A01,095574,Bach; Quang Tran,21,0,48,27
1657136104079,CSE 30,A01,083084,Eldon; John,4,0,80,76
1657136104079,CSE 30,B01,095061,Bhaskar; Nishant,7,0,50,43
1657136110105,CSE 100,A01,083659,Cao; Yingjun,4,4,70,66
1657136116130,CSE 134B,A01,083661,Powell; Thomas Allan,20,0,100,80
1657136122152,CSE 140,A01,083663,Gungor; Onat,13,0,85,72
1657136128175,CSE 140L,A01,083088,Eldon; John,17,0,100,83
1657136134201,CSE 175,A01,083665,Kumar; Rakesh,3,0,25,22
1657136140228,CSE 190,A00,092507,Dubnov; Shlomo,7,0,20,13
1657136146251,ECE 45,A01,083139,Congero; Spencer William,5,0,75,70
1657136152289,ECE 65,A50,083695,Saad; Andrew S,12,0,30,18
1657136152289,ECE 65,A51,095125,Saad; Andrew S,25,0,26,1
1657136158320,ECE 109,A01,091882,Touri; Behrouz,17,0,70,53
1657136164343,ECE 180,A00,083140,Abi Samra; Nicholas Camill,1,0,30,29
1657136164343,ECE 180,B00,083141,Abi Samra; Nicholas Camill,0,0,30,30
1657136170383,MATH 10A,A01,083735,Patchell; Gregory David,2,0,30,28
1657136170383,MATH 10A,A02,083736,Patchell; Gregory David,20,0,30,10
1657136170383,MATH 10A,A03,083737,Patchell; Gregory David,16,0,30,14
1657136176413,MATH 10B,A01,083207,Lim; Seonhee,7,0,34,27
1657136176413,MATH 10B,A02,083208,Lim; Seonhee,9,0,35,26
1657136176413,MATH 10B,A03,093472,Lim; Seonhee,5,0,34,29
1657136176413,MATH 10B,B01,083739,Sinha; Shubham,9,0,30,21
1657136182439,MATH 18,A01,083743,Cinel; Cameron Alexander,6,0,30,24
1657136182439,MATH 18,A02,083744,Cinel; Cameron Alexander,15,0,30,15
1657136182439,MATH 18,A03,083745,Cinel; Cameron Alexander,8,0,30,22
1657136182439,MATH 18,B01,083748,Rideout; David Porter,4,0,37,33
1657136182439,MATH 18,B02,083749,Rideout; David Porter,3,0,36,33
1657136182439,MATH 18,B03,083750,Rideout; David Porter,2,0,37,35
1657136182439,MATH 18,B04,083751,Rideout; David Porter,5,0,36,31
1657136182439,MATH 18,B05,093473,Rideout; David Porter,4,0,36,32
1657136182439,MATH 18,B06,093474,Rideout; David Porter,5,0,36,31
1657136188463,MATH 20A,A01,083754,Zheng; Zequn,12,0,40,28
1657136194492,MATH 20B,A01,083756,Briones; Jor-el Thomas Caparas,1,0,36,35
1657136194492,MATH 20B,A02,083757,Briones; Jor-el Thomas Caparas,1,0,36,35
1657136194492,MATH 20B,A03,093475,Briones; Jor-el Thomas Caparas,0,0,36,36
1657136200521,MATH 20C,A01,083760,Briones; Jor-el Thomas Caparas,1,0,35,34
1657136200521,MATH 20C,A02,083761,Briones; Jor-el Thomas Caparas,8,0,35,27
1657136200521,MATH 20C,A03,093476,Briones; Jor-el Thomas Caparas,0,1,36,36
1657136200521,MATH 20C,B01,083762,Bach; Quang Tran,0,0,30,30
1657136206546,MATH 20D,A01,083765,Tran; Brian Kha,4,0,30,26
1657136206546,MATH 20D,A02,083766,Tran; Brian Kha,5,0,30,25
1657136206546,MATH 20D,A03,083767,Tran; Brian Kha,3,0,30,27
1657136212573,MATH 20E,A01,083771,Ganguly; Soumya,7,0,32,25
1657136212573,MATH 20E,A02,083772,Ganguly; Soumya,6,0,32,26
1657136212573,MATH 20E,B01,083773,Ciotti; Benjamin,18,0,35,17
1657136212573,MATH 20E,B02,083774,Ciotti; Benjamin,17,0,35,18
1657136218600,MATH 103A,A01,083777,Greenfeld; Be'Eri,2,0,36,34
1657136218600,MATH 103A,A02,083778,Greenfeld; Be'Eri,5,0,36,31
1657136218600,MATH 103A,A03,093561,Greenfeld; Be'Eri,4,0,36,32
1657136218600,MATH 103A,B01,083779,Greenfeld; Be'Eri,6,0,36,30
1657136218600,MATH 103A,B02,083780,Greenfeld; Be'Eri,3,0,36,33
1657136218600,MATH 103A,B03,093562,Greenfeld; Be'Eri,3,0,36,33
1657136224645,MATH 105,A01,085443,Carter; Anne Toulson,14,0,35,21
1657136224645,MATH 105,A02,093477,Carter; Anne Toulson,20,0,35,15
1657136230669,MATH 109,A01,083213,Ganzberger; Geoffrey Michael,2,0,34,32
1657136230669,MATH 109,A02,083214,Ganzberger; Geoffrey Michael,3,0,34,31
1657136230669,MATH 109,A03,093478,Ganzberger; Geoffrey Michael,1,0,34,33
1657136230669,MATH 109,B01,083215,Ganzberger; Geoffrey Michael,1,0,32,31
1657136230669,MATH 109,B02,083216,Ganzberger; Geoffrey Michael,1,0,32,31
1657136230669,MATH 109,B03,093479,Ganzberger; Geoffrey Michael,6,0,32,26
1657136236702,MATH 142A,A01,083219,Chow; Bennett,6,0,32,26
1657136236702,MATH 142A,A02,083220,Chow; Bennett,10,0,32,22
1657136236702,MATH 142A,A03,093480,Chow; Bennett,7,0,32,25
1657136236702,MATH 142A,B03,093481,Chow; Bennett,8,0,32,24
1657136236702,MATH 142A,B04,093558,Chow; Bennett,11,0,32,21
1657136236702,MATH 142A,B05,093559,Chow; Bennett,6,0,32,26
1657136242736,MATH 193A,A01,083224,Rotar; Vladimir,7,0,34,27
1657136242736,MATH 193A,A02,083225,Rotar; Vladimir,5,0,34,29
1657136242736,MATH 193A,A03,083781,Rotar; Vladimir,1,0,34,33
1657136242736,MATH 193A,A04,083782,Rotar; Vladimir,8,0,34,26
1657136242736,MATH 193A,A05,093482,Rotar; Vladimir,6,0,34,28
1657136248761,MATH 197,001,091859,McAuley; Julian John,9999,0,9999,0
1657136248761,MATH 197,002,095566,Kedlaya; Kiran S.,9997,0,9999,2
1657136248761,MATH 197,003,095567,Xiao; Ming,9999,0,9999,0
1657136248761,MATH 197,004,095571,Perols; Johan Lars,9998,0,9999,1
1657136255827,COGS 9,A01,083615,Shannon; Kyle Michael,7,0,75,68
1657136261857,COGS 11,A01,083617,Boyle; Mary E. T.,21,0,48,27
1657136267880,COGS 13,A01,083071,Bastos; Amalia Pinkusfeld,9,0,71,62
1657136273905,COGS 14A,A01,092681,Semenuks; Arturs,1,1,100,99
1657136279931,COGS 14B,A01,083073,Cheng; Tzu-Han,6,0,63,57
1657136285954,COGS 17,A01,092677,Semenuks; Arturs,4,0,81,77
1657136291977,COGS 100,A01,083619,Allen; Michael Gordon,15,0,70,55
1657136298010,COGS 101A,A01,083621,Davis; Joshua Daniel,9,0,68,59
1657136304034,COGS 101B,A01,091572,Allen; Michael Gordon,9,0,65,56
1657136310060,COGS 101C,A01,083625,Delgado; Tania,17,0,35,18
1657136316083,COGS 107A,A01,083627,Boyle; Mary E. T.,13,0,60,47
1657136322106,COGS 118A,A01,083075,Gupta; Anjum,15,0,76,61
1657136328128,CSE 3,A50,083646,Miranda; Gregory Joseph,23,0,50,27
1657136334151,CSE 8A,A50,083650,Miranda; Gregory Joseph,17,1,56,39
1657136340182,CSE 11,A01,083080,Cao; Yingjun,5,15,40,35
1657136346207,CSE 12,A01,083652,Krause-Levy; Sophia Louisa,24,1,120,96
1657136352230,CSE 15L,A01,083654,Morris; Justin Loren,9,0,50,41
1657136352230,CSE 15L,A02,083655,Morris; Justin Loren,9,0,50,41
1657136358252,CSE 20,A01,083657,Tran; Khoa Dang,38,0,80,42
1657136364282,CSE 21,A01,095574,Bach; Quang Tran,21,0,48,27
1657136370305,CSE 30,A01,083084,Eldon; John,4,0,80,76
1657136370305,CSE 30,B01,095061,Bhaskar; Nishant,7,0,50,43
1657136376344,CSE 100,A01,083659,Cao; Yingjun,4,4,70,66
1657136382371,CSE 134B,A01,083661,Powell; Thomas Allan,20,0,100,80
1657136388403,CSE 140,A01,083663,Gungor; Onat,13,0,85,72
1657136394427,CSE 140L,A01,083088,Eldon; John,17,0,100,83
1657136400451,CSE 175,A01,083665,Kumar; Rakesh,3,0,25,22
1657136406485,CSE 190,A00,092507,Dubnov; Shlomo,7,0,20,13
1657136412512,ECE 45,A01,083139,Congero; Spencer William,5,0,75,70
1657136418537,ECE 65,A50,083695,Saad; Andrew S,12,0,30,18
1657136418537,ECE 65,A51,095125,Saad; Andrew S,25,0,26,1
1657136424560,ECE 109,A01,091882,Touri; Behrouz,17,0,70,53
1657136430588,ECE 180,A00,083140,Abi Samra; Nicholas Camill,1,0,30,29
1657136430588,ECE 180,B00,083141,Abi Samra; Nicholas Camill,0,0,30,30
1657136436611,MATH 10A,A01,083735,Patchell; Gregory David,2,0,30,28
1657136436611,MATH 10A,A02,083736,Patchell; Gregory David,20,0,30,10
1657136436611,MATH 10A,A03,083737,Patchell; Gregory David,16,0,30,14
1657136442635,MATH 10B,A01,083207,Lim; Seonhee,7,0,34,27
1657136442635,MATH 10B,A02,083208,Lim; Seonhee,9,0,35,26
1657136442635,MATH 10B,A03,093472,Lim; Seonhee,5,0,34,29
1657136442635,MATH 10B,B01,083739,Sinha; Shubham,9,0,30,21
1657136448660,MATH 18,A01,083743,Cinel; Cameron Alexander,6,0,30,24
1657136448660,MATH 18,A02,083744,Cinel; Cameron Alexander,15,0,30,15
1657136448660,MATH 18,A03,083745,Cinel; Cameron Alexander,8,0,30,22
1657136448660,MATH 18,B01,083748,Rideout; David Porter,4,0,37,33
1657136448660,MATH 18,B02,083749,Rideout; David Porter,3,0,36,33
1657136448660,MATH 18,B03,083750,Rideout; David Porter,2,0,37,35
1657136448660,MATH 18,B04,083751,Rideout; David Porter,5,0,36,31
1657136448660,MATH 18,B05,093473,Rideout; David Porter,4,0,36,32
1657136448660,MATH 18,B06,093474,Rideout; David Porter,5,0,36,31
1657136454682,MATH 20A,A01,083754,Zheng; Zequn,12,0,40,28
1657136460706,MATH 20B,A01,083756,Briones; Jor-el Thomas Caparas,1,0,36,35
1657136460706,MATH 20B,A02,083757,Briones; Jor-el Thomas Caparas,1,0,36,35
1657136460706,MATH 20B,A03,093475,Briones; Jor-el Thomas Caparas,0,0,36,36
1657136466729,MATH 20C,A01,083760,Briones; Jor-el Thomas Caparas,1,0,35,34
1657136466729,MATH 20C,A02,083761,Briones; Jor-el Thomas Caparas,8,0,35,27
1657136466729,MATH 20C,A03,093476,Briones; Jor-el Thomas Caparas,0,1,36,36
1657136466729,MATH 20C,B01,083762,Bach; Quang Tran,0,0,30,30
1657136472756,MATH 20D,A01,083765,Tran; Brian Kha,4,0,30,26
1657136472756,MATH 20D,A02,083766,Tran; Brian Kha,5,0,30,25
1657136472756,MATH 20D,A03,083767,Tran; Brian Kha,3,0,30,27
1657136478780,MATH 20E,A01,083771,Ganguly; Soumya,7,0,32,25
1657136478780,MATH 20E,A02,083772,Ganguly; Soumya,6,0,32,26
1657136478780,MATH 20E,B01,083773,Ciotti; Benjamin,18,0,35,17
1657136478780,MATH 20E,B02,083774,Ciotti; Benjamin,17,0,35,18
1657136484804,MATH 103A,A01,083777,Greenfeld; Be'Eri,2,0,36,34
1657136484804,MATH 103A,A02,083778,Greenfeld; Be'Eri,5,0,36,31
1657136484804,MATH 103A,A03,093561,Greenfeld; Be'Eri,4,0,36,32
1657136484804,MATH 103A,B01,083779,Greenfeld; Be'Eri,6,0,36,30
1657136484804,MATH 103A,B02,083780,Greenfeld; Be'Eri,3,0,36,33
1657136484804,MATH 103A,B03,093562,Greenfeld; Be'Eri,3,0,36,33
1657136490838,MATH 105,A01,085443,Carter; Anne Toulson,14,0,35,21
1657136490838,MATH 105,A02,093477,Carter; Anne Toulson,20,0,35,15
1657136496863,MATH 109,A01,083213,Ganzberger; Geoffrey Michael,2,0,34,32
1657136496863,MATH 109,A02,083214,Ganzberger; Geoffrey Michael,3,0,34,31
1657136496863,MATH 109,A03,093478,Ganzberger; Geoffrey Michael,1,0,34,33
1657136496863,MATH 109,B01,083215,Ganzberger; Geoffrey Michael,1,0,32,31
1657136496863,MATH 109,B02,083216,Ganzberger; Geoffrey Michael,1,0,32,31
1657136496863,MATH 109,B03,093479,Ganzberger; Geoffrey Michael,6,0,32,26
1657136502885,MATH 142A,A01,083219,Chow; Bennett,6,0,32,26
1657136502885,MATH 142A,A02,083220,Chow; Bennett,10,0,32,22
1657136502885,MATH 142A,A03,093480,Chow; Bennett,7,0,32,25
1657136502885,MATH 142A,B03,093481,Chow; Bennett,8,0,32,24
1657136502885,MATH 142A,B04,093558,Chow; Bennett,11,0,32,21
1657136502885,MATH 142A,B05,093559,Chow; Bennett,6,0,32,26
1657136508913,MATH 193A,A01,083224,Rotar; Vladimir,7,0,34,27
1657136508913,MATH 193A,A02,083225,Rotar; Vladimir,5,0,34,29
1657136508913,MATH 193A,A03,083781,Rotar; Vladimir,1,0,34,33
1657136508913,MATH 193A,A04,083782,Rotar; Vladimir,8,0,34,26
1657136508913,MATH 193A,A05,093482,Rotar; Vladimir,6,0,34,28
1657136514943,MATH 197,001,091859,McAuley; Julian John,9999,0,9999,0
1657136514943,MATH 197,002,095566,Kedlaya; Kiran S.,9997,0,9999,2
1657136514943,MATH 197,003,095567,Xiao; Ming,9999,0,9999,0
1657136514943,MATH 197,004,095571,Perols; Johan Lars,9998,0,9999,1
1657136521999,COGS 9,A01,083615,Shannon; Kyle Michael,7,0,75,68
1657136528020,COGS 11,A01,083617,Boyle; Mary E. T.,21,0,48,27
1657136534052,COGS 13,A01,083071,Bastos; Amalia Pinkusfeld,9,0,71,62
1657136540076,COGS 14A,A01,092681,Semenuks; Arturs,1,1,100,99
1657136546102,COGS 14B,A01,083073,Cheng; Tzu-Han,6,0,63,57
1657136552125,COGS 17,A01,092677,Semenuks; Arturs,4,0,81,77
1657136558153,COGS 100,A01,083619,Allen; Michael Gordon,15,0,70,55
1657136564181,COGS 101A,A01,083621,Davis; Joshua Daniel,9,0,68,59
1657136570204,COGS 101B,A01,091572,Allen; Michael Gordon,9,0,65,56
1657136576231,COGS 101C,A01,083625,Delgado; Tania,17,0,35,18
1657136582258,COGS 107A,A01,083627,Boyle; Mary E. T.,13,0,60,47
1657136588282,COGS 118A,A01,083075,Gupta; Anjum,15,0,76,61
1657136594305,CSE 3,A50,083646,Miranda; Gregory Joseph,23,0,50,27
1657136600328,CSE 8A,A50,083650,Miranda; Gregory Joseph,17,1,56,39
1657136606372,CSE 11,A01,083080,Cao; Yingjun,5,15,40,35
1657136612395,CSE 12,A01,083652,Krause-Levy; Sophia Louisa,24,1,120,96
1657136618420,CSE 15L,A01,083654,Morris; Justin Loren,9,0,50,41
1657136618420,CSE 15L,A02,083655,Morris; Justin Loren,9,0,50,41
1657136624517,CSE 20,A01,083657,Tran; Khoa Dang,38,0,80,42
1657136630545,CSE 21,A01,095574,Bach; Quang Tran,21,0,48,27
1657136636567,CSE 30,A01,083084,Eldon; John,4,0,80,76
1657136636567,CSE 30,B01,095061,Bhaskar; Nishant,7,0,50,43
1657136642595,CSE 100,A01,083659,Cao; Yingjun,4,4,70,66
1657136648618,CSE 134B,A01,083661,Powell; Thomas Allan,20,0,100,80
1657136654641,CSE 140,A01,083663,Gungor; Onat,13,0,85,72
1657136660667,CSE 140L,A01,083088,Eldon; John,17,0,100,83
1657136666690,CSE 175,A01,083665,Kumar; Rakesh,3,0,25,22
1657136672722,CSE 190,A00,092507,Dubnov; Shlomo,7,0,20,13
1657136678744,ECE 45,A01,083139,Congero; Spencer William,5,0,75,70
1657136684784,ECE 65,A50,083695,Saad; Andrew S,12,0,30,18
1657136684784,ECE 65,A51,095125,Saad; Andrew S,25,0,26,1
1657136690817,ECE 109,A01,091882,Touri; Behrouz,17,0,70,53
1657136696838,ECE 180,A00,083140,Abi Samra; Nicholas Camill,1,0,30,29
1657136696838,ECE 180,B00,083141,Abi Samra; Nicholas Camill,0,0,30,30
1657136702869,MATH 10A,A01,083735,Patchell; Gregory David,2,0,30,28
1657136702869,MATH 10A,A02,083736,Patchell; Gregory David,20,0,30,10
1657136702869,MATH 10A,A03,083737,Patchell; Gregory David,16,0,30,14
1657136708893,MATH 10B,A01,083207,Lim; Seonhee,7,0,34,27
1657136708893,MATH 10B,A02,083208,Lim; Seonhee,9,0,35,26
1657136708893,MATH 10B,A03,093472,Lim; Seonhee,5,0,34,29
1657136708893,MATH 10B,B01,083739,Sinha; Shubham,9,0,30,21
1657136714934,MATH 18,A01,083743,Cinel; Cameron Alexander,6,0,30,24
1657136714934,MATH 18,A02,083744,Cinel; Cameron Alexander,15,0,30,15
1657136714934,MATH 18,A03,083745,Cinel; Cameron Alexander,8,0,30,22
1657136714934,MATH 18,B01,083748,Rideout; David Porter,4,0,37,33
1657136714934,MATH 18,B02,083749,Rideout; David Porter,3,0,36,33
1657136714934,MATH 18,B03,083750,Rideout; David Porter,2,0,37,35
1657136714934,MATH 18,B04,083751,Rideout; David Porter,5,0,36,31
1657136714934,MATH 18,B05,093473,Rideout; David Porter,4,0,36,32
1657136714934,MATH 18,B06,093474,Rideout; David Porter,5,0,36,31
1657136720956,MATH 20A,A01,083754,Zheng; Zequn,12,0,40,28
1657136726989,MATH 20B,A01,083756,Briones; Jor-el Thomas Caparas,1,0,36,35
1657136726989,MATH 20B,A02,083757,Briones; Jor-el Thomas Caparas,1,0,36,35
1657136726989,MATH 20B,A03,093475,Briones; Jor-el Thomas Caparas,0,0,36,36
1657136733013,MATH 20C,A01,083760,Briones; Jor-el Thomas Caparas,1,0,35,34
1657136733013,MATH 20C,A02,083761,Briones; Jor-el Thomas Caparas,8,0,35,27
1657136733013,MATH 20C,A03,093476,Briones; Jor-el Thomas Caparas,0,1,36,36
1657136733013,MATH 20C,B01,083762,Bach; Quang Tran,0,0,30,30
1657136739040,MATH 20D,A01,083765,Tran; Brian Kha,4,0,30,26
1657136739040,MATH 20D,A02,083766,Tran; Brian Kha,5,0,30,25
1657136739040,MATH 20D,A03,083767,Tran; Brian Kha,3,0,30,27
1657136745080,MATH 20E,A01,083771,Ganguly; Soumya,7,0,32,25
1657136745080,MATH 20E,A02,083772,Ganguly; Soumya,6,0,32,26
1657136745080,MATH 20E,B01,083773,Ciotti; Benjamin,18,0,35,17
1657136745080,MATH 20E,B02,083774,Ciotti; Benjamin,17,0,35,18
1657136751105,MATH 103A,A01,083777,Greenfeld; Be'Eri,2,0,36,34
1657136751105,MATH 103A,A02,083778,Greenfeld; Be'Eri,5,0,36,31
1657136751105,MATH 103A,A03,093561,Greenfeld; Be'Eri,4,0,36,32
1657136751105,MATH 103A,B01,083779,Greenfeld; Be'Eri,6,0,36,30
1657136751105,MATH 103A,B02,083780,Greenfeld; Be'Eri,3,0,36,33
1657136751105,MATH 103A,B03,093562,Greenfeld; Be'Eri,3,0,36,33
1657136757127,MATH 105,A01,085443,Carter; Anne Toulson,14,0,35,21
1657136757127,MATH 105,A02,093477,Carter; Anne Toulson,20,0,35,15
1657136763152,MATH 109,A01,083213,Ganzberger; Geoffrey Michael,2,0,34,32
1657136763152,MATH 109,A02,083214,Ganzberger; Geoffrey Michael,3,0,34,31
1657136763152,MATH 109,A03,093478,Ganzberger; Geoffrey Michael,1,0,34,33
1657136763152,MATH 109,B01,083215,Ganzberger; Geoffrey Michael,1,0,32,31
1657136763152,MATH 109,B02,083216,Ganzberger; Geoffrey Michael,1,0,32,31
1657136763152,MATH 109,B03,093479,Ganzberger; Geoffrey Michael,6,0,32,26
1657136769185,MATH 142A,A01,083219,Chow; Bennett,6,0,32,26
1657136769185,MATH 142A,A02,083220,Chow; Bennett,10,0,32,22
1657136769185,MATH 142A,A03,093480,Chow; Bennett,7,0,32,25
1657136769185,MATH 142A,B03,093481,Chow; Bennett,8,0,32,24
1657136769185,MATH 142A,B04,093558,Chow; Bennett,11,0,32,21
1657136769185,MATH 142A,B05,093559,Chow; Bennett,6,0,32,26
1657136775208,MATH 193A,A01,083224,Rotar; Vladimir,7,0,34,27
1657136775208,MATH 193A,A02,083225,Rotar; Vladimir,5,0,34,29
1657136775208,MATH 193A,A03,083781,Rotar; Vladimir,1,0,34,33
1657136775208,MATH 193A,A04,083782,Rotar; Vladimir,8,0,34,26
1657136775208,MATH 193A,A05,093482,Rotar; Vladimir,6,0,34,28
1657136781235,MATH 197,001,091859,McAuley; Julian John,9999,0,9999,0
1657136781235,MATH 197,002,095566,Kedlaya; Kiran S.,9997,0,9999,2
1657136781235,MATH 197,003,095567,Xiao; Ming,9999,0,9999,0
1657136781235,MATH 197,004,095571,Perols; Johan Lars,9998,0,9999,1
1657136788290,COGS 9,A01,083615,Shannon; Kyle Michael,7,0,75,68
1657136794333,COGS 11,A01,083617,Boyle; Mary E. T.,21,0,48,27
1657136800359,COGS 13,A01,083071,Bastos; Amalia Pinkusfeld,9,0,71,62
1657136806385,COGS 14A,A01,092681,Semenuks; Arturs,1,1,100,99
1657136812413,COGS 14B,A01,083073,Cheng; Tzu-Han,6,0,63,57
1657136818439,COGS 17,A01,092677,Semenuks; Arturs,4,0,81,77
1657136824469,COGS 100,A01,083619,Allen; Michael Gordon,15,0,70,55
1657136830496,COGS 101A,A01,083621,Davis; Joshua Daniel,9,0,68,59
1657136836527,COGS 101B,A01,091572,Allen; Michael Gordon,9,0,65,56
1657136842552,COGS 101C,A01,083625,Delgado; Tania,17,0,35,18
1657136848583,COGS 107A,A01,083627,Boyle; Mary E. T.,13,0,60,47
1657136854611,COGS 118A,A01,083075,Gupta; Anjum,15,0,76,61
1657136860638,CSE 3,A50,083646,Miranda; Gregory Joseph,23,0,50,27
1657136866665,CSE 8A,A50,083650,Miranda; Gregory Joseph,17,1,56,39
1657136872686,CSE 11,A01,083080,Cao; Yingjun,5,15,40,35
1657136878712,CSE 12,A01,083652,Krause-Levy; Sophia Louisa,24,1,120,96
1657136884736,CSE 15L,A01,083654,Morris; Justin Loren,9,0,50,41
1657136884736,CSE 15L,A02,083655,Morris; Justin Loren,9,0,50,41
1657136890762,CSE 20,A01,083657,Tran; Khoa Dang,38,0,80,42
1657136896792,CSE 21,A01,095574,Bach; Quang Tran,21,0,48,27
1657136902816,CSE 30,A01,083084,Eldon; John,4,0,80,76
1657136902816,CSE 30,B01,095061,Bhaskar; Nishant,7,0,50,43
1657136908842,CSE 100,A01,083659,Cao; Yingjun,4,4,70,66
1657136914867,CSE 134B,A01,083661,Powell; Thomas Allan,20,0,100,80
1657136920890,CSE 140,A01,083663,Gungor; Onat,13,0,85,72
1657136926918,CSE 140L,A01,083088,Eldon; John,17,0,100,83
1657136932947,CSE 175,A01,083665,Kumar; Rakesh,3,0,25,22
1657136938977,CSE 190,A00,092507,Dubnov; Shlomo,7,0,20,13
1657136945001,ECE 45,A01,083139,Congero; Spencer William,5,0,75,70
1657136951029,ECE 65,A50,083695,Saad; Andrew S,12,0,30,18
1657136951029,ECE 65,A51,095125,Saad; Andrew S,25,0,26,1
1657136957057,ECE 109,A01,091882,Touri; Behrouz,17,0,70,53
1657136963085,ECE 180,A00,083140,Abi Samra; Nicholas Camill,1,0,30,29
1657136963085,ECE 180,B00,083141,Abi Samra; Nicholas Camill,0,0,30,30
1657136969114,MATH 10A,A01,083735,Patchell; Gregory David,2,0,30,28
1657136969114,MATH 10A,A02,083736,Patchell; Gregory David,20,0,30,10
1657136969114,MATH 10A,A03,083737,Patchell; Gregory David,16,0,30,14
1657136975150,MATH 10B,A01,083207,Lim; Seonhee,7,0,34,27
1657136975150,MATH 10B,A02,083208,Lim; Seonhee,9,0,35,26
1657136975150,MATH 10B,A03,093472,Lim; Seonhee,5,0,34,29
1657136975150,MATH 10B,B01,083739,Sinha; Shubham,9,0,30,21
1657136981182,MATH 18,A01,083743,Cinel; Cameron Alexander,6,0,30,24
1657136981182,MATH 18,A02,083744,Cinel; Cameron Alexander,15,0,30,15
1657136981182,MATH 18,A03,083745,Cinel; Cameron Alexander,8,0,30,22
1657136981182,MATH 18,B01,083748,Rideout; David Porter,4,0,37,33
1657136981182,MATH 18,B02,083749,Rideout; David Porter,3,0,36,33
1657136981182,MATH 18,B03,083750,Rideout; David Porter,2,0,37,35
1657136981182,MATH 18,B04,083751,Rideout; David Porter,5,0,36,31
1657136981182,MATH 18,B05,093473,Rideout; David Porter,4,0,36,32
1657136981182,MATH 18,B06,093474,Rideout; David Porter,5,0,36,31
1657136987208,MATH 20A,A01,083754,Zheng; Zequn,12,0,40,28
1657136993243,MATH 20B,A01,083756,Briones; Jor-el Thomas Caparas,1,0,36,35
1657136993243,MATH 20B,A02,083757,Briones; Jor-el Thomas Caparas,1,0,36,35
1657136993243,MATH 20B,A03,093475,Briones; Jor-el Thomas Caparas,0,0,36,36
1657136999268,MATH 20C,A01,083760,Briones; Jor-el Thomas Caparas,1,0,35,34
1657136999268,MATH 20C,A02,083761,Briones; Jor-el Thomas Caparas,8,0,35,27
1657136999268,MATH 20C,A03,093476,Briones; Jor-el Thomas Caparas,0,1,36,36
1657136999268,MATH 20C,B01,083762,Bach; Quang Tran,0,0,30,30
1657137005292,MATH 20D,A01,083765,Tran; Brian Kha,4,0,30,26
1657137005292,MATH 20D,A02,083766,Tran; Brian Kha,5,0,30,25
1657137005292,MATH 20D,A03,083767,Tran; Brian Kha,3,0,30,27
1657137011316,MATH 20E,A01,083771,Ganguly; Soumya,7,0,32,25
1657137011316,MATH 20E,A02,083772,Ganguly; Soumya,6,0,32,26
1657137011316,MATH 20E,B01,083773,Ciotti; Benjamin,18,0,35,17
1657137011316,MATH 20E,B02,083774,Ciotti; Benjamin,17,0,35,18
1657137017345,MATH 103A,A01,083777,Greenfeld; Be'Eri,2,0,36,34
1657137017345,MATH 103A,A02,083778,Greenfeld; Be'Eri,5,0,36,31
1657137017345,MATH 103A,A03,093561,Greenfeld; Be'Eri,4,0,36,32
1657137017345,MATH 103A,B01,083779,Greenfeld; Be'Eri,6,0,36,30
1657137017345,MATH 103A,B02,083780,Greenfeld; Be'Eri,3,0,36,33
1657137017345,MATH 103A,B03,093562,Greenfeld; Be'Eri,3,0,36,33
1657137023369,MATH 105,A01,085443,Carter; Anne Toulson,14,0,35,21
1657137023369,MATH 105,A02,093477,Carter; Anne Toulson,20,0,35,15
1657137029398,MATH 109,A01,083213,Ganzberger; Geoffrey Michael,2,0,34,32
1657137029398,MATH 109,A02,083214,Ganzberger; Geoffrey Michael,3,0,34,31
1657137029398,MATH 109,A03,093478,Ganzberger; Geoffrey Michael,1,0,34,33
1657137029398,MATH 109,B01,083215,Ganzberger; Geoffrey Michael,1,0,32,31
1657137029398,MATH 109,B02,083216,Ganzberger; Geoffrey Michael,1,0,32,31
1657137029398,MATH 109,B03,093479,Ganzberger; Geoffrey Michael,6,0,32,26
1657137035428,MATH 142A,A01,083219,Chow; Bennett,6,0,32,26
1657137035428,MATH 142A,A02,083220,Chow; Bennett,10,0,32,22
1657137035428,MATH 142A,A03,093480,Chow; Bennett,7,0,32,25
1657137035428,MATH 142A,B03,093481,Chow; Bennett,8,0,32,24
1657137035428,MATH 142A,B04,093558,Chow; Bennett,11,0,32,21
1657137035428,MATH 142A,B05,093559,Chow; Bennett,6,0,32,26
1657137041454,MATH 193A,A01,083224,Rotar; Vladimir,7,0,34,27
1657137041454,MATH 193A,A02,083225,Rotar; Vladimir,5,0,34,29
1657137041454,MATH 193A,A03,083781,Rotar; Vladimir,1,0,34,33
1657137041454,MATH 193A,A04,083782,Rotar; Vladimir,8,0,34,26
1657137041454,MATH 193A,A05,093482,Rotar; Vladimir,6,0,34,28
1657137047481,MATH 197,001,091859,McAuley; Julian John,9999,0,9999,0
1657137047481,MATH 197,002,095566,Kedlaya; Kiran S.,9997,0,9999,2
1657137047481,MATH 197,003,095567,Xiao; Ming,9999,0,9999,0
1657137047481,MATH 197,004,095571,Perols; Johan Lars,9998,0,9999,1
1657137054540,COGS 9,A01,083615,Shannon; Kyle Michael,7,0,75,68
1657137060566,COGS 11,A01,083617,Boyle; Mary E. T.,21,0,48,27
1657137066591,COGS 13,A01,083071,Bastos; Amalia Pinkusfeld,9,0,71,62
1657137072628,COGS 14A,A01,092681,Semenuks; Arturs,1,1,100,99
1657137078655,COGS 14B,A01,083073,Cheng; Tzu-Han,6,0,63,57
1657137084686,COGS 17,A01,092677,Semenuks; Arturs,4,0,81,77
1657137090709,COGS 100,A01,083619,Allen; Michael Gordon,15,0,70,55
1657137096742,COGS 101A,A01,083621,Davis; Joshua Daniel,9,0,68,59
1657137102769,COGS 101B,A01,091572,Allen; Michael Gordon,9,0,65,56
1657137108792,COGS 101C,A01,083625,Delgado; Tania,17,0,35,18
1657137114816,COGS 107A,A01,083627,Boyle; Mary E. T.,13,0,60,47
1657137120840,COGS 118A,A01,083075,Gupta; Anjum,15,0,76,61
1657137126866,CSE 3,A50,083646,Miranda; Gregory Joseph,23,0,50,27
1657137132897,CSE 8A,A50,083650,Miranda; Gregory Joseph,17,1,56,39
1657137138920,CSE 11,A01,083080,Cao; Yingjun,5,15,40,35
1657137144942,CSE 12,A01,083652,Krause-Levy; Sophia Louisa,24,1,120,96
1657137150965,CSE 15L,A01,083654,Morris; Justin Loren,9,0,50,41
1657137150965,CSE 15L,A02,083655,Morris; Justin Loren,9,0,50,41
1657137157006,CSE 20,A01,083657,Tran; Khoa Dang,38,0,80,42
1657137163029,CSE 21,A01,095574,Bach; Quang Tran,21,0,48,27
1657137169052,CSE 30,A01,083084,Eldon; John,4,0,80,76
1657137169052,CSE 30,B01,095061,Bhaskar; Nishant,7,0,50,43
1657137175081,CSE 100,A01,083659,Cao; Yingjun,4,4,70,66
1657137181109,CSE 134B,A01,083661,Powell; Thomas Allan,20,0,100,80
1657137187133,CSE 140,A01,083663,Gungor; Onat,13,0,85,72
1657137193158,CSE 140L,A01,083088,Eldon; John,17,0,100,83
1657137199182,CSE 175,A01,083665,Kumar; Rakesh,3,0,25,22
1657137205205,CSE 190,A00,092507,Dubnov; Shlomo,7,0,20,13
1657137211226,ECE 45,A01,083139,Congero; Spencer William,5,0,75,70
1657137217269,ECE 65,A50,083695,Saad; Andrew S,12,0,30,18
1657137217269,ECE 65,A51,095125,Saad; Andrew S,25,0,26,1
1657137223381,ECE 109,A01,091882,Touri; Behrouz,17,0,70,53
1657137229404,ECE 180,A00,083140,Abi Samra; Nicholas Camill,1,0,30,29
1657137229404,ECE 180,B00,083141,Abi Samra; Nicholas Camill,0,0,30,30
1657137235426,MATH 10A,A01,083735,Patchell; Gregory David,2,0,30,28
1657137235426,MATH 10A,A02,083736,Patchell; Gregory David,20,0,30,10
1657137235426,MATH 10A,A03,083737,Patchell; Gregory David,16,0,30,14
1657137241450,MATH 10B,A01,083207,Lim; Seonhee,7,0,34,27
1657137241450,MATH 10B,A02,083208,Lim; Seonhee,9,0,35,26
1657137241450,MATH 10B,A03,093472,Lim; Seonhee,5,0,34,29
1657137241450,MATH 10B,B01,083739,Sinha; Shubham,9,0,30,21
1657137247476,MATH 18,A01,083743,Cinel; Cameron Alexander,6,0,30,24
1657137247476,MATH 18,A02,083744,Cinel; Cameron Alexander,15,0,30,15
1657137247476,MATH 18,A03,083745,Cinel; Cameron Alexander,8,0,30,22
1657137247476,MATH 18,B01,083748,Rideout; David Porter,4,0,37,33
1657137247476,MATH 18,B02,083749,Rideout; David Porter,3,0,36,33
1657137247476,MATH 18,B03,083750,Rideout; David Porter,2,0,37,35
1657137247476,MATH 18,B04,083751,Rideout; David Porter,5,0,36,31
1657137247476,MATH 18,B05,093473,Rideout; David Porter,4,0,36,32
1657137247476,MATH 18,B06,093474,Rideout; David Porter,5,0,36,31
1657137253499,MATH 20A,A01,083754,Zheng; Zequn,12,0,40,28
1657137259522,MATH 20B,A01,083756,Briones; Jor-el Thomas Caparas,1,0,36,35
1657137259522,MATH 20B,A02,083757,Briones; Jor-el Thomas Caparas,1,0,36,35
1657137259522,MATH 20B,A03,093475,Briones; Jor-el Thomas Caparas,0,0,36,36
1657137265560,MATH 20C,A01,083760,Briones; Jor-el Thomas Caparas,1,0,35,34
1657137265560,MATH 20C,A02,083761,Briones; Jor-el Thomas Caparas,8,0,35,27
1657137265560,MATH 20C,A03,093476,Briones; Jor-el Thomas Caparas,0,1,36,36
1657137265560,MATH 20C,B01,083762,Bach; Quang Tran,0,0,30,30
1657137271582,MATH 20D,A01,083765,Tran; Brian Kha,4,0,30,26
1657137271582,MATH 20D,A02,083766,Tran; Brian Kha,5,0,30,25
1657137271582,MATH 20D,A03,083767,Tran; Brian Kha,3,0,30,27
1657137277611,MATH 20E,A01,083771,Ganguly; Soumya,7,0,32,25
1657137277611,MATH 20E,A02,083772,Ganguly; Soumya,6,0,32,26
1657137277611,MATH 20E,B01,083773,Ciotti; Benjamin,18,0,35,17
1657137277611,MATH 20E,B02,083774,Ciotti; Benjamin,17,0,35,18
1657137283633,MATH 103A,A01,083777,Greenfeld; Be'Eri,2,0,36,34
1657137283633,MATH 103A,A02,083778,Greenfeld; Be'Eri,5,0,36,31
1657137283633,MATH 103A,A03,093561,Greenfeld; Be'Eri,4,0,36,32
1657137283633,MATH 103A,B01,083779,Greenfeld; Be'Eri,6,0,36,30
1657137283633,MATH 103A,B02,083780,Greenfeld; Be'Eri,3,0,36,33
1657137283633,MATH 103A,B03,093562,Greenfeld; Be'Eri,3,0,36,33
1657137289655,MATH 105,A01,085443,Carter; Anne Toulson,14,0,35,21
1657137289655,MATH 105,A02,093477,Carter; Anne Toulson,20,0,35,15
1657137295679,MATH 109,A01,083213,Ganzberger; Geoffrey Michael,2,0,34,32
1657137295679,MATH 109,A02,083214,Ganzberger; Geoffrey Michael,3,0,34,31
1657137295679,MATH 109,A03,093478,Ganzberger; Geoffrey Michael,1,0,34,33
1657137295679,MATH 109,B01,083215,Ganzberger; Geoffrey Michael,1,0,32,31
1657137295679,MATH 109,B02,083216,Ganzberger; Geoffrey Michael,1,0,32,31
1657137295679,MATH 109,B03,093479,Ganzberger; Geoffrey Michael,6,0,32,26
1657137301709,MATH 142A,A01,083219,Chow; Bennett,6,0,32,26
1657137301709,MATH 142A,A02,083220,Chow; Bennett,10,0,32,22
1657137301709,MATH 142A,A03,093480,Chow; Bennett,7,0,32,25
1657137301709,MATH 142A,B03,093481,Chow; Bennett,8,0,32,24
1657137301709,MATH 142A,B04,093558,Chow; Bennett,11,0,32,21
1657137301709,MATH 142A,B05,093559,Chow; Bennett,6,0,32,26
1657137307740,MATH 193A,A01,083224,Rotar; Vladimir,7,0,34,27
1657137307740,MATH 193A,A02,083225,Rotar; Vladimir,5,0,34,29
1657137307740,MATH 193A,A03,083781,Rotar; Vladimir,1,0,34,33
1657137307740,MATH 193A,A04,083782,Rotar; Vladimir,8,0,34,26
1657137307740,MATH 193A,A05,093482,Rotar; Vladimir,6,0,34,28
1657137313767,MATH 197,001,091859,McAuley; Julian John,9999,0,9999,0
1657137313767,MATH 197,002,095566,Kedlaya; Kiran S.,9997,0,9999,2
1657137313767,MATH 197,003,095567,Xiao; Ming,9999,0,9999,0
1657137313767,MATH 197,004,095571,Perols; Johan Lars,9998,0,9999,1
1657137320832,COGS 9,A01,083615,Shannon; Kyle Michael,7,0,75,68
1657137326859,COGS 11,A01,083617,Boyle; Mary E. T.,21,0,48,27
1657137332893,COGS 13,A01,083071,Bastos; Amalia Pinkusfeld,9,0,71,62
1657137338921,COGS 14A,A01,092681,Semenuks; Arturs,1,1,100,99
1657137344949,COGS 14B,A01,083073,Cheng; Tzu-Han,6,0,63,57
1657137350971,COGS 17,A01,092677,Semenuks; Arturs,4,0,81,77
1657137356997,COGS 100,A01,083619,Allen; Michael Gordon,15,0,70,55
1657137363021,COGS 101A,A01,083621,Davis; Joshua Daniel,9,0,68,59
1657137369046,COGS 101B,A01,091572,Allen; Michael Gordon,9,0,65,56
1657137375073,COGS 101C,A01,083625,Delgado; Tania,17,0,35,18
1657137381108,COGS 107A,A01,083627,Boyle; Mary E. T.,13,0,60,47
1657137387134,COGS 118A,A01,083075,Gupta; Anjum,15,0,76,61
1657137393164,CSE 3,A50,083646,Miranda; Gregory Joseph,23,0,50,27
1657137399187,CSE 8A,A50,083650,Miranda; Gregory Joseph,17,1,56,39
1657137405214,CSE 11,A01,083080,Cao; Yingjun,5,15,40,35
1657137411246,CSE 12,A01,083652,Krause-Levy; Sophia Louisa,24,1,120,96
1657137417275,CSE 15L,A01,083654,Morris; Justin Loren,9,0,50,41
1657137417275,CSE 15L,A02,083655,Morris; Justin Loren,9,0,50,41
1657137423298,CSE 20,A01,083657,Tran; Khoa Dang,38,0,80,42
1657137429334,CSE 21,A01,095574,Bach; Quang Tran,21,0,48,27
1657137435362,CSE 30,A01,083084,Eldon; John,4,0,80,76
1657137435362,CSE 30,B01,095061,Bhaskar; Nishant,7,0,50,43
1657137441387,CSE 100,A01,083659,Cao; Yingjun,4,4,70,66
1657137447414,CSE 134B,A01,083661,Powell; Thomas Allan,20,0,100,80
1657137453454,CSE 140,A01,083663,Gungor; Onat,13,0,85,72
1657137459489,CSE 140L,A01,083088,Eldon; John,17,0,100,83
1657137465512,CSE 175,A01,083665,Kumar; Rakesh,3,0,25,22
1657137471535,CSE 190,A00,092507,Dubnov; Shlomo,7,0,20,13
1657137477561,ECE 45,A01,083139,Congero; Spencer William,5,0,75,70
1657137483593,ECE 65,A50,083695,Saad; Andrew S,12,0,30,18
1657137483593,ECE 65,A51,095125,Saad; Andrew S,25,0,26,1
1657137489617,ECE 109,A01,091882,Touri; Behrouz,17,0,70,53
1657137495641,ECE 180,A00,083140,Abi Samra; Nicholas Camill,1,0,30,29
1657137495641,ECE 180,B00,083141,Abi Samra; Nicholas Camill,0,0,30,30
1657137501668,MATH 10A,A01,083735,Patchell; Gregory David,2,0,30,28
1657137501668,MATH 10A,A02,083736,Patchell; Gregory David,20,0,30,10
1657137501668,MATH 10A,A03,083737,Patchell; Gregory David,16,0,30,14
1657137507707,MATH 10B,A01,083207,Lim; Seonhee,7,0,34,27
1657137507707,MATH 10B,A02,083208,Lim; Seonhee,9,0,35,26
1657137507707,MATH 10B,A03,093472,Lim; Seonhee,5,0,34,29
1657137507707,MATH 10B,B01,083739,Sinha; Shubham,9,0,30,21
1657137513732,MATH 18,A01,083743,Cinel; Cameron Alexander,6,0,30,24
1657137513732,MATH 18,A02,083744,Cinel; Cameron Alexander,15,0,30,15
1657137513732,MATH 18,A03,083745,Cinel; Cameron Alexander,8,0,30,22
1657137513732,MATH 18,B01,083748,Rideout; David Porter,4,0,37,33
1657137513732,MATH 18,B02,083749,Rideout; David Porter,3,0,36,33
1657137513732,MATH 18,B03,083750,Rideout; David Porter,2,0,37,35
1657137513732,MATH 18,B04,083751,Rideout; David Porter,5,0,36,31
1657137513732,MATH 18,B05,093473,Rideout; David Porter,4,0,36,32
1657137513732,MATH 18,B06,093474,Rideout; David Porter,5,0,36,31
1657137519755,MATH 20A,A01,083754,Zheng; Zequn,12,0,40,28
1657137525804,MATH 20B,A01,083756,Briones; Jor-el Thomas Caparas,1,0,36,35
1657137525804,MATH 20B,A02,083757,Briones; Jor-el Thomas Caparas,1,0,36,35
1657137525804,MATH 20B,A03,093475,Briones; Jor-el Thomas Caparas,0,0,36,36
1657137531829,MATH 20C,A01,083760,Briones; Jor-el Thomas Caparas,1,0,35,34
1657137531829,MATH 20C,A02,083761,Briones; Jor-el Thomas Caparas,8,0,35,27
1657137531829,MATH 20C,A03,093476,Briones; Jor-el Thomas Caparas,0,1,36,36
1657137531829,MATH 20C,B01,083762,Bach; Quang Tran,0,0,30,30
1657137537857,MATH 20D,A01,083765,Tran; Brian Kha,4,0,30,26
1657137537857,MATH 20D,A02,083766,Tran; Brian Kha,5,0,30,25
1657137537857,MATH 20D,A03,083767,Tran; Brian Kha,3,0,30,27
1657137543889,MATH 20E,A01,083771,Ganguly; Soumya,7,0,32,25
1657137543889,MATH 20E,A02,083772,Ganguly; Soumya,6,0,32,26
1657137543889,MATH 20E,B01,083773,Ciotti; Benjamin,18,0,35,17
1657137543889,MATH 20E,B02,083774,Ciotti; Benjamin,17,0,35,18
1657137549917,MATH 103A,A01,083777,Greenfeld; Be'Eri,2,0,36,34
1657137549917,MATH 103A,A02,083778,Greenfeld; Be'Eri,5,0,36,31
1657137549917,MATH 103A,A03,093561,Greenfeld; Be'Eri,4,0,36,32
1657137549917,MATH 103A,B01,083779,Greenfeld; Be'Eri,6,0,36,30
1657137549917,MATH 103A,B02,083780,Greenfeld; Be'Eri,3,0,36,33
1657137549917,MATH 103A,B03,093562,Greenfeld; Be'Eri,3,0,36,33
1657137555941,MATH 105,A01,085443,Carter; Anne Toulson,14,0,35,21
1657137555941,MATH 105,A02,093477,Carter; Anne Toulson,20,0,35,15
1657137561969,MATH 109,A01,083213,Ganzberger; Geoffrey Michael,2,0,34,32
1657137561969,MATH 109,A02,083214,Ganzberger; Geoffrey Michael,3,0,34,31
1657137561969,MATH 109,A03,093478,Ganzberger; Geoffrey Michael,1,0,34,33
1657137561969,MATH 109,B01,083215,Ganzberger; Geoffrey Michael,1,0,32,31
1657137561969,MATH 109,B02,083216,Ganzberger; Geoffrey Michael,1,0,32,31
1657137561969,MATH 109,B03,093479,Ganzberger; Geoffrey Michael,6,0,32,26
1657137567993,MATH 142A,A01,083219,Chow; Bennett,6,0,32,26
1657137567993,MATH 142A,A02,083220,Chow; Bennett,10,0,32,22
1657137567993,MATH 142A,A03,093480,Chow; Bennett,7,0,32,25
1657137567993,MATH 142A,B03,093481,Chow; Bennett,8,0,32,24
1657137567993,MATH 142A,B04,093558,Chow; Bennett,11,0,32,21
1657137567993,MATH 142A,B05,093559,Chow; Bennett,6,0,32,26
1657137574023,MATH 193A,A01,083224,Rotar; Vladimir,7,0,34,27
1657137574023,MATH 193A,A02,083225,Rotar; Vladimir,5,0,34,29
1657137574023,MATH 193A,A03,083781,Rotar; Vladimir,1,0,34,33
1657137574023,MATH 193A,A04,083782,Rotar; Vladimir,8,0,34,26
1657137574023,MATH 193A,A05,093482,Rotar; Vladimir,6,0,34,28
1657137580047,MATH 197,001,091859,McAuley; Julian John,9999,0,9999,0
1657137580047,MATH 197,002,095566,Kedlaya; Kiran S.,9997,0,9999,2
1657137580047,MATH 197,003,095567,Xiao; Ming,9999,0,9999,0
1657137580047,MATH 197,004,095571,Perols; Johan Lars,9998,0,9999,1
1657137587113,COGS 9,A01,083615,Shannon; Kyle Michael,7,0,75,68
1657137593137,COGS 11,A01,083617,Boyle; Mary E. T.,21,0,48,27
1657137599167,COGS 13,A01,083071,Bastos; Amalia Pinkusfeld,9,0,71,62
1657137605195,COGS 14A,A01,092681,Semenuks; Arturs,1,1,100,99
1657137611219,COGS 14B,A01,083073,Cheng; Tzu-Han,6,0,63,57
1657137617241,COGS 17,A01,092677,Semenuks; Arturs,4,0,81,77
1657137623266,COGS 100,A01,083619,Allen; Michael Gordon,15,0,70,55
1657137629303,COGS 101A,A01,083621,Davis; Joshua Daniel,9,0,68,59
1657137635327,COGS 101B,A01,091572,Allen; Michael Gordon,9,0,65,56
1657137641351,COGS 101C,A01,083625,Delgado; Tania,17,0,35,18
1657137647379,COGS 107A,A01,083627,Boyle; Mary E. T.,13,0,60,47
1657137653401,COGS 118A,A01,083075,Gupta; Anjum,15,0,76,61
1657137659431,CSE 3,A50,083646,Miranda; Gregory Joseph,23,0,50,27
1657137665459,CSE 8A,A50,083650,Miranda; Gregory Joseph,17,1,56,39
1657137671485,CSE 11,A01,083080,Cao; Yingjun,5,15,40,35
1657137677511,CSE 12,A01,083652,Krause-Levy; Sophia Louisa,24,1,120,96
1657137683533,CSE 15L,A01,083654,Morris; Justin Loren,9,0,50,41
1657137683533,CSE 15L,A02,083655,Morris; Justin Loren,9,0,50,41
1657137689555,CSE 20,A01,083657,Tran; Khoa Dang,38,0,80,42
1657137695580,CSE 21,A01,095574,Bach; Quang Tran,21,0,48,27
1657137701613,CSE 30,A01,083084,Eldon; John,4,0,80,76
1657137701613,CSE 30,B01,095061,Bhaskar; Nishant,7,0,50,43
1657137707636,CSE 100,A01,083659,Cao; Yingjun,4,4,70,66
1657137713659,CSE 134B,A01,083661,Powell; Thomas Allan,20,0,100,80
1657137719694,CSE 140,A01,083663,Gungor; Onat,13,0,85,72
1657137725716,CSE 140L,A01,083088,Eldon; John,17,0,100,83
1657137731738,CSE 175,A01,083665,Kumar; Rakesh,3,0,25,22
1657137737767,CSE 190,A00,092507,Dubnov; Shlomo,7,0,20,13
1657137743791,ECE 45,A01,083139,Congero; Spencer William,5,0,75,70
1657137749815,ECE 65,A50,083695,Saad; Andrew S,12,0,30,18
1657137749815,ECE 65,A51,095125,Saad; Andrew S,25,0,26,1
1657137755842,ECE 109,A01,091882,Touri; Behrouz,17,0,70,53
1657137761864,ECE 180,A00,083140,Abi Samra; Nicholas Camill,1,0,30,29
1657137761864,ECE 180,B00,083141,Abi Samra; Nicholas Camill,0,0,30,30
1657137767888,MATH 10A,A01,083735,Patchell; Gregory David,2,0,30,28
1657137767888,MATH 10A,A02,083736,Patchell; Gregory David,20,0,30,10
1657137767888,MATH 10A,A03,083737,Patchell; Gregory David,16,0,30,14
1657137773919,MATH 10B,A01,083207,Lim; Seonhee,7,0,34,27
1657137773919,MATH 10B,A02,083208,Lim; Seonhee,9,0,35,26
1657137773919,MATH 10B,A03,093472,Lim; Seonhee,5,0,34,29
1657137773919,MATH 10B,B01,083739,Sinha; Shubham,9,0,30,21
1657137779945,MATH 18,A01,083743,Cinel; Cameron Alexander,6,0,30,24
1657137779945,MATH 18,A02,083744,Cinel; Cameron Alexander,15,0,30,15
1657137779945,MATH 18,A03,083745,Cinel; Cameron Alexander,8,0,30,22
1657137779945,MATH 18,B01,083748,Rideout; David Porter,4,0,37,33
1657137779945,MATH 18,B02,083749,Rideout; David Porter,3,0,36,33
1657137779945,MATH 18,B03,083750,Rideout; David Porter,2,0,37,35
1657137779945,MATH 18,B04,083751,Rideout; David Porter,5,0,36,31
1657137779945,MATH 18,B05,093473,Rideout; David Porter,4,0,36,32
1657137779945,MATH 18,B06,093474,Rideout; David Porter,5,0,36,31
1657137785967,MATH 20A,A01,083754,Zheng; Zequn,12,0,40,28
1657137792003,MATH 20B,A01,083756,Briones; Jor-el Thomas Caparas,1,0,36,35
1657137792003,MATH 20B,A02,083757,Briones; Jor-el Thomas Caparas,1,0,36,35
1657137792003,MATH 20B,A03,093475,Briones; Jor-el Thomas Caparas,0,0,36,36
1657137798032,MATH 20C,A01,083760,Briones; Jor-el Thomas Caparas,1,0,35,34
1657137798032,MATH 20C,A02,083761,Briones; Jor-el Thomas Caparas,8,0,35,27
1657137798032,MATH 20C,A03,093476,Briones; Jor-el Thomas Caparas,0,1,36,36
1657137798032,MATH 20C,B01,083762,Bach; Quang Tran,0,0,30,30
1657137804057,MATH 20D,A01,083765,Tran; Brian Kha,4,0,30,26
1657137804057,MATH 20D,A02,083766,Tran; Brian Kha,5,0,30,25
1657137804057,MATH 20D,A03,083767,Tran; Brian Kha,3,0,30,27
1657137810086,MATH 20E,A01,083771,Ganguly; Soumya,7,0,32,25
1657137810086,MATH 20E,A02,083772,Ganguly; Soumya,6,0,32,26
1657137810086,MATH 20E,B01,083773,Ciotti; Benjamin,18,0,35,17
1657137810086,MATH 20E,B02,083774,Ciotti; Benjamin,17,0,35,18
1657137816116,MATH 103A,A01,083777,Greenfeld; Be'Eri,2,0,36,34
1657137816116,MATH 103A,A02,083778,Greenfeld; Be'Eri,5,0,36,31
1657137816116,MATH 103A,A03,093561,Greenfeld; Be'Eri,4,0,36,32
1657137816116,MATH 103A,B01,083779,Greenfeld; Be'Eri,6,0,36,30
1657137816116,MATH 103A,B02,083780,Greenfeld; Be'Eri,3,0,36,33
1657137816116,MATH 103A,B03,093562,Greenfeld; Be'Eri,3,0,36,33
1657137822216,MATH 105,A01,085443,Carter; Anne Toulson,14,0,35,21
1657137822216,MATH 105,A02,093477,Carter; Anne Toulson,20,0,35,15
1657137828251,MATH 109,A01,083213,Ganzberger; Geoffrey Michael,2,0,34,32
1657137828251,MATH 109,A02,083214,Ganzberger; Geoffrey Michael,3,0,34,31
1657137828251,MATH 109,A03,093478,Ganzberger; Geoffrey Michael,1,0,34,33
1657137828251,MATH 109,B01,083215,Ganzberger; Geoffrey Michael,1,0,32,31
1657137828251,MATH 109,B02,083216,Ganzberger; Geoffrey Michael,1,0,32,31
1657137828251,MATH 109,B03,093479,Ganzberger; Geoffrey Michael,6,0,32,26
1657137834276,MATH 142A,A01,083219,Chow; Bennett,6,0,32,26
1657137834276,MATH 142A,A02,083220,Chow; Bennett,10,0,32,22
1657137834276,MATH 142A,A03,093480,Chow; Bennett,7,0,32,25
1657137834276,MATH 142A,B03,093481,Chow; Bennett,8,0,32,24
1657137834276,MATH 142A,B04,093558,Chow; Bennett,11,0,32,21
1657137834276,MATH 142A,B05,093559,Chow; Bennett,6,0,32,26
1657137840302,MATH 193A,A01,083224,Rotar; Vladimir,7,0,34,27
1657137840302,MATH 193A,A02,083225,Rotar; Vladimir,5,0,34,29
1657137840302,MATH 193A,A03,083781,Rotar; Vladimir,1,0,34,33
1657137840302,MATH 193A,A04,083782,Rotar; Vladimir,8,0,34,26
1657137840302,MATH 193A,A05,093482,Rotar; Vladimir,6,0,34,28
1657137846328,MATH 197,001,091859,McAuley; Julian John,9999,0,9999,0
1657137846328,MATH 197,002,095566,Kedlaya; Kiran S.,9997,0,9999,2
1657137846328,MATH 197,003,095567,Xiao; Ming,9999,0,9999,0
1657137846328,MATH 197,004,095571,Perols; Johan Lars,9998,0,9999,1
1657137853405,COGS 9,A01,083615,Shannon; Kyle Michael,7,0,75,68
1657137859439,COGS 11,A01,083617,Boyle; Mary E. T.,21,0,48,27
1657137865462,COGS 13,A01,083071,Bastos; Amalia Pinkusfeld,9,0,71,62
1657137871488,COGS 14A,A01,092681,Semenuks; Arturs,1,1,100,99
1657137877515,COGS 14B,A01,083073,Cheng; Tzu-Han,6,0,63,57
1657137883538,COGS 17,A01,092677,Semenuks; Arturs,4,0,81,77
1657137889560,COGS 100,A01,083619,Allen; Michael Gordon,15,0,70,55
1657137895584,COGS 101A,A01,083621,Davis; Joshua Daniel,9,0,68,59
1657137901605,COGS 101B,A01,091572,Allen; Michael Gordon,9,0,65,56
1657137907631,COGS 101C,A01,083625,Delgado; Tania,17,0,35,18
1657137913659,COGS 107A,A01,083627,Boyle; Mary E. T.,13,0,60,47
1657137919684,COGS 118A,A01,083075,Gupta; Anjum,15,0,76,61
1657137925711,CSE 3,A50,083646,Miranda; Gregory Joseph,23,0,50,27
1657137931736,CSE 8A,A50,083650,Miranda; Gregory Joseph,17,1,56,39
1657137937757,CSE 11,A01,083080,Cao; Yingjun,5,15,40,35
1657137943784,CSE 12,A01,083652,Krause-Levy; Sophia Louisa,24,1,120,96
1657137949809,CSE 15L,A01,083654,Morris; Justin Loren,9,0,50,41
1657137949809,CSE 15L,A02,083655,Morris; Justin Loren,9,0,50,41
1657137955836,CSE 20,A01,083657,Tran; Khoa Dang,38,0,80,42
1657137961865,CSE 21,A01,095574,Bach; Quang Tran,21,0,48,27
1657137967897,CSE 30,A01,083084,Eldon; John,4,0,80,76
1657137967897,CSE 30,B01,095061,Bhaskar; Nishant,7,0,50,43
1657137973922,CSE 100,A01,083659,Cao; Yingjun,4,4,70,66
1657137979948,CSE 134B,A01,083661,Powell; Thomas Allan,20,0,100,80
1657137985970,CSE 140,A01,083663,Gungor; Onat,13,0,85,72
1657137991994,CSE 140L,A01,083088,Eldon; John,17,0,100,83
1657137998019,CSE 175,A01,083665,Kumar; Rakesh,3,0,25,22
1657138004043,CSE 190,A00,092507,Dubnov; Shlomo,7,0,20,13
1657138010077,ECE 45,A01,083139,Congero; Spencer William,5,0,75,70
1657138016105,ECE 65,A50,083695,Saad; Andrew S,12,0,30,18
1657138016105,ECE 65,A51,095125,Saad; Andrew S,25,0,26,1
1657138022133,ECE 109,A01,091882,Touri; Behrouz,17,0,70,53
1657138028164,ECE 180,A00,083140,Abi Samra; Nicholas Camill,1,0,30,29
1657138028164,ECE 180,B00,083141,Abi Samra; Nicholas Camill,0,0,30,30
1657138034188,MATH 10A,A01,083735,Patchell; Gregory David,2,0,30,28
1657138034188,MATH 10A,A02,083736,Patchell; Gregory David,20,0,30,10
1657138034188,MATH 10A,A03,083737,Patchell; Gregory David,16,0,30,14
1657138040213,MATH 10B,A01,083207,Lim; Seonhee,7,0,34,27
1657138040213,MATH 10B,A02,083208,Lim; Seonhee,9,0,35,26
1657138040213,MATH 10B,A03,093472,Lim; Seonhee,5,0,34,29
1657138040213,MATH 10B,B01,083739,Sinha; Shubham,9,0,30,21
1657138046246,MATH 18,A01,083743,Cinel; Cameron Alexander,6,0,30,24
1657138046246,MATH 18,A02,083744,Cinel; Cameron Alexander,15,0,30,15
1657138046246,MATH 18,A03,083745,Cinel; Cameron Alexander,8,0,30,22
1657138046246,MATH 18,B01,083748,Rideout; David Porter,4,0,37,33
1657138046246,MATH 18,B02,083749,Rideout; David Porter,3,0,36,33
1657138046246,MATH 18,B03,083750,Rideout; David Porter,2,0,37,35
1657138046246,MATH 18,B04,083751,Rideout; David Porter,5,0,36,31
1657138046246,MATH 18,B05,093473,Rideout; David Porter,4,0,36,32
1657138046246,MATH 18,B06,093474,Rideout; David Porter,5,0,36,31
1657138052270,MATH 20A,A01,083754,Zheng; Zequn,12,0,40,28
1657138058294,MATH 20B,A01,083756,Briones; Jor-el Thomas Caparas,1,0,36,35
1657138058294,MATH 20B,A02,083757,Briones; Jor-el Thomas Caparas,1,0,36,35
1657138058294,MATH 20B,A03,093475,Briones; Jor-el Thomas Caparas,0,0,36,36
1657138064323,MATH 20C,A01,083760,Briones; Jor-el Thomas Caparas,1,0,35,34
1657138064323,MATH 20C,A02,083761,Briones; Jor-el Thomas Caparas,8,0,35,27
1657138064323,MATH 20C,A03,093476,Briones; Jor-el Thomas Caparas,0,1,36,36
1657138064323,MATH 20C,B01,083762,Bach; Quang Tran,0,0,30,30
1657138070348,MATH 20D,A01,083765,Tran; Brian Kha,4,0,30,26
1657138070348,MATH 20D,A02,083766,Tran; Brian Kha,5,0,30,25
1657138070348,MATH 20D,A03,083767,Tran; Brian Kha,3,0,30,27
1657138076379,MATH 20E,A01,083771,Ganguly; Soumya,7,0,32,25
1657138076379,MATH 20E,A02,083772,Ganguly; Soumya,6,0,32,26
1657138076379,MATH 20E,B01,083773,Ciotti; Benjamin,18,0,35,17
1657138076379,MATH 20E,B02,083774,Ciotti; Benjamin,17,0,35,18
1657138082403,MATH 103A,A01,083777,Greenfeld; Be'Eri,2,0,36,34
1657138082403,MATH 103A,A02,083778,Greenfeld; Be'Eri,5,0,36,31
1657138082403,MATH 103A,A03,093561,Greenfeld; Be'Eri,4,0,36,32
1657138082403,MATH 103A,B01,083779,Greenfeld; Be'Eri,6,0,36,30
1657138082403,MATH 103A,B02,083780,Greenfeld; Be'Eri,3,0,36,33
1657138082403,MATH 103A,B03,093562,Greenfeld; Be'Eri,3,0,36,33
1657138088432,MATH 105,A01,085443,Carter; Anne Toulson,14,0,35,21
1657138088432,MATH 105,A02,093477,Carter; Anne Toulson,20,0,35,15
1657138094455,MATH 109,A01,083213,Ganzberger; Geoffrey Michael,2,0,34,32
1657138094455,MATH 109,A02,083214,Ganzberger; Geoffrey Michael,3,0,34,31
1657138094455,MATH 109,A03,093478,Ganzberger; Geoffrey Michael,1,0,34,33
1657138094455,MATH 109,B01,083215,Ganzberger; Geoffrey Michael,1,0,32,31
1657138094455,MATH 109,B02,083216,Ganzberger; Geoffrey Michael,1,0,32,31
1657138094455,MATH 109,B03,093479,Ganzberger; Geoffrey Michael,6,0,32,26
1657138100481,MATH 142A,A01,083219,Chow; Bennett,6,0,32,26
1657138100481,MATH 142A,A02,083220,Chow; Bennett,10,0,32,22
1657138100481,MATH 142A,A03,093480,Chow; Bennett,7,0,32,25
1657138100481,MATH 142A,B03,093481,Chow; Bennett,8,0,32,24
1657138100481,MATH 142A,B04,093558,Chow; Bennett,11,0,32,21
1657138100481,MATH 142A,B05,093559,Chow; Bennett,6,0,32,26
1657138106510,MATH 193A,A01,083224,Rotar; Vladimir,7,0,34,27
1657138106510,MATH 193A,A02,083225,Rotar; Vladimir,5,0,34,29
1657138106510,MATH 193A,A03,083781,Rotar; Vladimir,1,0,34,33
1657138106510,MATH 193A,A04,083782,Rotar; Vladimir,8,0,34,26
1657138106510,MATH 193A,A05,093482,Rotar; Vladimir,6,0,34,28
1657138112538,MATH 197,001,091859,McAuley; Julian John,9999,0,9999,0
1657138112538,MATH 197,002,095566,Kedlaya; Kiran S.,9997,0,9999,2
1657138112538,MATH 197,003,095567,Xiao; Ming,9999,0,9999,0
1657138112538,MATH 197,004,095571,Perols; Johan Lars,9998,0,9999,1
1657138119593,COGS 9,A01,083615,Shannon; Kyle Michael,7,0,75,68
1657138125615,COGS 11,A01,083617,Boyle; Mary E. T.,21,0,48,27
1657138131646,COGS 13,A01,083071,Bastos; Amalia Pinkusfeld,9,0,71,62
1657138137674,COGS 14A,A01,092681,Semenuks; Arturs,1,1,100,99
1657138143698,COGS 14B,A01,083073,Cheng; Tzu-Han,6,0,63,57
1657138149725,COGS 17,A01,092677,Semenuks; Arturs,4,0,81,77
1657138155760,COGS 100,A01,083619,Allen; Michael Gordon,15,0,70,55
1657138161789,COGS 101A,A01,083621,Davis; Joshua Daniel,9,0,68,59
1657138167811,COGS 101B,A01,091572,Allen; Michael Gordon,9,0,65,56
1657138173840,COGS 101C,A01,083625,Delgado; Tania,17,0,35,18
1657138179863,COGS 107A,A01,083627,Boyle; Mary E. T.,13,0,60,47
1657138185890,COGS 118A,A01,083075,Gupta; Anjum,15,0,76,61
1657138191918,CSE 3,A50,083646,Miranda; Gregory Joseph,23,0,50,27
1657138197941,CSE 8A,A50,083650,Miranda; Gregory Joseph,17,1,56,39
1657138203969,CSE 11,A01,083080,Cao; Yingjun,5,15,40,35
1657138209990,CSE 12,A01,083652,Krause-Levy; Sophia Louisa,24,1,120,96
1657138216019,CSE 15L,A01,083654,Morris; Justin Loren,9,0,50,41
1657138216019,CSE 15L,A02,083655,Morris; Justin Loren,9,0,50,41
1657138222051,CSE 20,A01,083657,Tran; Khoa Dang,38,0,80,42
1657138228086,CSE 21,A01,095574,Bach; Quang Tran,21,0,48,27
1657138234110,CSE 30,A01,083084,Eldon; John,4,0,80,76
1657138234110,CSE 30,B01,095061,Bhaskar; Nishant,7,0,50,43
1657138240134,CSE 100,A01,083659,Cao; Yingjun,4,4,70,66
1657138246157,CSE 134B,A01,083661,Powell; Thomas Allan,20,0,100,80
1657138252179,CSE 140,A01,083663,Gungor; Onat,13,0,85,72
1657138258210,CSE 140L,A01,083088,Eldon; John,17,0,100,83
1657138264232,CSE 175,A01,083665,Kumar; Rakesh,3,0,25,22
1657138270257,CSE 190,A00,092507,Dubnov; Shlomo,7,0,20,13
1657138276280,ECE 45,A01,083139,Congero; Spencer William,5,0,75,70
1657138282307,ECE 65,A50,083695,Saad; Andrew S,12,0,30,18
1657138282307,ECE 65,A51,095125,Saad; Andrew S,25,0,26,1
1657138288335,ECE 109,A01,091882,Touri; Behrouz,17,0,70,53
1657138294362,ECE 180,A00,083140,Abi Samra; Nicholas Camill,1,0,30,29
1657138294362,ECE 180,B00,083141,Abi Samra; Nicholas Camill,0,0,30,30
1657138300386,MATH 10A,A01,083735,Patchell; Gregory David,2,0,30,28
1657138300386,MATH 10A,A02,083736,Patchell; Gregory David,20,0,30,10
1657138300386,MATH 10A,A03,083737,Patchell; Gregory David,16,0,30,14
1657138306420,MATH 10B,A01,083207,Lim; Seonhee,7,0,34,27
1657138306420,MATH 10B,A02,083208,Lim; Seonhee,9,0,35,26
1657138306420,MATH 10B,A03,093472,Lim; Seonhee,5,0,34,29
1657138306420,MATH 10B,B01,083739,Sinha; Shubham,9,0,30,21
1657138312447,MATH 18,A01,083743,Cinel; Cameron Alexander,6,0,30,24
1657138312447,MATH 18,A02,083744,Cinel; Cameron Alexander,15,0,30,15
1657138312447,MATH 18,A03,083745,Cinel; Cameron Alexander,8,0,30,22
1657138312447,MATH 18,B01,083748,Rideout; David Porter,4,0,37,33
1657138312447,MATH 18,B02,083749,Rideout; David Porter,3,0,36,33
1657138312447,MATH 18,B03,083750,Rideout; David Porter,2,0,37,35
1657138312447,MATH 18,B04,083751,Rideout; David Porter,5,0,36,31
1657138312447,MATH 18,B05,093473,Rideout; David Porter,4,0,36,32
1657138312447,MATH 18,B06,093474,Rideout; David Porter,5,0,36,31
1657138318473,MATH 20A,A01,083754,Zheng; Zequn,12,0,40,28
1657138324496,MATH 20B,A01,083756,Briones; Jor-el Thomas Caparas,1,0,36,35
1657138324496,MATH 20B,A02,083757,Briones; Jor-el Thomas Caparas,1,0,36,35
1657138324496,MATH 20B,A03,093475,Briones; Jor-el Thomas Caparas,0,0,36,36
1657138330520,MATH 20C,A01,083760,Briones; Jor-el Thomas Caparas,1,0,35,34
1657138330520,MATH 20C,A02,083761,Briones; Jor-el Thomas Caparas,8,0,35,27
1657138330520,MATH 20C,A03,093476,Briones; Jor-el Thomas Caparas,0,1,36,36
1657138330520,MATH 20C,B01,083762,Bach; Quang Tran,0,0,30,30
1657138336549,MATH 20D,A01,083765,Tran; Brian Kha,4,0,30,26
1657138336549,MATH 20D,A02,083766,Tran; Brian Kha,5,0,30,25
1657138336549,MATH 20D,A03,083767,Tran; Brian Kha,3,0,30,27
1657138342573,MATH 20E,A01,083771,Ganguly; Soumya,7,0,32,25
1657138342573,MATH 20E,A02,083772,Ganguly; Soumya,6,0,32,26
1657138342573,MATH 20E,B01,083773,Ciotti; Benjamin,18,0,35,17
1657138342573,MATH 20E,B02,083774,Ciotti; Benjamin,17,0,35,18
1657138348606,MATH 103A,A01,083777,Greenfeld; Be'Eri,2,0,36,34
1657138348606,MATH 103A,A02,083778,Greenfeld; Be'Eri,5,0,36,31
1657138348606,MATH 103A,A03,093561,Greenfeld; Be'Eri,4,0,36,32
1657138348606,MATH 103A,B01,083779,Greenfeld; Be'Eri,6,0,36,30
1657138348606,MATH 103A,B02,083780,Greenfeld; Be'Eri,3,0,36,33
1657138348606,MATH 103A,B03,093562,Greenfeld; Be'Eri,3,0,36,33
1657138354632,MATH 105,A01,085443,Carter; Anne Toulson,14,0,35,21
1657138354632,MATH 105,A02,093477,Carter; Anne Toulson,20,0,35,15
1657138360671,MATH 109,A01,083213,Ganzberger; Geoffrey Michael,2,0,34,32
1657138360671,MATH 109,A02,083214,Ganzberger; Geoffrey Michael,3,0,34,31
1657138360671,MATH 109,A03,093478,Ganzberger; Geoffrey Michael,1,0,34,33
1657138360671,MATH 109,B01,083215,Ganzberger; Geoffrey Michael,1,0,32,31
1657138360671,MATH 109,B02,083216,Ganzberger; Geoffrey Michael,1,0,32,31
1657138360671,MATH 109,B03,093479,Ganzberger; Geoffrey Michael,6,0,32,26
1657138366696,MATH 142A,A01,083219,Chow; Bennett,6,0,32,26
1657138366696,MATH 142A,A02,083220,Chow; Bennett,10,0,32,22
1657138366696,MATH 142A,A03,093480,Chow; Bennett,7,0,32,25
1657138366696,MATH 142A,B03,093481,Chow; Bennett,8,0,32,24
1657138366696,MATH 142A,B04,093558,Chow; Bennett,11,0,32,21
1657138366696,MATH 142A,B05,093559,Chow; Bennett,6,0,32,26
1657138372719,MATH 193A,A01,083224,Rotar; Vladimir,7,0,34,27
1657138372719,MATH 193A,A02,083225,Rotar; Vladimir,5,0,34,29
1657138372719,MATH 193A,A03,083781,Rotar; Vladimir,1,0,34,33
1657138372719,MATH 193A,A04,083782,Rotar; Vladimir,8,0,34,26
1657138372719,MATH 193A,A05,093482,Rotar; Vladimir,6,0,34,28
1657138378741,MATH 197,001,091859,McAuley; Julian John,9999,0,9999,0
1657138378741,MATH 197,002,095566,Kedlaya; Kiran S.,9997,0,9999,2
1657138378741,MATH 197,003,095567,Xiao; Ming,9999,0,9999,0
1657138378741,MATH 197,004,095571,Perols; Johan Lars,9998,0,9999,1
1657138385800,COGS 9,A01,083615,Shannon; Kyle Michael,7,0,75,68
1657138391826,COGS 11,A01,083617,Boyle; Mary E. T.,21,0,48,27
1657138397849,COGS 13,A01,083071,Bastos; Amalia Pinkusfeld,9,0,71,62
1657138403873,COGS 14A,A01,092681,Semenuks; Arturs,1,1,100,99
1657138409896,COGS 14B,A01,083073,Cheng; Tzu-Han,6,0,63,57
1657138416028,COGS 17,A01,092677,Semenuks; Arturs,4,0,81,77
1657138422055,COGS 100,A01,083619,Allen; Michael Gordon,15,0,70,55
1657138428081,COGS 101A,A01,083621,Davis; Joshua Daniel,9,0,68,59
1657138434107,COGS 101B,A01,091572,Allen; Michael Gordon,9,0,65,56
1657138440130,COGS 101C,A01,083625,Delgado; Tania,17,0,35,18
1657138446154,COGS 107A,A01,083627,Boyle; Mary E. T.,13,0,60,47
1657138452179,COGS 118A,A01,083075,Gupta; Anjum,15,0,76,61
1657138458206,CSE 3,A50,083646,Miranda; Gregory Joseph,23,0,50,27
1657138464229,CSE 8A,A50,083650,Miranda; Gregory Joseph,17,1,56,39
1657138470256,CSE 11,A01,083080,Cao; Yingjun,5,15,40,35
1657138476289,CSE 12,A01,083652,Krause-Levy; Sophia Louisa,24,1,120,96
1657138482313,CSE 15L,A01,083654,Morris; Justin Loren,9,0,50,41
1657138482313,CSE 15L,A02,083655,Morris; Justin Loren,9,0,50,41
1657138488337,CSE 20,A01,083657,Tran; Khoa Dang,38,0,80,42
1657138494361,CSE 21,A01,095574,Bach; Quang Tran,21,0,48,27
1657138500385,CSE 30,A01,083084,Eldon; John,4,0,80,76
1657138500385,CSE 30,B01,095061,Bhaskar; Nishant,7,0,50,43
1657138506408,CSE 100,A01,083659,Cao; Yingjun,4,4,70,66
1657138512437,CSE 134B,A01,083661,Powell; Thomas Allan,20,0,100,80
1657138518459,CSE 140,A01,083663,Gungor; Onat,13,0,85,72
1657138524482,CSE 140L,A01,083088,Eldon; John,17,0,100,83
1657138530509,CSE 175,A01,083665,Kumar; Rakesh,3,0,25,22
1657138536536,CSE 190,A00,092507,Dubnov; Shlomo,7,0,20,13
1657138542563,ECE 45,A01,083139,Congero; Spencer William,5,0,75,70
1657138548592,ECE 65,A50,083695,Saad; Andrew S,12,0,30,18
1657138548592,ECE 65,A51,095125,Saad; Andrew S,25,0,26,1
1657138554616,ECE 109,A01,091882,Touri; Behrouz,17,0,70,53
1657138560638,ECE 180,A00,083140,Abi Samra; Nicholas Camill,1,0,30,29
1657138560638,ECE 180,B00,083141,Abi Samra; Nicholas Camill,0,0,30,30
1657138566663,MATH 10A,A01,083735,Patchell; Gregory David,2,0,30,28
1657138566663,MATH 10A,A02,083736,Patchell; Gregory David,20,0,30,10
1657138566663,MATH 10A,A03,083737,Patchell; Gregory David,16,0,30,14
1657138572686,MATH 10B,A01,083207,Lim; Seonhee,7,0,34,27
1657138572686,MATH 10B,A02,083208,Lim; Seonhee,9,0,35,26
1657138572686,MATH 10B,A03,093472,Lim; Seonhee,5,0,34,29
1657138572686,MATH 10B,B01,083739,Sinha; Shubham,9,0,30,21
1657138578711,MATH 18,A01,083743,Cinel; Cameron Alexander,6,0,30,24
1657138578711,MATH 18,A02,083744,Cinel; Cameron Alexander,15,0,30,15
1657138578711,MATH 18,A03,083745,Cinel; Cameron Alexander,8,0,30,22
1657138578711,MATH 18,B01,083748,Rideout; David Porter,4,0,37,33
1657138578711,MATH 18,B02,083749,Rideout; David Porter,3,0,36,33
1657138578711,MATH 18,B03,083750,Rideout; David Porter,2,0,37,35
1657138578711,MATH 18,B04,083751,Rideout; David Porter,5,0,36,31
1657138578711,MATH 18,B05,093473,Rideout; David Porter,4,0,36,32
1657138578711,MATH 18,B06,093474,Rideout; David Porter,5,0,36,31
1657138584737,MATH 20A,A01,083754,Zheng; Zequn,12,0,40,28
1657138590787,MATH 20B,A01,083756,Briones; Jor-el Thomas Caparas,1,0,36,35
1657138590787,MATH 20B,A02,083757,Briones; Jor-el Thomas Caparas,1,0,36,35
1657138590787,MATH 20B,A03,093475,Briones; Jor-el Thomas Caparas,0,0,36,36
1657138596810,MATH 20C,A01,083760,Briones; Jor-el Thomas Caparas,1,0,35,34
1657138596810,MATH 20C,A02,083761,Briones; Jor-el Thomas Caparas,8,0,35,27
1657138596810,MATH 20C,A03,093476,Briones; Jor-el Thomas Caparas,0,1,36,36
1657138596810,MATH 20C,B01,083762,Bach; Quang Tran,0,0,30,30
1657138602850,MATH 20D,A01,083765,Tran; Brian Kha,4,0,30,26
1657138602850,MATH 20D,A02,083766,Tran; Brian Kha,5,0,30,25
1657138602850,MATH 20D,A03,083767,Tran; Brian Kha,3,0,30,27
1657138608883,MATH 20E,A01,083771,Ganguly; Soumya,7,0,32,25
1657138608883,MATH 20E,A02,083772,Ganguly; Soumya,6,0,32,26
1657138608883,MATH 20E,B01,083773,Ciotti; Benjamin,18,0,35,17
1657138608883,MATH 20E,B02,083774,Ciotti; Benjamin,17,0,35,18
1657138614912,MATH 103A,A01,083777,Greenfeld; Be'Eri,2,0,36,34
1657138614912,MATH 103A,A02,083778,Greenfeld; Be'Eri,5,0,36,31
1657138614912,MATH 103A,A03,093561,Greenfeld; Be'Eri,4,0,36,32
1657138614912,MATH 103A,B01,083779,Greenfeld; Be'Eri,6,0,36,30
1657138614912,MATH 103A,B02,083780,Greenfeld; Be'Eri,3,0,36,33
1657138614912,MATH 103A,B03,093562,Greenfeld; Be'Eri,3,0,36,33
1657138620935,MATH 105,A01,085443,Carter; Anne Toulson,14,0,35,21
1657138620935,MATH 105,A02,093477,Carter; Anne Toulson,20,0,35,15
1657138626970,MATH 109,A01,083213,Ganzberger; Geoffrey Michael,2,0,34,32
1657138626970,MATH 109,A02,083214,Ganzberger; Geoffrey Michael,3,0,34,31
1657138626970,MATH 109,A03,093478,Ganzberger; Geoffrey Michael,1,0,34,33
1657138626970,MATH 109,B01,083215,Ganzberger; Geoffrey Michael,1,0,32,31
1657138626970,MATH 109,B02,083216,Ganzberger; Geoffrey Michael,1,0,32,31
1657138626970,MATH 109,B03,093479,Ganzberger; Geoffrey Michael,6,0,32,26
1657138632999,MATH 142A,A01,083219,Chow; Bennett,6,0,32,26
1657138632999,MATH 142A,A02,083220,Chow; Bennett,10,0,32,22
1657138632999,MATH 142A,A03,093480,Chow; Bennett,7,0,32,25
1657138632999,MATH 142A,B03,093481,Chow; Bennett,8,0,32,24
1657138632999,MATH 142A,B04,093558,Chow; Bennett,11,0,32,21
1657138632999,MATH 142A,B05,093559,Chow; Bennett,6,0,32,26
1657138639031,MATH 193A,A01,083224,Rotar; Vladimir,7,0,34,27
1657138639031,MATH 193A,A02,083225,Rotar; Vladimir,5,0,34,29
1657138639031,MATH 193A,A03,083781,Rotar; Vladimir,1,0,34,33
1657138639031,MATH 193A,A04,083782,Rotar; Vladimir,8,0,34,26
1657138639031,MATH 193A,A05,093482,Rotar; Vladimir,6,0,34,28
1657138645054,MATH 197,001,091859,McAuley; Julian John,9999,0,9999,0
1657138645054,MATH 197,002,095566,Kedlaya; Kiran S.,9997,0,9999,2
1657138645054,MATH 197,003,095567,Xiao; Ming,9999,0,9999,0
1657138645054,MATH 197,004,095571,Perols; Johan Lars,9998,0,9999,1
1657138652107,COGS 9,A01,083615,Shannon; Kyle Michael,7,0,75,68
1657138658134,COGS 11,A01,083617,Boyle; Mary E. T.,21,0,48,27
1657138664167,COGS 13,A01,083071,Bastos; Amalia Pinkusfeld,9,0,71,62
1657138670191,COGS 14A,A01,092681,Semenuks; Arturs,1,1,100,99
1657138676222,COGS 14B,A01,083073,Cheng; Tzu-Han,6,0,63,57
1657138682255,COGS 17,A01,092677,Semenuks; Arturs,4,0,81,77
1657138688278,COGS 100,A01,083619,Allen; Michael Gordon,15,0,70,55
1657138694304,COGS 101A,A01,083621,Davis; Joshua Daniel,9,0,68,59
1657138700328,COGS 101B,A01,091572,Allen; Michael Gordon,9,0,65,56
1657138706357,COGS 101C,A01,083625,Delgado; Tania,17,0,35,18
1657138712382,COGS 107A,A01,083627,Boyle; Mary E. T.,13,0,60,47
1657138718409,COGS 118A,A01,083075,Gupta; Anjum,15,0,76,61
1657138724432,CSE 3,A50,083646,Miranda; Gregory Joseph,23,0,50,27
1657138730460,CSE 8A,A50,083650,Miranda; Gregory Joseph,17,1,56,39
1657138736489,CSE 11,A01,083080,Cao; Yingjun,5,15,40,35
1657138742514,CSE 12,A01,083652,Krause-Levy; Sophia Louisa,24,1,120,96
1657138748538,CSE 15L,A01,083654,Morris; Justin Loren,9,0,50,41
1657138748538,CSE 15L,A02,083655,Morris; Justin Loren,9,0,50,41
1657138754565,CSE 20,A01,083657,Tran; Khoa Dang,38,0,80,42
1657138760589,CSE 21,A01,095574,Bach; Quang Tran,21,0,48,27
1657138766614,CSE 30,A01,083084,Eldon; John,4,0,80,76
1657138766614,CSE 30,B01,095061,Bhaskar; Nishant,7,0,50,43
1657138772641,CSE 100,A01,083659,Cao; Yingjun,4,4,70,66
1657138778667,CSE 134B,A01,083661,Powell; Thomas Allan,20,0,100,80
1657138784694,CSE 140,A01,083663,Gungor; Onat,13,0,85,72
1657138790721,CSE 140L,A01,083088,Eldon; John,17,0,100,83
1657138796744,CSE 175,A01,083665,Kumar; Rakesh,3,0,25,22
1657138802771,CSE 190,A00,092507,Dubnov; Shlomo,7,0,20,13
1657138808794,ECE 45,A01,083139,Congero; Spencer William,5,0,75,70
1657138814818,ECE 65,A50,083695,Saad; Andrew S,12,0,30,18
1657138814818,ECE 65,A51,095125,Saad; Andrew S,25,0,26,1
1657138820841,ECE 109,A01,091882,Touri; Behrouz,17,0,70,53
1657138826868,ECE 180,A00,083140,Abi Samra; Nicholas Camill,1,0,30,29
1657138826868,ECE 180,B00,083141,Abi Samra; Nicholas Camill,0,0,30,30
1657138832894,MATH 10A,A01,083735,Patchell; Gregory David,2,0,30,28
1657138832894,MATH 10A,A02,083736,Patchell; Gregory David,20,0,30,10
1657138832894,MATH 10A,A03,083737,Patchell; Gregory David,16,0,30,14
1657138838922,MATH 10B,A01,083207,Lim; Seonhee,7,0,34,27
1657138838922,MATH 10B,A02,083208,Lim; Seonhee,9,0,35,26
1657138838922,MATH 10B,A03,093472,Lim; Seonhee,5,0,34,29
1657138838922,MATH 10B,B01,083739,Sinha; Shubham,9,0,30,21
1657138844946,MATH 18,A01,083743,Cinel; Cameron Alexander,6,0,30,24
1657138844946,MATH 18,A02,083744,Cinel; Cameron Alexander,15,0,30,15
1657138844946,MATH 18,A03,083745,Cinel; Cameron Alexander,8,0,30,22
1657138844946,MATH 18,B01,083748,Rideout; David Porter,4,0,37,33
1657138844946,MATH 18,B02,083749,Rideout; David Porter,3,0,36,33
1657138844946,MATH 18,B03,083750,Rideout; David Porter,2,0,37,35
1657138844946,MATH 18,B04,083751,Rideout; David Porter,5,0,36,31
1657138844946,MATH 18,B05,093473,Rideout; David Porter,4,0,36,32
1657138844946,MATH 18,B06,093474,Rideout; David Porter,5,0,36,31
1657138850979,MATH 20A,A01,083754,Zheng; Zequn,12,0,40,28
1657138857020,MATH 20B,A01,083756,Briones; Jor-el Thomas Caparas,1,0,36,35
1657138857020,MATH 20B,A02,083757,Briones; Jor-el Thomas Caparas,1,0,36,35
1657138857020,MATH 20B,A03,093475,Briones; Jor-el Thomas Caparas,0,0,36,36
1657138863043,MATH 20C,A01,083760,Briones; Jor-el Thomas Caparas,1,0,35,34
1657138863043,MATH 20C,A02,083761,Briones; Jor-el Thomas Caparas,8,0,35,27
1657138863043,MATH 20C,A03,093476,Briones; Jor-el Thomas Caparas,0,1,36,36
1657138863043,MATH 20C,B01,083762,Bach; Quang Tran,0,0,30,30
1657138869066,MATH 20D,A01,083765,Tran; Brian Kha,4,0,30,26
1657138869066,MATH 20D,A02,083766,Tran; Brian Kha,5,0,30,25
1657138869066,MATH 20D,A03,083767,Tran; Brian Kha,3,0,30,27
1657138875089,MATH 20E,A01,083771,Ganguly; Soumya,7,0,32,25
1657138875089,MATH 20E,A02,083772,Ganguly; Soumya,6,0,32,26
1657138875089,MATH 20E,B01,083773,Ciotti; Benjamin,18,0,35,17
1657138875089,MATH 20E,B02,083774,Ciotti; Benjamin,17,0,35,18
1657138881117,MATH 103A,A01,083777,Greenfeld; Be'Eri,2,0,36,34
1657138881117,MATH 103A,A02,083778,Greenfeld; Be'Eri,5,0,36,31
1657138881117,MATH 103A,A03,093561,Greenfeld; Be'Eri,4,0,36,32
1657138881117,MATH 103A,B01,083779,Greenfeld; Be'Eri,6,0,36,30
1657138881117,MATH 103A,B02,083780,Greenfeld; Be'Eri,3,0,36,33
1657138881117,MATH 103A,B03,093562,Greenfeld; Be'Eri,3,0,36,33
1657138887141,MATH 105,A01,085443,Carter; Anne Toulson,14,0,35,21
1657138887141,MATH 105,A02,093477,Carter; Anne Toulson,20,0,35,15
1657138893167,MATH 109,A01,083213,Ganzberger; Geoffrey Michael,2,0,34,32
1657138893167,MATH 109,A02,083214,Ganzberger; Geoffrey Michael,3,0,34,31
1657138893167,MATH 109,A03,093478,Ganzberger; Geoffrey Michael,1,0,34,33
1657138893167,MATH 109,B01,083215,Ganzberger; Geoffrey Michael,1,0,32,31
1657138893167,MATH 109,B02,083216,Ganzberger; Geoffrey Michael,1,0,32,31
1657138893167,MATH 109,B03,093479,Ganzberger; Geoffrey Michael,6,0,32,26
1657138899200,MATH 142A,A01,083219,Chow; Bennett,6,0,32,26
1657138899200,MATH 142A,A02,083220,Chow; Bennett,10,0,32,22
1657138899200,MATH 142A,A03,093480,Chow; Bennett,7,0,32,25
1657138899200,MATH 142A,B03,093481,Chow; Bennett,8,0,32,24
1657138899200,MATH 142A,B04,093558,Chow; Bennett,11,0,32,21
1657138899200,MATH 142A,B05,093559,Chow; Bennett,6,0,32,26
1657138905229,MATH 193A,A01,083224,Rotar; Vladimir,7,0,34,27
1657138905229,MATH 193A,A02,083225,Rotar; Vladimir,5,0,34,29
1657138905229,MATH 193A,A03,083781,Rotar; Vladimir,1,0,34,33
1657138905229,MATH 193A,A04,083782,Rotar; Vladimir,8,0,34,26
1657138905229,MATH 193A,A05,093482,Rotar; Vladimir,6,0,34,28
1657138911259,MATH 197,001,091859,McAuley; Julian John,9999,0,9999,0
1657138911259,MATH 197,002,095566,Kedlaya; Kiran S.,9997,0,9999,2
1657138911259,MATH 197,003,095567,Xiao; Ming,9999,0,9999,0
1657138911259,MATH 197,004,095571,Perols; Johan Lars,9998,0,9999,1
1657138918312,COGS 9,A01,083615,Shannon; Kyle Michael,7,0,75,68
1657138924337,COGS 11,A01,083617,Boyle; Mary E. T.,21,0,48,27
1657138930365,COGS 13,A01,083071,Bastos; Amalia Pinkusfeld,9,0,71,62
1657138936392,COGS 14A,A01,092681,Semenuks; Arturs,1,1,100,99
1657138942419,COGS 14B,A01,083073,Cheng; Tzu-Han,6,0,63,57
1657138948443,COGS 17,A01,092677,Semenuks; Arturs,4,0,81,77
1657138954466,COGS 100,A01,083619,Allen; Michael Gordon,15,0,70,55
1657138960491,COGS 101A,A01,083621,Davis; Joshua Daniel,9,0,68,59
1657138966514,COGS 101B,A01,091572,Allen; Michael Gordon,9,0,65,56
1657138972539,COGS 101C,A01,083625,Delgado; Tania,17,0,35,18
1657138978565,COGS 107A,A01,083627,Boyle; Mary E. T.,13,0,60,47
1657138984587,COGS 118A,A01,083075,Gupta; Anjum,15,0,76,61
1657138990623,CSE 3,A50,083646,Miranda; Gregory Joseph,24,0,50,26
1657138996648,CSE 8A,A50,083650,Miranda; Gregory Joseph,17,1,56,39
1657139002681,CSE 11,A01,083080,Cao; Yingjun,5,15,40,35
1657139008707,CSE 12,A01,083652,Krause-Levy; Sophia Louisa,24,1,120,96
1657139014819,CSE 15L,A01,083654,Morris; Justin Loren,9,0,50,41
1657139014819,CSE 15L,A02,083655,Morris; Justin Loren,9,0,50,41
1657139020848,CSE 20,A01,083657,Tran; Khoa Dang,38,0,80,42
1657139026872,CSE 21,A01,095574,Bach; Quang Tran,22,0,48,26
1657139032895,CSE 30,A01,083084,Eldon; John,4,0,80,76
1657139032895,CSE 30,B01,095061,Bhaskar; Nishant,7,0,50,43
1657139038918,CSE 100,A01,083659,Cao; Yingjun,4,4,70,66
1657139044940,CSE 134B,A01,083661,Powell; Thomas Allan,20,0,100,80
1657139050964,CSE 140,A01,083663,Gungor; Onat,13,0,85,72
1657139056990,CSE 140L,A01,083088,Eldon; John,17,0,100,83
1657139063014,CSE 175,A01,083665,Kumar; Rakesh,3,0,25,22
1657139069040,CSE 190,A00,092507,Dubnov; Shlomo,7,0,20,13
1657139075069,ECE 45,A01,083139,Congero; Spencer William,5,0,75,70
1657139081099,ECE 65,A50,083695,Saad; Andrew S,12,0,30,18
1657139081099,ECE 65,A51,095125,Saad; Andrew S,25,0,26,1
1657139087130,ECE 109,A01,091882,Touri; Behrouz,17,0,70,53
1657139093154,ECE 180,A00,083140,Abi Samra; Nicholas Camill,1,0,30,29
1657139093154,ECE 180,B00,083141,Abi Samra; Nicholas Camill,0,0,30,30
1657139099178,MATH 10A,A01,083735,Patchell; Gregory David,2,0,30,28
1657139099178,MATH 10A,A02,083736,Patchell; Gregory David,20,0,30,10
1657139099178,MATH 10A,A03,083737,Patchell; Gregory David,16,0,30,14
1657139105202,MATH 10B,A01,083207,Lim; Seonhee,7,0,34,27
1657139105202,MATH 10B,A02,083208,Lim; Seonhee,9,0,35,26
1657139105202,MATH 10B,A03,093472,Lim; Seonhee,5,0,34,29
1657139105202,MATH 10B,B01,083739,Sinha; Shubham,9,0,30,21
1657139111227,MATH 18,A01,083743,Cinel; Cameron Alexander,6,0,30,24
1657139111227,MATH 18,A02,083744,Cinel; Cameron Alexander,15,0,30,15
1657139111227,MATH 18,A03,083745,Cinel; Cameron Alexander,8,0,30,22
1657139111227,MATH 18,B01,083748,Rideout; David Porter,4,0,37,33
1657139111227,MATH 18,B02,083749,Rideout; David Porter,3,0,36,33
1657139111227,MATH 18,B03,083750,Rideout; David Porter,2,0,37,35
1657139111227,MATH 18,B04,083751,Rideout; David Porter,5,0,36,31
1657139111227,MATH 18,B05,093473,Rideout; David Porter,4,0,36,32
1657139111227,MATH 18,B06,093474,Rideout; David Porter,5,0,36,31
1657139117250,MATH 20A,A01,083754,Zheng; Zequn,12,0,40,28
1657139123276,MATH 20B,A01,083756,Briones; Jor-el Thomas Caparas,1,0,36,35
1657139123276,MATH 20B,A02,083757,Briones; Jor-el Thomas Caparas,1,0,36,35
1657139123276,MATH 20B,A03,093475,Briones; Jor-el Thomas Caparas,1,0,36,35
1657139129316,MATH 20C,A01,083760,Briones; Jor-el Thomas Caparas,1,0,35,34
1657139129316,MATH 20C,A02,083761,Briones; Jor-el Thomas Caparas,8,0,35,27
1657139129316,MATH 20C,A03,093476,Briones; Jor-el Thomas Caparas,0,1,36,36
1657139129316,MATH 20C,B01,083762,Bach; Quang Tran,0,0,30,30
1657139135354,MATH 20D,A01,083765,Tran; Brian Kha,4,0,30,26
1657139135354,MATH 20D,A02,083766,Tran; Brian Kha,5,0,30,25
1657139135354,MATH 20D,A03,083767,Tran; Brian Kha,3,0,30,27
1657139141384,MATH 20E,A01,083771,Ganguly; Soumya,7,0,32,25
1657139141384,MATH 20E,A02,083772,Ganguly; Soumya,6,0,32,26
1657139141384,MATH 20E,B01,083773,Ciotti; Benjamin,18,0,35,17
1657139141384,MATH 20E,B02,083774,Ciotti; Benjamin,17,0,35,18
1657139147408,MATH 103A,A01,083777,Greenfeld; Be'Eri,2,0,36,34
1657139147408,MATH 103A,A02,083778,Greenfeld; Be'Eri,5,0,36,31
1657139147408,MATH 103A,A03,093561,Greenfeld; Be'Eri,4,0,36,32
1657139147408,MATH 103A,B01,083779,Greenfeld; Be'Eri,6,0,36,30
1657139147408,MATH 103A,B02,083780,Greenfeld; Be'Eri,3,0,36,33
1657139147408,MATH 103A,B03,093562,Greenfeld; Be'Eri,3,0,36,33
1657139153465,MATH 105,A01,085443,Carter; Anne Toulson,14,0,35,21
1657139153465,MATH 105,A02,093477,Carter; Anne Toulson,20,0,35,15
1657139159493,MATH 109,A01,083213,Ganzberger; Geoffrey Michael,2,0,34,32
1657139159493,MATH 109,A02,083214,Ganzberger; Geoffrey Michael,3,0,34,31
1657139159493,MATH 109,A03,093478,Ganzberger; Geoffrey Michael,1,0,34,33
1657139159493,MATH 109,B01,083215,Ganzberger; Geoffrey Michael,1,0,32,31
1657139159493,MATH 109,B02,083216,Ganzberger; Geoffrey Michael,1,0,32,31
1657139159493,MATH 109,B03,093479,Ganzberger; Geoffrey Michael,6,0,32,26
1657139165529,MATH 142A,A01,083219,Chow; Bennett,6,0,32,26
1657139165529,MATH 142A,A02,083220,Chow; Bennett,10,0,32,22
1657139165529,MATH 142A,A03,093480,Chow; Bennett,7,0,32,25
1657139165529,MATH 142A,B03,093481,Chow; Bennett,8,0,32,24
1657139165529,MATH 142A,B04,093558,Chow; Bennett,11,0,32,21
1657139165529,MATH 142A,B05,093559,Chow; Bennett,6,0,32,26
1657139171552,MATH 193A,A01,083224,Rotar; Vladimir,7,0,34,27
1657139171552,MATH 193A,A02,083225,Rotar; Vladimir,5,0,34,29
1657139171552,MATH 193A,A03,083781,Rotar; Vladimir,1,0,34,33
1657139171552,MATH 193A,A04,083782,Rotar; Vladimir,8,0,34,26
1657139171552,MATH 193A,A05,093482,Rotar; Vladimir,6,0,34,28
1657139177581,MATH 197,001,091859,McAuley; Julian John,9999,0,9999,0
1657139177581,MATH 197,002,095566,Kedlaya; Kiran S.,9997,0,9999,2
1657139177581,MATH 197,003,095567,Xiao; Ming,9999,0,9999,0
1657139177581,MATH 197,004,095571,Perols; Johan Lars,9998,0,9999,1
1657139184636,COGS 9,A01,083615,Shannon; Kyle Michael,7,0,75,68
1657139190663,COGS 11,A01,083617,Boyle; Mary E. T.,21,0,48,27
1657139196689,COGS 13,A01,083071,Bastos; Amalia Pinkusfeld,9,0,71,62
1657139202712,COGS 14A,A01,092681,Semenuks; Arturs,1,1,100,99
1657139208739,COGS 14B,A01,083073,Cheng; Tzu-Han,6,0,63,57
1657139214774,COGS 17,A01,092677,Semenuks; Arturs,4,0,81,77
1657139220798,COGS 100,A01,083619,Allen; Michael Gordon,15,0,70,55
1657139226821,COGS 101A,A01,083621,Davis; Joshua Daniel,9,0,68,59
1657139232845,COGS 101B,A01,091572,Allen; Michael Gordon,9,0,65,56
1657139238873,COGS 101C,A01,083625,Delgado; Tania,17,0,35,18
1657139244898,COGS 107A,A01,083627,Boyle; Mary E. T.,13,0,60,47
1657139250922,COGS 118A,A01,083075,Gupta; Anjum,15,0,76,61
1657139256960,CSE 3,A50,083646,Miranda; Gregory Joseph,24,0,50,26
1657139262993,CSE 8A,A50,083650,Miranda; Gregory Joseph,17,1,56,39
1657139269015,CSE 11,A01,083080,Cao; Yingjun,5,15,40,35
1657139275039,CSE 12,A01,083652,Krause-Levy; Sophia Louisa,24,1,120,96
1657139281062,CSE 15L,A01,083654,Morris; Justin Loren,9,0,50,41
1657139281062,CSE 15L,A02,083655,Morris; Justin Loren,9,0,50,41
1657139287096,CSE 20,A01,083657,Tran; Khoa Dang,38,0,80,42
1657139293130,CSE 21,A01,095574,Bach; Quang Tran,22,0,48,26
1657139299157,CSE 30,A01,083084,Eldon; John,4,0,80,76
1657139299157,CSE 30,B01,095061,Bhaskar; Nishant,7,0,50,43
1657139305183,CSE 100,A01,083659,Cao; Yingjun,4,4,70,66
1657139311214,CSE 134B,A01,083661,Powell; Thomas Allan,20,0,100,80
1657139317246,CSE 140,A01,083663,Gungor; Onat,13,0,85,72
1657139323269,CSE 140L,A01,083088,Eldon; John,17,0,100,83
1657139329296,CSE 175,A01,083665,Kumar; Rakesh,3,0,25,22
1657139335319,CSE 190,A00,092507,Dubnov; Shlomo,7,0,20,13
1657139341345,ECE 45,A01,083139,Congero; Spencer William,5,0,75,70
1657139347368,ECE 65,A50,083695,Saad; Andrew S,12,0,30,18
1657139347368,ECE 65,A51,095125,Saad; Andrew S,25,0,26,1
1657139353398,ECE 109,A01,091882,Touri; Behrouz,17,0,70,53
1657139359425,ECE 180,A00,083140,Abi Samra; Nicholas Camill,1,0,30,29
1657139359425,ECE 180,B00,083141,Abi Samra; Nicholas Camill,0,0,30,30
1657139365449,MATH 10A,A01,083735,Patchell; Gregory David,2,0,30,28
1657139365449,MATH 10A,A02,083736,Patchell; Gregory David,20,0,30,10
1657139365449,MATH 10A,A03,083737,Patchell; Gregory David,16,0,30,14
1657139371474,MATH 10B,A01,083207,Lim; Seonhee,7,0,34,27
1657139371474,MATH 10B,A02,083208,Lim; Seonhee,9,0,35,26
1657139371474,MATH 10B,A03,093472,Lim; Seonhee,5,0,34,29
1657139371474,MATH 10B,B01,083739,Sinha; Shubham,9,0,30,21
1657139377514,MATH 18,A01,083743,Cinel; Cameron Alexander,6,0,30,24
1657139377514,MATH 18,A02,083744,Cinel; Cameron Alexander,15,0,30,15
1657139377514,MATH 18,A03,083745,Cinel; Cameron Alexander,8,0,30,22
1657139377514,MATH 18,B01,083748,Rideout; David Porter,4,0,37,33
1657139377514,MATH 18,B02,083749,Rideout; David Porter,3,0,36,33
1657139377514,MATH 18,B03,083750,Rideout; David Porter,2,0,37,35
1657139377514,MATH 18,B04,083751,Rideout; David Porter,5,0,36,31
1657139377514,MATH 18,B05,093473,Rideout; David Porter,4,0,36,32
1657139377514,MATH 18,B06,093474,Rideout; David Porter,5,0,36,31
1657139383537,MATH 20A,A01,083754,Zheng; Zequn,12,0,40,28
1657139389560,MATH 20B,A01,083756,Briones; Jor-el Thomas Caparas,1,0,36,35
1657139389560,MATH 20B,A02,083757,Briones; Jor-el Thomas Caparas,1,0,36,35
1657139389560,MATH 20B,A03,093475,Briones; Jor-el Thomas Caparas,1,0,36,35
1657139395598,MATH 20C,A01,083760,Briones; Jor-el Thomas Caparas,1,0,35,34
1657139395598,MATH 20C,A02,083761,Briones; Jor-el Thomas Caparas,8,0,35,27
1657139395598,MATH 20C,A03,093476,Briones; Jor-el Thomas Caparas,0,1,36,36
1657139395598,MATH 20C,B01,083762,Bach; Quang Tran,0,0,30,30
1657139401628,MATH 20D,A01,083765,Tran; Brian Kha,4,0,30,26
1657139401628,MATH 20D,A02,083766,Tran; Brian Kha,5,0,30,25
1657139401628,MATH 20D,A03,083767,Tran; Brian Kha,3,0,30,27
1657139407651,MATH 20E,A01,083771,Ganguly; Soumya,7,0,32,25
1657139407651,MATH 20E,A02,083772,Ganguly; Soumya,6,0,32,26
1657139407651,MATH 20E,B01,083773,Ciotti; Benjamin,18,0,35,17
1657139407651,MATH 20E,B02,083774,Ciotti; Benjamin,17,0,35,18
1657139413679,MATH 103A,A01,083777,Greenfeld; Be'Eri,2,0,36,34
1657139413679,MATH 103A,A02,083778,Greenfeld; Be'Eri,5,0,36,31
1657139413679,MATH 103A,A03,093561,Greenfeld; Be'Eri,4,0,36,32
1657139413679,MATH 103A,B01,083779,Greenfeld; Be'Eri,6,0,36,30
1657139413679,MATH 103A,B02,083780,Greenfeld; Be'Eri,3,0,36,33
1657139413679,MATH 103A,B03,093562,Greenfeld; Be'Eri,3,0,36,33
1657139419716,MATH 105,A01,085443,Carter; Anne Toulson,14,0,35,21
1657139419716,MATH 105,A02,093477,Carter; Anne Toulson,20,0,35,15
1657139425739,MATH 109,A01,083213,Ganzberger; Geoffrey Michael,2,0,34,32
1657139425739,MATH 109,A02,083214,Ganzberger; Geoffrey Michael,3,0,34,31
1657139425739,MATH 109,A03,093478,Ganzberger; Geoffrey Michael,1,0,34,33
1657139425739,MATH 109,B01,083215,Ganzberger; Geoffrey Michael,1,0,32,31
1657139425739,MATH 109,B02,083216,Ganzberger; Geoffrey Michael,1,0,32,31
1657139425739,MATH 109,B03,093479,Ganzberger; Geoffrey Michael,6,0,32,26
1657139431762,MATH 142A,A01,083219,Chow; Bennett,6,0,32,26
1657139431762,MATH 142A,A02,083220,Chow; Bennett,10,0,32,22
1657139431762,MATH 142A,A03,093480,Chow; Bennett,7,0,32,25
1657139431762,MATH 142A,B03,093481,Chow; Bennett,8,0,32,24
1657139431762,MATH 142A,B04,093558,Chow; Bennett,11,0,32,21
1657139431762,MATH 142A,B05,093559,Chow; Bennett,6,0,32,26
1657139437784,MATH 193A,A01,083224,Rotar; Vladimir,7,0,34,27
1657139437784,MATH 193A,A02,083225,Rotar; Vladimir,5,0,34,29
1657139437784,MATH 193A,A03,083781,Rotar; Vladimir,1,0,34,33
1657139437784,MATH 193A,A04,083782,Rotar; Vladimir,8,0,34,26
1657139437784,MATH 193A,A05,093482,Rotar; Vladimir,6,0,34,28
1657139443814,MATH 197,001,091859,McAuley; Julian John,9999,0,9999,0
1657139443814,MATH 197,002,095566,Kedlaya; Kiran S.,9997,0,9999,2
1657139443814,MATH 197,003,095567,Xiao; Ming,9999,0,9999,0
1657139443814,MATH 197,004,095571,Perols; Johan Lars,9998,0,9999,1
1657139450881,COGS 9,A01,083615,Shannon; Kyle Michael,7,0,75,68
1657139456904,COGS 11,A01,083617,Boyle; Mary E. T.,21,0,48,27
1657139462937,COGS 13,A01,083071,Bastos; Amalia Pinkusfeld,9,0,71,62
1657139468961,COGS 14A,A01,092681,Semenuks; Arturs,1,1,100,99
1657139474996,COGS 14B,A01,083073,Cheng; Tzu-Han,6,0,63,57
1657139481020,COGS 17,A01,092677,Semenuks; Arturs,4,0,81,77
1657139487045,COGS 100,A01,083619,Allen; Michael Gordon,15,0,70,55
1657139493071,COGS 101A,A01,083621,Davis; Joshua Daniel,9,0,68,59
1657139499098,COGS 101B,A01,091572,Allen; Michael Gordon,9,0,65,56
1657139505130,COGS 101C,A01,083625,Delgado; Tania,17,0,35,18
1657139511159,COGS 107A,A01,083627,Boyle; Mary E. T.,13,0,60,47
1657139517185,COGS 118A,A01,083075,Gupta; Anjum,15,0,76,61
1657139523215,CSE 3,A50,083646,Miranda; Gregory Joseph,24,0,50,26
1657139529251,CSE 8A,A50,083650,Miranda; Gregory Joseph,17,1,56,39
1657139535285,CSE 11,A01,083080,Cao; Yingjun,5,15,40,35
1657139541307,CSE 12,A01,083652,Krause-Levy; Sophia Louisa,24,1,120,96
1657139547332,CSE 15L,A01,083654,Morris; Justin Loren,9,0,50,41
1657139547332,CSE 15L,A02,083655,Morris; Justin Loren,9,0,50,41
1657139553360,CSE 20,A01,083657,Tran; Khoa Dang,38,0,80,42
1657139559387,CSE 21,A01,095574,Bach; Quang Tran,22,0,48,26
1657139565410,CSE 30,A01,083084,Eldon; John,4,0,80,76
1657139565410,CSE 30,B01,095061,Bhaskar; Nishant,7,0,50,43
1657139571440,CSE 100,A01,083659,Cao; Yingjun,4,4,70,66
1657139577468,CSE 134B,A01,083661,Powell; Thomas Allan,20,0,100,80
1657139583490,CSE 140,A01,083663,Gungor; Onat,13,0,85,72
1657139589518,CSE 140L,A01,083088,Eldon; John,17,0,100,83
1657139595544,CSE 175,A01,083665,Kumar; Rakesh,3,0,25,22
1657139601570,CSE 190,A00,092507,Dubnov; Shlomo,7,0,20,13
1657139607599,ECE 45,A01,083139,Congero; Spencer William,5,0,75,70
1657139613694,ECE 65,A50,083695,Saad; Andrew S,12,0,30,18
1657139613694,ECE 65,A51,095125,Saad; Andrew S,25,0,26,1
1657139619720,ECE 109,A01,091882,Touri; Behrouz,17,0,70,53
1657139625748,ECE 180,A00,083140,Abi Samra; Nicholas Camill,1,0,30,29
1657139625748,ECE 180,B00,083141,Abi Samra; Nicholas Camill,0,0,30,30
1657139631772,MATH 10A,A01,083735,Patchell; Gregory David,2,0,30,28
1657139631772,MATH 10A,A02,083736,Patchell; Gregory David,20,0,30,10
1657139631772,MATH 10A,A03,083737,Patchell; Gregory David,16,0,30,14
1657139637809,MATH 10B,A01,083207,Lim; Seonhee,7,0,34,27
1657139637809,MATH 10B,A02,083208,Lim; Seonhee,9,0,35,26
1657139637809,MATH 10B,A03,093472,Lim; Seonhee,5,0,34,29
1657139637809,MATH 10B,B01,083739,Sinha; Shubham,9,0,30,21
1657139643836,MATH 18,A01,083743,Cinel; Cameron Alexander,6,0,30,24
1657139643836,MATH 18,A02,083744,Cinel; Cameron Alexander,15,0,30,15
1657139643836,MATH 18,A03,083745,Cinel; Cameron Alexander,8,0,30,22
1657139643836,MATH 18,B01,083748,Rideout; David Porter,4,0,37,33
1657139643836,MATH 18,B02,083749,Rideout; David Porter,3,0,36,33
1657139643836,MATH 18,B03,083750,Rideout; David Porter,2,0,37,35
1657139643836,MATH 18,B04,083751,Rideout; David Porter,5,0,36,31
1657139643836,MATH 18,B05,093473,Rideout; David Porter,4,0,36,32
1657139643836,MATH 18,B06,093474,Rideout; David Porter,5,0,36,31
1657139649862,MATH 20A,A01,083754,Zheng; Zequn,12,0,40,28
1657139655892,MATH 20B,A01,083756,Briones; Jor-el Thomas Caparas,1,0,36,35
1657139655892,MATH 20B,A02,083757,Briones; Jor-el Thomas Caparas,1,0,36,35
1657139655892,MATH 20B,A03,093475,Briones; Jor-el Thomas Caparas,1,0,36,35
1657139661915,MATH 20C,A01,083760,Briones; Jor-el Thomas Caparas,1,0,35,34
1657139661915,MATH 20C,A02,083761,Briones; Jor-el Thomas Caparas,8,0,35,27
1657139661915,MATH 20C,A03,093476,Briones; Jor-el Thomas Caparas,0,1,36,36
1657139661915,MATH 20C,B01,083762,Bach; Quang Tran,0,0,30,30
1657139667946,MATH 20D,A01,083765,Tran; Brian Kha,4,0,30,26
1657139667946,MATH 20D,A02,083766,Tran; Brian Kha,5,0,30,25
1657139667946,MATH 20D,A03,083767,Tran; Brian Kha,3,0,30,27
1657139673970,MATH 20E,A01,083771,Ganguly; Soumya,7,0,32,25
1657139673970,MATH 20E,A02,083772,Ganguly; Soumya,7,0,32,25
1657139673970,MATH 20E,B01,083773,Ciotti; Benjamin,18,0,35,17
1657139673970,MATH 20E,B02,083774,Ciotti; Benjamin,17,0,35,18
1657139680004,MATH 103A,A01,083777,Greenfeld; Be'Eri,2,0,36,34
1657139680004,MATH 103A,A02,083778,Greenfeld; Be'Eri,5,0,36,31
1657139680004,MATH 103A,A03,093561,Greenfeld; Be'Eri,4,0,36,32
1657139680004,MATH 103A,B01,083779,Greenfeld; Be'Eri,6,0,36,30
1657139680004,MATH 103A,B02,083780,Greenfeld; Be'Eri,3,0,36,33
1657139680004,MATH 103A,B03,093562,Greenfeld; Be'Eri,3,0,36,33
1657139686026,MATH 105,A01,085443,Carter; Anne Toulson,14,0,35,21
1657139686026,MATH 105,A02,093477,Carter; Anne Toulson,20,0,35,15
1657139692055,MATH 109,A01,083213,Ganzberger; Geoffrey Michael,2,0,34,32
1657139692055,MATH 109,A02,083214,Ganzberger; Geoffrey Michael,3,0,34,31
1657139692055,MATH 109,A03,093478,Ganzberger; Geoffrey Michael,1,0,34,33
1657139692055,MATH 109,B01,083215,Ganzberger; Geoffrey Michael,1,0,32,31
1657139692055,MATH 109,B02,083216,Ganzberger; Geoffrey Michael,1,0,32,31
1657139692055,MATH 109,B03,093479,Ganzberger; Geoffrey Michael,6,0,32,26
1657139698084,MATH 142A,A01,083219,Chow; Bennett,6,0,32,26
1657139698084,MATH 142A,A02,083220,Chow; Bennett,10,0,32,22
1657139698084,MATH 142A,A03,093480,Chow; Bennett,7,0,32,25
1657139698084,MATH 142A,B03,093481,Chow; Bennett,8,0,32,24
1657139698084,MATH 142A,B04,093558,Chow; Bennett,11,0,32,21
1657139698084,MATH 142A,B05,093559,Chow; Bennett,6,0,32,26
1657139704109,MATH 193A,A01,083224,Rotar; Vladimir,7,0,34,27
1657139704109,MATH 193A,A02,083225,Rotar; Vladimir,5,0,34,29
1657139704109,MATH 193A,A03,083781,Rotar; Vladimir,1,0,34,33
1657139704109,MATH 193A,A04,083782,Rotar; Vladimir,8,0,34,26
1657139704109,MATH 193A,A05,093482,Rotar; Vladimir,6,0,34,28
1657139710135,MATH 197,001,091859,McAuley; Julian John,9999,0,9999,0
1657139710135,MATH 197,002,095566,Kedlaya; Kiran S.,9997,0,9999,2
1657139710135,MATH 197,003,095567,Xiao; Ming,9999,0,9999,0
1657139710135,MATH 197,004,095571,Perols; Johan Lars,9998,0,9999,1
1657139717199,COGS 9,A01,083615,Shannon; Kyle Michael,7,0,75,68
1657139723225,COGS 11,A01,083617,Boyle; Mary E. T.,21,0,48,27
1657139729249,COGS 13,A01,083071,Bastos; Amalia Pinkusfeld,9,0,71,62
1657139735273,COGS 14A,A01,092681,Semenuks; Arturs,1,1,100,99
1657139741300,COGS 14B,A01,083073,Cheng; Tzu-Han,6,0,63,57
1657139747322,COGS 17,A01,092677,Semenuks; Arturs,4,0,81,77
1657139753349,COGS 100,A01,083619,Allen; Michael Gordon,15,0,70,55
1657139759373,COGS 101A,A01,083621,Davis; Joshua Daniel,9,0,68,59
1657139765398,COGS 101B,A01,091572,Allen; Michael Gordon,9,0,65,56
1657139771421,COGS 101C,A01,083625,Delgado; Tania,17,0,35,18
1657139777444,COGS 107A,A01,083627,Boyle; Mary E. T.,13,0,60,47
1657139783472,COGS 118A,A01,083075,Gupta; Anjum,15,0,76,61
1657139789514,CSE 3,A50,083646,Miranda; Gregory Joseph,24,0,50,26
1657139795537,CSE 8A,A50,083650,Miranda; Gregory Joseph,17,1,56,39
1657139801565,CSE 11,A01,083080,Cao; Yingjun,5,15,40,35
1657139807596,CSE 12,A01,083652,Krause-Levy; Sophia Louisa,24,1,120,96
1657139813632,CSE 15L,A01,083654,Morris; Justin Loren,9,0,50,41
1657139813632,CSE 15L,A02,083655,Morris; Justin Loren,9,0,50,41
1657139819661,CSE 20,A01,083657,Tran; Khoa Dang,38,0,80,42
1657139825685,CSE 21,A01,095574,Bach; Quang Tran,22,0,48,26
1657139831710,CSE 30,A01,083084,Eldon; John,4,0,80,76
1657139831710,CSE 30,B01,095061,Bhaskar; Nishant,7,0,50,43
1657139837737,CSE 100,A01,083659,Cao; Yingjun,4,4,70,66
1657139843764,CSE 134B,A01,083661,Powell; Thomas Allan,20,0,100,80
1657139849796,CSE 140,A01,083663,Gungor; Onat,13,0,85,72
1657139855819,CSE 140L,A01,083088,Eldon; John,17,0,100,83
1657139861852,CSE 175,A01,083665,Kumar; Rakesh,3,0,25,22
1657139867878,CSE 190,A00,092507,Dubnov; Shlomo,7,0,20,13
1657139873902,ECE 45,A01,083139,Congero; Spencer William,5,0,75,70
1657139879931,ECE 65,A50,083695,Saad; Andrew S,12,0,30,18
1657139879931,ECE 65,A51,095125,Saad; Andrew S,25,0,26,1
1657139885957,ECE 109,A01,091882,Touri; Behrouz,17,0,70,53
1657139891983,ECE 180,A00,083140,Abi Samra; Nicholas Camill,1,0,30,29
1657139891983,ECE 180,B00,083141,Abi Samra; Nicholas Camill,0,0,30,30
1657139898005,MATH 10A,A01,083735,Patchell; Gregory David,2,0,30,28
1657139898005,MATH 10A,A02,083736,Patchell; Gregory David,20,0,30,10
1657139898005,MATH 10A,A03,083737,Patchell; Gregory David,16,0,30,14
1657139904047,MATH 10B,A01,083207,Lim; Seonhee,7,0,34,27
1657139904047,MATH 10B,A02,083208,Lim; Seonhee,9,0,35,26
1657139904047,MATH 10B,A03,093472,Lim; Seonhee,5,0,34,29
1657139904047,MATH 10B,B01,083739,Sinha; Shubham,9,0,30,21
1657139910087,MATH 18,A01,083743,Cinel; Cameron Alexander,6,0,30,24
1657139910087,MATH 18,A02,083744,Cinel; Cameron Alexander,15,0,30,15
1657139910087,MATH 18,A03,083745,Cinel; Cameron Alexander,8,0,30,22
1657139910087,MATH 18,B01,083748,Rideout; David Porter,4,0,37,33
1657139910087,MATH 18,B02,083749,Rideout; David Porter,3,0,36,33
1657139910087,MATH 18,B03,083750,Rideout; David Porter,2,0,37,35
1657139910087,MATH 18,B04,083751,Rideout; David Porter,5,0,36,31
1657139910087,MATH 18,B05,093473,Rideout; David Porter,4,0,36,32
1657139910087,MATH 18,B06,093474,Rideout; David Porter,5,0,36,31
1657139916111,MATH 20A,A01,083754,Zheng; Zequn,12,0,40,28
1657139922133,MATH 20B,A01,083756,Briones; Jor-el Thomas Caparas,1,0,36,35
1657139922133,MATH 20B,A02,083757,Briones; Jor-el Thomas Caparas,1,0,36,35
1657139922133,MATH 20B,A03,093475,Briones; Jor-el Thomas Caparas,1,0,36,35
1657139928177,MATH 20C,A01,083760,Briones; Jor-el Thomas Caparas,1,0,35,34
1657139928177,MATH 20C,A02,083761,Briones; Jor-el Thomas Caparas,8,0,35,27
1657139928177,MATH 20C,A03,093476,Briones; Jor-el Thomas Caparas,0,1,36,36
1657139928177,MATH 20C,B01,083762,Bach; Quang Tran,0,0,30,30
1657139934202,MATH 20D,A01,083765,Tran; Brian Kha,4,0,30,26
1657139934202,MATH 20D,A02,083766,Tran; Brian Kha,5,0,30,25
1657139934202,MATH 20D,A03,083767,Tran; Brian Kha,3,0,30,27
1657139940234,MATH 20E,A01,083771,Ganguly; Soumya,7,0,32,25
1657139940234,MATH 20E,A02,083772,Ganguly; Soumya,7,0,32,25
1657139940234,MATH 20E,B01,083773,Ciotti; Benjamin,18,0,35,17
1657139940234,MATH 20E,B02,083774,Ciotti; Benjamin,17,0,35,18
1657139946256,MATH 103A,A01,083777,Greenfeld; Be'Eri,2,0,36,34
1657139946256,MATH 103A,A02,083778,Greenfeld; Be'Eri,5,0,36,31
1657139946256,MATH 103A,A03,093561,Greenfeld; Be'Eri,4,0,36,32
1657139946256,MATH 103A,B01,083779,Greenfeld; Be'Eri,6,0,36,30
1657139946256,MATH 103A,B02,083780,Greenfeld; Be'Eri,3,0,36,33
1657139946256,MATH 103A,B03,093562,Greenfeld; Be'Eri,3,0,36,33
1657139952279,MATH 105,A01,085443,Carter; Anne Toulson,14,0,35,21
1657139952279,MATH 105,A02,093477,Carter; Anne Toulson,20,0,35,15
1657139958316,MATH 109,A01,083213,Ganzberger; Geoffrey Michael,2,0,34,32
1657139958316,MATH 109,A02,083214,Ganzberger; Geoffrey Michael,3,0,34,31
1657139958316,MATH 109,A03,093478,Ganzberger; Geoffrey Michael,1,0,34,33
1657139958316,MATH 109,B01,083215,Ganzberger; Geoffrey Michael,1,0,32,31
1657139958316,MATH 109,B02,083216,Ganzberger; Geoffrey Michael,1,0,32,31
1657139958316,MATH 109,B03,093479,Ganzberger; Geoffrey Michael,6,0,32,26
1657139964339,MATH 142A,A01,083219,Chow; Bennett,6,0,32,26
1657139964339,MATH 142A,A02,083220,Chow; Bennett,10,0,32,22
1657139964339,MATH 142A,A03,093480,Chow; Bennett,7,0,32,25
1657139964339,MATH 142A,B03,093481,Chow; Bennett,8,0,32,24
1657139964339,MATH 142A,B04,093558,Chow; Bennett,11,0,32,21
1657139964339,MATH 142A,B05,093559,Chow; Bennett,6,0,32,26
1657139970382,MATH 193A,A01,083224,Rotar; Vladimir,7,0,34,27
1657139970382,MATH 193A,A02,083225,Rotar; Vladimir,5,0,34,29
1657139970382,MATH 193A,A03,083781,Rotar; Vladimir,1,0,34,33
1657139970382,MATH 193A,A04,083782,Rotar; Vladimir,8,0,34,26
1657139970382,MATH 193A,A05,093482,Rotar; Vladimir,6,0,34,28
1657139976405,MATH 197,001,091859,McAuley; Julian John,9999,0,9999,0
1657139976405,MATH 197,002,095566,Kedlaya; Kiran S.,9997,0,9999,2
1657139976405,MATH 197,003,095567,Xiao; Ming,9999,0,9999,0
1657139976405,MATH 197,004,095571,Perols; Johan Lars,9998,0,9999,1
1657139983486,COGS 9,A01,083615,Shannon; Kyle Michael,7,0,75,68
1657139989524,COGS 11,A01,083617,Boyle; Mary E. T.,21,0,48,27
1657139995551,COGS 13,A01,083071,Bastos; Amalia Pinkusfeld,9,0,71,62
1657140001588,COGS 14A,A01,092681,Semenuks; Arturs,1,1,100,99
1657140007610,COGS 14B,A01,083073,Cheng; Tzu-Han,6,0,63,57
1657140013637,COGS 17,A01,092677,Semenuks; Arturs,4,0,81,77
1657140019666,COGS 100,A01,083619,Allen; Michael Gordon,15,0,70,55
1657140025692,COGS 101A,A01,083621,Davis; Joshua Daniel,9,0,68,59
1657140031714,COGS 101B,A01,091572,Allen; Michael Gordon,9,0,65,56
1657140037743,COGS 101C,A01,083625,Delgado; Tania,17,0,35,18
1657140043769,COGS 107A,A01,083627,Boyle; Mary E. T.,13,0,60,47
1657140049800,COGS 118A,A01,083075,Gupta; Anjum,15,0,76,61
1657140055823,CSE 3,A50,083646,Miranda; Gregory Joseph,24,0,50,26
1657140061854,CSE 8A,A50,083650,Miranda; Gregory Joseph,17,1,56,39
1657140067877,CSE 11,A01,083080,Cao; Yingjun,5,15,40,35
1657140073906,CSE 12,A01,083652,Krause-Levy; Sophia Louisa,24,1,120,96
1657140079928,CSE 15L,A01,083654,Morris; Justin Loren,9,0,50,41
1657140079928,CSE 15L,A02,083655,Morris; Justin Loren,9,0,50,41
1657140085955,CSE 20,A01,083657,Tran; Khoa Dang,38,0,80,42
1657140091982,CSE 21,A01,095574,Bach; Quang Tran,22,0,48,26
1657140098009,CSE 30,A01,083084,Eldon; John,4,0,80,76
1657140098009,CSE 30,B01,095061,Bhaskar; Nishant,7,0,50,43
1657140104033,CSE 100,A01,083659,Cao; Yingjun,4,4,70,66
1657140110059,CSE 134B,A01,083661,Powell; Thomas Allan,20,0,100,80
1657140116081,CSE 140,A01,083663,Gungor; Onat,13,0,85,72
1657140122103,CSE 140L,A01,083088,Eldon; John,17,0,100,83
1657140128134,CSE 175,A01,083665,Kumar; Rakesh,3,0,25,22
1657140134178,CSE 190,A00,092507,Dubnov; Shlomo,7,0,20,13
1657140140209,ECE 45,A01,083139,Congero; Spencer William,5,0,75,70
1657140146233,ECE 65,A50,083695,Saad; Andrew S,12,0,30,18
1657140146233,ECE 65,A51,095125,Saad; Andrew S,25,0,26,1
1657140152256,ECE 109,A01,091882,Touri; Behrouz,17,0,70,53
1657140158287,ECE 180,A00,083140,Abi Samra; Nicholas Camill,1,0,30,29
1657140158287,ECE 180,B00,083141,Abi Samra; Nicholas Camill,0,0,30,30
1657140164311,MATH 10A,A01,083735,Patchell; Gregory David,2,0,30,28
1657140164311,MATH 10A,A02,083736,Patchell; Gregory David,20,0,30,10
1657140164311,MATH 10A,A03,083737,Patchell; Gregory David,16,0,30,14
1657140170336,MATH 10B,A01,083207,Lim; Seonhee,7,0,34,27
1657140170336,MATH 10B,A02,083208,Lim; Seonhee,9,0,35,26
1657140170336,MATH 10B,A03,093472,Lim; Seonhee,5,0,34,29
1657140170336,MATH 10B,B01,083739,Sinha; Shubham,9,0,30,21
1657140176368,MATH 18,A01,083743,Cinel; Cameron Alexander,6,0,30,24
1657140176368,MATH 18,A02,083744,Cinel; Cameron Alexander,15,0,30,15
1657140176368,MATH 18,A03,083745,Cinel; Cameron Alexander,8,0,30,22
1657140176368,MATH 18,B01,083748,Rideout; David Porter,4,0,37,33
1657140176368,MATH 18,B02,083749,Rideout; David Porter,3,0,36,33
1657140176368,MATH 18,B03,083750,Rideout; David Porter,2,0,37,35
1657140176368,MATH 18,B04,083751,Rideout; David Porter,5,0,36,31
1657140176368,MATH 18,B05,093473,Rideout; David Porter,4,0,36,32
1657140176368,MATH 18,B06,093474,Rideout; David Porter,5,0,36,31
1657140182391,MATH 20A,A01,083754,Zheng; Zequn,12,0,40,28
1657140188414,MATH 20B,A01,083756,Briones; Jor-el Thomas Caparas,1,0,36,35
1657140188414,MATH 20B,A02,083757,Briones; Jor-el Thomas Caparas,1,0,36,35
1657140188414,MATH 20B,A03,093475,Briones; Jor-el Thomas Caparas,1,0,36,35
1657140194442,MATH 20C,A01,083760,Briones; Jor-el Thomas Caparas,1,0,35,34
1657140194442,MATH 20C,A02,083761,Briones; Jor-el Thomas Caparas,8,0,35,27
1657140194442,MATH 20C,A03,093476,Briones; Jor-el Thomas Caparas,0,1,36,36
1657140194442,MATH 20C,B01,083762,Bach; Quang Tran,0,0,30,30
1657140200483,MATH 20D,A01,083765,Tran; Brian Kha,4,0,30,26
1657140200483,MATH 20D,A02,083766,Tran; Brian Kha,5,0,30,25
1657140200483,MATH 20D,A03,083767,Tran; Brian Kha,3,0,30,27
1657140206515,MATH 20E,A01,083771,Ganguly; Soumya,7,0,32,25
1657140206515,MATH 20E,A02,083772,Ganguly; Soumya,7,0,32,25
1657140206515,MATH 20E,B01,083773,Ciotti; Benjamin,18,0,35,17
1657140206515,MATH 20E,B02,083774,Ciotti; Benjamin,17,0,35,18
1657140212632,MATH 103A,A01,083777,Greenfeld; Be'Eri,2,0,36,34
1657140212632,MATH 103A,A02,083778,Greenfeld; Be'Eri,5,0,36,31
1657140212632,MATH 103A,A03,093561,Greenfeld; Be'Eri,4,0,36,32
1657140212632,MATH 103A,B01,083779,Greenfeld; Be'Eri,6,0,36,30
1657140212632,MATH 103A,B02,083780,Greenfeld; Be'Eri,3,0,36,33
1657140212632,MATH 103A,B03,093562,Greenfeld; Be'Eri,3,0,36,33
1657140218655,MATH 105,A01,085443,Carter; Anne Toulson,14,0,35,21
1657140218655,MATH 105,A02,093477,Carter; Anne Toulson,20,0,35,15
1657140224692,MATH 109,A01,083213,Ganzberger; Geoffrey Michael,2,0,34,32
1657140224692,MATH 109,A02,083214,Ganzberger; Geoffrey Michael,3,0,34,31
1657140224692,MATH 109,A03,093478,Ganzberger; Geoffrey Michael,1,0,34,33
1657140224692,MATH 109,B01,083215,Ganzberger; Geoffrey Michael,1,0,32,31
1657140224692,MATH 109,B02,083216,Ganzberger; Geoffrey Michael,1,0,32,31
1657140224692,MATH 109,B03,093479,Ganzberger; Geoffrey Michael,6,0,32,26
1657140230718,MATH 142A,A01,083219,Chow; Bennett,6,0,32,26
1657140230718,MATH 142A,A02,083220,Chow; Bennett,10,0,32,22
1657140230718,MATH 142A,A03,093480,Chow; Bennett,7,0,32,25
1657140230718,MATH 142A,B03,093481,Chow; Bennett,8,0,32,24
1657140230718,MATH 142A,B04,093558,Chow; Bennett,11,0,32,21
1657140230718,MATH 142A,B05,093559,Chow; Bennett,6,0,32,26
1657140236748,MATH 193A,A01,083224,Rotar; Vladimir,7,0,34,27
1657140236748,MATH 193A,A02,083225,Rotar; Vladimir,5,0,34,29
1657140236748,MATH 193A,A03,083781,Rotar; Vladimir,1,0,34,33
1657140236748,MATH 193A,A04,083782,Rotar; Vladimir,8,0,34,26
1657140236748,MATH 193A,A05,093482,Rotar; Vladimir,6,0,34,28
1657140242771,MATH 197,001,091859,McAuley; Julian John,9999,0,9999,0
1657140242771,MATH 197,002,095566,Kedlaya; Kiran S.,9997,0,9999,2
1657140242771,MATH 197,003,095567,Xiao; Ming,9999,0,9999,0
1657140242771,MATH 197,004,095571,Perols; Johan Lars,9998,0,9999,1
1657140249831,COGS 9,A01,083615,Shannon; Kyle Michael,7,0,75,68
1657140255854,COGS 11,A01,083617,Boyle; Mary E. T.,21,0,48,27
1657140261889,COGS 13,A01,083071,Bastos; Amalia Pinkusfeld,9,0,71,62
1657140267912,COGS 14A,A01,092681,Semenuks; Arturs,1,1,100,99
1657140273936,COGS 14B,A01,083073,Cheng; Tzu-Han,6,0,63,57
1657140279958,COGS 17,A01,092677,Semenuks; Arturs,4,0,81,77
1657140285981,COGS 100,A01,083619,Allen; Michael Gordon,15,0,70,55
1657140292004,COGS 101A,A01,083621,Davis; Joshua Daniel,9,0,68,59
1657140298043,COGS 101B,A01,091572,Allen; Michael Gordon,9,0,65,56
1657140304069,COGS 101C,A01,083625,Delgado; Tania,17,0,35,18
1657140310095,COGS 107A,A01,083627,Boyle; Mary E. T.,13,0,60,47
1657140316130,COGS 118A,A01,083075,Gupta; Anjum,15,0,76,61
1657140322161,CSE 3,A50,083646,Miranda; Gregory Joseph,24,0,50,26
1657140328184,CSE 8A,A50,083650,Miranda; Gregory Joseph,17,1,56,39
1657140334209,CSE 11,A01,083080,Cao; Yingjun,5,15,40,35
1657140340232,CSE 12,A01,083652,Krause-Levy; Sophia Louisa,24,1,120,96
1657140346256,CSE 15L,A01,083654,Morris; Justin Loren,9,0,50,41
1657140346256,CSE 15L,A02,083655,Morris; Justin Loren,9,0,50,41
1657140352283,CSE 20,A01,083657,Tran; Khoa Dang,38,0,80,42
1657140358320,CSE 21,A01,095574,Bach; Quang Tran,22,0,48,26
1657140364342,CSE 30,A01,083084,Eldon; John,4,0,80,76
1657140364342,CSE 30,B01,095061,Bhaskar; Nishant,7,0,50,43
1657140370365,CSE 100,A01,083659,Cao; Yingjun,4,4,70,66
1657140376390,CSE 134B,A01,083661,Powell; Thomas Allan,20,0,100,80
1657140382412,CSE 140,A01,083663,Gungor; Onat,13,0,85,72
1657140388448,CSE 140L,A01,083088,Eldon; John,17,0,100,83
1657140394474,CSE 175,A01,083665,Kumar; Rakesh,3,0,25,22
1657140400500,CSE 190,A00,092507,Dubnov; Shlomo,7,0,20,13
1657140406526,ECE 45,A01,083139,Congero; Spencer William,5,0,75,70
1657140412557,ECE 65,A50,083695,Saad; Andrew S,12,0,30,18
1657140412557,ECE 65,A51,095125,Saad; Andrew S,25,0,26,1
1657140418594,ECE 109,A01,091882,Touri; Behrouz,17,0,70,53
1657140424627,ECE 180,A00,083140,Abi Samra; Nicholas Camill,1,0,30,29
1657140424627,ECE 180,B00,083141,Abi Samra; Nicholas Camill,0,0,30,30
1657140430658,MATH 10A,A01,083735,Patchell; Gregory David,2,0,30,28
1657140430658,MATH 10A,A02,083736,Patchell; Gregory David,20,0,30,10
1657140430658,MATH 10A,A03,083737,Patchell; Gregory David,16,0,30,14
1657140436685,MATH 10B,A01,083207,Lim; Seonhee,7,0,34,27
1657140436685,MATH 10B,A02,083208,Lim; Seonhee,9,0,35,26
1657140436685,MATH 10B,A03,093472,Lim; Seonhee,5,0,34,29
1657140436685,MATH 10B,B01,083739,Sinha; Shubham,9,0,30,21
1657140442710,MATH 18,A01,083743,Cinel; Cameron Alexander,6,0,30,24
1657140442710,MATH 18,A02,083744,Cinel; Cameron Alexander,15,0,30,15
1657140442710,MATH 18,A03,083745,Cinel; Cameron Alexander,8,0,30,22
1657140442710,MATH 18,B01,083748,Rideout; David Porter,4,0,37,33
1657140442710,MATH 18,B02,083749,Rideout; David Porter,3,0,36,33
1657140442710,MATH 18,B03,083750,Rideout; David Porter,2,0,37,35
1657140442710,MATH 18,B04,083751,Rideout; David Porter,5,0,36,31
1657140442710,MATH 18,B05,093473,Rideout; David Porter,4,0,36,32
1657140442710,MATH 18,B06,093474,Rideout; David Porter,5,0,36,31
1657140448731,MATH 20A,A01,083754,Zheng; Zequn,12,0,40,28
1657140454753,MATH 20B,A01,083756,Briones; Jor-el Thomas Caparas,1,0,36,35
1657140454753,MATH 20B,A02,083757,Briones; Jor-el Thomas Caparas,1,0,36,35
1657140454753,MATH 20B,A03,093475,Briones; Jor-el Thomas Caparas,1,0,36,35
1657140460776,MATH 20C,A01,083760,Briones; Jor-el Thomas Caparas,1,0,35,34
1657140460776,MATH 20C,A02,083761,Briones; Jor-el Thomas Caparas,8,0,35,27
1657140460776,MATH 20C,A03,093476,Briones; Jor-el Thomas Caparas,0,1,36,36
1657140460776,MATH 20C,B01,083762,Bach; Quang Tran,0,0,30,30
1657140466807,MATH 20D,A01,083765,Tran; Brian Kha,4,0,30,26
1657140466807,MATH 20D,A02,083766,Tran; Brian Kha,5,0,30,25
1657140466807,MATH 20D,A03,083767,Tran; Brian Kha,3,0,30,27
1657140472839,MATH 20E,A01,083771,Ganguly; Soumya,7,0,32,25
1657140472839,MATH 20E,A02,083772,Ganguly; Soumya,7,0,32,25
1657140472839,MATH 20E,B01,083773,Ciotti; Benjamin,18,0,35,17
1657140472839,MATH 20E,B02,083774,Ciotti; Benjamin,17,0,35,18
1657140478864,MATH 103A,A01,083777,Greenfeld; Be'Eri,2,0,36,34
1657140478864,MATH 103A,A02,083778,Greenfeld; Be'Eri,5,0,36,31
1657140478864,MATH 103A,A03,093561,Greenfeld; Be'Eri,4,0,36,32
1657140478864,MATH 103A,B01,083779,Greenfeld; Be'Eri,6,0,36,30
1657140478864,MATH 103A,B02,083780,Greenfeld; Be'Eri,3,0,36,33
1657140478864,MATH 103A,B03,093562,Greenfeld; Be'Eri,3,0,36,33
1657140484897,MATH 105,A01,085443,Carter; Anne Toulson,14,0,35,21
1657140484897,MATH 105,A02,093477,Carter; Anne Toulson,20,0,35,15
1657140490926,MATH 109,A01,083213,Ganzberger; Geoffrey Michael,2,0,34,32
1657140490926,MATH 109,A02,083214,Ganzberger; Geoffrey Michael,3,0,34,31
1657140490926,MATH 109,A03,093478,Ganzberger; Geoffrey Michael,1,0,34,33
1657140490926,MATH 109,B01,083215,Ganzberger; Geoffrey Michael,1,0,32,31
1657140490926,MATH 109,B02,083216,Ganzberger; Geoffrey Michael,1,0,32,31
1657140490926,MATH 109,B03,093479,Ganzberger; Geoffrey Michael,6,0,32,26
1657140496953,MATH 142A,A01,083219,Chow; Bennett,6,0,32,26
1657140496953,MATH 142A,A02,083220,Chow; Bennett,10,0,32,22
1657140496953,MATH 142A,A03,093480,Chow; Bennett,7,0,32,25
1657140496953,MATH 142A,B03,093481,Chow; Bennett,8,0,32,24
1657140496953,MATH 142A,B04,093558,Chow; Bennett,11,0,32,21
1657140496953,MATH 142A,B05,093559,Chow; Bennett,6,0,32,26
1657140502981,MATH 193A,A01,083224,Rotar; Vladimir,7,0,34,27
1657140502981,MATH 193A,A02,083225,Rotar; Vladimir,5,0,34,29
1657140502981,MATH 193A,A03,083781,Rotar; Vladimir,1,0,34,33
1657140502981,MATH 193A,A04,083782,Rotar; Vladimir,8,0,34,26
1657140502981,MATH 193A,A05,093482,Rotar; Vladimir,6,0,34,28
1657140509010,MATH 197,001,091859,McAuley; Julian John,9999,0,9999,0
1657140509010,MATH 197,002,095566,Kedlaya; Kiran S.,9997,0,9999,2
1657140509010,MATH 197,003,095567,Xiao; Ming,9999,0,9999,0
1657140509010,MATH 197,004,095571,Perols; Johan Lars,9998,0,9999,1
1657140516073,COGS 9,A01,083615,Shannon; Kyle Michael,7,0,75,68
1657140522099,COGS 11,A01,083617,Boyle; Mary E. T.,21,0,48,27
1657140528122,COGS 13,A01,083071,Bastos; Amalia Pinkusfeld,9,0,71,62
1657140534148,COGS 14A,A01,092681,Semenuks; Arturs,1,1,100,99
1657140540172,COGS 14B,A01,083073,Cheng; Tzu-Han,6,0,63,57
1657140546195,COGS 17,A01,092677,Semenuks; Arturs,4,0,81,77
1657140552225,COGS 100,A01,083619,Allen; Michael Gordon,15,0,70,55
1657140558259,COGS 101A,A01,083621,Davis; Joshua Daniel,9,0,68,59
1657140564288,COGS 101B,A01,091572,Allen; Michael Gordon,9,0,65,56
1657140570321,COGS 101C,A01,083625,Delgado; Tania,17,0,35,18
1657140576345,COGS 107A,A01,083627,Boyle; Mary E. T.,13,0,60,47
1657140582373,COGS 118A,A01,083075,Gupta; Anjum,15,0,76,61
1657140588400,CSE 3,A50,083646,Miranda; Gregory Joseph,24,0,50,26
1657140594427,CSE 8A,A50,083650,Miranda; Gregory Joseph,17,1,56,39
1657140600451,CSE 11,A01,083080,Cao; Yingjun,5,15,40,35
1657140606486,CSE 12,A01,083652,Krause-Levy; Sophia Louisa,24,1,120,96
1657140612509,CSE 15L,A01,083654,Morris; Justin Loren,9,0,50,41
1657140612509,CSE 15L,A02,083655,Morris; Justin Loren,9,0,50,41
1657140618535,CSE 20,A01,083657,Tran; Khoa Dang,38,0,80,42
1657140624563,CSE 21,A01,095574,Bach; Quang Tran,22,0,48,26
1657140630594,CSE 30,A01,083084,Eldon; John,4,0,80,76
1657140630594,CSE 30,B01,095061,Bhaskar; Nishant,7,0,50,43
1657140636616,CSE 100,A01,083659,Cao; Yingjun,4,4,70,66
1657140642650,CSE 134B,A01,083661,Powell; Thomas Allan,20,0,100,80
1657140648674,CSE 140,A01,083663,Gungor; Onat,13,0,85,72
1657140654705,CSE 140L,A01,083088,Eldon; John,17,0,100,83
1657140660753,CSE 175,A01,083665,Kumar; Rakesh,3,0,25,22
1657140666775,CSE 190,A00,092507,Dubnov; Shlomo,7,0,20,13
1657140672808,ECE 45,A01,083139,Congero; Spencer William,5,0,75,70
1657140678844,ECE 65,A50,083695,Saad; Andrew S,12,0,30,18
1657140678844,ECE 65,A51,095125,Saad; Andrew S,25,0,26,1
1657140684869,ECE 109,A01,091882,Touri; Behrouz,17,0,70,53
1657140690890,ECE 180,A00,083140,Abi Samra; Nicholas Camill,1,0,30,29
1657140690890,ECE 180,B00,083141,Abi Samra; Nicholas Camill,0,0,30,30
1657140696913,MATH 10A,A01,083735,Patchell; Gregory David,2,0,30,28
1657140696913,MATH 10A,A02,083736,Patchell; Gregory David,20,0,30,10
1657140696913,MATH 10A,A03,083737,Patchell; Gregory David,16,0,30,14
1657140702938,MATH 10B,A01,083207,Lim; Seonhee,7,0,34,27
1657140702938,MATH 10B,A02,083208,Lim; Seonhee,9,0,35,26
1657140702938,MATH 10B,A03,093472,Lim; Seonhee,5,0,34,29
1657140702938,MATH 10B,B01,083739,Sinha; Shubham,9,0,30,21
1657140708969,MATH 18,A01,083743,Cinel; Cameron Alexander,6,0,30,24
1657140708969,MATH 18,A02,083744,Cinel; Cameron Alexander,15,0,30,15
1657140708969,MATH 18,A03,083745,Cinel; Cameron Alexander,8,0,30,22
1657140708969,MATH 18,B01,083748,Rideout; David Porter,4,0,37,33
1657140708969,MATH 18,B02,083749,Rideout; David Porter,3,0,36,33
1657140708969,MATH 18,B03,083750,Rideout; David Porter,2,0,37,35
1657140708969,MATH 18,B04,083751,Rideout; David Porter,5,0,36,31
1657140708969,MATH 18,B05,093473,Rideout; David Porter,4,0,36,32
1657140708969,MATH 18,B06,093474,Rideout; David Porter,5,0,36,31
1657140715130,MATH 20A,A01,083754,Zheng; Zequn,12,0,40,28
1657140721155,MATH 20B,A01,083756,Briones; Jor-el Thomas Caparas,1,0,36,35
1657140721155,MATH 20B,A02,083757,Briones; Jor-el Thomas Caparas,1,0,36,35
1657140721155,MATH 20B,A03,093475,Briones; Jor-el Thomas Caparas,1,0,36,35
1657140727191,MATH 20C,A01,083760,Briones; Jor-el Thomas Caparas,1,0,35,34
1657140727191,MATH 20C,A02,083761,Briones; Jor-el Thomas Caparas,8,0,35,27
1657140727191,MATH 20C,A03,093476,Briones; Jor-el Thomas Caparas,0,1,36,36
1657140727191,MATH 20C,B01,083762,Bach; Quang Tran,0,0,30,30
1657140733224,MATH 20D,A01,083765,Tran; Brian Kha,4,0,30,26
1657140733224,MATH 20D,A02,083766,Tran; Brian Kha,5,0,30,25
1657140733224,MATH 20D,A03,083767,Tran; Brian Kha,3,0,30,27
1657140739259,MATH 20E,A01,083771,Ganguly; Soumya,7,0,32,25
1657140739259,MATH 20E,A02,083772,Ganguly; Soumya,7,0,32,25
1657140739259,MATH 20E,B01,083773,Ciotti; Benjamin,18,0,35,17
1657140739259,MATH 20E,B02,083774,Ciotti; Benjamin,17,0,35,18
1657140745286,MATH 103A,A01,083777,Greenfeld; Be'Eri,2,0,36,34
1657140745286,MATH 103A,A02,083778,Greenfeld; Be'Eri,5,0,36,31
1657140745286,MATH 103A,A03,093561,Greenfeld; Be'Eri,4,0,36,32
1657140745286,MATH 103A,B01,083779,Greenfeld; Be'Eri,6,0,36,30
1657140745286,MATH 103A,B02,083780,Greenfeld; Be'Eri,3,0,36,33
1657140745286,MATH 103A,B03,093562,Greenfeld; Be'Eri,3,0,36,33
1657140751316,MATH 105,A01,085443,Carter; Anne Toulson,14,0,35,21
1657140751316,MATH 105,A02,093477,Carter; Anne Toulson,20,0,35,15
1657140757341,MATH 109,A01,083213,Ganzberger; Geoffrey Michael,2,0,34,32
1657140757341,MATH 109,A02,083214,Ganzberger; Geoffrey Michael,3,0,34,31
1657140757341,MATH 109,A03,093478,Ganzberger; Geoffrey Michael,1,0,34,33
1657140757341,MATH 109,B01,083215,Ganzberger; Geoffrey Michael,1,0,32,31
1657140757341,MATH 109,B02,083216,Ganzberger; Geoffrey Michael,1,0,32,31
1657140757341,MATH 109,B03,093479,Ganzberger; Geoffrey Michael,6,0,32,26
1657140763370,MATH 142A,A01,083219,Chow; Bennett,6,0,32,26
1657140763370,MATH 142A,A02,083220,Chow; Bennett,10,0,32,22
1657140763370,MATH 142A,A03,093480,Chow; Bennett,7,0,32,25
1657140763370,MATH 142A,B03,093481,Chow; Bennett,8,0,32,24
1657140763370,MATH 142A,B04,093558,Chow; Bennett,11,0,32,21
1657140763370,MATH 142A,B05,093559,Chow; Bennett,6,0,32,26
1657140769397,MATH 193A,A01,083224,Rotar; Vladimir,7,0,34,27
1657140769397,MATH 193A,A02,083225,Rotar; Vladimir,5,0,34,29
1657140769397,MATH 193A,A03,083781,Rotar; Vladimir,1,0,34,33
1657140769397,MATH 193A,A04,083782,Rotar; Vladimir,8,0,34,26
1657140769397,MATH 193A,A05,093482,Rotar; Vladimir,6,0,34,28
1657140775420,MATH 197,001,091859,McAuley; Julian John,9999,0,9999,0
1657140775420,MATH 197,002,095566,Kedlaya; Kiran S.,9997,0,9999,2
1657140775420,MATH 197,003,095567,Xiao; Ming,9999,0,9999,0
1657140775420,MATH 197,004,095571,Perols; Johan Lars,9998,0,9999,1
1657140782486,COGS 9,A01,083615,Shannon; Kyle Michael,7,0,75,68
1657140788509,COGS 11,A01,083617,Boyle; Mary E. T.,21,0,48,27
1657140794544,COGS 13,A01,083071,Bastos; Amalia Pinkusfeld,9,0,71,62
1657140800570,COGS 14A,A01,092681,Semenuks; Arturs,1,1,100,99
1657140806682,COGS 14B,A01,083073,Cheng; Tzu-Han,6,0,63,57
1657140812708,COGS 17,A01,092677,Semenuks; Arturs,4,0,81,77
1657140818738,COGS 100,A01,083619,Allen; Michael Gordon,15,0,70,55
1657140824771,COGS 101A,A01,083621,Davis; Joshua Daniel,9,0,68,59
1657140830797,COGS 101B,A01,091572,Allen; Michael Gordon,9,0,65,56
1657140836819,COGS 101C,A01,083625,Delgado; Tania,17,0,35,18
1657140842854,COGS 107A,A01,083627,Boyle; Mary E. T.,13,0,60,47
1657140848876,COGS 118A,A01,083075,Gupta; Anjum,15,0,76,61
1657140854899,CSE 3,A50,083646,Miranda; Gregory Joseph,24,0,50,26
1657140860927,CSE 8A,A50,083650,Miranda; Gregory Joseph,17,1,56,39
1657140866964,CSE 11,A01,083080,Cao; Yingjun,5,15,40,35
1657140872990,CSE 12,A01,083652,Krause-Levy; Sophia Louisa,24,1,120,96
1657140879014,CSE 15L,A01,083654,Morris; Justin Loren,9,0,50,41
1657140879014,CSE 15L,A02,083655,Morris; Justin Loren,9,0,50,41
1657140885044,CSE 20,A01,083657,Tran; Khoa Dang,38,0,80,42
1657140891067,CSE 21,A01,095574,Bach; Quang Tran,22,0,48,26
1657140897099,CSE 30,A01,083084,Eldon; John,4,0,80,76
1657140897099,CSE 30,B01,095061,Bhaskar; Nishant,7,0,50,43
1657140903127,CSE 100,A01,083659,Cao; Yingjun,4,4,70,66
1657140909148,CSE 134B,A01,083661,Powell; Thomas Allan,20,0,100,80
1657140915173,CSE 140,A01,083663,Gungor; Onat,13,0,85,72
1657140921203,CSE 140L,A01,083088,Eldon; John,17,0,100,83
1657140927227,CSE 175,A01,083665,Kumar; Rakesh,3,0,25,22
1657140933254,CSE 190,A00,092507,Dubnov; Shlomo,7,0,20,13
1657140939278,ECE 45,A01,083139,Congero; Spencer William,5,0,75,70
1657140945304,ECE 65,A50,083695,Saad; Andrew S,12,0,30,18
1657140945304,ECE 65,A51,095125,Saad; Andrew S,25,0,26,1
1657140951335,ECE 109,A01,091882,Touri; Behrouz,17,0,70,53
1657140957358,ECE 180,A00,083140,Abi Samra; Nicholas Camill,1,0,30,29
1657140957358,ECE 180,B00,083141,Abi Samra; Nicholas Camill,0,0,30,30
1657140963381,MATH 10A,A01,083735,Patchell; Gregory David,2,0,30,28
1657140963381,MATH 10A,A02,083736,Patchell; Gregory David,20,0,30,10
1657140963381,MATH 10A,A03,083737,Patchell; Gregory David,16,0,30,14
1657140969405,MATH 10B,A01,083207,Lim; Seonhee,7,0,34,27
1657140969405,MATH 10B,A02,083208,Lim; Seonhee,9,0,35,26
1657140969405,MATH 10B,A03,093472,Lim; Seonhee,5,0,34,29
1657140969405,MATH 10B,B01,083739,Sinha; Shubham,9,0,30,21
1657140975433,MATH 18,A01,083743,Cinel; Cameron Alexander,6,0,30,24
1657140975433,MATH 18,A02,083744,Cinel; Cameron Alexander,15,0,30,15
1657140975433,MATH 18,A03,083745,Cinel; Cameron Alexander,8,0,30,22
1657140975433,MATH 18,B01,083748,Rideout; David Porter,4,0,37,33
1657140975433,MATH 18,B02,083749,Rideout; David Porter,3,0,36,33
1657140975433,MATH 18,B03,083750,Rideout; David Porter,2,0,37,35
1657140975433,MATH 18,B04,083751,Rideout; David Porter,5,0,36,31
1657140975433,MATH 18,B05,093473,Rideout; David Porter,4,0,36,32
1657140975433,MATH 18,B06,093474,Rideout; David Porter,5,0,36,31
1657140981462,MATH 20A,A01,083754,Zheng; Zequn,12,0,40,28
1657140987493,MATH 20B,A01,083756,Briones; Jor-el Thomas Caparas,1,0,36,35
1657140987493,MATH 20B,A02,083757,Briones; Jor-el Thomas Caparas,1,0,36,35
1657140987493,MATH 20B,A03,093475,Briones; Jor-el Thomas Caparas,1,0,36,35
1657140993517,MATH 20C,A01,083760,Briones; Jor-el Thomas Caparas,1,0,35,34
1657140993517,MATH 20C,A02,083761,Briones; Jor-el Thomas Caparas,8,0,35,27
1657140993517,MATH 20C,A03,093476,Briones; Jor-el Thomas Caparas,0,1,36,36
1657140993517,MATH 20C,B01,083762,Bach; Quang Tran,0,0,30,30
1657140999546,MATH 20D,A01,083765,Tran; Brian Kha,4,0,30,26
1657140999546,MATH 20D,A02,083766,Tran; Brian Kha,5,0,30,25
1657140999546,MATH 20D,A03,083767,Tran; Brian Kha,3,0,30,27
1657141005576,MATH 20E,A01,083771,Ganguly; Soumya,7,0,32,25
1657141005576,MATH 20E,A02,083772,Ganguly; Soumya,7,0,32,25
1657141005576,MATH 20E,B01,083773,Ciotti; Benjamin,18,0,35,17
1657141005576,MATH 20E,B02,083774,Ciotti; Benjamin,17,0,35,18
1657141011606,MATH 103A,A01,083777,Greenfeld; Be'Eri,2,0,36,34
1657141011606,MATH 103A,A02,083778,Greenfeld; Be'Eri,5,0,36,31
1657141011606,MATH 103A,A03,093561,Greenfeld; Be'Eri,4,0,36,32
1657141011606,MATH 103A,B01,083779,Greenfeld; Be'Eri,6,0,36,30
1657141011606,MATH 103A,B02,083780,Greenfeld; Be'Eri,3,0,36,33
1657141011606,MATH 103A,B03,093562,Greenfeld; Be'Eri,3,0,36,33
1657141017633,MATH 105,A01,085443,Carter; Anne Toulson,14,0,35,21
1657141017633,MATH 105,A02,093477,Carter; Anne Toulson,20,0,35,15
1657141023675,MATH 109,A01,083213,Ganzberger; Geoffrey Michael,2,0,34,32
1657141023675,MATH 109,A02,083214,Ganzberger; Geoffrey Michael,3,0,34,31
1657141023675,MATH 109,A03,093478,Ganzberger; Geoffrey Michael,1,0,34,33
1657141023675,MATH 109,B01,083215,Ganzberger; Geoffrey Michael,1,0,32,31
1657141023675,MATH 109,B02,083216,Ganzberger; Geoffrey Michael,1,0,32,31
1657141023675,MATH 109,B03,093479,Ganzberger; Geoffrey Michael,6,0,32,26
1657141029706,MATH 142A,A01,083219,Chow; Bennett,6,0,32,26
1657141029706,MATH 142A,A02,083220,Chow; Bennett,10,0,32,22
1657141029706,MATH 142A,A03,093480,Chow; Bennett,7,0,32,25
1657141029706,MATH 142A,B03,093481,Chow; Bennett,8,0,32,24
1657141029706,MATH 142A,B04,093558,Chow; Bennett,11,0,32,21
1657141029706,MATH 142A,B05,093559,Chow; Bennett,6,0,32,26
1657141035729,MATH 193A,A01,083224,Rotar; Vladimir,7,0,34,27
1657141035729,MATH 193A,A02,083225,Rotar; Vladimir,5,0,34,29
1657141035729,MATH 193A,A03,083781,Rotar; Vladimir,1,0,34,33
1657141035729,MATH 193A,A04,083782,Rotar; Vladimir,8,0,34,26
1657141035729,MATH 193A,A05,093482,Rotar; Vladimir,6,0,34,28
1657141041751,MATH 197,001,091859,McAuley; Julian John,9999,0,9999,0
1657141041751,MATH 197,002,095566,Kedlaya; Kiran S.,9997,0,9999,2
1657141041751,MATH 197,003,095567,Xiao; Ming,9999,0,9999,0
1657141041751,MATH 197,004,095571,Perols; Johan Lars,9998,0,9999,1
1657141048815,COGS 9,A01,083615,Shannon; Kyle Michael,7,0,75,68
1657141054836,COGS 11,A01,083617,Boyle; Mary E. T.,21,0,48,27
1657141060868,COGS 13,A01,083071,Bastos; Amalia Pinkusfeld,9,0,71,62
1657141066895,COGS 14A,A01,092681,Semenuks; Arturs,1,1,100,99
1657141072918,COGS 14B,A01,083073,Cheng; Tzu-Han,6,0,63,57
1657141078942,COGS 17,A01,092677,Semenuks; Arturs,4,0,81,77
1657141084969,COGS 100,A01,083619,Allen; Michael Gordon,15,0,70,55
1657141090993,COGS 101A,A01,083621,Davis; Joshua Daniel,9,0,68,59
1657141097015,COGS 101B,A01,091572,Allen; Michael Gordon,9,0,65,56
1657141103039,COGS 101C,A01,083625,Delgado; Tania,17,0,35,18
1657141109086,COGS 107A,A01,083627,Boyle; Mary E. T.,13,0,60,47
1657141115110,COGS 118A,A01,083075,Gupta; Anjum,15,0,76,61
1657141121137,CSE 3,A50,083646,Miranda; Gregory Joseph,24,0,50,26
1657141127166,CSE 8A,A50,083650,Miranda; Gregory Joseph,17,1,56,39
1657141133199,CSE 11,A01,083080,Cao; Yingjun,5,15,40,35
1657141139232,CSE 12,A01,083652,Krause-Levy; Sophia Louisa,24,1,120,96
1657141145294,CSE 15L,A01,083654,Morris; Justin Loren,9,0,50,41
1657141145294,CSE 15L,A02,083655,Morris; Justin Loren,9,0,50,41
1657141151324,CSE 20,A01,083657,Tran; Khoa Dang,38,0,80,42
1657141157347,CSE 21,A01,095574,Bach; Quang Tran,22,0,48,26
1657141163376,CSE 30,A01,083084,Eldon; John,4,0,80,76
1657141163376,CSE 30,B01,095061,Bhaskar; Nishant,7,0,50,43
1657141169407,CSE 100,A01,083659,Cao; Yingjun,4,4,70,66
1657141175431,CSE 134B,A01,083661,Powell; Thomas Allan,20,0,100,80
1657141181470,CSE 140,A01,083663,Gungor; Onat,13,0,85,72
1657141187499,CSE 140L,A01,083088,Eldon; John,17,0,100,83
1657141193531,CSE 175,A01,083665,Kumar; Rakesh,3,0,25,22
1657141199563,CSE 190,A00,092507,Dubnov; Shlomo,7,0,20,13
1657141205586,ECE 45,A01,083139,Congero; Spencer William,5,0,75,70
1657141211621,ECE 65,A50,083695,Saad; Andrew S,12,0,30,18
1657141211621,ECE 65,A51,095125,Saad; Andrew S,25,0,26,1
1657141217652,ECE 109,A01,091882,Touri; Behrouz,17,0,70,53
1657141223674,ECE 180,A00,083140,Abi Samra; Nicholas Camill,1,0,30,29
1657141223674,ECE 180,B00,083141,Abi Samra; Nicholas Camill,0,0,30,30
1657141229709,MATH 10A,A01,083735,Patchell; Gregory David,2,0,30,28
1657141229709,MATH 10A,A02,083736,Patchell; Gregory David,20,0,30,10
1657141229709,MATH 10A,A03,083737,Patchell; Gregory David,16,0,30,14
1657141235745,MATH 10B,A01,083207,Lim; Seonhee,7,0,34,27
1657141235745,MATH 10B,A02,083208,Lim; Seonhee,9,0,35,26
1657141235745,MATH 10B,A03,093472,Lim; Seonhee,5,0,34,29
1657141235745,MATH 10B,B01,083739,Sinha; Shubham,9,0,30,21
1657141241769,MATH 18,A01,083743,Cinel; Cameron Alexander,6,0,30,24
1657141241769,MATH 18,A02,083744,Cinel; Cameron Alexander,15,0,30,15
1657141241769,MATH 18,A03,083745,Cinel; Cameron Alexander,8,0,30,22
1657141241769,MATH 18,B01,083748,Rideout; David Porter,4,0,37,33
1657141241769,MATH 18,B02,083749,Rideout; David Porter,3,0,36,33
1657141241769,MATH 18,B03,083750,Rideout; David Porter,2,0,37,35
1657141241769,MATH 18,B04,083751,Rideout; David Porter,5,0,36,31
1657141241769,MATH 18,B05,093473,Rideout; David Porter,4,0,36,32
1657141241769,MATH 18,B06,093474,Rideout; David Porter,5,0,36,31
1657141247792,MATH 20A,A01,083754,Zheng; Zequn,12,0,40,28
1657141253814,MATH 20B,A01,083756,Briones; Jor-el Thomas Caparas,1,0,36,35
1657141253814,MATH 20B,A02,083757,Briones; Jor-el Thomas Caparas,1,0,36,35
1657141253814,MATH 20B,A03,093475,Briones; Jor-el Thomas Caparas,1,0,36,35
1657141259844,MATH 20C,A01,083760,Briones; Jor-el Thomas Caparas,1,0,35,34
1657141259844,MATH 20C,A02,083761,Briones; Jor-el Thomas Caparas,8,0,35,27
1657141259844,MATH 20C,A03,093476,Briones; Jor-el Thomas Caparas,0,1,36,36
1657141259844,MATH 20C,B01,083762,Bach; Quang Tran,0,0,30,30
1657141265867,MATH 20D,A01,083765,Tran; Brian Kha,4,0,30,26
1657141265867,MATH 20D,A02,083766,Tran; Brian Kha,5,0,30,25
1657141265867,MATH 20D,A03,083767,Tran; Brian Kha,3,0,30,27
1657141271895,MATH 20E,A01,083771,Ganguly; Soumya,7,0,32,25
1657141271895,MATH 20E,A02,083772,Ganguly; Soumya,7,0,32,25
1657141271895,MATH 20E,B01,083773,Ciotti; Benjamin,18,0,35,17
1657141271895,MATH 20E,B02,083774,Ciotti; Benjamin,17,0,35,18
1657141277919,MATH 103A,A01,083777,Greenfeld; Be'Eri,2,0,36,34
1657141277919,MATH 103A,A02,083778,Greenfeld; Be'Eri,5,0,36,31
1657141277919,MATH 103A,A03,093561,Greenfeld; Be'Eri,4,0,36,32
1657141277919,MATH 103A,B01,083779,Greenfeld; Be'Eri,6,0,36,30
1657141277919,MATH 103A,B02,083780,Greenfeld; Be'Eri,3,0,36,33
1657141277919,MATH 103A,B03,093562,Greenfeld; Be'Eri,3,0,36,33
1657141283944,MATH 105,A01,085443,Carter; Anne Toulson,14,0,35,21
1657141283944,MATH 105,A02,093477,Carter; Anne Toulson,20,0,35,15
1657141289972,MATH 109,A01,083213,Ganzberger; Geoffrey Michael,2,0,34,32
1657141289972,MATH 109,A02,083214,Ganzberger; Geoffrey Michael,3,0,34,31
1657141289972,MATH 109,A03,093478,Ganzberger; Geoffrey Michael,1,0,34,33
1657141289972,MATH 109,B01,083215,Ganzberger; Geoffrey Michael,1,0,32,31
1657141289972,MATH 109,B02,083216,Ganzberger; Geoffrey Michael,1,0,32,31
1657141289972,MATH 109,B03,093479,Ganzberger; Geoffrey Michael,6,0,32,26
1657141296001,MATH 142A,A01,083219,Chow; Bennett,6,0,32,26
1657141296001,MATH 142A,A02,083220,Chow; Bennett,10,0,32,22
1657141296001,MATH 142A,A03,093480,Chow; Bennett,7,0,32,25
1657141296001,MATH 142A,B03,093481,Chow; Bennett,8,0,32,24
1657141296001,MATH 142A,B04,093558,Chow; Bennett,11,0,32,21
1657141296001,MATH 142A,B05,093559,Chow; Bennett,6,0,32,26
1657141302025,MATH 193A,A01,083224,Rotar; Vladimir,7,0,34,27
1657141302025,MATH 193A,A02,083225,Rotar; Vladimir,5,0,34,29
1657141302025,MATH 193A,A03,083781,Rotar; Vladimir,1,0,34,33
1657141302025,MATH 193A,A04,083782,Rotar; Vladimir,8,0,34,26
1657141302025,MATH 193A,A05,093482,Rotar; Vladimir,6,0,34,28
1657141308057,MATH 197,001,091859,McAuley; Julian John,9999,0,9999,0
1657141308057,MATH 197,002,095566,Kedlaya; Kiran S.,9997,0,9999,2
1657141308057,MATH 197,003,095567,Xiao; Ming,9999,0,9999,0
1657141308057,MATH 197,004,095571,Perols; Johan Lars,9998,0,9999,1
1657141315117,COGS 9,A01,083615,Shannon; Kyle Michael,7,0,75,68
1657141321144,COGS 11,A01,083617,Boyle; Mary E. T.,21,0,48,27
1657141327172,COGS 13,A01,083071,Bastos; Amalia Pinkusfeld,9,0,71,62
1657141333195,COGS 14A,A01,092681,Semenuks; Arturs,1,1,100,99
1657141339236,COGS 14B,A01,083073,Cheng; Tzu-Han,6,0,63,57
1657141345262,COGS 17,A01,092677,Semenuks; Arturs,4,0,81,77
1657141351286,COGS 100,A01,083619,Allen; Michael Gordon,15,0,70,55
1657141357315,COGS 101A,A01,083621,Davis; Joshua Daniel,9,0,68,59
1657141363337,COGS 101B,A01,091572,Allen; Michael Gordon,9,0,65,56
1657141369364,COGS 101C,A01,083625,Delgado; Tania,17,0,35,18
1657141375391,COGS 107A,A01,083627,Boyle; Mary E. T.,13,0,60,47
1657141381413,COGS 118A,A01,083075,Gupta; Anjum,15,0,76,61
1657141387434,CSE 3,A50,083646,Miranda; Gregory Joseph,24,0,50,26
1657141393461,CSE 8A,A50,083650,Miranda; Gregory Joseph,17,1,56,39
1657141399484,CSE 11,A01,083080,Cao; Yingjun,5,15,40,35
1657141405597,CSE 12,A01,083652,Krause-Levy; Sophia Louisa,24,1,120,96
1657141411623,CSE 15L,A01,083654,Morris; Justin Loren,9,0,50,41
1657141411623,CSE 15L,A02,083655,Morris; Justin Loren,9,0,50,41
1657141417645,CSE 20,A01,083657,Tran; Khoa Dang,38,0,80,42
1657141423671,CSE 21,A01,095574,Bach; Quang Tran,22,0,48,26
1657141429716,CSE 30,A01,083084,Eldon; John,4,0,80,76
1657141429716,CSE 30,B01,095061,Bhaskar; Nishant,7,0,50,43
1657141435742,CSE 100,A01,083659,Cao; Yingjun,4,4,70,66
1657141441765,CSE 134B,A01,083661,Powell; Thomas Allan,20,0,100,80
1657141447786,CSE 140,A01,083663,Gungor; Onat,13,0,85,72
1657141453815,CSE 140L,A01,083088,Eldon; John,17,0,100,83
1657141459840,CSE 175,A01,083665,Kumar; Rakesh,3,0,25,22
1657141465877,CSE 190,A00,092507,Dubnov; Shlomo,7,0,20,13
1657141471913,ECE 45,A01,083139,Congero; Spencer William,5,0,75,70
1657141477952,ECE 65,A50,083695,Saad; Andrew S,12,0,30,18
1657141477952,ECE 65,A51,095125,Saad; Andrew S,25,0,26,1
1657141483977,ECE 109,A01,091882,Touri; Behrouz,17,0,70,53
1657141490010,ECE 180,A00,083140,Abi Samra; Nicholas Camill,1,0,30,29
1657141490010,ECE 180,B00,083141,Abi Samra; Nicholas Camill,0,0,30,30
1657141496039,MATH 10A,A01,083735,Patchell; Gregory David,2,0,30,28
1657141496039,MATH 10A,A02,083736,Patchell; Gregory David,20,0,30,10
1657141496039,MATH 10A,A03,083737,Patchell; Gregory David,16,0,30,14
1657141502065,MATH 10B,A01,083207,Lim; Seonhee,7,0,34,27
1657141502065,MATH 10B,A02,083208,Lim; Seonhee,9,0,35,26
1657141502065,MATH 10B,A03,093472,Lim; Seonhee,5,0,34,29
1657141502065,MATH 10B,B01,083739,Sinha; Shubham,9,0,30,21
1657141508106,MATH 18,A01,083743,Cinel; Cameron Alexander,6,0,30,24
1657141508106,MATH 18,A02,083744,Cinel; Cameron Alexander,15,0,30,15
1657141508106,MATH 18,A03,083745,Cinel; Cameron Alexander,8,0,30,22
1657141508106,MATH 18,B01,083748,Rideout; David Porter,4,0,37,33
1657141508106,MATH 18,B02,083749,Rideout; David Porter,3,0,36,33
1657141508106,MATH 18,B03,083750,Rideout; David Porter,2,0,37,35
1657141508106,MATH 18,B04,083751,Rideout; David Porter,5,0,36,31
1657141508106,MATH 18,B05,093473,Rideout; David Porter,4,0,36,32
1657141508106,MATH 18,B06,093474,Rideout; David Porter,5,0,36,31
1657141514130,MATH 20A,A01,083754,Zheng; Zequn,12,0,40,28
1657141520152,MATH 20B,A01,083756,Briones; Jor-el Thomas Caparas,1,0,36,35
1657141520152,MATH 20B,A02,083757,Briones; Jor-el Thomas Caparas,1,0,36,35
1657141520152,MATH 20B,A03,093475,Briones; Jor-el Thomas Caparas,1,0,36,35
1657141526180,MATH 20C,A01,083760,Briones; Jor-el Thomas Caparas,1,0,35,34
1657141526180,MATH 20C,A02,083761,Briones; Jor-el Thomas Caparas,8,0,35,27
1657141526180,MATH 20C,A03,093476,Briones; Jor-el Thomas Caparas,0,1,36,36
1657141526180,MATH 20C,B01,083762,Bach; Quang Tran,0,0,30,30
1657141532204,MATH 20D,A01,083765,Tran; Brian Kha,4,0,30,26
1657141532204,MATH 20D,A02,083766,Tran; Brian Kha,5,0,30,25
1657141532204,MATH 20D,A03,083767,Tran; Brian Kha,3,0,30,27
1657141538235,MATH 20E,A01,083771,Ganguly; Soumya,7,0,32,25
1657141538235,MATH 20E,A02,083772,Ganguly; Soumya,7,0,32,25
1657141538235,MATH 20E,B01,083773,Ciotti; Benjamin,18,0,35,17
1657141538235,MATH 20E,B02,083774,Ciotti; Benjamin,17,0,35,18
1657141544265,MATH 103A,A01,083777,Greenfeld; Be'Eri,2,0,36,34
1657141544265,MATH 103A,A02,083778,Greenfeld; Be'Eri,5,0,36,31
1657141544265,MATH 103A,A03,093561,Greenfeld; Be'Eri,4,0,36,32
1657141544265,MATH 103A,B01,083779,Greenfeld; Be'Eri,6,0,36,30
1657141544265,MATH 103A,B02,083780,Greenfeld; Be'Eri,3,0,36,33
1657141544265,MATH 103A,B03,093562,Greenfeld; Be'Eri,3,0,36,33
1657141550292,MATH 105,A01,085443,Carter; Anne Toulson,14,0,35,21
1657141550292,MATH 105,A02,093477,Carter; Anne Toulson,20,0,35,15
1657141556315,MATH 109,A01,083213,Ganzberger; Geoffrey Michael,2,0,34,32
1657141556315,MATH 109,A02,083214,Ganzberger; Geoffrey Michael,3,0,34,31
1657141556315,MATH 109,A03,093478,Ganzberger; Geoffrey Michael,1,0,34,33
1657141556315,MATH 109,B01,083215,Ganzberger; Geoffrey Michael,1,0,32,31
1657141556315,MATH 109,B02,083216,Ganzberger; Geoffrey Michael,1,0,32,31
1657141556315,MATH 109,B03,093479,Ganzberger; Geoffrey Michael,6,0,32,26
1657141562353,MATH 142A,A01,083219,Chow; Bennett,6,0,32,26
1657141562353,MATH 142A,A02,083220,Chow; Bennett,10,0,32,22
1657141562353,MATH 142A,A03,093480,Chow; Bennett,7,0,32,25
1657141562353,MATH 142A,B03,093481,Chow; Bennett,8,0,32,24
1657141562353,MATH 142A,B04,093558,Chow; Bennett,11,0,32,21
1657141562353,MATH 142A,B05,093559,Chow; Bennett,6,0,32,26
1657141568383,MATH 193A,A01,083224,Rotar; Vladimir,7,0,34,27
1657141568383,MATH 193A,A02,083225,Rotar; Vladimir,5,0,34,29
1657141568383,MATH 193A,A03,083781,Rotar; Vladimir,1,0,34,33
1657141568383,MATH 193A,A04,083782,Rotar; Vladimir,8,0,34,26
1657141568383,MATH 193A,A05,093482,Rotar; Vladimir,6,0,34,28
1657141574406,MATH 197,001,091859,McAuley; Julian John,9999,0,9999,0
1657141574406,MATH 197,002,095566,Kedlaya; Kiran S.,9997,0,9999,2
1657141574406,MATH 197,003,095567,Xiao; Ming,9999,0,9999,0
1657141574406,MATH 197,004,095571,Perols; Johan Lars,9998,0,9999,1
1657141581469,COGS 9,A01,083615,Shannon; Kyle Michael,7,0,75,68
1657141587491,COGS 11,A01,083617,Boyle; Mary E. T.,21,0,48,27
1657141593513,COGS 13,A01,083071,Bastos; Amalia Pinkusfeld,9,0,71,62
1657141599537,COGS 14A,A01,092681,Semenuks; Arturs,1,1,100,99
1657141605561,COGS 14B,A01,083073,Cheng; Tzu-Han,6,0,63,57
1657141611588,COGS 17,A01,092677,Semenuks; Arturs,4,0,81,77
1657141617611,COGS 100,A01,083619,Allen; Michael Gordon,15,0,70,55
1657141623635,COGS 101A,A01,083621,Davis; Joshua Daniel,9,0,68,59
1657141629663,COGS 101B,A01,091572,Allen; Michael Gordon,9,0,65,56
1657141635690,COGS 101C,A01,083625,Delgado; Tania,17,0,35,18
1657141641713,COGS 107A,A01,083627,Boyle; Mary E. T.,13,0,60,47
1657141647740,COGS 118A,A01,083075,Gupta; Anjum,15,0,76,61
1657141653764,CSE 3,A50,083646,Miranda; Gregory Joseph,24,0,50,26
1657141659798,CSE 8A,A50,083650,Miranda; Gregory Joseph,17,1,56,39
1657141665826,CSE 11,A01,083080,Cao; Yingjun,5,15,40,35
1657141671851,CSE 12,A01,083652,Krause-Levy; Sophia Louisa,24,1,120,96
1657141677878,CSE 15L,A01,083654,Morris; Justin Loren,9,0,50,41
1657141677878,CSE 15L,A02,083655,Morris; Justin Loren,9,0,50,41
1657141683902,CSE 20,A01,083657,Tran; Khoa Dang,38,0,80,42
1657141689929,CSE 21,A01,095574,Bach; Quang Tran,22,0,48,26
1657141695957,CSE 30,A01,083084,Eldon; John,4,0,80,76
1657141695957,CSE 30,B01,095061,Bhaskar; Nishant,7,0,50,43
1657141701980,CSE 100,A01,083659,Cao; Yingjun,4,4,70,66
1657141708008,CSE 134B,A01,083661,Powell; Thomas Allan,20,0,100,80
1657141714032,CSE 140,A01,083663,Gungor; Onat,13,0,85,72
1657141720061,CSE 140L,A01,083088,Eldon; John,17,0,100,83
1657141726086,CSE 175,A01,083665,Kumar; Rakesh,3,0,25,22
1657141732109,CSE 190,A00,092507,Dubnov; Shlomo,7,0,20,13
1657141738134,ECE 45,A01,083139,Congero; Spencer William,5,0,75,70
1657141744158,ECE 65,A50,083695,Saad; Andrew S,12,0,30,18
1657141744158,ECE 65,A51,095125,Saad; Andrew S,25,0,26,1
1657141750184,ECE 109,A01,091882,Touri; Behrouz,17,0,70,53
1657141756207,ECE 180,A00,083140,Abi Samra; Nicholas Camill,1,0,30,29
1657141756207,ECE 180,B00,083141,Abi Samra; Nicholas Camill,0,0,30,30
1657141762234,MATH 10A,A01,083735,Patchell; Gregory David,2,0,30,28
1657141762234,MATH 10A,A02,083736,Patchell; Gregory David,20,0,30,10
1657141762234,MATH 10A,A03,083737,Patchell; Gregory David,16,0,30,14
1657141768258,MATH 10B,A01,083207,Lim; Seonhee,7,0,34,27
1657141768258,MATH 10B,A02,083208,Lim; Seonhee,9,0,35,26
1657141768258,MATH 10B,A03,093472,Lim; Seonhee,5,0,34,29
1657141768258,MATH 10B,B01,083739,Sinha; Shubham,9,0,30,21
1657141774288,MATH 18,A01,083743,Cinel; Cameron Alexander,6,0,30,24
1657141774288,MATH 18,A02,083744,Cinel; Cameron Alexander,15,0,30,15
1657141774288,MATH 18,A03,083745,Cinel; Cameron Alexander,8,0,30,22
1657141774288,MATH 18,B01,083748,Rideout; David Porter,4,0,37,33
1657141774288,MATH 18,B02,083749,Rideout; David Porter,3,0,36,33
1657141774288,MATH 18,B03,083750,Rideout; David Porter,2,0,37,35
1657141774288,MATH 18,B04,083751,Rideout; David Porter,5,0,36,31
1657141774288,MATH 18,B05,093473,Rideout; David Porter,4,0,36,32
1657141774288,MATH 18,B06,093474,Rideout; David Porter,5,0,36,31
1657141780312,MATH 20A,A01,083754,Zheng; Zequn,12,0,40,28
1657141786337,MATH 20B,A01,083756,Briones; Jor-el Thomas Caparas,1,0,36,35
1657141786337,MATH 20B,A02,083757,Briones; Jor-el Thomas Caparas,1,0,36,35
1657141786337,MATH 20B,A03,093475,Briones; Jor-el Thomas Caparas,1,0,36,35
1657141792361,MATH 20C,A01,083760,Briones; Jor-el Thomas Caparas,1,0,35,34
1657141792361,MATH 20C,A02,083761,Briones; Jor-el Thomas Caparas,8,0,35,27
1657141792361,MATH 20C,A03,093476,Briones; Jor-el Thomas Caparas,0,1,36,36
1657141792361,MATH 20C,B01,083762,Bach; Quang Tran,0,0,30,30
1657141798394,MATH 20D,A01,083765,Tran; Brian Kha,4,0,30,26
1657141798394,MATH 20D,A02,083766,Tran; Brian Kha,5,0,30,25
1657141798394,MATH 20D,A03,083767,Tran; Brian Kha,3,0,30,27
1657141804422,MATH 20E,A01,083771,Ganguly; Soumya,7,0,32,25
1657141804422,MATH 20E,A02,083772,Ganguly; Soumya,7,0,32,25
1657141804422,MATH 20E,B01,083773,Ciotti; Benjamin,18,0,35,17
1657141804422,MATH 20E,B02,083774,Ciotti; Benjamin,17,0,35,18
1657141810453,MATH 103A,A01,083777,Greenfeld; Be'Eri,2,0,36,34
1657141810453,MATH 103A,A02,083778,Greenfeld; Be'Eri,5,0,36,31
1657141810453,MATH 103A,A03,093561,Greenfeld; Be'Eri,4,0,36,32
1657141810453,MATH 103A,B01,083779,Greenfeld; Be'Eri,6,0,36,30
1657141810453,MATH 103A,B02,083780,Greenfeld; Be'Eri,3,0,36,33
1657141810453,MATH 103A,B03,093562,Greenfeld; Be'Eri,3,0,36,33
1657141816476,MATH 105,A01,085443,Carter; Anne Toulson,14,0,35,21
1657141816476,MATH 105,A02,093477,Carter; Anne Toulson,20,0,35,15
1657141822512,MATH 109,A01,083213,Ganzberger; Geoffrey Michael,2,0,34,32
1657141822512,MATH 109,A02,083214,Ganzberger; Geoffrey Michael,3,0,34,31
1657141822512,MATH 109,A03,093478,Ganzberger; Geoffrey Michael,1,0,34,33
1657141822512,MATH 109,B01,083215,Ganzberger; Geoffrey Michael,1,0,32,31
1657141822512,MATH 109,B02,083216,Ganzberger; Geoffrey Michael,1,0,32,31
1657141822512,MATH 109,B03,093479,Ganzberger; Geoffrey Michael,6,0,32,26
1657141828535,MATH 142A,A01,083219,Chow; Bennett,6,0,32,26
1657141828535,MATH 142A,A02,083220,Chow; Bennett,10,0,32,22
1657141828535,MATH 142A,A03,093480,Chow; Bennett,7,0,32,25
1657141828535,MATH 142A,B03,093481,Chow; Bennett,8,0,32,24
1657141828535,MATH 142A,B04,093558,Chow; Bennett,11,0,32,21
1657141828535,MATH 142A,B05,093559,Chow; Bennett,6,0,32,26
1657141834568,MATH 193A,A01,083224,Rotar; Vladimir,7,0,34,27
1657141834568,MATH 193A,A02,083225,Rotar; Vladimir,5,0,34,29
1657141834568,MATH 193A,A03,083781,Rotar; Vladimir,1,0,34,33
1657141834568,MATH 193A,A04,083782,Rotar; Vladimir,8,0,34,26
1657141834568,MATH 193A,A05,093482,Rotar; Vladimir,6,0,34,28
1657141840591,MATH 197,001,091859,McAuley; Julian John,9999,0,9999,0
1657141840591,MATH 197,002,095566,Kedlaya; Kiran S.,9997,0,9999,2
1657141840591,MATH 197,003,095567,Xiao; Ming,9999,0,9999,0
1657141840591,MATH 197,004,095571,Perols; Johan Lars,9998,0,9999,1
1657141847662,COGS 9,A01,083615,Shannon; Kyle Michael,7,0,75,68
1657141853686,COGS 11,A01,083617,Boyle; Mary E. T.,21,0,48,27
1657141859710,COGS 13,A01,083071,Bastos; Amalia Pinkusfeld,9,0,71,62
1657141865733,COGS 14A,A01,092681,Semenuks; Arturs,1,1,100,99
1657141871755,COGS 14B,A01,083073,Cheng; Tzu-Han,6,0,63,57
1657141877777,COGS 17,A01,092677,Semenuks; Arturs,4,0,81,77
1657141883806,COGS 100,A01,083619,Allen; Michael Gordon,15,0,70,55
1657141889833,COGS 101A,A01,083621,Davis; Joshua Daniel,9,0,68,59
1657141895860,COGS 101B,A01,091572,Allen; Michael Gordon,9,0,65,56
1657141901886,COGS 101C,A01,083625,Delgado; Tania,17,0,35,18
1657141907911,COGS 107A,A01,083627,Boyle; Mary E. T.,13,0,60,47
1657141913937,COGS 118A,A01,083075,Gupta; Anjum,15,0,76,61
1657141919961,CSE 3,A50,083646,Miranda; Gregory Joseph,24,0,50,26
1657141925984,CSE 8A,A50,083650,Miranda; Gregory Joseph,17,1,56,39
1657141932008,CSE 11,A01,083080,Cao; Yingjun,5,15,40,35
1657141938037,CSE 12,A01,083652,Krause-Levy; Sophia Louisa,24,1,120,96
1657141944063,CSE 15L,A01,083654,Morris; Justin Loren,9,0,50,41
1657141944063,CSE 15L,A02,083655,Morris; Justin Loren,9,0,50,41
1657141950085,CSE 20,A01,083657,Tran; Khoa Dang,38,0,80,42
1657141956112,CSE 21,A01,095574,Bach; Quang Tran,22,0,48,26
1657141962135,CSE 30,A01,083084,Eldon; John,4,0,80,76
1657141962135,CSE 30,B01,095061,Bhaskar; Nishant,7,0,50,43
1657141968167,CSE 100,A01,083659,Cao; Yingjun,4,4,70,66
1657141974204,CSE 134B,A01,083661,Powell; Thomas Allan,20,0,100,80
1657141989857,CSE 140,A01,083663,Gungor; Onat,13,0,85,72
1657141995887,CSE 140L,A01,083088,Eldon; John,17,0,100,83
1657142001914,CSE 175,A01,083665,Kumar; Rakesh,3,0,25,22
1657142007942,CSE 190,A00,092507,Dubnov; Shlomo,7,0,20,13
1657142014066,ECE 45,A01,083139,Congero; Spencer William,5,0,75,70
1657142020089,ECE 65,A50,083695,Saad; Andrew S,12,0,30,18
1657142020089,ECE 65,A51,095125,Saad; Andrew S,25,0,26,1
1657142026114,ECE 109,A01,091882,Touri; Behrouz,17,0,70,53
1657142032144,ECE 180,A00,083140,Abi Samra; Nicholas Camill,1,0,30,29
1657142032144,ECE 180,B00,083141,Abi Samra; Nicholas Camill,0,0,30,30
1657142038172,MATH 10A,A01,083735,Patchell; Gregory David,2,0,30,28
1657142038172,MATH 10A,A02,083736,Patchell; Gregory David,20,0,30,10
1657142038172,MATH 10A,A03,083737,Patchell; Gregory David,16,0,30,14
1657142044204,MATH 10B,A01,083207,Lim; Seonhee,7,0,34,27
1657142044204,MATH 10B,A02,083208,Lim; Seonhee,9,0,35,26
1657142044204,MATH 10B,A03,093472,Lim; Seonhee,5,0,34,29
1657142044204,MATH 10B,B01,083739,Sinha; Shubham,9,0,30,21
1657142050235,MATH 18,A01,083743,Cinel; Cameron Alexander,6,0,30,24
1657142050235,MATH 18,A02,083744,Cinel; Cameron Alexander,15,0,30,15
1657142050235,MATH 18,A03,083745,Cinel; Cameron Alexander,8,0,30,22
1657142050235,MATH 18,B01,083748,Rideout; David Porter,4,0,37,33
1657142050235,MATH 18,B02,083749,Rideout; David Porter,3,0,36,33
1657142050235,MATH 18,B03,083750,Rideout; David Porter,2,0,37,35
1657142050235,MATH 18,B04,083751,Rideout; David Porter,5,0,36,31
1657142050235,MATH 18,B05,093473,Rideout; David Porter,4,0,36,32
1657142050235,MATH 18,B06,093474,Rideout; David Porter,5,0,36,31
1657142056265,MATH 20A,A01,083754,Zheng; Zequn,12,0,40,28
1657142062290,MATH 20B,A01,083756,Briones; Jor-el Thomas Caparas,1,0,36,35
1657142062290,MATH 20B,A02,083757,Briones; Jor-el Thomas Caparas,1,0,36,35
1657142062290,MATH 20B,A03,093475,Briones; Jor-el Thomas Caparas,1,0,36,35
1657142068319,MATH 20C,A01,083760,Briones; Jor-el Thomas Caparas,1,0,35,34
1657142068319,MATH 20C,A02,083761,Briones; Jor-el Thomas Caparas,8,0,35,27
1657142068319,MATH 20C,A03,093476,Briones; Jor-el Thomas Caparas,0,1,36,36
1657142068319,MATH 20C,B01,083762,Bach; Quang Tran,0,0,30,30
1657142074357,MATH 20D,A01,083765,Tran; Brian Kha,4,0,30,26
1657142074357,MATH 20D,A02,083766,Tran; Brian Kha,5,0,30,25
1657142074357,MATH 20D,A03,083767,Tran; Brian Kha,3,0,30,27
1657142080383,MATH 20E,A01,083771,Ganguly; Soumya,7,0,32,25
1657142080383,MATH 20E,A02,083772,Ganguly; Soumya,7,0,32,25
1657142080383,MATH 20E,B01,083773,Ciotti; Benjamin,18,0,35,17
1657142080383,MATH 20E,B02,083774,Ciotti; Benjamin,17,0,35,18
1657142086412,MATH 103A,A01,083777,Greenfeld; Be'Eri,2,0,36,34
1657142086412,MATH 103A,A02,083778,Greenfeld; Be'Eri,5,0,36,31
1657142086412,MATH 103A,A03,093561,Greenfeld; Be'Eri,4,0,36,32
1657142086412,MATH 103A,B01,083779,Greenfeld; Be'Eri,6,0,36,30
1657142086412,MATH 103A,B02,083780,Greenfeld; Be'Eri,3,0,36,33
1657142086412,MATH 103A,B03,093562,Greenfeld; Be'Eri,3,0,36,33
1657142092439,MATH 105,A01,085443,Carter; Anne Toulson,14,0,35,21
1657142092439,MATH 105,A02,093477,Carter; Anne Toulson,20,0,35,15
1657142098475,MATH 109,A01,083213,Ganzberger; Geoffrey Michael,2,0,34,32
1657142098475,MATH 109,A02,083214,Ganzberger; Geoffrey Michael,3,0,34,31
1657142098475,MATH 109,A03,093478,Ganzberger; Geoffrey Michael,1,0,34,33
1657142098475,MATH 109,B01,083215,Ganzberger; Geoffrey Michael,1,0,32,31
1657142098475,MATH 109,B02,083216,Ganzberger; Geoffrey Michael,1,0,32,31
1657142098475,MATH 109,B03,093479,Ganzberger; Geoffrey Michael,6,0,32,26
1657142104503,MATH 142A,A01,083219,Chow; Bennett,6,0,32,26
1657142104503,MATH 142A,A02,083220,Chow; Bennett,10,0,32,22
1657142104503,MATH 142A,A03,093480,Chow; Bennett,7,0,32,25
1657142104503,MATH 142A,B03,093481,Chow; Bennett,8,0,32,24
1657142104503,MATH 142A,B04,093558,Chow; Bennett,11,0,32,21
1657142104503,MATH 142A,B05,093559,Chow; Bennett,6,0,32,26
1657142110526,MATH 193A,A01,083224,Rotar; Vladimir,7,0,34,27
1657142110526,MATH 193A,A02,083225,Rotar; Vladimir,5,0,34,29
1657142110526,MATH 193A,A03,083781,Rotar; Vladimir,1,0,34,33
1657142110526,MATH 193A,A04,083782,Rotar; Vladimir,8,0,34,26
1657142110526,MATH 193A,A05,093482,Rotar; Vladimir,6,0,34,28
1657142116548,MATH 197,001,091859,McAuley; Julian John,9999,0,9999,0
1657142116548,MATH 197,002,095566,Kedlaya; Kiran S.,9997,0,9999,2
1657142116548,MATH 197,003,095567,Xiao; Ming,9999,0,9999,0
1657142116548,MATH 197,004,095571,Perols; Johan Lars,9998,0,9999,1
1657142123622,COGS 9,A01,083615,Shannon; Kyle Michael,7,0,75,68
1657142129650,COGS 11,A01,083617,Boyle; Mary E. T.,21,0,48,27
1657142135672,COGS 13,A01,083071,Bastos; Amalia Pinkusfeld,9,0,71,62
1657142141693,COGS 14A,A01,092681,Semenuks; Arturs,1,1,100,99
1657142147719,COGS 14B,A01,083073,Cheng; Tzu-Han,6,0,63,57
1657142153744,COGS 17,A01,092677,Semenuks; Arturs,4,0,81,77
1657142159768,COGS 100,A01,083619,Allen; Michael Gordon,15,0,70,55
1657142165791,COGS 101A,A01,083621,Davis; Joshua Daniel,9,0,68,59
1657142171824,COGS 101B,A01,091572,Allen; Michael Gordon,9,0,65,56
1657142177848,COGS 101C,A01,083625,Delgado; Tania,17,0,35,18
1657142183873,COGS 107A,A01,083627,Boyle; Mary E. T.,13,0,60,47
1657142189895,COGS 118A,A01,083075,Gupta; Anjum,15,0,76,61
1657142195918,CSE 3,A50,083646,Miranda; Gregory Joseph,24,0,50,26
1657142201944,CSE 8A,A50,083650,Miranda; Gregory Joseph,17,1,56,39
1657142207976,CSE 11,A01,083080,Cao; Yingjun,5,15,40,35
1657142214005,CSE 12,A01,083652,Krause-Levy; Sophia Louisa,24,1,120,96
1657142220028,CSE 15L,A01,083654,Morris; Justin Loren,9,0,50,41
1657142220028,CSE 15L,A02,083655,Morris; Justin Loren,9,0,50,41
1657142226058,CSE 20,A01,083657,Tran; Khoa Dang,38,0,80,42
1657142232099,CSE 21,A01,095574,Bach; Quang Tran,22,0,48,26
1657142238122,CSE 30,A01,083084,Eldon; John,4,0,80,76
1657142238122,CSE 30,B01,095061,Bhaskar; Nishant,7,0,50,43
1657142244146,CSE 100,A01,083659,Cao; Yingjun,4,4,70,66
1657142250176,CSE 134B,A01,083661,Powell; Thomas Allan,20,0,100,80
1657142256207,CSE 140,A01,083663,Gungor; Onat,13,0,85,72
1657142262232,CSE 140L,A01,083088,Eldon; John,17,0,100,83
1657142268256,CSE 175,A01,083665,Kumar; Rakesh,3,0,25,22
1657142274281,CSE 190,A00,092507,Dubnov; Shlomo,7,0,20,13
1657142280303,ECE 45,A01,083139,Congero; Spencer William,5,0,75,70
1657142286325,ECE 65,A50,083695,Saad; Andrew S,12,0,30,18
1657142286325,ECE 65,A51,095125,Saad; Andrew S,25,0,26,1
1657142292348,ECE 109,A01,091882,Touri; Behrouz,17,0,70,53
1657142298375,ECE 180,A00,083140,Abi Samra; Nicholas Camill,1,0,30,29
1657142298375,ECE 180,B00,083141,Abi Samra; Nicholas Camill,0,0,30,30
1657142304408,MATH 10A,A01,083735,Patchell; Gregory David,2,0,30,28
1657142304408,MATH 10A,A02,083736,Patchell; Gregory David,20,0,30,10
1657142304408,MATH 10A,A03,083737,Patchell; Gregory David,16,0,30,14
1657142310436,MATH 10B,A01,083207,Lim; Seonhee,7,0,34,27
1657142310436,MATH 10B,A02,083208,Lim; Seonhee,9,0,35,26
1657142310436,MATH 10B,A03,093472,Lim; Seonhee,5,0,34,29
1657142310436,MATH 10B,B01,083739,Sinha; Shubham,9,0,30,21
1657142316466,MATH 18,A01,083743,Cinel; Cameron Alexander,6,0,30,24
1657142316466,MATH 18,A02,083744,Cinel; Cameron Alexander,15,0,30,15
1657142316466,MATH 18,A03,083745,Cinel; Cameron Alexander,8,0,30,22
1657142316466,MATH 18,B01,083748,Rideout; David Porter,4,0,37,33
1657142316466,MATH 18,B02,083749,Rideout; David Porter,3,0,36,33
1657142316466,MATH 18,B03,083750,Rideout; David Porter,2,0,37,35
1657142316466,MATH 18,B04,083751,Rideout; David Porter,5,0,36,31
1657142316466,MATH 18,B05,093473,Rideout; David Porter,4,0,36,32
1657142316466,MATH 18,B06,093474,Rideout; David Porter,5,0,36,31
1657142322500,MATH 20A,A01,083754,Zheng; Zequn,12,0,40,28
1657142328527,MATH 20B,A01,083756,Briones; Jor-el Thomas Caparas,1,0,36,35
1657142328527,MATH 20B,A02,083757,Briones; Jor-el Thomas Caparas,1,0,36,35
1657142328527,MATH 20B,A03,093475,Briones; Jor-el Thomas Caparas,1,0,36,35
1657142334551,MATH 20C,A01,083760,Briones; Jor-el Thomas Caparas,1,0,35,34
1657142334551,MATH 20C,A02,083761,Briones; Jor-el Thomas Caparas,8,0,35,27
1657142334551,MATH 20C,A03,093476,Briones; Jor-el Thomas Caparas,0,1,36,36
1657142334551,MATH 20C,B01,083762,Bach; Quang Tran,0,0,30,30
1657142340579,MATH 20D,A01,083765,Tran; Brian Kha,4,0,30,26
1657142340579,MATH 20D,A02,083766,Tran; Brian Kha,5,0,30,25
1657142340579,MATH 20D,A03,083767,Tran; Brian Kha,3,0,30,27
1657142346612,MATH 20E,A01,083771,Ganguly; Soumya,7,0,32,25
1657142346612,MATH 20E,A02,083772,Ganguly; Soumya,7,0,32,25
1657142346612,MATH 20E,B01,083773,Ciotti; Benjamin,18,0,35,17
1657142346612,MATH 20E,B02,083774,Ciotti; Benjamin,17,0,35,18
1657142352645,MATH 103A,A01,083777,Greenfeld; Be'Eri,2,0,36,34
1657142352645,MATH 103A,A02,083778,Greenfeld; Be'Eri,5,0,36,31
1657142352645,MATH 103A,A03,093561,Greenfeld; Be'Eri,4,0,36,32
1657142352645,MATH 103A,B01,083779,Greenfeld; Be'Eri,6,0,36,30
1657142352645,MATH 103A,B02,083780,Greenfeld; Be'Eri,3,0,36,33
1657142352645,MATH 103A,B03,093562,Greenfeld; Be'Eri,3,0,36,33
1657142358668,MATH 105,A01,085443,Carter; Anne Toulson,14,0,35,21
1657142358668,MATH 105,A02,093477,Carter; Anne Toulson,20,0,35,15
1657142364693,MATH 109,A01,083213,Ganzberger; Geoffrey Michael,2,0,34,32
1657142364693,MATH 109,A02,083214,Ganzberger; Geoffrey Michael,3,0,34,31
1657142364693,MATH 109,A03,093478,Ganzberger; Geoffrey Michael,1,0,34,33
1657142364693,MATH 109,B01,083215,Ganzberger; Geoffrey Michael,1,0,32,31
1657142364693,MATH 109,B02,083216,Ganzberger; Geoffrey Michael,1,0,32,31
1657142364693,MATH 109,B03,093479,Ganzberger; Geoffrey Michael,6,0,32,26
1657142370718,MATH 142A,A01,083219,Chow; Bennett,6,0,32,26
1657142370718,MATH 142A,A02,083220,Chow; Bennett,10,0,32,22
1657142370718,MATH 142A,A03,093480,Chow; Bennett,7,0,32,25
1657142370718,MATH 142A,B03,093481,Chow; Bennett,8,0,32,24
1657142370718,MATH 142A,B04,093558,Chow; Bennett,11,0,32,21
1657142370718,MATH 142A,B05,093559,Chow; Bennett,6,0,32,26
1657142376741,MATH 193A,A01,083224,Rotar; Vladimir,7,0,34,27
1657142376741,MATH 193A,A02,083225,Rotar; Vladimir,5,0,34,29
1657142376741,MATH 193A,A03,083781,Rotar; Vladimir,1,0,34,33
1657142376741,MATH 193A,A04,083782,Rotar; Vladimir,8,0,34,26
1657142376741,MATH 193A,A05,093482,Rotar; Vladimir,6,0,34,28
1657142382763,MATH 197,001,091859,McAuley; Julian John,9999,0,9999,0
1657142382763,MATH 197,002,095566,Kedlaya; Kiran S.,9997,0,9999,2
1657142382763,MATH 197,003,095567,Xiao; Ming,9999,0,9999,0
1657142382763,MATH 197,004,095571,Perols; Johan Lars,9998,0,9999,1
1657142389824,COGS 9,A01,083615,Shannon; Kyle Michael,7,0,75,68
1657142395852,COGS 11,A01,083617,Boyle; Mary E. T.,21,0,48,27
1657142401879,COGS 13,A01,083071,Bastos; Amalia Pinkusfeld,9,0,71,62
1657142407904,COGS 14A,A01,092681,Semenuks; Arturs,1,1,100,99
1657142413928,COGS 14B,A01,083073,Cheng; Tzu-Han,6,0,63,57
1657142419959,COGS 17,A01,092677,Semenuks; Arturs,4,0,81,77
1657142425995,COGS 100,A01,083619,Allen; Michael Gordon,15,0,70,55
1657142432019,COGS 101A,A01,083621,Davis; Joshua Daniel,9,0,68,59
1657142438046,COGS 101B,A01,091572,Allen; Michael Gordon,9,0,65,56
1657142444069,COGS 101C,A01,083625,Delgado; Tania,17,0,35,18
1657142450097,COGS 107A,A01,083627,Boyle; Mary E. T.,13,0,60,47
1657142456124,COGS 118A,A01,083075,Gupta; Anjum,15,0,76,61
1657142462153,CSE 3,A50,083646,Miranda; Gregory Joseph,24,0,50,26
1657142468189,CSE 8A,A50,083650,Miranda; Gregory Joseph,17,1,56,39
1657142474214,CSE 11,A01,083080,Cao; Yingjun,5,15,40,35
1657142480245,CSE 12,A01,083652,Krause-Levy; Sophia Louisa,24,1,120,96
1657142486269,CSE 15L,A01,083654,Morris; Justin Loren,9,0,50,41
1657142486269,CSE 15L,A02,083655,Morris; Justin Loren,9,0,50,41
1657142492294,CSE 20,A01,083657,Tran; Khoa Dang,38,0,80,42
1657142498322,CSE 21,A01,095574,Bach; Quang Tran,22,0,48,26
1657142504346,CSE 30,A01,083084,Eldon; John,4,0,80,76
1657142504346,CSE 30,B01,095061,Bhaskar; Nishant,7,0,50,43
1657142510367,CSE 100,A01,083659,Cao; Yingjun,4,4,70,66
1657142516396,CSE 134B,A01,083661,Powell; Thomas Allan,20,0,100,80
1657142522424,CSE 140,A01,083663,Gungor; Onat,13,0,85,72
1657142528451,CSE 140L,A01,083088,Eldon; John,17,0,100,83
1657142534477,CSE 175,A01,083665,Kumar; Rakesh,3,0,25,22
1657142540510,CSE 190,A00,092507,Dubnov; Shlomo,7,0,20,13
1657142546541,ECE 45,A01,083139,Congero; Spencer William,5,0,75,70
1657142552567,ECE 65,A50,083695,Saad; Andrew S,12,0,30,18
1657142552567,ECE 65,A51,095125,Saad; Andrew S,25,0,26,1
1657142558590,ECE 109,A01,091882,Touri; Behrouz,17,0,70,53
1657142564616,ECE 180,A00,083140,Abi Samra; Nicholas Camill,1,0,30,29
1657142564616,ECE 180,B00,083141,Abi Samra; Nicholas Camill,0,0,30,30
1657142570639,MATH 10A,A01,083735,Patchell; Gregory David,2,0,30,28
1657142570639,MATH 10A,A02,083736,Patchell; Gregory David,20,0,30,10
1657142570639,MATH 10A,A03,083737,Patchell; Gregory David,16,0,30,14
1657142576669,MATH 10B,A01,083207,Lim; Seonhee,7,0,34,27
1657142576669,MATH 10B,A02,083208,Lim; Seonhee,9,0,35,26
1657142576669,MATH 10B,A03,093472,Lim; Seonhee,5,0,34,29
1657142576669,MATH 10B,B01,083739,Sinha; Shubham,9,0,30,21
1657142582702,MATH 18,A01,083743,Cinel; Cameron Alexander,6,0,30,24
1657142582702,MATH 18,A02,083744,Cinel; Cameron Alexander,15,0,30,15
1657142582702,MATH 18,A03,083745,Cinel; Cameron Alexander,8,0,30,22
1657142582702,MATH 18,B01,083748,Rideout; David Porter,4,0,37,33
1657142582702,MATH 18,B02,083749,Rideout; David Porter,3,0,36,33
1657142582702,MATH 18,B03,083750,Rideout; David Porter,2,0,37,35
1657142582702,MATH 18,B04,083751,Rideout; David Porter,5,0,36,31
1657142582702,MATH 18,B05,093473,Rideout; David Porter,4,0,36,32
1657142582702,MATH 18,B06,093474,Rideout; David Porter,5,0,36,31
1657142588728,MATH 20A,A01,083754,Zheng; Zequn,12,0,40,28
1657142594753,MATH 20B,A01,083756,Briones; Jor-el Thomas Caparas,1,0,36,35
1657142594753,MATH 20B,A02,083757,Briones; Jor-el Thomas Caparas,1,0,36,35
1657142594753,MATH 20B,A03,093475,Briones; Jor-el Thomas Caparas,1,0,36,35
1657142600787,MATH 20C,A01,083760,Briones; Jor-el Thomas Caparas,1,0,35,34
1657142600787,MATH 20C,A02,083761,Briones; Jor-el Thomas Caparas,8,0,35,27
1657142600787,MATH 20C,A03,093476,Briones; Jor-el Thomas Caparas,0,1,36,36
1657142600787,MATH 20C,B01,083762,Bach; Quang Tran,0,0,30,30
1657142606831,MATH 20D,A01,083765,Tran; Brian Kha,4,0,30,26
1657142606831,MATH 20D,A02,083766,Tran; Brian Kha,5,0,30,25
1657142606831,MATH 20D,A03,083767,Tran; Brian Kha,3,0,30,27
1657142612956,MATH 20E,A01,083771,Ganguly; Soumya,7,0,32,25
1657142612956,MATH 20E,A02,083772,Ganguly; Soumya,7,0,32,25
1657142612956,MATH 20E,B01,083773,Ciotti; Benjamin,18,0,35,17
1657142612956,MATH 20E,B02,083774,Ciotti; Benjamin,17,0,35,18
1657142618984,MATH 103A,A01,083777,Greenfeld; Be'Eri,2,0,36,34
1657142618984,MATH 103A,A02,083778,Greenfeld; Be'Eri,5,0,36,31
1657142618984,MATH 103A,A03,093561,Greenfeld; Be'Eri,4,0,36,32
1657142618984,MATH 103A,B01,083779,Greenfeld; Be'Eri,6,0,36,30
1657142618984,MATH 103A,B02,083780,Greenfeld; Be'Eri,3,0,36,33
1657142618984,MATH 103A,B03,093562,Greenfeld; Be'Eri,3,0,36,33
1657142625017,MATH 105,A01,085443,Carter; Anne Toulson,14,0,35,21
1657142625017,MATH 105,A02,093477,Carter; Anne Toulson,20,0,35,15
1657142631041,MATH 109,A01,083213,Ganzberger; Geoffrey Michael,2,0,34,32
1657142631041,MATH 109,A02,083214,Ganzberger; Geoffrey Michael,3,0,34,31
1657142631041,MATH 109,A03,093478,Ganzberger; Geoffrey Michael,1,0,34,33
1657142631041,MATH 109,B01,083215,Ganzberger; Geoffrey Michael,1,0,32,31
1657142631041,MATH 109,B02,083216,Ganzberger; Geoffrey Michael,1,0,32,31
1657142631041,MATH 109,B03,093479,Ganzberger; Geoffrey Michael,6,0,32,26
1657142637064,MATH 142A,A01,083219,Chow; Bennett,6,0,32,26
1657142637064,MATH 142A,A02,083220,Chow; Bennett,10,0,32,22
1657142637064,MATH 142A,A03,093480,Chow; Bennett,7,0,32,25
1657142637064,MATH 142A,B03,093481,Chow; Bennett,8,0,32,24
1657142637064,MATH 142A,B04,093558,Chow; Bennett,11,0,32,21
1657142637064,MATH 142A,B05,093559,Chow; Bennett,6,0,32,26
1657142643092,MATH 193A,A01,083224,Rotar; Vladimir,7,0,34,27
1657142643092,MATH 193A,A02,083225,Rotar; Vladimir,5,0,34,29
1657142643092,MATH 193A,A03,083781,Rotar; Vladimir,1,0,34,33
1657142643092,MATH 193A,A04,083782,Rotar; Vladimir,8,0,34,26
1657142643092,MATH 193A,A05,093482,Rotar; Vladimir,6,0,34,28
1657142649113,MATH 197,001,091859,McAuley; Julian John,9999,0,9999,0
1657142649113,MATH 197,002,095566,Kedlaya; Kiran S.,9997,0,9999,2
1657142649113,MATH 197,003,095567,Xiao; Ming,9999,0,9999,0
1657142649113,MATH 197,004,095571,Perols; Johan Lars,9998,0,9999,1
1657142656175,COGS 9,A01,083615,Shannon; Kyle Michael,7,0,75,68
1657142662198,COGS 11,A01,083617,Boyle; Mary E. T.,21,0,48,27
1657142668222,COGS 13,A01,083071,Bastos; Amalia Pinkusfeld,9,0,71,62
1657142674255,COGS 14A,A01,092681,Semenuks; Arturs,1,1,100,99
1657142680320,COGS 14B,A01,083073,Cheng; Tzu-Han,6,0,63,57
1657142686342,COGS 17,A01,092677,Semenuks; Arturs,4,0,81,77
1657142692365,COGS 100,A01,083619,Allen; Michael Gordon,15,0,70,55
1657142698390,COGS 101A,A01,083621,Davis; Joshua Daniel,9,0,68,59
1657142704418,COGS 101B,A01,091572,Allen; Michael Gordon,9,0,65,56
1657142710444,COGS 101C,A01,083625,Delgado; Tania,17,0,35,18
1657142716470,COGS 107A,A01,083627,Boyle; Mary E. T.,13,0,60,47
1657142722500,COGS 118A,A01,083075,Gupta; Anjum,15,0,76,61
1657142728527,CSE 3,A50,083646,Miranda; Gregory Joseph,24,0,50,26
1657142734553,CSE 8A,A50,083650,Miranda; Gregory Joseph,17,1,56,39
1657142740576,CSE 11,A01,083080,Cao; Yingjun,5,15,40,35
1657142746602,CSE 12,A01,083652,Krause-Levy; Sophia Louisa,24,1,120,96
1657142752626,CSE 15L,A01,083654,Morris; Justin Loren,9,0,50,41
1657142752626,CSE 15L,A02,083655,Morris; Justin Loren,9,0,50,41
1657142758647,CSE 20,A01,083657,Tran; Khoa Dang,38,0,80,42
1657142764676,CSE 21,A01,095574,Bach; Quang Tran,22,0,48,26
1657142770711,CSE 30,A01,083084,Eldon; John,4,0,80,76
1657142770711,CSE 30,B01,095061,Bhaskar; Nishant,7,0,50,43
1657142776737,CSE 100,A01,083659,Cao; Yingjun,4,4,70,66
1657142782759,CSE 134B,A01,083661,Powell; Thomas Allan,20,0,100,80
1657142788782,CSE 140,A01,083663,Gungor; Onat,13,0,85,72
1657142794804,CSE 140L,A01,083088,Eldon; John,17,0,100,83
1657142800826,CSE 175,A01,083665,Kumar; Rakesh,3,0,25,22
1657142806850,CSE 190,A00,092507,Dubnov; Shlomo,7,0,20,13
1657142812883,ECE 45,A01,083139,Congero; Spencer William,5,0,75,70
1657142818907,ECE 65,A50,083695,Saad; Andrew S,12,0,30,18
1657142818907,ECE 65,A51,095125,Saad; Andrew S,25,0,26,1
1657142824930,ECE 109,A01,091882,Touri; Behrouz,17,0,70,53
1657142830957,ECE 180,A00,083140,Abi Samra; Nicholas Camill,1,0,30,29
1657142830957,ECE 180,B00,083141,Abi Samra; Nicholas Camill,0,0,30,30
1657142836986,MATH 10A,A01,083735,Patchell; Gregory David,2,0,30,28
1657142836986,MATH 10A,A02,083736,Patchell; Gregory David,20,0,30,10
1657142836986,MATH 10A,A03,083737,Patchell; Gregory David,16,0,30,14
1657142843011,MATH 10B,A01,083207,Lim; Seonhee,7,0,34,27
1657142843011,MATH 10B,A02,083208,Lim; Seonhee,9,0,35,26
1657142843011,MATH 10B,A03,093472,Lim; Seonhee,5,0,34,29
1657142843011,MATH 10B,B01,083739,Sinha; Shubham,9,0,30,21
1657142849036,MATH 18,A01,083743,Cinel; Cameron Alexander,6,0,30,24
1657142849036,MATH 18,A02,083744,Cinel; Cameron Alexander,15,0,30,15
1657142849036,MATH 18,A03,083745,Cinel; Cameron Alexander,8,0,30,22
1657142849036,MATH 18,B01,083748,Rideout; David Porter,4,0,37,33
1657142849036,MATH 18,B02,083749,Rideout; David Porter,3,0,36,33
1657142849036,MATH 18,B03,083750,Rideout; David Porter,2,0,37,35
1657142849036,MATH 18,B04,083751,Rideout; David Porter,5,0,36,31
1657142849036,MATH 18,B05,093473,Rideout; David Porter,4,0,36,32
1657142849036,MATH 18,B06,093474,Rideout; David Porter,5,0,36,31
1657142855066,MATH 20A,A01,083754,Zheng; Zequn,12,0,40,28
1657142861095,MATH 20B,A01,083756,Briones; Jor-el Thomas Caparas,1,0,36,35
1657142861095,MATH 20B,A02,083757,Briones; Jor-el Thomas Caparas,1,0,36,35
1657142861095,MATH 20B,A03,093475,Briones; Jor-el Thomas Caparas,1,0,36,35
1657142867118,MATH 20C,A01,083760,Briones; Jor-el Thomas Caparas,1,0,35,34
1657142867118,MATH 20C,A02,083761,Briones; Jor-el Thomas Caparas,8,0,35,27
1657142867118,MATH 20C,A03,093476,Briones; Jor-el Thomas Caparas,0,1,36,36
1657142867118,MATH 20C,B01,083762,Bach; Quang Tran,0,0,30,30
1657142873142,MATH 20D,A01,083765,Tran; Brian Kha,4,0,30,26
1657142873142,MATH 20D,A02,083766,Tran; Brian Kha,5,0,30,25
1657142873142,MATH 20D,A03,083767,Tran; Brian Kha,3,0,30,27
1657142879166,MATH 20E,A01,083771,Ganguly; Soumya,7,0,32,25
1657142879166,MATH 20E,A02,083772,Ganguly; Soumya,7,0,32,25
1657142879166,MATH 20E,B01,083773,Ciotti; Benjamin,18,0,35,17
1657142879166,MATH 20E,B02,083774,Ciotti; Benjamin,17,0,35,18
1657142885197,MATH 103A,A01,083777,Greenfeld; Be'Eri,2,0,36,34
1657142885197,MATH 103A,A02,083778,Greenfeld; Be'Eri,5,0,36,31
1657142885197,MATH 103A,A03,093561,Greenfeld; Be'Eri,4,0,36,32
1657142885197,MATH 103A,B01,083779,Greenfeld; Be'Eri,6,0,36,30
1657142885197,MATH 103A,B02,083780,Greenfeld; Be'Eri,3,0,36,33
1657142885197,MATH 103A,B03,093562,Greenfeld; Be'Eri,3,0,36,33
1657142891224,MATH 105,A01,085443,Carter; Anne Toulson,14,0,35,21
1657142891224,MATH 105,A02,093477,Carter; Anne Toulson,20,0,35,15
1657142897246,MATH 109,A01,083213,Ganzberger; Geoffrey Michael,2,0,34,32
1657142897246,MATH 109,A02,083214,Ganzberger; Geoffrey Michael,3,0,34,31
1657142897246,MATH 109,A03,093478,Ganzberger; Geoffrey Michael,1,0,34,33
1657142897246,MATH 109,B01,083215,Ganzberger; Geoffrey Michael,1,0,32,31
1657142897246,MATH 109,B02,083216,Ganzberger; Geoffrey Michael,1,0,32,31
1657142897246,MATH 109,B03,093479,Ganzberger; Geoffrey Michael,6,0,32,26
1657142903277,MATH 142A,A01,083219,Chow; Bennett,6,0,32,26
1657142903277,MATH 142A,A02,083220,Chow; Bennett,10,0,32,22
1657142903277,MATH 142A,A03,093480,Chow; Bennett,7,0,32,25
1657142903277,MATH 142A,B03,093481,Chow; Bennett,8,0,32,24
1657142903277,MATH 142A,B04,093558,Chow; Bennett,11,0,32,21
1657142903277,MATH 142A,B05,093559,Chow; Bennett,6,0,32,26
1657142909305,MATH 193A,A01,083224,Rotar; Vladimir,7,0,34,27
1657142909305,MATH 193A,A02,083225,Rotar; Vladimir,5,0,34,29
1657142909305,MATH 193A,A03,083781,Rotar; Vladimir,1,0,34,33
1657142909305,MATH 193A,A04,083782,Rotar; Vladimir,8,0,34,26
1657142909305,MATH 193A,A05,093482,Rotar; Vladimir,6,0,34,28
1657142915327,MATH 197,001,091859,McAuley; Julian John,9999,0,9999,0
1657142915327,MATH 197,002,095566,Kedlaya; Kiran S.,9997,0,9999,2
1657142915327,MATH 197,003,095567,Xiao; Ming,9999,0,9999,0
1657142915327,MATH 197,004,095571,Perols; Johan Lars,9998,0,9999,1
1657142922377,COGS 9,A01,083615,Shannon; Kyle Michael,7,0,75,68
1657142928401,COGS 11,A01,083617,Boyle; Mary E. T.,21,0,48,27
1657142934425,COGS 13,A01,083071,Bastos; Amalia Pinkusfeld,9,0,71,62
1657142940452,COGS 14A,A01,092681,Semenuks; Arturs,1,1,100,99
1657142946474,COGS 14B,A01,083073,Cheng; Tzu-Han,6,0,63,57
1657142952497,COGS 17,A01,092677,Semenuks; Arturs,4,0,81,77
1657142958520,COGS 100,A01,083619,Allen; Michael Gordon,15,0,70,55
1657142964543,COGS 101A,A01,083621,Davis; Joshua Daniel,9,0,68,59
1657142970583,COGS 101B,A01,091572,Allen; Michael Gordon,9,0,65,56
1657142976612,COGS 101C,A01,083625,Delgado; Tania,17,0,35,18
1657142982635,COGS 107A,A01,083627,Boyle; Mary E. T.,13,0,60,47
1657142988659,COGS 118A,A01,083075,Gupta; Anjum,15,0,76,61
1657142994685,CSE 3,A50,083646,Miranda; Gregory Joseph,24,0,50,26
1657143000712,CSE 8A,A50,083650,Miranda; Gregory Joseph,17,1,56,39
1657143006745,CSE 11,A01,083080,Cao; Yingjun,5,15,40,35
1657143012775,CSE 12,A01,083652,Krause-Levy; Sophia Louisa,24,1,120,96
1657143018801,CSE 15L,A01,083654,Morris; Justin Loren,9,0,50,41
1657143018801,CSE 15L,A02,083655,Morris; Justin Loren,9,0,50,41
1657143024828,CSE 20,A01,083657,Tran; Khoa Dang,38,0,80,42
1657143030864,CSE 21,A01,095574,Bach; Quang Tran,22,0,48,26
1657143036920,CSE 30,A01,083084,Eldon; John,4,0,80,76
1657143036920,CSE 30,B01,095061,Bhaskar; Nishant,7,0,50,43
1657143042959,CSE 100,A01,083659,Cao; Yingjun,4,4,70,66
1657143048984,CSE 134B,A01,083661,Powell; Thomas Allan,20,0,100,80
1657143055009,CSE 140,A01,083663,Gungor; Onat,13,0,85,72
1657143061035,CSE 140L,A01,083088,Eldon; John,17,0,100,83
1657143067061,CSE 175,A01,083665,Kumar; Rakesh,3,0,25,22
1657143073085,CSE 190,A00,092507,Dubnov; Shlomo,7,0,20,13
1657143079114,ECE 45,A01,083139,Congero; Spencer William,5,0,75,70
1657143085138,ECE 65,A50,083695,Saad; Andrew S,12,0,30,18
1657143085138,ECE 65,A51,095125,Saad; Andrew S,25,0,26,1
1657143091165,ECE 109,A01,091882,Touri; Behrouz,17,0,70,53
1657143097189,ECE 180,A00,083140,Abi Samra; Nicholas Camill,1,0,30,29
1657143097189,ECE 180,B00,083141,Abi Samra; Nicholas Camill,0,0,30,30
1657143103217,MATH 10A,A01,083735,Patchell; Gregory David,2,0,30,28
1657143103217,MATH 10A,A02,083736,Patchell; Gregory David,20,0,30,10
1657143103217,MATH 10A,A03,083737,Patchell; Gregory David,16,0,30,14
1657143109245,MATH 10B,A01,083207,Lim; Seonhee,7,0,34,27
1657143109245,MATH 10B,A02,083208,Lim; Seonhee,9,0,35,26
1657143109245,MATH 10B,A03,093472,Lim; Seonhee,5,0,34,29
1657143109245,MATH 10B,B01,083739,Sinha; Shubham,9,0,30,21
1657143115274,MATH 18,A01,083743,Cinel; Cameron Alexander,6,0,30,24
1657143115274,MATH 18,A02,083744,Cinel; Cameron Alexander,15,0,30,15
1657143115274,MATH 18,A03,083745,Cinel; Cameron Alexander,8,0,30,22
1657143115274,MATH 18,B01,083748,Rideout; David Porter,4,0,37,33
1657143115274,MATH 18,B02,083749,Rideout; David Porter,3,0,36,33
1657143115274,MATH 18,B03,083750,Rideout; David Porter,2,0,37,35
1657143115274,MATH 18,B04,083751,Rideout; David Porter,5,0,36,31
1657143115274,MATH 18,B05,093473,Rideout; David Porter,4,0,36,32
1657143115274,MATH 18,B06,093474,Rideout; David Porter,5,0,36,31
1657143121305,MATH 20A,A01,083754,Zheng; Zequn,12,0,40,28
1657143127329,MATH 20B,A01,083756,Briones; Jor-el Thomas Caparas,1,0,36,35
1657143127329,MATH 20B,A02,083757,Briones; Jor-el Thomas Caparas,1,0,36,35
1657143127329,MATH 20B,A03,093475,Briones; Jor-el Thomas Caparas,1,0,36,35
1657143133355,MATH 20C,A01,083760,Briones; Jor-el Thomas Caparas,1,0,35,34
1657143133355,MATH 20C,A02,083761,Briones; Jor-el Thomas Caparas,8,0,35,27
1657143133355,MATH 20C,A03,093476,Briones; Jor-el Thomas Caparas,0,1,36,36
1657143133355,MATH 20C,B01,083762,Bach; Quang Tran,0,0,30,30
1657143139381,MATH 20D,A01,083765,Tran; Brian Kha,4,0,30,26
1657143139381,MATH 20D,A02,083766,Tran; Brian Kha,5,0,30,25
1657143139381,MATH 20D,A03,083767,Tran; Brian Kha,3,0,30,27
1657143145412,MATH 20E,A01,083771,Ganguly; Soumya,7,0,32,25
1657143145412,MATH 20E,A02,083772,Ganguly; Soumya,7,0,32,25
1657143145412,MATH 20E,B01,083773,Ciotti; Benjamin,18,0,35,17
1657143145412,MATH 20E,B02,083774,Ciotti; Benjamin,17,0,35,18
1657143151441,MATH 103A,A01,083777,Greenfeld; Be'Eri,2,0,36,34
1657143151441,MATH 103A,A02,083778,Greenfeld; Be'Eri,5,0,36,31
1657143151441,MATH 103A,A03,093561,Greenfeld; Be'Eri,4,0,36,32
1657143151441,MATH 103A,B01,083779,Greenfeld; Be'Eri,6,0,36,30
1657143151441,MATH 103A,B02,083780,Greenfeld; Be'Eri,3,0,36,33
1657143151441,MATH 103A,B03,093562,Greenfeld; Be'Eri,3,0,36,33
1657143157470,MATH 105,A01,085443,Carter; Anne Toulson,14,0,35,21
1657143157470,MATH 105,A02,093477,Carter; Anne Toulson,20,0,35,15
1657143163495,MATH 109,A01,083213,Ganzberger; Geoffrey Michael,2,0,34,32
1657143163495,MATH 109,A02,083214,Ganzberger; Geoffrey Michael,3,0,34,31
1657143163495,MATH 109,A03,093478,Ganzberger; Geoffrey Michael,1,0,34,33
1657143163495,MATH 109,B01,083215,Ganzberger; Geoffrey Michael,1,0,32,31
1657143163495,MATH 109,B02,083216,Ganzberger; Geoffrey Michael,1,0,32,31
1657143163495,MATH 109,B03,093479,Ganzberger; Geoffrey Michael,6,0,32,26
1657143169520,MATH 142A,A01,083219,Chow; Bennett,6,0,32,26
1657143169520,MATH 142A,A02,083220,Chow; Bennett,10,0,32,22
1657143169520,MATH 142A,A03,093480,Chow; Bennett,7,0,32,25
1657143169520,MATH 142A,B03,093481,Chow; Bennett,8,0,32,24
1657143169520,MATH 142A,B04,093558,Chow; Bennett,11,0,32,21
1657143169520,MATH 142A,B05,093559,Chow; Bennett,6,0,32,26
1657143175550,MATH 193A,A01,083224,Rotar; Vladimir,7,0,34,27
1657143175550,MATH 193A,A02,083225,Rotar; Vladimir,5,0,34,29
1657143175550,MATH 193A,A03,083781,Rotar; Vladimir,1,0,34,33
1657143175550,MATH 193A,A04,083782,Rotar; Vladimir,8,0,34,26
1657143175550,MATH 193A,A05,093482,Rotar; Vladimir,6,0,34,28
1657143181575,MATH 197,001,091859,McAuley; Julian John,9999,0,9999,0
1657143181575,MATH 197,002,095566,Kedlaya; Kiran S.,9997,0,9999,2
1657143181575,MATH 197,003,095567,Xiao; Ming,9999,0,9999,0
1657143181575,MATH 197,004,095571,Perols; Johan Lars,9998,0,9999,1
1657143188630,COGS 9,A01,083615,Shannon; Kyle Michael,7,0,75,68
1657143194660,COGS 11,A01,083617,Boyle; Mary E. T.,21,0,48,27
1657143200686,COGS 13,A01,083071,Bastos; Amalia Pinkusfeld,9,0,71,62
1657143206790,COGS 14A,A01,092681,Semenuks; Arturs,1,1,100,99
1657143212815,COGS 14B,A01,083073,Cheng; Tzu-Han,6,0,63,57
1657143218846,COGS 17,A01,092677,Semenuks; Arturs,4,0,81,77
1657143224872,COGS 100,A01,083619,Allen; Michael Gordon,15,0,70,55
1657143230899,COGS 101A,A01,083621,Davis; Joshua Daniel,9,0,68,59
1657143236935,COGS 101B,A01,091572,Allen; Michael Gordon,9,0,65,56
1657143242957,COGS 101C,A01,083625,Delgado; Tania,17,0,35,18
1657143248988,COGS 107A,A01,083627,Boyle; Mary E. T.,13,0,60,47
1657143255014,COGS 118A,A01,083075,Gupta; Anjum,15,0,76,61
1657143261042,CSE 3,A50,083646,Miranda; Gregory Joseph,24,0,50,26
1657143267072,CSE 8A,A50,083650,Miranda; Gregory Joseph,17,1,56,39
1657143273098,CSE 11,A01,083080,Cao; Yingjun,5,15,40,35
1657143279124,CSE 12,A01,083652,Krause-Levy; Sophia Louisa,24,1,120,96
1657143285152,CSE 15L,A01,083654,Morris; Justin Loren,9,0,50,41
1657143285152,CSE 15L,A02,083655,Morris; Justin Loren,9,0,50,41
1657143291174,CSE 20,A01,083657,Tran; Khoa Dang,38,0,80,42
1657143297196,CSE 21,A01,095574,Bach; Quang Tran,22,0,48,26
1657143303245,CSE 30,A01,083084,Eldon; John,4,0,80,76
1657143303245,CSE 30,B01,095061,Bhaskar; Nishant,7,0,50,43
1657143309267,CSE 100,A01,083659,Cao; Yingjun,4,4,70,66
1657143315296,CSE 134B,A01,083661,Powell; Thomas Allan,20,0,100,80
1657143321326,CSE 140,A01,083663,Gungor; Onat,13,0,85,72
1657143327353,CSE 140L,A01,083088,Eldon; John,17,0,100,83
1657143333378,CSE 175,A01,083665,Kumar; Rakesh,3,0,25,22
1657143339401,CSE 190,A00,092507,Dubnov; Shlomo,7,0,20,13
1657143345429,ECE 45,A01,083139,Congero; Spencer William,5,0,75,70
1657143351456,ECE 65,A50,083695,Saad; Andrew S,12,0,30,18
1657143351456,ECE 65,A51,095125,Saad; Andrew S,25,0,26,1
1657143357478,ECE 109,A01,091882,Touri; Behrouz,17,0,70,53
1657143363501,ECE 180,A00,083140,Abi Samra; Nicholas Camill,1,0,30,29
1657143363501,ECE 180,B00,083141,Abi Samra; Nicholas Camill,0,0,30,30
1657143369523,MATH 10A,A01,083735,Patchell; Gregory David,2,0,30,28
1657143369523,MATH 10A,A02,083736,Patchell; Gregory David,20,0,30,10
1657143369523,MATH 10A,A03,083737,Patchell; Gregory David,16,0,30,14
1657143375545,MATH 10B,A01,083207,Lim; Seonhee,7,0,34,27
1657143375545,MATH 10B,A02,083208,Lim; Seonhee,9,0,35,26
1657143375545,MATH 10B,A03,093472,Lim; Seonhee,5,0,34,29
1657143375545,MATH 10B,B01,083739,Sinha; Shubham,9,0,30,21
1657143381575,MATH 18,A01,083743,Cinel; Cameron Alexander,6,0,30,24
1657143381575,MATH 18,A02,083744,Cinel; Cameron Alexander,15,0,30,15
1657143381575,MATH 18,A03,083745,Cinel; Cameron Alexander,8,0,30,22
1657143381575,MATH 18,B01,083748,Rideout; David Porter,4,0,37,33
1657143381575,MATH 18,B02,083749,Rideout; David Porter,3,0,36,33
1657143381575,MATH 18,B03,083750,Rideout; David Porter,2,0,37,35
1657143381575,MATH 18,B04,083751,Rideout; David Porter,5,0,36,31
1657143381575,MATH 18,B05,093473,Rideout; David Porter,4,0,36,32
1657143381575,MATH 18,B06,093474,Rideout; David Porter,5,0,36,31
1657143387598,MATH 20A,A01,083754,Zheng; Zequn,12,0,40,28
1657143393621,MATH 20B,A01,083756,Briones; Jor-el Thomas Caparas,1,0,36,35
1657143393621,MATH 20B,A02,083757,Briones; Jor-el Thomas Caparas,1,0,36,35
1657143393621,MATH 20B,A03,093475,Briones; Jor-el Thomas Caparas,1,0,36,35
1657143399652,MATH 20C,A01,083760,Briones; Jor-el Thomas Caparas,1,0,35,34
1657143399652,MATH 20C,A02,083761,Briones; Jor-el Thomas Caparas,8,0,35,27
1657143399652,MATH 20C,A03,093476,Briones; Jor-el Thomas Caparas,0,1,36,36
1657143399652,MATH 20C,B01,083762,Bach; Quang Tran,0,0,30,30
1657143405676,MATH 20D,A01,083765,Tran; Brian Kha,4,0,30,26
1657143405676,MATH 20D,A02,083766,Tran; Brian Kha,5,0,30,25
1657143405676,MATH 20D,A03,083767,Tran; Brian Kha,3,0,30,27
1657143411710,MATH 20E,A01,083771,Ganguly; Soumya,7,0,32,25
1657143411710,MATH 20E,A02,083772,Ganguly; Soumya,7,0,32,25
1657143411710,MATH 20E,B01,083773,Ciotti; Benjamin,18,0,35,17
1657143411710,MATH 20E,B02,083774,Ciotti; Benjamin,17,0,35,18
1657143417739,MATH 103A,A01,083777,Greenfeld; Be'Eri,2,0,36,34
1657143417739,MATH 103A,A02,083778,Greenfeld; Be'Eri,5,0,36,31
1657143417739,MATH 103A,A03,093561,Greenfeld; Be'Eri,4,0,36,32
1657143417739,MATH 103A,B01,083779,Greenfeld; Be'Eri,6,0,36,30
1657143417739,MATH 103A,B02,083780,Greenfeld; Be'Eri,3,0,36,33
1657143417739,MATH 103A,B03,093562,Greenfeld; Be'Eri,3,0,36,33
1657143423766,MATH 105,A01,085443,Carter; Anne Toulson,14,0,35,21
1657143423766,MATH 105,A02,093477,Carter; Anne Toulson,20,0,35,15
1657143429794,MATH 109,A01,083213,Ganzberger; Geoffrey Michael,2,0,34,32
1657143429794,MATH 109,A02,083214,Ganzberger; Geoffrey Michael,3,0,34,31
1657143429794,MATH 109,A03,093478,Ganzberger; Geoffrey Michael,1,0,34,33
1657143429794,MATH 109,B01,083215,Ganzberger; Geoffrey Michael,1,0,32,31
1657143429794,MATH 109,B02,083216,Ganzberger; Geoffrey Michael,1,0,32,31
1657143429794,MATH 109,B03,093479,Ganzberger; Geoffrey Michael,6,0,32,26
1657143435823,MATH 142A,A01,083219,Chow; Bennett,6,0,32,26
1657143435823,MATH 142A,A02,083220,Chow; Bennett,10,0,32,22
1657143435823,MATH 142A,A03,093480,Chow; Bennett,7,0,32,25
1657143435823,MATH 142A,B03,093481,Chow; Bennett,8,0,32,24
1657143435823,MATH 142A,B04,093558,Chow; Bennett,11,0,32,21
1657143435823,MATH 142A,B05,093559,Chow; Bennett,6,0,32,26
1657143441850,MATH 193A,A01,083224,Rotar; Vladimir,7,0,34,27
1657143441850,MATH 193A,A02,083225,Rotar; Vladimir,5,0,34,29
1657143441850,MATH 193A,A03,083781,Rotar; Vladimir,1,0,34,33
1657143441850,MATH 193A,A04,083782,Rotar; Vladimir,8,0,34,26
1657143441850,MATH 193A,A05,093482,Rotar; Vladimir,6,0,34,28
1657143447886,MATH 197,001,091859,McAuley; Julian John,9999,0,9999,0
1657143447886,MATH 197,002,095566,Kedlaya; Kiran S.,9997,0,9999,2
1657143447886,MATH 197,003,095567,Xiao; Ming,9999,0,9999,0
1657143447886,MATH 197,004,095571,Perols; Johan Lars,9998,0,9999,1
1657143454940,COGS 9,A01,083615,Shannon; Kyle Michael,7,0,75,68
1657143460964,COGS 11,A01,083617,Boyle; Mary E. T.,21,0,48,27
1657143466988,COGS 13,A01,083071,Bastos; Amalia Pinkusfeld,9,0,71,62
1657143473012,COGS 14A,A01,092681,Semenuks; Arturs,1,1,100,99
1657143479040,COGS 14B,A01,083073,Cheng; Tzu-Han,6,0,63,57
1657143485068,COGS 17,A01,092677,Semenuks; Arturs,4,0,81,77
1657143491092,COGS 100,A01,083619,Allen; Michael Gordon,15,0,70,55
1657143497143,COGS 101A,A01,083621,Davis; Joshua Daniel,9,0,68,59
1657143503174,COGS 101B,A01,091572,Allen; Michael Gordon,9,0,65,56
1657143509202,COGS 101C,A01,083625,Delgado; Tania,17,0,35,18
1657143515230,COGS 107A,A01,083627,Boyle; Mary E. T.,13,0,60,47
1657143521257,COGS 118A,A01,083075,Gupta; Anjum,15,0,76,61
1657143527280,CSE 3,A50,083646,Miranda; Gregory Joseph,24,0,50,26
1657143533329,CSE 8A,A50,083650,Miranda; Gregory Joseph,17,1,56,39
1657143539352,CSE 11,A01,083080,Cao; Yingjun,5,15,40,35
1657143545377,CSE 12,A01,083652,Krause-Levy; Sophia Louisa,24,1,120,96
1657143551400,CSE 15L,A01,083654,Morris; Justin Loren,9,0,50,41
1657143551400,CSE 15L,A02,083655,Morris; Justin Loren,9,0,50,41
1657143557433,CSE 20,A01,083657,Tran; Khoa Dang,38,0,80,42
1657143563456,CSE 21,A01,095574,Bach; Quang Tran,22,0,48,26
1657143569479,CSE 30,A01,083084,Eldon; John,4,0,80,76
1657143569479,CSE 30,B01,095061,Bhaskar; Nishant,7,0,50,43
1657143575503,CSE 100,A01,083659,Cao; Yingjun,4,4,70,66
1657143581632,CSE 134B,A01,083661,Powell; Thomas Allan,20,0,100,80
1657143587656,CSE 140,A01,083663,Gungor; Onat,13,0,85,72
1657143593679,CSE 140L,A01,083088,Eldon; John,17,0,100,83
1657143599708,CSE 175,A01,083665,Kumar; Rakesh,3,0,25,22
1657143605732,CSE 190,A00,092507,Dubnov; Shlomo,7,0,20,13
1657143611759,ECE 45,A01,083139,Congero; Spencer William,5,0,75,70
1657143617782,ECE 65,A50,083695,Saad; Andrew S,12,0,30,18
1657143617782,ECE 65,A51,095125,Saad; Andrew S,25,0,26,1
1657143623805,ECE 109,A01,091882,Touri; Behrouz,17,0,70,53
1657143629831,ECE 180,A00,083140,Abi Samra; Nicholas Camill,1,0,30,29
1657143629831,ECE 180,B00,083141,Abi Samra; Nicholas Camill,0,0,30,30
1657143635861,MATH 10A,A01,083735,Patchell; Gregory David,2,0,30,28
1657143635861,MATH 10A,A02,083736,Patchell; Gregory David,20,0,30,10
1657143635861,MATH 10A,A03,083737,Patchell; Gregory David,16,0,30,14
1657143641890,MATH 10B,A01,083207,Lim; Seonhee,7,0,34,27
1657143641890,MATH 10B,A02,083208,Lim; Seonhee,9,0,35,26
1657143641890,MATH 10B,A03,093472,Lim; Seonhee,5,0,34,29
1657143641890,MATH 10B,B01,083739,Sinha; Shubham,9,0,30,21
1657143647921,MATH 18,A01,083743,Cinel; Cameron Alexander,6,0,30,24
1657143647921,MATH 18,A02,083744,Cinel; Cameron Alexander,15,0,30,15
1657143647921,MATH 18,A03,083745,Cinel; Cameron Alexander,8,0,30,22
1657143647921,MATH 18,B01,083748,Rideout; David Porter,4,0,37,33
1657143647921,MATH 18,B02,083749,Rideout; David Porter,3,0,36,33
1657143647921,MATH 18,B03,083750,Rideout; David Porter,2,0,37,35
1657143647921,MATH 18,B04,083751,Rideout; David Porter,5,0,36,31
1657143647921,MATH 18,B05,093473,Rideout; David Porter,4,0,36,32
1657143647921,MATH 18,B06,093474,Rideout; David Porter,5,0,36,31
1657143653944,MATH 20A,A01,083754,Zheng; Zequn,12,0,40,28
1657143659968,MATH 20B,A01,083756,Briones; Jor-el Thomas Caparas,1,0,36,35
1657143659968,MATH 20B,A02,083757,Briones; Jor-el Thomas Caparas,1,0,36,35
1657143659968,MATH 20B,A03,093475,Briones; Jor-el Thomas Caparas,1,0,36,35
1657143665997,MATH 20C,A01,083760,Briones; Jor-el Thomas Caparas,1,0,35,34
1657143665997,MATH 20C,A02,083761,Briones; Jor-el Thomas Caparas,8,0,35,27
1657143665997,MATH 20C,A03,093476,Briones; Jor-el Thomas Caparas,0,1,36,36
1657143665997,MATH 20C,B01,083762,Bach; Quang Tran,0,0,30,30
1657143672021,MATH 20D,A01,083765,Tran; Brian Kha,4,0,30,26
1657143672021,MATH 20D,A02,083766,Tran; Brian Kha,5,0,30,25
1657143672021,MATH 20D,A03,083767,Tran; Brian Kha,3,0,30,27
1657143678045,MATH 20E,A01,083771,Ganguly; Soumya,7,0,32,25
1657143678045,MATH 20E,A02,083772,Ganguly; Soumya,7,0,32,25
1657143678045,MATH 20E,B01,083773,Ciotti; Benjamin,19,0,35,16
1657143678045,MATH 20E,B02,083774,Ciotti; Benjamin,17,0,35,18
1657143684079,MATH 103A,A01,083777,Greenfeld; Be'Eri,2,0,36,34
1657143684079,MATH 103A,A02,083778,Greenfeld; Be'Eri,5,0,36,31
1657143684079,MATH 103A,A03,093561,Greenfeld; Be'Eri,4,0,36,32
1657143684079,MATH 103A,B01,083779,Greenfeld; Be'Eri,6,0,36,30
1657143684079,MATH 103A,B02,083780,Greenfeld; Be'Eri,3,0,36,33
1657143684079,MATH 103A,B03,093562,Greenfeld; Be'Eri,3,0,36,33
1657143690106,MATH 105,A01,085443,Carter; Anne Toulson,14,0,35,21
1657143690106,MATH 105,A02,093477,Carter; Anne Toulson,20,0,35,15
1657143696130,MATH 109,A01,083213,Ganzberger; Geoffrey Michael,2,0,34,32
1657143696130,MATH 109,A02,083214,Ganzberger; Geoffrey Michael,3,0,34,31
1657143696130,MATH 109,A03,093478,Ganzberger; Geoffrey Michael,1,0,34,33
1657143696130,MATH 109,B01,083215,Ganzberger; Geoffrey Michael,1,0,32,31
1657143696130,MATH 109,B02,083216,Ganzberger; Geoffrey Michael,1,0,32,31
1657143696130,MATH 109,B03,093479,Ganzberger; Geoffrey Michael,6,0,32,26
1657143702159,MATH 142A,A01,083219,Chow; Bennett,6,0,32,26
1657143702159,MATH 142A,A02,083220,Chow; Bennett,10,0,32,22
1657143702159,MATH 142A,A03,093480,Chow; Bennett,7,0,32,25
1657143702159,MATH 142A,B03,093481,Chow; Bennett,8,0,32,24
1657143702159,MATH 142A,B04,093558,Chow; Bennett,11,0,32,21
1657143702159,MATH 142A,B05,093559,Chow; Bennett,6,0,32,26
1657143708188,MATH 193A,A01,083224,Rotar; Vladimir,7,0,34,27
1657143708188,MATH 193A,A02,083225,Rotar; Vladimir,5,0,34,29
1657143708188,MATH 193A,A03,083781,Rotar; Vladimir,1,0,34,33
1657143708188,MATH 193A,A04,083782,Rotar; Vladimir,8,0,34,26
1657143708188,MATH 193A,A05,093482,Rotar; Vladimir,6,0,34,28
1657143714215,MATH 197,001,091859,McAuley; Julian John,9999,0,9999,0
1657143714215,MATH 197,002,095566,Kedlaya; Kiran S.,9997,0,9999,2
1657143714215,MATH 197,003,095567,Xiao; Ming,9999,0,9999,0
1657143714215,MATH 197,004,095571,Perols; Johan Lars,9998,0,9999,1
1657143721281,COGS 9,A01,083615,Shannon; Kyle Michael,7,0,75,68
1657143727305,COGS 11,A01,083617,Boyle; Mary E. T.,21,0,48,27
1657143733331,COGS 13,A01,083071,Bastos; Amalia Pinkusfeld,9,0,71,62
1657143739356,COGS 14A,A01,092681,Semenuks; Arturs,1,1,100,99
1657143745383,COGS 14B,A01,083073,Cheng; Tzu-Han,6,0,63,57
1657143751416,COGS 17,A01,092677,Semenuks; Arturs,4,0,81,77
1657143757437,COGS 100,A01,083619,Allen; Michael Gordon,15,0,70,55
1657143763460,COGS 101A,A01,083621,Davis; Joshua Daniel,9,0,68,59
1657143769484,COGS 101B,A01,091572,Allen; Michael Gordon,9,0,65,56
1657143775516,COGS 101C,A01,083625,Delgado; Tania,17,0,35,18
1657143781548,COGS 107A,A01,083627,Boyle; Mary E. T.,13,0,60,47
1657143787571,COGS 118A,A01,083075,Gupta; Anjum,15,0,76,61
1657143793594,CSE 3,A50,083646,Miranda; Gregory Joseph,24,0,50,26
1657143799617,CSE 8A,A50,083650,Miranda; Gregory Joseph,17,1,56,39
1657143805712,CSE 11,A01,083080,Cao; Yingjun,5,15,40,35
1657143811734,CSE 12,A01,083652,Krause-Levy; Sophia Louisa,24,1,120,96
1657143817761,CSE 15L,A01,083654,Morris; Justin Loren,9,0,50,41
1657143817761,CSE 15L,A02,083655,Morris; Justin Loren,9,0,50,41
1657143823798,CSE 20,A01,083657,Tran; Khoa Dang,38,0,80,42
1657143829829,CSE 21,A01,095574,Bach; Quang Tran,22,0,48,26
1657143835856,CSE 30,A01,083084,Eldon; John,4,0,80,76
1657143835856,CSE 30,B01,095061,Bhaskar; Nishant,7,0,50,43
1657143841882,CSE 100,A01,083659,Cao; Yingjun,4,4,70,66
1657143847909,CSE 134B,A01,083661,Powell; Thomas Allan,20,0,100,80
1657143853936,CSE 140,A01,083663,Gungor; Onat,13,0,85,72
1657143859959,CSE 140L,A01,083088,Eldon; John,17,0,100,83
1657143865982,CSE 175,A01,083665,Kumar; Rakesh,3,0,25,22
1657143872004,CSE 190,A00,092507,Dubnov; Shlomo,7,0,20,13
1657143878048,ECE 45,A01,083139,Congero; Spencer William,5,0,75,70
1657143884091,ECE 65,A50,083695,Saad; Andrew S,12,0,30,18
1657143884091,ECE 65,A51,095125,Saad; Andrew S,25,0,26,1
1657143890118,ECE 109,A01,091882,Touri; Behrouz,18,0,70,52
1657143896142,ECE 180,A00,083140,Abi Samra; Nicholas Camill,1,0,30,29
1657143896142,ECE 180,B00,083141,Abi Samra; Nicholas Camill,0,0,30,30
1657143902167,MATH 10A,A01,083735,Patchell; Gregory David,2,0,30,28
1657143902167,MATH 10A,A02,083736,Patchell; Gregory David,20,0,30,10
1657143902167,MATH 10A,A03,083737,Patchell; Gregory David,16,0,30,14
1657143908189,MATH 10B,A01,083207,Lim; Seonhee,7,0,34,27
1657143908189,MATH 10B,A02,083208,Lim; Seonhee,9,0,35,26
1657143908189,MATH 10B,A03,093472,Lim; Seonhee,5,0,34,29
1657143908189,MATH 10B,B01,083739,Sinha; Shubham,9,0,30,21
1657143914219,MATH 18,A01,083743,Cinel; Cameron Alexander,6,0,30,24
1657143914219,MATH 18,A02,083744,Cinel; Cameron Alexander,15,0,30,15
1657143914219,MATH 18,A03,083745,Cinel; Cameron Alexander,8,0,30,22
1657143914219,MATH 18,B01,083748,Rideout; David Porter,4,0,37,33
1657143914219,MATH 18,B02,083749,Rideout; David Porter,3,0,36,33
1657143914219,MATH 18,B03,083750,Rideout; David Porter,2,0,37,35
1657143914219,MATH 18,B04,083751,Rideout; David Porter,5,0,36,31
1657143914219,MATH 18,B05,093473,Rideout; David Porter,4,0,36,32
1657143914219,MATH 18,B06,093474,Rideout; David Porter,5,0,36,31
1657143920247,MATH 20A,A01,083754,Zheng; Zequn,12,0,40,28
1657143926275,MATH 20B,A01,083756,Briones; Jor-el Thomas Caparas,1,0,36,35
1657143926275,MATH 20B,A02,083757,Briones; Jor-el Thomas Caparas,1,0,36,35
1657143926275,MATH 20B,A03,093475,Briones; Jor-el Thomas Caparas,1,0,36,35
1657143932303,MATH 20C,A01,083760,Briones; Jor-el Thomas Caparas,1,0,35,34
1657143932303,MATH 20C,A02,083761,Briones; Jor-el Thomas Caparas,8,0,35,27
1657143932303,MATH 20C,A03,093476,Briones; Jor-el Thomas Caparas,0,1,36,36
1657143932303,MATH 20C,B01,083762,Bach; Quang Tran,0,0,30,30
1657143938327,MATH 20D,A01,083765,Tran; Brian Kha,4,0,30,26
1657143938327,MATH 20D,A02,083766,Tran; Brian Kha,5,0,30,25
1657143938327,MATH 20D,A03,083767,Tran; Brian Kha,3,0,30,27
1657143944357,MATH 20E,A01,083771,Ganguly; Soumya,7,0,32,25
1657143944357,MATH 20E,A02,083772,Ganguly; Soumya,7,0,32,25
1657143944357,MATH 20E,B01,083773,Ciotti; Benjamin,19,0,35,16
1657143944357,MATH 20E,B02,083774,Ciotti; Benjamin,17,0,35,18
1657143950381,MATH 103A,A01,083777,Greenfeld; Be'Eri,2,0,36,34
1657143950381,MATH 103A,A02,083778,Greenfeld; Be'Eri,5,0,36,31
1657143950381,MATH 103A,A03,093561,Greenfeld; Be'Eri,4,0,36,32
1657143950381,MATH 103A,B01,083779,Greenfeld; Be'Eri,6,0,36,30
1657143950381,MATH 103A,B02,083780,Greenfeld; Be'Eri,3,0,36,33
1657143950381,MATH 103A,B03,093562,Greenfeld; Be'Eri,3,0,36,33
1657143956414,MATH 105,A01,085443,Carter; Anne Toulson,14,0,35,21
1657143956414,MATH 105,A02,093477,Carter; Anne Toulson,20,0,35,15
1657143962441,MATH 109,A01,083213,Ganzberger; Geoffrey Michael,2,0,34,32
1657143962441,MATH 109,A02,083214,Ganzberger; Geoffrey Michael,3,0,34,31
1657143962441,MATH 109,A03,093478,Ganzberger; Geoffrey Michael,1,0,34,33
1657143962441,MATH 109,B01,083215,Ganzberger; Geoffrey Michael,1,0,32,31
1657143962441,MATH 109,B02,083216,Ganzberger; Geoffrey Michael,1,0,32,31
1657143962441,MATH 109,B03,093479,Ganzberger; Geoffrey Michael,6,0,32,26
1657143968466,MATH 142A,A01,083219,Chow; Bennett,6,0,32,26
1657143968466,MATH 142A,A02,083220,Chow; Bennett,10,0,32,22
1657143968466,MATH 142A,A03,093480,Chow; Bennett,7,0,32,25
1657143968466,MATH 142A,B03,093481,Chow; Bennett,8,0,32,24
1657143968466,MATH 142A,B04,093558,Chow; Bennett,11,0,32,21
1657143968466,MATH 142A,B05,093559,Chow; Bennett,6,0,32,26
1657143974489,MATH 193A,A01,083224,Rotar; Vladimir,7,0,34,27
1657143974489,MATH 193A,A02,083225,Rotar; Vladimir,5,0,34,29
1657143974489,MATH 193A,A03,083781,Rotar; Vladimir,1,0,34,33
1657143974489,MATH 193A,A04,083782,Rotar; Vladimir,8,0,34,26
1657143974489,MATH 193A,A05,093482,Rotar; Vladimir,6,0,34,28
1657143980521,MATH 197,001,091859,McAuley; Julian John,9999,0,9999,0
1657143980521,MATH 197,002,095566,Kedlaya; Kiran S.,9997,0,9999,2
1657143980521,MATH 197,003,095567,Xiao; Ming,9999,0,9999,0
1657143980521,MATH 197,004,095571,Perols; Johan Lars,9998,0,9999,1
1657143987597,COGS 9,A01,083615,Shannon; Kyle Michael,7,0,75,68
1657143993632,COGS 11,A01,083617,Boyle; Mary E. T.,21,0,48,27
1657143999654,COGS 13,A01,083071,Bastos; Amalia Pinkusfeld,9,0,71,62
1657144005676,COGS 14A,A01,092681,Semenuks; Arturs,1,1,100,99
1657144011707,COGS 14B,A01,083073,Cheng; Tzu-Han,6,0,63,57
1657144017733,COGS 17,A01,092677,Semenuks; Arturs,4,0,81,77
1657144023761,COGS 100,A01,083619,Allen; Michael Gordon,15,0,70,55
1657144029784,COGS 101A,A01,083621,Davis; Joshua Daniel,9,0,68,59
1657144035828,COGS 101B,A01,091572,Allen; Michael Gordon,9,0,65,56
1657144041851,COGS 101C,A01,083625,Delgado; Tania,17,0,35,18
1657144047876,COGS 107A,A01,083627,Boyle; Mary E. T.,13,0,60,47
1657144053902,COGS 118A,A01,083075,Gupta; Anjum,15,0,76,61
1657144059926,CSE 3,A50,083646,Miranda; Gregory Joseph,24,0,50,26
1657144065948,CSE 8A,A50,083650,Miranda; Gregory Joseph,17,1,56,39
1657144071974,CSE 11,A01,083080,Cao; Yingjun,5,15,40,35
1657144078006,CSE 12,A01,083652,Krause-Levy; Sophia Louisa,24,1,120,96
1657144084029,CSE 15L,A01,083654,Morris; Justin Loren,9,0,50,41
1657144084029,CSE 15L,A02,083655,Morris; Justin Loren,9,0,50,41
1657144090053,CSE 20,A01,083657,Tran; Khoa Dang,38,0,80,42
1657144096075,CSE 21,A01,095574,Bach; Quang Tran,22,0,48,26
1657144102104,CSE 30,A01,083084,Eldon; John,4,0,80,76
1657144102104,CSE 30,B01,095061,Bhaskar; Nishant,7,0,50,43
1657144108127,CSE 100,A01,083659,Cao; Yingjun,4,4,70,66
1657144114150,CSE 134B,A01,083661,Powell; Thomas Allan,20,0,100,80
1657144120172,CSE 140,A01,083663,Gungor; Onat,13,0,85,72
1657144126198,CSE 140L,A01,083088,Eldon; John,17,0,100,83
1657144132224,CSE 175,A01,083665,Kumar; Rakesh,3,0,25,22
1657144138252,CSE 190,A00,092507,Dubnov; Shlomo,7,0,20,13
1657144144278,ECE 45,A01,083139,Congero; Spencer William,5,0,75,70
1657144150308,ECE 65,A50,083695,Saad; Andrew S,12,0,30,18
1657144150308,ECE 65,A51,095125,Saad; Andrew S,25,0,26,1
1657144156331,ECE 109,A01,091882,Touri; Behrouz,18,0,70,52
1657144162357,ECE 180,A00,083140,Abi Samra; Nicholas Camill,1,0,30,29
1657144162357,ECE 180,B00,083141,Abi Samra; Nicholas Camill,0,0,30,30
1657144168393,MATH 10A,A01,083735,Patchell; Gregory David,2,0,30,28
1657144168393,MATH 10A,A02,083736,Patchell; Gregory David,20,0,30,10
1657144168393,MATH 10A,A03,083737,Patchell; Gregory David,16,0,30,14
1657144174427,MATH 10B,A01,083207,Lim; Seonhee,7,0,34,27
1657144174427,MATH 10B,A02,083208,Lim; Seonhee,9,0,35,26
1657144174427,MATH 10B,A03,093472,Lim; Seonhee,5,0,34,29
1657144174427,MATH 10B,B01,083739,Sinha; Shubham,9,0,30,21
1657144180457,MATH 18,A01,083743,Cinel; Cameron Alexander,6,0,30,24
1657144180457,MATH 18,A02,083744,Cinel; Cameron Alexander,15,0,30,15
1657144180457,MATH 18,A03,083745,Cinel; Cameron Alexander,8,0,30,22
1657144180457,MATH 18,B01,083748,Rideout; David Porter,4,0,37,33
1657144180457,MATH 18,B02,083749,Rideout; David Porter,3,0,36,33
1657144180457,MATH 18,B03,083750,Rideout; David Porter,2,0,37,35
1657144180457,MATH 18,B04,083751,Rideout; David Porter,5,0,36,31
1657144180457,MATH 18,B05,093473,Rideout; David Porter,4,0,36,32
1657144180457,MATH 18,B06,093474,Rideout; David Porter,5,0,36,31
1657144186480,MATH 20A,A01,083754,Zheng; Zequn,12,0,40,28
1657144192506,MATH 20B,A01,083756,Briones; Jor-el Thomas Caparas,1,0,36,35
1657144192506,MATH 20B,A02,083757,Briones; Jor-el Thomas Caparas,1,0,36,35
1657144192506,MATH 20B,A03,093475,Briones; Jor-el Thomas Caparas,1,0,36,35
1657144198535,MATH 20C,A01,083760,Briones; Jor-el Thomas Caparas,1,0,35,34
1657144198535,MATH 20C,A02,083761,Briones; Jor-el Thomas Caparas,8,0,35,27
1657144198535,MATH 20C,A03,093476,Briones; Jor-el Thomas Caparas,0,1,36,36
1657144198535,MATH 20C,B01,083762,Bach; Quang Tran,0,0,30,30
1657144204564,MATH 20D,A01,083765,Tran; Brian Kha,4,0,30,26
1657144204564,MATH 20D,A02,083766,Tran; Brian Kha,5,0,30,25
1657144204564,MATH 20D,A03,083767,Tran; Brian Kha,3,0,30,27
1657144210591,MATH 20E,A01,083771,Ganguly; Soumya,7,0,32,25
1657144210591,MATH 20E,A02,083772,Ganguly; Soumya,7,0,32,25
1657144210591,MATH 20E,B01,083773,Ciotti; Benjamin,19,0,35,16
1657144210591,MATH 20E,B02,083774,Ciotti; Benjamin,17,0,35,18
1657144216621,MATH 103A,A01,083777,Greenfeld; Be'Eri,2,0,36,34
1657144216621,MATH 103A,A02,083778,Greenfeld; Be'Eri,5,0,36,31
1657144216621,MATH 103A,A03,093561,Greenfeld; Be'Eri,4,0,36,32
1657144216621,MATH 103A,B01,083779,Greenfeld; Be'Eri,6,0,36,30
1657144216621,MATH 103A,B02,083780,Greenfeld; Be'Eri,3,0,36,33
1657144216621,MATH 103A,B03,093562,Greenfeld; Be'Eri,3,0,36,33
1657144222646,MATH 105,A01,085443,Carter; Anne Toulson,14,0,35,21
1657144222646,MATH 105,A02,093477,Carter; Anne Toulson,20,0,35,15
1657144228674,MATH 109,A01,083213,Ganzberger; Geoffrey Michael,2,0,34,32
1657144228674,MATH 109,A02,083214,Ganzberger; Geoffrey Michael,3,0,34,31
1657144228674,MATH 109,A03,093478,Ganzberger; Geoffrey Michael,1,0,34,33
1657144228674,MATH 109,B01,083215,Ganzberger; Geoffrey Michael,1,0,32,31
1657144228674,MATH 109,B02,083216,Ganzberger; Geoffrey Michael,1,0,32,31
1657144228674,MATH 109,B03,093479,Ganzberger; Geoffrey Michael,6,0,32,26
1657144234702,MATH 142A,A01,083219,Chow; Bennett,6,0,32,26
1657144234702,MATH 142A,A02,083220,Chow; Bennett,10,0,32,22
1657144234702,MATH 142A,A03,093480,Chow; Bennett,7,0,32,25
1657144234702,MATH 142A,B03,093481,Chow; Bennett,8,0,32,24
1657144234702,MATH 142A,B04,093558,Chow; Bennett,11,0,32,21
1657144234702,MATH 142A,B05,093559,Chow; Bennett,6,0,32,26
1657144240731,MATH 193A,A01,083224,Rotar; Vladimir,7,0,34,27
1657144240731,MATH 193A,A02,083225,Rotar; Vladimir,5,0,34,29
1657144240731,MATH 193A,A03,083781,Rotar; Vladimir,1,0,34,33
1657144240731,MATH 193A,A04,083782,Rotar; Vladimir,8,0,34,26
1657144240731,MATH 193A,A05,093482,Rotar; Vladimir,6,0,34,28
1657144246753,MATH 197,001,091859,McAuley; Julian John,9999,0,9999,0
1657144246753,MATH 197,002,095566,Kedlaya; Kiran S.,9997,0,9999,2
1657144246753,MATH 197,003,095567,Xiao; Ming,9999,0,9999,0
1657144246753,MATH 197,004,095571,Perols; Johan Lars,9998,0,9999,1
1657144253805,COGS 9,A01,083615,Shannon; Kyle Michael,7,0,75,68
1657144259828,COGS 11,A01,083617,Boyle; Mary E. T.,21,0,48,27
1657144265855,COGS 13,A01,083071,Bastos; Amalia Pinkusfeld,9,0,71,62
1657144271883,COGS 14A,A01,092681,Semenuks; Arturs,1,1,100,99
1657144277909,COGS 14B,A01,083073,Cheng; Tzu-Han,6,0,63,57
1657144283932,COGS 17,A01,092677,Semenuks; Arturs,4,0,81,77
1657144289959,COGS 100,A01,083619,Allen; Michael Gordon,15,0,70,55
1657144296005,COGS 101A,A01,083621,Davis; Joshua Daniel,9,0,68,59
1657144302039,COGS 101B,A01,091572,Allen; Michael Gordon,9,0,65,56
1657144308065,COGS 101C,A01,083625,Delgado; Tania,17,0,35,18
1657144314088,COGS 107A,A01,083627,Boyle; Mary E. T.,13,0,60,47
1657144320111,COGS 118A,A01,083075,Gupta; Anjum,15,0,76,61
1657144326139,CSE 3,A50,083646,Miranda; Gregory Joseph,24,0,50,26
1657144332167,CSE 8A,A50,083650,Miranda; Gregory Joseph,17,1,56,39
1657144338193,CSE 11,A01,083080,Cao; Yingjun,5,15,40,35
1657144344220,CSE 12,A01,083652,Krause-Levy; Sophia Louisa,24,1,120,96
1657144350251,CSE 15L,A01,083654,Morris; Justin Loren,9,0,50,41
1657144350251,CSE 15L,A02,083655,Morris; Justin Loren,9,0,50,41
1657144356274,CSE 20,A01,083657,Tran; Khoa Dang,38,0,80,42
1657144362296,CSE 21,A01,095574,Bach; Quang Tran,22,0,48,26
1657144368320,CSE 30,A01,083084,Eldon; John,4,0,80,76
1657144368320,CSE 30,B01,095061,Bhaskar; Nishant,7,0,50,43
1657144374348,CSE 100,A01,083659,Cao; Yingjun,4,4,70,66
1657144380373,CSE 134B,A01,083661,Powell; Thomas Allan,20,0,100,80
1657144386397,CSE 140,A01,083663,Gungor; Onat,13,0,85,72
1657144392420,CSE 140L,A01,083088,Eldon; John,17,0,100,83
1657144398444,CSE 175,A01,083665,Kumar; Rakesh,3,0,25,22
1657144404552,CSE 190,A00,092507,Dubnov; Shlomo,7,0,20,13
1657144410575,ECE 45,A01,083139,Congero; Spencer William,5,0,75,70
1657144416597,ECE 65,A50,083695,Saad; Andrew S,12,0,30,18
1657144416597,ECE 65,A51,095125,Saad; Andrew S,25,0,26,1
1657144422620,ECE 109,A01,091882,Touri; Behrouz,18,0,70,52
1657144428646,ECE 180,A00,083140,Abi Samra; Nicholas Camill,1,0,30,29
1657144428646,ECE 180,B00,083141,Abi Samra; Nicholas Camill,0,0,30,30
1657144434667,MATH 10A,A01,083735,Patchell; Gregory David,2,0,30,28
1657144434667,MATH 10A,A02,083736,Patchell; Gregory David,20,0,30,10
1657144434667,MATH 10A,A03,083737,Patchell; Gregory David,16,0,30,14
1657144440690,MATH 10B,A01,083207,Lim; Seonhee,7,0,34,27
1657144440690,MATH 10B,A02,083208,Lim; Seonhee,9,0,35,26
1657144440690,MATH 10B,A03,093472,Lim; Seonhee,5,0,34,29
1657144440690,MATH 10B,B01,083739,Sinha; Shubham,9,0,30,21
1657144446722,MATH 18,A01,083743,Cinel; Cameron Alexander,6,0,30,24
1657144446722,MATH 18,A02,083744,Cinel; Cameron Alexander,15,0,30,15
1657144446722,MATH 18,A03,083745,Cinel; Cameron Alexander,8,0,30,22
1657144446722,MATH 18,B01,083748,Rideout; David Porter,4,0,37,33
1657144446722,MATH 18,B02,083749,Rideout; David Porter,3,0,36,33
1657144446722,MATH 18,B03,083750,Rideout; David Porter,2,0,37,35
1657144446722,MATH 18,B04,083751,Rideout; David Porter,5,0,36,31
1657144446722,MATH 18,B05,093473,Rideout; David Porter,4,0,36,32
1657144446722,MATH 18,B06,093474,Rideout; David Porter,5,0,36,31
1657144452751,MATH 20A,A01,083754,Zheng; Zequn,12,0,40,28
1657144458777,MATH 20B,A01,083756,Briones; Jor-el Thomas Caparas,1,0,36,35
1657144458777,MATH 20B,A02,083757,Briones; Jor-el Thomas Caparas,1,0,36,35
1657144458777,MATH 20B,A03,093475,Briones; Jor-el Thomas Caparas,1,0,36,35
1657144464805,MATH 20C,A01,083760,Briones; Jor-el Thomas Caparas,1,0,35,34
1657144464805,MATH 20C,A02,083761,Briones; Jor-el Thomas Caparas,8,0,35,27
1657144464805,MATH 20C,A03,093476,Briones; Jor-el Thomas Caparas,0,1,36,36
1657144464805,MATH 20C,B01,083762,Bach; Quang Tran,0,0,30,30
1657144470829,MATH 20D,A01,083765,Tran; Brian Kha,4,0,30,26
1657144470829,MATH 20D,A02,083766,Tran; Brian Kha,5,0,30,25
1657144470829,MATH 20D,A03,083767,Tran; Brian Kha,3,0,30,27
1657144476851,MATH 20E,A01,083771,Ganguly; Soumya,7,0,32,25
1657144476851,MATH 20E,A02,083772,Ganguly; Soumya,7,0,32,25
1657144476851,MATH 20E,B01,083773,Ciotti; Benjamin,19,0,35,16
1657144476851,MATH 20E,B02,083774,Ciotti; Benjamin,17,0,35,18
1657144482876,MATH 103A,A01,083777,Greenfeld; Be'Eri,2,0,36,34
1657144482876,MATH 103A,A02,083778,Greenfeld; Be'Eri,5,0,36,31
1657144482876,MATH 103A,A03,093561,Greenfeld; Be'Eri,4,0,36,32
1657144482876,MATH 103A,B01,083779,Greenfeld; Be'Eri,6,0,36,30
1657144482876,MATH 103A,B02,083780,Greenfeld; Be'Eri,3,0,36,33
1657144482876,MATH 103A,B03,093562,Greenfeld; Be'Eri,3,0,36,33
1657144488911,MATH 105,A01,085443,Carter; Anne Toulson,14,0,35,21
1657144488911,MATH 105,A02,093477,Carter; Anne Toulson,20,0,35,15
1657144494935,MATH 109,A01,083213,Ganzberger; Geoffrey Michael,2,0,34,32
1657144494935,MATH 109,A02,083214,Ganzberger; Geoffrey Michael,3,0,34,31
1657144494935,MATH 109,A03,093478,Ganzberger; Geoffrey Michael,1,0,34,33
1657144494935,MATH 109,B01,083215,Ganzberger; Geoffrey Michael,1,0,32,31
1657144494935,MATH 109,B02,083216,Ganzberger; Geoffrey Michael,1,0,32,31
1657144494935,MATH 109,B03,093479,Ganzberger; Geoffrey Michael,6,0,32,26
1657144500965,MATH 142A,A01,083219,Chow; Bennett,6,0,32,26
1657144500965,MATH 142A,A02,083220,Chow; Bennett,10,0,32,22
1657144500965,MATH 142A,A03,093480,Chow; Bennett,7,0,32,25
1657144500965,MATH 142A,B03,093481,Chow; Bennett,8,0,32,24
1657144500965,MATH 142A,B04,093558,Chow; Bennett,11,0,32,21
1657144500965,MATH 142A,B05,093559,Chow; Bennett,6,0,32,26
1657144506999,MATH 193A,A01,083224,Rotar; Vladimir,7,0,34,27
1657144506999,MATH 193A,A02,083225,Rotar; Vladimir,5,0,34,29
1657144506999,MATH 193A,A03,083781,Rotar; Vladimir,1,0,34,33
1657144506999,MATH 193A,A04,083782,Rotar; Vladimir,8,0,34,26
1657144506999,MATH 193A,A05,093482,Rotar; Vladimir,6,0,34,28
1657144513028,MATH 197,001,091859,McAuley; Julian John,9999,0,9999,0
1657144513028,MATH 197,002,095566,Kedlaya; Kiran S.,9997,0,9999,2
1657144513028,MATH 197,003,095567,Xiao; Ming,9999,0,9999,0
1657144513028,MATH 197,004,095571,Perols; Johan Lars,9998,0,9999,1
1657144520086,COGS 9,A01,083615,Shannon; Kyle Michael,7,0,75,68
1657144526109,COGS 11,A01,083617,Boyle; Mary E. T.,21,0,48,27
1657144532137,COGS 13,A01,083071,Bastos; Amalia Pinkusfeld,9,0,71,62
1657144538159,COGS 14A,A01,092681,Semenuks; Arturs,1,1,100,99
1657144544184,COGS 14B,A01,083073,Cheng; Tzu-Han,6,0,63,57
1657144550208,COGS 17,A01,092677,Semenuks; Arturs,4,0,81,77
1657144556238,COGS 100,A01,083619,Allen; Michael Gordon,15,0,70,55
1657144562260,COGS 101A,A01,083621,Davis; Joshua Daniel,9,0,68,59
1657144568292,COGS 101B,A01,091572,Allen; Michael Gordon,9,0,65,56
1657144574319,COGS 101C,A01,083625,Delgado; Tania,17,0,35,18
1657144580343,COGS 107A,A01,083627,Boyle; Mary E. T.,13,0,60,47
1657144586366,COGS 118A,A01,083075,Gupta; Anjum,15,0,76,61
1657144592402,CSE 3,A50,083646,Miranda; Gregory Joseph,24,0,50,26
1657144598427,CSE 8A,A50,083650,Miranda; Gregory Joseph,17,1,56,39
1657144604449,CSE 11,A01,083080,Cao; Yingjun,5,15,40,35
1657144610471,CSE 12,A01,083652,Krause-Levy; Sophia Louisa,24,1,120,96
1657144616510,CSE 15L,A01,083654,Morris; Justin Loren,9,0,50,41
1657144616510,CSE 15L,A02,083655,Morris; Justin Loren,9,0,50,41
1657144622531,CSE 20,A01,083657,Tran; Khoa Dang,38,0,80,42
1657144628560,CSE 21,A01,095574,Bach; Quang Tran,22,0,48,26
1657144634600,CSE 30,A01,083084,Eldon; John,4,0,80,76
1657144634600,CSE 30,B01,095061,Bhaskar; Nishant,7,0,50,43
1657144640624,CSE 100,A01,083659,Cao; Yingjun,4,4,70,66
1657144646646,CSE 134B,A01,083661,Powell; Thomas Allan,20,0,100,80
1657144652670,CSE 140,A01,083663,Gungor; Onat,13,0,85,72
1657144658697,CSE 140L,A01,083088,Eldon; John,17,0,100,83
1657144664727,CSE 175,A01,083665,Kumar; Rakesh,3,0,25,22
1657144670754,CSE 190,A00,092507,Dubnov; Shlomo,7,0,20,13
1657144676780,ECE 45,A01,083139,Congero; Spencer William,5,0,75,70
1657144682803,ECE 65,A50,083695,Saad; Andrew S,12,0,30,18
1657144682803,ECE 65,A51,095125,Saad; Andrew S,25,0,26,1
1657144688827,ECE 109,A01,091882,Touri; Behrouz,18,0,70,52
1657144694849,ECE 180,A00,083140,Abi Samra; Nicholas Camill,1,0,30,29
1657144694849,ECE 180,B00,083141,Abi Samra; Nicholas Camill,0,0,30,30
1657144700876,MATH 10A,A01,083735,Patchell; Gregory David,2,0,30,28
1657144700876,MATH 10A,A02,083736,Patchell; Gregory David,20,0,30,10
1657144700876,MATH 10A,A03,083737,Patchell; Gregory David,16,0,30,14
1657144706900,MATH 10B,A01,083207,Lim; Seonhee,7,0,34,27
1657144706900,MATH 10B,A02,083208,Lim; Seonhee,9,0,35,26
1657144706900,MATH 10B,A03,093472,Lim; Seonhee,5,0,34,29
1657144706900,MATH 10B,B01,083739,Sinha; Shubham,9,0,30,21
1657144712924,MATH 18,A01,083743,Cinel; Cameron Alexander,6,0,30,24
1657144712924,MATH 18,A02,083744,Cinel; Cameron Alexander,15,0,30,15
1657144712924,MATH 18,A03,083745,Cinel; Cameron Alexander,8,0,30,22
1657144712924,MATH 18,B01,083748,Rideout; David Porter,4,0,37,33
1657144712924,MATH 18,B02,083749,Rideout; David Porter,3,0,36,33
1657144712924,MATH 18,B03,083750,Rideout; David Porter,2,0,37,35
1657144712924,MATH 18,B04,083751,Rideout; David Porter,5,0,36,31
1657144712924,MATH 18,B05,093473,Rideout; David Porter,4,0,36,32
1657144712924,MATH 18,B06,093474,Rideout; David Porter,5,0,36,31
1657144718948,MATH 20A,A01,083754,Zheng; Zequn,12,0,40,28
1657144724971,MATH 20B,A01,083756,Briones; Jor-el Thomas Caparas,1,0,36,35
1657144724971,MATH 20B,A02,083757,Briones; Jor-el Thomas Caparas,1,0,36,35
1657144724971,MATH 20B,A03,093475,Briones; Jor-el Thomas Caparas,1,0,36,35
1657144730995,MATH 20C,A01,083760,Briones; Jor-el Thomas Caparas,1,0,35,34
1657144730995,MATH 20C,A02,083761,Briones; Jor-el Thomas Caparas,8,0,35,27
1657144730995,MATH 20C,A03,093476,Briones; Jor-el Thomas Caparas,0,1,36,36
1657144730995,MATH 20C,B01,083762,Bach; Quang Tran,0,0,30,30
1657144737021,MATH 20D,A01,083765,Tran; Brian Kha,4,0,30,26
1657144737021,MATH 20D,A02,083766,Tran; Brian Kha,5,0,30,25
1657144737021,MATH 20D,A03,083767,Tran; Brian Kha,3,0,30,27
1657144743049,MATH 20E,A01,083771,Ganguly; Soumya,7,0,32,25
1657144743049,MATH 20E,A02,083772,Ganguly; Soumya,7,0,32,25
1657144743049,MATH 20E,B01,083773,Ciotti; Benjamin,19,0,35,16
1657144743049,MATH 20E,B02,083774,Ciotti; Benjamin,17,0,35,18
1657144749080,MATH 103A,A01,083777,Greenfeld; Be'Eri,2,0,36,34
1657144749080,MATH 103A,A02,083778,Greenfeld; Be'Eri,5,0,36,31
1657144749080,MATH 103A,A03,093561,Greenfeld; Be'Eri,4,0,36,32
1657144749080,MATH 103A,B01,083779,Greenfeld; Be'Eri,6,0,36,30
1657144749080,MATH 103A,B02,083780,Greenfeld; Be'Eri,3,0,36,33
1657144749080,MATH 103A,B03,093562,Greenfeld; Be'Eri,3,0,36,33
1657144755103,MATH 105,A01,085443,Carter; Anne Toulson,14,0,35,21
1657144755103,MATH 105,A02,093477,Carter; Anne Toulson,20,0,35,15
1657144761134,MATH 109,A01,083213,Ganzberger; Geoffrey Michael,2,0,34,32
1657144761134,MATH 109,A02,083214,Ganzberger; Geoffrey Michael,3,0,34,31
1657144761134,MATH 109,A03,093478,Ganzberger; Geoffrey Michael,1,0,34,33
1657144761134,MATH 109,B01,083215,Ganzberger; Geoffrey Michael,1,0,32,31
1657144761134,MATH 109,B02,083216,Ganzberger; Geoffrey Michael,1,0,32,31
1657144761134,MATH 109,B03,093479,Ganzberger; Geoffrey Michael,6,0,32,26
1657144767173,MATH 142A,A01,083219,Chow; Bennett,6,0,32,26
1657144767173,MATH 142A,A02,083220,Chow; Bennett,10,0,32,22
1657144767173,MATH 142A,A03,093480,Chow; Bennett,7,0,32,25
1657144767173,MATH 142A,B03,093481,Chow; Bennett,8,0,32,24
1657144767173,MATH 142A,B04,093558,Chow; Bennett,11,0,32,21
1657144767173,MATH 142A,B05,093559,Chow; Bennett,6,0,32,26
1657144773196,MATH 193A,A01,083224,Rotar; Vladimir,7,0,34,27
1657144773196,MATH 193A,A02,083225,Rotar; Vladimir,5,0,34,29
1657144773196,MATH 193A,A03,083781,Rotar; Vladimir,1,0,34,33
1657144773196,MATH 193A,A04,083782,Rotar; Vladimir,8,0,34,26
1657144773196,MATH 193A,A05,093482,Rotar; Vladimir,6,0,34,28
1657144779218,MATH 197,001,091859,McAuley; Julian John,9999,0,9999,0
1657144779218,MATH 197,002,095566,Kedlaya; Kiran S.,9997,0,9999,2
1657144779218,MATH 197,003,095567,Xiao; Ming,9999,0,9999,0
1657144779218,MATH 197,004,095571,Perols; Johan Lars,9998,0,9999,1
1657144786287,COGS 9,A01,083615,Shannon; Kyle Michael,7,0,75,68
1657144792309,COGS 11,A01,083617,Boyle; Mary E. T.,21,0,48,27
1657144798334,COGS 13,A01,083071,Bastos; Amalia Pinkusfeld,9,0,71,62
1657144804365,COGS 14A,A01,092681,Semenuks; Arturs,1,1,100,99
1657144810392,COGS 14B,A01,083073,Cheng; Tzu-Han,6,0,63,57
1657144816418,COGS 17,A01,092677,Semenuks; Arturs,4,0,81,77
1657144822444,COGS 100,A01,083619,Allen; Michael Gordon,15,0,70,55
1657144828473,COGS 101A,A01,083621,Davis; Joshua Daniel,9,0,68,59
1657144834503,COGS 101B,A01,091572,Allen; Michael Gordon,9,0,65,56
1657144840532,COGS 101C,A01,083625,Delgado; Tania,17,0,35,18
1657144846562,COGS 107A,A01,083627,Boyle; Mary E. T.,13,0,60,47
1657144852587,COGS 118A,A01,083075,Gupta; Anjum,15,0,76,61
1657144858613,CSE 3,A50,083646,Miranda; Gregory Joseph,24,0,50,26
1657144864635,CSE 8A,A50,083650,Miranda; Gregory Joseph,17,1,56,39
1657144870658,CSE 11,A01,083080,Cao; Yingjun,5,15,40,35
1657144876685,CSE 12,A01,083652,Krause-Levy; Sophia Louisa,24,1,120,96
1657144882722,CSE 15L,A01,083654,Morris; Justin Loren,9,0,50,41
1657144882722,CSE 15L,A02,083655,Morris; Justin Loren,9,0,50,41
1657144888747,CSE 20,A01,083657,Tran; Khoa Dang,38,0,80,42
1657144894782,CSE 21,A01,095574,Bach; Quang Tran,22,0,48,26
1657144900808,CSE 30,A01,083084,Eldon; John,4,0,80,76
1657144900808,CSE 30,B01,095061,Bhaskar; Nishant,7,0,50,43
1657144906829,CSE 100,A01,083659,Cao; Yingjun,4,4,70,66
1657144912853,CSE 134B,A01,083661,Powell; Thomas Allan,20,0,100,80
1657144918876,CSE 140,A01,083663,Gungor; Onat,13,0,85,72
1657144924909,CSE 140L,A01,083088,Eldon; John,17,0,100,83
1657144930932,CSE 175,A01,083665,Kumar; Rakesh,3,0,25,22
1657144936974,CSE 190,A00,092507,Dubnov; Shlomo,7,0,20,13
1657144942997,ECE 45,A01,083139,Congero; Spencer William,5,0,75,70
1657144949022,ECE 65,A50,083695,Saad; Andrew S,12,0,30,18
1657144949022,ECE 65,A51,095125,Saad; Andrew S,25,0,26,1
1657144955053,ECE 109,A01,091882,Touri; Behrouz,18,0,70,52
1657144961078,ECE 180,A00,083140,Abi Samra; Nicholas Camill,1,0,30,29
1657144961078,ECE 180,B00,083141,Abi Samra; Nicholas Camill,0,0,30,30
1657144967111,MATH 10A,A01,083735,Patchell; Gregory David,2,0,30,28
1657144967111,MATH 10A,A02,083736,Patchell; Gregory David,20,0,30,10
1657144967111,MATH 10A,A03,083737,Patchell; Gregory David,16,0,30,14
1657144973139,MATH 10B,A01,083207,Lim; Seonhee,7,0,34,27
1657144973139,MATH 10B,A02,083208,Lim; Seonhee,9,0,35,26
1657144973139,MATH 10B,A03,093472,Lim; Seonhee,5,0,34,29
1657144973139,MATH 10B,B01,083739,Sinha; Shubham,9,0,30,21
1657144979181,MATH 18,A01,083743,Cinel; Cameron Alexander,6,0,30,24
1657144979181,MATH 18,A02,083744,Cinel; Cameron Alexander,15,0,30,15
1657144979181,MATH 18,A03,083745,Cinel; Cameron Alexander,8,0,30,22
1657144979181,MATH 18,B01,083748,Rideout; David Porter,4,0,37,33
1657144979181,MATH 18,B02,083749,Rideout; David Porter,3,0,36,33
1657144979181,MATH 18,B03,083750,Rideout; David Porter,2,0,37,35
1657144979181,MATH 18,B04,083751,Rideout; David Porter,5,0,36,31
1657144979181,MATH 18,B05,093473,Rideout; David Porter,4,0,36,32
1657144979181,MATH 18,B06,093474,Rideout; David Porter,5,0,36,31
1657144985207,MATH 20A,A01,083754,Zheng; Zequn,12,0,40,28
1657144991231,MATH 20B,A01,083756,Briones; Jor-el Thomas Caparas,1,0,36,35
1657144991231,MATH 20B,A02,083757,Briones; Jor-el Thomas Caparas,1,0,36,35
1657144991231,MATH 20B,A03,093475,Briones; Jor-el Thomas Caparas,1,0,36,35
1657144997260,MATH 20C,A01,083760,Briones; Jor-el Thomas Caparas,1,0,35,34
1657144997260,MATH 20C,A02,083761,Briones; Jor-el Thomas Caparas,8,0,35,27
1657144997260,MATH 20C,A03,093476,Briones; Jor-el Thomas Caparas,0,1,36,36
1657144997260,MATH 20C,B01,083762,Bach; Quang Tran,0,0,30,30
1657145003368,MATH 20D,A01,083765,Tran; Brian Kha,4,0,30,26
1657145003368,MATH 20D,A02,083766,Tran; Brian Kha,5,0,30,25
1657145003368,MATH 20D,A03,083767,Tran; Brian Kha,3,0,30,27
1657145009403,MATH 20E,A01,083771,Ganguly; Soumya,7,0,32,25
1657145009403,MATH 20E,A02,083772,Ganguly; Soumya,7,0,32,25
1657145009403,MATH 20E,B01,083773,Ciotti; Benjamin,19,0,35,16
1657145009403,MATH 20E,B02,083774,Ciotti; Benjamin,17,0,35,18
1657145015428,MATH 103A,A01,083777,Greenfeld; Be'Eri,2,0,36,34
1657145015428,MATH 103A,A02,083778,Greenfeld; Be'Eri,5,0,36,31
1657145015428,MATH 103A,A03,093561,Greenfeld; Be'Eri,4,0,36,32
1657145015428,MATH 103A,B01,083779,Greenfeld; Be'Eri,6,0,36,30
1657145015428,MATH 103A,B02,083780,Greenfeld; Be'Eri,3,0,36,33
1657145015428,MATH 103A,B03,093562,Greenfeld; Be'Eri,3,0,36,33
1657145021450,MATH 105,A01,085443,Carter; Anne Toulson,14,0,35,21
1657145021450,MATH 105,A02,093477,Carter; Anne Toulson,20,0,35,15
1657145027474,MATH 109,A01,083213,Ganzberger; Geoffrey Michael,2,0,34,32
1657145027474,MATH 109,A02,083214,Ganzberger; Geoffrey Michael,3,0,34,31
1657145027474,MATH 109,A03,093478,Ganzberger; Geoffrey Michael,1,0,34,33
1657145027474,MATH 109,B01,083215,Ganzberger; Geoffrey Michael,1,0,32,31
1657145027474,MATH 109,B02,083216,Ganzberger; Geoffrey Michael,1,0,32,31
1657145027474,MATH 109,B03,093479,Ganzberger; Geoffrey Michael,6,0,32,26
1657145033503,MATH 142A,A01,083219,Chow; Bennett,6,0,32,26
1657145033503,MATH 142A,A02,083220,Chow; Bennett,10,0,32,22
1657145033503,MATH 142A,A03,093480,Chow; Bennett,7,0,32,25
1657145033503,MATH 142A,B03,093481,Chow; Bennett,8,0,32,24
1657145033503,MATH 142A,B04,093558,Chow; Bennett,11,0,32,21
1657145033503,MATH 142A,B05,093559,Chow; Bennett,6,0,32,26
1657145039527,MATH 193A,A01,083224,Rotar; Vladimir,7,0,34,27
1657145039527,MATH 193A,A02,083225,Rotar; Vladimir,5,0,34,29
1657145039527,MATH 193A,A03,083781,Rotar; Vladimir,1,0,34,33
1657145039527,MATH 193A,A04,083782,Rotar; Vladimir,8,0,34,26
1657145039527,MATH 193A,A05,093482,Rotar; Vladimir,6,0,34,28
1657145045557,MATH 197,001,091859,McAuley; Julian John,9999,0,9999,0
1657145045557,MATH 197,002,095566,Kedlaya; Kiran S.,9997,0,9999,2
1657145045557,MATH 197,003,095567,Xiao; Ming,9999,0,9999,0
1657145045557,MATH 197,004,095571,Perols; Johan Lars,9998,0,9999,1
1657145052624,COGS 9,A01,083615,Shannon; Kyle Michael,7,0,75,68
1657145058651,COGS 11,A01,083617,Boyle; Mary E. T.,21,0,48,27
1657145064674,COGS 13,A01,083071,Bastos; Amalia Pinkusfeld,9,0,71,62
1657145070702,COGS 14A,A01,092681,Semenuks; Arturs,1,1,100,99
1657145076725,COGS 14B,A01,083073,Cheng; Tzu-Han,6,0,63,57
1657145082751,COGS 17,A01,092677,Semenuks; Arturs,4,0,81,77
1657145088773,COGS 100,A01,083619,Allen; Michael Gordon,15,0,70,55
1657145094801,COGS 101A,A01,083621,Davis; Joshua Daniel,9,0,68,59
1657145100835,COGS 101B,A01,091572,Allen; Michael Gordon,9,0,65,56
1657145106857,COGS 101C,A01,083625,Delgado; Tania,17,0,35,18
1657145112881,COGS 107A,A01,083627,Boyle; Mary E. T.,13,0,60,47
1657145118910,COGS 118A,A01,083075,Gupta; Anjum,15,0,76,61
1657145124933,CSE 3,A50,083646,Miranda; Gregory Joseph,24,0,50,26
1657145130965,CSE 8A,A50,083650,Miranda; Gregory Joseph,17,1,56,39
1657145136997,CSE 11,A01,083080,Cao; Yingjun,5,15,40,35
1657145143023,CSE 12,A01,083652,Krause-Levy; Sophia Louisa,24,1,120,96
1657145149047,CSE 15L,A01,083654,Morris; Justin Loren,9,0,50,41
1657145149047,CSE 15L,A02,083655,Morris; Justin Loren,9,0,50,41
1657145155073,CSE 20,A01,083657,Tran; Khoa Dang,38,0,80,42
1657145161102,CSE 21,A01,095574,Bach; Quang Tran,22,0,48,26
1657145167142,CSE 30,A01,083084,Eldon; John,4,0,80,76
1657145167142,CSE 30,B01,095061,Bhaskar; Nishant,7,0,50,43
1657145173176,CSE 100,A01,083659,Cao; Yingjun,4,4,70,66
1657145179198,CSE 134B,A01,083661,Powell; Thomas Allan,20,0,100,80
1657145185221,CSE 140,A01,083663,Gungor; Onat,13,0,85,72
1657145191246,CSE 140L,A01,083088,Eldon; John,17,0,100,83
1657145197270,CSE 175,A01,083665,Kumar; Rakesh,3,0,25,22
1657145203305,CSE 190,A00,092507,Dubnov; Shlomo,7,0,20,13
1657145209330,ECE 45,A01,083139,Congero; Spencer William,5,0,75,70
1657145215358,ECE 65,A50,083695,Saad; Andrew S,12,0,30,18
1657145215358,ECE 65,A51,095125,Saad; Andrew S,25,0,26,1
1657145221385,ECE 109,A01,091882,Touri; Behrouz,18,0,70,52
1657145227410,ECE 180,A00,083140,Abi Samra; Nicholas Camill,1,0,30,29
1657145227410,ECE 180,B00,083141,Abi Samra; Nicholas Camill,0,0,30,30
1657145233438,MATH 10A,A01,083735,Patchell; Gregory David,2,0,30,28
1657145233438,MATH 10A,A02,083736,Patchell; Gregory David,20,0,30,10
1657145233438,MATH 10A,A03,083737,Patchell; Gregory David,16,0,30,14
1657145239461,MATH 10B,A01,083207,Lim; Seonhee,7,0,34,27
1657145239461,MATH 10B,A02,083208,Lim; Seonhee,9,0,35,26
1657145239461,MATH 10B,A03,093472,Lim; Seonhee,5,0,34,29
1657145239461,MATH 10B,B01,083739,Sinha; Shubham,9,0,30,21
1657145245486,MATH 18,A01,083743,Cinel; Cameron Alexander,6,0,30,24
1657145245486,MATH 18,A02,083744,Cinel; Cameron Alexander,15,0,30,15
1657145245486,MATH 18,A03,083745,Cinel; Cameron Alexander,8,0,30,22
1657145245486,MATH 18,B01,083748,Rideout; David Porter,4,0,37,33
1657145245486,MATH 18,B02,083749,Rideout; David Porter,3,0,36,33
1657145245486,MATH 18,B03,083750,Rideout; David Porter,2,0,37,35
1657145245486,MATH 18,B04,083751,Rideout; David Porter,5,0,36,31
1657145245486,MATH 18,B05,093473,Rideout; David Porter,4,0,36,32
1657145245486,MATH 18,B06,093474,Rideout; David Porter,5,0,36,31
1657145251514,MATH 20A,A01,083754,Zheng; Zequn,12,0,40,28
1657145257548,MATH 20B,A01,083756,Briones; Jor-el Thomas Caparas,1,0,36,35
1657145257548,MATH 20B,A02,083757,Briones; Jor-el Thomas Caparas,1,0,36,35
1657145257548,MATH 20B,A03,093475,Briones; Jor-el Thomas Caparas,1,0,36,35
1657145263580,MATH 20C,A01,083760,Briones; Jor-el Thomas Caparas,1,0,35,34
1657145263580,MATH 20C,A02,083761,Briones; Jor-el Thomas Caparas,8,0,35,27
1657145263580,MATH 20C,A03,093476,Briones; Jor-el Thomas Caparas,0,1,36,36
1657145263580,MATH 20C,B01,083762,Bach; Quang Tran,0,0,30,30
1657145269602,MATH 20D,A01,083765,Tran; Brian Kha,4,0,30,26
1657145269602,MATH 20D,A02,083766,Tran; Brian Kha,5,0,30,25
1657145269602,MATH 20D,A03,083767,Tran; Brian Kha,3,0,30,27
1657145275638,MATH 20E,A01,083771,Ganguly; Soumya,7,0,32,25
1657145275638,MATH 20E,A02,083772,Ganguly; Soumya,7,0,32,25
1657145275638,MATH 20E,B01,083773,Ciotti; Benjamin,19,0,35,16
1657145275638,MATH 20E,B02,083774,Ciotti; Benjamin,17,0,35,18
1657145281669,MATH 103A,A01,083777,Greenfeld; Be'Eri,2,0,36,34
1657145281669,MATH 103A,A02,083778,Greenfeld; Be'Eri,5,0,36,31
1657145281669,MATH 103A,A03,093561,Greenfeld; Be'Eri,4,0,36,32
1657145281669,MATH 103A,B01,083779,Greenfeld; Be'Eri,6,0,36,30
1657145281669,MATH 103A,B02,083780,Greenfeld; Be'Eri,3,0,36,33
1657145281669,MATH 103A,B03,093562,Greenfeld; Be'Eri,3,0,36,33
1657145287701,MATH 105,A01,085443,Carter; Anne Toulson,14,0,35,21
1657145287701,MATH 105,A02,093477,Carter; Anne Toulson,20,0,35,15
1657145293736,MATH 109,A01,083213,Ganzberger; Geoffrey Michael,2,0,34,32
1657145293736,MATH 109,A02,083214,Ganzberger; Geoffrey Michael,3,0,34,31
1657145293736,MATH 109,A03,093478,Ganzberger; Geoffrey Michael,1,0,34,33
1657145293736,MATH 109,B01,083215,Ganzberger; Geoffrey Michael,1,0,32,31
1657145293736,MATH 109,B02,083216,Ganzberger; Geoffrey Michael,1,0,32,31
1657145293736,MATH 109,B03,093479,Ganzberger; Geoffrey Michael,6,0,32,26
1657145299771,MATH 142A,A01,083219,Chow; Bennett,6,0,32,26
1657145299771,MATH 142A,A02,083220,Chow; Bennett,10,0,32,22
1657145299771,MATH 142A,A03,093480,Chow; Bennett,7,0,32,25
1657145299771,MATH 142A,B03,093481,Chow; Bennett,8,0,32,24
1657145299771,MATH 142A,B04,093558,Chow; Bennett,11,0,32,21
1657145299771,MATH 142A,B05,093559,Chow; Bennett,6,0,32,26
1657145305803,MATH 193A,A01,083224,Rotar; Vladimir,7,0,34,27
1657145305803,MATH 193A,A02,083225,Rotar; Vladimir,5,0,34,29
1657145305803,MATH 193A,A03,083781,Rotar; Vladimir,1,0,34,33
1657145305803,MATH 193A,A04,083782,Rotar; Vladimir,8,0,34,26
1657145305803,MATH 193A,A05,093482,Rotar; Vladimir,6,0,34,28
1657145311825,MATH 197,001,091859,McAuley; Julian John,9999,0,9999,0
1657145311825,MATH 197,002,095566,Kedlaya; Kiran S.,9997,0,9999,2
1657145311825,MATH 197,003,095567,Xiao; Ming,9999,0,9999,0
1657145311825,MATH 197,004,095571,Perols; Johan Lars,9998,0,9999,1
1657145318878,COGS 9,A01,083615,Shannon; Kyle Michael,7,0,75,68
1657145324909,COGS 11,A01,083617,Boyle; Mary E. T.,21,0,48,27
1657145330938,COGS 13,A01,083071,Bastos; Amalia Pinkusfeld,9,0,71,62
1657145336961,COGS 14A,A01,092681,Semenuks; Arturs,1,1,100,99
1657145342989,COGS 14B,A01,083073,Cheng; Tzu-Han,6,0,63,57
1657145349012,COGS 17,A01,092677,Semenuks; Arturs,4,0,81,77
1657145355037,COGS 100,A01,083619,Allen; Michael Gordon,15,0,70,55
1657145361065,COGS 101A,A01,083621,Davis; Joshua Daniel,9,0,68,59
1657145367092,COGS 101B,A01,091572,Allen; Michael Gordon,9,0,65,56
1657145373117,COGS 101C,A01,083625,Delgado; Tania,17,0,35,18
1657145379140,COGS 107A,A01,083627,Boyle; Mary E. T.,13,0,60,47
1657145385163,COGS 118A,A01,083075,Gupta; Anjum,15,0,76,61
1657145391191,CSE 3,A50,083646,Miranda; Gregory Joseph,24,0,50,26
1657145397214,CSE 8A,A50,083650,Miranda; Gregory Joseph,17,1,56,39
1657145403237,CSE 11,A01,083080,Cao; Yingjun,5,15,40,35
1657145409264,CSE 12,A01,083652,Krause-Levy; Sophia Louisa,24,1,120,96
1657145415290,CSE 15L,A01,083654,Morris; Justin Loren,9,0,50,41
1657145415290,CSE 15L,A02,083655,Morris; Justin Loren,9,0,50,41
1657145421324,CSE 20,A01,083657,Tran; Khoa Dang,38,0,80,42
1657145427371,CSE 21,A01,095574,Bach; Quang Tran,22,0,48,26
1657145433400,CSE 30,A01,083084,Eldon; John,4,0,80,76
1657145433400,CSE 30,B01,095061,Bhaskar; Nishant,7,0,50,43
1657145439426,CSE 100,A01,083659,Cao; Yingjun,4,4,70,66
1657145445450,CSE 134B,A01,083661,Powell; Thomas Allan,20,0,100,80
1657145451475,CSE 140,A01,083663,Gungor; Onat,13,0,85,72
1657145457503,CSE 140L,A01,083088,Eldon; John,17,0,100,83
1657145463528,CSE 175,A01,083665,Kumar; Rakesh,3,0,25,22
1657145469551,CSE 190,A00,092507,Dubnov; Shlomo,7,0,20,13
1657145475579,ECE 45,A01,083139,Congero; Spencer William,5,0,75,70
1657145481607,ECE 65,A50,083695,Saad; Andrew S,12,0,30,18
1657145481607,ECE 65,A51,095125,Saad; Andrew S,25,0,26,1
1657145487632,ECE 109,A01,091882,Touri; Behrouz,18,0,70,52
1657145493655,ECE 180,A00,083140,Abi Samra; Nicholas Camill,1,0,30,29
1657145493655,ECE 180,B00,083141,Abi Samra; Nicholas Camill,0,0,30,30
1657145499690,MATH 10A,A01,083735,Patchell; Gregory David,2,0,30,28
1657145499690,MATH 10A,A02,083736,Patchell; Gregory David,20,0,30,10
1657145499690,MATH 10A,A03,083737,Patchell; Gregory David,16,0,30,14
1657145505715,MATH 10B,A01,083207,Lim; Seonhee,7,0,34,27
1657145505715,MATH 10B,A02,083208,Lim; Seonhee,9,0,35,26
1657145505715,MATH 10B,A03,093472,Lim; Seonhee,5,0,34,29
1657145505715,MATH 10B,B01,083739,Sinha; Shubham,9,0,30,21
1657145511747,MATH 18,A01,083743,Cinel; Cameron Alexander,6,0,30,24
1657145511747,MATH 18,A02,083744,Cinel; Cameron Alexander,15,0,30,15
1657145511747,MATH 18,A03,083745,Cinel; Cameron Alexander,8,0,30,22
1657145511747,MATH 18,B01,083748,Rideout; David Porter,4,0,37,33
1657145511747,MATH 18,B02,083749,Rideout; David Porter,3,0,36,33
1657145511747,MATH 18,B03,083750,Rideout; David Porter,2,0,37,35
1657145511747,MATH 18,B04,083751,Rideout; David Porter,5,0,36,31
1657145511747,MATH 18,B05,093473,Rideout; David Porter,4,0,36,32
1657145511747,MATH 18,B06,093474,Rideout; David Porter,5,0,36,31
1657145517777,MATH 20A,A01,083754,Zheng; Zequn,12,0,40,28
1657145523806,MATH 20B,A01,083756,Briones; Jor-el Thomas Caparas,1,0,36,35
1657145523806,MATH 20B,A02,083757,Briones; Jor-el Thomas Caparas,1,0,36,35
1657145523806,MATH 20B,A03,093475,Briones; Jor-el Thomas Caparas,1,0,36,35
1657145529834,MATH 20C,A01,083760,Briones; Jor-el Thomas Caparas,1,0,35,34
1657145529834,MATH 20C,A02,083761,Briones; Jor-el Thomas Caparas,8,0,35,27
1657145529834,MATH 20C,A03,093476,Briones; Jor-el Thomas Caparas,0,1,36,36
1657145529834,MATH 20C,B01,083762,Bach; Quang Tran,0,0,30,30
1657145535864,MATH 20D,A01,083765,Tran; Brian Kha,4,0,30,26
1657145535864,MATH 20D,A02,083766,Tran; Brian Kha,5,0,30,25
1657145535864,MATH 20D,A03,083767,Tran; Brian Kha,3,0,30,27
1657145541894,MATH 20E,A01,083771,Ganguly; Soumya,7,0,32,25
1657145541894,MATH 20E,A02,083772,Ganguly; Soumya,7,0,32,25
1657145541894,MATH 20E,B01,083773,Ciotti; Benjamin,19,0,35,16
1657145541894,MATH 20E,B02,083774,Ciotti; Benjamin,17,0,35,18
1657145547919,MATH 103A,A01,083777,Greenfeld; Be'Eri,2,0,36,34
1657145547919,MATH 103A,A02,083778,Greenfeld; Be'Eri,5,0,36,31
1657145547919,MATH 103A,A03,093561,Greenfeld; Be'Eri,4,0,36,32
1657145547919,MATH 103A,B01,083779,Greenfeld; Be'Eri,6,0,36,30
1657145547919,MATH 103A,B02,083780,Greenfeld; Be'Eri,3,0,36,33
1657145547919,MATH 103A,B03,093562,Greenfeld; Be'Eri,3,0,36,33
1657145553949,MATH 105,A01,085443,Carter; Anne Toulson,14,0,35,21
1657145553949,MATH 105,A02,093477,Carter; Anne Toulson,20,0,35,15
1657145559977,MATH 109,A01,083213,Ganzberger; Geoffrey Michael,2,0,34,32
1657145559977,MATH 109,A02,083214,Ganzberger; Geoffrey Michael,3,0,34,31
1657145559977,MATH 109,A03,093478,Ganzberger; Geoffrey Michael,1,0,34,33
1657145559977,MATH 109,B01,083215,Ganzberger; Geoffrey Michael,1,0,32,31
1657145559977,MATH 109,B02,083216,Ganzberger; Geoffrey Michael,1,0,32,31
1657145559977,MATH 109,B03,093479,Ganzberger; Geoffrey Michael,6,0,32,26
1657145566015,MATH 142A,A01,083219,Chow; Bennett,6,0,32,26
1657145566015,MATH 142A,A02,083220,Chow; Bennett,10,0,32,22
1657145566015,MATH 142A,A03,093480,Chow; Bennett,7,0,32,25
1657145566015,MATH 142A,B03,093481,Chow; Bennett,8,0,32,24
1657145566015,MATH 142A,B04,093558,Chow; Bennett,11,0,32,21
1657145566015,MATH 142A,B05,093559,Chow; Bennett,6,0,32,26
1657145572040,MATH 193A,A01,083224,Rotar; Vladimir,7,0,34,27
1657145572040,MATH 193A,A02,083225,Rotar; Vladimir,5,0,34,29
1657145572040,MATH 193A,A03,083781,Rotar; Vladimir,1,0,34,33
1657145572040,MATH 193A,A04,083782,Rotar; Vladimir,8,0,34,26
1657145572040,MATH 193A,A05,093482,Rotar; Vladimir,6,0,34,28
1657145578063,MATH 197,001,091859,McAuley; Julian John,9999,0,9999,0
1657145578063,MATH 197,002,095566,Kedlaya; Kiran S.,9997,0,9999,2
1657145578063,MATH 197,003,095567,Xiao; Ming,9999,0,9999,0
1657145578063,MATH 197,004,095571,Perols; Johan Lars,9998,0,9999,1
1657145585114,COGS 9,A01,083615,Shannon; Kyle Michael,7,0,75,68
1657145591142,COGS 11,A01,083617,Boyle; Mary E. T.,21,0,48,27
1657145597271,COGS 13,A01,083071,Bastos; Amalia Pinkusfeld,9,0,71,62
1657145603296,COGS 14A,A01,092681,Semenuks; Arturs,1,1,100,99
1657145609322,COGS 14B,A01,083073,Cheng; Tzu-Han,6,0,63,57
1657145615345,COGS 17,A01,092677,Semenuks; Arturs,4,0,81,77
1657145621415,COGS 100,A01,083619,Allen; Michael Gordon,15,0,70,55
1657145627443,COGS 101A,A01,083621,Davis; Joshua Daniel,9,0,68,59
1657145633466,COGS 101B,A01,091572,Allen; Michael Gordon,9,0,65,56
1657145639499,COGS 101C,A01,083625,Delgado; Tania,17,0,35,18
1657145645523,COGS 107A,A01,083627,Boyle; Mary E. T.,13,0,60,47
1657145651553,COGS 118A,A01,083075,Gupta; Anjum,15,0,76,61
1657145657579,CSE 3,A50,083646,Miranda; Gregory Joseph,24,0,50,26
1657145663603,CSE 8A,A50,083650,Miranda; Gregory Joseph,17,1,56,39
1657145669624,CSE 11,A01,083080,Cao; Yingjun,5,15,40,35
1657145675657,CSE 12,A01,083652,Krause-Levy; Sophia Louisa,24,1,120,96
1657145681699,CSE 15L,A01,083654,Morris; Justin Loren,9,0,50,41
1657145681699,CSE 15L,A02,083655,Morris; Justin Loren,9,0,50,41
1657145687723,CSE 20,A01,083657,Tran; Khoa Dang,38,0,80,42
1657145693753,CSE 21,A01,095574,Bach; Quang Tran,22,0,48,26
1657145699793,CSE 30,A01,083084,Eldon; John,4,0,80,76
1657145699793,CSE 30,B01,095061,Bhaskar; Nishant,7,0,50,43
1657145705816,CSE 100,A01,083659,Cao; Yingjun,4,4,70,66
1657145711842,CSE 134B,A01,083661,Powell; Thomas Allan,20,0,100,80
1657145717868,CSE 140,A01,083663,Gungor; Onat,13,0,85,72
1657145723892,CSE 140L,A01,083088,Eldon; John,17,0,100,83
1657145729923,CSE 175,A01,083665,Kumar; Rakesh,3,0,25,22
1657145735951,CSE 190,A00,092507,Dubnov; Shlomo,7,0,20,13
1657145741975,ECE 45,A01,083139,Congero; Spencer William,5,0,75,70
1657145748004,ECE 65,A50,083695,Saad; Andrew S,12,0,30,18
1657145748004,ECE 65,A51,095125,Saad; Andrew S,25,0,26,1
1657145754030,ECE 109,A01,091882,Touri; Behrouz,18,0,70,52
1657145760055,ECE 180,A00,083140,Abi Samra; Nicholas Camill,1,0,30,29
1657145760055,ECE 180,B00,083141,Abi Samra; Nicholas Camill,0,0,30,30
1657145766091,MATH 10A,A01,083735,Patchell; Gregory David,2,0,30,28
1657145766091,MATH 10A,A02,083736,Patchell; Gregory David,20,0,30,10
1657145766091,MATH 10A,A03,083737,Patchell; Gregory David,16,0,30,14
1657145772120,MATH 10B,A01,083207,Lim; Seonhee,7,0,34,27
1657145772120,MATH 10B,A02,083208,Lim; Seonhee,9,0,35,26
1657145772120,MATH 10B,A03,093472,Lim; Seonhee,5,0,34,29
1657145772120,MATH 10B,B01,083739,Sinha; Shubham,9,0,30,21
1657145778153,MATH 18,A01,083743,Cinel; Cameron Alexander,6,0,30,24
1657145778153,MATH 18,A02,083744,Cinel; Cameron Alexander,15,0,30,15
1657145778153,MATH 18,A03,083745,Cinel; Cameron Alexander,8,0,30,22
1657145778153,MATH 18,B01,083748,Rideout; David Porter,4,0,37,33
1657145778153,MATH 18,B02,083749,Rideout; David Porter,3,0,36,33
1657145778153,MATH 18,B03,083750,Rideout; David Porter,2,0,37,35
1657145778153,MATH 18,B04,083751,Rideout; David Porter,5,0,36,31
1657145778153,MATH 18,B05,093473,Rideout; David Porter,4,0,36,32
1657145778153,MATH 18,B06,093474,Rideout; David Porter,5,0,36,31
1657145784182,MATH 20A,A01,083754,Zheng; Zequn,12,0,40,28
1657145790221,MATH 20B,A01,083756,Briones; Jor-el Thomas Caparas,1,0,36,35
1657145790221,MATH 20B,A02,083757,Briones; Jor-el Thomas Caparas,1,0,36,35
1657145790221,MATH 20B,A03,093475,Briones; Jor-el Thomas Caparas,1,0,36,35
1657145796263,MATH 20C,A01,083760,Briones; Jor-el Thomas Caparas,1,0,35,34
1657145796263,MATH 20C,A02,083761,Briones; Jor-el Thomas Caparas,8,0,35,27
1657145796263,MATH 20C,A03,093476,Briones; Jor-el Thomas Caparas,0,1,36,36
1657145796263,MATH 20C,B01,083762,Bach; Quang Tran,0,0,30,30
1657145802290,MATH 20D,A01,083765,Tran; Brian Kha,4,0,30,26
1657145802290,MATH 20D,A02,083766,Tran; Brian Kha,5,0,30,25
1657145802290,MATH 20D,A03,083767,Tran; Brian Kha,3,0,30,27
1657145808314,MATH 20E,A01,083771,Ganguly; Soumya,7,0,32,25
1657145808314,MATH 20E,A02,083772,Ganguly; Soumya,7,0,32,25
1657145808314,MATH 20E,B01,083773,Ciotti; Benjamin,19,0,35,16
1657145808314,MATH 20E,B02,083774,Ciotti; Benjamin,17,0,35,18
1657145814340,MATH 103A,A01,083777,Greenfeld; Be'Eri,2,0,36,34
1657145814340,MATH 103A,A02,083778,Greenfeld; Be'Eri,5,0,36,31
1657145814340,MATH 103A,A03,093561,Greenfeld; Be'Eri,4,0,36,32
1657145814340,MATH 103A,B01,083779,Greenfeld; Be'Eri,6,0,36,30
1657145814340,MATH 103A,B02,083780,Greenfeld; Be'Eri,3,0,36,33
1657145814340,MATH 103A,B03,093562,Greenfeld; Be'Eri,3,0,36,33
1657145820364,MATH 105,A01,085443,Carter; Anne Toulson,14,0,35,21
1657145820364,MATH 105,A02,093477,Carter; Anne Toulson,20,0,35,15
1657145826388,MATH 109,A01,083213,Ganzberger; Geoffrey Michael,2,0,34,32
1657145826388,MATH 109,A02,083214,Ganzberger; Geoffrey Michael,3,0,34,31
1657145826388,MATH 109,A03,093478,Ganzberger; Geoffrey Michael,1,0,34,33
1657145826388,MATH 109,B01,083215,Ganzberger; Geoffrey Michael,1,0,32,31
1657145826388,MATH 109,B02,083216,Ganzberger; Geoffrey Michael,1,0,32,31
1657145826388,MATH 109,B03,093479,Ganzberger; Geoffrey Michael,6,0,32,26
1657145832422,MATH 142A,A01,083219,Chow; Bennett,6,0,32,26
1657145832422,MATH 142A,A02,083220,Chow; Bennett,10,0,32,22
1657145832422,MATH 142A,A03,093480,Chow; Bennett,7,0,32,25
1657145832422,MATH 142A,B03,093481,Chow; Bennett,8,0,32,24
1657145832422,MATH 142A,B04,093558,Chow; Bennett,11,0,32,21
1657145832422,MATH 142A,B05,093559,Chow; Bennett,6,0,32,26
1657145838452,MATH 193A,A01,083224,Rotar; Vladimir,7,0,34,27
1657145838452,MATH 193A,A02,083225,Rotar; Vladimir,5,0,34,29
1657145838452,MATH 193A,A03,083781,Rotar; Vladimir,1,0,34,33
1657145838452,MATH 193A,A04,083782,Rotar; Vladimir,8,0,34,26
1657145838452,MATH 193A,A05,093482,Rotar; Vladimir,6,0,34,28
1657145844479,MATH 197,001,091859,McAuley; Julian John,9999,0,9999,0
1657145844479,MATH 197,002,095566,Kedlaya; Kiran S.,9997,0,9999,2
1657145844479,MATH 197,003,095567,Xiao; Ming,9999,0,9999,0
1657145844479,MATH 197,004,095571,Perols; Johan Lars,9998,0,9999,1
1657145851548,COGS 9,A01,083615,Shannon; Kyle Michael,7,0,75,68
1657145857575,COGS 11,A01,083617,Boyle; Mary E. T.,21,0,48,27
1657145863599,COGS 13,A01,083071,Bastos; Amalia Pinkusfeld,9,0,71,62
1657145869622,COGS 14A,A01,092681,Semenuks; Arturs,1,1,100,99
1657145875652,COGS 14B,A01,083073,Cheng; Tzu-Han,6,0,63,57
1657145881676,COGS 17,A01,092677,Semenuks; Arturs,4,0,81,77
1657145887699,COGS 100,A01,083619,Allen; Michael Gordon,15,0,70,55
1657145893725,COGS 101A,A01,083621,Davis; Joshua Daniel,9,0,68,59
1657145899760,COGS 101B,A01,091572,Allen; Michael Gordon,9,0,65,56
1657145905785,COGS 101C,A01,083625,Delgado; Tania,17,0,35,18
1657145911808,COGS 107A,A01,083627,Boyle; Mary E. T.,13,0,60,47
1657145917834,COGS 118A,A01,083075,Gupta; Anjum,15,0,76,61
1657145923858,CSE 3,A50,083646,Miranda; Gregory Joseph,24,0,50,26
1657145929895,CSE 8A,A50,083650,Miranda; Gregory Joseph,17,1,56,39
1657145935921,CSE 11,A01,083080,Cao; Yingjun,5,15,40,35
1657145941942,CSE 12,A01,083652,Krause-Levy; Sophia Louisa,24,1,120,96
1657145947966,CSE 15L,A01,083654,Morris; Justin Loren,9,0,50,41
1657145947966,CSE 15L,A02,083655,Morris; Justin Loren,9,0,50,41
1657145953991,CSE 20,A01,083657,Tran; Khoa Dang,38,0,80,42
1657145960014,CSE 21,A01,095574,Bach; Quang Tran,22,0,48,26
1657145966046,CSE 30,A01,083084,Eldon; John,4,0,80,76
1657145966046,CSE 30,B01,095061,Bhaskar; Nishant,7,0,50,43
1657145972074,CSE 100,A01,083659,Cao; Yingjun,4,4,70,66
1657145978097,CSE 134B,A01,083661,Powell; Thomas Allan,20,0,100,80
1657145984133,CSE 140,A01,083663,Gungor; Onat,13,0,85,72
1657145990154,CSE 140L,A01,083088,Eldon; John,17,0,100,83
1657145996189,CSE 175,A01,083665,Kumar; Rakesh,3,0,25,22
1657146002220,CSE 190,A00,092507,Dubnov; Shlomo,7,0,20,13
1657146008249,ECE 45,A01,083139,Congero; Spencer William,5,0,75,70
1657146014276,ECE 65,A50,083695,Saad; Andrew S,12,0,30,18
1657146014276,ECE 65,A51,095125,Saad; Andrew S,25,0,26,1
1657146020310,ECE 109,A01,091882,Touri; Behrouz,18,0,70,52
1657146026336,ECE 180,A00,083140,Abi Samra; Nicholas Camill,1,0,30,29
1657146026336,ECE 180,B00,083141,Abi Samra; Nicholas Camill,0,0,30,30
1657146032375,MATH 10A,A01,083735,Patchell; Gregory David,2,0,30,28
1657146032375,MATH 10A,A02,083736,Patchell; Gregory David,20,0,30,10
1657146032375,MATH 10A,A03,083737,Patchell; Gregory David,16,0,30,14
1657146038399,MATH 10B,A01,083207,Lim; Seonhee,7,0,34,27
1657146038399,MATH 10B,A02,083208,Lim; Seonhee,9,0,35,26
1657146038399,MATH 10B,A03,093472,Lim; Seonhee,5,0,34,29
1657146038399,MATH 10B,B01,083739,Sinha; Shubham,9,0,30,21
1657146044444,MATH 18,A01,083743,Cinel; Cameron Alexander,6,0,30,24
1657146044444,MATH 18,A02,083744,Cinel; Cameron Alexander,15,0,30,15
1657146044444,MATH 18,A03,083745,Cinel; Cameron Alexander,8,0,30,22
1657146044444,MATH 18,B01,083748,Rideout; David Porter,4,0,37,33
1657146044444,MATH 18,B02,083749,Rideout; David Porter,3,0,36,33
1657146044444,MATH 18,B03,083750,Rideout; David Porter,2,0,37,35
1657146044444,MATH 18,B04,083751,Rideout; David Porter,5,0,36,31
1657146044444,MATH 18,B05,093473,Rideout; David Porter,4,0,36,32
1657146044444,MATH 18,B06,093474,Rideout; David Porter,5,0,36,31
1657146050470,MATH 20A,A01,083754,Zheng; Zequn,12,0,40,28
1657146056513,MATH 20B,A01,083756,Briones; Jor-el Thomas Caparas,1,0,36,35
1657146056513,MATH 20B,A02,083757,Briones; Jor-el Thomas Caparas,1,0,36,35
1657146056513,MATH 20B,A03,093475,Briones; Jor-el Thomas Caparas,1,0,36,35
1657146062536,MATH 20C,A01,083760,Briones; Jor-el Thomas Caparas,1,0,35,34
1657146062536,MATH 20C,A02,083761,Briones; Jor-el Thomas Caparas,8,0,35,27
1657146062536,MATH 20C,A03,093476,Briones; Jor-el Thomas Caparas,0,1,36,36
1657146062536,MATH 20C,B01,083762,Bach; Quang Tran,0,0,30,30
1657146068582,MATH 20D,A01,083765,Tran; Brian Kha,4,0,30,26
1657146068582,MATH 20D,A02,083766,Tran; Brian Kha,5,0,30,25
1657146068582,MATH 20D,A03,083767,Tran; Brian Kha,3,0,30,27
1657146074611,MATH 20E,A01,083771,Ganguly; Soumya,7,0,32,25
1657146074611,MATH 20E,A02,083772,Ganguly; Soumya,7,0,32,25
1657146074611,MATH 20E,B01,083773,Ciotti; Benjamin,19,0,35,16
1657146074611,MATH 20E,B02,083774,Ciotti; Benjamin,17,0,35,18
1657146080648,MATH 103A,A01,083777,Greenfeld; Be'Eri,2,0,36,34
1657146080648,MATH 103A,A02,083778,Greenfeld; Be'Eri,5,0,36,31
1657146080648,MATH 103A,A03,093561,Greenfeld; Be'Eri,4,0,36,32
1657146080648,MATH 103A,B01,083779,Greenfeld; Be'Eri,6,0,36,30
1657146080648,MATH 103A,B02,083780,Greenfeld; Be'Eri,3,0,36,33
1657146080648,MATH 103A,B03,093562,Greenfeld; Be'Eri,3,0,36,33
1657146086684,MATH 105,A01,085443,Carter; Anne Toulson,14,0,35,21
1657146086684,MATH 105,A02,093477,Carter; Anne Toulson,20,0,35,15
1657146092739,MATH 109,A01,083213,Ganzberger; Geoffrey Michael,2,0,34,32
1657146092739,MATH 109,A02,083214,Ganzberger; Geoffrey Michael,3,0,34,31
1657146092739,MATH 109,A03,093478,Ganzberger; Geoffrey Michael,1,0,34,33
1657146092739,MATH 109,B01,083215,Ganzberger; Geoffrey Michael,1,0,32,31
1657146092739,MATH 109,B02,083216,Ganzberger; Geoffrey Michael,1,0,32,31
1657146092739,MATH 109,B03,093479,Ganzberger; Geoffrey Michael,6,0,32,26
1657146098773,MATH 142A,A01,083219,Chow; Bennett,6,0,32,26
1657146098773,MATH 142A,A02,083220,Chow; Bennett,10,0,32,22
1657146098773,MATH 142A,A03,093480,Chow; Bennett,7,0,32,25
1657146098773,MATH 142A,B03,093481,Chow; Bennett,8,0,32,24
1657146098773,MATH 142A,B04,093558,Chow; Bennett,11,0,32,21
1657146098773,MATH 142A,B05,093559,Chow; Bennett,6,0,32,26
1657146104801,MATH 193A,A01,083224,Rotar; Vladimir,7,0,34,27
1657146104801,MATH 193A,A02,083225,Rotar; Vladimir,5,0,34,29
1657146104801,MATH 193A,A03,083781,Rotar; Vladimir,1,0,34,33
1657146104801,MATH 193A,A04,083782,Rotar; Vladimir,8,0,34,26
1657146104801,MATH 193A,A05,093482,Rotar; Vladimir,6,0,34,28
1657146110824,MATH 197,001,091859,McAuley; Julian John,9999,0,9999,0
1657146110824,MATH 197,002,095566,Kedlaya; Kiran S.,9997,0,9999,2
1657146110824,MATH 197,003,095567,Xiao; Ming,9999,0,9999,0
1657146110824,MATH 197,004,095571,Perols; Johan Lars,9998,0,9999,1
1657146117878,COGS 9,A01,083615,Shannon; Kyle Michael,7,0,75,68
1657146123920,COGS 11,A01,083617,Boyle; Mary E. T.,21,0,48,27
1657146129950,COGS 13,A01,083071,Bastos; Amalia Pinkusfeld,9,0,71,62
1657146135982,COGS 14A,A01,092681,Semenuks; Arturs,1,1,100,99
1657146142009,COGS 14B,A01,083073,Cheng; Tzu-Han,6,0,63,57
1657146148050,COGS 17,A01,092677,Semenuks; Arturs,4,0,81,77
1657146154075,COGS 100,A01,083619,Allen; Michael Gordon,15,0,70,55
1657146160098,COGS 101A,A01,083621,Davis; Joshua Daniel,9,0,68,59
1657146166125,COGS 101B,A01,091572,Allen; Michael Gordon,9,0,65,56
1657146172149,COGS 101C,A01,083625,Delgado; Tania,17,0,35,18
1657146178178,COGS 107A,A01,083627,Boyle; Mary E. T.,13,0,60,47
1657146184201,COGS 118A,A01,083075,Gupta; Anjum,15,0,76,61
1657146190223,CSE 3,A50,083646,Miranda; Gregory Joseph,24,0,50,26
1657146196340,CSE 8A,A50,083650,Miranda; Gregory Joseph,17,1,56,39
1657146202366,CSE 11,A01,083080,Cao; Yingjun,5,15,40,35
1657146208391,CSE 12,A01,083652,Krause-Levy; Sophia Louisa,24,1,120,96
1657146214422,CSE 15L,A01,083654,Morris; Justin Loren,9,0,50,41
1657146214422,CSE 15L,A02,083655,Morris; Justin Loren,9,0,50,41
1657146220449,CSE 20,A01,083657,Tran; Khoa Dang,38,0,80,42
1657146226471,CSE 21,A01,095574,Bach; Quang Tran,22,0,48,26
1657146232515,CSE 30,A01,083084,Eldon; John,4,0,80,76
1657146232515,CSE 30,B01,095061,Bhaskar; Nishant,7,0,50,43
1657146238543,CSE 100,A01,083659,Cao; Yingjun,4,4,70,66
1657146244577,CSE 134B,A01,083661,Powell; Thomas Allan,20,0,100,80
1657146250603,CSE 140,A01,083663,Gungor; Onat,13,0,85,72
1657146256637,CSE 140L,A01,083088,Eldon; John,17,0,100,83
1657146262669,CSE 175,A01,083665,Kumar; Rakesh,3,0,25,22
1657146268694,CSE 190,A00,092507,Dubnov; Shlomo,7,0,20,13
1657146274718,ECE 45,A01,083139,Congero; Spencer William,5,0,75,70
1657146280749,ECE 65,A50,083695,Saad; Andrew S,12,0,30,18
1657146280749,ECE 65,A51,095125,Saad; Andrew S,25,0,26,1
1657146286772,ECE 109,A01,091882,Touri; Behrouz,18,0,70,52
1657146292802,ECE 180,A00,083140,Abi Samra; Nicholas Camill,1,0,30,29
1657146292802,ECE 180,B00,083141,Abi Samra; Nicholas Camill,0,0,30,30
1657146298838,MATH 10A,A01,083735,Patchell; Gregory David,2,0,30,28
1657146298838,MATH 10A,A02,083736,Patchell; Gregory David,20,0,30,10
1657146298838,MATH 10A,A03,083737,Patchell; Gregory David,16,0,30,14
1657146304862,MATH 10B,A01,083207,Lim; Seonhee,7,0,34,27
1657146304862,MATH 10B,A02,083208,Lim; Seonhee,9,0,35,26
1657146304862,MATH 10B,A03,093472,Lim; Seonhee,5,0,34,29
1657146304862,MATH 10B,B01,083739,Sinha; Shubham,9,0,30,21
1657146310890,MATH 18,A01,083743,Cinel; Cameron Alexander,6,0,30,24
1657146310890,MATH 18,A02,083744,Cinel; Cameron Alexander,15,0,30,15
1657146310890,MATH 18,A03,083745,Cinel; Cameron Alexander,8,0,30,22
1657146310890,MATH 18,B01,083748,Rideout; David Porter,4,0,37,33
1657146310890,MATH 18,B02,083749,Rideout; David Porter,3,0,36,33
1657146310890,MATH 18,B03,083750,Rideout; David Porter,2,0,37,35
1657146310890,MATH 18,B04,083751,Rideout; David Porter,5,0,36,31
1657146310890,MATH 18,B05,093473,Rideout; David Porter,4,0,36,32
1657146310890,MATH 18,B06,093474,Rideout; David Porter,5,0,36,31
1657146316914,MATH 20A,A01,083754,Zheng; Zequn,12,0,40,28
1657146322938,MATH 20B,A01,083756,Briones; Jor-el Thomas Caparas,1,0,36,35
1657146322938,MATH 20B,A02,083757,Briones; Jor-el Thomas Caparas,1,0,36,35
1657146322938,MATH 20B,A03,093475,Briones; Jor-el Thomas Caparas,1,0,36,35
1657146328960,MATH 20C,A01,083760,Briones; Jor-el Thomas Caparas,1,0,35,34
1657146328960,MATH 20C,A02,083761,Briones; Jor-el Thomas Caparas,8,0,35,27
1657146328960,MATH 20C,A03,093476,Briones; Jor-el Thomas Caparas,0,1,36,36
1657146328960,MATH 20C,B01,083762,Bach; Quang Tran,0,0,30,30
1657146334987,MATH 20D,A01,083765,Tran; Brian Kha,4,0,30,26
1657146334987,MATH 20D,A02,083766,Tran; Brian Kha,5,0,30,25
1657146334987,MATH 20D,A03,083767,Tran; Brian Kha,3,0,30,27
1657146341018,MATH 20E,A01,083771,Ganguly; Soumya,7,0,32,25
1657146341018,MATH 20E,A02,083772,Ganguly; Soumya,7,0,32,25
1657146341018,MATH 20E,B01,083773,Ciotti; Benjamin,19,0,35,16
1657146341018,MATH 20E,B02,083774,Ciotti; Benjamin,17,0,35,18
1657146347045,MATH 103A,A01,083777,Greenfeld; Be'Eri,2,0,36,34
1657146347045,MATH 103A,A02,083778,Greenfeld; Be'Eri,5,0,36,31
1657146347045,MATH 103A,A03,093561,Greenfeld; Be'Eri,4,0,36,32
1657146347045,MATH 103A,B01,083779,Greenfeld; Be'Eri,6,0,36,30
1657146347045,MATH 103A,B02,083780,Greenfeld; Be'Eri,3,0,36,33
1657146347045,MATH 103A,B03,093562,Greenfeld; Be'Eri,3,0,36,33
1657146353069,MATH 105,A01,085443,Carter; Anne Toulson,14,0,35,21
1657146353069,MATH 105,A02,093477,Carter; Anne Toulson,20,0,35,15
1657146359099,MATH 109,A01,083213,Ganzberger; Geoffrey Michael,2,0,34,32
1657146359099,MATH 109,A02,083214,Ganzberger; Geoffrey Michael,3,0,34,31
1657146359099,MATH 109,A03,093478,Ganzberger; Geoffrey Michael,1,0,34,33
1657146359099,MATH 109,B01,083215,Ganzberger; Geoffrey Michael,1,0,32,31
1657146359099,MATH 109,B02,083216,Ganzberger; Geoffrey Michael,1,0,32,31
1657146359099,MATH 109,B03,093479,Ganzberger; Geoffrey Michael,6,0,32,26
1657146365123,MATH 142A,A01,083219,Chow; Bennett,6,0,32,26
1657146365123,MATH 142A,A02,083220,Chow; Bennett,10,0,32,22
1657146365123,MATH 142A,A03,093480,Chow; Bennett,7,0,32,25
1657146365123,MATH 142A,B03,093481,Chow; Bennett,8,0,32,24
1657146365123,MATH 142A,B04,093558,Chow; Bennett,11,0,32,21
1657146365123,MATH 142A,B05,093559,Chow; Bennett,6,0,32,26
1657146371154,MATH 193A,A01,083224,Rotar; Vladimir,7,0,34,27
1657146371154,MATH 193A,A02,083225,Rotar; Vladimir,5,0,34,29
1657146371154,MATH 193A,A03,083781,Rotar; Vladimir,1,0,34,33
1657146371154,MATH 193A,A04,083782,Rotar; Vladimir,8,0,34,26
1657146371154,MATH 193A,A05,093482,Rotar; Vladimir,6,0,34,28
1657146377176,MATH 197,001,091859,McAuley; Julian John,9999,0,9999,0
1657146377176,MATH 197,002,095566,Kedlaya; Kiran S.,9997,0,9999,2
1657146377176,MATH 197,003,095567,Xiao; Ming,9999,0,9999,0
1657146377176,MATH 197,004,095571,Perols; Johan Lars,9998,0,9999,1
1657146384226,COGS 9,A01,083615,Shannon; Kyle Michael,7,0,75,68
1657146390252,COGS 11,A01,083617,Boyle; Mary E. T.,21,0,48,27
1657146396276,COGS 13,A01,083071,Bastos; Amalia Pinkusfeld,9,0,71,62
1657146402304,COGS 14A,A01,092681,Semenuks; Arturs,1,1,100,99
1657146408327,COGS 14B,A01,083073,Cheng; Tzu-Han,6,0,63,57
1657146414351,COGS 17,A01,092677,Semenuks; Arturs,4,0,81,77
1657146420373,COGS 100,A01,083619,Allen; Michael Gordon,15,0,70,55
1657146426397,COGS 101A,A01,083621,Davis; Joshua Daniel,9,0,68,59
1657146432424,COGS 101B,A01,091572,Allen; Michael Gordon,9,0,65,56
1657146438460,COGS 101C,A01,083625,Delgado; Tania,17,0,35,18
1657146444486,COGS 107A,A01,083627,Boyle; Mary E. T.,13,0,60,47
1657146450511,COGS 118A,A01,083075,Gupta; Anjum,15,0,76,61
1657146456533,CSE 3,A50,083646,Miranda; Gregory Joseph,24,0,50,26
1657146462560,CSE 8A,A50,083650,Miranda; Gregory Joseph,17,1,56,39
1657146468585,CSE 11,A01,083080,Cao; Yingjun,5,15,40,35
1657146474612,CSE 12,A01,083652,Krause-Levy; Sophia Louisa,24,1,120,96
1657146480637,CSE 15L,A01,083654,Morris; Justin Loren,9,0,50,41
1657146480637,CSE 15L,A02,083655,Morris; Justin Loren,9,0,50,41
1657146486661,CSE 20,A01,083657,Tran; Khoa Dang,38,0,80,42
1657146492687,CSE 21,A01,095574,Bach; Quang Tran,22,0,48,26
1657146498711,CSE 30,A01,083084,Eldon; John,4,0,80,76
1657146498711,CSE 30,B01,095061,Bhaskar; Nishant,7,0,50,43
1657146504744,CSE 100,A01,083659,Cao; Yingjun,4,4,70,66
1657146510774,CSE 134B,A01,083661,Powell; Thomas Allan,20,0,100,80
1657146516805,CSE 140,A01,083663,Gungor; Onat,13,0,85,72
1657146522834,CSE 140L,A01,083088,Eldon; John,17,0,100,83
1657146528856,CSE 175,A01,083665,Kumar; Rakesh,3,0,25,22
1657146534881,CSE 190,A00,092507,Dubnov; Shlomo,7,0,20,13
1657146540908,ECE 45,A01,083139,Congero; Spencer William,5,0,75,70
1657146546937,ECE 65,A50,083695,Saad; Andrew S,12,0,30,18
1657146546937,ECE 65,A51,095125,Saad; Andrew S,25,0,26,1
1657146552960,ECE 109,A01,091882,Touri; Behrouz,18,0,70,52
1657146558990,ECE 180,A00,083140,Abi Samra; Nicholas Camill,1,0,30,29
1657146558990,ECE 180,B00,083141,Abi Samra; Nicholas Camill,0,0,30,30
1657146565016,MATH 10A,A01,083735,Patchell; Gregory David,2,0,30,28
1657146565016,MATH 10A,A02,083736,Patchell; Gregory David,20,0,30,10
1657146565016,MATH 10A,A03,083737,Patchell; Gregory David,16,0,30,14
1657146571048,MATH 10B,A01,083207,Lim; Seonhee,7,0,34,27
1657146571048,MATH 10B,A02,083208,Lim; Seonhee,9,0,35,26
1657146571048,MATH 10B,A03,093472,Lim; Seonhee,5,0,34,29
1657146571048,MATH 10B,B01,083739,Sinha; Shubham,9,0,30,21
1657146577074,MATH 18,A01,083743,Cinel; Cameron Alexander,6,0,30,24
1657146577074,MATH 18,A02,083744,Cinel; Cameron Alexander,15,0,30,15
1657146577074,MATH 18,A03,083745,Cinel; Cameron Alexander,8,0,30,22
1657146577074,MATH 18,B01,083748,Rideout; David Porter,4,0,37,33
1657146577074,MATH 18,B02,083749,Rideout; David Porter,3,0,36,33
1657146577074,MATH 18,B03,083750,Rideout; David Porter,2,0,37,35
1657146577074,MATH 18,B04,083751,Rideout; David Porter,5,0,36,31
1657146577074,MATH 18,B05,093473,Rideout; David Porter,4,0,36,32
1657146577074,MATH 18,B06,093474,Rideout; David Porter,5,0,36,31
1657146583100,MATH 20A,A01,083754,Zheng; Zequn,12,0,40,28
1657146589123,MATH 20B,A01,083756,Briones; Jor-el Thomas Caparas,1,0,36,35
1657146589123,MATH 20B,A02,083757,Briones; Jor-el Thomas Caparas,1,0,36,35
1657146589123,MATH 20B,A03,093475,Briones; Jor-el Thomas Caparas,1,0,36,35
1657146595152,MATH 20C,A01,083760,Briones; Jor-el Thomas Caparas,1,0,35,34
1657146595152,MATH 20C,A02,083761,Briones; Jor-el Thomas Caparas,8,0,35,27
1657146595152,MATH 20C,A03,093476,Briones; Jor-el Thomas Caparas,0,1,36,36
1657146595152,MATH 20C,B01,083762,Bach; Quang Tran,0,0,30,30
1657146601176,MATH 20D,A01,083765,Tran; Brian Kha,4,0,30,26
1657146601176,MATH 20D,A02,083766,Tran; Brian Kha,5,0,30,25
1657146601176,MATH 20D,A03,083767,Tran; Brian Kha,3,0,30,27
1657146607218,MATH 20E,A01,083771,Ganguly; Soumya,7,0,32,25
1657146607218,MATH 20E,A02,083772,Ganguly; Soumya,7,0,32,25
1657146607218,MATH 20E,B01,083773,Ciotti; Benjamin,19,0,35,16
1657146607218,MATH 20E,B02,083774,Ciotti; Benjamin,17,0,35,18
1657146613241,MATH 103A,A01,083777,Greenfeld; Be'Eri,2,0,36,34
1657146613241,MATH 103A,A02,083778,Greenfeld; Be'Eri,5,0,36,31
1657146613241,MATH 103A,A03,093561,Greenfeld; Be'Eri,4,0,36,32
1657146613241,MATH 103A,B01,083779,Greenfeld; Be'Eri,6,0,36,30
1657146613241,MATH 103A,B02,083780,Greenfeld; Be'Eri,3,0,36,33
1657146613241,MATH 103A,B03,093562,Greenfeld; Be'Eri,3,0,36,33
1657146619264,MATH 105,A01,085443,Carter; Anne Toulson,14,0,35,21
1657146619264,MATH 105,A02,093477,Carter; Anne Toulson,20,0,35,15
1657146625306,MATH 109,A01,083213,Ganzberger; Geoffrey Michael,2,0,34,32
1657146625306,MATH 109,A02,083214,Ganzberger; Geoffrey Michael,3,0,34,31
1657146625306,MATH 109,A03,093478,Ganzberger; Geoffrey Michael,1,0,34,33
1657146625306,MATH 109,B01,083215,Ganzberger; Geoffrey Michael,1,0,32,31
1657146625306,MATH 109,B02,083216,Ganzberger; Geoffrey Michael,1,0,32,31
1657146625306,MATH 109,B03,093479,Ganzberger; Geoffrey Michael,6,0,32,26
1657146631341,MATH 142A,A01,083219,Chow; Bennett,6,0,32,26
1657146631341,MATH 142A,A02,083220,Chow; Bennett,10,0,32,22
1657146631341,MATH 142A,A03,093480,Chow; Bennett,7,0,32,25
1657146631341,MATH 142A,B03,093481,Chow; Bennett,8,0,32,24
1657146631341,MATH 142A,B04,093558,Chow; Bennett,11,0,32,21
1657146631341,MATH 142A,B05,093559,Chow; Bennett,6,0,32,26
1657146637381,MATH 193A,A01,083224,Rotar; Vladimir,7,0,34,27
1657146637381,MATH 193A,A02,083225,Rotar; Vladimir,5,0,34,29
1657146637381,MATH 193A,A03,083781,Rotar; Vladimir,1,0,34,33
1657146637381,MATH 193A,A04,083782,Rotar; Vladimir,8,0,34,26
1657146637381,MATH 193A,A05,093482,Rotar; Vladimir,6,0,34,28
1657146643408,MATH 197,001,091859,McAuley; Julian John,9999,0,9999,0
1657146643408,MATH 197,002,095566,Kedlaya; Kiran S.,9997,0,9999,2
1657146643408,MATH 197,003,095567,Xiao; Ming,9999,0,9999,0
1657146643408,MATH 197,004,095571,Perols; Johan Lars,9998,0,9999,1
1657146650464,COGS 9,A01,083615,Shannon; Kyle Michael,7,0,75,68
1657146656493,COGS 11,A01,083617,Boyle; Mary E. T.,21,0,48,27
1657146662518,COGS 13,A01,083071,Bastos; Amalia Pinkusfeld,9,0,71,62
1657146668547,COGS 14A,A01,092681,Semenuks; Arturs,1,1,100,99
1657146674574,COGS 14B,A01,083073,Cheng; Tzu-Han,6,0,63,57
1657146680599,COGS 17,A01,092677,Semenuks; Arturs,4,0,81,77
1657146686624,COGS 100,A01,083619,Allen; Michael Gordon,15,0,70,55
1657146692656,COGS 101A,A01,083621,Davis; Joshua Daniel,9,0,68,59
1657146698679,COGS 101B,A01,091572,Allen; Michael Gordon,9,0,65,56
1657146704703,COGS 101C,A01,083625,Delgado; Tania,17,0,35,18
1657146710730,COGS 107A,A01,083627,Boyle; Mary E. T.,13,0,60,47
1657146716755,COGS 118A,A01,083075,Gupta; Anjum,15,0,76,61
1657146722777,CSE 3,A50,083646,Miranda; Gregory Joseph,24,0,50,26
1657146728804,CSE 8A,A50,083650,Miranda; Gregory Joseph,17,1,56,39
1657146734830,CSE 11,A01,083080,Cao; Yingjun,5,15,40,35
1657146740858,CSE 12,A01,083652,Krause-Levy; Sophia Louisa,24,1,120,96
1657146746884,CSE 15L,A01,083654,Morris; Justin Loren,9,0,50,41
1657146746884,CSE 15L,A02,083655,Morris; Justin Loren,9,0,50,41
1657146752911,CSE 20,A01,083657,Tran; Khoa Dang,38,0,80,42
1657146758935,CSE 21,A01,095574,Bach; Quang Tran,22,0,48,26
1657146764959,CSE 30,A01,083084,Eldon; John,4,0,80,76
1657146764959,CSE 30,B01,095061,Bhaskar; Nishant,7,0,50,43
1657146770988,CSE 100,A01,083659,Cao; Yingjun,4,4,70,66
1657146777011,CSE 134B,A01,083661,Powell; Thomas Allan,20,0,100,80
1657146783036,CSE 140,A01,083663,Gungor; Onat,13,0,85,72
1657146789068,CSE 140L,A01,083088,Eldon; John,17,0,100,83
1657146795186,CSE 175,A01,083665,Kumar; Rakesh,3,0,25,22
1657146801211,CSE 190,A00,092507,Dubnov; Shlomo,7,0,20,13
1657146807247,ECE 45,A01,083139,Congero; Spencer William,5,0,75,70
1657146813273,ECE 65,A50,083695,Saad; Andrew S,12,0,30,18
1657146813273,ECE 65,A51,095125,Saad; Andrew S,25,0,26,1
1657146819296,ECE 109,A01,091882,Touri; Behrouz,18,0,70,52
1657146825321,ECE 180,A00,083140,Abi Samra; Nicholas Camill,1,0,30,29
1657146825321,ECE 180,B00,083141,Abi Samra; Nicholas Camill,0,0,30,30
1657146831348,MATH 10A,A01,083735,Patchell; Gregory David,2,0,30,28
1657146831348,MATH 10A,A02,083736,Patchell; Gregory David,20,0,30,10
1657146831348,MATH 10A,A03,083737,Patchell; Gregory David,16,0,30,14
1657146837375,MATH 10B,A01,083207,Lim; Seonhee,7,0,34,27
1657146837375,MATH 10B,A02,083208,Lim; Seonhee,9,0,35,26
1657146837375,MATH 10B,A03,093472,Lim; Seonhee,5,0,34,29
1657146837375,MATH 10B,B01,083739,Sinha; Shubham,9,0,30,21
1657146843398,MATH 18,A01,083743,Cinel; Cameron Alexander,6,0,30,24
1657146843398,MATH 18,A02,083744,Cinel; Cameron Alexander,15,0,30,15
1657146843398,MATH 18,A03,083745,Cinel; Cameron Alexander,8,0,30,22
1657146843398,MATH 18,B01,083748,Rideout; David Porter,4,0,37,33
1657146843398,MATH 18,B02,083749,Rideout; David Porter,3,0,36,33
1657146843398,MATH 18,B03,083750,Rideout; David Porter,2,0,37,35
1657146843398,MATH 18,B04,083751,Rideout; David Porter,5,0,36,31
1657146843398,MATH 18,B05,093473,Rideout; David Porter,4,0,36,32
1657146843398,MATH 18,B06,093474,Rideout; David Porter,5,0,36,31
1657146849427,MATH 20A,A01,083754,Zheng; Zequn,12,0,40,28
1657146855464,MATH 20B,A01,083756,Briones; Jor-el Thomas Caparas,1,0,36,35
1657146855464,MATH 20B,A02,083757,Briones; Jor-el Thomas Caparas,1,0,36,35
1657146855464,MATH 20B,A03,093475,Briones; Jor-el Thomas Caparas,1,0,36,35
1657146861493,MATH 20C,A01,083760,Briones; Jor-el Thomas Caparas,1,0,35,34
1657146861493,MATH 20C,A02,083761,Briones; Jor-el Thomas Caparas,8,0,35,27
1657146861493,MATH 20C,A03,093476,Briones; Jor-el Thomas Caparas,0,1,36,36
1657146861493,MATH 20C,B01,083762,Bach; Quang Tran,0,0,30,30
1657146867523,MATH 20D,A01,083765,Tran; Brian Kha,4,0,30,26
1657146867523,MATH 20D,A02,083766,Tran; Brian Kha,5,0,30,25
1657146867523,MATH 20D,A03,083767,Tran; Brian Kha,3,0,30,27
1657146873549,MATH 20E,A01,083771,Ganguly; Soumya,7,0,32,25
1657146873549,MATH 20E,A02,083772,Ganguly; Soumya,7,0,32,25
1657146873549,MATH 20E,B01,083773,Ciotti; Benjamin,19,0,35,16
1657146873549,MATH 20E,B02,083774,Ciotti; Benjamin,17,0,35,18
1657146879587,MATH 103A,A01,083777,Greenfeld; Be'Eri,2,0,36,34
1657146879587,MATH 103A,A02,083778,Greenfeld; Be'Eri,5,0,36,31
1657146879587,MATH 103A,A03,093561,Greenfeld; Be'Eri,4,0,36,32
1657146879587,MATH 103A,B01,083779,Greenfeld; Be'Eri,6,0,36,30
1657146879587,MATH 103A,B02,083780,Greenfeld; Be'Eri,3,0,36,33
1657146879587,MATH 103A,B03,093562,Greenfeld; Be'Eri,3,0,36,33
1657146885618,MATH 105,A01,085443,Carter; Anne Toulson,14,0,35,21
1657146885618,MATH 105,A02,093477,Carter; Anne Toulson,20,0,35,15
1657146891642,MATH 109,A01,083213,Ganzberger; Geoffrey Michael,2,0,34,32
1657146891642,MATH 109,A02,083214,Ganzberger; Geoffrey Michael,3,0,34,31
1657146891642,MATH 109,A03,093478,Ganzberger; Geoffrey Michael,1,0,34,33
1657146891642,MATH 109,B01,083215,Ganzberger; Geoffrey Michael,1,0,32,31
1657146891642,MATH 109,B02,083216,Ganzberger; Geoffrey Michael,1,0,32,31
1657146891642,MATH 109,B03,093479,Ganzberger; Geoffrey Michael,6,0,32,26
1657146897667,MATH 142A,A01,083219,Chow; Bennett,6,0,32,26
1657146897667,MATH 142A,A02,083220,Chow; Bennett,10,0,32,22
1657146897667,MATH 142A,A03,093480,Chow; Bennett,7,0,32,25
1657146897667,MATH 142A,B03,093481,Chow; Bennett,8,0,32,24
1657146897667,MATH 142A,B04,093558,Chow; Bennett,11,0,32,21
1657146897667,MATH 142A,B05,093559,Chow; Bennett,6,0,32,26
1657146903696,MATH 193A,A01,083224,Rotar; Vladimir,7,0,34,27
1657146903696,MATH 193A,A02,083225,Rotar; Vladimir,5,0,34,29
1657146903696,MATH 193A,A03,083781,Rotar; Vladimir,1,0,34,33
1657146903696,MATH 193A,A04,083782,Rotar; Vladimir,8,0,34,26
1657146903696,MATH 193A,A05,093482,Rotar; Vladimir,6,0,34,28
1657146909722,MATH 197,001,091859,McAuley; Julian John,9999,0,9999,0
1657146909722,MATH 197,002,095566,Kedlaya; Kiran S.,9997,0,9999,2
1657146909722,MATH 197,003,095567,Xiao; Ming,9999,0,9999,0
1657146909722,MATH 197,004,095571,Perols; Johan Lars,9998,0,9999,1
1657146929804,COGS 9,A01,083615,Shannon; Kyle Michael,7,0,75,68
1657146935828,COGS 11,A01,083617,Boyle; Mary E. T.,21,0,48,27
1657146941851,COGS 13,A01,083071,Bastos; Amalia Pinkusfeld,9,0,71,62
1657146947874,COGS 14A,A01,092681,Semenuks; Arturs,1,1,100,99
1657146953901,COGS 14B,A01,083073,Cheng; Tzu-Han,6,0,63,57
1657146959924,COGS 17,A01,092677,Semenuks; Arturs,4,0,81,77
1657146965949,COGS 100,A01,083619,Allen; Michael Gordon,15,0,70,55
1657146971972,COGS 101A,A01,083621,Davis; Joshua Daniel,9,0,68,59
1657146977996,COGS 101B,A01,091572,Allen; Michael Gordon,9,0,65,56
1657146984019,COGS 101C,A01,083625,Delgado; Tania,17,0,35,18
1657146990043,COGS 107A,A01,083627,Boyle; Mary E. T.,13,0,60,47
1657146996073,COGS 118A,A01,083075,Gupta; Anjum,15,0,76,61
1657147002103,CSE 3,A50,083646,Miranda; Gregory Joseph,24,0,50,26
1657147008141,CSE 8A,A50,083650,Miranda; Gregory Joseph,17,1,56,39
1657147014171,CSE 11,A01,083080,Cao; Yingjun,5,15,40,35
1657147020203,CSE 12,A01,083652,Krause-Levy; Sophia Louisa,24,1,120,96
1657147026230,CSE 15L,A01,083654,Morris; Justin Loren,9,0,50,41
1657147026230,CSE 15L,A02,083655,Morris; Justin Loren,9,0,50,41
1657147032258,CSE 20,A01,083657,Tran; Khoa Dang,38,0,80,42
1657147038281,CSE 21,A01,095574,Bach; Quang Tran,22,0,48,26
1657147044311,CSE 30,A01,083084,Eldon; John,4,0,80,76
1657147044311,CSE 30,B01,095061,Bhaskar; Nishant,7,0,50,43
1657147050340,CSE 100,A01,083659,Cao; Yingjun,4,4,70,66
1657147056374,CSE 134B,A01,083661,Powell; Thomas Allan,20,0,100,80
1657147062401,CSE 140,A01,083663,Gungor; Onat,13,0,85,72
1657147068431,CSE 140L,A01,083088,Eldon; John,17,0,100,83
1657147074454,CSE 175,A01,083665,Kumar; Rakesh,3,0,25,22
1657147080489,CSE 190,A00,092507,Dubnov; Shlomo,7,0,20,13
1657147086514,ECE 45,A01,083139,Congero; Spencer William,5,0,75,70
1657147092542,ECE 65,A50,083695,Saad; Andrew S,12,0,30,18
1657147092542,ECE 65,A51,095125,Saad; Andrew S,25,0,26,1
1657147098571,ECE 109,A01,091882,Touri; Behrouz,18,0,70,52
1657147104595,ECE 180,A00,083140,Abi Samra; Nicholas Camill,1,0,30,29
1657147104595,ECE 180,B00,083141,Abi Samra; Nicholas Camill,0,0,30,30
1657147110624,MATH 10A,A01,083735,Patchell; Gregory David,2,0,30,28
1657147110624,MATH 10A,A02,083736,Patchell; Gregory David,20,0,30,10
1657147110624,MATH 10A,A03,083737,Patchell; Gregory David,16,0,30,14
1657147116663,MATH 10B,A01,083207,Lim; Seonhee,7,0,34,27
1657147116663,MATH 10B,A02,083208,Lim; Seonhee,9,0,35,26
1657147116663,MATH 10B,A03,093472,Lim; Seonhee,5,0,34,29
1657147116663,MATH 10B,B01,083739,Sinha; Shubham,9,0,30,21
1657147122689,MATH 18,A01,083743,Cinel; Cameron Alexander,6,0,30,24
1657147122689,MATH 18,A02,083744,Cinel; Cameron Alexander,15,0,30,15
1657147122689,MATH 18,A03,083745,Cinel; Cameron Alexander,8,0,30,22
1657147122689,MATH 18,B01,083748,Rideout; David Porter,4,0,37,33
1657147122689,MATH 18,B02,083749,Rideout; David Porter,3,0,36,33
1657147122689,MATH 18,B03,083750,Rideout; David Porter,2,0,37,35
1657147122689,MATH 18,B04,083751,Rideout; David Porter,5,0,36,31
1657147122689,MATH 18,B05,093473,Rideout; David Porter,4,0,36,32
1657147122689,MATH 18,B06,093474,Rideout; David Porter,5,0,36,31
1657147128714,MATH 20A,A01,083754,Zheng; Zequn,12,0,40,28
1657147134743,MATH 20B,A01,083756,Briones; Jor-el Thomas Caparas,1,0,36,35
1657147134743,MATH 20B,A02,083757,Briones; Jor-el Thomas Caparas,1,0,36,35
1657147134743,MATH 20B,A03,093475,Briones; Jor-el Thomas Caparas,1,0,36,35
1657147140766,MATH 20C,A01,083760,Briones; Jor-el Thomas Caparas,1,0,35,34
1657147140766,MATH 20C,A02,083761,Briones; Jor-el Thomas Caparas,8,0,35,27
1657147140766,MATH 20C,A03,093476,Briones; Jor-el Thomas Caparas,0,1,36,36
1657147140766,MATH 20C,B01,083762,Bach; Quang Tran,0,0,30,30
1657147146791,MATH 20D,A01,083765,Tran; Brian Kha,4,0,30,26
1657147146791,MATH 20D,A02,083766,Tran; Brian Kha,5,0,30,25
1657147146791,MATH 20D,A03,083767,Tran; Brian Kha,3,0,30,27
1657147152814,MATH 20E,A01,083771,Ganguly; Soumya,7,0,32,25
1657147152814,MATH 20E,A02,083772,Ganguly; Soumya,7,0,32,25
1657147152814,MATH 20E,B01,083773,Ciotti; Benjamin,19,0,35,16
1657147152814,MATH 20E,B02,083774,Ciotti; Benjamin,17,0,35,18
1657147158839,MATH 103A,A01,083777,Greenfeld; Be'Eri,2,0,36,34
1657147158839,MATH 103A,A02,083778,Greenfeld; Be'Eri,5,0,36,31
1657147158839,MATH 103A,A03,093561,Greenfeld; Be'Eri,4,0,36,32
1657147158839,MATH 103A,B01,083779,Greenfeld; Be'Eri,6,0,36,30
1657147158839,MATH 103A,B02,083780,Greenfeld; Be'Eri,3,0,36,33
1657147158839,MATH 103A,B03,093562,Greenfeld; Be'Eri,3,0,36,33
1657147164872,MATH 105,A01,085443,Carter; Anne Toulson,14,0,35,21
1657147164872,MATH 105,A02,093477,Carter; Anne Toulson,20,0,35,15
1657147170903,MATH 109,A01,083213,Ganzberger; Geoffrey Michael,2,0,34,32
1657147170903,MATH 109,A02,083214,Ganzberger; Geoffrey Michael,3,0,34,31
1657147170903,MATH 109,A03,093478,Ganzberger; Geoffrey Michael,1,0,34,33
1657147170903,MATH 109,B01,083215,Ganzberger; Geoffrey Michael,1,0,32,31
1657147170903,MATH 109,B02,083216,Ganzberger; Geoffrey Michael,1,0,32,31
1657147170903,MATH 109,B03,093479,Ganzberger; Geoffrey Michael,6,0,32,26
1657147176928,MATH 142A,A01,083219,Chow; Bennett,6,0,32,26
1657147176928,MATH 142A,A02,083220,Chow; Bennett,10,0,32,22
1657147176928,MATH 142A,A03,093480,Chow; Bennett,7,0,32,25
1657147176928,MATH 142A,B03,093481,Chow; Bennett,8,0,32,24
1657147176928,MATH 142A,B04,093558,Chow; Bennett,11,0,32,21
1657147176928,MATH 142A,B05,093559,Chow; Bennett,6,0,32,26
1657147182952,MATH 193A,A01,083224,Rotar; Vladimir,7,0,34,27
1657147182952,MATH 193A,A02,083225,Rotar; Vladimir,5,0,34,29
1657147182952,MATH 193A,A03,083781,Rotar; Vladimir,1,0,34,33
1657147182952,MATH 193A,A04,083782,Rotar; Vladimir,8,0,34,26
1657147182952,MATH 193A,A05,093482,Rotar; Vladimir,6,0,34,28
1657147188989,MATH 197,001,091859,McAuley; Julian John,9999,0,9999,0
1657147188989,MATH 197,002,095566,Kedlaya; Kiran S.,9997,0,9999,2
1657147188989,MATH 197,003,095567,Xiao; Ming,9999,0,9999,0
1657147188989,MATH 197,004,095571,Perols; Johan Lars,9998,0,9999,1
1657147196041,COGS 9,A01,083615,Shannon; Kyle Michael,7,0,75,68
1657147202067,COGS 11,A01,083617,Boyle; Mary E. T.,21,0,48,27
1657147208090,COGS 13,A01,083071,Bastos; Amalia Pinkusfeld,9,0,71,62
1657147214114,COGS 14A,A01,092681,Semenuks; Arturs,1,1,100,99
1657147220137,COGS 14B,A01,083073,Cheng; Tzu-Han,6,0,63,57
1657147226163,COGS 17,A01,092677,Semenuks; Arturs,4,0,81,77
1657147232191,COGS 100,A01,083619,Allen; Michael Gordon,15,0,70,55
1657147238218,COGS 101A,A01,083621,Davis; Joshua Daniel,9,0,68,59
1657147244240,COGS 101B,A01,091572,Allen; Michael Gordon,9,0,65,56
1657147250264,COGS 101C,A01,083625,Delgado; Tania,17,0,35,18
1657147256287,COGS 107A,A01,083627,Boyle; Mary E. T.,13,0,60,47
1657147262311,COGS 118A,A01,083075,Gupta; Anjum,15,0,76,61
1657147268339,CSE 3,A50,083646,Miranda; Gregory Joseph,24,0,50,26
1657147274366,CSE 8A,A50,083650,Miranda; Gregory Joseph,17,1,56,39
1657147280392,CSE 11,A01,083080,Cao; Yingjun,5,15,40,35
1657147286440,CSE 12,A01,083652,Krause-Levy; Sophia Louisa,24,1,120,96
1657147292477,CSE 15L,A01,083654,Morris; Justin Loren,9,0,50,41
1657147292477,CSE 15L,A02,083655,Morris; Justin Loren,9,0,50,41
1657147298503,CSE 20,A01,083657,Tran; Khoa Dang,38,0,80,42
1657147304529,CSE 21,A01,095574,Bach; Quang Tran,22,0,48,26
1657147310554,CSE 30,A01,083084,Eldon; John,4,0,80,76
1657147310554,CSE 30,B01,095061,Bhaskar; Nishant,7,0,50,43
1657147316577,CSE 100,A01,083659,Cao; Yingjun,4,4,70,66
1657147322601,CSE 134B,A01,083661,Powell; Thomas Allan,20,0,100,80
1657147328629,CSE 140,A01,083663,Gungor; Onat,13,0,85,72
1657147334655,CSE 140L,A01,083088,Eldon; John,17,0,100,83
1657147340684,CSE 175,A01,083665,Kumar; Rakesh,3,0,25,22
1657147346707,CSE 190,A00,092507,Dubnov; Shlomo,7,0,20,13
1657147352733,ECE 45,A01,083139,Congero; Spencer William,5,0,75,70
1657147358756,ECE 65,A50,083695,Saad; Andrew S,12,0,30,18
1657147358756,ECE 65,A51,095125,Saad; Andrew S,25,0,26,1
1657147364785,ECE 109,A01,091882,Touri; Behrouz,18,0,70,52
1657147370814,ECE 180,A00,083140,Abi Samra; Nicholas Camill,1,0,30,29
1657147370814,ECE 180,B00,083141,Abi Samra; Nicholas Camill,0,0,30,30
1657147376838,MATH 10A,A01,083735,Patchell; Gregory David,2,0,30,28
1657147376838,MATH 10A,A02,083736,Patchell; Gregory David,20,0,30,10
1657147376838,MATH 10A,A03,083737,Patchell; Gregory David,16,0,30,14
1657147382897,MATH 10B,A01,083207,Lim; Seonhee,7,0,34,27
1657147382897,MATH 10B,A02,083208,Lim; Seonhee,9,0,35,26
1657147382897,MATH 10B,A03,093472,Lim; Seonhee,5,0,34,29
1657147382897,MATH 10B,B01,083739,Sinha; Shubham,9,0,30,21
1657147388922,MATH 18,A01,083743,Cinel; Cameron Alexander,6,0,30,24
1657147388922,MATH 18,A02,083744,Cinel; Cameron Alexander,15,0,30,15
1657147388922,MATH 18,A03,083745,Cinel; Cameron Alexander,8,0,30,22
1657147388922,MATH 18,B01,083748,Rideout; David Porter,4,0,37,33
1657147388922,MATH 18,B02,083749,Rideout; David Porter,3,0,36,33
1657147388922,MATH 18,B03,083750,Rideout; David Porter,2,0,37,35
1657147388922,MATH 18,B04,083751,Rideout; David Porter,5,0,36,31
1657147388922,MATH 18,B05,093473,Rideout; David Porter,4,0,36,32
1657147388922,MATH 18,B06,093474,Rideout; David Porter,5,0,36,31
1657147394953,MATH 20A,A01,083754,Zheng; Zequn,12,0,40,28
1657147400987,MATH 20B,A01,083756,Briones; Jor-el Thomas Caparas,1,0,36,35
1657147400987,MATH 20B,A02,083757,Briones; Jor-el Thomas Caparas,1,0,36,35
1657147400987,MATH 20B,A03,093475,Briones; Jor-el Thomas Caparas,1,0,36,35
1657147407113,MATH 20C,A01,083760,Briones; Jor-el Thomas Caparas,1,0,35,34
1657147407113,MATH 20C,A02,083761,Briones; Jor-el Thomas Caparas,8,0,35,27
1657147407113,MATH 20C,A03,093476,Briones; Jor-el Thomas Caparas,0,1,36,36
1657147407113,MATH 20C,B01,083762,Bach; Quang Tran,0,0,30,30
1657147413139,MATH 20D,A01,083765,Tran; Brian Kha,4,0,30,26
1657147413139,MATH 20D,A02,083766,Tran; Brian Kha,5,0,30,25
1657147413139,MATH 20D,A03,083767,Tran; Brian Kha,3,0,30,27
1657147419167,MATH 20E,A01,083771,Ganguly; Soumya,7,0,32,25
1657147419167,MATH 20E,A02,083772,Ganguly; Soumya,7,0,32,25
1657147419167,MATH 20E,B01,083773,Ciotti; Benjamin,19,0,35,16
1657147419167,MATH 20E,B02,083774,Ciotti; Benjamin,17,0,35,18
1657147425197,MATH 103A,A01,083777,Greenfeld; Be'Eri,2,0,36,34
1657147425197,MATH 103A,A02,083778,Greenfeld; Be'Eri,5,0,36,31
1657147425197,MATH 103A,A03,093561,Greenfeld; Be'Eri,4,0,36,32
1657147425197,MATH 103A,B01,083779,Greenfeld; Be'Eri,6,0,36,30
1657147425197,MATH 103A,B02,083780,Greenfeld; Be'Eri,3,0,36,33
1657147425197,MATH 103A,B03,093562,Greenfeld; Be'Eri,3,0,36,33
1657147431233,MATH 105,A01,085443,Carter; Anne Toulson,14,0,35,21
1657147431233,MATH 105,A02,093477,Carter; Anne Toulson,20,0,35,15
1657147437257,MATH 109,A01,083213,Ganzberger; Geoffrey Michael,2,0,34,32
1657147437257,MATH 109,A02,083214,Ganzberger; Geoffrey Michael,3,0,34,31
1657147437257,MATH 109,A03,093478,Ganzberger; Geoffrey Michael,1,0,34,33
1657147437257,MATH 109,B01,083215,Ganzberger; Geoffrey Michael,1,0,32,31
1657147437257,MATH 109,B02,083216,Ganzberger; Geoffrey Michael,1,0,32,31
1657147437257,MATH 109,B03,093479,Ganzberger; Geoffrey Michael,6,0,32,26
1657147443283,MATH 142A,A01,083219,Chow; Bennett,6,0,32,26
1657147443283,MATH 142A,A02,083220,Chow; Bennett,10,0,32,22
1657147443283,MATH 142A,A03,093480,Chow; Bennett,7,0,32,25
1657147443283,MATH 142A,B03,093481,Chow; Bennett,8,0,32,24
1657147443283,MATH 142A,B04,093558,Chow; Bennett,11,0,32,21
1657147443283,MATH 142A,B05,093559,Chow; Bennett,6,0,32,26
1657147449305,MATH 193A,A01,083224,Rotar; Vladimir,7,0,34,27
1657147449305,MATH 193A,A02,083225,Rotar; Vladimir,5,0,34,29
1657147449305,MATH 193A,A03,083781,Rotar; Vladimir,1,0,34,33
1657147449305,MATH 193A,A04,083782,Rotar; Vladimir,8,0,34,26
1657147449305,MATH 193A,A05,093482,Rotar; Vladimir,6,0,34,28
1657147455335,MATH 197,001,091859,McAuley; Julian John,9999,0,9999,0
1657147455335,MATH 197,002,095566,Kedlaya; Kiran S.,9997,0,9999,2
1657147455335,MATH 197,003,095567,Xiao; Ming,9999,0,9999,0
1657147455335,MATH 197,004,095571,Perols; Johan Lars,9998,0,9999,1
1657147462405,COGS 9,A01,083615,Shannon; Kyle Michael,7,0,75,68
1657147468428,COGS 11,A01,083617,Boyle; Mary E. T.,21,0,48,27
1657147474456,COGS 13,A01,083071,Bastos; Amalia Pinkusfeld,9,0,71,62
1657147480480,COGS 14A,A01,092681,Semenuks; Arturs,1,1,100,99
1657147486502,COGS 14B,A01,083073,Cheng; Tzu-Han,6,0,63,57
1657147492526,COGS 17,A01,092677,Semenuks; Arturs,4,0,81,77
1657147498553,COGS 100,A01,083619,Allen; Michael Gordon,15,0,70,55
1657147504579,COGS 101A,A01,083621,Davis; Joshua Daniel,9,0,68,59
1657147510602,COGS 101B,A01,091572,Allen; Michael Gordon,9,0,65,56
1657147516629,COGS 101C,A01,083625,Delgado; Tania,17,0,35,18
1657147522652,COGS 107A,A01,083627,Boyle; Mary E. T.,13,0,60,47
1657147528686,COGS 118A,A01,083075,Gupta; Anjum,15,0,76,61
1657147534729,CSE 3,A50,083646,Miranda; Gregory Joseph,24,0,50,26
1657147540757,CSE 8A,A50,083650,Miranda; Gregory Joseph,17,1,56,39
1657147546787,CSE 11,A01,083080,Cao; Yingjun,5,15,40,35
1657147552809,CSE 12,A01,083652,Krause-Levy; Sophia Louisa,24,1,120,96
1657147558835,CSE 15L,A01,083654,Morris; Justin Loren,9,0,50,41
1657147558835,CSE 15L,A02,083655,Morris; Justin Loren,9,0,50,41
1657147564865,CSE 20,A01,083657,Tran; Khoa Dang,38,0,80,42
1657147570893,CSE 21,A01,095574,Bach; Quang Tran,22,0,48,26
1657147576934,CSE 30,A01,083084,Eldon; John,4,0,80,76
1657147576934,CSE 30,B01,095061,Bhaskar; Nishant,7,0,50,43
1657147582959,CSE 100,A01,083659,Cao; Yingjun,4,4,70,66
1657147588981,CSE 134B,A01,083661,Powell; Thomas Allan,20,0,100,80
1657147595008,CSE 140,A01,083663,Gungor; Onat,13,0,85,72
1657147601031,CSE 140L,A01,083088,Eldon; John,17,0,100,83
1657147607054,CSE 175,A01,083665,Kumar; Rakesh,3,0,25,22
1657147613087,CSE 190,A00,092507,Dubnov; Shlomo,7,0,20,13
1657147619122,ECE 45,A01,083139,Congero; Spencer William,5,0,75,70
1657147625144,ECE 65,A50,083695,Saad; Andrew S,12,0,30,18
1657147625144,ECE 65,A51,095125,Saad; Andrew S,25,0,26,1
1657147631170,ECE 109,A01,091882,Touri; Behrouz,18,0,70,52
1657147637196,ECE 180,A00,083140,Abi Samra; Nicholas Camill,1,0,30,29
1657147637196,ECE 180,B00,083141,Abi Samra; Nicholas Camill,0,0,30,30
1657147643219,MATH 10A,A01,083735,Patchell; Gregory David,2,0,30,28
1657147643219,MATH 10A,A02,083736,Patchell; Gregory David,20,0,30,10
1657147643219,MATH 10A,A03,083737,Patchell; Gregory David,16,0,30,14
1657147649246,MATH 10B,A01,083207,Lim; Seonhee,7,0,34,27
1657147649246,MATH 10B,A02,083208,Lim; Seonhee,9,0,35,26
1657147649246,MATH 10B,A03,093472,Lim; Seonhee,5,0,34,29
1657147649246,MATH 10B,B01,083739,Sinha; Shubham,9,0,30,21
1657147655289,MATH 18,A01,083743,Cinel; Cameron Alexander,6,0,30,24
1657147655289,MATH 18,A02,083744,Cinel; Cameron Alexander,15,0,30,15
1657147655289,MATH 18,A03,083745,Cinel; Cameron Alexander,8,0,30,22
1657147655289,MATH 18,B01,083748,Rideout; David Porter,4,0,37,33
1657147655289,MATH 18,B02,083749,Rideout; David Porter,3,0,36,33
1657147655289,MATH 18,B03,083750,Rideout; David Porter,2,0,37,35
1657147655289,MATH 18,B04,083751,Rideout; David Porter,5,0,36,31
1657147655289,MATH 18,B05,093473,Rideout; David Porter,4,0,36,32
1657147655289,MATH 18,B06,093474,Rideout; David Porter,5,0,36,31
1657147661330,MATH 20A,A01,083754,Zheng; Zequn,12,0,40,28
1657147667356,MATH 20B,A01,083756,Briones; Jor-el Thomas Caparas,1,0,36,35
1657147667356,MATH 20B,A02,083757,Briones; Jor-el Thomas Caparas,1,0,36,35
1657147667356,MATH 20B,A03,093475,Briones; Jor-el Thomas Caparas,1,0,36,35
1657147673389,MATH 20C,A01,083760,Briones; Jor-el Thomas Caparas,1,0,35,34
1657147673389,MATH 20C,A02,083761,Briones; Jor-el Thomas Caparas,8,0,35,27
1657147673389,MATH 20C,A03,093476,Briones; Jor-el Thomas Caparas,0,1,36,36
1657147673389,MATH 20C,B01,083762,Bach; Quang Tran,1,0,30,29
1657147679417,MATH 20D,A01,083765,Tran; Brian Kha,4,0,30,26
1657147679417,MATH 20D,A02,083766,Tran; Brian Kha,5,0,30,25
1657147679417,MATH 20D,A03,083767,Tran; Brian Kha,3,0,30,27
1657147685446,MATH 20E,A01,083771,Ganguly; Soumya,7,0,32,25
1657147685446,MATH 20E,A02,083772,Ganguly; Soumya,7,0,32,25
1657147685446,MATH 20E,B01,083773,Ciotti; Benjamin,19,0,35,16
1657147685446,MATH 20E,B02,083774,Ciotti; Benjamin,17,0,35,18
1657147691470,MATH 103A,A01,083777,Greenfeld; Be'Eri,2,0,36,34
1657147691470,MATH 103A,A02,083778,Greenfeld; Be'Eri,5,0,36,31
1657147691470,MATH 103A,A03,093561,Greenfeld; Be'Eri,4,0,36,32
1657147691470,MATH 103A,B01,083779,Greenfeld; Be'Eri,6,0,36,30
1657147691470,MATH 103A,B02,083780,Greenfeld; Be'Eri,3,0,36,33
1657147691470,MATH 103A,B03,093562,Greenfeld; Be'Eri,3,0,36,33
1657147697492,MATH 105,A01,085443,Carter; Anne Toulson,14,0,35,21
1657147697492,MATH 105,A02,093477,Carter; Anne Toulson,20,0,35,15
1657147703516,MATH 109,A01,083213,Ganzberger; Geoffrey Michael,2,0,34,32
1657147703516,MATH 109,A02,083214,Ganzberger; Geoffrey Michael,3,0,34,31
1657147703516,MATH 109,A03,093478,Ganzberger; Geoffrey Michael,1,0,34,33
1657147703516,MATH 109,B01,083215,Ganzberger; Geoffrey Michael,1,0,32,31
1657147703516,MATH 109,B02,083216,Ganzberger; Geoffrey Michael,1,0,32,31
1657147703516,MATH 109,B03,093479,Ganzberger; Geoffrey Michael,6,0,32,26
1657147709547,MATH 142A,A01,083219,Chow; Bennett,6,0,32,26
1657147709547,MATH 142A,A02,083220,Chow; Bennett,10,0,32,22
1657147709547,MATH 142A,A03,093480,Chow; Bennett,7,0,32,25
1657147709547,MATH 142A,B03,093481,Chow; Bennett,8,0,32,24
1657147709547,MATH 142A,B04,093558,Chow; Bennett,11,0,32,21
1657147709547,MATH 142A,B05,093559,Chow; Bennett,6,0,32,26
1657147715579,MATH 193A,A01,083224,Rotar; Vladimir,7,0,34,27
1657147715579,MATH 193A,A02,083225,Rotar; Vladimir,5,0,34,29
1657147715579,MATH 193A,A03,083781,Rotar; Vladimir,1,0,34,33
1657147715579,MATH 193A,A04,083782,Rotar; Vladimir,8,0,34,26
1657147715579,MATH 193A,A05,093482,Rotar; Vladimir,6,0,34,28
1657147721607,MATH 197,001,091859,McAuley; Julian John,9999,0,9999,0
1657147721607,MATH 197,002,095566,Kedlaya; Kiran S.,9997,0,9999,2
1657147721607,MATH 197,003,095567,Xiao; Ming,9999,0,9999,0
1657147721607,MATH 197,004,095571,Perols; Johan Lars,9998,0,9999,1
1657147728660,COGS 9,A01,083615,Shannon; Kyle Michael,7,0,75,68
1657147734688,COGS 11,A01,083617,Boyle; Mary E. T.,21,0,48,27
1657147740712,COGS 13,A01,083071,Bastos; Amalia Pinkusfeld,9,0,71,62
1657147746744,COGS 14A,A01,092681,Semenuks; Arturs,1,1,100,99
1657147752767,COGS 14B,A01,083073,Cheng; Tzu-Han,6,0,63,57
1657147758789,COGS 17,A01,092677,Semenuks; Arturs,4,0,81,77
1657147764814,COGS 100,A01,083619,Allen; Michael Gordon,15,0,70,55
1657147770838,COGS 101A,A01,083621,Davis; Joshua Daniel,9,0,68,59
1657147776865,COGS 101B,A01,091572,Allen; Michael Gordon,9,0,65,56
1657147782886,COGS 101C,A01,083625,Delgado; Tania,17,0,35,18
1657147788913,COGS 107A,A01,083627,Boyle; Mary E. T.,13,0,60,47
1657147794936,COGS 118A,A01,083075,Gupta; Anjum,15,0,76,61
1657147800963,CSE 3,A50,083646,Miranda; Gregory Joseph,24,0,50,26
1657147806986,CSE 8A,A50,083650,Miranda; Gregory Joseph,17,1,56,39
1657147813008,CSE 11,A01,083080,Cao; Yingjun,5,15,40,35
1657147819039,CSE 12,A01,083652,Krause-Levy; Sophia Louisa,24,1,120,96
1657147825063,CSE 15L,A01,083654,Morris; Justin Loren,9,0,50,41
1657147825063,CSE 15L,A02,083655,Morris; Justin Loren,9,0,50,41
1657147831086,CSE 20,A01,083657,Tran; Khoa Dang,38,0,80,42
1657147837117,CSE 21,A01,095574,Bach; Quang Tran,22,0,48,26
1657147843148,CSE 30,A01,083084,Eldon; John,4,0,80,76
1657147843148,CSE 30,B01,095061,Bhaskar; Nishant,7,0,50,43
1657147849177,CSE 100,A01,083659,Cao; Yingjun,4,4,70,66
1657147855216,CSE 134B,A01,083661,Powell; Thomas Allan,20,0,100,80
1657147861237,CSE 140,A01,083663,Gungor; Onat,13,0,85,72
1657147867271,CSE 140L,A01,083088,Eldon; John,17,0,100,83
1657147873302,CSE 175,A01,083665,Kumar; Rakesh,3,0,25,22
1657147879325,CSE 190,A00,092507,Dubnov; Shlomo,7,0,20,13
1657147885358,ECE 45,A01,083139,Congero; Spencer William,5,0,75,70
1657147891394,ECE 65,A50,083695,Saad; Andrew S,12,0,30,18
1657147891394,ECE 65,A51,095125,Saad; Andrew S,25,0,26,1
1657147897419,ECE 109,A01,091882,Touri; Behrouz,18,0,70,52
1657147903442,ECE 180,A00,083140,Abi Samra; Nicholas Camill,1,0,30,29
1657147903442,ECE 180,B00,083141,Abi Samra; Nicholas Camill,0,0,30,30
1657147909476,MATH 10A,A01,083735,Patchell; Gregory David,2,0,30,28
1657147909476,MATH 10A,A02,083736,Patchell; Gregory David,20,0,30,10
1657147909476,MATH 10A,A03,083737,Patchell; Gregory David,16,0,30,14
1657147915506,MATH 10B,A01,083207,Lim; Seonhee,7,0,34,27
1657147915506,MATH 10B,A02,083208,Lim; Seonhee,9,0,35,26
1657147915506,MATH 10B,A03,093472,Lim; Seonhee,5,0,34,29
1657147915506,MATH 10B,B01,083739,Sinha; Shubham,9,0,30,21
1657147921537,MATH 18,A01,083743,Cinel; Cameron Alexander,6,0,30,24
1657147921537,MATH 18,A02,083744,Cinel; Cameron Alexander,15,0,30,15
1657147921537,MATH 18,A03,083745,Cinel; Cameron Alexander,8,0,30,22
1657147921537,MATH 18,B01,083748,Rideout; David Porter,4,0,37,33
1657147921537,MATH 18,B02,083749,Rideout; David Porter,3,0,36,33
1657147921537,MATH 18,B03,083750,Rideout; David Porter,2,0,37,35
1657147921537,MATH 18,B04,083751,Rideout; David Porter,5,0,36,31
1657147921537,MATH 18,B05,093473,Rideout; David Porter,4,0,36,32
1657147921537,MATH 18,B06,093474,Rideout; David Porter,5,0,36,31
1657147927564,MATH 20A,A01,083754,Zheng; Zequn,12,0,40,28
1657147933591,MATH 20B,A01,083756,Briones; Jor-el Thomas Caparas,1,0,36,35
1657147933591,MATH 20B,A02,083757,Briones; Jor-el Thomas Caparas,1,0,36,35
1657147933591,MATH 20B,A03,093475,Briones; Jor-el Thomas Caparas,1,0,36,35
1657147939626,MATH 20C,A01,083760,Briones; Jor-el Thomas Caparas,1,0,35,34
1657147939626,MATH 20C,A02,083761,Briones; Jor-el Thomas Caparas,8,0,35,27
1657147939626,MATH 20C,A03,093476,Briones; Jor-el Thomas Caparas,0,1,36,36
1657147939626,MATH 20C,B01,083762,Bach; Quang Tran,1,0,30,29
1657147945650,MATH 20D,A01,083765,Tran; Brian Kha,4,0,30,26
1657147945650,MATH 20D,A02,083766,Tran; Brian Kha,5,0,30,25
1657147945650,MATH 20D,A03,083767,Tran; Brian Kha,3,0,30,27
1657147951680,MATH 20E,A01,083771,Ganguly; Soumya,7,0,32,25
1657147951680,MATH 20E,A02,083772,Ganguly; Soumya,7,0,32,25
1657147951680,MATH 20E,B01,083773,Ciotti; Benjamin,19,0,35,16
1657147951680,MATH 20E,B02,083774,Ciotti; Benjamin,17,0,35,18
1657147957702,MATH 103A,A01,083777,Greenfeld; Be'Eri,2,0,36,34
1657147957702,MATH 103A,A02,083778,Greenfeld; Be'Eri,5,0,36,31
1657147957702,MATH 103A,A03,093561,Greenfeld; Be'Eri,4,0,36,32
1657147957702,MATH 103A,B01,083779,Greenfeld; Be'Eri,6,0,36,30
1657147957702,MATH 103A,B02,083780,Greenfeld; Be'Eri,3,0,36,33
1657147957702,MATH 103A,B03,093562,Greenfeld; Be'Eri,3,0,36,33
1657147963724,MATH 105,A01,085443,Carter; Anne Toulson,14,0,35,21
1657147963724,MATH 105,A02,093477,Carter; Anne Toulson,20,0,35,15
1657147969749,MATH 109,A01,083213,Ganzberger; Geoffrey Michael,2,0,34,32
1657147969749,MATH 109,A02,083214,Ganzberger; Geoffrey Michael,3,0,34,31
1657147969749,MATH 109,A03,093478,Ganzberger; Geoffrey Michael,1,0,34,33
1657147969749,MATH 109,B01,083215,Ganzberger; Geoffrey Michael,1,0,32,31
1657147969749,MATH 109,B02,083216,Ganzberger; Geoffrey Michael,1,0,32,31
1657147969749,MATH 109,B03,093479,Ganzberger; Geoffrey Michael,6,0,32,26
1657147975772,MATH 142A,A01,083219,Chow; Bennett,6,0,32,26
1657147975772,MATH 142A,A02,083220,Chow; Bennett,10,0,32,22
1657147975772,MATH 142A,A03,093480,Chow; Bennett,7,0,32,25
1657147975772,MATH 142A,B03,093481,Chow; Bennett,8,0,32,24
1657147975772,MATH 142A,B04,093558,Chow; Bennett,11,0,32,21
1657147975772,MATH 142A,B05,093559,Chow; Bennett,6,0,32,26
1657147981803,MATH 193A,A01,083224,Rotar; Vladimir,7,0,34,27
1657147981803,MATH 193A,A02,083225,Rotar; Vladimir,5,0,34,29
1657147981803,MATH 193A,A03,083781,Rotar; Vladimir,1,0,34,33
1657147981803,MATH 193A,A04,083782,Rotar; Vladimir,8,0,34,26
1657147981803,MATH 193A,A05,093482,Rotar; Vladimir,6,0,34,28
1657147987833,MATH 197,001,091859,McAuley; Julian John,9999,0,9999,0
1657147987833,MATH 197,002,095566,Kedlaya; Kiran S.,9997,0,9999,2
1657147987833,MATH 197,003,095567,Xiao; Ming,9999,0,9999,0
1657147987833,MATH 197,004,095571,Perols; Johan Lars,9998,0,9999,1
1657147994898,COGS 9,A01,083615,Shannon; Kyle Michael,7,0,75,68
1657148001010,COGS 11,A01,083617,Boyle; Mary E. T.,21,0,48,27
1657148007034,COGS 13,A01,083071,Bastos; Amalia Pinkusfeld,9,0,71,62
1657148013062,COGS 14A,A01,092681,Semenuks; Arturs,1,1,100,99
1657148019085,COGS 14B,A01,083073,Cheng; Tzu-Han,6,0,63,57
1657148025108,COGS 17,A01,092677,Semenuks; Arturs,4,0,81,77
1657148031134,COGS 100,A01,083619,Allen; Michael Gordon,15,0,70,55
1657148037158,COGS 101A,A01,083621,Davis; Joshua Daniel,9,0,68,59
1657148043182,COGS 101B,A01,091572,Allen; Michael Gordon,9,0,65,56
1657148049209,COGS 101C,A01,083625,Delgado; Tania,17,0,35,18
1657148055241,COGS 107A,A01,083627,Boyle; Mary E. T.,13,0,60,47
1657148061270,COGS 118A,A01,083075,Gupta; Anjum,15,0,76,61
1657148067299,CSE 3,A50,083646,Miranda; Gregory Joseph,24,0,50,26
1657148073324,CSE 8A,A50,083650,Miranda; Gregory Joseph,17,1,56,39
1657148079354,CSE 11,A01,083080,Cao; Yingjun,5,15,40,35
1657148085380,CSE 12,A01,083652,Krause-Levy; Sophia Louisa,24,1,120,96
1657148091404,CSE 15L,A01,083654,Morris; Justin Loren,9,0,50,41
1657148091404,CSE 15L,A02,083655,Morris; Justin Loren,9,0,50,41
1657148097430,CSE 20,A01,083657,Tran; Khoa Dang,38,0,80,42
1657148103453,CSE 21,A01,095574,Bach; Quang Tran,22,0,48,26
1657148109480,CSE 30,A01,083084,Eldon; John,4,0,80,76
1657148109480,CSE 30,B01,095061,Bhaskar; Nishant,7,0,50,43
1657148115503,CSE 100,A01,083659,Cao; Yingjun,4,4,70,66
1657148121531,CSE 134B,A01,083661,Powell; Thomas Allan,20,0,100,80
1657148127557,CSE 140,A01,083663,Gungor; Onat,13,0,85,72
1657148133588,CSE 140L,A01,083088,Eldon; John,17,0,100,83
1657148139611,CSE 175,A01,083665,Kumar; Rakesh,3,0,25,22
1657148145633,CSE 190,A00,092507,Dubnov; Shlomo,7,0,20,13
1657148151660,ECE 45,A01,083139,Congero; Spencer William,5,0,75,70
1657148157682,ECE 65,A50,083695,Saad; Andrew S,12,0,30,18
1657148157682,ECE 65,A51,095125,Saad; Andrew S,25,0,26,1
1657148163709,ECE 109,A01,091882,Touri; Behrouz,18,0,70,52
1657148169735,ECE 180,A00,083140,Abi Samra; Nicholas Camill,1,0,30,29
1657148169735,ECE 180,B00,083141,Abi Samra; Nicholas Camill,0,0,30,30
1657148175766,MATH 10A,A01,083735,Patchell; Gregory David,2,0,30,28
1657148175766,MATH 10A,A02,083736,Patchell; Gregory David,20,0,30,10
1657148175766,MATH 10A,A03,083737,Patchell; Gregory David,16,0,30,14
1657148181794,MATH 10B,A01,083207,Lim; Seonhee,7,0,34,27
1657148181794,MATH 10B,A02,083208,Lim; Seonhee,9,0,35,26
1657148181794,MATH 10B,A03,093472,Lim; Seonhee,5,0,34,29
1657148181794,MATH 10B,B01,083739,Sinha; Shubham,9,0,30,21
1657148187829,MATH 18,A01,083743,Cinel; Cameron Alexander,6,0,30,24
1657148187829,MATH 18,A02,083744,Cinel; Cameron Alexander,15,0,30,15
1657148187829,MATH 18,A03,083745,Cinel; Cameron Alexander,8,0,30,22
1657148187829,MATH 18,B01,083748,Rideout; David Porter,4,0,37,33
1657148187829,MATH 18,B02,083749,Rideout; David Porter,3,0,36,33
1657148187829,MATH 18,B03,083750,Rideout; David Porter,2,0,37,35
1657148187829,MATH 18,B04,083751,Rideout; David Porter,5,0,36,31
1657148187829,MATH 18,B05,093473,Rideout; David Porter,4,0,36,32
1657148187829,MATH 18,B06,093474,Rideout; David Porter,5,0,36,31
1657148193853,MATH 20A,A01,083754,Zheng; Zequn,12,0,40,28
1657148199876,MATH 20B,A01,083756,Briones; Jor-el Thomas Caparas,1,0,36,35
1657148199876,MATH 20B,A02,083757,Briones; Jor-el Thomas Caparas,1,0,36,35
1657148199876,MATH 20B,A03,093475,Briones; Jor-el Thomas Caparas,1,0,36,35
1657148205900,MATH 20C,A01,083760,Briones; Jor-el Thomas Caparas,1,0,35,34
1657148205900,MATH 20C,A02,083761,Briones; Jor-el Thomas Caparas,8,0,35,27
1657148205900,MATH 20C,A03,093476,Briones; Jor-el Thomas Caparas,0,1,36,36
1657148205900,MATH 20C,B01,083762,Bach; Quang Tran,1,0,30,29
1657148211929,MATH 20D,A01,083765,Tran; Brian Kha,4,0,30,26
1657148211929,MATH 20D,A02,083766,Tran; Brian Kha,5,0,30,25
1657148211929,MATH 20D,A03,083767,Tran; Brian Kha,3,0,30,27
1657148217954,MATH 20E,A01,083771,Ganguly; Soumya,7,0,32,25
1657148217954,MATH 20E,A02,083772,Ganguly; Soumya,7,0,32,25
1657148217954,MATH 20E,B01,083773,Ciotti; Benjamin,19,0,35,16
1657148217954,MATH 20E,B02,083774,Ciotti; Benjamin,17,0,35,18
1657148223994,MATH 103A,A01,083777,Greenfeld; Be'Eri,2,0,36,34
1657148223994,MATH 103A,A02,083778,Greenfeld; Be'Eri,5,0,36,31
1657148223994,MATH 103A,A03,093561,Greenfeld; Be'Eri,4,0,36,32
1657148223994,MATH 103A,B01,083779,Greenfeld; Be'Eri,6,0,36,30
1657148223994,MATH 103A,B02,083780,Greenfeld; Be'Eri,3,0,36,33
1657148223994,MATH 103A,B03,093562,Greenfeld; Be'Eri,3,0,36,33
1657148230017,MATH 105,A01,085443,Carter; Anne Toulson,14,0,35,21
1657148230017,MATH 105,A02,093477,Carter; Anne Toulson,20,0,35,15
1657148236042,MATH 109,A01,083213,Ganzberger; Geoffrey Michael,2,0,34,32
1657148236042,MATH 109,A02,083214,Ganzberger; Geoffrey Michael,3,0,34,31
1657148236042,MATH 109,A03,093478,Ganzberger; Geoffrey Michael,1,0,34,33
1657148236042,MATH 109,B01,083215,Ganzberger; Geoffrey Michael,1,0,32,31
1657148236042,MATH 109,B02,083216,Ganzberger; Geoffrey Michael,1,0,32,31
1657148236042,MATH 109,B03,093479,Ganzberger; Geoffrey Michael,6,0,32,26
1657148242067,MATH 142A,A01,083219,Chow; Bennett,6,0,32,26
1657148242067,MATH 142A,A02,083220,Chow; Bennett,10,0,32,22
1657148242067,MATH 142A,A03,093480,Chow; Bennett,7,0,32,25
1657148242067,MATH 142A,B03,093481,Chow; Bennett,8,0,32,24
1657148242067,MATH 142A,B04,093558,Chow; Bennett,11,0,32,21
1657148242067,MATH 142A,B05,093559,Chow; Bennett,6,0,32,26
1657148248096,MATH 193A,A01,083224,Rotar; Vladimir,7,0,34,27
1657148248096,MATH 193A,A02,083225,Rotar; Vladimir,5,0,34,29
1657148248096,MATH 193A,A03,083781,Rotar; Vladimir,1,0,34,33
1657148248096,MATH 193A,A04,083782,Rotar; Vladimir,8,0,34,26
1657148248096,MATH 193A,A05,093482,Rotar; Vladimir,6,0,34,28
1657148254118,MATH 197,001,091859,McAuley; Julian John,9999,0,9999,0
1657148254118,MATH 197,002,095566,Kedlaya; Kiran S.,9997,0,9999,2
1657148254118,MATH 197,003,095567,Xiao; Ming,9999,0,9999,0
1657148254118,MATH 197,004,095571,Perols; Johan Lars,9998,0,9999,1
1657148261173,COGS 9,A01,083615,Shannon; Kyle Michael,7,0,75,68
1657148267204,COGS 11,A01,083617,Boyle; Mary E. T.,21,0,48,27
1657148273232,COGS 13,A01,083071,Bastos; Amalia Pinkusfeld,9,0,71,62
1657148279260,COGS 14A,A01,092681,Semenuks; Arturs,1,1,100,99
1657148285283,COGS 14B,A01,083073,Cheng; Tzu-Han,6,0,63,57
1657148291308,COGS 17,A01,092677,Semenuks; Arturs,4,0,81,77
1657148297336,COGS 100,A01,083619,Allen; Michael Gordon,15,0,70,55
1657148303358,COGS 101A,A01,083621,Davis; Joshua Daniel,9,0,68,59
1657148309381,COGS 101B,A01,091572,Allen; Michael Gordon,9,0,65,56
1657148315405,COGS 101C,A01,083625,Delgado; Tania,17,0,35,18
1657148321427,COGS 107A,A01,083627,Boyle; Mary E. T.,13,0,60,47
1657148327451,COGS 118A,A01,083075,Gupta; Anjum,15,0,76,61
1657148333473,CSE 3,A50,083646,Miranda; Gregory Joseph,24,0,50,26
1657148339506,CSE 8A,A50,083650,Miranda; Gregory Joseph,17,1,56,39
1657148345528,CSE 11,A01,083080,Cao; Yingjun,5,15,40,35
1657148351559,CSE 12,A01,083652,Krause-Levy; Sophia Louisa,24,1,120,96
1657148357582,CSE 15L,A01,083654,Morris; Justin Loren,9,0,50,41
1657148357582,CSE 15L,A02,083655,Morris; Justin Loren,9,0,50,41
1657148363608,CSE 20,A01,083657,Tran; Khoa Dang,38,0,80,42
1657148369631,CSE 21,A01,095574,Bach; Quang Tran,22,0,48,26
1657148375659,CSE 30,A01,083084,Eldon; John,4,0,80,76
1657148375659,CSE 30,B01,095061,Bhaskar; Nishant,7,0,50,43
1657148381716,CSE 100,A01,083659,Cao; Yingjun,4,4,70,66
1657148387742,CSE 134B,A01,083661,Powell; Thomas Allan,20,0,100,80
1657148393765,CSE 140,A01,083663,Gungor; Onat,13,0,85,72
1657148399788,CSE 140L,A01,083088,Eldon; John,17,0,100,83
1657148405810,CSE 175,A01,083665,Kumar; Rakesh,3,0,25,22
1657148411833,CSE 190,A00,092507,Dubnov; Shlomo,7,0,20,13
1657148417854,ECE 45,A01,083139,Congero; Spencer William,5,0,75,70
1657148423881,ECE 65,A50,083695,Saad; Andrew S,12,0,30,18
1657148423881,ECE 65,A51,095125,Saad; Andrew S,25,0,26,1
1657148429909,ECE 109,A01,091882,Touri; Behrouz,18,0,70,52
1657148435931,ECE 180,A00,083140,Abi Samra; Nicholas Camill,1,0,30,29
1657148435931,ECE 180,B00,083141,Abi Samra; Nicholas Camill,0,0,30,30
1657148441959,MATH 10A,A01,083735,Patchell; Gregory David,2,0,30,28
1657148441959,MATH 10A,A02,083736,Patchell; Gregory David,20,0,30,10
1657148441959,MATH 10A,A03,083737,Patchell; Gregory David,16,0,30,14
1657148447989,MATH 10B,A01,083207,Lim; Seonhee,7,0,34,27
1657148447989,MATH 10B,A02,083208,Lim; Seonhee,9,0,35,26
1657148447989,MATH 10B,A03,093472,Lim; Seonhee,5,0,34,29
1657148447989,MATH 10B,B01,083739,Sinha; Shubham,9,0,30,21
1657148454022,MATH 18,A01,083743,Cinel; Cameron Alexander,6,0,30,24
1657148454022,MATH 18,A02,083744,Cinel; Cameron Alexander,15,0,30,15
1657148454022,MATH 18,A03,083745,Cinel; Cameron Alexander,8,0,30,22
1657148454022,MATH 18,B01,083748,Rideout; David Porter,4,0,37,33
1657148454022,MATH 18,B02,083749,Rideout; David Porter,3,0,36,33
1657148454022,MATH 18,B03,083750,Rideout; David Porter,2,0,37,35
1657148454022,MATH 18,B04,083751,Rideout; David Porter,5,0,36,31
1657148454022,MATH 18,B05,093473,Rideout; David Porter,4,0,36,32
1657148454022,MATH 18,B06,093474,Rideout; David Porter,5,0,36,31
1657148460056,MATH 20A,A01,083754,Zheng; Zequn,12,0,40,28
1657148466079,MATH 20B,A01,083756,Briones; Jor-el Thomas Caparas,1,0,36,35
1657148466079,MATH 20B,A02,083757,Briones; Jor-el Thomas Caparas,1,0,36,35
1657148466079,MATH 20B,A03,093475,Briones; Jor-el Thomas Caparas,1,0,36,35
1657148472102,MATH 20C,A01,083760,Briones; Jor-el Thomas Caparas,1,0,35,34
1657148472102,MATH 20C,A02,083761,Briones; Jor-el Thomas Caparas,8,0,35,27
1657148472102,MATH 20C,A03,093476,Briones; Jor-el Thomas Caparas,0,1,36,36
1657148472102,MATH 20C,B01,083762,Bach; Quang Tran,1,0,30,29
1657148478130,MATH 20D,A01,083765,Tran; Brian Kha,4,0,30,26
1657148478130,MATH 20D,A02,083766,Tran; Brian Kha,5,0,30,25
1657148478130,MATH 20D,A03,083767,Tran; Brian Kha,3,0,30,27
1657148484157,MATH 20E,A01,083771,Ganguly; Soumya,7,0,32,25
1657148484157,MATH 20E,A02,083772,Ganguly; Soumya,7,0,32,25
1657148484157,MATH 20E,B01,083773,Ciotti; Benjamin,19,0,35,16
1657148484157,MATH 20E,B02,083774,Ciotti; Benjamin,17,0,35,18
1657148490181,MATH 103A,A01,083777,Greenfeld; Be'Eri,2,0,36,34
1657148490181,MATH 103A,A02,083778,Greenfeld; Be'Eri,5,0,36,31
1657148490181,MATH 103A,A03,093561,Greenfeld; Be'Eri,4,0,36,32
1657148490181,MATH 103A,B01,083779,Greenfeld; Be'Eri,6,0,36,30
1657148490181,MATH 103A,B02,083780,Greenfeld; Be'Eri,3,0,36,33
1657148490181,MATH 103A,B03,093562,Greenfeld; Be'Eri,3,0,36,33
1657148496204,MATH 105,A01,085443,Carter; Anne Toulson,14,0,35,21
1657148496204,MATH 105,A02,093477,Carter; Anne Toulson,20,0,35,15
1657148502230,MATH 109,A01,083213,Ganzberger; Geoffrey Michael,2,0,34,32
1657148502230,MATH 109,A02,083214,Ganzberger; Geoffrey Michael,3,0,34,31
1657148502230,MATH 109,A03,093478,Ganzberger; Geoffrey Michael,1,0,34,33
1657148502230,MATH 109,B01,083215,Ganzberger; Geoffrey Michael,1,0,32,31
1657148502230,MATH 109,B02,083216,Ganzberger; Geoffrey Michael,1,0,32,31
1657148502230,MATH 109,B03,093479,Ganzberger; Geoffrey Michael,6,0,32,26
1657148508258,MATH 142A,A01,083219,Chow; Bennett,6,0,32,26
1657148508258,MATH 142A,A02,083220,Chow; Bennett,10,0,32,22
1657148508258,MATH 142A,A03,093480,Chow; Bennett,7,0,32,25
1657148508258,MATH 142A,B03,093481,Chow; Bennett,8,0,32,24
1657148508258,MATH 142A,B04,093558,Chow; Bennett,11,0,32,21
1657148508258,MATH 142A,B05,093559,Chow; Bennett,6,0,32,26
1657148514282,MATH 193A,A01,083224,Rotar; Vladimir,7,0,34,27
1657148514282,MATH 193A,A02,083225,Rotar; Vladimir,5,0,34,29
1657148514282,MATH 193A,A03,083781,Rotar; Vladimir,1,0,34,33
1657148514282,MATH 193A,A04,083782,Rotar; Vladimir,8,0,34,26
1657148514282,MATH 193A,A05,093482,Rotar; Vladimir,6,0,34,28
1657148520304,MATH 197,001,091859,McAuley; Julian John,9999,0,9999,0
1657148520304,MATH 197,002,095566,Kedlaya; Kiran S.,9997,0,9999,2
1657148520304,MATH 197,003,095567,Xiao; Ming,9999,0,9999,0
1657148520304,MATH 197,004,095571,Perols; Johan Lars,9998,0,9999,1
1657148527369,COGS 9,A01,083615,Shannon; Kyle Michael,7,0,75,68
1657148533393,COGS 11,A01,083617,Boyle; Mary E. T.,21,0,48,27
1657148539424,COGS 13,A01,083071,Bastos; Amalia Pinkusfeld,9,0,71,62
1657148545450,COGS 14A,A01,092681,Semenuks; Arturs,1,1,100,99
1657148551472,COGS 14B,A01,083073,Cheng; Tzu-Han,6,0,63,57
1657148557494,COGS 17,A01,092677,Semenuks; Arturs,4,0,81,77
1657148563517,COGS 100,A01,083619,Allen; Michael Gordon,15,0,70,55
1657148569544,COGS 101A,A01,083621,Davis; Joshua Daniel,9,0,68,59
1657148575573,COGS 101B,A01,091572,Allen; Michael Gordon,9,0,65,56
1657148581600,COGS 101C,A01,083625,Delgado; Tania,17,0,35,18
1657148587625,COGS 107A,A01,083627,Boyle; Mary E. T.,13,0,60,47
1657148593654,COGS 118A,A01,083075,Gupta; Anjum,15,0,76,61
1657148599784,CSE 3,A50,083646,Miranda; Gregory Joseph,24,0,50,26
1657148605807,CSE 8A,A50,083650,Miranda; Gregory Joseph,17,1,56,39
1657148611830,CSE 11,A01,083080,Cao; Yingjun,5,15,40,35
1657148617854,CSE 12,A01,083652,Krause-Levy; Sophia Louisa,24,1,120,96
1657148623880,CSE 15L,A01,083654,Morris; Justin Loren,9,0,50,41
1657148623880,CSE 15L,A02,083655,Morris; Justin Loren,9,0,50,41
1657148629905,CSE 20,A01,083657,Tran; Khoa Dang,38,0,80,42
1657148635928,CSE 21,A01,095574,Bach; Quang Tran,22,0,48,26
1657148641954,CSE 30,A01,083084,Eldon; John,4,0,80,76
1657148641954,CSE 30,B01,095061,Bhaskar; Nishant,7,0,50,43
1657148647976,CSE 100,A01,083659,Cao; Yingjun,4,4,70,66
1657148654000,CSE 134B,A01,083661,Powell; Thomas Allan,20,0,100,80
1657148660036,CSE 140,A01,083663,Gungor; Onat,13,0,85,72
1657148666062,CSE 140L,A01,083088,Eldon; John,17,0,100,83
1657148672085,CSE 175,A01,083665,Kumar; Rakesh,3,0,25,22
1657148678107,CSE 190,A00,092507,Dubnov; Shlomo,7,0,20,13
1657148684133,ECE 45,A01,083139,Congero; Spencer William,5,0,75,70
1657148690161,ECE 65,A50,083695,Saad; Andrew S,12,0,30,18
1657148690161,ECE 65,A51,095125,Saad; Andrew S,25,0,26,1
1657148696187,ECE 109,A01,091882,Touri; Behrouz,18,0,70,52
1657148702221,ECE 180,A00,083140,Abi Samra; Nicholas Camill,1,0,30,29
1657148702221,ECE 180,B00,083141,Abi Samra; Nicholas Camill,0,0,30,30
1657148708250,MATH 10A,A01,083735,Patchell; Gregory David,2,0,30,28
1657148708250,MATH 10A,A02,083736,Patchell; Gregory David,20,0,30,10
1657148708250,MATH 10A,A03,083737,Patchell; Gregory David,16,0,30,14
1657148714275,MATH 10B,A01,083207,Lim; Seonhee,7,0,34,27
1657148714275,MATH 10B,A02,083208,Lim; Seonhee,9,0,35,26
1657148714275,MATH 10B,A03,093472,Lim; Seonhee,5,0,34,29
1657148714275,MATH 10B,B01,083739,Sinha; Shubham,9,0,30,21
1657148720304,MATH 18,A01,083743,Cinel; Cameron Alexander,6,0,30,24
1657148720304,MATH 18,A02,083744,Cinel; Cameron Alexander,15,0,30,15
1657148720304,MATH 18,A03,083745,Cinel; Cameron Alexander,8,0,30,22
1657148720304,MATH 18,B01,083748,Rideout; David Porter,4,0,37,33
1657148720304,MATH 18,B02,083749,Rideout; David Porter,3,0,36,33
1657148720304,MATH 18,B03,083750,Rideout; David Porter,2,0,37,35
1657148720304,MATH 18,B04,083751,Rideout; David Porter,5,0,36,31
1657148720304,MATH 18,B05,093473,Rideout; David Porter,4,0,36,32
1657148720304,MATH 18,B06,093474,Rideout; David Porter,5,0,36,31
1657148726337,MATH 20A,A01,083754,Zheng; Zequn,12,0,40,28
1657148732364,MATH 20B,A01,083756,Briones; Jor-el Thomas Caparas,1,0,36,35
1657148732364,MATH 20B,A02,083757,Briones; Jor-el Thomas Caparas,1,0,36,35
1657148732364,MATH 20B,A03,093475,Briones; Jor-el Thomas Caparas,1,0,36,35
1657148738389,MATH 20C,A01,083760,Briones; Jor-el Thomas Caparas,1,0,35,34
1657148738389,MATH 20C,A02,083761,Briones; Jor-el Thomas Caparas,8,0,35,27
1657148738389,MATH 20C,A03,093476,Briones; Jor-el Thomas Caparas,0,1,36,36
1657148738389,MATH 20C,B01,083762,Bach; Quang Tran,1,0,30,29
1657148744416,MATH 20D,A01,083765,Tran; Brian Kha,4,0,30,26
1657148744416,MATH 20D,A02,083766,Tran; Brian Kha,5,0,30,25
1657148744416,MATH 20D,A03,083767,Tran; Brian Kha,3,0,30,27
1657148750440,MATH 20E,A01,083771,Ganguly; Soumya,7,0,32,25
1657148750440,MATH 20E,A02,083772,Ganguly; Soumya,7,0,32,25
1657148750440,MATH 20E,B01,083773,Ciotti; Benjamin,19,0,35,16
1657148750440,MATH 20E,B02,083774,Ciotti; Benjamin,17,0,35,18
1657148756465,MATH 103A,A01,083777,Greenfeld; Be'Eri,2,0,36,34
1657148756465,MATH 103A,A02,083778,Greenfeld; Be'Eri,5,0,36,31
1657148756465,MATH 103A,A03,093561,Greenfeld; Be'Eri,4,0,36,32
1657148756465,MATH 103A,B01,083779,Greenfeld; Be'Eri,6,0,36,30
1657148756465,MATH 103A,B02,083780,Greenfeld; Be'Eri,3,0,36,33
1657148756465,MATH 103A,B03,093562,Greenfeld; Be'Eri,3,0,36,33
1657148762493,MATH 105,A01,085443,Carter; Anne Toulson,14,0,35,21
1657148762493,MATH 105,A02,093477,Carter; Anne Toulson,20,0,35,15
1657148768517,MATH 109,A01,083213,Ganzberger; Geoffrey Michael,2,0,34,32
1657148768517,MATH 109,A02,083214,Ganzberger; Geoffrey Michael,3,0,34,31
1657148768517,MATH 109,A03,093478,Ganzberger; Geoffrey Michael,1,0,34,33
1657148768517,MATH 109,B01,083215,Ganzberger; Geoffrey Michael,1,0,32,31
1657148768517,MATH 109,B02,083216,Ganzberger; Geoffrey Michael,1,0,32,31
1657148768517,MATH 109,B03,093479,Ganzberger; Geoffrey Michael,6,0,32,26
1657148774546,MATH 142A,A01,083219,Chow; Bennett,6,0,32,26
1657148774546,MATH 142A,A02,083220,Chow; Bennett,10,0,32,22
1657148774546,MATH 142A,A03,093480,Chow; Bennett,7,0,32,25
1657148774546,MATH 142A,B03,093481,Chow; Bennett,8,0,32,24
1657148774546,MATH 142A,B04,093558,Chow; Bennett,11,0,32,21
1657148774546,MATH 142A,B05,093559,Chow; Bennett,6,0,32,26
1657148780569,MATH 193A,A01,083224,Rotar; Vladimir,7,0,34,27
1657148780569,MATH 193A,A02,083225,Rotar; Vladimir,5,0,34,29
1657148780569,MATH 193A,A03,083781,Rotar; Vladimir,1,0,34,33
1657148780569,MATH 193A,A04,083782,Rotar; Vladimir,8,0,34,26
1657148780569,MATH 193A,A05,093482,Rotar; Vladimir,6,0,34,28
1657148786594,MATH 197,001,091859,McAuley; Julian John,9999,0,9999,0
1657148786594,MATH 197,002,095566,Kedlaya; Kiran S.,9997,0,9999,2
1657148786594,MATH 197,003,095567,Xiao; Ming,9999,0,9999,0
1657148786594,MATH 197,004,095571,Perols; Johan Lars,9998,0,9999,1
1657148793652,COGS 9,A01,083615,Shannon; Kyle Michael,7,0,75,68
1657148799677,COGS 11,A01,083617,Boyle; Mary E. T.,21,0,48,27
1657148805700,COGS 13,A01,083071,Bastos; Amalia Pinkusfeld,9,0,71,62
1657148811726,COGS 14A,A01,092681,Semenuks; Arturs,1,1,100,99
1657148817754,COGS 14B,A01,083073,Cheng; Tzu-Han,6,0,63,57
1657148823782,COGS 17,A01,092677,Semenuks; Arturs,4,0,81,77
1657148829805,COGS 100,A01,083619,Allen; Michael Gordon,15,0,70,55
1657148835833,COGS 101A,A01,083621,Davis; Joshua Daniel,9,0,68,59
1657148841876,COGS 101B,A01,091572,Allen; Michael Gordon,9,0,65,56
1657148847906,COGS 101C,A01,083625,Delgado; Tania,17,0,35,18
1657148853929,COGS 107A,A01,083627,Boyle; Mary E. T.,13,0,60,47
1657148859956,COGS 118A,A01,083075,Gupta; Anjum,15,0,76,61
1657148865982,CSE 3,A50,083646,Miranda; Gregory Joseph,24,0,50,26
1657148872007,CSE 8A,A50,083650,Miranda; Gregory Joseph,17,1,56,39
1657148878033,CSE 11,A01,083080,Cao; Yingjun,5,15,40,35
1657148884059,CSE 12,A01,083652,Krause-Levy; Sophia Louisa,24,1,120,96
1657148890086,CSE 15L,A01,083654,Morris; Justin Loren,9,0,50,41
1657148890086,CSE 15L,A02,083655,Morris; Justin Loren,9,0,50,41
1657148896108,CSE 20,A01,083657,Tran; Khoa Dang,38,0,80,42
1657148902138,CSE 21,A01,095574,Bach; Quang Tran,22,0,48,26
1657148908164,CSE 30,A01,083084,Eldon; John,4,0,80,76
1657148908164,CSE 30,B01,095061,Bhaskar; Nishant,7,0,50,43
1657148914197,CSE 100,A01,083659,Cao; Yingjun,4,4,70,66
1657148920220,CSE 134B,A01,083661,Powell; Thomas Allan,20,0,100,80
1657148926244,CSE 140,A01,083663,Gungor; Onat,13,0,85,72
1657148932272,CSE 140L,A01,083088,Eldon; John,17,0,100,83
1657148938297,CSE 175,A01,083665,Kumar; Rakesh,3,0,25,22
1657148944321,CSE 190,A00,092507,Dubnov; Shlomo,7,0,20,13
1657148950347,ECE 45,A01,083139,Congero; Spencer William,5,0,75,70
1657148956382,ECE 65,A50,083695,Saad; Andrew S,12,0,30,18
1657148956382,ECE 65,A51,095125,Saad; Andrew S,25,0,26,1
1657148962414,ECE 109,A01,091882,Touri; Behrouz,18,0,70,52
1657148968438,ECE 180,A00,083140,Abi Samra; Nicholas Camill,1,0,30,29
1657148968438,ECE 180,B00,083141,Abi Samra; Nicholas Camill,0,0,30,30
1657148974462,MATH 10A,A01,083735,Patchell; Gregory David,2,0,30,28
1657148974462,MATH 10A,A02,083736,Patchell; Gregory David,20,0,30,10
1657148974462,MATH 10A,A03,083737,Patchell; Gregory David,16,0,30,14
1657148980489,MATH 10B,A01,083207,Lim; Seonhee,7,0,34,27
1657148980489,MATH 10B,A02,083208,Lim; Seonhee,9,0,35,26
1657148980489,MATH 10B,A03,093472,Lim; Seonhee,5,0,34,29
1657148980489,MATH 10B,B01,083739,Sinha; Shubham,9,0,30,21
1657148986519,MATH 18,A01,083743,Cinel; Cameron Alexander,6,0,30,24
1657148986519,MATH 18,A02,083744,Cinel; Cameron Alexander,15,0,30,15
1657148986519,MATH 18,A03,083745,Cinel; Cameron Alexander,8,0,30,22
1657148986519,MATH 18,B01,083748,Rideout; David Porter,4,0,37,33
1657148986519,MATH 18,B02,083749,Rideout; David Porter,3,0,36,33
1657148986519,MATH 18,B03,083750,Rideout; David Porter,2,0,37,35
1657148986519,MATH 18,B04,083751,Rideout; David Porter,5,0,36,31
1657148986519,MATH 18,B05,093473,Rideout; David Porter,5,0,36,31
1657148986519,MATH 18,B06,093474,Rideout; David Porter,5,0,36,31
1657148992547,MATH 20A,A01,083754,Zheng; Zequn,12,0,40,28
1657148998575,MATH 20B,A01,083756,Briones; Jor-el Thomas Caparas,1,0,36,35
1657148998575,MATH 20B,A02,083757,Briones; Jor-el Thomas Caparas,1,0,36,35
1657148998575,MATH 20B,A03,093475,Briones; Jor-el Thomas Caparas,1,0,36,35
1657149004614,MATH 20C,A01,083760,Briones; Jor-el Thomas Caparas,1,0,35,34
1657149004614,MATH 20C,A02,083761,Briones; Jor-el Thomas Caparas,8,0,35,27
1657149004614,MATH 20C,A03,093476,Briones; Jor-el Thomas Caparas,0,1,36,36
1657149004614,MATH 20C,B01,083762,Bach; Quang Tran,1,0,30,29
1657149010643,MATH 20D,A01,083765,Tran; Brian Kha,4,0,30,26
1657149010643,MATH 20D,A02,083766,Tran; Brian Kha,5,0,30,25
1657149010643,MATH 20D,A03,083767,Tran; Brian Kha,3,0,30,27
1657149016668,MATH 20E,A01,083771,Ganguly; Soumya,7,0,32,25
1657149016668,MATH 20E,A02,083772,Ganguly; Soumya,7,0,32,25
1657149016668,MATH 20E,B01,083773,Ciotti; Benjamin,19,0,35,16
1657149016668,MATH 20E,B02,083774,Ciotti; Benjamin,17,0,35,18
1657149022697,MATH 103A,A01,083777,Greenfeld; Be'Eri,2,0,36,34
1657149022697,MATH 103A,A02,083778,Greenfeld; Be'Eri,5,0,36,31
1657149022697,MATH 103A,A03,093561,Greenfeld; Be'Eri,4,0,36,32
1657149022697,MATH 103A,B01,083779,Greenfeld; Be'Eri,6,0,36,30
1657149022697,MATH 103A,B02,083780,Greenfeld; Be'Eri,3,0,36,33
1657149022697,MATH 103A,B03,093562,Greenfeld; Be'Eri,3,0,36,33
1657149028723,MATH 105,A01,085443,Carter; Anne Toulson,14,0,35,21
1657149028723,MATH 105,A02,093477,Carter; Anne Toulson,20,0,35,15
1657149034744,MATH 109,A01,083213,Ganzberger; Geoffrey Michael,2,0,34,32
1657149034744,MATH 109,A02,083214,Ganzberger; Geoffrey Michael,3,0,34,31
1657149034744,MATH 109,A03,093478,Ganzberger; Geoffrey Michael,1,0,34,33
1657149034744,MATH 109,B01,083215,Ganzberger; Geoffrey Michael,1,0,32,31
1657149034744,MATH 109,B02,083216,Ganzberger; Geoffrey Michael,1,0,32,31
1657149034744,MATH 109,B03,093479,Ganzberger; Geoffrey Michael,6,0,32,26
1657149040772,MATH 142A,A01,083219,Chow; Bennett,6,0,32,26
1657149040772,MATH 142A,A02,083220,Chow; Bennett,10,0,32,22
1657149040772,MATH 142A,A03,093480,Chow; Bennett,7,0,32,25
1657149040772,MATH 142A,B03,093481,Chow; Bennett,8,0,32,24
1657149040772,MATH 142A,B04,093558,Chow; Bennett,11,0,32,21
1657149040772,MATH 142A,B05,093559,Chow; Bennett,6,0,32,26
1657149046825,MATH 193A,A01,083224,Rotar; Vladimir,7,0,34,27
1657149046825,MATH 193A,A02,083225,Rotar; Vladimir,5,0,34,29
1657149046825,MATH 193A,A03,083781,Rotar; Vladimir,1,0,34,33
1657149046825,MATH 193A,A04,083782,Rotar; Vladimir,8,0,34,26
1657149046825,MATH 193A,A05,093482,Rotar; Vladimir,6,0,34,28
1657149052852,MATH 197,001,091859,McAuley; Julian John,9999,0,9999,0
1657149052852,MATH 197,002,095566,Kedlaya; Kiran S.,9997,0,9999,2
1657149052852,MATH 197,003,095567,Xiao; Ming,9999,0,9999,0
1657149052852,MATH 197,004,095571,Perols; Johan Lars,9998,0,9999,1
1657149059912,COGS 9,A01,083615,Shannon; Kyle Michael,7,0,75,68
1657149065939,COGS 11,A01,083617,Boyle; Mary E. T.,22,0,48,26
1657149071965,COGS 13,A01,083071,Bastos; Amalia Pinkusfeld,9,0,71,62
1657149077989,COGS 14A,A01,092681,Semenuks; Arturs,1,1,100,99
1657149084020,COGS 14B,A01,083073,Cheng; Tzu-Han,6,0,63,57
1657149090047,COGS 17,A01,092677,Semenuks; Arturs,4,0,81,77
1657149096072,COGS 100,A01,083619,Allen; Michael Gordon,15,0,70,55
1657149102098,COGS 101A,A01,083621,Davis; Joshua Daniel,9,0,68,59
1657149108124,COGS 101B,A01,091572,Allen; Michael Gordon,9,0,65,56
1657149114152,COGS 101C,A01,083625,Delgado; Tania,17,0,35,18
1657149120177,COGS 107A,A01,083627,Boyle; Mary E. T.,13,0,60,47
1657149126199,COGS 118A,A01,083075,Gupta; Anjum,15,0,76,61
1657149132236,CSE 3,A50,083646,Miranda; Gregory Joseph,24,0,50,26
1657149138261,CSE 8A,A50,083650,Miranda; Gregory Joseph,17,1,56,39
1657149144300,CSE 11,A01,083080,Cao; Yingjun,5,15,40,35
1657149150331,CSE 12,A01,083652,Krause-Levy; Sophia Louisa,24,1,120,96
1657149156358,CSE 15L,A01,083654,Morris; Justin Loren,9,0,50,41
1657149156358,CSE 15L,A02,083655,Morris; Justin Loren,9,0,50,41
1657149162385,CSE 20,A01,083657,Tran; Khoa Dang,38,0,80,42
1657149168408,CSE 21,A01,095574,Bach; Quang Tran,22,0,48,26
1657149174433,CSE 30,A01,083084,Eldon; John,4,0,80,76
1657149174433,CSE 30,B01,095061,Bhaskar; Nishant,7,0,50,43
1657149180456,CSE 100,A01,083659,Cao; Yingjun,4,4,70,66
1657149186484,CSE 134B,A01,083661,Powell; Thomas Allan,20,0,100,80
1657149192508,CSE 140,A01,083663,Gungor; Onat,13,0,85,72
1657149198609,CSE 140L,A01,083088,Eldon; John,17,0,100,83
1657149204636,CSE 175,A01,083665,Kumar; Rakesh,3,0,25,22
1657149210663,CSE 190,A00,092507,Dubnov; Shlomo,7,0,20,13
1657149216688,ECE 45,A01,083139,Congero; Spencer William,5,0,75,70
1657149222716,ECE 65,A50,083695,Saad; Andrew S,12,0,30,18
1657149222716,ECE 65,A51,095125,Saad; Andrew S,25,0,26,1
1657149228738,ECE 109,A01,091882,Touri; Behrouz,18,0,70,52
1657149234770,ECE 180,A00,083140,Abi Samra; Nicholas Camill,1,0,30,29
1657149234770,ECE 180,B00,083141,Abi Samra; Nicholas Camill,0,0,30,30
1657149240797,MATH 10A,A01,083735,Patchell; Gregory David,2,0,30,28
1657149240797,MATH 10A,A02,083736,Patchell; Gregory David,20,0,30,10
1657149240797,MATH 10A,A03,083737,Patchell; Gregory David,16,0,30,14
1657149246827,MATH 10B,A01,083207,Lim; Seonhee,7,0,34,27
1657149246827,MATH 10B,A02,083208,Lim; Seonhee,9,0,35,26
1657149246827,MATH 10B,A03,093472,Lim; Seonhee,5,0,34,29
1657149246827,MATH 10B,B01,083739,Sinha; Shubham,9,0,30,21
1657149252851,MATH 18,A01,083743,Cinel; Cameron Alexander,6,0,30,24
1657149252851,MATH 18,A02,083744,Cinel; Cameron Alexander,15,0,30,15
1657149252851,MATH 18,A03,083745,Cinel; Cameron Alexander,8,0,30,22
1657149252851,MATH 18,B01,083748,Rideout; David Porter,4,0,37,33
1657149252851,MATH 18,B02,083749,Rideout; David Porter,3,0,36,33
1657149252851,MATH 18,B03,083750,Rideout; David Porter,2,0,37,35
1657149252851,MATH 18,B04,083751,Rideout; David Porter,5,0,36,31
1657149252851,MATH 18,B05,093473,Rideout; David Porter,5,0,36,31
1657149252851,MATH 18,B06,093474,Rideout; David Porter,5,0,36,31
1657149258876,MATH 20A,A01,083754,Zheng; Zequn,12,0,40,28
1657149264902,MATH 20B,A01,083756,Briones; Jor-el Thomas Caparas,1,0,36,35
1657149264902,MATH 20B,A02,083757,Briones; Jor-el Thomas Caparas,1,0,36,35
1657149264902,MATH 20B,A03,093475,Briones; Jor-el Thomas Caparas,1,0,36,35
1657149270924,MATH 20C,A01,083760,Briones; Jor-el Thomas Caparas,1,0,35,34
1657149270924,MATH 20C,A02,083761,Briones; Jor-el Thomas Caparas,8,0,35,27
1657149270924,MATH 20C,A03,093476,Briones; Jor-el Thomas Caparas,0,1,36,36
1657149270924,MATH 20C,B01,083762,Bach; Quang Tran,1,0,30,29
1657149276954,MATH 20D,A01,083765,Tran; Brian Kha,4,0,30,26
1657149276954,MATH 20D,A02,083766,Tran; Brian Kha,5,0,30,25
1657149276954,MATH 20D,A03,083767,Tran; Brian Kha,3,0,30,27
1657149282984,MATH 20E,A01,083771,Ganguly; Soumya,7,0,32,25
1657149282984,MATH 20E,A02,083772,Ganguly; Soumya,7,0,32,25
1657149282984,MATH 20E,B01,083773,Ciotti; Benjamin,19,0,35,16
1657149282984,MATH 20E,B02,083774,Ciotti; Benjamin,17,0,35,18
1657149289014,MATH 103A,A01,083777,Greenfeld; Be'Eri,2,0,36,34
1657149289014,MATH 103A,A02,083778,Greenfeld; Be'Eri,5,0,36,31
1657149289014,MATH 103A,A03,093561,Greenfeld; Be'Eri,4,0,36,32
1657149289014,MATH 103A,B01,083779,Greenfeld; Be'Eri,6,0,36,30
1657149289014,MATH 103A,B02,083780,Greenfeld; Be'Eri,3,0,36,33
1657149289014,MATH 103A,B03,093562,Greenfeld; Be'Eri,3,0,36,33
1657149295037,MATH 105,A01,085443,Carter; Anne Toulson,14,0,35,21
1657149295037,MATH 105,A02,093477,Carter; Anne Toulson,20,0,35,15
1657149301060,MATH 109,A01,083213,Ganzberger; Geoffrey Michael,2,0,34,32
1657149301060,MATH 109,A02,083214,Ganzberger; Geoffrey Michael,3,0,34,31
1657149301060,MATH 109,A03,093478,Ganzberger; Geoffrey Michael,1,0,34,33
1657149301060,MATH 109,B01,083215,Ganzberger; Geoffrey Michael,1,0,32,31
1657149301060,MATH 109,B02,083216,Ganzberger; Geoffrey Michael,1,0,32,31
1657149301060,MATH 109,B03,093479,Ganzberger; Geoffrey Michael,6,0,32,26
1657149307084,MATH 142A,A01,083219,Chow; Bennett,6,0,32,26
1657149307084,MATH 142A,A02,083220,Chow; Bennett,10,0,32,22
1657149307084,MATH 142A,A03,093480,Chow; Bennett,7,0,32,25
1657149307084,MATH 142A,B03,093481,Chow; Bennett,8,0,32,24
1657149307084,MATH 142A,B04,093558,Chow; Bennett,11,0,32,21
1657149307084,MATH 142A,B05,093559,Chow; Bennett,6,0,32,26
1657149313111,MATH 193A,A01,083224,Rotar; Vladimir,7,0,34,27
1657149313111,MATH 193A,A02,083225,Rotar; Vladimir,5,0,34,29
1657149313111,MATH 193A,A03,083781,Rotar; Vladimir,1,0,34,33
1657149313111,MATH 193A,A04,083782,Rotar; Vladimir,8,0,34,26
1657149313111,MATH 193A,A05,093482,Rotar; Vladimir,6,0,34,28
1657149319138,MATH 197,001,091859,McAuley; Julian John,9999,0,9999,0
1657149319138,MATH 197,002,095566,Kedlaya; Kiran S.,9997,0,9999,2
1657149319138,MATH 197,003,095567,Xiao; Ming,9999,0,9999,0
1657149319138,MATH 197,004,095571,Perols; Johan Lars,9998,0,9999,1
1657149326201,COGS 9,A01,083615,Shannon; Kyle Michael,7,0,75,68
1657149332232,COGS 11,A01,083617,Boyle; Mary E. T.,22,0,48,26
1657149338260,COGS 13,A01,083071,Bastos; Amalia Pinkusfeld,9,0,71,62
1657149344286,COGS 14A,A01,092681,Semenuks; Arturs,1,1,100,99
1657149350320,COGS 14B,A01,083073,Cheng; Tzu-Han,6,0,63,57
1657149356349,COGS 17,A01,092677,Semenuks; Arturs,4,0,81,77
1657149362371,COGS 100,A01,083619,Allen; Michael Gordon,15,0,70,55
1657149368395,COGS 101A,A01,083621,Davis; Joshua Daniel,9,0,68,59
1657149374428,COGS 101B,A01,091572,Allen; Michael Gordon,9,0,65,56
1657149380453,COGS 101C,A01,083625,Delgado; Tania,17,0,35,18
1657149386481,COGS 107A,A01,083627,Boyle; Mary E. T.,13,0,60,47
1657149392503,COGS 118A,A01,083075,Gupta; Anjum,15,0,76,61
1657149398527,CSE 3,A50,083646,Miranda; Gregory Joseph,24,0,50,26
1657149404549,CSE 8A,A50,083650,Miranda; Gregory Joseph,17,1,56,39
1657149410576,CSE 11,A01,083080,Cao; Yingjun,5,15,40,35
1657149416603,CSE 12,A01,083652,Krause-Levy; Sophia Louisa,24,1,120,96
1657149422630,CSE 15L,A01,083654,Morris; Justin Loren,9,0,50,41
1657149422630,CSE 15L,A02,083655,Morris; Justin Loren,9,0,50,41
1657149428659,CSE 20,A01,083657,Tran; Khoa Dang,38,0,80,42
1657149434687,CSE 21,A01,095574,Bach; Quang Tran,22,0,48,26
1657149440724,CSE 30,A01,083084,Eldon; John,4,0,80,76
1657149440724,CSE 30,B01,095061,Bhaskar; Nishant,7,0,50,43
1657149446746,CSE 100,A01,083659,Cao; Yingjun,4,4,70,66
1657149452780,CSE 134B,A01,083661,Powell; Thomas Allan,20,0,100,80
1657149458803,CSE 140,A01,083663,Gungor; Onat,13,0,85,72
1657149464829,CSE 140L,A01,083088,Eldon; John,17,0,100,83
1657149470850,CSE 175,A01,083665,Kumar; Rakesh,3,0,25,22
1657149476874,CSE 190,A00,092507,Dubnov; Shlomo,7,0,20,13
1657149482903,ECE 45,A01,083139,Congero; Spencer William,5,0,75,70
1657149488925,ECE 65,A50,083695,Saad; Andrew S,12,0,30,18
1657149488925,ECE 65,A51,095125,Saad; Andrew S,25,0,26,1
1657149494947,ECE 109,A01,091882,Touri; Behrouz,18,0,70,52
1657149500969,ECE 180,A00,083140,Abi Samra; Nicholas Camill,1,0,30,29
1657149500969,ECE 180,B00,083141,Abi Samra; Nicholas Camill,0,0,30,30
1657149507010,MATH 10A,A01,083735,Patchell; Gregory David,2,0,30,28
1657149507010,MATH 10A,A02,083736,Patchell; Gregory David,20,0,30,10
1657149507010,MATH 10A,A03,083737,Patchell; Gregory David,16,0,30,14
1657149513054,MATH 10B,A01,083207,Lim; Seonhee,7,0,34,27
1657149513054,MATH 10B,A02,083208,Lim; Seonhee,9,0,35,26
1657149513054,MATH 10B,A03,093472,Lim; Seonhee,5,0,34,29
1657149513054,MATH 10B,B01,083739,Sinha; Shubham,9,0,30,21
1657149519078,MATH 18,A01,083743,Cinel; Cameron Alexander,6,0,30,24
1657149519078,MATH 18,A02,083744,Cinel; Cameron Alexander,15,0,30,15
1657149519078,MATH 18,A03,083745,Cinel; Cameron Alexander,8,0,30,22
1657149519078,MATH 18,B01,083748,Rideout; David Porter,4,0,37,33
1657149519078,MATH 18,B02,083749,Rideout; David Porter,3,0,36,33
1657149519078,MATH 18,B03,083750,Rideout; David Porter,2,0,37,35
1657149519078,MATH 18,B04,083751,Rideout; David Porter,5,0,36,31
1657149519078,MATH 18,B05,093473,Rideout; David Porter,5,0,36,31
1657149519078,MATH 18,B06,093474,Rideout; David Porter,5,0,36,31
1657149525108,MATH 20A,A01,083754,Zheng; Zequn,12,0,40,28
1657149531135,MATH 20B,A01,083756,Briones; Jor-el Thomas Caparas,1,0,36,35
1657149531135,MATH 20B,A02,083757,Briones; Jor-el Thomas Caparas,1,0,36,35
1657149531135,MATH 20B,A03,093475,Briones; Jor-el Thomas Caparas,1,0,36,35
1657149537158,MATH 20C,A01,083760,Briones; Jor-el Thomas Caparas,1,0,35,34
1657149537158,MATH 20C,A02,083761,Briones; Jor-el Thomas Caparas,8,0,35,27
1657149537158,MATH 20C,A03,093476,Briones; Jor-el Thomas Caparas,0,1,36,36
1657149537158,MATH 20C,B01,083762,Bach; Quang Tran,1,0,30,29
1657149543189,MATH 20D,A01,083765,Tran; Brian Kha,4,0,30,26
1657149543189,MATH 20D,A02,083766,Tran; Brian Kha,5,0,30,25
1657149543189,MATH 20D,A03,083767,Tran; Brian Kha,3,0,30,27
1657149549218,MATH 20E,A01,083771,Ganguly; Soumya,7,0,32,25
1657149549218,MATH 20E,A02,083772,Ganguly; Soumya,7,0,32,25
1657149549218,MATH 20E,B01,083773,Ciotti; Benjamin,19,0,35,16
1657149549218,MATH 20E,B02,083774,Ciotti; Benjamin,17,0,35,18
1657149555241,MATH 103A,A01,083777,Greenfeld; Be'Eri,2,0,36,34
1657149555241,MATH 103A,A02,083778,Greenfeld; Be'Eri,5,0,36,31
1657149555241,MATH 103A,A03,093561,Greenfeld; Be'Eri,4,0,36,32
1657149555241,MATH 103A,B01,083779,Greenfeld; Be'Eri,6,0,36,30
1657149555241,MATH 103A,B02,083780,Greenfeld; Be'Eri,3,0,36,33
1657149555241,MATH 103A,B03,093562,Greenfeld; Be'Eri,3,0,36,33
1657149561265,MATH 105,A01,085443,Carter; Anne Toulson,14,0,35,21
1657149561265,MATH 105,A02,093477,Carter; Anne Toulson,20,0,35,15
1657149567304,MATH 109,A01,083213,Ganzberger; Geoffrey Michael,2,0,34,32
1657149567304,MATH 109,A02,083214,Ganzberger; Geoffrey Michael,3,0,34,31
1657149567304,MATH 109,A03,093478,Ganzberger; Geoffrey Michael,1,0,34,33
1657149567304,MATH 109,B01,083215,Ganzberger; Geoffrey Michael,1,0,32,31
1657149567304,MATH 109,B02,083216,Ganzberger; Geoffrey Michael,1,0,32,31
1657149567304,MATH 109,B03,093479,Ganzberger; Geoffrey Michael,6,0,32,26
1657149573333,MATH 142A,A01,083219,Chow; Bennett,6,0,32,26
1657149573333,MATH 142A,A02,083220,Chow; Bennett,10,0,32,22
1657149573333,MATH 142A,A03,093480,Chow; Bennett,7,0,32,25
1657149573333,MATH 142A,B03,093481,Chow; Bennett,8,0,32,24
1657149573333,MATH 142A,B04,093558,Chow; Bennett,11,0,32,21
1657149573333,MATH 142A,B05,093559,Chow; Bennett,6,0,32,26
1657149579362,MATH 193A,A01,083224,Rotar; Vladimir,7,0,34,27
1657149579362,MATH 193A,A02,083225,Rotar; Vladimir,5,0,34,29
1657149579362,MATH 193A,A03,083781,Rotar; Vladimir,1,0,34,33
1657149579362,MATH 193A,A04,083782,Rotar; Vladimir,8,0,34,26
1657149579362,MATH 193A,A05,093482,Rotar; Vladimir,6,0,34,28
1657149585384,MATH 197,001,091859,McAuley; Julian John,9999,0,9999,0
1657149585384,MATH 197,002,095566,Kedlaya; Kiran S.,9997,0,9999,2
1657149585384,MATH 197,003,095567,Xiao; Ming,9999,0,9999,0
1657149585384,MATH 197,004,095571,Perols; Johan Lars,9998,0,9999,1
1657149592449,COGS 9,A01,083615,Shannon; Kyle Michael,7,0,75,68
1657149598473,COGS 11,A01,083617,Boyle; Mary E. T.,22,0,48,26
1657149604496,COGS 13,A01,083071,Bastos; Amalia Pinkusfeld,9,0,71,62
1657149610531,COGS 14A,A01,092681,Semenuks; Arturs,1,1,100,99
1657149616565,COGS 14B,A01,083073,Cheng; Tzu-Han,6,0,63,57
1657149622595,COGS 17,A01,092677,Semenuks; Arturs,4,0,81,77
1657149628619,COGS 100,A01,083619,Allen; Michael Gordon,15,0,70,55
1657149634643,COGS 101A,A01,083621,Davis; Joshua Daniel,9,0,68,59
1657149640669,COGS 101B,A01,091572,Allen; Michael Gordon,9,0,65,56
1657149646695,COGS 101C,A01,083625,Delgado; Tania,17,0,35,18
1657149652718,COGS 107A,A01,083627,Boyle; Mary E. T.,13,0,60,47
1657149658741,COGS 118A,A01,083075,Gupta; Anjum,15,0,76,61
1657149664775,CSE 3,A50,083646,Miranda; Gregory Joseph,24,0,50,26
1657149670802,CSE 8A,A50,083650,Miranda; Gregory Joseph,17,1,56,39
1657149676824,CSE 11,A01,083080,Cao; Yingjun,5,15,40,35
1657149682850,CSE 12,A01,083652,Krause-Levy; Sophia Louisa,24,1,120,96
1657149688872,CSE 15L,A01,083654,Morris; Justin Loren,9,0,50,41
1657149688872,CSE 15L,A02,083655,Morris; Justin Loren,9,0,50,41
1657149694896,CSE 20,A01,083657,Tran; Khoa Dang,38,0,80,42
1657149700922,CSE 21,A01,095574,Bach; Quang Tran,22,0,48,26
1657149706965,CSE 30,A01,083084,Eldon; John,4,0,80,76
1657149706965,CSE 30,B01,095061,Bhaskar; Nishant,7,0,50,43
1657149712988,CSE 100,A01,083659,Cao; Yingjun,4,4,70,66
1657149719011,CSE 134B,A01,083661,Powell; Thomas Allan,20,0,100,80
1657149725038,CSE 140,A01,083663,Gungor; Onat,13,0,85,72
1657149731064,CSE 140L,A01,083088,Eldon; John,17,0,100,83
1657149737087,CSE 175,A01,083665,Kumar; Rakesh,3,0,25,22
1657149743109,CSE 190,A00,092507,Dubnov; Shlomo,7,0,20,13
1657149749131,ECE 45,A01,083139,Congero; Spencer William,5,0,75,70
1657149755154,ECE 65,A50,083695,Saad; Andrew S,12,0,30,18
1657149755154,ECE 65,A51,095125,Saad; Andrew S,25,0,26,1
1657149761175,ECE 109,A01,091882,Touri; Behrouz,18,0,70,52
1657149767201,ECE 180,A00,083140,Abi Samra; Nicholas Camill,1,0,30,29
1657149767201,ECE 180,B00,083141,Abi Samra; Nicholas Camill,0,0,30,30
1657149773225,MATH 10A,A01,083735,Patchell; Gregory David,2,0,30,28
1657149773225,MATH 10A,A02,083736,Patchell; Gregory David,20,0,30,10
1657149773225,MATH 10A,A03,083737,Patchell; Gregory David,16,0,30,14
1657149779253,MATH 10B,A01,083207,Lim; Seonhee,7,0,34,27
1657149779253,MATH 10B,A02,083208,Lim; Seonhee,9,0,35,26
1657149779253,MATH 10B,A03,093472,Lim; Seonhee,5,0,34,29
1657149779253,MATH 10B,B01,083739,Sinha; Shubham,9,0,30,21
1657149785284,MATH 18,A01,083743,Cinel; Cameron Alexander,6,0,30,24
1657149785284,MATH 18,A02,083744,Cinel; Cameron Alexander,15,0,30,15
1657149785284,MATH 18,A03,083745,Cinel; Cameron Alexander,8,0,30,22
1657149785284,MATH 18,B01,083748,Rideout; David Porter,4,0,37,33
1657149785284,MATH 18,B02,083749,Rideout; David Porter,3,0,36,33
1657149785284,MATH 18,B03,083750,Rideout; David Porter,2,0,37,35
1657149785284,MATH 18,B04,083751,Rideout; David Porter,5,0,36,31
1657149785284,MATH 18,B05,093473,Rideout; David Porter,5,0,36,31
1657149785284,MATH 18,B06,093474,Rideout; David Porter,5,0,36,31
1657149791312,MATH 20A,A01,083754,Zheng; Zequn,12,0,40,28
1657149797405,MATH 20B,A01,083756,Briones; Jor-el Thomas Caparas,1,0,36,35
1657149797405,MATH 20B,A02,083757,Briones; Jor-el Thomas Caparas,1,0,36,35
1657149797405,MATH 20B,A03,093475,Briones; Jor-el Thomas Caparas,1,0,36,35
1657149803429,MATH 20C,A01,083760,Briones; Jor-el Thomas Caparas,1,0,35,34
1657149803429,MATH 20C,A02,083761,Briones; Jor-el Thomas Caparas,8,0,35,27
1657149803429,MATH 20C,A03,093476,Briones; Jor-el Thomas Caparas,0,1,36,36
1657149803429,MATH 20C,B01,083762,Bach; Quang Tran,1,0,30,29
1657149809458,MATH 20D,A01,083765,Tran; Brian Kha,4,0,30,26
1657149809458,MATH 20D,A02,083766,Tran; Brian Kha,5,0,30,25
1657149809458,MATH 20D,A03,083767,Tran; Brian Kha,3,0,30,27
1657149815487,MATH 20E,A01,083771,Ganguly; Soumya,7,0,32,25
1657149815487,MATH 20E,A02,083772,Ganguly; Soumya,7,0,32,25
1657149815487,MATH 20E,B01,083773,Ciotti; Benjamin,19,0,35,16
1657149815487,MATH 20E,B02,083774,Ciotti; Benjamin,17,0,35,18
1657149821511,MATH 103A,A01,083777,Greenfeld; Be'Eri,2,0,36,34
1657149821511,MATH 103A,A02,083778,Greenfeld; Be'Eri,5,0,36,31
1657149821511,MATH 103A,A03,093561,Greenfeld; Be'Eri,4,0,36,32
1657149821511,MATH 103A,B01,083779,Greenfeld; Be'Eri,6,0,36,30
1657149821511,MATH 103A,B02,083780,Greenfeld; Be'Eri,3,0,36,33
1657149821511,MATH 103A,B03,093562,Greenfeld; Be'Eri,3,0,36,33
1657149827538,MATH 105,A01,085443,Carter; Anne Toulson,14,0,35,21
1657149827538,MATH 105,A02,093477,Carter; Anne Toulson,20,0,35,15
1657149833561,MATH 109,A01,083213,Ganzberger; Geoffrey Michael,2,0,34,32
1657149833561,MATH 109,A02,083214,Ganzberger; Geoffrey Michael,3,0,34,31
1657149833561,MATH 109,A03,093478,Ganzberger; Geoffrey Michael,1,0,34,33
1657149833561,MATH 109,B01,083215,Ganzberger; Geoffrey Michael,1,0,32,31
1657149833561,MATH 109,B02,083216,Ganzberger; Geoffrey Michael,1,0,32,31
1657149833561,MATH 109,B03,093479,Ganzberger; Geoffrey Michael,6,0,32,26
1657149839589,MATH 142A,A01,083219,Chow; Bennett,6,0,32,26
1657149839589,MATH 142A,A02,083220,Chow; Bennett,10,0,32,22
1657149839589,MATH 142A,A03,093480,Chow; Bennett,7,0,32,25
1657149839589,MATH 142A,B03,093481,Chow; Bennett,8,0,32,24
1657149839589,MATH 142A,B04,093558,Chow; Bennett,11,0,32,21
1657149839589,MATH 142A,B05,093559,Chow; Bennett,6,0,32,26
1657149845624,MATH 193A,A01,083224,Rotar; Vladimir,7,0,34,27
1657149845624,MATH 193A,A02,083225,Rotar; Vladimir,5,0,34,29
1657149845624,MATH 193A,A03,083781,Rotar; Vladimir,1,0,34,33
1657149845624,MATH 193A,A04,083782,Rotar; Vladimir,8,0,34,26
1657149845624,MATH 193A,A05,093482,Rotar; Vladimir,6,0,34,28
1657149851654,MATH 197,001,091859,McAuley; Julian John,9999,0,9999,0
1657149851654,MATH 197,002,095566,Kedlaya; Kiran S.,9997,0,9999,2
1657149851654,MATH 197,003,095567,Xiao; Ming,9999,0,9999,0
1657149851654,MATH 197,004,095571,Perols; Johan Lars,9998,0,9999,1
1657149858713,COGS 9,A01,083615,Shannon; Kyle Michael,7,0,75,68
1657149864740,COGS 11,A01,083617,Boyle; Mary E. T.,22,0,48,26
1657149870767,COGS 13,A01,083071,Bastos; Amalia Pinkusfeld,9,0,71,62
1657149876790,COGS 14A,A01,092681,Semenuks; Arturs,1,1,100,99
1657149882817,COGS 14B,A01,083073,Cheng; Tzu-Han,6,0,63,57
1657149888861,COGS 17,A01,092677,Semenuks; Arturs,4,0,81,77
1657149894889,COGS 100,A01,083619,Allen; Michael Gordon,15,0,70,55
1657149900912,COGS 101A,A01,083621,Davis; Joshua Daniel,9,0,68,59
1657149906951,COGS 101B,A01,091572,Allen; Michael Gordon,9,0,65,56
1657149912975,COGS 101C,A01,083625,Delgado; Tania,17,0,35,18
1657149919009,COGS 107A,A01,083627,Boyle; Mary E. T.,13,0,60,47
1657149925032,COGS 118A,A01,083075,Gupta; Anjum,15,0,76,61
1657149931063,CSE 3,A50,083646,Miranda; Gregory Joseph,24,0,50,26
1657149937090,CSE 8A,A50,083650,Miranda; Gregory Joseph,17,1,56,39
1657149943115,CSE 11,A01,083080,Cao; Yingjun,5,15,40,35
1657149949137,CSE 12,A01,083652,Krause-Levy; Sophia Louisa,24,1,120,96
1657149955164,CSE 15L,A01,083654,Morris; Justin Loren,9,0,50,41
1657149955164,CSE 15L,A02,083655,Morris; Justin Loren,9,0,50,41
1657149961188,CSE 20,A01,083657,Tran; Khoa Dang,38,0,80,42
1657149967212,CSE 21,A01,095574,Bach; Quang Tran,22,0,48,26
1657149973236,CSE 30,A01,083084,Eldon; John,4,0,80,76
1657149973236,CSE 30,B01,095061,Bhaskar; Nishant,7,0,50,43
1657149979260,CSE 100,A01,083659,Cao; Yingjun,4,4,70,66
1657149985284,CSE 134B,A01,083661,Powell; Thomas Allan,20,0,100,80
1657149991307,CSE 140,A01,083663,Gungor; Onat,13,0,85,72
1657149997333,CSE 140L,A01,083088,Eldon; John,17,0,100,83
1657150003364,CSE 175,A01,083665,Kumar; Rakesh,3,0,25,22
1657150009392,CSE 190,A00,092507,Dubnov; Shlomo,7,0,20,13
1657150015419,ECE 45,A01,083139,Congero; Spencer William,5,0,75,70
1657150021443,ECE 65,A50,083695,Saad; Andrew S,12,0,30,18
1657150021443,ECE 65,A51,095125,Saad; Andrew S,25,0,26,1
1657150027466,ECE 109,A01,091882,Touri; Behrouz,18,0,70,52
1657150033499,ECE 180,A00,083140,Abi Samra; Nicholas Camill,1,0,30,29
1657150033499,ECE 180,B00,083141,Abi Samra; Nicholas Camill,0,0,30,30
1657150039522,MATH 10A,A01,083735,Patchell; Gregory David,2,0,30,28
1657150039522,MATH 10A,A02,083736,Patchell; Gregory David,20,0,30,10
1657150039522,MATH 10A,A03,083737,Patchell; Gregory David,16,0,30,14
1657150045551,MATH 10B,A01,083207,Lim; Seonhee,7,0,34,27
1657150045551,MATH 10B,A02,083208,Lim; Seonhee,9,0,35,26
1657150045551,MATH 10B,A03,093472,Lim; Seonhee,5,0,34,29
1657150045551,MATH 10B,B01,083739,Sinha; Shubham,9,0,30,21
1657150051583,MATH 18,A01,083743,Cinel; Cameron Alexander,6,0,30,24
1657150051583,MATH 18,A02,083744,Cinel; Cameron Alexander,15,0,30,15
1657150051583,MATH 18,A03,083745,Cinel; Cameron Alexander,8,0,30,22
1657150051583,MATH 18,B01,083748,Rideout; David Porter,4,0,37,33
1657150051583,MATH 18,B02,083749,Rideout; David Porter,3,0,36,33
1657150051583,MATH 18,B03,083750,Rideout; David Porter,2,0,37,35
1657150051583,MATH 18,B04,083751,Rideout; David Porter,5,0,36,31
1657150051583,MATH 18,B05,093473,Rideout; David Porter,5,0,36,31
1657150051583,MATH 18,B06,093474,Rideout; David Porter,5,0,36,31
1657150057605,MATH 20A,A01,083754,Zheng; Zequn,12,0,40,28
1657150063632,MATH 20B,A01,083756,Briones; Jor-el Thomas Caparas,1,0,36,35
1657150063632,MATH 20B,A02,083757,Briones; Jor-el Thomas Caparas,1,0,36,35
1657150063632,MATH 20B,A03,093475,Briones; Jor-el Thomas Caparas,1,0,36,35
1657150069658,MATH 20C,A01,083760,Briones; Jor-el Thomas Caparas,1,0,35,34
1657150069658,MATH 20C,A02,083761,Briones; Jor-el Thomas Caparas,8,0,35,27
1657150069658,MATH 20C,A03,093476,Briones; Jor-el Thomas Caparas,0,1,36,36
1657150069658,MATH 20C,B01,083762,Bach; Quang Tran,1,0,30,29
1657150075702,MATH 20D,A01,083765,Tran; Brian Kha,4,0,30,26
1657150075702,MATH 20D,A02,083766,Tran; Brian Kha,5,0,30,25
1657150075702,MATH 20D,A03,083767,Tran; Brian Kha,3,0,30,27
1657150081728,MATH 20E,A01,083771,Ganguly; Soumya,7,0,32,25
1657150081728,MATH 20E,A02,083772,Ganguly; Soumya,7,0,32,25
1657150081728,MATH 20E,B01,083773,Ciotti; Benjamin,19,0,35,16
1657150081728,MATH 20E,B02,083774,Ciotti; Benjamin,17,0,35,18
1657150087757,MATH 103A,A01,083777,Greenfeld; Be'Eri,2,0,36,34
1657150087757,MATH 103A,A02,083778,Greenfeld; Be'Eri,5,0,36,31
1657150087757,MATH 103A,A03,093561,Greenfeld; Be'Eri,4,0,36,32
1657150087757,MATH 103A,B01,083779,Greenfeld; Be'Eri,6,0,36,30
1657150087757,MATH 103A,B02,083780,Greenfeld; Be'Eri,3,0,36,33
1657150087757,MATH 103A,B03,093562,Greenfeld; Be'Eri,3,0,36,33
1657150093784,MATH 105,A01,085443,Carter; Anne Toulson,14,0,35,21
1657150093784,MATH 105,A02,093477,Carter; Anne Toulson,20,0,35,15
1657150099806,MATH 109,A01,083213,Ganzberger; Geoffrey Michael,2,0,34,32
1657150099806,MATH 109,A02,083214,Ganzberger; Geoffrey Michael,3,0,34,31
1657150099806,MATH 109,A03,093478,Ganzberger; Geoffrey Michael,1,0,34,33
1657150099806,MATH 109,B01,083215,Ganzberger; Geoffrey Michael,1,0,32,31
1657150099806,MATH 109,B02,083216,Ganzberger; Geoffrey Michael,1,0,32,31
1657150099806,MATH 109,B03,093479,Ganzberger; Geoffrey Michael,6,0,32,26
1657150105837,MATH 142A,A01,083219,Chow; Bennett,6,0,32,26
1657150105837,MATH 142A,A02,083220,Chow; Bennett,10,0,32,22
1657150105837,MATH 142A,A03,093480,Chow; Bennett,7,0,32,25
1657150105837,MATH 142A,B03,093481,Chow; Bennett,8,0,32,24
1657150105837,MATH 142A,B04,093558,Chow; Bennett,11,0,32,21
1657150105837,MATH 142A,B05,093559,Chow; Bennett,6,0,32,26
1657150111874,MATH 193A,A01,083224,Rotar; Vladimir,7,0,34,27
1657150111874,MATH 193A,A02,083225,Rotar; Vladimir,5,0,34,29
1657150111874,MATH 193A,A03,083781,Rotar; Vladimir,1,0,34,33
1657150111874,MATH 193A,A04,083782,Rotar; Vladimir,8,0,34,26
1657150111874,MATH 193A,A05,093482,Rotar; Vladimir,6,0,34,28
1657150117914,MATH 197,001,091859,McAuley; Julian John,9999,0,9999,0
1657150117914,MATH 197,002,095566,Kedlaya; Kiran S.,9997,0,9999,2
1657150117914,MATH 197,003,095567,Xiao; Ming,9999,0,9999,0
1657150117914,MATH 197,004,095571,Perols; Johan Lars,9998,0,9999,1
1657150124979,COGS 9,A01,083615,Shannon; Kyle Michael,7,0,75,68
1657150131002,COGS 11,A01,083617,Boyle; Mary E. T.,22,0,48,26
1657150137026,COGS 13,A01,083071,Bastos; Amalia Pinkusfeld,9,0,71,62
1657150143050,COGS 14A,A01,092681,Semenuks; Arturs,1,1,100,99
1657150149088,COGS 14B,A01,083073,Cheng; Tzu-Han,6,0,63,57
1657150155110,COGS 17,A01,092677,Semenuks; Arturs,4,0,81,77
1657150161136,COGS 100,A01,083619,Allen; Michael Gordon,15,0,70,55
1657150167167,COGS 101A,A01,083621,Davis; Joshua Daniel,9,0,68,59
1657150173194,COGS 101B,A01,091572,Allen; Michael Gordon,9,0,65,56
1657150179217,COGS 101C,A01,083625,Delgado; Tania,17,0,35,18
1657150185240,COGS 107A,A01,083627,Boyle; Mary E. T.,13,0,60,47
1657150191267,COGS 118A,A01,083075,Gupta; Anjum,15,0,76,61
1657150197302,CSE 3,A50,083646,Miranda; Gregory Joseph,24,0,50,26
1657150203324,CSE 8A,A50,083650,Miranda; Gregory Joseph,17,1,56,39
1657150209349,CSE 11,A01,083080,Cao; Yingjun,5,15,40,35
1657150215382,CSE 12,A01,083652,Krause-Levy; Sophia Louisa,24,1,120,96
1657150221416,CSE 15L,A01,083654,Morris; Justin Loren,9,0,50,41
1657150221416,CSE 15L,A02,083655,Morris; Justin Loren,9,0,50,41
1657150227445,CSE 20,A01,083657,Tran; Khoa Dang,38,0,80,42
1657150233468,CSE 21,A01,095574,Bach; Quang Tran,22,0,48,26
1657150239495,CSE 30,A01,083084,Eldon; John,4,0,80,76
1657150239495,CSE 30,B01,095061,Bhaskar; Nishant,7,0,50,43
1657150245519,CSE 100,A01,083659,Cao; Yingjun,4,4,70,66
1657150251541,CSE 134B,A01,083661,Powell; Thomas Allan,20,0,100,80
1657150257562,CSE 140,A01,083663,Gungor; Onat,13,0,85,72
1657150263585,CSE 140L,A01,083088,Eldon; John,17,0,100,83
1657150269607,CSE 175,A01,083665,Kumar; Rakesh,3,0,25,22
1657150275646,CSE 190,A00,092507,Dubnov; Shlomo,7,0,20,13
1657150281676,ECE 45,A01,083139,Congero; Spencer William,5,0,75,70
1657150287703,ECE 65,A50,083695,Saad; Andrew S,12,0,30,18
1657150287703,ECE 65,A51,095125,Saad; Andrew S,25,0,26,1
1657150293726,ECE 109,A01,091882,Touri; Behrouz,18,0,70,52
1657150299750,ECE 180,A00,083140,Abi Samra; Nicholas Camill,1,0,30,29
1657150299750,ECE 180,B00,083141,Abi Samra; Nicholas Camill,0,0,30,30
1657150305780,MATH 10A,A01,083735,Patchell; Gregory David,2,0,30,28
1657150305780,MATH 10A,A02,083736,Patchell; Gregory David,20,0,30,10
1657150305780,MATH 10A,A03,083737,Patchell; Gregory David,16,0,30,14
1657150311813,MATH 10B,A01,083207,Lim; Seonhee,7,0,34,27
1657150311813,MATH 10B,A02,083208,Lim; Seonhee,9,0,35,26
1657150311813,MATH 10B,A03,093472,Lim; Seonhee,5,0,34,29
1657150311813,MATH 10B,B01,083739,Sinha; Shubham,9,0,30,21
1657150317849,MATH 18,A01,083743,Cinel; Cameron Alexander,6,0,30,24
1657150317849,MATH 18,A02,083744,Cinel; Cameron Alexander,15,0,30,15
1657150317849,MATH 18,A03,083745,Cinel; Cameron Alexander,8,0,30,22
1657150317849,MATH 18,B01,083748,Rideout; David Porter,4,0,37,33
1657150317849,MATH 18,B02,083749,Rideout; David Porter,3,0,36,33
1657150317849,MATH 18,B03,083750,Rideout; David Porter,2,0,37,35
1657150317849,MATH 18,B04,083751,Rideout; David Porter,5,0,36,31
1657150317849,MATH 18,B05,093473,Rideout; David Porter,5,0,36,31
1657150317849,MATH 18,B06,093474,Rideout; David Porter,5,0,36,31
1657150323876,MATH 20A,A01,083754,Zheng; Zequn,12,0,40,28
1657150329899,MATH 20B,A01,083756,Briones; Jor-el Thomas Caparas,1,0,36,35
1657150329899,MATH 20B,A02,083757,Briones; Jor-el Thomas Caparas,1,0,36,35
1657150329899,MATH 20B,A03,093475,Briones; Jor-el Thomas Caparas,1,0,36,35
1657150335922,MATH 20C,A01,083760,Briones; Jor-el Thomas Caparas,1,0,35,34
1657150335922,MATH 20C,A02,083761,Briones; Jor-el Thomas Caparas,8,0,35,27
1657150335922,MATH 20C,A03,093476,Briones; Jor-el Thomas Caparas,0,1,36,36
1657150335922,MATH 20C,B01,083762,Bach; Quang Tran,1,0,30,29
1657150341946,MATH 20D,A01,083765,Tran; Brian Kha,4,0,30,26
1657150341946,MATH 20D,A02,083766,Tran; Brian Kha,5,0,30,25
1657150341946,MATH 20D,A03,083767,Tran; Brian Kha,3,0,30,27
1657150347971,MATH 20E,A01,083771,Ganguly; Soumya,7,0,32,25
1657150347971,MATH 20E,A02,083772,Ganguly; Soumya,7,0,32,25
1657150347971,MATH 20E,B01,083773,Ciotti; Benjamin,19,0,35,16
1657150347971,MATH 20E,B02,083774,Ciotti; Benjamin,17,0,35,18
1657150354000,MATH 103A,A01,083777,Greenfeld; Be'Eri,2,0,36,34
1657150354000,MATH 103A,A02,083778,Greenfeld; Be'Eri,5,0,36,31
1657150354000,MATH 103A,A03,093561,Greenfeld; Be'Eri,4,0,36,32
1657150354000,MATH 103A,B01,083779,Greenfeld; Be'Eri,6,0,36,30
1657150354000,MATH 103A,B02,083780,Greenfeld; Be'Eri,3,0,36,33
1657150354000,MATH 103A,B03,093562,Greenfeld; Be'Eri,3,0,36,33
1657150360028,MATH 105,A01,085443,Carter; Anne Toulson,14,0,35,21
1657150360028,MATH 105,A02,093477,Carter; Anne Toulson,20,0,35,15
1657150366058,MATH 109,A01,083213,Ganzberger; Geoffrey Michael,2,0,34,32
1657150366058,MATH 109,A02,083214,Ganzberger; Geoffrey Michael,3,0,34,31
1657150366058,MATH 109,A03,093478,Ganzberger; Geoffrey Michael,1,0,34,33
1657150366058,MATH 109,B01,083215,Ganzberger; Geoffrey Michael,1,0,32,31
1657150366058,MATH 109,B02,083216,Ganzberger; Geoffrey Michael,1,0,32,31
1657150366058,MATH 109,B03,093479,Ganzberger; Geoffrey Michael,6,0,32,26
1657150372087,MATH 142A,A01,083219,Chow; Bennett,6,0,32,26
1657150372087,MATH 142A,A02,083220,Chow; Bennett,10,0,32,22
1657150372087,MATH 142A,A03,093480,Chow; Bennett,7,0,32,25
1657150372087,MATH 142A,B03,093481,Chow; Bennett,8,0,32,24
1657150372087,MATH 142A,B04,093558,Chow; Bennett,11,0,32,21
1657150372087,MATH 142A,B05,093559,Chow; Bennett,6,0,32,26
1657150378120,MATH 193A,A01,083224,Rotar; Vladimir,7,0,34,27
1657150378120,MATH 193A,A02,083225,Rotar; Vladimir,5,0,34,29
1657150378120,MATH 193A,A03,083781,Rotar; Vladimir,1,0,34,33
1657150378120,MATH 193A,A04,083782,Rotar; Vladimir,8,0,34,26
1657150378120,MATH 193A,A05,093482,Rotar; Vladimir,6,0,34,28
1657150384143,MATH 197,001,091859,McAuley; Julian John,9999,0,9999,0
1657150384143,MATH 197,002,095566,Kedlaya; Kiran S.,9997,0,9999,2
1657150384143,MATH 197,003,095567,Xiao; Ming,9999,0,9999,0
1657150384143,MATH 197,004,095571,Perols; Johan Lars,9998,0,9999,1
1657150391282,COGS 9,A01,083615,Shannon; Kyle Michael,7,0,75,68
1657150397308,COGS 11,A01,083617,Boyle; Mary E. T.,22,0,48,26
1657150403342,COGS 13,A01,083071,Bastos; Amalia Pinkusfeld,9,0,71,62
1657150409364,COGS 14A,A01,092681,Semenuks; Arturs,1,1,100,99
1657150415391,COGS 14B,A01,083073,Cheng; Tzu-Han,6,0,63,57
1657150421423,COGS 17,A01,092677,Semenuks; Arturs,4,0,81,77
1657150427444,COGS 100,A01,083619,Allen; Michael Gordon,15,0,70,55
1657150433472,COGS 101A,A01,083621,Davis; Joshua Daniel,9,0,68,59
1657150439507,COGS 101B,A01,091572,Allen; Michael Gordon,9,0,65,56
1657150445531,COGS 101C,A01,083625,Delgado; Tania,17,0,35,18
1657150451560,COGS 107A,A01,083627,Boyle; Mary E. T.,13,0,60,47
1657150457584,COGS 118A,A01,083075,Gupta; Anjum,15,0,76,61
1657150463612,CSE 3,A50,083646,Miranda; Gregory Joseph,24,0,50,26
1657150469642,CSE 8A,A50,083650,Miranda; Gregory Joseph,17,1,56,39
1657150475664,CSE 11,A01,083080,Cao; Yingjun,5,15,40,35
1657150481688,CSE 12,A01,083652,Krause-Levy; Sophia Louisa,24,1,120,96
1657150487713,CSE 15L,A01,083654,Morris; Justin Loren,9,0,50,41
1657150487713,CSE 15L,A02,083655,Morris; Justin Loren,9,0,50,41
1657150493737,CSE 20,A01,083657,Tran; Khoa Dang,38,0,80,42
1657150499764,CSE 21,A01,095574,Bach; Quang Tran,22,0,48,26
1657150505790,CSE 30,A01,083084,Eldon; John,4,0,80,76
1657150505790,CSE 30,B01,095061,Bhaskar; Nishant,7,0,50,43
1657150511813,CSE 100,A01,083659,Cao; Yingjun,4,4,70,66
1657150517841,CSE 134B,A01,083661,Powell; Thomas Allan,20,0,100,80
1657150523869,CSE 140,A01,083663,Gungor; Onat,13,0,85,72
1657150529891,CSE 140L,A01,083088,Eldon; John,17,0,100,83
1657150535914,CSE 175,A01,083665,Kumar; Rakesh,3,0,25,22
1657150541939,CSE 190,A00,092507,Dubnov; Shlomo,7,0,20,13
1657150547965,ECE 45,A01,083139,Congero; Spencer William,5,0,75,70
1657150553993,ECE 65,A50,083695,Saad; Andrew S,12,0,30,18
1657150553993,ECE 65,A51,095125,Saad; Andrew S,25,0,26,1
1657150560015,ECE 109,A01,091882,Touri; Behrouz,18,0,70,52
1657150566039,ECE 180,A00,083140,Abi Samra; Nicholas Camill,1,0,30,29
1657150566039,ECE 180,B00,083141,Abi Samra; Nicholas Camill,0,0,30,30
1657150572063,MATH 10A,A01,083735,Patchell; Gregory David,2,0,30,28
1657150572063,MATH 10A,A02,083736,Patchell; Gregory David,20,0,30,10
1657150572063,MATH 10A,A03,083737,Patchell; Gregory David,16,0,30,14
1657150578086,MATH 10B,A01,083207,Lim; Seonhee,7,0,34,27
1657150578086,MATH 10B,A02,083208,Lim; Seonhee,9,0,35,26
1657150578086,MATH 10B,A03,093472,Lim; Seonhee,5,0,34,29
1657150578086,MATH 10B,B01,083739,Sinha; Shubham,9,0,30,21
1657150584110,MATH 18,A01,083743,Cinel; Cameron Alexander,6,0,30,24
1657150584110,MATH 18,A02,083744,Cinel; Cameron Alexander,15,0,30,15
1657150584110,MATH 18,A03,083745,Cinel; Cameron Alexander,8,0,30,22
1657150584110,MATH 18,B01,083748,Rideout; David Porter,4,0,37,33
1657150584110,MATH 18,B02,083749,Rideout; David Porter,3,0,36,33
1657150584110,MATH 18,B03,083750,Rideout; David Porter,2,0,37,35
1657150584110,MATH 18,B04,083751,Rideout; David Porter,5,0,36,31
1657150584110,MATH 18,B05,093473,Rideout; David Porter,5,0,36,31
1657150584110,MATH 18,B06,093474,Rideout; David Porter,5,0,36,31
1657150590136,MATH 20A,A01,083754,Zheng; Zequn,12,0,40,28
1657150596161,MATH 20B,A01,083756,Briones; Jor-el Thomas Caparas,1,0,36,35
1657150596161,MATH 20B,A02,083757,Briones; Jor-el Thomas Caparas,1,0,36,35
1657150596161,MATH 20B,A03,093475,Briones; Jor-el Thomas Caparas,1,0,36,35
1657150602182,MATH 20C,A01,083760,Briones; Jor-el Thomas Caparas,1,0,35,34
1657150602182,MATH 20C,A02,083761,Briones; Jor-el Thomas Caparas,8,0,35,27
1657150602182,MATH 20C,A03,093476,Briones; Jor-el Thomas Caparas,0,1,36,36
1657150602182,MATH 20C,B01,083762,Bach; Quang Tran,1,0,30,29
1657150608212,MATH 20D,A01,083765,Tran; Brian Kha,4,0,30,26
1657150608212,MATH 20D,A02,083766,Tran; Brian Kha,5,0,30,25
1657150608212,MATH 20D,A03,083767,Tran; Brian Kha,3,0,30,27
1657150614234,MATH 20E,A01,083771,Ganguly; Soumya,7,0,32,25
1657150614234,MATH 20E,A02,083772,Ganguly; Soumya,7,0,32,25
1657150614234,MATH 20E,B01,083773,Ciotti; Benjamin,19,0,35,16
1657150614234,MATH 20E,B02,083774,Ciotti; Benjamin,17,0,35,18
1657150620270,MATH 103A,A01,083777,Greenfeld; Be'Eri,2,0,36,34
1657150620270,MATH 103A,A02,083778,Greenfeld; Be'Eri,5,0,36,31
1657150620270,MATH 103A,A03,093561,Greenfeld; Be'Eri,4,0,36,32
1657150620270,MATH 103A,B01,083779,Greenfeld; Be'Eri,6,0,36,30
1657150620270,MATH 103A,B02,083780,Greenfeld; Be'Eri,3,0,36,33
1657150620270,MATH 103A,B03,093562,Greenfeld; Be'Eri,3,0,36,33
1657150626297,MATH 105,A01,085443,Carter; Anne Toulson,14,0,35,21
1657150626297,MATH 105,A02,093477,Carter; Anne Toulson,20,0,35,15
1657150632325,MATH 109,A01,083213,Ganzberger; Geoffrey Michael,2,0,34,32
1657150632325,MATH 109,A02,083214,Ganzberger; Geoffrey Michael,3,0,34,31
1657150632325,MATH 109,A03,093478,Ganzberger; Geoffrey Michael,1,0,34,33
1657150632325,MATH 109,B01,083215,Ganzberger; Geoffrey Michael,1,0,32,31
1657150632325,MATH 109,B02,083216,Ganzberger; Geoffrey Michael,1,0,32,31
1657150632325,MATH 109,B03,093479,Ganzberger; Geoffrey Michael,6,0,32,26
1657150638353,MATH 142A,A01,083219,Chow; Bennett,6,0,32,26
1657150638353,MATH 142A,A02,083220,Chow; Bennett,10,0,32,22
1657150638353,MATH 142A,A03,093480,Chow; Bennett,7,0,32,25
1657150638353,MATH 142A,B03,093481,Chow; Bennett,8,0,32,24
1657150638353,MATH 142A,B04,093558,Chow; Bennett,11,0,32,21
1657150638353,MATH 142A,B05,093559,Chow; Bennett,6,0,32,26
1657150644383,MATH 193A,A01,083224,Rotar; Vladimir,7,0,34,27
1657150644383,MATH 193A,A02,083225,Rotar; Vladimir,5,0,34,29
1657150644383,MATH 193A,A03,083781,Rotar; Vladimir,1,0,34,33
1657150644383,MATH 193A,A04,083782,Rotar; Vladimir,8,0,34,26
1657150644383,MATH 193A,A05,093482,Rotar; Vladimir,6,0,34,28
1657150650407,MATH 197,001,091859,McAuley; Julian John,9999,0,9999,0
1657150650407,MATH 197,002,095566,Kedlaya; Kiran S.,9997,0,9999,2
1657150650407,MATH 197,003,095567,Xiao; Ming,9999,0,9999,0
1657150650407,MATH 197,004,095571,Perols; Johan Lars,9998,0,9999,1
1657150657468,COGS 9,A01,083615,Shannon; Kyle Michael,7,0,75,68
1657150663490,COGS 11,A01,083617,Boyle; Mary E. T.,22,0,48,26
1657150669519,COGS 13,A01,083071,Bastos; Amalia Pinkusfeld,9,0,71,62
1657150675546,COGS 14A,A01,092681,Semenuks; Arturs,1,1,100,99
1657150681572,COGS 14B,A01,083073,Cheng; Tzu-Han,6,0,63,57
1657150687596,COGS 17,A01,092677,Semenuks; Arturs,4,0,81,77
1657150693619,COGS 100,A01,083619,Allen; Michael Gordon,15,0,70,55
1657150699653,COGS 101A,A01,083621,Davis; Joshua Daniel,9,0,68,59
1657150705675,COGS 101B,A01,091572,Allen; Michael Gordon,9,0,65,56
1657150711696,COGS 101C,A01,083625,Delgado; Tania,17,0,35,18
1657150717723,COGS 107A,A01,083627,Boyle; Mary E. T.,13,0,60,47
1657150723750,COGS 118A,A01,083075,Gupta; Anjum,15,0,76,61
1657150729772,CSE 3,A50,083646,Miranda; Gregory Joseph,24,0,50,26
1657150735795,CSE 8A,A50,083650,Miranda; Gregory Joseph,17,1,56,39
1657150741818,CSE 11,A01,083080,Cao; Yingjun,5,15,40,35
1657150747843,CSE 12,A01,083652,Krause-Levy; Sophia Louisa,24,1,120,96
1657150753864,CSE 15L,A01,083654,Morris; Justin Loren,9,0,50,41
1657150753864,CSE 15L,A02,083655,Morris; Justin Loren,9,0,50,41
1657150759888,CSE 20,A01,083657,Tran; Khoa Dang,38,0,80,42
1657150765916,CSE 21,A01,095574,Bach; Quang Tran,22,0,48,26
1657150771937,CSE 30,A01,083084,Eldon; John,4,0,80,76
1657150771937,CSE 30,B01,095061,Bhaskar; Nishant,7,0,50,43
1657150777959,CSE 100,A01,083659,Cao; Yingjun,4,4,70,66
1657150783983,CSE 134B,A01,083661,Powell; Thomas Allan,20,0,100,80
1657150790004,CSE 140,A01,083663,Gungor; Onat,13,0,85,72
1657150796032,CSE 140L,A01,083088,Eldon; John,17,0,100,83
1657150802054,CSE 175,A01,083665,Kumar; Rakesh,3,0,25,22
1657150808079,CSE 190,A00,092507,Dubnov; Shlomo,7,0,20,13
1657150814102,ECE 45,A01,083139,Congero; Spencer William,5,0,75,70
1657150820124,ECE 65,A50,083695,Saad; Andrew S,12,0,30,18
1657150820124,ECE 65,A51,095125,Saad; Andrew S,25,0,26,1
1657150826155,ECE 109,A01,091882,Touri; Behrouz,18,0,70,52
1657150832183,ECE 180,A00,083140,Abi Samra; Nicholas Camill,1,0,30,29
1657150832183,ECE 180,B00,083141,Abi Samra; Nicholas Camill,0,0,30,30
1657150838221,MATH 10A,A01,083735,Patchell; Gregory David,2,0,30,28
1657150838221,MATH 10A,A02,083736,Patchell; Gregory David,20,0,30,10
1657150838221,MATH 10A,A03,083737,Patchell; Gregory David,16,0,30,14
1657150844248,MATH 10B,A01,083207,Lim; Seonhee,7,0,34,27
1657150844248,MATH 10B,A02,083208,Lim; Seonhee,9,0,35,26
1657150844248,MATH 10B,A03,093472,Lim; Seonhee,5,0,34,29
1657150844248,MATH 10B,B01,083739,Sinha; Shubham,9,0,30,21
1657150850275,MATH 18,A01,083743,Cinel; Cameron Alexander,6,0,30,24
1657150850275,MATH 18,A02,083744,Cinel; Cameron Alexander,15,0,30,15
1657150850275,MATH 18,A03,083745,Cinel; Cameron Alexander,8,0,30,22
1657150850275,MATH 18,B01,083748,Rideout; David Porter,4,0,37,33
1657150850275,MATH 18,B02,083749,Rideout; David Porter,3,0,36,33
1657150850275,MATH 18,B03,083750,Rideout; David Porter,2,0,37,35
1657150850275,MATH 18,B04,083751,Rideout; David Porter,5,0,36,31
1657150850275,MATH 18,B05,093473,Rideout; David Porter,5,0,36,31
1657150850275,MATH 18,B06,093474,Rideout; David Porter,5,0,36,31
1657150856297,MATH 20A,A01,083754,Zheng; Zequn,12,0,40,28
1657150862324,MATH 20B,A01,083756,Briones; Jor-el Thomas Caparas,1,0,36,35
1657150862324,MATH 20B,A02,083757,Briones; Jor-el Thomas Caparas,1,0,36,35
1657150862324,MATH 20B,A03,093475,Briones; Jor-el Thomas Caparas,1,0,36,35
1657150868346,MATH 20C,A01,083760,Briones; Jor-el Thomas Caparas,1,0,35,34
1657150868346,MATH 20C,A02,083761,Briones; Jor-el Thomas Caparas,8,0,35,27
1657150868346,MATH 20C,A03,093476,Briones; Jor-el Thomas Caparas,0,1,36,36
1657150868346,MATH 20C,B01,083762,Bach; Quang Tran,1,0,30,29
1657150874375,MATH 20D,A01,083765,Tran; Brian Kha,4,0,30,26
1657150874375,MATH 20D,A02,083766,Tran; Brian Kha,5,0,30,25
1657150874375,MATH 20D,A03,083767,Tran; Brian Kha,3,0,30,27
1657150880404,MATH 20E,A01,083771,Ganguly; Soumya,7,0,32,25
1657150880404,MATH 20E,A02,083772,Ganguly; Soumya,7,0,32,25
1657150880404,MATH 20E,B01,083773,Ciotti; Benjamin,19,0,35,16
1657150880404,MATH 20E,B02,083774,Ciotti; Benjamin,17,0,35,18
1657150886429,MATH 103A,A01,083777,Greenfeld; Be'Eri,2,0,36,34
1657150886429,MATH 103A,A02,083778,Greenfeld; Be'Eri,5,0,36,31
1657150886429,MATH 103A,A03,093561,Greenfeld; Be'Eri,4,0,36,32
1657150886429,MATH 103A,B01,083779,Greenfeld; Be'Eri,6,0,36,30
1657150886429,MATH 103A,B02,083780,Greenfeld; Be'Eri,3,0,36,33
1657150886429,MATH 103A,B03,093562,Greenfeld; Be'Eri,3,0,36,33
1657150892456,MATH 105,A01,085443,Carter; Anne Toulson,14,0,35,21
1657150892456,MATH 105,A02,093477,Carter; Anne Toulson,20,0,35,15
1657150898479,MATH 109,A01,083213,Ganzberger; Geoffrey Michael,2,0,34,32
1657150898479,MATH 109,A02,083214,Ganzberger; Geoffrey Michael,3,0,34,31
1657150898479,MATH 109,A03,093478,Ganzberger; Geoffrey Michael,1,0,34,33
1657150898479,MATH 109,B01,083215,Ganzberger; Geoffrey Michael,1,0,32,31
1657150898479,MATH 109,B02,083216,Ganzberger; Geoffrey Michael,1,0,32,31
1657150898479,MATH 109,B03,093479,Ganzberger; Geoffrey Michael,6,0,32,26
1657150904503,MATH 142A,A01,083219,Chow; Bennett,6,0,32,26
1657150904503,MATH 142A,A02,083220,Chow; Bennett,10,0,32,22
1657150904503,MATH 142A,A03,093480,Chow; Bennett,7,0,32,25
1657150904503,MATH 142A,B03,093481,Chow; Bennett,8,0,32,24
1657150904503,MATH 142A,B04,093558,Chow; Bennett,11,0,32,21
1657150904503,MATH 142A,B05,093559,Chow; Bennett,6,0,32,26
1657150910527,MATH 193A,A01,083224,Rotar; Vladimir,7,0,34,27
1657150910527,MATH 193A,A02,083225,Rotar; Vladimir,5,0,34,29
1657150910527,MATH 193A,A03,083781,Rotar; Vladimir,1,0,34,33
1657150910527,MATH 193A,A04,083782,Rotar; Vladimir,8,0,34,26
1657150910527,MATH 193A,A05,093482,Rotar; Vladimir,6,0,34,28
1657150916555,MATH 197,001,091859,McAuley; Julian John,9999,0,9999,0
1657150916555,MATH 197,002,095566,Kedlaya; Kiran S.,9997,0,9999,2
1657150916555,MATH 197,003,095567,Xiao; Ming,9999,0,9999,0
1657150916555,MATH 197,004,095571,Perols; Johan Lars,9998,0,9999,1
1657150923608,COGS 9,A01,083615,Shannon; Kyle Michael,7,0,75,68
1657150929632,COGS 11,A01,083617,Boyle; Mary E. T.,22,0,48,26
1657150935656,COGS 13,A01,083071,Bastos; Amalia Pinkusfeld,9,0,71,62
1657150941680,COGS 14A,A01,092681,Semenuks; Arturs,1,1,100,99
1657150947704,COGS 14B,A01,083073,Cheng; Tzu-Han,6,0,63,57
1657150953731,COGS 17,A01,092677,Semenuks; Arturs,4,0,81,77
1657150959760,COGS 100,A01,083619,Allen; Michael Gordon,15,0,70,55
1657150965786,COGS 101A,A01,083621,Davis; Joshua Daniel,9,0,68,59
1657150971811,COGS 101B,A01,091572,Allen; Michael Gordon,9,0,65,56
1657150977833,COGS 101C,A01,083625,Delgado; Tania,17,0,35,18
1657150983862,COGS 107A,A01,083627,Boyle; Mary E. T.,13,0,60,47
1657150989959,COGS 118A,A01,083075,Gupta; Anjum,15,0,76,61
1657150995985,CSE 3,A50,083646,Miranda; Gregory Joseph,24,0,50,26
1657151002011,CSE 8A,A50,083650,Miranda; Gregory Joseph,17,1,56,39
1657151008035,CSE 11,A01,083080,Cao; Yingjun,5,15,40,35
1657151014061,CSE 12,A01,083652,Krause-Levy; Sophia Louisa,24,1,120,96
1657151020085,CSE 15L,A01,083654,Morris; Justin Loren,9,0,50,41
1657151020085,CSE 15L,A02,083655,Morris; Justin Loren,9,0,50,41
1657151026124,CSE 20,A01,083657,Tran; Khoa Dang,38,0,80,42
1657151032154,CSE 21,A01,095574,Bach; Quang Tran,22,0,48,26
1657151038180,CSE 30,A01,083084,Eldon; John,4,0,80,76
1657151038180,CSE 30,B01,095061,Bhaskar; Nishant,7,0,50,43
1657151044203,CSE 100,A01,083659,Cao; Yingjun,4,4,70,66
1657151050231,CSE 134B,A01,083661,Powell; Thomas Allan,20,0,100,80
1657151056267,CSE 140,A01,083663,Gungor; Onat,13,0,85,72
1657151062295,CSE 140L,A01,083088,Eldon; John,17,0,100,83
1657151068317,CSE 175,A01,083665,Kumar; Rakesh,3,0,25,22
1657151074342,CSE 190,A00,092507,Dubnov; Shlomo,7,0,20,13
1657151080368,ECE 45,A01,083139,Congero; Spencer William,5,0,75,70
1657151086392,ECE 65,A50,083695,Saad; Andrew S,12,0,30,18
1657151086392,ECE 65,A51,095125,Saad; Andrew S,25,0,26,1
1657151092418,ECE 109,A01,091882,Touri; Behrouz,18,0,70,52
1657151098452,ECE 180,A00,083140,Abi Samra; Nicholas Camill,1,0,30,29
1657151098452,ECE 180,B00,083141,Abi Samra; Nicholas Camill,0,0,30,30
1657151104493,MATH 10A,A01,083735,Patchell; Gregory David,2,0,30,28
1657151104493,MATH 10A,A02,083736,Patchell; Gregory David,20,0,30,10
1657151104493,MATH 10A,A03,083737,Patchell; Gregory David,16,0,30,14
1657151110516,MATH 10B,A01,083207,Lim; Seonhee,7,0,34,27
1657151110516,MATH 10B,A02,083208,Lim; Seonhee,9,0,35,26
1657151110516,MATH 10B,A03,093472,Lim; Seonhee,5,0,34,29
1657151110516,MATH 10B,B01,083739,Sinha; Shubham,9,0,30,21
1657151116547,MATH 18,A01,083743,Cinel; Cameron Alexander,6,0,30,24
1657151116547,MATH 18,A02,083744,Cinel; Cameron Alexander,15,0,30,15
1657151116547,MATH 18,A03,083745,Cinel; Cameron Alexander,8,0,30,22
1657151116547,MATH 18,B01,083748,Rideout; David Porter,4,0,37,33
1657151116547,MATH 18,B02,083749,Rideout; David Porter,3,0,36,33
1657151116547,MATH 18,B03,083750,Rideout; David Porter,2,0,37,35
1657151116547,MATH 18,B04,083751,Rideout; David Porter,5,0,36,31
1657151116547,MATH 18,B05,093473,Rideout; David Porter,5,0,36,31
1657151116547,MATH 18,B06,093474,Rideout; David Porter,5,0,36,31
1657151122577,MATH 20A,A01,083754,Zheng; Zequn,12,0,40,28
1657151128604,MATH 20B,A01,083756,Briones; Jor-el Thomas Caparas,1,0,36,35
1657151128604,MATH 20B,A02,083757,Briones; Jor-el Thomas Caparas,1,0,36,35
1657151128604,MATH 20B,A03,093475,Briones; Jor-el Thomas Caparas,1,0,36,35
1657151134627,MATH 20C,A01,083760,Briones; Jor-el Thomas Caparas,1,0,35,34
1657151134627,MATH 20C,A02,083761,Briones; Jor-el Thomas Caparas,8,0,35,27
1657151134627,MATH 20C,A03,093476,Briones; Jor-el Thomas Caparas,0,1,36,36
1657151134627,MATH 20C,B01,083762,Bach; Quang Tran,1,0,30,29
1657151140652,MATH 20D,A01,083765,Tran; Brian Kha,4,0,30,26
1657151140652,MATH 20D,A02,083766,Tran; Brian Kha,5,0,30,25
1657151140652,MATH 20D,A03,083767,Tran; Brian Kha,3,0,30,27
1657151146674,MATH 20E,A01,083771,Ganguly; Soumya,7,0,32,25
1657151146674,MATH 20E,A02,083772,Ganguly; Soumya,7,0,32,25
1657151146674,MATH 20E,B01,083773,Ciotti; Benjamin,19,0,35,16
1657151146674,MATH 20E,B02,083774,Ciotti; Benjamin,17,0,35,18
1657151152696,MATH 103A,A01,083777,Greenfeld; Be'Eri,2,0,36,34
1657151152696,MATH 103A,A02,083778,Greenfeld; Be'Eri,5,0,36,31
1657151152696,MATH 103A,A03,093561,Greenfeld; Be'Eri,4,0,36,32
1657151152696,MATH 103A,B01,083779,Greenfeld; Be'Eri,6,0,36,30
1657151152696,MATH 103A,B02,083780,Greenfeld; Be'Eri,3,0,36,33
1657151152696,MATH 103A,B03,093562,Greenfeld; Be'Eri,3,0,36,33
1657151158728,MATH 105,A01,085443,Carter; Anne Toulson,14,0,35,21
1657151158728,MATH 105,A02,093477,Carter; Anne Toulson,20,0,35,15
1657151164755,MATH 109,A01,083213,Ganzberger; Geoffrey Michael,2,0,34,32
1657151164755,MATH 109,A02,083214,Ganzberger; Geoffrey Michael,3,0,34,31
1657151164755,MATH 109,A03,093478,Ganzberger; Geoffrey Michael,1,0,34,33
1657151164755,MATH 109,B01,083215,Ganzberger; Geoffrey Michael,1,0,32,31
1657151164755,MATH 109,B02,083216,Ganzberger; Geoffrey Michael,1,0,32,31
1657151164755,MATH 109,B03,093479,Ganzberger; Geoffrey Michael,6,0,32,26
1657151170783,MATH 142A,A01,083219,Chow; Bennett,6,0,32,26
1657151170783,MATH 142A,A02,083220,Chow; Bennett,10,0,32,22
1657151170783,MATH 142A,A03,093480,Chow; Bennett,7,0,32,25
1657151170783,MATH 142A,B03,093481,Chow; Bennett,8,0,32,24
1657151170783,MATH 142A,B04,093558,Chow; Bennett,11,0,32,21
1657151170783,MATH 142A,B05,093559,Chow; Bennett,6,0,32,26
1657151176815,MATH 193A,A01,083224,Rotar; Vladimir,7,0,34,27
1657151176815,MATH 193A,A02,083225,Rotar; Vladimir,5,0,34,29
1657151176815,MATH 193A,A03,083781,Rotar; Vladimir,1,0,34,33
1657151176815,MATH 193A,A04,083782,Rotar; Vladimir,8,0,34,26
1657151176815,MATH 193A,A05,093482,Rotar; Vladimir,6,0,34,28
1657151182839,MATH 197,001,091859,McAuley; Julian John,9999,0,9999,0
1657151182839,MATH 197,002,095566,Kedlaya; Kiran S.,9997,0,9999,2
1657151182839,MATH 197,003,095567,Xiao; Ming,9999,0,9999,0
1657151182839,MATH 197,004,095571,Perols; Johan Lars,9998,0,9999,1
1657151189903,COGS 9,A01,083615,Shannon; Kyle Michael,7,0,75,68
1657151195929,COGS 11,A01,083617,Boyle; Mary E. T.,22,0,48,26
1657151201953,COGS 13,A01,083071,Bastos; Amalia Pinkusfeld,9,0,71,62
1657151207979,COGS 14A,A01,092681,Semenuks; Arturs,1,1,100,99
1657151214004,COGS 14B,A01,083073,Cheng; Tzu-Han,6,0,63,57
1657151220029,COGS 17,A01,092677,Semenuks; Arturs,4,0,81,77
1657151226060,COGS 100,A01,083619,Allen; Michael Gordon,15,0,70,55
1657151232090,COGS 101A,A01,083621,Davis; Joshua Daniel,9,0,68,59
1657151238118,COGS 101B,A01,091572,Allen; Michael Gordon,9,0,65,56
1657151244150,COGS 101C,A01,083625,Delgado; Tania,17,0,35,18
1657151250181,COGS 107A,A01,083627,Boyle; Mary E. T.,13,0,60,47
1657151256205,COGS 118A,A01,083075,Gupta; Anjum,15,0,76,61
1657151262241,CSE 3,A50,083646,Miranda; Gregory Joseph,24,0,50,26
1657151268267,CSE 8A,A50,083650,Miranda; Gregory Joseph,17,1,56,39
1657151274293,CSE 11,A01,083080,Cao; Yingjun,5,15,40,35
1657151280316,CSE 12,A01,083652,Krause-Levy; Sophia Louisa,24,1,120,96
1657151286344,CSE 15L,A01,083654,Morris; Justin Loren,9,0,50,41
1657151286344,CSE 15L,A02,083655,Morris; Justin Loren,9,0,50,41
1657151292367,CSE 20,A01,083657,Tran; Khoa Dang,38,0,80,42
1657151298395,CSE 21,A01,095574,Bach; Quang Tran,22,0,48,26
1657151304418,CSE 30,A01,083084,Eldon; John,4,0,80,76
1657151304418,CSE 30,B01,095061,Bhaskar; Nishant,7,0,50,43
1657151310442,CSE 100,A01,083659,Cao; Yingjun,4,4,70,66
1657151316471,CSE 134B,A01,083661,Powell; Thomas Allan,20,0,100,80
1657151322496,CSE 140,A01,083663,Gungor; Onat,13,0,85,72
1657151328519,CSE 140L,A01,083088,Eldon; John,17,0,100,83
1657151334541,CSE 175,A01,083665,Kumar; Rakesh,3,0,25,22
1657151340564,CSE 190,A00,092507,Dubnov; Shlomo,7,0,20,13
1657151346587,ECE 45,A01,083139,Congero; Spencer William,5,0,75,70
1657151352611,ECE 65,A50,083695,Saad; Andrew S,12,0,30,18
1657151352611,ECE 65,A51,095125,Saad; Andrew S,25,0,26,1
1657151358643,ECE 109,A01,091882,Touri; Behrouz,18,0,70,52
1657151364664,ECE 180,A00,083140,Abi Samra; Nicholas Camill,1,0,30,29
1657151364664,ECE 180,B00,083141,Abi Samra; Nicholas Camill,0,0,30,30
1657151370693,MATH 10A,A01,083735,Patchell; Gregory David,2,0,30,28
1657151370693,MATH 10A,A02,083736,Patchell; Gregory David,20,0,30,10
1657151370693,MATH 10A,A03,083737,Patchell; Gregory David,16,0,30,14
1657151376718,MATH 10B,A01,083207,Lim; Seonhee,7,0,34,27
1657151376718,MATH 10B,A02,083208,Lim; Seonhee,9,0,35,26
1657151376718,MATH 10B,A03,093472,Lim; Seonhee,5,0,34,29
1657151376718,MATH 10B,B01,083739,Sinha; Shubham,9,0,30,21
1657151382743,MATH 18,A01,083743,Cinel; Cameron Alexander,6,0,30,24
1657151382743,MATH 18,A02,083744,Cinel; Cameron Alexander,15,0,30,15
1657151382743,MATH 18,A03,083745,Cinel; Cameron Alexander,8,0,30,22
1657151382743,MATH 18,B01,083748,Rideout; David Porter,4,0,37,33
1657151382743,MATH 18,B02,083749,Rideout; David Porter,3,0,36,33
1657151382743,MATH 18,B03,083750,Rideout; David Porter,2,0,37,35
1657151382743,MATH 18,B04,083751,Rideout; David Porter,5,0,36,31
1657151382743,MATH 18,B05,093473,Rideout; David Porter,5,0,36,31
1657151382743,MATH 18,B06,093474,Rideout; David Porter,5,0,36,31
1657151388766,MATH 20A,A01,083754,Zheng; Zequn,12,0,40,28
1657151394788,MATH 20B,A01,083756,Briones; Jor-el Thomas Caparas,1,0,36,35
1657151394788,MATH 20B,A02,083757,Briones; Jor-el Thomas Caparas,1,0,36,35
1657151394788,MATH 20B,A03,093475,Briones; Jor-el Thomas Caparas,1,0,36,35
1657151400813,MATH 20C,A01,083760,Briones; Jor-el Thomas Caparas,1,0,35,34
1657151400813,MATH 20C,A02,083761,Briones; Jor-el Thomas Caparas,8,0,35,27
1657151400813,MATH 20C,A03,093476,Briones; Jor-el Thomas Caparas,0,1,36,36
1657151400813,MATH 20C,B01,083762,Bach; Quang Tran,1,0,30,29
1657151406846,MATH 20D,A01,083765,Tran; Brian Kha,4,0,30,26
1657151406846,MATH 20D,A02,083766,Tran; Brian Kha,5,0,30,25
1657151406846,MATH 20D,A03,083767,Tran; Brian Kha,3,0,30,27
1657151412876,MATH 20E,A01,083771,Ganguly; Soumya,7,0,32,25
1657151412876,MATH 20E,A02,083772,Ganguly; Soumya,7,0,32,25
1657151412876,MATH 20E,B01,083773,Ciotti; Benjamin,19,0,35,16
1657151412876,MATH 20E,B02,083774,Ciotti; Benjamin,17,0,35,18
1657151418901,MATH 103A,A01,083777,Greenfeld; Be'Eri,2,0,36,34
1657151418901,MATH 103A,A02,083778,Greenfeld; Be'Eri,5,0,36,31
1657151418901,MATH 103A,A03,093561,Greenfeld; Be'Eri,4,0,36,32
1657151418901,MATH 103A,B01,083779,Greenfeld; Be'Eri,6,0,36,30
1657151418901,MATH 103A,B02,083780,Greenfeld; Be'Eri,3,0,36,33
1657151418901,MATH 103A,B03,093562,Greenfeld; Be'Eri,3,0,36,33
1657151424929,MATH 105,A01,085443,Carter; Anne Toulson,14,0,35,21
1657151424929,MATH 105,A02,093477,Carter; Anne Toulson,20,0,35,15
1657151430959,MATH 109,A01,083213,Ganzberger; Geoffrey Michael,2,0,34,32
1657151430959,MATH 109,A02,083214,Ganzberger; Geoffrey Michael,3,0,34,31
1657151430959,MATH 109,A03,093478,Ganzberger; Geoffrey Michael,1,0,34,33
1657151430959,MATH 109,B01,083215,Ganzberger; Geoffrey Michael,1,0,32,31
1657151430959,MATH 109,B02,083216,Ganzberger; Geoffrey Michael,1,0,32,31
1657151430959,MATH 109,B03,093479,Ganzberger; Geoffrey Michael,6,0,32,26
1657151436985,MATH 142A,A01,083219,Chow; Bennett,6,0,32,26
1657151436985,MATH 142A,A02,083220,Chow; Bennett,10,0,32,22
1657151436985,MATH 142A,A03,093480,Chow; Bennett,7,0,32,25
1657151436985,MATH 142A,B03,093481,Chow; Bennett,8,0,32,24
1657151436985,MATH 142A,B04,093558,Chow; Bennett,11,0,32,21
1657151436985,MATH 142A,B05,093559,Chow; Bennett,6,0,32,26
1657151443008,MATH 193A,A01,083224,Rotar; Vladimir,7,0,34,27
1657151443008,MATH 193A,A02,083225,Rotar; Vladimir,5,0,34,29
1657151443008,MATH 193A,A03,083781,Rotar; Vladimir,1,0,34,33
1657151443008,MATH 193A,A04,083782,Rotar; Vladimir,8,0,34,26
1657151443008,MATH 193A,A05,093482,Rotar; Vladimir,6,0,34,28
1657151449034,MATH 197,001,091859,McAuley; Julian John,9999,0,9999,0
1657151449034,MATH 197,002,095566,Kedlaya; Kiran S.,9997,0,9999,2
1657151449034,MATH 197,003,095567,Xiao; Ming,9999,0,9999,0
1657151449034,MATH 197,004,095571,Perols; Johan Lars,9998,0,9999,1
1657151456100,COGS 9,A01,083615,Shannon; Kyle Michael,7,0,75,68
1657151462129,COGS 11,A01,083617,Boyle; Mary E. T.,22,0,48,26
1657151468152,COGS 13,A01,083071,Bastos; Amalia Pinkusfeld,9,0,71,62
1657151474183,COGS 14A,A01,092681,Semenuks; Arturs,1,1,100,99
1657151480206,COGS 14B,A01,083073,Cheng; Tzu-Han,6,0,63,57
1657151486232,COGS 17,A01,092677,Semenuks; Arturs,4,0,81,77
1657151492264,COGS 100,A01,083619,Allen; Michael Gordon,15,0,70,55
1657151498288,COGS 101A,A01,083621,Davis; Joshua Daniel,9,0,68,59
1657151504311,COGS 101B,A01,091572,Allen; Michael Gordon,9,0,65,56
1657151510339,COGS 101C,A01,083625,Delgado; Tania,17,0,35,18
1657151516363,COGS 107A,A01,083627,Boyle; Mary E. T.,13,0,60,47
1657151522392,COGS 118A,A01,083075,Gupta; Anjum,15,0,76,61
1657151528419,CSE 3,A50,083646,Miranda; Gregory Joseph,24,0,50,26
1657151534443,CSE 8A,A50,083650,Miranda; Gregory Joseph,17,1,56,39
1657151540469,CSE 11,A01,083080,Cao; Yingjun,5,15,40,35
1657151546496,CSE 12,A01,083652,Krause-Levy; Sophia Louisa,24,1,120,96
1657151552524,CSE 15L,A01,083654,Morris; Justin Loren,9,0,50,41
1657151552524,CSE 15L,A02,083655,Morris; Justin Loren,9,0,50,41
1657151558545,CSE 20,A01,083657,Tran; Khoa Dang,38,0,80,42
1657151564569,CSE 21,A01,095574,Bach; Quang Tran,22,0,48,26
1657151570597,CSE 30,A01,083084,Eldon; John,4,0,80,76
1657151570597,CSE 30,B01,095061,Bhaskar; Nishant,7,0,50,43
1657151576629,CSE 100,A01,083659,Cao; Yingjun,4,4,70,66
1657151582657,CSE 134B,A01,083661,Powell; Thomas Allan,20,0,100,80
1657151588776,CSE 140,A01,083663,Gungor; Onat,13,0,85,72
1657151594812,CSE 140L,A01,083088,Eldon; John,17,0,100,83
1657151600834,CSE 175,A01,083665,Kumar; Rakesh,3,0,25,22
1657151606860,CSE 190,A00,092507,Dubnov; Shlomo,7,0,20,13
1657151612883,ECE 45,A01,083139,Congero; Spencer William,5,0,75,70
1657151618909,ECE 65,A50,083695,Saad; Andrew S,12,0,30,18
1657151618909,ECE 65,A51,095125,Saad; Andrew S,25,0,26,1
1657151624931,ECE 109,A01,091882,Touri; Behrouz,18,0,70,52
1657151630955,ECE 180,A00,083140,Abi Samra; Nicholas Camill,1,0,30,29
1657151630955,ECE 180,B00,083141,Abi Samra; Nicholas Camill,0,0,30,30
1657151636982,MATH 10A,A01,083735,Patchell; Gregory David,2,0,30,28
1657151636982,MATH 10A,A02,083736,Patchell; Gregory David,20,0,30,10
1657151636982,MATH 10A,A03,083737,Patchell; Gregory David,16,0,30,14
1657151643010,MATH 10B,A01,083207,Lim; Seonhee,7,0,34,27
1657151643010,MATH 10B,A02,083208,Lim; Seonhee,9,0,35,26
1657151643010,MATH 10B,A03,093472,Lim; Seonhee,5,0,34,29
1657151643010,MATH 10B,B01,083739,Sinha; Shubham,9,0,30,21
1657151649043,MATH 18,A01,083743,Cinel; Cameron Alexander,6,0,30,24
1657151649043,MATH 18,A02,083744,Cinel; Cameron Alexander,15,0,30,15
1657151649043,MATH 18,A03,083745,Cinel; Cameron Alexander,8,0,30,22
1657151649043,MATH 18,B01,083748,Rideout; David Porter,4,0,37,33
1657151649043,MATH 18,B02,083749,Rideout; David Porter,3,0,36,33
1657151649043,MATH 18,B03,083750,Rideout; David Porter,2,0,37,35
1657151649043,MATH 18,B04,083751,Rideout; David Porter,5,0,36,31
1657151649043,MATH 18,B05,093473,Rideout; David Porter,5,0,36,31
1657151649043,MATH 18,B06,093474,Rideout; David Porter,5,0,36,31
1657151655066,MATH 20A,A01,083754,Zheng; Zequn,12,0,40,28
1657151661100,MATH 20B,A01,083756,Briones; Jor-el Thomas Caparas,1,0,36,35
1657151661100,MATH 20B,A02,083757,Briones; Jor-el Thomas Caparas,1,0,36,35
1657151661100,MATH 20B,A03,093475,Briones; Jor-el Thomas Caparas,1,0,36,35
1657151667123,MATH 20C,A01,083760,Briones; Jor-el Thomas Caparas,1,0,35,34
1657151667123,MATH 20C,A02,083761,Briones; Jor-el Thomas Caparas,8,0,35,27
1657151667123,MATH 20C,A03,093476,Briones; Jor-el Thomas Caparas,0,1,36,36
1657151667123,MATH 20C,B01,083762,Bach; Quang Tran,1,0,30,29
1657151673153,MATH 20D,A01,083765,Tran; Brian Kha,4,0,30,26
1657151673153,MATH 20D,A02,083766,Tran; Brian Kha,5,0,30,25
1657151673153,MATH 20D,A03,083767,Tran; Brian Kha,3,0,30,27
1657151679177,MATH 20E,A01,083771,Ganguly; Soumya,7,0,32,25
1657151679177,MATH 20E,A02,083772,Ganguly; Soumya,7,0,32,25
1657151679177,MATH 20E,B01,083773,Ciotti; Benjamin,19,0,35,16
1657151679177,MATH 20E,B02,083774,Ciotti; Benjamin,17,0,35,18
1657151685200,MATH 103A,A01,083777,Greenfeld; Be'Eri,2,0,36,34
1657151685200,MATH 103A,A02,083778,Greenfeld; Be'Eri,5,0,36,31
1657151685200,MATH 103A,A03,093561,Greenfeld; Be'Eri,4,0,36,32
1657151685200,MATH 103A,B01,083779,Greenfeld; Be'Eri,6,0,36,30
1657151685200,MATH 103A,B02,083780,Greenfeld; Be'Eri,3,0,36,33
1657151685200,MATH 103A,B03,093562,Greenfeld; Be'Eri,3,0,36,33
1657151691226,MATH 105,A01,085443,Carter; Anne Toulson,14,0,35,21
1657151691226,MATH 105,A02,093477,Carter; Anne Toulson,20,0,35,15
1657151697249,MATH 109,A01,083213,Ganzberger; Geoffrey Michael,2,0,34,32
1657151697249,MATH 109,A02,083214,Ganzberger; Geoffrey Michael,3,0,34,31
1657151697249,MATH 109,A03,093478,Ganzberger; Geoffrey Michael,1,0,34,33
1657151697249,MATH 109,B01,083215,Ganzberger; Geoffrey Michael,1,0,32,31
1657151697249,MATH 109,B02,083216,Ganzberger; Geoffrey Michael,1,0,32,31
1657151697249,MATH 109,B03,093479,Ganzberger; Geoffrey Michael,6,0,32,26
1657151703279,MATH 142A,A01,083219,Chow; Bennett,6,0,32,26
1657151703279,MATH 142A,A02,083220,Chow; Bennett,10,0,32,22
1657151703279,MATH 142A,A03,093480,Chow; Bennett,7,0,32,25
1657151703279,MATH 142A,B03,093481,Chow; Bennett,8,0,32,24
1657151703279,MATH 142A,B04,093558,Chow; Bennett,11,0,32,21
1657151703279,MATH 142A,B05,093559,Chow; Bennett,6,0,32,26
1657151709305,MATH 193A,A01,083224,Rotar; Vladimir,7,0,34,27
1657151709305,MATH 193A,A02,083225,Rotar; Vladimir,5,0,34,29
1657151709305,MATH 193A,A03,083781,Rotar; Vladimir,1,0,34,33
1657151709305,MATH 193A,A04,083782,Rotar; Vladimir,8,0,34,26
1657151709305,MATH 193A,A05,093482,Rotar; Vladimir,6,0,34,28
1657151715336,MATH 197,001,091859,McAuley; Julian John,9999,0,9999,0
1657151715336,MATH 197,002,095566,Kedlaya; Kiran S.,9997,0,9999,2
1657151715336,MATH 197,003,095567,Xiao; Ming,9999,0,9999,0
1657151715336,MATH 197,004,095571,Perols; Johan Lars,9998,0,9999,1
1657151722396,COGS 9,A01,083615,Shannon; Kyle Michael,7,0,75,68
1657151728422,COGS 11,A01,083617,Boyle; Mary E. T.,22,0,48,26
1657151734447,COGS 13,A01,083071,Bastos; Amalia Pinkusfeld,9,0,71,62
1657151740473,COGS 14A,A01,092681,Semenuks; Arturs,1,1,100,99
1657151746501,COGS 14B,A01,083073,Cheng; Tzu-Han,6,0,63,57
1657151752525,COGS 17,A01,092677,Semenuks; Arturs,4,0,81,77
1657151758548,COGS 100,A01,083619,Allen; Michael Gordon,15,0,70,55
1657151764579,COGS 101A,A01,083621,Davis; Joshua Daniel,9,0,68,59
1657151770607,COGS 101B,A01,091572,Allen; Michael Gordon,9,0,65,56
1657151776637,COGS 101C,A01,083625,Delgado; Tania,17,0,35,18
1657151782661,COGS 107A,A01,083627,Boyle; Mary E. T.,13,0,60,47
1657151788688,COGS 118A,A01,083075,Gupta; Anjum,15,0,76,61
1657151794717,CSE 3,A50,083646,Miranda; Gregory Joseph,24,0,50,26
1657151800739,CSE 8A,A50,083650,Miranda; Gregory Joseph,17,1,56,39
1657151806764,CSE 11,A01,083080,Cao; Yingjun,5,15,40,35
1657151812787,CSE 12,A01,083652,Krause-Levy; Sophia Louisa,24,1,120,96
1657151818810,CSE 15L,A01,083654,Morris; Justin Loren,9,0,50,41
1657151818810,CSE 15L,A02,083655,Morris; Justin Loren,9,0,50,41
1657151824850,CSE 20,A01,083657,Tran; Khoa Dang,38,0,80,42
1657151830872,CSE 21,A01,095574,Bach; Quang Tran,22,0,48,26
1657151836896,CSE 30,A01,083084,Eldon; John,4,0,80,76
1657151836896,CSE 30,B01,095061,Bhaskar; Nishant,7,0,50,43
1657151842918,CSE 100,A01,083659,Cao; Yingjun,4,4,70,66
1657151848944,CSE 134B,A01,083661,Powell; Thomas Allan,20,0,100,80
1657151854972,CSE 140,A01,083663,Gungor; Onat,13,0,85,72
1657151860997,CSE 140L,A01,083088,Eldon; John,17,0,100,83
1657151867020,CSE 175,A01,083665,Kumar; Rakesh,3,0,25,22
1657151873047,CSE 190,A00,092507,Dubnov; Shlomo,7,0,20,13
1657151879075,ECE 45,A01,083139,Congero; Spencer William,5,0,75,70
1657151885101,ECE 65,A50,083695,Saad; Andrew S,12,0,30,18
1657151885101,ECE 65,A51,095125,Saad; Andrew S,25,0,26,1
1657151891127,ECE 109,A01,091882,Touri; Behrouz,18,0,70,52
1657151897152,ECE 180,A00,083140,Abi Samra; Nicholas Camill,1,0,30,29
1657151897152,ECE 180,B00,083141,Abi Samra; Nicholas Camill,0,0,30,30
1657151903189,MATH 10A,A01,083735,Patchell; Gregory David,2,0,30,28
1657151903189,MATH 10A,A02,083736,Patchell; Gregory David,20,0,30,10
1657151903189,MATH 10A,A03,083737,Patchell; Gregory David,16,0,30,14
1657151909214,MATH 10B,A01,083207,Lim; Seonhee,7,0,34,27
1657151909214,MATH 10B,A02,083208,Lim; Seonhee,9,0,35,26
1657151909214,MATH 10B,A03,093472,Lim; Seonhee,5,0,34,29
1657151909214,MATH 10B,B01,083739,Sinha; Shubham,9,0,30,21
1657151915246,MATH 18,A01,083743,Cinel; Cameron Alexander,6,0,30,24
1657151915246,MATH 18,A02,083744,Cinel; Cameron Alexander,15,0,30,15
1657151915246,MATH 18,A03,083745,Cinel; Cameron Alexander,8,0,30,22
1657151915246,MATH 18,B01,083748,Rideout; David Porter,4,0,37,33
1657151915246,MATH 18,B02,083749,Rideout; David Porter,3,0,36,33
1657151915246,MATH 18,B03,083750,Rideout; David Porter,2,0,37,35
1657151915246,MATH 18,B04,083751,Rideout; David Porter,5,0,36,31
1657151915246,MATH 18,B05,093473,Rideout; David Porter,5,0,36,31
1657151915246,MATH 18,B06,093474,Rideout; David Porter,5,0,36,31
1657151921273,MATH 20A,A01,083754,Zheng; Zequn,12,0,40,28
1657151927298,MATH 20B,A01,083756,Briones; Jor-el Thomas Caparas,1,0,36,35
1657151927298,MATH 20B,A02,083757,Briones; Jor-el Thomas Caparas,1,0,36,35
1657151927298,MATH 20B,A03,093475,Briones; Jor-el Thomas Caparas,1,0,36,35
1657151933321,MATH 20C,A01,083760,Briones; Jor-el Thomas Caparas,1,0,35,34
1657151933321,MATH 20C,A02,083761,Briones; Jor-el Thomas Caparas,8,0,35,27
1657151933321,MATH 20C,A03,093476,Briones; Jor-el Thomas Caparas,0,1,36,36
1657151933321,MATH 20C,B01,083762,Bach; Quang Tran,1,0,30,29
1657151939349,MATH 20D,A01,083765,Tran; Brian Kha,4,0,30,26
1657151939349,MATH 20D,A02,083766,Tran; Brian Kha,5,0,30,25
1657151939349,MATH 20D,A03,083767,Tran; Brian Kha,3,0,30,27
1657151945377,MATH 20E,A01,083771,Ganguly; Soumya,7,0,32,25
1657151945377,MATH 20E,A02,083772,Ganguly; Soumya,7,0,32,25
1657151945377,MATH 20E,B01,083773,Ciotti; Benjamin,19,0,35,16
1657151945377,MATH 20E,B02,083774,Ciotti; Benjamin,17,0,35,18
1657151951406,MATH 103A,A01,083777,Greenfeld; Be'Eri,2,0,36,34
1657151951406,MATH 103A,A02,083778,Greenfeld; Be'Eri,5,0,36,31
1657151951406,MATH 103A,A03,093561,Greenfeld; Be'Eri,4,0,36,32
1657151951406,MATH 103A,B01,083779,Greenfeld; Be'Eri,6,0,36,30
1657151951406,MATH 103A,B02,083780,Greenfeld; Be'Eri,3,0,36,33
1657151951406,MATH 103A,B03,093562,Greenfeld; Be'Eri,3,0,36,33
1657151957440,MATH 105,A01,085443,Carter; Anne Toulson,14,0,35,21
1657151957440,MATH 105,A02,093477,Carter; Anne Toulson,20,0,35,15
1657151963463,MATH 109,A01,083213,Ganzberger; Geoffrey Michael,2,0,34,32
1657151963463,MATH 109,A02,083214,Ganzberger; Geoffrey Michael,3,0,34,31
1657151963463,MATH 109,A03,093478,Ganzberger; Geoffrey Michael,1,0,34,33
1657151963463,MATH 109,B01,083215,Ganzberger; Geoffrey Michael,1,0,32,31
1657151963463,MATH 109,B02,083216,Ganzberger; Geoffrey Michael,1,0,32,31
1657151963463,MATH 109,B03,093479,Ganzberger; Geoffrey Michael,6,0,32,26
1657151969493,MATH 142A,A01,083219,Chow; Bennett,6,0,32,26
1657151969493,MATH 142A,A02,083220,Chow; Bennett,10,0,32,22
1657151969493,MATH 142A,A03,093480,Chow; Bennett,7,0,32,25
1657151969493,MATH 142A,B03,093481,Chow; Bennett,8,0,32,24
1657151969493,MATH 142A,B04,093558,Chow; Bennett,11,0,32,21
1657151969493,MATH 142A,B05,093559,Chow; Bennett,6,0,32,26
1657151975518,MATH 193A,A01,083224,Rotar; Vladimir,7,0,34,27
1657151975518,MATH 193A,A02,083225,Rotar; Vladimir,5,0,34,29
1657151975518,MATH 193A,A03,083781,Rotar; Vladimir,1,0,34,33
1657151975518,MATH 193A,A04,083782,Rotar; Vladimir,8,0,34,26
1657151975518,MATH 193A,A05,093482,Rotar; Vladimir,6,0,34,28
1657151981544,MATH 197,001,091859,McAuley; Julian John,9999,0,9999,0
1657151981544,MATH 197,002,095566,Kedlaya; Kiran S.,9997,0,9999,2
1657151981544,MATH 197,003,095567,Xiao; Ming,9999,0,9999,0
1657151981544,MATH 197,004,095571,Perols; Johan Lars,9998,0,9999,1
1657151988602,COGS 9,A01,083615,Shannon; Kyle Michael,7,0,75,68
1657151994641,COGS 11,A01,083617,Boyle; Mary E. T.,22,0,48,26
1657152000663,COGS 13,A01,083071,Bastos; Amalia Pinkusfeld,9,0,71,62
1657152006690,COGS 14A,A01,092681,Semenuks; Arturs,1,1,100,99
1657152012719,COGS 14B,A01,083073,Cheng; Tzu-Han,6,0,63,57
1657152018744,COGS 17,A01,092677,Semenuks; Arturs,4,0,81,77
1657152024776,COGS 100,A01,083619,Allen; Michael Gordon,15,0,70,55
1657152030800,COGS 101A,A01,083621,Davis; Joshua Daniel,9,0,68,59
1657152036834,COGS 101B,A01,091572,Allen; Michael Gordon,9,0,65,56
1657152042857,COGS 101C,A01,083625,Delgado; Tania,17,0,35,18
1657152048896,COGS 107A,A01,083627,Boyle; Mary E. T.,13,0,60,47
1657152054922,COGS 118A,A01,083075,Gupta; Anjum,15,0,76,61
1657152060947,CSE 3,A50,083646,Miranda; Gregory Joseph,24,0,50,26
1657152066971,CSE 8A,A50,083650,Miranda; Gregory Joseph,17,1,56,39
1657152072994,CSE 11,A01,083080,Cao; Yingjun,5,15,40,35
1657152079019,CSE 12,A01,083652,Krause-Levy; Sophia Louisa,24,1,120,96
1657152085044,CSE 15L,A01,083654,Morris; Justin Loren,9,0,50,41
1657152085044,CSE 15L,A02,083655,Morris; Justin Loren,9,0,50,41
1657152091076,CSE 20,A01,083657,Tran; Khoa Dang,38,0,80,42
1657152097100,CSE 21,A01,095574,Bach; Quang Tran,22,0,48,26
1657152103125,CSE 30,A01,083084,Eldon; John,4,0,80,76
1657152103125,CSE 30,B01,095061,Bhaskar; Nishant,7,0,50,43
1657152109150,CSE 100,A01,083659,Cao; Yingjun,4,4,70,66
1657152115178,CSE 134B,A01,083661,Powell; Thomas Allan,20,0,100,80
1657152121202,CSE 140,A01,083663,Gungor; Onat,13,0,85,72
1657152127234,CSE 140L,A01,083088,Eldon; John,17,0,100,83
1657152133255,CSE 175,A01,083665,Kumar; Rakesh,3,0,25,22
1657152139279,CSE 190,A00,092507,Dubnov; Shlomo,7,0,20,13
1657152145307,ECE 45,A01,083139,Congero; Spencer William,5,0,75,70
1657152151330,ECE 65,A50,083695,Saad; Andrew S,12,0,30,18
1657152151330,ECE 65,A51,095125,Saad; Andrew S,25,0,26,1
1657152157354,ECE 109,A01,091882,Touri; Behrouz,18,0,70,52
1657152163378,ECE 180,A00,083140,Abi Samra; Nicholas Camill,1,0,30,29
1657152163378,ECE 180,B00,083141,Abi Samra; Nicholas Camill,0,0,30,30
1657152169410,MATH 10A,A01,083735,Patchell; Gregory David,2,0,30,28
1657152169410,MATH 10A,A02,083736,Patchell; Gregory David,20,0,30,10
1657152169410,MATH 10A,A03,083737,Patchell; Gregory David,16,0,30,14
1657152175435,MATH 10B,A01,083207,Lim; Seonhee,7,0,34,27
1657152175435,MATH 10B,A02,083208,Lim; Seonhee,9,0,35,26
1657152175435,MATH 10B,A03,093472,Lim; Seonhee,5,0,34,29
1657152175435,MATH 10B,B01,083739,Sinha; Shubham,9,0,30,21
1657152181459,MATH 18,A01,083743,Cinel; Cameron Alexander,6,0,30,24
1657152181459,MATH 18,A02,083744,Cinel; Cameron Alexander,15,0,30,15
1657152181459,MATH 18,A03,083745,Cinel; Cameron Alexander,8,0,30,22
1657152181459,MATH 18,B01,083748,Rideout; David Porter,4,0,37,33
1657152181459,MATH 18,B02,083749,Rideout; David Porter,3,0,36,33
1657152181459,MATH 18,B03,083750,Rideout; David Porter,2,0,37,35
1657152181459,MATH 18,B04,083751,Rideout; David Porter,5,0,36,31
1657152181459,MATH 18,B05,093473,Rideout; David Porter,5,0,36,31
1657152181459,MATH 18,B06,093474,Rideout; David Porter,5,0,36,31
1657152187579,MATH 20A,A01,083754,Zheng; Zequn,12,0,40,28
1657152193613,MATH 20B,A01,083756,Briones; Jor-el Thomas Caparas,1,0,36,35
1657152193613,MATH 20B,A02,083757,Briones; Jor-el Thomas Caparas,1,0,36,35
1657152193613,MATH 20B,A03,093475,Briones; Jor-el Thomas Caparas,1,0,36,35
1657152199640,MATH 20C,A01,083760,Briones; Jor-el Thomas Caparas,1,0,35,34
1657152199640,MATH 20C,A02,083761,Briones; Jor-el Thomas Caparas,8,0,35,27
1657152199640,MATH 20C,A03,093476,Briones; Jor-el Thomas Caparas,0,1,36,36
1657152199640,MATH 20C,B01,083762,Bach; Quang Tran,1,0,30,29
1657152205664,MATH 20D,A01,083765,Tran; Brian Kha,4,0,30,26
1657152205664,MATH 20D,A02,083766,Tran; Brian Kha,5,0,30,25
1657152205664,MATH 20D,A03,083767,Tran; Brian Kha,3,0,30,27
1657152211695,MATH 20E,A01,083771,Ganguly; Soumya,7,0,32,25
1657152211695,MATH 20E,A02,083772,Ganguly; Soumya,7,0,32,25
1657152211695,MATH 20E,B01,083773,Ciotti; Benjamin,19,0,35,16
1657152211695,MATH 20E,B02,083774,Ciotti; Benjamin,17,0,35,18
1657152217726,MATH 103A,A01,083777,Greenfeld; Be'Eri,2,0,36,34
1657152217726,MATH 103A,A02,083778,Greenfeld; Be'Eri,5,0,36,31
1657152217726,MATH 103A,A03,093561,Greenfeld; Be'Eri,4,0,36,32
1657152217726,MATH 103A,B01,083779,Greenfeld; Be'Eri,6,0,36,30
1657152217726,MATH 103A,B02,083780,Greenfeld; Be'Eri,3,0,36,33
1657152217726,MATH 103A,B03,093562,Greenfeld; Be'Eri,3,0,36,33
1657152223755,MATH 105,A01,085443,Carter; Anne Toulson,14,0,35,21
1657152223755,MATH 105,A02,093477,Carter; Anne Toulson,20,0,35,15
1657152229785,MATH 109,A01,083213,Ganzberger; Geoffrey Michael,2,0,34,32
1657152229785,MATH 109,A02,083214,Ganzberger; Geoffrey Michael,3,0,34,31
1657152229785,MATH 109,A03,093478,Ganzberger; Geoffrey Michael,1,0,34,33
1657152229785,MATH 109,B01,083215,Ganzberger; Geoffrey Michael,1,0,32,31
1657152229785,MATH 109,B02,083216,Ganzberger; Geoffrey Michael,1,0,32,31
1657152229785,MATH 109,B03,093479,Ganzberger; Geoffrey Michael,6,0,32,26
1657152235809,MATH 142A,A01,083219,Chow; Bennett,6,0,32,26
1657152235809,MATH 142A,A02,083220,Chow; Bennett,10,0,32,22
1657152235809,MATH 142A,A03,093480,Chow; Bennett,7,0,32,25
1657152235809,MATH 142A,B03,093481,Chow; Bennett,8,0,32,24
1657152235809,MATH 142A,B04,093558,Chow; Bennett,11,0,32,21
1657152235809,MATH 142A,B05,093559,Chow; Bennett,6,0,32,26
1657152241839,MATH 193A,A01,083224,Rotar; Vladimir,7,0,34,27
1657152241839,MATH 193A,A02,083225,Rotar; Vladimir,5,0,34,29
1657152241839,MATH 193A,A03,083781,Rotar; Vladimir,1,0,34,33
1657152241839,MATH 193A,A04,083782,Rotar; Vladimir,8,0,34,26
1657152241839,MATH 193A,A05,093482,Rotar; Vladimir,6,0,34,28
1657152247861,MATH 197,001,091859,McAuley; Julian John,9999,0,9999,0
1657152247861,MATH 197,002,095566,Kedlaya; Kiran S.,9997,0,9999,2
1657152247861,MATH 197,003,095567,Xiao; Ming,9999,0,9999,0
1657152247861,MATH 197,004,095571,Perols; Johan Lars,9998,0,9999,1
1657152254914,COGS 9,A01,083615,Shannon; Kyle Michael,7,0,75,68
1657152260941,COGS 11,A01,083617,Boyle; Mary E. T.,22,0,48,26
1657152266965,COGS 13,A01,083071,Bastos; Amalia Pinkusfeld,9,0,71,62
1657152272987,COGS 14A,A01,092681,Semenuks; Arturs,1,1,100,99
1657152279019,COGS 14B,A01,083073,Cheng; Tzu-Han,6,0,63,57
1657152285050,COGS 17,A01,092677,Semenuks; Arturs,4,0,81,77
1657152291078,COGS 100,A01,083619,Allen; Michael Gordon,15,0,70,55
1657152297105,COGS 101A,A01,083621,Davis; Joshua Daniel,9,0,68,59
1657152303127,COGS 101B,A01,091572,Allen; Michael Gordon,9,0,65,56
1657152309155,COGS 101C,A01,083625,Delgado; Tania,17,0,35,18
1657152315179,COGS 107A,A01,083627,Boyle; Mary E. T.,13,0,60,47
1657152321203,COGS 118A,A01,083075,Gupta; Anjum,15,0,76,61
1657152327227,CSE 3,A50,083646,Miranda; Gregory Joseph,24,0,50,26
1657152333249,CSE 8A,A50,083650,Miranda; Gregory Joseph,17,1,56,39
1657152339289,CSE 11,A01,083080,Cao; Yingjun,5,15,40,35
1657152345317,CSE 12,A01,083652,Krause-Levy; Sophia Louisa,24,1,120,96
1657152351341,CSE 15L,A01,083654,Morris; Justin Loren,9,0,50,41
1657152351341,CSE 15L,A02,083655,Morris; Justin Loren,9,0,50,41
1657152357376,CSE 20,A01,083657,Tran; Khoa Dang,38,0,80,42
1657152363404,CSE 21,A01,095574,Bach; Quang Tran,22,0,48,26
1657152369429,CSE 30,A01,083084,Eldon; John,4,0,80,76
1657152369429,CSE 30,B01,095061,Bhaskar; Nishant,7,0,50,43
1657152375454,CSE 100,A01,083659,Cao; Yingjun,4,4,70,66
1657152381478,CSE 134B,A01,083661,Powell; Thomas Allan,20,0,100,80
1657152387503,CSE 140,A01,083663,Gungor; Onat,13,0,85,72
1657152393529,CSE 140L,A01,083088,Eldon; John,17,0,100,83
1657152399552,CSE 175,A01,083665,Kumar; Rakesh,3,0,25,22
1657152405587,CSE 190,A00,092507,Dubnov; Shlomo,7,0,20,13
1657152411613,ECE 45,A01,083139,Congero; Spencer William,5,0,75,70
1657152417638,ECE 65,A50,083695,Saad; Andrew S,12,0,30,18
1657152417638,ECE 65,A51,095125,Saad; Andrew S,25,0,26,1
1657152423662,ECE 109,A01,091882,Touri; Behrouz,18,0,70,52
1657152429686,ECE 180,A00,083140,Abi Samra; Nicholas Camill,1,0,30,29
1657152429686,ECE 180,B00,083141,Abi Samra; Nicholas Camill,0,0,30,30
1657152435723,MATH 10A,A01,083735,Patchell; Gregory David,2,0,30,28
1657152435723,MATH 10A,A02,083736,Patchell; Gregory David,20,0,30,10
1657152435723,MATH 10A,A03,083737,Patchell; Gregory David,16,0,30,14
1657152441753,MATH 10B,A01,083207,Lim; Seonhee,7,0,34,27
1657152441753,MATH 10B,A02,083208,Lim; Seonhee,9,0,35,26
1657152441753,MATH 10B,A03,093472,Lim; Seonhee,5,0,34,29
1657152441753,MATH 10B,B01,083739,Sinha; Shubham,9,0,30,21
1657152447779,MATH 18,A01,083743,Cinel; Cameron Alexander,6,0,30,24
1657152447779,MATH 18,A02,083744,Cinel; Cameron Alexander,15,0,30,15
1657152447779,MATH 18,A03,083745,Cinel; Cameron Alexander,8,0,30,22
1657152447779,MATH 18,B01,083748,Rideout; David Porter,4,0,37,33
1657152447779,MATH 18,B02,083749,Rideout; David Porter,3,0,36,33
1657152447779,MATH 18,B03,083750,Rideout; David Porter,2,0,37,35
1657152447779,MATH 18,B04,083751,Rideout; David Porter,5,0,36,31
1657152447779,MATH 18,B05,093473,Rideout; David Porter,5,0,36,31
1657152447779,MATH 18,B06,093474,Rideout; David Porter,5,0,36,31
1657152453802,MATH 20A,A01,083754,Zheng; Zequn,12,0,40,28
1657152459830,MATH 20B,A01,083756,Briones; Jor-el Thomas Caparas,1,0,36,35
1657152459830,MATH 20B,A02,083757,Briones; Jor-el Thomas Caparas,1,0,36,35
1657152459830,MATH 20B,A03,093475,Briones; Jor-el Thomas Caparas,1,0,36,35
1657152465859,MATH 20C,A01,083760,Briones; Jor-el Thomas Caparas,1,0,35,34
1657152465859,MATH 20C,A02,083761,Briones; Jor-el Thomas Caparas,8,0,35,27
1657152465859,MATH 20C,A03,093476,Briones; Jor-el Thomas Caparas,0,1,36,36
1657152465859,MATH 20C,B01,083762,Bach; Quang Tran,1,0,30,29
1657152471883,MATH 20D,A01,083765,Tran; Brian Kha,4,0,30,26
1657152471883,MATH 20D,A02,083766,Tran; Brian Kha,5,0,30,25
1657152471883,MATH 20D,A03,083767,Tran; Brian Kha,3,0,30,27
1657152477912,MATH 20E,A01,083771,Ganguly; Soumya,7,0,32,25
1657152477912,MATH 20E,A02,083772,Ganguly; Soumya,7,0,32,25
1657152477912,MATH 20E,B01,083773,Ciotti; Benjamin,19,0,35,16
1657152477912,MATH 20E,B02,083774,Ciotti; Benjamin,17,0,35,18
1657152483941,MATH 103A,A01,083777,Greenfeld; Be'Eri,2,0,36,34
1657152483941,MATH 103A,A02,083778,Greenfeld; Be'Eri,5,0,36,31
1657152483941,MATH 103A,A03,093561,Greenfeld; Be'Eri,4,0,36,32
1657152483941,MATH 103A,B01,083779,Greenfeld; Be'Eri,6,0,36,30
1657152483941,MATH 103A,B02,083780,Greenfeld; Be'Eri,3,0,36,33
1657152483941,MATH 103A,B03,093562,Greenfeld; Be'Eri,3,0,36,33
1657152489975,MATH 105,A01,085443,Carter; Anne Toulson,14,0,35,21
1657152489975,MATH 105,A02,093477,Carter; Anne Toulson,20,0,35,15
1657152496005,MATH 109,A01,083213,Ganzberger; Geoffrey Michael,2,0,34,32
1657152496005,MATH 109,A02,083214,Ganzberger; Geoffrey Michael,3,0,34,31
1657152496005,MATH 109,A03,093478,Ganzberger; Geoffrey Michael,1,0,34,33
1657152496005,MATH 109,B01,083215,Ganzberger; Geoffrey Michael,1,0,32,31
1657152496005,MATH 109,B02,083216,Ganzberger; Geoffrey Michael,1,0,32,31
1657152496005,MATH 109,B03,093479,Ganzberger; Geoffrey Michael,6,0,32,26
1657152502033,MATH 142A,A01,083219,Chow; Bennett,6,0,32,26
1657152502033,MATH 142A,A02,083220,Chow; Bennett,10,0,32,22
1657152502033,MATH 142A,A03,093480,Chow; Bennett,7,0,32,25
1657152502033,MATH 142A,B03,093481,Chow; Bennett,8,0,32,24
1657152502033,MATH 142A,B04,093558,Chow; Bennett,11,0,32,21
1657152502033,MATH 142A,B05,093559,Chow; Bennett,6,0,32,26
1657152508058,MATH 193A,A01,083224,Rotar; Vladimir,7,0,34,27
1657152508058,MATH 193A,A02,083225,Rotar; Vladimir,5,0,34,29
1657152508058,MATH 193A,A03,083781,Rotar; Vladimir,1,0,34,33
1657152508058,MATH 193A,A04,083782,Rotar; Vladimir,8,0,34,26
1657152508058,MATH 193A,A05,093482,Rotar; Vladimir,6,0,34,28
1657152514081,MATH 197,001,091859,McAuley; Julian John,9999,0,9999,0
1657152514081,MATH 197,002,095566,Kedlaya; Kiran S.,9997,0,9999,2
1657152514081,MATH 197,003,095567,Xiao; Ming,9999,0,9999,0
1657152514081,MATH 197,004,095571,Perols; Johan Lars,9998,0,9999,1
1657152521137,COGS 9,A01,083615,Shannon; Kyle Michael,7,0,75,68
1657152527162,COGS 11,A01,083617,Boyle; Mary E. T.,22,0,48,26
1657152533194,COGS 13,A01,083071,Bastos; Amalia Pinkusfeld,9,0,71,62
1657152539224,COGS 14A,A01,092681,Semenuks; Arturs,1,1,100,99
1657152545259,COGS 14B,A01,083073,Cheng; Tzu-Han,6,0,63,57
1657152551283,COGS 17,A01,092677,Semenuks; Arturs,4,0,81,77
1657152557308,COGS 100,A01,083619,Allen; Michael Gordon,15,0,70,55
1657152563339,COGS 101A,A01,083621,Davis; Joshua Daniel,9,0,68,59
1657152569361,COGS 101B,A01,091572,Allen; Michael Gordon,9,0,65,56
1657152575385,COGS 101C,A01,083625,Delgado; Tania,17,0,35,18
1657152581409,COGS 107A,A01,083627,Boyle; Mary E. T.,13,0,60,47
1657152587432,COGS 118A,A01,083075,Gupta; Anjum,15,0,76,61
1657152593461,CSE 3,A50,083646,Miranda; Gregory Joseph,24,0,50,26
1657152599485,CSE 8A,A50,083650,Miranda; Gregory Joseph,17,1,56,39
1657152605510,CSE 11,A01,083080,Cao; Yingjun,5,15,40,35
1657152611538,CSE 12,A01,083652,Krause-Levy; Sophia Louisa,24,1,120,96
1657152617565,CSE 15L,A01,083654,Morris; Justin Loren,9,0,50,41
1657152617565,CSE 15L,A02,083655,Morris; Justin Loren,9,0,50,41
1657152623594,CSE 20,A01,083657,Tran; Khoa Dang,38,0,80,42
1657152629623,CSE 21,A01,095574,Bach; Quang Tran,22,0,48,26
1657152635657,CSE 30,A01,083084,Eldon; John,4,0,80,76
1657152635657,CSE 30,B01,095061,Bhaskar; Nishant,7,0,50,43
1657152641683,CSE 100,A01,083659,Cao; Yingjun,4,4,70,66
1657152647725,CSE 134B,A01,083661,Powell; Thomas Allan,20,0,100,80
1657152653750,CSE 140,A01,083663,Gungor; Onat,13,0,85,72
1657152659776,CSE 140L,A01,083088,Eldon; John,17,0,100,83
1657152665803,CSE 175,A01,083665,Kumar; Rakesh,3,0,25,22
1657152671824,CSE 190,A00,092507,Dubnov; Shlomo,7,0,20,13
1657152677850,ECE 45,A01,083139,Congero; Spencer William,5,0,75,70
1657152683879,ECE 65,A50,083695,Saad; Andrew S,12,0,30,18
1657152683879,ECE 65,A51,095125,Saad; Andrew S,25,0,26,1
1657152689910,ECE 109,A01,091882,Touri; Behrouz,18,0,70,52
1657152695934,ECE 180,A00,083140,Abi Samra; Nicholas Camill,1,0,30,29
1657152695934,ECE 180,B00,083141,Abi Samra; Nicholas Camill,0,0,30,30
1657152701970,MATH 10A,A01,083735,Patchell; Gregory David,2,0,30,28
1657152701970,MATH 10A,A02,083736,Patchell; Gregory David,20,0,30,10
1657152701970,MATH 10A,A03,083737,Patchell; Gregory David,16,0,30,14
1657152708003,MATH 10B,A01,083207,Lim; Seonhee,7,0,34,27
1657152708003,MATH 10B,A02,083208,Lim; Seonhee,9,0,35,26
1657152708003,MATH 10B,A03,093472,Lim; Seonhee,5,0,34,29
1657152708003,MATH 10B,B01,083739,Sinha; Shubham,9,0,30,21
1657152714035,MATH 18,A01,083743,Cinel; Cameron Alexander,6,0,30,24
1657152714035,MATH 18,A02,083744,Cinel; Cameron Alexander,15,0,30,15
1657152714035,MATH 18,A03,083745,Cinel; Cameron Alexander,8,0,30,22
1657152714035,MATH 18,B01,083748,Rideout; David Porter,4,0,37,33
1657152714035,MATH 18,B02,083749,Rideout; David Porter,3,0,36,33
1657152714035,MATH 18,B03,083750,Rideout; David Porter,2,0,37,35
1657152714035,MATH 18,B04,083751,Rideout; David Porter,5,0,36,31
1657152714035,MATH 18,B05,093473,Rideout; David Porter,5,0,36,31
1657152714035,MATH 18,B06,093474,Rideout; David Porter,5,0,36,31
1657152720064,MATH 20A,A01,083754,Zheng; Zequn,12,0,40,28
1657152726093,MATH 20B,A01,083756,Briones; Jor-el Thomas Caparas,1,0,36,35
1657152726093,MATH 20B,A02,083757,Briones; Jor-el Thomas Caparas,1,0,36,35
1657152726093,MATH 20B,A03,093475,Briones; Jor-el Thomas Caparas,1,0,36,35
1657152732116,MATH 20C,A01,083760,Briones; Jor-el Thomas Caparas,1,0,35,34
1657152732116,MATH 20C,A02,083761,Briones; Jor-el Thomas Caparas,8,0,35,27
1657152732116,MATH 20C,A03,093476,Briones; Jor-el Thomas Caparas,0,1,36,36
1657152732116,MATH 20C,B01,083762,Bach; Quang Tran,1,0,30,29
1657152738166,MATH 20D,A01,083765,Tran; Brian Kha,4,0,30,26
1657152738166,MATH 20D,A02,083766,Tran; Brian Kha,5,0,30,25
1657152738166,MATH 20D,A03,083767,Tran; Brian Kha,3,0,30,27
1657152744189,MATH 20E,A01,083771,Ganguly; Soumya,7,0,32,25
1657152744189,MATH 20E,A02,083772,Ganguly; Soumya,7,0,32,25
1657152744189,MATH 20E,B01,083773,Ciotti; Benjamin,19,0,35,16
1657152744189,MATH 20E,B02,083774,Ciotti; Benjamin,17,0,35,18
1657152750212,MATH 103A,A01,083777,Greenfeld; Be'Eri,2,0,36,34
1657152750212,MATH 103A,A02,083778,Greenfeld; Be'Eri,5,0,36,31
1657152750212,MATH 103A,A03,093561,Greenfeld; Be'Eri,4,0,36,32
1657152750212,MATH 103A,B01,083779,Greenfeld; Be'Eri,6,0,36,30
1657152750212,MATH 103A,B02,083780,Greenfeld; Be'Eri,3,0,36,33
1657152750212,MATH 103A,B03,093562,Greenfeld; Be'Eri,3,0,36,33
1657152756241,MATH 105,A01,085443,Carter; Anne Toulson,14,0,35,21
1657152756241,MATH 105,A02,093477,Carter; Anne Toulson,20,0,35,15
1657152762265,MATH 109,A01,083213,Ganzberger; Geoffrey Michael,2,0,34,32
1657152762265,MATH 109,A02,083214,Ganzberger; Geoffrey Michael,3,0,34,31
1657152762265,MATH 109,A03,093478,Ganzberger; Geoffrey Michael,1,0,34,33
1657152762265,MATH 109,B01,083215,Ganzberger; Geoffrey Michael,1,0,32,31
1657152762265,MATH 109,B02,083216,Ganzberger; Geoffrey Michael,1,0,32,31
1657152762265,MATH 109,B03,093479,Ganzberger; Geoffrey Michael,6,0,32,26
1657152768304,MATH 142A,A01,083219,Chow; Bennett,6,0,32,26
1657152768304,MATH 142A,A02,083220,Chow; Bennett,10,0,32,22
1657152768304,MATH 142A,A03,093480,Chow; Bennett,7,0,32,25
1657152768304,MATH 142A,B03,093481,Chow; Bennett,8,0,32,24
1657152768304,MATH 142A,B04,093558,Chow; Bennett,11,0,32,21
1657152768304,MATH 142A,B05,093559,Chow; Bennett,6,0,32,26
1657152774326,MATH 193A,A01,083224,Rotar; Vladimir,7,0,34,27
1657152774326,MATH 193A,A02,083225,Rotar; Vladimir,5,0,34,29
1657152774326,MATH 193A,A03,083781,Rotar; Vladimir,1,0,34,33
1657152774326,MATH 193A,A04,083782,Rotar; Vladimir,8,0,34,26
1657152774326,MATH 193A,A05,093482,Rotar; Vladimir,6,0,34,28
1657152780357,MATH 197,001,091859,McAuley; Julian John,9999,0,9999,0
1657152780357,MATH 197,002,095566,Kedlaya; Kiran S.,9997,0,9999,2
1657152780357,MATH 197,003,095567,Xiao; Ming,9999,0,9999,0
1657152780357,MATH 197,004,095571,Perols; Johan Lars,9998,0,9999,1
1657152787496,COGS 9,A01,083615,Shannon; Kyle Michael,7,0,75,68
1657152793525,COGS 11,A01,083617,Boyle; Mary E. T.,22,0,48,26
1657152799548,COGS 13,A01,083071,Bastos; Amalia Pinkusfeld,9,0,71,62
1657152805574,COGS 14A,A01,092681,Semenuks; Arturs,1,1,100,99
1657152811599,COGS 14B,A01,083073,Cheng; Tzu-Han,6,0,63,57
1657152817621,COGS 17,A01,092677,Semenuks; Arturs,4,0,81,77
1657152823654,COGS 100,A01,083619,Allen; Michael Gordon,15,0,70,55
1657152829693,COGS 101A,A01,083621,Davis; Joshua Daniel,9,0,68,59
1657152835720,COGS 101B,A01,091572,Allen; Michael Gordon,9,0,65,56
1657152841751,COGS 101C,A01,083625,Delgado; Tania,17,0,35,18
1657152847777,COGS 107A,A01,083627,Boyle; Mary E. T.,13,0,60,47
1657152853800,COGS 118A,A01,083075,Gupta; Anjum,15,0,76,61
1657152859824,CSE 3,A50,083646,Miranda; Gregory Joseph,24,0,50,26
1657152865848,CSE 8A,A50,083650,Miranda; Gregory Joseph,17,1,56,39
1657152871870,CSE 11,A01,083080,Cao; Yingjun,5,15,40,35
1657152877897,CSE 12,A01,083652,Krause-Levy; Sophia Louisa,24,1,120,96
1657152883927,CSE 15L,A01,083654,Morris; Justin Loren,9,0,50,41
1657152883927,CSE 15L,A02,083655,Morris; Justin Loren,9,0,50,41
1657152889955,CSE 20,A01,083657,Tran; Khoa Dang,38,0,80,42
1657152895982,CSE 21,A01,095574,Bach; Quang Tran,22,0,48,26
1657152902005,CSE 30,A01,083084,Eldon; John,4,0,80,76
1657152902005,CSE 30,B01,095061,Bhaskar; Nishant,7,0,50,43
1657152908033,CSE 100,A01,083659,Cao; Yingjun,4,4,70,66
1657152914056,CSE 134B,A01,083661,Powell; Thomas Allan,20,0,100,80
1657152920084,CSE 140,A01,083663,Gungor; Onat,13,0,85,72
1657152926105,CSE 140L,A01,083088,Eldon; John,17,0,100,83
1657152932128,CSE 175,A01,083665,Kumar; Rakesh,3,0,25,22
1657152938149,CSE 190,A00,092507,Dubnov; Shlomo,7,0,20,13
1657152944178,ECE 45,A01,083139,Congero; Spencer William,5,0,75,70
1657152950201,ECE 65,A50,083695,Saad; Andrew S,12,0,30,18
1657152950201,ECE 65,A51,095125,Saad; Andrew S,25,0,26,1
1657152956224,ECE 109,A01,091882,Touri; Behrouz,18,0,70,52
1657152962250,ECE 180,A00,083140,Abi Samra; Nicholas Camill,1,0,30,29
1657152962250,ECE 180,B00,083141,Abi Samra; Nicholas Camill,0,0,30,30
1657152968276,MATH 10A,A01,083735,Patchell; Gregory David,2,0,30,28
1657152968276,MATH 10A,A02,083736,Patchell; Gregory David,20,0,30,10
1657152968276,MATH 10A,A03,083737,Patchell; Gregory David,16,0,30,14
1657152974306,MATH 10B,A01,083207,Lim; Seonhee,7,0,34,27
1657152974306,MATH 10B,A02,083208,Lim; Seonhee,9,0,35,26
1657152974306,MATH 10B,A03,093472,Lim; Seonhee,5,0,34,29
1657152974306,MATH 10B,B01,083739,Sinha; Shubham,9,0,30,21
1657152980332,MATH 18,A01,083743,Cinel; Cameron Alexander,6,0,30,24
1657152980332,MATH 18,A02,083744,Cinel; Cameron Alexander,15,0,30,15
1657152980332,MATH 18,A03,083745,Cinel; Cameron Alexander,8,0,30,22
1657152980332,MATH 18,B01,083748,Rideout; David Porter,4,0,37,33
1657152980332,MATH 18,B02,083749,Rideout; David Porter,3,0,36,33
1657152980332,MATH 18,B03,083750,Rideout; David Porter,2,0,37,35
1657152980332,MATH 18,B04,083751,Rideout; David Porter,5,0,36,31
1657152980332,MATH 18,B05,093473,Rideout; David Porter,5,0,36,31
1657152980332,MATH 18,B06,093474,Rideout; David Porter,5,0,36,31
1657152986362,MATH 20A,A01,083754,Zheng; Zequn,12,0,40,28
1657152992396,MATH 20B,A01,083756,Briones; Jor-el Thomas Caparas,1,0,36,35
1657152992396,MATH 20B,A02,083757,Briones; Jor-el Thomas Caparas,1,0,36,35
1657152992396,MATH 20B,A03,093475,Briones; Jor-el Thomas Caparas,1,0,36,35
1657152998421,MATH 20C,A01,083760,Briones; Jor-el Thomas Caparas,1,0,35,34
1657152998421,MATH 20C,A02,083761,Briones; Jor-el Thomas Caparas,8,0,35,27
1657152998421,MATH 20C,A03,093476,Briones; Jor-el Thomas Caparas,0,1,36,36
1657152998421,MATH 20C,B01,083762,Bach; Quang Tran,1,0,30,29
1657153004485,MATH 20D,A01,083765,Tran; Brian Kha,4,0,30,26
1657153004485,MATH 20D,A02,083766,Tran; Brian Kha,5,0,30,25
1657153004485,MATH 20D,A03,083767,Tran; Brian Kha,3,0,30,27
1657153010514,MATH 20E,A01,083771,Ganguly; Soumya,7,0,32,25
1657153010514,MATH 20E,A02,083772,Ganguly; Soumya,7,0,32,25
1657153010514,MATH 20E,B01,083773,Ciotti; Benjamin,19,0,35,16
1657153010514,MATH 20E,B02,083774,Ciotti; Benjamin,17,0,35,18
1657153016539,MATH 103A,A01,083777,Greenfeld; Be'Eri,2,0,36,34
1657153016539,MATH 103A,A02,083778,Greenfeld; Be'Eri,5,0,36,31
1657153016539,MATH 103A,A03,093561,Greenfeld; Be'Eri,4,0,36,32
1657153016539,MATH 103A,B01,083779,Greenfeld; Be'Eri,6,0,36,30
1657153016539,MATH 103A,B02,083780,Greenfeld; Be'Eri,3,0,36,33
1657153016539,MATH 103A,B03,093562,Greenfeld; Be'Eri,3,0,36,33
1657153022568,MATH 105,A01,085443,Carter; Anne Toulson,14,0,35,21
1657153022568,MATH 105,A02,093477,Carter; Anne Toulson,20,0,35,15
1657153028599,MATH 109,A01,083213,Ganzberger; Geoffrey Michael,2,0,34,32
1657153028599,MATH 109,A02,083214,Ganzberger; Geoffrey Michael,3,0,34,31
1657153028599,MATH 109,A03,093478,Ganzberger; Geoffrey Michael,1,0,34,33
1657153028599,MATH 109,B01,083215,Ganzberger; Geoffrey Michael,1,0,32,31
1657153028599,MATH 109,B02,083216,Ganzberger; Geoffrey Michael,1,0,32,31
1657153028599,MATH 109,B03,093479,Ganzberger; Geoffrey Michael,6,0,32,26
1657153034622,MATH 142A,A01,083219,Chow; Bennett,6,0,32,26
1657153034622,MATH 142A,A02,083220,Chow; Bennett,10,0,32,22
1657153034622,MATH 142A,A03,093480,Chow; Bennett,7,0,32,25
1657153034622,MATH 142A,B03,093481,Chow; Bennett,8,0,32,24
1657153034622,MATH 142A,B04,093558,Chow; Bennett,11,0,32,21
1657153034622,MATH 142A,B05,093559,Chow; Bennett,6,0,32,26
1657153040646,MATH 193A,A01,083224,Rotar; Vladimir,7,0,34,27
1657153040646,MATH 193A,A02,083225,Rotar; Vladimir,5,0,34,29
1657153040646,MATH 193A,A03,083781,Rotar; Vladimir,1,0,34,33
1657153040646,MATH 193A,A04,083782,Rotar; Vladimir,8,0,34,26
1657153040646,MATH 193A,A05,093482,Rotar; Vladimir,6,0,34,28
1657153046673,MATH 197,001,091859,McAuley; Julian John,9999,0,9999,0
1657153046673,MATH 197,002,095566,Kedlaya; Kiran S.,9997,0,9999,2
1657153046673,MATH 197,003,095567,Xiao; Ming,9999,0,9999,0
1657153046673,MATH 197,004,095571,Perols; Johan Lars,9998,0,9999,1
1657153053726,COGS 9,A01,083615,Shannon; Kyle Michael,7,0,75,68
1657153059753,COGS 11,A01,083617,Boyle; Mary E. T.,22,0,48,26
1657153065780,COGS 13,A01,083071,Bastos; Amalia Pinkusfeld,9,0,71,62
1657153071806,COGS 14A,A01,092681,Semenuks; Arturs,1,1,100,99
1657153077834,COGS 14B,A01,083073,Cheng; Tzu-Han,6,0,63,57
1657153083856,COGS 17,A01,092677,Semenuks; Arturs,4,0,81,77
1657153089882,COGS 100,A01,083619,Allen; Michael Gordon,15,0,70,55
1657153095905,COGS 101A,A01,083621,Davis; Joshua Daniel,9,0,68,59
1657153101929,COGS 101B,A01,091572,Allen; Michael Gordon,9,0,65,56
1657153107955,COGS 101C,A01,083625,Delgado; Tania,17,0,35,18
1657153113983,COGS 107A,A01,083627,Boyle; Mary E. T.,13,0,60,47
1657153120011,COGS 118A,A01,083075,Gupta; Anjum,15,0,76,61
1657153126039,CSE 3,A50,083646,Miranda; Gregory Joseph,24,0,50,26
1657153132069,CSE 8A,A50,083650,Miranda; Gregory Joseph,17,1,56,39
1657153138091,CSE 11,A01,083080,Cao; Yingjun,5,15,40,35
1657153144115,CSE 12,A01,083652,Krause-Levy; Sophia Louisa,24,1,120,96
1657153150141,CSE 15L,A01,083654,Morris; Justin Loren,9,0,50,41
1657153150141,CSE 15L,A02,083655,Morris; Justin Loren,9,0,50,41
1657153156165,CSE 20,A01,083657,Tran; Khoa Dang,38,0,80,42
1657153162191,CSE 21,A01,095574,Bach; Quang Tran,22,0,48,26
1657153168218,CSE 30,A01,083084,Eldon; John,4,0,80,76
1657153168218,CSE 30,B01,095061,Bhaskar; Nishant,7,0,50,43
1657153174240,CSE 100,A01,083659,Cao; Yingjun,4,4,70,66
1657153180271,CSE 134B,A01,083661,Powell; Thomas Allan,20,0,100,80
1657153186295,CSE 140,A01,083663,Gungor; Onat,13,0,85,72
1657153192321,CSE 140L,A01,083088,Eldon; John,17,0,100,83
1657153198344,CSE 175,A01,083665,Kumar; Rakesh,3,0,25,22
1657153204367,CSE 190,A00,092507,Dubnov; Shlomo,7,0,20,13
1657153210390,ECE 45,A01,083139,Congero; Spencer William,5,0,75,70
1657153216424,ECE 65,A50,083695,Saad; Andrew S,12,0,30,18
1657153216424,ECE 65,A51,095125,Saad; Andrew S,25,0,26,1
1657153222455,ECE 109,A01,091882,Touri; Behrouz,18,0,70,52
1657153228479,ECE 180,A00,083140,Abi Samra; Nicholas Camill,1,0,30,29
1657153228479,ECE 180,B00,083141,Abi Samra; Nicholas Camill,0,0,30,30
1657153234502,MATH 10A,A01,083735,Patchell; Gregory David,2,0,30,28
1657153234502,MATH 10A,A02,083736,Patchell; Gregory David,20,0,30,10
1657153234502,MATH 10A,A03,083737,Patchell; Gregory David,16,0,30,14
1657153240525,MATH 10B,A01,083207,Lim; Seonhee,7,0,34,27
1657153240525,MATH 10B,A02,083208,Lim; Seonhee,9,0,35,26
1657153240525,MATH 10B,A03,093472,Lim; Seonhee,5,0,34,29
1657153240525,MATH 10B,B01,083739,Sinha; Shubham,9,0,30,21
1657153246550,MATH 18,A01,083743,Cinel; Cameron Alexander,6,0,30,24
1657153246550,MATH 18,A02,083744,Cinel; Cameron Alexander,15,0,30,15
1657153246550,MATH 18,A03,083745,Cinel; Cameron Alexander,8,0,30,22
1657153246550,MATH 18,B01,083748,Rideout; David Porter,4,0,37,33
1657153246550,MATH 18,B02,083749,Rideout; David Porter,3,0,36,33
1657153246550,MATH 18,B03,083750,Rideout; David Porter,2,0,37,35
1657153246550,MATH 18,B04,083751,Rideout; David Porter,5,0,36,31
1657153246550,MATH 18,B05,093473,Rideout; David Porter,5,0,36,31
1657153246550,MATH 18,B06,093474,Rideout; David Porter,5,0,36,31
1657153252576,MATH 20A,A01,083754,Zheng; Zequn,12,0,40,28
1657153258597,MATH 20B,A01,083756,Briones; Jor-el Thomas Caparas,1,0,36,35
1657153258597,MATH 20B,A02,083757,Briones; Jor-el Thomas Caparas,1,0,36,35
1657153258597,MATH 20B,A03,093475,Briones; Jor-el Thomas Caparas,1,0,36,35
1657153264629,MATH 20C,A01,083760,Briones; Jor-el Thomas Caparas,1,0,35,34
1657153264629,MATH 20C,A02,083761,Briones; Jor-el Thomas Caparas,8,0,35,27
1657153264629,MATH 20C,A03,093476,Briones; Jor-el Thomas Caparas,0,1,36,36
1657153264629,MATH 20C,B01,083762,Bach; Quang Tran,1,0,30,29
1657153270658,MATH 20D,A01,083765,Tran; Brian Kha,4,0,30,26
1657153270658,MATH 20D,A02,083766,Tran; Brian Kha,5,0,30,25
1657153270658,MATH 20D,A03,083767,Tran; Brian Kha,3,0,30,27
1657153276685,MATH 20E,A01,083771,Ganguly; Soumya,7,0,32,25
1657153276685,MATH 20E,A02,083772,Ganguly; Soumya,7,0,32,25
1657153276685,MATH 20E,B01,083773,Ciotti; Benjamin,19,0,35,16
1657153276685,MATH 20E,B02,083774,Ciotti; Benjamin,17,0,35,18
1657153282709,MATH 103A,A01,083777,Greenfeld; Be'Eri,2,0,36,34
1657153282709,MATH 103A,A02,083778,Greenfeld; Be'Eri,5,0,36,31
1657153282709,MATH 103A,A03,093561,Greenfeld; Be'Eri,4,0,36,32
1657153282709,MATH 103A,B01,083779,Greenfeld; Be'Eri,6,0,36,30
1657153282709,MATH 103A,B02,083780,Greenfeld; Be'Eri,3,0,36,33
1657153282709,MATH 103A,B03,093562,Greenfeld; Be'Eri,3,0,36,33
1657153288734,MATH 105,A01,085443,Carter; Anne Toulson,14,0,35,21
1657153288734,MATH 105,A02,093477,Carter; Anne Toulson,20,0,35,15
1657153294757,MATH 109,A01,083213,Ganzberger; Geoffrey Michael,2,0,34,32
1657153294757,MATH 109,A02,083214,Ganzberger; Geoffrey Michael,3,0,34,31
1657153294757,MATH 109,A03,093478,Ganzberger; Geoffrey Michael,1,0,34,33
1657153294757,MATH 109,B01,083215,Ganzberger; Geoffrey Michael,1,0,32,31
1657153294757,MATH 109,B02,083216,Ganzberger; Geoffrey Michael,1,0,32,31
1657153294757,MATH 109,B03,093479,Ganzberger; Geoffrey Michael,6,0,32,26
1657153300791,MATH 142A,A01,083219,Chow; Bennett,6,0,32,26
1657153300791,MATH 142A,A02,083220,Chow; Bennett,10,0,32,22
1657153300791,MATH 142A,A03,093480,Chow; Bennett,7,0,32,25
1657153300791,MATH 142A,B03,093481,Chow; Bennett,8,0,32,24
1657153300791,MATH 142A,B04,093558,Chow; Bennett,11,0,32,21
1657153300791,MATH 142A,B05,093559,Chow; Bennett,6,0,32,26
1657153306817,MATH 193A,A01,083224,Rotar; Vladimir,7,0,34,27
1657153306817,MATH 193A,A02,083225,Rotar; Vladimir,5,0,34,29
1657153306817,MATH 193A,A03,083781,Rotar; Vladimir,1,0,34,33
1657153306817,MATH 193A,A04,083782,Rotar; Vladimir,8,0,34,26
1657153306817,MATH 193A,A05,093482,Rotar; Vladimir,6,0,34,28
1657153312841,MATH 197,001,091859,McAuley; Julian John,9999,0,9999,0
1657153312841,MATH 197,002,095566,Kedlaya; Kiran S.,9997,0,9999,2
1657153312841,MATH 197,003,095567,Xiao; Ming,9999,0,9999,0
1657153312841,MATH 197,004,095571,Perols; Johan Lars,9998,0,9999,1
1657153319906,COGS 9,A01,083615,Shannon; Kyle Michael,7,0,75,68
1657153325933,COGS 11,A01,083617,Boyle; Mary E. T.,22,0,48,26
1657153331968,COGS 13,A01,083071,Bastos; Amalia Pinkusfeld,9,0,71,62
1657153337990,COGS 14A,A01,092681,Semenuks; Arturs,1,1,100,99
1657153344018,COGS 14B,A01,083073,Cheng; Tzu-Han,6,0,63,57
1657153350041,COGS 17,A01,092677,Semenuks; Arturs,4,0,81,77
1657153356064,COGS 100,A01,083619,Allen; Michael Gordon,15,0,70,55
1657153362086,COGS 101A,A01,083621,Davis; Joshua Daniel,9,0,68,59
1657153368109,COGS 101B,A01,091572,Allen; Michael Gordon,9,0,65,56
1657153374130,COGS 101C,A01,083625,Delgado; Tania,17,0,35,18
1657153380242,COGS 107A,A01,083627,Boyle; Mary E. T.,13,0,60,47
1657153386269,COGS 118A,A01,083075,Gupta; Anjum,15,0,76,61
1657153392294,CSE 3,A50,083646,Miranda; Gregory Joseph,24,0,50,26
1657153398317,CSE 8A,A50,083650,Miranda; Gregory Joseph,17,1,56,39
1657153404341,CSE 11,A01,083080,Cao; Yingjun,5,15,40,35
1657153410364,CSE 12,A01,083652,Krause-Levy; Sophia Louisa,24,1,120,96
1657153416387,CSE 15L,A01,083654,Morris; Justin Loren,9,0,50,41
1657153416387,CSE 15L,A02,083655,Morris; Justin Loren,9,0,50,41
1657153422410,CSE 20,A01,083657,Tran; Khoa Dang,38,0,80,42
1657153428432,CSE 21,A01,095574,Bach; Quang Tran,22,0,48,26
1657153434460,CSE 30,A01,083084,Eldon; John,4,0,80,76
1657153434460,CSE 30,B01,095061,Bhaskar; Nishant,7,0,50,43
1657153440483,CSE 100,A01,083659,Cao; Yingjun,4,4,70,66
1657153446509,CSE 134B,A01,083661,Powell; Thomas Allan,20,0,100,80
1657153452533,CSE 140,A01,083663,Gungor; Onat,13,0,85,72
1657153458556,CSE 140L,A01,083088,Eldon; John,17,0,100,83
1657153464580,CSE 175,A01,083665,Kumar; Rakesh,3,0,25,22
1657153470605,CSE 190,A00,092507,Dubnov; Shlomo,7,0,20,13
1657153476627,ECE 45,A01,083139,Congero; Spencer William,5,0,75,70
1657153482652,ECE 65,A50,083695,Saad; Andrew S,12,0,30,18
1657153482652,ECE 65,A51,095125,Saad; Andrew S,25,0,26,1
1657153488675,ECE 109,A01,091882,Touri; Behrouz,18,0,70,52
1657153494701,ECE 180,A00,083140,Abi Samra; Nicholas Camill,1,0,30,29
1657153494701,ECE 180,B00,083141,Abi Samra; Nicholas Camill,0,0,30,30
1657153500724,MATH 10A,A01,083735,Patchell; Gregory David,2,0,30,28
1657153500724,MATH 10A,A02,083736,Patchell; Gregory David,20,0,30,10
1657153500724,MATH 10A,A03,083737,Patchell; Gregory David,16,0,30,14
1657153506747,MATH 10B,A01,083207,Lim; Seonhee,7,0,34,27
1657153506747,MATH 10B,A02,083208,Lim; Seonhee,9,0,35,26
1657153506747,MATH 10B,A03,093472,Lim; Seonhee,5,0,34,29
1657153506747,MATH 10B,B01,083739,Sinha; Shubham,9,0,30,21
1657153512778,MATH 18,A01,083743,Cinel; Cameron Alexander,6,0,30,24
1657153512778,MATH 18,A02,083744,Cinel; Cameron Alexander,15,0,30,15
1657153512778,MATH 18,A03,083745,Cinel; Cameron Alexander,8,0,30,22
1657153512778,MATH 18,B01,083748,Rideout; David Porter,4,0,37,33
1657153512778,MATH 18,B02,083749,Rideout; David Porter,3,0,36,33
1657153512778,MATH 18,B03,083750,Rideout; David Porter,2,0,37,35
1657153512778,MATH 18,B04,083751,Rideout; David Porter,5,0,36,31
1657153512778,MATH 18,B05,093473,Rideout; David Porter,5,0,36,31
1657153512778,MATH 18,B06,093474,Rideout; David Porter,5,0,36,31
1657153518801,MATH 20A,A01,083754,Zheng; Zequn,12,0,40,28
1657153524830,MATH 20B,A01,083756,Briones; Jor-el Thomas Caparas,1,0,36,35
1657153524830,MATH 20B,A02,083757,Briones; Jor-el Thomas Caparas,1,0,36,35
1657153524830,MATH 20B,A03,093475,Briones; Jor-el Thomas Caparas,1,0,36,35
1657153530861,MATH 20C,A01,083760,Briones; Jor-el Thomas Caparas,1,0,35,34
1657153530861,MATH 20C,A02,083761,Briones; Jor-el Thomas Caparas,8,0,35,27
1657153530861,MATH 20C,A03,093476,Briones; Jor-el Thomas Caparas,0,1,36,36
1657153530861,MATH 20C,B01,083762,Bach; Quang Tran,1,0,30,29
1657153536887,MATH 20D,A01,083765,Tran; Brian Kha,4,0,30,26
1657153536887,MATH 20D,A02,083766,Tran; Brian Kha,5,0,30,25
1657153536887,MATH 20D,A03,083767,Tran; Brian Kha,3,0,30,27
1657153542917,MATH 20E,A01,083771,Ganguly; Soumya,7,0,32,25
1657153542917,MATH 20E,A02,083772,Ganguly; Soumya,7,0,32,25
1657153542917,MATH 20E,B01,083773,Ciotti; Benjamin,19,0,35,16
1657153542917,MATH 20E,B02,083774,Ciotti; Benjamin,17,0,35,18
1657153548943,MATH 103A,A01,083777,Greenfeld; Be'Eri,2,0,36,34
1657153548943,MATH 103A,A02,083778,Greenfeld; Be'Eri,5,0,36,31
1657153548943,MATH 103A,A03,093561,Greenfeld; Be'Eri,4,0,36,32
1657153548943,MATH 103A,B01,083779,Greenfeld; Be'Eri,6,0,36,30
1657153548943,MATH 103A,B02,083780,Greenfeld; Be'Eri,3,0,36,33
1657153548943,MATH 103A,B03,093562,Greenfeld; Be'Eri,3,0,36,33
1657153554975,MATH 105,A01,085443,Carter; Anne Toulson,14,0,35,21
1657153554975,MATH 105,A02,093477,Carter; Anne Toulson,20,0,35,15
1657153561002,MATH 109,A01,083213,Ganzberger; Geoffrey Michael,2,0,34,32
1657153561002,MATH 109,A02,083214,Ganzberger; Geoffrey Michael,3,0,34,31
1657153561002,MATH 109,A03,093478,Ganzberger; Geoffrey Michael,1,0,34,33
1657153561002,MATH 109,B01,083215,Ganzberger; Geoffrey Michael,1,0,32,31
1657153561002,MATH 109,B02,083216,Ganzberger; Geoffrey Michael,1,0,32,31
1657153561002,MATH 109,B03,093479,Ganzberger; Geoffrey Michael,6,0,32,26
1657153567026,MATH 142A,A01,083219,Chow; Bennett,6,0,32,26
1657153567026,MATH 142A,A02,083220,Chow; Bennett,10,0,32,22
1657153567026,MATH 142A,A03,093480,Chow; Bennett,7,0,32,25
1657153567026,MATH 142A,B03,093481,Chow; Bennett,8,0,32,24
1657153567026,MATH 142A,B04,093558,Chow; Bennett,11,0,32,21
1657153567026,MATH 142A,B05,093559,Chow; Bennett,6,0,32,26
1657153573048,MATH 193A,A01,083224,Rotar; Vladimir,7,0,34,27
1657153573048,MATH 193A,A02,083225,Rotar; Vladimir,5,0,34,29
1657153573048,MATH 193A,A03,083781,Rotar; Vladimir,1,0,34,33
1657153573048,MATH 193A,A04,083782,Rotar; Vladimir,8,0,34,26
1657153573048,MATH 193A,A05,093482,Rotar; Vladimir,6,0,34,28
1657153579073,MATH 197,001,091859,McAuley; Julian John,9999,0,9999,0
1657153579073,MATH 197,002,095566,Kedlaya; Kiran S.,9997,0,9999,2
1657153579073,MATH 197,003,095567,Xiao; Ming,9999,0,9999,0
1657153579073,MATH 197,004,095571,Perols; Johan Lars,9998,0,9999,1
1657153586139,COGS 9,A01,083615,Shannon; Kyle Michael,7,0,75,68
1657153592168,COGS 11,A01,083617,Boyle; Mary E. T.,22,0,48,26
1657153598195,COGS 13,A01,083071,Bastos; Amalia Pinkusfeld,9,0,71,62
1657153604218,COGS 14A,A01,092681,Semenuks; Arturs,1,1,100,99
1657153610242,COGS 14B,A01,083073,Cheng; Tzu-Han,6,0,63,57
1657153616264,COGS 17,A01,092677,Semenuks; Arturs,4,0,81,77
1657153622287,COGS 100,A01,083619,Allen; Michael Gordon,15,0,70,55
1657153628311,COGS 101A,A01,083621,Davis; Joshua Daniel,9,0,68,59
1657153634336,COGS 101B,A01,091572,Allen; Michael Gordon,9,0,65,56
1657153640361,COGS 101C,A01,083625,Delgado; Tania,17,0,35,18
1657153646384,COGS 107A,A01,083627,Boyle; Mary E. T.,13,0,60,47
1657153652417,COGS 118A,A01,083075,Gupta; Anjum,15,0,76,61
1657153658448,CSE 3,A50,083646,Miranda; Gregory Joseph,24,0,50,26
1657153664472,CSE 8A,A50,083650,Miranda; Gregory Joseph,17,1,56,39
1657153670494,CSE 11,A01,083080,Cao; Yingjun,5,15,40,35
1657153676520,CSE 12,A01,083652,Krause-Levy; Sophia Louisa,24,1,120,96
1657153682550,CSE 15L,A01,083654,Morris; Justin Loren,9,0,50,41
1657153682550,CSE 15L,A02,083655,Morris; Justin Loren,9,0,50,41
1657153688573,CSE 20,A01,083657,Tran; Khoa Dang,38,0,80,42
1657153694598,CSE 21,A01,095574,Bach; Quang Tran,22,0,48,26
1657153700626,CSE 30,A01,083084,Eldon; John,4,0,80,76
1657153700626,CSE 30,B01,095061,Bhaskar; Nishant,7,0,50,43
1657153706649,CSE 100,A01,083659,Cao; Yingjun,4,4,70,66
1657153712671,CSE 134B,A01,083661,Powell; Thomas Allan,20,0,100,80
1657153718697,CSE 140,A01,083663,Gungor; Onat,13,0,85,72
1657153724720,CSE 140L,A01,083088,Eldon; John,17,0,100,83
1657153730743,CSE 175,A01,083665,Kumar; Rakesh,3,0,25,22
1657153736765,CSE 190,A00,092507,Dubnov; Shlomo,7,0,20,13
1657153742792,ECE 45,A01,083139,Congero; Spencer William,5,0,75,70
1657153748834,ECE 65,A50,083695,Saad; Andrew S,12,0,30,18
1657153748834,ECE 65,A51,095125,Saad; Andrew S,25,0,26,1
1657153754856,ECE 109,A01,091882,Touri; Behrouz,18,0,70,52
1657153760894,ECE 180,A00,083140,Abi Samra; Nicholas Camill,1,0,30,29
1657153760894,ECE 180,B00,083141,Abi Samra; Nicholas Camill,0,0,30,30
1657153766918,MATH 10A,A01,083735,Patchell; Gregory David,2,0,30,28
1657153766918,MATH 10A,A02,083736,Patchell; Gregory David,20,0,30,10
1657153766918,MATH 10A,A03,083737,Patchell; Gregory David,16,0,30,14
1657153772941,MATH 10B,A01,083207,Lim; Seonhee,7,0,34,27
1657153772941,MATH 10B,A02,083208,Lim; Seonhee,9,0,35,26
1657153772941,MATH 10B,A03,093472,Lim; Seonhee,5,0,34,29
1657153772941,MATH 10B,B01,083739,Sinha; Shubham,9,0,30,21
1657153778967,MATH 18,A01,083743,Cinel; Cameron Alexander,6,0,30,24
1657153778967,MATH 18,A02,083744,Cinel; Cameron Alexander,15,0,30,15
1657153778967,MATH 18,A03,083745,Cinel; Cameron Alexander,8,0,30,22
1657153778967,MATH 18,B01,083748,Rideout; David Porter,4,0,37,33
1657153778967,MATH 18,B02,083749,Rideout; David Porter,3,0,36,33
1657153778967,MATH 18,B03,083750,Rideout; David Porter,2,0,37,35
1657153778967,MATH 18,B04,083751,Rideout; David Porter,5,0,36,31
1657153778967,MATH 18,B05,093473,Rideout; David Porter,5,0,36,31
1657153778967,MATH 18,B06,093474,Rideout; David Porter,5,0,36,31
1657153784996,MATH 20A,A01,083754,Zheng; Zequn,12,0,40,28
1657153791019,MATH 20B,A01,083756,Briones; Jor-el Thomas Caparas,1,0,36,35
1657153791019,MATH 20B,A02,083757,Briones; Jor-el Thomas Caparas,1,0,36,35
1657153791019,MATH 20B,A03,093475,Briones; Jor-el Thomas Caparas,1,0,36,35
1657153797043,MATH 20C,A01,083760,Briones; Jor-el Thomas Caparas,1,0,35,34
1657153797043,MATH 20C,A02,083761,Briones; Jor-el Thomas Caparas,8,0,35,27
1657153797043,MATH 20C,A03,093476,Briones; Jor-el Thomas Caparas,0,1,36,36
1657153797043,MATH 20C,B01,083762,Bach; Quang Tran,1,0,30,29
1657153803073,MATH 20D,A01,083765,Tran; Brian Kha,4,0,30,26
1657153803073,MATH 20D,A02,083766,Tran; Brian Kha,5,0,30,25
1657153803073,MATH 20D,A03,083767,Tran; Brian Kha,3,0,30,27
1657153809096,MATH 20E,A01,083771,Ganguly; Soumya,7,0,32,25
1657153809096,MATH 20E,A02,083772,Ganguly; Soumya,7,0,32,25
1657153809096,MATH 20E,B01,083773,Ciotti; Benjamin,19,0,35,16
1657153809096,MATH 20E,B02,083774,Ciotti; Benjamin,17,0,35,18
1657153815118,MATH 103A,A01,083777,Greenfeld; Be'Eri,2,0,36,34
1657153815118,MATH 103A,A02,083778,Greenfeld; Be'Eri,5,0,36,31
1657153815118,MATH 103A,A03,093561,Greenfeld; Be'Eri,4,0,36,32
1657153815118,MATH 103A,B01,083779,Greenfeld; Be'Eri,6,0,36,30
1657153815118,MATH 103A,B02,083780,Greenfeld; Be'Eri,3,0,36,33
1657153815118,MATH 103A,B03,093562,Greenfeld; Be'Eri,3,0,36,33
1657153821141,MATH 105,A01,085443,Carter; Anne Toulson,14,0,35,21
1657153821141,MATH 105,A02,093477,Carter; Anne Toulson,20,0,35,15
1657153827164,MATH 109,A01,083213,Ganzberger; Geoffrey Michael,2,0,34,32
1657153827164,MATH 109,A02,083214,Ganzberger; Geoffrey Michael,3,0,34,31
1657153827164,MATH 109,A03,093478,Ganzberger; Geoffrey Michael,1,0,34,33
1657153827164,MATH 109,B01,083215,Ganzberger; Geoffrey Michael,1,0,32,31
1657153827164,MATH 109,B02,083216,Ganzberger; Geoffrey Michael,1,0,32,31
1657153827164,MATH 109,B03,093479,Ganzberger; Geoffrey Michael,6,0,32,26
1657153833189,MATH 142A,A01,083219,Chow; Bennett,6,0,32,26
1657153833189,MATH 142A,A02,083220,Chow; Bennett,10,0,32,22
1657153833189,MATH 142A,A03,093480,Chow; Bennett,7,0,32,25
1657153833189,MATH 142A,B03,093481,Chow; Bennett,8,0,32,24
1657153833189,MATH 142A,B04,093558,Chow; Bennett,11,0,32,21
1657153833189,MATH 142A,B05,093559,Chow; Bennett,6,0,32,26
1657153839212,MATH 193A,A01,083224,Rotar; Vladimir,7,0,34,27
1657153839212,MATH 193A,A02,083225,Rotar; Vladimir,5,0,34,29
1657153839212,MATH 193A,A03,083781,Rotar; Vladimir,1,0,34,33
1657153839212,MATH 193A,A04,083782,Rotar; Vladimir,8,0,34,26
1657153839212,MATH 193A,A05,093482,Rotar; Vladimir,6,0,34,28
1657153845239,MATH 197,001,091859,McAuley; Julian John,9999,0,9999,0
1657153845239,MATH 197,002,095566,Kedlaya; Kiran S.,9997,0,9999,2
1657153845239,MATH 197,003,095567,Xiao; Ming,9999,0,9999,0
1657153845239,MATH 197,004,095571,Perols; Johan Lars,9998,0,9999,1
1657153852297,COGS 9,A01,083615,Shannon; Kyle Michael,7,0,75,68
1657153858324,COGS 11,A01,083617,Boyle; Mary E. T.,22,0,48,26
1657153864354,COGS 13,A01,083071,Bastos; Amalia Pinkusfeld,9,0,71,62
1657153870378,COGS 14A,A01,092681,Semenuks; Arturs,1,1,100,99
1657153876406,COGS 14B,A01,083073,Cheng; Tzu-Han,6,0,63,57
1657153882432,COGS 17,A01,092677,Semenuks; Arturs,4,0,81,77
1657153888467,COGS 100,A01,083619,Allen; Michael Gordon,15,0,70,55
1657153894495,COGS 101A,A01,083621,Davis; Joshua Daniel,9,0,68,59
1657153900520,COGS 101B,A01,091572,Allen; Michael Gordon,9,0,65,56
1657153906542,COGS 101C,A01,083625,Delgado; Tania,17,0,35,18
1657153912572,COGS 107A,A01,083627,Boyle; Mary E. T.,13,0,60,47
1657153918600,COGS 118A,A01,083075,Gupta; Anjum,15,0,76,61
1657153924623,CSE 3,A50,083646,Miranda; Gregory Joseph,24,0,50,26
1657153930646,CSE 8A,A50,083650,Miranda; Gregory Joseph,17,1,56,39
1657153936669,CSE 11,A01,083080,Cao; Yingjun,5,15,40,35
1657153942696,CSE 12,A01,083652,Krause-Levy; Sophia Louisa,24,1,120,96
1657153948720,CSE 15L,A01,083654,Morris; Justin Loren,9,0,50,41
1657153948720,CSE 15L,A02,083655,Morris; Justin Loren,9,0,50,41
1657153954743,CSE 20,A01,083657,Tran; Khoa Dang,38,0,80,42
1657153960764,CSE 21,A01,095574,Bach; Quang Tran,22,0,48,26
1657153966786,CSE 30,A01,083084,Eldon; John,4,0,80,76
1657153966786,CSE 30,B01,095061,Bhaskar; Nishant,7,0,50,43
1657153972813,CSE 100,A01,083659,Cao; Yingjun,4,4,70,66
1657153978911,CSE 134B,A01,083661,Powell; Thomas Allan,20,0,100,80
1657153984937,CSE 140,A01,083663,Gungor; Onat,13,0,85,72
1657153990964,CSE 140L,A01,083088,Eldon; John,17,0,100,83
1657153996994,CSE 175,A01,083665,Kumar; Rakesh,3,0,25,22
1657154003020,CSE 190,A00,092507,Dubnov; Shlomo,7,0,20,13
1657154009049,ECE 45,A01,083139,Congero; Spencer William,5,0,75,70
1657154015071,ECE 65,A50,083695,Saad; Andrew S,12,0,30,18
1657154015071,ECE 65,A51,095125,Saad; Andrew S,25,0,26,1
1657154021096,ECE 109,A01,091882,Touri; Behrouz,18,0,70,52
1657154027118,ECE 180,A00,083140,Abi Samra; Nicholas Camill,1,0,30,29
1657154027118,ECE 180,B00,083141,Abi Samra; Nicholas Camill,0,0,30,30
1657154033145,MATH 10A,A01,083735,Patchell; Gregory David,2,0,30,28
1657154033145,MATH 10A,A02,083736,Patchell; Gregory David,20,0,30,10
1657154033145,MATH 10A,A03,083737,Patchell; Gregory David,16,0,30,14
1657154039171,MATH 10B,A01,083207,Lim; Seonhee,7,0,34,27
1657154039171,MATH 10B,A02,083208,Lim; Seonhee,9,0,35,26
1657154039171,MATH 10B,A03,093472,Lim; Seonhee,5,0,34,29
1657154039171,MATH 10B,B01,083739,Sinha; Shubham,9,0,30,21
1657154045205,MATH 18,A01,083743,Cinel; Cameron Alexander,6,0,30,24
1657154045205,MATH 18,A02,083744,Cinel; Cameron Alexander,15,0,30,15
1657154045205,MATH 18,A03,083745,Cinel; Cameron Alexander,8,0,30,22
1657154045205,MATH 18,B01,083748,Rideout; David Porter,4,0,37,33
1657154045205,MATH 18,B02,083749,Rideout; David Porter,3,0,36,33
1657154045205,MATH 18,B03,083750,Rideout; David Porter,2,0,37,35
1657154045205,MATH 18,B04,083751,Rideout; David Porter,5,0,36,31
1657154045205,MATH 18,B05,093473,Rideout; David Porter,5,0,36,31
1657154045205,MATH 18,B06,093474,Rideout; David Porter,5,0,36,31
1657154051227,MATH 20A,A01,083754,Zheng; Zequn,12,0,40,28
1657154057261,MATH 20B,A01,083756,Briones; Jor-el Thomas Caparas,1,0,36,35
1657154057261,MATH 20B,A02,083757,Briones; Jor-el Thomas Caparas,1,0,36,35
1657154057261,MATH 20B,A03,093475,Briones; Jor-el Thomas Caparas,1,0,36,35
1657154063296,MATH 20C,A01,083760,Briones; Jor-el Thomas Caparas,1,0,35,34
1657154063296,MATH 20C,A02,083761,Briones; Jor-el Thomas Caparas,8,0,35,27
1657154063296,MATH 20C,A03,093476,Briones; Jor-el Thomas Caparas,0,1,36,36
1657154063296,MATH 20C,B01,083762,Bach; Quang Tran,1,0,30,29
1657154069329,MATH 20D,A01,083765,Tran; Brian Kha,4,0,30,26
1657154069329,MATH 20D,A02,083766,Tran; Brian Kha,5,0,30,25
1657154069329,MATH 20D,A03,083767,Tran; Brian Kha,3,0,30,27
1657154075354,MATH 20E,A01,083771,Ganguly; Soumya,7,0,32,25
1657154075354,MATH 20E,A02,083772,Ganguly; Soumya,7,0,32,25
1657154075354,MATH 20E,B01,083773,Ciotti; Benjamin,19,0,35,16
1657154075354,MATH 20E,B02,083774,Ciotti; Benjamin,17,0,35,18
1657154081377,MATH 103A,A01,083777,Greenfeld; Be'Eri,2,0,36,34
1657154081377,MATH 103A,A02,083778,Greenfeld; Be'Eri,5,0,36,31
1657154081377,MATH 103A,A03,093561,Greenfeld; Be'Eri,4,0,36,32
1657154081377,MATH 103A,B01,083779,Greenfeld; Be'Eri,6,0,36,30
1657154081377,MATH 103A,B02,083780,Greenfeld; Be'Eri,3,0,36,33
1657154081377,MATH 103A,B03,093562,Greenfeld; Be'Eri,3,0,36,33
1657154087405,MATH 105,A01,085443,Carter; Anne Toulson,14,0,35,21
1657154087405,MATH 105,A02,093477,Carter; Anne Toulson,20,0,35,15
1657154093438,MATH 109,A01,083213,Ganzberger; Geoffrey Michael,2,0,34,32
1657154093438,MATH 109,A02,083214,Ganzberger; Geoffrey Michael,3,0,34,31
1657154093438,MATH 109,A03,093478,Ganzberger; Geoffrey Michael,1,0,34,33
1657154093438,MATH 109,B01,083215,Ganzberger; Geoffrey Michael,1,0,32,31
1657154093438,MATH 109,B02,083216,Ganzberger; Geoffrey Michael,1,0,32,31
1657154093438,MATH 109,B03,093479,Ganzberger; Geoffrey Michael,6,0,32,26
1657154099461,MATH 142A,A01,083219,Chow; Bennett,6,0,32,26
1657154099461,MATH 142A,A02,083220,Chow; Bennett,10,0,32,22
1657154099461,MATH 142A,A03,093480,Chow; Bennett,7,0,32,25
1657154099461,MATH 142A,B03,093481,Chow; Bennett,8,0,32,24
1657154099461,MATH 142A,B04,093558,Chow; Bennett,11,0,32,21
1657154099461,MATH 142A,B05,093559,Chow; Bennett,6,0,32,26
1657154105488,MATH 193A,A01,083224,Rotar; Vladimir,7,0,34,27
1657154105488,MATH 193A,A02,083225,Rotar; Vladimir,5,0,34,29
1657154105488,MATH 193A,A03,083781,Rotar; Vladimir,1,0,34,33
1657154105488,MATH 193A,A04,083782,Rotar; Vladimir,8,0,34,26
1657154105488,MATH 193A,A05,093482,Rotar; Vladimir,6,0,34,28
1657154111513,MATH 197,001,091859,McAuley; Julian John,9999,0,9999,0
1657154111513,MATH 197,002,095566,Kedlaya; Kiran S.,9997,0,9999,2
1657154111513,MATH 197,003,095567,Xiao; Ming,9999,0,9999,0
1657154111513,MATH 197,004,095571,Perols; Johan Lars,9998,0,9999,1
1657154118566,COGS 9,A01,083615,Shannon; Kyle Michael,7,0,75,68
1657154124588,COGS 11,A01,083617,Boyle; Mary E. T.,22,0,48,26
1657154138176,COGS 13,A01,083071,Bastos; Amalia Pinkusfeld,9,0,71,62
1657154144203,COGS 14A,A01,092681,Semenuks; Arturs,1,1,100,99
1657154150226,COGS 14B,A01,083073,Cheng; Tzu-Han,6,0,63,57
1657154156249,COGS 17,A01,092677,Semenuks; Arturs,4,0,81,77
1657154162272,COGS 100,A01,083619,Allen; Michael Gordon,15,0,70,55
1657154168295,COGS 101A,A01,083621,Davis; Joshua Daniel,9,0,68,59
1657154174322,COGS 101B,A01,091572,Allen; Michael Gordon,9,0,65,56
1657154180345,COGS 101C,A01,083625,Delgado; Tania,17,0,35,18
1657154186367,COGS 107A,A01,083627,Boyle; Mary E. T.,13,0,60,47
1657154192394,COGS 118A,A01,083075,Gupta; Anjum,15,0,76,61
1657154198416,CSE 3,A50,083646,Miranda; Gregory Joseph,24,0,50,26
1657154204438,CSE 8A,A50,083650,Miranda; Gregory Joseph,17,1,56,39
1657154210461,CSE 11,A01,083080,Cao; Yingjun,5,15,40,35
1657154216487,CSE 12,A01,083652,Krause-Levy; Sophia Louisa,24,1,120,96
1657154222509,CSE 15L,A01,083654,Morris; Justin Loren,9,0,50,41
1657154222509,CSE 15L,A02,083655,Morris; Justin Loren,9,0,50,41
1657154228535,CSE 20,A01,083657,Tran; Khoa Dang,38,0,80,42
1657154234558,CSE 21,A01,095574,Bach; Quang Tran,22,0,48,26
1657154240585,CSE 30,A01,083084,Eldon; John,4,0,80,76
1657154240585,CSE 30,B01,095061,Bhaskar; Nishant,7,0,50,43
1657154246614,CSE 100,A01,083659,Cao; Yingjun,4,4,70,66
1657154252638,CSE 134B,A01,083661,Powell; Thomas Allan,20,0,100,80
1657154258661,CSE 140,A01,083663,Gungor; Onat,13,0,85,72
1657154264684,CSE 140L,A01,083088,Eldon; John,17,0,100,83
1657154270708,CSE 175,A01,083665,Kumar; Rakesh,3,0,25,22
1657154276734,CSE 190,A00,092507,Dubnov; Shlomo,7,0,20,13
1657154282766,ECE 45,A01,083139,Congero; Spencer William,5,0,75,70
1657154288789,ECE 65,A50,083695,Saad; Andrew S,12,0,30,18
1657154288789,ECE 65,A51,095125,Saad; Andrew S,25,0,26,1
1657154294814,ECE 109,A01,091882,Touri; Behrouz,18,0,70,52
1657154300839,ECE 180,A00,083140,Abi Samra; Nicholas Camill,1,0,30,29
1657154300839,ECE 180,B00,083141,Abi Samra; Nicholas Camill,0,0,30,30
1657154306864,MATH 10A,A01,083735,Patchell; Gregory David,2,0,30,28
1657154306864,MATH 10A,A02,083736,Patchell; Gregory David,20,0,30,10
1657154306864,MATH 10A,A03,083737,Patchell; Gregory David,16,0,30,14
1657154312887,MATH 10B,A01,083207,Lim; Seonhee,7,0,34,27
1657154312887,MATH 10B,A02,083208,Lim; Seonhee,9,0,35,26
1657154312887,MATH 10B,A03,093472,Lim; Seonhee,5,0,34,29
1657154312887,MATH 10B,B01,083739,Sinha; Shubham,9,0,30,21
1657154318918,MATH 18,A01,083743,Cinel; Cameron Alexander,6,0,30,24
1657154318918,MATH 18,A02,083744,Cinel; Cameron Alexander,15,0,30,15
1657154318918,MATH 18,A03,083745,Cinel; Cameron Alexander,8,0,30,22
1657154318918,MATH 18,B01,083748,Rideout; David Porter,4,0,37,33
1657154318918,MATH 18,B02,083749,Rideout; David Porter,3,0,36,33
1657154318918,MATH 18,B03,083750,Rideout; David Porter,2,0,37,35
1657154318918,MATH 18,B04,083751,Rideout; David Porter,5,0,36,31
1657154318918,MATH 18,B05,093473,Rideout; David Porter,5,0,36,31
1657154318918,MATH 18,B06,093474,Rideout; David Porter,5,0,36,31
1657154324941,MATH 20A,A01,083754,Zheng; Zequn,12,0,40,28
1657154330964,MATH 20B,A01,083756,Briones; Jor-el Thomas Caparas,1,0,36,35
1657154330964,MATH 20B,A02,083757,Briones; Jor-el Thomas Caparas,1,0,36,35
1657154330964,MATH 20B,A03,093475,Briones; Jor-el Thomas Caparas,1,0,36,35
1657154336991,MATH 20C,A01,083760,Briones; Jor-el Thomas Caparas,1,0,35,34
1657154336991,MATH 20C,A02,083761,Briones; Jor-el Thomas Caparas,8,0,35,27
1657154336991,MATH 20C,A03,093476,Briones; Jor-el Thomas Caparas,0,1,36,36
1657154336991,MATH 20C,B01,083762,Bach; Quang Tran,1,0,30,29
1657154343020,MATH 20D,A01,083765,Tran; Brian Kha,4,0,30,26
1657154343020,MATH 20D,A02,083766,Tran; Brian Kha,5,0,30,25
1657154343020,MATH 20D,A03,083767,Tran; Brian Kha,3,0,30,27
1657154349043,MATH 20E,A01,083771,Ganguly; Soumya,7,0,32,25
1657154349043,MATH 20E,A02,083772,Ganguly; Soumya,7,0,32,25
1657154349043,MATH 20E,B01,083773,Ciotti; Benjamin,19,0,35,16
1657154349043,MATH 20E,B02,083774,Ciotti; Benjamin,17,0,35,18
1657154355068,MATH 103A,A01,083777,Greenfeld; Be'Eri,2,0,36,34
1657154355068,MATH 103A,A02,083778,Greenfeld; Be'Eri,5,0,36,31
1657154355068,MATH 103A,A03,093561,Greenfeld; Be'Eri,4,0,36,32
1657154355068,MATH 103A,B01,083779,Greenfeld; Be'Eri,6,0,36,30
1657154355068,MATH 103A,B02,083780,Greenfeld; Be'Eri,3,0,36,33
1657154355068,MATH 103A,B03,093562,Greenfeld; Be'Eri,3,0,36,33
1657154361091,MATH 105,A01,085443,Carter; Anne Toulson,14,0,35,21
1657154361091,MATH 105,A02,093477,Carter; Anne Toulson,20,0,35,15
1657154367119,MATH 109,A01,083213,Ganzberger; Geoffrey Michael,2,0,34,32
1657154367119,MATH 109,A02,083214,Ganzberger; Geoffrey Michael,3,0,34,31
1657154367119,MATH 109,A03,093478,Ganzberger; Geoffrey Michael,1,0,34,33
1657154367119,MATH 109,B01,083215,Ganzberger; Geoffrey Michael,1,0,32,31
1657154367119,MATH 109,B02,083216,Ganzberger; Geoffrey Michael,1,0,32,31
1657154367119,MATH 109,B03,093479,Ganzberger; Geoffrey Michael,6,0,32,26
1657154373149,MATH 142A,A01,083219,Chow; Bennett,6,0,32,26
1657154373149,MATH 142A,A02,083220,Chow; Bennett,10,0,32,22
1657154373149,MATH 142A,A03,093480,Chow; Bennett,7,0,32,25
1657154373149,MATH 142A,B03,093481,Chow; Bennett,8,0,32,24
1657154373149,MATH 142A,B04,093558,Chow; Bennett,11,0,32,21
1657154373149,MATH 142A,B05,093559,Chow; Bennett,6,0,32,26
1657154379173,MATH 193A,A01,083224,Rotar; Vladimir,7,0,34,27
1657154379173,MATH 193A,A02,083225,Rotar; Vladimir,5,0,34,29
1657154379173,MATH 193A,A03,083781,Rotar; Vladimir,1,0,34,33
1657154379173,MATH 193A,A04,083782,Rotar; Vladimir,8,0,34,26
1657154379173,MATH 193A,A05,093482,Rotar; Vladimir,6,0,34,28
1657154385207,MATH 197,001,091859,McAuley; Julian John,9999,0,9999,0
1657154385207,MATH 197,002,095566,Kedlaya; Kiran S.,9997,0,9999,2
1657154385207,MATH 197,003,095567,Xiao; Ming,9999,0,9999,0
1657154385207,MATH 197,004,095571,Perols; Johan Lars,9998,0,9999,1
1657154392258,COGS 9,A01,083615,Shannon; Kyle Michael,7,0,75,68
1657154398282,COGS 11,A01,083617,Boyle; Mary E. T.,22,0,48,26
1657154404305,COGS 13,A01,083071,Bastos; Amalia Pinkusfeld,9,0,71,62
1657154410329,COGS 14A,A01,092681,Semenuks; Arturs,1,1,100,99
1657154416356,COGS 14B,A01,083073,Cheng; Tzu-Han,6,0,63,57
1657154422383,COGS 17,A01,092677,Semenuks; Arturs,4,0,81,77
1657154428410,COGS 100,A01,083619,Allen; Michael Gordon,15,0,70,55
1657154434437,COGS 101A,A01,083621,Davis; Joshua Daniel,9,0,68,59
1657154440459,COGS 101B,A01,091572,Allen; Michael Gordon,9,0,65,56
1657154446486,COGS 101C,A01,083625,Delgado; Tania,17,0,35,18
1657154452509,COGS 107A,A01,083627,Boyle; Mary E. T.,13,0,60,47
1657154458534,COGS 118A,A01,083075,Gupta; Anjum,15,0,76,61
1657154464557,CSE 3,A50,083646,Miranda; Gregory Joseph,24,0,50,26
1657154470580,CSE 8A,A50,083650,Miranda; Gregory Joseph,17,1,56,39
1657154476602,CSE 11,A01,083080,Cao; Yingjun,5,15,40,35
1657154482627,CSE 12,A01,083652,Krause-Levy; Sophia Louisa,24,1,120,96
1657154488653,CSE 15L,A01,083654,Morris; Justin Loren,9,0,50,41
1657154488653,CSE 15L,A02,083655,Morris; Justin Loren,9,0,50,41
1657154494675,CSE 20,A01,083657,Tran; Khoa Dang,38,0,80,42
1657154500698,CSE 21,A01,095574,Bach; Quang Tran,22,0,48,26
1657154506722,CSE 30,A01,083084,Eldon; John,4,0,80,76
1657154506722,CSE 30,B01,095061,Bhaskar; Nishant,7,0,50,43
1657154512746,CSE 100,A01,083659,Cao; Yingjun,4,4,70,66
1657154518769,CSE 134B,A01,083661,Powell; Thomas Allan,20,0,100,80
1657154524791,CSE 140,A01,083663,Gungor; Onat,13,0,85,72
1657154530817,CSE 140L,A01,083088,Eldon; John,17,0,100,83
1657154536839,CSE 175,A01,083665,Kumar; Rakesh,3,0,25,22
1657154542865,CSE 190,A00,092507,Dubnov; Shlomo,7,0,20,13
1657154548893,ECE 45,A01,083139,Congero; Spencer William,5,0,75,70
1657154554914,ECE 65,A50,083695,Saad; Andrew S,12,0,30,18
1657154554914,ECE 65,A51,095125,Saad; Andrew S,25,0,26,1
1657154560937,ECE 109,A01,091882,Touri; Behrouz,18,0,70,52
1657154566959,ECE 180,A00,083140,Abi Samra; Nicholas Camill,1,0,30,29
1657154566959,ECE 180,B00,083141,Abi Samra; Nicholas Camill,0,0,30,30
1657154572982,MATH 10A,A01,083735,Patchell; Gregory David,2,0,30,28
1657154572982,MATH 10A,A02,083736,Patchell; Gregory David,20,0,30,10
1657154572982,MATH 10A,A03,083737,Patchell; Gregory David,16,0,30,14
1657154579010,MATH 10B,A01,083207,Lim; Seonhee,7,0,34,27
1657154579010,MATH 10B,A02,083208,Lim; Seonhee,9,0,35,26
1657154579010,MATH 10B,A03,093472,Lim; Seonhee,5,0,34,29
1657154579010,MATH 10B,B01,083739,Sinha; Shubham,9,0,30,21
1657154585117,MATH 18,A01,083743,Cinel; Cameron Alexander,6,0,30,24
1657154585117,MATH 18,A02,083744,Cinel; Cameron Alexander,15,0,30,15
1657154585117,MATH 18,A03,083745,Cinel; Cameron Alexander,8,0,30,22
1657154585117,MATH 18,B01,083748,Rideout; David Porter,4,0,37,33
1657154585117,MATH 18,B02,083749,Rideout; David Porter,3,0,36,33
1657154585117,MATH 18,B03,083750,Rideout; David Porter,2,0,37,35
1657154585117,MATH 18,B04,083751,Rideout; David Porter,5,0,36,31
1657154585117,MATH 18,B05,093473,Rideout; David Porter,5,0,36,31
1657154585117,MATH 18,B06,093474,Rideout; David Porter,5,0,36,31
1657154591142,MATH 20A,A01,083754,Zheng; Zequn,12,0,40,28
1657154597164,MATH 20B,A01,083756,Briones; Jor-el Thomas Caparas,1,0,36,35
1657154597164,MATH 20B,A02,083757,Briones; Jor-el Thomas Caparas,1,0,36,35
1657154597164,MATH 20B,A03,093475,Briones; Jor-el Thomas Caparas,1,0,36,35
1657154603187,MATH 20C,A01,083760,Briones; Jor-el Thomas Caparas,1,0,35,34
1657154603187,MATH 20C,A02,083761,Briones; Jor-el Thomas Caparas,8,0,35,27
1657154603187,MATH 20C,A03,093476,Briones; Jor-el Thomas Caparas,0,1,36,36
1657154603187,MATH 20C,B01,083762,Bach; Quang Tran,1,0,30,29
1657154609209,MATH 20D,A01,083765,Tran; Brian Kha,4,0,30,26
1657154609209,MATH 20D,A02,083766,Tran; Brian Kha,5,0,30,25
1657154609209,MATH 20D,A03,083767,Tran; Brian Kha,3,0,30,27
1657154615238,MATH 20E,A01,083771,Ganguly; Soumya,7,0,32,25
1657154615238,MATH 20E,A02,083772,Ganguly; Soumya,7,0,32,25
1657154615238,MATH 20E,B01,083773,Ciotti; Benjamin,19,0,35,16
1657154615238,MATH 20E,B02,083774,Ciotti; Benjamin,17,0,35,18
1657154621268,MATH 103A,A01,083777,Greenfeld; Be'Eri,2,0,36,34
1657154621268,MATH 103A,A02,083778,Greenfeld; Be'Eri,5,0,36,31
1657154621268,MATH 103A,A03,093561,Greenfeld; Be'Eri,4,0,36,32
1657154621268,MATH 103A,B01,083779,Greenfeld; Be'Eri,6,0,36,30
1657154621268,MATH 103A,B02,083780,Greenfeld; Be'Eri,3,0,36,33
1657154621268,MATH 103A,B03,093562,Greenfeld; Be'Eri,3,0,36,33
1657154627291,MATH 105,A01,085443,Carter; Anne Toulson,14,0,35,21
1657154627291,MATH 105,A02,093477,Carter; Anne Toulson,20,0,35,15
1657154633316,MATH 109,A01,083213,Ganzberger; Geoffrey Michael,2,0,34,32
1657154633316,MATH 109,A02,083214,Ganzberger; Geoffrey Michael,3,0,34,31
1657154633316,MATH 109,A03,093478,Ganzberger; Geoffrey Michael,1,0,34,33
1657154633316,MATH 109,B01,083215,Ganzberger; Geoffrey Michael,1,0,32,31
1657154633316,MATH 109,B02,083216,Ganzberger; Geoffrey Michael,1,0,32,31
1657154633316,MATH 109,B03,093479,Ganzberger; Geoffrey Michael,6,0,32,26
1657154639344,MATH 142A,A01,083219,Chow; Bennett,6,0,32,26
1657154639344,MATH 142A,A02,083220,Chow; Bennett,10,0,32,22
1657154639344,MATH 142A,A03,093480,Chow; Bennett,7,0,32,25
1657154639344,MATH 142A,B03,093481,Chow; Bennett,8,0,32,24
1657154639344,MATH 142A,B04,093558,Chow; Bennett,11,0,32,21
1657154639344,MATH 142A,B05,093559,Chow; Bennett,6,0,32,26
1657154645370,MATH 193A,A01,083224,Rotar; Vladimir,7,0,34,27
1657154645370,MATH 193A,A02,083225,Rotar; Vladimir,5,0,34,29
1657154645370,MATH 193A,A03,083781,Rotar; Vladimir,1,0,34,33
1657154645370,MATH 193A,A04,083782,Rotar; Vladimir,8,0,34,26
1657154645370,MATH 193A,A05,093482,Rotar; Vladimir,6,0,34,28
1657154651397,MATH 197,001,091859,McAuley; Julian John,9999,0,9999,0
1657154651397,MATH 197,002,095566,Kedlaya; Kiran S.,9997,0,9999,2
1657154651397,MATH 197,003,095567,Xiao; Ming,9999,0,9999,0
1657154651397,MATH 197,004,095571,Perols; Johan Lars,9998,0,9999,1
1657154658452,COGS 9,A01,083615,Shannon; Kyle Michael,7,0,75,68
1657154664474,COGS 11,A01,083617,Boyle; Mary E. T.,22,0,48,26
1657154670498,COGS 13,A01,083071,Bastos; Amalia Pinkusfeld,9,0,71,62
1657154676519,COGS 14A,A01,092681,Semenuks; Arturs,1,1,100,99
1657154682546,COGS 14B,A01,083073,Cheng; Tzu-Han,6,0,63,57
1657154688567,COGS 17,A01,092677,Semenuks; Arturs,4,0,81,77
1657154694605,COGS 100,A01,083619,Allen; Michael Gordon,15,0,70,55
1657154700629,COGS 101A,A01,083621,Davis; Joshua Daniel,9,0,68,59
1657154706652,COGS 101B,A01,091572,Allen; Michael Gordon,9,0,65,56
1657154712678,COGS 101C,A01,083625,Delgado; Tania,17,0,35,18
1657154718702,COGS 107A,A01,083627,Boyle; Mary E. T.,13,0,60,47
1657154724726,COGS 118A,A01,083075,Gupta; Anjum,15,0,76,61
1657154730754,CSE 3,A50,083646,Miranda; Gregory Joseph,24,0,50,26
1657154736781,CSE 8A,A50,083650,Miranda; Gregory Joseph,17,1,56,39
1657154742803,CSE 11,A01,083080,Cao; Yingjun,5,15,40,35
1657154748827,CSE 12,A01,083652,Krause-Levy; Sophia Louisa,24,1,120,96
1657154754852,CSE 15L,A01,083654,Morris; Justin Loren,9,0,50,41
1657154754852,CSE 15L,A02,083655,Morris; Justin Loren,9,0,50,41
1657154760887,CSE 20,A01,083657,Tran; Khoa Dang,38,0,80,42
1657154766914,CSE 21,A01,095574,Bach; Quang Tran,22,0,48,26
1657154772936,CSE 30,A01,083084,Eldon; John,4,0,80,76
1657154772936,CSE 30,B01,095061,Bhaskar; Nishant,7,0,50,43
1657154778963,CSE 100,A01,083659,Cao; Yingjun,4,4,70,66
1657154784987,CSE 134B,A01,083661,Powell; Thomas Allan,20,0,100,80
1657154791009,CSE 140,A01,083663,Gungor; Onat,13,0,85,72
1657154797036,CSE 140L,A01,083088,Eldon; John,17,0,100,83
1657154803058,CSE 175,A01,083665,Kumar; Rakesh,3,0,25,22
1657154809082,CSE 190,A00,092507,Dubnov; Shlomo,7,0,20,13
1657154815105,ECE 45,A01,083139,Congero; Spencer William,5,0,75,70
1657154821127,ECE 65,A50,083695,Saad; Andrew S,12,0,30,18
1657154821127,ECE 65,A51,095125,Saad; Andrew S,25,0,26,1
1657154827158,ECE 109,A01,091882,Touri; Behrouz,18,0,70,52
1657154833185,ECE 180,A00,083140,Abi Samra; Nicholas Camill,1,0,30,29
1657154833185,ECE 180,B00,083141,Abi Samra; Nicholas Camill,0,0,30,30
1657154839209,MATH 10A,A01,083735,Patchell; Gregory David,2,0,30,28
1657154839209,MATH 10A,A02,083736,Patchell; Gregory David,20,0,30,10
1657154839209,MATH 10A,A03,083737,Patchell; Gregory David,16,0,30,14
1657154845238,MATH 10B,A01,083207,Lim; Seonhee,7,0,34,27
1657154845238,MATH 10B,A02,083208,Lim; Seonhee,9,0,35,26
1657154845238,MATH 10B,A03,093472,Lim; Seonhee,5,0,34,29
1657154845238,MATH 10B,B01,083739,Sinha; Shubham,9,0,30,21
1657154851264,MATH 18,A01,083743,Cinel; Cameron Alexander,6,0,30,24
1657154851264,MATH 18,A02,083744,Cinel; Cameron Alexander,15,0,30,15
1657154851264,MATH 18,A03,083745,Cinel; Cameron Alexander,8,0,30,22
1657154851264,MATH 18,B01,083748,Rideout; David Porter,4,0,37,33
1657154851264,MATH 18,B02,083749,Rideout; David Porter,3,0,36,33
1657154851264,MATH 18,B03,083750,Rideout; David Porter,2,0,37,35
1657154851264,MATH 18,B04,083751,Rideout; David Porter,5,0,36,31
1657154851264,MATH 18,B05,093473,Rideout; David Porter,5,0,36,31
1657154851264,MATH 18,B06,093474,Rideout; David Porter,5,0,36,31
1657154857297,MATH 20A,A01,083754,Zheng; Zequn,12,0,40,28
1657154863326,MATH 20B,A01,083756,Briones; Jor-el Thomas Caparas,1,0,36,35
1657154863326,MATH 20B,A02,083757,Briones; Jor-el Thomas Caparas,1,0,36,35
1657154863326,MATH 20B,A03,093475,Briones; Jor-el Thomas Caparas,1,0,36,35
1657154869353,MATH 20C,A01,083760,Briones; Jor-el Thomas Caparas,1,0,35,34
1657154869353,MATH 20C,A02,083761,Briones; Jor-el Thomas Caparas,8,0,35,27
1657154869353,MATH 20C,A03,093476,Briones; Jor-el Thomas Caparas,0,1,36,36
1657154869353,MATH 20C,B01,083762,Bach; Quang Tran,1,0,30,29
1657154875377,MATH 20D,A01,083765,Tran; Brian Kha,4,0,30,26
1657154875377,MATH 20D,A02,083766,Tran; Brian Kha,5,0,30,25
1657154875377,MATH 20D,A03,083767,Tran; Brian Kha,3,0,30,27
1657154881402,MATH 20E,A01,083771,Ganguly; Soumya,7,0,32,25
1657154881402,MATH 20E,A02,083772,Ganguly; Soumya,7,0,32,25
1657154881402,MATH 20E,B01,083773,Ciotti; Benjamin,19,0,35,16
1657154881402,MATH 20E,B02,083774,Ciotti; Benjamin,17,0,35,18
1657154887428,MATH 103A,A01,083777,Greenfeld; Be'Eri,2,0,36,34
1657154887428,MATH 103A,A02,083778,Greenfeld; Be'Eri,5,0,36,31
1657154887428,MATH 103A,A03,093561,Greenfeld; Be'Eri,4,0,36,32
1657154887428,MATH 103A,B01,083779,Greenfeld; Be'Eri,6,0,36,30
1657154887428,MATH 103A,B02,083780,Greenfeld; Be'Eri,3,0,36,33
1657154887428,MATH 103A,B03,093562,Greenfeld; Be'Eri,3,0,36,33
1657154893452,MATH 105,A01,085443,Carter; Anne Toulson,14,0,35,21
1657154893452,MATH 105,A02,093477,Carter; Anne Toulson,20,0,35,15
1657154899480,MATH 109,A01,083213,Ganzberger; Geoffrey Michael,2,0,34,32
1657154899480,MATH 109,A02,083214,Ganzberger; Geoffrey Michael,3,0,34,31
1657154899480,MATH 109,A03,093478,Ganzberger; Geoffrey Michael,1,0,34,33
1657154899480,MATH 109,B01,083215,Ganzberger; Geoffrey Michael,1,0,32,31
1657154899480,MATH 109,B02,083216,Ganzberger; Geoffrey Michael,1,0,32,31
1657154899480,MATH 109,B03,093479,Ganzberger; Geoffrey Michael,6,0,32,26
1657154905514,MATH 142A,A01,083219,Chow; Bennett,6,0,32,26
1657154905514,MATH 142A,A02,083220,Chow; Bennett,10,0,32,22
1657154905514,MATH 142A,A03,093480,Chow; Bennett,7,0,32,25
1657154905514,MATH 142A,B03,093481,Chow; Bennett,8,0,32,24
1657154905514,MATH 142A,B04,093558,Chow; Bennett,11,0,32,21
1657154905514,MATH 142A,B05,093559,Chow; Bennett,6,0,32,26
1657154911547,MATH 193A,A01,083224,Rotar; Vladimir,7,0,34,27
1657154911547,MATH 193A,A02,083225,Rotar; Vladimir,5,0,34,29
1657154911547,MATH 193A,A03,083781,Rotar; Vladimir,1,0,34,33
1657154911547,MATH 193A,A04,083782,Rotar; Vladimir,8,0,34,26
1657154911547,MATH 193A,A05,093482,Rotar; Vladimir,6,0,34,28
1657154917578,MATH 197,001,091859,McAuley; Julian John,9999,0,9999,0
1657154917578,MATH 197,002,095566,Kedlaya; Kiran S.,9997,0,9999,2
1657154917578,MATH 197,003,095567,Xiao; Ming,9999,0,9999,0
1657154917578,MATH 197,004,095571,Perols; Johan Lars,9998,0,9999,1
1657154924635,COGS 9,A01,083615,Shannon; Kyle Michael,7,0,75,68
1657154930671,COGS 11,A01,083617,Boyle; Mary E. T.,22,0,48,26
1657154936693,COGS 13,A01,083071,Bastos; Amalia Pinkusfeld,9,0,71,62
1657154942722,COGS 14A,A01,092681,Semenuks; Arturs,1,1,100,99
1657154948750,COGS 14B,A01,083073,Cheng; Tzu-Han,6,0,63,57
1657154954775,COGS 17,A01,092677,Semenuks; Arturs,4,0,81,77
1657154960797,COGS 100,A01,083619,Allen; Michael Gordon,15,0,70,55
1657154966827,COGS 101A,A01,083621,Davis; Joshua Daniel,9,0,68,59
1657154972863,COGS 101B,A01,091572,Allen; Michael Gordon,9,0,65,56
1657154978894,COGS 101C,A01,083625,Delgado; Tania,17,0,35,18
1657154984917,COGS 107A,A01,083627,Boyle; Mary E. T.,13,0,60,47
1657154990943,COGS 118A,A01,083075,Gupta; Anjum,15,0,76,61
1657154996965,CSE 3,A50,083646,Miranda; Gregory Joseph,24,0,50,26
1657155002988,CSE 8A,A50,083650,Miranda; Gregory Joseph,17,1,56,39
1657155009013,CSE 11,A01,083080,Cao; Yingjun,5,15,40,35
1657155015037,CSE 12,A01,083652,Krause-Levy; Sophia Louisa,24,1,120,96
1657155021060,CSE 15L,A01,083654,Morris; Justin Loren,9,0,50,41
1657155021060,CSE 15L,A02,083655,Morris; Justin Loren,9,0,50,41
1657155027094,CSE 20,A01,083657,Tran; Khoa Dang,38,0,80,42
1657155033127,CSE 21,A01,095574,Bach; Quang Tran,22,0,48,26
1657155039153,CSE 30,A01,083084,Eldon; John,4,0,80,76
1657155039153,CSE 30,B01,095061,Bhaskar; Nishant,7,0,50,43
1657155045175,CSE 100,A01,083659,Cao; Yingjun,4,4,70,66
1657155051201,CSE 134B,A01,083661,Powell; Thomas Allan,20,0,100,80
1657155057224,CSE 140,A01,083663,Gungor; Onat,13,0,85,72
1657155063248,CSE 140L,A01,083088,Eldon; John,17,0,100,83
1657155069276,CSE 175,A01,083665,Kumar; Rakesh,3,0,25,22
1657155075300,CSE 190,A00,092507,Dubnov; Shlomo,7,0,20,13
1657155081332,ECE 45,A01,083139,Congero; Spencer William,5,0,75,70
1657155087370,ECE 65,A50,083695,Saad; Andrew S,12,0,30,18
1657155087370,ECE 65,A51,095125,Saad; Andrew S,25,0,26,1
1657155093398,ECE 109,A01,091882,Touri; Behrouz,18,0,70,52
1657155099425,ECE 180,A00,083140,Abi Samra; Nicholas Camill,1,0,30,29
1657155099425,ECE 180,B00,083141,Abi Samra; Nicholas Camill,0,0,30,30
1657155105452,MATH 10A,A01,083735,Patchell; Gregory David,2,0,30,28
1657155105452,MATH 10A,A02,083736,Patchell; Gregory David,20,0,30,10
1657155105452,MATH 10A,A03,083737,Patchell; Gregory David,16,0,30,14
1657155111477,MATH 10B,A01,083207,Lim; Seonhee,7,0,34,27
1657155111477,MATH 10B,A02,083208,Lim; Seonhee,9,0,35,26
1657155111477,MATH 10B,A03,093472,Lim; Seonhee,5,0,34,29
1657155111477,MATH 10B,B01,083739,Sinha; Shubham,9,0,30,21
1657155117500,MATH 18,A01,083743,Cinel; Cameron Alexander,6,0,30,24
1657155117500,MATH 18,A02,083744,Cinel; Cameron Alexander,15,0,30,15
1657155117500,MATH 18,A03,083745,Cinel; Cameron Alexander,8,0,30,22
1657155117500,MATH 18,B01,083748,Rideout; David Porter,4,0,37,33
1657155117500,MATH 18,B02,083749,Rideout; David Porter,3,0,36,33
1657155117500,MATH 18,B03,083750,Rideout; David Porter,2,0,37,35
1657155117500,MATH 18,B04,083751,Rideout; David Porter,5,0,36,31
1657155117500,MATH 18,B05,093473,Rideout; David Porter,5,0,36,31
1657155117500,MATH 18,B06,093474,Rideout; David Porter,5,0,36,31
1657155123524,MATH 20A,A01,083754,Zheng; Zequn,12,0,40,28
1657155129549,MATH 20B,A01,083756,Briones; Jor-el Thomas Caparas,1,0,36,35
1657155129549,MATH 20B,A02,083757,Briones; Jor-el Thomas Caparas,1,0,36,35
1657155129549,MATH 20B,A03,093475,Briones; Jor-el Thomas Caparas,1,0,36,35
1657155135570,MATH 20C,A01,083760,Briones; Jor-el Thomas Caparas,1,0,35,34
1657155135570,MATH 20C,A02,083761,Briones; Jor-el Thomas Caparas,8,0,35,27
1657155135570,MATH 20C,A03,093476,Briones; Jor-el Thomas Caparas,0,1,36,36
1657155135570,MATH 20C,B01,083762,Bach; Quang Tran,1,0,30,29
1657155141599,MATH 20D,A01,083765,Tran; Brian Kha,4,0,30,26
1657155141599,MATH 20D,A02,083766,Tran; Brian Kha,5,0,30,25
1657155141599,MATH 20D,A03,083767,Tran; Brian Kha,3,0,30,27
1657155147622,MATH 20E,A01,083771,Ganguly; Soumya,7,0,32,25
1657155147622,MATH 20E,A02,083772,Ganguly; Soumya,7,0,32,25
1657155147622,MATH 20E,B01,083773,Ciotti; Benjamin,19,0,35,16
1657155147622,MATH 20E,B02,083774,Ciotti; Benjamin,17,0,35,18
1657155153647,MATH 103A,A01,083777,Greenfeld; Be'Eri,2,0,36,34
1657155153647,MATH 103A,A02,083778,Greenfeld; Be'Eri,5,0,36,31
1657155153647,MATH 103A,A03,093561,Greenfeld; Be'Eri,4,0,36,32
1657155153647,MATH 103A,B01,083779,Greenfeld; Be'Eri,6,0,36,30
1657155153647,MATH 103A,B02,083780,Greenfeld; Be'Eri,3,0,36,33
1657155153647,MATH 103A,B03,093562,Greenfeld; Be'Eri,3,0,36,33
1657155159675,MATH 105,A01,085443,Carter; Anne Toulson,14,0,35,21
1657155159675,MATH 105,A02,093477,Carter; Anne Toulson,20,0,35,15
1657155165702,MATH 109,A01,083213,Ganzberger; Geoffrey Michael,2,0,34,32
1657155165702,MATH 109,A02,083214,Ganzberger; Geoffrey Michael,3,0,34,31
1657155165702,MATH 109,A03,093478,Ganzberger; Geoffrey Michael,1,0,34,33
1657155165702,MATH 109,B01,083215,Ganzberger; Geoffrey Michael,1,0,32,31
1657155165702,MATH 109,B02,083216,Ganzberger; Geoffrey Michael,1,0,32,31
1657155165702,MATH 109,B03,093479,Ganzberger; Geoffrey Michael,6,0,32,26
1657155171726,MATH 142A,A01,083219,Chow; Bennett,6,0,32,26
1657155171726,MATH 142A,A02,083220,Chow; Bennett,10,0,32,22
1657155171726,MATH 142A,A03,093480,Chow; Bennett,7,0,32,25
1657155171726,MATH 142A,B03,093481,Chow; Bennett,8,0,32,24
1657155171726,MATH 142A,B04,093558,Chow; Bennett,11,0,32,21
1657155171726,MATH 142A,B05,093559,Chow; Bennett,6,0,32,26
1657155177750,MATH 193A,A01,083224,Rotar; Vladimir,7,0,34,27
1657155177750,MATH 193A,A02,083225,Rotar; Vladimir,5,0,34,29
1657155177750,MATH 193A,A03,083781,Rotar; Vladimir,1,0,34,33
1657155177750,MATH 193A,A04,083782,Rotar; Vladimir,8,0,34,26
1657155177750,MATH 193A,A05,093482,Rotar; Vladimir,6,0,34,28
1657155183861,MATH 197,001,091859,McAuley; Julian John,9999,0,9999,0
1657155183861,MATH 197,002,095566,Kedlaya; Kiran S.,9997,0,9999,2
1657155183861,MATH 197,003,095567,Xiao; Ming,9999,0,9999,0
1657155183861,MATH 197,004,095571,Perols; Johan Lars,9998,0,9999,1
1657155190927,COGS 9,A01,083615,Shannon; Kyle Michael,7,0,75,68
1657155196952,COGS 11,A01,083617,Boyle; Mary E. T.,22,0,48,26
1657155202979,COGS 13,A01,083071,Bastos; Amalia Pinkusfeld,9,0,71,62
1657155209021,COGS 14A,A01,092681,Semenuks; Arturs,1,1,100,99
1657155215044,COGS 14B,A01,083073,Cheng; Tzu-Han,6,0,63,57
1657155221070,COGS 17,A01,092677,Semenuks; Arturs,4,0,81,77
1657155227098,COGS 100,A01,083619,Allen; Michael Gordon,15,0,70,55
1657155233121,COGS 101A,A01,083621,Davis; Joshua Daniel,9,0,68,59
1657155239153,COGS 101B,A01,091572,Allen; Michael Gordon,9,0,65,56
1657155245179,COGS 101C,A01,083625,Delgado; Tania,17,0,35,18
1657155251204,COGS 107A,A01,083627,Boyle; Mary E. T.,13,0,60,47
1657155257230,COGS 118A,A01,083075,Gupta; Anjum,15,0,76,61
1657155263264,CSE 3,A50,083646,Miranda; Gregory Joseph,24,0,50,26
1657155269286,CSE 8A,A50,083650,Miranda; Gregory Joseph,17,1,56,39
1657155275311,CSE 11,A01,083080,Cao; Yingjun,5,15,40,35
1657155281344,CSE 12,A01,083652,Krause-Levy; Sophia Louisa,24,1,120,96
1657155287367,CSE 15L,A01,083654,Morris; Justin Loren,9,0,50,41
1657155287367,CSE 15L,A02,083655,Morris; Justin Loren,9,0,50,41
1657155293399,CSE 20,A01,083657,Tran; Khoa Dang,38,0,80,42
1657155299436,CSE 21,A01,095574,Bach; Quang Tran,22,0,48,26
1657155305471,CSE 30,A01,083084,Eldon; John,4,0,80,76
1657155305471,CSE 30,B01,095061,Bhaskar; Nishant,7,0,50,43
1657155311494,CSE 100,A01,083659,Cao; Yingjun,4,4,70,66
1657155317516,CSE 134B,A01,083661,Powell; Thomas Allan,20,0,100,80
1657155323538,CSE 140,A01,083663,Gungor; Onat,13,0,85,72
1657155329563,CSE 140L,A01,083088,Eldon; John,17,0,100,83
1657155335597,CSE 175,A01,083665,Kumar; Rakesh,3,0,25,22
1657155341627,CSE 190,A00,092507,Dubnov; Shlomo,7,0,20,13
1657155347653,ECE 45,A01,083139,Congero; Spencer William,5,0,75,70
1657155353675,ECE 65,A50,083695,Saad; Andrew S,12,0,30,18
1657155353675,ECE 65,A51,095125,Saad; Andrew S,25,0,26,1
1657155359711,ECE 109,A01,091882,Touri; Behrouz,18,0,70,52
1657155365738,ECE 180,A00,083140,Abi Samra; Nicholas Camill,1,0,30,29
1657155365738,ECE 180,B00,083141,Abi Samra; Nicholas Camill,0,0,30,30
1657155371765,MATH 10A,A01,083735,Patchell; Gregory David,2,0,30,28
1657155371765,MATH 10A,A02,083736,Patchell; Gregory David,20,0,30,10
1657155371765,MATH 10A,A03,083737,Patchell; Gregory David,16,0,30,14
1657155377790,MATH 10B,A01,083207,Lim; Seonhee,7,0,34,27
1657155377790,MATH 10B,A02,083208,Lim; Seonhee,9,0,35,26
1657155377790,MATH 10B,A03,093472,Lim; Seonhee,5,0,34,29
1657155377790,MATH 10B,B01,083739,Sinha; Shubham,9,0,30,21
1657155383815,MATH 18,A01,083743,Cinel; Cameron Alexander,6,0,30,24
1657155383815,MATH 18,A02,083744,Cinel; Cameron Alexander,15,0,30,15
1657155383815,MATH 18,A03,083745,Cinel; Cameron Alexander,8,0,30,22
1657155383815,MATH 18,B01,083748,Rideout; David Porter,4,0,37,33
1657155383815,MATH 18,B02,083749,Rideout; David Porter,3,0,36,33
1657155383815,MATH 18,B03,083750,Rideout; David Porter,2,0,37,35
1657155383815,MATH 18,B04,083751,Rideout; David Porter,5,0,36,31
1657155383815,MATH 18,B05,093473,Rideout; David Porter,5,0,36,31
1657155383815,MATH 18,B06,093474,Rideout; David Porter,5,0,36,31
1657155389838,MATH 20A,A01,083754,Zheng; Zequn,12,0,40,28
1657155395863,MATH 20B,A01,083756,Briones; Jor-el Thomas Caparas,1,0,36,35
1657155395863,MATH 20B,A02,083757,Briones; Jor-el Thomas Caparas,1,0,36,35
1657155395863,MATH 20B,A03,093475,Briones; Jor-el Thomas Caparas,1,0,36,35
1657155401892,MATH 20C,A01,083760,Briones; Jor-el Thomas Caparas,1,0,35,34
1657155401892,MATH 20C,A02,083761,Briones; Jor-el Thomas Caparas,8,0,35,27
1657155401892,MATH 20C,A03,093476,Briones; Jor-el Thomas Caparas,0,1,36,36
1657155401892,MATH 20C,B01,083762,Bach; Quang Tran,1,0,30,29
1657155407915,MATH 20D,A01,083765,Tran; Brian Kha,4,0,30,26
1657155407915,MATH 20D,A02,083766,Tran; Brian Kha,5,0,30,25
1657155407915,MATH 20D,A03,083767,Tran; Brian Kha,3,0,30,27
1657155413943,MATH 20E,A01,083771,Ganguly; Soumya,7,0,32,25
1657155413943,MATH 20E,A02,083772,Ganguly; Soumya,7,0,32,25
1657155413943,MATH 20E,B01,083773,Ciotti; Benjamin,19,0,35,16
1657155413943,MATH 20E,B02,083774,Ciotti; Benjamin,17,0,35,18
1657155419973,MATH 103A,A01,083777,Greenfeld; Be'Eri,2,0,36,34
1657155419973,MATH 103A,A02,083778,Greenfeld; Be'Eri,5,0,36,31
1657155419973,MATH 103A,A03,093561,Greenfeld; Be'Eri,4,0,36,32
1657155419973,MATH 103A,B01,083779,Greenfeld; Be'Eri,6,0,36,30
1657155419973,MATH 103A,B02,083780,Greenfeld; Be'Eri,3,0,36,33
1657155419973,MATH 103A,B03,093562,Greenfeld; Be'Eri,3,0,36,33
1657155426000,MATH 105,A01,085443,Carter; Anne Toulson,14,0,35,21
1657155426000,MATH 105,A02,093477,Carter; Anne Toulson,20,0,35,15
1657155432022,MATH 109,A01,083213,Ganzberger; Geoffrey Michael,2,0,34,32
1657155432022,MATH 109,A02,083214,Ganzberger; Geoffrey Michael,3,0,34,31
1657155432022,MATH 109,A03,093478,Ganzberger; Geoffrey Michael,1,0,34,33
1657155432022,MATH 109,B01,083215,Ganzberger; Geoffrey Michael,1,0,32,31
1657155432022,MATH 109,B02,083216,Ganzberger; Geoffrey Michael,1,0,32,31
1657155432022,MATH 109,B03,093479,Ganzberger; Geoffrey Michael,6,0,32,26
1657155438050,MATH 142A,A01,083219,Chow; Bennett,6,0,32,26
1657155438050,MATH 142A,A02,083220,Chow; Bennett,10,0,32,22
1657155438050,MATH 142A,A03,093480,Chow; Bennett,7,0,32,25
1657155438050,MATH 142A,B03,093481,Chow; Bennett,8,0,32,24
1657155438050,MATH 142A,B04,093558,Chow; Bennett,11,0,32,21
1657155438050,MATH 142A,B05,093559,Chow; Bennett,6,0,32,26
1657155444078,MATH 193A,A01,083224,Rotar; Vladimir,7,0,34,27
1657155444078,MATH 193A,A02,083225,Rotar; Vladimir,5,0,34,29
1657155444078,MATH 193A,A03,083781,Rotar; Vladimir,1,0,34,33
1657155444078,MATH 193A,A04,083782,Rotar; Vladimir,8,0,34,26
1657155444078,MATH 193A,A05,093482,Rotar; Vladimir,6,0,34,28
1657155450105,MATH 197,001,091859,McAuley; Julian John,9999,0,9999,0
1657155450105,MATH 197,002,095566,Kedlaya; Kiran S.,9997,0,9999,2
1657155450105,MATH 197,003,095567,Xiao; Ming,9999,0,9999,0
1657155450105,MATH 197,004,095571,Perols; Johan Lars,9998,0,9999,1
1657155457162,COGS 9,A01,083615,Shannon; Kyle Michael,7,0,75,68
1657155463185,COGS 11,A01,083617,Boyle; Mary E. T.,22,0,48,26
1657155469208,COGS 13,A01,083071,Bastos; Amalia Pinkusfeld,9,0,71,62
1657155475231,COGS 14A,A01,092681,Semenuks; Arturs,1,1,100,99
1657155481253,COGS 14B,A01,083073,Cheng; Tzu-Han,6,0,63,57
1657155487276,COGS 17,A01,092677,Semenuks; Arturs,4,0,81,77
1657155493303,COGS 100,A01,083619,Allen; Michael Gordon,15,0,70,55
1657155499340,COGS 101A,A01,083621,Davis; Joshua Daniel,9,0,68,59
1657155505369,COGS 101B,A01,091572,Allen; Michael Gordon,9,0,65,56
1657155511397,COGS 101C,A01,083625,Delgado; Tania,17,0,35,18
1657155517419,COGS 107A,A01,083627,Boyle; Mary E. T.,13,0,60,47
1657155523444,COGS 118A,A01,083075,Gupta; Anjum,15,0,76,61
1657155529468,CSE 3,A50,083646,Miranda; Gregory Joseph,24,0,50,26
1657155535498,CSE 8A,A50,083650,Miranda; Gregory Joseph,17,1,56,39
1657155541522,CSE 11,A01,083080,Cao; Yingjun,5,15,40,35
1657155547547,CSE 12,A01,083652,Krause-Levy; Sophia Louisa,24,1,120,96
1657155553569,CSE 15L,A01,083654,Morris; Justin Loren,9,0,50,41
1657155553569,CSE 15L,A02,083655,Morris; Justin Loren,9,0,50,41
1657155559594,CSE 20,A01,083657,Tran; Khoa Dang,38,0,80,42
1657155565617,CSE 21,A01,095574,Bach; Quang Tran,22,0,48,26
1657155571646,CSE 30,A01,083084,Eldon; John,4,0,80,76
1657155571646,CSE 30,B01,095061,Bhaskar; Nishant,7,0,50,43
1657155577688,CSE 100,A01,083659,Cao; Yingjun,4,4,70,66
1657155583710,CSE 134B,A01,083661,Powell; Thomas Allan,20,0,100,80
1657155589731,CSE 140,A01,083663,Gungor; Onat,13,0,85,72
1657155595753,CSE 140L,A01,083088,Eldon; John,17,0,100,83
1657155601778,CSE 175,A01,083665,Kumar; Rakesh,3,0,25,22
1657155607800,CSE 190,A00,092507,Dubnov; Shlomo,7,0,20,13
1657155613827,ECE 45,A01,083139,Congero; Spencer William,5,0,75,70
1657155619862,ECE 65,A50,083695,Saad; Andrew S,12,0,30,18
1657155619862,ECE 65,A51,095125,Saad; Andrew S,25,0,26,1
1657155625888,ECE 109,A01,091882,Touri; Behrouz,18,0,70,52
1657155631914,ECE 180,A00,083140,Abi Samra; Nicholas Camill,1,0,30,29
1657155631914,ECE 180,B00,083141,Abi Samra; Nicholas Camill,0,0,30,30
1657155637938,MATH 10A,A01,083735,Patchell; Gregory David,2,0,30,28
1657155637938,MATH 10A,A02,083736,Patchell; Gregory David,20,0,30,10
1657155637938,MATH 10A,A03,083737,Patchell; Gregory David,16,0,30,14
1657155643969,MATH 10B,A01,083207,Lim; Seonhee,7,0,34,27
1657155643969,MATH 10B,A02,083208,Lim; Seonhee,9,0,35,26
1657155643969,MATH 10B,A03,093472,Lim; Seonhee,5,0,34,29
1657155643969,MATH 10B,B01,083739,Sinha; Shubham,9,0,30,21
1657155649995,MATH 18,A01,083743,Cinel; Cameron Alexander,6,0,30,24
1657155649995,MATH 18,A02,083744,Cinel; Cameron Alexander,15,0,30,15
1657155649995,MATH 18,A03,083745,Cinel; Cameron Alexander,8,0,30,22
1657155649995,MATH 18,B01,083748,Rideout; David Porter,4,0,37,33
1657155649995,MATH 18,B02,083749,Rideout; David Porter,3,0,36,33
1657155649995,MATH 18,B03,083750,Rideout; David Porter,2,0,37,35
1657155649995,MATH 18,B04,083751,Rideout; David Porter,5,0,36,31
1657155649995,MATH 18,B05,093473,Rideout; David Porter,5,0,36,31
1657155649995,MATH 18,B06,093474,Rideout; David Porter,5,0,36,31
1657155656017,MATH 20A,A01,083754,Zheng; Zequn,12,0,40,28
1657155662054,MATH 20B,A01,083756,Briones; Jor-el Thomas Caparas,1,0,36,35
1657155662054,MATH 20B,A02,083757,Briones; Jor-el Thomas Caparas,1,0,36,35
1657155662054,MATH 20B,A03,093475,Briones; Jor-el Thomas Caparas,1,0,36,35
1657155668079,MATH 20C,A01,083760,Briones; Jor-el Thomas Caparas,1,0,35,34
1657155668079,MATH 20C,A02,083761,Briones; Jor-el Thomas Caparas,8,0,35,27
1657155668079,MATH 20C,A03,093476,Briones; Jor-el Thomas Caparas,0,1,36,36
1657155668079,MATH 20C,B01,083762,Bach; Quang Tran,1,0,30,29
1657155674104,MATH 20D,A01,083765,Tran; Brian Kha,4,0,30,26
1657155674104,MATH 20D,A02,083766,Tran; Brian Kha,5,0,30,25
1657155674104,MATH 20D,A03,083767,Tran; Brian Kha,3,0,30,27
1657155680127,MATH 20E,A01,083771,Ganguly; Soumya,7,0,32,25
1657155680127,MATH 20E,A02,083772,Ganguly; Soumya,7,0,32,25
1657155680127,MATH 20E,B01,083773,Ciotti; Benjamin,19,0,35,16
1657155680127,MATH 20E,B02,083774,Ciotti; Benjamin,17,0,35,18
1657155686154,MATH 103A,A01,083777,Greenfeld; Be'Eri,2,0,36,34
1657155686154,MATH 103A,A02,083778,Greenfeld; Be'Eri,5,0,36,31
1657155686154,MATH 103A,A03,093561,Greenfeld; Be'Eri,4,0,36,32
1657155686154,MATH 103A,B01,083779,Greenfeld; Be'Eri,6,0,36,30
1657155686154,MATH 103A,B02,083780,Greenfeld; Be'Eri,3,0,36,33
1657155686154,MATH 103A,B03,093562,Greenfeld; Be'Eri,3,0,36,33
1657155692176,MATH 105,A01,085443,Carter; Anne Toulson,14,0,35,21
1657155692176,MATH 105,A02,093477,Carter; Anne Toulson,20,0,35,15
1657155698200,MATH 109,A01,083213,Ganzberger; Geoffrey Michael,2,0,34,32
1657155698200,MATH 109,A02,083214,Ganzberger; Geoffrey Michael,3,0,34,31
1657155698200,MATH 109,A03,093478,Ganzberger; Geoffrey Michael,1,0,34,33
1657155698200,MATH 109,B01,083215,Ganzberger; Geoffrey Michael,1,0,32,31
1657155698200,MATH 109,B02,083216,Ganzberger; Geoffrey Michael,1,0,32,31
1657155698200,MATH 109,B03,093479,Ganzberger; Geoffrey Michael,6,0,32,26
1657155704231,MATH 142A,A01,083219,Chow; Bennett,6,0,32,26
1657155704231,MATH 142A,A02,083220,Chow; Bennett,10,0,32,22
1657155704231,MATH 142A,A03,093480,Chow; Bennett,7,0,32,25
1657155704231,MATH 142A,B03,093481,Chow; Bennett,8,0,32,24
1657155704231,MATH 142A,B04,093558,Chow; Bennett,11,0,32,21
1657155704231,MATH 142A,B05,093559,Chow; Bennett,6,0,32,26
1657155710259,MATH 193A,A01,083224,Rotar; Vladimir,7,0,34,27
1657155710259,MATH 193A,A02,083225,Rotar; Vladimir,5,0,34,29
1657155710259,MATH 193A,A03,083781,Rotar; Vladimir,1,0,34,33
1657155710259,MATH 193A,A04,083782,Rotar; Vladimir,8,0,34,26
1657155710259,MATH 193A,A05,093482,Rotar; Vladimir,6,0,34,28
1657155716283,MATH 197,001,091859,McAuley; Julian John,9999,0,9999,0
1657155716283,MATH 197,002,095566,Kedlaya; Kiran S.,9997,0,9999,2
1657155716283,MATH 197,003,095567,Xiao; Ming,9999,0,9999,0
1657155716283,MATH 197,004,095571,Perols; Johan Lars,9998,0,9999,1
1657155723360,COGS 9,A01,083615,Shannon; Kyle Michael,7,0,75,68
1657155729387,COGS 11,A01,083617,Boyle; Mary E. T.,22,0,48,26
1657155735409,COGS 13,A01,083071,Bastos; Amalia Pinkusfeld,9,0,71,62
1657155741434,COGS 14A,A01,092681,Semenuks; Arturs,1,1,100,99
1657155747456,COGS 14B,A01,083073,Cheng; Tzu-Han,6,0,63,57
1657155753486,COGS 17,A01,092677,Semenuks; Arturs,4,0,81,77
1657155759510,COGS 100,A01,083619,Allen; Michael Gordon,15,0,70,55
1657155765538,COGS 101A,A01,083621,Davis; Joshua Daniel,9,0,68,59
1657155771564,COGS 101B,A01,091572,Allen; Michael Gordon,9,0,65,56
1657155777666,COGS 101C,A01,083625,Delgado; Tania,17,0,35,18
1657155783692,COGS 107A,A01,083627,Boyle; Mary E. T.,13,0,60,47
1657155789716,COGS 118A,A01,083075,Gupta; Anjum,15,0,76,61
1657155795742,CSE 3,A50,083646,Miranda; Gregory Joseph,24,0,50,26
1657155801773,CSE 8A,A50,083650,Miranda; Gregory Joseph,17,1,56,39
1657155807796,CSE 11,A01,083080,Cao; Yingjun,5,15,40,35
1657155813823,CSE 12,A01,083652,Krause-Levy; Sophia Louisa,24,1,120,96
1657155819846,CSE 15L,A01,083654,Morris; Justin Loren,9,0,50,41
1657155819846,CSE 15L,A02,083655,Morris; Justin Loren,9,0,50,41
1657155825869,CSE 20,A01,083657,Tran; Khoa Dang,38,0,80,42
1657155831896,CSE 21,A01,095574,Bach; Quang Tran,22,0,48,26
1657155837930,CSE 30,A01,083084,Eldon; John,4,0,80,76
1657155837930,CSE 30,B01,095061,Bhaskar; Nishant,7,0,50,43
1657155843957,CSE 100,A01,083659,Cao; Yingjun,4,4,70,66
1657155849988,CSE 134B,A01,083661,Powell; Thomas Allan,20,0,100,80
1657155856010,CSE 140,A01,083663,Gungor; Onat,13,0,85,72
1657155862034,CSE 140L,A01,083088,Eldon; John,17,0,100,83
1657155868061,CSE 175,A01,083665,Kumar; Rakesh,3,0,25,22
1657155874084,CSE 190,A00,092507,Dubnov; Shlomo,7,0,20,13
1657155880120,ECE 45,A01,083139,Congero; Spencer William,5,0,75,70
1657155886145,ECE 65,A50,083695,Saad; Andrew S,12,0,30,18
1657155886145,ECE 65,A51,095125,Saad; Andrew S,25,0,26,1
1657155892176,ECE 109,A01,091882,Touri; Behrouz,18,0,70,52
1657155898200,ECE 180,A00,083140,Abi Samra; Nicholas Camill,1,0,30,29
1657155898200,ECE 180,B00,083141,Abi Samra; Nicholas Camill,0,0,30,30
1657155904224,MATH 10A,A01,083735,Patchell; Gregory David,2,0,30,28
1657155904224,MATH 10A,A02,083736,Patchell; Gregory David,20,0,30,10
1657155904224,MATH 10A,A03,083737,Patchell; Gregory David,16,0,30,14
1657155910251,MATH 10B,A01,083207,Lim; Seonhee,7,0,34,27
1657155910251,MATH 10B,A02,083208,Lim; Seonhee,9,0,35,26
1657155910251,MATH 10B,A03,093472,Lim; Seonhee,5,0,34,29
1657155910251,MATH 10B,B01,083739,Sinha; Shubham,9,0,30,21
1657155916283,MATH 18,A01,083743,Cinel; Cameron Alexander,6,0,30,24
1657155916283,MATH 18,A02,083744,Cinel; Cameron Alexander,15,0,30,15
1657155916283,MATH 18,A03,083745,Cinel; Cameron Alexander,8,0,30,22
1657155916283,MATH 18,B01,083748,Rideout; David Porter,4,0,37,33
1657155916283,MATH 18,B02,083749,Rideout; David Porter,3,0,36,33
1657155916283,MATH 18,B03,083750,Rideout; David Porter,2,0,37,35
1657155916283,MATH 18,B04,083751,Rideout; David Porter,5,0,36,31
1657155916283,MATH 18,B05,093473,Rideout; David Porter,5,0,36,31
1657155916283,MATH 18,B06,093474,Rideout; David Porter,5,0,36,31
1657155922307,MATH 20A,A01,083754,Zheng; Zequn,12,0,40,28
1657155928333,MATH 20B,A01,083756,Briones; Jor-el Thomas Caparas,1,0,36,35
1657155928333,MATH 20B,A02,083757,Briones; Jor-el Thomas Caparas,1,0,36,35
1657155928333,MATH 20B,A03,093475,Briones; Jor-el Thomas Caparas,1,0,36,35
1657155934365,MATH 20C,A01,083760,Briones; Jor-el Thomas Caparas,1,0,35,34
1657155934365,MATH 20C,A02,083761,Briones; Jor-el Thomas Caparas,8,0,35,27
1657155934365,MATH 20C,A03,093476,Briones; Jor-el Thomas Caparas,0,1,36,36
1657155934365,MATH 20C,B01,083762,Bach; Quang Tran,1,0,30,29
1657155940392,MATH 20D,A01,083765,Tran; Brian Kha,4,0,30,26
1657155940392,MATH 20D,A02,083766,Tran; Brian Kha,5,0,30,25
1657155940392,MATH 20D,A03,083767,Tran; Brian Kha,3,0,30,27
1657155946416,MATH 20E,A01,083771,Ganguly; Soumya,7,0,32,25
1657155946416,MATH 20E,A02,083772,Ganguly; Soumya,7,0,32,25
1657155946416,MATH 20E,B01,083773,Ciotti; Benjamin,19,0,35,16
1657155946416,MATH 20E,B02,083774,Ciotti; Benjamin,17,0,35,18
1657155952447,MATH 103A,A01,083777,Greenfeld; Be'Eri,2,0,36,34
1657155952447,MATH 103A,A02,083778,Greenfeld; Be'Eri,5,0,36,31
1657155952447,MATH 103A,A03,093561,Greenfeld; Be'Eri,4,0,36,32
1657155952447,MATH 103A,B01,083779,Greenfeld; Be'Eri,6,0,36,30
1657155952447,MATH 103A,B02,083780,Greenfeld; Be'Eri,3,0,36,33
1657155952447,MATH 103A,B03,093562,Greenfeld; Be'Eri,3,0,36,33
1657155958475,MATH 105,A01,085443,Carter; Anne Toulson,14,0,35,21
1657155958475,MATH 105,A02,093477,Carter; Anne Toulson,20,0,35,15
1657155964505,MATH 109,A01,083213,Ganzberger; Geoffrey Michael,2,0,34,32
1657155964505,MATH 109,A02,083214,Ganzberger; Geoffrey Michael,3,0,34,31
1657155964505,MATH 109,A03,093478,Ganzberger; Geoffrey Michael,1,0,34,33
1657155964505,MATH 109,B01,083215,Ganzberger; Geoffrey Michael,1,0,32,31
1657155964505,MATH 109,B02,083216,Ganzberger; Geoffrey Michael,1,0,32,31
1657155964505,MATH 109,B03,093479,Ganzberger; Geoffrey Michael,6,0,32,26
1657155970529,MATH 142A,A01,083219,Chow; Bennett,6,0,32,26
1657155970529,MATH 142A,A02,083220,Chow; Bennett,10,0,32,22
1657155970529,MATH 142A,A03,093480,Chow; Bennett,7,0,32,25
1657155970529,MATH 142A,B03,093481,Chow; Bennett,8,0,32,24
1657155970529,MATH 142A,B04,093558,Chow; Bennett,11,0,32,21
1657155970529,MATH 142A,B05,093559,Chow; Bennett,6,0,32,26
1657155976560,MATH 193A,A01,083224,Rotar; Vladimir,7,0,34,27
1657155976560,MATH 193A,A02,083225,Rotar; Vladimir,5,0,34,29
1657155976560,MATH 193A,A03,083781,Rotar; Vladimir,1,0,34,33
1657155976560,MATH 193A,A04,083782,Rotar; Vladimir,8,0,34,26
1657155976560,MATH 193A,A05,093482,Rotar; Vladimir,6,0,34,28
1657155982582,MATH 197,001,091859,McAuley; Julian John,9999,0,9999,0
1657155982582,MATH 197,002,095566,Kedlaya; Kiran S.,9997,0,9999,2
1657155982582,MATH 197,003,095567,Xiao; Ming,9999,0,9999,0
1657155982582,MATH 197,004,095571,Perols; Johan Lars,9998,0,9999,1
1657155989674,COGS 9,A01,083615,Shannon; Kyle Michael,7,0,75,68
1657155995722,COGS 11,A01,083617,Boyle; Mary E. T.,22,0,48,26
1657156001750,COGS 13,A01,083071,Bastos; Amalia Pinkusfeld,9,0,71,62
1657156007782,COGS 14A,A01,092681,Semenuks; Arturs,1,1,100,99
1657156013806,COGS 14B,A01,083073,Cheng; Tzu-Han,6,0,63,57
1657156019833,COGS 17,A01,092677,Semenuks; Arturs,4,0,81,77
1657156025860,COGS 100,A01,083619,Allen; Michael Gordon,15,0,70,55
1657156031889,COGS 101A,A01,083621,Davis; Joshua Daniel,9,0,68,59
1657156037918,COGS 101B,A01,091572,Allen; Michael Gordon,9,0,65,56
1657156043943,COGS 101C,A01,083625,Delgado; Tania,17,0,35,18
1657156049971,COGS 107A,A01,083627,Boyle; Mary E. T.,13,0,60,47
1657156055998,COGS 118A,A01,083075,Gupta; Anjum,15,0,76,61
1657156062027,CSE 3,A50,083646,Miranda; Gregory Joseph,24,0,50,26
1657156068052,CSE 8A,A50,083650,Miranda; Gregory Joseph,17,1,56,39
1657156074074,CSE 11,A01,083080,Cao; Yingjun,5,15,40,35
1657156080097,CSE 12,A01,083652,Krause-Levy; Sophia Louisa,24,1,120,96
1657156086123,CSE 15L,A01,083654,Morris; Justin Loren,9,0,50,41
1657156086123,CSE 15L,A02,083655,Morris; Justin Loren,9,0,50,41
1657156092145,CSE 20,A01,083657,Tran; Khoa Dang,38,0,80,42
1657156098171,CSE 21,A01,095574,Bach; Quang Tran,22,0,48,26
1657156104207,CSE 30,A01,083084,Eldon; John,4,0,80,76
1657156104207,CSE 30,B01,095061,Bhaskar; Nishant,7,0,50,43
1657156110250,CSE 100,A01,083659,Cao; Yingjun,4,4,70,66
1657156116276,CSE 134B,A01,083661,Powell; Thomas Allan,20,0,100,80
1657156122310,CSE 140,A01,083663,Gungor; Onat,13,0,85,72
1657156128336,CSE 140L,A01,083088,Eldon; John,17,0,100,83
1657156134432,CSE 175,A01,083665,Kumar; Rakesh,3,0,25,22
1657156140453,CSE 190,A00,092507,Dubnov; Shlomo,7,0,20,13
1657156146476,ECE 45,A01,083139,Congero; Spencer William,5,0,75,70
1657156152500,ECE 65,A50,083695,Saad; Andrew S,12,0,30,18
1657156152500,ECE 65,A51,095125,Saad; Andrew S,25,0,26,1
1657156158527,ECE 109,A01,091882,Touri; Behrouz,18,0,70,52
1657156164553,ECE 180,A00,083140,Abi Samra; Nicholas Camill,1,0,30,29
1657156164553,ECE 180,B00,083141,Abi Samra; Nicholas Camill,0,0,30,30
1657156170580,MATH 10A,A01,083735,Patchell; Gregory David,2,0,30,28
1657156170580,MATH 10A,A02,083736,Patchell; Gregory David,20,0,30,10
1657156170580,MATH 10A,A03,083737,Patchell; Gregory David,16,0,30,14
1657156176605,MATH 10B,A01,083207,Lim; Seonhee,7,0,34,27
1657156176605,MATH 10B,A02,083208,Lim; Seonhee,9,0,35,26
1657156176605,MATH 10B,A03,093472,Lim; Seonhee,5,0,34,29
1657156176605,MATH 10B,B01,083739,Sinha; Shubham,9,0,30,21
1657156182637,MATH 18,A01,083743,Cinel; Cameron Alexander,6,0,30,24
1657156182637,MATH 18,A02,083744,Cinel; Cameron Alexander,15,0,30,15
1657156182637,MATH 18,A03,083745,Cinel; Cameron Alexander,8,0,30,22
1657156182637,MATH 18,B01,083748,Rideout; David Porter,4,0,37,33
1657156182637,MATH 18,B02,083749,Rideout; David Porter,3,0,36,33
1657156182637,MATH 18,B03,083750,Rideout; David Porter,2,0,37,35
1657156182637,MATH 18,B04,083751,Rideout; David Porter,5,0,36,31
1657156182637,MATH 18,B05,093473,Rideout; David Porter,5,0,36,31
1657156182637,MATH 18,B06,093474,Rideout; David Porter,5,0,36,31
1657156188663,MATH 20A,A01,083754,Zheng; Zequn,12,0,40,28
1657156194689,MATH 20B,A01,083756,Briones; Jor-el Thomas Caparas,1,0,36,35
1657156194689,MATH 20B,A02,083757,Briones; Jor-el Thomas Caparas,1,0,36,35
1657156194689,MATH 20B,A03,093475,Briones; Jor-el Thomas Caparas,1,0,36,35
1657156200712,MATH 20C,A01,083760,Briones; Jor-el Thomas Caparas,1,0,35,34
1657156200712,MATH 20C,A02,083761,Briones; Jor-el Thomas Caparas,8,0,35,27
1657156200712,MATH 20C,A03,093476,Briones; Jor-el Thomas Caparas,0,1,36,36
1657156200712,MATH 20C,B01,083762,Bach; Quang Tran,1,0,30,29
1657156206738,MATH 20D,A01,083765,Tran; Brian Kha,4,0,30,26
1657156206738,MATH 20D,A02,083766,Tran; Brian Kha,5,0,30,25
1657156206738,MATH 20D,A03,083767,Tran; Brian Kha,3,0,30,27
1657156212761,MATH 20E,A01,083771,Ganguly; Soumya,7,0,32,25
1657156212761,MATH 20E,A02,083772,Ganguly; Soumya,7,0,32,25
1657156212761,MATH 20E,B01,083773,Ciotti; Benjamin,19,0,35,16
1657156212761,MATH 20E,B02,083774,Ciotti; Benjamin,17,0,35,18
1657156218793,MATH 103A,A01,083777,Greenfeld; Be'Eri,2,0,36,34
1657156218793,MATH 103A,A02,083778,Greenfeld; Be'Eri,5,0,36,31
1657156218793,MATH 103A,A03,093561,Greenfeld; Be'Eri,4,0,36,32
1657156218793,MATH 103A,B01,083779,Greenfeld; Be'Eri,6,0,36,30
1657156218793,MATH 103A,B02,083780,Greenfeld; Be'Eri,3,0,36,33
1657156218793,MATH 103A,B03,093562,Greenfeld; Be'Eri,3,0,36,33
1657156224820,MATH 105,A01,085443,Carter; Anne Toulson,14,0,35,21
1657156224820,MATH 105,A02,093477,Carter; Anne Toulson,20,0,35,15
1657156230844,MATH 109,A01,083213,Ganzberger; Geoffrey Michael,2,0,34,32
1657156230844,MATH 109,A02,083214,Ganzberger; Geoffrey Michael,3,0,34,31
1657156230844,MATH 109,A03,093478,Ganzberger; Geoffrey Michael,1,0,34,33
1657156230844,MATH 109,B01,083215,Ganzberger; Geoffrey Michael,1,0,32,31
1657156230844,MATH 109,B02,083216,Ganzberger; Geoffrey Michael,1,0,32,31
1657156230844,MATH 109,B03,093479,Ganzberger; Geoffrey Michael,6,0,32,26
1657156236869,MATH 142A,A01,083219,Chow; Bennett,6,0,32,26
1657156236869,MATH 142A,A02,083220,Chow; Bennett,10,0,32,22
1657156236869,MATH 142A,A03,093480,Chow; Bennett,7,0,32,25
1657156236869,MATH 142A,B03,093481,Chow; Bennett,8,0,32,24
1657156236869,MATH 142A,B04,093558,Chow; Bennett,11,0,32,21
1657156236869,MATH 142A,B05,093559,Chow; Bennett,6,0,32,26
1657156242901,MATH 193A,A01,083224,Rotar; Vladimir,7,0,34,27
1657156242901,MATH 193A,A02,083225,Rotar; Vladimir,5,0,34,29
1657156242901,MATH 193A,A03,083781,Rotar; Vladimir,1,0,34,33
1657156242901,MATH 193A,A04,083782,Rotar; Vladimir,8,0,34,26
1657156242901,MATH 193A,A05,093482,Rotar; Vladimir,6,0,34,28
1657156248927,MATH 197,001,091859,McAuley; Julian John,9999,0,9999,0
1657156248927,MATH 197,002,095566,Kedlaya; Kiran S.,9997,0,9999,2
1657156248927,MATH 197,003,095567,Xiao; Ming,9999,0,9999,0
1657156248927,MATH 197,004,095571,Perols; Johan Lars,9998,0,9999,1
1657156255992,COGS 9,A01,083615,Shannon; Kyle Michael,7,0,75,68
1657156262015,COGS 11,A01,083617,Boyle; Mary E. T.,22,0,48,26
1657156268043,COGS 13,A01,083071,Bastos; Amalia Pinkusfeld,9,0,71,62
1657156274069,COGS 14A,A01,092681,Semenuks; Arturs,1,1,100,99
1657156280103,COGS 14B,A01,083073,Cheng; Tzu-Han,6,0,63,57
1657156286127,COGS 17,A01,092677,Semenuks; Arturs,4,0,81,77
1657156292155,COGS 100,A01,083619,Allen; Michael Gordon,15,0,70,55
1657156298182,COGS 101A,A01,083621,Davis; Joshua Daniel,9,0,68,59
1657156304206,COGS 101B,A01,091572,Allen; Michael Gordon,9,0,65,56
1657156310229,COGS 101C,A01,083625,Delgado; Tania,17,0,35,18
1657156316252,COGS 107A,A01,083627,Boyle; Mary E. T.,13,0,60,47
1657156322277,COGS 118A,A01,083075,Gupta; Anjum,15,0,76,61
1657156328309,CSE 3,A50,083646,Miranda; Gregory Joseph,24,0,50,26
1657156334345,CSE 8A,A50,083650,Miranda; Gregory Joseph,17,1,56,39
1657156340370,CSE 11,A01,083080,Cao; Yingjun,5,15,40,35
1657156346392,CSE 12,A01,083652,Krause-Levy; Sophia Louisa,24,1,120,96
1657156352416,CSE 15L,A01,083654,Morris; Justin Loren,9,0,50,41
1657156352416,CSE 15L,A02,083655,Morris; Justin Loren,9,0,50,41
1657156358439,CSE 20,A01,083657,Tran; Khoa Dang,38,0,80,42
1657156364466,CSE 21,A01,095574,Bach; Quang Tran,22,0,48,26
1657156370491,CSE 30,A01,083084,Eldon; John,4,0,80,76
1657156370491,CSE 30,B01,095061,Bhaskar; Nishant,7,0,50,43
1657156376601,CSE 100,A01,083659,Cao; Yingjun,4,4,70,66
1657156382631,CSE 134B,A01,083661,Powell; Thomas Allan,20,0,100,80
1657156388657,CSE 140,A01,083663,Gungor; Onat,13,0,85,72
1657156394683,CSE 140L,A01,083088,Eldon; John,17,0,100,83
1657156400719,CSE 175,A01,083665,Kumar; Rakesh,3,0,25,22
1657156406740,CSE 190,A00,092507,Dubnov; Shlomo,7,0,20,13
1657156412764,ECE 45,A01,083139,Congero; Spencer William,5,0,75,70
1657156418788,ECE 65,A50,083695,Saad; Andrew S,12,0,30,18
1657156418788,ECE 65,A51,095125,Saad; Andrew S,25,0,26,1
1657156424812,ECE 109,A01,091882,Touri; Behrouz,18,0,70,52
1657156430840,ECE 180,A00,083140,Abi Samra; Nicholas Camill,1,0,30,29
1657156430840,ECE 180,B00,083141,Abi Samra; Nicholas Camill,0,0,30,30
1657156436872,MATH 10A,A01,083735,Patchell; Gregory David,2,0,30,28
1657156436872,MATH 10A,A02,083736,Patchell; Gregory David,20,0,30,10
1657156436872,MATH 10A,A03,083737,Patchell; Gregory David,16,0,30,14
1657156442897,MATH 10B,A01,083207,Lim; Seonhee,7,0,34,27
1657156442897,MATH 10B,A02,083208,Lim; Seonhee,9,0,35,26
1657156442897,MATH 10B,A03,093472,Lim; Seonhee,5,0,34,29
1657156442897,MATH 10B,B01,083739,Sinha; Shubham,9,0,30,21
1657156448920,MATH 18,A01,083743,Cinel; Cameron Alexander,6,0,30,24
1657156448920,MATH 18,A02,083744,Cinel; Cameron Alexander,15,0,30,15
1657156448920,MATH 18,A03,083745,Cinel; Cameron Alexander,8,0,30,22
1657156448920,MATH 18,B01,083748,Rideout; David Porter,4,0,37,33
1657156448920,MATH 18,B02,083749,Rideout; David Porter,3,0,36,33
1657156448920,MATH 18,B03,083750,Rideout; David Porter,2,0,37,35
1657156448920,MATH 18,B04,083751,Rideout; David Porter,5,0,36,31
1657156448920,MATH 18,B05,093473,Rideout; David Porter,5,0,36,31
1657156448920,MATH 18,B06,093474,Rideout; David Porter,5,0,36,31
1657156454957,MATH 20A,A01,083754,Zheng; Zequn,12,0,40,28
1657156460986,MATH 20B,A01,083756,Briones; Jor-el Thomas Caparas,1,0,36,35
1657156460986,MATH 20B,A02,083757,Briones; Jor-el Thomas Caparas,1,0,36,35
1657156460986,MATH 20B,A03,093475,Briones; Jor-el Thomas Caparas,1,0,36,35
1657156467009,MATH 20C,A01,083760,Briones; Jor-el Thomas Caparas,1,0,35,34
1657156467009,MATH 20C,A02,083761,Briones; Jor-el Thomas Caparas,8,0,35,27
1657156467009,MATH 20C,A03,093476,Briones; Jor-el Thomas Caparas,0,1,36,36
1657156467009,MATH 20C,B01,083762,Bach; Quang Tran,1,0,30,29
1657156473042,MATH 20D,A01,083765,Tran; Brian Kha,4,0,30,26
1657156473042,MATH 20D,A02,083766,Tran; Brian Kha,5,0,30,25
1657156473042,MATH 20D,A03,083767,Tran; Brian Kha,3,0,30,27
1657156479070,MATH 20E,A01,083771,Ganguly; Soumya,7,0,32,25
1657156479070,MATH 20E,A02,083772,Ganguly; Soumya,7,0,32,25
1657156479070,MATH 20E,B01,083773,Ciotti; Benjamin,19,0,35,16
1657156479070,MATH 20E,B02,083774,Ciotti; Benjamin,17,0,35,18
1657156485094,MATH 103A,A01,083777,Greenfeld; Be'Eri,2,0,36,34
1657156485094,MATH 103A,A02,083778,Greenfeld; Be'Eri,5,0,36,31
1657156485094,MATH 103A,A03,093561,Greenfeld; Be'Eri,4,0,36,32
1657156485094,MATH 103A,B01,083779,Greenfeld; Be'Eri,6,0,36,30
1657156485094,MATH 103A,B02,083780,Greenfeld; Be'Eri,3,0,36,33
1657156485094,MATH 103A,B03,093562,Greenfeld; Be'Eri,3,0,36,33
1657156491115,MATH 105,A01,085443,Carter; Anne Toulson,14,0,35,21
1657156491115,MATH 105,A02,093477,Carter; Anne Toulson,20,0,35,15
1657156497140,MATH 109,A01,083213,Ganzberger; Geoffrey Michael,2,0,34,32
1657156497140,MATH 109,A02,083214,Ganzberger; Geoffrey Michael,3,0,34,31
1657156497140,MATH 109,A03,093478,Ganzberger; Geoffrey Michael,1,0,34,33
1657156497140,MATH 109,B01,083215,Ganzberger; Geoffrey Michael,1,0,32,31
1657156497140,MATH 109,B02,083216,Ganzberger; Geoffrey Michael,1,0,32,31
1657156497140,MATH 109,B03,093479,Ganzberger; Geoffrey Michael,6,0,32,26
1657156503173,MATH 142A,A01,083219,Chow; Bennett,6,0,32,26
1657156503173,MATH 142A,A02,083220,Chow; Bennett,10,0,32,22
1657156503173,MATH 142A,A03,093480,Chow; Bennett,7,0,32,25
1657156503173,MATH 142A,B03,093481,Chow; Bennett,8,0,32,24
1657156503173,MATH 142A,B04,093558,Chow; Bennett,11,0,32,21
1657156503173,MATH 142A,B05,093559,Chow; Bennett,6,0,32,26
1657156509196,MATH 193A,A01,083224,Rotar; Vladimir,7,0,34,27
1657156509196,MATH 193A,A02,083225,Rotar; Vladimir,5,0,34,29
1657156509196,MATH 193A,A03,083781,Rotar; Vladimir,1,0,34,33
1657156509196,MATH 193A,A04,083782,Rotar; Vladimir,8,0,34,26
1657156509196,MATH 193A,A05,093482,Rotar; Vladimir,6,0,34,28
1657156515218,MATH 197,001,091859,McAuley; Julian John,9999,0,9999,0
1657156515218,MATH 197,002,095566,Kedlaya; Kiran S.,9997,0,9999,2
1657156515218,MATH 197,003,095567,Xiao; Ming,9999,0,9999,0
1657156515218,MATH 197,004,095571,Perols; Johan Lars,9998,0,9999,1
1657156522280,COGS 9,A01,083615,Shannon; Kyle Michael,7,0,75,68
1657156528307,COGS 11,A01,083617,Boyle; Mary E. T.,22,0,48,26
1657156534344,COGS 13,A01,083071,Bastos; Amalia Pinkusfeld,9,0,71,62
1657156540367,COGS 14A,A01,092681,Semenuks; Arturs,1,1,100,99
1657156546394,COGS 14B,A01,083073,Cheng; Tzu-Han,6,0,63,57
1657156552418,COGS 17,A01,092677,Semenuks; Arturs,4,0,81,77
1657156558445,COGS 100,A01,083619,Allen; Michael Gordon,15,0,70,55
1657156564472,COGS 101A,A01,083621,Davis; Joshua Daniel,9,0,68,59
1657156570495,COGS 101B,A01,091572,Allen; Michael Gordon,9,0,65,56
1657156576531,COGS 101C,A01,083625,Delgado; Tania,17,0,35,18
1657156582556,COGS 107A,A01,083627,Boyle; Mary E. T.,13,0,60,47
1657156588579,COGS 118A,A01,083075,Gupta; Anjum,15,0,76,61
1657156594606,CSE 3,A50,083646,Miranda; Gregory Joseph,24,0,50,26
1657156600627,CSE 8A,A50,083650,Miranda; Gregory Joseph,17,1,56,39
1657156606648,CSE 11,A01,083080,Cao; Yingjun,5,15,40,35
1657156612671,CSE 12,A01,083652,Krause-Levy; Sophia Louisa,24,1,120,96
1657156618695,CSE 15L,A01,083654,Morris; Justin Loren,9,0,50,41
1657156618695,CSE 15L,A02,083655,Morris; Justin Loren,9,0,50,41
1657156624722,CSE 20,A01,083657,Tran; Khoa Dang,38,0,80,42
1657156630752,CSE 21,A01,095574,Bach; Quang Tran,22,0,48,26
1657156636779,CSE 30,A01,083084,Eldon; John,4,0,80,76
1657156636779,CSE 30,B01,095061,Bhaskar; Nishant,7,0,50,43
1657156642805,CSE 100,A01,083659,Cao; Yingjun,4,4,70,66
1657156648831,CSE 134B,A01,083661,Powell; Thomas Allan,20,0,100,80
1657156654855,CSE 140,A01,083663,Gungor; Onat,13,0,85,72
1657156660880,CSE 140L,A01,083088,Eldon; John,17,0,100,83
1657156666911,CSE 175,A01,083665,Kumar; Rakesh,3,0,25,22
1657156672934,CSE 190,A00,092507,Dubnov; Shlomo,7,0,20,13
1657156678983,ECE 45,A01,083139,Congero; Spencer William,5,0,75,70
1657156685007,ECE 65,A50,083695,Saad; Andrew S,12,0,30,18
1657156685007,ECE 65,A51,095125,Saad; Andrew S,25,0,26,1
1657156691037,ECE 109,A01,091882,Touri; Behrouz,18,0,70,52
1657156697059,ECE 180,A00,083140,Abi Samra; Nicholas Camill,1,0,30,29
1657156697059,ECE 180,B00,083141,Abi Samra; Nicholas Camill,0,0,30,30
1657156703086,MATH 10A,A01,083735,Patchell; Gregory David,2,0,30,28
1657156703086,MATH 10A,A02,083736,Patchell; Gregory David,20,0,30,10
1657156703086,MATH 10A,A03,083737,Patchell; Gregory David,16,0,30,14
1657156709115,MATH 10B,A01,083207,Lim; Seonhee,7,0,34,27
1657156709115,MATH 10B,A02,083208,Lim; Seonhee,9,0,35,26
1657156709115,MATH 10B,A03,093472,Lim; Seonhee,5,0,34,29
1657156709115,MATH 10B,B01,083739,Sinha; Shubham,9,0,30,21
1657156715138,MATH 18,A01,083743,Cinel; Cameron Alexander,6,0,30,24
1657156715138,MATH 18,A02,083744,Cinel; Cameron Alexander,15,0,30,15
1657156715138,MATH 18,A03,083745,Cinel; Cameron Alexander,8,0,30,22
1657156715138,MATH 18,B01,083748,Rideout; David Porter,4,0,37,33
1657156715138,MATH 18,B02,083749,Rideout; David Porter,3,0,36,33
1657156715138,MATH 18,B03,083750,Rideout; David Porter,2,0,37,35
1657156715138,MATH 18,B04,083751,Rideout; David Porter,5,0,36,31
1657156715138,MATH 18,B05,093473,Rideout; David Porter,5,0,36,31
1657156715138,MATH 18,B06,093474,Rideout; David Porter,5,0,36,31
1657156721171,MATH 20A,A01,083754,Zheng; Zequn,12,0,40,28
1657156727216,MATH 20B,A01,083756,Briones; Jor-el Thomas Caparas,1,0,36,35
1657156727216,MATH 20B,A02,083757,Briones; Jor-el Thomas Caparas,1,0,36,35
1657156727216,MATH 20B,A03,093475,Briones; Jor-el Thomas Caparas,1,0,36,35
1657156733245,MATH 20C,A01,083760,Briones; Jor-el Thomas Caparas,1,0,35,34
1657156733245,MATH 20C,A02,083761,Briones; Jor-el Thomas Caparas,8,0,35,27
1657156733245,MATH 20C,A03,093476,Briones; Jor-el Thomas Caparas,0,1,36,36
1657156733245,MATH 20C,B01,083762,Bach; Quang Tran,1,0,30,29
1657156739272,MATH 20D,A01,083765,Tran; Brian Kha,4,0,30,26
1657156739272,MATH 20D,A02,083766,Tran; Brian Kha,5,0,30,25
1657156739272,MATH 20D,A03,083767,Tran; Brian Kha,3,0,30,27
1657156745301,MATH 20E,A01,083771,Ganguly; Soumya,7,0,32,25
1657156745301,MATH 20E,A02,083772,Ganguly; Soumya,7,0,32,25
1657156745301,MATH 20E,B01,083773,Ciotti; Benjamin,19,0,35,16
1657156745301,MATH 20E,B02,083774,Ciotti; Benjamin,17,0,35,18
1657156751332,MATH 103A,A01,083777,Greenfeld; Be'Eri,2,0,36,34
1657156751332,MATH 103A,A02,083778,Greenfeld; Be'Eri,5,0,36,31
1657156751332,MATH 103A,A03,093561,Greenfeld; Be'Eri,4,0,36,32
1657156751332,MATH 103A,B01,083779,Greenfeld; Be'Eri,6,0,36,30
1657156751332,MATH 103A,B02,083780,Greenfeld; Be'Eri,3,0,36,33
1657156751332,MATH 103A,B03,093562,Greenfeld; Be'Eri,3,0,36,33
1657156757359,MATH 105,A01,085443,Carter; Anne Toulson,14,0,35,21
1657156757359,MATH 105,A02,093477,Carter; Anne Toulson,20,0,35,15
1657156763384,MATH 109,A01,083213,Ganzberger; Geoffrey Michael,2,0,34,32
1657156763384,MATH 109,A02,083214,Ganzberger; Geoffrey Michael,3,0,34,31
1657156763384,MATH 109,A03,093478,Ganzberger; Geoffrey Michael,1,0,34,33
1657156763384,MATH 109,B01,083215,Ganzberger; Geoffrey Michael,1,0,32,31
1657156763384,MATH 109,B02,083216,Ganzberger; Geoffrey Michael,1,0,32,31
1657156763384,MATH 109,B03,093479,Ganzberger; Geoffrey Michael,6,0,32,26
1657156769409,MATH 142A,A01,083219,Chow; Bennett,6,0,32,26
1657156769409,MATH 142A,A02,083220,Chow; Bennett,10,0,32,22
1657156769409,MATH 142A,A03,093480,Chow; Bennett,7,0,32,25
1657156769409,MATH 142A,B03,093481,Chow; Bennett,8,0,32,24
1657156769409,MATH 142A,B04,093558,Chow; Bennett,11,0,32,21
1657156769409,MATH 142A,B05,093559,Chow; Bennett,6,0,32,26
1657156775437,MATH 193A,A01,083224,Rotar; Vladimir,7,0,34,27
1657156775437,MATH 193A,A02,083225,Rotar; Vladimir,5,0,34,29
1657156775437,MATH 193A,A03,083781,Rotar; Vladimir,1,0,34,33
1657156775437,MATH 193A,A04,083782,Rotar; Vladimir,8,0,34,26
1657156775437,MATH 193A,A05,093482,Rotar; Vladimir,6,0,34,28
1657156781464,MATH 197,001,091859,McAuley; Julian John,9999,0,9999,0
1657156781464,MATH 197,002,095566,Kedlaya; Kiran S.,9997,0,9999,2
1657156781464,MATH 197,003,095567,Xiao; Ming,9999,0,9999,0
1657156781464,MATH 197,004,095571,Perols; Johan Lars,9998,0,9999,1
1657156788526,COGS 9,A01,083615,Shannon; Kyle Michael,7,0,75,68
1657156794549,COGS 11,A01,083617,Boyle; Mary E. T.,22,0,48,26
1657156800577,COGS 13,A01,083071,Bastos; Amalia Pinkusfeld,9,0,71,62
1657156806600,COGS 14A,A01,092681,Semenuks; Arturs,1,1,100,99
1657156812626,COGS 14B,A01,083073,Cheng; Tzu-Han,6,0,63,57
1657156818650,COGS 17,A01,092677,Semenuks; Arturs,4,0,81,77
1657156824678,COGS 100,A01,083619,Allen; Michael Gordon,15,0,70,55
1657156830702,COGS 101A,A01,083621,Davis; Joshua Daniel,9,0,68,59
1657156836734,COGS 101B,A01,091572,Allen; Michael Gordon,9,0,65,56
1657156842759,COGS 101C,A01,083625,Delgado; Tania,17,0,35,18
1657156848781,COGS 107A,A01,083627,Boyle; Mary E. T.,13,0,60,47
1657156854804,COGS 118A,A01,083075,Gupta; Anjum,15,0,76,61
1657156860834,CSE 3,A50,083646,Miranda; Gregory Joseph,24,0,50,26
1657156866862,CSE 8A,A50,083650,Miranda; Gregory Joseph,17,1,56,39
1657156872885,CSE 11,A01,083080,Cao; Yingjun,5,15,40,35
1657156878912,CSE 12,A01,083652,Krause-Levy; Sophia Louisa,24,1,120,96
1657156884939,CSE 15L,A01,083654,Morris; Justin Loren,9,0,50,41
1657156884939,CSE 15L,A02,083655,Morris; Justin Loren,9,0,50,41
1657156890969,CSE 20,A01,083657,Tran; Khoa Dang,38,0,80,42
1657156896995,CSE 21,A01,095574,Bach; Quang Tran,22,0,48,26
1657156903023,CSE 30,A01,083084,Eldon; John,4,0,80,76
1657156903023,CSE 30,B01,095061,Bhaskar; Nishant,7,0,50,43
1657156909050,CSE 100,A01,083659,Cao; Yingjun,4,4,70,66
1657156915076,CSE 134B,A01,083661,Powell; Thomas Allan,20,0,100,80
1657156921111,CSE 140,A01,083663,Gungor; Onat,13,0,85,72
1657156927135,CSE 140L,A01,083088,Eldon; John,17,0,100,83
1657156933168,CSE 175,A01,083665,Kumar; Rakesh,3,0,25,22
1657156939191,CSE 190,A00,092507,Dubnov; Shlomo,7,0,20,13
1657156945225,ECE 45,A01,083139,Congero; Spencer William,5,0,75,70
1657156951249,ECE 65,A50,083695,Saad; Andrew S,12,0,30,18
1657156951249,ECE 65,A51,095125,Saad; Andrew S,25,0,26,1
1657156957273,ECE 109,A01,091882,Touri; Behrouz,18,0,70,52
1657156963297,ECE 180,A00,083140,Abi Samra; Nicholas Camill,1,0,30,29
1657156963297,ECE 180,B00,083141,Abi Samra; Nicholas Camill,0,0,30,30
1657156969327,MATH 10A,A01,083735,Patchell; Gregory David,2,0,30,28
1657156969327,MATH 10A,A02,083736,Patchell; Gregory David,20,0,30,10
1657156969327,MATH 10A,A03,083737,Patchell; Gregory David,16,0,30,14
1657156975423,MATH 10B,A01,083207,Lim; Seonhee,7,0,34,27
1657156975423,MATH 10B,A02,083208,Lim; Seonhee,9,0,35,26
1657156975423,MATH 10B,A03,093472,Lim; Seonhee,5,0,34,29
1657156975423,MATH 10B,B01,083739,Sinha; Shubham,9,0,30,21
1657156981449,MATH 18,A01,083743,Cinel; Cameron Alexander,6,0,30,24
1657156981449,MATH 18,A02,083744,Cinel; Cameron Alexander,15,0,30,15
1657156981449,MATH 18,A03,083745,Cinel; Cameron Alexander,8,0,30,22
1657156981449,MATH 18,B01,083748,Rideout; David Porter,4,0,37,33
1657156981449,MATH 18,B02,083749,Rideout; David Porter,3,0,36,33
1657156981449,MATH 18,B03,083750,Rideout; David Porter,2,0,37,35
1657156981449,MATH 18,B04,083751,Rideout; David Porter,5,0,36,31
1657156981449,MATH 18,B05,093473,Rideout; David Porter,5,0,36,31
1657156981449,MATH 18,B06,093474,Rideout; David Porter,5,0,36,31
1657156987476,MATH 20A,A01,083754,Zheng; Zequn,12,0,40,28
1657156993503,MATH 20B,A01,083756,Briones; Jor-el Thomas Caparas,1,0,36,35
1657156993503,MATH 20B,A02,083757,Briones; Jor-el Thomas Caparas,1,0,36,35
1657156993503,MATH 20B,A03,093475,Briones; Jor-el Thomas Caparas,1,0,36,35
1657156999536,MATH 20C,A01,083760,Briones; Jor-el Thomas Caparas,1,0,35,34
1657156999536,MATH 20C,A02,083761,Briones; Jor-el Thomas Caparas,8,0,35,27
1657156999536,MATH 20C,A03,093476,Briones; Jor-el Thomas Caparas,0,1,36,36
1657156999536,MATH 20C,B01,083762,Bach; Quang Tran,1,0,30,29
1657157005561,MATH 20D,A01,083765,Tran; Brian Kha,4,0,30,26
1657157005561,MATH 20D,A02,083766,Tran; Brian Kha,5,0,30,25
1657157005561,MATH 20D,A03,083767,Tran; Brian Kha,3,0,30,27
1657157011584,MATH 20E,A01,083771,Ganguly; Soumya,7,0,32,25
1657157011584,MATH 20E,A02,083772,Ganguly; Soumya,7,0,32,25
1657157011584,MATH 20E,B01,083773,Ciotti; Benjamin,19,0,35,16
1657157011584,MATH 20E,B02,083774,Ciotti; Benjamin,17,0,35,18
1657157017614,MATH 103A,A01,083777,Greenfeld; Be'Eri,2,0,36,34
1657157017614,MATH 103A,A02,083778,Greenfeld; Be'Eri,5,0,36,31
1657157017614,MATH 103A,A03,093561,Greenfeld; Be'Eri,4,0,36,32
1657157017614,MATH 103A,B01,083779,Greenfeld; Be'Eri,6,0,36,30
1657157017614,MATH 103A,B02,083780,Greenfeld; Be'Eri,3,0,36,33
1657157017614,MATH 103A,B03,093562,Greenfeld; Be'Eri,3,0,36,33
1657157023642,MATH 105,A01,085443,Carter; Anne Toulson,14,0,35,21
1657157023642,MATH 105,A02,093477,Carter; Anne Toulson,20,0,35,15
1657157029669,MATH 109,A01,083213,Ganzberger; Geoffrey Michael,2,0,34,32
1657157029669,MATH 109,A02,083214,Ganzberger; Geoffrey Michael,3,0,34,31
1657157029669,MATH 109,A03,093478,Ganzberger; Geoffrey Michael,1,0,34,33
1657157029669,MATH 109,B01,083215,Ganzberger; Geoffrey Michael,1,0,32,31
1657157029669,MATH 109,B02,083216,Ganzberger; Geoffrey Michael,1,0,32,31
1657157029669,MATH 109,B03,093479,Ganzberger; Geoffrey Michael,6,0,32,26
1657157035694,MATH 142A,A01,083219,Chow; Bennett,6,0,32,26
1657157035694,MATH 142A,A02,083220,Chow; Bennett,10,0,32,22
1657157035694,MATH 142A,A03,093480,Chow; Bennett,7,0,32,25
1657157035694,MATH 142A,B03,093481,Chow; Bennett,8,0,32,24
1657157035694,MATH 142A,B04,093558,Chow; Bennett,11,0,32,21
1657157035694,MATH 142A,B05,093559,Chow; Bennett,6,0,32,26
1657157041722,MATH 193A,A01,083224,Rotar; Vladimir,7,0,34,27
1657157041722,MATH 193A,A02,083225,Rotar; Vladimir,5,0,34,29
1657157041722,MATH 193A,A03,083781,Rotar; Vladimir,1,0,34,33
1657157041722,MATH 193A,A04,083782,Rotar; Vladimir,8,0,34,26
1657157041722,MATH 193A,A05,093482,Rotar; Vladimir,6,0,34,28
1657157047747,MATH 197,001,091859,McAuley; Julian John,9999,0,9999,0
1657157047747,MATH 197,002,095566,Kedlaya; Kiran S.,9997,0,9999,2
1657157047747,MATH 197,003,095567,Xiao; Ming,9999,0,9999,0
1657157047747,MATH 197,004,095571,Perols; Johan Lars,9998,0,9999,1
1657157054797,COGS 9,A01,083615,Shannon; Kyle Michael,7,0,75,68
1657157060825,COGS 11,A01,083617,Boyle; Mary E. T.,22,0,48,26
1657157066848,COGS 13,A01,083071,Bastos; Amalia Pinkusfeld,9,0,71,62
1657157072878,COGS 14A,A01,092681,Semenuks; Arturs,1,1,100,99
1657157078915,COGS 14B,A01,083073,Cheng; Tzu-Han,6,0,63,57
1657157084942,COGS 17,A01,092677,Semenuks; Arturs,4,0,81,77
1657157090967,COGS 100,A01,083619,Allen; Michael Gordon,15,0,70,55
1657157096991,COGS 101A,A01,083621,Davis; Joshua Daniel,9,0,68,59
1657157103022,COGS 101B,A01,091572,Allen; Michael Gordon,9,0,65,56
1657157109045,COGS 101C,A01,083625,Delgado; Tania,17,0,35,18
1657157115069,COGS 107A,A01,083627,Boyle; Mary E. T.,13,0,60,47
1657157121091,COGS 118A,A01,083075,Gupta; Anjum,15,0,76,61
1657157127116,CSE 3,A50,083646,Miranda; Gregory Joseph,24,0,50,26
1657157133146,CSE 8A,A50,083650,Miranda; Gregory Joseph,17,1,56,39
1657157139171,CSE 11,A01,083080,Cao; Yingjun,5,15,40,35
1657157145199,CSE 12,A01,083652,Krause-Levy; Sophia Louisa,24,1,120,96
1657157151222,CSE 15L,A01,083654,Morris; Justin Loren,9,0,50,41
1657157151222,CSE 15L,A02,083655,Morris; Justin Loren,9,0,50,41
1657157157249,CSE 20,A01,083657,Tran; Khoa Dang,38,0,80,42
1657157163279,CSE 21,A01,095574,Bach; Quang Tran,22,0,48,26
1657157169305,CSE 30,A01,083084,Eldon; John,4,0,80,76
1657157169305,CSE 30,B01,095061,Bhaskar; Nishant,7,0,50,43
1657157175329,CSE 100,A01,083659,Cao; Yingjun,4,4,70,66
1657157181357,CSE 134B,A01,083661,Powell; Thomas Allan,20,0,100,80
1657157187390,CSE 140,A01,083663,Gungor; Onat,13,0,85,72
1657157193423,CSE 140L,A01,083088,Eldon; John,17,0,100,83
1657157199447,CSE 175,A01,083665,Kumar; Rakesh,3,0,25,22
1657157205481,CSE 190,A00,092507,Dubnov; Shlomo,7,0,20,13
1657157211503,ECE 45,A01,083139,Congero; Spencer William,5,0,75,70
1657157217528,ECE 65,A50,083695,Saad; Andrew S,12,0,30,18
1657157217528,ECE 65,A51,095125,Saad; Andrew S,25,0,26,1
1657157223551,ECE 109,A01,091882,Touri; Behrouz,18,0,70,52
1657157229575,ECE 180,A00,083140,Abi Samra; Nicholas Camill,1,0,30,29
1657157229575,ECE 180,B00,083141,Abi Samra; Nicholas Camill,0,0,30,30
1657157235599,MATH 10A,A01,083735,Patchell; Gregory David,2,0,30,28
1657157235599,MATH 10A,A02,083736,Patchell; Gregory David,20,0,30,10
1657157235599,MATH 10A,A03,083737,Patchell; Gregory David,16,0,30,14
1657157241629,MATH 10B,A01,083207,Lim; Seonhee,7,0,34,27
1657157241629,MATH 10B,A02,083208,Lim; Seonhee,9,0,35,26
1657157241629,MATH 10B,A03,093472,Lim; Seonhee,5,0,34,29
1657157241629,MATH 10B,B01,083739,Sinha; Shubham,9,0,30,21
1657157247659,MATH 18,A01,083743,Cinel; Cameron Alexander,6,0,30,24
1657157247659,MATH 18,A02,083744,Cinel; Cameron Alexander,15,0,30,15
1657157247659,MATH 18,A03,083745,Cinel; Cameron Alexander,8,0,30,22
1657157247659,MATH 18,B01,083748,Rideout; David Porter,4,0,37,33
1657157247659,MATH 18,B02,083749,Rideout; David Porter,3,0,36,33
1657157247659,MATH 18,B03,083750,Rideout; David Porter,2,0,37,35
1657157247659,MATH 18,B04,083751,Rideout; David Porter,5,0,36,31
1657157247659,MATH 18,B05,093473,Rideout; David Porter,5,0,36,31
1657157247659,MATH 18,B06,093474,Rideout; David Porter,5,0,36,31
1657157253684,MATH 20A,A01,083754,Zheng; Zequn,12,0,40,28
1657157259713,MATH 20B,A01,083756,Briones; Jor-el Thomas Caparas,1,0,36,35
1657157259713,MATH 20B,A02,083757,Briones; Jor-el Thomas Caparas,1,0,36,35
1657157259713,MATH 20B,A03,093475,Briones; Jor-el Thomas Caparas,1,0,36,35
1657157265742,MATH 20C,A01,083760,Briones; Jor-el Thomas Caparas,1,0,35,34
1657157265742,MATH 20C,A02,083761,Briones; Jor-el Thomas Caparas,8,0,35,27
1657157265742,MATH 20C,A03,093476,Briones; Jor-el Thomas Caparas,0,1,36,36
1657157265742,MATH 20C,B01,083762,Bach; Quang Tran,1,0,30,29
1657157271771,MATH 20D,A01,083765,Tran; Brian Kha,4,0,30,26
1657157271771,MATH 20D,A02,083766,Tran; Brian Kha,5,0,30,25
1657157271771,MATH 20D,A03,083767,Tran; Brian Kha,3,0,30,27
1657157277800,MATH 20E,A01,083771,Ganguly; Soumya,7,0,32,25
1657157277800,MATH 20E,A02,083772,Ganguly; Soumya,7,0,32,25
1657157277800,MATH 20E,B01,083773,Ciotti; Benjamin,19,0,35,16
1657157277800,MATH 20E,B02,083774,Ciotti; Benjamin,17,0,35,18
1657157283824,MATH 103A,A01,083777,Greenfeld; Be'Eri,2,0,36,34
1657157283824,MATH 103A,A02,083778,Greenfeld; Be'Eri,5,0,36,31
1657157283824,MATH 103A,A03,093561,Greenfeld; Be'Eri,4,0,36,32
1657157283824,MATH 103A,B01,083779,Greenfeld; Be'Eri,6,0,36,30
1657157283824,MATH 103A,B02,083780,Greenfeld; Be'Eri,3,0,36,33
1657157283824,MATH 103A,B03,093562,Greenfeld; Be'Eri,3,0,36,33
1657157289846,MATH 105,A01,085443,Carter; Anne Toulson,14,0,35,21
1657157289846,MATH 105,A02,093477,Carter; Anne Toulson,20,0,35,15
1657157295870,MATH 109,A01,083213,Ganzberger; Geoffrey Michael,2,0,34,32
1657157295870,MATH 109,A02,083214,Ganzberger; Geoffrey Michael,3,0,34,31
1657157295870,MATH 109,A03,093478,Ganzberger; Geoffrey Michael,1,0,34,33
1657157295870,MATH 109,B01,083215,Ganzberger; Geoffrey Michael,1,0,32,31
1657157295870,MATH 109,B02,083216,Ganzberger; Geoffrey Michael,1,0,32,31
1657157295870,MATH 109,B03,093479,Ganzberger; Geoffrey Michael,6,0,32,26
1657157301898,MATH 142A,A01,083219,Chow; Bennett,6,0,32,26
1657157301898,MATH 142A,A02,083220,Chow; Bennett,10,0,32,22
1657157301898,MATH 142A,A03,093480,Chow; Bennett,7,0,32,25
1657157301898,MATH 142A,B03,093481,Chow; Bennett,8,0,32,24
1657157301898,MATH 142A,B04,093558,Chow; Bennett,11,0,32,21
1657157301898,MATH 142A,B05,093559,Chow; Bennett,6,0,32,26
1657157307920,MATH 193A,A01,083224,Rotar; Vladimir,7,0,34,27
1657157307920,MATH 193A,A02,083225,Rotar; Vladimir,5,0,34,29
1657157307920,MATH 193A,A03,083781,Rotar; Vladimir,1,0,34,33
1657157307920,MATH 193A,A04,083782,Rotar; Vladimir,8,0,34,26
1657157307920,MATH 193A,A05,093482,Rotar; Vladimir,6,0,34,28
1657157313943,MATH 197,001,091859,McAuley; Julian John,9999,0,9999,0
1657157313943,MATH 197,002,095566,Kedlaya; Kiran S.,9997,0,9999,2
1657157313943,MATH 197,003,095567,Xiao; Ming,9999,0,9999,0
1657157313943,MATH 197,004,095571,Perols; Johan Lars,9998,0,9999,1
1657157321001,COGS 9,A01,083615,Shannon; Kyle Michael,7,0,75,68
1657157327031,COGS 11,A01,083617,Boyle; Mary E. T.,22,0,48,26
1657157333084,COGS 13,A01,083071,Bastos; Amalia Pinkusfeld,9,0,71,62
1657157339112,COGS 14A,A01,092681,Semenuks; Arturs,1,1,100,99
1657157345136,COGS 14B,A01,083073,Cheng; Tzu-Han,6,0,63,57
1657157351160,COGS 17,A01,092677,Semenuks; Arturs,4,0,81,77
1657157357187,COGS 100,A01,083619,Allen; Michael Gordon,15,0,70,55
1657157363213,COGS 101A,A01,083621,Davis; Joshua Daniel,9,0,68,59
1657157369236,COGS 101B,A01,091572,Allen; Michael Gordon,9,0,65,56
1657157375259,COGS 101C,A01,083625,Delgado; Tania,17,0,35,18
1657157381287,COGS 107A,A01,083627,Boyle; Mary E. T.,13,0,60,47
1657157387311,COGS 118A,A01,083075,Gupta; Anjum,15,0,76,61
1657157393334,CSE 3,A50,083646,Miranda; Gregory Joseph,24,0,50,26
1657157399362,CSE 8A,A50,083650,Miranda; Gregory Joseph,17,1,56,39
1657157405389,CSE 11,A01,083080,Cao; Yingjun,5,15,40,35
1657157411412,CSE 12,A01,083652,Krause-Levy; Sophia Louisa,24,1,120,96
1657157417435,CSE 15L,A01,083654,Morris; Justin Loren,9,0,50,41
1657157417435,CSE 15L,A02,083655,Morris; Justin Loren,9,0,50,41
1657157423459,CSE 20,A01,083657,Tran; Khoa Dang,38,0,80,42
1657157429482,CSE 21,A01,095574,Bach; Quang Tran,22,0,48,26
1657157435505,CSE 30,A01,083084,Eldon; John,4,0,80,76
1657157435505,CSE 30,B01,095061,Bhaskar; Nishant,7,0,50,43
1657157441532,CSE 100,A01,083659,Cao; Yingjun,4,4,70,66
1657157447558,CSE 134B,A01,083661,Powell; Thomas Allan,20,0,100,80
1657157453585,CSE 140,A01,083663,Gungor; Onat,13,0,85,72
1657157459607,CSE 140L,A01,083088,Eldon; John,17,0,100,83
1657157465630,CSE 175,A01,083665,Kumar; Rakesh,3,0,25,22
1657157471653,CSE 190,A00,092507,Dubnov; Shlomo,7,0,20,13
1657157477676,ECE 45,A01,083139,Congero; Spencer William,5,0,75,70
1657157483700,ECE 65,A50,083695,Saad; Andrew S,12,0,30,18
1657157483700,ECE 65,A51,095125,Saad; Andrew S,25,0,26,1
1657157489724,ECE 109,A01,091882,Touri; Behrouz,18,0,70,52
1657157495750,ECE 180,A00,083140,Abi Samra; Nicholas Camill,1,0,30,29
1657157495750,ECE 180,B00,083141,Abi Samra; Nicholas Camill,0,0,30,30
1657157501778,MATH 10A,A01,083735,Patchell; Gregory David,2,0,30,28
1657157501778,MATH 10A,A02,083736,Patchell; Gregory David,20,0,30,10
1657157501778,MATH 10A,A03,083737,Patchell; Gregory David,16,0,30,14
1657157507807,MATH 10B,A01,083207,Lim; Seonhee,7,0,34,27
1657157507807,MATH 10B,A02,083208,Lim; Seonhee,9,0,35,26
1657157507807,MATH 10B,A03,093472,Lim; Seonhee,5,0,34,29
1657157507807,MATH 10B,B01,083739,Sinha; Shubham,9,0,30,21
1657157513837,MATH 18,A01,083743,Cinel; Cameron Alexander,6,0,30,24
1657157513837,MATH 18,A02,083744,Cinel; Cameron Alexander,15,0,30,15
1657157513837,MATH 18,A03,083745,Cinel; Cameron Alexander,8,0,30,22
1657157513837,MATH 18,B01,083748,Rideout; David Porter,4,0,37,33
1657157513837,MATH 18,B02,083749,Rideout; David Porter,3,0,36,33
1657157513837,MATH 18,B03,083750,Rideout; David Porter,2,0,37,35
1657157513837,MATH 18,B04,083751,Rideout; David Porter,5,0,36,31
1657157513837,MATH 18,B05,093473,Rideout; David Porter,5,0,36,31
1657157513837,MATH 18,B06,093474,Rideout; David Porter,5,0,36,31
1657157519868,MATH 20A,A01,083754,Zheng; Zequn,12,0,40,28
1657157525893,MATH 20B,A01,083756,Briones; Jor-el Thomas Caparas,1,0,36,35
1657157525893,MATH 20B,A02,083757,Briones; Jor-el Thomas Caparas,1,0,36,35
1657157525893,MATH 20B,A03,093475,Briones; Jor-el Thomas Caparas,1,0,36,35
1657157531920,MATH 20C,A01,083760,Briones; Jor-el Thomas Caparas,1,0,35,34
1657157531920,MATH 20C,A02,083761,Briones; Jor-el Thomas Caparas,8,0,35,27
1657157531920,MATH 20C,A03,093476,Briones; Jor-el Thomas Caparas,0,1,36,36
1657157531920,MATH 20C,B01,083762,Bach; Quang Tran,1,0,30,29
1657157537944,MATH 20D,A01,083765,Tran; Brian Kha,4,0,30,26
1657157537944,MATH 20D,A02,083766,Tran; Brian Kha,5,0,30,25
1657157537944,MATH 20D,A03,083767,Tran; Brian Kha,3,0,30,27
1657157543973,MATH 20E,A01,083771,Ganguly; Soumya,7,0,32,25
1657157543973,MATH 20E,A02,083772,Ganguly; Soumya,7,0,32,25
1657157543973,MATH 20E,B01,083773,Ciotti; Benjamin,19,0,35,16
1657157543973,MATH 20E,B02,083774,Ciotti; Benjamin,17,0,35,18
1657157549998,MATH 103A,A01,083777,Greenfeld; Be'Eri,2,0,36,34
1657157549998,MATH 103A,A02,083778,Greenfeld; Be'Eri,5,0,36,31
1657157549998,MATH 103A,A03,093561,Greenfeld; Be'Eri,4,0,36,32
1657157549998,MATH 103A,B01,083779,Greenfeld; Be'Eri,6,0,36,30
1657157549998,MATH 103A,B02,083780,Greenfeld; Be'Eri,3,0,36,33
1657157549998,MATH 103A,B03,093562,Greenfeld; Be'Eri,3,0,36,33
1657157556022,MATH 105,A01,085443,Carter; Anne Toulson,14,0,35,21
1657157556022,MATH 105,A02,093477,Carter; Anne Toulson,20,0,35,15
1657157562049,MATH 109,A01,083213,Ganzberger; Geoffrey Michael,2,0,34,32
1657157562049,MATH 109,A02,083214,Ganzberger; Geoffrey Michael,3,0,34,31
1657157562049,MATH 109,A03,093478,Ganzberger; Geoffrey Michael,1,0,34,33
1657157562049,MATH 109,B01,083215,Ganzberger; Geoffrey Michael,1,0,32,31
1657157562049,MATH 109,B02,083216,Ganzberger; Geoffrey Michael,1,0,32,31
1657157562049,MATH 109,B03,093479,Ganzberger; Geoffrey Michael,6,0,32,26
1657157568078,MATH 142A,A01,083219,Chow; Bennett,6,0,32,26
1657157568078,MATH 142A,A02,083220,Chow; Bennett,10,0,32,22
1657157568078,MATH 142A,A03,093480,Chow; Bennett,7,0,32,25
1657157568078,MATH 142A,B03,093481,Chow; Bennett,8,0,32,24
1657157568078,MATH 142A,B04,093558,Chow; Bennett,11,0,32,21
1657157568078,MATH 142A,B05,093559,Chow; Bennett,6,0,32,26
1657157574211,MATH 193A,A01,083224,Rotar; Vladimir,7,0,34,27
1657157574211,MATH 193A,A02,083225,Rotar; Vladimir,5,0,34,29
1657157574211,MATH 193A,A03,083781,Rotar; Vladimir,1,0,34,33
1657157574211,MATH 193A,A04,083782,Rotar; Vladimir,8,0,34,26
1657157574211,MATH 193A,A05,093482,Rotar; Vladimir,6,0,34,28
1657157580244,MATH 197,001,091859,McAuley; Julian John,9999,0,9999,0
1657157580244,MATH 197,002,095566,Kedlaya; Kiran S.,9997,0,9999,2
1657157580244,MATH 197,003,095567,Xiao; Ming,9999,0,9999,0
1657157580244,MATH 197,004,095571,Perols; Johan Lars,9998,0,9999,1
1657157587294,COGS 9,A01,083615,Shannon; Kyle Michael,7,0,75,68
1657157593318,COGS 11,A01,083617,Boyle; Mary E. T.,22,0,48,26
1657157599339,COGS 13,A01,083071,Bastos; Amalia Pinkusfeld,9,0,71,62
1657157605371,COGS 14A,A01,092681,Semenuks; Arturs,1,1,100,99
1657157611393,COGS 14B,A01,083073,Cheng; Tzu-Han,6,0,63,57
1657157617423,COGS 17,A01,092677,Semenuks; Arturs,4,0,81,77
1657157623451,COGS 100,A01,083619,Allen; Michael Gordon,15,0,70,55
1657157629478,COGS 101A,A01,083621,Davis; Joshua Daniel,9,0,68,59
1657157635501,COGS 101B,A01,091572,Allen; Michael Gordon,9,0,65,56
1657157641529,COGS 101C,A01,083625,Delgado; Tania,17,0,35,18
1657157647553,COGS 107A,A01,083627,Boyle; Mary E. T.,13,0,60,47
1657157653577,COGS 118A,A01,083075,Gupta; Anjum,15,0,76,61
1657157659603,CSE 3,A50,083646,Miranda; Gregory Joseph,24,0,50,26
1657157665629,CSE 8A,A50,083650,Miranda; Gregory Joseph,17,1,56,39
1657157671661,CSE 11,A01,083080,Cao; Yingjun,5,15,40,35
1657157677684,CSE 12,A01,083652,Krause-Levy; Sophia Louisa,24,1,120,96
1657157683710,CSE 15L,A01,083654,Morris; Justin Loren,9,0,50,41
1657157683710,CSE 15L,A02,083655,Morris; Justin Loren,9,0,50,41
1657157689740,CSE 20,A01,083657,Tran; Khoa Dang,38,0,80,42
1657157695768,CSE 21,A01,095574,Bach; Quang Tran,22,0,48,26
1657157701795,CSE 30,A01,083084,Eldon; John,4,0,80,76
1657157701795,CSE 30,B01,095061,Bhaskar; Nishant,7,0,50,43
1657157707817,CSE 100,A01,083659,Cao; Yingjun,4,4,70,66
1657157713840,CSE 134B,A01,083661,Powell; Thomas Allan,20,0,100,80
1657157719862,CSE 140,A01,083663,Gungor; Onat,13,0,85,72
1657157725890,CSE 140L,A01,083088,Eldon; John,17,0,100,83
1657157731914,CSE 175,A01,083665,Kumar; Rakesh,3,0,25,22
1657157737937,CSE 190,A00,092507,Dubnov; Shlomo,7,0,20,13
1657157743963,ECE 45,A01,083139,Congero; Spencer William,5,0,75,70
1657157749989,ECE 65,A50,083695,Saad; Andrew S,12,0,30,18
1657157749989,ECE 65,A51,095125,Saad; Andrew S,25,0,26,1
1657157756014,ECE 109,A01,091882,Touri; Behrouz,18,0,70,52
1657157762041,ECE 180,A00,083140,Abi Samra; Nicholas Camill,1,0,30,29
1657157762041,ECE 180,B00,083141,Abi Samra; Nicholas Camill,0,0,30,30
1657157768064,MATH 10A,A01,083735,Patchell; Gregory David,2,0,30,28
1657157768064,MATH 10A,A02,083736,Patchell; Gregory David,20,0,30,10
1657157768064,MATH 10A,A03,083737,Patchell; Gregory David,16,0,30,14
1657157774087,MATH 10B,A01,083207,Lim; Seonhee,7,0,34,27
1657157774087,MATH 10B,A02,083208,Lim; Seonhee,9,0,35,26
1657157774087,MATH 10B,A03,093472,Lim; Seonhee,5,0,34,29
1657157774087,MATH 10B,B01,083739,Sinha; Shubham,9,0,30,21
1657157780112,MATH 18,A01,083743,Cinel; Cameron Alexander,6,0,30,24
1657157780112,MATH 18,A02,083744,Cinel; Cameron Alexander,15,0,30,15
1657157780112,MATH 18,A03,083745,Cinel; Cameron Alexander,8,0,30,22
1657157780112,MATH 18,B01,083748,Rideout; David Porter,4,0,37,33
1657157780112,MATH 18,B02,083749,Rideout; David Porter,3,0,36,33
1657157780112,MATH 18,B03,083750,Rideout; David Porter,2,0,37,35
1657157780112,MATH 18,B04,083751,Rideout; David Porter,5,0,36,31
1657157780112,MATH 18,B05,093473,Rideout; David Porter,5,0,36,31
1657157780112,MATH 18,B06,093474,Rideout; David Porter,5,0,36,31
1657157786134,MATH 20A,A01,083754,Zheng; Zequn,12,0,40,28
1657157792162,MATH 20B,A01,083756,Briones; Jor-el Thomas Caparas,1,0,36,35
1657157792162,MATH 20B,A02,083757,Briones; Jor-el Thomas Caparas,1,0,36,35
1657157792162,MATH 20B,A03,093475,Briones; Jor-el Thomas Caparas,1,0,36,35
1657157798184,MATH 20C,A01,083760,Briones; Jor-el Thomas Caparas,1,0,35,34
1657157798184,MATH 20C,A02,083761,Briones; Jor-el Thomas Caparas,8,0,35,27
1657157798184,MATH 20C,A03,093476,Briones; Jor-el Thomas Caparas,0,1,36,36
1657157798184,MATH 20C,B01,083762,Bach; Quang Tran,1,0,30,29
1657157804213,MATH 20D,A01,083765,Tran; Brian Kha,4,0,30,26
1657157804213,MATH 20D,A02,083766,Tran; Brian Kha,5,0,30,25
1657157804213,MATH 20D,A03,083767,Tran; Brian Kha,3,0,30,27
1657157810241,MATH 20E,A01,083771,Ganguly; Soumya,7,0,32,25
1657157810241,MATH 20E,A02,083772,Ganguly; Soumya,7,0,32,25
1657157810241,MATH 20E,B01,083773,Ciotti; Benjamin,19,0,35,16
1657157810241,MATH 20E,B02,083774,Ciotti; Benjamin,17,0,35,18
1657157816265,MATH 103A,A01,083777,Greenfeld; Be'Eri,2,0,36,34
1657157816265,MATH 103A,A02,083778,Greenfeld; Be'Eri,5,0,36,31
1657157816265,MATH 103A,A03,093561,Greenfeld; Be'Eri,4,0,36,32
1657157816265,MATH 103A,B01,083779,Greenfeld; Be'Eri,6,0,36,30
1657157816265,MATH 103A,B02,083780,Greenfeld; Be'Eri,3,0,36,33
1657157816265,MATH 103A,B03,093562,Greenfeld; Be'Eri,3,0,36,33
1657157822290,MATH 105,A01,085443,Carter; Anne Toulson,14,0,35,21
1657157822290,MATH 105,A02,093477,Carter; Anne Toulson,20,0,35,15
1657157828316,MATH 109,A01,083213,Ganzberger; Geoffrey Michael,2,0,34,32
1657157828316,MATH 109,A02,083214,Ganzberger; Geoffrey Michael,3,0,34,31
1657157828316,MATH 109,A03,093478,Ganzberger; Geoffrey Michael,1,0,34,33
1657157828316,MATH 109,B01,083215,Ganzberger; Geoffrey Michael,1,0,32,31
1657157828316,MATH 109,B02,083216,Ganzberger; Geoffrey Michael,1,0,32,31
1657157828316,MATH 109,B03,093479,Ganzberger; Geoffrey Michael,6,0,32,26
1657157834345,MATH 142A,A01,083219,Chow; Bennett,6,0,32,26
1657157834345,MATH 142A,A02,083220,Chow; Bennett,10,0,32,22
1657157834345,MATH 142A,A03,093480,Chow; Bennett,7,0,32,25
1657157834345,MATH 142A,B03,093481,Chow; Bennett,8,0,32,24
1657157834345,MATH 142A,B04,093558,Chow; Bennett,11,0,32,21
1657157834345,MATH 142A,B05,093559,Chow; Bennett,6,0,32,26
1657157840370,MATH 193A,A01,083224,Rotar; Vladimir,7,0,34,27
1657157840370,MATH 193A,A02,083225,Rotar; Vladimir,5,0,34,29
1657157840370,MATH 193A,A03,083781,Rotar; Vladimir,1,0,34,33
1657157840370,MATH 193A,A04,083782,Rotar; Vladimir,8,0,34,26
1657157840370,MATH 193A,A05,093482,Rotar; Vladimir,6,0,34,28
1657157846394,MATH 197,001,091859,McAuley; Julian John,9999,0,9999,0
1657157846394,MATH 197,002,095566,Kedlaya; Kiran S.,9997,0,9999,2
1657157846394,MATH 197,003,095567,Xiao; Ming,9999,0,9999,0
1657157846394,MATH 197,004,095571,Perols; Johan Lars,9998,0,9999,1
1657157853443,COGS 9,A01,083615,Shannon; Kyle Michael,7,0,75,68
1657157859470,COGS 11,A01,083617,Boyle; Mary E. T.,22,0,48,26
1657157865494,COGS 13,A01,083071,Bastos; Amalia Pinkusfeld,9,0,71,62
1657157871527,COGS 14A,A01,092681,Semenuks; Arturs,1,1,100,99
1657157877551,COGS 14B,A01,083073,Cheng; Tzu-Han,6,0,63,57
1657157883576,COGS 17,A01,092677,Semenuks; Arturs,4,0,81,77
1657157889599,COGS 100,A01,083619,Allen; Michael Gordon,15,0,70,55
1657157895627,COGS 101A,A01,083621,Davis; Joshua Daniel,9,0,68,59
1657157901652,COGS 101B,A01,091572,Allen; Michael Gordon,9,0,65,56
1657157907675,COGS 101C,A01,083625,Delgado; Tania,17,0,35,18
1657157913708,COGS 107A,A01,083627,Boyle; Mary E. T.,13,0,60,47
1657157919734,COGS 118A,A01,083075,Gupta; Anjum,15,0,76,61
1657157925757,CSE 3,A50,083646,Miranda; Gregory Joseph,24,0,50,26
1657157931780,CSE 8A,A50,083650,Miranda; Gregory Joseph,17,1,56,39
1657157937804,CSE 11,A01,083080,Cao; Yingjun,5,15,40,35
1657157943828,CSE 12,A01,083652,Krause-Levy; Sophia Louisa,24,1,120,96
1657157949858,CSE 15L,A01,083654,Morris; Justin Loren,9,0,50,41
1657157949858,CSE 15L,A02,083655,Morris; Justin Loren,9,0,50,41
1657157955882,CSE 20,A01,083657,Tran; Khoa Dang,38,0,80,42
1657157961906,CSE 21,A01,095574,Bach; Quang Tran,22,0,48,26
1657157967929,CSE 30,A01,083084,Eldon; John,4,0,80,76
1657157967929,CSE 30,B01,095061,Bhaskar; Nishant,7,0,50,43
1657157973951,CSE 100,A01,083659,Cao; Yingjun,4,4,70,66
1657157979977,CSE 134B,A01,083661,Powell; Thomas Allan,20,0,100,80
1657157986001,CSE 140,A01,083663,Gungor; Onat,13,0,85,72
1657157992024,CSE 140L,A01,083088,Eldon; John,17,0,100,83
1657157998047,CSE 175,A01,083665,Kumar; Rakesh,3,0,25,22
1657158004071,CSE 190,A00,092507,Dubnov; Shlomo,7,0,20,13
1657158010095,ECE 45,A01,083139,Congero; Spencer William,5,0,75,70
1657158016132,ECE 65,A50,083695,Saad; Andrew S,12,0,30,18
1657158016132,ECE 65,A51,095125,Saad; Andrew S,25,0,26,1
1657158022166,ECE 109,A01,091882,Touri; Behrouz,18,0,70,52
1657158028195,ECE 180,A00,083140,Abi Samra; Nicholas Camill,1,0,30,29
1657158028195,ECE 180,B00,083141,Abi Samra; Nicholas Camill,0,0,30,30
1657158034228,MATH 10A,A01,083735,Patchell; Gregory David,2,0,30,28
1657158034228,MATH 10A,A02,083736,Patchell; Gregory David,20,0,30,10
1657158034228,MATH 10A,A03,083737,Patchell; Gregory David,16,0,30,14
1657158040253,MATH 10B,A01,083207,Lim; Seonhee,7,0,34,27
1657158040253,MATH 10B,A02,083208,Lim; Seonhee,9,0,35,26
1657158040253,MATH 10B,A03,093472,Lim; Seonhee,5,0,34,29
1657158040253,MATH 10B,B01,083739,Sinha; Shubham,9,0,30,21
1657158046284,MATH 18,A01,083743,Cinel; Cameron Alexander,6,0,30,24
1657158046284,MATH 18,A02,083744,Cinel; Cameron Alexander,15,0,30,15
1657158046284,MATH 18,A03,083745,Cinel; Cameron Alexander,8,0,30,22
1657158046284,MATH 18,B01,083748,Rideout; David Porter,4,0,37,33
1657158046284,MATH 18,B02,083749,Rideout; David Porter,3,0,36,33
1657158046284,MATH 18,B03,083750,Rideout; David Porter,2,0,37,35
1657158046284,MATH 18,B04,083751,Rideout; David Porter,5,0,36,31
1657158046284,MATH 18,B05,093473,Rideout; David Porter,5,0,36,31
1657158046284,MATH 18,B06,093474,Rideout; David Porter,5,0,36,31
1657158052311,MATH 20A,A01,083754,Zheng; Zequn,12,0,40,28
1657158058335,MATH 20B,A01,083756,Briones; Jor-el Thomas Caparas,1,0,36,35
1657158058335,MATH 20B,A02,083757,Briones; Jor-el Thomas Caparas,1,0,36,35
1657158058335,MATH 20B,A03,093475,Briones; Jor-el Thomas Caparas,1,0,36,35
1657158064357,MATH 20C,A01,083760,Briones; Jor-el Thomas Caparas,1,0,35,34
1657158064357,MATH 20C,A02,083761,Briones; Jor-el Thomas Caparas,8,0,35,27
1657158064357,MATH 20C,A03,093476,Briones; Jor-el Thomas Caparas,0,1,36,36
1657158064357,MATH 20C,B01,083762,Bach; Quang Tran,1,0,30,29
1657158070382,MATH 20D,A01,083765,Tran; Brian Kha,4,0,30,26
1657158070382,MATH 20D,A02,083766,Tran; Brian Kha,5,0,30,25
1657158070382,MATH 20D,A03,083767,Tran; Brian Kha,3,0,30,27
1657158076406,MATH 20E,A01,083771,Ganguly; Soumya,7,0,32,25
1657158076406,MATH 20E,A02,083772,Ganguly; Soumya,7,0,32,25
1657158076406,MATH 20E,B01,083773,Ciotti; Benjamin,19,0,35,16
1657158076406,MATH 20E,B02,083774,Ciotti; Benjamin,17,0,35,18
1657158082435,MATH 103A,A01,083777,Greenfeld; Be'Eri,2,0,36,34
1657158082435,MATH 103A,A02,083778,Greenfeld; Be'Eri,5,0,36,31
1657158082435,MATH 103A,A03,093561,Greenfeld; Be'Eri,4,0,36,32
1657158082435,MATH 103A,B01,083779,Greenfeld; Be'Eri,6,0,36,30
1657158082435,MATH 103A,B02,083780,Greenfeld; Be'Eri,3,0,36,33
1657158082435,MATH 103A,B03,093562,Greenfeld; Be'Eri,3,0,36,33
1657158088464,MATH 105,A01,085443,Carter; Anne Toulson,14,0,35,21
1657158088464,MATH 105,A02,093477,Carter; Anne Toulson,20,0,35,15
1657158094495,MATH 109,A01,083213,Ganzberger; Geoffrey Michael,2,0,34,32
1657158094495,MATH 109,A02,083214,Ganzberger; Geoffrey Michael,3,0,34,31
1657158094495,MATH 109,A03,093478,Ganzberger; Geoffrey Michael,1,0,34,33
1657158094495,MATH 109,B01,083215,Ganzberger; Geoffrey Michael,1,0,32,31
1657158094495,MATH 109,B02,083216,Ganzberger; Geoffrey Michael,1,0,32,31
1657158094495,MATH 109,B03,093479,Ganzberger; Geoffrey Michael,6,0,32,26
1657158100524,MATH 142A,A01,083219,Chow; Bennett,6,0,32,26
1657158100524,MATH 142A,A02,083220,Chow; Bennett,10,0,32,22
1657158100524,MATH 142A,A03,093480,Chow; Bennett,7,0,32,25
1657158100524,MATH 142A,B03,093481,Chow; Bennett,8,0,32,24
1657158100524,MATH 142A,B04,093558,Chow; Bennett,11,0,32,21
1657158100524,MATH 142A,B05,093559,Chow; Bennett,6,0,32,26
1657158106547,MATH 193A,A01,083224,Rotar; Vladimir,7,0,34,27
1657158106547,MATH 193A,A02,083225,Rotar; Vladimir,5,0,34,29
1657158106547,MATH 193A,A03,083781,Rotar; Vladimir,1,0,34,33
1657158106547,MATH 193A,A04,083782,Rotar; Vladimir,8,0,34,26
1657158106547,MATH 193A,A05,093482,Rotar; Vladimir,6,0,34,28
1657158112578,MATH 197,001,091859,McAuley; Julian John,9999,0,9999,0
1657158112578,MATH 197,002,095566,Kedlaya; Kiran S.,9997,0,9999,2
1657158112578,MATH 197,003,095567,Xiao; Ming,9999,0,9999,0
1657158112578,MATH 197,004,095571,Perols; Johan Lars,9998,0,9999,1
1657158119631,COGS 9,A01,083615,Shannon; Kyle Michael,7,0,75,68
1657158125657,COGS 11,A01,083617,Boyle; Mary E. T.,22,0,48,26
1657158131682,COGS 13,A01,083071,Bastos; Amalia Pinkusfeld,9,0,71,62
1657158137705,COGS 14A,A01,092681,Semenuks; Arturs,1,1,100,99
1657158143729,COGS 14B,A01,083073,Cheng; Tzu-Han,6,0,63,57
1657158149752,COGS 17,A01,092677,Semenuks; Arturs,4,0,81,77
1657158155776,COGS 100,A01,083619,Allen; Michael Gordon,15,0,70,55
1657158161800,COGS 101A,A01,083621,Davis; Joshua Daniel,9,0,68,59
1657158167924,COGS 101B,A01,091572,Allen; Michael Gordon,9,0,65,56
1657158173951,COGS 101C,A01,083625,Delgado; Tania,17,0,35,18
1657158179973,COGS 107A,A01,083627,Boyle; Mary E. T.,13,0,60,47
1657158185997,COGS 118A,A01,083075,Gupta; Anjum,16,0,76,60
1657158192023,CSE 3,A50,083646,Miranda; Gregory Joseph,24,0,50,26
1657158198046,CSE 8A,A50,083650,Miranda; Gregory Joseph,17,1,56,39
1657158204069,CSE 11,A01,083080,Cao; Yingjun,5,15,40,35
1657158210096,CSE 12,A01,083652,Krause-Levy; Sophia Louisa,24,1,120,96
1657158216122,CSE 15L,A01,083654,Morris; Justin Loren,9,0,50,41
1657158216122,CSE 15L,A02,083655,Morris; Justin Loren,9,0,50,41
1657158222145,CSE 20,A01,083657,Tran; Khoa Dang,38,0,80,42
1657158228169,CSE 21,A01,095574,Bach; Quang Tran,22,0,48,26
1657158234196,CSE 30,A01,083084,Eldon; John,4,0,80,76
1657158234196,CSE 30,B01,095061,Bhaskar; Nishant,7,0,50,43
1657158240220,CSE 100,A01,083659,Cao; Yingjun,4,4,70,66
1657158246268,CSE 134B,A01,083661,Powell; Thomas Allan,20,0,100,80
1657158252294,CSE 140,A01,083663,Gungor; Onat,13,0,85,72
1657158258318,CSE 140L,A01,083088,Eldon; John,17,0,100,83
1657158264344,CSE 175,A01,083665,Kumar; Rakesh,3,0,25,22
1657158270369,CSE 190,A00,092507,Dubnov; Shlomo,7,0,20,13
1657158276393,ECE 45,A01,083139,Congero; Spencer William,5,0,75,70
1657158282417,ECE 65,A50,083695,Saad; Andrew S,12,0,30,18
1657158282417,ECE 65,A51,095125,Saad; Andrew S,25,0,26,1
1657158288440,ECE 109,A01,091882,Touri; Behrouz,18,0,70,52
1657158294484,ECE 180,A00,083140,Abi Samra; Nicholas Camill,1,0,30,29
1657158294484,ECE 180,B00,083141,Abi Samra; Nicholas Camill,0,0,30,30
1657158300514,MATH 10A,A01,083735,Patchell; Gregory David,2,0,30,28
1657158300514,MATH 10A,A02,083736,Patchell; Gregory David,20,0,30,10
1657158300514,MATH 10A,A03,083737,Patchell; Gregory David,16,0,30,14
1657158306536,MATH 10B,A01,083207,Lim; Seonhee,7,0,34,27
1657158306536,MATH 10B,A02,083208,Lim; Seonhee,9,0,35,26
1657158306536,MATH 10B,A03,093472,Lim; Seonhee,5,0,34,29
1657158306536,MATH 10B,B01,083739,Sinha; Shubham,9,0,30,21
1657158312566,MATH 18,A01,083743,Cinel; Cameron Alexander,6,0,30,24
1657158312566,MATH 18,A02,083744,Cinel; Cameron Alexander,15,0,30,15
1657158312566,MATH 18,A03,083745,Cinel; Cameron Alexander,8,0,30,22
1657158312566,MATH 18,B01,083748,Rideout; David Porter,4,0,37,33
1657158312566,MATH 18,B02,083749,Rideout; David Porter,3,0,36,33
1657158312566,MATH 18,B03,083750,Rideout; David Porter,2,0,37,35
1657158312566,MATH 18,B04,083751,Rideout; David Porter,5,0,36,31
1657158312566,MATH 18,B05,093473,Rideout; David Porter,5,0,36,31
1657158312566,MATH 18,B06,093474,Rideout; David Porter,5,0,36,31
1657158318605,MATH 20A,A01,083754,Zheng; Zequn,12,0,40,28
1657158324628,MATH 20B,A01,083756,Briones; Jor-el Thomas Caparas,1,0,36,35
1657158324628,MATH 20B,A02,083757,Briones; Jor-el Thomas Caparas,1,0,36,35
1657158324628,MATH 20B,A03,093475,Briones; Jor-el Thomas Caparas,1,0,36,35
1657158330655,MATH 20C,A01,083760,Briones; Jor-el Thomas Caparas,1,0,35,34
1657158330655,MATH 20C,A02,083761,Briones; Jor-el Thomas Caparas,8,0,35,27
1657158330655,MATH 20C,A03,093476,Briones; Jor-el Thomas Caparas,0,1,36,36
1657158330655,MATH 20C,B01,083762,Bach; Quang Tran,1,0,30,29
1657158336684,MATH 20D,A01,083765,Tran; Brian Kha,4,0,30,26
1657158336684,MATH 20D,A02,083766,Tran; Brian Kha,5,0,30,25
1657158336684,MATH 20D,A03,083767,Tran; Brian Kha,3,0,30,27
1657158342721,MATH 20E,A01,083771,Ganguly; Soumya,7,0,32,25
1657158342721,MATH 20E,A02,083772,Ganguly; Soumya,7,0,32,25
1657158342721,MATH 20E,B01,083773,Ciotti; Benjamin,19,0,35,16
1657158342721,MATH 20E,B02,083774,Ciotti; Benjamin,17,0,35,18
1657158348750,MATH 103A,A01,083777,Greenfeld; Be'Eri,2,0,36,34
1657158348750,MATH 103A,A02,083778,Greenfeld; Be'Eri,5,0,36,31
1657158348750,MATH 103A,A03,093561,Greenfeld; Be'Eri,4,0,36,32
1657158348750,MATH 103A,B01,083779,Greenfeld; Be'Eri,6,0,36,30
1657158348750,MATH 103A,B02,083780,Greenfeld; Be'Eri,3,0,36,33
1657158348750,MATH 103A,B03,093562,Greenfeld; Be'Eri,3,0,36,33
1657158354777,MATH 105,A01,085443,Carter; Anne Toulson,14,0,35,21
1657158354777,MATH 105,A02,093477,Carter; Anne Toulson,20,0,35,15
1657158360807,MATH 109,A01,083213,Ganzberger; Geoffrey Michael,2,0,34,32
1657158360807,MATH 109,A02,083214,Ganzberger; Geoffrey Michael,3,0,34,31
1657158360807,MATH 109,A03,093478,Ganzberger; Geoffrey Michael,1,0,34,33
1657158360807,MATH 109,B01,083215,Ganzberger; Geoffrey Michael,1,0,32,31
1657158360807,MATH 109,B02,083216,Ganzberger; Geoffrey Michael,1,0,32,31
1657158360807,MATH 109,B03,093479,Ganzberger; Geoffrey Michael,6,0,32,26
1657158366836,MATH 142A,A01,083219,Chow; Bennett,6,0,32,26
1657158366836,MATH 142A,A02,083220,Chow; Bennett,10,0,32,22
1657158366836,MATH 142A,A03,093480,Chow; Bennett,7,0,32,25
1657158366836,MATH 142A,B03,093481,Chow; Bennett,8,0,32,24
1657158366836,MATH 142A,B04,093558,Chow; Bennett,11,0,32,21
1657158366836,MATH 142A,B05,093559,Chow; Bennett,6,0,32,26
1657158372871,MATH 193A,A01,083224,Rotar; Vladimir,7,0,34,27
1657158372871,MATH 193A,A02,083225,Rotar; Vladimir,5,0,34,29
1657158372871,MATH 193A,A03,083781,Rotar; Vladimir,1,0,34,33
1657158372871,MATH 193A,A04,083782,Rotar; Vladimir,8,0,34,26
1657158372871,MATH 193A,A05,093482,Rotar; Vladimir,6,0,34,28
1657158378898,MATH 197,001,091859,McAuley; Julian John,9999,0,9999,0
1657158378898,MATH 197,002,095566,Kedlaya; Kiran S.,9997,0,9999,2
1657158378898,MATH 197,003,095567,Xiao; Ming,9999,0,9999,0
1657158378898,MATH 197,004,095571,Perols; Johan Lars,9998,0,9999,1
1657158385963,COGS 9,A01,083615,Shannon; Kyle Michael,7,0,75,68
1657158391986,COGS 11,A01,083617,Boyle; Mary E. T.,22,0,48,26
1657158398009,COGS 13,A01,083071,Bastos; Amalia Pinkusfeld,9,0,71,62
1657158404033,COGS 14A,A01,092681,Semenuks; Arturs,1,1,100,99
1657158410054,COGS 14B,A01,083073,Cheng; Tzu-Han,6,0,63,57
1657158416077,COGS 17,A01,092677,Semenuks; Arturs,4,0,81,77
1657158422100,COGS 100,A01,083619,Allen; Michael Gordon,15,0,70,55
1657158428128,COGS 101A,A01,083621,Davis; Joshua Daniel,9,0,68,59
1657158434152,COGS 101B,A01,091572,Allen; Michael Gordon,9,0,65,56
1657158440176,COGS 101C,A01,083625,Delgado; Tania,17,0,35,18
1657158446198,COGS 107A,A01,083627,Boyle; Mary E. T.,13,0,60,47
1657158452219,COGS 118A,A01,083075,Gupta; Anjum,16,0,76,60
1657158458243,CSE 3,A50,083646,Miranda; Gregory Joseph,24,0,50,26
1657158464268,CSE 8A,A50,083650,Miranda; Gregory Joseph,17,1,56,39
1657158470295,CSE 11,A01,083080,Cao; Yingjun,5,15,40,35
1657158476319,CSE 12,A01,083652,Krause-Levy; Sophia Louisa,24,1,120,96
1657158482348,CSE 15L,A01,083654,Morris; Justin Loren,9,0,50,41
1657158482348,CSE 15L,A02,083655,Morris; Justin Loren,9,0,50,41
1657158488371,CSE 20,A01,083657,Tran; Khoa Dang,38,0,80,42
1657158494394,CSE 21,A01,095574,Bach; Quang Tran,22,0,48,26
1657158500416,CSE 30,A01,083084,Eldon; John,4,0,80,76
1657158500416,CSE 30,B01,095061,Bhaskar; Nishant,7,0,50,43
1657158506443,CSE 100,A01,083659,Cao; Yingjun,4,4,70,66
1657158512470,CSE 134B,A01,083661,Powell; Thomas Allan,20,0,100,80
1657158518493,CSE 140,A01,083663,Gungor; Onat,13,0,85,72
1657158524515,CSE 140L,A01,083088,Eldon; John,17,0,100,83
1657158530542,CSE 175,A01,083665,Kumar; Rakesh,3,0,25,22
1657158536565,CSE 190,A00,092507,Dubnov; Shlomo,7,0,20,13
1657158542592,ECE 45,A01,083139,Congero; Spencer William,5,0,75,70
1657158548624,ECE 65,A50,083695,Saad; Andrew S,12,0,30,18
1657158548624,ECE 65,A51,095125,Saad; Andrew S,25,0,26,1
1657158554647,ECE 109,A01,091882,Touri; Behrouz,18,0,70,52
1657158560673,ECE 180,A00,083140,Abi Samra; Nicholas Camill,1,0,30,29
1657158560673,ECE 180,B00,083141,Abi Samra; Nicholas Camill,0,0,30,30
1657158566705,MATH 10A,A01,083735,Patchell; Gregory David,2,0,30,28
1657158566705,MATH 10A,A02,083736,Patchell; Gregory David,20,0,30,10
1657158566705,MATH 10A,A03,083737,Patchell; Gregory David,16,0,30,14
1657158572733,MATH 10B,A01,083207,Lim; Seonhee,7,0,34,27
1657158572733,MATH 10B,A02,083208,Lim; Seonhee,9,0,35,26
1657158572733,MATH 10B,A03,093472,Lim; Seonhee,5,0,34,29
1657158572733,MATH 10B,B01,083739,Sinha; Shubham,9,0,30,21
1657158578765,MATH 18,A01,083743,Cinel; Cameron Alexander,6,0,30,24
1657158578765,MATH 18,A02,083744,Cinel; Cameron Alexander,15,0,30,15
1657158578765,MATH 18,A03,083745,Cinel; Cameron Alexander,8,0,30,22
1657158578765,MATH 18,B01,083748,Rideout; David Porter,4,0,37,33
1657158578765,MATH 18,B02,083749,Rideout; David Porter,3,0,36,33
1657158578765,MATH 18,B03,083750,Rideout; David Porter,2,0,37,35
1657158578765,MATH 18,B04,083751,Rideout; David Porter,5,0,36,31
1657158578765,MATH 18,B05,093473,Rideout; David Porter,5,0,36,31
1657158578765,MATH 18,B06,093474,Rideout; David Porter,5,0,36,31
1657158584790,MATH 20A,A01,083754,Zheng; Zequn,12,0,40,28
1657158590818,MATH 20B,A01,083756,Briones; Jor-el Thomas Caparas,1,0,36,35
1657158590818,MATH 20B,A02,083757,Briones; Jor-el Thomas Caparas,1,0,36,35
1657158590818,MATH 20B,A03,093475,Briones; Jor-el Thomas Caparas,1,0,36,35
1657158596841,MATH 20C,A01,083760,Briones; Jor-el Thomas Caparas,1,0,35,34
1657158596841,MATH 20C,A02,083761,Briones; Jor-el Thomas Caparas,8,0,35,27
1657158596841,MATH 20C,A03,093476,Briones; Jor-el Thomas Caparas,0,1,36,36
1657158596841,MATH 20C,B01,083762,Bach; Quang Tran,1,0,30,29
1657158602875,MATH 20D,A01,083765,Tran; Brian Kha,4,0,30,26
1657158602875,MATH 20D,A02,083766,Tran; Brian Kha,5,0,30,25
1657158602875,MATH 20D,A03,083767,Tran; Brian Kha,3,0,30,27
1657158608904,MATH 20E,A01,083771,Ganguly; Soumya,7,0,32,25
1657158608904,MATH 20E,A02,083772,Ganguly; Soumya,7,0,32,25
1657158608904,MATH 20E,B01,083773,Ciotti; Benjamin,19,0,35,16
1657158608904,MATH 20E,B02,083774,Ciotti; Benjamin,17,0,35,18
1657158614927,MATH 103A,A01,083777,Greenfeld; Be'Eri,2,0,36,34
1657158614927,MATH 103A,A02,083778,Greenfeld; Be'Eri,5,0,36,31
1657158614927,MATH 103A,A03,093561,Greenfeld; Be'Eri,4,0,36,32
1657158614927,MATH 103A,B01,083779,Greenfeld; Be'Eri,6,0,36,30
1657158614927,MATH 103A,B02,083780,Greenfeld; Be'Eri,3,0,36,33
1657158614927,MATH 103A,B03,093562,Greenfeld; Be'Eri,3,0,36,33
1657158620951,MATH 105,A01,085443,Carter; Anne Toulson,14,0,35,21
1657158620951,MATH 105,A02,093477,Carter; Anne Toulson,20,0,35,15
1657158626977,MATH 109,A01,083213,Ganzberger; Geoffrey Michael,2,0,34,32
1657158626977,MATH 109,A02,083214,Ganzberger; Geoffrey Michael,3,0,34,31
1657158626977,MATH 109,A03,093478,Ganzberger; Geoffrey Michael,1,0,34,33
1657158626977,MATH 109,B01,083215,Ganzberger; Geoffrey Michael,1,0,32,31
1657158626977,MATH 109,B02,083216,Ganzberger; Geoffrey Michael,1,0,32,31
1657158626977,MATH 109,B03,093479,Ganzberger; Geoffrey Michael,6,0,32,26
1657158633002,MATH 142A,A01,083219,Chow; Bennett,6,0,32,26
1657158633002,MATH 142A,A02,083220,Chow; Bennett,10,0,32,22
1657158633002,MATH 142A,A03,093480,Chow; Bennett,7,0,32,25
1657158633002,MATH 142A,B03,093481,Chow; Bennett,8,0,32,24
1657158633002,MATH 142A,B04,093558,Chow; Bennett,11,0,32,21
1657158633002,MATH 142A,B05,093559,Chow; Bennett,6,0,32,26
1657158639037,MATH 193A,A01,083224,Rotar; Vladimir,7,0,34,27
1657158639037,MATH 193A,A02,083225,Rotar; Vladimir,5,0,34,29
1657158639037,MATH 193A,A03,083781,Rotar; Vladimir,1,0,34,33
1657158639037,MATH 193A,A04,083782,Rotar; Vladimir,8,0,34,26
1657158639037,MATH 193A,A05,093482,Rotar; Vladimir,6,0,34,28
1657158645062,MATH 197,001,091859,McAuley; Julian John,9999,0,9999,0
1657158645062,MATH 197,002,095566,Kedlaya; Kiran S.,9997,0,9999,2
1657158645062,MATH 197,003,095567,Xiao; Ming,9999,0,9999,0
1657158645062,MATH 197,004,095571,Perols; Johan Lars,9998,0,9999,1
1657158652140,COGS 9,A01,083615,Shannon; Kyle Michael,7,0,75,68
1657158658163,COGS 11,A01,083617,Boyle; Mary E. T.,22,0,48,26
1657158664186,COGS 13,A01,083071,Bastos; Amalia Pinkusfeld,9,0,71,62
1657158670212,COGS 14A,A01,092681,Semenuks; Arturs,1,1,100,99
1657158676237,COGS 14B,A01,083073,Cheng; Tzu-Han,6,0,63,57
1657158682270,COGS 17,A01,092677,Semenuks; Arturs,4,0,81,77
1657158688293,COGS 100,A01,083619,Allen; Michael Gordon,15,0,70,55
1657158694323,COGS 101A,A01,083621,Davis; Joshua Daniel,9,0,68,59
1657158700347,COGS 101B,A01,091572,Allen; Michael Gordon,9,0,65,56
1657158706371,COGS 101C,A01,083625,Delgado; Tania,17,0,35,18
1657158712392,COGS 107A,A01,083627,Boyle; Mary E. T.,13,0,60,47
1657158718418,COGS 118A,A01,083075,Gupta; Anjum,16,0,76,60
1657158724444,CSE 3,A50,083646,Miranda; Gregory Joseph,24,0,50,26
1657158730468,CSE 8A,A50,083650,Miranda; Gregory Joseph,17,1,56,39
1657158736490,CSE 11,A01,083080,Cao; Yingjun,5,15,40,35
1657158742517,CSE 12,A01,083652,Krause-Levy; Sophia Louisa,24,1,120,96
1657158748545,CSE 15L,A01,083654,Morris; Justin Loren,9,0,50,41
1657158748545,CSE 15L,A02,083655,Morris; Justin Loren,9,0,50,41
1657158754576,CSE 20,A01,083657,Tran; Khoa Dang,38,0,80,42
1657158760599,CSE 21,A01,095574,Bach; Quang Tran,22,0,48,26
1657158766694,CSE 30,A01,083084,Eldon; John,4,0,80,76
1657158766694,CSE 30,B01,095061,Bhaskar; Nishant,7,0,50,43
1657158772716,CSE 100,A01,083659,Cao; Yingjun,4,4,70,66
1657158778743,CSE 134B,A01,083661,Powell; Thomas Allan,20,0,100,80
1657158784765,CSE 140,A01,083663,Gungor; Onat,13,0,85,72
1657158790791,CSE 140L,A01,083088,Eldon; John,17,0,100,83
1657158796812,CSE 175,A01,083665,Kumar; Rakesh,3,0,25,22
1657158802837,CSE 190,A00,092507,Dubnov; Shlomo,7,0,20,13
1657158808863,ECE 45,A01,083139,Congero; Spencer William,5,0,75,70
1657158814887,ECE 65,A50,083695,Saad; Andrew S,12,0,30,18
1657158814887,ECE 65,A51,095125,Saad; Andrew S,25,0,26,1
1657158820908,ECE 109,A01,091882,Touri; Behrouz,18,0,70,52
1657158826931,ECE 180,A00,083140,Abi Samra; Nicholas Camill,1,0,30,29
1657158826931,ECE 180,B00,083141,Abi Samra; Nicholas Camill,0,0,30,30
1657158832968,MATH 10A,A01,083735,Patchell; Gregory David,2,0,30,28
1657158832968,MATH 10A,A02,083736,Patchell; Gregory David,20,0,30,10
1657158832968,MATH 10A,A03,083737,Patchell; Gregory David,16,0,30,14
1657158839002,MATH 10B,A01,083207,Lim; Seonhee,7,0,34,27
1657158839002,MATH 10B,A02,083208,Lim; Seonhee,9,0,35,26
1657158839002,MATH 10B,A03,093472,Lim; Seonhee,5,0,34,29
1657158839002,MATH 10B,B01,083739,Sinha; Shubham,9,0,30,21
1657158845032,MATH 18,A01,083743,Cinel; Cameron Alexander,6,0,30,24
1657158845032,MATH 18,A02,083744,Cinel; Cameron Alexander,15,0,30,15
1657158845032,MATH 18,A03,083745,Cinel; Cameron Alexander,8,0,30,22
1657158845032,MATH 18,B01,083748,Rideout; David Porter,4,0,37,33
1657158845032,MATH 18,B02,083749,Rideout; David Porter,3,0,36,33
1657158845032,MATH 18,B03,083750,Rideout; David Porter,2,0,37,35
1657158845032,MATH 18,B04,083751,Rideout; David Porter,5,0,36,31
1657158845032,MATH 18,B05,093473,Rideout; David Porter,5,0,36,31
1657158845032,MATH 18,B06,093474,Rideout; David Porter,5,0,36,31
1657158851055,MATH 20A,A01,083754,Zheng; Zequn,12,0,40,28
1657158857080,MATH 20B,A01,083756,Briones; Jor-el Thomas Caparas,1,0,36,35
1657158857080,MATH 20B,A02,083757,Briones; Jor-el Thomas Caparas,1,0,36,35
1657158857080,MATH 20B,A03,093475,Briones; Jor-el Thomas Caparas,1,0,36,35
1657158863108,MATH 20C,A01,083760,Briones; Jor-el Thomas Caparas,1,0,35,34
1657158863108,MATH 20C,A02,083761,Briones; Jor-el Thomas Caparas,8,0,35,27
1657158863108,MATH 20C,A03,093476,Briones; Jor-el Thomas Caparas,0,1,36,36
1657158863108,MATH 20C,B01,083762,Bach; Quang Tran,1,0,30,29
1657158869132,MATH 20D,A01,083765,Tran; Brian Kha,4,0,30,26
1657158869132,MATH 20D,A02,083766,Tran; Brian Kha,5,0,30,25
1657158869132,MATH 20D,A03,083767,Tran; Brian Kha,3,0,30,27
1657158875162,MATH 20E,A01,083771,Ganguly; Soumya,7,0,32,25
1657158875162,MATH 20E,A02,083772,Ganguly; Soumya,7,0,32,25
1657158875162,MATH 20E,B01,083773,Ciotti; Benjamin,19,0,35,16
1657158875162,MATH 20E,B02,083774,Ciotti; Benjamin,17,0,35,18
1657158881191,MATH 103A,A01,083777,Greenfeld; Be'Eri,2,0,36,34
1657158881191,MATH 103A,A02,083778,Greenfeld; Be'Eri,5,0,36,31
1657158881191,MATH 103A,A03,093561,Greenfeld; Be'Eri,4,0,36,32
1657158881191,MATH 103A,B01,083779,Greenfeld; Be'Eri,6,0,36,30
1657158881191,MATH 103A,B02,083780,Greenfeld; Be'Eri,3,0,36,33
1657158881191,MATH 103A,B03,093562,Greenfeld; Be'Eri,3,0,36,33
1657158887218,MATH 105,A01,085443,Carter; Anne Toulson,14,0,35,21
1657158887218,MATH 105,A02,093477,Carter; Anne Toulson,20,0,35,15
1657158893242,MATH 109,A01,083213,Ganzberger; Geoffrey Michael,2,0,34,32
1657158893242,MATH 109,A02,083214,Ganzberger; Geoffrey Michael,3,0,34,31
1657158893242,MATH 109,A03,093478,Ganzberger; Geoffrey Michael,1,0,34,33
1657158893242,MATH 109,B01,083215,Ganzberger; Geoffrey Michael,1,0,32,31
1657158893242,MATH 109,B02,083216,Ganzberger; Geoffrey Michael,1,0,32,31
1657158893242,MATH 109,B03,093479,Ganzberger; Geoffrey Michael,6,0,32,26
1657158899272,MATH 142A,A01,083219,Chow; Bennett,6,0,32,26
1657158899272,MATH 142A,A02,083220,Chow; Bennett,10,0,32,22
1657158899272,MATH 142A,A03,093480,Chow; Bennett,7,0,32,25
1657158899272,MATH 142A,B03,093481,Chow; Bennett,8,0,32,24
1657158899272,MATH 142A,B04,093558,Chow; Bennett,11,0,32,21
1657158899272,MATH 142A,B05,093559,Chow; Bennett,6,0,32,26
1657158905295,MATH 193A,A01,083224,Rotar; Vladimir,7,0,34,27
1657158905295,MATH 193A,A02,083225,Rotar; Vladimir,5,0,34,29
1657158905295,MATH 193A,A03,083781,Rotar; Vladimir,1,0,34,33
1657158905295,MATH 193A,A04,083782,Rotar; Vladimir,8,0,34,26
1657158905295,MATH 193A,A05,093482,Rotar; Vladimir,6,0,34,28
1657158911322,MATH 197,001,091859,McAuley; Julian John,9999,0,9999,0
1657158911322,MATH 197,002,095566,Kedlaya; Kiran S.,9997,0,9999,2
1657158911322,MATH 197,003,095567,Xiao; Ming,9999,0,9999,0
1657158911322,MATH 197,004,095571,Perols; Johan Lars,9998,0,9999,1
1657158918380,COGS 9,A01,083615,Shannon; Kyle Michael,7,0,75,68
1657158924405,COGS 11,A01,083617,Boyle; Mary E. T.,22,0,48,26
1657158930427,COGS 13,A01,083071,Bastos; Amalia Pinkusfeld,9,0,71,62
1657158936451,COGS 14A,A01,092681,Semenuks; Arturs,1,1,100,99
1657158942478,COGS 14B,A01,083073,Cheng; Tzu-Han,6,0,63,57
1657158948504,COGS 17,A01,092677,Semenuks; Arturs,4,0,81,77
1657158954529,COGS 100,A01,083619,Allen; Michael Gordon,15,0,70,55
1657158960562,COGS 101A,A01,083621,Davis; Joshua Daniel,9,0,68,59
1657158966588,COGS 101B,A01,091572,Allen; Michael Gordon,9,0,65,56
1657158972615,COGS 101C,A01,083625,Delgado; Tania,17,0,35,18
1657158978638,COGS 107A,A01,083627,Boyle; Mary E. T.,13,0,60,47
1657158984665,COGS 118A,A01,083075,Gupta; Anjum,16,0,76,60
1657158990690,CSE 3,A50,083646,Miranda; Gregory Joseph,24,0,50,26
1657158996711,CSE 8A,A50,083650,Miranda; Gregory Joseph,17,1,56,39
1657159002742,CSE 11,A01,083080,Cao; Yingjun,5,15,40,35
1657159008765,CSE 12,A01,083652,Krause-Levy; Sophia Louisa,24,1,120,96
1657159014788,CSE 15L,A01,083654,Morris; Justin Loren,9,0,50,41
1657159014788,CSE 15L,A02,083655,Morris; Justin Loren,9,0,50,41
1657159020814,CSE 20,A01,083657,Tran; Khoa Dang,38,0,80,42
1657159026843,CSE 21,A01,095574,Bach; Quang Tran,22,0,48,26
1657159032876,CSE 30,A01,083084,Eldon; John,4,0,80,76
1657159032876,CSE 30,B01,095061,Bhaskar; Nishant,7,0,50,43
1657159038906,CSE 100,A01,083659,Cao; Yingjun,4,4,70,66
1657159044935,CSE 134B,A01,083661,Powell; Thomas Allan,20,0,100,80
1657159050959,CSE 140,A01,083663,Gungor; Onat,13,0,85,72
1657159056985,CSE 140L,A01,083088,Eldon; John,17,0,100,83
1657159063020,CSE 175,A01,083665,Kumar; Rakesh,3,0,25,22
1657159069045,CSE 190,A00,092507,Dubnov; Shlomo,7,0,20,13
1657159075070,ECE 45,A01,083139,Congero; Spencer William,5,0,75,70
1657159081098,ECE 65,A50,083695,Saad; Andrew S,12,0,30,18
1657159081098,ECE 65,A51,095125,Saad; Andrew S,25,0,26,1
1657159087132,ECE 109,A01,091882,Touri; Behrouz,18,0,70,52
1657159093165,ECE 180,A00,083140,Abi Samra; Nicholas Camill,1,0,30,29
1657159093165,ECE 180,B00,083141,Abi Samra; Nicholas Camill,0,0,30,30
1657159099200,MATH 10A,A01,083735,Patchell; Gregory David,2,0,30,28
1657159099200,MATH 10A,A02,083736,Patchell; Gregory David,20,0,30,10
1657159099200,MATH 10A,A03,083737,Patchell; Gregory David,16,0,30,14
1657159105222,MATH 10B,A01,083207,Lim; Seonhee,7,0,34,27
1657159105222,MATH 10B,A02,083208,Lim; Seonhee,9,0,35,26
1657159105222,MATH 10B,A03,093472,Lim; Seonhee,5,0,34,29
1657159105222,MATH 10B,B01,083739,Sinha; Shubham,9,0,30,21
1657159111245,MATH 18,A01,083743,Cinel; Cameron Alexander,6,0,30,24
1657159111245,MATH 18,A02,083744,Cinel; Cameron Alexander,15,0,30,15
1657159111245,MATH 18,A03,083745,Cinel; Cameron Alexander,8,0,30,22
1657159111245,MATH 18,B01,083748,Rideout; David Porter,4,0,37,33
1657159111245,MATH 18,B02,083749,Rideout; David Porter,3,0,36,33
1657159111245,MATH 18,B03,083750,Rideout; David Porter,2,0,37,35
1657159111245,MATH 18,B04,083751,Rideout; David Porter,5,0,36,31
1657159111245,MATH 18,B05,093473,Rideout; David Porter,5,0,36,31
1657159111245,MATH 18,B06,093474,Rideout; David Porter,5,0,36,31
1657159117267,MATH 20A,A01,083754,Zheng; Zequn,12,0,40,28
1657159123293,MATH 20B,A01,083756,Briones; Jor-el Thomas Caparas,1,0,36,35
1657159123293,MATH 20B,A02,083757,Briones; Jor-el Thomas Caparas,1,0,36,35
1657159123293,MATH 20B,A03,093475,Briones; Jor-el Thomas Caparas,1,0,36,35
1657159129316,MATH 20C,A01,083760,Briones; Jor-el Thomas Caparas,1,0,35,34
1657159129316,MATH 20C,A02,083761,Briones; Jor-el Thomas Caparas,8,0,35,27
1657159129316,MATH 20C,A03,093476,Briones; Jor-el Thomas Caparas,0,1,36,36
1657159129316,MATH 20C,B01,083762,Bach; Quang Tran,1,0,30,29
1657159135339,MATH 20D,A01,083765,Tran; Brian Kha,4,0,30,26
1657159135339,MATH 20D,A02,083766,Tran; Brian Kha,5,0,30,25
1657159135339,MATH 20D,A03,083767,Tran; Brian Kha,3,0,30,27
1657159141367,MATH 20E,A01,083771,Ganguly; Soumya,7,0,32,25
1657159141367,MATH 20E,A02,083772,Ganguly; Soumya,7,0,32,25
1657159141367,MATH 20E,B01,083773,Ciotti; Benjamin,19,0,35,16
1657159141367,MATH 20E,B02,083774,Ciotti; Benjamin,17,0,35,18
1657159147392,MATH 103A,A01,083777,Greenfeld; Be'Eri,2,0,36,34
1657159147392,MATH 103A,A02,083778,Greenfeld; Be'Eri,5,0,36,31
1657159147392,MATH 103A,A03,093561,Greenfeld; Be'Eri,4,0,36,32
1657159147392,MATH 103A,B01,083779,Greenfeld; Be'Eri,6,0,36,30
1657159147392,MATH 103A,B02,083780,Greenfeld; Be'Eri,3,0,36,33
1657159147392,MATH 103A,B03,093562,Greenfeld; Be'Eri,3,0,36,33
1657159153419,MATH 105,A01,085443,Carter; Anne Toulson,14,0,35,21
1657159153419,MATH 105,A02,093477,Carter; Anne Toulson,20,0,35,15
1657159159447,MATH 109,A01,083213,Ganzberger; Geoffrey Michael,2,0,34,32
1657159159447,MATH 109,A02,083214,Ganzberger; Geoffrey Michael,3,0,34,31
1657159159447,MATH 109,A03,093478,Ganzberger; Geoffrey Michael,1,0,34,33
1657159159447,MATH 109,B01,083215,Ganzberger; Geoffrey Michael,1,0,32,31
1657159159447,MATH 109,B02,083216,Ganzberger; Geoffrey Michael,1,0,32,31
1657159159447,MATH 109,B03,093479,Ganzberger; Geoffrey Michael,6,0,32,26
1657159165477,MATH 142A,A01,083219,Chow; Bennett,6,0,32,26
1657159165477,MATH 142A,A02,083220,Chow; Bennett,10,0,32,22
1657159165477,MATH 142A,A03,093480,Chow; Bennett,7,0,32,25
1657159165477,MATH 142A,B03,093481,Chow; Bennett,8,0,32,24
1657159165477,MATH 142A,B04,093558,Chow; Bennett,11,0,32,21
1657159165477,MATH 142A,B05,093559,Chow; Bennett,6,0,32,26
1657159171502,MATH 193A,A01,083224,Rotar; Vladimir,7,0,34,27
1657159171502,MATH 193A,A02,083225,Rotar; Vladimir,5,0,34,29
1657159171502,MATH 193A,A03,083781,Rotar; Vladimir,1,0,34,33
1657159171502,MATH 193A,A04,083782,Rotar; Vladimir,8,0,34,26
1657159171502,MATH 193A,A05,093482,Rotar; Vladimir,6,0,34,28
1657159177525,MATH 197,001,091859,McAuley; Julian John,9999,0,9999,0
1657159177525,MATH 197,002,095566,Kedlaya; Kiran S.,9997,0,9999,2
1657159177525,MATH 197,003,095567,Xiao; Ming,9999,0,9999,0
1657159177525,MATH 197,004,095571,Perols; Johan Lars,9998,0,9999,1
1657159184598,COGS 9,A01,083615,Shannon; Kyle Michael,7,0,75,68
1657159190624,COGS 11,A01,083617,Boyle; Mary E. T.,22,0,48,26
1657159196649,COGS 13,A01,083071,Bastos; Amalia Pinkusfeld,9,0,71,62
1657159202671,COGS 14A,A01,092681,Semenuks; Arturs,1,1,100,99
1657159208701,COGS 14B,A01,083073,Cheng; Tzu-Han,6,0,63,57
1657159214724,COGS 17,A01,092677,Semenuks; Arturs,4,0,81,77
1657159220746,COGS 100,A01,083619,Allen; Michael Gordon,15,0,70,55
1657159226776,COGS 101A,A01,083621,Davis; Joshua Daniel,9,0,68,59
1657159232803,COGS 101B,A01,091572,Allen; Michael Gordon,9,0,65,56
1657159238839,COGS 101C,A01,083625,Delgado; Tania,17,0,35,18
1657159244866,COGS 107A,A01,083627,Boyle; Mary E. T.,13,0,60,47
1657159250895,COGS 118A,A01,083075,Gupta; Anjum,16,0,76,60
1657159256922,CSE 3,A50,083646,Miranda; Gregory Joseph,24,0,50,26
1657159262944,CSE 8A,A50,083650,Miranda; Gregory Joseph,17,1,56,39
1657159268967,CSE 11,A01,083080,Cao; Yingjun,5,15,40,35
1657159274990,CSE 12,A01,083652,Krause-Levy; Sophia Louisa,24,1,120,96
1657159281031,CSE 15L,A01,083654,Morris; Justin Loren,9,0,50,41
1657159281031,CSE 15L,A02,083655,Morris; Justin Loren,9,0,50,41
1657159287055,CSE 20,A01,083657,Tran; Khoa Dang,38,0,80,42
1657159293078,CSE 21,A01,095574,Bach; Quang Tran,22,0,48,26
1657159299102,CSE 30,A01,083084,Eldon; John,4,0,80,76
1657159299102,CSE 30,B01,095061,Bhaskar; Nishant,7,0,50,43
1657159305127,CSE 100,A01,083659,Cao; Yingjun,4,4,70,66
1657159311152,CSE 134B,A01,083661,Powell; Thomas Allan,20,0,100,80
1657159317180,CSE 140,A01,083663,Gungor; Onat,13,0,85,72
1657159323204,CSE 140L,A01,083088,Eldon; John,17,0,100,83
1657159329230,CSE 175,A01,083665,Kumar; Rakesh,3,0,25,22
1657159335256,CSE 190,A00,092507,Dubnov; Shlomo,7,0,20,13
1657159341278,ECE 45,A01,083139,Congero; Spencer William,5,0,75,70
1657159347314,ECE 65,A50,083695,Saad; Andrew S,12,0,30,18
1657159347314,ECE 65,A51,095125,Saad; Andrew S,25,0,26,1
1657159353340,ECE 109,A01,091882,Touri; Behrouz,18,0,70,52
1657159359364,ECE 180,A00,083140,Abi Samra; Nicholas Camill,1,0,30,29
1657159359364,ECE 180,B00,083141,Abi Samra; Nicholas Camill,0,0,30,30
1657159365467,MATH 10A,A01,083735,Patchell; Gregory David,2,0,30,28
1657159365467,MATH 10A,A02,083736,Patchell; Gregory David,20,0,30,10
1657159365467,MATH 10A,A03,083737,Patchell; Gregory David,16,0,30,14
1657159371492,MATH 10B,A01,083207,Lim; Seonhee,7,0,34,27
1657159371492,MATH 10B,A02,083208,Lim; Seonhee,9,0,35,26
1657159371492,MATH 10B,A03,093472,Lim; Seonhee,5,0,34,29
1657159371492,MATH 10B,B01,083739,Sinha; Shubham,9,0,30,21
1657159377524,MATH 18,A01,083743,Cinel; Cameron Alexander,6,0,30,24
1657159377524,MATH 18,A02,083744,Cinel; Cameron Alexander,15,0,30,15
1657159377524,MATH 18,A03,083745,Cinel; Cameron Alexander,8,0,30,22
1657159377524,MATH 18,B01,083748,Rideout; David Porter,4,0,37,33
1657159377524,MATH 18,B02,083749,Rideout; David Porter,3,0,36,33
1657159377524,MATH 18,B03,083750,Rideout; David Porter,2,0,37,35
1657159377524,MATH 18,B04,083751,Rideout; David Porter,5,0,36,31
1657159377524,MATH 18,B05,093473,Rideout; David Porter,5,0,36,31
1657159377524,MATH 18,B06,093474,Rideout; David Porter,5,0,36,31
1657159383546,MATH 20A,A01,083754,Zheng; Zequn,12,0,40,28
1657159389575,MATH 20B,A01,083756,Briones; Jor-el Thomas Caparas,1,0,36,35
1657159389575,MATH 20B,A02,083757,Briones; Jor-el Thomas Caparas,1,0,36,35
1657159389575,MATH 20B,A03,093475,Briones; Jor-el Thomas Caparas,1,0,36,35
1657159395598,MATH 20C,A01,083760,Briones; Jor-el Thomas Caparas,1,0,35,34
1657159395598,MATH 20C,A02,083761,Briones; Jor-el Thomas Caparas,8,0,35,27
1657159395598,MATH 20C,A03,093476,Briones; Jor-el Thomas Caparas,0,1,36,36
1657159395598,MATH 20C,B01,083762,Bach; Quang Tran,1,0,30,29
1657159401630,MATH 20D,A01,083765,Tran; Brian Kha,4,0,30,26
1657159401630,MATH 20D,A02,083766,Tran; Brian Kha,5,0,30,25
1657159401630,MATH 20D,A03,083767,Tran; Brian Kha,3,0,30,27
1657159407654,MATH 20E,A01,083771,Ganguly; Soumya,7,0,32,25
1657159407654,MATH 20E,A02,083772,Ganguly; Soumya,7,0,32,25
1657159407654,MATH 20E,B01,083773,Ciotti; Benjamin,19,0,35,16
1657159407654,MATH 20E,B02,083774,Ciotti; Benjamin,17,0,35,18
1657159413678,MATH 103A,A01,083777,Greenfeld; Be'Eri,2,0,36,34
1657159413678,MATH 103A,A02,083778,Greenfeld; Be'Eri,5,0,36,31
1657159413678,MATH 103A,A03,093561,Greenfeld; Be'Eri,4,0,36,32
1657159413678,MATH 103A,B01,083779,Greenfeld; Be'Eri,6,0,36,30
1657159413678,MATH 103A,B02,083780,Greenfeld; Be'Eri,3,0,36,33
1657159413678,MATH 103A,B03,093562,Greenfeld; Be'Eri,3,0,36,33
1657159419706,MATH 105,A01,085443,Carter; Anne Toulson,14,0,35,21
1657159419706,MATH 105,A02,093477,Carter; Anne Toulson,20,0,35,15
1657159425734,MATH 109,A01,083213,Ganzberger; Geoffrey Michael,2,0,34,32
1657159425734,MATH 109,A02,083214,Ganzberger; Geoffrey Michael,3,0,34,31
1657159425734,MATH 109,A03,093478,Ganzberger; Geoffrey Michael,1,0,34,33
1657159425734,MATH 109,B01,083215,Ganzberger; Geoffrey Michael,1,0,32,31
1657159425734,MATH 109,B02,083216,Ganzberger; Geoffrey Michael,1,0,32,31
1657159425734,MATH 109,B03,093479,Ganzberger; Geoffrey Michael,6,0,32,26
1657159431760,MATH 142A,A01,083219,Chow; Bennett,6,0,32,26
1657159431760,MATH 142A,A02,083220,Chow; Bennett,10,0,32,22
1657159431760,MATH 142A,A03,093480,Chow; Bennett,7,0,32,25
1657159431760,MATH 142A,B03,093481,Chow; Bennett,8,0,32,24
1657159431760,MATH 142A,B04,093558,Chow; Bennett,11,0,32,21
1657159431760,MATH 142A,B05,093559,Chow; Bennett,6,0,32,26
1657159437797,MATH 193A,A01,083224,Rotar; Vladimir,7,0,34,27
1657159437797,MATH 193A,A02,083225,Rotar; Vladimir,5,0,34,29
1657159437797,MATH 193A,A03,083781,Rotar; Vladimir,1,0,34,33
1657159437797,MATH 193A,A04,083782,Rotar; Vladimir,8,0,34,26
1657159437797,MATH 193A,A05,093482,Rotar; Vladimir,6,0,34,28
1657159443832,MATH 197,001,091859,McAuley; Julian John,9999,0,9999,0
1657159443832,MATH 197,002,095566,Kedlaya; Kiran S.,9997,0,9999,2
1657159443832,MATH 197,003,095567,Xiao; Ming,9999,0,9999,0
1657159443832,MATH 197,004,095571,Perols; Johan Lars,9998,0,9999,1
1657159450888,COGS 9,A01,083615,Shannon; Kyle Michael,7,0,75,68
1657159456915,COGS 11,A01,083617,Boyle; Mary E. T.,22,0,48,26
1657159462943,COGS 13,A01,083071,Bastos; Amalia Pinkusfeld,9,0,71,62
1657159468968,COGS 14A,A01,092681,Semenuks; Arturs,1,1,100,99
1657159474990,COGS 14B,A01,083073,Cheng; Tzu-Han,6,0,63,57
1657159481015,COGS 17,A01,092677,Semenuks; Arturs,4,0,81,77
1657159487043,COGS 100,A01,083619,Allen; Michael Gordon,15,0,70,55
1657159493078,COGS 101A,A01,083621,Davis; Joshua Daniel,9,0,68,59
1657159499105,COGS 101B,A01,091572,Allen; Michael Gordon,9,0,65,56
1657159505138,COGS 101C,A01,083625,Delgado; Tania,17,0,35,18
1657159511160,COGS 107A,A01,083627,Boyle; Mary E. T.,13,0,60,47
1657159517187,COGS 118A,A01,083075,Gupta; Anjum,16,0,76,60
1657159523215,CSE 3,A50,083646,Miranda; Gregory Joseph,24,0,50,26
1657159529239,CSE 8A,A50,083650,Miranda; Gregory Joseph,17,1,56,39
1657159535263,CSE 11,A01,083080,Cao; Yingjun,5,15,40,35
1657159541287,CSE 12,A01,083652,Krause-Levy; Sophia Louisa,24,1,120,96
1657159547311,CSE 15L,A01,083654,Morris; Justin Loren,9,0,50,41
1657159547311,CSE 15L,A02,083655,Morris; Justin Loren,9,0,50,41
1657159553334,CSE 20,A01,083657,Tran; Khoa Dang,38,0,80,42
1657159559356,CSE 21,A01,095574,Bach; Quang Tran,22,0,48,26
1657159565380,CSE 30,A01,083084,Eldon; John,4,0,80,76
1657159565380,CSE 30,B01,095061,Bhaskar; Nishant,7,0,50,43
1657159571403,CSE 100,A01,083659,Cao; Yingjun,4,4,70,66
1657159577428,CSE 134B,A01,083661,Powell; Thomas Allan,20,0,100,80
1657159583454,CSE 140,A01,083663,Gungor; Onat,13,0,85,72
1657159589489,CSE 140L,A01,083088,Eldon; John,17,0,100,83
1657159595515,CSE 175,A01,083665,Kumar; Rakesh,3,0,25,22
1657159601539,CSE 190,A00,092507,Dubnov; Shlomo,7,0,20,13
1657159607565,ECE 45,A01,083139,Congero; Spencer William,5,0,75,70
1657159613588,ECE 65,A50,083695,Saad; Andrew S,12,0,30,18
1657159613588,ECE 65,A51,095125,Saad; Andrew S,25,0,26,1
1657159619615,ECE 109,A01,091882,Touri; Behrouz,18,0,70,52
1657159625638,ECE 180,A00,083140,Abi Samra; Nicholas Camill,1,0,30,29
1657159625638,ECE 180,B00,083141,Abi Samra; Nicholas Camill,0,0,30,30
1657159631663,MATH 10A,A01,083735,Patchell; Gregory David,2,0,30,28
1657159631663,MATH 10A,A02,083736,Patchell; Gregory David,20,0,30,10
1657159631663,MATH 10A,A03,083737,Patchell; Gregory David,16,0,30,14
1657159637690,MATH 10B,A01,083207,Lim; Seonhee,7,0,34,27
1657159637690,MATH 10B,A02,083208,Lim; Seonhee,9,0,35,26
1657159637690,MATH 10B,A03,093472,Lim; Seonhee,5,0,34,29
1657159637690,MATH 10B,B01,083739,Sinha; Shubham,9,0,30,21
1657159643720,MATH 18,A01,083743,Cinel; Cameron Alexander,6,0,30,24
1657159643720,MATH 18,A02,083744,Cinel; Cameron Alexander,15,0,30,15
1657159643720,MATH 18,A03,083745,Cinel; Cameron Alexander,8,0,30,22
1657159643720,MATH 18,B01,083748,Rideout; David Porter,4,0,37,33
1657159643720,MATH 18,B02,083749,Rideout; David Porter,3,0,36,33
1657159643720,MATH 18,B03,083750,Rideout; David Porter,2,0,37,35
1657159643720,MATH 18,B04,083751,Rideout; David Porter,5,0,36,31
1657159643720,MATH 18,B05,093473,Rideout; David Porter,5,0,36,31
1657159643720,MATH 18,B06,093474,Rideout; David Porter,5,0,36,31
1657159649743,MATH 20A,A01,083754,Zheng; Zequn,12,0,40,28
1657159655775,MATH 20B,A01,083756,Briones; Jor-el Thomas Caparas,1,0,36,35
1657159655775,MATH 20B,A02,083757,Briones; Jor-el Thomas Caparas,1,0,36,35
1657159655775,MATH 20B,A03,093475,Briones; Jor-el Thomas Caparas,1,0,36,35
1657159661799,MATH 20C,A01,083760,Briones; Jor-el Thomas Caparas,1,0,35,34
1657159661799,MATH 20C,A02,083761,Briones; Jor-el Thomas Caparas,8,0,35,27
1657159661799,MATH 20C,A03,093476,Briones; Jor-el Thomas Caparas,0,1,36,36
1657159661799,MATH 20C,B01,083762,Bach; Quang Tran,1,0,30,29
1657159667824,MATH 20D,A01,083765,Tran; Brian Kha,4,0,30,26
1657159667824,MATH 20D,A02,083766,Tran; Brian Kha,5,0,30,25
1657159667824,MATH 20D,A03,083767,Tran; Brian Kha,3,0,30,27
1657159673855,MATH 20E,A01,083771,Ganguly; Soumya,7,0,32,25
1657159673855,MATH 20E,A02,083772,Ganguly; Soumya,7,0,32,25
1657159673855,MATH 20E,B01,083773,Ciotti; Benjamin,19,0,35,16
1657159673855,MATH 20E,B02,083774,Ciotti; Benjamin,17,0,35,18
1657159679885,MATH 103A,A01,083777,Greenfeld; Be'Eri,2,0,36,34
1657159679885,MATH 103A,A02,083778,Greenfeld; Be'Eri,5,0,36,31
1657159679885,MATH 103A,A03,093561,Greenfeld; Be'Eri,4,0,36,32
1657159679885,MATH 103A,B01,083779,Greenfeld; Be'Eri,6,0,36,30
1657159679885,MATH 103A,B02,083780,Greenfeld; Be'Eri,3,0,36,33
1657159679885,MATH 103A,B03,093562,Greenfeld; Be'Eri,3,0,36,33
1657159685910,MATH 105,A01,085443,Carter; Anne Toulson,14,0,35,21
1657159685910,MATH 105,A02,093477,Carter; Anne Toulson,20,0,35,15
1657159691937,MATH 109,A01,083213,Ganzberger; Geoffrey Michael,2,0,34,32
1657159691937,MATH 109,A02,083214,Ganzberger; Geoffrey Michael,3,0,34,31
1657159691937,MATH 109,A03,093478,Ganzberger; Geoffrey Michael,1,0,34,33
1657159691937,MATH 109,B01,083215,Ganzberger; Geoffrey Michael,1,0,32,31
1657159691937,MATH 109,B02,083216,Ganzberger; Geoffrey Michael,1,0,32,31
1657159691937,MATH 109,B03,093479,Ganzberger; Geoffrey Michael,6,0,32,26
1657159697962,MATH 142A,A01,083219,Chow; Bennett,6,0,32,26
1657159697962,MATH 142A,A02,083220,Chow; Bennett,10,0,32,22
1657159697962,MATH 142A,A03,093480,Chow; Bennett,7,0,32,25
1657159697962,MATH 142A,B03,093481,Chow; Bennett,8,0,32,24
1657159697962,MATH 142A,B04,093558,Chow; Bennett,11,0,32,21
1657159697962,MATH 142A,B05,093559,Chow; Bennett,6,0,32,26
1657159703985,MATH 193A,A01,083224,Rotar; Vladimir,7,0,34,27
1657159703985,MATH 193A,A02,083225,Rotar; Vladimir,5,0,34,29
1657159703985,MATH 193A,A03,083781,Rotar; Vladimir,1,0,34,33
1657159703985,MATH 193A,A04,083782,Rotar; Vladimir,8,0,34,26
1657159703985,MATH 193A,A05,093482,Rotar; Vladimir,6,0,34,28
1657159710011,MATH 197,001,091859,McAuley; Julian John,9999,0,9999,0
1657159710011,MATH 197,002,095566,Kedlaya; Kiran S.,9997,0,9999,2
1657159710011,MATH 197,003,095567,Xiao; Ming,9999,0,9999,0
1657159710011,MATH 197,004,095571,Perols; Johan Lars,9998,0,9999,1
1657159717074,COGS 9,A01,083615,Shannon; Kyle Michael,7,0,75,68
1657159723100,COGS 11,A01,083617,Boyle; Mary E. T.,22,0,48,26
1657159729122,COGS 13,A01,083071,Bastos; Amalia Pinkusfeld,9,0,71,62
1657159735149,COGS 14A,A01,092681,Semenuks; Arturs,1,1,100,99
1657159741171,COGS 14B,A01,083073,Cheng; Tzu-Han,6,0,63,57
1657159747194,COGS 17,A01,092677,Semenuks; Arturs,4,0,81,77
1657159753217,COGS 100,A01,083619,Allen; Michael Gordon,15,0,70,55
1657159759244,COGS 101A,A01,083621,Davis; Joshua Daniel,9,0,68,59
1657159765270,COGS 101B,A01,091572,Allen; Michael Gordon,9,0,65,56
1657159771293,COGS 101C,A01,083625,Delgado; Tania,17,0,35,18
1657159777319,COGS 107A,A01,083627,Boyle; Mary E. T.,13,0,60,47
1657159783352,COGS 118A,A01,083075,Gupta; Anjum,16,0,76,60
1657159789375,CSE 3,A50,083646,Miranda; Gregory Joseph,24,0,50,26
1657159795398,CSE 8A,A50,083650,Miranda; Gregory Joseph,17,1,56,39
1657159801425,CSE 11,A01,083080,Cao; Yingjun,5,15,40,35
1657159807451,CSE 12,A01,083652,Krause-Levy; Sophia Louisa,24,1,120,96
1657159813473,CSE 15L,A01,083654,Morris; Justin Loren,9,0,50,41
1657159813473,CSE 15L,A02,083655,Morris; Justin Loren,9,0,50,41
1657159819501,CSE 20,A01,083657,Tran; Khoa Dang,38,0,80,42
1657159825525,CSE 21,A01,095574,Bach; Quang Tran,22,0,48,26
1657159831549,CSE 30,A01,083084,Eldon; John,4,0,80,76
1657159831549,CSE 30,B01,095061,Bhaskar; Nishant,7,0,50,43
1657159837586,CSE 100,A01,083659,Cao; Yingjun,4,4,70,66
1657159843607,CSE 134B,A01,083661,Powell; Thomas Allan,20,0,100,80
1657159849629,CSE 140,A01,083663,Gungor; Onat,13,0,85,72
1657159855651,CSE 140L,A01,083088,Eldon; John,17,0,100,83
1657159861675,CSE 175,A01,083665,Kumar; Rakesh,3,0,25,22
1657159867701,CSE 190,A00,092507,Dubnov; Shlomo,7,0,20,13
1657159873726,ECE 45,A01,083139,Congero; Spencer William,5,0,75,70
1657159879750,ECE 65,A50,083695,Saad; Andrew S,12,0,30,18
1657159879750,ECE 65,A51,095125,Saad; Andrew S,25,0,26,1
1657159885772,ECE 109,A01,091882,Touri; Behrouz,18,0,70,52
1657159891795,ECE 180,A00,083140,Abi Samra; Nicholas Camill,1,0,30,29
1657159891795,ECE 180,B00,083141,Abi Samra; Nicholas Camill,0,0,30,30
1657159897823,MATH 10A,A01,083735,Patchell; Gregory David,2,0,30,28
1657159897823,MATH 10A,A02,083736,Patchell; Gregory David,20,0,30,10
1657159897823,MATH 10A,A03,083737,Patchell; Gregory David,16,0,30,14
1657159903845,MATH 10B,A01,083207,Lim; Seonhee,7,0,34,27
1657159903845,MATH 10B,A02,083208,Lim; Seonhee,9,0,35,26
1657159903845,MATH 10B,A03,093472,Lim; Seonhee,5,0,34,29
1657159903845,MATH 10B,B01,083739,Sinha; Shubham,9,0,30,21
1657159909876,MATH 18,A01,083743,Cinel; Cameron Alexander,6,0,30,24
1657159909876,MATH 18,A02,083744,Cinel; Cameron Alexander,15,0,30,15
1657159909876,MATH 18,A03,083745,Cinel; Cameron Alexander,8,0,30,22
1657159909876,MATH 18,B01,083748,Rideout; David Porter,4,0,37,33
1657159909876,MATH 18,B02,083749,Rideout; David Porter,3,0,36,33
1657159909876,MATH 18,B03,083750,Rideout; David Porter,2,0,37,35
1657159909876,MATH 18,B04,083751,Rideout; David Porter,5,0,36,31
1657159909876,MATH 18,B05,093473,Rideout; David Porter,5,0,36,31
1657159909876,MATH 18,B06,093474,Rideout; David Porter,5,0,36,31
1657159915902,MATH 20A,A01,083754,Zheng; Zequn,12,0,40,28
1657159921928,MATH 20B,A01,083756,Briones; Jor-el Thomas Caparas,1,0,36,35
1657159921928,MATH 20B,A02,083757,Briones; Jor-el Thomas Caparas,1,0,36,35
1657159921928,MATH 20B,A03,093475,Briones; Jor-el Thomas Caparas,1,0,36,35
1657159927956,MATH 20C,A01,083760,Briones; Jor-el Thomas Caparas,1,0,35,34
1657159927956,MATH 20C,A02,083761,Briones; Jor-el Thomas Caparas,8,0,35,27
1657159927956,MATH 20C,A03,093476,Briones; Jor-el Thomas Caparas,0,1,36,36
1657159927956,MATH 20C,B01,083762,Bach; Quang Tran,1,0,30,29
1657159933981,MATH 20D,A01,083765,Tran; Brian Kha,4,0,30,26
1657159933981,MATH 20D,A02,083766,Tran; Brian Kha,5,0,30,25
1657159933981,MATH 20D,A03,083767,Tran; Brian Kha,3,0,30,27
1657159940005,MATH 20E,A01,083771,Ganguly; Soumya,7,0,32,25
1657159940005,MATH 20E,A02,083772,Ganguly; Soumya,7,0,32,25
1657159940005,MATH 20E,B01,083773,Ciotti; Benjamin,19,0,35,16
1657159940005,MATH 20E,B02,083774,Ciotti; Benjamin,17,0,35,18
1657159946030,MATH 103A,A01,083777,Greenfeld; Be'Eri,2,0,36,34
1657159946030,MATH 103A,A02,083778,Greenfeld; Be'Eri,5,0,36,31
1657159946030,MATH 103A,A03,093561,Greenfeld; Be'Eri,4,0,36,32
1657159946030,MATH 103A,B01,083779,Greenfeld; Be'Eri,6,0,36,30
1657159946030,MATH 103A,B02,083780,Greenfeld; Be'Eri,3,0,36,33
1657159946030,MATH 103A,B03,093562,Greenfeld; Be'Eri,3,0,36,33
1657159952055,MATH 105,A01,085443,Carter; Anne Toulson,14,0,35,21
1657159952055,MATH 105,A02,093477,Carter; Anne Toulson,20,0,35,15
1657159958078,MATH 109,A01,083213,Ganzberger; Geoffrey Michael,2,0,34,32
1657159958078,MATH 109,A02,083214,Ganzberger; Geoffrey Michael,3,0,34,31
1657159958078,MATH 109,A03,093478,Ganzberger; Geoffrey Michael,1,0,34,33
1657159958078,MATH 109,B01,083215,Ganzberger; Geoffrey Michael,1,0,32,31
1657159958078,MATH 109,B02,083216,Ganzberger; Geoffrey Michael,1,0,32,31
1657159958078,MATH 109,B03,093479,Ganzberger; Geoffrey Michael,6,0,32,26
1657159964184,MATH 142A,A01,083219,Chow; Bennett,6,0,32,26
1657159964184,MATH 142A,A02,083220,Chow; Bennett,10,0,32,22
1657159964184,MATH 142A,A03,093480,Chow; Bennett,7,0,32,25
1657159964184,MATH 142A,B03,093481,Chow; Bennett,8,0,32,24
1657159964184,MATH 142A,B04,093558,Chow; Bennett,11,0,32,21
1657159964184,MATH 142A,B05,093559,Chow; Bennett,6,0,32,26
1657159970207,MATH 193A,A01,083224,Rotar; Vladimir,7,0,34,27
1657159970207,MATH 193A,A02,083225,Rotar; Vladimir,5,0,34,29
1657159970207,MATH 193A,A03,083781,Rotar; Vladimir,1,0,34,33
1657159970207,MATH 193A,A04,083782,Rotar; Vladimir,8,0,34,26
1657159970207,MATH 193A,A05,093482,Rotar; Vladimir,6,0,34,28
1657159976233,MATH 197,001,091859,McAuley; Julian John,9999,0,9999,0
1657159976233,MATH 197,002,095566,Kedlaya; Kiran S.,9997,0,9999,2
1657159976233,MATH 197,003,095567,Xiao; Ming,9999,0,9999,0
1657159976233,MATH 197,004,095571,Perols; Johan Lars,9998,0,9999,1
1657159983319,COGS 9,A01,083615,Shannon; Kyle Michael,7,0,75,68
1657159989344,COGS 11,A01,083617,Boyle; Mary E. T.,22,0,48,26
1657159995369,COGS 13,A01,083071,Bastos; Amalia Pinkusfeld,9,0,71,62
1657160001392,COGS 14A,A01,092681,Semenuks; Arturs,1,1,100,99
1657160007417,COGS 14B,A01,083073,Cheng; Tzu-Han,6,0,63,57
1657160013441,COGS 17,A01,092677,Semenuks; Arturs,4,0,81,77
1657160019468,COGS 100,A01,083619,Allen; Michael Gordon,15,0,70,55
1657160025491,COGS 101A,A01,083621,Davis; Joshua Daniel,9,0,68,59
1657160031514,COGS 101B,A01,091572,Allen; Michael Gordon,9,0,65,56
1657160037539,COGS 101C,A01,083625,Delgado; Tania,17,0,35,18
1657160043561,COGS 107A,A01,083627,Boyle; Mary E. T.,13,0,60,47
1657160049587,COGS 118A,A01,083075,Gupta; Anjum,16,0,76,60
1657160055616,CSE 3,A50,083646,Miranda; Gregory Joseph,24,0,50,26
1657160061643,CSE 8A,A50,083650,Miranda; Gregory Joseph,17,1,56,39
1657160067669,CSE 11,A01,083080,Cao; Yingjun,5,15,40,35
1657160073692,CSE 12,A01,083652,Krause-Levy; Sophia Louisa,24,1,120,96
1657160079716,CSE 15L,A01,083654,Morris; Justin Loren,9,0,50,41
1657160079716,CSE 15L,A02,083655,Morris; Justin Loren,9,0,50,41
1657160085739,CSE 20,A01,083657,Tran; Khoa Dang,38,0,80,42
1657160091778,CSE 21,A01,095574,Bach; Quang Tran,22,0,48,26
1657160097801,CSE 30,A01,083084,Eldon; John,4,0,80,76
1657160097801,CSE 30,B01,095061,Bhaskar; Nishant,7,0,50,43
1657160103823,CSE 100,A01,083659,Cao; Yingjun,4,4,70,66
1657160109847,CSE 134B,A01,083661,Powell; Thomas Allan,20,0,100,80
1657160115870,CSE 140,A01,083663,Gungor; Onat,13,0,85,72
1657160121896,CSE 140L,A01,083088,Eldon; John,17,0,100,83
1657160127920,CSE 175,A01,083665,Kumar; Rakesh,3,0,25,22
1657160133944,CSE 190,A00,092507,Dubnov; Shlomo,7,0,20,13
1657160139967,ECE 45,A01,083139,Congero; Spencer William,5,0,75,70
1657160145991,ECE 65,A50,083695,Saad; Andrew S,12,0,30,18
1657160145991,ECE 65,A51,095125,Saad; Andrew S,25,0,26,1
1657160152014,ECE 109,A01,091882,Touri; Behrouz,18,0,70,52
1657160158038,ECE 180,A00,083140,Abi Samra; Nicholas Camill,1,0,30,29
1657160158038,ECE 180,B00,083141,Abi Samra; Nicholas Camill,0,0,30,30
1657160164061,MATH 10A,A01,083735,Patchell; Gregory David,2,0,30,28
1657160164061,MATH 10A,A02,083736,Patchell; Gregory David,20,0,30,10
1657160164061,MATH 10A,A03,083737,Patchell; Gregory David,16,0,30,14
1657160170089,MATH 10B,A01,083207,Lim; Seonhee,7,0,34,27
1657160170089,MATH 10B,A02,083208,Lim; Seonhee,9,0,35,26
1657160170089,MATH 10B,A03,093472,Lim; Seonhee,5,0,34,29
1657160170089,MATH 10B,B01,083739,Sinha; Shubham,9,0,30,21
1657160176114,MATH 18,A01,083743,Cinel; Cameron Alexander,6,0,30,24
1657160176114,MATH 18,A02,083744,Cinel; Cameron Alexander,15,0,30,15
1657160176114,MATH 18,A03,083745,Cinel; Cameron Alexander,8,0,30,22
1657160176114,MATH 18,B01,083748,Rideout; David Porter,4,0,37,33
1657160176114,MATH 18,B02,083749,Rideout; David Porter,3,0,36,33
1657160176114,MATH 18,B03,083750,Rideout; David Porter,2,0,37,35
1657160176114,MATH 18,B04,083751,Rideout; David Porter,5,0,36,31
1657160176114,MATH 18,B05,093473,Rideout; David Porter,5,0,36,31
1657160176114,MATH 18,B06,093474,Rideout; David Porter,5,0,36,31
1657160182138,MATH 20A,A01,083754,Zheng; Zequn,12,0,40,28
1657160188167,MATH 20B,A01,083756,Briones; Jor-el Thomas Caparas,1,0,36,35
1657160188167,MATH 20B,A02,083757,Briones; Jor-el Thomas Caparas,1,0,36,35
1657160188167,MATH 20B,A03,093475,Briones; Jor-el Thomas Caparas,1,0,36,35
1657160194196,MATH 20C,A01,083760,Briones; Jor-el Thomas Caparas,1,0,35,34
1657160194196,MATH 20C,A02,083761,Briones; Jor-el Thomas Caparas,8,0,35,27
1657160194196,MATH 20C,A03,093476,Briones; Jor-el Thomas Caparas,0,1,36,36
1657160194196,MATH 20C,B01,083762,Bach; Quang Tran,1,0,30,29
1657160200220,MATH 20D,A01,083765,Tran; Brian Kha,4,0,30,26
1657160200220,MATH 20D,A02,083766,Tran; Brian Kha,5,0,30,25
1657160200220,MATH 20D,A03,083767,Tran; Brian Kha,3,0,30,27
1657160206245,MATH 20E,A01,083771,Ganguly; Soumya,7,0,32,25
1657160206245,MATH 20E,A02,083772,Ganguly; Soumya,7,0,32,25
1657160206245,MATH 20E,B01,083773,Ciotti; Benjamin,19,0,35,16
1657160206245,MATH 20E,B02,083774,Ciotti; Benjamin,17,0,35,18
1657160212275,MATH 103A,A01,083777,Greenfeld; Be'Eri,2,0,36,34
1657160212275,MATH 103A,A02,083778,Greenfeld; Be'Eri,5,0,36,31
1657160212275,MATH 103A,A03,093561,Greenfeld; Be'Eri,4,0,36,32
1657160212275,MATH 103A,B01,083779,Greenfeld; Be'Eri,6,0,36,30
1657160212275,MATH 103A,B02,083780,Greenfeld; Be'Eri,3,0,36,33
1657160212275,MATH 103A,B03,093562,Greenfeld; Be'Eri,3,0,36,33
1657160218303,MATH 105,A01,085443,Carter; Anne Toulson,14,0,35,21
1657160218303,MATH 105,A02,093477,Carter; Anne Toulson,20,0,35,15
1657160224333,MATH 109,A01,083213,Ganzberger; Geoffrey Michael,2,0,34,32
1657160224333,MATH 109,A02,083214,Ganzberger; Geoffrey Michael,3,0,34,31
1657160224333,MATH 109,A03,093478,Ganzberger; Geoffrey Michael,1,0,34,33
1657160224333,MATH 109,B01,083215,Ganzberger; Geoffrey Michael,1,0,32,31
1657160224333,MATH 109,B02,083216,Ganzberger; Geoffrey Michael,1,0,32,31
1657160224333,MATH 109,B03,093479,Ganzberger; Geoffrey Michael,6,0,32,26
1657160230363,MATH 142A,A01,083219,Chow; Bennett,6,0,32,26
1657160230363,MATH 142A,A02,083220,Chow; Bennett,10,0,32,22
1657160230363,MATH 142A,A03,093480,Chow; Bennett,7,0,32,25
1657160230363,MATH 142A,B03,093481,Chow; Bennett,8,0,32,24
1657160230363,MATH 142A,B04,093558,Chow; Bennett,11,0,32,21
1657160230363,MATH 142A,B05,093559,Chow; Bennett,6,0,32,26
1657160236394,MATH 193A,A01,083224,Rotar; Vladimir,7,0,34,27
1657160236394,MATH 193A,A02,083225,Rotar; Vladimir,5,0,34,29
1657160236394,MATH 193A,A03,083781,Rotar; Vladimir,1,0,34,33
1657160236394,MATH 193A,A04,083782,Rotar; Vladimir,8,0,34,26
1657160236394,MATH 193A,A05,093482,Rotar; Vladimir,6,0,34,28
1657160242417,MATH 197,001,091859,McAuley; Julian John,9999,0,9999,0
1657160242417,MATH 197,002,095566,Kedlaya; Kiran S.,9997,0,9999,2
1657160242417,MATH 197,003,095567,Xiao; Ming,9999,0,9999,0
1657160242417,MATH 197,004,095571,Perols; Johan Lars,9998,0,9999,1
1657160249477,COGS 9,A01,083615,Shannon; Kyle Michael,7,0,75,68
1657160255499,COGS 11,A01,083617,Boyle; Mary E. T.,22,0,48,26
1657160261522,COGS 13,A01,083071,Bastos; Amalia Pinkusfeld,9,0,71,62
1657160267550,COGS 14A,A01,092681,Semenuks; Arturs,1,1,100,99
1657160273576,COGS 14B,A01,083073,Cheng; Tzu-Han,6,0,63,57
1657160279600,COGS 17,A01,092677,Semenuks; Arturs,4,0,81,77
1657160285623,COGS 100,A01,083619,Allen; Michael Gordon,15,0,70,55
1657160291646,COGS 101A,A01,083621,Davis; Joshua Daniel,9,0,68,59
1657160297680,COGS 101B,A01,091572,Allen; Michael Gordon,9,0,65,56
1657160303718,COGS 101C,A01,083625,Delgado; Tania,17,0,35,18
1657160309750,COGS 107A,A01,083627,Boyle; Mary E. T.,13,0,60,47
1657160315777,COGS 118A,A01,083075,Gupta; Anjum,16,0,76,60
1657160321802,CSE 3,A50,083646,Miranda; Gregory Joseph,24,0,50,26
1657160327830,CSE 8A,A50,083650,Miranda; Gregory Joseph,17,1,56,39
1657160333856,CSE 11,A01,083080,Cao; Yingjun,5,15,40,35
1657160339883,CSE 12,A01,083652,Krause-Levy; Sophia Louisa,24,1,120,96
1657160345906,CSE 15L,A01,083654,Morris; Justin Loren,9,0,50,41
1657160345906,CSE 15L,A02,083655,Morris; Justin Loren,9,0,50,41
1657160351929,CSE 20,A01,083657,Tran; Khoa Dang,38,0,80,42
1657160357955,CSE 21,A01,095574,Bach; Quang Tran,22,0,48,26
1657160363981,CSE 30,A01,083084,Eldon; John,4,0,80,76
1657160363981,CSE 30,B01,095061,Bhaskar; Nishant,7,0,50,43
1657160370010,CSE 100,A01,083659,Cao; Yingjun,4,4,70,66
1657160376037,CSE 134B,A01,083661,Powell; Thomas Allan,20,0,100,80
1657160382061,CSE 140,A01,083663,Gungor; Onat,13,0,85,72
1657160388088,CSE 140L,A01,083088,Eldon; John,17,0,100,83
1657160394113,CSE 175,A01,083665,Kumar; Rakesh,3,0,25,22
1657160400141,CSE 190,A00,092507,Dubnov; Shlomo,7,0,20,13
1657160406165,ECE 45,A01,083139,Congero; Spencer William,5,0,75,70
1657160412205,ECE 65,A50,083695,Saad; Andrew S,12,0,30,18
1657160412205,ECE 65,A51,095125,Saad; Andrew S,25,0,26,1
1657160418229,ECE 109,A01,091882,Touri; Behrouz,18,0,70,52
1657160424258,ECE 180,A00,083140,Abi Samra; Nicholas Camill,1,0,30,29
1657160424258,ECE 180,B00,083141,Abi Samra; Nicholas Camill,0,0,30,30
1657160430283,MATH 10A,A01,083735,Patchell; Gregory David,2,0,30,28
1657160430283,MATH 10A,A02,083736,Patchell; Gregory David,20,0,30,10
1657160430283,MATH 10A,A03,083737,Patchell; Gregory David,16,0,30,14
1657160436308,MATH 10B,A01,083207,Lim; Seonhee,7,0,34,27
1657160436308,MATH 10B,A02,083208,Lim; Seonhee,9,0,35,26
1657160436308,MATH 10B,A03,093472,Lim; Seonhee,5,0,34,29
1657160436308,MATH 10B,B01,083739,Sinha; Shubham,9,0,30,21
1657160442343,MATH 18,A01,083743,Cinel; Cameron Alexander,6,0,30,24
1657160442343,MATH 18,A02,083744,Cinel; Cameron Alexander,15,0,30,15
1657160442343,MATH 18,A03,083745,Cinel; Cameron Alexander,8,0,30,22
1657160442343,MATH 18,B01,083748,Rideout; David Porter,4,0,37,33
1657160442343,MATH 18,B02,083749,Rideout; David Porter,3,0,36,33
1657160442343,MATH 18,B03,083750,Rideout; David Porter,2,0,37,35
1657160442343,MATH 18,B04,083751,Rideout; David Porter,5,0,36,31
1657160442343,MATH 18,B05,093473,Rideout; David Porter,5,0,36,31
1657160442343,MATH 18,B06,093474,Rideout; David Porter,5,0,36,31
1657160448375,MATH 20A,A01,083754,Zheng; Zequn,12,0,40,28
1657160454403,MATH 20B,A01,083756,Briones; Jor-el Thomas Caparas,1,0,36,35
1657160454403,MATH 20B,A02,083757,Briones; Jor-el Thomas Caparas,1,0,36,35
1657160454403,MATH 20B,A03,093475,Briones; Jor-el Thomas Caparas,1,0,36,35
1657160460433,MATH 20C,A01,083760,Briones; Jor-el Thomas Caparas,1,0,35,34
1657160460433,MATH 20C,A02,083761,Briones; Jor-el Thomas Caparas,8,0,35,27
1657160460433,MATH 20C,A03,093476,Briones; Jor-el Thomas Caparas,0,1,36,36
1657160460433,MATH 20C,B01,083762,Bach; Quang Tran,1,0,30,29
1657160466464,MATH 20D,A01,083765,Tran; Brian Kha,4,0,30,26
1657160466464,MATH 20D,A02,083766,Tran; Brian Kha,5,0,30,25
1657160466464,MATH 20D,A03,083767,Tran; Brian Kha,3,0,30,27
1657160472497,MATH 20E,A01,083771,Ganguly; Soumya,7,0,32,25
1657160472497,MATH 20E,A02,083772,Ganguly; Soumya,7,0,32,25
1657160472497,MATH 20E,B01,083773,Ciotti; Benjamin,19,0,35,16
1657160472497,MATH 20E,B02,083774,Ciotti; Benjamin,17,0,35,18
1657160478531,MATH 103A,A01,083777,Greenfeld; Be'Eri,2,0,36,34
1657160478531,MATH 103A,A02,083778,Greenfeld; Be'Eri,5,0,36,31
1657160478531,MATH 103A,A03,093561,Greenfeld; Be'Eri,4,0,36,32
1657160478531,MATH 103A,B01,083779,Greenfeld; Be'Eri,6,0,36,30
1657160478531,MATH 103A,B02,083780,Greenfeld; Be'Eri,3,0,36,33
1657160478531,MATH 103A,B03,093562,Greenfeld; Be'Eri,3,0,36,33
1657160484560,MATH 105,A01,085443,Carter; Anne Toulson,14,0,35,21
1657160484560,MATH 105,A02,093477,Carter; Anne Toulson,20,0,35,15
1657160490584,MATH 109,A01,083213,Ganzberger; Geoffrey Michael,2,0,34,32
1657160490584,MATH 109,A02,083214,Ganzberger; Geoffrey Michael,3,0,34,31
1657160490584,MATH 109,A03,093478,Ganzberger; Geoffrey Michael,1,0,34,33
1657160490584,MATH 109,B01,083215,Ganzberger; Geoffrey Michael,1,0,32,31
1657160490584,MATH 109,B02,083216,Ganzberger; Geoffrey Michael,1,0,32,31
1657160490584,MATH 109,B03,093479,Ganzberger; Geoffrey Michael,6,0,32,26
1657160496610,MATH 142A,A01,083219,Chow; Bennett,6,0,32,26
1657160496610,MATH 142A,A02,083220,Chow; Bennett,10,0,32,22
1657160496610,MATH 142A,A03,093480,Chow; Bennett,7,0,32,25
1657160496610,MATH 142A,B03,093481,Chow; Bennett,8,0,32,24
1657160496610,MATH 142A,B04,093558,Chow; Bennett,11,0,32,21
1657160496610,MATH 142A,B05,093559,Chow; Bennett,6,0,32,26
1657160502634,MATH 193A,A01,083224,Rotar; Vladimir,7,0,34,27
1657160502634,MATH 193A,A02,083225,Rotar; Vladimir,5,0,34,29
1657160502634,MATH 193A,A03,083781,Rotar; Vladimir,1,0,34,33
1657160502634,MATH 193A,A04,083782,Rotar; Vladimir,8,0,34,26
1657160502634,MATH 193A,A05,093482,Rotar; Vladimir,6,0,34,28
1657160508658,MATH 197,001,091859,McAuley; Julian John,9999,0,9999,0
1657160508658,MATH 197,002,095566,Kedlaya; Kiran S.,9997,0,9999,2
1657160508658,MATH 197,003,095567,Xiao; Ming,9999,0,9999,0
1657160508658,MATH 197,004,095571,Perols; Johan Lars,9998,0,9999,1
1657160515721,COGS 9,A01,083615,Shannon; Kyle Michael,7,0,75,68
1657160521744,COGS 11,A01,083617,Boyle; Mary E. T.,22,0,48,26
1657160527770,COGS 13,A01,083071,Bastos; Amalia Pinkusfeld,9,0,71,62
1657160533797,COGS 14A,A01,092681,Semenuks; Arturs,1,1,100,99
1657160539821,COGS 14B,A01,083073,Cheng; Tzu-Han,6,0,63,57
1657160545847,COGS 17,A01,092677,Semenuks; Arturs,4,0,81,77
1657160551872,COGS 100,A01,083619,Allen; Michael Gordon,15,0,70,55
1657160558011,COGS 101A,A01,083621,Davis; Joshua Daniel,9,0,68,59
1657160564039,COGS 101B,A01,091572,Allen; Michael Gordon,9,0,65,56
1657160570063,COGS 101C,A01,083625,Delgado; Tania,17,0,35,18
1657160576090,COGS 107A,A01,083627,Boyle; Mary E. T.,13,0,60,47
1657160582115,COGS 118A,A01,083075,Gupta; Anjum,16,0,76,60
1657160588143,CSE 3,A50,083646,Miranda; Gregory Joseph,24,0,50,26
1657160594170,CSE 8A,A50,083650,Miranda; Gregory Joseph,17,1,56,39
1657160600194,CSE 11,A01,083080,Cao; Yingjun,5,15,40,35
1657160606218,CSE 12,A01,083652,Krause-Levy; Sophia Louisa,24,1,120,96
1657160612242,CSE 15L,A01,083654,Morris; Justin Loren,9,0,50,41
1657160612242,CSE 15L,A02,083655,Morris; Justin Loren,9,0,50,41
1657160618269,CSE 20,A01,083657,Tran; Khoa Dang,38,0,80,42
1657160624300,CSE 21,A01,095574,Bach; Quang Tran,22,0,48,26
1657160630340,CSE 30,A01,083084,Eldon; John,4,0,80,76
1657160630340,CSE 30,B01,095061,Bhaskar; Nishant,7,0,50,43
1657160636369,CSE 100,A01,083659,Cao; Yingjun,4,4,70,66
1657160642393,CSE 134B,A01,083661,Powell; Thomas Allan,20,0,100,80
1657160648416,CSE 140,A01,083663,Gungor; Onat,13,0,85,72
1657160654440,CSE 140L,A01,083088,Eldon; John,17,0,100,83
1657160660467,CSE 175,A01,083665,Kumar; Rakesh,3,0,25,22
1657160666505,CSE 190,A00,092507,Dubnov; Shlomo,7,0,20,13
1657160672530,ECE 45,A01,083139,Congero; Spencer William,5,0,75,70
1657160678558,ECE 65,A50,083695,Saad; Andrew S,12,0,30,18
1657160678558,ECE 65,A51,095125,Saad; Andrew S,25,0,26,1
1657160684584,ECE 109,A01,091882,Touri; Behrouz,18,0,70,52
1657160690608,ECE 180,A00,083140,Abi Samra; Nicholas Camill,1,0,30,29
1657160690608,ECE 180,B00,083141,Abi Samra; Nicholas Camill,0,0,30,30
1657160696637,MATH 10A,A01,083735,Patchell; Gregory David,2,0,30,28
1657160696637,MATH 10A,A02,083736,Patchell; Gregory David,20,0,30,10
1657160696637,MATH 10A,A03,083737,Patchell; Gregory David,16,0,30,14
1657160702662,MATH 10B,A01,083207,Lim; Seonhee,7,0,34,27
1657160702662,MATH 10B,A02,083208,Lim; Seonhee,9,0,35,26
1657160702662,MATH 10B,A03,093472,Lim; Seonhee,5,0,34,29
1657160702662,MATH 10B,B01,083739,Sinha; Shubham,9,0,30,21
1657160708688,MATH 18,A01,083743,Cinel; Cameron Alexander,6,0,30,24
1657160708688,MATH 18,A02,083744,Cinel; Cameron Alexander,15,0,30,15
1657160708688,MATH 18,A03,083745,Cinel; Cameron Alexander,8,0,30,22
1657160708688,MATH 18,B01,083748,Rideout; David Porter,4,0,37,33
1657160708688,MATH 18,B02,083749,Rideout; David Porter,3,0,36,33
1657160708688,MATH 18,B03,083750,Rideout; David Porter,2,0,37,35
1657160708688,MATH 18,B04,083751,Rideout; David Porter,5,0,36,31
1657160708688,MATH 18,B05,093473,Rideout; David Porter,5,0,36,31
1657160708688,MATH 18,B06,093474,Rideout; David Porter,5,0,36,31
1657160714713,MATH 20A,A01,083754,Zheng; Zequn,12,0,40,28
1657160720743,MATH 20B,A01,083756,Briones; Jor-el Thomas Caparas,1,0,36,35
1657160720743,MATH 20B,A02,083757,Briones; Jor-el Thomas Caparas,1,0,36,35
1657160720743,MATH 20B,A03,093475,Briones; Jor-el Thomas Caparas,1,0,36,35
1657160726772,MATH 20C,A01,083760,Briones; Jor-el Thomas Caparas,1,0,35,34
1657160726772,MATH 20C,A02,083761,Briones; Jor-el Thomas Caparas,8,0,35,27
1657160726772,MATH 20C,A03,093476,Briones; Jor-el Thomas Caparas,0,1,36,36
1657160726772,MATH 20C,B01,083762,Bach; Quang Tran,1,0,30,29
1657160732799,MATH 20D,A01,083765,Tran; Brian Kha,4,0,30,26
1657160732799,MATH 20D,A02,083766,Tran; Brian Kha,5,0,30,25
1657160732799,MATH 20D,A03,083767,Tran; Brian Kha,3,0,30,27
1657160738829,MATH 20E,A01,083771,Ganguly; Soumya,7,0,32,25
1657160738829,MATH 20E,A02,083772,Ganguly; Soumya,7,0,32,25
1657160738829,MATH 20E,B01,083773,Ciotti; Benjamin,19,0,35,16
1657160738829,MATH 20E,B02,083774,Ciotti; Benjamin,17,0,35,18
1657160744867,MATH 103A,A01,083777,Greenfeld; Be'Eri,2,0,36,34
1657160744867,MATH 103A,A02,083778,Greenfeld; Be'Eri,5,0,36,31
1657160744867,MATH 103A,A03,093561,Greenfeld; Be'Eri,4,0,36,32
1657160744867,MATH 103A,B01,083779,Greenfeld; Be'Eri,6,0,36,30
1657160744867,MATH 103A,B02,083780,Greenfeld; Be'Eri,3,0,36,33
1657160744867,MATH 103A,B03,093562,Greenfeld; Be'Eri,3,0,36,33
1657160750893,MATH 105,A01,085443,Carter; Anne Toulson,14,0,35,21
1657160750893,MATH 105,A02,093477,Carter; Anne Toulson,20,0,35,15
1657160756917,MATH 109,A01,083213,Ganzberger; Geoffrey Michael,2,0,34,32
1657160756917,MATH 109,A02,083214,Ganzberger; Geoffrey Michael,3,0,34,31
1657160756917,MATH 109,A03,093478,Ganzberger; Geoffrey Michael,1,0,34,33
1657160756917,MATH 109,B01,083215,Ganzberger; Geoffrey Michael,1,0,32,31
1657160756917,MATH 109,B02,083216,Ganzberger; Geoffrey Michael,1,0,32,31
1657160756917,MATH 109,B03,093479,Ganzberger; Geoffrey Michael,6,0,32,26
1657160762947,MATH 142A,A01,083219,Chow; Bennett,6,0,32,26
1657160762947,MATH 142A,A02,083220,Chow; Bennett,10,0,32,22
1657160762947,MATH 142A,A03,093480,Chow; Bennett,7,0,32,25
1657160762947,MATH 142A,B03,093481,Chow; Bennett,8,0,32,24
1657160762947,MATH 142A,B04,093558,Chow; Bennett,11,0,32,21
1657160762947,MATH 142A,B05,093559,Chow; Bennett,6,0,32,26
1657160768985,MATH 193A,A01,083224,Rotar; Vladimir,7,0,34,27
1657160768985,MATH 193A,A02,083225,Rotar; Vladimir,5,0,34,29
1657160768985,MATH 193A,A03,083781,Rotar; Vladimir,1,0,34,33
1657160768985,MATH 193A,A04,083782,Rotar; Vladimir,8,0,34,26
1657160768985,MATH 193A,A05,093482,Rotar; Vladimir,6,0,34,28
1657160775018,MATH 197,001,091859,McAuley; Julian John,9999,0,9999,0
1657160775018,MATH 197,002,095566,Kedlaya; Kiran S.,9997,0,9999,2
1657160775018,MATH 197,003,095567,Xiao; Ming,9999,0,9999,0
1657160775018,MATH 197,004,095571,Perols; Johan Lars,9998,0,9999,1
1657160782069,COGS 9,A01,083615,Shannon; Kyle Michael,7,0,75,68
1657160788092,COGS 11,A01,083617,Boyle; Mary E. T.,22,0,48,26
1657160794115,COGS 13,A01,083071,Bastos; Amalia Pinkusfeld,9,0,71,62
1657160800152,COGS 14A,A01,092681,Semenuks; Arturs,1,1,100,99
1657160806176,COGS 14B,A01,083073,Cheng; Tzu-Han,6,0,63,57
1657160812203,COGS 17,A01,092677,Semenuks; Arturs,4,0,81,77
1657160818226,COGS 100,A01,083619,Allen; Michael Gordon,15,0,70,55
1657160824254,COGS 101A,A01,083621,Davis; Joshua Daniel,9,0,68,59
1657160830277,COGS 101B,A01,091572,Allen; Michael Gordon,9,0,65,56
1657160836300,COGS 101C,A01,083625,Delgado; Tania,17,0,35,18
1657160842324,COGS 107A,A01,083627,Boyle; Mary E. T.,13,0,60,47
1657160848353,COGS 118A,A01,083075,Gupta; Anjum,16,0,76,60
1657160854376,CSE 3,A50,083646,Miranda; Gregory Joseph,24,0,50,26
1657160860399,CSE 8A,A50,083650,Miranda; Gregory Joseph,17,1,56,39
1657160866430,CSE 11,A01,083080,Cao; Yingjun,5,15,40,35
1657160872457,CSE 12,A01,083652,Krause-Levy; Sophia Louisa,24,1,120,96
1657160878485,CSE 15L,A01,083654,Morris; Justin Loren,9,0,50,41
1657160878485,CSE 15L,A02,083655,Morris; Justin Loren,9,0,50,41
1657160884512,CSE 20,A01,083657,Tran; Khoa Dang,38,0,80,42
1657160890534,CSE 21,A01,095574,Bach; Quang Tran,22,0,48,26
1657160896560,CSE 30,A01,083084,Eldon; John,4,0,80,76
1657160896560,CSE 30,B01,095061,Bhaskar; Nishant,7,0,50,43
1657160902582,CSE 100,A01,083659,Cao; Yingjun,4,4,70,66
1657160908609,CSE 134B,A01,083661,Powell; Thomas Allan,20,0,100,80
1657160914632,CSE 140,A01,083663,Gungor; Onat,13,0,85,72
1657160920657,CSE 140L,A01,083088,Eldon; John,17,0,100,83
1657160926683,CSE 175,A01,083665,Kumar; Rakesh,3,0,25,22
1657160932704,CSE 190,A00,092507,Dubnov; Shlomo,7,0,20,13
1657160938725,ECE 45,A01,083139,Congero; Spencer William,5,0,75,70
1657160944752,ECE 65,A50,083695,Saad; Andrew S,12,0,30,18
1657160944752,ECE 65,A51,095125,Saad; Andrew S,25,0,26,1
1657160950777,ECE 109,A01,091882,Touri; Behrouz,18,0,70,52
1657160956799,ECE 180,A00,083140,Abi Samra; Nicholas Camill,1,0,30,29
1657160956799,ECE 180,B00,083141,Abi Samra; Nicholas Camill,0,0,30,30
1657160962824,MATH 10A,A01,083735,Patchell; Gregory David,2,0,30,28
1657160962824,MATH 10A,A02,083736,Patchell; Gregory David,20,0,30,10
1657160962824,MATH 10A,A03,083737,Patchell; Gregory David,16,0,30,14
1657160968851,MATH 10B,A01,083207,Lim; Seonhee,7,0,34,27
1657160968851,MATH 10B,A02,083208,Lim; Seonhee,9,0,35,26
1657160968851,MATH 10B,A03,093472,Lim; Seonhee,5,0,34,29
1657160968851,MATH 10B,B01,083739,Sinha; Shubham,9,0,30,21
1657160974883,MATH 18,A01,083743,Cinel; Cameron Alexander,6,0,30,24
1657160974883,MATH 18,A02,083744,Cinel; Cameron Alexander,15,0,30,15
1657160974883,MATH 18,A03,083745,Cinel; Cameron Alexander,8,0,30,22
1657160974883,MATH 18,B01,083748,Rideout; David Porter,4,0,37,33
1657160974883,MATH 18,B02,083749,Rideout; David Porter,3,0,36,33
1657160974883,MATH 18,B03,083750,Rideout; David Porter,2,0,37,35
1657160974883,MATH 18,B04,083751,Rideout; David Porter,5,0,36,31
1657160974883,MATH 18,B05,093473,Rideout; David Porter,5,0,36,31
1657160974883,MATH 18,B06,093474,Rideout; David Porter,5,0,36,31
1657160980904,MATH 20A,A01,083754,Zheng; Zequn,12,0,40,28
1657160986932,MATH 20B,A01,083756,Briones; Jor-el Thomas Caparas,1,0,36,35
1657160986932,MATH 20B,A02,083757,Briones; Jor-el Thomas Caparas,1,0,36,35
1657160986932,MATH 20B,A03,093475,Briones; Jor-el Thomas Caparas,1,0,36,35
1657160992955,MATH 20C,A01,083760,Briones; Jor-el Thomas Caparas,1,0,35,34
1657160992955,MATH 20C,A02,083761,Briones; Jor-el Thomas Caparas,8,0,35,27
1657160992955,MATH 20C,A03,093476,Briones; Jor-el Thomas Caparas,0,1,36,36
1657160992955,MATH 20C,B01,083762,Bach; Quang Tran,1,0,30,29
1657160999000,MATH 20D,A01,083765,Tran; Brian Kha,4,0,30,26
1657160999000,MATH 20D,A02,083766,Tran; Brian Kha,5,0,30,25
1657160999000,MATH 20D,A03,083767,Tran; Brian Kha,3,0,30,27
1657161005026,MATH 20E,A01,083771,Ganguly; Soumya,7,0,32,25
1657161005026,MATH 20E,A02,083772,Ganguly; Soumya,7,0,32,25
1657161005026,MATH 20E,B01,083773,Ciotti; Benjamin,19,0,35,16
1657161005026,MATH 20E,B02,083774,Ciotti; Benjamin,17,0,35,18
1657161011050,MATH 103A,A01,083777,Greenfeld; Be'Eri,2,0,36,34
1657161011050,MATH 103A,A02,083778,Greenfeld; Be'Eri,5,0,36,31
1657161011050,MATH 103A,A03,093561,Greenfeld; Be'Eri,4,0,36,32
1657161011050,MATH 103A,B01,083779,Greenfeld; Be'Eri,6,0,36,30
1657161011050,MATH 103A,B02,083780,Greenfeld; Be'Eri,3,0,36,33
1657161011050,MATH 103A,B03,093562,Greenfeld; Be'Eri,3,0,36,33
1657161017072,MATH 105,A01,085443,Carter; Anne Toulson,14,0,35,21
1657161017072,MATH 105,A02,093477,Carter; Anne Toulson,20,0,35,15
1657161023094,MATH 109,A01,083213,Ganzberger; Geoffrey Michael,2,0,34,32
1657161023094,MATH 109,A02,083214,Ganzberger; Geoffrey Michael,3,0,34,31
1657161023094,MATH 109,A03,093478,Ganzberger; Geoffrey Michael,1,0,34,33
1657161023094,MATH 109,B01,083215,Ganzberger; Geoffrey Michael,1,0,32,31
1657161023094,MATH 109,B02,083216,Ganzberger; Geoffrey Michael,1,0,32,31
1657161023094,MATH 109,B03,093479,Ganzberger; Geoffrey Michael,6,0,32,26
1657161029119,MATH 142A,A01,083219,Chow; Bennett,6,0,32,26
1657161029119,MATH 142A,A02,083220,Chow; Bennett,10,0,32,22
1657161029119,MATH 142A,A03,093480,Chow; Bennett,7,0,32,25
1657161029119,MATH 142A,B03,093481,Chow; Bennett,8,0,32,24
1657161029119,MATH 142A,B04,093558,Chow; Bennett,11,0,32,21
1657161029119,MATH 142A,B05,093559,Chow; Bennett,6,0,32,26
1657161035145,MATH 193A,A01,083224,Rotar; Vladimir,7,0,34,27
1657161035145,MATH 193A,A02,083225,Rotar; Vladimir,5,0,34,29
1657161035145,MATH 193A,A03,083781,Rotar; Vladimir,1,0,34,33
1657161035145,MATH 193A,A04,083782,Rotar; Vladimir,8,0,34,26
1657161035145,MATH 193A,A05,093482,Rotar; Vladimir,6,0,34,28
1657161041169,MATH 197,001,091859,McAuley; Julian John,9999,0,9999,0
1657161041169,MATH 197,002,095566,Kedlaya; Kiran S.,9997,0,9999,2
1657161041169,MATH 197,003,095567,Xiao; Ming,9999,0,9999,0
1657161041169,MATH 197,004,095571,Perols; Johan Lars,9998,0,9999,1
1657161048247,COGS 9,A01,083615,Shannon; Kyle Michael,7,0,75,68
1657161054270,COGS 11,A01,083617,Boyle; Mary E. T.,22,0,48,26
1657161060292,COGS 13,A01,083071,Bastos; Amalia Pinkusfeld,9,0,71,62
1657161066319,COGS 14A,A01,092681,Semenuks; Arturs,1,1,100,99
1657161072349,COGS 14B,A01,083073,Cheng; Tzu-Han,6,0,63,57
1657161078375,COGS 17,A01,092677,Semenuks; Arturs,4,0,81,77
1657161084398,COGS 100,A01,083619,Allen; Michael Gordon,15,0,70,55
1657161090424,COGS 101A,A01,083621,Davis; Joshua Daniel,9,0,68,59
1657161096460,COGS 101B,A01,091572,Allen; Michael Gordon,9,0,65,56
1657161102485,COGS 101C,A01,083625,Delgado; Tania,17,0,35,18
1657161108508,COGS 107A,A01,083627,Boyle; Mary E. T.,13,0,60,47
1657161114539,COGS 118A,A01,083075,Gupta; Anjum,16,0,76,60
1657161120566,CSE 3,A50,083646,Miranda; Gregory Joseph,24,0,50,26
1657161126594,CSE 8A,A50,083650,Miranda; Gregory Joseph,17,1,56,39
1657161132615,CSE 11,A01,083080,Cao; Yingjun,5,15,40,35
1657161138651,CSE 12,A01,083652,Krause-Levy; Sophia Louisa,24,1,120,96
1657161144677,CSE 15L,A01,083654,Morris; Justin Loren,9,0,50,41
1657161144677,CSE 15L,A02,083655,Morris; Justin Loren,9,0,50,41
1657161150703,CSE 20,A01,083657,Tran; Khoa Dang,38,0,80,42
1657161156816,CSE 21,A01,095574,Bach; Quang Tran,22,0,48,26
1657161162839,CSE 30,A01,083084,Eldon; John,4,0,80,76
1657161162839,CSE 30,B01,095061,Bhaskar; Nishant,7,0,50,43
1657161168862,CSE 100,A01,083659,Cao; Yingjun,4,4,70,66
1657161174888,CSE 134B,A01,083661,Powell; Thomas Allan,20,0,100,80
1657161180914,CSE 140,A01,083663,Gungor; Onat,13,0,85,72
1657161186936,CSE 140L,A01,083088,Eldon; John,17,0,100,83
1657161192963,CSE 175,A01,083665,Kumar; Rakesh,3,0,25,22
1657161198984,CSE 190,A00,092507,Dubnov; Shlomo,7,0,20,13
1657161205006,ECE 45,A01,083139,Congero; Spencer William,5,0,75,70
1657161211033,ECE 65,A50,083695,Saad; Andrew S,12,0,30,18
1657161211033,ECE 65,A51,095125,Saad; Andrew S,25,0,26,1
1657161217059,ECE 109,A01,091882,Touri; Behrouz,18,0,70,52
1657161223084,ECE 180,A00,083140,Abi Samra; Nicholas Camill,1,0,30,29
1657161223084,ECE 180,B00,083141,Abi Samra; Nicholas Camill,0,0,30,30
1657161229107,MATH 10A,A01,083735,Patchell; Gregory David,2,0,30,28
1657161229107,MATH 10A,A02,083736,Patchell; Gregory David,20,0,30,10
1657161229107,MATH 10A,A03,083737,Patchell; Gregory David,16,0,30,14
1657161235132,MATH 10B,A01,083207,Lim; Seonhee,7,0,34,27
1657161235132,MATH 10B,A02,083208,Lim; Seonhee,9,0,35,26
1657161235132,MATH 10B,A03,093472,Lim; Seonhee,5,0,34,29
1657161235132,MATH 10B,B01,083739,Sinha; Shubham,9,0,30,21
1657161241154,MATH 18,A01,083743,Cinel; Cameron Alexander,6,0,30,24
1657161241154,MATH 18,A02,083744,Cinel; Cameron Alexander,15,0,30,15
1657161241154,MATH 18,A03,083745,Cinel; Cameron Alexander,8,0,30,22
1657161241154,MATH 18,B01,083748,Rideout; David Porter,4,0,37,33
1657161241154,MATH 18,B02,083749,Rideout; David Porter,3,0,36,33
1657161241154,MATH 18,B03,083750,Rideout; David Porter,2,0,37,35
1657161241154,MATH 18,B04,083751,Rideout; David Porter,5,0,36,31
1657161241154,MATH 18,B05,093473,Rideout; David Porter,5,0,36,31
1657161241154,MATH 18,B06,093474,Rideout; David Porter,5,0,36,31
1657161247177,MATH 20A,A01,083754,Zheng; Zequn,12,0,40,28
1657161253205,MATH 20B,A01,083756,Briones; Jor-el Thomas Caparas,1,0,36,35
1657161253205,MATH 20B,A02,083757,Briones; Jor-el Thomas Caparas,1,0,36,35
1657161253205,MATH 20B,A03,093475,Briones; Jor-el Thomas Caparas,1,0,36,35
1657161259237,MATH 20C,A01,083760,Briones; Jor-el Thomas Caparas,1,0,35,34
1657161259237,MATH 20C,A02,083761,Briones; Jor-el Thomas Caparas,8,0,35,27
1657161259237,MATH 20C,A03,093476,Briones; Jor-el Thomas Caparas,0,1,36,36
1657161259237,MATH 20C,B01,083762,Bach; Quang Tran,1,0,30,29
1657161265259,MATH 20D,A01,083765,Tran; Brian Kha,4,0,30,26
1657161265259,MATH 20D,A02,083766,Tran; Brian Kha,5,0,30,25
1657161265259,MATH 20D,A03,083767,Tran; Brian Kha,3,0,30,27
1657161271289,MATH 20E,A01,083771,Ganguly; Soumya,7,0,32,25
1657161271289,MATH 20E,A02,083772,Ganguly; Soumya,7,0,32,25
1657161271289,MATH 20E,B01,083773,Ciotti; Benjamin,19,0,35,16
1657161271289,MATH 20E,B02,083774,Ciotti; Benjamin,17,0,35,18
1657161277313,MATH 103A,A01,083777,Greenfeld; Be'Eri,2,0,36,34
1657161277313,MATH 103A,A02,083778,Greenfeld; Be'Eri,5,0,36,31
1657161277313,MATH 103A,A03,093561,Greenfeld; Be'Eri,4,0,36,32
1657161277313,MATH 103A,B01,083779,Greenfeld; Be'Eri,6,0,36,30
1657161277313,MATH 103A,B02,083780,Greenfeld; Be'Eri,3,0,36,33
1657161277313,MATH 103A,B03,093562,Greenfeld; Be'Eri,3,0,36,33
1657161283335,MATH 105,A01,085443,Carter; Anne Toulson,14,0,35,21
1657161283335,MATH 105,A02,093477,Carter; Anne Toulson,20,0,35,15
1657161289360,MATH 109,A01,083213,Ganzberger; Geoffrey Michael,2,0,34,32
1657161289360,MATH 109,A02,083214,Ganzberger; Geoffrey Michael,3,0,34,31
1657161289360,MATH 109,A03,093478,Ganzberger; Geoffrey Michael,1,0,34,33
1657161289360,MATH 109,B01,083215,Ganzberger; Geoffrey Michael,1,0,32,31
1657161289360,MATH 109,B02,083216,Ganzberger; Geoffrey Michael,1,0,32,31
1657161289360,MATH 109,B03,093479,Ganzberger; Geoffrey Michael,6,0,32,26
1657161295386,MATH 142A,A01,083219,Chow; Bennett,6,0,32,26
1657161295386,MATH 142A,A02,083220,Chow; Bennett,10,0,32,22
1657161295386,MATH 142A,A03,093480,Chow; Bennett,7,0,32,25
1657161295386,MATH 142A,B03,093481,Chow; Bennett,8,0,32,24
1657161295386,MATH 142A,B04,093558,Chow; Bennett,11,0,32,21
1657161295386,MATH 142A,B05,093559,Chow; Bennett,6,0,32,26
1657161301408,MATH 193A,A01,083224,Rotar; Vladimir,7,0,34,27
1657161301408,MATH 193A,A02,083225,Rotar; Vladimir,5,0,34,29
1657161301408,MATH 193A,A03,083781,Rotar; Vladimir,1,0,34,33
1657161301408,MATH 193A,A04,083782,Rotar; Vladimir,8,0,34,26
1657161301408,MATH 193A,A05,093482,Rotar; Vladimir,6,0,34,28
1657161307433,MATH 197,001,091859,McAuley; Julian John,9999,0,9999,0
1657161307433,MATH 197,002,095566,Kedlaya; Kiran S.,9997,0,9999,2
1657161307433,MATH 197,003,095567,Xiao; Ming,9999,0,9999,0
1657161307433,MATH 197,004,095571,Perols; Johan Lars,9998,0,9999,1
1657161314488,COGS 9,A01,083615,Shannon; Kyle Michael,7,0,75,68
1657161320510,COGS 11,A01,083617,Boyle; Mary E. T.,22,0,48,26
1657161326534,COGS 13,A01,083071,Bastos; Amalia Pinkusfeld,9,0,71,62
1657161332557,COGS 14A,A01,092681,Semenuks; Arturs,1,1,100,99
1657161338583,COGS 14B,A01,083073,Cheng; Tzu-Han,6,0,63,57
1657161344609,COGS 17,A01,092677,Semenuks; Arturs,4,0,81,77
1657161350632,COGS 100,A01,083619,Allen; Michael Gordon,15,0,70,55
1657161356654,COGS 101A,A01,083621,Davis; Joshua Daniel,9,0,68,59
1657161362677,COGS 101B,A01,091572,Allen; Michael Gordon,9,0,65,56
1657161368710,COGS 101C,A01,083625,Delgado; Tania,17,0,35,18
1657161374739,COGS 107A,A01,083627,Boyle; Mary E. T.,13,0,60,47
1657161380762,COGS 118A,A01,083075,Gupta; Anjum,16,0,76,60
1657161386789,CSE 3,A50,083646,Miranda; Gregory Joseph,24,0,50,26
1657161392813,CSE 8A,A50,083650,Miranda; Gregory Joseph,17,1,56,39
1657161398835,CSE 11,A01,083080,Cao; Yingjun,5,15,40,35
1657161404862,CSE 12,A01,083652,Krause-Levy; Sophia Louisa,24,1,120,96
1657161410886,CSE 15L,A01,083654,Morris; Justin Loren,9,0,50,41
1657161410886,CSE 15L,A02,083655,Morris; Justin Loren,9,0,50,41
1657161416914,CSE 20,A01,083657,Tran; Khoa Dang,38,0,80,42
1657161422938,CSE 21,A01,095574,Bach; Quang Tran,22,0,48,26
1657161428962,CSE 30,A01,083084,Eldon; John,4,0,80,76
1657161428962,CSE 30,B01,095061,Bhaskar; Nishant,7,0,50,43
1657161434994,CSE 100,A01,083659,Cao; Yingjun,4,4,70,66
1657161441029,CSE 134B,A01,083661,Powell; Thomas Allan,20,0,100,80
1657161447054,CSE 140,A01,083663,Gungor; Onat,13,0,85,72
1657161453076,CSE 140L,A01,083088,Eldon; John,17,0,100,83
1657161459099,CSE 175,A01,083665,Kumar; Rakesh,3,0,25,22
1657161465127,CSE 190,A00,092507,Dubnov; Shlomo,7,0,20,13
1657161471150,ECE 45,A01,083139,Congero; Spencer William,5,0,75,70
1657161477174,ECE 65,A50,083695,Saad; Andrew S,12,0,30,18
1657161477174,ECE 65,A51,095125,Saad; Andrew S,25,0,26,1
1657161483205,ECE 109,A01,091882,Touri; Behrouz,18,0,70,52
1657161489236,ECE 180,A00,083140,Abi Samra; Nicholas Camill,1,0,30,29
1657161489236,ECE 180,B00,083141,Abi Samra; Nicholas Camill,0,0,30,30
1657161495261,MATH 10A,A01,083735,Patchell; Gregory David,2,0,30,28
1657161495261,MATH 10A,A02,083736,Patchell; Gregory David,20,0,30,10
1657161495261,MATH 10A,A03,083737,Patchell; Gregory David,16,0,30,14
1657161501288,MATH 10B,A01,083207,Lim; Seonhee,7,0,34,27
1657161501288,MATH 10B,A02,083208,Lim; Seonhee,9,0,35,26
1657161501288,MATH 10B,A03,093472,Lim; Seonhee,5,0,34,29
1657161501288,MATH 10B,B01,083739,Sinha; Shubham,9,0,30,21
1657161507317,MATH 18,A01,083743,Cinel; Cameron Alexander,6,0,30,24
1657161507317,MATH 18,A02,083744,Cinel; Cameron Alexander,15,0,30,15
1657161507317,MATH 18,A03,083745,Cinel; Cameron Alexander,8,0,30,22
1657161507317,MATH 18,B01,083748,Rideout; David Porter,4,0,37,33
1657161507317,MATH 18,B02,083749,Rideout; David Porter,3,0,36,33
1657161507317,MATH 18,B03,083750,Rideout; David Porter,2,0,37,35
1657161507317,MATH 18,B04,083751,Rideout; David Porter,5,0,36,31
1657161507317,MATH 18,B05,093473,Rideout; David Porter,5,0,36,31
1657161507317,MATH 18,B06,093474,Rideout; David Porter,5,0,36,31
1657161513343,MATH 20A,A01,083754,Zheng; Zequn,12,0,40,28
1657161519366,MATH 20B,A01,083756,Briones; Jor-el Thomas Caparas,1,0,36,35
1657161519366,MATH 20B,A02,083757,Briones; Jor-el Thomas Caparas,1,0,36,35
1657161519366,MATH 20B,A03,093475,Briones; Jor-el Thomas Caparas,1,0,36,35
1657161525394,MATH 20C,A01,083760,Briones; Jor-el Thomas Caparas,1,0,35,34
1657161525394,MATH 20C,A02,083761,Briones; Jor-el Thomas Caparas,8,0,35,27
1657161525394,MATH 20C,A03,093476,Briones; Jor-el Thomas Caparas,0,1,36,36
1657161525394,MATH 20C,B01,083762,Bach; Quang Tran,1,0,30,29
1657161531416,MATH 20D,A01,083765,Tran; Brian Kha,4,0,30,26
1657161531416,MATH 20D,A02,083766,Tran; Brian Kha,5,0,30,25
1657161531416,MATH 20D,A03,083767,Tran; Brian Kha,3,0,30,27
1657161537444,MATH 20E,A01,083771,Ganguly; Soumya,7,0,32,25
1657161537444,MATH 20E,A02,083772,Ganguly; Soumya,7,0,32,25
1657161537444,MATH 20E,B01,083773,Ciotti; Benjamin,19,0,35,16
1657161537444,MATH 20E,B02,083774,Ciotti; Benjamin,17,0,35,18
1657161543480,MATH 103A,A01,083777,Greenfeld; Be'Eri,2,0,36,34
1657161543480,MATH 103A,A02,083778,Greenfeld; Be'Eri,5,0,36,31
1657161543480,MATH 103A,A03,093561,Greenfeld; Be'Eri,4,0,36,32
1657161543480,MATH 103A,B01,083779,Greenfeld; Be'Eri,6,0,36,30
1657161543480,MATH 103A,B02,083780,Greenfeld; Be'Eri,3,0,36,33
1657161543480,MATH 103A,B03,093562,Greenfeld; Be'Eri,3,0,36,33
1657161549503,MATH 105,A01,085443,Carter; Anne Toulson,14,0,35,21
1657161549503,MATH 105,A02,093477,Carter; Anne Toulson,20,0,35,15
1657161555535,MATH 109,A01,083213,Ganzberger; Geoffrey Michael,2,0,34,32
1657161555535,MATH 109,A02,083214,Ganzberger; Geoffrey Michael,3,0,34,31
1657161555535,MATH 109,A03,093478,Ganzberger; Geoffrey Michael,1,0,34,33
1657161555535,MATH 109,B01,083215,Ganzberger; Geoffrey Michael,1,0,32,31
1657161555535,MATH 109,B02,083216,Ganzberger; Geoffrey Michael,1,0,32,31
1657161555535,MATH 109,B03,093479,Ganzberger; Geoffrey Michael,6,0,32,26
1657161561563,MATH 142A,A01,083219,Chow; Bennett,6,0,32,26
1657161561563,MATH 142A,A02,083220,Chow; Bennett,10,0,32,22
1657161561563,MATH 142A,A03,093480,Chow; Bennett,7,0,32,25
1657161561563,MATH 142A,B03,093481,Chow; Bennett,8,0,32,24
1657161561563,MATH 142A,B04,093558,Chow; Bennett,11,0,32,21
1657161561563,MATH 142A,B05,093559,Chow; Bennett,6,0,32,26
1657161567586,MATH 193A,A01,083224,Rotar; Vladimir,7,0,34,27
1657161567586,MATH 193A,A02,083225,Rotar; Vladimir,5,0,34,29
1657161567586,MATH 193A,A03,083781,Rotar; Vladimir,1,0,34,33
1657161567586,MATH 193A,A04,083782,Rotar; Vladimir,8,0,34,26
1657161567586,MATH 193A,A05,093482,Rotar; Vladimir,6,0,34,28
1657161573621,MATH 197,001,091859,McAuley; Julian John,9999,0,9999,0
1657161573621,MATH 197,002,095566,Kedlaya; Kiran S.,9997,0,9999,2
1657161573621,MATH 197,003,095567,Xiao; Ming,9999,0,9999,0
1657161573621,MATH 197,004,095571,Perols; Johan Lars,9998,0,9999,1
1657161580671,COGS 9,A01,083615,Shannon; Kyle Michael,7,0,75,68
1657161586694,COGS 11,A01,083617,Boyle; Mary E. T.,22,0,48,26
1657161592720,COGS 13,A01,083071,Bastos; Amalia Pinkusfeld,9,0,71,62
1657161598744,COGS 14A,A01,092681,Semenuks; Arturs,1,1,100,99
1657161604782,COGS 14B,A01,083073,Cheng; Tzu-Han,6,0,63,57
1657161610810,COGS 17,A01,092677,Semenuks; Arturs,4,0,81,77
1657161616832,COGS 100,A01,083619,Allen; Michael Gordon,15,0,70,55
1657161622860,COGS 101A,A01,083621,Davis; Joshua Daniel,9,0,68,59
1657161628882,COGS 101B,A01,091572,Allen; Michael Gordon,9,0,65,56
1657161634916,COGS 101C,A01,083625,Delgado; Tania,17,0,35,18
1657161640942,COGS 107A,A01,083627,Boyle; Mary E. T.,13,0,60,47
1657161646968,COGS 118A,A01,083075,Gupta; Anjum,16,0,76,60
1657161652991,CSE 3,A50,083646,Miranda; Gregory Joseph,24,0,50,26
1657161659019,CSE 8A,A50,083650,Miranda; Gregory Joseph,17,1,56,39
1657161665042,CSE 11,A01,083080,Cao; Yingjun,5,15,40,35
1657161671064,CSE 12,A01,083652,Krause-Levy; Sophia Louisa,24,1,120,96
1657161677091,CSE 15L,A01,083654,Morris; Justin Loren,9,0,50,41
1657161677091,CSE 15L,A02,083655,Morris; Justin Loren,9,0,50,41
1657161683117,CSE 20,A01,083657,Tran; Khoa Dang,38,0,80,42
1657161689168,CSE 21,A01,095574,Bach; Quang Tran,22,0,48,26
1657161695192,CSE 30,A01,083084,Eldon; John,4,0,80,76
1657161695192,CSE 30,B01,095061,Bhaskar; Nishant,7,0,50,43
1657161701220,CSE 100,A01,083659,Cao; Yingjun,4,4,70,66
1657161707242,CSE 134B,A01,083661,Powell; Thomas Allan,20,0,100,80
1657161713274,CSE 140,A01,083663,Gungor; Onat,13,0,85,72
1657161719298,CSE 140L,A01,083088,Eldon; John,17,0,100,83
1657161725320,CSE 175,A01,083665,Kumar; Rakesh,3,0,25,22
1657161731347,CSE 190,A00,092507,Dubnov; Shlomo,7,0,20,13
1657161737374,ECE 45,A01,083139,Congero; Spencer William,5,0,75,70
1657161743396,ECE 65,A50,083695,Saad; Andrew S,12,0,30,18
1657161743396,ECE 65,A51,095125,Saad; Andrew S,25,0,26,1
1657161749420,ECE 109,A01,091882,Touri; Behrouz,18,0,70,52
1657161755545,ECE 180,A00,083140,Abi Samra; Nicholas Camill,1,0,30,29
1657161755545,ECE 180,B00,083141,Abi Samra; Nicholas Camill,0,0,30,30
1657161761569,MATH 10A,A01,083735,Patchell; Gregory David,2,0,30,28
1657161761569,MATH 10A,A02,083736,Patchell; Gregory David,20,0,30,10
1657161761569,MATH 10A,A03,083737,Patchell; Gregory David,16,0,30,14
1657161767591,MATH 10B,A01,083207,Lim; Seonhee,7,0,34,27
1657161767591,MATH 10B,A02,083208,Lim; Seonhee,9,0,35,26
1657161767591,MATH 10B,A03,093472,Lim; Seonhee,5,0,34,29
1657161767591,MATH 10B,B01,083739,Sinha; Shubham,9,0,30,21
1657161773617,MATH 18,A01,083743,Cinel; Cameron Alexander,6,0,30,24
1657161773617,MATH 18,A02,083744,Cinel; Cameron Alexander,15,0,30,15
1657161773617,MATH 18,A03,083745,Cinel; Cameron Alexander,8,0,30,22
1657161773617,MATH 18,B01,083748,Rideout; David Porter,4,0,37,33
1657161773617,MATH 18,B02,083749,Rideout; David Porter,3,0,36,33
1657161773617,MATH 18,B03,083750,Rideout; David Porter,2,0,37,35
1657161773617,MATH 18,B04,083751,Rideout; David Porter,5,0,36,31
1657161773617,MATH 18,B05,093473,Rideout; David Porter,5,0,36,31
1657161773617,MATH 18,B06,093474,Rideout; David Porter,5,0,36,31
1657161779641,MATH 20A,A01,083754,Zheng; Zequn,12,0,40,28
1657161785681,MATH 20B,A01,083756,Briones; Jor-el Thomas Caparas,1,0,36,35
1657161785681,MATH 20B,A02,083757,Briones; Jor-el Thomas Caparas,1,0,36,35
1657161785681,MATH 20B,A03,093475,Briones; Jor-el Thomas Caparas,1,0,36,35
1657161791705,MATH 20C,A01,083760,Briones; Jor-el Thomas Caparas,1,0,35,34
1657161791705,MATH 20C,A02,083761,Briones; Jor-el Thomas Caparas,8,0,35,27
1657161791705,MATH 20C,A03,093476,Briones; Jor-el Thomas Caparas,0,1,36,36
1657161791705,MATH 20C,B01,083762,Bach; Quang Tran,1,0,30,29
1657161797742,MATH 20D,A01,083765,Tran; Brian Kha,4,0,30,26
1657161797742,MATH 20D,A02,083766,Tran; Brian Kha,5,0,30,25
1657161797742,MATH 20D,A03,083767,Tran; Brian Kha,3,0,30,27
1657161803770,MATH 20E,A01,083771,Ganguly; Soumya,7,0,32,25
1657161803770,MATH 20E,A02,083772,Ganguly; Soumya,7,0,32,25
1657161803770,MATH 20E,B01,083773,Ciotti; Benjamin,19,0,35,16
1657161803770,MATH 20E,B02,083774,Ciotti; Benjamin,17,0,35,18
1657161809794,MATH 103A,A01,083777,Greenfeld; Be'Eri,2,0,36,34
1657161809794,MATH 103A,A02,083778,Greenfeld; Be'Eri,5,0,36,31
1657161809794,MATH 103A,A03,093561,Greenfeld; Be'Eri,4,0,36,32
1657161809794,MATH 103A,B01,083779,Greenfeld; Be'Eri,6,0,36,30
1657161809794,MATH 103A,B02,083780,Greenfeld; Be'Eri,3,0,36,33
1657161809794,MATH 103A,B03,093562,Greenfeld; Be'Eri,3,0,36,33
1657161815818,MATH 105,A01,085443,Carter; Anne Toulson,14,0,35,21
1657161815818,MATH 105,A02,093477,Carter; Anne Toulson,20,0,35,15
1657161821847,MATH 109,A01,083213,Ganzberger; Geoffrey Michael,2,0,34,32
1657161821847,MATH 109,A02,083214,Ganzberger; Geoffrey Michael,3,0,34,31
1657161821847,MATH 109,A03,093478,Ganzberger; Geoffrey Michael,1,0,34,33
1657161821847,MATH 109,B01,083215,Ganzberger; Geoffrey Michael,1,0,32,31
1657161821847,MATH 109,B02,083216,Ganzberger; Geoffrey Michael,1,0,32,31
1657161821847,MATH 109,B03,093479,Ganzberger; Geoffrey Michael,6,0,32,26
1657161827873,MATH 142A,A01,083219,Chow; Bennett,6,0,32,26
1657161827873,MATH 142A,A02,083220,Chow; Bennett,10,0,32,22
1657161827873,MATH 142A,A03,093480,Chow; Bennett,7,0,32,25
1657161827873,MATH 142A,B03,093481,Chow; Bennett,8,0,32,24
1657161827873,MATH 142A,B04,093558,Chow; Bennett,11,0,32,21
1657161827873,MATH 142A,B05,093559,Chow; Bennett,6,0,32,26
1657161833895,MATH 193A,A01,083224,Rotar; Vladimir,7,0,34,27
1657161833895,MATH 193A,A02,083225,Rotar; Vladimir,5,0,34,29
1657161833895,MATH 193A,A03,083781,Rotar; Vladimir,1,0,34,33
1657161833895,MATH 193A,A04,083782,Rotar; Vladimir,8,0,34,26
1657161833895,MATH 193A,A05,093482,Rotar; Vladimir,6,0,34,28
1657161839919,MATH 197,001,091859,McAuley; Julian John,9999,0,9999,0
1657161839919,MATH 197,002,095566,Kedlaya; Kiran S.,9997,0,9999,2
1657161839919,MATH 197,003,095567,Xiao; Ming,9999,0,9999,0
1657161839919,MATH 197,004,095571,Perols; Johan Lars,9998,0,9999,1
1657161846986,COGS 9,A01,083615,Shannon; Kyle Michael,7,0,75,68
1657161853012,COGS 11,A01,083617,Boyle; Mary E. T.,22,0,48,26
1657161859049,COGS 13,A01,083071,Bastos; Amalia Pinkusfeld,9,0,71,62
1657161865076,COGS 14A,A01,092681,Semenuks; Arturs,1,1,100,99
1657161871103,COGS 14B,A01,083073,Cheng; Tzu-Han,6,0,63,57
1657161877128,COGS 17,A01,092677,Semenuks; Arturs,4,0,81,77
1657161883152,COGS 100,A01,083619,Allen; Michael Gordon,15,0,70,55
1657161889176,COGS 101A,A01,083621,Davis; Joshua Daniel,9,0,68,59
1657161895202,COGS 101B,A01,091572,Allen; Michael Gordon,9,0,65,56
1657161901234,COGS 101C,A01,083625,Delgado; Tania,17,0,35,18
1657161907273,COGS 107A,A01,083627,Boyle; Mary E. T.,13,0,60,47
1657161913296,COGS 118A,A01,083075,Gupta; Anjum,16,0,76,60
1657161919319,CSE 3,A50,083646,Miranda; Gregory Joseph,24,0,50,26
1657161925347,CSE 8A,A50,083650,Miranda; Gregory Joseph,17,1,56,39
1657161931371,CSE 11,A01,083080,Cao; Yingjun,5,15,40,35
1657161937395,CSE 12,A01,083652,Krause-Levy; Sophia Louisa,24,1,120,96
1657161943422,CSE 15L,A01,083654,Morris; Justin Loren,9,0,50,41
1657161943422,CSE 15L,A02,083655,Morris; Justin Loren,9,0,50,41
1657161949447,CSE 20,A01,083657,Tran; Khoa Dang,38,0,80,42
1657161955475,CSE 21,A01,095574,Bach; Quang Tran,22,0,48,26
1657161961508,CSE 30,A01,083084,Eldon; John,4,0,80,76
1657161961508,CSE 30,B01,095061,Bhaskar; Nishant,7,0,50,43
1657161967532,CSE 100,A01,083659,Cao; Yingjun,4,4,70,66
1657161973555,CSE 134B,A01,083661,Powell; Thomas Allan,20,0,100,80
1657161979589,CSE 140,A01,083663,Gungor; Onat,13,0,85,72
1657161985616,CSE 140L,A01,083088,Eldon; John,17,0,100,83
1657161991641,CSE 175,A01,083665,Kumar; Rakesh,3,0,25,22
1657161997666,CSE 190,A00,092507,Dubnov; Shlomo,7,0,20,13
1657162003692,ECE 45,A01,083139,Congero; Spencer William,5,0,75,70
1657162009722,ECE 65,A50,083695,Saad; Andrew S,12,0,30,18
1657162009722,ECE 65,A51,095125,Saad; Andrew S,25,0,26,1
1657162015750,ECE 109,A01,091882,Touri; Behrouz,18,0,70,52
1657162021776,ECE 180,A00,083140,Abi Samra; Nicholas Camill,1,0,30,29
1657162021776,ECE 180,B00,083141,Abi Samra; Nicholas Camill,0,0,30,30
1657162027801,MATH 10A,A01,083735,Patchell; Gregory David,2,0,30,28
1657162027801,MATH 10A,A02,083736,Patchell; Gregory David,20,0,30,10
1657162027801,MATH 10A,A03,083737,Patchell; Gregory David,16,0,30,14
1657162033829,MATH 10B,A01,083207,Lim; Seonhee,7,0,34,27
1657162033829,MATH 10B,A02,083208,Lim; Seonhee,9,0,35,26
1657162033829,MATH 10B,A03,093472,Lim; Seonhee,5,0,34,29
1657162033829,MATH 10B,B01,083739,Sinha; Shubham,9,0,30,21
1657162039861,MATH 18,A01,083743,Cinel; Cameron Alexander,6,0,30,24
1657162039861,MATH 18,A02,083744,Cinel; Cameron Alexander,15,0,30,15
1657162039861,MATH 18,A03,083745,Cinel; Cameron Alexander,8,0,30,22
1657162039861,MATH 18,B01,083748,Rideout; David Porter,4,0,37,33
1657162039861,MATH 18,B02,083749,Rideout; David Porter,3,0,36,33
1657162039861,MATH 18,B03,083750,Rideout; David Porter,2,0,37,35
1657162039861,MATH 18,B04,083751,Rideout; David Porter,5,0,36,31
1657162039861,MATH 18,B05,093473,Rideout; David Porter,5,0,36,31
1657162039861,MATH 18,B06,093474,Rideout; David Porter,5,0,36,31
1657162045884,MATH 20A,A01,083754,Zheng; Zequn,12,0,40,28
1657162051917,MATH 20B,A01,083756,Briones; Jor-el Thomas Caparas,1,0,36,35
1657162051917,MATH 20B,A02,083757,Briones; Jor-el Thomas Caparas,1,0,36,35
1657162051917,MATH 20B,A03,093475,Briones; Jor-el Thomas Caparas,1,0,36,35
1657162057944,MATH 20C,A01,083760,Briones; Jor-el Thomas Caparas,1,0,35,34
1657162057944,MATH 20C,A02,083761,Briones; Jor-el Thomas Caparas,8,0,35,27
1657162057944,MATH 20C,A03,093476,Briones; Jor-el Thomas Caparas,0,1,36,36
1657162057944,MATH 20C,B01,083762,Bach; Quang Tran,1,0,30,29
1657162063971,MATH 20D,A01,083765,Tran; Brian Kha,4,0,30,26
1657162063971,MATH 20D,A02,083766,Tran; Brian Kha,5,0,30,25
1657162063971,MATH 20D,A03,083767,Tran; Brian Kha,3,0,30,27
1657162070004,MATH 20E,A01,083771,Ganguly; Soumya,7,0,32,25
1657162070004,MATH 20E,A02,083772,Ganguly; Soumya,7,0,32,25
1657162070004,MATH 20E,B01,083773,Ciotti; Benjamin,19,0,35,16
1657162070004,MATH 20E,B02,083774,Ciotti; Benjamin,17,0,35,18
1657162076029,MATH 103A,A01,083777,Greenfeld; Be'Eri,2,0,36,34
1657162076029,MATH 103A,A02,083778,Greenfeld; Be'Eri,5,0,36,31
1657162076029,MATH 103A,A03,093561,Greenfeld; Be'Eri,4,0,36,32
1657162076029,MATH 103A,B01,083779,Greenfeld; Be'Eri,6,0,36,30
1657162076029,MATH 103A,B02,083780,Greenfeld; Be'Eri,3,0,36,33
1657162076029,MATH 103A,B03,093562,Greenfeld; Be'Eri,3,0,36,33
1657162082067,MATH 105,A01,085443,Carter; Anne Toulson,14,0,35,21
1657162082067,MATH 105,A02,093477,Carter; Anne Toulson,20,0,35,15
1657162088092,MATH 109,A01,083213,Ganzberger; Geoffrey Michael,2,0,34,32
1657162088092,MATH 109,A02,083214,Ganzberger; Geoffrey Michael,3,0,34,31
1657162088092,MATH 109,A03,093478,Ganzberger; Geoffrey Michael,1,0,34,33
1657162088092,MATH 109,B01,083215,Ganzberger; Geoffrey Michael,1,0,32,31
1657162088092,MATH 109,B02,083216,Ganzberger; Geoffrey Michael,1,0,32,31
1657162088092,MATH 109,B03,093479,Ganzberger; Geoffrey Michael,6,0,32,26
1657162094115,MATH 142A,A01,083219,Chow; Bennett,6,0,32,26
1657162094115,MATH 142A,A02,083220,Chow; Bennett,10,0,32,22
1657162094115,MATH 142A,A03,093480,Chow; Bennett,7,0,32,25
1657162094115,MATH 142A,B03,093481,Chow; Bennett,8,0,32,24
1657162094115,MATH 142A,B04,093558,Chow; Bennett,11,0,32,21
1657162094115,MATH 142A,B05,093559,Chow; Bennett,6,0,32,26
1657162100148,MATH 193A,A01,083224,Rotar; Vladimir,7,0,34,27
1657162100148,MATH 193A,A02,083225,Rotar; Vladimir,5,0,34,29
1657162100148,MATH 193A,A03,083781,Rotar; Vladimir,1,0,34,33
1657162100148,MATH 193A,A04,083782,Rotar; Vladimir,8,0,34,26
1657162100148,MATH 193A,A05,093482,Rotar; Vladimir,6,0,34,28
1657162106173,MATH 197,001,091859,McAuley; Julian John,9999,0,9999,0
1657162106173,MATH 197,002,095566,Kedlaya; Kiran S.,9997,0,9999,2
1657162106173,MATH 197,003,095567,Xiao; Ming,9999,0,9999,0
1657162106173,MATH 197,004,095571,Perols; Johan Lars,9998,0,9999,1
1657162113231,COGS 9,A01,083615,Shannon; Kyle Michael,7,0,75,68
1657162119254,COGS 11,A01,083617,Boyle; Mary E. T.,22,0,48,26
1657162125275,COGS 13,A01,083071,Bastos; Amalia Pinkusfeld,9,0,71,62
1657162131297,COGS 14A,A01,092681,Semenuks; Arturs,1,1,100,99
1657162137324,COGS 14B,A01,083073,Cheng; Tzu-Han,6,0,63,57
1657162143347,COGS 17,A01,092677,Semenuks; Arturs,4,0,81,77
1657162149373,COGS 100,A01,083619,Allen; Michael Gordon,15,0,70,55
1657162155399,COGS 101A,A01,083621,Davis; Joshua Daniel,9,0,68,59
1657162161422,COGS 101B,A01,091572,Allen; Michael Gordon,9,0,65,56
1657162167446,COGS 101C,A01,083625,Delgado; Tania,17,0,35,18
1657162173469,COGS 107A,A01,083627,Boyle; Mary E. T.,13,0,60,47
1657162179512,COGS 118A,A01,083075,Gupta; Anjum,16,0,76,60
1657162185540,CSE 3,A50,083646,Miranda; Gregory Joseph,24,0,50,26
1657162191563,CSE 8A,A50,083650,Miranda; Gregory Joseph,17,1,56,39
1657162197589,CSE 11,A01,083080,Cao; Yingjun,5,15,40,35
1657162203612,CSE 12,A01,083652,Krause-Levy; Sophia Louisa,24,1,120,96
1657162209633,CSE 15L,A01,083654,Morris; Justin Loren,9,0,50,41
1657162209633,CSE 15L,A02,083655,Morris; Justin Loren,9,0,50,41
1657162215656,CSE 20,A01,083657,Tran; Khoa Dang,38,0,80,42
1657162221683,CSE 21,A01,095574,Bach; Quang Tran,22,0,48,26
1657162227706,CSE 30,A01,083084,Eldon; John,4,0,80,76
1657162227706,CSE 30,B01,095061,Bhaskar; Nishant,7,0,50,43
1657162233729,CSE 100,A01,083659,Cao; Yingjun,4,4,70,66
1657162239752,CSE 134B,A01,083661,Powell; Thomas Allan,20,0,100,80
1657162245775,CSE 140,A01,083663,Gungor; Onat,13,0,85,72
1657162251796,CSE 140L,A01,083088,Eldon; John,17,0,100,83
1657162257818,CSE 175,A01,083665,Kumar; Rakesh,3,0,25,22
1657162263844,CSE 190,A00,092507,Dubnov; Shlomo,7,0,20,13
1657162269871,ECE 45,A01,083139,Congero; Spencer William,5,0,75,70
1657162275895,ECE 65,A50,083695,Saad; Andrew S,12,0,30,18
1657162275895,ECE 65,A51,095125,Saad; Andrew S,25,0,26,1
1657162281921,ECE 109,A01,091882,Touri; Behrouz,18,0,70,52
1657162287947,ECE 180,A00,083140,Abi Samra; Nicholas Camill,1,0,30,29
1657162287947,ECE 180,B00,083141,Abi Samra; Nicholas Camill,0,0,30,30
1657162293970,MATH 10A,A01,083735,Patchell; Gregory David,2,0,30,28
1657162293970,MATH 10A,A02,083736,Patchell; Gregory David,20,0,30,10
1657162293970,MATH 10A,A03,083737,Patchell; Gregory David,16,0,30,14
1657162300000,MATH 10B,A01,083207,Lim; Seonhee,7,0,34,27
1657162300000,MATH 10B,A02,083208,Lim; Seonhee,9,0,35,26
1657162300000,MATH 10B,A03,093472,Lim; Seonhee,5,0,34,29
1657162300000,MATH 10B,B01,083739,Sinha; Shubham,9,0,30,21
1657162306036,MATH 18,A01,083743,Cinel; Cameron Alexander,6,0,30,24
1657162306036,MATH 18,A02,083744,Cinel; Cameron Alexander,15,0,30,15
1657162306036,MATH 18,A03,083745,Cinel; Cameron Alexander,8,0,30,22
1657162306036,MATH 18,B01,083748,Rideout; David Porter,4,0,37,33
1657162306036,MATH 18,B02,083749,Rideout; David Porter,3,0,36,33
1657162306036,MATH 18,B03,083750,Rideout; David Porter,2,0,37,35
1657162306036,MATH 18,B04,083751,Rideout; David Porter,5,0,36,31
1657162306036,MATH 18,B05,093473,Rideout; David Porter,5,0,36,31
1657162306036,MATH 18,B06,093474,Rideout; David Porter,5,0,36,31
1657162312059,MATH 20A,A01,083754,Zheng; Zequn,12,0,40,28
1657162318084,MATH 20B,A01,083756,Briones; Jor-el Thomas Caparas,1,0,36,35
1657162318084,MATH 20B,A02,083757,Briones; Jor-el Thomas Caparas,1,0,36,35
1657162318084,MATH 20B,A03,093475,Briones; Jor-el Thomas Caparas,1,0,36,35
1657162324107,MATH 20C,A01,083760,Briones; Jor-el Thomas Caparas,1,0,35,34
1657162324107,MATH 20C,A02,083761,Briones; Jor-el Thomas Caparas,8,0,35,27
1657162324107,MATH 20C,A03,093476,Briones; Jor-el Thomas Caparas,0,1,36,36
1657162324107,MATH 20C,B01,083762,Bach; Quang Tran,1,0,30,29
1657162330388,MATH 20D,A01,083765,Tran; Brian Kha,4,0,30,26
1657162330388,MATH 20D,A02,083766,Tran; Brian Kha,5,0,30,25
1657162330388,MATH 20D,A03,083767,Tran; Brian Kha,3,0,30,27
1657162336412,MATH 20E,A01,083771,Ganguly; Soumya,7,0,32,25
1657162336412,MATH 20E,A02,083772,Ganguly; Soumya,7,0,32,25
1657162336412,MATH 20E,B01,083773,Ciotti; Benjamin,19,0,35,16
1657162336412,MATH 20E,B02,083774,Ciotti; Benjamin,17,0,35,18
1657162342445,MATH 103A,A01,083777,Greenfeld; Be'Eri,2,0,36,34
1657162342445,MATH 103A,A02,083778,Greenfeld; Be'Eri,5,0,36,31
1657162342445,MATH 103A,A03,093561,Greenfeld; Be'Eri,4,0,36,32
1657162342445,MATH 103A,B01,083779,Greenfeld; Be'Eri,6,0,36,30
1657162342445,MATH 103A,B02,083780,Greenfeld; Be'Eri,3,0,36,33
1657162342445,MATH 103A,B03,093562,Greenfeld; Be'Eri,3,0,36,33
1657162348468,MATH 105,A01,085443,Carter; Anne Toulson,14,0,35,21
1657162348468,MATH 105,A02,093477,Carter; Anne Toulson,20,0,35,15
1657162354567,MATH 109,A01,083213,Ganzberger; Geoffrey Michael,2,0,34,32
1657162354567,MATH 109,A02,083214,Ganzberger; Geoffrey Michael,3,0,34,31
1657162354567,MATH 109,A03,093478,Ganzberger; Geoffrey Michael,1,0,34,33
1657162354567,MATH 109,B01,083215,Ganzberger; Geoffrey Michael,1,0,32,31
1657162354567,MATH 109,B02,083216,Ganzberger; Geoffrey Michael,1,0,32,31
1657162354567,MATH 109,B03,093479,Ganzberger; Geoffrey Michael,6,0,32,26
1657162360591,MATH 142A,A01,083219,Chow; Bennett,6,0,32,26
1657162360591,MATH 142A,A02,083220,Chow; Bennett,10,0,32,22
1657162360591,MATH 142A,A03,093480,Chow; Bennett,7,0,32,25
1657162360591,MATH 142A,B03,093481,Chow; Bennett,8,0,32,24
1657162360591,MATH 142A,B04,093558,Chow; Bennett,11,0,32,21
1657162360591,MATH 142A,B05,093559,Chow; Bennett,6,0,32,26
1657162366618,MATH 193A,A01,083224,Rotar; Vladimir,7,0,34,27
1657162366618,MATH 193A,A02,083225,Rotar; Vladimir,5,0,34,29
1657162366618,MATH 193A,A03,083781,Rotar; Vladimir,1,0,34,33
1657162366618,MATH 193A,A04,083782,Rotar; Vladimir,8,0,34,26
1657162366618,MATH 193A,A05,093482,Rotar; Vladimir,6,0,34,28
1657162372640,MATH 197,001,091859,McAuley; Julian John,9999,0,9999,0
1657162372640,MATH 197,002,095566,Kedlaya; Kiran S.,9997,0,9999,2
1657162372640,MATH 197,003,095567,Xiao; Ming,9999,0,9999,0
1657162372640,MATH 197,004,095571,Perols; Johan Lars,9998,0,9999,1
1657162379702,COGS 9,A01,083615,Shannon; Kyle Michael,7,0,75,68
1657162385729,COGS 11,A01,083617,Boyle; Mary E. T.,22,0,48,26
1657162391751,COGS 13,A01,083071,Bastos; Amalia Pinkusfeld,9,0,71,62
1657162397778,COGS 14A,A01,092681,Semenuks; Arturs,1,1,100,99
1657162403803,COGS 14B,A01,083073,Cheng; Tzu-Han,6,0,63,57
1657162409826,COGS 17,A01,092677,Semenuks; Arturs,4,0,81,77
1657162415851,COGS 100,A01,083619,Allen; Michael Gordon,15,0,70,55
1657162421885,COGS 101A,A01,083621,Davis; Joshua Daniel,9,0,68,59
1657162427911,COGS 101B,A01,091572,Allen; Michael Gordon,9,0,65,56
1657162433936,COGS 101C,A01,083625,Delgado; Tania,17,0,35,18
1657162439962,COGS 107A,A01,083627,Boyle; Mary E. T.,13,0,60,47
1657162445986,COGS 118A,A01,083075,Gupta; Anjum,16,0,76,60
1657162452010,CSE 3,A50,083646,Miranda; Gregory Joseph,24,0,50,26
1657162458038,CSE 8A,A50,083650,Miranda; Gregory Joseph,17,1,56,39
1657162464060,CSE 11,A01,083080,Cao; Yingjun,5,15,40,35
1657162470087,CSE 12,A01,083652,Krause-Levy; Sophia Louisa,24,1,120,96
1657162476117,CSE 15L,A01,083654,Morris; Justin Loren,9,0,50,41
1657162476117,CSE 15L,A02,083655,Morris; Justin Loren,9,0,50,41
1657162482147,CSE 20,A01,083657,Tran; Khoa Dang,38,0,80,42
1657162488171,CSE 21,A01,095574,Bach; Quang Tran,22,0,48,26
1657162494194,CSE 30,A01,083084,Eldon; John,4,0,80,76
1657162494194,CSE 30,B01,095061,Bhaskar; Nishant,7,0,50,43
1657162500222,CSE 100,A01,083659,Cao; Yingjun,4,4,70,66
1657162506245,CSE 134B,A01,083661,Powell; Thomas Allan,20,0,100,80
1657162512268,CSE 140,A01,083663,Gungor; Onat,13,0,85,72
1657162518290,CSE 140L,A01,083088,Eldon; John,17,0,100,83
1657162524312,CSE 175,A01,083665,Kumar; Rakesh,3,0,25,22
1657162530334,CSE 190,A00,092507,Dubnov; Shlomo,7,0,20,13
1657162536356,ECE 45,A01,083139,Congero; Spencer William,5,0,75,70
1657162542382,ECE 65,A50,083695,Saad; Andrew S,12,0,30,18
1657162542382,ECE 65,A51,095125,Saad; Andrew S,25,0,26,1
1657162548411,ECE 109,A01,091882,Touri; Behrouz,18,0,70,52
1657162554438,ECE 180,A00,083140,Abi Samra; Nicholas Camill,1,0,30,29
1657162554438,ECE 180,B00,083141,Abi Samra; Nicholas Camill,0,0,30,30
1657162560467,MATH 10A,A01,083735,Patchell; Gregory David,2,0,30,28
1657162560467,MATH 10A,A02,083736,Patchell; Gregory David,20,0,30,10
1657162560467,MATH 10A,A03,083737,Patchell; Gregory David,16,0,30,14
1657162566495,MATH 10B,A01,083207,Lim; Seonhee,7,0,34,27
1657162566495,MATH 10B,A02,083208,Lim; Seonhee,9,0,35,26
1657162566495,MATH 10B,A03,093472,Lim; Seonhee,5,0,34,29
1657162566495,MATH 10B,B01,083739,Sinha; Shubham,9,0,30,21
1657162572535,MATH 18,A01,083743,Cinel; Cameron Alexander,6,0,30,24
1657162572535,MATH 18,A02,083744,Cinel; Cameron Alexander,15,0,30,15
1657162572535,MATH 18,A03,083745,Cinel; Cameron Alexander,8,0,30,22
1657162572535,MATH 18,B01,083748,Rideout; David Porter,4,0,37,33
1657162572535,MATH 18,B02,083749,Rideout; David Porter,3,0,36,33
1657162572535,MATH 18,B03,083750,Rideout; David Porter,2,0,37,35
1657162572535,MATH 18,B04,083751,Rideout; David Porter,5,0,36,31
1657162572535,MATH 18,B05,093473,Rideout; David Porter,5,0,36,31
1657162572535,MATH 18,B06,093474,Rideout; David Porter,5,0,36,31
1657162578559,MATH 20A,A01,083754,Zheng; Zequn,12,0,40,28
1657162584597,MATH 20B,A01,083756,Briones; Jor-el Thomas Caparas,1,0,36,35
1657162584597,MATH 20B,A02,083757,Briones; Jor-el Thomas Caparas,1,0,36,35
1657162584597,MATH 20B,A03,093475,Briones; Jor-el Thomas Caparas,1,0,36,35
1657162590627,MATH 20C,A01,083760,Briones; Jor-el Thomas Caparas,1,0,35,34
1657162590627,MATH 20C,A02,083761,Briones; Jor-el Thomas Caparas,8,0,35,27
1657162590627,MATH 20C,A03,093476,Briones; Jor-el Thomas Caparas,0,1,36,36
1657162590627,MATH 20C,B01,083762,Bach; Quang Tran,1,0,30,29
1657162596652,MATH 20D,A01,083765,Tran; Brian Kha,4,0,30,26
1657162596652,MATH 20D,A02,083766,Tran; Brian Kha,5,0,30,25
1657162596652,MATH 20D,A03,083767,Tran; Brian Kha,3,0,30,27
1657162602674,MATH 20E,A01,083771,Ganguly; Soumya,7,0,32,25
1657162602674,MATH 20E,A02,083772,Ganguly; Soumya,7,0,32,25
1657162602674,MATH 20E,B01,083773,Ciotti; Benjamin,19,0,35,16
1657162602674,MATH 20E,B02,083774,Ciotti; Benjamin,17,0,35,18
1657162608697,MATH 103A,A01,083777,Greenfeld; Be'Eri,2,0,36,34
1657162608697,MATH 103A,A02,083778,Greenfeld; Be'Eri,5,0,36,31
1657162608697,MATH 103A,A03,093561,Greenfeld; Be'Eri,4,0,36,32
1657162608697,MATH 103A,B01,083779,Greenfeld; Be'Eri,6,0,36,30
1657162608697,MATH 103A,B02,083780,Greenfeld; Be'Eri,3,0,36,33
1657162608697,MATH 103A,B03,093562,Greenfeld; Be'Eri,3,0,36,33
1657162614729,MATH 105,A01,085443,Carter; Anne Toulson,14,0,35,21
1657162614729,MATH 105,A02,093477,Carter; Anne Toulson,20,0,35,15
1657162620753,MATH 109,A01,083213,Ganzberger; Geoffrey Michael,2,0,34,32
1657162620753,MATH 109,A02,083214,Ganzberger; Geoffrey Michael,3,0,34,31
1657162620753,MATH 109,A03,093478,Ganzberger; Geoffrey Michael,1,0,34,33
1657162620753,MATH 109,B01,083215,Ganzberger; Geoffrey Michael,1,0,32,31
1657162620753,MATH 109,B02,083216,Ganzberger; Geoffrey Michael,1,0,32,31
1657162620753,MATH 109,B03,093479,Ganzberger; Geoffrey Michael,6,0,32,26
1657162626793,MATH 142A,A01,083219,Chow; Bennett,6,0,32,26
1657162626793,MATH 142A,A02,083220,Chow; Bennett,10,0,32,22
1657162626793,MATH 142A,A03,093480,Chow; Bennett,7,0,32,25
1657162626793,MATH 142A,B03,093481,Chow; Bennett,8,0,32,24
1657162626793,MATH 142A,B04,093558,Chow; Bennett,11,0,32,21
1657162626793,MATH 142A,B05,093559,Chow; Bennett,6,0,32,26
1657162632821,MATH 193A,A01,083224,Rotar; Vladimir,7,0,34,27
1657162632821,MATH 193A,A02,083225,Rotar; Vladimir,5,0,34,29
1657162632821,MATH 193A,A03,083781,Rotar; Vladimir,1,0,34,33
1657162632821,MATH 193A,A04,083782,Rotar; Vladimir,8,0,34,26
1657162632821,MATH 193A,A05,093482,Rotar; Vladimir,6,0,34,28
1657162638844,MATH 197,001,091859,McAuley; Julian John,9999,0,9999,0
1657162638844,MATH 197,002,095566,Kedlaya; Kiran S.,9997,0,9999,2
1657162638844,MATH 197,003,095567,Xiao; Ming,9999,0,9999,0
1657162638844,MATH 197,004,095571,Perols; Johan Lars,9998,0,9999,1
1657162645898,COGS 9,A01,083615,Shannon; Kyle Michael,7,0,75,68
1657162651923,COGS 11,A01,083617,Boyle; Mary E. T.,22,0,48,26
1657162657950,COGS 13,A01,083071,Bastos; Amalia Pinkusfeld,9,0,71,62
1657162663973,COGS 14A,A01,092681,Semenuks; Arturs,1,1,100,99
1657162670000,COGS 14B,A01,083073,Cheng; Tzu-Han,6,0,63,57
1657162676023,COGS 17,A01,092677,Semenuks; Arturs,4,0,81,77
1657162682052,COGS 100,A01,083619,Allen; Michael Gordon,15,0,70,55
1657162688075,COGS 101A,A01,083621,Davis; Joshua Daniel,9,0,68,59
1657162694097,COGS 101B,A01,091572,Allen; Michael Gordon,9,0,65,56
1657162700120,COGS 101C,A01,083625,Delgado; Tania,17,0,35,18
1657162706153,COGS 107A,A01,083627,Boyle; Mary E. T.,13,0,60,47
1657162712176,COGS 118A,A01,083075,Gupta; Anjum,16,0,76,60
1657162718198,CSE 3,A50,083646,Miranda; Gregory Joseph,24,0,50,26
1657162724224,CSE 8A,A50,083650,Miranda; Gregory Joseph,17,1,56,39
1657162730248,CSE 11,A01,083080,Cao; Yingjun,5,15,40,35
1657162736275,CSE 12,A01,083652,Krause-Levy; Sophia Louisa,24,1,120,96
1657162742306,CSE 15L,A01,083654,Morris; Justin Loren,9,0,50,41
1657162742306,CSE 15L,A02,083655,Morris; Justin Loren,9,0,50,41
1657162748339,CSE 20,A01,083657,Tran; Khoa Dang,38,0,80,42
1657162754373,CSE 21,A01,095574,Bach; Quang Tran,22,0,48,26
1657162760396,CSE 30,A01,083084,Eldon; John,4,0,80,76
1657162760396,CSE 30,B01,095061,Bhaskar; Nishant,7,0,50,43
1657162766423,CSE 100,A01,083659,Cao; Yingjun,4,4,70,66
1657162772446,CSE 134B,A01,083661,Powell; Thomas Allan,20,0,100,80
1657162778472,CSE 140,A01,083663,Gungor; Onat,13,0,85,72
1657162784496,CSE 140L,A01,083088,Eldon; John,17,0,100,83
1657162790521,CSE 175,A01,083665,Kumar; Rakesh,3,0,25,22
1657162796555,CSE 190,A00,092507,Dubnov; Shlomo,7,0,20,13
1657162802578,ECE 45,A01,083139,Congero; Spencer William,5,0,75,70
1657162808607,ECE 65,A50,083695,Saad; Andrew S,12,0,30,18
1657162808607,ECE 65,A51,095125,Saad; Andrew S,25,0,26,1
1657162814628,ECE 109,A01,091882,Touri; Behrouz,18,0,70,52
1657162820654,ECE 180,A00,083140,Abi Samra; Nicholas Camill,1,0,30,29
1657162820654,ECE 180,B00,083141,Abi Samra; Nicholas Camill,0,0,30,30
1657162826682,MATH 10A,A01,083735,Patchell; Gregory David,2,0,30,28
1657162826682,MATH 10A,A02,083736,Patchell; Gregory David,20,0,30,10
1657162826682,MATH 10A,A03,083737,Patchell; Gregory David,16,0,30,14
1657162832706,MATH 10B,A01,083207,Lim; Seonhee,7,0,34,27
1657162832706,MATH 10B,A02,083208,Lim; Seonhee,9,0,35,26
1657162832706,MATH 10B,A03,093472,Lim; Seonhee,5,0,34,29
1657162832706,MATH 10B,B01,083739,Sinha; Shubham,9,0,30,21
1657162838730,MATH 18,A01,083743,Cinel; Cameron Alexander,6,0,30,24
1657162838730,MATH 18,A02,083744,Cinel; Cameron Alexander,15,0,30,15
1657162838730,MATH 18,A03,083745,Cinel; Cameron Alexander,8,0,30,22
1657162838730,MATH 18,B01,083748,Rideout; David Porter,4,0,37,33
1657162838730,MATH 18,B02,083749,Rideout; David Porter,3,0,36,33
1657162838730,MATH 18,B03,083750,Rideout; David Porter,2,0,37,35
1657162838730,MATH 18,B04,083751,Rideout; David Porter,5,0,36,31
1657162838730,MATH 18,B05,093473,Rideout; David Porter,5,0,36,31
1657162838730,MATH 18,B06,093474,Rideout; David Porter,5,0,36,31
1657162844755,MATH 20A,A01,083754,Zheng; Zequn,12,0,40,28
1657162850778,MATH 20B,A01,083756,Briones; Jor-el Thomas Caparas,1,0,36,35
1657162850778,MATH 20B,A02,083757,Briones; Jor-el Thomas Caparas,1,0,36,35
1657162850778,MATH 20B,A03,093475,Briones; Jor-el Thomas Caparas,1,0,36,35
1657162856808,MATH 20C,A01,083760,Briones; Jor-el Thomas Caparas,1,0,35,34
1657162856808,MATH 20C,A02,083761,Briones; Jor-el Thomas Caparas,8,0,35,27
1657162856808,MATH 20C,A03,093476,Briones; Jor-el Thomas Caparas,0,1,36,36
1657162856808,MATH 20C,B01,083762,Bach; Quang Tran,1,0,30,29
1657162862847,MATH 20D,A01,083765,Tran; Brian Kha,4,0,30,26
1657162862847,MATH 20D,A02,083766,Tran; Brian Kha,5,0,30,25
1657162862847,MATH 20D,A03,083767,Tran; Brian Kha,3,0,30,27
1657162868870,MATH 20E,A01,083771,Ganguly; Soumya,7,0,32,25
1657162868870,MATH 20E,A02,083772,Ganguly; Soumya,7,0,32,25
1657162868870,MATH 20E,B01,083773,Ciotti; Benjamin,19,0,35,16
1657162868870,MATH 20E,B02,083774,Ciotti; Benjamin,17,0,35,18
1657162874899,MATH 103A,A01,083777,Greenfeld; Be'Eri,2,0,36,34
1657162874899,MATH 103A,A02,083778,Greenfeld; Be'Eri,5,0,36,31
1657162874899,MATH 103A,A03,093561,Greenfeld; Be'Eri,4,0,36,32
1657162874899,MATH 103A,B01,083779,Greenfeld; Be'Eri,6,0,36,30
1657162874899,MATH 103A,B02,083780,Greenfeld; Be'Eri,3,0,36,33
1657162874899,MATH 103A,B03,093562,Greenfeld; Be'Eri,3,0,36,33
1657162880926,MATH 105,A01,085443,Carter; Anne Toulson,14,0,35,21
1657162880926,MATH 105,A02,093477,Carter; Anne Toulson,20,0,35,15
1657162886951,MATH 109,A01,083213,Ganzberger; Geoffrey Michael,2,0,34,32
1657162886951,MATH 109,A02,083214,Ganzberger; Geoffrey Michael,3,0,34,31
1657162886951,MATH 109,A03,093478,Ganzberger; Geoffrey Michael,1,0,34,33
1657162886951,MATH 109,B01,083215,Ganzberger; Geoffrey Michael,1,0,32,31
1657162886951,MATH 109,B02,083216,Ganzberger; Geoffrey Michael,1,0,32,31
1657162886951,MATH 109,B03,093479,Ganzberger; Geoffrey Michael,6,0,32,26
1657162892983,MATH 142A,A01,083219,Chow; Bennett,6,0,32,26
1657162892983,MATH 142A,A02,083220,Chow; Bennett,10,0,32,22
1657162892983,MATH 142A,A03,093480,Chow; Bennett,7,0,32,25
1657162892983,MATH 142A,B03,093481,Chow; Bennett,8,0,32,24
1657162892983,MATH 142A,B04,093558,Chow; Bennett,11,0,32,21
1657162892983,MATH 142A,B05,093559,Chow; Bennett,6,0,32,26
1657162899013,MATH 193A,A01,083224,Rotar; Vladimir,7,0,34,27
1657162899013,MATH 193A,A02,083225,Rotar; Vladimir,5,0,34,29
1657162899013,MATH 193A,A03,083781,Rotar; Vladimir,1,0,34,33
1657162899013,MATH 193A,A04,083782,Rotar; Vladimir,8,0,34,26
1657162899013,MATH 193A,A05,093482,Rotar; Vladimir,6,0,34,28
1657162905036,MATH 197,001,091859,McAuley; Julian John,9999,0,9999,0
1657162905036,MATH 197,002,095566,Kedlaya; Kiran S.,9997,0,9999,2
1657162905036,MATH 197,003,095567,Xiao; Ming,9999,0,9999,0
1657162905036,MATH 197,004,095571,Perols; Johan Lars,9998,0,9999,1
1657162912100,COGS 9,A01,083615,Shannon; Kyle Michael,7,0,75,68
1657162918127,COGS 11,A01,083617,Boyle; Mary E. T.,22,0,48,26
1657162924156,COGS 13,A01,083071,Bastos; Amalia Pinkusfeld,9,0,71,62
1657162930183,COGS 14A,A01,092681,Semenuks; Arturs,1,1,100,99
1657162936209,COGS 14B,A01,083073,Cheng; Tzu-Han,6,0,63,57
1657162942236,COGS 17,A01,092677,Semenuks; Arturs,4,0,81,77
1657162948356,COGS 100,A01,083619,Allen; Michael Gordon,15,0,70,55
1657162954384,COGS 101A,A01,083621,Davis; Joshua Daniel,9,0,68,59
1657162960409,COGS 101B,A01,091572,Allen; Michael Gordon,9,0,65,56
1657162966433,COGS 101C,A01,083625,Delgado; Tania,17,0,35,18
1657162972460,COGS 107A,A01,083627,Boyle; Mary E. T.,13,0,60,47
1657162978482,COGS 118A,A01,083075,Gupta; Anjum,16,0,76,60
1657162984511,CSE 3,A50,083646,Miranda; Gregory Joseph,24,0,50,26
1657162990538,CSE 8A,A50,083650,Miranda; Gregory Joseph,17,1,56,39
1657162996560,CSE 11,A01,083080,Cao; Yingjun,5,15,40,35
1657163002585,CSE 12,A01,083652,Krause-Levy; Sophia Louisa,24,1,120,96
1657163008607,CSE 15L,A01,083654,Morris; Justin Loren,9,0,50,41
1657163008607,CSE 15L,A02,083655,Morris; Justin Loren,9,0,50,41
1657163014645,CSE 20,A01,083657,Tran; Khoa Dang,38,0,80,42
1657163020669,CSE 21,A01,095574,Bach; Quang Tran,22,0,48,26
1657163026696,CSE 30,A01,083084,Eldon; John,4,0,80,76
1657163026696,CSE 30,B01,095061,Bhaskar; Nishant,7,0,50,43
1657163032719,CSE 100,A01,083659,Cao; Yingjun,4,4,70,66
1657163038743,CSE 134B,A01,083661,Powell; Thomas Allan,20,0,100,80
1657163044766,CSE 140,A01,083663,Gungor; Onat,13,0,85,72
1657163050797,CSE 140L,A01,083088,Eldon; John,17,0,100,83
1657163056821,CSE 175,A01,083665,Kumar; Rakesh,3,0,25,22
1657163062857,CSE 190,A00,092507,Dubnov; Shlomo,7,0,20,13
1657163068881,ECE 45,A01,083139,Congero; Spencer William,5,0,75,70
1657163074904,ECE 65,A50,083695,Saad; Andrew S,12,0,30,18
1657163074904,ECE 65,A51,095125,Saad; Andrew S,25,0,26,1
1657163080927,ECE 109,A01,091882,Touri; Behrouz,18,0,70,52
1657163086953,ECE 180,A00,083140,Abi Samra; Nicholas Camill,1,0,30,29
1657163086953,ECE 180,B00,083141,Abi Samra; Nicholas Camill,0,0,30,30
1657163092984,MATH 10A,A01,083735,Patchell; Gregory David,2,0,30,28
1657163092984,MATH 10A,A02,083736,Patchell; Gregory David,20,0,30,10
1657163092984,MATH 10A,A03,083737,Patchell; Gregory David,16,0,30,14
1657163099012,MATH 10B,A01,083207,Lim; Seonhee,7,0,34,27
1657163099012,MATH 10B,A02,083208,Lim; Seonhee,9,0,35,26
1657163099012,MATH 10B,A03,093472,Lim; Seonhee,5,0,34,29
1657163099012,MATH 10B,B01,083739,Sinha; Shubham,9,0,30,21
1657163105042,MATH 18,A01,083743,Cinel; Cameron Alexander,6,0,30,24
1657163105042,MATH 18,A02,083744,Cinel; Cameron Alexander,15,0,30,15
1657163105042,MATH 18,A03,083745,Cinel; Cameron Alexander,8,0,30,22
1657163105042,MATH 18,B01,083748,Rideout; David Porter,4,0,37,33
1657163105042,MATH 18,B02,083749,Rideout; David Porter,3,0,36,33
1657163105042,MATH 18,B03,083750,Rideout; David Porter,2,0,37,35
1657163105042,MATH 18,B04,083751,Rideout; David Porter,5,0,36,31
1657163105042,MATH 18,B05,093473,Rideout; David Porter,5,0,36,31
1657163105042,MATH 18,B06,093474,Rideout; David Porter,5,0,36,31
1657163111065,MATH 20A,A01,083754,Zheng; Zequn,12,0,40,28
1657163117097,MATH 20B,A01,083756,Briones; Jor-el Thomas Caparas,1,0,36,35
1657163117097,MATH 20B,A02,083757,Briones; Jor-el Thomas Caparas,1,0,36,35
1657163117097,MATH 20B,A03,093475,Briones; Jor-el Thomas Caparas,1,0,36,35
1657163123124,MATH 20C,A01,083760,Briones; Jor-el Thomas Caparas,1,0,35,34
1657163123124,MATH 20C,A02,083761,Briones; Jor-el Thomas Caparas,8,0,35,27
1657163123124,MATH 20C,A03,093476,Briones; Jor-el Thomas Caparas,0,1,36,36
1657163123124,MATH 20C,B01,083762,Bach; Quang Tran,1,0,30,29
1657163129153,MATH 20D,A01,083765,Tran; Brian Kha,4,0,30,26
1657163129153,MATH 20D,A02,083766,Tran; Brian Kha,5,0,30,25
1657163129153,MATH 20D,A03,083767,Tran; Brian Kha,3,0,30,27
1657163135176,MATH 20E,A01,083771,Ganguly; Soumya,7,0,32,25
1657163135176,MATH 20E,A02,083772,Ganguly; Soumya,7,0,32,25
1657163135176,MATH 20E,B01,083773,Ciotti; Benjamin,19,0,35,16
1657163135176,MATH 20E,B02,083774,Ciotti; Benjamin,17,0,35,18
1657163141204,MATH 103A,A01,083777,Greenfeld; Be'Eri,2,0,36,34
1657163141204,MATH 103A,A02,083778,Greenfeld; Be'Eri,5,0,36,31
1657163141204,MATH 103A,A03,093561,Greenfeld; Be'Eri,4,0,36,32
1657163141204,MATH 103A,B01,083779,Greenfeld; Be'Eri,6,0,36,30
1657163141204,MATH 103A,B02,083780,Greenfeld; Be'Eri,3,0,36,33
1657163141204,MATH 103A,B03,093562,Greenfeld; Be'Eri,3,0,36,33
1657163147230,MATH 105,A01,085443,Carter; Anne Toulson,14,0,35,21
1657163147230,MATH 105,A02,093477,Carter; Anne Toulson,20,0,35,15
1657163153252,MATH 109,A01,083213,Ganzberger; Geoffrey Michael,2,0,34,32
1657163153252,MATH 109,A02,083214,Ganzberger; Geoffrey Michael,3,0,34,31
1657163153252,MATH 109,A03,093478,Ganzberger; Geoffrey Michael,1,0,34,33
1657163153252,MATH 109,B01,083215,Ganzberger; Geoffrey Michael,1,0,32,31
1657163153252,MATH 109,B02,083216,Ganzberger; Geoffrey Michael,1,0,32,31
1657163153252,MATH 109,B03,093479,Ganzberger; Geoffrey Michael,6,0,32,26
1657163159274,MATH 142A,A01,083219,Chow; Bennett,6,0,32,26
1657163159274,MATH 142A,A02,083220,Chow; Bennett,10,0,32,22
1657163159274,MATH 142A,A03,093480,Chow; Bennett,7,0,32,25
1657163159274,MATH 142A,B03,093481,Chow; Bennett,8,0,32,24
1657163159274,MATH 142A,B04,093558,Chow; Bennett,11,0,32,21
1657163159274,MATH 142A,B05,093559,Chow; Bennett,6,0,32,26
1657163165301,MATH 193A,A01,083224,Rotar; Vladimir,7,0,34,27
1657163165301,MATH 193A,A02,083225,Rotar; Vladimir,5,0,34,29
1657163165301,MATH 193A,A03,083781,Rotar; Vladimir,1,0,34,33
1657163165301,MATH 193A,A04,083782,Rotar; Vladimir,8,0,34,26
1657163165301,MATH 193A,A05,093482,Rotar; Vladimir,6,0,34,28
1657163171336,MATH 197,001,091859,McAuley; Julian John,9999,0,9999,0
1657163171336,MATH 197,002,095566,Kedlaya; Kiran S.,9997,0,9999,2
1657163171336,MATH 197,003,095567,Xiao; Ming,9999,0,9999,0
1657163171336,MATH 197,004,095571,Perols; Johan Lars,9998,0,9999,1
1657163178393,COGS 9,A01,083615,Shannon; Kyle Michael,7,0,75,68
1657163184415,COGS 11,A01,083617,Boyle; Mary E. T.,22,0,48,26
1657163190438,COGS 13,A01,083071,Bastos; Amalia Pinkusfeld,9,0,71,62
1657163196465,COGS 14A,A01,092681,Semenuks; Arturs,1,1,100,99
1657163202488,COGS 14B,A01,083073,Cheng; Tzu-Han,6,0,63,57
1657163208511,COGS 17,A01,092677,Semenuks; Arturs,4,0,81,77
1657163214548,COGS 100,A01,083619,Allen; Michael Gordon,15,0,70,55
1657163220578,COGS 101A,A01,083621,Davis; Joshua Daniel,9,0,68,59
1657163226601,COGS 101B,A01,091572,Allen; Michael Gordon,9,0,65,56
1657163232624,COGS 101C,A01,083625,Delgado; Tania,17,0,35,18
1657163238650,COGS 107A,A01,083627,Boyle; Mary E. T.,13,0,60,47
1657163244677,COGS 118A,A01,083075,Gupta; Anjum,16,0,76,60
1657163250702,CSE 3,A50,083646,Miranda; Gregory Joseph,24,0,50,26
1657163256725,CSE 8A,A50,083650,Miranda; Gregory Joseph,17,1,56,39
1657163262750,CSE 11,A01,083080,Cao; Yingjun,5,15,40,35
1657163268774,CSE 12,A01,083652,Krause-Levy; Sophia Louisa,24,1,120,96
1657163274798,CSE 15L,A01,083654,Morris; Justin Loren,9,0,50,41
1657163274798,CSE 15L,A02,083655,Morris; Justin Loren,9,0,50,41
1657163280823,CSE 20,A01,083657,Tran; Khoa Dang,38,0,80,42
1657163286845,CSE 21,A01,095574,Bach; Quang Tran,22,0,48,26
1657163292868,CSE 30,A01,083084,Eldon; John,4,0,80,76
1657163292868,CSE 30,B01,095061,Bhaskar; Nishant,7,0,50,43
1657163298889,CSE 100,A01,083659,Cao; Yingjun,4,4,70,66
1657163304912,CSE 134B,A01,083661,Powell; Thomas Allan,20,0,100,80
1657163310935,CSE 140,A01,083663,Gungor; Onat,13,0,85,72
1657163316959,CSE 140L,A01,083088,Eldon; John,17,0,100,83
1657163322987,CSE 175,A01,083665,Kumar; Rakesh,3,0,25,22
1657163329013,CSE 190,A00,092507,Dubnov; Shlomo,7,0,20,13
1657163335039,ECE 45,A01,083139,Congero; Spencer William,5,0,75,70
1657163341063,ECE 65,A50,083695,Saad; Andrew S,12,0,30,18
1657163341063,ECE 65,A51,095125,Saad; Andrew S,25,0,26,1
1657163347086,ECE 109,A01,091882,Touri; Behrouz,18,0,70,52
1657163353111,ECE 180,A00,083140,Abi Samra; Nicholas Camill,1,0,30,29
1657163353111,ECE 180,B00,083141,Abi Samra; Nicholas Camill,0,0,30,30
1657163359134,MATH 10A,A01,083735,Patchell; Gregory David,2,0,30,28
1657163359134,MATH 10A,A02,083736,Patchell; Gregory David,20,0,30,10
1657163359134,MATH 10A,A03,083737,Patchell; Gregory David,16,0,30,14
1657163365163,MATH 10B,A01,083207,Lim; Seonhee,7,0,34,27
1657163365163,MATH 10B,A02,083208,Lim; Seonhee,9,0,35,26
1657163365163,MATH 10B,A03,093472,Lim; Seonhee,5,0,34,29
1657163365163,MATH 10B,B01,083739,Sinha; Shubham,9,0,30,21
1657163371193,MATH 18,A01,083743,Cinel; Cameron Alexander,6,0,30,24
1657163371193,MATH 18,A02,083744,Cinel; Cameron Alexander,15,0,30,15
1657163371193,MATH 18,A03,083745,Cinel; Cameron Alexander,8,0,30,22
1657163371193,MATH 18,B01,083748,Rideout; David Porter,4,0,37,33
1657163371193,MATH 18,B02,083749,Rideout; David Porter,3,0,36,33
1657163371193,MATH 18,B03,083750,Rideout; David Porter,2,0,37,35
1657163371193,MATH 18,B04,083751,Rideout; David Porter,5,0,36,31
1657163371193,MATH 18,B05,093473,Rideout; David Porter,5,0,36,31
1657163371193,MATH 18,B06,093474,Rideout; David Porter,5,0,36,31
1657163377219,MATH 20A,A01,083754,Zheng; Zequn,12,0,40,28
1657163383247,MATH 20B,A01,083756,Briones; Jor-el Thomas Caparas,1,0,36,35
1657163383247,MATH 20B,A02,083757,Briones; Jor-el Thomas Caparas,1,0,36,35
1657163383247,MATH 20B,A03,093475,Briones; Jor-el Thomas Caparas,1,0,36,35
1657163389276,MATH 20C,A01,083760,Briones; Jor-el Thomas Caparas,1,0,35,34
1657163389276,MATH 20C,A02,083761,Briones; Jor-el Thomas Caparas,8,0,35,27
1657163389276,MATH 20C,A03,093476,Briones; Jor-el Thomas Caparas,0,1,36,36
1657163389276,MATH 20C,B01,083762,Bach; Quang Tran,1,0,30,29
1657163395299,MATH 20D,A01,083765,Tran; Brian Kha,4,0,30,26
1657163395299,MATH 20D,A02,083766,Tran; Brian Kha,5,0,30,25
1657163395299,MATH 20D,A03,083767,Tran; Brian Kha,3,0,30,27
1657163401333,MATH 20E,A01,083771,Ganguly; Soumya,7,0,32,25
1657163401333,MATH 20E,A02,083772,Ganguly; Soumya,7,0,32,25
1657163401333,MATH 20E,B01,083773,Ciotti; Benjamin,19,0,35,16
1657163401333,MATH 20E,B02,083774,Ciotti; Benjamin,17,0,35,18
1657163407357,MATH 103A,A01,083777,Greenfeld; Be'Eri,2,0,36,34
1657163407357,MATH 103A,A02,083778,Greenfeld; Be'Eri,5,0,36,31
1657163407357,MATH 103A,A03,093561,Greenfeld; Be'Eri,4,0,36,32
1657163407357,MATH 103A,B01,083779,Greenfeld; Be'Eri,6,0,36,30
1657163407357,MATH 103A,B02,083780,Greenfeld; Be'Eri,3,0,36,33
1657163407357,MATH 103A,B03,093562,Greenfeld; Be'Eri,3,0,36,33
1657163413382,MATH 105,A01,085443,Carter; Anne Toulson,14,0,35,21
1657163413382,MATH 105,A02,093477,Carter; Anne Toulson,20,0,35,15
1657163419411,MATH 109,A01,083213,Ganzberger; Geoffrey Michael,2,0,34,32
1657163419411,MATH 109,A02,083214,Ganzberger; Geoffrey Michael,3,0,34,31
1657163419411,MATH 109,A03,093478,Ganzberger; Geoffrey Michael,1,0,34,33
1657163419411,MATH 109,B01,083215,Ganzberger; Geoffrey Michael,1,0,32,31
1657163419411,MATH 109,B02,083216,Ganzberger; Geoffrey Michael,1,0,32,31
1657163419411,MATH 109,B03,093479,Ganzberger; Geoffrey Michael,6,0,32,26
1657163425447,MATH 142A,A01,083219,Chow; Bennett,6,0,32,26
1657163425447,MATH 142A,A02,083220,Chow; Bennett,10,0,32,22
1657163425447,MATH 142A,A03,093480,Chow; Bennett,7,0,32,25
1657163425447,MATH 142A,B03,093481,Chow; Bennett,8,0,32,24
1657163425447,MATH 142A,B04,093558,Chow; Bennett,11,0,32,21
1657163425447,MATH 142A,B05,093559,Chow; Bennett,6,0,32,26
1657163431471,MATH 193A,A01,083224,Rotar; Vladimir,7,0,34,27
1657163431471,MATH 193A,A02,083225,Rotar; Vladimir,5,0,34,29
1657163431471,MATH 193A,A03,083781,Rotar; Vladimir,1,0,34,33
1657163431471,MATH 193A,A04,083782,Rotar; Vladimir,8,0,34,26
1657163431471,MATH 193A,A05,093482,Rotar; Vladimir,6,0,34,28
1657163437498,MATH 197,001,091859,McAuley; Julian John,9999,0,9999,0
1657163437498,MATH 197,002,095566,Kedlaya; Kiran S.,9997,0,9999,2
1657163437498,MATH 197,003,095567,Xiao; Ming,9999,0,9999,0
1657163437498,MATH 197,004,095571,Perols; Johan Lars,9998,0,9999,1
1657163444553,COGS 9,A01,083615,Shannon; Kyle Michael,7,0,75,68
1657163450581,COGS 11,A01,083617,Boyle; Mary E. T.,22,0,48,26
1657163456604,COGS 13,A01,083071,Bastos; Amalia Pinkusfeld,9,0,71,62
1657163462629,COGS 14A,A01,092681,Semenuks; Arturs,1,1,100,99
1657163468652,COGS 14B,A01,083073,Cheng; Tzu-Han,6,0,63,57
1657163474676,COGS 17,A01,092677,Semenuks; Arturs,4,0,81,77
1657163480701,COGS 100,A01,083619,Allen; Michael Gordon,15,0,70,55
1657163486725,COGS 101A,A01,083621,Davis; Joshua Daniel,9,0,68,59
1657163492750,COGS 101B,A01,091572,Allen; Michael Gordon,9,0,65,56
1657163498776,COGS 101C,A01,083625,Delgado; Tania,17,0,35,18
1657163510371,COGS 107A,A01,083627,Boyle; Mary E. T.,13,0,60,47
1657163516403,COGS 118A,A01,083075,Gupta; Anjum,16,0,76,60
1657163522439,CSE 3,A50,083646,Miranda; Gregory Joseph,24,0,50,26
1657163528468,CSE 8A,A50,083650,Miranda; Gregory Joseph,17,1,56,39
1657163534491,CSE 11,A01,083080,Cao; Yingjun,5,15,40,35
1657163540518,CSE 12,A01,083652,Krause-Levy; Sophia Louisa,24,1,120,96
1657163546545,CSE 15L,A01,083654,Morris; Justin Loren,9,0,50,41
1657163546545,CSE 15L,A02,083655,Morris; Justin Loren,9,0,50,41
1657163552644,CSE 20,A01,083657,Tran; Khoa Dang,38,0,80,42
1657163558676,CSE 21,A01,095574,Bach; Quang Tran,22,0,48,26
1657163564700,CSE 30,A01,083084,Eldon; John,4,0,80,76
1657163564700,CSE 30,B01,095061,Bhaskar; Nishant,7,0,50,43
1657163570727,CSE 100,A01,083659,Cao; Yingjun,4,4,70,66
1657163576751,CSE 134B,A01,083661,Powell; Thomas Allan,20,0,100,80
1657163582778,CSE 140,A01,083663,Gungor; Onat,13,0,85,72
1657163588804,CSE 140L,A01,083088,Eldon; John,17,0,100,83
1657163594826,CSE 175,A01,083665,Kumar; Rakesh,3,0,25,22
1657163600851,CSE 190,A00,092507,Dubnov; Shlomo,7,0,20,13
1657163606878,ECE 45,A01,083139,Congero; Spencer William,5,0,75,70
1657163612901,ECE 65,A50,083695,Saad; Andrew S,12,0,30,18
1657163612901,ECE 65,A51,095125,Saad; Andrew S,25,0,26,1
1657163618928,ECE 109,A01,091882,Touri; Behrouz,18,0,70,52
1657163624950,ECE 180,A00,083140,Abi Samra; Nicholas Camill,1,0,30,29
1657163624950,ECE 180,B00,083141,Abi Samra; Nicholas Camill,0,0,30,30
1657163630973,MATH 10A,A01,083735,Patchell; Gregory David,2,0,30,28
1657163630973,MATH 10A,A02,083736,Patchell; Gregory David,20,0,30,10
1657163630973,MATH 10A,A03,083737,Patchell; Gregory David,16,0,30,14
1657163636996,MATH 10B,A01,083207,Lim; Seonhee,7,0,34,27
1657163636996,MATH 10B,A02,083208,Lim; Seonhee,9,0,35,26
1657163636996,MATH 10B,A03,093472,Lim; Seonhee,5,0,34,29
1657163636996,MATH 10B,B01,083739,Sinha; Shubham,9,0,30,21
1657163643029,MATH 18,A01,083743,Cinel; Cameron Alexander,6,0,30,24
1657163643029,MATH 18,A02,083744,Cinel; Cameron Alexander,15,0,30,15
1657163643029,MATH 18,A03,083745,Cinel; Cameron Alexander,8,0,30,22
1657163643029,MATH 18,B01,083748,Rideout; David Porter,4,0,37,33
1657163643029,MATH 18,B02,083749,Rideout; David Porter,3,0,36,33
1657163643029,MATH 18,B03,083750,Rideout; David Porter,2,0,37,35
1657163643029,MATH 18,B04,083751,Rideout; David Porter,5,0,36,31
1657163643029,MATH 18,B05,093473,Rideout; David Porter,5,0,36,31
1657163643029,MATH 18,B06,093474,Rideout; David Porter,5,0,36,31
1657163649055,MATH 20A,A01,083754,Zheng; Zequn,12,0,40,28
1657163655079,MATH 20B,A01,083756,Briones; Jor-el Thomas Caparas,1,0,36,35
1657163655079,MATH 20B,A02,083757,Briones; Jor-el Thomas Caparas,1,0,36,35
1657163655079,MATH 20B,A03,093475,Briones; Jor-el Thomas Caparas,1,0,36,35
1657163661105,MATH 20C,A01,083760,Briones; Jor-el Thomas Caparas,1,0,35,34
1657163661105,MATH 20C,A02,083761,Briones; Jor-el Thomas Caparas,8,0,35,27
1657163661105,MATH 20C,A03,093476,Briones; Jor-el Thomas Caparas,0,1,36,36
1657163661105,MATH 20C,B01,083762,Bach; Quang Tran,1,0,30,29
1657163667129,MATH 20D,A01,083765,Tran; Brian Kha,4,0,30,26
1657163667129,MATH 20D,A02,083766,Tran; Brian Kha,5,0,30,25
1657163667129,MATH 20D,A03,083767,Tran; Brian Kha,3,0,30,27
1657163673153,MATH 20E,A01,083771,Ganguly; Soumya,7,0,32,25
1657163673153,MATH 20E,A02,083772,Ganguly; Soumya,7,0,32,25
1657163673153,MATH 20E,B01,083773,Ciotti; Benjamin,19,0,35,16
1657163673153,MATH 20E,B02,083774,Ciotti; Benjamin,17,0,35,18
1657163679182,MATH 103A,A01,083777,Greenfeld; Be'Eri,2,0,36,34
1657163679182,MATH 103A,A02,083778,Greenfeld; Be'Eri,5,0,36,31
1657163679182,MATH 103A,A03,093561,Greenfeld; Be'Eri,4,0,36,32
1657163679182,MATH 103A,B01,083779,Greenfeld; Be'Eri,6,0,36,30
1657163679182,MATH 103A,B02,083780,Greenfeld; Be'Eri,3,0,36,33
1657163679182,MATH 103A,B03,093562,Greenfeld; Be'Eri,3,0,36,33
1657163685213,MATH 105,A01,085443,Carter; Anne Toulson,14,0,35,21
1657163685213,MATH 105,A02,093477,Carter; Anne Toulson,20,0,35,15
1657163691236,MATH 109,A01,083213,Ganzberger; Geoffrey Michael,2,0,34,32
1657163691236,MATH 109,A02,083214,Ganzberger; Geoffrey Michael,3,0,34,31
1657163691236,MATH 109,A03,093478,Ganzberger; Geoffrey Michael,1,0,34,33
1657163691236,MATH 109,B01,083215,Ganzberger; Geoffrey Michael,1,0,32,31
1657163691236,MATH 109,B02,083216,Ganzberger; Geoffrey Michael,1,0,32,31
1657163691236,MATH 109,B03,093479,Ganzberger; Geoffrey Michael,6,0,32,26
1657163697261,MATH 142A,A01,083219,Chow; Bennett,6,0,32,26
1657163697261,MATH 142A,A02,083220,Chow; Bennett,10,0,32,22
1657163697261,MATH 142A,A03,093480,Chow; Bennett,7,0,32,25
1657163697261,MATH 142A,B03,093481,Chow; Bennett,8,0,32,24
1657163697261,MATH 142A,B04,093558,Chow; Bennett,11,0,32,21
1657163697261,MATH 142A,B05,093559,Chow; Bennett,6,0,32,26
1657163703285,MATH 193A,A01,083224,Rotar; Vladimir,7,0,34,27
1657163703285,MATH 193A,A02,083225,Rotar; Vladimir,5,0,34,29
1657163703285,MATH 193A,A03,083781,Rotar; Vladimir,1,0,34,33
1657163703285,MATH 193A,A04,083782,Rotar; Vladimir,8,0,34,26
1657163703285,MATH 193A,A05,093482,Rotar; Vladimir,6,0,34,28
1657163709311,MATH 197,001,091859,McAuley; Julian John,9999,0,9999,0
1657163709311,MATH 197,002,095566,Kedlaya; Kiran S.,9997,0,9999,2
1657163709311,MATH 197,003,095567,Xiao; Ming,9999,0,9999,0
1657163709311,MATH 197,004,095571,Perols; Johan Lars,9998,0,9999,1
1657163716380,COGS 9,A01,083615,Shannon; Kyle Michael,7,0,75,68
1657163722403,COGS 11,A01,083617,Boyle; Mary E. T.,22,0,48,26
1657163728434,COGS 13,A01,083071,Bastos; Amalia Pinkusfeld,9,0,71,62
1657163734460,COGS 14A,A01,092681,Semenuks; Arturs,1,1,100,99
1657163740483,COGS 14B,A01,083073,Cheng; Tzu-Han,6,0,63,57
1657163746505,COGS 17,A01,092677,Semenuks; Arturs,4,0,81,77
1657163752532,COGS 100,A01,083619,Allen; Michael Gordon,15,0,70,55
1657163758557,COGS 101A,A01,083621,Davis; Joshua Daniel,9,0,68,59
1657163764583,COGS 101B,A01,091572,Allen; Michael Gordon,9,0,65,56
1657163770605,COGS 101C,A01,083625,Delgado; Tania,17,0,35,18
1657163776630,COGS 107A,A01,083627,Boyle; Mary E. T.,13,0,60,47
1657163782652,COGS 118A,A01,083075,Gupta; Anjum,16,0,76,60
1657163788676,CSE 3,A50,083646,Miranda; Gregory Joseph,24,0,50,26
1657163794704,CSE 8A,A50,083650,Miranda; Gregory Joseph,17,1,56,39
1657163800731,CSE 11,A01,083080,Cao; Yingjun,5,15,40,35
1657163806753,CSE 12,A01,083652,Krause-Levy; Sophia Louisa,24,1,120,96
1657163812776,CSE 15L,A01,083654,Morris; Justin Loren,9,0,50,41
1657163812776,CSE 15L,A02,083655,Morris; Justin Loren,9,0,50,41
1657163818798,CSE 20,A01,083657,Tran; Khoa Dang,38,0,80,42
1657163824821,CSE 21,A01,095574,Bach; Quang Tran,22,0,48,26
1657163830848,CSE 30,A01,083084,Eldon; John,4,0,80,76
1657163830848,CSE 30,B01,095061,Bhaskar; Nishant,7,0,50,43
1657163836876,CSE 100,A01,083659,Cao; Yingjun,4,4,70,66
1657163842903,CSE 134B,A01,083661,Powell; Thomas Allan,20,0,100,80
1657163848929,CSE 140,A01,083663,Gungor; Onat,13,0,85,72
1657163854951,CSE 140L,A01,083088,Eldon; John,17,0,100,83
1657163860974,CSE 175,A01,083665,Kumar; Rakesh,3,0,25,22
1657163866998,CSE 190,A00,092507,Dubnov; Shlomo,7,0,20,13
1657163873022,ECE 45,A01,083139,Congero; Spencer William,5,0,75,70
1657163879044,ECE 65,A50,083695,Saad; Andrew S,12,0,30,18
1657163879044,ECE 65,A51,095125,Saad; Andrew S,25,0,26,1
1657163885069,ECE 109,A01,091882,Touri; Behrouz,18,0,70,52
1657163891095,ECE 180,A00,083140,Abi Samra; Nicholas Camill,1,0,30,29
1657163891095,ECE 180,B00,083141,Abi Samra; Nicholas Camill,0,0,30,30
1657163897118,MATH 10A,A01,083735,Patchell; Gregory David,2,0,30,28
1657163897118,MATH 10A,A02,083736,Patchell; Gregory David,20,0,30,10
1657163897118,MATH 10A,A03,083737,Patchell; Gregory David,16,0,30,14
1657163903144,MATH 10B,A01,083207,Lim; Seonhee,7,0,34,27
1657163903144,MATH 10B,A02,083208,Lim; Seonhee,9,0,35,26
1657163903144,MATH 10B,A03,093472,Lim; Seonhee,5,0,34,29
1657163903144,MATH 10B,B01,083739,Sinha; Shubham,9,0,30,21
1657163909167,MATH 18,A01,083743,Cinel; Cameron Alexander,6,0,30,24
1657163909167,MATH 18,A02,083744,Cinel; Cameron Alexander,15,0,30,15
1657163909167,MATH 18,A03,083745,Cinel; Cameron Alexander,8,0,30,22
1657163909167,MATH 18,B01,083748,Rideout; David Porter,4,0,37,33
1657163909167,MATH 18,B02,083749,Rideout; David Porter,3,0,36,33
1657163909167,MATH 18,B03,083750,Rideout; David Porter,2,0,37,35
1657163909167,MATH 18,B04,083751,Rideout; David Porter,5,0,36,31
1657163909167,MATH 18,B05,093473,Rideout; David Porter,5,0,36,31
1657163909167,MATH 18,B06,093474,Rideout; David Porter,5,0,36,31
1657163915193,MATH 20A,A01,083754,Zheng; Zequn,12,0,40,28
1657163921216,MATH 20B,A01,083756,Briones; Jor-el Thomas Caparas,1,0,36,35
1657163921216,MATH 20B,A02,083757,Briones; Jor-el Thomas Caparas,1,0,36,35
1657163921216,MATH 20B,A03,093475,Briones; Jor-el Thomas Caparas,1,0,36,35
1657163927243,MATH 20C,A01,083760,Briones; Jor-el Thomas Caparas,1,0,35,34
1657163927243,MATH 20C,A02,083761,Briones; Jor-el Thomas Caparas,8,0,35,27
1657163927243,MATH 20C,A03,093476,Briones; Jor-el Thomas Caparas,0,1,36,36
1657163927243,MATH 20C,B01,083762,Bach; Quang Tran,1,0,30,29
1657163933271,MATH 20D,A01,083765,Tran; Brian Kha,4,0,30,26
1657163933271,MATH 20D,A02,083766,Tran; Brian Kha,5,0,30,25
1657163933271,MATH 20D,A03,083767,Tran; Brian Kha,3,0,30,27
1657163939297,MATH 20E,A01,083771,Ganguly; Soumya,7,0,32,25
1657163939297,MATH 20E,A02,083772,Ganguly; Soumya,7,0,32,25
1657163939297,MATH 20E,B01,083773,Ciotti; Benjamin,19,0,35,16
1657163939297,MATH 20E,B02,083774,Ciotti; Benjamin,17,0,35,18
1657163945322,MATH 103A,A01,083777,Greenfeld; Be'Eri,2,0,36,34
1657163945322,MATH 103A,A02,083778,Greenfeld; Be'Eri,5,0,36,31
1657163945322,MATH 103A,A03,093561,Greenfeld; Be'Eri,4,0,36,32
1657163945322,MATH 103A,B01,083779,Greenfeld; Be'Eri,6,0,36,30
1657163945322,MATH 103A,B02,083780,Greenfeld; Be'Eri,3,0,36,33
1657163945322,MATH 103A,B03,093562,Greenfeld; Be'Eri,3,0,36,33
1657163951349,MATH 105,A01,085443,Carter; Anne Toulson,14,0,35,21
1657163951349,MATH 105,A02,093477,Carter; Anne Toulson,20,0,35,15
1657163957377,MATH 109,A01,083213,Ganzberger; Geoffrey Michael,2,0,34,32
1657163957377,MATH 109,A02,083214,Ganzberger; Geoffrey Michael,3,0,34,31
1657163957377,MATH 109,A03,093478,Ganzberger; Geoffrey Michael,1,0,34,33
1657163957377,MATH 109,B01,083215,Ganzberger; Geoffrey Michael,1,0,32,31
1657163957377,MATH 109,B02,083216,Ganzberger; Geoffrey Michael,1,0,32,31
1657163957377,MATH 109,B03,093479,Ganzberger; Geoffrey Michael,6,0,32,26
1657163963402,MATH 142A,A01,083219,Chow; Bennett,6,0,32,26
1657163963402,MATH 142A,A02,083220,Chow; Bennett,10,0,32,22
1657163963402,MATH 142A,A03,093480,Chow; Bennett,7,0,32,25
1657163963402,MATH 142A,B03,093481,Chow; Bennett,8,0,32,24
1657163963402,MATH 142A,B04,093558,Chow; Bennett,11,0,32,21
1657163963402,MATH 142A,B05,093559,Chow; Bennett,6,0,32,26
1657163969431,MATH 193A,A01,083224,Rotar; Vladimir,7,0,34,27
1657163969431,MATH 193A,A02,083225,Rotar; Vladimir,5,0,34,29
1657163969431,MATH 193A,A03,083781,Rotar; Vladimir,1,0,34,33
1657163969431,MATH 193A,A04,083782,Rotar; Vladimir,8,0,34,26
1657163969431,MATH 193A,A05,093482,Rotar; Vladimir,6,0,34,28
1657163975458,MATH 197,001,091859,McAuley; Julian John,9999,0,9999,0
1657163975458,MATH 197,002,095566,Kedlaya; Kiran S.,9997,0,9999,2
1657163975458,MATH 197,003,095567,Xiao; Ming,9999,0,9999,0
1657163975458,MATH 197,004,095571,Perols; Johan Lars,9998,0,9999,1
1657163982524,COGS 9,A01,083615,Shannon; Kyle Michael,7,0,75,68
1657163988548,COGS 11,A01,083617,Boyle; Mary E. T.,22,0,48,26
1657163994574,COGS 13,A01,083071,Bastos; Amalia Pinkusfeld,9,0,71,62
1657164000608,COGS 14A,A01,092681,Semenuks; Arturs,1,1,100,99
1657164006633,COGS 14B,A01,083073,Cheng; Tzu-Han,6,0,63,57
1657164012656,COGS 17,A01,092677,Semenuks; Arturs,4,0,81,77
1657164018683,COGS 100,A01,083619,Allen; Michael Gordon,15,0,70,55
1657164024706,COGS 101A,A01,083621,Davis; Joshua Daniel,9,0,68,59
1657164030730,COGS 101B,A01,091572,Allen; Michael Gordon,9,0,65,56
1657164036753,COGS 101C,A01,083625,Delgado; Tania,17,0,35,18
1657164042777,COGS 107A,A01,083627,Boyle; Mary E. T.,13,0,60,47
1657164048800,COGS 118A,A01,083075,Gupta; Anjum,16,0,76,60
1657164054839,CSE 3,A50,083646,Miranda; Gregory Joseph,24,0,50,26
1657164060872,CSE 8A,A50,083650,Miranda; Gregory Joseph,17,1,56,39
1657164066918,CSE 11,A01,083080,Cao; Yingjun,5,15,40,35
1657164072941,CSE 12,A01,083652,Krause-Levy; Sophia Louisa,24,1,120,96
1657164078965,CSE 15L,A01,083654,Morris; Justin Loren,9,0,50,41
1657164078965,CSE 15L,A02,083655,Morris; Justin Loren,9,0,50,41
1657164084987,CSE 20,A01,083657,Tran; Khoa Dang,38,0,80,42
1657164091021,CSE 21,A01,095574,Bach; Quang Tran,22,0,48,26
1657164097048,CSE 30,A01,083084,Eldon; John,4,0,80,76
1657164097048,CSE 30,B01,095061,Bhaskar; Nishant,7,0,50,43
1657164103076,CSE 100,A01,083659,Cao; Yingjun,4,4,70,66
1657164109098,CSE 134B,A01,083661,Powell; Thomas Allan,20,0,100,80
1657164115122,CSE 140,A01,083663,Gungor; Onat,13,0,85,72
1657164121151,CSE 140L,A01,083088,Eldon; John,17,0,100,83
1657164127174,CSE 175,A01,083665,Kumar; Rakesh,3,0,25,22
1657164133201,CSE 190,A00,092507,Dubnov; Shlomo,7,0,20,13
1657164139223,ECE 45,A01,083139,Congero; Spencer William,5,0,75,70
1657164145247,ECE 65,A50,083695,Saad; Andrew S,12,0,30,18
1657164145247,ECE 65,A51,095125,Saad; Andrew S,25,0,26,1
1657164151366,ECE 109,A01,091882,Touri; Behrouz,18,0,70,52
1657164157392,ECE 180,A00,083140,Abi Samra; Nicholas Camill,1,0,30,29
1657164157392,ECE 180,B00,083141,Abi Samra; Nicholas Camill,0,0,30,30
1657164163418,MATH 10A,A01,083735,Patchell; Gregory David,2,0,30,28
1657164163418,MATH 10A,A02,083736,Patchell; Gregory David,20,0,30,10
1657164163418,MATH 10A,A03,083737,Patchell; Gregory David,16,0,30,14
1657164169442,MATH 10B,A01,083207,Lim; Seonhee,7,0,34,27
1657164169442,MATH 10B,A02,083208,Lim; Seonhee,9,0,35,26
1657164169442,MATH 10B,A03,093472,Lim; Seonhee,5,0,34,29
1657164169442,MATH 10B,B01,083739,Sinha; Shubham,9,0,30,21
1657164175473,MATH 18,A01,083743,Cinel; Cameron Alexander,6,0,30,24
1657164175473,MATH 18,A02,083744,Cinel; Cameron Alexander,15,0,30,15
1657164175473,MATH 18,A03,083745,Cinel; Cameron Alexander,8,0,30,22
1657164175473,MATH 18,B01,083748,Rideout; David Porter,4,0,37,33
1657164175473,MATH 18,B02,083749,Rideout; David Porter,3,0,36,33
1657164175473,MATH 18,B03,083750,Rideout; David Porter,2,0,37,35
1657164175473,MATH 18,B04,083751,Rideout; David Porter,5,0,36,31
1657164175473,MATH 18,B05,093473,Rideout; David Porter,5,0,36,31
1657164175473,MATH 18,B06,093474,Rideout; David Porter,5,0,36,31
1657164181497,MATH 20A,A01,083754,Zheng; Zequn,12,0,40,28
1657164187521,MATH 20B,A01,083756,Briones; Jor-el Thomas Caparas,1,0,36,35
1657164187521,MATH 20B,A02,083757,Briones; Jor-el Thomas Caparas,1,0,36,35
1657164187521,MATH 20B,A03,093475,Briones; Jor-el Thomas Caparas,1,0,36,35
1657164193544,MATH 20C,A01,083760,Briones; Jor-el Thomas Caparas,1,0,35,34
1657164193544,MATH 20C,A02,083761,Briones; Jor-el Thomas Caparas,8,0,35,27
1657164193544,MATH 20C,A03,093476,Briones; Jor-el Thomas Caparas,0,1,36,36
1657164193544,MATH 20C,B01,083762,Bach; Quang Tran,1,0,30,29
1657164199571,MATH 20D,A01,083765,Tran; Brian Kha,4,0,30,26
1657164199571,MATH 20D,A02,083766,Tran; Brian Kha,5,0,30,25
1657164199571,MATH 20D,A03,083767,Tran; Brian Kha,3,0,30,27
1657164205598,MATH 20E,A01,083771,Ganguly; Soumya,7,0,32,25
1657164205598,MATH 20E,A02,083772,Ganguly; Soumya,7,0,32,25
1657164205598,MATH 20E,B01,083773,Ciotti; Benjamin,19,0,35,16
1657164205598,MATH 20E,B02,083774,Ciotti; Benjamin,17,0,35,18
1657164211620,MATH 103A,A01,083777,Greenfeld; Be'Eri,2,0,36,34
1657164211620,MATH 103A,A02,083778,Greenfeld; Be'Eri,5,0,36,31
1657164211620,MATH 103A,A03,093561,Greenfeld; Be'Eri,4,0,36,32
1657164211620,MATH 103A,B01,083779,Greenfeld; Be'Eri,6,0,36,30
1657164211620,MATH 103A,B02,083780,Greenfeld; Be'Eri,3,0,36,33
1657164211620,MATH 103A,B03,093562,Greenfeld; Be'Eri,3,0,36,33
1657164217644,MATH 105,A01,085443,Carter; Anne Toulson,14,0,35,21
1657164217644,MATH 105,A02,093477,Carter; Anne Toulson,20,0,35,15
1657164223672,MATH 109,A01,083213,Ganzberger; Geoffrey Michael,2,0,34,32
1657164223672,MATH 109,A02,083214,Ganzberger; Geoffrey Michael,3,0,34,31
1657164223672,MATH 109,A03,093478,Ganzberger; Geoffrey Michael,1,0,34,33
1657164223672,MATH 109,B01,083215,Ganzberger; Geoffrey Michael,1,0,32,31
1657164223672,MATH 109,B02,083216,Ganzberger; Geoffrey Michael,1,0,32,31
1657164223672,MATH 109,B03,093479,Ganzberger; Geoffrey Michael,6,0,32,26
1657164229696,MATH 142A,A01,083219,Chow; Bennett,6,0,32,26
1657164229696,MATH 142A,A02,083220,Chow; Bennett,10,0,32,22
1657164229696,MATH 142A,A03,093480,Chow; Bennett,7,0,32,25
1657164229696,MATH 142A,B03,093481,Chow; Bennett,8,0,32,24
1657164229696,MATH 142A,B04,093558,Chow; Bennett,11,0,32,21
1657164229696,MATH 142A,B05,093559,Chow; Bennett,6,0,32,26
1657164235719,MATH 193A,A01,083224,Rotar; Vladimir,7,0,34,27
1657164235719,MATH 193A,A02,083225,Rotar; Vladimir,5,0,34,29
1657164235719,MATH 193A,A03,083781,Rotar; Vladimir,1,0,34,33
1657164235719,MATH 193A,A04,083782,Rotar; Vladimir,8,0,34,26
1657164235719,MATH 193A,A05,093482,Rotar; Vladimir,6,0,34,28
1657164241744,MATH 197,001,091859,McAuley; Julian John,9999,0,9999,0
1657164241744,MATH 197,002,095566,Kedlaya; Kiran S.,9997,0,9999,2
1657164241744,MATH 197,003,095567,Xiao; Ming,9999,0,9999,0
1657164241744,MATH 197,004,095571,Perols; Johan Lars,9998,0,9999,1
1657164248794,COGS 9,A01,083615,Shannon; Kyle Michael,7,0,75,68
1657164254822,COGS 11,A01,083617,Boyle; Mary E. T.,22,0,48,26
1657164260845,COGS 13,A01,083071,Bastos; Amalia Pinkusfeld,9,0,71,62
1657164266868,COGS 14A,A01,092681,Semenuks; Arturs,1,1,100,99
1657164272892,COGS 14B,A01,083073,Cheng; Tzu-Han,6,0,63,57
1657164278920,COGS 17,A01,092677,Semenuks; Arturs,4,0,81,77
1657164284944,COGS 100,A01,083619,Allen; Michael Gordon,15,0,70,55
1657164290967,COGS 101A,A01,083621,Davis; Joshua Daniel,9,0,68,59
1657164296991,COGS 101B,A01,091572,Allen; Michael Gordon,9,0,65,56
1657164303017,COGS 101C,A01,083625,Delgado; Tania,17,0,35,18
1657164309041,COGS 107A,A01,083627,Boyle; Mary E. T.,13,0,60,47
1657164315068,COGS 118A,A01,083075,Gupta; Anjum,16,0,76,60
1657164321097,CSE 3,A50,083646,Miranda; Gregory Joseph,24,0,50,26
1657164327121,CSE 8A,A50,083650,Miranda; Gregory Joseph,17,1,56,39
1657164333146,CSE 11,A01,083080,Cao; Yingjun,5,15,40,35
1657164339173,CSE 12,A01,083652,Krause-Levy; Sophia Louisa,24,1,120,96
1657164345200,CSE 15L,A01,083654,Morris; Justin Loren,9,0,50,41
1657164345200,CSE 15L,A02,083655,Morris; Justin Loren,9,0,50,41
1657164351233,CSE 20,A01,083657,Tran; Khoa Dang,38,0,80,42
1657164357257,CSE 21,A01,095574,Bach; Quang Tran,22,0,48,26
1657164363279,CSE 30,A01,083084,Eldon; John,4,0,80,76
1657164363279,CSE 30,B01,095061,Bhaskar; Nishant,7,0,50,43
1657164369307,CSE 100,A01,083659,Cao; Yingjun,4,4,70,66
1657164375330,CSE 134B,A01,083661,Powell; Thomas Allan,20,0,100,80
1657164381352,CSE 140,A01,083663,Gungor; Onat,13,0,85,72
1657164387376,CSE 140L,A01,083088,Eldon; John,17,0,100,83
1657164393403,CSE 175,A01,083665,Kumar; Rakesh,3,0,25,22
1657164399427,CSE 190,A00,092507,Dubnov; Shlomo,7,0,20,13
1657164405458,ECE 45,A01,083139,Congero; Spencer William,5,0,75,70
1657164411484,ECE 65,A50,083695,Saad; Andrew S,12,0,30,18
1657164411484,ECE 65,A51,095125,Saad; Andrew S,25,0,26,1
1657164417508,ECE 109,A01,091882,Touri; Behrouz,18,0,70,52
1657164423535,ECE 180,A00,083140,Abi Samra; Nicholas Camill,1,0,30,29
1657164423535,ECE 180,B00,083141,Abi Samra; Nicholas Camill,0,0,30,30
1657164429558,MATH 10A,A01,083735,Patchell; Gregory David,2,0,30,28
1657164429558,MATH 10A,A02,083736,Patchell; Gregory David,20,0,30,10
1657164429558,MATH 10A,A03,083737,Patchell; Gregory David,16,0,30,14
1657164435584,MATH 10B,A01,083207,Lim; Seonhee,7,0,34,27
1657164435584,MATH 10B,A02,083208,Lim; Seonhee,9,0,35,26
1657164435584,MATH 10B,A03,093472,Lim; Seonhee,5,0,34,29
1657164435584,MATH 10B,B01,083739,Sinha; Shubham,9,0,30,21
1657164441611,MATH 18,A01,083743,Cinel; Cameron Alexander,6,0,30,24
1657164441611,MATH 18,A02,083744,Cinel; Cameron Alexander,15,0,30,15
1657164441611,MATH 18,A03,083745,Cinel; Cameron Alexander,8,0,30,22
1657164441611,MATH 18,B01,083748,Rideout; David Porter,4,0,37,33
1657164441611,MATH 18,B02,083749,Rideout; David Porter,3,0,36,33
1657164441611,MATH 18,B03,083750,Rideout; David Porter,2,0,37,35
1657164441611,MATH 18,B04,083751,Rideout; David Porter,5,0,36,31
1657164441611,MATH 18,B05,093473,Rideout; David Porter,5,0,36,31
1657164441611,MATH 18,B06,093474,Rideout; David Porter,5,0,36,31
1657164447638,MATH 20A,A01,083754,Zheng; Zequn,12,0,40,28
1657164453671,MATH 20B,A01,083756,Briones; Jor-el Thomas Caparas,1,0,36,35
1657164453671,MATH 20B,A02,083757,Briones; Jor-el Thomas Caparas,1,0,36,35
1657164453671,MATH 20B,A03,093475,Briones; Jor-el Thomas Caparas,1,0,36,35
1657164459700,MATH 20C,A01,083760,Briones; Jor-el Thomas Caparas,1,0,35,34
1657164459700,MATH 20C,A02,083761,Briones; Jor-el Thomas Caparas,8,0,35,27
1657164459700,MATH 20C,A03,093476,Briones; Jor-el Thomas Caparas,0,1,36,36
1657164459700,MATH 20C,B01,083762,Bach; Quang Tran,1,0,30,29
1657164465735,MATH 20D,A01,083765,Tran; Brian Kha,4,0,30,26
1657164465735,MATH 20D,A02,083766,Tran; Brian Kha,5,0,30,25
1657164465735,MATH 20D,A03,083767,Tran; Brian Kha,3,0,30,27
1657164471764,MATH 20E,A01,083771,Ganguly; Soumya,7,0,32,25
1657164471764,MATH 20E,A02,083772,Ganguly; Soumya,7,0,32,25
1657164471764,MATH 20E,B01,083773,Ciotti; Benjamin,19,0,35,16
1657164471764,MATH 20E,B02,083774,Ciotti; Benjamin,17,0,35,18
1657164477789,MATH 103A,A01,083777,Greenfeld; Be'Eri,2,0,36,34
1657164477789,MATH 103A,A02,083778,Greenfeld; Be'Eri,5,0,36,31
1657164477789,MATH 103A,A03,093561,Greenfeld; Be'Eri,4,0,36,32
1657164477789,MATH 103A,B01,083779,Greenfeld; Be'Eri,6,0,36,30
1657164477789,MATH 103A,B02,083780,Greenfeld; Be'Eri,3,0,36,33
1657164477789,MATH 103A,B03,093562,Greenfeld; Be'Eri,3,0,36,33
1657164483820,MATH 105,A01,085443,Carter; Anne Toulson,14,0,35,21
1657164483820,MATH 105,A02,093477,Carter; Anne Toulson,20,0,35,15
1657164489842,MATH 109,A01,083213,Ganzberger; Geoffrey Michael,2,0,34,32
1657164489842,MATH 109,A02,083214,Ganzberger; Geoffrey Michael,3,0,34,31
1657164489842,MATH 109,A03,093478,Ganzberger; Geoffrey Michael,1,0,34,33
1657164489842,MATH 109,B01,083215,Ganzberger; Geoffrey Michael,1,0,32,31
1657164489842,MATH 109,B02,083216,Ganzberger; Geoffrey Michael,1,0,32,31
1657164489842,MATH 109,B03,093479,Ganzberger; Geoffrey Michael,6,0,32,26
1657164495873,MATH 142A,A01,083219,Chow; Bennett,6,0,32,26
1657164495873,MATH 142A,A02,083220,Chow; Bennett,10,0,32,22
1657164495873,MATH 142A,A03,093480,Chow; Bennett,7,0,32,25
1657164495873,MATH 142A,B03,093481,Chow; Bennett,8,0,32,24
1657164495873,MATH 142A,B04,093558,Chow; Bennett,11,0,32,21
1657164495873,MATH 142A,B05,093559,Chow; Bennett,6,0,32,26
1657164501901,MATH 193A,A01,083224,Rotar; Vladimir,7,0,34,27
1657164501901,MATH 193A,A02,083225,Rotar; Vladimir,5,0,34,29
1657164501901,MATH 193A,A03,083781,Rotar; Vladimir,1,0,34,33
1657164501901,MATH 193A,A04,083782,Rotar; Vladimir,8,0,34,26
1657164501901,MATH 193A,A05,093482,Rotar; Vladimir,6,0,34,28
1657164507923,MATH 197,001,091859,McAuley; Julian John,9999,0,9999,0
1657164507923,MATH 197,002,095566,Kedlaya; Kiran S.,9997,0,9999,2
1657164507923,MATH 197,003,095567,Xiao; Ming,9999,0,9999,0
1657164507923,MATH 197,004,095571,Perols; Johan Lars,9998,0,9999,1
1657164514974,COGS 9,A01,083615,Shannon; Kyle Michael,7,0,75,68
1657164521002,COGS 11,A01,083617,Boyle; Mary E. T.,22,0,48,26
1657164527025,COGS 13,A01,083071,Bastos; Amalia Pinkusfeld,9,0,71,62
1657164533052,COGS 14A,A01,092681,Semenuks; Arturs,1,1,100,99
1657164539076,COGS 14B,A01,083073,Cheng; Tzu-Han,6,0,63,57
1657164545098,COGS 17,A01,092677,Semenuks; Arturs,4,0,81,77
1657164551136,COGS 100,A01,083619,Allen; Michael Gordon,15,0,70,55
1657164557163,COGS 101A,A01,083621,Davis; Joshua Daniel,9,0,68,59
1657164563190,COGS 101B,A01,091572,Allen; Michael Gordon,9,0,65,56
1657164569218,COGS 101C,A01,083625,Delgado; Tania,17,0,35,18
1657164575242,COGS 107A,A01,083627,Boyle; Mary E. T.,13,0,60,47
1657164581270,COGS 118A,A01,083075,Gupta; Anjum,16,0,76,60
1657164587296,CSE 3,A50,083646,Miranda; Gregory Joseph,24,0,50,26
1657164593319,CSE 8A,A50,083650,Miranda; Gregory Joseph,17,1,56,39
1657164599342,CSE 11,A01,083080,Cao; Yingjun,5,15,40,35
1657164605368,CSE 12,A01,083652,Krause-Levy; Sophia Louisa,24,1,120,96
1657164611397,CSE 15L,A01,083654,Morris; Justin Loren,9,0,50,41
1657164611397,CSE 15L,A02,083655,Morris; Justin Loren,9,0,50,41
1657164617421,CSE 20,A01,083657,Tran; Khoa Dang,38,0,80,42
1657164623444,CSE 21,A01,095574,Bach; Quang Tran,22,0,48,26
1657164629471,CSE 30,A01,083084,Eldon; John,4,0,80,76
1657164629471,CSE 30,B01,095061,Bhaskar; Nishant,7,0,50,43
1657164635494,CSE 100,A01,083659,Cao; Yingjun,4,4,70,66
1657164641519,CSE 134B,A01,083661,Powell; Thomas Allan,20,0,100,80
1657164647545,CSE 140,A01,083663,Gungor; Onat,13,0,85,72
1657164653566,CSE 140L,A01,083088,Eldon; John,17,0,100,83
1657164659590,CSE 175,A01,083665,Kumar; Rakesh,3,0,25,22
1657164665614,CSE 190,A00,092507,Dubnov; Shlomo,7,0,20,13
1657164671637,ECE 45,A01,083139,Congero; Spencer William,5,0,75,70
1657164677667,ECE 65,A50,083695,Saad; Andrew S,12,0,30,18
1657164677667,ECE 65,A51,095125,Saad; Andrew S,25,0,26,1
1657164683691,ECE 109,A01,091882,Touri; Behrouz,18,0,70,52
1657164689720,ECE 180,A00,083140,Abi Samra; Nicholas Camill,1,0,30,29
1657164689720,ECE 180,B00,083141,Abi Samra; Nicholas Camill,0,0,30,30
1657164695744,MATH 10A,A01,083735,Patchell; Gregory David,2,0,30,28
1657164695744,MATH 10A,A02,083736,Patchell; Gregory David,20,0,30,10
1657164695744,MATH 10A,A03,083737,Patchell; Gregory David,16,0,30,14
1657164701773,MATH 10B,A01,083207,Lim; Seonhee,7,0,34,27
1657164701773,MATH 10B,A02,083208,Lim; Seonhee,9,0,35,26
1657164701773,MATH 10B,A03,093472,Lim; Seonhee,5,0,34,29
1657164701773,MATH 10B,B01,083739,Sinha; Shubham,9,0,30,21
1657164707798,MATH 18,A01,083743,Cinel; Cameron Alexander,6,0,30,24
1657164707798,MATH 18,A02,083744,Cinel; Cameron Alexander,15,0,30,15
1657164707798,MATH 18,A03,083745,Cinel; Cameron Alexander,8,0,30,22
1657164707798,MATH 18,B01,083748,Rideout; David Porter,4,0,37,33
1657164707798,MATH 18,B02,083749,Rideout; David Porter,3,0,36,33
1657164707798,MATH 18,B03,083750,Rideout; David Porter,2,0,37,35
1657164707798,MATH 18,B04,083751,Rideout; David Porter,5,0,36,31
1657164707798,MATH 18,B05,093473,Rideout; David Porter,5,0,36,31
1657164707798,MATH 18,B06,093474,Rideout; David Porter,5,0,36,31
1657164713823,MATH 20A,A01,083754,Zheng; Zequn,12,0,40,28
1657164719846,MATH 20B,A01,083756,Briones; Jor-el Thomas Caparas,1,0,36,35
1657164719846,MATH 20B,A02,083757,Briones; Jor-el Thomas Caparas,1,0,36,35
1657164719846,MATH 20B,A03,093475,Briones; Jor-el Thomas Caparas,1,0,36,35
1657164725874,MATH 20C,A01,083760,Briones; Jor-el Thomas Caparas,1,0,35,34
1657164725874,MATH 20C,A02,083761,Briones; Jor-el Thomas Caparas,8,0,35,27
1657164725874,MATH 20C,A03,093476,Briones; Jor-el Thomas Caparas,0,1,36,36
1657164725874,MATH 20C,B01,083762,Bach; Quang Tran,1,0,30,29
1657164731898,MATH 20D,A01,083765,Tran; Brian Kha,4,0,30,26
1657164731898,MATH 20D,A02,083766,Tran; Brian Kha,5,0,30,25
1657164731898,MATH 20D,A03,083767,Tran; Brian Kha,3,0,30,27
1657164737922,MATH 20E,A01,083771,Ganguly; Soumya,7,0,32,25
1657164737922,MATH 20E,A02,083772,Ganguly; Soumya,7,0,32,25
1657164737922,MATH 20E,B01,083773,Ciotti; Benjamin,19,0,35,16
1657164737922,MATH 20E,B02,083774,Ciotti; Benjamin,17,0,35,18
1657164743954,MATH 103A,A01,083777,Greenfeld; Be'Eri,2,0,36,34
1657164743954,MATH 103A,A02,083778,Greenfeld; Be'Eri,5,0,36,31
1657164743954,MATH 103A,A03,093561,Greenfeld; Be'Eri,4,0,36,32
1657164743954,MATH 103A,B01,083779,Greenfeld; Be'Eri,6,0,36,30
1657164743954,MATH 103A,B02,083780,Greenfeld; Be'Eri,3,0,36,33
1657164743954,MATH 103A,B03,093562,Greenfeld; Be'Eri,3,0,36,33
1657164750051,MATH 105,A01,085443,Carter; Anne Toulson,14,0,35,21
1657164750051,MATH 105,A02,093477,Carter; Anne Toulson,20,0,35,15
1657164756085,MATH 109,A01,083213,Ganzberger; Geoffrey Michael,2,0,34,32
1657164756085,MATH 109,A02,083214,Ganzberger; Geoffrey Michael,3,0,34,31
1657164756085,MATH 109,A03,093478,Ganzberger; Geoffrey Michael,1,0,34,33
1657164756085,MATH 109,B01,083215,Ganzberger; Geoffrey Michael,1,0,32,31
1657164756085,MATH 109,B02,083216,Ganzberger; Geoffrey Michael,1,0,32,31
1657164756085,MATH 109,B03,093479,Ganzberger; Geoffrey Michael,6,0,32,26
1657164762116,MATH 142A,A01,083219,Chow; Bennett,6,0,32,26
1657164762116,MATH 142A,A02,083220,Chow; Bennett,10,0,32,22
1657164762116,MATH 142A,A03,093480,Chow; Bennett,7,0,32,25
1657164762116,MATH 142A,B03,093481,Chow; Bennett,8,0,32,24
1657164762116,MATH 142A,B04,093558,Chow; Bennett,11,0,32,21
1657164762116,MATH 142A,B05,093559,Chow; Bennett,6,0,32,26
1657164768139,MATH 193A,A01,083224,Rotar; Vladimir,7,0,34,27
1657164768139,MATH 193A,A02,083225,Rotar; Vladimir,5,0,34,29
1657164768139,MATH 193A,A03,083781,Rotar; Vladimir,1,0,34,33
1657164768139,MATH 193A,A04,083782,Rotar; Vladimir,8,0,34,26
1657164768139,MATH 193A,A05,093482,Rotar; Vladimir,6,0,34,28
1657164774162,MATH 197,001,091859,McAuley; Julian John,9999,0,9999,0
1657164774162,MATH 197,002,095566,Kedlaya; Kiran S.,9997,0,9999,2
1657164774162,MATH 197,003,095567,Xiao; Ming,9999,0,9999,0
1657164774162,MATH 197,004,095571,Perols; Johan Lars,9998,0,9999,1
1657164781227,COGS 9,A01,083615,Shannon; Kyle Michael,7,0,75,68
1657164787258,COGS 11,A01,083617,Boyle; Mary E. T.,22,0,48,26
1657164793281,COGS 13,A01,083071,Bastos; Amalia Pinkusfeld,9,0,71,62
1657164799307,COGS 14A,A01,092681,Semenuks; Arturs,1,1,100,99
1657164805331,COGS 14B,A01,083073,Cheng; Tzu-Han,6,0,63,57
1657164811355,COGS 17,A01,092677,Semenuks; Arturs,4,0,81,77
1657164817381,COGS 100,A01,083619,Allen; Michael Gordon,15,0,70,55
1657164823410,COGS 101A,A01,083621,Davis; Joshua Daniel,9,0,68,59
1657164829436,COGS 101B,A01,091572,Allen; Michael Gordon,9,0,65,56
1657164835459,COGS 101C,A01,083625,Delgado; Tania,17,0,35,18
1657164841483,COGS 107A,A01,083627,Boyle; Mary E. T.,13,0,60,47
1657164847509,COGS 118A,A01,083075,Gupta; Anjum,16,0,76,60
1657164853531,CSE 3,A50,083646,Miranda; Gregory Joseph,24,0,50,26
1657164859554,CSE 8A,A50,083650,Miranda; Gregory Joseph,17,1,56,39
1657164865588,CSE 11,A01,083080,Cao; Yingjun,5,15,40,35
1657164871614,CSE 12,A01,083652,Krause-Levy; Sophia Louisa,24,1,120,96
1657164877638,CSE 15L,A01,083654,Morris; Justin Loren,9,0,50,41
1657164877638,CSE 15L,A02,083655,Morris; Justin Loren,9,0,50,41
1657164883662,CSE 20,A01,083657,Tran; Khoa Dang,38,0,80,42
1657164889691,CSE 21,A01,095574,Bach; Quang Tran,22,0,48,26
1657164895714,CSE 30,A01,083084,Eldon; John,4,0,80,76
1657164895714,CSE 30,B01,095061,Bhaskar; Nishant,7,0,50,43
1657164901736,CSE 100,A01,083659,Cao; Yingjun,4,4,70,66
1657164907759,CSE 134B,A01,083661,Powell; Thomas Allan,20,0,100,80
1657164913782,CSE 140,A01,083663,Gungor; Onat,13,0,85,72
1657164919803,CSE 140L,A01,083088,Eldon; John,17,0,100,83
1657164925842,CSE 175,A01,083665,Kumar; Rakesh,3,0,25,22
1657164931879,CSE 190,A00,092507,Dubnov; Shlomo,7,0,20,13
1657164937905,ECE 45,A01,083139,Congero; Spencer William,5,0,75,70
1657164943932,ECE 65,A50,083695,Saad; Andrew S,12,0,30,18
1657164943932,ECE 65,A51,095125,Saad; Andrew S,25,0,26,1
1657164949961,ECE 109,A01,091882,Touri; Behrouz,18,0,70,52
1657164955988,ECE 180,A00,083140,Abi Samra; Nicholas Camill,1,0,30,29
1657164955988,ECE 180,B00,083141,Abi Samra; Nicholas Camill,0,0,30,30
1657164962013,MATH 10A,A01,083735,Patchell; Gregory David,2,0,30,28
1657164962013,MATH 10A,A02,083736,Patchell; Gregory David,20,0,30,10
1657164962013,MATH 10A,A03,083737,Patchell; Gregory David,16,0,30,14
1657164968038,MATH 10B,A01,083207,Lim; Seonhee,7,0,34,27
1657164968038,MATH 10B,A02,083208,Lim; Seonhee,9,0,35,26
1657164968038,MATH 10B,A03,093472,Lim; Seonhee,5,0,34,29
1657164968038,MATH 10B,B01,083739,Sinha; Shubham,9,0,30,21
1657164974088,MATH 18,A01,083743,Cinel; Cameron Alexander,6,0,30,24
1657164974088,MATH 18,A02,083744,Cinel; Cameron Alexander,15,0,30,15
1657164974088,MATH 18,A03,083745,Cinel; Cameron Alexander,8,0,30,22
1657164974088,MATH 18,B01,083748,Rideout; David Porter,4,0,37,33
1657164974088,MATH 18,B02,083749,Rideout; David Porter,3,0,36,33
1657164974088,MATH 18,B03,083750,Rideout; David Porter,2,0,37,35
1657164974088,MATH 18,B04,083751,Rideout; David Porter,5,0,36,31
1657164974088,MATH 18,B05,093473,Rideout; David Porter,5,0,36,31
1657164974088,MATH 18,B06,093474,Rideout; David Porter,5,0,36,31
1657164980117,MATH 20A,A01,083754,Zheng; Zequn,12,0,40,28
1657164986143,MATH 20B,A01,083756,Briones; Jor-el Thomas Caparas,1,0,36,35
1657164986143,MATH 20B,A02,083757,Briones; Jor-el Thomas Caparas,1,0,36,35
1657164986143,MATH 20B,A03,093475,Briones; Jor-el Thomas Caparas,1,0,36,35
1657164992167,MATH 20C,A01,083760,Briones; Jor-el Thomas Caparas,1,0,35,34
1657164992167,MATH 20C,A02,083761,Briones; Jor-el Thomas Caparas,8,0,35,27
1657164992167,MATH 20C,A03,093476,Briones; Jor-el Thomas Caparas,0,1,36,36
1657164992167,MATH 20C,B01,083762,Bach; Quang Tran,1,0,30,29
1657164998195,MATH 20D,A01,083765,Tran; Brian Kha,4,0,30,26
1657164998195,MATH 20D,A02,083766,Tran; Brian Kha,5,0,30,25
1657164998195,MATH 20D,A03,083767,Tran; Brian Kha,3,0,30,27
1657165004218,MATH 20E,A01,083771,Ganguly; Soumya,7,0,32,25
1657165004218,MATH 20E,A02,083772,Ganguly; Soumya,7,0,32,25
1657165004218,MATH 20E,B01,083773,Ciotti; Benjamin,19,0,35,16
1657165004218,MATH 20E,B02,083774,Ciotti; Benjamin,17,0,35,18
1657165010241,MATH 103A,A01,083777,Greenfeld; Be'Eri,2,0,36,34
1657165010241,MATH 103A,A02,083778,Greenfeld; Be'Eri,5,0,36,31
1657165010241,MATH 103A,A03,093561,Greenfeld; Be'Eri,4,0,36,32
1657165010241,MATH 103A,B01,083779,Greenfeld; Be'Eri,6,0,36,30
1657165010241,MATH 103A,B02,083780,Greenfeld; Be'Eri,3,0,36,33
1657165010241,MATH 103A,B03,093562,Greenfeld; Be'Eri,3,0,36,33
1657165016264,MATH 105,A01,085443,Carter; Anne Toulson,14,0,35,21
1657165016264,MATH 105,A02,093477,Carter; Anne Toulson,20,0,35,15
1657165022306,MATH 109,A01,083213,Ganzberger; Geoffrey Michael,2,0,34,32
1657165022306,MATH 109,A02,083214,Ganzberger; Geoffrey Michael,3,0,34,31
1657165022306,MATH 109,A03,093478,Ganzberger; Geoffrey Michael,1,0,34,33
1657165022306,MATH 109,B01,083215,Ganzberger; Geoffrey Michael,1,0,32,31
1657165022306,MATH 109,B02,083216,Ganzberger; Geoffrey Michael,1,0,32,31
1657165022306,MATH 109,B03,093479,Ganzberger; Geoffrey Michael,6,0,32,26
1657165028336,MATH 142A,A01,083219,Chow; Bennett,6,0,32,26
1657165028336,MATH 142A,A02,083220,Chow; Bennett,10,0,32,22
1657165028336,MATH 142A,A03,093480,Chow; Bennett,7,0,32,25
1657165028336,MATH 142A,B03,093481,Chow; Bennett,8,0,32,24
1657165028336,MATH 142A,B04,093558,Chow; Bennett,11,0,32,21
1657165028336,MATH 142A,B05,093559,Chow; Bennett,6,0,32,26
1657165034362,MATH 193A,A01,083224,Rotar; Vladimir,7,0,34,27
1657165034362,MATH 193A,A02,083225,Rotar; Vladimir,5,0,34,29
1657165034362,MATH 193A,A03,083781,Rotar; Vladimir,1,0,34,33
1657165034362,MATH 193A,A04,083782,Rotar; Vladimir,8,0,34,26
1657165034362,MATH 193A,A05,093482,Rotar; Vladimir,6,0,34,28
1657165040386,MATH 197,001,091859,McAuley; Julian John,9999,0,9999,0
1657165040386,MATH 197,002,095566,Kedlaya; Kiran S.,9997,0,9999,2
1657165040386,MATH 197,003,095567,Xiao; Ming,9999,0,9999,0
1657165040386,MATH 197,004,095571,Perols; Johan Lars,9998,0,9999,1
1657165047437,COGS 9,A01,083615,Shannon; Kyle Michael,7,0,75,68
1657165053460,COGS 11,A01,083617,Boyle; Mary E. T.,22,0,48,26
1657165059488,COGS 13,A01,083071,Bastos; Amalia Pinkusfeld,9,0,71,62
1657165065510,COGS 14A,A01,092681,Semenuks; Arturs,1,1,100,99
1657165071538,COGS 14B,A01,083073,Cheng; Tzu-Han,6,0,63,57
1657165077562,COGS 17,A01,092677,Semenuks; Arturs,4,0,81,77
1657165083586,COGS 100,A01,083619,Allen; Michael Gordon,15,0,70,55
1657165089613,COGS 101A,A01,083621,Davis; Joshua Daniel,9,0,68,59
1657165095639,COGS 101B,A01,091572,Allen; Michael Gordon,9,0,65,56
1657165101666,COGS 101C,A01,083625,Delgado; Tania,17,0,35,18
1657165107690,COGS 107A,A01,083627,Boyle; Mary E. T.,13,0,60,47
1657165113715,COGS 118A,A01,083075,Gupta; Anjum,16,0,76,60
1657165119746,CSE 3,A50,083646,Miranda; Gregory Joseph,24,0,50,26
1657165125774,CSE 8A,A50,083650,Miranda; Gregory Joseph,17,1,56,39
1657165131797,CSE 11,A01,083080,Cao; Yingjun,5,15,40,35
1657165137829,CSE 12,A01,083652,Krause-Levy; Sophia Louisa,24,1,120,96
1657165143851,CSE 15L,A01,083654,Morris; Justin Loren,9,0,50,41
1657165143851,CSE 15L,A02,083655,Morris; Justin Loren,9,0,50,41
1657165149874,CSE 20,A01,083657,Tran; Khoa Dang,38,0,80,42
1657165155898,CSE 21,A01,095574,Bach; Quang Tran,22,0,48,26
1657165161930,CSE 30,A01,083084,Eldon; John,4,0,80,76
1657165161930,CSE 30,B01,095061,Bhaskar; Nishant,7,0,50,43
1657165167952,CSE 100,A01,083659,Cao; Yingjun,4,4,70,66
1657165173978,CSE 134B,A01,083661,Powell; Thomas Allan,20,0,100,80
1657165180005,CSE 140,A01,083663,Gungor; Onat,13,0,85,72
1657165186028,CSE 140L,A01,083088,Eldon; John,17,0,100,83
1657165192052,CSE 175,A01,083665,Kumar; Rakesh,3,0,25,22
1657165198076,CSE 190,A00,092507,Dubnov; Shlomo,7,0,20,13
1657165204099,ECE 45,A01,083139,Congero; Spencer William,5,0,75,70
1657165210122,ECE 65,A50,083695,Saad; Andrew S,12,0,30,18
1657165210122,ECE 65,A51,095125,Saad; Andrew S,25,0,26,1
1657165216144,ECE 109,A01,091882,Touri; Behrouz,18,0,70,52
1657165222172,ECE 180,A00,083140,Abi Samra; Nicholas Camill,1,0,30,29
1657165222172,ECE 180,B00,083141,Abi Samra; Nicholas Camill,0,0,30,30
1657165228195,MATH 10A,A01,083735,Patchell; Gregory David,2,0,30,28
1657165228195,MATH 10A,A02,083736,Patchell; Gregory David,20,0,30,10
1657165228195,MATH 10A,A03,083737,Patchell; Gregory David,16,0,30,14
1657165234219,MATH 10B,A01,083207,Lim; Seonhee,7,0,34,27
1657165234219,MATH 10B,A02,083208,Lim; Seonhee,9,0,35,26
1657165234219,MATH 10B,A03,093472,Lim; Seonhee,5,0,34,29
1657165234219,MATH 10B,B01,083739,Sinha; Shubham,9,0,30,21
1657165240245,MATH 18,A01,083743,Cinel; Cameron Alexander,6,0,30,24
1657165240245,MATH 18,A02,083744,Cinel; Cameron Alexander,15,0,30,15
1657165240245,MATH 18,A03,083745,Cinel; Cameron Alexander,8,0,30,22
1657165240245,MATH 18,B01,083748,Rideout; David Porter,4,0,37,33
1657165240245,MATH 18,B02,083749,Rideout; David Porter,3,0,36,33
1657165240245,MATH 18,B03,083750,Rideout; David Porter,2,0,37,35
1657165240245,MATH 18,B04,083751,Rideout; David Porter,5,0,36,31
1657165240245,MATH 18,B05,093473,Rideout; David Porter,5,0,36,31
1657165240245,MATH 18,B06,093474,Rideout; David Porter,5,0,36,31
1657165246268,MATH 20A,A01,083754,Zheng; Zequn,12,0,40,28
1657165252296,MATH 20B,A01,083756,Briones; Jor-el Thomas Caparas,1,0,36,35
1657165252296,MATH 20B,A02,083757,Briones; Jor-el Thomas Caparas,1,0,36,35
1657165252296,MATH 20B,A03,093475,Briones; Jor-el Thomas Caparas,1,0,36,35
1657165258319,MATH 20C,A01,083760,Briones; Jor-el Thomas Caparas,1,0,35,34
1657165258319,MATH 20C,A02,083761,Briones; Jor-el Thomas Caparas,8,0,35,27
1657165258319,MATH 20C,A03,093476,Briones; Jor-el Thomas Caparas,0,1,36,36
1657165258319,MATH 20C,B01,083762,Bach; Quang Tran,1,0,30,29
1657165264344,MATH 20D,A01,083765,Tran; Brian Kha,4,0,30,26
1657165264344,MATH 20D,A02,083766,Tran; Brian Kha,5,0,30,25
1657165264344,MATH 20D,A03,083767,Tran; Brian Kha,3,0,30,27
1657165270367,MATH 20E,A01,083771,Ganguly; Soumya,7,0,32,25
1657165270367,MATH 20E,A02,083772,Ganguly; Soumya,7,0,32,25
1657165270367,MATH 20E,B01,083773,Ciotti; Benjamin,19,0,35,16
1657165270367,MATH 20E,B02,083774,Ciotti; Benjamin,17,0,35,18
1657165276390,MATH 103A,A01,083777,Greenfeld; Be'Eri,2,0,36,34
1657165276390,MATH 103A,A02,083778,Greenfeld; Be'Eri,5,0,36,31
1657165276390,MATH 103A,A03,093561,Greenfeld; Be'Eri,4,0,36,32
1657165276390,MATH 103A,B01,083779,Greenfeld; Be'Eri,6,0,36,30
1657165276390,MATH 103A,B02,083780,Greenfeld; Be'Eri,3,0,36,33
1657165276390,MATH 103A,B03,093562,Greenfeld; Be'Eri,3,0,36,33
1657165282424,MATH 105,A01,085443,Carter; Anne Toulson,14,0,35,21
1657165282424,MATH 105,A02,093477,Carter; Anne Toulson,20,0,35,15
1657165288451,MATH 109,A01,083213,Ganzberger; Geoffrey Michael,2,0,34,32
1657165288451,MATH 109,A02,083214,Ganzberger; Geoffrey Michael,3,0,34,31
1657165288451,MATH 109,A03,093478,Ganzberger; Geoffrey Michael,1,0,34,33
1657165288451,MATH 109,B01,083215,Ganzberger; Geoffrey Michael,1,0,32,31
1657165288451,MATH 109,B02,083216,Ganzberger; Geoffrey Michael,1,0,32,31
1657165288451,MATH 109,B03,093479,Ganzberger; Geoffrey Michael,6,0,32,26
1657165294475,MATH 142A,A01,083219,Chow; Bennett,6,0,32,26
1657165294475,MATH 142A,A02,083220,Chow; Bennett,10,0,32,22
1657165294475,MATH 142A,A03,093480,Chow; Bennett,7,0,32,25
1657165294475,MATH 142A,B03,093481,Chow; Bennett,8,0,32,24
1657165294475,MATH 142A,B04,093558,Chow; Bennett,11,0,32,21
1657165294475,MATH 142A,B05,093559,Chow; Bennett,6,0,32,26
1657165300500,MATH 193A,A01,083224,Rotar; Vladimir,7,0,34,27
1657165300500,MATH 193A,A02,083225,Rotar; Vladimir,5,0,34,29
1657165300500,MATH 193A,A03,083781,Rotar; Vladimir,1,0,34,33
1657165300500,MATH 193A,A04,083782,Rotar; Vladimir,8,0,34,26
1657165300500,MATH 193A,A05,093482,Rotar; Vladimir,6,0,34,28
1657165306524,MATH 197,001,091859,McAuley; Julian John,9999,0,9999,0
1657165306524,MATH 197,002,095566,Kedlaya; Kiran S.,9997,0,9999,2
1657165306524,MATH 197,003,095567,Xiao; Ming,9999,0,9999,0
1657165306524,MATH 197,004,095571,Perols; Johan Lars,9998,0,9999,1
1657165313588,COGS 9,A01,083615,Shannon; Kyle Michael,7,0,75,68
1657165319616,COGS 11,A01,083617,Boyle; Mary E. T.,22,0,48,26
1657165325639,COGS 13,A01,083071,Bastos; Amalia Pinkusfeld,9,0,71,62
1657165331662,COGS 14A,A01,092681,Semenuks; Arturs,1,1,100,99
1657165337684,COGS 14B,A01,083073,Cheng; Tzu-Han,6,0,63,57
1657165343781,COGS 17,A01,092677,Semenuks; Arturs,4,0,81,77
1657165349810,COGS 100,A01,083619,Allen; Michael Gordon,15,0,70,55
1657165355832,COGS 101A,A01,083621,Davis; Joshua Daniel,9,0,68,59
1657165361862,COGS 101B,A01,091572,Allen; Michael Gordon,9,0,65,56
1657165367890,COGS 101C,A01,083625,Delgado; Tania,17,0,35,18
1657165373914,COGS 107A,A01,083627,Boyle; Mary E. T.,13,0,60,47
1657165379937,COGS 118A,A01,083075,Gupta; Anjum,16,0,76,60
1657165385964,CSE 3,A50,083646,Miranda; Gregory Joseph,24,0,50,26
1657165391986,CSE 8A,A50,083650,Miranda; Gregory Joseph,17,1,56,39
1657165398010,CSE 11,A01,083080,Cao; Yingjun,5,15,40,35
1657165404041,CSE 12,A01,083652,Krause-Levy; Sophia Louisa,24,1,120,96
1657165410067,CSE 15L,A01,083654,Morris; Justin Loren,9,0,50,41
1657165410067,CSE 15L,A02,083655,Morris; Justin Loren,9,0,50,41
1657165416090,CSE 20,A01,083657,Tran; Khoa Dang,38,0,80,42
1657165422111,CSE 21,A01,095574,Bach; Quang Tran,22,0,48,26
1657165428139,CSE 30,A01,083084,Eldon; John,4,0,80,76
1657165428139,CSE 30,B01,095061,Bhaskar; Nishant,7,0,50,43
1657165434162,CSE 100,A01,083659,Cao; Yingjun,4,4,70,66
1657165440186,CSE 134B,A01,083661,Powell; Thomas Allan,20,0,100,80
1657165446219,CSE 140,A01,083663,Gungor; Onat,13,0,85,72
1657165452248,CSE 140L,A01,083088,Eldon; John,17,0,100,83
1657165458271,CSE 175,A01,083665,Kumar; Rakesh,3,0,25,22
1657165464295,CSE 190,A00,092507,Dubnov; Shlomo,7,0,20,13
1657165470327,ECE 45,A01,083139,Congero; Spencer William,5,0,75,70
1657165476354,ECE 65,A50,083695,Saad; Andrew S,12,0,30,18
1657165476354,ECE 65,A51,095125,Saad; Andrew S,25,0,26,1
1657165482378,ECE 109,A01,091882,Touri; Behrouz,18,0,70,52
1657165488406,ECE 180,A00,083140,Abi Samra; Nicholas Camill,1,0,30,29
1657165488406,ECE 180,B00,083141,Abi Samra; Nicholas Camill,0,0,30,30
1657165494432,MATH 10A,A01,083735,Patchell; Gregory David,2,0,30,28
1657165494432,MATH 10A,A02,083736,Patchell; Gregory David,20,0,30,10
1657165494432,MATH 10A,A03,083737,Patchell; Gregory David,16,0,30,14
1657165500456,MATH 10B,A01,083207,Lim; Seonhee,7,0,34,27
1657165500456,MATH 10B,A02,083208,Lim; Seonhee,9,0,35,26
1657165500456,MATH 10B,A03,093472,Lim; Seonhee,5,0,34,29
1657165500456,MATH 10B,B01,083739,Sinha; Shubham,9,0,30,21
1657165506480,MATH 18,A01,083743,Cinel; Cameron Alexander,6,0,30,24
1657165506480,MATH 18,A02,083744,Cinel; Cameron Alexander,15,0,30,15
1657165506480,MATH 18,A03,083745,Cinel; Cameron Alexander,8,0,30,22
1657165506480,MATH 18,B01,083748,Rideout; David Porter,4,0,37,33
1657165506480,MATH 18,B02,083749,Rideout; David Porter,3,0,36,33
1657165506480,MATH 18,B03,083750,Rideout; David Porter,2,0,37,35
1657165506480,MATH 18,B04,083751,Rideout; David Porter,5,0,36,31
1657165506480,MATH 18,B05,093473,Rideout; David Porter,5,0,36,31
1657165506480,MATH 18,B06,093474,Rideout; David Porter,5,0,36,31
1657165512503,MATH 20A,A01,083754,Zheng; Zequn,12,0,40,28
1657165518530,MATH 20B,A01,083756,Briones; Jor-el Thomas Caparas,1,0,36,35
1657165518530,MATH 20B,A02,083757,Briones; Jor-el Thomas Caparas,1,0,36,35
1657165518530,MATH 20B,A03,093475,Briones; Jor-el Thomas Caparas,1,0,36,35
1657165524553,MATH 20C,A01,083760,Briones; Jor-el Thomas Caparas,1,0,35,34
1657165524553,MATH 20C,A02,083761,Briones; Jor-el Thomas Caparas,8,0,35,27
1657165524553,MATH 20C,A03,093476,Briones; Jor-el Thomas Caparas,0,1,36,36
1657165524553,MATH 20C,B01,083762,Bach; Quang Tran,1,0,30,29
1657165530578,MATH 20D,A01,083765,Tran; Brian Kha,4,0,30,26
1657165530578,MATH 20D,A02,083766,Tran; Brian Kha,5,0,30,25
1657165530578,MATH 20D,A03,083767,Tran; Brian Kha,3,0,30,27
1657165536605,MATH 20E,A01,083771,Ganguly; Soumya,7,0,32,25
1657165536605,MATH 20E,A02,083772,Ganguly; Soumya,7,0,32,25
1657165536605,MATH 20E,B01,083773,Ciotti; Benjamin,19,0,35,16
1657165536605,MATH 20E,B02,083774,Ciotti; Benjamin,17,0,35,18
1657165542634,MATH 103A,A01,083777,Greenfeld; Be'Eri,2,0,36,34
1657165542634,MATH 103A,A02,083778,Greenfeld; Be'Eri,5,0,36,31
1657165542634,MATH 103A,A03,093561,Greenfeld; Be'Eri,4,0,36,32
1657165542634,MATH 103A,B01,083779,Greenfeld; Be'Eri,6,0,36,30
1657165542634,MATH 103A,B02,083780,Greenfeld; Be'Eri,3,0,36,33
1657165542634,MATH 103A,B03,093562,Greenfeld; Be'Eri,3,0,36,33
1657165548659,MATH 105,A01,085443,Carter; Anne Toulson,14,0,35,21
1657165548659,MATH 105,A02,093477,Carter; Anne Toulson,20,0,35,15
1657165554688,MATH 109,A01,083213,Ganzberger; Geoffrey Michael,2,0,34,32
1657165554688,MATH 109,A02,083214,Ganzberger; Geoffrey Michael,3,0,34,31
1657165554688,MATH 109,A03,093478,Ganzberger; Geoffrey Michael,1,0,34,33
1657165554688,MATH 109,B01,083215,Ganzberger; Geoffrey Michael,1,0,32,31
1657165554688,MATH 109,B02,083216,Ganzberger; Geoffrey Michael,1,0,32,31
1657165554688,MATH 109,B03,093479,Ganzberger; Geoffrey Michael,6,0,32,26
1657165560710,MATH 142A,A01,083219,Chow; Bennett,6,0,32,26
1657165560710,MATH 142A,A02,083220,Chow; Bennett,10,0,32,22
1657165560710,MATH 142A,A03,093480,Chow; Bennett,7,0,32,25
1657165560710,MATH 142A,B03,093481,Chow; Bennett,8,0,32,24
1657165560710,MATH 142A,B04,093558,Chow; Bennett,11,0,32,21
1657165560710,MATH 142A,B05,093559,Chow; Bennett,6,0,32,26
1657165566738,MATH 193A,A01,083224,Rotar; Vladimir,7,0,34,27
1657165566738,MATH 193A,A02,083225,Rotar; Vladimir,5,0,34,29
1657165566738,MATH 193A,A03,083781,Rotar; Vladimir,1,0,34,33
1657165566738,MATH 193A,A04,083782,Rotar; Vladimir,8,0,34,26
1657165566738,MATH 193A,A05,093482,Rotar; Vladimir,6,0,34,28
1657165572759,MATH 197,001,091859,McAuley; Julian John,9999,0,9999,0
1657165572759,MATH 197,002,095566,Kedlaya; Kiran S.,9997,0,9999,2
1657165572759,MATH 197,003,095567,Xiao; Ming,9999,0,9999,0
1657165572759,MATH 197,004,095571,Perols; Johan Lars,9998,0,9999,1
1657165579809,COGS 9,A01,083615,Shannon; Kyle Michael,7,0,75,68
1657165585836,COGS 11,A01,083617,Boyle; Mary E. T.,22,0,48,26
1657165591859,COGS 13,A01,083071,Bastos; Amalia Pinkusfeld,9,0,71,62
1657165597885,COGS 14A,A01,092681,Semenuks; Arturs,1,1,100,99
1657165603911,COGS 14B,A01,083073,Cheng; Tzu-Han,6,0,63,57
1657165609934,COGS 17,A01,092677,Semenuks; Arturs,4,0,81,77
1657165615957,COGS 100,A01,083619,Allen; Michael Gordon,15,0,70,55
1657165621984,COGS 101A,A01,083621,Davis; Joshua Daniel,9,0,68,59
1657165628007,COGS 101B,A01,091572,Allen; Michael Gordon,9,0,65,56
1657165634036,COGS 101C,A01,083625,Delgado; Tania,17,0,35,18
1657165640065,COGS 107A,A01,083627,Boyle; Mary E. T.,13,0,60,47
1657165646091,COGS 118A,A01,083075,Gupta; Anjum,16,0,76,60
1657165652121,CSE 3,A50,083646,Miranda; Gregory Joseph,24,0,50,26
1657165658153,CSE 8A,A50,083650,Miranda; Gregory Joseph,17,1,56,39
1657165664184,CSE 11,A01,083080,Cao; Yingjun,5,15,40,35
1657165670211,CSE 12,A01,083652,Krause-Levy; Sophia Louisa,24,1,120,96
1657165676234,CSE 15L,A01,083654,Morris; Justin Loren,9,0,50,41
1657165676234,CSE 15L,A02,083655,Morris; Justin Loren,9,0,50,41
1657165682260,CSE 20,A01,083657,Tran; Khoa Dang,38,0,80,42
1657165688282,CSE 21,A01,095574,Bach; Quang Tran,22,0,48,26
1657165694305,CSE 30,A01,083084,Eldon; John,4,0,80,76
1657165694305,CSE 30,B01,095061,Bhaskar; Nishant,7,0,50,43
1657165700328,CSE 100,A01,083659,Cao; Yingjun,4,4,70,66
1657165706363,CSE 134B,A01,083661,Powell; Thomas Allan,20,0,100,80
1657165712385,CSE 140,A01,083663,Gungor; Onat,13,0,85,72
1657165718412,CSE 140L,A01,083088,Eldon; John,17,0,100,83
1657165724437,CSE 175,A01,083665,Kumar; Rakesh,3,0,25,22
1657165730463,CSE 190,A00,092507,Dubnov; Shlomo,7,0,20,13
1657165736487,ECE 45,A01,083139,Congero; Spencer William,5,0,75,70
1657165742522,ECE 65,A50,083695,Saad; Andrew S,12,0,30,18
1657165742522,ECE 65,A51,095125,Saad; Andrew S,25,0,26,1
1657165748552,ECE 109,A01,091882,Touri; Behrouz,18,0,70,52
1657165754576,ECE 180,A00,083140,Abi Samra; Nicholas Camill,1,0,30,29
1657165754576,ECE 180,B00,083141,Abi Samra; Nicholas Camill,0,0,30,30
1657165760600,MATH 10A,A01,083735,Patchell; Gregory David,2,0,30,28
1657165760600,MATH 10A,A02,083736,Patchell; Gregory David,20,0,30,10
1657165760600,MATH 10A,A03,083737,Patchell; Gregory David,16,0,30,14
1657165766628,MATH 10B,A01,083207,Lim; Seonhee,7,0,34,27
1657165766628,MATH 10B,A02,083208,Lim; Seonhee,9,0,35,26
1657165766628,MATH 10B,A03,093472,Lim; Seonhee,5,0,34,29
1657165766628,MATH 10B,B01,083739,Sinha; Shubham,9,0,30,21
1657165772661,MATH 18,A01,083743,Cinel; Cameron Alexander,6,0,30,24
1657165772661,MATH 18,A02,083744,Cinel; Cameron Alexander,15,0,30,15
1657165772661,MATH 18,A03,083745,Cinel; Cameron Alexander,8,0,30,22
1657165772661,MATH 18,B01,083748,Rideout; David Porter,4,0,37,33
1657165772661,MATH 18,B02,083749,Rideout; David Porter,3,0,36,33
1657165772661,MATH 18,B03,083750,Rideout; David Porter,2,0,37,35
1657165772661,MATH 18,B04,083751,Rideout; David Porter,5,0,36,31
1657165772661,MATH 18,B05,093473,Rideout; David Porter,5,0,36,31
1657165772661,MATH 18,B06,093474,Rideout; David Porter,5,0,36,31
1657165778684,MATH 20A,A01,083754,Zheng; Zequn,12,0,40,28
1657165784714,MATH 20B,A01,083756,Briones; Jor-el Thomas Caparas,1,0,36,35
1657165784714,MATH 20B,A02,083757,Briones; Jor-el Thomas Caparas,1,0,36,35
1657165784714,MATH 20B,A03,093475,Briones; Jor-el Thomas Caparas,1,0,36,35
1657165790743,MATH 20C,A01,083760,Briones; Jor-el Thomas Caparas,1,0,35,34
1657165790743,MATH 20C,A02,083761,Briones; Jor-el Thomas Caparas,8,0,35,27
1657165790743,MATH 20C,A03,093476,Briones; Jor-el Thomas Caparas,0,1,36,36
1657165790743,MATH 20C,B01,083762,Bach; Quang Tran,1,0,30,29
1657165796765,MATH 20D,A01,083765,Tran; Brian Kha,4,0,30,26
1657165796765,MATH 20D,A02,083766,Tran; Brian Kha,5,0,30,25
1657165796765,MATH 20D,A03,083767,Tran; Brian Kha,3,0,30,27
1657165802790,MATH 20E,A01,083771,Ganguly; Soumya,7,0,32,25
1657165802790,MATH 20E,A02,083772,Ganguly; Soumya,7,0,32,25
1657165802790,MATH 20E,B01,083773,Ciotti; Benjamin,19,0,35,16
1657165802790,MATH 20E,B02,083774,Ciotti; Benjamin,17,0,35,18
1657165808818,MATH 103A,A01,083777,Greenfeld; Be'Eri,2,0,36,34
1657165808818,MATH 103A,A02,083778,Greenfeld; Be'Eri,5,0,36,31
1657165808818,MATH 103A,A03,093561,Greenfeld; Be'Eri,4,0,36,32
1657165808818,MATH 103A,B01,083779,Greenfeld; Be'Eri,6,0,36,30
1657165808818,MATH 103A,B02,083780,Greenfeld; Be'Eri,3,0,36,33
1657165808818,MATH 103A,B03,093562,Greenfeld; Be'Eri,3,0,36,33
1657165814847,MATH 105,A01,085443,Carter; Anne Toulson,14,0,35,21
1657165814847,MATH 105,A02,093477,Carter; Anne Toulson,20,0,35,15
1657165820871,MATH 109,A01,083213,Ganzberger; Geoffrey Michael,2,0,34,32
1657165820871,MATH 109,A02,083214,Ganzberger; Geoffrey Michael,3,0,34,31
1657165820871,MATH 109,A03,093478,Ganzberger; Geoffrey Michael,1,0,34,33
1657165820871,MATH 109,B01,083215,Ganzberger; Geoffrey Michael,1,0,32,31
1657165820871,MATH 109,B02,083216,Ganzberger; Geoffrey Michael,1,0,32,31
1657165820871,MATH 109,B03,093479,Ganzberger; Geoffrey Michael,6,0,32,26
1657165826896,MATH 142A,A01,083219,Chow; Bennett,6,0,32,26
1657165826896,MATH 142A,A02,083220,Chow; Bennett,10,0,32,22
1657165826896,MATH 142A,A03,093480,Chow; Bennett,7,0,32,25
1657165826896,MATH 142A,B03,093481,Chow; Bennett,8,0,32,24
1657165826896,MATH 142A,B04,093558,Chow; Bennett,11,0,32,21
1657165826896,MATH 142A,B05,093559,Chow; Bennett,6,0,32,26
1657165832932,MATH 193A,A01,083224,Rotar; Vladimir,7,0,34,27
1657165832932,MATH 193A,A02,083225,Rotar; Vladimir,5,0,34,29
1657165832932,MATH 193A,A03,083781,Rotar; Vladimir,1,0,34,33
1657165832932,MATH 193A,A04,083782,Rotar; Vladimir,8,0,34,26
1657165832932,MATH 193A,A05,093482,Rotar; Vladimir,6,0,34,28
1657165838956,MATH 197,001,091859,McAuley; Julian John,9999,0,9999,0
1657165838956,MATH 197,002,095566,Kedlaya; Kiran S.,9997,0,9999,2
1657165838956,MATH 197,003,095567,Xiao; Ming,9999,0,9999,0
1657165838956,MATH 197,004,095571,Perols; Johan Lars,9998,0,9999,1
1657165846020,COGS 9,A01,083615,Shannon; Kyle Michael,7,0,75,68
1657165852044,COGS 11,A01,083617,Boyle; Mary E. T.,22,0,48,26
1657165858067,COGS 13,A01,083071,Bastos; Amalia Pinkusfeld,9,0,71,62
1657165864089,COGS 14A,A01,092681,Semenuks; Arturs,1,1,100,99
1657165870112,COGS 14B,A01,083073,Cheng; Tzu-Han,6,0,63,57
1657165876135,COGS 17,A01,092677,Semenuks; Arturs,4,0,81,77
1657165882157,COGS 100,A01,083619,Allen; Michael Gordon,15,0,70,55
1657165888183,COGS 101A,A01,083621,Davis; Joshua Daniel,9,0,68,59
1657165894215,COGS 101B,A01,091572,Allen; Michael Gordon,9,0,65,56
1657165900241,COGS 101C,A01,083625,Delgado; Tania,17,0,35,18
1657165906265,COGS 107A,A01,083627,Boyle; Mary E. T.,13,0,60,47
1657165912291,COGS 118A,A01,083075,Gupta; Anjum,16,0,76,60
1657165918319,CSE 3,A50,083646,Miranda; Gregory Joseph,24,0,50,26
1657165924348,CSE 8A,A50,083650,Miranda; Gregory Joseph,17,1,56,39
1657165930374,CSE 11,A01,083080,Cao; Yingjun,5,15,40,35
1657165936398,CSE 12,A01,083652,Krause-Levy; Sophia Louisa,24,1,120,96
1657165942494,CSE 15L,A01,083654,Morris; Justin Loren,9,0,50,41
1657165942494,CSE 15L,A02,083655,Morris; Justin Loren,9,0,50,41
1657165948521,CSE 20,A01,083657,Tran; Khoa Dang,38,0,80,42
1657165954545,CSE 21,A01,095574,Bach; Quang Tran,22,0,48,26
1657165960583,CSE 30,A01,083084,Eldon; John,4,0,80,76
1657165960583,CSE 30,B01,095061,Bhaskar; Nishant,7,0,50,43
1657165966611,CSE 100,A01,083659,Cao; Yingjun,4,4,70,66
1657165972636,CSE 134B,A01,083661,Powell; Thomas Allan,20,0,100,80
1657165978660,CSE 140,A01,083663,Gungor; Onat,13,0,85,72
1657165984694,CSE 140L,A01,083088,Eldon; John,17,0,100,83
1657165990729,CSE 175,A01,083665,Kumar; Rakesh,3,0,25,22
1657165996752,CSE 190,A00,092507,Dubnov; Shlomo,7,0,20,13
1657166002773,ECE 45,A01,083139,Congero; Spencer William,5,0,75,70
1657166008794,ECE 65,A50,083695,Saad; Andrew S,12,0,30,18
1657166008794,ECE 65,A51,095125,Saad; Andrew S,25,0,26,1
1657166014820,ECE 109,A01,091882,Touri; Behrouz,18,0,70,52
1657166020843,ECE 180,A00,083140,Abi Samra; Nicholas Camill,1,0,30,29
1657166020843,ECE 180,B00,083141,Abi Samra; Nicholas Camill,0,0,30,30
1657166026865,MATH 10A,A01,083735,Patchell; Gregory David,2,0,30,28
1657166026865,MATH 10A,A02,083736,Patchell; Gregory David,20,0,30,10
1657166026865,MATH 10A,A03,083737,Patchell; Gregory David,16,0,30,14
1657166032890,MATH 10B,A01,083207,Lim; Seonhee,7,0,34,27
1657166032890,MATH 10B,A02,083208,Lim; Seonhee,9,0,35,26
1657166032890,MATH 10B,A03,093472,Lim; Seonhee,5,0,34,29
1657166032890,MATH 10B,B01,083739,Sinha; Shubham,9,0,30,21
1657166038914,MATH 18,A01,083743,Cinel; Cameron Alexander,6,0,30,24
1657166038914,MATH 18,A02,083744,Cinel; Cameron Alexander,15,0,30,15
1657166038914,MATH 18,A03,083745,Cinel; Cameron Alexander,8,0,30,22
1657166038914,MATH 18,B01,083748,Rideout; David Porter,4,0,37,33
1657166038914,MATH 18,B02,083749,Rideout; David Porter,4,0,36,32
1657166038914,MATH 18,B03,083750,Rideout; David Porter,2,0,37,35
1657166038914,MATH 18,B04,083751,Rideout; David Porter,5,0,36,31
1657166038914,MATH 18,B05,093473,Rideout; David Porter,5,0,36,31
1657166038914,MATH 18,B06,093474,Rideout; David Porter,5,0,36,31
1657166044937,MATH 20A,A01,083754,Zheng; Zequn,12,0,40,28
1657166050965,MATH 20B,A01,083756,Briones; Jor-el Thomas Caparas,1,0,36,35
1657166050965,MATH 20B,A02,083757,Briones; Jor-el Thomas Caparas,1,0,36,35
1657166050965,MATH 20B,A03,093475,Briones; Jor-el Thomas Caparas,1,0,36,35
1657166056994,MATH 20C,A01,083760,Briones; Jor-el Thomas Caparas,1,0,35,34
1657166056994,MATH 20C,A02,083761,Briones; Jor-el Thomas Caparas,8,0,35,27
1657166056994,MATH 20C,A03,093476,Briones; Jor-el Thomas Caparas,0,1,36,36
1657166056994,MATH 20C,B01,083762,Bach; Quang Tran,1,0,30,29
1657166063019,MATH 20D,A01,083765,Tran; Brian Kha,4,0,30,26
1657166063019,MATH 20D,A02,083766,Tran; Brian Kha,5,0,30,25
1657166063019,MATH 20D,A03,083767,Tran; Brian Kha,3,0,30,27
1657166069042,MATH 20E,A01,083771,Ganguly; Soumya,7,0,32,25
1657166069042,MATH 20E,A02,083772,Ganguly; Soumya,7,0,32,25
1657166069042,MATH 20E,B01,083773,Ciotti; Benjamin,19,0,35,16
1657166069042,MATH 20E,B02,083774,Ciotti; Benjamin,17,0,35,18
1657166075067,MATH 103A,A01,083777,Greenfeld; Be'Eri,2,0,36,34
1657166075067,MATH 103A,A02,083778,Greenfeld; Be'Eri,5,0,36,31
1657166075067,MATH 103A,A03,093561,Greenfeld; Be'Eri,4,0,36,32
1657166075067,MATH 103A,B01,083779,Greenfeld; Be'Eri,6,0,36,30
1657166075067,MATH 103A,B02,083780,Greenfeld; Be'Eri,3,0,36,33
1657166075067,MATH 103A,B03,093562,Greenfeld; Be'Eri,3,0,36,33
1657166081091,MATH 105,A01,085443,Carter; Anne Toulson,14,0,35,21
1657166081091,MATH 105,A02,093477,Carter; Anne Toulson,20,0,35,15
1657166087115,MATH 109,A01,083213,Ganzberger; Geoffrey Michael,2,0,34,32
1657166087115,MATH 109,A02,083214,Ganzberger; Geoffrey Michael,3,0,34,31
1657166087115,MATH 109,A03,093478,Ganzberger; Geoffrey Michael,1,0,34,33
1657166087115,MATH 109,B01,083215,Ganzberger; Geoffrey Michael,1,0,32,31
1657166087115,MATH 109,B02,083216,Ganzberger; Geoffrey Michael,1,0,32,31
1657166087115,MATH 109,B03,093479,Ganzberger; Geoffrey Michael,6,0,32,26
1657166093152,MATH 142A,A01,083219,Chow; Bennett,6,0,32,26
1657166093152,MATH 142A,A02,083220,Chow; Bennett,10,0,32,22
1657166093152,MATH 142A,A03,093480,Chow; Bennett,7,0,32,25
1657166093152,MATH 142A,B03,093481,Chow; Bennett,8,0,32,24
1657166093152,MATH 142A,B04,093558,Chow; Bennett,11,0,32,21
1657166093152,MATH 142A,B05,093559,Chow; Bennett,6,0,32,26
1657166099176,MATH 193A,A01,083224,Rotar; Vladimir,7,0,34,27
1657166099176,MATH 193A,A02,083225,Rotar; Vladimir,5,0,34,29
1657166099176,MATH 193A,A03,083781,Rotar; Vladimir,1,0,34,33
1657166099176,MATH 193A,A04,083782,Rotar; Vladimir,8,0,34,26
1657166099176,MATH 193A,A05,093482,Rotar; Vladimir,6,0,34,28
1657166105202,MATH 197,001,091859,McAuley; Julian John,9999,0,9999,0
1657166105202,MATH 197,002,095566,Kedlaya; Kiran S.,9997,0,9999,2
1657166105202,MATH 197,003,095567,Xiao; Ming,9999,0,9999,0
1657166105202,MATH 197,004,095571,Perols; Johan Lars,9998,0,9999,1
1657166112267,COGS 9,A01,083615,Shannon; Kyle Michael,7,0,75,68
1657166118291,COGS 11,A01,083617,Boyle; Mary E. T.,22,0,48,26
1657166124322,COGS 13,A01,083071,Bastos; Amalia Pinkusfeld,9,0,71,62
1657166130345,COGS 14A,A01,092681,Semenuks; Arturs,1,1,100,99
1657166136411,COGS 14B,A01,083073,Cheng; Tzu-Han,6,0,63,57
1657166142438,COGS 17,A01,092677,Semenuks; Arturs,4,0,81,77
1657166148462,COGS 100,A01,083619,Allen; Michael Gordon,15,0,70,55
1657166154486,COGS 101A,A01,083621,Davis; Joshua Daniel,9,0,68,59
1657166160517,COGS 101B,A01,091572,Allen; Michael Gordon,9,0,65,56
1657166166544,COGS 101C,A01,083625,Delgado; Tania,17,0,35,18
1657166172567,COGS 107A,A01,083627,Boyle; Mary E. T.,13,0,60,47
1657166178591,COGS 118A,A01,083075,Gupta; Anjum,16,0,76,60
1657166184619,CSE 3,A50,083646,Miranda; Gregory Joseph,24,0,50,26
1657166190644,CSE 8A,A50,083650,Miranda; Gregory Joseph,17,1,56,39
1657166196666,CSE 11,A01,083080,Cao; Yingjun,5,15,40,35
1657166202691,CSE 12,A01,083652,Krause-Levy; Sophia Louisa,24,1,120,96
1657166208720,CSE 15L,A01,083654,Morris; Justin Loren,9,0,50,41
1657166208720,CSE 15L,A02,083655,Morris; Justin Loren,9,0,50,41
1657166214744,CSE 20,A01,083657,Tran; Khoa Dang,38,0,80,42
1657166220768,CSE 21,A01,095574,Bach; Quang Tran,22,0,48,26
1657166226797,CSE 30,A01,083084,Eldon; John,4,0,80,76
1657166226797,CSE 30,B01,095061,Bhaskar; Nishant,7,0,50,43
1657166232821,CSE 100,A01,083659,Cao; Yingjun,4,4,70,66
1657166238846,CSE 134B,A01,083661,Powell; Thomas Allan,20,0,100,80
1657166244902,CSE 140,A01,083663,Gungor; Onat,13,0,85,72
1657166250926,CSE 140L,A01,083088,Eldon; John,17,0,100,83
1657166256953,CSE 175,A01,083665,Kumar; Rakesh,3,0,25,22
1657166262979,CSE 190,A00,092507,Dubnov; Shlomo,7,0,20,13
1657166269004,ECE 45,A01,083139,Congero; Spencer William,5,0,75,70
1657166275028,ECE 65,A50,083695,Saad; Andrew S,12,0,30,18
1657166275028,ECE 65,A51,095125,Saad; Andrew S,25,0,26,1
1657166281056,ECE 109,A01,091882,Touri; Behrouz,18,0,70,52
1657166287093,ECE 180,A00,083140,Abi Samra; Nicholas Camill,1,0,30,29
1657166287093,ECE 180,B00,083141,Abi Samra; Nicholas Camill,0,0,30,30
1657166293121,MATH 10A,A01,083735,Patchell; Gregory David,2,0,30,28
1657166293121,MATH 10A,A02,083736,Patchell; Gregory David,20,0,30,10
1657166293121,MATH 10A,A03,083737,Patchell; Gregory David,16,0,30,14
1657166299146,MATH 10B,A01,083207,Lim; Seonhee,7,0,34,27
1657166299146,MATH 10B,A02,083208,Lim; Seonhee,9,0,35,26
1657166299146,MATH 10B,A03,093472,Lim; Seonhee,5,0,34,29
1657166299146,MATH 10B,B01,083739,Sinha; Shubham,9,0,30,21
1657166305171,MATH 18,A01,083743,Cinel; Cameron Alexander,6,0,30,24
1657166305171,MATH 18,A02,083744,Cinel; Cameron Alexander,15,0,30,15
1657166305171,MATH 18,A03,083745,Cinel; Cameron Alexander,8,0,30,22
1657166305171,MATH 18,B01,083748,Rideout; David Porter,4,0,37,33
1657166305171,MATH 18,B02,083749,Rideout; David Porter,4,0,36,32
1657166305171,MATH 18,B03,083750,Rideout; David Porter,2,0,37,35
1657166305171,MATH 18,B04,083751,Rideout; David Porter,5,0,36,31
1657166305171,MATH 18,B05,093473,Rideout; David Porter,5,0,36,31
1657166305171,MATH 18,B06,093474,Rideout; David Porter,5,0,36,31
1657166311210,MATH 20A,A01,083754,Zheng; Zequn,12,0,40,28
1657166317232,MATH 20B,A01,083756,Briones; Jor-el Thomas Caparas,1,0,36,35
1657166317232,MATH 20B,A02,083757,Briones; Jor-el Thomas Caparas,1,0,36,35
1657166317232,MATH 20B,A03,093475,Briones; Jor-el Thomas Caparas,1,0,36,35
1657166323262,MATH 20C,A01,083760,Briones; Jor-el Thomas Caparas,1,0,35,34
1657166323262,MATH 20C,A02,083761,Briones; Jor-el Thomas Caparas,8,0,35,27
1657166323262,MATH 20C,A03,093476,Briones; Jor-el Thomas Caparas,0,1,36,36
1657166323262,MATH 20C,B01,083762,Bach; Quang Tran,1,0,30,29
1657166329284,MATH 20D,A01,083765,Tran; Brian Kha,4,0,30,26
1657166329284,MATH 20D,A02,083766,Tran; Brian Kha,5,0,30,25
1657166329284,MATH 20D,A03,083767,Tran; Brian Kha,3,0,30,27
1657166335313,MATH 20E,A01,083771,Ganguly; Soumya,7,0,32,25
1657166335313,MATH 20E,A02,083772,Ganguly; Soumya,7,0,32,25
1657166335313,MATH 20E,B01,083773,Ciotti; Benjamin,19,0,35,16
1657166335313,MATH 20E,B02,083774,Ciotti; Benjamin,17,0,35,18
1657166341344,MATH 103A,A01,083777,Greenfeld; Be'Eri,2,0,36,34
1657166341344,MATH 103A,A02,083778,Greenfeld; Be'Eri,5,0,36,31
1657166341344,MATH 103A,A03,093561,Greenfeld; Be'Eri,4,0,36,32
1657166341344,MATH 103A,B01,083779,Greenfeld; Be'Eri,6,0,36,30
1657166341344,MATH 103A,B02,083780,Greenfeld; Be'Eri,3,0,36,33
1657166341344,MATH 103A,B03,093562,Greenfeld; Be'Eri,3,0,36,33
1657166347370,MATH 105,A01,085443,Carter; Anne Toulson,14,0,35,21
1657166347370,MATH 105,A02,093477,Carter; Anne Toulson,20,0,35,15
1657166353393,MATH 109,A01,083213,Ganzberger; Geoffrey Michael,2,0,34,32
1657166353393,MATH 109,A02,083214,Ganzberger; Geoffrey Michael,3,0,34,31
1657166353393,MATH 109,A03,093478,Ganzberger; Geoffrey Michael,1,0,34,33
1657166353393,MATH 109,B01,083215,Ganzberger; Geoffrey Michael,1,0,32,31
1657166353393,MATH 109,B02,083216,Ganzberger; Geoffrey Michael,1,0,32,31
1657166353393,MATH 109,B03,093479,Ganzberger; Geoffrey Michael,6,0,32,26
1657166359418,MATH 142A,A01,083219,Chow; Bennett,6,0,32,26
1657166359418,MATH 142A,A02,083220,Chow; Bennett,10,0,32,22
1657166359418,MATH 142A,A03,093480,Chow; Bennett,7,0,32,25
1657166359418,MATH 142A,B03,093481,Chow; Bennett,8,0,32,24
1657166359418,MATH 142A,B04,093558,Chow; Bennett,11,0,32,21
1657166359418,MATH 142A,B05,093559,Chow; Bennett,6,0,32,26
1657166365442,MATH 193A,A01,083224,Rotar; Vladimir,7,0,34,27
1657166365442,MATH 193A,A02,083225,Rotar; Vladimir,5,0,34,29
1657166365442,MATH 193A,A03,083781,Rotar; Vladimir,1,0,34,33
1657166365442,MATH 193A,A04,083782,Rotar; Vladimir,8,0,34,26
1657166365442,MATH 193A,A05,093482,Rotar; Vladimir,6,0,34,28
1657166371467,MATH 197,001,091859,McAuley; Julian John,9999,0,9999,0
1657166371467,MATH 197,002,095566,Kedlaya; Kiran S.,9997,0,9999,2
1657166371467,MATH 197,003,095567,Xiao; Ming,9999,0,9999,0
1657166371467,MATH 197,004,095571,Perols; Johan Lars,9998,0,9999,1
1657166378530,COGS 9,A01,083615,Shannon; Kyle Michael,7,0,75,68
1657166384554,COGS 11,A01,083617,Boyle; Mary E. T.,22,0,48,26
1657166390581,COGS 13,A01,083071,Bastos; Amalia Pinkusfeld,9,0,71,62
1657166396604,COGS 14A,A01,092681,Semenuks; Arturs,1,1,100,99
1657166402626,COGS 14B,A01,083073,Cheng; Tzu-Han,6,0,63,57
1657166408653,COGS 17,A01,092677,Semenuks; Arturs,4,0,81,77
1657166414675,COGS 100,A01,083619,Allen; Michael Gordon,15,0,70,55
1657166420710,COGS 101A,A01,083621,Davis; Joshua Daniel,9,0,68,59
1657166426733,COGS 101B,A01,091572,Allen; Michael Gordon,9,0,65,56
1657166432763,COGS 101C,A01,083625,Delgado; Tania,17,0,35,18
1657166438791,COGS 107A,A01,083627,Boyle; Mary E. T.,13,0,60,47
1657166444817,COGS 118A,A01,083075,Gupta; Anjum,16,0,76,60
1657166450842,CSE 3,A50,083646,Miranda; Gregory Joseph,24,0,50,26
1657166456864,CSE 8A,A50,083650,Miranda; Gregory Joseph,17,1,56,39
1657166462888,CSE 11,A01,083080,Cao; Yingjun,5,15,40,35
1657166468914,CSE 12,A01,083652,Krause-Levy; Sophia Louisa,24,1,120,96
1657166474937,CSE 15L,A01,083654,Morris; Justin Loren,9,0,50,41
1657166474937,CSE 15L,A02,083655,Morris; Justin Loren,9,0,50,41
1657166480976,CSE 20,A01,083657,Tran; Khoa Dang,38,0,80,42
1657166487002,CSE 21,A01,095574,Bach; Quang Tran,22,0,48,26
1657166493028,CSE 30,A01,083084,Eldon; John,4,0,80,76
1657166493028,CSE 30,B01,095061,Bhaskar; Nishant,7,0,50,43
1657166499071,CSE 100,A01,083659,Cao; Yingjun,4,4,70,66
1657166505096,CSE 134B,A01,083661,Powell; Thomas Allan,20,0,100,80
1657166511121,CSE 140,A01,083663,Gungor; Onat,13,0,85,72
1657166517147,CSE 140L,A01,083088,Eldon; John,17,0,100,83
1657166523174,CSE 175,A01,083665,Kumar; Rakesh,3,0,25,22
1657166529198,CSE 190,A00,092507,Dubnov; Shlomo,7,0,20,13
1657166535229,ECE 45,A01,083139,Congero; Spencer William,5,0,75,70
1657166541352,ECE 65,A50,083695,Saad; Andrew S,12,0,30,18
1657166541352,ECE 65,A51,095125,Saad; Andrew S,25,0,26,1
1657166547374,ECE 109,A01,091882,Touri; Behrouz,18,0,70,52
1657166553406,ECE 180,A00,083140,Abi Samra; Nicholas Camill,1,0,30,29
1657166553406,ECE 180,B00,083141,Abi Samra; Nicholas Camill,0,0,30,30
1657166559430,MATH 10A,A01,083735,Patchell; Gregory David,2,0,30,28
1657166559430,MATH 10A,A02,083736,Patchell; Gregory David,20,0,30,10
1657166559430,MATH 10A,A03,083737,Patchell; Gregory David,16,0,30,14
1657166565460,MATH 10B,A01,083207,Lim; Seonhee,7,0,34,27
1657166565460,MATH 10B,A02,083208,Lim; Seonhee,9,0,35,26
1657166565460,MATH 10B,A03,093472,Lim; Seonhee,5,0,34,29
1657166565460,MATH 10B,B01,083739,Sinha; Shubham,9,0,30,21
1657166571491,MATH 18,A01,083743,Cinel; Cameron Alexander,6,0,30,24
1657166571491,MATH 18,A02,083744,Cinel; Cameron Alexander,15,0,30,15
1657166571491,MATH 18,A03,083745,Cinel; Cameron Alexander,8,0,30,22
1657166571491,MATH 18,B01,083748,Rideout; David Porter,4,0,37,33
1657166571491,MATH 18,B02,083749,Rideout; David Porter,4,0,36,32
1657166571491,MATH 18,B03,083750,Rideout; David Porter,2,0,37,35
1657166571491,MATH 18,B04,083751,Rideout; David Porter,5,0,36,31
1657166571491,MATH 18,B05,093473,Rideout; David Porter,5,0,36,31
1657166571491,MATH 18,B06,093474,Rideout; David Porter,5,0,36,31
1657166577515,MATH 20A,A01,083754,Zheng; Zequn,12,0,40,28
1657166583540,MATH 20B,A01,083756,Briones; Jor-el Thomas Caparas,1,0,36,35
1657166583540,MATH 20B,A02,083757,Briones; Jor-el Thomas Caparas,1,0,36,35
1657166583540,MATH 20B,A03,093475,Briones; Jor-el Thomas Caparas,1,0,36,35
1657166589579,MATH 20C,A01,083760,Briones; Jor-el Thomas Caparas,1,0,35,34
1657166589579,MATH 20C,A02,083761,Briones; Jor-el Thomas Caparas,8,0,35,27
1657166589579,MATH 20C,A03,093476,Briones; Jor-el Thomas Caparas,0,1,36,36
1657166589579,MATH 20C,B01,083762,Bach; Quang Tran,1,0,30,29
1657166595608,MATH 20D,A01,083765,Tran; Brian Kha,4,0,30,26
1657166595608,MATH 20D,A02,083766,Tran; Brian Kha,5,0,30,25
1657166595608,MATH 20D,A03,083767,Tran; Brian Kha,3,0,30,27
1657166601634,MATH 20E,A01,083771,Ganguly; Soumya,7,0,32,25
1657166601634,MATH 20E,A02,083772,Ganguly; Soumya,7,0,32,25
1657166601634,MATH 20E,B01,083773,Ciotti; Benjamin,19,0,35,16
1657166601634,MATH 20E,B02,083774,Ciotti; Benjamin,17,0,35,18
1657166607671,MATH 103A,A01,083777,Greenfeld; Be'Eri,2,0,36,34
1657166607671,MATH 103A,A02,083778,Greenfeld; Be'Eri,5,0,36,31
1657166607671,MATH 103A,A03,093561,Greenfeld; Be'Eri,4,0,36,32
1657166607671,MATH 103A,B01,083779,Greenfeld; Be'Eri,6,0,36,30
1657166607671,MATH 103A,B02,083780,Greenfeld; Be'Eri,3,0,36,33
1657166607671,MATH 103A,B03,093562,Greenfeld; Be'Eri,3,0,36,33
1657166613695,MATH 105,A01,085443,Carter; Anne Toulson,14,0,35,21
1657166613695,MATH 105,A02,093477,Carter; Anne Toulson,20,0,35,15
1657166619719,MATH 109,A01,083213,Ganzberger; Geoffrey Michael,2,0,34,32
1657166619719,MATH 109,A02,083214,Ganzberger; Geoffrey Michael,3,0,34,31
1657166619719,MATH 109,A03,093478,Ganzberger; Geoffrey Michael,1,0,34,33
1657166619719,MATH 109,B01,083215,Ganzberger; Geoffrey Michael,1,0,32,31
1657166619719,MATH 109,B02,083216,Ganzberger; Geoffrey Michael,1,0,32,31
1657166619719,MATH 109,B03,093479,Ganzberger; Geoffrey Michael,6,0,32,26
1657166625746,MATH 142A,A01,083219,Chow; Bennett,6,0,32,26
1657166625746,MATH 142A,A02,083220,Chow; Bennett,10,0,32,22
1657166625746,MATH 142A,A03,093480,Chow; Bennett,7,0,32,25
1657166625746,MATH 142A,B03,093481,Chow; Bennett,8,0,32,24
1657166625746,MATH 142A,B04,093558,Chow; Bennett,11,0,32,21
1657166625746,MATH 142A,B05,093559,Chow; Bennett,6,0,32,26
1657166631770,MATH 193A,A01,083224,Rotar; Vladimir,7,0,34,27
1657166631770,MATH 193A,A02,083225,Rotar; Vladimir,5,0,34,29
1657166631770,MATH 193A,A03,083781,Rotar; Vladimir,1,0,34,33
1657166631770,MATH 193A,A04,083782,Rotar; Vladimir,8,0,34,26
1657166631770,MATH 193A,A05,093482,Rotar; Vladimir,6,0,34,28
1657166637793,MATH 197,001,091859,McAuley; Julian John,9999,0,9999,0
1657166637793,MATH 197,002,095566,Kedlaya; Kiran S.,9997,0,9999,2
1657166637793,MATH 197,003,095567,Xiao; Ming,9999,0,9999,0
1657166637793,MATH 197,004,095571,Perols; Johan Lars,9998,0,9999,1
1657166644853,COGS 9,A01,083615,Shannon; Kyle Michael,7,0,75,68
1657166650879,COGS 11,A01,083617,Boyle; Mary E. T.,22,0,48,26
1657166656906,COGS 13,A01,083071,Bastos; Amalia Pinkusfeld,9,0,71,62
1657166662930,COGS 14A,A01,092681,Semenuks; Arturs,1,1,100,99
1657166668953,COGS 14B,A01,083073,Cheng; Tzu-Han,6,0,63,57
1657166674980,COGS 17,A01,092677,Semenuks; Arturs,4,0,81,77
1657166681013,COGS 100,A01,083619,Allen; Michael Gordon,15,0,70,55
1657166687037,COGS 101A,A01,083621,Davis; Joshua Daniel,9,0,68,59
1657166693062,COGS 101B,A01,091572,Allen; Michael Gordon,9,0,65,56
1657166699083,COGS 101C,A01,083625,Delgado; Tania,17,0,35,18
1657166705110,COGS 107A,A01,083627,Boyle; Mary E. T.,13,0,60,47
1657166711133,COGS 118A,A01,083075,Gupta; Anjum,16,0,76,60
1657166717161,CSE 3,A50,083646,Miranda; Gregory Joseph,24,0,50,26
1657166723188,CSE 8A,A50,083650,Miranda; Gregory Joseph,17,1,56,39
1657166729211,CSE 11,A01,083080,Cao; Yingjun,5,15,40,35
1657166735239,CSE 12,A01,083652,Krause-Levy; Sophia Louisa,24,1,120,96
1657166741262,CSE 15L,A01,083654,Morris; Justin Loren,9,0,50,41
1657166741262,CSE 15L,A02,083655,Morris; Justin Loren,9,0,50,41
1657166747289,CSE 20,A01,083657,Tran; Khoa Dang,38,0,80,42
1657166753315,CSE 21,A01,095574,Bach; Quang Tran,22,0,48,26
1657166759336,CSE 30,A01,083084,Eldon; John,4,0,80,76
1657166759336,CSE 30,B01,095061,Bhaskar; Nishant,7,0,50,43
1657166765359,CSE 100,A01,083659,Cao; Yingjun,4,4,70,66
1657166771386,CSE 134B,A01,083661,Powell; Thomas Allan,20,0,100,80
1657166777409,CSE 140,A01,083663,Gungor; Onat,13,0,85,72
1657166783437,CSE 140L,A01,083088,Eldon; John,17,0,100,83
1657166789463,CSE 175,A01,083665,Kumar; Rakesh,3,0,25,22
1657166795489,CSE 190,A00,092507,Dubnov; Shlomo,7,0,20,13
1657166801515,ECE 45,A01,083139,Congero; Spencer William,5,0,75,70
1657166807550,ECE 65,A50,083695,Saad; Andrew S,12,0,30,18
1657166807550,ECE 65,A51,095125,Saad; Andrew S,25,0,26,1
1657166813572,ECE 109,A01,091882,Touri; Behrouz,18,0,70,52
1657166819595,ECE 180,A00,083140,Abi Samra; Nicholas Camill,1,0,30,29
1657166819595,ECE 180,B00,083141,Abi Samra; Nicholas Camill,0,0,30,30
1657166825617,MATH 10A,A01,083735,Patchell; Gregory David,2,0,30,28
1657166825617,MATH 10A,A02,083736,Patchell; Gregory David,20,0,30,10
1657166825617,MATH 10A,A03,083737,Patchell; Gregory David,16,0,30,14
1657166831642,MATH 10B,A01,083207,Lim; Seonhee,7,0,34,27
1657166831642,MATH 10B,A02,083208,Lim; Seonhee,9,0,35,26
1657166831642,MATH 10B,A03,093472,Lim; Seonhee,5,0,34,29
1657166831642,MATH 10B,B01,083739,Sinha; Shubham,9,0,30,21
1657166837666,MATH 18,A01,083743,Cinel; Cameron Alexander,6,0,30,24
1657166837666,MATH 18,A02,083744,Cinel; Cameron Alexander,15,0,30,15
1657166837666,MATH 18,A03,083745,Cinel; Cameron Alexander,8,0,30,22
1657166837666,MATH 18,B01,083748,Rideout; David Porter,4,0,37,33
1657166837666,MATH 18,B02,083749,Rideout; David Porter,4,0,36,32
1657166837666,MATH 18,B03,083750,Rideout; David Porter,2,0,37,35
1657166837666,MATH 18,B04,083751,Rideout; David Porter,5,0,36,31
1657166837666,MATH 18,B05,093473,Rideout; David Porter,5,0,36,31
1657166837666,MATH 18,B06,093474,Rideout; David Porter,5,0,36,31
1657166843693,MATH 20A,A01,083754,Zheng; Zequn,12,0,40,28
1657166849724,MATH 20B,A01,083756,Briones; Jor-el Thomas Caparas,1,0,36,35
1657166849724,MATH 20B,A02,083757,Briones; Jor-el Thomas Caparas,1,0,36,35
1657166849724,MATH 20B,A03,093475,Briones; Jor-el Thomas Caparas,1,0,36,35
1657166855746,MATH 20C,A01,083760,Briones; Jor-el Thomas Caparas,1,0,35,34
1657166855746,MATH 20C,A02,083761,Briones; Jor-el Thomas Caparas,8,0,35,27
1657166855746,MATH 20C,A03,093476,Briones; Jor-el Thomas Caparas,0,1,36,36
1657166855746,MATH 20C,B01,083762,Bach; Quang Tran,1,0,30,29
1657166861772,MATH 20D,A01,083765,Tran; Brian Kha,4,0,30,26
1657166861772,MATH 20D,A02,083766,Tran; Brian Kha,5,0,30,25
1657166861772,MATH 20D,A03,083767,Tran; Brian Kha,3,0,30,27
1657166867798,MATH 20E,A01,083771,Ganguly; Soumya,7,0,32,25
1657166867798,MATH 20E,A02,083772,Ganguly; Soumya,7,0,32,25
1657166867798,MATH 20E,B01,083773,Ciotti; Benjamin,19,0,35,16
1657166867798,MATH 20E,B02,083774,Ciotti; Benjamin,17,0,35,18
1657166873822,MATH 103A,A01,083777,Greenfeld; Be'Eri,2,0,36,34
1657166873822,MATH 103A,A02,083778,Greenfeld; Be'Eri,5,0,36,31
1657166873822,MATH 103A,A03,093561,Greenfeld; Be'Eri,4,0,36,32
1657166873822,MATH 103A,B01,083779,Greenfeld; Be'Eri,6,0,36,30
1657166873822,MATH 103A,B02,083780,Greenfeld; Be'Eri,3,0,36,33
1657166873822,MATH 103A,B03,093562,Greenfeld; Be'Eri,3,0,36,33
1657166879849,MATH 105,A01,085443,Carter; Anne Toulson,14,0,35,21
1657166879849,MATH 105,A02,093477,Carter; Anne Toulson,20,0,35,15
1657166885874,MATH 109,A01,083213,Ganzberger; Geoffrey Michael,2,0,34,32
1657166885874,MATH 109,A02,083214,Ganzberger; Geoffrey Michael,3,0,34,31
1657166885874,MATH 109,A03,093478,Ganzberger; Geoffrey Michael,1,0,34,33
1657166885874,MATH 109,B01,083215,Ganzberger; Geoffrey Michael,1,0,32,31
1657166885874,MATH 109,B02,083216,Ganzberger; Geoffrey Michael,1,0,32,31
1657166885874,MATH 109,B03,093479,Ganzberger; Geoffrey Michael,6,0,32,26
1657166891897,MATH 142A,A01,083219,Chow; Bennett,6,0,32,26
1657166891897,MATH 142A,A02,083220,Chow; Bennett,10,0,32,22
1657166891897,MATH 142A,A03,093480,Chow; Bennett,7,0,32,25
1657166891897,MATH 142A,B03,093481,Chow; Bennett,8,0,32,24
1657166891897,MATH 142A,B04,093558,Chow; Bennett,11,0,32,21
1657166891897,MATH 142A,B05,093559,Chow; Bennett,6,0,32,26
1657166897921,MATH 193A,A01,083224,Rotar; Vladimir,7,0,34,27
1657166897921,MATH 193A,A02,083225,Rotar; Vladimir,5,0,34,29
1657166897921,MATH 193A,A03,083781,Rotar; Vladimir,1,0,34,33
1657166897921,MATH 193A,A04,083782,Rotar; Vladimir,8,0,34,26
1657166897921,MATH 193A,A05,093482,Rotar; Vladimir,6,0,34,28
1657166903945,MATH 197,001,091859,McAuley; Julian John,9999,0,9999,0
1657166903945,MATH 197,002,095566,Kedlaya; Kiran S.,9997,0,9999,2
1657166903945,MATH 197,003,095567,Xiao; Ming,9999,0,9999,0
1657166903945,MATH 197,004,095571,Perols; Johan Lars,9998,0,9999,1
1657166910998,COGS 9,A01,083615,Shannon; Kyle Michael,7,0,75,68
1657166917020,COGS 11,A01,083617,Boyle; Mary E. T.,22,0,48,26
1657166923043,COGS 13,A01,083071,Bastos; Amalia Pinkusfeld,9,0,71,62
1657166929069,COGS 14A,A01,092681,Semenuks; Arturs,1,1,100,99
1657166935095,COGS 14B,A01,083073,Cheng; Tzu-Han,6,0,63,57
1657166941119,COGS 17,A01,092677,Semenuks; Arturs,4,0,81,77
1657166947146,COGS 100,A01,083619,Allen; Michael Gordon,15,0,70,55
1657166953173,COGS 101A,A01,083621,Davis; Joshua Daniel,9,0,68,59
1657166959200,COGS 101B,A01,091572,Allen; Michael Gordon,9,0,65,56
1657166965221,COGS 101C,A01,083625,Delgado; Tania,17,0,35,18
1657166971244,COGS 107A,A01,083627,Boyle; Mary E. T.,13,0,60,47
1657166977272,COGS 118A,A01,083075,Gupta; Anjum,16,0,76,60
1657166983299,CSE 3,A50,083646,Miranda; Gregory Joseph,24,0,50,26
1657166989329,CSE 8A,A50,083650,Miranda; Gregory Joseph,17,1,56,39
1657166995355,CSE 11,A01,083080,Cao; Yingjun,5,15,40,35
1657167001379,CSE 12,A01,083652,Krause-Levy; Sophia Louisa,24,1,120,96
1657167007402,CSE 15L,A01,083654,Morris; Justin Loren,9,0,50,41
1657167007402,CSE 15L,A02,083655,Morris; Justin Loren,9,0,50,41
1657167013424,CSE 20,A01,083657,Tran; Khoa Dang,38,0,80,42
1657167019447,CSE 21,A01,095574,Bach; Quang Tran,22,0,48,26
1657167025469,CSE 30,A01,083084,Eldon; John,4,0,80,76
1657167025469,CSE 30,B01,095061,Bhaskar; Nishant,7,0,50,43
1657167031493,CSE 100,A01,083659,Cao; Yingjun,4,4,70,66
1657167037525,CSE 134B,A01,083661,Powell; Thomas Allan,20,0,100,80
1657167043559,CSE 140,A01,083663,Gungor; Onat,13,0,85,72
1657167049583,CSE 140L,A01,083088,Eldon; John,17,0,100,83
1657167055607,CSE 175,A01,083665,Kumar; Rakesh,3,0,25,22
1657167061646,CSE 190,A00,092507,Dubnov; Shlomo,7,0,20,13
1657167067673,ECE 45,A01,083139,Congero; Spencer William,5,0,75,70
1657167073694,ECE 65,A50,083695,Saad; Andrew S,12,0,30,18
1657167073694,ECE 65,A51,095125,Saad; Andrew S,25,0,26,1
1657167079719,ECE 109,A01,091882,Touri; Behrouz,18,0,70,52
1657167085742,ECE 180,A00,083140,Abi Samra; Nicholas Camill,1,0,30,29
1657167085742,ECE 180,B00,083141,Abi Samra; Nicholas Camill,0,0,30,30
1657167091764,MATH 10A,A01,083735,Patchell; Gregory David,2,0,30,28
1657167091764,MATH 10A,A02,083736,Patchell; Gregory David,20,0,30,10
1657167091764,MATH 10A,A03,083737,Patchell; Gregory David,16,0,30,14
1657167097791,MATH 10B,A01,083207,Lim; Seonhee,7,0,34,27
1657167097791,MATH 10B,A02,083208,Lim; Seonhee,9,0,35,26
1657167097791,MATH 10B,A03,093472,Lim; Seonhee,5,0,34,29
1657167097791,MATH 10B,B01,083739,Sinha; Shubham,9,0,30,21
1657167103814,MATH 18,A01,083743,Cinel; Cameron Alexander,6,0,30,24
1657167103814,MATH 18,A02,083744,Cinel; Cameron Alexander,15,0,30,15
1657167103814,MATH 18,A03,083745,Cinel; Cameron Alexander,8,0,30,22
1657167103814,MATH 18,B01,083748,Rideout; David Porter,4,0,37,33
1657167103814,MATH 18,B02,083749,Rideout; David Porter,4,0,36,32
1657167103814,MATH 18,B03,083750,Rideout; David Porter,2,0,37,35
1657167103814,MATH 18,B04,083751,Rideout; David Porter,5,0,36,31
1657167103814,MATH 18,B05,093473,Rideout; David Porter,5,0,36,31
1657167103814,MATH 18,B06,093474,Rideout; David Porter,5,0,36,31
1657167109839,MATH 20A,A01,083754,Zheng; Zequn,12,0,40,28
1657167115863,MATH 20B,A01,083756,Briones; Jor-el Thomas Caparas,1,0,36,35
1657167115863,MATH 20B,A02,083757,Briones; Jor-el Thomas Caparas,1,0,36,35
1657167115863,MATH 20B,A03,093475,Briones; Jor-el Thomas Caparas,1,0,36,35
1657167121886,MATH 20C,A01,083760,Briones; Jor-el Thomas Caparas,1,0,35,34
1657167121886,MATH 20C,A02,083761,Briones; Jor-el Thomas Caparas,8,0,35,27
1657167121886,MATH 20C,A03,093476,Briones; Jor-el Thomas Caparas,0,1,36,36
1657167121886,MATH 20C,B01,083762,Bach; Quang Tran,1,0,30,29
1657167127909,MATH 20D,A01,083765,Tran; Brian Kha,4,0,30,26
1657167127909,MATH 20D,A02,083766,Tran; Brian Kha,5,0,30,25
1657167127909,MATH 20D,A03,083767,Tran; Brian Kha,3,0,30,27
1657167133932,MATH 20E,A01,083771,Ganguly; Soumya,7,0,32,25
1657167133932,MATH 20E,A02,083772,Ganguly; Soumya,7,0,32,25
1657167133932,MATH 20E,B01,083773,Ciotti; Benjamin,19,0,35,16
1657167133932,MATH 20E,B02,083774,Ciotti; Benjamin,17,0,35,18
1657167140039,MATH 103A,A01,083777,Greenfeld; Be'Eri,2,0,36,34
1657167140039,MATH 103A,A02,083778,Greenfeld; Be'Eri,5,0,36,31
1657167140039,MATH 103A,A03,093561,Greenfeld; Be'Eri,4,0,36,32
1657167140039,MATH 103A,B01,083779,Greenfeld; Be'Eri,6,0,36,30
1657167140039,MATH 103A,B02,083780,Greenfeld; Be'Eri,3,0,36,33
1657167140039,MATH 103A,B03,093562,Greenfeld; Be'Eri,3,0,36,33
1657167146061,MATH 105,A01,085443,Carter; Anne Toulson,14,0,35,21
1657167146061,MATH 105,A02,093477,Carter; Anne Toulson,20,0,35,15
1657167152090,MATH 109,A01,083213,Ganzberger; Geoffrey Michael,2,0,34,32
1657167152090,MATH 109,A02,083214,Ganzberger; Geoffrey Michael,3,0,34,31
1657167152090,MATH 109,A03,093478,Ganzberger; Geoffrey Michael,1,0,34,33
1657167152090,MATH 109,B01,083215,Ganzberger; Geoffrey Michael,1,0,32,31
1657167152090,MATH 109,B02,083216,Ganzberger; Geoffrey Michael,1,0,32,31
1657167152090,MATH 109,B03,093479,Ganzberger; Geoffrey Michael,6,0,32,26
1657167158120,MATH 142A,A01,083219,Chow; Bennett,6,0,32,26
1657167158120,MATH 142A,A02,083220,Chow; Bennett,10,0,32,22
1657167158120,MATH 142A,A03,093480,Chow; Bennett,7,0,32,25
1657167158120,MATH 142A,B03,093481,Chow; Bennett,8,0,32,24
1657167158120,MATH 142A,B04,093558,Chow; Bennett,11,0,32,21
1657167158120,MATH 142A,B05,093559,Chow; Bennett,6,0,32,26
1657167164144,MATH 193A,A01,083224,Rotar; Vladimir,7,0,34,27
1657167164144,MATH 193A,A02,083225,Rotar; Vladimir,5,0,34,29
1657167164144,MATH 193A,A03,083781,Rotar; Vladimir,1,0,34,33
1657167164144,MATH 193A,A04,083782,Rotar; Vladimir,8,0,34,26
1657167164144,MATH 193A,A05,093482,Rotar; Vladimir,6,0,34,28
1657167170172,MATH 197,001,091859,McAuley; Julian John,9999,0,9999,0
1657167170172,MATH 197,002,095566,Kedlaya; Kiran S.,9997,0,9999,2
1657167170172,MATH 197,003,095567,Xiao; Ming,9999,0,9999,0
1657167170172,MATH 197,004,095571,Perols; Johan Lars,9998,0,9999,1
1657167177228,COGS 9,A01,083615,Shannon; Kyle Michael,7,0,75,68
1657167183249,COGS 11,A01,083617,Boyle; Mary E. T.,22,0,48,26
1657167189273,COGS 13,A01,083071,Bastos; Amalia Pinkusfeld,9,0,71,62
1657167195299,COGS 14A,A01,092681,Semenuks; Arturs,1,1,100,99
1657167201324,COGS 14B,A01,083073,Cheng; Tzu-Han,6,0,63,57
1657167207347,COGS 17,A01,092677,Semenuks; Arturs,4,0,81,77
1657167213370,COGS 100,A01,083619,Allen; Michael Gordon,15,0,70,55
1657167219400,COGS 101A,A01,083621,Davis; Joshua Daniel,9,0,68,59
1657167225425,COGS 101B,A01,091572,Allen; Michael Gordon,9,0,65,56
1657167231448,COGS 101C,A01,083625,Delgado; Tania,17,0,35,18
1657167237474,COGS 107A,A01,083627,Boyle; Mary E. T.,13,0,60,47
1657167243501,COGS 118A,A01,083075,Gupta; Anjum,16,0,76,60
1657167249531,CSE 3,A50,083646,Miranda; Gregory Joseph,24,0,50,26
1657167255556,CSE 8A,A50,083650,Miranda; Gregory Joseph,17,1,56,39
1657167261580,CSE 11,A01,083080,Cao; Yingjun,5,15,40,35
1657167267614,CSE 12,A01,083652,Krause-Levy; Sophia Louisa,24,1,120,96
1657167273650,CSE 15L,A01,083654,Morris; Justin Loren,9,0,50,41
1657167273650,CSE 15L,A02,083655,Morris; Justin Loren,9,0,50,41
1657167279673,CSE 20,A01,083657,Tran; Khoa Dang,38,0,80,42
1657167285702,CSE 21,A01,095574,Bach; Quang Tran,22,0,48,26
1657167291741,CSE 30,A01,083084,Eldon; John,4,0,80,76
1657167291741,CSE 30,B01,095061,Bhaskar; Nishant,7,0,50,43
1657167297771,CSE 100,A01,083659,Cao; Yingjun,4,4,70,66
1657167303797,CSE 134B,A01,083661,Powell; Thomas Allan,20,0,100,80
1657167309821,CSE 140,A01,083663,Gungor; Onat,13,0,85,72
1657167315843,CSE 140L,A01,083088,Eldon; John,17,0,100,83
1657167321870,CSE 175,A01,083665,Kumar; Rakesh,3,0,25,22
1657167327897,CSE 190,A00,092507,Dubnov; Shlomo,7,0,20,13
1657167333923,ECE 45,A01,083139,Congero; Spencer William,5,0,75,70
1657167339951,ECE 65,A50,083695,Saad; Andrew S,12,0,30,18
1657167339951,ECE 65,A51,095125,Saad; Andrew S,25,0,26,1
1657167345975,ECE 109,A01,091882,Touri; Behrouz,18,0,70,52
1657167352001,ECE 180,A00,083140,Abi Samra; Nicholas Camill,1,0,30,29
1657167352001,ECE 180,B00,083141,Abi Samra; Nicholas Camill,0,0,30,30
1657167358029,MATH 10A,A01,083735,Patchell; Gregory David,2,0,30,28
1657167358029,MATH 10A,A02,083736,Patchell; Gregory David,20,0,30,10
1657167358029,MATH 10A,A03,083737,Patchell; Gregory David,16,0,30,14
1657167364054,MATH 10B,A01,083207,Lim; Seonhee,7,0,34,27
1657167364054,MATH 10B,A02,083208,Lim; Seonhee,9,0,35,26
1657167364054,MATH 10B,A03,093472,Lim; Seonhee,5,0,34,29
1657167364054,MATH 10B,B01,083739,Sinha; Shubham,9,0,30,21
1657167370083,MATH 18,A01,083743,Cinel; Cameron Alexander,6,0,30,24
1657167370083,MATH 18,A02,083744,Cinel; Cameron Alexander,15,0,30,15
1657167370083,MATH 18,A03,083745,Cinel; Cameron Alexander,8,0,30,22
1657167370083,MATH 18,B01,083748,Rideout; David Porter,4,0,37,33
1657167370083,MATH 18,B02,083749,Rideout; David Porter,4,0,36,32
1657167370083,MATH 18,B03,083750,Rideout; David Porter,2,0,37,35
1657167370083,MATH 18,B04,083751,Rideout; David Porter,5,0,36,31
1657167370083,MATH 18,B05,093473,Rideout; David Porter,5,0,36,31
1657167370083,MATH 18,B06,093474,Rideout; David Porter,5,0,36,31
1657167376114,MATH 20A,A01,083754,Zheng; Zequn,12,0,40,28
1657167382140,MATH 20B,A01,083756,Briones; Jor-el Thomas Caparas,1,0,36,35
1657167382140,MATH 20B,A02,083757,Briones; Jor-el Thomas Caparas,1,0,36,35
1657167382140,MATH 20B,A03,093475,Briones; Jor-el Thomas Caparas,1,0,36,35
1657167388165,MATH 20C,A01,083760,Briones; Jor-el Thomas Caparas,1,0,35,34
1657167388165,MATH 20C,A02,083761,Briones; Jor-el Thomas Caparas,8,0,35,27
1657167388165,MATH 20C,A03,093476,Briones; Jor-el Thomas Caparas,0,1,36,36
1657167388165,MATH 20C,B01,083762,Bach; Quang Tran,1,0,30,29
1657167394188,MATH 20D,A01,083765,Tran; Brian Kha,4,0,30,26
1657167394188,MATH 20D,A02,083766,Tran; Brian Kha,5,0,30,25
1657167394188,MATH 20D,A03,083767,Tran; Brian Kha,3,0,30,27
1657167400213,MATH 20E,A01,083771,Ganguly; Soumya,7,0,32,25
1657167400213,MATH 20E,A02,083772,Ganguly; Soumya,7,0,32,25
1657167400213,MATH 20E,B01,083773,Ciotti; Benjamin,19,0,35,16
1657167400213,MATH 20E,B02,083774,Ciotti; Benjamin,17,0,35,18
1657167406242,MATH 103A,A01,083777,Greenfeld; Be'Eri,2,0,36,34
1657167406242,MATH 103A,A02,083778,Greenfeld; Be'Eri,5,0,36,31
1657167406242,MATH 103A,A03,093561,Greenfeld; Be'Eri,4,0,36,32
1657167406242,MATH 103A,B01,083779,Greenfeld; Be'Eri,6,0,36,30
1657167406242,MATH 103A,B02,083780,Greenfeld; Be'Eri,3,0,36,33
1657167406242,MATH 103A,B03,093562,Greenfeld; Be'Eri,3,0,36,33
1657167412270,MATH 105,A01,085443,Carter; Anne Toulson,14,0,35,21
1657167412270,MATH 105,A02,093477,Carter; Anne Toulson,20,0,35,15
1657167418298,MATH 109,A01,083213,Ganzberger; Geoffrey Michael,2,0,34,32
1657167418298,MATH 109,A02,083214,Ganzberger; Geoffrey Michael,3,0,34,31
1657167418298,MATH 109,A03,093478,Ganzberger; Geoffrey Michael,1,0,34,33
1657167418298,MATH 109,B01,083215,Ganzberger; Geoffrey Michael,1,0,32,31
1657167418298,MATH 109,B02,083216,Ganzberger; Geoffrey Michael,1,0,32,31
1657167418298,MATH 109,B03,093479,Ganzberger; Geoffrey Michael,6,0,32,26
1657167424328,MATH 142A,A01,083219,Chow; Bennett,6,0,32,26
1657167424328,MATH 142A,A02,083220,Chow; Bennett,10,0,32,22
1657167424328,MATH 142A,A03,093480,Chow; Bennett,7,0,32,25
1657167424328,MATH 142A,B03,093481,Chow; Bennett,8,0,32,24
1657167424328,MATH 142A,B04,093558,Chow; Bennett,11,0,32,21
1657167424328,MATH 142A,B05,093559,Chow; Bennett,6,0,32,26
1657167430353,MATH 193A,A01,083224,Rotar; Vladimir,7,0,34,27
1657167430353,MATH 193A,A02,083225,Rotar; Vladimir,5,0,34,29
1657167430353,MATH 193A,A03,083781,Rotar; Vladimir,1,0,34,33
1657167430353,MATH 193A,A04,083782,Rotar; Vladimir,8,0,34,26
1657167430353,MATH 193A,A05,093482,Rotar; Vladimir,6,0,34,28
1657167436377,MATH 197,001,091859,McAuley; Julian John,9999,0,9999,0
1657167436377,MATH 197,002,095566,Kedlaya; Kiran S.,9997,0,9999,2
1657167436377,MATH 197,003,095567,Xiao; Ming,9999,0,9999,0
1657167436377,MATH 197,004,095571,Perols; Johan Lars,9998,0,9999,1
1657167443439,COGS 9,A01,083615,Shannon; Kyle Michael,7,0,75,68
1657167449462,COGS 11,A01,083617,Boyle; Mary E. T.,22,0,48,26
1657167455494,COGS 13,A01,083071,Bastos; Amalia Pinkusfeld,9,0,71,62
1657167461516,COGS 14A,A01,092681,Semenuks; Arturs,1,1,100,99
1657167467543,COGS 14B,A01,083073,Cheng; Tzu-Han,6,0,63,57
1657167473566,COGS 17,A01,092677,Semenuks; Arturs,4,0,81,77
1657167479588,COGS 100,A01,083619,Allen; Michael Gordon,15,0,70,55
1657167485616,COGS 101A,A01,083621,Davis; Joshua Daniel,9,0,68,59
1657167491643,COGS 101B,A01,091572,Allen; Michael Gordon,9,0,65,56
1657167497666,COGS 101C,A01,083625,Delgado; Tania,17,0,35,18
1657167503688,COGS 107A,A01,083627,Boyle; Mary E. T.,13,0,60,47
1657167509715,COGS 118A,A01,083075,Gupta; Anjum,16,0,76,60
1657167515743,CSE 3,A50,083646,Miranda; Gregory Joseph,24,0,50,26
1657167521766,CSE 8A,A50,083650,Miranda; Gregory Joseph,17,1,56,39
1657167527789,CSE 11,A01,083080,Cao; Yingjun,5,15,40,35
1657167533812,CSE 12,A01,083652,Krause-Levy; Sophia Louisa,24,1,120,96
1657167539834,CSE 15L,A01,083654,Morris; Justin Loren,9,0,50,41
1657167539834,CSE 15L,A02,083655,Morris; Justin Loren,9,0,50,41
1657167545858,CSE 20,A01,083657,Tran; Khoa Dang,38,0,80,42
1657167551890,CSE 21,A01,095574,Bach; Quang Tran,22,0,48,26
1657167557913,CSE 30,A01,083084,Eldon; John,4,0,80,76
1657167557913,CSE 30,B01,095061,Bhaskar; Nishant,7,0,50,43
1657167563940,CSE 100,A01,083659,Cao; Yingjun,4,4,70,66
1657167569965,CSE 134B,A01,083661,Powell; Thomas Allan,20,0,100,80
1657167575991,CSE 140,A01,083663,Gungor; Onat,13,0,85,72
1657167582019,CSE 140L,A01,083088,Eldon; John,17,0,100,83
1657167588044,CSE 175,A01,083665,Kumar; Rakesh,3,0,25,22
1657167594066,CSE 190,A00,092507,Dubnov; Shlomo,7,0,20,13
1657167600089,ECE 45,A01,083139,Congero; Spencer William,5,0,75,70
1657167606115,ECE 65,A50,083695,Saad; Andrew S,12,0,30,18
1657167606115,ECE 65,A51,095125,Saad; Andrew S,25,0,26,1
1657167612138,ECE 109,A01,091882,Touri; Behrouz,18,0,70,52
1657167618165,ECE 180,A00,083140,Abi Samra; Nicholas Camill,1,0,30,29
1657167618165,ECE 180,B00,083141,Abi Samra; Nicholas Camill,0,0,30,30
1657167624193,MATH 10A,A01,083735,Patchell; Gregory David,2,0,30,28
1657167624193,MATH 10A,A02,083736,Patchell; Gregory David,20,0,30,10
1657167624193,MATH 10A,A03,083737,Patchell; Gregory David,16,0,30,14
1657167630221,MATH 10B,A01,083207,Lim; Seonhee,7,0,34,27
1657167630221,MATH 10B,A02,083208,Lim; Seonhee,9,0,35,26
1657167630221,MATH 10B,A03,093472,Lim; Seonhee,5,0,34,29
1657167630221,MATH 10B,B01,083739,Sinha; Shubham,9,0,30,21
1657167636252,MATH 18,A01,083743,Cinel; Cameron Alexander,6,0,30,24
1657167636252,MATH 18,A02,083744,Cinel; Cameron Alexander,15,0,30,15
1657167636252,MATH 18,A03,083745,Cinel; Cameron Alexander,8,0,30,22
1657167636252,MATH 18,B01,083748,Rideout; David Porter,4,0,37,33
1657167636252,MATH 18,B02,083749,Rideout; David Porter,4,0,36,32
1657167636252,MATH 18,B03,083750,Rideout; David Porter,2,0,37,35
1657167636252,MATH 18,B04,083751,Rideout; David Porter,5,0,36,31
1657167636252,MATH 18,B05,093473,Rideout; David Porter,5,0,36,31
1657167636252,MATH 18,B06,093474,Rideout; David Porter,5,0,36,31
1657167642275,MATH 20A,A01,083754,Zheng; Zequn,12,0,40,28
1657167648311,MATH 20B,A01,083756,Briones; Jor-el Thomas Caparas,1,0,36,35
1657167648311,MATH 20B,A02,083757,Briones; Jor-el Thomas Caparas,1,0,36,35
1657167648311,MATH 20B,A03,093475,Briones; Jor-el Thomas Caparas,1,0,36,35
1657167654335,MATH 20C,A01,083760,Briones; Jor-el Thomas Caparas,1,0,35,34
1657167654335,MATH 20C,A02,083761,Briones; Jor-el Thomas Caparas,8,0,35,27
1657167654335,MATH 20C,A03,093476,Briones; Jor-el Thomas Caparas,0,1,36,36
1657167654335,MATH 20C,B01,083762,Bach; Quang Tran,1,0,30,29
1657167660362,MATH 20D,A01,083765,Tran; Brian Kha,4,0,30,26
1657167660362,MATH 20D,A02,083766,Tran; Brian Kha,5,0,30,25
1657167660362,MATH 20D,A03,083767,Tran; Brian Kha,3,0,30,27
1657167666384,MATH 20E,A01,083771,Ganguly; Soumya,7,0,32,25
1657167666384,MATH 20E,A02,083772,Ganguly; Soumya,7,0,32,25
1657167666384,MATH 20E,B01,083773,Ciotti; Benjamin,19,0,35,16
1657167666384,MATH 20E,B02,083774,Ciotti; Benjamin,17,0,35,18
1657167672408,MATH 103A,A01,083777,Greenfeld; Be'Eri,2,0,36,34
1657167672408,MATH 103A,A02,083778,Greenfeld; Be'Eri,5,0,36,31
1657167672408,MATH 103A,A03,093561,Greenfeld; Be'Eri,4,0,36,32
1657167672408,MATH 103A,B01,083779,Greenfeld; Be'Eri,6,0,36,30
1657167672408,MATH 103A,B02,083780,Greenfeld; Be'Eri,3,0,36,33
1657167672408,MATH 103A,B03,093562,Greenfeld; Be'Eri,3,0,36,33
1657167678432,MATH 105,A01,085443,Carter; Anne Toulson,14,0,35,21
1657167678432,MATH 105,A02,093477,Carter; Anne Toulson,20,0,35,15
1657167684455,MATH 109,A01,083213,Ganzberger; Geoffrey Michael,2,0,34,32
1657167684455,MATH 109,A02,083214,Ganzberger; Geoffrey Michael,3,0,34,31
1657167684455,MATH 109,A03,093478,Ganzberger; Geoffrey Michael,1,0,34,33
1657167684455,MATH 109,B01,083215,Ganzberger; Geoffrey Michael,1,0,32,31
1657167684455,MATH 109,B02,083216,Ganzberger; Geoffrey Michael,1,0,32,31
1657167684455,MATH 109,B03,093479,Ganzberger; Geoffrey Michael,6,0,32,26
1657167690479,MATH 142A,A01,083219,Chow; Bennett,6,0,32,26
1657167690479,MATH 142A,A02,083220,Chow; Bennett,10,0,32,22
1657167690479,MATH 142A,A03,093480,Chow; Bennett,7,0,32,25
1657167690479,MATH 142A,B03,093481,Chow; Bennett,8,0,32,24
1657167690479,MATH 142A,B04,093558,Chow; Bennett,11,0,32,21
1657167690479,MATH 142A,B05,093559,Chow; Bennett,6,0,32,26
1657167696512,MATH 193A,A01,083224,Rotar; Vladimir,7,0,34,27
1657167696512,MATH 193A,A02,083225,Rotar; Vladimir,5,0,34,29
1657167696512,MATH 193A,A03,083781,Rotar; Vladimir,1,0,34,33
1657167696512,MATH 193A,A04,083782,Rotar; Vladimir,8,0,34,26
1657167696512,MATH 193A,A05,093482,Rotar; Vladimir,6,0,34,28
1657167702536,MATH 197,001,091859,McAuley; Julian John,9999,0,9999,0
1657167702536,MATH 197,002,095566,Kedlaya; Kiran S.,9997,0,9999,2
1657167702536,MATH 197,003,095567,Xiao; Ming,9999,0,9999,0
1657167702536,MATH 197,004,095571,Perols; Johan Lars,9998,0,9999,1
1657167709588,COGS 9,A01,083615,Shannon; Kyle Michael,7,0,75,68
1657167715613,COGS 11,A01,083617,Boyle; Mary E. T.,22,0,48,26
1657167721635,COGS 13,A01,083071,Bastos; Amalia Pinkusfeld,9,0,71,62
1657167727657,COGS 14A,A01,092681,Semenuks; Arturs,1,1,100,99
1657167733772,COGS 14B,A01,083073,Cheng; Tzu-Han,6,0,63,57
1657167739794,COGS 17,A01,092677,Semenuks; Arturs,4,0,81,77
1657167745818,COGS 100,A01,083619,Allen; Michael Gordon,15,0,70,55
1657167751844,COGS 101A,A01,083621,Davis; Joshua Daniel,9,0,68,59
1657167757869,COGS 101B,A01,091572,Allen; Michael Gordon,9,0,65,56
1657167763896,COGS 101C,A01,083625,Delgado; Tania,17,0,35,18
1657167769923,COGS 107A,A01,083627,Boyle; Mary E. T.,13,0,60,47
1657167775944,COGS 118A,A01,083075,Gupta; Anjum,16,0,76,60
1657167781979,CSE 3,A50,083646,Miranda; Gregory Joseph,24,0,50,26
1657167788006,CSE 8A,A50,083650,Miranda; Gregory Joseph,17,1,56,39
1657167794031,CSE 11,A01,083080,Cao; Yingjun,5,15,40,35
1657167800056,CSE 12,A01,083652,Krause-Levy; Sophia Louisa,24,1,120,96
1657167806081,CSE 15L,A01,083654,Morris; Justin Loren,9,0,50,41
1657167806081,CSE 15L,A02,083655,Morris; Justin Loren,9,0,50,41
1657167812106,CSE 20,A01,083657,Tran; Khoa Dang,38,0,80,42
1657167818132,CSE 21,A01,095574,Bach; Quang Tran,22,0,48,26
1657167824158,CSE 30,A01,083084,Eldon; John,4,0,80,76
1657167824158,CSE 30,B01,095061,Bhaskar; Nishant,7,0,50,43
1657167830188,CSE 100,A01,083659,Cao; Yingjun,4,4,70,66
1657167836210,CSE 134B,A01,083661,Powell; Thomas Allan,20,0,100,80
1657167842241,CSE 140,A01,083663,Gungor; Onat,13,0,85,72
1657167848277,CSE 140L,A01,083088,Eldon; John,17,0,100,83
1657167854315,CSE 175,A01,083665,Kumar; Rakesh,3,0,25,22
1657167860341,CSE 190,A00,092507,Dubnov; Shlomo,7,0,20,13
1657167866365,ECE 45,A01,083139,Congero; Spencer William,5,0,75,70
1657167872388,ECE 65,A50,083695,Saad; Andrew S,12,0,30,18
1657167872388,ECE 65,A51,095125,Saad; Andrew S,25,0,26,1
1657167878415,ECE 109,A01,091882,Touri; Behrouz,18,0,70,52
1657167884437,ECE 180,A00,083140,Abi Samra; Nicholas Camill,1,0,30,29
1657167884437,ECE 180,B00,083141,Abi Samra; Nicholas Camill,0,0,30,30
1657167890465,MATH 10A,A01,083735,Patchell; Gregory David,2,0,30,28
1657167890465,MATH 10A,A02,083736,Patchell; Gregory David,20,0,30,10
1657167890465,MATH 10A,A03,083737,Patchell; Gregory David,16,0,30,14
1657167896487,MATH 10B,A01,083207,Lim; Seonhee,7,0,34,27
1657167896487,MATH 10B,A02,083208,Lim; Seonhee,9,0,35,26
1657167896487,MATH 10B,A03,093472,Lim; Seonhee,5,0,34,29
1657167896487,MATH 10B,B01,083739,Sinha; Shubham,9,0,30,21
1657167902512,MATH 18,A01,083743,Cinel; Cameron Alexander,6,0,30,24
1657167902512,MATH 18,A02,083744,Cinel; Cameron Alexander,15,0,30,15
1657167902512,MATH 18,A03,083745,Cinel; Cameron Alexander,8,0,30,22
1657167902512,MATH 18,B01,083748,Rideout; David Porter,4,0,37,33
1657167902512,MATH 18,B02,083749,Rideout; David Porter,4,0,36,32
1657167902512,MATH 18,B03,083750,Rideout; David Porter,2,0,37,35
1657167902512,MATH 18,B04,083751,Rideout; David Porter,5,0,36,31
1657167902512,MATH 18,B05,093473,Rideout; David Porter,5,0,36,31
1657167902512,MATH 18,B06,093474,Rideout; David Porter,5,0,36,31
1657167908552,MATH 20A,A01,083754,Zheng; Zequn,12,0,40,28
1657167914580,MATH 20B,A01,083756,Briones; Jor-el Thomas Caparas,1,0,36,35
1657167914580,MATH 20B,A02,083757,Briones; Jor-el Thomas Caparas,1,0,36,35
1657167914580,MATH 20B,A03,093475,Briones; Jor-el Thomas Caparas,1,0,36,35
1657167920605,MATH 20C,A01,083760,Briones; Jor-el Thomas Caparas,1,0,35,34
1657167920605,MATH 20C,A02,083761,Briones; Jor-el Thomas Caparas,8,0,35,27
1657167920605,MATH 20C,A03,093476,Briones; Jor-el Thomas Caparas,0,1,36,36
1657167920605,MATH 20C,B01,083762,Bach; Quang Tran,1,0,30,29
1657167926629,MATH 20D,A01,083765,Tran; Brian Kha,4,0,30,26
1657167926629,MATH 20D,A02,083766,Tran; Brian Kha,5,0,30,25
1657167926629,MATH 20D,A03,083767,Tran; Brian Kha,3,0,30,27
1657167932651,MATH 20E,A01,083771,Ganguly; Soumya,7,0,32,25
1657167932651,MATH 20E,A02,083772,Ganguly; Soumya,7,0,32,25
1657167932651,MATH 20E,B01,083773,Ciotti; Benjamin,19,0,35,16
1657167932651,MATH 20E,B02,083774,Ciotti; Benjamin,17,0,35,18
1657167938696,MATH 103A,A01,083777,Greenfeld; Be'Eri,2,0,36,34
1657167938696,MATH 103A,A02,083778,Greenfeld; Be'Eri,5,0,36,31
1657167938696,MATH 103A,A03,093561,Greenfeld; Be'Eri,4,0,36,32
1657167938696,MATH 103A,B01,083779,Greenfeld; Be'Eri,6,0,36,30
1657167938696,MATH 103A,B02,083780,Greenfeld; Be'Eri,3,0,36,33
1657167938696,MATH 103A,B03,093562,Greenfeld; Be'Eri,3,0,36,33
1657167944725,MATH 105,A01,085443,Carter; Anne Toulson,14,0,35,21
1657167944725,MATH 105,A02,093477,Carter; Anne Toulson,20,0,35,15
1657167950754,MATH 109,A01,083213,Ganzberger; Geoffrey Michael,2,0,34,32
1657167950754,MATH 109,A02,083214,Ganzberger; Geoffrey Michael,3,0,34,31
1657167950754,MATH 109,A03,093478,Ganzberger; Geoffrey Michael,1,0,34,33
1657167950754,MATH 109,B01,083215,Ganzberger; Geoffrey Michael,1,0,32,31
1657167950754,MATH 109,B02,083216,Ganzberger; Geoffrey Michael,1,0,32,31
1657167950754,MATH 109,B03,093479,Ganzberger; Geoffrey Michael,6,0,32,26
1657167956781,MATH 142A,A01,083219,Chow; Bennett,6,0,32,26
1657167956781,MATH 142A,A02,083220,Chow; Bennett,10,0,32,22
1657167956781,MATH 142A,A03,093480,Chow; Bennett,7,0,32,25
1657167956781,MATH 142A,B03,093481,Chow; Bennett,8,0,32,24
1657167956781,MATH 142A,B04,093558,Chow; Bennett,11,0,32,21
1657167956781,MATH 142A,B05,093559,Chow; Bennett,6,0,32,26
1657167962817,MATH 193A,A01,083224,Rotar; Vladimir,7,0,34,27
1657167962817,MATH 193A,A02,083225,Rotar; Vladimir,5,0,34,29
1657167962817,MATH 193A,A03,083781,Rotar; Vladimir,1,0,34,33
1657167962817,MATH 193A,A04,083782,Rotar; Vladimir,8,0,34,26
1657167962817,MATH 193A,A05,093482,Rotar; Vladimir,6,0,34,28
1657167968841,MATH 197,001,091859,McAuley; Julian John,9999,0,9999,0
1657167968841,MATH 197,002,095566,Kedlaya; Kiran S.,9997,0,9999,2
1657167968841,MATH 197,003,095567,Xiao; Ming,9999,0,9999,0
1657167968841,MATH 197,004,095571,Perols; Johan Lars,9998,0,9999,1
1657167975896,COGS 9,A01,083615,Shannon; Kyle Michael,7,0,75,68
1657167981921,COGS 11,A01,083617,Boyle; Mary E. T.,22,0,48,26
1657167987945,COGS 13,A01,083071,Bastos; Amalia Pinkusfeld,9,0,71,62
1657167993966,COGS 14A,A01,092681,Semenuks; Arturs,1,1,100,99
1657167999991,COGS 14B,A01,083073,Cheng; Tzu-Han,6,0,63,57
1657168006013,COGS 17,A01,092677,Semenuks; Arturs,4,0,81,77
1657168012038,COGS 100,A01,083619,Allen; Michael Gordon,15,0,70,55
1657168018065,COGS 101A,A01,083621,Davis; Joshua Daniel,9,0,68,59
1657168024089,COGS 101B,A01,091572,Allen; Michael Gordon,9,0,65,56
1657168030115,COGS 101C,A01,083625,Delgado; Tania,17,0,35,18
1657168036144,COGS 107A,A01,083627,Boyle; Mary E. T.,13,0,60,47
1657168042171,COGS 118A,A01,083075,Gupta; Anjum,16,0,76,60
1657168048200,CSE 3,A50,083646,Miranda; Gregory Joseph,24,0,50,26
1657168054230,CSE 8A,A50,083650,Miranda; Gregory Joseph,17,1,56,39
1657168060256,CSE 11,A01,083080,Cao; Yingjun,5,15,40,35
1657168066284,CSE 12,A01,083652,Krause-Levy; Sophia Louisa,24,1,120,96
1657168072307,CSE 15L,A01,083654,Morris; Justin Loren,9,0,50,41
1657168072307,CSE 15L,A02,083655,Morris; Justin Loren,9,0,50,41
1657168078331,CSE 20,A01,083657,Tran; Khoa Dang,38,0,80,42
1657168084353,CSE 21,A01,095574,Bach; Quang Tran,22,0,48,26
1657168090376,CSE 30,A01,083084,Eldon; John,4,0,80,76
1657168090376,CSE 30,B01,095061,Bhaskar; Nishant,7,0,50,43
1657168096398,CSE 100,A01,083659,Cao; Yingjun,4,4,70,66
1657168102421,CSE 134B,A01,083661,Powell; Thomas Allan,20,0,100,80
1657168108445,CSE 140,A01,083663,Gungor; Onat,13,0,85,72
1657168114469,CSE 140L,A01,083088,Eldon; John,17,0,100,83
1657168120494,CSE 175,A01,083665,Kumar; Rakesh,3,0,25,22
1657168126518,CSE 190,A00,092507,Dubnov; Shlomo,7,0,20,13
1657168132545,ECE 45,A01,083139,Congero; Spencer William,5,0,75,70
1657168138568,ECE 65,A50,083695,Saad; Andrew S,12,0,30,18
1657168138568,ECE 65,A51,095125,Saad; Andrew S,25,0,26,1
1657168144592,ECE 109,A01,091882,Touri; Behrouz,18,0,70,52
1657168150622,ECE 180,A00,083140,Abi Samra; Nicholas Camill,1,0,30,29
1657168150622,ECE 180,B00,083141,Abi Samra; Nicholas Camill,0,0,30,30
1657168156645,MATH 10A,A01,083735,Patchell; Gregory David,2,0,30,28
1657168156645,MATH 10A,A02,083736,Patchell; Gregory David,20,0,30,10
1657168156645,MATH 10A,A03,083737,Patchell; Gregory David,16,0,30,14
1657168162668,MATH 10B,A01,083207,Lim; Seonhee,7,0,34,27
1657168162668,MATH 10B,A02,083208,Lim; Seonhee,9,0,35,26
1657168162668,MATH 10B,A03,093472,Lim; Seonhee,5,0,34,29
1657168162668,MATH 10B,B01,083739,Sinha; Shubham,9,0,30,21
1657168168691,MATH 18,A01,083743,Cinel; Cameron Alexander,6,0,30,24
1657168168691,MATH 18,A02,083744,Cinel; Cameron Alexander,15,0,30,15
1657168168691,MATH 18,A03,083745,Cinel; Cameron Alexander,8,0,30,22
1657168168691,MATH 18,B01,083748,Rideout; David Porter,4,0,37,33
1657168168691,MATH 18,B02,083749,Rideout; David Porter,4,0,36,32
1657168168691,MATH 18,B03,083750,Rideout; David Porter,2,0,37,35
1657168168691,MATH 18,B04,083751,Rideout; David Porter,5,0,36,31
1657168168691,MATH 18,B05,093473,Rideout; David Porter,5,0,36,31
1657168168691,MATH 18,B06,093474,Rideout; David Porter,5,0,36,31
1657168174713,MATH 20A,A01,083754,Zheng; Zequn,12,0,40,28
1657168180736,MATH 20B,A01,083756,Briones; Jor-el Thomas Caparas,1,0,36,35
1657168180736,MATH 20B,A02,083757,Briones; Jor-el Thomas Caparas,1,0,36,35
1657168180736,MATH 20B,A03,093475,Briones; Jor-el Thomas Caparas,1,0,36,35
1657168186762,MATH 20C,A01,083760,Briones; Jor-el Thomas Caparas,1,0,35,34
1657168186762,MATH 20C,A02,083761,Briones; Jor-el Thomas Caparas,8,0,35,27
1657168186762,MATH 20C,A03,093476,Briones; Jor-el Thomas Caparas,0,1,36,36
1657168186762,MATH 20C,B01,083762,Bach; Quang Tran,1,0,30,29
1657168192785,MATH 20D,A01,083765,Tran; Brian Kha,4,0,30,26
1657168192785,MATH 20D,A02,083766,Tran; Brian Kha,5,0,30,25
1657168192785,MATH 20D,A03,083767,Tran; Brian Kha,3,0,30,27
1657168198817,MATH 20E,A01,083771,Ganguly; Soumya,7,0,32,25
1657168198817,MATH 20E,A02,083772,Ganguly; Soumya,7,0,32,25
1657168198817,MATH 20E,B01,083773,Ciotti; Benjamin,19,0,35,16
1657168198817,MATH 20E,B02,083774,Ciotti; Benjamin,17,0,35,18
1657168204840,MATH 103A,A01,083777,Greenfeld; Be'Eri,2,0,36,34
1657168204840,MATH 103A,A02,083778,Greenfeld; Be'Eri,5,0,36,31
1657168204840,MATH 103A,A03,093561,Greenfeld; Be'Eri,4,0,36,32
1657168204840,MATH 103A,B01,083779,Greenfeld; Be'Eri,6,0,36,30
1657168204840,MATH 103A,B02,083780,Greenfeld; Be'Eri,3,0,36,33
1657168204840,MATH 103A,B03,093562,Greenfeld; Be'Eri,3,0,36,33
1657168210867,MATH 105,A01,085443,Carter; Anne Toulson,14,0,35,21
1657168210867,MATH 105,A02,093477,Carter; Anne Toulson,20,0,35,15
1657168216891,MATH 109,A01,083213,Ganzberger; Geoffrey Michael,2,0,34,32
1657168216891,MATH 109,A02,083214,Ganzberger; Geoffrey Michael,3,0,34,31
1657168216891,MATH 109,A03,093478,Ganzberger; Geoffrey Michael,1,0,34,33
1657168216891,MATH 109,B01,083215,Ganzberger; Geoffrey Michael,1,0,32,31
1657168216891,MATH 109,B02,083216,Ganzberger; Geoffrey Michael,1,0,32,31
1657168216891,MATH 109,B03,093479,Ganzberger; Geoffrey Michael,6,0,32,26
1657168222916,MATH 142A,A01,083219,Chow; Bennett,6,0,32,26
1657168222916,MATH 142A,A02,083220,Chow; Bennett,10,0,32,22
1657168222916,MATH 142A,A03,093480,Chow; Bennett,7,0,32,25
1657168222916,MATH 142A,B03,093481,Chow; Bennett,8,0,32,24
1657168222916,MATH 142A,B04,093558,Chow; Bennett,11,0,32,21
1657168222916,MATH 142A,B05,093559,Chow; Bennett,6,0,32,26
1657168228946,MATH 193A,A01,083224,Rotar; Vladimir,7,0,34,27
1657168228946,MATH 193A,A02,083225,Rotar; Vladimir,5,0,34,29
1657168228946,MATH 193A,A03,083781,Rotar; Vladimir,1,0,34,33
1657168228946,MATH 193A,A04,083782,Rotar; Vladimir,8,0,34,26
1657168228946,MATH 193A,A05,093482,Rotar; Vladimir,6,0,34,28
1657168234969,MATH 197,001,091859,McAuley; Julian John,9999,0,9999,0
1657168234969,MATH 197,002,095566,Kedlaya; Kiran S.,9997,0,9999,2
1657168234969,MATH 197,003,095567,Xiao; Ming,9999,0,9999,0
1657168234969,MATH 197,004,095571,Perols; Johan Lars,9998,0,9999,1
1657168242027,COGS 9,A01,083615,Shannon; Kyle Michael,7,0,75,68
1657168248051,COGS 11,A01,083617,Boyle; Mary E. T.,22,0,48,26
1657168254078,COGS 13,A01,083071,Bastos; Amalia Pinkusfeld,9,0,71,62
1657168260106,COGS 14A,A01,092681,Semenuks; Arturs,1,1,100,99
1657168266132,COGS 14B,A01,083073,Cheng; Tzu-Han,6,0,63,57
1657168272155,COGS 17,A01,092677,Semenuks; Arturs,4,0,81,77
1657168278178,COGS 100,A01,083619,Allen; Michael Gordon,15,0,70,55
1657168284202,COGS 101A,A01,083621,Davis; Joshua Daniel,9,0,68,59
1657168290226,COGS 101B,A01,091572,Allen; Michael Gordon,9,0,65,56
1657168296249,COGS 101C,A01,083625,Delgado; Tania,17,0,35,18
1657168302286,COGS 107A,A01,083627,Boyle; Mary E. T.,13,0,60,47
1657168308315,COGS 118A,A01,083075,Gupta; Anjum,16,0,76,60
1657168314344,CSE 3,A50,083646,Miranda; Gregory Joseph,24,0,50,26
1657168320377,CSE 8A,A50,083650,Miranda; Gregory Joseph,17,1,56,39
1657168326399,CSE 11,A01,083080,Cao; Yingjun,5,15,40,35
1657168332495,CSE 12,A01,083652,Krause-Levy; Sophia Louisa,24,1,120,96
1657168338519,CSE 15L,A01,083654,Morris; Justin Loren,9,0,50,41
1657168338519,CSE 15L,A02,083655,Morris; Justin Loren,9,0,50,41
1657168344551,CSE 20,A01,083657,Tran; Khoa Dang,38,0,80,42
1657168350584,CSE 21,A01,095574,Bach; Quang Tran,22,0,48,26
1657168356608,CSE 30,A01,083084,Eldon; John,4,0,80,76
1657168356608,CSE 30,B01,095061,Bhaskar; Nishant,7,0,50,43
1657168362642,CSE 100,A01,083659,Cao; Yingjun,4,4,70,66
1657168368664,CSE 134B,A01,083661,Powell; Thomas Allan,20,0,100,80
1657168374688,CSE 140,A01,083663,Gungor; Onat,13,0,85,72
1657168380710,CSE 140L,A01,083088,Eldon; John,17,0,100,83
1657168386733,CSE 175,A01,083665,Kumar; Rakesh,3,0,25,22
1657168392787,CSE 190,A00,092507,Dubnov; Shlomo,7,0,20,13
1657168398809,ECE 45,A01,083139,Congero; Spencer William,5,0,75,70
1657168404837,ECE 65,A50,083695,Saad; Andrew S,12,0,30,18
1657168404837,ECE 65,A51,095125,Saad; Andrew S,25,0,26,1
1657168410860,ECE 109,A01,091882,Touri; Behrouz,18,0,70,52
1657168416883,ECE 180,A00,083140,Abi Samra; Nicholas Camill,1,0,30,29
1657168416883,ECE 180,B00,083141,Abi Samra; Nicholas Camill,0,0,30,30
1657168422906,MATH 10A,A01,083735,Patchell; Gregory David,2,0,30,28
1657168422906,MATH 10A,A02,083736,Patchell; Gregory David,20,0,30,10
1657168422906,MATH 10A,A03,083737,Patchell; Gregory David,16,0,30,14
1657168428932,MATH 10B,A01,083207,Lim; Seonhee,7,0,34,27
1657168428932,MATH 10B,A02,083208,Lim; Seonhee,9,0,35,26
1657168428932,MATH 10B,A03,093472,Lim; Seonhee,5,0,34,29
1657168428932,MATH 10B,B01,083739,Sinha; Shubham,9,0,30,21
1657168434955,MATH 18,A01,083743,Cinel; Cameron Alexander,6,0,30,24
1657168434955,MATH 18,A02,083744,Cinel; Cameron Alexander,15,0,30,15
1657168434955,MATH 18,A03,083745,Cinel; Cameron Alexander,8,0,30,22
1657168434955,MATH 18,B01,083748,Rideout; David Porter,4,0,37,33
1657168434955,MATH 18,B02,083749,Rideout; David Porter,4,0,36,32
1657168434955,MATH 18,B03,083750,Rideout; David Porter,2,0,37,35
1657168434955,MATH 18,B04,083751,Rideout; David Porter,5,0,36,31
1657168434955,MATH 18,B05,093473,Rideout; David Porter,5,0,36,31
1657168434955,MATH 18,B06,093474,Rideout; David Porter,5,0,36,31
1657168440983,MATH 20A,A01,083754,Zheng; Zequn,12,0,40,28
1657168447007,MATH 20B,A01,083756,Briones; Jor-el Thomas Caparas,1,0,36,35
1657168447007,MATH 20B,A02,083757,Briones; Jor-el Thomas Caparas,1,0,36,35
1657168447007,MATH 20B,A03,093475,Briones; Jor-el Thomas Caparas,1,0,36,35
1657168453037,MATH 20C,A01,083760,Briones; Jor-el Thomas Caparas,1,0,35,34
1657168453037,MATH 20C,A02,083761,Briones; Jor-el Thomas Caparas,8,0,35,27
1657168453037,MATH 20C,A03,093476,Briones; Jor-el Thomas Caparas,0,1,36,36
1657168453037,MATH 20C,B01,083762,Bach; Quang Tran,1,0,30,29
1657168459065,MATH 20D,A01,083765,Tran; Brian Kha,4,0,30,26
1657168459065,MATH 20D,A02,083766,Tran; Brian Kha,5,0,30,25
1657168459065,MATH 20D,A03,083767,Tran; Brian Kha,3,0,30,27
1657168465088,MATH 20E,A01,083771,Ganguly; Soumya,7,0,32,25
1657168465088,MATH 20E,A02,083772,Ganguly; Soumya,7,0,32,25
1657168465088,MATH 20E,B01,083773,Ciotti; Benjamin,19,0,35,16
1657168465088,MATH 20E,B02,083774,Ciotti; Benjamin,17,0,35,18
1657168471111,MATH 103A,A01,083777,Greenfeld; Be'Eri,2,0,36,34
1657168471111,MATH 103A,A02,083778,Greenfeld; Be'Eri,5,0,36,31
1657168471111,MATH 103A,A03,093561,Greenfeld; Be'Eri,4,0,36,32
1657168471111,MATH 103A,B01,083779,Greenfeld; Be'Eri,6,0,36,30
1657168471111,MATH 103A,B02,083780,Greenfeld; Be'Eri,3,0,36,33
1657168471111,MATH 103A,B03,093562,Greenfeld; Be'Eri,3,0,36,33
1657168477134,MATH 105,A01,085443,Carter; Anne Toulson,14,0,35,21
1657168477134,MATH 105,A02,093477,Carter; Anne Toulson,20,0,35,15
1657168483156,MATH 109,A01,083213,Ganzberger; Geoffrey Michael,2,0,34,32
1657168483156,MATH 109,A02,083214,Ganzberger; Geoffrey Michael,3,0,34,31
1657168483156,MATH 109,A03,093478,Ganzberger; Geoffrey Michael,1,0,34,33
1657168483156,MATH 109,B01,083215,Ganzberger; Geoffrey Michael,1,0,32,31
1657168483156,MATH 109,B02,083216,Ganzberger; Geoffrey Michael,1,0,32,31
1657168483156,MATH 109,B03,093479,Ganzberger; Geoffrey Michael,6,0,32,26
1657168489186,MATH 142A,A01,083219,Chow; Bennett,6,0,32,26
1657168489186,MATH 142A,A02,083220,Chow; Bennett,10,0,32,22
1657168489186,MATH 142A,A03,093480,Chow; Bennett,7,0,32,25
1657168489186,MATH 142A,B03,093481,Chow; Bennett,8,0,32,24
1657168489186,MATH 142A,B04,093558,Chow; Bennett,11,0,32,21
1657168489186,MATH 142A,B05,093559,Chow; Bennett,6,0,32,26
1657168495221,MATH 193A,A01,083224,Rotar; Vladimir,7,0,34,27
1657168495221,MATH 193A,A02,083225,Rotar; Vladimir,5,0,34,29
1657168495221,MATH 193A,A03,083781,Rotar; Vladimir,1,0,34,33
1657168495221,MATH 193A,A04,083782,Rotar; Vladimir,8,0,34,26
1657168495221,MATH 193A,A05,093482,Rotar; Vladimir,6,0,34,28
1657168501245,MATH 197,001,091859,McAuley; Julian John,9999,0,9999,0
1657168501245,MATH 197,002,095566,Kedlaya; Kiran S.,9997,0,9999,2
1657168501245,MATH 197,003,095567,Xiao; Ming,9999,0,9999,0
1657168501245,MATH 197,004,095571,Perols; Johan Lars,9998,0,9999,1
1657168508306,COGS 9,A01,083615,Shannon; Kyle Michael,7,0,75,68
1657168514333,COGS 11,A01,083617,Boyle; Mary E. T.,22,0,48,26
1657168520360,COGS 13,A01,083071,Bastos; Amalia Pinkusfeld,9,0,71,62
1657168526389,COGS 14A,A01,092681,Semenuks; Arturs,1,1,100,99
1657168532412,COGS 14B,A01,083073,Cheng; Tzu-Han,6,0,63,57
1657168538436,COGS 17,A01,092677,Semenuks; Arturs,4,0,81,77
1657168544459,COGS 100,A01,083619,Allen; Michael Gordon,15,0,70,55
1657168550487,COGS 101A,A01,083621,Davis; Joshua Daniel,9,0,68,59
1657168556523,COGS 101B,A01,091572,Allen; Michael Gordon,9,0,65,56
1657168562547,COGS 101C,A01,083625,Delgado; Tania,17,0,35,18
1657168568571,COGS 107A,A01,083627,Boyle; Mary E. T.,13,0,60,47
1657168574594,COGS 118A,A01,083075,Gupta; Anjum,16,0,76,60
1657168580617,CSE 3,A50,083646,Miranda; Gregory Joseph,24,0,50,26
1657168586641,CSE 8A,A50,083650,Miranda; Gregory Joseph,17,1,56,39
1657168592668,CSE 11,A01,083080,Cao; Yingjun,5,15,40,35
1657168598698,CSE 12,A01,083652,Krause-Levy; Sophia Louisa,24,1,120,96
1657168604740,CSE 15L,A01,083654,Morris; Justin Loren,9,0,50,41
1657168604740,CSE 15L,A02,083655,Morris; Justin Loren,9,0,50,41
1657168610767,CSE 20,A01,083657,Tran; Khoa Dang,38,0,80,42
1657168616791,CSE 21,A01,095574,Bach; Quang Tran,22,0,48,26
1657168622824,CSE 30,A01,083084,Eldon; John,4,0,80,76
1657168622824,CSE 30,B01,095061,Bhaskar; Nishant,7,0,50,43
1657168628846,CSE 100,A01,083659,Cao; Yingjun,4,4,70,66
1657168634871,CSE 134B,A01,083661,Powell; Thomas Allan,20,0,100,80
1657168640894,CSE 140,A01,083663,Gungor; Onat,13,0,85,72
1657168646918,CSE 140L,A01,083088,Eldon; John,17,0,100,83
1657168652945,CSE 175,A01,083665,Kumar; Rakesh,3,0,25,22
1657168658969,CSE 190,A00,092507,Dubnov; Shlomo,7,0,20,13
1657168664996,ECE 45,A01,083139,Congero; Spencer William,5,0,75,70
1657168671023,ECE 65,A50,083695,Saad; Andrew S,12,0,30,18
1657168671023,ECE 65,A51,095125,Saad; Andrew S,25,0,26,1
1657168677048,ECE 109,A01,091882,Touri; Behrouz,18,0,70,52
1657168683071,ECE 180,A00,083140,Abi Samra; Nicholas Camill,1,0,30,29
1657168683071,ECE 180,B00,083141,Abi Samra; Nicholas Camill,0,0,30,30
1657168689099,MATH 10A,A01,083735,Patchell; Gregory David,2,0,30,28
1657168689099,MATH 10A,A02,083736,Patchell; Gregory David,20,0,30,10
1657168689099,MATH 10A,A03,083737,Patchell; Gregory David,16,0,30,14
1657168695122,MATH 10B,A01,083207,Lim; Seonhee,7,0,34,27
1657168695122,MATH 10B,A02,083208,Lim; Seonhee,9,0,35,26
1657168695122,MATH 10B,A03,093472,Lim; Seonhee,5,0,34,29
1657168695122,MATH 10B,B01,083739,Sinha; Shubham,9,0,30,21
1657168701153,MATH 18,A01,083743,Cinel; Cameron Alexander,6,0,30,24
1657168701153,MATH 18,A02,083744,Cinel; Cameron Alexander,15,0,30,15
1657168701153,MATH 18,A03,083745,Cinel; Cameron Alexander,8,0,30,22
1657168701153,MATH 18,B01,083748,Rideout; David Porter,4,0,37,33
1657168701153,MATH 18,B02,083749,Rideout; David Porter,4,0,36,32
1657168701153,MATH 18,B03,083750,Rideout; David Porter,2,0,37,35
1657168701153,MATH 18,B04,083751,Rideout; David Porter,5,0,36,31
1657168701153,MATH 18,B05,093473,Rideout; David Porter,5,0,36,31
1657168701153,MATH 18,B06,093474,Rideout; David Porter,5,0,36,31
1657168707177,MATH 20A,A01,083754,Zheng; Zequn,12,0,40,28
1657168713199,MATH 20B,A01,083756,Briones; Jor-el Thomas Caparas,1,0,36,35
1657168713199,MATH 20B,A02,083757,Briones; Jor-el Thomas Caparas,1,0,36,35
1657168713199,MATH 20B,A03,093475,Briones; Jor-el Thomas Caparas,1,0,36,35
1657168719228,MATH 20C,A01,083760,Briones; Jor-el Thomas Caparas,1,0,35,34
1657168719228,MATH 20C,A02,083761,Briones; Jor-el Thomas Caparas,8,0,35,27
1657168719228,MATH 20C,A03,093476,Briones; Jor-el Thomas Caparas,0,1,36,36
1657168719228,MATH 20C,B01,083762,Bach; Quang Tran,1,0,30,29
1657168725251,MATH 20D,A01,083765,Tran; Brian Kha,4,0,30,26
1657168725251,MATH 20D,A02,083766,Tran; Brian Kha,5,0,30,25
1657168725251,MATH 20D,A03,083767,Tran; Brian Kha,3,0,30,27
1657168731279,MATH 20E,A01,083771,Ganguly; Soumya,7,0,32,25
1657168731279,MATH 20E,A02,083772,Ganguly; Soumya,7,0,32,25
1657168731279,MATH 20E,B01,083773,Ciotti; Benjamin,19,0,35,16
1657168731279,MATH 20E,B02,083774,Ciotti; Benjamin,17,0,35,18
1657168737313,MATH 103A,A01,083777,Greenfeld; Be'Eri,2,0,36,34
1657168737313,MATH 103A,A02,083778,Greenfeld; Be'Eri,5,0,36,31
1657168737313,MATH 103A,A03,093561,Greenfeld; Be'Eri,4,0,36,32
1657168737313,MATH 103A,B01,083779,Greenfeld; Be'Eri,6,0,36,30
1657168737313,MATH 103A,B02,083780,Greenfeld; Be'Eri,3,0,36,33
1657168737313,MATH 103A,B03,093562,Greenfeld; Be'Eri,3,0,36,33
1657168743336,MATH 105,A01,085443,Carter; Anne Toulson,14,0,35,21
1657168743336,MATH 105,A02,093477,Carter; Anne Toulson,20,0,35,15
1657168749365,MATH 109,A01,083213,Ganzberger; Geoffrey Michael,2,0,34,32
1657168749365,MATH 109,A02,083214,Ganzberger; Geoffrey Michael,3,0,34,31
1657168749365,MATH 109,A03,093478,Ganzberger; Geoffrey Michael,1,0,34,33
1657168749365,MATH 109,B01,083215,Ganzberger; Geoffrey Michael,1,0,32,31
1657168749365,MATH 109,B02,083216,Ganzberger; Geoffrey Michael,1,0,32,31
1657168749365,MATH 109,B03,093479,Ganzberger; Geoffrey Michael,6,0,32,26
1657168755395,MATH 142A,A01,083219,Chow; Bennett,6,0,32,26
1657168755395,MATH 142A,A02,083220,Chow; Bennett,10,0,32,22
1657168755395,MATH 142A,A03,093480,Chow; Bennett,7,0,32,25
1657168755395,MATH 142A,B03,093481,Chow; Bennett,8,0,32,24
1657168755395,MATH 142A,B04,093558,Chow; Bennett,11,0,32,21
1657168755395,MATH 142A,B05,093559,Chow; Bennett,6,0,32,26
1657168761422,MATH 193A,A01,083224,Rotar; Vladimir,7,0,34,27
1657168761422,MATH 193A,A02,083225,Rotar; Vladimir,5,0,34,29
1657168761422,MATH 193A,A03,083781,Rotar; Vladimir,1,0,34,33
1657168761422,MATH 193A,A04,083782,Rotar; Vladimir,8,0,34,26
1657168761422,MATH 193A,A05,093482,Rotar; Vladimir,6,0,34,28
1657168767448,MATH 197,001,091859,McAuley; Julian John,9999,0,9999,0
1657168767448,MATH 197,002,095566,Kedlaya; Kiran S.,9997,0,9999,2
1657168767448,MATH 197,003,095567,Xiao; Ming,9999,0,9999,0
1657168767448,MATH 197,004,095571,Perols; Johan Lars,9998,0,9999,1
1657168774501,COGS 9,A01,083615,Shannon; Kyle Michael,7,0,75,68
1657168780529,COGS 11,A01,083617,Boyle; Mary E. T.,22,0,48,26
1657168786560,COGS 13,A01,083071,Bastos; Amalia Pinkusfeld,9,0,71,62
1657168792582,COGS 14A,A01,092681,Semenuks; Arturs,1,1,100,99
1657168798606,COGS 14B,A01,083073,Cheng; Tzu-Han,6,0,63,57
1657168804632,COGS 17,A01,092677,Semenuks; Arturs,4,0,81,77
1657168810656,COGS 100,A01,083619,Allen; Michael Gordon,15,0,70,55
1657168816683,COGS 101A,A01,083621,Davis; Joshua Daniel,9,0,68,59
1657168822710,COGS 101B,A01,091572,Allen; Michael Gordon,9,0,65,56
1657168828731,COGS 101C,A01,083625,Delgado; Tania,17,0,35,18
1657168834755,COGS 107A,A01,083627,Boyle; Mary E. T.,13,0,60,47
1657168840777,COGS 118A,A01,083075,Gupta; Anjum,16,0,76,60
1657168846803,CSE 3,A50,083646,Miranda; Gregory Joseph,24,0,50,26
1657168852836,CSE 8A,A50,083650,Miranda; Gregory Joseph,17,1,56,39
1657168858859,CSE 11,A01,083080,Cao; Yingjun,5,15,40,35
1657168864885,CSE 12,A01,083652,Krause-Levy; Sophia Louisa,24,1,120,96
1657168870910,CSE 15L,A01,083654,Morris; Justin Loren,9,0,50,41
1657168870910,CSE 15L,A02,083655,Morris; Justin Loren,9,0,50,41
1657168876933,CSE 20,A01,083657,Tran; Khoa Dang,38,0,80,42
1657168882956,CSE 21,A01,095574,Bach; Quang Tran,22,0,48,26
1657168888984,CSE 30,A01,083084,Eldon; John,4,0,80,76
1657168888984,CSE 30,B01,095061,Bhaskar; Nishant,7,0,50,43
1657168895006,CSE 100,A01,083659,Cao; Yingjun,4,4,70,66
1657168901029,CSE 134B,A01,083661,Powell; Thomas Allan,20,0,100,80
1657168907052,CSE 140,A01,083663,Gungor; Onat,13,0,85,72
1657168913076,CSE 140L,A01,083088,Eldon; John,17,0,100,83
1657168919097,CSE 175,A01,083665,Kumar; Rakesh,3,0,25,22
1657168925121,CSE 190,A00,092507,Dubnov; Shlomo,7,0,20,13
1657168931219,ECE 45,A01,083139,Congero; Spencer William,5,0,75,70
1657168937246,ECE 65,A50,083695,Saad; Andrew S,12,0,30,18
1657168937246,ECE 65,A51,095125,Saad; Andrew S,25,0,26,1
1657168943271,ECE 109,A01,091882,Touri; Behrouz,18,0,70,52
1657168949295,ECE 180,A00,083140,Abi Samra; Nicholas Camill,1,0,30,29
1657168949295,ECE 180,B00,083141,Abi Samra; Nicholas Camill,0,0,30,30
1657168955319,MATH 10A,A01,083735,Patchell; Gregory David,2,0,30,28
1657168955319,MATH 10A,A02,083736,Patchell; Gregory David,20,0,30,10
1657168955319,MATH 10A,A03,083737,Patchell; Gregory David,16,0,30,14
1657168961347,MATH 10B,A01,083207,Lim; Seonhee,7,0,34,27
1657168961347,MATH 10B,A02,083208,Lim; Seonhee,9,0,35,26
1657168961347,MATH 10B,A03,093472,Lim; Seonhee,5,0,34,29
1657168961347,MATH 10B,B01,083739,Sinha; Shubham,9,0,30,21
1657168967377,MATH 18,A01,083743,Cinel; Cameron Alexander,6,0,30,24
1657168967377,MATH 18,A02,083744,Cinel; Cameron Alexander,15,0,30,15
1657168967377,MATH 18,A03,083745,Cinel; Cameron Alexander,8,0,30,22
1657168967377,MATH 18,B01,083748,Rideout; David Porter,4,0,37,33
1657168967377,MATH 18,B02,083749,Rideout; David Porter,4,0,36,32
1657168967377,MATH 18,B03,083750,Rideout; David Porter,2,0,37,35
1657168967377,MATH 18,B04,083751,Rideout; David Porter,5,0,36,31
1657168967377,MATH 18,B05,093473,Rideout; David Porter,5,0,36,31
1657168967377,MATH 18,B06,093474,Rideout; David Porter,5,0,36,31
1657168973404,MATH 20A,A01,083754,Zheng; Zequn,12,0,40,28
1657168979427,MATH 20B,A01,083756,Briones; Jor-el Thomas Caparas,1,0,36,35
1657168979427,MATH 20B,A02,083757,Briones; Jor-el Thomas Caparas,1,0,36,35
1657168979427,MATH 20B,A03,093475,Briones; Jor-el Thomas Caparas,1,0,36,35
1657168985451,MATH 20C,A01,083760,Briones; Jor-el Thomas Caparas,1,0,35,34
1657168985451,MATH 20C,A02,083761,Briones; Jor-el Thomas Caparas,8,0,35,27
1657168985451,MATH 20C,A03,093476,Briones; Jor-el Thomas Caparas,0,1,36,36
1657168985451,MATH 20C,B01,083762,Bach; Quang Tran,1,0,30,29
1657168991479,MATH 20D,A01,083765,Tran; Brian Kha,4,0,30,26
1657168991479,MATH 20D,A02,083766,Tran; Brian Kha,5,0,30,25
1657168991479,MATH 20D,A03,083767,Tran; Brian Kha,3,0,30,27
1657168997502,MATH 20E,A01,083771,Ganguly; Soumya,7,0,32,25
1657168997502,MATH 20E,A02,083772,Ganguly; Soumya,7,0,32,25
1657168997502,MATH 20E,B01,083773,Ciotti; Benjamin,19,0,35,16
1657168997502,MATH 20E,B02,083774,Ciotti; Benjamin,17,0,35,18
1657169003530,MATH 103A,A01,083777,Greenfeld; Be'Eri,2,0,36,34
1657169003530,MATH 103A,A02,083778,Greenfeld; Be'Eri,5,0,36,31
1657169003530,MATH 103A,A03,093561,Greenfeld; Be'Eri,4,0,36,32
1657169003530,MATH 103A,B01,083779,Greenfeld; Be'Eri,6,0,36,30
1657169003530,MATH 103A,B02,083780,Greenfeld; Be'Eri,3,0,36,33
1657169003530,MATH 103A,B03,093562,Greenfeld; Be'Eri,3,0,36,33
1657169009551,MATH 105,A01,085443,Carter; Anne Toulson,14,0,35,21
1657169009551,MATH 105,A02,093477,Carter; Anne Toulson,20,0,35,15
1657169015578,MATH 109,A01,083213,Ganzberger; Geoffrey Michael,2,0,34,32
1657169015578,MATH 109,A02,083214,Ganzberger; Geoffrey Michael,3,0,34,31
1657169015578,MATH 109,A03,093478,Ganzberger; Geoffrey Michael,1,0,34,33
1657169015578,MATH 109,B01,083215,Ganzberger; Geoffrey Michael,1,0,32,31
1657169015578,MATH 109,B02,083216,Ganzberger; Geoffrey Michael,1,0,32,31
1657169015578,MATH 109,B03,093479,Ganzberger; Geoffrey Michael,6,0,32,26
1657169021608,MATH 142A,A01,083219,Chow; Bennett,6,0,32,26
1657169021608,MATH 142A,A02,083220,Chow; Bennett,10,0,32,22
1657169021608,MATH 142A,A03,093480,Chow; Bennett,7,0,32,25
1657169021608,MATH 142A,B03,093481,Chow; Bennett,8,0,32,24
1657169021608,MATH 142A,B04,093558,Chow; Bennett,11,0,32,21
1657169021608,MATH 142A,B05,093559,Chow; Bennett,6,0,32,26
1657169027631,MATH 193A,A01,083224,Rotar; Vladimir,7,0,34,27
1657169027631,MATH 193A,A02,083225,Rotar; Vladimir,5,0,34,29
1657169027631,MATH 193A,A03,083781,Rotar; Vladimir,1,0,34,33
1657169027631,MATH 193A,A04,083782,Rotar; Vladimir,8,0,34,26
1657169027631,MATH 193A,A05,093482,Rotar; Vladimir,6,0,34,28
1657169033656,MATH 197,001,091859,McAuley; Julian John,9999,0,9999,0
1657169033656,MATH 197,002,095566,Kedlaya; Kiran S.,9997,0,9999,2
1657169033656,MATH 197,003,095567,Xiao; Ming,9999,0,9999,0
1657169033656,MATH 197,004,095571,Perols; Johan Lars,9998,0,9999,1
1657169040720,COGS 9,A01,083615,Shannon; Kyle Michael,7,0,75,68
1657169046744,COGS 11,A01,083617,Boyle; Mary E. T.,22,0,48,26
1657169052769,COGS 13,A01,083071,Bastos; Amalia Pinkusfeld,9,0,71,62
1657169058798,COGS 14A,A01,092681,Semenuks; Arturs,1,1,100,99
1657169064821,COGS 14B,A01,083073,Cheng; Tzu-Han,6,0,63,57
1657169070844,COGS 17,A01,092677,Semenuks; Arturs,4,0,81,77
1657169076868,COGS 100,A01,083619,Allen; Michael Gordon,15,0,70,55
1657169082892,COGS 101A,A01,083621,Davis; Joshua Daniel,9,0,68,59
1657169088915,COGS 101B,A01,091572,Allen; Michael Gordon,9,0,65,56
1657169094937,COGS 101C,A01,083625,Delgado; Tania,17,0,35,18
1657169100960,COGS 107A,A01,083627,Boyle; Mary E. T.,13,0,60,47
1657169106985,COGS 118A,A01,083075,Gupta; Anjum,16,0,76,60
1657169113011,CSE 3,A50,083646,Miranda; Gregory Joseph,24,0,50,26
1657169119035,CSE 8A,A50,083650,Miranda; Gregory Joseph,17,1,56,39
1657169125059,CSE 11,A01,083080,Cao; Yingjun,5,15,40,35
1657169131080,CSE 12,A01,083652,Krause-Levy; Sophia Louisa,24,1,120,96
1657169137104,CSE 15L,A01,083654,Morris; Justin Loren,9,0,50,41
1657169137104,CSE 15L,A02,083655,Morris; Justin Loren,9,0,50,41
1657169143127,CSE 20,A01,083657,Tran; Khoa Dang,38,0,80,42
1657169149151,CSE 21,A01,095574,Bach; Quang Tran,22,0,48,26
1657169155187,CSE 30,A01,083084,Eldon; John,4,0,80,76
1657169155187,CSE 30,B01,095061,Bhaskar; Nishant,7,0,50,43
1657169161211,CSE 100,A01,083659,Cao; Yingjun,4,4,70,66
1657169167240,CSE 134B,A01,083661,Powell; Thomas Allan,20,0,100,80
1657169173265,CSE 140,A01,083663,Gungor; Onat,13,0,85,72
1657169179287,CSE 140L,A01,083088,Eldon; John,17,0,100,83
1657169185311,CSE 175,A01,083665,Kumar; Rakesh,3,0,25,22
1657169191335,CSE 190,A00,092507,Dubnov; Shlomo,7,0,20,13
1657169197365,ECE 45,A01,083139,Congero; Spencer William,5,0,75,70
1657169203392,ECE 65,A50,083695,Saad; Andrew S,12,0,30,18
1657169203392,ECE 65,A51,095125,Saad; Andrew S,25,0,26,1
1657169209419,ECE 109,A01,091882,Touri; Behrouz,18,0,70,52
1657169215442,ECE 180,A00,083140,Abi Samra; Nicholas Camill,1,0,30,29
1657169215442,ECE 180,B00,083141,Abi Samra; Nicholas Camill,0,0,30,30
1657169221470,MATH 10A,A01,083735,Patchell; Gregory David,2,0,30,28
1657169221470,MATH 10A,A02,083736,Patchell; Gregory David,20,0,30,10
1657169221470,MATH 10A,A03,083737,Patchell; Gregory David,16,0,30,14
1657169227494,MATH 10B,A01,083207,Lim; Seonhee,7,0,34,27
1657169227494,MATH 10B,A02,083208,Lim; Seonhee,9,0,35,26
1657169227494,MATH 10B,A03,093472,Lim; Seonhee,5,0,34,29
1657169227494,MATH 10B,B01,083739,Sinha; Shubham,9,0,30,21
1657169233526,MATH 18,A01,083743,Cinel; Cameron Alexander,6,0,30,24
1657169233526,MATH 18,A02,083744,Cinel; Cameron Alexander,15,0,30,15
1657169233526,MATH 18,A03,083745,Cinel; Cameron Alexander,8,0,30,22
1657169233526,MATH 18,B01,083748,Rideout; David Porter,4,0,37,33
1657169233526,MATH 18,B02,083749,Rideout; David Porter,4,0,36,32
1657169233526,MATH 18,B03,083750,Rideout; David Porter,2,0,37,35
1657169233526,MATH 18,B04,083751,Rideout; David Porter,5,0,36,31
1657169233526,MATH 18,B05,093473,Rideout; David Porter,5,0,36,31
1657169233526,MATH 18,B06,093474,Rideout; David Porter,5,0,36,31
1657169239554,MATH 20A,A01,083754,Zheng; Zequn,12,0,40,28
1657169245577,MATH 20B,A01,083756,Briones; Jor-el Thomas Caparas,1,0,36,35
1657169245577,MATH 20B,A02,083757,Briones; Jor-el Thomas Caparas,1,0,36,35
1657169245577,MATH 20B,A03,093475,Briones; Jor-el Thomas Caparas,1,0,36,35
1657169251599,MATH 20C,A01,083760,Briones; Jor-el Thomas Caparas,1,0,35,34
1657169251599,MATH 20C,A02,083761,Briones; Jor-el Thomas Caparas,8,0,35,27
1657169251599,MATH 20C,A03,093476,Briones; Jor-el Thomas Caparas,0,1,36,36
1657169251599,MATH 20C,B01,083762,Bach; Quang Tran,1,0,30,29
1657169257628,MATH 20D,A01,083765,Tran; Brian Kha,4,0,30,26
1657169257628,MATH 20D,A02,083766,Tran; Brian Kha,5,0,30,25
1657169257628,MATH 20D,A03,083767,Tran; Brian Kha,3,0,30,27
1657169263653,MATH 20E,A01,083771,Ganguly; Soumya,7,0,32,25
1657169263653,MATH 20E,A02,083772,Ganguly; Soumya,7,0,32,25
1657169263653,MATH 20E,B01,083773,Ciotti; Benjamin,19,0,35,16
1657169263653,MATH 20E,B02,083774,Ciotti; Benjamin,17,0,35,18
1657169269683,MATH 103A,A01,083777,Greenfeld; Be'Eri,2,0,36,34
1657169269683,MATH 103A,A02,083778,Greenfeld; Be'Eri,5,0,36,31
1657169269683,MATH 103A,A03,093561,Greenfeld; Be'Eri,4,0,36,32
1657169269683,MATH 103A,B01,083779,Greenfeld; Be'Eri,6,0,36,30
1657169269683,MATH 103A,B02,083780,Greenfeld; Be'Eri,3,0,36,33
1657169269683,MATH 103A,B03,093562,Greenfeld; Be'Eri,3,0,36,33
1657169275706,MATH 105,A01,085443,Carter; Anne Toulson,14,0,35,21
1657169275706,MATH 105,A02,093477,Carter; Anne Toulson,20,0,35,15
1657169281727,MATH 109,A01,083213,Ganzberger; Geoffrey Michael,2,0,34,32
1657169281727,MATH 109,A02,083214,Ganzberger; Geoffrey Michael,3,0,34,31
1657169281727,MATH 109,A03,093478,Ganzberger; Geoffrey Michael,1,0,34,33
1657169281727,MATH 109,B01,083215,Ganzberger; Geoffrey Michael,1,0,32,31
1657169281727,MATH 109,B02,083216,Ganzberger; Geoffrey Michael,1,0,32,31
1657169281727,MATH 109,B03,093479,Ganzberger; Geoffrey Michael,6,0,32,26
1657169287749,MATH 142A,A01,083219,Chow; Bennett,6,0,32,26
1657169287749,MATH 142A,A02,083220,Chow; Bennett,10,0,32,22
1657169287749,MATH 142A,A03,093480,Chow; Bennett,7,0,32,25
1657169287749,MATH 142A,B03,093481,Chow; Bennett,8,0,32,24
1657169287749,MATH 142A,B04,093558,Chow; Bennett,11,0,32,21
1657169287749,MATH 142A,B05,093559,Chow; Bennett,6,0,32,26
1657169293776,MATH 193A,A01,083224,Rotar; Vladimir,7,0,34,27
1657169293776,MATH 193A,A02,083225,Rotar; Vladimir,5,0,34,29
1657169293776,MATH 193A,A03,083781,Rotar; Vladimir,1,0,34,33
1657169293776,MATH 193A,A04,083782,Rotar; Vladimir,8,0,34,26
1657169293776,MATH 193A,A05,093482,Rotar; Vladimir,6,0,34,28
1657169299798,MATH 197,001,091859,McAuley; Julian John,9999,0,9999,0
1657169299798,MATH 197,002,095566,Kedlaya; Kiran S.,9997,0,9999,2
1657169299798,MATH 197,003,095567,Xiao; Ming,9999,0,9999,0
1657169299798,MATH 197,004,095571,Perols; Johan Lars,9998,0,9999,1
1657169306855,COGS 9,A01,083615,Shannon; Kyle Michael,7,0,75,68
1657169312879,COGS 11,A01,083617,Boyle; Mary E. T.,22,0,48,26
1657169318901,COGS 13,A01,083071,Bastos; Amalia Pinkusfeld,9,0,71,62
1657169324924,COGS 14A,A01,092681,Semenuks; Arturs,1,1,100,99
1657169330950,COGS 14B,A01,083073,Cheng; Tzu-Han,6,0,63,57
1657169336976,COGS 17,A01,092677,Semenuks; Arturs,4,0,81,77
1657169342998,COGS 100,A01,083619,Allen; Michael Gordon,15,0,70,55
1657169349026,COGS 101A,A01,083621,Davis; Joshua Daniel,9,0,68,59
1657169355049,COGS 101B,A01,091572,Allen; Michael Gordon,9,0,65,56
1657169361072,COGS 101C,A01,083625,Delgado; Tania,17,0,35,18
1657169367095,COGS 107A,A01,083627,Boyle; Mary E. T.,13,0,60,47
1657169373117,COGS 118A,A01,083075,Gupta; Anjum,16,0,76,60
1657169379145,CSE 3,A50,083646,Miranda; Gregory Joseph,24,0,50,26
1657169385179,CSE 8A,A50,083650,Miranda; Gregory Joseph,17,1,56,39
1657169391202,CSE 11,A01,083080,Cao; Yingjun,5,15,40,35
1657169397226,CSE 12,A01,083652,Krause-Levy; Sophia Louisa,24,1,120,96
1657169403256,CSE 15L,A01,083654,Morris; Justin Loren,9,0,50,41
1657169403256,CSE 15L,A02,083655,Morris; Justin Loren,9,0,50,41
1657169409279,CSE 20,A01,083657,Tran; Khoa Dang,38,0,80,42
1657169415309,CSE 21,A01,095574,Bach; Quang Tran,22,0,48,26
1657169421337,CSE 30,A01,083084,Eldon; John,4,0,80,76
1657169421337,CSE 30,B01,095061,Bhaskar; Nishant,7,0,50,43
1657169427361,CSE 100,A01,083659,Cao; Yingjun,4,4,70,66
1657169433389,CSE 134B,A01,083661,Powell; Thomas Allan,20,0,100,80
1657169439415,CSE 140,A01,083663,Gungor; Onat,13,0,85,72
1657169445437,CSE 140L,A01,083088,Eldon; John,17,0,100,83
1657169451463,CSE 175,A01,083665,Kumar; Rakesh,3,0,25,22
1657169457490,CSE 190,A00,092507,Dubnov; Shlomo,7,0,20,13
1657169463512,ECE 45,A01,083139,Congero; Spencer William,5,0,75,70
1657169469534,ECE 65,A50,083695,Saad; Andrew S,12,0,30,18
1657169469534,ECE 65,A51,095125,Saad; Andrew S,25,0,26,1
1657169475562,ECE 109,A01,091882,Touri; Behrouz,18,0,70,52
1657169481589,ECE 180,A00,083140,Abi Samra; Nicholas Camill,1,0,30,29
1657169481589,ECE 180,B00,083141,Abi Samra; Nicholas Camill,0,0,30,30
1657169487613,MATH 10A,A01,083735,Patchell; Gregory David,2,0,30,28
1657169487613,MATH 10A,A02,083736,Patchell; Gregory David,20,0,30,10
1657169487613,MATH 10A,A03,083737,Patchell; Gregory David,16,0,30,14
1657169493648,MATH 10B,A01,083207,Lim; Seonhee,7,0,34,27
1657169493648,MATH 10B,A02,083208,Lim; Seonhee,9,0,35,26
1657169493648,MATH 10B,A03,093472,Lim; Seonhee,5,0,34,29
1657169493648,MATH 10B,B01,083739,Sinha; Shubham,9,0,30,21
1657169499680,MATH 18,A01,083743,Cinel; Cameron Alexander,6,0,30,24
1657169499680,MATH 18,A02,083744,Cinel; Cameron Alexander,15,0,30,15
1657169499680,MATH 18,A03,083745,Cinel; Cameron Alexander,8,0,30,22
1657169499680,MATH 18,B01,083748,Rideout; David Porter,4,0,37,33
1657169499680,MATH 18,B02,083749,Rideout; David Porter,4,0,36,32
1657169499680,MATH 18,B03,083750,Rideout; David Porter,2,0,37,35
1657169499680,MATH 18,B04,083751,Rideout; David Porter,5,0,36,31
1657169499680,MATH 18,B05,093473,Rideout; David Porter,5,0,36,31
1657169499680,MATH 18,B06,093474,Rideout; David Porter,5,0,36,31
1657169505708,MATH 20A,A01,083754,Zheng; Zequn,12,0,40,28
1657169511736,MATH 20B,A01,083756,Briones; Jor-el Thomas Caparas,1,0,36,35
1657169511736,MATH 20B,A02,083757,Briones; Jor-el Thomas Caparas,1,0,36,35
1657169511736,MATH 20B,A03,093475,Briones; Jor-el Thomas Caparas,1,0,36,35
1657169517763,MATH 20C,A01,083760,Briones; Jor-el Thomas Caparas,1,0,35,34
1657169517763,MATH 20C,A02,083761,Briones; Jor-el Thomas Caparas,8,0,35,27
1657169517763,MATH 20C,A03,093476,Briones; Jor-el Thomas Caparas,0,1,36,36
1657169517763,MATH 20C,B01,083762,Bach; Quang Tran,1,0,30,29
1657169523788,MATH 20D,A01,083765,Tran; Brian Kha,4,0,30,26
1657169523788,MATH 20D,A02,083766,Tran; Brian Kha,5,0,30,25
1657169523788,MATH 20D,A03,083767,Tran; Brian Kha,3,0,30,27
1657169529904,MATH 20E,A01,083771,Ganguly; Soumya,7,0,32,25
1657169529904,MATH 20E,A02,083772,Ganguly; Soumya,7,0,32,25
1657169529904,MATH 20E,B01,083773,Ciotti; Benjamin,19,0,35,16
1657169529904,MATH 20E,B02,083774,Ciotti; Benjamin,17,0,35,18
1657169535929,MATH 103A,A01,083777,Greenfeld; Be'Eri,2,0,36,34
1657169535929,MATH 103A,A02,083778,Greenfeld; Be'Eri,5,0,36,31
1657169535929,MATH 103A,A03,093561,Greenfeld; Be'Eri,4,0,36,32
1657169535929,MATH 103A,B01,083779,Greenfeld; Be'Eri,6,0,36,30
1657169535929,MATH 103A,B02,083780,Greenfeld; Be'Eri,3,0,36,33
1657169535929,MATH 103A,B03,093562,Greenfeld; Be'Eri,3,0,36,33
1657169541950,MATH 105,A01,085443,Carter; Anne Toulson,14,0,35,21
1657169541950,MATH 105,A02,093477,Carter; Anne Toulson,20,0,35,15
1657169547974,MATH 109,A01,083213,Ganzberger; Geoffrey Michael,2,0,34,32
1657169547974,MATH 109,A02,083214,Ganzberger; Geoffrey Michael,3,0,34,31
1657169547974,MATH 109,A03,093478,Ganzberger; Geoffrey Michael,1,0,34,33
1657169547974,MATH 109,B01,083215,Ganzberger; Geoffrey Michael,1,0,32,31
1657169547974,MATH 109,B02,083216,Ganzberger; Geoffrey Michael,1,0,32,31
1657169547974,MATH 109,B03,093479,Ganzberger; Geoffrey Michael,6,0,32,26
1657169554002,MATH 142A,A01,083219,Chow; Bennett,6,0,32,26
1657169554002,MATH 142A,A02,083220,Chow; Bennett,10,0,32,22
1657169554002,MATH 142A,A03,093480,Chow; Bennett,7,0,32,25
1657169554002,MATH 142A,B03,093481,Chow; Bennett,8,0,32,24
1657169554002,MATH 142A,B04,093558,Chow; Bennett,11,0,32,21
1657169554002,MATH 142A,B05,093559,Chow; Bennett,6,0,32,26
1657169560024,MATH 193A,A01,083224,Rotar; Vladimir,7,0,34,27
1657169560024,MATH 193A,A02,083225,Rotar; Vladimir,5,0,34,29
1657169560024,MATH 193A,A03,083781,Rotar; Vladimir,1,0,34,33
1657169560024,MATH 193A,A04,083782,Rotar; Vladimir,8,0,34,26
1657169560024,MATH 193A,A05,093482,Rotar; Vladimir,6,0,34,28
1657169566050,MATH 197,001,091859,McAuley; Julian John,9999,0,9999,0
1657169566050,MATH 197,002,095566,Kedlaya; Kiran S.,9997,0,9999,2
1657169566050,MATH 197,003,095567,Xiao; Ming,9999,0,9999,0
1657169566050,MATH 197,004,095571,Perols; Johan Lars,9998,0,9999,1
1657169573103,COGS 9,A01,083615,Shannon; Kyle Michael,7,0,75,68
1657169579127,COGS 11,A01,083617,Boyle; Mary E. T.,22,0,48,26
1657169585155,COGS 13,A01,083071,Bastos; Amalia Pinkusfeld,9,0,71,62
1657169591180,COGS 14A,A01,092681,Semenuks; Arturs,1,1,100,99
1657169597203,COGS 14B,A01,083073,Cheng; Tzu-Han,6,0,63,57
1657169603226,COGS 17,A01,092677,Semenuks; Arturs,4,0,81,77
1657169609248,COGS 100,A01,083619,Allen; Michael Gordon,15,0,70,55
1657169615270,COGS 101A,A01,083621,Davis; Joshua Daniel,9,0,68,59
1657169621293,COGS 101B,A01,091572,Allen; Michael Gordon,9,0,65,56
1657169627319,COGS 101C,A01,083625,Delgado; Tania,17,0,35,18
1657169633345,COGS 107A,A01,083627,Boyle; Mary E. T.,13,0,60,47
1657169639368,COGS 118A,A01,083075,Gupta; Anjum,16,0,76,60
1657169645418,CSE 3,A50,083646,Miranda; Gregory Joseph,24,0,50,26
1657169651445,CSE 8A,A50,083650,Miranda; Gregory Joseph,17,1,56,39
1657169657472,CSE 11,A01,083080,Cao; Yingjun,5,15,40,35
1657169663499,CSE 12,A01,083652,Krause-Levy; Sophia Louisa,24,1,120,96
1657169669522,CSE 15L,A01,083654,Morris; Justin Loren,9,0,50,41
1657169669522,CSE 15L,A02,083655,Morris; Justin Loren,9,0,50,41
1657169675545,CSE 20,A01,083657,Tran; Khoa Dang,38,0,80,42
1657169681571,CSE 21,A01,095574,Bach; Quang Tran,22,0,48,26
1657169687597,CSE 30,A01,083084,Eldon; John,4,0,80,76
1657169687597,CSE 30,B01,095061,Bhaskar; Nishant,7,0,50,43
1657169693627,CSE 100,A01,083659,Cao; Yingjun,4,4,70,66
1657169699653,CSE 134B,A01,083661,Powell; Thomas Allan,20,0,100,80
1657169705677,CSE 140,A01,083663,Gungor; Onat,13,0,85,72
1657169711700,CSE 140L,A01,083088,Eldon; John,17,0,100,83
1657169717726,CSE 175,A01,083665,Kumar; Rakesh,3,0,25,22
1657169723752,CSE 190,A00,092507,Dubnov; Shlomo,7,0,20,13
1657169729779,ECE 45,A01,083139,Congero; Spencer William,5,0,75,70
1657169735801,ECE 65,A50,083695,Saad; Andrew S,12,0,30,18
1657169735801,ECE 65,A51,095125,Saad; Andrew S,25,0,26,1
1657169741833,ECE 109,A01,091882,Touri; Behrouz,18,0,70,52
1657169747857,ECE 180,A00,083140,Abi Samra; Nicholas Camill,1,0,30,29
1657169747857,ECE 180,B00,083141,Abi Samra; Nicholas Camill,0,0,30,30
1657169753887,MATH 10A,A01,083735,Patchell; Gregory David,2,0,30,28
1657169753887,MATH 10A,A02,083736,Patchell; Gregory David,20,0,30,10
1657169753887,MATH 10A,A03,083737,Patchell; Gregory David,16,0,30,14
1657169759911,MATH 10B,A01,083207,Lim; Seonhee,7,0,34,27
1657169759911,MATH 10B,A02,083208,Lim; Seonhee,9,0,35,26
1657169759911,MATH 10B,A03,093472,Lim; Seonhee,5,0,34,29
1657169759911,MATH 10B,B01,083739,Sinha; Shubham,9,0,30,21
1657169765936,MATH 18,A01,083743,Cinel; Cameron Alexander,6,0,30,24
1657169765936,MATH 18,A02,083744,Cinel; Cameron Alexander,15,0,30,15
1657169765936,MATH 18,A03,083745,Cinel; Cameron Alexander,8,0,30,22
1657169765936,MATH 18,B01,083748,Rideout; David Porter,4,0,37,33
1657169765936,MATH 18,B02,083749,Rideout; David Porter,4,0,36,32
1657169765936,MATH 18,B03,083750,Rideout; David Porter,2,0,37,35
1657169765936,MATH 18,B04,083751,Rideout; David Porter,5,0,36,31
1657169765936,MATH 18,B05,093473,Rideout; David Porter,5,0,36,31
1657169765936,MATH 18,B06,093474,Rideout; David Porter,5,0,36,31
1657169771959,MATH 20A,A01,083754,Zheng; Zequn,12,0,40,28
1657169777983,MATH 20B,A01,083756,Briones; Jor-el Thomas Caparas,1,0,36,35
1657169777983,MATH 20B,A02,083757,Briones; Jor-el Thomas Caparas,1,0,36,35
1657169777983,MATH 20B,A03,093475,Briones; Jor-el Thomas Caparas,1,0,36,35
1657169784008,MATH 20C,A01,083760,Briones; Jor-el Thomas Caparas,1,0,35,34
1657169784008,MATH 20C,A02,083761,Briones; Jor-el Thomas Caparas,8,0,35,27
1657169784008,MATH 20C,A03,093476,Briones; Jor-el Thomas Caparas,0,1,36,36
1657169784008,MATH 20C,B01,083762,Bach; Quang Tran,1,0,30,29
1657169790032,MATH 20D,A01,083765,Tran; Brian Kha,4,0,30,26
1657169790032,MATH 20D,A02,083766,Tran; Brian Kha,5,0,30,25
1657169790032,MATH 20D,A03,083767,Tran; Brian Kha,3,0,30,27
1657169796057,MATH 20E,A01,083771,Ganguly; Soumya,7,0,32,25
1657169796057,MATH 20E,A02,083772,Ganguly; Soumya,7,0,32,25
1657169796057,MATH 20E,B01,083773,Ciotti; Benjamin,19,0,35,16
1657169796057,MATH 20E,B02,083774,Ciotti; Benjamin,17,0,35,18
1657169802081,MATH 103A,A01,083777,Greenfeld; Be'Eri,2,0,36,34
1657169802081,MATH 103A,A02,083778,Greenfeld; Be'Eri,5,0,36,31
1657169802081,MATH 103A,A03,093561,Greenfeld; Be'Eri,4,0,36,32
1657169802081,MATH 103A,B01,083779,Greenfeld; Be'Eri,6,0,36,30
1657169802081,MATH 103A,B02,083780,Greenfeld; Be'Eri,3,0,36,33
1657169802081,MATH 103A,B03,093562,Greenfeld; Be'Eri,3,0,36,33
1657169808109,MATH 105,A01,085443,Carter; Anne Toulson,14,0,35,21
1657169808109,MATH 105,A02,093477,Carter; Anne Toulson,20,0,35,15
1657169814135,MATH 109,A01,083213,Ganzberger; Geoffrey Michael,2,0,34,32
1657169814135,MATH 109,A02,083214,Ganzberger; Geoffrey Michael,3,0,34,31
1657169814135,MATH 109,A03,093478,Ganzberger; Geoffrey Michael,1,0,34,33
1657169814135,MATH 109,B01,083215,Ganzberger; Geoffrey Michael,1,0,32,31
1657169814135,MATH 109,B02,083216,Ganzberger; Geoffrey Michael,1,0,32,31
1657169814135,MATH 109,B03,093479,Ganzberger; Geoffrey Michael,6,0,32,26
1657169820159,MATH 142A,A01,083219,Chow; Bennett,6,0,32,26
1657169820159,MATH 142A,A02,083220,Chow; Bennett,10,0,32,22
1657169820159,MATH 142A,A03,093480,Chow; Bennett,7,0,32,25
1657169820159,MATH 142A,B03,093481,Chow; Bennett,8,0,32,24
1657169820159,MATH 142A,B04,093558,Chow; Bennett,11,0,32,21
1657169820159,MATH 142A,B05,093559,Chow; Bennett,6,0,32,26
1657169826192,MATH 193A,A01,083224,Rotar; Vladimir,7,0,34,27
1657169826192,MATH 193A,A02,083225,Rotar; Vladimir,5,0,34,29
1657169826192,MATH 193A,A03,083781,Rotar; Vladimir,1,0,34,33
1657169826192,MATH 193A,A04,083782,Rotar; Vladimir,8,0,34,26
1657169826192,MATH 193A,A05,093482,Rotar; Vladimir,6,0,34,28
1657169832216,MATH 197,001,091859,McAuley; Julian John,9999,0,9999,0
1657169832216,MATH 197,002,095566,Kedlaya; Kiran S.,9997,0,9999,2
1657169832216,MATH 197,003,095567,Xiao; Ming,9999,0,9999,0
1657169832216,MATH 197,004,095571,Perols; Johan Lars,9998,0,9999,1
1657169839271,COGS 9,A01,083615,Shannon; Kyle Michael,7,0,75,68
1657169845295,COGS 11,A01,083617,Boyle; Mary E. T.,22,0,48,26
1657169851318,COGS 13,A01,083071,Bastos; Amalia Pinkusfeld,9,0,71,62
1657169857344,COGS 14A,A01,092681,Semenuks; Arturs,1,1,100,99
1657169863395,COGS 14B,A01,083073,Cheng; Tzu-Han,6,0,63,57
1657169869416,COGS 17,A01,092677,Semenuks; Arturs,4,0,81,77
1657169875438,COGS 100,A01,083619,Allen; Michael Gordon,15,0,70,55
1657169881465,COGS 101A,A01,083621,Davis; Joshua Daniel,9,0,68,59
1657169887492,COGS 101B,A01,091572,Allen; Michael Gordon,9,0,65,56
1657169893528,COGS 101C,A01,083625,Delgado; Tania,17,0,35,18
1657169899553,COGS 107A,A01,083627,Boyle; Mary E. T.,13,0,60,47
1657169905586,COGS 118A,A01,083075,Gupta; Anjum,16,0,76,60
1657169911612,CSE 3,A50,083646,Miranda; Gregory Joseph,24,0,50,26
1657169917639,CSE 8A,A50,083650,Miranda; Gregory Joseph,17,1,56,39
1657169923661,CSE 11,A01,083080,Cao; Yingjun,5,15,40,35
1657169929682,CSE 12,A01,083652,Krause-Levy; Sophia Louisa,24,1,120,96
1657169935703,CSE 15L,A01,083654,Morris; Justin Loren,9,0,50,41
1657169935703,CSE 15L,A02,083655,Morris; Justin Loren,9,0,50,41
1657169941725,CSE 20,A01,083657,Tran; Khoa Dang,38,0,80,42
1657169947751,CSE 21,A01,095574,Bach; Quang Tran,22,0,48,26
1657169953779,CSE 30,A01,083084,Eldon; John,4,0,80,76
1657169953779,CSE 30,B01,095061,Bhaskar; Nishant,7,0,50,43
1657169959802,CSE 100,A01,083659,Cao; Yingjun,4,4,70,66
1657169965828,CSE 134B,A01,083661,Powell; Thomas Allan,20,0,100,80
1657169971849,CSE 140,A01,083663,Gungor; Onat,13,0,85,72
1657169977880,CSE 140L,A01,083088,Eldon; John,17,0,100,83
1657169983903,CSE 175,A01,083665,Kumar; Rakesh,3,0,25,22
1657169989926,CSE 190,A00,092507,Dubnov; Shlomo,7,0,20,13
1657169995952,ECE 45,A01,083139,Congero; Spencer William,5,0,75,70
1657170001980,ECE 65,A50,083695,Saad; Andrew S,12,0,30,18
1657170001980,ECE 65,A51,095125,Saad; Andrew S,25,0,26,1
1657170008003,ECE 109,A01,091882,Touri; Behrouz,18,0,70,52
1657170014026,ECE 180,A00,083140,Abi Samra; Nicholas Camill,1,0,30,29
1657170014026,ECE 180,B00,083141,Abi Samra; Nicholas Camill,0,0,30,30
1657170020051,MATH 10A,A01,083735,Patchell; Gregory David,2,0,30,28
1657170020051,MATH 10A,A02,083736,Patchell; Gregory David,20,0,30,10
1657170020051,MATH 10A,A03,083737,Patchell; Gregory David,16,0,30,14
1657170026080,MATH 10B,A01,083207,Lim; Seonhee,7,0,34,27
1657170026080,MATH 10B,A02,083208,Lim; Seonhee,9,0,35,26
1657170026080,MATH 10B,A03,093472,Lim; Seonhee,5,0,34,29
1657170026080,MATH 10B,B01,083739,Sinha; Shubham,9,0,30,21
1657170032103,MATH 18,A01,083743,Cinel; Cameron Alexander,6,0,30,24
1657170032103,MATH 18,A02,083744,Cinel; Cameron Alexander,15,0,30,15
1657170032103,MATH 18,A03,083745,Cinel; Cameron Alexander,8,0,30,22
1657170032103,MATH 18,B01,083748,Rideout; David Porter,4,0,37,33
1657170032103,MATH 18,B02,083749,Rideout; David Porter,4,0,36,32
1657170032103,MATH 18,B03,083750,Rideout; David Porter,2,0,37,35
1657170032103,MATH 18,B04,083751,Rideout; David Porter,5,0,36,31
1657170032103,MATH 18,B05,093473,Rideout; David Porter,5,0,36,31
1657170032103,MATH 18,B06,093474,Rideout; David Porter,5,0,36,31
1657170038129,MATH 20A,A01,083754,Zheng; Zequn,12,0,40,28
1657170044156,MATH 20B,A01,083756,Briones; Jor-el Thomas Caparas,1,0,36,35
1657170044156,MATH 20B,A02,083757,Briones; Jor-el Thomas Caparas,1,0,36,35
1657170044156,MATH 20B,A03,093475,Briones; Jor-el Thomas Caparas,1,0,36,35
1657170050191,MATH 20C,A01,083760,Briones; Jor-el Thomas Caparas,1,0,35,34
1657170050191,MATH 20C,A02,083761,Briones; Jor-el Thomas Caparas,8,0,35,27
1657170050191,MATH 20C,A03,093476,Briones; Jor-el Thomas Caparas,0,1,36,36
1657170050191,MATH 20C,B01,083762,Bach; Quang Tran,1,0,30,29
1657170056214,MATH 20D,A01,083765,Tran; Brian Kha,4,0,30,26
1657170056214,MATH 20D,A02,083766,Tran; Brian Kha,5,0,30,25
1657170056214,MATH 20D,A03,083767,Tran; Brian Kha,3,0,30,27
1657170062251,MATH 20E,A01,083771,Ganguly; Soumya,7,0,32,25
1657170062251,MATH 20E,A02,083772,Ganguly; Soumya,7,0,32,25
1657170062251,MATH 20E,B01,083773,Ciotti; Benjamin,19,0,35,16
1657170062251,MATH 20E,B02,083774,Ciotti; Benjamin,17,0,35,18
1657170068283,MATH 103A,A01,083777,Greenfeld; Be'Eri,2,0,36,34
1657170068283,MATH 103A,A02,083778,Greenfeld; Be'Eri,5,0,36,31
1657170068283,MATH 103A,A03,093561,Greenfeld; Be'Eri,4,0,36,32
1657170068283,MATH 103A,B01,083779,Greenfeld; Be'Eri,6,0,36,30
1657170068283,MATH 103A,B02,083780,Greenfeld; Be'Eri,3,0,36,33
1657170068283,MATH 103A,B03,093562,Greenfeld; Be'Eri,3,0,36,33
1657170074309,MATH 105,A01,085443,Carter; Anne Toulson,14,0,35,21
1657170074309,MATH 105,A02,093477,Carter; Anne Toulson,20,0,35,15
1657170080345,MATH 109,A01,083213,Ganzberger; Geoffrey Michael,2,0,34,32
1657170080345,MATH 109,A02,083214,Ganzberger; Geoffrey Michael,3,0,34,31
1657170080345,MATH 109,A03,093478,Ganzberger; Geoffrey Michael,1,0,34,33
1657170080345,MATH 109,B01,083215,Ganzberger; Geoffrey Michael,1,0,32,31
1657170080345,MATH 109,B02,083216,Ganzberger; Geoffrey Michael,1,0,32,31
1657170080345,MATH 109,B03,093479,Ganzberger; Geoffrey Michael,6,0,32,26
1657170086369,MATH 142A,A01,083219,Chow; Bennett,6,0,32,26
1657170086369,MATH 142A,A02,083220,Chow; Bennett,10,0,32,22
1657170086369,MATH 142A,A03,093480,Chow; Bennett,7,0,32,25
1657170086369,MATH 142A,B03,093481,Chow; Bennett,8,0,32,24
1657170086369,MATH 142A,B04,093558,Chow; Bennett,11,0,32,21
1657170086369,MATH 142A,B05,093559,Chow; Bennett,6,0,32,26
1657170092391,MATH 193A,A01,083224,Rotar; Vladimir,7,0,34,27
1657170092391,MATH 193A,A02,083225,Rotar; Vladimir,5,0,34,29
1657170092391,MATH 193A,A03,083781,Rotar; Vladimir,1,0,34,33
1657170092391,MATH 193A,A04,083782,Rotar; Vladimir,8,0,34,26
1657170092391,MATH 193A,A05,093482,Rotar; Vladimir,6,0,34,28
1657170098411,MATH 197,001,091859,McAuley; Julian John,9999,0,9999,0
1657170098411,MATH 197,002,095566,Kedlaya; Kiran S.,9997,0,9999,2
1657170098411,MATH 197,003,095567,Xiao; Ming,9999,0,9999,0
1657170098411,MATH 197,004,095571,Perols; Johan Lars,9998,0,9999,1
1657170105475,COGS 9,A01,083615,Shannon; Kyle Michael,7,0,75,68
1657170111505,COGS 11,A01,083617,Boyle; Mary E. T.,22,0,48,26
1657170117532,COGS 13,A01,083071,Bastos; Amalia Pinkusfeld,9,0,71,62
1657170123644,COGS 14A,A01,092681,Semenuks; Arturs,1,1,100,99
1657170129670,COGS 14B,A01,083073,Cheng; Tzu-Han,6,0,63,57
1657170135692,COGS 17,A01,092677,Semenuks; Arturs,4,0,81,77
1657170141716,COGS 100,A01,083619,Allen; Michael Gordon,15,0,70,55
1657170147743,COGS 101A,A01,083621,Davis; Joshua Daniel,9,0,68,59
1657170153765,COGS 101B,A01,091572,Allen; Michael Gordon,9,0,65,56
1657170159790,COGS 101C,A01,083625,Delgado; Tania,17,0,35,18
1657170165815,COGS 107A,A01,083627,Boyle; Mary E. T.,13,0,60,47
1657170171850,COGS 118A,A01,083075,Gupta; Anjum,16,0,76,60
1657170177875,CSE 3,A50,083646,Miranda; Gregory Joseph,24,0,50,26
1657170183902,CSE 8A,A50,083650,Miranda; Gregory Joseph,17,1,56,39
1657170189925,CSE 11,A01,083080,Cao; Yingjun,5,15,40,35
1657170195950,CSE 12,A01,083652,Krause-Levy; Sophia Louisa,24,1,120,96
1657170201977,CSE 15L,A01,083654,Morris; Justin Loren,9,0,50,41
1657170201977,CSE 15L,A02,083655,Morris; Justin Loren,9,0,50,41
1657170208001,CSE 20,A01,083657,Tran; Khoa Dang,38,0,80,42
1657170214025,CSE 21,A01,095574,Bach; Quang Tran,22,0,48,26
1657170220048,CSE 30,A01,083084,Eldon; John,4,0,80,76
1657170220048,CSE 30,B01,095061,Bhaskar; Nishant,7,0,50,43
1657170226069,CSE 100,A01,083659,Cao; Yingjun,4,4,70,66
1657170232091,CSE 134B,A01,083661,Powell; Thomas Allan,20,0,100,80
1657170238114,CSE 140,A01,083663,Gungor; Onat,13,0,85,72
1657170244140,CSE 140L,A01,083088,Eldon; John,17,0,100,83
1657170250164,CSE 175,A01,083665,Kumar; Rakesh,3,0,25,22
1657170256186,CSE 190,A00,092507,Dubnov; Shlomo,7,0,20,13
1657170262210,ECE 45,A01,083139,Congero; Spencer William,5,0,75,70
1657170268234,ECE 65,A50,083695,Saad; Andrew S,12,0,30,18
1657170268234,ECE 65,A51,095125,Saad; Andrew S,25,0,26,1
1657170274258,ECE 109,A01,091882,Touri; Behrouz,18,0,70,52
1657170280282,ECE 180,A00,083140,Abi Samra; Nicholas Camill,1,0,30,29
1657170280282,ECE 180,B00,083141,Abi Samra; Nicholas Camill,0,0,30,30
1657170286310,MATH 10A,A01,083735,Patchell; Gregory David,2,0,30,28
1657170286310,MATH 10A,A02,083736,Patchell; Gregory David,20,0,30,10
1657170286310,MATH 10A,A03,083737,Patchell; Gregory David,16,0,30,14
1657170292334,MATH 10B,A01,083207,Lim; Seonhee,7,0,34,27
1657170292334,MATH 10B,A02,083208,Lim; Seonhee,9,0,35,26
1657170292334,MATH 10B,A03,093472,Lim; Seonhee,5,0,34,29
1657170292334,MATH 10B,B01,083739,Sinha; Shubham,9,0,30,21
1657170298368,MATH 18,A01,083743,Cinel; Cameron Alexander,6,0,30,24
1657170298368,MATH 18,A02,083744,Cinel; Cameron Alexander,15,0,30,15
1657170298368,MATH 18,A03,083745,Cinel; Cameron Alexander,8,0,30,22
1657170298368,MATH 18,B01,083748,Rideout; David Porter,4,0,37,33
1657170298368,MATH 18,B02,083749,Rideout; David Porter,4,0,36,32
1657170298368,MATH 18,B03,083750,Rideout; David Porter,2,0,37,35
1657170298368,MATH 18,B04,083751,Rideout; David Porter,5,0,36,31
1657170298368,MATH 18,B05,093473,Rideout; David Porter,5,0,36,31
1657170298368,MATH 18,B06,093474,Rideout; David Porter,5,0,36,31
1657170304395,MATH 20A,A01,083754,Zheng; Zequn,12,0,40,28
1657170310422,MATH 20B,A01,083756,Briones; Jor-el Thomas Caparas,1,0,36,35
1657170310422,MATH 20B,A02,083757,Briones; Jor-el Thomas Caparas,1,0,36,35
1657170310422,MATH 20B,A03,093475,Briones; Jor-el Thomas Caparas,1,0,36,35
1657170316446,MATH 20C,A01,083760,Briones; Jor-el Thomas Caparas,1,0,35,34
1657170316446,MATH 20C,A02,083761,Briones; Jor-el Thomas Caparas,8,0,35,27
1657170316446,MATH 20C,A03,093476,Briones; Jor-el Thomas Caparas,0,1,36,36
1657170316446,MATH 20C,B01,083762,Bach; Quang Tran,1,0,30,29
1657170322475,MATH 20D,A01,083765,Tran; Brian Kha,4,0,30,26
1657170322475,MATH 20D,A02,083766,Tran; Brian Kha,5,0,30,25
1657170322475,MATH 20D,A03,083767,Tran; Brian Kha,3,0,30,27
1657170328504,MATH 20E,A01,083771,Ganguly; Soumya,7,0,32,25
1657170328504,MATH 20E,A02,083772,Ganguly; Soumya,7,0,32,25
1657170328504,MATH 20E,B01,083773,Ciotti; Benjamin,19,0,35,16
1657170328504,MATH 20E,B02,083774,Ciotti; Benjamin,17,0,35,18
1657170334528,MATH 103A,A01,083777,Greenfeld; Be'Eri,2,0,36,34
1657170334528,MATH 103A,A02,083778,Greenfeld; Be'Eri,5,0,36,31
1657170334528,MATH 103A,A03,093561,Greenfeld; Be'Eri,4,0,36,32
1657170334528,MATH 103A,B01,083779,Greenfeld; Be'Eri,6,0,36,30
1657170334528,MATH 103A,B02,083780,Greenfeld; Be'Eri,3,0,36,33
1657170334528,MATH 103A,B03,093562,Greenfeld; Be'Eri,3,0,36,33
1657170340555,MATH 105,A01,085443,Carter; Anne Toulson,14,0,35,21
1657170340555,MATH 105,A02,093477,Carter; Anne Toulson,20,0,35,15
1657170346579,MATH 109,A01,083213,Ganzberger; Geoffrey Michael,2,0,34,32
1657170346579,MATH 109,A02,083214,Ganzberger; Geoffrey Michael,3,0,34,31
1657170346579,MATH 109,A03,093478,Ganzberger; Geoffrey Michael,1,0,34,33
1657170346579,MATH 109,B01,083215,Ganzberger; Geoffrey Michael,1,0,32,31
1657170346579,MATH 109,B02,083216,Ganzberger; Geoffrey Michael,1,0,32,31
1657170346579,MATH 109,B03,093479,Ganzberger; Geoffrey Michael,6,0,32,26
1657170352604,MATH 142A,A01,083219,Chow; Bennett,6,0,32,26
1657170352604,MATH 142A,A02,083220,Chow; Bennett,10,0,32,22
1657170352604,MATH 142A,A03,093480,Chow; Bennett,7,0,32,25
1657170352604,MATH 142A,B03,093481,Chow; Bennett,8,0,32,24
1657170352604,MATH 142A,B04,093558,Chow; Bennett,11,0,32,21
1657170352604,MATH 142A,B05,093559,Chow; Bennett,6,0,32,26
1657170358632,MATH 193A,A01,083224,Rotar; Vladimir,7,0,34,27
1657170358632,MATH 193A,A02,083225,Rotar; Vladimir,5,0,34,29
1657170358632,MATH 193A,A03,083781,Rotar; Vladimir,1,0,34,33
1657170358632,MATH 193A,A04,083782,Rotar; Vladimir,8,0,34,26
1657170358632,MATH 193A,A05,093482,Rotar; Vladimir,6,0,34,28
1657170364656,MATH 197,001,091859,McAuley; Julian John,9999,0,9999,0
1657170364656,MATH 197,002,095566,Kedlaya; Kiran S.,9997,0,9999,2
1657170364656,MATH 197,003,095567,Xiao; Ming,9999,0,9999,0
1657170364656,MATH 197,004,095571,Perols; Johan Lars,9998,0,9999,1
1657170371713,COGS 9,A01,083615,Shannon; Kyle Michael,7,0,75,68
1657170377746,COGS 11,A01,083617,Boyle; Mary E. T.,22,0,48,26
1657170383768,COGS 13,A01,083071,Bastos; Amalia Pinkusfeld,9,0,71,62
1657170389794,COGS 14A,A01,092681,Semenuks; Arturs,1,1,100,99
1657170395822,COGS 14B,A01,083073,Cheng; Tzu-Han,6,0,63,57
1657170401853,COGS 17,A01,092677,Semenuks; Arturs,4,0,81,77
1657170407880,COGS 100,A01,083619,Allen; Michael Gordon,15,0,70,55
1657170413908,COGS 101A,A01,083621,Davis; Joshua Daniel,9,0,68,59
1657170419931,COGS 101B,A01,091572,Allen; Michael Gordon,9,0,65,56
1657170425956,COGS 101C,A01,083625,Delgado; Tania,17,0,35,18
1657170431978,COGS 107A,A01,083627,Boyle; Mary E. T.,13,0,60,47
1657170438006,COGS 118A,A01,083075,Gupta; Anjum,16,0,76,60
1657170444030,CSE 3,A50,083646,Miranda; Gregory Joseph,24,0,50,26
1657170450054,CSE 8A,A50,083650,Miranda; Gregory Joseph,17,1,56,39
1657170456079,CSE 11,A01,083080,Cao; Yingjun,5,15,40,35
1657170462102,CSE 12,A01,083652,Krause-Levy; Sophia Louisa,24,1,120,96
1657170468127,CSE 15L,A01,083654,Morris; Justin Loren,9,0,50,41
1657170468127,CSE 15L,A02,083655,Morris; Justin Loren,9,0,50,41
1657170474151,CSE 20,A01,083657,Tran; Khoa Dang,38,0,80,42
1657170480177,CSE 21,A01,095574,Bach; Quang Tran,22,0,48,26
1657170486200,CSE 30,A01,083084,Eldon; John,4,0,80,76
1657170486200,CSE 30,B01,095061,Bhaskar; Nishant,7,0,50,43
1657170492226,CSE 100,A01,083659,Cao; Yingjun,4,4,70,66
1657170498249,CSE 134B,A01,083661,Powell; Thomas Allan,20,0,100,80
1657170504272,CSE 140,A01,083663,Gungor; Onat,13,0,85,72
1657170510295,CSE 140L,A01,083088,Eldon; John,17,0,100,83
1657170516324,CSE 175,A01,083665,Kumar; Rakesh,3,0,25,22
1657170522348,CSE 190,A00,092507,Dubnov; Shlomo,7,0,20,13
1657170528387,ECE 45,A01,083139,Congero; Spencer William,5,0,75,70
1657170534411,ECE 65,A50,083695,Saad; Andrew S,12,0,30,18
1657170534411,ECE 65,A51,095125,Saad; Andrew S,25,0,26,1
1657170540437,ECE 109,A01,091882,Touri; Behrouz,18,0,70,52
1657170546462,ECE 180,A00,083140,Abi Samra; Nicholas Camill,1,0,30,29
1657170546462,ECE 180,B00,083141,Abi Samra; Nicholas Camill,0,0,30,30
1657170552485,MATH 10A,A01,083735,Patchell; Gregory David,2,0,30,28
1657170552485,MATH 10A,A02,083736,Patchell; Gregory David,20,0,30,10
1657170552485,MATH 10A,A03,083737,Patchell; Gregory David,16,0,30,14
1657170558516,MATH 10B,A01,083207,Lim; Seonhee,7,0,34,27
1657170558516,MATH 10B,A02,083208,Lim; Seonhee,9,0,35,26
1657170558516,MATH 10B,A03,093472,Lim; Seonhee,5,0,34,29
1657170558516,MATH 10B,B01,083739,Sinha; Shubham,9,0,30,21
1657170564546,MATH 18,A01,083743,Cinel; Cameron Alexander,6,0,30,24
1657170564546,MATH 18,A02,083744,Cinel; Cameron Alexander,15,0,30,15
1657170564546,MATH 18,A03,083745,Cinel; Cameron Alexander,8,0,30,22
1657170564546,MATH 18,B01,083748,Rideout; David Porter,4,0,37,33
1657170564546,MATH 18,B02,083749,Rideout; David Porter,4,0,36,32
1657170564546,MATH 18,B03,083750,Rideout; David Porter,2,0,37,35
1657170564546,MATH 18,B04,083751,Rideout; David Porter,5,0,36,31
1657170564546,MATH 18,B05,093473,Rideout; David Porter,5,0,36,31
1657170564546,MATH 18,B06,093474,Rideout; David Porter,5,0,36,31
1657170570569,MATH 20A,A01,083754,Zheng; Zequn,12,0,40,28
1657170576594,MATH 20B,A01,083756,Briones; Jor-el Thomas Caparas,1,0,36,35
1657170576594,MATH 20B,A02,083757,Briones; Jor-el Thomas Caparas,1,0,36,35
1657170576594,MATH 20B,A03,093475,Briones; Jor-el Thomas Caparas,1,0,36,35
1657170582625,MATH 20C,A01,083760,Briones; Jor-el Thomas Caparas,1,0,35,34
1657170582625,MATH 20C,A02,083761,Briones; Jor-el Thomas Caparas,8,0,35,27
1657170582625,MATH 20C,A03,093476,Briones; Jor-el Thomas Caparas,0,1,36,36
1657170582625,MATH 20C,B01,083762,Bach; Quang Tran,1,0,30,29
1657170588647,MATH 20D,A01,083765,Tran; Brian Kha,4,0,30,26
1657170588647,MATH 20D,A02,083766,Tran; Brian Kha,5,0,30,25
1657170588647,MATH 20D,A03,083767,Tran; Brian Kha,3,0,30,27
1657170594671,MATH 20E,A01,083771,Ganguly; Soumya,7,0,32,25
1657170594671,MATH 20E,A02,083772,Ganguly; Soumya,7,0,32,25
1657170594671,MATH 20E,B01,083773,Ciotti; Benjamin,19,0,35,16
1657170594671,MATH 20E,B02,083774,Ciotti; Benjamin,17,0,35,18
1657170600705,MATH 103A,A01,083777,Greenfeld; Be'Eri,2,0,36,34
1657170600705,MATH 103A,A02,083778,Greenfeld; Be'Eri,5,0,36,31
1657170600705,MATH 103A,A03,093561,Greenfeld; Be'Eri,4,0,36,32
1657170600705,MATH 103A,B01,083779,Greenfeld; Be'Eri,6,0,36,30
1657170600705,MATH 103A,B02,083780,Greenfeld; Be'Eri,3,0,36,33
1657170600705,MATH 103A,B03,093562,Greenfeld; Be'Eri,3,0,36,33
1657170606727,MATH 105,A01,085443,Carter; Anne Toulson,14,0,35,21
1657170606727,MATH 105,A02,093477,Carter; Anne Toulson,20,0,35,15
1657170612751,MATH 109,A01,083213,Ganzberger; Geoffrey Michael,2,0,34,32
1657170612751,MATH 109,A02,083214,Ganzberger; Geoffrey Michael,3,0,34,31
1657170612751,MATH 109,A03,093478,Ganzberger; Geoffrey Michael,1,0,34,33
1657170612751,MATH 109,B01,083215,Ganzberger; Geoffrey Michael,1,0,32,31
1657170612751,MATH 109,B02,083216,Ganzberger; Geoffrey Michael,1,0,32,31
1657170612751,MATH 109,B03,093479,Ganzberger; Geoffrey Michael,6,0,32,26
1657170618779,MATH 142A,A01,083219,Chow; Bennett,6,0,32,26
1657170618779,MATH 142A,A02,083220,Chow; Bennett,10,0,32,22
1657170618779,MATH 142A,A03,093480,Chow; Bennett,7,0,32,25
1657170618779,MATH 142A,B03,093481,Chow; Bennett,8,0,32,24
1657170618779,MATH 142A,B04,093558,Chow; Bennett,11,0,32,21
1657170618779,MATH 142A,B05,093559,Chow; Bennett,6,0,32,26
1657170624804,MATH 193A,A01,083224,Rotar; Vladimir,7,0,34,27
1657170624804,MATH 193A,A02,083225,Rotar; Vladimir,5,0,34,29
1657170624804,MATH 193A,A03,083781,Rotar; Vladimir,1,0,34,33
1657170624804,MATH 193A,A04,083782,Rotar; Vladimir,8,0,34,26
1657170624804,MATH 193A,A05,093482,Rotar; Vladimir,6,0,34,28
1657170630828,MATH 197,001,091859,McAuley; Julian John,9999,0,9999,0
1657170630828,MATH 197,002,095566,Kedlaya; Kiran S.,9997,0,9999,2
1657170630828,MATH 197,003,095567,Xiao; Ming,9999,0,9999,0
1657170630828,MATH 197,004,095571,Perols; Johan Lars,9998,0,9999,1
1657170637906,COGS 9,A01,083615,Shannon; Kyle Michael,7,0,75,68
1657170643930,COGS 11,A01,083617,Boyle; Mary E. T.,22,0,48,26
1657170649956,COGS 13,A01,083071,Bastos; Amalia Pinkusfeld,9,0,71,62
1657170656014,COGS 14A,A01,092681,Semenuks; Arturs,1,1,100,99
1657170662041,COGS 14B,A01,083073,Cheng; Tzu-Han,6,0,63,57
1657170668067,COGS 17,A01,092677,Semenuks; Arturs,4,0,81,77
1657170674094,COGS 100,A01,083619,Allen; Michael Gordon,15,0,70,55
1657170680118,COGS 101A,A01,083621,Davis; Joshua Daniel,9,0,68,59
1657170686144,COGS 101B,A01,091572,Allen; Michael Gordon,9,0,65,56
1657170692172,COGS 101C,A01,083625,Delgado; Tania,17,0,35,18
1657170698234,COGS 107A,A01,083627,Boyle; Mary E. T.,13,0,60,47
1657170704259,COGS 118A,A01,083075,Gupta; Anjum,16,0,76,60
1657170710282,CSE 3,A50,083646,Miranda; Gregory Joseph,24,0,50,26
1657170716307,CSE 8A,A50,083650,Miranda; Gregory Joseph,17,1,56,39
1657170722402,CSE 11,A01,083080,Cao; Yingjun,5,15,40,35
1657170728430,CSE 12,A01,083652,Krause-Levy; Sophia Louisa,24,1,120,96
1657170734460,CSE 15L,A01,083654,Morris; Justin Loren,9,0,50,41
1657170734460,CSE 15L,A02,083655,Morris; Justin Loren,9,0,50,41
1657170740485,CSE 20,A01,083657,Tran; Khoa Dang,38,0,80,42
1657170746510,CSE 21,A01,095574,Bach; Quang Tran,22,0,48,26
1657170752537,CSE 30,A01,083084,Eldon; John,4,0,80,76
1657170752537,CSE 30,B01,095061,Bhaskar; Nishant,7,0,50,43
1657170758563,CSE 100,A01,083659,Cao; Yingjun,4,4,70,66
1657170764587,CSE 134B,A01,083661,Powell; Thomas Allan,20,0,100,80
1657170770614,CSE 140,A01,083663,Gungor; Onat,13,0,85,72
1657170776637,CSE 140L,A01,083088,Eldon; John,17,0,100,83
1657170782662,CSE 175,A01,083665,Kumar; Rakesh,3,0,25,22
1657170788685,CSE 190,A00,092507,Dubnov; Shlomo,7,0,20,13
1657170794708,ECE 45,A01,083139,Congero; Spencer William,5,0,75,70
1657170800735,ECE 65,A50,083695,Saad; Andrew S,12,0,30,18
1657170800735,ECE 65,A51,095125,Saad; Andrew S,25,0,26,1
1657170806761,ECE 109,A01,091882,Touri; Behrouz,18,0,70,52
1657170812789,ECE 180,A00,083140,Abi Samra; Nicholas Camill,1,0,30,29
1657170812789,ECE 180,B00,083141,Abi Samra; Nicholas Camill,0,0,30,30
1657170818817,MATH 10A,A01,083735,Patchell; Gregory David,2,0,30,28
1657170818817,MATH 10A,A02,083736,Patchell; Gregory David,20,0,30,10
1657170818817,MATH 10A,A03,083737,Patchell; Gregory David,16,0,30,14
1657170824845,MATH 10B,A01,083207,Lim; Seonhee,7,0,34,27
1657170824845,MATH 10B,A02,083208,Lim; Seonhee,9,0,35,26
1657170824845,MATH 10B,A03,093472,Lim; Seonhee,5,0,34,29
1657170824845,MATH 10B,B01,083739,Sinha; Shubham,9,0,30,21
1657170830868,MATH 18,A01,083743,Cinel; Cameron Alexander,6,0,30,24
1657170830868,MATH 18,A02,083744,Cinel; Cameron Alexander,15,0,30,15
1657170830868,MATH 18,A03,083745,Cinel; Cameron Alexander,8,0,30,22
1657170830868,MATH 18,B01,083748,Rideout; David Porter,4,0,37,33
1657170830868,MATH 18,B02,083749,Rideout; David Porter,4,0,36,32
1657170830868,MATH 18,B03,083750,Rideout; David Porter,2,0,37,35
1657170830868,MATH 18,B04,083751,Rideout; David Porter,5,0,36,31
1657170830868,MATH 18,B05,093473,Rideout; David Porter,5,0,36,31
1657170830868,MATH 18,B06,093474,Rideout; David Porter,5,0,36,31
1657170836891,MATH 20A,A01,083754,Zheng; Zequn,12,0,40,28
1657170842915,MATH 20B,A01,083756,Briones; Jor-el Thomas Caparas,1,0,36,35
1657170842915,MATH 20B,A02,083757,Briones; Jor-el Thomas Caparas,1,0,36,35
1657170842915,MATH 20B,A03,093475,Briones; Jor-el Thomas Caparas,1,0,36,35
1657170848955,MATH 20C,A01,083760,Briones; Jor-el Thomas Caparas,1,0,35,34
1657170848955,MATH 20C,A02,083761,Briones; Jor-el Thomas Caparas,8,0,35,27
1657170848955,MATH 20C,A03,093476,Briones; Jor-el Thomas Caparas,0,1,36,36
1657170848955,MATH 20C,B01,083762,Bach; Quang Tran,1,0,30,29
1657170854982,MATH 20D,A01,083765,Tran; Brian Kha,4,0,30,26
1657170854982,MATH 20D,A02,083766,Tran; Brian Kha,5,0,30,25
1657170854982,MATH 20D,A03,083767,Tran; Brian Kha,3,0,30,27
1657170861017,MATH 20E,A01,083771,Ganguly; Soumya,7,0,32,25
1657170861017,MATH 20E,A02,083772,Ganguly; Soumya,7,0,32,25
1657170861017,MATH 20E,B01,083773,Ciotti; Benjamin,19,0,35,16
1657170861017,MATH 20E,B02,083774,Ciotti; Benjamin,17,0,35,18
1657170867045,MATH 103A,A01,083777,Greenfeld; Be'Eri,2,0,36,34
1657170867045,MATH 103A,A02,083778,Greenfeld; Be'Eri,5,0,36,31
1657170867045,MATH 103A,A03,093561,Greenfeld; Be'Eri,4,0,36,32
1657170867045,MATH 103A,B01,083779,Greenfeld; Be'Eri,6,0,36,30
1657170867045,MATH 103A,B02,083780,Greenfeld; Be'Eri,3,0,36,33
1657170867045,MATH 103A,B03,093562,Greenfeld; Be'Eri,3,0,36,33
1657170873069,MATH 105,A01,085443,Carter; Anne Toulson,14,0,35,21
1657170873069,MATH 105,A02,093477,Carter; Anne Toulson,20,0,35,15
1657170879099,MATH 109,A01,083213,Ganzberger; Geoffrey Michael,2,0,34,32
1657170879099,MATH 109,A02,083214,Ganzberger; Geoffrey Michael,3,0,34,31
1657170879099,MATH 109,A03,093478,Ganzberger; Geoffrey Michael,1,0,34,33
1657170879099,MATH 109,B01,083215,Ganzberger; Geoffrey Michael,1,0,32,31
1657170879099,MATH 109,B02,083216,Ganzberger; Geoffrey Michael,1,0,32,31
1657170879099,MATH 109,B03,093479,Ganzberger; Geoffrey Michael,6,0,32,26
1657170885123,MATH 142A,A01,083219,Chow; Bennett,6,0,32,26
1657170885123,MATH 142A,A02,083220,Chow; Bennett,10,0,32,22
1657170885123,MATH 142A,A03,093480,Chow; Bennett,7,0,32,25
1657170885123,MATH 142A,B03,093481,Chow; Bennett,8,0,32,24
1657170885123,MATH 142A,B04,093558,Chow; Bennett,11,0,32,21
1657170885123,MATH 142A,B05,093559,Chow; Bennett,6,0,32,26
1657170891146,MATH 193A,A01,083224,Rotar; Vladimir,7,0,34,27
1657170891146,MATH 193A,A02,083225,Rotar; Vladimir,5,0,34,29
1657170891146,MATH 193A,A03,083781,Rotar; Vladimir,1,0,34,33
1657170891146,MATH 193A,A04,083782,Rotar; Vladimir,8,0,34,26
1657170891146,MATH 193A,A05,093482,Rotar; Vladimir,6,0,34,28
1657170897175,MATH 197,001,091859,McAuley; Julian John,9999,0,9999,0
1657170897175,MATH 197,002,095566,Kedlaya; Kiran S.,9997,0,9999,2
1657170897175,MATH 197,003,095567,Xiao; Ming,9999,0,9999,0
1657170897175,MATH 197,004,095571,Perols; Johan Lars,9998,0,9999,1
1657170904244,COGS 9,A01,083615,Shannon; Kyle Michael,7,0,75,68
1657170910271,COGS 11,A01,083617,Boyle; Mary E. T.,22,0,48,26
1657170916296,COGS 13,A01,083071,Bastos; Amalia Pinkusfeld,9,0,71,62
1657170922324,COGS 14A,A01,092681,Semenuks; Arturs,1,1,100,99
1657170928347,COGS 14B,A01,083073,Cheng; Tzu-Han,6,0,63,57
1657170934371,COGS 17,A01,092677,Semenuks; Arturs,4,0,81,77
1657170940398,COGS 100,A01,083619,Allen; Michael Gordon,15,0,70,55
1657170946428,COGS 101A,A01,083621,Davis; Joshua Daniel,9,0,68,59
1657170952460,COGS 101B,A01,091572,Allen; Michael Gordon,9,0,65,56
1657170958485,COGS 101C,A01,083625,Delgado; Tania,17,0,35,18
1657170964511,COGS 107A,A01,083627,Boyle; Mary E. T.,13,0,60,47
1657170970534,COGS 118A,A01,083075,Gupta; Anjum,16,0,76,60
1657170976563,CSE 3,A50,083646,Miranda; Gregory Joseph,24,0,50,26
1657170982589,CSE 8A,A50,083650,Miranda; Gregory Joseph,17,1,56,39
1657170988615,CSE 11,A01,083080,Cao; Yingjun,5,15,40,35
1657170994643,CSE 12,A01,083652,Krause-Levy; Sophia Louisa,24,1,120,96
1657171000666,CSE 15L,A01,083654,Morris; Justin Loren,9,0,50,41
1657171000666,CSE 15L,A02,083655,Morris; Justin Loren,9,0,50,41
1657171006695,CSE 20,A01,083657,Tran; Khoa Dang,38,0,80,42
1657171012720,CSE 21,A01,095574,Bach; Quang Tran,22,0,48,26
1657171018750,CSE 30,A01,083084,Eldon; John,4,0,80,76
1657171018750,CSE 30,B01,095061,Bhaskar; Nishant,7,0,50,43
1657171024772,CSE 100,A01,083659,Cao; Yingjun,4,4,70,66
1657171030794,CSE 134B,A01,083661,Powell; Thomas Allan,20,0,100,80
1657171036821,CSE 140,A01,083663,Gungor; Onat,13,0,85,72
1657171042843,CSE 140L,A01,083088,Eldon; John,17,0,100,83
1657171048874,CSE 175,A01,083665,Kumar; Rakesh,3,0,25,22
1657171054900,CSE 190,A00,092507,Dubnov; Shlomo,7,0,20,13
1657171060923,ECE 45,A01,083139,Congero; Spencer William,5,0,75,70
1657171066946,ECE 65,A50,083695,Saad; Andrew S,12,0,30,18
1657171066946,ECE 65,A51,095125,Saad; Andrew S,25,0,26,1
1657171072971,ECE 109,A01,091882,Touri; Behrouz,18,0,70,52
1657171078995,ECE 180,A00,083140,Abi Samra; Nicholas Camill,1,0,30,29
1657171078995,ECE 180,B00,083141,Abi Samra; Nicholas Camill,0,0,30,30
1657171085025,MATH 10A,A01,083735,Patchell; Gregory David,2,0,30,28
1657171085025,MATH 10A,A02,083736,Patchell; Gregory David,20,0,30,10
1657171085025,MATH 10A,A03,083737,Patchell; Gregory David,16,0,30,14
1657171091052,MATH 10B,A01,083207,Lim; Seonhee,7,0,34,27
1657171091052,MATH 10B,A02,083208,Lim; Seonhee,9,0,35,26
1657171091052,MATH 10B,A03,093472,Lim; Seonhee,5,0,34,29
1657171091052,MATH 10B,B01,083739,Sinha; Shubham,9,0,30,21
1657171097077,MATH 18,A01,083743,Cinel; Cameron Alexander,6,0,30,24
1657171097077,MATH 18,A02,083744,Cinel; Cameron Alexander,15,0,30,15
1657171097077,MATH 18,A03,083745,Cinel; Cameron Alexander,8,0,30,22
1657171097077,MATH 18,B01,083748,Rideout; David Porter,4,0,37,33
1657171097077,MATH 18,B02,083749,Rideout; David Porter,4,0,36,32
1657171097077,MATH 18,B03,083750,Rideout; David Porter,2,0,37,35
1657171097077,MATH 18,B04,083751,Rideout; David Porter,5,0,36,31
1657171097077,MATH 18,B05,093473,Rideout; David Porter,5,0,36,31
1657171097077,MATH 18,B06,093474,Rideout; David Porter,5,0,36,31
1657171103102,MATH 20A,A01,083754,Zheng; Zequn,12,0,40,28
1657171109126,MATH 20B,A01,083756,Briones; Jor-el Thomas Caparas,1,0,36,35
1657171109126,MATH 20B,A02,083757,Briones; Jor-el Thomas Caparas,1,0,36,35
1657171109126,MATH 20B,A03,093475,Briones; Jor-el Thomas Caparas,1,0,36,35
1657171115159,MATH 20C,A01,083760,Briones; Jor-el Thomas Caparas,1,0,35,34
1657171115159,MATH 20C,A02,083761,Briones; Jor-el Thomas Caparas,8,0,35,27
1657171115159,MATH 20C,A03,093476,Briones; Jor-el Thomas Caparas,0,1,36,36
1657171115159,MATH 20C,B01,083762,Bach; Quang Tran,1,0,30,29
1657171121186,MATH 20D,A01,083765,Tran; Brian Kha,4,0,30,26
1657171121186,MATH 20D,A02,083766,Tran; Brian Kha,5,0,30,25
1657171121186,MATH 20D,A03,083767,Tran; Brian Kha,3,0,30,27
1657171127210,MATH 20E,A01,083771,Ganguly; Soumya,7,0,32,25
1657171127210,MATH 20E,A02,083772,Ganguly; Soumya,7,0,32,25
1657171127210,MATH 20E,B01,083773,Ciotti; Benjamin,19,0,35,16
1657171127210,MATH 20E,B02,083774,Ciotti; Benjamin,17,0,35,18
1657171133234,MATH 103A,A01,083777,Greenfeld; Be'Eri,2,0,36,34
1657171133234,MATH 103A,A02,083778,Greenfeld; Be'Eri,5,0,36,31
1657171133234,MATH 103A,A03,093561,Greenfeld; Be'Eri,4,0,36,32
1657171133234,MATH 103A,B01,083779,Greenfeld; Be'Eri,6,0,36,30
1657171133234,MATH 103A,B02,083780,Greenfeld; Be'Eri,3,0,36,33
1657171133234,MATH 103A,B03,093562,Greenfeld; Be'Eri,3,0,36,33
1657171139258,MATH 105,A01,085443,Carter; Anne Toulson,14,0,35,21
1657171139258,MATH 105,A02,093477,Carter; Anne Toulson,20,0,35,15
1657171145283,MATH 109,A01,083213,Ganzberger; Geoffrey Michael,2,0,34,32
1657171145283,MATH 109,A02,083214,Ganzberger; Geoffrey Michael,3,0,34,31
1657171145283,MATH 109,A03,093478,Ganzberger; Geoffrey Michael,1,0,34,33
1657171145283,MATH 109,B01,083215,Ganzberger; Geoffrey Michael,1,0,32,31
1657171145283,MATH 109,B02,083216,Ganzberger; Geoffrey Michael,1,0,32,31
1657171145283,MATH 109,B03,093479,Ganzberger; Geoffrey Michael,6,0,32,26
1657171151307,MATH 142A,A01,083219,Chow; Bennett,6,0,32,26
1657171151307,MATH 142A,A02,083220,Chow; Bennett,10,0,32,22
1657171151307,MATH 142A,A03,093480,Chow; Bennett,7,0,32,25
1657171151307,MATH 142A,B03,093481,Chow; Bennett,8,0,32,24
1657171151307,MATH 142A,B04,093558,Chow; Bennett,11,0,32,21
1657171151307,MATH 142A,B05,093559,Chow; Bennett,6,0,32,26
1657171157335,MATH 193A,A01,083224,Rotar; Vladimir,7,0,34,27
1657171157335,MATH 193A,A02,083225,Rotar; Vladimir,5,0,34,29
1657171157335,MATH 193A,A03,083781,Rotar; Vladimir,1,0,34,33
1657171157335,MATH 193A,A04,083782,Rotar; Vladimir,8,0,34,26
1657171157335,MATH 193A,A05,093482,Rotar; Vladimir,6,0,34,28
1657171163362,MATH 197,001,091859,McAuley; Julian John,9999,0,9999,0
1657171163362,MATH 197,002,095566,Kedlaya; Kiran S.,9997,0,9999,2
1657171163362,MATH 197,003,095567,Xiao; Ming,9999,0,9999,0
1657171163362,MATH 197,004,095571,Perols; Johan Lars,9998,0,9999,1
1657171170414,COGS 9,A01,083615,Shannon; Kyle Michael,7,0,75,68
1657171176438,COGS 11,A01,083617,Boyle; Mary E. T.,22,0,48,26
1657171182461,COGS 13,A01,083071,Bastos; Amalia Pinkusfeld,9,0,71,62
1657171188490,COGS 14A,A01,092681,Semenuks; Arturs,1,1,100,99
1657171194513,COGS 14B,A01,083073,Cheng; Tzu-Han,6,0,63,57
1657171200539,COGS 17,A01,092677,Semenuks; Arturs,4,0,81,77
1657171206562,COGS 100,A01,083619,Allen; Michael Gordon,15,0,70,55
1657171212588,COGS 101A,A01,083621,Davis; Joshua Daniel,9,0,68,59
1657171218612,COGS 101B,A01,091572,Allen; Michael Gordon,9,0,65,56
1657171224634,COGS 101C,A01,083625,Delgado; Tania,17,0,35,18
1657171230662,COGS 107A,A01,083627,Boyle; Mary E. T.,13,0,60,47
1657171236688,COGS 118A,A01,083075,Gupta; Anjum,16,0,76,60
1657171242719,CSE 3,A50,083646,Miranda; Gregory Joseph,24,0,50,26
1657171248746,CSE 8A,A50,083650,Miranda; Gregory Joseph,17,1,56,39
1657171254769,CSE 11,A01,083080,Cao; Yingjun,5,15,40,35
1657171260793,CSE 12,A01,083652,Krause-Levy; Sophia Louisa,24,1,120,96
1657171266817,CSE 15L,A01,083654,Morris; Justin Loren,9,0,50,41
1657171266817,CSE 15L,A02,083655,Morris; Justin Loren,9,0,50,41
1657171272840,CSE 20,A01,083657,Tran; Khoa Dang,38,0,80,42
1657171278871,CSE 21,A01,095574,Bach; Quang Tran,22,0,48,26
1657171284898,CSE 30,A01,083084,Eldon; John,4,0,80,76
1657171284898,CSE 30,B01,095061,Bhaskar; Nishant,7,0,50,43
1657171290925,CSE 100,A01,083659,Cao; Yingjun,4,4,70,66
1657171296958,CSE 134B,A01,083661,Powell; Thomas Allan,20,0,100,80
1657171302982,CSE 140,A01,083663,Gungor; Onat,13,0,85,72
1657171309012,CSE 140L,A01,083088,Eldon; John,17,0,100,83
1657171315033,CSE 175,A01,083665,Kumar; Rakesh,3,0,25,22
1657171321147,CSE 190,A00,092507,Dubnov; Shlomo,7,0,20,13
1657171327187,ECE 45,A01,083139,Congero; Spencer William,5,0,75,70
1657171333211,ECE 65,A50,083695,Saad; Andrew S,12,0,30,18
1657171333211,ECE 65,A51,095125,Saad; Andrew S,25,0,26,1
1657171339237,ECE 109,A01,091882,Touri; Behrouz,18,0,70,52
1657171345262,ECE 180,A00,083140,Abi Samra; Nicholas Camill,1,0,30,29
1657171345262,ECE 180,B00,083141,Abi Samra; Nicholas Camill,0,0,30,30
1657171351287,MATH 10A,A01,083735,Patchell; Gregory David,2,0,30,28
1657171351287,MATH 10A,A02,083736,Patchell; Gregory David,20,0,30,10
1657171351287,MATH 10A,A03,083737,Patchell; Gregory David,16,0,30,14
1657171357312,MATH 10B,A01,083207,Lim; Seonhee,7,0,34,27
1657171357312,MATH 10B,A02,083208,Lim; Seonhee,9,0,35,26
1657171357312,MATH 10B,A03,093472,Lim; Seonhee,5,0,34,29
1657171357312,MATH 10B,B01,083739,Sinha; Shubham,9,0,30,21
1657171363341,MATH 18,A01,083743,Cinel; Cameron Alexander,6,0,30,24
1657171363341,MATH 18,A02,083744,Cinel; Cameron Alexander,15,0,30,15
1657171363341,MATH 18,A03,083745,Cinel; Cameron Alexander,8,0,30,22
1657171363341,MATH 18,B01,083748,Rideout; David Porter,4,0,37,33
1657171363341,MATH 18,B02,083749,Rideout; David Porter,4,0,36,32
1657171363341,MATH 18,B03,083750,Rideout; David Porter,2,0,37,35
1657171363341,MATH 18,B04,083751,Rideout; David Porter,5,0,36,31
1657171363341,MATH 18,B05,093473,Rideout; David Porter,5,0,36,31
1657171363341,MATH 18,B06,093474,Rideout; David Porter,5,0,36,31
1657171369364,MATH 20A,A01,083754,Zheng; Zequn,12,0,40,28
1657171375387,MATH 20B,A01,083756,Briones; Jor-el Thomas Caparas,1,0,36,35
1657171375387,MATH 20B,A02,083757,Briones; Jor-el Thomas Caparas,1,0,36,35
1657171375387,MATH 20B,A03,093475,Briones; Jor-el Thomas Caparas,1,0,36,35
1657171381419,MATH 20C,A01,083760,Briones; Jor-el Thomas Caparas,1,0,35,34
1657171381419,MATH 20C,A02,083761,Briones; Jor-el Thomas Caparas,8,0,35,27
1657171381419,MATH 20C,A03,093476,Briones; Jor-el Thomas Caparas,0,1,36,36
1657171381419,MATH 20C,B01,083762,Bach; Quang Tran,1,0,30,29
1657171387449,MATH 20D,A01,083765,Tran; Brian Kha,4,0,30,26
1657171387449,MATH 20D,A02,083766,Tran; Brian Kha,5,0,30,25
1657171387449,MATH 20D,A03,083767,Tran; Brian Kha,3,0,30,27
1657171393494,MATH 20E,A01,083771,Ganguly; Soumya,7,0,32,25
1657171393494,MATH 20E,A02,083772,Ganguly; Soumya,7,0,32,25
1657171393494,MATH 20E,B01,083773,Ciotti; Benjamin,19,0,35,16
1657171393494,MATH 20E,B02,083774,Ciotti; Benjamin,17,0,35,18
1657171399519,MATH 103A,A01,083777,Greenfeld; Be'Eri,2,0,36,34
1657171399519,MATH 103A,A02,083778,Greenfeld; Be'Eri,5,0,36,31
1657171399519,MATH 103A,A03,093561,Greenfeld; Be'Eri,4,0,36,32
1657171399519,MATH 103A,B01,083779,Greenfeld; Be'Eri,6,0,36,30
1657171399519,MATH 103A,B02,083780,Greenfeld; Be'Eri,3,0,36,33
1657171399519,MATH 103A,B03,093562,Greenfeld; Be'Eri,3,0,36,33
1657171405543,MATH 105,A01,085443,Carter; Anne Toulson,14,0,35,21
1657171405543,MATH 105,A02,093477,Carter; Anne Toulson,20,0,35,15
1657171411569,MATH 109,A01,083213,Ganzberger; Geoffrey Michael,2,0,34,32
1657171411569,MATH 109,A02,083214,Ganzberger; Geoffrey Michael,3,0,34,31
1657171411569,MATH 109,A03,093478,Ganzberger; Geoffrey Michael,1,0,34,33
1657171411569,MATH 109,B01,083215,Ganzberger; Geoffrey Michael,1,0,32,31
1657171411569,MATH 109,B02,083216,Ganzberger; Geoffrey Michael,1,0,32,31
1657171411569,MATH 109,B03,093479,Ganzberger; Geoffrey Michael,6,0,32,26
1657171417591,MATH 142A,A01,083219,Chow; Bennett,6,0,32,26
1657171417591,MATH 142A,A02,083220,Chow; Bennett,10,0,32,22
1657171417591,MATH 142A,A03,093480,Chow; Bennett,7,0,32,25
1657171417591,MATH 142A,B03,093481,Chow; Bennett,8,0,32,24
1657171417591,MATH 142A,B04,093558,Chow; Bennett,11,0,32,21
1657171417591,MATH 142A,B05,093559,Chow; Bennett,6,0,32,26
1657171423620,MATH 193A,A01,083224,Rotar; Vladimir,7,0,34,27
1657171423620,MATH 193A,A02,083225,Rotar; Vladimir,5,0,34,29
1657171423620,MATH 193A,A03,083781,Rotar; Vladimir,1,0,34,33
1657171423620,MATH 193A,A04,083782,Rotar; Vladimir,8,0,34,26
1657171423620,MATH 193A,A05,093482,Rotar; Vladimir,6,0,34,28
1657171429645,MATH 197,001,091859,McAuley; Julian John,9999,0,9999,0
1657171429645,MATH 197,002,095566,Kedlaya; Kiran S.,9997,0,9999,2
1657171429645,MATH 197,003,095567,Xiao; Ming,9999,0,9999,0
1657171429645,MATH 197,004,095571,Perols; Johan Lars,9998,0,9999,1
1657171436701,COGS 9,A01,083615,Shannon; Kyle Michael,7,0,75,68
1657171442728,COGS 11,A01,083617,Boyle; Mary E. T.,22,0,48,26
1657171448752,COGS 13,A01,083071,Bastos; Amalia Pinkusfeld,9,0,71,62
1657171454774,COGS 14A,A01,092681,Semenuks; Arturs,1,1,100,99
1657171460801,COGS 14B,A01,083073,Cheng; Tzu-Han,6,0,63,57
1657171466828,COGS 17,A01,092677,Semenuks; Arturs,4,0,81,77
1657171472852,COGS 100,A01,083619,Allen; Michael Gordon,15,0,70,55
1657171478877,COGS 101A,A01,083621,Davis; Joshua Daniel,9,0,68,59
1657171484900,COGS 101B,A01,091572,Allen; Michael Gordon,9,0,65,56
1657171490927,COGS 101C,A01,083625,Delgado; Tania,17,0,35,18
1657171496957,COGS 107A,A01,083627,Boyle; Mary E. T.,13,0,60,47
1657171502986,COGS 118A,A01,083075,Gupta; Anjum,16,0,76,60
1657171509013,CSE 3,A50,083646,Miranda; Gregory Joseph,24,0,50,26
1657171515049,CSE 8A,A50,083650,Miranda; Gregory Joseph,17,1,56,39
1657171521073,CSE 11,A01,083080,Cao; Yingjun,5,15,40,35
1657171527098,CSE 12,A01,083652,Krause-Levy; Sophia Louisa,24,1,120,96
1657171533125,CSE 15L,A01,083654,Morris; Justin Loren,9,0,50,41
1657171533125,CSE 15L,A02,083655,Morris; Justin Loren,9,0,50,41
1657171539148,CSE 20,A01,083657,Tran; Khoa Dang,38,0,80,42
1657171545177,CSE 21,A01,095574,Bach; Quang Tran,22,0,48,26
1657171551201,CSE 30,A01,083084,Eldon; John,4,0,80,76
1657171551201,CSE 30,B01,095061,Bhaskar; Nishant,7,0,50,43
1657171557225,CSE 100,A01,083659,Cao; Yingjun,4,4,70,66
1657171563249,CSE 134B,A01,083661,Powell; Thomas Allan,20,0,100,80
1657171569272,CSE 140,A01,083663,Gungor; Onat,13,0,85,72
1657171575313,CSE 140L,A01,083088,Eldon; John,17,0,100,83
1657171581337,CSE 175,A01,083665,Kumar; Rakesh,3,0,25,22
1657171587365,CSE 190,A00,092507,Dubnov; Shlomo,7,0,20,13
1657171593392,ECE 45,A01,083139,Congero; Spencer William,5,0,75,70
1657171599415,ECE 65,A50,083695,Saad; Andrew S,12,0,30,18
1657171599415,ECE 65,A51,095125,Saad; Andrew S,25,0,26,1
1657171605437,ECE 109,A01,091882,Touri; Behrouz,18,0,70,52
1657171611460,ECE 180,A00,083140,Abi Samra; Nicholas Camill,1,0,30,29
1657171611460,ECE 180,B00,083141,Abi Samra; Nicholas Camill,0,0,30,30
1657171617486,MATH 10A,A01,083735,Patchell; Gregory David,2,0,30,28
1657171617486,MATH 10A,A02,083736,Patchell; Gregory David,20,0,30,10
1657171617486,MATH 10A,A03,083737,Patchell; Gregory David,16,0,30,14
1657171623511,MATH 10B,A01,083207,Lim; Seonhee,7,0,34,27
1657171623511,MATH 10B,A02,083208,Lim; Seonhee,9,0,35,26
1657171623511,MATH 10B,A03,093472,Lim; Seonhee,5,0,34,29
1657171623511,MATH 10B,B01,083739,Sinha; Shubham,9,0,30,21
1657171629545,MATH 18,A01,083743,Cinel; Cameron Alexander,6,0,30,24
1657171629545,MATH 18,A02,083744,Cinel; Cameron Alexander,15,0,30,15
1657171629545,MATH 18,A03,083745,Cinel; Cameron Alexander,8,0,30,22
1657171629545,MATH 18,B01,083748,Rideout; David Porter,4,0,37,33
1657171629545,MATH 18,B02,083749,Rideout; David Porter,4,0,36,32
1657171629545,MATH 18,B03,083750,Rideout; David Porter,2,0,37,35
1657171629545,MATH 18,B04,083751,Rideout; David Porter,5,0,36,31
1657171629545,MATH 18,B05,093473,Rideout; David Porter,5,0,36,31
1657171629545,MATH 18,B06,093474,Rideout; David Porter,5,0,36,31
1657171635574,MATH 20A,A01,083754,Zheng; Zequn,12,0,40,28
1657171641602,MATH 20B,A01,083756,Briones; Jor-el Thomas Caparas,1,0,36,35
1657171641602,MATH 20B,A02,083757,Briones; Jor-el Thomas Caparas,1,0,36,35
1657171641602,MATH 20B,A03,093475,Briones; Jor-el Thomas Caparas,1,0,36,35
1657171647627,MATH 20C,A01,083760,Briones; Jor-el Thomas Caparas,1,0,35,34
1657171647627,MATH 20C,A02,083761,Briones; Jor-el Thomas Caparas,8,0,35,27
1657171647627,MATH 20C,A03,093476,Briones; Jor-el Thomas Caparas,0,1,36,36
1657171647627,MATH 20C,B01,083762,Bach; Quang Tran,1,0,30,29
1657171653656,MATH 20D,A01,083765,Tran; Brian Kha,4,0,30,26
1657171653656,MATH 20D,A02,083766,Tran; Brian Kha,5,0,30,25
1657171653656,MATH 20D,A03,083767,Tran; Brian Kha,3,0,30,27
1657171659684,MATH 20E,A01,083771,Ganguly; Soumya,7,0,32,25
1657171659684,MATH 20E,A02,083772,Ganguly; Soumya,7,0,32,25
1657171659684,MATH 20E,B01,083773,Ciotti; Benjamin,19,0,35,16
1657171659684,MATH 20E,B02,083774,Ciotti; Benjamin,17,0,35,18
1657171665707,MATH 103A,A01,083777,Greenfeld; Be'Eri,2,0,36,34
1657171665707,MATH 103A,A02,083778,Greenfeld; Be'Eri,5,0,36,31
1657171665707,MATH 103A,A03,093561,Greenfeld; Be'Eri,4,0,36,32
1657171665707,MATH 103A,B01,083779,Greenfeld; Be'Eri,6,0,36,30
1657171665707,MATH 103A,B02,083780,Greenfeld; Be'Eri,3,0,36,33
1657171665707,MATH 103A,B03,093562,Greenfeld; Be'Eri,3,0,36,33
1657171671730,MATH 105,A01,085443,Carter; Anne Toulson,14,0,35,21
1657171671730,MATH 105,A02,093477,Carter; Anne Toulson,20,0,35,15
1657171677769,MATH 109,A01,083213,Ganzberger; Geoffrey Michael,2,0,34,32
1657171677769,MATH 109,A02,083214,Ganzberger; Geoffrey Michael,3,0,34,31
1657171677769,MATH 109,A03,093478,Ganzberger; Geoffrey Michael,1,0,34,33
1657171677769,MATH 109,B01,083215,Ganzberger; Geoffrey Michael,1,0,32,31
1657171677769,MATH 109,B02,083216,Ganzberger; Geoffrey Michael,1,0,32,31
1657171677769,MATH 109,B03,093479,Ganzberger; Geoffrey Michael,6,0,32,26
1657171683792,MATH 142A,A01,083219,Chow; Bennett,6,0,32,26
1657171683792,MATH 142A,A02,083220,Chow; Bennett,10,0,32,22
1657171683792,MATH 142A,A03,093480,Chow; Bennett,7,0,32,25
1657171683792,MATH 142A,B03,093481,Chow; Bennett,8,0,32,24
1657171683792,MATH 142A,B04,093558,Chow; Bennett,11,0,32,21
1657171683792,MATH 142A,B05,093559,Chow; Bennett,6,0,32,26
1657171689815,MATH 193A,A01,083224,Rotar; Vladimir,7,0,34,27
1657171689815,MATH 193A,A02,083225,Rotar; Vladimir,5,0,34,29
1657171689815,MATH 193A,A03,083781,Rotar; Vladimir,1,0,34,33
1657171689815,MATH 193A,A04,083782,Rotar; Vladimir,8,0,34,26
1657171689815,MATH 193A,A05,093482,Rotar; Vladimir,6,0,34,28
1657171695848,MATH 197,001,091859,McAuley; Julian John,9999,0,9999,0
1657171695848,MATH 197,002,095566,Kedlaya; Kiran S.,9997,0,9999,2
1657171695848,MATH 197,003,095567,Xiao; Ming,9999,0,9999,0
1657171695848,MATH 197,004,095571,Perols; Johan Lars,9998,0,9999,1
1657171702913,COGS 9,A01,083615,Shannon; Kyle Michael,7,0,75,68
1657171708942,COGS 11,A01,083617,Boyle; Mary E. T.,22,0,48,26
1657171714970,COGS 13,A01,083071,Bastos; Amalia Pinkusfeld,9,0,71,62
1657171720994,COGS 14A,A01,092681,Semenuks; Arturs,1,1,100,99
1657171727020,COGS 14B,A01,083073,Cheng; Tzu-Han,6,0,63,57
1657171733043,COGS 17,A01,092677,Semenuks; Arturs,4,0,81,77
1657171739068,COGS 100,A01,083619,Allen; Michael Gordon,15,0,70,55
1657171745090,COGS 101A,A01,083621,Davis; Joshua Daniel,9,0,68,59
1657171751112,COGS 101B,A01,091572,Allen; Michael Gordon,9,0,65,56
1657171757139,COGS 101C,A01,083625,Delgado; Tania,17,0,35,18
1657171763164,COGS 107A,A01,083627,Boyle; Mary E. T.,13,0,60,47
1657171769189,COGS 118A,A01,083075,Gupta; Anjum,16,0,76,60
1657171775216,CSE 3,A50,083646,Miranda; Gregory Joseph,24,0,50,26
1657171781251,CSE 8A,A50,083650,Miranda; Gregory Joseph,17,1,56,39
1657171787274,CSE 11,A01,083080,Cao; Yingjun,5,15,40,35
1657171793298,CSE 12,A01,083652,Krause-Levy; Sophia Louisa,24,1,120,96
1657171799331,CSE 15L,A01,083654,Morris; Justin Loren,9,0,50,41
1657171799331,CSE 15L,A02,083655,Morris; Justin Loren,9,0,50,41
1657171805358,CSE 20,A01,083657,Tran; Khoa Dang,38,0,80,42
1657171811385,CSE 21,A01,095574,Bach; Quang Tran,22,0,48,26
1657171817408,CSE 30,A01,083084,Eldon; John,4,0,80,76
1657171817408,CSE 30,B01,095061,Bhaskar; Nishant,7,0,50,43
1657171823432,CSE 100,A01,083659,Cao; Yingjun,4,4,70,66
1657171829459,CSE 134B,A01,083661,Powell; Thomas Allan,20,0,100,80
1657171835486,CSE 140,A01,083663,Gungor; Onat,13,0,85,72
1657171841509,CSE 140L,A01,083088,Eldon; John,17,0,100,83
1657171847535,CSE 175,A01,083665,Kumar; Rakesh,3,0,25,22
1657171853559,CSE 190,A00,092507,Dubnov; Shlomo,7,0,20,13
1657171859584,ECE 45,A01,083139,Congero; Spencer William,5,0,75,70
1657171865615,ECE 65,A50,083695,Saad; Andrew S,12,0,30,18
1657171865615,ECE 65,A51,095125,Saad; Andrew S,25,0,26,1
1657171871644,ECE 109,A01,091882,Touri; Behrouz,19,0,70,51
1657171877668,ECE 180,A00,083140,Abi Samra; Nicholas Camill,1,0,30,29
1657171877668,ECE 180,B00,083141,Abi Samra; Nicholas Camill,0,0,30,30
1657171883693,MATH 10A,A01,083735,Patchell; Gregory David,2,0,30,28
1657171883693,MATH 10A,A02,083736,Patchell; Gregory David,20,0,30,10
1657171883693,MATH 10A,A03,083737,Patchell; Gregory David,16,0,30,14
1657171889722,MATH 10B,A01,083207,Lim; Seonhee,7,0,34,27
1657171889722,MATH 10B,A02,083208,Lim; Seonhee,9,0,35,26
1657171889722,MATH 10B,A03,093472,Lim; Seonhee,5,0,34,29
1657171889722,MATH 10B,B01,083739,Sinha; Shubham,9,0,30,21
1657171895747,MATH 18,A01,083743,Cinel; Cameron Alexander,6,0,30,24
1657171895747,MATH 18,A02,083744,Cinel; Cameron Alexander,15,0,30,15
1657171895747,MATH 18,A03,083745,Cinel; Cameron Alexander,8,0,30,22
1657171895747,MATH 18,B01,083748,Rideout; David Porter,4,0,37,33
1657171895747,MATH 18,B02,083749,Rideout; David Porter,4,0,36,32
1657171895747,MATH 18,B03,083750,Rideout; David Porter,2,0,37,35
1657171895747,MATH 18,B04,083751,Rideout; David Porter,5,0,36,31
1657171895747,MATH 18,B05,093473,Rideout; David Porter,5,0,36,31
1657171895747,MATH 18,B06,093474,Rideout; David Porter,5,0,36,31
1657171901775,MATH 20A,A01,083754,Zheng; Zequn,12,0,40,28
1657171907802,MATH 20B,A01,083756,Briones; Jor-el Thomas Caparas,1,0,36,35
1657171907802,MATH 20B,A02,083757,Briones; Jor-el Thomas Caparas,1,0,36,35
1657171907802,MATH 20B,A03,093475,Briones; Jor-el Thomas Caparas,1,0,36,35
1657171913832,MATH 20C,A01,083760,Briones; Jor-el Thomas Caparas,1,0,35,34
1657171913832,MATH 20C,A02,083761,Briones; Jor-el Thomas Caparas,8,0,35,27
1657171913832,MATH 20C,A03,093476,Briones; Jor-el Thomas Caparas,0,1,36,36
1657171913832,MATH 20C,B01,083762,Bach; Quang Tran,1,0,30,29
1657171919930,MATH 20D,A01,083765,Tran; Brian Kha,4,0,30,26
1657171919930,MATH 20D,A02,083766,Tran; Brian Kha,5,0,30,25
1657171919930,MATH 20D,A03,083767,Tran; Brian Kha,3,0,30,27
1657171925952,MATH 20E,A01,083771,Ganguly; Soumya,7,0,32,25
1657171925952,MATH 20E,A02,083772,Ganguly; Soumya,7,0,32,25
1657171925952,MATH 20E,B01,083773,Ciotti; Benjamin,19,0,35,16
1657171925952,MATH 20E,B02,083774,Ciotti; Benjamin,17,0,35,18
1657171931983,MATH 103A,A01,083777,Greenfeld; Be'Eri,2,0,36,34
1657171931983,MATH 103A,A02,083778,Greenfeld; Be'Eri,5,0,36,31
1657171931983,MATH 103A,A03,093561,Greenfeld; Be'Eri,4,0,36,32
1657171931983,MATH 103A,B01,083779,Greenfeld; Be'Eri,6,0,36,30
1657171931983,MATH 103A,B02,083780,Greenfeld; Be'Eri,3,0,36,33
1657171931983,MATH 103A,B03,093562,Greenfeld; Be'Eri,3,0,36,33
1657171938008,MATH 105,A01,085443,Carter; Anne Toulson,14,0,35,21
1657171938008,MATH 105,A02,093477,Carter; Anne Toulson,20,0,35,15
1657171944033,MATH 109,A01,083213,Ganzberger; Geoffrey Michael,2,0,34,32
1657171944033,MATH 109,A02,083214,Ganzberger; Geoffrey Michael,3,0,34,31
1657171944033,MATH 109,A03,093478,Ganzberger; Geoffrey Michael,1,0,34,33
1657171944033,MATH 109,B01,083215,Ganzberger; Geoffrey Michael,1,0,32,31
1657171944033,MATH 109,B02,083216,Ganzberger; Geoffrey Michael,1,0,32,31
1657171944033,MATH 109,B03,093479,Ganzberger; Geoffrey Michael,6,0,32,26
1657171950061,MATH 142A,A01,083219,Chow; Bennett,6,0,32,26
1657171950061,MATH 142A,A02,083220,Chow; Bennett,10,0,32,22
1657171950061,MATH 142A,A03,093480,Chow; Bennett,7,0,32,25
1657171950061,MATH 142A,B03,093481,Chow; Bennett,8,0,32,24
1657171950061,MATH 142A,B04,093558,Chow; Bennett,11,0,32,21
1657171950061,MATH 142A,B05,093559,Chow; Bennett,6,0,32,26
1657171956084,MATH 193A,A01,083224,Rotar; Vladimir,7,0,34,27
1657171956084,MATH 193A,A02,083225,Rotar; Vladimir,5,0,34,29
1657171956084,MATH 193A,A03,083781,Rotar; Vladimir,1,0,34,33
1657171956084,MATH 193A,A04,083782,Rotar; Vladimir,8,0,34,26
1657171956084,MATH 193A,A05,093482,Rotar; Vladimir,6,0,34,28
1657171962111,MATH 197,001,091859,McAuley; Julian John,9999,0,9999,0
1657171962111,MATH 197,002,095566,Kedlaya; Kiran S.,9997,0,9999,2
1657171962111,MATH 197,003,095567,Xiao; Ming,9999,0,9999,0
1657171962111,MATH 197,004,095571,Perols; Johan Lars,9998,0,9999,1
1657171969173,COGS 9,A01,083615,Shannon; Kyle Michael,7,0,75,68
1657171975195,COGS 11,A01,083617,Boyle; Mary E. T.,22,0,48,26
1657171981218,COGS 13,A01,083071,Bastos; Amalia Pinkusfeld,9,0,71,62
1657171987240,COGS 14A,A01,092681,Semenuks; Arturs,1,1,100,99
1657171993271,COGS 14B,A01,083073,Cheng; Tzu-Han,6,0,63,57
1657171999293,COGS 17,A01,092677,Semenuks; Arturs,4,0,81,77
1657172005319,COGS 100,A01,083619,Allen; Michael Gordon,15,0,70,55
1657172011347,COGS 101A,A01,083621,Davis; Joshua Daniel,9,0,68,59
1657172017369,COGS 101B,A01,091572,Allen; Michael Gordon,9,0,65,56
1657172023391,COGS 101C,A01,083625,Delgado; Tania,17,0,35,18
1657172029418,COGS 107A,A01,083627,Boyle; Mary E. T.,13,0,60,47
1657172035443,COGS 118A,A01,083075,Gupta; Anjum,16,0,76,60
1657172041465,CSE 3,A50,083646,Miranda; Gregory Joseph,24,0,50,26
1657172047491,CSE 8A,A50,083650,Miranda; Gregory Joseph,17,1,56,39
1657172053516,CSE 11,A01,083080,Cao; Yingjun,5,15,40,35
1657172059540,CSE 12,A01,083652,Krause-Levy; Sophia Louisa,24,1,120,96
1657172065573,CSE 15L,A01,083654,Morris; Justin Loren,9,0,50,41
1657172065573,CSE 15L,A02,083655,Morris; Justin Loren,9,0,50,41
1657172071597,CSE 20,A01,083657,Tran; Khoa Dang,38,0,80,42
1657172077628,CSE 21,A01,095574,Bach; Quang Tran,22,0,48,26
1657172083652,CSE 30,A01,083084,Eldon; John,4,0,80,76
1657172083652,CSE 30,B01,095061,Bhaskar; Nishant,7,0,50,43
1657172089678,CSE 100,A01,083659,Cao; Yingjun,4,4,70,66
1657172095716,CSE 134B,A01,083661,Powell; Thomas Allan,20,0,100,80
1657172101757,CSE 140,A01,083663,Gungor; Onat,13,0,85,72
1657172107780,CSE 140L,A01,083088,Eldon; John,17,0,100,83
1657172113807,CSE 175,A01,083665,Kumar; Rakesh,3,0,25,22
1657172119837,CSE 190,A00,092507,Dubnov; Shlomo,7,0,20,13
1657172125859,ECE 45,A01,083139,Congero; Spencer William,5,0,75,70
1657172131883,ECE 65,A50,083695,Saad; Andrew S,12,0,30,18
1657172131883,ECE 65,A51,095125,Saad; Andrew S,25,0,26,1
1657172137908,ECE 109,A01,091882,Touri; Behrouz,19,0,70,51
1657172143931,ECE 180,A00,083140,Abi Samra; Nicholas Camill,1,0,30,29
1657172143931,ECE 180,B00,083141,Abi Samra; Nicholas Camill,0,0,30,30
1657172149959,MATH 10A,A01,083735,Patchell; Gregory David,2,0,30,28
1657172149959,MATH 10A,A02,083736,Patchell; Gregory David,20,0,30,10
1657172149959,MATH 10A,A03,083737,Patchell; Gregory David,16,0,30,14
1657172155984,MATH 10B,A01,083207,Lim; Seonhee,7,0,34,27
1657172155984,MATH 10B,A02,083208,Lim; Seonhee,9,0,35,26
1657172155984,MATH 10B,A03,093472,Lim; Seonhee,5,0,34,29
1657172155984,MATH 10B,B01,083739,Sinha; Shubham,9,0,30,21
1657172162009,MATH 18,A01,083743,Cinel; Cameron Alexander,6,0,30,24
1657172162009,MATH 18,A02,083744,Cinel; Cameron Alexander,15,0,30,15
1657172162009,MATH 18,A03,083745,Cinel; Cameron Alexander,8,0,30,22
1657172162009,MATH 18,B01,083748,Rideout; David Porter,4,0,37,33
1657172162009,MATH 18,B02,083749,Rideout; David Porter,4,0,36,32
1657172162009,MATH 18,B03,083750,Rideout; David Porter,2,0,37,35
1657172162009,MATH 18,B04,083751,Rideout; David Porter,5,0,36,31
1657172162009,MATH 18,B05,093473,Rideout; David Porter,5,0,36,31
1657172162009,MATH 18,B06,093474,Rideout; David Porter,5,0,36,31
1657172168042,MATH 20A,A01,083754,Zheng; Zequn,12,0,40,28
1657172174068,MATH 20B,A01,083756,Briones; Jor-el Thomas Caparas,1,0,36,35
1657172174068,MATH 20B,A02,083757,Briones; Jor-el Thomas Caparas,1,0,36,35
1657172174068,MATH 20B,A03,093475,Briones; Jor-el Thomas Caparas,1,0,36,35
1657172180093,MATH 20C,A01,083760,Briones; Jor-el Thomas Caparas,1,0,35,34
1657172180093,MATH 20C,A02,083761,Briones; Jor-el Thomas Caparas,8,0,35,27
1657172180093,MATH 20C,A03,093476,Briones; Jor-el Thomas Caparas,0,1,36,36
1657172180093,MATH 20C,B01,083762,Bach; Quang Tran,1,0,30,29
1657172186117,MATH 20D,A01,083765,Tran; Brian Kha,4,0,30,26
1657172186117,MATH 20D,A02,083766,Tran; Brian Kha,5,0,30,25
1657172186117,MATH 20D,A03,083767,Tran; Brian Kha,3,0,30,27
1657172192140,MATH 20E,A01,083771,Ganguly; Soumya,7,0,32,25
1657172192140,MATH 20E,A02,083772,Ganguly; Soumya,7,0,32,25
1657172192140,MATH 20E,B01,083773,Ciotti; Benjamin,19,0,35,16
1657172192140,MATH 20E,B02,083774,Ciotti; Benjamin,17,0,35,18
1657172198164,MATH 103A,A01,083777,Greenfeld; Be'Eri,2,0,36,34
1657172198164,MATH 103A,A02,083778,Greenfeld; Be'Eri,5,0,36,31
1657172198164,MATH 103A,A03,093561,Greenfeld; Be'Eri,4,0,36,32
1657172198164,MATH 103A,B01,083779,Greenfeld; Be'Eri,6,0,36,30
1657172198164,MATH 103A,B02,083780,Greenfeld; Be'Eri,3,0,36,33
1657172198164,MATH 103A,B03,093562,Greenfeld; Be'Eri,3,0,36,33
1657172204187,MATH 105,A01,085443,Carter; Anne Toulson,14,0,35,21
1657172204187,MATH 105,A02,093477,Carter; Anne Toulson,20,0,35,15
1657172210213,MATH 109,A01,083213,Ganzberger; Geoffrey Michael,2,0,34,32
1657172210213,MATH 109,A02,083214,Ganzberger; Geoffrey Michael,3,0,34,31
1657172210213,MATH 109,A03,093478,Ganzberger; Geoffrey Michael,1,0,34,33
1657172210213,MATH 109,B01,083215,Ganzberger; Geoffrey Michael,1,0,32,31
1657172210213,MATH 109,B02,083216,Ganzberger; Geoffrey Michael,1,0,32,31
1657172210213,MATH 109,B03,093479,Ganzberger; Geoffrey Michael,6,0,32,26
1657172216237,MATH 142A,A01,083219,Chow; Bennett,6,0,32,26
1657172216237,MATH 142A,A02,083220,Chow; Bennett,10,0,32,22
1657172216237,MATH 142A,A03,093480,Chow; Bennett,7,0,32,25
1657172216237,MATH 142A,B03,093481,Chow; Bennett,8,0,32,24
1657172216237,MATH 142A,B04,093558,Chow; Bennett,11,0,32,21
1657172216237,MATH 142A,B05,093559,Chow; Bennett,6,0,32,26
1657172222260,MATH 193A,A01,083224,Rotar; Vladimir,7,0,34,27
1657172222260,MATH 193A,A02,083225,Rotar; Vladimir,5,0,34,29
1657172222260,MATH 193A,A03,083781,Rotar; Vladimir,1,0,34,33
1657172222260,MATH 193A,A04,083782,Rotar; Vladimir,8,0,34,26
1657172222260,MATH 193A,A05,093482,Rotar; Vladimir,6,0,34,28
1657172228287,MATH 197,001,091859,McAuley; Julian John,9999,0,9999,0
1657172228287,MATH 197,002,095566,Kedlaya; Kiran S.,9997,0,9999,2
1657172228287,MATH 197,003,095567,Xiao; Ming,9999,0,9999,0
1657172228287,MATH 197,004,095571,Perols; Johan Lars,9998,0,9999,1
1657172235348,COGS 9,A01,083615,Shannon; Kyle Michael,7,0,75,68
1657172241378,COGS 11,A01,083617,Boyle; Mary E. T.,22,0,48,26
1657172247405,COGS 13,A01,083071,Bastos; Amalia Pinkusfeld,9,0,71,62
1657172253429,COGS 14A,A01,092681,Semenuks; Arturs,1,1,100,99
1657172259456,COGS 14B,A01,083073,Cheng; Tzu-Han,6,0,63,57
1657172265483,COGS 17,A01,092677,Semenuks; Arturs,4,0,81,77
1657172271510,COGS 100,A01,083619,Allen; Michael Gordon,15,0,70,55
1657172277538,COGS 101A,A01,083621,Davis; Joshua Daniel,9,0,68,59
1657172283561,COGS 101B,A01,091572,Allen; Michael Gordon,9,0,65,56
1657172289589,COGS 101C,A01,083625,Delgado; Tania,17,0,35,18
1657172295612,COGS 107A,A01,083627,Boyle; Mary E. T.,13,0,60,47
1657172301634,COGS 118A,A01,083075,Gupta; Anjum,16,0,76,60
1657172307657,CSE 3,A50,083646,Miranda; Gregory Joseph,24,0,50,26
1657172313684,CSE 8A,A50,083650,Miranda; Gregory Joseph,17,1,56,39
1657172319714,CSE 11,A01,083080,Cao; Yingjun,5,15,40,35
1657172325746,CSE 12,A01,083652,Krause-Levy; Sophia Louisa,24,1,120,96
1657172331770,CSE 15L,A01,083654,Morris; Justin Loren,9,0,50,41
1657172331770,CSE 15L,A02,083655,Morris; Justin Loren,9,0,50,41
1657172337795,CSE 20,A01,083657,Tran; Khoa Dang,38,0,80,42
1657172343821,CSE 21,A01,095574,Bach; Quang Tran,22,0,48,26
1657172349844,CSE 30,A01,083084,Eldon; John,4,0,80,76
1657172349844,CSE 30,B01,095061,Bhaskar; Nishant,7,0,50,43
1657172355875,CSE 100,A01,083659,Cao; Yingjun,4,4,70,66
1657172361897,CSE 134B,A01,083661,Powell; Thomas Allan,20,0,100,80
1657172367921,CSE 140,A01,083663,Gungor; Onat,13,0,85,72
1657172373946,CSE 140L,A01,083088,Eldon; John,17,0,100,83
1657172379969,CSE 175,A01,083665,Kumar; Rakesh,3,0,25,22
1657172385994,CSE 190,A00,092507,Dubnov; Shlomo,7,0,20,13
1657172392020,ECE 45,A01,083139,Congero; Spencer William,5,0,75,70
1657172398046,ECE 65,A50,083695,Saad; Andrew S,12,0,30,18
1657172398046,ECE 65,A51,095125,Saad; Andrew S,25,0,26,1
1657172404069,ECE 109,A01,091882,Touri; Behrouz,19,0,70,51
1657172410093,ECE 180,A00,083140,Abi Samra; Nicholas Camill,1,0,30,29
1657172410093,ECE 180,B00,083141,Abi Samra; Nicholas Camill,0,0,30,30
1657172416121,MATH 10A,A01,083735,Patchell; Gregory David,2,0,30,28
1657172416121,MATH 10A,A02,083736,Patchell; Gregory David,20,0,30,10
1657172416121,MATH 10A,A03,083737,Patchell; Gregory David,16,0,30,14
1657172422149,MATH 10B,A01,083207,Lim; Seonhee,7,0,34,27
1657172422149,MATH 10B,A02,083208,Lim; Seonhee,9,0,35,26
1657172422149,MATH 10B,A03,093472,Lim; Seonhee,5,0,34,29
1657172422149,MATH 10B,B01,083739,Sinha; Shubham,9,0,30,21
1657172428174,MATH 18,A01,083743,Cinel; Cameron Alexander,6,0,30,24
1657172428174,MATH 18,A02,083744,Cinel; Cameron Alexander,15,0,30,15
1657172428174,MATH 18,A03,083745,Cinel; Cameron Alexander,8,0,30,22
1657172428174,MATH 18,B01,083748,Rideout; David Porter,4,0,37,33
1657172428174,MATH 18,B02,083749,Rideout; David Porter,4,0,36,32
1657172428174,MATH 18,B03,083750,Rideout; David Porter,2,0,37,35
1657172428174,MATH 18,B04,083751,Rideout; David Porter,5,0,36,31
1657172428174,MATH 18,B05,093473,Rideout; David Porter,5,0,36,31
1657172428174,MATH 18,B06,093474,Rideout; David Porter,5,0,36,31
1657172434197,MATH 20A,A01,083754,Zheng; Zequn,12,0,40,28
1657172440227,MATH 20B,A01,083756,Briones; Jor-el Thomas Caparas,1,0,36,35
1657172440227,MATH 20B,A02,083757,Briones; Jor-el Thomas Caparas,1,0,36,35
1657172440227,MATH 20B,A03,093475,Briones; Jor-el Thomas Caparas,1,0,36,35
1657172446250,MATH 20C,A01,083760,Briones; Jor-el Thomas Caparas,1,0,35,34
1657172446250,MATH 20C,A02,083761,Briones; Jor-el Thomas Caparas,8,0,35,27
1657172446250,MATH 20C,A03,093476,Briones; Jor-el Thomas Caparas,0,1,36,36
1657172446250,MATH 20C,B01,083762,Bach; Quang Tran,1,0,30,29
1657172452277,MATH 20D,A01,083765,Tran; Brian Kha,4,0,30,26
1657172452277,MATH 20D,A02,083766,Tran; Brian Kha,5,0,30,25
1657172452277,MATH 20D,A03,083767,Tran; Brian Kha,3,0,30,27
1657172458305,MATH 20E,A01,083771,Ganguly; Soumya,7,0,32,25
1657172458305,MATH 20E,A02,083772,Ganguly; Soumya,7,0,32,25
1657172458305,MATH 20E,B01,083773,Ciotti; Benjamin,19,0,35,16
1657172458305,MATH 20E,B02,083774,Ciotti; Benjamin,17,0,35,18
1657172464336,MATH 103A,A01,083777,Greenfeld; Be'Eri,2,0,36,34
1657172464336,MATH 103A,A02,083778,Greenfeld; Be'Eri,5,0,36,31
1657172464336,MATH 103A,A03,093561,Greenfeld; Be'Eri,4,0,36,32
1657172464336,MATH 103A,B01,083779,Greenfeld; Be'Eri,6,0,36,30
1657172464336,MATH 103A,B02,083780,Greenfeld; Be'Eri,3,0,36,33
1657172464336,MATH 103A,B03,093562,Greenfeld; Be'Eri,3,0,36,33
1657172470369,MATH 105,A01,085443,Carter; Anne Toulson,14,0,35,21
1657172470369,MATH 105,A02,093477,Carter; Anne Toulson,20,0,35,15
1657172476403,MATH 109,A01,083213,Ganzberger; Geoffrey Michael,2,0,34,32
1657172476403,MATH 109,A02,083214,Ganzberger; Geoffrey Michael,3,0,34,31
1657172476403,MATH 109,A03,093478,Ganzberger; Geoffrey Michael,1,0,34,33
1657172476403,MATH 109,B01,083215,Ganzberger; Geoffrey Michael,1,0,32,31
1657172476403,MATH 109,B02,083216,Ganzberger; Geoffrey Michael,1,0,32,31
1657172476403,MATH 109,B03,093479,Ganzberger; Geoffrey Michael,6,0,32,26
1657172482427,MATH 142A,A01,083219,Chow; Bennett,6,0,32,26
1657172482427,MATH 142A,A02,083220,Chow; Bennett,10,0,32,22
1657172482427,MATH 142A,A03,093480,Chow; Bennett,7,0,32,25
1657172482427,MATH 142A,B03,093481,Chow; Bennett,8,0,32,24
1657172482427,MATH 142A,B04,093558,Chow; Bennett,11,0,32,21
1657172482427,MATH 142A,B05,093559,Chow; Bennett,6,0,32,26
1657172488454,MATH 193A,A01,083224,Rotar; Vladimir,7,0,34,27
1657172488454,MATH 193A,A02,083225,Rotar; Vladimir,5,0,34,29
1657172488454,MATH 193A,A03,083781,Rotar; Vladimir,1,0,34,33
1657172488454,MATH 193A,A04,083782,Rotar; Vladimir,8,0,34,26
1657172488454,MATH 193A,A05,093482,Rotar; Vladimir,6,0,34,28
1657172494478,MATH 197,001,091859,McAuley; Julian John,9999,0,9999,0
1657172494478,MATH 197,002,095566,Kedlaya; Kiran S.,9997,0,9999,2
1657172494478,MATH 197,003,095567,Xiao; Ming,9999,0,9999,0
1657172494478,MATH 197,004,095571,Perols; Johan Lars,9998,0,9999,1
1657172501529,COGS 9,A01,083615,Shannon; Kyle Michael,7,0,75,68
1657172507551,COGS 11,A01,083617,Boyle; Mary E. T.,22,0,48,26
1657172513651,COGS 13,A01,083071,Bastos; Amalia Pinkusfeld,9,0,71,62
1657172519677,COGS 14A,A01,092681,Semenuks; Arturs,1,1,100,99
1657172525699,COGS 14B,A01,083073,Cheng; Tzu-Han,6,0,63,57
1657172531724,COGS 17,A01,092677,Semenuks; Arturs,4,0,81,77
1657172537747,COGS 100,A01,083619,Allen; Michael Gordon,15,0,70,55
1657172543771,COGS 101A,A01,083621,Davis; Joshua Daniel,9,0,68,59
1657172549810,COGS 101B,A01,091572,Allen; Michael Gordon,9,0,65,56
1657172555837,COGS 101C,A01,083625,Delgado; Tania,17,0,35,18
1657172561865,COGS 107A,A01,083627,Boyle; Mary E. T.,13,0,60,47
1657172567892,COGS 118A,A01,083075,Gupta; Anjum,16,0,76,60
1657172573920,CSE 3,A50,083646,Miranda; Gregory Joseph,24,0,50,26
1657172579944,CSE 8A,A50,083650,Miranda; Gregory Joseph,17,1,56,39
1657172585969,CSE 11,A01,083080,Cao; Yingjun,5,15,40,35
1657172591995,CSE 12,A01,083652,Krause-Levy; Sophia Louisa,24,1,120,96
1657172598023,CSE 15L,A01,083654,Morris; Justin Loren,9,0,50,41
1657172598023,CSE 15L,A02,083655,Morris; Justin Loren,9,0,50,41
1657172604046,CSE 20,A01,083657,Tran; Khoa Dang,38,0,80,42
1657172610068,CSE 21,A01,095574,Bach; Quang Tran,22,0,48,26
1657172616094,CSE 30,A01,083084,Eldon; John,4,0,80,76
1657172616094,CSE 30,B01,095061,Bhaskar; Nishant,7,0,50,43
1657172622120,CSE 100,A01,083659,Cao; Yingjun,4,4,70,66
1657172628144,CSE 134B,A01,083661,Powell; Thomas Allan,20,0,100,80
1657172634168,CSE 140,A01,083663,Gungor; Onat,13,0,85,72
1657172640195,CSE 140L,A01,083088,Eldon; John,17,0,100,83
1657172646218,CSE 175,A01,083665,Kumar; Rakesh,3,0,25,22
1657172652244,CSE 190,A00,092507,Dubnov; Shlomo,7,0,20,13
1657172658266,ECE 45,A01,083139,Congero; Spencer William,5,0,75,70
1657172664291,ECE 65,A50,083695,Saad; Andrew S,12,0,30,18
1657172664291,ECE 65,A51,095125,Saad; Andrew S,25,0,26,1
1657172670314,ECE 109,A01,091882,Touri; Behrouz,19,0,70,51
1657172676338,ECE 180,A00,083140,Abi Samra; Nicholas Camill,1,0,30,29
1657172676338,ECE 180,B00,083141,Abi Samra; Nicholas Camill,0,0,30,30
1657172682364,MATH 10A,A01,083735,Patchell; Gregory David,2,0,30,28
1657172682364,MATH 10A,A02,083736,Patchell; Gregory David,20,0,30,10
1657172682364,MATH 10A,A03,083737,Patchell; Gregory David,16,0,30,14
1657172688393,MATH 10B,A01,083207,Lim; Seonhee,7,0,34,27
1657172688393,MATH 10B,A02,083208,Lim; Seonhee,9,0,35,26
1657172688393,MATH 10B,A03,093472,Lim; Seonhee,5,0,34,29
1657172688393,MATH 10B,B01,083739,Sinha; Shubham,9,0,30,21
1657172694432,MATH 18,A01,083743,Cinel; Cameron Alexander,6,0,30,24
1657172694432,MATH 18,A02,083744,Cinel; Cameron Alexander,15,0,30,15
1657172694432,MATH 18,A03,083745,Cinel; Cameron Alexander,8,0,30,22
1657172694432,MATH 18,B01,083748,Rideout; David Porter,4,0,37,33
1657172694432,MATH 18,B02,083749,Rideout; David Porter,4,0,36,32
1657172694432,MATH 18,B03,083750,Rideout; David Porter,2,0,37,35
1657172694432,MATH 18,B04,083751,Rideout; David Porter,5,0,36,31
1657172694432,MATH 18,B05,093473,Rideout; David Porter,5,0,36,31
1657172694432,MATH 18,B06,093474,Rideout; David Porter,5,0,36,31
1657172700457,MATH 20A,A01,083754,Zheng; Zequn,12,0,40,28
1657172706479,MATH 20B,A01,083756,Briones; Jor-el Thomas Caparas,1,0,36,35
1657172706479,MATH 20B,A02,083757,Briones; Jor-el Thomas Caparas,1,0,36,35
1657172706479,MATH 20B,A03,093475,Briones; Jor-el Thomas Caparas,1,0,36,35
1657172712503,MATH 20C,A01,083760,Briones; Jor-el Thomas Caparas,1,0,35,34
1657172712503,MATH 20C,A02,083761,Briones; Jor-el Thomas Caparas,8,0,35,27
1657172712503,MATH 20C,A03,093476,Briones; Jor-el Thomas Caparas,0,1,36,36
1657172712503,MATH 20C,B01,083762,Bach; Quang Tran,1,0,30,29
1657172718526,MATH 20D,A01,083765,Tran; Brian Kha,4,0,30,26
1657172718526,MATH 20D,A02,083766,Tran; Brian Kha,5,0,30,25
1657172718526,MATH 20D,A03,083767,Tran; Brian Kha,3,0,30,27
1657172724554,MATH 20E,A01,083771,Ganguly; Soumya,7,0,32,25
1657172724554,MATH 20E,A02,083772,Ganguly; Soumya,7,0,32,25
1657172724554,MATH 20E,B01,083773,Ciotti; Benjamin,19,0,35,16
1657172724554,MATH 20E,B02,083774,Ciotti; Benjamin,17,0,35,18
1657172730583,MATH 103A,A01,083777,Greenfeld; Be'Eri,2,0,36,34
1657172730583,MATH 103A,A02,083778,Greenfeld; Be'Eri,5,0,36,31
1657172730583,MATH 103A,A03,093561,Greenfeld; Be'Eri,4,0,36,32
1657172730583,MATH 103A,B01,083779,Greenfeld; Be'Eri,6,0,36,30
1657172730583,MATH 103A,B02,083780,Greenfeld; Be'Eri,3,0,36,33
1657172730583,MATH 103A,B03,093562,Greenfeld; Be'Eri,3,0,36,33
1657172736606,MATH 105,A01,085443,Carter; Anne Toulson,14,0,35,21
1657172736606,MATH 105,A02,093477,Carter; Anne Toulson,20,0,35,15
1657172742636,MATH 109,A01,083213,Ganzberger; Geoffrey Michael,2,0,34,32
1657172742636,MATH 109,A02,083214,Ganzberger; Geoffrey Michael,3,0,34,31
1657172742636,MATH 109,A03,093478,Ganzberger; Geoffrey Michael,1,0,34,33
1657172742636,MATH 109,B01,083215,Ganzberger; Geoffrey Michael,1,0,32,31
1657172742636,MATH 109,B02,083216,Ganzberger; Geoffrey Michael,1,0,32,31
1657172742636,MATH 109,B03,093479,Ganzberger; Geoffrey Michael,6,0,32,26
1657172748659,MATH 142A,A01,083219,Chow; Bennett,6,0,32,26
1657172748659,MATH 142A,A02,083220,Chow; Bennett,10,0,32,22
1657172748659,MATH 142A,A03,093480,Chow; Bennett,7,0,32,25
1657172748659,MATH 142A,B03,093481,Chow; Bennett,8,0,32,24
1657172748659,MATH 142A,B04,093558,Chow; Bennett,11,0,32,21
1657172748659,MATH 142A,B05,093559,Chow; Bennett,6,0,32,26
1657172754683,MATH 193A,A01,083224,Rotar; Vladimir,7,0,34,27
1657172754683,MATH 193A,A02,083225,Rotar; Vladimir,5,0,34,29
1657172754683,MATH 193A,A03,083781,Rotar; Vladimir,1,0,34,33
1657172754683,MATH 193A,A04,083782,Rotar; Vladimir,8,0,34,26
1657172754683,MATH 193A,A05,093482,Rotar; Vladimir,6,0,34,28
1657172760708,MATH 197,001,091859,McAuley; Julian John,9999,0,9999,0
1657172760708,MATH 197,002,095566,Kedlaya; Kiran S.,9997,0,9999,2
1657172760708,MATH 197,003,095567,Xiao; Ming,9999,0,9999,0
1657172760708,MATH 197,004,095571,Perols; Johan Lars,9998,0,9999,1
1657172767773,COGS 9,A01,083615,Shannon; Kyle Michael,7,0,75,68
1657172773798,COGS 11,A01,083617,Boyle; Mary E. T.,22,0,48,26
1657172779821,COGS 13,A01,083071,Bastos; Amalia Pinkusfeld,9,0,71,62
1657172785847,COGS 14A,A01,092681,Semenuks; Arturs,1,1,100,99
1657172791885,COGS 14B,A01,083073,Cheng; Tzu-Han,6,0,63,57
1657172797911,COGS 17,A01,092677,Semenuks; Arturs,4,0,81,77
1657172803935,COGS 100,A01,083619,Allen; Michael Gordon,15,0,70,55
1657172809958,COGS 101A,A01,083621,Davis; Joshua Daniel,9,0,68,59
1657172815983,COGS 101B,A01,091572,Allen; Michael Gordon,9,0,65,56
1657172822010,COGS 101C,A01,083625,Delgado; Tania,17,0,35,18
1657172828033,COGS 107A,A01,083627,Boyle; Mary E. T.,13,0,60,47
1657172834058,COGS 118A,A01,083075,Gupta; Anjum,16,0,76,60
1657172840084,CSE 3,A50,083646,Miranda; Gregory Joseph,24,0,50,26
1657172846108,CSE 8A,A50,083650,Miranda; Gregory Joseph,17,1,56,39
1657172852132,CSE 11,A01,083080,Cao; Yingjun,5,15,40,35
1657172858160,CSE 12,A01,083652,Krause-Levy; Sophia Louisa,24,1,120,96
1657172864185,CSE 15L,A01,083654,Morris; Justin Loren,9,0,50,41
1657172864185,CSE 15L,A02,083655,Morris; Justin Loren,9,0,50,41
1657172870209,CSE 20,A01,083657,Tran; Khoa Dang,38,0,80,42
1657172876236,CSE 21,A01,095574,Bach; Quang Tran,22,0,48,26
1657172882258,CSE 30,A01,083084,Eldon; John,4,0,80,76
1657172882258,CSE 30,B01,095061,Bhaskar; Nishant,7,0,50,43
1657172888291,CSE 100,A01,083659,Cao; Yingjun,4,4,70,66
1657172894317,CSE 134B,A01,083661,Powell; Thomas Allan,20,0,100,80
1657172900340,CSE 140,A01,083663,Gungor; Onat,13,0,85,72
1657172906366,CSE 140L,A01,083088,Eldon; John,17,0,100,83
1657172912390,CSE 175,A01,083665,Kumar; Rakesh,3,0,25,22
1657172918415,CSE 190,A00,092507,Dubnov; Shlomo,7,0,20,13
1657172924442,ECE 45,A01,083139,Congero; Spencer William,5,0,75,70
1657172930465,ECE 65,A50,083695,Saad; Andrew S,12,0,30,18
1657172930465,ECE 65,A51,095125,Saad; Andrew S,25,0,26,1
1657172936486,ECE 109,A01,091882,Touri; Behrouz,19,0,70,51
1657172942508,ECE 180,A00,083140,Abi Samra; Nicholas Camill,1,0,30,29
1657172942508,ECE 180,B00,083141,Abi Samra; Nicholas Camill,0,0,30,30
1657172948539,MATH 10A,A01,083735,Patchell; Gregory David,2,0,30,28
1657172948539,MATH 10A,A02,083736,Patchell; Gregory David,20,0,30,10
1657172948539,MATH 10A,A03,083737,Patchell; Gregory David,16,0,30,14
1657172954567,MATH 10B,A01,083207,Lim; Seonhee,7,0,34,27
1657172954567,MATH 10B,A02,083208,Lim; Seonhee,9,0,35,26
1657172954567,MATH 10B,A03,093472,Lim; Seonhee,5,0,34,29
1657172954567,MATH 10B,B01,083739,Sinha; Shubham,9,0,30,21
1657172960599,MATH 18,A01,083743,Cinel; Cameron Alexander,6,0,30,24
1657172960599,MATH 18,A02,083744,Cinel; Cameron Alexander,15,0,30,15
1657172960599,MATH 18,A03,083745,Cinel; Cameron Alexander,8,0,30,22
1657172960599,MATH 18,B01,083748,Rideout; David Porter,4,0,37,33
1657172960599,MATH 18,B02,083749,Rideout; David Porter,4,0,36,32
1657172960599,MATH 18,B03,083750,Rideout; David Porter,2,0,37,35
1657172960599,MATH 18,B04,083751,Rideout; David Porter,5,0,36,31
1657172960599,MATH 18,B05,093473,Rideout; David Porter,5,0,36,31
1657172960599,MATH 18,B06,093474,Rideout; David Porter,5,0,36,31
1657172966626,MATH 20A,A01,083754,Zheng; Zequn,12,0,40,28
1657172972653,MATH 20B,A01,083756,Briones; Jor-el Thomas Caparas,1,0,36,35
1657172972653,MATH 20B,A02,083757,Briones; Jor-el Thomas Caparas,1,0,36,35
1657172972653,MATH 20B,A03,093475,Briones; Jor-el Thomas Caparas,1,0,36,35
1657172978677,MATH 20C,A01,083760,Briones; Jor-el Thomas Caparas,1,0,35,34
1657172978677,MATH 20C,A02,083761,Briones; Jor-el Thomas Caparas,8,0,35,27
1657172978677,MATH 20C,A03,093476,Briones; Jor-el Thomas Caparas,0,1,36,36
1657172978677,MATH 20C,B01,083762,Bach; Quang Tran,1,0,30,29
1657172984706,MATH 20D,A01,083765,Tran; Brian Kha,4,0,30,26
1657172984706,MATH 20D,A02,083766,Tran; Brian Kha,5,0,30,25
1657172984706,MATH 20D,A03,083767,Tran; Brian Kha,3,0,30,27
1657172990729,MATH 20E,A01,083771,Ganguly; Soumya,7,0,32,25
1657172990729,MATH 20E,A02,083772,Ganguly; Soumya,7,0,32,25
1657172990729,MATH 20E,B01,083773,Ciotti; Benjamin,19,0,35,16
1657172990729,MATH 20E,B02,083774,Ciotti; Benjamin,17,0,35,18
1657172996752,MATH 103A,A01,083777,Greenfeld; Be'Eri,2,0,36,34
1657172996752,MATH 103A,A02,083778,Greenfeld; Be'Eri,5,0,36,31
1657172996752,MATH 103A,A03,093561,Greenfeld; Be'Eri,4,0,36,32
1657172996752,MATH 103A,B01,083779,Greenfeld; Be'Eri,6,0,36,30
1657172996752,MATH 103A,B02,083780,Greenfeld; Be'Eri,3,0,36,33
1657172996752,MATH 103A,B03,093562,Greenfeld; Be'Eri,3,0,36,33
1657173002777,MATH 105,A01,085443,Carter; Anne Toulson,14,0,35,21
1657173002777,MATH 105,A02,093477,Carter; Anne Toulson,20,0,35,15
1657173008799,MATH 109,A01,083213,Ganzberger; Geoffrey Michael,2,0,34,32
1657173008799,MATH 109,A02,083214,Ganzberger; Geoffrey Michael,3,0,34,31
1657173008799,MATH 109,A03,093478,Ganzberger; Geoffrey Michael,1,0,34,33
1657173008799,MATH 109,B01,083215,Ganzberger; Geoffrey Michael,1,0,32,31
1657173008799,MATH 109,B02,083216,Ganzberger; Geoffrey Michael,1,0,32,31
1657173008799,MATH 109,B03,093479,Ganzberger; Geoffrey Michael,6,0,32,26
1657173014825,MATH 142A,A01,083219,Chow; Bennett,6,0,32,26
1657173014825,MATH 142A,A02,083220,Chow; Bennett,10,0,32,22
1657173014825,MATH 142A,A03,093480,Chow; Bennett,7,0,32,25
1657173014825,MATH 142A,B03,093481,Chow; Bennett,8,0,32,24
1657173014825,MATH 142A,B04,093558,Chow; Bennett,11,0,32,21
1657173014825,MATH 142A,B05,093559,Chow; Bennett,6,0,32,26
1657173020848,MATH 193A,A01,083224,Rotar; Vladimir,7,0,34,27
1657173020848,MATH 193A,A02,083225,Rotar; Vladimir,5,0,34,29
1657173020848,MATH 193A,A03,083781,Rotar; Vladimir,1,0,34,33
1657173020848,MATH 193A,A04,083782,Rotar; Vladimir,8,0,34,26
1657173020848,MATH 193A,A05,093482,Rotar; Vladimir,6,0,34,28
1657173026871,MATH 197,001,091859,McAuley; Julian John,9999,0,9999,0
1657173026871,MATH 197,002,095566,Kedlaya; Kiran S.,9997,0,9999,2
1657173026871,MATH 197,003,095567,Xiao; Ming,9999,0,9999,0
1657173026871,MATH 197,004,095571,Perols; Johan Lars,9998,0,9999,1
1657173033933,COGS 9,A01,083615,Shannon; Kyle Michael,7,0,75,68
1657173039957,COGS 11,A01,083617,Boyle; Mary E. T.,22,0,48,26
1657173045981,COGS 13,A01,083071,Bastos; Amalia Pinkusfeld,9,0,71,62
1657173052008,COGS 14A,A01,092681,Semenuks; Arturs,1,1,100,99
1657173058031,COGS 14B,A01,083073,Cheng; Tzu-Han,6,0,63,57
1657173064055,COGS 17,A01,092677,Semenuks; Arturs,4,0,81,77
1657173070082,COGS 100,A01,083619,Allen; Michael Gordon,15,0,70,55
1657173076104,COGS 101A,A01,083621,Davis; Joshua Daniel,9,0,68,59
1657173082129,COGS 101B,A01,091572,Allen; Michael Gordon,9,0,65,56
1657173088157,COGS 101C,A01,083625,Delgado; Tania,17,0,35,18
1657173094183,COGS 107A,A01,083627,Boyle; Mary E. T.,13,0,60,47
1657173100211,COGS 118A,A01,083075,Gupta; Anjum,16,0,76,60
1657173106234,CSE 3,A50,083646,Miranda; Gregory Joseph,24,0,50,26
1657173112339,CSE 8A,A50,083650,Miranda; Gregory Joseph,17,1,56,39
1657173118372,CSE 11,A01,083080,Cao; Yingjun,5,15,40,35
1657173124399,CSE 12,A01,083652,Krause-Levy; Sophia Louisa,24,1,120,96
1657173130426,CSE 15L,A01,083654,Morris; Justin Loren,9,0,50,41
1657173130426,CSE 15L,A02,083655,Morris; Justin Loren,9,0,50,41
1657173136461,CSE 20,A01,083657,Tran; Khoa Dang,38,0,80,42
1657173142488,CSE 21,A01,095574,Bach; Quang Tran,22,0,48,26
1657173148513,CSE 30,A01,083084,Eldon; John,4,0,80,76
1657173148513,CSE 30,B01,095061,Bhaskar; Nishant,7,0,50,43
1657173154541,CSE 100,A01,083659,Cao; Yingjun,4,4,70,66
1657173160567,CSE 134B,A01,083661,Powell; Thomas Allan,20,0,100,80
1657173166600,CSE 140,A01,083663,Gungor; Onat,13,0,85,72
1657173172624,CSE 140L,A01,083088,Eldon; John,17,0,100,83
1657173178652,CSE 175,A01,083665,Kumar; Rakesh,3,0,25,22
1657173184675,CSE 190,A00,092507,Dubnov; Shlomo,7,0,20,13
1657173190698,ECE 45,A01,083139,Congero; Spencer William,5,0,75,70
1657173196727,ECE 65,A50,083695,Saad; Andrew S,12,0,30,18
1657173196727,ECE 65,A51,095125,Saad; Andrew S,25,0,26,1
1657173202753,ECE 109,A01,091882,Touri; Behrouz,19,0,70,51
1657173208775,ECE 180,A00,083140,Abi Samra; Nicholas Camill,1,0,30,29
1657173208775,ECE 180,B00,083141,Abi Samra; Nicholas Camill,0,0,30,30
1657173214798,MATH 10A,A01,083735,Patchell; Gregory David,2,0,30,28
1657173214798,MATH 10A,A02,083736,Patchell; Gregory David,20,0,30,10
1657173214798,MATH 10A,A03,083737,Patchell; Gregory David,16,0,30,14
1657173220821,MATH 10B,A01,083207,Lim; Seonhee,7,0,34,27
1657173220821,MATH 10B,A02,083208,Lim; Seonhee,9,0,35,26
1657173220821,MATH 10B,A03,093472,Lim; Seonhee,5,0,34,29
1657173220821,MATH 10B,B01,083739,Sinha; Shubham,9,0,30,21
1657173226845,MATH 18,A01,083743,Cinel; Cameron Alexander,6,0,30,24
1657173226845,MATH 18,A02,083744,Cinel; Cameron Alexander,15,0,30,15
1657173226845,MATH 18,A03,083745,Cinel; Cameron Alexander,8,0,30,22
1657173226845,MATH 18,B01,083748,Rideout; David Porter,4,0,37,33
1657173226845,MATH 18,B02,083749,Rideout; David Porter,4,0,36,32
1657173226845,MATH 18,B03,083750,Rideout; David Porter,2,0,37,35
1657173226845,MATH 18,B04,083751,Rideout; David Porter,5,0,36,31
1657173226845,MATH 18,B05,093473,Rideout; David Porter,5,0,36,31
1657173226845,MATH 18,B06,093474,Rideout; David Porter,5,0,36,31
1657173232869,MATH 20A,A01,083754,Zheng; Zequn,12,0,40,28
1657173238893,MATH 20B,A01,083756,Briones; Jor-el Thomas Caparas,1,0,36,35
1657173238893,MATH 20B,A02,083757,Briones; Jor-el Thomas Caparas,1,0,36,35
1657173238893,MATH 20B,A03,093475,Briones; Jor-el Thomas Caparas,1,0,36,35
1657173244921,MATH 20C,A01,083760,Briones; Jor-el Thomas Caparas,1,0,35,34
1657173244921,MATH 20C,A02,083761,Briones; Jor-el Thomas Caparas,8,0,35,27
1657173244921,MATH 20C,A03,093476,Briones; Jor-el Thomas Caparas,0,1,36,36
1657173244921,MATH 20C,B01,083762,Bach; Quang Tran,1,0,30,29
1657173250948,MATH 20D,A01,083765,Tran; Brian Kha,4,0,30,26
1657173250948,MATH 20D,A02,083766,Tran; Brian Kha,5,0,30,25
1657173250948,MATH 20D,A03,083767,Tran; Brian Kha,3,0,30,27
1657173256976,MATH 20E,A01,083771,Ganguly; Soumya,7,0,32,25
1657173256976,MATH 20E,A02,083772,Ganguly; Soumya,7,0,32,25
1657173256976,MATH 20E,B01,083773,Ciotti; Benjamin,19,0,35,16
1657173256976,MATH 20E,B02,083774,Ciotti; Benjamin,17,0,35,18
1657173263006,MATH 103A,A01,083777,Greenfeld; Be'Eri,2,0,36,34
1657173263006,MATH 103A,A02,083778,Greenfeld; Be'Eri,5,0,36,31
1657173263006,MATH 103A,A03,093561,Greenfeld; Be'Eri,4,0,36,32
1657173263006,MATH 103A,B01,083779,Greenfeld; Be'Eri,6,0,36,30
1657173263006,MATH 103A,B02,083780,Greenfeld; Be'Eri,3,0,36,33
1657173263006,MATH 103A,B03,093562,Greenfeld; Be'Eri,3,0,36,33
1657173269032,MATH 105,A01,085443,Carter; Anne Toulson,14,0,35,21
1657173269032,MATH 105,A02,093477,Carter; Anne Toulson,20,0,35,15
1657173275061,MATH 109,A01,083213,Ganzberger; Geoffrey Michael,2,0,34,32
1657173275061,MATH 109,A02,083214,Ganzberger; Geoffrey Michael,3,0,34,31
1657173275061,MATH 109,A03,093478,Ganzberger; Geoffrey Michael,1,0,34,33
1657173275061,MATH 109,B01,083215,Ganzberger; Geoffrey Michael,1,0,32,31
1657173275061,MATH 109,B02,083216,Ganzberger; Geoffrey Michael,1,0,32,31
1657173275061,MATH 109,B03,093479,Ganzberger; Geoffrey Michael,6,0,32,26
1657173281091,MATH 142A,A01,083219,Chow; Bennett,6,0,32,26
1657173281091,MATH 142A,A02,083220,Chow; Bennett,10,0,32,22
1657173281091,MATH 142A,A03,093480,Chow; Bennett,7,0,32,25
1657173281091,MATH 142A,B03,093481,Chow; Bennett,8,0,32,24
1657173281091,MATH 142A,B04,093558,Chow; Bennett,11,0,32,21
1657173281091,MATH 142A,B05,093559,Chow; Bennett,6,0,32,26
1657173287114,MATH 193A,A01,083224,Rotar; Vladimir,7,0,34,27
1657173287114,MATH 193A,A02,083225,Rotar; Vladimir,5,0,34,29
1657173287114,MATH 193A,A03,083781,Rotar; Vladimir,1,0,34,33
1657173287114,MATH 193A,A04,083782,Rotar; Vladimir,8,0,34,26
1657173287114,MATH 193A,A05,093482,Rotar; Vladimir,6,0,34,28
1657173293138,MATH 197,001,091859,McAuley; Julian John,9999,0,9999,0
1657173293138,MATH 197,002,095566,Kedlaya; Kiran S.,9997,0,9999,2
1657173293138,MATH 197,003,095567,Xiao; Ming,9999,0,9999,0
1657173293138,MATH 197,004,095571,Perols; Johan Lars,9998,0,9999,1
1657173300202,COGS 9,A01,083615,Shannon; Kyle Michael,7,0,75,68
1657173306225,COGS 11,A01,083617,Boyle; Mary E. T.,22,0,48,26
1657173312248,COGS 13,A01,083071,Bastos; Amalia Pinkusfeld,9,0,71,62
1657173318272,COGS 14A,A01,092681,Semenuks; Arturs,1,1,100,99
1657173324300,COGS 14B,A01,083073,Cheng; Tzu-Han,6,0,63,57
1657173330322,COGS 17,A01,092677,Semenuks; Arturs,4,0,81,77
1657173336347,COGS 100,A01,083619,Allen; Michael Gordon,15,0,70,55
1657173342381,COGS 101A,A01,083621,Davis; Joshua Daniel,9,0,68,59
1657173348409,COGS 101B,A01,091572,Allen; Michael Gordon,9,0,65,56
1657173354433,COGS 101C,A01,083625,Delgado; Tania,17,0,35,18
1657173360460,COGS 107A,A01,083627,Boyle; Mary E. T.,13,0,60,47
1657173366483,COGS 118A,A01,083075,Gupta; Anjum,16,0,76,60
1657173372510,CSE 3,A50,083646,Miranda; Gregory Joseph,24,0,50,26
1657173378533,CSE 8A,A50,083650,Miranda; Gregory Joseph,17,1,56,39
1657173384561,CSE 11,A01,083080,Cao; Yingjun,5,15,40,35
1657173390585,CSE 12,A01,083652,Krause-Levy; Sophia Louisa,24,1,120,96
1657173396613,CSE 15L,A01,083654,Morris; Justin Loren,9,0,50,41
1657173396613,CSE 15L,A02,083655,Morris; Justin Loren,9,0,50,41
1657173402637,CSE 20,A01,083657,Tran; Khoa Dang,38,0,80,42
1657173408662,CSE 21,A01,095574,Bach; Quang Tran,22,0,48,26
1657173414685,CSE 30,A01,083084,Eldon; John,4,0,80,76
1657173414685,CSE 30,B01,095061,Bhaskar; Nishant,7,0,50,43
1657173420709,CSE 100,A01,083659,Cao; Yingjun,4,4,70,66
1657173426732,CSE 134B,A01,083661,Powell; Thomas Allan,20,0,100,80
1657173432765,CSE 140,A01,083663,Gungor; Onat,13,0,85,72
1657173438795,CSE 140L,A01,083088,Eldon; John,17,0,100,83
1657173444825,CSE 175,A01,083665,Kumar; Rakesh,3,0,25,22
1657173450849,CSE 190,A00,092507,Dubnov; Shlomo,7,0,20,13
1657173456887,ECE 45,A01,083139,Congero; Spencer William,5,0,75,70
1657173462912,ECE 65,A50,083695,Saad; Andrew S,12,0,30,18
1657173462912,ECE 65,A51,095125,Saad; Andrew S,25,0,26,1
1657173468940,ECE 109,A01,091882,Touri; Behrouz,19,0,70,51
1657173474964,ECE 180,A00,083140,Abi Samra; Nicholas Camill,1,0,30,29
1657173474964,ECE 180,B00,083141,Abi Samra; Nicholas Camill,0,0,30,30
1657173481008,MATH 10A,A01,083735,Patchell; Gregory David,2,0,30,28
1657173481008,MATH 10A,A02,083736,Patchell; Gregory David,20,0,30,10
1657173481008,MATH 10A,A03,083737,Patchell; Gregory David,16,0,30,14
1657173487032,MATH 10B,A01,083207,Lim; Seonhee,7,0,34,27
1657173487032,MATH 10B,A02,083208,Lim; Seonhee,9,0,35,26
1657173487032,MATH 10B,A03,093472,Lim; Seonhee,5,0,34,29
1657173487032,MATH 10B,B01,083739,Sinha; Shubham,9,0,30,21
1657173493070,MATH 18,A01,083743,Cinel; Cameron Alexander,6,0,30,24
1657173493070,MATH 18,A02,083744,Cinel; Cameron Alexander,15,0,30,15
1657173493070,MATH 18,A03,083745,Cinel; Cameron Alexander,8,0,30,22
1657173493070,MATH 18,B01,083748,Rideout; David Porter,4,0,37,33
1657173493070,MATH 18,B02,083749,Rideout; David Porter,4,0,36,32
1657173493070,MATH 18,B03,083750,Rideout; David Porter,2,0,37,35
1657173493070,MATH 18,B04,083751,Rideout; David Porter,5,0,36,31
1657173493070,MATH 18,B05,093473,Rideout; David Porter,5,0,36,31
1657173493070,MATH 18,B06,093474,Rideout; David Porter,5,0,36,31
1657173499093,MATH 20A,A01,083754,Zheng; Zequn,12,0,40,28
1657173505125,MATH 20B,A01,083756,Briones; Jor-el Thomas Caparas,1,0,36,35
1657173505125,MATH 20B,A02,083757,Briones; Jor-el Thomas Caparas,1,0,36,35
1657173505125,MATH 20B,A03,093475,Briones; Jor-el Thomas Caparas,1,0,36,35
1657173511149,MATH 20C,A01,083760,Briones; Jor-el Thomas Caparas,1,0,35,34
1657173511149,MATH 20C,A02,083761,Briones; Jor-el Thomas Caparas,8,0,35,27
1657173511149,MATH 20C,A03,093476,Briones; Jor-el Thomas Caparas,0,1,36,36
1657173511149,MATH 20C,B01,083762,Bach; Quang Tran,1,0,30,29
1657173517174,MATH 20D,A01,083765,Tran; Brian Kha,4,0,30,26
1657173517174,MATH 20D,A02,083766,Tran; Brian Kha,5,0,30,25
1657173517174,MATH 20D,A03,083767,Tran; Brian Kha,3,0,30,27
1657173523199,MATH 20E,A01,083771,Ganguly; Soumya,7,0,32,25
1657173523199,MATH 20E,A02,083772,Ganguly; Soumya,7,0,32,25
1657173523199,MATH 20E,B01,083773,Ciotti; Benjamin,19,0,35,16
1657173523199,MATH 20E,B02,083774,Ciotti; Benjamin,17,0,35,18
1657173529226,MATH 103A,A01,083777,Greenfeld; Be'Eri,2,0,36,34
1657173529226,MATH 103A,A02,083778,Greenfeld; Be'Eri,5,0,36,31
1657173529226,MATH 103A,A03,093561,Greenfeld; Be'Eri,4,0,36,32
1657173529226,MATH 103A,B01,083779,Greenfeld; Be'Eri,6,0,36,30
1657173529226,MATH 103A,B02,083780,Greenfeld; Be'Eri,3,0,36,33
1657173529226,MATH 103A,B03,093562,Greenfeld; Be'Eri,3,0,36,33
1657173535250,MATH 105,A01,085443,Carter; Anne Toulson,14,0,35,21
1657173535250,MATH 105,A02,093477,Carter; Anne Toulson,20,0,35,15
1657173541278,MATH 109,A01,083213,Ganzberger; Geoffrey Michael,2,0,34,32
1657173541278,MATH 109,A02,083214,Ganzberger; Geoffrey Michael,3,0,34,31
1657173541278,MATH 109,A03,093478,Ganzberger; Geoffrey Michael,1,0,34,33
1657173541278,MATH 109,B01,083215,Ganzberger; Geoffrey Michael,1,0,32,31
1657173541278,MATH 109,B02,083216,Ganzberger; Geoffrey Michael,1,0,32,31
1657173541278,MATH 109,B03,093479,Ganzberger; Geoffrey Michael,6,0,32,26
1657173547302,MATH 142A,A01,083219,Chow; Bennett,6,0,32,26
1657173547302,MATH 142A,A02,083220,Chow; Bennett,10,0,32,22
1657173547302,MATH 142A,A03,093480,Chow; Bennett,7,0,32,25
1657173547302,MATH 142A,B03,093481,Chow; Bennett,8,0,32,24
1657173547302,MATH 142A,B04,093558,Chow; Bennett,11,0,32,21
1657173547302,MATH 142A,B05,093559,Chow; Bennett,6,0,32,26
1657173553327,MATH 193A,A01,083224,Rotar; Vladimir,7,0,34,27
1657173553327,MATH 193A,A02,083225,Rotar; Vladimir,5,0,34,29
1657173553327,MATH 193A,A03,083781,Rotar; Vladimir,1,0,34,33
1657173553327,MATH 193A,A04,083782,Rotar; Vladimir,8,0,34,26
1657173553327,MATH 193A,A05,093482,Rotar; Vladimir,6,0,34,28
1657173559349,MATH 197,001,091859,McAuley; Julian John,9999,0,9999,0
1657173559349,MATH 197,002,095566,Kedlaya; Kiran S.,9997,0,9999,2
1657173559349,MATH 197,003,095567,Xiao; Ming,9999,0,9999,0
1657173559349,MATH 197,004,095571,Perols; Johan Lars,9998,0,9999,1
1657173566407,COGS 9,A01,083615,Shannon; Kyle Michael,7,0,75,68
1657173572431,COGS 11,A01,083617,Boyle; Mary E. T.,22,0,48,26
1657173578462,COGS 13,A01,083071,Bastos; Amalia Pinkusfeld,9,0,71,62
1657173584490,COGS 14A,A01,092681,Semenuks; Arturs,1,1,100,99
1657173590512,COGS 14B,A01,083073,Cheng; Tzu-Han,6,0,63,57
1657173596535,COGS 17,A01,092677,Semenuks; Arturs,4,0,81,77
1657173602569,COGS 100,A01,083619,Allen; Michael Gordon,15,0,70,55
1657173608593,COGS 101A,A01,083621,Davis; Joshua Daniel,9,0,68,59
1657173614625,COGS 101B,A01,091572,Allen; Michael Gordon,9,0,65,56
1657173620652,COGS 101C,A01,083625,Delgado; Tania,17,0,35,18
1657173626679,COGS 107A,A01,083627,Boyle; Mary E. T.,13,0,60,47
1657173632706,COGS 118A,A01,083075,Gupta; Anjum,16,0,76,60
1657173638730,CSE 3,A50,083646,Miranda; Gregory Joseph,24,0,50,26
1657173644753,CSE 8A,A50,083650,Miranda; Gregory Joseph,17,1,56,39
1657173650776,CSE 11,A01,083080,Cao; Yingjun,5,15,40,35
1657173656801,CSE 12,A01,083652,Krause-Levy; Sophia Louisa,24,1,120,96
1657173662827,CSE 15L,A01,083654,Morris; Justin Loren,9,0,50,41
1657173662827,CSE 15L,A02,083655,Morris; Justin Loren,9,0,50,41
1657173668850,CSE 20,A01,083657,Tran; Khoa Dang,38,0,80,42
1657173674878,CSE 21,A01,095574,Bach; Quang Tran,22,0,48,26
1657173680908,CSE 30,A01,083084,Eldon; John,4,0,80,76
1657173680908,CSE 30,B01,095061,Bhaskar; Nishant,7,0,50,43
1657173686936,CSE 100,A01,083659,Cao; Yingjun,4,4,70,66
1657173692963,CSE 134B,A01,083661,Powell; Thomas Allan,20,0,100,80
1657173698986,CSE 140,A01,083663,Gungor; Onat,13,0,85,72
1657173705012,CSE 140L,A01,083088,Eldon; John,17,0,100,83
1657173711122,CSE 175,A01,083665,Kumar; Rakesh,3,0,25,22
1657173717149,CSE 190,A00,092507,Dubnov; Shlomo,7,0,20,13
1657173723178,ECE 45,A01,083139,Congero; Spencer William,5,0,75,70
1657173729201,ECE 65,A50,083695,Saad; Andrew S,12,0,30,18
1657173729201,ECE 65,A51,095125,Saad; Andrew S,25,0,26,1
1657173735229,ECE 109,A01,091882,Touri; Behrouz,19,0,70,51
1657173741260,ECE 180,A00,083140,Abi Samra; Nicholas Camill,1,0,30,29
1657173741260,ECE 180,B00,083141,Abi Samra; Nicholas Camill,0,0,30,30
1657173747285,MATH 10A,A01,083735,Patchell; Gregory David,2,0,30,28
1657173747285,MATH 10A,A02,083736,Patchell; Gregory David,20,0,30,10
1657173747285,MATH 10A,A03,083737,Patchell; Gregory David,16,0,30,14
1657173753310,MATH 10B,A01,083207,Lim; Seonhee,7,0,34,27
1657173753310,MATH 10B,A02,083208,Lim; Seonhee,9,0,35,26
1657173753310,MATH 10B,A03,093472,Lim; Seonhee,5,0,34,29
1657173753310,MATH 10B,B01,083739,Sinha; Shubham,9,0,30,21
1657173759338,MATH 18,A01,083743,Cinel; Cameron Alexander,6,0,30,24
1657173759338,MATH 18,A02,083744,Cinel; Cameron Alexander,15,0,30,15
1657173759338,MATH 18,A03,083745,Cinel; Cameron Alexander,8,0,30,22
1657173759338,MATH 18,B01,083748,Rideout; David Porter,4,0,37,33
1657173759338,MATH 18,B02,083749,Rideout; David Porter,4,0,36,32
1657173759338,MATH 18,B03,083750,Rideout; David Porter,2,0,37,35
1657173759338,MATH 18,B04,083751,Rideout; David Porter,5,0,36,31
1657173759338,MATH 18,B05,093473,Rideout; David Porter,5,0,36,31
1657173759338,MATH 18,B06,093474,Rideout; David Porter,5,0,36,31
1657173765361,MATH 20A,A01,083754,Zheng; Zequn,12,0,40,28
1657173771390,MATH 20B,A01,083756,Briones; Jor-el Thomas Caparas,1,0,36,35
1657173771390,MATH 20B,A02,083757,Briones; Jor-el Thomas Caparas,1,0,36,35
1657173771390,MATH 20B,A03,093475,Briones; Jor-el Thomas Caparas,1,0,36,35
1657173777425,MATH 20C,A01,083760,Briones; Jor-el Thomas Caparas,1,0,35,34
1657173777425,MATH 20C,A02,083761,Briones; Jor-el Thomas Caparas,8,0,35,27
1657173777425,MATH 20C,A03,093476,Briones; Jor-el Thomas Caparas,0,1,36,36
1657173777425,MATH 20C,B01,083762,Bach; Quang Tran,1,0,30,29
1657173783455,MATH 20D,A01,083765,Tran; Brian Kha,4,0,30,26
1657173783455,MATH 20D,A02,083766,Tran; Brian Kha,5,0,30,25
1657173783455,MATH 20D,A03,083767,Tran; Brian Kha,3,0,30,27
1657173789481,MATH 20E,A01,083771,Ganguly; Soumya,7,0,32,25
1657173789481,MATH 20E,A02,083772,Ganguly; Soumya,7,0,32,25
1657173789481,MATH 20E,B01,083773,Ciotti; Benjamin,19,0,35,16
1657173789481,MATH 20E,B02,083774,Ciotti; Benjamin,17,0,35,18
1657173795507,MATH 103A,A01,083777,Greenfeld; Be'Eri,2,0,36,34
1657173795507,MATH 103A,A02,083778,Greenfeld; Be'Eri,5,0,36,31
1657173795507,MATH 103A,A03,093561,Greenfeld; Be'Eri,4,0,36,32
1657173795507,MATH 103A,B01,083779,Greenfeld; Be'Eri,6,0,36,30
1657173795507,MATH 103A,B02,083780,Greenfeld; Be'Eri,3,0,36,33
1657173795507,MATH 103A,B03,093562,Greenfeld; Be'Eri,3,0,36,33
1657173801539,MATH 105,A01,085443,Carter; Anne Toulson,14,0,35,21
1657173801539,MATH 105,A02,093477,Carter; Anne Toulson,20,0,35,15
1657173807564,MATH 109,A01,083213,Ganzberger; Geoffrey Michael,2,0,34,32
1657173807564,MATH 109,A02,083214,Ganzberger; Geoffrey Michael,3,0,34,31
1657173807564,MATH 109,A03,093478,Ganzberger; Geoffrey Michael,1,0,34,33
1657173807564,MATH 109,B01,083215,Ganzberger; Geoffrey Michael,1,0,32,31
1657173807564,MATH 109,B02,083216,Ganzberger; Geoffrey Michael,1,0,32,31
1657173807564,MATH 109,B03,093479,Ganzberger; Geoffrey Michael,6,0,32,26
1657173813592,MATH 142A,A01,083219,Chow; Bennett,6,0,32,26
1657173813592,MATH 142A,A02,083220,Chow; Bennett,10,0,32,22
1657173813592,MATH 142A,A03,093480,Chow; Bennett,7,0,32,25
1657173813592,MATH 142A,B03,093481,Chow; Bennett,8,0,32,24
1657173813592,MATH 142A,B04,093558,Chow; Bennett,11,0,32,21
1657173813592,MATH 142A,B05,093559,Chow; Bennett,6,0,32,26
1657173819626,MATH 193A,A01,083224,Rotar; Vladimir,7,0,34,27
1657173819626,MATH 193A,A02,083225,Rotar; Vladimir,5,0,34,29
1657173819626,MATH 193A,A03,083781,Rotar; Vladimir,1,0,34,33
1657173819626,MATH 193A,A04,083782,Rotar; Vladimir,8,0,34,26
1657173819626,MATH 193A,A05,093482,Rotar; Vladimir,6,0,34,28
1657173833832,MATH 197,001,091859,McAuley; Julian John,9999,0,9999,0
1657173833832,MATH 197,002,095566,Kedlaya; Kiran S.,9997,0,9999,2
1657173833832,MATH 197,003,095567,Xiao; Ming,9999,0,9999,0
1657173833832,MATH 197,004,095571,Perols; Johan Lars,9998,0,9999,1
1657173840916,COGS 9,A01,083615,Shannon; Kyle Michael,7,0,75,68
1657173846939,COGS 11,A01,083617,Boyle; Mary E. T.,22,0,48,26
1657173852962,COGS 13,A01,083071,Bastos; Amalia Pinkusfeld,9,0,71,62
1657173858988,COGS 14A,A01,092681,Semenuks; Arturs,1,1,100,99
1657173865015,COGS 14B,A01,083073,Cheng; Tzu-Han,6,0,63,57
1657173871041,COGS 17,A01,092677,Semenuks; Arturs,4,0,81,77
1657173877064,COGS 100,A01,083619,Allen; Michael Gordon,15,0,70,55
1657173883087,COGS 101A,A01,083621,Davis; Joshua Daniel,9,0,68,59
1657173889114,COGS 101B,A01,091572,Allen; Michael Gordon,9,0,65,56
1657173895153,COGS 101C,A01,083625,Delgado; Tania,17,0,35,18
1657173901180,COGS 107A,A01,083627,Boyle; Mary E. T.,13,0,60,47
1657173907207,COGS 118A,A01,083075,Gupta; Anjum,16,0,76,60
1657173913235,CSE 3,A50,083646,Miranda; Gregory Joseph,24,0,50,26
1657173919259,CSE 8A,A50,083650,Miranda; Gregory Joseph,17,1,56,39
1657173925283,CSE 11,A01,083080,Cao; Yingjun,5,15,40,35
1657173931309,CSE 12,A01,083652,Krause-Levy; Sophia Louisa,24,1,120,96
1657173937335,CSE 15L,A01,083654,Morris; Justin Loren,9,0,50,41
1657173937335,CSE 15L,A02,083655,Morris; Justin Loren,9,0,50,41
1657173943359,CSE 20,A01,083657,Tran; Khoa Dang,38,0,80,42
1657173949386,CSE 21,A01,095574,Bach; Quang Tran,22,0,48,26
1657173955417,CSE 30,A01,083084,Eldon; John,4,0,80,76
1657173955417,CSE 30,B01,095061,Bhaskar; Nishant,7,0,50,43
1657173961445,CSE 100,A01,083659,Cao; Yingjun,4,4,70,66
1657173967473,CSE 134B,A01,083661,Powell; Thomas Allan,20,0,100,80
1657173973505,CSE 140,A01,083663,Gungor; Onat,13,0,85,72
1657173979533,CSE 140L,A01,083088,Eldon; John,17,0,100,83
1657173985558,CSE 175,A01,083665,Kumar; Rakesh,3,0,25,22
1657173991581,CSE 190,A00,092507,Dubnov; Shlomo,7,0,20,13
1657173997614,ECE 45,A01,083139,Congero; Spencer William,5,0,75,70
1657174003637,ECE 65,A50,083695,Saad; Andrew S,12,0,30,18
1657174003637,ECE 65,A51,095125,Saad; Andrew S,25,0,26,1
1657174009660,ECE 109,A01,091882,Touri; Behrouz,19,0,70,51
1657174015684,ECE 180,A00,083140,Abi Samra; Nicholas Camill,1,0,30,29
1657174015684,ECE 180,B00,083141,Abi Samra; Nicholas Camill,0,0,30,30
1657174021711,MATH 10A,A01,083735,Patchell; Gregory David,2,0,30,28
1657174021711,MATH 10A,A02,083736,Patchell; Gregory David,20,0,30,10
1657174021711,MATH 10A,A03,083737,Patchell; Gregory David,16,0,30,14
1657174027739,MATH 10B,A01,083207,Lim; Seonhee,7,0,34,27
1657174027739,MATH 10B,A02,083208,Lim; Seonhee,9,0,35,26
1657174027739,MATH 10B,A03,093472,Lim; Seonhee,5,0,34,29
1657174027739,MATH 10B,B01,083739,Sinha; Shubham,9,0,30,21
1657174033765,MATH 18,A01,083743,Cinel; Cameron Alexander,6,0,30,24
1657174033765,MATH 18,A02,083744,Cinel; Cameron Alexander,15,0,30,15
1657174033765,MATH 18,A03,083745,Cinel; Cameron Alexander,8,0,30,22
1657174033765,MATH 18,B01,083748,Rideout; David Porter,4,0,37,33
1657174033765,MATH 18,B02,083749,Rideout; David Porter,4,0,36,32
1657174033765,MATH 18,B03,083750,Rideout; David Porter,2,0,37,35
1657174033765,MATH 18,B04,083751,Rideout; David Porter,5,0,36,31
1657174033765,MATH 18,B05,093473,Rideout; David Porter,5,0,36,31
1657174033765,MATH 18,B06,093474,Rideout; David Porter,5,0,36,31
1657174039791,MATH 20A,A01,083754,Zheng; Zequn,12,0,40,28
1657174045832,MATH 20B,A01,083756,Briones; Jor-el Thomas Caparas,1,0,36,35
1657174045832,MATH 20B,A02,083757,Briones; Jor-el Thomas Caparas,1,0,36,35
1657174045832,MATH 20B,A03,093475,Briones; Jor-el Thomas Caparas,1,0,36,35
1657174051862,MATH 20C,A01,083760,Briones; Jor-el Thomas Caparas,1,0,35,34
1657174051862,MATH 20C,A02,083761,Briones; Jor-el Thomas Caparas,8,0,35,27
1657174051862,MATH 20C,A03,093476,Briones; Jor-el Thomas Caparas,0,1,36,36
1657174051862,MATH 20C,B01,083762,Bach; Quang Tran,1,0,30,29
1657174057891,MATH 20D,A01,083765,Tran; Brian Kha,4,0,30,26
1657174057891,MATH 20D,A02,083766,Tran; Brian Kha,5,0,30,25
1657174057891,MATH 20D,A03,083767,Tran; Brian Kha,3,0,30,27
1657174063920,MATH 20E,A01,083771,Ganguly; Soumya,7,0,32,25
1657174063920,MATH 20E,A02,083772,Ganguly; Soumya,7,0,32,25
1657174063920,MATH 20E,B01,083773,Ciotti; Benjamin,19,0,35,16
1657174063920,MATH 20E,B02,083774,Ciotti; Benjamin,17,0,35,18
1657174069944,MATH 103A,A01,083777,Greenfeld; Be'Eri,2,0,36,34
1657174069944,MATH 103A,A02,083778,Greenfeld; Be'Eri,5,0,36,31
1657174069944,MATH 103A,A03,093561,Greenfeld; Be'Eri,4,0,36,32
1657174069944,MATH 103A,B01,083779,Greenfeld; Be'Eri,6,0,36,30
1657174069944,MATH 103A,B02,083780,Greenfeld; Be'Eri,3,0,36,33
1657174069944,MATH 103A,B03,093562,Greenfeld; Be'Eri,3,0,36,33
1657174075970,MATH 105,A01,085443,Carter; Anne Toulson,14,0,35,21
1657174075970,MATH 105,A02,093477,Carter; Anne Toulson,20,0,35,15
1657174081995,MATH 109,A01,083213,Ganzberger; Geoffrey Michael,2,0,34,32
1657174081995,MATH 109,A02,083214,Ganzberger; Geoffrey Michael,3,0,34,31
1657174081995,MATH 109,A03,093478,Ganzberger; Geoffrey Michael,1,0,34,33
1657174081995,MATH 109,B01,083215,Ganzberger; Geoffrey Michael,1,0,32,31
1657174081995,MATH 109,B02,083216,Ganzberger; Geoffrey Michael,1,0,32,31
1657174081995,MATH 109,B03,093479,Ganzberger; Geoffrey Michael,6,0,32,26
1657174088020,MATH 142A,A01,083219,Chow; Bennett,6,0,32,26
1657174088020,MATH 142A,A02,083220,Chow; Bennett,10,0,32,22
1657174088020,MATH 142A,A03,093480,Chow; Bennett,7,0,32,25
1657174088020,MATH 142A,B03,093481,Chow; Bennett,8,0,32,24
1657174088020,MATH 142A,B04,093558,Chow; Bennett,11,0,32,21
1657174088020,MATH 142A,B05,093559,Chow; Bennett,6,0,32,26
1657174094043,MATH 193A,A01,083224,Rotar; Vladimir,7,0,34,27
1657174094043,MATH 193A,A02,083225,Rotar; Vladimir,5,0,34,29
1657174094043,MATH 193A,A03,083781,Rotar; Vladimir,1,0,34,33
1657174094043,MATH 193A,A04,083782,Rotar; Vladimir,8,0,34,26
1657174094043,MATH 193A,A05,093482,Rotar; Vladimir,6,0,34,28
1657174100066,MATH 197,001,091859,McAuley; Julian John,9999,0,9999,0
1657174100066,MATH 197,002,095566,Kedlaya; Kiran S.,9997,0,9999,2
1657174100066,MATH 197,003,095567,Xiao; Ming,9999,0,9999,0
1657174100066,MATH 197,004,095571,Perols; Johan Lars,9998,0,9999,1
1657174107137,COGS 9,A01,083615,Shannon; Kyle Michael,7,0,75,68
1657174113163,COGS 11,A01,083617,Boyle; Mary E. T.,22,0,48,26
1657174119186,COGS 13,A01,083071,Bastos; Amalia Pinkusfeld,9,0,71,62
1657174125211,COGS 14A,A01,092681,Semenuks; Arturs,1,1,100,99
1657174131239,COGS 14B,A01,083073,Cheng; Tzu-Han,6,0,63,57
1657174137262,COGS 17,A01,092677,Semenuks; Arturs,4,0,81,77
1657174143288,COGS 100,A01,083619,Allen; Michael Gordon,15,0,70,55
1657174149313,COGS 101A,A01,083621,Davis; Joshua Daniel,9,0,68,59
1657174155337,COGS 101B,A01,091572,Allen; Michael Gordon,9,0,65,56
1657174161362,COGS 101C,A01,083625,Delgado; Tania,17,0,35,18
1657174167388,COGS 107A,A01,083627,Boyle; Mary E. T.,13,0,60,47
1657174173412,COGS 118A,A01,083075,Gupta; Anjum,16,0,76,60
1657174179437,CSE 3,A50,083646,Miranda; Gregory Joseph,24,0,50,26
1657174185465,CSE 8A,A50,083650,Miranda; Gregory Joseph,17,1,56,39
1657174191488,CSE 11,A01,083080,Cao; Yingjun,5,15,40,35
1657174197513,CSE 12,A01,083652,Krause-Levy; Sophia Louisa,24,1,120,96
1657174203537,CSE 15L,A01,083654,Morris; Justin Loren,9,0,50,41
1657174203537,CSE 15L,A02,083655,Morris; Justin Loren,9,0,50,41
1657174209561,CSE 20,A01,083657,Tran; Khoa Dang,38,0,80,42
1657174215589,CSE 21,A01,095574,Bach; Quang Tran,22,0,48,26
1657174221614,CSE 30,A01,083084,Eldon; John,4,0,80,76
1657174221614,CSE 30,B01,095061,Bhaskar; Nishant,7,0,50,43
1657174227641,CSE 100,A01,083659,Cao; Yingjun,4,4,70,66
1657174233666,CSE 134B,A01,083661,Powell; Thomas Allan,20,0,100,80
1657174239689,CSE 140,A01,083663,Gungor; Onat,13,0,85,72
1657174245717,CSE 140L,A01,083088,Eldon; John,17,0,100,83
1657174251738,CSE 175,A01,083665,Kumar; Rakesh,3,0,25,22
1657174257762,CSE 190,A00,092507,Dubnov; Shlomo,7,0,20,13
1657174263790,ECE 45,A01,083139,Congero; Spencer William,5,0,75,70
1657174269813,ECE 65,A50,083695,Saad; Andrew S,12,0,30,18
1657174269813,ECE 65,A51,095125,Saad; Andrew S,25,0,26,1
1657174275846,ECE 109,A01,091882,Touri; Behrouz,19,0,70,51
1657174281869,ECE 180,A00,083140,Abi Samra; Nicholas Camill,1,0,30,29
1657174281869,ECE 180,B00,083141,Abi Samra; Nicholas Camill,0,0,30,30
1657174287899,MATH 10A,A01,083735,Patchell; Gregory David,2,0,30,28
1657174287899,MATH 10A,A02,083736,Patchell; Gregory David,20,0,30,10
1657174287899,MATH 10A,A03,083737,Patchell; Gregory David,16,0,30,14
1657174293933,MATH 10B,A01,083207,Lim; Seonhee,7,0,34,27
1657174293933,MATH 10B,A02,083208,Lim; Seonhee,9,0,35,26
1657174293933,MATH 10B,A03,093472,Lim; Seonhee,5,0,34,29
1657174293933,MATH 10B,B01,083739,Sinha; Shubham,9,0,30,21
1657174299957,MATH 18,A01,083743,Cinel; Cameron Alexander,6,0,30,24
1657174299957,MATH 18,A02,083744,Cinel; Cameron Alexander,15,0,30,15
1657174299957,MATH 18,A03,083745,Cinel; Cameron Alexander,8,0,30,22
1657174299957,MATH 18,B01,083748,Rideout; David Porter,4,0,37,33
1657174299957,MATH 18,B02,083749,Rideout; David Porter,4,0,36,32
1657174299957,MATH 18,B03,083750,Rideout; David Porter,2,0,37,35
1657174299957,MATH 18,B04,083751,Rideout; David Porter,5,0,36,31
1657174299957,MATH 18,B05,093473,Rideout; David Porter,5,0,36,31
1657174299957,MATH 18,B06,093474,Rideout; David Porter,5,0,36,31
1657174305988,MATH 20A,A01,083754,Zheng; Zequn,12,0,40,28
1657174312011,MATH 20B,A01,083756,Briones; Jor-el Thomas Caparas,1,0,36,35
1657174312011,MATH 20B,A02,083757,Briones; Jor-el Thomas Caparas,1,0,36,35
1657174312011,MATH 20B,A03,093475,Briones; Jor-el Thomas Caparas,1,0,36,35
1657174318140,MATH 20C,A01,083760,Briones; Jor-el Thomas Caparas,1,0,35,34
1657174318140,MATH 20C,A02,083761,Briones; Jor-el Thomas Caparas,8,0,35,27
1657174318140,MATH 20C,A03,093476,Briones; Jor-el Thomas Caparas,0,1,36,36
1657174318140,MATH 20C,B01,083762,Bach; Quang Tran,1,0,30,29
1657174324163,MATH 20D,A01,083765,Tran; Brian Kha,4,0,30,26
1657174324163,MATH 20D,A02,083766,Tran; Brian Kha,5,0,30,25
1657174324163,MATH 20D,A03,083767,Tran; Brian Kha,3,0,30,27
1657174330192,MATH 20E,A01,083771,Ganguly; Soumya,7,0,32,25
1657174330192,MATH 20E,A02,083772,Ganguly; Soumya,7,0,32,25
1657174330192,MATH 20E,B01,083773,Ciotti; Benjamin,19,0,35,16
1657174330192,MATH 20E,B02,083774,Ciotti; Benjamin,17,0,35,18
1657174336216,MATH 103A,A01,083777,Greenfeld; Be'Eri,2,0,36,34
1657174336216,MATH 103A,A02,083778,Greenfeld; Be'Eri,5,0,36,31
1657174336216,MATH 103A,A03,093561,Greenfeld; Be'Eri,4,0,36,32
1657174336216,MATH 103A,B01,083779,Greenfeld; Be'Eri,6,0,36,30
1657174336216,MATH 103A,B02,083780,Greenfeld; Be'Eri,3,0,36,33
1657174336216,MATH 103A,B03,093562,Greenfeld; Be'Eri,3,0,36,33
1657174342241,MATH 105,A01,085443,Carter; Anne Toulson,14,0,35,21
1657174342241,MATH 105,A02,093477,Carter; Anne Toulson,20,0,35,15
1657174348266,MATH 109,A01,083213,Ganzberger; Geoffrey Michael,2,0,34,32
1657174348266,MATH 109,A02,083214,Ganzberger; Geoffrey Michael,3,0,34,31
1657174348266,MATH 109,A03,093478,Ganzberger; Geoffrey Michael,1,0,34,33
1657174348266,MATH 109,B01,083215,Ganzberger; Geoffrey Michael,1,0,32,31
1657174348266,MATH 109,B02,083216,Ganzberger; Geoffrey Michael,1,0,32,31
1657174348266,MATH 109,B03,093479,Ganzberger; Geoffrey Michael,6,0,32,26
1657174354293,MATH 142A,A01,083219,Chow; Bennett,6,0,32,26
1657174354293,MATH 142A,A02,083220,Chow; Bennett,10,0,32,22
1657174354293,MATH 142A,A03,093480,Chow; Bennett,7,0,32,25
1657174354293,MATH 142A,B03,093481,Chow; Bennett,8,0,32,24
1657174354293,MATH 142A,B04,093558,Chow; Bennett,11,0,32,21
1657174354293,MATH 142A,B05,093559,Chow; Bennett,6,0,32,26
1657174360322,MATH 193A,A01,083224,Rotar; Vladimir,7,0,34,27
1657174360322,MATH 193A,A02,083225,Rotar; Vladimir,5,0,34,29
1657174360322,MATH 193A,A03,083781,Rotar; Vladimir,1,0,34,33
1657174360322,MATH 193A,A04,083782,Rotar; Vladimir,8,0,34,26
1657174360322,MATH 193A,A05,093482,Rotar; Vladimir,6,0,34,28
1657174366346,MATH 197,001,091859,McAuley; Julian John,9999,0,9999,0
1657174366346,MATH 197,002,095566,Kedlaya; Kiran S.,9997,0,9999,2
1657174366346,MATH 197,003,095567,Xiao; Ming,9999,0,9999,0
1657174366346,MATH 197,004,095571,Perols; Johan Lars,9998,0,9999,1
1657174373414,COGS 9,A01,083615,Shannon; Kyle Michael,7,0,75,68
1657174379437,COGS 11,A01,083617,Boyle; Mary E. T.,22,0,48,26
1657174385466,COGS 13,A01,083071,Bastos; Amalia Pinkusfeld,9,0,71,62
1657174391488,COGS 14A,A01,092681,Semenuks; Arturs,1,1,100,99
1657174397512,COGS 14B,A01,083073,Cheng; Tzu-Han,6,0,63,57
1657174403536,COGS 17,A01,092677,Semenuks; Arturs,4,0,81,77
1657174409563,COGS 100,A01,083619,Allen; Michael Gordon,15,0,70,55
1657174415585,COGS 101A,A01,083621,Davis; Joshua Daniel,9,0,68,59
1657174421609,COGS 101B,A01,091572,Allen; Michael Gordon,9,0,65,56
1657174427641,COGS 101C,A01,083625,Delgado; Tania,17,0,35,18
1657174433669,COGS 107A,A01,083627,Boyle; Mary E. T.,13,0,60,47
1657174439693,COGS 118A,A01,083075,Gupta; Anjum,16,0,76,60
1657174445722,CSE 3,A50,083646,Miranda; Gregory Joseph,24,0,50,26
1657174451749,CSE 8A,A50,083650,Miranda; Gregory Joseph,17,1,56,39
1657174457776,CSE 11,A01,083080,Cao; Yingjun,5,15,40,35
1657174463800,CSE 12,A01,083652,Krause-Levy; Sophia Louisa,24,1,120,96
1657174469824,CSE 15L,A01,083654,Morris; Justin Loren,9,0,50,41
1657174469824,CSE 15L,A02,083655,Morris; Justin Loren,9,0,50,41
1657174475847,CSE 20,A01,083657,Tran; Khoa Dang,38,0,80,42
1657174481875,CSE 21,A01,095574,Bach; Quang Tran,22,0,48,26
1657174487903,CSE 30,A01,083084,Eldon; John,4,0,80,76
1657174487903,CSE 30,B01,095061,Bhaskar; Nishant,7,0,50,43
1657174493927,CSE 100,A01,083659,Cao; Yingjun,4,4,70,66
1657174499951,CSE 134B,A01,083661,Powell; Thomas Allan,20,0,100,80
1657174505975,CSE 140,A01,083663,Gungor; Onat,13,0,85,72
1657174511997,CSE 140L,A01,083088,Eldon; John,17,0,100,83
1657174518025,CSE 175,A01,083665,Kumar; Rakesh,3,0,25,22
1657174524050,CSE 190,A00,092507,Dubnov; Shlomo,7,0,20,13
1657174530072,ECE 45,A01,083139,Congero; Spencer William,5,0,75,70
1657174536096,ECE 65,A50,083695,Saad; Andrew S,12,0,30,18
1657174536096,ECE 65,A51,095125,Saad; Andrew S,25,0,26,1
1657174542119,ECE 109,A01,091882,Touri; Behrouz,19,0,70,51
1657174548145,ECE 180,A00,083140,Abi Samra; Nicholas Camill,1,0,30,29
1657174548145,ECE 180,B00,083141,Abi Samra; Nicholas Camill,0,0,30,30
1657174554169,MATH 10A,A01,083735,Patchell; Gregory David,2,0,30,28
1657174554169,MATH 10A,A02,083736,Patchell; Gregory David,20,0,30,10
1657174554169,MATH 10A,A03,083737,Patchell; Gregory David,16,0,30,14
1657174560206,MATH 10B,A01,083207,Lim; Seonhee,7,0,34,27
1657174560206,MATH 10B,A02,083208,Lim; Seonhee,9,0,35,26
1657174560206,MATH 10B,A03,093472,Lim; Seonhee,5,0,34,29
1657174560206,MATH 10B,B01,083739,Sinha; Shubham,9,0,30,21
1657174566230,MATH 18,A01,083743,Cinel; Cameron Alexander,6,0,30,24
1657174566230,MATH 18,A02,083744,Cinel; Cameron Alexander,15,0,30,15
1657174566230,MATH 18,A03,083745,Cinel; Cameron Alexander,8,0,30,22
1657174566230,MATH 18,B01,083748,Rideout; David Porter,4,0,37,33
1657174566230,MATH 18,B02,083749,Rideout; David Porter,4,0,36,32
1657174566230,MATH 18,B03,083750,Rideout; David Porter,2,0,37,35
1657174566230,MATH 18,B04,083751,Rideout; David Porter,5,0,36,31
1657174566230,MATH 18,B05,093473,Rideout; David Porter,5,0,36,31
1657174566230,MATH 18,B06,093474,Rideout; David Porter,5,0,36,31
1657174572258,MATH 20A,A01,083754,Zheng; Zequn,12,0,40,28
1657174578282,MATH 20B,A01,083756,Briones; Jor-el Thomas Caparas,1,0,36,35
1657174578282,MATH 20B,A02,083757,Briones; Jor-el Thomas Caparas,1,0,36,35
1657174578282,MATH 20B,A03,093475,Briones; Jor-el Thomas Caparas,1,0,36,35
1657174584306,MATH 20C,A01,083760,Briones; Jor-el Thomas Caparas,1,0,35,34
1657174584306,MATH 20C,A02,083761,Briones; Jor-el Thomas Caparas,8,0,35,27
1657174584306,MATH 20C,A03,093476,Briones; Jor-el Thomas Caparas,0,1,36,36
1657174584306,MATH 20C,B01,083762,Bach; Quang Tran,1,0,30,29
1657174590334,MATH 20D,A01,083765,Tran; Brian Kha,4,0,30,26
1657174590334,MATH 20D,A02,083766,Tran; Brian Kha,5,0,30,25
1657174590334,MATH 20D,A03,083767,Tran; Brian Kha,3,0,30,27
1657174596366,MATH 20E,A01,083771,Ganguly; Soumya,7,0,32,25
1657174596366,MATH 20E,A02,083772,Ganguly; Soumya,7,0,32,25
1657174596366,MATH 20E,B01,083773,Ciotti; Benjamin,19,0,35,16
1657174596366,MATH 20E,B02,083774,Ciotti; Benjamin,17,0,35,18
1657174602391,MATH 103A,A01,083777,Greenfeld; Be'Eri,2,0,36,34
1657174602391,MATH 103A,A02,083778,Greenfeld; Be'Eri,5,0,36,31
1657174602391,MATH 103A,A03,093561,Greenfeld; Be'Eri,4,0,36,32
1657174602391,MATH 103A,B01,083779,Greenfeld; Be'Eri,6,0,36,30
1657174602391,MATH 103A,B02,083780,Greenfeld; Be'Eri,3,0,36,33
1657174602391,MATH 103A,B03,093562,Greenfeld; Be'Eri,3,0,36,33
1657174608419,MATH 105,A01,085443,Carter; Anne Toulson,14,0,35,21
1657174608419,MATH 105,A02,093477,Carter; Anne Toulson,20,0,35,15
1657174614444,MATH 109,A01,083213,Ganzberger; Geoffrey Michael,2,0,34,32
1657174614444,MATH 109,A02,083214,Ganzberger; Geoffrey Michael,3,0,34,31
1657174614444,MATH 109,A03,093478,Ganzberger; Geoffrey Michael,1,0,34,33
1657174614444,MATH 109,B01,083215,Ganzberger; Geoffrey Michael,1,0,32,31
1657174614444,MATH 109,B02,083216,Ganzberger; Geoffrey Michael,1,0,32,31
1657174614444,MATH 109,B03,093479,Ganzberger; Geoffrey Michael,6,0,32,26
1657174620468,MATH 142A,A01,083219,Chow; Bennett,6,0,32,26
1657174620468,MATH 142A,A02,083220,Chow; Bennett,10,0,32,22
1657174620468,MATH 142A,A03,093480,Chow; Bennett,7,0,32,25
1657174620468,MATH 142A,B03,093481,Chow; Bennett,8,0,32,24
1657174620468,MATH 142A,B04,093558,Chow; Bennett,11,0,32,21
1657174620468,MATH 142A,B05,093559,Chow; Bennett,6,0,32,26
1657174626490,MATH 193A,A01,083224,Rotar; Vladimir,7,0,34,27
1657174626490,MATH 193A,A02,083225,Rotar; Vladimir,5,0,34,29
1657174626490,MATH 193A,A03,083781,Rotar; Vladimir,1,0,34,33
1657174626490,MATH 193A,A04,083782,Rotar; Vladimir,8,0,34,26
1657174626490,MATH 193A,A05,093482,Rotar; Vladimir,6,0,34,28
1657174632512,MATH 197,001,091859,McAuley; Julian John,9999,0,9999,0
1657174632512,MATH 197,002,095566,Kedlaya; Kiran S.,9997,0,9999,2
1657174632512,MATH 197,003,095567,Xiao; Ming,9999,0,9999,0
1657174632512,MATH 197,004,095571,Perols; Johan Lars,9998,0,9999,1
1657174639572,COGS 9,A01,083615,Shannon; Kyle Michael,7,0,75,68
1657174645597,COGS 11,A01,083617,Boyle; Mary E. T.,22,0,48,26
1657174651621,COGS 13,A01,083071,Bastos; Amalia Pinkusfeld,9,0,71,62
1657174657644,COGS 14A,A01,092681,Semenuks; Arturs,1,1,100,99
1657174663667,COGS 14B,A01,083073,Cheng; Tzu-Han,6,0,63,57
1657174669704,COGS 17,A01,092677,Semenuks; Arturs,4,0,81,77
1657174675732,COGS 100,A01,083619,Allen; Michael Gordon,15,0,70,55
1657174681762,COGS 101A,A01,083621,Davis; Joshua Daniel,9,0,68,59
1657174687797,COGS 101B,A01,091572,Allen; Michael Gordon,9,0,65,56
1657174693824,COGS 101C,A01,083625,Delgado; Tania,17,0,35,18
1657174699863,COGS 107A,A01,083627,Boyle; Mary E. T.,13,0,60,47
1657174705886,COGS 118A,A01,083075,Gupta; Anjum,16,0,76,60
1657174711911,CSE 3,A50,083646,Miranda; Gregory Joseph,24,0,50,26
1657174717932,CSE 8A,A50,083650,Miranda; Gregory Joseph,17,1,56,39
1657174723958,CSE 11,A01,083080,Cao; Yingjun,5,15,40,35
1657174729986,CSE 12,A01,083652,Krause-Levy; Sophia Louisa,24,1,120,96
1657174736014,CSE 15L,A01,083654,Morris; Justin Loren,9,0,50,41
1657174736014,CSE 15L,A02,083655,Morris; Justin Loren,9,0,50,41
1657174742041,CSE 20,A01,083657,Tran; Khoa Dang,38,0,80,42
1657174748064,CSE 21,A01,095574,Bach; Quang Tran,22,0,48,26
1657174754091,CSE 30,A01,083084,Eldon; John,4,0,80,76
1657174754091,CSE 30,B01,095061,Bhaskar; Nishant,7,0,50,43
1657174760121,CSE 100,A01,083659,Cao; Yingjun,4,4,70,66
1657174766144,CSE 134B,A01,083661,Powell; Thomas Allan,20,0,100,80
1657174772172,CSE 140,A01,083663,Gungor; Onat,13,0,85,72
1657174778200,CSE 140L,A01,083088,Eldon; John,17,0,100,83
1657174784226,CSE 175,A01,083665,Kumar; Rakesh,3,0,25,22
1657174790252,CSE 190,A00,092507,Dubnov; Shlomo,7,0,20,13
1657174796278,ECE 45,A01,083139,Congero; Spencer William,5,0,75,70
1657174802300,ECE 65,A50,083695,Saad; Andrew S,12,0,30,18
1657174802300,ECE 65,A51,095125,Saad; Andrew S,25,0,26,1
1657174808325,ECE 109,A01,091882,Touri; Behrouz,19,0,70,51
1657174814352,ECE 180,A00,083140,Abi Samra; Nicholas Camill,1,0,30,29
1657174814352,ECE 180,B00,083141,Abi Samra; Nicholas Camill,0,0,30,30
1657174820381,MATH 10A,A01,083735,Patchell; Gregory David,2,0,30,28
1657174820381,MATH 10A,A02,083736,Patchell; Gregory David,20,0,30,10
1657174820381,MATH 10A,A03,083737,Patchell; Gregory David,16,0,30,14
1657174826404,MATH 10B,A01,083207,Lim; Seonhee,7,0,34,27
1657174826404,MATH 10B,A02,083208,Lim; Seonhee,9,0,35,26
1657174826404,MATH 10B,A03,093472,Lim; Seonhee,5,0,34,29
1657174826404,MATH 10B,B01,083739,Sinha; Shubham,9,0,30,21
1657174832429,MATH 18,A01,083743,Cinel; Cameron Alexander,6,0,30,24
1657174832429,MATH 18,A02,083744,Cinel; Cameron Alexander,15,0,30,15
1657174832429,MATH 18,A03,083745,Cinel; Cameron Alexander,8,0,30,22
1657174832429,MATH 18,B01,083748,Rideout; David Porter,4,0,37,33
1657174832429,MATH 18,B02,083749,Rideout; David Porter,4,0,36,32
1657174832429,MATH 18,B03,083750,Rideout; David Porter,2,0,37,35
1657174832429,MATH 18,B04,083751,Rideout; David Porter,5,0,36,31
1657174832429,MATH 18,B05,093473,Rideout; David Porter,5,0,36,31
1657174832429,MATH 18,B06,093474,Rideout; David Porter,5,0,36,31
1657174838452,MATH 20A,A01,083754,Zheng; Zequn,13,0,40,27
1657174844475,MATH 20B,A01,083756,Briones; Jor-el Thomas Caparas,1,0,36,35
1657174844475,MATH 20B,A02,083757,Briones; Jor-el Thomas Caparas,1,0,36,35
1657174844475,MATH 20B,A03,093475,Briones; Jor-el Thomas Caparas,1,0,36,35
1657174850502,MATH 20C,A01,083760,Briones; Jor-el Thomas Caparas,1,0,35,34
1657174850502,MATH 20C,A02,083761,Briones; Jor-el Thomas Caparas,8,0,35,27
1657174850502,MATH 20C,A03,093476,Briones; Jor-el Thomas Caparas,0,1,36,36
1657174850502,MATH 20C,B01,083762,Bach; Quang Tran,1,0,30,29
1657174856532,MATH 20D,A01,083765,Tran; Brian Kha,4,0,30,26
1657174856532,MATH 20D,A02,083766,Tran; Brian Kha,5,0,30,25
1657174856532,MATH 20D,A03,083767,Tran; Brian Kha,3,0,30,27
1657174862564,MATH 20E,A01,083771,Ganguly; Soumya,7,0,32,25
1657174862564,MATH 20E,A02,083772,Ganguly; Soumya,7,0,32,25
1657174862564,MATH 20E,B01,083773,Ciotti; Benjamin,19,0,35,16
1657174862564,MATH 20E,B02,083774,Ciotti; Benjamin,17,0,35,18
1657174868594,MATH 103A,A01,083777,Greenfeld; Be'Eri,2,0,36,34
1657174868594,MATH 103A,A02,083778,Greenfeld; Be'Eri,5,0,36,31
1657174868594,MATH 103A,A03,093561,Greenfeld; Be'Eri,4,0,36,32
1657174868594,MATH 103A,B01,083779,Greenfeld; Be'Eri,6,0,36,30
1657174868594,MATH 103A,B02,083780,Greenfeld; Be'Eri,3,0,36,33
1657174868594,MATH 103A,B03,093562,Greenfeld; Be'Eri,3,0,36,33
1657174874620,MATH 105,A01,085443,Carter; Anne Toulson,14,0,35,21
1657174874620,MATH 105,A02,093477,Carter; Anne Toulson,20,0,35,15
1657174880646,MATH 109,A01,083213,Ganzberger; Geoffrey Michael,2,0,34,32
1657174880646,MATH 109,A02,083214,Ganzberger; Geoffrey Michael,3,0,34,31
1657174880646,MATH 109,A03,093478,Ganzberger; Geoffrey Michael,1,0,34,33
1657174880646,MATH 109,B01,083215,Ganzberger; Geoffrey Michael,1,0,32,31
1657174880646,MATH 109,B02,083216,Ganzberger; Geoffrey Michael,1,0,32,31
1657174880646,MATH 109,B03,093479,Ganzberger; Geoffrey Michael,6,0,32,26
1657174886675,MATH 142A,A01,083219,Chow; Bennett,6,0,32,26
1657174886675,MATH 142A,A02,083220,Chow; Bennett,10,0,32,22
1657174886675,MATH 142A,A03,093480,Chow; Bennett,7,0,32,25
1657174886675,MATH 142A,B03,093481,Chow; Bennett,8,0,32,24
1657174886675,MATH 142A,B04,093558,Chow; Bennett,11,0,32,21
1657174886675,MATH 142A,B05,093559,Chow; Bennett,6,0,32,26
1657174892704,MATH 193A,A01,083224,Rotar; Vladimir,7,0,34,27
1657174892704,MATH 193A,A02,083225,Rotar; Vladimir,5,0,34,29
1657174892704,MATH 193A,A03,083781,Rotar; Vladimir,1,0,34,33
1657174892704,MATH 193A,A04,083782,Rotar; Vladimir,8,0,34,26
1657174892704,MATH 193A,A05,093482,Rotar; Vladimir,6,0,34,28
1657174898727,MATH 197,001,091859,McAuley; Julian John,9999,0,9999,0
1657174898727,MATH 197,002,095566,Kedlaya; Kiran S.,9997,0,9999,2
1657174898727,MATH 197,003,095567,Xiao; Ming,9999,0,9999,0
1657174898727,MATH 197,004,095571,Perols; Johan Lars,9998,0,9999,1
1657174905784,COGS 9,A01,083615,Shannon; Kyle Michael,7,0,75,68
1657174911896,COGS 11,A01,083617,Boyle; Mary E. T.,22,0,48,26
1657174917921,COGS 13,A01,083071,Bastos; Amalia Pinkusfeld,9,0,71,62
1657174923946,COGS 14A,A01,092681,Semenuks; Arturs,1,1,100,99
1657174929969,COGS 14B,A01,083073,Cheng; Tzu-Han,6,0,63,57
1657174935991,COGS 17,A01,092677,Semenuks; Arturs,4,0,81,77
1657174942016,COGS 100,A01,083619,Allen; Michael Gordon,15,0,70,55
1657174948039,COGS 101A,A01,083621,Davis; Joshua Daniel,9,0,68,59
1657174954066,COGS 101B,A01,091572,Allen; Michael Gordon,9,0,65,56
1657174960090,COGS 101C,A01,083625,Delgado; Tania,17,0,35,18
1657174966113,COGS 107A,A01,083627,Boyle; Mary E. T.,13,0,60,47
1657174972137,COGS 118A,A01,083075,Gupta; Anjum,16,0,76,60
1657174978163,CSE 3,A50,083646,Miranda; Gregory Joseph,24,0,50,26
1657174984188,CSE 8A,A50,083650,Miranda; Gregory Joseph,17,1,56,39
1657174990211,CSE 11,A01,083080,Cao; Yingjun,5,15,40,35
1657174996233,CSE 12,A01,083652,Krause-Levy; Sophia Louisa,24,1,120,96
1657175002267,CSE 15L,A01,083654,Morris; Justin Loren,9,0,50,41
1657175002267,CSE 15L,A02,083655,Morris; Justin Loren,9,0,50,41
1657175008294,CSE 20,A01,083657,Tran; Khoa Dang,38,0,80,42
1657175014320,CSE 21,A01,095574,Bach; Quang Tran,22,0,48,26
1657175020343,CSE 30,A01,083084,Eldon; John,4,0,80,76
1657175020343,CSE 30,B01,095061,Bhaskar; Nishant,7,0,50,43
1657175026364,CSE 100,A01,083659,Cao; Yingjun,4,4,70,66
1657175032391,CSE 134B,A01,083661,Powell; Thomas Allan,20,0,100,80
1657175038414,CSE 140,A01,083663,Gungor; Onat,13,0,85,72
1657175044436,CSE 140L,A01,083088,Eldon; John,17,0,100,83
1657175050458,CSE 175,A01,083665,Kumar; Rakesh,3,0,25,22
1657175056482,CSE 190,A00,092507,Dubnov; Shlomo,7,0,20,13
1657175062507,ECE 45,A01,083139,Congero; Spencer William,5,0,75,70
1657175068545,ECE 65,A50,083695,Saad; Andrew S,12,0,30,18
1657175068545,ECE 65,A51,095125,Saad; Andrew S,25,0,26,1
1657175074571,ECE 109,A01,091882,Touri; Behrouz,19,0,70,51
1657175080592,ECE 180,A00,083140,Abi Samra; Nicholas Camill,1,0,30,29
1657175080592,ECE 180,B00,083141,Abi Samra; Nicholas Camill,0,0,30,30
1657175086618,MATH 10A,A01,083735,Patchell; Gregory David,2,0,30,28
1657175086618,MATH 10A,A02,083736,Patchell; Gregory David,20,0,30,10
1657175086618,MATH 10A,A03,083737,Patchell; Gregory David,16,0,30,14
1657175092645,MATH 10B,A01,083207,Lim; Seonhee,7,0,34,27
1657175092645,MATH 10B,A02,083208,Lim; Seonhee,9,0,35,26
1657175092645,MATH 10B,A03,093472,Lim; Seonhee,5,0,34,29
1657175092645,MATH 10B,B01,083739,Sinha; Shubham,9,0,30,21
1657175098667,MATH 18,A01,083743,Cinel; Cameron Alexander,6,0,30,24
1657175098667,MATH 18,A02,083744,Cinel; Cameron Alexander,15,0,30,15
1657175098667,MATH 18,A03,083745,Cinel; Cameron Alexander,8,0,30,22
1657175098667,MATH 18,B01,083748,Rideout; David Porter,4,0,37,33
1657175098667,MATH 18,B02,083749,Rideout; David Porter,4,0,36,32
1657175098667,MATH 18,B03,083750,Rideout; David Porter,2,0,37,35
1657175098667,MATH 18,B04,083751,Rideout; David Porter,5,0,36,31
1657175098667,MATH 18,B05,093473,Rideout; David Porter,5,0,36,31
1657175098667,MATH 18,B06,093474,Rideout; David Porter,5,0,36,31
1657175104692,MATH 20A,A01,083754,Zheng; Zequn,13,0,40,27
1657175110715,MATH 20B,A01,083756,Briones; Jor-el Thomas Caparas,1,0,36,35
1657175110715,MATH 20B,A02,083757,Briones; Jor-el Thomas Caparas,1,0,36,35
1657175110715,MATH 20B,A03,093475,Briones; Jor-el Thomas Caparas,1,0,36,35
1657175116738,MATH 20C,A01,083760,Briones; Jor-el Thomas Caparas,1,0,35,34
1657175116738,MATH 20C,A02,083761,Briones; Jor-el Thomas Caparas,8,0,35,27
1657175116738,MATH 20C,A03,093476,Briones; Jor-el Thomas Caparas,0,1,36,36
1657175116738,MATH 20C,B01,083762,Bach; Quang Tran,1,0,30,29
1657175122773,MATH 20D,A01,083765,Tran; Brian Kha,4,0,30,26
1657175122773,MATH 20D,A02,083766,Tran; Brian Kha,5,0,30,25
1657175122773,MATH 20D,A03,083767,Tran; Brian Kha,3,0,30,27
1657175128800,MATH 20E,A01,083771,Ganguly; Soumya,7,0,32,25
1657175128800,MATH 20E,A02,083772,Ganguly; Soumya,7,0,32,25
1657175128800,MATH 20E,B01,083773,Ciotti; Benjamin,19,0,35,16
1657175128800,MATH 20E,B02,083774,Ciotti; Benjamin,17,0,35,18
1657175134827,MATH 103A,A01,083777,Greenfeld; Be'Eri,2,0,36,34
1657175134827,MATH 103A,A02,083778,Greenfeld; Be'Eri,5,0,36,31
1657175134827,MATH 103A,A03,093561,Greenfeld; Be'Eri,4,0,36,32
1657175134827,MATH 103A,B01,083779,Greenfeld; Be'Eri,6,0,36,30
1657175134827,MATH 103A,B02,083780,Greenfeld; Be'Eri,3,0,36,33
1657175134827,MATH 103A,B03,093562,Greenfeld; Be'Eri,3,0,36,33
1657175140851,MATH 105,A01,085443,Carter; Anne Toulson,14,0,35,21
1657175140851,MATH 105,A02,093477,Carter; Anne Toulson,20,0,35,15
1657175146877,MATH 109,A01,083213,Ganzberger; Geoffrey Michael,2,0,34,32
1657175146877,MATH 109,A02,083214,Ganzberger; Geoffrey Michael,3,0,34,31
1657175146877,MATH 109,A03,093478,Ganzberger; Geoffrey Michael,1,0,34,33
1657175146877,MATH 109,B01,083215,Ganzberger; Geoffrey Michael,1,0,32,31
1657175146877,MATH 109,B02,083216,Ganzberger; Geoffrey Michael,1,0,32,31
1657175146877,MATH 109,B03,093479,Ganzberger; Geoffrey Michael,6,0,32,26
1657175152901,MATH 142A,A01,083219,Chow; Bennett,6,0,32,26
1657175152901,MATH 142A,A02,083220,Chow; Bennett,10,0,32,22
1657175152901,MATH 142A,A03,093480,Chow; Bennett,7,0,32,25
1657175152901,MATH 142A,B03,093481,Chow; Bennett,8,0,32,24
1657175152901,MATH 142A,B04,093558,Chow; Bennett,11,0,32,21
1657175152901,MATH 142A,B05,093559,Chow; Bennett,6,0,32,26
1657175158929,MATH 193A,A01,083224,Rotar; Vladimir,7,0,34,27
1657175158929,MATH 193A,A02,083225,Rotar; Vladimir,5,0,34,29
1657175158929,MATH 193A,A03,083781,Rotar; Vladimir,1,0,34,33
1657175158929,MATH 193A,A04,083782,Rotar; Vladimir,8,0,34,26
1657175158929,MATH 193A,A05,093482,Rotar; Vladimir,6,0,34,28
1657175164960,MATH 197,001,091859,McAuley; Julian John,9999,0,9999,0
1657175164960,MATH 197,002,095566,Kedlaya; Kiran S.,9997,0,9999,2
1657175164960,MATH 197,003,095567,Xiao; Ming,9999,0,9999,0
1657175164960,MATH 197,004,095571,Perols; Johan Lars,9998,0,9999,1
1657175172025,COGS 9,A01,083615,Shannon; Kyle Michael,7,0,75,68
1657175178052,COGS 11,A01,083617,Boyle; Mary E. T.,22,0,48,26
1657175184074,COGS 13,A01,083071,Bastos; Amalia Pinkusfeld,9,0,71,62
1657175190099,COGS 14A,A01,092681,Semenuks; Arturs,1,1,100,99
1657175196124,COGS 14B,A01,083073,Cheng; Tzu-Han,6,0,63,57
1657175202164,COGS 17,A01,092677,Semenuks; Arturs,4,0,81,77
1657175208188,COGS 100,A01,083619,Allen; Michael Gordon,15,0,70,55
1657175214211,COGS 101A,A01,083621,Davis; Joshua Daniel,9,0,68,59
1657175220239,COGS 101B,A01,091572,Allen; Michael Gordon,9,0,65,56
1657175226268,COGS 101C,A01,083625,Delgado; Tania,17,0,35,18
1657175232291,COGS 107A,A01,083627,Boyle; Mary E. T.,13,0,60,47
1657175238316,COGS 118A,A01,083075,Gupta; Anjum,16,0,76,60
1657175244344,CSE 3,A50,083646,Miranda; Gregory Joseph,24,0,50,26
1657175250368,CSE 8A,A50,083650,Miranda; Gregory Joseph,17,1,56,39
1657175256396,CSE 11,A01,083080,Cao; Yingjun,5,15,40,35
1657175262419,CSE 12,A01,083652,Krause-Levy; Sophia Louisa,24,1,120,96
1657175268458,CSE 15L,A01,083654,Morris; Justin Loren,9,0,50,41
1657175268458,CSE 15L,A02,083655,Morris; Justin Loren,9,0,50,41
1657175274482,CSE 20,A01,083657,Tran; Khoa Dang,38,0,80,42
1657175280507,CSE 21,A01,095574,Bach; Quang Tran,22,0,48,26
1657175286529,CSE 30,A01,083084,Eldon; John,4,0,80,76
1657175286529,CSE 30,B01,095061,Bhaskar; Nishant,7,0,50,43
1657175292557,CSE 100,A01,083659,Cao; Yingjun,4,4,70,66
1657175298579,CSE 134B,A01,083661,Powell; Thomas Allan,20,0,100,80
1657175304605,CSE 140,A01,083663,Gungor; Onat,13,0,85,72
1657175310629,CSE 140L,A01,083088,Eldon; John,17,0,100,83
1657175316652,CSE 175,A01,083665,Kumar; Rakesh,3,0,25,22
1657175322675,CSE 190,A00,092507,Dubnov; Shlomo,7,0,20,13
1657175328698,ECE 45,A01,083139,Congero; Spencer William,5,0,75,70
1657175334722,ECE 65,A50,083695,Saad; Andrew S,12,0,30,18
1657175334722,ECE 65,A51,095125,Saad; Andrew S,25,0,26,1
1657175340744,ECE 109,A01,091882,Touri; Behrouz,19,0,70,51
1657175346771,ECE 180,A00,083140,Abi Samra; Nicholas Camill,1,0,30,29
1657175346771,ECE 180,B00,083141,Abi Samra; Nicholas Camill,0,0,30,30
1657175352793,MATH 10A,A01,083735,Patchell; Gregory David,2,0,30,28
1657175352793,MATH 10A,A02,083736,Patchell; Gregory David,20,0,30,10
1657175352793,MATH 10A,A03,083737,Patchell; Gregory David,16,0,30,14
1657175358817,MATH 10B,A01,083207,Lim; Seonhee,7,0,34,27
1657175358817,MATH 10B,A02,083208,Lim; Seonhee,9,0,35,26
1657175358817,MATH 10B,A03,093472,Lim; Seonhee,5,0,34,29
1657175358817,MATH 10B,B01,083739,Sinha; Shubham,9,0,30,21
1657175364849,MATH 18,A01,083743,Cinel; Cameron Alexander,6,0,30,24
1657175364849,MATH 18,A02,083744,Cinel; Cameron Alexander,15,0,30,15
1657175364849,MATH 18,A03,083745,Cinel; Cameron Alexander,8,0,30,22
1657175364849,MATH 18,B01,083748,Rideout; David Porter,4,0,37,33
1657175364849,MATH 18,B02,083749,Rideout; David Porter,4,0,36,32
1657175364849,MATH 18,B03,083750,Rideout; David Porter,2,0,37,35
1657175364849,MATH 18,B04,083751,Rideout; David Porter,5,0,36,31
1657175364849,MATH 18,B05,093473,Rideout; David Porter,5,0,36,31
1657175364849,MATH 18,B06,093474,Rideout; David Porter,5,0,36,31
1657175370877,MATH 20A,A01,083754,Zheng; Zequn,13,0,40,27
1657175376899,MATH 20B,A01,083756,Briones; Jor-el Thomas Caparas,1,0,36,35
1657175376899,MATH 20B,A02,083757,Briones; Jor-el Thomas Caparas,1,0,36,35
1657175376899,MATH 20B,A03,093475,Briones; Jor-el Thomas Caparas,1,0,36,35
1657175382925,MATH 20C,A01,083760,Briones; Jor-el Thomas Caparas,1,0,35,34
1657175382925,MATH 20C,A02,083761,Briones; Jor-el Thomas Caparas,8,0,35,27
1657175382925,MATH 20C,A03,093476,Briones; Jor-el Thomas Caparas,0,1,36,36
1657175382925,MATH 20C,B01,083762,Bach; Quang Tran,1,0,30,29
1657175388955,MATH 20D,A01,083765,Tran; Brian Kha,4,0,30,26
1657175388955,MATH 20D,A02,083766,Tran; Brian Kha,5,0,30,25
1657175388955,MATH 20D,A03,083767,Tran; Brian Kha,3,0,30,27
1657175394984,MATH 20E,A01,083771,Ganguly; Soumya,7,0,32,25
1657175394984,MATH 20E,A02,083772,Ganguly; Soumya,7,0,32,25
1657175394984,MATH 20E,B01,083773,Ciotti; Benjamin,19,0,35,16
1657175394984,MATH 20E,B02,083774,Ciotti; Benjamin,17,0,35,18
1657175401011,MATH 103A,A01,083777,Greenfeld; Be'Eri,2,0,36,34
1657175401011,MATH 103A,A02,083778,Greenfeld; Be'Eri,5,0,36,31
1657175401011,MATH 103A,A03,093561,Greenfeld; Be'Eri,4,0,36,32
1657175401011,MATH 103A,B01,083779,Greenfeld; Be'Eri,6,0,36,30
1657175401011,MATH 103A,B02,083780,Greenfeld; Be'Eri,3,0,36,33
1657175401011,MATH 103A,B03,093562,Greenfeld; Be'Eri,3,0,36,33
1657175407033,MATH 105,A01,085443,Carter; Anne Toulson,14,0,35,21
1657175407033,MATH 105,A02,093477,Carter; Anne Toulson,20,0,35,15
1657175413063,MATH 109,A01,083213,Ganzberger; Geoffrey Michael,2,0,34,32
1657175413063,MATH 109,A02,083214,Ganzberger; Geoffrey Michael,3,0,34,31
1657175413063,MATH 109,A03,093478,Ganzberger; Geoffrey Michael,1,0,34,33
1657175413063,MATH 109,B01,083215,Ganzberger; Geoffrey Michael,1,0,32,31
1657175413063,MATH 109,B02,083216,Ganzberger; Geoffrey Michael,1,0,32,31
1657175413063,MATH 109,B03,093479,Ganzberger; Geoffrey Michael,6,0,32,26
1657175419087,MATH 142A,A01,083219,Chow; Bennett,6,0,32,26
1657175419087,MATH 142A,A02,083220,Chow; Bennett,10,0,32,22
1657175419087,MATH 142A,A03,093480,Chow; Bennett,7,0,32,25
1657175419087,MATH 142A,B03,093481,Chow; Bennett,8,0,32,24
1657175419087,MATH 142A,B04,093558,Chow; Bennett,11,0,32,21
1657175419087,MATH 142A,B05,093559,Chow; Bennett,6,0,32,26
1657175425111,MATH 193A,A01,083224,Rotar; Vladimir,7,0,34,27
1657175425111,MATH 193A,A02,083225,Rotar; Vladimir,5,0,34,29
1657175425111,MATH 193A,A03,083781,Rotar; Vladimir,1,0,34,33
1657175425111,MATH 193A,A04,083782,Rotar; Vladimir,8,0,34,26
1657175425111,MATH 193A,A05,093482,Rotar; Vladimir,6,0,34,28
1657175431138,MATH 197,001,091859,McAuley; Julian John,9999,0,9999,0
1657175431138,MATH 197,002,095566,Kedlaya; Kiran S.,9997,0,9999,2
1657175431138,MATH 197,003,095567,Xiao; Ming,9999,0,9999,0
1657175431138,MATH 197,004,095571,Perols; Johan Lars,9998,0,9999,1
1657175438192,COGS 9,A01,083615,Shannon; Kyle Michael,7,0,75,68
1657175444214,COGS 11,A01,083617,Boyle; Mary E. T.,22,0,48,26
1657175450236,COGS 13,A01,083071,Bastos; Amalia Pinkusfeld,9,0,71,62
1657175456260,COGS 14A,A01,092681,Semenuks; Arturs,1,1,100,99
1657175462387,COGS 14B,A01,083073,Cheng; Tzu-Han,6,0,63,57
1657175468410,COGS 17,A01,092677,Semenuks; Arturs,4,0,81,77
1657175474433,COGS 100,A01,083619,Allen; Michael Gordon,15,0,70,55
1657175480456,COGS 101A,A01,083621,Davis; Joshua Daniel,9,0,68,59
1657175486478,COGS 101B,A01,091572,Allen; Michael Gordon,9,0,65,56
1657175492506,COGS 101C,A01,083625,Delgado; Tania,17,0,35,18
1657175498546,COGS 107A,A01,083627,Boyle; Mary E. T.,13,0,60,47
1657175504571,COGS 118A,A01,083075,Gupta; Anjum,16,0,76,60
1657175510665,CSE 3,A50,083646,Miranda; Gregory Joseph,24,0,50,26
1657175516689,CSE 8A,A50,083650,Miranda; Gregory Joseph,17,1,56,39
1657175522712,CSE 11,A01,083080,Cao; Yingjun,5,15,40,35
1657175528735,CSE 12,A01,083652,Krause-Levy; Sophia Louisa,24,1,120,96
1657175534763,CSE 15L,A01,083654,Morris; Justin Loren,9,0,50,41
1657175534763,CSE 15L,A02,083655,Morris; Justin Loren,9,0,50,41
1657175540787,CSE 20,A01,083657,Tran; Khoa Dang,38,0,80,42
1657175546808,CSE 21,A01,095574,Bach; Quang Tran,22,0,48,26
1657175552836,CSE 30,A01,083084,Eldon; John,4,0,80,76
1657175552836,CSE 30,B01,095061,Bhaskar; Nishant,7,0,50,43
1657175558861,CSE 100,A01,083659,Cao; Yingjun,4,4,70,66
1657175564887,CSE 134B,A01,083661,Powell; Thomas Allan,20,0,100,80
1657175570911,CSE 140,A01,083663,Gungor; Onat,13,0,85,72
1657175576935,CSE 140L,A01,083088,Eldon; John,17,0,100,83
1657175582961,CSE 175,A01,083665,Kumar; Rakesh,3,0,25,22
1657175588985,CSE 190,A00,092507,Dubnov; Shlomo,7,0,20,13
1657175595007,ECE 45,A01,083139,Congero; Spencer William,5,0,75,70
1657175601033,ECE 65,A50,083695,Saad; Andrew S,12,0,30,18
1657175601033,ECE 65,A51,095125,Saad; Andrew S,25,0,26,1
1657175607061,ECE 109,A01,091882,Touri; Behrouz,19,0,70,51
1657175613089,ECE 180,A00,083140,Abi Samra; Nicholas Camill,1,0,30,29
1657175613089,ECE 180,B00,083141,Abi Samra; Nicholas Camill,0,0,30,30
1657175619119,MATH 10A,A01,083735,Patchell; Gregory David,2,0,30,28
1657175619119,MATH 10A,A02,083736,Patchell; Gregory David,20,0,30,10
1657175619119,MATH 10A,A03,083737,Patchell; Gregory David,16,0,30,14
1657175625142,MATH 10B,A01,083207,Lim; Seonhee,7,0,34,27
1657175625142,MATH 10B,A02,083208,Lim; Seonhee,9,0,35,26
1657175625142,MATH 10B,A03,093472,Lim; Seonhee,5,0,34,29
1657175625142,MATH 10B,B01,083739,Sinha; Shubham,9,0,30,21
1657175631168,MATH 18,A01,083743,Cinel; Cameron Alexander,6,0,30,24
1657175631168,MATH 18,A02,083744,Cinel; Cameron Alexander,15,0,30,15
1657175631168,MATH 18,A03,083745,Cinel; Cameron Alexander,8,0,30,22
1657175631168,MATH 18,B01,083748,Rideout; David Porter,4,0,37,33
1657175631168,MATH 18,B02,083749,Rideout; David Porter,4,0,36,32
1657175631168,MATH 18,B03,083750,Rideout; David Porter,2,0,37,35
1657175631168,MATH 18,B04,083751,Rideout; David Porter,5,0,36,31
1657175631168,MATH 18,B05,093473,Rideout; David Porter,5,0,36,31
1657175631168,MATH 18,B06,093474,Rideout; David Porter,5,0,36,31
1657175637195,MATH 20A,A01,083754,Zheng; Zequn,13,0,40,27
1657175643223,MATH 20B,A01,083756,Briones; Jor-el Thomas Caparas,1,0,36,35
1657175643223,MATH 20B,A02,083757,Briones; Jor-el Thomas Caparas,1,0,36,35
1657175643223,MATH 20B,A03,093475,Briones; Jor-el Thomas Caparas,1,0,36,35
1657175649248,MATH 20C,A01,083760,Briones; Jor-el Thomas Caparas,1,0,35,34
1657175649248,MATH 20C,A02,083761,Briones; Jor-el Thomas Caparas,8,0,35,27
1657175649248,MATH 20C,A03,093476,Briones; Jor-el Thomas Caparas,0,1,36,36
1657175649248,MATH 20C,B01,083762,Bach; Quang Tran,1,0,30,29
1657175655276,MATH 20D,A01,083765,Tran; Brian Kha,4,0,30,26
1657175655276,MATH 20D,A02,083766,Tran; Brian Kha,5,0,30,25
1657175655276,MATH 20D,A03,083767,Tran; Brian Kha,3,0,30,27
1657175661306,MATH 20E,A01,083771,Ganguly; Soumya,7,0,32,25
1657175661306,MATH 20E,A02,083772,Ganguly; Soumya,7,0,32,25
1657175661306,MATH 20E,B01,083773,Ciotti; Benjamin,19,0,35,16
1657175661306,MATH 20E,B02,083774,Ciotti; Benjamin,17,0,35,18
1657175667331,MATH 103A,A01,083777,Greenfeld; Be'Eri,2,0,36,34
1657175667331,MATH 103A,A02,083778,Greenfeld; Be'Eri,5,0,36,31
1657175667331,MATH 103A,A03,093561,Greenfeld; Be'Eri,4,0,36,32
1657175667331,MATH 103A,B01,083779,Greenfeld; Be'Eri,6,0,36,30
1657175667331,MATH 103A,B02,083780,Greenfeld; Be'Eri,3,0,36,33
1657175667331,MATH 103A,B03,093562,Greenfeld; Be'Eri,3,0,36,33
1657175673361,MATH 105,A01,085443,Carter; Anne Toulson,14,0,35,21
1657175673361,MATH 105,A02,093477,Carter; Anne Toulson,20,0,35,15
1657175679385,MATH 109,A01,083213,Ganzberger; Geoffrey Michael,2,0,34,32
1657175679385,MATH 109,A02,083214,Ganzberger; Geoffrey Michael,3,0,34,31
1657175679385,MATH 109,A03,093478,Ganzberger; Geoffrey Michael,1,0,34,33
1657175679385,MATH 109,B01,083215,Ganzberger; Geoffrey Michael,1,0,32,31
1657175679385,MATH 109,B02,083216,Ganzberger; Geoffrey Michael,1,0,32,31
1657175679385,MATH 109,B03,093479,Ganzberger; Geoffrey Michael,6,0,32,26
1657175685408,MATH 142A,A01,083219,Chow; Bennett,6,0,32,26
1657175685408,MATH 142A,A02,083220,Chow; Bennett,10,0,32,22
1657175685408,MATH 142A,A03,093480,Chow; Bennett,7,0,32,25
1657175685408,MATH 142A,B03,093481,Chow; Bennett,8,0,32,24
1657175685408,MATH 142A,B04,093558,Chow; Bennett,11,0,32,21
1657175685408,MATH 142A,B05,093559,Chow; Bennett,6,0,32,26
1657175691437,MATH 193A,A01,083224,Rotar; Vladimir,7,0,34,27
1657175691437,MATH 193A,A02,083225,Rotar; Vladimir,5,0,34,29
1657175691437,MATH 193A,A03,083781,Rotar; Vladimir,1,0,34,33
1657175691437,MATH 193A,A04,083782,Rotar; Vladimir,8,0,34,26
1657175691437,MATH 193A,A05,093482,Rotar; Vladimir,6,0,34,28
1657175697474,MATH 197,001,091859,McAuley; Julian John,9999,0,9999,0
1657175697474,MATH 197,002,095566,Kedlaya; Kiran S.,9997,0,9999,2
1657175697474,MATH 197,003,095567,Xiao; Ming,9999,0,9999,0
1657175697474,MATH 197,004,095571,Perols; Johan Lars,9998,0,9999,1
1657175704525,COGS 9,A01,083615,Shannon; Kyle Michael,7,0,75,68
1657175710547,COGS 11,A01,083617,Boyle; Mary E. T.,22,0,48,26
1657175716569,COGS 13,A01,083071,Bastos; Amalia Pinkusfeld,9,0,71,62
1657175722603,COGS 14A,A01,092681,Semenuks; Arturs,1,1,100,99
1657175728629,COGS 14B,A01,083073,Cheng; Tzu-Han,6,0,63,57
1657175734657,COGS 17,A01,092677,Semenuks; Arturs,4,0,81,77
1657175740680,COGS 100,A01,083619,Allen; Michael Gordon,15,0,70,55
1657175746709,COGS 101A,A01,083621,Davis; Joshua Daniel,9,0,68,59
1657175752734,COGS 101B,A01,091572,Allen; Michael Gordon,9,0,65,56
1657175758756,COGS 101C,A01,083625,Delgado; Tania,17,0,35,18
1657175764786,COGS 107A,A01,083627,Boyle; Mary E. T.,13,0,60,47
1657175770807,COGS 118A,A01,083075,Gupta; Anjum,16,0,76,60
1657175776831,CSE 3,A50,083646,Miranda; Gregory Joseph,24,0,50,26
1657175782855,CSE 8A,A50,083650,Miranda; Gregory Joseph,17,1,56,39
1657175788878,CSE 11,A01,083080,Cao; Yingjun,5,15,40,35
1657175794904,CSE 12,A01,083652,Krause-Levy; Sophia Louisa,24,1,120,96
1657175800932,CSE 15L,A01,083654,Morris; Justin Loren,9,0,50,41
1657175800932,CSE 15L,A02,083655,Morris; Justin Loren,9,0,50,41
1657175806955,CSE 20,A01,083657,Tran; Khoa Dang,38,0,80,42
1657175812981,CSE 21,A01,095574,Bach; Quang Tran,22,0,48,26
1657175819005,CSE 30,A01,083084,Eldon; John,4,0,80,76
1657175819005,CSE 30,B01,095061,Bhaskar; Nishant,7,0,50,43
1657175825032,CSE 100,A01,083659,Cao; Yingjun,4,4,70,66
1657175831062,CSE 134B,A01,083661,Powell; Thomas Allan,20,0,100,80
1657175837087,CSE 140,A01,083663,Gungor; Onat,13,0,85,72
1657175843115,CSE 140L,A01,083088,Eldon; John,17,0,100,83
1657175849139,CSE 175,A01,083665,Kumar; Rakesh,3,0,25,22
1657175855164,CSE 190,A00,092507,Dubnov; Shlomo,7,0,20,13
1657175861187,ECE 45,A01,083139,Congero; Spencer William,5,0,75,70
1657175867209,ECE 65,A50,083695,Saad; Andrew S,12,0,30,18
1657175867209,ECE 65,A51,095125,Saad; Andrew S,25,0,26,1
1657175873231,ECE 109,A01,091882,Touri; Behrouz,19,0,70,51
1657175879261,ECE 180,A00,083140,Abi Samra; Nicholas Camill,1,0,30,29
1657175879261,ECE 180,B00,083141,Abi Samra; Nicholas Camill,0,0,30,30
1657175885289,MATH 10A,A01,083735,Patchell; Gregory David,2,0,30,28
1657175885289,MATH 10A,A02,083736,Patchell; Gregory David,20,0,30,10
1657175885289,MATH 10A,A03,083737,Patchell; Gregory David,16,0,30,14
1657175891313,MATH 10B,A01,083207,Lim; Seonhee,7,0,34,27
1657175891313,MATH 10B,A02,083208,Lim; Seonhee,9,0,35,26
1657175891313,MATH 10B,A03,093472,Lim; Seonhee,5,0,34,29
1657175891313,MATH 10B,B01,083739,Sinha; Shubham,10,0,30,20
1657175897339,MATH 18,A01,083743,Cinel; Cameron Alexander,6,0,30,24
1657175897339,MATH 18,A02,083744,Cinel; Cameron Alexander,15,0,30,15
1657175897339,MATH 18,A03,083745,Cinel; Cameron Alexander,8,0,30,22
1657175897339,MATH 18,B01,083748,Rideout; David Porter,4,0,37,33
1657175897339,MATH 18,B02,083749,Rideout; David Porter,4,0,36,32
1657175897339,MATH 18,B03,083750,Rideout; David Porter,2,0,37,35
1657175897339,MATH 18,B04,083751,Rideout; David Porter,5,0,36,31
1657175897339,MATH 18,B05,093473,Rideout; David Porter,5,0,36,31
1657175897339,MATH 18,B06,093474,Rideout; David Porter,5,0,36,31
1657175903368,MATH 20A,A01,083754,Zheng; Zequn,13,0,40,27
1657175909398,MATH 20B,A01,083756,Briones; Jor-el Thomas Caparas,1,0,36,35
1657175909398,MATH 20B,A02,083757,Briones; Jor-el Thomas Caparas,1,0,36,35
1657175909398,MATH 20B,A03,093475,Briones; Jor-el Thomas Caparas,1,0,36,35
1657175915426,MATH 20C,A01,083760,Briones; Jor-el Thomas Caparas,1,0,35,34
1657175915426,MATH 20C,A02,083761,Briones; Jor-el Thomas Caparas,8,0,35,27
1657175915426,MATH 20C,A03,093476,Briones; Jor-el Thomas Caparas,0,1,36,36
1657175915426,MATH 20C,B01,083762,Bach; Quang Tran,1,0,30,29
1657175921454,MATH 20D,A01,083765,Tran; Brian Kha,4,0,30,26
1657175921454,MATH 20D,A02,083766,Tran; Brian Kha,5,0,30,25
1657175921454,MATH 20D,A03,083767,Tran; Brian Kha,4,0,30,26
1657175927476,MATH 20E,A01,083771,Ganguly; Soumya,7,0,32,25
1657175927476,MATH 20E,A02,083772,Ganguly; Soumya,7,0,32,25
1657175927476,MATH 20E,B01,083773,Ciotti; Benjamin,19,0,35,16
1657175927476,MATH 20E,B02,083774,Ciotti; Benjamin,17,0,35,18
1657175933498,MATH 103A,A01,083777,Greenfeld; Be'Eri,2,0,36,34
1657175933498,MATH 103A,A02,083778,Greenfeld; Be'Eri,5,0,36,31
1657175933498,MATH 103A,A03,093561,Greenfeld; Be'Eri,4,0,36,32
1657175933498,MATH 103A,B01,083779,Greenfeld; Be'Eri,6,0,36,30
1657175933498,MATH 103A,B02,083780,Greenfeld; Be'Eri,3,0,36,33
1657175933498,MATH 103A,B03,093562,Greenfeld; Be'Eri,3,0,36,33
1657175939520,MATH 105,A01,085443,Carter; Anne Toulson,14,0,35,21
1657175939520,MATH 105,A02,093477,Carter; Anne Toulson,20,0,35,15
1657175945543,MATH 109,A01,083213,Ganzberger; Geoffrey Michael,2,0,34,32
1657175945543,MATH 109,A02,083214,Ganzberger; Geoffrey Michael,3,0,34,31
1657175945543,MATH 109,A03,093478,Ganzberger; Geoffrey Michael,1,0,34,33
1657175945543,MATH 109,B01,083215,Ganzberger; Geoffrey Michael,1,0,32,31
1657175945543,MATH 109,B02,083216,Ganzberger; Geoffrey Michael,1,0,32,31
1657175945543,MATH 109,B03,093479,Ganzberger; Geoffrey Michael,6,0,32,26
1657175951565,MATH 142A,A01,083219,Chow; Bennett,6,0,32,26
1657175951565,MATH 142A,A02,083220,Chow; Bennett,10,0,32,22
1657175951565,MATH 142A,A03,093480,Chow; Bennett,7,0,32,25
1657175951565,MATH 142A,B03,093481,Chow; Bennett,8,0,32,24
1657175951565,MATH 142A,B04,093558,Chow; Bennett,11,0,32,21
1657175951565,MATH 142A,B05,093559,Chow; Bennett,6,0,32,26
1657175957593,MATH 193A,A01,083224,Rotar; Vladimir,7,0,34,27
1657175957593,MATH 193A,A02,083225,Rotar; Vladimir,5,0,34,29
1657175957593,MATH 193A,A03,083781,Rotar; Vladimir,1,0,34,33
1657175957593,MATH 193A,A04,083782,Rotar; Vladimir,8,0,34,26
1657175957593,MATH 193A,A05,093482,Rotar; Vladimir,6,0,34,28
1657175963618,MATH 197,001,091859,McAuley; Julian John,9999,0,9999,0
1657175963618,MATH 197,002,095566,Kedlaya; Kiran S.,9997,0,9999,2
1657175963618,MATH 197,003,095567,Xiao; Ming,9999,0,9999,0
1657175963618,MATH 197,004,095571,Perols; Johan Lars,9998,0,9999,1
1657175970676,COGS 9,A01,083615,Shannon; Kyle Michael,7,0,75,68
1657175976702,COGS 11,A01,083617,Boyle; Mary E. T.,22,0,48,26
1657175982733,COGS 13,A01,083071,Bastos; Amalia Pinkusfeld,9,0,71,62
1657175988755,COGS 14A,A01,092681,Semenuks; Arturs,1,1,100,99
1657175994777,COGS 14B,A01,083073,Cheng; Tzu-Han,6,0,63,57
1657176000798,COGS 17,A01,092677,Semenuks; Arturs,4,0,81,77
1657176006824,COGS 100,A01,083619,Allen; Michael Gordon,15,0,70,55
1657176012846,COGS 101A,A01,083621,Davis; Joshua Daniel,9,0,68,59
1657176018869,COGS 101B,A01,091572,Allen; Michael Gordon,9,0,65,56
1657176024892,COGS 101C,A01,083625,Delgado; Tania,17,0,35,18
1657176030918,COGS 107A,A01,083627,Boyle; Mary E. T.,13,0,60,47
1657176036942,COGS 118A,A01,083075,Gupta; Anjum,16,0,76,60
1657176042970,CSE 3,A50,083646,Miranda; Gregory Joseph,24,0,50,26
1657176048998,CSE 8A,A50,083650,Miranda; Gregory Joseph,17,1,56,39
1657176055021,CSE 11,A01,083080,Cao; Yingjun,5,15,40,35
1657176061043,CSE 12,A01,083652,Krause-Levy; Sophia Louisa,24,1,120,96
1657176067067,CSE 15L,A01,083654,Morris; Justin Loren,9,0,50,41
1657176067067,CSE 15L,A02,083655,Morris; Justin Loren,9,0,50,41
1657176073093,CSE 20,A01,083657,Tran; Khoa Dang,38,0,80,42
1657176079119,CSE 21,A01,095574,Bach; Quang Tran,22,0,48,26
1657176085145,CSE 30,A01,083084,Eldon; John,4,0,80,76
1657176085145,CSE 30,B01,095061,Bhaskar; Nishant,7,0,50,43
1657176091171,CSE 100,A01,083659,Cao; Yingjun,4,4,70,66
1657176097193,CSE 134B,A01,083661,Powell; Thomas Allan,20,0,100,80
1657176103215,CSE 140,A01,083663,Gungor; Onat,13,0,85,72
1657176109312,CSE 140L,A01,083088,Eldon; John,17,0,100,83
1657176115335,CSE 175,A01,083665,Kumar; Rakesh,3,0,25,22
1657176121361,CSE 190,A00,092507,Dubnov; Shlomo,7,0,20,13
1657176127385,ECE 45,A01,083139,Congero; Spencer William,5,0,75,70
1657176133407,ECE 65,A50,083695,Saad; Andrew S,12,0,30,18
1657176133407,ECE 65,A51,095125,Saad; Andrew S,25,0,26,1
1657176139429,ECE 109,A01,091882,Touri; Behrouz,19,0,70,51
1657176145456,ECE 180,A00,083140,Abi Samra; Nicholas Camill,1,0,30,29
1657176145456,ECE 180,B00,083141,Abi Samra; Nicholas Camill,0,0,30,30
1657176151480,MATH 10A,A01,083735,Patchell; Gregory David,2,0,30,28
1657176151480,MATH 10A,A02,083736,Patchell; Gregory David,20,0,30,10
1657176151480,MATH 10A,A03,083737,Patchell; Gregory David,16,0,30,14
1657176157503,MATH 10B,A01,083207,Lim; Seonhee,7,0,34,27
1657176157503,MATH 10B,A02,083208,Lim; Seonhee,9,0,35,26
1657176157503,MATH 10B,A03,093472,Lim; Seonhee,5,0,34,29
1657176157503,MATH 10B,B01,083739,Sinha; Shubham,10,0,30,20
1657176163533,MATH 18,A01,083743,Cinel; Cameron Alexander,6,0,30,24
1657176163533,MATH 18,A02,083744,Cinel; Cameron Alexander,15,0,30,15
1657176163533,MATH 18,A03,083745,Cinel; Cameron Alexander,8,0,30,22
1657176163533,MATH 18,B01,083748,Rideout; David Porter,4,0,37,33
1657176163533,MATH 18,B02,083749,Rideout; David Porter,4,0,36,32
1657176163533,MATH 18,B03,083750,Rideout; David Porter,2,0,37,35
1657176163533,MATH 18,B04,083751,Rideout; David Porter,5,0,36,31
1657176163533,MATH 18,B05,093473,Rideout; David Porter,5,0,36,31
1657176163533,MATH 18,B06,093474,Rideout; David Porter,5,0,36,31
1657176169560,MATH 20A,A01,083754,Zheng; Zequn,13,0,40,27
1657176175587,MATH 20B,A01,083756,Briones; Jor-el Thomas Caparas,1,0,36,35
1657176175587,MATH 20B,A02,083757,Briones; Jor-el Thomas Caparas,1,0,36,35
1657176175587,MATH 20B,A03,093475,Briones; Jor-el Thomas Caparas,1,0,36,35
1657176181610,MATH 20C,A01,083760,Briones; Jor-el Thomas Caparas,1,0,35,34
1657176181610,MATH 20C,A02,083761,Briones; Jor-el Thomas Caparas,8,0,35,27
1657176181610,MATH 20C,A03,093476,Briones; Jor-el Thomas Caparas,0,1,36,36
1657176181610,MATH 20C,B01,083762,Bach; Quang Tran,1,0,30,29
1657176187632,MATH 20D,A01,083765,Tran; Brian Kha,4,0,30,26
1657176187632,MATH 20D,A02,083766,Tran; Brian Kha,5,0,30,25
1657176187632,MATH 20D,A03,083767,Tran; Brian Kha,4,0,30,26
1657176193655,MATH 20E,A01,083771,Ganguly; Soumya,7,0,32,25
1657176193655,MATH 20E,A02,083772,Ganguly; Soumya,7,0,32,25
1657176193655,MATH 20E,B01,083773,Ciotti; Benjamin,19,0,35,16
1657176193655,MATH 20E,B02,083774,Ciotti; Benjamin,17,0,35,18
1657176199683,MATH 103A,A01,083777,Greenfeld; Be'Eri,2,0,36,34
1657176199683,MATH 103A,A02,083778,Greenfeld; Be'Eri,5,0,36,31
1657176199683,MATH 103A,A03,093561,Greenfeld; Be'Eri,4,0,36,32
1657176199683,MATH 103A,B01,083779,Greenfeld; Be'Eri,6,0,36,30
1657176199683,MATH 103A,B02,083780,Greenfeld; Be'Eri,3,0,36,33
1657176199683,MATH 103A,B03,093562,Greenfeld; Be'Eri,3,0,36,33
1657176205705,MATH 105,A01,085443,Carter; Anne Toulson,14,0,35,21
1657176205705,MATH 105,A02,093477,Carter; Anne Toulson,20,0,35,15
1657176211742,MATH 109,A01,083213,Ganzberger; Geoffrey Michael,2,0,34,32
1657176211742,MATH 109,A02,083214,Ganzberger; Geoffrey Michael,3,0,34,31
1657176211742,MATH 109,A03,093478,Ganzberger; Geoffrey Michael,1,0,34,33
1657176211742,MATH 109,B01,083215,Ganzberger; Geoffrey Michael,1,0,32,31
1657176211742,MATH 109,B02,083216,Ganzberger; Geoffrey Michael,1,0,32,31
1657176211742,MATH 109,B03,093479,Ganzberger; Geoffrey Michael,6,0,32,26
1657176217764,MATH 142A,A01,083219,Chow; Bennett,6,0,32,26
1657176217764,MATH 142A,A02,083220,Chow; Bennett,10,0,32,22
1657176217764,MATH 142A,A03,093480,Chow; Bennett,7,0,32,25
1657176217764,MATH 142A,B03,093481,Chow; Bennett,8,0,32,24
1657176217764,MATH 142A,B04,093558,Chow; Bennett,11,0,32,21
1657176217764,MATH 142A,B05,093559,Chow; Bennett,6,0,32,26
1657176223787,MATH 193A,A01,083224,Rotar; Vladimir,7,0,34,27
1657176223787,MATH 193A,A02,083225,Rotar; Vladimir,5,0,34,29
1657176223787,MATH 193A,A03,083781,Rotar; Vladimir,1,0,34,33
1657176223787,MATH 193A,A04,083782,Rotar; Vladimir,8,0,34,26
1657176223787,MATH 193A,A05,093482,Rotar; Vladimir,6,0,34,28
1657176229809,MATH 197,001,091859,McAuley; Julian John,9999,0,9999,0
1657176229809,MATH 197,002,095566,Kedlaya; Kiran S.,9997,0,9999,2
1657176229809,MATH 197,003,095567,Xiao; Ming,9999,0,9999,0
1657176229809,MATH 197,004,095571,Perols; Johan Lars,9998,0,9999,1
1657176236858,COGS 9,A01,083615,Shannon; Kyle Michael,7,0,75,68
1657176242883,COGS 11,A01,083617,Boyle; Mary E. T.,22,0,48,26
1657176248918,COGS 13,A01,083071,Bastos; Amalia Pinkusfeld,9,0,71,62
1657176254951,COGS 14A,A01,092681,Semenuks; Arturs,1,1,100,99
1657176260987,COGS 14B,A01,083073,Cheng; Tzu-Han,6,0,63,57
1657176267010,COGS 17,A01,092677,Semenuks; Arturs,4,0,81,77
1657176273037,COGS 100,A01,083619,Allen; Michael Gordon,15,0,70,55
1657176279064,COGS 101A,A01,083621,Davis; Joshua Daniel,9,0,68,59
1657176285086,COGS 101B,A01,091572,Allen; Michael Gordon,9,0,65,56
1657176291111,COGS 101C,A01,083625,Delgado; Tania,17,0,35,18
1657176297137,COGS 107A,A01,083627,Boyle; Mary E. T.,13,0,60,47
1657176303160,COGS 118A,A01,083075,Gupta; Anjum,16,0,76,60
1657176309186,CSE 3,A50,083646,Miranda; Gregory Joseph,24,0,50,26
1657176315214,CSE 8A,A50,083650,Miranda; Gregory Joseph,17,1,56,39
1657176321238,CSE 11,A01,083080,Cao; Yingjun,5,15,40,35
1657176327261,CSE 12,A01,083652,Krause-Levy; Sophia Louisa,24,1,120,96
1657176333285,CSE 15L,A01,083654,Morris; Justin Loren,9,0,50,41
1657176333285,CSE 15L,A02,083655,Morris; Justin Loren,9,0,50,41
1657176339315,CSE 20,A01,083657,Tran; Khoa Dang,38,0,80,42
1657176345340,CSE 21,A01,095574,Bach; Quang Tran,22,0,48,26
1657176351363,CSE 30,A01,083084,Eldon; John,4,0,80,76
1657176351363,CSE 30,B01,095061,Bhaskar; Nishant,7,0,50,43
1657176357390,CSE 100,A01,083659,Cao; Yingjun,4,4,70,66
1657176363416,CSE 134B,A01,083661,Powell; Thomas Allan,20,0,100,80
1657176369454,CSE 140,A01,083663,Gungor; Onat,13,0,85,72
1657176375478,CSE 140L,A01,083088,Eldon; John,17,0,100,83
1657176381506,CSE 175,A01,083665,Kumar; Rakesh,3,0,25,22
1657176387532,CSE 190,A00,092507,Dubnov; Shlomo,7,0,20,13
1657176393560,ECE 45,A01,083139,Congero; Spencer William,5,0,75,70
1657176399588,ECE 65,A50,083695,Saad; Andrew S,12,0,30,18
1657176399588,ECE 65,A51,095125,Saad; Andrew S,25,0,26,1
1657176405619,ECE 109,A01,091882,Touri; Behrouz,19,0,70,51
1657176411654,ECE 180,A00,083140,Abi Samra; Nicholas Camill,1,0,30,29
1657176411654,ECE 180,B00,083141,Abi Samra; Nicholas Camill,0,0,30,30
1657176417678,MATH 10A,A01,083735,Patchell; Gregory David,2,0,30,28
1657176417678,MATH 10A,A02,083736,Patchell; Gregory David,20,0,30,10
1657176417678,MATH 10A,A03,083737,Patchell; Gregory David,16,0,30,14
1657176423700,MATH 10B,A01,083207,Lim; Seonhee,7,0,34,27
1657176423700,MATH 10B,A02,083208,Lim; Seonhee,9,0,35,26
1657176423700,MATH 10B,A03,093472,Lim; Seonhee,5,0,34,29
1657176423700,MATH 10B,B01,083739,Sinha; Shubham,10,0,30,20
1657176429727,MATH 18,A01,083743,Cinel; Cameron Alexander,6,0,30,24
1657176429727,MATH 18,A02,083744,Cinel; Cameron Alexander,15,0,30,15
1657176429727,MATH 18,A03,083745,Cinel; Cameron Alexander,8,0,30,22
1657176429727,MATH 18,B01,083748,Rideout; David Porter,4,0,37,33
1657176429727,MATH 18,B02,083749,Rideout; David Porter,4,0,36,32
1657176429727,MATH 18,B03,083750,Rideout; David Porter,2,0,37,35
1657176429727,MATH 18,B04,083751,Rideout; David Porter,5,0,36,31
1657176429727,MATH 18,B05,093473,Rideout; David Porter,5,0,36,31
1657176429727,MATH 18,B06,093474,Rideout; David Porter,5,0,36,31
1657176435754,MATH 20A,A01,083754,Zheng; Zequn,13,0,40,27
1657176441778,MATH 20B,A01,083756,Briones; Jor-el Thomas Caparas,1,0,36,35
1657176441778,MATH 20B,A02,083757,Briones; Jor-el Thomas Caparas,1,0,36,35
1657176441778,MATH 20B,A03,093475,Briones; Jor-el Thomas Caparas,1,0,36,35
1657176447802,MATH 20C,A01,083760,Briones; Jor-el Thomas Caparas,1,0,35,34
1657176447802,MATH 20C,A02,083761,Briones; Jor-el Thomas Caparas,8,0,35,27
1657176447802,MATH 20C,A03,093476,Briones; Jor-el Thomas Caparas,0,1,36,36
1657176447802,MATH 20C,B01,083762,Bach; Quang Tran,1,0,30,29
1657176453829,MATH 20D,A01,083765,Tran; Brian Kha,4,0,30,26
1657176453829,MATH 20D,A02,083766,Tran; Brian Kha,5,0,30,25
1657176453829,MATH 20D,A03,083767,Tran; Brian Kha,4,0,30,26
1657176459856,MATH 20E,A01,083771,Ganguly; Soumya,7,0,32,25
1657176459856,MATH 20E,A02,083772,Ganguly; Soumya,7,0,32,25
1657176459856,MATH 20E,B01,083773,Ciotti; Benjamin,19,0,35,16
1657176459856,MATH 20E,B02,083774,Ciotti; Benjamin,17,0,35,18
1657176465886,MATH 103A,A01,083777,Greenfeld; Be'Eri,2,0,36,34
1657176465886,MATH 103A,A02,083778,Greenfeld; Be'Eri,5,0,36,31
1657176465886,MATH 103A,A03,093561,Greenfeld; Be'Eri,4,0,36,32
1657176465886,MATH 103A,B01,083779,Greenfeld; Be'Eri,6,0,36,30
1657176465886,MATH 103A,B02,083780,Greenfeld; Be'Eri,3,0,36,33
1657176465886,MATH 103A,B03,093562,Greenfeld; Be'Eri,3,0,36,33
1657176471921,MATH 105,A01,085443,Carter; Anne Toulson,14,0,35,21
1657176471921,MATH 105,A02,093477,Carter; Anne Toulson,20,0,35,15
1657176477945,MATH 109,A01,083213,Ganzberger; Geoffrey Michael,2,0,34,32
1657176477945,MATH 109,A02,083214,Ganzberger; Geoffrey Michael,3,0,34,31
1657176477945,MATH 109,A03,093478,Ganzberger; Geoffrey Michael,1,0,34,33
1657176477945,MATH 109,B01,083215,Ganzberger; Geoffrey Michael,1,0,32,31
1657176477945,MATH 109,B02,083216,Ganzberger; Geoffrey Michael,1,0,32,31
1657176477945,MATH 109,B03,093479,Ganzberger; Geoffrey Michael,6,0,32,26
1657176483970,MATH 142A,A01,083219,Chow; Bennett,6,0,32,26
1657176483970,MATH 142A,A02,083220,Chow; Bennett,10,0,32,22
1657176483970,MATH 142A,A03,093480,Chow; Bennett,7,0,32,25
1657176483970,MATH 142A,B03,093481,Chow; Bennett,8,0,32,24
1657176483970,MATH 142A,B04,093558,Chow; Bennett,11,0,32,21
1657176483970,MATH 142A,B05,093559,Chow; Bennett,6,0,32,26
1657176489996,MATH 193A,A01,083224,Rotar; Vladimir,7,0,34,27
1657176489996,MATH 193A,A02,083225,Rotar; Vladimir,5,0,34,29
1657176489996,MATH 193A,A03,083781,Rotar; Vladimir,1,0,34,33
1657176489996,MATH 193A,A04,083782,Rotar; Vladimir,8,0,34,26
1657176489996,MATH 193A,A05,093482,Rotar; Vladimir,6,0,34,28
1657176496022,MATH 197,001,091859,McAuley; Julian John,9999,0,9999,0
1657176496022,MATH 197,002,095566,Kedlaya; Kiran S.,9997,0,9999,2
1657176496022,MATH 197,003,095567,Xiao; Ming,9999,0,9999,0
1657176496022,MATH 197,004,095571,Perols; Johan Lars,9998,0,9999,1
1657176503075,COGS 9,A01,083615,Shannon; Kyle Michael,7,0,75,68
1657176509100,COGS 11,A01,083617,Boyle; Mary E. T.,22,0,48,26
1657176515123,COGS 13,A01,083071,Bastos; Amalia Pinkusfeld,9,0,71,62
1657176521151,COGS 14A,A01,092681,Semenuks; Arturs,1,1,100,99
1657176527175,COGS 14B,A01,083073,Cheng; Tzu-Han,6,0,63,57
1657176533201,COGS 17,A01,092677,Semenuks; Arturs,4,0,81,77
1657176539224,COGS 100,A01,083619,Allen; Michael Gordon,15,0,70,55
1657176545249,COGS 101A,A01,083621,Davis; Joshua Daniel,9,0,68,59
1657176551275,COGS 101B,A01,091572,Allen; Michael Gordon,9,0,65,56
1657176557297,COGS 101C,A01,083625,Delgado; Tania,17,0,35,18
1657176563324,COGS 107A,A01,083627,Boyle; Mary E. T.,13,0,60,47
1657176569346,COGS 118A,A01,083075,Gupta; Anjum,16,0,76,60
1657176575370,CSE 3,A50,083646,Miranda; Gregory Joseph,24,0,50,26
1657176581404,CSE 8A,A50,083650,Miranda; Gregory Joseph,17,1,56,39
1657176587427,CSE 11,A01,083080,Cao; Yingjun,5,15,40,35
1657176593454,CSE 12,A01,083652,Krause-Levy; Sophia Louisa,24,1,120,96
1657176599481,CSE 15L,A01,083654,Morris; Justin Loren,9,0,50,41
1657176599481,CSE 15L,A02,083655,Morris; Justin Loren,9,0,50,41
1657176605504,CSE 20,A01,083657,Tran; Khoa Dang,38,0,80,42
1657176611527,CSE 21,A01,095574,Bach; Quang Tran,22,0,48,26
1657176617555,CSE 30,A01,083084,Eldon; John,4,0,80,76
1657176617555,CSE 30,B01,095061,Bhaskar; Nishant,7,0,50,43
1657176623579,CSE 100,A01,083659,Cao; Yingjun,4,4,70,66
1657176629602,CSE 134B,A01,083661,Powell; Thomas Allan,20,0,100,80
1657176635629,CSE 140,A01,083663,Gungor; Onat,13,0,85,72
1657176641653,CSE 140L,A01,083088,Eldon; John,17,0,100,83
1657176647692,CSE 175,A01,083665,Kumar; Rakesh,3,0,25,22
1657176653715,CSE 190,A00,092507,Dubnov; Shlomo,7,0,20,13
1657176659751,ECE 45,A01,083139,Congero; Spencer William,5,0,75,70
1657176665777,ECE 65,A50,083695,Saad; Andrew S,12,0,30,18
1657176665777,ECE 65,A51,095125,Saad; Andrew S,25,0,26,1
1657176671800,ECE 109,A01,091882,Touri; Behrouz,19,0,70,51
1657176677823,ECE 180,A00,083140,Abi Samra; Nicholas Camill,1,0,30,29
1657176677823,ECE 180,B00,083141,Abi Samra; Nicholas Camill,0,0,30,30
1657176683847,MATH 10A,A01,083735,Patchell; Gregory David,2,0,30,28
1657176683847,MATH 10A,A02,083736,Patchell; Gregory David,20,0,30,10
1657176683847,MATH 10A,A03,083737,Patchell; Gregory David,16,0,30,14
1657176689871,MATH 10B,A01,083207,Lim; Seonhee,7,0,34,27
1657176689871,MATH 10B,A02,083208,Lim; Seonhee,9,0,35,26
1657176689871,MATH 10B,A03,093472,Lim; Seonhee,5,0,34,29
1657176689871,MATH 10B,B01,083739,Sinha; Shubham,10,0,30,20
1657176695897,MATH 18,A01,083743,Cinel; Cameron Alexander,6,0,30,24
1657176695897,MATH 18,A02,083744,Cinel; Cameron Alexander,15,0,30,15
1657176695897,MATH 18,A03,083745,Cinel; Cameron Alexander,8,0,30,22
1657176695897,MATH 18,B01,083748,Rideout; David Porter,4,0,37,33
1657176695897,MATH 18,B02,083749,Rideout; David Porter,4,0,36,32
1657176695897,MATH 18,B03,083750,Rideout; David Porter,2,0,37,35
1657176695897,MATH 18,B04,083751,Rideout; David Porter,5,0,36,31
1657176695897,MATH 18,B05,093473,Rideout; David Porter,5,0,36,31
1657176695897,MATH 18,B06,093474,Rideout; David Porter,5,0,36,31
1657176701921,MATH 20A,A01,083754,Zheng; Zequn,13,0,40,27
1657176708014,MATH 20B,A01,083756,Briones; Jor-el Thomas Caparas,1,0,36,35
1657176708014,MATH 20B,A02,083757,Briones; Jor-el Thomas Caparas,1,0,36,35
1657176708014,MATH 20B,A03,093475,Briones; Jor-el Thomas Caparas,1,0,36,35
1657176714039,MATH 20C,A01,083760,Briones; Jor-el Thomas Caparas,1,0,35,34
1657176714039,MATH 20C,A02,083761,Briones; Jor-el Thomas Caparas,8,0,35,27
1657176714039,MATH 20C,A03,093476,Briones; Jor-el Thomas Caparas,0,1,36,36
1657176714039,MATH 20C,B01,083762,Bach; Quang Tran,1,0,30,29
1657176720062,MATH 20D,A01,083765,Tran; Brian Kha,4,0,30,26
1657176720062,MATH 20D,A02,083766,Tran; Brian Kha,5,0,30,25
1657176720062,MATH 20D,A03,083767,Tran; Brian Kha,4,0,30,26
1657176726085,MATH 20E,A01,083771,Ganguly; Soumya,7,0,32,25
1657176726085,MATH 20E,A02,083772,Ganguly; Soumya,7,0,32,25
1657176726085,MATH 20E,B01,083773,Ciotti; Benjamin,19,0,35,16
1657176726085,MATH 20E,B02,083774,Ciotti; Benjamin,17,0,35,18
1657176732114,MATH 103A,A01,083777,Greenfeld; Be'Eri,2,0,36,34
1657176732114,MATH 103A,A02,083778,Greenfeld; Be'Eri,5,0,36,31
1657176732114,MATH 103A,A03,093561,Greenfeld; Be'Eri,4,0,36,32
1657176732114,MATH 103A,B01,083779,Greenfeld; Be'Eri,6,0,36,30
1657176732114,MATH 103A,B02,083780,Greenfeld; Be'Eri,3,0,36,33
1657176732114,MATH 103A,B03,093562,Greenfeld; Be'Eri,3,0,36,33
1657176738141,MATH 105,A01,085443,Carter; Anne Toulson,14,0,35,21
1657176738141,MATH 105,A02,093477,Carter; Anne Toulson,20,0,35,15
1657176744182,MATH 109,A01,083213,Ganzberger; Geoffrey Michael,2,0,34,32
1657176744182,MATH 109,A02,083214,Ganzberger; Geoffrey Michael,3,0,34,31
1657176744182,MATH 109,A03,093478,Ganzberger; Geoffrey Michael,1,0,34,33
1657176744182,MATH 109,B01,083215,Ganzberger; Geoffrey Michael,1,0,32,31
1657176744182,MATH 109,B02,083216,Ganzberger; Geoffrey Michael,1,0,32,31
1657176744182,MATH 109,B03,093479,Ganzberger; Geoffrey Michael,6,0,32,26
1657176750213,MATH 142A,A01,083219,Chow; Bennett,6,0,32,26
1657176750213,MATH 142A,A02,083220,Chow; Bennett,10,0,32,22
1657176750213,MATH 142A,A03,093480,Chow; Bennett,7,0,32,25
1657176750213,MATH 142A,B03,093481,Chow; Bennett,8,0,32,24
1657176750213,MATH 142A,B04,093558,Chow; Bennett,11,0,32,21
1657176750213,MATH 142A,B05,093559,Chow; Bennett,6,0,32,26
1657176756239,MATH 193A,A01,083224,Rotar; Vladimir,7,0,34,27
1657176756239,MATH 193A,A02,083225,Rotar; Vladimir,5,0,34,29
1657176756239,MATH 193A,A03,083781,Rotar; Vladimir,1,0,34,33
1657176756239,MATH 193A,A04,083782,Rotar; Vladimir,8,0,34,26
1657176756239,MATH 193A,A05,093482,Rotar; Vladimir,6,0,34,28
1657176762262,MATH 197,001,091859,McAuley; Julian John,9999,0,9999,0
1657176762262,MATH 197,002,095566,Kedlaya; Kiran S.,9997,0,9999,2
1657176762262,MATH 197,003,095567,Xiao; Ming,9999,0,9999,0
1657176762262,MATH 197,004,095571,Perols; Johan Lars,9998,0,9999,1
1657176769329,COGS 9,A01,083615,Shannon; Kyle Michael,7,0,75,68
1657176775352,COGS 11,A01,083617,Boyle; Mary E. T.,22,0,48,26
1657176781376,COGS 13,A01,083071,Bastos; Amalia Pinkusfeld,9,0,71,62
1657176787398,COGS 14A,A01,092681,Semenuks; Arturs,1,1,100,99
1657176793426,COGS 14B,A01,083073,Cheng; Tzu-Han,6,0,63,57
1657176799681,COGS 17,A01,092677,Semenuks; Arturs,4,0,81,77
1657176805707,COGS 100,A01,083619,Allen; Michael Gordon,15,0,70,55
1657176811728,COGS 101A,A01,083621,Davis; Joshua Daniel,9,0,68,59
1657176817753,COGS 101B,A01,091572,Allen; Michael Gordon,9,0,65,56
1657176823776,COGS 101C,A01,083625,Delgado; Tania,17,0,35,18
1657176829798,COGS 107A,A01,083627,Boyle; Mary E. T.,13,0,60,47
1657176835828,COGS 118A,A01,083075,Gupta; Anjum,16,0,76,60
1657176841850,CSE 3,A50,083646,Miranda; Gregory Joseph,24,0,50,26
1657176847874,CSE 8A,A50,083650,Miranda; Gregory Joseph,17,1,56,39
1657176853901,CSE 11,A01,083080,Cao; Yingjun,5,15,40,35
1657176859924,CSE 12,A01,083652,Krause-Levy; Sophia Louisa,24,1,120,96
1657176865948,CSE 15L,A01,083654,Morris; Justin Loren,9,0,50,41
1657176865948,CSE 15L,A02,083655,Morris; Justin Loren,9,0,50,41
1657176871970,CSE 20,A01,083657,Tran; Khoa Dang,38,0,80,42
1657176877993,CSE 21,A01,095574,Bach; Quang Tran,22,0,48,26
1657176884021,CSE 30,A01,083084,Eldon; John,4,0,80,76
1657176884021,CSE 30,B01,095061,Bhaskar; Nishant,7,0,50,43
1657176890048,CSE 100,A01,083659,Cao; Yingjun,4,4,70,66
1657176896072,CSE 134B,A01,083661,Powell; Thomas Allan,20,0,100,80
1657176902097,CSE 140,A01,083663,Gungor; Onat,13,0,85,72
1657176908120,CSE 140L,A01,083088,Eldon; John,17,0,100,83
1657176914142,CSE 175,A01,083665,Kumar; Rakesh,3,0,25,22
1657176920166,CSE 190,A00,092507,Dubnov; Shlomo,7,0,20,13
1657176926196,ECE 45,A01,083139,Congero; Spencer William,5,0,75,70
1657176932223,ECE 65,A50,083695,Saad; Andrew S,12,0,30,18
1657176932223,ECE 65,A51,095125,Saad; Andrew S,25,0,26,1
1657176938247,ECE 109,A01,091882,Touri; Behrouz,19,0,70,51
1657176944271,ECE 180,A00,083140,Abi Samra; Nicholas Camill,1,0,30,29
1657176944271,ECE 180,B00,083141,Abi Samra; Nicholas Camill,0,0,30,30
1657176950295,MATH 10A,A01,083735,Patchell; Gregory David,2,0,30,28
1657176950295,MATH 10A,A02,083736,Patchell; Gregory David,20,0,30,10
1657176950295,MATH 10A,A03,083737,Patchell; Gregory David,16,0,30,14
1657176956331,MATH 10B,A01,083207,Lim; Seonhee,7,0,34,27
1657176956331,MATH 10B,A02,083208,Lim; Seonhee,9,0,35,26
1657176956331,MATH 10B,A03,093472,Lim; Seonhee,5,0,34,29
1657176956331,MATH 10B,B01,083739,Sinha; Shubham,10,0,30,20
1657176962371,MATH 18,A01,083743,Cinel; Cameron Alexander,6,0,30,24
1657176962371,MATH 18,A02,083744,Cinel; Cameron Alexander,15,0,30,15
1657176962371,MATH 18,A03,083745,Cinel; Cameron Alexander,8,0,30,22
1657176962371,MATH 18,B01,083748,Rideout; David Porter,4,0,37,33
1657176962371,MATH 18,B02,083749,Rideout; David Porter,4,0,36,32
1657176962371,MATH 18,B03,083750,Rideout; David Porter,2,0,37,35
1657176962371,MATH 18,B04,083751,Rideout; David Porter,5,0,36,31
1657176962371,MATH 18,B05,093473,Rideout; David Porter,5,0,36,31
1657176962371,MATH 18,B06,093474,Rideout; David Porter,5,0,36,31
1657176968394,MATH 20A,A01,083754,Zheng; Zequn,13,0,40,27
1657176974418,MATH 20B,A01,083756,Briones; Jor-el Thomas Caparas,1,0,36,35
1657176974418,MATH 20B,A02,083757,Briones; Jor-el Thomas Caparas,1,0,36,35
1657176974418,MATH 20B,A03,093475,Briones; Jor-el Thomas Caparas,1,0,36,35
1657176980441,MATH 20C,A01,083760,Briones; Jor-el Thomas Caparas,1,0,35,34
1657176980441,MATH 20C,A02,083761,Briones; Jor-el Thomas Caparas,8,0,35,27
1657176980441,MATH 20C,A03,093476,Briones; Jor-el Thomas Caparas,0,1,36,36
1657176980441,MATH 20C,B01,083762,Bach; Quang Tran,1,0,30,29
1657176986465,MATH 20D,A01,083765,Tran; Brian Kha,4,0,30,26
1657176986465,MATH 20D,A02,083766,Tran; Brian Kha,5,0,30,25
1657176986465,MATH 20D,A03,083767,Tran; Brian Kha,4,0,30,26
1657176992493,MATH 20E,A01,083771,Ganguly; Soumya,7,0,32,25
1657176992493,MATH 20E,A02,083772,Ganguly; Soumya,7,0,32,25
1657176992493,MATH 20E,B01,083773,Ciotti; Benjamin,19,0,35,16
1657176992493,MATH 20E,B02,083774,Ciotti; Benjamin,17,0,35,18
1657176998522,MATH 103A,A01,083777,Greenfeld; Be'Eri,2,0,36,34
1657176998522,MATH 103A,A02,083778,Greenfeld; Be'Eri,5,0,36,31
1657176998522,MATH 103A,A03,093561,Greenfeld; Be'Eri,4,0,36,32
1657176998522,MATH 103A,B01,083779,Greenfeld; Be'Eri,6,0,36,30
1657176998522,MATH 103A,B02,083780,Greenfeld; Be'Eri,3,0,36,33
1657176998522,MATH 103A,B03,093562,Greenfeld; Be'Eri,3,0,36,33
1657177004549,MATH 105,A01,085443,Carter; Anne Toulson,14,0,35,21
1657177004549,MATH 105,A02,093477,Carter; Anne Toulson,20,0,35,15
1657177010573,MATH 109,A01,083213,Ganzberger; Geoffrey Michael,2,0,34,32
1657177010573,MATH 109,A02,083214,Ganzberger; Geoffrey Michael,3,0,34,31
1657177010573,MATH 109,A03,093478,Ganzberger; Geoffrey Michael,1,0,34,33
1657177010573,MATH 109,B01,083215,Ganzberger; Geoffrey Michael,1,0,32,31
1657177010573,MATH 109,B02,083216,Ganzberger; Geoffrey Michael,1,0,32,31
1657177010573,MATH 109,B03,093479,Ganzberger; Geoffrey Michael,6,0,32,26
1657177016598,MATH 142A,A01,083219,Chow; Bennett,6,0,32,26
1657177016598,MATH 142A,A02,083220,Chow; Bennett,10,0,32,22
1657177016598,MATH 142A,A03,093480,Chow; Bennett,7,0,32,25
1657177016598,MATH 142A,B03,093481,Chow; Bennett,8,0,32,24
1657177016598,MATH 142A,B04,093558,Chow; Bennett,11,0,32,21
1657177016598,MATH 142A,B05,093559,Chow; Bennett,6,0,32,26
1657177022634,MATH 193A,A01,083224,Rotar; Vladimir,7,0,34,27
1657177022634,MATH 193A,A02,083225,Rotar; Vladimir,5,0,34,29
1657177022634,MATH 193A,A03,083781,Rotar; Vladimir,1,0,34,33
1657177022634,MATH 193A,A04,083782,Rotar; Vladimir,8,0,34,26
1657177022634,MATH 193A,A05,093482,Rotar; Vladimir,6,0,34,28
1657177028656,MATH 197,001,091859,McAuley; Julian John,9999,0,9999,0
1657177028656,MATH 197,002,095566,Kedlaya; Kiran S.,9997,0,9999,2
1657177028656,MATH 197,003,095567,Xiao; Ming,9999,0,9999,0
1657177028656,MATH 197,004,095571,Perols; Johan Lars,9998,0,9999,1
1657177035726,COGS 9,A01,083615,Shannon; Kyle Michael,7,0,75,68
1657177041756,COGS 11,A01,083617,Boyle; Mary E. T.,22,0,48,26
1657177047779,COGS 13,A01,083071,Bastos; Amalia Pinkusfeld,9,0,71,62
1657177053802,COGS 14A,A01,092681,Semenuks; Arturs,1,1,100,99
1657177059827,COGS 14B,A01,083073,Cheng; Tzu-Han,6,0,63,57
1657177065853,COGS 17,A01,092677,Semenuks; Arturs,4,0,81,77
1657177071881,COGS 100,A01,083619,Allen; Michael Gordon,15,0,70,55
1657177077916,COGS 101A,A01,083621,Davis; Joshua Daniel,9,0,68,59
1657177083941,COGS 101B,A01,091572,Allen; Michael Gordon,9,0,65,56
1657177089972,COGS 101C,A01,083625,Delgado; Tania,17,0,35,18
1657177095994,COGS 107A,A01,083627,Boyle; Mary E. T.,13,0,60,47
1657177102019,COGS 118A,A01,083075,Gupta; Anjum,16,0,76,60
1657177108053,CSE 3,A50,083646,Miranda; Gregory Joseph,24,0,50,26
1657177114079,CSE 8A,A50,083650,Miranda; Gregory Joseph,17,1,56,39
1657177120103,CSE 11,A01,083080,Cao; Yingjun,5,15,40,35
1657177126126,CSE 12,A01,083652,Krause-Levy; Sophia Louisa,24,1,120,96
1657177132152,CSE 15L,A01,083654,Morris; Justin Loren,9,0,50,41
1657177132152,CSE 15L,A02,083655,Morris; Justin Loren,9,0,50,41
1657177138179,CSE 20,A01,083657,Tran; Khoa Dang,38,0,80,42
1657177144202,CSE 21,A01,095574,Bach; Quang Tran,22,0,48,26
1657177150226,CSE 30,A01,083084,Eldon; John,4,0,80,76
1657177150226,CSE 30,B01,095061,Bhaskar; Nishant,7,0,50,43
1657177156250,CSE 100,A01,083659,Cao; Yingjun,4,4,70,66
1657177162280,CSE 134B,A01,083661,Powell; Thomas Allan,20,0,100,80
1657177168308,CSE 140,A01,083663,Gungor; Onat,13,0,85,72
1657177174340,CSE 140L,A01,083088,Eldon; John,17,0,100,83
1657177180365,CSE 175,A01,083665,Kumar; Rakesh,3,0,25,22
1657177186392,CSE 190,A00,092507,Dubnov; Shlomo,7,0,20,13
1657177192416,ECE 45,A01,083139,Congero; Spencer William,5,0,75,70
1657177198439,ECE 65,A50,083695,Saad; Andrew S,12,0,30,18
1657177198439,ECE 65,A51,095125,Saad; Andrew S,25,0,26,1
1657177204461,ECE 109,A01,091882,Touri; Behrouz,19,0,70,51
1657177210498,ECE 180,A00,083140,Abi Samra; Nicholas Camill,1,0,30,29
1657177210498,ECE 180,B00,083141,Abi Samra; Nicholas Camill,0,0,30,30
1657177216527,MATH 10A,A01,083735,Patchell; Gregory David,2,0,30,28
1657177216527,MATH 10A,A02,083736,Patchell; Gregory David,20,0,30,10
1657177216527,MATH 10A,A03,083737,Patchell; Gregory David,16,0,30,14
1657177222579,MATH 10B,A01,083207,Lim; Seonhee,7,0,34,27
1657177222579,MATH 10B,A02,083208,Lim; Seonhee,9,0,35,26
1657177222579,MATH 10B,A03,093472,Lim; Seonhee,5,0,34,29
1657177222579,MATH 10B,B01,083739,Sinha; Shubham,10,0,30,20
1657177228614,MATH 18,A01,083743,Cinel; Cameron Alexander,6,0,30,24
1657177228614,MATH 18,A02,083744,Cinel; Cameron Alexander,15,0,30,15
1657177228614,MATH 18,A03,083745,Cinel; Cameron Alexander,8,0,30,22
1657177228614,MATH 18,B01,083748,Rideout; David Porter,4,0,37,33
1657177228614,MATH 18,B02,083749,Rideout; David Porter,4,0,36,32
1657177228614,MATH 18,B03,083750,Rideout; David Porter,2,0,37,35
1657177228614,MATH 18,B04,083751,Rideout; David Porter,5,0,36,31
1657177228614,MATH 18,B05,093473,Rideout; David Porter,5,0,36,31
1657177228614,MATH 18,B06,093474,Rideout; David Porter,5,0,36,31
1657177234636,MATH 20A,A01,083754,Zheng; Zequn,13,0,40,27
1657177240661,MATH 20B,A01,083756,Briones; Jor-el Thomas Caparas,1,0,36,35
1657177240661,MATH 20B,A02,083757,Briones; Jor-el Thomas Caparas,1,0,36,35
1657177240661,MATH 20B,A03,093475,Briones; Jor-el Thomas Caparas,1,0,36,35
1657177246684,MATH 20C,A01,083760,Briones; Jor-el Thomas Caparas,1,0,35,34
1657177246684,MATH 20C,A02,083761,Briones; Jor-el Thomas Caparas,8,0,35,27
1657177246684,MATH 20C,A03,093476,Briones; Jor-el Thomas Caparas,0,1,36,36
1657177246684,MATH 20C,B01,083762,Bach; Quang Tran,1,0,30,29
1657177252707,MATH 20D,A01,083765,Tran; Brian Kha,4,0,30,26
1657177252707,MATH 20D,A02,083766,Tran; Brian Kha,5,0,30,25
1657177252707,MATH 20D,A03,083767,Tran; Brian Kha,4,0,30,26
1657177258737,MATH 20E,A01,083771,Ganguly; Soumya,7,0,32,25
1657177258737,MATH 20E,A02,083772,Ganguly; Soumya,7,0,32,25
1657177258737,MATH 20E,B01,083773,Ciotti; Benjamin,19,0,35,16
1657177258737,MATH 20E,B02,083774,Ciotti; Benjamin,17,0,35,18
1657177264762,MATH 103A,A01,083777,Greenfeld; Be'Eri,2,0,36,34
1657177264762,MATH 103A,A02,083778,Greenfeld; Be'Eri,5,0,36,31
1657177264762,MATH 103A,A03,093561,Greenfeld; Be'Eri,4,0,36,32
1657177264762,MATH 103A,B01,083779,Greenfeld; Be'Eri,6,0,36,30
1657177264762,MATH 103A,B02,083780,Greenfeld; Be'Eri,3,0,36,33
1657177264762,MATH 103A,B03,093562,Greenfeld; Be'Eri,3,0,36,33
1657177270792,MATH 105,A01,085443,Carter; Anne Toulson,14,0,35,21
1657177270792,MATH 105,A02,093477,Carter; Anne Toulson,20,0,35,15
1657177276818,MATH 109,A01,083213,Ganzberger; Geoffrey Michael,2,0,34,32
1657177276818,MATH 109,A02,083214,Ganzberger; Geoffrey Michael,3,0,34,31
1657177276818,MATH 109,A03,093478,Ganzberger; Geoffrey Michael,1,0,34,33
1657177276818,MATH 109,B01,083215,Ganzberger; Geoffrey Michael,1,0,32,31
1657177276818,MATH 109,B02,083216,Ganzberger; Geoffrey Michael,1,0,32,31
1657177276818,MATH 109,B03,093479,Ganzberger; Geoffrey Michael,6,0,32,26
1657177282849,MATH 142A,A01,083219,Chow; Bennett,6,0,32,26
1657177282849,MATH 142A,A02,083220,Chow; Bennett,10,0,32,22
1657177282849,MATH 142A,A03,093480,Chow; Bennett,7,0,32,25
1657177282849,MATH 142A,B03,093481,Chow; Bennett,8,0,32,24
1657177282849,MATH 142A,B04,093558,Chow; Bennett,11,0,32,21
1657177282849,MATH 142A,B05,093559,Chow; Bennett,6,0,32,26
1657177288873,MATH 193A,A01,083224,Rotar; Vladimir,7,0,34,27
1657177288873,MATH 193A,A02,083225,Rotar; Vladimir,5,0,34,29
1657177288873,MATH 193A,A03,083781,Rotar; Vladimir,1,0,34,33
1657177288873,MATH 193A,A04,083782,Rotar; Vladimir,8,0,34,26
1657177288873,MATH 193A,A05,093482,Rotar; Vladimir,6,0,34,28
1657177294896,MATH 197,001,091859,McAuley; Julian John,9999,0,9999,0
1657177294896,MATH 197,002,095566,Kedlaya; Kiran S.,9997,0,9999,2
1657177294896,MATH 197,003,095567,Xiao; Ming,9999,0,9999,0
1657177294896,MATH 197,004,095571,Perols; Johan Lars,9998,0,9999,1
1657177302058,COGS 9,A01,083615,Shannon; Kyle Michael,7,0,75,68
1657177308098,COGS 11,A01,083617,Boyle; Mary E. T.,22,0,48,26
1657177314127,COGS 13,A01,083071,Bastos; Amalia Pinkusfeld,9,0,71,62
1657177320152,COGS 14A,A01,092681,Semenuks; Arturs,1,1,100,99
1657177326182,COGS 14B,A01,083073,Cheng; Tzu-Han,6,0,63,57
1657177332218,COGS 17,A01,092677,Semenuks; Arturs,4,0,81,77
1657177338261,COGS 100,A01,083619,Allen; Michael Gordon,15,0,70,55
1657177344289,COGS 101A,A01,083621,Davis; Joshua Daniel,9,0,68,59
1657177350312,COGS 101B,A01,091572,Allen; Michael Gordon,9,0,65,56
1657177356335,COGS 101C,A01,083625,Delgado; Tania,17,0,35,18
1657177362360,COGS 107A,A01,083627,Boyle; Mary E. T.,13,0,60,47
1657177368385,COGS 118A,A01,083075,Gupta; Anjum,16,0,76,60
1657177374410,CSE 3,A50,083646,Miranda; Gregory Joseph,24,0,50,26
1657177380440,CSE 8A,A50,083650,Miranda; Gregory Joseph,17,1,56,39
1657177386471,CSE 11,A01,083080,Cao; Yingjun,5,15,40,35
1657177392497,CSE 12,A01,083652,Krause-Levy; Sophia Louisa,24,1,120,96
1657177398525,CSE 15L,A01,083654,Morris; Justin Loren,9,0,50,41
1657177398525,CSE 15L,A02,083655,Morris; Justin Loren,9,0,50,41
1657177404548,CSE 20,A01,083657,Tran; Khoa Dang,38,0,80,42
1657177410570,CSE 21,A01,095574,Bach; Quang Tran,22,0,48,26
1657177416597,CSE 30,A01,083084,Eldon; John,4,0,80,76
1657177416597,CSE 30,B01,095061,Bhaskar; Nishant,7,0,50,43
1657177422623,CSE 100,A01,083659,Cao; Yingjun,4,4,70,66
1657177428646,CSE 134B,A01,083661,Powell; Thomas Allan,20,0,100,80
1657177434674,CSE 140,A01,083663,Gungor; Onat,13,0,85,72
1657177440697,CSE 140L,A01,083088,Eldon; John,17,0,100,83
1657177446720,CSE 175,A01,083665,Kumar; Rakesh,3,0,25,22
1657177452754,CSE 190,A00,092507,Dubnov; Shlomo,7,0,20,13
1657177458777,ECE 45,A01,083139,Congero; Spencer William,5,0,75,70
1657177464808,ECE 65,A50,083695,Saad; Andrew S,12,0,30,18
1657177464808,ECE 65,A51,095125,Saad; Andrew S,25,0,26,1
1657177470830,ECE 109,A01,091882,Touri; Behrouz,19,0,70,51
1657177476858,ECE 180,A00,083140,Abi Samra; Nicholas Camill,1,0,30,29
1657177476858,ECE 180,B00,083141,Abi Samra; Nicholas Camill,0,0,30,30
1657177482881,MATH 10A,A01,083735,Patchell; Gregory David,2,0,30,28
1657177482881,MATH 10A,A02,083736,Patchell; Gregory David,20,0,30,10
1657177482881,MATH 10A,A03,083737,Patchell; Gregory David,16,0,30,14
1657177488906,MATH 10B,A01,083207,Lim; Seonhee,7,0,34,27
1657177488906,MATH 10B,A02,083208,Lim; Seonhee,9,0,35,26
1657177488906,MATH 10B,A03,093472,Lim; Seonhee,5,0,34,29
1657177488906,MATH 10B,B01,083739,Sinha; Shubham,10,0,30,20
1657177494938,MATH 18,A01,083743,Cinel; Cameron Alexander,6,0,30,24
1657177494938,MATH 18,A02,083744,Cinel; Cameron Alexander,15,0,30,15
1657177494938,MATH 18,A03,083745,Cinel; Cameron Alexander,8,0,30,22
1657177494938,MATH 18,B01,083748,Rideout; David Porter,4,0,37,33
1657177494938,MATH 18,B02,083749,Rideout; David Porter,4,0,36,32
1657177494938,MATH 18,B03,083750,Rideout; David Porter,2,0,37,35
1657177494938,MATH 18,B04,083751,Rideout; David Porter,5,0,36,31
1657177494938,MATH 18,B05,093473,Rideout; David Porter,5,0,36,31
1657177494938,MATH 18,B06,093474,Rideout; David Porter,5,0,36,31
1657177500964,MATH 20A,A01,083754,Zheng; Zequn,13,0,40,27
1657177506991,MATH 20B,A01,083756,Briones; Jor-el Thomas Caparas,1,0,36,35
1657177506991,MATH 20B,A02,083757,Briones; Jor-el Thomas Caparas,1,0,36,35
1657177506991,MATH 20B,A03,093475,Briones; Jor-el Thomas Caparas,1,0,36,35
1657177513016,MATH 20C,A01,083760,Briones; Jor-el Thomas Caparas,1,0,35,34
1657177513016,MATH 20C,A02,083761,Briones; Jor-el Thomas Caparas,8,0,35,27
1657177513016,MATH 20C,A03,093476,Briones; Jor-el Thomas Caparas,0,1,36,36
1657177513016,MATH 20C,B01,083762,Bach; Quang Tran,1,0,30,29
1657177519038,MATH 20D,A01,083765,Tran; Brian Kha,4,0,30,26
1657177519038,MATH 20D,A02,083766,Tran; Brian Kha,5,0,30,25
1657177519038,MATH 20D,A03,083767,Tran; Brian Kha,4,0,30,26
1657177525061,MATH 20E,A01,083771,Ganguly; Soumya,7,0,32,25
1657177525061,MATH 20E,A02,083772,Ganguly; Soumya,7,0,32,25
1657177525061,MATH 20E,B01,083773,Ciotti; Benjamin,19,0,35,16
1657177525061,MATH 20E,B02,083774,Ciotti; Benjamin,17,0,35,18
1657177531091,MATH 103A,A01,083777,Greenfeld; Be'Eri,2,0,36,34
1657177531091,MATH 103A,A02,083778,Greenfeld; Be'Eri,5,0,36,31
1657177531091,MATH 103A,A03,093561,Greenfeld; Be'Eri,4,0,36,32
1657177531091,MATH 103A,B01,083779,Greenfeld; Be'Eri,6,0,36,30
1657177531091,MATH 103A,B02,083780,Greenfeld; Be'Eri,3,0,36,33
1657177531091,MATH 103A,B03,093562,Greenfeld; Be'Eri,3,0,36,33
1657177537128,MATH 105,A01,085443,Carter; Anne Toulson,14,0,35,21
1657177537128,MATH 105,A02,093477,Carter; Anne Toulson,20,0,35,15
1657177543160,MATH 109,A01,083213,Ganzberger; Geoffrey Michael,2,0,34,32
1657177543160,MATH 109,A02,083214,Ganzberger; Geoffrey Michael,3,0,34,31
1657177543160,MATH 109,A03,093478,Ganzberger; Geoffrey Michael,1,0,34,33
1657177543160,MATH 109,B01,083215,Ganzberger; Geoffrey Michael,1,0,32,31
1657177543160,MATH 109,B02,083216,Ganzberger; Geoffrey Michael,1,0,32,31
1657177543160,MATH 109,B03,093479,Ganzberger; Geoffrey Michael,6,0,32,26
1657177549188,MATH 142A,A01,083219,Chow; Bennett,6,0,32,26
1657177549188,MATH 142A,A02,083220,Chow; Bennett,10,0,32,22
1657177549188,MATH 142A,A03,093480,Chow; Bennett,7,0,32,25
1657177549188,MATH 142A,B03,093481,Chow; Bennett,8,0,32,24
1657177549188,MATH 142A,B04,093558,Chow; Bennett,11,0,32,21
1657177549188,MATH 142A,B05,093559,Chow; Bennett,6,0,32,26
1657177555213,MATH 193A,A01,083224,Rotar; Vladimir,7,0,34,27
1657177555213,MATH 193A,A02,083225,Rotar; Vladimir,5,0,34,29
1657177555213,MATH 193A,A03,083781,Rotar; Vladimir,1,0,34,33
1657177555213,MATH 193A,A04,083782,Rotar; Vladimir,8,0,34,26
1657177555213,MATH 193A,A05,093482,Rotar; Vladimir,6,0,34,28
1657177561241,MATH 197,001,091859,McAuley; Julian John,9999,0,9999,0
1657177561241,MATH 197,002,095566,Kedlaya; Kiran S.,9997,0,9999,2
1657177561241,MATH 197,003,095567,Xiao; Ming,9999,0,9999,0
1657177561241,MATH 197,004,095571,Perols; Johan Lars,9998,0,9999,1
1657177568308,COGS 9,A01,083615,Shannon; Kyle Michael,7,0,75,68
1657177574333,COGS 11,A01,083617,Boyle; Mary E. T.,22,0,48,26
1657177580362,COGS 13,A01,083071,Bastos; Amalia Pinkusfeld,9,0,71,62
1657177586389,COGS 14A,A01,092681,Semenuks; Arturs,1,1,100,99
1657177592414,COGS 14B,A01,083073,Cheng; Tzu-Han,6,0,63,57
1657177598445,COGS 17,A01,092677,Semenuks; Arturs,4,0,81,77
1657177604471,COGS 100,A01,083619,Allen; Michael Gordon,15,0,70,55
1657177610496,COGS 101A,A01,083621,Davis; Joshua Daniel,9,0,68,59
1657177616526,COGS 101B,A01,091572,Allen; Michael Gordon,9,0,65,56
1657177622550,COGS 101C,A01,083625,Delgado; Tania,17,0,35,18
1657177628581,COGS 107A,A01,083627,Boyle; Mary E. T.,13,0,60,47
1657177634609,COGS 118A,A01,083075,Gupta; Anjum,16,0,76,60
1657177640634,CSE 3,A50,083646,Miranda; Gregory Joseph,24,0,50,26
1657177646665,CSE 8A,A50,083650,Miranda; Gregory Joseph,17,1,56,39
1657177652693,CSE 11,A01,083080,Cao; Yingjun,5,15,40,35
1657177658720,CSE 12,A01,083652,Krause-Levy; Sophia Louisa,24,1,120,96
1657177664764,CSE 15L,A01,083654,Morris; Justin Loren,9,0,50,41
1657177664764,CSE 15L,A02,083655,Morris; Justin Loren,9,0,50,41
1657177670791,CSE 20,A01,083657,Tran; Khoa Dang,38,0,80,42
1657177676836,CSE 21,A01,095574,Bach; Quang Tran,22,0,48,26
1657177682869,CSE 30,A01,083084,Eldon; John,4,0,80,76
1657177682869,CSE 30,B01,095061,Bhaskar; Nishant,7,0,50,43
1657177688896,CSE 100,A01,083659,Cao; Yingjun,4,4,70,66
1657177694920,CSE 134B,A01,083661,Powell; Thomas Allan,20,0,100,80
1657177700944,CSE 140,A01,083663,Gungor; Onat,13,0,85,72
1657177706972,CSE 140L,A01,083088,Eldon; John,17,0,100,83
1657177712995,CSE 175,A01,083665,Kumar; Rakesh,3,0,25,22
1657177719018,CSE 190,A00,092507,Dubnov; Shlomo,7,0,20,13
1657177725041,ECE 45,A01,083139,Congero; Spencer William,5,0,75,70
1657177731064,ECE 65,A50,083695,Saad; Andrew S,12,0,30,18
1657177731064,ECE 65,A51,095125,Saad; Andrew S,25,0,26,1
1657177737087,ECE 109,A01,091882,Touri; Behrouz,19,0,70,51
1657177743115,ECE 180,A00,083140,Abi Samra; Nicholas Camill,1,0,30,29
1657177743115,ECE 180,B00,083141,Abi Samra; Nicholas Camill,0,0,30,30
1657177749138,MATH 10A,A01,083735,Patchell; Gregory David,2,0,30,28
1657177749138,MATH 10A,A02,083736,Patchell; Gregory David,20,0,30,10
1657177749138,MATH 10A,A03,083737,Patchell; Gregory David,16,0,30,14
1657177755170,MATH 10B,A01,083207,Lim; Seonhee,7,0,34,27
1657177755170,MATH 10B,A02,083208,Lim; Seonhee,9,0,35,26
1657177755170,MATH 10B,A03,093472,Lim; Seonhee,5,0,34,29
1657177755170,MATH 10B,B01,083739,Sinha; Shubham,10,0,30,20
1657177761201,MATH 18,A01,083743,Cinel; Cameron Alexander,6,0,30,24
1657177761201,MATH 18,A02,083744,Cinel; Cameron Alexander,15,0,30,15
1657177761201,MATH 18,A03,083745,Cinel; Cameron Alexander,8,0,30,22
1657177761201,MATH 18,B01,083748,Rideout; David Porter,4,0,37,33
1657177761201,MATH 18,B02,083749,Rideout; David Porter,4,0,36,32
1657177761201,MATH 18,B03,083750,Rideout; David Porter,2,0,37,35
1657177761201,MATH 18,B04,083751,Rideout; David Porter,5,0,36,31
1657177761201,MATH 18,B05,093473,Rideout; David Porter,5,0,36,31
1657177761201,MATH 18,B06,093474,Rideout; David Porter,5,0,36,31
1657177767237,MATH 20A,A01,083754,Zheng; Zequn,13,0,40,27
1657177773273,MATH 20B,A01,083756,Briones; Jor-el Thomas Caparas,1,0,36,35
1657177773273,MATH 20B,A02,083757,Briones; Jor-el Thomas Caparas,1,0,36,35
1657177773273,MATH 20B,A03,093475,Briones; Jor-el Thomas Caparas,1,0,36,35
1657177779298,MATH 20C,A01,083760,Briones; Jor-el Thomas Caparas,1,0,35,34
1657177779298,MATH 20C,A02,083761,Briones; Jor-el Thomas Caparas,8,0,35,27
1657177779298,MATH 20C,A03,093476,Briones; Jor-el Thomas Caparas,0,1,36,36
1657177779298,MATH 20C,B01,083762,Bach; Quang Tran,1,0,30,29
1657177785329,MATH 20D,A01,083765,Tran; Brian Kha,4,0,30,26
1657177785329,MATH 20D,A02,083766,Tran; Brian Kha,5,0,30,25
1657177785329,MATH 20D,A03,083767,Tran; Brian Kha,4,0,30,26
1657177791353,MATH 20E,A01,083771,Ganguly; Soumya,7,0,32,25
1657177791353,MATH 20E,A02,083772,Ganguly; Soumya,7,0,32,25
1657177791353,MATH 20E,B01,083773,Ciotti; Benjamin,19,0,35,16
1657177791353,MATH 20E,B02,083774,Ciotti; Benjamin,17,0,35,18
1657177797384,MATH 103A,A01,083777,Greenfeld; Be'Eri,2,0,36,34
1657177797384,MATH 103A,A02,083778,Greenfeld; Be'Eri,5,0,36,31
1657177797384,MATH 103A,A03,093561,Greenfeld; Be'Eri,4,0,36,32
1657177797384,MATH 103A,B01,083779,Greenfeld; Be'Eri,6,0,36,30
1657177797384,MATH 103A,B02,083780,Greenfeld; Be'Eri,3,0,36,33
1657177797384,MATH 103A,B03,093562,Greenfeld; Be'Eri,3,0,36,33
1657177803407,MATH 105,A01,085443,Carter; Anne Toulson,14,0,35,21
1657177803407,MATH 105,A02,093477,Carter; Anne Toulson,20,0,35,15
1657177809437,MATH 109,A01,083213,Ganzberger; Geoffrey Michael,2,0,34,32
1657177809437,MATH 109,A02,083214,Ganzberger; Geoffrey Michael,3,0,34,31
1657177809437,MATH 109,A03,093478,Ganzberger; Geoffrey Michael,1,0,34,33
1657177809437,MATH 109,B01,083215,Ganzberger; Geoffrey Michael,1,0,32,31
1657177809437,MATH 109,B02,083216,Ganzberger; Geoffrey Michael,1,0,32,31
1657177809437,MATH 109,B03,093479,Ganzberger; Geoffrey Michael,6,0,32,26
1657177815468,MATH 142A,A01,083219,Chow; Bennett,6,0,32,26
1657177815468,MATH 142A,A02,083220,Chow; Bennett,10,0,32,22
1657177815468,MATH 142A,A03,093480,Chow; Bennett,7,0,32,25
1657177815468,MATH 142A,B03,093481,Chow; Bennett,8,0,32,24
1657177815468,MATH 142A,B04,093558,Chow; Bennett,11,0,32,21
1657177815468,MATH 142A,B05,093559,Chow; Bennett,6,0,32,26
1657177821492,MATH 193A,A01,083224,Rotar; Vladimir,7,0,34,27
1657177821492,MATH 193A,A02,083225,Rotar; Vladimir,5,0,34,29
1657177821492,MATH 193A,A03,083781,Rotar; Vladimir,1,0,34,33
1657177821492,MATH 193A,A04,083782,Rotar; Vladimir,8,0,34,26
1657177821492,MATH 193A,A05,093482,Rotar; Vladimir,6,0,34,28
1657177827516,MATH 197,001,091859,McAuley; Julian John,9999,0,9999,0
1657177827516,MATH 197,002,095566,Kedlaya; Kiran S.,9997,0,9999,2
1657177827516,MATH 197,003,095567,Xiao; Ming,9999,0,9999,0
1657177827516,MATH 197,004,095571,Perols; Johan Lars,9998,0,9999,1
1657177834585,COGS 9,A01,083615,Shannon; Kyle Michael,7,0,75,68
1657177840608,COGS 11,A01,083617,Boyle; Mary E. T.,22,0,48,26
1657177846636,COGS 13,A01,083071,Bastos; Amalia Pinkusfeld,9,0,71,62
1657177852660,COGS 14A,A01,092681,Semenuks; Arturs,1,1,100,99
1657177858688,COGS 14B,A01,083073,Cheng; Tzu-Han,6,0,63,57
1657177864714,COGS 17,A01,092677,Semenuks; Arturs,4,0,81,77
1657177870736,COGS 100,A01,083619,Allen; Michael Gordon,15,0,70,55
1657177876768,COGS 101A,A01,083621,Davis; Joshua Daniel,9,0,68,59
1657177882798,COGS 101B,A01,091572,Allen; Michael Gordon,9,0,65,56
1657177888828,COGS 101C,A01,083625,Delgado; Tania,17,0,35,18
1657177894852,COGS 107A,A01,083627,Boyle; Mary E. T.,13,0,60,47
1657177900993,COGS 118A,A01,083075,Gupta; Anjum,16,0,76,60
1657177907024,CSE 3,A50,083646,Miranda; Gregory Joseph,24,0,50,26
1657177913059,CSE 8A,A50,083650,Miranda; Gregory Joseph,17,1,56,39
1657177919084,CSE 11,A01,083080,Cao; Yingjun,5,15,40,35
1657177925108,CSE 12,A01,083652,Krause-Levy; Sophia Louisa,24,1,120,96
1657177931140,CSE 15L,A01,083654,Morris; Justin Loren,9,0,50,41
1657177931140,CSE 15L,A02,083655,Morris; Justin Loren,9,0,50,41
1657177937165,CSE 20,A01,083657,Tran; Khoa Dang,38,0,80,42
1657177943189,CSE 21,A01,095574,Bach; Quang Tran,22,0,48,26
1657177949226,CSE 30,A01,083084,Eldon; John,4,0,80,76
1657177949226,CSE 30,B01,095061,Bhaskar; Nishant,7,0,50,43
1657177955261,CSE 100,A01,083659,Cao; Yingjun,4,4,70,66
1657177961284,CSE 134B,A01,083661,Powell; Thomas Allan,20,0,100,80
1657177967316,CSE 140,A01,083663,Gungor; Onat,13,0,85,72
1657177973339,CSE 140L,A01,083088,Eldon; John,17,0,100,83
1657177979363,CSE 175,A01,083665,Kumar; Rakesh,3,0,25,22
1657177985387,CSE 190,A00,092507,Dubnov; Shlomo,7,0,20,13
1657177991410,ECE 45,A01,083139,Congero; Spencer William,5,0,75,70
1657177997434,ECE 65,A50,083695,Saad; Andrew S,12,0,30,18
1657177997434,ECE 65,A51,095125,Saad; Andrew S,25,0,26,1
1657178003459,ECE 109,A01,091882,Touri; Behrouz,19,0,70,51
1657178009492,ECE 180,A00,083140,Abi Samra; Nicholas Camill,1,0,30,29
1657178009492,ECE 180,B00,083141,Abi Samra; Nicholas Camill,0,0,30,30
1657178015517,MATH 10A,A01,083735,Patchell; Gregory David,2,0,30,28
1657178015517,MATH 10A,A02,083736,Patchell; Gregory David,20,0,30,10
1657178015517,MATH 10A,A03,083737,Patchell; Gregory David,16,0,30,14
1657178021543,MATH 10B,A01,083207,Lim; Seonhee,7,0,34,27
1657178021543,MATH 10B,A02,083208,Lim; Seonhee,9,0,35,26
1657178021543,MATH 10B,A03,093472,Lim; Seonhee,5,0,34,29
1657178021543,MATH 10B,B01,083739,Sinha; Shubham,10,0,30,20
1657178027567,MATH 18,A01,083743,Cinel; Cameron Alexander,6,0,30,24
1657178027567,MATH 18,A02,083744,Cinel; Cameron Alexander,15,0,30,15
1657178027567,MATH 18,A03,083745,Cinel; Cameron Alexander,8,0,30,22
1657178027567,MATH 18,B01,083748,Rideout; David Porter,4,0,37,33
1657178027567,MATH 18,B02,083749,Rideout; David Porter,4,0,36,32
1657178027567,MATH 18,B03,083750,Rideout; David Porter,2,0,37,35
1657178027567,MATH 18,B04,083751,Rideout; David Porter,5,0,36,31
1657178027567,MATH 18,B05,093473,Rideout; David Porter,5,0,36,31
1657178027567,MATH 18,B06,093474,Rideout; David Porter,5,0,36,31
1657178033599,MATH 20A,A01,083754,Zheng; Zequn,13,0,40,27
1657178039632,MATH 20B,A01,083756,Briones; Jor-el Thomas Caparas,1,0,36,35
1657178039632,MATH 20B,A02,083757,Briones; Jor-el Thomas Caparas,1,0,36,35
1657178039632,MATH 20B,A03,093475,Briones; Jor-el Thomas Caparas,1,0,36,35
1657178045666,MATH 20C,A01,083760,Briones; Jor-el Thomas Caparas,1,0,35,34
1657178045666,MATH 20C,A02,083761,Briones; Jor-el Thomas Caparas,8,0,35,27
1657178045666,MATH 20C,A03,093476,Briones; Jor-el Thomas Caparas,0,1,36,36
1657178045666,MATH 20C,B01,083762,Bach; Quang Tran,1,0,30,29
1657178051691,MATH 20D,A01,083765,Tran; Brian Kha,4,0,30,26
1657178051691,MATH 20D,A02,083766,Tran; Brian Kha,5,0,30,25
1657178051691,MATH 20D,A03,083767,Tran; Brian Kha,4,0,30,26
1657178057729,MATH 20E,A01,083771,Ganguly; Soumya,7,0,32,25
1657178057729,MATH 20E,A02,083772,Ganguly; Soumya,7,0,32,25
1657178057729,MATH 20E,B01,083773,Ciotti; Benjamin,19,0,35,16
1657178057729,MATH 20E,B02,083774,Ciotti; Benjamin,17,0,35,18
1657178063768,MATH 103A,A01,083777,Greenfeld; Be'Eri,2,0,36,34
1657178063768,MATH 103A,A02,083778,Greenfeld; Be'Eri,5,0,36,31
1657178063768,MATH 103A,A03,093561,Greenfeld; Be'Eri,4,0,36,32
1657178063768,MATH 103A,B01,083779,Greenfeld; Be'Eri,6,0,36,30
1657178063768,MATH 103A,B02,083780,Greenfeld; Be'Eri,3,0,36,33
1657178063768,MATH 103A,B03,093562,Greenfeld; Be'Eri,3,0,36,33
1657178069792,MATH 105,A01,085443,Carter; Anne Toulson,14,0,35,21
1657178069792,MATH 105,A02,093477,Carter; Anne Toulson,20,0,35,15
1657178075823,MATH 109,A01,083213,Ganzberger; Geoffrey Michael,2,0,34,32
1657178075823,MATH 109,A02,083214,Ganzberger; Geoffrey Michael,3,0,34,31
1657178075823,MATH 109,A03,093478,Ganzberger; Geoffrey Michael,1,0,34,33
1657178075823,MATH 109,B01,083215,Ganzberger; Geoffrey Michael,1,0,32,31
1657178075823,MATH 109,B02,083216,Ganzberger; Geoffrey Michael,1,0,32,31
1657178075823,MATH 109,B03,093479,Ganzberger; Geoffrey Michael,6,0,32,26
1657178081859,MATH 142A,A01,083219,Chow; Bennett,6,0,32,26
1657178081859,MATH 142A,A02,083220,Chow; Bennett,10,0,32,22
1657178081859,MATH 142A,A03,093480,Chow; Bennett,7,0,32,25
1657178081859,MATH 142A,B03,093481,Chow; Bennett,8,0,32,24
1657178081859,MATH 142A,B04,093558,Chow; Bennett,11,0,32,21
1657178081859,MATH 142A,B05,093559,Chow; Bennett,6,0,32,26
1657178087884,MATH 193A,A01,083224,Rotar; Vladimir,7,0,34,27
1657178087884,MATH 193A,A02,083225,Rotar; Vladimir,5,0,34,29
1657178087884,MATH 193A,A03,083781,Rotar; Vladimir,1,0,34,33
1657178087884,MATH 193A,A04,083782,Rotar; Vladimir,8,0,34,26
1657178087884,MATH 193A,A05,093482,Rotar; Vladimir,6,0,34,28
1657178093915,MATH 197,001,091859,McAuley; Julian John,9999,0,9999,0
1657178093915,MATH 197,002,095566,Kedlaya; Kiran S.,9997,0,9999,2
1657178093915,MATH 197,003,095567,Xiao; Ming,9999,0,9999,0
1657178093915,MATH 197,004,095571,Perols; Johan Lars,9998,0,9999,1
1657178100976,COGS 9,A01,083615,Shannon; Kyle Michael,7,0,75,68
1657178106999,COGS 11,A01,083617,Boyle; Mary E. T.,22,0,48,26
1657178113024,COGS 13,A01,083071,Bastos; Amalia Pinkusfeld,9,0,71,62
1657178119060,COGS 14A,A01,092681,Semenuks; Arturs,1,1,100,99
1657178125088,COGS 14B,A01,083073,Cheng; Tzu-Han,6,0,63,57
1657178131113,COGS 17,A01,092677,Semenuks; Arturs,4,0,81,77
1657178137150,COGS 100,A01,083619,Allen; Michael Gordon,15,0,70,55
1657178143181,COGS 101A,A01,083621,Davis; Joshua Daniel,9,0,68,59
1657178149208,COGS 101B,A01,091572,Allen; Michael Gordon,9,0,65,56
1657178155235,COGS 101C,A01,083625,Delgado; Tania,17,0,35,18
1657178161267,COGS 107A,A01,083627,Boyle; Mary E. T.,13,0,60,47
1657178167298,COGS 118A,A01,083075,Gupta; Anjum,16,0,76,60
1657178173323,CSE 3,A50,083646,Miranda; Gregory Joseph,24,0,50,26
1657178179355,CSE 8A,A50,083650,Miranda; Gregory Joseph,17,1,56,39
1657178185392,CSE 11,A01,083080,Cao; Yingjun,5,15,40,35
1657178191432,CSE 12,A01,083652,Krause-Levy; Sophia Louisa,24,1,120,96
1657178197513,CSE 15L,A01,083654,Morris; Justin Loren,9,0,50,41
1657178197513,CSE 15L,A02,083655,Morris; Justin Loren,9,0,50,41
1657178203566,CSE 20,A01,083657,Tran; Khoa Dang,38,0,80,42
1657178209598,CSE 21,A01,095574,Bach; Quang Tran,22,0,48,26
1657178215624,CSE 30,A01,083084,Eldon; John,4,0,80,76
1657178215624,CSE 30,B01,095061,Bhaskar; Nishant,7,0,50,43
1657178221647,CSE 100,A01,083659,Cao; Yingjun,4,4,70,66
1657178227675,CSE 134B,A01,083661,Powell; Thomas Allan,20,0,100,80
1657178233697,CSE 140,A01,083663,Gungor; Onat,13,0,85,72
1657178239726,CSE 140L,A01,083088,Eldon; John,17,0,100,83
1657178245751,CSE 175,A01,083665,Kumar; Rakesh,3,0,25,22
1657178251773,CSE 190,A00,092507,Dubnov; Shlomo,7,0,20,13
1657178257797,ECE 45,A01,083139,Congero; Spencer William,5,0,75,70
1657178263825,ECE 65,A50,083695,Saad; Andrew S,12,0,30,18
1657178263825,ECE 65,A51,095125,Saad; Andrew S,25,0,26,1
1657178269858,ECE 109,A01,091882,Touri; Behrouz,19,0,70,51
1657178275891,ECE 180,A00,083140,Abi Samra; Nicholas Camill,1,0,30,29
1657178275891,ECE 180,B00,083141,Abi Samra; Nicholas Camill,0,0,30,30
1657178281920,MATH 10A,A01,083735,Patchell; Gregory David,2,0,30,28
1657178281920,MATH 10A,A02,083736,Patchell; Gregory David,20,0,30,10
1657178281920,MATH 10A,A03,083737,Patchell; Gregory David,16,0,30,14
1657178287956,MATH 10B,A01,083207,Lim; Seonhee,7,0,34,27
1657178287956,MATH 10B,A02,083208,Lim; Seonhee,9,0,35,26
1657178287956,MATH 10B,A03,093472,Lim; Seonhee,5,0,34,29
1657178287956,MATH 10B,B01,083739,Sinha; Shubham,10,0,30,20
1657178293985,MATH 18,A01,083743,Cinel; Cameron Alexander,6,0,30,24
1657178293985,MATH 18,A02,083744,Cinel; Cameron Alexander,15,0,30,15
1657178293985,MATH 18,A03,083745,Cinel; Cameron Alexander,8,0,30,22
1657178293985,MATH 18,B01,083748,Rideout; David Porter,4,0,37,33
1657178293985,MATH 18,B02,083749,Rideout; David Porter,4,0,36,32
1657178293985,MATH 18,B03,083750,Rideout; David Porter,2,0,37,35
1657178293985,MATH 18,B04,083751,Rideout; David Porter,5,0,36,31
1657178293985,MATH 18,B05,093473,Rideout; David Porter,5,0,36,31
1657178293985,MATH 18,B06,093474,Rideout; David Porter,5,0,36,31
1657178300008,MATH 20A,A01,083754,Zheng; Zequn,13,0,40,27
1657178306035,MATH 20B,A01,083756,Briones; Jor-el Thomas Caparas,1,0,36,35
1657178306035,MATH 20B,A02,083757,Briones; Jor-el Thomas Caparas,1,0,36,35
1657178306035,MATH 20B,A03,093475,Briones; Jor-el Thomas Caparas,1,0,36,35
1657178312060,MATH 20C,A01,083760,Briones; Jor-el Thomas Caparas,1,0,35,34
1657178312060,MATH 20C,A02,083761,Briones; Jor-el Thomas Caparas,8,0,35,27
1657178312060,MATH 20C,A03,093476,Briones; Jor-el Thomas Caparas,0,1,36,36
1657178312060,MATH 20C,B01,083762,Bach; Quang Tran,1,0,30,29
1657178318091,MATH 20D,A01,083765,Tran; Brian Kha,4,0,30,26
1657178318091,MATH 20D,A02,083766,Tran; Brian Kha,5,0,30,25
1657178318091,MATH 20D,A03,083767,Tran; Brian Kha,4,0,30,26
1657178324122,MATH 20E,A01,083771,Ganguly; Soumya,7,0,32,25
1657178324122,MATH 20E,A02,083772,Ganguly; Soumya,7,0,32,25
1657178324122,MATH 20E,B01,083773,Ciotti; Benjamin,19,0,35,16
1657178324122,MATH 20E,B02,083774,Ciotti; Benjamin,17,0,35,18
1657178330148,MATH 103A,A01,083777,Greenfeld; Be'Eri,2,0,36,34
1657178330148,MATH 103A,A02,083778,Greenfeld; Be'Eri,5,0,36,31
1657178330148,MATH 103A,A03,093561,Greenfeld; Be'Eri,4,0,36,32
1657178330148,MATH 103A,B01,083779,Greenfeld; Be'Eri,6,0,36,30
1657178330148,MATH 103A,B02,083780,Greenfeld; Be'Eri,3,0,36,33
1657178330148,MATH 103A,B03,093562,Greenfeld; Be'Eri,3,0,36,33
1657178336177,MATH 105,A01,085443,Carter; Anne Toulson,14,0,35,21
1657178336177,MATH 105,A02,093477,Carter; Anne Toulson,20,0,35,15
1657178342242,MATH 109,A01,083213,Ganzberger; Geoffrey Michael,2,0,34,32
1657178342242,MATH 109,A02,083214,Ganzberger; Geoffrey Michael,3,0,34,31
1657178342242,MATH 109,A03,093478,Ganzberger; Geoffrey Michael,1,0,34,33
1657178342242,MATH 109,B01,083215,Ganzberger; Geoffrey Michael,1,0,32,31
1657178342242,MATH 109,B02,083216,Ganzberger; Geoffrey Michael,1,0,32,31
1657178342242,MATH 109,B03,093479,Ganzberger; Geoffrey Michael,6,0,32,26
1657178348278,MATH 142A,A01,083219,Chow; Bennett,6,0,32,26
1657178348278,MATH 142A,A02,083220,Chow; Bennett,10,0,32,22
1657178348278,MATH 142A,A03,093480,Chow; Bennett,7,0,32,25
1657178348278,MATH 142A,B03,093481,Chow; Bennett,8,0,32,24
1657178348278,MATH 142A,B04,093558,Chow; Bennett,11,0,32,21
1657178348278,MATH 142A,B05,093559,Chow; Bennett,6,0,32,26
1657178354304,MATH 193A,A01,083224,Rotar; Vladimir,7,0,34,27
1657178354304,MATH 193A,A02,083225,Rotar; Vladimir,5,0,34,29
1657178354304,MATH 193A,A03,083781,Rotar; Vladimir,1,0,34,33
1657178354304,MATH 193A,A04,083782,Rotar; Vladimir,8,0,34,26
1657178354304,MATH 193A,A05,093482,Rotar; Vladimir,6,0,34,28
1657178360332,MATH 197,001,091859,McAuley; Julian John,9999,0,9999,0
1657178360332,MATH 197,002,095566,Kedlaya; Kiran S.,9997,0,9999,2
1657178360332,MATH 197,003,095567,Xiao; Ming,9999,0,9999,0
1657178360332,MATH 197,004,095571,Perols; Johan Lars,9998,0,9999,1
1657178367391,COGS 9,A01,083615,Shannon; Kyle Michael,7,0,75,68
1657178373415,COGS 11,A01,083617,Boyle; Mary E. T.,22,0,48,26
1657178379446,COGS 13,A01,083071,Bastos; Amalia Pinkusfeld,9,0,71,62
1657178385478,COGS 14A,A01,092681,Semenuks; Arturs,1,1,100,99
1657178391504,COGS 14B,A01,083073,Cheng; Tzu-Han,6,0,63,57
1657178397527,COGS 17,A01,092677,Semenuks; Arturs,4,0,81,77
1657178403552,COGS 100,A01,083619,Allen; Michael Gordon,15,0,70,55
1657178409578,COGS 101A,A01,083621,Davis; Joshua Daniel,9,0,68,59
1657178415601,COGS 101B,A01,091572,Allen; Michael Gordon,9,0,65,56
1657178421624,COGS 101C,A01,083625,Delgado; Tania,17,0,35,18
1657178427647,COGS 107A,A01,083627,Boyle; Mary E. T.,13,0,60,47
1657178433672,COGS 118A,A01,083075,Gupta; Anjum,16,0,76,60
1657178439700,CSE 3,A50,083646,Miranda; Gregory Joseph,24,0,50,26
1657178445725,CSE 8A,A50,083650,Miranda; Gregory Joseph,17,1,56,39
1657178451748,CSE 11,A01,083080,Cao; Yingjun,5,15,40,35
1657178457777,CSE 12,A01,083652,Krause-Levy; Sophia Louisa,24,1,120,96
1657178463801,CSE 15L,A01,083654,Morris; Justin Loren,9,0,50,41
1657178463801,CSE 15L,A02,083655,Morris; Justin Loren,9,0,50,41
1657178469829,CSE 20,A01,083657,Tran; Khoa Dang,38,0,80,42
1657178475873,CSE 21,A01,095574,Bach; Quang Tran,22,0,48,26
1657178481898,CSE 30,A01,083084,Eldon; John,4,0,80,76
1657178481898,CSE 30,B01,095061,Bhaskar; Nishant,7,0,50,43
1657178487924,CSE 100,A01,083659,Cao; Yingjun,4,4,70,66
1657178493950,CSE 134B,A01,083661,Powell; Thomas Allan,20,0,100,80
1657178500052,CSE 140,A01,083663,Gungor; Onat,13,0,85,72
1657178506078,CSE 140L,A01,083088,Eldon; John,17,0,100,83
1657178512102,CSE 175,A01,083665,Kumar; Rakesh,3,0,25,22
1657178518126,CSE 190,A00,092507,Dubnov; Shlomo,7,0,20,13
1657178524152,ECE 45,A01,083139,Congero; Spencer William,5,0,75,70
1657178530187,ECE 65,A50,083695,Saad; Andrew S,12,0,30,18
1657178530187,ECE 65,A51,095125,Saad; Andrew S,25,0,26,1
1657178536212,ECE 109,A01,091882,Touri; Behrouz,19,0,70,51
1657178542236,ECE 180,A00,083140,Abi Samra; Nicholas Camill,1,0,30,29
1657178542236,ECE 180,B00,083141,Abi Samra; Nicholas Camill,0,0,30,30
1657178548280,MATH 10A,A01,083735,Patchell; Gregory David,2,0,30,28
1657178548280,MATH 10A,A02,083736,Patchell; Gregory David,20,0,30,10
1657178548280,MATH 10A,A03,083737,Patchell; Gregory David,16,0,30,14
1657178554307,MATH 10B,A01,083207,Lim; Seonhee,7,0,34,27
1657178554307,MATH 10B,A02,083208,Lim; Seonhee,9,0,35,26
1657178554307,MATH 10B,A03,093472,Lim; Seonhee,5,0,34,29
1657178554307,MATH 10B,B01,083739,Sinha; Shubham,10,0,30,20
1657178560334,MATH 18,A01,083743,Cinel; Cameron Alexander,6,0,30,24
1657178560334,MATH 18,A02,083744,Cinel; Cameron Alexander,15,0,30,15
1657178560334,MATH 18,A03,083745,Cinel; Cameron Alexander,8,0,30,22
1657178560334,MATH 18,B01,083748,Rideout; David Porter,4,0,37,33
1657178560334,MATH 18,B02,083749,Rideout; David Porter,4,0,36,32
1657178560334,MATH 18,B03,083750,Rideout; David Porter,2,0,37,35
1657178560334,MATH 18,B04,083751,Rideout; David Porter,5,0,36,31
1657178560334,MATH 18,B05,093473,Rideout; David Porter,5,0,36,31
1657178560334,MATH 18,B06,093474,Rideout; David Porter,5,0,36,31
1657178566373,MATH 20A,A01,083754,Zheng; Zequn,13,0,40,27
1657178572406,MATH 20B,A01,083756,Briones; Jor-el Thomas Caparas,1,0,36,35
1657178572406,MATH 20B,A02,083757,Briones; Jor-el Thomas Caparas,1,0,36,35
1657178572406,MATH 20B,A03,093475,Briones; Jor-el Thomas Caparas,1,0,36,35
1657178578439,MATH 20C,A01,083760,Briones; Jor-el Thomas Caparas,1,0,35,34
1657178578439,MATH 20C,A02,083761,Briones; Jor-el Thomas Caparas,8,0,35,27
1657178578439,MATH 20C,A03,093476,Briones; Jor-el Thomas Caparas,0,1,36,36
1657178578439,MATH 20C,B01,083762,Bach; Quang Tran,1,0,30,29
1657178584471,MATH 20D,A01,083765,Tran; Brian Kha,4,0,30,26
1657178584471,MATH 20D,A02,083766,Tran; Brian Kha,5,0,30,25
1657178584471,MATH 20D,A03,083767,Tran; Brian Kha,4,0,30,26
1657178590504,MATH 20E,A01,083771,Ganguly; Soumya,7,0,32,25
1657178590504,MATH 20E,A02,083772,Ganguly; Soumya,7,0,32,25
1657178590504,MATH 20E,B01,083773,Ciotti; Benjamin,19,0,35,16
1657178590504,MATH 20E,B02,083774,Ciotti; Benjamin,17,0,35,18
1657178596529,MATH 103A,A01,083777,Greenfeld; Be'Eri,2,0,36,34
1657178596529,MATH 103A,A02,083778,Greenfeld; Be'Eri,5,0,36,31
1657178596529,MATH 103A,A03,093561,Greenfeld; Be'Eri,4,0,36,32
1657178596529,MATH 103A,B01,083779,Greenfeld; Be'Eri,6,0,36,30
1657178596529,MATH 103A,B02,083780,Greenfeld; Be'Eri,3,0,36,33
1657178596529,MATH 103A,B03,093562,Greenfeld; Be'Eri,3,0,36,33
1657178602559,MATH 105,A01,085443,Carter; Anne Toulson,14,0,35,21
1657178602559,MATH 105,A02,093477,Carter; Anne Toulson,20,0,35,15
1657178608581,MATH 109,A01,083213,Ganzberger; Geoffrey Michael,2,0,34,32
1657178608581,MATH 109,A02,083214,Ganzberger; Geoffrey Michael,3,0,34,31
1657178608581,MATH 109,A03,093478,Ganzberger; Geoffrey Michael,1,0,34,33
1657178608581,MATH 109,B01,083215,Ganzberger; Geoffrey Michael,1,0,32,31
1657178608581,MATH 109,B02,083216,Ganzberger; Geoffrey Michael,1,0,32,31
1657178608581,MATH 109,B03,093479,Ganzberger; Geoffrey Michael,6,0,32,26
1657178614606,MATH 142A,A01,083219,Chow; Bennett,6,0,32,26
1657178614606,MATH 142A,A02,083220,Chow; Bennett,10,0,32,22
1657178614606,MATH 142A,A03,093480,Chow; Bennett,7,0,32,25
1657178614606,MATH 142A,B03,093481,Chow; Bennett,8,0,32,24
1657178614606,MATH 142A,B04,093558,Chow; Bennett,11,0,32,21
1657178614606,MATH 142A,B05,093559,Chow; Bennett,6,0,32,26
1657178620635,MATH 193A,A01,083224,Rotar; Vladimir,7,0,34,27
1657178620635,MATH 193A,A02,083225,Rotar; Vladimir,5,0,34,29
1657178620635,MATH 193A,A03,083781,Rotar; Vladimir,1,0,34,33
1657178620635,MATH 193A,A04,083782,Rotar; Vladimir,8,0,34,26
1657178620635,MATH 193A,A05,093482,Rotar; Vladimir,6,0,34,28
1657178626670,MATH 197,001,091859,McAuley; Julian John,9999,0,9999,0
1657178626670,MATH 197,002,095566,Kedlaya; Kiran S.,9997,0,9999,2
1657178626670,MATH 197,003,095567,Xiao; Ming,9999,0,9999,0
1657178626670,MATH 197,004,095571,Perols; Johan Lars,9998,0,9999,1
1657178633737,COGS 9,A01,083615,Shannon; Kyle Michael,7,0,75,68
1657178639760,COGS 11,A01,083617,Boyle; Mary E. T.,22,0,48,26
1657178645793,COGS 13,A01,083071,Bastos; Amalia Pinkusfeld,9,0,71,62
1657178651824,COGS 14A,A01,092681,Semenuks; Arturs,1,1,100,99
1657178657849,COGS 14B,A01,083073,Cheng; Tzu-Han,6,0,63,57
1657178663878,COGS 17,A01,092677,Semenuks; Arturs,4,0,81,77
1657178669903,COGS 100,A01,083619,Allen; Michael Gordon,15,0,70,55
1657178675932,COGS 101A,A01,083621,Davis; Joshua Daniel,9,0,68,59
1657178681961,COGS 101B,A01,091572,Allen; Michael Gordon,9,0,65,56
1657178687990,COGS 101C,A01,083625,Delgado; Tania,17,0,35,18
1657178694015,COGS 107A,A01,083627,Boyle; Mary E. T.,13,0,60,47
1657178700038,COGS 118A,A01,083075,Gupta; Anjum,16,0,76,60
1657178706064,CSE 3,A50,083646,Miranda; Gregory Joseph,24,0,50,26
1657178712094,CSE 8A,A50,083650,Miranda; Gregory Joseph,17,1,56,39
1657178718117,CSE 11,A01,083080,Cao; Yingjun,5,15,40,35
1657178724143,CSE 12,A01,083652,Krause-Levy; Sophia Louisa,24,1,120,96
1657178730167,CSE 15L,A01,083654,Morris; Justin Loren,9,0,50,41
1657178730167,CSE 15L,A02,083655,Morris; Justin Loren,9,0,50,41
1657178736191,CSE 20,A01,083657,Tran; Khoa Dang,38,0,80,42
1657178742218,CSE 21,A01,095574,Bach; Quang Tran,22,0,48,26
1657178748247,CSE 30,A01,083084,Eldon; John,4,0,80,76
1657178748247,CSE 30,B01,095061,Bhaskar; Nishant,7,0,50,43
1657178754267,CSE 100,A01,083659,Cao; Yingjun,4,4,70,66
1657178760296,CSE 134B,A01,083661,Powell; Thomas Allan,20,0,100,80
1657178766318,CSE 140,A01,083663,Gungor; Onat,13,0,85,72
1657178772344,CSE 140L,A01,083088,Eldon; John,17,0,100,83
1657178778376,CSE 175,A01,083665,Kumar; Rakesh,3,0,25,22
1657178784402,CSE 190,A00,092507,Dubnov; Shlomo,7,0,20,13
1657178790427,ECE 45,A01,083139,Congero; Spencer William,5,0,75,70
1657178796455,ECE 65,A50,083695,Saad; Andrew S,12,0,30,18
1657178796455,ECE 65,A51,095125,Saad; Andrew S,25,0,26,1
1657178802483,ECE 109,A01,091882,Touri; Behrouz,19,0,70,51
1657178808509,ECE 180,A00,083140,Abi Samra; Nicholas Camill,1,0,30,29
1657178808509,ECE 180,B00,083141,Abi Samra; Nicholas Camill,0,0,30,30
1657178814540,MATH 10A,A01,083735,Patchell; Gregory David,2,0,30,28
1657178814540,MATH 10A,A02,083736,Patchell; Gregory David,20,0,30,10
1657178814540,MATH 10A,A03,083737,Patchell; Gregory David,16,0,30,14
1657178820570,MATH 10B,A01,083207,Lim; Seonhee,7,0,34,27
1657178820570,MATH 10B,A02,083208,Lim; Seonhee,9,0,35,26
1657178820570,MATH 10B,A03,093472,Lim; Seonhee,5,0,34,29
1657178820570,MATH 10B,B01,083739,Sinha; Shubham,10,0,30,20
1657178826603,MATH 18,A01,083743,Cinel; Cameron Alexander,6,0,30,24
1657178826603,MATH 18,A02,083744,Cinel; Cameron Alexander,15,0,30,15
1657178826603,MATH 18,A03,083745,Cinel; Cameron Alexander,8,0,30,22
1657178826603,MATH 18,B01,083748,Rideout; David Porter,4,0,37,33
1657178826603,MATH 18,B02,083749,Rideout; David Porter,4,0,36,32
1657178826603,MATH 18,B03,083750,Rideout; David Porter,2,0,37,35
1657178826603,MATH 18,B04,083751,Rideout; David Porter,5,0,36,31
1657178826603,MATH 18,B05,093473,Rideout; David Porter,5,0,36,31
1657178826603,MATH 18,B06,093474,Rideout; David Porter,5,0,36,31
1657178832631,MATH 20A,A01,083754,Zheng; Zequn,13,0,40,27
1657178838661,MATH 20B,A01,083756,Briones; Jor-el Thomas Caparas,1,0,36,35
1657178838661,MATH 20B,A02,083757,Briones; Jor-el Thomas Caparas,1,0,36,35
1657178838661,MATH 20B,A03,093475,Briones; Jor-el Thomas Caparas,1,0,36,35
1657178844685,MATH 20C,A01,083760,Briones; Jor-el Thomas Caparas,1,0,35,34
1657178844685,MATH 20C,A02,083761,Briones; Jor-el Thomas Caparas,8,0,35,27
1657178844685,MATH 20C,A03,093476,Briones; Jor-el Thomas Caparas,0,1,36,36
1657178844685,MATH 20C,B01,083762,Bach; Quang Tran,1,0,30,29
1657178850710,MATH 20D,A01,083765,Tran; Brian Kha,4,0,30,26
1657178850710,MATH 20D,A02,083766,Tran; Brian Kha,5,0,30,25
1657178850710,MATH 20D,A03,083767,Tran; Brian Kha,4,0,30,26
1657178856738,MATH 20E,A01,083771,Ganguly; Soumya,7,0,32,25
1657178856738,MATH 20E,A02,083772,Ganguly; Soumya,7,0,32,25
1657178856738,MATH 20E,B01,083773,Ciotti; Benjamin,19,0,35,16
1657178856738,MATH 20E,B02,083774,Ciotti; Benjamin,17,0,35,18
1657178862763,MATH 103A,A01,083777,Greenfeld; Be'Eri,2,0,36,34
1657178862763,MATH 103A,A02,083778,Greenfeld; Be'Eri,5,0,36,31
1657178862763,MATH 103A,A03,093561,Greenfeld; Be'Eri,4,0,36,32
1657178862763,MATH 103A,B01,083779,Greenfeld; Be'Eri,6,0,36,30
1657178862763,MATH 103A,B02,083780,Greenfeld; Be'Eri,3,0,36,33
1657178862763,MATH 103A,B03,093562,Greenfeld; Be'Eri,3,0,36,33
1657178868792,MATH 105,A01,085443,Carter; Anne Toulson,14,0,35,21
1657178868792,MATH 105,A02,093477,Carter; Anne Toulson,20,0,35,15
1657178874818,MATH 109,A01,083213,Ganzberger; Geoffrey Michael,2,0,34,32
1657178874818,MATH 109,A02,083214,Ganzberger; Geoffrey Michael,3,0,34,31
1657178874818,MATH 109,A03,093478,Ganzberger; Geoffrey Michael,1,0,34,33
1657178874818,MATH 109,B01,083215,Ganzberger; Geoffrey Michael,1,0,32,31
1657178874818,MATH 109,B02,083216,Ganzberger; Geoffrey Michael,1,0,32,31
1657178874818,MATH 109,B03,093479,Ganzberger; Geoffrey Michael,6,0,32,26
1657178880841,MATH 142A,A01,083219,Chow; Bennett,6,0,32,26
1657178880841,MATH 142A,A02,083220,Chow; Bennett,10,0,32,22
1657178880841,MATH 142A,A03,093480,Chow; Bennett,7,0,32,25
1657178880841,MATH 142A,B03,093481,Chow; Bennett,8,0,32,24
1657178880841,MATH 142A,B04,093558,Chow; Bennett,11,0,32,21
1657178880841,MATH 142A,B05,093559,Chow; Bennett,6,0,32,26
1657178886877,MATH 193A,A01,083224,Rotar; Vladimir,7,0,34,27
1657178886877,MATH 193A,A02,083225,Rotar; Vladimir,5,0,34,29
1657178886877,MATH 193A,A03,083781,Rotar; Vladimir,1,0,34,33
1657178886877,MATH 193A,A04,083782,Rotar; Vladimir,8,0,34,26
1657178886877,MATH 193A,A05,093482,Rotar; Vladimir,6,0,34,28
1657178892899,MATH 197,001,091859,McAuley; Julian John,9999,0,9999,0
1657178892899,MATH 197,002,095566,Kedlaya; Kiran S.,9997,0,9999,2
1657178892899,MATH 197,003,095567,Xiao; Ming,9999,0,9999,0
1657178892899,MATH 197,004,095571,Perols; Johan Lars,9998,0,9999,1
1657178899959,COGS 9,A01,083615,Shannon; Kyle Michael,7,0,75,68
1657178905984,COGS 11,A01,083617,Boyle; Mary E. T.,22,0,48,26
1657178912009,COGS 13,A01,083071,Bastos; Amalia Pinkusfeld,9,0,71,62
1657178918035,COGS 14A,A01,092681,Semenuks; Arturs,1,1,100,99
1657178924058,COGS 14B,A01,083073,Cheng; Tzu-Han,6,0,63,57
1657178930080,COGS 17,A01,092677,Semenuks; Arturs,4,0,81,77
1657178936104,COGS 100,A01,083619,Allen; Michael Gordon,15,0,70,55
1657178942130,COGS 101A,A01,083621,Davis; Joshua Daniel,9,0,68,59
1657178948159,COGS 101B,A01,091572,Allen; Michael Gordon,9,0,65,56
1657178954184,COGS 101C,A01,083625,Delgado; Tania,17,0,35,18
1657178960212,COGS 107A,A01,083627,Boyle; Mary E. T.,13,0,60,47
1657178966239,COGS 118A,A01,083075,Gupta; Anjum,16,0,76,60
1657178972268,CSE 3,A50,083646,Miranda; Gregory Joseph,24,0,50,26
1657178978292,CSE 8A,A50,083650,Miranda; Gregory Joseph,17,1,56,39
1657178984319,CSE 11,A01,083080,Cao; Yingjun,5,15,40,35
1657178990343,CSE 12,A01,083652,Krause-Levy; Sophia Louisa,24,1,120,96
1657178996368,CSE 15L,A01,083654,Morris; Justin Loren,9,0,50,41
1657178996368,CSE 15L,A02,083655,Morris; Justin Loren,9,0,50,41
1657179002396,CSE 20,A01,083657,Tran; Khoa Dang,38,0,80,42
1657179008420,CSE 21,A01,095574,Bach; Quang Tran,22,0,48,26
1657179014445,CSE 30,A01,083084,Eldon; John,4,0,80,76
1657179014445,CSE 30,B01,095061,Bhaskar; Nishant,7,0,50,43
1657179020468,CSE 100,A01,083659,Cao; Yingjun,4,4,70,66
1657179026491,CSE 134B,A01,083661,Powell; Thomas Allan,20,0,100,80
1657179032514,CSE 140,A01,083663,Gungor; Onat,13,0,85,72
1657179038539,CSE 140L,A01,083088,Eldon; John,17,0,100,83
1657179044563,CSE 175,A01,083665,Kumar; Rakesh,3,0,25,22
1657179050589,CSE 190,A00,092507,Dubnov; Shlomo,7,0,20,13
1657179056621,ECE 45,A01,083139,Congero; Spencer William,5,0,75,70
1657179062646,ECE 65,A50,083695,Saad; Andrew S,12,0,30,18
1657179062646,ECE 65,A51,095125,Saad; Andrew S,25,0,26,1
1657179068674,ECE 109,A01,091882,Touri; Behrouz,19,0,70,51
1657179074698,ECE 180,A00,083140,Abi Samra; Nicholas Camill,1,0,30,29
1657179074698,ECE 180,B00,083141,Abi Samra; Nicholas Camill,0,0,30,30
1657179080722,MATH 10A,A01,083735,Patchell; Gregory David,2,0,30,28
1657179080722,MATH 10A,A02,083736,Patchell; Gregory David,20,0,30,10
1657179080722,MATH 10A,A03,083737,Patchell; Gregory David,16,0,30,14
1657179086746,MATH 10B,A01,083207,Lim; Seonhee,7,0,34,27
1657179086746,MATH 10B,A02,083208,Lim; Seonhee,9,0,35,26
1657179086746,MATH 10B,A03,093472,Lim; Seonhee,5,0,34,29
1657179086746,MATH 10B,B01,083739,Sinha; Shubham,10,0,30,20
1657179092772,MATH 18,A01,083743,Cinel; Cameron Alexander,6,0,30,24
1657179092772,MATH 18,A02,083744,Cinel; Cameron Alexander,15,0,30,15
1657179092772,MATH 18,A03,083745,Cinel; Cameron Alexander,8,0,30,22
1657179092772,MATH 18,B01,083748,Rideout; David Porter,4,0,37,33
1657179092772,MATH 18,B02,083749,Rideout; David Porter,4,0,36,32
1657179092772,MATH 18,B03,083750,Rideout; David Porter,2,0,37,35
1657179092772,MATH 18,B04,083751,Rideout; David Porter,5,0,36,31
1657179092772,MATH 18,B05,093473,Rideout; David Porter,5,0,36,31
1657179092772,MATH 18,B06,093474,Rideout; David Porter,5,0,36,31
1657179098869,MATH 20A,A01,083754,Zheng; Zequn,13,0,40,27
1657179104899,MATH 20B,A01,083756,Briones; Jor-el Thomas Caparas,1,0,36,35
1657179104899,MATH 20B,A02,083757,Briones; Jor-el Thomas Caparas,1,0,36,35
1657179104899,MATH 20B,A03,093475,Briones; Jor-el Thomas Caparas,1,0,36,35
1657179110927,MATH 20C,A01,083760,Briones; Jor-el Thomas Caparas,1,0,35,34
1657179110927,MATH 20C,A02,083761,Briones; Jor-el Thomas Caparas,8,0,35,27
1657179110927,MATH 20C,A03,093476,Briones; Jor-el Thomas Caparas,0,1,36,36
1657179110927,MATH 20C,B01,083762,Bach; Quang Tran,1,0,30,29
1657179116957,MATH 20D,A01,083765,Tran; Brian Kha,4,0,30,26
1657179116957,MATH 20D,A02,083766,Tran; Brian Kha,5,0,30,25
1657179116957,MATH 20D,A03,083767,Tran; Brian Kha,4,0,30,26
1657179122983,MATH 20E,A01,083771,Ganguly; Soumya,7,0,32,25
1657179122983,MATH 20E,A02,083772,Ganguly; Soumya,7,0,32,25
1657179122983,MATH 20E,B01,083773,Ciotti; Benjamin,19,0,35,16
1657179122983,MATH 20E,B02,083774,Ciotti; Benjamin,17,0,35,18
1657179129014,MATH 103A,A01,083777,Greenfeld; Be'Eri,2,0,36,34
1657179129014,MATH 103A,A02,083778,Greenfeld; Be'Eri,5,0,36,31
1657179129014,MATH 103A,A03,093561,Greenfeld; Be'Eri,4,0,36,32
1657179129014,MATH 103A,B01,083779,Greenfeld; Be'Eri,6,0,36,30
1657179129014,MATH 103A,B02,083780,Greenfeld; Be'Eri,3,0,36,33
1657179129014,MATH 103A,B03,093562,Greenfeld; Be'Eri,3,0,36,33
1657179135040,MATH 105,A01,085443,Carter; Anne Toulson,14,0,35,21
1657179135040,MATH 105,A02,093477,Carter; Anne Toulson,20,0,35,15
1657179141071,MATH 109,A01,083213,Ganzberger; Geoffrey Michael,2,0,34,32
1657179141071,MATH 109,A02,083214,Ganzberger; Geoffrey Michael,3,0,34,31
1657179141071,MATH 109,A03,093478,Ganzberger; Geoffrey Michael,1,0,34,33
1657179141071,MATH 109,B01,083215,Ganzberger; Geoffrey Michael,1,0,32,31
1657179141071,MATH 109,B02,083216,Ganzberger; Geoffrey Michael,1,0,32,31
1657179141071,MATH 109,B03,093479,Ganzberger; Geoffrey Michael,6,0,32,26
1657179147096,MATH 142A,A01,083219,Chow; Bennett,6,0,32,26
1657179147096,MATH 142A,A02,083220,Chow; Bennett,10,0,32,22
1657179147096,MATH 142A,A03,093480,Chow; Bennett,7,0,32,25
1657179147096,MATH 142A,B03,093481,Chow; Bennett,8,0,32,24
1657179147096,MATH 142A,B04,093558,Chow; Bennett,11,0,32,21
1657179147096,MATH 142A,B05,093559,Chow; Bennett,6,0,32,26
1657179153121,MATH 193A,A01,083224,Rotar; Vladimir,7,0,34,27
1657179153121,MATH 193A,A02,083225,Rotar; Vladimir,5,0,34,29
1657179153121,MATH 193A,A03,083781,Rotar; Vladimir,1,0,34,33
1657179153121,MATH 193A,A04,083782,Rotar; Vladimir,8,0,34,26
1657179153121,MATH 193A,A05,093482,Rotar; Vladimir,6,0,34,28
1657179159155,MATH 197,001,091859,McAuley; Julian John,9999,0,9999,0
1657179159155,MATH 197,002,095566,Kedlaya; Kiran S.,9997,0,9999,2
1657179159155,MATH 197,003,095567,Xiao; Ming,9999,0,9999,0
1657179159155,MATH 197,004,095571,Perols; Johan Lars,9998,0,9999,1
1657179166228,COGS 9,A01,083615,Shannon; Kyle Michael,7,0,75,68
1657179172258,COGS 11,A01,083617,Boyle; Mary E. T.,22,0,48,26
1657179178293,COGS 13,A01,083071,Bastos; Amalia Pinkusfeld,9,0,71,62
1657179184315,COGS 14A,A01,092681,Semenuks; Arturs,1,1,100,99
1657179190341,COGS 14B,A01,083073,Cheng; Tzu-Han,6,0,63,57
1657179196364,COGS 17,A01,092677,Semenuks; Arturs,4,0,81,77
1657179202396,COGS 100,A01,083619,Allen; Michael Gordon,15,0,70,55
1657179208426,COGS 101A,A01,083621,Davis; Joshua Daniel,9,0,68,59
1657179214451,COGS 101B,A01,091572,Allen; Michael Gordon,9,0,65,56
1657179220482,COGS 101C,A01,083625,Delgado; Tania,17,0,35,18
1657179226511,COGS 107A,A01,083627,Boyle; Mary E. T.,13,0,60,47
1657179232540,COGS 118A,A01,083075,Gupta; Anjum,16,0,76,60
1657179238568,CSE 3,A50,083646,Miranda; Gregory Joseph,24,0,50,26
1657179244593,CSE 8A,A50,083650,Miranda; Gregory Joseph,17,1,56,39
1657179250621,CSE 11,A01,083080,Cao; Yingjun,5,15,40,35
1657179256658,CSE 12,A01,083652,Krause-Levy; Sophia Louisa,24,1,120,96
1657179262688,CSE 15L,A01,083654,Morris; Justin Loren,9,0,50,41
1657179262688,CSE 15L,A02,083655,Morris; Justin Loren,9,0,50,41
1657179268712,CSE 20,A01,083657,Tran; Khoa Dang,38,0,80,42
1657179274742,CSE 21,A01,095574,Bach; Quang Tran,22,0,48,26
1657179280767,CSE 30,A01,083084,Eldon; John,4,0,80,76
1657179280767,CSE 30,B01,095061,Bhaskar; Nishant,7,0,50,43
1657179286795,CSE 100,A01,083659,Cao; Yingjun,4,4,70,66
1657179292823,CSE 134B,A01,083661,Powell; Thomas Allan,20,0,100,80
1657179298846,CSE 140,A01,083663,Gungor; Onat,13,0,85,72
1657179304872,CSE 140L,A01,083088,Eldon; John,17,0,100,83
1657179310904,CSE 175,A01,083665,Kumar; Rakesh,3,0,25,22
1657179316931,CSE 190,A00,092507,Dubnov; Shlomo,7,0,20,13
1657179322956,ECE 45,A01,083139,Congero; Spencer William,5,0,75,70
1657179328982,ECE 65,A50,083695,Saad; Andrew S,12,0,30,18
1657179328982,ECE 65,A51,095125,Saad; Andrew S,25,0,26,1
1657179335006,ECE 109,A01,091882,Touri; Behrouz,19,0,70,51
1657179341034,ECE 180,A00,083140,Abi Samra; Nicholas Camill,1,0,30,29
1657179341034,ECE 180,B00,083141,Abi Samra; Nicholas Camill,0,0,30,30
1657179347063,MATH 10A,A01,083735,Patchell; Gregory David,2,0,30,28
1657179347063,MATH 10A,A02,083736,Patchell; Gregory David,20,0,30,10
1657179347063,MATH 10A,A03,083737,Patchell; Gregory David,16,0,30,14
1657179353093,MATH 10B,A01,083207,Lim; Seonhee,7,0,34,27
1657179353093,MATH 10B,A02,083208,Lim; Seonhee,9,0,35,26
1657179353093,MATH 10B,A03,093472,Lim; Seonhee,5,0,34,29
1657179353093,MATH 10B,B01,083739,Sinha; Shubham,10,0,30,20
1657179359135,MATH 18,A01,083743,Cinel; Cameron Alexander,6,0,30,24
1657179359135,MATH 18,A02,083744,Cinel; Cameron Alexander,15,0,30,15
1657179359135,MATH 18,A03,083745,Cinel; Cameron Alexander,8,0,30,22
1657179359135,MATH 18,B01,083748,Rideout; David Porter,4,0,37,33
1657179359135,MATH 18,B02,083749,Rideout; David Porter,4,0,36,32
1657179359135,MATH 18,B03,083750,Rideout; David Porter,2,0,37,35
1657179359135,MATH 18,B04,083751,Rideout; David Porter,5,0,36,31
1657179359135,MATH 18,B05,093473,Rideout; David Porter,5,0,36,31
1657179359135,MATH 18,B06,093474,Rideout; David Porter,5,0,36,31
1657179365161,MATH 20A,A01,083754,Zheng; Zequn,13,0,40,27
1657179371188,MATH 20B,A01,083756,Briones; Jor-el Thomas Caparas,1,0,36,35
1657179371188,MATH 20B,A02,083757,Briones; Jor-el Thomas Caparas,1,0,36,35
1657179371188,MATH 20B,A03,093475,Briones; Jor-el Thomas Caparas,1,0,36,35
1657179377224,MATH 20C,A01,083760,Briones; Jor-el Thomas Caparas,1,0,35,34
1657179377224,MATH 20C,A02,083761,Briones; Jor-el Thomas Caparas,8,0,35,27
1657179377224,MATH 20C,A03,093476,Briones; Jor-el Thomas Caparas,0,1,36,36
1657179377224,MATH 20C,B01,083762,Bach; Quang Tran,1,0,30,29
1657179383249,MATH 20D,A01,083765,Tran; Brian Kha,4,0,30,26
1657179383249,MATH 20D,A02,083766,Tran; Brian Kha,5,0,30,25
1657179383249,MATH 20D,A03,083767,Tran; Brian Kha,4,0,30,26
1657179389276,MATH 20E,A01,083771,Ganguly; Soumya,7,0,32,25
1657179389276,MATH 20E,A02,083772,Ganguly; Soumya,7,0,32,25
1657179389276,MATH 20E,B01,083773,Ciotti; Benjamin,19,0,35,16
1657179389276,MATH 20E,B02,083774,Ciotti; Benjamin,17,0,35,18
1657179395313,MATH 103A,A01,083777,Greenfeld; Be'Eri,2,0,36,34
1657179395313,MATH 103A,A02,083778,Greenfeld; Be'Eri,5,0,36,31
1657179395313,MATH 103A,A03,093561,Greenfeld; Be'Eri,4,0,36,32
1657179395313,MATH 103A,B01,083779,Greenfeld; Be'Eri,6,0,36,30
1657179395313,MATH 103A,B02,083780,Greenfeld; Be'Eri,3,0,36,33
1657179395313,MATH 103A,B03,093562,Greenfeld; Be'Eri,3,0,36,33
1657179401347,MATH 105,A01,085443,Carter; Anne Toulson,14,0,35,21
1657179401347,MATH 105,A02,093477,Carter; Anne Toulson,20,0,35,15
1657179407380,MATH 109,A01,083213,Ganzberger; Geoffrey Michael,2,0,34,32
1657179407380,MATH 109,A02,083214,Ganzberger; Geoffrey Michael,3,0,34,31
1657179407380,MATH 109,A03,093478,Ganzberger; Geoffrey Michael,1,0,34,33
1657179407380,MATH 109,B01,083215,Ganzberger; Geoffrey Michael,1,0,32,31
1657179407380,MATH 109,B02,083216,Ganzberger; Geoffrey Michael,1,0,32,31
1657179407380,MATH 109,B03,093479,Ganzberger; Geoffrey Michael,6,0,32,26
1657179413414,MATH 142A,A01,083219,Chow; Bennett,6,0,32,26
1657179413414,MATH 142A,A02,083220,Chow; Bennett,10,0,32,22
1657179413414,MATH 142A,A03,093480,Chow; Bennett,7,0,32,25
1657179413414,MATH 142A,B03,093481,Chow; Bennett,8,0,32,24
1657179413414,MATH 142A,B04,093558,Chow; Bennett,11,0,32,21
1657179413414,MATH 142A,B05,093559,Chow; Bennett,6,0,32,26
1657179419440,MATH 193A,A01,083224,Rotar; Vladimir,7,0,34,27
1657179419440,MATH 193A,A02,083225,Rotar; Vladimir,5,0,34,29
1657179419440,MATH 193A,A03,083781,Rotar; Vladimir,1,0,34,33
1657179419440,MATH 193A,A04,083782,Rotar; Vladimir,8,0,34,26
1657179419440,MATH 193A,A05,093482,Rotar; Vladimir,6,0,34,28
1657179425472,MATH 197,001,091859,McAuley; Julian John,9999,0,9999,0
1657179425472,MATH 197,002,095566,Kedlaya; Kiran S.,9997,0,9999,2
1657179425472,MATH 197,003,095567,Xiao; Ming,9999,0,9999,0
1657179425472,MATH 197,004,095571,Perols; Johan Lars,9998,0,9999,1
1657179432560,COGS 9,A01,083615,Shannon; Kyle Michael,7,0,75,68
1657179438591,COGS 11,A01,083617,Boyle; Mary E. T.,22,0,48,26
1657179444616,COGS 13,A01,083071,Bastos; Amalia Pinkusfeld,9,0,71,62
1657179450640,COGS 14A,A01,092681,Semenuks; Arturs,1,1,100,99
1657179456664,COGS 14B,A01,083073,Cheng; Tzu-Han,6,0,63,57
1657179462703,COGS 17,A01,092677,Semenuks; Arturs,4,0,81,77
1657179468728,COGS 100,A01,083619,Allen; Michael Gordon,15,0,70,55
1657179474753,COGS 101A,A01,083621,Davis; Joshua Daniel,9,0,68,59
1657179480783,COGS 101B,A01,091572,Allen; Michael Gordon,9,0,65,56
1657179486811,COGS 101C,A01,083625,Delgado; Tania,17,0,35,18
1657179492840,COGS 107A,A01,083627,Boyle; Mary E. T.,13,0,60,47
1657179498865,COGS 118A,A01,083075,Gupta; Anjum,16,0,76,60
1657179504891,CSE 3,A50,083646,Miranda; Gregory Joseph,24,0,50,26
1657179510915,CSE 8A,A50,083650,Miranda; Gregory Joseph,17,1,56,39
1657179516946,CSE 11,A01,083080,Cao; Yingjun,5,15,40,35
1657179522971,CSE 12,A01,083652,Krause-Levy; Sophia Louisa,24,1,120,96
1657179528996,CSE 15L,A01,083654,Morris; Justin Loren,9,0,50,41
1657179528996,CSE 15L,A02,083655,Morris; Justin Loren,9,0,50,41
1657179535021,CSE 20,A01,083657,Tran; Khoa Dang,38,0,80,42
1657179541045,CSE 21,A01,095574,Bach; Quang Tran,22,0,48,26
1657179547074,CSE 30,A01,083084,Eldon; John,4,0,80,76
1657179547074,CSE 30,B01,095061,Bhaskar; Nishant,7,0,50,43
1657179553102,CSE 100,A01,083659,Cao; Yingjun,4,4,70,66
1657179559126,CSE 134B,A01,083661,Powell; Thomas Allan,20,0,100,80
1657179565157,CSE 140,A01,083663,Gungor; Onat,13,0,85,72
1657179571181,CSE 140L,A01,083088,Eldon; John,17,0,100,83
1657179577218,CSE 175,A01,083665,Kumar; Rakesh,3,0,25,22
1657179583243,CSE 190,A00,092507,Dubnov; Shlomo,7,0,20,13
1657179589274,ECE 45,A01,083139,Congero; Spencer William,5,0,75,70
1657179595307,ECE 65,A50,083695,Saad; Andrew S,12,0,30,18
1657179595307,ECE 65,A51,095125,Saad; Andrew S,25,0,26,1
1657179601333,ECE 109,A01,091882,Touri; Behrouz,19,0,70,51
1657179607359,ECE 180,A00,083140,Abi Samra; Nicholas Camill,1,0,30,29
1657179607359,ECE 180,B00,083141,Abi Samra; Nicholas Camill,0,0,30,30
1657179613392,MATH 10A,A01,083735,Patchell; Gregory David,2,0,30,28
1657179613392,MATH 10A,A02,083736,Patchell; Gregory David,20,0,30,10
1657179613392,MATH 10A,A03,083737,Patchell; Gregory David,16,0,30,14
1657179619422,MATH 10B,A01,083207,Lim; Seonhee,7,0,34,27
1657179619422,MATH 10B,A02,083208,Lim; Seonhee,9,0,35,26
1657179619422,MATH 10B,A03,093472,Lim; Seonhee,5,0,34,29
1657179619422,MATH 10B,B01,083739,Sinha; Shubham,10,0,30,20
1657179625453,MATH 18,A01,083743,Cinel; Cameron Alexander,6,0,30,24
1657179625453,MATH 18,A02,083744,Cinel; Cameron Alexander,15,0,30,15
1657179625453,MATH 18,A03,083745,Cinel; Cameron Alexander,8,0,30,22
1657179625453,MATH 18,B01,083748,Rideout; David Porter,4,0,37,33
1657179625453,MATH 18,B02,083749,Rideout; David Porter,4,0,36,32
1657179625453,MATH 18,B03,083750,Rideout; David Porter,2,0,37,35
1657179625453,MATH 18,B04,083751,Rideout; David Porter,5,0,36,31
1657179625453,MATH 18,B05,093473,Rideout; David Porter,5,0,36,31
1657179625453,MATH 18,B06,093474,Rideout; David Porter,5,0,36,31
1657179631479,MATH 20A,A01,083754,Zheng; Zequn,13,0,40,27
1657179637504,MATH 20B,A01,083756,Briones; Jor-el Thomas Caparas,1,0,36,35
1657179637504,MATH 20B,A02,083757,Briones; Jor-el Thomas Caparas,1,0,36,35
1657179637504,MATH 20B,A03,093475,Briones; Jor-el Thomas Caparas,1,0,36,35
1657179643540,MATH 20C,A01,083760,Briones; Jor-el Thomas Caparas,1,0,35,34
1657179643540,MATH 20C,A02,083761,Briones; Jor-el Thomas Caparas,8,0,35,27
1657179643540,MATH 20C,A03,093476,Briones; Jor-el Thomas Caparas,0,1,36,36
1657179643540,MATH 20C,B01,083762,Bach; Quang Tran,1,0,30,29
1657179649566,MATH 20D,A01,083765,Tran; Brian Kha,4,0,30,26
1657179649566,MATH 20D,A02,083766,Tran; Brian Kha,5,0,30,25
1657179649566,MATH 20D,A03,083767,Tran; Brian Kha,4,0,30,26
1657179655593,MATH 20E,A01,083771,Ganguly; Soumya,7,0,32,25
1657179655593,MATH 20E,A02,083772,Ganguly; Soumya,7,0,32,25
1657179655593,MATH 20E,B01,083773,Ciotti; Benjamin,19,0,35,16
1657179655593,MATH 20E,B02,083774,Ciotti; Benjamin,17,0,35,18
1657179661623,MATH 103A,A01,083777,Greenfeld; Be'Eri,2,0,36,34
1657179661623,MATH 103A,A02,083778,Greenfeld; Be'Eri,5,0,36,31
1657179661623,MATH 103A,A03,093561,Greenfeld; Be'Eri,4,0,36,32
1657179661623,MATH 103A,B01,083779,Greenfeld; Be'Eri,6,0,36,30
1657179661623,MATH 103A,B02,083780,Greenfeld; Be'Eri,3,0,36,33
1657179661623,MATH 103A,B03,093562,Greenfeld; Be'Eri,3,0,36,33
1657179667658,MATH 105,A01,085443,Carter; Anne Toulson,14,0,35,21
1657179667658,MATH 105,A02,093477,Carter; Anne Toulson,20,0,35,15
1657179673683,MATH 109,A01,083213,Ganzberger; Geoffrey Michael,2,0,34,32
1657179673683,MATH 109,A02,083214,Ganzberger; Geoffrey Michael,3,0,34,31
1657179673683,MATH 109,A03,093478,Ganzberger; Geoffrey Michael,1,0,34,33
1657179673683,MATH 109,B01,083215,Ganzberger; Geoffrey Michael,1,0,32,31
1657179673683,MATH 109,B02,083216,Ganzberger; Geoffrey Michael,1,0,32,31
1657179673683,MATH 109,B03,093479,Ganzberger; Geoffrey Michael,6,0,32,26
1657179679714,MATH 142A,A01,083219,Chow; Bennett,6,0,32,26
1657179679714,MATH 142A,A02,083220,Chow; Bennett,10,0,32,22
1657179679714,MATH 142A,A03,093480,Chow; Bennett,7,0,32,25
1657179679714,MATH 142A,B03,093481,Chow; Bennett,8,0,32,24
1657179679714,MATH 142A,B04,093558,Chow; Bennett,11,0,32,21
1657179679714,MATH 142A,B05,093559,Chow; Bennett,6,0,32,26
1657179685759,MATH 193A,A01,083224,Rotar; Vladimir,7,0,34,27
1657179685759,MATH 193A,A02,083225,Rotar; Vladimir,5,0,34,29
1657179685759,MATH 193A,A03,083781,Rotar; Vladimir,1,0,34,33
1657179685759,MATH 193A,A04,083782,Rotar; Vladimir,8,0,34,26
1657179685759,MATH 193A,A05,093482,Rotar; Vladimir,6,0,34,28
1657179691788,MATH 197,001,091859,McAuley; Julian John,9999,0,9999,0
1657179691788,MATH 197,002,095566,Kedlaya; Kiran S.,9997,0,9999,2
1657179691788,MATH 197,003,095567,Xiao; Ming,9999,0,9999,0
1657179691788,MATH 197,004,095571,Perols; Johan Lars,9998,0,9999,1
1657179698962,COGS 9,A01,083615,Shannon; Kyle Michael,7,0,75,68
1657179704987,COGS 11,A01,083617,Boyle; Mary E. T.,22,0,48,26
1657179711011,COGS 13,A01,083071,Bastos; Amalia Pinkusfeld,9,0,71,62
1657179717039,COGS 14A,A01,092681,Semenuks; Arturs,1,1,100,99
1657179723068,COGS 14B,A01,083073,Cheng; Tzu-Han,6,0,63,57
1657179729092,COGS 17,A01,092677,Semenuks; Arturs,4,0,81,77
1657179735118,COGS 100,A01,083619,Allen; Michael Gordon,15,0,70,55
1657179741145,COGS 101A,A01,083621,Davis; Joshua Daniel,9,0,68,59
1657179747171,COGS 101B,A01,091572,Allen; Michael Gordon,9,0,65,56
1657179753206,COGS 101C,A01,083625,Delgado; Tania,17,0,35,18
1657179759230,COGS 107A,A01,083627,Boyle; Mary E. T.,13,0,60,47
1657179765254,COGS 118A,A01,083075,Gupta; Anjum,16,0,76,60
1657179771281,CSE 3,A50,083646,Miranda; Gregory Joseph,24,0,50,26
1657179777305,CSE 8A,A50,083650,Miranda; Gregory Joseph,17,1,56,39
1657179783331,CSE 11,A01,083080,Cao; Yingjun,5,15,40,35
1657179789355,CSE 12,A01,083652,Krause-Levy; Sophia Louisa,24,1,120,96
1657179795380,CSE 15L,A01,083654,Morris; Justin Loren,9,0,50,41
1657179795380,CSE 15L,A02,083655,Morris; Justin Loren,9,0,50,41
1657179801408,CSE 20,A01,083657,Tran; Khoa Dang,38,0,80,42
1657179807436,CSE 21,A01,095574,Bach; Quang Tran,22,0,48,26
1657179813462,CSE 30,A01,083084,Eldon; John,4,0,80,76
1657179813462,CSE 30,B01,095061,Bhaskar; Nishant,7,0,50,43
1657179819489,CSE 100,A01,083659,Cao; Yingjun,4,4,70,66
1657179825513,CSE 134B,A01,083661,Powell; Thomas Allan,20,0,100,80
1657179831540,CSE 140,A01,083663,Gungor; Onat,13,0,85,72
1657179837564,CSE 140L,A01,083088,Eldon; John,17,0,100,83
1657179843601,CSE 175,A01,083665,Kumar; Rakesh,3,0,25,22
1657179849627,CSE 190,A00,092507,Dubnov; Shlomo,7,0,20,13
1657179855652,ECE 45,A01,083139,Congero; Spencer William,5,0,75,70
1657179861688,ECE 65,A50,083695,Saad; Andrew S,12,0,30,18
1657179861688,ECE 65,A51,095125,Saad; Andrew S,25,0,26,1
1657179867717,ECE 109,A01,091882,Touri; Behrouz,19,0,70,51
1657179873751,ECE 180,A00,083140,Abi Samra; Nicholas Camill,1,0,30,29
1657179873751,ECE 180,B00,083141,Abi Samra; Nicholas Camill,0,0,30,30
1657179879795,MATH 10A,A01,083735,Patchell; Gregory David,2,0,30,28
1657179879795,MATH 10A,A02,083736,Patchell; Gregory David,20,0,30,10
1657179879795,MATH 10A,A03,083737,Patchell; Gregory David,16,0,30,14
1657179885832,MATH 10B,A01,083207,Lim; Seonhee,7,0,34,27
1657179885832,MATH 10B,A02,083208,Lim; Seonhee,9,0,35,26
1657179885832,MATH 10B,A03,093472,Lim; Seonhee,5,0,34,29
1657179885832,MATH 10B,B01,083739,Sinha; Shubham,10,0,30,20
1657179891862,MATH 18,A01,083743,Cinel; Cameron Alexander,6,0,30,24
1657179891862,MATH 18,A02,083744,Cinel; Cameron Alexander,15,0,30,15
1657179891862,MATH 18,A03,083745,Cinel; Cameron Alexander,8,0,30,22
1657179891862,MATH 18,B01,083748,Rideout; David Porter,4,0,37,33
1657179891862,MATH 18,B02,083749,Rideout; David Porter,4,0,36,32
1657179891862,MATH 18,B03,083750,Rideout; David Porter,2,0,37,35
1657179891862,MATH 18,B04,083751,Rideout; David Porter,5,0,36,31
1657179891862,MATH 18,B05,093473,Rideout; David Porter,5,0,36,31
1657179891862,MATH 18,B06,093474,Rideout; David Porter,5,0,36,31
1657179897889,MATH 20A,A01,083754,Zheng; Zequn,13,0,40,27
1657179903916,MATH 20B,A01,083756,Briones; Jor-el Thomas Caparas,1,0,36,35
1657179903916,MATH 20B,A02,083757,Briones; Jor-el Thomas Caparas,1,0,36,35
1657179903916,MATH 20B,A03,093475,Briones; Jor-el Thomas Caparas,1,0,36,35
1657179909949,MATH 20C,A01,083760,Briones; Jor-el Thomas Caparas,1,0,35,34
1657179909949,MATH 20C,A02,083761,Briones; Jor-el Thomas Caparas,8,0,35,27
1657179909949,MATH 20C,A03,093476,Briones; Jor-el Thomas Caparas,0,1,36,36
1657179909949,MATH 20C,B01,083762,Bach; Quang Tran,1,0,30,29
1657179915976,MATH 20D,A01,083765,Tran; Brian Kha,4,0,30,26
1657179915976,MATH 20D,A02,083766,Tran; Brian Kha,5,0,30,25
1657179915976,MATH 20D,A03,083767,Tran; Brian Kha,4,0,30,26
1657179922015,MATH 20E,A01,083771,Ganguly; Soumya,7,0,32,25
1657179922015,MATH 20E,A02,083772,Ganguly; Soumya,7,0,32,25
1657179922015,MATH 20E,B01,083773,Ciotti; Benjamin,19,0,35,16
1657179922015,MATH 20E,B02,083774,Ciotti; Benjamin,17,0,35,18
1657179928055,MATH 103A,A01,083777,Greenfeld; Be'Eri,2,0,36,34
1657179928055,MATH 103A,A02,083778,Greenfeld; Be'Eri,5,0,36,31
1657179928055,MATH 103A,A03,093561,Greenfeld; Be'Eri,4,0,36,32
1657179928055,MATH 103A,B01,083779,Greenfeld; Be'Eri,6,0,36,30
1657179928055,MATH 103A,B02,083780,Greenfeld; Be'Eri,3,0,36,33
1657179928055,MATH 103A,B03,093562,Greenfeld; Be'Eri,3,0,36,33
1657179934081,MATH 105,A01,085443,Carter; Anne Toulson,14,0,35,21
1657179934081,MATH 105,A02,093477,Carter; Anne Toulson,20,0,35,15
1657179940107,MATH 109,A01,083213,Ganzberger; Geoffrey Michael,2,0,34,32
1657179940107,MATH 109,A02,083214,Ganzberger; Geoffrey Michael,3,0,34,31
1657179940107,MATH 109,A03,093478,Ganzberger; Geoffrey Michael,1,0,34,33
1657179940107,MATH 109,B01,083215,Ganzberger; Geoffrey Michael,1,0,32,31
1657179940107,MATH 109,B02,083216,Ganzberger; Geoffrey Michael,1,0,32,31
1657179940107,MATH 109,B03,093479,Ganzberger; Geoffrey Michael,6,0,32,26
1657179946136,MATH 142A,A01,083219,Chow; Bennett,6,0,32,26
1657179946136,MATH 142A,A02,083220,Chow; Bennett,10,0,32,22
1657179946136,MATH 142A,A03,093480,Chow; Bennett,7,0,32,25
1657179946136,MATH 142A,B03,093481,Chow; Bennett,8,0,32,24
1657179946136,MATH 142A,B04,093558,Chow; Bennett,11,0,32,21
1657179946136,MATH 142A,B05,093559,Chow; Bennett,6,0,32,26
1657179952169,MATH 193A,A01,083224,Rotar; Vladimir,7,0,34,27
1657179952169,MATH 193A,A02,083225,Rotar; Vladimir,5,0,34,29
1657179952169,MATH 193A,A03,083781,Rotar; Vladimir,1,0,34,33
1657179952169,MATH 193A,A04,083782,Rotar; Vladimir,8,0,34,26
1657179952169,MATH 193A,A05,093482,Rotar; Vladimir,6,0,34,28
1657179958194,MATH 197,001,091859,McAuley; Julian John,9999,0,9999,0
1657179958194,MATH 197,002,095566,Kedlaya; Kiran S.,9997,0,9999,2
1657179958194,MATH 197,003,095567,Xiao; Ming,9999,0,9999,0
1657179958194,MATH 197,004,095571,Perols; Johan Lars,9998,0,9999,1
1657179965271,COGS 9,A01,083615,Shannon; Kyle Michael,7,0,75,68
1657179971301,COGS 11,A01,083617,Boyle; Mary E. T.,22,0,48,26
1657179977328,COGS 13,A01,083071,Bastos; Amalia Pinkusfeld,9,0,71,62
1657179983370,COGS 14A,A01,092681,Semenuks; Arturs,1,1,100,99
1657179989400,COGS 14B,A01,083073,Cheng; Tzu-Han,6,0,63,57
1657179995431,COGS 17,A01,092677,Semenuks; Arturs,4,0,81,77
1657180001457,COGS 100,A01,083619,Allen; Michael Gordon,15,0,70,55
1657180007483,COGS 101A,A01,083621,Davis; Joshua Daniel,9,0,68,59
1657180013508,COGS 101B,A01,091572,Allen; Michael Gordon,9,0,65,56
1657180019534,COGS 101C,A01,083625,Delgado; Tania,17,0,35,18
1657180025557,COGS 107A,A01,083627,Boyle; Mary E. T.,13,0,60,47
1657180031587,COGS 118A,A01,083075,Gupta; Anjum,16,0,76,60
1657180037621,CSE 3,A50,083646,Miranda; Gregory Joseph,24,0,50,26
1657180043646,CSE 8A,A50,083650,Miranda; Gregory Joseph,17,1,56,39
1657180049672,CSE 11,A01,083080,Cao; Yingjun,5,15,40,35
1657180055698,CSE 12,A01,083652,Krause-Levy; Sophia Louisa,24,1,120,96
1657180061727,CSE 15L,A01,083654,Morris; Justin Loren,9,0,50,41
1657180061727,CSE 15L,A02,083655,Morris; Justin Loren,9,0,50,41
1657180067753,CSE 20,A01,083657,Tran; Khoa Dang,38,0,80,42
1657180073777,CSE 21,A01,095574,Bach; Quang Tran,22,0,48,26
1657180079812,CSE 30,A01,083084,Eldon; John,4,0,80,76
1657180079812,CSE 30,B01,095061,Bhaskar; Nishant,7,0,50,43
1657180085843,CSE 100,A01,083659,Cao; Yingjun,4,4,70,66
1657180091867,CSE 134B,A01,083661,Powell; Thomas Allan,20,0,100,80
1657180097893,CSE 140,A01,083663,Gungor; Onat,13,0,85,72
1657180103922,CSE 140L,A01,083088,Eldon; John,17,0,100,83
1657180109948,CSE 175,A01,083665,Kumar; Rakesh,3,0,25,22
1657180115975,CSE 190,A00,092507,Dubnov; Shlomo,7,0,20,13
1657180122010,ECE 45,A01,083139,Congero; Spencer William,5,0,75,70
1657180128039,ECE 65,A50,083695,Saad; Andrew S,12,0,30,18
1657180128039,ECE 65,A51,095125,Saad; Andrew S,25,0,26,1
1657180134070,ECE 109,A01,091882,Touri; Behrouz,19,0,70,51
1657180140095,ECE 180,A00,083140,Abi Samra; Nicholas Camill,1,0,30,29
1657180140095,ECE 180,B00,083141,Abi Samra; Nicholas Camill,0,0,30,30
1657180146122,MATH 10A,A01,083735,Patchell; Gregory David,2,0,30,28
1657180146122,MATH 10A,A02,083736,Patchell; Gregory David,20,0,30,10
1657180146122,MATH 10A,A03,083737,Patchell; Gregory David,16,0,30,14
1657180152163,MATH 10B,A01,083207,Lim; Seonhee,7,0,34,27
1657180152163,MATH 10B,A02,083208,Lim; Seonhee,9,0,35,26
1657180152163,MATH 10B,A03,093472,Lim; Seonhee,5,0,34,29
1657180152163,MATH 10B,B01,083739,Sinha; Shubham,10,0,30,20
1657180158195,MATH 18,A01,083743,Cinel; Cameron Alexander,6,0,30,24
1657180158195,MATH 18,A02,083744,Cinel; Cameron Alexander,15,0,30,15
1657180158195,MATH 18,A03,083745,Cinel; Cameron Alexander,8,0,30,22
1657180158195,MATH 18,B01,083748,Rideout; David Porter,4,0,37,33
1657180158195,MATH 18,B02,083749,Rideout; David Porter,4,0,36,32
1657180158195,MATH 18,B03,083750,Rideout; David Porter,2,0,37,35
1657180158195,MATH 18,B04,083751,Rideout; David Porter,5,0,36,31
1657180158195,MATH 18,B05,093473,Rideout; David Porter,5,0,36,31
1657180158195,MATH 18,B06,093474,Rideout; David Porter,5,0,36,31
1657180164224,MATH 20A,A01,083754,Zheng; Zequn,13,0,40,27
1657180170258,MATH 20B,A01,083756,Briones; Jor-el Thomas Caparas,1,0,36,35
1657180170258,MATH 20B,A02,083757,Briones; Jor-el Thomas Caparas,1,0,36,35
1657180170258,MATH 20B,A03,093475,Briones; Jor-el Thomas Caparas,1,0,36,35
1657180176292,MATH 20C,A01,083760,Briones; Jor-el Thomas Caparas,1,0,35,34
1657180176292,MATH 20C,A02,083761,Briones; Jor-el Thomas Caparas,8,0,35,27
1657180176292,MATH 20C,A03,093476,Briones; Jor-el Thomas Caparas,0,1,36,36
1657180176292,MATH 20C,B01,083762,Bach; Quang Tran,1,0,30,29
1657180182319,MATH 20D,A01,083765,Tran; Brian Kha,4,0,30,26
1657180182319,MATH 20D,A02,083766,Tran; Brian Kha,5,0,30,25
1657180182319,MATH 20D,A03,083767,Tran; Brian Kha,4,0,30,26
1657180188348,MATH 20E,A01,083771,Ganguly; Soumya,7,0,32,25
1657180188348,MATH 20E,A02,083772,Ganguly; Soumya,7,0,32,25
1657180188348,MATH 20E,B01,083773,Ciotti; Benjamin,19,0,35,16
1657180188348,MATH 20E,B02,083774,Ciotti; Benjamin,17,0,35,18
1657180194375,MATH 103A,A01,083777,Greenfeld; Be'Eri,2,0,36,34
1657180194375,MATH 103A,A02,083778,Greenfeld; Be'Eri,5,0,36,31
1657180194375,MATH 103A,A03,093561,Greenfeld; Be'Eri,4,0,36,32
1657180194375,MATH 103A,B01,083779,Greenfeld; Be'Eri,6,0,36,30
1657180194375,MATH 103A,B02,083780,Greenfeld; Be'Eri,3,0,36,33
1657180194375,MATH 103A,B03,093562,Greenfeld; Be'Eri,3,0,36,33
1657180200402,MATH 105,A01,085443,Carter; Anne Toulson,14,0,35,21
1657180200402,MATH 105,A02,093477,Carter; Anne Toulson,20,0,35,15
1657180206438,MATH 109,A01,083213,Ganzberger; Geoffrey Michael,2,0,34,32
1657180206438,MATH 109,A02,083214,Ganzberger; Geoffrey Michael,3,0,34,31
1657180206438,MATH 109,A03,093478,Ganzberger; Geoffrey Michael,1,0,34,33
1657180206438,MATH 109,B01,083215,Ganzberger; Geoffrey Michael,1,0,32,31
1657180206438,MATH 109,B02,083216,Ganzberger; Geoffrey Michael,1,0,32,31
1657180206438,MATH 109,B03,093479,Ganzberger; Geoffrey Michael,6,0,32,26
1657180212474,MATH 142A,A01,083219,Chow; Bennett,6,0,32,26
1657180212474,MATH 142A,A02,083220,Chow; Bennett,10,0,32,22
1657180212474,MATH 142A,A03,093480,Chow; Bennett,7,0,32,25
1657180212474,MATH 142A,B03,093481,Chow; Bennett,8,0,32,24
1657180212474,MATH 142A,B04,093558,Chow; Bennett,11,0,32,21
1657180212474,MATH 142A,B05,093559,Chow; Bennett,6,0,32,26
1657180218508,MATH 193A,A01,083224,Rotar; Vladimir,7,0,34,27
1657180218508,MATH 193A,A02,083225,Rotar; Vladimir,5,0,34,29
1657180218508,MATH 193A,A03,083781,Rotar; Vladimir,1,0,34,33
1657180218508,MATH 193A,A04,083782,Rotar; Vladimir,8,0,34,26
1657180218508,MATH 193A,A05,093482,Rotar; Vladimir,6,0,34,28
1657180224535,MATH 197,001,091859,McAuley; Julian John,9999,0,9999,0
1657180224535,MATH 197,002,095566,Kedlaya; Kiran S.,9997,0,9999,2
1657180224535,MATH 197,003,095567,Xiao; Ming,9999,0,9999,0
1657180224535,MATH 197,004,095571,Perols; Johan Lars,9998,0,9999,1
1657180231616,COGS 9,A01,083615,Shannon; Kyle Michael,7,0,75,68
1657180237639,COGS 11,A01,083617,Boyle; Mary E. T.,22,0,48,26
1657180243664,COGS 13,A01,083071,Bastos; Amalia Pinkusfeld,9,0,71,62
1657180249687,COGS 14A,A01,092681,Semenuks; Arturs,1,1,100,99
1657180255719,COGS 14B,A01,083073,Cheng; Tzu-Han,6,0,63,57
1657180261749,COGS 17,A01,092677,Semenuks; Arturs,4,0,81,77
1657180267771,COGS 100,A01,083619,Allen; Michael Gordon,15,0,70,55
1657180273799,COGS 101A,A01,083621,Davis; Joshua Daniel,9,0,68,59
1657180279830,COGS 101B,A01,091572,Allen; Michael Gordon,9,0,65,56
1657180285857,COGS 101C,A01,083625,Delgado; Tania,17,0,35,18
1657180291955,COGS 107A,A01,083627,Boyle; Mary E. T.,13,0,60,47
1657180297981,COGS 118A,A01,083075,Gupta; Anjum,16,0,76,60
1657180304008,CSE 3,A50,083646,Miranda; Gregory Joseph,24,0,50,26
1657180310034,CSE 8A,A50,083650,Miranda; Gregory Joseph,17,1,56,39
1657180316059,CSE 11,A01,083080,Cao; Yingjun,5,15,40,35
1657180322085,CSE 12,A01,083652,Krause-Levy; Sophia Louisa,24,1,120,96
1657180328115,CSE 15L,A01,083654,Morris; Justin Loren,9,0,50,41
1657180328115,CSE 15L,A02,083655,Morris; Justin Loren,9,0,50,41
1657180334147,CSE 20,A01,083657,Tran; Khoa Dang,38,0,80,42
1657180340181,CSE 21,A01,095574,Bach; Quang Tran,22,0,48,26
1657180346207,CSE 30,A01,083084,Eldon; John,4,0,80,76
1657180346207,CSE 30,B01,095061,Bhaskar; Nishant,7,0,50,43
1657180352239,CSE 100,A01,083659,Cao; Yingjun,4,4,70,66
1657180358264,CSE 134B,A01,083661,Powell; Thomas Allan,20,0,100,80
1657180364294,CSE 140,A01,083663,Gungor; Onat,13,0,85,72
1657180370319,CSE 140L,A01,083088,Eldon; John,17,0,100,83
1657180376343,CSE 175,A01,083665,Kumar; Rakesh,3,0,25,22
1657180382386,CSE 190,A00,092507,Dubnov; Shlomo,7,0,20,13
1657180388416,ECE 45,A01,083139,Congero; Spencer William,5,0,75,70
1657180394441,ECE 65,A50,083695,Saad; Andrew S,12,0,30,18
1657180394441,ECE 65,A51,095125,Saad; Andrew S,25,0,26,1
1657180400467,ECE 109,A01,091882,Touri; Behrouz,19,0,70,51
1657180406499,ECE 180,A00,083140,Abi Samra; Nicholas Camill,1,0,30,29
1657180406499,ECE 180,B00,083141,Abi Samra; Nicholas Camill,0,0,30,30
1657180412530,MATH 10A,A01,083735,Patchell; Gregory David,2,0,30,28
1657180412530,MATH 10A,A02,083736,Patchell; Gregory David,20,0,30,10
1657180412530,MATH 10A,A03,083737,Patchell; Gregory David,16,0,30,14
1657180418558,MATH 10B,A01,083207,Lim; Seonhee,7,0,34,27
1657180418558,MATH 10B,A02,083208,Lim; Seonhee,9,0,35,26
1657180418558,MATH 10B,A03,093472,Lim; Seonhee,5,0,34,29
1657180418558,MATH 10B,B01,083739,Sinha; Shubham,10,0,30,20
1657180424595,MATH 18,A01,083743,Cinel; Cameron Alexander,6,0,30,24
1657180424595,MATH 18,A02,083744,Cinel; Cameron Alexander,15,0,30,15
1657180424595,MATH 18,A03,083745,Cinel; Cameron Alexander,8,0,30,22
1657180424595,MATH 18,B01,083748,Rideout; David Porter,4,0,37,33
1657180424595,MATH 18,B02,083749,Rideout; David Porter,4,0,36,32
1657180424595,MATH 18,B03,083750,Rideout; David Porter,2,0,37,35
1657180424595,MATH 18,B04,083751,Rideout; David Porter,5,0,36,31
1657180424595,MATH 18,B05,093473,Rideout; David Porter,5,0,36,31
1657180424595,MATH 18,B06,093474,Rideout; David Porter,5,0,36,31
1657180430630,MATH 20A,A01,083754,Zheng; Zequn,13,0,40,27
1657180436656,MATH 20B,A01,083756,Briones; Jor-el Thomas Caparas,1,0,36,35
1657180436656,MATH 20B,A02,083757,Briones; Jor-el Thomas Caparas,1,0,36,35
1657180436656,MATH 20B,A03,093475,Briones; Jor-el Thomas Caparas,1,0,36,35
1657180442683,MATH 20C,A01,083760,Briones; Jor-el Thomas Caparas,1,0,35,34
1657180442683,MATH 20C,A02,083761,Briones; Jor-el Thomas Caparas,8,0,35,27
1657180442683,MATH 20C,A03,093476,Briones; Jor-el Thomas Caparas,0,1,36,36
1657180442683,MATH 20C,B01,083762,Bach; Quang Tran,1,0,30,29
1657180448709,MATH 20D,A01,083765,Tran; Brian Kha,4,0,30,26
1657180448709,MATH 20D,A02,083766,Tran; Brian Kha,5,0,30,25
1657180448709,MATH 20D,A03,083767,Tran; Brian Kha,4,0,30,26
1657180454735,MATH 20E,A01,083771,Ganguly; Soumya,7,0,32,25
1657180454735,MATH 20E,A02,083772,Ganguly; Soumya,7,0,32,25
1657180454735,MATH 20E,B01,083773,Ciotti; Benjamin,19,0,35,16
1657180454735,MATH 20E,B02,083774,Ciotti; Benjamin,17,0,35,18
1657180460770,MATH 103A,A01,083777,Greenfeld; Be'Eri,2,0,36,34
1657180460770,MATH 103A,A02,083778,Greenfeld; Be'Eri,5,0,36,31
1657180460770,MATH 103A,A03,093561,Greenfeld; Be'Eri,4,0,36,32
1657180460770,MATH 103A,B01,083779,Greenfeld; Be'Eri,6,0,36,30
1657180460770,MATH 103A,B02,083780,Greenfeld; Be'Eri,3,0,36,33
1657180460770,MATH 103A,B03,093562,Greenfeld; Be'Eri,3,0,36,33
1657180466798,MATH 105,A01,085443,Carter; Anne Toulson,14,0,35,21
1657180466798,MATH 105,A02,093477,Carter; Anne Toulson,20,0,35,15
1657180472826,MATH 109,A01,083213,Ganzberger; Geoffrey Michael,2,0,34,32
1657180472826,MATH 109,A02,083214,Ganzberger; Geoffrey Michael,3,0,34,31
1657180472826,MATH 109,A03,093478,Ganzberger; Geoffrey Michael,1,0,34,33
1657180472826,MATH 109,B01,083215,Ganzberger; Geoffrey Michael,1,0,32,31
1657180472826,MATH 109,B02,083216,Ganzberger; Geoffrey Michael,1,0,32,31
1657180472826,MATH 109,B03,093479,Ganzberger; Geoffrey Michael,6,0,32,26
1657180478857,MATH 142A,A01,083219,Chow; Bennett,6,0,32,26
1657180478857,MATH 142A,A02,083220,Chow; Bennett,10,0,32,22
1657180478857,MATH 142A,A03,093480,Chow; Bennett,7,0,32,25
1657180478857,MATH 142A,B03,093481,Chow; Bennett,8,0,32,24
1657180478857,MATH 142A,B04,093558,Chow; Bennett,11,0,32,21
1657180478857,MATH 142A,B05,093559,Chow; Bennett,6,0,32,26
1657180484886,MATH 193A,A01,083224,Rotar; Vladimir,7,0,34,27
1657180484886,MATH 193A,A02,083225,Rotar; Vladimir,5,0,34,29
1657180484886,MATH 193A,A03,083781,Rotar; Vladimir,1,0,34,33
1657180484886,MATH 193A,A04,083782,Rotar; Vladimir,8,0,34,26
1657180484886,MATH 193A,A05,093482,Rotar; Vladimir,6,0,34,28
1657180490915,MATH 197,001,091859,McAuley; Julian John,9999,0,9999,0
1657180490915,MATH 197,002,095566,Kedlaya; Kiran S.,9997,0,9999,2
1657180490915,MATH 197,003,095567,Xiao; Ming,9999,0,9999,0
1657180490915,MATH 197,004,095571,Perols; Johan Lars,9998,0,9999,1
1657180497974,COGS 9,A01,083615,Shannon; Kyle Michael,7,0,75,68
1657180503999,COGS 11,A01,083617,Boyle; Mary E. T.,22,0,48,26
1657180510024,COGS 13,A01,083071,Bastos; Amalia Pinkusfeld,9,0,71,62
1657180516053,COGS 14A,A01,092681,Semenuks; Arturs,1,1,100,99
1657180522081,COGS 14B,A01,083073,Cheng; Tzu-Han,6,0,63,57
1657180528103,COGS 17,A01,092677,Semenuks; Arturs,4,0,81,77
1657180534129,COGS 100,A01,083619,Allen; Michael Gordon,15,0,70,55
1657180540157,COGS 101A,A01,083621,Davis; Joshua Daniel,9,0,68,59
1657180546181,COGS 101B,A01,091572,Allen; Michael Gordon,9,0,65,56
1657180552215,COGS 101C,A01,083625,Delgado; Tania,17,0,35,18
1657180558240,COGS 107A,A01,083627,Boyle; Mary E. T.,13,0,60,47
1657180564264,COGS 118A,A01,083075,Gupta; Anjum,16,0,76,60
1657180570288,CSE 3,A50,083646,Miranda; Gregory Joseph,24,0,50,26
1657180576326,CSE 8A,A50,083650,Miranda; Gregory Joseph,17,1,56,39
1657180582350,CSE 11,A01,083080,Cao; Yingjun,5,15,40,35
1657180588382,CSE 12,A01,083652,Krause-Levy; Sophia Louisa,24,1,120,96
1657180594415,CSE 15L,A01,083654,Morris; Justin Loren,9,0,50,41
1657180594415,CSE 15L,A02,083655,Morris; Justin Loren,9,0,50,41
1657180600440,CSE 20,A01,083657,Tran; Khoa Dang,38,0,80,42
1657180606472,CSE 21,A01,095574,Bach; Quang Tran,22,0,48,26
1657180612508,CSE 30,A01,083084,Eldon; John,4,0,80,76
1657180612508,CSE 30,B01,095061,Bhaskar; Nishant,7,0,50,43
1657180618532,CSE 100,A01,083659,Cao; Yingjun,4,4,70,66
1657180624562,CSE 134B,A01,083661,Powell; Thomas Allan,20,0,100,80
1657180630593,CSE 140,A01,083663,Gungor; Onat,13,0,85,72
1657180636620,CSE 140L,A01,083088,Eldon; John,17,0,100,83
1657180642644,CSE 175,A01,083665,Kumar; Rakesh,3,0,25,22
1657180648670,CSE 190,A00,092507,Dubnov; Shlomo,7,0,20,13
1657180654697,ECE 45,A01,083139,Congero; Spencer William,5,0,75,70
1657180660724,ECE 65,A50,083695,Saad; Andrew S,12,0,30,18
1657180660724,ECE 65,A51,095125,Saad; Andrew S,25,0,26,1
1657180666746,ECE 109,A01,091882,Touri; Behrouz,19,0,70,51
1657180672774,ECE 180,A00,083140,Abi Samra; Nicholas Camill,1,0,30,29
1657180672774,ECE 180,B00,083141,Abi Samra; Nicholas Camill,0,0,30,30
1657180678798,MATH 10A,A01,083735,Patchell; Gregory David,2,0,30,28
1657180678798,MATH 10A,A02,083736,Patchell; Gregory David,20,0,30,10
1657180678798,MATH 10A,A03,083737,Patchell; Gregory David,16,0,30,14
1657180684840,MATH 10B,A01,083207,Lim; Seonhee,7,0,34,27
1657180684840,MATH 10B,A02,083208,Lim; Seonhee,9,0,35,26
1657180684840,MATH 10B,A03,093472,Lim; Seonhee,5,0,34,29
1657180684840,MATH 10B,B01,083739,Sinha; Shubham,10,0,30,20
1657180690882,MATH 18,A01,083743,Cinel; Cameron Alexander,6,0,30,24
1657180690882,MATH 18,A02,083744,Cinel; Cameron Alexander,15,0,30,15
1657180690882,MATH 18,A03,083745,Cinel; Cameron Alexander,8,0,30,22
1657180690882,MATH 18,B01,083748,Rideout; David Porter,4,0,37,33
1657180690882,MATH 18,B02,083749,Rideout; David Porter,4,0,36,32
1657180690882,MATH 18,B03,083750,Rideout; David Porter,2,0,37,35
1657180690882,MATH 18,B04,083751,Rideout; David Porter,5,0,36,31
1657180690882,MATH 18,B05,093473,Rideout; David Porter,5,0,36,31
1657180690882,MATH 18,B06,093474,Rideout; David Porter,5,0,36,31
1657180696906,MATH 20A,A01,083754,Zheng; Zequn,13,0,40,27
1657180702932,MATH 20B,A01,083756,Briones; Jor-el Thomas Caparas,1,0,36,35
1657180702932,MATH 20B,A02,083757,Briones; Jor-el Thomas Caparas,1,0,36,35
1657180702932,MATH 20B,A03,093475,Briones; Jor-el Thomas Caparas,1,0,36,35
1657180708962,MATH 20C,A01,083760,Briones; Jor-el Thomas Caparas,1,0,35,34
1657180708962,MATH 20C,A02,083761,Briones; Jor-el Thomas Caparas,8,0,35,27
1657180708962,MATH 20C,A03,093476,Briones; Jor-el Thomas Caparas,0,1,36,36
1657180708962,MATH 20C,B01,083762,Bach; Quang Tran,1,0,30,29
1657180714994,MATH 20D,A01,083765,Tran; Brian Kha,4,0,30,26
1657180714994,MATH 20D,A02,083766,Tran; Brian Kha,5,0,30,25
1657180714994,MATH 20D,A03,083767,Tran; Brian Kha,4,0,30,26
1657180721031,MATH 20E,A01,083771,Ganguly; Soumya,7,0,32,25
1657180721031,MATH 20E,A02,083772,Ganguly; Soumya,7,0,32,25
1657180721031,MATH 20E,B01,083773,Ciotti; Benjamin,19,0,35,16
1657180721031,MATH 20E,B02,083774,Ciotti; Benjamin,17,0,35,18
1657180727065,MATH 103A,A01,083777,Greenfeld; Be'Eri,2,0,36,34
1657180727065,MATH 103A,A02,083778,Greenfeld; Be'Eri,5,0,36,31
1657180727065,MATH 103A,A03,093561,Greenfeld; Be'Eri,4,0,36,32
1657180727065,MATH 103A,B01,083779,Greenfeld; Be'Eri,6,0,36,30
1657180727065,MATH 103A,B02,083780,Greenfeld; Be'Eri,3,0,36,33
1657180727065,MATH 103A,B03,093562,Greenfeld; Be'Eri,3,0,36,33
1657180733091,MATH 105,A01,085443,Carter; Anne Toulson,14,0,35,21
1657180733091,MATH 105,A02,093477,Carter; Anne Toulson,20,0,35,15
1657180739117,MATH 109,A01,083213,Ganzberger; Geoffrey Michael,2,0,34,32
1657180739117,MATH 109,A02,083214,Ganzberger; Geoffrey Michael,3,0,34,31
1657180739117,MATH 109,A03,093478,Ganzberger; Geoffrey Michael,1,0,34,33
1657180739117,MATH 109,B01,083215,Ganzberger; Geoffrey Michael,1,0,32,31
1657180739117,MATH 109,B02,083216,Ganzberger; Geoffrey Michael,1,0,32,31
1657180739117,MATH 109,B03,093479,Ganzberger; Geoffrey Michael,6,0,32,26
1657180745143,MATH 142A,A01,083219,Chow; Bennett,6,0,32,26
1657180745143,MATH 142A,A02,083220,Chow; Bennett,10,0,32,22
1657180745143,MATH 142A,A03,093480,Chow; Bennett,7,0,32,25
1657180745143,MATH 142A,B03,093481,Chow; Bennett,8,0,32,24
1657180745143,MATH 142A,B04,093558,Chow; Bennett,11,0,32,21
1657180745143,MATH 142A,B05,093559,Chow; Bennett,6,0,32,26
1657180751173,MATH 193A,A01,083224,Rotar; Vladimir,7,0,34,27
1657180751173,MATH 193A,A02,083225,Rotar; Vladimir,5,0,34,29
1657180751173,MATH 193A,A03,083781,Rotar; Vladimir,1,0,34,33
1657180751173,MATH 193A,A04,083782,Rotar; Vladimir,8,0,34,26
1657180751173,MATH 193A,A05,093482,Rotar; Vladimir,6,0,34,28
1657180757202,MATH 197,001,091859,McAuley; Julian John,9999,0,9999,0
1657180757202,MATH 197,002,095566,Kedlaya; Kiran S.,9997,0,9999,2
1657180757202,MATH 197,003,095567,Xiao; Ming,9999,0,9999,0
1657180757202,MATH 197,004,095571,Perols; Johan Lars,9998,0,9999,1
1657180764277,COGS 9,A01,083615,Shannon; Kyle Michael,7,0,75,68
1657180770306,COGS 11,A01,083617,Boyle; Mary E. T.,22,0,48,26
1657180776330,COGS 13,A01,083071,Bastos; Amalia Pinkusfeld,9,0,71,62
1657180782356,COGS 14A,A01,092681,Semenuks; Arturs,1,1,100,99
1657180788387,COGS 14B,A01,083073,Cheng; Tzu-Han,6,0,63,57
1657180794411,COGS 17,A01,092677,Semenuks; Arturs,4,0,81,77
1657180800439,COGS 100,A01,083619,Allen; Michael Gordon,15,0,70,55
1657180806463,COGS 101A,A01,083621,Davis; Joshua Daniel,9,0,68,59
1657180812488,COGS 101B,A01,091572,Allen; Michael Gordon,9,0,65,56
1657180818512,COGS 101C,A01,083625,Delgado; Tania,17,0,35,18
1657180824539,COGS 107A,A01,083627,Boyle; Mary E. T.,13,0,60,47
1657180830568,COGS 118A,A01,083075,Gupta; Anjum,16,0,76,60
1657180836594,CSE 3,A50,083646,Miranda; Gregory Joseph,24,0,50,26
1657180842623,CSE 8A,A50,083650,Miranda; Gregory Joseph,17,1,56,39
1657180848652,CSE 11,A01,083080,Cao; Yingjun,5,15,40,35
1657180854676,CSE 12,A01,083652,Krause-Levy; Sophia Louisa,24,1,120,96
1657180860701,CSE 15L,A01,083654,Morris; Justin Loren,9,0,50,41
1657180860701,CSE 15L,A02,083655,Morris; Justin Loren,9,0,50,41
1657180866730,CSE 20,A01,083657,Tran; Khoa Dang,38,0,80,42
1657180872754,CSE 21,A01,095574,Bach; Quang Tran,22,0,48,26
1657180878779,CSE 30,A01,083084,Eldon; John,4,0,80,76
1657180878779,CSE 30,B01,095061,Bhaskar; Nishant,7,0,50,43
1657180884805,CSE 100,A01,083659,Cao; Yingjun,4,4,70,66
1657180890927,CSE 134B,A01,083661,Powell; Thomas Allan,20,0,100,80
1657180896958,CSE 140,A01,083663,Gungor; Onat,13,0,85,72
1657180902981,CSE 140L,A01,083088,Eldon; John,17,0,100,83
1657180909006,CSE 175,A01,083665,Kumar; Rakesh,3,0,25,22
1657180915034,CSE 190,A00,092507,Dubnov; Shlomo,7,0,20,13
1657180921058,ECE 45,A01,083139,Congero; Spencer William,5,0,75,70
1657180927083,ECE 65,A50,083695,Saad; Andrew S,12,0,30,18
1657180927083,ECE 65,A51,095125,Saad; Andrew S,25,0,26,1
1657180933112,ECE 109,A01,091882,Touri; Behrouz,19,0,70,51
1657180939138,ECE 180,A00,083140,Abi Samra; Nicholas Camill,1,0,30,29
1657180939138,ECE 180,B00,083141,Abi Samra; Nicholas Camill,0,0,30,30
1657180945165,MATH 10A,A01,083735,Patchell; Gregory David,2,0,30,28
1657180945165,MATH 10A,A02,083736,Patchell; Gregory David,20,0,30,10
1657180945165,MATH 10A,A03,083737,Patchell; Gregory David,16,0,30,14
1657180951198,MATH 10B,A01,083207,Lim; Seonhee,7,0,34,27
1657180951198,MATH 10B,A02,083208,Lim; Seonhee,9,0,35,26
1657180951198,MATH 10B,A03,093472,Lim; Seonhee,5,0,34,29
1657180951198,MATH 10B,B01,083739,Sinha; Shubham,10,0,30,20
1657180957223,MATH 18,A01,083743,Cinel; Cameron Alexander,6,0,30,24
1657180957223,MATH 18,A02,083744,Cinel; Cameron Alexander,15,0,30,15
1657180957223,MATH 18,A03,083745,Cinel; Cameron Alexander,8,0,30,22
1657180957223,MATH 18,B01,083748,Rideout; David Porter,4,0,37,33
1657180957223,MATH 18,B02,083749,Rideout; David Porter,4,0,36,32
1657180957223,MATH 18,B03,083750,Rideout; David Porter,2,0,37,35
1657180957223,MATH 18,B04,083751,Rideout; David Porter,5,0,36,31
1657180957223,MATH 18,B05,093473,Rideout; David Porter,5,0,36,31
1657180957223,MATH 18,B06,093474,Rideout; David Porter,5,0,36,31
1657180963246,MATH 20A,A01,083754,Zheng; Zequn,13,0,40,27
1657180969277,MATH 20B,A01,083756,Briones; Jor-el Thomas Caparas,1,0,36,35
1657180969277,MATH 20B,A02,083757,Briones; Jor-el Thomas Caparas,1,0,36,35
1657180969277,MATH 20B,A03,093475,Briones; Jor-el Thomas Caparas,1,0,36,35
1657180975305,MATH 20C,A01,083760,Briones; Jor-el Thomas Caparas,1,0,35,34
1657180975305,MATH 20C,A02,083761,Briones; Jor-el Thomas Caparas,8,0,35,27
1657180975305,MATH 20C,A03,093476,Briones; Jor-el Thomas Caparas,0,1,36,36
1657180975305,MATH 20C,B01,083762,Bach; Quang Tran,1,0,30,29
1657180981336,MATH 20D,A01,083765,Tran; Brian Kha,4,0,30,26
1657180981336,MATH 20D,A02,083766,Tran; Brian Kha,5,0,30,25
1657180981336,MATH 20D,A03,083767,Tran; Brian Kha,4,0,30,26
1657180987360,MATH 20E,A01,083771,Ganguly; Soumya,7,0,32,25
1657180987360,MATH 20E,A02,083772,Ganguly; Soumya,7,0,32,25
1657180987360,MATH 20E,B01,083773,Ciotti; Benjamin,19,0,35,16
1657180987360,MATH 20E,B02,083774,Ciotti; Benjamin,17,0,35,18
1657180993385,MATH 103A,A01,083777,Greenfeld; Be'Eri,2,0,36,34
1657180993385,MATH 103A,A02,083778,Greenfeld; Be'Eri,5,0,36,31
1657180993385,MATH 103A,A03,093561,Greenfeld; Be'Eri,4,0,36,32
1657180993385,MATH 103A,B01,083779,Greenfeld; Be'Eri,6,0,36,30
1657180993385,MATH 103A,B02,083780,Greenfeld; Be'Eri,3,0,36,33
1657180993385,MATH 103A,B03,093562,Greenfeld; Be'Eri,3,0,36,33
1657180999415,MATH 105,A01,085443,Carter; Anne Toulson,14,0,35,21
1657180999415,MATH 105,A02,093477,Carter; Anne Toulson,20,0,35,15
1657181005440,MATH 109,A01,083213,Ganzberger; Geoffrey Michael,2,0,34,32
1657181005440,MATH 109,A02,083214,Ganzberger; Geoffrey Michael,3,0,34,31
1657181005440,MATH 109,A03,093478,Ganzberger; Geoffrey Michael,1,0,34,33
1657181005440,MATH 109,B01,083215,Ganzberger; Geoffrey Michael,1,0,32,31
1657181005440,MATH 109,B02,083216,Ganzberger; Geoffrey Michael,1,0,32,31
1657181005440,MATH 109,B03,093479,Ganzberger; Geoffrey Michael,6,0,32,26
1657181011469,MATH 142A,A01,083219,Chow; Bennett,6,0,32,26
1657181011469,MATH 142A,A02,083220,Chow; Bennett,10,0,32,22
1657181011469,MATH 142A,A03,093480,Chow; Bennett,7,0,32,25
1657181011469,MATH 142A,B03,093481,Chow; Bennett,8,0,32,24
1657181011469,MATH 142A,B04,093558,Chow; Bennett,11,0,32,21
1657181011469,MATH 142A,B05,093559,Chow; Bennett,6,0,32,26
1657181017500,MATH 193A,A01,083224,Rotar; Vladimir,7,0,34,27
1657181017500,MATH 193A,A02,083225,Rotar; Vladimir,5,0,34,29
1657181017500,MATH 193A,A03,083781,Rotar; Vladimir,1,0,34,33
1657181017500,MATH 193A,A04,083782,Rotar; Vladimir,8,0,34,26
1657181017500,MATH 193A,A05,093482,Rotar; Vladimir,6,0,34,28
1657181023525,MATH 197,001,091859,McAuley; Julian John,9999,0,9999,0
1657181023525,MATH 197,002,095566,Kedlaya; Kiran S.,9997,0,9999,2
1657181023525,MATH 197,003,095567,Xiao; Ming,9999,0,9999,0
1657181023525,MATH 197,004,095571,Perols; Johan Lars,9998,0,9999,1
1657181030587,COGS 9,A01,083615,Shannon; Kyle Michael,7,0,75,68
1657181036615,COGS 11,A01,083617,Boyle; Mary E. T.,22,0,48,26
1657181042641,COGS 13,A01,083071,Bastos; Amalia Pinkusfeld,9,0,71,62
1657181048669,COGS 14A,A01,092681,Semenuks; Arturs,1,1,100,99
1657181054694,COGS 14B,A01,083073,Cheng; Tzu-Han,6,0,63,57
1657181060723,COGS 17,A01,092677,Semenuks; Arturs,4,0,81,77
1657181066750,COGS 100,A01,083619,Allen; Michael Gordon,15,0,70,55
1657181072773,COGS 101A,A01,083621,Davis; Joshua Daniel,9,0,68,59
1657181078802,COGS 101B,A01,091572,Allen; Michael Gordon,9,0,65,56
1657181084825,COGS 101C,A01,083625,Delgado; Tania,17,0,35,18
1657181090850,COGS 107A,A01,083627,Boyle; Mary E. T.,13,0,60,47
1657181096875,COGS 118A,A01,083075,Gupta; Anjum,16,0,76,60
1657181102901,CSE 3,A50,083646,Miranda; Gregory Joseph,24,0,50,26
1657181108925,CSE 8A,A50,083650,Miranda; Gregory Joseph,17,1,56,39
1657181114952,CSE 11,A01,083080,Cao; Yingjun,5,15,40,35
1657181120980,CSE 12,A01,083652,Krause-Levy; Sophia Louisa,24,1,120,96
1657181127009,CSE 15L,A01,083654,Morris; Justin Loren,9,0,50,41
1657181127009,CSE 15L,A02,083655,Morris; Justin Loren,9,0,50,41
1657181133044,CSE 20,A01,083657,Tran; Khoa Dang,38,0,80,42
1657181139067,CSE 21,A01,095574,Bach; Quang Tran,22,0,48,26
1657181145095,CSE 30,A01,083084,Eldon; John,4,0,80,76
1657181145095,CSE 30,B01,095061,Bhaskar; Nishant,7,0,50,43
1657181151118,CSE 100,A01,083659,Cao; Yingjun,4,4,70,66
1657181157141,CSE 134B,A01,083661,Powell; Thomas Allan,20,0,100,80
1657181163169,CSE 140,A01,083663,Gungor; Onat,13,0,85,72
1657181169193,CSE 140L,A01,083088,Eldon; John,17,0,100,83
1657181175217,CSE 175,A01,083665,Kumar; Rakesh,3,0,25,22
1657181181244,CSE 190,A00,092507,Dubnov; Shlomo,7,0,20,13
1657181187270,ECE 45,A01,083139,Congero; Spencer William,5,0,75,70
1657181193298,ECE 65,A50,083695,Saad; Andrew S,12,0,30,18
1657181193298,ECE 65,A51,095125,Saad; Andrew S,25,0,26,1
1657181199321,ECE 109,A01,091882,Touri; Behrouz,19,0,70,51
1657181205349,ECE 180,A00,083140,Abi Samra; Nicholas Camill,1,0,30,29
1657181205349,ECE 180,B00,083141,Abi Samra; Nicholas Camill,0,0,30,30
1657181211373,MATH 10A,A01,083735,Patchell; Gregory David,2,0,30,28
1657181211373,MATH 10A,A02,083736,Patchell; Gregory David,20,0,30,10
1657181211373,MATH 10A,A03,083737,Patchell; Gregory David,16,0,30,14
1657181217398,MATH 10B,A01,083207,Lim; Seonhee,7,0,34,27
1657181217398,MATH 10B,A02,083208,Lim; Seonhee,9,0,35,26
1657181217398,MATH 10B,A03,093472,Lim; Seonhee,5,0,34,29
1657181217398,MATH 10B,B01,083739,Sinha; Shubham,10,0,30,20
1657181223432,MATH 18,A01,083743,Cinel; Cameron Alexander,6,0,30,24
1657181223432,MATH 18,A02,083744,Cinel; Cameron Alexander,15,0,30,15
1657181223432,MATH 18,A03,083745,Cinel; Cameron Alexander,8,0,30,22
1657181223432,MATH 18,B01,083748,Rideout; David Porter,4,0,37,33
1657181223432,MATH 18,B02,083749,Rideout; David Porter,4,0,36,32
1657181223432,MATH 18,B03,083750,Rideout; David Porter,2,0,37,35
1657181223432,MATH 18,B04,083751,Rideout; David Porter,5,0,36,31
1657181223432,MATH 18,B05,093473,Rideout; David Porter,5,0,36,31
1657181223432,MATH 18,B06,093474,Rideout; David Porter,5,0,36,31
1657181229454,MATH 20A,A01,083754,Zheng; Zequn,13,0,40,27
1657181235478,MATH 20B,A01,083756,Briones; Jor-el Thomas Caparas,1,0,36,35
1657181235478,MATH 20B,A02,083757,Briones; Jor-el Thomas Caparas,1,0,36,35
1657181235478,MATH 20B,A03,093475,Briones; Jor-el Thomas Caparas,1,0,36,35
1657181241507,MATH 20C,A01,083760,Briones; Jor-el Thomas Caparas,1,0,35,34
1657181241507,MATH 20C,A02,083761,Briones; Jor-el Thomas Caparas,8,0,35,27
1657181241507,MATH 20C,A03,093476,Briones; Jor-el Thomas Caparas,0,1,36,36
1657181241507,MATH 20C,B01,083762,Bach; Quang Tran,1,0,30,29
1657181247532,MATH 20D,A01,083765,Tran; Brian Kha,4,0,30,26
1657181247532,MATH 20D,A02,083766,Tran; Brian Kha,5,0,30,25
1657181247532,MATH 20D,A03,083767,Tran; Brian Kha,4,0,30,26
1657181253557,MATH 20E,A01,083771,Ganguly; Soumya,7,0,32,25
1657181253557,MATH 20E,A02,083772,Ganguly; Soumya,7,0,32,25
1657181253557,MATH 20E,B01,083773,Ciotti; Benjamin,19,0,35,16
1657181253557,MATH 20E,B02,083774,Ciotti; Benjamin,17,0,35,18
1657181259582,MATH 103A,A01,083777,Greenfeld; Be'Eri,2,0,36,34
1657181259582,MATH 103A,A02,083778,Greenfeld; Be'Eri,5,0,36,31
1657181259582,MATH 103A,A03,093561,Greenfeld; Be'Eri,4,0,36,32
1657181259582,MATH 103A,B01,083779,Greenfeld; Be'Eri,6,0,36,30
1657181259582,MATH 103A,B02,083780,Greenfeld; Be'Eri,3,0,36,33
1657181259582,MATH 103A,B03,093562,Greenfeld; Be'Eri,3,0,36,33
1657181265607,MATH 105,A01,085443,Carter; Anne Toulson,14,0,35,21
1657181265607,MATH 105,A02,093477,Carter; Anne Toulson,20,0,35,15
1657181271630,MATH 109,A01,083213,Ganzberger; Geoffrey Michael,2,0,34,32
1657181271630,MATH 109,A02,083214,Ganzberger; Geoffrey Michael,3,0,34,31
1657181271630,MATH 109,A03,093478,Ganzberger; Geoffrey Michael,1,0,34,33
1657181271630,MATH 109,B01,083215,Ganzberger; Geoffrey Michael,1,0,32,31
1657181271630,MATH 109,B02,083216,Ganzberger; Geoffrey Michael,1,0,32,31
1657181271630,MATH 109,B03,093479,Ganzberger; Geoffrey Michael,6,0,32,26
1657181277654,MATH 142A,A01,083219,Chow; Bennett,6,0,32,26
1657181277654,MATH 142A,A02,083220,Chow; Bennett,10,0,32,22
1657181277654,MATH 142A,A03,093480,Chow; Bennett,7,0,32,25
1657181277654,MATH 142A,B03,093481,Chow; Bennett,8,0,32,24
1657181277654,MATH 142A,B04,093558,Chow; Bennett,11,0,32,21
1657181277654,MATH 142A,B05,093559,Chow; Bennett,6,0,32,26
1657181283678,MATH 193A,A01,083224,Rotar; Vladimir,7,0,34,27
1657181283678,MATH 193A,A02,083225,Rotar; Vladimir,5,0,34,29
1657181283678,MATH 193A,A03,083781,Rotar; Vladimir,1,0,34,33
1657181283678,MATH 193A,A04,083782,Rotar; Vladimir,8,0,34,26
1657181283678,MATH 193A,A05,093482,Rotar; Vladimir,6,0,34,28
1657181289702,MATH 197,001,091859,McAuley; Julian John,9999,0,9999,0
1657181289702,MATH 197,002,095566,Kedlaya; Kiran S.,9997,0,9999,2
1657181289702,MATH 197,003,095567,Xiao; Ming,9999,0,9999,0
1657181289702,MATH 197,004,095571,Perols; Johan Lars,9998,0,9999,1
1657181296768,COGS 9,A01,083615,Shannon; Kyle Michael,7,0,75,68
1657181302795,COGS 11,A01,083617,Boyle; Mary E. T.,22,0,48,26
1657181308817,COGS 13,A01,083071,Bastos; Amalia Pinkusfeld,9,0,71,62
1657181314839,COGS 14A,A01,092681,Semenuks; Arturs,1,1,100,99
1657181320863,COGS 14B,A01,083073,Cheng; Tzu-Han,6,0,63,57
1657181326886,COGS 17,A01,092677,Semenuks; Arturs,4,0,81,77
1657181332914,COGS 100,A01,083619,Allen; Michael Gordon,15,0,70,55
1657181338939,COGS 101A,A01,083621,Davis; Joshua Daniel,9,0,68,59
1657181344962,COGS 101B,A01,091572,Allen; Michael Gordon,9,0,65,56
1657181350985,COGS 101C,A01,083625,Delgado; Tania,17,0,35,18
1657181357010,COGS 107A,A01,083627,Boyle; Mary E. T.,13,0,60,47
1657181363033,COGS 118A,A01,083075,Gupta; Anjum,16,0,76,60
1657181369064,CSE 3,A50,083646,Miranda; Gregory Joseph,24,0,50,26
1657181375089,CSE 8A,A50,083650,Miranda; Gregory Joseph,17,1,56,39
1657181381112,CSE 11,A01,083080,Cao; Yingjun,5,15,40,35
1657181387139,CSE 12,A01,083652,Krause-Levy; Sophia Louisa,24,1,120,96
1657181393164,CSE 15L,A01,083654,Morris; Justin Loren,9,0,50,41
1657181393164,CSE 15L,A02,083655,Morris; Justin Loren,9,0,50,41
1657181399188,CSE 20,A01,083657,Tran; Khoa Dang,38,0,80,42
1657181405219,CSE 21,A01,095574,Bach; Quang Tran,22,0,48,26
1657181411258,CSE 30,A01,083084,Eldon; John,4,0,80,76
1657181411258,CSE 30,B01,095061,Bhaskar; Nishant,7,0,50,43
1657181417285,CSE 100,A01,083659,Cao; Yingjun,4,4,70,66
1657181423309,CSE 134B,A01,083661,Powell; Thomas Allan,20,0,100,80
1657181429333,CSE 140,A01,083663,Gungor; Onat,13,0,85,72
1657181435360,CSE 140L,A01,083088,Eldon; John,17,0,100,83
1657181441388,CSE 175,A01,083665,Kumar; Rakesh,3,0,25,22
1657181447415,CSE 190,A00,092507,Dubnov; Shlomo,7,0,20,13
1657181453440,ECE 45,A01,083139,Congero; Spencer William,5,0,75,70
1657181459467,ECE 65,A50,083695,Saad; Andrew S,12,0,30,18
1657181459467,ECE 65,A51,095125,Saad; Andrew S,25,0,26,1
1657181465490,ECE 109,A01,091882,Touri; Behrouz,19,0,70,51
1657181471515,ECE 180,A00,083140,Abi Samra; Nicholas Camill,1,0,30,29
1657181471515,ECE 180,B00,083141,Abi Samra; Nicholas Camill,0,0,30,30
1657181477543,MATH 10A,A01,083735,Patchell; Gregory David,2,0,30,28
1657181477543,MATH 10A,A02,083736,Patchell; Gregory David,20,0,30,10
1657181477543,MATH 10A,A03,083737,Patchell; Gregory David,16,0,30,14
1657181483575,MATH 10B,A01,083207,Lim; Seonhee,7,0,34,27
1657181483575,MATH 10B,A02,083208,Lim; Seonhee,9,0,35,26
1657181483575,MATH 10B,A03,093472,Lim; Seonhee,5,0,34,29
1657181483575,MATH 10B,B01,083739,Sinha; Shubham,10,0,30,20
1657181489693,MATH 18,A01,083743,Cinel; Cameron Alexander,6,0,30,24
1657181489693,MATH 18,A02,083744,Cinel; Cameron Alexander,15,0,30,15
1657181489693,MATH 18,A03,083745,Cinel; Cameron Alexander,8,0,30,22
1657181489693,MATH 18,B01,083748,Rideout; David Porter,4,0,37,33
1657181489693,MATH 18,B02,083749,Rideout; David Porter,4,0,36,32
1657181489693,MATH 18,B03,083750,Rideout; David Porter,2,0,37,35
1657181489693,MATH 18,B04,083751,Rideout; David Porter,5,0,36,31
1657181489693,MATH 18,B05,093473,Rideout; David Porter,5,0,36,31
1657181489693,MATH 18,B06,093474,Rideout; David Porter,5,0,36,31
1657181495720,MATH 20A,A01,083754,Zheng; Zequn,13,0,40,27
1657181501750,MATH 20B,A01,083756,Briones; Jor-el Thomas Caparas,1,0,36,35
1657181501750,MATH 20B,A02,083757,Briones; Jor-el Thomas Caparas,1,0,36,35
1657181501750,MATH 20B,A03,093475,Briones; Jor-el Thomas Caparas,1,0,36,35
1657181507777,MATH 20C,A01,083760,Briones; Jor-el Thomas Caparas,1,0,35,34
1657181507777,MATH 20C,A02,083761,Briones; Jor-el Thomas Caparas,8,0,35,27
1657181507777,MATH 20C,A03,093476,Briones; Jor-el Thomas Caparas,0,1,36,36
1657181507777,MATH 20C,B01,083762,Bach; Quang Tran,1,0,30,29
1657181513806,MATH 20D,A01,083765,Tran; Brian Kha,4,0,30,26
1657181513806,MATH 20D,A02,083766,Tran; Brian Kha,5,0,30,25
1657181513806,MATH 20D,A03,083767,Tran; Brian Kha,4,0,30,26
1657181519843,MATH 20E,A01,083771,Ganguly; Soumya,7,0,32,25
1657181519843,MATH 20E,A02,083772,Ganguly; Soumya,7,0,32,25
1657181519843,MATH 20E,B01,083773,Ciotti; Benjamin,19,0,35,16
1657181519843,MATH 20E,B02,083774,Ciotti; Benjamin,17,0,35,18
1657181525872,MATH 103A,A01,083777,Greenfeld; Be'Eri,2,0,36,34
1657181525872,MATH 103A,A02,083778,Greenfeld; Be'Eri,5,0,36,31
1657181525872,MATH 103A,A03,093561,Greenfeld; Be'Eri,4,0,36,32
1657181525872,MATH 103A,B01,083779,Greenfeld; Be'Eri,6,0,36,30
1657181525872,MATH 103A,B02,083780,Greenfeld; Be'Eri,3,0,36,33
1657181525872,MATH 103A,B03,093562,Greenfeld; Be'Eri,3,0,36,33
1657181531898,MATH 105,A01,085443,Carter; Anne Toulson,14,0,35,21
1657181531898,MATH 105,A02,093477,Carter; Anne Toulson,20,0,35,15
1657181537939,MATH 109,A01,083213,Ganzberger; Geoffrey Michael,2,0,34,32
1657181537939,MATH 109,A02,083214,Ganzberger; Geoffrey Michael,3,0,34,31
1657181537939,MATH 109,A03,093478,Ganzberger; Geoffrey Michael,1,0,34,33
1657181537939,MATH 109,B01,083215,Ganzberger; Geoffrey Michael,1,0,32,31
1657181537939,MATH 109,B02,083216,Ganzberger; Geoffrey Michael,1,0,32,31
1657181537939,MATH 109,B03,093479,Ganzberger; Geoffrey Michael,6,0,32,26
1657181543966,MATH 142A,A01,083219,Chow; Bennett,6,0,32,26
1657181543966,MATH 142A,A02,083220,Chow; Bennett,10,0,32,22
1657181543966,MATH 142A,A03,093480,Chow; Bennett,7,0,32,25
1657181543966,MATH 142A,B03,093481,Chow; Bennett,8,0,32,24
1657181543966,MATH 142A,B04,093558,Chow; Bennett,11,0,32,21
1657181543966,MATH 142A,B05,093559,Chow; Bennett,6,0,32,26
1657181549997,MATH 193A,A01,083224,Rotar; Vladimir,7,0,34,27
1657181549997,MATH 193A,A02,083225,Rotar; Vladimir,5,0,34,29
1657181549997,MATH 193A,A03,083781,Rotar; Vladimir,1,0,34,33
1657181549997,MATH 193A,A04,083782,Rotar; Vladimir,8,0,34,26
1657181549997,MATH 193A,A05,093482,Rotar; Vladimir,6,0,34,28
1657181556022,MATH 197,001,091859,McAuley; Julian John,9999,0,9999,0
1657181556022,MATH 197,002,095566,Kedlaya; Kiran S.,9997,0,9999,2
1657181556022,MATH 197,003,095567,Xiao; Ming,9999,0,9999,0
1657181556022,MATH 197,004,095571,Perols; Johan Lars,9998,0,9999,1
1657181563109,COGS 9,A01,083615,Shannon; Kyle Michael,7,0,75,68
1657181569138,COGS 11,A01,083617,Boyle; Mary E. T.,22,0,48,26
1657181575164,COGS 13,A01,083071,Bastos; Amalia Pinkusfeld,9,0,71,62
1657181581191,COGS 14A,A01,092681,Semenuks; Arturs,1,1,100,99
1657181587215,COGS 14B,A01,083073,Cheng; Tzu-Han,6,0,63,57
1657181593237,COGS 17,A01,092677,Semenuks; Arturs,4,0,81,77
1657181599262,COGS 100,A01,083619,Allen; Michael Gordon,15,0,70,55
1657181605287,COGS 101A,A01,083621,Davis; Joshua Daniel,9,0,68,59
1657181611315,COGS 101B,A01,091572,Allen; Michael Gordon,9,0,65,56
1657181617346,COGS 101C,A01,083625,Delgado; Tania,17,0,35,18
1657181623375,COGS 107A,A01,083627,Boyle; Mary E. T.,13,0,60,47
1657181629399,COGS 118A,A01,083075,Gupta; Anjum,16,0,76,60
1657181635430,CSE 3,A50,083646,Miranda; Gregory Joseph,24,0,50,26
1657181641459,CSE 8A,A50,083650,Miranda; Gregory Joseph,17,1,56,39
1657181647483,CSE 11,A01,083080,Cao; Yingjun,5,15,40,35
1657181653513,CSE 12,A01,083652,Krause-Levy; Sophia Louisa,24,1,120,96
1657181659538,CSE 15L,A01,083654,Morris; Justin Loren,9,0,50,41
1657181659538,CSE 15L,A02,083655,Morris; Justin Loren,9,0,50,41
1657181665563,CSE 20,A01,083657,Tran; Khoa Dang,38,0,80,42
1657181671588,CSE 21,A01,095574,Bach; Quang Tran,22,0,48,26
1657181677618,CSE 30,A01,083084,Eldon; John,4,0,80,76
1657181677618,CSE 30,B01,095061,Bhaskar; Nishant,7,0,50,43
1657181683640,CSE 100,A01,083659,Cao; Yingjun,4,4,70,66
1657181689664,CSE 134B,A01,083661,Powell; Thomas Allan,20,0,100,80
1657181695686,CSE 140,A01,083663,Gungor; Onat,13,0,85,72
1657181701714,CSE 140L,A01,083088,Eldon; John,17,0,100,83
1657181707736,CSE 175,A01,083665,Kumar; Rakesh,3,0,25,22
1657181713762,CSE 190,A00,092507,Dubnov; Shlomo,7,0,20,13
1657181719788,ECE 45,A01,083139,Congero; Spencer William,5,0,75,70
1657181725812,ECE 65,A50,083695,Saad; Andrew S,12,0,30,18
1657181725812,ECE 65,A51,095125,Saad; Andrew S,25,0,26,1
1657181731850,ECE 109,A01,091882,Touri; Behrouz,19,0,70,51
1657181737879,ECE 180,A00,083140,Abi Samra; Nicholas Camill,1,0,30,29
1657181737879,ECE 180,B00,083141,Abi Samra; Nicholas Camill,0,0,30,30
1657181743903,MATH 10A,A01,083735,Patchell; Gregory David,2,0,30,28
1657181743903,MATH 10A,A02,083736,Patchell; Gregory David,20,0,30,10
1657181743903,MATH 10A,A03,083737,Patchell; Gregory David,16,0,30,14
1657181749928,MATH 10B,A01,083207,Lim; Seonhee,7,0,34,27
1657181749928,MATH 10B,A02,083208,Lim; Seonhee,9,0,35,26
1657181749928,MATH 10B,A03,093472,Lim; Seonhee,5,0,34,29
1657181749928,MATH 10B,B01,083739,Sinha; Shubham,10,0,30,20
1657181755962,MATH 18,A01,083743,Cinel; Cameron Alexander,6,0,30,24
1657181755962,MATH 18,A02,083744,Cinel; Cameron Alexander,15,0,30,15
1657181755962,MATH 18,A03,083745,Cinel; Cameron Alexander,8,0,30,22
1657181755962,MATH 18,B01,083748,Rideout; David Porter,4,0,37,33
1657181755962,MATH 18,B02,083749,Rideout; David Porter,4,0,36,32
1657181755962,MATH 18,B03,083750,Rideout; David Porter,2,0,37,35
1657181755962,MATH 18,B04,083751,Rideout; David Porter,5,0,36,31
1657181755962,MATH 18,B05,093473,Rideout; David Porter,5,0,36,31
1657181755962,MATH 18,B06,093474,Rideout; David Porter,5,0,36,31
1657181761991,MATH 20A,A01,083754,Zheng; Zequn,13,0,40,27
1657181768022,MATH 20B,A01,083756,Briones; Jor-el Thomas Caparas,1,0,36,35
1657181768022,MATH 20B,A02,083757,Briones; Jor-el Thomas Caparas,1,0,36,35
1657181768022,MATH 20B,A03,093475,Briones; Jor-el Thomas Caparas,1,0,36,35
1657181774047,MATH 20C,A01,083760,Briones; Jor-el Thomas Caparas,1,0,35,34
1657181774047,MATH 20C,A02,083761,Briones; Jor-el Thomas Caparas,8,0,35,27
1657181774047,MATH 20C,A03,093476,Briones; Jor-el Thomas Caparas,0,1,36,36
1657181774047,MATH 20C,B01,083762,Bach; Quang Tran,1,0,30,29
1657181780072,MATH 20D,A01,083765,Tran; Brian Kha,4,0,30,26
1657181780072,MATH 20D,A02,083766,Tran; Brian Kha,5,0,30,25
1657181780072,MATH 20D,A03,083767,Tran; Brian Kha,4,0,30,26
1657181786106,MATH 20E,A01,083771,Ganguly; Soumya,7,0,32,25
1657181786106,MATH 20E,A02,083772,Ganguly; Soumya,7,0,32,25
1657181786106,MATH 20E,B01,083773,Ciotti; Benjamin,19,0,35,16
1657181786106,MATH 20E,B02,083774,Ciotti; Benjamin,17,0,35,18
1657181792139,MATH 103A,A01,083777,Greenfeld; Be'Eri,2,0,36,34
1657181792139,MATH 103A,A02,083778,Greenfeld; Be'Eri,5,0,36,31
1657181792139,MATH 103A,A03,093561,Greenfeld; Be'Eri,4,0,36,32
1657181792139,MATH 103A,B01,083779,Greenfeld; Be'Eri,6,0,36,30
1657181792139,MATH 103A,B02,083780,Greenfeld; Be'Eri,3,0,36,33
1657181792139,MATH 103A,B03,093562,Greenfeld; Be'Eri,3,0,36,33
1657181798163,MATH 105,A01,085443,Carter; Anne Toulson,14,0,35,21
1657181798163,MATH 105,A02,093477,Carter; Anne Toulson,20,0,35,15
1657181804189,MATH 109,A01,083213,Ganzberger; Geoffrey Michael,2,0,34,32
1657181804189,MATH 109,A02,083214,Ganzberger; Geoffrey Michael,3,0,34,31
1657181804189,MATH 109,A03,093478,Ganzberger; Geoffrey Michael,1,0,34,33
1657181804189,MATH 109,B01,083215,Ganzberger; Geoffrey Michael,1,0,32,31
1657181804189,MATH 109,B02,083216,Ganzberger; Geoffrey Michael,1,0,32,31
1657181804189,MATH 109,B03,093479,Ganzberger; Geoffrey Michael,6,0,32,26
1657181810213,MATH 142A,A01,083219,Chow; Bennett,6,0,32,26
1657181810213,MATH 142A,A02,083220,Chow; Bennett,10,0,32,22
1657181810213,MATH 142A,A03,093480,Chow; Bennett,7,0,32,25
1657181810213,MATH 142A,B03,093481,Chow; Bennett,8,0,32,24
1657181810213,MATH 142A,B04,093558,Chow; Bennett,11,0,32,21
1657181810213,MATH 142A,B05,093559,Chow; Bennett,6,0,32,26
1657181816238,MATH 193A,A01,083224,Rotar; Vladimir,7,0,34,27
1657181816238,MATH 193A,A02,083225,Rotar; Vladimir,5,0,34,29
1657181816238,MATH 193A,A03,083781,Rotar; Vladimir,1,0,34,33
1657181816238,MATH 193A,A04,083782,Rotar; Vladimir,8,0,34,26
1657181816238,MATH 193A,A05,093482,Rotar; Vladimir,6,0,34,28
1657181822269,MATH 197,001,091859,McAuley; Julian John,9999,0,9999,0
1657181822269,MATH 197,002,095566,Kedlaya; Kiran S.,9997,0,9999,2
1657181822269,MATH 197,003,095567,Xiao; Ming,9999,0,9999,0
1657181822269,MATH 197,004,095571,Perols; Johan Lars,9998,0,9999,1
1657181829362,COGS 9,A01,083615,Shannon; Kyle Michael,7,0,75,68
1657181835389,COGS 11,A01,083617,Boyle; Mary E. T.,22,0,48,26
1657181841412,COGS 13,A01,083071,Bastos; Amalia Pinkusfeld,9,0,71,62
1657181847437,COGS 14A,A01,092681,Semenuks; Arturs,1,1,100,99
1657181853462,COGS 14B,A01,083073,Cheng; Tzu-Han,6,0,63,57
1657181859490,COGS 17,A01,092677,Semenuks; Arturs,4,0,81,77
1657181865513,COGS 100,A01,083619,Allen; Michael Gordon,15,0,70,55
1657181871537,COGS 101A,A01,083621,Davis; Joshua Daniel,9,0,68,59
1657181877565,COGS 101B,A01,091572,Allen; Michael Gordon,9,0,65,56
1657181883589,COGS 101C,A01,083625,Delgado; Tania,17,0,35,18
1657181889616,COGS 107A,A01,083627,Boyle; Mary E. T.,13,0,60,47
1657181895640,COGS 118A,A01,083075,Gupta; Anjum,16,0,76,60
1657181901667,CSE 3,A50,083646,Miranda; Gregory Joseph,24,0,50,26
1657181907696,CSE 8A,A50,083650,Miranda; Gregory Joseph,17,1,56,39
1657181913720,CSE 11,A01,083080,Cao; Yingjun,5,15,40,35
1657181919748,CSE 12,A01,083652,Krause-Levy; Sophia Louisa,24,1,120,96
1657181925772,CSE 15L,A01,083654,Morris; Justin Loren,9,0,50,41
1657181925772,CSE 15L,A02,083655,Morris; Justin Loren,9,0,50,41
1657181931796,CSE 20,A01,083657,Tran; Khoa Dang,38,0,80,42
1657181937823,CSE 21,A01,095574,Bach; Quang Tran,22,0,48,26
1657181943857,CSE 30,A01,083084,Eldon; John,4,0,80,76
1657181943857,CSE 30,B01,095061,Bhaskar; Nishant,7,0,50,43
1657181949880,CSE 100,A01,083659,Cao; Yingjun,4,4,70,66
1657181955910,CSE 134B,A01,083661,Powell; Thomas Allan,20,0,100,80
1657181961938,CSE 140,A01,083663,Gungor; Onat,13,0,85,72
1657181967962,CSE 140L,A01,083088,Eldon; John,17,0,100,83
1657181973985,CSE 175,A01,083665,Kumar; Rakesh,3,0,25,22
1657181980009,CSE 190,A00,092507,Dubnov; Shlomo,7,0,20,13
1657181986033,ECE 45,A01,083139,Congero; Spencer William,5,0,75,70
1657181992058,ECE 65,A50,083695,Saad; Andrew S,12,0,30,18
1657181992058,ECE 65,A51,095125,Saad; Andrew S,25,0,26,1
1657181998082,ECE 109,A01,091882,Touri; Behrouz,19,0,70,51
1657182004106,ECE 180,A00,083140,Abi Samra; Nicholas Camill,1,0,30,29
1657182004106,ECE 180,B00,083141,Abi Samra; Nicholas Camill,0,0,30,30
1657182010131,MATH 10A,A01,083735,Patchell; Gregory David,2,0,30,28
1657182010131,MATH 10A,A02,083736,Patchell; Gregory David,20,0,30,10
1657182010131,MATH 10A,A03,083737,Patchell; Gregory David,16,0,30,14
1657182016158,MATH 10B,A01,083207,Lim; Seonhee,7,0,34,27
1657182016158,MATH 10B,A02,083208,Lim; Seonhee,9,0,35,26
1657182016158,MATH 10B,A03,093472,Lim; Seonhee,5,0,34,29
1657182016158,MATH 10B,B01,083739,Sinha; Shubham,10,0,30,20
1657182022189,MATH 18,A01,083743,Cinel; Cameron Alexander,6,0,30,24
1657182022189,MATH 18,A02,083744,Cinel; Cameron Alexander,15,0,30,15
1657182022189,MATH 18,A03,083745,Cinel; Cameron Alexander,8,0,30,22
1657182022189,MATH 18,B01,083748,Rideout; David Porter,4,0,37,33
1657182022189,MATH 18,B02,083749,Rideout; David Porter,4,0,36,32
1657182022189,MATH 18,B03,083750,Rideout; David Porter,2,0,37,35
1657182022189,MATH 18,B04,083751,Rideout; David Porter,5,0,36,31
1657182022189,MATH 18,B05,093473,Rideout; David Porter,5,0,36,31
1657182022189,MATH 18,B06,093474,Rideout; David Porter,5,0,36,31
1657182028216,MATH 20A,A01,083754,Zheng; Zequn,13,0,40,27
1657182034240,MATH 20B,A01,083756,Briones; Jor-el Thomas Caparas,1,0,36,35
1657182034240,MATH 20B,A02,083757,Briones; Jor-el Thomas Caparas,1,0,36,35
1657182034240,MATH 20B,A03,093475,Briones; Jor-el Thomas Caparas,1,0,36,35
1657182040263,MATH 20C,A01,083760,Briones; Jor-el Thomas Caparas,1,0,35,34
1657182040263,MATH 20C,A02,083761,Briones; Jor-el Thomas Caparas,8,0,35,27
1657182040263,MATH 20C,A03,093476,Briones; Jor-el Thomas Caparas,0,1,36,36
1657182040263,MATH 20C,B01,083762,Bach; Quang Tran,1,0,30,29
1657182046292,MATH 20D,A01,083765,Tran; Brian Kha,4,0,30,26
1657182046292,MATH 20D,A02,083766,Tran; Brian Kha,5,0,30,25
1657182046292,MATH 20D,A03,083767,Tran; Brian Kha,4,0,30,26
1657182052318,MATH 20E,A01,083771,Ganguly; Soumya,7,0,32,25
1657182052318,MATH 20E,A02,083772,Ganguly; Soumya,7,0,32,25
1657182052318,MATH 20E,B01,083773,Ciotti; Benjamin,19,0,35,16
1657182052318,MATH 20E,B02,083774,Ciotti; Benjamin,17,0,35,18
1657182058345,MATH 103A,A01,083777,Greenfeld; Be'Eri,2,0,36,34
1657182058345,MATH 103A,A02,083778,Greenfeld; Be'Eri,5,0,36,31
1657182058345,MATH 103A,A03,093561,Greenfeld; Be'Eri,4,0,36,32
1657182058345,MATH 103A,B01,083779,Greenfeld; Be'Eri,6,0,36,30
1657182058345,MATH 103A,B02,083780,Greenfeld; Be'Eri,3,0,36,33
1657182058345,MATH 103A,B03,093562,Greenfeld; Be'Eri,3,0,36,33
1657182064373,MATH 105,A01,085443,Carter; Anne Toulson,14,0,35,21
1657182064373,MATH 105,A02,093477,Carter; Anne Toulson,20,0,35,15
1657182070403,MATH 109,A01,083213,Ganzberger; Geoffrey Michael,2,0,34,32
1657182070403,MATH 109,A02,083214,Ganzberger; Geoffrey Michael,3,0,34,31
1657182070403,MATH 109,A03,093478,Ganzberger; Geoffrey Michael,1,0,34,33
1657182070403,MATH 109,B01,083215,Ganzberger; Geoffrey Michael,1,0,32,31
1657182070403,MATH 109,B02,083216,Ganzberger; Geoffrey Michael,1,0,32,31
1657182070403,MATH 109,B03,093479,Ganzberger; Geoffrey Michael,6,0,32,26
1657182076437,MATH 142A,A01,083219,Chow; Bennett,6,0,32,26
1657182076437,MATH 142A,A02,083220,Chow; Bennett,10,0,32,22
1657182076437,MATH 142A,A03,093480,Chow; Bennett,7,0,32,25
1657182076437,MATH 142A,B03,093481,Chow; Bennett,8,0,32,24
1657182076437,MATH 142A,B04,093558,Chow; Bennett,11,0,32,21
1657182076437,MATH 142A,B05,093559,Chow; Bennett,6,0,32,26
1657182082469,MATH 193A,A01,083224,Rotar; Vladimir,7,0,34,27
1657182082469,MATH 193A,A02,083225,Rotar; Vladimir,5,0,34,29
1657182082469,MATH 193A,A03,083781,Rotar; Vladimir,1,0,34,33
1657182082469,MATH 193A,A04,083782,Rotar; Vladimir,8,0,34,26
1657182082469,MATH 193A,A05,093482,Rotar; Vladimir,6,0,34,28
1657182088569,MATH 197,001,091859,McAuley; Julian John,9999,0,9999,0
1657182088569,MATH 197,002,095566,Kedlaya; Kiran S.,9997,0,9999,2
1657182088569,MATH 197,003,095567,Xiao; Ming,9999,0,9999,0
1657182088569,MATH 197,004,095571,Perols; Johan Lars,9998,0,9999,1
1657182095635,COGS 9,A01,083615,Shannon; Kyle Michael,7,0,75,68
1657182101659,COGS 11,A01,083617,Boyle; Mary E. T.,22,0,48,26
1657182107690,COGS 13,A01,083071,Bastos; Amalia Pinkusfeld,9,0,71,62
1657182113718,COGS 14A,A01,092681,Semenuks; Arturs,1,1,100,99
1657182119743,COGS 14B,A01,083073,Cheng; Tzu-Han,6,0,63,57
1657182125773,COGS 17,A01,092677,Semenuks; Arturs,4,0,81,77
1657182131799,COGS 100,A01,083619,Allen; Michael Gordon,15,0,70,55
1657182137831,COGS 101A,A01,083621,Davis; Joshua Daniel,9,0,68,59
1657182143860,COGS 101B,A01,091572,Allen; Michael Gordon,9,0,65,56
1657182149885,COGS 101C,A01,083625,Delgado; Tania,17,0,35,18
1657182155914,COGS 107A,A01,083627,Boyle; Mary E. T.,13,0,60,47
1657182161941,COGS 118A,A01,083075,Gupta; Anjum,16,0,76,60
1657182167968,CSE 3,A50,083646,Miranda; Gregory Joseph,24,0,50,26
1657182174000,CSE 8A,A50,083650,Miranda; Gregory Joseph,17,1,56,39
1657182180030,CSE 11,A01,083080,Cao; Yingjun,5,15,40,35
1657182186055,CSE 12,A01,083652,Krause-Levy; Sophia Louisa,24,1,120,96
1657182192080,CSE 15L,A01,083654,Morris; Justin Loren,9,0,50,41
1657182192080,CSE 15L,A02,083655,Morris; Justin Loren,9,0,50,41
1657182198122,CSE 20,A01,083657,Tran; Khoa Dang,38,0,80,42
1657182204150,CSE 21,A01,095574,Bach; Quang Tran,22,0,48,26
1657182210176,CSE 30,A01,083084,Eldon; John,4,0,80,76
1657182210176,CSE 30,B01,095061,Bhaskar; Nishant,7,0,50,43
1657182216208,CSE 100,A01,083659,Cao; Yingjun,4,4,70,66
1657182222238,CSE 134B,A01,083661,Powell; Thomas Allan,20,0,100,80
1657182228267,CSE 140,A01,083663,Gungor; Onat,13,0,85,72
1657182234291,CSE 140L,A01,083088,Eldon; John,17,0,100,83
1657182240318,CSE 175,A01,083665,Kumar; Rakesh,3,0,25,22
1657182246350,CSE 190,A00,092507,Dubnov; Shlomo,7,0,20,13
1657182252377,ECE 45,A01,083139,Congero; Spencer William,5,0,75,70
1657182258405,ECE 65,A50,083695,Saad; Andrew S,12,0,30,18
1657182258405,ECE 65,A51,095125,Saad; Andrew S,25,0,26,1
1657182264431,ECE 109,A01,091882,Touri; Behrouz,19,0,70,51
1657182270457,ECE 180,A00,083140,Abi Samra; Nicholas Camill,1,0,30,29
1657182270457,ECE 180,B00,083141,Abi Samra; Nicholas Camill,0,0,30,30
1657182276490,MATH 10A,A01,083735,Patchell; Gregory David,2,0,30,28
1657182276490,MATH 10A,A02,083736,Patchell; Gregory David,20,0,30,10
1657182276490,MATH 10A,A03,083737,Patchell; Gregory David,16,0,30,14
1657182282518,MATH 10B,A01,083207,Lim; Seonhee,7,0,34,27
1657182282518,MATH 10B,A02,083208,Lim; Seonhee,9,0,35,26
1657182282518,MATH 10B,A03,093472,Lim; Seonhee,5,0,34,29
1657182282518,MATH 10B,B01,083739,Sinha; Shubham,10,0,30,20
1657182288548,MATH 18,A01,083743,Cinel; Cameron Alexander,6,0,30,24
1657182288548,MATH 18,A02,083744,Cinel; Cameron Alexander,15,0,30,15
1657182288548,MATH 18,A03,083745,Cinel; Cameron Alexander,8,0,30,22
1657182288548,MATH 18,B01,083748,Rideout; David Porter,4,0,37,33
1657182288548,MATH 18,B02,083749,Rideout; David Porter,4,0,36,32
1657182288548,MATH 18,B03,083750,Rideout; David Porter,2,0,37,35
1657182288548,MATH 18,B04,083751,Rideout; David Porter,5,0,36,31
1657182288548,MATH 18,B05,093473,Rideout; David Porter,5,0,36,31
1657182288548,MATH 18,B06,093474,Rideout; David Porter,5,0,36,31
1657182294574,MATH 20A,A01,083754,Zheng; Zequn,13,0,40,27
1657182300609,MATH 20B,A01,083756,Briones; Jor-el Thomas Caparas,1,0,36,35
1657182300609,MATH 20B,A02,083757,Briones; Jor-el Thomas Caparas,1,0,36,35
1657182300609,MATH 20B,A03,093475,Briones; Jor-el Thomas Caparas,1,0,36,35
1657182306640,MATH 20C,A01,083760,Briones; Jor-el Thomas Caparas,1,0,35,34
1657182306640,MATH 20C,A02,083761,Briones; Jor-el Thomas Caparas,8,0,35,27
1657182306640,MATH 20C,A03,093476,Briones; Jor-el Thomas Caparas,0,1,36,36
1657182306640,MATH 20C,B01,083762,Bach; Quang Tran,1,0,30,29
1657182312673,MATH 20D,A01,083765,Tran; Brian Kha,4,0,30,26
1657182312673,MATH 20D,A02,083766,Tran; Brian Kha,5,0,30,25
1657182312673,MATH 20D,A03,083767,Tran; Brian Kha,4,0,30,26
1657182318699,MATH 20E,A01,083771,Ganguly; Soumya,7,0,32,25
1657182318699,MATH 20E,A02,083772,Ganguly; Soumya,7,0,32,25
1657182318699,MATH 20E,B01,083773,Ciotti; Benjamin,19,0,35,16
1657182318699,MATH 20E,B02,083774,Ciotti; Benjamin,17,0,35,18
1657182324739,MATH 103A,A01,083777,Greenfeld; Be'Eri,2,0,36,34
1657182324739,MATH 103A,A02,083778,Greenfeld; Be'Eri,5,0,36,31
1657182324739,MATH 103A,A03,093561,Greenfeld; Be'Eri,4,0,36,32
1657182324739,MATH 103A,B01,083779,Greenfeld; Be'Eri,6,0,36,30
1657182324739,MATH 103A,B02,083780,Greenfeld; Be'Eri,3,0,36,33
1657182324739,MATH 103A,B03,093562,Greenfeld; Be'Eri,3,0,36,33
1657182330773,MATH 105,A01,085443,Carter; Anne Toulson,14,0,35,21
1657182330773,MATH 105,A02,093477,Carter; Anne Toulson,20,0,35,15
1657182336797,MATH 109,A01,083213,Ganzberger; Geoffrey Michael,2,0,34,32
1657182336797,MATH 109,A02,083214,Ganzberger; Geoffrey Michael,3,0,34,31
1657182336797,MATH 109,A03,093478,Ganzberger; Geoffrey Michael,1,0,34,33
1657182336797,MATH 109,B01,083215,Ganzberger; Geoffrey Michael,1,0,32,31
1657182336797,MATH 109,B02,083216,Ganzberger; Geoffrey Michael,1,0,32,31
1657182336797,MATH 109,B03,093479,Ganzberger; Geoffrey Michael,6,0,32,26
1657182342832,MATH 142A,A01,083219,Chow; Bennett,6,0,32,26
1657182342832,MATH 142A,A02,083220,Chow; Bennett,10,0,32,22
1657182342832,MATH 142A,A03,093480,Chow; Bennett,7,0,32,25
1657182342832,MATH 142A,B03,093481,Chow; Bennett,8,0,32,24
1657182342832,MATH 142A,B04,093558,Chow; Bennett,11,0,32,21
1657182342832,MATH 142A,B05,093559,Chow; Bennett,6,0,32,26
1657182348857,MATH 193A,A01,083224,Rotar; Vladimir,7,0,34,27
1657182348857,MATH 193A,A02,083225,Rotar; Vladimir,5,0,34,29
1657182348857,MATH 193A,A03,083781,Rotar; Vladimir,1,0,34,33
1657182348857,MATH 193A,A04,083782,Rotar; Vladimir,8,0,34,26
1657182348857,MATH 193A,A05,093482,Rotar; Vladimir,6,0,34,28
1657182354890,MATH 197,001,091859,McAuley; Julian John,9999,0,9999,0
1657182354890,MATH 197,002,095566,Kedlaya; Kiran S.,9997,0,9999,2
1657182354890,MATH 197,003,095567,Xiao; Ming,9999,0,9999,0
1657182354890,MATH 197,004,095571,Perols; Johan Lars,9998,0,9999,1
1657182361981,COGS 9,A01,083615,Shannon; Kyle Michael,7,0,75,68
1657182368007,COGS 11,A01,083617,Boyle; Mary E. T.,22,0,48,26
1657182374032,COGS 13,A01,083071,Bastos; Amalia Pinkusfeld,9,0,71,62
1657182380057,COGS 14A,A01,092681,Semenuks; Arturs,1,1,100,99
1657182386081,COGS 14B,A01,083073,Cheng; Tzu-Han,6,0,63,57
1657182392106,COGS 17,A01,092677,Semenuks; Arturs,4,0,81,77
1657182398135,COGS 100,A01,083619,Allen; Michael Gordon,15,0,70,55
1657182404160,COGS 101A,A01,083621,Davis; Joshua Daniel,9,0,68,59
1657182410192,COGS 101B,A01,091572,Allen; Michael Gordon,9,0,65,56
1657182416217,COGS 101C,A01,083625,Delgado; Tania,17,0,35,18
1657182422241,COGS 107A,A01,083627,Boyle; Mary E. T.,13,0,60,47
1657182428265,COGS 118A,A01,083075,Gupta; Anjum,16,0,76,60
1657182434293,CSE 3,A50,083646,Miranda; Gregory Joseph,24,0,50,26
1657182440324,CSE 8A,A50,083650,Miranda; Gregory Joseph,17,1,56,39
1657182446349,CSE 11,A01,083080,Cao; Yingjun,5,15,40,35
1657182452379,CSE 12,A01,083652,Krause-Levy; Sophia Louisa,24,1,120,96
1657182458405,CSE 15L,A01,083654,Morris; Justin Loren,9,0,50,41
1657182458405,CSE 15L,A02,083655,Morris; Justin Loren,9,0,50,41
1657182464436,CSE 20,A01,083657,Tran; Khoa Dang,38,0,80,42
1657182470468,CSE 21,A01,095574,Bach; Quang Tran,22,0,48,26
1657182476507,CSE 30,A01,083084,Eldon; John,4,0,80,76
1657182476507,CSE 30,B01,095061,Bhaskar; Nishant,7,0,50,43
1657182482541,CSE 100,A01,083659,Cao; Yingjun,4,4,70,66
1657182488570,CSE 134B,A01,083661,Powell; Thomas Allan,20,0,100,80
1657182494598,CSE 140,A01,083663,Gungor; Onat,13,0,85,72
1657182500628,CSE 140L,A01,083088,Eldon; John,17,0,100,83
1657182506654,CSE 175,A01,083665,Kumar; Rakesh,3,0,25,22
1657182512685,CSE 190,A00,092507,Dubnov; Shlomo,7,0,20,13
1657182518712,ECE 45,A01,083139,Congero; Spencer William,5,0,75,70
1657182524748,ECE 65,A50,083695,Saad; Andrew S,12,0,30,18
1657182524748,ECE 65,A51,095125,Saad; Andrew S,25,0,26,1
1657182530778,ECE 109,A01,091882,Touri; Behrouz,19,0,70,51
1657182536801,ECE 180,A00,083140,Abi Samra; Nicholas Camill,1,0,30,29
1657182536801,ECE 180,B00,083141,Abi Samra; Nicholas Camill,0,0,30,30
1657182542835,MATH 10A,A01,083735,Patchell; Gregory David,2,0,30,28
1657182542835,MATH 10A,A02,083736,Patchell; Gregory David,20,0,30,10
1657182542835,MATH 10A,A03,083737,Patchell; Gregory David,16,0,30,14
1657182548876,MATH 10B,A01,083207,Lim; Seonhee,7,0,34,27
1657182548876,MATH 10B,A02,083208,Lim; Seonhee,9,0,35,26
1657182548876,MATH 10B,A03,093472,Lim; Seonhee,5,0,34,29
1657182548876,MATH 10B,B01,083739,Sinha; Shubham,10,0,30,20
1657182554922,MATH 18,A01,083743,Cinel; Cameron Alexander,6,0,30,24
1657182554922,MATH 18,A02,083744,Cinel; Cameron Alexander,15,0,30,15
1657182554922,MATH 18,A03,083745,Cinel; Cameron Alexander,8,0,30,22
1657182554922,MATH 18,B01,083748,Rideout; David Porter,4,0,37,33
1657182554922,MATH 18,B02,083749,Rideout; David Porter,4,0,36,32
1657182554922,MATH 18,B03,083750,Rideout; David Porter,2,0,37,35
1657182554922,MATH 18,B04,083751,Rideout; David Porter,5,0,36,31
1657182554922,MATH 18,B05,093473,Rideout; David Porter,5,0,36,31
1657182554922,MATH 18,B06,093474,Rideout; David Porter,5,0,36,31
1657182560954,MATH 20A,A01,083754,Zheng; Zequn,13,0,40,27
1657182566997,MATH 20B,A01,083756,Briones; Jor-el Thomas Caparas,1,0,36,35
1657182566997,MATH 20B,A02,083757,Briones; Jor-el Thomas Caparas,1,0,36,35
1657182566997,MATH 20B,A03,093475,Briones; Jor-el Thomas Caparas,1,0,36,35
1657182573025,MATH 20C,A01,083760,Briones; Jor-el Thomas Caparas,1,0,35,34
1657182573025,MATH 20C,A02,083761,Briones; Jor-el Thomas Caparas,8,0,35,27
1657182573025,MATH 20C,A03,093476,Briones; Jor-el Thomas Caparas,0,1,36,36
1657182573025,MATH 20C,B01,083762,Bach; Quang Tran,1,0,30,29
1657182579063,MATH 20D,A01,083765,Tran; Brian Kha,4,0,30,26
1657182579063,MATH 20D,A02,083766,Tran; Brian Kha,5,0,30,25
1657182579063,MATH 20D,A03,083767,Tran; Brian Kha,4,0,30,26
1657182585091,MATH 20E,A01,083771,Ganguly; Soumya,7,0,32,25
1657182585091,MATH 20E,A02,083772,Ganguly; Soumya,7,0,32,25
1657182585091,MATH 20E,B01,083773,Ciotti; Benjamin,19,0,35,16
1657182585091,MATH 20E,B02,083774,Ciotti; Benjamin,17,0,35,18
1657182591119,MATH 103A,A01,083777,Greenfeld; Be'Eri,2,0,36,34
1657182591119,MATH 103A,A02,083778,Greenfeld; Be'Eri,5,0,36,31
1657182591119,MATH 103A,A03,093561,Greenfeld; Be'Eri,4,0,36,32
1657182591119,MATH 103A,B01,083779,Greenfeld; Be'Eri,6,0,36,30
1657182591119,MATH 103A,B02,083780,Greenfeld; Be'Eri,3,0,36,33
1657182591119,MATH 103A,B03,093562,Greenfeld; Be'Eri,3,0,36,33
1657182597149,MATH 105,A01,085443,Carter; Anne Toulson,14,0,35,21
1657182597149,MATH 105,A02,093477,Carter; Anne Toulson,20,0,35,15
1657182603182,MATH 109,A01,083213,Ganzberger; Geoffrey Michael,2,0,34,32
1657182603182,MATH 109,A02,083214,Ganzberger; Geoffrey Michael,3,0,34,31
1657182603182,MATH 109,A03,093478,Ganzberger; Geoffrey Michael,1,0,34,33
1657182603182,MATH 109,B01,083215,Ganzberger; Geoffrey Michael,1,0,32,31
1657182603182,MATH 109,B02,083216,Ganzberger; Geoffrey Michael,1,0,32,31
1657182603182,MATH 109,B03,093479,Ganzberger; Geoffrey Michael,6,0,32,26
1657182609215,MATH 142A,A01,083219,Chow; Bennett,6,0,32,26
1657182609215,MATH 142A,A02,083220,Chow; Bennett,10,0,32,22
1657182609215,MATH 142A,A03,093480,Chow; Bennett,7,0,32,25
1657182609215,MATH 142A,B03,093481,Chow; Bennett,8,0,32,24
1657182609215,MATH 142A,B04,093558,Chow; Bennett,11,0,32,21
1657182609215,MATH 142A,B05,093559,Chow; Bennett,6,0,32,26
1657182615243,MATH 193A,A01,083224,Rotar; Vladimir,7,0,34,27
1657182615243,MATH 193A,A02,083225,Rotar; Vladimir,5,0,34,29
1657182615243,MATH 193A,A03,083781,Rotar; Vladimir,1,0,34,33
1657182615243,MATH 193A,A04,083782,Rotar; Vladimir,8,0,34,26
1657182615243,MATH 193A,A05,093482,Rotar; Vladimir,6,0,34,28
1657182621269,MATH 197,001,091859,McAuley; Julian John,9999,0,9999,0
1657182621269,MATH 197,002,095566,Kedlaya; Kiran S.,9997,0,9999,2
1657182621269,MATH 197,003,095567,Xiao; Ming,9999,0,9999,0
1657182621269,MATH 197,004,095571,Perols; Johan Lars,9998,0,9999,1
1657182628332,COGS 9,A01,083615,Shannon; Kyle Michael,7,0,75,68
1657182634357,COGS 11,A01,083617,Boyle; Mary E. T.,22,0,48,26
1657182640384,COGS 13,A01,083071,Bastos; Amalia Pinkusfeld,9,0,71,62
1657182646414,COGS 14A,A01,092681,Semenuks; Arturs,1,1,100,99
1657182652443,COGS 14B,A01,083073,Cheng; Tzu-Han,6,0,63,57
1657182658468,COGS 17,A01,092677,Semenuks; Arturs,4,0,81,77
1657182664493,COGS 100,A01,083619,Allen; Michael Gordon,15,0,70,55
1657182670525,COGS 101A,A01,083621,Davis; Joshua Daniel,9,0,68,59
1657182676553,COGS 101B,A01,091572,Allen; Michael Gordon,9,0,65,56
1657182682651,COGS 101C,A01,083625,Delgado; Tania,17,0,35,18
1657182688676,COGS 107A,A01,083627,Boyle; Mary E. T.,13,0,60,47
1657182694698,COGS 118A,A01,083075,Gupta; Anjum,16,0,76,60
1657182700733,CSE 3,A50,083646,Miranda; Gregory Joseph,24,0,50,26
1657182706762,CSE 8A,A50,083650,Miranda; Gregory Joseph,17,1,56,39
1657182712785,CSE 11,A01,083080,Cao; Yingjun,5,15,40,35
1657182718815,CSE 12,A01,083652,Krause-Levy; Sophia Louisa,24,1,120,96
1657182724848,CSE 15L,A01,083654,Morris; Justin Loren,9,0,50,41
1657182724848,CSE 15L,A02,083655,Morris; Justin Loren,9,0,50,41
1657182730874,CSE 20,A01,083657,Tran; Khoa Dang,38,0,80,42
1657182736906,CSE 21,A01,095574,Bach; Quang Tran,22,0,48,26
1657182742933,CSE 30,A01,083084,Eldon; John,4,0,80,76
1657182742933,CSE 30,B01,095061,Bhaskar; Nishant,7,0,50,43
1657182748963,CSE 100,A01,083659,Cao; Yingjun,4,4,70,66
1657182754996,CSE 134B,A01,083661,Powell; Thomas Allan,20,0,100,80
1657182761021,CSE 140,A01,083663,Gungor; Onat,13,0,85,72
1657182767049,CSE 140L,A01,083088,Eldon; John,17,0,100,83
1657182773085,CSE 175,A01,083665,Kumar; Rakesh,3,0,25,22
1657182779111,CSE 190,A00,092507,Dubnov; Shlomo,7,0,20,13
1657182785137,ECE 45,A01,083139,Congero; Spencer William,5,0,75,70
1657182791163,ECE 65,A50,083695,Saad; Andrew S,12,0,30,18
1657182791163,ECE 65,A51,095125,Saad; Andrew S,25,0,26,1
1657182797200,ECE 109,A01,091882,Touri; Behrouz,19,0,70,51
1657182803231,ECE 180,A00,083140,Abi Samra; Nicholas Camill,1,0,30,29
1657182803231,ECE 180,B00,083141,Abi Samra; Nicholas Camill,0,0,30,30
1657182809264,MATH 10A,A01,083735,Patchell; Gregory David,2,0,30,28
1657182809264,MATH 10A,A02,083736,Patchell; Gregory David,20,0,30,10
1657182809264,MATH 10A,A03,083737,Patchell; Gregory David,16,0,30,14
1657182815293,MATH 10B,A01,083207,Lim; Seonhee,7,0,34,27
1657182815293,MATH 10B,A02,083208,Lim; Seonhee,9,0,35,26
1657182815293,MATH 10B,A03,093472,Lim; Seonhee,5,0,34,29
1657182815293,MATH 10B,B01,083739,Sinha; Shubham,10,0,30,20
1657182821331,MATH 18,A01,083743,Cinel; Cameron Alexander,6,0,30,24
1657182821331,MATH 18,A02,083744,Cinel; Cameron Alexander,15,0,30,15
1657182821331,MATH 18,A03,083745,Cinel; Cameron Alexander,8,0,30,22
1657182821331,MATH 18,B01,083748,Rideout; David Porter,4,0,37,33
1657182821331,MATH 18,B02,083749,Rideout; David Porter,4,0,36,32
1657182821331,MATH 18,B03,083750,Rideout; David Porter,2,0,37,35
1657182821331,MATH 18,B04,083751,Rideout; David Porter,5,0,36,31
1657182821331,MATH 18,B05,093473,Rideout; David Porter,5,0,36,31
1657182821331,MATH 18,B06,093474,Rideout; David Porter,5,0,36,31
1657182827357,MATH 20A,A01,083754,Zheng; Zequn,13,0,40,27
1657182833387,MATH 20B,A01,083756,Briones; Jor-el Thomas Caparas,1,0,36,35
1657182833387,MATH 20B,A02,083757,Briones; Jor-el Thomas Caparas,1,0,36,35
1657182833387,MATH 20B,A03,093475,Briones; Jor-el Thomas Caparas,1,0,36,35
1657182839427,MATH 20C,A01,083760,Briones; Jor-el Thomas Caparas,1,0,35,34
1657182839427,MATH 20C,A02,083761,Briones; Jor-el Thomas Caparas,8,0,35,27
1657182839427,MATH 20C,A03,093476,Briones; Jor-el Thomas Caparas,0,1,36,36
1657182839427,MATH 20C,B01,083762,Bach; Quang Tran,1,0,30,29
1657182845458,MATH 20D,A01,083765,Tran; Brian Kha,4,0,30,26
1657182845458,MATH 20D,A02,083766,Tran; Brian Kha,5,0,30,25
1657182845458,MATH 20D,A03,083767,Tran; Brian Kha,4,0,30,26
1657182851486,MATH 20E,A01,083771,Ganguly; Soumya,7,0,32,25
1657182851486,MATH 20E,A02,083772,Ganguly; Soumya,7,0,32,25
1657182851486,MATH 20E,B01,083773,Ciotti; Benjamin,19,0,35,16
1657182851486,MATH 20E,B02,083774,Ciotti; Benjamin,17,0,35,18
1657182857513,MATH 103A,A01,083777,Greenfeld; Be'Eri,2,0,36,34
1657182857513,MATH 103A,A02,083778,Greenfeld; Be'Eri,5,0,36,31
1657182857513,MATH 103A,A03,093561,Greenfeld; Be'Eri,4,0,36,32
1657182857513,MATH 103A,B01,083779,Greenfeld; Be'Eri,6,0,36,30
1657182857513,MATH 103A,B02,083780,Greenfeld; Be'Eri,3,0,36,33
1657182857513,MATH 103A,B03,093562,Greenfeld; Be'Eri,3,0,36,33
1657182863543,MATH 105,A01,085443,Carter; Anne Toulson,14,0,35,21
1657182863543,MATH 105,A02,093477,Carter; Anne Toulson,20,0,35,15
1657182869573,MATH 109,A01,083213,Ganzberger; Geoffrey Michael,2,0,34,32
1657182869573,MATH 109,A02,083214,Ganzberger; Geoffrey Michael,3,0,34,31
1657182869573,MATH 109,A03,093478,Ganzberger; Geoffrey Michael,1,0,34,33
1657182869573,MATH 109,B01,083215,Ganzberger; Geoffrey Michael,1,0,32,31
1657182869573,MATH 109,B02,083216,Ganzberger; Geoffrey Michael,1,0,32,31
1657182869573,MATH 109,B03,093479,Ganzberger; Geoffrey Michael,6,0,32,26
1657182875599,MATH 142A,A01,083219,Chow; Bennett,6,0,32,26
1657182875599,MATH 142A,A02,083220,Chow; Bennett,10,0,32,22
1657182875599,MATH 142A,A03,093480,Chow; Bennett,7,0,32,25
1657182875599,MATH 142A,B03,093481,Chow; Bennett,8,0,32,24
1657182875599,MATH 142A,B04,093558,Chow; Bennett,11,0,32,21
1657182875599,MATH 142A,B05,093559,Chow; Bennett,6,0,32,26
1657182881625,MATH 193A,A01,083224,Rotar; Vladimir,7,0,34,27
1657182881625,MATH 193A,A02,083225,Rotar; Vladimir,5,0,34,29
1657182881625,MATH 193A,A03,083781,Rotar; Vladimir,1,0,34,33
1657182881625,MATH 193A,A04,083782,Rotar; Vladimir,8,0,34,26
1657182881625,MATH 193A,A05,093482,Rotar; Vladimir,6,0,34,28
1657182887649,MATH 197,001,091859,McAuley; Julian John,9999,0,9999,0
1657182887649,MATH 197,002,095566,Kedlaya; Kiran S.,9997,0,9999,2
1657182887649,MATH 197,003,095567,Xiao; Ming,9999,0,9999,0
1657182887649,MATH 197,004,095571,Perols; Johan Lars,9998,0,9999,1
1657182894722,COGS 9,A01,083615,Shannon; Kyle Michael,7,0,75,68
1657182900746,COGS 11,A01,083617,Boyle; Mary E. T.,22,0,48,26
1657182906775,COGS 13,A01,083071,Bastos; Amalia Pinkusfeld,9,0,71,62
1657182912800,COGS 14A,A01,092681,Semenuks; Arturs,1,1,100,99
1657182918828,COGS 14B,A01,083073,Cheng; Tzu-Han,6,0,63,57
1657182924852,COGS 17,A01,092677,Semenuks; Arturs,4,0,81,77
1657182930906,COGS 100,A01,083619,Allen; Michael Gordon,15,0,70,55
1657182936932,COGS 101A,A01,083621,Davis; Joshua Daniel,9,0,68,59
1657182942957,COGS 101B,A01,091572,Allen; Michael Gordon,9,0,65,56
1657182948982,COGS 101C,A01,083625,Delgado; Tania,17,0,35,18
1657182955006,COGS 107A,A01,083627,Boyle; Mary E. T.,13,0,60,47
1657182961029,COGS 118A,A01,083075,Gupta; Anjum,16,0,76,60
1657182967059,CSE 3,A50,083646,Miranda; Gregory Joseph,24,0,50,26
1657182973087,CSE 8A,A50,083650,Miranda; Gregory Joseph,17,1,56,39
1657182979116,CSE 11,A01,083080,Cao; Yingjun,5,15,40,35
1657182985145,CSE 12,A01,083652,Krause-Levy; Sophia Louisa,24,1,120,96
1657182991174,CSE 15L,A01,083654,Morris; Justin Loren,9,0,50,41
1657182991174,CSE 15L,A02,083655,Morris; Justin Loren,9,0,50,41
1657182997197,CSE 20,A01,083657,Tran; Khoa Dang,38,0,80,42
1657183003222,CSE 21,A01,095574,Bach; Quang Tran,22,0,48,26
1657183009255,CSE 30,A01,083084,Eldon; John,4,0,80,76
1657183009255,CSE 30,B01,095061,Bhaskar; Nishant,7,0,50,43
1657183015281,CSE 100,A01,083659,Cao; Yingjun,4,4,70,66
1657183021309,CSE 134B,A01,083661,Powell; Thomas Allan,20,0,100,80
1657183027335,CSE 140,A01,083663,Gungor; Onat,13,0,85,72
1657183033359,CSE 140L,A01,083088,Eldon; John,17,0,100,83
1657183039383,CSE 175,A01,083665,Kumar; Rakesh,3,0,25,22
1657183045408,CSE 190,A00,092507,Dubnov; Shlomo,7,0,20,13
1657183051436,ECE 45,A01,083139,Congero; Spencer William,5,0,75,70
1657183057467,ECE 65,A50,083695,Saad; Andrew S,12,0,30,18
1657183057467,ECE 65,A51,095125,Saad; Andrew S,25,0,26,1
1657183063491,ECE 109,A01,091882,Touri; Behrouz,19,0,70,51
1657183069517,ECE 180,A00,083140,Abi Samra; Nicholas Camill,1,0,30,29
1657183069517,ECE 180,B00,083141,Abi Samra; Nicholas Camill,0,0,30,30
1657183075546,MATH 10A,A01,083735,Patchell; Gregory David,2,0,30,28
1657183075546,MATH 10A,A02,083736,Patchell; Gregory David,20,0,30,10
1657183075546,MATH 10A,A03,083737,Patchell; Gregory David,16,0,30,14
1657183081579,MATH 10B,A01,083207,Lim; Seonhee,7,0,34,27
1657183081579,MATH 10B,A02,083208,Lim; Seonhee,9,0,35,26
1657183081579,MATH 10B,A03,093472,Lim; Seonhee,5,0,34,29
1657183081579,MATH 10B,B01,083739,Sinha; Shubham,10,0,30,20
1657183087602,MATH 18,A01,083743,Cinel; Cameron Alexander,6,0,30,24
1657183087602,MATH 18,A02,083744,Cinel; Cameron Alexander,15,0,30,15
1657183087602,MATH 18,A03,083745,Cinel; Cameron Alexander,8,0,30,22
1657183087602,MATH 18,B01,083748,Rideout; David Porter,4,0,37,33
1657183087602,MATH 18,B02,083749,Rideout; David Porter,4,0,36,32
1657183087602,MATH 18,B03,083750,Rideout; David Porter,2,0,37,35
1657183087602,MATH 18,B04,083751,Rideout; David Porter,5,0,36,31
1657183087602,MATH 18,B05,093473,Rideout; David Porter,5,0,36,31
1657183087602,MATH 18,B06,093474,Rideout; David Porter,5,0,36,31
1657183093625,MATH 20A,A01,083754,Zheng; Zequn,13,0,40,27
1657183099656,MATH 20B,A01,083756,Briones; Jor-el Thomas Caparas,1,0,36,35
1657183099656,MATH 20B,A02,083757,Briones; Jor-el Thomas Caparas,1,0,36,35
1657183099656,MATH 20B,A03,093475,Briones; Jor-el Thomas Caparas,1,0,36,35
1657183105680,MATH 20C,A01,083760,Briones; Jor-el Thomas Caparas,1,0,35,34
1657183105680,MATH 20C,A02,083761,Briones; Jor-el Thomas Caparas,8,0,35,27
1657183105680,MATH 20C,A03,093476,Briones; Jor-el Thomas Caparas,0,1,36,36
1657183105680,MATH 20C,B01,083762,Bach; Quang Tran,1,0,30,29
1657183111704,MATH 20D,A01,083765,Tran; Brian Kha,4,0,30,26
1657183111704,MATH 20D,A02,083766,Tran; Brian Kha,5,0,30,25
1657183111704,MATH 20D,A03,083767,Tran; Brian Kha,4,0,30,26
1657183117729,MATH 20E,A01,083771,Ganguly; Soumya,7,0,32,25
1657183117729,MATH 20E,A02,083772,Ganguly; Soumya,7,0,32,25
1657183117729,MATH 20E,B01,083773,Ciotti; Benjamin,19,0,35,16
1657183117729,MATH 20E,B02,083774,Ciotti; Benjamin,17,0,35,18
1657183123754,MATH 103A,A01,083777,Greenfeld; Be'Eri,2,0,36,34
1657183123754,MATH 103A,A02,083778,Greenfeld; Be'Eri,5,0,36,31
1657183123754,MATH 103A,A03,093561,Greenfeld; Be'Eri,4,0,36,32
1657183123754,MATH 103A,B01,083779,Greenfeld; Be'Eri,6,0,36,30
1657183123754,MATH 103A,B02,083780,Greenfeld; Be'Eri,3,0,36,33
1657183123754,MATH 103A,B03,093562,Greenfeld; Be'Eri,3,0,36,33
1657183129777,MATH 105,A01,085443,Carter; Anne Toulson,14,0,35,21
1657183129777,MATH 105,A02,093477,Carter; Anne Toulson,20,0,35,15
1657183135804,MATH 109,A01,083213,Ganzberger; Geoffrey Michael,2,0,34,32
1657183135804,MATH 109,A02,083214,Ganzberger; Geoffrey Michael,3,0,34,31
1657183135804,MATH 109,A03,093478,Ganzberger; Geoffrey Michael,1,0,34,33
1657183135804,MATH 109,B01,083215,Ganzberger; Geoffrey Michael,1,0,32,31
1657183135804,MATH 109,B02,083216,Ganzberger; Geoffrey Michael,1,0,32,31
1657183135804,MATH 109,B03,093479,Ganzberger; Geoffrey Michael,6,0,32,26
1657183141838,MATH 142A,A01,083219,Chow; Bennett,6,0,32,26
1657183141838,MATH 142A,A02,083220,Chow; Bennett,10,0,32,22
1657183141838,MATH 142A,A03,093480,Chow; Bennett,7,0,32,25
1657183141838,MATH 142A,B03,093481,Chow; Bennett,8,0,32,24
1657183141838,MATH 142A,B04,093558,Chow; Bennett,11,0,32,21
1657183141838,MATH 142A,B05,093559,Chow; Bennett,6,0,32,26
1657183147866,MATH 193A,A01,083224,Rotar; Vladimir,7,0,34,27
1657183147866,MATH 193A,A02,083225,Rotar; Vladimir,5,0,34,29
1657183147866,MATH 193A,A03,083781,Rotar; Vladimir,1,0,34,33
1657183147866,MATH 193A,A04,083782,Rotar; Vladimir,8,0,34,26
1657183147866,MATH 193A,A05,093482,Rotar; Vladimir,6,0,34,28
1657183153891,MATH 197,001,091859,McAuley; Julian John,9999,0,9999,0
1657183153891,MATH 197,002,095566,Kedlaya; Kiran S.,9997,0,9999,2
1657183153891,MATH 197,003,095567,Xiao; Ming,9999,0,9999,0
1657183153891,MATH 197,004,095571,Perols; Johan Lars,9998,0,9999,1
1657183160962,COGS 9,A01,083615,Shannon; Kyle Michael,7,0,75,68
1657183166988,COGS 11,A01,083617,Boyle; Mary E. T.,22,0,48,26
1657183173014,COGS 13,A01,083071,Bastos; Amalia Pinkusfeld,9,0,71,62
1657183179043,COGS 14A,A01,092681,Semenuks; Arturs,1,1,100,99
1657183185066,COGS 14B,A01,083073,Cheng; Tzu-Han,6,0,63,57
1657183191089,COGS 17,A01,092677,Semenuks; Arturs,4,0,81,77
1657183197121,COGS 100,A01,083619,Allen; Michael Gordon,15,0,70,55
1657183203144,COGS 101A,A01,083621,Davis; Joshua Daniel,9,0,68,59
1657183209167,COGS 101B,A01,091572,Allen; Michael Gordon,9,0,65,56
1657183215204,COGS 101C,A01,083625,Delgado; Tania,17,0,35,18
1657183221227,COGS 107A,A01,083627,Boyle; Mary E. T.,13,0,60,47
1657183227249,COGS 118A,A01,083075,Gupta; Anjum,16,0,76,60
1657183233273,CSE 3,A50,083646,Miranda; Gregory Joseph,24,0,50,26
1657183239297,CSE 8A,A50,083650,Miranda; Gregory Joseph,17,1,56,39
1657183245323,CSE 11,A01,083080,Cao; Yingjun,5,15,40,35
1657183251352,CSE 12,A01,083652,Krause-Levy; Sophia Louisa,24,1,120,96
1657183257378,CSE 15L,A01,083654,Morris; Justin Loren,9,0,50,41
1657183257378,CSE 15L,A02,083655,Morris; Justin Loren,9,0,50,41
1657183263403,CSE 20,A01,083657,Tran; Khoa Dang,38,0,80,42
1657183269427,CSE 21,A01,095574,Bach; Quang Tran,22,0,48,26
1657183275455,CSE 30,A01,083084,Eldon; John,4,0,80,76
1657183275455,CSE 30,B01,095061,Bhaskar; Nishant,7,0,50,43
1657183281581,CSE 100,A01,083659,Cao; Yingjun,4,4,70,66
1657183287613,CSE 134B,A01,083661,Powell; Thomas Allan,20,0,100,80
1657183293642,CSE 140,A01,083663,Gungor; Onat,13,0,85,72
1657183299665,CSE 140L,A01,083088,Eldon; John,17,0,100,83
1657183305694,CSE 175,A01,083665,Kumar; Rakesh,3,0,25,22
1657183311719,CSE 190,A00,092507,Dubnov; Shlomo,7,0,20,13
1657183317744,ECE 45,A01,083139,Congero; Spencer William,5,0,75,70
1657183323770,ECE 65,A50,083695,Saad; Andrew S,12,0,30,18
1657183323770,ECE 65,A51,095125,Saad; Andrew S,25,0,26,1
1657183329793,ECE 109,A01,091882,Touri; Behrouz,19,0,70,51
1657183335822,ECE 180,A00,083140,Abi Samra; Nicholas Camill,1,0,30,29
1657183335822,ECE 180,B00,083141,Abi Samra; Nicholas Camill,0,0,30,30
1657183341848,MATH 10A,A01,083735,Patchell; Gregory David,2,0,30,28
1657183341848,MATH 10A,A02,083736,Patchell; Gregory David,20,0,30,10
1657183341848,MATH 10A,A03,083737,Patchell; Gregory David,16,0,30,14
1657183347874,MATH 10B,A01,083207,Lim; Seonhee,7,0,34,27
1657183347874,MATH 10B,A02,083208,Lim; Seonhee,9,0,35,26
1657183347874,MATH 10B,A03,093472,Lim; Seonhee,5,0,34,29
1657183347874,MATH 10B,B01,083739,Sinha; Shubham,10,0,30,20
1657183353913,MATH 18,A01,083743,Cinel; Cameron Alexander,6,0,30,24
1657183353913,MATH 18,A02,083744,Cinel; Cameron Alexander,15,0,30,15
1657183353913,MATH 18,A03,083745,Cinel; Cameron Alexander,8,0,30,22
1657183353913,MATH 18,B01,083748,Rideout; David Porter,4,0,37,33
1657183353913,MATH 18,B02,083749,Rideout; David Porter,4,0,36,32
1657183353913,MATH 18,B03,083750,Rideout; David Porter,2,0,37,35
1657183353913,MATH 18,B04,083751,Rideout; David Porter,5,0,36,31
1657183353913,MATH 18,B05,093473,Rideout; David Porter,5,0,36,31
1657183353913,MATH 18,B06,093474,Rideout; David Porter,5,0,36,31
1657183359936,MATH 20A,A01,083754,Zheng; Zequn,13,0,40,27
1657183365963,MATH 20B,A01,083756,Briones; Jor-el Thomas Caparas,1,0,36,35
1657183365963,MATH 20B,A02,083757,Briones; Jor-el Thomas Caparas,1,0,36,35
1657183365963,MATH 20B,A03,093475,Briones; Jor-el Thomas Caparas,1,0,36,35
1657183371988,MATH 20C,A01,083760,Briones; Jor-el Thomas Caparas,1,0,35,34
1657183371988,MATH 20C,A02,083761,Briones; Jor-el Thomas Caparas,8,0,35,27
1657183371988,MATH 20C,A03,093476,Briones; Jor-el Thomas Caparas,0,1,36,36
1657183371988,MATH 20C,B01,083762,Bach; Quang Tran,1,0,30,29
1657183378016,MATH 20D,A01,083765,Tran; Brian Kha,4,0,30,26
1657183378016,MATH 20D,A02,083766,Tran; Brian Kha,5,0,30,25
1657183378016,MATH 20D,A03,083767,Tran; Brian Kha,4,0,30,26
1657183384042,MATH 20E,A01,083771,Ganguly; Soumya,7,0,32,25
1657183384042,MATH 20E,A02,083772,Ganguly; Soumya,7,0,32,25
1657183384042,MATH 20E,B01,083773,Ciotti; Benjamin,19,0,35,16
1657183384042,MATH 20E,B02,083774,Ciotti; Benjamin,17,0,35,18
1657183390078,MATH 103A,A01,083777,Greenfeld; Be'Eri,2,0,36,34
1657183390078,MATH 103A,A02,083778,Greenfeld; Be'Eri,5,0,36,31
1657183390078,MATH 103A,A03,093561,Greenfeld; Be'Eri,4,0,36,32
1657183390078,MATH 103A,B01,083779,Greenfeld; Be'Eri,6,0,36,30
1657183390078,MATH 103A,B02,083780,Greenfeld; Be'Eri,3,0,36,33
1657183390078,MATH 103A,B03,093562,Greenfeld; Be'Eri,3,0,36,33
1657183396104,MATH 105,A01,085443,Carter; Anne Toulson,14,0,35,21
1657183396104,MATH 105,A02,093477,Carter; Anne Toulson,20,0,35,15
1657183402133,MATH 109,A01,083213,Ganzberger; Geoffrey Michael,2,0,34,32
1657183402133,MATH 109,A02,083214,Ganzberger; Geoffrey Michael,3,0,34,31
1657183402133,MATH 109,A03,093478,Ganzberger; Geoffrey Michael,1,0,34,33
1657183402133,MATH 109,B01,083215,Ganzberger; Geoffrey Michael,1,0,32,31
1657183402133,MATH 109,B02,083216,Ganzberger; Geoffrey Michael,1,0,32,31
1657183402133,MATH 109,B03,093479,Ganzberger; Geoffrey Michael,6,0,32,26
1657183408163,MATH 142A,A01,083219,Chow; Bennett,6,0,32,26
1657183408163,MATH 142A,A02,083220,Chow; Bennett,10,0,32,22
1657183408163,MATH 142A,A03,093480,Chow; Bennett,7,0,32,25
1657183408163,MATH 142A,B03,093481,Chow; Bennett,8,0,32,24
1657183408163,MATH 142A,B04,093558,Chow; Bennett,11,0,32,21
1657183408163,MATH 142A,B05,093559,Chow; Bennett,6,0,32,26
1657183414188,MATH 193A,A01,083224,Rotar; Vladimir,7,0,34,27
1657183414188,MATH 193A,A02,083225,Rotar; Vladimir,5,0,34,29
1657183414188,MATH 193A,A03,083781,Rotar; Vladimir,1,0,34,33
1657183414188,MATH 193A,A04,083782,Rotar; Vladimir,8,0,34,26
1657183414188,MATH 193A,A05,093482,Rotar; Vladimir,6,0,34,28
1657183420213,MATH 197,001,091859,McAuley; Julian John,9999,0,9999,0
1657183420213,MATH 197,002,095566,Kedlaya; Kiran S.,9997,0,9999,2
1657183420213,MATH 197,003,095567,Xiao; Ming,9999,0,9999,0
1657183420213,MATH 197,004,095571,Perols; Johan Lars,9998,0,9999,1
1657183427293,COGS 9,A01,083615,Shannon; Kyle Michael,7,0,75,68
1657183433325,COGS 11,A01,083617,Boyle; Mary E. T.,22,0,48,26
1657183439355,COGS 13,A01,083071,Bastos; Amalia Pinkusfeld,9,0,71,62
1657183445389,COGS 14A,A01,092681,Semenuks; Arturs,1,1,100,99
1657183451415,COGS 14B,A01,083073,Cheng; Tzu-Han,6,0,63,57
1657183457444,COGS 17,A01,092677,Semenuks; Arturs,4,0,81,77
1657183463469,COGS 100,A01,083619,Allen; Michael Gordon,15,0,70,55
1657183469494,COGS 101A,A01,083621,Davis; Joshua Daniel,9,0,68,59
1657183475520,COGS 101B,A01,091572,Allen; Michael Gordon,9,0,65,56
1657183481544,COGS 101C,A01,083625,Delgado; Tania,17,0,35,18
1657183487571,COGS 107A,A01,083627,Boyle; Mary E. T.,13,0,60,47
1657183493595,COGS 118A,A01,083075,Gupta; Anjum,16,0,76,60
1657183499621,CSE 3,A50,083646,Miranda; Gregory Joseph,24,0,50,26
1657183505652,CSE 8A,A50,083650,Miranda; Gregory Joseph,17,1,56,39
1657183511675,CSE 11,A01,083080,Cao; Yingjun,5,15,40,35
1657183517703,CSE 12,A01,083652,Krause-Levy; Sophia Louisa,24,1,120,96
1657183523730,CSE 15L,A01,083654,Morris; Justin Loren,9,0,50,41
1657183523730,CSE 15L,A02,083655,Morris; Justin Loren,9,0,50,41
1657183529759,CSE 20,A01,083657,Tran; Khoa Dang,38,0,80,42
1657183535782,CSE 21,A01,095574,Bach; Quang Tran,22,0,48,26
1657183541815,CSE 30,A01,083084,Eldon; John,4,0,80,76
1657183541815,CSE 30,B01,095061,Bhaskar; Nishant,7,0,50,43
1657183547840,CSE 100,A01,083659,Cao; Yingjun,4,4,70,66
1657183553867,CSE 134B,A01,083661,Powell; Thomas Allan,20,0,100,80
1657183559892,CSE 140,A01,083663,Gungor; Onat,13,0,85,72
1657183565924,CSE 140L,A01,083088,Eldon; John,17,0,100,83
1657183571950,CSE 175,A01,083665,Kumar; Rakesh,3,0,25,22
1657183577975,CSE 190,A00,092507,Dubnov; Shlomo,7,0,20,13
1657183584006,ECE 45,A01,083139,Congero; Spencer William,5,0,75,70
1657183590038,ECE 65,A50,083695,Saad; Andrew S,12,0,30,18
1657183590038,ECE 65,A51,095125,Saad; Andrew S,25,0,26,1
1657183596063,ECE 109,A01,091882,Touri; Behrouz,19,0,70,51
1657183602098,ECE 180,A00,083140,Abi Samra; Nicholas Camill,1,0,30,29
1657183602098,ECE 180,B00,083141,Abi Samra; Nicholas Camill,0,0,30,30
1657183608130,MATH 10A,A01,083735,Patchell; Gregory David,2,0,30,28
1657183608130,MATH 10A,A02,083736,Patchell; Gregory David,20,0,30,10
1657183608130,MATH 10A,A03,083737,Patchell; Gregory David,16,0,30,14
1657183614168,MATH 10B,A01,083207,Lim; Seonhee,7,0,34,27
1657183614168,MATH 10B,A02,083208,Lim; Seonhee,9,0,35,26
1657183614168,MATH 10B,A03,093472,Lim; Seonhee,5,0,34,29
1657183614168,MATH 10B,B01,083739,Sinha; Shubham,10,0,30,20
1657183620195,MATH 18,A01,083743,Cinel; Cameron Alexander,6,0,30,24
1657183620195,MATH 18,A02,083744,Cinel; Cameron Alexander,15,0,30,15
1657183620195,MATH 18,A03,083745,Cinel; Cameron Alexander,8,0,30,22
1657183620195,MATH 18,B01,083748,Rideout; David Porter,4,0,37,33
1657183620195,MATH 18,B02,083749,Rideout; David Porter,4,0,36,32
1657183620195,MATH 18,B03,083750,Rideout; David Porter,2,0,37,35
1657183620195,MATH 18,B04,083751,Rideout; David Porter,5,0,36,31
1657183620195,MATH 18,B05,093473,Rideout; David Porter,5,0,36,31
1657183620195,MATH 18,B06,093474,Rideout; David Porter,5,0,36,31
1657183626229,MATH 20A,A01,083754,Zheng; Zequn,13,0,40,27
1657183632262,MATH 20B,A01,083756,Briones; Jor-el Thomas Caparas,1,0,36,35
1657183632262,MATH 20B,A02,083757,Briones; Jor-el Thomas Caparas,1,0,36,35
1657183632262,MATH 20B,A03,093475,Briones; Jor-el Thomas Caparas,1,0,36,35
1657183638288,MATH 20C,A01,083760,Briones; Jor-el Thomas Caparas,1,0,35,34
1657183638288,MATH 20C,A02,083761,Briones; Jor-el Thomas Caparas,8,0,35,27
1657183638288,MATH 20C,A03,093476,Briones; Jor-el Thomas Caparas,0,1,36,36
1657183638288,MATH 20C,B01,083762,Bach; Quang Tran,1,0,30,29
1657183644321,MATH 20D,A01,083765,Tran; Brian Kha,4,0,30,26
1657183644321,MATH 20D,A02,083766,Tran; Brian Kha,5,0,30,25
1657183644321,MATH 20D,A03,083767,Tran; Brian Kha,4,0,30,26
1657183650357,MATH 20E,A01,083771,Ganguly; Soumya,7,0,32,25
1657183650357,MATH 20E,A02,083772,Ganguly; Soumya,7,0,32,25
1657183650357,MATH 20E,B01,083773,Ciotti; Benjamin,19,0,35,16
1657183650357,MATH 20E,B02,083774,Ciotti; Benjamin,17,0,35,18
1657183656394,MATH 103A,A01,083777,Greenfeld; Be'Eri,2,0,36,34
1657183656394,MATH 103A,A02,083778,Greenfeld; Be'Eri,5,0,36,31
1657183656394,MATH 103A,A03,093561,Greenfeld; Be'Eri,4,0,36,32
1657183656394,MATH 103A,B01,083779,Greenfeld; Be'Eri,6,0,36,30
1657183656394,MATH 103A,B02,083780,Greenfeld; Be'Eri,3,0,36,33
1657183656394,MATH 103A,B03,093562,Greenfeld; Be'Eri,3,0,36,33
1657183662426,MATH 105,A01,085443,Carter; Anne Toulson,14,0,35,21
1657183662426,MATH 105,A02,093477,Carter; Anne Toulson,20,0,35,15
1657183668459,MATH 109,A01,083213,Ganzberger; Geoffrey Michael,2,0,34,32
1657183668459,MATH 109,A02,083214,Ganzberger; Geoffrey Michael,3,0,34,31
1657183668459,MATH 109,A03,093478,Ganzberger; Geoffrey Michael,1,0,34,33
1657183668459,MATH 109,B01,083215,Ganzberger; Geoffrey Michael,1,0,32,31
1657183668459,MATH 109,B02,083216,Ganzberger; Geoffrey Michael,1,0,32,31
1657183668459,MATH 109,B03,093479,Ganzberger; Geoffrey Michael,6,0,32,26
1657183674486,MATH 142A,A01,083219,Chow; Bennett,6,0,32,26
1657183674486,MATH 142A,A02,083220,Chow; Bennett,10,0,32,22
1657183674486,MATH 142A,A03,093480,Chow; Bennett,7,0,32,25
1657183674486,MATH 142A,B03,093481,Chow; Bennett,8,0,32,24
1657183674486,MATH 142A,B04,093558,Chow; Bennett,11,0,32,21
1657183674486,MATH 142A,B05,093559,Chow; Bennett,6,0,32,26
1657183680514,MATH 193A,A01,083224,Rotar; Vladimir,7,0,34,27
1657183680514,MATH 193A,A02,083225,Rotar; Vladimir,5,0,34,29
1657183680514,MATH 193A,A03,083781,Rotar; Vladimir,1,0,34,33
1657183680514,MATH 193A,A04,083782,Rotar; Vladimir,8,0,34,26
1657183680514,MATH 193A,A05,093482,Rotar; Vladimir,6,0,34,28
1657183686538,MATH 197,001,091859,McAuley; Julian John,9999,0,9999,0
1657183686538,MATH 197,002,095566,Kedlaya; Kiran S.,9997,0,9999,2
1657183686538,MATH 197,003,095567,Xiao; Ming,9999,0,9999,0
1657183686538,MATH 197,004,095571,Perols; Johan Lars,9998,0,9999,1
1657183693611,COGS 9,A01,083615,Shannon; Kyle Michael,7,0,75,68
1657183699643,COGS 11,A01,083617,Boyle; Mary E. T.,22,0,48,26
1657183705683,COGS 13,A01,083071,Bastos; Amalia Pinkusfeld,9,0,71,62
1657183711718,COGS 14A,A01,092681,Semenuks; Arturs,1,1,100,99
1657183717741,COGS 14B,A01,083073,Cheng; Tzu-Han,6,0,63,57
1657183723766,COGS 17,A01,092677,Semenuks; Arturs,4,0,81,77
1657183729798,COGS 100,A01,083619,Allen; Michael Gordon,15,0,70,55
1657183735827,COGS 101A,A01,083621,Davis; Joshua Daniel,9,0,68,59
1657183741852,COGS 101B,A01,091572,Allen; Michael Gordon,9,0,65,56
1657183747880,COGS 101C,A01,083625,Delgado; Tania,17,0,35,18
1657183753909,COGS 107A,A01,083627,Boyle; Mary E. T.,13,0,60,47
1657183759934,COGS 118A,A01,083075,Gupta; Anjum,16,0,76,60
1657183765960,CSE 3,A50,083646,Miranda; Gregory Joseph,24,0,50,26
1657183771984,CSE 8A,A50,083650,Miranda; Gregory Joseph,17,1,56,39
1657183778013,CSE 11,A01,083080,Cao; Yingjun,5,15,40,35
1657183784039,CSE 12,A01,083652,Krause-Levy; Sophia Louisa,24,1,120,96
1657183790063,CSE 15L,A01,083654,Morris; Justin Loren,9,0,50,41
1657183790063,CSE 15L,A02,083655,Morris; Justin Loren,9,0,50,41
1657183796088,CSE 20,A01,083657,Tran; Khoa Dang,38,0,80,42
1657183802119,CSE 21,A01,095574,Bach; Quang Tran,22,0,48,26
1657183808150,CSE 30,A01,083084,Eldon; John,4,0,80,76
1657183808150,CSE 30,B01,095061,Bhaskar; Nishant,7,0,50,43
1657183814173,CSE 100,A01,083659,Cao; Yingjun,4,4,70,66
1657183820202,CSE 134B,A01,083661,Powell; Thomas Allan,20,0,100,80
1657183826229,CSE 140,A01,083663,Gungor; Onat,13,0,85,72
1657183832258,CSE 140L,A01,083088,Eldon; John,17,0,100,83
1657183838283,CSE 175,A01,083665,Kumar; Rakesh,3,0,25,22
1657183844307,CSE 190,A00,092507,Dubnov; Shlomo,7,0,20,13
1657183850346,ECE 45,A01,083139,Congero; Spencer William,5,0,75,70
1657183856377,ECE 65,A50,083695,Saad; Andrew S,12,0,30,18
1657183856377,ECE 65,A51,095125,Saad; Andrew S,25,0,26,1
1657183862404,ECE 109,A01,091882,Touri; Behrouz,19,0,70,51
1657183868427,ECE 180,A00,083140,Abi Samra; Nicholas Camill,1,0,30,29
1657183868427,ECE 180,B00,083141,Abi Samra; Nicholas Camill,0,0,30,30
1657183874456,MATH 10A,A01,083735,Patchell; Gregory David,2,0,30,28
1657183874456,MATH 10A,A02,083736,Patchell; Gregory David,20,0,30,10
1657183874456,MATH 10A,A03,083737,Patchell; Gregory David,16,0,30,14
1657183880582,MATH 10B,A01,083207,Lim; Seonhee,7,0,34,27
1657183880582,MATH 10B,A02,083208,Lim; Seonhee,9,0,35,26
1657183880582,MATH 10B,A03,093472,Lim; Seonhee,5,0,34,29
1657183880582,MATH 10B,B01,083739,Sinha; Shubham,10,0,30,20
1657183886611,MATH 18,A01,083743,Cinel; Cameron Alexander,6,0,30,24
1657183886611,MATH 18,A02,083744,Cinel; Cameron Alexander,15,0,30,15
1657183886611,MATH 18,A03,083745,Cinel; Cameron Alexander,8,0,30,22
1657183886611,MATH 18,B01,083748,Rideout; David Porter,4,0,37,33
1657183886611,MATH 18,B02,083749,Rideout; David Porter,4,0,36,32
1657183886611,MATH 18,B03,083750,Rideout; David Porter,2,0,37,35
1657183886611,MATH 18,B04,083751,Rideout; David Porter,5,0,36,31
1657183886611,MATH 18,B05,093473,Rideout; David Porter,5,0,36,31
1657183886611,MATH 18,B06,093474,Rideout; David Porter,5,0,36,31
1657183892636,MATH 20A,A01,083754,Zheng; Zequn,13,0,40,27
1657183898670,MATH 20B,A01,083756,Briones; Jor-el Thomas Caparas,1,0,36,35
1657183898670,MATH 20B,A02,083757,Briones; Jor-el Thomas Caparas,1,0,36,35
1657183898670,MATH 20B,A03,093475,Briones; Jor-el Thomas Caparas,1,0,36,35
1657183904701,MATH 20C,A01,083760,Briones; Jor-el Thomas Caparas,1,0,35,34
1657183904701,MATH 20C,A02,083761,Briones; Jor-el Thomas Caparas,8,0,35,27
1657183904701,MATH 20C,A03,093476,Briones; Jor-el Thomas Caparas,0,1,36,36
1657183904701,MATH 20C,B01,083762,Bach; Quang Tran,1,0,30,29
1657183910727,MATH 20D,A01,083765,Tran; Brian Kha,4,0,30,26
1657183910727,MATH 20D,A02,083766,Tran; Brian Kha,5,0,30,25
1657183910727,MATH 20D,A03,083767,Tran; Brian Kha,4,0,30,26
1657183916751,MATH 20E,A01,083771,Ganguly; Soumya,7,0,32,25
1657183916751,MATH 20E,A02,083772,Ganguly; Soumya,7,0,32,25
1657183916751,MATH 20E,B01,083773,Ciotti; Benjamin,19,0,35,16
1657183916751,MATH 20E,B02,083774,Ciotti; Benjamin,17,0,35,18
1657183922784,MATH 103A,A01,083777,Greenfeld; Be'Eri,2,0,36,34
1657183922784,MATH 103A,A02,083778,Greenfeld; Be'Eri,5,0,36,31
1657183922784,MATH 103A,A03,093561,Greenfeld; Be'Eri,4,0,36,32
1657183922784,MATH 103A,B01,083779,Greenfeld; Be'Eri,6,0,36,30
1657183922784,MATH 103A,B02,083780,Greenfeld; Be'Eri,3,0,36,33
1657183922784,MATH 103A,B03,093562,Greenfeld; Be'Eri,3,0,36,33
1657183928808,MATH 105,A01,085443,Carter; Anne Toulson,14,0,35,21
1657183928808,MATH 105,A02,093477,Carter; Anne Toulson,20,0,35,15
1657183934833,MATH 109,A01,083213,Ganzberger; Geoffrey Michael,2,0,34,32
1657183934833,MATH 109,A02,083214,Ganzberger; Geoffrey Michael,3,0,34,31
1657183934833,MATH 109,A03,093478,Ganzberger; Geoffrey Michael,1,0,34,33
1657183934833,MATH 109,B01,083215,Ganzberger; Geoffrey Michael,1,0,32,31
1657183934833,MATH 109,B02,083216,Ganzberger; Geoffrey Michael,1,0,32,31
1657183934833,MATH 109,B03,093479,Ganzberger; Geoffrey Michael,6,0,32,26
1657183940859,MATH 142A,A01,083219,Chow; Bennett,6,0,32,26
1657183940859,MATH 142A,A02,083220,Chow; Bennett,10,0,32,22
1657183940859,MATH 142A,A03,093480,Chow; Bennett,7,0,32,25
1657183940859,MATH 142A,B03,093481,Chow; Bennett,8,0,32,24
1657183940859,MATH 142A,B04,093558,Chow; Bennett,11,0,32,21
1657183940859,MATH 142A,B05,093559,Chow; Bennett,6,0,32,26
1657183946888,MATH 193A,A01,083224,Rotar; Vladimir,7,0,34,27
1657183946888,MATH 193A,A02,083225,Rotar; Vladimir,5,0,34,29
1657183946888,MATH 193A,A03,083781,Rotar; Vladimir,1,0,34,33
1657183946888,MATH 193A,A04,083782,Rotar; Vladimir,8,0,34,26
1657183946888,MATH 193A,A05,093482,Rotar; Vladimir,6,0,34,28
1657183952917,MATH 197,001,091859,McAuley; Julian John,9999,0,9999,0
1657183952917,MATH 197,002,095566,Kedlaya; Kiran S.,9997,0,9999,2
1657183952917,MATH 197,003,095567,Xiao; Ming,9999,0,9999,0
1657183952917,MATH 197,004,095571,Perols; Johan Lars,9998,0,9999,1
1657183959992,COGS 9,A01,083615,Shannon; Kyle Michael,7,0,75,68
1657183966016,COGS 11,A01,083617,Boyle; Mary E. T.,22,0,48,26
1657183972040,COGS 13,A01,083071,Bastos; Amalia Pinkusfeld,9,0,71,62
1657183978064,COGS 14A,A01,092681,Semenuks; Arturs,1,1,100,99
1657183984089,COGS 14B,A01,083073,Cheng; Tzu-Han,6,0,63,57
1657183990113,COGS 17,A01,092677,Semenuks; Arturs,4,0,81,77
1657183996134,COGS 100,A01,083619,Allen; Michael Gordon,15,0,70,55
1657184002160,COGS 101A,A01,083621,Davis; Joshua Daniel,9,0,68,59
1657184008187,COGS 101B,A01,091572,Allen; Michael Gordon,9,0,65,56
1657184014214,COGS 101C,A01,083625,Delgado; Tania,17,0,35,18
1657184020236,COGS 107A,A01,083627,Boyle; Mary E. T.,13,0,60,47
1657184026259,COGS 118A,A01,083075,Gupta; Anjum,16,0,76,60
1657184032286,CSE 3,A50,083646,Miranda; Gregory Joseph,24,0,50,26
1657184038311,CSE 8A,A50,083650,Miranda; Gregory Joseph,17,1,56,39
1657184044335,CSE 11,A01,083080,Cao; Yingjun,5,15,40,35
1657184050363,CSE 12,A01,083652,Krause-Levy; Sophia Louisa,24,1,120,96
1657184056386,CSE 15L,A01,083654,Morris; Justin Loren,9,0,50,41
1657184056386,CSE 15L,A02,083655,Morris; Justin Loren,9,0,50,41
1657184062416,CSE 20,A01,083657,Tran; Khoa Dang,38,0,80,42
1657184068440,CSE 21,A01,095574,Bach; Quang Tran,22,0,48,26
1657184074465,CSE 30,A01,083084,Eldon; John,4,0,80,76
1657184074465,CSE 30,B01,095061,Bhaskar; Nishant,7,0,50,43
1657184080490,CSE 100,A01,083659,Cao; Yingjun,4,4,70,66
1657184086517,CSE 134B,A01,083661,Powell; Thomas Allan,20,0,100,80
1657184092544,CSE 140,A01,083663,Gungor; Onat,13,0,85,72
1657184098568,CSE 140L,A01,083088,Eldon; John,17,0,100,83
1657184104591,CSE 175,A01,083665,Kumar; Rakesh,3,0,25,22
1657184110618,CSE 190,A00,092507,Dubnov; Shlomo,7,0,20,13
1657184116642,ECE 45,A01,083139,Congero; Spencer William,5,0,75,70
1657184122666,ECE 65,A50,083695,Saad; Andrew S,12,0,30,18
1657184122666,ECE 65,A51,095125,Saad; Andrew S,25,0,26,1
1657184128692,ECE 109,A01,091882,Touri; Behrouz,19,0,70,51
1657184134717,ECE 180,A00,083140,Abi Samra; Nicholas Camill,1,0,30,29
1657184134717,ECE 180,B00,083141,Abi Samra; Nicholas Camill,0,0,30,30
1657184140740,MATH 10A,A01,083735,Patchell; Gregory David,2,0,30,28
1657184140740,MATH 10A,A02,083736,Patchell; Gregory David,20,0,30,10
1657184140740,MATH 10A,A03,083737,Patchell; Gregory David,16,0,30,14
1657184146762,MATH 10B,A01,083207,Lim; Seonhee,7,0,34,27
1657184146762,MATH 10B,A02,083208,Lim; Seonhee,9,0,35,26
1657184146762,MATH 10B,A03,093472,Lim; Seonhee,5,0,34,29
1657184146762,MATH 10B,B01,083739,Sinha; Shubham,10,0,30,20
1657184152796,MATH 18,A01,083743,Cinel; Cameron Alexander,6,0,30,24
1657184152796,MATH 18,A02,083744,Cinel; Cameron Alexander,15,0,30,15
1657184152796,MATH 18,A03,083745,Cinel; Cameron Alexander,8,0,30,22
1657184152796,MATH 18,B01,083748,Rideout; David Porter,4,0,37,33
1657184152796,MATH 18,B02,083749,Rideout; David Porter,4,0,36,32
1657184152796,MATH 18,B03,083750,Rideout; David Porter,2,0,37,35
1657184152796,MATH 18,B04,083751,Rideout; David Porter,5,0,36,31
1657184152796,MATH 18,B05,093473,Rideout; David Porter,5,0,36,31
1657184152796,MATH 18,B06,093474,Rideout; David Porter,5,0,36,31
1657184158824,MATH 20A,A01,083754,Zheng; Zequn,13,0,40,27
1657184164851,MATH 20B,A01,083756,Briones; Jor-el Thomas Caparas,1,0,36,35
1657184164851,MATH 20B,A02,083757,Briones; Jor-el Thomas Caparas,1,0,36,35
1657184164851,MATH 20B,A03,093475,Briones; Jor-el Thomas Caparas,1,0,36,35
1657184170876,MATH 20C,A01,083760,Briones; Jor-el Thomas Caparas,1,0,35,34
1657184170876,MATH 20C,A02,083761,Briones; Jor-el Thomas Caparas,8,0,35,27
1657184170876,MATH 20C,A03,093476,Briones; Jor-el Thomas Caparas,0,1,36,36
1657184170876,MATH 20C,B01,083762,Bach; Quang Tran,1,0,30,29
1657184176901,MATH 20D,A01,083765,Tran; Brian Kha,4,0,30,26
1657184176901,MATH 20D,A02,083766,Tran; Brian Kha,5,0,30,25
1657184176901,MATH 20D,A03,083767,Tran; Brian Kha,4,0,30,26
1657184182926,MATH 20E,A01,083771,Ganguly; Soumya,7,0,32,25
1657184182926,MATH 20E,A02,083772,Ganguly; Soumya,7,0,32,25
1657184182926,MATH 20E,B01,083773,Ciotti; Benjamin,19,0,35,16
1657184182926,MATH 20E,B02,083774,Ciotti; Benjamin,17,0,35,18
1657184188951,MATH 103A,A01,083777,Greenfeld; Be'Eri,2,0,36,34
1657184188951,MATH 103A,A02,083778,Greenfeld; Be'Eri,5,0,36,31
1657184188951,MATH 103A,A03,093561,Greenfeld; Be'Eri,4,0,36,32
1657184188951,MATH 103A,B01,083779,Greenfeld; Be'Eri,6,0,36,30
1657184188951,MATH 103A,B02,083780,Greenfeld; Be'Eri,3,0,36,33
1657184188951,MATH 103A,B03,093562,Greenfeld; Be'Eri,3,0,36,33
1657184194975,MATH 105,A01,085443,Carter; Anne Toulson,14,0,35,21
1657184194975,MATH 105,A02,093477,Carter; Anne Toulson,20,0,35,15
1657184201000,MATH 109,A01,083213,Ganzberger; Geoffrey Michael,2,0,34,32
1657184201000,MATH 109,A02,083214,Ganzberger; Geoffrey Michael,3,0,34,31
1657184201000,MATH 109,A03,093478,Ganzberger; Geoffrey Michael,1,0,34,33
1657184201000,MATH 109,B01,083215,Ganzberger; Geoffrey Michael,1,0,32,31
1657184201000,MATH 109,B02,083216,Ganzberger; Geoffrey Michael,1,0,32,31
1657184201000,MATH 109,B03,093479,Ganzberger; Geoffrey Michael,6,0,32,26
1657184207025,MATH 142A,A01,083219,Chow; Bennett,6,0,32,26
1657184207025,MATH 142A,A02,083220,Chow; Bennett,10,0,32,22
1657184207025,MATH 142A,A03,093480,Chow; Bennett,7,0,32,25
1657184207025,MATH 142A,B03,093481,Chow; Bennett,8,0,32,24
1657184207025,MATH 142A,B04,093558,Chow; Bennett,11,0,32,21
1657184207025,MATH 142A,B05,093559,Chow; Bennett,6,0,32,26
1657184213052,MATH 193A,A01,083224,Rotar; Vladimir,7,0,34,27
1657184213052,MATH 193A,A02,083225,Rotar; Vladimir,5,0,34,29
1657184213052,MATH 193A,A03,083781,Rotar; Vladimir,1,0,34,33
1657184213052,MATH 193A,A04,083782,Rotar; Vladimir,8,0,34,26
1657184213052,MATH 193A,A05,093482,Rotar; Vladimir,6,0,34,28
1657184219080,MATH 197,001,091859,McAuley; Julian John,9999,0,9999,0
1657184219080,MATH 197,002,095566,Kedlaya; Kiran S.,9997,0,9999,2
1657184219080,MATH 197,003,095567,Xiao; Ming,9999,0,9999,0
1657184219080,MATH 197,004,095571,Perols; Johan Lars,9998,0,9999,1
1657184226141,COGS 9,A01,083615,Shannon; Kyle Michael,7,0,75,68
1657184232164,COGS 11,A01,083617,Boyle; Mary E. T.,22,0,48,26
1657184238187,COGS 13,A01,083071,Bastos; Amalia Pinkusfeld,9,0,71,62
1657184244211,COGS 14A,A01,092681,Semenuks; Arturs,1,1,100,99
1657184250240,COGS 14B,A01,083073,Cheng; Tzu-Han,6,0,63,57
1657184256264,COGS 17,A01,092677,Semenuks; Arturs,4,0,81,77
1657184262291,COGS 100,A01,083619,Allen; Michael Gordon,15,0,70,55
1657184268315,COGS 101A,A01,083621,Davis; Joshua Daniel,9,0,68,59
1657184274337,COGS 101B,A01,091572,Allen; Michael Gordon,9,0,65,56
1657184280365,COGS 101C,A01,083625,Delgado; Tania,17,0,35,18
1657184286395,COGS 107A,A01,083627,Boyle; Mary E. T.,13,0,60,47
1657184292418,COGS 118A,A01,083075,Gupta; Anjum,16,0,76,60
1657184298443,CSE 3,A50,083646,Miranda; Gregory Joseph,24,0,50,26
1657184304471,CSE 8A,A50,083650,Miranda; Gregory Joseph,17,1,56,39
1657184310496,CSE 11,A01,083080,Cao; Yingjun,5,15,40,35
1657184316519,CSE 12,A01,083652,Krause-Levy; Sophia Louisa,24,1,120,96
1657184322541,CSE 15L,A01,083654,Morris; Justin Loren,9,0,50,41
1657184322541,CSE 15L,A02,083655,Morris; Justin Loren,9,0,50,41
1657184328564,CSE 20,A01,083657,Tran; Khoa Dang,38,0,80,42
1657184334591,CSE 21,A01,095574,Bach; Quang Tran,22,0,48,26
1657184340613,CSE 30,A01,083084,Eldon; John,4,0,80,76
1657184340613,CSE 30,B01,095061,Bhaskar; Nishant,7,0,50,43
1657184346637,CSE 100,A01,083659,Cao; Yingjun,4,4,70,66
1657184352664,CSE 134B,A01,083661,Powell; Thomas Allan,20,0,100,80
1657184358690,CSE 140,A01,083663,Gungor; Onat,13,0,85,72
1657184364715,CSE 140L,A01,083088,Eldon; John,17,0,100,83
1657184370741,CSE 175,A01,083665,Kumar; Rakesh,3,0,25,22
1657184376766,CSE 190,A00,092507,Dubnov; Shlomo,7,0,20,13
1657184382795,ECE 45,A01,083139,Congero; Spencer William,5,0,75,70
1657184388822,ECE 65,A50,083695,Saad; Andrew S,12,0,30,18
1657184388822,ECE 65,A51,095125,Saad; Andrew S,25,0,26,1
1657184394851,ECE 109,A01,091882,Touri; Behrouz,19,0,70,51
1657184400873,ECE 180,A00,083140,Abi Samra; Nicholas Camill,1,0,30,29
1657184400873,ECE 180,B00,083141,Abi Samra; Nicholas Camill,0,0,30,30
1657184406899,MATH 10A,A01,083735,Patchell; Gregory David,2,0,30,28
1657184406899,MATH 10A,A02,083736,Patchell; Gregory David,20,0,30,10
1657184406899,MATH 10A,A03,083737,Patchell; Gregory David,16,0,30,14
1657184412926,MATH 10B,A01,083207,Lim; Seonhee,7,0,34,27
1657184412926,MATH 10B,A02,083208,Lim; Seonhee,9,0,35,26
1657184412926,MATH 10B,A03,093472,Lim; Seonhee,5,0,34,29
1657184412926,MATH 10B,B01,083739,Sinha; Shubham,10,0,30,20
1657184418951,MATH 18,A01,083743,Cinel; Cameron Alexander,6,0,30,24
1657184418951,MATH 18,A02,083744,Cinel; Cameron Alexander,15,0,30,15
1657184418951,MATH 18,A03,083745,Cinel; Cameron Alexander,8,0,30,22
1657184418951,MATH 18,B01,083748,Rideout; David Porter,4,0,37,33
1657184418951,MATH 18,B02,083749,Rideout; David Porter,4,0,36,32
1657184418951,MATH 18,B03,083750,Rideout; David Porter,2,0,37,35
1657184418951,MATH 18,B04,083751,Rideout; David Porter,5,0,36,31
1657184418951,MATH 18,B05,093473,Rideout; David Porter,5,0,36,31
1657184418951,MATH 18,B06,093474,Rideout; David Porter,5,0,36,31
1657184424980,MATH 20A,A01,083754,Zheng; Zequn,13,0,40,27
1657184431004,MATH 20B,A01,083756,Briones; Jor-el Thomas Caparas,1,0,36,35
1657184431004,MATH 20B,A02,083757,Briones; Jor-el Thomas Caparas,1,0,36,35
1657184431004,MATH 20B,A03,093475,Briones; Jor-el Thomas Caparas,1,0,36,35
1657184437028,MATH 20C,A01,083760,Briones; Jor-el Thomas Caparas,1,0,35,34
1657184437028,MATH 20C,A02,083761,Briones; Jor-el Thomas Caparas,8,0,35,27
1657184437028,MATH 20C,A03,093476,Briones; Jor-el Thomas Caparas,0,1,36,36
1657184437028,MATH 20C,B01,083762,Bach; Quang Tran,1,0,30,29
1657184443051,MATH 20D,A01,083765,Tran; Brian Kha,4,0,30,26
1657184443051,MATH 20D,A02,083766,Tran; Brian Kha,5,0,30,25
1657184443051,MATH 20D,A03,083767,Tran; Brian Kha,4,0,30,26
1657184449075,MATH 20E,A01,083771,Ganguly; Soumya,7,0,32,25
1657184449075,MATH 20E,A02,083772,Ganguly; Soumya,7,0,32,25
1657184449075,MATH 20E,B01,083773,Ciotti; Benjamin,19,0,35,16
1657184449075,MATH 20E,B02,083774,Ciotti; Benjamin,17,0,35,18
1657184455106,MATH 103A,A01,083777,Greenfeld; Be'Eri,2,0,36,34
1657184455106,MATH 103A,A02,083778,Greenfeld; Be'Eri,5,0,36,31
1657184455106,MATH 103A,A03,093561,Greenfeld; Be'Eri,4,0,36,32
1657184455106,MATH 103A,B01,083779,Greenfeld; Be'Eri,6,0,36,30
1657184455106,MATH 103A,B02,083780,Greenfeld; Be'Eri,3,0,36,33
1657184455106,MATH 103A,B03,093562,Greenfeld; Be'Eri,3,0,36,33
1657184461128,MATH 105,A01,085443,Carter; Anne Toulson,14,0,35,21
1657184461128,MATH 105,A02,093477,Carter; Anne Toulson,20,0,35,15
1657184467153,MATH 109,A01,083213,Ganzberger; Geoffrey Michael,2,0,34,32
1657184467153,MATH 109,A02,083214,Ganzberger; Geoffrey Michael,3,0,34,31
1657184467153,MATH 109,A03,093478,Ganzberger; Geoffrey Michael,1,0,34,33
1657184467153,MATH 109,B01,083215,Ganzberger; Geoffrey Michael,1,0,32,31
1657184467153,MATH 109,B02,083216,Ganzberger; Geoffrey Michael,1,0,32,31
1657184467153,MATH 109,B03,093479,Ganzberger; Geoffrey Michael,6,0,32,26
1657184473184,MATH 142A,A01,083219,Chow; Bennett,6,0,32,26
1657184473184,MATH 142A,A02,083220,Chow; Bennett,10,0,32,22
1657184473184,MATH 142A,A03,093480,Chow; Bennett,7,0,32,25
1657184473184,MATH 142A,B03,093481,Chow; Bennett,8,0,32,24
1657184473184,MATH 142A,B04,093558,Chow; Bennett,11,0,32,21
1657184473184,MATH 142A,B05,093559,Chow; Bennett,6,0,32,26
1657184479286,MATH 193A,A01,083224,Rotar; Vladimir,7,0,34,27
1657184479286,MATH 193A,A02,083225,Rotar; Vladimir,5,0,34,29
1657184479286,MATH 193A,A03,083781,Rotar; Vladimir,1,0,34,33
1657184479286,MATH 193A,A04,083782,Rotar; Vladimir,8,0,34,26
1657184479286,MATH 193A,A05,093482,Rotar; Vladimir,6,0,34,28
1657184485310,MATH 197,001,091859,McAuley; Julian John,9999,0,9999,0
1657184485310,MATH 197,002,095566,Kedlaya; Kiran S.,9997,0,9999,2
1657184485310,MATH 197,003,095567,Xiao; Ming,9999,0,9999,0
1657184485310,MATH 197,004,095571,Perols; Johan Lars,9998,0,9999,1
1657184492365,COGS 9,A01,083615,Shannon; Kyle Michael,7,0,75,68
1657184498390,COGS 11,A01,083617,Boyle; Mary E. T.,22,0,48,26
1657184504415,COGS 13,A01,083071,Bastos; Amalia Pinkusfeld,9,0,71,62
1657184510441,COGS 14A,A01,092681,Semenuks; Arturs,1,1,100,99
1657184516467,COGS 14B,A01,083073,Cheng; Tzu-Han,6,0,63,57
1657184522499,COGS 17,A01,092677,Semenuks; Arturs,4,0,81,77
1657184528530,COGS 100,A01,083619,Allen; Michael Gordon,15,0,70,55
1657184534554,COGS 101A,A01,083621,Davis; Joshua Daniel,9,0,68,59
1657184540579,COGS 101B,A01,091572,Allen; Michael Gordon,9,0,65,56
1657184546603,COGS 101C,A01,083625,Delgado; Tania,17,0,35,18
1657184552624,COGS 107A,A01,083627,Boyle; Mary E. T.,13,0,60,47
1657184558651,COGS 118A,A01,083075,Gupta; Anjum,16,0,76,60
1657184564681,CSE 3,A50,083646,Miranda; Gregory Joseph,24,0,50,26
1657184570706,CSE 8A,A50,083650,Miranda; Gregory Joseph,17,1,56,39
1657184576729,CSE 11,A01,083080,Cao; Yingjun,5,15,40,35
1657184582758,CSE 12,A01,083652,Krause-Levy; Sophia Louisa,24,1,120,96
1657184588789,CSE 15L,A01,083654,Morris; Justin Loren,9,0,50,41
1657184588789,CSE 15L,A02,083655,Morris; Justin Loren,9,0,50,41
1657184594817,CSE 20,A01,083657,Tran; Khoa Dang,38,0,80,42
1657184600845,CSE 21,A01,095574,Bach; Quang Tran,22,0,48,26
1657184606877,CSE 30,A01,083084,Eldon; John,4,0,80,76
1657184606877,CSE 30,B01,095061,Bhaskar; Nishant,7,0,50,43
1657184612906,CSE 100,A01,083659,Cao; Yingjun,4,4,70,66
1657184618931,CSE 134B,A01,083661,Powell; Thomas Allan,20,0,100,80
1657184624956,CSE 140,A01,083663,Gungor; Onat,13,0,85,72
1657184630983,CSE 140L,A01,083088,Eldon; John,17,0,100,83
1657184637011,CSE 175,A01,083665,Kumar; Rakesh,3,0,25,22
1657184643033,CSE 190,A00,092507,Dubnov; Shlomo,7,0,20,13
1657184649059,ECE 45,A01,083139,Congero; Spencer William,5,0,75,70
1657184655086,ECE 65,A50,083695,Saad; Andrew S,12,0,30,18
1657184655086,ECE 65,A51,095125,Saad; Andrew S,25,0,26,1
1657184661115,ECE 109,A01,091882,Touri; Behrouz,19,0,70,51
1657184667140,ECE 180,A00,083140,Abi Samra; Nicholas Camill,1,0,30,29
1657184667140,ECE 180,B00,083141,Abi Samra; Nicholas Camill,0,0,30,30
1657184673166,MATH 10A,A01,083735,Patchell; Gregory David,2,0,30,28
1657184673166,MATH 10A,A02,083736,Patchell; Gregory David,20,0,30,10
1657184673166,MATH 10A,A03,083737,Patchell; Gregory David,16,0,30,14
1657184679195,MATH 10B,A01,083207,Lim; Seonhee,7,0,34,27
1657184679195,MATH 10B,A02,083208,Lim; Seonhee,9,0,35,26
1657184679195,MATH 10B,A03,093472,Lim; Seonhee,5,0,34,29
1657184679195,MATH 10B,B01,083739,Sinha; Shubham,10,0,30,20
1657184685223,MATH 18,A01,083743,Cinel; Cameron Alexander,6,0,30,24
1657184685223,MATH 18,A02,083744,Cinel; Cameron Alexander,15,0,30,15
1657184685223,MATH 18,A03,083745,Cinel; Cameron Alexander,8,0,30,22
1657184685223,MATH 18,B01,083748,Rideout; David Porter,4,0,37,33
1657184685223,MATH 18,B02,083749,Rideout; David Porter,4,0,36,32
1657184685223,MATH 18,B03,083750,Rideout; David Porter,2,0,37,35
1657184685223,MATH 18,B04,083751,Rideout; David Porter,5,0,36,31
1657184685223,MATH 18,B05,093473,Rideout; David Porter,5,0,36,31
1657184685223,MATH 18,B06,093474,Rideout; David Porter,5,0,36,31
1657184691247,MATH 20A,A01,083754,Zheng; Zequn,13,0,40,27
1657184697275,MATH 20B,A01,083756,Briones; Jor-el Thomas Caparas,1,0,36,35
1657184697275,MATH 20B,A02,083757,Briones; Jor-el Thomas Caparas,1,0,36,35
1657184697275,MATH 20B,A03,093475,Briones; Jor-el Thomas Caparas,1,0,36,35
1657184703301,MATH 20C,A01,083760,Briones; Jor-el Thomas Caparas,1,0,35,34
1657184703301,MATH 20C,A02,083761,Briones; Jor-el Thomas Caparas,8,0,35,27
1657184703301,MATH 20C,A03,093476,Briones; Jor-el Thomas Caparas,0,1,36,36
1657184703301,MATH 20C,B01,083762,Bach; Quang Tran,1,0,30,29
1657184709335,MATH 20D,A01,083765,Tran; Brian Kha,4,0,30,26
1657184709335,MATH 20D,A02,083766,Tran; Brian Kha,5,0,30,25
1657184709335,MATH 20D,A03,083767,Tran; Brian Kha,4,0,30,26
1657184715361,MATH 20E,A01,083771,Ganguly; Soumya,7,0,32,25
1657184715361,MATH 20E,A02,083772,Ganguly; Soumya,7,0,32,25
1657184715361,MATH 20E,B01,083773,Ciotti; Benjamin,19,0,35,16
1657184715361,MATH 20E,B02,083774,Ciotti; Benjamin,17,0,35,18
1657184721386,MATH 103A,A01,083777,Greenfeld; Be'Eri,2,0,36,34
1657184721386,MATH 103A,A02,083778,Greenfeld; Be'Eri,5,0,36,31
1657184721386,MATH 103A,A03,093561,Greenfeld; Be'Eri,4,0,36,32
1657184721386,MATH 103A,B01,083779,Greenfeld; Be'Eri,6,0,36,30
1657184721386,MATH 103A,B02,083780,Greenfeld; Be'Eri,3,0,36,33
1657184721386,MATH 103A,B03,093562,Greenfeld; Be'Eri,3,0,36,33
1657184727416,MATH 105,A01,085443,Carter; Anne Toulson,14,0,35,21
1657184727416,MATH 105,A02,093477,Carter; Anne Toulson,20,0,35,15
1657184733449,MATH 109,A01,083213,Ganzberger; Geoffrey Michael,2,0,34,32
1657184733449,MATH 109,A02,083214,Ganzberger; Geoffrey Michael,3,0,34,31
1657184733449,MATH 109,A03,093478,Ganzberger; Geoffrey Michael,1,0,34,33
1657184733449,MATH 109,B01,083215,Ganzberger; Geoffrey Michael,1,0,32,31
1657184733449,MATH 109,B02,083216,Ganzberger; Geoffrey Michael,1,0,32,31
1657184733449,MATH 109,B03,093479,Ganzberger; Geoffrey Michael,6,0,32,26
1657184739478,MATH 142A,A01,083219,Chow; Bennett,6,0,32,26
1657184739478,MATH 142A,A02,083220,Chow; Bennett,10,0,32,22
1657184739478,MATH 142A,A03,093480,Chow; Bennett,7,0,32,25
1657184739478,MATH 142A,B03,093481,Chow; Bennett,8,0,32,24
1657184739478,MATH 142A,B04,093558,Chow; Bennett,11,0,32,21
1657184739478,MATH 142A,B05,093559,Chow; Bennett,6,0,32,26
1657184745504,MATH 193A,A01,083224,Rotar; Vladimir,7,0,34,27
1657184745504,MATH 193A,A02,083225,Rotar; Vladimir,5,0,34,29
1657184745504,MATH 193A,A03,083781,Rotar; Vladimir,1,0,34,33
1657184745504,MATH 193A,A04,083782,Rotar; Vladimir,8,0,34,26
1657184745504,MATH 193A,A05,093482,Rotar; Vladimir,6,0,34,28
1657184751532,MATH 197,001,091859,McAuley; Julian John,9999,0,9999,0
1657184751532,MATH 197,002,095566,Kedlaya; Kiran S.,9997,0,9999,2
1657184751532,MATH 197,003,095567,Xiao; Ming,9999,0,9999,0
1657184751532,MATH 197,004,095571,Perols; Johan Lars,9998,0,9999,1
1657184758597,COGS 9,A01,083615,Shannon; Kyle Michael,7,0,75,68
1657184764623,COGS 11,A01,083617,Boyle; Mary E. T.,22,0,48,26
1657184770647,COGS 13,A01,083071,Bastos; Amalia Pinkusfeld,9,0,71,62
1657184776671,COGS 14A,A01,092681,Semenuks; Arturs,1,1,100,99
1657184782695,COGS 14B,A01,083073,Cheng; Tzu-Han,6,0,63,57
1657184788719,COGS 17,A01,092677,Semenuks; Arturs,4,0,81,77
1657184794742,COGS 100,A01,083619,Allen; Michael Gordon,15,0,70,55
1657184800769,COGS 101A,A01,083621,Davis; Joshua Daniel,9,0,68,59
1657184806792,COGS 101B,A01,091572,Allen; Michael Gordon,9,0,65,56
1657184812819,COGS 101C,A01,083625,Delgado; Tania,17,0,35,18
1657184818843,COGS 107A,A01,083627,Boyle; Mary E. T.,13,0,60,47
1657184824872,COGS 118A,A01,083075,Gupta; Anjum,16,0,76,60
1657184830897,CSE 3,A50,083646,Miranda; Gregory Joseph,24,0,50,26
1657184836924,CSE 8A,A50,083650,Miranda; Gregory Joseph,17,1,56,39
1657184842961,CSE 11,A01,083080,Cao; Yingjun,5,15,40,35
1657184848993,CSE 12,A01,083652,Krause-Levy; Sophia Louisa,24,1,120,96
1657184855016,CSE 15L,A01,083654,Morris; Justin Loren,9,0,50,41
1657184855016,CSE 15L,A02,083655,Morris; Justin Loren,9,0,50,41
1657184861043,CSE 20,A01,083657,Tran; Khoa Dang,38,0,80,42
1657184867066,CSE 21,A01,095574,Bach; Quang Tran,22,0,48,26
1657184873095,CSE 30,A01,083084,Eldon; John,4,0,80,76
1657184873095,CSE 30,B01,095061,Bhaskar; Nishant,7,0,50,43
1657184879122,CSE 100,A01,083659,Cao; Yingjun,4,4,70,66
1657184885152,CSE 134B,A01,083661,Powell; Thomas Allan,20,0,100,80
1657184891175,CSE 140,A01,083663,Gungor; Onat,13,0,85,72
1657184897201,CSE 140L,A01,083088,Eldon; John,17,0,100,83
1657184903225,CSE 175,A01,083665,Kumar; Rakesh,3,0,25,22
1657184909248,CSE 190,A00,092507,Dubnov; Shlomo,7,0,20,13
1657184915276,ECE 45,A01,083139,Congero; Spencer William,5,0,75,70
1657184921300,ECE 65,A50,083695,Saad; Andrew S,12,0,30,18
1657184921300,ECE 65,A51,095125,Saad; Andrew S,25,0,26,1
1657184927326,ECE 109,A01,091882,Touri; Behrouz,19,0,70,51
1657184933354,ECE 180,A00,083140,Abi Samra; Nicholas Camill,1,0,30,29
1657184933354,ECE 180,B00,083141,Abi Samra; Nicholas Camill,0,0,30,30
1657184939378,MATH 10A,A01,083735,Patchell; Gregory David,2,0,30,28
1657184939378,MATH 10A,A02,083736,Patchell; Gregory David,20,0,30,10
1657184939378,MATH 10A,A03,083737,Patchell; Gregory David,16,0,30,14
1657184945401,MATH 10B,A01,083207,Lim; Seonhee,7,0,34,27
1657184945401,MATH 10B,A02,083208,Lim; Seonhee,9,0,35,26
1657184945401,MATH 10B,A03,093472,Lim; Seonhee,5,0,34,29
1657184945401,MATH 10B,B01,083739,Sinha; Shubham,10,0,30,20
1657184951435,MATH 18,A01,083743,Cinel; Cameron Alexander,6,0,30,24
1657184951435,MATH 18,A02,083744,Cinel; Cameron Alexander,15,0,30,15
1657184951435,MATH 18,A03,083745,Cinel; Cameron Alexander,8,0,30,22
1657184951435,MATH 18,B01,083748,Rideout; David Porter,4,0,37,33
1657184951435,MATH 18,B02,083749,Rideout; David Porter,4,0,36,32
1657184951435,MATH 18,B03,083750,Rideout; David Porter,2,0,37,35
1657184951435,MATH 18,B04,083751,Rideout; David Porter,5,0,36,31
1657184951435,MATH 18,B05,093473,Rideout; David Porter,5,0,36,31
1657184951435,MATH 18,B06,093474,Rideout; David Porter,5,0,36,31
1657184957458,MATH 20A,A01,083754,Zheng; Zequn,13,0,40,27
1657184963485,MATH 20B,A01,083756,Briones; Jor-el Thomas Caparas,1,0,36,35
1657184963485,MATH 20B,A02,083757,Briones; Jor-el Thomas Caparas,1,0,36,35
1657184963485,MATH 20B,A03,093475,Briones; Jor-el Thomas Caparas,1,0,36,35
1657184969508,MATH 20C,A01,083760,Briones; Jor-el Thomas Caparas,1,0,35,34
1657184969508,MATH 20C,A02,083761,Briones; Jor-el Thomas Caparas,8,0,35,27
1657184969508,MATH 20C,A03,093476,Briones; Jor-el Thomas Caparas,0,1,36,36
1657184969508,MATH 20C,B01,083762,Bach; Quang Tran,1,0,30,29
1657184975531,MATH 20D,A01,083765,Tran; Brian Kha,4,0,30,26
1657184975531,MATH 20D,A02,083766,Tran; Brian Kha,5,0,30,25
1657184975531,MATH 20D,A03,083767,Tran; Brian Kha,4,0,30,26
1657184981559,MATH 20E,A01,083771,Ganguly; Soumya,7,0,32,25
1657184981559,MATH 20E,A02,083772,Ganguly; Soumya,7,0,32,25
1657184981559,MATH 20E,B01,083773,Ciotti; Benjamin,19,0,35,16
1657184981559,MATH 20E,B02,083774,Ciotti; Benjamin,17,0,35,18
1657184987583,MATH 103A,A01,083777,Greenfeld; Be'Eri,2,0,36,34
1657184987583,MATH 103A,A02,083778,Greenfeld; Be'Eri,5,0,36,31
1657184987583,MATH 103A,A03,093561,Greenfeld; Be'Eri,4,0,36,32
1657184987583,MATH 103A,B01,083779,Greenfeld; Be'Eri,6,0,36,30
1657184987583,MATH 103A,B02,083780,Greenfeld; Be'Eri,3,0,36,33
1657184987583,MATH 103A,B03,093562,Greenfeld; Be'Eri,3,0,36,33
1657184993609,MATH 105,A01,085443,Carter; Anne Toulson,14,0,35,21
1657184993609,MATH 105,A02,093477,Carter; Anne Toulson,20,0,35,15
1657184999633,MATH 109,A01,083213,Ganzberger; Geoffrey Michael,2,0,34,32
1657184999633,MATH 109,A02,083214,Ganzberger; Geoffrey Michael,3,0,34,31
1657184999633,MATH 109,A03,093478,Ganzberger; Geoffrey Michael,1,0,34,33
1657184999633,MATH 109,B01,083215,Ganzberger; Geoffrey Michael,1,0,32,31
1657184999633,MATH 109,B02,083216,Ganzberger; Geoffrey Michael,1,0,32,31
1657184999633,MATH 109,B03,093479,Ganzberger; Geoffrey Michael,6,0,32,26
1657185005656,MATH 142A,A01,083219,Chow; Bennett,6,0,32,26
1657185005656,MATH 142A,A02,083220,Chow; Bennett,10,0,32,22
1657185005656,MATH 142A,A03,093480,Chow; Bennett,7,0,32,25
1657185005656,MATH 142A,B03,093481,Chow; Bennett,8,0,32,24
1657185005656,MATH 142A,B04,093558,Chow; Bennett,11,0,32,21
1657185005656,MATH 142A,B05,093559,Chow; Bennett,6,0,32,26
1657185011680,MATH 193A,A01,083224,Rotar; Vladimir,7,0,34,27
1657185011680,MATH 193A,A02,083225,Rotar; Vladimir,5,0,34,29
1657185011680,MATH 193A,A03,083781,Rotar; Vladimir,1,0,34,33
1657185011680,MATH 193A,A04,083782,Rotar; Vladimir,8,0,34,26
1657185011680,MATH 193A,A05,093482,Rotar; Vladimir,6,0,34,28
1657185017704,MATH 197,001,091859,McAuley; Julian John,9999,0,9999,0
1657185017704,MATH 197,002,095566,Kedlaya; Kiran S.,9997,0,9999,2
1657185017704,MATH 197,003,095567,Xiao; Ming,9999,0,9999,0
1657185017704,MATH 197,004,095571,Perols; Johan Lars,9998,0,9999,1
1657185024773,COGS 9,A01,083615,Shannon; Kyle Michael,7,0,75,68
1657185030800,COGS 11,A01,083617,Boyle; Mary E. T.,22,0,48,26
1657185036828,COGS 13,A01,083071,Bastos; Amalia Pinkusfeld,9,0,71,62
1657185042856,COGS 14A,A01,092681,Semenuks; Arturs,1,1,100,99
1657185048882,COGS 14B,A01,083073,Cheng; Tzu-Han,6,0,63,57
1657185054909,COGS 17,A01,092677,Semenuks; Arturs,4,0,81,77
1657185060932,COGS 100,A01,083619,Allen; Michael Gordon,15,0,70,55
1657185066961,COGS 101A,A01,083621,Davis; Joshua Daniel,9,0,68,59
1657185073079,COGS 101B,A01,091572,Allen; Michael Gordon,9,0,65,56
1657185079104,COGS 101C,A01,083625,Delgado; Tania,17,0,35,18
1657185085127,COGS 107A,A01,083627,Boyle; Mary E. T.,13,0,60,47
1657185091153,COGS 118A,A01,083075,Gupta; Anjum,16,0,76,60
1657185097178,CSE 3,A50,083646,Miranda; Gregory Joseph,24,0,50,26
1657185103202,CSE 8A,A50,083650,Miranda; Gregory Joseph,17,1,56,39
1657185109227,CSE 11,A01,083080,Cao; Yingjun,5,15,40,35
1657185115250,CSE 12,A01,083652,Krause-Levy; Sophia Louisa,24,1,120,96
1657185121276,CSE 15L,A01,083654,Morris; Justin Loren,9,0,50,41
1657185121276,CSE 15L,A02,083655,Morris; Justin Loren,9,0,50,41
1657185127301,CSE 20,A01,083657,Tran; Khoa Dang,38,0,80,42
1657185133328,CSE 21,A01,095574,Bach; Quang Tran,22,0,48,26
1657185139356,CSE 30,A01,083084,Eldon; John,4,0,80,76
1657185139356,CSE 30,B01,095061,Bhaskar; Nishant,7,0,50,43
1657185145384,CSE 100,A01,083659,Cao; Yingjun,4,4,70,66
1657185151408,CSE 134B,A01,083661,Powell; Thomas Allan,20,0,100,80
1657185157436,CSE 140,A01,083663,Gungor; Onat,13,0,85,72
1657185163459,CSE 140L,A01,083088,Eldon; John,17,0,100,83
1657185169500,CSE 175,A01,083665,Kumar; Rakesh,3,0,25,22
1657185175524,CSE 190,A00,092507,Dubnov; Shlomo,7,0,20,13
1657185181551,ECE 45,A01,083139,Congero; Spencer William,5,0,75,70
1657185187578,ECE 65,A50,083695,Saad; Andrew S,12,0,30,18
1657185187578,ECE 65,A51,095125,Saad; Andrew S,25,0,26,1
1657185193608,ECE 109,A01,091882,Touri; Behrouz,19,0,70,51
1657185199630,ECE 180,A00,083140,Abi Samra; Nicholas Camill,1,0,30,29
1657185199630,ECE 180,B00,083141,Abi Samra; Nicholas Camill,0,0,30,30
1657185205659,MATH 10A,A01,083735,Patchell; Gregory David,2,0,30,28
1657185205659,MATH 10A,A02,083736,Patchell; Gregory David,20,0,30,10
1657185205659,MATH 10A,A03,083737,Patchell; Gregory David,16,0,30,14
1657185211689,MATH 10B,A01,083207,Lim; Seonhee,7,0,34,27
1657185211689,MATH 10B,A02,083208,Lim; Seonhee,9,0,35,26
1657185211689,MATH 10B,A03,093472,Lim; Seonhee,5,0,34,29
1657185211689,MATH 10B,B01,083739,Sinha; Shubham,10,0,30,20
1657185217712,MATH 18,A01,083743,Cinel; Cameron Alexander,6,0,30,24
1657185217712,MATH 18,A02,083744,Cinel; Cameron Alexander,15,0,30,15
1657185217712,MATH 18,A03,083745,Cinel; Cameron Alexander,8,0,30,22
1657185217712,MATH 18,B01,083748,Rideout; David Porter,4,0,37,33
1657185217712,MATH 18,B02,083749,Rideout; David Porter,4,0,36,32
1657185217712,MATH 18,B03,083750,Rideout; David Porter,2,0,37,35
1657185217712,MATH 18,B04,083751,Rideout; David Porter,5,0,36,31
1657185217712,MATH 18,B05,093473,Rideout; David Porter,5,0,36,31
1657185217712,MATH 18,B06,093474,Rideout; David Porter,5,0,36,31
1657185223738,MATH 20A,A01,083754,Zheng; Zequn,13,0,40,27
1657185229761,MATH 20B,A01,083756,Briones; Jor-el Thomas Caparas,1,0,36,35
1657185229761,MATH 20B,A02,083757,Briones; Jor-el Thomas Caparas,1,0,36,35
1657185229761,MATH 20B,A03,093475,Briones; Jor-el Thomas Caparas,1,0,36,35
1657185235783,MATH 20C,A01,083760,Briones; Jor-el Thomas Caparas,1,0,35,34
1657185235783,MATH 20C,A02,083761,Briones; Jor-el Thomas Caparas,8,0,35,27
1657185235783,MATH 20C,A03,093476,Briones; Jor-el Thomas Caparas,0,1,36,36
1657185235783,MATH 20C,B01,083762,Bach; Quang Tran,1,0,30,29
1657185241807,MATH 20D,A01,083765,Tran; Brian Kha,4,0,30,26
1657185241807,MATH 20D,A02,083766,Tran; Brian Kha,5,0,30,25
1657185241807,MATH 20D,A03,083767,Tran; Brian Kha,4,0,30,26
1657185247832,MATH 20E,A01,083771,Ganguly; Soumya,7,0,32,25
1657185247832,MATH 20E,A02,083772,Ganguly; Soumya,7,0,32,25
1657185247832,MATH 20E,B01,083773,Ciotti; Benjamin,19,0,35,16
1657185247832,MATH 20E,B02,083774,Ciotti; Benjamin,17,0,35,18
1657185253856,MATH 103A,A01,083777,Greenfeld; Be'Eri,2,0,36,34
1657185253856,MATH 103A,A02,083778,Greenfeld; Be'Eri,5,0,36,31
1657185253856,MATH 103A,A03,093561,Greenfeld; Be'Eri,4,0,36,32
1657185253856,MATH 103A,B01,083779,Greenfeld; Be'Eri,6,0,36,30
1657185253856,MATH 103A,B02,083780,Greenfeld; Be'Eri,3,0,36,33
1657185253856,MATH 103A,B03,093562,Greenfeld; Be'Eri,3,0,36,33
1657185259881,MATH 105,A01,085443,Carter; Anne Toulson,14,0,35,21
1657185259881,MATH 105,A02,093477,Carter; Anne Toulson,20,0,35,15
1657185265910,MATH 109,A01,083213,Ganzberger; Geoffrey Michael,2,0,34,32
1657185265910,MATH 109,A02,083214,Ganzberger; Geoffrey Michael,3,0,34,31
1657185265910,MATH 109,A03,093478,Ganzberger; Geoffrey Michael,1,0,34,33
1657185265910,MATH 109,B01,083215,Ganzberger; Geoffrey Michael,1,0,32,31
1657185265910,MATH 109,B02,083216,Ganzberger; Geoffrey Michael,1,0,32,31
1657185265910,MATH 109,B03,093479,Ganzberger; Geoffrey Michael,6,0,32,26
1657185271939,MATH 142A,A01,083219,Chow; Bennett,6,0,32,26
1657185271939,MATH 142A,A02,083220,Chow; Bennett,10,0,32,22
1657185271939,MATH 142A,A03,093480,Chow; Bennett,7,0,32,25
1657185271939,MATH 142A,B03,093481,Chow; Bennett,8,0,32,24
1657185271939,MATH 142A,B04,093558,Chow; Bennett,11,0,32,21
1657185271939,MATH 142A,B05,093559,Chow; Bennett,6,0,32,26
1657185277961,MATH 193A,A01,083224,Rotar; Vladimir,7,0,34,27
1657185277961,MATH 193A,A02,083225,Rotar; Vladimir,5,0,34,29
1657185277961,MATH 193A,A03,083781,Rotar; Vladimir,1,0,34,33
1657185277961,MATH 193A,A04,083782,Rotar; Vladimir,8,0,34,26
1657185277961,MATH 193A,A05,093482,Rotar; Vladimir,6,0,34,28
1657185283995,MATH 197,001,091859,McAuley; Julian John,9999,0,9999,0
1657185283995,MATH 197,002,095566,Kedlaya; Kiran S.,9997,0,9999,2
1657185283995,MATH 197,003,095567,Xiao; Ming,9999,0,9999,0
1657185283995,MATH 197,004,095571,Perols; Johan Lars,9998,0,9999,1
1657185291071,COGS 9,A01,083615,Shannon; Kyle Michael,7,0,75,68
1657185297095,COGS 11,A01,083617,Boyle; Mary E. T.,22,0,48,26
1657185303117,COGS 13,A01,083071,Bastos; Amalia Pinkusfeld,9,0,71,62
1657185309139,COGS 14A,A01,092681,Semenuks; Arturs,1,1,100,99
1657185315167,COGS 14B,A01,083073,Cheng; Tzu-Han,6,0,63,57
1657185321195,COGS 17,A01,092677,Semenuks; Arturs,4,0,81,77
1657185327220,COGS 100,A01,083619,Allen; Michael Gordon,15,0,70,55
1657185333244,COGS 101A,A01,083621,Davis; Joshua Daniel,9,0,68,59
1657185339268,COGS 101B,A01,091572,Allen; Michael Gordon,9,0,65,56
1657185345290,COGS 101C,A01,083625,Delgado; Tania,17,0,35,18
1657185351318,COGS 107A,A01,083627,Boyle; Mary E. T.,13,0,60,47
1657185357347,COGS 118A,A01,083075,Gupta; Anjum,16,0,76,60
1657185363374,CSE 3,A50,083646,Miranda; Gregory Joseph,24,0,50,26
1657185369398,CSE 8A,A50,083650,Miranda; Gregory Joseph,17,1,56,39
1657185375423,CSE 11,A01,083080,Cao; Yingjun,5,15,40,35
1657185381451,CSE 12,A01,083652,Krause-Levy; Sophia Louisa,24,1,120,96
1657185387476,CSE 15L,A01,083654,Morris; Justin Loren,9,0,50,41
1657185387476,CSE 15L,A02,083655,Morris; Justin Loren,9,0,50,41
1657185393498,CSE 20,A01,083657,Tran; Khoa Dang,38,0,80,42
1657185399521,CSE 21,A01,095574,Bach; Quang Tran,22,0,48,26
1657185405544,CSE 30,A01,083084,Eldon; John,4,0,80,76
1657185405544,CSE 30,B01,095061,Bhaskar; Nishant,7,0,50,43
1657185411572,CSE 100,A01,083659,Cao; Yingjun,4,4,70,66
1657185417596,CSE 134B,A01,083661,Powell; Thomas Allan,20,0,100,80
1657185423620,CSE 140,A01,083663,Gungor; Onat,13,0,85,72
1657185429644,CSE 140L,A01,083088,Eldon; John,17,0,100,83
1657185435672,CSE 175,A01,083665,Kumar; Rakesh,3,0,25,22
1657185441703,CSE 190,A00,092507,Dubnov; Shlomo,7,0,20,13
1657185447733,ECE 45,A01,083139,Congero; Spencer William,5,0,75,70
1657185453757,ECE 65,A50,083695,Saad; Andrew S,12,0,30,18
1657185453757,ECE 65,A51,095125,Saad; Andrew S,25,0,26,1
1657185459780,ECE 109,A01,091882,Touri; Behrouz,19,0,70,51
1657185465807,ECE 180,A00,083140,Abi Samra; Nicholas Camill,1,0,30,29
1657185465807,ECE 180,B00,083141,Abi Samra; Nicholas Camill,0,0,30,30
1657185471833,MATH 10A,A01,083735,Patchell; Gregory David,2,0,30,28
1657185471833,MATH 10A,A02,083736,Patchell; Gregory David,20,0,30,10
1657185471833,MATH 10A,A03,083737,Patchell; Gregory David,16,0,30,14
1657185477862,MATH 10B,A01,083207,Lim; Seonhee,7,0,34,27
1657185477862,MATH 10B,A02,083208,Lim; Seonhee,9,0,35,26
1657185477862,MATH 10B,A03,093472,Lim; Seonhee,5,0,34,29
1657185477862,MATH 10B,B01,083739,Sinha; Shubham,10,0,30,20
1657185483887,MATH 18,A01,083743,Cinel; Cameron Alexander,6,0,30,24
1657185483887,MATH 18,A02,083744,Cinel; Cameron Alexander,15,0,30,15
1657185483887,MATH 18,A03,083745,Cinel; Cameron Alexander,8,0,30,22
1657185483887,MATH 18,B01,083748,Rideout; David Porter,4,0,37,33
1657185483887,MATH 18,B02,083749,Rideout; David Porter,4,0,36,32
1657185483887,MATH 18,B03,083750,Rideout; David Porter,2,0,37,35
1657185483887,MATH 18,B04,083751,Rideout; David Porter,5,0,36,31
1657185483887,MATH 18,B05,093473,Rideout; David Porter,5,0,36,31
1657185483887,MATH 18,B06,093474,Rideout; David Porter,5,0,36,31
1657185489910,MATH 20A,A01,083754,Zheng; Zequn,13,0,40,27
1657185495933,MATH 20B,A01,083756,Briones; Jor-el Thomas Caparas,1,0,36,35
1657185495933,MATH 20B,A02,083757,Briones; Jor-el Thomas Caparas,1,0,36,35
1657185495933,MATH 20B,A03,093475,Briones; Jor-el Thomas Caparas,1,0,36,35
1657185501957,MATH 20C,A01,083760,Briones; Jor-el Thomas Caparas,1,0,35,34
1657185501957,MATH 20C,A02,083761,Briones; Jor-el Thomas Caparas,8,0,35,27
1657185501957,MATH 20C,A03,093476,Briones; Jor-el Thomas Caparas,0,1,36,36
1657185501957,MATH 20C,B01,083762,Bach; Quang Tran,1,0,30,29
1657185507986,MATH 20D,A01,083765,Tran; Brian Kha,4,0,30,26
1657185507986,MATH 20D,A02,083766,Tran; Brian Kha,5,0,30,25
1657185507986,MATH 20D,A03,083767,Tran; Brian Kha,4,0,30,26
1657185514015,MATH 20E,A01,083771,Ganguly; Soumya,7,0,32,25
1657185514015,MATH 20E,A02,083772,Ganguly; Soumya,7,0,32,25
1657185514015,MATH 20E,B01,083773,Ciotti; Benjamin,19,0,35,16
1657185514015,MATH 20E,B02,083774,Ciotti; Benjamin,17,0,35,18
1657185520044,MATH 103A,A01,083777,Greenfeld; Be'Eri,2,0,36,34
1657185520044,MATH 103A,A02,083778,Greenfeld; Be'Eri,5,0,36,31
1657185520044,MATH 103A,A03,093561,Greenfeld; Be'Eri,4,0,36,32
1657185520044,MATH 103A,B01,083779,Greenfeld; Be'Eri,6,0,36,30
1657185520044,MATH 103A,B02,083780,Greenfeld; Be'Eri,3,0,36,33
1657185520044,MATH 103A,B03,093562,Greenfeld; Be'Eri,3,0,36,33
1657185526068,MATH 105,A01,085443,Carter; Anne Toulson,14,0,35,21
1657185526068,MATH 105,A02,093477,Carter; Anne Toulson,20,0,35,15
1657185532096,MATH 109,A01,083213,Ganzberger; Geoffrey Michael,2,0,34,32
1657185532096,MATH 109,A02,083214,Ganzberger; Geoffrey Michael,3,0,34,31
1657185532096,MATH 109,A03,093478,Ganzberger; Geoffrey Michael,1,0,34,33
1657185532096,MATH 109,B01,083215,Ganzberger; Geoffrey Michael,1,0,32,31
1657185532096,MATH 109,B02,083216,Ganzberger; Geoffrey Michael,1,0,32,31
1657185532096,MATH 109,B03,093479,Ganzberger; Geoffrey Michael,6,0,32,26
1657185538120,MATH 142A,A01,083219,Chow; Bennett,6,0,32,26
1657185538120,MATH 142A,A02,083220,Chow; Bennett,10,0,32,22
1657185538120,MATH 142A,A03,093480,Chow; Bennett,7,0,32,25
1657185538120,MATH 142A,B03,093481,Chow; Bennett,8,0,32,24
1657185538120,MATH 142A,B04,093558,Chow; Bennett,11,0,32,21
1657185538120,MATH 142A,B05,093559,Chow; Bennett,6,0,32,26
1657185544142,MATH 193A,A01,083224,Rotar; Vladimir,7,0,34,27
1657185544142,MATH 193A,A02,083225,Rotar; Vladimir,5,0,34,29
1657185544142,MATH 193A,A03,083781,Rotar; Vladimir,1,0,34,33
1657185544142,MATH 193A,A04,083782,Rotar; Vladimir,8,0,34,26
1657185544142,MATH 193A,A05,093482,Rotar; Vladimir,6,0,34,28
1657185550165,MATH 197,001,091859,McAuley; Julian John,9999,0,9999,0
1657185550165,MATH 197,002,095566,Kedlaya; Kiran S.,9997,0,9999,2
1657185550165,MATH 197,003,095567,Xiao; Ming,9999,0,9999,0
1657185550165,MATH 197,004,095571,Perols; Johan Lars,9998,0,9999,1
1657185557217,COGS 9,A01,083615,Shannon; Kyle Michael,7,0,75,68
1657185563240,COGS 11,A01,083617,Boyle; Mary E. T.,22,0,48,26
1657185569270,COGS 13,A01,083071,Bastos; Amalia Pinkusfeld,9,0,71,62
1657185575293,COGS 14A,A01,092681,Semenuks; Arturs,1,1,100,99
1657185581329,COGS 14B,A01,083073,Cheng; Tzu-Han,6,0,63,57
1657185587351,COGS 17,A01,092677,Semenuks; Arturs,4,0,81,77
1657185593378,COGS 100,A01,083619,Allen; Michael Gordon,15,0,70,55
1657185599402,COGS 101A,A01,083621,Davis; Joshua Daniel,9,0,68,59
1657185605429,COGS 101B,A01,091572,Allen; Michael Gordon,9,0,65,56
1657185611453,COGS 101C,A01,083625,Delgado; Tania,17,0,35,18
1657185617477,COGS 107A,A01,083627,Boyle; Mary E. T.,13,0,60,47
1657185623502,COGS 118A,A01,083075,Gupta; Anjum,16,0,76,60
1657185629530,CSE 3,A50,083646,Miranda; Gregory Joseph,24,0,50,26
1657185635553,CSE 8A,A50,083650,Miranda; Gregory Joseph,17,1,56,39
1657185641578,CSE 11,A01,083080,Cao; Yingjun,5,15,40,35
1657185647606,CSE 12,A01,083652,Krause-Levy; Sophia Louisa,24,1,120,96
1657185653634,CSE 15L,A01,083654,Morris; Justin Loren,9,0,50,41
1657185653634,CSE 15L,A02,083655,Morris; Justin Loren,9,0,50,41
1657185659657,CSE 20,A01,083657,Tran; Khoa Dang,38,0,80,42
1657185665681,CSE 21,A01,095574,Bach; Quang Tran,22,0,48,26
1657185671795,CSE 30,A01,083084,Eldon; John,4,0,80,76
1657185671795,CSE 30,B01,095061,Bhaskar; Nishant,7,0,50,43
1657185677817,CSE 100,A01,083659,Cao; Yingjun,4,4,70,66
1657185683840,CSE 134B,A01,083661,Powell; Thomas Allan,20,0,100,80
1657185689865,CSE 140,A01,083663,Gungor; Onat,13,0,85,72
1657185695889,CSE 140L,A01,083088,Eldon; John,17,0,100,83
1657185701912,CSE 175,A01,083665,Kumar; Rakesh,3,0,25,22
1657185707935,CSE 190,A00,092507,Dubnov; Shlomo,7,0,20,13
1657185713962,ECE 45,A01,083139,Congero; Spencer William,5,0,75,70
1657185719983,ECE 65,A50,083695,Saad; Andrew S,12,0,30,18
1657185719983,ECE 65,A51,095125,Saad; Andrew S,25,0,26,1
1657185726006,ECE 109,A01,091882,Touri; Behrouz,19,0,70,51
1657185732037,ECE 180,A00,083140,Abi Samra; Nicholas Camill,1,0,30,29
1657185732037,ECE 180,B00,083141,Abi Samra; Nicholas Camill,0,0,30,30
1657185738058,MATH 10A,A01,083735,Patchell; Gregory David,2,0,30,28
1657185738058,MATH 10A,A02,083736,Patchell; Gregory David,20,0,30,10
1657185738058,MATH 10A,A03,083737,Patchell; Gregory David,16,0,30,14
1657185744083,MATH 10B,A01,083207,Lim; Seonhee,7,0,34,27
1657185744083,MATH 10B,A02,083208,Lim; Seonhee,9,0,35,26
1657185744083,MATH 10B,A03,093472,Lim; Seonhee,5,0,34,29
1657185744083,MATH 10B,B01,083739,Sinha; Shubham,10,0,30,20
1657185750112,MATH 18,A01,083743,Cinel; Cameron Alexander,6,0,30,24
1657185750112,MATH 18,A02,083744,Cinel; Cameron Alexander,15,0,30,15
1657185750112,MATH 18,A03,083745,Cinel; Cameron Alexander,8,0,30,22
1657185750112,MATH 18,B01,083748,Rideout; David Porter,4,0,37,33
1657185750112,MATH 18,B02,083749,Rideout; David Porter,4,0,36,32
1657185750112,MATH 18,B03,083750,Rideout; David Porter,2,0,37,35
1657185750112,MATH 18,B04,083751,Rideout; David Porter,5,0,36,31
1657185750112,MATH 18,B05,093473,Rideout; David Porter,5,0,36,31
1657185750112,MATH 18,B06,093474,Rideout; David Porter,5,0,36,31
1657185756136,MATH 20A,A01,083754,Zheng; Zequn,13,0,40,27
1657185762161,MATH 20B,A01,083756,Briones; Jor-el Thomas Caparas,1,0,36,35
1657185762161,MATH 20B,A02,083757,Briones; Jor-el Thomas Caparas,1,0,36,35
1657185762161,MATH 20B,A03,093475,Briones; Jor-el Thomas Caparas,1,0,36,35
1657185768200,MATH 20C,A01,083760,Briones; Jor-el Thomas Caparas,1,0,35,34
1657185768200,MATH 20C,A02,083761,Briones; Jor-el Thomas Caparas,8,0,35,27
1657185768200,MATH 20C,A03,093476,Briones; Jor-el Thomas Caparas,0,1,36,36
1657185768200,MATH 20C,B01,083762,Bach; Quang Tran,1,0,30,29
1657185774228,MATH 20D,A01,083765,Tran; Brian Kha,4,0,30,26
1657185774228,MATH 20D,A02,083766,Tran; Brian Kha,5,0,30,25
1657185774228,MATH 20D,A03,083767,Tran; Brian Kha,4,0,30,26
1657185780250,MATH 20E,A01,083771,Ganguly; Soumya,7,0,32,25
1657185780250,MATH 20E,A02,083772,Ganguly; Soumya,7,0,32,25
1657185780250,MATH 20E,B01,083773,Ciotti; Benjamin,19,0,35,16
1657185780250,MATH 20E,B02,083774,Ciotti; Benjamin,17,0,35,18
1657185786281,MATH 103A,A01,083777,Greenfeld; Be'Eri,2,0,36,34
1657185786281,MATH 103A,A02,083778,Greenfeld; Be'Eri,5,0,36,31
1657185786281,MATH 103A,A03,093561,Greenfeld; Be'Eri,4,0,36,32
1657185786281,MATH 103A,B01,083779,Greenfeld; Be'Eri,6,0,36,30
1657185786281,MATH 103A,B02,083780,Greenfeld; Be'Eri,3,0,36,33
1657185786281,MATH 103A,B03,093562,Greenfeld; Be'Eri,3,0,36,33
1657185792303,MATH 105,A01,085443,Carter; Anne Toulson,14,0,35,21
1657185792303,MATH 105,A02,093477,Carter; Anne Toulson,20,0,35,15
1657185798327,MATH 109,A01,083213,Ganzberger; Geoffrey Michael,2,0,34,32
1657185798327,MATH 109,A02,083214,Ganzberger; Geoffrey Michael,3,0,34,31
1657185798327,MATH 109,A03,093478,Ganzberger; Geoffrey Michael,1,0,34,33
1657185798327,MATH 109,B01,083215,Ganzberger; Geoffrey Michael,1,0,32,31
1657185798327,MATH 109,B02,083216,Ganzberger; Geoffrey Michael,1,0,32,31
1657185798327,MATH 109,B03,093479,Ganzberger; Geoffrey Michael,6,0,32,26
1657185804352,MATH 142A,A01,083219,Chow; Bennett,6,0,32,26
1657185804352,MATH 142A,A02,083220,Chow; Bennett,10,0,32,22
1657185804352,MATH 142A,A03,093480,Chow; Bennett,7,0,32,25
1657185804352,MATH 142A,B03,093481,Chow; Bennett,8,0,32,24
1657185804352,MATH 142A,B04,093558,Chow; Bennett,11,0,32,21
1657185804352,MATH 142A,B05,093559,Chow; Bennett,6,0,32,26
1657185810375,MATH 193A,A01,083224,Rotar; Vladimir,7,0,34,27
1657185810375,MATH 193A,A02,083225,Rotar; Vladimir,5,0,34,29
1657185810375,MATH 193A,A03,083781,Rotar; Vladimir,1,0,34,33
1657185810375,MATH 193A,A04,083782,Rotar; Vladimir,8,0,34,26
1657185810375,MATH 193A,A05,093482,Rotar; Vladimir,6,0,34,28
1657185816402,MATH 197,001,091859,McAuley; Julian John,9999,0,9999,0
1657185816402,MATH 197,002,095566,Kedlaya; Kiran S.,9997,0,9999,2
1657185816402,MATH 197,003,095567,Xiao; Ming,9999,0,9999,0
1657185816402,MATH 197,004,095571,Perols; Johan Lars,9998,0,9999,1
1657185823472,COGS 9,A01,083615,Shannon; Kyle Michael,7,0,75,68
1657185829494,COGS 11,A01,083617,Boyle; Mary E. T.,22,0,48,26
1657185835529,COGS 13,A01,083071,Bastos; Amalia Pinkusfeld,9,0,71,62
1657185841558,COGS 14A,A01,092681,Semenuks; Arturs,1,1,100,99
1657185847579,COGS 14B,A01,083073,Cheng; Tzu-Han,6,0,63,57
1657185853600,COGS 17,A01,092677,Semenuks; Arturs,4,0,81,77
1657185859623,COGS 100,A01,083619,Allen; Michael Gordon,15,0,70,55
1657185865646,COGS 101A,A01,083621,Davis; Joshua Daniel,9,0,68,59
1657185871669,COGS 101B,A01,091572,Allen; Michael Gordon,9,0,65,56
1657185877692,COGS 101C,A01,083625,Delgado; Tania,17,0,35,18
1657185883718,COGS 107A,A01,083627,Boyle; Mary E. T.,13,0,60,47
1657185889743,COGS 118A,A01,083075,Gupta; Anjum,16,0,76,60
1657185895764,CSE 3,A50,083646,Miranda; Gregory Joseph,24,0,50,26
1657185901791,CSE 8A,A50,083650,Miranda; Gregory Joseph,17,1,56,39
1657185907813,CSE 11,A01,083080,Cao; Yingjun,5,15,40,35
1657185913836,CSE 12,A01,083652,Krause-Levy; Sophia Louisa,24,1,120,96
1657185919863,CSE 15L,A01,083654,Morris; Justin Loren,9,0,50,41
1657185919863,CSE 15L,A02,083655,Morris; Justin Loren,9,0,50,41
1657185925886,CSE 20,A01,083657,Tran; Khoa Dang,38,0,80,42
1657185931913,CSE 21,A01,095574,Bach; Quang Tran,22,0,48,26
1657185937935,CSE 30,A01,083084,Eldon; John,4,0,80,76
1657185937935,CSE 30,B01,095061,Bhaskar; Nishant,7,0,50,43
1657185943962,CSE 100,A01,083659,Cao; Yingjun,4,4,70,66
1657185949989,CSE 134B,A01,083661,Powell; Thomas Allan,20,0,100,80
1657185956012,CSE 140,A01,083663,Gungor; Onat,13,0,85,72
1657185962039,CSE 140L,A01,083088,Eldon; John,17,0,100,83
1657185968065,CSE 175,A01,083665,Kumar; Rakesh,3,0,25,22
1657185974088,CSE 190,A00,092507,Dubnov; Shlomo,7,0,20,13
1657185980110,ECE 45,A01,083139,Congero; Spencer William,5,0,75,70
1657185986134,ECE 65,A50,083695,Saad; Andrew S,12,0,30,18
1657185986134,ECE 65,A51,095125,Saad; Andrew S,25,0,26,1
1657185992158,ECE 109,A01,091882,Touri; Behrouz,19,0,70,51
1657185998185,ECE 180,A00,083140,Abi Samra; Nicholas Camill,1,0,30,29
1657185998185,ECE 180,B00,083141,Abi Samra; Nicholas Camill,0,0,30,30
1657186004206,MATH 10A,A01,083735,Patchell; Gregory David,2,0,30,28
1657186004206,MATH 10A,A02,083736,Patchell; Gregory David,20,0,30,10
1657186004206,MATH 10A,A03,083737,Patchell; Gregory David,16,0,30,14
1657186010230,MATH 10B,A01,083207,Lim; Seonhee,7,0,34,27
1657186010230,MATH 10B,A02,083208,Lim; Seonhee,9,0,35,26
1657186010230,MATH 10B,A03,093472,Lim; Seonhee,5,0,34,29
1657186010230,MATH 10B,B01,083739,Sinha; Shubham,10,0,30,20
1657186016255,MATH 18,A01,083743,Cinel; Cameron Alexander,6,0,30,24
1657186016255,MATH 18,A02,083744,Cinel; Cameron Alexander,15,0,30,15
1657186016255,MATH 18,A03,083745,Cinel; Cameron Alexander,8,0,30,22
1657186016255,MATH 18,B01,083748,Rideout; David Porter,4,0,37,33
1657186016255,MATH 18,B02,083749,Rideout; David Porter,4,0,36,32
1657186016255,MATH 18,B03,083750,Rideout; David Porter,2,0,37,35
1657186016255,MATH 18,B04,083751,Rideout; David Porter,5,0,36,31
1657186016255,MATH 18,B05,093473,Rideout; David Porter,5,0,36,31
1657186016255,MATH 18,B06,093474,Rideout; David Porter,5,0,36,31
1657186022278,MATH 20A,A01,083754,Zheng; Zequn,13,0,40,27
1657186028301,MATH 20B,A01,083756,Briones; Jor-el Thomas Caparas,1,0,36,35
1657186028301,MATH 20B,A02,083757,Briones; Jor-el Thomas Caparas,1,0,36,35
1657186028301,MATH 20B,A03,093475,Briones; Jor-el Thomas Caparas,1,0,36,35
1657186034330,MATH 20C,A01,083760,Briones; Jor-el Thomas Caparas,1,0,35,34
1657186034330,MATH 20C,A02,083761,Briones; Jor-el Thomas Caparas,8,0,35,27
1657186034330,MATH 20C,A03,093476,Briones; Jor-el Thomas Caparas,0,1,36,36
1657186034330,MATH 20C,B01,083762,Bach; Quang Tran,1,0,30,29
1657186040355,MATH 20D,A01,083765,Tran; Brian Kha,4,0,30,26
1657186040355,MATH 20D,A02,083766,Tran; Brian Kha,5,0,30,25
1657186040355,MATH 20D,A03,083767,Tran; Brian Kha,4,0,30,26
1657186046379,MATH 20E,A01,083771,Ganguly; Soumya,7,0,32,25
1657186046379,MATH 20E,A02,083772,Ganguly; Soumya,7,0,32,25
1657186046379,MATH 20E,B01,083773,Ciotti; Benjamin,19,0,35,16
1657186046379,MATH 20E,B02,083774,Ciotti; Benjamin,17,0,35,18
1657186052407,MATH 103A,A01,083777,Greenfeld; Be'Eri,2,0,36,34
1657186052407,MATH 103A,A02,083778,Greenfeld; Be'Eri,5,0,36,31
1657186052407,MATH 103A,A03,093561,Greenfeld; Be'Eri,4,0,36,32
1657186052407,MATH 103A,B01,083779,Greenfeld; Be'Eri,6,0,36,30
1657186052407,MATH 103A,B02,083780,Greenfeld; Be'Eri,3,0,36,33
1657186052407,MATH 103A,B03,093562,Greenfeld; Be'Eri,3,0,36,33
1657186058431,MATH 105,A01,085443,Carter; Anne Toulson,14,0,35,21
1657186058431,MATH 105,A02,093477,Carter; Anne Toulson,20,0,35,15
1657186064455,MATH 109,A01,083213,Ganzberger; Geoffrey Michael,2,0,34,32
1657186064455,MATH 109,A02,083214,Ganzberger; Geoffrey Michael,3,0,34,31
1657186064455,MATH 109,A03,093478,Ganzberger; Geoffrey Michael,1,0,34,33
1657186064455,MATH 109,B01,083215,Ganzberger; Geoffrey Michael,1,0,32,31
1657186064455,MATH 109,B02,083216,Ganzberger; Geoffrey Michael,1,0,32,31
1657186064455,MATH 109,B03,093479,Ganzberger; Geoffrey Michael,6,0,32,26
1657186070479,MATH 142A,A01,083219,Chow; Bennett,6,0,32,26
1657186070479,MATH 142A,A02,083220,Chow; Bennett,10,0,32,22
1657186070479,MATH 142A,A03,093480,Chow; Bennett,7,0,32,25
1657186070479,MATH 142A,B03,093481,Chow; Bennett,8,0,32,24
1657186070479,MATH 142A,B04,093558,Chow; Bennett,11,0,32,21
1657186070479,MATH 142A,B05,093559,Chow; Bennett,6,0,32,26
1657186076508,MATH 193A,A01,083224,Rotar; Vladimir,7,0,34,27
1657186076508,MATH 193A,A02,083225,Rotar; Vladimir,5,0,34,29
1657186076508,MATH 193A,A03,083781,Rotar; Vladimir,1,0,34,33
1657186076508,MATH 193A,A04,083782,Rotar; Vladimir,8,0,34,26
1657186076508,MATH 193A,A05,093482,Rotar; Vladimir,6,0,34,28
1657186082530,MATH 197,001,091859,McAuley; Julian John,9999,0,9999,0
1657186082530,MATH 197,002,095566,Kedlaya; Kiran S.,9997,0,9999,2
1657186082530,MATH 197,003,095567,Xiao; Ming,9999,0,9999,0
1657186082530,MATH 197,004,095571,Perols; Johan Lars,9998,0,9999,1
1657186089592,COGS 9,A01,083615,Shannon; Kyle Michael,7,0,75,68
1657186095614,COGS 11,A01,083617,Boyle; Mary E. T.,22,0,48,26
1657186101636,COGS 13,A01,083071,Bastos; Amalia Pinkusfeld,9,0,71,62
1657186107662,COGS 14A,A01,092681,Semenuks; Arturs,1,1,100,99
1657186113684,COGS 14B,A01,083073,Cheng; Tzu-Han,6,0,63,57
1657186119709,COGS 17,A01,092677,Semenuks; Arturs,4,0,81,77
1657186125732,COGS 100,A01,083619,Allen; Michael Gordon,15,0,70,55
1657186131758,COGS 101A,A01,083621,Davis; Joshua Daniel,9,0,68,59
1657186137785,COGS 101B,A01,091572,Allen; Michael Gordon,9,0,65,56
1657186143809,COGS 101C,A01,083625,Delgado; Tania,17,0,35,18
1657186149831,COGS 107A,A01,083627,Boyle; Mary E. T.,13,0,60,47
1657186155860,COGS 118A,A01,083075,Gupta; Anjum,16,0,76,60
1657186161887,CSE 3,A50,083646,Miranda; Gregory Joseph,24,0,50,26
1657186167910,CSE 8A,A50,083650,Miranda; Gregory Joseph,17,1,56,39
1657186173941,CSE 11,A01,083080,Cao; Yingjun,5,15,40,35
1657186179969,CSE 12,A01,083652,Krause-Levy; Sophia Louisa,24,1,120,96
1657186185993,CSE 15L,A01,083654,Morris; Justin Loren,9,0,50,41
1657186185993,CSE 15L,A02,083655,Morris; Justin Loren,9,0,50,41
1657186192016,CSE 20,A01,083657,Tran; Khoa Dang,38,0,80,42
1657186198043,CSE 21,A01,095574,Bach; Quang Tran,22,0,48,26
1657186204069,CSE 30,A01,083084,Eldon; John,4,0,80,76
1657186204069,CSE 30,B01,095061,Bhaskar; Nishant,7,0,50,43
1657186210093,CSE 100,A01,083659,Cao; Yingjun,4,4,70,66
1657186216115,CSE 134B,A01,083661,Powell; Thomas Allan,20,0,100,80
1657186222138,CSE 140,A01,083663,Gungor; Onat,13,0,85,72
1657186228162,CSE 140L,A01,083088,Eldon; John,17,0,100,83
1657186234186,CSE 175,A01,083665,Kumar; Rakesh,3,0,25,22
1657186240210,CSE 190,A00,092507,Dubnov; Shlomo,7,0,20,13
1657186246233,ECE 45,A01,083139,Congero; Spencer William,5,0,75,70
1657186252257,ECE 65,A50,083695,Saad; Andrew S,12,0,30,18
1657186252257,ECE 65,A51,095125,Saad; Andrew S,25,0,26,1
1657186258280,ECE 109,A01,091882,Touri; Behrouz,19,0,70,51
1657186264305,ECE 180,A00,083140,Abi Samra; Nicholas Camill,1,0,30,29
1657186264305,ECE 180,B00,083141,Abi Samra; Nicholas Camill,0,0,30,30
1657186270403,MATH 10A,A01,083735,Patchell; Gregory David,2,0,30,28
1657186270403,MATH 10A,A02,083736,Patchell; Gregory David,20,0,30,10
1657186270403,MATH 10A,A03,083737,Patchell; Gregory David,16,0,30,14
1657186276428,MATH 10B,A01,083207,Lim; Seonhee,7,0,34,27
1657186276428,MATH 10B,A02,083208,Lim; Seonhee,9,0,35,26
1657186276428,MATH 10B,A03,093472,Lim; Seonhee,5,0,34,29
1657186276428,MATH 10B,B01,083739,Sinha; Shubham,10,0,30,20
1657186282452,MATH 18,A01,083743,Cinel; Cameron Alexander,6,0,30,24
1657186282452,MATH 18,A02,083744,Cinel; Cameron Alexander,15,0,30,15
1657186282452,MATH 18,A03,083745,Cinel; Cameron Alexander,8,0,30,22
1657186282452,MATH 18,B01,083748,Rideout; David Porter,4,0,37,33
1657186282452,MATH 18,B02,083749,Rideout; David Porter,4,0,36,32
1657186282452,MATH 18,B03,083750,Rideout; David Porter,2,0,37,35
1657186282452,MATH 18,B04,083751,Rideout; David Porter,5,0,36,31
1657186282452,MATH 18,B05,093473,Rideout; David Porter,5,0,36,31
1657186282452,MATH 18,B06,093474,Rideout; David Porter,5,0,36,31
1657186288482,MATH 20A,A01,083754,Zheng; Zequn,13,0,40,27
1657186294505,MATH 20B,A01,083756,Briones; Jor-el Thomas Caparas,1,0,36,35
1657186294505,MATH 20B,A02,083757,Briones; Jor-el Thomas Caparas,1,0,36,35
1657186294505,MATH 20B,A03,093475,Briones; Jor-el Thomas Caparas,1,0,36,35
1657186300535,MATH 20C,A01,083760,Briones; Jor-el Thomas Caparas,1,0,35,34
1657186300535,MATH 20C,A02,083761,Briones; Jor-el Thomas Caparas,8,0,35,27
1657186300535,MATH 20C,A03,093476,Briones; Jor-el Thomas Caparas,0,1,36,36
1657186300535,MATH 20C,B01,083762,Bach; Quang Tran,1,0,30,29
1657186306563,MATH 20D,A01,083765,Tran; Brian Kha,4,0,30,26
1657186306563,MATH 20D,A02,083766,Tran; Brian Kha,5,0,30,25
1657186306563,MATH 20D,A03,083767,Tran; Brian Kha,4,0,30,26
1657186312594,MATH 20E,A01,083771,Ganguly; Soumya,7,0,32,25
1657186312594,MATH 20E,A02,083772,Ganguly; Soumya,7,0,32,25
1657186312594,MATH 20E,B01,083773,Ciotti; Benjamin,19,0,35,16
1657186312594,MATH 20E,B02,083774,Ciotti; Benjamin,17,0,35,18
1657186318618,MATH 103A,A01,083777,Greenfeld; Be'Eri,2,0,36,34
1657186318618,MATH 103A,A02,083778,Greenfeld; Be'Eri,5,0,36,31
1657186318618,MATH 103A,A03,093561,Greenfeld; Be'Eri,4,0,36,32
1657186318618,MATH 103A,B01,083779,Greenfeld; Be'Eri,6,0,36,30
1657186318618,MATH 103A,B02,083780,Greenfeld; Be'Eri,3,0,36,33
1657186318618,MATH 103A,B03,093562,Greenfeld; Be'Eri,3,0,36,33
1657186324641,MATH 105,A01,085443,Carter; Anne Toulson,14,0,35,21
1657186324641,MATH 105,A02,093477,Carter; Anne Toulson,20,0,35,15
1657186330665,MATH 109,A01,083213,Ganzberger; Geoffrey Michael,2,0,34,32
1657186330665,MATH 109,A02,083214,Ganzberger; Geoffrey Michael,3,0,34,31
1657186330665,MATH 109,A03,093478,Ganzberger; Geoffrey Michael,1,0,34,33
1657186330665,MATH 109,B01,083215,Ganzberger; Geoffrey Michael,1,0,32,31
1657186330665,MATH 109,B02,083216,Ganzberger; Geoffrey Michael,1,0,32,31
1657186330665,MATH 109,B03,093479,Ganzberger; Geoffrey Michael,6,0,32,26
1657186336689,MATH 142A,A01,083219,Chow; Bennett,6,0,32,26
1657186336689,MATH 142A,A02,083220,Chow; Bennett,10,0,32,22
1657186336689,MATH 142A,A03,093480,Chow; Bennett,7,0,32,25
1657186336689,MATH 142A,B03,093481,Chow; Bennett,8,0,32,24
1657186336689,MATH 142A,B04,093558,Chow; Bennett,11,0,32,21
1657186336689,MATH 142A,B05,093559,Chow; Bennett,6,0,32,26
1657186342718,MATH 193A,A01,083224,Rotar; Vladimir,7,0,34,27
1657186342718,MATH 193A,A02,083225,Rotar; Vladimir,5,0,34,29
1657186342718,MATH 193A,A03,083781,Rotar; Vladimir,1,0,34,33
1657186342718,MATH 193A,A04,083782,Rotar; Vladimir,8,0,34,26
1657186342718,MATH 193A,A05,093482,Rotar; Vladimir,6,0,34,28
1657186348742,MATH 197,001,091859,McAuley; Julian John,9999,0,9999,0
1657186348742,MATH 197,002,095566,Kedlaya; Kiran S.,9997,0,9999,2
1657186348742,MATH 197,003,095567,Xiao; Ming,9999,0,9999,0
1657186348742,MATH 197,004,095571,Perols; Johan Lars,9998,0,9999,1
1657186355796,COGS 9,A01,083615,Shannon; Kyle Michael,7,0,75,68
1657186361820,COGS 11,A01,083617,Boyle; Mary E. T.,22,0,48,26
1657186367844,COGS 13,A01,083071,Bastos; Amalia Pinkusfeld,9,0,71,62
1657186373867,COGS 14A,A01,092681,Semenuks; Arturs,1,1,100,99
1657186379902,COGS 14B,A01,083073,Cheng; Tzu-Han,6,0,63,57
1657186385930,COGS 17,A01,092677,Semenuks; Arturs,4,0,81,77
1657186391957,COGS 100,A01,083619,Allen; Michael Gordon,15,0,70,55
1657186397982,COGS 101A,A01,083621,Davis; Joshua Daniel,9,0,68,59
1657186404011,COGS 101B,A01,091572,Allen; Michael Gordon,9,0,65,56
1657186410033,COGS 101C,A01,083625,Delgado; Tania,17,0,35,18
1657186416056,COGS 107A,A01,083627,Boyle; Mary E. T.,13,0,60,47
1657186422081,COGS 118A,A01,083075,Gupta; Anjum,16,0,76,60
1657186428103,CSE 3,A50,083646,Miranda; Gregory Joseph,24,0,50,26
1657186434132,CSE 8A,A50,083650,Miranda; Gregory Joseph,17,1,56,39
1657186440158,CSE 11,A01,083080,Cao; Yingjun,5,15,40,35
1657186446180,CSE 12,A01,083652,Krause-Levy; Sophia Louisa,24,1,120,96
1657186452203,CSE 15L,A01,083654,Morris; Justin Loren,9,0,50,41
1657186452203,CSE 15L,A02,083655,Morris; Justin Loren,9,0,50,41
1657186458227,CSE 20,A01,083657,Tran; Khoa Dang,38,0,80,42
1657186464250,CSE 21,A01,095574,Bach; Quang Tran,22,0,48,26
1657186470279,CSE 30,A01,083084,Eldon; John,4,0,80,76
1657186470279,CSE 30,B01,095061,Bhaskar; Nishant,7,0,50,43
1657186476303,CSE 100,A01,083659,Cao; Yingjun,4,4,70,66
1657186482327,CSE 134B,A01,083661,Powell; Thomas Allan,20,0,100,80
1657186488353,CSE 140,A01,083663,Gungor; Onat,13,0,85,72
1657186494377,CSE 140L,A01,083088,Eldon; John,17,0,100,83
1657186500403,CSE 175,A01,083665,Kumar; Rakesh,3,0,25,22
1657186506425,CSE 190,A00,092507,Dubnov; Shlomo,7,0,20,13
1657186512452,ECE 45,A01,083139,Congero; Spencer William,5,0,75,70
1657186518475,ECE 65,A50,083695,Saad; Andrew S,12,0,30,18
1657186518475,ECE 65,A51,095125,Saad; Andrew S,25,0,26,1
1657186524509,ECE 109,A01,091882,Touri; Behrouz,19,0,70,51
1657186530532,ECE 180,A00,083140,Abi Samra; Nicholas Camill,1,0,30,29
1657186530532,ECE 180,B00,083141,Abi Samra; Nicholas Camill,0,0,30,30
1657186536557,MATH 10A,A01,083735,Patchell; Gregory David,2,0,30,28
1657186536557,MATH 10A,A02,083736,Patchell; Gregory David,20,0,30,10
1657186536557,MATH 10A,A03,083737,Patchell; Gregory David,16,0,30,14
1657186542581,MATH 10B,A01,083207,Lim; Seonhee,7,0,34,27
1657186542581,MATH 10B,A02,083208,Lim; Seonhee,9,0,35,26
1657186542581,MATH 10B,A03,093472,Lim; Seonhee,5,0,34,29
1657186542581,MATH 10B,B01,083739,Sinha; Shubham,10,0,30,20
1657186548606,MATH 18,A01,083743,Cinel; Cameron Alexander,6,0,30,24
1657186548606,MATH 18,A02,083744,Cinel; Cameron Alexander,15,0,30,15
1657186548606,MATH 18,A03,083745,Cinel; Cameron Alexander,8,0,30,22
1657186548606,MATH 18,B01,083748,Rideout; David Porter,4,0,37,33
1657186548606,MATH 18,B02,083749,Rideout; David Porter,4,0,36,32
1657186548606,MATH 18,B03,083750,Rideout; David Porter,2,0,37,35
1657186548606,MATH 18,B04,083751,Rideout; David Porter,5,0,36,31
1657186548606,MATH 18,B05,093473,Rideout; David Porter,5,0,36,31
1657186548606,MATH 18,B06,093474,Rideout; David Porter,5,0,36,31
1657186554630,MATH 20A,A01,083754,Zheng; Zequn,13,0,40,27
1657186560653,MATH 20B,A01,083756,Briones; Jor-el Thomas Caparas,1,0,36,35
1657186560653,MATH 20B,A02,083757,Briones; Jor-el Thomas Caparas,1,0,36,35
1657186560653,MATH 20B,A03,093475,Briones; Jor-el Thomas Caparas,1,0,36,35
1657186566677,MATH 20C,A01,083760,Briones; Jor-el Thomas Caparas,1,0,35,34
1657186566677,MATH 20C,A02,083761,Briones; Jor-el Thomas Caparas,8,0,35,27
1657186566677,MATH 20C,A03,093476,Briones; Jor-el Thomas Caparas,0,1,36,36
1657186566677,MATH 20C,B01,083762,Bach; Quang Tran,1,0,30,29
1657186572700,MATH 20D,A01,083765,Tran; Brian Kha,4,0,30,26
1657186572700,MATH 20D,A02,083766,Tran; Brian Kha,5,0,30,25
1657186572700,MATH 20D,A03,083767,Tran; Brian Kha,4,0,30,26
1657186578729,MATH 20E,A01,083771,Ganguly; Soumya,7,0,32,25
1657186578729,MATH 20E,A02,083772,Ganguly; Soumya,7,0,32,25
1657186578729,MATH 20E,B01,083773,Ciotti; Benjamin,19,0,35,16
1657186578729,MATH 20E,B02,083774,Ciotti; Benjamin,17,0,35,18
1657186584759,MATH 103A,A01,083777,Greenfeld; Be'Eri,2,0,36,34
1657186584759,MATH 103A,A02,083778,Greenfeld; Be'Eri,5,0,36,31
1657186584759,MATH 103A,A03,093561,Greenfeld; Be'Eri,4,0,36,32
1657186584759,MATH 103A,B01,083779,Greenfeld; Be'Eri,6,0,36,30
1657186584759,MATH 103A,B02,083780,Greenfeld; Be'Eri,3,0,36,33
1657186584759,MATH 103A,B03,093562,Greenfeld; Be'Eri,3,0,36,33
1657186590786,MATH 105,A01,085443,Carter; Anne Toulson,14,0,35,21
1657186590786,MATH 105,A02,093477,Carter; Anne Toulson,20,0,35,15
1657186596811,MATH 109,A01,083213,Ganzberger; Geoffrey Michael,2,0,34,32
1657186596811,MATH 109,A02,083214,Ganzberger; Geoffrey Michael,3,0,34,31
1657186596811,MATH 109,A03,093478,Ganzberger; Geoffrey Michael,1,0,34,33
1657186596811,MATH 109,B01,083215,Ganzberger; Geoffrey Michael,1,0,32,31
1657186596811,MATH 109,B02,083216,Ganzberger; Geoffrey Michael,1,0,32,31
1657186596811,MATH 109,B03,093479,Ganzberger; Geoffrey Michael,6,0,32,26
1657186602835,MATH 142A,A01,083219,Chow; Bennett,6,0,32,26
1657186602835,MATH 142A,A02,083220,Chow; Bennett,10,0,32,22
1657186602835,MATH 142A,A03,093480,Chow; Bennett,7,0,32,25
1657186602835,MATH 142A,B03,093481,Chow; Bennett,8,0,32,24
1657186602835,MATH 142A,B04,093558,Chow; Bennett,11,0,32,21
1657186602835,MATH 142A,B05,093559,Chow; Bennett,6,0,32,26
1657186608859,MATH 193A,A01,083224,Rotar; Vladimir,7,0,34,27
1657186608859,MATH 193A,A02,083225,Rotar; Vladimir,5,0,34,29
1657186608859,MATH 193A,A03,083781,Rotar; Vladimir,1,0,34,33
1657186608859,MATH 193A,A04,083782,Rotar; Vladimir,8,0,34,26
1657186608859,MATH 193A,A05,093482,Rotar; Vladimir,6,0,34,28
1657186614883,MATH 197,001,091859,McAuley; Julian John,9999,0,9999,0
1657186614883,MATH 197,002,095566,Kedlaya; Kiran S.,9997,0,9999,2
1657186614883,MATH 197,003,095567,Xiao; Ming,9999,0,9999,0
1657186614883,MATH 197,004,095571,Perols; Johan Lars,9998,0,9999,1
1657186621951,COGS 9,A01,083615,Shannon; Kyle Michael,7,0,75,68
1657186627975,COGS 11,A01,083617,Boyle; Mary E. T.,22,0,48,26
1657186634002,COGS 13,A01,083071,Bastos; Amalia Pinkusfeld,9,0,71,62
1657186640026,COGS 14A,A01,092681,Semenuks; Arturs,1,1,100,99
1657186646053,COGS 14B,A01,083073,Cheng; Tzu-Han,6,0,63,57
1657186652077,COGS 17,A01,092677,Semenuks; Arturs,4,0,81,77
1657186658100,COGS 100,A01,083619,Allen; Michael Gordon,15,0,70,55
1657186664123,COGS 101A,A01,083621,Davis; Joshua Daniel,9,0,68,59
1657186670152,COGS 101B,A01,091572,Allen; Michael Gordon,9,0,65,56
1657186676176,COGS 101C,A01,083625,Delgado; Tania,17,0,35,18
1657186682201,COGS 107A,A01,083627,Boyle; Mary E. T.,13,0,60,47
1657186688234,COGS 118A,A01,083075,Gupta; Anjum,16,0,76,60
1657186694259,CSE 3,A50,083646,Miranda; Gregory Joseph,24,0,50,26
1657186700283,CSE 8A,A50,083650,Miranda; Gregory Joseph,17,1,56,39
1657186706308,CSE 11,A01,083080,Cao; Yingjun,5,15,40,35
1657186712333,CSE 12,A01,083652,Krause-Levy; Sophia Louisa,24,1,120,96
1657186718359,CSE 15L,A01,083654,Morris; Justin Loren,9,0,50,41
1657186718359,CSE 15L,A02,083655,Morris; Justin Loren,9,0,50,41
1657186724384,CSE 20,A01,083657,Tran; Khoa Dang,38,0,80,42
1657186730411,CSE 21,A01,095574,Bach; Quang Tran,22,0,48,26
1657186736440,CSE 30,A01,083084,Eldon; John,4,0,80,76
1657186736440,CSE 30,B01,095061,Bhaskar; Nishant,7,0,50,43
1657186742467,CSE 100,A01,083659,Cao; Yingjun,4,4,70,66
1657186748490,CSE 134B,A01,083661,Powell; Thomas Allan,20,0,100,80
1657186754517,CSE 140,A01,083663,Gungor; Onat,13,0,85,72
1657186760542,CSE 140L,A01,083088,Eldon; John,17,0,100,83
1657186766567,CSE 175,A01,083665,Kumar; Rakesh,3,0,25,22
1657186772591,CSE 190,A00,092507,Dubnov; Shlomo,7,0,20,13
1657186778619,ECE 45,A01,083139,Congero; Spencer William,5,0,75,70
1657186784644,ECE 65,A50,083695,Saad; Andrew S,12,0,30,18
1657186784644,ECE 65,A51,095125,Saad; Andrew S,25,0,26,1
1657186790668,ECE 109,A01,091882,Touri; Behrouz,19,0,70,51
1657186796691,ECE 180,A00,083140,Abi Samra; Nicholas Camill,1,0,30,29
1657186796691,ECE 180,B00,083141,Abi Samra; Nicholas Camill,0,0,30,30
1657186802716,MATH 10A,A01,083735,Patchell; Gregory David,2,0,30,28
1657186802716,MATH 10A,A02,083736,Patchell; Gregory David,20,0,30,10
1657186802716,MATH 10A,A03,083737,Patchell; Gregory David,16,0,30,14
1657186808744,MATH 10B,A01,083207,Lim; Seonhee,7,0,34,27
1657186808744,MATH 10B,A02,083208,Lim; Seonhee,9,0,35,26
1657186808744,MATH 10B,A03,093472,Lim; Seonhee,5,0,34,29
1657186808744,MATH 10B,B01,083739,Sinha; Shubham,10,0,30,20
1657186814775,MATH 18,A01,083743,Cinel; Cameron Alexander,6,0,30,24
1657186814775,MATH 18,A02,083744,Cinel; Cameron Alexander,15,0,30,15
1657186814775,MATH 18,A03,083745,Cinel; Cameron Alexander,8,0,30,22
1657186814775,MATH 18,B01,083748,Rideout; David Porter,4,0,37,33
1657186814775,MATH 18,B02,083749,Rideout; David Porter,4,0,36,32
1657186814775,MATH 18,B03,083750,Rideout; David Porter,2,0,37,35
1657186814775,MATH 18,B04,083751,Rideout; David Porter,5,0,36,31
1657186814775,MATH 18,B05,093473,Rideout; David Porter,5,0,36,31
1657186814775,MATH 18,B06,093474,Rideout; David Porter,5,0,36,31
1657186820798,MATH 20A,A01,083754,Zheng; Zequn,13,0,40,27
1657186826827,MATH 20B,A01,083756,Briones; Jor-el Thomas Caparas,1,0,36,35
1657186826827,MATH 20B,A02,083757,Briones; Jor-el Thomas Caparas,1,0,36,35
1657186826827,MATH 20B,A03,093475,Briones; Jor-el Thomas Caparas,1,0,36,35
1657186832855,MATH 20C,A01,083760,Briones; Jor-el Thomas Caparas,1,0,35,34
1657186832855,MATH 20C,A02,083761,Briones; Jor-el Thomas Caparas,8,0,35,27
1657186832855,MATH 20C,A03,093476,Briones; Jor-el Thomas Caparas,0,1,36,36
1657186832855,MATH 20C,B01,083762,Bach; Quang Tran,1,0,30,29
1657186838883,MATH 20D,A01,083765,Tran; Brian Kha,4,0,30,26
1657186838883,MATH 20D,A02,083766,Tran; Brian Kha,5,0,30,25
1657186838883,MATH 20D,A03,083767,Tran; Brian Kha,4,0,30,26
1657186844910,MATH 20E,A01,083771,Ganguly; Soumya,7,0,32,25
1657186844910,MATH 20E,A02,083772,Ganguly; Soumya,7,0,32,25
1657186844910,MATH 20E,B01,083773,Ciotti; Benjamin,19,0,35,16
1657186844910,MATH 20E,B02,083774,Ciotti; Benjamin,17,0,35,18
1657186850933,MATH 103A,A01,083777,Greenfeld; Be'Eri,2,0,36,34
1657186850933,MATH 103A,A02,083778,Greenfeld; Be'Eri,5,0,36,31
1657186850933,MATH 103A,A03,093561,Greenfeld; Be'Eri,4,0,36,32
1657186850933,MATH 103A,B01,083779,Greenfeld; Be'Eri,6,0,36,30
1657186850933,MATH 103A,B02,083780,Greenfeld; Be'Eri,3,0,36,33
1657186850933,MATH 103A,B03,093562,Greenfeld; Be'Eri,3,0,36,33
1657186856962,MATH 105,A01,085443,Carter; Anne Toulson,14,0,35,21
1657186856962,MATH 105,A02,093477,Carter; Anne Toulson,20,0,35,15
1657186862992,MATH 109,A01,083213,Ganzberger; Geoffrey Michael,2,0,34,32
1657186862992,MATH 109,A02,083214,Ganzberger; Geoffrey Michael,3,0,34,31
1657186862992,MATH 109,A03,093478,Ganzberger; Geoffrey Michael,1,0,34,33
1657186862992,MATH 109,B01,083215,Ganzberger; Geoffrey Michael,1,0,32,31
1657186862992,MATH 109,B02,083216,Ganzberger; Geoffrey Michael,1,0,32,31
1657186862992,MATH 109,B03,093479,Ganzberger; Geoffrey Michael,6,0,32,26
1657186869105,MATH 142A,A01,083219,Chow; Bennett,6,0,32,26
1657186869105,MATH 142A,A02,083220,Chow; Bennett,10,0,32,22
1657186869105,MATH 142A,A03,093480,Chow; Bennett,7,0,32,25
1657186869105,MATH 142A,B03,093481,Chow; Bennett,8,0,32,24
1657186869105,MATH 142A,B04,093558,Chow; Bennett,11,0,32,21
1657186869105,MATH 142A,B05,093559,Chow; Bennett,6,0,32,26
1657186875137,MATH 193A,A01,083224,Rotar; Vladimir,7,0,34,27
1657186875137,MATH 193A,A02,083225,Rotar; Vladimir,5,0,34,29
1657186875137,MATH 193A,A03,083781,Rotar; Vladimir,1,0,34,33
1657186875137,MATH 193A,A04,083782,Rotar; Vladimir,8,0,34,26
1657186875137,MATH 193A,A05,093482,Rotar; Vladimir,6,0,34,28
1657186881164,MATH 197,001,091859,McAuley; Julian John,9999,0,9999,0
1657186881164,MATH 197,002,095566,Kedlaya; Kiran S.,9997,0,9999,2
1657186881164,MATH 197,003,095567,Xiao; Ming,9999,0,9999,0
1657186881164,MATH 197,004,095571,Perols; Johan Lars,9998,0,9999,1
1657186888229,COGS 9,A01,083615,Shannon; Kyle Michael,7,0,75,68
1657186894257,COGS 11,A01,083617,Boyle; Mary E. T.,22,0,48,26
1657186900285,COGS 13,A01,083071,Bastos; Amalia Pinkusfeld,9,0,71,62
1657186906321,COGS 14A,A01,092681,Semenuks; Arturs,1,1,100,99
1657186912353,COGS 14B,A01,083073,Cheng; Tzu-Han,6,0,63,57
1657186918381,COGS 17,A01,092677,Semenuks; Arturs,4,0,81,77
1657186924408,COGS 100,A01,083619,Allen; Michael Gordon,15,0,70,55
1657186930434,COGS 101A,A01,083621,Davis; Joshua Daniel,9,0,68,59
1657186936460,COGS 101B,A01,091572,Allen; Michael Gordon,9,0,65,56
1657186942485,COGS 101C,A01,083625,Delgado; Tania,17,0,35,18
1657186948517,COGS 107A,A01,083627,Boyle; Mary E. T.,13,0,60,47
1657186954539,COGS 118A,A01,083075,Gupta; Anjum,16,0,76,60
1657186960567,CSE 3,A50,083646,Miranda; Gregory Joseph,24,0,50,26
1657186966604,CSE 8A,A50,083650,Miranda; Gregory Joseph,17,1,56,39
1657186972627,CSE 11,A01,083080,Cao; Yingjun,5,15,40,35
1657186978651,CSE 12,A01,083652,Krause-Levy; Sophia Louisa,24,1,120,96
1657186984674,CSE 15L,A01,083654,Morris; Justin Loren,9,0,50,41
1657186984674,CSE 15L,A02,083655,Morris; Justin Loren,9,0,50,41
1657186990700,CSE 20,A01,083657,Tran; Khoa Dang,38,0,80,42
1657186996726,CSE 21,A01,095574,Bach; Quang Tran,22,0,48,26
1657187002749,CSE 30,A01,083084,Eldon; John,4,0,80,76
1657187002749,CSE 30,B01,095061,Bhaskar; Nishant,7,0,50,43
1657187008772,CSE 100,A01,083659,Cao; Yingjun,4,4,70,66
1657187014798,CSE 134B,A01,083661,Powell; Thomas Allan,20,0,100,80
1657187020823,CSE 140,A01,083663,Gungor; Onat,13,0,85,72
1657187026846,CSE 140L,A01,083088,Eldon; John,17,0,100,83
1657187032869,CSE 175,A01,083665,Kumar; Rakesh,3,0,25,22
1657187038893,CSE 190,A00,092507,Dubnov; Shlomo,7,0,20,13
1657187044920,ECE 45,A01,083139,Congero; Spencer William,5,0,75,70
1657187050947,ECE 65,A50,083695,Saad; Andrew S,12,0,30,18
1657187050947,ECE 65,A51,095125,Saad; Andrew S,25,0,26,1
1657187056970,ECE 109,A01,091882,Touri; Behrouz,19,0,70,51
1657187062993,ECE 180,A00,083140,Abi Samra; Nicholas Camill,1,0,30,29
1657187062993,ECE 180,B00,083141,Abi Samra; Nicholas Camill,0,0,30,30
1657187069017,MATH 10A,A01,083735,Patchell; Gregory David,2,0,30,28
1657187069017,MATH 10A,A02,083736,Patchell; Gregory David,20,0,30,10
1657187069017,MATH 10A,A03,083737,Patchell; Gregory David,16,0,30,14
1657187075041,MATH 10B,A01,083207,Lim; Seonhee,7,0,34,27
1657187075041,MATH 10B,A02,083208,Lim; Seonhee,9,0,35,26
1657187075041,MATH 10B,A03,093472,Lim; Seonhee,5,0,34,29
1657187075041,MATH 10B,B01,083739,Sinha; Shubham,10,0,30,20
1657187081063,MATH 18,A01,083743,Cinel; Cameron Alexander,6,0,30,24
1657187081063,MATH 18,A02,083744,Cinel; Cameron Alexander,15,0,30,15
1657187081063,MATH 18,A03,083745,Cinel; Cameron Alexander,8,0,30,22
1657187081063,MATH 18,B01,083748,Rideout; David Porter,4,0,37,33
1657187081063,MATH 18,B02,083749,Rideout; David Porter,4,0,36,32
1657187081063,MATH 18,B03,083750,Rideout; David Porter,2,0,37,35
1657187081063,MATH 18,B04,083751,Rideout; David Porter,5,0,36,31
1657187081063,MATH 18,B05,093473,Rideout; David Porter,5,0,36,31
1657187081063,MATH 18,B06,093474,Rideout; David Porter,5,0,36,31
1657187087114,MATH 20A,A01,083754,Zheng; Zequn,13,0,40,27
1657187093147,MATH 20B,A01,083756,Briones; Jor-el Thomas Caparas,1,0,36,35
1657187093147,MATH 20B,A02,083757,Briones; Jor-el Thomas Caparas,1,0,36,35
1657187093147,MATH 20B,A03,093475,Briones; Jor-el Thomas Caparas,1,0,36,35
1657187099171,MATH 20C,A01,083760,Briones; Jor-el Thomas Caparas,1,0,35,34
1657187099171,MATH 20C,A02,083761,Briones; Jor-el Thomas Caparas,8,0,35,27
1657187099171,MATH 20C,A03,093476,Briones; Jor-el Thomas Caparas,0,1,36,36
1657187099171,MATH 20C,B01,083762,Bach; Quang Tran,1,0,30,29
1657187105201,MATH 20D,A01,083765,Tran; Brian Kha,4,0,30,26
1657187105201,MATH 20D,A02,083766,Tran; Brian Kha,5,0,30,25
1657187105201,MATH 20D,A03,083767,Tran; Brian Kha,4,0,30,26
1657187111223,MATH 20E,A01,083771,Ganguly; Soumya,7,0,32,25
1657187111223,MATH 20E,A02,083772,Ganguly; Soumya,7,0,32,25
1657187111223,MATH 20E,B01,083773,Ciotti; Benjamin,19,0,35,16
1657187111223,MATH 20E,B02,083774,Ciotti; Benjamin,17,0,35,18
1657187117251,MATH 103A,A01,083777,Greenfeld; Be'Eri,2,0,36,34
1657187117251,MATH 103A,A02,083778,Greenfeld; Be'Eri,5,0,36,31
1657187117251,MATH 103A,A03,093561,Greenfeld; Be'Eri,4,0,36,32
1657187117251,MATH 103A,B01,083779,Greenfeld; Be'Eri,6,0,36,30
1657187117251,MATH 103A,B02,083780,Greenfeld; Be'Eri,3,0,36,33
1657187117251,MATH 103A,B03,093562,Greenfeld; Be'Eri,3,0,36,33
1657187123274,MATH 105,A01,085443,Carter; Anne Toulson,14,0,35,21
1657187123274,MATH 105,A02,093477,Carter; Anne Toulson,20,0,35,15
1657187129303,MATH 109,A01,083213,Ganzberger; Geoffrey Michael,2,0,34,32
1657187129303,MATH 109,A02,083214,Ganzberger; Geoffrey Michael,3,0,34,31
1657187129303,MATH 109,A03,093478,Ganzberger; Geoffrey Michael,1,0,34,33
1657187129303,MATH 109,B01,083215,Ganzberger; Geoffrey Michael,1,0,32,31
1657187129303,MATH 109,B02,083216,Ganzberger; Geoffrey Michael,1,0,32,31
1657187129303,MATH 109,B03,093479,Ganzberger; Geoffrey Michael,6,0,32,26
1657187135327,MATH 142A,A01,083219,Chow; Bennett,6,0,32,26
1657187135327,MATH 142A,A02,083220,Chow; Bennett,10,0,32,22
1657187135327,MATH 142A,A03,093480,Chow; Bennett,7,0,32,25
1657187135327,MATH 142A,B03,093481,Chow; Bennett,8,0,32,24
1657187135327,MATH 142A,B04,093558,Chow; Bennett,11,0,32,21
1657187135327,MATH 142A,B05,093559,Chow; Bennett,6,0,32,26
1657187141356,MATH 193A,A01,083224,Rotar; Vladimir,7,0,34,27
1657187141356,MATH 193A,A02,083225,Rotar; Vladimir,5,0,34,29
1657187141356,MATH 193A,A03,083781,Rotar; Vladimir,1,0,34,33
1657187141356,MATH 193A,A04,083782,Rotar; Vladimir,8,0,34,26
1657187141356,MATH 193A,A05,093482,Rotar; Vladimir,6,0,34,28
1657187147382,MATH 197,001,091859,McAuley; Julian John,9999,0,9999,0
1657187147382,MATH 197,002,095566,Kedlaya; Kiran S.,9997,0,9999,2
1657187147382,MATH 197,003,095567,Xiao; Ming,9999,0,9999,0
1657187147382,MATH 197,004,095571,Perols; Johan Lars,9998,0,9999,1
1657187154454,COGS 9,A01,083615,Shannon; Kyle Michael,7,0,75,68
1657187160490,COGS 11,A01,083617,Boyle; Mary E. T.,22,0,48,26
1657187166518,COGS 13,A01,083071,Bastos; Amalia Pinkusfeld,9,0,71,62
1657187172541,COGS 14A,A01,092681,Semenuks; Arturs,1,1,100,99
1657187178564,COGS 14B,A01,083073,Cheng; Tzu-Han,6,0,63,57
1657187184586,COGS 17,A01,092677,Semenuks; Arturs,4,0,81,77
1657187190611,COGS 100,A01,083619,Allen; Michael Gordon,15,0,70,55
1657187196639,COGS 101A,A01,083621,Davis; Joshua Daniel,9,0,68,59
1657187202667,COGS 101B,A01,091572,Allen; Michael Gordon,9,0,65,56
1657187208694,COGS 101C,A01,083625,Delgado; Tania,17,0,35,18
1657187214718,COGS 107A,A01,083627,Boyle; Mary E. T.,13,0,60,47
1657187220742,COGS 118A,A01,083075,Gupta; Anjum,16,0,76,60
1657187226769,CSE 3,A50,083646,Miranda; Gregory Joseph,24,0,50,26
1657187232793,CSE 8A,A50,083650,Miranda; Gregory Joseph,17,1,56,39
1657187238821,CSE 11,A01,083080,Cao; Yingjun,5,15,40,35
1657187244843,CSE 12,A01,083652,Krause-Levy; Sophia Louisa,24,1,120,96
1657187250874,CSE 15L,A01,083654,Morris; Justin Loren,9,0,50,41
1657187250874,CSE 15L,A02,083655,Morris; Justin Loren,9,0,50,41
1657187256898,CSE 20,A01,083657,Tran; Khoa Dang,38,0,80,42
1657187262922,CSE 21,A01,095574,Bach; Quang Tran,22,0,48,26
1657187268946,CSE 30,A01,083084,Eldon; John,4,0,80,76
1657187268946,CSE 30,B01,095061,Bhaskar; Nishant,7,0,50,43
1657187274974,CSE 100,A01,083659,Cao; Yingjun,4,4,70,66
1657187280999,CSE 134B,A01,083661,Powell; Thomas Allan,20,0,100,80
1657187287023,CSE 140,A01,083663,Gungor; Onat,13,0,85,72
1657187293049,CSE 140L,A01,083088,Eldon; John,17,0,100,83
1657187299076,CSE 175,A01,083665,Kumar; Rakesh,3,0,25,22
1657187305099,CSE 190,A00,092507,Dubnov; Shlomo,7,0,20,13
1657187311124,ECE 45,A01,083139,Congero; Spencer William,5,0,75,70
1657187317146,ECE 65,A50,083695,Saad; Andrew S,12,0,30,18
1657187317146,ECE 65,A51,095125,Saad; Andrew S,25,0,26,1
1657187323174,ECE 109,A01,091882,Touri; Behrouz,19,0,70,51
1657187329199,ECE 180,A00,083140,Abi Samra; Nicholas Camill,1,0,30,29
1657187329199,ECE 180,B00,083141,Abi Samra; Nicholas Camill,0,0,30,30
1657187335227,MATH 10A,A01,083735,Patchell; Gregory David,2,0,30,28
1657187335227,MATH 10A,A02,083736,Patchell; Gregory David,20,0,30,10
1657187335227,MATH 10A,A03,083737,Patchell; Gregory David,16,0,30,14
1657187341256,MATH 10B,A01,083207,Lim; Seonhee,7,0,34,27
1657187341256,MATH 10B,A02,083208,Lim; Seonhee,9,0,35,26
1657187341256,MATH 10B,A03,093472,Lim; Seonhee,5,0,34,29
1657187341256,MATH 10B,B01,083739,Sinha; Shubham,10,0,30,20
1657187347287,MATH 18,A01,083743,Cinel; Cameron Alexander,6,0,30,24
1657187347287,MATH 18,A02,083744,Cinel; Cameron Alexander,15,0,30,15
1657187347287,MATH 18,A03,083745,Cinel; Cameron Alexander,8,0,30,22
1657187347287,MATH 18,B01,083748,Rideout; David Porter,4,0,37,33
1657187347287,MATH 18,B02,083749,Rideout; David Porter,4,0,36,32
1657187347287,MATH 18,B03,083750,Rideout; David Porter,2,0,37,35
1657187347287,MATH 18,B04,083751,Rideout; David Porter,5,0,36,31
1657187347287,MATH 18,B05,093473,Rideout; David Porter,5,0,36,31
1657187347287,MATH 18,B06,093474,Rideout; David Porter,5,0,36,31
1657187353310,MATH 20A,A01,083754,Zheng; Zequn,13,0,40,27
1657187359333,MATH 20B,A01,083756,Briones; Jor-el Thomas Caparas,1,0,36,35
1657187359333,MATH 20B,A02,083757,Briones; Jor-el Thomas Caparas,1,0,36,35
1657187359333,MATH 20B,A03,093475,Briones; Jor-el Thomas Caparas,1,0,36,35
1657187365356,MATH 20C,A01,083760,Briones; Jor-el Thomas Caparas,1,0,35,34
1657187365356,MATH 20C,A02,083761,Briones; Jor-el Thomas Caparas,8,0,35,27
1657187365356,MATH 20C,A03,093476,Briones; Jor-el Thomas Caparas,0,1,36,36
1657187365356,MATH 20C,B01,083762,Bach; Quang Tran,1,0,30,29
1657187371386,MATH 20D,A01,083765,Tran; Brian Kha,4,0,30,26
1657187371386,MATH 20D,A02,083766,Tran; Brian Kha,5,0,30,25
1657187371386,MATH 20D,A03,083767,Tran; Brian Kha,4,0,30,26
1657187377410,MATH 20E,A01,083771,Ganguly; Soumya,7,0,32,25
1657187377410,MATH 20E,A02,083772,Ganguly; Soumya,7,0,32,25
1657187377410,MATH 20E,B01,083773,Ciotti; Benjamin,19,0,35,16
1657187377410,MATH 20E,B02,083774,Ciotti; Benjamin,17,0,35,18
1657187383437,MATH 103A,A01,083777,Greenfeld; Be'Eri,2,0,36,34
1657187383437,MATH 103A,A02,083778,Greenfeld; Be'Eri,5,0,36,31
1657187383437,MATH 103A,A03,093561,Greenfeld; Be'Eri,4,0,36,32
1657187383437,MATH 103A,B01,083779,Greenfeld; Be'Eri,6,0,36,30
1657187383437,MATH 103A,B02,083780,Greenfeld; Be'Eri,3,0,36,33
1657187383437,MATH 103A,B03,093562,Greenfeld; Be'Eri,3,0,36,33
1657187389465,MATH 105,A01,085443,Carter; Anne Toulson,14,0,35,21
1657187389465,MATH 105,A02,093477,Carter; Anne Toulson,20,0,35,15
1657187395492,MATH 109,A01,083213,Ganzberger; Geoffrey Michael,2,0,34,32
1657187395492,MATH 109,A02,083214,Ganzberger; Geoffrey Michael,3,0,34,31
1657187395492,MATH 109,A03,093478,Ganzberger; Geoffrey Michael,1,0,34,33
1657187395492,MATH 109,B01,083215,Ganzberger; Geoffrey Michael,1,0,32,31
1657187395492,MATH 109,B02,083216,Ganzberger; Geoffrey Michael,1,0,32,31
1657187395492,MATH 109,B03,093479,Ganzberger; Geoffrey Michael,6,0,32,26
1657187401523,MATH 142A,A01,083219,Chow; Bennett,6,0,32,26
1657187401523,MATH 142A,A02,083220,Chow; Bennett,10,0,32,22
1657187401523,MATH 142A,A03,093480,Chow; Bennett,7,0,32,25
1657187401523,MATH 142A,B03,093481,Chow; Bennett,8,0,32,24
1657187401523,MATH 142A,B04,093558,Chow; Bennett,11,0,32,21
1657187401523,MATH 142A,B05,093559,Chow; Bennett,6,0,32,26
1657187407550,MATH 193A,A01,083224,Rotar; Vladimir,7,0,34,27
1657187407550,MATH 193A,A02,083225,Rotar; Vladimir,5,0,34,29
1657187407550,MATH 193A,A03,083781,Rotar; Vladimir,1,0,34,33
1657187407550,MATH 193A,A04,083782,Rotar; Vladimir,8,0,34,26
1657187407550,MATH 193A,A05,093482,Rotar; Vladimir,6,0,34,28
1657187413576,MATH 197,001,091859,McAuley; Julian John,9999,0,9999,0
1657187413576,MATH 197,002,095566,Kedlaya; Kiran S.,9997,0,9999,2
1657187413576,MATH 197,003,095567,Xiao; Ming,9999,0,9999,0
1657187413576,MATH 197,004,095571,Perols; Johan Lars,9998,0,9999,1
1657187420648,COGS 9,A01,083615,Shannon; Kyle Michael,7,0,75,68
1657187426672,COGS 11,A01,083617,Boyle; Mary E. T.,22,0,48,26
1657187432698,COGS 13,A01,083071,Bastos; Amalia Pinkusfeld,9,0,71,62
1657187438721,COGS 14A,A01,092681,Semenuks; Arturs,1,1,100,99
1657187444748,COGS 14B,A01,083073,Cheng; Tzu-Han,6,0,63,57
1657187450771,COGS 17,A01,092677,Semenuks; Arturs,4,0,81,77
1657187456793,COGS 100,A01,083619,Allen; Michael Gordon,15,0,70,55
1657187462910,COGS 101A,A01,083621,Davis; Joshua Daniel,9,0,68,59
1657187468936,COGS 101B,A01,091572,Allen; Michael Gordon,9,0,65,56
1657187474963,COGS 101C,A01,083625,Delgado; Tania,17,0,35,18
1657187480987,COGS 107A,A01,083627,Boyle; Mary E. T.,13,0,60,47
1657187487014,COGS 118A,A01,083075,Gupta; Anjum,16,0,76,60
1657187493039,CSE 3,A50,083646,Miranda; Gregory Joseph,24,0,50,26
1657187499067,CSE 8A,A50,083650,Miranda; Gregory Joseph,17,1,56,39
1657187505093,CSE 11,A01,083080,Cao; Yingjun,5,15,40,35
1657187511119,CSE 12,A01,083652,Krause-Levy; Sophia Louisa,24,1,120,96
1657187517143,CSE 15L,A01,083654,Morris; Justin Loren,9,0,50,41
1657187517143,CSE 15L,A02,083655,Morris; Justin Loren,9,0,50,41
1657187523166,CSE 20,A01,083657,Tran; Khoa Dang,38,0,80,42
1657187529189,CSE 21,A01,095574,Bach; Quang Tran,22,0,48,26
1657187535213,CSE 30,A01,083084,Eldon; John,4,0,80,76
1657187535213,CSE 30,B01,095061,Bhaskar; Nishant,7,0,50,43
1657187541238,CSE 100,A01,083659,Cao; Yingjun,4,4,70,66
1657187547266,CSE 134B,A01,083661,Powell; Thomas Allan,20,0,100,80
1657187553294,CSE 140,A01,083663,Gungor; Onat,13,0,85,72
1657187559322,CSE 140L,A01,083088,Eldon; John,17,0,100,83
1657187565344,CSE 175,A01,083665,Kumar; Rakesh,3,0,25,22
1657187571371,CSE 190,A00,092507,Dubnov; Shlomo,7,0,20,13
1657187577399,ECE 45,A01,083139,Congero; Spencer William,5,0,75,70
1657187583426,ECE 65,A50,083695,Saad; Andrew S,12,0,30,18
1657187583426,ECE 65,A51,095125,Saad; Andrew S,25,0,26,1
1657187589457,ECE 109,A01,091882,Touri; Behrouz,19,0,70,51
1657187595479,ECE 180,A00,083140,Abi Samra; Nicholas Camill,1,0,30,29
1657187595479,ECE 180,B00,083141,Abi Samra; Nicholas Camill,0,0,30,30
1657187601507,MATH 10A,A01,083735,Patchell; Gregory David,2,0,30,28
1657187601507,MATH 10A,A02,083736,Patchell; Gregory David,20,0,30,10
1657187601507,MATH 10A,A03,083737,Patchell; Gregory David,16,0,30,14
1657187607530,MATH 10B,A01,083207,Lim; Seonhee,7,0,34,27
1657187607530,MATH 10B,A02,083208,Lim; Seonhee,9,0,35,26
1657187607530,MATH 10B,A03,093472,Lim; Seonhee,5,0,34,29
1657187607530,MATH 10B,B01,083739,Sinha; Shubham,10,0,30,20
1657187613562,MATH 18,A01,083743,Cinel; Cameron Alexander,6,0,30,24
1657187613562,MATH 18,A02,083744,Cinel; Cameron Alexander,15,0,30,15
1657187613562,MATH 18,A03,083745,Cinel; Cameron Alexander,8,0,30,22
1657187613562,MATH 18,B01,083748,Rideout; David Porter,4,0,37,33
1657187613562,MATH 18,B02,083749,Rideout; David Porter,4,0,36,32
1657187613562,MATH 18,B03,083750,Rideout; David Porter,2,0,37,35
1657187613562,MATH 18,B04,083751,Rideout; David Porter,5,0,36,31
1657187613562,MATH 18,B05,093473,Rideout; David Porter,5,0,36,31
1657187613562,MATH 18,B06,093474,Rideout; David Porter,5,0,36,31
1657187619586,MATH 20A,A01,083754,Zheng; Zequn,13,0,40,27
1657187625611,MATH 20B,A01,083756,Briones; Jor-el Thomas Caparas,1,0,36,35
1657187625611,MATH 20B,A02,083757,Briones; Jor-el Thomas Caparas,1,0,36,35
1657187625611,MATH 20B,A03,093475,Briones; Jor-el Thomas Caparas,1,0,36,35
1657187631638,MATH 20C,A01,083760,Briones; Jor-el Thomas Caparas,1,0,35,34
1657187631638,MATH 20C,A02,083761,Briones; Jor-el Thomas Caparas,8,0,35,27
1657187631638,MATH 20C,A03,093476,Briones; Jor-el Thomas Caparas,0,1,36,36
1657187631638,MATH 20C,B01,083762,Bach; Quang Tran,1,0,30,29
1657187637667,MATH 20D,A01,083765,Tran; Brian Kha,4,0,30,26
1657187637667,MATH 20D,A02,083766,Tran; Brian Kha,5,0,30,25
1657187637667,MATH 20D,A03,083767,Tran; Brian Kha,4,0,30,26
1657187643693,MATH 20E,A01,083771,Ganguly; Soumya,7,0,32,25
1657187643693,MATH 20E,A02,083772,Ganguly; Soumya,7,0,32,25
1657187643693,MATH 20E,B01,083773,Ciotti; Benjamin,19,0,35,16
1657187643693,MATH 20E,B02,083774,Ciotti; Benjamin,17,0,35,18
1657187649724,MATH 103A,A01,083777,Greenfeld; Be'Eri,2,0,36,34
1657187649724,MATH 103A,A02,083778,Greenfeld; Be'Eri,5,0,36,31
1657187649724,MATH 103A,A03,093561,Greenfeld; Be'Eri,4,0,36,32
1657187649724,MATH 103A,B01,083779,Greenfeld; Be'Eri,6,0,36,30
1657187649724,MATH 103A,B02,083780,Greenfeld; Be'Eri,3,0,36,33
1657187649724,MATH 103A,B03,093562,Greenfeld; Be'Eri,3,0,36,33
1657187655749,MATH 105,A01,085443,Carter; Anne Toulson,14,0,35,21
1657187655749,MATH 105,A02,093477,Carter; Anne Toulson,20,0,35,15
1657187661781,MATH 109,A01,083213,Ganzberger; Geoffrey Michael,2,0,34,32
1657187661781,MATH 109,A02,083214,Ganzberger; Geoffrey Michael,3,0,34,31
1657187661781,MATH 109,A03,093478,Ganzberger; Geoffrey Michael,1,0,34,33
1657187661781,MATH 109,B01,083215,Ganzberger; Geoffrey Michael,1,0,32,31
1657187661781,MATH 109,B02,083216,Ganzberger; Geoffrey Michael,1,0,32,31
1657187661781,MATH 109,B03,093479,Ganzberger; Geoffrey Michael,6,0,32,26
1657187667806,MATH 142A,A01,083219,Chow; Bennett,6,0,32,26
1657187667806,MATH 142A,A02,083220,Chow; Bennett,10,0,32,22
1657187667806,MATH 142A,A03,093480,Chow; Bennett,7,0,32,25
1657187667806,MATH 142A,B03,093481,Chow; Bennett,8,0,32,24
1657187667806,MATH 142A,B04,093558,Chow; Bennett,11,0,32,21
1657187667806,MATH 142A,B05,093559,Chow; Bennett,6,0,32,26
1657187673831,MATH 193A,A01,083224,Rotar; Vladimir,7,0,34,27
1657187673831,MATH 193A,A02,083225,Rotar; Vladimir,5,0,34,29
1657187673831,MATH 193A,A03,083781,Rotar; Vladimir,1,0,34,33
1657187673831,MATH 193A,A04,083782,Rotar; Vladimir,8,0,34,26
1657187673831,MATH 193A,A05,093482,Rotar; Vladimir,6,0,34,28
1657187679855,MATH 197,001,091859,McAuley; Julian John,9999,0,9999,0
1657187679855,MATH 197,002,095566,Kedlaya; Kiran S.,9997,0,9999,2
1657187679855,MATH 197,003,095567,Xiao; Ming,9999,0,9999,0
1657187679855,MATH 197,004,095571,Perols; Johan Lars,9998,0,9999,1
1657187686909,COGS 9,A01,083615,Shannon; Kyle Michael,7,0,75,68
1657187692942,COGS 11,A01,083617,Boyle; Mary E. T.,22,0,48,26
1657187698964,COGS 13,A01,083071,Bastos; Amalia Pinkusfeld,9,0,71,62
1657187704987,COGS 14A,A01,092681,Semenuks; Arturs,1,1,100,99
1657187711016,COGS 14B,A01,083073,Cheng; Tzu-Han,6,0,63,57
1657187717042,COGS 17,A01,092677,Semenuks; Arturs,4,0,81,77
1657187723065,COGS 100,A01,083619,Allen; Michael Gordon,15,0,70,55
1657187729093,COGS 101A,A01,083621,Davis; Joshua Daniel,9,0,68,59
1657187735120,COGS 101B,A01,091572,Allen; Michael Gordon,9,0,65,56
1657187741149,COGS 101C,A01,083625,Delgado; Tania,17,0,35,18
1657187747172,COGS 107A,A01,083627,Boyle; Mary E. T.,13,0,60,47
1657187753199,COGS 118A,A01,083075,Gupta; Anjum,16,0,76,60
1657187759222,CSE 3,A50,083646,Miranda; Gregory Joseph,24,0,50,26
1657187765246,CSE 8A,A50,083650,Miranda; Gregory Joseph,17,1,56,39
1657187771273,CSE 11,A01,083080,Cao; Yingjun,5,15,40,35
1657187777299,CSE 12,A01,083652,Krause-Levy; Sophia Louisa,24,1,120,96
1657187783326,CSE 15L,A01,083654,Morris; Justin Loren,9,0,50,41
1657187783326,CSE 15L,A02,083655,Morris; Justin Loren,9,0,50,41
1657187789351,CSE 20,A01,083657,Tran; Khoa Dang,38,0,80,42
1657187795373,CSE 21,A01,095574,Bach; Quang Tran,22,0,48,26
1657187801395,CSE 30,A01,083084,Eldon; John,4,0,80,76
1657187801395,CSE 30,B01,095061,Bhaskar; Nishant,7,0,50,43
1657187807423,CSE 100,A01,083659,Cao; Yingjun,4,4,70,66
1657187813450,CSE 134B,A01,083661,Powell; Thomas Allan,20,0,100,80
1657187819473,CSE 140,A01,083663,Gungor; Onat,13,0,85,72
1657187825496,CSE 140L,A01,083088,Eldon; John,17,0,100,83
1657187831519,CSE 175,A01,083665,Kumar; Rakesh,3,0,25,22
1657187837544,CSE 190,A00,092507,Dubnov; Shlomo,7,0,20,13
1657187843568,ECE 45,A01,083139,Congero; Spencer William,5,0,75,70
1657187849590,ECE 65,A50,083695,Saad; Andrew S,12,0,30,18
1657187849590,ECE 65,A51,095125,Saad; Andrew S,25,0,26,1
1657187855621,ECE 109,A01,091882,Touri; Behrouz,19,0,70,51
1657187861645,ECE 180,A00,083140,Abi Samra; Nicholas Camill,1,0,30,29
1657187861645,ECE 180,B00,083141,Abi Samra; Nicholas Camill,0,0,30,30
1657187867669,MATH 10A,A01,083735,Patchell; Gregory David,2,0,30,28
1657187867669,MATH 10A,A02,083736,Patchell; Gregory David,20,0,30,10
1657187867669,MATH 10A,A03,083737,Patchell; Gregory David,16,0,30,14
1657187873698,MATH 10B,A01,083207,Lim; Seonhee,7,0,34,27
1657187873698,MATH 10B,A02,083208,Lim; Seonhee,9,0,35,26
1657187873698,MATH 10B,A03,093472,Lim; Seonhee,5,0,34,29
1657187873698,MATH 10B,B01,083739,Sinha; Shubham,10,0,30,20
1657187879724,MATH 18,A01,083743,Cinel; Cameron Alexander,6,0,30,24
1657187879724,MATH 18,A02,083744,Cinel; Cameron Alexander,15,0,30,15
1657187879724,MATH 18,A03,083745,Cinel; Cameron Alexander,8,0,30,22
1657187879724,MATH 18,B01,083748,Rideout; David Porter,4,0,37,33
1657187879724,MATH 18,B02,083749,Rideout; David Porter,4,0,36,32
1657187879724,MATH 18,B03,083750,Rideout; David Porter,2,0,37,35
1657187879724,MATH 18,B04,083751,Rideout; David Porter,5,0,36,31
1657187879724,MATH 18,B05,093473,Rideout; David Porter,5,0,36,31
1657187879724,MATH 18,B06,093474,Rideout; David Porter,5,0,36,31
1657187885749,MATH 20A,A01,083754,Zheng; Zequn,13,0,40,27
1657187891777,MATH 20B,A01,083756,Briones; Jor-el Thomas Caparas,1,0,36,35
1657187891777,MATH 20B,A02,083757,Briones; Jor-el Thomas Caparas,1,0,36,35
1657187891777,MATH 20B,A03,093475,Briones; Jor-el Thomas Caparas,1,0,36,35
1657187897799,MATH 20C,A01,083760,Briones; Jor-el Thomas Caparas,1,0,35,34
1657187897799,MATH 20C,A02,083761,Briones; Jor-el Thomas Caparas,8,0,35,27
1657187897799,MATH 20C,A03,093476,Briones; Jor-el Thomas Caparas,0,1,36,36
1657187897799,MATH 20C,B01,083762,Bach; Quang Tran,1,0,30,29
1657187903829,MATH 20D,A01,083765,Tran; Brian Kha,4,0,30,26
1657187903829,MATH 20D,A02,083766,Tran; Brian Kha,5,0,30,25
1657187903829,MATH 20D,A03,083767,Tran; Brian Kha,4,0,30,26
1657187909860,MATH 20E,A01,083771,Ganguly; Soumya,7,0,32,25
1657187909860,MATH 20E,A02,083772,Ganguly; Soumya,7,0,32,25
1657187909860,MATH 20E,B01,083773,Ciotti; Benjamin,19,0,35,16
1657187909860,MATH 20E,B02,083774,Ciotti; Benjamin,17,0,35,18
1657187915883,MATH 103A,A01,083777,Greenfeld; Be'Eri,2,0,36,34
1657187915883,MATH 103A,A02,083778,Greenfeld; Be'Eri,5,0,36,31
1657187915883,MATH 103A,A03,093561,Greenfeld; Be'Eri,4,0,36,32
1657187915883,MATH 103A,B01,083779,Greenfeld; Be'Eri,6,0,36,30
1657187915883,MATH 103A,B02,083780,Greenfeld; Be'Eri,3,0,36,33
1657187915883,MATH 103A,B03,093562,Greenfeld; Be'Eri,3,0,36,33
1657187921907,MATH 105,A01,085443,Carter; Anne Toulson,14,0,35,21
1657187921907,MATH 105,A02,093477,Carter; Anne Toulson,20,0,35,15
1657187927929,MATH 109,A01,083213,Ganzberger; Geoffrey Michael,2,0,34,32
1657187927929,MATH 109,A02,083214,Ganzberger; Geoffrey Michael,3,0,34,31
1657187927929,MATH 109,A03,093478,Ganzberger; Geoffrey Michael,1,0,34,33
1657187927929,MATH 109,B01,083215,Ganzberger; Geoffrey Michael,1,0,32,31
1657187927929,MATH 109,B02,083216,Ganzberger; Geoffrey Michael,1,0,32,31
1657187927929,MATH 109,B03,093479,Ganzberger; Geoffrey Michael,7,0,32,25
1657187933951,MATH 142A,A01,083219,Chow; Bennett,6,0,32,26
1657187933951,MATH 142A,A02,083220,Chow; Bennett,10,0,32,22
1657187933951,MATH 142A,A03,093480,Chow; Bennett,7,0,32,25
1657187933951,MATH 142A,B03,093481,Chow; Bennett,8,0,32,24
1657187933951,MATH 142A,B04,093558,Chow; Bennett,11,0,32,21
1657187933951,MATH 142A,B05,093559,Chow; Bennett,6,0,32,26
1657187939979,MATH 193A,A01,083224,Rotar; Vladimir,7,0,34,27
1657187939979,MATH 193A,A02,083225,Rotar; Vladimir,5,0,34,29
1657187939979,MATH 193A,A03,083781,Rotar; Vladimir,1,0,34,33
1657187939979,MATH 193A,A04,083782,Rotar; Vladimir,8,0,34,26
1657187939979,MATH 193A,A05,093482,Rotar; Vladimir,6,0,34,28
1657187946004,MATH 197,001,091859,McAuley; Julian John,9999,0,9999,0
1657187946004,MATH 197,002,095566,Kedlaya; Kiran S.,9997,0,9999,2
1657187946004,MATH 197,003,095567,Xiao; Ming,9999,0,9999,0
1657187946004,MATH 197,004,095571,Perols; Johan Lars,9998,0,9999,1
1657187953060,COGS 9,A01,083615,Shannon; Kyle Michael,7,0,75,68
1657187959081,COGS 11,A01,083617,Boyle; Mary E. T.,22,0,48,26
1657187965104,COGS 13,A01,083071,Bastos; Amalia Pinkusfeld,9,0,71,62
1657187971130,COGS 14A,A01,092681,Semenuks; Arturs,1,1,100,99
1657187977154,COGS 14B,A01,083073,Cheng; Tzu-Han,6,0,63,57
1657187983182,COGS 17,A01,092677,Semenuks; Arturs,4,0,81,77
1657187989208,COGS 100,A01,083619,Allen; Michael Gordon,15,0,70,55
1657187995231,COGS 101A,A01,083621,Davis; Joshua Daniel,9,0,68,59
1657188001256,COGS 101B,A01,091572,Allen; Michael Gordon,9,0,65,56
1657188007279,COGS 101C,A01,083625,Delgado; Tania,17,0,35,18
1657188013302,COGS 107A,A01,083627,Boyle; Mary E. T.,13,0,60,47
1657188019325,COGS 118A,A01,083075,Gupta; Anjum,16,0,76,60
1657188025348,CSE 3,A50,083646,Miranda; Gregory Joseph,24,0,50,26
1657188031376,CSE 8A,A50,083650,Miranda; Gregory Joseph,17,1,56,39
1657188037402,CSE 11,A01,083080,Cao; Yingjun,5,15,40,35
1657188043424,CSE 12,A01,083652,Krause-Levy; Sophia Louisa,24,1,120,96
1657188049446,CSE 15L,A01,083654,Morris; Justin Loren,9,0,50,41
1657188049446,CSE 15L,A02,083655,Morris; Justin Loren,9,0,50,41
1657188055470,CSE 20,A01,083657,Tran; Khoa Dang,38,0,80,42
1657188061570,CSE 21,A01,095574,Bach; Quang Tran,22,0,48,26
1657188067592,CSE 30,A01,083084,Eldon; John,4,0,80,76
1657188067592,CSE 30,B01,095061,Bhaskar; Nishant,7,0,50,43
1657188073620,CSE 100,A01,083659,Cao; Yingjun,4,4,70,66
1657188079643,CSE 134B,A01,083661,Powell; Thomas Allan,20,0,100,80
1657188085668,CSE 140,A01,083663,Gungor; Onat,13,0,85,72
1657188091695,CSE 140L,A01,083088,Eldon; John,17,0,100,83
1657188097718,CSE 175,A01,083665,Kumar; Rakesh,3,0,25,22
1657188103741,CSE 190,A00,092507,Dubnov; Shlomo,7,0,20,13
1657188109766,ECE 45,A01,083139,Congero; Spencer William,5,0,75,70
1657188115794,ECE 65,A50,083695,Saad; Andrew S,12,0,30,18
1657188115794,ECE 65,A51,095125,Saad; Andrew S,25,0,26,1
1657188121826,ECE 109,A01,091882,Touri; Behrouz,19,0,70,51
1657188127852,ECE 180,A00,083140,Abi Samra; Nicholas Camill,1,0,30,29
1657188127852,ECE 180,B00,083141,Abi Samra; Nicholas Camill,0,0,30,30
1657188133874,MATH 10A,A01,083735,Patchell; Gregory David,2,0,30,28
1657188133874,MATH 10A,A02,083736,Patchell; Gregory David,20,0,30,10
1657188133874,MATH 10A,A03,083737,Patchell; Gregory David,16,0,30,14
1657188139897,MATH 10B,A01,083207,Lim; Seonhee,7,0,34,27
1657188139897,MATH 10B,A02,083208,Lim; Seonhee,9,0,35,26
1657188139897,MATH 10B,A03,093472,Lim; Seonhee,5,0,34,29
1657188139897,MATH 10B,B01,083739,Sinha; Shubham,10,0,30,20
1657188145921,MATH 18,A01,083743,Cinel; Cameron Alexander,6,0,30,24
1657188145921,MATH 18,A02,083744,Cinel; Cameron Alexander,15,0,30,15
1657188145921,MATH 18,A03,083745,Cinel; Cameron Alexander,8,0,30,22
1657188145921,MATH 18,B01,083748,Rideout; David Porter,4,0,37,33
1657188145921,MATH 18,B02,083749,Rideout; David Porter,4,0,36,32
1657188145921,MATH 18,B03,083750,Rideout; David Porter,2,0,37,35
1657188145921,MATH 18,B04,083751,Rideout; David Porter,5,0,36,31
1657188145921,MATH 18,B05,093473,Rideout; David Porter,5,0,36,31
1657188145921,MATH 18,B06,093474,Rideout; David Porter,5,0,36,31
1657188151945,MATH 20A,A01,083754,Zheng; Zequn,13,0,40,27
1657188157972,MATH 20B,A01,083756,Briones; Jor-el Thomas Caparas,1,0,36,35
1657188157972,MATH 20B,A02,083757,Briones; Jor-el Thomas Caparas,1,0,36,35
1657188157972,MATH 20B,A03,093475,Briones; Jor-el Thomas Caparas,1,0,36,35
1657188163996,MATH 20C,A01,083760,Briones; Jor-el Thomas Caparas,1,0,35,34
1657188163996,MATH 20C,A02,083761,Briones; Jor-el Thomas Caparas,8,0,35,27
1657188163996,MATH 20C,A03,093476,Briones; Jor-el Thomas Caparas,0,1,36,36
1657188163996,MATH 20C,B01,083762,Bach; Quang Tran,1,0,30,29
1657188170018,MATH 20D,A01,083765,Tran; Brian Kha,4,0,30,26
1657188170018,MATH 20D,A02,083766,Tran; Brian Kha,5,0,30,25
1657188170018,MATH 20D,A03,083767,Tran; Brian Kha,4,0,30,26
1657188176046,MATH 20E,A01,083771,Ganguly; Soumya,7,0,32,25
1657188176046,MATH 20E,A02,083772,Ganguly; Soumya,7,0,32,25
1657188176046,MATH 20E,B01,083773,Ciotti; Benjamin,19,0,35,16
1657188176046,MATH 20E,B02,083774,Ciotti; Benjamin,17,0,35,18
1657188182070,MATH 103A,A01,083777,Greenfeld; Be'Eri,2,0,36,34
1657188182070,MATH 103A,A02,083778,Greenfeld; Be'Eri,5,0,36,31
1657188182070,MATH 103A,A03,093561,Greenfeld; Be'Eri,4,0,36,32
1657188182070,MATH 103A,B01,083779,Greenfeld; Be'Eri,6,0,36,30
1657188182070,MATH 103A,B02,083780,Greenfeld; Be'Eri,3,0,36,33
1657188182070,MATH 103A,B03,093562,Greenfeld; Be'Eri,3,0,36,33
1657188188096,MATH 105,A01,085443,Carter; Anne Toulson,14,0,35,21
1657188188096,MATH 105,A02,093477,Carter; Anne Toulson,20,0,35,15
1657188194119,MATH 109,A01,083213,Ganzberger; Geoffrey Michael,2,0,34,32
1657188194119,MATH 109,A02,083214,Ganzberger; Geoffrey Michael,3,0,34,31
1657188194119,MATH 109,A03,093478,Ganzberger; Geoffrey Michael,1,0,34,33
1657188194119,MATH 109,B01,083215,Ganzberger; Geoffrey Michael,1,0,32,31
1657188194119,MATH 109,B02,083216,Ganzberger; Geoffrey Michael,1,0,32,31
1657188194119,MATH 109,B03,093479,Ganzberger; Geoffrey Michael,7,0,32,25
1657188200147,MATH 142A,A01,083219,Chow; Bennett,6,0,32,26
1657188200147,MATH 142A,A02,083220,Chow; Bennett,10,0,32,22
1657188200147,MATH 142A,A03,093480,Chow; Bennett,7,0,32,25
1657188200147,MATH 142A,B03,093481,Chow; Bennett,8,0,32,24
1657188200147,MATH 142A,B04,093558,Chow; Bennett,11,0,32,21
1657188200147,MATH 142A,B05,093559,Chow; Bennett,6,0,32,26
1657188206171,MATH 193A,A01,083224,Rotar; Vladimir,7,0,34,27
1657188206171,MATH 193A,A02,083225,Rotar; Vladimir,5,0,34,29
1657188206171,MATH 193A,A03,083781,Rotar; Vladimir,1,0,34,33
1657188206171,MATH 193A,A04,083782,Rotar; Vladimir,8,0,34,26
1657188206171,MATH 193A,A05,093482,Rotar; Vladimir,6,0,34,28
1657188212194,MATH 197,001,091859,McAuley; Julian John,9999,0,9999,0
1657188212194,MATH 197,002,095566,Kedlaya; Kiran S.,9997,0,9999,2
1657188212194,MATH 197,003,095567,Xiao; Ming,9999,0,9999,0
1657188212194,MATH 197,004,095571,Perols; Johan Lars,9998,0,9999,1
1657188219264,COGS 9,A01,083615,Shannon; Kyle Michael,7,0,75,68
1657188225288,COGS 11,A01,083617,Boyle; Mary E. T.,22,0,48,26
1657188231312,COGS 13,A01,083071,Bastos; Amalia Pinkusfeld,9,0,71,62
1657188237338,COGS 14A,A01,092681,Semenuks; Arturs,1,1,100,99
1657188243361,COGS 14B,A01,083073,Cheng; Tzu-Han,6,0,63,57
1657188249385,COGS 17,A01,092677,Semenuks; Arturs,4,0,81,77
1657188255409,COGS 100,A01,083619,Allen; Michael Gordon,15,0,70,55
1657188261444,COGS 101A,A01,083621,Davis; Joshua Daniel,9,0,68,59
1657188267472,COGS 101B,A01,091572,Allen; Michael Gordon,9,0,65,56
1657188273495,COGS 101C,A01,083625,Delgado; Tania,17,0,35,18
1657188279519,COGS 107A,A01,083627,Boyle; Mary E. T.,13,0,60,47
1657188285543,COGS 118A,A01,083075,Gupta; Anjum,16,0,76,60
1657188291565,CSE 3,A50,083646,Miranda; Gregory Joseph,24,0,50,26
1657188297593,CSE 8A,A50,083650,Miranda; Gregory Joseph,17,1,56,39
1657188303617,CSE 11,A01,083080,Cao; Yingjun,5,15,40,35
1657188309645,CSE 12,A01,083652,Krause-Levy; Sophia Louisa,24,1,120,96
1657188315669,CSE 15L,A01,083654,Morris; Justin Loren,9,0,50,41
1657188315669,CSE 15L,A02,083655,Morris; Justin Loren,9,0,50,41
1657188321693,CSE 20,A01,083657,Tran; Khoa Dang,38,0,80,42
1657188327719,CSE 21,A01,095574,Bach; Quang Tran,22,0,48,26
1657188333742,CSE 30,A01,083084,Eldon; John,4,0,80,76
1657188333742,CSE 30,B01,095061,Bhaskar; Nishant,7,0,50,43
1657188339765,CSE 100,A01,083659,Cao; Yingjun,4,4,70,66
1657188345787,CSE 134B,A01,083661,Powell; Thomas Allan,20,0,100,80
1657188351814,CSE 140,A01,083663,Gungor; Onat,13,0,85,72
1657188357839,CSE 140L,A01,083088,Eldon; John,17,0,100,83
1657188363865,CSE 175,A01,083665,Kumar; Rakesh,3,0,25,22
1657188369907,CSE 190,A00,092507,Dubnov; Shlomo,7,0,20,13
1657188375930,ECE 45,A01,083139,Congero; Spencer William,5,0,75,70
1657188381955,ECE 65,A50,083695,Saad; Andrew S,12,0,30,18
1657188381955,ECE 65,A51,095125,Saad; Andrew S,25,0,26,1
1657188387978,ECE 109,A01,091882,Touri; Behrouz,19,0,70,51
1657188394002,ECE 180,A00,083140,Abi Samra; Nicholas Camill,1,0,30,29
1657188394002,ECE 180,B00,083141,Abi Samra; Nicholas Camill,0,0,30,30
1657188400031,MATH 10A,A01,083735,Patchell; Gregory David,2,0,30,28
1657188400031,MATH 10A,A02,083736,Patchell; Gregory David,20,0,30,10
1657188400031,MATH 10A,A03,083737,Patchell; Gregory David,16,0,30,14
1657188406054,MATH 10B,A01,083207,Lim; Seonhee,7,0,34,27
1657188406054,MATH 10B,A02,083208,Lim; Seonhee,9,0,35,26
1657188406054,MATH 10B,A03,093472,Lim; Seonhee,5,0,34,29
1657188406054,MATH 10B,B01,083739,Sinha; Shubham,10,0,30,20
1657188412081,MATH 18,A01,083743,Cinel; Cameron Alexander,6,0,30,24
1657188412081,MATH 18,A02,083744,Cinel; Cameron Alexander,15,0,30,15
1657188412081,MATH 18,A03,083745,Cinel; Cameron Alexander,8,0,30,22
1657188412081,MATH 18,B01,083748,Rideout; David Porter,4,0,37,33
1657188412081,MATH 18,B02,083749,Rideout; David Porter,4,0,36,32
1657188412081,MATH 18,B03,083750,Rideout; David Porter,2,0,37,35
1657188412081,MATH 18,B04,083751,Rideout; David Porter,5,0,36,31
1657188412081,MATH 18,B05,093473,Rideout; David Porter,5,0,36,31
1657188412081,MATH 18,B06,093474,Rideout; David Porter,5,0,36,31
1657188418107,MATH 20A,A01,083754,Zheng; Zequn,13,0,40,27
1657188424131,MATH 20B,A01,083756,Briones; Jor-el Thomas Caparas,1,0,36,35
1657188424131,MATH 20B,A02,083757,Briones; Jor-el Thomas Caparas,1,0,36,35
1657188424131,MATH 20B,A03,093475,Briones; Jor-el Thomas Caparas,1,0,36,35
1657188430159,MATH 20C,A01,083760,Briones; Jor-el Thomas Caparas,1,0,35,34
1657188430159,MATH 20C,A02,083761,Briones; Jor-el Thomas Caparas,8,0,35,27
1657188430159,MATH 20C,A03,093476,Briones; Jor-el Thomas Caparas,0,1,36,36
1657188430159,MATH 20C,B01,083762,Bach; Quang Tran,1,0,30,29
1657188436186,MATH 20D,A01,083765,Tran; Brian Kha,4,0,30,26
1657188436186,MATH 20D,A02,083766,Tran; Brian Kha,5,0,30,25
1657188436186,MATH 20D,A03,083767,Tran; Brian Kha,4,0,30,26
1657188442211,MATH 20E,A01,083771,Ganguly; Soumya,7,0,32,25
1657188442211,MATH 20E,A02,083772,Ganguly; Soumya,7,0,32,25
1657188442211,MATH 20E,B01,083773,Ciotti; Benjamin,19,0,35,16
1657188442211,MATH 20E,B02,083774,Ciotti; Benjamin,17,0,35,18
1657188448237,MATH 103A,A01,083777,Greenfeld; Be'Eri,2,0,36,34
1657188448237,MATH 103A,A02,083778,Greenfeld; Be'Eri,5,0,36,31
1657188448237,MATH 103A,A03,093561,Greenfeld; Be'Eri,4,0,36,32
1657188448237,MATH 103A,B01,083779,Greenfeld; Be'Eri,6,0,36,30
1657188448237,MATH 103A,B02,083780,Greenfeld; Be'Eri,3,0,36,33
1657188448237,MATH 103A,B03,093562,Greenfeld; Be'Eri,3,0,36,33
1657188454261,MATH 105,A01,085443,Carter; Anne Toulson,14,0,35,21
1657188454261,MATH 105,A02,093477,Carter; Anne Toulson,20,0,35,15
1657188460286,MATH 109,A01,083213,Ganzberger; Geoffrey Michael,2,0,34,32
1657188460286,MATH 109,A02,083214,Ganzberger; Geoffrey Michael,3,0,34,31
1657188460286,MATH 109,A03,093478,Ganzberger; Geoffrey Michael,1,0,34,33
1657188460286,MATH 109,B01,083215,Ganzberger; Geoffrey Michael,1,0,32,31
1657188460286,MATH 109,B02,083216,Ganzberger; Geoffrey Michael,1,0,32,31
1657188460286,MATH 109,B03,093479,Ganzberger; Geoffrey Michael,7,0,32,25
1657188466309,MATH 142A,A01,083219,Chow; Bennett,6,0,32,26
1657188466309,MATH 142A,A02,083220,Chow; Bennett,10,0,32,22
1657188466309,MATH 142A,A03,093480,Chow; Bennett,7,0,32,25
1657188466309,MATH 142A,B03,093481,Chow; Bennett,8,0,32,24
1657188466309,MATH 142A,B04,093558,Chow; Bennett,11,0,32,21
1657188466309,MATH 142A,B05,093559,Chow; Bennett,6,0,32,26
1657188472334,MATH 193A,A01,083224,Rotar; Vladimir,7,0,34,27
1657188472334,MATH 193A,A02,083225,Rotar; Vladimir,5,0,34,29
1657188472334,MATH 193A,A03,083781,Rotar; Vladimir,1,0,34,33
1657188472334,MATH 193A,A04,083782,Rotar; Vladimir,8,0,34,26
1657188472334,MATH 193A,A05,093482,Rotar; Vladimir,6,0,34,28
1657188478357,MATH 197,001,091859,McAuley; Julian John,9999,0,9999,0
1657188478357,MATH 197,002,095566,Kedlaya; Kiran S.,9997,0,9999,2
1657188478357,MATH 197,003,095567,Xiao; Ming,9999,0,9999,0
1657188478357,MATH 197,004,095571,Perols; Johan Lars,9998,0,9999,1
1657188485413,COGS 9,A01,083615,Shannon; Kyle Michael,7,0,75,68
1657188491434,COGS 11,A01,083617,Boyle; Mary E. T.,22,0,48,26
1657188497459,COGS 13,A01,083071,Bastos; Amalia Pinkusfeld,9,0,71,62
1657188503485,COGS 14A,A01,092681,Semenuks; Arturs,1,1,100,99
1657188509508,COGS 14B,A01,083073,Cheng; Tzu-Han,6,0,63,57
1657188515535,COGS 17,A01,092677,Semenuks; Arturs,4,0,81,77
1657188521563,COGS 100,A01,083619,Allen; Michael Gordon,15,0,70,55
1657188527590,COGS 101A,A01,083621,Davis; Joshua Daniel,9,0,68,59
1657188533614,COGS 101B,A01,091572,Allen; Michael Gordon,9,0,65,56
1657188539638,COGS 101C,A01,083625,Delgado; Tania,17,0,35,18
1657188545664,COGS 107A,A01,083627,Boyle; Mary E. T.,13,0,60,47
1657188551688,COGS 118A,A01,083075,Gupta; Anjum,16,0,76,60
1657188557713,CSE 3,A50,083646,Miranda; Gregory Joseph,24,0,50,26
1657188563741,CSE 8A,A50,083650,Miranda; Gregory Joseph,17,1,56,39
1657188569769,CSE 11,A01,083080,Cao; Yingjun,5,15,40,35
1657188575794,CSE 12,A01,083652,Krause-Levy; Sophia Louisa,24,1,120,96
1657188581823,CSE 15L,A01,083654,Morris; Justin Loren,9,0,50,41
1657188581823,CSE 15L,A02,083655,Morris; Justin Loren,9,0,50,41
1657188587849,CSE 20,A01,083657,Tran; Khoa Dang,38,0,80,42
1657188593874,CSE 21,A01,095574,Bach; Quang Tran,22,0,48,26
1657188599900,CSE 30,A01,083084,Eldon; John,4,0,80,76
1657188599900,CSE 30,B01,095061,Bhaskar; Nishant,7,0,50,43
1657188605923,CSE 100,A01,083659,Cao; Yingjun,4,4,70,66
1657188611949,CSE 134B,A01,083661,Powell; Thomas Allan,20,0,100,80
1657188617971,CSE 140,A01,083663,Gungor; Onat,13,0,85,72
1657188623997,CSE 140L,A01,083088,Eldon; John,17,0,100,83
1657188630029,CSE 175,A01,083665,Kumar; Rakesh,3,0,25,22
1657188636051,CSE 190,A00,092507,Dubnov; Shlomo,7,0,20,13
1657188642077,ECE 45,A01,083139,Congero; Spencer William,5,0,75,70
1657188648101,ECE 65,A50,083695,Saad; Andrew S,12,0,30,18
1657188648101,ECE 65,A51,095125,Saad; Andrew S,25,0,26,1
1657188654125,ECE 109,A01,091882,Touri; Behrouz,19,0,70,51
1657188660221,ECE 180,A00,083140,Abi Samra; Nicholas Camill,1,0,30,29
1657188660221,ECE 180,B00,083141,Abi Samra; Nicholas Camill,0,0,30,30
1657188666250,MATH 10A,A01,083735,Patchell; Gregory David,2,0,30,28
1657188666250,MATH 10A,A02,083736,Patchell; Gregory David,20,0,30,10
1657188666250,MATH 10A,A03,083737,Patchell; Gregory David,16,0,30,14
1657188672280,MATH 10B,A01,083207,Lim; Seonhee,7,0,34,27
1657188672280,MATH 10B,A02,083208,Lim; Seonhee,9,0,35,26
1657188672280,MATH 10B,A03,093472,Lim; Seonhee,5,0,34,29
1657188672280,MATH 10B,B01,083739,Sinha; Shubham,10,0,30,20
1657188678305,MATH 18,A01,083743,Cinel; Cameron Alexander,6,0,30,24
1657188678305,MATH 18,A02,083744,Cinel; Cameron Alexander,15,0,30,15
1657188678305,MATH 18,A03,083745,Cinel; Cameron Alexander,8,0,30,22
1657188678305,MATH 18,B01,083748,Rideout; David Porter,4,0,37,33
1657188678305,MATH 18,B02,083749,Rideout; David Porter,4,0,36,32
1657188678305,MATH 18,B03,083750,Rideout; David Porter,2,0,37,35
1657188678305,MATH 18,B04,083751,Rideout; David Porter,5,0,36,31
1657188678305,MATH 18,B05,093473,Rideout; David Porter,5,0,36,31
1657188678305,MATH 18,B06,093474,Rideout; David Porter,5,0,36,31
1657188684329,MATH 20A,A01,083754,Zheng; Zequn,13,0,40,27
1657188690358,MATH 20B,A01,083756,Briones; Jor-el Thomas Caparas,1,0,36,35
1657188690358,MATH 20B,A02,083757,Briones; Jor-el Thomas Caparas,1,0,36,35
1657188690358,MATH 20B,A03,093475,Briones; Jor-el Thomas Caparas,1,0,36,35
1657188696381,MATH 20C,A01,083760,Briones; Jor-el Thomas Caparas,1,0,35,34
1657188696381,MATH 20C,A02,083761,Briones; Jor-el Thomas Caparas,8,0,35,27
1657188696381,MATH 20C,A03,093476,Briones; Jor-el Thomas Caparas,0,1,36,36
1657188696381,MATH 20C,B01,083762,Bach; Quang Tran,1,0,30,29
1657188702404,MATH 20D,A01,083765,Tran; Brian Kha,4,0,30,26
1657188702404,MATH 20D,A02,083766,Tran; Brian Kha,5,0,30,25
1657188702404,MATH 20D,A03,083767,Tran; Brian Kha,4,0,30,26
1657188708434,MATH 20E,A01,083771,Ganguly; Soumya,7,0,32,25
1657188708434,MATH 20E,A02,083772,Ganguly; Soumya,7,0,32,25
1657188708434,MATH 20E,B01,083773,Ciotti; Benjamin,19,0,35,16
1657188708434,MATH 20E,B02,083774,Ciotti; Benjamin,17,0,35,18
1657188714459,MATH 103A,A01,083777,Greenfeld; Be'Eri,2,0,36,34
1657188714459,MATH 103A,A02,083778,Greenfeld; Be'Eri,5,0,36,31
1657188714459,MATH 103A,A03,093561,Greenfeld; Be'Eri,4,0,36,32
1657188714459,MATH 103A,B01,083779,Greenfeld; Be'Eri,6,0,36,30
1657188714459,MATH 103A,B02,083780,Greenfeld; Be'Eri,3,0,36,33
1657188714459,MATH 103A,B03,093562,Greenfeld; Be'Eri,3,0,36,33
1657188720485,MATH 105,A01,085443,Carter; Anne Toulson,14,0,35,21
1657188720485,MATH 105,A02,093477,Carter; Anne Toulson,20,0,35,15
1657188726510,MATH 109,A01,083213,Ganzberger; Geoffrey Michael,2,0,34,32
1657188726510,MATH 109,A02,083214,Ganzberger; Geoffrey Michael,3,0,34,31
1657188726510,MATH 109,A03,093478,Ganzberger; Geoffrey Michael,1,0,34,33
1657188726510,MATH 109,B01,083215,Ganzberger; Geoffrey Michael,1,0,32,31
1657188726510,MATH 109,B02,083216,Ganzberger; Geoffrey Michael,1,0,32,31
1657188726510,MATH 109,B03,093479,Ganzberger; Geoffrey Michael,7,0,32,25
1657188732538,MATH 142A,A01,083219,Chow; Bennett,6,0,32,26
1657188732538,MATH 142A,A02,083220,Chow; Bennett,10,0,32,22
1657188732538,MATH 142A,A03,093480,Chow; Bennett,7,0,32,25
1657188732538,MATH 142A,B03,093481,Chow; Bennett,8,0,32,24
1657188732538,MATH 142A,B04,093558,Chow; Bennett,11,0,32,21
1657188732538,MATH 142A,B05,093559,Chow; Bennett,6,0,32,26
1657188738562,MATH 193A,A01,083224,Rotar; Vladimir,7,0,34,27
1657188738562,MATH 193A,A02,083225,Rotar; Vladimir,5,0,34,29
1657188738562,MATH 193A,A03,083781,Rotar; Vladimir,1,0,34,33
1657188738562,MATH 193A,A04,083782,Rotar; Vladimir,8,0,34,26
1657188738562,MATH 193A,A05,093482,Rotar; Vladimir,6,0,34,28
1657188744589,MATH 197,001,091859,McAuley; Julian John,9999,0,9999,0
1657188744589,MATH 197,002,095566,Kedlaya; Kiran S.,9997,0,9999,2
1657188744589,MATH 197,003,095567,Xiao; Ming,9999,0,9999,0
1657188744589,MATH 197,004,095571,Perols; Johan Lars,9998,0,9999,1
1657188751644,COGS 9,A01,083615,Shannon; Kyle Michael,7,0,75,68
1657188757667,COGS 11,A01,083617,Boyle; Mary E. T.,22,0,48,26
1657188763694,COGS 13,A01,083071,Bastos; Amalia Pinkusfeld,9,0,71,62
1657188769720,COGS 14A,A01,092681,Semenuks; Arturs,1,1,100,99
1657188775742,COGS 14B,A01,083073,Cheng; Tzu-Han,6,0,63,57
1657188781763,COGS 17,A01,092677,Semenuks; Arturs,4,0,81,77
1657188787789,COGS 100,A01,083619,Allen; Michael Gordon,15,0,70,55
1657188793819,COGS 101A,A01,083621,Davis; Joshua Daniel,9,0,68,59
1657188799842,COGS 101B,A01,091572,Allen; Michael Gordon,9,0,65,56
1657188805864,COGS 101C,A01,083625,Delgado; Tania,17,0,35,18
1657188811891,COGS 107A,A01,083627,Boyle; Mary E. T.,13,0,60,47
1657188817914,COGS 118A,A01,083075,Gupta; Anjum,16,0,76,60
1657188823937,CSE 3,A50,083646,Miranda; Gregory Joseph,24,0,50,26
1657188829960,CSE 8A,A50,083650,Miranda; Gregory Joseph,17,1,56,39
1657188835984,CSE 11,A01,083080,Cao; Yingjun,5,15,40,35
1657188842006,CSE 12,A01,083652,Krause-Levy; Sophia Louisa,24,1,120,96
1657188848038,CSE 15L,A01,083654,Morris; Justin Loren,9,0,50,41
1657188848038,CSE 15L,A02,083655,Morris; Justin Loren,9,0,50,41
1657188854065,CSE 20,A01,083657,Tran; Khoa Dang,38,0,80,42
1657188860088,CSE 21,A01,095574,Bach; Quang Tran,22,0,48,26
1657188866116,CSE 30,A01,083084,Eldon; John,4,0,80,76
1657188866116,CSE 30,B01,095061,Bhaskar; Nishant,7,0,50,43
1657188872142,CSE 100,A01,083659,Cao; Yingjun,4,4,70,66
1657188878169,CSE 134B,A01,083661,Powell; Thomas Allan,20,0,100,80
1657188884193,CSE 140,A01,083663,Gungor; Onat,13,0,85,72
1657188890222,CSE 140L,A01,083088,Eldon; John,17,0,100,83
1657188896248,CSE 175,A01,083665,Kumar; Rakesh,3,0,25,22
1657188902274,CSE 190,A00,092507,Dubnov; Shlomo,7,0,20,13
1657188908297,ECE 45,A01,083139,Congero; Spencer William,5,0,75,70
1657188914325,ECE 65,A50,083695,Saad; Andrew S,12,0,30,18
1657188914325,ECE 65,A51,095125,Saad; Andrew S,25,0,26,1
1657188920352,ECE 109,A01,091882,Touri; Behrouz,19,0,70,51
1657188926374,ECE 180,A00,083140,Abi Samra; Nicholas Camill,1,0,30,29
1657188926374,ECE 180,B00,083141,Abi Samra; Nicholas Camill,0,0,30,30
1657188932398,MATH 10A,A01,083735,Patchell; Gregory David,2,0,30,28
1657188932398,MATH 10A,A02,083736,Patchell; Gregory David,20,0,30,10
1657188932398,MATH 10A,A03,083737,Patchell; Gregory David,16,0,30,14
1657188938421,MATH 10B,A01,083207,Lim; Seonhee,7,0,34,27
1657188938421,MATH 10B,A02,083208,Lim; Seonhee,9,0,35,26
1657188938421,MATH 10B,A03,093472,Lim; Seonhee,5,0,34,29
1657188938421,MATH 10B,B01,083739,Sinha; Shubham,10,0,30,20
1657188944451,MATH 18,A01,083743,Cinel; Cameron Alexander,6,0,30,24
1657188944451,MATH 18,A02,083744,Cinel; Cameron Alexander,15,0,30,15
1657188944451,MATH 18,A03,083745,Cinel; Cameron Alexander,8,0,30,22
1657188944451,MATH 18,B01,083748,Rideout; David Porter,4,0,37,33
1657188944451,MATH 18,B02,083749,Rideout; David Porter,4,0,36,32
1657188944451,MATH 18,B03,083750,Rideout; David Porter,2,0,37,35
1657188944451,MATH 18,B04,083751,Rideout; David Porter,5,0,36,31
1657188944451,MATH 18,B05,093473,Rideout; David Porter,5,0,36,31
1657188944451,MATH 18,B06,093474,Rideout; David Porter,5,0,36,31
1657188950474,MATH 20A,A01,083754,Zheng; Zequn,13,0,40,27
1657188956497,MATH 20B,A01,083756,Briones; Jor-el Thomas Caparas,1,0,36,35
1657188956497,MATH 20B,A02,083757,Briones; Jor-el Thomas Caparas,1,0,36,35
1657188956497,MATH 20B,A03,093475,Briones; Jor-el Thomas Caparas,1,0,36,35
1657188962529,MATH 20C,A01,083760,Briones; Jor-el Thomas Caparas,1,0,35,34
1657188962529,MATH 20C,A02,083761,Briones; Jor-el Thomas Caparas,8,0,35,27
1657188962529,MATH 20C,A03,093476,Briones; Jor-el Thomas Caparas,0,1,36,36
1657188962529,MATH 20C,B01,083762,Bach; Quang Tran,1,0,30,29
1657188968551,MATH 20D,A01,083765,Tran; Brian Kha,4,0,30,26
1657188968551,MATH 20D,A02,083766,Tran; Brian Kha,5,0,30,25
1657188968551,MATH 20D,A03,083767,Tran; Brian Kha,4,0,30,26
1657188974573,MATH 20E,A01,083771,Ganguly; Soumya,7,0,32,25
1657188974573,MATH 20E,A02,083772,Ganguly; Soumya,7,0,32,25
1657188974573,MATH 20E,B01,083773,Ciotti; Benjamin,19,0,35,16
1657188974573,MATH 20E,B02,083774,Ciotti; Benjamin,17,0,35,18
1657188980596,MATH 103A,A01,083777,Greenfeld; Be'Eri,2,0,36,34
1657188980596,MATH 103A,A02,083778,Greenfeld; Be'Eri,5,0,36,31
1657188980596,MATH 103A,A03,093561,Greenfeld; Be'Eri,4,0,36,32
1657188980596,MATH 103A,B01,083779,Greenfeld; Be'Eri,6,0,36,30
1657188980596,MATH 103A,B02,083780,Greenfeld; Be'Eri,3,0,36,33
1657188980596,MATH 103A,B03,093562,Greenfeld; Be'Eri,3,0,36,33
1657188986618,MATH 105,A01,085443,Carter; Anne Toulson,14,0,35,21
1657188986618,MATH 105,A02,093477,Carter; Anne Toulson,20,0,35,15
1657188992648,MATH 109,A01,083213,Ganzberger; Geoffrey Michael,2,0,34,32
1657188992648,MATH 109,A02,083214,Ganzberger; Geoffrey Michael,3,0,34,31
1657188992648,MATH 109,A03,093478,Ganzberger; Geoffrey Michael,1,0,34,33
1657188992648,MATH 109,B01,083215,Ganzberger; Geoffrey Michael,1,0,32,31
1657188992648,MATH 109,B02,083216,Ganzberger; Geoffrey Michael,1,0,32,31
1657188992648,MATH 109,B03,093479,Ganzberger; Geoffrey Michael,7,0,32,25
1657188998672,MATH 142A,A01,083219,Chow; Bennett,6,0,32,26
1657188998672,MATH 142A,A02,083220,Chow; Bennett,10,0,32,22
1657188998672,MATH 142A,A03,093480,Chow; Bennett,7,0,32,25
1657188998672,MATH 142A,B03,093481,Chow; Bennett,8,0,32,24
1657188998672,MATH 142A,B04,093558,Chow; Bennett,11,0,32,21
1657188998672,MATH 142A,B05,093559,Chow; Bennett,6,0,32,26
1657189004701,MATH 193A,A01,083224,Rotar; Vladimir,7,0,34,27
1657189004701,MATH 193A,A02,083225,Rotar; Vladimir,5,0,34,29
1657189004701,MATH 193A,A03,083781,Rotar; Vladimir,1,0,34,33
1657189004701,MATH 193A,A04,083782,Rotar; Vladimir,8,0,34,26
1657189004701,MATH 193A,A05,093482,Rotar; Vladimir,6,0,34,28
1657189010724,MATH 197,001,091859,McAuley; Julian John,9999,0,9999,0
1657189010724,MATH 197,002,095566,Kedlaya; Kiran S.,9997,0,9999,2
1657189010724,MATH 197,003,095567,Xiao; Ming,9999,0,9999,0
1657189010724,MATH 197,004,095571,Perols; Johan Lars,9998,0,9999,1
1657189017801,COGS 9,A01,083615,Shannon; Kyle Michael,7,0,75,68
1657189023829,COGS 11,A01,083617,Boyle; Mary E. T.,22,0,48,26
1657189029852,COGS 13,A01,083071,Bastos; Amalia Pinkusfeld,9,0,71,62
1657189035879,COGS 14A,A01,092681,Semenuks; Arturs,1,1,100,99
1657189041902,COGS 14B,A01,083073,Cheng; Tzu-Han,6,0,63,57
1657189047925,COGS 17,A01,092677,Semenuks; Arturs,4,0,81,77
1657189053958,COGS 100,A01,083619,Allen; Michael Gordon,15,0,70,55
1657189059984,COGS 101A,A01,083621,Davis; Joshua Daniel,9,0,68,59
1657189066009,COGS 101B,A01,091572,Allen; Michael Gordon,9,0,65,56
1657189072032,COGS 101C,A01,083625,Delgado; Tania,17,0,35,18
1657189078054,COGS 107A,A01,083627,Boyle; Mary E. T.,13,0,60,47
1657189084081,COGS 118A,A01,083075,Gupta; Anjum,16,0,76,60
1657189090105,CSE 3,A50,083646,Miranda; Gregory Joseph,24,0,50,26
1657189096128,CSE 8A,A50,083650,Miranda; Gregory Joseph,17,1,56,39
1657189102155,CSE 11,A01,083080,Cao; Yingjun,5,15,40,35
1657189108178,CSE 12,A01,083652,Krause-Levy; Sophia Louisa,24,1,120,96
1657189114202,CSE 15L,A01,083654,Morris; Justin Loren,9,0,50,41
1657189114202,CSE 15L,A02,083655,Morris; Justin Loren,9,0,50,41
1657189120228,CSE 20,A01,083657,Tran; Khoa Dang,38,0,80,42
1657189126252,CSE 21,A01,095574,Bach; Quang Tran,22,0,48,26
1657189132276,CSE 30,A01,083084,Eldon; John,4,0,80,76
1657189132276,CSE 30,B01,095061,Bhaskar; Nishant,7,0,50,43
1657189138299,CSE 100,A01,083659,Cao; Yingjun,4,4,70,66
1657189144322,CSE 134B,A01,083661,Powell; Thomas Allan,20,0,100,80
1657189150345,CSE 140,A01,083663,Gungor; Onat,13,0,85,72
1657189156373,CSE 140L,A01,083088,Eldon; John,17,0,100,83
1657189162397,CSE 175,A01,083665,Kumar; Rakesh,3,0,25,22
1657189168420,CSE 190,A00,092507,Dubnov; Shlomo,7,0,20,13
1657189174441,ECE 45,A01,083139,Congero; Spencer William,5,0,75,70
1657189180465,ECE 65,A50,083695,Saad; Andrew S,12,0,30,18
1657189180465,ECE 65,A51,095125,Saad; Andrew S,25,0,26,1
1657189186491,ECE 109,A01,091882,Touri; Behrouz,19,0,70,51
1657189192518,ECE 180,A00,083140,Abi Samra; Nicholas Camill,1,0,30,29
1657189192518,ECE 180,B00,083141,Abi Samra; Nicholas Camill,0,0,30,30
1657189198542,MATH 10A,A01,083735,Patchell; Gregory David,2,0,30,28
1657189198542,MATH 10A,A02,083736,Patchell; Gregory David,20,0,30,10
1657189198542,MATH 10A,A03,083737,Patchell; Gregory David,16,0,30,14
1657189204569,MATH 10B,A01,083207,Lim; Seonhee,7,0,34,27
1657189204569,MATH 10B,A02,083208,Lim; Seonhee,9,0,35,26
1657189204569,MATH 10B,A03,093472,Lim; Seonhee,5,0,34,29
1657189204569,MATH 10B,B01,083739,Sinha; Shubham,10,0,30,20
1657189210599,MATH 18,A01,083743,Cinel; Cameron Alexander,6,0,30,24
1657189210599,MATH 18,A02,083744,Cinel; Cameron Alexander,15,0,30,15
1657189210599,MATH 18,A03,083745,Cinel; Cameron Alexander,8,0,30,22
1657189210599,MATH 18,B01,083748,Rideout; David Porter,4,0,37,33
1657189210599,MATH 18,B02,083749,Rideout; David Porter,4,0,36,32
1657189210599,MATH 18,B03,083750,Rideout; David Porter,2,0,37,35
1657189210599,MATH 18,B04,083751,Rideout; David Porter,5,0,36,31
1657189210599,MATH 18,B05,093473,Rideout; David Porter,5,0,36,31
1657189210599,MATH 18,B06,093474,Rideout; David Porter,5,0,36,31
1657189216626,MATH 20A,A01,083754,Zheng; Zequn,13,0,40,27
1657189222660,MATH 20B,A01,083756,Briones; Jor-el Thomas Caparas,1,0,36,35
1657189222660,MATH 20B,A02,083757,Briones; Jor-el Thomas Caparas,1,0,36,35
1657189222660,MATH 20B,A03,093475,Briones; Jor-el Thomas Caparas,1,0,36,35
1657189228691,MATH 20C,A01,083760,Briones; Jor-el Thomas Caparas,1,0,35,34
1657189228691,MATH 20C,A02,083761,Briones; Jor-el Thomas Caparas,8,0,35,27
1657189228691,MATH 20C,A03,093476,Briones; Jor-el Thomas Caparas,0,1,36,36
1657189228691,MATH 20C,B01,083762,Bach; Quang Tran,1,0,30,29
1657189234714,MATH 20D,A01,083765,Tran; Brian Kha,4,0,30,26
1657189234714,MATH 20D,A02,083766,Tran; Brian Kha,5,0,30,25
1657189234714,MATH 20D,A03,083767,Tran; Brian Kha,4,0,30,26
1657189240742,MATH 20E,A01,083771,Ganguly; Soumya,7,0,32,25
1657189240742,MATH 20E,A02,083772,Ganguly; Soumya,7,0,32,25
1657189240742,MATH 20E,B01,083773,Ciotti; Benjamin,19,0,35,16
1657189240742,MATH 20E,B02,083774,Ciotti; Benjamin,17,0,35,18
1657189246779,MATH 103A,A01,083777,Greenfeld; Be'Eri,2,0,36,34
1657189246779,MATH 103A,A02,083778,Greenfeld; Be'Eri,5,0,36,31
1657189246779,MATH 103A,A03,093561,Greenfeld; Be'Eri,4,0,36,32
1657189246779,MATH 103A,B01,083779,Greenfeld; Be'Eri,6,0,36,30
1657189246779,MATH 103A,B02,083780,Greenfeld; Be'Eri,3,0,36,33
1657189246779,MATH 103A,B03,093562,Greenfeld; Be'Eri,3,0,36,33
1657189252808,MATH 105,A01,085443,Carter; Anne Toulson,14,0,35,21
1657189252808,MATH 105,A02,093477,Carter; Anne Toulson,20,0,35,15
1657189258906,MATH 109,A01,083213,Ganzberger; Geoffrey Michael,2,0,34,32
1657189258906,MATH 109,A02,083214,Ganzberger; Geoffrey Michael,3,0,34,31
1657189258906,MATH 109,A03,093478,Ganzberger; Geoffrey Michael,1,0,34,33
1657189258906,MATH 109,B01,083215,Ganzberger; Geoffrey Michael,1,0,32,31
1657189258906,MATH 109,B02,083216,Ganzberger; Geoffrey Michael,1,0,32,31
1657189258906,MATH 109,B03,093479,Ganzberger; Geoffrey Michael,7,0,32,25
1657189264931,MATH 142A,A01,083219,Chow; Bennett,6,0,32,26
1657189264931,MATH 142A,A02,083220,Chow; Bennett,10,0,32,22
1657189264931,MATH 142A,A03,093480,Chow; Bennett,7,0,32,25
1657189264931,MATH 142A,B03,093481,Chow; Bennett,8,0,32,24
1657189264931,MATH 142A,B04,093558,Chow; Bennett,11,0,32,21
1657189264931,MATH 142A,B05,093559,Chow; Bennett,6,0,32,26
1657189270959,MATH 193A,A01,083224,Rotar; Vladimir,7,0,34,27
1657189270959,MATH 193A,A02,083225,Rotar; Vladimir,5,0,34,29
1657189270959,MATH 193A,A03,083781,Rotar; Vladimir,1,0,34,33
1657189270959,MATH 193A,A04,083782,Rotar; Vladimir,8,0,34,26
1657189270959,MATH 193A,A05,093482,Rotar; Vladimir,6,0,34,28
1657189276985,MATH 197,001,091859,McAuley; Julian John,9999,0,9999,0
1657189276985,MATH 197,002,095566,Kedlaya; Kiran S.,9997,0,9999,2
1657189276985,MATH 197,003,095567,Xiao; Ming,9999,0,9999,0
1657189276985,MATH 197,004,095571,Perols; Johan Lars,9998,0,9999,1
1657189284045,COGS 9,A01,083615,Shannon; Kyle Michael,7,0,75,68
1657189290069,COGS 11,A01,083617,Boyle; Mary E. T.,22,0,48,26
1657189296094,COGS 13,A01,083071,Bastos; Amalia Pinkusfeld,9,0,71,62
1657189302119,COGS 14A,A01,092681,Semenuks; Arturs,1,1,100,99
1657189308147,COGS 14B,A01,083073,Cheng; Tzu-Han,6,0,63,57
1657189314175,COGS 17,A01,092677,Semenuks; Arturs,4,0,81,77
1657189320201,COGS 100,A01,083619,Allen; Michael Gordon,15,0,70,55
1657189326237,COGS 101A,A01,083621,Davis; Joshua Daniel,9,0,68,59
1657189332265,COGS 101B,A01,091572,Allen; Michael Gordon,9,0,65,56
1657189338298,COGS 101C,A01,083625,Delgado; Tania,17,0,35,18
1657189344325,COGS 107A,A01,083627,Boyle; Mary E. T.,13,0,60,47
1657189350348,COGS 118A,A01,083075,Gupta; Anjum,16,0,76,60
1657189356376,CSE 3,A50,083646,Miranda; Gregory Joseph,24,0,50,26
1657189362399,CSE 8A,A50,083650,Miranda; Gregory Joseph,17,1,56,39
1657189368426,CSE 11,A01,083080,Cao; Yingjun,5,15,40,35
1657189374452,CSE 12,A01,083652,Krause-Levy; Sophia Louisa,24,1,120,96
1657189380478,CSE 15L,A01,083654,Morris; Justin Loren,9,0,50,41
1657189380478,CSE 15L,A02,083655,Morris; Justin Loren,9,0,50,41
1657189386506,CSE 20,A01,083657,Tran; Khoa Dang,38,0,80,42
1657189392532,CSE 21,A01,095574,Bach; Quang Tran,22,0,48,26
1657189398554,CSE 30,A01,083084,Eldon; John,4,0,80,76
1657189398554,CSE 30,B01,095061,Bhaskar; Nishant,7,0,50,43
1657189404576,CSE 100,A01,083659,Cao; Yingjun,4,4,70,66
1657189410600,CSE 134B,A01,083661,Powell; Thomas Allan,20,0,100,80
1657189416623,CSE 140,A01,083663,Gungor; Onat,13,0,85,72
1657189422648,CSE 140L,A01,083088,Eldon; John,17,0,100,83
1657189428669,CSE 175,A01,083665,Kumar; Rakesh,3,0,25,22
1657189434693,CSE 190,A00,092507,Dubnov; Shlomo,7,0,20,13
1657189440721,ECE 45,A01,083139,Congero; Spencer William,5,0,75,70
1657189446744,ECE 65,A50,083695,Saad; Andrew S,12,0,30,18
1657189446744,ECE 65,A51,095125,Saad; Andrew S,25,0,26,1
1657189452771,ECE 109,A01,091882,Touri; Behrouz,19,0,70,51
1657189458795,ECE 180,A00,083140,Abi Samra; Nicholas Camill,1,0,30,29
1657189458795,ECE 180,B00,083141,Abi Samra; Nicholas Camill,0,0,30,30
1657189464818,MATH 10A,A01,083735,Patchell; Gregory David,2,0,30,28
1657189464818,MATH 10A,A02,083736,Patchell; Gregory David,20,0,30,10
1657189464818,MATH 10A,A03,083737,Patchell; Gregory David,16,0,30,14
1657189470843,MATH 10B,A01,083207,Lim; Seonhee,7,0,34,27
1657189470843,MATH 10B,A02,083208,Lim; Seonhee,9,0,35,26
1657189470843,MATH 10B,A03,093472,Lim; Seonhee,5,0,34,29
1657189470843,MATH 10B,B01,083739,Sinha; Shubham,10,0,30,20
1657189476868,MATH 18,A01,083743,Cinel; Cameron Alexander,6,0,30,24
1657189476868,MATH 18,A02,083744,Cinel; Cameron Alexander,15,0,30,15
1657189476868,MATH 18,A03,083745,Cinel; Cameron Alexander,8,0,30,22
1657189476868,MATH 18,B01,083748,Rideout; David Porter,4,0,37,33
1657189476868,MATH 18,B02,083749,Rideout; David Porter,4,0,36,32
1657189476868,MATH 18,B03,083750,Rideout; David Porter,2,0,37,35
1657189476868,MATH 18,B04,083751,Rideout; David Porter,5,0,36,31
1657189476868,MATH 18,B05,093473,Rideout; David Porter,5,0,36,31
1657189476868,MATH 18,B06,093474,Rideout; David Porter,5,0,36,31
1657189482893,MATH 20A,A01,083754,Zheng; Zequn,13,0,40,27
1657189488917,MATH 20B,A01,083756,Briones; Jor-el Thomas Caparas,1,0,36,35
1657189488917,MATH 20B,A02,083757,Briones; Jor-el Thomas Caparas,1,0,36,35
1657189488917,MATH 20B,A03,093475,Briones; Jor-el Thomas Caparas,1,0,36,35
1657189494941,MATH 20C,A01,083760,Briones; Jor-el Thomas Caparas,1,0,35,34
1657189494941,MATH 20C,A02,083761,Briones; Jor-el Thomas Caparas,8,0,35,27
1657189494941,MATH 20C,A03,093476,Briones; Jor-el Thomas Caparas,0,1,36,36
1657189494941,MATH 20C,B01,083762,Bach; Quang Tran,1,0,30,29
1657189500969,MATH 20D,A01,083765,Tran; Brian Kha,4,0,30,26
1657189500969,MATH 20D,A02,083766,Tran; Brian Kha,5,0,30,25
1657189500969,MATH 20D,A03,083767,Tran; Brian Kha,4,0,30,26
1657189506991,MATH 20E,A01,083771,Ganguly; Soumya,7,0,32,25
1657189506991,MATH 20E,A02,083772,Ganguly; Soumya,7,0,32,25
1657189506991,MATH 20E,B01,083773,Ciotti; Benjamin,19,0,35,16
1657189506991,MATH 20E,B02,083774,Ciotti; Benjamin,17,0,35,18
1657189513016,MATH 103A,A01,083777,Greenfeld; Be'Eri,2,0,36,34
1657189513016,MATH 103A,A02,083778,Greenfeld; Be'Eri,5,0,36,31
1657189513016,MATH 103A,A03,093561,Greenfeld; Be'Eri,4,0,36,32
1657189513016,MATH 103A,B01,083779,Greenfeld; Be'Eri,6,0,36,30
1657189513016,MATH 103A,B02,083780,Greenfeld; Be'Eri,3,0,36,33
1657189513016,MATH 103A,B03,093562,Greenfeld; Be'Eri,3,0,36,33
1657189519040,MATH 105,A01,085443,Carter; Anne Toulson,14,0,35,21
1657189519040,MATH 105,A02,093477,Carter; Anne Toulson,20,0,35,15
1657189525070,MATH 109,A01,083213,Ganzberger; Geoffrey Michael,2,0,34,32
1657189525070,MATH 109,A02,083214,Ganzberger; Geoffrey Michael,3,0,34,31
1657189525070,MATH 109,A03,093478,Ganzberger; Geoffrey Michael,1,0,34,33
1657189525070,MATH 109,B01,083215,Ganzberger; Geoffrey Michael,1,0,32,31
1657189525070,MATH 109,B02,083216,Ganzberger; Geoffrey Michael,1,0,32,31
1657189525070,MATH 109,B03,093479,Ganzberger; Geoffrey Michael,7,0,32,25
1657189531095,MATH 142A,A01,083219,Chow; Bennett,6,0,32,26
1657189531095,MATH 142A,A02,083220,Chow; Bennett,10,0,32,22
1657189531095,MATH 142A,A03,093480,Chow; Bennett,7,0,32,25
1657189531095,MATH 142A,B03,093481,Chow; Bennett,8,0,32,24
1657189531095,MATH 142A,B04,093558,Chow; Bennett,11,0,32,21
1657189531095,MATH 142A,B05,093559,Chow; Bennett,6,0,32,26
1657189537120,MATH 193A,A01,083224,Rotar; Vladimir,7,0,34,27
1657189537120,MATH 193A,A02,083225,Rotar; Vladimir,5,0,34,29
1657189537120,MATH 193A,A03,083781,Rotar; Vladimir,1,0,34,33
1657189537120,MATH 193A,A04,083782,Rotar; Vladimir,8,0,34,26
1657189537120,MATH 193A,A05,093482,Rotar; Vladimir,6,0,34,28
1657189543145,MATH 197,001,091859,McAuley; Julian John,9999,0,9999,0
1657189543145,MATH 197,002,095566,Kedlaya; Kiran S.,9997,0,9999,2
1657189543145,MATH 197,003,095567,Xiao; Ming,9999,0,9999,0
1657189543145,MATH 197,004,095571,Perols; Johan Lars,9998,0,9999,1
1657189550208,COGS 9,A01,083615,Shannon; Kyle Michael,7,0,75,68
1657189556232,COGS 11,A01,083617,Boyle; Mary E. T.,22,0,48,26
1657189562254,COGS 13,A01,083071,Bastos; Amalia Pinkusfeld,9,0,71,62
1657189568282,COGS 14A,A01,092681,Semenuks; Arturs,1,1,100,99
1657189574304,COGS 14B,A01,083073,Cheng; Tzu-Han,6,0,63,57
1657189580327,COGS 17,A01,092677,Semenuks; Arturs,4,0,81,77
1657189586351,COGS 100,A01,083619,Allen; Michael Gordon,15,0,70,55
1657189592377,COGS 101A,A01,083621,Davis; Joshua Daniel,9,0,68,59
1657189598405,COGS 101B,A01,091572,Allen; Michael Gordon,9,0,65,56
1657189604431,COGS 101C,A01,083625,Delgado; Tania,17,0,35,18
1657189610456,COGS 107A,A01,083627,Boyle; Mary E. T.,13,0,60,47
1657189616482,COGS 118A,A01,083075,Gupta; Anjum,16,0,76,60
1657189622514,CSE 3,A50,083646,Miranda; Gregory Joseph,24,0,50,26
1657189628543,CSE 8A,A50,083650,Miranda; Gregory Joseph,17,1,56,39
1657189634565,CSE 11,A01,083080,Cao; Yingjun,5,15,40,35
1657189640600,CSE 12,A01,083652,Krause-Levy; Sophia Louisa,24,1,120,96
1657189646635,CSE 15L,A01,083654,Morris; Justin Loren,9,0,50,41
1657189646635,CSE 15L,A02,083655,Morris; Justin Loren,9,0,50,41
1657189652663,CSE 20,A01,083657,Tran; Khoa Dang,38,0,80,42
1657189658696,CSE 21,A01,095574,Bach; Quang Tran,22,0,48,26
1657189664720,CSE 30,A01,083084,Eldon; John,4,0,80,76
1657189664720,CSE 30,B01,095061,Bhaskar; Nishant,7,0,50,43
1657189670746,CSE 100,A01,083659,Cao; Yingjun,4,4,70,66
1657189676770,CSE 134B,A01,083661,Powell; Thomas Allan,20,0,100,80
1657189682796,CSE 140,A01,083663,Gungor; Onat,13,0,85,72
1657189688822,CSE 140L,A01,083088,Eldon; John,17,0,100,83
1657189694848,CSE 175,A01,083665,Kumar; Rakesh,3,0,25,22
1657189700871,CSE 190,A00,092507,Dubnov; Shlomo,7,0,20,13
1657189706894,ECE 45,A01,083139,Congero; Spencer William,5,0,75,70
1657189712921,ECE 65,A50,083695,Saad; Andrew S,12,0,30,18
1657189712921,ECE 65,A51,095125,Saad; Andrew S,25,0,26,1
1657189718944,ECE 109,A01,091882,Touri; Behrouz,19,0,70,51
1657189724966,ECE 180,A00,083140,Abi Samra; Nicholas Camill,1,0,30,29
1657189724966,ECE 180,B00,083141,Abi Samra; Nicholas Camill,0,0,30,30
1657189730990,MATH 10A,A01,083735,Patchell; Gregory David,2,0,30,28
1657189730990,MATH 10A,A02,083736,Patchell; Gregory David,20,0,30,10
1657189730990,MATH 10A,A03,083737,Patchell; Gregory David,16,0,30,14
1657189737018,MATH 10B,A01,083207,Lim; Seonhee,7,0,34,27
1657189737018,MATH 10B,A02,083208,Lim; Seonhee,9,0,35,26
1657189737018,MATH 10B,A03,093472,Lim; Seonhee,5,0,34,29
1657189737018,MATH 10B,B01,083739,Sinha; Shubham,10,0,30,20
1657189743044,MATH 18,A01,083743,Cinel; Cameron Alexander,6,0,30,24
1657189743044,MATH 18,A02,083744,Cinel; Cameron Alexander,15,0,30,15
1657189743044,MATH 18,A03,083745,Cinel; Cameron Alexander,8,0,30,22
1657189743044,MATH 18,B01,083748,Rideout; David Porter,4,0,37,33
1657189743044,MATH 18,B02,083749,Rideout; David Porter,4,0,36,32
1657189743044,MATH 18,B03,083750,Rideout; David Porter,2,0,37,35
1657189743044,MATH 18,B04,083751,Rideout; David Porter,5,0,36,31
1657189743044,MATH 18,B05,093473,Rideout; David Porter,5,0,36,31
1657189743044,MATH 18,B06,093474,Rideout; David Porter,5,0,36,31
1657189749070,MATH 20A,A01,083754,Zheng; Zequn,13,0,40,27
1657189755091,MATH 20B,A01,083756,Briones; Jor-el Thomas Caparas,1,0,36,35
1657189755091,MATH 20B,A02,083757,Briones; Jor-el Thomas Caparas,1,0,36,35
1657189755091,MATH 20B,A03,093475,Briones; Jor-el Thomas Caparas,1,0,36,35
1657189761115,MATH 20C,A01,083760,Briones; Jor-el Thomas Caparas,1,0,35,34
1657189761115,MATH 20C,A02,083761,Briones; Jor-el Thomas Caparas,8,0,35,27
1657189761115,MATH 20C,A03,093476,Briones; Jor-el Thomas Caparas,0,1,36,36
1657189761115,MATH 20C,B01,083762,Bach; Quang Tran,1,0,30,29
1657189767138,MATH 20D,A01,083765,Tran; Brian Kha,4,0,30,26
1657189767138,MATH 20D,A02,083766,Tran; Brian Kha,5,0,30,25
1657189767138,MATH 20D,A03,083767,Tran; Brian Kha,4,0,30,26
1657189773162,MATH 20E,A01,083771,Ganguly; Soumya,7,0,32,25
1657189773162,MATH 20E,A02,083772,Ganguly; Soumya,7,0,32,25
1657189773162,MATH 20E,B01,083773,Ciotti; Benjamin,19,0,35,16
1657189773162,MATH 20E,B02,083774,Ciotti; Benjamin,17,0,35,18
1657189779192,MATH 103A,A01,083777,Greenfeld; Be'Eri,2,0,36,34
1657189779192,MATH 103A,A02,083778,Greenfeld; Be'Eri,5,0,36,31
1657189779192,MATH 103A,A03,093561,Greenfeld; Be'Eri,4,0,36,32
1657189779192,MATH 103A,B01,083779,Greenfeld; Be'Eri,6,0,36,30
1657189779192,MATH 103A,B02,083780,Greenfeld; Be'Eri,3,0,36,33
1657189779192,MATH 103A,B03,093562,Greenfeld; Be'Eri,3,0,36,33
1657189785216,MATH 105,A01,085443,Carter; Anne Toulson,14,0,35,21
1657189785216,MATH 105,A02,093477,Carter; Anne Toulson,20,0,35,15
1657189791240,MATH 109,A01,083213,Ganzberger; Geoffrey Michael,2,0,34,32
1657189791240,MATH 109,A02,083214,Ganzberger; Geoffrey Michael,3,0,34,31
1657189791240,MATH 109,A03,093478,Ganzberger; Geoffrey Michael,1,0,34,33
1657189791240,MATH 109,B01,083215,Ganzberger; Geoffrey Michael,1,0,32,31
1657189791240,MATH 109,B02,083216,Ganzberger; Geoffrey Michael,1,0,32,31
1657189791240,MATH 109,B03,093479,Ganzberger; Geoffrey Michael,7,0,32,25
1657189797268,MATH 142A,A01,083219,Chow; Bennett,6,0,32,26
1657189797268,MATH 142A,A02,083220,Chow; Bennett,10,0,32,22
1657189797268,MATH 142A,A03,093480,Chow; Bennett,7,0,32,25
1657189797268,MATH 142A,B03,093481,Chow; Bennett,8,0,32,24
1657189797268,MATH 142A,B04,093558,Chow; Bennett,11,0,32,21
1657189797268,MATH 142A,B05,093559,Chow; Bennett,6,0,32,26
1657189803292,MATH 193A,A01,083224,Rotar; Vladimir,7,0,34,27
1657189803292,MATH 193A,A02,083225,Rotar; Vladimir,5,0,34,29
1657189803292,MATH 193A,A03,083781,Rotar; Vladimir,1,0,34,33
1657189803292,MATH 193A,A04,083782,Rotar; Vladimir,8,0,34,26
1657189803292,MATH 193A,A05,093482,Rotar; Vladimir,6,0,34,28
1657189809317,MATH 197,001,091859,McAuley; Julian John,9999,0,9999,0
1657189809317,MATH 197,002,095566,Kedlaya; Kiran S.,9997,0,9999,2
1657189809317,MATH 197,003,095567,Xiao; Ming,9999,0,9999,0
1657189809317,MATH 197,004,095571,Perols; Johan Lars,9998,0,9999,1
1657189816367,COGS 9,A01,083615,Shannon; Kyle Michael,7,0,75,68
1657189822398,COGS 11,A01,083617,Boyle; Mary E. T.,22,0,48,26
1657189828420,COGS 13,A01,083071,Bastos; Amalia Pinkusfeld,9,0,71,62
1657189834445,COGS 14A,A01,092681,Semenuks; Arturs,1,1,100,99
1657189840469,COGS 14B,A01,083073,Cheng; Tzu-Han,6,0,63,57
1657189846495,COGS 17,A01,092677,Semenuks; Arturs,4,0,81,77
1657189852590,COGS 100,A01,083619,Allen; Michael Gordon,15,0,70,55
1657189858615,COGS 101A,A01,083621,Davis; Joshua Daniel,9,0,68,59
1657189864641,COGS 101B,A01,091572,Allen; Michael Gordon,9,0,65,56
1657189870664,COGS 101C,A01,083625,Delgado; Tania,17,0,35,18
1657189876689,COGS 107A,A01,083627,Boyle; Mary E. T.,13,0,60,47
1657189882712,COGS 118A,A01,083075,Gupta; Anjum,16,0,76,60
1657189888741,CSE 3,A50,083646,Miranda; Gregory Joseph,24,0,50,26
1657189894762,CSE 8A,A50,083650,Miranda; Gregory Joseph,17,1,56,39
1657189900786,CSE 11,A01,083080,Cao; Yingjun,5,15,40,35
1657189906809,CSE 12,A01,083652,Krause-Levy; Sophia Louisa,24,1,120,96
1657189912837,CSE 15L,A01,083654,Morris; Justin Loren,9,0,50,41
1657189912837,CSE 15L,A02,083655,Morris; Justin Loren,9,0,50,41
1657189918860,CSE 20,A01,083657,Tran; Khoa Dang,38,0,80,42
1657189924885,CSE 21,A01,095574,Bach; Quang Tran,22,0,48,26
1657189930909,CSE 30,A01,083084,Eldon; John,4,0,80,76
1657189930909,CSE 30,B01,095061,Bhaskar; Nishant,7,0,50,43
1657189936931,CSE 100,A01,083659,Cao; Yingjun,4,4,70,66
1657189942958,CSE 134B,A01,083661,Powell; Thomas Allan,20,0,100,80
1657189948981,CSE 140,A01,083663,Gungor; Onat,13,0,85,72
1657189955008,CSE 140L,A01,083088,Eldon; John,17,0,100,83
1657189961031,CSE 175,A01,083665,Kumar; Rakesh,3,0,25,22
1657189967056,CSE 190,A00,092507,Dubnov; Shlomo,7,0,20,13
1657189973084,ECE 45,A01,083139,Congero; Spencer William,5,0,75,70
1657189979113,ECE 65,A50,083695,Saad; Andrew S,12,0,30,18
1657189979113,ECE 65,A51,095125,Saad; Andrew S,25,0,26,1
1657189985138,ECE 109,A01,091882,Touri; Behrouz,19,0,70,51
1657189991162,ECE 180,A00,083140,Abi Samra; Nicholas Camill,1,0,30,29
1657189991162,ECE 180,B00,083141,Abi Samra; Nicholas Camill,0,0,30,30
1657189997185,MATH 10A,A01,083735,Patchell; Gregory David,2,0,30,28
1657189997185,MATH 10A,A02,083736,Patchell; Gregory David,20,0,30,10
1657189997185,MATH 10A,A03,083737,Patchell; Gregory David,16,0,30,14
1657190003207,MATH 10B,A01,083207,Lim; Seonhee,7,0,34,27
1657190003207,MATH 10B,A02,083208,Lim; Seonhee,9,0,35,26
1657190003207,MATH 10B,A03,093472,Lim; Seonhee,5,0,34,29
1657190003207,MATH 10B,B01,083739,Sinha; Shubham,10,0,30,20
1657190009240,MATH 18,A01,083743,Cinel; Cameron Alexander,6,0,30,24
1657190009240,MATH 18,A02,083744,Cinel; Cameron Alexander,15,0,30,15
1657190009240,MATH 18,A03,083745,Cinel; Cameron Alexander,8,0,30,22
1657190009240,MATH 18,B01,083748,Rideout; David Porter,4,0,37,33
1657190009240,MATH 18,B02,083749,Rideout; David Porter,4,0,36,32
1657190009240,MATH 18,B03,083750,Rideout; David Porter,2,0,37,35
1657190009240,MATH 18,B04,083751,Rideout; David Porter,5,0,36,31
1657190009240,MATH 18,B05,093473,Rideout; David Porter,5,0,36,31
1657190009240,MATH 18,B06,093474,Rideout; David Porter,5,0,36,31
1657190015263,MATH 20A,A01,083754,Zheng; Zequn,13,0,40,27
1657190021287,MATH 20B,A01,083756,Briones; Jor-el Thomas Caparas,1,0,36,35
1657190021287,MATH 20B,A02,083757,Briones; Jor-el Thomas Caparas,1,0,36,35
1657190021287,MATH 20B,A03,093475,Briones; Jor-el Thomas Caparas,1,0,36,35
1657190027315,MATH 20C,A01,083760,Briones; Jor-el Thomas Caparas,1,0,35,34
1657190027315,MATH 20C,A02,083761,Briones; Jor-el Thomas Caparas,8,0,35,27
1657190027315,MATH 20C,A03,093476,Briones; Jor-el Thomas Caparas,0,1,36,36
1657190027315,MATH 20C,B01,083762,Bach; Quang Tran,1,0,30,29
1657190033339,MATH 20D,A01,083765,Tran; Brian Kha,4,0,30,26
1657190033339,MATH 20D,A02,083766,Tran; Brian Kha,5,0,30,25
1657190033339,MATH 20D,A03,083767,Tran; Brian Kha,4,0,30,26
1657190039363,MATH 20E,A01,083771,Ganguly; Soumya,7,0,32,25
1657190039363,MATH 20E,A02,083772,Ganguly; Soumya,7,0,32,25
1657190039363,MATH 20E,B01,083773,Ciotti; Benjamin,19,0,35,16
1657190039363,MATH 20E,B02,083774,Ciotti; Benjamin,17,0,35,18
1657190045388,MATH 103A,A01,083777,Greenfeld; Be'Eri,2,0,36,34
1657190045388,MATH 103A,A02,083778,Greenfeld; Be'Eri,5,0,36,31
1657190045388,MATH 103A,A03,093561,Greenfeld; Be'Eri,4,0,36,32
1657190045388,MATH 103A,B01,083779,Greenfeld; Be'Eri,6,0,36,30
1657190045388,MATH 103A,B02,083780,Greenfeld; Be'Eri,3,0,36,33
1657190045388,MATH 103A,B03,093562,Greenfeld; Be'Eri,3,0,36,33
1657190051414,MATH 105,A01,085443,Carter; Anne Toulson,14,0,35,21
1657190051414,MATH 105,A02,093477,Carter; Anne Toulson,20,0,35,15
1657190057436,MATH 109,A01,083213,Ganzberger; Geoffrey Michael,2,0,34,32
1657190057436,MATH 109,A02,083214,Ganzberger; Geoffrey Michael,3,0,34,31
1657190057436,MATH 109,A03,093478,Ganzberger; Geoffrey Michael,1,0,34,33
1657190057436,MATH 109,B01,083215,Ganzberger; Geoffrey Michael,1,0,32,31
1657190057436,MATH 109,B02,083216,Ganzberger; Geoffrey Michael,1,0,32,31
1657190057436,MATH 109,B03,093479,Ganzberger; Geoffrey Michael,7,0,32,25
1657190063464,MATH 142A,A01,083219,Chow; Bennett,6,0,32,26
1657190063464,MATH 142A,A02,083220,Chow; Bennett,10,0,32,22
1657190063464,MATH 142A,A03,093480,Chow; Bennett,7,0,32,25
1657190063464,MATH 142A,B03,093481,Chow; Bennett,8,0,32,24
1657190063464,MATH 142A,B04,093558,Chow; Bennett,11,0,32,21
1657190063464,MATH 142A,B05,093559,Chow; Bennett,6,0,32,26
1657190069489,MATH 193A,A01,083224,Rotar; Vladimir,7,0,34,27
1657190069489,MATH 193A,A02,083225,Rotar; Vladimir,5,0,34,29
1657190069489,MATH 193A,A03,083781,Rotar; Vladimir,1,0,34,33
1657190069489,MATH 193A,A04,083782,Rotar; Vladimir,8,0,34,26
1657190069489,MATH 193A,A05,093482,Rotar; Vladimir,6,0,34,28
1657190075511,MATH 197,001,091859,McAuley; Julian John,9999,0,9999,0
1657190075511,MATH 197,002,095566,Kedlaya; Kiran S.,9997,0,9999,2
1657190075511,MATH 197,003,095567,Xiao; Ming,9999,0,9999,0
1657190075511,MATH 197,004,095571,Perols; Johan Lars,9998,0,9999,1
1657190082578,COGS 9,A01,083615,Shannon; Kyle Michael,7,0,75,68
1657190088602,COGS 11,A01,083617,Boyle; Mary E. T.,22,0,48,26
1657190094636,COGS 13,A01,083071,Bastos; Amalia Pinkusfeld,9,0,71,62
1657190100659,COGS 14A,A01,092681,Semenuks; Arturs,1,1,100,99
1657190106681,COGS 14B,A01,083073,Cheng; Tzu-Han,6,0,63,57
1657190112704,COGS 17,A01,092677,Semenuks; Arturs,4,0,81,77
1657190118730,COGS 100,A01,083619,Allen; Michael Gordon,15,0,70,55
1657190124753,COGS 101A,A01,083621,Davis; Joshua Daniel,9,0,68,59
1657190130779,COGS 101B,A01,091572,Allen; Michael Gordon,9,0,65,56
1657190136802,COGS 101C,A01,083625,Delgado; Tania,17,0,35,18
1657190142828,COGS 107A,A01,083627,Boyle; Mary E. T.,13,0,60,47
1657190148857,COGS 118A,A01,083075,Gupta; Anjum,16,0,76,60
1657190154886,CSE 3,A50,083646,Miranda; Gregory Joseph,24,0,50,26
1657190160913,CSE 8A,A50,083650,Miranda; Gregory Joseph,17,1,56,39
1657190166945,CSE 11,A01,083080,Cao; Yingjun,5,15,40,35
1657190172973,CSE 12,A01,083652,Krause-Levy; Sophia Louisa,24,1,120,96
1657190179004,CSE 15L,A01,083654,Morris; Justin Loren,9,0,50,41
1657190179004,CSE 15L,A02,083655,Morris; Justin Loren,9,0,50,41
1657190185027,CSE 20,A01,083657,Tran; Khoa Dang,38,0,80,42
1657190191050,CSE 21,A01,095574,Bach; Quang Tran,22,0,48,26
1657190197077,CSE 30,A01,083084,Eldon; John,4,0,80,76
1657190197077,CSE 30,B01,095061,Bhaskar; Nishant,7,0,50,43
1657190203103,CSE 100,A01,083659,Cao; Yingjun,4,4,70,66
1657190209127,CSE 134B,A01,083661,Powell; Thomas Allan,20,0,100,80
1657190215151,CSE 140,A01,083663,Gungor; Onat,13,0,85,72
1657190221198,CSE 140L,A01,083088,Eldon; John,17,0,100,83
1657190227226,CSE 175,A01,083665,Kumar; Rakesh,3,0,25,22
1657190233264,CSE 190,A00,092507,Dubnov; Shlomo,7,0,20,13
1657190239285,ECE 45,A01,083139,Congero; Spencer William,5,0,75,70
1657190245312,ECE 65,A50,083695,Saad; Andrew S,12,0,30,18
1657190245312,ECE 65,A51,095125,Saad; Andrew S,25,0,26,1
1657190251338,ECE 109,A01,091882,Touri; Behrouz,19,0,70,51
1657190257365,ECE 180,A00,083140,Abi Samra; Nicholas Camill,1,0,30,29
1657190257365,ECE 180,B00,083141,Abi Samra; Nicholas Camill,0,0,30,30
1657190263387,MATH 10A,A01,083735,Patchell; Gregory David,2,0,30,28
1657190263387,MATH 10A,A02,083736,Patchell; Gregory David,20,0,30,10
1657190263387,MATH 10A,A03,083737,Patchell; Gregory David,16,0,30,14
1657190269411,MATH 10B,A01,083207,Lim; Seonhee,7,0,34,27
1657190269411,MATH 10B,A02,083208,Lim; Seonhee,9,0,35,26
1657190269411,MATH 10B,A03,093472,Lim; Seonhee,5,0,34,29
1657190269411,MATH 10B,B01,083739,Sinha; Shubham,10,0,30,20
1657190275437,MATH 18,A01,083743,Cinel; Cameron Alexander,6,0,30,24
1657190275437,MATH 18,A02,083744,Cinel; Cameron Alexander,15,0,30,15
1657190275437,MATH 18,A03,083745,Cinel; Cameron Alexander,8,0,30,22
1657190275437,MATH 18,B01,083748,Rideout; David Porter,4,0,37,33
1657190275437,MATH 18,B02,083749,Rideout; David Porter,4,0,36,32
1657190275437,MATH 18,B03,083750,Rideout; David Porter,2,0,37,35
1657190275437,MATH 18,B04,083751,Rideout; David Porter,5,0,36,31
1657190275437,MATH 18,B05,093473,Rideout; David Porter,5,0,36,31
1657190275437,MATH 18,B06,093474,Rideout; David Porter,5,0,36,31
1657190281460,MATH 20A,A01,083754,Zheng; Zequn,13,0,40,27
1657190287481,MATH 20B,A01,083756,Briones; Jor-el Thomas Caparas,1,0,36,35
1657190287481,MATH 20B,A02,083757,Briones; Jor-el Thomas Caparas,1,0,36,35
1657190287481,MATH 20B,A03,093475,Briones; Jor-el Thomas Caparas,1,0,36,35
1657190293509,MATH 20C,A01,083760,Briones; Jor-el Thomas Caparas,1,0,35,34
1657190293509,MATH 20C,A02,083761,Briones; Jor-el Thomas Caparas,8,0,35,27
1657190293509,MATH 20C,A03,093476,Briones; Jor-el Thomas Caparas,0,1,36,36
1657190293509,MATH 20C,B01,083762,Bach; Quang Tran,1,0,30,29
1657190299536,MATH 20D,A01,083765,Tran; Brian Kha,4,0,30,26
1657190299536,MATH 20D,A02,083766,Tran; Brian Kha,5,0,30,25
1657190299536,MATH 20D,A03,083767,Tran; Brian Kha,4,0,30,26
1657190305559,MATH 20E,A01,083771,Ganguly; Soumya,7,0,32,25
1657190305559,MATH 20E,A02,083772,Ganguly; Soumya,7,0,32,25
1657190305559,MATH 20E,B01,083773,Ciotti; Benjamin,19,0,35,16
1657190305559,MATH 20E,B02,083774,Ciotti; Benjamin,17,0,35,18
1657190311583,MATH 103A,A01,083777,Greenfeld; Be'Eri,2,0,36,34
1657190311583,MATH 103A,A02,083778,Greenfeld; Be'Eri,5,0,36,31
1657190311583,MATH 103A,A03,093561,Greenfeld; Be'Eri,4,0,36,32
1657190311583,MATH 103A,B01,083779,Greenfeld; Be'Eri,6,0,36,30
1657190311583,MATH 103A,B02,083780,Greenfeld; Be'Eri,3,0,36,33
1657190311583,MATH 103A,B03,093562,Greenfeld; Be'Eri,3,0,36,33
1657190317605,MATH 105,A01,085443,Carter; Anne Toulson,14,0,35,21
1657190317605,MATH 105,A02,093477,Carter; Anne Toulson,20,0,35,15
1657190323633,MATH 109,A01,083213,Ganzberger; Geoffrey Michael,2,0,34,32
1657190323633,MATH 109,A02,083214,Ganzberger; Geoffrey Michael,3,0,34,31
1657190323633,MATH 109,A03,093478,Ganzberger; Geoffrey Michael,1,0,34,33
1657190323633,MATH 109,B01,083215,Ganzberger; Geoffrey Michael,1,0,32,31
1657190323633,MATH 109,B02,083216,Ganzberger; Geoffrey Michael,1,0,32,31
1657190323633,MATH 109,B03,093479,Ganzberger; Geoffrey Michael,7,0,32,25
1657190329661,MATH 142A,A01,083219,Chow; Bennett,6,0,32,26
1657190329661,MATH 142A,A02,083220,Chow; Bennett,10,0,32,22
1657190329661,MATH 142A,A03,093480,Chow; Bennett,7,0,32,25
1657190329661,MATH 142A,B03,093481,Chow; Bennett,8,0,32,24
1657190329661,MATH 142A,B04,093558,Chow; Bennett,11,0,32,21
1657190329661,MATH 142A,B05,093559,Chow; Bennett,6,0,32,26
1657190335689,MATH 193A,A01,083224,Rotar; Vladimir,7,0,34,27
1657190335689,MATH 193A,A02,083225,Rotar; Vladimir,5,0,34,29
1657190335689,MATH 193A,A03,083781,Rotar; Vladimir,1,0,34,33
1657190335689,MATH 193A,A04,083782,Rotar; Vladimir,8,0,34,26
1657190335689,MATH 193A,A05,093482,Rotar; Vladimir,6,0,34,28
1657190341716,MATH 197,001,091859,McAuley; Julian John,9999,0,9999,0
1657190341716,MATH 197,002,095566,Kedlaya; Kiran S.,9997,0,9999,2
1657190341716,MATH 197,003,095567,Xiao; Ming,9999,0,9999,0
1657190341716,MATH 197,004,095571,Perols; Johan Lars,9998,0,9999,1
1657190348782,COGS 9,A01,083615,Shannon; Kyle Michael,7,0,75,68
1657190354805,COGS 11,A01,083617,Boyle; Mary E. T.,22,0,48,26
1657190360828,COGS 13,A01,083071,Bastos; Amalia Pinkusfeld,9,0,71,62
1657190366852,COGS 14A,A01,092681,Semenuks; Arturs,1,1,100,99
1657190372885,COGS 14B,A01,083073,Cheng; Tzu-Han,6,0,63,57
1657190378911,COGS 17,A01,092677,Semenuks; Arturs,4,0,81,77
1657190384935,COGS 100,A01,083619,Allen; Michael Gordon,15,0,70,55
1657190390990,COGS 101A,A01,083621,Davis; Joshua Daniel,9,0,68,59
1657190397013,COGS 101B,A01,091572,Allen; Michael Gordon,9,0,65,56
1657190403047,COGS 101C,A01,083625,Delgado; Tania,17,0,35,18
1657190409073,COGS 107A,A01,083627,Boyle; Mary E. T.,13,0,60,47
1657190415096,COGS 118A,A01,083075,Gupta; Anjum,16,0,76,60
1657190421127,CSE 3,A50,083646,Miranda; Gregory Joseph,24,0,50,26
1657190427154,CSE 8A,A50,083650,Miranda; Gregory Joseph,17,1,56,39
1657190433178,CSE 11,A01,083080,Cao; Yingjun,5,15,40,35
1657190439201,CSE 12,A01,083652,Krause-Levy; Sophia Louisa,24,1,120,96
1657190445226,CSE 15L,A01,083654,Morris; Justin Loren,9,0,50,41
1657190445226,CSE 15L,A02,083655,Morris; Justin Loren,9,0,50,41
1657190451335,CSE 20,A01,083657,Tran; Khoa Dang,38,0,80,42
1657190457367,CSE 21,A01,095574,Bach; Quang Tran,22,0,48,26
1657190463390,CSE 30,A01,083084,Eldon; John,4,0,80,76
1657190463390,CSE 30,B01,095061,Bhaskar; Nishant,7,0,50,43
1657190469416,CSE 100,A01,083659,Cao; Yingjun,4,4,70,66
1657190475440,CSE 134B,A01,083661,Powell; Thomas Allan,20,0,100,80
1657190481470,CSE 140,A01,083663,Gungor; Onat,13,0,85,72
1657190487494,CSE 140L,A01,083088,Eldon; John,17,0,100,83
1657190493529,CSE 175,A01,083665,Kumar; Rakesh,3,0,25,22
1657190499551,CSE 190,A00,092507,Dubnov; Shlomo,7,0,20,13
1657190505585,ECE 45,A01,083139,Congero; Spencer William,5,0,75,70
1657190511609,ECE 65,A50,083695,Saad; Andrew S,12,0,30,18
1657190511609,ECE 65,A51,095125,Saad; Andrew S,25,0,26,1
1657190517633,ECE 109,A01,091882,Touri; Behrouz,19,0,70,51
1657190523660,ECE 180,A00,083140,Abi Samra; Nicholas Camill,1,0,30,29
1657190523660,ECE 180,B00,083141,Abi Samra; Nicholas Camill,0,0,30,30
1657190529687,MATH 10A,A01,083735,Patchell; Gregory David,2,0,30,28
1657190529687,MATH 10A,A02,083736,Patchell; Gregory David,20,0,30,10
1657190529687,MATH 10A,A03,083737,Patchell; Gregory David,16,0,30,14
1657190535716,MATH 10B,A01,083207,Lim; Seonhee,7,0,34,27
1657190535716,MATH 10B,A02,083208,Lim; Seonhee,9,0,35,26
1657190535716,MATH 10B,A03,093472,Lim; Seonhee,5,0,34,29
1657190535716,MATH 10B,B01,083739,Sinha; Shubham,10,0,30,20
1657190541752,MATH 18,A01,083743,Cinel; Cameron Alexander,6,0,30,24
1657190541752,MATH 18,A02,083744,Cinel; Cameron Alexander,15,0,30,15
1657190541752,MATH 18,A03,083745,Cinel; Cameron Alexander,8,0,30,22
1657190541752,MATH 18,B01,083748,Rideout; David Porter,4,0,37,33
1657190541752,MATH 18,B02,083749,Rideout; David Porter,4,0,36,32
1657190541752,MATH 18,B03,083750,Rideout; David Porter,2,0,37,35
1657190541752,MATH 18,B04,083751,Rideout; David Porter,5,0,36,31
1657190541752,MATH 18,B05,093473,Rideout; David Porter,5,0,36,31
1657190541752,MATH 18,B06,093474,Rideout; David Porter,5,0,36,31
1657190547775,MATH 20A,A01,083754,Zheng; Zequn,13,0,40,27
1657190553802,MATH 20B,A01,083756,Briones; Jor-el Thomas Caparas,1,0,36,35
1657190553802,MATH 20B,A02,083757,Briones; Jor-el Thomas Caparas,1,0,36,35
1657190553802,MATH 20B,A03,093475,Briones; Jor-el Thomas Caparas,1,0,36,35
1657190559833,MATH 20C,A01,083760,Briones; Jor-el Thomas Caparas,1,0,35,34
1657190559833,MATH 20C,A02,083761,Briones; Jor-el Thomas Caparas,8,0,35,27
1657190559833,MATH 20C,A03,093476,Briones; Jor-el Thomas Caparas,0,1,36,36
1657190559833,MATH 20C,B01,083762,Bach; Quang Tran,1,0,30,29
1657190565863,MATH 20D,A01,083765,Tran; Brian Kha,4,0,30,26
1657190565863,MATH 20D,A02,083766,Tran; Brian Kha,5,0,30,25
1657190565863,MATH 20D,A03,083767,Tran; Brian Kha,4,0,30,26
1657190571887,MATH 20E,A01,083771,Ganguly; Soumya,7,0,32,25
1657190571887,MATH 20E,A02,083772,Ganguly; Soumya,7,0,32,25
1657190571887,MATH 20E,B01,083773,Ciotti; Benjamin,19,0,35,16
1657190571887,MATH 20E,B02,083774,Ciotti; Benjamin,17,0,35,18
1657190577916,MATH 103A,A01,083777,Greenfeld; Be'Eri,2,0,36,34
1657190577916,MATH 103A,A02,083778,Greenfeld; Be'Eri,5,0,36,31
1657190577916,MATH 103A,A03,093561,Greenfeld; Be'Eri,4,0,36,32
1657190577916,MATH 103A,B01,083779,Greenfeld; Be'Eri,6,0,36,30
1657190577916,MATH 103A,B02,083780,Greenfeld; Be'Eri,3,0,36,33
1657190577916,MATH 103A,B03,093562,Greenfeld; Be'Eri,3,0,36,33
1657190583944,MATH 105,A01,085443,Carter; Anne Toulson,14,0,35,21
1657190583944,MATH 105,A02,093477,Carter; Anne Toulson,20,0,35,15
1657190589967,MATH 109,A01,083213,Ganzberger; Geoffrey Michael,2,0,34,32
1657190589967,MATH 109,A02,083214,Ganzberger; Geoffrey Michael,3,0,34,31
1657190589967,MATH 109,A03,093478,Ganzberger; Geoffrey Michael,1,0,34,33
1657190589967,MATH 109,B01,083215,Ganzberger; Geoffrey Michael,1,0,32,31
1657190589967,MATH 109,B02,083216,Ganzberger; Geoffrey Michael,1,0,32,31
1657190589967,MATH 109,B03,093479,Ganzberger; Geoffrey Michael,7,0,32,25
1657190595997,MATH 142A,A01,083219,Chow; Bennett,6,0,32,26
1657190595997,MATH 142A,A02,083220,Chow; Bennett,10,0,32,22
1657190595997,MATH 142A,A03,093480,Chow; Bennett,7,0,32,25
1657190595997,MATH 142A,B03,093481,Chow; Bennett,8,0,32,24
1657190595997,MATH 142A,B04,093558,Chow; Bennett,11,0,32,21
1657190595997,MATH 142A,B05,093559,Chow; Bennett,6,0,32,26
1657190602024,MATH 193A,A01,083224,Rotar; Vladimir,7,0,34,27
1657190602024,MATH 193A,A02,083225,Rotar; Vladimir,5,0,34,29
1657190602024,MATH 193A,A03,083781,Rotar; Vladimir,1,0,34,33
1657190602024,MATH 193A,A04,083782,Rotar; Vladimir,8,0,34,26
1657190602024,MATH 193A,A05,093482,Rotar; Vladimir,6,0,34,28
1657190608046,MATH 197,001,091859,McAuley; Julian John,9999,0,9999,0
1657190608046,MATH 197,002,095566,Kedlaya; Kiran S.,9997,0,9999,2
1657190608046,MATH 197,003,095567,Xiao; Ming,9999,0,9999,0
1657190608046,MATH 197,004,095571,Perols; Johan Lars,9998,0,9999,1
1657190615109,COGS 9,A01,083615,Shannon; Kyle Michael,7,0,75,68
1657190621131,COGS 11,A01,083617,Boyle; Mary E. T.,22,0,48,26
1657190627155,COGS 13,A01,083071,Bastos; Amalia Pinkusfeld,9,0,71,62
1657190633179,COGS 14A,A01,092681,Semenuks; Arturs,1,1,100,99
1657190639203,COGS 14B,A01,083073,Cheng; Tzu-Han,6,0,63,57
1657190645232,COGS 17,A01,092677,Semenuks; Arturs,4,0,81,77
1657190651258,COGS 100,A01,083619,Allen; Michael Gordon,15,0,70,55
1657190657285,COGS 101A,A01,083621,Davis; Joshua Daniel,9,0,68,59
1657190663309,COGS 101B,A01,091572,Allen; Michael Gordon,9,0,65,56
1657190669335,COGS 101C,A01,083625,Delgado; Tania,17,0,35,18
1657190675359,COGS 107A,A01,083627,Boyle; Mary E. T.,13,0,60,47
1657190681383,COGS 118A,A01,083075,Gupta; Anjum,16,0,76,60
1657190687406,CSE 3,A50,083646,Miranda; Gregory Joseph,24,0,50,26
1657190693434,CSE 8A,A50,083650,Miranda; Gregory Joseph,17,1,56,39
1657190699459,CSE 11,A01,083080,Cao; Yingjun,5,15,40,35
1657190705486,CSE 12,A01,083652,Krause-Levy; Sophia Louisa,24,1,120,96
1657190711508,CSE 15L,A01,083654,Morris; Justin Loren,9,0,50,41
1657190711508,CSE 15L,A02,083655,Morris; Justin Loren,9,0,50,41
1657190717530,CSE 20,A01,083657,Tran; Khoa Dang,38,0,80,42
1657190723554,CSE 21,A01,095574,Bach; Quang Tran,22,0,48,26
1657190729576,CSE 30,A01,083084,Eldon; John,4,0,80,76
1657190729576,CSE 30,B01,095061,Bhaskar; Nishant,7,0,50,43
1657190735598,CSE 100,A01,083659,Cao; Yingjun,4,4,70,66
1657190741621,CSE 134B,A01,083661,Powell; Thomas Allan,20,0,100,80
1657190747647,CSE 140,A01,083663,Gungor; Onat,13,0,85,72
1657190753674,CSE 140L,A01,083088,Eldon; John,17,0,100,83
1657190759697,CSE 175,A01,083665,Kumar; Rakesh,3,0,25,22
1657190765719,CSE 190,A00,092507,Dubnov; Shlomo,7,0,20,13
1657190771744,ECE 45,A01,083139,Congero; Spencer William,5,0,75,70
1657190777767,ECE 65,A50,083695,Saad; Andrew S,12,0,30,18
1657190777767,ECE 65,A51,095125,Saad; Andrew S,25,0,26,1
1657190783790,ECE 109,A01,091882,Touri; Behrouz,19,0,70,51
1657190789813,ECE 180,A00,083140,Abi Samra; Nicholas Camill,1,0,30,29
1657190789813,ECE 180,B00,083141,Abi Samra; Nicholas Camill,0,0,30,30
1657190795837,MATH 10A,A01,083735,Patchell; Gregory David,2,0,30,28
1657190795837,MATH 10A,A02,083736,Patchell; Gregory David,20,0,30,10
1657190795837,MATH 10A,A03,083737,Patchell; Gregory David,16,0,30,14
1657190801861,MATH 10B,A01,083207,Lim; Seonhee,7,0,34,27
1657190801861,MATH 10B,A02,083208,Lim; Seonhee,9,0,35,26
1657190801861,MATH 10B,A03,093472,Lim; Seonhee,5,0,34,29
1657190801861,MATH 10B,B01,083739,Sinha; Shubham,10,0,30,20
1657190807886,MATH 18,A01,083743,Cinel; Cameron Alexander,6,0,30,24
1657190807886,MATH 18,A02,083744,Cinel; Cameron Alexander,15,0,30,15
1657190807886,MATH 18,A03,083745,Cinel; Cameron Alexander,8,0,30,22
1657190807886,MATH 18,B01,083748,Rideout; David Porter,4,0,37,33
1657190807886,MATH 18,B02,083749,Rideout; David Porter,4,0,36,32
1657190807886,MATH 18,B03,083750,Rideout; David Porter,2,0,37,35
1657190807886,MATH 18,B04,083751,Rideout; David Porter,5,0,36,31
1657190807886,MATH 18,B05,093473,Rideout; David Porter,5,0,36,31
1657190807886,MATH 18,B06,093474,Rideout; David Porter,5,0,36,31
1657190813910,MATH 20A,A01,083754,Zheng; Zequn,13,0,40,27
1657190819937,MATH 20B,A01,083756,Briones; Jor-el Thomas Caparas,1,0,36,35
1657190819937,MATH 20B,A02,083757,Briones; Jor-el Thomas Caparas,1,0,36,35
1657190819937,MATH 20B,A03,093475,Briones; Jor-el Thomas Caparas,1,0,36,35
1657190825961,MATH 20C,A01,083760,Briones; Jor-el Thomas Caparas,1,0,35,34
1657190825961,MATH 20C,A02,083761,Briones; Jor-el Thomas Caparas,8,0,35,27
1657190825961,MATH 20C,A03,093476,Briones; Jor-el Thomas Caparas,0,1,36,36
1657190825961,MATH 20C,B01,083762,Bach; Quang Tran,1,0,30,29
1657190831986,MATH 20D,A01,083765,Tran; Brian Kha,4,0,30,26
1657190831986,MATH 20D,A02,083766,Tran; Brian Kha,5,0,30,25
1657190831986,MATH 20D,A03,083767,Tran; Brian Kha,4,0,30,26
1657190838014,MATH 20E,A01,083771,Ganguly; Soumya,7,0,32,25
1657190838014,MATH 20E,A02,083772,Ganguly; Soumya,7,0,32,25
1657190838014,MATH 20E,B01,083773,Ciotti; Benjamin,19,0,35,16
1657190838014,MATH 20E,B02,083774,Ciotti; Benjamin,17,0,35,18
1657190844040,MATH 103A,A01,083777,Greenfeld; Be'Eri,2,0,36,34
1657190844040,MATH 103A,A02,083778,Greenfeld; Be'Eri,5,0,36,31
1657190844040,MATH 103A,A03,093561,Greenfeld; Be'Eri,4,0,36,32
1657190844040,MATH 103A,B01,083779,Greenfeld; Be'Eri,6,0,36,30
1657190844040,MATH 103A,B02,083780,Greenfeld; Be'Eri,3,0,36,33
1657190844040,MATH 103A,B03,093562,Greenfeld; Be'Eri,3,0,36,33
1657190850063,MATH 105,A01,085443,Carter; Anne Toulson,14,0,35,21
1657190850063,MATH 105,A02,093477,Carter; Anne Toulson,20,0,35,15
1657190856093,MATH 109,A01,083213,Ganzberger; Geoffrey Michael,2,0,34,32
1657190856093,MATH 109,A02,083214,Ganzberger; Geoffrey Michael,3,0,34,31
1657190856093,MATH 109,A03,093478,Ganzberger; Geoffrey Michael,1,0,34,33
1657190856093,MATH 109,B01,083215,Ganzberger; Geoffrey Michael,1,0,32,31
1657190856093,MATH 109,B02,083216,Ganzberger; Geoffrey Michael,1,0,32,31
1657190856093,MATH 109,B03,093479,Ganzberger; Geoffrey Michael,7,0,32,25
1657190862117,MATH 142A,A01,083219,Chow; Bennett,6,0,32,26
1657190862117,MATH 142A,A02,083220,Chow; Bennett,10,0,32,22
1657190862117,MATH 142A,A03,093480,Chow; Bennett,7,0,32,25
1657190862117,MATH 142A,B03,093481,Chow; Bennett,8,0,32,24
1657190862117,MATH 142A,B04,093558,Chow; Bennett,11,0,32,21
1657190862117,MATH 142A,B05,093559,Chow; Bennett,6,0,32,26
1657190868145,MATH 193A,A01,083224,Rotar; Vladimir,7,0,34,27
1657190868145,MATH 193A,A02,083225,Rotar; Vladimir,5,0,34,29
1657190868145,MATH 193A,A03,083781,Rotar; Vladimir,1,0,34,33
1657190868145,MATH 193A,A04,083782,Rotar; Vladimir,8,0,34,26
1657190868145,MATH 193A,A05,093482,Rotar; Vladimir,6,0,34,28
1657190874186,MATH 197,001,091859,McAuley; Julian John,9999,0,9999,0
1657190874186,MATH 197,002,095566,Kedlaya; Kiran S.,9997,0,9999,2
1657190874186,MATH 197,003,095567,Xiao; Ming,9999,0,9999,0
1657190874186,MATH 197,004,095571,Perols; Johan Lars,9998,0,9999,1
1657190881253,COGS 9,A01,083615,Shannon; Kyle Michael,7,0,75,68
1657190887277,COGS 11,A01,083617,Boyle; Mary E. T.,22,0,48,26
1657190893300,COGS 13,A01,083071,Bastos; Amalia Pinkusfeld,9,0,71,62
1657190899325,COGS 14A,A01,092681,Semenuks; Arturs,1,1,100,99
1657190905352,COGS 14B,A01,083073,Cheng; Tzu-Han,6,0,63,57
1657190911374,COGS 17,A01,092677,Semenuks; Arturs,4,0,81,77
1657190917396,COGS 100,A01,083619,Allen; Michael Gordon,15,0,70,55
1657190923422,COGS 101A,A01,083621,Davis; Joshua Daniel,9,0,68,59
1657190929465,COGS 101B,A01,091572,Allen; Michael Gordon,9,0,65,56
1657190935495,COGS 101C,A01,083625,Delgado; Tania,17,0,35,18
1657190941517,COGS 107A,A01,083627,Boyle; Mary E. T.,13,0,60,47
1657190947543,COGS 118A,A01,083075,Gupta; Anjum,16,0,76,60
1657190953573,CSE 3,A50,083646,Miranda; Gregory Joseph,24,0,50,26
1657190959600,CSE 8A,A50,083650,Miranda; Gregory Joseph,17,1,56,39
1657190965622,CSE 11,A01,083080,Cao; Yingjun,5,15,40,35
1657190971648,CSE 12,A01,083652,Krause-Levy; Sophia Louisa,24,1,120,96
1657190977672,CSE 15L,A01,083654,Morris; Justin Loren,9,0,50,41
1657190977672,CSE 15L,A02,083655,Morris; Justin Loren,9,0,50,41
1657190983695,CSE 20,A01,083657,Tran; Khoa Dang,38,0,80,42
1657190989718,CSE 21,A01,095574,Bach; Quang Tran,22,0,48,26
1657190995739,CSE 30,A01,083084,Eldon; John,4,0,80,76
1657190995739,CSE 30,B01,095061,Bhaskar; Nishant,7,0,50,43
1657191001765,CSE 100,A01,083659,Cao; Yingjun,4,4,70,66
1657191007789,CSE 134B,A01,083661,Powell; Thomas Allan,20,0,100,80
1657191013812,CSE 140,A01,083663,Gungor; Onat,13,0,85,72
1657191019838,CSE 140L,A01,083088,Eldon; John,17,0,100,83
1657191025863,CSE 175,A01,083665,Kumar; Rakesh,3,0,25,22
1657191031892,CSE 190,A00,092507,Dubnov; Shlomo,7,0,20,13
1657191037917,ECE 45,A01,083139,Congero; Spencer William,5,0,75,70
1657191043940,ECE 65,A50,083695,Saad; Andrew S,12,0,30,18
1657191043940,ECE 65,A51,095125,Saad; Andrew S,25,0,26,1
1657191050037,ECE 109,A01,091882,Touri; Behrouz,19,0,70,51
1657191056060,ECE 180,A00,083140,Abi Samra; Nicholas Camill,1,0,30,29
1657191056060,ECE 180,B00,083141,Abi Samra; Nicholas Camill,0,0,30,30
1657191062083,MATH 10A,A01,083735,Patchell; Gregory David,2,0,30,28
1657191062083,MATH 10A,A02,083736,Patchell; Gregory David,20,0,30,10
1657191062083,MATH 10A,A03,083737,Patchell; Gregory David,16,0,30,14
1657191068115,MATH 10B,A01,083207,Lim; Seonhee,7,0,34,27
1657191068115,MATH 10B,A02,083208,Lim; Seonhee,9,0,35,26
1657191068115,MATH 10B,A03,093472,Lim; Seonhee,5,0,34,29
1657191068115,MATH 10B,B01,083739,Sinha; Shubham,10,0,30,20
1657191074147,MATH 18,A01,083743,Cinel; Cameron Alexander,6,0,30,24
1657191074147,MATH 18,A02,083744,Cinel; Cameron Alexander,15,0,30,15
1657191074147,MATH 18,A03,083745,Cinel; Cameron Alexander,8,0,30,22
1657191074147,MATH 18,B01,083748,Rideout; David Porter,4,0,37,33
1657191074147,MATH 18,B02,083749,Rideout; David Porter,4,0,36,32
1657191074147,MATH 18,B03,083750,Rideout; David Porter,2,0,37,35
1657191074147,MATH 18,B04,083751,Rideout; David Porter,5,0,36,31
1657191074147,MATH 18,B05,093473,Rideout; David Porter,5,0,36,31
1657191074147,MATH 18,B06,093474,Rideout; David Porter,5,0,36,31
1657191080171,MATH 20A,A01,083754,Zheng; Zequn,13,0,40,27
1657191086199,MATH 20B,A01,083756,Briones; Jor-el Thomas Caparas,1,0,36,35
1657191086199,MATH 20B,A02,083757,Briones; Jor-el Thomas Caparas,1,0,36,35
1657191086199,MATH 20B,A03,093475,Briones; Jor-el Thomas Caparas,1,0,36,35
1657191092228,MATH 20C,A01,083760,Briones; Jor-el Thomas Caparas,1,0,35,34
1657191092228,MATH 20C,A02,083761,Briones; Jor-el Thomas Caparas,8,0,35,27
1657191092228,MATH 20C,A03,093476,Briones; Jor-el Thomas Caparas,0,1,36,36
1657191092228,MATH 20C,B01,083762,Bach; Quang Tran,1,0,30,29
1657191098251,MATH 20D,A01,083765,Tran; Brian Kha,4,0,30,26
1657191098251,MATH 20D,A02,083766,Tran; Brian Kha,5,0,30,25
1657191098251,MATH 20D,A03,083767,Tran; Brian Kha,4,0,30,26
1657191104280,MATH 20E,A01,083771,Ganguly; Soumya,7,0,32,25
1657191104280,MATH 20E,A02,083772,Ganguly; Soumya,7,0,32,25
1657191104280,MATH 20E,B01,083773,Ciotti; Benjamin,19,0,35,16
1657191104280,MATH 20E,B02,083774,Ciotti; Benjamin,17,0,35,18
1657191110310,MATH 103A,A01,083777,Greenfeld; Be'Eri,2,0,36,34
1657191110310,MATH 103A,A02,083778,Greenfeld; Be'Eri,5,0,36,31
1657191110310,MATH 103A,A03,093561,Greenfeld; Be'Eri,4,0,36,32
1657191110310,MATH 103A,B01,083779,Greenfeld; Be'Eri,6,0,36,30
1657191110310,MATH 103A,B02,083780,Greenfeld; Be'Eri,3,0,36,33
1657191110310,MATH 103A,B03,093562,Greenfeld; Be'Eri,3,0,36,33
1657191116335,MATH 105,A01,085443,Carter; Anne Toulson,14,0,35,21
1657191116335,MATH 105,A02,093477,Carter; Anne Toulson,20,0,35,15
1657191122357,MATH 109,A01,083213,Ganzberger; Geoffrey Michael,2,0,34,32
1657191122357,MATH 109,A02,083214,Ganzberger; Geoffrey Michael,3,0,34,31
1657191122357,MATH 109,A03,093478,Ganzberger; Geoffrey Michael,1,0,34,33
1657191122357,MATH 109,B01,083215,Ganzberger; Geoffrey Michael,1,0,32,31
1657191122357,MATH 109,B02,083216,Ganzberger; Geoffrey Michael,1,0,32,31
1657191122357,MATH 109,B03,093479,Ganzberger; Geoffrey Michael,7,0,32,25
1657191137747,MATH 142A,A01,083219,Chow; Bennett,6,0,32,26
1657191137747,MATH 142A,A02,083220,Chow; Bennett,10,0,32,22
1657191137747,MATH 142A,A03,093480,Chow; Bennett,7,0,32,25
1657191137747,MATH 142A,B03,093481,Chow; Bennett,8,0,32,24
1657191137747,MATH 142A,B04,093558,Chow; Bennett,11,0,32,21
1657191137747,MATH 142A,B05,093559,Chow; Bennett,6,0,32,26
1657191143775,MATH 193A,A01,083224,Rotar; Vladimir,7,0,34,27
1657191143775,MATH 193A,A02,083225,Rotar; Vladimir,5,0,34,29
1657191143775,MATH 193A,A03,083781,Rotar; Vladimir,1,0,34,33
1657191143775,MATH 193A,A04,083782,Rotar; Vladimir,8,0,34,26
1657191143775,MATH 193A,A05,093482,Rotar; Vladimir,6,0,34,28
1657191161544,MATH 197,001,091859,McAuley; Julian John,9999,0,9999,0
1657191161544,MATH 197,002,095566,Kedlaya; Kiran S.,9997,0,9999,2
1657191161544,MATH 197,003,095567,Xiao; Ming,9999,0,9999,0
1657191161544,MATH 197,004,095571,Perols; Johan Lars,9998,0,9999,1
1657191168627,COGS 9,A01,083615,Shannon; Kyle Michael,7,0,75,68
1657191185346,COGS 11,A01,083617,Boyle; Mary E. T.,22,0,48,26
1657191191369,COGS 13,A01,083071,Bastos; Amalia Pinkusfeld,9,0,71,62
1657191209468,COGS 14A,A01,092681,Semenuks; Arturs,1,1,100,99
1657191215507,COGS 14B,A01,083073,Cheng; Tzu-Han,6,0,63,57
1657191233366,COGS 17,A01,092677,Semenuks; Arturs,4,0,81,77
1657191239390,COGS 100,A01,083619,Allen; Michael Gordon,15,0,70,55
1657191256915,COGS 101A,A01,083621,Davis; Joshua Daniel,9,0,68,59
1657191262938,COGS 101B,A01,091572,Allen; Michael Gordon,9,0,65,56
1657191280465,COGS 101C,A01,083625,Delgado; Tania,17,0,35,18
1657191286501,COGS 107A,A01,083627,Boyle; Mary E. T.,13,0,60,47
1657191303608,COGS 118A,A01,083075,Gupta; Anjum,16,0,76,60
1657191309632,CSE 3,A50,083646,Miranda; Gregory Joseph,24,0,50,26
1657191326615,CSE 8A,A50,083650,Miranda; Gregory Joseph,17,1,56,39
1657191332638,CSE 11,A01,083080,Cao; Yingjun,5,15,40,35
1657191348964,CSE 12,A01,083652,Krause-Levy; Sophia Louisa,24,1,120,96
1657191354987,CSE 15L,A01,083654,Morris; Justin Loren,9,0,50,41
1657191354987,CSE 15L,A02,083655,Morris; Justin Loren,9,0,50,41
1657191361956,CSE 20,A01,083657,Tran; Khoa Dang,38,0,80,42
1657191367978,CSE 21,A01,095574,Bach; Quang Tran,22,0,48,26
1657191374002,CSE 30,A01,083084,Eldon; John,4,0,80,76
1657191374002,CSE 30,B01,095061,Bhaskar; Nishant,7,0,50,43
1657191380029,CSE 100,A01,083659,Cao; Yingjun,4,4,70,66
1657191386052,CSE 134B,A01,083661,Powell; Thomas Allan,20,0,100,80
1657191392075,CSE 140,A01,083663,Gungor; Onat,13,0,85,72
1657191398099,CSE 140L,A01,083088,Eldon; John,17,0,100,83
1657191404125,CSE 175,A01,083665,Kumar; Rakesh,3,0,25,22
1657191410149,CSE 190,A00,092507,Dubnov; Shlomo,7,0,20,13
1657191416172,ECE 45,A01,083139,Congero; Spencer William,5,0,75,70
1657191422196,ECE 65,A50,083695,Saad; Andrew S,12,0,30,18
1657191422196,ECE 65,A51,095125,Saad; Andrew S,25,0,26,1
1657191428224,ECE 109,A01,091882,Touri; Behrouz,19,0,70,51
1657191434255,ECE 180,A00,083140,Abi Samra; Nicholas Camill,1,0,30,29
1657191434255,ECE 180,B00,083141,Abi Samra; Nicholas Camill,0,0,30,30
1657191440281,MATH 10A,A01,083735,Patchell; Gregory David,2,0,30,28
1657191440281,MATH 10A,A02,083736,Patchell; Gregory David,20,0,30,10
1657191440281,MATH 10A,A03,083737,Patchell; Gregory David,16,0,30,14
1657191446306,MATH 10B,A01,083207,Lim; Seonhee,7,0,34,27
1657191446306,MATH 10B,A02,083208,Lim; Seonhee,9,0,35,26
1657191446306,MATH 10B,A03,093472,Lim; Seonhee,5,0,34,29
1657191446306,MATH 10B,B01,083739,Sinha; Shubham,10,0,30,20
1657191452331,MATH 18,A01,083743,Cinel; Cameron Alexander,6,0,30,24
1657191452331,MATH 18,A02,083744,Cinel; Cameron Alexander,15,0,30,15
1657191452331,MATH 18,A03,083745,Cinel; Cameron Alexander,8,0,30,22
1657191452331,MATH 18,B01,083748,Rideout; David Porter,4,0,37,33
1657191452331,MATH 18,B02,083749,Rideout; David Porter,4,0,36,32
1657191452331,MATH 18,B03,083750,Rideout; David Porter,2,0,37,35
1657191452331,MATH 18,B04,083751,Rideout; David Porter,5,0,36,31
1657191452331,MATH 18,B05,093473,Rideout; David Porter,5,0,36,31
1657191452331,MATH 18,B06,093474,Rideout; David Porter,5,0,36,31
1657191458354,MATH 20A,A01,083754,Zheng; Zequn,13,0,40,27
1657191464379,MATH 20B,A01,083756,Briones; Jor-el Thomas Caparas,1,0,36,35
1657191464379,MATH 20B,A02,083757,Briones; Jor-el Thomas Caparas,1,0,36,35
1657191464379,MATH 20B,A03,093475,Briones; Jor-el Thomas Caparas,1,0,36,35
1657191470407,MATH 20C,A01,083760,Briones; Jor-el Thomas Caparas,1,0,35,34
1657191470407,MATH 20C,A02,083761,Briones; Jor-el Thomas Caparas,8,0,35,27
1657191470407,MATH 20C,A03,093476,Briones; Jor-el Thomas Caparas,0,1,36,36
1657191470407,MATH 20C,B01,083762,Bach; Quang Tran,1,0,30,29
1657191476435,MATH 20D,A01,083765,Tran; Brian Kha,4,0,30,26
1657191476435,MATH 20D,A02,083766,Tran; Brian Kha,5,0,30,25
1657191476435,MATH 20D,A03,083767,Tran; Brian Kha,4,0,30,26
1657191482460,MATH 20E,A01,083771,Ganguly; Soumya,7,0,32,25
1657191482460,MATH 20E,A02,083772,Ganguly; Soumya,7,0,32,25
1657191482460,MATH 20E,B01,083773,Ciotti; Benjamin,19,0,35,16
1657191482460,MATH 20E,B02,083774,Ciotti; Benjamin,17,0,35,18
1657191488491,MATH 103A,A01,083777,Greenfeld; Be'Eri,2,0,36,34
1657191488491,MATH 103A,A02,083778,Greenfeld; Be'Eri,5,0,36,31
1657191488491,MATH 103A,A03,093561,Greenfeld; Be'Eri,4,0,36,32
1657191488491,MATH 103A,B01,083779,Greenfeld; Be'Eri,6,0,36,30
1657191488491,MATH 103A,B02,083780,Greenfeld; Be'Eri,3,0,36,33
1657191488491,MATH 103A,B03,093562,Greenfeld; Be'Eri,3,0,36,33
1657191494529,MATH 105,A01,085443,Carter; Anne Toulson,14,0,35,21
1657191494529,MATH 105,A02,093477,Carter; Anne Toulson,20,0,35,15
1657191500557,MATH 109,A01,083213,Ganzberger; Geoffrey Michael,2,0,34,32
1657191500557,MATH 109,A02,083214,Ganzberger; Geoffrey Michael,3,0,34,31
1657191500557,MATH 109,A03,093478,Ganzberger; Geoffrey Michael,1,0,34,33
1657191500557,MATH 109,B01,083215,Ganzberger; Geoffrey Michael,1,0,32,31
1657191500557,MATH 109,B02,083216,Ganzberger; Geoffrey Michael,1,0,32,31
1657191500557,MATH 109,B03,093479,Ganzberger; Geoffrey Michael,7,0,32,25
1657191506586,MATH 142A,A01,083219,Chow; Bennett,6,0,32,26
1657191506586,MATH 142A,A02,083220,Chow; Bennett,10,0,32,22
1657191506586,MATH 142A,A03,093480,Chow; Bennett,7,0,32,25
1657191506586,MATH 142A,B03,093481,Chow; Bennett,8,0,32,24
1657191506586,MATH 142A,B04,093558,Chow; Bennett,11,0,32,21
1657191506586,MATH 142A,B05,093559,Chow; Bennett,6,0,32,26
1657191512613,MATH 193A,A01,083224,Rotar; Vladimir,7,0,34,27
1657191512613,MATH 193A,A02,083225,Rotar; Vladimir,5,0,34,29
1657191512613,MATH 193A,A03,083781,Rotar; Vladimir,1,0,34,33
1657191512613,MATH 193A,A04,083782,Rotar; Vladimir,8,0,34,26
1657191512613,MATH 193A,A05,093482,Rotar; Vladimir,6,0,34,28
1657191518635,MATH 197,001,091859,McAuley; Julian John,9999,0,9999,0
1657191518635,MATH 197,002,095566,Kedlaya; Kiran S.,9997,0,9999,2
1657191518635,MATH 197,003,095567,Xiao; Ming,9999,0,9999,0
1657191518635,MATH 197,004,095571,Perols; Johan Lars,9998,0,9999,1
1657191525703,COGS 9,A01,083615,Shannon; Kyle Michael,7,0,75,68
1657191531730,COGS 11,A01,083617,Boyle; Mary E. T.,22,0,48,26
1657191537762,COGS 13,A01,083071,Bastos; Amalia Pinkusfeld,9,0,71,62
1657191543785,COGS 14A,A01,092681,Semenuks; Arturs,1,1,100,99
1657191549818,COGS 14B,A01,083073,Cheng; Tzu-Han,6,0,63,57
1657191555847,COGS 17,A01,092677,Semenuks; Arturs,4,0,81,77
1657191561870,COGS 100,A01,083619,Allen; Michael Gordon,15,0,70,55
1657191567893,COGS 101A,A01,083621,Davis; Joshua Daniel,9,0,68,59
1657191573916,COGS 101B,A01,091572,Allen; Michael Gordon,9,0,65,56
1657191579940,COGS 101C,A01,083625,Delgado; Tania,17,0,35,18
1657191585965,COGS 107A,A01,083627,Boyle; Mary E. T.,13,0,60,47
1657191591988,COGS 118A,A01,083075,Gupta; Anjum,16,0,76,60
1657191598011,CSE 3,A50,083646,Miranda; Gregory Joseph,24,0,50,26
1657191604042,CSE 8A,A50,083650,Miranda; Gregory Joseph,17,1,56,39
1657191610069,CSE 11,A01,083080,Cao; Yingjun,5,15,40,35
1657191616092,CSE 12,A01,083652,Krause-Levy; Sophia Louisa,24,1,120,96
1657191622116,CSE 15L,A01,083654,Morris; Justin Loren,9,0,50,41
1657191622116,CSE 15L,A02,083655,Morris; Justin Loren,9,0,50,41
1657191628141,CSE 20,A01,083657,Tran; Khoa Dang,38,0,80,42
1657191641461,CSE 21,A01,095574,Bach; Quang Tran,22,0,48,26
1657191647488,CSE 30,A01,083084,Eldon; John,4,0,80,76
1657191647488,CSE 30,B01,095061,Bhaskar; Nishant,7,0,50,43
1657191653513,CSE 100,A01,083659,Cao; Yingjun,4,4,70,66
1657191659542,CSE 134B,A01,083661,Powell; Thomas Allan,20,0,100,80
1657191665565,CSE 140,A01,083663,Gungor; Onat,13,0,85,72
1657191671588,CSE 140L,A01,083088,Eldon; John,17,0,100,83
1657191677611,CSE 175,A01,083665,Kumar; Rakesh,3,0,25,22
1657191683634,CSE 190,A00,092507,Dubnov; Shlomo,7,0,20,13
1657191689657,ECE 45,A01,083139,Congero; Spencer William,5,0,75,70
1657191695684,ECE 65,A50,083695,Saad; Andrew S,12,0,30,18
1657191695684,ECE 65,A51,095125,Saad; Andrew S,25,0,26,1
1657191701708,ECE 109,A01,091882,Touri; Behrouz,19,0,70,51
1657191707732,ECE 180,A00,083140,Abi Samra; Nicholas Camill,1,0,30,29
1657191707732,ECE 180,B00,083141,Abi Samra; Nicholas Camill,0,0,30,30
1657191713760,MATH 10A,A01,083735,Patchell; Gregory David,2,0,30,28
1657191713760,MATH 10A,A02,083736,Patchell; Gregory David,20,0,30,10
1657191713760,MATH 10A,A03,083737,Patchell; Gregory David,16,0,30,14
1657191719789,MATH 10B,A01,083207,Lim; Seonhee,7,0,34,27
1657191719789,MATH 10B,A02,083208,Lim; Seonhee,9,0,35,26
1657191719789,MATH 10B,A03,093472,Lim; Seonhee,5,0,34,29
1657191719789,MATH 10B,B01,083739,Sinha; Shubham,10,0,30,20
1657191725812,MATH 18,A01,083743,Cinel; Cameron Alexander,6,0,30,24
1657191725812,MATH 18,A02,083744,Cinel; Cameron Alexander,15,0,30,15
1657191725812,MATH 18,A03,083745,Cinel; Cameron Alexander,8,0,30,22
1657191725812,MATH 18,B01,083748,Rideout; David Porter,4,0,37,33
1657191725812,MATH 18,B02,083749,Rideout; David Porter,4,0,36,32
1657191725812,MATH 18,B03,083750,Rideout; David Porter,2,0,37,35
1657191725812,MATH 18,B04,083751,Rideout; David Porter,5,0,36,31
1657191725812,MATH 18,B05,093473,Rideout; David Porter,5,0,36,31
1657191725812,MATH 18,B06,093474,Rideout; David Porter,5,0,36,31
1657191731840,MATH 20A,A01,083754,Zheng; Zequn,13,0,40,27
1657191737863,MATH 20B,A01,083756,Briones; Jor-el Thomas Caparas,1,0,36,35
1657191737863,MATH 20B,A02,083757,Briones; Jor-el Thomas Caparas,1,0,36,35
1657191737863,MATH 20B,A03,093475,Briones; Jor-el Thomas Caparas,1,0,36,35
1657191743887,MATH 20C,A01,083760,Briones; Jor-el Thomas Caparas,1,0,35,34
1657191743887,MATH 20C,A02,083761,Briones; Jor-el Thomas Caparas,8,0,35,27
1657191743887,MATH 20C,A03,093476,Briones; Jor-el Thomas Caparas,0,1,36,36
1657191743887,MATH 20C,B01,083762,Bach; Quang Tran,1,0,30,29
1657191749917,MATH 20D,A01,083765,Tran; Brian Kha,4,0,30,26
1657191749917,MATH 20D,A02,083766,Tran; Brian Kha,5,0,30,25
1657191749917,MATH 20D,A03,083767,Tran; Brian Kha,4,0,30,26
1657191755947,MATH 20E,A01,083771,Ganguly; Soumya,7,0,32,25
1657191755947,MATH 20E,A02,083772,Ganguly; Soumya,7,0,32,25
1657191755947,MATH 20E,B01,083773,Ciotti; Benjamin,19,0,35,16
1657191755947,MATH 20E,B02,083774,Ciotti; Benjamin,17,0,35,18
1657191761974,MATH 103A,A01,083777,Greenfeld; Be'Eri,2,0,36,34
1657191761974,MATH 103A,A02,083778,Greenfeld; Be'Eri,5,0,36,31
1657191761974,MATH 103A,A03,093561,Greenfeld; Be'Eri,4,0,36,32
1657191761974,MATH 103A,B01,083779,Greenfeld; Be'Eri,6,0,36,30
1657191761974,MATH 103A,B02,083780,Greenfeld; Be'Eri,3,0,36,33
1657191761974,MATH 103A,B03,093562,Greenfeld; Be'Eri,3,0,36,33
1657191768072,MATH 105,A01,085443,Carter; Anne Toulson,14,0,35,21
1657191768072,MATH 105,A02,093477,Carter; Anne Toulson,20,0,35,15
1657191774094,MATH 109,A01,083213,Ganzberger; Geoffrey Michael,2,0,34,32
1657191774094,MATH 109,A02,083214,Ganzberger; Geoffrey Michael,3,0,34,31
1657191774094,MATH 109,A03,093478,Ganzberger; Geoffrey Michael,1,0,34,33
1657191774094,MATH 109,B01,083215,Ganzberger; Geoffrey Michael,1,0,32,31
1657191774094,MATH 109,B02,083216,Ganzberger; Geoffrey Michael,1,0,32,31
1657191774094,MATH 109,B03,093479,Ganzberger; Geoffrey Michael,7,0,32,25
1657191780126,MATH 142A,A01,083219,Chow; Bennett,6,0,32,26
1657191780126,MATH 142A,A02,083220,Chow; Bennett,10,0,32,22
1657191780126,MATH 142A,A03,093480,Chow; Bennett,7,0,32,25
1657191780126,MATH 142A,B03,093481,Chow; Bennett,8,0,32,24
1657191780126,MATH 142A,B04,093558,Chow; Bennett,11,0,32,21
1657191780126,MATH 142A,B05,093559,Chow; Bennett,6,0,32,26
1657191786153,MATH 193A,A01,083224,Rotar; Vladimir,7,0,34,27
1657191786153,MATH 193A,A02,083225,Rotar; Vladimir,5,0,34,29
1657191786153,MATH 193A,A03,083781,Rotar; Vladimir,1,0,34,33
1657191786153,MATH 193A,A04,083782,Rotar; Vladimir,8,0,34,26
1657191786153,MATH 193A,A05,093482,Rotar; Vladimir,6,0,34,28
1657191792175,MATH 197,001,091859,McAuley; Julian John,9999,0,9999,0
1657191792175,MATH 197,002,095566,Kedlaya; Kiran S.,9997,0,9999,2
1657191792175,MATH 197,003,095567,Xiao; Ming,9999,0,9999,0
1657191792175,MATH 197,004,095571,Perols; Johan Lars,9998,0,9999,1
1657191799318,COGS 9,A01,083615,Shannon; Kyle Michael,7,0,75,68
1657191805345,COGS 11,A01,083617,Boyle; Mary E. T.,22,0,48,26
1657191811374,COGS 13,A01,083071,Bastos; Amalia Pinkusfeld,9,0,71,62
1657191817401,COGS 14A,A01,092681,Semenuks; Arturs,1,1,100,99
1657191823425,COGS 14B,A01,083073,Cheng; Tzu-Han,6,0,63,57
1657191829453,COGS 17,A01,092677,Semenuks; Arturs,4,0,81,77
1657191835483,COGS 100,A01,083619,Allen; Michael Gordon,15,0,70,55
1657191841512,COGS 101A,A01,083621,Davis; Joshua Daniel,9,0,68,59
1657191847538,COGS 101B,A01,091572,Allen; Michael Gordon,9,0,65,56
1657191853563,COGS 101C,A01,083625,Delgado; Tania,17,0,35,18
1657191859591,COGS 107A,A01,083627,Boyle; Mary E. T.,13,0,60,47
1657191865616,COGS 118A,A01,083075,Gupta; Anjum,16,0,76,60
1657191871645,CSE 3,A50,083646,Miranda; Gregory Joseph,24,0,50,26
1657191877671,CSE 8A,A50,083650,Miranda; Gregory Joseph,17,1,56,39
1657191883694,CSE 11,A01,083080,Cao; Yingjun,5,15,40,35
1657191889722,CSE 12,A01,083652,Krause-Levy; Sophia Louisa,24,1,120,96
1657191895749,CSE 15L,A01,083654,Morris; Justin Loren,9,0,50,41
1657191895749,CSE 15L,A02,083655,Morris; Justin Loren,9,0,50,41
1657191901777,CSE 20,A01,083657,Tran; Khoa Dang,38,0,80,42
1657191907804,CSE 21,A01,095574,Bach; Quang Tran,22,0,48,26
1657191913830,CSE 30,A01,083084,Eldon; John,4,0,80,76
1657191913830,CSE 30,B01,095061,Bhaskar; Nishant,7,0,50,43
1657191919852,CSE 100,A01,083659,Cao; Yingjun,4,4,70,66
1657191925874,CSE 134B,A01,083661,Powell; Thomas Allan,20,0,100,80
1657191931900,CSE 140,A01,083663,Gungor; Onat,13,0,85,72
1657191937923,CSE 140L,A01,083088,Eldon; John,17,0,100,83
1657191943947,CSE 175,A01,083665,Kumar; Rakesh,3,0,25,22
1657191949974,CSE 190,A00,092507,Dubnov; Shlomo,7,0,20,13
1657191956002,ECE 45,A01,083139,Congero; Spencer William,5,0,75,70
1657191962029,ECE 65,A50,083695,Saad; Andrew S,12,0,30,18
1657191962029,ECE 65,A51,095125,Saad; Andrew S,25,0,26,1
1657191968052,ECE 109,A01,091882,Touri; Behrouz,19,0,70,51
1657191974080,ECE 180,A00,083140,Abi Samra; Nicholas Camill,1,0,30,29
1657191974080,ECE 180,B00,083141,Abi Samra; Nicholas Camill,0,0,30,30
1657191980104,MATH 10A,A01,083735,Patchell; Gregory David,2,0,30,28
1657191980104,MATH 10A,A02,083736,Patchell; Gregory David,20,0,30,10
1657191980104,MATH 10A,A03,083737,Patchell; Gregory David,16,0,30,14
