time,subj_course_id,sec_code,sec_id,prof,available,waitlist,total,enrolled_ct
1657538900798,COGS 9,A01,083615,Shannon; Kyle Michael,9,0,75,66
1657538906830,COGS 11,A01,083617,Boyle; Mary E. T.,22,0,48,26
1657538912861,COGS 13,A01,083071,Bastos; Amalia Pinkusfeld,11,0,71,60
1657538918895,COGS 14A,A01,092681,Semenuks; Arturs,5,1,100,95
1657538924941,COGS 14B,A01,083073,Cheng; Tzu-Han,6,0,63,57
1657538930972,COGS 17,A01,092677,Semenuks; Arturs,6,0,81,75
1657538937003,COGS 100,A01,083619,Allen; Michael Gordon,17,0,70,53
1657538943040,COGS 101A,A01,083621,Davis; Joshua Daniel,9,0,68,59
1657538949069,COGS 101B,A01,091572,Allen; Michael Gordon,12,0,65,53
1657538955105,COGS 101C,A01,083625,Delgado; Tania,17,0,35,18
1657538961140,COGS 107A,A01,083627,Boyle; Mary E. T.,13,0,60,47
1657538967174,COGS 118A,A01,083075,Gupta; Anjum,21,0,76,55
1657538973210,CSE 3,A50,083646,Miranda; Gregory Joseph,24,0,50,26
1657538979237,CSE 8A,A50,083650,Miranda; Gregory Joseph,17,1,56,39
1657538985266,CSE 11,A01,083080,Cao; Yingjun,6,15,40,34
1657538991303,CSE 12,A01,083652,Krause-Levy; Sophia Louisa,28,1,120,92
1657538997336,CSE 15L,A01,083654,Morris; Justin Loren,9,0,50,41
1657538997336,CSE 15L,A02,083655,Morris; Justin Loren,9,0,50,41
1657539003371,CSE 20,A01,083657,Tran; Khoa Dang,39,0,80,41
1657539009407,CSE 21,A01,095574,Bach; Quang Tran,22,0,48,26
1657539015437,CSE 30,A01,083084,Eldon; John,5,0,80,75
1657539015437,CSE 30,B01,095061,Bhaskar; Nishant,9,0,50,41
1657539021466,CSE 100,A01,083659,Cao; Yingjun,5,4,70,65
1657539027498,CSE 134B,A01,083661,Powell; Thomas Allan,22,0,100,78
1657539033529,CSE 140,A01,083663,Gungor; Onat,15,0,85,70
1657539039566,CSE 140L,A01,083088,Eldon; John,21,0,100,79
1657539045601,CSE 175,A01,083665,Kumar; Rakesh,3,0,25,22
1657539051627,CSE 190,A00,092507,Dubnov; Shlomo,8,0,20,12
1657539057664,ECE 45,A01,083139,Congero; Spencer William,6,0,75,69
1657539063705,ECE 65,A50,083695,Saad; Andrew S,12,0,30,18
1657539063705,ECE 65,A51,095125,Saad; Andrew S,24,0,26,2
1657539069740,ECE 109,A01,091882,Touri; Behrouz,19,0,70,51
1657539075768,ECE 180,A00,083140,Abi Samra; Nicholas Camill,1,0,30,29
1657539075768,ECE 180,B00,083141,Abi Samra; Nicholas Camill,0,0,30,30
1657539081802,MATH 10A,A01,083735,Patchell; Gregory David,2,0,30,28
1657539081802,MATH 10A,A02,083736,Patchell; Gregory David,20,0,30,10
1657539081802,MATH 10A,A03,083737,Patchell; Gregory David,16,0,30,14
1657539087836,MATH 10B,A01,083207,Lim; Seonhee,8,0,34,26
1657539087836,MATH 10B,A02,083208,Lim; Seonhee,9,0,35,26
1657539087836,MATH 10B,A03,093472,Lim; Seonhee,7,0,34,27
1657539087836,MATH 10B,B01,083739,Sinha; Shubham,12,0,30,18
1657539093883,MATH 18,A01,083743,Cinel; Cameron Alexander,7,0,30,23
1657539093883,MATH 18,A02,083744,Cinel; Cameron Alexander,17,0,30,13
1657539093883,MATH 18,A03,083745,Cinel; Cameron Alexander,9,0,30,21
1657539093883,MATH 18,B01,083748,Rideout; David Porter,5,0,37,32
1657539093883,MATH 18,B02,083749,Rideout; David Porter,5,0,36,31
1657539093883,MATH 18,B03,083750,Rideout; David Porter,3,0,37,34
1657539093883,MATH 18,B04,083751,Rideout; David Porter,6,0,36,30
1657539093883,MATH 18,B05,093473,Rideout; David Porter,6,0,36,30
1657539093883,MATH 18,B06,093474,Rideout; David Porter,6,0,36,30
1657539099913,MATH 20A,A01,083754,Zheng; Zequn,14,0,40,26
1657539105941,MATH 20B,A01,083756,Briones; Jor-el Thomas Caparas,4,0,36,32
1657539105941,MATH 20B,A02,083757,Briones; Jor-el Thomas Caparas,1,0,36,35
1657539105941,MATH 20B,A03,093475,Briones; Jor-el Thomas Caparas,2,0,36,34
1657539111973,MATH 20C,A01,083760,Briones; Jor-el Thomas Caparas,1,0,35,34
1657539111973,MATH 20C,A02,083761,Briones; Jor-el Thomas Caparas,8,0,35,27
1657539111973,MATH 20C,A03,093476,Briones; Jor-el Thomas Caparas,0,1,36,36
1657539111973,MATH 20C,B01,083762,Bach; Quang Tran,1,0,30,29
1657539118001,MATH 20D,A01,083765,Tran; Brian Kha,5,0,30,25
1657539118001,MATH 20D,A02,083766,Tran; Brian Kha,5,0,30,25
1657539118001,MATH 20D,A03,083767,Tran; Brian Kha,5,0,30,25
1657539124049,MATH 20E,A01,083771,Ganguly; Soumya,9,0,32,23
1657539124049,MATH 20E,A02,083772,Ganguly; Soumya,6,0,32,26
1657539124049,MATH 20E,B01,083773,Ciotti; Benjamin,20,0,35,15
1657539124049,MATH 20E,B02,083774,Ciotti; Benjamin,17,0,35,18
1657539130097,MATH 103A,A01,083777,Greenfeld; Be'Eri,3,0,36,33
1657539130097,MATH 103A,A02,083778,Greenfeld; Be'Eri,5,0,36,31
1657539130097,MATH 103A,A03,093561,Greenfeld; Be'Eri,5,0,36,31
1657539130097,MATH 103A,B01,083779,Greenfeld; Be'Eri,7,0,36,29
1657539130097,MATH 103A,B02,083780,Greenfeld; Be'Eri,4,0,36,32
1657539130097,MATH 103A,B03,093562,Greenfeld; Be'Eri,3,0,36,33
1657539136136,MATH 105,A01,085443,Carter; Anne Toulson,15,0,35,20
1657539136136,MATH 105,A02,093477,Carter; Anne Toulson,20,0,35,15
1657539142165,MATH 109,A01,083213,Ganzberger; Geoffrey Michael,2,0,34,32
1657539142165,MATH 109,A02,083214,Ganzberger; Geoffrey Michael,4,0,34,30
1657539142165,MATH 109,A03,093478,Ganzberger; Geoffrey Michael,2,0,34,32
1657539142165,MATH 109,B01,083215,Ganzberger; Geoffrey Michael,1,0,32,31
1657539142165,MATH 109,B02,083216,Ganzberger; Geoffrey Michael,2,0,32,30
1657539142165,MATH 109,B03,093479,Ganzberger; Geoffrey Michael,8,0,32,24
1657539148193,MATH 142A,A01,083219,Chow; Bennett,7,0,32,25
1657539148193,MATH 142A,A02,083220,Chow; Bennett,10,0,32,22
1657539148193,MATH 142A,A03,093480,Chow; Bennett,8,0,32,24
1657539148193,MATH 142A,B03,093481,Chow; Bennett,8,0,32,24
1657539148193,MATH 142A,B04,093558,Chow; Bennett,13,0,32,19
1657539148193,MATH 142A,B05,093559,Chow; Bennett,6,0,32,26
1657539154226,MATH 193A,A01,083224,Rotar; Vladimir,8,0,34,26
1657539154226,MATH 193A,A02,083225,Rotar; Vladimir,9,0,34,25
1657539154226,MATH 193A,A03,083781,Rotar; Vladimir,5,0,34,29
1657539154226,MATH 193A,A04,083782,Rotar; Vladimir,10,0,34,24
1657539154226,MATH 193A,A05,093482,Rotar; Vladimir,10,0,34,24
1657539160264,MATH 197,001,091859,McAuley; Julian John,9999,0,9999,0
1657539160264,MATH 197,002,095566,Kedlaya; Kiran S.,9997,0,9999,2
1657539160264,MATH 197,003,095567,Xiao; Ming,9999,0,9999,0
1657539160264,MATH 197,004,095571,Perols; Johan Lars,9998,0,9999,1
1657539167351,COGS 9,A01,083615,Shannon; Kyle Michael,9,0,75,66
1657539181193,COGS 11,A01,083617,Boyle; Mary E. T.,22,0,48,26
1657539187226,COGS 13,A01,083071,Bastos; Amalia Pinkusfeld,11,0,71,60
1657539201983,COGS 14A,A01,092681,Semenuks; Arturs,5,1,100,95
1657539208014,COGS 14B,A01,083073,Cheng; Tzu-Han,6,0,63,57
1657539214044,COGS 17,A01,092677,Semenuks; Arturs,6,0,81,75
1657539220077,COGS 100,A01,083619,Allen; Michael Gordon,17,0,70,53
1657539226106,COGS 101A,A01,083621,Davis; Joshua Daniel,9,0,68,59
1657539232139,COGS 101B,A01,091572,Allen; Michael Gordon,12,0,65,53
1657539238165,COGS 101C,A01,083625,Delgado; Tania,17,0,35,18
1657539244191,COGS 107A,A01,083627,Boyle; Mary E. T.,13,0,60,47
1657539250220,COGS 118A,A01,083075,Gupta; Anjum,21,0,76,55
1657539256256,CSE 3,A50,083646,Miranda; Gregory Joseph,24,0,50,26
1657539262286,CSE 8A,A50,083650,Miranda; Gregory Joseph,17,1,56,39
1657539268315,CSE 11,A01,083080,Cao; Yingjun,6,15,40,34
1657539274354,CSE 12,A01,083652,Krause-Levy; Sophia Louisa,28,1,120,92
1657539280382,CSE 15L,A01,083654,Morris; Justin Loren,9,0,50,41
1657539280382,CSE 15L,A02,083655,Morris; Justin Loren,9,0,50,41
1657539286415,CSE 20,A01,083657,Tran; Khoa Dang,39,0,80,41
1657539292449,CSE 21,A01,095574,Bach; Quang Tran,22,0,48,26
1657539298485,CSE 30,A01,083084,Eldon; John,5,0,80,75
1657539298485,CSE 30,B01,095061,Bhaskar; Nishant,9,0,50,41
1657539304516,CSE 100,A01,083659,Cao; Yingjun,5,4,70,65
1657539310542,CSE 134B,A01,083661,Powell; Thomas Allan,22,0,100,78
1657539316572,CSE 140,A01,083663,Gungor; Onat,15,0,85,70
1657539322597,CSE 140L,A01,083088,Eldon; John,21,0,100,79
1657539328630,CSE 175,A01,083665,Kumar; Rakesh,3,0,25,22
1657539334658,CSE 190,A00,092507,Dubnov; Shlomo,8,0,20,12
1657539340688,ECE 45,A01,083139,Congero; Spencer William,6,0,75,69
1657539346714,ECE 65,A50,083695,Saad; Andrew S,12,0,30,18
1657539346714,ECE 65,A51,095125,Saad; Andrew S,24,0,26,2
1657539352742,ECE 109,A01,091882,Touri; Behrouz,19,0,70,51
1657539358778,ECE 180,A00,083140,Abi Samra; Nicholas Camill,1,0,30,29
1657539358778,ECE 180,B00,083141,Abi Samra; Nicholas Camill,0,0,30,30
1657539364816,MATH 10A,A01,083735,Patchell; Gregory David,2,0,30,28
1657539364816,MATH 10A,A02,083736,Patchell; Gregory David,20,0,30,10
1657539364816,MATH 10A,A03,083737,Patchell; Gregory David,16,0,30,14
1657539370847,MATH 10B,A01,083207,Lim; Seonhee,8,0,34,26
1657539370847,MATH 10B,A02,083208,Lim; Seonhee,9,0,35,26
1657539370847,MATH 10B,A03,093472,Lim; Seonhee,7,0,34,27
1657539370847,MATH 10B,B01,083739,Sinha; Shubham,12,0,30,18
1657539376881,MATH 18,A01,083743,Cinel; Cameron Alexander,7,0,30,23
1657539376881,MATH 18,A02,083744,Cinel; Cameron Alexander,17,0,30,13
1657539376881,MATH 18,A03,083745,Cinel; Cameron Alexander,9,0,30,21
1657539376881,MATH 18,B01,083748,Rideout; David Porter,5,0,37,32
1657539376881,MATH 18,B02,083749,Rideout; David Porter,5,0,36,31
1657539376881,MATH 18,B03,083750,Rideout; David Porter,3,0,37,34
1657539376881,MATH 18,B04,083751,Rideout; David Porter,6,0,36,30
1657539376881,MATH 18,B05,093473,Rideout; David Porter,6,0,36,30
1657539376881,MATH 18,B06,093474,Rideout; David Porter,6,0,36,30
1657539382914,MATH 20A,A01,083754,Zheng; Zequn,14,0,40,26
1657539388950,MATH 20B,A01,083756,Briones; Jor-el Thomas Caparas,4,0,36,32
1657539388950,MATH 20B,A02,083757,Briones; Jor-el Thomas Caparas,1,0,36,35
1657539388950,MATH 20B,A03,093475,Briones; Jor-el Thomas Caparas,2,0,36,34
1657539394976,MATH 20C,A01,083760,Briones; Jor-el Thomas Caparas,1,0,35,34
1657539394976,MATH 20C,A02,083761,Briones; Jor-el Thomas Caparas,8,0,35,27
1657539394976,MATH 20C,A03,093476,Briones; Jor-el Thomas Caparas,0,1,36,36
1657539394976,MATH 20C,B01,083762,Bach; Quang Tran,1,0,30,29
1657539401009,MATH 20D,A01,083765,Tran; Brian Kha,5,0,30,25
1657539401009,MATH 20D,A02,083766,Tran; Brian Kha,5,0,30,25
1657539401009,MATH 20D,A03,083767,Tran; Brian Kha,5,0,30,25
1657539407083,MATH 20E,A01,083771,Ganguly; Soumya,9,0,32,23
1657539407083,MATH 20E,A02,083772,Ganguly; Soumya,6,0,32,26
1657539407083,MATH 20E,B01,083773,Ciotti; Benjamin,20,0,35,15
1657539407083,MATH 20E,B02,083774,Ciotti; Benjamin,17,0,35,18
1657539413113,MATH 103A,A01,083777,Greenfeld; Be'Eri,3,0,36,33
1657539413113,MATH 103A,A02,083778,Greenfeld; Be'Eri,5,0,36,31
1657539413113,MATH 103A,A03,093561,Greenfeld; Be'Eri,5,0,36,31
1657539413113,MATH 103A,B01,083779,Greenfeld; Be'Eri,7,0,36,29
1657539413113,MATH 103A,B02,083780,Greenfeld; Be'Eri,4,0,36,32
1657539413113,MATH 103A,B03,093562,Greenfeld; Be'Eri,3,0,36,33
1657539419151,MATH 105,A01,085443,Carter; Anne Toulson,15,0,35,20
1657539419151,MATH 105,A02,093477,Carter; Anne Toulson,20,0,35,15
1657539425187,MATH 109,A01,083213,Ganzberger; Geoffrey Michael,2,0,34,32
1657539425187,MATH 109,A02,083214,Ganzberger; Geoffrey Michael,4,0,34,30
1657539425187,MATH 109,A03,093478,Ganzberger; Geoffrey Michael,2,0,34,32
1657539425187,MATH 109,B01,083215,Ganzberger; Geoffrey Michael,1,0,32,31
1657539425187,MATH 109,B02,083216,Ganzberger; Geoffrey Michael,2,0,32,30
1657539425187,MATH 109,B03,093479,Ganzberger; Geoffrey Michael,8,0,32,24
1657539431219,MATH 142A,A01,083219,Chow; Bennett,7,0,32,25
1657539431219,MATH 142A,A02,083220,Chow; Bennett,10,0,32,22
1657539431219,MATH 142A,A03,093480,Chow; Bennett,8,0,32,24
1657539431219,MATH 142A,B03,093481,Chow; Bennett,8,0,32,24
1657539431219,MATH 142A,B04,093558,Chow; Bennett,13,0,32,19
1657539431219,MATH 142A,B05,093559,Chow; Bennett,6,0,32,26
1657539437249,MATH 193A,A01,083224,Rotar; Vladimir,8,0,34,26
1657539437249,MATH 193A,A02,083225,Rotar; Vladimir,9,0,34,25
1657539437249,MATH 193A,A03,083781,Rotar; Vladimir,5,0,34,29
1657539437249,MATH 193A,A04,083782,Rotar; Vladimir,10,0,34,24
1657539437249,MATH 193A,A05,093482,Rotar; Vladimir,10,0,34,24
1657539443279,MATH 197,001,091859,McAuley; Julian John,9999,0,9999,0
1657539443279,MATH 197,002,095566,Kedlaya; Kiran S.,9997,0,9999,2
1657539443279,MATH 197,003,095567,Xiao; Ming,9999,0,9999,0
1657539443279,MATH 197,004,095571,Perols; Johan Lars,9998,0,9999,1
1657539450355,COGS 9,A01,083615,Shannon; Kyle Michael,9,0,75,66
1657539456389,COGS 11,A01,083617,Boyle; Mary E. T.,22,0,48,26
1657539462424,COGS 13,A01,083071,Bastos; Amalia Pinkusfeld,11,0,71,60
1657539468452,COGS 14A,A01,092681,Semenuks; Arturs,5,1,100,95
1657539474476,COGS 14B,A01,083073,Cheng; Tzu-Han,6,0,63,57
1657539480509,COGS 17,A01,092677,Semenuks; Arturs,6,0,81,75
1657539486537,COGS 100,A01,083619,Allen; Michael Gordon,17,0,70,53
1657539492651,COGS 101A,A01,083621,Davis; Joshua Daniel,9,0,68,59
1657539498682,COGS 101B,A01,091572,Allen; Michael Gordon,12,0,65,53
1657539504710,COGS 101C,A01,083625,Delgado; Tania,17,0,35,18
1657539510739,COGS 107A,A01,083627,Boyle; Mary E. T.,13,0,60,47
1657539516765,COGS 118A,A01,083075,Gupta; Anjum,21,0,76,55
1657539522795,CSE 3,A50,083646,Miranda; Gregory Joseph,24,0,50,26
1657539528828,CSE 8A,A50,083650,Miranda; Gregory Joseph,17,1,56,39
1657539534861,CSE 11,A01,083080,Cao; Yingjun,6,15,40,34
1657539540891,CSE 12,A01,083652,Krause-Levy; Sophia Louisa,28,1,120,92
1657539546927,CSE 15L,A01,083654,Morris; Justin Loren,9,0,50,41
1657539546927,CSE 15L,A02,083655,Morris; Justin Loren,9,0,50,41
1657539552955,CSE 20,A01,083657,Tran; Khoa Dang,39,0,80,41
1657539558984,CSE 21,A01,095574,Bach; Quang Tran,22,0,48,26
1657539565012,CSE 30,A01,083084,Eldon; John,5,0,80,75
1657539565012,CSE 30,B01,095061,Bhaskar; Nishant,9,0,50,41
1657539571043,CSE 100,A01,083659,Cao; Yingjun,5,4,70,65
1657539577075,CSE 134B,A01,083661,Powell; Thomas Allan,22,0,100,78
1657539583104,CSE 140,A01,083663,Gungor; Onat,15,0,85,70
1657539589132,CSE 140L,A01,083088,Eldon; John,21,0,100,79
1657539595158,CSE 175,A01,083665,Kumar; Rakesh,3,0,25,22
1657539601185,CSE 190,A00,092507,Dubnov; Shlomo,8,0,20,12
1657539607214,ECE 45,A01,083139,Congero; Spencer William,6,0,75,69
1657539613242,ECE 65,A50,083695,Saad; Andrew S,12,0,30,18
1657539613242,ECE 65,A51,095125,Saad; Andrew S,24,0,26,2
1657539619270,ECE 109,A01,091882,Touri; Behrouz,19,0,70,51
1657539625297,ECE 180,A00,083140,Abi Samra; Nicholas Camill,1,0,30,29
1657539625297,ECE 180,B00,083141,Abi Samra; Nicholas Camill,0,0,30,30
1657539631327,MATH 10A,A01,083735,Patchell; Gregory David,2,0,30,28
1657539631327,MATH 10A,A02,083736,Patchell; Gregory David,20,0,30,10
1657539631327,MATH 10A,A03,083737,Patchell; Gregory David,16,0,30,14
1657539637361,MATH 10B,A01,083207,Lim; Seonhee,8,0,34,26
1657539637361,MATH 10B,A02,083208,Lim; Seonhee,9,0,35,26
1657539637361,MATH 10B,A03,093472,Lim; Seonhee,7,0,34,27
1657539637361,MATH 10B,B01,083739,Sinha; Shubham,12,0,30,18
1657539643404,MATH 18,A01,083743,Cinel; Cameron Alexander,7,0,30,23
1657539643404,MATH 18,A02,083744,Cinel; Cameron Alexander,17,0,30,13
1657539643404,MATH 18,A03,083745,Cinel; Cameron Alexander,9,0,30,21
1657539643404,MATH 18,B01,083748,Rideout; David Porter,5,0,37,32
1657539643404,MATH 18,B02,083749,Rideout; David Porter,5,0,36,31
1657539643404,MATH 18,B03,083750,Rideout; David Porter,3,0,37,34
1657539643404,MATH 18,B04,083751,Rideout; David Porter,6,0,36,30
1657539643404,MATH 18,B05,093473,Rideout; David Porter,6,0,36,30
1657539643404,MATH 18,B06,093474,Rideout; David Porter,6,0,36,30
1657539649429,MATH 20A,A01,083754,Zheng; Zequn,14,0,40,26
1657539655456,MATH 20B,A01,083756,Briones; Jor-el Thomas Caparas,4,0,36,32
1657539655456,MATH 20B,A02,083757,Briones; Jor-el Thomas Caparas,1,0,36,35
1657539655456,MATH 20B,A03,093475,Briones; Jor-el Thomas Caparas,2,0,36,34
1657539661486,MATH 20C,A01,083760,Briones; Jor-el Thomas Caparas,1,0,35,34
1657539661486,MATH 20C,A02,083761,Briones; Jor-el Thomas Caparas,8,0,35,27
1657539661486,MATH 20C,A03,093476,Briones; Jor-el Thomas Caparas,0,1,36,36
1657539661486,MATH 20C,B01,083762,Bach; Quang Tran,1,0,30,29
1657539667516,MATH 20D,A01,083765,Tran; Brian Kha,5,0,30,25
1657539667516,MATH 20D,A02,083766,Tran; Brian Kha,5,0,30,25
1657539667516,MATH 20D,A03,083767,Tran; Brian Kha,5,0,30,25
1657539673553,MATH 20E,A01,083771,Ganguly; Soumya,9,0,32,23
1657539673553,MATH 20E,A02,083772,Ganguly; Soumya,6,0,32,26
1657539673553,MATH 20E,B01,083773,Ciotti; Benjamin,20,0,35,15
1657539673553,MATH 20E,B02,083774,Ciotti; Benjamin,17,0,35,18
1657539679582,MATH 103A,A01,083777,Greenfeld; Be'Eri,3,0,36,33
1657539679582,MATH 103A,A02,083778,Greenfeld; Be'Eri,5,0,36,31
1657539679582,MATH 103A,A03,093561,Greenfeld; Be'Eri,5,0,36,31
1657539679582,MATH 103A,B01,083779,Greenfeld; Be'Eri,7,0,36,29
1657539679582,MATH 103A,B02,083780,Greenfeld; Be'Eri,4,0,36,32
1657539679582,MATH 103A,B03,093562,Greenfeld; Be'Eri,3,0,36,33
1657539685616,MATH 105,A01,085443,Carter; Anne Toulson,15,0,35,20
1657539685616,MATH 105,A02,093477,Carter; Anne Toulson,20,0,35,15
1657539691645,MATH 109,A01,083213,Ganzberger; Geoffrey Michael,2,0,34,32
1657539691645,MATH 109,A02,083214,Ganzberger; Geoffrey Michael,4,0,34,30
1657539691645,MATH 109,A03,093478,Ganzberger; Geoffrey Michael,2,0,34,32
1657539691645,MATH 109,B01,083215,Ganzberger; Geoffrey Michael,1,0,32,31
1657539691645,MATH 109,B02,083216,Ganzberger; Geoffrey Michael,2,0,32,30
1657539691645,MATH 109,B03,093479,Ganzberger; Geoffrey Michael,8,0,32,24
1657539697671,MATH 142A,A01,083219,Chow; Bennett,7,0,32,25
1657539697671,MATH 142A,A02,083220,Chow; Bennett,10,0,32,22
1657539697671,MATH 142A,A03,093480,Chow; Bennett,8,0,32,24
1657539697671,MATH 142A,B03,093481,Chow; Bennett,8,0,32,24
1657539697671,MATH 142A,B04,093558,Chow; Bennett,13,0,32,19
1657539697671,MATH 142A,B05,093559,Chow; Bennett,6,0,32,26
1657539703697,MATH 193A,A01,083224,Rotar; Vladimir,8,0,34,26
1657539703697,MATH 193A,A02,083225,Rotar; Vladimir,9,0,34,25
1657539703697,MATH 193A,A03,083781,Rotar; Vladimir,5,0,34,29
1657539703697,MATH 193A,A04,083782,Rotar; Vladimir,10,0,34,24
1657539703697,MATH 193A,A05,093482,Rotar; Vladimir,10,0,34,24
1657539709724,MATH 197,001,091859,McAuley; Julian John,9999,0,9999,0
1657539709724,MATH 197,002,095566,Kedlaya; Kiran S.,9997,0,9999,2
1657539709724,MATH 197,003,095567,Xiao; Ming,9999,0,9999,0
1657539709724,MATH 197,004,095571,Perols; Johan Lars,9998,0,9999,1
1657539716806,COGS 9,A01,083615,Shannon; Kyle Michael,9,0,75,66
1657539722839,COGS 11,A01,083617,Boyle; Mary E. T.,22,0,48,26
1657539728872,COGS 13,A01,083071,Bastos; Amalia Pinkusfeld,11,0,71,60
1657539734906,COGS 14A,A01,092681,Semenuks; Arturs,5,1,100,95
1657539740962,COGS 14B,A01,083073,Cheng; Tzu-Han,6,0,63,57
1657539746994,COGS 17,A01,092677,Semenuks; Arturs,6,0,81,75
1657539753023,COGS 100,A01,083619,Allen; Michael Gordon,17,0,70,53
1657539759051,COGS 101A,A01,083621,Davis; Joshua Daniel,9,0,68,59
1657539765082,COGS 101B,A01,091572,Allen; Michael Gordon,12,0,65,53
1657539771112,COGS 101C,A01,083625,Delgado; Tania,17,0,35,18
1657539777142,COGS 107A,A01,083627,Boyle; Mary E. T.,13,0,60,47
1657539783167,COGS 118A,A01,083075,Gupta; Anjum,21,0,76,55
1657539789195,CSE 3,A50,083646,Miranda; Gregory Joseph,24,0,50,26
1657539795227,CSE 8A,A50,083650,Miranda; Gregory Joseph,17,1,56,39
1657539801254,CSE 11,A01,083080,Cao; Yingjun,6,15,40,34
1657539807283,CSE 12,A01,083652,Krause-Levy; Sophia Louisa,28,1,120,92
1657539813317,CSE 15L,A01,083654,Morris; Justin Loren,9,0,50,41
1657539813317,CSE 15L,A02,083655,Morris; Justin Loren,9,0,50,41
1657539819350,CSE 20,A01,083657,Tran; Khoa Dang,39,0,80,41
1657539825380,CSE 21,A01,095574,Bach; Quang Tran,22,0,48,26
1657539831420,CSE 30,A01,083084,Eldon; John,5,0,80,75
1657539831420,CSE 30,B01,095061,Bhaskar; Nishant,9,0,50,41
1657539837447,CSE 100,A01,083659,Cao; Yingjun,5,4,70,65
1657539843473,CSE 134B,A01,083661,Powell; Thomas Allan,22,0,100,78
1657539849499,CSE 140,A01,083663,Gungor; Onat,15,0,85,70
1657539855525,CSE 140L,A01,083088,Eldon; John,21,0,100,79
1657539861558,CSE 175,A01,083665,Kumar; Rakesh,3,0,25,22
1657539867585,CSE 190,A00,092507,Dubnov; Shlomo,8,0,20,12
1657539873617,ECE 45,A01,083139,Congero; Spencer William,6,0,75,69
1657539879650,ECE 65,A50,083695,Saad; Andrew S,12,0,30,18
1657539879650,ECE 65,A51,095125,Saad; Andrew S,24,0,26,2
1657539885683,ECE 109,A01,091882,Touri; Behrouz,19,0,70,51
1657539891718,ECE 180,A00,083140,Abi Samra; Nicholas Camill,1,0,30,29
1657539891718,ECE 180,B00,083141,Abi Samra; Nicholas Camill,0,0,30,30
1657539897756,MATH 10A,A01,083735,Patchell; Gregory David,2,0,30,28
1657539897756,MATH 10A,A02,083736,Patchell; Gregory David,20,0,30,10
1657539897756,MATH 10A,A03,083737,Patchell; Gregory David,16,0,30,14
1657539903797,MATH 10B,A01,083207,Lim; Seonhee,8,0,34,26
1657539903797,MATH 10B,A02,083208,Lim; Seonhee,9,0,35,26
1657539903797,MATH 10B,A03,093472,Lim; Seonhee,7,0,34,27
1657539903797,MATH 10B,B01,083739,Sinha; Shubham,12,0,30,18
1657539909840,MATH 18,A01,083743,Cinel; Cameron Alexander,7,0,30,23
1657539909840,MATH 18,A02,083744,Cinel; Cameron Alexander,17,0,30,13
1657539909840,MATH 18,A03,083745,Cinel; Cameron Alexander,9,0,30,21
1657539909840,MATH 18,B01,083748,Rideout; David Porter,5,0,37,32
1657539909840,MATH 18,B02,083749,Rideout; David Porter,5,0,36,31
1657539909840,MATH 18,B03,083750,Rideout; David Porter,3,0,37,34
1657539909840,MATH 18,B04,083751,Rideout; David Porter,6,0,36,30
1657539909840,MATH 18,B05,093473,Rideout; David Porter,6,0,36,30
1657539909840,MATH 18,B06,093474,Rideout; David Porter,6,0,36,30
1657539915871,MATH 20A,A01,083754,Zheng; Zequn,14,0,40,26
1657539921909,MATH 20B,A01,083756,Briones; Jor-el Thomas Caparas,4,0,36,32
1657539921909,MATH 20B,A02,083757,Briones; Jor-el Thomas Caparas,1,0,36,35
1657539921909,MATH 20B,A03,093475,Briones; Jor-el Thomas Caparas,2,0,36,34
1657539927938,MATH 20C,A01,083760,Briones; Jor-el Thomas Caparas,1,0,35,34
1657539927938,MATH 20C,A02,083761,Briones; Jor-el Thomas Caparas,8,0,35,27
1657539927938,MATH 20C,A03,093476,Briones; Jor-el Thomas Caparas,0,1,36,36
1657539927938,MATH 20C,B01,083762,Bach; Quang Tran,1,0,30,29
1657539933968,MATH 20D,A01,083765,Tran; Brian Kha,5,0,30,25
1657539933968,MATH 20D,A02,083766,Tran; Brian Kha,5,0,30,25
1657539933968,MATH 20D,A03,083767,Tran; Brian Kha,5,0,30,25
1657539939996,MATH 20E,A01,083771,Ganguly; Soumya,9,0,32,23
1657539939996,MATH 20E,A02,083772,Ganguly; Soumya,6,0,32,26
1657539939996,MATH 20E,B01,083773,Ciotti; Benjamin,20,0,35,15
1657539939996,MATH 20E,B02,083774,Ciotti; Benjamin,17,0,35,18
1657539946025,MATH 103A,A01,083777,Greenfeld; Be'Eri,3,0,36,33
1657539946025,MATH 103A,A02,083778,Greenfeld; Be'Eri,5,0,36,31
1657539946025,MATH 103A,A03,093561,Greenfeld; Be'Eri,5,0,36,31
1657539946025,MATH 103A,B01,083779,Greenfeld; Be'Eri,7,0,36,29
1657539946025,MATH 103A,B02,083780,Greenfeld; Be'Eri,4,0,36,32
1657539946025,MATH 103A,B03,093562,Greenfeld; Be'Eri,3,0,36,33
1657539952056,MATH 105,A01,085443,Carter; Anne Toulson,15,0,35,20
1657539952056,MATH 105,A02,093477,Carter; Anne Toulson,20,0,35,15
1657539958092,MATH 109,A01,083213,Ganzberger; Geoffrey Michael,2,0,34,32
1657539958092,MATH 109,A02,083214,Ganzberger; Geoffrey Michael,4,0,34,30
1657539958092,MATH 109,A03,093478,Ganzberger; Geoffrey Michael,2,0,34,32
1657539958092,MATH 109,B01,083215,Ganzberger; Geoffrey Michael,1,0,32,31
1657539958092,MATH 109,B02,083216,Ganzberger; Geoffrey Michael,2,0,32,30
1657539958092,MATH 109,B03,093479,Ganzberger; Geoffrey Michael,8,0,32,24
1657539964129,MATH 142A,A01,083219,Chow; Bennett,7,0,32,25
1657539964129,MATH 142A,A02,083220,Chow; Bennett,10,0,32,22
1657539964129,MATH 142A,A03,093480,Chow; Bennett,8,0,32,24
1657539964129,MATH 142A,B03,093481,Chow; Bennett,8,0,32,24
1657539964129,MATH 142A,B04,093558,Chow; Bennett,13,0,32,19
1657539964129,MATH 142A,B05,093559,Chow; Bennett,6,0,32,26
1657539970162,MATH 193A,A01,083224,Rotar; Vladimir,8,0,34,26
1657539970162,MATH 193A,A02,083225,Rotar; Vladimir,9,0,34,25
1657539970162,MATH 193A,A03,083781,Rotar; Vladimir,5,0,34,29
1657539970162,MATH 193A,A04,083782,Rotar; Vladimir,10,0,34,24
1657539970162,MATH 193A,A05,093482,Rotar; Vladimir,10,0,34,24
1657539976190,MATH 197,001,091859,McAuley; Julian John,9999,0,9999,0
1657539976190,MATH 197,002,095566,Kedlaya; Kiran S.,9997,0,9999,2
1657539976190,MATH 197,003,095567,Xiao; Ming,9999,0,9999,0
1657539976190,MATH 197,004,095571,Perols; Johan Lars,9998,0,9999,1
1657539983282,COGS 9,A01,083615,Shannon; Kyle Michael,9,0,75,66
1657539989315,COGS 11,A01,083617,Boyle; Mary E. T.,22,0,48,26
1657539995353,COGS 13,A01,083071,Bastos; Amalia Pinkusfeld,11,0,71,60
1657540001385,COGS 14A,A01,092681,Semenuks; Arturs,5,1,100,95
1657540007411,COGS 14B,A01,083073,Cheng; Tzu-Han,6,0,63,57
1657540013437,COGS 17,A01,092677,Semenuks; Arturs,6,0,81,75
1657540019464,COGS 100,A01,083619,Allen; Michael Gordon,17,0,70,53
1657540025490,COGS 101A,A01,083621,Davis; Joshua Daniel,9,0,68,59
1657540031519,COGS 101B,A01,091572,Allen; Michael Gordon,12,0,65,53
1657540037550,COGS 101C,A01,083625,Delgado; Tania,17,0,35,18
1657540043580,COGS 107A,A01,083627,Boyle; Mary E. T.,13,0,60,47
1657540049612,COGS 118A,A01,083075,Gupta; Anjum,21,0,76,55
1657540055648,CSE 3,A50,083646,Miranda; Gregory Joseph,24,0,50,26
1657540061675,CSE 8A,A50,083650,Miranda; Gregory Joseph,17,1,56,39
1657540067702,CSE 11,A01,083080,Cao; Yingjun,6,15,40,34
1657540073730,CSE 12,A01,083652,Krause-Levy; Sophia Louisa,28,1,120,92
1657540079763,CSE 15L,A01,083654,Morris; Justin Loren,9,0,50,41
1657540079763,CSE 15L,A02,083655,Morris; Justin Loren,9,0,50,41
1657540085791,CSE 20,A01,083657,Tran; Khoa Dang,39,0,80,41
1657540091901,CSE 21,A01,095574,Bach; Quang Tran,22,0,48,26
1657540097928,CSE 30,A01,083084,Eldon; John,5,0,80,75
1657540097928,CSE 30,B01,095061,Bhaskar; Nishant,9,0,50,41
1657540103960,CSE 100,A01,083659,Cao; Yingjun,5,4,70,65
1657540109991,CSE 134B,A01,083661,Powell; Thomas Allan,22,0,100,78
1657540116017,CSE 140,A01,083663,Gungor; Onat,15,0,85,70
1657540122046,CSE 140L,A01,083088,Eldon; John,21,0,100,79
1657540128075,CSE 175,A01,083665,Kumar; Rakesh,3,0,25,22
1657540134105,CSE 190,A00,092507,Dubnov; Shlomo,8,0,20,12
1657540140131,ECE 45,A01,083139,Congero; Spencer William,6,0,75,69
1657540146161,ECE 65,A50,083695,Saad; Andrew S,12,0,30,18
1657540146161,ECE 65,A51,095125,Saad; Andrew S,24,0,26,2
1657540152190,ECE 109,A01,091882,Touri; Behrouz,19,0,70,51
1657540158220,ECE 180,A00,083140,Abi Samra; Nicholas Camill,1,0,30,29
1657540158220,ECE 180,B00,083141,Abi Samra; Nicholas Camill,0,0,30,30
1657540164256,MATH 10A,A01,083735,Patchell; Gregory David,2,0,30,28
1657540164256,MATH 10A,A02,083736,Patchell; Gregory David,20,0,30,10
1657540164256,MATH 10A,A03,083737,Patchell; Gregory David,16,0,30,14
1657540170287,MATH 10B,A01,083207,Lim; Seonhee,8,0,34,26
1657540170287,MATH 10B,A02,083208,Lim; Seonhee,9,0,35,26
1657540170287,MATH 10B,A03,093472,Lim; Seonhee,7,0,34,27
1657540170287,MATH 10B,B01,083739,Sinha; Shubham,12,0,30,18
1657540176319,MATH 18,A01,083743,Cinel; Cameron Alexander,7,0,30,23
1657540176319,MATH 18,A02,083744,Cinel; Cameron Alexander,17,0,30,13
1657540176319,MATH 18,A03,083745,Cinel; Cameron Alexander,9,0,30,21
1657540176319,MATH 18,B01,083748,Rideout; David Porter,5,0,37,32
1657540176319,MATH 18,B02,083749,Rideout; David Porter,5,0,36,31
1657540176319,MATH 18,B03,083750,Rideout; David Porter,3,0,37,34
1657540176319,MATH 18,B04,083751,Rideout; David Porter,6,0,36,30
1657540176319,MATH 18,B05,093473,Rideout; David Porter,6,0,36,30
1657540176319,MATH 18,B06,093474,Rideout; David Porter,6,0,36,30
1657540182346,MATH 20A,A01,083754,Zheng; Zequn,14,0,40,26
1657540188375,MATH 20B,A01,083756,Briones; Jor-el Thomas Caparas,4,0,36,32
1657540188375,MATH 20B,A02,083757,Briones; Jor-el Thomas Caparas,1,0,36,35
1657540188375,MATH 20B,A03,093475,Briones; Jor-el Thomas Caparas,2,0,36,34
1657540194403,MATH 20C,A01,083760,Briones; Jor-el Thomas Caparas,1,0,35,34
1657540194403,MATH 20C,A02,083761,Briones; Jor-el Thomas Caparas,8,0,35,27
1657540194403,MATH 20C,A03,093476,Briones; Jor-el Thomas Caparas,0,1,36,36
1657540194403,MATH 20C,B01,083762,Bach; Quang Tran,1,0,30,29
1657540200436,MATH 20D,A01,083765,Tran; Brian Kha,5,0,30,25
1657540200436,MATH 20D,A02,083766,Tran; Brian Kha,5,0,30,25
1657540200436,MATH 20D,A03,083767,Tran; Brian Kha,5,0,30,25
1657540206470,MATH 20E,A01,083771,Ganguly; Soumya,9,0,32,23
1657540206470,MATH 20E,A02,083772,Ganguly; Soumya,6,0,32,26
1657540206470,MATH 20E,B01,083773,Ciotti; Benjamin,20,0,35,15
1657540206470,MATH 20E,B02,083774,Ciotti; Benjamin,17,0,35,18
1657540212510,MATH 103A,A01,083777,Greenfeld; Be'Eri,3,0,36,33
1657540212510,MATH 103A,A02,083778,Greenfeld; Be'Eri,5,0,36,31
1657540212510,MATH 103A,A03,093561,Greenfeld; Be'Eri,5,0,36,31
1657540212510,MATH 103A,B01,083779,Greenfeld; Be'Eri,7,0,36,29
1657540212510,MATH 103A,B02,083780,Greenfeld; Be'Eri,4,0,36,32
1657540212510,MATH 103A,B03,093562,Greenfeld; Be'Eri,3,0,36,33
1657540218542,MATH 105,A01,085443,Carter; Anne Toulson,15,0,35,20
1657540218542,MATH 105,A02,093477,Carter; Anne Toulson,20,0,35,15
1657540224568,MATH 109,A01,083213,Ganzberger; Geoffrey Michael,2,0,34,32
1657540224568,MATH 109,A02,083214,Ganzberger; Geoffrey Michael,4,0,34,30
1657540224568,MATH 109,A03,093478,Ganzberger; Geoffrey Michael,2,0,34,32
1657540224568,MATH 109,B01,083215,Ganzberger; Geoffrey Michael,1,0,32,31
1657540224568,MATH 109,B02,083216,Ganzberger; Geoffrey Michael,2,0,32,30
1657540224568,MATH 109,B03,093479,Ganzberger; Geoffrey Michael,8,0,32,24
1657540230599,MATH 142A,A01,083219,Chow; Bennett,7,0,32,25
1657540230599,MATH 142A,A02,083220,Chow; Bennett,10,0,32,22
1657540230599,MATH 142A,A03,093480,Chow; Bennett,8,0,32,24
1657540230599,MATH 142A,B03,093481,Chow; Bennett,8,0,32,24
1657540230599,MATH 142A,B04,093558,Chow; Bennett,13,0,32,19
1657540230599,MATH 142A,B05,093559,Chow; Bennett,6,0,32,26
1657540236626,MATH 193A,A01,083224,Rotar; Vladimir,8,0,34,26
1657540236626,MATH 193A,A02,083225,Rotar; Vladimir,9,0,34,25
1657540236626,MATH 193A,A03,083781,Rotar; Vladimir,5,0,34,29
1657540236626,MATH 193A,A04,083782,Rotar; Vladimir,10,0,34,24
1657540236626,MATH 193A,A05,093482,Rotar; Vladimir,10,0,34,24
1657540242654,MATH 197,001,091859,McAuley; Julian John,9999,0,9999,0
1657540242654,MATH 197,002,095566,Kedlaya; Kiran S.,9997,0,9999,2
1657540242654,MATH 197,003,095567,Xiao; Ming,9999,0,9999,0
1657540242654,MATH 197,004,095571,Perols; Johan Lars,9998,0,9999,1
1657540249735,COGS 9,A01,083615,Shannon; Kyle Michael,9,0,75,66
1657540255760,COGS 11,A01,083617,Boyle; Mary E. T.,22,0,48,26
1657540261794,COGS 13,A01,083071,Bastos; Amalia Pinkusfeld,11,0,71,60
1657540267821,COGS 14A,A01,092681,Semenuks; Arturs,5,1,100,95
1657540273846,COGS 14B,A01,083073,Cheng; Tzu-Han,6,0,63,57
1657540279877,COGS 17,A01,092677,Semenuks; Arturs,6,0,81,75
1657540285904,COGS 100,A01,083619,Allen; Michael Gordon,17,0,70,53
1657540291929,COGS 101A,A01,083621,Davis; Joshua Daniel,9,0,68,59
1657540297956,COGS 101B,A01,091572,Allen; Michael Gordon,12,0,65,53
1657540303984,COGS 101C,A01,083625,Delgado; Tania,17,0,35,18
1657540310010,COGS 107A,A01,083627,Boyle; Mary E. T.,13,0,60,47
1657540316038,COGS 118A,A01,083075,Gupta; Anjum,21,0,76,55
1657540322073,CSE 3,A50,083646,Miranda; Gregory Joseph,24,0,50,26
1657540328101,CSE 8A,A50,083650,Miranda; Gregory Joseph,17,1,56,39
1657540334129,CSE 11,A01,083080,Cao; Yingjun,6,15,40,34
1657540340156,CSE 12,A01,083652,Krause-Levy; Sophia Louisa,28,1,120,92
1657540346189,CSE 15L,A01,083654,Morris; Justin Loren,9,0,50,41
1657540346189,CSE 15L,A02,083655,Morris; Justin Loren,9,0,50,41
1657540352216,CSE 20,A01,083657,Tran; Khoa Dang,39,0,80,41
1657540358245,CSE 21,A01,095574,Bach; Quang Tran,22,0,48,26
1657540364274,CSE 30,A01,083084,Eldon; John,5,0,80,75
1657540364274,CSE 30,B01,095061,Bhaskar; Nishant,9,0,50,41
1657540370298,CSE 100,A01,083659,Cao; Yingjun,5,4,70,65
1657540376334,CSE 134B,A01,083661,Powell; Thomas Allan,22,0,100,78
1657540382373,CSE 140,A01,083663,Gungor; Onat,15,0,85,70
1657540388405,CSE 140L,A01,083088,Eldon; John,21,0,100,79
1657540394436,CSE 175,A01,083665,Kumar; Rakesh,3,0,25,22
1657540400464,CSE 190,A00,092507,Dubnov; Shlomo,8,0,20,12
1657540406498,ECE 45,A01,083139,Congero; Spencer William,6,0,75,69
1657540412538,ECE 65,A50,083695,Saad; Andrew S,12,0,30,18
1657540412538,ECE 65,A51,095125,Saad; Andrew S,24,0,26,2
1657540418569,ECE 109,A01,091882,Touri; Behrouz,19,0,70,51
1657540424603,ECE 180,A00,083140,Abi Samra; Nicholas Camill,1,0,30,29
1657540424603,ECE 180,B00,083141,Abi Samra; Nicholas Camill,0,0,30,30
1657540430636,MATH 10A,A01,083735,Patchell; Gregory David,2,0,30,28
1657540430636,MATH 10A,A02,083736,Patchell; Gregory David,20,0,30,10
1657540430636,MATH 10A,A03,083737,Patchell; Gregory David,16,0,30,14
1657540436664,MATH 10B,A01,083207,Lim; Seonhee,8,0,34,26
1657540436664,MATH 10B,A02,083208,Lim; Seonhee,9,0,35,26
1657540436664,MATH 10B,A03,093472,Lim; Seonhee,7,0,34,27
1657540436664,MATH 10B,B01,083739,Sinha; Shubham,12,0,30,18
1657540442696,MATH 18,A01,083743,Cinel; Cameron Alexander,7,0,30,23
1657540442696,MATH 18,A02,083744,Cinel; Cameron Alexander,17,0,30,13
1657540442696,MATH 18,A03,083745,Cinel; Cameron Alexander,9,0,30,21
1657540442696,MATH 18,B01,083748,Rideout; David Porter,5,0,37,32
1657540442696,MATH 18,B02,083749,Rideout; David Porter,5,0,36,31
1657540442696,MATH 18,B03,083750,Rideout; David Porter,3,0,37,34
1657540442696,MATH 18,B04,083751,Rideout; David Porter,6,0,36,30
1657540442696,MATH 18,B05,093473,Rideout; David Porter,6,0,36,30
1657540442696,MATH 18,B06,093474,Rideout; David Porter,6,0,36,30
1657540448725,MATH 20A,A01,083754,Zheng; Zequn,14,0,40,26
1657540454763,MATH 20B,A01,083756,Briones; Jor-el Thomas Caparas,4,0,36,32
1657540454763,MATH 20B,A02,083757,Briones; Jor-el Thomas Caparas,1,0,36,35
1657540454763,MATH 20B,A03,093475,Briones; Jor-el Thomas Caparas,2,0,36,34
1657540460797,MATH 20C,A01,083760,Briones; Jor-el Thomas Caparas,1,0,35,34
1657540460797,MATH 20C,A02,083761,Briones; Jor-el Thomas Caparas,8,0,35,27
1657540460797,MATH 20C,A03,093476,Briones; Jor-el Thomas Caparas,0,1,36,36
1657540460797,MATH 20C,B01,083762,Bach; Quang Tran,1,0,30,29
1657540466826,MATH 20D,A01,083765,Tran; Brian Kha,5,0,30,25
1657540466826,MATH 20D,A02,083766,Tran; Brian Kha,5,0,30,25
1657540466826,MATH 20D,A03,083767,Tran; Brian Kha,5,0,30,25
1657540472854,MATH 20E,A01,083771,Ganguly; Soumya,9,0,32,23
1657540472854,MATH 20E,A02,083772,Ganguly; Soumya,6,0,32,26
1657540472854,MATH 20E,B01,083773,Ciotti; Benjamin,20,0,35,15
1657540472854,MATH 20E,B02,083774,Ciotti; Benjamin,17,0,35,18
1657540478880,MATH 103A,A01,083777,Greenfeld; Be'Eri,3,0,36,33
1657540478880,MATH 103A,A02,083778,Greenfeld; Be'Eri,5,0,36,31
1657540478880,MATH 103A,A03,093561,Greenfeld; Be'Eri,5,0,36,31
1657540478880,MATH 103A,B01,083779,Greenfeld; Be'Eri,7,0,36,29
1657540478880,MATH 103A,B02,083780,Greenfeld; Be'Eri,4,0,36,32
1657540478880,MATH 103A,B03,093562,Greenfeld; Be'Eri,3,0,36,33
1657540484907,MATH 105,A01,085443,Carter; Anne Toulson,15,0,35,20
1657540484907,MATH 105,A02,093477,Carter; Anne Toulson,20,0,35,15
1657540490934,MATH 109,A01,083213,Ganzberger; Geoffrey Michael,2,0,34,32
1657540490934,MATH 109,A02,083214,Ganzberger; Geoffrey Michael,4,0,34,30
1657540490934,MATH 109,A03,093478,Ganzberger; Geoffrey Michael,2,0,34,32
1657540490934,MATH 109,B01,083215,Ganzberger; Geoffrey Michael,1,0,32,31
1657540490934,MATH 109,B02,083216,Ganzberger; Geoffrey Michael,2,0,32,30
1657540490934,MATH 109,B03,093479,Ganzberger; Geoffrey Michael,8,0,32,24
1657540496961,MATH 142A,A01,083219,Chow; Bennett,7,0,32,25
1657540496961,MATH 142A,A02,083220,Chow; Bennett,10,0,32,22
1657540496961,MATH 142A,A03,093480,Chow; Bennett,8,0,32,24
1657540496961,MATH 142A,B03,093481,Chow; Bennett,8,0,32,24
1657540496961,MATH 142A,B04,093558,Chow; Bennett,13,0,32,19
1657540496961,MATH 142A,B05,093559,Chow; Bennett,6,0,32,26
1657540502991,MATH 193A,A01,083224,Rotar; Vladimir,8,0,34,26
1657540502991,MATH 193A,A02,083225,Rotar; Vladimir,9,0,34,25
1657540502991,MATH 193A,A03,083781,Rotar; Vladimir,5,0,34,29
1657540502991,MATH 193A,A04,083782,Rotar; Vladimir,10,0,34,24
1657540502991,MATH 193A,A05,093482,Rotar; Vladimir,10,0,34,24
1657540509018,MATH 197,001,091859,McAuley; Julian John,9999,0,9999,0
1657540509018,MATH 197,002,095566,Kedlaya; Kiran S.,9997,0,9999,2
1657540509018,MATH 197,003,095567,Xiao; Ming,9999,0,9999,0
1657540509018,MATH 197,004,095571,Perols; Johan Lars,9998,0,9999,1
1657540516094,COGS 9,A01,083615,Shannon; Kyle Michael,9,0,75,66
1657540522120,COGS 11,A01,083617,Boyle; Mary E. T.,22,0,48,26
1657540528153,COGS 13,A01,083071,Bastos; Amalia Pinkusfeld,11,0,71,60
1657540534183,COGS 14A,A01,092681,Semenuks; Arturs,5,1,100,95
1657540540210,COGS 14B,A01,083073,Cheng; Tzu-Han,6,0,63,57
1657540546235,COGS 17,A01,092677,Semenuks; Arturs,6,0,81,75
1657540552267,COGS 100,A01,083619,Allen; Michael Gordon,17,0,70,53
1657540558294,COGS 101A,A01,083621,Davis; Joshua Daniel,9,0,68,59
1657540564319,COGS 101B,A01,091572,Allen; Michael Gordon,12,0,65,53
1657540570352,COGS 101C,A01,083625,Delgado; Tania,17,0,35,18
1657540576374,COGS 107A,A01,083627,Boyle; Mary E. T.,13,0,60,47
1657540582402,COGS 118A,A01,083075,Gupta; Anjum,21,0,76,55
1657540588438,CSE 3,A50,083646,Miranda; Gregory Joseph,24,0,50,26
1657540594470,CSE 8A,A50,083650,Miranda; Gregory Joseph,17,1,56,39
1657540600502,CSE 11,A01,083080,Cao; Yingjun,6,15,40,34
1657540606532,CSE 12,A01,083652,Krause-Levy; Sophia Louisa,28,1,120,92
1657540612559,CSE 15L,A01,083654,Morris; Justin Loren,9,0,50,41
1657540612559,CSE 15L,A02,083655,Morris; Justin Loren,9,0,50,41
1657540618588,CSE 20,A01,083657,Tran; Khoa Dang,39,0,80,41
1657540624614,CSE 21,A01,095574,Bach; Quang Tran,22,0,48,26
1657540630644,CSE 30,A01,083084,Eldon; John,5,0,80,75
1657540630644,CSE 30,B01,095061,Bhaskar; Nishant,9,0,50,41
1657540636682,CSE 100,A01,083659,Cao; Yingjun,5,4,70,65
1657540642709,CSE 134B,A01,083661,Powell; Thomas Allan,22,0,100,78
1657540648739,CSE 140,A01,083663,Gungor; Onat,15,0,85,70
1657540654763,CSE 140L,A01,083088,Eldon; John,21,0,100,79
1657540660788,CSE 175,A01,083665,Kumar; Rakesh,3,0,25,22
1657540666825,CSE 190,A00,092507,Dubnov; Shlomo,8,0,20,12
1657540672857,ECE 45,A01,083139,Congero; Spencer William,6,0,75,69
1657540678890,ECE 65,A50,083695,Saad; Andrew S,12,0,30,18
1657540678890,ECE 65,A51,095125,Saad; Andrew S,24,0,26,2
1657540684922,ECE 109,A01,091882,Touri; Behrouz,19,0,70,51
1657540691025,ECE 180,A00,083140,Abi Samra; Nicholas Camill,1,0,30,29
1657540691025,ECE 180,B00,083141,Abi Samra; Nicholas Camill,0,0,30,30
1657540697067,MATH 10A,A01,083735,Patchell; Gregory David,2,0,30,28
1657540697067,MATH 10A,A02,083736,Patchell; Gregory David,20,0,30,10
1657540697067,MATH 10A,A03,083737,Patchell; Gregory David,16,0,30,14
1657540703100,MATH 10B,A01,083207,Lim; Seonhee,8,0,34,26
1657540703100,MATH 10B,A02,083208,Lim; Seonhee,9,0,35,26
1657540703100,MATH 10B,A03,093472,Lim; Seonhee,7,0,34,27
1657540703100,MATH 10B,B01,083739,Sinha; Shubham,12,0,30,18
1657540709129,MATH 18,A01,083743,Cinel; Cameron Alexander,7,0,30,23
1657540709129,MATH 18,A02,083744,Cinel; Cameron Alexander,17,0,30,13
1657540709129,MATH 18,A03,083745,Cinel; Cameron Alexander,9,0,30,21
1657540709129,MATH 18,B01,083748,Rideout; David Porter,5,0,37,32
1657540709129,MATH 18,B02,083749,Rideout; David Porter,5,0,36,31
1657540709129,MATH 18,B03,083750,Rideout; David Porter,3,0,37,34
1657540709129,MATH 18,B04,083751,Rideout; David Porter,6,0,36,30
1657540709129,MATH 18,B05,093473,Rideout; David Porter,6,0,36,30
1657540709129,MATH 18,B06,093474,Rideout; David Porter,6,0,36,30
1657540715154,MATH 20A,A01,083754,Zheng; Zequn,14,0,40,26
1657540721183,MATH 20B,A01,083756,Briones; Jor-el Thomas Caparas,4,0,36,32
1657540721183,MATH 20B,A02,083757,Briones; Jor-el Thomas Caparas,1,0,36,35
1657540721183,MATH 20B,A03,093475,Briones; Jor-el Thomas Caparas,2,0,36,34
1657540727213,MATH 20C,A01,083760,Briones; Jor-el Thomas Caparas,1,0,35,34
1657540727213,MATH 20C,A02,083761,Briones; Jor-el Thomas Caparas,8,0,35,27
1657540727213,MATH 20C,A03,093476,Briones; Jor-el Thomas Caparas,0,1,36,36
1657540727213,MATH 20C,B01,083762,Bach; Quang Tran,1,0,30,29
1657540733248,MATH 20D,A01,083765,Tran; Brian Kha,5,0,30,25
1657540733248,MATH 20D,A02,083766,Tran; Brian Kha,5,0,30,25
1657540733248,MATH 20D,A03,083767,Tran; Brian Kha,5,0,30,25
1657540739277,MATH 20E,A01,083771,Ganguly; Soumya,9,0,32,23
1657540739277,MATH 20E,A02,083772,Ganguly; Soumya,6,0,32,26
1657540739277,MATH 20E,B01,083773,Ciotti; Benjamin,20,0,35,15
1657540739277,MATH 20E,B02,083774,Ciotti; Benjamin,17,0,35,18
1657540745315,MATH 103A,A01,083777,Greenfeld; Be'Eri,3,0,36,33
1657540745315,MATH 103A,A02,083778,Greenfeld; Be'Eri,5,0,36,31
1657540745315,MATH 103A,A03,093561,Greenfeld; Be'Eri,5,0,36,31
1657540745315,MATH 103A,B01,083779,Greenfeld; Be'Eri,7,0,36,29
1657540745315,MATH 103A,B02,083780,Greenfeld; Be'Eri,4,0,36,32
1657540745315,MATH 103A,B03,093562,Greenfeld; Be'Eri,3,0,36,33
1657540751342,MATH 105,A01,085443,Carter; Anne Toulson,15,0,35,20
1657540751342,MATH 105,A02,093477,Carter; Anne Toulson,20,0,35,15
1657540757369,MATH 109,A01,083213,Ganzberger; Geoffrey Michael,2,0,34,32
1657540757369,MATH 109,A02,083214,Ganzberger; Geoffrey Michael,4,0,34,30
1657540757369,MATH 109,A03,093478,Ganzberger; Geoffrey Michael,2,0,34,32
1657540757369,MATH 109,B01,083215,Ganzberger; Geoffrey Michael,1,0,32,31
1657540757369,MATH 109,B02,083216,Ganzberger; Geoffrey Michael,2,0,32,30
1657540757369,MATH 109,B03,093479,Ganzberger; Geoffrey Michael,8,0,32,24
1657540763396,MATH 142A,A01,083219,Chow; Bennett,7,0,32,25
1657540763396,MATH 142A,A02,083220,Chow; Bennett,10,0,32,22
1657540763396,MATH 142A,A03,093480,Chow; Bennett,8,0,32,24
1657540763396,MATH 142A,B03,093481,Chow; Bennett,8,0,32,24
1657540763396,MATH 142A,B04,093558,Chow; Bennett,13,0,32,19
1657540763396,MATH 142A,B05,093559,Chow; Bennett,6,0,32,26
1657540769435,MATH 193A,A01,083224,Rotar; Vladimir,8,0,34,26
1657540769435,MATH 193A,A02,083225,Rotar; Vladimir,9,0,34,25
1657540769435,MATH 193A,A03,083781,Rotar; Vladimir,5,0,34,29
1657540769435,MATH 193A,A04,083782,Rotar; Vladimir,10,0,34,24
1657540769435,MATH 193A,A05,093482,Rotar; Vladimir,10,0,34,24
1657540775461,MATH 197,001,091859,McAuley; Julian John,9999,0,9999,0
1657540775461,MATH 197,002,095566,Kedlaya; Kiran S.,9997,0,9999,2
1657540775461,MATH 197,003,095567,Xiao; Ming,9999,0,9999,0
1657540775461,MATH 197,004,095571,Perols; Johan Lars,9998,0,9999,1
1657540782558,COGS 9,A01,083615,Shannon; Kyle Michael,9,0,75,66
1657540788585,COGS 11,A01,083617,Boyle; Mary E. T.,22,0,48,26
1657540794612,COGS 13,A01,083071,Bastos; Amalia Pinkusfeld,11,0,71,60
1657540800640,COGS 14A,A01,092681,Semenuks; Arturs,5,1,100,95
1657540806674,COGS 14B,A01,083073,Cheng; Tzu-Han,6,0,63,57
1657540812699,COGS 17,A01,092677,Semenuks; Arturs,6,0,81,75
1657540818731,COGS 100,A01,083619,Allen; Michael Gordon,17,0,70,53
1657540824759,COGS 101A,A01,083621,Davis; Joshua Daniel,9,0,68,59
1657540830791,COGS 101B,A01,091572,Allen; Michael Gordon,12,0,65,53
1657540836818,COGS 101C,A01,083625,Delgado; Tania,17,0,35,18
1657540842848,COGS 107A,A01,083627,Boyle; Mary E. T.,13,0,60,47
1657540848875,COGS 118A,A01,083075,Gupta; Anjum,21,0,76,55
1657540854907,CSE 3,A50,083646,Miranda; Gregory Joseph,24,0,50,26
1657540860932,CSE 8A,A50,083650,Miranda; Gregory Joseph,17,1,56,39
1657540866961,CSE 11,A01,083080,Cao; Yingjun,6,15,40,34
1657540872991,CSE 12,A01,083652,Krause-Levy; Sophia Louisa,28,1,120,92
1657540879027,CSE 15L,A01,083654,Morris; Justin Loren,9,0,50,41
1657540879027,CSE 15L,A02,083655,Morris; Justin Loren,9,0,50,41
1657540885052,CSE 20,A01,083657,Tran; Khoa Dang,39,0,80,41
1657540891180,CSE 21,A01,095574,Bach; Quang Tran,22,0,48,26
1657540897214,CSE 30,A01,083084,Eldon; John,5,0,80,75
1657540897214,CSE 30,B01,095061,Bhaskar; Nishant,9,0,50,41
1657540903249,CSE 100,A01,083659,Cao; Yingjun,5,4,70,65
1657540909282,CSE 134B,A01,083661,Powell; Thomas Allan,22,0,100,78
1657540915311,CSE 140,A01,083663,Gungor; Onat,15,0,85,70
1657540921340,CSE 140L,A01,083088,Eldon; John,21,0,100,79
1657540927367,CSE 175,A01,083665,Kumar; Rakesh,3,0,25,22
1657540933394,CSE 190,A00,092507,Dubnov; Shlomo,8,0,20,12
1657540939427,ECE 45,A01,083139,Congero; Spencer William,6,0,75,69
1657540945452,ECE 65,A50,083695,Saad; Andrew S,12,0,30,18
1657540945452,ECE 65,A51,095125,Saad; Andrew S,24,0,26,2
1657540951477,ECE 109,A01,091882,Touri; Behrouz,19,0,70,51
1657540957504,ECE 180,A00,083140,Abi Samra; Nicholas Camill,1,0,30,29
1657540957504,ECE 180,B00,083141,Abi Samra; Nicholas Camill,0,0,30,30
1657540963532,MATH 10A,A01,083735,Patchell; Gregory David,2,0,30,28
1657540963532,MATH 10A,A02,083736,Patchell; Gregory David,20,0,30,10
1657540963532,MATH 10A,A03,083737,Patchell; Gregory David,16,0,30,14
1657540969560,MATH 10B,A01,083207,Lim; Seonhee,8,0,34,26
1657540969560,MATH 10B,A02,083208,Lim; Seonhee,9,0,35,26
1657540969560,MATH 10B,A03,093472,Lim; Seonhee,7,0,34,27
1657540969560,MATH 10B,B01,083739,Sinha; Shubham,12,0,30,18
1657540975595,MATH 18,A01,083743,Cinel; Cameron Alexander,7,0,30,23
1657540975595,MATH 18,A02,083744,Cinel; Cameron Alexander,17,0,30,13
1657540975595,MATH 18,A03,083745,Cinel; Cameron Alexander,9,0,30,21
1657540975595,MATH 18,B01,083748,Rideout; David Porter,5,0,37,32
1657540975595,MATH 18,B02,083749,Rideout; David Porter,5,0,36,31
1657540975595,MATH 18,B03,083750,Rideout; David Porter,3,0,37,34
1657540975595,MATH 18,B04,083751,Rideout; David Porter,6,0,36,30
1657540975595,MATH 18,B05,093473,Rideout; David Porter,6,0,36,30
1657540975595,MATH 18,B06,093474,Rideout; David Porter,6,0,36,30
1657540981622,MATH 20A,A01,083754,Zheng; Zequn,14,0,40,26
1657540987666,MATH 20B,A01,083756,Briones; Jor-el Thomas Caparas,4,0,36,32
1657540987666,MATH 20B,A02,083757,Briones; Jor-el Thomas Caparas,1,0,36,35
1657540987666,MATH 20B,A03,093475,Briones; Jor-el Thomas Caparas,2,0,36,34
1657540993693,MATH 20C,A01,083760,Briones; Jor-el Thomas Caparas,1,0,35,34
1657540993693,MATH 20C,A02,083761,Briones; Jor-el Thomas Caparas,8,0,35,27
1657540993693,MATH 20C,A03,093476,Briones; Jor-el Thomas Caparas,0,1,36,36
1657540993693,MATH 20C,B01,083762,Bach; Quang Tran,1,0,30,29
1657540999725,MATH 20D,A01,083765,Tran; Brian Kha,5,0,30,25
1657540999725,MATH 20D,A02,083766,Tran; Brian Kha,5,0,30,25
1657540999725,MATH 20D,A03,083767,Tran; Brian Kha,5,0,30,25
1657541005762,MATH 20E,A01,083771,Ganguly; Soumya,9,0,32,23
1657541005762,MATH 20E,A02,083772,Ganguly; Soumya,6,0,32,26
1657541005762,MATH 20E,B01,083773,Ciotti; Benjamin,20,0,35,15
1657541005762,MATH 20E,B02,083774,Ciotti; Benjamin,17,0,35,18
1657541011802,MATH 103A,A01,083777,Greenfeld; Be'Eri,3,0,36,33
1657541011802,MATH 103A,A02,083778,Greenfeld; Be'Eri,5,0,36,31
1657541011802,MATH 103A,A03,093561,Greenfeld; Be'Eri,5,0,36,31
1657541011802,MATH 103A,B01,083779,Greenfeld; Be'Eri,7,0,36,29
1657541011802,MATH 103A,B02,083780,Greenfeld; Be'Eri,4,0,36,32
1657541011802,MATH 103A,B03,093562,Greenfeld; Be'Eri,3,0,36,33
1657541017827,MATH 105,A01,085443,Carter; Anne Toulson,15,0,35,20
1657541017827,MATH 105,A02,093477,Carter; Anne Toulson,20,0,35,15
1657541023867,MATH 109,A01,083213,Ganzberger; Geoffrey Michael,2,0,34,32
1657541023867,MATH 109,A02,083214,Ganzberger; Geoffrey Michael,4,0,34,30
1657541023867,MATH 109,A03,093478,Ganzberger; Geoffrey Michael,2,0,34,32
1657541023867,MATH 109,B01,083215,Ganzberger; Geoffrey Michael,1,0,32,31
1657541023867,MATH 109,B02,083216,Ganzberger; Geoffrey Michael,2,0,32,30
1657541023867,MATH 109,B03,093479,Ganzberger; Geoffrey Michael,8,0,32,24
1657541029902,MATH 142A,A01,083219,Chow; Bennett,7,0,32,25
1657541029902,MATH 142A,A02,083220,Chow; Bennett,10,0,32,22
1657541029902,MATH 142A,A03,093480,Chow; Bennett,8,0,32,24
1657541029902,MATH 142A,B03,093481,Chow; Bennett,8,0,32,24
1657541029902,MATH 142A,B04,093558,Chow; Bennett,13,0,32,19
1657541029902,MATH 142A,B05,093559,Chow; Bennett,6,0,32,26
1657541035936,MATH 193A,A01,083224,Rotar; Vladimir,8,0,34,26
1657541035936,MATH 193A,A02,083225,Rotar; Vladimir,9,0,34,25
1657541035936,MATH 193A,A03,083781,Rotar; Vladimir,5,0,34,29
1657541035936,MATH 193A,A04,083782,Rotar; Vladimir,10,0,34,24
1657541035936,MATH 193A,A05,093482,Rotar; Vladimir,10,0,34,24
1657541041963,MATH 197,001,091859,McAuley; Julian John,9999,0,9999,0
1657541041963,MATH 197,002,095566,Kedlaya; Kiran S.,9997,0,9999,2
1657541041963,MATH 197,003,095567,Xiao; Ming,9999,0,9999,0
1657541041963,MATH 197,004,095571,Perols; Johan Lars,9998,0,9999,1
1657541049045,COGS 9,A01,083615,Shannon; Kyle Michael,9,0,75,66
1657541055078,COGS 11,A01,083617,Boyle; Mary E. T.,22,0,48,26
1657541061104,COGS 13,A01,083071,Bastos; Amalia Pinkusfeld,11,0,71,60
1657541067134,COGS 14A,A01,092681,Semenuks; Arturs,5,1,100,95
1657541073162,COGS 14B,A01,083073,Cheng; Tzu-Han,6,0,63,57
1657541079187,COGS 17,A01,092677,Semenuks; Arturs,6,0,81,75
1657541085213,COGS 100,A01,083619,Allen; Michael Gordon,17,0,70,53
1657541091241,COGS 101A,A01,083621,Davis; Joshua Daniel,9,0,68,59
1657541097274,COGS 101B,A01,091572,Allen; Michael Gordon,12,0,65,53
1657541103309,COGS 101C,A01,083625,Delgado; Tania,17,0,35,18
1657541109341,COGS 107A,A01,083627,Boyle; Mary E. T.,13,0,60,47
1657541115374,COGS 118A,A01,083075,Gupta; Anjum,21,0,76,55
1657541121399,CSE 3,A50,083646,Miranda; Gregory Joseph,24,0,50,26
1657541127425,CSE 8A,A50,083650,Miranda; Gregory Joseph,17,1,56,39
1657541133454,CSE 11,A01,083080,Cao; Yingjun,6,15,40,34
1657541139487,CSE 12,A01,083652,Krause-Levy; Sophia Louisa,28,1,120,92
1657541145518,CSE 15L,A01,083654,Morris; Justin Loren,9,0,50,41
1657541145518,CSE 15L,A02,083655,Morris; Justin Loren,9,0,50,41
1657541151545,CSE 20,A01,083657,Tran; Khoa Dang,39,0,80,41
1657541157570,CSE 21,A01,095574,Bach; Quang Tran,22,0,48,26
1657541163607,CSE 30,A01,083084,Eldon; John,5,0,80,75
1657541163607,CSE 30,B01,095061,Bhaskar; Nishant,9,0,50,41
1657541169641,CSE 100,A01,083659,Cao; Yingjun,5,4,70,65
1657541175666,CSE 134B,A01,083661,Powell; Thomas Allan,22,0,100,78
1657541181696,CSE 140,A01,083663,Gungor; Onat,15,0,85,70
1657541187727,CSE 140L,A01,083088,Eldon; John,21,0,100,79
1657541193751,CSE 175,A01,083665,Kumar; Rakesh,3,0,25,22
1657541199780,CSE 190,A00,092507,Dubnov; Shlomo,8,0,20,12
1657541205809,ECE 45,A01,083139,Congero; Spencer William,6,0,75,69
1657541211842,ECE 65,A50,083695,Saad; Andrew S,12,0,30,18
1657541211842,ECE 65,A51,095125,Saad; Andrew S,24,0,26,2
1657541217872,ECE 109,A01,091882,Touri; Behrouz,19,0,70,51
1657541223902,ECE 180,A00,083140,Abi Samra; Nicholas Camill,1,0,30,29
1657541223902,ECE 180,B00,083141,Abi Samra; Nicholas Camill,0,0,30,30
1657541229937,MATH 10A,A01,083735,Patchell; Gregory David,2,0,30,28
1657541229937,MATH 10A,A02,083736,Patchell; Gregory David,20,0,30,10
1657541229937,MATH 10A,A03,083737,Patchell; Gregory David,16,0,30,14
1657541235967,MATH 10B,A01,083207,Lim; Seonhee,8,0,34,26
1657541235967,MATH 10B,A02,083208,Lim; Seonhee,9,0,35,26
1657541235967,MATH 10B,A03,093472,Lim; Seonhee,7,0,34,27
1657541235967,MATH 10B,B01,083739,Sinha; Shubham,12,0,30,18
1657541241999,MATH 18,A01,083743,Cinel; Cameron Alexander,7,0,30,23
1657541241999,MATH 18,A02,083744,Cinel; Cameron Alexander,17,0,30,13
1657541241999,MATH 18,A03,083745,Cinel; Cameron Alexander,9,0,30,21
1657541241999,MATH 18,B01,083748,Rideout; David Porter,5,0,37,32
1657541241999,MATH 18,B02,083749,Rideout; David Porter,5,0,36,31
1657541241999,MATH 18,B03,083750,Rideout; David Porter,3,0,37,34
1657541241999,MATH 18,B04,083751,Rideout; David Porter,6,0,36,30
1657541241999,MATH 18,B05,093473,Rideout; David Porter,6,0,36,30
1657541241999,MATH 18,B06,093474,Rideout; David Porter,6,0,36,30
1657541248030,MATH 20A,A01,083754,Zheng; Zequn,14,0,40,26
1657541254056,MATH 20B,A01,083756,Briones; Jor-el Thomas Caparas,4,0,36,32
1657541254056,MATH 20B,A02,083757,Briones; Jor-el Thomas Caparas,1,0,36,35
1657541254056,MATH 20B,A03,093475,Briones; Jor-el Thomas Caparas,2,0,36,34
1657541260084,MATH 20C,A01,083760,Briones; Jor-el Thomas Caparas,1,0,35,34
1657541260084,MATH 20C,A02,083761,Briones; Jor-el Thomas Caparas,8,0,35,27
1657541260084,MATH 20C,A03,093476,Briones; Jor-el Thomas Caparas,0,1,36,36
1657541260084,MATH 20C,B01,083762,Bach; Quang Tran,1,0,30,29
1657541266122,MATH 20D,A01,083765,Tran; Brian Kha,5,0,30,25
1657541266122,MATH 20D,A02,083766,Tran; Brian Kha,5,0,30,25
1657541266122,MATH 20D,A03,083767,Tran; Brian Kha,5,0,30,25
1657541272149,MATH 20E,A01,083771,Ganguly; Soumya,9,0,32,23
1657541272149,MATH 20E,A02,083772,Ganguly; Soumya,6,0,32,26
1657541272149,MATH 20E,B01,083773,Ciotti; Benjamin,20,0,35,15
1657541272149,MATH 20E,B02,083774,Ciotti; Benjamin,17,0,35,18
1657541278188,MATH 103A,A01,083777,Greenfeld; Be'Eri,3,0,36,33
1657541278188,MATH 103A,A02,083778,Greenfeld; Be'Eri,5,0,36,31
1657541278188,MATH 103A,A03,093561,Greenfeld; Be'Eri,5,0,36,31
1657541278188,MATH 103A,B01,083779,Greenfeld; Be'Eri,7,0,36,29
1657541278188,MATH 103A,B02,083780,Greenfeld; Be'Eri,4,0,36,32
1657541278188,MATH 103A,B03,093562,Greenfeld; Be'Eri,3,0,36,33
1657541284215,MATH 105,A01,085443,Carter; Anne Toulson,15,0,35,20
1657541284215,MATH 105,A02,093477,Carter; Anne Toulson,20,0,35,15
1657541290324,MATH 109,A01,083213,Ganzberger; Geoffrey Michael,2,0,34,32
1657541290324,MATH 109,A02,083214,Ganzberger; Geoffrey Michael,4,0,34,30
1657541290324,MATH 109,A03,093478,Ganzberger; Geoffrey Michael,2,0,34,32
1657541290324,MATH 109,B01,083215,Ganzberger; Geoffrey Michael,1,0,32,31
1657541290324,MATH 109,B02,083216,Ganzberger; Geoffrey Michael,2,0,32,30
1657541290324,MATH 109,B03,093479,Ganzberger; Geoffrey Michael,8,0,32,24
1657541296362,MATH 142A,A01,083219,Chow; Bennett,7,0,32,25
1657541296362,MATH 142A,A02,083220,Chow; Bennett,10,0,32,22
1657541296362,MATH 142A,A03,093480,Chow; Bennett,8,0,32,24
1657541296362,MATH 142A,B03,093481,Chow; Bennett,8,0,32,24
1657541296362,MATH 142A,B04,093558,Chow; Bennett,13,0,32,19
1657541296362,MATH 142A,B05,093559,Chow; Bennett,6,0,32,26
1657541302389,MATH 193A,A01,083224,Rotar; Vladimir,8,0,34,26
1657541302389,MATH 193A,A02,083225,Rotar; Vladimir,9,0,34,25
1657541302389,MATH 193A,A03,083781,Rotar; Vladimir,5,0,34,29
1657541302389,MATH 193A,A04,083782,Rotar; Vladimir,10,0,34,24
1657541302389,MATH 193A,A05,093482,Rotar; Vladimir,10,0,34,24
1657541308422,MATH 197,001,091859,McAuley; Julian John,9999,0,9999,0
1657541308422,MATH 197,002,095566,Kedlaya; Kiran S.,9997,0,9999,2
1657541308422,MATH 197,003,095567,Xiao; Ming,9999,0,9999,0
1657541308422,MATH 197,004,095571,Perols; Johan Lars,9998,0,9999,1
1657541315494,COGS 9,A01,083615,Shannon; Kyle Michael,9,0,75,66
1657541321539,COGS 11,A01,083617,Boyle; Mary E. T.,22,0,48,26
1657541327571,COGS 13,A01,083071,Bastos; Amalia Pinkusfeld,11,0,71,60
1657541333596,COGS 14A,A01,092681,Semenuks; Arturs,5,1,100,95
1657541339624,COGS 14B,A01,083073,Cheng; Tzu-Han,6,0,63,57
1657541345650,COGS 17,A01,092677,Semenuks; Arturs,6,0,81,75
1657541351680,COGS 100,A01,083619,Allen; Michael Gordon,17,0,70,53
1657541357705,COGS 101A,A01,083621,Davis; Joshua Daniel,9,0,68,59
1657541363732,COGS 101B,A01,091572,Allen; Michael Gordon,12,0,65,53
1657541369763,COGS 101C,A01,083625,Delgado; Tania,17,0,35,18
1657541375787,COGS 107A,A01,083627,Boyle; Mary E. T.,13,0,60,47
1657541381819,COGS 118A,A01,083075,Gupta; Anjum,21,0,76,55
1657541387852,CSE 3,A50,083646,Miranda; Gregory Joseph,24,0,50,26
1657541393878,CSE 8A,A50,083650,Miranda; Gregory Joseph,17,1,56,39
1657541399902,CSE 11,A01,083080,Cao; Yingjun,6,15,40,34
1657541405937,CSE 12,A01,083652,Krause-Levy; Sophia Louisa,28,1,120,92
1657541411967,CSE 15L,A01,083654,Morris; Justin Loren,9,0,50,41
1657541411967,CSE 15L,A02,083655,Morris; Justin Loren,9,0,50,41
1657541417997,CSE 20,A01,083657,Tran; Khoa Dang,39,0,80,41
1657541424029,CSE 21,A01,095574,Bach; Quang Tran,22,0,48,26
1657541430065,CSE 30,A01,083084,Eldon; John,5,0,80,75
1657541430065,CSE 30,B01,095061,Bhaskar; Nishant,9,0,50,41
1657541436092,CSE 100,A01,083659,Cao; Yingjun,5,4,70,65
1657541442133,CSE 134B,A01,083661,Powell; Thomas Allan,22,0,100,78
1657541448162,CSE 140,A01,083663,Gungor; Onat,15,0,85,70
1657541454189,CSE 140L,A01,083088,Eldon; John,21,0,100,79
1657541460222,CSE 175,A01,083665,Kumar; Rakesh,3,0,25,22
1657541466247,CSE 190,A00,092507,Dubnov; Shlomo,8,0,20,12
1657541472273,ECE 45,A01,083139,Congero; Spencer William,6,0,75,69
1657541478298,ECE 65,A50,083695,Saad; Andrew S,12,0,30,18
1657541478298,ECE 65,A51,095125,Saad; Andrew S,24,0,26,2
1657541484326,ECE 109,A01,091882,Touri; Behrouz,19,0,70,51
1657541490353,ECE 180,A00,083140,Abi Samra; Nicholas Camill,1,0,30,29
1657541490353,ECE 180,B00,083141,Abi Samra; Nicholas Camill,0,0,30,30
1657541496381,MATH 10A,A01,083735,Patchell; Gregory David,2,0,30,28
1657541496381,MATH 10A,A02,083736,Patchell; Gregory David,20,0,30,10
1657541496381,MATH 10A,A03,083737,Patchell; Gregory David,16,0,30,14
1657541502408,MATH 10B,A01,083207,Lim; Seonhee,8,0,34,26
1657541502408,MATH 10B,A02,083208,Lim; Seonhee,9,0,35,26
1657541502408,MATH 10B,A03,093472,Lim; Seonhee,7,0,34,27
1657541502408,MATH 10B,B01,083739,Sinha; Shubham,12,0,30,18
1657541508439,MATH 18,A01,083743,Cinel; Cameron Alexander,7,0,30,23
1657541508439,MATH 18,A02,083744,Cinel; Cameron Alexander,17,0,30,13
1657541508439,MATH 18,A03,083745,Cinel; Cameron Alexander,9,0,30,21
1657541508439,MATH 18,B01,083748,Rideout; David Porter,5,0,37,32
1657541508439,MATH 18,B02,083749,Rideout; David Porter,5,0,36,31
1657541508439,MATH 18,B03,083750,Rideout; David Porter,3,0,37,34
1657541508439,MATH 18,B04,083751,Rideout; David Porter,6,0,36,30
1657541508439,MATH 18,B05,093473,Rideout; David Porter,6,0,36,30
1657541508439,MATH 18,B06,093474,Rideout; David Porter,6,0,36,30
1657541514469,MATH 20A,A01,083754,Zheng; Zequn,14,0,40,26
1657541520504,MATH 20B,A01,083756,Briones; Jor-el Thomas Caparas,4,0,36,32
1657541520504,MATH 20B,A02,083757,Briones; Jor-el Thomas Caparas,1,0,36,35
1657541520504,MATH 20B,A03,093475,Briones; Jor-el Thomas Caparas,2,0,36,34
1657541526541,MATH 20C,A01,083760,Briones; Jor-el Thomas Caparas,1,0,35,34
1657541526541,MATH 20C,A02,083761,Briones; Jor-el Thomas Caparas,8,0,35,27
1657541526541,MATH 20C,A03,093476,Briones; Jor-el Thomas Caparas,0,1,36,36
1657541526541,MATH 20C,B01,083762,Bach; Quang Tran,1,0,30,29
1657541532565,MATH 20D,A01,083765,Tran; Brian Kha,5,0,30,25
1657541532565,MATH 20D,A02,083766,Tran; Brian Kha,5,0,30,25
1657541532565,MATH 20D,A03,083767,Tran; Brian Kha,5,0,30,25
1657541538602,MATH 20E,A01,083771,Ganguly; Soumya,9,0,32,23
1657541538602,MATH 20E,A02,083772,Ganguly; Soumya,6,0,32,26
1657541538602,MATH 20E,B01,083773,Ciotti; Benjamin,20,0,35,15
1657541538602,MATH 20E,B02,083774,Ciotti; Benjamin,17,0,35,18
1657541544630,MATH 103A,A01,083777,Greenfeld; Be'Eri,3,0,36,33
1657541544630,MATH 103A,A02,083778,Greenfeld; Be'Eri,5,0,36,31
1657541544630,MATH 103A,A03,093561,Greenfeld; Be'Eri,5,0,36,31
1657541544630,MATH 103A,B01,083779,Greenfeld; Be'Eri,7,0,36,29
1657541544630,MATH 103A,B02,083780,Greenfeld; Be'Eri,4,0,36,32
1657541544630,MATH 103A,B03,093562,Greenfeld; Be'Eri,3,0,36,33
1657541550657,MATH 105,A01,085443,Carter; Anne Toulson,15,0,35,20
1657541550657,MATH 105,A02,093477,Carter; Anne Toulson,20,0,35,15
1657541556684,MATH 109,A01,083213,Ganzberger; Geoffrey Michael,2,0,34,32
1657541556684,MATH 109,A02,083214,Ganzberger; Geoffrey Michael,4,0,34,30
1657541556684,MATH 109,A03,093478,Ganzberger; Geoffrey Michael,2,0,34,32
1657541556684,MATH 109,B01,083215,Ganzberger; Geoffrey Michael,1,0,32,31
1657541556684,MATH 109,B02,083216,Ganzberger; Geoffrey Michael,2,0,32,30
1657541556684,MATH 109,B03,093479,Ganzberger; Geoffrey Michael,8,0,32,24
1657541562710,MATH 142A,A01,083219,Chow; Bennett,7,0,32,25
1657541562710,MATH 142A,A02,083220,Chow; Bennett,10,0,32,22
1657541562710,MATH 142A,A03,093480,Chow; Bennett,8,0,32,24
1657541562710,MATH 142A,B03,093481,Chow; Bennett,8,0,32,24
1657541562710,MATH 142A,B04,093558,Chow; Bennett,13,0,32,19
1657541562710,MATH 142A,B05,093559,Chow; Bennett,6,0,32,26
1657541568735,MATH 193A,A01,083224,Rotar; Vladimir,8,0,34,26
1657541568735,MATH 193A,A02,083225,Rotar; Vladimir,9,0,34,25
1657541568735,MATH 193A,A03,083781,Rotar; Vladimir,5,0,34,29
1657541568735,MATH 193A,A04,083782,Rotar; Vladimir,10,0,34,24
1657541568735,MATH 193A,A05,093482,Rotar; Vladimir,10,0,34,24
1657541574774,MATH 197,001,091859,McAuley; Julian John,9999,0,9999,0
1657541574774,MATH 197,002,095566,Kedlaya; Kiran S.,9997,0,9999,2
1657541574774,MATH 197,003,095567,Xiao; Ming,9999,0,9999,0
1657541574774,MATH 197,004,095571,Perols; Johan Lars,9998,0,9999,1
1657541581842,COGS 9,A01,083615,Shannon; Kyle Michael,9,0,75,66
1657541587867,COGS 11,A01,083617,Boyle; Mary E. T.,22,0,48,26
1657541593893,COGS 13,A01,083071,Bastos; Amalia Pinkusfeld,11,0,71,60
1657541599925,COGS 14A,A01,092681,Semenuks; Arturs,5,1,100,95
1657541605957,COGS 14B,A01,083073,Cheng; Tzu-Han,6,0,63,57
1657541611983,COGS 17,A01,092677,Semenuks; Arturs,6,0,81,75
1657541618015,COGS 100,A01,083619,Allen; Michael Gordon,17,0,70,53
1657541624040,COGS 101A,A01,083621,Davis; Joshua Daniel,9,0,68,59
1657541630072,COGS 101B,A01,091572,Allen; Michael Gordon,12,0,65,53
1657541636102,COGS 101C,A01,083625,Delgado; Tania,17,0,35,18
1657541642129,COGS 107A,A01,083627,Boyle; Mary E. T.,13,0,60,47
1657541648154,COGS 118A,A01,083075,Gupta; Anjum,21,0,76,55
1657541654182,CSE 3,A50,083646,Miranda; Gregory Joseph,24,0,50,26
1657541660212,CSE 8A,A50,083650,Miranda; Gregory Joseph,17,1,56,39
1657541666238,CSE 11,A01,083080,Cao; Yingjun,6,15,40,34
1657541672267,CSE 12,A01,083652,Krause-Levy; Sophia Louisa,28,1,120,92
1657541678296,CSE 15L,A01,083654,Morris; Justin Loren,9,0,50,41
1657541678296,CSE 15L,A02,083655,Morris; Justin Loren,9,0,50,41
1657541684327,CSE 20,A01,083657,Tran; Khoa Dang,39,0,80,41
1657541690364,CSE 21,A01,095574,Bach; Quang Tran,22,0,48,26
1657541696393,CSE 30,A01,083084,Eldon; John,5,0,80,75
1657541696393,CSE 30,B01,095061,Bhaskar; Nishant,9,0,50,41
1657541702425,CSE 100,A01,083659,Cao; Yingjun,5,4,70,65
1657541708450,CSE 134B,A01,083661,Powell; Thomas Allan,22,0,100,78
1657541714476,CSE 140,A01,083663,Gungor; Onat,15,0,85,70
1657541720500,CSE 140L,A01,083088,Eldon; John,21,0,100,79
1657541726531,CSE 175,A01,083665,Kumar; Rakesh,3,0,25,22
1657541732564,CSE 190,A00,092507,Dubnov; Shlomo,8,0,20,12
1657541738599,ECE 45,A01,083139,Congero; Spencer William,6,0,75,69
1657541744634,ECE 65,A50,083695,Saad; Andrew S,12,0,30,18
1657541744634,ECE 65,A51,095125,Saad; Andrew S,24,0,26,2
1657541750658,ECE 109,A01,091882,Touri; Behrouz,19,0,70,51
1657541756691,ECE 180,A00,083140,Abi Samra; Nicholas Camill,1,0,30,29
1657541756691,ECE 180,B00,083141,Abi Samra; Nicholas Camill,0,0,30,30
1657541762734,MATH 10A,A01,083735,Patchell; Gregory David,2,0,30,28
1657541762734,MATH 10A,A02,083736,Patchell; Gregory David,20,0,30,10
1657541762734,MATH 10A,A03,083737,Patchell; Gregory David,16,0,30,14
1657541768763,MATH 10B,A01,083207,Lim; Seonhee,8,0,34,26
1657541768763,MATH 10B,A02,083208,Lim; Seonhee,9,0,35,26
1657541768763,MATH 10B,A03,093472,Lim; Seonhee,7,0,34,27
1657541768763,MATH 10B,B01,083739,Sinha; Shubham,12,0,30,18
1657541774795,MATH 18,A01,083743,Cinel; Cameron Alexander,7,0,30,23
1657541774795,MATH 18,A02,083744,Cinel; Cameron Alexander,17,0,30,13
1657541774795,MATH 18,A03,083745,Cinel; Cameron Alexander,9,0,30,21
1657541774795,MATH 18,B01,083748,Rideout; David Porter,5,0,37,32
1657541774795,MATH 18,B02,083749,Rideout; David Porter,5,0,36,31
1657541774795,MATH 18,B03,083750,Rideout; David Porter,3,0,37,34
1657541774795,MATH 18,B04,083751,Rideout; David Porter,6,0,36,30
1657541774795,MATH 18,B05,093473,Rideout; David Porter,6,0,36,30
1657541774795,MATH 18,B06,093474,Rideout; David Porter,6,0,36,30
1657541780823,MATH 20A,A01,083754,Zheng; Zequn,14,0,40,26
1657541786891,MATH 20B,A01,083756,Briones; Jor-el Thomas Caparas,4,0,36,32
1657541786891,MATH 20B,A02,083757,Briones; Jor-el Thomas Caparas,1,0,36,35
1657541786891,MATH 20B,A03,093475,Briones; Jor-el Thomas Caparas,2,0,36,34
1657541792926,MATH 20C,A01,083760,Briones; Jor-el Thomas Caparas,1,0,35,34
1657541792926,MATH 20C,A02,083761,Briones; Jor-el Thomas Caparas,8,0,35,27
1657541792926,MATH 20C,A03,093476,Briones; Jor-el Thomas Caparas,0,1,36,36
1657541792926,MATH 20C,B01,083762,Bach; Quang Tran,1,0,30,29
1657541798954,MATH 20D,A01,083765,Tran; Brian Kha,5,0,30,25
1657541798954,MATH 20D,A02,083766,Tran; Brian Kha,5,0,30,25
1657541798954,MATH 20D,A03,083767,Tran; Brian Kha,5,0,30,25
1657541804992,MATH 20E,A01,083771,Ganguly; Soumya,9,0,32,23
1657541804992,MATH 20E,A02,083772,Ganguly; Soumya,6,0,32,26
1657541804992,MATH 20E,B01,083773,Ciotti; Benjamin,20,0,35,15
1657541804992,MATH 20E,B02,083774,Ciotti; Benjamin,17,0,35,18
1657541811034,MATH 103A,A01,083777,Greenfeld; Be'Eri,3,0,36,33
1657541811034,MATH 103A,A02,083778,Greenfeld; Be'Eri,5,0,36,31
1657541811034,MATH 103A,A03,093561,Greenfeld; Be'Eri,5,0,36,31
1657541811034,MATH 103A,B01,083779,Greenfeld; Be'Eri,7,0,36,29
1657541811034,MATH 103A,B02,083780,Greenfeld; Be'Eri,4,0,36,32
1657541811034,MATH 103A,B03,093562,Greenfeld; Be'Eri,3,0,36,33
1657541817069,MATH 105,A01,085443,Carter; Anne Toulson,15,0,35,20
1657541817069,MATH 105,A02,093477,Carter; Anne Toulson,20,0,35,15
1657541823097,MATH 109,A01,083213,Ganzberger; Geoffrey Michael,2,0,34,32
1657541823097,MATH 109,A02,083214,Ganzberger; Geoffrey Michael,4,0,34,30
1657541823097,MATH 109,A03,093478,Ganzberger; Geoffrey Michael,2,0,34,32
1657541823097,MATH 109,B01,083215,Ganzberger; Geoffrey Michael,1,0,32,31
1657541823097,MATH 109,B02,083216,Ganzberger; Geoffrey Michael,2,0,32,30
1657541823097,MATH 109,B03,093479,Ganzberger; Geoffrey Michael,8,0,32,24
1657541829128,MATH 142A,A01,083219,Chow; Bennett,7,0,32,25
1657541829128,MATH 142A,A02,083220,Chow; Bennett,10,0,32,22
1657541829128,MATH 142A,A03,093480,Chow; Bennett,8,0,32,24
1657541829128,MATH 142A,B03,093481,Chow; Bennett,8,0,32,24
1657541829128,MATH 142A,B04,093558,Chow; Bennett,13,0,32,19
1657541829128,MATH 142A,B05,093559,Chow; Bennett,6,0,32,26
1657541835156,MATH 193A,A01,083224,Rotar; Vladimir,8,0,34,26
1657541835156,MATH 193A,A02,083225,Rotar; Vladimir,9,0,34,25
1657541835156,MATH 193A,A03,083781,Rotar; Vladimir,5,0,34,29
1657541835156,MATH 193A,A04,083782,Rotar; Vladimir,10,0,34,24
1657541835156,MATH 193A,A05,093482,Rotar; Vladimir,10,0,34,24
1657541841184,MATH 197,001,091859,McAuley; Julian John,9999,0,9999,0
1657541841184,MATH 197,002,095566,Kedlaya; Kiran S.,9997,0,9999,2
1657541841184,MATH 197,003,095567,Xiao; Ming,9999,0,9999,0
1657541841184,MATH 197,004,095571,Perols; Johan Lars,9998,0,9999,1
1657541848271,COGS 9,A01,083615,Shannon; Kyle Michael,9,0,75,66
1657541854300,COGS 11,A01,083617,Boyle; Mary E. T.,22,0,48,26
1657541860337,COGS 13,A01,083071,Bastos; Amalia Pinkusfeld,11,0,71,60
1657541866366,COGS 14A,A01,092681,Semenuks; Arturs,5,1,100,95
1657541872394,COGS 14B,A01,083073,Cheng; Tzu-Han,6,0,63,57
1657541878424,COGS 17,A01,092677,Semenuks; Arturs,6,0,81,75
1657541884526,COGS 100,A01,083619,Allen; Michael Gordon,17,0,70,53
1657541890557,COGS 101A,A01,083621,Davis; Joshua Daniel,9,0,68,59
1657541896583,COGS 101B,A01,091572,Allen; Michael Gordon,12,0,65,53
1657541902609,COGS 101C,A01,083625,Delgado; Tania,17,0,35,18
1657541908635,COGS 107A,A01,083627,Boyle; Mary E. T.,13,0,60,47
1657541914664,COGS 118A,A01,083075,Gupta; Anjum,21,0,76,55
1657541920700,CSE 3,A50,083646,Miranda; Gregory Joseph,24,0,50,26
1657541926731,CSE 8A,A50,083650,Miranda; Gregory Joseph,17,1,56,39
1657541932761,CSE 11,A01,083080,Cao; Yingjun,6,15,40,34
1657541938793,CSE 12,A01,083652,Krause-Levy; Sophia Louisa,28,1,120,92
1657541944824,CSE 15L,A01,083654,Morris; Justin Loren,9,0,50,41
1657541944824,CSE 15L,A02,083655,Morris; Justin Loren,9,0,50,41
1657541950852,CSE 20,A01,083657,Tran; Khoa Dang,39,0,80,41
1657541956886,CSE 21,A01,095574,Bach; Quang Tran,22,0,48,26
1657541962913,CSE 30,A01,083084,Eldon; John,5,0,80,75
1657541962913,CSE 30,B01,095061,Bhaskar; Nishant,9,0,50,41
1657541968940,CSE 100,A01,083659,Cao; Yingjun,5,4,70,65
1657541974971,CSE 134B,A01,083661,Powell; Thomas Allan,22,0,100,78
1657541980997,CSE 140,A01,083663,Gungor; Onat,15,0,85,70
1657541987028,CSE 140L,A01,083088,Eldon; John,21,0,100,79
1657541993055,CSE 175,A01,083665,Kumar; Rakesh,3,0,25,22
1657541999087,CSE 190,A00,092507,Dubnov; Shlomo,8,0,20,12
1657542005124,ECE 45,A01,083139,Congero; Spencer William,6,0,75,69
1657542011151,ECE 65,A50,083695,Saad; Andrew S,12,0,30,18
1657542011151,ECE 65,A51,095125,Saad; Andrew S,24,0,26,2
1657542017176,ECE 109,A01,091882,Touri; Behrouz,19,0,70,51
1657542023202,ECE 180,A00,083140,Abi Samra; Nicholas Camill,1,0,30,29
1657542023202,ECE 180,B00,083141,Abi Samra; Nicholas Camill,0,0,30,30
1657542029232,MATH 10A,A01,083735,Patchell; Gregory David,2,0,30,28
1657542029232,MATH 10A,A02,083736,Patchell; Gregory David,20,0,30,10
1657542029232,MATH 10A,A03,083737,Patchell; Gregory David,16,0,30,14
1657542035271,MATH 10B,A01,083207,Lim; Seonhee,8,0,34,26
1657542035271,MATH 10B,A02,083208,Lim; Seonhee,9,0,35,26
1657542035271,MATH 10B,A03,093472,Lim; Seonhee,7,0,34,27
1657542035271,MATH 10B,B01,083739,Sinha; Shubham,12,0,30,18
1657542041308,MATH 18,A01,083743,Cinel; Cameron Alexander,7,0,30,23
1657542041308,MATH 18,A02,083744,Cinel; Cameron Alexander,17,0,30,13
1657542041308,MATH 18,A03,083745,Cinel; Cameron Alexander,9,0,30,21
1657542041308,MATH 18,B01,083748,Rideout; David Porter,5,0,37,32
1657542041308,MATH 18,B02,083749,Rideout; David Porter,5,0,36,31
1657542041308,MATH 18,B03,083750,Rideout; David Porter,3,0,37,34
1657542041308,MATH 18,B04,083751,Rideout; David Porter,6,0,36,30
1657542041308,MATH 18,B05,093473,Rideout; David Porter,6,0,36,30
1657542041308,MATH 18,B06,093474,Rideout; David Porter,6,0,36,30
1657542047339,MATH 20A,A01,083754,Zheng; Zequn,14,0,40,26
1657542053365,MATH 20B,A01,083756,Briones; Jor-el Thomas Caparas,4,0,36,32
1657542053365,MATH 20B,A02,083757,Briones; Jor-el Thomas Caparas,1,0,36,35
1657542053365,MATH 20B,A03,093475,Briones; Jor-el Thomas Caparas,2,0,36,34
1657542059393,MATH 20C,A01,083760,Briones; Jor-el Thomas Caparas,1,0,35,34
1657542059393,MATH 20C,A02,083761,Briones; Jor-el Thomas Caparas,8,0,35,27
1657542059393,MATH 20C,A03,093476,Briones; Jor-el Thomas Caparas,0,1,36,36
1657542059393,MATH 20C,B01,083762,Bach; Quang Tran,1,0,30,29
1657542065422,MATH 20D,A01,083765,Tran; Brian Kha,5,0,30,25
1657542065422,MATH 20D,A02,083766,Tran; Brian Kha,5,0,30,25
1657542065422,MATH 20D,A03,083767,Tran; Brian Kha,5,0,30,25
1657542071450,MATH 20E,A01,083771,Ganguly; Soumya,9,0,32,23
1657542071450,MATH 20E,A02,083772,Ganguly; Soumya,6,0,32,26
1657542071450,MATH 20E,B01,083773,Ciotti; Benjamin,20,0,35,15
1657542071450,MATH 20E,B02,083774,Ciotti; Benjamin,17,0,35,18
1657542077477,MATH 103A,A01,083777,Greenfeld; Be'Eri,3,0,36,33
1657542077477,MATH 103A,A02,083778,Greenfeld; Be'Eri,5,0,36,31
1657542077477,MATH 103A,A03,093561,Greenfeld; Be'Eri,5,0,36,31
1657542077477,MATH 103A,B01,083779,Greenfeld; Be'Eri,7,0,36,29
1657542077477,MATH 103A,B02,083780,Greenfeld; Be'Eri,4,0,36,32
1657542077477,MATH 103A,B03,093562,Greenfeld; Be'Eri,3,0,36,33
1657542083516,MATH 105,A01,085443,Carter; Anne Toulson,15,0,35,20
1657542083516,MATH 105,A02,093477,Carter; Anne Toulson,20,0,35,15
1657542089550,MATH 109,A01,083213,Ganzberger; Geoffrey Michael,2,0,34,32
1657542089550,MATH 109,A02,083214,Ganzberger; Geoffrey Michael,4,0,34,30
1657542089550,MATH 109,A03,093478,Ganzberger; Geoffrey Michael,2,0,34,32
1657542089550,MATH 109,B01,083215,Ganzberger; Geoffrey Michael,1,0,32,31
1657542089550,MATH 109,B02,083216,Ganzberger; Geoffrey Michael,2,0,32,30
1657542089550,MATH 109,B03,093479,Ganzberger; Geoffrey Michael,8,0,32,24
1657542095595,MATH 142A,A01,083219,Chow; Bennett,7,0,32,25
1657542095595,MATH 142A,A02,083220,Chow; Bennett,10,0,32,22
1657542095595,MATH 142A,A03,093480,Chow; Bennett,8,0,32,24
1657542095595,MATH 142A,B03,093481,Chow; Bennett,8,0,32,24
1657542095595,MATH 142A,B04,093558,Chow; Bennett,13,0,32,19
1657542095595,MATH 142A,B05,093559,Chow; Bennett,6,0,32,26
1657542101626,MATH 193A,A01,083224,Rotar; Vladimir,8,0,34,26
1657542101626,MATH 193A,A02,083225,Rotar; Vladimir,9,0,34,25
1657542101626,MATH 193A,A03,083781,Rotar; Vladimir,5,0,34,29
1657542101626,MATH 193A,A04,083782,Rotar; Vladimir,10,0,34,24
1657542101626,MATH 193A,A05,093482,Rotar; Vladimir,10,0,34,24
1657542107653,MATH 197,001,091859,McAuley; Julian John,9999,0,9999,0
1657542107653,MATH 197,002,095566,Kedlaya; Kiran S.,9997,0,9999,2
1657542107653,MATH 197,003,095567,Xiao; Ming,9999,0,9999,0
1657542107653,MATH 197,004,095571,Perols; Johan Lars,9998,0,9999,1
1657542114724,COGS 9,A01,083615,Shannon; Kyle Michael,9,0,75,66
1657542120751,COGS 11,A01,083617,Boyle; Mary E. T.,22,0,48,26
1657542126778,COGS 13,A01,083071,Bastos; Amalia Pinkusfeld,11,0,71,60
1657542132806,COGS 14A,A01,092681,Semenuks; Arturs,5,1,100,95
1657542138837,COGS 14B,A01,083073,Cheng; Tzu-Han,6,0,63,57
1657542144868,COGS 17,A01,092677,Semenuks; Arturs,6,0,81,75
1657542150898,COGS 100,A01,083619,Allen; Michael Gordon,17,0,70,53
1657542156927,COGS 101A,A01,083621,Davis; Joshua Daniel,9,0,68,59
1657542162958,COGS 101B,A01,091572,Allen; Michael Gordon,12,0,65,53
1657542168991,COGS 101C,A01,083625,Delgado; Tania,17,0,35,18
1657542175017,COGS 107A,A01,083627,Boyle; Mary E. T.,13,0,60,47
1657542181046,COGS 118A,A01,083075,Gupta; Anjum,21,0,76,55
1657542187084,CSE 3,A50,083646,Miranda; Gregory Joseph,24,0,50,26
1657542193113,CSE 8A,A50,083650,Miranda; Gregory Joseph,17,1,56,39
1657542199142,CSE 11,A01,083080,Cao; Yingjun,6,15,40,34
1657542205172,CSE 12,A01,083652,Krause-Levy; Sophia Louisa,28,1,120,92
1657542211204,CSE 15L,A01,083654,Morris; Justin Loren,9,0,50,41
1657542211204,CSE 15L,A02,083655,Morris; Justin Loren,9,0,50,41
1657542217233,CSE 20,A01,083657,Tran; Khoa Dang,39,0,80,41
1657542223262,CSE 21,A01,095574,Bach; Quang Tran,22,0,48,26
1657542229297,CSE 30,A01,083084,Eldon; John,5,0,80,75
1657542229297,CSE 30,B01,095061,Bhaskar; Nishant,9,0,50,41
1657542235326,CSE 100,A01,083659,Cao; Yingjun,5,4,70,65
1657542241360,CSE 134B,A01,083661,Powell; Thomas Allan,22,0,100,78
1657542247386,CSE 140,A01,083663,Gungor; Onat,15,0,85,70
1657542253416,CSE 140L,A01,083088,Eldon; John,21,0,100,79
1657542259447,CSE 175,A01,083665,Kumar; Rakesh,3,0,25,22
1657542265478,CSE 190,A00,092507,Dubnov; Shlomo,8,0,20,12
1657542271517,ECE 45,A01,083139,Congero; Spencer William,6,0,75,69
1657542277547,ECE 65,A50,083695,Saad; Andrew S,12,0,30,18
1657542277547,ECE 65,A51,095125,Saad; Andrew S,24,0,26,2
1657542283571,ECE 109,A01,091882,Touri; Behrouz,19,0,70,51
1657542289599,ECE 180,A00,083140,Abi Samra; Nicholas Camill,1,0,30,29
1657542289599,ECE 180,B00,083141,Abi Samra; Nicholas Camill,0,0,30,30
1657542295633,MATH 10A,A01,083735,Patchell; Gregory David,2,0,30,28
1657542295633,MATH 10A,A02,083736,Patchell; Gregory David,20,0,30,10
1657542295633,MATH 10A,A03,083737,Patchell; Gregory David,16,0,30,14
1657542301662,MATH 10B,A01,083207,Lim; Seonhee,8,0,34,26
1657542301662,MATH 10B,A02,083208,Lim; Seonhee,9,0,35,26
1657542301662,MATH 10B,A03,093472,Lim; Seonhee,7,0,34,27
1657542301662,MATH 10B,B01,083739,Sinha; Shubham,12,0,30,18
1657542307693,MATH 18,A01,083743,Cinel; Cameron Alexander,7,0,30,23
1657542307693,MATH 18,A02,083744,Cinel; Cameron Alexander,17,0,30,13
1657542307693,MATH 18,A03,083745,Cinel; Cameron Alexander,9,0,30,21
1657542307693,MATH 18,B01,083748,Rideout; David Porter,5,0,37,32
1657542307693,MATH 18,B02,083749,Rideout; David Porter,5,0,36,31
1657542307693,MATH 18,B03,083750,Rideout; David Porter,3,0,37,34
1657542307693,MATH 18,B04,083751,Rideout; David Porter,6,0,36,30
1657542307693,MATH 18,B05,093473,Rideout; David Porter,6,0,36,30
1657542307693,MATH 18,B06,093474,Rideout; David Porter,6,0,36,30
1657542313719,MATH 20A,A01,083754,Zheng; Zequn,14,0,40,26
1657542319757,MATH 20B,A01,083756,Briones; Jor-el Thomas Caparas,4,0,36,32
1657542319757,MATH 20B,A02,083757,Briones; Jor-el Thomas Caparas,1,0,36,35
1657542319757,MATH 20B,A03,093475,Briones; Jor-el Thomas Caparas,2,0,36,34
1657542325791,MATH 20C,A01,083760,Briones; Jor-el Thomas Caparas,1,0,35,34
1657542325791,MATH 20C,A02,083761,Briones; Jor-el Thomas Caparas,8,0,35,27
1657542325791,MATH 20C,A03,093476,Briones; Jor-el Thomas Caparas,0,1,36,36
1657542325791,MATH 20C,B01,083762,Bach; Quang Tran,1,0,30,29
1657542331839,MATH 20D,A01,083765,Tran; Brian Kha,5,0,30,25
1657542331839,MATH 20D,A02,083766,Tran; Brian Kha,5,0,30,25
1657542331839,MATH 20D,A03,083767,Tran; Brian Kha,5,0,30,25
1657542337865,MATH 20E,A01,083771,Ganguly; Soumya,9,0,32,23
1657542337865,MATH 20E,A02,083772,Ganguly; Soumya,6,0,32,26
1657542337865,MATH 20E,B01,083773,Ciotti; Benjamin,20,0,35,15
1657542337865,MATH 20E,B02,083774,Ciotti; Benjamin,17,0,35,18
1657542343897,MATH 103A,A01,083777,Greenfeld; Be'Eri,3,0,36,33
1657542343897,MATH 103A,A02,083778,Greenfeld; Be'Eri,5,0,36,31
1657542343897,MATH 103A,A03,093561,Greenfeld; Be'Eri,5,0,36,31
1657542343897,MATH 103A,B01,083779,Greenfeld; Be'Eri,7,0,36,29
1657542343897,MATH 103A,B02,083780,Greenfeld; Be'Eri,4,0,36,32
1657542343897,MATH 103A,B03,093562,Greenfeld; Be'Eri,3,0,36,33
1657542349923,MATH 105,A01,085443,Carter; Anne Toulson,15,0,35,20
1657542349923,MATH 105,A02,093477,Carter; Anne Toulson,20,0,35,15
1657542355955,MATH 109,A01,083213,Ganzberger; Geoffrey Michael,2,0,34,32
1657542355955,MATH 109,A02,083214,Ganzberger; Geoffrey Michael,4,0,34,30
1657542355955,MATH 109,A03,093478,Ganzberger; Geoffrey Michael,2,0,34,32
1657542355955,MATH 109,B01,083215,Ganzberger; Geoffrey Michael,1,0,32,31
1657542355955,MATH 109,B02,083216,Ganzberger; Geoffrey Michael,2,0,32,30
1657542355955,MATH 109,B03,093479,Ganzberger; Geoffrey Michael,8,0,32,24
1657542361981,MATH 142A,A01,083219,Chow; Bennett,7,0,32,25
1657542361981,MATH 142A,A02,083220,Chow; Bennett,10,0,32,22
1657542361981,MATH 142A,A03,093480,Chow; Bennett,8,0,32,24
1657542361981,MATH 142A,B03,093481,Chow; Bennett,8,0,32,24
1657542361981,MATH 142A,B04,093558,Chow; Bennett,13,0,32,19
1657542361981,MATH 142A,B05,093559,Chow; Bennett,6,0,32,26
1657542368015,MATH 193A,A01,083224,Rotar; Vladimir,8,0,34,26
1657542368015,MATH 193A,A02,083225,Rotar; Vladimir,9,0,34,25
1657542368015,MATH 193A,A03,083781,Rotar; Vladimir,5,0,34,29
1657542368015,MATH 193A,A04,083782,Rotar; Vladimir,10,0,34,24
1657542368015,MATH 193A,A05,093482,Rotar; Vladimir,10,0,34,24
1657542374045,MATH 197,001,091859,McAuley; Julian John,9999,0,9999,0
1657542374045,MATH 197,002,095566,Kedlaya; Kiran S.,9997,0,9999,2
1657542374045,MATH 197,003,095567,Xiao; Ming,9999,0,9999,0
1657542374045,MATH 197,004,095571,Perols; Johan Lars,9998,0,9999,1
1657542381124,COGS 9,A01,083615,Shannon; Kyle Michael,9,0,75,66
1657542387155,COGS 11,A01,083617,Boyle; Mary E. T.,22,0,48,26
1657542393188,COGS 13,A01,083071,Bastos; Amalia Pinkusfeld,11,0,71,60
1657542399223,COGS 14A,A01,092681,Semenuks; Arturs,5,1,100,95
1657542405249,COGS 14B,A01,083073,Cheng; Tzu-Han,6,0,63,57
1657542411277,COGS 17,A01,092677,Semenuks; Arturs,6,0,81,75
1657542417302,COGS 100,A01,083619,Allen; Michael Gordon,17,0,70,53
1657542423335,COGS 101A,A01,083621,Davis; Joshua Daniel,9,0,68,59
1657542429366,COGS 101B,A01,091572,Allen; Michael Gordon,12,0,65,53
1657542435398,COGS 101C,A01,083625,Delgado; Tania,17,0,35,18
1657542441426,COGS 107A,A01,083627,Boyle; Mary E. T.,13,0,60,47
1657542447452,COGS 118A,A01,083075,Gupta; Anjum,21,0,76,55
1657542453476,CSE 3,A50,083646,Miranda; Gregory Joseph,24,0,50,26
1657542459502,CSE 8A,A50,083650,Miranda; Gregory Joseph,17,1,56,39
1657542465533,CSE 11,A01,083080,Cao; Yingjun,6,15,40,34
1657542471560,CSE 12,A01,083652,Krause-Levy; Sophia Louisa,28,1,120,92
1657542477585,CSE 15L,A01,083654,Morris; Justin Loren,9,0,50,41
1657542477585,CSE 15L,A02,083655,Morris; Justin Loren,9,0,50,41
1657542483705,CSE 20,A01,083657,Tran; Khoa Dang,39,0,80,41
1657542489736,CSE 21,A01,095574,Bach; Quang Tran,22,0,48,26
1657542495763,CSE 30,A01,083084,Eldon; John,5,0,80,75
1657542495763,CSE 30,B01,095061,Bhaskar; Nishant,9,0,50,41
1657542501795,CSE 100,A01,083659,Cao; Yingjun,5,4,70,65
1657542507819,CSE 134B,A01,083661,Powell; Thomas Allan,22,0,100,78
1657542513851,CSE 140,A01,083663,Gungor; Onat,15,0,85,70
1657542519876,CSE 140L,A01,083088,Eldon; John,21,0,100,79
1657542525907,CSE 175,A01,083665,Kumar; Rakesh,3,0,25,22
1657542531935,CSE 190,A00,092507,Dubnov; Shlomo,8,0,20,12
1657542537966,ECE 45,A01,083139,Congero; Spencer William,6,0,75,69
1657542544000,ECE 65,A50,083695,Saad; Andrew S,12,0,30,18
1657542544000,ECE 65,A51,095125,Saad; Andrew S,24,0,26,2
1657542550034,ECE 109,A01,091882,Touri; Behrouz,19,0,70,51
1657542556063,ECE 180,A00,083140,Abi Samra; Nicholas Camill,1,0,30,29
1657542556063,ECE 180,B00,083141,Abi Samra; Nicholas Camill,0,0,30,30
1657542562099,MATH 10A,A01,083735,Patchell; Gregory David,2,0,30,28
1657542562099,MATH 10A,A02,083736,Patchell; Gregory David,20,0,30,10
1657542562099,MATH 10A,A03,083737,Patchell; Gregory David,16,0,30,14
1657542568135,MATH 10B,A01,083207,Lim; Seonhee,8,0,34,26
1657542568135,MATH 10B,A02,083208,Lim; Seonhee,9,0,35,26
1657542568135,MATH 10B,A03,093472,Lim; Seonhee,7,0,34,27
1657542568135,MATH 10B,B01,083739,Sinha; Shubham,12,0,30,18
1657542574172,MATH 18,A01,083743,Cinel; Cameron Alexander,7,0,30,23
1657542574172,MATH 18,A02,083744,Cinel; Cameron Alexander,17,0,30,13
1657542574172,MATH 18,A03,083745,Cinel; Cameron Alexander,9,0,30,21
1657542574172,MATH 18,B01,083748,Rideout; David Porter,5,0,37,32
1657542574172,MATH 18,B02,083749,Rideout; David Porter,5,0,36,31
1657542574172,MATH 18,B03,083750,Rideout; David Porter,3,0,37,34
1657542574172,MATH 18,B04,083751,Rideout; David Porter,6,0,36,30
1657542574172,MATH 18,B05,093473,Rideout; David Porter,6,0,36,30
1657542574172,MATH 18,B06,093474,Rideout; David Porter,6,0,36,30
1657542580197,MATH 20A,A01,083754,Zheng; Zequn,14,0,40,26
1657542586229,MATH 20B,A01,083756,Briones; Jor-el Thomas Caparas,4,0,36,32
1657542586229,MATH 20B,A02,083757,Briones; Jor-el Thomas Caparas,1,0,36,35
1657542586229,MATH 20B,A03,093475,Briones; Jor-el Thomas Caparas,2,0,36,34
1657542592262,MATH 20C,A01,083760,Briones; Jor-el Thomas Caparas,1,0,35,34
1657542592262,MATH 20C,A02,083761,Briones; Jor-el Thomas Caparas,8,0,35,27
1657542592262,MATH 20C,A03,093476,Briones; Jor-el Thomas Caparas,0,1,36,36
1657542592262,MATH 20C,B01,083762,Bach; Quang Tran,1,0,30,29
1657542598295,MATH 20D,A01,083765,Tran; Brian Kha,5,0,30,25
1657542598295,MATH 20D,A02,083766,Tran; Brian Kha,5,0,30,25
1657542598295,MATH 20D,A03,083767,Tran; Brian Kha,5,0,30,25
1657542604326,MATH 20E,A01,083771,Ganguly; Soumya,9,0,32,23
1657542604326,MATH 20E,A02,083772,Ganguly; Soumya,6,0,32,26
1657542604326,MATH 20E,B01,083773,Ciotti; Benjamin,20,0,35,15
1657542604326,MATH 20E,B02,083774,Ciotti; Benjamin,17,0,35,18
1657542610363,MATH 103A,A01,083777,Greenfeld; Be'Eri,3,0,36,33
1657542610363,MATH 103A,A02,083778,Greenfeld; Be'Eri,5,0,36,31
1657542610363,MATH 103A,A03,093561,Greenfeld; Be'Eri,5,0,36,31
1657542610363,MATH 103A,B01,083779,Greenfeld; Be'Eri,7,0,36,29
1657542610363,MATH 103A,B02,083780,Greenfeld; Be'Eri,4,0,36,32
1657542610363,MATH 103A,B03,093562,Greenfeld; Be'Eri,3,0,36,33
1657542616409,MATH 105,A01,085443,Carter; Anne Toulson,15,0,35,20
1657542616409,MATH 105,A02,093477,Carter; Anne Toulson,20,0,35,15
1657542622442,MATH 109,A01,083213,Ganzberger; Geoffrey Michael,2,0,34,32
1657542622442,MATH 109,A02,083214,Ganzberger; Geoffrey Michael,4,0,34,30
1657542622442,MATH 109,A03,093478,Ganzberger; Geoffrey Michael,2,0,34,32
1657542622442,MATH 109,B01,083215,Ganzberger; Geoffrey Michael,1,0,32,31
1657542622442,MATH 109,B02,083216,Ganzberger; Geoffrey Michael,2,0,32,30
1657542622442,MATH 109,B03,093479,Ganzberger; Geoffrey Michael,8,0,32,24
1657542628478,MATH 142A,A01,083219,Chow; Bennett,7,0,32,25
1657542628478,MATH 142A,A02,083220,Chow; Bennett,10,0,32,22
1657542628478,MATH 142A,A03,093480,Chow; Bennett,8,0,32,24
1657542628478,MATH 142A,B03,093481,Chow; Bennett,8,0,32,24
1657542628478,MATH 142A,B04,093558,Chow; Bennett,13,0,32,19
1657542628478,MATH 142A,B05,093559,Chow; Bennett,6,0,32,26
1657542634508,MATH 193A,A01,083224,Rotar; Vladimir,8,0,34,26
1657542634508,MATH 193A,A02,083225,Rotar; Vladimir,9,0,34,25
1657542634508,MATH 193A,A03,083781,Rotar; Vladimir,5,0,34,29
1657542634508,MATH 193A,A04,083782,Rotar; Vladimir,10,0,34,24
1657542634508,MATH 193A,A05,093482,Rotar; Vladimir,10,0,34,24
1657542640537,MATH 197,001,091859,McAuley; Julian John,9999,0,9999,0
1657542640537,MATH 197,002,095566,Kedlaya; Kiran S.,9997,0,9999,2
1657542640537,MATH 197,003,095567,Xiao; Ming,9999,0,9999,0
1657542640537,MATH 197,004,095571,Perols; Johan Lars,9998,0,9999,1
1657542647610,COGS 9,A01,083615,Shannon; Kyle Michael,9,0,75,66
1657542653636,COGS 11,A01,083617,Boyle; Mary E. T.,22,0,48,26
1657542659662,COGS 13,A01,083071,Bastos; Amalia Pinkusfeld,11,0,71,60
1657542665696,COGS 14A,A01,092681,Semenuks; Arturs,5,1,100,95
1657542671746,COGS 14B,A01,083073,Cheng; Tzu-Han,6,0,63,57
1657542677774,COGS 17,A01,092677,Semenuks; Arturs,6,0,81,75
1657542683798,COGS 100,A01,083619,Allen; Michael Gordon,17,0,70,53
1657542689828,COGS 101A,A01,083621,Davis; Joshua Daniel,9,0,68,59
1657542695866,COGS 101B,A01,091572,Allen; Michael Gordon,12,0,65,53
1657542701894,COGS 101C,A01,083625,Delgado; Tania,17,0,35,18
1657542707918,COGS 107A,A01,083627,Boyle; Mary E. T.,13,0,60,47
1657542713949,COGS 118A,A01,083075,Gupta; Anjum,21,0,76,55
1657542719978,CSE 3,A50,083646,Miranda; Gregory Joseph,24,0,50,26
1657542726008,CSE 8A,A50,083650,Miranda; Gregory Joseph,17,1,56,39
1657542732038,CSE 11,A01,083080,Cao; Yingjun,6,15,40,34
1657542738084,CSE 12,A01,083652,Krause-Levy; Sophia Louisa,28,1,120,92
1657542744120,CSE 15L,A01,083654,Morris; Justin Loren,9,0,50,41
1657542744120,CSE 15L,A02,083655,Morris; Justin Loren,9,0,50,41
1657542750149,CSE 20,A01,083657,Tran; Khoa Dang,39,0,80,41
1657542756178,CSE 21,A01,095574,Bach; Quang Tran,22,0,48,26
1657542762216,CSE 30,A01,083084,Eldon; John,5,0,80,75
1657542762216,CSE 30,B01,095061,Bhaskar; Nishant,9,0,50,41
1657542768243,CSE 100,A01,083659,Cao; Yingjun,5,4,70,65
1657542774274,CSE 134B,A01,083661,Powell; Thomas Allan,22,0,100,78
1657542780301,CSE 140,A01,083663,Gungor; Onat,15,0,85,70
1657542786327,CSE 140L,A01,083088,Eldon; John,21,0,100,79
1657542792357,CSE 175,A01,083665,Kumar; Rakesh,3,0,25,22
1657542798384,CSE 190,A00,092507,Dubnov; Shlomo,8,0,20,12
1657542804428,ECE 45,A01,083139,Congero; Spencer William,6,0,75,69
1657542810467,ECE 65,A50,083695,Saad; Andrew S,12,0,30,18
1657542810467,ECE 65,A51,095125,Saad; Andrew S,24,0,26,2
1657542816503,ECE 109,A01,091882,Touri; Behrouz,19,0,70,51
1657542822542,ECE 180,A00,083140,Abi Samra; Nicholas Camill,1,0,30,29
1657542822542,ECE 180,B00,083141,Abi Samra; Nicholas Camill,0,0,30,30
1657542828572,MATH 10A,A01,083735,Patchell; Gregory David,2,0,30,28
1657542828572,MATH 10A,A02,083736,Patchell; Gregory David,20,0,30,10
1657542828572,MATH 10A,A03,083737,Patchell; Gregory David,16,0,30,14
1657542834603,MATH 10B,A01,083207,Lim; Seonhee,8,0,34,26
1657542834603,MATH 10B,A02,083208,Lim; Seonhee,9,0,35,26
1657542834603,MATH 10B,A03,093472,Lim; Seonhee,7,0,34,27
1657542834603,MATH 10B,B01,083739,Sinha; Shubham,12,0,30,18
1657542840635,MATH 18,A01,083743,Cinel; Cameron Alexander,7,0,30,23
1657542840635,MATH 18,A02,083744,Cinel; Cameron Alexander,17,0,30,13
1657542840635,MATH 18,A03,083745,Cinel; Cameron Alexander,9,0,30,21
1657542840635,MATH 18,B01,083748,Rideout; David Porter,5,0,37,32
1657542840635,MATH 18,B02,083749,Rideout; David Porter,5,0,36,31
1657542840635,MATH 18,B03,083750,Rideout; David Porter,3,0,37,34
1657542840635,MATH 18,B04,083751,Rideout; David Porter,6,0,36,30
1657542840635,MATH 18,B05,093473,Rideout; David Porter,6,0,36,30
1657542840635,MATH 18,B06,093474,Rideout; David Porter,6,0,36,30
1657542846670,MATH 20A,A01,083754,Zheng; Zequn,14,0,40,26
1657542852700,MATH 20B,A01,083756,Briones; Jor-el Thomas Caparas,4,0,36,32
1657542852700,MATH 20B,A02,083757,Briones; Jor-el Thomas Caparas,1,0,36,35
1657542852700,MATH 20B,A03,093475,Briones; Jor-el Thomas Caparas,2,0,36,34
1657542858737,MATH 20C,A01,083760,Briones; Jor-el Thomas Caparas,1,0,35,34
1657542858737,MATH 20C,A02,083761,Briones; Jor-el Thomas Caparas,8,0,35,27
1657542858737,MATH 20C,A03,093476,Briones; Jor-el Thomas Caparas,0,1,36,36
1657542858737,MATH 20C,B01,083762,Bach; Quang Tran,1,0,30,29
1657542864766,MATH 20D,A01,083765,Tran; Brian Kha,5,0,30,25
1657542864766,MATH 20D,A02,083766,Tran; Brian Kha,5,0,30,25
1657542864766,MATH 20D,A03,083767,Tran; Brian Kha,5,0,30,25
1657542870793,MATH 20E,A01,083771,Ganguly; Soumya,9,0,32,23
1657542870793,MATH 20E,A02,083772,Ganguly; Soumya,6,0,32,26
1657542870793,MATH 20E,B01,083773,Ciotti; Benjamin,20,0,35,15
1657542870793,MATH 20E,B02,083774,Ciotti; Benjamin,17,0,35,18
1657542876818,MATH 103A,A01,083777,Greenfeld; Be'Eri,3,0,36,33
1657542876818,MATH 103A,A02,083778,Greenfeld; Be'Eri,5,0,36,31
1657542876818,MATH 103A,A03,093561,Greenfeld; Be'Eri,5,0,36,31
1657542876818,MATH 103A,B01,083779,Greenfeld; Be'Eri,7,0,36,29
1657542876818,MATH 103A,B02,083780,Greenfeld; Be'Eri,4,0,36,32
1657542876818,MATH 103A,B03,093562,Greenfeld; Be'Eri,3,0,36,33
1657542882844,MATH 105,A01,085443,Carter; Anne Toulson,15,0,35,20
1657542882844,MATH 105,A02,093477,Carter; Anne Toulson,20,0,35,15
1657542888871,MATH 109,A01,083213,Ganzberger; Geoffrey Michael,2,0,34,32
1657542888871,MATH 109,A02,083214,Ganzberger; Geoffrey Michael,4,0,34,30
1657542888871,MATH 109,A03,093478,Ganzberger; Geoffrey Michael,2,0,34,32
1657542888871,MATH 109,B01,083215,Ganzberger; Geoffrey Michael,1,0,32,31
1657542888871,MATH 109,B02,083216,Ganzberger; Geoffrey Michael,2,0,32,30
1657542888871,MATH 109,B03,093479,Ganzberger; Geoffrey Michael,8,0,32,24
1657542894902,MATH 142A,A01,083219,Chow; Bennett,7,0,32,25
1657542894902,MATH 142A,A02,083220,Chow; Bennett,10,0,32,22
1657542894902,MATH 142A,A03,093480,Chow; Bennett,8,0,32,24
1657542894902,MATH 142A,B03,093481,Chow; Bennett,8,0,32,24
1657542894902,MATH 142A,B04,093558,Chow; Bennett,13,0,32,19
1657542894902,MATH 142A,B05,093559,Chow; Bennett,6,0,32,26
1657542900927,MATH 193A,A01,083224,Rotar; Vladimir,8,0,34,26
1657542900927,MATH 193A,A02,083225,Rotar; Vladimir,9,0,34,25
1657542900927,MATH 193A,A03,083781,Rotar; Vladimir,5,0,34,29
1657542900927,MATH 193A,A04,083782,Rotar; Vladimir,10,0,34,24
1657542900927,MATH 193A,A05,093482,Rotar; Vladimir,10,0,34,24
1657542906952,MATH 197,001,091859,McAuley; Julian John,9999,0,9999,0
1657542906952,MATH 197,002,095566,Kedlaya; Kiran S.,9997,0,9999,2
1657542906952,MATH 197,003,095567,Xiao; Ming,9999,0,9999,0
1657542906952,MATH 197,004,095571,Perols; Johan Lars,9998,0,9999,1
1657542914020,COGS 9,A01,083615,Shannon; Kyle Michael,9,0,75,66
1657542920046,COGS 11,A01,083617,Boyle; Mary E. T.,22,0,48,26
1657542926071,COGS 13,A01,083071,Bastos; Amalia Pinkusfeld,11,0,71,60
1657542932099,COGS 14A,A01,092681,Semenuks; Arturs,5,1,100,95
1657542938141,COGS 14B,A01,083073,Cheng; Tzu-Han,6,0,63,57
1657542944169,COGS 17,A01,092677,Semenuks; Arturs,6,0,81,75
1657542950199,COGS 100,A01,083619,Allen; Michael Gordon,17,0,70,53
1657542956225,COGS 101A,A01,083621,Davis; Joshua Daniel,9,0,68,59
1657542962249,COGS 101B,A01,091572,Allen; Michael Gordon,12,0,65,53
1657542968288,COGS 101C,A01,083625,Delgado; Tania,17,0,35,18
1657542974317,COGS 107A,A01,083627,Boyle; Mary E. T.,13,0,60,47
1657542980342,COGS 118A,A01,083075,Gupta; Anjum,21,0,76,55
1657542986371,CSE 3,A50,083646,Miranda; Gregory Joseph,24,0,50,26
1657542992397,CSE 8A,A50,083650,Miranda; Gregory Joseph,17,1,56,39
1657542998424,CSE 11,A01,083080,Cao; Yingjun,6,15,40,34
1657543004452,CSE 12,A01,083652,Krause-Levy; Sophia Louisa,28,1,120,92
1657543010476,CSE 15L,A01,083654,Morris; Justin Loren,9,0,50,41
1657543010476,CSE 15L,A02,083655,Morris; Justin Loren,9,0,50,41
1657543016504,CSE 20,A01,083657,Tran; Khoa Dang,39,0,80,41
1657543022533,CSE 21,A01,095574,Bach; Quang Tran,22,0,48,26
1657543028564,CSE 30,A01,083084,Eldon; John,5,0,80,75
1657543028564,CSE 30,B01,095061,Bhaskar; Nishant,9,0,50,41
1657543034587,CSE 100,A01,083659,Cao; Yingjun,5,4,70,65
1657543040613,CSE 134B,A01,083661,Powell; Thomas Allan,22,0,100,78
1657543046640,CSE 140,A01,083663,Gungor; Onat,15,0,85,70
1657543052666,CSE 140L,A01,083088,Eldon; John,21,0,100,79
1657543058691,CSE 175,A01,083665,Kumar; Rakesh,3,0,25,22
1657543064716,CSE 190,A00,092507,Dubnov; Shlomo,8,0,20,12
1657543070739,ECE 45,A01,083139,Congero; Spencer William,6,0,75,69
1657543076767,ECE 65,A50,083695,Saad; Andrew S,12,0,30,18
1657543076767,ECE 65,A51,095125,Saad; Andrew S,24,0,26,2
1657543082869,ECE 109,A01,091882,Touri; Behrouz,19,0,70,51
1657543088894,ECE 180,A00,083140,Abi Samra; Nicholas Camill,1,0,30,29
1657543088894,ECE 180,B00,083141,Abi Samra; Nicholas Camill,0,0,30,30
1657543094918,MATH 10A,A01,083735,Patchell; Gregory David,2,0,30,28
1657543094918,MATH 10A,A02,083736,Patchell; Gregory David,20,0,30,10
1657543094918,MATH 10A,A03,083737,Patchell; Gregory David,16,0,30,14
1657543100948,MATH 10B,A01,083207,Lim; Seonhee,8,0,34,26
1657543100948,MATH 10B,A02,083208,Lim; Seonhee,9,0,35,26
1657543100948,MATH 10B,A03,093472,Lim; Seonhee,7,0,34,27
1657543100948,MATH 10B,B01,083739,Sinha; Shubham,12,0,30,18
1657543106994,MATH 18,A01,083743,Cinel; Cameron Alexander,7,0,30,23
1657543106994,MATH 18,A02,083744,Cinel; Cameron Alexander,17,0,30,13
1657543106994,MATH 18,A03,083745,Cinel; Cameron Alexander,9,0,30,21
1657543106994,MATH 18,B01,083748,Rideout; David Porter,5,0,37,32
1657543106994,MATH 18,B02,083749,Rideout; David Porter,5,0,36,31
1657543106994,MATH 18,B03,083750,Rideout; David Porter,3,0,37,34
1657543106994,MATH 18,B04,083751,Rideout; David Porter,6,0,36,30
1657543106994,MATH 18,B05,093473,Rideout; David Porter,6,0,36,30
1657543106994,MATH 18,B06,093474,Rideout; David Porter,6,0,36,30
1657543113027,MATH 20A,A01,083754,Zheng; Zequn,14,0,40,26
1657543119052,MATH 20B,A01,083756,Briones; Jor-el Thomas Caparas,4,0,36,32
1657543119052,MATH 20B,A02,083757,Briones; Jor-el Thomas Caparas,1,0,36,35
1657543119052,MATH 20B,A03,093475,Briones; Jor-el Thomas Caparas,2,0,36,34
1657543125077,MATH 20C,A01,083760,Briones; Jor-el Thomas Caparas,1,0,35,34
1657543125077,MATH 20C,A02,083761,Briones; Jor-el Thomas Caparas,8,0,35,27
1657543125077,MATH 20C,A03,093476,Briones; Jor-el Thomas Caparas,0,1,36,36
1657543125077,MATH 20C,B01,083762,Bach; Quang Tran,1,0,30,29
1657543131109,MATH 20D,A01,083765,Tran; Brian Kha,5,0,30,25
1657543131109,MATH 20D,A02,083766,Tran; Brian Kha,5,0,30,25
1657543131109,MATH 20D,A03,083767,Tran; Brian Kha,5,0,30,25
1657543137139,MATH 20E,A01,083771,Ganguly; Soumya,9,0,32,23
1657543137139,MATH 20E,A02,083772,Ganguly; Soumya,6,0,32,26
1657543137139,MATH 20E,B01,083773,Ciotti; Benjamin,20,0,35,15
1657543137139,MATH 20E,B02,083774,Ciotti; Benjamin,17,0,35,18
1657543143170,MATH 103A,A01,083777,Greenfeld; Be'Eri,3,0,36,33
1657543143170,MATH 103A,A02,083778,Greenfeld; Be'Eri,5,0,36,31
1657543143170,MATH 103A,A03,093561,Greenfeld; Be'Eri,5,0,36,31
1657543143170,MATH 103A,B01,083779,Greenfeld; Be'Eri,7,0,36,29
1657543143170,MATH 103A,B02,083780,Greenfeld; Be'Eri,4,0,36,32
1657543143170,MATH 103A,B03,093562,Greenfeld; Be'Eri,3,0,36,33
1657543149197,MATH 105,A01,085443,Carter; Anne Toulson,15,0,35,20
1657543149197,MATH 105,A02,093477,Carter; Anne Toulson,20,0,35,15
1657543155224,MATH 109,A01,083213,Ganzberger; Geoffrey Michael,2,0,34,32
1657543155224,MATH 109,A02,083214,Ganzberger; Geoffrey Michael,4,0,34,30
1657543155224,MATH 109,A03,093478,Ganzberger; Geoffrey Michael,2,0,34,32
1657543155224,MATH 109,B01,083215,Ganzberger; Geoffrey Michael,1,0,32,31
1657543155224,MATH 109,B02,083216,Ganzberger; Geoffrey Michael,2,0,32,30
1657543155224,MATH 109,B03,093479,Ganzberger; Geoffrey Michael,8,0,32,24
1657543161249,MATH 142A,A01,083219,Chow; Bennett,7,0,32,25
1657543161249,MATH 142A,A02,083220,Chow; Bennett,10,0,32,22
1657543161249,MATH 142A,A03,093480,Chow; Bennett,8,0,32,24
1657543161249,MATH 142A,B03,093481,Chow; Bennett,8,0,32,24
1657543161249,MATH 142A,B04,093558,Chow; Bennett,13,0,32,19
1657543161249,MATH 142A,B05,093559,Chow; Bennett,6,0,32,26
1657543167277,MATH 193A,A01,083224,Rotar; Vladimir,8,0,34,26
1657543167277,MATH 193A,A02,083225,Rotar; Vladimir,9,0,34,25
1657543167277,MATH 193A,A03,083781,Rotar; Vladimir,5,0,34,29
1657543167277,MATH 193A,A04,083782,Rotar; Vladimir,10,0,34,24
1657543167277,MATH 193A,A05,093482,Rotar; Vladimir,10,0,34,24
1657543173304,MATH 197,001,091859,McAuley; Julian John,9999,0,9999,0
1657543173304,MATH 197,002,095566,Kedlaya; Kiran S.,9997,0,9999,2
1657543173304,MATH 197,003,095567,Xiao; Ming,9999,0,9999,0
1657543173304,MATH 197,004,095571,Perols; Johan Lars,9998,0,9999,1
1657543180373,COGS 9,A01,083615,Shannon; Kyle Michael,9,0,75,66
1657543186401,COGS 11,A01,083617,Boyle; Mary E. T.,22,0,48,26
1657543192425,COGS 13,A01,083071,Bastos; Amalia Pinkusfeld,11,0,71,60
1657543198450,COGS 14A,A01,092681,Semenuks; Arturs,5,1,100,95
1657543204474,COGS 14B,A01,083073,Cheng; Tzu-Han,6,0,63,57
1657543210499,COGS 17,A01,092677,Semenuks; Arturs,6,0,81,75
1657543216522,COGS 100,A01,083619,Allen; Michael Gordon,17,0,70,53
1657543222545,COGS 101A,A01,083621,Davis; Joshua Daniel,9,0,68,59
1657543228572,COGS 101B,A01,091572,Allen; Michael Gordon,12,0,65,53
1657543234598,COGS 101C,A01,083625,Delgado; Tania,17,0,35,18
1657543240626,COGS 107A,A01,083627,Boyle; Mary E. T.,13,0,60,47
1657543246653,COGS 118A,A01,083075,Gupta; Anjum,21,0,76,55
1657543252684,CSE 3,A50,083646,Miranda; Gregory Joseph,24,0,50,26
1657543258710,CSE 8A,A50,083650,Miranda; Gregory Joseph,17,1,56,39
1657543264738,CSE 11,A01,083080,Cao; Yingjun,6,15,40,34
1657543270762,CSE 12,A01,083652,Krause-Levy; Sophia Louisa,28,1,120,92
1657543276790,CSE 15L,A01,083654,Morris; Justin Loren,9,0,50,41
1657543276790,CSE 15L,A02,083655,Morris; Justin Loren,9,0,50,41
1657543282813,CSE 20,A01,083657,Tran; Khoa Dang,39,0,80,41
1657543288838,CSE 21,A01,095574,Bach; Quang Tran,22,0,48,26
1657543294862,CSE 30,A01,083084,Eldon; John,5,0,80,75
1657543294862,CSE 30,B01,095061,Bhaskar; Nishant,9,0,50,41
1657543300889,CSE 100,A01,083659,Cao; Yingjun,5,4,70,65
1657543306919,CSE 134B,A01,083661,Powell; Thomas Allan,22,0,100,78
1657543312945,CSE 140,A01,083663,Gungor; Onat,15,0,85,70
1657543318969,CSE 140L,A01,083088,Eldon; John,21,0,100,79
1657543324992,CSE 175,A01,083665,Kumar; Rakesh,3,0,25,22
1657543331020,CSE 190,A00,092507,Dubnov; Shlomo,8,0,20,12
1657543337052,ECE 45,A01,083139,Congero; Spencer William,6,0,75,69
1657543343076,ECE 65,A50,083695,Saad; Andrew S,12,0,30,18
1657543343076,ECE 65,A51,095125,Saad; Andrew S,24,0,26,2
1657543349102,ECE 109,A01,091882,Touri; Behrouz,19,0,70,51
1657543355131,ECE 180,A00,083140,Abi Samra; Nicholas Camill,1,0,30,29
1657543355131,ECE 180,B00,083141,Abi Samra; Nicholas Camill,0,0,30,30
1657543361160,MATH 10A,A01,083735,Patchell; Gregory David,2,0,30,28
1657543361160,MATH 10A,A02,083736,Patchell; Gregory David,20,0,30,10
1657543361160,MATH 10A,A03,083737,Patchell; Gregory David,16,0,30,14
1657543367190,MATH 10B,A01,083207,Lim; Seonhee,8,0,34,26
1657543367190,MATH 10B,A02,083208,Lim; Seonhee,9,0,35,26
1657543367190,MATH 10B,A03,093472,Lim; Seonhee,7,0,34,27
1657543367190,MATH 10B,B01,083739,Sinha; Shubham,12,0,30,18
1657543373216,MATH 18,A01,083743,Cinel; Cameron Alexander,7,0,30,23
1657543373216,MATH 18,A02,083744,Cinel; Cameron Alexander,17,0,30,13
1657543373216,MATH 18,A03,083745,Cinel; Cameron Alexander,9,0,30,21
1657543373216,MATH 18,B01,083748,Rideout; David Porter,5,0,37,32
1657543373216,MATH 18,B02,083749,Rideout; David Porter,5,0,36,31
1657543373216,MATH 18,B03,083750,Rideout; David Porter,3,0,37,34
1657543373216,MATH 18,B04,083751,Rideout; David Porter,6,0,36,30
1657543373216,MATH 18,B05,093473,Rideout; David Porter,6,0,36,30
1657543373216,MATH 18,B06,093474,Rideout; David Porter,6,0,36,30
1657543379240,MATH 20A,A01,083754,Zheng; Zequn,14,0,40,26
1657543385264,MATH 20B,A01,083756,Briones; Jor-el Thomas Caparas,4,0,36,32
1657543385264,MATH 20B,A02,083757,Briones; Jor-el Thomas Caparas,1,0,36,35
1657543385264,MATH 20B,A03,093475,Briones; Jor-el Thomas Caparas,2,0,36,34
1657543391294,MATH 20C,A01,083760,Briones; Jor-el Thomas Caparas,1,0,35,34
1657543391294,MATH 20C,A02,083761,Briones; Jor-el Thomas Caparas,8,0,35,27
1657543391294,MATH 20C,A03,093476,Briones; Jor-el Thomas Caparas,0,1,36,36
1657543391294,MATH 20C,B01,083762,Bach; Quang Tran,1,0,30,29
1657543397331,MATH 20D,A01,083765,Tran; Brian Kha,5,0,30,25
1657543397331,MATH 20D,A02,083766,Tran; Brian Kha,5,0,30,25
1657543397331,MATH 20D,A03,083767,Tran; Brian Kha,5,0,30,25
1657543403360,MATH 20E,A01,083771,Ganguly; Soumya,9,0,32,23
1657543403360,MATH 20E,A02,083772,Ganguly; Soumya,6,0,32,26
1657543403360,MATH 20E,B01,083773,Ciotti; Benjamin,20,0,35,15
1657543403360,MATH 20E,B02,083774,Ciotti; Benjamin,17,0,35,18
1657543409384,MATH 103A,A01,083777,Greenfeld; Be'Eri,3,0,36,33
1657543409384,MATH 103A,A02,083778,Greenfeld; Be'Eri,5,0,36,31
1657543409384,MATH 103A,A03,093561,Greenfeld; Be'Eri,5,0,36,31
1657543409384,MATH 103A,B01,083779,Greenfeld; Be'Eri,7,0,36,29
1657543409384,MATH 103A,B02,083780,Greenfeld; Be'Eri,4,0,36,32
1657543409384,MATH 103A,B03,093562,Greenfeld; Be'Eri,3,0,36,33
1657543415412,MATH 105,A01,085443,Carter; Anne Toulson,15,0,35,20
1657543415412,MATH 105,A02,093477,Carter; Anne Toulson,20,0,35,15
1657543421443,MATH 109,A01,083213,Ganzberger; Geoffrey Michael,2,0,34,32
1657543421443,MATH 109,A02,083214,Ganzberger; Geoffrey Michael,4,0,34,30
1657543421443,MATH 109,A03,093478,Ganzberger; Geoffrey Michael,2,0,34,32
1657543421443,MATH 109,B01,083215,Ganzberger; Geoffrey Michael,1,0,32,31
1657543421443,MATH 109,B02,083216,Ganzberger; Geoffrey Michael,2,0,32,30
1657543421443,MATH 109,B03,093479,Ganzberger; Geoffrey Michael,8,0,32,24
1657543427468,MATH 142A,A01,083219,Chow; Bennett,7,0,32,25
1657543427468,MATH 142A,A02,083220,Chow; Bennett,10,0,32,22
1657543427468,MATH 142A,A03,093480,Chow; Bennett,8,0,32,24
1657543427468,MATH 142A,B03,093481,Chow; Bennett,8,0,32,24
1657543427468,MATH 142A,B04,093558,Chow; Bennett,13,0,32,19
1657543427468,MATH 142A,B05,093559,Chow; Bennett,6,0,32,26
1657543433492,MATH 193A,A01,083224,Rotar; Vladimir,8,0,34,26
1657543433492,MATH 193A,A02,083225,Rotar; Vladimir,9,0,34,25
1657543433492,MATH 193A,A03,083781,Rotar; Vladimir,5,0,34,29
1657543433492,MATH 193A,A04,083782,Rotar; Vladimir,10,0,34,24
1657543433492,MATH 193A,A05,093482,Rotar; Vladimir,10,0,34,24
1657543439516,MATH 197,001,091859,McAuley; Julian John,9999,0,9999,0
1657543439516,MATH 197,002,095566,Kedlaya; Kiran S.,9997,0,9999,2
1657543439516,MATH 197,003,095567,Xiao; Ming,9999,0,9999,0
1657543439516,MATH 197,004,095571,Perols; Johan Lars,9998,0,9999,1
1657543446597,COGS 9,A01,083615,Shannon; Kyle Michael,9,0,75,66
1657543452635,COGS 11,A01,083617,Boyle; Mary E. T.,22,0,48,26
1657543458660,COGS 13,A01,083071,Bastos; Amalia Pinkusfeld,11,0,71,60
1657543464690,COGS 14A,A01,092681,Semenuks; Arturs,5,1,100,95
1657543470719,COGS 14B,A01,083073,Cheng; Tzu-Han,6,0,63,57
1657543476745,COGS 17,A01,092677,Semenuks; Arturs,6,0,81,75
1657543482776,COGS 100,A01,083619,Allen; Michael Gordon,17,0,70,53
1657543488802,COGS 101A,A01,083621,Davis; Joshua Daniel,9,0,68,59
1657543494830,COGS 101B,A01,091572,Allen; Michael Gordon,12,0,65,53
1657543500859,COGS 101C,A01,083625,Delgado; Tania,17,0,35,18
1657543506883,COGS 107A,A01,083627,Boyle; Mary E. T.,13,0,60,47
1657543512911,COGS 118A,A01,083075,Gupta; Anjum,21,0,76,55
1657543518935,CSE 3,A50,083646,Miranda; Gregory Joseph,24,0,50,26
1657543524965,CSE 8A,A50,083650,Miranda; Gregory Joseph,17,1,56,39
1657543530989,CSE 11,A01,083080,Cao; Yingjun,6,15,40,34
1657543537021,CSE 12,A01,083652,Krause-Levy; Sophia Louisa,28,1,120,92
1657543543051,CSE 15L,A01,083654,Morris; Justin Loren,9,0,50,41
1657543543051,CSE 15L,A02,083655,Morris; Justin Loren,9,0,50,41
1657543549076,CSE 20,A01,083657,Tran; Khoa Dang,39,0,80,41
1657543555104,CSE 21,A01,095574,Bach; Quang Tran,22,0,48,26
1657543561135,CSE 30,A01,083084,Eldon; John,5,0,80,75
1657543561135,CSE 30,B01,095061,Bhaskar; Nishant,9,0,50,41
1657543567159,CSE 100,A01,083659,Cao; Yingjun,5,4,70,65
1657543573186,CSE 134B,A01,083661,Powell; Thomas Allan,22,0,100,78
1657543579209,CSE 140,A01,083663,Gungor; Onat,15,0,85,70
1657543585239,CSE 140L,A01,083088,Eldon; John,21,0,100,79
1657543591264,CSE 175,A01,083665,Kumar; Rakesh,3,0,25,22
1657543597297,CSE 190,A00,092507,Dubnov; Shlomo,8,0,20,12
1657543603328,ECE 45,A01,083139,Congero; Spencer William,6,0,75,69
1657543609354,ECE 65,A50,083695,Saad; Andrew S,12,0,30,18
1657543609354,ECE 65,A51,095125,Saad; Andrew S,24,0,26,2
1657543615377,ECE 109,A01,091882,Touri; Behrouz,19,0,70,51
1657543621407,ECE 180,A00,083140,Abi Samra; Nicholas Camill,1,0,30,29
1657543621407,ECE 180,B00,083141,Abi Samra; Nicholas Camill,0,0,30,30
1657543627433,MATH 10A,A01,083735,Patchell; Gregory David,2,0,30,28
1657543627433,MATH 10A,A02,083736,Patchell; Gregory David,20,0,30,10
1657543627433,MATH 10A,A03,083737,Patchell; Gregory David,16,0,30,14
1657543633459,MATH 10B,A01,083207,Lim; Seonhee,8,0,34,26
1657543633459,MATH 10B,A02,083208,Lim; Seonhee,9,0,35,26
1657543633459,MATH 10B,A03,093472,Lim; Seonhee,7,0,34,27
1657543633459,MATH 10B,B01,083739,Sinha; Shubham,12,0,30,18
1657543639489,MATH 18,A01,083743,Cinel; Cameron Alexander,7,0,30,23
1657543639489,MATH 18,A02,083744,Cinel; Cameron Alexander,17,0,30,13
1657543639489,MATH 18,A03,083745,Cinel; Cameron Alexander,9,0,30,21
1657543639489,MATH 18,B01,083748,Rideout; David Porter,5,0,37,32
1657543639489,MATH 18,B02,083749,Rideout; David Porter,5,0,36,31
1657543639489,MATH 18,B03,083750,Rideout; David Porter,3,0,37,34
1657543639489,MATH 18,B04,083751,Rideout; David Porter,6,0,36,30
1657543639489,MATH 18,B05,093473,Rideout; David Porter,6,0,36,30
1657543639489,MATH 18,B06,093474,Rideout; David Porter,6,0,36,30
1657543645515,MATH 20A,A01,083754,Zheng; Zequn,14,0,40,26
1657543651542,MATH 20B,A01,083756,Briones; Jor-el Thomas Caparas,4,0,36,32
1657543651542,MATH 20B,A02,083757,Briones; Jor-el Thomas Caparas,1,0,36,35
1657543651542,MATH 20B,A03,093475,Briones; Jor-el Thomas Caparas,2,0,36,34
1657543657574,MATH 20C,A01,083760,Briones; Jor-el Thomas Caparas,1,0,35,34
1657543657574,MATH 20C,A02,083761,Briones; Jor-el Thomas Caparas,8,0,35,27
1657543657574,MATH 20C,A03,093476,Briones; Jor-el Thomas Caparas,0,1,36,36
1657543657574,MATH 20C,B01,083762,Bach; Quang Tran,1,0,30,29
1657543663602,MATH 20D,A01,083765,Tran; Brian Kha,5,0,30,25
1657543663602,MATH 20D,A02,083766,Tran; Brian Kha,5,0,30,25
1657543663602,MATH 20D,A03,083767,Tran; Brian Kha,5,0,30,25
1657543669627,MATH 20E,A01,083771,Ganguly; Soumya,9,0,32,23
1657543669627,MATH 20E,A02,083772,Ganguly; Soumya,6,0,32,26
1657543669627,MATH 20E,B01,083773,Ciotti; Benjamin,20,0,35,15
1657543669627,MATH 20E,B02,083774,Ciotti; Benjamin,17,0,35,18
1657543675662,MATH 103A,A01,083777,Greenfeld; Be'Eri,3,0,36,33
1657543675662,MATH 103A,A02,083778,Greenfeld; Be'Eri,5,0,36,31
1657543675662,MATH 103A,A03,093561,Greenfeld; Be'Eri,5,0,36,31
1657543675662,MATH 103A,B01,083779,Greenfeld; Be'Eri,7,0,36,29
1657543675662,MATH 103A,B02,083780,Greenfeld; Be'Eri,4,0,36,32
1657543675662,MATH 103A,B03,093562,Greenfeld; Be'Eri,3,0,36,33
1657543681761,MATH 105,A01,085443,Carter; Anne Toulson,15,0,35,20
1657543681761,MATH 105,A02,093477,Carter; Anne Toulson,20,0,35,15
1657543687793,MATH 109,A01,083213,Ganzberger; Geoffrey Michael,2,0,34,32
1657543687793,MATH 109,A02,083214,Ganzberger; Geoffrey Michael,4,0,34,30
1657543687793,MATH 109,A03,093478,Ganzberger; Geoffrey Michael,2,0,34,32
1657543687793,MATH 109,B01,083215,Ganzberger; Geoffrey Michael,1,0,32,31
1657543687793,MATH 109,B02,083216,Ganzberger; Geoffrey Michael,2,0,32,30
1657543687793,MATH 109,B03,093479,Ganzberger; Geoffrey Michael,8,0,32,24
1657543693826,MATH 142A,A01,083219,Chow; Bennett,7,0,32,25
1657543693826,MATH 142A,A02,083220,Chow; Bennett,10,0,32,22
1657543693826,MATH 142A,A03,093480,Chow; Bennett,8,0,32,24
1657543693826,MATH 142A,B03,093481,Chow; Bennett,8,0,32,24
1657543693826,MATH 142A,B04,093558,Chow; Bennett,13,0,32,19
1657543693826,MATH 142A,B05,093559,Chow; Bennett,6,0,32,26
1657543699858,MATH 193A,A01,083224,Rotar; Vladimir,8,0,34,26
1657543699858,MATH 193A,A02,083225,Rotar; Vladimir,9,0,34,25
1657543699858,MATH 193A,A03,083781,Rotar; Vladimir,5,0,34,29
1657543699858,MATH 193A,A04,083782,Rotar; Vladimir,10,0,34,24
1657543699858,MATH 193A,A05,093482,Rotar; Vladimir,10,0,34,24
1657543705884,MATH 197,001,091859,McAuley; Julian John,9999,0,9999,0
1657543705884,MATH 197,002,095566,Kedlaya; Kiran S.,9997,0,9999,2
1657543705884,MATH 197,003,095567,Xiao; Ming,9999,0,9999,0
1657543705884,MATH 197,004,095571,Perols; Johan Lars,9998,0,9999,1
1657543712957,COGS 9,A01,083615,Shannon; Kyle Michael,9,0,75,66
1657543718981,COGS 11,A01,083617,Boyle; Mary E. T.,22,0,48,26
1657543725007,COGS 13,A01,083071,Bastos; Amalia Pinkusfeld,11,0,71,60
1657543731032,COGS 14A,A01,092681,Semenuks; Arturs,5,1,100,95
1657543737057,COGS 14B,A01,083073,Cheng; Tzu-Han,6,0,63,57
1657543743085,COGS 17,A01,092677,Semenuks; Arturs,6,0,81,75
1657543749111,COGS 100,A01,083619,Allen; Michael Gordon,17,0,70,53
1657543755135,COGS 101A,A01,083621,Davis; Joshua Daniel,9,0,68,59
1657543761164,COGS 101B,A01,091572,Allen; Michael Gordon,12,0,65,53
1657543767190,COGS 101C,A01,083625,Delgado; Tania,17,0,35,18
1657543773217,COGS 107A,A01,083627,Boyle; Mary E. T.,13,0,60,47
1657543779247,COGS 118A,A01,083075,Gupta; Anjum,21,0,76,55
1657543785277,CSE 3,A50,083646,Miranda; Gregory Joseph,24,0,50,26
1657543791306,CSE 8A,A50,083650,Miranda; Gregory Joseph,17,1,56,39
1657543797338,CSE 11,A01,083080,Cao; Yingjun,6,15,40,34
1657543803365,CSE 12,A01,083652,Krause-Levy; Sophia Louisa,28,1,120,92
1657543809393,CSE 15L,A01,083654,Morris; Justin Loren,9,0,50,41
1657543809393,CSE 15L,A02,083655,Morris; Justin Loren,9,0,50,41
1657543815423,CSE 20,A01,083657,Tran; Khoa Dang,39,0,80,41
1657543821451,CSE 21,A01,095574,Bach; Quang Tran,22,0,48,26
1657543827489,CSE 30,A01,083084,Eldon; John,5,0,80,75
1657543827489,CSE 30,B01,095061,Bhaskar; Nishant,9,0,50,41
1657543833524,CSE 100,A01,083659,Cao; Yingjun,5,4,70,65
1657543839547,CSE 134B,A01,083661,Powell; Thomas Allan,22,0,100,78
1657543845576,CSE 140,A01,083663,Gungor; Onat,15,0,85,70
1657543851602,CSE 140L,A01,083088,Eldon; John,21,0,100,79
1657543857627,CSE 175,A01,083665,Kumar; Rakesh,3,0,25,22
1657543863651,CSE 190,A00,092507,Dubnov; Shlomo,8,0,20,12
1657543869682,ECE 45,A01,083139,Congero; Spencer William,6,0,75,69
1657543875715,ECE 65,A50,083695,Saad; Andrew S,12,0,30,18
1657543875715,ECE 65,A51,095125,Saad; Andrew S,24,0,26,2
1657543881750,ECE 109,A01,091882,Touri; Behrouz,19,0,70,51
1657543887773,ECE 180,A00,083140,Abi Samra; Nicholas Camill,1,0,30,29
1657543887773,ECE 180,B00,083141,Abi Samra; Nicholas Camill,0,0,30,30
1657543893802,MATH 10A,A01,083735,Patchell; Gregory David,2,0,30,28
1657543893802,MATH 10A,A02,083736,Patchell; Gregory David,20,0,30,10
1657543893802,MATH 10A,A03,083737,Patchell; Gregory David,16,0,30,14
1657543899826,MATH 10B,A01,083207,Lim; Seonhee,8,0,34,26
1657543899826,MATH 10B,A02,083208,Lim; Seonhee,9,0,35,26
1657543899826,MATH 10B,A03,093472,Lim; Seonhee,7,0,34,27
1657543899826,MATH 10B,B01,083739,Sinha; Shubham,12,0,30,18
1657543905864,MATH 18,A01,083743,Cinel; Cameron Alexander,7,0,30,23
1657543905864,MATH 18,A02,083744,Cinel; Cameron Alexander,17,0,30,13
1657543905864,MATH 18,A03,083745,Cinel; Cameron Alexander,9,0,30,21
1657543905864,MATH 18,B01,083748,Rideout; David Porter,5,0,37,32
1657543905864,MATH 18,B02,083749,Rideout; David Porter,5,0,36,31
1657543905864,MATH 18,B03,083750,Rideout; David Porter,3,0,37,34
1657543905864,MATH 18,B04,083751,Rideout; David Porter,6,0,36,30
1657543905864,MATH 18,B05,093473,Rideout; David Porter,6,0,36,30
1657543905864,MATH 18,B06,093474,Rideout; David Porter,6,0,36,30
1657543911893,MATH 20A,A01,083754,Zheng; Zequn,14,0,40,26
1657543917923,MATH 20B,A01,083756,Briones; Jor-el Thomas Caparas,4,0,36,32
1657543917923,MATH 20B,A02,083757,Briones; Jor-el Thomas Caparas,1,0,36,35
1657543917923,MATH 20B,A03,093475,Briones; Jor-el Thomas Caparas,2,0,36,34
1657543923955,MATH 20C,A01,083760,Briones; Jor-el Thomas Caparas,1,0,35,34
1657543923955,MATH 20C,A02,083761,Briones; Jor-el Thomas Caparas,8,0,35,27
1657543923955,MATH 20C,A03,093476,Briones; Jor-el Thomas Caparas,0,1,36,36
1657543923955,MATH 20C,B01,083762,Bach; Quang Tran,1,0,30,29
1657543929982,MATH 20D,A01,083765,Tran; Brian Kha,5,0,30,25
1657543929982,MATH 20D,A02,083766,Tran; Brian Kha,5,0,30,25
1657543929982,MATH 20D,A03,083767,Tran; Brian Kha,5,0,30,25
1657543936019,MATH 20E,A01,083771,Ganguly; Soumya,9,0,32,23
1657543936019,MATH 20E,A02,083772,Ganguly; Soumya,6,0,32,26
1657543936019,MATH 20E,B01,083773,Ciotti; Benjamin,20,0,35,15
1657543936019,MATH 20E,B02,083774,Ciotti; Benjamin,17,0,35,18
1657543942054,MATH 103A,A01,083777,Greenfeld; Be'Eri,3,0,36,33
1657543942054,MATH 103A,A02,083778,Greenfeld; Be'Eri,5,0,36,31
1657543942054,MATH 103A,A03,093561,Greenfeld; Be'Eri,5,0,36,31
1657543942054,MATH 103A,B01,083779,Greenfeld; Be'Eri,7,0,36,29
1657543942054,MATH 103A,B02,083780,Greenfeld; Be'Eri,4,0,36,32
1657543942054,MATH 103A,B03,093562,Greenfeld; Be'Eri,3,0,36,33
1657543948085,MATH 105,A01,085443,Carter; Anne Toulson,15,0,35,20
1657543948085,MATH 105,A02,093477,Carter; Anne Toulson,20,0,35,15
1657543954110,MATH 109,A01,083213,Ganzberger; Geoffrey Michael,2,0,34,32
1657543954110,MATH 109,A02,083214,Ganzberger; Geoffrey Michael,4,0,34,30
1657543954110,MATH 109,A03,093478,Ganzberger; Geoffrey Michael,2,0,34,32
1657543954110,MATH 109,B01,083215,Ganzberger; Geoffrey Michael,1,0,32,31
1657543954110,MATH 109,B02,083216,Ganzberger; Geoffrey Michael,2,0,32,30
1657543954110,MATH 109,B03,093479,Ganzberger; Geoffrey Michael,8,0,32,24
1657543960135,MATH 142A,A01,083219,Chow; Bennett,7,0,32,25
1657543960135,MATH 142A,A02,083220,Chow; Bennett,10,0,32,22
1657543960135,MATH 142A,A03,093480,Chow; Bennett,8,0,32,24
1657543960135,MATH 142A,B03,093481,Chow; Bennett,8,0,32,24
1657543960135,MATH 142A,B04,093558,Chow; Bennett,13,0,32,19
1657543960135,MATH 142A,B05,093559,Chow; Bennett,6,0,32,26
1657543966163,MATH 193A,A01,083224,Rotar; Vladimir,8,0,34,26
1657543966163,MATH 193A,A02,083225,Rotar; Vladimir,9,0,34,25
1657543966163,MATH 193A,A03,083781,Rotar; Vladimir,5,0,34,29
1657543966163,MATH 193A,A04,083782,Rotar; Vladimir,10,0,34,24
1657543966163,MATH 193A,A05,093482,Rotar; Vladimir,10,0,34,24
1657543972194,MATH 197,001,091859,McAuley; Julian John,9999,0,9999,0
1657543972194,MATH 197,002,095566,Kedlaya; Kiran S.,9997,0,9999,2
1657543972194,MATH 197,003,095567,Xiao; Ming,9999,0,9999,0
1657543972194,MATH 197,004,095571,Perols; Johan Lars,9998,0,9999,1
1657543979255,COGS 9,A01,083615,Shannon; Kyle Michael,9,0,75,66
1657543985283,COGS 11,A01,083617,Boyle; Mary E. T.,22,0,48,26
1657543991315,COGS 13,A01,083071,Bastos; Amalia Pinkusfeld,11,0,71,60
1657543997346,COGS 14A,A01,092681,Semenuks; Arturs,5,1,100,95
1657544003370,COGS 14B,A01,083073,Cheng; Tzu-Han,6,0,63,57
1657544009400,COGS 17,A01,092677,Semenuks; Arturs,6,0,81,75
1657544015425,COGS 100,A01,083619,Allen; Michael Gordon,17,0,70,53
1657544021454,COGS 101A,A01,083621,Davis; Joshua Daniel,9,0,68,59
1657544027480,COGS 101B,A01,091572,Allen; Michael Gordon,12,0,65,53
1657544033507,COGS 101C,A01,083625,Delgado; Tania,17,0,35,18
1657544039535,COGS 107A,A01,083627,Boyle; Mary E. T.,13,0,60,47
1657544045564,COGS 118A,A01,083075,Gupta; Anjum,21,0,76,55
1657544051591,CSE 3,A50,083646,Miranda; Gregory Joseph,24,0,50,26
1657544057618,CSE 8A,A50,083650,Miranda; Gregory Joseph,17,1,56,39
1657544063646,CSE 11,A01,083080,Cao; Yingjun,6,15,40,34
1657544069672,CSE 12,A01,083652,Krause-Levy; Sophia Louisa,28,1,120,92
1657544075702,CSE 15L,A01,083654,Morris; Justin Loren,9,0,50,41
1657544075702,CSE 15L,A02,083655,Morris; Justin Loren,9,0,50,41
1657544081727,CSE 20,A01,083657,Tran; Khoa Dang,39,0,80,41
1657544087754,CSE 21,A01,095574,Bach; Quang Tran,22,0,48,26
1657544093779,CSE 30,A01,083084,Eldon; John,5,0,80,75
1657544093779,CSE 30,B01,095061,Bhaskar; Nishant,9,0,50,41
1657544099802,CSE 100,A01,083659,Cao; Yingjun,5,4,70,65
1657544105829,CSE 134B,A01,083661,Powell; Thomas Allan,22,0,100,78
1657544111862,CSE 140,A01,083663,Gungor; Onat,15,0,85,70
1657544117886,CSE 140L,A01,083088,Eldon; John,21,0,100,79
1657544123911,CSE 175,A01,083665,Kumar; Rakesh,3,0,25,22
1657544129935,CSE 190,A00,092507,Dubnov; Shlomo,8,0,20,12
1657544135962,ECE 45,A01,083139,Congero; Spencer William,6,0,75,69
1657544141989,ECE 65,A50,083695,Saad; Andrew S,12,0,30,18
1657544141989,ECE 65,A51,095125,Saad; Andrew S,24,0,26,2
1657544148014,ECE 109,A01,091882,Touri; Behrouz,19,0,70,51
1657544154044,ECE 180,A00,083140,Abi Samra; Nicholas Camill,1,0,30,29
1657544154044,ECE 180,B00,083141,Abi Samra; Nicholas Camill,0,0,30,30
1657544160077,MATH 10A,A01,083735,Patchell; Gregory David,2,0,30,28
1657544160077,MATH 10A,A02,083736,Patchell; Gregory David,20,0,30,10
1657544160077,MATH 10A,A03,083737,Patchell; Gregory David,16,0,30,14
1657544166103,MATH 10B,A01,083207,Lim; Seonhee,8,0,34,26
1657544166103,MATH 10B,A02,083208,Lim; Seonhee,9,0,35,26
1657544166103,MATH 10B,A03,093472,Lim; Seonhee,7,0,34,27
1657544166103,MATH 10B,B01,083739,Sinha; Shubham,12,0,30,18
1657544172139,MATH 18,A01,083743,Cinel; Cameron Alexander,7,0,30,23
1657544172139,MATH 18,A02,083744,Cinel; Cameron Alexander,17,0,30,13
1657544172139,MATH 18,A03,083745,Cinel; Cameron Alexander,9,0,30,21
1657544172139,MATH 18,B01,083748,Rideout; David Porter,5,0,37,32
1657544172139,MATH 18,B02,083749,Rideout; David Porter,5,0,36,31
1657544172139,MATH 18,B03,083750,Rideout; David Porter,3,0,37,34
1657544172139,MATH 18,B04,083751,Rideout; David Porter,6,0,36,30
1657544172139,MATH 18,B05,093473,Rideout; David Porter,6,0,36,30
1657544172139,MATH 18,B06,093474,Rideout; David Porter,6,0,36,30
1657544178164,MATH 20A,A01,083754,Zheng; Zequn,14,0,40,26
1657544184191,MATH 20B,A01,083756,Briones; Jor-el Thomas Caparas,4,0,36,32
1657544184191,MATH 20B,A02,083757,Briones; Jor-el Thomas Caparas,1,0,36,35
1657544184191,MATH 20B,A03,093475,Briones; Jor-el Thomas Caparas,2,0,36,34
1657544190214,MATH 20C,A01,083760,Briones; Jor-el Thomas Caparas,1,0,35,34
1657544190214,MATH 20C,A02,083761,Briones; Jor-el Thomas Caparas,8,0,35,27
1657544190214,MATH 20C,A03,093476,Briones; Jor-el Thomas Caparas,0,1,36,36
1657544190214,MATH 20C,B01,083762,Bach; Quang Tran,1,0,30,29
1657544196251,MATH 20D,A01,083765,Tran; Brian Kha,5,0,30,25
1657544196251,MATH 20D,A02,083766,Tran; Brian Kha,5,0,30,25
1657544196251,MATH 20D,A03,083767,Tran; Brian Kha,5,0,30,25
1657544202283,MATH 20E,A01,083771,Ganguly; Soumya,9,0,32,23
1657544202283,MATH 20E,A02,083772,Ganguly; Soumya,6,0,32,26
1657544202283,MATH 20E,B01,083773,Ciotti; Benjamin,20,0,35,15
1657544202283,MATH 20E,B02,083774,Ciotti; Benjamin,17,0,35,18
1657544208316,MATH 103A,A01,083777,Greenfeld; Be'Eri,3,0,36,33
1657544208316,MATH 103A,A02,083778,Greenfeld; Be'Eri,5,0,36,31
1657544208316,MATH 103A,A03,093561,Greenfeld; Be'Eri,5,0,36,31
1657544208316,MATH 103A,B01,083779,Greenfeld; Be'Eri,7,0,36,29
1657544208316,MATH 103A,B02,083780,Greenfeld; Be'Eri,4,0,36,32
1657544208316,MATH 103A,B03,093562,Greenfeld; Be'Eri,3,0,36,33
1657544214338,MATH 105,A01,085443,Carter; Anne Toulson,15,0,35,20
1657544214338,MATH 105,A02,093477,Carter; Anne Toulson,20,0,35,15
1657544220373,MATH 109,A01,083213,Ganzberger; Geoffrey Michael,2,0,34,32
1657544220373,MATH 109,A02,083214,Ganzberger; Geoffrey Michael,4,0,34,30
1657544220373,MATH 109,A03,093478,Ganzberger; Geoffrey Michael,2,0,34,32
1657544220373,MATH 109,B01,083215,Ganzberger; Geoffrey Michael,1,0,32,31
1657544220373,MATH 109,B02,083216,Ganzberger; Geoffrey Michael,2,0,32,30
1657544220373,MATH 109,B03,093479,Ganzberger; Geoffrey Michael,8,0,32,24
1657544226406,MATH 142A,A01,083219,Chow; Bennett,7,0,32,25
1657544226406,MATH 142A,A02,083220,Chow; Bennett,10,0,32,22
1657544226406,MATH 142A,A03,093480,Chow; Bennett,8,0,32,24
1657544226406,MATH 142A,B03,093481,Chow; Bennett,8,0,32,24
1657544226406,MATH 142A,B04,093558,Chow; Bennett,13,0,32,19
1657544226406,MATH 142A,B05,093559,Chow; Bennett,6,0,32,26
1657544232441,MATH 193A,A01,083224,Rotar; Vladimir,8,0,34,26
1657544232441,MATH 193A,A02,083225,Rotar; Vladimir,9,0,34,25
1657544232441,MATH 193A,A03,083781,Rotar; Vladimir,5,0,34,29
1657544232441,MATH 193A,A04,083782,Rotar; Vladimir,10,0,34,24
1657544232441,MATH 193A,A05,093482,Rotar; Vladimir,10,0,34,24
1657544238470,MATH 197,001,091859,McAuley; Julian John,9999,0,9999,0
1657544238470,MATH 197,002,095566,Kedlaya; Kiran S.,9997,0,9999,2
1657544238470,MATH 197,003,095567,Xiao; Ming,9999,0,9999,0
1657544238470,MATH 197,004,095571,Perols; Johan Lars,9998,0,9999,1
1657544245546,COGS 9,A01,083615,Shannon; Kyle Michael,9,0,75,66
1657544251570,COGS 11,A01,083617,Boyle; Mary E. T.,22,0,48,26
1657544257599,COGS 13,A01,083071,Bastos; Amalia Pinkusfeld,11,0,71,60
1657544263628,COGS 14A,A01,092681,Semenuks; Arturs,5,1,100,95
1657544269654,COGS 14B,A01,083073,Cheng; Tzu-Han,6,0,63,57
1657544275774,COGS 17,A01,092677,Semenuks; Arturs,6,0,81,75
1657544281798,COGS 100,A01,083619,Allen; Michael Gordon,17,0,70,53
1657544287825,COGS 101A,A01,083621,Davis; Joshua Daniel,9,0,68,59
1657544293851,COGS 101B,A01,091572,Allen; Michael Gordon,12,0,65,53
1657544299874,COGS 101C,A01,083625,Delgado; Tania,17,0,35,18
1657544305898,COGS 107A,A01,083627,Boyle; Mary E. T.,13,0,60,47
1657544311961,COGS 118A,A01,083075,Gupta; Anjum,21,0,76,55
1657544318005,CSE 3,A50,083646,Miranda; Gregory Joseph,24,0,50,26
1657544324033,CSE 8A,A50,083650,Miranda; Gregory Joseph,17,1,56,39
1657544330062,CSE 11,A01,083080,Cao; Yingjun,6,15,40,34
1657544336092,CSE 12,A01,083652,Krause-Levy; Sophia Louisa,28,1,120,92
1657544342119,CSE 15L,A01,083654,Morris; Justin Loren,9,0,50,41
1657544342119,CSE 15L,A02,083655,Morris; Justin Loren,9,0,50,41
1657544348145,CSE 20,A01,083657,Tran; Khoa Dang,39,0,80,41
1657544354174,CSE 21,A01,095574,Bach; Quang Tran,22,0,48,26
1657544360199,CSE 30,A01,083084,Eldon; John,5,0,80,75
1657544360199,CSE 30,B01,095061,Bhaskar; Nishant,9,0,50,41
1657544366228,CSE 100,A01,083659,Cao; Yingjun,5,4,70,65
1657544372258,CSE 134B,A01,083661,Powell; Thomas Allan,22,0,100,78
1657544378285,CSE 140,A01,083663,Gungor; Onat,15,0,85,70
1657544384313,CSE 140L,A01,083088,Eldon; John,21,0,100,79
1657544390342,CSE 175,A01,083665,Kumar; Rakesh,3,0,25,22
1657544396365,CSE 190,A00,092507,Dubnov; Shlomo,8,0,20,12
1657544402397,ECE 45,A01,083139,Congero; Spencer William,6,0,75,69
1657544408426,ECE 65,A50,083695,Saad; Andrew S,12,0,30,18
1657544408426,ECE 65,A51,095125,Saad; Andrew S,24,0,26,2
1657544414455,ECE 109,A01,091882,Touri; Behrouz,19,0,70,51
1657544420488,ECE 180,A00,083140,Abi Samra; Nicholas Camill,1,0,30,29
1657544420488,ECE 180,B00,083141,Abi Samra; Nicholas Camill,0,0,30,30
1657544426519,MATH 10A,A01,083735,Patchell; Gregory David,2,0,30,28
1657544426519,MATH 10A,A02,083736,Patchell; Gregory David,20,0,30,10
1657544426519,MATH 10A,A03,083737,Patchell; Gregory David,16,0,30,14
1657544432557,MATH 10B,A01,083207,Lim; Seonhee,8,0,34,26
1657544432557,MATH 10B,A02,083208,Lim; Seonhee,9,0,35,26
1657544432557,MATH 10B,A03,093472,Lim; Seonhee,7,0,34,27
1657544432557,MATH 10B,B01,083739,Sinha; Shubham,12,0,30,18
1657544438583,MATH 18,A01,083743,Cinel; Cameron Alexander,7,0,30,23
1657544438583,MATH 18,A02,083744,Cinel; Cameron Alexander,17,0,30,13
1657544438583,MATH 18,A03,083745,Cinel; Cameron Alexander,9,0,30,21
1657544438583,MATH 18,B01,083748,Rideout; David Porter,5,0,37,32
1657544438583,MATH 18,B02,083749,Rideout; David Porter,5,0,36,31
1657544438583,MATH 18,B03,083750,Rideout; David Porter,3,0,37,34
1657544438583,MATH 18,B04,083751,Rideout; David Porter,6,0,36,30
1657544438583,MATH 18,B05,093473,Rideout; David Porter,6,0,36,30
1657544438583,MATH 18,B06,093474,Rideout; David Porter,6,0,36,30
1657544444612,MATH 20A,A01,083754,Zheng; Zequn,14,0,40,26
1657544450639,MATH 20B,A01,083756,Briones; Jor-el Thomas Caparas,4,0,36,32
1657544450639,MATH 20B,A02,083757,Briones; Jor-el Thomas Caparas,1,0,36,35
1657544450639,MATH 20B,A03,093475,Briones; Jor-el Thomas Caparas,2,0,36,34
1657544456665,MATH 20C,A01,083760,Briones; Jor-el Thomas Caparas,1,0,35,34
1657544456665,MATH 20C,A02,083761,Briones; Jor-el Thomas Caparas,8,0,35,27
1657544456665,MATH 20C,A03,093476,Briones; Jor-el Thomas Caparas,0,1,36,36
1657544456665,MATH 20C,B01,083762,Bach; Quang Tran,1,0,30,29
1657544462694,MATH 20D,A01,083765,Tran; Brian Kha,5,0,30,25
1657544462694,MATH 20D,A02,083766,Tran; Brian Kha,5,0,30,25
1657544462694,MATH 20D,A03,083767,Tran; Brian Kha,5,0,30,25
1657544468720,MATH 20E,A01,083771,Ganguly; Soumya,9,0,32,23
1657544468720,MATH 20E,A02,083772,Ganguly; Soumya,6,0,32,26
1657544468720,MATH 20E,B01,083773,Ciotti; Benjamin,20,0,35,15
1657544468720,MATH 20E,B02,083774,Ciotti; Benjamin,17,0,35,18
1657544474754,MATH 103A,A01,083777,Greenfeld; Be'Eri,3,0,36,33
1657544474754,MATH 103A,A02,083778,Greenfeld; Be'Eri,5,0,36,31
1657544474754,MATH 103A,A03,093561,Greenfeld; Be'Eri,5,0,36,31
1657544474754,MATH 103A,B01,083779,Greenfeld; Be'Eri,7,0,36,29
1657544474754,MATH 103A,B02,083780,Greenfeld; Be'Eri,4,0,36,32
1657544474754,MATH 103A,B03,093562,Greenfeld; Be'Eri,3,0,36,33
1657544480780,MATH 105,A01,085443,Carter; Anne Toulson,15,0,35,20
1657544480780,MATH 105,A02,093477,Carter; Anne Toulson,20,0,35,15
1657544486808,MATH 109,A01,083213,Ganzberger; Geoffrey Michael,2,0,34,32
1657544486808,MATH 109,A02,083214,Ganzberger; Geoffrey Michael,4,0,34,30
1657544486808,MATH 109,A03,093478,Ganzberger; Geoffrey Michael,2,0,34,32
1657544486808,MATH 109,B01,083215,Ganzberger; Geoffrey Michael,1,0,32,31
1657544486808,MATH 109,B02,083216,Ganzberger; Geoffrey Michael,2,0,32,30
1657544486808,MATH 109,B03,093479,Ganzberger; Geoffrey Michael,8,0,32,24
1657544492837,MATH 142A,A01,083219,Chow; Bennett,7,0,32,25
1657544492837,MATH 142A,A02,083220,Chow; Bennett,10,0,32,22
1657544492837,MATH 142A,A03,093480,Chow; Bennett,8,0,32,24
1657544492837,MATH 142A,B03,093481,Chow; Bennett,8,0,32,24
1657544492837,MATH 142A,B04,093558,Chow; Bennett,13,0,32,19
1657544492837,MATH 142A,B05,093559,Chow; Bennett,6,0,32,26
1657544498862,MATH 193A,A01,083224,Rotar; Vladimir,8,0,34,26
1657544498862,MATH 193A,A02,083225,Rotar; Vladimir,9,0,34,25
1657544498862,MATH 193A,A03,083781,Rotar; Vladimir,5,0,34,29
1657544498862,MATH 193A,A04,083782,Rotar; Vladimir,10,0,34,24
1657544498862,MATH 193A,A05,093482,Rotar; Vladimir,10,0,34,24
1657544504885,MATH 197,001,091859,McAuley; Julian John,9999,0,9999,0
1657544504885,MATH 197,002,095566,Kedlaya; Kiran S.,9997,0,9999,2
1657544504885,MATH 197,003,095567,Xiao; Ming,9999,0,9999,0
1657544504885,MATH 197,004,095571,Perols; Johan Lars,9998,0,9999,1
1657544511965,COGS 9,A01,083615,Shannon; Kyle Michael,9,0,75,66
1657544517991,COGS 11,A01,083617,Boyle; Mary E. T.,22,0,48,26
1657544524021,COGS 13,A01,083071,Bastos; Amalia Pinkusfeld,11,0,71,60
1657544530051,COGS 14A,A01,092681,Semenuks; Arturs,5,1,100,95
1657544536075,COGS 14B,A01,083073,Cheng; Tzu-Han,6,0,63,57
1657544542104,COGS 17,A01,092677,Semenuks; Arturs,6,0,81,75
1657544548132,COGS 100,A01,083619,Allen; Michael Gordon,17,0,70,53
1657544554159,COGS 101A,A01,083621,Davis; Joshua Daniel,9,0,68,59
1657544560183,COGS 101B,A01,091572,Allen; Michael Gordon,12,0,65,53
1657544566216,COGS 101C,A01,083625,Delgado; Tania,17,0,35,18
1657544572239,COGS 107A,A01,083627,Boyle; Mary E. T.,13,0,60,47
1657544578265,COGS 118A,A01,083075,Gupta; Anjum,21,0,76,55
1657544584294,CSE 3,A50,083646,Miranda; Gregory Joseph,24,0,50,26
1657544590361,CSE 8A,A50,083650,Miranda; Gregory Joseph,17,1,56,39
1657544596391,CSE 11,A01,083080,Cao; Yingjun,6,15,40,34
1657544602421,CSE 12,A01,083652,Krause-Levy; Sophia Louisa,28,1,120,92
1657544608456,CSE 15L,A01,083654,Morris; Justin Loren,9,0,50,41
1657544608456,CSE 15L,A02,083655,Morris; Justin Loren,9,0,50,41
1657544614493,CSE 20,A01,083657,Tran; Khoa Dang,39,0,80,41
1657544620523,CSE 21,A01,095574,Bach; Quang Tran,22,0,48,26
1657544626549,CSE 30,A01,083084,Eldon; John,5,0,80,75
1657544626549,CSE 30,B01,095061,Bhaskar; Nishant,9,0,50,41
1657544632573,CSE 100,A01,083659,Cao; Yingjun,5,4,70,65
1657544638597,CSE 134B,A01,083661,Powell; Thomas Allan,22,0,100,78
1657544644635,CSE 140,A01,083663,Gungor; Onat,15,0,85,70
1657544650659,CSE 140L,A01,083088,Eldon; John,21,0,100,79
1657544656685,CSE 175,A01,083665,Kumar; Rakesh,3,0,25,22
1657544662711,CSE 190,A00,092507,Dubnov; Shlomo,8,0,20,12
1657544668737,ECE 45,A01,083139,Congero; Spencer William,6,0,75,69
1657544674776,ECE 65,A50,083695,Saad; Andrew S,12,0,30,18
1657544674776,ECE 65,A51,095125,Saad; Andrew S,24,0,26,2
1657544680802,ECE 109,A01,091882,Touri; Behrouz,19,0,70,51
1657544686837,ECE 180,A00,083140,Abi Samra; Nicholas Camill,1,0,30,29
1657544686837,ECE 180,B00,083141,Abi Samra; Nicholas Camill,0,0,30,30
1657544692867,MATH 10A,A01,083735,Patchell; Gregory David,2,0,30,28
1657544692867,MATH 10A,A02,083736,Patchell; Gregory David,20,0,30,10
1657544692867,MATH 10A,A03,083737,Patchell; Gregory David,16,0,30,14
1657544698893,MATH 10B,A01,083207,Lim; Seonhee,8,0,34,26
1657544698893,MATH 10B,A02,083208,Lim; Seonhee,9,0,35,26
1657544698893,MATH 10B,A03,093472,Lim; Seonhee,7,0,34,27
1657544698893,MATH 10B,B01,083739,Sinha; Shubham,12,0,30,18
1657544704920,MATH 18,A01,083743,Cinel; Cameron Alexander,7,0,30,23
1657544704920,MATH 18,A02,083744,Cinel; Cameron Alexander,17,0,30,13
1657544704920,MATH 18,A03,083745,Cinel; Cameron Alexander,9,0,30,21
1657544704920,MATH 18,B01,083748,Rideout; David Porter,5,0,37,32
1657544704920,MATH 18,B02,083749,Rideout; David Porter,5,0,36,31
1657544704920,MATH 18,B03,083750,Rideout; David Porter,3,0,37,34
1657544704920,MATH 18,B04,083751,Rideout; David Porter,6,0,36,30
1657544704920,MATH 18,B05,093473,Rideout; David Porter,6,0,36,30
1657544704920,MATH 18,B06,093474,Rideout; David Porter,6,0,36,30
1657544710950,MATH 20A,A01,083754,Zheng; Zequn,14,0,40,26
1657544716981,MATH 20B,A01,083756,Briones; Jor-el Thomas Caparas,4,0,36,32
1657544716981,MATH 20B,A02,083757,Briones; Jor-el Thomas Caparas,1,0,36,35
1657544716981,MATH 20B,A03,093475,Briones; Jor-el Thomas Caparas,2,0,36,34
1657544723006,MATH 20C,A01,083760,Briones; Jor-el Thomas Caparas,1,0,35,34
1657544723006,MATH 20C,A02,083761,Briones; Jor-el Thomas Caparas,8,0,35,27
1657544723006,MATH 20C,A03,093476,Briones; Jor-el Thomas Caparas,0,1,36,36
1657544723006,MATH 20C,B01,083762,Bach; Quang Tran,1,0,30,29
1657544729039,MATH 20D,A01,083765,Tran; Brian Kha,5,0,30,25
1657544729039,MATH 20D,A02,083766,Tran; Brian Kha,5,0,30,25
1657544729039,MATH 20D,A03,083767,Tran; Brian Kha,5,0,30,25
1657544735070,MATH 20E,A01,083771,Ganguly; Soumya,9,0,32,23
1657544735070,MATH 20E,A02,083772,Ganguly; Soumya,6,0,32,26
1657544735070,MATH 20E,B01,083773,Ciotti; Benjamin,20,0,35,15
1657544735070,MATH 20E,B02,083774,Ciotti; Benjamin,17,0,35,18
1657544741101,MATH 103A,A01,083777,Greenfeld; Be'Eri,3,0,36,33
1657544741101,MATH 103A,A02,083778,Greenfeld; Be'Eri,5,0,36,31
1657544741101,MATH 103A,A03,093561,Greenfeld; Be'Eri,5,0,36,31
1657544741101,MATH 103A,B01,083779,Greenfeld; Be'Eri,7,0,36,29
1657544741101,MATH 103A,B02,083780,Greenfeld; Be'Eri,4,0,36,32
1657544741101,MATH 103A,B03,093562,Greenfeld; Be'Eri,3,0,36,33
1657544747124,MATH 105,A01,085443,Carter; Anne Toulson,15,0,35,20
1657544747124,MATH 105,A02,093477,Carter; Anne Toulson,20,0,35,15
1657544753160,MATH 109,A01,083213,Ganzberger; Geoffrey Michael,2,0,34,32
1657544753160,MATH 109,A02,083214,Ganzberger; Geoffrey Michael,4,0,34,30
1657544753160,MATH 109,A03,093478,Ganzberger; Geoffrey Michael,2,0,34,32
1657544753160,MATH 109,B01,083215,Ganzberger; Geoffrey Michael,1,0,32,31
1657544753160,MATH 109,B02,083216,Ganzberger; Geoffrey Michael,2,0,32,30
1657544753160,MATH 109,B03,093479,Ganzberger; Geoffrey Michael,8,0,32,24
1657544759187,MATH 142A,A01,083219,Chow; Bennett,7,0,32,25
1657544759187,MATH 142A,A02,083220,Chow; Bennett,10,0,32,22
1657544759187,MATH 142A,A03,093480,Chow; Bennett,8,0,32,24
1657544759187,MATH 142A,B03,093481,Chow; Bennett,8,0,32,24
1657544759187,MATH 142A,B04,093558,Chow; Bennett,13,0,32,19
1657544759187,MATH 142A,B05,093559,Chow; Bennett,6,0,32,26
1657544765212,MATH 193A,A01,083224,Rotar; Vladimir,8,0,34,26
1657544765212,MATH 193A,A02,083225,Rotar; Vladimir,9,0,34,25
1657544765212,MATH 193A,A03,083781,Rotar; Vladimir,5,0,34,29
1657544765212,MATH 193A,A04,083782,Rotar; Vladimir,10,0,34,24
1657544765212,MATH 193A,A05,093482,Rotar; Vladimir,10,0,34,24
1657544771237,MATH 197,001,091859,McAuley; Julian John,9999,0,9999,0
1657544771237,MATH 197,002,095566,Kedlaya; Kiran S.,9997,0,9999,2
1657544771237,MATH 197,003,095567,Xiao; Ming,9999,0,9999,0
1657544771237,MATH 197,004,095571,Perols; Johan Lars,9998,0,9999,1
1657544778306,COGS 9,A01,083615,Shannon; Kyle Michael,9,0,75,66
1657544784337,COGS 11,A01,083617,Boyle; Mary E. T.,22,0,48,26
1657544790366,COGS 13,A01,083071,Bastos; Amalia Pinkusfeld,11,0,71,60
1657544796390,COGS 14A,A01,092681,Semenuks; Arturs,5,1,100,95
1657544802414,COGS 14B,A01,083073,Cheng; Tzu-Han,6,0,63,57
1657544808441,COGS 17,A01,092677,Semenuks; Arturs,6,0,81,75
1657544814469,COGS 100,A01,083619,Allen; Michael Gordon,17,0,70,53
1657544820494,COGS 101A,A01,083621,Davis; Joshua Daniel,9,0,68,59
1657544826522,COGS 101B,A01,091572,Allen; Michael Gordon,12,0,65,53
1657544832545,COGS 101C,A01,083625,Delgado; Tania,17,0,35,18
1657544838571,COGS 107A,A01,083627,Boyle; Mary E. T.,13,0,60,47
1657544844596,COGS 118A,A01,083075,Gupta; Anjum,21,0,76,55
1657544850636,CSE 3,A50,083646,Miranda; Gregory Joseph,24,0,50,26
1657544856661,CSE 8A,A50,083650,Miranda; Gregory Joseph,17,1,56,39
1657544862689,CSE 11,A01,083080,Cao; Yingjun,6,15,40,34
1657544868719,CSE 12,A01,083652,Krause-Levy; Sophia Louisa,28,1,120,92
1657544874820,CSE 15L,A01,083654,Morris; Justin Loren,9,0,50,41
1657544874820,CSE 15L,A02,083655,Morris; Justin Loren,9,0,50,41
1657544880847,CSE 20,A01,083657,Tran; Khoa Dang,39,0,80,41
1657544886871,CSE 21,A01,095574,Bach; Quang Tran,22,0,48,26
1657544892901,CSE 30,A01,083084,Eldon; John,5,0,80,75
1657544892901,CSE 30,B01,095061,Bhaskar; Nishant,9,0,50,41
1657544898926,CSE 100,A01,083659,Cao; Yingjun,5,4,70,65
1657544904952,CSE 134B,A01,083661,Powell; Thomas Allan,22,0,100,78
1657544910982,CSE 140,A01,083663,Gungor; Onat,15,0,85,70
1657544917004,CSE 140L,A01,083088,Eldon; John,21,0,100,79
1657544923030,CSE 175,A01,083665,Kumar; Rakesh,3,0,25,22
1657544929055,CSE 190,A00,092507,Dubnov; Shlomo,8,0,20,12
1657544935086,ECE 45,A01,083139,Congero; Spencer William,6,0,75,69
1657544941116,ECE 65,A50,083695,Saad; Andrew S,12,0,30,18
1657544941116,ECE 65,A51,095125,Saad; Andrew S,24,0,26,2
1657544947141,ECE 109,A01,091882,Touri; Behrouz,19,0,70,51
1657544953167,ECE 180,A00,083140,Abi Samra; Nicholas Camill,1,0,30,29
1657544953167,ECE 180,B00,083141,Abi Samra; Nicholas Camill,0,0,30,30
1657544959192,MATH 10A,A01,083735,Patchell; Gregory David,2,0,30,28
1657544959192,MATH 10A,A02,083736,Patchell; Gregory David,20,0,30,10
1657544959192,MATH 10A,A03,083737,Patchell; Gregory David,16,0,30,14
1657544965226,MATH 10B,A01,083207,Lim; Seonhee,8,0,34,26
1657544965226,MATH 10B,A02,083208,Lim; Seonhee,9,0,35,26
1657544965226,MATH 10B,A03,093472,Lim; Seonhee,7,0,34,27
1657544965226,MATH 10B,B01,083739,Sinha; Shubham,12,0,30,18
1657544971253,MATH 18,A01,083743,Cinel; Cameron Alexander,7,0,30,23
1657544971253,MATH 18,A02,083744,Cinel; Cameron Alexander,17,0,30,13
1657544971253,MATH 18,A03,083745,Cinel; Cameron Alexander,9,0,30,21
1657544971253,MATH 18,B01,083748,Rideout; David Porter,5,0,37,32
1657544971253,MATH 18,B02,083749,Rideout; David Porter,5,0,36,31
1657544971253,MATH 18,B03,083750,Rideout; David Porter,3,0,37,34
1657544971253,MATH 18,B04,083751,Rideout; David Porter,6,0,36,30
1657544971253,MATH 18,B05,093473,Rideout; David Porter,6,0,36,30
1657544971253,MATH 18,B06,093474,Rideout; David Porter,6,0,36,30
1657544977277,MATH 20A,A01,083754,Zheng; Zequn,14,0,40,26
1657544983307,MATH 20B,A01,083756,Briones; Jor-el Thomas Caparas,4,0,36,32
1657544983307,MATH 20B,A02,083757,Briones; Jor-el Thomas Caparas,1,0,36,35
1657544983307,MATH 20B,A03,093475,Briones; Jor-el Thomas Caparas,2,0,36,34
1657544989333,MATH 20C,A01,083760,Briones; Jor-el Thomas Caparas,1,0,35,34
1657544989333,MATH 20C,A02,083761,Briones; Jor-el Thomas Caparas,8,0,35,27
1657544989333,MATH 20C,A03,093476,Briones; Jor-el Thomas Caparas,0,1,36,36
1657544989333,MATH 20C,B01,083762,Bach; Quang Tran,1,0,30,29
1657544995359,MATH 20D,A01,083765,Tran; Brian Kha,5,0,30,25
1657544995359,MATH 20D,A02,083766,Tran; Brian Kha,5,0,30,25
1657544995359,MATH 20D,A03,083767,Tran; Brian Kha,5,0,30,25
1657545001386,MATH 20E,A01,083771,Ganguly; Soumya,9,0,32,23
1657545001386,MATH 20E,A02,083772,Ganguly; Soumya,6,0,32,26
1657545001386,MATH 20E,B01,083773,Ciotti; Benjamin,20,0,35,15
1657545001386,MATH 20E,B02,083774,Ciotti; Benjamin,17,0,35,18
1657545007418,MATH 103A,A01,083777,Greenfeld; Be'Eri,3,0,36,33
1657545007418,MATH 103A,A02,083778,Greenfeld; Be'Eri,5,0,36,31
1657545007418,MATH 103A,A03,093561,Greenfeld; Be'Eri,5,0,36,31
1657545007418,MATH 103A,B01,083779,Greenfeld; Be'Eri,7,0,36,29
1657545007418,MATH 103A,B02,083780,Greenfeld; Be'Eri,4,0,36,32
1657545007418,MATH 103A,B03,093562,Greenfeld; Be'Eri,3,0,36,33
1657545013443,MATH 105,A01,085443,Carter; Anne Toulson,15,0,35,20
1657545013443,MATH 105,A02,093477,Carter; Anne Toulson,20,0,35,15
1657545019472,MATH 109,A01,083213,Ganzberger; Geoffrey Michael,2,0,34,32
1657545019472,MATH 109,A02,083214,Ganzberger; Geoffrey Michael,4,0,34,30
1657545019472,MATH 109,A03,093478,Ganzberger; Geoffrey Michael,2,0,34,32
1657545019472,MATH 109,B01,083215,Ganzberger; Geoffrey Michael,1,0,32,31
1657545019472,MATH 109,B02,083216,Ganzberger; Geoffrey Michael,2,0,32,30
1657545019472,MATH 109,B03,093479,Ganzberger; Geoffrey Michael,8,0,32,24
1657545025498,MATH 142A,A01,083219,Chow; Bennett,7,0,32,25
1657545025498,MATH 142A,A02,083220,Chow; Bennett,10,0,32,22
1657545025498,MATH 142A,A03,093480,Chow; Bennett,8,0,32,24
1657545025498,MATH 142A,B03,093481,Chow; Bennett,8,0,32,24
1657545025498,MATH 142A,B04,093558,Chow; Bennett,13,0,32,19
1657545025498,MATH 142A,B05,093559,Chow; Bennett,6,0,32,26
1657545031528,MATH 193A,A01,083224,Rotar; Vladimir,8,0,34,26
1657545031528,MATH 193A,A02,083225,Rotar; Vladimir,9,0,34,25
1657545031528,MATH 193A,A03,083781,Rotar; Vladimir,5,0,34,29
1657545031528,MATH 193A,A04,083782,Rotar; Vladimir,10,0,34,24
1657545031528,MATH 193A,A05,093482,Rotar; Vladimir,10,0,34,24
1657545037558,MATH 197,001,091859,McAuley; Julian John,9999,0,9999,0
1657545037558,MATH 197,002,095566,Kedlaya; Kiran S.,9997,0,9999,2
1657545037558,MATH 197,003,095567,Xiao; Ming,9999,0,9999,0
1657545037558,MATH 197,004,095571,Perols; Johan Lars,9998,0,9999,1
1657545044627,COGS 9,A01,083615,Shannon; Kyle Michael,9,0,75,66
1657545050654,COGS 11,A01,083617,Boyle; Mary E. T.,22,0,48,26
1657545056678,COGS 13,A01,083071,Bastos; Amalia Pinkusfeld,11,0,71,60
1657545062707,COGS 14A,A01,092681,Semenuks; Arturs,5,1,100,95
1657545068735,COGS 14B,A01,083073,Cheng; Tzu-Han,6,0,63,57
1657545074764,COGS 17,A01,092677,Semenuks; Arturs,6,0,81,75
1657545080795,COGS 100,A01,083619,Allen; Michael Gordon,17,0,70,53
1657545086818,COGS 101A,A01,083621,Davis; Joshua Daniel,9,0,68,59
1657545092843,COGS 101B,A01,091572,Allen; Michael Gordon,12,0,65,53
1657545098873,COGS 101C,A01,083625,Delgado; Tania,17,0,35,18
1657545104906,COGS 107A,A01,083627,Boyle; Mary E. T.,13,0,60,47
1657545110931,COGS 118A,A01,083075,Gupta; Anjum,21,0,76,55
1657545116956,CSE 3,A50,083646,Miranda; Gregory Joseph,24,0,50,26
1657545122982,CSE 8A,A50,083650,Miranda; Gregory Joseph,17,1,56,39
1657545129007,CSE 11,A01,083080,Cao; Yingjun,6,15,40,34
1657545135033,CSE 12,A01,083652,Krause-Levy; Sophia Louisa,28,1,120,92
1657545141058,CSE 15L,A01,083654,Morris; Justin Loren,9,0,50,41
1657545141058,CSE 15L,A02,083655,Morris; Justin Loren,9,0,50,41
1657545147084,CSE 20,A01,083657,Tran; Khoa Dang,39,0,80,41
1657545153110,CSE 21,A01,095574,Bach; Quang Tran,22,0,48,26
1657545159138,CSE 30,A01,083084,Eldon; John,5,0,80,75
1657545159138,CSE 30,B01,095061,Bhaskar; Nishant,9,0,50,41
1657545165166,CSE 100,A01,083659,Cao; Yingjun,5,4,70,65
1657545171198,CSE 134B,A01,083661,Powell; Thomas Allan,22,0,100,78
1657545177228,CSE 140,A01,083663,Gungor; Onat,15,0,85,70
1657545183255,CSE 140L,A01,083088,Eldon; John,21,0,100,79
1657545189290,CSE 175,A01,083665,Kumar; Rakesh,3,0,25,22
1657545195318,CSE 190,A00,092507,Dubnov; Shlomo,8,0,20,12
1657545201344,ECE 45,A01,083139,Congero; Spencer William,6,0,75,69
1657545207370,ECE 65,A50,083695,Saad; Andrew S,12,0,30,18
1657545207370,ECE 65,A51,095125,Saad; Andrew S,24,0,26,2
1657545213399,ECE 109,A01,091882,Touri; Behrouz,19,0,70,51
1657545219423,ECE 180,A00,083140,Abi Samra; Nicholas Camill,1,0,30,29
1657545219423,ECE 180,B00,083141,Abi Samra; Nicholas Camill,0,0,30,30
1657545225448,MATH 10A,A01,083735,Patchell; Gregory David,2,0,30,28
1657545225448,MATH 10A,A02,083736,Patchell; Gregory David,20,0,30,10
1657545225448,MATH 10A,A03,083737,Patchell; Gregory David,16,0,30,14
1657545231474,MATH 10B,A01,083207,Lim; Seonhee,8,0,34,26
1657545231474,MATH 10B,A02,083208,Lim; Seonhee,9,0,35,26
1657545231474,MATH 10B,A03,093472,Lim; Seonhee,7,0,34,27
1657545231474,MATH 10B,B01,083739,Sinha; Shubham,12,0,30,18
1657545237500,MATH 18,A01,083743,Cinel; Cameron Alexander,7,0,30,23
1657545237500,MATH 18,A02,083744,Cinel; Cameron Alexander,17,0,30,13
1657545237500,MATH 18,A03,083745,Cinel; Cameron Alexander,9,0,30,21
1657545237500,MATH 18,B01,083748,Rideout; David Porter,5,0,37,32
1657545237500,MATH 18,B02,083749,Rideout; David Porter,5,0,36,31
1657545237500,MATH 18,B03,083750,Rideout; David Porter,3,0,37,34
1657545237500,MATH 18,B04,083751,Rideout; David Porter,6,0,36,30
1657545237500,MATH 18,B05,093473,Rideout; David Porter,6,0,36,30
1657545237500,MATH 18,B06,093474,Rideout; David Porter,6,0,36,30
1657545243525,MATH 20A,A01,083754,Zheng; Zequn,14,0,40,26
1657545249549,MATH 20B,A01,083756,Briones; Jor-el Thomas Caparas,4,0,36,32
1657545249549,MATH 20B,A02,083757,Briones; Jor-el Thomas Caparas,1,0,36,35
1657545249549,MATH 20B,A03,093475,Briones; Jor-el Thomas Caparas,2,0,36,34
1657545255576,MATH 20C,A01,083760,Briones; Jor-el Thomas Caparas,1,0,35,34
1657545255576,MATH 20C,A02,083761,Briones; Jor-el Thomas Caparas,8,0,35,27
1657545255576,MATH 20C,A03,093476,Briones; Jor-el Thomas Caparas,0,1,36,36
1657545255576,MATH 20C,B01,083762,Bach; Quang Tran,1,0,30,29
1657545261602,MATH 20D,A01,083765,Tran; Brian Kha,5,0,30,25
1657545261602,MATH 20D,A02,083766,Tran; Brian Kha,5,0,30,25
1657545261602,MATH 20D,A03,083767,Tran; Brian Kha,5,0,30,25
1657545267627,MATH 20E,A01,083771,Ganguly; Soumya,9,0,32,23
1657545267627,MATH 20E,A02,083772,Ganguly; Soumya,6,0,32,26
1657545267627,MATH 20E,B01,083773,Ciotti; Benjamin,20,0,35,15
1657545267627,MATH 20E,B02,083774,Ciotti; Benjamin,17,0,35,18
1657545273652,MATH 103A,A01,083777,Greenfeld; Be'Eri,3,0,36,33
1657545273652,MATH 103A,A02,083778,Greenfeld; Be'Eri,5,0,36,31
1657545273652,MATH 103A,A03,093561,Greenfeld; Be'Eri,5,0,36,31
1657545273652,MATH 103A,B01,083779,Greenfeld; Be'Eri,7,0,36,29
1657545273652,MATH 103A,B02,083780,Greenfeld; Be'Eri,4,0,36,32
1657545273652,MATH 103A,B03,093562,Greenfeld; Be'Eri,3,0,36,33
1657545279677,MATH 105,A01,085443,Carter; Anne Toulson,15,0,35,20
1657545279677,MATH 105,A02,093477,Carter; Anne Toulson,20,0,35,15
1657545285701,MATH 109,A01,083213,Ganzberger; Geoffrey Michael,2,0,34,32
1657545285701,MATH 109,A02,083214,Ganzberger; Geoffrey Michael,4,0,34,30
1657545285701,MATH 109,A03,093478,Ganzberger; Geoffrey Michael,2,0,34,32
1657545285701,MATH 109,B01,083215,Ganzberger; Geoffrey Michael,1,0,32,31
1657545285701,MATH 109,B02,083216,Ganzberger; Geoffrey Michael,2,0,32,30
1657545285701,MATH 109,B03,093479,Ganzberger; Geoffrey Michael,8,0,32,24
1657545291726,MATH 142A,A01,083219,Chow; Bennett,7,0,32,25
1657545291726,MATH 142A,A02,083220,Chow; Bennett,10,0,32,22
1657545291726,MATH 142A,A03,093480,Chow; Bennett,8,0,32,24
1657545291726,MATH 142A,B03,093481,Chow; Bennett,8,0,32,24
1657545291726,MATH 142A,B04,093558,Chow; Bennett,13,0,32,19
1657545291726,MATH 142A,B05,093559,Chow; Bennett,6,0,32,26
1657545297749,MATH 193A,A01,083224,Rotar; Vladimir,8,0,34,26
1657545297749,MATH 193A,A02,083225,Rotar; Vladimir,9,0,34,25
1657545297749,MATH 193A,A03,083781,Rotar; Vladimir,5,0,34,29
1657545297749,MATH 193A,A04,083782,Rotar; Vladimir,10,0,34,24
1657545297749,MATH 193A,A05,093482,Rotar; Vladimir,10,0,34,24
1657545303774,MATH 197,001,091859,McAuley; Julian John,9999,0,9999,0
1657545303774,MATH 197,002,095566,Kedlaya; Kiran S.,9997,0,9999,2
1657545303774,MATH 197,003,095567,Xiao; Ming,9999,0,9999,0
1657545303774,MATH 197,004,095571,Perols; Johan Lars,9998,0,9999,1
1657545310843,COGS 9,A01,083615,Shannon; Kyle Michael,9,0,75,66
1657545316867,COGS 11,A01,083617,Boyle; Mary E. T.,22,0,48,26
1657545322892,COGS 13,A01,083071,Bastos; Amalia Pinkusfeld,11,0,71,60
1657545328921,COGS 14A,A01,092681,Semenuks; Arturs,5,1,100,95
1657545334949,COGS 14B,A01,083073,Cheng; Tzu-Han,6,0,63,57
1657545340977,COGS 17,A01,092677,Semenuks; Arturs,6,0,81,75
1657545347002,COGS 100,A01,083619,Allen; Michael Gordon,17,0,70,53
1657545353026,COGS 101A,A01,083621,Davis; Joshua Daniel,9,0,68,59
1657545359053,COGS 101B,A01,091572,Allen; Michael Gordon,12,0,65,53
1657545365081,COGS 101C,A01,083625,Delgado; Tania,17,0,35,18
1657545371111,COGS 107A,A01,083627,Boyle; Mary E. T.,13,0,60,47
1657545377140,COGS 118A,A01,083075,Gupta; Anjum,21,0,76,55
1657545383165,CSE 3,A50,083646,Miranda; Gregory Joseph,24,0,50,26
1657545389188,CSE 8A,A50,083650,Miranda; Gregory Joseph,17,1,56,39
1657545395215,CSE 11,A01,083080,Cao; Yingjun,6,15,40,34
1657545401244,CSE 12,A01,083652,Krause-Levy; Sophia Louisa,28,1,120,92
1657545407268,CSE 15L,A01,083654,Morris; Justin Loren,9,0,50,41
1657545407268,CSE 15L,A02,083655,Morris; Justin Loren,9,0,50,41
1657545413293,CSE 20,A01,083657,Tran; Khoa Dang,39,0,80,41
1657545419317,CSE 21,A01,095574,Bach; Quang Tran,22,0,48,26
1657545425341,CSE 30,A01,083084,Eldon; John,5,0,80,75
1657545425341,CSE 30,B01,095061,Bhaskar; Nishant,9,0,50,41
1657545431366,CSE 100,A01,083659,Cao; Yingjun,5,4,70,65
1657545437392,CSE 134B,A01,083661,Powell; Thomas Allan,22,0,100,78
1657545443415,CSE 140,A01,083663,Gungor; Onat,15,0,85,70
1657545449439,CSE 140L,A01,083088,Eldon; John,21,0,100,79
1657545455465,CSE 175,A01,083665,Kumar; Rakesh,3,0,25,22
1657545461490,CSE 190,A00,092507,Dubnov; Shlomo,8,0,20,12
1657545467517,ECE 45,A01,083139,Congero; Spencer William,6,0,75,69
1657545473620,ECE 65,A50,083695,Saad; Andrew S,12,0,30,18
1657545473620,ECE 65,A51,095125,Saad; Andrew S,24,0,26,2
1657545479648,ECE 109,A01,091882,Touri; Behrouz,19,0,70,51
1657545485676,ECE 180,A00,083140,Abi Samra; Nicholas Camill,1,0,30,29
1657545485676,ECE 180,B00,083141,Abi Samra; Nicholas Camill,0,0,30,30
1657545491702,MATH 10A,A01,083735,Patchell; Gregory David,2,0,30,28
1657545491702,MATH 10A,A02,083736,Patchell; Gregory David,20,0,30,10
1657545491702,MATH 10A,A03,083737,Patchell; Gregory David,16,0,30,14
1657545497729,MATH 10B,A01,083207,Lim; Seonhee,8,0,34,26
1657545497729,MATH 10B,A02,083208,Lim; Seonhee,9,0,35,26
1657545497729,MATH 10B,A03,093472,Lim; Seonhee,7,0,34,27
1657545497729,MATH 10B,B01,083739,Sinha; Shubham,12,0,30,18
1657545503758,MATH 18,A01,083743,Cinel; Cameron Alexander,7,0,30,23
1657545503758,MATH 18,A02,083744,Cinel; Cameron Alexander,17,0,30,13
1657545503758,MATH 18,A03,083745,Cinel; Cameron Alexander,9,0,30,21
1657545503758,MATH 18,B01,083748,Rideout; David Porter,5,0,37,32
1657545503758,MATH 18,B02,083749,Rideout; David Porter,5,0,36,31
1657545503758,MATH 18,B03,083750,Rideout; David Porter,3,0,37,34
1657545503758,MATH 18,B04,083751,Rideout; David Porter,6,0,36,30
1657545503758,MATH 18,B05,093473,Rideout; David Porter,6,0,36,30
1657545503758,MATH 18,B06,093474,Rideout; David Porter,6,0,36,30
1657545509787,MATH 20A,A01,083754,Zheng; Zequn,14,0,40,26
1657545515812,MATH 20B,A01,083756,Briones; Jor-el Thomas Caparas,4,0,36,32
1657545515812,MATH 20B,A02,083757,Briones; Jor-el Thomas Caparas,1,0,36,35
1657545515812,MATH 20B,A03,093475,Briones; Jor-el Thomas Caparas,2,0,36,34
1657545521842,MATH 20C,A01,083760,Briones; Jor-el Thomas Caparas,1,0,35,34
1657545521842,MATH 20C,A02,083761,Briones; Jor-el Thomas Caparas,8,0,35,27
1657545521842,MATH 20C,A03,093476,Briones; Jor-el Thomas Caparas,0,1,36,36
1657545521842,MATH 20C,B01,083762,Bach; Quang Tran,1,0,30,29
1657545527873,MATH 20D,A01,083765,Tran; Brian Kha,5,0,30,25
1657545527873,MATH 20D,A02,083766,Tran; Brian Kha,5,0,30,25
1657545527873,MATH 20D,A03,083767,Tran; Brian Kha,5,0,30,25
1657545533899,MATH 20E,A01,083771,Ganguly; Soumya,9,0,32,23
1657545533899,MATH 20E,A02,083772,Ganguly; Soumya,6,0,32,26
1657545533899,MATH 20E,B01,083773,Ciotti; Benjamin,20,0,35,15
1657545533899,MATH 20E,B02,083774,Ciotti; Benjamin,17,0,35,18
1657545539929,MATH 103A,A01,083777,Greenfeld; Be'Eri,3,0,36,33
1657545539929,MATH 103A,A02,083778,Greenfeld; Be'Eri,5,0,36,31
1657545539929,MATH 103A,A03,093561,Greenfeld; Be'Eri,5,0,36,31
1657545539929,MATH 103A,B01,083779,Greenfeld; Be'Eri,7,0,36,29
1657545539929,MATH 103A,B02,083780,Greenfeld; Be'Eri,4,0,36,32
1657545539929,MATH 103A,B03,093562,Greenfeld; Be'Eri,3,0,36,33
1657545545961,MATH 105,A01,085443,Carter; Anne Toulson,15,0,35,20
1657545545961,MATH 105,A02,093477,Carter; Anne Toulson,20,0,35,15
1657545551988,MATH 109,A01,083213,Ganzberger; Geoffrey Michael,2,0,34,32
1657545551988,MATH 109,A02,083214,Ganzberger; Geoffrey Michael,4,0,34,30
1657545551988,MATH 109,A03,093478,Ganzberger; Geoffrey Michael,2,0,34,32
1657545551988,MATH 109,B01,083215,Ganzberger; Geoffrey Michael,1,0,32,31
1657545551988,MATH 109,B02,083216,Ganzberger; Geoffrey Michael,2,0,32,30
1657545551988,MATH 109,B03,093479,Ganzberger; Geoffrey Michael,8,0,32,24
1657545558021,MATH 142A,A01,083219,Chow; Bennett,7,0,32,25
1657545558021,MATH 142A,A02,083220,Chow; Bennett,10,0,32,22
1657545558021,MATH 142A,A03,093480,Chow; Bennett,8,0,32,24
1657545558021,MATH 142A,B03,093481,Chow; Bennett,8,0,32,24
1657545558021,MATH 142A,B04,093558,Chow; Bennett,13,0,32,19
1657545558021,MATH 142A,B05,093559,Chow; Bennett,6,0,32,26
1657545564054,MATH 193A,A01,083224,Rotar; Vladimir,8,0,34,26
1657545564054,MATH 193A,A02,083225,Rotar; Vladimir,9,0,34,25
1657545564054,MATH 193A,A03,083781,Rotar; Vladimir,5,0,34,29
1657545564054,MATH 193A,A04,083782,Rotar; Vladimir,10,0,34,24
1657545564054,MATH 193A,A05,093482,Rotar; Vladimir,10,0,34,24
1657545570079,MATH 197,001,091859,McAuley; Julian John,9999,0,9999,0
1657545570079,MATH 197,002,095566,Kedlaya; Kiran S.,9997,0,9999,2
1657545570079,MATH 197,003,095567,Xiao; Ming,9999,0,9999,0
1657545570079,MATH 197,004,095571,Perols; Johan Lars,9998,0,9999,1
1657545577148,COGS 9,A01,083615,Shannon; Kyle Michael,9,0,75,66
1657545583173,COGS 11,A01,083617,Boyle; Mary E. T.,22,0,48,26
1657545589201,COGS 13,A01,083071,Bastos; Amalia Pinkusfeld,11,0,71,60
1657545595230,COGS 14A,A01,092681,Semenuks; Arturs,5,1,100,95
1657545601258,COGS 14B,A01,083073,Cheng; Tzu-Han,6,0,63,57
1657545607282,COGS 17,A01,092677,Semenuks; Arturs,6,0,81,75
1657545613311,COGS 100,A01,083619,Allen; Michael Gordon,17,0,70,53
1657545619340,COGS 101A,A01,083621,Davis; Joshua Daniel,9,0,68,59
1657545625369,COGS 101B,A01,091572,Allen; Michael Gordon,12,0,65,53
1657545631399,COGS 101C,A01,083625,Delgado; Tania,17,0,35,18
1657545637423,COGS 107A,A01,083627,Boyle; Mary E. T.,13,0,60,47
1657545643453,COGS 118A,A01,083075,Gupta; Anjum,21,0,76,55
1657545649479,CSE 3,A50,083646,Miranda; Gregory Joseph,24,0,50,26
1657545655507,CSE 8A,A50,083650,Miranda; Gregory Joseph,17,1,56,39
1657545661532,CSE 11,A01,083080,Cao; Yingjun,6,15,40,34
1657545667556,CSE 12,A01,083652,Krause-Levy; Sophia Louisa,28,1,120,92
1657545673582,CSE 15L,A01,083654,Morris; Justin Loren,9,0,50,41
1657545673582,CSE 15L,A02,083655,Morris; Justin Loren,9,0,50,41
1657545679612,CSE 20,A01,083657,Tran; Khoa Dang,39,0,80,41
1657545685635,CSE 21,A01,095574,Bach; Quang Tran,22,0,48,26
1657545691664,CSE 30,A01,083084,Eldon; John,5,0,80,75
1657545691664,CSE 30,B01,095061,Bhaskar; Nishant,9,0,50,41
1657545697692,CSE 100,A01,083659,Cao; Yingjun,5,4,70,65
1657545703723,CSE 134B,A01,083661,Powell; Thomas Allan,22,0,100,78
1657545709752,CSE 140,A01,083663,Gungor; Onat,15,0,85,70
1657545715779,CSE 140L,A01,083088,Eldon; John,21,0,100,79
1657545721803,CSE 175,A01,083665,Kumar; Rakesh,3,0,25,22
1657545727830,CSE 190,A00,092507,Dubnov; Shlomo,8,0,20,12
1657545733864,ECE 45,A01,083139,Congero; Spencer William,6,0,75,69
1657545739889,ECE 65,A50,083695,Saad; Andrew S,12,0,30,18
1657545739889,ECE 65,A51,095125,Saad; Andrew S,24,0,26,2
1657545745917,ECE 109,A01,091882,Touri; Behrouz,19,0,70,51
1657545751942,ECE 180,A00,083140,Abi Samra; Nicholas Camill,1,0,30,29
1657545751942,ECE 180,B00,083141,Abi Samra; Nicholas Camill,0,0,30,30
1657545757970,MATH 10A,A01,083735,Patchell; Gregory David,2,0,30,28
1657545757970,MATH 10A,A02,083736,Patchell; Gregory David,20,0,30,10
1657545757970,MATH 10A,A03,083737,Patchell; Gregory David,16,0,30,14
1657545763994,MATH 10B,A01,083207,Lim; Seonhee,8,0,34,26
1657545763994,MATH 10B,A02,083208,Lim; Seonhee,9,0,35,26
1657545763994,MATH 10B,A03,093472,Lim; Seonhee,7,0,34,27
1657545763994,MATH 10B,B01,083739,Sinha; Shubham,12,0,30,18
1657545770027,MATH 18,A01,083743,Cinel; Cameron Alexander,7,0,30,23
1657545770027,MATH 18,A02,083744,Cinel; Cameron Alexander,17,0,30,13
1657545770027,MATH 18,A03,083745,Cinel; Cameron Alexander,9,0,30,21
1657545770027,MATH 18,B01,083748,Rideout; David Porter,5,0,37,32
1657545770027,MATH 18,B02,083749,Rideout; David Porter,5,0,36,31
1657545770027,MATH 18,B03,083750,Rideout; David Porter,3,0,37,34
1657545770027,MATH 18,B04,083751,Rideout; David Porter,6,0,36,30
1657545770027,MATH 18,B05,093473,Rideout; David Porter,6,0,36,30
1657545770027,MATH 18,B06,093474,Rideout; David Porter,6,0,36,30
1657545776051,MATH 20A,A01,083754,Zheng; Zequn,14,0,40,26
1657545782076,MATH 20B,A01,083756,Briones; Jor-el Thomas Caparas,4,0,36,32
1657545782076,MATH 20B,A02,083757,Briones; Jor-el Thomas Caparas,1,0,36,35
1657545782076,MATH 20B,A03,093475,Briones; Jor-el Thomas Caparas,2,0,36,34
1657545788101,MATH 20C,A01,083760,Briones; Jor-el Thomas Caparas,1,0,35,34
1657545788101,MATH 20C,A02,083761,Briones; Jor-el Thomas Caparas,8,0,35,27
1657545788101,MATH 20C,A03,093476,Briones; Jor-el Thomas Caparas,0,1,36,36
1657545788101,MATH 20C,B01,083762,Bach; Quang Tran,1,0,30,29
1657545794125,MATH 20D,A01,083765,Tran; Brian Kha,5,0,30,25
1657545794125,MATH 20D,A02,083766,Tran; Brian Kha,5,0,30,25
1657545794125,MATH 20D,A03,083767,Tran; Brian Kha,5,0,30,25
1657545800154,MATH 20E,A01,083771,Ganguly; Soumya,9,0,32,23
1657545800154,MATH 20E,A02,083772,Ganguly; Soumya,6,0,32,26
1657545800154,MATH 20E,B01,083773,Ciotti; Benjamin,20,0,35,15
1657545800154,MATH 20E,B02,083774,Ciotti; Benjamin,17,0,35,18
1657545806177,MATH 103A,A01,083777,Greenfeld; Be'Eri,3,0,36,33
1657545806177,MATH 103A,A02,083778,Greenfeld; Be'Eri,5,0,36,31
1657545806177,MATH 103A,A03,093561,Greenfeld; Be'Eri,5,0,36,31
1657545806177,MATH 103A,B01,083779,Greenfeld; Be'Eri,7,0,36,29
1657545806177,MATH 103A,B02,083780,Greenfeld; Be'Eri,4,0,36,32
1657545806177,MATH 103A,B03,093562,Greenfeld; Be'Eri,3,0,36,33
1657545812212,MATH 105,A01,085443,Carter; Anne Toulson,15,0,35,20
1657545812212,MATH 105,A02,093477,Carter; Anne Toulson,20,0,35,15
1657545818237,MATH 109,A01,083213,Ganzberger; Geoffrey Michael,2,0,34,32
1657545818237,MATH 109,A02,083214,Ganzberger; Geoffrey Michael,4,0,34,30
1657545818237,MATH 109,A03,093478,Ganzberger; Geoffrey Michael,2,0,34,32
1657545818237,MATH 109,B01,083215,Ganzberger; Geoffrey Michael,1,0,32,31
1657545818237,MATH 109,B02,083216,Ganzberger; Geoffrey Michael,2,0,32,30
1657545818237,MATH 109,B03,093479,Ganzberger; Geoffrey Michael,8,0,32,24
1657545824262,MATH 142A,A01,083219,Chow; Bennett,7,0,32,25
1657545824262,MATH 142A,A02,083220,Chow; Bennett,10,0,32,22
1657545824262,MATH 142A,A03,093480,Chow; Bennett,8,0,32,24
1657545824262,MATH 142A,B03,093481,Chow; Bennett,8,0,32,24
1657545824262,MATH 142A,B04,093558,Chow; Bennett,13,0,32,19
1657545824262,MATH 142A,B05,093559,Chow; Bennett,6,0,32,26
1657545830294,MATH 193A,A01,083224,Rotar; Vladimir,8,0,34,26
1657545830294,MATH 193A,A02,083225,Rotar; Vladimir,9,0,34,25
1657545830294,MATH 193A,A03,083781,Rotar; Vladimir,5,0,34,29
1657545830294,MATH 193A,A04,083782,Rotar; Vladimir,10,0,34,24
1657545830294,MATH 193A,A05,093482,Rotar; Vladimir,10,0,34,24
1657545836323,MATH 197,001,091859,McAuley; Julian John,9999,0,9999,0
1657545836323,MATH 197,002,095566,Kedlaya; Kiran S.,9997,0,9999,2
1657545836323,MATH 197,003,095567,Xiao; Ming,9999,0,9999,0
1657545836323,MATH 197,004,095571,Perols; Johan Lars,9998,0,9999,1
1657545843379,COGS 9,A01,083615,Shannon; Kyle Michael,9,0,75,66
1657545849405,COGS 11,A01,083617,Boyle; Mary E. T.,22,0,48,26
1657545855434,COGS 13,A01,083071,Bastos; Amalia Pinkusfeld,11,0,71,60
1657545861461,COGS 14A,A01,092681,Semenuks; Arturs,5,1,100,95
1657545867487,COGS 14B,A01,083073,Cheng; Tzu-Han,6,0,63,57
1657545873512,COGS 17,A01,092677,Semenuks; Arturs,6,0,81,75
1657545879536,COGS 100,A01,083619,Allen; Michael Gordon,17,0,70,53
1657545885565,COGS 101A,A01,083621,Davis; Joshua Daniel,9,0,68,59
1657545891594,COGS 101B,A01,091572,Allen; Michael Gordon,12,0,65,53
1657545897620,COGS 101C,A01,083625,Delgado; Tania,17,0,35,18
1657545903643,COGS 107A,A01,083627,Boyle; Mary E. T.,13,0,60,47
1657545909672,COGS 118A,A01,083075,Gupta; Anjum,21,0,76,55
1657545915697,CSE 3,A50,083646,Miranda; Gregory Joseph,24,0,50,26
1657545921721,CSE 8A,A50,083650,Miranda; Gregory Joseph,17,1,56,39
1657545927747,CSE 11,A01,083080,Cao; Yingjun,6,15,40,34
1657545933771,CSE 12,A01,083652,Krause-Levy; Sophia Louisa,28,1,120,92
1657545939813,CSE 15L,A01,083654,Morris; Justin Loren,9,0,50,41
1657545939813,CSE 15L,A02,083655,Morris; Justin Loren,9,0,50,41
1657545945840,CSE 20,A01,083657,Tran; Khoa Dang,39,0,80,41
1657545951865,CSE 21,A01,095574,Bach; Quang Tran,22,0,48,26
1657545957895,CSE 30,A01,083084,Eldon; John,5,0,80,75
1657545957895,CSE 30,B01,095061,Bhaskar; Nishant,9,0,50,41
1657545963922,CSE 100,A01,083659,Cao; Yingjun,5,4,70,65
1657545969945,CSE 134B,A01,083661,Powell; Thomas Allan,22,0,100,78
1657545975968,CSE 140,A01,083663,Gungor; Onat,15,0,85,70
1657545981999,CSE 140L,A01,083088,Eldon; John,21,0,100,79
1657545988023,CSE 175,A01,083665,Kumar; Rakesh,3,0,25,22
1657545994065,CSE 190,A00,092507,Dubnov; Shlomo,8,0,20,12
1657546000092,ECE 45,A01,083139,Congero; Spencer William,6,0,75,69
1657546006120,ECE 65,A50,083695,Saad; Andrew S,12,0,30,18
1657546006120,ECE 65,A51,095125,Saad; Andrew S,24,0,26,2
1657546012146,ECE 109,A01,091882,Touri; Behrouz,19,0,70,51
1657546018171,ECE 180,A00,083140,Abi Samra; Nicholas Camill,1,0,30,29
1657546018171,ECE 180,B00,083141,Abi Samra; Nicholas Camill,0,0,30,30
1657546024198,MATH 10A,A01,083735,Patchell; Gregory David,2,0,30,28
1657546024198,MATH 10A,A02,083736,Patchell; Gregory David,20,0,30,10
1657546024198,MATH 10A,A03,083737,Patchell; Gregory David,16,0,30,14
1657546030230,MATH 10B,A01,083207,Lim; Seonhee,8,0,34,26
1657546030230,MATH 10B,A02,083208,Lim; Seonhee,9,0,35,26
1657546030230,MATH 10B,A03,093472,Lim; Seonhee,7,0,34,27
1657546030230,MATH 10B,B01,083739,Sinha; Shubham,12,0,30,18
1657546036261,MATH 18,A01,083743,Cinel; Cameron Alexander,7,0,30,23
1657546036261,MATH 18,A02,083744,Cinel; Cameron Alexander,17,0,30,13
1657546036261,MATH 18,A03,083745,Cinel; Cameron Alexander,9,0,30,21
1657546036261,MATH 18,B01,083748,Rideout; David Porter,5,0,37,32
1657546036261,MATH 18,B02,083749,Rideout; David Porter,5,0,36,31
1657546036261,MATH 18,B03,083750,Rideout; David Porter,3,0,37,34
1657546036261,MATH 18,B04,083751,Rideout; David Porter,6,0,36,30
1657546036261,MATH 18,B05,093473,Rideout; David Porter,6,0,36,30
1657546036261,MATH 18,B06,093474,Rideout; David Porter,6,0,36,30
1657546042292,MATH 20A,A01,083754,Zheng; Zequn,14,0,40,26
1657546048320,MATH 20B,A01,083756,Briones; Jor-el Thomas Caparas,4,0,36,32
1657546048320,MATH 20B,A02,083757,Briones; Jor-el Thomas Caparas,1,0,36,35
1657546048320,MATH 20B,A03,093475,Briones; Jor-el Thomas Caparas,2,0,36,34
1657546054349,MATH 20C,A01,083760,Briones; Jor-el Thomas Caparas,1,0,35,34
1657546054349,MATH 20C,A02,083761,Briones; Jor-el Thomas Caparas,8,0,35,27
1657546054349,MATH 20C,A03,093476,Briones; Jor-el Thomas Caparas,0,1,36,36
1657546054349,MATH 20C,B01,083762,Bach; Quang Tran,1,0,30,29
1657546060379,MATH 20D,A01,083765,Tran; Brian Kha,5,0,30,25
1657546060379,MATH 20D,A02,083766,Tran; Brian Kha,5,0,30,25
1657546060379,MATH 20D,A03,083767,Tran; Brian Kha,5,0,30,25
1657546066413,MATH 20E,A01,083771,Ganguly; Soumya,9,0,32,23
1657546066413,MATH 20E,A02,083772,Ganguly; Soumya,6,0,32,26
1657546066413,MATH 20E,B01,083773,Ciotti; Benjamin,20,0,35,15
1657546066413,MATH 20E,B02,083774,Ciotti; Benjamin,17,0,35,18
1657546072529,MATH 103A,A01,083777,Greenfeld; Be'Eri,3,0,36,33
1657546072529,MATH 103A,A02,083778,Greenfeld; Be'Eri,5,0,36,31
1657546072529,MATH 103A,A03,093561,Greenfeld; Be'Eri,5,0,36,31
1657546072529,MATH 103A,B01,083779,Greenfeld; Be'Eri,7,0,36,29
1657546072529,MATH 103A,B02,083780,Greenfeld; Be'Eri,4,0,36,32
1657546072529,MATH 103A,B03,093562,Greenfeld; Be'Eri,3,0,36,33
1657546078552,MATH 105,A01,085443,Carter; Anne Toulson,15,0,35,20
1657546078552,MATH 105,A02,093477,Carter; Anne Toulson,20,0,35,15
1657546084577,MATH 109,A01,083213,Ganzberger; Geoffrey Michael,2,0,34,32
1657546084577,MATH 109,A02,083214,Ganzberger; Geoffrey Michael,4,0,34,30
1657546084577,MATH 109,A03,093478,Ganzberger; Geoffrey Michael,2,0,34,32
1657546084577,MATH 109,B01,083215,Ganzberger; Geoffrey Michael,1,0,32,31
1657546084577,MATH 109,B02,083216,Ganzberger; Geoffrey Michael,2,0,32,30
1657546084577,MATH 109,B03,093479,Ganzberger; Geoffrey Michael,8,0,32,24
1657546090604,MATH 142A,A01,083219,Chow; Bennett,7,0,32,25
1657546090604,MATH 142A,A02,083220,Chow; Bennett,10,0,32,22
1657546090604,MATH 142A,A03,093480,Chow; Bennett,8,0,32,24
1657546090604,MATH 142A,B03,093481,Chow; Bennett,8,0,32,24
1657546090604,MATH 142A,B04,093558,Chow; Bennett,13,0,32,19
1657546090604,MATH 142A,B05,093559,Chow; Bennett,6,0,32,26
1657546096630,MATH 193A,A01,083224,Rotar; Vladimir,8,0,34,26
1657546096630,MATH 193A,A02,083225,Rotar; Vladimir,9,0,34,25
1657546096630,MATH 193A,A03,083781,Rotar; Vladimir,5,0,34,29
1657546096630,MATH 193A,A04,083782,Rotar; Vladimir,10,0,34,24
1657546096630,MATH 193A,A05,093482,Rotar; Vladimir,10,0,34,24
1657546102660,MATH 197,001,091859,McAuley; Julian John,9999,0,9999,0
1657546102660,MATH 197,002,095566,Kedlaya; Kiran S.,9997,0,9999,2
1657546102660,MATH 197,003,095567,Xiao; Ming,9999,0,9999,0
1657546102660,MATH 197,004,095571,Perols; Johan Lars,9998,0,9999,1
1657546109743,COGS 9,A01,083615,Shannon; Kyle Michael,9,0,75,66
1657546115771,COGS 11,A01,083617,Boyle; Mary E. T.,22,0,48,26
1657546121796,COGS 13,A01,083071,Bastos; Amalia Pinkusfeld,11,0,71,60
1657546127827,COGS 14A,A01,092681,Semenuks; Arturs,5,1,100,95
1657546133855,COGS 14B,A01,083073,Cheng; Tzu-Han,6,0,63,57
1657546139883,COGS 17,A01,092677,Semenuks; Arturs,6,0,81,75
1657546145915,COGS 100,A01,083619,Allen; Michael Gordon,17,0,70,53
1657546151945,COGS 101A,A01,083621,Davis; Joshua Daniel,9,0,68,59
1657546157972,COGS 101B,A01,091572,Allen; Michael Gordon,12,0,65,53
1657546163998,COGS 101C,A01,083625,Delgado; Tania,17,0,35,18
1657546170022,COGS 107A,A01,083627,Boyle; Mary E. T.,13,0,60,47
1657546176047,COGS 118A,A01,083075,Gupta; Anjum,21,0,76,55
1657546182077,CSE 3,A50,083646,Miranda; Gregory Joseph,24,0,50,26
1657546188107,CSE 8A,A50,083650,Miranda; Gregory Joseph,17,1,56,39
1657546194133,CSE 11,A01,083080,Cao; Yingjun,6,15,40,34
1657546200164,CSE 12,A01,083652,Krause-Levy; Sophia Louisa,28,1,120,92
1657546206188,CSE 15L,A01,083654,Morris; Justin Loren,9,0,50,41
1657546206188,CSE 15L,A02,083655,Morris; Justin Loren,9,0,50,41
1657546212217,CSE 20,A01,083657,Tran; Khoa Dang,39,0,80,41
1657546218243,CSE 21,A01,095574,Bach; Quang Tran,22,0,48,26
1657546224270,CSE 30,A01,083084,Eldon; John,5,0,80,75
1657546224270,CSE 30,B01,095061,Bhaskar; Nishant,9,0,50,41
1657546230292,CSE 100,A01,083659,Cao; Yingjun,5,4,70,65
1657546236318,CSE 134B,A01,083661,Powell; Thomas Allan,22,0,100,78
1657546242348,CSE 140,A01,083663,Gungor; Onat,15,0,85,70
1657546248373,CSE 140L,A01,083088,Eldon; John,21,0,100,79
1657546254401,CSE 175,A01,083665,Kumar; Rakesh,3,0,25,22
1657546260424,CSE 190,A00,092507,Dubnov; Shlomo,8,0,20,12
1657546266452,ECE 45,A01,083139,Congero; Spencer William,6,0,75,69
1657546272481,ECE 65,A50,083695,Saad; Andrew S,12,0,30,18
1657546272481,ECE 65,A51,095125,Saad; Andrew S,24,0,26,2
1657546278510,ECE 109,A01,091882,Touri; Behrouz,19,0,70,51
1657546284541,ECE 180,A00,083140,Abi Samra; Nicholas Camill,1,0,30,29
1657546284541,ECE 180,B00,083141,Abi Samra; Nicholas Camill,0,0,30,30
1657546290564,MATH 10A,A01,083735,Patchell; Gregory David,2,0,30,28
1657546290564,MATH 10A,A02,083736,Patchell; Gregory David,20,0,30,10
1657546290564,MATH 10A,A03,083737,Patchell; Gregory David,16,0,30,14
1657546296596,MATH 10B,A01,083207,Lim; Seonhee,8,0,34,26
1657546296596,MATH 10B,A02,083208,Lim; Seonhee,9,0,35,26
1657546296596,MATH 10B,A03,093472,Lim; Seonhee,7,0,34,27
1657546296596,MATH 10B,B01,083739,Sinha; Shubham,12,0,30,18
1657546302624,MATH 18,A01,083743,Cinel; Cameron Alexander,7,0,30,23
1657546302624,MATH 18,A02,083744,Cinel; Cameron Alexander,17,0,30,13
1657546302624,MATH 18,A03,083745,Cinel; Cameron Alexander,9,0,30,21
1657546302624,MATH 18,B01,083748,Rideout; David Porter,5,0,37,32
1657546302624,MATH 18,B02,083749,Rideout; David Porter,5,0,36,31
1657546302624,MATH 18,B03,083750,Rideout; David Porter,3,0,37,34
1657546302624,MATH 18,B04,083751,Rideout; David Porter,6,0,36,30
1657546302624,MATH 18,B05,093473,Rideout; David Porter,6,0,36,30
1657546302624,MATH 18,B06,093474,Rideout; David Porter,6,0,36,30
1657546308649,MATH 20A,A01,083754,Zheng; Zequn,14,0,40,26
1657546314672,MATH 20B,A01,083756,Briones; Jor-el Thomas Caparas,4,0,36,32
1657546314672,MATH 20B,A02,083757,Briones; Jor-el Thomas Caparas,1,0,36,35
1657546314672,MATH 20B,A03,093475,Briones; Jor-el Thomas Caparas,2,0,36,34
1657546320697,MATH 20C,A01,083760,Briones; Jor-el Thomas Caparas,1,0,35,34
1657546320697,MATH 20C,A02,083761,Briones; Jor-el Thomas Caparas,8,0,35,27
1657546320697,MATH 20C,A03,093476,Briones; Jor-el Thomas Caparas,0,1,36,36
1657546320697,MATH 20C,B01,083762,Bach; Quang Tran,1,0,30,29
1657546326722,MATH 20D,A01,083765,Tran; Brian Kha,5,0,30,25
1657546326722,MATH 20D,A02,083766,Tran; Brian Kha,5,0,30,25
1657546326722,MATH 20D,A03,083767,Tran; Brian Kha,5,0,30,25
1657546332759,MATH 20E,A01,083771,Ganguly; Soumya,9,0,32,23
1657546332759,MATH 20E,A02,083772,Ganguly; Soumya,6,0,32,26
1657546332759,MATH 20E,B01,083773,Ciotti; Benjamin,20,0,35,15
1657546332759,MATH 20E,B02,083774,Ciotti; Benjamin,17,0,35,18
1657546338785,MATH 103A,A01,083777,Greenfeld; Be'Eri,3,0,36,33
1657546338785,MATH 103A,A02,083778,Greenfeld; Be'Eri,5,0,36,31
1657546338785,MATH 103A,A03,093561,Greenfeld; Be'Eri,5,0,36,31
1657546338785,MATH 103A,B01,083779,Greenfeld; Be'Eri,7,0,36,29
1657546338785,MATH 103A,B02,083780,Greenfeld; Be'Eri,4,0,36,32
1657546338785,MATH 103A,B03,093562,Greenfeld; Be'Eri,3,0,36,33
1657546344813,MATH 105,A01,085443,Carter; Anne Toulson,15,0,35,20
1657546344813,MATH 105,A02,093477,Carter; Anne Toulson,20,0,35,15
1657546350839,MATH 109,A01,083213,Ganzberger; Geoffrey Michael,2,0,34,32
1657546350839,MATH 109,A02,083214,Ganzberger; Geoffrey Michael,4,0,34,30
1657546350839,MATH 109,A03,093478,Ganzberger; Geoffrey Michael,2,0,34,32
1657546350839,MATH 109,B01,083215,Ganzberger; Geoffrey Michael,1,0,32,31
1657546350839,MATH 109,B02,083216,Ganzberger; Geoffrey Michael,2,0,32,30
1657546350839,MATH 109,B03,093479,Ganzberger; Geoffrey Michael,8,0,32,24
1657546356865,MATH 142A,A01,083219,Chow; Bennett,7,0,32,25
1657546356865,MATH 142A,A02,083220,Chow; Bennett,10,0,32,22
1657546356865,MATH 142A,A03,093480,Chow; Bennett,8,0,32,24
1657546356865,MATH 142A,B03,093481,Chow; Bennett,8,0,32,24
1657546356865,MATH 142A,B04,093558,Chow; Bennett,13,0,32,19
1657546356865,MATH 142A,B05,093559,Chow; Bennett,6,0,32,26
1657546362893,MATH 193A,A01,083224,Rotar; Vladimir,8,0,34,26
1657546362893,MATH 193A,A02,083225,Rotar; Vladimir,9,0,34,25
1657546362893,MATH 193A,A03,083781,Rotar; Vladimir,5,0,34,29
1657546362893,MATH 193A,A04,083782,Rotar; Vladimir,10,0,34,24
1657546362893,MATH 193A,A05,093482,Rotar; Vladimir,10,0,34,24
1657546368918,MATH 197,001,091859,McAuley; Julian John,9999,0,9999,0
1657546368918,MATH 197,002,095566,Kedlaya; Kiran S.,9997,0,9999,2
1657546368918,MATH 197,003,095567,Xiao; Ming,9999,0,9999,0
1657546368918,MATH 197,004,095571,Perols; Johan Lars,9998,0,9999,1
1657546375988,COGS 9,A01,083615,Shannon; Kyle Michael,9,0,75,66
1657546382016,COGS 11,A01,083617,Boyle; Mary E. T.,22,0,48,26
1657546388044,COGS 13,A01,083071,Bastos; Amalia Pinkusfeld,11,0,71,60
1657546394070,COGS 14A,A01,092681,Semenuks; Arturs,5,1,100,95
1657546400099,COGS 14B,A01,083073,Cheng; Tzu-Han,6,0,63,57
1657546406122,COGS 17,A01,092677,Semenuks; Arturs,6,0,81,75
1657546412150,COGS 100,A01,083619,Allen; Michael Gordon,17,0,70,53
1657546418173,COGS 101A,A01,083621,Davis; Joshua Daniel,9,0,68,59
1657546424199,COGS 101B,A01,091572,Allen; Michael Gordon,12,0,65,53
1657546430224,COGS 101C,A01,083625,Delgado; Tania,17,0,35,18
1657546436252,COGS 107A,A01,083627,Boyle; Mary E. T.,13,0,60,47
1657546442276,COGS 118A,A01,083075,Gupta; Anjum,21,0,76,55
1657546448299,CSE 3,A50,083646,Miranda; Gregory Joseph,24,0,50,26
1657546454321,CSE 8A,A50,083650,Miranda; Gregory Joseph,17,1,56,39
1657546460348,CSE 11,A01,083080,Cao; Yingjun,6,15,40,34
1657546466375,CSE 12,A01,083652,Krause-Levy; Sophia Louisa,28,1,120,92
1657546472409,CSE 15L,A01,083654,Morris; Justin Loren,9,0,50,41
1657546472409,CSE 15L,A02,083655,Morris; Justin Loren,9,0,50,41
1657546478436,CSE 20,A01,083657,Tran; Khoa Dang,39,0,80,41
1657546484463,CSE 21,A01,095574,Bach; Quang Tran,22,0,48,26
1657546490488,CSE 30,A01,083084,Eldon; John,5,0,80,75
1657546490488,CSE 30,B01,095061,Bhaskar; Nishant,9,0,50,41
1657546496511,CSE 100,A01,083659,Cao; Yingjun,5,4,70,65
1657546502537,CSE 134B,A01,083661,Powell; Thomas Allan,22,0,100,78
1657546508562,CSE 140,A01,083663,Gungor; Onat,15,0,85,70
1657546514585,CSE 140L,A01,083088,Eldon; John,21,0,100,79
1657546520613,CSE 175,A01,083665,Kumar; Rakesh,3,0,25,22
1657546526639,CSE 190,A00,092507,Dubnov; Shlomo,8,0,20,12
1657546532665,ECE 45,A01,083139,Congero; Spencer William,6,0,75,69
1657546538695,ECE 65,A50,083695,Saad; Andrew S,12,0,30,18
1657546538695,ECE 65,A51,095125,Saad; Andrew S,24,0,26,2
1657546544721,ECE 109,A01,091882,Touri; Behrouz,19,0,70,51
1657546550744,ECE 180,A00,083140,Abi Samra; Nicholas Camill,1,0,30,29
1657546550744,ECE 180,B00,083141,Abi Samra; Nicholas Camill,0,0,30,30
1657546556770,MATH 10A,A01,083735,Patchell; Gregory David,2,0,30,28
1657546556770,MATH 10A,A02,083736,Patchell; Gregory David,20,0,30,10
1657546556770,MATH 10A,A03,083737,Patchell; Gregory David,16,0,30,14
1657546562794,MATH 10B,A01,083207,Lim; Seonhee,8,0,34,26
1657546562794,MATH 10B,A02,083208,Lim; Seonhee,9,0,35,26
1657546562794,MATH 10B,A03,093472,Lim; Seonhee,7,0,34,27
1657546562794,MATH 10B,B01,083739,Sinha; Shubham,12,0,30,18
1657546568827,MATH 18,A01,083743,Cinel; Cameron Alexander,7,0,30,23
1657546568827,MATH 18,A02,083744,Cinel; Cameron Alexander,17,0,30,13
1657546568827,MATH 18,A03,083745,Cinel; Cameron Alexander,9,0,30,21
1657546568827,MATH 18,B01,083748,Rideout; David Porter,5,0,37,32
1657546568827,MATH 18,B02,083749,Rideout; David Porter,5,0,36,31
1657546568827,MATH 18,B03,083750,Rideout; David Porter,3,0,37,34
1657546568827,MATH 18,B04,083751,Rideout; David Porter,6,0,36,30
1657546568827,MATH 18,B05,093473,Rideout; David Porter,6,0,36,30
1657546568827,MATH 18,B06,093474,Rideout; David Porter,6,0,36,30
1657546574853,MATH 20A,A01,083754,Zheng; Zequn,14,0,40,26
1657546580883,MATH 20B,A01,083756,Briones; Jor-el Thomas Caparas,4,0,36,32
1657546580883,MATH 20B,A02,083757,Briones; Jor-el Thomas Caparas,1,0,36,35
1657546580883,MATH 20B,A03,093475,Briones; Jor-el Thomas Caparas,2,0,36,34
1657546586913,MATH 20C,A01,083760,Briones; Jor-el Thomas Caparas,1,0,35,34
1657546586913,MATH 20C,A02,083761,Briones; Jor-el Thomas Caparas,8,0,35,27
1657546586913,MATH 20C,A03,093476,Briones; Jor-el Thomas Caparas,0,1,36,36
1657546586913,MATH 20C,B01,083762,Bach; Quang Tran,1,0,30,29
1657546592941,MATH 20D,A01,083765,Tran; Brian Kha,5,0,30,25
1657546592941,MATH 20D,A02,083766,Tran; Brian Kha,5,0,30,25
1657546592941,MATH 20D,A03,083767,Tran; Brian Kha,5,0,30,25
1657546598972,MATH 20E,A01,083771,Ganguly; Soumya,9,0,32,23
1657546598972,MATH 20E,A02,083772,Ganguly; Soumya,6,0,32,26
1657546598972,MATH 20E,B01,083773,Ciotti; Benjamin,20,0,35,15
1657546598972,MATH 20E,B02,083774,Ciotti; Benjamin,17,0,35,18
1657546605003,MATH 103A,A01,083777,Greenfeld; Be'Eri,3,0,36,33
1657546605003,MATH 103A,A02,083778,Greenfeld; Be'Eri,5,0,36,31
1657546605003,MATH 103A,A03,093561,Greenfeld; Be'Eri,5,0,36,31
1657546605003,MATH 103A,B01,083779,Greenfeld; Be'Eri,7,0,36,29
1657546605003,MATH 103A,B02,083780,Greenfeld; Be'Eri,4,0,36,32
1657546605003,MATH 103A,B03,093562,Greenfeld; Be'Eri,3,0,36,33
1657546611033,MATH 105,A01,085443,Carter; Anne Toulson,15,0,35,20
1657546611033,MATH 105,A02,093477,Carter; Anne Toulson,20,0,35,15
1657546617059,MATH 109,A01,083213,Ganzberger; Geoffrey Michael,2,0,34,32
1657546617059,MATH 109,A02,083214,Ganzberger; Geoffrey Michael,4,0,34,30
1657546617059,MATH 109,A03,093478,Ganzberger; Geoffrey Michael,2,0,34,32
1657546617059,MATH 109,B01,083215,Ganzberger; Geoffrey Michael,1,0,32,31
1657546617059,MATH 109,B02,083216,Ganzberger; Geoffrey Michael,2,0,32,30
1657546617059,MATH 109,B03,093479,Ganzberger; Geoffrey Michael,8,0,32,24
1657546623083,MATH 142A,A01,083219,Chow; Bennett,7,0,32,25
1657546623083,MATH 142A,A02,083220,Chow; Bennett,10,0,32,22
1657546623083,MATH 142A,A03,093480,Chow; Bennett,8,0,32,24
1657546623083,MATH 142A,B03,093481,Chow; Bennett,8,0,32,24
1657546623083,MATH 142A,B04,093558,Chow; Bennett,13,0,32,19
1657546623083,MATH 142A,B05,093559,Chow; Bennett,6,0,32,26
1657546629110,MATH 193A,A01,083224,Rotar; Vladimir,8,0,34,26
1657546629110,MATH 193A,A02,083225,Rotar; Vladimir,9,0,34,25
1657546629110,MATH 193A,A03,083781,Rotar; Vladimir,5,0,34,29
1657546629110,MATH 193A,A04,083782,Rotar; Vladimir,10,0,34,24
1657546629110,MATH 193A,A05,093482,Rotar; Vladimir,10,0,34,24
1657546635135,MATH 197,001,091859,McAuley; Julian John,9999,0,9999,0
1657546635135,MATH 197,002,095566,Kedlaya; Kiran S.,9997,0,9999,2
1657546635135,MATH 197,003,095567,Xiao; Ming,9999,0,9999,0
1657546635135,MATH 197,004,095571,Perols; Johan Lars,9998,0,9999,1
1657546642207,COGS 9,A01,083615,Shannon; Kyle Michael,9,0,75,66
1657546648231,COGS 11,A01,083617,Boyle; Mary E. T.,22,0,48,26
1657546654255,COGS 13,A01,083071,Bastos; Amalia Pinkusfeld,11,0,71,60
1657546660282,COGS 14A,A01,092681,Semenuks; Arturs,5,1,100,95
1657546666378,COGS 14B,A01,083073,Cheng; Tzu-Han,6,0,63,57
1657546672403,COGS 17,A01,092677,Semenuks; Arturs,6,0,81,75
1657546678427,COGS 100,A01,083619,Allen; Michael Gordon,17,0,70,53
1657546684457,COGS 101A,A01,083621,Davis; Joshua Daniel,9,0,68,59
1657546690485,COGS 101B,A01,091572,Allen; Michael Gordon,12,0,65,53
1657546696507,COGS 101C,A01,083625,Delgado; Tania,17,0,35,18
1657546702531,COGS 107A,A01,083627,Boyle; Mary E. T.,13,0,60,47
1657546708559,COGS 118A,A01,083075,Gupta; Anjum,21,0,76,55
1657546714581,CSE 3,A50,083646,Miranda; Gregory Joseph,24,0,50,26
1657546720605,CSE 8A,A50,083650,Miranda; Gregory Joseph,17,1,56,39
1657546726627,CSE 11,A01,083080,Cao; Yingjun,6,15,40,34
1657546732651,CSE 12,A01,083652,Krause-Levy; Sophia Louisa,28,1,120,92
1657546738679,CSE 15L,A01,083654,Morris; Justin Loren,9,0,50,41
1657546738679,CSE 15L,A02,083655,Morris; Justin Loren,9,0,50,41
1657546744711,CSE 20,A01,083657,Tran; Khoa Dang,39,0,80,41
1657546750733,CSE 21,A01,095574,Bach; Quang Tran,22,0,48,26
1657546756762,CSE 30,A01,083084,Eldon; John,5,0,80,75
1657546756762,CSE 30,B01,095061,Bhaskar; Nishant,9,0,50,41
1657546762787,CSE 100,A01,083659,Cao; Yingjun,5,4,70,65
1657546768811,CSE 134B,A01,083661,Powell; Thomas Allan,22,0,100,78
1657546774838,CSE 140,A01,083663,Gungor; Onat,15,0,85,70
1657546780864,CSE 140L,A01,083088,Eldon; John,21,0,100,79
1657546786887,CSE 175,A01,083665,Kumar; Rakesh,3,0,25,22
1657546792915,CSE 190,A00,092507,Dubnov; Shlomo,8,0,20,12
1657546798941,ECE 45,A01,083139,Congero; Spencer William,6,0,75,69
1657546804971,ECE 65,A50,083695,Saad; Andrew S,12,0,30,18
1657546804971,ECE 65,A51,095125,Saad; Andrew S,24,0,26,2
1657546810997,ECE 109,A01,091882,Touri; Behrouz,19,0,70,51
1657546817029,ECE 180,A00,083140,Abi Samra; Nicholas Camill,1,0,30,29
1657546817029,ECE 180,B00,083141,Abi Samra; Nicholas Camill,0,0,30,30
1657546823053,MATH 10A,A01,083735,Patchell; Gregory David,2,0,30,28
1657546823053,MATH 10A,A02,083736,Patchell; Gregory David,20,0,30,10
1657546823053,MATH 10A,A03,083737,Patchell; Gregory David,16,0,30,14
1657546829083,MATH 10B,A01,083207,Lim; Seonhee,8,0,34,26
1657546829083,MATH 10B,A02,083208,Lim; Seonhee,9,0,35,26
1657546829083,MATH 10B,A03,093472,Lim; Seonhee,7,0,34,27
1657546829083,MATH 10B,B01,083739,Sinha; Shubham,12,0,30,18
1657546835109,MATH 18,A01,083743,Cinel; Cameron Alexander,7,0,30,23
1657546835109,MATH 18,A02,083744,Cinel; Cameron Alexander,17,0,30,13
1657546835109,MATH 18,A03,083745,Cinel; Cameron Alexander,9,0,30,21
1657546835109,MATH 18,B01,083748,Rideout; David Porter,5,0,37,32
1657546835109,MATH 18,B02,083749,Rideout; David Porter,5,0,36,31
1657546835109,MATH 18,B03,083750,Rideout; David Porter,3,0,37,34
1657546835109,MATH 18,B04,083751,Rideout; David Porter,6,0,36,30
1657546835109,MATH 18,B05,093473,Rideout; David Porter,6,0,36,30
1657546835109,MATH 18,B06,093474,Rideout; David Porter,6,0,36,30
1657546841142,MATH 20A,A01,083754,Zheng; Zequn,14,0,40,26
1657546847173,MATH 20B,A01,083756,Briones; Jor-el Thomas Caparas,4,0,36,32
1657546847173,MATH 20B,A02,083757,Briones; Jor-el Thomas Caparas,1,0,36,35
1657546847173,MATH 20B,A03,093475,Briones; Jor-el Thomas Caparas,2,0,36,34
1657546853202,MATH 20C,A01,083760,Briones; Jor-el Thomas Caparas,1,0,35,34
1657546853202,MATH 20C,A02,083761,Briones; Jor-el Thomas Caparas,8,0,35,27
1657546853202,MATH 20C,A03,093476,Briones; Jor-el Thomas Caparas,0,1,36,36
1657546853202,MATH 20C,B01,083762,Bach; Quang Tran,1,0,30,29
1657546859226,MATH 20D,A01,083765,Tran; Brian Kha,5,0,30,25
1657546859226,MATH 20D,A02,083766,Tran; Brian Kha,5,0,30,25
1657546859226,MATH 20D,A03,083767,Tran; Brian Kha,5,0,30,25
1657546865254,MATH 20E,A01,083771,Ganguly; Soumya,9,0,32,23
1657546865254,MATH 20E,A02,083772,Ganguly; Soumya,6,0,32,26
1657546865254,MATH 20E,B01,083773,Ciotti; Benjamin,20,0,35,15
1657546865254,MATH 20E,B02,083774,Ciotti; Benjamin,17,0,35,18
1657546871284,MATH 103A,A01,083777,Greenfeld; Be'Eri,3,0,36,33
1657546871284,MATH 103A,A02,083778,Greenfeld; Be'Eri,5,0,36,31
1657546871284,MATH 103A,A03,093561,Greenfeld; Be'Eri,5,0,36,31
1657546871284,MATH 103A,B01,083779,Greenfeld; Be'Eri,7,0,36,29
1657546871284,MATH 103A,B02,083780,Greenfeld; Be'Eri,4,0,36,32
1657546871284,MATH 103A,B03,093562,Greenfeld; Be'Eri,3,0,36,33
1657546877311,MATH 105,A01,085443,Carter; Anne Toulson,15,0,35,20
1657546877311,MATH 105,A02,093477,Carter; Anne Toulson,20,0,35,15
1657546883335,MATH 109,A01,083213,Ganzberger; Geoffrey Michael,2,0,34,32
1657546883335,MATH 109,A02,083214,Ganzberger; Geoffrey Michael,4,0,34,30
1657546883335,MATH 109,A03,093478,Ganzberger; Geoffrey Michael,2,0,34,32
1657546883335,MATH 109,B01,083215,Ganzberger; Geoffrey Michael,1,0,32,31
1657546883335,MATH 109,B02,083216,Ganzberger; Geoffrey Michael,2,0,32,30
1657546883335,MATH 109,B03,093479,Ganzberger; Geoffrey Michael,8,0,32,24
1657546889360,MATH 142A,A01,083219,Chow; Bennett,7,0,32,25
1657546889360,MATH 142A,A02,083220,Chow; Bennett,10,0,32,22
1657546889360,MATH 142A,A03,093480,Chow; Bennett,8,0,32,24
1657546889360,MATH 142A,B03,093481,Chow; Bennett,8,0,32,24
1657546889360,MATH 142A,B04,093558,Chow; Bennett,13,0,32,19
1657546889360,MATH 142A,B05,093559,Chow; Bennett,6,0,32,26
1657546895389,MATH 193A,A01,083224,Rotar; Vladimir,8,0,34,26
1657546895389,MATH 193A,A02,083225,Rotar; Vladimir,9,0,34,25
1657546895389,MATH 193A,A03,083781,Rotar; Vladimir,5,0,34,29
1657546895389,MATH 193A,A04,083782,Rotar; Vladimir,10,0,34,24
1657546895389,MATH 193A,A05,093482,Rotar; Vladimir,10,0,34,24
1657546901415,MATH 197,001,091859,McAuley; Julian John,9999,0,9999,0
1657546901415,MATH 197,002,095566,Kedlaya; Kiran S.,9997,0,9999,2
1657546901415,MATH 197,003,095567,Xiao; Ming,9999,0,9999,0
1657546901415,MATH 197,004,095571,Perols; Johan Lars,9998,0,9999,1
1657546908475,COGS 9,A01,083615,Shannon; Kyle Michael,9,0,75,66
1657546914508,COGS 11,A01,083617,Boyle; Mary E. T.,22,0,48,26
1657546920535,COGS 13,A01,083071,Bastos; Amalia Pinkusfeld,11,0,71,60
1657546926563,COGS 14A,A01,092681,Semenuks; Arturs,5,1,100,95
1657546932587,COGS 14B,A01,083073,Cheng; Tzu-Han,6,0,63,57
1657546938621,COGS 17,A01,092677,Semenuks; Arturs,6,0,81,75
1657546944649,COGS 100,A01,083619,Allen; Michael Gordon,17,0,70,53
1657546950674,COGS 101A,A01,083621,Davis; Joshua Daniel,9,0,68,59
1657546956702,COGS 101B,A01,091572,Allen; Michael Gordon,12,0,65,53
1657546962727,COGS 101C,A01,083625,Delgado; Tania,17,0,35,18
1657546968752,COGS 107A,A01,083627,Boyle; Mary E. T.,13,0,60,47
1657546974776,COGS 118A,A01,083075,Gupta; Anjum,21,0,76,55
1657546980800,CSE 3,A50,083646,Miranda; Gregory Joseph,24,0,50,26
1657546986836,CSE 8A,A50,083650,Miranda; Gregory Joseph,17,1,56,39
1657546992862,CSE 11,A01,083080,Cao; Yingjun,6,15,40,34
1657546998890,CSE 12,A01,083652,Krause-Levy; Sophia Louisa,28,1,120,92
1657547004914,CSE 15L,A01,083654,Morris; Justin Loren,9,0,50,41
1657547004914,CSE 15L,A02,083655,Morris; Justin Loren,9,0,50,41
1657547010940,CSE 20,A01,083657,Tran; Khoa Dang,39,0,80,41
1657547016967,CSE 21,A01,095574,Bach; Quang Tran,22,0,48,26
1657547022995,CSE 30,A01,083084,Eldon; John,5,0,80,75
1657547022995,CSE 30,B01,095061,Bhaskar; Nishant,9,0,50,41
1657547029018,CSE 100,A01,083659,Cao; Yingjun,5,4,70,65
1657547035042,CSE 134B,A01,083661,Powell; Thomas Allan,22,0,100,78
1657547041067,CSE 140,A01,083663,Gungor; Onat,15,0,85,70
1657547047092,CSE 140L,A01,083088,Eldon; John,21,0,100,79
1657547053115,CSE 175,A01,083665,Kumar; Rakesh,3,0,25,22
1657547059140,CSE 190,A00,092507,Dubnov; Shlomo,8,0,20,12
1657547065164,ECE 45,A01,083139,Congero; Spencer William,6,0,75,69
1657547071197,ECE 65,A50,083695,Saad; Andrew S,12,0,30,18
1657547071197,ECE 65,A51,095125,Saad; Andrew S,24,0,26,2
1657547077224,ECE 109,A01,091882,Touri; Behrouz,19,0,70,51
1657547083256,ECE 180,A00,083140,Abi Samra; Nicholas Camill,1,0,30,29
1657547083256,ECE 180,B00,083141,Abi Samra; Nicholas Camill,0,0,30,30
1657547089281,MATH 10A,A01,083735,Patchell; Gregory David,2,0,30,28
1657547089281,MATH 10A,A02,083736,Patchell; Gregory David,20,0,30,10
1657547089281,MATH 10A,A03,083737,Patchell; Gregory David,16,0,30,14
1657547095312,MATH 10B,A01,083207,Lim; Seonhee,8,0,34,26
1657547095312,MATH 10B,A02,083208,Lim; Seonhee,9,0,35,26
1657547095312,MATH 10B,A03,093472,Lim; Seonhee,7,0,34,27
1657547095312,MATH 10B,B01,083739,Sinha; Shubham,12,0,30,18
1657547101339,MATH 18,A01,083743,Cinel; Cameron Alexander,7,0,30,23
1657547101339,MATH 18,A02,083744,Cinel; Cameron Alexander,17,0,30,13
1657547101339,MATH 18,A03,083745,Cinel; Cameron Alexander,9,0,30,21
1657547101339,MATH 18,B01,083748,Rideout; David Porter,5,0,37,32
1657547101339,MATH 18,B02,083749,Rideout; David Porter,5,0,36,31
1657547101339,MATH 18,B03,083750,Rideout; David Porter,3,0,37,34
1657547101339,MATH 18,B04,083751,Rideout; David Porter,6,0,36,30
1657547101339,MATH 18,B05,093473,Rideout; David Porter,6,0,36,30
1657547101339,MATH 18,B06,093474,Rideout; David Porter,6,0,36,30
1657547107362,MATH 20A,A01,083754,Zheng; Zequn,14,0,40,26
1657547113386,MATH 20B,A01,083756,Briones; Jor-el Thomas Caparas,4,0,36,32
1657547113386,MATH 20B,A02,083757,Briones; Jor-el Thomas Caparas,1,0,36,35
1657547113386,MATH 20B,A03,093475,Briones; Jor-el Thomas Caparas,2,0,36,34
1657547119415,MATH 20C,A01,083760,Briones; Jor-el Thomas Caparas,1,0,35,34
1657547119415,MATH 20C,A02,083761,Briones; Jor-el Thomas Caparas,8,0,35,27
1657547119415,MATH 20C,A03,093476,Briones; Jor-el Thomas Caparas,0,1,36,36
1657547119415,MATH 20C,B01,083762,Bach; Quang Tran,1,0,30,29
1657547125439,MATH 20D,A01,083765,Tran; Brian Kha,5,0,30,25
1657547125439,MATH 20D,A02,083766,Tran; Brian Kha,5,0,30,25
1657547125439,MATH 20D,A03,083767,Tran; Brian Kha,5,0,30,25
1657547131462,MATH 20E,A01,083771,Ganguly; Soumya,9,0,32,23
1657547131462,MATH 20E,A02,083772,Ganguly; Soumya,6,0,32,26
1657547131462,MATH 20E,B01,083773,Ciotti; Benjamin,20,0,35,15
1657547131462,MATH 20E,B02,083774,Ciotti; Benjamin,17,0,35,18
1657547137493,MATH 103A,A01,083777,Greenfeld; Be'Eri,3,0,36,33
1657547137493,MATH 103A,A02,083778,Greenfeld; Be'Eri,5,0,36,31
1657547137493,MATH 103A,A03,093561,Greenfeld; Be'Eri,5,0,36,31
1657547137493,MATH 103A,B01,083779,Greenfeld; Be'Eri,7,0,36,29
1657547137493,MATH 103A,B02,083780,Greenfeld; Be'Eri,4,0,36,32
1657547137493,MATH 103A,B03,093562,Greenfeld; Be'Eri,3,0,36,33
1657547143522,MATH 105,A01,085443,Carter; Anne Toulson,15,0,35,20
1657547143522,MATH 105,A02,093477,Carter; Anne Toulson,20,0,35,15
1657547149550,MATH 109,A01,083213,Ganzberger; Geoffrey Michael,2,0,34,32
1657547149550,MATH 109,A02,083214,Ganzberger; Geoffrey Michael,4,0,34,30
1657547149550,MATH 109,A03,093478,Ganzberger; Geoffrey Michael,2,0,34,32
1657547149550,MATH 109,B01,083215,Ganzberger; Geoffrey Michael,1,0,32,31
1657547149550,MATH 109,B02,083216,Ganzberger; Geoffrey Michael,2,0,32,30
1657547149550,MATH 109,B03,093479,Ganzberger; Geoffrey Michael,8,0,32,24
1657547155577,MATH 142A,A01,083219,Chow; Bennett,7,0,32,25
1657547155577,MATH 142A,A02,083220,Chow; Bennett,10,0,32,22
1657547155577,MATH 142A,A03,093480,Chow; Bennett,8,0,32,24
1657547155577,MATH 142A,B03,093481,Chow; Bennett,8,0,32,24
1657547155577,MATH 142A,B04,093558,Chow; Bennett,13,0,32,19
1657547155577,MATH 142A,B05,093559,Chow; Bennett,6,0,32,26
1657547161602,MATH 193A,A01,083224,Rotar; Vladimir,8,0,34,26
1657547161602,MATH 193A,A02,083225,Rotar; Vladimir,9,0,34,25
1657547161602,MATH 193A,A03,083781,Rotar; Vladimir,5,0,34,29
1657547161602,MATH 193A,A04,083782,Rotar; Vladimir,10,0,34,24
1657547161602,MATH 193A,A05,093482,Rotar; Vladimir,10,0,34,24
1657547167635,MATH 197,001,091859,McAuley; Julian John,9999,0,9999,0
1657547167635,MATH 197,002,095566,Kedlaya; Kiran S.,9997,0,9999,2
1657547167635,MATH 197,003,095567,Xiao; Ming,9999,0,9999,0
1657547167635,MATH 197,004,095571,Perols; Johan Lars,9998,0,9999,1
1657547174698,COGS 9,A01,083615,Shannon; Kyle Michael,9,0,75,66
1657547180724,COGS 11,A01,083617,Boyle; Mary E. T.,22,0,48,26
1657547186748,COGS 13,A01,083071,Bastos; Amalia Pinkusfeld,11,0,71,60
1657547192774,COGS 14A,A01,092681,Semenuks; Arturs,5,1,100,95
1657547198798,COGS 14B,A01,083073,Cheng; Tzu-Han,6,0,63,57
1657547204826,COGS 17,A01,092677,Semenuks; Arturs,6,0,81,75
1657547210855,COGS 100,A01,083619,Allen; Michael Gordon,17,0,70,53
1657547216883,COGS 101A,A01,083621,Davis; Joshua Daniel,9,0,68,59
1657547222911,COGS 101B,A01,091572,Allen; Michael Gordon,12,0,65,53
1657547228944,COGS 101C,A01,083625,Delgado; Tania,17,0,35,18
1657547234969,COGS 107A,A01,083627,Boyle; Mary E. T.,13,0,60,47
1657547240997,COGS 118A,A01,083075,Gupta; Anjum,21,0,76,55
1657547247026,CSE 3,A50,083646,Miranda; Gregory Joseph,24,0,50,26
1657547253051,CSE 8A,A50,083650,Miranda; Gregory Joseph,17,1,56,39
1657547259076,CSE 11,A01,083080,Cao; Yingjun,6,15,40,34
1657547265171,CSE 12,A01,083652,Krause-Levy; Sophia Louisa,28,1,120,92
1657547271202,CSE 15L,A01,083654,Morris; Justin Loren,9,0,50,41
1657547271202,CSE 15L,A02,083655,Morris; Justin Loren,9,0,50,41
1657547277227,CSE 20,A01,083657,Tran; Khoa Dang,39,0,80,41
1657547283254,CSE 21,A01,095574,Bach; Quang Tran,22,0,48,26
1657547289281,CSE 30,A01,083084,Eldon; John,5,0,80,75
1657547289281,CSE 30,B01,095061,Bhaskar; Nishant,9,0,50,41
1657547295304,CSE 100,A01,083659,Cao; Yingjun,5,4,70,65
1657547301327,CSE 134B,A01,083661,Powell; Thomas Allan,22,0,100,78
1657547307349,CSE 140,A01,083663,Gungor; Onat,15,0,85,70
1657547313373,CSE 140L,A01,083088,Eldon; John,21,0,100,79
1657547319398,CSE 175,A01,083665,Kumar; Rakesh,3,0,25,22
1657547325425,CSE 190,A00,092507,Dubnov; Shlomo,8,0,20,12
1657547331453,ECE 45,A01,083139,Congero; Spencer William,6,0,75,69
1657547337481,ECE 65,A50,083695,Saad; Andrew S,12,0,30,18
1657547337481,ECE 65,A51,095125,Saad; Andrew S,24,0,26,2
1657547343508,ECE 109,A01,091882,Touri; Behrouz,19,0,70,51
1657547349536,ECE 180,A00,083140,Abi Samra; Nicholas Camill,1,0,30,29
1657547349536,ECE 180,B00,083141,Abi Samra; Nicholas Camill,0,0,30,30
1657547355561,MATH 10A,A01,083735,Patchell; Gregory David,2,0,30,28
1657547355561,MATH 10A,A02,083736,Patchell; Gregory David,20,0,30,10
1657547355561,MATH 10A,A03,083737,Patchell; Gregory David,16,0,30,14
1657547361595,MATH 10B,A01,083207,Lim; Seonhee,8,0,34,26
1657547361595,MATH 10B,A02,083208,Lim; Seonhee,9,0,35,26
1657547361595,MATH 10B,A03,093472,Lim; Seonhee,7,0,34,27
1657547361595,MATH 10B,B01,083739,Sinha; Shubham,12,0,30,18
1657547367622,MATH 18,A01,083743,Cinel; Cameron Alexander,7,0,30,23
1657547367622,MATH 18,A02,083744,Cinel; Cameron Alexander,17,0,30,13
1657547367622,MATH 18,A03,083745,Cinel; Cameron Alexander,9,0,30,21
1657547367622,MATH 18,B01,083748,Rideout; David Porter,5,0,37,32
1657547367622,MATH 18,B02,083749,Rideout; David Porter,5,0,36,31
1657547367622,MATH 18,B03,083750,Rideout; David Porter,3,0,37,34
1657547367622,MATH 18,B04,083751,Rideout; David Porter,6,0,36,30
1657547367622,MATH 18,B05,093473,Rideout; David Porter,6,0,36,30
1657547367622,MATH 18,B06,093474,Rideout; David Porter,6,0,36,30
1657547373649,MATH 20A,A01,083754,Zheng; Zequn,14,0,40,26
1657547379676,MATH 20B,A01,083756,Briones; Jor-el Thomas Caparas,4,0,36,32
1657547379676,MATH 20B,A02,083757,Briones; Jor-el Thomas Caparas,1,0,36,35
1657547379676,MATH 20B,A03,093475,Briones; Jor-el Thomas Caparas,2,0,36,34
1657547385701,MATH 20C,A01,083760,Briones; Jor-el Thomas Caparas,1,0,35,34
1657547385701,MATH 20C,A02,083761,Briones; Jor-el Thomas Caparas,8,0,35,27
1657547385701,MATH 20C,A03,093476,Briones; Jor-el Thomas Caparas,0,1,36,36
1657547385701,MATH 20C,B01,083762,Bach; Quang Tran,1,0,30,29
1657547391731,MATH 20D,A01,083765,Tran; Brian Kha,5,0,30,25
1657547391731,MATH 20D,A02,083766,Tran; Brian Kha,5,0,30,25
1657547391731,MATH 20D,A03,083767,Tran; Brian Kha,5,0,30,25
1657547397768,MATH 20E,A01,083771,Ganguly; Soumya,9,0,32,23
1657547397768,MATH 20E,A02,083772,Ganguly; Soumya,6,0,32,26
1657547397768,MATH 20E,B01,083773,Ciotti; Benjamin,20,0,35,15
1657547397768,MATH 20E,B02,083774,Ciotti; Benjamin,17,0,35,18
1657547403799,MATH 103A,A01,083777,Greenfeld; Be'Eri,3,0,36,33
1657547403799,MATH 103A,A02,083778,Greenfeld; Be'Eri,5,0,36,31
1657547403799,MATH 103A,A03,093561,Greenfeld; Be'Eri,5,0,36,31
1657547403799,MATH 103A,B01,083779,Greenfeld; Be'Eri,7,0,36,29
1657547403799,MATH 103A,B02,083780,Greenfeld; Be'Eri,4,0,36,32
1657547403799,MATH 103A,B03,093562,Greenfeld; Be'Eri,3,0,36,33
1657547409824,MATH 105,A01,085443,Carter; Anne Toulson,15,0,35,20
1657547409824,MATH 105,A02,093477,Carter; Anne Toulson,20,0,35,15
1657547415862,MATH 109,A01,083213,Ganzberger; Geoffrey Michael,2,0,34,32
1657547415862,MATH 109,A02,083214,Ganzberger; Geoffrey Michael,4,0,34,30
1657547415862,MATH 109,A03,093478,Ganzberger; Geoffrey Michael,2,0,34,32
1657547415862,MATH 109,B01,083215,Ganzberger; Geoffrey Michael,1,0,32,31
1657547415862,MATH 109,B02,083216,Ganzberger; Geoffrey Michael,2,0,32,30
1657547415862,MATH 109,B03,093479,Ganzberger; Geoffrey Michael,8,0,32,24
1657547421894,MATH 142A,A01,083219,Chow; Bennett,7,0,32,25
1657547421894,MATH 142A,A02,083220,Chow; Bennett,10,0,32,22
1657547421894,MATH 142A,A03,093480,Chow; Bennett,8,0,32,24
1657547421894,MATH 142A,B03,093481,Chow; Bennett,8,0,32,24
1657547421894,MATH 142A,B04,093558,Chow; Bennett,13,0,32,19
1657547421894,MATH 142A,B05,093559,Chow; Bennett,6,0,32,26
1657547427920,MATH 193A,A01,083224,Rotar; Vladimir,8,0,34,26
1657547427920,MATH 193A,A02,083225,Rotar; Vladimir,9,0,34,25
1657547427920,MATH 193A,A03,083781,Rotar; Vladimir,5,0,34,29
1657547427920,MATH 193A,A04,083782,Rotar; Vladimir,10,0,34,24
1657547427920,MATH 193A,A05,093482,Rotar; Vladimir,10,0,34,24
1657547433945,MATH 197,001,091859,McAuley; Julian John,9999,0,9999,0
1657547433945,MATH 197,002,095566,Kedlaya; Kiran S.,9997,0,9999,2
1657547433945,MATH 197,003,095567,Xiao; Ming,9999,0,9999,0
1657547433945,MATH 197,004,095571,Perols; Johan Lars,9998,0,9999,1
1657547440998,COGS 9,A01,083615,Shannon; Kyle Michael,9,0,75,66
1657547447023,COGS 11,A01,083617,Boyle; Mary E. T.,22,0,48,26
1657547453048,COGS 13,A01,083071,Bastos; Amalia Pinkusfeld,11,0,71,60
1657547459080,COGS 14A,A01,092681,Semenuks; Arturs,5,1,100,95
1657547465108,COGS 14B,A01,083073,Cheng; Tzu-Han,6,0,63,57
1657547471132,COGS 17,A01,092677,Semenuks; Arturs,6,0,81,75
1657547477160,COGS 100,A01,083619,Allen; Michael Gordon,17,0,70,53
1657547483185,COGS 101A,A01,083621,Davis; Joshua Daniel,9,0,68,59
1657547489209,COGS 101B,A01,091572,Allen; Michael Gordon,12,0,65,53
1657547495255,COGS 101C,A01,083625,Delgado; Tania,17,0,35,18
1657547501279,COGS 107A,A01,083627,Boyle; Mary E. T.,13,0,60,47
1657547507309,COGS 118A,A01,083075,Gupta; Anjum,21,0,76,55
1657547513339,CSE 3,A50,083646,Miranda; Gregory Joseph,24,0,50,26
1657547519363,CSE 8A,A50,083650,Miranda; Gregory Joseph,17,1,56,39
1657547525387,CSE 11,A01,083080,Cao; Yingjun,6,15,40,34
1657547531411,CSE 12,A01,083652,Krause-Levy; Sophia Louisa,28,1,120,92
1657547537438,CSE 15L,A01,083654,Morris; Justin Loren,9,0,50,41
1657547537438,CSE 15L,A02,083655,Morris; Justin Loren,9,0,50,41
1657547543466,CSE 20,A01,083657,Tran; Khoa Dang,39,0,80,41
1657547549495,CSE 21,A01,095574,Bach; Quang Tran,22,0,48,26
1657547555531,CSE 30,A01,083084,Eldon; John,5,0,80,75
1657547555531,CSE 30,B01,095061,Bhaskar; Nishant,9,0,50,41
1657547561556,CSE 100,A01,083659,Cao; Yingjun,5,4,70,65
1657547567580,CSE 134B,A01,083661,Powell; Thomas Allan,22,0,100,78
1657547573606,CSE 140,A01,083663,Gungor; Onat,15,0,85,70
1657547579633,CSE 140L,A01,083088,Eldon; John,21,0,100,79
1657547585658,CSE 175,A01,083665,Kumar; Rakesh,3,0,25,22
1657547591687,CSE 190,A00,092507,Dubnov; Shlomo,8,0,20,12
1657547597709,ECE 45,A01,083139,Congero; Spencer William,6,0,75,69
1657547603734,ECE 65,A50,083695,Saad; Andrew S,12,0,30,18
1657547603734,ECE 65,A51,095125,Saad; Andrew S,24,0,26,2
1657547609761,ECE 109,A01,091882,Touri; Behrouz,19,0,70,51
1657547615806,ECE 180,A00,083140,Abi Samra; Nicholas Camill,1,0,30,29
1657547615806,ECE 180,B00,083141,Abi Samra; Nicholas Camill,0,0,30,30
1657547621837,MATH 10A,A01,083735,Patchell; Gregory David,2,0,30,28
1657547621837,MATH 10A,A02,083736,Patchell; Gregory David,20,0,30,10
1657547621837,MATH 10A,A03,083737,Patchell; Gregory David,16,0,30,14
1657547627863,MATH 10B,A01,083207,Lim; Seonhee,8,0,34,26
1657547627863,MATH 10B,A02,083208,Lim; Seonhee,9,0,35,26
1657547627863,MATH 10B,A03,093472,Lim; Seonhee,7,0,34,27
1657547627863,MATH 10B,B01,083739,Sinha; Shubham,12,0,30,18
1657547633894,MATH 18,A01,083743,Cinel; Cameron Alexander,7,0,30,23
1657547633894,MATH 18,A02,083744,Cinel; Cameron Alexander,17,0,30,13
1657547633894,MATH 18,A03,083745,Cinel; Cameron Alexander,9,0,30,21
1657547633894,MATH 18,B01,083748,Rideout; David Porter,5,0,37,32
1657547633894,MATH 18,B02,083749,Rideout; David Porter,5,0,36,31
1657547633894,MATH 18,B03,083750,Rideout; David Porter,3,0,37,34
1657547633894,MATH 18,B04,083751,Rideout; David Porter,6,0,36,30
1657547633894,MATH 18,B05,093473,Rideout; David Porter,6,0,36,30
1657547633894,MATH 18,B06,093474,Rideout; David Porter,6,0,36,30
1657547639923,MATH 20A,A01,083754,Zheng; Zequn,14,0,40,26
1657547645953,MATH 20B,A01,083756,Briones; Jor-el Thomas Caparas,4,0,36,32
1657547645953,MATH 20B,A02,083757,Briones; Jor-el Thomas Caparas,1,0,36,35
1657547645953,MATH 20B,A03,093475,Briones; Jor-el Thomas Caparas,2,0,36,34
1657547651979,MATH 20C,A01,083760,Briones; Jor-el Thomas Caparas,1,0,35,34
1657547651979,MATH 20C,A02,083761,Briones; Jor-el Thomas Caparas,8,0,35,27
1657547651979,MATH 20C,A03,093476,Briones; Jor-el Thomas Caparas,0,1,36,36
1657547651979,MATH 20C,B01,083762,Bach; Quang Tran,1,0,30,29
1657547658008,MATH 20D,A01,083765,Tran; Brian Kha,5,0,30,25
1657547658008,MATH 20D,A02,083766,Tran; Brian Kha,5,0,30,25
1657547658008,MATH 20D,A03,083767,Tran; Brian Kha,5,0,30,25
1657547664035,MATH 20E,A01,083771,Ganguly; Soumya,9,0,32,23
1657547664035,MATH 20E,A02,083772,Ganguly; Soumya,6,0,32,26
1657547664035,MATH 20E,B01,083773,Ciotti; Benjamin,20,0,35,15
1657547664035,MATH 20E,B02,083774,Ciotti; Benjamin,17,0,35,18
1657547670061,MATH 103A,A01,083777,Greenfeld; Be'Eri,3,0,36,33
1657547670061,MATH 103A,A02,083778,Greenfeld; Be'Eri,5,0,36,31
1657547670061,MATH 103A,A03,093561,Greenfeld; Be'Eri,5,0,36,31
1657547670061,MATH 103A,B01,083779,Greenfeld; Be'Eri,7,0,36,29
1657547670061,MATH 103A,B02,083780,Greenfeld; Be'Eri,4,0,36,32
1657547670061,MATH 103A,B03,093562,Greenfeld; Be'Eri,3,0,36,33
1657547676087,MATH 105,A01,085443,Carter; Anne Toulson,15,0,35,20
1657547676087,MATH 105,A02,093477,Carter; Anne Toulson,20,0,35,15
1657547682117,MATH 109,A01,083213,Ganzberger; Geoffrey Michael,2,0,34,32
1657547682117,MATH 109,A02,083214,Ganzberger; Geoffrey Michael,4,0,34,30
1657547682117,MATH 109,A03,093478,Ganzberger; Geoffrey Michael,2,0,34,32
1657547682117,MATH 109,B01,083215,Ganzberger; Geoffrey Michael,1,0,32,31
1657547682117,MATH 109,B02,083216,Ganzberger; Geoffrey Michael,2,0,32,30
1657547682117,MATH 109,B03,093479,Ganzberger; Geoffrey Michael,8,0,32,24
1657547688144,MATH 142A,A01,083219,Chow; Bennett,7,0,32,25
1657547688144,MATH 142A,A02,083220,Chow; Bennett,10,0,32,22
1657547688144,MATH 142A,A03,093480,Chow; Bennett,8,0,32,24
1657547688144,MATH 142A,B03,093481,Chow; Bennett,8,0,32,24
1657547688144,MATH 142A,B04,093558,Chow; Bennett,13,0,32,19
1657547688144,MATH 142A,B05,093559,Chow; Bennett,6,0,32,26
1657547694175,MATH 193A,A01,083224,Rotar; Vladimir,8,0,34,26
1657547694175,MATH 193A,A02,083225,Rotar; Vladimir,9,0,34,25
1657547694175,MATH 193A,A03,083781,Rotar; Vladimir,5,0,34,29
1657547694175,MATH 193A,A04,083782,Rotar; Vladimir,10,0,34,24
1657547694175,MATH 193A,A05,093482,Rotar; Vladimir,10,0,34,24
1657547700199,MATH 197,001,091859,McAuley; Julian John,9999,0,9999,0
1657547700199,MATH 197,002,095566,Kedlaya; Kiran S.,9997,0,9999,2
1657547700199,MATH 197,003,095567,Xiao; Ming,9999,0,9999,0
1657547700199,MATH 197,004,095571,Perols; Johan Lars,9998,0,9999,1
1657547707253,COGS 9,A01,083615,Shannon; Kyle Michael,9,0,75,66
1657547713276,COGS 11,A01,083617,Boyle; Mary E. T.,22,0,48,26
1657547719298,COGS 13,A01,083071,Bastos; Amalia Pinkusfeld,11,0,71,60
1657547725325,COGS 14A,A01,092681,Semenuks; Arturs,5,1,100,95
1657547731354,COGS 14B,A01,083073,Cheng; Tzu-Han,6,0,63,57
1657547737380,COGS 17,A01,092677,Semenuks; Arturs,6,0,81,75
1657547743417,COGS 100,A01,083619,Allen; Michael Gordon,17,0,70,53
1657547749442,COGS 101A,A01,083621,Davis; Joshua Daniel,9,0,68,59
1657547755465,COGS 101B,A01,091572,Allen; Michael Gordon,12,0,65,53
1657547761494,COGS 101C,A01,083625,Delgado; Tania,17,0,35,18
1657547767517,COGS 107A,A01,083627,Boyle; Mary E. T.,13,0,60,47
1657547773542,COGS 118A,A01,083075,Gupta; Anjum,21,0,76,55
1657547779566,CSE 3,A50,083646,Miranda; Gregory Joseph,24,0,50,26
1657547785593,CSE 8A,A50,083650,Miranda; Gregory Joseph,17,1,56,39
1657547791619,CSE 11,A01,083080,Cao; Yingjun,6,15,40,34
1657547797647,CSE 12,A01,083652,Krause-Levy; Sophia Louisa,28,1,120,92
1657547803674,CSE 15L,A01,083654,Morris; Justin Loren,9,0,50,41
1657547803674,CSE 15L,A02,083655,Morris; Justin Loren,9,0,50,41
1657547809699,CSE 20,A01,083657,Tran; Khoa Dang,39,0,80,41
1657547815724,CSE 21,A01,095574,Bach; Quang Tran,22,0,48,26
1657547821748,CSE 30,A01,083084,Eldon; John,5,0,80,75
1657547821748,CSE 30,B01,095061,Bhaskar; Nishant,9,0,50,41
1657547827776,CSE 100,A01,083659,Cao; Yingjun,5,4,70,65
1657547833798,CSE 134B,A01,083661,Powell; Thomas Allan,22,0,100,78
1657547839822,CSE 140,A01,083663,Gungor; Onat,15,0,85,70
1657547845854,CSE 140L,A01,083088,Eldon; John,21,0,100,79
1657547851880,CSE 175,A01,083665,Kumar; Rakesh,3,0,25,22
1657547857905,CSE 190,A00,092507,Dubnov; Shlomo,8,0,20,12
1657547864003,ECE 45,A01,083139,Congero; Spencer William,6,0,75,69
1657547870028,ECE 65,A50,083695,Saad; Andrew S,12,0,30,18
1657547870028,ECE 65,A51,095125,Saad; Andrew S,24,0,26,2
1657547876052,ECE 109,A01,091882,Touri; Behrouz,19,0,70,51
1657547882076,ECE 180,A00,083140,Abi Samra; Nicholas Camill,1,0,30,29
1657547882076,ECE 180,B00,083141,Abi Samra; Nicholas Camill,0,0,30,30
1657547888106,MATH 10A,A01,083735,Patchell; Gregory David,2,0,30,28
1657547888106,MATH 10A,A02,083736,Patchell; Gregory David,20,0,30,10
1657547888106,MATH 10A,A03,083737,Patchell; Gregory David,16,0,30,14
1657547894137,MATH 10B,A01,083207,Lim; Seonhee,8,0,34,26
1657547894137,MATH 10B,A02,083208,Lim; Seonhee,9,0,35,26
1657547894137,MATH 10B,A03,093472,Lim; Seonhee,7,0,34,27
1657547894137,MATH 10B,B01,083739,Sinha; Shubham,12,0,30,18
1657547900170,MATH 18,A01,083743,Cinel; Cameron Alexander,7,0,30,23
1657547900170,MATH 18,A02,083744,Cinel; Cameron Alexander,17,0,30,13
1657547900170,MATH 18,A03,083745,Cinel; Cameron Alexander,9,0,30,21
1657547900170,MATH 18,B01,083748,Rideout; David Porter,5,0,37,32
1657547900170,MATH 18,B02,083749,Rideout; David Porter,5,0,36,31
1657547900170,MATH 18,B03,083750,Rideout; David Porter,3,0,37,34
1657547900170,MATH 18,B04,083751,Rideout; David Porter,6,0,36,30
1657547900170,MATH 18,B05,093473,Rideout; David Porter,6,0,36,30
1657547900170,MATH 18,B06,093474,Rideout; David Porter,6,0,36,30
1657547906196,MATH 20A,A01,083754,Zheng; Zequn,14,0,40,26
1657547912220,MATH 20B,A01,083756,Briones; Jor-el Thomas Caparas,4,0,36,32
1657547912220,MATH 20B,A02,083757,Briones; Jor-el Thomas Caparas,1,0,36,35
1657547912220,MATH 20B,A03,093475,Briones; Jor-el Thomas Caparas,2,0,36,34
1657547918245,MATH 20C,A01,083760,Briones; Jor-el Thomas Caparas,1,0,35,34
1657547918245,MATH 20C,A02,083761,Briones; Jor-el Thomas Caparas,8,0,35,27
1657547918245,MATH 20C,A03,093476,Briones; Jor-el Thomas Caparas,0,1,36,36
1657547918245,MATH 20C,B01,083762,Bach; Quang Tran,1,0,30,29
1657547924275,MATH 20D,A01,083765,Tran; Brian Kha,5,0,30,25
1657547924275,MATH 20D,A02,083766,Tran; Brian Kha,5,0,30,25
1657547924275,MATH 20D,A03,083767,Tran; Brian Kha,5,0,30,25
1657547930304,MATH 20E,A01,083771,Ganguly; Soumya,9,0,32,23
1657547930304,MATH 20E,A02,083772,Ganguly; Soumya,6,0,32,26
1657547930304,MATH 20E,B01,083773,Ciotti; Benjamin,20,0,35,15
1657547930304,MATH 20E,B02,083774,Ciotti; Benjamin,17,0,35,18
1657547936336,MATH 103A,A01,083777,Greenfeld; Be'Eri,3,0,36,33
1657547936336,MATH 103A,A02,083778,Greenfeld; Be'Eri,5,0,36,31
1657547936336,MATH 103A,A03,093561,Greenfeld; Be'Eri,5,0,36,31
1657547936336,MATH 103A,B01,083779,Greenfeld; Be'Eri,7,0,36,29
1657547936336,MATH 103A,B02,083780,Greenfeld; Be'Eri,4,0,36,32
1657547936336,MATH 103A,B03,093562,Greenfeld; Be'Eri,3,0,36,33
1657547942359,MATH 105,A01,085443,Carter; Anne Toulson,15,0,35,20
1657547942359,MATH 105,A02,093477,Carter; Anne Toulson,20,0,35,15
1657547948383,MATH 109,A01,083213,Ganzberger; Geoffrey Michael,2,0,34,32
1657547948383,MATH 109,A02,083214,Ganzberger; Geoffrey Michael,4,0,34,30
1657547948383,MATH 109,A03,093478,Ganzberger; Geoffrey Michael,2,0,34,32
1657547948383,MATH 109,B01,083215,Ganzberger; Geoffrey Michael,1,0,32,31
1657547948383,MATH 109,B02,083216,Ganzberger; Geoffrey Michael,2,0,32,30
1657547948383,MATH 109,B03,093479,Ganzberger; Geoffrey Michael,8,0,32,24
1657547954409,MATH 142A,A01,083219,Chow; Bennett,7,0,32,25
1657547954409,MATH 142A,A02,083220,Chow; Bennett,10,0,32,22
1657547954409,MATH 142A,A03,093480,Chow; Bennett,8,0,32,24
1657547954409,MATH 142A,B03,093481,Chow; Bennett,8,0,32,24
1657547954409,MATH 142A,B04,093558,Chow; Bennett,13,0,32,19
1657547954409,MATH 142A,B05,093559,Chow; Bennett,6,0,32,26
1657547960434,MATH 193A,A01,083224,Rotar; Vladimir,8,0,34,26
1657547960434,MATH 193A,A02,083225,Rotar; Vladimir,9,0,34,25
1657547960434,MATH 193A,A03,083781,Rotar; Vladimir,5,0,34,29
1657547960434,MATH 193A,A04,083782,Rotar; Vladimir,10,0,34,24
1657547960434,MATH 193A,A05,093482,Rotar; Vladimir,10,0,34,24
1657547966461,MATH 197,001,091859,McAuley; Julian John,9999,0,9999,0
1657547966461,MATH 197,002,095566,Kedlaya; Kiran S.,9997,0,9999,2
1657547966461,MATH 197,003,095567,Xiao; Ming,9999,0,9999,0
1657547966461,MATH 197,004,095571,Perols; Johan Lars,9998,0,9999,1
1657547973518,COGS 9,A01,083615,Shannon; Kyle Michael,9,0,75,66
1657547979543,COGS 11,A01,083617,Boyle; Mary E. T.,22,0,48,26
1657547985578,COGS 13,A01,083071,Bastos; Amalia Pinkusfeld,11,0,71,60
1657547991603,COGS 14A,A01,092681,Semenuks; Arturs,5,1,100,95
1657547997632,COGS 14B,A01,083073,Cheng; Tzu-Han,6,0,63,57
1657548003656,COGS 17,A01,092677,Semenuks; Arturs,6,0,81,75
1657548009683,COGS 100,A01,083619,Allen; Michael Gordon,17,0,70,53
1657548015710,COGS 101A,A01,083621,Davis; Joshua Daniel,9,0,68,59
1657548021734,COGS 101B,A01,091572,Allen; Michael Gordon,12,0,65,53
1657548027758,COGS 101C,A01,083625,Delgado; Tania,17,0,35,18
1657548033782,COGS 107A,A01,083627,Boyle; Mary E. T.,13,0,60,47
1657548039816,COGS 118A,A01,083075,Gupta; Anjum,21,0,76,55
1657548045841,CSE 3,A50,083646,Miranda; Gregory Joseph,24,0,50,26
1657548051870,CSE 8A,A50,083650,Miranda; Gregory Joseph,17,1,56,39
1657548057896,CSE 11,A01,083080,Cao; Yingjun,6,15,40,34
1657548063920,CSE 12,A01,083652,Krause-Levy; Sophia Louisa,28,1,120,92
1657548069945,CSE 15L,A01,083654,Morris; Justin Loren,9,0,50,41
1657548069945,CSE 15L,A02,083655,Morris; Justin Loren,9,0,50,41
1657548075972,CSE 20,A01,083657,Tran; Khoa Dang,39,0,80,41
1657548081999,CSE 21,A01,095574,Bach; Quang Tran,22,0,48,26
1657548088023,CSE 30,A01,083084,Eldon; John,5,0,80,75
1657548088023,CSE 30,B01,095061,Bhaskar; Nishant,9,0,50,41
1657548094046,CSE 100,A01,083659,Cao; Yingjun,5,4,70,65
1657548100070,CSE 134B,A01,083661,Powell; Thomas Allan,22,0,100,78
1657548106102,CSE 140,A01,083663,Gungor; Onat,15,0,85,70
1657548112136,CSE 140L,A01,083088,Eldon; John,21,0,100,79
1657548118164,CSE 175,A01,083665,Kumar; Rakesh,3,0,25,22
1657548124193,CSE 190,A00,092507,Dubnov; Shlomo,8,0,20,12
1657548130224,ECE 45,A01,083139,Congero; Spencer William,6,0,75,69
1657548136256,ECE 65,A50,083695,Saad; Andrew S,12,0,30,18
1657548136256,ECE 65,A51,095125,Saad; Andrew S,24,0,26,2
1657548142284,ECE 109,A01,091882,Touri; Behrouz,19,0,70,51
1657548148311,ECE 180,A00,083140,Abi Samra; Nicholas Camill,1,0,30,29
1657548148311,ECE 180,B00,083141,Abi Samra; Nicholas Camill,0,0,30,30
1657548154347,MATH 10A,A01,083735,Patchell; Gregory David,2,0,30,28
1657548154347,MATH 10A,A02,083736,Patchell; Gregory David,20,0,30,10
1657548154347,MATH 10A,A03,083737,Patchell; Gregory David,16,0,30,14
1657548160370,MATH 10B,A01,083207,Lim; Seonhee,8,0,34,26
1657548160370,MATH 10B,A02,083208,Lim; Seonhee,9,0,35,26
1657548160370,MATH 10B,A03,093472,Lim; Seonhee,7,0,34,27
1657548160370,MATH 10B,B01,083739,Sinha; Shubham,12,0,30,18
1657548166400,MATH 18,A01,083743,Cinel; Cameron Alexander,7,0,30,23
1657548166400,MATH 18,A02,083744,Cinel; Cameron Alexander,17,0,30,13
1657548166400,MATH 18,A03,083745,Cinel; Cameron Alexander,9,0,30,21
1657548166400,MATH 18,B01,083748,Rideout; David Porter,5,0,37,32
1657548166400,MATH 18,B02,083749,Rideout; David Porter,5,0,36,31
1657548166400,MATH 18,B03,083750,Rideout; David Porter,3,0,37,34
1657548166400,MATH 18,B04,083751,Rideout; David Porter,6,0,36,30
1657548166400,MATH 18,B05,093473,Rideout; David Porter,6,0,36,30
1657548166400,MATH 18,B06,093474,Rideout; David Porter,6,0,36,30
1657548172426,MATH 20A,A01,083754,Zheng; Zequn,14,0,40,26
1657548178450,MATH 20B,A01,083756,Briones; Jor-el Thomas Caparas,4,0,36,32
1657548178450,MATH 20B,A02,083757,Briones; Jor-el Thomas Caparas,1,0,36,35
1657548178450,MATH 20B,A03,093475,Briones; Jor-el Thomas Caparas,2,0,36,34
1657548184474,MATH 20C,A01,083760,Briones; Jor-el Thomas Caparas,1,0,35,34
1657548184474,MATH 20C,A02,083761,Briones; Jor-el Thomas Caparas,8,0,35,27
1657548184474,MATH 20C,A03,093476,Briones; Jor-el Thomas Caparas,0,1,36,36
1657548184474,MATH 20C,B01,083762,Bach; Quang Tran,1,0,30,29
1657548190500,MATH 20D,A01,083765,Tran; Brian Kha,5,0,30,25
1657548190500,MATH 20D,A02,083766,Tran; Brian Kha,5,0,30,25
1657548190500,MATH 20D,A03,083767,Tran; Brian Kha,5,0,30,25
1657548196528,MATH 20E,A01,083771,Ganguly; Soumya,9,0,32,23
1657548196528,MATH 20E,A02,083772,Ganguly; Soumya,6,0,32,26
1657548196528,MATH 20E,B01,083773,Ciotti; Benjamin,20,0,35,15
1657548196528,MATH 20E,B02,083774,Ciotti; Benjamin,17,0,35,18
1657548202557,MATH 103A,A01,083777,Greenfeld; Be'Eri,3,0,36,33
1657548202557,MATH 103A,A02,083778,Greenfeld; Be'Eri,5,0,36,31
1657548202557,MATH 103A,A03,093561,Greenfeld; Be'Eri,5,0,36,31
1657548202557,MATH 103A,B01,083779,Greenfeld; Be'Eri,7,0,36,29
1657548202557,MATH 103A,B02,083780,Greenfeld; Be'Eri,4,0,36,32
1657548202557,MATH 103A,B03,093562,Greenfeld; Be'Eri,3,0,36,33
1657548208582,MATH 105,A01,085443,Carter; Anne Toulson,15,0,35,20
1657548208582,MATH 105,A02,093477,Carter; Anne Toulson,20,0,35,15
1657548214608,MATH 109,A01,083213,Ganzberger; Geoffrey Michael,2,0,34,32
1657548214608,MATH 109,A02,083214,Ganzberger; Geoffrey Michael,4,0,34,30
1657548214608,MATH 109,A03,093478,Ganzberger; Geoffrey Michael,2,0,34,32
1657548214608,MATH 109,B01,083215,Ganzberger; Geoffrey Michael,1,0,32,31
1657548214608,MATH 109,B02,083216,Ganzberger; Geoffrey Michael,2,0,32,30
1657548214608,MATH 109,B03,093479,Ganzberger; Geoffrey Michael,8,0,32,24
1657548220639,MATH 142A,A01,083219,Chow; Bennett,7,0,32,25
1657548220639,MATH 142A,A02,083220,Chow; Bennett,10,0,32,22
1657548220639,MATH 142A,A03,093480,Chow; Bennett,8,0,32,24
1657548220639,MATH 142A,B03,093481,Chow; Bennett,8,0,32,24
1657548220639,MATH 142A,B04,093558,Chow; Bennett,13,0,32,19
1657548220639,MATH 142A,B05,093559,Chow; Bennett,6,0,32,26
1657548226666,MATH 193A,A01,083224,Rotar; Vladimir,8,0,34,26
1657548226666,MATH 193A,A02,083225,Rotar; Vladimir,9,0,34,25
1657548226666,MATH 193A,A03,083781,Rotar; Vladimir,5,0,34,29
1657548226666,MATH 193A,A04,083782,Rotar; Vladimir,10,0,34,24
1657548226666,MATH 193A,A05,093482,Rotar; Vladimir,10,0,34,24
1657548232694,MATH 197,001,091859,McAuley; Julian John,9999,0,9999,0
1657548232694,MATH 197,002,095566,Kedlaya; Kiran S.,9997,0,9999,2
1657548232694,MATH 197,003,095567,Xiao; Ming,9999,0,9999,0
1657548232694,MATH 197,004,095571,Perols; Johan Lars,9998,0,9999,1
1657548239750,COGS 9,A01,083615,Shannon; Kyle Michael,9,0,75,66
1657548245776,COGS 11,A01,083617,Boyle; Mary E. T.,22,0,48,26
1657548251804,COGS 13,A01,083071,Bastos; Amalia Pinkusfeld,11,0,71,60
1657548257828,COGS 14A,A01,092681,Semenuks; Arturs,5,1,100,95
1657548263857,COGS 14B,A01,083073,Cheng; Tzu-Han,6,0,63,57
1657548269883,COGS 17,A01,092677,Semenuks; Arturs,6,0,81,75
1657548275907,COGS 100,A01,083619,Allen; Michael Gordon,17,0,70,53
1657548281936,COGS 101A,A01,083621,Davis; Joshua Daniel,9,0,68,59
1657548287960,COGS 101B,A01,091572,Allen; Michael Gordon,12,0,65,53
1657548293982,COGS 101C,A01,083625,Delgado; Tania,17,0,35,18
1657548300009,COGS 107A,A01,083627,Boyle; Mary E. T.,13,0,60,47
1657548306035,COGS 118A,A01,083075,Gupta; Anjum,21,0,76,55
1657548312062,CSE 3,A50,083646,Miranda; Gregory Joseph,24,0,50,26
1657548318087,CSE 8A,A50,083650,Miranda; Gregory Joseph,17,1,56,39
1657548324110,CSE 11,A01,083080,Cao; Yingjun,6,15,40,34
1657548330137,CSE 12,A01,083652,Krause-Levy; Sophia Louisa,28,1,120,92
1657548336173,CSE 15L,A01,083654,Morris; Justin Loren,9,0,50,41
1657548336173,CSE 15L,A02,083655,Morris; Justin Loren,9,0,50,41
1657548342197,CSE 20,A01,083657,Tran; Khoa Dang,39,0,80,41
1657548348224,CSE 21,A01,095574,Bach; Quang Tran,22,0,48,26
1657548354249,CSE 30,A01,083084,Eldon; John,5,0,80,75
1657548354249,CSE 30,B01,095061,Bhaskar; Nishant,9,0,50,41
1657548360280,CSE 100,A01,083659,Cao; Yingjun,5,4,70,65
1657548366311,CSE 134B,A01,083661,Powell; Thomas Allan,22,0,100,78
1657548372339,CSE 140,A01,083663,Gungor; Onat,15,0,85,70
1657548378365,CSE 140L,A01,083088,Eldon; John,21,0,100,79
1657548384391,CSE 175,A01,083665,Kumar; Rakesh,3,0,25,22
1657548390431,CSE 190,A00,092507,Dubnov; Shlomo,8,0,20,12
1657548396460,ECE 45,A01,083139,Congero; Spencer William,6,0,75,69
1657548402486,ECE 65,A50,083695,Saad; Andrew S,12,0,30,18
1657548402486,ECE 65,A51,095125,Saad; Andrew S,24,0,26,2
1657548408514,ECE 109,A01,091882,Touri; Behrouz,19,0,70,51
1657548414542,ECE 180,A00,083140,Abi Samra; Nicholas Camill,1,0,30,29
1657548414542,ECE 180,B00,083141,Abi Samra; Nicholas Camill,0,0,30,30
1657548420579,MATH 10A,A01,083735,Patchell; Gregory David,2,0,30,28
1657548420579,MATH 10A,A02,083736,Patchell; Gregory David,20,0,30,10
1657548420579,MATH 10A,A03,083737,Patchell; Gregory David,16,0,30,14
1657548426606,MATH 10B,A01,083207,Lim; Seonhee,8,0,34,26
1657548426606,MATH 10B,A02,083208,Lim; Seonhee,9,0,35,26
1657548426606,MATH 10B,A03,093472,Lim; Seonhee,7,0,34,27
1657548426606,MATH 10B,B01,083739,Sinha; Shubham,12,0,30,18
1657548432632,MATH 18,A01,083743,Cinel; Cameron Alexander,7,0,30,23
1657548432632,MATH 18,A02,083744,Cinel; Cameron Alexander,17,0,30,13
1657548432632,MATH 18,A03,083745,Cinel; Cameron Alexander,9,0,30,21
1657548432632,MATH 18,B01,083748,Rideout; David Porter,5,0,37,32
1657548432632,MATH 18,B02,083749,Rideout; David Porter,5,0,36,31
1657548432632,MATH 18,B03,083750,Rideout; David Porter,3,0,37,34
1657548432632,MATH 18,B04,083751,Rideout; David Porter,6,0,36,30
1657548432632,MATH 18,B05,093473,Rideout; David Porter,6,0,36,30
1657548432632,MATH 18,B06,093474,Rideout; David Porter,6,0,36,30
1657548438666,MATH 20A,A01,083754,Zheng; Zequn,14,0,40,26
1657548444693,MATH 20B,A01,083756,Briones; Jor-el Thomas Caparas,4,0,36,32
1657548444693,MATH 20B,A02,083757,Briones; Jor-el Thomas Caparas,1,0,36,35
1657548444693,MATH 20B,A03,093475,Briones; Jor-el Thomas Caparas,2,0,36,34
1657548450716,MATH 20C,A01,083760,Briones; Jor-el Thomas Caparas,1,0,35,34
1657548450716,MATH 20C,A02,083761,Briones; Jor-el Thomas Caparas,8,0,35,27
1657548450716,MATH 20C,A03,093476,Briones; Jor-el Thomas Caparas,0,1,36,36
1657548450716,MATH 20C,B01,083762,Bach; Quang Tran,1,0,30,29
1657548456746,MATH 20D,A01,083765,Tran; Brian Kha,5,0,30,25
1657548456746,MATH 20D,A02,083766,Tran; Brian Kha,5,0,30,25
1657548456746,MATH 20D,A03,083767,Tran; Brian Kha,5,0,30,25
1657548462843,MATH 20E,A01,083771,Ganguly; Soumya,9,0,32,23
1657548462843,MATH 20E,A02,083772,Ganguly; Soumya,6,0,32,26
1657548462843,MATH 20E,B01,083773,Ciotti; Benjamin,20,0,35,15
1657548462843,MATH 20E,B02,083774,Ciotti; Benjamin,17,0,35,18
1657548468873,MATH 103A,A01,083777,Greenfeld; Be'Eri,3,0,36,33
1657548468873,MATH 103A,A02,083778,Greenfeld; Be'Eri,5,0,36,31
1657548468873,MATH 103A,A03,093561,Greenfeld; Be'Eri,5,0,36,31
1657548468873,MATH 103A,B01,083779,Greenfeld; Be'Eri,7,0,36,29
1657548468873,MATH 103A,B02,083780,Greenfeld; Be'Eri,4,0,36,32
1657548468873,MATH 103A,B03,093562,Greenfeld; Be'Eri,3,0,36,33
1657548474895,MATH 105,A01,085443,Carter; Anne Toulson,15,0,35,20
1657548474895,MATH 105,A02,093477,Carter; Anne Toulson,20,0,35,15
1657548480924,MATH 109,A01,083213,Ganzberger; Geoffrey Michael,2,0,34,32
1657548480924,MATH 109,A02,083214,Ganzberger; Geoffrey Michael,4,0,34,30
1657548480924,MATH 109,A03,093478,Ganzberger; Geoffrey Michael,2,0,34,32
1657548480924,MATH 109,B01,083215,Ganzberger; Geoffrey Michael,1,0,32,31
1657548480924,MATH 109,B02,083216,Ganzberger; Geoffrey Michael,2,0,32,30
1657548480924,MATH 109,B03,093479,Ganzberger; Geoffrey Michael,8,0,32,24
1657548486949,MATH 142A,A01,083219,Chow; Bennett,7,0,32,25
1657548486949,MATH 142A,A02,083220,Chow; Bennett,10,0,32,22
1657548486949,MATH 142A,A03,093480,Chow; Bennett,8,0,32,24
1657548486949,MATH 142A,B03,093481,Chow; Bennett,8,0,32,24
1657548486949,MATH 142A,B04,093558,Chow; Bennett,13,0,32,19
1657548486949,MATH 142A,B05,093559,Chow; Bennett,6,0,32,26
1657548492971,MATH 193A,A01,083224,Rotar; Vladimir,8,0,34,26
1657548492971,MATH 193A,A02,083225,Rotar; Vladimir,9,0,34,25
1657548492971,MATH 193A,A03,083781,Rotar; Vladimir,5,0,34,29
1657548492971,MATH 193A,A04,083782,Rotar; Vladimir,10,0,34,24
1657548492971,MATH 193A,A05,093482,Rotar; Vladimir,10,0,34,24
1657548498999,MATH 197,001,091859,McAuley; Julian John,9999,0,9999,0
1657548498999,MATH 197,002,095566,Kedlaya; Kiran S.,9997,0,9999,2
1657548498999,MATH 197,003,095567,Xiao; Ming,9999,0,9999,0
1657548498999,MATH 197,004,095571,Perols; Johan Lars,9998,0,9999,1
1657548506060,COGS 9,A01,083615,Shannon; Kyle Michael,9,0,75,66
1657548512084,COGS 11,A01,083617,Boyle; Mary E. T.,22,0,48,26
1657548518109,COGS 13,A01,083071,Bastos; Amalia Pinkusfeld,11,0,71,60
1657548524139,COGS 14A,A01,092681,Semenuks; Arturs,5,1,100,95
1657548530163,COGS 14B,A01,083073,Cheng; Tzu-Han,6,0,63,57
1657548536186,COGS 17,A01,092677,Semenuks; Arturs,6,0,81,75
1657548542210,COGS 100,A01,083619,Allen; Michael Gordon,17,0,70,53
1657548548236,COGS 101A,A01,083621,Davis; Joshua Daniel,9,0,68,59
1657548554260,COGS 101B,A01,091572,Allen; Michael Gordon,12,0,65,53
1657548560288,COGS 101C,A01,083625,Delgado; Tania,17,0,35,18
1657548566315,COGS 107A,A01,083627,Boyle; Mary E. T.,13,0,60,47
1657548572339,COGS 118A,A01,083075,Gupta; Anjum,21,0,76,55
1657548578368,CSE 3,A50,083646,Miranda; Gregory Joseph,24,0,50,26
1657548584394,CSE 8A,A50,083650,Miranda; Gregory Joseph,17,1,56,39
1657548590418,CSE 11,A01,083080,Cao; Yingjun,6,15,40,34
1657548596445,CSE 12,A01,083652,Krause-Levy; Sophia Louisa,28,1,120,92
1657548602472,CSE 15L,A01,083654,Morris; Justin Loren,9,0,50,41
1657548602472,CSE 15L,A02,083655,Morris; Justin Loren,9,0,50,41
1657548608496,CSE 20,A01,083657,Tran; Khoa Dang,39,0,80,41
1657548614521,CSE 21,A01,095574,Bach; Quang Tran,22,0,48,26
1657548620550,CSE 30,A01,083084,Eldon; John,5,0,80,75
1657548620550,CSE 30,B01,095061,Bhaskar; Nishant,9,0,50,41
1657548626576,CSE 100,A01,083659,Cao; Yingjun,5,4,70,65
1657548632605,CSE 134B,A01,083661,Powell; Thomas Allan,22,0,100,78
1657548638630,CSE 140,A01,083663,Gungor; Onat,15,0,85,70
1657548644657,CSE 140L,A01,083088,Eldon; John,21,0,100,79
1657548650683,CSE 175,A01,083665,Kumar; Rakesh,3,0,25,22
1657548656707,CSE 190,A00,092507,Dubnov; Shlomo,8,0,20,12
1657548662731,ECE 45,A01,083139,Congero; Spencer William,6,0,75,69
1657548668756,ECE 65,A50,083695,Saad; Andrew S,12,0,30,18
1657548668756,ECE 65,A51,095125,Saad; Andrew S,24,0,26,2
1657548674780,ECE 109,A01,091882,Touri; Behrouz,19,0,70,51
1657548680806,ECE 180,A00,083140,Abi Samra; Nicholas Camill,1,0,30,29
1657548680806,ECE 180,B00,083141,Abi Samra; Nicholas Camill,0,0,30,30
1657548686830,MATH 10A,A01,083735,Patchell; Gregory David,2,0,30,28
1657548686830,MATH 10A,A02,083736,Patchell; Gregory David,20,0,30,10
1657548686830,MATH 10A,A03,083737,Patchell; Gregory David,16,0,30,14
1657548692859,MATH 10B,A01,083207,Lim; Seonhee,8,0,34,26
1657548692859,MATH 10B,A02,083208,Lim; Seonhee,9,0,35,26
1657548692859,MATH 10B,A03,093472,Lim; Seonhee,7,0,34,27
1657548692859,MATH 10B,B01,083739,Sinha; Shubham,12,0,30,18
1657548698891,MATH 18,A01,083743,Cinel; Cameron Alexander,7,0,30,23
1657548698891,MATH 18,A02,083744,Cinel; Cameron Alexander,17,0,30,13
1657548698891,MATH 18,A03,083745,Cinel; Cameron Alexander,9,0,30,21
1657548698891,MATH 18,B01,083748,Rideout; David Porter,5,0,37,32
1657548698891,MATH 18,B02,083749,Rideout; David Porter,5,0,36,31
1657548698891,MATH 18,B03,083750,Rideout; David Porter,3,0,37,34
1657548698891,MATH 18,B04,083751,Rideout; David Porter,6,0,36,30
1657548698891,MATH 18,B05,093473,Rideout; David Porter,6,0,36,30
1657548698891,MATH 18,B06,093474,Rideout; David Porter,6,0,36,30
1657548704934,MATH 20A,A01,083754,Zheng; Zequn,14,0,40,26
1657548710961,MATH 20B,A01,083756,Briones; Jor-el Thomas Caparas,4,0,36,32
1657548710961,MATH 20B,A02,083757,Briones; Jor-el Thomas Caparas,1,0,36,35
1657548710961,MATH 20B,A03,093475,Briones; Jor-el Thomas Caparas,2,0,36,34
1657548716985,MATH 20C,A01,083760,Briones; Jor-el Thomas Caparas,1,0,35,34
1657548716985,MATH 20C,A02,083761,Briones; Jor-el Thomas Caparas,8,0,35,27
1657548716985,MATH 20C,A03,093476,Briones; Jor-el Thomas Caparas,0,1,36,36
1657548716985,MATH 20C,B01,083762,Bach; Quang Tran,1,0,30,29
1657548723009,MATH 20D,A01,083765,Tran; Brian Kha,5,0,30,25
1657548723009,MATH 20D,A02,083766,Tran; Brian Kha,5,0,30,25
1657548723009,MATH 20D,A03,083767,Tran; Brian Kha,5,0,30,25
1657548729032,MATH 20E,A01,083771,Ganguly; Soumya,9,0,32,23
1657548729032,MATH 20E,A02,083772,Ganguly; Soumya,6,0,32,26
1657548729032,MATH 20E,B01,083773,Ciotti; Benjamin,20,0,35,15
1657548729032,MATH 20E,B02,083774,Ciotti; Benjamin,17,0,35,18
1657548735062,MATH 103A,A01,083777,Greenfeld; Be'Eri,3,0,36,33
1657548735062,MATH 103A,A02,083778,Greenfeld; Be'Eri,5,0,36,31
1657548735062,MATH 103A,A03,093561,Greenfeld; Be'Eri,5,0,36,31
1657548735062,MATH 103A,B01,083779,Greenfeld; Be'Eri,7,0,36,29
1657548735062,MATH 103A,B02,083780,Greenfeld; Be'Eri,4,0,36,32
1657548735062,MATH 103A,B03,093562,Greenfeld; Be'Eri,3,0,36,33
1657548741091,MATH 105,A01,085443,Carter; Anne Toulson,15,0,35,20
1657548741091,MATH 105,A02,093477,Carter; Anne Toulson,20,0,35,15
1657548747114,MATH 109,A01,083213,Ganzberger; Geoffrey Michael,2,0,34,32
1657548747114,MATH 109,A02,083214,Ganzberger; Geoffrey Michael,4,0,34,30
1657548747114,MATH 109,A03,093478,Ganzberger; Geoffrey Michael,2,0,34,32
1657548747114,MATH 109,B01,083215,Ganzberger; Geoffrey Michael,1,0,32,31
1657548747114,MATH 109,B02,083216,Ganzberger; Geoffrey Michael,2,0,32,30
1657548747114,MATH 109,B03,093479,Ganzberger; Geoffrey Michael,8,0,32,24
1657548753139,MATH 142A,A01,083219,Chow; Bennett,7,0,32,25
1657548753139,MATH 142A,A02,083220,Chow; Bennett,10,0,32,22
1657548753139,MATH 142A,A03,093480,Chow; Bennett,8,0,32,24
1657548753139,MATH 142A,B03,093481,Chow; Bennett,8,0,32,24
1657548753139,MATH 142A,B04,093558,Chow; Bennett,13,0,32,19
1657548753139,MATH 142A,B05,093559,Chow; Bennett,6,0,32,26
1657548759171,MATH 193A,A01,083224,Rotar; Vladimir,8,0,34,26
1657548759171,MATH 193A,A02,083225,Rotar; Vladimir,9,0,34,25
1657548759171,MATH 193A,A03,083781,Rotar; Vladimir,5,0,34,29
1657548759171,MATH 193A,A04,083782,Rotar; Vladimir,10,0,34,24
1657548759171,MATH 193A,A05,093482,Rotar; Vladimir,10,0,34,24
1657548765196,MATH 197,001,091859,McAuley; Julian John,9999,0,9999,0
1657548765196,MATH 197,002,095566,Kedlaya; Kiran S.,9997,0,9999,2
1657548765196,MATH 197,003,095567,Xiao; Ming,9999,0,9999,0
1657548765196,MATH 197,004,095571,Perols; Johan Lars,9998,0,9999,1
1657548772258,COGS 9,A01,083615,Shannon; Kyle Michael,9,0,75,66
1657548778282,COGS 11,A01,083617,Boyle; Mary E. T.,22,0,48,26
1657548784307,COGS 13,A01,083071,Bastos; Amalia Pinkusfeld,11,0,71,60
1657548790334,COGS 14A,A01,092681,Semenuks; Arturs,5,1,100,95
1657548796357,COGS 14B,A01,083073,Cheng; Tzu-Han,6,0,63,57
1657548802379,COGS 17,A01,092677,Semenuks; Arturs,6,0,81,75
1657548808417,COGS 100,A01,083619,Allen; Michael Gordon,17,0,70,53
1657548814445,COGS 101A,A01,083621,Davis; Joshua Daniel,9,0,68,59
1657548820472,COGS 101B,A01,091572,Allen; Michael Gordon,12,0,65,53
1657548826508,COGS 101C,A01,083625,Delgado; Tania,17,0,35,18
1657548832538,COGS 107A,A01,083627,Boyle; Mary E. T.,13,0,60,47
1657548838561,COGS 118A,A01,083075,Gupta; Anjum,21,0,76,55
1657548844589,CSE 3,A50,083646,Miranda; Gregory Joseph,24,0,50,26
1657548850611,CSE 8A,A50,083650,Miranda; Gregory Joseph,17,1,56,39
1657548856638,CSE 11,A01,083080,Cao; Yingjun,6,15,40,34
1657548862660,CSE 12,A01,083652,Krause-Levy; Sophia Louisa,28,1,120,92
1657548868688,CSE 15L,A01,083654,Morris; Justin Loren,9,0,50,41
1657548868688,CSE 15L,A02,083655,Morris; Justin Loren,9,0,50,41
1657548874713,CSE 20,A01,083657,Tran; Khoa Dang,39,0,80,41
1657548880743,CSE 21,A01,095574,Bach; Quang Tran,22,0,48,26
1657548886771,CSE 30,A01,083084,Eldon; John,5,0,80,75
1657548886771,CSE 30,B01,095061,Bhaskar; Nishant,9,0,50,41
1657548892809,CSE 100,A01,083659,Cao; Yingjun,5,4,70,65
1657548898837,CSE 134B,A01,083661,Powell; Thomas Allan,22,0,100,78
1657548904865,CSE 140,A01,083663,Gungor; Onat,15,0,85,70
1657548910889,CSE 140L,A01,083088,Eldon; John,21,0,100,79
1657548916916,CSE 175,A01,083665,Kumar; Rakesh,3,0,25,22
1657548922943,CSE 190,A00,092507,Dubnov; Shlomo,8,0,20,12
1657548928971,ECE 45,A01,083139,Congero; Spencer William,6,0,75,69
1657548934998,ECE 65,A50,083695,Saad; Andrew S,12,0,30,18
1657548934998,ECE 65,A51,095125,Saad; Andrew S,24,0,26,2
1657548941025,ECE 109,A01,091882,Touri; Behrouz,19,0,70,51
1657548947050,ECE 180,A00,083140,Abi Samra; Nicholas Camill,1,0,30,29
1657548947050,ECE 180,B00,083141,Abi Samra; Nicholas Camill,0,0,30,30
1657548953081,MATH 10A,A01,083735,Patchell; Gregory David,2,0,30,28
1657548953081,MATH 10A,A02,083736,Patchell; Gregory David,20,0,30,10
1657548953081,MATH 10A,A03,083737,Patchell; Gregory David,16,0,30,14
1657548959105,MATH 10B,A01,083207,Lim; Seonhee,8,0,34,26
1657548959105,MATH 10B,A02,083208,Lim; Seonhee,9,0,35,26
1657548959105,MATH 10B,A03,093472,Lim; Seonhee,7,0,34,27
1657548959105,MATH 10B,B01,083739,Sinha; Shubham,12,0,30,18
1657548965138,MATH 18,A01,083743,Cinel; Cameron Alexander,7,0,30,23
1657548965138,MATH 18,A02,083744,Cinel; Cameron Alexander,17,0,30,13
1657548965138,MATH 18,A03,083745,Cinel; Cameron Alexander,9,0,30,21
1657548965138,MATH 18,B01,083748,Rideout; David Porter,5,0,37,32
1657548965138,MATH 18,B02,083749,Rideout; David Porter,5,0,36,31
1657548965138,MATH 18,B03,083750,Rideout; David Porter,3,0,37,34
1657548965138,MATH 18,B04,083751,Rideout; David Porter,6,0,36,30
1657548965138,MATH 18,B05,093473,Rideout; David Porter,6,0,36,30
1657548965138,MATH 18,B06,093474,Rideout; David Porter,6,0,36,30
1657548971162,MATH 20A,A01,083754,Zheng; Zequn,14,0,40,26
1657548977189,MATH 20B,A01,083756,Briones; Jor-el Thomas Caparas,4,0,36,32
1657548977189,MATH 20B,A02,083757,Briones; Jor-el Thomas Caparas,1,0,36,35
1657548977189,MATH 20B,A03,093475,Briones; Jor-el Thomas Caparas,2,0,36,34
1657548983211,MATH 20C,A01,083760,Briones; Jor-el Thomas Caparas,1,0,35,34
1657548983211,MATH 20C,A02,083761,Briones; Jor-el Thomas Caparas,8,0,35,27
1657548983211,MATH 20C,A03,093476,Briones; Jor-el Thomas Caparas,0,1,36,36
1657548983211,MATH 20C,B01,083762,Bach; Quang Tran,1,0,30,29
1657548989239,MATH 20D,A01,083765,Tran; Brian Kha,5,0,30,25
1657548989239,MATH 20D,A02,083766,Tran; Brian Kha,5,0,30,25
1657548989239,MATH 20D,A03,083767,Tran; Brian Kha,5,0,30,25
1657548995264,MATH 20E,A01,083771,Ganguly; Soumya,9,0,32,23
1657548995264,MATH 20E,A02,083772,Ganguly; Soumya,6,0,32,26
1657548995264,MATH 20E,B01,083773,Ciotti; Benjamin,20,0,35,15
1657548995264,MATH 20E,B02,083774,Ciotti; Benjamin,17,0,35,18
1657549001294,MATH 103A,A01,083777,Greenfeld; Be'Eri,3,0,36,33
1657549001294,MATH 103A,A02,083778,Greenfeld; Be'Eri,5,0,36,31
1657549001294,MATH 103A,A03,093561,Greenfeld; Be'Eri,5,0,36,31
1657549001294,MATH 103A,B01,083779,Greenfeld; Be'Eri,7,0,36,29
1657549001294,MATH 103A,B02,083780,Greenfeld; Be'Eri,4,0,36,32
1657549001294,MATH 103A,B03,093562,Greenfeld; Be'Eri,3,0,36,33
1657549007322,MATH 105,A01,085443,Carter; Anne Toulson,15,0,35,20
1657549007322,MATH 105,A02,093477,Carter; Anne Toulson,20,0,35,15
1657549013351,MATH 109,A01,083213,Ganzberger; Geoffrey Michael,2,0,34,32
1657549013351,MATH 109,A02,083214,Ganzberger; Geoffrey Michael,4,0,34,30
1657549013351,MATH 109,A03,093478,Ganzberger; Geoffrey Michael,2,0,34,32
1657549013351,MATH 109,B01,083215,Ganzberger; Geoffrey Michael,1,0,32,31
1657549013351,MATH 109,B02,083216,Ganzberger; Geoffrey Michael,2,0,32,30
1657549013351,MATH 109,B03,093479,Ganzberger; Geoffrey Michael,8,0,32,24
1657549019375,MATH 142A,A01,083219,Chow; Bennett,7,0,32,25
1657549019375,MATH 142A,A02,083220,Chow; Bennett,10,0,32,22
1657549019375,MATH 142A,A03,093480,Chow; Bennett,8,0,32,24
1657549019375,MATH 142A,B03,093481,Chow; Bennett,8,0,32,24
1657549019375,MATH 142A,B04,093558,Chow; Bennett,13,0,32,19
1657549019375,MATH 142A,B05,093559,Chow; Bennett,6,0,32,26
1657549025402,MATH 193A,A01,083224,Rotar; Vladimir,8,0,34,26
1657549025402,MATH 193A,A02,083225,Rotar; Vladimir,9,0,34,25
1657549025402,MATH 193A,A03,083781,Rotar; Vladimir,5,0,34,29
1657549025402,MATH 193A,A04,083782,Rotar; Vladimir,10,0,34,24
1657549025402,MATH 193A,A05,093482,Rotar; Vladimir,10,0,34,24
1657549031427,MATH 197,001,091859,McAuley; Julian John,9999,0,9999,0
1657549031427,MATH 197,002,095566,Kedlaya; Kiran S.,9997,0,9999,2
1657549031427,MATH 197,003,095567,Xiao; Ming,9999,0,9999,0
1657549031427,MATH 197,004,095571,Perols; Johan Lars,9998,0,9999,1
1657549038488,COGS 9,A01,083615,Shannon; Kyle Michael,9,0,75,66
1657549044511,COGS 11,A01,083617,Boyle; Mary E. T.,22,0,48,26
1657549050535,COGS 13,A01,083071,Bastos; Amalia Pinkusfeld,11,0,71,60
1657549056629,COGS 14A,A01,092681,Semenuks; Arturs,5,1,100,95
1657549062657,COGS 14B,A01,083073,Cheng; Tzu-Han,6,0,63,57
1657549068683,COGS 17,A01,092677,Semenuks; Arturs,6,0,81,75
1657549074705,COGS 100,A01,083619,Allen; Michael Gordon,17,0,70,53
1657549080736,COGS 101A,A01,083621,Davis; Joshua Daniel,9,0,68,59
1657549086767,COGS 101B,A01,091572,Allen; Michael Gordon,12,0,65,53
1657549092795,COGS 101C,A01,083625,Delgado; Tania,17,0,35,18
1657549098824,COGS 107A,A01,083627,Boyle; Mary E. T.,13,0,60,47
1657549104850,COGS 118A,A01,083075,Gupta; Anjum,21,0,76,55
1657549110874,CSE 3,A50,083646,Miranda; Gregory Joseph,24,0,50,26
1657549116898,CSE 8A,A50,083650,Miranda; Gregory Joseph,17,1,56,39
1657549122924,CSE 11,A01,083080,Cao; Yingjun,6,15,40,34
1657549128948,CSE 12,A01,083652,Krause-Levy; Sophia Louisa,28,1,120,92
1657549134975,CSE 15L,A01,083654,Morris; Justin Loren,9,0,50,41
1657549134975,CSE 15L,A02,083655,Morris; Justin Loren,9,0,50,41
1657549140999,CSE 20,A01,083657,Tran; Khoa Dang,39,0,80,41
1657549147027,CSE 21,A01,095574,Bach; Quang Tran,22,0,48,26
1657549153055,CSE 30,A01,083084,Eldon; John,5,0,80,75
1657549153055,CSE 30,B01,095061,Bhaskar; Nishant,9,0,50,41
1657549159084,CSE 100,A01,083659,Cao; Yingjun,5,4,70,65
1657549165107,CSE 134B,A01,083661,Powell; Thomas Allan,22,0,100,78
1657549171130,CSE 140,A01,083663,Gungor; Onat,15,0,85,70
1657549177155,CSE 140L,A01,083088,Eldon; John,21,0,100,79
1657549183190,CSE 175,A01,083665,Kumar; Rakesh,3,0,25,22
1657549189215,CSE 190,A00,092507,Dubnov; Shlomo,8,0,20,12
1657549195239,ECE 45,A01,083139,Congero; Spencer William,6,0,75,69
1657549201271,ECE 65,A50,083695,Saad; Andrew S,12,0,30,18
1657549201271,ECE 65,A51,095125,Saad; Andrew S,24,0,26,2
1657549207299,ECE 109,A01,091882,Touri; Behrouz,19,0,70,51
1657549213333,ECE 180,A00,083140,Abi Samra; Nicholas Camill,1,0,30,29
1657549213333,ECE 180,B00,083141,Abi Samra; Nicholas Camill,0,0,30,30
1657549219366,MATH 10A,A01,083735,Patchell; Gregory David,2,0,30,28
1657549219366,MATH 10A,A02,083736,Patchell; Gregory David,20,0,30,10
1657549219366,MATH 10A,A03,083737,Patchell; Gregory David,16,0,30,14
1657549225390,MATH 10B,A01,083207,Lim; Seonhee,8,0,34,26
1657549225390,MATH 10B,A02,083208,Lim; Seonhee,9,0,35,26
1657549225390,MATH 10B,A03,093472,Lim; Seonhee,7,0,34,27
1657549225390,MATH 10B,B01,083739,Sinha; Shubham,12,0,30,18
1657549231415,MATH 18,A01,083743,Cinel; Cameron Alexander,7,0,30,23
1657549231415,MATH 18,A02,083744,Cinel; Cameron Alexander,17,0,30,13
1657549231415,MATH 18,A03,083745,Cinel; Cameron Alexander,9,0,30,21
1657549231415,MATH 18,B01,083748,Rideout; David Porter,5,0,37,32
1657549231415,MATH 18,B02,083749,Rideout; David Porter,5,0,36,31
1657549231415,MATH 18,B03,083750,Rideout; David Porter,3,0,37,34
1657549231415,MATH 18,B04,083751,Rideout; David Porter,6,0,36,30
1657549231415,MATH 18,B05,093473,Rideout; David Porter,6,0,36,30
1657549231415,MATH 18,B06,093474,Rideout; David Porter,6,0,36,30
1657549237441,MATH 20A,A01,083754,Zheng; Zequn,14,0,40,26
1657549243466,MATH 20B,A01,083756,Briones; Jor-el Thomas Caparas,4,0,36,32
1657549243466,MATH 20B,A02,083757,Briones; Jor-el Thomas Caparas,1,0,36,35
1657549243466,MATH 20B,A03,093475,Briones; Jor-el Thomas Caparas,2,0,36,34
1657549249491,MATH 20C,A01,083760,Briones; Jor-el Thomas Caparas,1,0,35,34
1657549249491,MATH 20C,A02,083761,Briones; Jor-el Thomas Caparas,8,0,35,27
1657549249491,MATH 20C,A03,093476,Briones; Jor-el Thomas Caparas,0,1,36,36
1657549249491,MATH 20C,B01,083762,Bach; Quang Tran,1,0,30,29
1657549255519,MATH 20D,A01,083765,Tran; Brian Kha,5,0,30,25
1657549255519,MATH 20D,A02,083766,Tran; Brian Kha,5,0,30,25
1657549255519,MATH 20D,A03,083767,Tran; Brian Kha,5,0,30,25
1657549261552,MATH 20E,A01,083771,Ganguly; Soumya,9,0,32,23
1657549261552,MATH 20E,A02,083772,Ganguly; Soumya,6,0,32,26
1657549261552,MATH 20E,B01,083773,Ciotti; Benjamin,20,0,35,15
1657549261552,MATH 20E,B02,083774,Ciotti; Benjamin,17,0,35,18
1657549267576,MATH 103A,A01,083777,Greenfeld; Be'Eri,3,0,36,33
1657549267576,MATH 103A,A02,083778,Greenfeld; Be'Eri,5,0,36,31
1657549267576,MATH 103A,A03,093561,Greenfeld; Be'Eri,5,0,36,31
1657549267576,MATH 103A,B01,083779,Greenfeld; Be'Eri,7,0,36,29
1657549267576,MATH 103A,B02,083780,Greenfeld; Be'Eri,4,0,36,32
1657549267576,MATH 103A,B03,093562,Greenfeld; Be'Eri,3,0,36,33
1657549273604,MATH 105,A01,085443,Carter; Anne Toulson,15,0,35,20
1657549273604,MATH 105,A02,093477,Carter; Anne Toulson,20,0,35,15
1657549279631,MATH 109,A01,083213,Ganzberger; Geoffrey Michael,2,0,34,32
1657549279631,MATH 109,A02,083214,Ganzberger; Geoffrey Michael,4,0,34,30
1657549279631,MATH 109,A03,093478,Ganzberger; Geoffrey Michael,2,0,34,32
1657549279631,MATH 109,B01,083215,Ganzberger; Geoffrey Michael,1,0,32,31
1657549279631,MATH 109,B02,083216,Ganzberger; Geoffrey Michael,2,0,32,30
1657549279631,MATH 109,B03,093479,Ganzberger; Geoffrey Michael,8,0,32,24
1657549285662,MATH 142A,A01,083219,Chow; Bennett,7,0,32,25
1657549285662,MATH 142A,A02,083220,Chow; Bennett,10,0,32,22
1657549285662,MATH 142A,A03,093480,Chow; Bennett,8,0,32,24
1657549285662,MATH 142A,B03,093481,Chow; Bennett,8,0,32,24
1657549285662,MATH 142A,B04,093558,Chow; Bennett,13,0,32,19
1657549285662,MATH 142A,B05,093559,Chow; Bennett,6,0,32,26
1657549291691,MATH 193A,A01,083224,Rotar; Vladimir,8,0,34,26
1657549291691,MATH 193A,A02,083225,Rotar; Vladimir,9,0,34,25
1657549291691,MATH 193A,A03,083781,Rotar; Vladimir,5,0,34,29
1657549291691,MATH 193A,A04,083782,Rotar; Vladimir,10,0,34,24
1657549291691,MATH 193A,A05,093482,Rotar; Vladimir,10,0,34,24
1657549297718,MATH 197,001,091859,McAuley; Julian John,9999,0,9999,0
1657549297718,MATH 197,002,095566,Kedlaya; Kiran S.,9997,0,9999,2
1657549297718,MATH 197,003,095567,Xiao; Ming,9999,0,9999,0
1657549297718,MATH 197,004,095571,Perols; Johan Lars,9998,0,9999,1
1657549304792,COGS 9,A01,083615,Shannon; Kyle Michael,9,0,75,66
1657549310818,COGS 11,A01,083617,Boyle; Mary E. T.,22,0,48,26
1657549316846,COGS 13,A01,083071,Bastos; Amalia Pinkusfeld,11,0,71,60
1657549322873,COGS 14A,A01,092681,Semenuks; Arturs,5,1,100,95
1657549328898,COGS 14B,A01,083073,Cheng; Tzu-Han,6,0,63,57
1657549334925,COGS 17,A01,092677,Semenuks; Arturs,6,0,81,75
1657549340948,COGS 100,A01,083619,Allen; Michael Gordon,17,0,70,53
1657549346980,COGS 101A,A01,083621,Davis; Joshua Daniel,9,0,68,59
1657549353003,COGS 101B,A01,091572,Allen; Michael Gordon,12,0,65,53
1657549359030,COGS 101C,A01,083625,Delgado; Tania,17,0,35,18
1657549365061,COGS 107A,A01,083627,Boyle; Mary E. T.,13,0,60,47
1657549371087,COGS 118A,A01,083075,Gupta; Anjum,21,0,76,55
1657549377124,CSE 3,A50,083646,Miranda; Gregory Joseph,24,0,50,26
1657549383148,CSE 8A,A50,083650,Miranda; Gregory Joseph,17,1,56,39
1657549389181,CSE 11,A01,083080,Cao; Yingjun,6,15,40,34
1657549395206,CSE 12,A01,083652,Krause-Levy; Sophia Louisa,28,1,120,92
1657549401234,CSE 15L,A01,083654,Morris; Justin Loren,9,0,50,41
1657549401234,CSE 15L,A02,083655,Morris; Justin Loren,9,0,50,41
1657549407258,CSE 20,A01,083657,Tran; Khoa Dang,39,0,80,41
1657549413287,CSE 21,A01,095574,Bach; Quang Tran,22,0,48,26
1657549419311,CSE 30,A01,083084,Eldon; John,5,0,80,75
1657549419311,CSE 30,B01,095061,Bhaskar; Nishant,9,0,50,41
1657549425342,CSE 100,A01,083659,Cao; Yingjun,5,4,70,65
1657549431366,CSE 134B,A01,083661,Powell; Thomas Allan,22,0,100,78
1657549437401,CSE 140,A01,083663,Gungor; Onat,15,0,85,70
1657549443429,CSE 140L,A01,083088,Eldon; John,21,0,100,79
1657549449453,CSE 175,A01,083665,Kumar; Rakesh,3,0,25,22
1657549455479,CSE 190,A00,092507,Dubnov; Shlomo,8,0,20,12
1657549461512,ECE 45,A01,083139,Congero; Spencer William,6,0,75,69
1657549467535,ECE 65,A50,083695,Saad; Andrew S,12,0,30,18
1657549467535,ECE 65,A51,095125,Saad; Andrew S,24,0,26,2
1657549473561,ECE 109,A01,091882,Touri; Behrouz,19,0,70,51
1657549479585,ECE 180,A00,083140,Abi Samra; Nicholas Camill,1,0,30,29
1657549479585,ECE 180,B00,083141,Abi Samra; Nicholas Camill,0,0,30,30
1657549485610,MATH 10A,A01,083735,Patchell; Gregory David,2,0,30,28
1657549485610,MATH 10A,A02,083736,Patchell; Gregory David,20,0,30,10
1657549485610,MATH 10A,A03,083737,Patchell; Gregory David,16,0,30,14
1657549491633,MATH 10B,A01,083207,Lim; Seonhee,8,0,34,26
1657549491633,MATH 10B,A02,083208,Lim; Seonhee,9,0,35,26
1657549491633,MATH 10B,A03,093472,Lim; Seonhee,7,0,34,27
1657549491633,MATH 10B,B01,083739,Sinha; Shubham,12,0,30,18
1657549497658,MATH 18,A01,083743,Cinel; Cameron Alexander,7,0,30,23
1657549497658,MATH 18,A02,083744,Cinel; Cameron Alexander,17,0,30,13
1657549497658,MATH 18,A03,083745,Cinel; Cameron Alexander,9,0,30,21
1657549497658,MATH 18,B01,083748,Rideout; David Porter,5,0,37,32
1657549497658,MATH 18,B02,083749,Rideout; David Porter,5,0,36,31
1657549497658,MATH 18,B03,083750,Rideout; David Porter,3,0,37,34
1657549497658,MATH 18,B04,083751,Rideout; David Porter,6,0,36,30
1657549497658,MATH 18,B05,093473,Rideout; David Porter,6,0,36,30
1657549497658,MATH 18,B06,093474,Rideout; David Porter,6,0,36,30
1657549503682,MATH 20A,A01,083754,Zheng; Zequn,14,0,40,26
1657549509706,MATH 20B,A01,083756,Briones; Jor-el Thomas Caparas,4,0,36,32
1657549509706,MATH 20B,A02,083757,Briones; Jor-el Thomas Caparas,1,0,36,35
1657549509706,MATH 20B,A03,093475,Briones; Jor-el Thomas Caparas,2,0,36,34
1657549515736,MATH 20C,A01,083760,Briones; Jor-el Thomas Caparas,1,0,35,34
1657549515736,MATH 20C,A02,083761,Briones; Jor-el Thomas Caparas,8,0,35,27
1657549515736,MATH 20C,A03,093476,Briones; Jor-el Thomas Caparas,0,1,36,36
1657549515736,MATH 20C,B01,083762,Bach; Quang Tran,1,0,30,29
1657549521760,MATH 20D,A01,083765,Tran; Brian Kha,5,0,30,25
1657549521760,MATH 20D,A02,083766,Tran; Brian Kha,5,0,30,25
1657549521760,MATH 20D,A03,083767,Tran; Brian Kha,5,0,30,25
1657549527791,MATH 20E,A01,083771,Ganguly; Soumya,9,0,32,23
1657549527791,MATH 20E,A02,083772,Ganguly; Soumya,6,0,32,26
1657549527791,MATH 20E,B01,083773,Ciotti; Benjamin,20,0,35,15
1657549527791,MATH 20E,B02,083774,Ciotti; Benjamin,17,0,35,18
1657549533819,MATH 103A,A01,083777,Greenfeld; Be'Eri,3,0,36,33
1657549533819,MATH 103A,A02,083778,Greenfeld; Be'Eri,5,0,36,31
1657549533819,MATH 103A,A03,093561,Greenfeld; Be'Eri,5,0,36,31
1657549533819,MATH 103A,B01,083779,Greenfeld; Be'Eri,7,0,36,29
1657549533819,MATH 103A,B02,083780,Greenfeld; Be'Eri,4,0,36,32
1657549533819,MATH 103A,B03,093562,Greenfeld; Be'Eri,3,0,36,33
1657549539848,MATH 105,A01,085443,Carter; Anne Toulson,15,0,35,20
1657549539848,MATH 105,A02,093477,Carter; Anne Toulson,20,0,35,15
1657549545878,MATH 109,A01,083213,Ganzberger; Geoffrey Michael,2,0,34,32
1657549545878,MATH 109,A02,083214,Ganzberger; Geoffrey Michael,4,0,34,30
1657549545878,MATH 109,A03,093478,Ganzberger; Geoffrey Michael,2,0,34,32
1657549545878,MATH 109,B01,083215,Ganzberger; Geoffrey Michael,1,0,32,31
1657549545878,MATH 109,B02,083216,Ganzberger; Geoffrey Michael,2,0,32,30
1657549545878,MATH 109,B03,093479,Ganzberger; Geoffrey Michael,8,0,32,24
1657549551902,MATH 142A,A01,083219,Chow; Bennett,7,0,32,25
1657549551902,MATH 142A,A02,083220,Chow; Bennett,10,0,32,22
1657549551902,MATH 142A,A03,093480,Chow; Bennett,8,0,32,24
1657549551902,MATH 142A,B03,093481,Chow; Bennett,8,0,32,24
1657549551902,MATH 142A,B04,093558,Chow; Bennett,13,0,32,19
1657549551902,MATH 142A,B05,093559,Chow; Bennett,6,0,32,26
1657549557927,MATH 193A,A01,083224,Rotar; Vladimir,8,0,34,26
1657549557927,MATH 193A,A02,083225,Rotar; Vladimir,9,0,34,25
1657549557927,MATH 193A,A03,083781,Rotar; Vladimir,5,0,34,29
1657549557927,MATH 193A,A04,083782,Rotar; Vladimir,10,0,34,24
1657549557927,MATH 193A,A05,093482,Rotar; Vladimir,10,0,34,24
1657549563950,MATH 197,001,091859,McAuley; Julian John,9999,0,9999,0
1657549563950,MATH 197,002,095566,Kedlaya; Kiran S.,9997,0,9999,2
1657549563950,MATH 197,003,095567,Xiao; Ming,9999,0,9999,0
1657549563950,MATH 197,004,095571,Perols; Johan Lars,9998,0,9999,1
1657549571012,COGS 9,A01,083615,Shannon; Kyle Michael,9,0,75,66
1657549577040,COGS 11,A01,083617,Boyle; Mary E. T.,22,0,48,26
1657549583067,COGS 13,A01,083071,Bastos; Amalia Pinkusfeld,11,0,71,60
1657549589094,COGS 14A,A01,092681,Semenuks; Arturs,5,1,100,95
1657549595117,COGS 14B,A01,083073,Cheng; Tzu-Han,6,0,63,57
1657549601142,COGS 17,A01,092677,Semenuks; Arturs,6,0,81,75
1657549607168,COGS 100,A01,083619,Allen; Michael Gordon,17,0,70,53
1657549613200,COGS 101A,A01,083621,Davis; Joshua Daniel,9,0,68,59
1657549619227,COGS 101B,A01,091572,Allen; Michael Gordon,12,0,65,53
1657549625252,COGS 101C,A01,083625,Delgado; Tania,17,0,35,18
1657549631281,COGS 107A,A01,083627,Boyle; Mary E. T.,13,0,60,47
1657549637305,COGS 118A,A01,083075,Gupta; Anjum,21,0,76,55
1657549643333,CSE 3,A50,083646,Miranda; Gregory Joseph,24,0,50,26
1657549649357,CSE 8A,A50,083650,Miranda; Gregory Joseph,17,1,56,39
1657549655461,CSE 11,A01,083080,Cao; Yingjun,6,15,40,34
1657549661486,CSE 12,A01,083652,Krause-Levy; Sophia Louisa,28,1,120,92
1657549667513,CSE 15L,A01,083654,Morris; Justin Loren,9,0,50,41
1657549667513,CSE 15L,A02,083655,Morris; Justin Loren,9,0,50,41
1657549673537,CSE 20,A01,083657,Tran; Khoa Dang,39,0,80,41
1657549679562,CSE 21,A01,095574,Bach; Quang Tran,22,0,48,26
1657549685589,CSE 30,A01,083084,Eldon; John,5,0,80,75
1657549685589,CSE 30,B01,095061,Bhaskar; Nishant,9,0,50,41
1657549691618,CSE 100,A01,083659,Cao; Yingjun,5,4,70,65
1657549697646,CSE 134B,A01,083661,Powell; Thomas Allan,22,0,100,78
1657549703669,CSE 140,A01,083663,Gungor; Onat,15,0,85,70
1657549709695,CSE 140L,A01,083088,Eldon; John,21,0,100,79
1657549715723,CSE 175,A01,083665,Kumar; Rakesh,3,0,25,22
1657549721756,CSE 190,A00,092507,Dubnov; Shlomo,8,0,20,12
1657549727780,ECE 45,A01,083139,Congero; Spencer William,6,0,75,69
1657549733808,ECE 65,A50,083695,Saad; Andrew S,12,0,30,18
1657549733808,ECE 65,A51,095125,Saad; Andrew S,24,0,26,2
1657549739847,ECE 109,A01,091882,Touri; Behrouz,19,0,70,51
1657549745874,ECE 180,A00,083140,Abi Samra; Nicholas Camill,1,0,30,29
1657549745874,ECE 180,B00,083141,Abi Samra; Nicholas Camill,0,0,30,30
1657549751897,MATH 10A,A01,083735,Patchell; Gregory David,2,0,30,28
1657549751897,MATH 10A,A02,083736,Patchell; Gregory David,20,0,30,10
1657549751897,MATH 10A,A03,083737,Patchell; Gregory David,16,0,30,14
1657549757927,MATH 10B,A01,083207,Lim; Seonhee,8,0,34,26
1657549757927,MATH 10B,A02,083208,Lim; Seonhee,9,0,35,26
1657549757927,MATH 10B,A03,093472,Lim; Seonhee,7,0,34,27
1657549757927,MATH 10B,B01,083739,Sinha; Shubham,12,0,30,18
1657549763952,MATH 18,A01,083743,Cinel; Cameron Alexander,7,0,30,23
1657549763952,MATH 18,A02,083744,Cinel; Cameron Alexander,17,0,30,13
1657549763952,MATH 18,A03,083745,Cinel; Cameron Alexander,9,0,30,21
1657549763952,MATH 18,B01,083748,Rideout; David Porter,5,0,37,32
1657549763952,MATH 18,B02,083749,Rideout; David Porter,5,0,36,31
1657549763952,MATH 18,B03,083750,Rideout; David Porter,3,0,37,34
1657549763952,MATH 18,B04,083751,Rideout; David Porter,6,0,36,30
1657549763952,MATH 18,B05,093473,Rideout; David Porter,6,0,36,30
1657549763952,MATH 18,B06,093474,Rideout; David Porter,6,0,36,30
1657549769976,MATH 20A,A01,083754,Zheng; Zequn,14,0,40,26
1657549776016,MATH 20B,A01,083756,Briones; Jor-el Thomas Caparas,4,0,36,32
1657549776016,MATH 20B,A02,083757,Briones; Jor-el Thomas Caparas,1,0,36,35
1657549776016,MATH 20B,A03,093475,Briones; Jor-el Thomas Caparas,2,0,36,34
1657549782045,MATH 20C,A01,083760,Briones; Jor-el Thomas Caparas,1,0,35,34
1657549782045,MATH 20C,A02,083761,Briones; Jor-el Thomas Caparas,8,0,35,27
1657549782045,MATH 20C,A03,093476,Briones; Jor-el Thomas Caparas,0,1,36,36
1657549782045,MATH 20C,B01,083762,Bach; Quang Tran,1,0,30,29
1657549788070,MATH 20D,A01,083765,Tran; Brian Kha,5,0,30,25
1657549788070,MATH 20D,A02,083766,Tran; Brian Kha,5,0,30,25
1657549788070,MATH 20D,A03,083767,Tran; Brian Kha,5,0,30,25
1657549794095,MATH 20E,A01,083771,Ganguly; Soumya,9,0,32,23
1657549794095,MATH 20E,A02,083772,Ganguly; Soumya,6,0,32,26
1657549794095,MATH 20E,B01,083773,Ciotti; Benjamin,20,0,35,15
1657549794095,MATH 20E,B02,083774,Ciotti; Benjamin,17,0,35,18
1657549800118,MATH 103A,A01,083777,Greenfeld; Be'Eri,3,0,36,33
1657549800118,MATH 103A,A02,083778,Greenfeld; Be'Eri,5,0,36,31
1657549800118,MATH 103A,A03,093561,Greenfeld; Be'Eri,5,0,36,31
1657549800118,MATH 103A,B01,083779,Greenfeld; Be'Eri,7,0,36,29
1657549800118,MATH 103A,B02,083780,Greenfeld; Be'Eri,4,0,36,32
1657549800118,MATH 103A,B03,093562,Greenfeld; Be'Eri,3,0,36,33
1657549806142,MATH 105,A01,085443,Carter; Anne Toulson,15,0,35,20
1657549806142,MATH 105,A02,093477,Carter; Anne Toulson,20,0,35,15
1657549812170,MATH 109,A01,083213,Ganzberger; Geoffrey Michael,2,0,34,32
1657549812170,MATH 109,A02,083214,Ganzberger; Geoffrey Michael,4,0,34,30
1657549812170,MATH 109,A03,093478,Ganzberger; Geoffrey Michael,2,0,34,32
1657549812170,MATH 109,B01,083215,Ganzberger; Geoffrey Michael,1,0,32,31
1657549812170,MATH 109,B02,083216,Ganzberger; Geoffrey Michael,2,0,32,30
1657549812170,MATH 109,B03,093479,Ganzberger; Geoffrey Michael,8,0,32,24
1657549818196,MATH 142A,A01,083219,Chow; Bennett,7,0,32,25
1657549818196,MATH 142A,A02,083220,Chow; Bennett,10,0,32,22
1657549818196,MATH 142A,A03,093480,Chow; Bennett,8,0,32,24
1657549818196,MATH 142A,B03,093481,Chow; Bennett,8,0,32,24
1657549818196,MATH 142A,B04,093558,Chow; Bennett,13,0,32,19
1657549818196,MATH 142A,B05,093559,Chow; Bennett,6,0,32,26
1657549824220,MATH 193A,A01,083224,Rotar; Vladimir,8,0,34,26
1657549824220,MATH 193A,A02,083225,Rotar; Vladimir,9,0,34,25
1657549824220,MATH 193A,A03,083781,Rotar; Vladimir,5,0,34,29
1657549824220,MATH 193A,A04,083782,Rotar; Vladimir,10,0,34,24
1657549824220,MATH 193A,A05,093482,Rotar; Vladimir,10,0,34,24
1657549830242,MATH 197,001,091859,McAuley; Julian John,9999,0,9999,0
1657549830242,MATH 197,002,095566,Kedlaya; Kiran S.,9997,0,9999,2
1657549830242,MATH 197,003,095567,Xiao; Ming,9999,0,9999,0
1657549830242,MATH 197,004,095571,Perols; Johan Lars,9998,0,9999,1
1657549837305,COGS 9,A01,083615,Shannon; Kyle Michael,9,0,75,66
1657549843331,COGS 11,A01,083617,Boyle; Mary E. T.,22,0,48,26
1657549849355,COGS 13,A01,083071,Bastos; Amalia Pinkusfeld,11,0,71,60
1657549855379,COGS 14A,A01,092681,Semenuks; Arturs,5,1,100,95
1657549861408,COGS 14B,A01,083073,Cheng; Tzu-Han,6,0,63,57
1657549867435,COGS 17,A01,092677,Semenuks; Arturs,6,0,81,75
1657549873463,COGS 100,A01,083619,Allen; Michael Gordon,17,0,70,53
1657549879487,COGS 101A,A01,083621,Davis; Joshua Daniel,9,0,68,59
1657549885509,COGS 101B,A01,091572,Allen; Michael Gordon,12,0,65,53
1657549891532,COGS 101C,A01,083625,Delgado; Tania,17,0,35,18
1657549897554,COGS 107A,A01,083627,Boyle; Mary E. T.,13,0,60,47
1657549903581,COGS 118A,A01,083075,Gupta; Anjum,21,0,76,55
1657549909612,CSE 3,A50,083646,Miranda; Gregory Joseph,24,0,50,26
1657549915639,CSE 8A,A50,083650,Miranda; Gregory Joseph,17,1,56,39
1657549921665,CSE 11,A01,083080,Cao; Yingjun,6,15,40,34
1657549927691,CSE 12,A01,083652,Krause-Levy; Sophia Louisa,28,1,120,92
1657549933720,CSE 15L,A01,083654,Morris; Justin Loren,9,0,50,41
1657549933720,CSE 15L,A02,083655,Morris; Justin Loren,9,0,50,41
1657549939742,CSE 20,A01,083657,Tran; Khoa Dang,39,0,80,41
1657549945773,CSE 21,A01,095574,Bach; Quang Tran,22,0,48,26
1657549951799,CSE 30,A01,083084,Eldon; John,5,0,80,75
1657549951799,CSE 30,B01,095061,Bhaskar; Nishant,9,0,50,41
1657549957825,CSE 100,A01,083659,Cao; Yingjun,5,4,70,65
1657549963850,CSE 134B,A01,083661,Powell; Thomas Allan,22,0,100,78
1657549969874,CSE 140,A01,083663,Gungor; Onat,15,0,85,70
1657549975903,CSE 140L,A01,083088,Eldon; John,21,0,100,79
1657549981930,CSE 175,A01,083665,Kumar; Rakesh,3,0,25,22
1657549987953,CSE 190,A00,092507,Dubnov; Shlomo,8,0,20,12
1657549993976,ECE 45,A01,083139,Congero; Spencer William,6,0,75,69
1657550000001,ECE 65,A50,083695,Saad; Andrew S,12,0,30,18
1657550000001,ECE 65,A51,095125,Saad; Andrew S,24,0,26,2
1657550006025,ECE 109,A01,091882,Touri; Behrouz,19,0,70,51
1657550012052,ECE 180,A00,083140,Abi Samra; Nicholas Camill,1,0,30,29
1657550012052,ECE 180,B00,083141,Abi Samra; Nicholas Camill,0,0,30,30
1657550018075,MATH 10A,A01,083735,Patchell; Gregory David,2,0,30,28
1657550018075,MATH 10A,A02,083736,Patchell; Gregory David,20,0,30,10
1657550018075,MATH 10A,A03,083737,Patchell; Gregory David,16,0,30,14
1657550024100,MATH 10B,A01,083207,Lim; Seonhee,8,0,34,26
1657550024100,MATH 10B,A02,083208,Lim; Seonhee,9,0,35,26
1657550024100,MATH 10B,A03,093472,Lim; Seonhee,7,0,34,27
1657550024100,MATH 10B,B01,083739,Sinha; Shubham,12,0,30,18
1657550030125,MATH 18,A01,083743,Cinel; Cameron Alexander,7,0,30,23
1657550030125,MATH 18,A02,083744,Cinel; Cameron Alexander,17,0,30,13
1657550030125,MATH 18,A03,083745,Cinel; Cameron Alexander,9,0,30,21
1657550030125,MATH 18,B01,083748,Rideout; David Porter,5,0,37,32
1657550030125,MATH 18,B02,083749,Rideout; David Porter,5,0,36,31
1657550030125,MATH 18,B03,083750,Rideout; David Porter,3,0,37,34
1657550030125,MATH 18,B04,083751,Rideout; David Porter,6,0,36,30
1657550030125,MATH 18,B05,093473,Rideout; David Porter,6,0,36,30
1657550030125,MATH 18,B06,093474,Rideout; David Porter,6,0,36,30
1657550036159,MATH 20A,A01,083754,Zheng; Zequn,14,0,40,26
1657550042185,MATH 20B,A01,083756,Briones; Jor-el Thomas Caparas,4,0,36,32
1657550042185,MATH 20B,A02,083757,Briones; Jor-el Thomas Caparas,1,0,36,35
1657550042185,MATH 20B,A03,093475,Briones; Jor-el Thomas Caparas,2,0,36,34
1657550048209,MATH 20C,A01,083760,Briones; Jor-el Thomas Caparas,1,0,35,34
1657550048209,MATH 20C,A02,083761,Briones; Jor-el Thomas Caparas,8,0,35,27
1657550048209,MATH 20C,A03,093476,Briones; Jor-el Thomas Caparas,0,1,36,36
1657550048209,MATH 20C,B01,083762,Bach; Quang Tran,1,0,30,29
1657550054238,MATH 20D,A01,083765,Tran; Brian Kha,5,0,30,25
1657550054238,MATH 20D,A02,083766,Tran; Brian Kha,5,0,30,25
1657550054238,MATH 20D,A03,083767,Tran; Brian Kha,5,0,30,25
1657550060264,MATH 20E,A01,083771,Ganguly; Soumya,9,0,32,23
1657550060264,MATH 20E,A02,083772,Ganguly; Soumya,6,0,32,26
1657550060264,MATH 20E,B01,083773,Ciotti; Benjamin,20,0,35,15
1657550060264,MATH 20E,B02,083774,Ciotti; Benjamin,17,0,35,18
1657550066302,MATH 103A,A01,083777,Greenfeld; Be'Eri,3,0,36,33
1657550066302,MATH 103A,A02,083778,Greenfeld; Be'Eri,5,0,36,31
1657550066302,MATH 103A,A03,093561,Greenfeld; Be'Eri,5,0,36,31
1657550066302,MATH 103A,B01,083779,Greenfeld; Be'Eri,7,0,36,29
1657550066302,MATH 103A,B02,083780,Greenfeld; Be'Eri,4,0,36,32
1657550066302,MATH 103A,B03,093562,Greenfeld; Be'Eri,3,0,36,33
1657550072326,MATH 105,A01,085443,Carter; Anne Toulson,15,0,35,20
1657550072326,MATH 105,A02,093477,Carter; Anne Toulson,20,0,35,15
1657550078350,MATH 109,A01,083213,Ganzberger; Geoffrey Michael,2,0,34,32
1657550078350,MATH 109,A02,083214,Ganzberger; Geoffrey Michael,4,0,34,30
1657550078350,MATH 109,A03,093478,Ganzberger; Geoffrey Michael,2,0,34,32
1657550078350,MATH 109,B01,083215,Ganzberger; Geoffrey Michael,1,0,32,31
1657550078350,MATH 109,B02,083216,Ganzberger; Geoffrey Michael,2,0,32,30
1657550078350,MATH 109,B03,093479,Ganzberger; Geoffrey Michael,8,0,32,24
1657550084378,MATH 142A,A01,083219,Chow; Bennett,7,0,32,25
1657550084378,MATH 142A,A02,083220,Chow; Bennett,10,0,32,22
1657550084378,MATH 142A,A03,093480,Chow; Bennett,8,0,32,24
1657550084378,MATH 142A,B03,093481,Chow; Bennett,8,0,32,24
1657550084378,MATH 142A,B04,093558,Chow; Bennett,13,0,32,19
1657550084378,MATH 142A,B05,093559,Chow; Bennett,6,0,32,26
1657550090402,MATH 193A,A01,083224,Rotar; Vladimir,8,0,34,26
1657550090402,MATH 193A,A02,083225,Rotar; Vladimir,9,0,34,25
1657550090402,MATH 193A,A03,083781,Rotar; Vladimir,5,0,34,29
1657550090402,MATH 193A,A04,083782,Rotar; Vladimir,10,0,34,24
1657550090402,MATH 193A,A05,093482,Rotar; Vladimir,10,0,34,24
1657550096426,MATH 197,001,091859,McAuley; Julian John,9999,0,9999,0
1657550096426,MATH 197,002,095566,Kedlaya; Kiran S.,9997,0,9999,2
1657550096426,MATH 197,003,095567,Xiao; Ming,9999,0,9999,0
1657550096426,MATH 197,004,095571,Perols; Johan Lars,9998,0,9999,1
1657550103488,COGS 9,A01,083615,Shannon; Kyle Michael,9,0,75,66
1657550109518,COGS 11,A01,083617,Boyle; Mary E. T.,22,0,48,26
1657550115541,COGS 13,A01,083071,Bastos; Amalia Pinkusfeld,11,0,71,60
1657550121587,COGS 14A,A01,092681,Semenuks; Arturs,5,1,100,95
1657550127614,COGS 14B,A01,083073,Cheng; Tzu-Han,6,0,63,57
1657550133651,COGS 17,A01,092677,Semenuks; Arturs,6,0,81,75
1657550139685,COGS 100,A01,083619,Allen; Michael Gordon,17,0,70,53
1657550145714,COGS 101A,A01,083621,Davis; Joshua Daniel,9,0,68,59
1657550151736,COGS 101B,A01,091572,Allen; Michael Gordon,12,0,65,53
1657550157766,COGS 101C,A01,083625,Delgado; Tania,17,0,35,18
1657550163789,COGS 107A,A01,083627,Boyle; Mary E. T.,13,0,60,47
1657550169822,COGS 118A,A01,083075,Gupta; Anjum,21,0,76,55
1657550175861,CSE 3,A50,083646,Miranda; Gregory Joseph,24,0,50,26
1657550181883,CSE 8A,A50,083650,Miranda; Gregory Joseph,17,1,56,39
1657550187906,CSE 11,A01,083080,Cao; Yingjun,6,15,40,34
1657550193928,CSE 12,A01,083652,Krause-Levy; Sophia Louisa,28,1,120,92
1657550199951,CSE 15L,A01,083654,Morris; Justin Loren,9,0,50,41
1657550199951,CSE 15L,A02,083655,Morris; Justin Loren,9,0,50,41
1657550205975,CSE 20,A01,083657,Tran; Khoa Dang,39,0,80,41
1657550212003,CSE 21,A01,095574,Bach; Quang Tran,22,0,48,26
1657550218030,CSE 30,A01,083084,Eldon; John,5,0,80,75
1657550218030,CSE 30,B01,095061,Bhaskar; Nishant,9,0,50,41
1657550224053,CSE 100,A01,083659,Cao; Yingjun,5,4,70,65
1657550230077,CSE 134B,A01,083661,Powell; Thomas Allan,22,0,100,78
1657550236104,CSE 140,A01,083663,Gungor; Onat,15,0,85,70
1657550242132,CSE 140L,A01,083088,Eldon; John,21,0,100,79
1657550248156,CSE 175,A01,083665,Kumar; Rakesh,3,0,25,22
1657550254258,CSE 190,A00,092507,Dubnov; Shlomo,8,0,20,12
1657550260288,ECE 45,A01,083139,Congero; Spencer William,6,0,75,69
1657550266316,ECE 65,A50,083695,Saad; Andrew S,12,0,30,18
1657550266316,ECE 65,A51,095125,Saad; Andrew S,24,0,26,2
1657550272340,ECE 109,A01,091882,Touri; Behrouz,19,0,70,51
1657550278380,ECE 180,A00,083140,Abi Samra; Nicholas Camill,1,0,30,29
1657550278380,ECE 180,B00,083141,Abi Samra; Nicholas Camill,0,0,30,30
1657550284411,MATH 10A,A01,083735,Patchell; Gregory David,2,0,30,28
1657550284411,MATH 10A,A02,083736,Patchell; Gregory David,20,0,30,10
1657550284411,MATH 10A,A03,083737,Patchell; Gregory David,16,0,30,14
1657550290455,MATH 10B,A01,083207,Lim; Seonhee,8,0,34,26
1657550290455,MATH 10B,A02,083208,Lim; Seonhee,9,0,35,26
1657550290455,MATH 10B,A03,093472,Lim; Seonhee,7,0,34,27
1657550290455,MATH 10B,B01,083739,Sinha; Shubham,12,0,30,18
1657550296485,MATH 18,A01,083743,Cinel; Cameron Alexander,7,0,30,23
1657550296485,MATH 18,A02,083744,Cinel; Cameron Alexander,17,0,30,13
1657550296485,MATH 18,A03,083745,Cinel; Cameron Alexander,9,0,30,21
1657550296485,MATH 18,B01,083748,Rideout; David Porter,5,0,37,32
1657550296485,MATH 18,B02,083749,Rideout; David Porter,5,0,36,31
1657550296485,MATH 18,B03,083750,Rideout; David Porter,3,0,37,34
1657550296485,MATH 18,B04,083751,Rideout; David Porter,6,0,36,30
1657550296485,MATH 18,B05,093473,Rideout; David Porter,6,0,36,30
1657550296485,MATH 18,B06,093474,Rideout; David Porter,6,0,36,30
1657550302512,MATH 20A,A01,083754,Zheng; Zequn,14,0,40,26
1657550308538,MATH 20B,A01,083756,Briones; Jor-el Thomas Caparas,4,0,36,32
1657550308538,MATH 20B,A02,083757,Briones; Jor-el Thomas Caparas,1,0,36,35
1657550308538,MATH 20B,A03,093475,Briones; Jor-el Thomas Caparas,2,0,36,34
1657550314563,MATH 20C,A01,083760,Briones; Jor-el Thomas Caparas,1,0,35,34
1657550314563,MATH 20C,A02,083761,Briones; Jor-el Thomas Caparas,8,0,35,27
1657550314563,MATH 20C,A03,093476,Briones; Jor-el Thomas Caparas,0,1,36,36
1657550314563,MATH 20C,B01,083762,Bach; Quang Tran,1,0,30,29
1657550320606,MATH 20D,A01,083765,Tran; Brian Kha,5,0,30,25
1657550320606,MATH 20D,A02,083766,Tran; Brian Kha,5,0,30,25
1657550320606,MATH 20D,A03,083767,Tran; Brian Kha,5,0,30,25
1657550326632,MATH 20E,A01,083771,Ganguly; Soumya,9,0,32,23
1657550326632,MATH 20E,A02,083772,Ganguly; Soumya,6,0,32,26
1657550326632,MATH 20E,B01,083773,Ciotti; Benjamin,20,0,35,15
1657550326632,MATH 20E,B02,083774,Ciotti; Benjamin,17,0,35,18
1657550332660,MATH 103A,A01,083777,Greenfeld; Be'Eri,3,0,36,33
1657550332660,MATH 103A,A02,083778,Greenfeld; Be'Eri,5,0,36,31
1657550332660,MATH 103A,A03,093561,Greenfeld; Be'Eri,5,0,36,31
1657550332660,MATH 103A,B01,083779,Greenfeld; Be'Eri,7,0,36,29
1657550332660,MATH 103A,B02,083780,Greenfeld; Be'Eri,4,0,36,32
1657550332660,MATH 103A,B03,093562,Greenfeld; Be'Eri,3,0,36,33
1657550338704,MATH 105,A01,085443,Carter; Anne Toulson,15,0,35,20
1657550338704,MATH 105,A02,093477,Carter; Anne Toulson,20,0,35,15
1657550344731,MATH 109,A01,083213,Ganzberger; Geoffrey Michael,2,0,34,32
1657550344731,MATH 109,A02,083214,Ganzberger; Geoffrey Michael,4,0,34,30
1657550344731,MATH 109,A03,093478,Ganzberger; Geoffrey Michael,2,0,34,32
1657550344731,MATH 109,B01,083215,Ganzberger; Geoffrey Michael,1,0,32,31
1657550344731,MATH 109,B02,083216,Ganzberger; Geoffrey Michael,2,0,32,30
1657550344731,MATH 109,B03,093479,Ganzberger; Geoffrey Michael,8,0,32,24
1657550350764,MATH 142A,A01,083219,Chow; Bennett,7,0,32,25
1657550350764,MATH 142A,A02,083220,Chow; Bennett,10,0,32,22
1657550350764,MATH 142A,A03,093480,Chow; Bennett,8,0,32,24
1657550350764,MATH 142A,B03,093481,Chow; Bennett,8,0,32,24
1657550350764,MATH 142A,B04,093558,Chow; Bennett,13,0,32,19
1657550350764,MATH 142A,B05,093559,Chow; Bennett,6,0,32,26
1657550356787,MATH 193A,A01,083224,Rotar; Vladimir,8,0,34,26
1657550356787,MATH 193A,A02,083225,Rotar; Vladimir,9,0,34,25
1657550356787,MATH 193A,A03,083781,Rotar; Vladimir,5,0,34,29
1657550356787,MATH 193A,A04,083782,Rotar; Vladimir,10,0,34,24
1657550356787,MATH 193A,A05,093482,Rotar; Vladimir,10,0,34,24
1657550362810,MATH 197,001,091859,McAuley; Julian John,9999,0,9999,0
1657550362810,MATH 197,002,095566,Kedlaya; Kiran S.,9997,0,9999,2
1657550362810,MATH 197,003,095567,Xiao; Ming,9999,0,9999,0
1657550362810,MATH 197,004,095571,Perols; Johan Lars,9998,0,9999,1
1657550369880,COGS 9,A01,083615,Shannon; Kyle Michael,9,0,75,66
1657550375907,COGS 11,A01,083617,Boyle; Mary E. T.,22,0,48,26
1657550381929,COGS 13,A01,083071,Bastos; Amalia Pinkusfeld,11,0,71,60
1657550387953,COGS 14A,A01,092681,Semenuks; Arturs,5,1,100,95
1657550393982,COGS 14B,A01,083073,Cheng; Tzu-Han,6,0,63,57
1657550400010,COGS 17,A01,092677,Semenuks; Arturs,6,0,81,75
1657550406033,COGS 100,A01,083619,Allen; Michael Gordon,17,0,70,53
1657550412059,COGS 101A,A01,083621,Davis; Joshua Daniel,9,0,68,59
1657550418081,COGS 101B,A01,091572,Allen; Michael Gordon,12,0,65,53
1657550424110,COGS 101C,A01,083625,Delgado; Tania,17,0,35,18
1657550430133,COGS 107A,A01,083627,Boyle; Mary E. T.,13,0,60,47
1657550436160,COGS 118A,A01,083075,Gupta; Anjum,21,0,76,55
1657550442184,CSE 3,A50,083646,Miranda; Gregory Joseph,24,0,50,26
1657550448207,CSE 8A,A50,083650,Miranda; Gregory Joseph,17,1,56,39
1657550454235,CSE 11,A01,083080,Cao; Yingjun,6,15,40,34
1657550460260,CSE 12,A01,083652,Krause-Levy; Sophia Louisa,28,1,120,92
1657550466287,CSE 15L,A01,083654,Morris; Justin Loren,9,0,50,41
1657550466287,CSE 15L,A02,083655,Morris; Justin Loren,9,0,50,41
1657550472318,CSE 20,A01,083657,Tran; Khoa Dang,39,0,80,41
1657550478348,CSE 21,A01,095574,Bach; Quang Tran,22,0,48,26
1657550484373,CSE 30,A01,083084,Eldon; John,5,0,80,75
1657550484373,CSE 30,B01,095061,Bhaskar; Nishant,9,0,50,41
1657550490404,CSE 100,A01,083659,Cao; Yingjun,5,4,70,65
1657550496430,CSE 134B,A01,083661,Powell; Thomas Allan,22,0,100,78
1657550502461,CSE 140,A01,083663,Gungor; Onat,15,0,85,70
1657550508486,CSE 140L,A01,083088,Eldon; John,21,0,100,79
1657550514512,CSE 175,A01,083665,Kumar; Rakesh,3,0,25,22
1657550520541,CSE 190,A00,092507,Dubnov; Shlomo,8,0,20,12
1657550526574,ECE 45,A01,083139,Congero; Spencer William,6,0,75,69
1657550532598,ECE 65,A50,083695,Saad; Andrew S,12,0,30,18
1657550532598,ECE 65,A51,095125,Saad; Andrew S,24,0,26,2
1657550538621,ECE 109,A01,091882,Touri; Behrouz,19,0,70,51
1657550544659,ECE 180,A00,083140,Abi Samra; Nicholas Camill,1,0,30,29
1657550544659,ECE 180,B00,083141,Abi Samra; Nicholas Camill,0,0,30,30
1657550550685,MATH 10A,A01,083735,Patchell; Gregory David,2,0,30,28
1657550550685,MATH 10A,A02,083736,Patchell; Gregory David,20,0,30,10
1657550550685,MATH 10A,A03,083737,Patchell; Gregory David,16,0,30,14
1657550556709,MATH 10B,A01,083207,Lim; Seonhee,8,0,34,26
1657550556709,MATH 10B,A02,083208,Lim; Seonhee,9,0,35,26
1657550556709,MATH 10B,A03,093472,Lim; Seonhee,7,0,34,27
1657550556709,MATH 10B,B01,083739,Sinha; Shubham,12,0,30,18
1657550562742,MATH 18,A01,083743,Cinel; Cameron Alexander,7,0,30,23
1657550562742,MATH 18,A02,083744,Cinel; Cameron Alexander,17,0,30,13
1657550562742,MATH 18,A03,083745,Cinel; Cameron Alexander,9,0,30,21
1657550562742,MATH 18,B01,083748,Rideout; David Porter,5,0,37,32
1657550562742,MATH 18,B02,083749,Rideout; David Porter,5,0,36,31
1657550562742,MATH 18,B03,083750,Rideout; David Porter,3,0,37,34
1657550562742,MATH 18,B04,083751,Rideout; David Porter,6,0,36,30
1657550562742,MATH 18,B05,093473,Rideout; David Porter,6,0,36,30
1657550562742,MATH 18,B06,093474,Rideout; David Porter,6,0,36,30
1657550568779,MATH 20A,A01,083754,Zheng; Zequn,14,0,40,26
1657550574809,MATH 20B,A01,083756,Briones; Jor-el Thomas Caparas,4,0,36,32
1657550574809,MATH 20B,A02,083757,Briones; Jor-el Thomas Caparas,1,0,36,35
1657550574809,MATH 20B,A03,093475,Briones; Jor-el Thomas Caparas,2,0,36,34
1657550580833,MATH 20C,A01,083760,Briones; Jor-el Thomas Caparas,1,0,35,34
1657550580833,MATH 20C,A02,083761,Briones; Jor-el Thomas Caparas,8,0,35,27
1657550580833,MATH 20C,A03,093476,Briones; Jor-el Thomas Caparas,0,1,36,36
1657550580833,MATH 20C,B01,083762,Bach; Quang Tran,1,0,30,29
1657550586862,MATH 20D,A01,083765,Tran; Brian Kha,5,0,30,25
1657550586862,MATH 20D,A02,083766,Tran; Brian Kha,5,0,30,25
1657550586862,MATH 20D,A03,083767,Tran; Brian Kha,5,0,30,25
1657550592891,MATH 20E,A01,083771,Ganguly; Soumya,9,0,32,23
1657550592891,MATH 20E,A02,083772,Ganguly; Soumya,6,0,32,26
1657550592891,MATH 20E,B01,083773,Ciotti; Benjamin,20,0,35,15
1657550592891,MATH 20E,B02,083774,Ciotti; Benjamin,17,0,35,18
1657550598931,MATH 103A,A01,083777,Greenfeld; Be'Eri,3,0,36,33
1657550598931,MATH 103A,A02,083778,Greenfeld; Be'Eri,5,0,36,31
1657550598931,MATH 103A,A03,093561,Greenfeld; Be'Eri,5,0,36,31
1657550598931,MATH 103A,B01,083779,Greenfeld; Be'Eri,7,0,36,29
1657550598931,MATH 103A,B02,083780,Greenfeld; Be'Eri,4,0,36,32
1657550598931,MATH 103A,B03,093562,Greenfeld; Be'Eri,3,0,36,33
1657550604959,MATH 105,A01,085443,Carter; Anne Toulson,15,0,35,20
1657550604959,MATH 105,A02,093477,Carter; Anne Toulson,20,0,35,15
1657550610988,MATH 109,A01,083213,Ganzberger; Geoffrey Michael,2,0,34,32
1657550610988,MATH 109,A02,083214,Ganzberger; Geoffrey Michael,4,0,34,30
1657550610988,MATH 109,A03,093478,Ganzberger; Geoffrey Michael,2,0,34,32
1657550610988,MATH 109,B01,083215,Ganzberger; Geoffrey Michael,1,0,32,31
1657550610988,MATH 109,B02,083216,Ganzberger; Geoffrey Michael,2,0,32,30
1657550610988,MATH 109,B03,093479,Ganzberger; Geoffrey Michael,8,0,32,24
1657550617018,MATH 142A,A01,083219,Chow; Bennett,7,0,32,25
1657550617018,MATH 142A,A02,083220,Chow; Bennett,10,0,32,22
1657550617018,MATH 142A,A03,093480,Chow; Bennett,8,0,32,24
1657550617018,MATH 142A,B03,093481,Chow; Bennett,8,0,32,24
1657550617018,MATH 142A,B04,093558,Chow; Bennett,13,0,32,19
1657550617018,MATH 142A,B05,093559,Chow; Bennett,6,0,32,26
1657550623046,MATH 193A,A01,083224,Rotar; Vladimir,8,0,34,26
1657550623046,MATH 193A,A02,083225,Rotar; Vladimir,9,0,34,25
1657550623046,MATH 193A,A03,083781,Rotar; Vladimir,5,0,34,29
1657550623046,MATH 193A,A04,083782,Rotar; Vladimir,10,0,34,24
1657550623046,MATH 193A,A05,093482,Rotar; Vladimir,10,0,34,24
1657550629072,MATH 197,001,091859,McAuley; Julian John,9999,0,9999,0
1657550629072,MATH 197,002,095566,Kedlaya; Kiran S.,9997,0,9999,2
1657550629072,MATH 197,003,095567,Xiao; Ming,9999,0,9999,0
1657550629072,MATH 197,004,095571,Perols; Johan Lars,9998,0,9999,1
1657550636124,COGS 9,A01,083615,Shannon; Kyle Michael,9,0,75,66
1657550642149,COGS 11,A01,083617,Boyle; Mary E. T.,22,0,48,26
1657550648177,COGS 13,A01,083071,Bastos; Amalia Pinkusfeld,11,0,71,60
1657550654201,COGS 14A,A01,092681,Semenuks; Arturs,5,1,100,95
1657550660225,COGS 14B,A01,083073,Cheng; Tzu-Han,6,0,63,57
1657550666248,COGS 17,A01,092677,Semenuks; Arturs,6,0,81,75
1657550672275,COGS 100,A01,083619,Allen; Michael Gordon,17,0,70,53
1657550678303,COGS 101A,A01,083621,Davis; Joshua Daniel,9,0,68,59
1657550684332,COGS 101B,A01,091572,Allen; Michael Gordon,12,0,65,53
1657550690357,COGS 101C,A01,083625,Delgado; Tania,17,0,35,18
1657550696383,COGS 107A,A01,083627,Boyle; Mary E. T.,13,0,60,47
1657550702408,COGS 118A,A01,083075,Gupta; Anjum,21,0,76,55
1657550708434,CSE 3,A50,083646,Miranda; Gregory Joseph,24,0,50,26
1657550714457,CSE 8A,A50,083650,Miranda; Gregory Joseph,17,1,56,39
1657550720484,CSE 11,A01,083080,Cao; Yingjun,6,15,40,34
1657550726507,CSE 12,A01,083652,Krause-Levy; Sophia Louisa,28,1,120,92
1657550732530,CSE 15L,A01,083654,Morris; Justin Loren,9,0,50,41
1657550732530,CSE 15L,A02,083655,Morris; Justin Loren,9,0,50,41
1657550738557,CSE 20,A01,083657,Tran; Khoa Dang,39,0,80,41
1657550744582,CSE 21,A01,095574,Bach; Quang Tran,22,0,48,26
1657550750606,CSE 30,A01,083084,Eldon; John,5,0,80,75
1657550750606,CSE 30,B01,095061,Bhaskar; Nishant,9,0,50,41
1657550756633,CSE 100,A01,083659,Cao; Yingjun,5,4,70,65
1657550762663,CSE 134B,A01,083661,Powell; Thomas Allan,22,0,100,78
1657550768688,CSE 140,A01,083663,Gungor; Onat,15,0,85,70
1657550774711,CSE 140L,A01,083088,Eldon; John,21,0,100,79
1657550780740,CSE 175,A01,083665,Kumar; Rakesh,3,0,25,22
1657550786766,CSE 190,A00,092507,Dubnov; Shlomo,8,0,20,12
1657550792788,ECE 45,A01,083139,Congero; Spencer William,6,0,75,69
1657550798815,ECE 65,A50,083695,Saad; Andrew S,12,0,30,18
1657550798815,ECE 65,A51,095125,Saad; Andrew S,24,0,26,2
1657550804840,ECE 109,A01,091882,Touri; Behrouz,19,0,70,51
1657550810865,ECE 180,A00,083140,Abi Samra; Nicholas Camill,1,0,30,29
1657550810865,ECE 180,B00,083141,Abi Samra; Nicholas Camill,0,0,30,30
1657550816888,MATH 10A,A01,083735,Patchell; Gregory David,2,0,30,28
1657550816888,MATH 10A,A02,083736,Patchell; Gregory David,20,0,30,10
1657550816888,MATH 10A,A03,083737,Patchell; Gregory David,16,0,30,14
1657550822912,MATH 10B,A01,083207,Lim; Seonhee,8,0,34,26
1657550822912,MATH 10B,A02,083208,Lim; Seonhee,9,0,35,26
1657550822912,MATH 10B,A03,093472,Lim; Seonhee,7,0,34,27
1657550822912,MATH 10B,B01,083739,Sinha; Shubham,12,0,30,18
1657550828943,MATH 18,A01,083743,Cinel; Cameron Alexander,7,0,30,23
1657550828943,MATH 18,A02,083744,Cinel; Cameron Alexander,17,0,30,13
1657550828943,MATH 18,A03,083745,Cinel; Cameron Alexander,9,0,30,21
1657550828943,MATH 18,B01,083748,Rideout; David Porter,5,0,37,32
1657550828943,MATH 18,B02,083749,Rideout; David Porter,5,0,36,31
1657550828943,MATH 18,B03,083750,Rideout; David Porter,3,0,37,34
1657550828943,MATH 18,B04,083751,Rideout; David Porter,6,0,36,30
1657550828943,MATH 18,B05,093473,Rideout; David Porter,6,0,36,30
1657550828943,MATH 18,B06,093474,Rideout; David Porter,6,0,36,30
1657550834968,MATH 20A,A01,083754,Zheng; Zequn,14,0,40,26
1657550840997,MATH 20B,A01,083756,Briones; Jor-el Thomas Caparas,4,0,36,32
1657550840997,MATH 20B,A02,083757,Briones; Jor-el Thomas Caparas,1,0,36,35
1657550840997,MATH 20B,A03,093475,Briones; Jor-el Thomas Caparas,2,0,36,34
1657550847023,MATH 20C,A01,083760,Briones; Jor-el Thomas Caparas,1,0,35,34
1657550847023,MATH 20C,A02,083761,Briones; Jor-el Thomas Caparas,8,0,35,27
1657550847023,MATH 20C,A03,093476,Briones; Jor-el Thomas Caparas,0,1,36,36
1657550847023,MATH 20C,B01,083762,Bach; Quang Tran,1,0,30,29
1657550853125,MATH 20D,A01,083765,Tran; Brian Kha,5,0,30,25
1657550853125,MATH 20D,A02,083766,Tran; Brian Kha,5,0,30,25
1657550853125,MATH 20D,A03,083767,Tran; Brian Kha,5,0,30,25
1657550859150,MATH 20E,A01,083771,Ganguly; Soumya,9,0,32,23
1657550859150,MATH 20E,A02,083772,Ganguly; Soumya,6,0,32,26
1657550859150,MATH 20E,B01,083773,Ciotti; Benjamin,20,0,35,15
1657550859150,MATH 20E,B02,083774,Ciotti; Benjamin,17,0,35,18
1657550865175,MATH 103A,A01,083777,Greenfeld; Be'Eri,3,0,36,33
1657550865175,MATH 103A,A02,083778,Greenfeld; Be'Eri,5,0,36,31
1657550865175,MATH 103A,A03,093561,Greenfeld; Be'Eri,5,0,36,31
1657550865175,MATH 103A,B01,083779,Greenfeld; Be'Eri,7,0,36,29
1657550865175,MATH 103A,B02,083780,Greenfeld; Be'Eri,4,0,36,32
1657550865175,MATH 103A,B03,093562,Greenfeld; Be'Eri,3,0,36,33
1657550871200,MATH 105,A01,085443,Carter; Anne Toulson,15,0,35,20
1657550871200,MATH 105,A02,093477,Carter; Anne Toulson,20,0,35,15
1657550877223,MATH 109,A01,083213,Ganzberger; Geoffrey Michael,2,0,34,32
1657550877223,MATH 109,A02,083214,Ganzberger; Geoffrey Michael,4,0,34,30
1657550877223,MATH 109,A03,093478,Ganzberger; Geoffrey Michael,2,0,34,32
1657550877223,MATH 109,B01,083215,Ganzberger; Geoffrey Michael,1,0,32,31
1657550877223,MATH 109,B02,083216,Ganzberger; Geoffrey Michael,2,0,32,30
1657550877223,MATH 109,B03,093479,Ganzberger; Geoffrey Michael,8,0,32,24
1657550883246,MATH 142A,A01,083219,Chow; Bennett,7,0,32,25
1657550883246,MATH 142A,A02,083220,Chow; Bennett,10,0,32,22
1657550883246,MATH 142A,A03,093480,Chow; Bennett,8,0,32,24
1657550883246,MATH 142A,B03,093481,Chow; Bennett,8,0,32,24
1657550883246,MATH 142A,B04,093558,Chow; Bennett,13,0,32,19
1657550883246,MATH 142A,B05,093559,Chow; Bennett,6,0,32,26
1657550889270,MATH 193A,A01,083224,Rotar; Vladimir,8,0,34,26
1657550889270,MATH 193A,A02,083225,Rotar; Vladimir,9,0,34,25
1657550889270,MATH 193A,A03,083781,Rotar; Vladimir,5,0,34,29
1657550889270,MATH 193A,A04,083782,Rotar; Vladimir,10,0,34,24
1657550889270,MATH 193A,A05,093482,Rotar; Vladimir,10,0,34,24
1657550895295,MATH 197,001,091859,McAuley; Julian John,9999,0,9999,0
1657550895295,MATH 197,002,095566,Kedlaya; Kiran S.,9997,0,9999,2
1657550895295,MATH 197,003,095567,Xiao; Ming,9999,0,9999,0
1657550895295,MATH 197,004,095571,Perols; Johan Lars,9998,0,9999,1
1657550902363,COGS 9,A01,083615,Shannon; Kyle Michael,9,0,75,66
1657550908392,COGS 11,A01,083617,Boyle; Mary E. T.,22,0,48,26
1657550914416,COGS 13,A01,083071,Bastos; Amalia Pinkusfeld,11,0,71,60
1657550920442,COGS 14A,A01,092681,Semenuks; Arturs,5,1,100,95
1657550926470,COGS 14B,A01,083073,Cheng; Tzu-Han,6,0,63,57
1657550932496,COGS 17,A01,092677,Semenuks; Arturs,6,0,81,75
1657550938520,COGS 100,A01,083619,Allen; Michael Gordon,17,0,70,53
1657550944543,COGS 101A,A01,083621,Davis; Joshua Daniel,9,0,68,59
1657550950571,COGS 101B,A01,091572,Allen; Michael Gordon,12,0,65,53
1657550956594,COGS 101C,A01,083625,Delgado; Tania,17,0,35,18
1657550962620,COGS 107A,A01,083627,Boyle; Mary E. T.,13,0,60,47
1657550968643,COGS 118A,A01,083075,Gupta; Anjum,21,0,76,55
1657550974670,CSE 3,A50,083646,Miranda; Gregory Joseph,24,0,50,26
1657550980697,CSE 8A,A50,083650,Miranda; Gregory Joseph,17,1,56,39
1657550986723,CSE 11,A01,083080,Cao; Yingjun,6,15,40,34
1657550992747,CSE 12,A01,083652,Krause-Levy; Sophia Louisa,28,1,120,92
1657550998770,CSE 15L,A01,083654,Morris; Justin Loren,9,0,50,41
1657550998770,CSE 15L,A02,083655,Morris; Justin Loren,9,0,50,41
1657551004804,CSE 20,A01,083657,Tran; Khoa Dang,39,0,80,41
1657551010828,CSE 21,A01,095574,Bach; Quang Tran,22,0,48,26
1657551016852,CSE 30,A01,083084,Eldon; John,5,0,80,75
1657551016852,CSE 30,B01,095061,Bhaskar; Nishant,9,0,50,41
1657551022876,CSE 100,A01,083659,Cao; Yingjun,5,4,70,65
1657551028903,CSE 134B,A01,083661,Powell; Thomas Allan,22,0,100,78
1657551034929,CSE 140,A01,083663,Gungor; Onat,15,0,85,70
1657551040957,CSE 140L,A01,083088,Eldon; John,21,0,100,79
1657551046979,CSE 175,A01,083665,Kumar; Rakesh,3,0,25,22
1657551053005,CSE 190,A00,092507,Dubnov; Shlomo,8,0,20,12
1657551059033,ECE 45,A01,083139,Congero; Spencer William,6,0,75,69
1657551065058,ECE 65,A50,083695,Saad; Andrew S,12,0,30,18
1657551065058,ECE 65,A51,095125,Saad; Andrew S,24,0,26,2
1657551071081,ECE 109,A01,091882,Touri; Behrouz,19,0,70,51
1657551077106,ECE 180,A00,083140,Abi Samra; Nicholas Camill,1,0,30,29
1657551077106,ECE 180,B00,083141,Abi Samra; Nicholas Camill,0,0,30,30
1657551083133,MATH 10A,A01,083735,Patchell; Gregory David,2,0,30,28
1657551083133,MATH 10A,A02,083736,Patchell; Gregory David,20,0,30,10
1657551083133,MATH 10A,A03,083737,Patchell; Gregory David,16,0,30,14
1657551089159,MATH 10B,A01,083207,Lim; Seonhee,8,0,34,26
1657551089159,MATH 10B,A02,083208,Lim; Seonhee,9,0,35,26
1657551089159,MATH 10B,A03,093472,Lim; Seonhee,7,0,34,27
1657551089159,MATH 10B,B01,083739,Sinha; Shubham,12,0,30,18
1657551095187,MATH 18,A01,083743,Cinel; Cameron Alexander,7,0,30,23
1657551095187,MATH 18,A02,083744,Cinel; Cameron Alexander,17,0,30,13
1657551095187,MATH 18,A03,083745,Cinel; Cameron Alexander,9,0,30,21
1657551095187,MATH 18,B01,083748,Rideout; David Porter,5,0,37,32
1657551095187,MATH 18,B02,083749,Rideout; David Porter,5,0,36,31
1657551095187,MATH 18,B03,083750,Rideout; David Porter,3,0,37,34
1657551095187,MATH 18,B04,083751,Rideout; David Porter,6,0,36,30
1657551095187,MATH 18,B05,093473,Rideout; David Porter,6,0,36,30
1657551095187,MATH 18,B06,093474,Rideout; David Porter,6,0,36,30
1657551101211,MATH 20A,A01,083754,Zheng; Zequn,14,0,40,26
1657551107242,MATH 20B,A01,083756,Briones; Jor-el Thomas Caparas,4,0,36,32
1657551107242,MATH 20B,A02,083757,Briones; Jor-el Thomas Caparas,1,0,36,35
1657551107242,MATH 20B,A03,093475,Briones; Jor-el Thomas Caparas,2,0,36,34
1657551113266,MATH 20C,A01,083760,Briones; Jor-el Thomas Caparas,1,0,35,34
1657551113266,MATH 20C,A02,083761,Briones; Jor-el Thomas Caparas,8,0,35,27
1657551113266,MATH 20C,A03,093476,Briones; Jor-el Thomas Caparas,0,1,36,36
1657551113266,MATH 20C,B01,083762,Bach; Quang Tran,1,0,30,29
1657551119295,MATH 20D,A01,083765,Tran; Brian Kha,5,0,30,25
1657551119295,MATH 20D,A02,083766,Tran; Brian Kha,5,0,30,25
1657551119295,MATH 20D,A03,083767,Tran; Brian Kha,5,0,30,25
1657551125320,MATH 20E,A01,083771,Ganguly; Soumya,9,0,32,23
1657551125320,MATH 20E,A02,083772,Ganguly; Soumya,6,0,32,26
1657551125320,MATH 20E,B01,083773,Ciotti; Benjamin,20,0,35,15
1657551125320,MATH 20E,B02,083774,Ciotti; Benjamin,17,0,35,18
1657551131350,MATH 103A,A01,083777,Greenfeld; Be'Eri,3,0,36,33
1657551131350,MATH 103A,A02,083778,Greenfeld; Be'Eri,5,0,36,31
1657551131350,MATH 103A,A03,093561,Greenfeld; Be'Eri,5,0,36,31
1657551131350,MATH 103A,B01,083779,Greenfeld; Be'Eri,7,0,36,29
1657551131350,MATH 103A,B02,083780,Greenfeld; Be'Eri,4,0,36,32
1657551131350,MATH 103A,B03,093562,Greenfeld; Be'Eri,3,0,36,33
1657551137378,MATH 105,A01,085443,Carter; Anne Toulson,15,0,35,20
1657551137378,MATH 105,A02,093477,Carter; Anne Toulson,20,0,35,15
1657551143409,MATH 109,A01,083213,Ganzberger; Geoffrey Michael,2,0,34,32
1657551143409,MATH 109,A02,083214,Ganzberger; Geoffrey Michael,4,0,34,30
1657551143409,MATH 109,A03,093478,Ganzberger; Geoffrey Michael,2,0,34,32
1657551143409,MATH 109,B01,083215,Ganzberger; Geoffrey Michael,1,0,32,31
1657551143409,MATH 109,B02,083216,Ganzberger; Geoffrey Michael,2,0,32,30
1657551143409,MATH 109,B03,093479,Ganzberger; Geoffrey Michael,8,0,32,24
1657551149433,MATH 142A,A01,083219,Chow; Bennett,7,0,32,25
1657551149433,MATH 142A,A02,083220,Chow; Bennett,10,0,32,22
1657551149433,MATH 142A,A03,093480,Chow; Bennett,8,0,32,24
1657551149433,MATH 142A,B03,093481,Chow; Bennett,8,0,32,24
1657551149433,MATH 142A,B04,093558,Chow; Bennett,13,0,32,19
1657551149433,MATH 142A,B05,093559,Chow; Bennett,6,0,32,26
1657551155460,MATH 193A,A01,083224,Rotar; Vladimir,8,0,34,26
1657551155460,MATH 193A,A02,083225,Rotar; Vladimir,9,0,34,25
1657551155460,MATH 193A,A03,083781,Rotar; Vladimir,5,0,34,29
1657551155460,MATH 193A,A04,083782,Rotar; Vladimir,10,0,34,24
1657551155460,MATH 193A,A05,093482,Rotar; Vladimir,10,0,34,24
1657551161481,MATH 197,001,091859,McAuley; Julian John,9999,0,9999,0
1657551161481,MATH 197,002,095566,Kedlaya; Kiran S.,9997,0,9999,2
1657551161481,MATH 197,003,095567,Xiao; Ming,9999,0,9999,0
1657551161481,MATH 197,004,095571,Perols; Johan Lars,9998,0,9999,1
1657551168545,COGS 9,A01,083615,Shannon; Kyle Michael,9,0,75,66
1657551174572,COGS 11,A01,083617,Boyle; Mary E. T.,22,0,48,26
1657551180601,COGS 13,A01,083071,Bastos; Amalia Pinkusfeld,11,0,71,60
1657551186629,COGS 14A,A01,092681,Semenuks; Arturs,5,1,100,95
1657551192655,COGS 14B,A01,083073,Cheng; Tzu-Han,6,0,63,57
1657551198681,COGS 17,A01,092677,Semenuks; Arturs,6,0,81,75
1657551204708,COGS 100,A01,083619,Allen; Michael Gordon,17,0,70,53
1657551210733,COGS 101A,A01,083621,Davis; Joshua Daniel,9,0,68,59
1657551216757,COGS 101B,A01,091572,Allen; Michael Gordon,12,0,65,53
1657551222780,COGS 101C,A01,083625,Delgado; Tania,17,0,35,18
1657551228805,COGS 107A,A01,083627,Boyle; Mary E. T.,13,0,60,47
1657551234831,COGS 118A,A01,083075,Gupta; Anjum,21,0,76,55
1657551240868,CSE 3,A50,083646,Miranda; Gregory Joseph,24,0,50,26
1657551246903,CSE 8A,A50,083650,Miranda; Gregory Joseph,17,1,56,39
1657551252930,CSE 11,A01,083080,Cao; Yingjun,6,15,40,34
1657551258955,CSE 12,A01,083652,Krause-Levy; Sophia Louisa,28,1,120,92
1657551264980,CSE 15L,A01,083654,Morris; Justin Loren,9,0,50,41
1657551264980,CSE 15L,A02,083655,Morris; Justin Loren,9,0,50,41
1657551271007,CSE 20,A01,083657,Tran; Khoa Dang,39,0,80,41
1657551277035,CSE 21,A01,095574,Bach; Quang Tran,22,0,48,26
1657551283058,CSE 30,A01,083084,Eldon; John,5,0,80,75
1657551283058,CSE 30,B01,095061,Bhaskar; Nishant,9,0,50,41
1657551289082,CSE 100,A01,083659,Cao; Yingjun,5,4,70,65
1657551295109,CSE 134B,A01,083661,Powell; Thomas Allan,22,0,100,78
1657551301139,CSE 140,A01,083663,Gungor; Onat,15,0,85,70
1657551307167,CSE 140L,A01,083088,Eldon; John,21,0,100,79
1657551313192,CSE 175,A01,083665,Kumar; Rakesh,3,0,25,22
1657551319217,CSE 190,A00,092507,Dubnov; Shlomo,8,0,20,12
1657551325244,ECE 45,A01,083139,Congero; Spencer William,6,0,75,69
1657551331273,ECE 65,A50,083695,Saad; Andrew S,12,0,30,18
1657551331273,ECE 65,A51,095125,Saad; Andrew S,24,0,26,2
1657551337302,ECE 109,A01,091882,Touri; Behrouz,19,0,70,51
1657551343328,ECE 180,A00,083140,Abi Samra; Nicholas Camill,1,0,30,29
1657551343328,ECE 180,B00,083141,Abi Samra; Nicholas Camill,0,0,30,30
1657551349349,MATH 10A,A01,083735,Patchell; Gregory David,2,0,30,28
1657551349349,MATH 10A,A02,083736,Patchell; Gregory David,20,0,30,10
1657551349349,MATH 10A,A03,083737,Patchell; Gregory David,16,0,30,14
1657551355378,MATH 10B,A01,083207,Lim; Seonhee,8,0,34,26
1657551355378,MATH 10B,A02,083208,Lim; Seonhee,9,0,35,26
1657551355378,MATH 10B,A03,093472,Lim; Seonhee,7,0,34,27
1657551355378,MATH 10B,B01,083739,Sinha; Shubham,12,0,30,18
1657551361402,MATH 18,A01,083743,Cinel; Cameron Alexander,7,0,30,23
1657551361402,MATH 18,A02,083744,Cinel; Cameron Alexander,17,0,30,13
1657551361402,MATH 18,A03,083745,Cinel; Cameron Alexander,9,0,30,21
1657551361402,MATH 18,B01,083748,Rideout; David Porter,5,0,37,32
1657551361402,MATH 18,B02,083749,Rideout; David Porter,5,0,36,31
1657551361402,MATH 18,B03,083750,Rideout; David Porter,3,0,37,34
1657551361402,MATH 18,B04,083751,Rideout; David Porter,6,0,36,30
1657551361402,MATH 18,B05,093473,Rideout; David Porter,6,0,36,30
1657551361402,MATH 18,B06,093474,Rideout; David Porter,6,0,36,30
1657551367426,MATH 20A,A01,083754,Zheng; Zequn,14,0,40,26
1657551373449,MATH 20B,A01,083756,Briones; Jor-el Thomas Caparas,4,0,36,32
1657551373449,MATH 20B,A02,083757,Briones; Jor-el Thomas Caparas,1,0,36,35
1657551373449,MATH 20B,A03,093475,Briones; Jor-el Thomas Caparas,2,0,36,34
1657551379474,MATH 20C,A01,083760,Briones; Jor-el Thomas Caparas,1,0,35,34
1657551379474,MATH 20C,A02,083761,Briones; Jor-el Thomas Caparas,8,0,35,27
1657551379474,MATH 20C,A03,093476,Briones; Jor-el Thomas Caparas,0,1,36,36
1657551379474,MATH 20C,B01,083762,Bach; Quang Tran,1,0,30,29
1657551385505,MATH 20D,A01,083765,Tran; Brian Kha,5,0,30,25
1657551385505,MATH 20D,A02,083766,Tran; Brian Kha,5,0,30,25
1657551385505,MATH 20D,A03,083767,Tran; Brian Kha,5,0,30,25
1657551391530,MATH 20E,A01,083771,Ganguly; Soumya,9,0,32,23
1657551391530,MATH 20E,A02,083772,Ganguly; Soumya,6,0,32,26
1657551391530,MATH 20E,B01,083773,Ciotti; Benjamin,20,0,35,15
1657551391530,MATH 20E,B02,083774,Ciotti; Benjamin,17,0,35,18
1657551397557,MATH 103A,A01,083777,Greenfeld; Be'Eri,3,0,36,33
1657551397557,MATH 103A,A02,083778,Greenfeld; Be'Eri,5,0,36,31
1657551397557,MATH 103A,A03,093561,Greenfeld; Be'Eri,5,0,36,31
1657551397557,MATH 103A,B01,083779,Greenfeld; Be'Eri,7,0,36,29
1657551397557,MATH 103A,B02,083780,Greenfeld; Be'Eri,4,0,36,32
1657551397557,MATH 103A,B03,093562,Greenfeld; Be'Eri,3,0,36,33
1657551403579,MATH 105,A01,085443,Carter; Anne Toulson,15,0,35,20
1657551403579,MATH 105,A02,093477,Carter; Anne Toulson,20,0,35,15
1657551409603,MATH 109,A01,083213,Ganzberger; Geoffrey Michael,2,0,34,32
1657551409603,MATH 109,A02,083214,Ganzberger; Geoffrey Michael,4,0,34,30
1657551409603,MATH 109,A03,093478,Ganzberger; Geoffrey Michael,2,0,34,32
1657551409603,MATH 109,B01,083215,Ganzberger; Geoffrey Michael,1,0,32,31
1657551409603,MATH 109,B02,083216,Ganzberger; Geoffrey Michael,2,0,32,30
1657551409603,MATH 109,B03,093479,Ganzberger; Geoffrey Michael,8,0,32,24
1657551415628,MATH 142A,A01,083219,Chow; Bennett,7,0,32,25
1657551415628,MATH 142A,A02,083220,Chow; Bennett,10,0,32,22
1657551415628,MATH 142A,A03,093480,Chow; Bennett,8,0,32,24
1657551415628,MATH 142A,B03,093481,Chow; Bennett,8,0,32,24
1657551415628,MATH 142A,B04,093558,Chow; Bennett,13,0,32,19
1657551415628,MATH 142A,B05,093559,Chow; Bennett,6,0,32,26
1657551421651,MATH 193A,A01,083224,Rotar; Vladimir,8,0,34,26
1657551421651,MATH 193A,A02,083225,Rotar; Vladimir,9,0,34,25
1657551421651,MATH 193A,A03,083781,Rotar; Vladimir,5,0,34,29
1657551421651,MATH 193A,A04,083782,Rotar; Vladimir,10,0,34,24
1657551421651,MATH 193A,A05,093482,Rotar; Vladimir,10,0,34,24
1657551427677,MATH 197,001,091859,McAuley; Julian John,9999,0,9999,0
1657551427677,MATH 197,002,095566,Kedlaya; Kiran S.,9997,0,9999,2
1657551427677,MATH 197,003,095567,Xiao; Ming,9999,0,9999,0
1657551427677,MATH 197,004,095571,Perols; Johan Lars,9998,0,9999,1
1657551434731,COGS 9,A01,083615,Shannon; Kyle Michael,9,0,75,66
1657551440758,COGS 11,A01,083617,Boyle; Mary E. T.,22,0,48,26
1657551446857,COGS 13,A01,083071,Bastos; Amalia Pinkusfeld,11,0,71,60
1657551452883,COGS 14A,A01,092681,Semenuks; Arturs,5,1,100,95
1657551458909,COGS 14B,A01,083073,Cheng; Tzu-Han,6,0,63,57
1657551464932,COGS 17,A01,092677,Semenuks; Arturs,6,0,81,75
1657551470960,COGS 100,A01,083619,Allen; Michael Gordon,17,0,70,53
1657551476983,COGS 101A,A01,083621,Davis; Joshua Daniel,9,0,68,59
1657551483008,COGS 101B,A01,091572,Allen; Michael Gordon,12,0,65,53
1657551489031,COGS 101C,A01,083625,Delgado; Tania,17,0,35,18
1657551495059,COGS 107A,A01,083627,Boyle; Mary E. T.,13,0,60,47
1657551501081,COGS 118A,A01,083075,Gupta; Anjum,21,0,76,55
1657551507116,CSE 3,A50,083646,Miranda; Gregory Joseph,24,0,50,26
1657551513152,CSE 8A,A50,083650,Miranda; Gregory Joseph,17,1,56,39
1657551519177,CSE 11,A01,083080,Cao; Yingjun,6,15,40,34
1657551525201,CSE 12,A01,083652,Krause-Levy; Sophia Louisa,28,1,120,92
1657551531225,CSE 15L,A01,083654,Morris; Justin Loren,9,0,50,41
1657551531225,CSE 15L,A02,083655,Morris; Justin Loren,9,0,50,41
1657551537248,CSE 20,A01,083657,Tran; Khoa Dang,39,0,80,41
1657551543276,CSE 21,A01,095574,Bach; Quang Tran,22,0,48,26
1657551549300,CSE 30,A01,083084,Eldon; John,5,0,80,75
1657551549300,CSE 30,B01,095061,Bhaskar; Nishant,9,0,50,41
1657551555326,CSE 100,A01,083659,Cao; Yingjun,5,4,70,65
1657551561353,CSE 134B,A01,083661,Powell; Thomas Allan,22,0,100,78
1657551567381,CSE 140,A01,083663,Gungor; Onat,15,0,85,70
1657551573404,CSE 140L,A01,083088,Eldon; John,21,0,100,79
1657551579427,CSE 175,A01,083665,Kumar; Rakesh,3,0,25,22
1657551585449,CSE 190,A00,092507,Dubnov; Shlomo,8,0,20,12
1657551591476,ECE 45,A01,083139,Congero; Spencer William,6,0,75,69
1657551597500,ECE 65,A50,083695,Saad; Andrew S,12,0,30,18
1657551597500,ECE 65,A51,095125,Saad; Andrew S,24,0,26,2
1657551603531,ECE 109,A01,091882,Touri; Behrouz,19,0,70,51
1657551609558,ECE 180,A00,083140,Abi Samra; Nicholas Camill,1,0,30,29
1657551609558,ECE 180,B00,083141,Abi Samra; Nicholas Camill,0,0,30,30
1657551615585,MATH 10A,A01,083735,Patchell; Gregory David,2,0,30,28
1657551615585,MATH 10A,A02,083736,Patchell; Gregory David,20,0,30,10
1657551615585,MATH 10A,A03,083737,Patchell; Gregory David,16,0,30,14
1657551621612,MATH 10B,A01,083207,Lim; Seonhee,8,0,34,26
1657551621612,MATH 10B,A02,083208,Lim; Seonhee,9,0,35,26
1657551621612,MATH 10B,A03,093472,Lim; Seonhee,7,0,34,27
1657551621612,MATH 10B,B01,083739,Sinha; Shubham,12,0,30,18
1657551627644,MATH 18,A01,083743,Cinel; Cameron Alexander,7,0,30,23
1657551627644,MATH 18,A02,083744,Cinel; Cameron Alexander,17,0,30,13
1657551627644,MATH 18,A03,083745,Cinel; Cameron Alexander,9,0,30,21
1657551627644,MATH 18,B01,083748,Rideout; David Porter,5,0,37,32
1657551627644,MATH 18,B02,083749,Rideout; David Porter,5,0,36,31
1657551627644,MATH 18,B03,083750,Rideout; David Porter,3,0,37,34
1657551627644,MATH 18,B04,083751,Rideout; David Porter,6,0,36,30
1657551627644,MATH 18,B05,093473,Rideout; David Porter,6,0,36,30
1657551627644,MATH 18,B06,093474,Rideout; David Porter,6,0,36,30
1657551633667,MATH 20A,A01,083754,Zheng; Zequn,14,0,40,26
1657551639700,MATH 20B,A01,083756,Briones; Jor-el Thomas Caparas,4,0,36,32
1657551639700,MATH 20B,A02,083757,Briones; Jor-el Thomas Caparas,1,0,36,35
1657551639700,MATH 20B,A03,093475,Briones; Jor-el Thomas Caparas,2,0,36,34
1657551645727,MATH 20C,A01,083760,Briones; Jor-el Thomas Caparas,1,0,35,34
1657551645727,MATH 20C,A02,083761,Briones; Jor-el Thomas Caparas,8,0,35,27
1657551645727,MATH 20C,A03,093476,Briones; Jor-el Thomas Caparas,0,1,36,36
1657551645727,MATH 20C,B01,083762,Bach; Quang Tran,1,0,30,29
1657551651761,MATH 20D,A01,083765,Tran; Brian Kha,5,0,30,25
1657551651761,MATH 20D,A02,083766,Tran; Brian Kha,5,0,30,25
1657551651761,MATH 20D,A03,083767,Tran; Brian Kha,5,0,30,25
1657551657784,MATH 20E,A01,083771,Ganguly; Soumya,9,0,32,23
1657551657784,MATH 20E,A02,083772,Ganguly; Soumya,6,0,32,26
1657551657784,MATH 20E,B01,083773,Ciotti; Benjamin,20,0,35,15
1657551657784,MATH 20E,B02,083774,Ciotti; Benjamin,17,0,35,18
1657551663823,MATH 103A,A01,083777,Greenfeld; Be'Eri,3,0,36,33
1657551663823,MATH 103A,A02,083778,Greenfeld; Be'Eri,5,0,36,31
1657551663823,MATH 103A,A03,093561,Greenfeld; Be'Eri,5,0,36,31
1657551663823,MATH 103A,B01,083779,Greenfeld; Be'Eri,7,0,36,29
1657551663823,MATH 103A,B02,083780,Greenfeld; Be'Eri,4,0,36,32
1657551663823,MATH 103A,B03,093562,Greenfeld; Be'Eri,3,0,36,33
1657551669856,MATH 105,A01,085443,Carter; Anne Toulson,15,0,35,20
1657551669856,MATH 105,A02,093477,Carter; Anne Toulson,20,0,35,15
1657551675882,MATH 109,A01,083213,Ganzberger; Geoffrey Michael,2,0,34,32
1657551675882,MATH 109,A02,083214,Ganzberger; Geoffrey Michael,4,0,34,30
1657551675882,MATH 109,A03,093478,Ganzberger; Geoffrey Michael,2,0,34,32
1657551675882,MATH 109,B01,083215,Ganzberger; Geoffrey Michael,1,0,32,31
1657551675882,MATH 109,B02,083216,Ganzberger; Geoffrey Michael,2,0,32,30
1657551675882,MATH 109,B03,093479,Ganzberger; Geoffrey Michael,8,0,32,24
1657551681910,MATH 142A,A01,083219,Chow; Bennett,7,0,32,25
1657551681910,MATH 142A,A02,083220,Chow; Bennett,10,0,32,22
1657551681910,MATH 142A,A03,093480,Chow; Bennett,8,0,32,24
1657551681910,MATH 142A,B03,093481,Chow; Bennett,8,0,32,24
1657551681910,MATH 142A,B04,093558,Chow; Bennett,13,0,32,19
1657551681910,MATH 142A,B05,093559,Chow; Bennett,6,0,32,26
1657551687933,MATH 193A,A01,083224,Rotar; Vladimir,8,0,34,26
1657551687933,MATH 193A,A02,083225,Rotar; Vladimir,9,0,34,25
1657551687933,MATH 193A,A03,083781,Rotar; Vladimir,5,0,34,29
1657551687933,MATH 193A,A04,083782,Rotar; Vladimir,10,0,34,24
1657551687933,MATH 193A,A05,093482,Rotar; Vladimir,10,0,34,24
1657551693960,MATH 197,001,091859,McAuley; Julian John,9999,0,9999,0
1657551693960,MATH 197,002,095566,Kedlaya; Kiran S.,9997,0,9999,2
1657551693960,MATH 197,003,095567,Xiao; Ming,9999,0,9999,0
1657551693960,MATH 197,004,095571,Perols; Johan Lars,9998,0,9999,1
1657551701027,COGS 9,A01,083615,Shannon; Kyle Michael,9,0,75,66
1657551707096,COGS 11,A01,083617,Boyle; Mary E. T.,22,0,48,26
1657551713122,COGS 13,A01,083071,Bastos; Amalia Pinkusfeld,11,0,71,60
1657551719144,COGS 14A,A01,092681,Semenuks; Arturs,5,1,100,95
1657551725172,COGS 14B,A01,083073,Cheng; Tzu-Han,6,0,63,57
1657551731198,COGS 17,A01,092677,Semenuks; Arturs,6,0,81,75
1657551737220,COGS 100,A01,083619,Allen; Michael Gordon,17,0,70,53
1657551743249,COGS 101A,A01,083621,Davis; Joshua Daniel,9,0,68,59
1657551749273,COGS 101B,A01,091572,Allen; Michael Gordon,12,0,65,53
1657551755302,COGS 101C,A01,083625,Delgado; Tania,17,0,35,18
1657551761324,COGS 107A,A01,083627,Boyle; Mary E. T.,13,0,60,47
1657551767355,COGS 118A,A01,083075,Gupta; Anjum,21,0,76,55
1657551773382,CSE 3,A50,083646,Miranda; Gregory Joseph,24,0,50,26
1657551779405,CSE 8A,A50,083650,Miranda; Gregory Joseph,17,1,56,39
1657551785439,CSE 11,A01,083080,Cao; Yingjun,6,15,40,34
1657551791472,CSE 12,A01,083652,Krause-Levy; Sophia Louisa,28,1,120,92
1657551797497,CSE 15L,A01,083654,Morris; Justin Loren,9,0,50,41
1657551797497,CSE 15L,A02,083655,Morris; Justin Loren,9,0,50,41
1657551803522,CSE 20,A01,083657,Tran; Khoa Dang,39,0,80,41
1657551809548,CSE 21,A01,095574,Bach; Quang Tran,22,0,48,26
1657551815572,CSE 30,A01,083084,Eldon; John,5,0,80,75
1657551815572,CSE 30,B01,095061,Bhaskar; Nishant,9,0,50,41
1657551821600,CSE 100,A01,083659,Cao; Yingjun,5,4,70,65
1657551827633,CSE 134B,A01,083661,Powell; Thomas Allan,22,0,100,78
1657551833660,CSE 140,A01,083663,Gungor; Onat,15,0,85,70
1657551839704,CSE 140L,A01,083088,Eldon; John,21,0,100,79
1657551845726,CSE 175,A01,083665,Kumar; Rakesh,3,0,25,22
1657551851754,CSE 190,A00,092507,Dubnov; Shlomo,8,0,20,12
1657551857778,ECE 45,A01,083139,Congero; Spencer William,6,0,75,69
1657551863819,ECE 65,A50,083695,Saad; Andrew S,12,0,30,18
1657551863819,ECE 65,A51,095125,Saad; Andrew S,24,0,26,2
1657551869847,ECE 109,A01,091882,Touri; Behrouz,19,0,70,51
1657551875877,ECE 180,A00,083140,Abi Samra; Nicholas Camill,1,0,30,29
1657551875877,ECE 180,B00,083141,Abi Samra; Nicholas Camill,0,0,30,30
1657551881906,MATH 10A,A01,083735,Patchell; Gregory David,2,0,30,28
1657551881906,MATH 10A,A02,083736,Patchell; Gregory David,20,0,30,10
1657551881906,MATH 10A,A03,083737,Patchell; Gregory David,16,0,30,14
1657551887939,MATH 10B,A01,083207,Lim; Seonhee,8,0,34,26
1657551887939,MATH 10B,A02,083208,Lim; Seonhee,9,0,35,26
1657551887939,MATH 10B,A03,093472,Lim; Seonhee,7,0,34,27
1657551887939,MATH 10B,B01,083739,Sinha; Shubham,12,0,30,18
1657551893971,MATH 18,A01,083743,Cinel; Cameron Alexander,7,0,30,23
1657551893971,MATH 18,A02,083744,Cinel; Cameron Alexander,17,0,30,13
1657551893971,MATH 18,A03,083745,Cinel; Cameron Alexander,9,0,30,21
1657551893971,MATH 18,B01,083748,Rideout; David Porter,5,0,37,32
1657551893971,MATH 18,B02,083749,Rideout; David Porter,5,0,36,31
1657551893971,MATH 18,B03,083750,Rideout; David Porter,3,0,37,34
1657551893971,MATH 18,B04,083751,Rideout; David Porter,6,0,36,30
1657551893971,MATH 18,B05,093473,Rideout; David Porter,6,0,36,30
1657551893971,MATH 18,B06,093474,Rideout; David Porter,6,0,36,30
1657551899999,MATH 20A,A01,083754,Zheng; Zequn,14,0,40,26
1657551906029,MATH 20B,A01,083756,Briones; Jor-el Thomas Caparas,4,0,36,32
1657551906029,MATH 20B,A02,083757,Briones; Jor-el Thomas Caparas,1,0,36,35
1657551906029,MATH 20B,A03,093475,Briones; Jor-el Thomas Caparas,2,0,36,34
1657551912061,MATH 20C,A01,083760,Briones; Jor-el Thomas Caparas,1,0,35,34
1657551912061,MATH 20C,A02,083761,Briones; Jor-el Thomas Caparas,8,0,35,27
1657551912061,MATH 20C,A03,093476,Briones; Jor-el Thomas Caparas,0,1,36,36
1657551912061,MATH 20C,B01,083762,Bach; Quang Tran,1,0,30,29
1657551918089,MATH 20D,A01,083765,Tran; Brian Kha,5,0,30,25
1657551918089,MATH 20D,A02,083766,Tran; Brian Kha,5,0,30,25
1657551918089,MATH 20D,A03,083767,Tran; Brian Kha,5,0,30,25
1657551924116,MATH 20E,A01,083771,Ganguly; Soumya,9,0,32,23
1657551924116,MATH 20E,A02,083772,Ganguly; Soumya,6,0,32,26
1657551924116,MATH 20E,B01,083773,Ciotti; Benjamin,20,0,35,15
1657551924116,MATH 20E,B02,083774,Ciotti; Benjamin,17,0,35,18
1657551930142,MATH 103A,A01,083777,Greenfeld; Be'Eri,3,0,36,33
1657551930142,MATH 103A,A02,083778,Greenfeld; Be'Eri,5,0,36,31
1657551930142,MATH 103A,A03,093561,Greenfeld; Be'Eri,5,0,36,31
1657551930142,MATH 103A,B01,083779,Greenfeld; Be'Eri,7,0,36,29
1657551930142,MATH 103A,B02,083780,Greenfeld; Be'Eri,4,0,36,32
1657551930142,MATH 103A,B03,093562,Greenfeld; Be'Eri,3,0,36,33
1657551936174,MATH 105,A01,085443,Carter; Anne Toulson,15,0,35,20
1657551936174,MATH 105,A02,093477,Carter; Anne Toulson,20,0,35,15
1657551942204,MATH 109,A01,083213,Ganzberger; Geoffrey Michael,2,0,34,32
1657551942204,MATH 109,A02,083214,Ganzberger; Geoffrey Michael,4,0,34,30
1657551942204,MATH 109,A03,093478,Ganzberger; Geoffrey Michael,2,0,34,32
1657551942204,MATH 109,B01,083215,Ganzberger; Geoffrey Michael,1,0,32,31
1657551942204,MATH 109,B02,083216,Ganzberger; Geoffrey Michael,2,0,32,30
1657551942204,MATH 109,B03,093479,Ganzberger; Geoffrey Michael,8,0,32,24
1657551948229,MATH 142A,A01,083219,Chow; Bennett,7,0,32,25
1657551948229,MATH 142A,A02,083220,Chow; Bennett,10,0,32,22
1657551948229,MATH 142A,A03,093480,Chow; Bennett,8,0,32,24
1657551948229,MATH 142A,B03,093481,Chow; Bennett,8,0,32,24
1657551948229,MATH 142A,B04,093558,Chow; Bennett,13,0,32,19
1657551948229,MATH 142A,B05,093559,Chow; Bennett,6,0,32,26
1657551954259,MATH 193A,A01,083224,Rotar; Vladimir,8,0,34,26
1657551954259,MATH 193A,A02,083225,Rotar; Vladimir,9,0,34,25
1657551954259,MATH 193A,A03,083781,Rotar; Vladimir,5,0,34,29
1657551954259,MATH 193A,A04,083782,Rotar; Vladimir,10,0,34,24
1657551954259,MATH 193A,A05,093482,Rotar; Vladimir,10,0,34,24
1657551960294,MATH 197,001,091859,McAuley; Julian John,9999,0,9999,0
1657551960294,MATH 197,002,095566,Kedlaya; Kiran S.,9997,0,9999,2
1657551960294,MATH 197,003,095567,Xiao; Ming,9999,0,9999,0
1657551960294,MATH 197,004,095571,Perols; Johan Lars,9998,0,9999,1
1657551967365,COGS 9,A01,083615,Shannon; Kyle Michael,9,0,75,66
1657551973391,COGS 11,A01,083617,Boyle; Mary E. T.,22,0,48,26
1657551979417,COGS 13,A01,083071,Bastos; Amalia Pinkusfeld,11,0,71,60
1657551985442,COGS 14A,A01,092681,Semenuks; Arturs,5,1,100,95
1657551991466,COGS 14B,A01,083073,Cheng; Tzu-Han,6,0,63,57
1657551997494,COGS 17,A01,092677,Semenuks; Arturs,6,0,81,75
1657552003522,COGS 100,A01,083619,Allen; Michael Gordon,17,0,70,53
1657552009552,COGS 101A,A01,083621,Davis; Joshua Daniel,9,0,68,59
1657552015580,COGS 101B,A01,091572,Allen; Michael Gordon,12,0,65,53
1657552021606,COGS 101C,A01,083625,Delgado; Tania,17,0,35,18
1657552027631,COGS 107A,A01,083627,Boyle; Mary E. T.,13,0,60,47
1657552033655,COGS 118A,A01,083075,Gupta; Anjum,21,0,76,55
1657552039679,CSE 3,A50,083646,Miranda; Gregory Joseph,24,0,50,26
1657552045824,CSE 8A,A50,083650,Miranda; Gregory Joseph,17,1,56,39
1657552051849,CSE 11,A01,083080,Cao; Yingjun,6,15,40,34
1657552057873,CSE 12,A01,083652,Krause-Levy; Sophia Louisa,28,1,120,92
1657552063901,CSE 15L,A01,083654,Morris; Justin Loren,9,0,50,41
1657552063901,CSE 15L,A02,083655,Morris; Justin Loren,9,0,50,41
1657552069925,CSE 20,A01,083657,Tran; Khoa Dang,39,0,80,41
1657552075952,CSE 21,A01,095574,Bach; Quang Tran,22,0,48,26
1657552081976,CSE 30,A01,083084,Eldon; John,5,0,80,75
1657552081976,CSE 30,B01,095061,Bhaskar; Nishant,9,0,50,41
1657552087998,CSE 100,A01,083659,Cao; Yingjun,5,4,70,65
1657552094038,CSE 134B,A01,083661,Powell; Thomas Allan,22,0,100,78
1657552100065,CSE 140,A01,083663,Gungor; Onat,15,0,85,70
1657552106096,CSE 140L,A01,083088,Eldon; John,21,0,100,79
1657552112127,CSE 175,A01,083665,Kumar; Rakesh,3,0,25,22
1657552118154,CSE 190,A00,092507,Dubnov; Shlomo,8,0,20,12
1657552124182,ECE 45,A01,083139,Congero; Spencer William,6,0,75,69
1657552130211,ECE 65,A50,083695,Saad; Andrew S,12,0,30,18
1657552130211,ECE 65,A51,095125,Saad; Andrew S,24,0,26,2
1657552136238,ECE 109,A01,091882,Touri; Behrouz,19,0,70,51
1657552142263,ECE 180,A00,083140,Abi Samra; Nicholas Camill,1,0,30,29
1657552142263,ECE 180,B00,083141,Abi Samra; Nicholas Camill,0,0,30,30
1657552148296,MATH 10A,A01,083735,Patchell; Gregory David,2,0,30,28
1657552148296,MATH 10A,A02,083736,Patchell; Gregory David,20,0,30,10
1657552148296,MATH 10A,A03,083737,Patchell; Gregory David,16,0,30,14
1657552154325,MATH 10B,A01,083207,Lim; Seonhee,8,0,34,26
1657552154325,MATH 10B,A02,083208,Lim; Seonhee,9,0,35,26
1657552154325,MATH 10B,A03,093472,Lim; Seonhee,7,0,34,27
1657552154325,MATH 10B,B01,083739,Sinha; Shubham,12,0,30,18
1657552160358,MATH 18,A01,083743,Cinel; Cameron Alexander,7,0,30,23
1657552160358,MATH 18,A02,083744,Cinel; Cameron Alexander,17,0,30,13
1657552160358,MATH 18,A03,083745,Cinel; Cameron Alexander,9,0,30,21
1657552160358,MATH 18,B01,083748,Rideout; David Porter,5,0,37,32
1657552160358,MATH 18,B02,083749,Rideout; David Porter,5,0,36,31
1657552160358,MATH 18,B03,083750,Rideout; David Porter,3,0,37,34
1657552160358,MATH 18,B04,083751,Rideout; David Porter,6,0,36,30
1657552160358,MATH 18,B05,093473,Rideout; David Porter,6,0,36,30
1657552160358,MATH 18,B06,093474,Rideout; David Porter,6,0,36,30
1657552166386,MATH 20A,A01,083754,Zheng; Zequn,14,0,40,26
1657552172420,MATH 20B,A01,083756,Briones; Jor-el Thomas Caparas,4,0,36,32
1657552172420,MATH 20B,A02,083757,Briones; Jor-el Thomas Caparas,1,0,36,35
1657552172420,MATH 20B,A03,093475,Briones; Jor-el Thomas Caparas,2,0,36,34
1657552178445,MATH 20C,A01,083760,Briones; Jor-el Thomas Caparas,1,0,35,34
1657552178445,MATH 20C,A02,083761,Briones; Jor-el Thomas Caparas,8,0,35,27
1657552178445,MATH 20C,A03,093476,Briones; Jor-el Thomas Caparas,0,1,36,36
1657552178445,MATH 20C,B01,083762,Bach; Quang Tran,1,0,30,29
1657552184476,MATH 20D,A01,083765,Tran; Brian Kha,5,0,30,25
1657552184476,MATH 20D,A02,083766,Tran; Brian Kha,5,0,30,25
1657552184476,MATH 20D,A03,083767,Tran; Brian Kha,5,0,30,25
1657552190502,MATH 20E,A01,083771,Ganguly; Soumya,9,0,32,23
1657552190502,MATH 20E,A02,083772,Ganguly; Soumya,6,0,32,26
1657552190502,MATH 20E,B01,083773,Ciotti; Benjamin,20,0,35,15
1657552190502,MATH 20E,B02,083774,Ciotti; Benjamin,17,0,35,18
1657552196537,MATH 103A,A01,083777,Greenfeld; Be'Eri,3,0,36,33
1657552196537,MATH 103A,A02,083778,Greenfeld; Be'Eri,5,0,36,31
1657552196537,MATH 103A,A03,093561,Greenfeld; Be'Eri,5,0,36,31
1657552196537,MATH 103A,B01,083779,Greenfeld; Be'Eri,7,0,36,29
1657552196537,MATH 103A,B02,083780,Greenfeld; Be'Eri,4,0,36,32
1657552196537,MATH 103A,B03,093562,Greenfeld; Be'Eri,3,0,36,33
1657552202565,MATH 105,A01,085443,Carter; Anne Toulson,15,0,35,20
1657552202565,MATH 105,A02,093477,Carter; Anne Toulson,20,0,35,15
1657552208596,MATH 109,A01,083213,Ganzberger; Geoffrey Michael,2,0,34,32
1657552208596,MATH 109,A02,083214,Ganzberger; Geoffrey Michael,4,0,34,30
1657552208596,MATH 109,A03,093478,Ganzberger; Geoffrey Michael,2,0,34,32
1657552208596,MATH 109,B01,083215,Ganzberger; Geoffrey Michael,1,0,32,31
1657552208596,MATH 109,B02,083216,Ganzberger; Geoffrey Michael,2,0,32,30
1657552208596,MATH 109,B03,093479,Ganzberger; Geoffrey Michael,8,0,32,24
1657552214620,MATH 142A,A01,083219,Chow; Bennett,7,0,32,25
1657552214620,MATH 142A,A02,083220,Chow; Bennett,10,0,32,22
1657552214620,MATH 142A,A03,093480,Chow; Bennett,8,0,32,24
1657552214620,MATH 142A,B03,093481,Chow; Bennett,8,0,32,24
1657552214620,MATH 142A,B04,093558,Chow; Bennett,13,0,32,19
1657552214620,MATH 142A,B05,093559,Chow; Bennett,6,0,32,26
1657552220649,MATH 193A,A01,083224,Rotar; Vladimir,8,0,34,26
1657552220649,MATH 193A,A02,083225,Rotar; Vladimir,9,0,34,25
1657552220649,MATH 193A,A03,083781,Rotar; Vladimir,5,0,34,29
1657552220649,MATH 193A,A04,083782,Rotar; Vladimir,10,0,34,24
1657552220649,MATH 193A,A05,093482,Rotar; Vladimir,10,0,34,24
1657552226680,MATH 197,001,091859,McAuley; Julian John,9999,0,9999,0
1657552226680,MATH 197,002,095566,Kedlaya; Kiran S.,9997,0,9999,2
1657552226680,MATH 197,003,095567,Xiao; Ming,9999,0,9999,0
1657552226680,MATH 197,004,095571,Perols; Johan Lars,9998,0,9999,1
1657552233737,COGS 9,A01,083615,Shannon; Kyle Michael,9,0,75,66
1657552239760,COGS 11,A01,083617,Boyle; Mary E. T.,22,0,48,26
1657552245786,COGS 13,A01,083071,Bastos; Amalia Pinkusfeld,11,0,71,60
1657552251820,COGS 14A,A01,092681,Semenuks; Arturs,5,1,100,95
1657552257845,COGS 14B,A01,083073,Cheng; Tzu-Han,6,0,63,57
1657552263882,COGS 17,A01,092677,Semenuks; Arturs,6,0,81,75
1657552269910,COGS 100,A01,083619,Allen; Michael Gordon,17,0,70,53
1657552275937,COGS 101A,A01,083621,Davis; Joshua Daniel,9,0,68,59
1657552281961,COGS 101B,A01,091572,Allen; Michael Gordon,12,0,65,53
1657552287992,COGS 101C,A01,083625,Delgado; Tania,17,0,35,18
1657552294019,COGS 107A,A01,083627,Boyle; Mary E. T.,13,0,60,47
1657552300049,COGS 118A,A01,083075,Gupta; Anjum,21,0,76,55
1657552306074,CSE 3,A50,083646,Miranda; Gregory Joseph,24,0,50,26
1657552312097,CSE 8A,A50,083650,Miranda; Gregory Joseph,17,1,56,39
1657552318120,CSE 11,A01,083080,Cao; Yingjun,6,15,40,34
1657552324144,CSE 12,A01,083652,Krause-Levy; Sophia Louisa,28,1,120,92
1657552330169,CSE 15L,A01,083654,Morris; Justin Loren,9,0,50,41
1657552330169,CSE 15L,A02,083655,Morris; Justin Loren,9,0,50,41
1657552336194,CSE 20,A01,083657,Tran; Khoa Dang,39,0,80,41
1657552342218,CSE 21,A01,095574,Bach; Quang Tran,22,0,48,26
1657552348243,CSE 30,A01,083084,Eldon; John,5,0,80,75
1657552348243,CSE 30,B01,095061,Bhaskar; Nishant,9,0,50,41
1657552354278,CSE 100,A01,083659,Cao; Yingjun,5,4,70,65
1657552360307,CSE 134B,A01,083661,Powell; Thomas Allan,22,0,100,78
1657552366334,CSE 140,A01,083663,Gungor; Onat,15,0,85,70
1657552372362,CSE 140L,A01,083088,Eldon; John,21,0,100,79
1657552378385,CSE 175,A01,083665,Kumar; Rakesh,3,0,25,22
1657552384416,CSE 190,A00,092507,Dubnov; Shlomo,8,0,20,12
1657552390443,ECE 45,A01,083139,Congero; Spencer William,6,0,75,69
1657552396467,ECE 65,A50,083695,Saad; Andrew S,12,0,30,18
1657552396467,ECE 65,A51,095125,Saad; Andrew S,24,0,26,2
1657552402491,ECE 109,A01,091882,Touri; Behrouz,19,0,70,51
1657552408515,ECE 180,A00,083140,Abi Samra; Nicholas Camill,1,0,30,29
1657552408515,ECE 180,B00,083141,Abi Samra; Nicholas Camill,0,0,30,30
1657552414541,MATH 10A,A01,083735,Patchell; Gregory David,2,0,30,28
1657552414541,MATH 10A,A02,083736,Patchell; Gregory David,20,0,30,10
1657552414541,MATH 10A,A03,083737,Patchell; Gregory David,16,0,30,14
1657552420569,MATH 10B,A01,083207,Lim; Seonhee,8,0,34,26
1657552420569,MATH 10B,A02,083208,Lim; Seonhee,9,0,35,26
1657552420569,MATH 10B,A03,093472,Lim; Seonhee,7,0,34,27
1657552420569,MATH 10B,B01,083739,Sinha; Shubham,12,0,30,18
1657552426593,MATH 18,A01,083743,Cinel; Cameron Alexander,7,0,30,23
1657552426593,MATH 18,A02,083744,Cinel; Cameron Alexander,17,0,30,13
1657552426593,MATH 18,A03,083745,Cinel; Cameron Alexander,9,0,30,21
1657552426593,MATH 18,B01,083748,Rideout; David Porter,5,0,37,32
1657552426593,MATH 18,B02,083749,Rideout; David Porter,5,0,36,31
1657552426593,MATH 18,B03,083750,Rideout; David Porter,3,0,37,34
1657552426593,MATH 18,B04,083751,Rideout; David Porter,6,0,36,30
1657552426593,MATH 18,B05,093473,Rideout; David Porter,6,0,36,30
1657552426593,MATH 18,B06,093474,Rideout; David Porter,6,0,36,30
1657552432614,MATH 20A,A01,083754,Zheng; Zequn,14,0,40,26
1657552438644,MATH 20B,A01,083756,Briones; Jor-el Thomas Caparas,4,0,36,32
1657552438644,MATH 20B,A02,083757,Briones; Jor-el Thomas Caparas,1,0,36,35
1657552438644,MATH 20B,A03,093475,Briones; Jor-el Thomas Caparas,2,0,36,34
1657552444670,MATH 20C,A01,083760,Briones; Jor-el Thomas Caparas,1,0,35,34
1657552444670,MATH 20C,A02,083761,Briones; Jor-el Thomas Caparas,8,0,35,27
1657552444670,MATH 20C,A03,093476,Briones; Jor-el Thomas Caparas,0,1,36,36
1657552444670,MATH 20C,B01,083762,Bach; Quang Tran,1,0,30,29
1657552450692,MATH 20D,A01,083765,Tran; Brian Kha,5,0,30,25
1657552450692,MATH 20D,A02,083766,Tran; Brian Kha,5,0,30,25
1657552450692,MATH 20D,A03,083767,Tran; Brian Kha,5,0,30,25
1657552456715,MATH 20E,A01,083771,Ganguly; Soumya,9,0,32,23
1657552456715,MATH 20E,A02,083772,Ganguly; Soumya,6,0,32,26
1657552456715,MATH 20E,B01,083773,Ciotti; Benjamin,20,0,35,15
1657552456715,MATH 20E,B02,083774,Ciotti; Benjamin,17,0,35,18
1657552462744,MATH 103A,A01,083777,Greenfeld; Be'Eri,3,0,36,33
1657552462744,MATH 103A,A02,083778,Greenfeld; Be'Eri,5,0,36,31
1657552462744,MATH 103A,A03,093561,Greenfeld; Be'Eri,5,0,36,31
1657552462744,MATH 103A,B01,083779,Greenfeld; Be'Eri,7,0,36,29
1657552462744,MATH 103A,B02,083780,Greenfeld; Be'Eri,4,0,36,32
1657552462744,MATH 103A,B03,093562,Greenfeld; Be'Eri,3,0,36,33
1657552468769,MATH 105,A01,085443,Carter; Anne Toulson,15,0,35,20
1657552468769,MATH 105,A02,093477,Carter; Anne Toulson,20,0,35,15
1657552474798,MATH 109,A01,083213,Ganzberger; Geoffrey Michael,2,0,34,32
1657552474798,MATH 109,A02,083214,Ganzberger; Geoffrey Michael,4,0,34,30
1657552474798,MATH 109,A03,093478,Ganzberger; Geoffrey Michael,2,0,34,32
1657552474798,MATH 109,B01,083215,Ganzberger; Geoffrey Michael,1,0,32,31
1657552474798,MATH 109,B02,083216,Ganzberger; Geoffrey Michael,2,0,32,30
1657552474798,MATH 109,B03,093479,Ganzberger; Geoffrey Michael,8,0,32,24
1657552480828,MATH 142A,A01,083219,Chow; Bennett,7,0,32,25
1657552480828,MATH 142A,A02,083220,Chow; Bennett,10,0,32,22
1657552480828,MATH 142A,A03,093480,Chow; Bennett,8,0,32,24
1657552480828,MATH 142A,B03,093481,Chow; Bennett,8,0,32,24
1657552480828,MATH 142A,B04,093558,Chow; Bennett,13,0,32,19
1657552480828,MATH 142A,B05,093559,Chow; Bennett,6,0,32,26
1657552486854,MATH 193A,A01,083224,Rotar; Vladimir,8,0,34,26
1657552486854,MATH 193A,A02,083225,Rotar; Vladimir,9,0,34,25
1657552486854,MATH 193A,A03,083781,Rotar; Vladimir,5,0,34,29
1657552486854,MATH 193A,A04,083782,Rotar; Vladimir,10,0,34,24
1657552486854,MATH 193A,A05,093482,Rotar; Vladimir,10,0,34,24
1657552492882,MATH 197,001,091859,McAuley; Julian John,9999,0,9999,0
1657552492882,MATH 197,002,095566,Kedlaya; Kiran S.,9997,0,9999,2
1657552492882,MATH 197,003,095567,Xiao; Ming,9999,0,9999,0
1657552492882,MATH 197,004,095571,Perols; Johan Lars,9998,0,9999,1
1657552499937,COGS 9,A01,083615,Shannon; Kyle Michael,9,0,75,66
1657552505964,COGS 11,A01,083617,Boyle; Mary E. T.,22,0,48,26
1657552511987,COGS 13,A01,083071,Bastos; Amalia Pinkusfeld,11,0,71,60
1657552518011,COGS 14A,A01,092681,Semenuks; Arturs,5,1,100,95
1657552524036,COGS 14B,A01,083073,Cheng; Tzu-Han,6,0,63,57
1657552530064,COGS 17,A01,092677,Semenuks; Arturs,6,0,81,75
1657552536091,COGS 100,A01,083619,Allen; Michael Gordon,17,0,70,53
1657552542115,COGS 101A,A01,083621,Davis; Joshua Daniel,9,0,68,59
1657552548141,COGS 101B,A01,091572,Allen; Michael Gordon,12,0,65,53
1657552554173,COGS 101C,A01,083625,Delgado; Tania,17,0,35,18
1657552560200,COGS 107A,A01,083627,Boyle; Mary E. T.,13,0,60,47
1657552566228,COGS 118A,A01,083075,Gupta; Anjum,21,0,76,55
1657552572264,CSE 3,A50,083646,Miranda; Gregory Joseph,24,0,50,26
1657552578291,CSE 8A,A50,083650,Miranda; Gregory Joseph,17,1,56,39
1657552584316,CSE 11,A01,083080,Cao; Yingjun,6,15,40,34
1657552590338,CSE 12,A01,083652,Krause-Levy; Sophia Louisa,28,1,120,92
1657552596409,CSE 15L,A01,083654,Morris; Justin Loren,9,0,50,41
1657552596409,CSE 15L,A02,083655,Morris; Justin Loren,9,0,50,41
1657552602440,CSE 20,A01,083657,Tran; Khoa Dang,39,0,80,41
1657552608462,CSE 21,A01,095574,Bach; Quang Tran,22,0,48,26
1657552614488,CSE 30,A01,083084,Eldon; John,5,0,80,75
1657552614488,CSE 30,B01,095061,Bhaskar; Nishant,9,0,50,41
1657552620516,CSE 100,A01,083659,Cao; Yingjun,5,4,70,65
1657552626538,CSE 134B,A01,083661,Powell; Thomas Allan,22,0,100,78
1657552632559,CSE 140,A01,083663,Gungor; Onat,15,0,85,70
1657552638587,CSE 140L,A01,083088,Eldon; John,21,0,100,79
1657552644709,CSE 175,A01,083665,Kumar; Rakesh,3,0,25,22
1657552650733,CSE 190,A00,092507,Dubnov; Shlomo,8,0,20,12
1657552656755,ECE 45,A01,083139,Congero; Spencer William,6,0,75,69
1657552662784,ECE 65,A50,083695,Saad; Andrew S,12,0,30,18
1657552662784,ECE 65,A51,095125,Saad; Andrew S,24,0,26,2
1657552668811,ECE 109,A01,091882,Touri; Behrouz,19,0,70,51
1657552674856,ECE 180,A00,083140,Abi Samra; Nicholas Camill,1,0,30,29
1657552674856,ECE 180,B00,083141,Abi Samra; Nicholas Camill,0,0,30,30
1657552680879,MATH 10A,A01,083735,Patchell; Gregory David,2,0,30,28
1657552680879,MATH 10A,A02,083736,Patchell; Gregory David,20,0,30,10
1657552680879,MATH 10A,A03,083737,Patchell; Gregory David,16,0,30,14
1657552686902,MATH 10B,A01,083207,Lim; Seonhee,8,0,34,26
1657552686902,MATH 10B,A02,083208,Lim; Seonhee,9,0,35,26
1657552686902,MATH 10B,A03,093472,Lim; Seonhee,7,0,34,27
1657552686902,MATH 10B,B01,083739,Sinha; Shubham,12,0,30,18
1657552692931,MATH 18,A01,083743,Cinel; Cameron Alexander,7,0,30,23
1657552692931,MATH 18,A02,083744,Cinel; Cameron Alexander,17,0,30,13
1657552692931,MATH 18,A03,083745,Cinel; Cameron Alexander,9,0,30,21
1657552692931,MATH 18,B01,083748,Rideout; David Porter,5,0,37,32
1657552692931,MATH 18,B02,083749,Rideout; David Porter,5,0,36,31
1657552692931,MATH 18,B03,083750,Rideout; David Porter,3,0,37,34
1657552692931,MATH 18,B04,083751,Rideout; David Porter,6,0,36,30
1657552692931,MATH 18,B05,093473,Rideout; David Porter,6,0,36,30
1657552692931,MATH 18,B06,093474,Rideout; David Porter,6,0,36,30
1657552698953,MATH 20A,A01,083754,Zheng; Zequn,14,0,40,26
1657552704976,MATH 20B,A01,083756,Briones; Jor-el Thomas Caparas,4,0,36,32
1657552704976,MATH 20B,A02,083757,Briones; Jor-el Thomas Caparas,1,0,36,35
1657552704976,MATH 20B,A03,093475,Briones; Jor-el Thomas Caparas,2,0,36,34
1657552711006,MATH 20C,A01,083760,Briones; Jor-el Thomas Caparas,1,0,35,34
1657552711006,MATH 20C,A02,083761,Briones; Jor-el Thomas Caparas,8,0,35,27
1657552711006,MATH 20C,A03,093476,Briones; Jor-el Thomas Caparas,0,1,36,36
1657552711006,MATH 20C,B01,083762,Bach; Quang Tran,1,0,30,29
1657552717029,MATH 20D,A01,083765,Tran; Brian Kha,5,0,30,25
1657552717029,MATH 20D,A02,083766,Tran; Brian Kha,5,0,30,25
1657552717029,MATH 20D,A03,083767,Tran; Brian Kha,5,0,30,25
1657552723054,MATH 20E,A01,083771,Ganguly; Soumya,9,0,32,23
1657552723054,MATH 20E,A02,083772,Ganguly; Soumya,6,0,32,26
1657552723054,MATH 20E,B01,083773,Ciotti; Benjamin,20,0,35,15
1657552723054,MATH 20E,B02,083774,Ciotti; Benjamin,17,0,35,18
1657552729078,MATH 103A,A01,083777,Greenfeld; Be'Eri,3,0,36,33
1657552729078,MATH 103A,A02,083778,Greenfeld; Be'Eri,5,0,36,31
1657552729078,MATH 103A,A03,093561,Greenfeld; Be'Eri,5,0,36,31
1657552729078,MATH 103A,B01,083779,Greenfeld; Be'Eri,7,0,36,29
1657552729078,MATH 103A,B02,083780,Greenfeld; Be'Eri,4,0,36,32
1657552729078,MATH 103A,B03,093562,Greenfeld; Be'Eri,3,0,36,33
1657552735101,MATH 105,A01,085443,Carter; Anne Toulson,15,0,35,20
1657552735101,MATH 105,A02,093477,Carter; Anne Toulson,20,0,35,15
1657552741124,MATH 109,A01,083213,Ganzberger; Geoffrey Michael,2,0,34,32
1657552741124,MATH 109,A02,083214,Ganzberger; Geoffrey Michael,4,0,34,30
1657552741124,MATH 109,A03,093478,Ganzberger; Geoffrey Michael,2,0,34,32
1657552741124,MATH 109,B01,083215,Ganzberger; Geoffrey Michael,1,0,32,31
1657552741124,MATH 109,B02,083216,Ganzberger; Geoffrey Michael,2,0,32,30
1657552741124,MATH 109,B03,093479,Ganzberger; Geoffrey Michael,8,0,32,24
1657552747148,MATH 142A,A01,083219,Chow; Bennett,7,0,32,25
1657552747148,MATH 142A,A02,083220,Chow; Bennett,10,0,32,22
1657552747148,MATH 142A,A03,093480,Chow; Bennett,8,0,32,24
1657552747148,MATH 142A,B03,093481,Chow; Bennett,8,0,32,24
1657552747148,MATH 142A,B04,093558,Chow; Bennett,13,0,32,19
1657552747148,MATH 142A,B05,093559,Chow; Bennett,6,0,32,26
1657552753176,MATH 193A,A01,083224,Rotar; Vladimir,8,0,34,26
1657552753176,MATH 193A,A02,083225,Rotar; Vladimir,9,0,34,25
1657552753176,MATH 193A,A03,083781,Rotar; Vladimir,5,0,34,29
1657552753176,MATH 193A,A04,083782,Rotar; Vladimir,10,0,34,24
1657552753176,MATH 193A,A05,093482,Rotar; Vladimir,10,0,34,24
1657552759199,MATH 197,001,091859,McAuley; Julian John,9999,0,9999,0
1657552759199,MATH 197,002,095566,Kedlaya; Kiran S.,9997,0,9999,2
1657552759199,MATH 197,003,095567,Xiao; Ming,9999,0,9999,0
1657552759199,MATH 197,004,095571,Perols; Johan Lars,9998,0,9999,1
1657552766273,COGS 9,A01,083615,Shannon; Kyle Michael,9,0,75,66
1657552772298,COGS 11,A01,083617,Boyle; Mary E. T.,22,0,48,26
1657552778326,COGS 13,A01,083071,Bastos; Amalia Pinkusfeld,11,0,71,60
1657552784350,COGS 14A,A01,092681,Semenuks; Arturs,5,1,100,95
1657552790373,COGS 14B,A01,083073,Cheng; Tzu-Han,6,0,63,57
1657552796395,COGS 17,A01,092677,Semenuks; Arturs,6,0,81,75
1657552802422,COGS 100,A01,083619,Allen; Michael Gordon,17,0,70,53
1657552808451,COGS 101A,A01,083621,Davis; Joshua Daniel,9,0,68,59
1657552814474,COGS 101B,A01,091572,Allen; Michael Gordon,12,0,65,53
1657552820503,COGS 101C,A01,083625,Delgado; Tania,17,0,35,18
1657552826531,COGS 107A,A01,083627,Boyle; Mary E. T.,13,0,60,47
1657552832575,COGS 118A,A01,083075,Gupta; Anjum,21,0,76,55
1657552838617,CSE 3,A50,083646,Miranda; Gregory Joseph,24,0,50,26
1657552844640,CSE 8A,A50,083650,Miranda; Gregory Joseph,17,1,56,39
1657552850667,CSE 11,A01,083080,Cao; Yingjun,6,15,40,34
1657552856694,CSE 12,A01,083652,Krause-Levy; Sophia Louisa,28,1,120,92
1657552862717,CSE 15L,A01,083654,Morris; Justin Loren,9,0,50,41
1657552862717,CSE 15L,A02,083655,Morris; Justin Loren,9,0,50,41
1657552868741,CSE 20,A01,083657,Tran; Khoa Dang,39,0,80,41
1657552874763,CSE 21,A01,095574,Bach; Quang Tran,22,0,48,26
1657552880791,CSE 30,A01,083084,Eldon; John,5,0,80,75
1657552880791,CSE 30,B01,095061,Bhaskar; Nishant,9,0,50,41
1657552886815,CSE 100,A01,083659,Cao; Yingjun,5,4,70,65
1657552892840,CSE 134B,A01,083661,Powell; Thomas Allan,22,0,100,78
1657552898863,CSE 140,A01,083663,Gungor; Onat,15,0,85,70
1657552904886,CSE 140L,A01,083088,Eldon; John,21,0,100,79
1657552910920,CSE 175,A01,083665,Kumar; Rakesh,3,0,25,22
1657552916946,CSE 190,A00,092507,Dubnov; Shlomo,8,0,20,12
1657552922968,ECE 45,A01,083139,Congero; Spencer William,6,0,75,69
1657552928995,ECE 65,A50,083695,Saad; Andrew S,12,0,30,18
1657552928995,ECE 65,A51,095125,Saad; Andrew S,24,0,26,2
1657552935026,ECE 109,A01,091882,Touri; Behrouz,19,0,70,51
1657552941050,ECE 180,A00,083140,Abi Samra; Nicholas Camill,1,0,30,29
1657552941050,ECE 180,B00,083141,Abi Samra; Nicholas Camill,0,0,30,30
1657552947077,MATH 10A,A01,083735,Patchell; Gregory David,2,0,30,28
1657552947077,MATH 10A,A02,083736,Patchell; Gregory David,20,0,30,10
1657552947077,MATH 10A,A03,083737,Patchell; Gregory David,16,0,30,14
1657552953109,MATH 10B,A01,083207,Lim; Seonhee,8,0,34,26
1657552953109,MATH 10B,A02,083208,Lim; Seonhee,9,0,35,26
1657552953109,MATH 10B,A03,093472,Lim; Seonhee,7,0,34,27
1657552953109,MATH 10B,B01,083739,Sinha; Shubham,12,0,30,18
1657552959133,MATH 18,A01,083743,Cinel; Cameron Alexander,7,0,30,23
1657552959133,MATH 18,A02,083744,Cinel; Cameron Alexander,17,0,30,13
1657552959133,MATH 18,A03,083745,Cinel; Cameron Alexander,9,0,30,21
1657552959133,MATH 18,B01,083748,Rideout; David Porter,5,0,37,32
1657552959133,MATH 18,B02,083749,Rideout; David Porter,5,0,36,31
1657552959133,MATH 18,B03,083750,Rideout; David Porter,3,0,37,34
1657552959133,MATH 18,B04,083751,Rideout; David Porter,6,0,36,30
1657552959133,MATH 18,B05,093473,Rideout; David Porter,6,0,36,30
1657552959133,MATH 18,B06,093474,Rideout; David Porter,6,0,36,30
1657552965156,MATH 20A,A01,083754,Zheng; Zequn,14,0,40,26
1657552971180,MATH 20B,A01,083756,Briones; Jor-el Thomas Caparas,4,0,36,32
1657552971180,MATH 20B,A02,083757,Briones; Jor-el Thomas Caparas,1,0,36,35
1657552971180,MATH 20B,A03,093475,Briones; Jor-el Thomas Caparas,2,0,36,34
1657552977204,MATH 20C,A01,083760,Briones; Jor-el Thomas Caparas,1,0,35,34
1657552977204,MATH 20C,A02,083761,Briones; Jor-el Thomas Caparas,8,0,35,27
1657552977204,MATH 20C,A03,093476,Briones; Jor-el Thomas Caparas,0,1,36,36
1657552977204,MATH 20C,B01,083762,Bach; Quang Tran,1,0,30,29
1657552983233,MATH 20D,A01,083765,Tran; Brian Kha,5,0,30,25
1657552983233,MATH 20D,A02,083766,Tran; Brian Kha,5,0,30,25
1657552983233,MATH 20D,A03,083767,Tran; Brian Kha,5,0,30,25
1657552989264,MATH 20E,A01,083771,Ganguly; Soumya,9,0,32,23
1657552989264,MATH 20E,A02,083772,Ganguly; Soumya,6,0,32,26
1657552989264,MATH 20E,B01,083773,Ciotti; Benjamin,20,0,35,15
1657552989264,MATH 20E,B02,083774,Ciotti; Benjamin,17,0,35,18
1657552995287,MATH 103A,A01,083777,Greenfeld; Be'Eri,3,0,36,33
1657552995287,MATH 103A,A02,083778,Greenfeld; Be'Eri,5,0,36,31
1657552995287,MATH 103A,A03,093561,Greenfeld; Be'Eri,5,0,36,31
1657552995287,MATH 103A,B01,083779,Greenfeld; Be'Eri,7,0,36,29
1657552995287,MATH 103A,B02,083780,Greenfeld; Be'Eri,4,0,36,32
1657552995287,MATH 103A,B03,093562,Greenfeld; Be'Eri,3,0,36,33
1657553001314,MATH 105,A01,085443,Carter; Anne Toulson,15,0,35,20
1657553001314,MATH 105,A02,093477,Carter; Anne Toulson,20,0,35,15
1657553007347,MATH 109,A01,083213,Ganzberger; Geoffrey Michael,2,0,34,32
1657553007347,MATH 109,A02,083214,Ganzberger; Geoffrey Michael,4,0,34,30
1657553007347,MATH 109,A03,093478,Ganzberger; Geoffrey Michael,2,0,34,32
1657553007347,MATH 109,B01,083215,Ganzberger; Geoffrey Michael,1,0,32,31
1657553007347,MATH 109,B02,083216,Ganzberger; Geoffrey Michael,2,0,32,30
1657553007347,MATH 109,B03,093479,Ganzberger; Geoffrey Michael,8,0,32,24
1657553013374,MATH 142A,A01,083219,Chow; Bennett,7,0,32,25
1657553013374,MATH 142A,A02,083220,Chow; Bennett,10,0,32,22
1657553013374,MATH 142A,A03,093480,Chow; Bennett,8,0,32,24
1657553013374,MATH 142A,B03,093481,Chow; Bennett,8,0,32,24
1657553013374,MATH 142A,B04,093558,Chow; Bennett,13,0,32,19
1657553013374,MATH 142A,B05,093559,Chow; Bennett,6,0,32,26
1657553019400,MATH 193A,A01,083224,Rotar; Vladimir,8,0,34,26
1657553019400,MATH 193A,A02,083225,Rotar; Vladimir,9,0,34,25
1657553019400,MATH 193A,A03,083781,Rotar; Vladimir,5,0,34,29
1657553019400,MATH 193A,A04,083782,Rotar; Vladimir,10,0,34,24
1657553019400,MATH 193A,A05,093482,Rotar; Vladimir,10,0,34,24
1657553025430,MATH 197,001,091859,McAuley; Julian John,9999,0,9999,0
1657553025430,MATH 197,002,095566,Kedlaya; Kiran S.,9997,0,9999,2
1657553025430,MATH 197,003,095567,Xiao; Ming,9999,0,9999,0
1657553025430,MATH 197,004,095571,Perols; Johan Lars,9998,0,9999,1
1657553032529,COGS 9,A01,083615,Shannon; Kyle Michael,9,0,75,66
1657553038568,COGS 11,A01,083617,Boyle; Mary E. T.,22,0,48,26
1657553044599,COGS 13,A01,083071,Bastos; Amalia Pinkusfeld,11,0,71,60
1657553050636,COGS 14A,A01,092681,Semenuks; Arturs,5,1,100,95
1657553056662,COGS 14B,A01,083073,Cheng; Tzu-Han,6,0,63,57
1657553062697,COGS 17,A01,092677,Semenuks; Arturs,6,0,81,75
1657553068727,COGS 100,A01,083619,Allen; Michael Gordon,17,0,70,53
1657553074752,COGS 101A,A01,083621,Davis; Joshua Daniel,9,0,68,59
1657553080773,COGS 101B,A01,091572,Allen; Michael Gordon,12,0,65,53
1657553086797,COGS 101C,A01,083625,Delgado; Tania,17,0,35,18
1657553092846,COGS 107A,A01,083627,Boyle; Mary E. T.,13,0,60,47
1657553098873,COGS 118A,A01,083075,Gupta; Anjum,21,0,76,55
1657553104913,CSE 3,A50,083646,Miranda; Gregory Joseph,24,0,50,26
1657553110936,CSE 8A,A50,083650,Miranda; Gregory Joseph,17,1,56,39
1657553116966,CSE 11,A01,083080,Cao; Yingjun,6,15,40,34
1657553122990,CSE 12,A01,083652,Krause-Levy; Sophia Louisa,28,1,120,92
1657553129026,CSE 15L,A01,083654,Morris; Justin Loren,9,0,50,41
1657553129026,CSE 15L,A02,083655,Morris; Justin Loren,9,0,50,41
1657553135050,CSE 20,A01,083657,Tran; Khoa Dang,39,0,80,41
1657553141081,CSE 21,A01,095574,Bach; Quang Tran,22,0,48,26
1657553147117,CSE 30,A01,083084,Eldon; John,5,0,80,75
1657553147117,CSE 30,B01,095061,Bhaskar; Nishant,9,0,50,41
1657553153140,CSE 100,A01,083659,Cao; Yingjun,5,4,70,65
1657553159167,CSE 134B,A01,083661,Powell; Thomas Allan,22,0,100,78
1657553165190,CSE 140,A01,083663,Gungor; Onat,15,0,85,70
1657553171223,CSE 140L,A01,083088,Eldon; John,21,0,100,79
1657553177252,CSE 175,A01,083665,Kumar; Rakesh,3,0,25,22
1657553183276,CSE 190,A00,092507,Dubnov; Shlomo,8,0,20,12
1657553189303,ECE 45,A01,083139,Congero; Spencer William,6,0,75,69
1657553195332,ECE 65,A50,083695,Saad; Andrew S,12,0,30,18
1657553195332,ECE 65,A51,095125,Saad; Andrew S,24,0,26,2
1657553201358,ECE 109,A01,091882,Touri; Behrouz,19,0,70,51
1657553207394,ECE 180,A00,083140,Abi Samra; Nicholas Camill,1,0,30,29
1657553207394,ECE 180,B00,083141,Abi Samra; Nicholas Camill,0,0,30,30
1657553213417,MATH 10A,A01,083735,Patchell; Gregory David,2,0,30,28
1657553213417,MATH 10A,A02,083736,Patchell; Gregory David,20,0,30,10
1657553213417,MATH 10A,A03,083737,Patchell; Gregory David,16,0,30,14
1657553219447,MATH 10B,A01,083207,Lim; Seonhee,8,0,34,26
1657553219447,MATH 10B,A02,083208,Lim; Seonhee,9,0,35,26
1657553219447,MATH 10B,A03,093472,Lim; Seonhee,7,0,34,27
1657553219447,MATH 10B,B01,083739,Sinha; Shubham,12,0,30,18
1657553225509,MATH 18,A01,083743,Cinel; Cameron Alexander,7,0,30,23
1657553225509,MATH 18,A02,083744,Cinel; Cameron Alexander,17,0,30,13
1657553225509,MATH 18,A03,083745,Cinel; Cameron Alexander,9,0,30,21
1657553225509,MATH 18,B01,083748,Rideout; David Porter,5,0,37,32
1657553225509,MATH 18,B02,083749,Rideout; David Porter,5,0,36,31
1657553225509,MATH 18,B03,083750,Rideout; David Porter,3,0,37,34
1657553225509,MATH 18,B04,083751,Rideout; David Porter,6,0,36,30
1657553225509,MATH 18,B05,093473,Rideout; David Porter,6,0,36,30
1657553225509,MATH 18,B06,093474,Rideout; David Porter,6,0,36,30
1657553231538,MATH 20A,A01,083754,Zheng; Zequn,14,0,40,26
1657553237567,MATH 20B,A01,083756,Briones; Jor-el Thomas Caparas,4,0,36,32
1657553237567,MATH 20B,A02,083757,Briones; Jor-el Thomas Caparas,1,0,36,35
1657553237567,MATH 20B,A03,093475,Briones; Jor-el Thomas Caparas,2,0,36,34
1657553243687,MATH 20C,A01,083760,Briones; Jor-el Thomas Caparas,1,0,35,34
1657553243687,MATH 20C,A02,083761,Briones; Jor-el Thomas Caparas,8,0,35,27
1657553243687,MATH 20C,A03,093476,Briones; Jor-el Thomas Caparas,0,1,36,36
1657553243687,MATH 20C,B01,083762,Bach; Quang Tran,1,0,30,29
1657553249713,MATH 20D,A01,083765,Tran; Brian Kha,5,0,30,25
1657553249713,MATH 20D,A02,083766,Tran; Brian Kha,5,0,30,25
1657553249713,MATH 20D,A03,083767,Tran; Brian Kha,5,0,30,25
1657553255745,MATH 20E,A01,083771,Ganguly; Soumya,9,0,32,23
1657553255745,MATH 20E,A02,083772,Ganguly; Soumya,6,0,32,26
1657553255745,MATH 20E,B01,083773,Ciotti; Benjamin,20,0,35,15
1657553255745,MATH 20E,B02,083774,Ciotti; Benjamin,17,0,35,18
1657553261775,MATH 103A,A01,083777,Greenfeld; Be'Eri,3,0,36,33
1657553261775,MATH 103A,A02,083778,Greenfeld; Be'Eri,5,0,36,31
1657553261775,MATH 103A,A03,093561,Greenfeld; Be'Eri,5,0,36,31
1657553261775,MATH 103A,B01,083779,Greenfeld; Be'Eri,7,0,36,29
1657553261775,MATH 103A,B02,083780,Greenfeld; Be'Eri,4,0,36,32
1657553261775,MATH 103A,B03,093562,Greenfeld; Be'Eri,3,0,36,33
1657553267805,MATH 105,A01,085443,Carter; Anne Toulson,15,0,35,20
1657553267805,MATH 105,A02,093477,Carter; Anne Toulson,20,0,35,15
1657553273836,MATH 109,A01,083213,Ganzberger; Geoffrey Michael,2,0,34,32
1657553273836,MATH 109,A02,083214,Ganzberger; Geoffrey Michael,4,0,34,30
1657553273836,MATH 109,A03,093478,Ganzberger; Geoffrey Michael,2,0,34,32
1657553273836,MATH 109,B01,083215,Ganzberger; Geoffrey Michael,1,0,32,31
1657553273836,MATH 109,B02,083216,Ganzberger; Geoffrey Michael,2,0,32,30
1657553273836,MATH 109,B03,093479,Ganzberger; Geoffrey Michael,8,0,32,24
1657553279861,MATH 142A,A01,083219,Chow; Bennett,7,0,32,25
1657553279861,MATH 142A,A02,083220,Chow; Bennett,10,0,32,22
1657553279861,MATH 142A,A03,093480,Chow; Bennett,8,0,32,24
1657553279861,MATH 142A,B03,093481,Chow; Bennett,8,0,32,24
1657553279861,MATH 142A,B04,093558,Chow; Bennett,13,0,32,19
1657553279861,MATH 142A,B05,093559,Chow; Bennett,6,0,32,26
1657553285883,MATH 193A,A01,083224,Rotar; Vladimir,8,0,34,26
1657553285883,MATH 193A,A02,083225,Rotar; Vladimir,9,0,34,25
1657553285883,MATH 193A,A03,083781,Rotar; Vladimir,5,0,34,29
1657553285883,MATH 193A,A04,083782,Rotar; Vladimir,10,0,34,24
1657553285883,MATH 193A,A05,093482,Rotar; Vladimir,10,0,34,24
1657553291906,MATH 197,001,091859,McAuley; Julian John,9999,0,9999,0
1657553291906,MATH 197,002,095566,Kedlaya; Kiran S.,9997,0,9999,2
1657553291906,MATH 197,003,095567,Xiao; Ming,9999,0,9999,0
1657553291906,MATH 197,004,095571,Perols; Johan Lars,9998,0,9999,1
1657553298966,COGS 9,A01,083615,Shannon; Kyle Michael,9,0,75,66
1657553304991,COGS 11,A01,083617,Boyle; Mary E. T.,22,0,48,26
1657553311018,COGS 13,A01,083071,Bastos; Amalia Pinkusfeld,11,0,71,60
1657553317055,COGS 14A,A01,092681,Semenuks; Arturs,5,1,100,95
1657553323079,COGS 14B,A01,083073,Cheng; Tzu-Han,6,0,63,57
1657553329103,COGS 17,A01,092677,Semenuks; Arturs,6,0,81,75
1657553335126,COGS 100,A01,083619,Allen; Michael Gordon,17,0,70,53
1657553341149,COGS 101A,A01,083621,Davis; Joshua Daniel,9,0,68,59
1657553347171,COGS 101B,A01,091572,Allen; Michael Gordon,12,0,65,53
1657553353194,COGS 101C,A01,083625,Delgado; Tania,17,0,35,18
1657553359228,COGS 107A,A01,083627,Boyle; Mary E. T.,13,0,60,47
1657553365259,COGS 118A,A01,083075,Gupta; Anjum,21,0,76,55
1657553371283,CSE 3,A50,083646,Miranda; Gregory Joseph,24,0,50,26
1657553377309,CSE 8A,A50,083650,Miranda; Gregory Joseph,17,1,56,39
1657553383337,CSE 11,A01,083080,Cao; Yingjun,6,15,40,34
1657553389362,CSE 12,A01,083652,Krause-Levy; Sophia Louisa,28,1,120,92
1657553395385,CSE 15L,A01,083654,Morris; Justin Loren,9,0,50,41
1657553395385,CSE 15L,A02,083655,Morris; Justin Loren,9,0,50,41
1657553401411,CSE 20,A01,083657,Tran; Khoa Dang,39,0,80,41
1657553407447,CSE 21,A01,095574,Bach; Quang Tran,22,0,48,26
1657553413472,CSE 30,A01,083084,Eldon; John,5,0,80,75
1657553413472,CSE 30,B01,095061,Bhaskar; Nishant,9,0,50,41
1657553419502,CSE 100,A01,083659,Cao; Yingjun,5,4,70,65
1657553425525,CSE 134B,A01,083661,Powell; Thomas Allan,22,0,100,78
1657553431548,CSE 140,A01,083663,Gungor; Onat,15,0,85,70
1657553437572,CSE 140L,A01,083088,Eldon; John,21,0,100,79
1657553443603,CSE 175,A01,083665,Kumar; Rakesh,3,0,25,22
1657553449635,CSE 190,A00,092507,Dubnov; Shlomo,8,0,20,12
1657553455663,ECE 45,A01,083139,Congero; Spencer William,6,0,75,69
1657553461693,ECE 65,A50,083695,Saad; Andrew S,12,0,30,18
1657553461693,ECE 65,A51,095125,Saad; Andrew S,24,0,26,2
1657553467720,ECE 109,A01,091882,Touri; Behrouz,19,0,70,51
1657553473746,ECE 180,A00,083140,Abi Samra; Nicholas Camill,1,0,30,29
1657553473746,ECE 180,B00,083141,Abi Samra; Nicholas Camill,0,0,30,30
1657553479775,MATH 10A,A01,083735,Patchell; Gregory David,2,0,30,28
1657553479775,MATH 10A,A02,083736,Patchell; Gregory David,20,0,30,10
1657553479775,MATH 10A,A03,083737,Patchell; Gregory David,16,0,30,14
1657553485800,MATH 10B,A01,083207,Lim; Seonhee,8,0,34,26
1657553485800,MATH 10B,A02,083208,Lim; Seonhee,9,0,35,26
1657553485800,MATH 10B,A03,093472,Lim; Seonhee,7,0,34,27
1657553485800,MATH 10B,B01,083739,Sinha; Shubham,12,0,30,18
1657553491825,MATH 18,A01,083743,Cinel; Cameron Alexander,7,0,30,23
1657553491825,MATH 18,A02,083744,Cinel; Cameron Alexander,17,0,30,13
1657553491825,MATH 18,A03,083745,Cinel; Cameron Alexander,9,0,30,21
1657553491825,MATH 18,B01,083748,Rideout; David Porter,5,0,37,32
1657553491825,MATH 18,B02,083749,Rideout; David Porter,5,0,36,31
1657553491825,MATH 18,B03,083750,Rideout; David Porter,3,0,37,34
1657553491825,MATH 18,B04,083751,Rideout; David Porter,6,0,36,30
1657553491825,MATH 18,B05,093473,Rideout; David Porter,6,0,36,30
1657553491825,MATH 18,B06,093474,Rideout; David Porter,6,0,36,30
1657553497875,MATH 20A,A01,083754,Zheng; Zequn,14,0,40,26
1657553503901,MATH 20B,A01,083756,Briones; Jor-el Thomas Caparas,4,0,36,32
1657553503901,MATH 20B,A02,083757,Briones; Jor-el Thomas Caparas,1,0,36,35
1657553503901,MATH 20B,A03,093475,Briones; Jor-el Thomas Caparas,2,0,36,34
1657553509926,MATH 20C,A01,083760,Briones; Jor-el Thomas Caparas,1,0,35,34
1657553509926,MATH 20C,A02,083761,Briones; Jor-el Thomas Caparas,8,0,35,27
1657553509926,MATH 20C,A03,093476,Briones; Jor-el Thomas Caparas,0,1,36,36
1657553509926,MATH 20C,B01,083762,Bach; Quang Tran,1,0,30,29
1657553515955,MATH 20D,A01,083765,Tran; Brian Kha,5,0,30,25
1657553515955,MATH 20D,A02,083766,Tran; Brian Kha,5,0,30,25
1657553515955,MATH 20D,A03,083767,Tran; Brian Kha,5,0,30,25
1657553521981,MATH 20E,A01,083771,Ganguly; Soumya,9,0,32,23
1657553521981,MATH 20E,A02,083772,Ganguly; Soumya,6,0,32,26
1657553521981,MATH 20E,B01,083773,Ciotti; Benjamin,20,0,35,15
1657553521981,MATH 20E,B02,083774,Ciotti; Benjamin,17,0,35,18
1657553528016,MATH 103A,A01,083777,Greenfeld; Be'Eri,3,0,36,33
1657553528016,MATH 103A,A02,083778,Greenfeld; Be'Eri,5,0,36,31
1657553528016,MATH 103A,A03,093561,Greenfeld; Be'Eri,5,0,36,31
1657553528016,MATH 103A,B01,083779,Greenfeld; Be'Eri,7,0,36,29
1657553528016,MATH 103A,B02,083780,Greenfeld; Be'Eri,4,0,36,32
1657553528016,MATH 103A,B03,093562,Greenfeld; Be'Eri,3,0,36,33
1657553534041,MATH 105,A01,085443,Carter; Anne Toulson,15,0,35,20
1657553534041,MATH 105,A02,093477,Carter; Anne Toulson,20,0,35,15
1657553540066,MATH 109,A01,083213,Ganzberger; Geoffrey Michael,2,0,34,32
1657553540066,MATH 109,A02,083214,Ganzberger; Geoffrey Michael,4,0,34,30
1657553540066,MATH 109,A03,093478,Ganzberger; Geoffrey Michael,2,0,34,32
1657553540066,MATH 109,B01,083215,Ganzberger; Geoffrey Michael,1,0,32,31
1657553540066,MATH 109,B02,083216,Ganzberger; Geoffrey Michael,2,0,32,30
1657553540066,MATH 109,B03,093479,Ganzberger; Geoffrey Michael,8,0,32,24
1657553546095,MATH 142A,A01,083219,Chow; Bennett,7,0,32,25
1657553546095,MATH 142A,A02,083220,Chow; Bennett,10,0,32,22
1657553546095,MATH 142A,A03,093480,Chow; Bennett,8,0,32,24
1657553546095,MATH 142A,B03,093481,Chow; Bennett,8,0,32,24
1657553546095,MATH 142A,B04,093558,Chow; Bennett,13,0,32,19
1657553546095,MATH 142A,B05,093559,Chow; Bennett,6,0,32,26
1657553552128,MATH 193A,A01,083224,Rotar; Vladimir,8,0,34,26
1657553552128,MATH 193A,A02,083225,Rotar; Vladimir,9,0,34,25
1657553552128,MATH 193A,A03,083781,Rotar; Vladimir,5,0,34,29
1657553552128,MATH 193A,A04,083782,Rotar; Vladimir,10,0,34,24
1657553552128,MATH 193A,A05,093482,Rotar; Vladimir,10,0,34,24
1657553558159,MATH 197,001,091859,McAuley; Julian John,9999,0,9999,0
1657553558159,MATH 197,002,095566,Kedlaya; Kiran S.,9997,0,9999,2
1657553558159,MATH 197,003,095567,Xiao; Ming,9999,0,9999,0
1657553558159,MATH 197,004,095571,Perols; Johan Lars,9998,0,9999,1
1657553565228,COGS 9,A01,083615,Shannon; Kyle Michael,9,0,75,66
1657553571252,COGS 11,A01,083617,Boyle; Mary E. T.,22,0,48,26
1657553577292,COGS 13,A01,083071,Bastos; Amalia Pinkusfeld,11,0,71,60
1657553583316,COGS 14A,A01,092681,Semenuks; Arturs,5,1,100,95
1657553589345,COGS 14B,A01,083073,Cheng; Tzu-Han,6,0,63,57
1657553595386,COGS 17,A01,092677,Semenuks; Arturs,6,0,81,75
1657553601413,COGS 100,A01,083619,Allen; Michael Gordon,17,0,70,53
1657553607439,COGS 101A,A01,083621,Davis; Joshua Daniel,9,0,68,59
1657553613470,COGS 101B,A01,091572,Allen; Michael Gordon,12,0,65,53
1657553619495,COGS 101C,A01,083625,Delgado; Tania,17,0,35,18
1657553625518,COGS 107A,A01,083627,Boyle; Mary E. T.,13,0,60,47
1657553631540,COGS 118A,A01,083075,Gupta; Anjum,21,0,76,55
1657553637565,CSE 3,A50,083646,Miranda; Gregory Joseph,24,0,50,26
1657553643596,CSE 8A,A50,083650,Miranda; Gregory Joseph,17,1,56,39
1657553649623,CSE 11,A01,083080,Cao; Yingjun,6,15,40,34
1657553655650,CSE 12,A01,083652,Krause-Levy; Sophia Louisa,28,1,120,92
1657553661676,CSE 15L,A01,083654,Morris; Justin Loren,9,0,50,41
1657553661676,CSE 15L,A02,083655,Morris; Justin Loren,9,0,50,41
1657553667699,CSE 20,A01,083657,Tran; Khoa Dang,39,0,80,41
1657553673725,CSE 21,A01,095574,Bach; Quang Tran,22,0,48,26
1657553679753,CSE 30,A01,083084,Eldon; John,5,0,80,75
1657553679753,CSE 30,B01,095061,Bhaskar; Nishant,9,0,50,41
1657553685779,CSE 100,A01,083659,Cao; Yingjun,5,4,70,65
1657553691806,CSE 134B,A01,083661,Powell; Thomas Allan,22,0,100,78
1657553697833,CSE 140,A01,083663,Gungor; Onat,15,0,85,70
1657553703855,CSE 140L,A01,083088,Eldon; John,21,0,100,79
1657553709883,CSE 175,A01,083665,Kumar; Rakesh,3,0,25,22
1657553715910,CSE 190,A00,092507,Dubnov; Shlomo,8,0,20,12
1657553721938,ECE 45,A01,083139,Congero; Spencer William,6,0,75,69
1657553727962,ECE 65,A50,083695,Saad; Andrew S,12,0,30,18
1657553727962,ECE 65,A51,095125,Saad; Andrew S,24,0,26,2
1657553733988,ECE 109,A01,091882,Touri; Behrouz,19,0,70,51
1657553740010,ECE 180,A00,083140,Abi Samra; Nicholas Camill,1,0,30,29
1657553740010,ECE 180,B00,083141,Abi Samra; Nicholas Camill,0,0,30,30
1657553746035,MATH 10A,A01,083735,Patchell; Gregory David,2,0,30,28
1657553746035,MATH 10A,A02,083736,Patchell; Gregory David,20,0,30,10
1657553746035,MATH 10A,A03,083737,Patchell; Gregory David,16,0,30,14
1657553752068,MATH 10B,A01,083207,Lim; Seonhee,8,0,34,26
1657553752068,MATH 10B,A02,083208,Lim; Seonhee,9,0,35,26
1657553752068,MATH 10B,A03,093472,Lim; Seonhee,7,0,34,27
1657553752068,MATH 10B,B01,083739,Sinha; Shubham,12,0,30,18
1657553758097,MATH 18,A01,083743,Cinel; Cameron Alexander,7,0,30,23
1657553758097,MATH 18,A02,083744,Cinel; Cameron Alexander,17,0,30,13
1657553758097,MATH 18,A03,083745,Cinel; Cameron Alexander,9,0,30,21
1657553758097,MATH 18,B01,083748,Rideout; David Porter,5,0,37,32
1657553758097,MATH 18,B02,083749,Rideout; David Porter,5,0,36,31
1657553758097,MATH 18,B03,083750,Rideout; David Porter,3,0,37,34
1657553758097,MATH 18,B04,083751,Rideout; David Porter,6,0,36,30
1657553758097,MATH 18,B05,093473,Rideout; David Porter,6,0,36,30
1657553758097,MATH 18,B06,093474,Rideout; David Porter,6,0,36,30
1657553764127,MATH 20A,A01,083754,Zheng; Zequn,14,0,40,26
1657553770151,MATH 20B,A01,083756,Briones; Jor-el Thomas Caparas,4,0,36,32
1657553770151,MATH 20B,A02,083757,Briones; Jor-el Thomas Caparas,1,0,36,35
1657553770151,MATH 20B,A03,093475,Briones; Jor-el Thomas Caparas,2,0,36,34
1657553776179,MATH 20C,A01,083760,Briones; Jor-el Thomas Caparas,1,0,35,34
1657553776179,MATH 20C,A02,083761,Briones; Jor-el Thomas Caparas,8,0,35,27
1657553776179,MATH 20C,A03,093476,Briones; Jor-el Thomas Caparas,0,1,36,36
1657553776179,MATH 20C,B01,083762,Bach; Quang Tran,1,0,30,29
1657553782207,MATH 20D,A01,083765,Tran; Brian Kha,5,0,30,25
1657553782207,MATH 20D,A02,083766,Tran; Brian Kha,5,0,30,25
1657553782207,MATH 20D,A03,083767,Tran; Brian Kha,5,0,30,25
1657553788241,MATH 20E,A01,083771,Ganguly; Soumya,9,0,32,23
1657553788241,MATH 20E,A02,083772,Ganguly; Soumya,6,0,32,26
1657553788241,MATH 20E,B01,083773,Ciotti; Benjamin,20,0,35,15
1657553788241,MATH 20E,B02,083774,Ciotti; Benjamin,17,0,35,18
1657553794271,MATH 103A,A01,083777,Greenfeld; Be'Eri,3,0,36,33
1657553794271,MATH 103A,A02,083778,Greenfeld; Be'Eri,5,0,36,31
1657553794271,MATH 103A,A03,093561,Greenfeld; Be'Eri,5,0,36,31
1657553794271,MATH 103A,B01,083779,Greenfeld; Be'Eri,7,0,36,29
1657553794271,MATH 103A,B02,083780,Greenfeld; Be'Eri,4,0,36,32
1657553794271,MATH 103A,B03,093562,Greenfeld; Be'Eri,3,0,36,33
1657553800300,MATH 105,A01,085443,Carter; Anne Toulson,15,0,35,20
1657553800300,MATH 105,A02,093477,Carter; Anne Toulson,20,0,35,15
1657553806325,MATH 109,A01,083213,Ganzberger; Geoffrey Michael,2,0,34,32
1657553806325,MATH 109,A02,083214,Ganzberger; Geoffrey Michael,4,0,34,30
1657553806325,MATH 109,A03,093478,Ganzberger; Geoffrey Michael,2,0,34,32
1657553806325,MATH 109,B01,083215,Ganzberger; Geoffrey Michael,1,0,32,31
1657553806325,MATH 109,B02,083216,Ganzberger; Geoffrey Michael,2,0,32,30
1657553806325,MATH 109,B03,093479,Ganzberger; Geoffrey Michael,8,0,32,24
1657553812371,MATH 142A,A01,083219,Chow; Bennett,7,0,32,25
1657553812371,MATH 142A,A02,083220,Chow; Bennett,10,0,32,22
1657553812371,MATH 142A,A03,093480,Chow; Bennett,8,0,32,24
1657553812371,MATH 142A,B03,093481,Chow; Bennett,8,0,32,24
1657553812371,MATH 142A,B04,093558,Chow; Bennett,13,0,32,19
1657553812371,MATH 142A,B05,093559,Chow; Bennett,6,0,32,26
1657553818403,MATH 193A,A01,083224,Rotar; Vladimir,8,0,34,26
1657553818403,MATH 193A,A02,083225,Rotar; Vladimir,9,0,34,25
1657553818403,MATH 193A,A03,083781,Rotar; Vladimir,5,0,34,29
1657553818403,MATH 193A,A04,083782,Rotar; Vladimir,10,0,34,24
1657553818403,MATH 193A,A05,093482,Rotar; Vladimir,10,0,34,24
1657553824425,MATH 197,001,091859,McAuley; Julian John,9999,0,9999,0
1657553824425,MATH 197,002,095566,Kedlaya; Kiran S.,9997,0,9999,2
1657553824425,MATH 197,003,095567,Xiao; Ming,9999,0,9999,0
1657553824425,MATH 197,004,095571,Perols; Johan Lars,9998,0,9999,1
1657553831476,COGS 9,A01,083615,Shannon; Kyle Michael,9,0,75,66
1657553837569,COGS 11,A01,083617,Boyle; Mary E. T.,22,0,48,26
1657553843592,COGS 13,A01,083071,Bastos; Amalia Pinkusfeld,11,0,71,60
1657553849618,COGS 14A,A01,092681,Semenuks; Arturs,5,1,100,95
1657553855642,COGS 14B,A01,083073,Cheng; Tzu-Han,6,0,63,57
1657553861679,COGS 17,A01,092677,Semenuks; Arturs,6,0,81,75
1657553867722,COGS 100,A01,083619,Allen; Michael Gordon,17,0,70,53
1657553873749,COGS 101A,A01,083621,Davis; Joshua Daniel,9,0,68,59
1657553879773,COGS 101B,A01,091572,Allen; Michael Gordon,12,0,65,53
1657553885796,COGS 101C,A01,083625,Delgado; Tania,17,0,35,18
1657553891824,COGS 107A,A01,083627,Boyle; Mary E. T.,13,0,60,47
1657553897848,COGS 118A,A01,083075,Gupta; Anjum,21,0,76,55
1657553903871,CSE 3,A50,083646,Miranda; Gregory Joseph,24,0,50,26
1657553909898,CSE 8A,A50,083650,Miranda; Gregory Joseph,17,1,56,39
1657553915929,CSE 11,A01,083080,Cao; Yingjun,6,15,40,34
1657553921951,CSE 12,A01,083652,Krause-Levy; Sophia Louisa,28,1,120,92
1657553927973,CSE 15L,A01,083654,Morris; Justin Loren,9,0,50,41
1657553927973,CSE 15L,A02,083655,Morris; Justin Loren,9,0,50,41
1657553933996,CSE 20,A01,083657,Tran; Khoa Dang,39,0,80,41
1657553940023,CSE 21,A01,095574,Bach; Quang Tran,22,0,48,26
1657553946044,CSE 30,A01,083084,Eldon; John,5,0,80,75
1657553946044,CSE 30,B01,095061,Bhaskar; Nishant,9,0,50,41
1657553952069,CSE 100,A01,083659,Cao; Yingjun,5,4,70,65
1657553958100,CSE 134B,A01,083661,Powell; Thomas Allan,22,0,100,78
1657553964125,CSE 140,A01,083663,Gungor; Onat,15,0,85,70
1657553970155,CSE 140L,A01,083088,Eldon; John,21,0,100,79
1657553976177,CSE 175,A01,083665,Kumar; Rakesh,3,0,25,22
1657553982202,CSE 190,A00,092507,Dubnov; Shlomo,8,0,20,12
1657553988231,ECE 45,A01,083139,Congero; Spencer William,6,0,75,69
1657553994254,ECE 65,A50,083695,Saad; Andrew S,12,0,30,18
1657553994254,ECE 65,A51,095125,Saad; Andrew S,24,0,26,2
1657554000292,ECE 109,A01,091882,Touri; Behrouz,19,0,70,51
1657554006315,ECE 180,A00,083140,Abi Samra; Nicholas Camill,1,0,30,29
1657554006315,ECE 180,B00,083141,Abi Samra; Nicholas Camill,0,0,30,30
1657554012342,MATH 10A,A01,083735,Patchell; Gregory David,2,0,30,28
1657554012342,MATH 10A,A02,083736,Patchell; Gregory David,20,0,30,10
1657554012342,MATH 10A,A03,083737,Patchell; Gregory David,16,0,30,14
1657554018367,MATH 10B,A01,083207,Lim; Seonhee,8,0,34,26
1657554018367,MATH 10B,A02,083208,Lim; Seonhee,9,0,35,26
1657554018367,MATH 10B,A03,093472,Lim; Seonhee,7,0,34,27
1657554018367,MATH 10B,B01,083739,Sinha; Shubham,12,0,30,18
1657554024397,MATH 18,A01,083743,Cinel; Cameron Alexander,7,0,30,23
1657554024397,MATH 18,A02,083744,Cinel; Cameron Alexander,17,0,30,13
1657554024397,MATH 18,A03,083745,Cinel; Cameron Alexander,9,0,30,21
1657554024397,MATH 18,B01,083748,Rideout; David Porter,5,0,37,32
1657554024397,MATH 18,B02,083749,Rideout; David Porter,5,0,36,31
1657554024397,MATH 18,B03,083750,Rideout; David Porter,3,0,37,34
1657554024397,MATH 18,B04,083751,Rideout; David Porter,6,0,36,30
1657554024397,MATH 18,B05,093473,Rideout; David Porter,6,0,36,30
1657554024397,MATH 18,B06,093474,Rideout; David Porter,6,0,36,30
1657554030420,MATH 20A,A01,083754,Zheng; Zequn,14,0,40,26
1657554036442,MATH 20B,A01,083756,Briones; Jor-el Thomas Caparas,4,0,36,32
1657554036442,MATH 20B,A02,083757,Briones; Jor-el Thomas Caparas,1,0,36,35
1657554036442,MATH 20B,A03,093475,Briones; Jor-el Thomas Caparas,2,0,36,34
1657554042466,MATH 20C,A01,083760,Briones; Jor-el Thomas Caparas,1,0,35,34
1657554042466,MATH 20C,A02,083761,Briones; Jor-el Thomas Caparas,8,0,35,27
1657554042466,MATH 20C,A03,093476,Briones; Jor-el Thomas Caparas,0,1,36,36
1657554042466,MATH 20C,B01,083762,Bach; Quang Tran,1,0,30,29
1657554048488,MATH 20D,A01,083765,Tran; Brian Kha,5,0,30,25
1657554048488,MATH 20D,A02,083766,Tran; Brian Kha,5,0,30,25
1657554048488,MATH 20D,A03,083767,Tran; Brian Kha,5,0,30,25
1657554054516,MATH 20E,A01,083771,Ganguly; Soumya,9,0,32,23
1657554054516,MATH 20E,A02,083772,Ganguly; Soumya,6,0,32,26
1657554054516,MATH 20E,B01,083773,Ciotti; Benjamin,20,0,35,15
1657554054516,MATH 20E,B02,083774,Ciotti; Benjamin,17,0,35,18
1657554060546,MATH 103A,A01,083777,Greenfeld; Be'Eri,3,0,36,33
1657554060546,MATH 103A,A02,083778,Greenfeld; Be'Eri,5,0,36,31
1657554060546,MATH 103A,A03,093561,Greenfeld; Be'Eri,5,0,36,31
1657554060546,MATH 103A,B01,083779,Greenfeld; Be'Eri,7,0,36,29
1657554060546,MATH 103A,B02,083780,Greenfeld; Be'Eri,4,0,36,32
1657554060546,MATH 103A,B03,093562,Greenfeld; Be'Eri,3,0,36,33
1657554066569,MATH 105,A01,085443,Carter; Anne Toulson,15,0,35,20
1657554066569,MATH 105,A02,093477,Carter; Anne Toulson,20,0,35,15
1657554072609,MATH 109,A01,083213,Ganzberger; Geoffrey Michael,2,0,34,32
1657554072609,MATH 109,A02,083214,Ganzberger; Geoffrey Michael,4,0,34,30
1657554072609,MATH 109,A03,093478,Ganzberger; Geoffrey Michael,2,0,34,32
1657554072609,MATH 109,B01,083215,Ganzberger; Geoffrey Michael,1,0,32,31
1657554072609,MATH 109,B02,083216,Ganzberger; Geoffrey Michael,2,0,32,30
1657554072609,MATH 109,B03,093479,Ganzberger; Geoffrey Michael,8,0,32,24
1657554078633,MATH 142A,A01,083219,Chow; Bennett,7,0,32,25
1657554078633,MATH 142A,A02,083220,Chow; Bennett,10,0,32,22
1657554078633,MATH 142A,A03,093480,Chow; Bennett,8,0,32,24
1657554078633,MATH 142A,B03,093481,Chow; Bennett,8,0,32,24
1657554078633,MATH 142A,B04,093558,Chow; Bennett,13,0,32,19
1657554078633,MATH 142A,B05,093559,Chow; Bennett,6,0,32,26
1657554084658,MATH 193A,A01,083224,Rotar; Vladimir,8,0,34,26
1657554084658,MATH 193A,A02,083225,Rotar; Vladimir,9,0,34,25
1657554084658,MATH 193A,A03,083781,Rotar; Vladimir,5,0,34,29
1657554084658,MATH 193A,A04,083782,Rotar; Vladimir,10,0,34,24
1657554084658,MATH 193A,A05,093482,Rotar; Vladimir,10,0,34,24
1657554090681,MATH 197,001,091859,McAuley; Julian John,9999,0,9999,0
1657554090681,MATH 197,002,095566,Kedlaya; Kiran S.,9997,0,9999,2
1657554090681,MATH 197,003,095567,Xiao; Ming,9999,0,9999,0
1657554090681,MATH 197,004,095571,Perols; Johan Lars,9998,0,9999,1
1657554097749,COGS 9,A01,083615,Shannon; Kyle Michael,9,0,75,66
1657554103795,COGS 11,A01,083617,Boyle; Mary E. T.,22,0,48,26
1657554109822,COGS 13,A01,083071,Bastos; Amalia Pinkusfeld,11,0,71,60
1657554115845,COGS 14A,A01,092681,Semenuks; Arturs,5,1,100,95
1657554121870,COGS 14B,A01,083073,Cheng; Tzu-Han,6,0,63,57
1657554127891,COGS 17,A01,092677,Semenuks; Arturs,6,0,81,75
1657554133918,COGS 100,A01,083619,Allen; Michael Gordon,17,0,70,53
1657554139944,COGS 101A,A01,083621,Davis; Joshua Daniel,9,0,68,59
1657554145965,COGS 101B,A01,091572,Allen; Michael Gordon,12,0,65,53
1657554151989,COGS 101C,A01,083625,Delgado; Tania,17,0,35,18
1657554158013,COGS 107A,A01,083627,Boyle; Mary E. T.,13,0,60,47
1657554164045,COGS 118A,A01,083075,Gupta; Anjum,21,0,76,55
1657554170073,CSE 3,A50,083646,Miranda; Gregory Joseph,24,0,50,26
1657554176105,CSE 8A,A50,083650,Miranda; Gregory Joseph,17,1,56,39
1657554182145,CSE 11,A01,083080,Cao; Yingjun,6,15,40,34
1657554188171,CSE 12,A01,083652,Krause-Levy; Sophia Louisa,28,1,120,92
1657554194198,CSE 15L,A01,083654,Morris; Justin Loren,9,0,50,41
1657554194198,CSE 15L,A02,083655,Morris; Justin Loren,9,0,50,41
1657554200229,CSE 20,A01,083657,Tran; Khoa Dang,39,0,80,41
1657554206274,CSE 21,A01,095574,Bach; Quang Tran,22,0,48,26
1657554212314,CSE 30,A01,083084,Eldon; John,5,0,80,75
1657554212314,CSE 30,B01,095061,Bhaskar; Nishant,9,0,50,41
1657554218338,CSE 100,A01,083659,Cao; Yingjun,5,4,70,65
1657554224367,CSE 134B,A01,083661,Powell; Thomas Allan,22,0,100,78
1657554230393,CSE 140,A01,083663,Gungor; Onat,15,0,85,70
1657554236417,CSE 140L,A01,083088,Eldon; John,21,0,100,79
1657554242439,CSE 175,A01,083665,Kumar; Rakesh,3,0,25,22
1657554248462,CSE 190,A00,092507,Dubnov; Shlomo,8,0,20,12
1657554254492,ECE 45,A01,083139,Congero; Spencer William,6,0,75,69
1657554260516,ECE 65,A50,083695,Saad; Andrew S,12,0,30,18
1657554260516,ECE 65,A51,095125,Saad; Andrew S,24,0,26,2
1657554266541,ECE 109,A01,091882,Touri; Behrouz,19,0,70,51
1657554272572,ECE 180,A00,083140,Abi Samra; Nicholas Camill,1,0,30,29
1657554272572,ECE 180,B00,083141,Abi Samra; Nicholas Camill,0,0,30,30
1657554278597,MATH 10A,A01,083735,Patchell; Gregory David,2,0,30,28
1657554278597,MATH 10A,A02,083736,Patchell; Gregory David,20,0,30,10
1657554278597,MATH 10A,A03,083737,Patchell; Gregory David,16,0,30,14
1657554284620,MATH 10B,A01,083207,Lim; Seonhee,8,0,34,26
1657554284620,MATH 10B,A02,083208,Lim; Seonhee,9,0,35,26
1657554284620,MATH 10B,A03,093472,Lim; Seonhee,7,0,34,27
1657554284620,MATH 10B,B01,083739,Sinha; Shubham,12,0,30,18
1657554290643,MATH 18,A01,083743,Cinel; Cameron Alexander,7,0,30,23
1657554290643,MATH 18,A02,083744,Cinel; Cameron Alexander,17,0,30,13
1657554290643,MATH 18,A03,083745,Cinel; Cameron Alexander,9,0,30,21
1657554290643,MATH 18,B01,083748,Rideout; David Porter,5,0,37,32
1657554290643,MATH 18,B02,083749,Rideout; David Porter,5,0,36,31
1657554290643,MATH 18,B03,083750,Rideout; David Porter,3,0,37,34
1657554290643,MATH 18,B04,083751,Rideout; David Porter,6,0,36,30
1657554290643,MATH 18,B05,093473,Rideout; David Porter,6,0,36,30
1657554290643,MATH 18,B06,093474,Rideout; David Porter,6,0,36,30
1657554296666,MATH 20A,A01,083754,Zheng; Zequn,14,0,40,26
1657554302689,MATH 20B,A01,083756,Briones; Jor-el Thomas Caparas,4,0,36,32
1657554302689,MATH 20B,A02,083757,Briones; Jor-el Thomas Caparas,1,0,36,35
1657554302689,MATH 20B,A03,093475,Briones; Jor-el Thomas Caparas,2,0,36,34
1657554308712,MATH 20C,A01,083760,Briones; Jor-el Thomas Caparas,1,0,35,34
1657554308712,MATH 20C,A02,083761,Briones; Jor-el Thomas Caparas,8,0,35,27
1657554308712,MATH 20C,A03,093476,Briones; Jor-el Thomas Caparas,0,1,36,36
1657554308712,MATH 20C,B01,083762,Bach; Quang Tran,1,0,30,29
1657554314735,MATH 20D,A01,083765,Tran; Brian Kha,5,0,30,25
1657554314735,MATH 20D,A02,083766,Tran; Brian Kha,5,0,30,25
1657554314735,MATH 20D,A03,083767,Tran; Brian Kha,5,0,30,25
1657554320758,MATH 20E,A01,083771,Ganguly; Soumya,9,0,32,23
1657554320758,MATH 20E,A02,083772,Ganguly; Soumya,6,0,32,26
1657554320758,MATH 20E,B01,083773,Ciotti; Benjamin,20,0,35,15
1657554320758,MATH 20E,B02,083774,Ciotti; Benjamin,17,0,35,18
1657554326783,MATH 103A,A01,083777,Greenfeld; Be'Eri,3,0,36,33
1657554326783,MATH 103A,A02,083778,Greenfeld; Be'Eri,5,0,36,31
1657554326783,MATH 103A,A03,093561,Greenfeld; Be'Eri,5,0,36,31
1657554326783,MATH 103A,B01,083779,Greenfeld; Be'Eri,7,0,36,29
1657554326783,MATH 103A,B02,083780,Greenfeld; Be'Eri,4,0,36,32
1657554326783,MATH 103A,B03,093562,Greenfeld; Be'Eri,3,0,36,33
1657554332810,MATH 105,A01,085443,Carter; Anne Toulson,15,0,35,20
1657554332810,MATH 105,A02,093477,Carter; Anne Toulson,20,0,35,15
1657554338835,MATH 109,A01,083213,Ganzberger; Geoffrey Michael,2,0,34,32
1657554338835,MATH 109,A02,083214,Ganzberger; Geoffrey Michael,4,0,34,30
1657554338835,MATH 109,A03,093478,Ganzberger; Geoffrey Michael,2,0,34,32
1657554338835,MATH 109,B01,083215,Ganzberger; Geoffrey Michael,1,0,32,31
1657554338835,MATH 109,B02,083216,Ganzberger; Geoffrey Michael,2,0,32,30
1657554338835,MATH 109,B03,093479,Ganzberger; Geoffrey Michael,8,0,32,24
1657554344858,MATH 142A,A01,083219,Chow; Bennett,7,0,32,25
1657554344858,MATH 142A,A02,083220,Chow; Bennett,10,0,32,22
1657554344858,MATH 142A,A03,093480,Chow; Bennett,8,0,32,24
1657554344858,MATH 142A,B03,093481,Chow; Bennett,8,0,32,24
1657554344858,MATH 142A,B04,093558,Chow; Bennett,13,0,32,19
1657554344858,MATH 142A,B05,093559,Chow; Bennett,6,0,32,26
1657554350882,MATH 193A,A01,083224,Rotar; Vladimir,8,0,34,26
1657554350882,MATH 193A,A02,083225,Rotar; Vladimir,9,0,34,25
1657554350882,MATH 193A,A03,083781,Rotar; Vladimir,5,0,34,29
1657554350882,MATH 193A,A04,083782,Rotar; Vladimir,10,0,34,24
1657554350882,MATH 193A,A05,093482,Rotar; Vladimir,10,0,34,24
1657554356907,MATH 197,001,091859,McAuley; Julian John,9999,0,9999,0
1657554356907,MATH 197,002,095566,Kedlaya; Kiran S.,9997,0,9999,2
1657554356907,MATH 197,003,095567,Xiao; Ming,9999,0,9999,0
1657554356907,MATH 197,004,095571,Perols; Johan Lars,9998,0,9999,1
1657554363969,COGS 9,A01,083615,Shannon; Kyle Michael,9,0,75,66
1657554369992,COGS 11,A01,083617,Boyle; Mary E. T.,22,0,48,26
1657554376017,COGS 13,A01,083071,Bastos; Amalia Pinkusfeld,11,0,71,60
1657554382043,COGS 14A,A01,092681,Semenuks; Arturs,5,1,100,95
1657554388074,COGS 14B,A01,083073,Cheng; Tzu-Han,6,0,63,57
1657554394097,COGS 17,A01,092677,Semenuks; Arturs,6,0,81,75
1657554400119,COGS 100,A01,083619,Allen; Michael Gordon,17,0,70,53
1657554406141,COGS 101A,A01,083621,Davis; Joshua Daniel,9,0,68,59
1657554412163,COGS 101B,A01,091572,Allen; Michael Gordon,12,0,65,53
1657554418187,COGS 101C,A01,083625,Delgado; Tania,17,0,35,18
1657554424216,COGS 107A,A01,083627,Boyle; Mary E. T.,13,0,60,47
1657554430243,COGS 118A,A01,083075,Gupta; Anjum,21,0,76,55
1657554436349,CSE 3,A50,083646,Miranda; Gregory Joseph,24,0,50,26
1657554442373,CSE 8A,A50,083650,Miranda; Gregory Joseph,17,1,56,39
1657554448396,CSE 11,A01,083080,Cao; Yingjun,6,15,40,34
1657554454419,CSE 12,A01,083652,Krause-Levy; Sophia Louisa,28,1,120,92
1657554460442,CSE 15L,A01,083654,Morris; Justin Loren,9,0,50,41
1657554460442,CSE 15L,A02,083655,Morris; Justin Loren,9,0,50,41
1657554466480,CSE 20,A01,083657,Tran; Khoa Dang,39,0,80,41
1657554472505,CSE 21,A01,095574,Bach; Quang Tran,22,0,48,26
1657554478533,CSE 30,A01,083084,Eldon; John,5,0,80,75
1657554478533,CSE 30,B01,095061,Bhaskar; Nishant,9,0,50,41
1657554484555,CSE 100,A01,083659,Cao; Yingjun,5,4,70,65
1657554490594,CSE 134B,A01,083661,Powell; Thomas Allan,22,0,100,78
1657554496618,CSE 140,A01,083663,Gungor; Onat,15,0,85,70
1657554502640,CSE 140L,A01,083088,Eldon; John,21,0,100,79
1657554508665,CSE 175,A01,083665,Kumar; Rakesh,3,0,25,22
1657554514696,CSE 190,A00,092507,Dubnov; Shlomo,8,0,20,12
1657554520726,ECE 45,A01,083139,Congero; Spencer William,6,0,75,69
1657554526747,ECE 65,A50,083695,Saad; Andrew S,12,0,30,18
1657554526747,ECE 65,A51,095125,Saad; Andrew S,24,0,26,2
1657554532769,ECE 109,A01,091882,Touri; Behrouz,19,0,70,51
1657554538792,ECE 180,A00,083140,Abi Samra; Nicholas Camill,1,0,30,29
1657554538792,ECE 180,B00,083141,Abi Samra; Nicholas Camill,0,0,30,30
1657554544823,MATH 10A,A01,083735,Patchell; Gregory David,2,0,30,28
1657554544823,MATH 10A,A02,083736,Patchell; Gregory David,20,0,30,10
1657554544823,MATH 10A,A03,083737,Patchell; Gregory David,16,0,30,14
1657554550848,MATH 10B,A01,083207,Lim; Seonhee,8,0,34,26
1657554550848,MATH 10B,A02,083208,Lim; Seonhee,9,0,35,26
1657554550848,MATH 10B,A03,093472,Lim; Seonhee,7,0,34,27
1657554550848,MATH 10B,B01,083739,Sinha; Shubham,12,0,30,18
1657554556872,MATH 18,A01,083743,Cinel; Cameron Alexander,7,0,30,23
1657554556872,MATH 18,A02,083744,Cinel; Cameron Alexander,17,0,30,13
1657554556872,MATH 18,A03,083745,Cinel; Cameron Alexander,9,0,30,21
1657554556872,MATH 18,B01,083748,Rideout; David Porter,5,0,37,32
1657554556872,MATH 18,B02,083749,Rideout; David Porter,5,0,36,31
1657554556872,MATH 18,B03,083750,Rideout; David Porter,3,0,37,34
1657554556872,MATH 18,B04,083751,Rideout; David Porter,6,0,36,30
1657554556872,MATH 18,B05,093473,Rideout; David Porter,6,0,36,30
1657554556872,MATH 18,B06,093474,Rideout; David Porter,6,0,36,30
1657554562898,MATH 20A,A01,083754,Zheng; Zequn,14,0,40,26
1657554568923,MATH 20B,A01,083756,Briones; Jor-el Thomas Caparas,4,0,36,32
1657554568923,MATH 20B,A02,083757,Briones; Jor-el Thomas Caparas,1,0,36,35
1657554568923,MATH 20B,A03,093475,Briones; Jor-el Thomas Caparas,2,0,36,34
1657554574946,MATH 20C,A01,083760,Briones; Jor-el Thomas Caparas,1,0,35,34
1657554574946,MATH 20C,A02,083761,Briones; Jor-el Thomas Caparas,8,0,35,27
1657554574946,MATH 20C,A03,093476,Briones; Jor-el Thomas Caparas,0,1,36,36
1657554574946,MATH 20C,B01,083762,Bach; Quang Tran,1,0,30,29
1657554580968,MATH 20D,A01,083765,Tran; Brian Kha,5,0,30,25
1657554580968,MATH 20D,A02,083766,Tran; Brian Kha,5,0,30,25
1657554580968,MATH 20D,A03,083767,Tran; Brian Kha,5,0,30,25
1657554586992,MATH 20E,A01,083771,Ganguly; Soumya,9,0,32,23
1657554586992,MATH 20E,A02,083772,Ganguly; Soumya,6,0,32,26
1657554586992,MATH 20E,B01,083773,Ciotti; Benjamin,20,0,35,15
1657554586992,MATH 20E,B02,083774,Ciotti; Benjamin,17,0,35,18
1657554593019,MATH 103A,A01,083777,Greenfeld; Be'Eri,3,0,36,33
1657554593019,MATH 103A,A02,083778,Greenfeld; Be'Eri,5,0,36,31
1657554593019,MATH 103A,A03,093561,Greenfeld; Be'Eri,5,0,36,31
1657554593019,MATH 103A,B01,083779,Greenfeld; Be'Eri,7,0,36,29
1657554593019,MATH 103A,B02,083780,Greenfeld; Be'Eri,4,0,36,32
1657554593019,MATH 103A,B03,093562,Greenfeld; Be'Eri,3,0,36,33
1657554599047,MATH 105,A01,085443,Carter; Anne Toulson,15,0,35,20
1657554599047,MATH 105,A02,093477,Carter; Anne Toulson,20,0,35,15
1657554605083,MATH 109,A01,083213,Ganzberger; Geoffrey Michael,2,0,34,32
1657554605083,MATH 109,A02,083214,Ganzberger; Geoffrey Michael,4,0,34,30
1657554605083,MATH 109,A03,093478,Ganzberger; Geoffrey Michael,2,0,34,32
1657554605083,MATH 109,B01,083215,Ganzberger; Geoffrey Michael,1,0,32,31
1657554605083,MATH 109,B02,083216,Ganzberger; Geoffrey Michael,2,0,32,30
1657554605083,MATH 109,B03,093479,Ganzberger; Geoffrey Michael,8,0,32,24
1657554611112,MATH 142A,A01,083219,Chow; Bennett,7,0,32,25
1657554611112,MATH 142A,A02,083220,Chow; Bennett,10,0,32,22
1657554611112,MATH 142A,A03,093480,Chow; Bennett,8,0,32,24
1657554611112,MATH 142A,B03,093481,Chow; Bennett,8,0,32,24
1657554611112,MATH 142A,B04,093558,Chow; Bennett,13,0,32,19
1657554611112,MATH 142A,B05,093559,Chow; Bennett,6,0,32,26
1657554617140,MATH 193A,A01,083224,Rotar; Vladimir,8,0,34,26
1657554617140,MATH 193A,A02,083225,Rotar; Vladimir,9,0,34,25
1657554617140,MATH 193A,A03,083781,Rotar; Vladimir,5,0,34,29
1657554617140,MATH 193A,A04,083782,Rotar; Vladimir,10,0,34,24
1657554617140,MATH 193A,A05,093482,Rotar; Vladimir,10,0,34,24
1657554623163,MATH 197,001,091859,McAuley; Julian John,9999,0,9999,0
1657554623163,MATH 197,002,095566,Kedlaya; Kiran S.,9997,0,9999,2
1657554623163,MATH 197,003,095567,Xiao; Ming,9999,0,9999,0
1657554623163,MATH 197,004,095571,Perols; Johan Lars,9998,0,9999,1
1657554630216,COGS 9,A01,083615,Shannon; Kyle Michael,9,0,75,66
1657554636242,COGS 11,A01,083617,Boyle; Mary E. T.,22,0,48,26
1657554642274,COGS 13,A01,083071,Bastos; Amalia Pinkusfeld,11,0,71,60
1657554648301,COGS 14A,A01,092681,Semenuks; Arturs,5,1,100,95
1657554654324,COGS 14B,A01,083073,Cheng; Tzu-Han,6,0,63,57
1657554660354,COGS 17,A01,092677,Semenuks; Arturs,6,0,81,75
1657554666381,COGS 100,A01,083619,Allen; Michael Gordon,17,0,70,53
1657554672404,COGS 101A,A01,083621,Davis; Joshua Daniel,9,0,68,59
1657554678431,COGS 101B,A01,091572,Allen; Michael Gordon,12,0,65,53
1657554684453,COGS 101C,A01,083625,Delgado; Tania,17,0,35,18
1657554690478,COGS 107A,A01,083627,Boyle; Mary E. T.,13,0,60,47
1657554696509,COGS 118A,A01,083075,Gupta; Anjum,21,0,76,55
1657554702535,CSE 3,A50,083646,Miranda; Gregory Joseph,24,0,50,26
1657554708558,CSE 8A,A50,083650,Miranda; Gregory Joseph,17,1,56,39
1657554714584,CSE 11,A01,083080,Cao; Yingjun,6,15,40,34
1657554720609,CSE 12,A01,083652,Krause-Levy; Sophia Louisa,28,1,120,92
1657554726632,CSE 15L,A01,083654,Morris; Justin Loren,9,0,50,41
1657554726632,CSE 15L,A02,083655,Morris; Justin Loren,9,0,50,41
1657554732661,CSE 20,A01,083657,Tran; Khoa Dang,39,0,80,41
1657554738688,CSE 21,A01,095574,Bach; Quang Tran,22,0,48,26
1657554744716,CSE 30,A01,083084,Eldon; John,5,0,80,75
1657554744716,CSE 30,B01,095061,Bhaskar; Nishant,9,0,50,41
1657554750745,CSE 100,A01,083659,Cao; Yingjun,5,4,70,65
1657554756768,CSE 134B,A01,083661,Powell; Thomas Allan,22,0,100,78
1657554762790,CSE 140,A01,083663,Gungor; Onat,15,0,85,70
1657554768818,CSE 140L,A01,083088,Eldon; John,21,0,100,79
1657554774845,CSE 175,A01,083665,Kumar; Rakesh,3,0,25,22
1657554780872,CSE 190,A00,092507,Dubnov; Shlomo,8,0,20,12
1657554786895,ECE 45,A01,083139,Congero; Spencer William,6,0,75,69
1657554792918,ECE 65,A50,083695,Saad; Andrew S,12,0,30,18
1657554792918,ECE 65,A51,095125,Saad; Andrew S,24,0,26,2
1657554798943,ECE 109,A01,091882,Touri; Behrouz,19,0,70,51
1657554804970,ECE 180,A00,083140,Abi Samra; Nicholas Camill,1,0,30,29
1657554804970,ECE 180,B00,083141,Abi Samra; Nicholas Camill,0,0,30,30
1657554810999,MATH 10A,A01,083735,Patchell; Gregory David,2,0,30,28
1657554810999,MATH 10A,A02,083736,Patchell; Gregory David,20,0,30,10
1657554810999,MATH 10A,A03,083737,Patchell; Gregory David,16,0,30,14
1657554817024,MATH 10B,A01,083207,Lim; Seonhee,8,0,34,26
1657554817024,MATH 10B,A02,083208,Lim; Seonhee,9,0,35,26
1657554817024,MATH 10B,A03,093472,Lim; Seonhee,7,0,34,27
1657554817024,MATH 10B,B01,083739,Sinha; Shubham,12,0,30,18
1657554823059,MATH 18,A01,083743,Cinel; Cameron Alexander,7,0,30,23
1657554823059,MATH 18,A02,083744,Cinel; Cameron Alexander,17,0,30,13
1657554823059,MATH 18,A03,083745,Cinel; Cameron Alexander,9,0,30,21
1657554823059,MATH 18,B01,083748,Rideout; David Porter,5,0,37,32
1657554823059,MATH 18,B02,083749,Rideout; David Porter,5,0,36,31
1657554823059,MATH 18,B03,083750,Rideout; David Porter,3,0,37,34
1657554823059,MATH 18,B04,083751,Rideout; David Porter,6,0,36,30
1657554823059,MATH 18,B05,093473,Rideout; David Porter,6,0,36,30
1657554823059,MATH 18,B06,093474,Rideout; David Porter,6,0,36,30
1657554829082,MATH 20A,A01,083754,Zheng; Zequn,14,0,40,26
1657554835107,MATH 20B,A01,083756,Briones; Jor-el Thomas Caparas,4,0,36,32
1657554835107,MATH 20B,A02,083757,Briones; Jor-el Thomas Caparas,1,0,36,35
1657554835107,MATH 20B,A03,093475,Briones; Jor-el Thomas Caparas,2,0,36,34
1657554841135,MATH 20C,A01,083760,Briones; Jor-el Thomas Caparas,1,0,35,34
1657554841135,MATH 20C,A02,083761,Briones; Jor-el Thomas Caparas,8,0,35,27
1657554841135,MATH 20C,A03,093476,Briones; Jor-el Thomas Caparas,0,1,36,36
1657554841135,MATH 20C,B01,083762,Bach; Quang Tran,1,0,30,29
1657554847166,MATH 20D,A01,083765,Tran; Brian Kha,5,0,30,25
1657554847166,MATH 20D,A02,083766,Tran; Brian Kha,5,0,30,25
1657554847166,MATH 20D,A03,083767,Tran; Brian Kha,5,0,30,25
1657554853190,MATH 20E,A01,083771,Ganguly; Soumya,9,0,32,23
1657554853190,MATH 20E,A02,083772,Ganguly; Soumya,6,0,32,26
1657554853190,MATH 20E,B01,083773,Ciotti; Benjamin,20,0,35,15
1657554853190,MATH 20E,B02,083774,Ciotti; Benjamin,17,0,35,18
1657554859215,MATH 103A,A01,083777,Greenfeld; Be'Eri,3,0,36,33
1657554859215,MATH 103A,A02,083778,Greenfeld; Be'Eri,5,0,36,31
1657554859215,MATH 103A,A03,093561,Greenfeld; Be'Eri,5,0,36,31
1657554859215,MATH 103A,B01,083779,Greenfeld; Be'Eri,7,0,36,29
1657554859215,MATH 103A,B02,083780,Greenfeld; Be'Eri,4,0,36,32
1657554859215,MATH 103A,B03,093562,Greenfeld; Be'Eri,3,0,36,33
1657554865241,MATH 105,A01,085443,Carter; Anne Toulson,15,0,35,20
1657554865241,MATH 105,A02,093477,Carter; Anne Toulson,20,0,35,15
1657554871273,MATH 109,A01,083213,Ganzberger; Geoffrey Michael,2,0,34,32
1657554871273,MATH 109,A02,083214,Ganzberger; Geoffrey Michael,4,0,34,30
1657554871273,MATH 109,A03,093478,Ganzberger; Geoffrey Michael,2,0,34,32
1657554871273,MATH 109,B01,083215,Ganzberger; Geoffrey Michael,1,0,32,31
1657554871273,MATH 109,B02,083216,Ganzberger; Geoffrey Michael,2,0,32,30
1657554871273,MATH 109,B03,093479,Ganzberger; Geoffrey Michael,8,0,32,24
1657554877304,MATH 142A,A01,083219,Chow; Bennett,7,0,32,25
1657554877304,MATH 142A,A02,083220,Chow; Bennett,10,0,32,22
1657554877304,MATH 142A,A03,093480,Chow; Bennett,8,0,32,24
1657554877304,MATH 142A,B03,093481,Chow; Bennett,8,0,32,24
1657554877304,MATH 142A,B04,093558,Chow; Bennett,13,0,32,19
1657554877304,MATH 142A,B05,093559,Chow; Bennett,6,0,32,26
1657554883327,MATH 193A,A01,083224,Rotar; Vladimir,8,0,34,26
1657554883327,MATH 193A,A02,083225,Rotar; Vladimir,9,0,34,25
1657554883327,MATH 193A,A03,083781,Rotar; Vladimir,5,0,34,29
1657554883327,MATH 193A,A04,083782,Rotar; Vladimir,10,0,34,24
1657554883327,MATH 193A,A05,093482,Rotar; Vladimir,10,0,34,24
1657554889358,MATH 197,001,091859,McAuley; Julian John,9999,0,9999,0
1657554889358,MATH 197,002,095566,Kedlaya; Kiran S.,9997,0,9999,2
1657554889358,MATH 197,003,095567,Xiao; Ming,9999,0,9999,0
1657554889358,MATH 197,004,095571,Perols; Johan Lars,9998,0,9999,1
1657554896410,COGS 9,A01,083615,Shannon; Kyle Michael,9,0,75,66
1657554902432,COGS 11,A01,083617,Boyle; Mary E. T.,22,0,48,26
1657554908458,COGS 13,A01,083071,Bastos; Amalia Pinkusfeld,11,0,71,60
1657554914483,COGS 14A,A01,092681,Semenuks; Arturs,5,1,100,95
1657554920510,COGS 14B,A01,083073,Cheng; Tzu-Han,6,0,63,57
1657554926534,COGS 17,A01,092677,Semenuks; Arturs,6,0,81,75
1657554932558,COGS 100,A01,083619,Allen; Michael Gordon,17,0,70,53
1657554938580,COGS 101A,A01,083621,Davis; Joshua Daniel,9,0,68,59
1657554944603,COGS 101B,A01,091572,Allen; Michael Gordon,12,0,65,53
1657554950626,COGS 101C,A01,083625,Delgado; Tania,17,0,35,18
1657554956649,COGS 107A,A01,083627,Boyle; Mary E. T.,13,0,60,47
1657554962675,COGS 118A,A01,083075,Gupta; Anjum,21,0,76,55
1657554968707,CSE 3,A50,083646,Miranda; Gregory Joseph,24,0,50,26
1657554974729,CSE 8A,A50,083650,Miranda; Gregory Joseph,17,1,56,39
1657554980753,CSE 11,A01,083080,Cao; Yingjun,6,15,40,34
1657554986780,CSE 12,A01,083652,Krause-Levy; Sophia Louisa,28,1,120,92
1657554992802,CSE 15L,A01,083654,Morris; Justin Loren,9,0,50,41
1657554992802,CSE 15L,A02,083655,Morris; Justin Loren,9,0,50,41
1657554998832,CSE 20,A01,083657,Tran; Khoa Dang,39,0,80,41
1657555004856,CSE 21,A01,095574,Bach; Quang Tran,22,0,48,26
1657555010884,CSE 30,A01,083084,Eldon; John,5,0,80,75
1657555010884,CSE 30,B01,095061,Bhaskar; Nishant,9,0,50,41
1657555016908,CSE 100,A01,083659,Cao; Yingjun,5,4,70,65
1657555022935,CSE 134B,A01,083661,Powell; Thomas Allan,22,0,100,78
1657555028958,CSE 140,A01,083663,Gungor; Onat,15,0,85,70
1657555035056,CSE 140L,A01,083088,Eldon; John,21,0,100,79
1657555041082,CSE 175,A01,083665,Kumar; Rakesh,3,0,25,22
1657555047104,CSE 190,A00,092507,Dubnov; Shlomo,8,0,20,12
1657555053130,ECE 45,A01,083139,Congero; Spencer William,6,0,75,69
1657555059155,ECE 65,A50,083695,Saad; Andrew S,12,0,30,18
1657555059155,ECE 65,A51,095125,Saad; Andrew S,24,0,26,2
1657555065178,ECE 109,A01,091882,Touri; Behrouz,19,0,70,51
1657555071203,ECE 180,A00,083140,Abi Samra; Nicholas Camill,1,0,30,29
1657555071203,ECE 180,B00,083141,Abi Samra; Nicholas Camill,0,0,30,30
1657555077238,MATH 10A,A01,083735,Patchell; Gregory David,2,0,30,28
1657555077238,MATH 10A,A02,083736,Patchell; Gregory David,20,0,30,10
1657555077238,MATH 10A,A03,083737,Patchell; Gregory David,16,0,30,14
1657555083271,MATH 10B,A01,083207,Lim; Seonhee,8,0,34,26
1657555083271,MATH 10B,A02,083208,Lim; Seonhee,9,0,35,26
1657555083271,MATH 10B,A03,093472,Lim; Seonhee,7,0,34,27
1657555083271,MATH 10B,B01,083739,Sinha; Shubham,12,0,30,18
1657555089296,MATH 18,A01,083743,Cinel; Cameron Alexander,7,0,30,23
1657555089296,MATH 18,A02,083744,Cinel; Cameron Alexander,17,0,30,13
1657555089296,MATH 18,A03,083745,Cinel; Cameron Alexander,9,0,30,21
1657555089296,MATH 18,B01,083748,Rideout; David Porter,5,0,37,32
1657555089296,MATH 18,B02,083749,Rideout; David Porter,5,0,36,31
1657555089296,MATH 18,B03,083750,Rideout; David Porter,3,0,37,34
1657555089296,MATH 18,B04,083751,Rideout; David Porter,6,0,36,30
1657555089296,MATH 18,B05,093473,Rideout; David Porter,6,0,36,30
1657555089296,MATH 18,B06,093474,Rideout; David Porter,6,0,36,30
1657555095321,MATH 20A,A01,083754,Zheng; Zequn,14,0,40,26
1657555101345,MATH 20B,A01,083756,Briones; Jor-el Thomas Caparas,4,0,36,32
1657555101345,MATH 20B,A02,083757,Briones; Jor-el Thomas Caparas,1,0,36,35
1657555101345,MATH 20B,A03,093475,Briones; Jor-el Thomas Caparas,2,0,36,34
1657555107367,MATH 20C,A01,083760,Briones; Jor-el Thomas Caparas,1,0,35,34
1657555107367,MATH 20C,A02,083761,Briones; Jor-el Thomas Caparas,8,0,35,27
1657555107367,MATH 20C,A03,093476,Briones; Jor-el Thomas Caparas,0,1,36,36
1657555107367,MATH 20C,B01,083762,Bach; Quang Tran,1,0,30,29
1657555113392,MATH 20D,A01,083765,Tran; Brian Kha,5,0,30,25
1657555113392,MATH 20D,A02,083766,Tran; Brian Kha,5,0,30,25
1657555113392,MATH 20D,A03,083767,Tran; Brian Kha,5,0,30,25
1657555119418,MATH 20E,A01,083771,Ganguly; Soumya,9,0,32,23
1657555119418,MATH 20E,A02,083772,Ganguly; Soumya,6,0,32,26
1657555119418,MATH 20E,B01,083773,Ciotti; Benjamin,20,0,35,15
1657555119418,MATH 20E,B02,083774,Ciotti; Benjamin,17,0,35,18
1657555125442,MATH 103A,A01,083777,Greenfeld; Be'Eri,3,0,36,33
1657555125442,MATH 103A,A02,083778,Greenfeld; Be'Eri,5,0,36,31
1657555125442,MATH 103A,A03,093561,Greenfeld; Be'Eri,5,0,36,31
1657555125442,MATH 103A,B01,083779,Greenfeld; Be'Eri,7,0,36,29
1657555125442,MATH 103A,B02,083780,Greenfeld; Be'Eri,4,0,36,32
1657555125442,MATH 103A,B03,093562,Greenfeld; Be'Eri,3,0,36,33
1657555131464,MATH 105,A01,085443,Carter; Anne Toulson,15,0,35,20
1657555131464,MATH 105,A02,093477,Carter; Anne Toulson,20,0,35,15
1657555137489,MATH 109,A01,083213,Ganzberger; Geoffrey Michael,2,0,34,32
1657555137489,MATH 109,A02,083214,Ganzberger; Geoffrey Michael,4,0,34,30
1657555137489,MATH 109,A03,093478,Ganzberger; Geoffrey Michael,2,0,34,32
1657555137489,MATH 109,B01,083215,Ganzberger; Geoffrey Michael,1,0,32,31
1657555137489,MATH 109,B02,083216,Ganzberger; Geoffrey Michael,2,0,32,30
1657555137489,MATH 109,B03,093479,Ganzberger; Geoffrey Michael,8,0,32,24
1657555143511,MATH 142A,A01,083219,Chow; Bennett,7,0,32,25
1657555143511,MATH 142A,A02,083220,Chow; Bennett,10,0,32,22
1657555143511,MATH 142A,A03,093480,Chow; Bennett,8,0,32,24
1657555143511,MATH 142A,B03,093481,Chow; Bennett,8,0,32,24
1657555143511,MATH 142A,B04,093558,Chow; Bennett,13,0,32,19
1657555143511,MATH 142A,B05,093559,Chow; Bennett,6,0,32,26
1657555149537,MATH 193A,A01,083224,Rotar; Vladimir,8,0,34,26
1657555149537,MATH 193A,A02,083225,Rotar; Vladimir,9,0,34,25
1657555149537,MATH 193A,A03,083781,Rotar; Vladimir,5,0,34,29
1657555149537,MATH 193A,A04,083782,Rotar; Vladimir,10,0,34,24
1657555149537,MATH 193A,A05,093482,Rotar; Vladimir,10,0,34,24
1657555155565,MATH 197,001,091859,McAuley; Julian John,9999,0,9999,0
1657555155565,MATH 197,002,095566,Kedlaya; Kiran S.,9997,0,9999,2
1657555155565,MATH 197,003,095567,Xiao; Ming,9999,0,9999,0
1657555155565,MATH 197,004,095571,Perols; Johan Lars,9998,0,9999,1
1657555162621,COGS 9,A01,083615,Shannon; Kyle Michael,9,0,75,66
1657555168645,COGS 11,A01,083617,Boyle; Mary E. T.,22,0,48,26
1657555174672,COGS 13,A01,083071,Bastos; Amalia Pinkusfeld,11,0,71,60
1657555180697,COGS 14A,A01,092681,Semenuks; Arturs,5,1,100,95
1657555186722,COGS 14B,A01,083073,Cheng; Tzu-Han,6,0,63,57
1657555192744,COGS 17,A01,092677,Semenuks; Arturs,6,0,81,75
1657555198772,COGS 100,A01,083619,Allen; Michael Gordon,17,0,70,53
1657555204794,COGS 101A,A01,083621,Davis; Joshua Daniel,9,0,68,59
1657555210821,COGS 101B,A01,091572,Allen; Michael Gordon,12,0,65,53
1657555216855,COGS 101C,A01,083625,Delgado; Tania,17,0,35,18
1657555222882,COGS 107A,A01,083627,Boyle; Mary E. T.,13,0,60,47
1657555228908,COGS 118A,A01,083075,Gupta; Anjum,21,0,76,55
1657555234929,CSE 3,A50,083646,Miranda; Gregory Joseph,24,0,50,26
1657555240959,CSE 8A,A50,083650,Miranda; Gregory Joseph,17,1,56,39
1657555246994,CSE 11,A01,083080,Cao; Yingjun,6,15,40,34
1657555253027,CSE 12,A01,083652,Krause-Levy; Sophia Louisa,28,1,120,92
1657555259050,CSE 15L,A01,083654,Morris; Justin Loren,9,0,50,41
1657555259050,CSE 15L,A02,083655,Morris; Justin Loren,9,0,50,41
1657555265079,CSE 20,A01,083657,Tran; Khoa Dang,39,0,80,41
1657555271110,CSE 21,A01,095574,Bach; Quang Tran,22,0,48,26
1657555277136,CSE 30,A01,083084,Eldon; John,5,0,80,75
1657555277136,CSE 30,B01,095061,Bhaskar; Nishant,9,0,50,41
1657555283166,CSE 100,A01,083659,Cao; Yingjun,5,4,70,65
1657555289192,CSE 134B,A01,083661,Powell; Thomas Allan,22,0,100,78
1657555295226,CSE 140,A01,083663,Gungor; Onat,15,0,85,70
1657555301251,CSE 140L,A01,083088,Eldon; John,21,0,100,79
1657555307277,CSE 175,A01,083665,Kumar; Rakesh,3,0,25,22
1657555313299,CSE 190,A00,092507,Dubnov; Shlomo,8,0,20,12
1657555319323,ECE 45,A01,083139,Congero; Spencer William,6,0,75,69
1657555325346,ECE 65,A50,083695,Saad; Andrew S,12,0,30,18
1657555325346,ECE 65,A51,095125,Saad; Andrew S,24,0,26,2
1657555331371,ECE 109,A01,091882,Touri; Behrouz,19,0,70,51
1657555337392,ECE 180,A00,083140,Abi Samra; Nicholas Camill,1,0,30,29
1657555337392,ECE 180,B00,083141,Abi Samra; Nicholas Camill,0,0,30,30
1657555343415,MATH 10A,A01,083735,Patchell; Gregory David,2,0,30,28
1657555343415,MATH 10A,A02,083736,Patchell; Gregory David,20,0,30,10
1657555343415,MATH 10A,A03,083737,Patchell; Gregory David,16,0,30,14
1657555349443,MATH 10B,A01,083207,Lim; Seonhee,8,0,34,26
1657555349443,MATH 10B,A02,083208,Lim; Seonhee,9,0,35,26
1657555349443,MATH 10B,A03,093472,Lim; Seonhee,7,0,34,27
1657555349443,MATH 10B,B01,083739,Sinha; Shubham,12,0,30,18
1657555355472,MATH 18,A01,083743,Cinel; Cameron Alexander,7,0,30,23
1657555355472,MATH 18,A02,083744,Cinel; Cameron Alexander,17,0,30,13
1657555355472,MATH 18,A03,083745,Cinel; Cameron Alexander,9,0,30,21
1657555355472,MATH 18,B01,083748,Rideout; David Porter,5,0,37,32
1657555355472,MATH 18,B02,083749,Rideout; David Porter,5,0,36,31
1657555355472,MATH 18,B03,083750,Rideout; David Porter,3,0,37,34
1657555355472,MATH 18,B04,083751,Rideout; David Porter,6,0,36,30
1657555355472,MATH 18,B05,093473,Rideout; David Porter,6,0,36,30
1657555355472,MATH 18,B06,093474,Rideout; David Porter,6,0,36,30
1657555361495,MATH 20A,A01,083754,Zheng; Zequn,14,0,40,26
1657555367528,MATH 20B,A01,083756,Briones; Jor-el Thomas Caparas,4,0,36,32
1657555367528,MATH 20B,A02,083757,Briones; Jor-el Thomas Caparas,1,0,36,35
1657555367528,MATH 20B,A03,093475,Briones; Jor-el Thomas Caparas,2,0,36,34
1657555373551,MATH 20C,A01,083760,Briones; Jor-el Thomas Caparas,1,0,35,34
1657555373551,MATH 20C,A02,083761,Briones; Jor-el Thomas Caparas,8,0,35,27
1657555373551,MATH 20C,A03,093476,Briones; Jor-el Thomas Caparas,0,1,36,36
1657555373551,MATH 20C,B01,083762,Bach; Quang Tran,1,0,30,29
1657555379579,MATH 20D,A01,083765,Tran; Brian Kha,5,0,30,25
1657555379579,MATH 20D,A02,083766,Tran; Brian Kha,5,0,30,25
1657555379579,MATH 20D,A03,083767,Tran; Brian Kha,5,0,30,25
1657555385609,MATH 20E,A01,083771,Ganguly; Soumya,9,0,32,23
1657555385609,MATH 20E,A02,083772,Ganguly; Soumya,6,0,32,26
1657555385609,MATH 20E,B01,083773,Ciotti; Benjamin,20,0,35,15
1657555385609,MATH 20E,B02,083774,Ciotti; Benjamin,17,0,35,18
1657555391641,MATH 103A,A01,083777,Greenfeld; Be'Eri,3,0,36,33
1657555391641,MATH 103A,A02,083778,Greenfeld; Be'Eri,5,0,36,31
1657555391641,MATH 103A,A03,093561,Greenfeld; Be'Eri,5,0,36,31
1657555391641,MATH 103A,B01,083779,Greenfeld; Be'Eri,7,0,36,29
1657555391641,MATH 103A,B02,083780,Greenfeld; Be'Eri,4,0,36,32
1657555391641,MATH 103A,B03,093562,Greenfeld; Be'Eri,3,0,36,33
1657555397674,MATH 105,A01,085443,Carter; Anne Toulson,15,0,35,20
1657555397674,MATH 105,A02,093477,Carter; Anne Toulson,20,0,35,15
1657555403697,MATH 109,A01,083213,Ganzberger; Geoffrey Michael,2,0,34,32
1657555403697,MATH 109,A02,083214,Ganzberger; Geoffrey Michael,4,0,34,30
1657555403697,MATH 109,A03,093478,Ganzberger; Geoffrey Michael,2,0,34,32
1657555403697,MATH 109,B01,083215,Ganzberger; Geoffrey Michael,1,0,32,31
1657555403697,MATH 109,B02,083216,Ganzberger; Geoffrey Michael,2,0,32,30
1657555403697,MATH 109,B03,093479,Ganzberger; Geoffrey Michael,8,0,32,24
1657555409722,MATH 142A,A01,083219,Chow; Bennett,7,0,32,25
1657555409722,MATH 142A,A02,083220,Chow; Bennett,10,0,32,22
1657555409722,MATH 142A,A03,093480,Chow; Bennett,8,0,32,24
1657555409722,MATH 142A,B03,093481,Chow; Bennett,8,0,32,24
1657555409722,MATH 142A,B04,093558,Chow; Bennett,13,0,32,19
1657555409722,MATH 142A,B05,093559,Chow; Bennett,6,0,32,26
1657555415744,MATH 193A,A01,083224,Rotar; Vladimir,8,0,34,26
1657555415744,MATH 193A,A02,083225,Rotar; Vladimir,9,0,34,25
1657555415744,MATH 193A,A03,083781,Rotar; Vladimir,5,0,34,29
1657555415744,MATH 193A,A04,083782,Rotar; Vladimir,10,0,34,24
1657555415744,MATH 193A,A05,093482,Rotar; Vladimir,10,0,34,24
1657555421767,MATH 197,001,091859,McAuley; Julian John,9999,0,9999,0
1657555421767,MATH 197,002,095566,Kedlaya; Kiran S.,9997,0,9999,2
1657555421767,MATH 197,003,095567,Xiao; Ming,9999,0,9999,0
1657555421767,MATH 197,004,095571,Perols; Johan Lars,9998,0,9999,1
1657555428826,COGS 9,A01,083615,Shannon; Kyle Michael,9,0,75,66
1657555434850,COGS 11,A01,083617,Boyle; Mary E. T.,22,0,48,26
1657555440879,COGS 13,A01,083071,Bastos; Amalia Pinkusfeld,11,0,71,60
1657555446913,COGS 14A,A01,092681,Semenuks; Arturs,5,1,100,95
1657555452939,COGS 14B,A01,083073,Cheng; Tzu-Han,6,0,63,57
1657555458962,COGS 17,A01,092677,Semenuks; Arturs,6,0,81,75
1657555464988,COGS 100,A01,083619,Allen; Michael Gordon,17,0,70,53
1657555471011,COGS 101A,A01,083621,Davis; Joshua Daniel,9,0,68,59
1657555477034,COGS 101B,A01,091572,Allen; Michael Gordon,12,0,65,53
1657555483060,COGS 101C,A01,083625,Delgado; Tania,17,0,35,18
1657555489084,COGS 107A,A01,083627,Boyle; Mary E. T.,13,0,60,47
1657555495106,COGS 118A,A01,083075,Gupta; Anjum,21,0,76,55
1657555501148,CSE 3,A50,083646,Miranda; Gregory Joseph,24,0,50,26
1657555507175,CSE 8A,A50,083650,Miranda; Gregory Joseph,17,1,56,39
1657555513209,CSE 11,A01,083080,Cao; Yingjun,6,15,40,34
1657555519241,CSE 12,A01,083652,Krause-Levy; Sophia Louisa,28,1,120,92
1657555525270,CSE 15L,A01,083654,Morris; Justin Loren,9,0,50,41
1657555525270,CSE 15L,A02,083655,Morris; Justin Loren,9,0,50,41
1657555531300,CSE 20,A01,083657,Tran; Khoa Dang,39,0,80,41
1657555537321,CSE 21,A01,095574,Bach; Quang Tran,22,0,48,26
1657555543358,CSE 30,A01,083084,Eldon; John,5,0,80,75
1657555543358,CSE 30,B01,095061,Bhaskar; Nishant,9,0,50,41
1657555549382,CSE 100,A01,083659,Cao; Yingjun,5,4,70,65
1657555555404,CSE 134B,A01,083661,Powell; Thomas Allan,22,0,100,78
1657555561427,CSE 140,A01,083663,Gungor; Onat,15,0,85,70
1657555567453,CSE 140L,A01,083088,Eldon; John,21,0,100,79
1657555573480,CSE 175,A01,083665,Kumar; Rakesh,3,0,25,22
1657555579501,CSE 190,A00,092507,Dubnov; Shlomo,8,0,20,12
1657555585525,ECE 45,A01,083139,Congero; Spencer William,6,0,75,69
1657555591552,ECE 65,A50,083695,Saad; Andrew S,12,0,30,18
1657555591552,ECE 65,A51,095125,Saad; Andrew S,24,0,26,2
1657555597575,ECE 109,A01,091882,Touri; Behrouz,19,0,70,51
1657555603596,ECE 180,A00,083140,Abi Samra; Nicholas Camill,1,0,30,29
1657555603596,ECE 180,B00,083141,Abi Samra; Nicholas Camill,0,0,30,30
1657555609622,MATH 10A,A01,083735,Patchell; Gregory David,2,0,30,28
1657555609622,MATH 10A,A02,083736,Patchell; Gregory David,20,0,30,10
1657555609622,MATH 10A,A03,083737,Patchell; Gregory David,16,0,30,14
1657555615646,MATH 10B,A01,083207,Lim; Seonhee,8,0,34,26
1657555615646,MATH 10B,A02,083208,Lim; Seonhee,9,0,35,26
1657555615646,MATH 10B,A03,093472,Lim; Seonhee,7,0,34,27
1657555615646,MATH 10B,B01,083739,Sinha; Shubham,12,0,30,18
1657555621692,MATH 18,A01,083743,Cinel; Cameron Alexander,7,0,30,23
1657555621692,MATH 18,A02,083744,Cinel; Cameron Alexander,17,0,30,13
1657555621692,MATH 18,A03,083745,Cinel; Cameron Alexander,9,0,30,21
1657555621692,MATH 18,B01,083748,Rideout; David Porter,5,0,37,32
1657555621692,MATH 18,B02,083749,Rideout; David Porter,5,0,36,31
1657555621692,MATH 18,B03,083750,Rideout; David Porter,3,0,37,34
1657555621692,MATH 18,B04,083751,Rideout; David Porter,6,0,36,30
1657555621692,MATH 18,B05,093473,Rideout; David Porter,6,0,36,30
1657555621692,MATH 18,B06,093474,Rideout; David Porter,6,0,36,30
1657555627719,MATH 20A,A01,083754,Zheng; Zequn,14,0,40,26
1657555633843,MATH 20B,A01,083756,Briones; Jor-el Thomas Caparas,4,0,36,32
1657555633843,MATH 20B,A02,083757,Briones; Jor-el Thomas Caparas,1,0,36,35
1657555633843,MATH 20B,A03,093475,Briones; Jor-el Thomas Caparas,2,0,36,34
1657555639866,MATH 20C,A01,083760,Briones; Jor-el Thomas Caparas,1,0,35,34
1657555639866,MATH 20C,A02,083761,Briones; Jor-el Thomas Caparas,8,0,35,27
1657555639866,MATH 20C,A03,093476,Briones; Jor-el Thomas Caparas,0,1,36,36
1657555639866,MATH 20C,B01,083762,Bach; Quang Tran,1,0,30,29
1657555645893,MATH 20D,A01,083765,Tran; Brian Kha,5,0,30,25
1657555645893,MATH 20D,A02,083766,Tran; Brian Kha,5,0,30,25
1657555645893,MATH 20D,A03,083767,Tran; Brian Kha,5,0,30,25
1657555651921,MATH 20E,A01,083771,Ganguly; Soumya,9,0,32,23
1657555651921,MATH 20E,A02,083772,Ganguly; Soumya,6,0,32,26
1657555651921,MATH 20E,B01,083773,Ciotti; Benjamin,20,0,35,15
1657555651921,MATH 20E,B02,083774,Ciotti; Benjamin,17,0,35,18
1657555657949,MATH 103A,A01,083777,Greenfeld; Be'Eri,3,0,36,33
1657555657949,MATH 103A,A02,083778,Greenfeld; Be'Eri,5,0,36,31
1657555657949,MATH 103A,A03,093561,Greenfeld; Be'Eri,5,0,36,31
1657555657949,MATH 103A,B01,083779,Greenfeld; Be'Eri,7,0,36,29
1657555657949,MATH 103A,B02,083780,Greenfeld; Be'Eri,4,0,36,32
1657555657949,MATH 103A,B03,093562,Greenfeld; Be'Eri,3,0,36,33
1657555663976,MATH 105,A01,085443,Carter; Anne Toulson,15,0,35,20
1657555663976,MATH 105,A02,093477,Carter; Anne Toulson,20,0,35,15
1657555669998,MATH 109,A01,083213,Ganzberger; Geoffrey Michael,2,0,34,32
1657555669998,MATH 109,A02,083214,Ganzberger; Geoffrey Michael,4,0,34,30
1657555669998,MATH 109,A03,093478,Ganzberger; Geoffrey Michael,2,0,34,32
1657555669998,MATH 109,B01,083215,Ganzberger; Geoffrey Michael,1,0,32,31
1657555669998,MATH 109,B02,083216,Ganzberger; Geoffrey Michael,2,0,32,30
1657555669998,MATH 109,B03,093479,Ganzberger; Geoffrey Michael,8,0,32,24
1657555676027,MATH 142A,A01,083219,Chow; Bennett,7,0,32,25
1657555676027,MATH 142A,A02,083220,Chow; Bennett,10,0,32,22
1657555676027,MATH 142A,A03,093480,Chow; Bennett,8,0,32,24
1657555676027,MATH 142A,B03,093481,Chow; Bennett,8,0,32,24
1657555676027,MATH 142A,B04,093558,Chow; Bennett,13,0,32,19
1657555676027,MATH 142A,B05,093559,Chow; Bennett,6,0,32,26
1657555682049,MATH 193A,A01,083224,Rotar; Vladimir,8,0,34,26
1657555682049,MATH 193A,A02,083225,Rotar; Vladimir,9,0,34,25
1657555682049,MATH 193A,A03,083781,Rotar; Vladimir,5,0,34,29
1657555682049,MATH 193A,A04,083782,Rotar; Vladimir,10,0,34,24
1657555682049,MATH 193A,A05,093482,Rotar; Vladimir,10,0,34,24
1657555688073,MATH 197,001,091859,McAuley; Julian John,9999,0,9999,0
1657555688073,MATH 197,002,095566,Kedlaya; Kiran S.,9997,0,9999,2
1657555688073,MATH 197,003,095567,Xiao; Ming,9999,0,9999,0
1657555688073,MATH 197,004,095571,Perols; Johan Lars,9998,0,9999,1
1657555695132,COGS 9,A01,083615,Shannon; Kyle Michael,9,0,75,66
1657555701155,COGS 11,A01,083617,Boyle; Mary E. T.,22,0,48,26
1657555707179,COGS 13,A01,083071,Bastos; Amalia Pinkusfeld,11,0,71,60
1657555713203,COGS 14A,A01,092681,Semenuks; Arturs,5,1,100,95
1657555719236,COGS 14B,A01,083073,Cheng; Tzu-Han,6,0,63,57
1657555725262,COGS 17,A01,092677,Semenuks; Arturs,6,0,81,75
1657555731284,COGS 100,A01,083619,Allen; Michael Gordon,17,0,70,53
1657555737309,COGS 101A,A01,083621,Davis; Joshua Daniel,9,0,68,59
1657555743331,COGS 101B,A01,091572,Allen; Michael Gordon,12,0,65,53
1657555749355,COGS 101C,A01,083625,Delgado; Tania,17,0,35,18
1657555755380,COGS 107A,A01,083627,Boyle; Mary E. T.,13,0,60,47
1657555761406,COGS 118A,A01,083075,Gupta; Anjum,21,0,76,55
1657555767430,CSE 3,A50,083646,Miranda; Gregory Joseph,24,0,50,26
1657555773465,CSE 8A,A50,083650,Miranda; Gregory Joseph,17,1,56,39
1657555779488,CSE 11,A01,083080,Cao; Yingjun,6,15,40,34
1657555785513,CSE 12,A01,083652,Krause-Levy; Sophia Louisa,28,1,120,92
1657555791541,CSE 15L,A01,083654,Morris; Justin Loren,9,0,50,41
1657555791541,CSE 15L,A02,083655,Morris; Justin Loren,9,0,50,41
1657555797602,CSE 20,A01,083657,Tran; Khoa Dang,39,0,80,41
1657555803626,CSE 21,A01,095574,Bach; Quang Tran,22,0,48,26
1657555809652,CSE 30,A01,083084,Eldon; John,5,0,80,75
1657555809652,CSE 30,B01,095061,Bhaskar; Nishant,9,0,50,41
1657555815673,CSE 100,A01,083659,Cao; Yingjun,5,4,70,65
1657555821697,CSE 134B,A01,083661,Powell; Thomas Allan,22,0,100,78
1657555827718,CSE 140,A01,083663,Gungor; Onat,15,0,85,70
1657555833747,CSE 140L,A01,083088,Eldon; John,21,0,100,79
1657555839787,CSE 175,A01,083665,Kumar; Rakesh,3,0,25,22
1657555845809,CSE 190,A00,092507,Dubnov; Shlomo,8,0,20,12
1657555851833,ECE 45,A01,083139,Congero; Spencer William,6,0,75,69
1657555857859,ECE 65,A50,083695,Saad; Andrew S,12,0,30,18
1657555857859,ECE 65,A51,095125,Saad; Andrew S,24,0,26,2
1657555863885,ECE 109,A01,091882,Touri; Behrouz,19,0,70,51
1657555869908,ECE 180,A00,083140,Abi Samra; Nicholas Camill,1,0,30,29
1657555869908,ECE 180,B00,083141,Abi Samra; Nicholas Camill,0,0,30,30
1657555875935,MATH 10A,A01,083735,Patchell; Gregory David,2,0,30,28
1657555875935,MATH 10A,A02,083736,Patchell; Gregory David,20,0,30,10
1657555875935,MATH 10A,A03,083737,Patchell; Gregory David,16,0,30,14
1657555881964,MATH 10B,A01,083207,Lim; Seonhee,8,0,34,26
1657555881964,MATH 10B,A02,083208,Lim; Seonhee,9,0,35,26
1657555881964,MATH 10B,A03,093472,Lim; Seonhee,7,0,34,27
1657555881964,MATH 10B,B01,083739,Sinha; Shubham,12,0,30,18
1657555887987,MATH 18,A01,083743,Cinel; Cameron Alexander,7,0,30,23
1657555887987,MATH 18,A02,083744,Cinel; Cameron Alexander,17,0,30,13
1657555887987,MATH 18,A03,083745,Cinel; Cameron Alexander,9,0,30,21
1657555887987,MATH 18,B01,083748,Rideout; David Porter,5,0,37,32
1657555887987,MATH 18,B02,083749,Rideout; David Porter,5,0,36,31
1657555887987,MATH 18,B03,083750,Rideout; David Porter,3,0,37,34
1657555887987,MATH 18,B04,083751,Rideout; David Porter,6,0,36,30
1657555887987,MATH 18,B05,093473,Rideout; David Porter,6,0,36,30
1657555887987,MATH 18,B06,093474,Rideout; David Porter,6,0,36,30
1657555894017,MATH 20A,A01,083754,Zheng; Zequn,14,0,40,26
1657555900044,MATH 20B,A01,083756,Briones; Jor-el Thomas Caparas,4,0,36,32
1657555900044,MATH 20B,A02,083757,Briones; Jor-el Thomas Caparas,1,0,36,35
1657555900044,MATH 20B,A03,093475,Briones; Jor-el Thomas Caparas,2,0,36,34
1657555906074,MATH 20C,A01,083760,Briones; Jor-el Thomas Caparas,1,0,35,34
1657555906074,MATH 20C,A02,083761,Briones; Jor-el Thomas Caparas,8,0,35,27
1657555906074,MATH 20C,A03,093476,Briones; Jor-el Thomas Caparas,0,1,36,36
1657555906074,MATH 20C,B01,083762,Bach; Quang Tran,1,0,30,29
1657555912101,MATH 20D,A01,083765,Tran; Brian Kha,5,0,30,25
1657555912101,MATH 20D,A02,083766,Tran; Brian Kha,5,0,30,25
1657555912101,MATH 20D,A03,083767,Tran; Brian Kha,5,0,30,25
1657555918124,MATH 20E,A01,083771,Ganguly; Soumya,9,0,32,23
1657555918124,MATH 20E,A02,083772,Ganguly; Soumya,6,0,32,26
1657555918124,MATH 20E,B01,083773,Ciotti; Benjamin,20,0,35,15
1657555918124,MATH 20E,B02,083774,Ciotti; Benjamin,17,0,35,18
1657555924153,MATH 103A,A01,083777,Greenfeld; Be'Eri,3,0,36,33
1657555924153,MATH 103A,A02,083778,Greenfeld; Be'Eri,5,0,36,31
1657555924153,MATH 103A,A03,093561,Greenfeld; Be'Eri,5,0,36,31
1657555924153,MATH 103A,B01,083779,Greenfeld; Be'Eri,7,0,36,29
1657555924153,MATH 103A,B02,083780,Greenfeld; Be'Eri,4,0,36,32
1657555924153,MATH 103A,B03,093562,Greenfeld; Be'Eri,3,0,36,33
1657555930178,MATH 105,A01,085443,Carter; Anne Toulson,15,0,35,20
1657555930178,MATH 105,A02,093477,Carter; Anne Toulson,20,0,35,15
1657555936208,MATH 109,A01,083213,Ganzberger; Geoffrey Michael,2,0,34,32
1657555936208,MATH 109,A02,083214,Ganzberger; Geoffrey Michael,4,0,34,30
1657555936208,MATH 109,A03,093478,Ganzberger; Geoffrey Michael,2,0,34,32
1657555936208,MATH 109,B01,083215,Ganzberger; Geoffrey Michael,1,0,32,31
1657555936208,MATH 109,B02,083216,Ganzberger; Geoffrey Michael,2,0,32,30
1657555936208,MATH 109,B03,093479,Ganzberger; Geoffrey Michael,8,0,32,24
1657555942235,MATH 142A,A01,083219,Chow; Bennett,7,0,32,25
1657555942235,MATH 142A,A02,083220,Chow; Bennett,10,0,32,22
1657555942235,MATH 142A,A03,093480,Chow; Bennett,8,0,32,24
1657555942235,MATH 142A,B03,093481,Chow; Bennett,8,0,32,24
1657555942235,MATH 142A,B04,093558,Chow; Bennett,13,0,32,19
1657555942235,MATH 142A,B05,093559,Chow; Bennett,6,0,32,26
1657555948262,MATH 193A,A01,083224,Rotar; Vladimir,8,0,34,26
1657555948262,MATH 193A,A02,083225,Rotar; Vladimir,9,0,34,25
1657555948262,MATH 193A,A03,083781,Rotar; Vladimir,5,0,34,29
1657555948262,MATH 193A,A04,083782,Rotar; Vladimir,10,0,34,24
1657555948262,MATH 193A,A05,093482,Rotar; Vladimir,10,0,34,24
1657555954285,MATH 197,001,091859,McAuley; Julian John,9999,0,9999,0
1657555954285,MATH 197,002,095566,Kedlaya; Kiran S.,9997,0,9999,2
1657555954285,MATH 197,003,095567,Xiao; Ming,9999,0,9999,0
1657555954285,MATH 197,004,095571,Perols; Johan Lars,9998,0,9999,1
1657555961344,COGS 9,A01,083615,Shannon; Kyle Michael,9,0,75,66
1657555967383,COGS 11,A01,083617,Boyle; Mary E. T.,22,0,48,26
1657555973409,COGS 13,A01,083071,Bastos; Amalia Pinkusfeld,11,0,71,60
1657555979431,COGS 14A,A01,092681,Semenuks; Arturs,5,1,100,95
1657555985453,COGS 14B,A01,083073,Cheng; Tzu-Han,6,0,63,57
1657555991476,COGS 17,A01,092677,Semenuks; Arturs,6,0,81,75
1657555997501,COGS 100,A01,083619,Allen; Michael Gordon,17,0,70,53
1657556003525,COGS 101A,A01,083621,Davis; Joshua Daniel,9,0,68,59
1657556009552,COGS 101B,A01,091572,Allen; Michael Gordon,12,0,65,53
1657556015579,COGS 101C,A01,083625,Delgado; Tania,17,0,35,18
1657556021610,COGS 107A,A01,083627,Boyle; Mary E. T.,13,0,60,47
1657556027636,COGS 118A,A01,083075,Gupta; Anjum,21,0,76,55
1657556033662,CSE 3,A50,083646,Miranda; Gregory Joseph,24,0,50,26
1657556039692,CSE 8A,A50,083650,Miranda; Gregory Joseph,17,1,56,39
1657556045718,CSE 11,A01,083080,Cao; Yingjun,6,15,40,34
1657556051739,CSE 12,A01,083652,Krause-Levy; Sophia Louisa,28,1,120,92
1657556057767,CSE 15L,A01,083654,Morris; Justin Loren,9,0,50,41
1657556057767,CSE 15L,A02,083655,Morris; Justin Loren,9,0,50,41
1657556063790,CSE 20,A01,083657,Tran; Khoa Dang,39,0,80,41
1657556069817,CSE 21,A01,095574,Bach; Quang Tran,22,0,48,26
1657556075845,CSE 30,A01,083084,Eldon; John,5,0,80,75
1657556075845,CSE 30,B01,095061,Bhaskar; Nishant,9,0,50,41
1657556081872,CSE 100,A01,083659,Cao; Yingjun,5,4,70,65
1657556087902,CSE 134B,A01,083661,Powell; Thomas Allan,22,0,100,78
1657556093928,CSE 140,A01,083663,Gungor; Onat,15,0,85,70
1657556099950,CSE 140L,A01,083088,Eldon; John,21,0,100,79
1657556105988,CSE 175,A01,083665,Kumar; Rakesh,3,0,25,22
1657556112010,CSE 190,A00,092507,Dubnov; Shlomo,8,0,20,12
1657556118043,ECE 45,A01,083139,Congero; Spencer William,6,0,75,69
1657556124067,ECE 65,A50,083695,Saad; Andrew S,12,0,30,18
1657556124067,ECE 65,A51,095125,Saad; Andrew S,24,0,26,2
1657556130093,ECE 109,A01,091882,Touri; Behrouz,19,0,70,51
1657556136116,ECE 180,A00,083140,Abi Samra; Nicholas Camill,1,0,30,29
1657556136116,ECE 180,B00,083141,Abi Samra; Nicholas Camill,0,0,30,30
1657556142139,MATH 10A,A01,083735,Patchell; Gregory David,2,0,30,28
1657556142139,MATH 10A,A02,083736,Patchell; Gregory David,20,0,30,10
1657556142139,MATH 10A,A03,083737,Patchell; Gregory David,16,0,30,14
1657556148169,MATH 10B,A01,083207,Lim; Seonhee,8,0,34,26
1657556148169,MATH 10B,A02,083208,Lim; Seonhee,9,0,35,26
1657556148169,MATH 10B,A03,093472,Lim; Seonhee,7,0,34,27
1657556148169,MATH 10B,B01,083739,Sinha; Shubham,12,0,30,18
1657556154193,MATH 18,A01,083743,Cinel; Cameron Alexander,7,0,30,23
1657556154193,MATH 18,A02,083744,Cinel; Cameron Alexander,17,0,30,13
1657556154193,MATH 18,A03,083745,Cinel; Cameron Alexander,9,0,30,21
1657556154193,MATH 18,B01,083748,Rideout; David Porter,5,0,37,32
1657556154193,MATH 18,B02,083749,Rideout; David Porter,5,0,36,31
1657556154193,MATH 18,B03,083750,Rideout; David Porter,3,0,37,34
1657556154193,MATH 18,B04,083751,Rideout; David Porter,6,0,36,30
1657556154193,MATH 18,B05,093473,Rideout; David Porter,6,0,36,30
1657556154193,MATH 18,B06,093474,Rideout; David Porter,6,0,36,30
1657556160225,MATH 20A,A01,083754,Zheng; Zequn,14,0,40,26
1657556166258,MATH 20B,A01,083756,Briones; Jor-el Thomas Caparas,4,0,36,32
1657556166258,MATH 20B,A02,083757,Briones; Jor-el Thomas Caparas,1,0,36,35
1657556166258,MATH 20B,A03,093475,Briones; Jor-el Thomas Caparas,2,0,36,34
1657556172280,MATH 20C,A01,083760,Briones; Jor-el Thomas Caparas,1,0,35,34
1657556172280,MATH 20C,A02,083761,Briones; Jor-el Thomas Caparas,8,0,35,27
1657556172280,MATH 20C,A03,093476,Briones; Jor-el Thomas Caparas,0,1,36,36
1657556172280,MATH 20C,B01,083762,Bach; Quang Tran,1,0,30,29
1657556178301,MATH 20D,A01,083765,Tran; Brian Kha,5,0,30,25
1657556178301,MATH 20D,A02,083766,Tran; Brian Kha,5,0,30,25
1657556178301,MATH 20D,A03,083767,Tran; Brian Kha,5,0,30,25
1657556184332,MATH 20E,A01,083771,Ganguly; Soumya,9,0,32,23
1657556184332,MATH 20E,A02,083772,Ganguly; Soumya,6,0,32,26
1657556184332,MATH 20E,B01,083773,Ciotti; Benjamin,20,0,35,15
1657556184332,MATH 20E,B02,083774,Ciotti; Benjamin,17,0,35,18
1657556190361,MATH 103A,A01,083777,Greenfeld; Be'Eri,3,0,36,33
1657556190361,MATH 103A,A02,083778,Greenfeld; Be'Eri,5,0,36,31
1657556190361,MATH 103A,A03,093561,Greenfeld; Be'Eri,5,0,36,31
1657556190361,MATH 103A,B01,083779,Greenfeld; Be'Eri,7,0,36,29
1657556190361,MATH 103A,B02,083780,Greenfeld; Be'Eri,4,0,36,32
1657556190361,MATH 103A,B03,093562,Greenfeld; Be'Eri,3,0,36,33
1657556196384,MATH 105,A01,085443,Carter; Anne Toulson,15,0,35,20
1657556196384,MATH 105,A02,093477,Carter; Anne Toulson,20,0,35,15
1657556202414,MATH 109,A01,083213,Ganzberger; Geoffrey Michael,2,0,34,32
1657556202414,MATH 109,A02,083214,Ganzberger; Geoffrey Michael,4,0,34,30
1657556202414,MATH 109,A03,093478,Ganzberger; Geoffrey Michael,2,0,34,32
1657556202414,MATH 109,B01,083215,Ganzberger; Geoffrey Michael,1,0,32,31
1657556202414,MATH 109,B02,083216,Ganzberger; Geoffrey Michael,2,0,32,30
1657556202414,MATH 109,B03,093479,Ganzberger; Geoffrey Michael,8,0,32,24
1657556208457,MATH 142A,A01,083219,Chow; Bennett,7,0,32,25
1657556208457,MATH 142A,A02,083220,Chow; Bennett,10,0,32,22
1657556208457,MATH 142A,A03,093480,Chow; Bennett,8,0,32,24
1657556208457,MATH 142A,B03,093481,Chow; Bennett,8,0,32,24
1657556208457,MATH 142A,B04,093558,Chow; Bennett,13,0,32,19
1657556208457,MATH 142A,B05,093559,Chow; Bennett,6,0,32,26
1657556214490,MATH 193A,A01,083224,Rotar; Vladimir,8,0,34,26
1657556214490,MATH 193A,A02,083225,Rotar; Vladimir,9,0,34,25
1657556214490,MATH 193A,A03,083781,Rotar; Vladimir,5,0,34,29
1657556214490,MATH 193A,A04,083782,Rotar; Vladimir,10,0,34,24
1657556214490,MATH 193A,A05,093482,Rotar; Vladimir,10,0,34,24
1657556220527,MATH 197,001,091859,McAuley; Julian John,9999,0,9999,0
1657556220527,MATH 197,002,095566,Kedlaya; Kiran S.,9997,0,9999,2
1657556220527,MATH 197,003,095567,Xiao; Ming,9999,0,9999,0
1657556220527,MATH 197,004,095571,Perols; Johan Lars,9998,0,9999,1
1657556227667,COGS 9,A01,083615,Shannon; Kyle Michael,9,0,75,66
1657556233697,COGS 11,A01,083617,Boyle; Mary E. T.,22,0,48,26
1657556239720,COGS 13,A01,083071,Bastos; Amalia Pinkusfeld,11,0,71,60
1657556245747,COGS 14A,A01,092681,Semenuks; Arturs,5,1,100,95
1657556251768,COGS 14B,A01,083073,Cheng; Tzu-Han,6,0,63,57
1657556257796,COGS 17,A01,092677,Semenuks; Arturs,6,0,81,75
1657556263831,COGS 100,A01,083619,Allen; Michael Gordon,17,0,70,53
1657556269855,COGS 101A,A01,083621,Davis; Joshua Daniel,9,0,68,59
1657556275878,COGS 101B,A01,091572,Allen; Michael Gordon,12,0,65,53
1657556281902,COGS 101C,A01,083625,Delgado; Tania,17,0,35,18
1657556287926,COGS 107A,A01,083627,Boyle; Mary E. T.,13,0,60,47
1657556293949,COGS 118A,A01,083075,Gupta; Anjum,21,0,76,55
1657556299976,CSE 3,A50,083646,Miranda; Gregory Joseph,24,0,50,26
1657556305999,CSE 8A,A50,083650,Miranda; Gregory Joseph,17,1,56,39
1657556312023,CSE 11,A01,083080,Cao; Yingjun,6,15,40,34
1657556318049,CSE 12,A01,083652,Krause-Levy; Sophia Louisa,28,1,120,92
1657556324076,CSE 15L,A01,083654,Morris; Justin Loren,9,0,50,41
1657556324076,CSE 15L,A02,083655,Morris; Justin Loren,9,0,50,41
1657556330108,CSE 20,A01,083657,Tran; Khoa Dang,39,0,80,41
1657556336131,CSE 21,A01,095574,Bach; Quang Tran,22,0,48,26
1657556342162,CSE 30,A01,083084,Eldon; John,5,0,80,75
1657556342162,CSE 30,B01,095061,Bhaskar; Nishant,9,0,50,41
1657556348189,CSE 100,A01,083659,Cao; Yingjun,5,4,70,65
1657556354221,CSE 134B,A01,083661,Powell; Thomas Allan,22,0,100,78
1657556360247,CSE 140,A01,083663,Gungor; Onat,15,0,85,70
1657556366271,CSE 140L,A01,083088,Eldon; John,21,0,100,79
1657556372297,CSE 175,A01,083665,Kumar; Rakesh,3,0,25,22
1657556378322,CSE 190,A00,092507,Dubnov; Shlomo,8,0,20,12
1657556384352,ECE 45,A01,083139,Congero; Spencer William,6,0,75,69
1657556390384,ECE 65,A50,083695,Saad; Andrew S,12,0,30,18
1657556390384,ECE 65,A51,095125,Saad; Andrew S,24,0,26,2
1657556396406,ECE 109,A01,091882,Touri; Behrouz,19,0,70,51
1657556402431,ECE 180,A00,083140,Abi Samra; Nicholas Camill,1,0,30,29
1657556402431,ECE 180,B00,083141,Abi Samra; Nicholas Camill,0,0,30,30
1657556408467,MATH 10A,A01,083735,Patchell; Gregory David,2,0,30,28
1657556408467,MATH 10A,A02,083736,Patchell; Gregory David,20,0,30,10
1657556408467,MATH 10A,A03,083737,Patchell; Gregory David,16,0,30,14
1657556414489,MATH 10B,A01,083207,Lim; Seonhee,8,0,34,26
1657556414489,MATH 10B,A02,083208,Lim; Seonhee,9,0,35,26
1657556414489,MATH 10B,A03,093472,Lim; Seonhee,7,0,34,27
1657556414489,MATH 10B,B01,083739,Sinha; Shubham,12,0,30,18
1657556420521,MATH 18,A01,083743,Cinel; Cameron Alexander,7,0,30,23
1657556420521,MATH 18,A02,083744,Cinel; Cameron Alexander,17,0,30,13
1657556420521,MATH 18,A03,083745,Cinel; Cameron Alexander,9,0,30,21
1657556420521,MATH 18,B01,083748,Rideout; David Porter,5,0,37,32
1657556420521,MATH 18,B02,083749,Rideout; David Porter,5,0,36,31
1657556420521,MATH 18,B03,083750,Rideout; David Porter,3,0,37,34
1657556420521,MATH 18,B04,083751,Rideout; David Porter,6,0,36,30
1657556420521,MATH 18,B05,093473,Rideout; David Porter,6,0,36,30
1657556420521,MATH 18,B06,093474,Rideout; David Porter,6,0,36,30
1657556426544,MATH 20A,A01,083754,Zheng; Zequn,14,0,40,26
1657556432573,MATH 20B,A01,083756,Briones; Jor-el Thomas Caparas,4,0,36,32
1657556432573,MATH 20B,A02,083757,Briones; Jor-el Thomas Caparas,1,0,36,35
1657556432573,MATH 20B,A03,093475,Briones; Jor-el Thomas Caparas,2,0,36,34
1657556438597,MATH 20C,A01,083760,Briones; Jor-el Thomas Caparas,1,0,35,34
1657556438597,MATH 20C,A02,083761,Briones; Jor-el Thomas Caparas,8,0,35,27
1657556438597,MATH 20C,A03,093476,Briones; Jor-el Thomas Caparas,0,1,36,36
1657556438597,MATH 20C,B01,083762,Bach; Quang Tran,1,0,30,29
1657556444626,MATH 20D,A01,083765,Tran; Brian Kha,5,0,30,25
1657556444626,MATH 20D,A02,083766,Tran; Brian Kha,5,0,30,25
1657556444626,MATH 20D,A03,083767,Tran; Brian Kha,5,0,30,25
1657556450686,MATH 20E,A01,083771,Ganguly; Soumya,9,0,32,23
1657556450686,MATH 20E,A02,083772,Ganguly; Soumya,6,0,32,26
1657556450686,MATH 20E,B01,083773,Ciotti; Benjamin,20,0,35,15
1657556450686,MATH 20E,B02,083774,Ciotti; Benjamin,17,0,35,18
1657556456710,MATH 103A,A01,083777,Greenfeld; Be'Eri,3,0,36,33
1657556456710,MATH 103A,A02,083778,Greenfeld; Be'Eri,5,0,36,31
1657556456710,MATH 103A,A03,093561,Greenfeld; Be'Eri,5,0,36,31
1657556456710,MATH 103A,B01,083779,Greenfeld; Be'Eri,7,0,36,29
1657556456710,MATH 103A,B02,083780,Greenfeld; Be'Eri,4,0,36,32
1657556456710,MATH 103A,B03,093562,Greenfeld; Be'Eri,3,0,36,33
1657556462739,MATH 105,A01,085443,Carter; Anne Toulson,15,0,35,20
1657556462739,MATH 105,A02,093477,Carter; Anne Toulson,20,0,35,15
1657556468768,MATH 109,A01,083213,Ganzberger; Geoffrey Michael,2,0,34,32
1657556468768,MATH 109,A02,083214,Ganzberger; Geoffrey Michael,4,0,34,30
1657556468768,MATH 109,A03,093478,Ganzberger; Geoffrey Michael,2,0,34,32
1657556468768,MATH 109,B01,083215,Ganzberger; Geoffrey Michael,1,0,32,31
1657556468768,MATH 109,B02,083216,Ganzberger; Geoffrey Michael,2,0,32,30
1657556468768,MATH 109,B03,093479,Ganzberger; Geoffrey Michael,8,0,32,24
1657556474794,MATH 142A,A01,083219,Chow; Bennett,7,0,32,25
1657556474794,MATH 142A,A02,083220,Chow; Bennett,10,0,32,22
1657556474794,MATH 142A,A03,093480,Chow; Bennett,8,0,32,24
1657556474794,MATH 142A,B03,093481,Chow; Bennett,8,0,32,24
1657556474794,MATH 142A,B04,093558,Chow; Bennett,13,0,32,19
1657556474794,MATH 142A,B05,093559,Chow; Bennett,6,0,32,26
1657556480818,MATH 193A,A01,083224,Rotar; Vladimir,8,0,34,26
1657556480818,MATH 193A,A02,083225,Rotar; Vladimir,9,0,34,25
1657556480818,MATH 193A,A03,083781,Rotar; Vladimir,5,0,34,29
1657556480818,MATH 193A,A04,083782,Rotar; Vladimir,10,0,34,24
1657556480818,MATH 193A,A05,093482,Rotar; Vladimir,10,0,34,24
1657556486840,MATH 197,001,091859,McAuley; Julian John,9999,0,9999,0
1657556486840,MATH 197,002,095566,Kedlaya; Kiran S.,9997,0,9999,2
1657556486840,MATH 197,003,095567,Xiao; Ming,9999,0,9999,0
1657556486840,MATH 197,004,095571,Perols; Johan Lars,9998,0,9999,1
1657556493903,COGS 9,A01,083615,Shannon; Kyle Michael,9,0,75,66
1657556499925,COGS 11,A01,083617,Boyle; Mary E. T.,22,0,48,26
1657556505948,COGS 13,A01,083071,Bastos; Amalia Pinkusfeld,11,0,71,60
1657556511974,COGS 14A,A01,092681,Semenuks; Arturs,5,1,100,95
1657556518000,COGS 14B,A01,083073,Cheng; Tzu-Han,6,0,63,57
1657556524034,COGS 17,A01,092677,Semenuks; Arturs,6,0,81,75
1657556530061,COGS 100,A01,083619,Allen; Michael Gordon,17,0,70,53
1657556536084,COGS 101A,A01,083621,Davis; Joshua Daniel,9,0,68,59
1657556542115,COGS 101B,A01,091572,Allen; Michael Gordon,12,0,65,53
1657556548142,COGS 101C,A01,083625,Delgado; Tania,17,0,35,18
1657556554165,COGS 107A,A01,083627,Boyle; Mary E. T.,13,0,60,47
1657556560187,COGS 118A,A01,083075,Gupta; Anjum,21,0,76,55
1657556566211,CSE 3,A50,083646,Miranda; Gregory Joseph,24,0,50,26
1657556572238,CSE 8A,A50,083650,Miranda; Gregory Joseph,17,1,56,39
1657556578260,CSE 11,A01,083080,Cao; Yingjun,6,15,40,34
1657556584288,CSE 12,A01,083652,Krause-Levy; Sophia Louisa,28,1,120,92
1657556590311,CSE 15L,A01,083654,Morris; Justin Loren,9,0,50,41
1657556590311,CSE 15L,A02,083655,Morris; Justin Loren,9,0,50,41
1657556596338,CSE 20,A01,083657,Tran; Khoa Dang,39,0,80,41
1657556602367,CSE 21,A01,095574,Bach; Quang Tran,22,0,48,26
1657556608397,CSE 30,A01,083084,Eldon; John,5,0,80,75
1657556608397,CSE 30,B01,095061,Bhaskar; Nishant,9,0,50,41
1657556614422,CSE 100,A01,083659,Cao; Yingjun,5,4,70,65
1657556620446,CSE 134B,A01,083661,Powell; Thomas Allan,22,0,100,78
1657556626476,CSE 140,A01,083663,Gungor; Onat,15,0,85,70
1657556632501,CSE 140L,A01,083088,Eldon; John,21,0,100,79
1657556638537,CSE 175,A01,083665,Kumar; Rakesh,3,0,25,22
1657556644558,CSE 190,A00,092507,Dubnov; Shlomo,8,0,20,12
1657556650595,ECE 45,A01,083139,Congero; Spencer William,6,0,75,69
1657556656620,ECE 65,A50,083695,Saad; Andrew S,12,0,30,18
1657556656620,ECE 65,A51,095125,Saad; Andrew S,24,0,26,2
1657556662647,ECE 109,A01,091882,Touri; Behrouz,19,0,70,51
1657556668670,ECE 180,A00,083140,Abi Samra; Nicholas Camill,1,0,30,29
1657556668670,ECE 180,B00,083141,Abi Samra; Nicholas Camill,0,0,30,30
1657556674693,MATH 10A,A01,083735,Patchell; Gregory David,2,0,30,28
1657556674693,MATH 10A,A02,083736,Patchell; Gregory David,20,0,30,10
1657556674693,MATH 10A,A03,083737,Patchell; Gregory David,16,0,30,14
1657556680724,MATH 10B,A01,083207,Lim; Seonhee,8,0,34,26
1657556680724,MATH 10B,A02,083208,Lim; Seonhee,9,0,35,26
1657556680724,MATH 10B,A03,093472,Lim; Seonhee,7,0,34,27
1657556680724,MATH 10B,B01,083739,Sinha; Shubham,12,0,30,18
1657556686747,MATH 18,A01,083743,Cinel; Cameron Alexander,7,0,30,23
1657556686747,MATH 18,A02,083744,Cinel; Cameron Alexander,17,0,30,13
1657556686747,MATH 18,A03,083745,Cinel; Cameron Alexander,9,0,30,21
1657556686747,MATH 18,B01,083748,Rideout; David Porter,5,0,37,32
1657556686747,MATH 18,B02,083749,Rideout; David Porter,5,0,36,31
1657556686747,MATH 18,B03,083750,Rideout; David Porter,3,0,37,34
1657556686747,MATH 18,B04,083751,Rideout; David Porter,6,0,36,30
1657556686747,MATH 18,B05,093473,Rideout; David Porter,6,0,36,30
1657556686747,MATH 18,B06,093474,Rideout; David Porter,6,0,36,30
1657556692772,MATH 20A,A01,083754,Zheng; Zequn,14,0,40,26
1657556698795,MATH 20B,A01,083756,Briones; Jor-el Thomas Caparas,4,0,36,32
1657556698795,MATH 20B,A02,083757,Briones; Jor-el Thomas Caparas,1,0,36,35
1657556698795,MATH 20B,A03,093475,Briones; Jor-el Thomas Caparas,2,0,36,34
1657556704818,MATH 20C,A01,083760,Briones; Jor-el Thomas Caparas,1,0,35,34
1657556704818,MATH 20C,A02,083761,Briones; Jor-el Thomas Caparas,8,0,35,27
1657556704818,MATH 20C,A03,093476,Briones; Jor-el Thomas Caparas,0,1,36,36
1657556704818,MATH 20C,B01,083762,Bach; Quang Tran,1,0,30,29
1657556710850,MATH 20D,A01,083765,Tran; Brian Kha,5,0,30,25
1657556710850,MATH 20D,A02,083766,Tran; Brian Kha,5,0,30,25
1657556710850,MATH 20D,A03,083767,Tran; Brian Kha,5,0,30,25
1657556716874,MATH 20E,A01,083771,Ganguly; Soumya,9,0,32,23
1657556716874,MATH 20E,A02,083772,Ganguly; Soumya,6,0,32,26
1657556716874,MATH 20E,B01,083773,Ciotti; Benjamin,20,0,35,15
1657556716874,MATH 20E,B02,083774,Ciotti; Benjamin,17,0,35,18
1657556722897,MATH 103A,A01,083777,Greenfeld; Be'Eri,3,0,36,33
1657556722897,MATH 103A,A02,083778,Greenfeld; Be'Eri,5,0,36,31
1657556722897,MATH 103A,A03,093561,Greenfeld; Be'Eri,5,0,36,31
1657556722897,MATH 103A,B01,083779,Greenfeld; Be'Eri,7,0,36,29
1657556722897,MATH 103A,B02,083780,Greenfeld; Be'Eri,4,0,36,32
1657556722897,MATH 103A,B03,093562,Greenfeld; Be'Eri,3,0,36,33
1657556728925,MATH 105,A01,085443,Carter; Anne Toulson,15,0,35,20
1657556728925,MATH 105,A02,093477,Carter; Anne Toulson,20,0,35,15
1657556734952,MATH 109,A01,083213,Ganzberger; Geoffrey Michael,2,0,34,32
1657556734952,MATH 109,A02,083214,Ganzberger; Geoffrey Michael,4,0,34,30
1657556734952,MATH 109,A03,093478,Ganzberger; Geoffrey Michael,2,0,34,32
1657556734952,MATH 109,B01,083215,Ganzberger; Geoffrey Michael,1,0,32,31
1657556734952,MATH 109,B02,083216,Ganzberger; Geoffrey Michael,2,0,32,30
1657556734952,MATH 109,B03,093479,Ganzberger; Geoffrey Michael,8,0,32,24
1657556741003,MATH 142A,A01,083219,Chow; Bennett,7,0,32,25
1657556741003,MATH 142A,A02,083220,Chow; Bennett,10,0,32,22
1657556741003,MATH 142A,A03,093480,Chow; Bennett,8,0,32,24
1657556741003,MATH 142A,B03,093481,Chow; Bennett,8,0,32,24
1657556741003,MATH 142A,B04,093558,Chow; Bennett,13,0,32,19
1657556741003,MATH 142A,B05,093559,Chow; Bennett,6,0,32,26
1657556747046,MATH 193A,A01,083224,Rotar; Vladimir,8,0,34,26
1657556747046,MATH 193A,A02,083225,Rotar; Vladimir,9,0,34,25
1657556747046,MATH 193A,A03,083781,Rotar; Vladimir,5,0,34,29
1657556747046,MATH 193A,A04,083782,Rotar; Vladimir,10,0,34,24
1657556747046,MATH 193A,A05,093482,Rotar; Vladimir,10,0,34,24
1657556753074,MATH 197,001,091859,McAuley; Julian John,9999,0,9999,0
1657556753074,MATH 197,002,095566,Kedlaya; Kiran S.,9997,0,9999,2
1657556753074,MATH 197,003,095567,Xiao; Ming,9999,0,9999,0
1657556753074,MATH 197,004,095571,Perols; Johan Lars,9998,0,9999,1
1657556760135,COGS 9,A01,083615,Shannon; Kyle Michael,9,0,75,66
1657556766159,COGS 11,A01,083617,Boyle; Mary E. T.,22,0,48,26
1657556772185,COGS 13,A01,083071,Bastos; Amalia Pinkusfeld,11,0,71,60
1657556778212,COGS 14A,A01,092681,Semenuks; Arturs,5,1,100,95
1657556784235,COGS 14B,A01,083073,Cheng; Tzu-Han,6,0,63,57
1657556790259,COGS 17,A01,092677,Semenuks; Arturs,6,0,81,75
1657556796282,COGS 100,A01,083619,Allen; Michael Gordon,17,0,70,53
1657556802311,COGS 101A,A01,083621,Davis; Joshua Daniel,9,0,68,59
1657556808334,COGS 101B,A01,091572,Allen; Michael Gordon,12,0,65,53
1657556814357,COGS 101C,A01,083625,Delgado; Tania,17,0,35,18
1657556820385,COGS 107A,A01,083627,Boyle; Mary E. T.,13,0,60,47
1657556826479,COGS 118A,A01,083075,Gupta; Anjum,21,0,76,55
1657556832505,CSE 3,A50,083646,Miranda; Gregory Joseph,24,0,50,26
1657556838529,CSE 8A,A50,083650,Miranda; Gregory Joseph,17,1,56,39
1657556844563,CSE 11,A01,083080,Cao; Yingjun,6,15,40,34
1657556850597,CSE 12,A01,083652,Krause-Levy; Sophia Louisa,28,1,120,92
1657556856623,CSE 15L,A01,083654,Morris; Justin Loren,9,0,50,41
1657556856623,CSE 15L,A02,083655,Morris; Justin Loren,9,0,50,41
1657556862649,CSE 20,A01,083657,Tran; Khoa Dang,39,0,80,41
1657556868677,CSE 21,A01,095574,Bach; Quang Tran,22,0,48,26
1657556874700,CSE 30,A01,083084,Eldon; John,5,0,80,75
1657556874700,CSE 30,B01,095061,Bhaskar; Nishant,9,0,50,41
1657556880730,CSE 100,A01,083659,Cao; Yingjun,5,4,70,65
1657556886752,CSE 134B,A01,083661,Powell; Thomas Allan,22,0,100,78
1657556892783,CSE 140,A01,083663,Gungor; Onat,15,0,85,70
1657556898810,CSE 140L,A01,083088,Eldon; John,21,0,100,79
1657556904832,CSE 175,A01,083665,Kumar; Rakesh,3,0,25,22
1657556910854,CSE 190,A00,092507,Dubnov; Shlomo,8,0,20,12
1657556916878,ECE 45,A01,083139,Congero; Spencer William,6,0,75,69
1657556922902,ECE 65,A50,083695,Saad; Andrew S,12,0,30,18
1657556922902,ECE 65,A51,095125,Saad; Andrew S,24,0,26,2
1657556928927,ECE 109,A01,091882,Touri; Behrouz,19,0,70,51
1657556934962,ECE 180,A00,083140,Abi Samra; Nicholas Camill,1,0,30,29
1657556934962,ECE 180,B00,083141,Abi Samra; Nicholas Camill,0,0,30,30
1657556940986,MATH 10A,A01,083735,Patchell; Gregory David,2,0,30,28
1657556940986,MATH 10A,A02,083736,Patchell; Gregory David,20,0,30,10
1657556940986,MATH 10A,A03,083737,Patchell; Gregory David,16,0,30,14
1657556947009,MATH 10B,A01,083207,Lim; Seonhee,8,0,34,26
1657556947009,MATH 10B,A02,083208,Lim; Seonhee,9,0,35,26
1657556947009,MATH 10B,A03,093472,Lim; Seonhee,7,0,34,27
1657556947009,MATH 10B,B01,083739,Sinha; Shubham,12,0,30,18
1657556953034,MATH 18,A01,083743,Cinel; Cameron Alexander,7,0,30,23
1657556953034,MATH 18,A02,083744,Cinel; Cameron Alexander,17,0,30,13
1657556953034,MATH 18,A03,083745,Cinel; Cameron Alexander,9,0,30,21
1657556953034,MATH 18,B01,083748,Rideout; David Porter,5,0,37,32
1657556953034,MATH 18,B02,083749,Rideout; David Porter,5,0,36,31
1657556953034,MATH 18,B03,083750,Rideout; David Porter,3,0,37,34
1657556953034,MATH 18,B04,083751,Rideout; David Porter,6,0,36,30
1657556953034,MATH 18,B05,093473,Rideout; David Porter,6,0,36,30
1657556953034,MATH 18,B06,093474,Rideout; David Porter,6,0,36,30
1657556959057,MATH 20A,A01,083754,Zheng; Zequn,14,0,40,26
1657556965080,MATH 20B,A01,083756,Briones; Jor-el Thomas Caparas,4,0,36,32
1657556965080,MATH 20B,A02,083757,Briones; Jor-el Thomas Caparas,1,0,36,35
1657556965080,MATH 20B,A03,093475,Briones; Jor-el Thomas Caparas,2,0,36,34
1657556971102,MATH 20C,A01,083760,Briones; Jor-el Thomas Caparas,1,0,35,34
1657556971102,MATH 20C,A02,083761,Briones; Jor-el Thomas Caparas,8,0,35,27
1657556971102,MATH 20C,A03,093476,Briones; Jor-el Thomas Caparas,0,1,36,36
1657556971102,MATH 20C,B01,083762,Bach; Quang Tran,1,0,30,29
1657556977129,MATH 20D,A01,083765,Tran; Brian Kha,5,0,30,25
1657556977129,MATH 20D,A02,083766,Tran; Brian Kha,5,0,30,25
1657556977129,MATH 20D,A03,083767,Tran; Brian Kha,5,0,30,25
1657556983151,MATH 20E,A01,083771,Ganguly; Soumya,9,0,32,23
1657556983151,MATH 20E,A02,083772,Ganguly; Soumya,6,0,32,26
1657556983151,MATH 20E,B01,083773,Ciotti; Benjamin,20,0,35,15
1657556983151,MATH 20E,B02,083774,Ciotti; Benjamin,17,0,35,18
1657556989186,MATH 103A,A01,083777,Greenfeld; Be'Eri,3,0,36,33
1657556989186,MATH 103A,A02,083778,Greenfeld; Be'Eri,5,0,36,31
1657556989186,MATH 103A,A03,093561,Greenfeld; Be'Eri,5,0,36,31
1657556989186,MATH 103A,B01,083779,Greenfeld; Be'Eri,7,0,36,29
1657556989186,MATH 103A,B02,083780,Greenfeld; Be'Eri,4,0,36,32
1657556989186,MATH 103A,B03,093562,Greenfeld; Be'Eri,3,0,36,33
1657556995209,MATH 105,A01,085443,Carter; Anne Toulson,15,0,35,20
1657556995209,MATH 105,A02,093477,Carter; Anne Toulson,20,0,35,15
1657557001232,MATH 109,A01,083213,Ganzberger; Geoffrey Michael,2,0,34,32
1657557001232,MATH 109,A02,083214,Ganzberger; Geoffrey Michael,4,0,34,30
1657557001232,MATH 109,A03,093478,Ganzberger; Geoffrey Michael,2,0,34,32
1657557001232,MATH 109,B01,083215,Ganzberger; Geoffrey Michael,1,0,32,31
1657557001232,MATH 109,B02,083216,Ganzberger; Geoffrey Michael,2,0,32,30
1657557001232,MATH 109,B03,093479,Ganzberger; Geoffrey Michael,8,0,32,24
1657557007254,MATH 142A,A01,083219,Chow; Bennett,7,0,32,25
1657557007254,MATH 142A,A02,083220,Chow; Bennett,10,0,32,22
1657557007254,MATH 142A,A03,093480,Chow; Bennett,8,0,32,24
1657557007254,MATH 142A,B03,093481,Chow; Bennett,8,0,32,24
1657557007254,MATH 142A,B04,093558,Chow; Bennett,13,0,32,19
1657557007254,MATH 142A,B05,093559,Chow; Bennett,6,0,32,26
1657557013288,MATH 193A,A01,083224,Rotar; Vladimir,8,0,34,26
1657557013288,MATH 193A,A02,083225,Rotar; Vladimir,9,0,34,25
1657557013288,MATH 193A,A03,083781,Rotar; Vladimir,5,0,34,29
1657557013288,MATH 193A,A04,083782,Rotar; Vladimir,10,0,34,24
1657557013288,MATH 193A,A05,093482,Rotar; Vladimir,10,0,34,24
1657557019309,MATH 197,001,091859,McAuley; Julian John,9999,0,9999,0
1657557019309,MATH 197,002,095566,Kedlaya; Kiran S.,9997,0,9999,2
1657557019309,MATH 197,003,095567,Xiao; Ming,9999,0,9999,0
1657557019309,MATH 197,004,095571,Perols; Johan Lars,9998,0,9999,1
1657557026362,COGS 9,A01,083615,Shannon; Kyle Michael,9,0,75,66
1657557032384,COGS 11,A01,083617,Boyle; Mary E. T.,22,0,48,26
1657557038412,COGS 13,A01,083071,Bastos; Amalia Pinkusfeld,11,0,71,60
1657557044444,COGS 14A,A01,092681,Semenuks; Arturs,5,1,100,95
1657557050469,COGS 14B,A01,083073,Cheng; Tzu-Han,6,0,63,57
1657557056492,COGS 17,A01,092677,Semenuks; Arturs,6,0,81,75
1657557062515,COGS 100,A01,083619,Allen; Michael Gordon,17,0,70,53
1657557068543,COGS 101A,A01,083621,Davis; Joshua Daniel,9,0,68,59
1657557074569,COGS 101B,A01,091572,Allen; Michael Gordon,12,0,65,53
1657557080590,COGS 101C,A01,083625,Delgado; Tania,17,0,35,18
1657557086612,COGS 107A,A01,083627,Boyle; Mary E. T.,13,0,60,47
1657557092636,COGS 118A,A01,083075,Gupta; Anjum,21,0,76,55
1657557098658,CSE 3,A50,083646,Miranda; Gregory Joseph,24,0,50,26
1657557104685,CSE 8A,A50,083650,Miranda; Gregory Joseph,17,1,56,39
1657557110708,CSE 11,A01,083080,Cao; Yingjun,6,15,40,34
1657557116737,CSE 12,A01,083652,Krause-Levy; Sophia Louisa,28,1,120,92
1657557122761,CSE 15L,A01,083654,Morris; Justin Loren,9,0,50,41
1657557122761,CSE 15L,A02,083655,Morris; Justin Loren,9,0,50,41
1657557128791,CSE 20,A01,083657,Tran; Khoa Dang,39,0,80,41
1657557134818,CSE 21,A01,095574,Bach; Quang Tran,22,0,48,26
1657557140844,CSE 30,A01,083084,Eldon; John,5,0,80,75
1657557140844,CSE 30,B01,095061,Bhaskar; Nishant,9,0,50,41
1657557146869,CSE 100,A01,083659,Cao; Yingjun,5,4,70,65
1657557152903,CSE 134B,A01,083661,Powell; Thomas Allan,22,0,100,78
1657557158930,CSE 140,A01,083663,Gungor; Onat,15,0,85,70
1657557164956,CSE 140L,A01,083088,Eldon; John,21,0,100,79
1657557170984,CSE 175,A01,083665,Kumar; Rakesh,3,0,25,22
1657557177017,CSE 190,A00,092507,Dubnov; Shlomo,8,0,20,12
1657557183038,ECE 45,A01,083139,Congero; Spencer William,6,0,75,69
1657557189063,ECE 65,A50,083695,Saad; Andrew S,12,0,30,18
1657557189063,ECE 65,A51,095125,Saad; Andrew S,24,0,26,2
1657557195088,ECE 109,A01,091882,Touri; Behrouz,19,0,70,51
1657557201111,ECE 180,A00,083140,Abi Samra; Nicholas Camill,1,0,30,29
1657557201111,ECE 180,B00,083141,Abi Samra; Nicholas Camill,0,0,30,30
1657557207138,MATH 10A,A01,083735,Patchell; Gregory David,2,0,30,28
1657557207138,MATH 10A,A02,083736,Patchell; Gregory David,20,0,30,10
1657557207138,MATH 10A,A03,083737,Patchell; Gregory David,16,0,30,14
1657557213168,MATH 10B,A01,083207,Lim; Seonhee,8,0,34,26
1657557213168,MATH 10B,A02,083208,Lim; Seonhee,9,0,35,26
1657557213168,MATH 10B,A03,093472,Lim; Seonhee,7,0,34,27
1657557213168,MATH 10B,B01,083739,Sinha; Shubham,12,0,30,18
1657557219197,MATH 18,A01,083743,Cinel; Cameron Alexander,7,0,30,23
1657557219197,MATH 18,A02,083744,Cinel; Cameron Alexander,17,0,30,13
1657557219197,MATH 18,A03,083745,Cinel; Cameron Alexander,9,0,30,21
1657557219197,MATH 18,B01,083748,Rideout; David Porter,5,0,37,32
1657557219197,MATH 18,B02,083749,Rideout; David Porter,5,0,36,31
1657557219197,MATH 18,B03,083750,Rideout; David Porter,3,0,37,34
1657557219197,MATH 18,B04,083751,Rideout; David Porter,6,0,36,30
1657557219197,MATH 18,B05,093473,Rideout; David Porter,6,0,36,30
1657557219197,MATH 18,B06,093474,Rideout; David Porter,6,0,36,30
1657557225228,MATH 20A,A01,083754,Zheng; Zequn,14,0,40,26
1657557231250,MATH 20B,A01,083756,Briones; Jor-el Thomas Caparas,4,0,36,32
1657557231250,MATH 20B,A02,083757,Briones; Jor-el Thomas Caparas,1,0,36,35
1657557231250,MATH 20B,A03,093475,Briones; Jor-el Thomas Caparas,2,0,36,34
1657557237274,MATH 20C,A01,083760,Briones; Jor-el Thomas Caparas,1,0,35,34
1657557237274,MATH 20C,A02,083761,Briones; Jor-el Thomas Caparas,8,0,35,27
1657557237274,MATH 20C,A03,093476,Briones; Jor-el Thomas Caparas,0,1,36,36
1657557237274,MATH 20C,B01,083762,Bach; Quang Tran,1,0,30,29
1657557243297,MATH 20D,A01,083765,Tran; Brian Kha,5,0,30,25
1657557243297,MATH 20D,A02,083766,Tran; Brian Kha,5,0,30,25
1657557243297,MATH 20D,A03,083767,Tran; Brian Kha,5,0,30,25
1657557249330,MATH 20E,A01,083771,Ganguly; Soumya,9,0,32,23
1657557249330,MATH 20E,A02,083772,Ganguly; Soumya,6,0,32,26
1657557249330,MATH 20E,B01,083773,Ciotti; Benjamin,20,0,35,15
1657557249330,MATH 20E,B02,083774,Ciotti; Benjamin,17,0,35,18
1657557255359,MATH 103A,A01,083777,Greenfeld; Be'Eri,3,0,36,33
1657557255359,MATH 103A,A02,083778,Greenfeld; Be'Eri,5,0,36,31
1657557255359,MATH 103A,A03,093561,Greenfeld; Be'Eri,5,0,36,31
1657557255359,MATH 103A,B01,083779,Greenfeld; Be'Eri,7,0,36,29
1657557255359,MATH 103A,B02,083780,Greenfeld; Be'Eri,4,0,36,32
1657557255359,MATH 103A,B03,093562,Greenfeld; Be'Eri,3,0,36,33
1657557261382,MATH 105,A01,085443,Carter; Anne Toulson,15,0,35,20
1657557261382,MATH 105,A02,093477,Carter; Anne Toulson,20,0,35,15
1657557267409,MATH 109,A01,083213,Ganzberger; Geoffrey Michael,2,0,34,32
1657557267409,MATH 109,A02,083214,Ganzberger; Geoffrey Michael,4,0,34,30
1657557267409,MATH 109,A03,093478,Ganzberger; Geoffrey Michael,2,0,34,32
1657557267409,MATH 109,B01,083215,Ganzberger; Geoffrey Michael,1,0,32,31
1657557267409,MATH 109,B02,083216,Ganzberger; Geoffrey Michael,2,0,32,30
1657557267409,MATH 109,B03,093479,Ganzberger; Geoffrey Michael,8,0,32,24
1657557273433,MATH 142A,A01,083219,Chow; Bennett,7,0,32,25
1657557273433,MATH 142A,A02,083220,Chow; Bennett,10,0,32,22
1657557273433,MATH 142A,A03,093480,Chow; Bennett,8,0,32,24
1657557273433,MATH 142A,B03,093481,Chow; Bennett,8,0,32,24
1657557273433,MATH 142A,B04,093558,Chow; Bennett,13,0,32,19
1657557273433,MATH 142A,B05,093559,Chow; Bennett,6,0,32,26
1657557279470,MATH 193A,A01,083224,Rotar; Vladimir,8,0,34,26
1657557279470,MATH 193A,A02,083225,Rotar; Vladimir,9,0,34,25
1657557279470,MATH 193A,A03,083781,Rotar; Vladimir,5,0,34,29
1657557279470,MATH 193A,A04,083782,Rotar; Vladimir,10,0,34,24
1657557279470,MATH 193A,A05,093482,Rotar; Vladimir,10,0,34,24
1657557285494,MATH 197,001,091859,McAuley; Julian John,9999,0,9999,0
1657557285494,MATH 197,002,095566,Kedlaya; Kiran S.,9997,0,9999,2
1657557285494,MATH 197,003,095567,Xiao; Ming,9999,0,9999,0
1657557285494,MATH 197,004,095571,Perols; Johan Lars,9998,0,9999,1
1657557292557,COGS 9,A01,083615,Shannon; Kyle Michael,9,0,75,66
1657557298586,COGS 11,A01,083617,Boyle; Mary E. T.,22,0,48,26
1657557304612,COGS 13,A01,083071,Bastos; Amalia Pinkusfeld,11,0,71,60
1657557310641,COGS 14A,A01,092681,Semenuks; Arturs,5,1,100,95
1657557316667,COGS 14B,A01,083073,Cheng; Tzu-Han,6,0,63,57
1657557322692,COGS 17,A01,092677,Semenuks; Arturs,6,0,81,75
1657557328715,COGS 100,A01,083619,Allen; Michael Gordon,17,0,70,53
1657557334738,COGS 101A,A01,083621,Davis; Joshua Daniel,9,0,68,59
1657557340772,COGS 101B,A01,091572,Allen; Michael Gordon,12,0,65,53
1657557346794,COGS 101C,A01,083625,Delgado; Tania,17,0,35,18
1657557352815,COGS 107A,A01,083627,Boyle; Mary E. T.,13,0,60,47
1657557358841,COGS 118A,A01,083075,Gupta; Anjum,21,0,76,55
1657557364871,CSE 3,A50,083646,Miranda; Gregory Joseph,24,0,50,26
1657557370892,CSE 8A,A50,083650,Miranda; Gregory Joseph,17,1,56,39
1657557376921,CSE 11,A01,083080,Cao; Yingjun,6,15,40,34
1657557382945,CSE 12,A01,083652,Krause-Levy; Sophia Louisa,28,1,120,92
1657557388972,CSE 15L,A01,083654,Morris; Justin Loren,9,0,50,41
1657557388972,CSE 15L,A02,083655,Morris; Justin Loren,9,0,50,41
1657557395011,CSE 20,A01,083657,Tran; Khoa Dang,39,0,80,41
1657557401033,CSE 21,A01,095574,Bach; Quang Tran,22,0,48,26
1657557407059,CSE 30,A01,083084,Eldon; John,5,0,80,75
1657557407059,CSE 30,B01,095061,Bhaskar; Nishant,9,0,50,41
1657557413088,CSE 100,A01,083659,Cao; Yingjun,5,4,70,65
1657557419115,CSE 134B,A01,083661,Powell; Thomas Allan,22,0,100,78
1657557425211,CSE 140,A01,083663,Gungor; Onat,15,0,85,70
1657557431237,CSE 140L,A01,083088,Eldon; John,21,0,100,79
1657557437259,CSE 175,A01,083665,Kumar; Rakesh,3,0,25,22
1657557443281,CSE 190,A00,092507,Dubnov; Shlomo,8,0,20,12
1657557449304,ECE 45,A01,083139,Congero; Spencer William,6,0,75,69
1657557455327,ECE 65,A50,083695,Saad; Andrew S,12,0,30,18
1657557455327,ECE 65,A51,095125,Saad; Andrew S,24,0,26,2
1657557461353,ECE 109,A01,091882,Touri; Behrouz,19,0,70,51
1657557467383,ECE 180,A00,083140,Abi Samra; Nicholas Camill,1,0,30,29
1657557467383,ECE 180,B00,083141,Abi Samra; Nicholas Camill,0,0,30,30
1657557473409,MATH 10A,A01,083735,Patchell; Gregory David,2,0,30,28
1657557473409,MATH 10A,A02,083736,Patchell; Gregory David,20,0,30,10
1657557473409,MATH 10A,A03,083737,Patchell; Gregory David,16,0,30,14
1657557479433,MATH 10B,A01,083207,Lim; Seonhee,8,0,34,26
1657557479433,MATH 10B,A02,083208,Lim; Seonhee,9,0,35,26
1657557479433,MATH 10B,A03,093472,Lim; Seonhee,7,0,34,27
1657557479433,MATH 10B,B01,083739,Sinha; Shubham,12,0,30,18
1657557485464,MATH 18,A01,083743,Cinel; Cameron Alexander,7,0,30,23
1657557485464,MATH 18,A02,083744,Cinel; Cameron Alexander,17,0,30,13
1657557485464,MATH 18,A03,083745,Cinel; Cameron Alexander,9,0,30,21
1657557485464,MATH 18,B01,083748,Rideout; David Porter,5,0,37,32
1657557485464,MATH 18,B02,083749,Rideout; David Porter,5,0,36,31
1657557485464,MATH 18,B03,083750,Rideout; David Porter,3,0,37,34
1657557485464,MATH 18,B04,083751,Rideout; David Porter,6,0,36,30
1657557485464,MATH 18,B05,093473,Rideout; David Porter,6,0,36,30
1657557485464,MATH 18,B06,093474,Rideout; David Porter,6,0,36,30
1657557491491,MATH 20A,A01,083754,Zheng; Zequn,14,0,40,26
1657557497514,MATH 20B,A01,083756,Briones; Jor-el Thomas Caparas,4,0,36,32
1657557497514,MATH 20B,A02,083757,Briones; Jor-el Thomas Caparas,1,0,36,35
1657557497514,MATH 20B,A03,093475,Briones; Jor-el Thomas Caparas,2,0,36,34
1657557503536,MATH 20C,A01,083760,Briones; Jor-el Thomas Caparas,1,0,35,34
1657557503536,MATH 20C,A02,083761,Briones; Jor-el Thomas Caparas,8,0,35,27
1657557503536,MATH 20C,A03,093476,Briones; Jor-el Thomas Caparas,0,1,36,36
1657557503536,MATH 20C,B01,083762,Bach; Quang Tran,1,0,30,29
1657557509561,MATH 20D,A01,083765,Tran; Brian Kha,5,0,30,25
1657557509561,MATH 20D,A02,083766,Tran; Brian Kha,5,0,30,25
1657557509561,MATH 20D,A03,083767,Tran; Brian Kha,5,0,30,25
1657557515586,MATH 20E,A01,083771,Ganguly; Soumya,9,0,32,23
1657557515586,MATH 20E,A02,083772,Ganguly; Soumya,6,0,32,26
1657557515586,MATH 20E,B01,083773,Ciotti; Benjamin,20,0,35,15
1657557515586,MATH 20E,B02,083774,Ciotti; Benjamin,17,0,35,18
1657557521611,MATH 103A,A01,083777,Greenfeld; Be'Eri,3,0,36,33
1657557521611,MATH 103A,A02,083778,Greenfeld; Be'Eri,5,0,36,31
1657557521611,MATH 103A,A03,093561,Greenfeld; Be'Eri,5,0,36,31
1657557521611,MATH 103A,B01,083779,Greenfeld; Be'Eri,7,0,36,29
1657557521611,MATH 103A,B02,083780,Greenfeld; Be'Eri,4,0,36,32
1657557521611,MATH 103A,B03,093562,Greenfeld; Be'Eri,3,0,36,33
1657557527633,MATH 105,A01,085443,Carter; Anne Toulson,15,0,35,20
1657557527633,MATH 105,A02,093477,Carter; Anne Toulson,20,0,35,15
1657557533671,MATH 109,A01,083213,Ganzberger; Geoffrey Michael,2,0,34,32
1657557533671,MATH 109,A02,083214,Ganzberger; Geoffrey Michael,4,0,34,30
1657557533671,MATH 109,A03,093478,Ganzberger; Geoffrey Michael,2,0,34,32
1657557533671,MATH 109,B01,083215,Ganzberger; Geoffrey Michael,1,0,32,31
1657557533671,MATH 109,B02,083216,Ganzberger; Geoffrey Michael,2,0,32,30
1657557533671,MATH 109,B03,093479,Ganzberger; Geoffrey Michael,8,0,32,24
1657557539693,MATH 142A,A01,083219,Chow; Bennett,7,0,32,25
1657557539693,MATH 142A,A02,083220,Chow; Bennett,10,0,32,22
1657557539693,MATH 142A,A03,093480,Chow; Bennett,8,0,32,24
1657557539693,MATH 142A,B03,093481,Chow; Bennett,8,0,32,24
1657557539693,MATH 142A,B04,093558,Chow; Bennett,13,0,32,19
1657557539693,MATH 142A,B05,093559,Chow; Bennett,6,0,32,26
1657557545717,MATH 193A,A01,083224,Rotar; Vladimir,8,0,34,26
1657557545717,MATH 193A,A02,083225,Rotar; Vladimir,9,0,34,25
1657557545717,MATH 193A,A03,083781,Rotar; Vladimir,5,0,34,29
1657557545717,MATH 193A,A04,083782,Rotar; Vladimir,10,0,34,24
1657557545717,MATH 193A,A05,093482,Rotar; Vladimir,10,0,34,24
1657557551742,MATH 197,001,091859,McAuley; Julian John,9999,0,9999,0
1657557551742,MATH 197,002,095566,Kedlaya; Kiran S.,9997,0,9999,2
1657557551742,MATH 197,003,095567,Xiao; Ming,9999,0,9999,0
1657557551742,MATH 197,004,095571,Perols; Johan Lars,9998,0,9999,1
1657557558798,COGS 9,A01,083615,Shannon; Kyle Michael,9,0,75,66
1657557564832,COGS 11,A01,083617,Boyle; Mary E. T.,22,0,48,26
1657557570854,COGS 13,A01,083071,Bastos; Amalia Pinkusfeld,11,0,71,60
1657557576882,COGS 14A,A01,092681,Semenuks; Arturs,5,1,100,95
1657557582911,COGS 14B,A01,083073,Cheng; Tzu-Han,6,0,63,57
1657557588939,COGS 17,A01,092677,Semenuks; Arturs,6,0,81,75
1657557594962,COGS 100,A01,083619,Allen; Michael Gordon,17,0,70,53
1657557600989,COGS 101A,A01,083621,Davis; Joshua Daniel,9,0,68,59
1657557607016,COGS 101B,A01,091572,Allen; Michael Gordon,12,0,65,53
1657557613044,COGS 101C,A01,083625,Delgado; Tania,17,0,35,18
1657557619072,COGS 107A,A01,083627,Boyle; Mary E. T.,13,0,60,47
1657557625096,COGS 118A,A01,083075,Gupta; Anjum,21,0,76,55
1657557631125,CSE 3,A50,083646,Miranda; Gregory Joseph,24,0,50,26
1657557637153,CSE 8A,A50,083650,Miranda; Gregory Joseph,17,1,56,39
1657557643177,CSE 11,A01,083080,Cao; Yingjun,6,15,40,34
1657557649198,CSE 12,A01,083652,Krause-Levy; Sophia Louisa,28,1,120,92
1657557655222,CSE 15L,A01,083654,Morris; Justin Loren,9,0,50,41
1657557655222,CSE 15L,A02,083655,Morris; Justin Loren,9,0,50,41
1657557661250,CSE 20,A01,083657,Tran; Khoa Dang,39,0,80,41
1657557667272,CSE 21,A01,095574,Bach; Quang Tran,22,0,48,26
1657557673295,CSE 30,A01,083084,Eldon; John,5,0,80,75
1657557673295,CSE 30,B01,095061,Bhaskar; Nishant,9,0,50,41
1657557679322,CSE 100,A01,083659,Cao; Yingjun,5,4,70,65
1657557685347,CSE 134B,A01,083661,Powell; Thomas Allan,22,0,100,78
1657557691371,CSE 140,A01,083663,Gungor; Onat,15,0,85,70
1657557697399,CSE 140L,A01,083088,Eldon; John,21,0,100,79
1657557703422,CSE 175,A01,083665,Kumar; Rakesh,3,0,25,22
1657557709445,CSE 190,A00,092507,Dubnov; Shlomo,8,0,20,12
1657557715466,ECE 45,A01,083139,Congero; Spencer William,6,0,75,69
1657557721494,ECE 65,A50,083695,Saad; Andrew S,12,0,30,18
1657557721494,ECE 65,A51,095125,Saad; Andrew S,24,0,26,2
1657557727516,ECE 109,A01,091882,Touri; Behrouz,19,0,70,51
1657557733549,ECE 180,A00,083140,Abi Samra; Nicholas Camill,1,0,30,29
1657557733549,ECE 180,B00,083141,Abi Samra; Nicholas Camill,0,0,30,30
1657557739575,MATH 10A,A01,083735,Patchell; Gregory David,2,0,30,28
1657557739575,MATH 10A,A02,083736,Patchell; Gregory David,20,0,30,10
1657557739575,MATH 10A,A03,083737,Patchell; Gregory David,16,0,30,14
1657557745602,MATH 10B,A01,083207,Lim; Seonhee,8,0,34,26
1657557745602,MATH 10B,A02,083208,Lim; Seonhee,9,0,35,26
1657557745602,MATH 10B,A03,093472,Lim; Seonhee,7,0,34,27
1657557745602,MATH 10B,B01,083739,Sinha; Shubham,12,0,30,18
1657557751636,MATH 18,A01,083743,Cinel; Cameron Alexander,7,0,30,23
1657557751636,MATH 18,A02,083744,Cinel; Cameron Alexander,17,0,30,13
1657557751636,MATH 18,A03,083745,Cinel; Cameron Alexander,9,0,30,21
1657557751636,MATH 18,B01,083748,Rideout; David Porter,5,0,37,32
1657557751636,MATH 18,B02,083749,Rideout; David Porter,5,0,36,31
1657557751636,MATH 18,B03,083750,Rideout; David Porter,3,0,37,34
1657557751636,MATH 18,B04,083751,Rideout; David Porter,6,0,36,30
1657557751636,MATH 18,B05,093473,Rideout; David Porter,6,0,36,30
1657557751636,MATH 18,B06,093474,Rideout; David Porter,6,0,36,30
1657557757658,MATH 20A,A01,083754,Zheng; Zequn,14,0,40,26
1657557763685,MATH 20B,A01,083756,Briones; Jor-el Thomas Caparas,4,0,36,32
1657557763685,MATH 20B,A02,083757,Briones; Jor-el Thomas Caparas,1,0,36,35
1657557763685,MATH 20B,A03,093475,Briones; Jor-el Thomas Caparas,2,0,36,34
1657557769708,MATH 20C,A01,083760,Briones; Jor-el Thomas Caparas,1,0,35,34
1657557769708,MATH 20C,A02,083761,Briones; Jor-el Thomas Caparas,8,0,35,27
1657557769708,MATH 20C,A03,093476,Briones; Jor-el Thomas Caparas,0,1,36,36
1657557769708,MATH 20C,B01,083762,Bach; Quang Tran,1,0,30,29
1657557775735,MATH 20D,A01,083765,Tran; Brian Kha,5,0,30,25
1657557775735,MATH 20D,A02,083766,Tran; Brian Kha,5,0,30,25
1657557775735,MATH 20D,A03,083767,Tran; Brian Kha,5,0,30,25
1657557781762,MATH 20E,A01,083771,Ganguly; Soumya,9,0,32,23
1657557781762,MATH 20E,A02,083772,Ganguly; Soumya,6,0,32,26
1657557781762,MATH 20E,B01,083773,Ciotti; Benjamin,20,0,35,15
1657557781762,MATH 20E,B02,083774,Ciotti; Benjamin,17,0,35,18
1657557787784,MATH 103A,A01,083777,Greenfeld; Be'Eri,3,0,36,33
1657557787784,MATH 103A,A02,083778,Greenfeld; Be'Eri,5,0,36,31
1657557787784,MATH 103A,A03,093561,Greenfeld; Be'Eri,5,0,36,31
1657557787784,MATH 103A,B01,083779,Greenfeld; Be'Eri,7,0,36,29
1657557787784,MATH 103A,B02,083780,Greenfeld; Be'Eri,4,0,36,32
1657557787784,MATH 103A,B03,093562,Greenfeld; Be'Eri,3,0,36,33
1657557793806,MATH 105,A01,085443,Carter; Anne Toulson,15,0,35,20
1657557793806,MATH 105,A02,093477,Carter; Anne Toulson,20,0,35,15
1657557799849,MATH 109,A01,083213,Ganzberger; Geoffrey Michael,2,0,34,32
1657557799849,MATH 109,A02,083214,Ganzberger; Geoffrey Michael,4,0,34,30
1657557799849,MATH 109,A03,093478,Ganzberger; Geoffrey Michael,2,0,34,32
1657557799849,MATH 109,B01,083215,Ganzberger; Geoffrey Michael,1,0,32,31
1657557799849,MATH 109,B02,083216,Ganzberger; Geoffrey Michael,2,0,32,30
1657557799849,MATH 109,B03,093479,Ganzberger; Geoffrey Michael,8,0,32,24
1657557805890,MATH 142A,A01,083219,Chow; Bennett,7,0,32,25
1657557805890,MATH 142A,A02,083220,Chow; Bennett,10,0,32,22
1657557805890,MATH 142A,A03,093480,Chow; Bennett,8,0,32,24
1657557805890,MATH 142A,B03,093481,Chow; Bennett,8,0,32,24
1657557805890,MATH 142A,B04,093558,Chow; Bennett,13,0,32,19
1657557805890,MATH 142A,B05,093559,Chow; Bennett,6,0,32,26
1657557811920,MATH 193A,A01,083224,Rotar; Vladimir,8,0,34,26
1657557811920,MATH 193A,A02,083225,Rotar; Vladimir,9,0,34,25
1657557811920,MATH 193A,A03,083781,Rotar; Vladimir,5,0,34,29
1657557811920,MATH 193A,A04,083782,Rotar; Vladimir,10,0,34,24
1657557811920,MATH 193A,A05,093482,Rotar; Vladimir,10,0,34,24
1657557817942,MATH 197,001,091859,McAuley; Julian John,9999,0,9999,0
1657557817942,MATH 197,002,095566,Kedlaya; Kiran S.,9997,0,9999,2
1657557817942,MATH 197,003,095567,Xiao; Ming,9999,0,9999,0
1657557817942,MATH 197,004,095571,Perols; Johan Lars,9998,0,9999,1
1657557825005,COGS 9,A01,083615,Shannon; Kyle Michael,9,0,75,66
1657557831027,COGS 11,A01,083617,Boyle; Mary E. T.,22,0,48,26
1657557837050,COGS 13,A01,083071,Bastos; Amalia Pinkusfeld,11,0,71,60
1657557843074,COGS 14A,A01,092681,Semenuks; Arturs,5,1,100,95
1657557849096,COGS 14B,A01,083073,Cheng; Tzu-Han,6,0,63,57
1657557855129,COGS 17,A01,092677,Semenuks; Arturs,6,0,81,75
1657557861155,COGS 100,A01,083619,Allen; Michael Gordon,17,0,70,53
1657557867184,COGS 101A,A01,083621,Davis; Joshua Daniel,9,0,68,59
1657557873221,COGS 101B,A01,091572,Allen; Michael Gordon,12,0,65,53
1657557879248,COGS 101C,A01,083625,Delgado; Tania,17,0,35,18
1657557885287,COGS 107A,A01,083627,Boyle; Mary E. T.,13,0,60,47
1657557891315,COGS 118A,A01,083075,Gupta; Anjum,21,0,76,55
1657557897341,CSE 3,A50,083646,Miranda; Gregory Joseph,24,0,50,26
1657557903365,CSE 8A,A50,083650,Miranda; Gregory Joseph,17,1,56,39
1657557909397,CSE 11,A01,083080,Cao; Yingjun,6,15,40,34
1657557915424,CSE 12,A01,083652,Krause-Levy; Sophia Louisa,28,1,120,92
1657557921449,CSE 15L,A01,083654,Morris; Justin Loren,9,0,50,41
1657557921449,CSE 15L,A02,083655,Morris; Justin Loren,9,0,50,41
1657557927471,CSE 20,A01,083657,Tran; Khoa Dang,39,0,80,41
1657557933520,CSE 21,A01,095574,Bach; Quang Tran,22,0,48,26
1657557939543,CSE 30,A01,083084,Eldon; John,5,0,80,75
1657557939543,CSE 30,B01,095061,Bhaskar; Nishant,9,0,50,41
1657557945567,CSE 100,A01,083659,Cao; Yingjun,5,4,70,65
1657557951596,CSE 134B,A01,083661,Powell; Thomas Allan,22,0,100,78
1657557957622,CSE 140,A01,083663,Gungor; Onat,15,0,85,70
1657557963646,CSE 140L,A01,083088,Eldon; John,21,0,100,79
1657557969682,CSE 175,A01,083665,Kumar; Rakesh,3,0,25,22
1657557975723,CSE 190,A00,092507,Dubnov; Shlomo,8,0,20,12
1657557981769,ECE 45,A01,083139,Congero; Spencer William,6,0,75,69
1657557987802,ECE 65,A50,083695,Saad; Andrew S,12,0,30,18
1657557987802,ECE 65,A51,095125,Saad; Andrew S,24,0,26,2
1657557993824,ECE 109,A01,091882,Touri; Behrouz,19,0,70,51
1657557999857,ECE 180,A00,083140,Abi Samra; Nicholas Camill,1,0,30,29
1657557999857,ECE 180,B00,083141,Abi Samra; Nicholas Camill,0,0,30,30
1657558005888,MATH 10A,A01,083735,Patchell; Gregory David,2,0,30,28
1657558005888,MATH 10A,A02,083736,Patchell; Gregory David,20,0,30,10
1657558005888,MATH 10A,A03,083737,Patchell; Gregory David,16,0,30,14
1657558011911,MATH 10B,A01,083207,Lim; Seonhee,8,0,34,26
1657558011911,MATH 10B,A02,083208,Lim; Seonhee,9,0,35,26
1657558011911,MATH 10B,A03,093472,Lim; Seonhee,7,0,34,27
1657558011911,MATH 10B,B01,083739,Sinha; Shubham,12,0,30,18
1657558017936,MATH 18,A01,083743,Cinel; Cameron Alexander,7,0,30,23
1657558017936,MATH 18,A02,083744,Cinel; Cameron Alexander,17,0,30,13
1657558017936,MATH 18,A03,083745,Cinel; Cameron Alexander,9,0,30,21
1657558017936,MATH 18,B01,083748,Rideout; David Porter,5,0,37,32
1657558017936,MATH 18,B02,083749,Rideout; David Porter,5,0,36,31
1657558017936,MATH 18,B03,083750,Rideout; David Porter,3,0,37,34
1657558017936,MATH 18,B04,083751,Rideout; David Porter,6,0,36,30
1657558017936,MATH 18,B05,093473,Rideout; David Porter,6,0,36,30
1657558017936,MATH 18,B06,093474,Rideout; David Porter,6,0,36,30
1657558024047,MATH 20A,A01,083754,Zheng; Zequn,14,0,40,26
1657558030069,MATH 20B,A01,083756,Briones; Jor-el Thomas Caparas,4,0,36,32
1657558030069,MATH 20B,A02,083757,Briones; Jor-el Thomas Caparas,1,0,36,35
1657558030069,MATH 20B,A03,093475,Briones; Jor-el Thomas Caparas,2,0,36,34
1657558036107,MATH 20C,A01,083760,Briones; Jor-el Thomas Caparas,1,0,35,34
1657558036107,MATH 20C,A02,083761,Briones; Jor-el Thomas Caparas,8,0,35,27
1657558036107,MATH 20C,A03,093476,Briones; Jor-el Thomas Caparas,0,1,36,36
1657558036107,MATH 20C,B01,083762,Bach; Quang Tran,1,0,30,29
1657558042135,MATH 20D,A01,083765,Tran; Brian Kha,5,0,30,25
1657558042135,MATH 20D,A02,083766,Tran; Brian Kha,5,0,30,25
1657558042135,MATH 20D,A03,083767,Tran; Brian Kha,5,0,30,25
1657558048159,MATH 20E,A01,083771,Ganguly; Soumya,9,0,32,23
1657558048159,MATH 20E,A02,083772,Ganguly; Soumya,6,0,32,26
1657558048159,MATH 20E,B01,083773,Ciotti; Benjamin,20,0,35,15
1657558048159,MATH 20E,B02,083774,Ciotti; Benjamin,17,0,35,18
1657558054182,MATH 103A,A01,083777,Greenfeld; Be'Eri,3,0,36,33
1657558054182,MATH 103A,A02,083778,Greenfeld; Be'Eri,5,0,36,31
1657558054182,MATH 103A,A03,093561,Greenfeld; Be'Eri,5,0,36,31
1657558054182,MATH 103A,B01,083779,Greenfeld; Be'Eri,7,0,36,29
1657558054182,MATH 103A,B02,083780,Greenfeld; Be'Eri,4,0,36,32
1657558054182,MATH 103A,B03,093562,Greenfeld; Be'Eri,3,0,36,33
1657558060206,MATH 105,A01,085443,Carter; Anne Toulson,15,0,35,20
1657558060206,MATH 105,A02,093477,Carter; Anne Toulson,20,0,35,15
1657558066252,MATH 109,A01,083213,Ganzberger; Geoffrey Michael,2,0,34,32
1657558066252,MATH 109,A02,083214,Ganzberger; Geoffrey Michael,4,0,34,30
1657558066252,MATH 109,A03,093478,Ganzberger; Geoffrey Michael,2,0,34,32
1657558066252,MATH 109,B01,083215,Ganzberger; Geoffrey Michael,1,0,32,31
1657558066252,MATH 109,B02,083216,Ganzberger; Geoffrey Michael,2,0,32,30
1657558066252,MATH 109,B03,093479,Ganzberger; Geoffrey Michael,8,0,32,24
1657558072281,MATH 142A,A01,083219,Chow; Bennett,7,0,32,25
1657558072281,MATH 142A,A02,083220,Chow; Bennett,10,0,32,22
1657558072281,MATH 142A,A03,093480,Chow; Bennett,8,0,32,24
1657558072281,MATH 142A,B03,093481,Chow; Bennett,8,0,32,24
1657558072281,MATH 142A,B04,093558,Chow; Bennett,13,0,32,19
1657558072281,MATH 142A,B05,093559,Chow; Bennett,6,0,32,26
1657558078302,MATH 193A,A01,083224,Rotar; Vladimir,8,0,34,26
1657558078302,MATH 193A,A02,083225,Rotar; Vladimir,9,0,34,25
1657558078302,MATH 193A,A03,083781,Rotar; Vladimir,5,0,34,29
1657558078302,MATH 193A,A04,083782,Rotar; Vladimir,10,0,34,24
1657558078302,MATH 193A,A05,093482,Rotar; Vladimir,10,0,34,24
1657558084328,MATH 197,001,091859,McAuley; Julian John,9999,0,9999,0
1657558084328,MATH 197,002,095566,Kedlaya; Kiran S.,9997,0,9999,2
1657558084328,MATH 197,003,095567,Xiao; Ming,9999,0,9999,0
1657558084328,MATH 197,004,095571,Perols; Johan Lars,9998,0,9999,1
1657558091407,COGS 9,A01,083615,Shannon; Kyle Michael,9,0,75,66
1657558097435,COGS 11,A01,083617,Boyle; Mary E. T.,22,0,48,26
1657558103465,COGS 13,A01,083071,Bastos; Amalia Pinkusfeld,11,0,71,60
1657558109489,COGS 14A,A01,092681,Semenuks; Arturs,5,1,100,95
1657558115511,COGS 14B,A01,083073,Cheng; Tzu-Han,6,0,63,57
1657558121535,COGS 17,A01,092677,Semenuks; Arturs,6,0,81,75
1657558127557,COGS 100,A01,083619,Allen; Michael Gordon,17,0,70,53
1657558133585,COGS 101A,A01,083621,Davis; Joshua Daniel,9,0,68,59
1657558139607,COGS 101B,A01,091572,Allen; Michael Gordon,12,0,65,53
1657558145630,COGS 101C,A01,083625,Delgado; Tania,17,0,35,18
1657558151656,COGS 107A,A01,083627,Boyle; Mary E. T.,13,0,60,47
1657558157679,COGS 118A,A01,083075,Gupta; Anjum,21,0,76,55
1657558163718,CSE 3,A50,083646,Miranda; Gregory Joseph,24,0,50,26
1657558169745,CSE 8A,A50,083650,Miranda; Gregory Joseph,17,1,56,39
1657558175776,CSE 11,A01,083080,Cao; Yingjun,6,15,40,34
1657558181799,CSE 12,A01,083652,Krause-Levy; Sophia Louisa,28,1,120,92
1657558187828,CSE 15L,A01,083654,Morris; Justin Loren,9,0,50,41
1657558187828,CSE 15L,A02,083655,Morris; Justin Loren,9,0,50,41
1657558193863,CSE 20,A01,083657,Tran; Khoa Dang,39,0,80,41
1657558199890,CSE 21,A01,095574,Bach; Quang Tran,22,0,48,26
1657558205928,CSE 30,A01,083084,Eldon; John,5,0,80,75
1657558205928,CSE 30,B01,095061,Bhaskar; Nishant,9,0,50,41
1657558211954,CSE 100,A01,083659,Cao; Yingjun,5,4,70,65
1657558217980,CSE 134B,A01,083661,Powell; Thomas Allan,22,0,100,78
1657558224002,CSE 140,A01,083663,Gungor; Onat,15,0,85,70
1657558230031,CSE 140L,A01,083088,Eldon; John,21,0,100,79
1657558236054,CSE 175,A01,083665,Kumar; Rakesh,3,0,25,22
1657558242080,CSE 190,A00,092507,Dubnov; Shlomo,8,0,20,12
1657558248106,ECE 45,A01,083139,Congero; Spencer William,6,0,75,69
1657558254128,ECE 65,A50,083695,Saad; Andrew S,12,0,30,18
1657558254128,ECE 65,A51,095125,Saad; Andrew S,24,0,26,2
1657558260150,ECE 109,A01,091882,Touri; Behrouz,19,0,70,51
1657558266173,ECE 180,A00,083140,Abi Samra; Nicholas Camill,1,0,30,29
1657558266173,ECE 180,B00,083141,Abi Samra; Nicholas Camill,0,0,30,30
1657558272200,MATH 10A,A01,083735,Patchell; Gregory David,2,0,30,28
1657558272200,MATH 10A,A02,083736,Patchell; Gregory David,20,0,30,10
1657558272200,MATH 10A,A03,083737,Patchell; Gregory David,16,0,30,14
1657558278328,MATH 10B,A01,083207,Lim; Seonhee,8,0,34,26
1657558278328,MATH 10B,A02,083208,Lim; Seonhee,9,0,35,26
1657558278328,MATH 10B,A03,093472,Lim; Seonhee,7,0,34,27
1657558278328,MATH 10B,B01,083739,Sinha; Shubham,12,0,30,18
1657558284368,MATH 18,A01,083743,Cinel; Cameron Alexander,7,0,30,23
1657558284368,MATH 18,A02,083744,Cinel; Cameron Alexander,17,0,30,13
1657558284368,MATH 18,A03,083745,Cinel; Cameron Alexander,9,0,30,21
1657558284368,MATH 18,B01,083748,Rideout; David Porter,5,0,37,32
1657558284368,MATH 18,B02,083749,Rideout; David Porter,5,0,36,31
1657558284368,MATH 18,B03,083750,Rideout; David Porter,3,0,37,34
1657558284368,MATH 18,B04,083751,Rideout; David Porter,6,0,36,30
1657558284368,MATH 18,B05,093473,Rideout; David Porter,6,0,36,30
1657558284368,MATH 18,B06,093474,Rideout; David Porter,6,0,36,30
1657558290396,MATH 20A,A01,083754,Zheng; Zequn,14,0,40,26
1657558296421,MATH 20B,A01,083756,Briones; Jor-el Thomas Caparas,4,0,36,32
1657558296421,MATH 20B,A02,083757,Briones; Jor-el Thomas Caparas,1,0,36,35
1657558296421,MATH 20B,A03,093475,Briones; Jor-el Thomas Caparas,2,0,36,34
1657558302448,MATH 20C,A01,083760,Briones; Jor-el Thomas Caparas,1,0,35,34
1657558302448,MATH 20C,A02,083761,Briones; Jor-el Thomas Caparas,8,0,35,27
1657558302448,MATH 20C,A03,093476,Briones; Jor-el Thomas Caparas,0,1,36,36
1657558302448,MATH 20C,B01,083762,Bach; Quang Tran,1,0,30,29
1657558308477,MATH 20D,A01,083765,Tran; Brian Kha,5,0,30,25
1657558308477,MATH 20D,A02,083766,Tran; Brian Kha,5,0,30,25
1657558308477,MATH 20D,A03,083767,Tran; Brian Kha,5,0,30,25
1657558314502,MATH 20E,A01,083771,Ganguly; Soumya,9,0,32,23
1657558314502,MATH 20E,A02,083772,Ganguly; Soumya,6,0,32,26
1657558314502,MATH 20E,B01,083773,Ciotti; Benjamin,20,0,35,15
1657558314502,MATH 20E,B02,083774,Ciotti; Benjamin,17,0,35,18
1657558320542,MATH 103A,A01,083777,Greenfeld; Be'Eri,3,0,36,33
1657558320542,MATH 103A,A02,083778,Greenfeld; Be'Eri,5,0,36,31
1657558320542,MATH 103A,A03,093561,Greenfeld; Be'Eri,5,0,36,31
1657558320542,MATH 103A,B01,083779,Greenfeld; Be'Eri,7,0,36,29
1657558320542,MATH 103A,B02,083780,Greenfeld; Be'Eri,4,0,36,32
1657558320542,MATH 103A,B03,093562,Greenfeld; Be'Eri,3,0,36,33
1657558326566,MATH 105,A01,085443,Carter; Anne Toulson,15,0,35,20
1657558326566,MATH 105,A02,093477,Carter; Anne Toulson,20,0,35,15
1657558332606,MATH 109,A01,083213,Ganzberger; Geoffrey Michael,2,0,34,32
1657558332606,MATH 109,A02,083214,Ganzberger; Geoffrey Michael,4,0,34,30
1657558332606,MATH 109,A03,093478,Ganzberger; Geoffrey Michael,2,0,34,32
1657558332606,MATH 109,B01,083215,Ganzberger; Geoffrey Michael,1,0,32,31
1657558332606,MATH 109,B02,083216,Ganzberger; Geoffrey Michael,2,0,32,30
1657558332606,MATH 109,B03,093479,Ganzberger; Geoffrey Michael,8,0,32,24
1657558338633,MATH 142A,A01,083219,Chow; Bennett,7,0,32,25
1657558338633,MATH 142A,A02,083220,Chow; Bennett,10,0,32,22
1657558338633,MATH 142A,A03,093480,Chow; Bennett,8,0,32,24
1657558338633,MATH 142A,B03,093481,Chow; Bennett,8,0,32,24
1657558338633,MATH 142A,B04,093558,Chow; Bennett,13,0,32,19
1657558338633,MATH 142A,B05,093559,Chow; Bennett,6,0,32,26
1657558344658,MATH 193A,A01,083224,Rotar; Vladimir,8,0,34,26
1657558344658,MATH 193A,A02,083225,Rotar; Vladimir,9,0,34,25
1657558344658,MATH 193A,A03,083781,Rotar; Vladimir,5,0,34,29
1657558344658,MATH 193A,A04,083782,Rotar; Vladimir,10,0,34,24
1657558344658,MATH 193A,A05,093482,Rotar; Vladimir,10,0,34,24
1657558350686,MATH 197,001,091859,McAuley; Julian John,9999,0,9999,0
1657558350686,MATH 197,002,095566,Kedlaya; Kiran S.,9997,0,9999,2
1657558350686,MATH 197,003,095567,Xiao; Ming,9999,0,9999,0
1657558350686,MATH 197,004,095571,Perols; Johan Lars,9998,0,9999,1
1657558357740,COGS 9,A01,083615,Shannon; Kyle Michael,9,0,75,66
1657558363761,COGS 11,A01,083617,Boyle; Mary E. T.,22,0,48,26
1657558369787,COGS 13,A01,083071,Bastos; Amalia Pinkusfeld,11,0,71,60
1657558375813,COGS 14A,A01,092681,Semenuks; Arturs,5,1,100,95
1657558381846,COGS 14B,A01,083073,Cheng; Tzu-Han,6,0,63,57
1657558387868,COGS 17,A01,092677,Semenuks; Arturs,6,0,81,75
1657558393893,COGS 100,A01,083619,Allen; Michael Gordon,17,0,70,53
1657558399925,COGS 101A,A01,083621,Davis; Joshua Daniel,9,0,68,59
1657558405947,COGS 101B,A01,091572,Allen; Michael Gordon,12,0,65,53
1657558411984,COGS 101C,A01,083625,Delgado; Tania,17,0,35,18
1657558418019,COGS 107A,A01,083627,Boyle; Mary E. T.,13,0,60,47
1657558424047,COGS 118A,A01,083075,Gupta; Anjum,21,0,76,55
1657558430072,CSE 3,A50,083646,Miranda; Gregory Joseph,24,0,50,26
1657558436096,CSE 8A,A50,083650,Miranda; Gregory Joseph,17,1,56,39
1657558442123,CSE 11,A01,083080,Cao; Yingjun,6,15,40,34
1657558448146,CSE 12,A01,083652,Krause-Levy; Sophia Louisa,28,1,120,92
1657558454177,CSE 15L,A01,083654,Morris; Justin Loren,9,0,50,41
1657558454177,CSE 15L,A02,083655,Morris; Justin Loren,9,0,50,41
1657558460206,CSE 20,A01,083657,Tran; Khoa Dang,39,0,80,41
1657558466234,CSE 21,A01,095574,Bach; Quang Tran,22,0,48,26
1657558472258,CSE 30,A01,083084,Eldon; John,5,0,80,75
1657558472258,CSE 30,B01,095061,Bhaskar; Nishant,9,0,50,41
1657558478283,CSE 100,A01,083659,Cao; Yingjun,5,4,70,65
1657558484319,CSE 134B,A01,083661,Powell; Thomas Allan,22,0,100,78
1657558490343,CSE 140,A01,083663,Gungor; Onat,15,0,85,70
1657558496365,CSE 140L,A01,083088,Eldon; John,21,0,100,79
1657558502388,CSE 175,A01,083665,Kumar; Rakesh,3,0,25,22
1657558508411,CSE 190,A00,092507,Dubnov; Shlomo,8,0,20,12
1657558514445,ECE 45,A01,083139,Congero; Spencer William,6,0,75,69
1657558520470,ECE 65,A50,083695,Saad; Andrew S,12,0,30,18
1657558520470,ECE 65,A51,095125,Saad; Andrew S,24,0,26,2
1657558526511,ECE 109,A01,091882,Touri; Behrouz,19,0,70,51
1657558532538,ECE 180,A00,083140,Abi Samra; Nicholas Camill,1,0,30,29
1657558532538,ECE 180,B00,083141,Abi Samra; Nicholas Camill,0,0,30,30
1657558538574,MATH 10A,A01,083735,Patchell; Gregory David,2,0,30,28
1657558538574,MATH 10A,A02,083736,Patchell; Gregory David,20,0,30,10
1657558538574,MATH 10A,A03,083737,Patchell; Gregory David,16,0,30,14
1657558544603,MATH 10B,A01,083207,Lim; Seonhee,8,0,34,26
1657558544603,MATH 10B,A02,083208,Lim; Seonhee,9,0,35,26
1657558544603,MATH 10B,A03,093472,Lim; Seonhee,7,0,34,27
1657558544603,MATH 10B,B01,083739,Sinha; Shubham,12,0,30,18
1657558550627,MATH 18,A01,083743,Cinel; Cameron Alexander,7,0,30,23
1657558550627,MATH 18,A02,083744,Cinel; Cameron Alexander,17,0,30,13
1657558550627,MATH 18,A03,083745,Cinel; Cameron Alexander,9,0,30,21
1657558550627,MATH 18,B01,083748,Rideout; David Porter,5,0,37,32
1657558550627,MATH 18,B02,083749,Rideout; David Porter,5,0,36,31
1657558550627,MATH 18,B03,083750,Rideout; David Porter,3,0,37,34
1657558550627,MATH 18,B04,083751,Rideout; David Porter,6,0,36,30
1657558550627,MATH 18,B05,093473,Rideout; David Porter,6,0,36,30
1657558550627,MATH 18,B06,093474,Rideout; David Porter,6,0,36,30
1657558556660,MATH 20A,A01,083754,Zheng; Zequn,14,0,40,26
1657558562687,MATH 20B,A01,083756,Briones; Jor-el Thomas Caparas,4,0,36,32
1657558562687,MATH 20B,A02,083757,Briones; Jor-el Thomas Caparas,1,0,36,35
1657558562687,MATH 20B,A03,093475,Briones; Jor-el Thomas Caparas,2,0,36,34
1657558568711,MATH 20C,A01,083760,Briones; Jor-el Thomas Caparas,1,0,35,34
1657558568711,MATH 20C,A02,083761,Briones; Jor-el Thomas Caparas,8,0,35,27
1657558568711,MATH 20C,A03,093476,Briones; Jor-el Thomas Caparas,0,1,36,36
1657558568711,MATH 20C,B01,083762,Bach; Quang Tran,1,0,30,29
1657558574753,MATH 20D,A01,083765,Tran; Brian Kha,5,0,30,25
1657558574753,MATH 20D,A02,083766,Tran; Brian Kha,5,0,30,25
1657558574753,MATH 20D,A03,083767,Tran; Brian Kha,5,0,30,25
1657558580794,MATH 20E,A01,083771,Ganguly; Soumya,9,0,32,23
1657558580794,MATH 20E,A02,083772,Ganguly; Soumya,6,0,32,26
1657558580794,MATH 20E,B01,083773,Ciotti; Benjamin,20,0,35,15
1657558580794,MATH 20E,B02,083774,Ciotti; Benjamin,17,0,35,18
1657558586817,MATH 103A,A01,083777,Greenfeld; Be'Eri,3,0,36,33
1657558586817,MATH 103A,A02,083778,Greenfeld; Be'Eri,5,0,36,31
1657558586817,MATH 103A,A03,093561,Greenfeld; Be'Eri,5,0,36,31
1657558586817,MATH 103A,B01,083779,Greenfeld; Be'Eri,7,0,36,29
1657558586817,MATH 103A,B02,083780,Greenfeld; Be'Eri,4,0,36,32
1657558586817,MATH 103A,B03,093562,Greenfeld; Be'Eri,3,0,36,33
1657558592839,MATH 105,A01,085443,Carter; Anne Toulson,15,0,35,20
1657558592839,MATH 105,A02,093477,Carter; Anne Toulson,20,0,35,15
1657558598878,MATH 109,A01,083213,Ganzberger; Geoffrey Michael,2,0,34,32
1657558598878,MATH 109,A02,083214,Ganzberger; Geoffrey Michael,4,0,34,30
1657558598878,MATH 109,A03,093478,Ganzberger; Geoffrey Michael,2,0,34,32
1657558598878,MATH 109,B01,083215,Ganzberger; Geoffrey Michael,1,0,32,31
1657558598878,MATH 109,B02,083216,Ganzberger; Geoffrey Michael,2,0,32,30
1657558598878,MATH 109,B03,093479,Ganzberger; Geoffrey Michael,8,0,32,24
1657558604907,MATH 142A,A01,083219,Chow; Bennett,7,0,32,25
1657558604907,MATH 142A,A02,083220,Chow; Bennett,10,0,32,22
1657558604907,MATH 142A,A03,093480,Chow; Bennett,8,0,32,24
1657558604907,MATH 142A,B03,093481,Chow; Bennett,8,0,32,24
1657558604907,MATH 142A,B04,093558,Chow; Bennett,13,0,32,19
1657558604907,MATH 142A,B05,093559,Chow; Bennett,6,0,32,26
1657558610930,MATH 193A,A01,083224,Rotar; Vladimir,8,0,34,26
1657558610930,MATH 193A,A02,083225,Rotar; Vladimir,9,0,34,25
1657558610930,MATH 193A,A03,083781,Rotar; Vladimir,5,0,34,29
1657558610930,MATH 193A,A04,083782,Rotar; Vladimir,10,0,34,24
1657558610930,MATH 193A,A05,093482,Rotar; Vladimir,10,0,34,24
1657558616956,MATH 197,001,091859,McAuley; Julian John,9999,0,9999,0
1657558616956,MATH 197,002,095566,Kedlaya; Kiran S.,9997,0,9999,2
1657558616956,MATH 197,003,095567,Xiao; Ming,9999,0,9999,0
1657558616956,MATH 197,004,095571,Perols; Johan Lars,9998,0,9999,1
1657558624087,COGS 9,A01,083615,Shannon; Kyle Michael,9,0,75,66
1657558630127,COGS 11,A01,083617,Boyle; Mary E. T.,22,0,48,26
1657558636154,COGS 13,A01,083071,Bastos; Amalia Pinkusfeld,11,0,71,60
1657558642179,COGS 14A,A01,092681,Semenuks; Arturs,5,1,100,95
1657558648201,COGS 14B,A01,083073,Cheng; Tzu-Han,6,0,63,57
1657558654235,COGS 17,A01,092677,Semenuks; Arturs,6,0,81,75
1657558660259,COGS 100,A01,083619,Allen; Michael Gordon,17,0,70,53
1657558666283,COGS 101A,A01,083621,Davis; Joshua Daniel,9,0,68,59
1657558672315,COGS 101B,A01,091572,Allen; Michael Gordon,12,0,65,53
1657558678338,COGS 101C,A01,083625,Delgado; Tania,17,0,35,18
1657558684361,COGS 107A,A01,083627,Boyle; Mary E. T.,13,0,60,47
1657558690384,COGS 118A,A01,083075,Gupta; Anjum,21,0,76,55
1657558696416,CSE 3,A50,083646,Miranda; Gregory Joseph,24,0,50,26
1657558702442,CSE 8A,A50,083650,Miranda; Gregory Joseph,17,1,56,39
1657558708468,CSE 11,A01,083080,Cao; Yingjun,6,15,40,34
1657558714496,CSE 12,A01,083652,Krause-Levy; Sophia Louisa,28,1,120,92
1657558720521,CSE 15L,A01,083654,Morris; Justin Loren,9,0,50,41
1657558720521,CSE 15L,A02,083655,Morris; Justin Loren,9,0,50,41
1657558726543,CSE 20,A01,083657,Tran; Khoa Dang,39,0,80,41
1657558732566,CSE 21,A01,095574,Bach; Quang Tran,22,0,48,26
1657558738593,CSE 30,A01,083084,Eldon; John,5,0,80,75
1657558738593,CSE 30,B01,095061,Bhaskar; Nishant,9,0,50,41
1657558744630,CSE 100,A01,083659,Cao; Yingjun,5,4,70,65
1657558750656,CSE 134B,A01,083661,Powell; Thomas Allan,22,0,100,78
1657558756681,CSE 140,A01,083663,Gungor; Onat,15,0,85,70
1657558762710,CSE 140L,A01,083088,Eldon; John,21,0,100,79
1657558768740,CSE 175,A01,083665,Kumar; Rakesh,3,0,25,22
1657558774777,CSE 190,A00,092507,Dubnov; Shlomo,8,0,20,12
1657558780799,ECE 45,A01,083139,Congero; Spencer William,6,0,75,69
1657558786821,ECE 65,A50,083695,Saad; Andrew S,12,0,30,18
1657558786821,ECE 65,A51,095125,Saad; Andrew S,24,0,26,2
1657558792847,ECE 109,A01,091882,Touri; Behrouz,19,0,70,51
1657558798879,ECE 180,A00,083140,Abi Samra; Nicholas Camill,1,0,30,29
1657558798879,ECE 180,B00,083141,Abi Samra; Nicholas Camill,0,0,30,30
1657558804904,MATH 10A,A01,083735,Patchell; Gregory David,2,0,30,28
1657558804904,MATH 10A,A02,083736,Patchell; Gregory David,20,0,30,10
1657558804904,MATH 10A,A03,083737,Patchell; Gregory David,16,0,30,14
1657558810931,MATH 10B,A01,083207,Lim; Seonhee,8,0,34,26
1657558810931,MATH 10B,A02,083208,Lim; Seonhee,9,0,35,26
1657558810931,MATH 10B,A03,093472,Lim; Seonhee,7,0,34,27
1657558810931,MATH 10B,B01,083739,Sinha; Shubham,12,0,30,18
1657558816955,MATH 18,A01,083743,Cinel; Cameron Alexander,7,0,30,23
1657558816955,MATH 18,A02,083744,Cinel; Cameron Alexander,17,0,30,13
1657558816955,MATH 18,A03,083745,Cinel; Cameron Alexander,9,0,30,21
1657558816955,MATH 18,B01,083748,Rideout; David Porter,5,0,37,32
1657558816955,MATH 18,B02,083749,Rideout; David Porter,5,0,36,31
1657558816955,MATH 18,B03,083750,Rideout; David Porter,3,0,37,34
1657558816955,MATH 18,B04,083751,Rideout; David Porter,6,0,36,30
1657558816955,MATH 18,B05,093473,Rideout; David Porter,6,0,36,30
1657558816955,MATH 18,B06,093474,Rideout; David Porter,6,0,36,30
1657558822983,MATH 20A,A01,083754,Zheng; Zequn,14,0,40,26
1657558829006,MATH 20B,A01,083756,Briones; Jor-el Thomas Caparas,4,0,36,32
1657558829006,MATH 20B,A02,083757,Briones; Jor-el Thomas Caparas,1,0,36,35
1657558829006,MATH 20B,A03,093475,Briones; Jor-el Thomas Caparas,2,0,36,34
1657558835030,MATH 20C,A01,083760,Briones; Jor-el Thomas Caparas,1,0,35,34
1657558835030,MATH 20C,A02,083761,Briones; Jor-el Thomas Caparas,8,0,35,27
1657558835030,MATH 20C,A03,093476,Briones; Jor-el Thomas Caparas,0,1,36,36
1657558835030,MATH 20C,B01,083762,Bach; Quang Tran,1,0,30,29
1657558841058,MATH 20D,A01,083765,Tran; Brian Kha,5,0,30,25
1657558841058,MATH 20D,A02,083766,Tran; Brian Kha,5,0,30,25
1657558841058,MATH 20D,A03,083767,Tran; Brian Kha,5,0,30,25
1657558847086,MATH 20E,A01,083771,Ganguly; Soumya,9,0,32,23
1657558847086,MATH 20E,A02,083772,Ganguly; Soumya,6,0,32,26
1657558847086,MATH 20E,B01,083773,Ciotti; Benjamin,20,0,35,15
1657558847086,MATH 20E,B02,083774,Ciotti; Benjamin,17,0,35,18
1657558853118,MATH 103A,A01,083777,Greenfeld; Be'Eri,3,0,36,33
1657558853118,MATH 103A,A02,083778,Greenfeld; Be'Eri,5,0,36,31
1657558853118,MATH 103A,A03,093561,Greenfeld; Be'Eri,5,0,36,31
1657558853118,MATH 103A,B01,083779,Greenfeld; Be'Eri,7,0,36,29
1657558853118,MATH 103A,B02,083780,Greenfeld; Be'Eri,4,0,36,32
1657558853118,MATH 103A,B03,093562,Greenfeld; Be'Eri,3,0,36,33
1657558859141,MATH 105,A01,085443,Carter; Anne Toulson,15,0,35,20
1657558859141,MATH 105,A02,093477,Carter; Anne Toulson,20,0,35,15
1657558865164,MATH 109,A01,083213,Ganzberger; Geoffrey Michael,2,0,34,32
1657558865164,MATH 109,A02,083214,Ganzberger; Geoffrey Michael,4,0,34,30
1657558865164,MATH 109,A03,093478,Ganzberger; Geoffrey Michael,2,0,34,32
1657558865164,MATH 109,B01,083215,Ganzberger; Geoffrey Michael,1,0,32,31
1657558865164,MATH 109,B02,083216,Ganzberger; Geoffrey Michael,2,0,32,30
1657558865164,MATH 109,B03,093479,Ganzberger; Geoffrey Michael,8,0,32,24
1657558871193,MATH 142A,A01,083219,Chow; Bennett,7,0,32,25
1657558871193,MATH 142A,A02,083220,Chow; Bennett,10,0,32,22
1657558871193,MATH 142A,A03,093480,Chow; Bennett,8,0,32,24
1657558871193,MATH 142A,B03,093481,Chow; Bennett,8,0,32,24
1657558871193,MATH 142A,B04,093558,Chow; Bennett,13,0,32,19
1657558871193,MATH 142A,B05,093559,Chow; Bennett,6,0,32,26
1657558877221,MATH 193A,A01,083224,Rotar; Vladimir,8,0,34,26
1657558877221,MATH 193A,A02,083225,Rotar; Vladimir,9,0,34,25
1657558877221,MATH 193A,A03,083781,Rotar; Vladimir,5,0,34,29
1657558877221,MATH 193A,A04,083782,Rotar; Vladimir,10,0,34,24
1657558877221,MATH 193A,A05,093482,Rotar; Vladimir,10,0,34,24
1657558883248,MATH 197,001,091859,McAuley; Julian John,9999,0,9999,0
1657558883248,MATH 197,002,095566,Kedlaya; Kiran S.,9997,0,9999,2
1657558883248,MATH 197,003,095567,Xiao; Ming,9999,0,9999,0
1657558883248,MATH 197,004,095571,Perols; Johan Lars,9998,0,9999,1
1657558890307,COGS 9,A01,083615,Shannon; Kyle Michael,9,0,75,66
1657558896339,COGS 11,A01,083617,Boyle; Mary E. T.,22,0,48,26
1657558902371,COGS 13,A01,083071,Bastos; Amalia Pinkusfeld,11,0,71,60
1657558908397,COGS 14A,A01,092681,Semenuks; Arturs,5,1,100,95
1657558914420,COGS 14B,A01,083073,Cheng; Tzu-Han,6,0,63,57
1657558920446,COGS 17,A01,092677,Semenuks; Arturs,6,0,81,75
1657558926480,COGS 100,A01,083619,Allen; Michael Gordon,17,0,70,53
1657558932507,COGS 101A,A01,083621,Davis; Joshua Daniel,9,0,68,59
1657558938543,COGS 101B,A01,091572,Allen; Michael Gordon,12,0,65,53
1657558944566,COGS 101C,A01,083625,Delgado; Tania,17,0,35,18
1657558950601,COGS 107A,A01,083627,Boyle; Mary E. T.,13,0,60,47
1657558956630,COGS 118A,A01,083075,Gupta; Anjum,21,0,76,55
1657558962669,CSE 3,A50,083646,Miranda; Gregory Joseph,24,0,50,26
1657558968698,CSE 8A,A50,083650,Miranda; Gregory Joseph,17,1,56,39
1657558974729,CSE 11,A01,083080,Cao; Yingjun,6,15,40,34
1657558980756,CSE 12,A01,083652,Krause-Levy; Sophia Louisa,28,1,120,92
1657558986780,CSE 15L,A01,083654,Morris; Justin Loren,9,0,50,41
1657558986780,CSE 15L,A02,083655,Morris; Justin Loren,9,0,50,41
1657558992809,CSE 20,A01,083657,Tran; Khoa Dang,39,0,80,41
1657558998837,CSE 21,A01,095574,Bach; Quang Tran,22,0,48,26
1657559004863,CSE 30,A01,083084,Eldon; John,5,0,80,75
1657559004863,CSE 30,B01,095061,Bhaskar; Nishant,9,0,50,41
1657559010886,CSE 100,A01,083659,Cao; Yingjun,5,4,70,65
1657559016916,CSE 134B,A01,083661,Powell; Thomas Allan,22,0,100,78
1657559022939,CSE 140,A01,083663,Gungor; Onat,15,0,85,70
1657559028967,CSE 140L,A01,083088,Eldon; John,21,0,100,79
1657559035000,CSE 175,A01,083665,Kumar; Rakesh,3,0,25,22
1657559041026,CSE 190,A00,092507,Dubnov; Shlomo,8,0,20,12
1657559047057,ECE 45,A01,083139,Congero; Spencer William,6,0,75,69
1657559053081,ECE 65,A50,083695,Saad; Andrew S,12,0,30,18
1657559053081,ECE 65,A51,095125,Saad; Andrew S,24,0,26,2
1657559059103,ECE 109,A01,091882,Touri; Behrouz,19,0,70,51
1657559065136,ECE 180,A00,083140,Abi Samra; Nicholas Camill,1,0,30,29
1657559065136,ECE 180,B00,083141,Abi Samra; Nicholas Camill,0,0,30,30
1657559071161,MATH 10A,A01,083735,Patchell; Gregory David,2,0,30,28
1657559071161,MATH 10A,A02,083736,Patchell; Gregory David,20,0,30,10
1657559071161,MATH 10A,A03,083737,Patchell; Gregory David,16,0,30,14
1657559077190,MATH 10B,A01,083207,Lim; Seonhee,8,0,34,26
1657559077190,MATH 10B,A02,083208,Lim; Seonhee,9,0,35,26
1657559077190,MATH 10B,A03,093472,Lim; Seonhee,7,0,34,27
1657559077190,MATH 10B,B01,083739,Sinha; Shubham,12,0,30,18
1657559083222,MATH 18,A01,083743,Cinel; Cameron Alexander,7,0,30,23
1657559083222,MATH 18,A02,083744,Cinel; Cameron Alexander,17,0,30,13
1657559083222,MATH 18,A03,083745,Cinel; Cameron Alexander,9,0,30,21
1657559083222,MATH 18,B01,083748,Rideout; David Porter,5,0,37,32
1657559083222,MATH 18,B02,083749,Rideout; David Porter,5,0,36,31
1657559083222,MATH 18,B03,083750,Rideout; David Porter,3,0,37,34
1657559083222,MATH 18,B04,083751,Rideout; David Porter,6,0,36,30
1657559083222,MATH 18,B05,093473,Rideout; David Porter,6,0,36,30
1657559083222,MATH 18,B06,093474,Rideout; David Porter,6,0,36,30
1657559089244,MATH 20A,A01,083754,Zheng; Zequn,14,0,40,26
1657559095268,MATH 20B,A01,083756,Briones; Jor-el Thomas Caparas,4,0,36,32
1657559095268,MATH 20B,A02,083757,Briones; Jor-el Thomas Caparas,1,0,36,35
1657559095268,MATH 20B,A03,093475,Briones; Jor-el Thomas Caparas,2,0,36,34
1657559101293,MATH 20C,A01,083760,Briones; Jor-el Thomas Caparas,1,0,35,34
1657559101293,MATH 20C,A02,083761,Briones; Jor-el Thomas Caparas,8,0,35,27
1657559101293,MATH 20C,A03,093476,Briones; Jor-el Thomas Caparas,0,1,36,36
1657559101293,MATH 20C,B01,083762,Bach; Quang Tran,1,0,30,29
1657559107316,MATH 20D,A01,083765,Tran; Brian Kha,5,0,30,25
1657559107316,MATH 20D,A02,083766,Tran; Brian Kha,5,0,30,25
1657559107316,MATH 20D,A03,083767,Tran; Brian Kha,5,0,30,25
1657559113344,MATH 20E,A01,083771,Ganguly; Soumya,9,0,32,23
1657559113344,MATH 20E,A02,083772,Ganguly; Soumya,6,0,32,26
1657559113344,MATH 20E,B01,083773,Ciotti; Benjamin,20,0,35,15
1657559113344,MATH 20E,B02,083774,Ciotti; Benjamin,17,0,35,18
1657559119367,MATH 103A,A01,083777,Greenfeld; Be'Eri,3,0,36,33
1657559119367,MATH 103A,A02,083778,Greenfeld; Be'Eri,5,0,36,31
1657559119367,MATH 103A,A03,093561,Greenfeld; Be'Eri,5,0,36,31
1657559119367,MATH 103A,B01,083779,Greenfeld; Be'Eri,7,0,36,29
1657559119367,MATH 103A,B02,083780,Greenfeld; Be'Eri,4,0,36,32
1657559119367,MATH 103A,B03,093562,Greenfeld; Be'Eri,3,0,36,33
1657559125389,MATH 105,A01,085443,Carter; Anne Toulson,15,0,35,20
1657559125389,MATH 105,A02,093477,Carter; Anne Toulson,20,0,35,15
1657559131413,MATH 109,A01,083213,Ganzberger; Geoffrey Michael,2,0,34,32
1657559131413,MATH 109,A02,083214,Ganzberger; Geoffrey Michael,4,0,34,30
1657559131413,MATH 109,A03,093478,Ganzberger; Geoffrey Michael,2,0,34,32
1657559131413,MATH 109,B01,083215,Ganzberger; Geoffrey Michael,1,0,32,31
1657559131413,MATH 109,B02,083216,Ganzberger; Geoffrey Michael,2,0,32,30
1657559131413,MATH 109,B03,093479,Ganzberger; Geoffrey Michael,8,0,32,24
1657559137437,MATH 142A,A01,083219,Chow; Bennett,7,0,32,25
1657559137437,MATH 142A,A02,083220,Chow; Bennett,10,0,32,22
1657559137437,MATH 142A,A03,093480,Chow; Bennett,8,0,32,24
1657559137437,MATH 142A,B03,093481,Chow; Bennett,8,0,32,24
1657559137437,MATH 142A,B04,093558,Chow; Bennett,13,0,32,19
1657559137437,MATH 142A,B05,093559,Chow; Bennett,6,0,32,26
1657559143460,MATH 193A,A01,083224,Rotar; Vladimir,8,0,34,26
1657559143460,MATH 193A,A02,083225,Rotar; Vladimir,9,0,34,25
1657559143460,MATH 193A,A03,083781,Rotar; Vladimir,5,0,34,29
1657559143460,MATH 193A,A04,083782,Rotar; Vladimir,10,0,34,24
1657559143460,MATH 193A,A05,093482,Rotar; Vladimir,10,0,34,24
1657559149486,MATH 197,001,091859,McAuley; Julian John,9999,0,9999,0
1657559149486,MATH 197,002,095566,Kedlaya; Kiran S.,9997,0,9999,2
1657559149486,MATH 197,003,095567,Xiao; Ming,9999,0,9999,0
1657559149486,MATH 197,004,095571,Perols; Johan Lars,9998,0,9999,1
1657559156539,COGS 9,A01,083615,Shannon; Kyle Michael,9,0,75,66
1657559162561,COGS 11,A01,083617,Boyle; Mary E. T.,22,0,48,26
1657559168596,COGS 13,A01,083071,Bastos; Amalia Pinkusfeld,11,0,71,60
1657559174632,COGS 14A,A01,092681,Semenuks; Arturs,5,1,100,95
1657559180670,COGS 14B,A01,083073,Cheng; Tzu-Han,6,0,63,57
1657559186693,COGS 17,A01,092677,Semenuks; Arturs,6,0,81,75
1657559192720,COGS 100,A01,083619,Allen; Michael Gordon,17,0,70,53
1657559198748,COGS 101A,A01,083621,Davis; Joshua Daniel,9,0,68,59
1657559204785,COGS 101B,A01,091572,Allen; Michael Gordon,12,0,65,53
1657559210809,COGS 101C,A01,083625,Delgado; Tania,17,0,35,18
1657559216925,COGS 107A,A01,083627,Boyle; Mary E. T.,13,0,60,47
1657559222952,COGS 118A,A01,083075,Gupta; Anjum,21,0,76,55
1657559228976,CSE 3,A50,083646,Miranda; Gregory Joseph,24,0,50,26
1657559235004,CSE 8A,A50,083650,Miranda; Gregory Joseph,17,1,56,39
1657559241031,CSE 11,A01,083080,Cao; Yingjun,6,15,40,34
1657559247059,CSE 12,A01,083652,Krause-Levy; Sophia Louisa,28,1,120,92
1657559253082,CSE 15L,A01,083654,Morris; Justin Loren,9,0,50,41
1657559253082,CSE 15L,A02,083655,Morris; Justin Loren,9,0,50,41
1657559259109,CSE 20,A01,083657,Tran; Khoa Dang,39,0,80,41
1657559265142,CSE 21,A01,095574,Bach; Quang Tran,22,0,48,26
1657559271172,CSE 30,A01,083084,Eldon; John,5,0,80,75
1657559271172,CSE 30,B01,095061,Bhaskar; Nishant,9,0,50,41
1657559277194,CSE 100,A01,083659,Cao; Yingjun,5,4,70,65
1657559283231,CSE 134B,A01,083661,Powell; Thomas Allan,22,0,100,78
1657559289257,CSE 140,A01,083663,Gungor; Onat,15,0,85,70
1657559295280,CSE 140L,A01,083088,Eldon; John,21,0,100,79
1657559301305,CSE 175,A01,083665,Kumar; Rakesh,3,0,25,22
1657559307341,CSE 190,A00,092507,Dubnov; Shlomo,8,0,20,12
1657559313363,ECE 45,A01,083139,Congero; Spencer William,6,0,75,69
1657559319394,ECE 65,A50,083695,Saad; Andrew S,12,0,30,18
1657559319394,ECE 65,A51,095125,Saad; Andrew S,24,0,26,2
1657559325418,ECE 109,A01,091882,Touri; Behrouz,19,0,70,51
1657559331443,ECE 180,A00,083140,Abi Samra; Nicholas Camill,1,0,30,29
1657559331443,ECE 180,B00,083141,Abi Samra; Nicholas Camill,0,0,30,30
1657559337471,MATH 10A,A01,083735,Patchell; Gregory David,2,0,30,28
1657559337471,MATH 10A,A02,083736,Patchell; Gregory David,20,0,30,10
1657559337471,MATH 10A,A03,083737,Patchell; Gregory David,16,0,30,14
1657559343495,MATH 10B,A01,083207,Lim; Seonhee,8,0,34,26
1657559343495,MATH 10B,A02,083208,Lim; Seonhee,9,0,35,26
1657559343495,MATH 10B,A03,093472,Lim; Seonhee,7,0,34,27
1657559343495,MATH 10B,B01,083739,Sinha; Shubham,12,0,30,18
1657559349526,MATH 18,A01,083743,Cinel; Cameron Alexander,7,0,30,23
1657559349526,MATH 18,A02,083744,Cinel; Cameron Alexander,17,0,30,13
1657559349526,MATH 18,A03,083745,Cinel; Cameron Alexander,9,0,30,21
1657559349526,MATH 18,B01,083748,Rideout; David Porter,5,0,37,32
1657559349526,MATH 18,B02,083749,Rideout; David Porter,5,0,36,31
1657559349526,MATH 18,B03,083750,Rideout; David Porter,3,0,37,34
1657559349526,MATH 18,B04,083751,Rideout; David Porter,6,0,36,30
1657559349526,MATH 18,B05,093473,Rideout; David Porter,6,0,36,30
1657559349526,MATH 18,B06,093474,Rideout; David Porter,6,0,36,30
1657559355552,MATH 20A,A01,083754,Zheng; Zequn,14,0,40,26
1657559361585,MATH 20B,A01,083756,Briones; Jor-el Thomas Caparas,4,0,36,32
1657559361585,MATH 20B,A02,083757,Briones; Jor-el Thomas Caparas,1,0,36,35
1657559361585,MATH 20B,A03,093475,Briones; Jor-el Thomas Caparas,2,0,36,34
1657559367608,MATH 20C,A01,083760,Briones; Jor-el Thomas Caparas,1,0,35,34
1657559367608,MATH 20C,A02,083761,Briones; Jor-el Thomas Caparas,8,0,35,27
1657559367608,MATH 20C,A03,093476,Briones; Jor-el Thomas Caparas,0,1,36,36
1657559367608,MATH 20C,B01,083762,Bach; Quang Tran,1,0,30,29
1657559373633,MATH 20D,A01,083765,Tran; Brian Kha,5,0,30,25
1657559373633,MATH 20D,A02,083766,Tran; Brian Kha,5,0,30,25
1657559373633,MATH 20D,A03,083767,Tran; Brian Kha,5,0,30,25
1657559379661,MATH 20E,A01,083771,Ganguly; Soumya,9,0,32,23
1657559379661,MATH 20E,A02,083772,Ganguly; Soumya,6,0,32,26
1657559379661,MATH 20E,B01,083773,Ciotti; Benjamin,20,0,35,15
1657559379661,MATH 20E,B02,083774,Ciotti; Benjamin,17,0,35,18
1657559385690,MATH 103A,A01,083777,Greenfeld; Be'Eri,3,0,36,33
1657559385690,MATH 103A,A02,083778,Greenfeld; Be'Eri,5,0,36,31
1657559385690,MATH 103A,A03,093561,Greenfeld; Be'Eri,5,0,36,31
1657559385690,MATH 103A,B01,083779,Greenfeld; Be'Eri,7,0,36,29
1657559385690,MATH 103A,B02,083780,Greenfeld; Be'Eri,4,0,36,32
1657559385690,MATH 103A,B03,093562,Greenfeld; Be'Eri,3,0,36,33
1657559391713,MATH 105,A01,085443,Carter; Anne Toulson,15,0,35,20
1657559391713,MATH 105,A02,093477,Carter; Anne Toulson,20,0,35,15
1657559397738,MATH 109,A01,083213,Ganzberger; Geoffrey Michael,2,0,34,32
1657559397738,MATH 109,A02,083214,Ganzberger; Geoffrey Michael,4,0,34,30
1657559397738,MATH 109,A03,093478,Ganzberger; Geoffrey Michael,2,0,34,32
1657559397738,MATH 109,B01,083215,Ganzberger; Geoffrey Michael,1,0,32,31
1657559397738,MATH 109,B02,083216,Ganzberger; Geoffrey Michael,2,0,32,30
1657559397738,MATH 109,B03,093479,Ganzberger; Geoffrey Michael,8,0,32,24
1657559403761,MATH 142A,A01,083219,Chow; Bennett,7,0,32,25
1657559403761,MATH 142A,A02,083220,Chow; Bennett,10,0,32,22
1657559403761,MATH 142A,A03,093480,Chow; Bennett,8,0,32,24
1657559403761,MATH 142A,B03,093481,Chow; Bennett,8,0,32,24
1657559403761,MATH 142A,B04,093558,Chow; Bennett,13,0,32,19
1657559403761,MATH 142A,B05,093559,Chow; Bennett,6,0,32,26
1657559409789,MATH 193A,A01,083224,Rotar; Vladimir,8,0,34,26
1657559409789,MATH 193A,A02,083225,Rotar; Vladimir,9,0,34,25
1657559409789,MATH 193A,A03,083781,Rotar; Vladimir,5,0,34,29
1657559409789,MATH 193A,A04,083782,Rotar; Vladimir,10,0,34,24
1657559409789,MATH 193A,A05,093482,Rotar; Vladimir,10,0,34,24
1657559415827,MATH 197,001,091859,McAuley; Julian John,9999,0,9999,0
1657559415827,MATH 197,002,095566,Kedlaya; Kiran S.,9997,0,9999,2
1657559415827,MATH 197,003,095567,Xiao; Ming,9999,0,9999,0
1657559415827,MATH 197,004,095571,Perols; Johan Lars,9998,0,9999,1
1657559422888,COGS 9,A01,083615,Shannon; Kyle Michael,9,0,75,66
1657559428911,COGS 11,A01,083617,Boyle; Mary E. T.,22,0,48,26
1657559434953,COGS 13,A01,083071,Bastos; Amalia Pinkusfeld,11,0,71,60
1657559440982,COGS 14A,A01,092681,Semenuks; Arturs,5,1,100,95
1657559447005,COGS 14B,A01,083073,Cheng; Tzu-Han,6,0,63,57
1657559453028,COGS 17,A01,092677,Semenuks; Arturs,6,0,81,75
1657559459053,COGS 100,A01,083619,Allen; Michael Gordon,17,0,70,53
1657559465081,COGS 101A,A01,083621,Davis; Joshua Daniel,9,0,68,59
1657559471107,COGS 101B,A01,091572,Allen; Michael Gordon,12,0,65,53
1657559477136,COGS 101C,A01,083625,Delgado; Tania,17,0,35,18
1657559483178,COGS 107A,A01,083627,Boyle; Mary E. T.,13,0,60,47
1657559489206,COGS 118A,A01,083075,Gupta; Anjum,21,0,76,55
1657559495229,CSE 3,A50,083646,Miranda; Gregory Joseph,24,0,50,26
1657559501255,CSE 8A,A50,083650,Miranda; Gregory Joseph,17,1,56,39
1657559507287,CSE 11,A01,083080,Cao; Yingjun,6,15,40,34
1657559513314,CSE 12,A01,083652,Krause-Levy; Sophia Louisa,28,1,120,92
1657559519344,CSE 15L,A01,083654,Morris; Justin Loren,9,0,50,41
1657559519344,CSE 15L,A02,083655,Morris; Justin Loren,9,0,50,41
1657559525383,CSE 20,A01,083657,Tran; Khoa Dang,39,0,80,41
1657559531408,CSE 21,A01,095574,Bach; Quang Tran,22,0,48,26
1657559537433,CSE 30,A01,083084,Eldon; John,5,0,80,75
1657559537433,CSE 30,B01,095061,Bhaskar; Nishant,9,0,50,41
1657559543462,CSE 100,A01,083659,Cao; Yingjun,5,4,70,65
1657559549485,CSE 134B,A01,083661,Powell; Thomas Allan,22,0,100,78
1657559555507,CSE 140,A01,083663,Gungor; Onat,15,0,85,70
1657559561534,CSE 140L,A01,083088,Eldon; John,21,0,100,79
1657559567560,CSE 175,A01,083665,Kumar; Rakesh,3,0,25,22
1657559573582,CSE 190,A00,092507,Dubnov; Shlomo,8,0,20,12
1657559579613,ECE 45,A01,083139,Congero; Spencer William,6,0,75,69
1657559585640,ECE 65,A50,083695,Saad; Andrew S,12,0,30,18
1657559585640,ECE 65,A51,095125,Saad; Andrew S,24,0,26,2
1657559591663,ECE 109,A01,091882,Touri; Behrouz,19,0,70,51
1657559597690,ECE 180,A00,083140,Abi Samra; Nicholas Camill,1,0,30,29
1657559597690,ECE 180,B00,083141,Abi Samra; Nicholas Camill,0,0,30,30
1657559603718,MATH 10A,A01,083735,Patchell; Gregory David,2,0,30,28
1657559603718,MATH 10A,A02,083736,Patchell; Gregory David,20,0,30,10
1657559603718,MATH 10A,A03,083737,Patchell; Gregory David,16,0,30,14
1657559609750,MATH 10B,A01,083207,Lim; Seonhee,8,0,34,26
1657559609750,MATH 10B,A02,083208,Lim; Seonhee,9,0,35,26
1657559609750,MATH 10B,A03,093472,Lim; Seonhee,7,0,34,27
1657559609750,MATH 10B,B01,083739,Sinha; Shubham,12,0,30,18
1657559615776,MATH 18,A01,083743,Cinel; Cameron Alexander,7,0,30,23
1657559615776,MATH 18,A02,083744,Cinel; Cameron Alexander,17,0,30,13
1657559615776,MATH 18,A03,083745,Cinel; Cameron Alexander,9,0,30,21
1657559615776,MATH 18,B01,083748,Rideout; David Porter,5,0,37,32
1657559615776,MATH 18,B02,083749,Rideout; David Porter,5,0,36,31
1657559615776,MATH 18,B03,083750,Rideout; David Porter,3,0,37,34
1657559615776,MATH 18,B04,083751,Rideout; David Porter,6,0,36,30
1657559615776,MATH 18,B05,093473,Rideout; David Porter,6,0,36,30
1657559615776,MATH 18,B06,093474,Rideout; David Porter,6,0,36,30
1657559621803,MATH 20A,A01,083754,Zheng; Zequn,14,0,40,26
1657559627826,MATH 20B,A01,083756,Briones; Jor-el Thomas Caparas,4,0,36,32
1657559627826,MATH 20B,A02,083757,Briones; Jor-el Thomas Caparas,1,0,36,35
1657559627826,MATH 20B,A03,093475,Briones; Jor-el Thomas Caparas,2,0,36,34
1657559633858,MATH 20C,A01,083760,Briones; Jor-el Thomas Caparas,1,0,35,34
1657559633858,MATH 20C,A02,083761,Briones; Jor-el Thomas Caparas,8,0,35,27
1657559633858,MATH 20C,A03,093476,Briones; Jor-el Thomas Caparas,0,1,36,36
1657559633858,MATH 20C,B01,083762,Bach; Quang Tran,1,0,30,29
1657559639888,MATH 20D,A01,083765,Tran; Brian Kha,5,0,30,25
1657559639888,MATH 20D,A02,083766,Tran; Brian Kha,5,0,30,25
1657559639888,MATH 20D,A03,083767,Tran; Brian Kha,5,0,30,25
1657559645911,MATH 20E,A01,083771,Ganguly; Soumya,9,0,32,23
1657559645911,MATH 20E,A02,083772,Ganguly; Soumya,6,0,32,26
1657559645911,MATH 20E,B01,083773,Ciotti; Benjamin,20,0,35,15
1657559645911,MATH 20E,B02,083774,Ciotti; Benjamin,17,0,35,18
1657559651940,MATH 103A,A01,083777,Greenfeld; Be'Eri,3,0,36,33
1657559651940,MATH 103A,A02,083778,Greenfeld; Be'Eri,5,0,36,31
1657559651940,MATH 103A,A03,093561,Greenfeld; Be'Eri,5,0,36,31
1657559651940,MATH 103A,B01,083779,Greenfeld; Be'Eri,7,0,36,29
1657559651940,MATH 103A,B02,083780,Greenfeld; Be'Eri,4,0,36,32
1657559651940,MATH 103A,B03,093562,Greenfeld; Be'Eri,3,0,36,33
1657559657965,MATH 105,A01,085443,Carter; Anne Toulson,15,0,35,20
1657559657965,MATH 105,A02,093477,Carter; Anne Toulson,20,0,35,15
1657559663999,MATH 109,A01,083213,Ganzberger; Geoffrey Michael,2,0,34,32
1657559663999,MATH 109,A02,083214,Ganzberger; Geoffrey Michael,4,0,34,30
1657559663999,MATH 109,A03,093478,Ganzberger; Geoffrey Michael,2,0,34,32
1657559663999,MATH 109,B01,083215,Ganzberger; Geoffrey Michael,1,0,32,31
1657559663999,MATH 109,B02,083216,Ganzberger; Geoffrey Michael,2,0,32,30
1657559663999,MATH 109,B03,093479,Ganzberger; Geoffrey Michael,8,0,32,24
1657559670024,MATH 142A,A01,083219,Chow; Bennett,7,0,32,25
1657559670024,MATH 142A,A02,083220,Chow; Bennett,10,0,32,22
1657559670024,MATH 142A,A03,093480,Chow; Bennett,8,0,32,24
1657559670024,MATH 142A,B03,093481,Chow; Bennett,8,0,32,24
1657559670024,MATH 142A,B04,093558,Chow; Bennett,13,0,32,19
1657559670024,MATH 142A,B05,093559,Chow; Bennett,6,0,32,26
1657559676047,MATH 193A,A01,083224,Rotar; Vladimir,8,0,34,26
1657559676047,MATH 193A,A02,083225,Rotar; Vladimir,9,0,34,25
1657559676047,MATH 193A,A03,083781,Rotar; Vladimir,5,0,34,29
1657559676047,MATH 193A,A04,083782,Rotar; Vladimir,10,0,34,24
1657559676047,MATH 193A,A05,093482,Rotar; Vladimir,10,0,34,24
1657559682079,MATH 197,001,091859,McAuley; Julian John,9999,0,9999,0
1657559682079,MATH 197,002,095566,Kedlaya; Kiran S.,9997,0,9999,2
1657559682079,MATH 197,003,095567,Xiao; Ming,9999,0,9999,0
1657559682079,MATH 197,004,095571,Perols; Johan Lars,9998,0,9999,1
1657559689141,COGS 9,A01,083615,Shannon; Kyle Michael,9,0,75,66
1657559695168,COGS 11,A01,083617,Boyle; Mary E. T.,22,0,48,26
1657559701195,COGS 13,A01,083071,Bastos; Amalia Pinkusfeld,11,0,71,60
1657559707227,COGS 14A,A01,092681,Semenuks; Arturs,5,1,100,95
1657559713251,COGS 14B,A01,083073,Cheng; Tzu-Han,6,0,63,57
1657559719273,COGS 17,A01,092677,Semenuks; Arturs,6,0,81,75
1657559725304,COGS 100,A01,083619,Allen; Michael Gordon,17,0,70,53
1657559731329,COGS 101A,A01,083621,Davis; Joshua Daniel,9,0,68,59
1657559737355,COGS 101B,A01,091572,Allen; Michael Gordon,12,0,65,53
1657559743381,COGS 101C,A01,083625,Delgado; Tania,17,0,35,18
1657559749409,COGS 107A,A01,083627,Boyle; Mary E. T.,13,0,60,47
1657559755435,COGS 118A,A01,083075,Gupta; Anjum,21,0,76,55
1657559761467,CSE 3,A50,083646,Miranda; Gregory Joseph,24,0,50,26
1657559767503,CSE 8A,A50,083650,Miranda; Gregory Joseph,17,1,56,39
1657559773527,CSE 11,A01,083080,Cao; Yingjun,6,15,40,34
1657559779559,CSE 12,A01,083652,Krause-Levy; Sophia Louisa,28,1,120,92
1657559785588,CSE 15L,A01,083654,Morris; Justin Loren,9,0,50,41
1657559785588,CSE 15L,A02,083655,Morris; Justin Loren,9,0,50,41
1657559791612,CSE 20,A01,083657,Tran; Khoa Dang,39,0,80,41
1657559797633,CSE 21,A01,095574,Bach; Quang Tran,22,0,48,26
1657559803667,CSE 30,A01,083084,Eldon; John,5,0,80,75
1657559803667,CSE 30,B01,095061,Bhaskar; Nishant,9,0,50,41
1657559809693,CSE 100,A01,083659,Cao; Yingjun,5,4,70,65
1657559815803,CSE 134B,A01,083661,Powell; Thomas Allan,22,0,100,78
1657559821829,CSE 140,A01,083663,Gungor; Onat,15,0,85,70
1657559827851,CSE 140L,A01,083088,Eldon; John,21,0,100,79
1657559833876,CSE 175,A01,083665,Kumar; Rakesh,3,0,25,22
1657559839899,CSE 190,A00,092507,Dubnov; Shlomo,8,0,20,12
1657559845922,ECE 45,A01,083139,Congero; Spencer William,6,0,75,69
1657559851946,ECE 65,A50,083695,Saad; Andrew S,12,0,30,18
1657559851946,ECE 65,A51,095125,Saad; Andrew S,24,0,26,2
1657559857974,ECE 109,A01,091882,Touri; Behrouz,19,0,70,51
1657559863996,ECE 180,A00,083140,Abi Samra; Nicholas Camill,1,0,30,29
1657559863996,ECE 180,B00,083141,Abi Samra; Nicholas Camill,0,0,30,30
1657559870020,MATH 10A,A01,083735,Patchell; Gregory David,2,0,30,28
1657559870020,MATH 10A,A02,083736,Patchell; Gregory David,20,0,30,10
1657559870020,MATH 10A,A03,083737,Patchell; Gregory David,16,0,30,14
1657559876048,MATH 10B,A01,083207,Lim; Seonhee,8,0,34,26
1657559876048,MATH 10B,A02,083208,Lim; Seonhee,9,0,35,26
1657559876048,MATH 10B,A03,093472,Lim; Seonhee,7,0,34,27
1657559876048,MATH 10B,B01,083739,Sinha; Shubham,12,0,30,18
1657559882077,MATH 18,A01,083743,Cinel; Cameron Alexander,7,0,30,23
1657559882077,MATH 18,A02,083744,Cinel; Cameron Alexander,17,0,30,13
1657559882077,MATH 18,A03,083745,Cinel; Cameron Alexander,9,0,30,21
1657559882077,MATH 18,B01,083748,Rideout; David Porter,5,0,37,32
1657559882077,MATH 18,B02,083749,Rideout; David Porter,5,0,36,31
1657559882077,MATH 18,B03,083750,Rideout; David Porter,3,0,37,34
1657559882077,MATH 18,B04,083751,Rideout; David Porter,6,0,36,30
1657559882077,MATH 18,B05,093473,Rideout; David Porter,6,0,36,30
1657559882077,MATH 18,B06,093474,Rideout; David Porter,6,0,36,30
1657559888166,MATH 20A,A01,083754,Zheng; Zequn,14,0,40,26
1657559894189,MATH 20B,A01,083756,Briones; Jor-el Thomas Caparas,4,0,36,32
1657559894189,MATH 20B,A02,083757,Briones; Jor-el Thomas Caparas,1,0,36,35
1657559894189,MATH 20B,A03,093475,Briones; Jor-el Thomas Caparas,2,0,36,34
1657559900217,MATH 20C,A01,083760,Briones; Jor-el Thomas Caparas,1,0,35,34
1657559900217,MATH 20C,A02,083761,Briones; Jor-el Thomas Caparas,8,0,35,27
1657559900217,MATH 20C,A03,093476,Briones; Jor-el Thomas Caparas,0,1,36,36
1657559900217,MATH 20C,B01,083762,Bach; Quang Tran,1,0,30,29
1657559906241,MATH 20D,A01,083765,Tran; Brian Kha,5,0,30,25
1657559906241,MATH 20D,A02,083766,Tran; Brian Kha,5,0,30,25
1657559906241,MATH 20D,A03,083767,Tran; Brian Kha,5,0,30,25
1657559912276,MATH 20E,A01,083771,Ganguly; Soumya,9,0,32,23
1657559912276,MATH 20E,A02,083772,Ganguly; Soumya,6,0,32,26
1657559912276,MATH 20E,B01,083773,Ciotti; Benjamin,20,0,35,15
1657559912276,MATH 20E,B02,083774,Ciotti; Benjamin,17,0,35,18
1657559918299,MATH 103A,A01,083777,Greenfeld; Be'Eri,3,0,36,33
1657559918299,MATH 103A,A02,083778,Greenfeld; Be'Eri,5,0,36,31
1657559918299,MATH 103A,A03,093561,Greenfeld; Be'Eri,5,0,36,31
1657559918299,MATH 103A,B01,083779,Greenfeld; Be'Eri,7,0,36,29
1657559918299,MATH 103A,B02,083780,Greenfeld; Be'Eri,4,0,36,32
1657559918299,MATH 103A,B03,093562,Greenfeld; Be'Eri,3,0,36,33
1657559924326,MATH 105,A01,085443,Carter; Anne Toulson,15,0,35,20
1657559924326,MATH 105,A02,093477,Carter; Anne Toulson,20,0,35,15
1657559930351,MATH 109,A01,083213,Ganzberger; Geoffrey Michael,2,0,34,32
1657559930351,MATH 109,A02,083214,Ganzberger; Geoffrey Michael,4,0,34,30
1657559930351,MATH 109,A03,093478,Ganzberger; Geoffrey Michael,2,0,34,32
1657559930351,MATH 109,B01,083215,Ganzberger; Geoffrey Michael,1,0,32,31
1657559930351,MATH 109,B02,083216,Ganzberger; Geoffrey Michael,2,0,32,30
1657559930351,MATH 109,B03,093479,Ganzberger; Geoffrey Michael,8,0,32,24
1657559936382,MATH 142A,A01,083219,Chow; Bennett,7,0,32,25
1657559936382,MATH 142A,A02,083220,Chow; Bennett,10,0,32,22
1657559936382,MATH 142A,A03,093480,Chow; Bennett,8,0,32,24
1657559936382,MATH 142A,B03,093481,Chow; Bennett,8,0,32,24
1657559936382,MATH 142A,B04,093558,Chow; Bennett,13,0,32,19
1657559936382,MATH 142A,B05,093559,Chow; Bennett,6,0,32,26
1657559942420,MATH 193A,A01,083224,Rotar; Vladimir,8,0,34,26
1657559942420,MATH 193A,A02,083225,Rotar; Vladimir,9,0,34,25
1657559942420,MATH 193A,A03,083781,Rotar; Vladimir,5,0,34,29
1657559942420,MATH 193A,A04,083782,Rotar; Vladimir,10,0,34,24
1657559942420,MATH 193A,A05,093482,Rotar; Vladimir,10,0,34,24
1657559948451,MATH 197,001,091859,McAuley; Julian John,9999,0,9999,0
1657559948451,MATH 197,002,095566,Kedlaya; Kiran S.,9997,0,9999,2
1657559948451,MATH 197,003,095567,Xiao; Ming,9999,0,9999,0
1657559948451,MATH 197,004,095571,Perols; Johan Lars,9998,0,9999,1
1657559955503,COGS 9,A01,083615,Shannon; Kyle Michael,9,0,75,66
1657559961526,COGS 11,A01,083617,Boyle; Mary E. T.,22,0,48,26
1657559967554,COGS 13,A01,083071,Bastos; Amalia Pinkusfeld,11,0,71,60
1657559973576,COGS 14A,A01,092681,Semenuks; Arturs,5,1,100,95
1657559979600,COGS 14B,A01,083073,Cheng; Tzu-Han,6,0,63,57
1657559985622,COGS 17,A01,092677,Semenuks; Arturs,6,0,81,75
1657559991645,COGS 100,A01,083619,Allen; Michael Gordon,17,0,70,53
1657559997683,COGS 101A,A01,083621,Davis; Joshua Daniel,9,0,68,59
1657560003724,COGS 101B,A01,091572,Allen; Michael Gordon,12,0,65,53
1657560009757,COGS 101C,A01,083625,Delgado; Tania,17,0,35,18
1657560015782,COGS 107A,A01,083627,Boyle; Mary E. T.,13,0,60,47
1657560021806,COGS 118A,A01,083075,Gupta; Anjum,21,0,76,55
1657560027841,CSE 3,A50,083646,Miranda; Gregory Joseph,24,0,50,26
1657560033866,CSE 8A,A50,083650,Miranda; Gregory Joseph,17,1,56,39
1657560039888,CSE 11,A01,083080,Cao; Yingjun,6,15,40,34
1657560045911,CSE 12,A01,083652,Krause-Levy; Sophia Louisa,28,1,120,92
1657560051948,CSE 15L,A01,083654,Morris; Justin Loren,9,0,50,41
1657560051948,CSE 15L,A02,083655,Morris; Justin Loren,9,0,50,41
1657560057982,CSE 20,A01,083657,Tran; Khoa Dang,39,0,80,41
1657560064010,CSE 21,A01,095574,Bach; Quang Tran,22,0,48,26
1657560070036,CSE 30,A01,083084,Eldon; John,5,0,80,75
1657560070036,CSE 30,B01,095061,Bhaskar; Nishant,9,0,50,41
1657560076073,CSE 100,A01,083659,Cao; Yingjun,5,4,70,65
1657560082098,CSE 134B,A01,083661,Powell; Thomas Allan,22,0,100,78
1657560088121,CSE 140,A01,083663,Gungor; Onat,15,0,85,70
1657560094154,CSE 140L,A01,083088,Eldon; John,21,0,100,79
1657560100183,CSE 175,A01,083665,Kumar; Rakesh,3,0,25,22
1657560106206,CSE 190,A00,092507,Dubnov; Shlomo,8,0,20,12
1657560112233,ECE 45,A01,083139,Congero; Spencer William,6,0,75,69
1657560118256,ECE 65,A50,083695,Saad; Andrew S,12,0,30,18
1657560118256,ECE 65,A51,095125,Saad; Andrew S,24,0,26,2
1657560124279,ECE 109,A01,091882,Touri; Behrouz,19,0,70,51
1657560130305,ECE 180,A00,083140,Abi Samra; Nicholas Camill,1,0,30,29
1657560130305,ECE 180,B00,083141,Abi Samra; Nicholas Camill,0,0,30,30
1657560136327,MATH 10A,A01,083735,Patchell; Gregory David,2,0,30,28
1657560136327,MATH 10A,A02,083736,Patchell; Gregory David,20,0,30,10
1657560136327,MATH 10A,A03,083737,Patchell; Gregory David,16,0,30,14
1657560142358,MATH 10B,A01,083207,Lim; Seonhee,8,0,34,26
1657560142358,MATH 10B,A02,083208,Lim; Seonhee,9,0,35,26
1657560142358,MATH 10B,A03,093472,Lim; Seonhee,7,0,34,27
1657560142358,MATH 10B,B01,083739,Sinha; Shubham,12,0,30,18
1657560148383,MATH 18,A01,083743,Cinel; Cameron Alexander,7,0,30,23
1657560148383,MATH 18,A02,083744,Cinel; Cameron Alexander,17,0,30,13
1657560148383,MATH 18,A03,083745,Cinel; Cameron Alexander,9,0,30,21
1657560148383,MATH 18,B01,083748,Rideout; David Porter,5,0,37,32
1657560148383,MATH 18,B02,083749,Rideout; David Porter,5,0,36,31
1657560148383,MATH 18,B03,083750,Rideout; David Porter,3,0,37,34
1657560148383,MATH 18,B04,083751,Rideout; David Porter,6,0,36,30
1657560148383,MATH 18,B05,093473,Rideout; David Porter,6,0,36,30
1657560148383,MATH 18,B06,093474,Rideout; David Porter,6,0,36,30
1657560154417,MATH 20A,A01,083754,Zheng; Zequn,14,0,40,26
1657560160444,MATH 20B,A01,083756,Briones; Jor-el Thomas Caparas,4,0,36,32
1657560160444,MATH 20B,A02,083757,Briones; Jor-el Thomas Caparas,1,0,36,35
1657560160444,MATH 20B,A03,093475,Briones; Jor-el Thomas Caparas,2,0,36,34
1657560166475,MATH 20C,A01,083760,Briones; Jor-el Thomas Caparas,1,0,35,34
1657560166475,MATH 20C,A02,083761,Briones; Jor-el Thomas Caparas,8,0,35,27
1657560166475,MATH 20C,A03,093476,Briones; Jor-el Thomas Caparas,0,1,36,36
1657560166475,MATH 20C,B01,083762,Bach; Quang Tran,1,0,30,29
1657560172502,MATH 20D,A01,083765,Tran; Brian Kha,5,0,30,25
1657560172502,MATH 20D,A02,083766,Tran; Brian Kha,5,0,30,25
1657560172502,MATH 20D,A03,083767,Tran; Brian Kha,5,0,30,25
1657560178526,MATH 20E,A01,083771,Ganguly; Soumya,9,0,32,23
1657560178526,MATH 20E,A02,083772,Ganguly; Soumya,6,0,32,26
1657560178526,MATH 20E,B01,083773,Ciotti; Benjamin,20,0,35,15
1657560178526,MATH 20E,B02,083774,Ciotti; Benjamin,17,0,35,18
1657560184551,MATH 103A,A01,083777,Greenfeld; Be'Eri,3,0,36,33
1657560184551,MATH 103A,A02,083778,Greenfeld; Be'Eri,5,0,36,31
1657560184551,MATH 103A,A03,093561,Greenfeld; Be'Eri,5,0,36,31
1657560184551,MATH 103A,B01,083779,Greenfeld; Be'Eri,7,0,36,29
1657560184551,MATH 103A,B02,083780,Greenfeld; Be'Eri,4,0,36,32
1657560184551,MATH 103A,B03,093562,Greenfeld; Be'Eri,3,0,36,33
1657560190574,MATH 105,A01,085443,Carter; Anne Toulson,15,0,35,20
1657560190574,MATH 105,A02,093477,Carter; Anne Toulson,20,0,35,15
1657560196605,MATH 109,A01,083213,Ganzberger; Geoffrey Michael,2,0,34,32
1657560196605,MATH 109,A02,083214,Ganzberger; Geoffrey Michael,4,0,34,30
1657560196605,MATH 109,A03,093478,Ganzberger; Geoffrey Michael,2,0,34,32
1657560196605,MATH 109,B01,083215,Ganzberger; Geoffrey Michael,1,0,32,31
1657560196605,MATH 109,B02,083216,Ganzberger; Geoffrey Michael,2,0,32,30
1657560196605,MATH 109,B03,093479,Ganzberger; Geoffrey Michael,8,0,32,24
1657560202631,MATH 142A,A01,083219,Chow; Bennett,7,0,32,25
1657560202631,MATH 142A,A02,083220,Chow; Bennett,10,0,32,22
1657560202631,MATH 142A,A03,093480,Chow; Bennett,8,0,32,24
1657560202631,MATH 142A,B03,093481,Chow; Bennett,8,0,32,24
1657560202631,MATH 142A,B04,093558,Chow; Bennett,13,0,32,19
1657560202631,MATH 142A,B05,093559,Chow; Bennett,6,0,32,26
1657560208662,MATH 193A,A01,083224,Rotar; Vladimir,8,0,34,26
1657560208662,MATH 193A,A02,083225,Rotar; Vladimir,9,0,34,25
1657560208662,MATH 193A,A03,083781,Rotar; Vladimir,5,0,34,29
1657560208662,MATH 193A,A04,083782,Rotar; Vladimir,10,0,34,24
1657560208662,MATH 193A,A05,093482,Rotar; Vladimir,10,0,34,24
1657560214686,MATH 197,001,091859,McAuley; Julian John,9999,0,9999,0
1657560214686,MATH 197,002,095566,Kedlaya; Kiran S.,9997,0,9999,2
1657560214686,MATH 197,003,095567,Xiao; Ming,9999,0,9999,0
1657560214686,MATH 197,004,095571,Perols; Johan Lars,9998,0,9999,1
1657560221751,COGS 9,A01,083615,Shannon; Kyle Michael,9,0,75,66
1657560227787,COGS 11,A01,083617,Boyle; Mary E. T.,22,0,48,26
1657560233811,COGS 13,A01,083071,Bastos; Amalia Pinkusfeld,11,0,71,60
1657560239836,COGS 14A,A01,092681,Semenuks; Arturs,5,1,100,95
1657560245860,COGS 14B,A01,083073,Cheng; Tzu-Han,6,0,63,57
1657560251882,COGS 17,A01,092677,Semenuks; Arturs,6,0,81,75
1657560257910,COGS 100,A01,083619,Allen; Michael Gordon,17,0,70,53
1657560263932,COGS 101A,A01,083621,Davis; Joshua Daniel,9,0,68,59
1657560269965,COGS 101B,A01,091572,Allen; Michael Gordon,12,0,65,53
1657560275988,COGS 101C,A01,083625,Delgado; Tania,17,0,35,18
1657560282011,COGS 107A,A01,083627,Boyle; Mary E. T.,13,0,60,47
1657560288034,COGS 118A,A01,083075,Gupta; Anjum,21,0,76,55
1657560294060,CSE 3,A50,083646,Miranda; Gregory Joseph,24,0,50,26
1657560300089,CSE 8A,A50,083650,Miranda; Gregory Joseph,17,1,56,39
1657560306111,CSE 11,A01,083080,Cao; Yingjun,6,15,40,34
1657560312137,CSE 12,A01,083652,Krause-Levy; Sophia Louisa,28,1,120,92
1657560318170,CSE 15L,A01,083654,Morris; Justin Loren,9,0,50,41
1657560318170,CSE 15L,A02,083655,Morris; Justin Loren,9,0,50,41
1657560324196,CSE 20,A01,083657,Tran; Khoa Dang,39,0,80,41
1657560330224,CSE 21,A01,095574,Bach; Quang Tran,22,0,48,26
1657560336249,CSE 30,A01,083084,Eldon; John,5,0,80,75
1657560336249,CSE 30,B01,095061,Bhaskar; Nishant,9,0,50,41
1657560342271,CSE 100,A01,083659,Cao; Yingjun,5,4,70,65
1657560348301,CSE 134B,A01,083661,Powell; Thomas Allan,22,0,100,78
1657560354328,CSE 140,A01,083663,Gungor; Onat,15,0,85,70
1657560360354,CSE 140L,A01,083088,Eldon; John,21,0,100,79
1657560366381,CSE 175,A01,083665,Kumar; Rakesh,3,0,25,22
1657560372404,CSE 190,A00,092507,Dubnov; Shlomo,8,0,20,12
1657560378430,ECE 45,A01,083139,Congero; Spencer William,6,0,75,69
1657560384457,ECE 65,A50,083695,Saad; Andrew S,12,0,30,18
1657560384457,ECE 65,A51,095125,Saad; Andrew S,24,0,26,2
1657560390488,ECE 109,A01,091882,Touri; Behrouz,19,0,70,51
1657560396517,ECE 180,A00,083140,Abi Samra; Nicholas Camill,1,0,30,29
1657560396517,ECE 180,B00,083141,Abi Samra; Nicholas Camill,0,0,30,30
1657560402540,MATH 10A,A01,083735,Patchell; Gregory David,2,0,30,28
1657560402540,MATH 10A,A02,083736,Patchell; Gregory David,20,0,30,10
1657560402540,MATH 10A,A03,083737,Patchell; Gregory David,16,0,30,14
1657560408569,MATH 10B,A01,083207,Lim; Seonhee,8,0,34,26
1657560408569,MATH 10B,A02,083208,Lim; Seonhee,9,0,35,26
1657560408569,MATH 10B,A03,093472,Lim; Seonhee,7,0,34,27
1657560408569,MATH 10B,B01,083739,Sinha; Shubham,12,0,30,18
1657560414677,MATH 18,A01,083743,Cinel; Cameron Alexander,7,0,30,23
1657560414677,MATH 18,A02,083744,Cinel; Cameron Alexander,17,0,30,13
1657560414677,MATH 18,A03,083745,Cinel; Cameron Alexander,9,0,30,21
1657560414677,MATH 18,B01,083748,Rideout; David Porter,5,0,37,32
1657560414677,MATH 18,B02,083749,Rideout; David Porter,5,0,36,31
1657560414677,MATH 18,B03,083750,Rideout; David Porter,3,0,37,34
1657560414677,MATH 18,B04,083751,Rideout; David Porter,6,0,36,30
1657560414677,MATH 18,B05,093473,Rideout; David Porter,6,0,36,30
1657560414677,MATH 18,B06,093474,Rideout; David Porter,6,0,36,30
1657560420703,MATH 20A,A01,083754,Zheng; Zequn,14,0,40,26
1657560426738,MATH 20B,A01,083756,Briones; Jor-el Thomas Caparas,4,0,36,32
1657560426738,MATH 20B,A02,083757,Briones; Jor-el Thomas Caparas,1,0,36,35
1657560426738,MATH 20B,A03,093475,Briones; Jor-el Thomas Caparas,2,0,36,34
1657560432771,MATH 20C,A01,083760,Briones; Jor-el Thomas Caparas,1,0,35,34
1657560432771,MATH 20C,A02,083761,Briones; Jor-el Thomas Caparas,8,0,35,27
1657560432771,MATH 20C,A03,093476,Briones; Jor-el Thomas Caparas,0,1,36,36
1657560432771,MATH 20C,B01,083762,Bach; Quang Tran,1,0,30,29
1657560438794,MATH 20D,A01,083765,Tran; Brian Kha,5,0,30,25
1657560438794,MATH 20D,A02,083766,Tran; Brian Kha,5,0,30,25
1657560438794,MATH 20D,A03,083767,Tran; Brian Kha,5,0,30,25
1657560444821,MATH 20E,A01,083771,Ganguly; Soumya,9,0,32,23
1657560444821,MATH 20E,A02,083772,Ganguly; Soumya,6,0,32,26
1657560444821,MATH 20E,B01,083773,Ciotti; Benjamin,20,0,35,15
1657560444821,MATH 20E,B02,083774,Ciotti; Benjamin,17,0,35,18
1657560450845,MATH 103A,A01,083777,Greenfeld; Be'Eri,3,0,36,33
1657560450845,MATH 103A,A02,083778,Greenfeld; Be'Eri,5,0,36,31
1657560450845,MATH 103A,A03,093561,Greenfeld; Be'Eri,5,0,36,31
1657560450845,MATH 103A,B01,083779,Greenfeld; Be'Eri,7,0,36,29
1657560450845,MATH 103A,B02,083780,Greenfeld; Be'Eri,4,0,36,32
1657560450845,MATH 103A,B03,093562,Greenfeld; Be'Eri,3,0,36,33
1657560456867,MATH 105,A01,085443,Carter; Anne Toulson,15,0,35,20
1657560456867,MATH 105,A02,093477,Carter; Anne Toulson,20,0,35,15
1657560462895,MATH 109,A01,083213,Ganzberger; Geoffrey Michael,2,0,34,32
1657560462895,MATH 109,A02,083214,Ganzberger; Geoffrey Michael,4,0,34,30
1657560462895,MATH 109,A03,093478,Ganzberger; Geoffrey Michael,2,0,34,32
1657560462895,MATH 109,B01,083215,Ganzberger; Geoffrey Michael,1,0,32,31
1657560462895,MATH 109,B02,083216,Ganzberger; Geoffrey Michael,2,0,32,30
1657560462895,MATH 109,B03,093479,Ganzberger; Geoffrey Michael,8,0,32,24
1657560468920,MATH 142A,A01,083219,Chow; Bennett,7,0,32,25
1657560468920,MATH 142A,A02,083220,Chow; Bennett,10,0,32,22
1657560468920,MATH 142A,A03,093480,Chow; Bennett,8,0,32,24
1657560468920,MATH 142A,B03,093481,Chow; Bennett,8,0,32,24
1657560468920,MATH 142A,B04,093558,Chow; Bennett,13,0,32,19
1657560468920,MATH 142A,B05,093559,Chow; Bennett,6,0,32,26
1657560474941,MATH 193A,A01,083224,Rotar; Vladimir,8,0,34,26
1657560474941,MATH 193A,A02,083225,Rotar; Vladimir,9,0,34,25
1657560474941,MATH 193A,A03,083781,Rotar; Vladimir,5,0,34,29
1657560474941,MATH 193A,A04,083782,Rotar; Vladimir,10,0,34,24
1657560474941,MATH 193A,A05,093482,Rotar; Vladimir,10,0,34,24
1657560480965,MATH 197,001,091859,McAuley; Julian John,9999,0,9999,0
1657560480965,MATH 197,002,095566,Kedlaya; Kiran S.,9997,0,9999,2
1657560480965,MATH 197,003,095567,Xiao; Ming,9999,0,9999,0
1657560480965,MATH 197,004,095571,Perols; Johan Lars,9998,0,9999,1
1657560488017,COGS 9,A01,083615,Shannon; Kyle Michael,9,0,75,66
1657560494043,COGS 11,A01,083617,Boyle; Mary E. T.,23,0,48,25
1657560500078,COGS 13,A01,083071,Bastos; Amalia Pinkusfeld,11,0,71,60
1657560506179,COGS 14A,A01,092681,Semenuks; Arturs,5,1,100,95
1657560512209,COGS 14B,A01,083073,Cheng; Tzu-Han,6,0,63,57
1657560518254,COGS 17,A01,092677,Semenuks; Arturs,6,0,81,75
1657560524281,COGS 100,A01,083619,Allen; Michael Gordon,17,0,70,53
1657560530312,COGS 101A,A01,083621,Davis; Joshua Daniel,9,0,68,59
1657560536340,COGS 101B,A01,091572,Allen; Michael Gordon,12,0,65,53
1657560542362,COGS 101C,A01,083625,Delgado; Tania,17,0,35,18
1657560548386,COGS 107A,A01,083627,Boyle; Mary E. T.,13,0,60,47
1657560554409,COGS 118A,A01,083075,Gupta; Anjum,21,0,76,55
1657560560441,CSE 3,A50,083646,Miranda; Gregory Joseph,24,0,50,26
1657560566476,CSE 8A,A50,083650,Miranda; Gregory Joseph,17,1,56,39
1657560572518,CSE 11,A01,083080,Cao; Yingjun,6,15,40,34
1657560578553,CSE 12,A01,083652,Krause-Levy; Sophia Louisa,28,1,120,92
1657560584577,CSE 15L,A01,083654,Morris; Justin Loren,9,0,50,41
1657560584577,CSE 15L,A02,083655,Morris; Justin Loren,9,0,50,41
1657560590611,CSE 20,A01,083657,Tran; Khoa Dang,39,0,80,41
1657560596649,CSE 21,A01,095574,Bach; Quang Tran,22,0,48,26
1657560602672,CSE 30,A01,083084,Eldon; John,5,0,80,75
1657560602672,CSE 30,B01,095061,Bhaskar; Nishant,9,0,50,41
1657560608699,CSE 100,A01,083659,Cao; Yingjun,5,4,70,65
1657560614728,CSE 134B,A01,083661,Powell; Thomas Allan,22,0,100,78
1657560620756,CSE 140,A01,083663,Gungor; Onat,15,0,85,70
1657560626781,CSE 140L,A01,083088,Eldon; John,21,0,100,79
1657560632804,CSE 175,A01,083665,Kumar; Rakesh,3,0,25,22
1657560638832,CSE 190,A00,092507,Dubnov; Shlomo,8,0,20,12
1657560644869,ECE 45,A01,083139,Congero; Spencer William,6,0,75,69
1657560650899,ECE 65,A50,083695,Saad; Andrew S,12,0,30,18
1657560650899,ECE 65,A51,095125,Saad; Andrew S,24,0,26,2
1657560656933,ECE 109,A01,091882,Touri; Behrouz,19,0,70,51
1657560662956,ECE 180,A00,083140,Abi Samra; Nicholas Camill,1,0,30,29
1657560662956,ECE 180,B00,083141,Abi Samra; Nicholas Camill,0,0,30,30
1657560668986,MATH 10A,A01,083735,Patchell; Gregory David,2,0,30,28
1657560668986,MATH 10A,A02,083736,Patchell; Gregory David,20,0,30,10
1657560668986,MATH 10A,A03,083737,Patchell; Gregory David,16,0,30,14
1657560675017,MATH 10B,A01,083207,Lim; Seonhee,8,0,34,26
1657560675017,MATH 10B,A02,083208,Lim; Seonhee,9,0,35,26
1657560675017,MATH 10B,A03,093472,Lim; Seonhee,7,0,34,27
1657560675017,MATH 10B,B01,083739,Sinha; Shubham,12,0,30,18
1657560681046,MATH 18,A01,083743,Cinel; Cameron Alexander,7,0,30,23
1657560681046,MATH 18,A02,083744,Cinel; Cameron Alexander,17,0,30,13
1657560681046,MATH 18,A03,083745,Cinel; Cameron Alexander,9,0,30,21
1657560681046,MATH 18,B01,083748,Rideout; David Porter,5,0,37,32
1657560681046,MATH 18,B02,083749,Rideout; David Porter,5,0,36,31
1657560681046,MATH 18,B03,083750,Rideout; David Porter,3,0,37,34
1657560681046,MATH 18,B04,083751,Rideout; David Porter,6,0,36,30
1657560681046,MATH 18,B05,093473,Rideout; David Porter,6,0,36,30
1657560681046,MATH 18,B06,093474,Rideout; David Porter,6,0,36,30
1657560687070,MATH 20A,A01,083754,Zheng; Zequn,14,0,40,26
1657560693109,MATH 20B,A01,083756,Briones; Jor-el Thomas Caparas,4,0,36,32
1657560693109,MATH 20B,A02,083757,Briones; Jor-el Thomas Caparas,1,0,36,35
1657560693109,MATH 20B,A03,093475,Briones; Jor-el Thomas Caparas,2,0,36,34
1657560699133,MATH 20C,A01,083760,Briones; Jor-el Thomas Caparas,1,0,35,34
1657560699133,MATH 20C,A02,083761,Briones; Jor-el Thomas Caparas,8,0,35,27
1657560699133,MATH 20C,A03,093476,Briones; Jor-el Thomas Caparas,0,1,36,36
1657560699133,MATH 20C,B01,083762,Bach; Quang Tran,1,0,30,29
1657560705173,MATH 20D,A01,083765,Tran; Brian Kha,5,0,30,25
1657560705173,MATH 20D,A02,083766,Tran; Brian Kha,5,0,30,25
1657560705173,MATH 20D,A03,083767,Tran; Brian Kha,5,0,30,25
1657560711201,MATH 20E,A01,083771,Ganguly; Soumya,9,0,32,23
1657560711201,MATH 20E,A02,083772,Ganguly; Soumya,6,0,32,26
1657560711201,MATH 20E,B01,083773,Ciotti; Benjamin,20,0,35,15
1657560711201,MATH 20E,B02,083774,Ciotti; Benjamin,17,0,35,18
1657560717226,MATH 103A,A01,083777,Greenfeld; Be'Eri,3,0,36,33
1657560717226,MATH 103A,A02,083778,Greenfeld; Be'Eri,5,0,36,31
1657560717226,MATH 103A,A03,093561,Greenfeld; Be'Eri,5,0,36,31
1657560717226,MATH 103A,B01,083779,Greenfeld; Be'Eri,7,0,36,29
1657560717226,MATH 103A,B02,083780,Greenfeld; Be'Eri,4,0,36,32
1657560717226,MATH 103A,B03,093562,Greenfeld; Be'Eri,3,0,36,33
1657560723247,MATH 105,A01,085443,Carter; Anne Toulson,15,0,35,20
1657560723247,MATH 105,A02,093477,Carter; Anne Toulson,20,0,35,15
1657560729272,MATH 109,A01,083213,Ganzberger; Geoffrey Michael,2,0,34,32
1657560729272,MATH 109,A02,083214,Ganzberger; Geoffrey Michael,4,0,34,30
1657560729272,MATH 109,A03,093478,Ganzberger; Geoffrey Michael,2,0,34,32
1657560729272,MATH 109,B01,083215,Ganzberger; Geoffrey Michael,1,0,32,31
1657560729272,MATH 109,B02,083216,Ganzberger; Geoffrey Michael,2,0,32,30
1657560729272,MATH 109,B03,093479,Ganzberger; Geoffrey Michael,8,0,32,24
1657560735296,MATH 142A,A01,083219,Chow; Bennett,7,0,32,25
1657560735296,MATH 142A,A02,083220,Chow; Bennett,10,0,32,22
1657560735296,MATH 142A,A03,093480,Chow; Bennett,8,0,32,24
1657560735296,MATH 142A,B03,093481,Chow; Bennett,8,0,32,24
1657560735296,MATH 142A,B04,093558,Chow; Bennett,13,0,32,19
1657560735296,MATH 142A,B05,093559,Chow; Bennett,6,0,32,26
1657560741329,MATH 193A,A01,083224,Rotar; Vladimir,8,0,34,26
1657560741329,MATH 193A,A02,083225,Rotar; Vladimir,9,0,34,25
1657560741329,MATH 193A,A03,083781,Rotar; Vladimir,5,0,34,29
1657560741329,MATH 193A,A04,083782,Rotar; Vladimir,10,0,34,24
1657560741329,MATH 193A,A05,093482,Rotar; Vladimir,10,0,34,24
1657560747357,MATH 197,001,091859,McAuley; Julian John,9999,0,9999,0
1657560747357,MATH 197,002,095566,Kedlaya; Kiran S.,9997,0,9999,2
1657560747357,MATH 197,003,095567,Xiao; Ming,9999,0,9999,0
1657560747357,MATH 197,004,095571,Perols; Johan Lars,9998,0,9999,1
1657560754423,COGS 9,A01,083615,Shannon; Kyle Michael,9,0,75,66
1657560760447,COGS 11,A01,083617,Boyle; Mary E. T.,23,0,48,25
1657560766473,COGS 13,A01,083071,Bastos; Amalia Pinkusfeld,11,0,71,60
1657560772499,COGS 14A,A01,092681,Semenuks; Arturs,5,1,100,95
1657560778525,COGS 14B,A01,083073,Cheng; Tzu-Han,6,0,63,57
1657560784550,COGS 17,A01,092677,Semenuks; Arturs,6,0,81,75
1657560790573,COGS 100,A01,083619,Allen; Michael Gordon,17,0,70,53
1657560796600,COGS 101A,A01,083621,Davis; Joshua Daniel,9,0,68,59
1657560802622,COGS 101B,A01,091572,Allen; Michael Gordon,12,0,65,53
1657560808648,COGS 101C,A01,083625,Delgado; Tania,17,0,35,18
1657560814672,COGS 107A,A01,083627,Boyle; Mary E. T.,13,0,60,47
1657560820706,COGS 118A,A01,083075,Gupta; Anjum,21,0,76,55
1657560826740,CSE 3,A50,083646,Miranda; Gregory Joseph,24,0,50,26
1657560832761,CSE 8A,A50,083650,Miranda; Gregory Joseph,17,1,56,39
1657560838784,CSE 11,A01,083080,Cao; Yingjun,6,15,40,34
1657560844808,CSE 12,A01,083652,Krause-Levy; Sophia Louisa,28,1,120,92
1657560850835,CSE 15L,A01,083654,Morris; Justin Loren,9,0,50,41
1657560850835,CSE 15L,A02,083655,Morris; Justin Loren,9,0,50,41
1657560856862,CSE 20,A01,083657,Tran; Khoa Dang,39,0,80,41
1657560862886,CSE 21,A01,095574,Bach; Quang Tran,22,0,48,26
1657560868909,CSE 30,A01,083084,Eldon; John,5,0,80,75
1657560868909,CSE 30,B01,095061,Bhaskar; Nishant,9,0,50,41
1657560874935,CSE 100,A01,083659,Cao; Yingjun,5,4,70,65
1657560880959,CSE 134B,A01,083661,Powell; Thomas Allan,22,0,100,78
1657560886980,CSE 140,A01,083663,Gungor; Onat,15,0,85,70
1657560893008,CSE 140L,A01,083088,Eldon; John,21,0,100,79
1657560899032,CSE 175,A01,083665,Kumar; Rakesh,3,0,25,22
1657560905055,CSE 190,A00,092507,Dubnov; Shlomo,8,0,20,12
1657560911077,ECE 45,A01,083139,Congero; Spencer William,6,0,75,69
1657560917120,ECE 65,A50,083695,Saad; Andrew S,12,0,30,18
1657560917120,ECE 65,A51,095125,Saad; Andrew S,24,0,26,2
1657560923146,ECE 109,A01,091882,Touri; Behrouz,19,0,70,51
1657560929175,ECE 180,A00,083140,Abi Samra; Nicholas Camill,1,0,30,29
1657560929175,ECE 180,B00,083141,Abi Samra; Nicholas Camill,0,0,30,30
1657560935203,MATH 10A,A01,083735,Patchell; Gregory David,2,0,30,28
1657560935203,MATH 10A,A02,083736,Patchell; Gregory David,20,0,30,10
1657560935203,MATH 10A,A03,083737,Patchell; Gregory David,16,0,30,14
1657560941235,MATH 10B,A01,083207,Lim; Seonhee,8,0,34,26
1657560941235,MATH 10B,A02,083208,Lim; Seonhee,9,0,35,26
1657560941235,MATH 10B,A03,093472,Lim; Seonhee,7,0,34,27
1657560941235,MATH 10B,B01,083739,Sinha; Shubham,12,0,30,18
1657560947261,MATH 18,A01,083743,Cinel; Cameron Alexander,7,0,30,23
1657560947261,MATH 18,A02,083744,Cinel; Cameron Alexander,17,0,30,13
1657560947261,MATH 18,A03,083745,Cinel; Cameron Alexander,9,0,30,21
1657560947261,MATH 18,B01,083748,Rideout; David Porter,5,0,37,32
1657560947261,MATH 18,B02,083749,Rideout; David Porter,5,0,36,31
1657560947261,MATH 18,B03,083750,Rideout; David Porter,3,0,37,34
1657560947261,MATH 18,B04,083751,Rideout; David Porter,6,0,36,30
1657560947261,MATH 18,B05,093473,Rideout; David Porter,6,0,36,30
1657560947261,MATH 18,B06,093474,Rideout; David Porter,6,0,36,30
1657560953284,MATH 20A,A01,083754,Zheng; Zequn,14,0,40,26
1657560959305,MATH 20B,A01,083756,Briones; Jor-el Thomas Caparas,4,0,36,32
1657560959305,MATH 20B,A02,083757,Briones; Jor-el Thomas Caparas,1,0,36,35
1657560959305,MATH 20B,A03,093475,Briones; Jor-el Thomas Caparas,2,0,36,34
1657560965336,MATH 20C,A01,083760,Briones; Jor-el Thomas Caparas,1,0,35,34
1657560965336,MATH 20C,A02,083761,Briones; Jor-el Thomas Caparas,8,0,35,27
1657560965336,MATH 20C,A03,093476,Briones; Jor-el Thomas Caparas,0,1,36,36
1657560965336,MATH 20C,B01,083762,Bach; Quang Tran,1,0,30,29
1657560971361,MATH 20D,A01,083765,Tran; Brian Kha,5,0,30,25
1657560971361,MATH 20D,A02,083766,Tran; Brian Kha,5,0,30,25
1657560971361,MATH 20D,A03,083767,Tran; Brian Kha,5,0,30,25
1657560977399,MATH 20E,A01,083771,Ganguly; Soumya,9,0,32,23
1657560977399,MATH 20E,A02,083772,Ganguly; Soumya,6,0,32,26
1657560977399,MATH 20E,B01,083773,Ciotti; Benjamin,20,0,35,15
1657560977399,MATH 20E,B02,083774,Ciotti; Benjamin,17,0,35,18
1657560983424,MATH 103A,A01,083777,Greenfeld; Be'Eri,3,0,36,33
1657560983424,MATH 103A,A02,083778,Greenfeld; Be'Eri,5,0,36,31
1657560983424,MATH 103A,A03,093561,Greenfeld; Be'Eri,5,0,36,31
1657560983424,MATH 103A,B01,083779,Greenfeld; Be'Eri,7,0,36,29
1657560983424,MATH 103A,B02,083780,Greenfeld; Be'Eri,4,0,36,32
1657560983424,MATH 103A,B03,093562,Greenfeld; Be'Eri,3,0,36,33
1657560989450,MATH 105,A01,085443,Carter; Anne Toulson,15,0,35,20
1657560989450,MATH 105,A02,093477,Carter; Anne Toulson,20,0,35,15
1657560995478,MATH 109,A01,083213,Ganzberger; Geoffrey Michael,2,0,34,32
1657560995478,MATH 109,A02,083214,Ganzberger; Geoffrey Michael,4,0,34,30
1657560995478,MATH 109,A03,093478,Ganzberger; Geoffrey Michael,2,0,34,32
1657560995478,MATH 109,B01,083215,Ganzberger; Geoffrey Michael,1,0,32,31
1657560995478,MATH 109,B02,083216,Ganzberger; Geoffrey Michael,2,0,32,30
1657560995478,MATH 109,B03,093479,Ganzberger; Geoffrey Michael,8,0,32,24
1657561001508,MATH 142A,A01,083219,Chow; Bennett,7,0,32,25
1657561001508,MATH 142A,A02,083220,Chow; Bennett,10,0,32,22
1657561001508,MATH 142A,A03,093480,Chow; Bennett,8,0,32,24
1657561001508,MATH 142A,B03,093481,Chow; Bennett,8,0,32,24
1657561001508,MATH 142A,B04,093558,Chow; Bennett,13,0,32,19
1657561001508,MATH 142A,B05,093559,Chow; Bennett,6,0,32,26
1657561007531,MATH 193A,A01,083224,Rotar; Vladimir,8,0,34,26
1657561007531,MATH 193A,A02,083225,Rotar; Vladimir,9,0,34,25
1657561007531,MATH 193A,A03,083781,Rotar; Vladimir,5,0,34,29
1657561007531,MATH 193A,A04,083782,Rotar; Vladimir,10,0,34,24
1657561007531,MATH 193A,A05,093482,Rotar; Vladimir,10,0,34,24
1657561013627,MATH 197,001,091859,McAuley; Julian John,9999,0,9999,0
1657561013627,MATH 197,002,095566,Kedlaya; Kiran S.,9997,0,9999,2
1657561013627,MATH 197,003,095567,Xiao; Ming,9999,0,9999,0
1657561013627,MATH 197,004,095571,Perols; Johan Lars,9998,0,9999,1
1657561020684,COGS 9,A01,083615,Shannon; Kyle Michael,9,0,75,66
1657561026705,COGS 11,A01,083617,Boyle; Mary E. T.,23,0,48,25
1657561032742,COGS 13,A01,083071,Bastos; Amalia Pinkusfeld,11,0,71,60
1657561038767,COGS 14A,A01,092681,Semenuks; Arturs,5,1,100,95
1657561044794,COGS 14B,A01,083073,Cheng; Tzu-Han,6,0,63,57
1657561050822,COGS 17,A01,092677,Semenuks; Arturs,6,0,81,75
1657561056847,COGS 100,A01,083619,Allen; Michael Gordon,17,0,70,53
1657561062871,COGS 101A,A01,083621,Davis; Joshua Daniel,9,0,68,59
1657561068895,COGS 101B,A01,091572,Allen; Michael Gordon,12,0,65,53
1657561074922,COGS 101C,A01,083625,Delgado; Tania,17,0,35,18
1657561080948,COGS 107A,A01,083627,Boyle; Mary E. T.,13,0,60,47
1657561086981,COGS 118A,A01,083075,Gupta; Anjum,21,0,76,55
1657561093015,CSE 3,A50,083646,Miranda; Gregory Joseph,24,0,50,26
1657561099051,CSE 8A,A50,083650,Miranda; Gregory Joseph,17,1,56,39
1657561105073,CSE 11,A01,083080,Cao; Yingjun,6,15,40,34
1657561111096,CSE 12,A01,083652,Krause-Levy; Sophia Louisa,28,1,120,92
1657561117121,CSE 15L,A01,083654,Morris; Justin Loren,9,0,50,41
1657561117121,CSE 15L,A02,083655,Morris; Justin Loren,9,0,50,41
1657561123148,CSE 20,A01,083657,Tran; Khoa Dang,39,0,80,41
1657561129176,CSE 21,A01,095574,Bach; Quang Tran,22,0,48,26
1657561135204,CSE 30,A01,083084,Eldon; John,5,0,80,75
1657561135204,CSE 30,B01,095061,Bhaskar; Nishant,9,0,50,41
1657561141230,CSE 100,A01,083659,Cao; Yingjun,5,4,70,65
1657561147252,CSE 134B,A01,083661,Powell; Thomas Allan,22,0,100,78
1657561153283,CSE 140,A01,083663,Gungor; Onat,15,0,85,70
1657561159315,CSE 140L,A01,083088,Eldon; John,21,0,100,79
1657561165341,CSE 175,A01,083665,Kumar; Rakesh,3,0,25,22
1657561171366,CSE 190,A00,092507,Dubnov; Shlomo,8,0,20,12
1657561177388,ECE 45,A01,083139,Congero; Spencer William,6,0,75,69
1657561183414,ECE 65,A50,083695,Saad; Andrew S,12,0,30,18
1657561183414,ECE 65,A51,095125,Saad; Andrew S,24,0,26,2
1657561189444,ECE 109,A01,091882,Touri; Behrouz,19,0,70,51
1657561195465,ECE 180,A00,083140,Abi Samra; Nicholas Camill,1,0,30,29
1657561195465,ECE 180,B00,083141,Abi Samra; Nicholas Camill,0,0,30,30
1657561201492,MATH 10A,A01,083735,Patchell; Gregory David,2,0,30,28
1657561201492,MATH 10A,A02,083736,Patchell; Gregory David,20,0,30,10
1657561201492,MATH 10A,A03,083737,Patchell; Gregory David,16,0,30,14
1657561207515,MATH 10B,A01,083207,Lim; Seonhee,8,0,34,26
1657561207515,MATH 10B,A02,083208,Lim; Seonhee,9,0,35,26
1657561207515,MATH 10B,A03,093472,Lim; Seonhee,7,0,34,27
1657561207515,MATH 10B,B01,083739,Sinha; Shubham,12,0,30,18
1657561213573,MATH 18,A01,083743,Cinel; Cameron Alexander,7,0,30,23
1657561213573,MATH 18,A02,083744,Cinel; Cameron Alexander,17,0,30,13
1657561213573,MATH 18,A03,083745,Cinel; Cameron Alexander,9,0,30,21
1657561213573,MATH 18,B01,083748,Rideout; David Porter,5,0,37,32
1657561213573,MATH 18,B02,083749,Rideout; David Porter,5,0,36,31
1657561213573,MATH 18,B03,083750,Rideout; David Porter,3,0,37,34
1657561213573,MATH 18,B04,083751,Rideout; David Porter,6,0,36,30
1657561213573,MATH 18,B05,093473,Rideout; David Porter,6,0,36,30
1657561213573,MATH 18,B06,093474,Rideout; David Porter,6,0,36,30
1657561219593,MATH 20A,A01,083754,Zheng; Zequn,14,0,40,26
1657561225615,MATH 20B,A01,083756,Briones; Jor-el Thomas Caparas,4,0,36,32
1657561225615,MATH 20B,A02,083757,Briones; Jor-el Thomas Caparas,1,0,36,35
1657561225615,MATH 20B,A03,093475,Briones; Jor-el Thomas Caparas,2,0,36,34
1657561231643,MATH 20C,A01,083760,Briones; Jor-el Thomas Caparas,1,0,35,34
1657561231643,MATH 20C,A02,083761,Briones; Jor-el Thomas Caparas,8,0,35,27
1657561231643,MATH 20C,A03,093476,Briones; Jor-el Thomas Caparas,0,1,36,36
1657561231643,MATH 20C,B01,083762,Bach; Quang Tran,1,0,30,29
1657561237668,MATH 20D,A01,083765,Tran; Brian Kha,5,0,30,25
1657561237668,MATH 20D,A02,083766,Tran; Brian Kha,5,0,30,25
1657561237668,MATH 20D,A03,083767,Tran; Brian Kha,5,0,30,25
1657561243692,MATH 20E,A01,083771,Ganguly; Soumya,9,0,32,23
1657561243692,MATH 20E,A02,083772,Ganguly; Soumya,6,0,32,26
1657561243692,MATH 20E,B01,083773,Ciotti; Benjamin,20,0,35,15
1657561243692,MATH 20E,B02,083774,Ciotti; Benjamin,17,0,35,18
1657561249716,MATH 103A,A01,083777,Greenfeld; Be'Eri,3,0,36,33
1657561249716,MATH 103A,A02,083778,Greenfeld; Be'Eri,5,0,36,31
1657561249716,MATH 103A,A03,093561,Greenfeld; Be'Eri,5,0,36,31
1657561249716,MATH 103A,B01,083779,Greenfeld; Be'Eri,7,0,36,29
1657561249716,MATH 103A,B02,083780,Greenfeld; Be'Eri,4,0,36,32
1657561249716,MATH 103A,B03,093562,Greenfeld; Be'Eri,3,0,36,33
1657561255739,MATH 105,A01,085443,Carter; Anne Toulson,15,0,35,20
1657561255739,MATH 105,A02,093477,Carter; Anne Toulson,20,0,35,15
1657561261770,MATH 109,A01,083213,Ganzberger; Geoffrey Michael,2,0,34,32
1657561261770,MATH 109,A02,083214,Ganzberger; Geoffrey Michael,4,0,34,30
1657561261770,MATH 109,A03,093478,Ganzberger; Geoffrey Michael,2,0,34,32
1657561261770,MATH 109,B01,083215,Ganzberger; Geoffrey Michael,1,0,32,31
1657561261770,MATH 109,B02,083216,Ganzberger; Geoffrey Michael,2,0,32,30
1657561261770,MATH 109,B03,093479,Ganzberger; Geoffrey Michael,8,0,32,24
1657561267793,MATH 142A,A01,083219,Chow; Bennett,7,0,32,25
1657561267793,MATH 142A,A02,083220,Chow; Bennett,10,0,32,22
1657561267793,MATH 142A,A03,093480,Chow; Bennett,8,0,32,24
1657561267793,MATH 142A,B03,093481,Chow; Bennett,8,0,32,24
1657561267793,MATH 142A,B04,093558,Chow; Bennett,13,0,32,19
1657561267793,MATH 142A,B05,093559,Chow; Bennett,6,0,32,26
1657561273816,MATH 193A,A01,083224,Rotar; Vladimir,8,0,34,26
1657561273816,MATH 193A,A02,083225,Rotar; Vladimir,9,0,34,25
1657561273816,MATH 193A,A03,083781,Rotar; Vladimir,5,0,34,29
1657561273816,MATH 193A,A04,083782,Rotar; Vladimir,10,0,34,24
1657561273816,MATH 193A,A05,093482,Rotar; Vladimir,10,0,34,24
1657561279842,MATH 197,001,091859,McAuley; Julian John,9999,0,9999,0
1657561279842,MATH 197,002,095566,Kedlaya; Kiran S.,9997,0,9999,2
1657561279842,MATH 197,003,095567,Xiao; Ming,9999,0,9999,0
1657561279842,MATH 197,004,095571,Perols; Johan Lars,9998,0,9999,1
1657561286902,COGS 9,A01,083615,Shannon; Kyle Michael,9,0,75,66
1657561292932,COGS 11,A01,083617,Boyle; Mary E. T.,23,0,48,25
1657561298971,COGS 13,A01,083071,Bastos; Amalia Pinkusfeld,11,0,71,60
1657561304995,COGS 14A,A01,092681,Semenuks; Arturs,5,1,100,95
1657561311023,COGS 14B,A01,083073,Cheng; Tzu-Han,6,0,63,57
1657561317049,COGS 17,A01,092677,Semenuks; Arturs,6,0,81,75
1657561323071,COGS 100,A01,083619,Allen; Michael Gordon,17,0,70,53
1657561329099,COGS 101A,A01,083621,Davis; Joshua Daniel,9,0,68,59
1657561335121,COGS 101B,A01,091572,Allen; Michael Gordon,12,0,65,53
1657561341155,COGS 101C,A01,083625,Delgado; Tania,17,0,35,18
1657561347177,COGS 107A,A01,083627,Boyle; Mary E. T.,13,0,60,47
1657561353205,COGS 118A,A01,083075,Gupta; Anjum,21,0,76,55
1657561359230,CSE 3,A50,083646,Miranda; Gregory Joseph,24,0,50,26
1657561365256,CSE 8A,A50,083650,Miranda; Gregory Joseph,17,1,56,39
1657561371297,CSE 11,A01,083080,Cao; Yingjun,6,15,40,34
1657561377323,CSE 12,A01,083652,Krause-Levy; Sophia Louisa,28,1,120,92
1657561383352,CSE 15L,A01,083654,Morris; Justin Loren,9,0,50,41
1657561383352,CSE 15L,A02,083655,Morris; Justin Loren,9,0,50,41
1657561389375,CSE 20,A01,083657,Tran; Khoa Dang,39,0,80,41
1657561395399,CSE 21,A01,095574,Bach; Quang Tran,22,0,48,26
1657561401422,CSE 30,A01,083084,Eldon; John,5,0,80,75
1657561401422,CSE 30,B01,095061,Bhaskar; Nishant,9,0,50,41
1657561407445,CSE 100,A01,083659,Cao; Yingjun,5,4,70,65
1657561413466,CSE 134B,A01,083661,Powell; Thomas Allan,22,0,100,78
1657561419489,CSE 140,A01,083663,Gungor; Onat,15,0,85,70
1657561425525,CSE 140L,A01,083088,Eldon; John,21,0,100,79
1657561431551,CSE 175,A01,083665,Kumar; Rakesh,3,0,25,22
1657561437576,CSE 190,A00,092507,Dubnov; Shlomo,8,0,20,12
1657561443600,ECE 45,A01,083139,Congero; Spencer William,6,0,75,69
1657561449624,ECE 65,A50,083695,Saad; Andrew S,12,0,30,18
1657561449624,ECE 65,A51,095125,Saad; Andrew S,24,0,26,2
1657561455647,ECE 109,A01,091882,Touri; Behrouz,19,0,70,51
1657561461670,ECE 180,A00,083140,Abi Samra; Nicholas Camill,1,0,30,29
1657561461670,ECE 180,B00,083141,Abi Samra; Nicholas Camill,0,0,30,30
1657561467698,MATH 10A,A01,083735,Patchell; Gregory David,2,0,30,28
1657561467698,MATH 10A,A02,083736,Patchell; Gregory David,20,0,30,10
1657561467698,MATH 10A,A03,083737,Patchell; Gregory David,16,0,30,14
1657561473732,MATH 10B,A01,083207,Lim; Seonhee,8,0,34,26
1657561473732,MATH 10B,A02,083208,Lim; Seonhee,9,0,35,26
1657561473732,MATH 10B,A03,093472,Lim; Seonhee,7,0,34,27
1657561473732,MATH 10B,B01,083739,Sinha; Shubham,12,0,30,18
1657561479759,MATH 18,A01,083743,Cinel; Cameron Alexander,7,0,30,23
1657561479759,MATH 18,A02,083744,Cinel; Cameron Alexander,17,0,30,13
1657561479759,MATH 18,A03,083745,Cinel; Cameron Alexander,9,0,30,21
1657561479759,MATH 18,B01,083748,Rideout; David Porter,5,0,37,32
1657561479759,MATH 18,B02,083749,Rideout; David Porter,5,0,36,31
1657561479759,MATH 18,B03,083750,Rideout; David Porter,3,0,37,34
1657561479759,MATH 18,B04,083751,Rideout; David Porter,6,0,36,30
1657561479759,MATH 18,B05,093473,Rideout; David Porter,6,0,36,30
1657561479759,MATH 18,B06,093474,Rideout; David Porter,6,0,36,30
1657561485785,MATH 20A,A01,083754,Zheng; Zequn,14,0,40,26
1657561491809,MATH 20B,A01,083756,Briones; Jor-el Thomas Caparas,4,0,36,32
1657561491809,MATH 20B,A02,083757,Briones; Jor-el Thomas Caparas,1,0,36,35
1657561491809,MATH 20B,A03,093475,Briones; Jor-el Thomas Caparas,2,0,36,34
1657561497838,MATH 20C,A01,083760,Briones; Jor-el Thomas Caparas,1,0,35,34
1657561497838,MATH 20C,A02,083761,Briones; Jor-el Thomas Caparas,8,0,35,27
1657561497838,MATH 20C,A03,093476,Briones; Jor-el Thomas Caparas,0,1,36,36
1657561497838,MATH 20C,B01,083762,Bach; Quang Tran,1,0,30,29
1657561503878,MATH 20D,A01,083765,Tran; Brian Kha,5,0,30,25
1657561503878,MATH 20D,A02,083766,Tran; Brian Kha,5,0,30,25
1657561503878,MATH 20D,A03,083767,Tran; Brian Kha,5,0,30,25
1657561509902,MATH 20E,A01,083771,Ganguly; Soumya,9,0,32,23
1657561509902,MATH 20E,A02,083772,Ganguly; Soumya,6,0,32,26
1657561509902,MATH 20E,B01,083773,Ciotti; Benjamin,20,0,35,15
1657561509902,MATH 20E,B02,083774,Ciotti; Benjamin,17,0,35,18
1657561515925,MATH 103A,A01,083777,Greenfeld; Be'Eri,3,0,36,33
1657561515925,MATH 103A,A02,083778,Greenfeld; Be'Eri,5,0,36,31
1657561515925,MATH 103A,A03,093561,Greenfeld; Be'Eri,5,0,36,31
1657561515925,MATH 103A,B01,083779,Greenfeld; Be'Eri,7,0,36,29
1657561515925,MATH 103A,B02,083780,Greenfeld; Be'Eri,4,0,36,32
1657561515925,MATH 103A,B03,093562,Greenfeld; Be'Eri,3,0,36,33
1657561521949,MATH 105,A01,085443,Carter; Anne Toulson,15,0,35,20
1657561521949,MATH 105,A02,093477,Carter; Anne Toulson,20,0,35,15
1657561527973,MATH 109,A01,083213,Ganzberger; Geoffrey Michael,2,0,34,32
1657561527973,MATH 109,A02,083214,Ganzberger; Geoffrey Michael,4,0,34,30
1657561527973,MATH 109,A03,093478,Ganzberger; Geoffrey Michael,2,0,34,32
1657561527973,MATH 109,B01,083215,Ganzberger; Geoffrey Michael,1,0,32,31
1657561527973,MATH 109,B02,083216,Ganzberger; Geoffrey Michael,2,0,32,30
1657561527973,MATH 109,B03,093479,Ganzberger; Geoffrey Michael,8,0,32,24
1657561534005,MATH 142A,A01,083219,Chow; Bennett,7,0,32,25
1657561534005,MATH 142A,A02,083220,Chow; Bennett,10,0,32,22
1657561534005,MATH 142A,A03,093480,Chow; Bennett,8,0,32,24
1657561534005,MATH 142A,B03,093481,Chow; Bennett,8,0,32,24
1657561534005,MATH 142A,B04,093558,Chow; Bennett,13,0,32,19
1657561534005,MATH 142A,B05,093559,Chow; Bennett,6,0,32,26
1657561540034,MATH 193A,A01,083224,Rotar; Vladimir,8,0,34,26
1657561540034,MATH 193A,A02,083225,Rotar; Vladimir,9,0,34,25
1657561540034,MATH 193A,A03,083781,Rotar; Vladimir,5,0,34,29
1657561540034,MATH 193A,A04,083782,Rotar; Vladimir,10,0,34,24
1657561540034,MATH 193A,A05,093482,Rotar; Vladimir,10,0,34,24
1657561546064,MATH 197,001,091859,McAuley; Julian John,9999,0,9999,0
1657561546064,MATH 197,002,095566,Kedlaya; Kiran S.,9997,0,9999,2
1657561546064,MATH 197,003,095567,Xiao; Ming,9999,0,9999,0
1657561546064,MATH 197,004,095571,Perols; Johan Lars,9998,0,9999,1
1657561553135,COGS 9,A01,083615,Shannon; Kyle Michael,9,0,75,66
1657561559164,COGS 11,A01,083617,Boyle; Mary E. T.,23,0,48,25
1657561565187,COGS 13,A01,083071,Bastos; Amalia Pinkusfeld,11,0,71,60
1657561571210,COGS 14A,A01,092681,Semenuks; Arturs,5,1,100,95
1657561577243,COGS 14B,A01,083073,Cheng; Tzu-Han,6,0,63,57
1657561583265,COGS 17,A01,092677,Semenuks; Arturs,6,0,81,75
1657561589298,COGS 100,A01,083619,Allen; Michael Gordon,17,0,70,53
1657561595321,COGS 101A,A01,083621,Davis; Joshua Daniel,9,0,68,59
1657561601343,COGS 101B,A01,091572,Allen; Michael Gordon,12,0,65,53
1657561607441,COGS 101C,A01,083625,Delgado; Tania,17,0,35,18
1657561613467,COGS 107A,A01,083627,Boyle; Mary E. T.,13,0,60,47
1657561619502,COGS 118A,A01,083075,Gupta; Anjum,21,0,76,55
1657561625526,CSE 3,A50,083646,Miranda; Gregory Joseph,24,0,50,26
1657561631551,CSE 8A,A50,083650,Miranda; Gregory Joseph,17,1,56,39
1657561637573,CSE 11,A01,083080,Cao; Yingjun,6,15,40,34
1657561643598,CSE 12,A01,083652,Krause-Levy; Sophia Louisa,28,1,120,92
1657561649630,CSE 15L,A01,083654,Morris; Justin Loren,9,0,50,41
1657561649630,CSE 15L,A02,083655,Morris; Justin Loren,9,0,50,41
1657561655654,CSE 20,A01,083657,Tran; Khoa Dang,39,0,80,41
1657561661680,CSE 21,A01,095574,Bach; Quang Tran,22,0,48,26
1657561667702,CSE 30,A01,083084,Eldon; John,5,0,80,75
1657561667702,CSE 30,B01,095061,Bhaskar; Nishant,9,0,50,41
1657561673725,CSE 100,A01,083659,Cao; Yingjun,5,4,70,65
1657561679751,CSE 134B,A01,083661,Powell; Thomas Allan,22,0,100,78
1657561685779,CSE 140,A01,083663,Gungor; Onat,15,0,85,70
1657561691801,CSE 140L,A01,083088,Eldon; John,21,0,100,79
1657561697842,CSE 175,A01,083665,Kumar; Rakesh,3,0,25,22
1657561703865,CSE 190,A00,092507,Dubnov; Shlomo,8,0,20,12
1657561709890,ECE 45,A01,083139,Congero; Spencer William,6,0,75,69
1657561715912,ECE 65,A50,083695,Saad; Andrew S,12,0,30,18
1657561715912,ECE 65,A51,095125,Saad; Andrew S,24,0,26,2
1657561721934,ECE 109,A01,091882,Touri; Behrouz,19,0,70,51
1657561727971,ECE 180,A00,083140,Abi Samra; Nicholas Camill,1,0,30,29
1657561727971,ECE 180,B00,083141,Abi Samra; Nicholas Camill,0,0,30,30
1657561734005,MATH 10A,A01,083735,Patchell; Gregory David,2,0,30,28
1657561734005,MATH 10A,A02,083736,Patchell; Gregory David,20,0,30,10
1657561734005,MATH 10A,A03,083737,Patchell; Gregory David,16,0,30,14
1657561740037,MATH 10B,A01,083207,Lim; Seonhee,8,0,34,26
1657561740037,MATH 10B,A02,083208,Lim; Seonhee,9,0,35,26
1657561740037,MATH 10B,A03,093472,Lim; Seonhee,7,0,34,27
1657561740037,MATH 10B,B01,083739,Sinha; Shubham,12,0,30,18
1657561746069,MATH 18,A01,083743,Cinel; Cameron Alexander,7,0,30,23
1657561746069,MATH 18,A02,083744,Cinel; Cameron Alexander,17,0,30,13
1657561746069,MATH 18,A03,083745,Cinel; Cameron Alexander,9,0,30,21
1657561746069,MATH 18,B01,083748,Rideout; David Porter,5,0,37,32
1657561746069,MATH 18,B02,083749,Rideout; David Porter,5,0,36,31
1657561746069,MATH 18,B03,083750,Rideout; David Porter,3,0,37,34
1657561746069,MATH 18,B04,083751,Rideout; David Porter,6,0,36,30
1657561746069,MATH 18,B05,093473,Rideout; David Porter,6,0,36,30
1657561746069,MATH 18,B06,093474,Rideout; David Porter,6,0,36,30
1657561752094,MATH 20A,A01,083754,Zheng; Zequn,14,0,40,26
1657561758123,MATH 20B,A01,083756,Briones; Jor-el Thomas Caparas,4,0,36,32
1657561758123,MATH 20B,A02,083757,Briones; Jor-el Thomas Caparas,1,0,36,35
1657561758123,MATH 20B,A03,093475,Briones; Jor-el Thomas Caparas,2,0,36,34
1657561764147,MATH 20C,A01,083760,Briones; Jor-el Thomas Caparas,1,0,35,34
1657561764147,MATH 20C,A02,083761,Briones; Jor-el Thomas Caparas,8,0,35,27
1657561764147,MATH 20C,A03,093476,Briones; Jor-el Thomas Caparas,0,1,36,36
1657561764147,MATH 20C,B01,083762,Bach; Quang Tran,1,0,30,29
1657561770184,MATH 20D,A01,083765,Tran; Brian Kha,5,0,30,25
1657561770184,MATH 20D,A02,083766,Tran; Brian Kha,5,0,30,25
1657561770184,MATH 20D,A03,083767,Tran; Brian Kha,5,0,30,25
1657561776208,MATH 20E,A01,083771,Ganguly; Soumya,9,0,32,23
1657561776208,MATH 20E,A02,083772,Ganguly; Soumya,6,0,32,26
1657561776208,MATH 20E,B01,083773,Ciotti; Benjamin,20,0,35,15
1657561776208,MATH 20E,B02,083774,Ciotti; Benjamin,17,0,35,18
1657561782246,MATH 103A,A01,083777,Greenfeld; Be'Eri,3,0,36,33
1657561782246,MATH 103A,A02,083778,Greenfeld; Be'Eri,5,0,36,31
1657561782246,MATH 103A,A03,093561,Greenfeld; Be'Eri,5,0,36,31
1657561782246,MATH 103A,B01,083779,Greenfeld; Be'Eri,7,0,36,29
1657561782246,MATH 103A,B02,083780,Greenfeld; Be'Eri,4,0,36,32
1657561782246,MATH 103A,B03,093562,Greenfeld; Be'Eri,3,0,36,33
1657561788270,MATH 105,A01,085443,Carter; Anne Toulson,15,0,35,20
1657561788270,MATH 105,A02,093477,Carter; Anne Toulson,20,0,35,15
1657561794293,MATH 109,A01,083213,Ganzberger; Geoffrey Michael,2,0,34,32
1657561794293,MATH 109,A02,083214,Ganzberger; Geoffrey Michael,4,0,34,30
1657561794293,MATH 109,A03,093478,Ganzberger; Geoffrey Michael,2,0,34,32
1657561794293,MATH 109,B01,083215,Ganzberger; Geoffrey Michael,1,0,32,31
1657561794293,MATH 109,B02,083216,Ganzberger; Geoffrey Michael,2,0,32,30
1657561794293,MATH 109,B03,093479,Ganzberger; Geoffrey Michael,8,0,32,24
1657561800323,MATH 142A,A01,083219,Chow; Bennett,7,0,32,25
1657561800323,MATH 142A,A02,083220,Chow; Bennett,10,0,32,22
1657561800323,MATH 142A,A03,093480,Chow; Bennett,8,0,32,24
1657561800323,MATH 142A,B03,093481,Chow; Bennett,8,0,32,24
1657561800323,MATH 142A,B04,093558,Chow; Bennett,13,0,32,19
1657561800323,MATH 142A,B05,093559,Chow; Bennett,6,0,32,26
1657561806351,MATH 193A,A01,083224,Rotar; Vladimir,8,0,34,26
1657561806351,MATH 193A,A02,083225,Rotar; Vladimir,9,0,34,25
1657561806351,MATH 193A,A03,083781,Rotar; Vladimir,5,0,34,29
1657561806351,MATH 193A,A04,083782,Rotar; Vladimir,10,0,34,24
1657561806351,MATH 193A,A05,093482,Rotar; Vladimir,10,0,34,24
1657561812373,MATH 197,001,091859,McAuley; Julian John,9999,0,9999,0
1657561812373,MATH 197,002,095566,Kedlaya; Kiran S.,9997,0,9999,2
1657561812373,MATH 197,003,095567,Xiao; Ming,9999,0,9999,0
1657561812373,MATH 197,004,095571,Perols; Johan Lars,9998,0,9999,1
1657561819457,COGS 9,A01,083615,Shannon; Kyle Michael,9,0,75,66
1657561825483,COGS 11,A01,083617,Boyle; Mary E. T.,23,0,48,25
1657561831510,COGS 13,A01,083071,Bastos; Amalia Pinkusfeld,11,0,71,60
1657561837533,COGS 14A,A01,092681,Semenuks; Arturs,5,1,100,95
1657561843566,COGS 14B,A01,083073,Cheng; Tzu-Han,6,0,63,57
1657561849602,COGS 17,A01,092677,Semenuks; Arturs,6,0,81,75
1657561855628,COGS 100,A01,083619,Allen; Michael Gordon,17,0,70,53
1657561861664,COGS 101A,A01,083621,Davis; Joshua Daniel,9,0,68,59
1657561867686,COGS 101B,A01,091572,Allen; Michael Gordon,12,0,65,53
1657561873735,COGS 101C,A01,083625,Delgado; Tania,17,0,35,18
1657561879765,COGS 107A,A01,083627,Boyle; Mary E. T.,13,0,60,47
1657561885802,COGS 118A,A01,083075,Gupta; Anjum,21,0,76,55
1657561891840,CSE 3,A50,083646,Miranda; Gregory Joseph,24,0,50,26
1657561897862,CSE 8A,A50,083650,Miranda; Gregory Joseph,17,1,56,39
1657561903935,CSE 11,A01,083080,Cao; Yingjun,6,15,40,34
1657561909961,CSE 12,A01,083652,Krause-Levy; Sophia Louisa,28,1,120,92
1657561915990,CSE 15L,A01,083654,Morris; Justin Loren,9,0,50,41
1657561915990,CSE 15L,A02,083655,Morris; Justin Loren,9,0,50,41
1657561922015,CSE 20,A01,083657,Tran; Khoa Dang,39,0,80,41
1657561928048,CSE 21,A01,095574,Bach; Quang Tran,22,0,48,26
1657561934086,CSE 30,A01,083084,Eldon; John,5,0,80,75
1657561934086,CSE 30,B01,095061,Bhaskar; Nishant,9,0,50,41
1657561940128,CSE 100,A01,083659,Cao; Yingjun,5,4,70,65
1657561946158,CSE 134B,A01,083661,Powell; Thomas Allan,22,0,100,78
1657561952187,CSE 140,A01,083663,Gungor; Onat,15,0,85,70
1657561958210,CSE 140L,A01,083088,Eldon; John,21,0,100,79
1657561964233,CSE 175,A01,083665,Kumar; Rakesh,3,0,25,22
1657561970259,CSE 190,A00,092507,Dubnov; Shlomo,8,0,20,12
1657561976281,ECE 45,A01,083139,Congero; Spencer William,6,0,75,69
1657561982324,ECE 65,A50,083695,Saad; Andrew S,12,0,30,18
1657561982324,ECE 65,A51,095125,Saad; Andrew S,24,0,26,2
1657561988361,ECE 109,A01,091882,Touri; Behrouz,19,0,70,51
1657561994400,ECE 180,A00,083140,Abi Samra; Nicholas Camill,1,0,30,29
1657561994400,ECE 180,B00,083141,Abi Samra; Nicholas Camill,0,0,30,30
1657562000425,MATH 10A,A01,083735,Patchell; Gregory David,2,0,30,28
1657562000425,MATH 10A,A02,083736,Patchell; Gregory David,20,0,30,10
1657562000425,MATH 10A,A03,083737,Patchell; Gregory David,16,0,30,14
1657562006447,MATH 10B,A01,083207,Lim; Seonhee,8,0,34,26
1657562006447,MATH 10B,A02,083208,Lim; Seonhee,9,0,35,26
1657562006447,MATH 10B,A03,093472,Lim; Seonhee,7,0,34,27
1657562006447,MATH 10B,B01,083739,Sinha; Shubham,12,0,30,18
1657562012476,MATH 18,A01,083743,Cinel; Cameron Alexander,7,0,30,23
1657562012476,MATH 18,A02,083744,Cinel; Cameron Alexander,17,0,30,13
1657562012476,MATH 18,A03,083745,Cinel; Cameron Alexander,9,0,30,21
1657562012476,MATH 18,B01,083748,Rideout; David Porter,5,0,37,32
1657562012476,MATH 18,B02,083749,Rideout; David Porter,5,0,36,31
1657562012476,MATH 18,B03,083750,Rideout; David Porter,3,0,37,34
1657562012476,MATH 18,B04,083751,Rideout; David Porter,6,0,36,30
1657562012476,MATH 18,B05,093473,Rideout; David Porter,6,0,36,30
1657562012476,MATH 18,B06,093474,Rideout; David Porter,6,0,36,30
1657562018503,MATH 20A,A01,083754,Zheng; Zequn,14,0,40,26
1657562024526,MATH 20B,A01,083756,Briones; Jor-el Thomas Caparas,4,0,36,32
1657562024526,MATH 20B,A02,083757,Briones; Jor-el Thomas Caparas,1,0,36,35
1657562024526,MATH 20B,A03,093475,Briones; Jor-el Thomas Caparas,2,0,36,34
1657562030554,MATH 20C,A01,083760,Briones; Jor-el Thomas Caparas,1,0,35,34
1657562030554,MATH 20C,A02,083761,Briones; Jor-el Thomas Caparas,8,0,35,27
1657562030554,MATH 20C,A03,093476,Briones; Jor-el Thomas Caparas,0,1,36,36
1657562030554,MATH 20C,B01,083762,Bach; Quang Tran,1,0,30,29
1657562036582,MATH 20D,A01,083765,Tran; Brian Kha,5,0,30,25
1657562036582,MATH 20D,A02,083766,Tran; Brian Kha,5,0,30,25
1657562036582,MATH 20D,A03,083767,Tran; Brian Kha,5,0,30,25
1657562042621,MATH 20E,A01,083771,Ganguly; Soumya,9,0,32,23
1657562042621,MATH 20E,A02,083772,Ganguly; Soumya,6,0,32,26
1657562042621,MATH 20E,B01,083773,Ciotti; Benjamin,20,0,35,15
1657562042621,MATH 20E,B02,083774,Ciotti; Benjamin,17,0,35,18
1657562048654,MATH 103A,A01,083777,Greenfeld; Be'Eri,3,0,36,33
1657562048654,MATH 103A,A02,083778,Greenfeld; Be'Eri,5,0,36,31
1657562048654,MATH 103A,A03,093561,Greenfeld; Be'Eri,5,0,36,31
1657562048654,MATH 103A,B01,083779,Greenfeld; Be'Eri,7,0,36,29
1657562048654,MATH 103A,B02,083780,Greenfeld; Be'Eri,4,0,36,32
1657562048654,MATH 103A,B03,093562,Greenfeld; Be'Eri,3,0,36,33
1657562054689,MATH 105,A01,085443,Carter; Anne Toulson,15,0,35,20
1657562054689,MATH 105,A02,093477,Carter; Anne Toulson,20,0,35,15
1657562060723,MATH 109,A01,083213,Ganzberger; Geoffrey Michael,2,0,34,32
1657562060723,MATH 109,A02,083214,Ganzberger; Geoffrey Michael,4,0,34,30
1657562060723,MATH 109,A03,093478,Ganzberger; Geoffrey Michael,2,0,34,32
1657562060723,MATH 109,B01,083215,Ganzberger; Geoffrey Michael,1,0,32,31
1657562060723,MATH 109,B02,083216,Ganzberger; Geoffrey Michael,2,0,32,30
1657562060723,MATH 109,B03,093479,Ganzberger; Geoffrey Michael,8,0,32,24
1657562066747,MATH 142A,A01,083219,Chow; Bennett,7,0,32,25
1657562066747,MATH 142A,A02,083220,Chow; Bennett,10,0,32,22
1657562066747,MATH 142A,A03,093480,Chow; Bennett,8,0,32,24
1657562066747,MATH 142A,B03,093481,Chow; Bennett,8,0,32,24
1657562066747,MATH 142A,B04,093558,Chow; Bennett,13,0,32,19
1657562066747,MATH 142A,B05,093559,Chow; Bennett,6,0,32,26
1657562072769,MATH 193A,A01,083224,Rotar; Vladimir,8,0,34,26
1657562072769,MATH 193A,A02,083225,Rotar; Vladimir,9,0,34,25
1657562072769,MATH 193A,A03,083781,Rotar; Vladimir,5,0,34,29
1657562072769,MATH 193A,A04,083782,Rotar; Vladimir,10,0,34,24
1657562072769,MATH 193A,A05,093482,Rotar; Vladimir,10,0,34,24
1657562078796,MATH 197,001,091859,McAuley; Julian John,9999,0,9999,0
1657562078796,MATH 197,002,095566,Kedlaya; Kiran S.,9997,0,9999,2
1657562078796,MATH 197,003,095567,Xiao; Ming,9999,0,9999,0
1657562078796,MATH 197,004,095571,Perols; Johan Lars,9998,0,9999,1
1657562085877,COGS 9,A01,083615,Shannon; Kyle Michael,9,0,75,66
1657562091899,COGS 11,A01,083617,Boyle; Mary E. T.,23,0,48,25
1657562097936,COGS 13,A01,083071,Bastos; Amalia Pinkusfeld,11,0,71,60
1657562103964,COGS 14A,A01,092681,Semenuks; Arturs,5,1,100,95
1657562109987,COGS 14B,A01,083073,Cheng; Tzu-Han,6,0,63,57
1657562116013,COGS 17,A01,092677,Semenuks; Arturs,6,0,81,75
1657562122038,COGS 100,A01,083619,Allen; Michael Gordon,17,0,70,53
1657562128061,COGS 101A,A01,083621,Davis; Joshua Daniel,9,0,68,59
1657562134091,COGS 101B,A01,091572,Allen; Michael Gordon,12,0,65,53
1657562140115,COGS 101C,A01,083625,Delgado; Tania,17,0,35,18
1657562146158,COGS 107A,A01,083627,Boyle; Mary E. T.,13,0,60,47
1657562152182,COGS 118A,A01,083075,Gupta; Anjum,21,0,76,55
1657562158208,CSE 3,A50,083646,Miranda; Gregory Joseph,24,0,50,26
1657562164254,CSE 8A,A50,083650,Miranda; Gregory Joseph,17,1,56,39
1657562170293,CSE 11,A01,083080,Cao; Yingjun,6,15,40,34
1657562176319,CSE 12,A01,083652,Krause-Levy; Sophia Louisa,28,1,120,92
1657562182344,CSE 15L,A01,083654,Morris; Justin Loren,9,0,50,41
1657562182344,CSE 15L,A02,083655,Morris; Justin Loren,9,0,50,41
1657562188376,CSE 20,A01,083657,Tran; Khoa Dang,39,0,80,41
1657562194399,CSE 21,A01,095574,Bach; Quang Tran,22,0,48,26
1657562200432,CSE 30,A01,083084,Eldon; John,5,0,80,75
1657562200432,CSE 30,B01,095061,Bhaskar; Nishant,9,0,50,41
1657562206564,CSE 100,A01,083659,Cao; Yingjun,5,4,70,65
1657562212586,CSE 134B,A01,083661,Powell; Thomas Allan,22,0,100,78
1657562218609,CSE 140,A01,083663,Gungor; Onat,15,0,85,70
1657562224634,CSE 140L,A01,083088,Eldon; John,21,0,100,79
1657562230659,CSE 175,A01,083665,Kumar; Rakesh,3,0,25,22
1657562236681,CSE 190,A00,092507,Dubnov; Shlomo,8,0,20,12
1657562242712,ECE 45,A01,083139,Congero; Spencer William,6,0,75,69
1657562248745,ECE 65,A50,083695,Saad; Andrew S,12,0,30,18
1657562248745,ECE 65,A51,095125,Saad; Andrew S,24,0,26,2
1657562254767,ECE 109,A01,091882,Touri; Behrouz,19,0,70,51
1657562260789,ECE 180,A00,083140,Abi Samra; Nicholas Camill,1,0,30,29
1657562260789,ECE 180,B00,083141,Abi Samra; Nicholas Camill,0,0,30,30
1657562266816,MATH 10A,A01,083735,Patchell; Gregory David,2,0,30,28
1657562266816,MATH 10A,A02,083736,Patchell; Gregory David,20,0,30,10
1657562266816,MATH 10A,A03,083737,Patchell; Gregory David,16,0,30,14
1657562272839,MATH 10B,A01,083207,Lim; Seonhee,8,0,34,26
1657562272839,MATH 10B,A02,083208,Lim; Seonhee,9,0,35,26
1657562272839,MATH 10B,A03,093472,Lim; Seonhee,7,0,34,27
1657562272839,MATH 10B,B01,083739,Sinha; Shubham,12,0,30,18
1657562278862,MATH 18,A01,083743,Cinel; Cameron Alexander,7,0,30,23
1657562278862,MATH 18,A02,083744,Cinel; Cameron Alexander,17,0,30,13
1657562278862,MATH 18,A03,083745,Cinel; Cameron Alexander,9,0,30,21
1657562278862,MATH 18,B01,083748,Rideout; David Porter,5,0,37,32
1657562278862,MATH 18,B02,083749,Rideout; David Porter,5,0,36,31
1657562278862,MATH 18,B03,083750,Rideout; David Porter,3,0,37,34
1657562278862,MATH 18,B04,083751,Rideout; David Porter,6,0,36,30
1657562278862,MATH 18,B05,093473,Rideout; David Porter,6,0,36,30
1657562278862,MATH 18,B06,093474,Rideout; David Porter,6,0,36,30
1657562284887,MATH 20A,A01,083754,Zheng; Zequn,14,0,40,26
1657562290911,MATH 20B,A01,083756,Briones; Jor-el Thomas Caparas,4,0,36,32
1657562290911,MATH 20B,A02,083757,Briones; Jor-el Thomas Caparas,1,0,36,35
1657562290911,MATH 20B,A03,093475,Briones; Jor-el Thomas Caparas,2,0,36,34
1657562296933,MATH 20C,A01,083760,Briones; Jor-el Thomas Caparas,1,0,35,34
1657562296933,MATH 20C,A02,083761,Briones; Jor-el Thomas Caparas,8,0,35,27
1657562296933,MATH 20C,A03,093476,Briones; Jor-el Thomas Caparas,0,1,36,36
1657562296933,MATH 20C,B01,083762,Bach; Quang Tran,1,0,30,29
1657562302976,MATH 20D,A01,083765,Tran; Brian Kha,5,0,30,25
1657562302976,MATH 20D,A02,083766,Tran; Brian Kha,5,0,30,25
1657562302976,MATH 20D,A03,083767,Tran; Brian Kha,5,0,30,25
1657562309004,MATH 20E,A01,083771,Ganguly; Soumya,9,0,32,23
1657562309004,MATH 20E,A02,083772,Ganguly; Soumya,6,0,32,26
1657562309004,MATH 20E,B01,083773,Ciotti; Benjamin,20,0,35,15
1657562309004,MATH 20E,B02,083774,Ciotti; Benjamin,17,0,35,18
1657562315042,MATH 103A,A01,083777,Greenfeld; Be'Eri,3,0,36,33
1657562315042,MATH 103A,A02,083778,Greenfeld; Be'Eri,5,0,36,31
1657562315042,MATH 103A,A03,093561,Greenfeld; Be'Eri,5,0,36,31
1657562315042,MATH 103A,B01,083779,Greenfeld; Be'Eri,7,0,36,29
1657562315042,MATH 103A,B02,083780,Greenfeld; Be'Eri,4,0,36,32
1657562315042,MATH 103A,B03,093562,Greenfeld; Be'Eri,3,0,36,33
1657562321079,MATH 105,A01,085443,Carter; Anne Toulson,15,0,35,20
1657562321079,MATH 105,A02,093477,Carter; Anne Toulson,20,0,35,15
1657562327107,MATH 109,A01,083213,Ganzberger; Geoffrey Michael,2,0,34,32
1657562327107,MATH 109,A02,083214,Ganzberger; Geoffrey Michael,4,0,34,30
1657562327107,MATH 109,A03,093478,Ganzberger; Geoffrey Michael,2,0,34,32
1657562327107,MATH 109,B01,083215,Ganzberger; Geoffrey Michael,1,0,32,31
1657562327107,MATH 109,B02,083216,Ganzberger; Geoffrey Michael,2,0,32,30
1657562327107,MATH 109,B03,093479,Ganzberger; Geoffrey Michael,8,0,32,24
1657562333130,MATH 142A,A01,083219,Chow; Bennett,7,0,32,25
1657562333130,MATH 142A,A02,083220,Chow; Bennett,10,0,32,22
1657562333130,MATH 142A,A03,093480,Chow; Bennett,8,0,32,24
1657562333130,MATH 142A,B03,093481,Chow; Bennett,8,0,32,24
1657562333130,MATH 142A,B04,093558,Chow; Bennett,13,0,32,19
1657562333130,MATH 142A,B05,093559,Chow; Bennett,6,0,32,26
1657562339160,MATH 193A,A01,083224,Rotar; Vladimir,8,0,34,26
1657562339160,MATH 193A,A02,083225,Rotar; Vladimir,9,0,34,25
1657562339160,MATH 193A,A03,083781,Rotar; Vladimir,5,0,34,29
1657562339160,MATH 193A,A04,083782,Rotar; Vladimir,10,0,34,24
1657562339160,MATH 193A,A05,093482,Rotar; Vladimir,10,0,34,24
1657562345188,MATH 197,001,091859,McAuley; Julian John,9999,0,9999,0
1657562345188,MATH 197,002,095566,Kedlaya; Kiran S.,9997,0,9999,2
1657562345188,MATH 197,003,095567,Xiao; Ming,9999,0,9999,0
1657562345188,MATH 197,004,095571,Perols; Johan Lars,9998,0,9999,1
1657562352256,COGS 9,A01,083615,Shannon; Kyle Michael,9,0,75,66
1657562358293,COGS 11,A01,083617,Boyle; Mary E. T.,23,0,48,25
1657562364319,COGS 13,A01,083071,Bastos; Amalia Pinkusfeld,11,0,71,60
1657562370344,COGS 14A,A01,092681,Semenuks; Arturs,5,1,100,95
1657562376366,COGS 14B,A01,083073,Cheng; Tzu-Han,6,0,63,57
1657562382387,COGS 17,A01,092677,Semenuks; Arturs,6,0,81,75
1657562388425,COGS 100,A01,083619,Allen; Michael Gordon,17,0,70,53
1657562394447,COGS 101A,A01,083621,Davis; Joshua Daniel,9,0,68,59
1657562400476,COGS 101B,A01,091572,Allen; Michael Gordon,12,0,65,53
1657562406505,COGS 101C,A01,083625,Delgado; Tania,17,0,35,18
1657562412527,COGS 107A,A01,083627,Boyle; Mary E. T.,13,0,60,47
1657562418566,COGS 118A,A01,083075,Gupta; Anjum,21,0,76,55
1657562424588,CSE 3,A50,083646,Miranda; Gregory Joseph,24,0,50,26
1657562430612,CSE 8A,A50,083650,Miranda; Gregory Joseph,17,1,56,39
1657562436634,CSE 11,A01,083080,Cao; Yingjun,6,15,40,34
1657562442656,CSE 12,A01,083652,Krause-Levy; Sophia Louisa,28,1,120,92
1657562448683,CSE 15L,A01,083654,Morris; Justin Loren,9,0,50,41
1657562448683,CSE 15L,A02,083655,Morris; Justin Loren,9,0,50,41
1657562454716,CSE 20,A01,083657,Tran; Khoa Dang,39,0,80,41
1657562460739,CSE 21,A01,095574,Bach; Quang Tran,22,0,48,26
1657562466779,CSE 30,A01,083084,Eldon; John,5,0,80,75
1657562466779,CSE 30,B01,095061,Bhaskar; Nishant,9,0,50,41
1657562472802,CSE 100,A01,083659,Cao; Yingjun,5,4,70,65
1657562478833,CSE 134B,A01,083661,Powell; Thomas Allan,22,0,100,78
1657562484855,CSE 140,A01,083663,Gungor; Onat,15,0,85,70
1657562490886,CSE 140L,A01,083088,Eldon; John,21,0,100,79
1657562496908,CSE 175,A01,083665,Kumar; Rakesh,3,0,25,22
1657562502930,CSE 190,A00,092507,Dubnov; Shlomo,8,0,20,12
1657562508959,ECE 45,A01,083139,Congero; Spencer William,6,0,75,69
1657562514987,ECE 65,A50,083695,Saad; Andrew S,12,0,30,18
1657562514987,ECE 65,A51,095125,Saad; Andrew S,24,0,26,2
1657562521010,ECE 109,A01,091882,Touri; Behrouz,19,0,70,51
1657562527039,ECE 180,A00,083140,Abi Samra; Nicholas Camill,1,0,30,29
1657562527039,ECE 180,B00,083141,Abi Samra; Nicholas Camill,0,0,30,30
1657562533062,MATH 10A,A01,083735,Patchell; Gregory David,2,0,30,28
1657562533062,MATH 10A,A02,083736,Patchell; Gregory David,20,0,30,10
1657562533062,MATH 10A,A03,083737,Patchell; Gregory David,16,0,30,14
1657562539086,MATH 10B,A01,083207,Lim; Seonhee,8,0,34,26
1657562539086,MATH 10B,A02,083208,Lim; Seonhee,9,0,35,26
1657562539086,MATH 10B,A03,093472,Lim; Seonhee,7,0,34,27
1657562539086,MATH 10B,B01,083739,Sinha; Shubham,12,0,30,18
1657562545120,MATH 18,A01,083743,Cinel; Cameron Alexander,7,0,30,23
1657562545120,MATH 18,A02,083744,Cinel; Cameron Alexander,17,0,30,13
1657562545120,MATH 18,A03,083745,Cinel; Cameron Alexander,9,0,30,21
1657562545120,MATH 18,B01,083748,Rideout; David Porter,5,0,37,32
1657562545120,MATH 18,B02,083749,Rideout; David Porter,5,0,36,31
1657562545120,MATH 18,B03,083750,Rideout; David Porter,3,0,37,34
1657562545120,MATH 18,B04,083751,Rideout; David Porter,6,0,36,30
1657562545120,MATH 18,B05,093473,Rideout; David Porter,6,0,36,30
1657562545120,MATH 18,B06,093474,Rideout; David Porter,6,0,36,30
1657562551143,MATH 20A,A01,083754,Zheng; Zequn,14,0,40,26
1657562557175,MATH 20B,A01,083756,Briones; Jor-el Thomas Caparas,4,0,36,32
1657562557175,MATH 20B,A02,083757,Briones; Jor-el Thomas Caparas,1,0,36,35
1657562557175,MATH 20B,A03,093475,Briones; Jor-el Thomas Caparas,2,0,36,34
1657562563209,MATH 20C,A01,083760,Briones; Jor-el Thomas Caparas,1,0,35,34
1657562563209,MATH 20C,A02,083761,Briones; Jor-el Thomas Caparas,8,0,35,27
1657562563209,MATH 20C,A03,093476,Briones; Jor-el Thomas Caparas,0,1,36,36
1657562563209,MATH 20C,B01,083762,Bach; Quang Tran,1,0,30,29
1657562569233,MATH 20D,A01,083765,Tran; Brian Kha,5,0,30,25
1657562569233,MATH 20D,A02,083766,Tran; Brian Kha,5,0,30,25
1657562569233,MATH 20D,A03,083767,Tran; Brian Kha,5,0,30,25
1657562575265,MATH 20E,A01,083771,Ganguly; Soumya,9,0,32,23
1657562575265,MATH 20E,A02,083772,Ganguly; Soumya,6,0,32,26
1657562575265,MATH 20E,B01,083773,Ciotti; Benjamin,20,0,35,15
1657562575265,MATH 20E,B02,083774,Ciotti; Benjamin,17,0,35,18
1657562581300,MATH 103A,A01,083777,Greenfeld; Be'Eri,3,0,36,33
1657562581300,MATH 103A,A02,083778,Greenfeld; Be'Eri,5,0,36,31
1657562581300,MATH 103A,A03,093561,Greenfeld; Be'Eri,5,0,36,31
1657562581300,MATH 103A,B01,083779,Greenfeld; Be'Eri,7,0,36,29
1657562581300,MATH 103A,B02,083780,Greenfeld; Be'Eri,4,0,36,32
1657562581300,MATH 103A,B03,093562,Greenfeld; Be'Eri,3,0,36,33
1657562587330,MATH 105,A01,085443,Carter; Anne Toulson,15,0,35,20
1657562587330,MATH 105,A02,093477,Carter; Anne Toulson,20,0,35,15
1657562593365,MATH 109,A01,083213,Ganzberger; Geoffrey Michael,2,0,34,32
1657562593365,MATH 109,A02,083214,Ganzberger; Geoffrey Michael,4,0,34,30
1657562593365,MATH 109,A03,093478,Ganzberger; Geoffrey Michael,2,0,34,32
1657562593365,MATH 109,B01,083215,Ganzberger; Geoffrey Michael,1,0,32,31
1657562593365,MATH 109,B02,083216,Ganzberger; Geoffrey Michael,2,0,32,30
1657562593365,MATH 109,B03,093479,Ganzberger; Geoffrey Michael,8,0,32,24
1657562599393,MATH 142A,A01,083219,Chow; Bennett,7,0,32,25
1657562599393,MATH 142A,A02,083220,Chow; Bennett,10,0,32,22
1657562599393,MATH 142A,A03,093480,Chow; Bennett,8,0,32,24
1657562599393,MATH 142A,B03,093481,Chow; Bennett,8,0,32,24
1657562599393,MATH 142A,B04,093558,Chow; Bennett,13,0,32,19
1657562599393,MATH 142A,B05,093559,Chow; Bennett,6,0,32,26
1657562605422,MATH 193A,A01,083224,Rotar; Vladimir,8,0,34,26
1657562605422,MATH 193A,A02,083225,Rotar; Vladimir,9,0,34,25
1657562605422,MATH 193A,A03,083781,Rotar; Vladimir,5,0,34,29
1657562605422,MATH 193A,A04,083782,Rotar; Vladimir,10,0,34,24
1657562605422,MATH 193A,A05,093482,Rotar; Vladimir,10,0,34,24
1657562611448,MATH 197,001,091859,McAuley; Julian John,9999,0,9999,0
1657562611448,MATH 197,002,095566,Kedlaya; Kiran S.,9997,0,9999,2
1657562611448,MATH 197,003,095567,Xiao; Ming,9999,0,9999,0
1657562611448,MATH 197,004,095571,Perols; Johan Lars,9998,0,9999,1
1657562618498,COGS 9,A01,083615,Shannon; Kyle Michael,9,0,75,66
1657562624531,COGS 11,A01,083617,Boyle; Mary E. T.,23,0,48,25
1657562630557,COGS 13,A01,083071,Bastos; Amalia Pinkusfeld,11,0,71,60
1657562636584,COGS 14A,A01,092681,Semenuks; Arturs,5,1,100,95
1657562642641,COGS 14B,A01,083073,Cheng; Tzu-Han,6,0,63,57
1657562648662,COGS 17,A01,092677,Semenuks; Arturs,6,0,81,75
1657562654693,COGS 100,A01,083619,Allen; Michael Gordon,17,0,70,53
1657562660718,COGS 101A,A01,083621,Davis; Joshua Daniel,9,0,68,59
1657562666746,COGS 101B,A01,091572,Allen; Michael Gordon,12,0,65,53
1657562672776,COGS 101C,A01,083625,Delgado; Tania,17,0,35,18
1657562678799,COGS 107A,A01,083627,Boyle; Mary E. T.,13,0,60,47
1657562684822,COGS 118A,A01,083075,Gupta; Anjum,21,0,76,55
1657562690853,CSE 3,A50,083646,Miranda; Gregory Joseph,24,0,50,26
1657562696877,CSE 8A,A50,083650,Miranda; Gregory Joseph,17,1,56,39
1657562702901,CSE 11,A01,083080,Cao; Yingjun,6,15,40,34
1657562708927,CSE 12,A01,083652,Krause-Levy; Sophia Louisa,28,1,120,92
1657562714960,CSE 15L,A01,083654,Morris; Justin Loren,9,0,50,41
1657562714960,CSE 15L,A02,083655,Morris; Justin Loren,9,0,50,41
1657562720992,CSE 20,A01,083657,Tran; Khoa Dang,39,0,80,41
1657562727014,CSE 21,A01,095574,Bach; Quang Tran,22,0,48,26
1657562733041,CSE 30,A01,083084,Eldon; John,5,0,80,75
1657562733041,CSE 30,B01,095061,Bhaskar; Nishant,9,0,50,41
1657562739063,CSE 100,A01,083659,Cao; Yingjun,5,4,70,65
1657562745087,CSE 134B,A01,083661,Powell; Thomas Allan,22,0,100,78
1657562751116,CSE 140,A01,083663,Gungor; Onat,15,0,85,70
1657562757146,CSE 140L,A01,083088,Eldon; John,21,0,100,79
1657562763168,CSE 175,A01,083665,Kumar; Rakesh,3,0,25,22
1657562769210,CSE 190,A00,092507,Dubnov; Shlomo,8,0,20,12
1657562775244,ECE 45,A01,083139,Congero; Spencer William,6,0,75,69
1657562781274,ECE 65,A50,083695,Saad; Andrew S,12,0,30,18
1657562781274,ECE 65,A51,095125,Saad; Andrew S,24,0,26,2
1657562787312,ECE 109,A01,091882,Touri; Behrouz,19,0,70,51
1657562793359,ECE 180,A00,083140,Abi Samra; Nicholas Camill,1,0,30,29
1657562793359,ECE 180,B00,083141,Abi Samra; Nicholas Camill,0,0,30,30
1657562799404,MATH 10A,A01,083735,Patchell; Gregory David,2,0,30,28
1657562799404,MATH 10A,A02,083736,Patchell; Gregory David,20,0,30,10
1657562799404,MATH 10A,A03,083737,Patchell; Gregory David,16,0,30,14
1657562805501,MATH 10B,A01,083207,Lim; Seonhee,8,0,34,26
1657562805501,MATH 10B,A02,083208,Lim; Seonhee,9,0,35,26
1657562805501,MATH 10B,A03,093472,Lim; Seonhee,7,0,34,27
1657562805501,MATH 10B,B01,083739,Sinha; Shubham,12,0,30,18
1657562811535,MATH 18,A01,083743,Cinel; Cameron Alexander,7,0,30,23
1657562811535,MATH 18,A02,083744,Cinel; Cameron Alexander,17,0,30,13
1657562811535,MATH 18,A03,083745,Cinel; Cameron Alexander,9,0,30,21
1657562811535,MATH 18,B01,083748,Rideout; David Porter,5,0,37,32
1657562811535,MATH 18,B02,083749,Rideout; David Porter,5,0,36,31
1657562811535,MATH 18,B03,083750,Rideout; David Porter,3,0,37,34
1657562811535,MATH 18,B04,083751,Rideout; David Porter,6,0,36,30
1657562811535,MATH 18,B05,093473,Rideout; David Porter,6,0,36,30
1657562811535,MATH 18,B06,093474,Rideout; David Porter,6,0,36,30
1657562817556,MATH 20A,A01,083754,Zheng; Zequn,14,0,40,26
1657562823625,MATH 20B,A01,083756,Briones; Jor-el Thomas Caparas,4,0,36,32
1657562823625,MATH 20B,A02,083757,Briones; Jor-el Thomas Caparas,1,0,36,35
1657562823625,MATH 20B,A03,093475,Briones; Jor-el Thomas Caparas,2,0,36,34
1657562829654,MATH 20C,A01,083760,Briones; Jor-el Thomas Caparas,1,0,35,34
1657562829654,MATH 20C,A02,083761,Briones; Jor-el Thomas Caparas,8,0,35,27
1657562829654,MATH 20C,A03,093476,Briones; Jor-el Thomas Caparas,0,1,36,36
1657562829654,MATH 20C,B01,083762,Bach; Quang Tran,1,0,30,29
1657562835692,MATH 20D,A01,083765,Tran; Brian Kha,5,0,30,25
1657562835692,MATH 20D,A02,083766,Tran; Brian Kha,5,0,30,25
1657562835692,MATH 20D,A03,083767,Tran; Brian Kha,5,0,30,25
1657562841715,MATH 20E,A01,083771,Ganguly; Soumya,9,0,32,23
1657562841715,MATH 20E,A02,083772,Ganguly; Soumya,6,0,32,26
1657562841715,MATH 20E,B01,083773,Ciotti; Benjamin,20,0,35,15
1657562841715,MATH 20E,B02,083774,Ciotti; Benjamin,17,0,35,18
1657562847745,MATH 103A,A01,083777,Greenfeld; Be'Eri,3,0,36,33
1657562847745,MATH 103A,A02,083778,Greenfeld; Be'Eri,5,0,36,31
1657562847745,MATH 103A,A03,093561,Greenfeld; Be'Eri,5,0,36,31
1657562847745,MATH 103A,B01,083779,Greenfeld; Be'Eri,7,0,36,29
1657562847745,MATH 103A,B02,083780,Greenfeld; Be'Eri,4,0,36,32
1657562847745,MATH 103A,B03,093562,Greenfeld; Be'Eri,3,0,36,33
1657562853768,MATH 105,A01,085443,Carter; Anne Toulson,15,0,35,20
1657562853768,MATH 105,A02,093477,Carter; Anne Toulson,20,0,35,15
1657562859796,MATH 109,A01,083213,Ganzberger; Geoffrey Michael,2,0,34,32
1657562859796,MATH 109,A02,083214,Ganzberger; Geoffrey Michael,4,0,34,30
1657562859796,MATH 109,A03,093478,Ganzberger; Geoffrey Michael,2,0,34,32
1657562859796,MATH 109,B01,083215,Ganzberger; Geoffrey Michael,1,0,32,31
1657562859796,MATH 109,B02,083216,Ganzberger; Geoffrey Michael,2,0,32,30
1657562859796,MATH 109,B03,093479,Ganzberger; Geoffrey Michael,8,0,32,24
1657562865820,MATH 142A,A01,083219,Chow; Bennett,7,0,32,25
1657562865820,MATH 142A,A02,083220,Chow; Bennett,10,0,32,22
1657562865820,MATH 142A,A03,093480,Chow; Bennett,8,0,32,24
1657562865820,MATH 142A,B03,093481,Chow; Bennett,8,0,32,24
1657562865820,MATH 142A,B04,093558,Chow; Bennett,13,0,32,19
1657562865820,MATH 142A,B05,093559,Chow; Bennett,6,0,32,26
1657562871859,MATH 193A,A01,083224,Rotar; Vladimir,8,0,34,26
1657562871859,MATH 193A,A02,083225,Rotar; Vladimir,9,0,34,25
1657562871859,MATH 193A,A03,083781,Rotar; Vladimir,5,0,34,29
1657562871859,MATH 193A,A04,083782,Rotar; Vladimir,10,0,34,24
1657562871859,MATH 193A,A05,093482,Rotar; Vladimir,10,0,34,24
1657562877883,MATH 197,001,091859,McAuley; Julian John,9999,0,9999,0
1657562877883,MATH 197,002,095566,Kedlaya; Kiran S.,9997,0,9999,2
1657562877883,MATH 197,003,095567,Xiao; Ming,9999,0,9999,0
1657562877883,MATH 197,004,095571,Perols; Johan Lars,9998,0,9999,1
1657562884934,COGS 9,A01,083615,Shannon; Kyle Michael,9,0,75,66
1657562890957,COGS 11,A01,083617,Boyle; Mary E. T.,23,0,48,25
1657562896979,COGS 13,A01,083071,Bastos; Amalia Pinkusfeld,11,0,71,60
1657562903005,COGS 14A,A01,092681,Semenuks; Arturs,5,1,100,95
1657562909031,COGS 14B,A01,083073,Cheng; Tzu-Han,6,0,63,57
1657562915052,COGS 17,A01,092677,Semenuks; Arturs,6,0,81,75
1657562921076,COGS 100,A01,083619,Allen; Michael Gordon,17,0,70,53
1657562927106,COGS 101A,A01,083621,Davis; Joshua Daniel,9,0,68,59
1657562933132,COGS 101B,A01,091572,Allen; Michael Gordon,12,0,65,53
1657562939171,COGS 101C,A01,083625,Delgado; Tania,17,0,35,18
1657562945201,COGS 107A,A01,083627,Boyle; Mary E. T.,13,0,60,47
1657562951227,COGS 118A,A01,083075,Gupta; Anjum,21,0,76,55
1657562957249,CSE 3,A50,083646,Miranda; Gregory Joseph,24,0,50,26
1657562963278,CSE 8A,A50,083650,Miranda; Gregory Joseph,17,1,56,39
1657562969316,CSE 11,A01,083080,Cao; Yingjun,6,15,40,34
1657562975339,CSE 12,A01,083652,Krause-Levy; Sophia Louisa,28,1,120,92
1657562981367,CSE 15L,A01,083654,Morris; Justin Loren,9,0,50,41
1657562981367,CSE 15L,A02,083655,Morris; Justin Loren,9,0,50,41
1657562987390,CSE 20,A01,083657,Tran; Khoa Dang,39,0,80,41
1657562993416,CSE 21,A01,095574,Bach; Quang Tran,22,0,48,26
1657562999439,CSE 30,A01,083084,Eldon; John,5,0,80,75
1657562999439,CSE 30,B01,095061,Bhaskar; Nishant,9,0,50,41
1657563005464,CSE 100,A01,083659,Cao; Yingjun,5,4,70,65
1657563011494,CSE 134B,A01,083661,Powell; Thomas Allan,22,0,100,78
1657563017517,CSE 140,A01,083663,Gungor; Onat,15,0,85,70
1657563023546,CSE 140L,A01,083088,Eldon; John,21,0,100,79
1657563029583,CSE 175,A01,083665,Kumar; Rakesh,3,0,25,22
1657563035610,CSE 190,A00,092507,Dubnov; Shlomo,8,0,20,12
1657563041635,ECE 45,A01,083139,Congero; Spencer William,6,0,75,69
1657563047662,ECE 65,A50,083695,Saad; Andrew S,12,0,30,18
1657563047662,ECE 65,A51,095125,Saad; Andrew S,24,0,26,2
1657563053688,ECE 109,A01,091882,Touri; Behrouz,19,0,70,51
1657563059717,ECE 180,A00,083140,Abi Samra; Nicholas Camill,1,0,30,29
1657563059717,ECE 180,B00,083141,Abi Samra; Nicholas Camill,0,0,30,30
1657563065740,MATH 10A,A01,083735,Patchell; Gregory David,2,0,30,28
1657563065740,MATH 10A,A02,083736,Patchell; Gregory David,20,0,30,10
1657563065740,MATH 10A,A03,083737,Patchell; Gregory David,16,0,30,14
1657563071764,MATH 10B,A01,083207,Lim; Seonhee,8,0,34,26
1657563071764,MATH 10B,A02,083208,Lim; Seonhee,9,0,35,26
1657563071764,MATH 10B,A03,093472,Lim; Seonhee,7,0,34,27
1657563071764,MATH 10B,B01,083739,Sinha; Shubham,12,0,30,18
1657563077810,MATH 18,A01,083743,Cinel; Cameron Alexander,7,0,30,23
1657563077810,MATH 18,A02,083744,Cinel; Cameron Alexander,17,0,30,13
1657563077810,MATH 18,A03,083745,Cinel; Cameron Alexander,9,0,30,21
1657563077810,MATH 18,B01,083748,Rideout; David Porter,5,0,37,32
1657563077810,MATH 18,B02,083749,Rideout; David Porter,5,0,36,31
1657563077810,MATH 18,B03,083750,Rideout; David Porter,3,0,37,34
1657563077810,MATH 18,B04,083751,Rideout; David Porter,6,0,36,30
1657563077810,MATH 18,B05,093473,Rideout; David Porter,6,0,36,30
1657563077810,MATH 18,B06,093474,Rideout; David Porter,6,0,36,30
1657563083853,MATH 20A,A01,083754,Zheng; Zequn,14,0,40,26
1657563089891,MATH 20B,A01,083756,Briones; Jor-el Thomas Caparas,4,0,36,32
1657563089891,MATH 20B,A02,083757,Briones; Jor-el Thomas Caparas,1,0,36,35
1657563089891,MATH 20B,A03,093475,Briones; Jor-el Thomas Caparas,2,0,36,34
1657563095915,MATH 20C,A01,083760,Briones; Jor-el Thomas Caparas,1,0,35,34
1657563095915,MATH 20C,A02,083761,Briones; Jor-el Thomas Caparas,8,0,35,27
1657563095915,MATH 20C,A03,093476,Briones; Jor-el Thomas Caparas,0,1,36,36
1657563095915,MATH 20C,B01,083762,Bach; Quang Tran,1,0,30,29
1657563101937,MATH 20D,A01,083765,Tran; Brian Kha,5,0,30,25
1657563101937,MATH 20D,A02,083766,Tran; Brian Kha,5,0,30,25
1657563101937,MATH 20D,A03,083767,Tran; Brian Kha,5,0,30,25
1657563107962,MATH 20E,A01,083771,Ganguly; Soumya,9,0,32,23
1657563107962,MATH 20E,A02,083772,Ganguly; Soumya,6,0,32,26
1657563107962,MATH 20E,B01,083773,Ciotti; Benjamin,20,0,35,15
1657563107962,MATH 20E,B02,083774,Ciotti; Benjamin,17,0,35,18
1657563113991,MATH 103A,A01,083777,Greenfeld; Be'Eri,3,0,36,33
1657563113991,MATH 103A,A02,083778,Greenfeld; Be'Eri,5,0,36,31
1657563113991,MATH 103A,A03,093561,Greenfeld; Be'Eri,5,0,36,31
1657563113991,MATH 103A,B01,083779,Greenfeld; Be'Eri,7,0,36,29
1657563113991,MATH 103A,B02,083780,Greenfeld; Be'Eri,4,0,36,32
1657563113991,MATH 103A,B03,093562,Greenfeld; Be'Eri,3,0,36,33
1657563120018,MATH 105,A01,085443,Carter; Anne Toulson,15,0,35,20
1657563120018,MATH 105,A02,093477,Carter; Anne Toulson,20,0,35,15
1657563126046,MATH 109,A01,083213,Ganzberger; Geoffrey Michael,2,0,34,32
1657563126046,MATH 109,A02,083214,Ganzberger; Geoffrey Michael,4,0,34,30
1657563126046,MATH 109,A03,093478,Ganzberger; Geoffrey Michael,2,0,34,32
1657563126046,MATH 109,B01,083215,Ganzberger; Geoffrey Michael,1,0,32,31
1657563126046,MATH 109,B02,083216,Ganzberger; Geoffrey Michael,2,0,32,30
1657563126046,MATH 109,B03,093479,Ganzberger; Geoffrey Michael,8,0,32,24
1657563132085,MATH 142A,A01,083219,Chow; Bennett,7,0,32,25
1657563132085,MATH 142A,A02,083220,Chow; Bennett,10,0,32,22
1657563132085,MATH 142A,A03,093480,Chow; Bennett,8,0,32,24
1657563132085,MATH 142A,B03,093481,Chow; Bennett,8,0,32,24
1657563132085,MATH 142A,B04,093558,Chow; Bennett,13,0,32,19
1657563132085,MATH 142A,B05,093559,Chow; Bennett,6,0,32,26
1657563138116,MATH 193A,A01,083224,Rotar; Vladimir,8,0,34,26
1657563138116,MATH 193A,A02,083225,Rotar; Vladimir,9,0,34,25
1657563138116,MATH 193A,A03,083781,Rotar; Vladimir,5,0,34,29
1657563138116,MATH 193A,A04,083782,Rotar; Vladimir,10,0,34,24
1657563138116,MATH 193A,A05,093482,Rotar; Vladimir,10,0,34,24
1657563144150,MATH 197,001,091859,McAuley; Julian John,9999,0,9999,0
1657563144150,MATH 197,002,095566,Kedlaya; Kiran S.,9997,0,9999,2
1657563144150,MATH 197,003,095567,Xiao; Ming,9999,0,9999,0
1657563144150,MATH 197,004,095571,Perols; Johan Lars,9998,0,9999,1
1657563151235,COGS 9,A01,083615,Shannon; Kyle Michael,9,0,75,66
1657563157257,COGS 11,A01,083617,Boyle; Mary E. T.,23,0,48,25
1657563163287,COGS 13,A01,083071,Bastos; Amalia Pinkusfeld,11,0,71,60
1657563169318,COGS 14A,A01,092681,Semenuks; Arturs,5,1,100,95
1657563175340,COGS 14B,A01,083073,Cheng; Tzu-Han,6,0,63,57
1657563181373,COGS 17,A01,092677,Semenuks; Arturs,6,0,81,75
1657563187416,COGS 100,A01,083619,Allen; Michael Gordon,17,0,70,53
1657563193438,COGS 101A,A01,083621,Davis; Joshua Daniel,9,0,68,59
1657563199461,COGS 101B,A01,091572,Allen; Michael Gordon,12,0,65,53
1657563205497,COGS 101C,A01,083625,Delgado; Tania,17,0,35,18
1657563211522,COGS 107A,A01,083627,Boyle; Mary E. T.,13,0,60,47
1657563217548,COGS 118A,A01,083075,Gupta; Anjum,21,0,76,55
1657563223571,CSE 3,A50,083646,Miranda; Gregory Joseph,24,0,50,26
1657563229597,CSE 8A,A50,083650,Miranda; Gregory Joseph,17,1,56,39
1657563235623,CSE 11,A01,083080,Cao; Yingjun,6,15,40,34
1657563241644,CSE 12,A01,083652,Krause-Levy; Sophia Louisa,28,1,120,92
1657563254932,CSE 15L,A01,083654,Morris; Justin Loren,9,0,50,41
1657563254932,CSE 15L,A02,083655,Morris; Justin Loren,9,0,50,41
1657563260976,CSE 20,A01,083657,Tran; Khoa Dang,39,0,80,41
1657563267009,CSE 21,A01,095574,Bach; Quang Tran,22,0,48,26
1657563273041,CSE 30,A01,083084,Eldon; John,5,0,80,75
1657563273041,CSE 30,B01,095061,Bhaskar; Nishant,9,0,50,41
1657563279070,CSE 100,A01,083659,Cao; Yingjun,5,4,70,65
1657563285093,CSE 134B,A01,083661,Powell; Thomas Allan,22,0,100,78
1657563291114,CSE 140,A01,083663,Gungor; Onat,15,0,85,70
1657563297142,CSE 140L,A01,083088,Eldon; John,21,0,100,79
1657563303184,CSE 175,A01,083665,Kumar; Rakesh,3,0,25,22
1657563309210,CSE 190,A00,092507,Dubnov; Shlomo,8,0,20,12
1657563315245,ECE 45,A01,083139,Congero; Spencer William,6,0,75,69
1657563321282,ECE 65,A50,083695,Saad; Andrew S,12,0,30,18
1657563321282,ECE 65,A51,095125,Saad; Andrew S,24,0,26,2
1657563327312,ECE 109,A01,091882,Touri; Behrouz,19,0,70,51
1657563333339,ECE 180,A00,083140,Abi Samra; Nicholas Camill,1,0,30,29
1657563333339,ECE 180,B00,083141,Abi Samra; Nicholas Camill,0,0,30,30
1657563339362,MATH 10A,A01,083735,Patchell; Gregory David,2,0,30,28
1657563339362,MATH 10A,A02,083736,Patchell; Gregory David,20,0,30,10
1657563339362,MATH 10A,A03,083737,Patchell; Gregory David,16,0,30,14
1657563345393,MATH 10B,A01,083207,Lim; Seonhee,8,0,34,26
1657563345393,MATH 10B,A02,083208,Lim; Seonhee,9,0,35,26
1657563345393,MATH 10B,A03,093472,Lim; Seonhee,7,0,34,27
1657563345393,MATH 10B,B01,083739,Sinha; Shubham,12,0,30,18
1657563351436,MATH 18,A01,083743,Cinel; Cameron Alexander,7,0,30,23
1657563351436,MATH 18,A02,083744,Cinel; Cameron Alexander,17,0,30,13
1657563351436,MATH 18,A03,083745,Cinel; Cameron Alexander,9,0,30,21
1657563351436,MATH 18,B01,083748,Rideout; David Porter,5,0,37,32
1657563351436,MATH 18,B02,083749,Rideout; David Porter,5,0,36,31
1657563351436,MATH 18,B03,083750,Rideout; David Porter,3,0,37,34
1657563351436,MATH 18,B04,083751,Rideout; David Porter,6,0,36,30
1657563351436,MATH 18,B05,093473,Rideout; David Porter,6,0,36,30
1657563351436,MATH 18,B06,093474,Rideout; David Porter,6,0,36,30
1657563357461,MATH 20A,A01,083754,Zheng; Zequn,14,0,40,26
1657563363498,MATH 20B,A01,083756,Briones; Jor-el Thomas Caparas,4,0,36,32
1657563363498,MATH 20B,A02,083757,Briones; Jor-el Thomas Caparas,1,0,36,35
1657563363498,MATH 20B,A03,093475,Briones; Jor-el Thomas Caparas,2,0,36,34
1657563369535,MATH 20C,A01,083760,Briones; Jor-el Thomas Caparas,1,0,35,34
1657563369535,MATH 20C,A02,083761,Briones; Jor-el Thomas Caparas,8,0,35,27
1657563369535,MATH 20C,A03,093476,Briones; Jor-el Thomas Caparas,0,1,36,36
1657563369535,MATH 20C,B01,083762,Bach; Quang Tran,1,0,30,29
1657563375557,MATH 20D,A01,083765,Tran; Brian Kha,5,0,30,25
1657563375557,MATH 20D,A02,083766,Tran; Brian Kha,5,0,30,25
1657563375557,MATH 20D,A03,083767,Tran; Brian Kha,5,0,30,25
1657563381581,MATH 20E,A01,083771,Ganguly; Soumya,9,0,32,23
1657563381581,MATH 20E,A02,083772,Ganguly; Soumya,6,0,32,26
1657563381581,MATH 20E,B01,083773,Ciotti; Benjamin,20,0,35,15
1657563381581,MATH 20E,B02,083774,Ciotti; Benjamin,17,0,35,18
1657563387628,MATH 103A,A01,083777,Greenfeld; Be'Eri,3,0,36,33
1657563387628,MATH 103A,A02,083778,Greenfeld; Be'Eri,5,0,36,31
1657563387628,MATH 103A,A03,093561,Greenfeld; Be'Eri,5,0,36,31
1657563387628,MATH 103A,B01,083779,Greenfeld; Be'Eri,7,0,36,29
1657563387628,MATH 103A,B02,083780,Greenfeld; Be'Eri,4,0,36,32
1657563387628,MATH 103A,B03,093562,Greenfeld; Be'Eri,3,0,36,33
1657563393657,MATH 105,A01,085443,Carter; Anne Toulson,15,0,35,20
1657563393657,MATH 105,A02,093477,Carter; Anne Toulson,20,0,35,15
1657563399686,MATH 109,A01,083213,Ganzberger; Geoffrey Michael,2,0,34,32
1657563399686,MATH 109,A02,083214,Ganzberger; Geoffrey Michael,4,0,34,30
1657563399686,MATH 109,A03,093478,Ganzberger; Geoffrey Michael,2,0,34,32
1657563399686,MATH 109,B01,083215,Ganzberger; Geoffrey Michael,1,0,32,31
1657563399686,MATH 109,B02,083216,Ganzberger; Geoffrey Michael,2,0,32,30
1657563399686,MATH 109,B03,093479,Ganzberger; Geoffrey Michael,8,0,32,24
1657563405718,MATH 142A,A01,083219,Chow; Bennett,7,0,32,25
1657563405718,MATH 142A,A02,083220,Chow; Bennett,10,0,32,22
1657563405718,MATH 142A,A03,093480,Chow; Bennett,8,0,32,24
1657563405718,MATH 142A,B03,093481,Chow; Bennett,8,0,32,24
1657563405718,MATH 142A,B04,093558,Chow; Bennett,13,0,32,19
1657563405718,MATH 142A,B05,093559,Chow; Bennett,6,0,32,26
1657563411867,MATH 193A,A01,083224,Rotar; Vladimir,8,0,34,26
1657563411867,MATH 193A,A02,083225,Rotar; Vladimir,9,0,34,25
1657563411867,MATH 193A,A03,083781,Rotar; Vladimir,5,0,34,29
1657563411867,MATH 193A,A04,083782,Rotar; Vladimir,10,0,34,24
1657563411867,MATH 193A,A05,093482,Rotar; Vladimir,10,0,34,24
1657563417902,MATH 197,001,091859,McAuley; Julian John,9999,0,9999,0
1657563417902,MATH 197,002,095566,Kedlaya; Kiran S.,9997,0,9999,2
1657563417902,MATH 197,003,095567,Xiao; Ming,9999,0,9999,0
1657563417902,MATH 197,004,095571,Perols; Johan Lars,9998,0,9999,1
1657563424957,COGS 9,A01,083615,Shannon; Kyle Michael,9,0,75,66
1657563430981,COGS 11,A01,083617,Boyle; Mary E. T.,23,0,48,25
1657563437006,COGS 13,A01,083071,Bastos; Amalia Pinkusfeld,11,0,71,60
1657563443032,COGS 14A,A01,092681,Semenuks; Arturs,5,1,100,95
1657563449079,COGS 14B,A01,083073,Cheng; Tzu-Han,6,0,63,57
1657563455107,COGS 17,A01,092677,Semenuks; Arturs,6,0,81,75
1657563461134,COGS 100,A01,083619,Allen; Michael Gordon,17,0,70,53
1657563467166,COGS 101A,A01,083621,Davis; Joshua Daniel,9,0,68,59
1657563473189,COGS 101B,A01,091572,Allen; Michael Gordon,12,0,65,53
1657563479216,COGS 101C,A01,083625,Delgado; Tania,17,0,35,18
1657563485245,COGS 107A,A01,083627,Boyle; Mary E. T.,13,0,60,47
1657563491274,COGS 118A,A01,083075,Gupta; Anjum,21,0,76,55
1657563497316,CSE 3,A50,083646,Miranda; Gregory Joseph,24,0,50,26
1657563503342,CSE 8A,A50,083650,Miranda; Gregory Joseph,17,1,56,39
1657563509384,CSE 11,A01,083080,Cao; Yingjun,6,15,40,34
1657563515408,CSE 12,A01,083652,Krause-Levy; Sophia Louisa,28,1,120,92
1657563521438,CSE 15L,A01,083654,Morris; Justin Loren,9,0,50,41
1657563521438,CSE 15L,A02,083655,Morris; Justin Loren,9,0,50,41
1657563527476,CSE 20,A01,083657,Tran; Khoa Dang,39,0,80,41
1657563533498,CSE 21,A01,095574,Bach; Quang Tran,22,0,48,26
1657563539534,CSE 30,A01,083084,Eldon; John,5,0,80,75
1657563539534,CSE 30,B01,095061,Bhaskar; Nishant,9,0,50,41
1657563545579,CSE 100,A01,083659,Cao; Yingjun,5,4,70,65
1657563551605,CSE 134B,A01,083661,Powell; Thomas Allan,22,0,100,78
1657563557628,CSE 140,A01,083663,Gungor; Onat,15,0,85,70
1657563563659,CSE 140L,A01,083088,Eldon; John,21,0,100,79
1657563569710,CSE 175,A01,083665,Kumar; Rakesh,3,0,25,22
1657563575747,CSE 190,A00,092507,Dubnov; Shlomo,8,0,20,12
1657563581780,ECE 45,A01,083139,Congero; Spencer William,6,0,75,69
1657563587826,ECE 65,A50,083695,Saad; Andrew S,12,0,30,18
1657563587826,ECE 65,A51,095125,Saad; Andrew S,24,0,26,2
1657563593854,ECE 109,A01,091882,Touri; Behrouz,19,0,70,51
1657563599904,ECE 180,A00,083140,Abi Samra; Nicholas Camill,1,0,30,29
1657563599904,ECE 180,B00,083141,Abi Samra; Nicholas Camill,0,0,30,30
1657563605927,MATH 10A,A01,083735,Patchell; Gregory David,2,0,30,28
1657563605927,MATH 10A,A02,083736,Patchell; Gregory David,20,0,30,10
1657563605927,MATH 10A,A03,083737,Patchell; Gregory David,16,0,30,14
1657563611976,MATH 10B,A01,083207,Lim; Seonhee,8,0,34,26
1657563611976,MATH 10B,A02,083208,Lim; Seonhee,9,0,35,26
1657563611976,MATH 10B,A03,093472,Lim; Seonhee,7,0,34,27
1657563611976,MATH 10B,B01,083739,Sinha; Shubham,12,0,30,18
1657563618016,MATH 18,A01,083743,Cinel; Cameron Alexander,7,0,30,23
1657563618016,MATH 18,A02,083744,Cinel; Cameron Alexander,17,0,30,13
1657563618016,MATH 18,A03,083745,Cinel; Cameron Alexander,9,0,30,21
1657563618016,MATH 18,B01,083748,Rideout; David Porter,5,0,37,32
1657563618016,MATH 18,B02,083749,Rideout; David Porter,5,0,36,31
1657563618016,MATH 18,B03,083750,Rideout; David Porter,3,0,37,34
1657563618016,MATH 18,B04,083751,Rideout; David Porter,6,0,36,30
1657563618016,MATH 18,B05,093473,Rideout; David Porter,6,0,36,30
1657563618016,MATH 18,B06,093474,Rideout; David Porter,6,0,36,30
1657563624041,MATH 20A,A01,083754,Zheng; Zequn,14,0,40,26
1657563630064,MATH 20B,A01,083756,Briones; Jor-el Thomas Caparas,4,0,36,32
1657563630064,MATH 20B,A02,083757,Briones; Jor-el Thomas Caparas,1,0,36,35
1657563630064,MATH 20B,A03,093475,Briones; Jor-el Thomas Caparas,2,0,36,34
1657563636100,MATH 20C,A01,083760,Briones; Jor-el Thomas Caparas,1,0,35,34
1657563636100,MATH 20C,A02,083761,Briones; Jor-el Thomas Caparas,8,0,35,27
1657563636100,MATH 20C,A03,093476,Briones; Jor-el Thomas Caparas,0,1,36,36
1657563636100,MATH 20C,B01,083762,Bach; Quang Tran,1,0,30,29
1657563642126,MATH 20D,A01,083765,Tran; Brian Kha,5,0,30,25
1657563642126,MATH 20D,A02,083766,Tran; Brian Kha,5,0,30,25
1657563642126,MATH 20D,A03,083767,Tran; Brian Kha,5,0,30,25
1657563648172,MATH 20E,A01,083771,Ganguly; Soumya,9,0,32,23
1657563648172,MATH 20E,A02,083772,Ganguly; Soumya,6,0,32,26
1657563648172,MATH 20E,B01,083773,Ciotti; Benjamin,20,0,35,15
1657563648172,MATH 20E,B02,083774,Ciotti; Benjamin,17,0,35,18
1657563654202,MATH 103A,A01,083777,Greenfeld; Be'Eri,3,0,36,33
1657563654202,MATH 103A,A02,083778,Greenfeld; Be'Eri,5,0,36,31
1657563654202,MATH 103A,A03,093561,Greenfeld; Be'Eri,5,0,36,31
1657563654202,MATH 103A,B01,083779,Greenfeld; Be'Eri,7,0,36,29
1657563654202,MATH 103A,B02,083780,Greenfeld; Be'Eri,4,0,36,32
1657563654202,MATH 103A,B03,093562,Greenfeld; Be'Eri,3,0,36,33
1657563660225,MATH 105,A01,085443,Carter; Anne Toulson,15,0,35,20
1657563660225,MATH 105,A02,093477,Carter; Anne Toulson,20,0,35,15
1657563666262,MATH 109,A01,083213,Ganzberger; Geoffrey Michael,2,0,34,32
1657563666262,MATH 109,A02,083214,Ganzberger; Geoffrey Michael,4,0,34,30
1657563666262,MATH 109,A03,093478,Ganzberger; Geoffrey Michael,2,0,34,32
1657563666262,MATH 109,B01,083215,Ganzberger; Geoffrey Michael,1,0,32,31
1657563666262,MATH 109,B02,083216,Ganzberger; Geoffrey Michael,2,0,32,30
1657563666262,MATH 109,B03,093479,Ganzberger; Geoffrey Michael,8,0,32,24
1657563672303,MATH 142A,A01,083219,Chow; Bennett,7,0,32,25
1657563672303,MATH 142A,A02,083220,Chow; Bennett,10,0,32,22
1657563672303,MATH 142A,A03,093480,Chow; Bennett,8,0,32,24
1657563672303,MATH 142A,B03,093481,Chow; Bennett,8,0,32,24
1657563672303,MATH 142A,B04,093558,Chow; Bennett,13,0,32,19
1657563672303,MATH 142A,B05,093559,Chow; Bennett,6,0,32,26
1657563678330,MATH 193A,A01,083224,Rotar; Vladimir,8,0,34,26
1657563678330,MATH 193A,A02,083225,Rotar; Vladimir,9,0,34,25
1657563678330,MATH 193A,A03,083781,Rotar; Vladimir,5,0,34,29
1657563678330,MATH 193A,A04,083782,Rotar; Vladimir,10,0,34,24
1657563678330,MATH 193A,A05,093482,Rotar; Vladimir,10,0,34,24
1657563684351,MATH 197,001,091859,McAuley; Julian John,9999,0,9999,0
1657563684351,MATH 197,002,095566,Kedlaya; Kiran S.,9997,0,9999,2
1657563684351,MATH 197,003,095567,Xiao; Ming,9999,0,9999,0
1657563684351,MATH 197,004,095571,Perols; Johan Lars,9998,0,9999,1
1657563691421,COGS 9,A01,083615,Shannon; Kyle Michael,9,0,75,66
1657563697454,COGS 11,A01,083617,Boyle; Mary E. T.,23,0,48,25
1657563703487,COGS 13,A01,083071,Bastos; Amalia Pinkusfeld,11,0,71,60
1657563709527,COGS 14A,A01,092681,Semenuks; Arturs,5,1,100,95
1657563715551,COGS 14B,A01,083073,Cheng; Tzu-Han,6,0,63,57
1657563721581,COGS 17,A01,092677,Semenuks; Arturs,6,0,81,75
1657563727604,COGS 100,A01,083619,Allen; Michael Gordon,17,0,70,53
1657563733636,COGS 101A,A01,083621,Davis; Joshua Daniel,9,0,68,59
1657563739658,COGS 101B,A01,091572,Allen; Michael Gordon,12,0,65,53
1657563745685,COGS 101C,A01,083625,Delgado; Tania,17,0,35,18
1657563751719,COGS 107A,A01,083627,Boyle; Mary E. T.,13,0,60,47
1657563757740,COGS 118A,A01,083075,Gupta; Anjum,21,0,76,55
1657563763762,CSE 3,A50,083646,Miranda; Gregory Joseph,24,0,50,26
1657563769789,CSE 8A,A50,083650,Miranda; Gregory Joseph,17,1,56,39
1657563775810,CSE 11,A01,083080,Cao; Yingjun,6,15,40,34
1657563781837,CSE 12,A01,083652,Krause-Levy; Sophia Louisa,28,1,120,92
1657563787860,CSE 15L,A01,083654,Morris; Justin Loren,9,0,50,41
1657563787860,CSE 15L,A02,083655,Morris; Justin Loren,9,0,50,41
1657563793882,CSE 20,A01,083657,Tran; Khoa Dang,39,0,80,41
1657563799917,CSE 21,A01,095574,Bach; Quang Tran,22,0,48,26
1657563805944,CSE 30,A01,083084,Eldon; John,5,0,80,75
1657563805944,CSE 30,B01,095061,Bhaskar; Nishant,9,0,50,41
1657563811988,CSE 100,A01,083659,Cao; Yingjun,5,4,70,65
1657563818021,CSE 134B,A01,083661,Powell; Thomas Allan,22,0,100,78
1657563824059,CSE 140,A01,083663,Gungor; Onat,15,0,85,70
1657563830091,CSE 140L,A01,083088,Eldon; John,21,0,100,79
1657563836135,CSE 175,A01,083665,Kumar; Rakesh,3,0,25,22
1657563842160,CSE 190,A00,092507,Dubnov; Shlomo,8,0,20,12
1657563848207,ECE 45,A01,083139,Congero; Spencer William,6,0,75,69
1657563854230,ECE 65,A50,083695,Saad; Andrew S,12,0,30,18
1657563854230,ECE 65,A51,095125,Saad; Andrew S,24,0,26,2
1657563860265,ECE 109,A01,091882,Touri; Behrouz,19,0,70,51
1657563866309,ECE 180,A00,083140,Abi Samra; Nicholas Camill,1,0,30,29
1657563866309,ECE 180,B00,083141,Abi Samra; Nicholas Camill,0,0,30,30
1657563872341,MATH 10A,A01,083735,Patchell; Gregory David,2,0,30,28
1657563872341,MATH 10A,A02,083736,Patchell; Gregory David,20,0,30,10
1657563872341,MATH 10A,A03,083737,Patchell; Gregory David,16,0,30,14
1657563878377,MATH 10B,A01,083207,Lim; Seonhee,8,0,34,26
1657563878377,MATH 10B,A02,083208,Lim; Seonhee,9,0,35,26
1657563878377,MATH 10B,A03,093472,Lim; Seonhee,7,0,34,27
1657563878377,MATH 10B,B01,083739,Sinha; Shubham,12,0,30,18
1657563884411,MATH 18,A01,083743,Cinel; Cameron Alexander,7,0,30,23
1657563884411,MATH 18,A02,083744,Cinel; Cameron Alexander,17,0,30,13
1657563884411,MATH 18,A03,083745,Cinel; Cameron Alexander,9,0,30,21
1657563884411,MATH 18,B01,083748,Rideout; David Porter,5,0,37,32
1657563884411,MATH 18,B02,083749,Rideout; David Porter,5,0,36,31
1657563884411,MATH 18,B03,083750,Rideout; David Porter,3,0,37,34
1657563884411,MATH 18,B04,083751,Rideout; David Porter,6,0,36,30
1657563884411,MATH 18,B05,093473,Rideout; David Porter,6,0,36,30
1657563884411,MATH 18,B06,093474,Rideout; David Porter,6,0,36,30
1657563890446,MATH 20A,A01,083754,Zheng; Zequn,14,0,40,26
1657563896468,MATH 20B,A01,083756,Briones; Jor-el Thomas Caparas,4,0,36,32
1657563896468,MATH 20B,A02,083757,Briones; Jor-el Thomas Caparas,1,0,36,35
1657563896468,MATH 20B,A03,093475,Briones; Jor-el Thomas Caparas,2,0,36,34
1657563902491,MATH 20C,A01,083760,Briones; Jor-el Thomas Caparas,1,0,35,34
1657563902491,MATH 20C,A02,083761,Briones; Jor-el Thomas Caparas,8,0,35,27
1657563902491,MATH 20C,A03,093476,Briones; Jor-el Thomas Caparas,0,1,36,36
1657563902491,MATH 20C,B01,083762,Bach; Quang Tran,1,0,30,29
1657563908519,MATH 20D,A01,083765,Tran; Brian Kha,5,0,30,25
1657563908519,MATH 20D,A02,083766,Tran; Brian Kha,5,0,30,25
1657563908519,MATH 20D,A03,083767,Tran; Brian Kha,5,0,30,25
1657563914556,MATH 20E,A01,083771,Ganguly; Soumya,9,0,32,23
1657563914556,MATH 20E,A02,083772,Ganguly; Soumya,6,0,32,26
1657563914556,MATH 20E,B01,083773,Ciotti; Benjamin,20,0,35,15
1657563914556,MATH 20E,B02,083774,Ciotti; Benjamin,17,0,35,18
1657563920586,MATH 103A,A01,083777,Greenfeld; Be'Eri,3,0,36,33
1657563920586,MATH 103A,A02,083778,Greenfeld; Be'Eri,5,0,36,31
1657563920586,MATH 103A,A03,093561,Greenfeld; Be'Eri,5,0,36,31
1657563920586,MATH 103A,B01,083779,Greenfeld; Be'Eri,7,0,36,29
1657563920586,MATH 103A,B02,083780,Greenfeld; Be'Eri,4,0,36,32
1657563920586,MATH 103A,B03,093562,Greenfeld; Be'Eri,3,0,36,33
1657563926624,MATH 105,A01,085443,Carter; Anne Toulson,15,0,35,20
1657563926624,MATH 105,A02,093477,Carter; Anne Toulson,20,0,35,15
1657563932647,MATH 109,A01,083213,Ganzberger; Geoffrey Michael,2,0,34,32
1657563932647,MATH 109,A02,083214,Ganzberger; Geoffrey Michael,4,0,34,30
1657563932647,MATH 109,A03,093478,Ganzberger; Geoffrey Michael,2,0,34,32
1657563932647,MATH 109,B01,083215,Ganzberger; Geoffrey Michael,1,0,32,31
1657563932647,MATH 109,B02,083216,Ganzberger; Geoffrey Michael,2,0,32,30
1657563932647,MATH 109,B03,093479,Ganzberger; Geoffrey Michael,8,0,32,24
1657563938680,MATH 142A,A01,083219,Chow; Bennett,7,0,32,25
1657563938680,MATH 142A,A02,083220,Chow; Bennett,10,0,32,22
1657563938680,MATH 142A,A03,093480,Chow; Bennett,8,0,32,24
1657563938680,MATH 142A,B03,093481,Chow; Bennett,8,0,32,24
1657563938680,MATH 142A,B04,093558,Chow; Bennett,13,0,32,19
1657563938680,MATH 142A,B05,093559,Chow; Bennett,6,0,32,26
1657563944717,MATH 193A,A01,083224,Rotar; Vladimir,8,0,34,26
1657563944717,MATH 193A,A02,083225,Rotar; Vladimir,9,0,34,25
1657563944717,MATH 193A,A03,083781,Rotar; Vladimir,5,0,34,29
1657563944717,MATH 193A,A04,083782,Rotar; Vladimir,10,0,34,24
1657563944717,MATH 193A,A05,093482,Rotar; Vladimir,10,0,34,24
1657563950743,MATH 197,001,091859,McAuley; Julian John,9999,0,9999,0
1657563950743,MATH 197,002,095566,Kedlaya; Kiran S.,9997,0,9999,2
1657563950743,MATH 197,003,095567,Xiao; Ming,9999,0,9999,0
1657563950743,MATH 197,004,095571,Perols; Johan Lars,9998,0,9999,1
1657563957807,COGS 9,A01,083615,Shannon; Kyle Michael,9,0,75,66
1657563963839,COGS 11,A01,083617,Boyle; Mary E. T.,23,0,48,25
1657563969870,COGS 13,A01,083071,Bastos; Amalia Pinkusfeld,11,0,71,60
1657563975895,COGS 14A,A01,092681,Semenuks; Arturs,5,1,100,95
1657563981948,COGS 14B,A01,083073,Cheng; Tzu-Han,6,0,63,57
1657563987996,COGS 17,A01,092677,Semenuks; Arturs,6,0,81,75
1657563994033,COGS 100,A01,083619,Allen; Michael Gordon,17,0,70,53
1657564000082,COGS 101A,A01,083621,Davis; Joshua Daniel,9,0,68,59
1657564006205,COGS 101B,A01,091572,Allen; Michael Gordon,12,0,65,53
1657564012228,COGS 101C,A01,083625,Delgado; Tania,17,0,35,18
1657564018267,COGS 107A,A01,083627,Boyle; Mary E. T.,13,0,60,47
1657564024294,COGS 118A,A01,083075,Gupta; Anjum,21,0,76,55
1657564030318,CSE 3,A50,083646,Miranda; Gregory Joseph,24,0,50,26
1657564036342,CSE 8A,A50,083650,Miranda; Gregory Joseph,17,1,56,39
1657564042371,CSE 11,A01,083080,Cao; Yingjun,6,15,40,34
1657564048399,CSE 12,A01,083652,Krause-Levy; Sophia Louisa,28,1,120,92
1657564054425,CSE 15L,A01,083654,Morris; Justin Loren,9,0,50,41
1657564054425,CSE 15L,A02,083655,Morris; Justin Loren,9,0,50,41
1657564060446,CSE 20,A01,083657,Tran; Khoa Dang,39,0,80,41
1657564066469,CSE 21,A01,095574,Bach; Quang Tran,22,0,48,26
1657564072499,CSE 30,A01,083084,Eldon; John,5,0,80,75
1657564072499,CSE 30,B01,095061,Bhaskar; Nishant,9,0,50,41
1657564078522,CSE 100,A01,083659,Cao; Yingjun,5,4,70,65
1657564084546,CSE 134B,A01,083661,Powell; Thomas Allan,22,0,100,78
1657564090584,CSE 140,A01,083663,Gungor; Onat,15,0,85,70
1657564096606,CSE 140L,A01,083088,Eldon; John,21,0,100,79
1657564102636,CSE 175,A01,083665,Kumar; Rakesh,3,0,25,22
1657564108672,CSE 190,A00,092507,Dubnov; Shlomo,8,0,20,12
1657564114706,ECE 45,A01,083139,Congero; Spencer William,6,0,75,69
1657564120737,ECE 65,A50,083695,Saad; Andrew S,12,0,30,18
1657564120737,ECE 65,A51,095125,Saad; Andrew S,24,0,26,2
1657564126763,ECE 109,A01,091882,Touri; Behrouz,19,0,70,51
1657564132784,ECE 180,A00,083140,Abi Samra; Nicholas Camill,1,0,30,29
1657564132784,ECE 180,B00,083141,Abi Samra; Nicholas Camill,0,0,30,30
1657564138824,MATH 10A,A01,083735,Patchell; Gregory David,2,0,30,28
1657564138824,MATH 10A,A02,083736,Patchell; Gregory David,20,0,30,10
1657564138824,MATH 10A,A03,083737,Patchell; Gregory David,16,0,30,14
1657564144851,MATH 10B,A01,083207,Lim; Seonhee,8,0,34,26
1657564144851,MATH 10B,A02,083208,Lim; Seonhee,9,0,35,26
1657564144851,MATH 10B,A03,093472,Lim; Seonhee,7,0,34,27
1657564144851,MATH 10B,B01,083739,Sinha; Shubham,12,0,30,18
1657564150874,MATH 18,A01,083743,Cinel; Cameron Alexander,7,0,30,23
1657564150874,MATH 18,A02,083744,Cinel; Cameron Alexander,17,0,30,13
1657564150874,MATH 18,A03,083745,Cinel; Cameron Alexander,9,0,30,21
1657564150874,MATH 18,B01,083748,Rideout; David Porter,5,0,37,32
1657564150874,MATH 18,B02,083749,Rideout; David Porter,5,0,36,31
1657564150874,MATH 18,B03,083750,Rideout; David Porter,3,0,37,34
1657564150874,MATH 18,B04,083751,Rideout; David Porter,6,0,36,30
1657564150874,MATH 18,B05,093473,Rideout; David Porter,6,0,36,30
1657564150874,MATH 18,B06,093474,Rideout; David Porter,6,0,36,30
1657564156906,MATH 20A,A01,083754,Zheng; Zequn,14,0,40,26
1657564162934,MATH 20B,A01,083756,Briones; Jor-el Thomas Caparas,4,0,36,32
1657564162934,MATH 20B,A02,083757,Briones; Jor-el Thomas Caparas,1,0,36,35
1657564162934,MATH 20B,A03,093475,Briones; Jor-el Thomas Caparas,2,0,36,34
1657564168957,MATH 20C,A01,083760,Briones; Jor-el Thomas Caparas,1,0,35,34
1657564168957,MATH 20C,A02,083761,Briones; Jor-el Thomas Caparas,8,0,35,27
1657564168957,MATH 20C,A03,093476,Briones; Jor-el Thomas Caparas,0,1,36,36
1657564168957,MATH 20C,B01,083762,Bach; Quang Tran,1,0,30,29
1657564174984,MATH 20D,A01,083765,Tran; Brian Kha,5,0,30,25
1657564174984,MATH 20D,A02,083766,Tran; Brian Kha,5,0,30,25
1657564174984,MATH 20D,A03,083767,Tran; Brian Kha,5,0,30,25
1657564181013,MATH 20E,A01,083771,Ganguly; Soumya,9,0,32,23
1657564181013,MATH 20E,A02,083772,Ganguly; Soumya,6,0,32,26
1657564181013,MATH 20E,B01,083773,Ciotti; Benjamin,20,0,35,15
1657564181013,MATH 20E,B02,083774,Ciotti; Benjamin,17,0,35,18
1657564187043,MATH 103A,A01,083777,Greenfeld; Be'Eri,3,0,36,33
1657564187043,MATH 103A,A02,083778,Greenfeld; Be'Eri,5,0,36,31
1657564187043,MATH 103A,A03,093561,Greenfeld; Be'Eri,5,0,36,31
1657564187043,MATH 103A,B01,083779,Greenfeld; Be'Eri,7,0,36,29
1657564187043,MATH 103A,B02,083780,Greenfeld; Be'Eri,4,0,36,32
1657564187043,MATH 103A,B03,093562,Greenfeld; Be'Eri,3,0,36,33
1657564193069,MATH 105,A01,085443,Carter; Anne Toulson,15,0,35,20
1657564193069,MATH 105,A02,093477,Carter; Anne Toulson,20,0,35,15
1657564199120,MATH 109,A01,083213,Ganzberger; Geoffrey Michael,2,0,34,32
1657564199120,MATH 109,A02,083214,Ganzberger; Geoffrey Michael,4,0,34,30
1657564199120,MATH 109,A03,093478,Ganzberger; Geoffrey Michael,2,0,34,32
1657564199120,MATH 109,B01,083215,Ganzberger; Geoffrey Michael,1,0,32,31
1657564199120,MATH 109,B02,083216,Ganzberger; Geoffrey Michael,2,0,32,30
1657564199120,MATH 109,B03,093479,Ganzberger; Geoffrey Michael,8,0,32,24
1657564205144,MATH 142A,A01,083219,Chow; Bennett,7,0,32,25
1657564205144,MATH 142A,A02,083220,Chow; Bennett,10,0,32,22
1657564205144,MATH 142A,A03,093480,Chow; Bennett,8,0,32,24
1657564205144,MATH 142A,B03,093481,Chow; Bennett,8,0,32,24
1657564205144,MATH 142A,B04,093558,Chow; Bennett,13,0,32,19
1657564205144,MATH 142A,B05,093559,Chow; Bennett,6,0,32,26
1657564211174,MATH 193A,A01,083224,Rotar; Vladimir,8,0,34,26
1657564211174,MATH 193A,A02,083225,Rotar; Vladimir,9,0,34,25
1657564211174,MATH 193A,A03,083781,Rotar; Vladimir,5,0,34,29
1657564211174,MATH 193A,A04,083782,Rotar; Vladimir,10,0,34,24
1657564211174,MATH 193A,A05,093482,Rotar; Vladimir,10,0,34,24
1657564217196,MATH 197,001,091859,McAuley; Julian John,9999,0,9999,0
1657564217196,MATH 197,002,095566,Kedlaya; Kiran S.,9997,0,9999,2
1657564217196,MATH 197,003,095567,Xiao; Ming,9999,0,9999,0
1657564217196,MATH 197,004,095571,Perols; Johan Lars,9998,0,9999,1
1657564224263,COGS 9,A01,083615,Shannon; Kyle Michael,9,0,75,66
1657564230293,COGS 11,A01,083617,Boyle; Mary E. T.,23,0,48,25
1657564236337,COGS 13,A01,083071,Bastos; Amalia Pinkusfeld,11,0,71,60
1657564242358,COGS 14A,A01,092681,Semenuks; Arturs,5,1,100,95
1657564248392,COGS 14B,A01,083073,Cheng; Tzu-Han,6,0,63,57
1657564254417,COGS 17,A01,092677,Semenuks; Arturs,6,0,81,75
1657564260447,COGS 100,A01,083619,Allen; Michael Gordon,17,0,70,53
1657564266470,COGS 101A,A01,083621,Davis; Joshua Daniel,9,0,68,59
1657564272503,COGS 101B,A01,091572,Allen; Michael Gordon,12,0,65,53
1657564278525,COGS 101C,A01,083625,Delgado; Tania,17,0,35,18
1657564284560,COGS 107A,A01,083627,Boyle; Mary E. T.,13,0,60,47
1657564290602,COGS 118A,A01,083075,Gupta; Anjum,21,0,76,55
1657564296632,CSE 3,A50,083646,Miranda; Gregory Joseph,24,0,50,26
1657564302661,CSE 8A,A50,083650,Miranda; Gregory Joseph,17,1,56,39
1657564308689,CSE 11,A01,083080,Cao; Yingjun,6,15,40,34
1657564314718,CSE 12,A01,083652,Krause-Levy; Sophia Louisa,28,1,120,92
1657564320745,CSE 15L,A01,083654,Morris; Justin Loren,9,0,50,41
1657564320745,CSE 15L,A02,083655,Morris; Justin Loren,9,0,50,41
1657564326766,CSE 20,A01,083657,Tran; Khoa Dang,39,0,80,41
1657564332789,CSE 21,A01,095574,Bach; Quang Tran,22,0,48,26
1657564338811,CSE 30,A01,083084,Eldon; John,5,0,80,75
1657564338811,CSE 30,B01,095061,Bhaskar; Nishant,9,0,50,41
1657564344834,CSE 100,A01,083659,Cao; Yingjun,5,4,70,65
1657564350858,CSE 134B,A01,083661,Powell; Thomas Allan,22,0,100,78
1657564356878,CSE 140,A01,083663,Gungor; Onat,15,0,85,70
1657564362909,CSE 140L,A01,083088,Eldon; John,21,0,100,79
1657564368935,CSE 175,A01,083665,Kumar; Rakesh,3,0,25,22
1657564374960,CSE 190,A00,092507,Dubnov; Shlomo,8,0,20,12
1657564380982,ECE 45,A01,083139,Congero; Spencer William,6,0,75,69
1657564387003,ECE 65,A50,083695,Saad; Andrew S,12,0,30,18
1657564387003,ECE 65,A51,095125,Saad; Andrew S,24,0,26,2
1657564393028,ECE 109,A01,091882,Touri; Behrouz,19,0,70,51
1657564399056,ECE 180,A00,083140,Abi Samra; Nicholas Camill,1,0,30,29
1657564399056,ECE 180,B00,083141,Abi Samra; Nicholas Camill,0,0,30,30
1657564405079,MATH 10A,A01,083735,Patchell; Gregory David,2,0,30,28
1657564405079,MATH 10A,A02,083736,Patchell; Gregory David,20,0,30,10
1657564405079,MATH 10A,A03,083737,Patchell; Gregory David,16,0,30,14
1657564411110,MATH 10B,A01,083207,Lim; Seonhee,8,0,34,26
1657564411110,MATH 10B,A02,083208,Lim; Seonhee,9,0,35,26
1657564411110,MATH 10B,A03,093472,Lim; Seonhee,7,0,34,27
1657564411110,MATH 10B,B01,083739,Sinha; Shubham,12,0,30,18
1657564417135,MATH 18,A01,083743,Cinel; Cameron Alexander,7,0,30,23
1657564417135,MATH 18,A02,083744,Cinel; Cameron Alexander,17,0,30,13
1657564417135,MATH 18,A03,083745,Cinel; Cameron Alexander,9,0,30,21
1657564417135,MATH 18,B01,083748,Rideout; David Porter,5,0,37,32
1657564417135,MATH 18,B02,083749,Rideout; David Porter,5,0,36,31
1657564417135,MATH 18,B03,083750,Rideout; David Porter,3,0,37,34
1657564417135,MATH 18,B04,083751,Rideout; David Porter,6,0,36,30
1657564417135,MATH 18,B05,093473,Rideout; David Porter,6,0,36,30
1657564417135,MATH 18,B06,093474,Rideout; David Porter,6,0,36,30
1657564423165,MATH 20A,A01,083754,Zheng; Zequn,14,0,40,26
1657564429194,MATH 20B,A01,083756,Briones; Jor-el Thomas Caparas,4,0,36,32
1657564429194,MATH 20B,A02,083757,Briones; Jor-el Thomas Caparas,1,0,36,35
1657564429194,MATH 20B,A03,093475,Briones; Jor-el Thomas Caparas,2,0,36,34
1657564435221,MATH 20C,A01,083760,Briones; Jor-el Thomas Caparas,1,0,35,34
1657564435221,MATH 20C,A02,083761,Briones; Jor-el Thomas Caparas,8,0,35,27
1657564435221,MATH 20C,A03,093476,Briones; Jor-el Thomas Caparas,0,1,36,36
1657564435221,MATH 20C,B01,083762,Bach; Quang Tran,1,0,30,29
1657564441250,MATH 20D,A01,083765,Tran; Brian Kha,5,0,30,25
1657564441250,MATH 20D,A02,083766,Tran; Brian Kha,5,0,30,25
1657564441250,MATH 20D,A03,083767,Tran; Brian Kha,5,0,30,25
1657564447283,MATH 20E,A01,083771,Ganguly; Soumya,9,0,32,23
1657564447283,MATH 20E,A02,083772,Ganguly; Soumya,6,0,32,26
1657564447283,MATH 20E,B01,083773,Ciotti; Benjamin,20,0,35,15
1657564447283,MATH 20E,B02,083774,Ciotti; Benjamin,17,0,35,18
1657564453313,MATH 103A,A01,083777,Greenfeld; Be'Eri,3,0,36,33
1657564453313,MATH 103A,A02,083778,Greenfeld; Be'Eri,5,0,36,31
1657564453313,MATH 103A,A03,093561,Greenfeld; Be'Eri,5,0,36,31
1657564453313,MATH 103A,B01,083779,Greenfeld; Be'Eri,7,0,36,29
1657564453313,MATH 103A,B02,083780,Greenfeld; Be'Eri,4,0,36,32
1657564453313,MATH 103A,B03,093562,Greenfeld; Be'Eri,3,0,36,33
1657564459335,MATH 105,A01,085443,Carter; Anne Toulson,15,0,35,20
1657564459335,MATH 105,A02,093477,Carter; Anne Toulson,20,0,35,15
1657564465359,MATH 109,A01,083213,Ganzberger; Geoffrey Michael,2,0,34,32
1657564465359,MATH 109,A02,083214,Ganzberger; Geoffrey Michael,4,0,34,30
1657564465359,MATH 109,A03,093478,Ganzberger; Geoffrey Michael,2,0,34,32
1657564465359,MATH 109,B01,083215,Ganzberger; Geoffrey Michael,1,0,32,31
1657564465359,MATH 109,B02,083216,Ganzberger; Geoffrey Michael,2,0,32,30
1657564465359,MATH 109,B03,093479,Ganzberger; Geoffrey Michael,8,0,32,24
1657564471388,MATH 142A,A01,083219,Chow; Bennett,7,0,32,25
1657564471388,MATH 142A,A02,083220,Chow; Bennett,10,0,32,22
1657564471388,MATH 142A,A03,093480,Chow; Bennett,8,0,32,24
1657564471388,MATH 142A,B03,093481,Chow; Bennett,8,0,32,24
1657564471388,MATH 142A,B04,093558,Chow; Bennett,13,0,32,19
1657564471388,MATH 142A,B05,093559,Chow; Bennett,6,0,32,26
1657564477412,MATH 193A,A01,083224,Rotar; Vladimir,8,0,34,26
1657564477412,MATH 193A,A02,083225,Rotar; Vladimir,9,0,34,25
1657564477412,MATH 193A,A03,083781,Rotar; Vladimir,5,0,34,29
1657564477412,MATH 193A,A04,083782,Rotar; Vladimir,10,0,34,24
1657564477412,MATH 193A,A05,093482,Rotar; Vladimir,10,0,34,24
1657564483436,MATH 197,001,091859,McAuley; Julian John,9999,0,9999,0
1657564483436,MATH 197,002,095566,Kedlaya; Kiran S.,9997,0,9999,2
1657564483436,MATH 197,003,095567,Xiao; Ming,9999,0,9999,0
1657564483436,MATH 197,004,095571,Perols; Johan Lars,9998,0,9999,1
1657564490486,COGS 9,A01,083615,Shannon; Kyle Michael,9,0,75,66
1657564496517,COGS 11,A01,083617,Boyle; Mary E. T.,23,0,48,25
1657564502545,COGS 13,A01,083071,Bastos; Amalia Pinkusfeld,11,0,71,60
1657564508567,COGS 14A,A01,092681,Semenuks; Arturs,5,1,100,95
1657564514591,COGS 14B,A01,083073,Cheng; Tzu-Han,6,0,63,57
1657564520613,COGS 17,A01,092677,Semenuks; Arturs,6,0,81,75
1657564526638,COGS 100,A01,083619,Allen; Michael Gordon,17,0,70,53
1657564532675,COGS 101A,A01,083621,Davis; Joshua Daniel,9,0,68,59
1657564538701,COGS 101B,A01,091572,Allen; Michael Gordon,12,0,65,53
1657564544729,COGS 101C,A01,083625,Delgado; Tania,17,0,35,18
1657564550752,COGS 107A,A01,083627,Boyle; Mary E. T.,13,0,60,47
1657564556775,COGS 118A,A01,083075,Gupta; Anjum,21,0,76,55
1657564562798,CSE 3,A50,083646,Miranda; Gregory Joseph,24,0,50,26
1657564568834,CSE 8A,A50,083650,Miranda; Gregory Joseph,17,1,56,39
1657564574861,CSE 11,A01,083080,Cao; Yingjun,6,15,40,34
1657564580883,CSE 12,A01,083652,Krause-Levy; Sophia Louisa,28,1,120,92
1657564586907,CSE 15L,A01,083654,Morris; Justin Loren,9,0,50,41
1657564586907,CSE 15L,A02,083655,Morris; Justin Loren,9,0,50,41
1657564592933,CSE 20,A01,083657,Tran; Khoa Dang,39,0,80,41
1657564598961,CSE 21,A01,095574,Bach; Quang Tran,22,0,48,26
1657564605055,CSE 30,A01,083084,Eldon; John,5,0,80,75
1657564605055,CSE 30,B01,095061,Bhaskar; Nishant,9,0,50,41
1657564611079,CSE 100,A01,083659,Cao; Yingjun,5,4,70,65
1657564617107,CSE 134B,A01,083661,Powell; Thomas Allan,22,0,100,78
1657564623129,CSE 140,A01,083663,Gungor; Onat,15,0,85,70
1657564629151,CSE 140L,A01,083088,Eldon; John,21,0,100,79
1657564635179,CSE 175,A01,083665,Kumar; Rakesh,3,0,25,22
1657564641204,CSE 190,A00,092507,Dubnov; Shlomo,8,0,20,12
1657564647234,ECE 45,A01,083139,Congero; Spencer William,6,0,75,69
1657564653257,ECE 65,A50,083695,Saad; Andrew S,12,0,30,18
1657564653257,ECE 65,A51,095125,Saad; Andrew S,24,0,26,2
1657564659293,ECE 109,A01,091882,Touri; Behrouz,19,0,70,51
1657564665316,ECE 180,A00,083140,Abi Samra; Nicholas Camill,1,0,30,29
1657564665316,ECE 180,B00,083141,Abi Samra; Nicholas Camill,0,0,30,30
1657564671338,MATH 10A,A01,083735,Patchell; Gregory David,2,0,30,28
1657564671338,MATH 10A,A02,083736,Patchell; Gregory David,20,0,30,10
1657564671338,MATH 10A,A03,083737,Patchell; Gregory David,16,0,30,14
1657564677361,MATH 10B,A01,083207,Lim; Seonhee,8,0,34,26
1657564677361,MATH 10B,A02,083208,Lim; Seonhee,9,0,35,26
1657564677361,MATH 10B,A03,093472,Lim; Seonhee,7,0,34,27
1657564677361,MATH 10B,B01,083739,Sinha; Shubham,12,0,30,18
1657564683385,MATH 18,A01,083743,Cinel; Cameron Alexander,7,0,30,23
1657564683385,MATH 18,A02,083744,Cinel; Cameron Alexander,17,0,30,13
1657564683385,MATH 18,A03,083745,Cinel; Cameron Alexander,9,0,30,21
1657564683385,MATH 18,B01,083748,Rideout; David Porter,5,0,37,32
1657564683385,MATH 18,B02,083749,Rideout; David Porter,5,0,36,31
1657564683385,MATH 18,B03,083750,Rideout; David Porter,3,0,37,34
1657564683385,MATH 18,B04,083751,Rideout; David Porter,6,0,36,30
1657564683385,MATH 18,B05,093473,Rideout; David Porter,6,0,36,30
1657564683385,MATH 18,B06,093474,Rideout; David Porter,6,0,36,30
1657564689418,MATH 20A,A01,083754,Zheng; Zequn,14,0,40,26
1657564695442,MATH 20B,A01,083756,Briones; Jor-el Thomas Caparas,4,0,36,32
1657564695442,MATH 20B,A02,083757,Briones; Jor-el Thomas Caparas,1,0,36,35
1657564695442,MATH 20B,A03,093475,Briones; Jor-el Thomas Caparas,2,0,36,34
1657564701466,MATH 20C,A01,083760,Briones; Jor-el Thomas Caparas,1,0,35,34
1657564701466,MATH 20C,A02,083761,Briones; Jor-el Thomas Caparas,8,0,35,27
1657564701466,MATH 20C,A03,093476,Briones; Jor-el Thomas Caparas,0,1,36,36
1657564701466,MATH 20C,B01,083762,Bach; Quang Tran,1,0,30,29
1657564707490,MATH 20D,A01,083765,Tran; Brian Kha,5,0,30,25
1657564707490,MATH 20D,A02,083766,Tran; Brian Kha,5,0,30,25
1657564707490,MATH 20D,A03,083767,Tran; Brian Kha,5,0,30,25
1657564713533,MATH 20E,A01,083771,Ganguly; Soumya,9,0,32,23
1657564713533,MATH 20E,A02,083772,Ganguly; Soumya,6,0,32,26
1657564713533,MATH 20E,B01,083773,Ciotti; Benjamin,20,0,35,15
1657564713533,MATH 20E,B02,083774,Ciotti; Benjamin,17,0,35,18
1657564719557,MATH 103A,A01,083777,Greenfeld; Be'Eri,3,0,36,33
1657564719557,MATH 103A,A02,083778,Greenfeld; Be'Eri,5,0,36,31
1657564719557,MATH 103A,A03,093561,Greenfeld; Be'Eri,5,0,36,31
1657564719557,MATH 103A,B01,083779,Greenfeld; Be'Eri,7,0,36,29
1657564719557,MATH 103A,B02,083780,Greenfeld; Be'Eri,4,0,36,32
1657564719557,MATH 103A,B03,093562,Greenfeld; Be'Eri,3,0,36,33
1657564725583,MATH 105,A01,085443,Carter; Anne Toulson,15,0,35,20
1657564725583,MATH 105,A02,093477,Carter; Anne Toulson,20,0,35,15
1657564731623,MATH 109,A01,083213,Ganzberger; Geoffrey Michael,2,0,34,32
1657564731623,MATH 109,A02,083214,Ganzberger; Geoffrey Michael,4,0,34,30
1657564731623,MATH 109,A03,093478,Ganzberger; Geoffrey Michael,2,0,34,32
1657564731623,MATH 109,B01,083215,Ganzberger; Geoffrey Michael,1,0,32,31
1657564731623,MATH 109,B02,083216,Ganzberger; Geoffrey Michael,2,0,32,30
1657564731623,MATH 109,B03,093479,Ganzberger; Geoffrey Michael,8,0,32,24
1657564737651,MATH 142A,A01,083219,Chow; Bennett,7,0,32,25
1657564737651,MATH 142A,A02,083220,Chow; Bennett,10,0,32,22
1657564737651,MATH 142A,A03,093480,Chow; Bennett,8,0,32,24
1657564737651,MATH 142A,B03,093481,Chow; Bennett,8,0,32,24
1657564737651,MATH 142A,B04,093558,Chow; Bennett,13,0,32,19
1657564737651,MATH 142A,B05,093559,Chow; Bennett,6,0,32,26
1657564743673,MATH 193A,A01,083224,Rotar; Vladimir,8,0,34,26
1657564743673,MATH 193A,A02,083225,Rotar; Vladimir,9,0,34,25
1657564743673,MATH 193A,A03,083781,Rotar; Vladimir,5,0,34,29
1657564743673,MATH 193A,A04,083782,Rotar; Vladimir,10,0,34,24
1657564743673,MATH 193A,A05,093482,Rotar; Vladimir,10,0,34,24
1657564749707,MATH 197,001,091859,McAuley; Julian John,9999,0,9999,0
1657564749707,MATH 197,002,095566,Kedlaya; Kiran S.,9997,0,9999,2
1657564749707,MATH 197,003,095567,Xiao; Ming,9999,0,9999,0
1657564749707,MATH 197,004,095571,Perols; Johan Lars,9998,0,9999,1
1657564756777,COGS 9,A01,083615,Shannon; Kyle Michael,9,0,75,66
1657564762802,COGS 11,A01,083617,Boyle; Mary E. T.,23,0,48,25
1657564768827,COGS 13,A01,083071,Bastos; Amalia Pinkusfeld,11,0,71,60
1657564774852,COGS 14A,A01,092681,Semenuks; Arturs,5,1,100,95
1657564780875,COGS 14B,A01,083073,Cheng; Tzu-Han,6,0,63,57
1657564786897,COGS 17,A01,092677,Semenuks; Arturs,6,0,81,75
1657564792924,COGS 100,A01,083619,Allen; Michael Gordon,17,0,70,53
1657564798955,COGS 101A,A01,083621,Davis; Joshua Daniel,9,0,68,59
1657564804980,COGS 101B,A01,091572,Allen; Michael Gordon,12,0,65,53
1657564811005,COGS 101C,A01,083625,Delgado; Tania,17,0,35,18
1657564817027,COGS 107A,A01,083627,Boyle; Mary E. T.,13,0,60,47
1657564823050,COGS 118A,A01,083075,Gupta; Anjum,21,0,76,55
1657564829083,CSE 3,A50,083646,Miranda; Gregory Joseph,24,0,50,26
1657564835111,CSE 8A,A50,083650,Miranda; Gregory Joseph,17,1,56,39
1657564841134,CSE 11,A01,083080,Cao; Yingjun,6,15,40,34
1657564847156,CSE 12,A01,083652,Krause-Levy; Sophia Louisa,28,1,120,92
1657564853191,CSE 15L,A01,083654,Morris; Justin Loren,9,0,50,41
1657564853191,CSE 15L,A02,083655,Morris; Justin Loren,9,0,50,41
1657564859228,CSE 20,A01,083657,Tran; Khoa Dang,39,0,80,41
1657564865254,CSE 21,A01,095574,Bach; Quang Tran,22,0,48,26
1657564871281,CSE 30,A01,083084,Eldon; John,5,0,80,75
1657564871281,CSE 30,B01,095061,Bhaskar; Nishant,9,0,50,41
1657564877303,CSE 100,A01,083659,Cao; Yingjun,5,4,70,65
1657564883325,CSE 134B,A01,083661,Powell; Thomas Allan,22,0,100,78
1657564889355,CSE 140,A01,083663,Gungor; Onat,15,0,85,70
1657564895386,CSE 140L,A01,083088,Eldon; John,21,0,100,79
1657564901411,CSE 175,A01,083665,Kumar; Rakesh,3,0,25,22
1657564907443,CSE 190,A00,092507,Dubnov; Shlomo,8,0,20,12
1657564913467,ECE 45,A01,083139,Congero; Spencer William,6,0,75,69
1657564919492,ECE 65,A50,083695,Saad; Andrew S,12,0,30,18
1657564919492,ECE 65,A51,095125,Saad; Andrew S,24,0,26,2
1657564925518,ECE 109,A01,091882,Touri; Behrouz,19,0,70,51
1657564931545,ECE 180,A00,083140,Abi Samra; Nicholas Camill,1,0,30,29
1657564931545,ECE 180,B00,083141,Abi Samra; Nicholas Camill,0,0,30,30
1657564937572,MATH 10A,A01,083735,Patchell; Gregory David,2,0,30,28
1657564937572,MATH 10A,A02,083736,Patchell; Gregory David,20,0,30,10
1657564937572,MATH 10A,A03,083737,Patchell; Gregory David,16,0,30,14
1657564943603,MATH 10B,A01,083207,Lim; Seonhee,8,0,34,26
1657564943603,MATH 10B,A02,083208,Lim; Seonhee,9,0,35,26
1657564943603,MATH 10B,A03,093472,Lim; Seonhee,7,0,34,27
1657564943603,MATH 10B,B01,083739,Sinha; Shubham,12,0,30,18
1657564949625,MATH 18,A01,083743,Cinel; Cameron Alexander,7,0,30,23
1657564949625,MATH 18,A02,083744,Cinel; Cameron Alexander,17,0,30,13
1657564949625,MATH 18,A03,083745,Cinel; Cameron Alexander,9,0,30,21
1657564949625,MATH 18,B01,083748,Rideout; David Porter,5,0,37,32
1657564949625,MATH 18,B02,083749,Rideout; David Porter,5,0,36,31
1657564949625,MATH 18,B03,083750,Rideout; David Porter,3,0,37,34
1657564949625,MATH 18,B04,083751,Rideout; David Porter,6,0,36,30
1657564949625,MATH 18,B05,093473,Rideout; David Porter,6,0,36,30
1657564949625,MATH 18,B06,093474,Rideout; David Porter,6,0,36,30
1657564955653,MATH 20A,A01,083754,Zheng; Zequn,14,0,40,26
1657564961684,MATH 20B,A01,083756,Briones; Jor-el Thomas Caparas,4,0,36,32
1657564961684,MATH 20B,A02,083757,Briones; Jor-el Thomas Caparas,1,0,36,35
1657564961684,MATH 20B,A03,093475,Briones; Jor-el Thomas Caparas,2,0,36,34
1657564967708,MATH 20C,A01,083760,Briones; Jor-el Thomas Caparas,1,0,35,34
1657564967708,MATH 20C,A02,083761,Briones; Jor-el Thomas Caparas,8,0,35,27
1657564967708,MATH 20C,A03,093476,Briones; Jor-el Thomas Caparas,0,1,36,36
1657564967708,MATH 20C,B01,083762,Bach; Quang Tran,1,0,30,29
1657564973736,MATH 20D,A01,083765,Tran; Brian Kha,5,0,30,25
1657564973736,MATH 20D,A02,083766,Tran; Brian Kha,5,0,30,25
1657564973736,MATH 20D,A03,083767,Tran; Brian Kha,5,0,30,25
1657564979763,MATH 20E,A01,083771,Ganguly; Soumya,9,0,32,23
1657564979763,MATH 20E,A02,083772,Ganguly; Soumya,6,0,32,26
1657564979763,MATH 20E,B01,083773,Ciotti; Benjamin,20,0,35,15
1657564979763,MATH 20E,B02,083774,Ciotti; Benjamin,17,0,35,18
1657564985792,MATH 103A,A01,083777,Greenfeld; Be'Eri,3,0,36,33
1657564985792,MATH 103A,A02,083778,Greenfeld; Be'Eri,5,0,36,31
1657564985792,MATH 103A,A03,093561,Greenfeld; Be'Eri,5,0,36,31
1657564985792,MATH 103A,B01,083779,Greenfeld; Be'Eri,7,0,36,29
1657564985792,MATH 103A,B02,083780,Greenfeld; Be'Eri,4,0,36,32
1657564985792,MATH 103A,B03,093562,Greenfeld; Be'Eri,3,0,36,33
1657564991815,MATH 105,A01,085443,Carter; Anne Toulson,15,0,35,20
1657564991815,MATH 105,A02,093477,Carter; Anne Toulson,20,0,35,15
1657564997845,MATH 109,A01,083213,Ganzberger; Geoffrey Michael,2,0,34,32
1657564997845,MATH 109,A02,083214,Ganzberger; Geoffrey Michael,4,0,34,30
1657564997845,MATH 109,A03,093478,Ganzberger; Geoffrey Michael,2,0,34,32
1657564997845,MATH 109,B01,083215,Ganzberger; Geoffrey Michael,1,0,32,31
1657564997845,MATH 109,B02,083216,Ganzberger; Geoffrey Michael,2,0,32,30
1657564997845,MATH 109,B03,093479,Ganzberger; Geoffrey Michael,8,0,32,24
1657565003877,MATH 142A,A01,083219,Chow; Bennett,7,0,32,25
1657565003877,MATH 142A,A02,083220,Chow; Bennett,10,0,32,22
1657565003877,MATH 142A,A03,093480,Chow; Bennett,8,0,32,24
1657565003877,MATH 142A,B03,093481,Chow; Bennett,8,0,32,24
1657565003877,MATH 142A,B04,093558,Chow; Bennett,13,0,32,19
1657565003877,MATH 142A,B05,093559,Chow; Bennett,6,0,32,26
1657565009900,MATH 193A,A01,083224,Rotar; Vladimir,8,0,34,26
1657565009900,MATH 193A,A02,083225,Rotar; Vladimir,9,0,34,25
1657565009900,MATH 193A,A03,083781,Rotar; Vladimir,5,0,34,29
1657565009900,MATH 193A,A04,083782,Rotar; Vladimir,10,0,34,24
1657565009900,MATH 193A,A05,093482,Rotar; Vladimir,10,0,34,24
1657565015923,MATH 197,001,091859,McAuley; Julian John,9999,0,9999,0
1657565015923,MATH 197,002,095566,Kedlaya; Kiran S.,9997,0,9999,2
1657565015923,MATH 197,003,095567,Xiao; Ming,9999,0,9999,0
1657565015923,MATH 197,004,095571,Perols; Johan Lars,9998,0,9999,1
1657565022987,COGS 9,A01,083615,Shannon; Kyle Michael,9,0,75,66
1657565029013,COGS 11,A01,083617,Boyle; Mary E. T.,23,0,48,25
1657565035040,COGS 13,A01,083071,Bastos; Amalia Pinkusfeld,11,0,71,60
1657565041064,COGS 14A,A01,092681,Semenuks; Arturs,5,1,100,95
1657565047093,COGS 14B,A01,083073,Cheng; Tzu-Han,6,0,63,57
1657565053114,COGS 17,A01,092677,Semenuks; Arturs,6,0,81,75
1657565059150,COGS 100,A01,083619,Allen; Michael Gordon,17,0,70,53
1657565065183,COGS 101A,A01,083621,Davis; Joshua Daniel,9,0,68,59
1657565071215,COGS 101B,A01,091572,Allen; Michael Gordon,12,0,65,53
1657565077238,COGS 101C,A01,083625,Delgado; Tania,17,0,35,18
1657565083268,COGS 107A,A01,083627,Boyle; Mary E. T.,13,0,60,47
1657565089294,COGS 118A,A01,083075,Gupta; Anjum,21,0,76,55
1657565095331,CSE 3,A50,083646,Miranda; Gregory Joseph,24,0,50,26
1657565101357,CSE 8A,A50,083650,Miranda; Gregory Joseph,17,1,56,39
1657565107379,CSE 11,A01,083080,Cao; Yingjun,6,15,40,34
1657565113414,CSE 12,A01,083652,Krause-Levy; Sophia Louisa,28,1,120,92
1657565119437,CSE 15L,A01,083654,Morris; Justin Loren,9,0,50,41
1657565119437,CSE 15L,A02,083655,Morris; Justin Loren,9,0,50,41
1657565125459,CSE 20,A01,083657,Tran; Khoa Dang,39,0,80,41
1657565131484,CSE 21,A01,095574,Bach; Quang Tran,22,0,48,26
1657565137507,CSE 30,A01,083084,Eldon; John,5,0,80,75
1657565137507,CSE 30,B01,095061,Bhaskar; Nishant,9,0,50,41
1657565143533,CSE 100,A01,083659,Cao; Yingjun,5,4,70,65
1657565149560,CSE 134B,A01,083661,Powell; Thomas Allan,22,0,100,78
1657565155584,CSE 140,A01,083663,Gungor; Onat,15,0,85,70
1657565161611,CSE 140L,A01,083088,Eldon; John,21,0,100,79
1657565167646,CSE 175,A01,083665,Kumar; Rakesh,3,0,25,22
1657565173671,CSE 190,A00,092507,Dubnov; Shlomo,8,0,20,12
1657565179698,ECE 45,A01,083139,Congero; Spencer William,6,0,75,69
1657565185725,ECE 65,A50,083695,Saad; Andrew S,12,0,30,18
1657565185725,ECE 65,A51,095125,Saad; Andrew S,24,0,26,2
1657565191748,ECE 109,A01,091882,Touri; Behrouz,19,0,70,51
1657565197779,ECE 180,A00,083140,Abi Samra; Nicholas Camill,1,0,30,29
1657565197779,ECE 180,B00,083141,Abi Samra; Nicholas Camill,0,0,30,30
1657565203878,MATH 10A,A01,083735,Patchell; Gregory David,2,0,30,28
1657565203878,MATH 10A,A02,083736,Patchell; Gregory David,20,0,30,10
1657565203878,MATH 10A,A03,083737,Patchell; Gregory David,16,0,30,14
1657565209908,MATH 10B,A01,083207,Lim; Seonhee,8,0,34,26
1657565209908,MATH 10B,A02,083208,Lim; Seonhee,9,0,35,26
1657565209908,MATH 10B,A03,093472,Lim; Seonhee,7,0,34,27
1657565209908,MATH 10B,B01,083739,Sinha; Shubham,12,0,30,18
1657565215937,MATH 18,A01,083743,Cinel; Cameron Alexander,7,0,30,23
1657565215937,MATH 18,A02,083744,Cinel; Cameron Alexander,17,0,30,13
1657565215937,MATH 18,A03,083745,Cinel; Cameron Alexander,9,0,30,21
1657565215937,MATH 18,B01,083748,Rideout; David Porter,5,0,37,32
1657565215937,MATH 18,B02,083749,Rideout; David Porter,5,0,36,31
1657565215937,MATH 18,B03,083750,Rideout; David Porter,3,0,37,34
1657565215937,MATH 18,B04,083751,Rideout; David Porter,6,0,36,30
1657565215937,MATH 18,B05,093473,Rideout; David Porter,6,0,36,30
1657565215937,MATH 18,B06,093474,Rideout; David Porter,6,0,36,30
1657565221963,MATH 20A,A01,083754,Zheng; Zequn,14,0,40,26
1657565227986,MATH 20B,A01,083756,Briones; Jor-el Thomas Caparas,4,0,36,32
1657565227986,MATH 20B,A02,083757,Briones; Jor-el Thomas Caparas,1,0,36,35
1657565227986,MATH 20B,A03,093475,Briones; Jor-el Thomas Caparas,2,0,36,34
1657565234011,MATH 20C,A01,083760,Briones; Jor-el Thomas Caparas,1,0,35,34
1657565234011,MATH 20C,A02,083761,Briones; Jor-el Thomas Caparas,8,0,35,27
1657565234011,MATH 20C,A03,093476,Briones; Jor-el Thomas Caparas,0,1,36,36
1657565234011,MATH 20C,B01,083762,Bach; Quang Tran,1,0,30,29
1657565240036,MATH 20D,A01,083765,Tran; Brian Kha,5,0,30,25
1657565240036,MATH 20D,A02,083766,Tran; Brian Kha,5,0,30,25
1657565240036,MATH 20D,A03,083767,Tran; Brian Kha,5,0,30,25
1657565246080,MATH 20E,A01,083771,Ganguly; Soumya,9,0,32,23
1657565246080,MATH 20E,A02,083772,Ganguly; Soumya,6,0,32,26
1657565246080,MATH 20E,B01,083773,Ciotti; Benjamin,20,0,35,15
1657565246080,MATH 20E,B02,083774,Ciotti; Benjamin,17,0,35,18
1657565252105,MATH 103A,A01,083777,Greenfeld; Be'Eri,3,0,36,33
1657565252105,MATH 103A,A02,083778,Greenfeld; Be'Eri,5,0,36,31
1657565252105,MATH 103A,A03,093561,Greenfeld; Be'Eri,5,0,36,31
1657565252105,MATH 103A,B01,083779,Greenfeld; Be'Eri,7,0,36,29
1657565252105,MATH 103A,B02,083780,Greenfeld; Be'Eri,4,0,36,32
1657565252105,MATH 103A,B03,093562,Greenfeld; Be'Eri,3,0,36,33
1657565258130,MATH 105,A01,085443,Carter; Anne Toulson,15,0,35,20
1657565258130,MATH 105,A02,093477,Carter; Anne Toulson,20,0,35,15
1657565264153,MATH 109,A01,083213,Ganzberger; Geoffrey Michael,2,0,34,32
1657565264153,MATH 109,A02,083214,Ganzberger; Geoffrey Michael,4,0,34,30
1657565264153,MATH 109,A03,093478,Ganzberger; Geoffrey Michael,2,0,34,32
1657565264153,MATH 109,B01,083215,Ganzberger; Geoffrey Michael,1,0,32,31
1657565264153,MATH 109,B02,083216,Ganzberger; Geoffrey Michael,2,0,32,30
1657565264153,MATH 109,B03,093479,Ganzberger; Geoffrey Michael,8,0,32,24
1657565270181,MATH 142A,A01,083219,Chow; Bennett,7,0,32,25
1657565270181,MATH 142A,A02,083220,Chow; Bennett,10,0,32,22
1657565270181,MATH 142A,A03,093480,Chow; Bennett,8,0,32,24
1657565270181,MATH 142A,B03,093481,Chow; Bennett,8,0,32,24
1657565270181,MATH 142A,B04,093558,Chow; Bennett,13,0,32,19
1657565270181,MATH 142A,B05,093559,Chow; Bennett,6,0,32,26
1657565276205,MATH 193A,A01,083224,Rotar; Vladimir,8,0,34,26
1657565276205,MATH 193A,A02,083225,Rotar; Vladimir,9,0,34,25
1657565276205,MATH 193A,A03,083781,Rotar; Vladimir,5,0,34,29
1657565276205,MATH 193A,A04,083782,Rotar; Vladimir,10,0,34,24
1657565276205,MATH 193A,A05,093482,Rotar; Vladimir,10,0,34,24
1657565282237,MATH 197,001,091859,McAuley; Julian John,9999,0,9999,0
1657565282237,MATH 197,002,095566,Kedlaya; Kiran S.,9997,0,9999,2
1657565282237,MATH 197,003,095567,Xiao; Ming,9999,0,9999,0
1657565282237,MATH 197,004,095571,Perols; Johan Lars,9998,0,9999,1
1657565289296,COGS 9,A01,083615,Shannon; Kyle Michael,9,0,75,66
1657565295318,COGS 11,A01,083617,Boyle; Mary E. T.,23,0,48,25
1657565301344,COGS 13,A01,083071,Bastos; Amalia Pinkusfeld,11,0,71,60
1657565307365,COGS 14A,A01,092681,Semenuks; Arturs,5,1,100,95
1657565313393,COGS 14B,A01,083073,Cheng; Tzu-Han,6,0,63,57
1657565319417,COGS 17,A01,092677,Semenuks; Arturs,6,0,81,75
1657565325442,COGS 100,A01,083619,Allen; Michael Gordon,17,0,70,53
1657565331469,COGS 101A,A01,083621,Davis; Joshua Daniel,9,0,68,59
1657565337491,COGS 101B,A01,091572,Allen; Michael Gordon,12,0,65,53
1657565343513,COGS 101C,A01,083625,Delgado; Tania,17,0,35,18
1657565349544,COGS 107A,A01,083627,Boyle; Mary E. T.,13,0,60,47
1657565355574,COGS 118A,A01,083075,Gupta; Anjum,21,0,76,55
1657565361599,CSE 3,A50,083646,Miranda; Gregory Joseph,24,0,50,26
1657565367623,CSE 8A,A50,083650,Miranda; Gregory Joseph,17,1,56,39
1657565373651,CSE 11,A01,083080,Cao; Yingjun,6,15,40,34
1657565379688,CSE 12,A01,083652,Krause-Levy; Sophia Louisa,28,1,120,92
1657565385722,CSE 15L,A01,083654,Morris; Justin Loren,9,0,50,41
1657565385722,CSE 15L,A02,083655,Morris; Justin Loren,9,0,50,41
1657565391744,CSE 20,A01,083657,Tran; Khoa Dang,39,0,80,41
1657565397771,CSE 21,A01,095574,Bach; Quang Tran,22,0,48,26
1657565403798,CSE 30,A01,083084,Eldon; John,5,0,80,75
1657565403798,CSE 30,B01,095061,Bhaskar; Nishant,9,0,50,41
1657565409823,CSE 100,A01,083659,Cao; Yingjun,5,4,70,65
1657565415846,CSE 134B,A01,083661,Powell; Thomas Allan,22,0,100,78
1657565421869,CSE 140,A01,083663,Gungor; Onat,15,0,85,70
1657565427892,CSE 140L,A01,083088,Eldon; John,21,0,100,79
1657565433913,CSE 175,A01,083665,Kumar; Rakesh,3,0,25,22
1657565439959,CSE 190,A00,092507,Dubnov; Shlomo,8,0,20,12
1657565445986,ECE 45,A01,083139,Congero; Spencer William,6,0,75,69
1657565452024,ECE 65,A50,083695,Saad; Andrew S,12,0,30,18
1657565452024,ECE 65,A51,095125,Saad; Andrew S,24,0,26,2
1657565458051,ECE 109,A01,091882,Touri; Behrouz,19,0,70,51
1657565464074,ECE 180,A00,083140,Abi Samra; Nicholas Camill,1,0,30,29
1657565464074,ECE 180,B00,083141,Abi Samra; Nicholas Camill,0,0,30,30
1657565470102,MATH 10A,A01,083735,Patchell; Gregory David,2,0,30,28
1657565470102,MATH 10A,A02,083736,Patchell; Gregory David,20,0,30,10
1657565470102,MATH 10A,A03,083737,Patchell; Gregory David,16,0,30,14
1657565476124,MATH 10B,A01,083207,Lim; Seonhee,8,0,34,26
1657565476124,MATH 10B,A02,083208,Lim; Seonhee,9,0,35,26
1657565476124,MATH 10B,A03,093472,Lim; Seonhee,7,0,34,27
1657565476124,MATH 10B,B01,083739,Sinha; Shubham,12,0,30,18
1657565482148,MATH 18,A01,083743,Cinel; Cameron Alexander,7,0,30,23
1657565482148,MATH 18,A02,083744,Cinel; Cameron Alexander,17,0,30,13
1657565482148,MATH 18,A03,083745,Cinel; Cameron Alexander,9,0,30,21
1657565482148,MATH 18,B01,083748,Rideout; David Porter,5,0,37,32
1657565482148,MATH 18,B02,083749,Rideout; David Porter,5,0,36,31
1657565482148,MATH 18,B03,083750,Rideout; David Porter,3,0,37,34
1657565482148,MATH 18,B04,083751,Rideout; David Porter,6,0,36,30
1657565482148,MATH 18,B05,093473,Rideout; David Porter,6,0,36,30
1657565482148,MATH 18,B06,093474,Rideout; David Porter,6,0,36,30
1657565488174,MATH 20A,A01,083754,Zheng; Zequn,14,0,40,26
1657565494202,MATH 20B,A01,083756,Briones; Jor-el Thomas Caparas,4,0,36,32
1657565494202,MATH 20B,A02,083757,Briones; Jor-el Thomas Caparas,1,0,36,35
1657565494202,MATH 20B,A03,093475,Briones; Jor-el Thomas Caparas,2,0,36,34
1657565500229,MATH 20C,A01,083760,Briones; Jor-el Thomas Caparas,1,0,35,34
1657565500229,MATH 20C,A02,083761,Briones; Jor-el Thomas Caparas,8,0,35,27
1657565500229,MATH 20C,A03,093476,Briones; Jor-el Thomas Caparas,0,1,36,36
1657565500229,MATH 20C,B01,083762,Bach; Quang Tran,1,0,30,29
1657565506259,MATH 20D,A01,083765,Tran; Brian Kha,5,0,30,25
1657565506259,MATH 20D,A02,083766,Tran; Brian Kha,5,0,30,25
1657565506259,MATH 20D,A03,083767,Tran; Brian Kha,5,0,30,25
1657565512282,MATH 20E,A01,083771,Ganguly; Soumya,9,0,32,23
1657565512282,MATH 20E,A02,083772,Ganguly; Soumya,6,0,32,26
1657565512282,MATH 20E,B01,083773,Ciotti; Benjamin,20,0,35,15
1657565512282,MATH 20E,B02,083774,Ciotti; Benjamin,17,0,35,18
1657565518310,MATH 103A,A01,083777,Greenfeld; Be'Eri,3,0,36,33
1657565518310,MATH 103A,A02,083778,Greenfeld; Be'Eri,5,0,36,31
1657565518310,MATH 103A,A03,093561,Greenfeld; Be'Eri,5,0,36,31
1657565518310,MATH 103A,B01,083779,Greenfeld; Be'Eri,7,0,36,29
1657565518310,MATH 103A,B02,083780,Greenfeld; Be'Eri,4,0,36,32
1657565518310,MATH 103A,B03,093562,Greenfeld; Be'Eri,3,0,36,33
1657565524337,MATH 105,A01,085443,Carter; Anne Toulson,15,0,35,20
1657565524337,MATH 105,A02,093477,Carter; Anne Toulson,20,0,35,15
1657565530365,MATH 109,A01,083213,Ganzberger; Geoffrey Michael,2,0,34,32
1657565530365,MATH 109,A02,083214,Ganzberger; Geoffrey Michael,4,0,34,30
1657565530365,MATH 109,A03,093478,Ganzberger; Geoffrey Michael,2,0,34,32
1657565530365,MATH 109,B01,083215,Ganzberger; Geoffrey Michael,1,0,32,31
1657565530365,MATH 109,B02,083216,Ganzberger; Geoffrey Michael,2,0,32,30
1657565530365,MATH 109,B03,093479,Ganzberger; Geoffrey Michael,8,0,32,24
1657565536389,MATH 142A,A01,083219,Chow; Bennett,7,0,32,25
1657565536389,MATH 142A,A02,083220,Chow; Bennett,10,0,32,22
1657565536389,MATH 142A,A03,093480,Chow; Bennett,8,0,32,24
1657565536389,MATH 142A,B03,093481,Chow; Bennett,8,0,32,24
1657565536389,MATH 142A,B04,093558,Chow; Bennett,13,0,32,19
1657565536389,MATH 142A,B05,093559,Chow; Bennett,6,0,32,26
1657565542429,MATH 193A,A01,083224,Rotar; Vladimir,8,0,34,26
1657565542429,MATH 193A,A02,083225,Rotar; Vladimir,9,0,34,25
1657565542429,MATH 193A,A03,083781,Rotar; Vladimir,5,0,34,29
1657565542429,MATH 193A,A04,083782,Rotar; Vladimir,10,0,34,24
1657565542429,MATH 193A,A05,093482,Rotar; Vladimir,10,0,34,24
1657565548453,MATH 197,001,091859,McAuley; Julian John,9999,0,9999,0
1657565548453,MATH 197,002,095566,Kedlaya; Kiran S.,9997,0,9999,2
1657565548453,MATH 197,003,095567,Xiao; Ming,9999,0,9999,0
1657565548453,MATH 197,004,095571,Perols; Johan Lars,9998,0,9999,1
1657565555514,COGS 9,A01,083615,Shannon; Kyle Michael,9,0,75,66
1657565561537,COGS 11,A01,083617,Boyle; Mary E. T.,23,0,48,25
1657565567579,COGS 13,A01,083071,Bastos; Amalia Pinkusfeld,11,0,71,60
1657565573602,COGS 14A,A01,092681,Semenuks; Arturs,5,1,100,95
1657565579634,COGS 14B,A01,083073,Cheng; Tzu-Han,6,0,63,57
1657565585656,COGS 17,A01,092677,Semenuks; Arturs,6,0,81,75
1657565591682,COGS 100,A01,083619,Allen; Michael Gordon,17,0,70,53
1657565597707,COGS 101A,A01,083621,Davis; Joshua Daniel,9,0,68,59
1657565603731,COGS 101B,A01,091572,Allen; Michael Gordon,12,0,65,53
1657565609753,COGS 101C,A01,083625,Delgado; Tania,17,0,35,18
1657565615776,COGS 107A,A01,083627,Boyle; Mary E. T.,13,0,60,47
1657565621801,COGS 118A,A01,083075,Gupta; Anjum,21,0,76,55
1657565627825,CSE 3,A50,083646,Miranda; Gregory Joseph,24,0,50,26
1657565633847,CSE 8A,A50,083650,Miranda; Gregory Joseph,17,1,56,39
1657565639873,CSE 11,A01,083080,Cao; Yingjun,6,15,40,34
1657565645896,CSE 12,A01,083652,Krause-Levy; Sophia Louisa,28,1,120,92
1657565651921,CSE 15L,A01,083654,Morris; Justin Loren,9,0,50,41
1657565651921,CSE 15L,A02,083655,Morris; Justin Loren,9,0,50,41
1657565657944,CSE 20,A01,083657,Tran; Khoa Dang,39,0,80,41
1657565663970,CSE 21,A01,095574,Bach; Quang Tran,22,0,48,26
1657565669992,CSE 30,A01,083084,Eldon; John,5,0,80,75
1657565669992,CSE 30,B01,095061,Bhaskar; Nishant,9,0,50,41
1657565676017,CSE 100,A01,083659,Cao; Yingjun,5,4,70,65
1657565682044,CSE 134B,A01,083661,Powell; Thomas Allan,22,0,100,78
1657565688071,CSE 140,A01,083663,Gungor; Onat,15,0,85,70
1657565694098,CSE 140L,A01,083088,Eldon; John,21,0,100,79
1657565700122,CSE 175,A01,083665,Kumar; Rakesh,3,0,25,22
1657565706151,CSE 190,A00,092507,Dubnov; Shlomo,8,0,20,12
1657565712176,ECE 45,A01,083139,Congero; Spencer William,6,0,75,69
1657565718199,ECE 65,A50,083695,Saad; Andrew S,12,0,30,18
1657565718199,ECE 65,A51,095125,Saad; Andrew S,24,0,26,2
1657565724222,ECE 109,A01,091882,Touri; Behrouz,19,0,70,51
1657565730248,ECE 180,A00,083140,Abi Samra; Nicholas Camill,1,0,30,29
1657565730248,ECE 180,B00,083141,Abi Samra; Nicholas Camill,0,0,30,30
1657565736274,MATH 10A,A01,083735,Patchell; Gregory David,2,0,30,28
1657565736274,MATH 10A,A02,083736,Patchell; Gregory David,20,0,30,10
1657565736274,MATH 10A,A03,083737,Patchell; Gregory David,16,0,30,14
1657565742302,MATH 10B,A01,083207,Lim; Seonhee,8,0,34,26
1657565742302,MATH 10B,A02,083208,Lim; Seonhee,9,0,35,26
1657565742302,MATH 10B,A03,093472,Lim; Seonhee,7,0,34,27
1657565742302,MATH 10B,B01,083739,Sinha; Shubham,12,0,30,18
1657565748333,MATH 18,A01,083743,Cinel; Cameron Alexander,7,0,30,23
1657565748333,MATH 18,A02,083744,Cinel; Cameron Alexander,17,0,30,13
1657565748333,MATH 18,A03,083745,Cinel; Cameron Alexander,9,0,30,21
1657565748333,MATH 18,B01,083748,Rideout; David Porter,5,0,37,32
1657565748333,MATH 18,B02,083749,Rideout; David Porter,5,0,36,31
1657565748333,MATH 18,B03,083750,Rideout; David Porter,3,0,37,34
1657565748333,MATH 18,B04,083751,Rideout; David Porter,6,0,36,30
1657565748333,MATH 18,B05,093473,Rideout; David Porter,6,0,36,30
1657565748333,MATH 18,B06,093474,Rideout; David Porter,6,0,36,30
1657565754359,MATH 20A,A01,083754,Zheng; Zequn,14,0,40,26
1657565760384,MATH 20B,A01,083756,Briones; Jor-el Thomas Caparas,4,0,36,32
1657565760384,MATH 20B,A02,083757,Briones; Jor-el Thomas Caparas,1,0,36,35
1657565760384,MATH 20B,A03,093475,Briones; Jor-el Thomas Caparas,2,0,36,34
1657565766407,MATH 20C,A01,083760,Briones; Jor-el Thomas Caparas,1,0,35,34
1657565766407,MATH 20C,A02,083761,Briones; Jor-el Thomas Caparas,8,0,35,27
1657565766407,MATH 20C,A03,093476,Briones; Jor-el Thomas Caparas,0,1,36,36
1657565766407,MATH 20C,B01,083762,Bach; Quang Tran,1,0,30,29
1657565772434,MATH 20D,A01,083765,Tran; Brian Kha,5,0,30,25
1657565772434,MATH 20D,A02,083766,Tran; Brian Kha,5,0,30,25
1657565772434,MATH 20D,A03,083767,Tran; Brian Kha,5,0,30,25
1657565778472,MATH 20E,A01,083771,Ganguly; Soumya,9,0,32,23
1657565778472,MATH 20E,A02,083772,Ganguly; Soumya,6,0,32,26
1657565778472,MATH 20E,B01,083773,Ciotti; Benjamin,20,0,35,15
1657565778472,MATH 20E,B02,083774,Ciotti; Benjamin,17,0,35,18
1657565784500,MATH 103A,A01,083777,Greenfeld; Be'Eri,3,0,36,33
1657565784500,MATH 103A,A02,083778,Greenfeld; Be'Eri,5,0,36,31
1657565784500,MATH 103A,A03,093561,Greenfeld; Be'Eri,5,0,36,31
1657565784500,MATH 103A,B01,083779,Greenfeld; Be'Eri,7,0,36,29
1657565784500,MATH 103A,B02,083780,Greenfeld; Be'Eri,4,0,36,32
1657565784500,MATH 103A,B03,093562,Greenfeld; Be'Eri,3,0,36,33
1657565790535,MATH 105,A01,085443,Carter; Anne Toulson,15,0,35,20
1657565790535,MATH 105,A02,093477,Carter; Anne Toulson,20,0,35,15
1657565796565,MATH 109,A01,083213,Ganzberger; Geoffrey Michael,2,0,34,32
1657565796565,MATH 109,A02,083214,Ganzberger; Geoffrey Michael,4,0,34,30
1657565796565,MATH 109,A03,093478,Ganzberger; Geoffrey Michael,2,0,34,32
1657565796565,MATH 109,B01,083215,Ganzberger; Geoffrey Michael,1,0,32,31
1657565796565,MATH 109,B02,083216,Ganzberger; Geoffrey Michael,2,0,32,30
1657565796565,MATH 109,B03,093479,Ganzberger; Geoffrey Michael,8,0,32,24
1657565802683,MATH 142A,A01,083219,Chow; Bennett,7,0,32,25
1657565802683,MATH 142A,A02,083220,Chow; Bennett,10,0,32,22
1657565802683,MATH 142A,A03,093480,Chow; Bennett,8,0,32,24
1657565802683,MATH 142A,B03,093481,Chow; Bennett,8,0,32,24
1657565802683,MATH 142A,B04,093558,Chow; Bennett,13,0,32,19
1657565802683,MATH 142A,B05,093559,Chow; Bennett,6,0,32,26
1657565808706,MATH 193A,A01,083224,Rotar; Vladimir,8,0,34,26
1657565808706,MATH 193A,A02,083225,Rotar; Vladimir,9,0,34,25
1657565808706,MATH 193A,A03,083781,Rotar; Vladimir,5,0,34,29
1657565808706,MATH 193A,A04,083782,Rotar; Vladimir,10,0,34,24
1657565808706,MATH 193A,A05,093482,Rotar; Vladimir,10,0,34,24
1657565814732,MATH 197,001,091859,McAuley; Julian John,9999,0,9999,0
1657565814732,MATH 197,002,095566,Kedlaya; Kiran S.,9997,0,9999,2
1657565814732,MATH 197,003,095567,Xiao; Ming,9999,0,9999,0
1657565814732,MATH 197,004,095571,Perols; Johan Lars,9998,0,9999,1
1657565821797,COGS 9,A01,083615,Shannon; Kyle Michael,9,0,75,66
1657565827822,COGS 11,A01,083617,Boyle; Mary E. T.,23,0,48,25
1657565833848,COGS 13,A01,083071,Bastos; Amalia Pinkusfeld,11,0,71,60
1657565839872,COGS 14A,A01,092681,Semenuks; Arturs,5,1,100,95
1657565845900,COGS 14B,A01,083073,Cheng; Tzu-Han,6,0,63,57
1657565851924,COGS 17,A01,092677,Semenuks; Arturs,6,0,81,75
1657565857946,COGS 100,A01,083619,Allen; Michael Gordon,17,0,70,53
1657565863972,COGS 101A,A01,083621,Davis; Joshua Daniel,9,0,68,59
1657565870004,COGS 101B,A01,091572,Allen; Michael Gordon,12,0,65,53
1657565876031,COGS 101C,A01,083625,Delgado; Tania,17,0,35,18
1657565882058,COGS 107A,A01,083627,Boyle; Mary E. T.,13,0,60,47
1657565888084,COGS 118A,A01,083075,Gupta; Anjum,21,0,76,55
1657565894117,CSE 3,A50,083646,Miranda; Gregory Joseph,24,0,50,26
1657565900140,CSE 8A,A50,083650,Miranda; Gregory Joseph,17,1,56,39
1657565906175,CSE 11,A01,083080,Cao; Yingjun,6,15,40,34
1657565912198,CSE 12,A01,083652,Krause-Levy; Sophia Louisa,28,1,120,92
1657565918228,CSE 15L,A01,083654,Morris; Justin Loren,9,0,50,41
1657565918228,CSE 15L,A02,083655,Morris; Justin Loren,9,0,50,41
1657565924251,CSE 20,A01,083657,Tran; Khoa Dang,39,0,80,41
1657565930275,CSE 21,A01,095574,Bach; Quang Tran,22,0,48,26
1657565936297,CSE 30,A01,083084,Eldon; John,5,0,80,75
1657565936297,CSE 30,B01,095061,Bhaskar; Nishant,9,0,50,41
1657565942321,CSE 100,A01,083659,Cao; Yingjun,5,4,70,65
1657565948347,CSE 134B,A01,083661,Powell; Thomas Allan,22,0,100,78
1657565954374,CSE 140,A01,083663,Gungor; Onat,15,0,85,70
1657565960414,CSE 140L,A01,083088,Eldon; John,21,0,100,79
1657565966448,CSE 175,A01,083665,Kumar; Rakesh,3,0,25,22
1657565972470,CSE 190,A00,092507,Dubnov; Shlomo,8,0,20,12
1657565978492,ECE 45,A01,083139,Congero; Spencer William,6,0,75,69
1657565984515,ECE 65,A50,083695,Saad; Andrew S,12,0,30,18
1657565984515,ECE 65,A51,095125,Saad; Andrew S,24,0,26,2
1657565990544,ECE 109,A01,091882,Touri; Behrouz,19,0,70,51
1657565996566,ECE 180,A00,083140,Abi Samra; Nicholas Camill,1,0,30,29
1657565996566,ECE 180,B00,083141,Abi Samra; Nicholas Camill,0,0,30,30
1657566002594,MATH 10A,A01,083735,Patchell; Gregory David,2,0,30,28
1657566002594,MATH 10A,A02,083736,Patchell; Gregory David,20,0,30,10
1657566002594,MATH 10A,A03,083737,Patchell; Gregory David,16,0,30,14
1657566008621,MATH 10B,A01,083207,Lim; Seonhee,8,0,34,26
1657566008621,MATH 10B,A02,083208,Lim; Seonhee,9,0,35,26
1657566008621,MATH 10B,A03,093472,Lim; Seonhee,7,0,34,27
1657566008621,MATH 10B,B01,083739,Sinha; Shubham,12,0,30,18
1657566014648,MATH 18,A01,083743,Cinel; Cameron Alexander,7,0,30,23
1657566014648,MATH 18,A02,083744,Cinel; Cameron Alexander,17,0,30,13
1657566014648,MATH 18,A03,083745,Cinel; Cameron Alexander,9,0,30,21
1657566014648,MATH 18,B01,083748,Rideout; David Porter,5,0,37,32
1657566014648,MATH 18,B02,083749,Rideout; David Porter,5,0,36,31
1657566014648,MATH 18,B03,083750,Rideout; David Porter,3,0,37,34
1657566014648,MATH 18,B04,083751,Rideout; David Porter,6,0,36,30
1657566014648,MATH 18,B05,093473,Rideout; David Porter,6,0,36,30
1657566014648,MATH 18,B06,093474,Rideout; David Porter,6,0,36,30
1657566020674,MATH 20A,A01,083754,Zheng; Zequn,14,0,40,26
1657566026708,MATH 20B,A01,083756,Briones; Jor-el Thomas Caparas,4,0,36,32
1657566026708,MATH 20B,A02,083757,Briones; Jor-el Thomas Caparas,1,0,36,35
1657566026708,MATH 20B,A03,093475,Briones; Jor-el Thomas Caparas,2,0,36,34
1657566032734,MATH 20C,A01,083760,Briones; Jor-el Thomas Caparas,1,0,35,34
1657566032734,MATH 20C,A02,083761,Briones; Jor-el Thomas Caparas,8,0,35,27
1657566032734,MATH 20C,A03,093476,Briones; Jor-el Thomas Caparas,0,1,36,36
1657566032734,MATH 20C,B01,083762,Bach; Quang Tran,1,0,30,29
1657566038757,MATH 20D,A01,083765,Tran; Brian Kha,5,0,30,25
1657566038757,MATH 20D,A02,083766,Tran; Brian Kha,5,0,30,25
1657566038757,MATH 20D,A03,083767,Tran; Brian Kha,5,0,30,25
1657566044781,MATH 20E,A01,083771,Ganguly; Soumya,9,0,32,23
1657566044781,MATH 20E,A02,083772,Ganguly; Soumya,6,0,32,26
1657566044781,MATH 20E,B01,083773,Ciotti; Benjamin,20,0,35,15
1657566044781,MATH 20E,B02,083774,Ciotti; Benjamin,17,0,35,18
1657566050805,MATH 103A,A01,083777,Greenfeld; Be'Eri,3,0,36,33
1657566050805,MATH 103A,A02,083778,Greenfeld; Be'Eri,5,0,36,31
1657566050805,MATH 103A,A03,093561,Greenfeld; Be'Eri,5,0,36,31
1657566050805,MATH 103A,B01,083779,Greenfeld; Be'Eri,7,0,36,29
1657566050805,MATH 103A,B02,083780,Greenfeld; Be'Eri,4,0,36,32
1657566050805,MATH 103A,B03,093562,Greenfeld; Be'Eri,3,0,36,33
1657566056835,MATH 105,A01,085443,Carter; Anne Toulson,15,0,35,20
1657566056835,MATH 105,A02,093477,Carter; Anne Toulson,20,0,35,15
1657566062859,MATH 109,A01,083213,Ganzberger; Geoffrey Michael,2,0,34,32
1657566062859,MATH 109,A02,083214,Ganzberger; Geoffrey Michael,4,0,34,30
1657566062859,MATH 109,A03,093478,Ganzberger; Geoffrey Michael,2,0,34,32
1657566062859,MATH 109,B01,083215,Ganzberger; Geoffrey Michael,1,0,32,31
1657566062859,MATH 109,B02,083216,Ganzberger; Geoffrey Michael,2,0,32,30
1657566062859,MATH 109,B03,093479,Ganzberger; Geoffrey Michael,8,0,32,24
1657566068887,MATH 142A,A01,083219,Chow; Bennett,7,0,32,25
1657566068887,MATH 142A,A02,083220,Chow; Bennett,10,0,32,22
1657566068887,MATH 142A,A03,093480,Chow; Bennett,8,0,32,24
1657566068887,MATH 142A,B03,093481,Chow; Bennett,8,0,32,24
1657566068887,MATH 142A,B04,093558,Chow; Bennett,13,0,32,19
1657566068887,MATH 142A,B05,093559,Chow; Bennett,6,0,32,26
1657566074925,MATH 193A,A01,083224,Rotar; Vladimir,8,0,34,26
1657566074925,MATH 193A,A02,083225,Rotar; Vladimir,9,0,34,25
1657566074925,MATH 193A,A03,083781,Rotar; Vladimir,5,0,34,29
1657566074925,MATH 193A,A04,083782,Rotar; Vladimir,10,0,34,24
1657566074925,MATH 193A,A05,093482,Rotar; Vladimir,10,0,34,24
1657566080955,MATH 197,001,091859,McAuley; Julian John,9999,0,9999,0
1657566080955,MATH 197,002,095566,Kedlaya; Kiran S.,9997,0,9999,2
1657566080955,MATH 197,003,095567,Xiao; Ming,9999,0,9999,0
1657566080955,MATH 197,004,095571,Perols; Johan Lars,9998,0,9999,1
1657566088009,COGS 9,A01,083615,Shannon; Kyle Michael,9,0,75,66
1657566094035,COGS 11,A01,083617,Boyle; Mary E. T.,23,0,48,25
1657566100060,COGS 13,A01,083071,Bastos; Amalia Pinkusfeld,11,0,71,60
1657566106085,COGS 14A,A01,092681,Semenuks; Arturs,5,1,100,95
1657566112111,COGS 14B,A01,083073,Cheng; Tzu-Han,6,0,63,57
1657566118138,COGS 17,A01,092677,Semenuks; Arturs,6,0,81,75
1657566124161,COGS 100,A01,083619,Allen; Michael Gordon,17,0,70,53
1657566130188,COGS 101A,A01,083621,Davis; Joshua Daniel,9,0,68,59
1657566136211,COGS 101B,A01,091572,Allen; Michael Gordon,12,0,65,53
1657566142234,COGS 101C,A01,083625,Delgado; Tania,17,0,35,18
1657566148260,COGS 107A,A01,083627,Boyle; Mary E. T.,13,0,60,47
1657566154296,COGS 118A,A01,083075,Gupta; Anjum,21,0,76,55
1657566160325,CSE 3,A50,083646,Miranda; Gregory Joseph,24,0,50,26
1657566166352,CSE 8A,A50,083650,Miranda; Gregory Joseph,17,1,56,39
1657566172377,CSE 11,A01,083080,Cao; Yingjun,6,15,40,34
1657566178403,CSE 12,A01,083652,Krause-Levy; Sophia Louisa,28,1,120,92
1657566184440,CSE 15L,A01,083654,Morris; Justin Loren,9,0,50,41
1657566184440,CSE 15L,A02,083655,Morris; Justin Loren,9,0,50,41
1657566190465,CSE 20,A01,083657,Tran; Khoa Dang,39,0,80,41
1657566196487,CSE 21,A01,095574,Bach; Quang Tran,22,0,48,26
1657566202513,CSE 30,A01,083084,Eldon; John,5,0,80,75
1657566202513,CSE 30,B01,095061,Bhaskar; Nishant,9,0,50,41
1657566208535,CSE 100,A01,083659,Cao; Yingjun,5,4,70,65
1657566214562,CSE 134B,A01,083661,Powell; Thomas Allan,22,0,100,78
1657566220584,CSE 140,A01,083663,Gungor; Onat,15,0,85,70
1657566226617,CSE 140L,A01,083088,Eldon; John,21,0,100,79
1657566232641,CSE 175,A01,083665,Kumar; Rakesh,3,0,25,22
1657566238665,CSE 190,A00,092507,Dubnov; Shlomo,8,0,20,12
1657566244686,ECE 45,A01,083139,Congero; Spencer William,6,0,75,69
1657566250709,ECE 65,A50,083695,Saad; Andrew S,12,0,30,18
1657566250709,ECE 65,A51,095125,Saad; Andrew S,24,0,26,2
1657566256731,ECE 109,A01,091882,Touri; Behrouz,19,0,70,51
1657566262756,ECE 180,A00,083140,Abi Samra; Nicholas Camill,1,0,30,29
1657566262756,ECE 180,B00,083141,Abi Samra; Nicholas Camill,0,0,30,30
1657566268777,MATH 10A,A01,083735,Patchell; Gregory David,2,0,30,28
1657566268777,MATH 10A,A02,083736,Patchell; Gregory David,20,0,30,10
1657566268777,MATH 10A,A03,083737,Patchell; Gregory David,16,0,30,14
1657566274799,MATH 10B,A01,083207,Lim; Seonhee,8,0,34,26
1657566274799,MATH 10B,A02,083208,Lim; Seonhee,9,0,35,26
1657566274799,MATH 10B,A03,093472,Lim; Seonhee,7,0,34,27
1657566274799,MATH 10B,B01,083739,Sinha; Shubham,12,0,30,18
1657566280830,MATH 18,A01,083743,Cinel; Cameron Alexander,7,0,30,23
1657566280830,MATH 18,A02,083744,Cinel; Cameron Alexander,17,0,30,13
1657566280830,MATH 18,A03,083745,Cinel; Cameron Alexander,9,0,30,21
1657566280830,MATH 18,B01,083748,Rideout; David Porter,5,0,37,32
1657566280830,MATH 18,B02,083749,Rideout; David Porter,5,0,36,31
1657566280830,MATH 18,B03,083750,Rideout; David Porter,3,0,37,34
1657566280830,MATH 18,B04,083751,Rideout; David Porter,6,0,36,30
1657566280830,MATH 18,B05,093473,Rideout; David Porter,6,0,36,30
1657566280830,MATH 18,B06,093474,Rideout; David Porter,6,0,36,30
1657566286854,MATH 20A,A01,083754,Zheng; Zequn,14,0,40,26
1657566292878,MATH 20B,A01,083756,Briones; Jor-el Thomas Caparas,4,0,36,32
1657566292878,MATH 20B,A02,083757,Briones; Jor-el Thomas Caparas,1,0,36,35
1657566292878,MATH 20B,A03,093475,Briones; Jor-el Thomas Caparas,2,0,36,34
1657566298916,MATH 20C,A01,083760,Briones; Jor-el Thomas Caparas,1,0,35,34
1657566298916,MATH 20C,A02,083761,Briones; Jor-el Thomas Caparas,8,0,35,27
1657566298916,MATH 20C,A03,093476,Briones; Jor-el Thomas Caparas,0,1,36,36
1657566298916,MATH 20C,B01,083762,Bach; Quang Tran,1,0,30,29
1657566304940,MATH 20D,A01,083765,Tran; Brian Kha,5,0,30,25
1657566304940,MATH 20D,A02,083766,Tran; Brian Kha,5,0,30,25
1657566304940,MATH 20D,A03,083767,Tran; Brian Kha,5,0,30,25
1657566310964,MATH 20E,A01,083771,Ganguly; Soumya,9,0,32,23
1657566310964,MATH 20E,A02,083772,Ganguly; Soumya,6,0,32,26
1657566310964,MATH 20E,B01,083773,Ciotti; Benjamin,20,0,35,15
1657566310964,MATH 20E,B02,083774,Ciotti; Benjamin,17,0,35,18
1657566316992,MATH 103A,A01,083777,Greenfeld; Be'Eri,3,0,36,33
1657566316992,MATH 103A,A02,083778,Greenfeld; Be'Eri,5,0,36,31
1657566316992,MATH 103A,A03,093561,Greenfeld; Be'Eri,5,0,36,31
1657566316992,MATH 103A,B01,083779,Greenfeld; Be'Eri,7,0,36,29
1657566316992,MATH 103A,B02,083780,Greenfeld; Be'Eri,4,0,36,32
1657566316992,MATH 103A,B03,093562,Greenfeld; Be'Eri,3,0,36,33
1657566323018,MATH 105,A01,085443,Carter; Anne Toulson,15,0,35,20
1657566323018,MATH 105,A02,093477,Carter; Anne Toulson,20,0,35,15
1657566329040,MATH 109,A01,083213,Ganzberger; Geoffrey Michael,2,0,34,32
1657566329040,MATH 109,A02,083214,Ganzberger; Geoffrey Michael,4,0,34,30
1657566329040,MATH 109,A03,093478,Ganzberger; Geoffrey Michael,2,0,34,32
1657566329040,MATH 109,B01,083215,Ganzberger; Geoffrey Michael,1,0,32,31
1657566329040,MATH 109,B02,083216,Ganzberger; Geoffrey Michael,2,0,32,30
1657566329040,MATH 109,B03,093479,Ganzberger; Geoffrey Michael,8,0,32,24
1657566335063,MATH 142A,A01,083219,Chow; Bennett,7,0,32,25
1657566335063,MATH 142A,A02,083220,Chow; Bennett,10,0,32,22
1657566335063,MATH 142A,A03,093480,Chow; Bennett,8,0,32,24
1657566335063,MATH 142A,B03,093481,Chow; Bennett,8,0,32,24
1657566335063,MATH 142A,B04,093558,Chow; Bennett,13,0,32,19
1657566335063,MATH 142A,B05,093559,Chow; Bennett,6,0,32,26
1657566341092,MATH 193A,A01,083224,Rotar; Vladimir,8,0,34,26
1657566341092,MATH 193A,A02,083225,Rotar; Vladimir,9,0,34,25
1657566341092,MATH 193A,A03,083781,Rotar; Vladimir,5,0,34,29
1657566341092,MATH 193A,A04,083782,Rotar; Vladimir,10,0,34,24
1657566341092,MATH 193A,A05,093482,Rotar; Vladimir,10,0,34,24
1657566347115,MATH 197,001,091859,McAuley; Julian John,9999,0,9999,0
1657566347115,MATH 197,002,095566,Kedlaya; Kiran S.,9997,0,9999,2
1657566347115,MATH 197,003,095567,Xiao; Ming,9999,0,9999,0
1657566347115,MATH 197,004,095571,Perols; Johan Lars,9998,0,9999,1
1657566354176,COGS 9,A01,083615,Shannon; Kyle Michael,9,0,75,66
1657566360203,COGS 11,A01,083617,Boyle; Mary E. T.,23,0,48,25
1657566366229,COGS 13,A01,083071,Bastos; Amalia Pinkusfeld,11,0,71,60
1657566372254,COGS 14A,A01,092681,Semenuks; Arturs,5,1,100,95
1657566378278,COGS 14B,A01,083073,Cheng; Tzu-Han,6,0,63,57
1657566384301,COGS 17,A01,092677,Semenuks; Arturs,6,0,81,75
1657566390328,COGS 100,A01,083619,Allen; Michael Gordon,17,0,70,53
1657566396424,COGS 101A,A01,083621,Davis; Joshua Daniel,9,0,68,59
1657566402447,COGS 101B,A01,091572,Allen; Michael Gordon,12,0,65,53
1657566408472,COGS 101C,A01,083625,Delgado; Tania,17,0,35,18
1657566414498,COGS 107A,A01,083627,Boyle; Mary E. T.,13,0,60,47
1657566420524,COGS 118A,A01,083075,Gupta; Anjum,21,0,76,55
1657566426552,CSE 3,A50,083646,Miranda; Gregory Joseph,24,0,50,26
1657566432576,CSE 8A,A50,083650,Miranda; Gregory Joseph,17,1,56,39
1657566438598,CSE 11,A01,083080,Cao; Yingjun,6,15,40,34
1657566444625,CSE 12,A01,083652,Krause-Levy; Sophia Louisa,28,1,120,92
1657566450650,CSE 15L,A01,083654,Morris; Justin Loren,9,0,50,41
1657566450650,CSE 15L,A02,083655,Morris; Justin Loren,9,0,50,41
1657566456677,CSE 20,A01,083657,Tran; Khoa Dang,39,0,80,41
1657566462699,CSE 21,A01,095574,Bach; Quang Tran,22,0,48,26
1657566468731,CSE 30,A01,083084,Eldon; John,5,0,80,75
1657566468731,CSE 30,B01,095061,Bhaskar; Nishant,9,0,50,41
1657566474755,CSE 100,A01,083659,Cao; Yingjun,5,4,70,65
1657566480778,CSE 134B,A01,083661,Powell; Thomas Allan,22,0,100,78
1657566486801,CSE 140,A01,083663,Gungor; Onat,15,0,85,70
1657566492826,CSE 140L,A01,083088,Eldon; John,21,0,100,79
1657566498859,CSE 175,A01,083665,Kumar; Rakesh,3,0,25,22
1657566504884,CSE 190,A00,092507,Dubnov; Shlomo,8,0,20,12
1657566510906,ECE 45,A01,083139,Congero; Spencer William,6,0,75,69
1657566516939,ECE 65,A50,083695,Saad; Andrew S,12,0,30,18
1657566516939,ECE 65,A51,095125,Saad; Andrew S,24,0,26,2
1657566522967,ECE 109,A01,091882,Touri; Behrouz,19,0,70,51
1657566528995,ECE 180,A00,083140,Abi Samra; Nicholas Camill,1,0,30,29
1657566528995,ECE 180,B00,083141,Abi Samra; Nicholas Camill,0,0,30,30
1657566535020,MATH 10A,A01,083735,Patchell; Gregory David,2,0,30,28
1657566535020,MATH 10A,A02,083736,Patchell; Gregory David,20,0,30,10
1657566535020,MATH 10A,A03,083737,Patchell; Gregory David,16,0,30,14
1657566541043,MATH 10B,A01,083207,Lim; Seonhee,8,0,34,26
1657566541043,MATH 10B,A02,083208,Lim; Seonhee,9,0,35,26
1657566541043,MATH 10B,A03,093472,Lim; Seonhee,7,0,34,27
1657566541043,MATH 10B,B01,083739,Sinha; Shubham,12,0,30,18
1657566547071,MATH 18,A01,083743,Cinel; Cameron Alexander,7,0,30,23
1657566547071,MATH 18,A02,083744,Cinel; Cameron Alexander,17,0,30,13
1657566547071,MATH 18,A03,083745,Cinel; Cameron Alexander,9,0,30,21
1657566547071,MATH 18,B01,083748,Rideout; David Porter,5,0,37,32
1657566547071,MATH 18,B02,083749,Rideout; David Porter,5,0,36,31
1657566547071,MATH 18,B03,083750,Rideout; David Porter,3,0,37,34
1657566547071,MATH 18,B04,083751,Rideout; David Porter,6,0,36,30
1657566547071,MATH 18,B05,093473,Rideout; David Porter,6,0,36,30
1657566547071,MATH 18,B06,093474,Rideout; David Porter,6,0,36,30
1657566553097,MATH 20A,A01,083754,Zheng; Zequn,14,0,40,26
1657566559126,MATH 20B,A01,083756,Briones; Jor-el Thomas Caparas,4,0,36,32
1657566559126,MATH 20B,A02,083757,Briones; Jor-el Thomas Caparas,1,0,36,35
1657566559126,MATH 20B,A03,093475,Briones; Jor-el Thomas Caparas,2,0,36,34
1657566565148,MATH 20C,A01,083760,Briones; Jor-el Thomas Caparas,1,0,35,34
1657566565148,MATH 20C,A02,083761,Briones; Jor-el Thomas Caparas,8,0,35,27
1657566565148,MATH 20C,A03,093476,Briones; Jor-el Thomas Caparas,0,1,36,36
1657566565148,MATH 20C,B01,083762,Bach; Quang Tran,1,0,30,29
1657566571173,MATH 20D,A01,083765,Tran; Brian Kha,5,0,30,25
1657566571173,MATH 20D,A02,083766,Tran; Brian Kha,5,0,30,25
1657566571173,MATH 20D,A03,083767,Tran; Brian Kha,5,0,30,25
1657566577197,MATH 20E,A01,083771,Ganguly; Soumya,9,0,32,23
1657566577197,MATH 20E,A02,083772,Ganguly; Soumya,6,0,32,26
1657566577197,MATH 20E,B01,083773,Ciotti; Benjamin,20,0,35,15
1657566577197,MATH 20E,B02,083774,Ciotti; Benjamin,17,0,35,18
1657566583221,MATH 103A,A01,083777,Greenfeld; Be'Eri,3,0,36,33
1657566583221,MATH 103A,A02,083778,Greenfeld; Be'Eri,5,0,36,31
1657566583221,MATH 103A,A03,093561,Greenfeld; Be'Eri,5,0,36,31
1657566583221,MATH 103A,B01,083779,Greenfeld; Be'Eri,7,0,36,29
1657566583221,MATH 103A,B02,083780,Greenfeld; Be'Eri,4,0,36,32
1657566583221,MATH 103A,B03,093562,Greenfeld; Be'Eri,3,0,36,33
1657566589259,MATH 105,A01,085443,Carter; Anne Toulson,15,0,35,20
1657566589259,MATH 105,A02,093477,Carter; Anne Toulson,20,0,35,15
1657566595288,MATH 109,A01,083213,Ganzberger; Geoffrey Michael,2,0,34,32
1657566595288,MATH 109,A02,083214,Ganzberger; Geoffrey Michael,4,0,34,30
1657566595288,MATH 109,A03,093478,Ganzberger; Geoffrey Michael,2,0,34,32
1657566595288,MATH 109,B01,083215,Ganzberger; Geoffrey Michael,1,0,32,31
1657566595288,MATH 109,B02,083216,Ganzberger; Geoffrey Michael,2,0,32,30
1657566595288,MATH 109,B03,093479,Ganzberger; Geoffrey Michael,8,0,32,24
1657566601317,MATH 142A,A01,083219,Chow; Bennett,7,0,32,25
1657566601317,MATH 142A,A02,083220,Chow; Bennett,10,0,32,22
1657566601317,MATH 142A,A03,093480,Chow; Bennett,8,0,32,24
1657566601317,MATH 142A,B03,093481,Chow; Bennett,8,0,32,24
1657566601317,MATH 142A,B04,093558,Chow; Bennett,13,0,32,19
1657566601317,MATH 142A,B05,093559,Chow; Bennett,6,0,32,26
1657566607350,MATH 193A,A01,083224,Rotar; Vladimir,8,0,34,26
1657566607350,MATH 193A,A02,083225,Rotar; Vladimir,9,0,34,25
1657566607350,MATH 193A,A03,083781,Rotar; Vladimir,5,0,34,29
1657566607350,MATH 193A,A04,083782,Rotar; Vladimir,10,0,34,24
1657566607350,MATH 193A,A05,093482,Rotar; Vladimir,10,0,34,24
1657566613375,MATH 197,001,091859,McAuley; Julian John,9999,0,9999,0
1657566613375,MATH 197,002,095566,Kedlaya; Kiran S.,9997,0,9999,2
1657566613375,MATH 197,003,095567,Xiao; Ming,9999,0,9999,0
1657566613375,MATH 197,004,095571,Perols; Johan Lars,9998,0,9999,1
1657566620436,COGS 9,A01,083615,Shannon; Kyle Michael,9,0,75,66
1657566626474,COGS 11,A01,083617,Boyle; Mary E. T.,23,0,48,25
1657566632498,COGS 13,A01,083071,Bastos; Amalia Pinkusfeld,11,0,71,60
1657566638520,COGS 14A,A01,092681,Semenuks; Arturs,5,1,100,95
1657566644544,COGS 14B,A01,083073,Cheng; Tzu-Han,6,0,63,57
1657566650569,COGS 17,A01,092677,Semenuks; Arturs,6,0,81,75
1657566656596,COGS 100,A01,083619,Allen; Michael Gordon,17,0,70,53
1657566662623,COGS 101A,A01,083621,Davis; Joshua Daniel,9,0,68,59
1657566668651,COGS 101B,A01,091572,Allen; Michael Gordon,12,0,65,53
1657566674681,COGS 101C,A01,083625,Delgado; Tania,17,0,35,18
1657566680712,COGS 107A,A01,083627,Boyle; Mary E. T.,13,0,60,47
1657566686734,COGS 118A,A01,083075,Gupta; Anjum,21,0,76,55
1657566692761,CSE 3,A50,083646,Miranda; Gregory Joseph,24,0,50,26
1657566698784,CSE 8A,A50,083650,Miranda; Gregory Joseph,17,1,56,39
1657566704818,CSE 11,A01,083080,Cao; Yingjun,6,15,40,34
1657566710842,CSE 12,A01,083652,Krause-Levy; Sophia Louisa,28,1,120,92
1657566716869,CSE 15L,A01,083654,Morris; Justin Loren,9,0,50,41
1657566716869,CSE 15L,A02,083655,Morris; Justin Loren,9,0,50,41
1657566722894,CSE 20,A01,083657,Tran; Khoa Dang,39,0,80,41
1657566728917,CSE 21,A01,095574,Bach; Quang Tran,22,0,48,26
1657566734941,CSE 30,A01,083084,Eldon; John,5,0,80,75
1657566734941,CSE 30,B01,095061,Bhaskar; Nishant,9,0,50,41
1657566740967,CSE 100,A01,083659,Cao; Yingjun,5,4,70,65
1657566746996,CSE 134B,A01,083661,Powell; Thomas Allan,22,0,100,78
1657566753022,CSE 140,A01,083663,Gungor; Onat,15,0,85,70
1657566759049,CSE 140L,A01,083088,Eldon; John,21,0,100,79
1657566765091,CSE 175,A01,083665,Kumar; Rakesh,3,0,25,22
1657566771120,CSE 190,A00,092507,Dubnov; Shlomo,8,0,20,12
1657566777146,ECE 45,A01,083139,Congero; Spencer William,6,0,75,69
1657566783174,ECE 65,A50,083695,Saad; Andrew S,12,0,30,18
1657566783174,ECE 65,A51,095125,Saad; Andrew S,24,0,26,2
1657566789201,ECE 109,A01,091882,Touri; Behrouz,19,0,70,51
1657566795230,ECE 180,A00,083140,Abi Samra; Nicholas Camill,1,0,30,29
1657566795230,ECE 180,B00,083141,Abi Samra; Nicholas Camill,0,0,30,30
1657566801257,MATH 10A,A01,083735,Patchell; Gregory David,2,0,30,28
1657566801257,MATH 10A,A02,083736,Patchell; Gregory David,20,0,30,10
1657566801257,MATH 10A,A03,083737,Patchell; Gregory David,16,0,30,14
1657566807287,MATH 10B,A01,083207,Lim; Seonhee,8,0,34,26
1657566807287,MATH 10B,A02,083208,Lim; Seonhee,9,0,35,26
1657566807287,MATH 10B,A03,093472,Lim; Seonhee,7,0,34,27
1657566807287,MATH 10B,B01,083739,Sinha; Shubham,12,0,30,18
1657566813322,MATH 18,A01,083743,Cinel; Cameron Alexander,7,0,30,23
1657566813322,MATH 18,A02,083744,Cinel; Cameron Alexander,17,0,30,13
1657566813322,MATH 18,A03,083745,Cinel; Cameron Alexander,9,0,30,21
1657566813322,MATH 18,B01,083748,Rideout; David Porter,5,0,37,32
1657566813322,MATH 18,B02,083749,Rideout; David Porter,5,0,36,31
1657566813322,MATH 18,B03,083750,Rideout; David Porter,3,0,37,34
1657566813322,MATH 18,B04,083751,Rideout; David Porter,6,0,36,30
1657566813322,MATH 18,B05,093473,Rideout; David Porter,6,0,36,30
1657566813322,MATH 18,B06,093474,Rideout; David Porter,6,0,36,30
1657566819357,MATH 20A,A01,083754,Zheng; Zequn,14,0,40,26
1657566825385,MATH 20B,A01,083756,Briones; Jor-el Thomas Caparas,4,0,36,32
1657566825385,MATH 20B,A02,083757,Briones; Jor-el Thomas Caparas,1,0,36,35
1657566825385,MATH 20B,A03,093475,Briones; Jor-el Thomas Caparas,2,0,36,34
1657566831420,MATH 20C,A01,083760,Briones; Jor-el Thomas Caparas,1,0,35,34
1657566831420,MATH 20C,A02,083761,Briones; Jor-el Thomas Caparas,8,0,35,27
1657566831420,MATH 20C,A03,093476,Briones; Jor-el Thomas Caparas,0,1,36,36
1657566831420,MATH 20C,B01,083762,Bach; Quang Tran,1,0,30,29
1657566837447,MATH 20D,A01,083765,Tran; Brian Kha,5,0,30,25
1657566837447,MATH 20D,A02,083766,Tran; Brian Kha,5,0,30,25
1657566837447,MATH 20D,A03,083767,Tran; Brian Kha,5,0,30,25
1657566843482,MATH 20E,A01,083771,Ganguly; Soumya,9,0,32,23
1657566843482,MATH 20E,A02,083772,Ganguly; Soumya,6,0,32,26
1657566843482,MATH 20E,B01,083773,Ciotti; Benjamin,20,0,35,15
1657566843482,MATH 20E,B02,083774,Ciotti; Benjamin,17,0,35,18
1657566849517,MATH 103A,A01,083777,Greenfeld; Be'Eri,3,0,36,33
1657566849517,MATH 103A,A02,083778,Greenfeld; Be'Eri,5,0,36,31
1657566849517,MATH 103A,A03,093561,Greenfeld; Be'Eri,5,0,36,31
1657566849517,MATH 103A,B01,083779,Greenfeld; Be'Eri,7,0,36,29
1657566849517,MATH 103A,B02,083780,Greenfeld; Be'Eri,4,0,36,32
1657566849517,MATH 103A,B03,093562,Greenfeld; Be'Eri,3,0,36,33
1657566855540,MATH 105,A01,085443,Carter; Anne Toulson,15,0,35,20
1657566855540,MATH 105,A02,093477,Carter; Anne Toulson,20,0,35,15
1657566861577,MATH 109,A01,083213,Ganzberger; Geoffrey Michael,2,0,34,32
1657566861577,MATH 109,A02,083214,Ganzberger; Geoffrey Michael,4,0,34,30
1657566861577,MATH 109,A03,093478,Ganzberger; Geoffrey Michael,2,0,34,32
1657566861577,MATH 109,B01,083215,Ganzberger; Geoffrey Michael,1,0,32,31
1657566861577,MATH 109,B02,083216,Ganzberger; Geoffrey Michael,2,0,32,30
1657566861577,MATH 109,B03,093479,Ganzberger; Geoffrey Michael,8,0,32,24
1657566867605,MATH 142A,A01,083219,Chow; Bennett,7,0,32,25
1657566867605,MATH 142A,A02,083220,Chow; Bennett,10,0,32,22
1657566867605,MATH 142A,A03,093480,Chow; Bennett,8,0,32,24
1657566867605,MATH 142A,B03,093481,Chow; Bennett,8,0,32,24
1657566867605,MATH 142A,B04,093558,Chow; Bennett,13,0,32,19
1657566867605,MATH 142A,B05,093559,Chow; Bennett,6,0,32,26
1657566873629,MATH 193A,A01,083224,Rotar; Vladimir,8,0,34,26
1657566873629,MATH 193A,A02,083225,Rotar; Vladimir,9,0,34,25
1657566873629,MATH 193A,A03,083781,Rotar; Vladimir,5,0,34,29
1657566873629,MATH 193A,A04,083782,Rotar; Vladimir,10,0,34,24
1657566873629,MATH 193A,A05,093482,Rotar; Vladimir,10,0,34,24
1657566879652,MATH 197,001,091859,McAuley; Julian John,9999,0,9999,0
1657566879652,MATH 197,002,095566,Kedlaya; Kiran S.,9997,0,9999,2
1657566879652,MATH 197,003,095567,Xiao; Ming,9999,0,9999,0
1657566879652,MATH 197,004,095571,Perols; Johan Lars,9998,0,9999,1
1657566886712,COGS 9,A01,083615,Shannon; Kyle Michael,9,0,75,66
1657566892734,COGS 11,A01,083617,Boyle; Mary E. T.,23,0,48,25
1657566898765,COGS 13,A01,083071,Bastos; Amalia Pinkusfeld,11,0,71,60
1657566904787,COGS 14A,A01,092681,Semenuks; Arturs,5,1,100,95
1657566910809,COGS 14B,A01,083073,Cheng; Tzu-Han,6,0,63,57
1657566916835,COGS 17,A01,092677,Semenuks; Arturs,6,0,81,75
1657566922865,COGS 100,A01,083619,Allen; Michael Gordon,17,0,70,53
1657566928895,COGS 101A,A01,083621,Davis; Joshua Daniel,9,0,68,59
1657566934922,COGS 101B,A01,091572,Allen; Michael Gordon,12,0,65,53
1657566940954,COGS 101C,A01,083625,Delgado; Tania,17,0,35,18
1657566946978,COGS 107A,A01,083627,Boyle; Mary E. T.,13,0,60,47
1657566953011,COGS 118A,A01,083075,Gupta; Anjum,21,0,76,55
1657566959040,CSE 3,A50,083646,Miranda; Gregory Joseph,24,0,50,26
1657566965062,CSE 8A,A50,083650,Miranda; Gregory Joseph,17,1,56,39
1657566971085,CSE 11,A01,083080,Cao; Yingjun,6,15,40,34
1657566977119,CSE 12,A01,083652,Krause-Levy; Sophia Louisa,28,1,120,92
1657566983144,CSE 15L,A01,083654,Morris; Justin Loren,9,0,50,41
1657566983144,CSE 15L,A02,083655,Morris; Justin Loren,9,0,50,41
1657566989166,CSE 20,A01,083657,Tran; Khoa Dang,39,0,80,41
1657566995262,CSE 21,A01,095574,Bach; Quang Tran,22,0,48,26
1657567001291,CSE 30,A01,083084,Eldon; John,5,0,80,75
1657567001291,CSE 30,B01,095061,Bhaskar; Nishant,9,0,50,41
1657567007312,CSE 100,A01,083659,Cao; Yingjun,5,4,70,65
1657567013357,CSE 134B,A01,083661,Powell; Thomas Allan,22,0,100,78
1657567019388,CSE 140,A01,083663,Gungor; Onat,15,0,85,70
1657567025413,CSE 140L,A01,083088,Eldon; John,21,0,100,79
1657567031444,CSE 175,A01,083665,Kumar; Rakesh,3,0,25,22
1657567037471,CSE 190,A00,092507,Dubnov; Shlomo,8,0,20,12
1657567043494,ECE 45,A01,083139,Congero; Spencer William,6,0,75,69
1657567049521,ECE 65,A50,083695,Saad; Andrew S,12,0,30,18
1657567049521,ECE 65,A51,095125,Saad; Andrew S,24,0,26,2
1657567055548,ECE 109,A01,091882,Touri; Behrouz,19,0,70,51
1657567061577,ECE 180,A00,083140,Abi Samra; Nicholas Camill,1,0,30,29
1657567061577,ECE 180,B00,083141,Abi Samra; Nicholas Camill,0,0,30,30
1657567067605,MATH 10A,A01,083735,Patchell; Gregory David,2,0,30,28
1657567067605,MATH 10A,A02,083736,Patchell; Gregory David,20,0,30,10
1657567067605,MATH 10A,A03,083737,Patchell; Gregory David,16,0,30,14
1657567073635,MATH 10B,A01,083207,Lim; Seonhee,8,0,34,26
1657567073635,MATH 10B,A02,083208,Lim; Seonhee,9,0,35,26
1657567073635,MATH 10B,A03,093472,Lim; Seonhee,7,0,34,27
1657567073635,MATH 10B,B01,083739,Sinha; Shubham,12,0,30,18
1657567079659,MATH 18,A01,083743,Cinel; Cameron Alexander,7,0,30,23
1657567079659,MATH 18,A02,083744,Cinel; Cameron Alexander,17,0,30,13
1657567079659,MATH 18,A03,083745,Cinel; Cameron Alexander,9,0,30,21
1657567079659,MATH 18,B01,083748,Rideout; David Porter,5,0,37,32
1657567079659,MATH 18,B02,083749,Rideout; David Porter,5,0,36,31
1657567079659,MATH 18,B03,083750,Rideout; David Porter,3,0,37,34
1657567079659,MATH 18,B04,083751,Rideout; David Porter,6,0,36,30
1657567079659,MATH 18,B05,093473,Rideout; David Porter,6,0,36,30
1657567079659,MATH 18,B06,093474,Rideout; David Porter,6,0,36,30
1657567085683,MATH 20A,A01,083754,Zheng; Zequn,14,0,40,26
1657567091715,MATH 20B,A01,083756,Briones; Jor-el Thomas Caparas,4,0,36,32
1657567091715,MATH 20B,A02,083757,Briones; Jor-el Thomas Caparas,1,0,36,35
1657567091715,MATH 20B,A03,093475,Briones; Jor-el Thomas Caparas,2,0,36,34
1657567097744,MATH 20C,A01,083760,Briones; Jor-el Thomas Caparas,1,0,35,34
1657567097744,MATH 20C,A02,083761,Briones; Jor-el Thomas Caparas,8,0,35,27
1657567097744,MATH 20C,A03,093476,Briones; Jor-el Thomas Caparas,0,1,36,36
1657567097744,MATH 20C,B01,083762,Bach; Quang Tran,1,0,30,29
1657567103766,MATH 20D,A01,083765,Tran; Brian Kha,5,0,30,25
1657567103766,MATH 20D,A02,083766,Tran; Brian Kha,5,0,30,25
1657567103766,MATH 20D,A03,083767,Tran; Brian Kha,5,0,30,25
1657567109791,MATH 20E,A01,083771,Ganguly; Soumya,9,0,32,23
1657567109791,MATH 20E,A02,083772,Ganguly; Soumya,6,0,32,26
1657567109791,MATH 20E,B01,083773,Ciotti; Benjamin,20,0,35,15
1657567109791,MATH 20E,B02,083774,Ciotti; Benjamin,17,0,35,18
1657567115819,MATH 103A,A01,083777,Greenfeld; Be'Eri,3,0,36,33
1657567115819,MATH 103A,A02,083778,Greenfeld; Be'Eri,5,0,36,31
1657567115819,MATH 103A,A03,093561,Greenfeld; Be'Eri,5,0,36,31
1657567115819,MATH 103A,B01,083779,Greenfeld; Be'Eri,7,0,36,29
1657567115819,MATH 103A,B02,083780,Greenfeld; Be'Eri,4,0,36,32
1657567115819,MATH 103A,B03,093562,Greenfeld; Be'Eri,3,0,36,33
1657567121851,MATH 105,A01,085443,Carter; Anne Toulson,15,0,35,20
1657567121851,MATH 105,A02,093477,Carter; Anne Toulson,20,0,35,15
1657567127877,MATH 109,A01,083213,Ganzberger; Geoffrey Michael,2,0,34,32
1657567127877,MATH 109,A02,083214,Ganzberger; Geoffrey Michael,4,0,34,30
1657567127877,MATH 109,A03,093478,Ganzberger; Geoffrey Michael,2,0,34,32
1657567127877,MATH 109,B01,083215,Ganzberger; Geoffrey Michael,1,0,32,31
1657567127877,MATH 109,B02,083216,Ganzberger; Geoffrey Michael,2,0,32,30
1657567127877,MATH 109,B03,093479,Ganzberger; Geoffrey Michael,8,0,32,24
1657567133916,MATH 142A,A01,083219,Chow; Bennett,7,0,32,25
1657567133916,MATH 142A,A02,083220,Chow; Bennett,10,0,32,22
1657567133916,MATH 142A,A03,093480,Chow; Bennett,8,0,32,24
1657567133916,MATH 142A,B03,093481,Chow; Bennett,8,0,32,24
1657567133916,MATH 142A,B04,093558,Chow; Bennett,13,0,32,19
1657567133916,MATH 142A,B05,093559,Chow; Bennett,6,0,32,26
1657567139939,MATH 193A,A01,083224,Rotar; Vladimir,8,0,34,26
1657567139939,MATH 193A,A02,083225,Rotar; Vladimir,9,0,34,25
1657567139939,MATH 193A,A03,083781,Rotar; Vladimir,5,0,34,29
1657567139939,MATH 193A,A04,083782,Rotar; Vladimir,10,0,34,24
1657567139939,MATH 193A,A05,093482,Rotar; Vladimir,10,0,34,24
1657567145961,MATH 197,001,091859,McAuley; Julian John,9999,0,9999,0
1657567145961,MATH 197,002,095566,Kedlaya; Kiran S.,9997,0,9999,2
1657567145961,MATH 197,003,095567,Xiao; Ming,9999,0,9999,0
1657567145961,MATH 197,004,095571,Perols; Johan Lars,9998,0,9999,1
1657567153033,COGS 9,A01,083615,Shannon; Kyle Michael,9,0,75,66
1657567159068,COGS 11,A01,083617,Boyle; Mary E. T.,23,0,48,25
1657567165090,COGS 13,A01,083071,Bastos; Amalia Pinkusfeld,11,0,71,60
1657567171114,COGS 14A,A01,092681,Semenuks; Arturs,5,1,100,95
1657567177140,COGS 14B,A01,083073,Cheng; Tzu-Han,6,0,63,57
1657567183163,COGS 17,A01,092677,Semenuks; Arturs,6,0,81,75
1657567189193,COGS 100,A01,083619,Allen; Michael Gordon,17,0,70,53
1657567195219,COGS 101A,A01,083621,Davis; Joshua Daniel,9,0,68,59
1657567201246,COGS 101B,A01,091572,Allen; Michael Gordon,12,0,65,53
1657567207278,COGS 101C,A01,083625,Delgado; Tania,17,0,35,18
1657567213305,COGS 107A,A01,083627,Boyle; Mary E. T.,13,0,60,47
1657567219331,COGS 118A,A01,083075,Gupta; Anjum,21,0,76,55
1657567225355,CSE 3,A50,083646,Miranda; Gregory Joseph,24,0,50,26
1657567231379,CSE 8A,A50,083650,Miranda; Gregory Joseph,17,1,56,39
1657567237402,CSE 11,A01,083080,Cao; Yingjun,6,15,40,34
1657567243429,CSE 12,A01,083652,Krause-Levy; Sophia Louisa,28,1,120,92
1657567249450,CSE 15L,A01,083654,Morris; Justin Loren,9,0,50,41
1657567249450,CSE 15L,A02,083655,Morris; Justin Loren,9,0,50,41
1657567255474,CSE 20,A01,083657,Tran; Khoa Dang,39,0,80,41
1657567261498,CSE 21,A01,095574,Bach; Quang Tran,22,0,48,26
1657567267522,CSE 30,A01,083084,Eldon; John,5,0,80,75
1657567267522,CSE 30,B01,095061,Bhaskar; Nishant,9,0,50,41
1657567273544,CSE 100,A01,083659,Cao; Yingjun,5,4,70,65
1657567279572,CSE 134B,A01,083661,Powell; Thomas Allan,22,0,100,78
1657567285595,CSE 140,A01,083663,Gungor; Onat,15,0,85,70
1657567291622,CSE 140L,A01,083088,Eldon; John,21,0,100,79
1657567297650,CSE 175,A01,083665,Kumar; Rakesh,3,0,25,22
1657567303675,CSE 190,A00,092507,Dubnov; Shlomo,8,0,20,12
1657567309697,ECE 45,A01,083139,Congero; Spencer William,6,0,75,69
1657567315719,ECE 65,A50,083695,Saad; Andrew S,12,0,30,18
1657567315719,ECE 65,A51,095125,Saad; Andrew S,24,0,26,2
1657567321744,ECE 109,A01,091882,Touri; Behrouz,19,0,70,51
1657567327778,ECE 180,A00,083140,Abi Samra; Nicholas Camill,1,0,30,29
1657567327778,ECE 180,B00,083141,Abi Samra; Nicholas Camill,0,0,30,30
1657567333802,MATH 10A,A01,083735,Patchell; Gregory David,2,0,30,28
1657567333802,MATH 10A,A02,083736,Patchell; Gregory David,20,0,30,10
1657567333802,MATH 10A,A03,083737,Patchell; Gregory David,16,0,30,14
1657567339825,MATH 10B,A01,083207,Lim; Seonhee,8,0,34,26
1657567339825,MATH 10B,A02,083208,Lim; Seonhee,9,0,35,26
1657567339825,MATH 10B,A03,093472,Lim; Seonhee,7,0,34,27
1657567339825,MATH 10B,B01,083739,Sinha; Shubham,12,0,30,18
1657567345855,MATH 18,A01,083743,Cinel; Cameron Alexander,7,0,30,23
1657567345855,MATH 18,A02,083744,Cinel; Cameron Alexander,17,0,30,13
1657567345855,MATH 18,A03,083745,Cinel; Cameron Alexander,9,0,30,21
1657567345855,MATH 18,B01,083748,Rideout; David Porter,5,0,37,32
1657567345855,MATH 18,B02,083749,Rideout; David Porter,5,0,36,31
1657567345855,MATH 18,B03,083750,Rideout; David Porter,3,0,37,34
1657567345855,MATH 18,B04,083751,Rideout; David Porter,6,0,36,30
1657567345855,MATH 18,B05,093473,Rideout; David Porter,6,0,36,30
1657567345855,MATH 18,B06,093474,Rideout; David Porter,6,0,36,30
1657567351879,MATH 20A,A01,083754,Zheng; Zequn,14,0,40,26
1657567357901,MATH 20B,A01,083756,Briones; Jor-el Thomas Caparas,4,0,36,32
1657567357901,MATH 20B,A02,083757,Briones; Jor-el Thomas Caparas,1,0,36,35
1657567357901,MATH 20B,A03,093475,Briones; Jor-el Thomas Caparas,2,0,36,34
1657567363923,MATH 20C,A01,083760,Briones; Jor-el Thomas Caparas,1,0,35,34
1657567363923,MATH 20C,A02,083761,Briones; Jor-el Thomas Caparas,8,0,35,27
1657567363923,MATH 20C,A03,093476,Briones; Jor-el Thomas Caparas,0,1,36,36
1657567363923,MATH 20C,B01,083762,Bach; Quang Tran,1,0,30,29
1657567369951,MATH 20D,A01,083765,Tran; Brian Kha,5,0,30,25
1657567369951,MATH 20D,A02,083766,Tran; Brian Kha,5,0,30,25
1657567369951,MATH 20D,A03,083767,Tran; Brian Kha,5,0,30,25
1657567375975,MATH 20E,A01,083771,Ganguly; Soumya,9,0,32,23
1657567375975,MATH 20E,A02,083772,Ganguly; Soumya,6,0,32,26
1657567375975,MATH 20E,B01,083773,Ciotti; Benjamin,20,0,35,15
1657567375975,MATH 20E,B02,083774,Ciotti; Benjamin,17,0,35,18
1657567381997,MATH 103A,A01,083777,Greenfeld; Be'Eri,3,0,36,33
1657567381997,MATH 103A,A02,083778,Greenfeld; Be'Eri,5,0,36,31
1657567381997,MATH 103A,A03,093561,Greenfeld; Be'Eri,5,0,36,31
1657567381997,MATH 103A,B01,083779,Greenfeld; Be'Eri,7,0,36,29
1657567381997,MATH 103A,B02,083780,Greenfeld; Be'Eri,4,0,36,32
1657567381997,MATH 103A,B03,093562,Greenfeld; Be'Eri,3,0,36,33
1657567388029,MATH 105,A01,085443,Carter; Anne Toulson,15,0,35,20
1657567388029,MATH 105,A02,093477,Carter; Anne Toulson,20,0,35,15
1657567394057,MATH 109,A01,083213,Ganzberger; Geoffrey Michael,2,0,34,32
1657567394057,MATH 109,A02,083214,Ganzberger; Geoffrey Michael,4,0,34,30
1657567394057,MATH 109,A03,093478,Ganzberger; Geoffrey Michael,2,0,34,32
1657567394057,MATH 109,B01,083215,Ganzberger; Geoffrey Michael,1,0,32,31
1657567394057,MATH 109,B02,083216,Ganzberger; Geoffrey Michael,2,0,32,30
1657567394057,MATH 109,B03,093479,Ganzberger; Geoffrey Michael,8,0,32,24
1657567400084,MATH 142A,A01,083219,Chow; Bennett,7,0,32,25
1657567400084,MATH 142A,A02,083220,Chow; Bennett,10,0,32,22
1657567400084,MATH 142A,A03,093480,Chow; Bennett,8,0,32,24
1657567400084,MATH 142A,B03,093481,Chow; Bennett,8,0,32,24
1657567400084,MATH 142A,B04,093558,Chow; Bennett,13,0,32,19
1657567400084,MATH 142A,B05,093559,Chow; Bennett,6,0,32,26
1657567406107,MATH 193A,A01,083224,Rotar; Vladimir,8,0,34,26
1657567406107,MATH 193A,A02,083225,Rotar; Vladimir,9,0,34,25
1657567406107,MATH 193A,A03,083781,Rotar; Vladimir,5,0,34,29
1657567406107,MATH 193A,A04,083782,Rotar; Vladimir,10,0,34,24
1657567406107,MATH 193A,A05,093482,Rotar; Vladimir,10,0,34,24
1657567412143,MATH 197,001,091859,McAuley; Julian John,9999,0,9999,0
1657567412143,MATH 197,002,095566,Kedlaya; Kiran S.,9997,0,9999,2
1657567412143,MATH 197,003,095567,Xiao; Ming,9999,0,9999,0
1657567412143,MATH 197,004,095571,Perols; Johan Lars,9998,0,9999,1
1657567419216,COGS 9,A01,083615,Shannon; Kyle Michael,9,0,75,66
1657567425246,COGS 11,A01,083617,Boyle; Mary E. T.,23,0,48,25
1657567431268,COGS 13,A01,083071,Bastos; Amalia Pinkusfeld,11,0,71,60
1657567437294,COGS 14A,A01,092681,Semenuks; Arturs,5,1,100,95
1657567443328,COGS 14B,A01,083073,Cheng; Tzu-Han,6,0,63,57
1657567449356,COGS 17,A01,092677,Semenuks; Arturs,6,0,81,75
1657567455380,COGS 100,A01,083619,Allen; Michael Gordon,17,0,70,53
1657567461408,COGS 101A,A01,083621,Davis; Joshua Daniel,9,0,68,59
1657567467430,COGS 101B,A01,091572,Allen; Michael Gordon,12,0,65,53
1657567473452,COGS 101C,A01,083625,Delgado; Tania,17,0,35,18
1657567479479,COGS 107A,A01,083627,Boyle; Mary E. T.,13,0,60,47
1657567485512,COGS 118A,A01,083075,Gupta; Anjum,21,0,76,55
1657567491540,CSE 3,A50,083646,Miranda; Gregory Joseph,24,0,50,26
1657567497567,CSE 8A,A50,083650,Miranda; Gregory Joseph,17,1,56,39
1657567503590,CSE 11,A01,083080,Cao; Yingjun,6,15,40,34
1657567509617,CSE 12,A01,083652,Krause-Levy; Sophia Louisa,28,1,120,92
1657567515638,CSE 15L,A01,083654,Morris; Justin Loren,9,0,50,41
1657567515638,CSE 15L,A02,083655,Morris; Justin Loren,9,0,50,41
1657567521663,CSE 20,A01,083657,Tran; Khoa Dang,39,0,80,41
1657567527691,CSE 21,A01,095574,Bach; Quang Tran,22,0,48,26
1657567533713,CSE 30,A01,083084,Eldon; John,5,0,80,75
1657567533713,CSE 30,B01,095061,Bhaskar; Nishant,9,0,50,41
1657567539735,CSE 100,A01,083659,Cao; Yingjun,5,4,70,65
1657567545766,CSE 134B,A01,083661,Powell; Thomas Allan,22,0,100,78
1657567551805,CSE 140,A01,083663,Gungor; Onat,15,0,85,70
1657567557828,CSE 140L,A01,083088,Eldon; John,21,0,100,79
1657567563850,CSE 175,A01,083665,Kumar; Rakesh,3,0,25,22
1657567569872,CSE 190,A00,092507,Dubnov; Shlomo,8,0,20,12
1657567575897,ECE 45,A01,083139,Congero; Spencer William,6,0,75,69
1657567581921,ECE 65,A50,083695,Saad; Andrew S,12,0,30,18
1657567581921,ECE 65,A51,095125,Saad; Andrew S,24,0,26,2
1657567587945,ECE 109,A01,091882,Touri; Behrouz,19,0,70,51
1657567594041,ECE 180,A00,083140,Abi Samra; Nicholas Camill,1,0,30,29
1657567594041,ECE 180,B00,083141,Abi Samra; Nicholas Camill,0,0,30,30
1657567600065,MATH 10A,A01,083735,Patchell; Gregory David,2,0,30,28
1657567600065,MATH 10A,A02,083736,Patchell; Gregory David,20,0,30,10
1657567600065,MATH 10A,A03,083737,Patchell; Gregory David,16,0,30,14
1657567606092,MATH 10B,A01,083207,Lim; Seonhee,8,0,34,26
1657567606092,MATH 10B,A02,083208,Lim; Seonhee,9,0,35,26
1657567606092,MATH 10B,A03,093472,Lim; Seonhee,7,0,34,27
1657567606092,MATH 10B,B01,083739,Sinha; Shubham,12,0,30,18
1657567612125,MATH 18,A01,083743,Cinel; Cameron Alexander,7,0,30,23
1657567612125,MATH 18,A02,083744,Cinel; Cameron Alexander,17,0,30,13
1657567612125,MATH 18,A03,083745,Cinel; Cameron Alexander,9,0,30,21
1657567612125,MATH 18,B01,083748,Rideout; David Porter,5,0,37,32
1657567612125,MATH 18,B02,083749,Rideout; David Porter,5,0,36,31
1657567612125,MATH 18,B03,083750,Rideout; David Porter,3,0,37,34
1657567612125,MATH 18,B04,083751,Rideout; David Porter,6,0,36,30
1657567612125,MATH 18,B05,093473,Rideout; David Porter,6,0,36,30
1657567612125,MATH 18,B06,093474,Rideout; David Porter,6,0,36,30
1657567618148,MATH 20A,A01,083754,Zheng; Zequn,14,0,40,26
1657567624173,MATH 20B,A01,083756,Briones; Jor-el Thomas Caparas,4,0,36,32
1657567624173,MATH 20B,A02,083757,Briones; Jor-el Thomas Caparas,1,0,36,35
1657567624173,MATH 20B,A03,093475,Briones; Jor-el Thomas Caparas,2,0,36,34
1657567630197,MATH 20C,A01,083760,Briones; Jor-el Thomas Caparas,1,0,35,34
1657567630197,MATH 20C,A02,083761,Briones; Jor-el Thomas Caparas,8,0,35,27
1657567630197,MATH 20C,A03,093476,Briones; Jor-el Thomas Caparas,0,1,36,36
1657567630197,MATH 20C,B01,083762,Bach; Quang Tran,1,0,30,29
1657567636223,MATH 20D,A01,083765,Tran; Brian Kha,5,0,30,25
1657567636223,MATH 20D,A02,083766,Tran; Brian Kha,5,0,30,25
1657567636223,MATH 20D,A03,083767,Tran; Brian Kha,5,0,30,25
1657567642253,MATH 20E,A01,083771,Ganguly; Soumya,9,0,32,23
1657567642253,MATH 20E,A02,083772,Ganguly; Soumya,6,0,32,26
1657567642253,MATH 20E,B01,083773,Ciotti; Benjamin,20,0,35,15
1657567642253,MATH 20E,B02,083774,Ciotti; Benjamin,17,0,35,18
1657567648281,MATH 103A,A01,083777,Greenfeld; Be'Eri,3,0,36,33
1657567648281,MATH 103A,A02,083778,Greenfeld; Be'Eri,5,0,36,31
1657567648281,MATH 103A,A03,093561,Greenfeld; Be'Eri,5,0,36,31
1657567648281,MATH 103A,B01,083779,Greenfeld; Be'Eri,7,0,36,29
1657567648281,MATH 103A,B02,083780,Greenfeld; Be'Eri,4,0,36,32
1657567648281,MATH 103A,B03,093562,Greenfeld; Be'Eri,3,0,36,33
1657567654308,MATH 105,A01,085443,Carter; Anne Toulson,15,0,35,20
1657567654308,MATH 105,A02,093477,Carter; Anne Toulson,20,0,35,15
1657567660341,MATH 109,A01,083213,Ganzberger; Geoffrey Michael,2,0,34,32
1657567660341,MATH 109,A02,083214,Ganzberger; Geoffrey Michael,4,0,34,30
1657567660341,MATH 109,A03,093478,Ganzberger; Geoffrey Michael,2,0,34,32
1657567660341,MATH 109,B01,083215,Ganzberger; Geoffrey Michael,1,0,32,31
1657567660341,MATH 109,B02,083216,Ganzberger; Geoffrey Michael,2,0,32,30
1657567660341,MATH 109,B03,093479,Ganzberger; Geoffrey Michael,8,0,32,24
1657567666372,MATH 142A,A01,083219,Chow; Bennett,7,0,32,25
1657567666372,MATH 142A,A02,083220,Chow; Bennett,10,0,32,22
1657567666372,MATH 142A,A03,093480,Chow; Bennett,8,0,32,24
1657567666372,MATH 142A,B03,093481,Chow; Bennett,8,0,32,24
1657567666372,MATH 142A,B04,093558,Chow; Bennett,13,0,32,19
1657567666372,MATH 142A,B05,093559,Chow; Bennett,6,0,32,26
1657567672407,MATH 193A,A01,083224,Rotar; Vladimir,8,0,34,26
1657567672407,MATH 193A,A02,083225,Rotar; Vladimir,9,0,34,25
1657567672407,MATH 193A,A03,083781,Rotar; Vladimir,5,0,34,29
1657567672407,MATH 193A,A04,083782,Rotar; Vladimir,10,0,34,24
1657567672407,MATH 193A,A05,093482,Rotar; Vladimir,10,0,34,24
1657567678434,MATH 197,001,091859,McAuley; Julian John,9999,0,9999,0
1657567678434,MATH 197,002,095566,Kedlaya; Kiran S.,9997,0,9999,2
1657567678434,MATH 197,003,095567,Xiao; Ming,9999,0,9999,0
1657567678434,MATH 197,004,095571,Perols; Johan Lars,9998,0,9999,1
1657567685485,COGS 9,A01,083615,Shannon; Kyle Michael,9,0,75,66
1657567691515,COGS 11,A01,083617,Boyle; Mary E. T.,23,0,48,25
1657567697548,COGS 13,A01,083071,Bastos; Amalia Pinkusfeld,11,0,71,60
1657567703571,COGS 14A,A01,092681,Semenuks; Arturs,5,1,100,95
1657567709594,COGS 14B,A01,083073,Cheng; Tzu-Han,6,0,63,57
1657567715616,COGS 17,A01,092677,Semenuks; Arturs,6,0,81,75
1657567721643,COGS 100,A01,083619,Allen; Michael Gordon,17,0,70,53
1657567727681,COGS 101A,A01,083621,Davis; Joshua Daniel,9,0,68,59
1657567733704,COGS 101B,A01,091572,Allen; Michael Gordon,12,0,65,53
1657567739729,COGS 101C,A01,083625,Delgado; Tania,17,0,35,18
1657567745754,COGS 107A,A01,083627,Boyle; Mary E. T.,13,0,60,47
1657567751788,COGS 118A,A01,083075,Gupta; Anjum,21,0,76,55
1657567757811,CSE 3,A50,083646,Miranda; Gregory Joseph,24,0,50,26
1657567763835,CSE 8A,A50,083650,Miranda; Gregory Joseph,17,1,56,39
1657567769860,CSE 11,A01,083080,Cao; Yingjun,6,15,40,34
1657567775902,CSE 12,A01,083652,Krause-Levy; Sophia Louisa,28,1,120,92
1657567781929,CSE 15L,A01,083654,Morris; Justin Loren,9,0,50,41
1657567781929,CSE 15L,A02,083655,Morris; Justin Loren,9,0,50,41
1657567787955,CSE 20,A01,083657,Tran; Khoa Dang,39,0,80,41
1657567793983,CSE 21,A01,095574,Bach; Quang Tran,22,0,48,26
1657567800005,CSE 30,A01,083084,Eldon; John,5,0,80,75
1657567800005,CSE 30,B01,095061,Bhaskar; Nishant,9,0,50,41
1657567806032,CSE 100,A01,083659,Cao; Yingjun,5,4,70,65
1657567812053,CSE 134B,A01,083661,Powell; Thomas Allan,22,0,100,78
1657567818076,CSE 140,A01,083663,Gungor; Onat,15,0,85,70
1657567824099,CSE 140L,A01,083088,Eldon; John,21,0,100,79
1657567830142,CSE 175,A01,083665,Kumar; Rakesh,3,0,25,22
1657567836165,CSE 190,A00,092507,Dubnov; Shlomo,8,0,20,12
1657567842188,ECE 45,A01,083139,Congero; Spencer William,6,0,75,69
1657567848214,ECE 65,A50,083695,Saad; Andrew S,12,0,30,18
1657567848214,ECE 65,A51,095125,Saad; Andrew S,24,0,26,2
1657567854239,ECE 109,A01,091882,Touri; Behrouz,19,0,70,51
1657567860262,ECE 180,A00,083140,Abi Samra; Nicholas Camill,1,0,30,29
1657567860262,ECE 180,B00,083141,Abi Samra; Nicholas Camill,0,0,30,30
1657567866285,MATH 10A,A01,083735,Patchell; Gregory David,2,0,30,28
1657567866285,MATH 10A,A02,083736,Patchell; Gregory David,20,0,30,10
1657567866285,MATH 10A,A03,083737,Patchell; Gregory David,16,0,30,14
1657567872321,MATH 10B,A01,083207,Lim; Seonhee,8,0,34,26
1657567872321,MATH 10B,A02,083208,Lim; Seonhee,9,0,35,26
1657567872321,MATH 10B,A03,093472,Lim; Seonhee,7,0,34,27
1657567872321,MATH 10B,B01,083739,Sinha; Shubham,12,0,30,18
1657567878350,MATH 18,A01,083743,Cinel; Cameron Alexander,7,0,30,23
1657567878350,MATH 18,A02,083744,Cinel; Cameron Alexander,17,0,30,13
1657567878350,MATH 18,A03,083745,Cinel; Cameron Alexander,9,0,30,21
1657567878350,MATH 18,B01,083748,Rideout; David Porter,5,0,37,32
1657567878350,MATH 18,B02,083749,Rideout; David Porter,5,0,36,31
1657567878350,MATH 18,B03,083750,Rideout; David Porter,3,0,37,34
1657567878350,MATH 18,B04,083751,Rideout; David Porter,6,0,36,30
1657567878350,MATH 18,B05,093473,Rideout; David Porter,6,0,36,30
1657567878350,MATH 18,B06,093474,Rideout; David Porter,6,0,36,30
1657567884385,MATH 20A,A01,083754,Zheng; Zequn,14,0,40,26
1657567890416,MATH 20B,A01,083756,Briones; Jor-el Thomas Caparas,4,0,36,32
1657567890416,MATH 20B,A02,083757,Briones; Jor-el Thomas Caparas,1,0,36,35
1657567890416,MATH 20B,A03,093475,Briones; Jor-el Thomas Caparas,2,0,36,34
1657567896439,MATH 20C,A01,083760,Briones; Jor-el Thomas Caparas,1,0,35,34
1657567896439,MATH 20C,A02,083761,Briones; Jor-el Thomas Caparas,8,0,35,27
1657567896439,MATH 20C,A03,093476,Briones; Jor-el Thomas Caparas,0,1,36,36
1657567896439,MATH 20C,B01,083762,Bach; Quang Tran,1,0,30,29
1657567902462,MATH 20D,A01,083765,Tran; Brian Kha,5,0,30,25
1657567902462,MATH 20D,A02,083766,Tran; Brian Kha,5,0,30,25
1657567902462,MATH 20D,A03,083767,Tran; Brian Kha,5,0,30,25
1657567908497,MATH 20E,A01,083771,Ganguly; Soumya,9,0,32,23
1657567908497,MATH 20E,A02,083772,Ganguly; Soumya,6,0,32,26
1657567908497,MATH 20E,B01,083773,Ciotti; Benjamin,20,0,35,15
1657567908497,MATH 20E,B02,083774,Ciotti; Benjamin,17,0,35,18
1657567914527,MATH 103A,A01,083777,Greenfeld; Be'Eri,3,0,36,33
1657567914527,MATH 103A,A02,083778,Greenfeld; Be'Eri,5,0,36,31
1657567914527,MATH 103A,A03,093561,Greenfeld; Be'Eri,5,0,36,31
1657567914527,MATH 103A,B01,083779,Greenfeld; Be'Eri,7,0,36,29
1657567914527,MATH 103A,B02,083780,Greenfeld; Be'Eri,4,0,36,32
1657567914527,MATH 103A,B03,093562,Greenfeld; Be'Eri,3,0,36,33
1657567920550,MATH 105,A01,085443,Carter; Anne Toulson,15,0,35,20
1657567920550,MATH 105,A02,093477,Carter; Anne Toulson,20,0,35,15
1657567926579,MATH 109,A01,083213,Ganzberger; Geoffrey Michael,2,0,34,32
1657567926579,MATH 109,A02,083214,Ganzberger; Geoffrey Michael,4,0,34,30
1657567926579,MATH 109,A03,093478,Ganzberger; Geoffrey Michael,2,0,34,32
1657567926579,MATH 109,B01,083215,Ganzberger; Geoffrey Michael,1,0,32,31
1657567926579,MATH 109,B02,083216,Ganzberger; Geoffrey Michael,2,0,32,30
1657567926579,MATH 109,B03,093479,Ganzberger; Geoffrey Michael,8,0,32,24
1657567932604,MATH 142A,A01,083219,Chow; Bennett,7,0,32,25
1657567932604,MATH 142A,A02,083220,Chow; Bennett,10,0,32,22
1657567932604,MATH 142A,A03,093480,Chow; Bennett,8,0,32,24
1657567932604,MATH 142A,B03,093481,Chow; Bennett,8,0,32,24
1657567932604,MATH 142A,B04,093558,Chow; Bennett,13,0,32,19
1657567932604,MATH 142A,B05,093559,Chow; Bennett,6,0,32,26
1657567938631,MATH 193A,A01,083224,Rotar; Vladimir,8,0,34,26
1657567938631,MATH 193A,A02,083225,Rotar; Vladimir,9,0,34,25
1657567938631,MATH 193A,A03,083781,Rotar; Vladimir,5,0,34,29
1657567938631,MATH 193A,A04,083782,Rotar; Vladimir,10,0,34,24
1657567938631,MATH 193A,A05,093482,Rotar; Vladimir,10,0,34,24
1657567944657,MATH 197,001,091859,McAuley; Julian John,9999,0,9999,0
1657567944657,MATH 197,002,095566,Kedlaya; Kiran S.,9997,0,9999,2
1657567944657,MATH 197,003,095567,Xiao; Ming,9999,0,9999,0
1657567944657,MATH 197,004,095571,Perols; Johan Lars,9998,0,9999,1
1657567951776,COGS 9,A01,083615,Shannon; Kyle Michael,9,0,75,66
1657567957799,COGS 11,A01,083617,Boyle; Mary E. T.,23,0,48,25
1657567963822,COGS 13,A01,083071,Bastos; Amalia Pinkusfeld,11,0,71,60
1657567969843,COGS 14A,A01,092681,Semenuks; Arturs,5,1,100,95
1657567975869,COGS 14B,A01,083073,Cheng; Tzu-Han,6,0,63,57
1657567981895,COGS 17,A01,092677,Semenuks; Arturs,6,0,81,75
1657567987926,COGS 100,A01,083619,Allen; Michael Gordon,17,0,70,53
1657567993954,COGS 101A,A01,083621,Davis; Joshua Daniel,9,0,68,59
1657567999977,COGS 101B,A01,091572,Allen; Michael Gordon,12,0,65,53
1657568006004,COGS 101C,A01,083625,Delgado; Tania,17,0,35,18
1657568012026,COGS 107A,A01,083627,Boyle; Mary E. T.,13,0,60,47
1657568018049,COGS 118A,A01,083075,Gupta; Anjum,21,0,76,55
1657568024076,CSE 3,A50,083646,Miranda; Gregory Joseph,24,0,50,26
1657568030104,CSE 8A,A50,083650,Miranda; Gregory Joseph,17,1,56,39
1657568036127,CSE 11,A01,083080,Cao; Yingjun,6,15,40,34
1657568042163,CSE 12,A01,083652,Krause-Levy; Sophia Louisa,28,1,120,92
1657568048187,CSE 15L,A01,083654,Morris; Justin Loren,9,0,50,41
1657568048187,CSE 15L,A02,083655,Morris; Justin Loren,9,0,50,41
1657568054212,CSE 20,A01,083657,Tran; Khoa Dang,39,0,80,41
1657568060239,CSE 21,A01,095574,Bach; Quang Tran,22,0,48,26
1657568066262,CSE 30,A01,083084,Eldon; John,5,0,80,75
1657568066262,CSE 30,B01,095061,Bhaskar; Nishant,9,0,50,41
1657568072291,CSE 100,A01,083659,Cao; Yingjun,5,4,70,65
1657568078316,CSE 134B,A01,083661,Powell; Thomas Allan,22,0,100,78
1657568084356,CSE 140,A01,083663,Gungor; Onat,15,0,85,70
1657568090378,CSE 140L,A01,083088,Eldon; John,21,0,100,79
1657568096411,CSE 175,A01,083665,Kumar; Rakesh,3,0,25,22
1657568102435,CSE 190,A00,092507,Dubnov; Shlomo,8,0,20,12
1657568108468,ECE 45,A01,083139,Congero; Spencer William,6,0,75,69
1657568114492,ECE 65,A50,083695,Saad; Andrew S,12,0,30,18
1657568114492,ECE 65,A51,095125,Saad; Andrew S,24,0,26,2
1657568120515,ECE 109,A01,091882,Touri; Behrouz,19,0,70,51
1657568126537,ECE 180,A00,083140,Abi Samra; Nicholas Camill,1,0,30,29
1657568126537,ECE 180,B00,083141,Abi Samra; Nicholas Camill,0,0,30,30
1657568132564,MATH 10A,A01,083735,Patchell; Gregory David,2,0,30,28
1657568132564,MATH 10A,A02,083736,Patchell; Gregory David,20,0,30,10
1657568132564,MATH 10A,A03,083737,Patchell; Gregory David,16,0,30,14
1657568138607,MATH 10B,A01,083207,Lim; Seonhee,8,0,34,26
1657568138607,MATH 10B,A02,083208,Lim; Seonhee,9,0,35,26
1657568138607,MATH 10B,A03,093472,Lim; Seonhee,7,0,34,27
1657568138607,MATH 10B,B01,083739,Sinha; Shubham,12,0,30,18
1657568144637,MATH 18,A01,083743,Cinel; Cameron Alexander,7,0,30,23
1657568144637,MATH 18,A02,083744,Cinel; Cameron Alexander,17,0,30,13
1657568144637,MATH 18,A03,083745,Cinel; Cameron Alexander,9,0,30,21
1657568144637,MATH 18,B01,083748,Rideout; David Porter,5,0,37,32
1657568144637,MATH 18,B02,083749,Rideout; David Porter,5,0,36,31
1657568144637,MATH 18,B03,083750,Rideout; David Porter,3,0,37,34
1657568144637,MATH 18,B04,083751,Rideout; David Porter,6,0,36,30
1657568144637,MATH 18,B05,093473,Rideout; David Porter,6,0,36,30
1657568144637,MATH 18,B06,093474,Rideout; David Porter,6,0,36,30
1657568150663,MATH 20A,A01,083754,Zheng; Zequn,14,0,40,26
1657568156699,MATH 20B,A01,083756,Briones; Jor-el Thomas Caparas,4,0,36,32
1657568156699,MATH 20B,A02,083757,Briones; Jor-el Thomas Caparas,1,0,36,35
1657568156699,MATH 20B,A03,093475,Briones; Jor-el Thomas Caparas,2,0,36,34
1657568162723,MATH 20C,A01,083760,Briones; Jor-el Thomas Caparas,1,0,35,34
1657568162723,MATH 20C,A02,083761,Briones; Jor-el Thomas Caparas,8,0,35,27
1657568162723,MATH 20C,A03,093476,Briones; Jor-el Thomas Caparas,0,1,36,36
1657568162723,MATH 20C,B01,083762,Bach; Quang Tran,1,0,30,29
1657568168751,MATH 20D,A01,083765,Tran; Brian Kha,5,0,30,25
1657568168751,MATH 20D,A02,083766,Tran; Brian Kha,5,0,30,25
1657568168751,MATH 20D,A03,083767,Tran; Brian Kha,5,0,30,25
1657568174774,MATH 20E,A01,083771,Ganguly; Soumya,9,0,32,23
1657568174774,MATH 20E,A02,083772,Ganguly; Soumya,6,0,32,26
1657568174774,MATH 20E,B01,083773,Ciotti; Benjamin,20,0,35,15
1657568174774,MATH 20E,B02,083774,Ciotti; Benjamin,17,0,35,18
1657568180814,MATH 103A,A01,083777,Greenfeld; Be'Eri,3,0,36,33
1657568180814,MATH 103A,A02,083778,Greenfeld; Be'Eri,5,0,36,31
1657568180814,MATH 103A,A03,093561,Greenfeld; Be'Eri,5,0,36,31
1657568180814,MATH 103A,B01,083779,Greenfeld; Be'Eri,7,0,36,29
1657568180814,MATH 103A,B02,083780,Greenfeld; Be'Eri,4,0,36,32
1657568180814,MATH 103A,B03,093562,Greenfeld; Be'Eri,3,0,36,33
1657568186845,MATH 105,A01,085443,Carter; Anne Toulson,15,0,35,20
1657568186845,MATH 105,A02,093477,Carter; Anne Toulson,20,0,35,15
1657568192961,MATH 109,A01,083213,Ganzberger; Geoffrey Michael,2,0,34,32
1657568192961,MATH 109,A02,083214,Ganzberger; Geoffrey Michael,4,0,34,30
1657568192961,MATH 109,A03,093478,Ganzberger; Geoffrey Michael,2,0,34,32
1657568192961,MATH 109,B01,083215,Ganzberger; Geoffrey Michael,1,0,32,31
1657568192961,MATH 109,B02,083216,Ganzberger; Geoffrey Michael,2,0,32,30
1657568192961,MATH 109,B03,093479,Ganzberger; Geoffrey Michael,8,0,32,24
1657568198990,MATH 142A,A01,083219,Chow; Bennett,7,0,32,25
1657568198990,MATH 142A,A02,083220,Chow; Bennett,10,0,32,22
1657568198990,MATH 142A,A03,093480,Chow; Bennett,8,0,32,24
1657568198990,MATH 142A,B03,093481,Chow; Bennett,8,0,32,24
1657568198990,MATH 142A,B04,093558,Chow; Bennett,13,0,32,19
1657568198990,MATH 142A,B05,093559,Chow; Bennett,6,0,32,26
1657568205014,MATH 193A,A01,083224,Rotar; Vladimir,8,0,34,26
1657568205014,MATH 193A,A02,083225,Rotar; Vladimir,9,0,34,25
1657568205014,MATH 193A,A03,083781,Rotar; Vladimir,5,0,34,29
1657568205014,MATH 193A,A04,083782,Rotar; Vladimir,10,0,34,24
1657568205014,MATH 193A,A05,093482,Rotar; Vladimir,10,0,34,24
1657568211071,MATH 197,001,091859,McAuley; Julian John,9999,0,9999,0
1657568211071,MATH 197,002,095566,Kedlaya; Kiran S.,9997,0,9999,2
1657568211071,MATH 197,003,095567,Xiao; Ming,9999,0,9999,0
1657568211071,MATH 197,004,095571,Perols; Johan Lars,9998,0,9999,1
1657568218132,COGS 9,A01,083615,Shannon; Kyle Michael,9,0,75,66
1657568224155,COGS 11,A01,083617,Boyle; Mary E. T.,23,0,48,25
1657568230181,COGS 13,A01,083071,Bastos; Amalia Pinkusfeld,11,0,71,60
1657568236207,COGS 14A,A01,092681,Semenuks; Arturs,5,1,100,95
1657568242233,COGS 14B,A01,083073,Cheng; Tzu-Han,6,0,63,57
1657568248254,COGS 17,A01,092677,Semenuks; Arturs,6,0,81,75
1657568254276,COGS 100,A01,083619,Allen; Michael Gordon,17,0,70,53
1657568260303,COGS 101A,A01,083621,Davis; Joshua Daniel,9,0,68,59
1657568266331,COGS 101B,A01,091572,Allen; Michael Gordon,12,0,65,53
1657568272355,COGS 101C,A01,083625,Delgado; Tania,17,0,35,18
1657568278377,COGS 107A,A01,083627,Boyle; Mary E. T.,13,0,60,47
1657568284402,COGS 118A,A01,083075,Gupta; Anjum,21,0,76,55
1657568290426,CSE 3,A50,083646,Miranda; Gregory Joseph,24,0,50,26
1657568296448,CSE 8A,A50,083650,Miranda; Gregory Joseph,17,1,56,39
1657568302471,CSE 11,A01,083080,Cao; Yingjun,6,15,40,34
1657568308497,CSE 12,A01,083652,Krause-Levy; Sophia Louisa,28,1,120,92
1657568314523,CSE 15L,A01,083654,Morris; Justin Loren,9,0,50,41
1657568314523,CSE 15L,A02,083655,Morris; Justin Loren,9,0,50,41
1657568320546,CSE 20,A01,083657,Tran; Khoa Dang,39,0,80,41
1657568326567,CSE 21,A01,095574,Bach; Quang Tran,22,0,48,26
1657568332591,CSE 30,A01,083084,Eldon; John,5,0,80,75
1657568332591,CSE 30,B01,095061,Bhaskar; Nishant,9,0,50,41
1657568338617,CSE 100,A01,083659,Cao; Yingjun,5,4,70,65
1657568344651,CSE 134B,A01,083661,Powell; Thomas Allan,22,0,100,78
1657568350682,CSE 140,A01,083663,Gungor; Onat,15,0,85,70
1657568356703,CSE 140L,A01,083088,Eldon; John,21,0,100,79
1657568362729,CSE 175,A01,083665,Kumar; Rakesh,3,0,25,22
1657568368756,CSE 190,A00,092507,Dubnov; Shlomo,8,0,20,12
1657568374778,ECE 45,A01,083139,Congero; Spencer William,6,0,75,69
1657568380804,ECE 65,A50,083695,Saad; Andrew S,12,0,30,18
1657568380804,ECE 65,A51,095125,Saad; Andrew S,24,0,26,2
1657568386826,ECE 109,A01,091882,Touri; Behrouz,19,0,70,51
1657568392853,ECE 180,A00,083140,Abi Samra; Nicholas Camill,1,0,30,29
1657568392853,ECE 180,B00,083141,Abi Samra; Nicholas Camill,0,0,30,30
1657568398900,MATH 10A,A01,083735,Patchell; Gregory David,2,0,30,28
1657568398900,MATH 10A,A02,083736,Patchell; Gregory David,20,0,30,10
1657568398900,MATH 10A,A03,083737,Patchell; Gregory David,16,0,30,14
1657568404928,MATH 10B,A01,083207,Lim; Seonhee,8,0,34,26
1657568404928,MATH 10B,A02,083208,Lim; Seonhee,9,0,35,26
1657568404928,MATH 10B,A03,093472,Lim; Seonhee,7,0,34,27
1657568404928,MATH 10B,B01,083739,Sinha; Shubham,12,0,30,18
1657568410951,MATH 18,A01,083743,Cinel; Cameron Alexander,7,0,30,23
1657568410951,MATH 18,A02,083744,Cinel; Cameron Alexander,17,0,30,13
1657568410951,MATH 18,A03,083745,Cinel; Cameron Alexander,9,0,30,21
1657568410951,MATH 18,B01,083748,Rideout; David Porter,5,0,37,32
1657568410951,MATH 18,B02,083749,Rideout; David Porter,5,0,36,31
1657568410951,MATH 18,B03,083750,Rideout; David Porter,3,0,37,34
1657568410951,MATH 18,B04,083751,Rideout; David Porter,6,0,36,30
1657568410951,MATH 18,B05,093473,Rideout; David Porter,6,0,36,30
1657568410951,MATH 18,B06,093474,Rideout; David Porter,6,0,36,30
1657568416983,MATH 20A,A01,083754,Zheng; Zequn,14,0,40,26
1657568423010,MATH 20B,A01,083756,Briones; Jor-el Thomas Caparas,4,0,36,32
1657568423010,MATH 20B,A02,083757,Briones; Jor-el Thomas Caparas,1,0,36,35
1657568423010,MATH 20B,A03,093475,Briones; Jor-el Thomas Caparas,2,0,36,34
1657568429032,MATH 20C,A01,083760,Briones; Jor-el Thomas Caparas,1,0,35,34
1657568429032,MATH 20C,A02,083761,Briones; Jor-el Thomas Caparas,8,0,35,27
1657568429032,MATH 20C,A03,093476,Briones; Jor-el Thomas Caparas,0,1,36,36
1657568429032,MATH 20C,B01,083762,Bach; Quang Tran,1,0,30,29
1657568435055,MATH 20D,A01,083765,Tran; Brian Kha,5,0,30,25
1657568435055,MATH 20D,A02,083766,Tran; Brian Kha,5,0,30,25
1657568435055,MATH 20D,A03,083767,Tran; Brian Kha,5,0,30,25
1657568441093,MATH 20E,A01,083771,Ganguly; Soumya,9,0,32,23
1657568441093,MATH 20E,A02,083772,Ganguly; Soumya,6,0,32,26
1657568441093,MATH 20E,B01,083773,Ciotti; Benjamin,20,0,35,15
1657568441093,MATH 20E,B02,083774,Ciotti; Benjamin,17,0,35,18
1657568447128,MATH 103A,A01,083777,Greenfeld; Be'Eri,3,0,36,33
1657568447128,MATH 103A,A02,083778,Greenfeld; Be'Eri,5,0,36,31
1657568447128,MATH 103A,A03,093561,Greenfeld; Be'Eri,5,0,36,31
1657568447128,MATH 103A,B01,083779,Greenfeld; Be'Eri,7,0,36,29
1657568447128,MATH 103A,B02,083780,Greenfeld; Be'Eri,4,0,36,32
1657568447128,MATH 103A,B03,093562,Greenfeld; Be'Eri,3,0,36,33
1657568453148,MATH 105,A01,085443,Carter; Anne Toulson,15,0,35,20
1657568453148,MATH 105,A02,093477,Carter; Anne Toulson,20,0,35,15
1657568459170,MATH 109,A01,083213,Ganzberger; Geoffrey Michael,2,0,34,32
1657568459170,MATH 109,A02,083214,Ganzberger; Geoffrey Michael,4,0,34,30
1657568459170,MATH 109,A03,093478,Ganzberger; Geoffrey Michael,2,0,34,32
1657568459170,MATH 109,B01,083215,Ganzberger; Geoffrey Michael,1,0,32,31
1657568459170,MATH 109,B02,083216,Ganzberger; Geoffrey Michael,2,0,32,30
1657568459170,MATH 109,B03,093479,Ganzberger; Geoffrey Michael,8,0,32,24
1657568465193,MATH 142A,A01,083219,Chow; Bennett,7,0,32,25
1657568465193,MATH 142A,A02,083220,Chow; Bennett,10,0,32,22
1657568465193,MATH 142A,A03,093480,Chow; Bennett,8,0,32,24
1657568465193,MATH 142A,B03,093481,Chow; Bennett,8,0,32,24
1657568465193,MATH 142A,B04,093558,Chow; Bennett,13,0,32,19
1657568465193,MATH 142A,B05,093559,Chow; Bennett,6,0,32,26
1657568471224,MATH 193A,A01,083224,Rotar; Vladimir,8,0,34,26
1657568471224,MATH 193A,A02,083225,Rotar; Vladimir,9,0,34,25
1657568471224,MATH 193A,A03,083781,Rotar; Vladimir,5,0,34,29
1657568471224,MATH 193A,A04,083782,Rotar; Vladimir,10,0,34,24
1657568471224,MATH 193A,A05,093482,Rotar; Vladimir,10,0,34,24
1657568477256,MATH 197,001,091859,McAuley; Julian John,9999,0,9999,0
1657568477256,MATH 197,002,095566,Kedlaya; Kiran S.,9997,0,9999,2
1657568477256,MATH 197,003,095567,Xiao; Ming,9999,0,9999,0
1657568477256,MATH 197,004,095571,Perols; Johan Lars,9998,0,9999,1
1657568484318,COGS 9,A01,083615,Shannon; Kyle Michael,9,0,75,66
1657568490341,COGS 11,A01,083617,Boyle; Mary E. T.,23,0,48,25
1657568496363,COGS 13,A01,083071,Bastos; Amalia Pinkusfeld,11,0,71,60
1657568502400,COGS 14A,A01,092681,Semenuks; Arturs,5,1,100,95
1657568508421,COGS 14B,A01,083073,Cheng; Tzu-Han,6,0,63,57
1657568514444,COGS 17,A01,092677,Semenuks; Arturs,6,0,81,75
1657568520484,COGS 100,A01,083619,Allen; Michael Gordon,17,0,70,53
1657568526511,COGS 101A,A01,083621,Davis; Joshua Daniel,9,0,68,59
1657568532543,COGS 101B,A01,091572,Allen; Michael Gordon,12,0,65,53
1657568538570,COGS 101C,A01,083625,Delgado; Tania,17,0,35,18
1657568544603,COGS 107A,A01,083627,Boyle; Mary E. T.,13,0,60,47
1657568550629,COGS 118A,A01,083075,Gupta; Anjum,21,0,76,55
1657568556656,CSE 3,A50,083646,Miranda; Gregory Joseph,24,0,50,26
1657568562682,CSE 8A,A50,083650,Miranda; Gregory Joseph,17,1,56,39
1657568568707,CSE 11,A01,083080,Cao; Yingjun,6,15,40,34
1657568574741,CSE 12,A01,083652,Krause-Levy; Sophia Louisa,28,1,120,92
1657568580764,CSE 15L,A01,083654,Morris; Justin Loren,9,0,50,41
1657568580764,CSE 15L,A02,083655,Morris; Justin Loren,9,0,50,41
1657568586796,CSE 20,A01,083657,Tran; Khoa Dang,39,0,80,41
1657568592826,CSE 21,A01,095574,Bach; Quang Tran,22,0,48,26
1657568598862,CSE 30,A01,083084,Eldon; John,5,0,80,75
1657568598862,CSE 30,B01,095061,Bhaskar; Nishant,9,0,50,41
1657568604885,CSE 100,A01,083659,Cao; Yingjun,5,4,70,65
1657568610912,CSE 134B,A01,083661,Powell; Thomas Allan,22,0,100,78
1657568616948,CSE 140,A01,083663,Gungor; Onat,15,0,85,70
1657568622972,CSE 140L,A01,083088,Eldon; John,21,0,100,79
1657568628998,CSE 175,A01,083665,Kumar; Rakesh,3,0,25,22
1657568635031,CSE 190,A00,092507,Dubnov; Shlomo,8,0,20,12
1657568641059,ECE 45,A01,083139,Congero; Spencer William,6,0,75,69
1657568647086,ECE 65,A50,083695,Saad; Andrew S,12,0,30,18
1657568647086,ECE 65,A51,095125,Saad; Andrew S,24,0,26,2
1657568653114,ECE 109,A01,091882,Touri; Behrouz,19,0,70,51
1657568659137,ECE 180,A00,083140,Abi Samra; Nicholas Camill,1,0,30,29
1657568659137,ECE 180,B00,083141,Abi Samra; Nicholas Camill,0,0,30,30
1657568665166,MATH 10A,A01,083735,Patchell; Gregory David,2,0,30,28
1657568665166,MATH 10A,A02,083736,Patchell; Gregory David,20,0,30,10
1657568665166,MATH 10A,A03,083737,Patchell; Gregory David,16,0,30,14
1657568671199,MATH 10B,A01,083207,Lim; Seonhee,8,0,34,26
1657568671199,MATH 10B,A02,083208,Lim; Seonhee,9,0,35,26
1657568671199,MATH 10B,A03,093472,Lim; Seonhee,7,0,34,27
1657568671199,MATH 10B,B01,083739,Sinha; Shubham,12,0,30,18
1657568677228,MATH 18,A01,083743,Cinel; Cameron Alexander,7,0,30,23
1657568677228,MATH 18,A02,083744,Cinel; Cameron Alexander,17,0,30,13
1657568677228,MATH 18,A03,083745,Cinel; Cameron Alexander,9,0,30,21
1657568677228,MATH 18,B01,083748,Rideout; David Porter,5,0,37,32
1657568677228,MATH 18,B02,083749,Rideout; David Porter,5,0,36,31
1657568677228,MATH 18,B03,083750,Rideout; David Porter,3,0,37,34
1657568677228,MATH 18,B04,083751,Rideout; David Porter,6,0,36,30
1657568677228,MATH 18,B05,093473,Rideout; David Porter,6,0,36,30
1657568677228,MATH 18,B06,093474,Rideout; David Porter,6,0,36,30
1657568683252,MATH 20A,A01,083754,Zheng; Zequn,14,0,40,26
1657568689280,MATH 20B,A01,083756,Briones; Jor-el Thomas Caparas,4,0,36,32
1657568689280,MATH 20B,A02,083757,Briones; Jor-el Thomas Caparas,1,0,36,35
1657568689280,MATH 20B,A03,093475,Briones; Jor-el Thomas Caparas,2,0,36,34
1657568695304,MATH 20C,A01,083760,Briones; Jor-el Thomas Caparas,1,0,35,34
1657568695304,MATH 20C,A02,083761,Briones; Jor-el Thomas Caparas,8,0,35,27
1657568695304,MATH 20C,A03,093476,Briones; Jor-el Thomas Caparas,0,1,36,36
1657568695304,MATH 20C,B01,083762,Bach; Quang Tran,1,0,30,29
1657568701333,MATH 20D,A01,083765,Tran; Brian Kha,5,0,30,25
1657568701333,MATH 20D,A02,083766,Tran; Brian Kha,5,0,30,25
1657568701333,MATH 20D,A03,083767,Tran; Brian Kha,5,0,30,25
1657568707368,MATH 20E,A01,083771,Ganguly; Soumya,9,0,32,23
1657568707368,MATH 20E,A02,083772,Ganguly; Soumya,6,0,32,26
1657568707368,MATH 20E,B01,083773,Ciotti; Benjamin,20,0,35,15
1657568707368,MATH 20E,B02,083774,Ciotti; Benjamin,17,0,35,18
1657568713391,MATH 103A,A01,083777,Greenfeld; Be'Eri,3,0,36,33
1657568713391,MATH 103A,A02,083778,Greenfeld; Be'Eri,5,0,36,31
1657568713391,MATH 103A,A03,093561,Greenfeld; Be'Eri,5,0,36,31
1657568713391,MATH 103A,B01,083779,Greenfeld; Be'Eri,7,0,36,29
1657568713391,MATH 103A,B02,083780,Greenfeld; Be'Eri,4,0,36,32
1657568713391,MATH 103A,B03,093562,Greenfeld; Be'Eri,3,0,36,33
1657568719421,MATH 105,A01,085443,Carter; Anne Toulson,15,0,35,20
1657568719421,MATH 105,A02,093477,Carter; Anne Toulson,20,0,35,15
1657568725449,MATH 109,A01,083213,Ganzberger; Geoffrey Michael,2,0,34,32
1657568725449,MATH 109,A02,083214,Ganzberger; Geoffrey Michael,4,0,34,30
1657568725449,MATH 109,A03,093478,Ganzberger; Geoffrey Michael,2,0,34,32
1657568725449,MATH 109,B01,083215,Ganzberger; Geoffrey Michael,1,0,32,31
1657568725449,MATH 109,B02,083216,Ganzberger; Geoffrey Michael,2,0,32,30
1657568725449,MATH 109,B03,093479,Ganzberger; Geoffrey Michael,8,0,32,24
1657568731478,MATH 142A,A01,083219,Chow; Bennett,7,0,32,25
1657568731478,MATH 142A,A02,083220,Chow; Bennett,10,0,32,22
1657568731478,MATH 142A,A03,093480,Chow; Bennett,8,0,32,24
1657568731478,MATH 142A,B03,093481,Chow; Bennett,8,0,32,24
1657568731478,MATH 142A,B04,093558,Chow; Bennett,13,0,32,19
1657568731478,MATH 142A,B05,093559,Chow; Bennett,6,0,32,26
1657568737501,MATH 193A,A01,083224,Rotar; Vladimir,8,0,34,26
1657568737501,MATH 193A,A02,083225,Rotar; Vladimir,9,0,34,25
1657568737501,MATH 193A,A03,083781,Rotar; Vladimir,5,0,34,29
1657568737501,MATH 193A,A04,083782,Rotar; Vladimir,10,0,34,24
1657568737501,MATH 193A,A05,093482,Rotar; Vladimir,10,0,34,24
1657568743531,MATH 197,001,091859,McAuley; Julian John,9999,0,9999,0
1657568743531,MATH 197,002,095566,Kedlaya; Kiran S.,9997,0,9999,2
1657568743531,MATH 197,003,095567,Xiao; Ming,9999,0,9999,0
1657568743531,MATH 197,004,095571,Perols; Johan Lars,9998,0,9999,1
1657568750589,COGS 9,A01,083615,Shannon; Kyle Michael,9,0,75,66
1657568756620,COGS 11,A01,083617,Boyle; Mary E. T.,23,0,48,25
1657568762655,COGS 13,A01,083071,Bastos; Amalia Pinkusfeld,11,0,71,60
1657568768677,COGS 14A,A01,092681,Semenuks; Arturs,5,1,100,95
1657568774704,COGS 14B,A01,083073,Cheng; Tzu-Han,6,0,63,57
1657568780727,COGS 17,A01,092677,Semenuks; Arturs,6,0,81,75
1657568786835,COGS 100,A01,083619,Allen; Michael Gordon,17,0,70,53
1657568792859,COGS 101A,A01,083621,Davis; Joshua Daniel,9,0,68,59
1657568798886,COGS 101B,A01,091572,Allen; Michael Gordon,12,0,65,53
1657568804918,COGS 101C,A01,083625,Delgado; Tania,17,0,35,18
1657568810940,COGS 107A,A01,083627,Boyle; Mary E. T.,13,0,60,47
1657568816964,COGS 118A,A01,083075,Gupta; Anjum,21,0,76,55
1657568822991,CSE 3,A50,083646,Miranda; Gregory Joseph,24,0,50,26
1657568829014,CSE 8A,A50,083650,Miranda; Gregory Joseph,17,1,56,39
1657568835041,CSE 11,A01,083080,Cao; Yingjun,6,15,40,34
1657568841064,CSE 12,A01,083652,Krause-Levy; Sophia Louisa,28,1,120,92
1657568847091,CSE 15L,A01,083654,Morris; Justin Loren,9,0,50,41
1657568847091,CSE 15L,A02,083655,Morris; Justin Loren,9,0,50,41
1657568853114,CSE 20,A01,083657,Tran; Khoa Dang,39,0,80,41
1657568859136,CSE 21,A01,095574,Bach; Quang Tran,22,0,48,26
1657568865158,CSE 30,A01,083084,Eldon; John,5,0,80,75
1657568865158,CSE 30,B01,095061,Bhaskar; Nishant,9,0,50,41
1657568871184,CSE 100,A01,083659,Cao; Yingjun,5,4,70,65
1657568877208,CSE 134B,A01,083661,Powell; Thomas Allan,22,0,100,78
1657568883233,CSE 140,A01,083663,Gungor; Onat,15,0,85,70
1657568889255,CSE 140L,A01,083088,Eldon; John,21,0,100,79
1657568895285,CSE 175,A01,083665,Kumar; Rakesh,3,0,25,22
1657568901307,CSE 190,A00,092507,Dubnov; Shlomo,8,0,20,12
1657568907335,ECE 45,A01,083139,Congero; Spencer William,6,0,75,69
1657568913357,ECE 65,A50,083695,Saad; Andrew S,12,0,30,18
1657568913357,ECE 65,A51,095125,Saad; Andrew S,24,0,26,2
1657568919380,ECE 109,A01,091882,Touri; Behrouz,19,0,70,51
1657568925409,ECE 180,A00,083140,Abi Samra; Nicholas Camill,1,0,30,29
1657568925409,ECE 180,B00,083141,Abi Samra; Nicholas Camill,0,0,30,30
1657568931435,MATH 10A,A01,083735,Patchell; Gregory David,2,0,30,28
1657568931435,MATH 10A,A02,083736,Patchell; Gregory David,20,0,30,10
1657568931435,MATH 10A,A03,083737,Patchell; Gregory David,16,0,30,14
1657568937459,MATH 10B,A01,083207,Lim; Seonhee,8,0,34,26
1657568937459,MATH 10B,A02,083208,Lim; Seonhee,9,0,35,26
1657568937459,MATH 10B,A03,093472,Lim; Seonhee,7,0,34,27
1657568937459,MATH 10B,B01,083739,Sinha; Shubham,12,0,30,18
1657568943488,MATH 18,A01,083743,Cinel; Cameron Alexander,7,0,30,23
1657568943488,MATH 18,A02,083744,Cinel; Cameron Alexander,17,0,30,13
1657568943488,MATH 18,A03,083745,Cinel; Cameron Alexander,9,0,30,21
1657568943488,MATH 18,B01,083748,Rideout; David Porter,5,0,37,32
1657568943488,MATH 18,B02,083749,Rideout; David Porter,5,0,36,31
1657568943488,MATH 18,B03,083750,Rideout; David Porter,3,0,37,34
1657568943488,MATH 18,B04,083751,Rideout; David Porter,6,0,36,30
1657568943488,MATH 18,B05,093473,Rideout; David Porter,6,0,36,30
1657568943488,MATH 18,B06,093474,Rideout; David Porter,6,0,36,30
1657568949516,MATH 20A,A01,083754,Zheng; Zequn,14,0,40,26
1657568955544,MATH 20B,A01,083756,Briones; Jor-el Thomas Caparas,4,0,36,32
1657568955544,MATH 20B,A02,083757,Briones; Jor-el Thomas Caparas,1,0,36,35
1657568955544,MATH 20B,A03,093475,Briones; Jor-el Thomas Caparas,2,0,36,34
1657568961568,MATH 20C,A01,083760,Briones; Jor-el Thomas Caparas,1,0,35,34
1657568961568,MATH 20C,A02,083761,Briones; Jor-el Thomas Caparas,8,0,35,27
1657568961568,MATH 20C,A03,093476,Briones; Jor-el Thomas Caparas,0,1,36,36
1657568961568,MATH 20C,B01,083762,Bach; Quang Tran,1,0,30,29
1657568967595,MATH 20D,A01,083765,Tran; Brian Kha,5,0,30,25
1657568967595,MATH 20D,A02,083766,Tran; Brian Kha,5,0,30,25
1657568967595,MATH 20D,A03,083767,Tran; Brian Kha,5,0,30,25
1657568973635,MATH 20E,A01,083771,Ganguly; Soumya,9,0,32,23
1657568973635,MATH 20E,A02,083772,Ganguly; Soumya,6,0,32,26
1657568973635,MATH 20E,B01,083773,Ciotti; Benjamin,20,0,35,15
1657568973635,MATH 20E,B02,083774,Ciotti; Benjamin,17,0,35,18
1657568979667,MATH 103A,A01,083777,Greenfeld; Be'Eri,3,0,36,33
1657568979667,MATH 103A,A02,083778,Greenfeld; Be'Eri,5,0,36,31
1657568979667,MATH 103A,A03,093561,Greenfeld; Be'Eri,5,0,36,31
1657568979667,MATH 103A,B01,083779,Greenfeld; Be'Eri,7,0,36,29
1657568979667,MATH 103A,B02,083780,Greenfeld; Be'Eri,4,0,36,32
1657568979667,MATH 103A,B03,093562,Greenfeld; Be'Eri,3,0,36,33
1657568985691,MATH 105,A01,085443,Carter; Anne Toulson,15,0,35,20
1657568985691,MATH 105,A02,093477,Carter; Anne Toulson,20,0,35,15
1657568991716,MATH 109,A01,083213,Ganzberger; Geoffrey Michael,2,0,34,32
1657568991716,MATH 109,A02,083214,Ganzberger; Geoffrey Michael,4,0,34,30
1657568991716,MATH 109,A03,093478,Ganzberger; Geoffrey Michael,2,0,34,32
1657568991716,MATH 109,B01,083215,Ganzberger; Geoffrey Michael,1,0,32,31
1657568991716,MATH 109,B02,083216,Ganzberger; Geoffrey Michael,2,0,32,30
1657568991716,MATH 109,B03,093479,Ganzberger; Geoffrey Michael,8,0,32,24
1657568997745,MATH 142A,A01,083219,Chow; Bennett,7,0,32,25
1657568997745,MATH 142A,A02,083220,Chow; Bennett,10,0,32,22
1657568997745,MATH 142A,A03,093480,Chow; Bennett,8,0,32,24
1657568997745,MATH 142A,B03,093481,Chow; Bennett,8,0,32,24
1657568997745,MATH 142A,B04,093558,Chow; Bennett,13,0,32,19
1657568997745,MATH 142A,B05,093559,Chow; Bennett,6,0,32,26
1657569003773,MATH 193A,A01,083224,Rotar; Vladimir,8,0,34,26
1657569003773,MATH 193A,A02,083225,Rotar; Vladimir,9,0,34,25
1657569003773,MATH 193A,A03,083781,Rotar; Vladimir,5,0,34,29
1657569003773,MATH 193A,A04,083782,Rotar; Vladimir,10,0,34,24
1657569003773,MATH 193A,A05,093482,Rotar; Vladimir,10,0,34,24
1657569009801,MATH 197,001,091859,McAuley; Julian John,9999,0,9999,0
1657569009801,MATH 197,002,095566,Kedlaya; Kiran S.,9997,0,9999,2
1657569009801,MATH 197,003,095567,Xiao; Ming,9999,0,9999,0
1657569009801,MATH 197,004,095571,Perols; Johan Lars,9998,0,9999,1
1657569016859,COGS 9,A01,083615,Shannon; Kyle Michael,9,0,75,66
1657569022883,COGS 11,A01,083617,Boyle; Mary E. T.,23,0,48,25
1657569028906,COGS 13,A01,083071,Bastos; Amalia Pinkusfeld,11,0,71,60
1657569034933,COGS 14A,A01,092681,Semenuks; Arturs,5,1,100,95
1657569040957,COGS 14B,A01,083073,Cheng; Tzu-Han,6,0,63,57
1657569046980,COGS 17,A01,092677,Semenuks; Arturs,6,0,81,75
1657569053007,COGS 100,A01,083619,Allen; Michael Gordon,17,0,70,53
1657569059031,COGS 101A,A01,083621,Davis; Joshua Daniel,9,0,68,59
1657569065052,COGS 101B,A01,091572,Allen; Michael Gordon,12,0,65,53
1657569071100,COGS 101C,A01,083625,Delgado; Tania,17,0,35,18
1657569077124,COGS 107A,A01,083627,Boyle; Mary E. T.,13,0,60,47
1657569083147,COGS 118A,A01,083075,Gupta; Anjum,21,0,76,55
1657569089171,CSE 3,A50,083646,Miranda; Gregory Joseph,24,0,50,26
1657569095200,CSE 8A,A50,083650,Miranda; Gregory Joseph,17,1,56,39
1657569101220,CSE 11,A01,083080,Cao; Yingjun,6,15,40,34
1657569107243,CSE 12,A01,083652,Krause-Levy; Sophia Louisa,28,1,120,92
1657569113265,CSE 15L,A01,083654,Morris; Justin Loren,9,0,50,41
1657569113265,CSE 15L,A02,083655,Morris; Justin Loren,9,0,50,41
1657569119288,CSE 20,A01,083657,Tran; Khoa Dang,39,0,80,41
1657569125323,CSE 21,A01,095574,Bach; Quang Tran,22,0,48,26
1657569131354,CSE 30,A01,083084,Eldon; John,5,0,80,75
1657569131354,CSE 30,B01,095061,Bhaskar; Nishant,9,0,50,41
1657569137376,CSE 100,A01,083659,Cao; Yingjun,5,4,70,65
1657569143399,CSE 134B,A01,083661,Powell; Thomas Allan,22,0,100,78
1657569149423,CSE 140,A01,083663,Gungor; Onat,15,0,85,70
1657569155449,CSE 140L,A01,083088,Eldon; John,21,0,100,79
1657569161475,CSE 175,A01,083665,Kumar; Rakesh,3,0,25,22
1657569167506,CSE 190,A00,092507,Dubnov; Shlomo,8,0,20,12
1657569173529,ECE 45,A01,083139,Congero; Spencer William,6,0,75,69
1657569179552,ECE 65,A50,083695,Saad; Andrew S,12,0,30,18
1657569179552,ECE 65,A51,095125,Saad; Andrew S,24,0,26,2
1657569185576,ECE 109,A01,091882,Touri; Behrouz,19,0,70,51
1657569191600,ECE 180,A00,083140,Abi Samra; Nicholas Camill,1,0,30,29
1657569191600,ECE 180,B00,083141,Abi Samra; Nicholas Camill,0,0,30,30
1657569197627,MATH 10A,A01,083735,Patchell; Gregory David,2,0,30,28
1657569197627,MATH 10A,A02,083736,Patchell; Gregory David,20,0,30,10
1657569197627,MATH 10A,A03,083737,Patchell; Gregory David,16,0,30,14
1657569203654,MATH 10B,A01,083207,Lim; Seonhee,8,0,34,26
1657569203654,MATH 10B,A02,083208,Lim; Seonhee,9,0,35,26
1657569203654,MATH 10B,A03,093472,Lim; Seonhee,7,0,34,27
1657569203654,MATH 10B,B01,083739,Sinha; Shubham,12,0,30,18
1657569209690,MATH 18,A01,083743,Cinel; Cameron Alexander,7,0,30,23
1657569209690,MATH 18,A02,083744,Cinel; Cameron Alexander,17,0,30,13
1657569209690,MATH 18,A03,083745,Cinel; Cameron Alexander,9,0,30,21
1657569209690,MATH 18,B01,083748,Rideout; David Porter,5,0,37,32
1657569209690,MATH 18,B02,083749,Rideout; David Porter,5,0,36,31
1657569209690,MATH 18,B03,083750,Rideout; David Porter,3,0,37,34
1657569209690,MATH 18,B04,083751,Rideout; David Porter,6,0,36,30
1657569209690,MATH 18,B05,093473,Rideout; David Porter,6,0,36,30
1657569209690,MATH 18,B06,093474,Rideout; David Porter,6,0,36,30
1657569215714,MATH 20A,A01,083754,Zheng; Zequn,14,0,40,26
1657569221738,MATH 20B,A01,083756,Briones; Jor-el Thomas Caparas,4,0,36,32
1657569221738,MATH 20B,A02,083757,Briones; Jor-el Thomas Caparas,1,0,36,35
1657569221738,MATH 20B,A03,093475,Briones; Jor-el Thomas Caparas,2,0,36,34
1657569227766,MATH 20C,A01,083760,Briones; Jor-el Thomas Caparas,1,0,35,34
1657569227766,MATH 20C,A02,083761,Briones; Jor-el Thomas Caparas,8,0,35,27
1657569227766,MATH 20C,A03,093476,Briones; Jor-el Thomas Caparas,0,1,36,36
1657569227766,MATH 20C,B01,083762,Bach; Quang Tran,1,0,30,29
1657569233790,MATH 20D,A01,083765,Tran; Brian Kha,5,0,30,25
1657569233790,MATH 20D,A02,083766,Tran; Brian Kha,5,0,30,25
1657569233790,MATH 20D,A03,083767,Tran; Brian Kha,5,0,30,25
1657569239818,MATH 20E,A01,083771,Ganguly; Soumya,9,0,32,23
1657569239818,MATH 20E,A02,083772,Ganguly; Soumya,6,0,32,26
1657569239818,MATH 20E,B01,083773,Ciotti; Benjamin,20,0,35,15
1657569239818,MATH 20E,B02,083774,Ciotti; Benjamin,17,0,35,18
1657569245847,MATH 103A,A01,083777,Greenfeld; Be'Eri,3,0,36,33
1657569245847,MATH 103A,A02,083778,Greenfeld; Be'Eri,5,0,36,31
1657569245847,MATH 103A,A03,093561,Greenfeld; Be'Eri,5,0,36,31
1657569245847,MATH 103A,B01,083779,Greenfeld; Be'Eri,7,0,36,29
1657569245847,MATH 103A,B02,083780,Greenfeld; Be'Eri,4,0,36,32
1657569245847,MATH 103A,B03,093562,Greenfeld; Be'Eri,3,0,36,33
1657569251875,MATH 105,A01,085443,Carter; Anne Toulson,15,0,35,20
1657569251875,MATH 105,A02,093477,Carter; Anne Toulson,20,0,35,15
1657569257914,MATH 109,A01,083213,Ganzberger; Geoffrey Michael,2,0,34,32
1657569257914,MATH 109,A02,083214,Ganzberger; Geoffrey Michael,4,0,34,30
1657569257914,MATH 109,A03,093478,Ganzberger; Geoffrey Michael,2,0,34,32
1657569257914,MATH 109,B01,083215,Ganzberger; Geoffrey Michael,1,0,32,31
1657569257914,MATH 109,B02,083216,Ganzberger; Geoffrey Michael,2,0,32,30
1657569257914,MATH 109,B03,093479,Ganzberger; Geoffrey Michael,8,0,32,24
1657569263943,MATH 142A,A01,083219,Chow; Bennett,7,0,32,25
1657569263943,MATH 142A,A02,083220,Chow; Bennett,10,0,32,22
1657569263943,MATH 142A,A03,093480,Chow; Bennett,8,0,32,24
1657569263943,MATH 142A,B03,093481,Chow; Bennett,8,0,32,24
1657569263943,MATH 142A,B04,093558,Chow; Bennett,13,0,32,19
1657569263943,MATH 142A,B05,093559,Chow; Bennett,6,0,32,26
1657569269987,MATH 193A,A01,083224,Rotar; Vladimir,8,0,34,26
1657569269987,MATH 193A,A02,083225,Rotar; Vladimir,9,0,34,25
1657569269987,MATH 193A,A03,083781,Rotar; Vladimir,5,0,34,29
1657569269987,MATH 193A,A04,083782,Rotar; Vladimir,10,0,34,24
1657569269987,MATH 193A,A05,093482,Rotar; Vladimir,10,0,34,24
1657569276013,MATH 197,001,091859,McAuley; Julian John,9999,0,9999,0
1657569276013,MATH 197,002,095566,Kedlaya; Kiran S.,9997,0,9999,2
1657569276013,MATH 197,003,095567,Xiao; Ming,9999,0,9999,0
1657569276013,MATH 197,004,095571,Perols; Johan Lars,9998,0,9999,1
1657569283067,COGS 9,A01,083615,Shannon; Kyle Michael,9,0,75,66
1657569289089,COGS 11,A01,083617,Boyle; Mary E. T.,23,0,48,25
1657569295113,COGS 13,A01,083071,Bastos; Amalia Pinkusfeld,11,0,71,60
1657569301138,COGS 14A,A01,092681,Semenuks; Arturs,5,1,100,95
1657569307160,COGS 14B,A01,083073,Cheng; Tzu-Han,6,0,63,57
1657569313186,COGS 17,A01,092677,Semenuks; Arturs,6,0,81,75
1657569319216,COGS 100,A01,083619,Allen; Michael Gordon,17,0,70,53
1657569325254,COGS 101A,A01,083621,Davis; Joshua Daniel,9,0,68,59
1657569331279,COGS 101B,A01,091572,Allen; Michael Gordon,12,0,65,53
1657569337311,COGS 101C,A01,083625,Delgado; Tania,17,0,35,18
1657569343333,COGS 107A,A01,083627,Boyle; Mary E. T.,13,0,60,47
1657569349365,COGS 118A,A01,083075,Gupta; Anjum,21,0,76,55
1657569355392,CSE 3,A50,083646,Miranda; Gregory Joseph,24,0,50,26
1657569361423,CSE 8A,A50,083650,Miranda; Gregory Joseph,17,1,56,39
1657569367450,CSE 11,A01,083080,Cao; Yingjun,6,15,40,34
1657569373476,CSE 12,A01,083652,Krause-Levy; Sophia Louisa,28,1,120,92
1657569379501,CSE 15L,A01,083654,Morris; Justin Loren,9,0,50,41
1657569379501,CSE 15L,A02,083655,Morris; Justin Loren,9,0,50,41
1657569385601,CSE 20,A01,083657,Tran; Khoa Dang,39,0,80,41
1657569391628,CSE 21,A01,095574,Bach; Quang Tran,22,0,48,26
1657569397656,CSE 30,A01,083084,Eldon; John,5,0,80,75
1657569397656,CSE 30,B01,095061,Bhaskar; Nishant,9,0,50,41
1657569403680,CSE 100,A01,083659,Cao; Yingjun,5,4,70,65
1657569409704,CSE 134B,A01,083661,Powell; Thomas Allan,22,0,100,78
1657569415730,CSE 140,A01,083663,Gungor; Onat,15,0,85,70
1657569421755,CSE 140L,A01,083088,Eldon; John,21,0,100,79
1657569427776,CSE 175,A01,083665,Kumar; Rakesh,3,0,25,22
1657569433810,CSE 190,A00,092507,Dubnov; Shlomo,8,0,20,12
1657569439841,ECE 45,A01,083139,Congero; Spencer William,6,0,75,69
1657569445864,ECE 65,A50,083695,Saad; Andrew S,12,0,30,18
1657569445864,ECE 65,A51,095125,Saad; Andrew S,24,0,26,2
1657569451887,ECE 109,A01,091882,Touri; Behrouz,19,0,70,51
1657569457923,ECE 180,A00,083140,Abi Samra; Nicholas Camill,1,0,30,29
1657569457923,ECE 180,B00,083141,Abi Samra; Nicholas Camill,0,0,30,30
1657569463946,MATH 10A,A01,083735,Patchell; Gregory David,2,0,30,28
1657569463946,MATH 10A,A02,083736,Patchell; Gregory David,20,0,30,10
1657569463946,MATH 10A,A03,083737,Patchell; Gregory David,16,0,30,14
1657569469972,MATH 10B,A01,083207,Lim; Seonhee,8,0,34,26
1657569469972,MATH 10B,A02,083208,Lim; Seonhee,9,0,35,26
1657569469972,MATH 10B,A03,093472,Lim; Seonhee,7,0,34,27
1657569469972,MATH 10B,B01,083739,Sinha; Shubham,12,0,30,18
1657569476006,MATH 18,A01,083743,Cinel; Cameron Alexander,7,0,30,23
1657569476006,MATH 18,A02,083744,Cinel; Cameron Alexander,17,0,30,13
1657569476006,MATH 18,A03,083745,Cinel; Cameron Alexander,9,0,30,21
1657569476006,MATH 18,B01,083748,Rideout; David Porter,5,0,37,32
1657569476006,MATH 18,B02,083749,Rideout; David Porter,5,0,36,31
1657569476006,MATH 18,B03,083750,Rideout; David Porter,3,0,37,34
1657569476006,MATH 18,B04,083751,Rideout; David Porter,6,0,36,30
1657569476006,MATH 18,B05,093473,Rideout; David Porter,6,0,36,30
1657569476006,MATH 18,B06,093474,Rideout; David Porter,6,0,36,30
1657569482032,MATH 20A,A01,083754,Zheng; Zequn,14,0,40,26
1657569488057,MATH 20B,A01,083756,Briones; Jor-el Thomas Caparas,4,0,36,32
1657569488057,MATH 20B,A02,083757,Briones; Jor-el Thomas Caparas,1,0,36,35
1657569488057,MATH 20B,A03,093475,Briones; Jor-el Thomas Caparas,2,0,36,34
1657569494086,MATH 20C,A01,083760,Briones; Jor-el Thomas Caparas,1,0,35,34
1657569494086,MATH 20C,A02,083761,Briones; Jor-el Thomas Caparas,8,0,35,27
1657569494086,MATH 20C,A03,093476,Briones; Jor-el Thomas Caparas,0,1,36,36
1657569494086,MATH 20C,B01,083762,Bach; Quang Tran,1,0,30,29
1657569500124,MATH 20D,A01,083765,Tran; Brian Kha,5,0,30,25
1657569500124,MATH 20D,A02,083766,Tran; Brian Kha,5,0,30,25
1657569500124,MATH 20D,A03,083767,Tran; Brian Kha,5,0,30,25
1657569506146,MATH 20E,A01,083771,Ganguly; Soumya,9,0,32,23
1657569506146,MATH 20E,A02,083772,Ganguly; Soumya,6,0,32,26
1657569506146,MATH 20E,B01,083773,Ciotti; Benjamin,20,0,35,15
1657569506146,MATH 20E,B02,083774,Ciotti; Benjamin,17,0,35,18
1657569512175,MATH 103A,A01,083777,Greenfeld; Be'Eri,3,0,36,33
1657569512175,MATH 103A,A02,083778,Greenfeld; Be'Eri,5,0,36,31
1657569512175,MATH 103A,A03,093561,Greenfeld; Be'Eri,5,0,36,31
1657569512175,MATH 103A,B01,083779,Greenfeld; Be'Eri,7,0,36,29
1657569512175,MATH 103A,B02,083780,Greenfeld; Be'Eri,4,0,36,32
1657569512175,MATH 103A,B03,093562,Greenfeld; Be'Eri,3,0,36,33
1657569518199,MATH 105,A01,085443,Carter; Anne Toulson,15,0,35,20
1657569518199,MATH 105,A02,093477,Carter; Anne Toulson,20,0,35,15
1657569524227,MATH 109,A01,083213,Ganzberger; Geoffrey Michael,2,0,34,32
1657569524227,MATH 109,A02,083214,Ganzberger; Geoffrey Michael,4,0,34,30
1657569524227,MATH 109,A03,093478,Ganzberger; Geoffrey Michael,2,0,34,32
1657569524227,MATH 109,B01,083215,Ganzberger; Geoffrey Michael,1,0,32,31
1657569524227,MATH 109,B02,083216,Ganzberger; Geoffrey Michael,2,0,32,30
1657569524227,MATH 109,B03,093479,Ganzberger; Geoffrey Michael,8,0,32,24
1657569530251,MATH 142A,A01,083219,Chow; Bennett,7,0,32,25
1657569530251,MATH 142A,A02,083220,Chow; Bennett,10,0,32,22
1657569530251,MATH 142A,A03,093480,Chow; Bennett,8,0,32,24
1657569530251,MATH 142A,B03,093481,Chow; Bennett,8,0,32,24
1657569530251,MATH 142A,B04,093558,Chow; Bennett,13,0,32,19
1657569530251,MATH 142A,B05,093559,Chow; Bennett,6,0,32,26
1657569536283,MATH 193A,A01,083224,Rotar; Vladimir,8,0,34,26
1657569536283,MATH 193A,A02,083225,Rotar; Vladimir,9,0,34,25
1657569536283,MATH 193A,A03,083781,Rotar; Vladimir,5,0,34,29
1657569536283,MATH 193A,A04,083782,Rotar; Vladimir,10,0,34,24
1657569536283,MATH 193A,A05,093482,Rotar; Vladimir,10,0,34,24
1657569542311,MATH 197,001,091859,McAuley; Julian John,9999,0,9999,0
1657569542311,MATH 197,002,095566,Kedlaya; Kiran S.,9997,0,9999,2
1657569542311,MATH 197,003,095567,Xiao; Ming,9999,0,9999,0
1657569542311,MATH 197,004,095571,Perols; Johan Lars,9998,0,9999,1
1657569549368,COGS 9,A01,083615,Shannon; Kyle Michael,9,0,75,66
1657569555392,COGS 11,A01,083617,Boyle; Mary E. T.,23,0,48,25
1657569561421,COGS 13,A01,083071,Bastos; Amalia Pinkusfeld,11,0,71,60
1657569567444,COGS 14A,A01,092681,Semenuks; Arturs,5,1,100,95
1657569573472,COGS 14B,A01,083073,Cheng; Tzu-Han,6,0,63,57
1657569579495,COGS 17,A01,092677,Semenuks; Arturs,6,0,81,75
1657569585520,COGS 100,A01,083619,Allen; Michael Gordon,17,0,70,53
1657569591543,COGS 101A,A01,083621,Davis; Joshua Daniel,9,0,68,59
1657569597566,COGS 101B,A01,091572,Allen; Michael Gordon,12,0,65,53
1657569603598,COGS 101C,A01,083625,Delgado; Tania,17,0,35,18
1657569609626,COGS 107A,A01,083627,Boyle; Mary E. T.,13,0,60,47
1657569615648,COGS 118A,A01,083075,Gupta; Anjum,21,0,76,55
1657569621671,CSE 3,A50,083646,Miranda; Gregory Joseph,24,0,50,26
1657569627693,CSE 8A,A50,083650,Miranda; Gregory Joseph,17,1,56,39
1657569633715,CSE 11,A01,083080,Cao; Yingjun,6,15,40,34
1657569639739,CSE 12,A01,083652,Krause-Levy; Sophia Louisa,28,1,120,92
1657569645761,CSE 15L,A01,083654,Morris; Justin Loren,9,0,50,41
1657569645761,CSE 15L,A02,083655,Morris; Justin Loren,9,0,50,41
1657569651783,CSE 20,A01,083657,Tran; Khoa Dang,39,0,80,41
1657569657806,CSE 21,A01,095574,Bach; Quang Tran,22,0,48,26
1657569663830,CSE 30,A01,083084,Eldon; John,5,0,80,75
1657569663830,CSE 30,B01,095061,Bhaskar; Nishant,9,0,50,41
1657569669859,CSE 100,A01,083659,Cao; Yingjun,5,4,70,65
1657569675901,CSE 134B,A01,083661,Powell; Thomas Allan,22,0,100,78
1657569681922,CSE 140,A01,083663,Gungor; Onat,15,0,85,70
1657569687954,CSE 140L,A01,083088,Eldon; John,21,0,100,79
1657569693978,CSE 175,A01,083665,Kumar; Rakesh,3,0,25,22
1657569700009,CSE 190,A00,092507,Dubnov; Shlomo,8,0,20,12
1657569706036,ECE 45,A01,083139,Congero; Spencer William,6,0,75,69
1657569712065,ECE 65,A50,083695,Saad; Andrew S,12,0,30,18
1657569712065,ECE 65,A51,095125,Saad; Andrew S,24,0,26,2
1657569718087,ECE 109,A01,091882,Touri; Behrouz,19,0,70,51
1657569724114,ECE 180,A00,083140,Abi Samra; Nicholas Camill,1,0,30,29
1657569724114,ECE 180,B00,083141,Abi Samra; Nicholas Camill,0,0,30,30
1657569730141,MATH 10A,A01,083735,Patchell; Gregory David,2,0,30,28
1657569730141,MATH 10A,A02,083736,Patchell; Gregory David,20,0,30,10
1657569730141,MATH 10A,A03,083737,Patchell; Gregory David,16,0,30,14
1657569736175,MATH 10B,A01,083207,Lim; Seonhee,8,0,34,26
1657569736175,MATH 10B,A02,083208,Lim; Seonhee,9,0,35,26
1657569736175,MATH 10B,A03,093472,Lim; Seonhee,7,0,34,27
1657569736175,MATH 10B,B01,083739,Sinha; Shubham,12,0,30,18
1657569742201,MATH 18,A01,083743,Cinel; Cameron Alexander,7,0,30,23
1657569742201,MATH 18,A02,083744,Cinel; Cameron Alexander,17,0,30,13
1657569742201,MATH 18,A03,083745,Cinel; Cameron Alexander,9,0,30,21
1657569742201,MATH 18,B01,083748,Rideout; David Porter,5,0,37,32
1657569742201,MATH 18,B02,083749,Rideout; David Porter,5,0,36,31
1657569742201,MATH 18,B03,083750,Rideout; David Porter,3,0,37,34
1657569742201,MATH 18,B04,083751,Rideout; David Porter,6,0,36,30
1657569742201,MATH 18,B05,093473,Rideout; David Porter,6,0,36,30
1657569742201,MATH 18,B06,093474,Rideout; David Porter,6,0,36,30
1657569748235,MATH 20A,A01,083754,Zheng; Zequn,14,0,40,26
1657569754263,MATH 20B,A01,083756,Briones; Jor-el Thomas Caparas,4,0,36,32
1657569754263,MATH 20B,A02,083757,Briones; Jor-el Thomas Caparas,1,0,36,35
1657569754263,MATH 20B,A03,093475,Briones; Jor-el Thomas Caparas,2,0,36,34
1657569760286,MATH 20C,A01,083760,Briones; Jor-el Thomas Caparas,1,0,35,34
1657569760286,MATH 20C,A02,083761,Briones; Jor-el Thomas Caparas,8,0,35,27
1657569760286,MATH 20C,A03,093476,Briones; Jor-el Thomas Caparas,0,1,36,36
1657569760286,MATH 20C,B01,083762,Bach; Quang Tran,1,0,30,29
1657569766314,MATH 20D,A01,083765,Tran; Brian Kha,5,0,30,25
1657569766314,MATH 20D,A02,083766,Tran; Brian Kha,5,0,30,25
1657569766314,MATH 20D,A03,083767,Tran; Brian Kha,5,0,30,25
1657569772343,MATH 20E,A01,083771,Ganguly; Soumya,9,0,32,23
1657569772343,MATH 20E,A02,083772,Ganguly; Soumya,6,0,32,26
1657569772343,MATH 20E,B01,083773,Ciotti; Benjamin,20,0,35,15
1657569772343,MATH 20E,B02,083774,Ciotti; Benjamin,17,0,35,18
1657569778371,MATH 103A,A01,083777,Greenfeld; Be'Eri,3,0,36,33
1657569778371,MATH 103A,A02,083778,Greenfeld; Be'Eri,5,0,36,31
1657569778371,MATH 103A,A03,093561,Greenfeld; Be'Eri,5,0,36,31
1657569778371,MATH 103A,B01,083779,Greenfeld; Be'Eri,7,0,36,29
1657569778371,MATH 103A,B02,083780,Greenfeld; Be'Eri,4,0,36,32
1657569778371,MATH 103A,B03,093562,Greenfeld; Be'Eri,3,0,36,33
1657569784406,MATH 105,A01,085443,Carter; Anne Toulson,15,0,35,20
1657569784406,MATH 105,A02,093477,Carter; Anne Toulson,20,0,35,15
1657569790440,MATH 109,A01,083213,Ganzberger; Geoffrey Michael,2,0,34,32
1657569790440,MATH 109,A02,083214,Ganzberger; Geoffrey Michael,4,0,34,30
1657569790440,MATH 109,A03,093478,Ganzberger; Geoffrey Michael,2,0,34,32
1657569790440,MATH 109,B01,083215,Ganzberger; Geoffrey Michael,1,0,32,31
1657569790440,MATH 109,B02,083216,Ganzberger; Geoffrey Michael,2,0,32,30
1657569790440,MATH 109,B03,093479,Ganzberger; Geoffrey Michael,8,0,32,24
1657569796467,MATH 142A,A01,083219,Chow; Bennett,7,0,32,25
1657569796467,MATH 142A,A02,083220,Chow; Bennett,10,0,32,22
1657569796467,MATH 142A,A03,093480,Chow; Bennett,8,0,32,24
1657569796467,MATH 142A,B03,093481,Chow; Bennett,8,0,32,24
1657569796467,MATH 142A,B04,093558,Chow; Bennett,13,0,32,19
1657569796467,MATH 142A,B05,093559,Chow; Bennett,6,0,32,26
1657569802494,MATH 193A,A01,083224,Rotar; Vladimir,8,0,34,26
1657569802494,MATH 193A,A02,083225,Rotar; Vladimir,9,0,34,25
1657569802494,MATH 193A,A03,083781,Rotar; Vladimir,5,0,34,29
1657569802494,MATH 193A,A04,083782,Rotar; Vladimir,10,0,34,24
1657569802494,MATH 193A,A05,093482,Rotar; Vladimir,10,0,34,24
1657569808525,MATH 197,001,091859,McAuley; Julian John,9999,0,9999,0
1657569808525,MATH 197,002,095566,Kedlaya; Kiran S.,9997,0,9999,2
1657569808525,MATH 197,003,095567,Xiao; Ming,9999,0,9999,0
1657569808525,MATH 197,004,095571,Perols; Johan Lars,9998,0,9999,1
1657569815593,COGS 9,A01,083615,Shannon; Kyle Michael,9,0,75,66
1657569821617,COGS 11,A01,083617,Boyle; Mary E. T.,23,0,48,25
1657569827651,COGS 13,A01,083071,Bastos; Amalia Pinkusfeld,11,0,71,60
1657569833679,COGS 14A,A01,092681,Semenuks; Arturs,5,1,100,95
1657569839704,COGS 14B,A01,083073,Cheng; Tzu-Han,6,0,63,57
1657569845726,COGS 17,A01,092677,Semenuks; Arturs,6,0,81,75
1657569851760,COGS 100,A01,083619,Allen; Michael Gordon,17,0,70,53
1657569857787,COGS 101A,A01,083621,Davis; Joshua Daniel,9,0,68,59
1657569863827,COGS 101B,A01,091572,Allen; Michael Gordon,12,0,65,53
1657569869853,COGS 101C,A01,083625,Delgado; Tania,17,0,35,18
1657569875880,COGS 107A,A01,083627,Boyle; Mary E. T.,13,0,60,47
1657569881909,COGS 118A,A01,083075,Gupta; Anjum,21,0,76,55
1657569887932,CSE 3,A50,083646,Miranda; Gregory Joseph,24,0,50,26
1657569893955,CSE 8A,A50,083650,Miranda; Gregory Joseph,17,1,56,39
1657569899980,CSE 11,A01,083080,Cao; Yingjun,6,15,40,34
1657569906005,CSE 12,A01,083652,Krause-Levy; Sophia Louisa,28,1,120,92
1657569912039,CSE 15L,A01,083654,Morris; Justin Loren,9,0,50,41
1657569912039,CSE 15L,A02,083655,Morris; Justin Loren,9,0,50,41
1657569918066,CSE 20,A01,083657,Tran; Khoa Dang,39,0,80,41
1657569924092,CSE 21,A01,095574,Bach; Quang Tran,22,0,48,26
1657569930116,CSE 30,A01,083084,Eldon; John,5,0,80,75
1657569930116,CSE 30,B01,095061,Bhaskar; Nishant,9,0,50,41
1657569936138,CSE 100,A01,083659,Cao; Yingjun,5,4,70,65
1657569942165,CSE 134B,A01,083661,Powell; Thomas Allan,22,0,100,78
1657569948197,CSE 140,A01,083663,Gungor; Onat,15,0,85,70
1657569954223,CSE 140L,A01,083088,Eldon; John,21,0,100,79
1657569960249,CSE 175,A01,083665,Kumar; Rakesh,3,0,25,22
1657569966276,CSE 190,A00,092507,Dubnov; Shlomo,8,0,20,12
1657569972299,ECE 45,A01,083139,Congero; Spencer William,6,0,75,69
1657569978321,ECE 65,A50,083695,Saad; Andrew S,12,0,30,18
1657569978321,ECE 65,A51,095125,Saad; Andrew S,24,0,26,2
1657569984413,ECE 109,A01,091882,Touri; Behrouz,19,0,70,51
1657569990439,ECE 180,A00,083140,Abi Samra; Nicholas Camill,1,0,30,29
1657569990439,ECE 180,B00,083141,Abi Samra; Nicholas Camill,0,0,30,30
1657569996476,MATH 10A,A01,083735,Patchell; Gregory David,2,0,30,28
1657569996476,MATH 10A,A02,083736,Patchell; Gregory David,20,0,30,10
1657569996476,MATH 10A,A03,083737,Patchell; Gregory David,16,0,30,14
1657570002505,MATH 10B,A01,083207,Lim; Seonhee,8,0,34,26
1657570002505,MATH 10B,A02,083208,Lim; Seonhee,9,0,35,26
1657570002505,MATH 10B,A03,093472,Lim; Seonhee,7,0,34,27
1657570002505,MATH 10B,B01,083739,Sinha; Shubham,12,0,30,18
1657570008553,MATH 18,A01,083743,Cinel; Cameron Alexander,7,0,30,23
1657570008553,MATH 18,A02,083744,Cinel; Cameron Alexander,17,0,30,13
1657570008553,MATH 18,A03,083745,Cinel; Cameron Alexander,9,0,30,21
1657570008553,MATH 18,B01,083748,Rideout; David Porter,5,0,37,32
1657570008553,MATH 18,B02,083749,Rideout; David Porter,5,0,36,31
1657570008553,MATH 18,B03,083750,Rideout; David Porter,3,0,37,34
1657570008553,MATH 18,B04,083751,Rideout; David Porter,6,0,36,30
1657570008553,MATH 18,B05,093473,Rideout; David Porter,6,0,36,30
1657570008553,MATH 18,B06,093474,Rideout; David Porter,6,0,36,30
1657570014578,MATH 20A,A01,083754,Zheng; Zequn,14,0,40,26
1657570020602,MATH 20B,A01,083756,Briones; Jor-el Thomas Caparas,4,0,36,32
1657570020602,MATH 20B,A02,083757,Briones; Jor-el Thomas Caparas,1,0,36,35
1657570020602,MATH 20B,A03,093475,Briones; Jor-el Thomas Caparas,2,0,36,34
1657570026626,MATH 20C,A01,083760,Briones; Jor-el Thomas Caparas,1,0,35,34
1657570026626,MATH 20C,A02,083761,Briones; Jor-el Thomas Caparas,8,0,35,27
1657570026626,MATH 20C,A03,093476,Briones; Jor-el Thomas Caparas,0,1,36,36
1657570026626,MATH 20C,B01,083762,Bach; Quang Tran,1,0,30,29
1657570032655,MATH 20D,A01,083765,Tran; Brian Kha,5,0,30,25
1657570032655,MATH 20D,A02,083766,Tran; Brian Kha,5,0,30,25
1657570032655,MATH 20D,A03,083767,Tran; Brian Kha,5,0,30,25
1657570038685,MATH 20E,A01,083771,Ganguly; Soumya,9,0,32,23
1657570038685,MATH 20E,A02,083772,Ganguly; Soumya,6,0,32,26
1657570038685,MATH 20E,B01,083773,Ciotti; Benjamin,20,0,35,15
1657570038685,MATH 20E,B02,083774,Ciotti; Benjamin,17,0,35,18
1657570044708,MATH 103A,A01,083777,Greenfeld; Be'Eri,3,0,36,33
1657570044708,MATH 103A,A02,083778,Greenfeld; Be'Eri,5,0,36,31
1657570044708,MATH 103A,A03,093561,Greenfeld; Be'Eri,5,0,36,31
1657570044708,MATH 103A,B01,083779,Greenfeld; Be'Eri,7,0,36,29
1657570044708,MATH 103A,B02,083780,Greenfeld; Be'Eri,4,0,36,32
1657570044708,MATH 103A,B03,093562,Greenfeld; Be'Eri,3,0,36,33
1657570050732,MATH 105,A01,085443,Carter; Anne Toulson,15,0,35,20
1657570050732,MATH 105,A02,093477,Carter; Anne Toulson,20,0,35,15
1657570056755,MATH 109,A01,083213,Ganzberger; Geoffrey Michael,2,0,34,32
1657570056755,MATH 109,A02,083214,Ganzberger; Geoffrey Michael,4,0,34,30
1657570056755,MATH 109,A03,093478,Ganzberger; Geoffrey Michael,2,0,34,32
1657570056755,MATH 109,B01,083215,Ganzberger; Geoffrey Michael,1,0,32,31
1657570056755,MATH 109,B02,083216,Ganzberger; Geoffrey Michael,2,0,32,30
1657570056755,MATH 109,B03,093479,Ganzberger; Geoffrey Michael,8,0,32,24
1657570062786,MATH 142A,A01,083219,Chow; Bennett,7,0,32,25
1657570062786,MATH 142A,A02,083220,Chow; Bennett,10,0,32,22
1657570062786,MATH 142A,A03,093480,Chow; Bennett,8,0,32,24
1657570062786,MATH 142A,B03,093481,Chow; Bennett,8,0,32,24
1657570062786,MATH 142A,B04,093558,Chow; Bennett,13,0,32,19
1657570062786,MATH 142A,B05,093559,Chow; Bennett,6,0,32,26
1657570068808,MATH 193A,A01,083224,Rotar; Vladimir,8,0,34,26
1657570068808,MATH 193A,A02,083225,Rotar; Vladimir,9,0,34,25
1657570068808,MATH 193A,A03,083781,Rotar; Vladimir,5,0,34,29
1657570068808,MATH 193A,A04,083782,Rotar; Vladimir,10,0,34,24
1657570068808,MATH 193A,A05,093482,Rotar; Vladimir,10,0,34,24
1657570074833,MATH 197,001,091859,McAuley; Julian John,9999,0,9999,0
1657570074833,MATH 197,002,095566,Kedlaya; Kiran S.,9997,0,9999,2
1657570074833,MATH 197,003,095567,Xiao; Ming,9999,0,9999,0
1657570074833,MATH 197,004,095571,Perols; Johan Lars,9998,0,9999,1
1657570081888,COGS 9,A01,083615,Shannon; Kyle Michael,9,0,75,66
1657570087919,COGS 11,A01,083617,Boyle; Mary E. T.,23,0,48,25
1657570093943,COGS 13,A01,083071,Bastos; Amalia Pinkusfeld,11,0,71,60
1657570099975,COGS 14A,A01,092681,Semenuks; Arturs,5,1,100,95
1657570105998,COGS 14B,A01,083073,Cheng; Tzu-Han,6,0,63,57
1657570112032,COGS 17,A01,092677,Semenuks; Arturs,6,0,81,75
1657570118056,COGS 100,A01,083619,Allen; Michael Gordon,17,0,70,53
1657570124096,COGS 101A,A01,083621,Davis; Joshua Daniel,9,0,68,59
1657570130122,COGS 101B,A01,091572,Allen; Michael Gordon,12,0,65,53
1657570136147,COGS 101C,A01,083625,Delgado; Tania,17,0,35,18
1657570142174,COGS 107A,A01,083627,Boyle; Mary E. T.,13,0,60,47
1657570148199,COGS 118A,A01,083075,Gupta; Anjum,21,0,76,55
1657570154237,CSE 3,A50,083646,Miranda; Gregory Joseph,24,0,50,26
1657570160261,CSE 8A,A50,083650,Miranda; Gregory Joseph,17,1,56,39
1657570166289,CSE 11,A01,083080,Cao; Yingjun,6,15,40,34
1657570172316,CSE 12,A01,083652,Krause-Levy; Sophia Louisa,28,1,120,92
1657570178343,CSE 15L,A01,083654,Morris; Justin Loren,9,0,50,41
1657570178343,CSE 15L,A02,083655,Morris; Justin Loren,9,0,50,41
1657570184371,CSE 20,A01,083657,Tran; Khoa Dang,39,0,80,41
1657570190403,CSE 21,A01,095574,Bach; Quang Tran,22,0,48,26
1657570196425,CSE 30,A01,083084,Eldon; John,5,0,80,75
1657570196425,CSE 30,B01,095061,Bhaskar; Nishant,9,0,50,41
1657570202451,CSE 100,A01,083659,Cao; Yingjun,5,4,70,65
1657570208472,CSE 134B,A01,083661,Powell; Thomas Allan,22,0,100,78
1657570214498,CSE 140,A01,083663,Gungor; Onat,15,0,85,70
1657570220520,CSE 140L,A01,083088,Eldon; John,21,0,100,79
1657570226542,CSE 175,A01,083665,Kumar; Rakesh,3,0,25,22
1657570232566,CSE 190,A00,092507,Dubnov; Shlomo,8,0,20,12
1657570238589,ECE 45,A01,083139,Congero; Spencer William,6,0,75,69
1657570244613,ECE 65,A50,083695,Saad; Andrew S,12,0,30,18
1657570244613,ECE 65,A51,095125,Saad; Andrew S,24,0,26,2
1657570250640,ECE 109,A01,091882,Touri; Behrouz,19,0,70,51
1657570256662,ECE 180,A00,083140,Abi Samra; Nicholas Camill,1,0,30,29
1657570256662,ECE 180,B00,083141,Abi Samra; Nicholas Camill,0,0,30,30
1657570262690,MATH 10A,A01,083735,Patchell; Gregory David,2,0,30,28
1657570262690,MATH 10A,A02,083736,Patchell; Gregory David,20,0,30,10
1657570262690,MATH 10A,A03,083737,Patchell; Gregory David,16,0,30,14
1657570268719,MATH 10B,A01,083207,Lim; Seonhee,8,0,34,26
1657570268719,MATH 10B,A02,083208,Lim; Seonhee,9,0,35,26
1657570268719,MATH 10B,A03,093472,Lim; Seonhee,7,0,34,27
1657570268719,MATH 10B,B01,083739,Sinha; Shubham,12,0,30,18
1657570274750,MATH 18,A01,083743,Cinel; Cameron Alexander,7,0,30,23
1657570274750,MATH 18,A02,083744,Cinel; Cameron Alexander,17,0,30,13
1657570274750,MATH 18,A03,083745,Cinel; Cameron Alexander,9,0,30,21
1657570274750,MATH 18,B01,083748,Rideout; David Porter,5,0,37,32
1657570274750,MATH 18,B02,083749,Rideout; David Porter,5,0,36,31
1657570274750,MATH 18,B03,083750,Rideout; David Porter,3,0,37,34
1657570274750,MATH 18,B04,083751,Rideout; David Porter,6,0,36,30
1657570274750,MATH 18,B05,093473,Rideout; David Porter,6,0,36,30
1657570274750,MATH 18,B06,093474,Rideout; David Porter,6,0,36,30
1657570280777,MATH 20A,A01,083754,Zheng; Zequn,14,0,40,26
1657570286800,MATH 20B,A01,083756,Briones; Jor-el Thomas Caparas,4,0,36,32
1657570286800,MATH 20B,A02,083757,Briones; Jor-el Thomas Caparas,1,0,36,35
1657570286800,MATH 20B,A03,093475,Briones; Jor-el Thomas Caparas,2,0,36,34
1657570292828,MATH 20C,A01,083760,Briones; Jor-el Thomas Caparas,1,0,35,34
1657570292828,MATH 20C,A02,083761,Briones; Jor-el Thomas Caparas,8,0,35,27
1657570292828,MATH 20C,A03,093476,Briones; Jor-el Thomas Caparas,0,1,36,36
1657570292828,MATH 20C,B01,083762,Bach; Quang Tran,1,0,30,29
1657570298869,MATH 20D,A01,083765,Tran; Brian Kha,5,0,30,25
1657570298869,MATH 20D,A02,083766,Tran; Brian Kha,5,0,30,25
1657570298869,MATH 20D,A03,083767,Tran; Brian Kha,5,0,30,25
1657570304902,MATH 20E,A01,083771,Ganguly; Soumya,9,0,32,23
1657570304902,MATH 20E,A02,083772,Ganguly; Soumya,6,0,32,26
1657570304902,MATH 20E,B01,083773,Ciotti; Benjamin,20,0,35,15
1657570304902,MATH 20E,B02,083774,Ciotti; Benjamin,17,0,35,18
1657570310930,MATH 103A,A01,083777,Greenfeld; Be'Eri,3,0,36,33
1657570310930,MATH 103A,A02,083778,Greenfeld; Be'Eri,5,0,36,31
1657570310930,MATH 103A,A03,093561,Greenfeld; Be'Eri,5,0,36,31
1657570310930,MATH 103A,B01,083779,Greenfeld; Be'Eri,7,0,36,29
1657570310930,MATH 103A,B02,083780,Greenfeld; Be'Eri,4,0,36,32
1657570310930,MATH 103A,B03,093562,Greenfeld; Be'Eri,3,0,36,33
1657570316967,MATH 105,A01,085443,Carter; Anne Toulson,15,0,35,20
1657570316967,MATH 105,A02,093477,Carter; Anne Toulson,20,0,35,15
1657570322989,MATH 109,A01,083213,Ganzberger; Geoffrey Michael,2,0,34,32
1657570322989,MATH 109,A02,083214,Ganzberger; Geoffrey Michael,4,0,34,30
1657570322989,MATH 109,A03,093478,Ganzberger; Geoffrey Michael,2,0,34,32
1657570322989,MATH 109,B01,083215,Ganzberger; Geoffrey Michael,1,0,32,31
1657570322989,MATH 109,B02,083216,Ganzberger; Geoffrey Michael,2,0,32,30
1657570322989,MATH 109,B03,093479,Ganzberger; Geoffrey Michael,8,0,32,24
1657570329023,MATH 142A,A01,083219,Chow; Bennett,7,0,32,25
1657570329023,MATH 142A,A02,083220,Chow; Bennett,10,0,32,22
1657570329023,MATH 142A,A03,093480,Chow; Bennett,8,0,32,24
1657570329023,MATH 142A,B03,093481,Chow; Bennett,8,0,32,24
1657570329023,MATH 142A,B04,093558,Chow; Bennett,13,0,32,19
1657570329023,MATH 142A,B05,093559,Chow; Bennett,6,0,32,26
1657570335053,MATH 193A,A01,083224,Rotar; Vladimir,8,0,34,26
1657570335053,MATH 193A,A02,083225,Rotar; Vladimir,9,0,34,25
1657570335053,MATH 193A,A03,083781,Rotar; Vladimir,5,0,34,29
1657570335053,MATH 193A,A04,083782,Rotar; Vladimir,10,0,34,24
1657570335053,MATH 193A,A05,093482,Rotar; Vladimir,10,0,34,24
1657570341077,MATH 197,001,091859,McAuley; Julian John,9999,0,9999,0
1657570341077,MATH 197,002,095566,Kedlaya; Kiran S.,9997,0,9999,2
1657570341077,MATH 197,003,095567,Xiao; Ming,9999,0,9999,0
1657570341077,MATH 197,004,095571,Perols; Johan Lars,9998,0,9999,1
1657570348136,COGS 9,A01,083615,Shannon; Kyle Michael,9,0,75,66
1657570354162,COGS 11,A01,083617,Boyle; Mary E. T.,23,0,48,25
1657570360185,COGS 13,A01,083071,Bastos; Amalia Pinkusfeld,11,0,71,60
1657570366215,COGS 14A,A01,092681,Semenuks; Arturs,5,1,100,95
1657570372239,COGS 14B,A01,083073,Cheng; Tzu-Han,6,0,63,57
1657570378263,COGS 17,A01,092677,Semenuks; Arturs,6,0,81,75
1657570384285,COGS 100,A01,083619,Allen; Michael Gordon,17,0,70,53
1657570390311,COGS 101A,A01,083621,Davis; Joshua Daniel,9,0,68,59
1657570396338,COGS 101B,A01,091572,Allen; Michael Gordon,12,0,65,53
1657570402384,COGS 101C,A01,083625,Delgado; Tania,17,0,35,18
1657570408408,COGS 107A,A01,083627,Boyle; Mary E. T.,13,0,60,47
1657570414430,COGS 118A,A01,083075,Gupta; Anjum,21,0,76,55
1657570420462,CSE 3,A50,083646,Miranda; Gregory Joseph,24,0,50,26
1657570426489,CSE 8A,A50,083650,Miranda; Gregory Joseph,17,1,56,39
1657570432514,CSE 11,A01,083080,Cao; Yingjun,6,15,40,34
1657570438547,CSE 12,A01,083652,Krause-Levy; Sophia Louisa,28,1,120,92
1657570444586,CSE 15L,A01,083654,Morris; Justin Loren,9,0,50,41
1657570444586,CSE 15L,A02,083655,Morris; Justin Loren,9,0,50,41
1657570450609,CSE 20,A01,083657,Tran; Khoa Dang,39,0,80,41
1657570456632,CSE 21,A01,095574,Bach; Quang Tran,22,0,48,26
1657570462665,CSE 30,A01,083084,Eldon; John,5,0,80,75
1657570462665,CSE 30,B01,095061,Bhaskar; Nishant,9,0,50,41
1657570468693,CSE 100,A01,083659,Cao; Yingjun,5,4,70,65
1657570474716,CSE 134B,A01,083661,Powell; Thomas Allan,22,0,100,78
1657570480739,CSE 140,A01,083663,Gungor; Onat,15,0,85,70
1657570486765,CSE 140L,A01,083088,Eldon; John,21,0,100,79
1657570492786,CSE 175,A01,083665,Kumar; Rakesh,3,0,25,22
1657570498808,CSE 190,A00,092507,Dubnov; Shlomo,8,0,20,12
1657570504835,ECE 45,A01,083139,Congero; Spencer William,6,0,75,69
1657570510856,ECE 65,A50,083695,Saad; Andrew S,12,0,30,18
1657570510856,ECE 65,A51,095125,Saad; Andrew S,24,0,26,2
1657570516878,ECE 109,A01,091882,Touri; Behrouz,19,0,70,51
1657570522907,ECE 180,A00,083140,Abi Samra; Nicholas Camill,1,0,30,29
1657570522907,ECE 180,B00,083141,Abi Samra; Nicholas Camill,0,0,30,30
1657570528942,MATH 10A,A01,083735,Patchell; Gregory David,2,0,30,28
1657570528942,MATH 10A,A02,083736,Patchell; Gregory David,20,0,30,10
1657570528942,MATH 10A,A03,083737,Patchell; Gregory David,16,0,30,14
1657570534988,MATH 10B,A01,083207,Lim; Seonhee,8,0,34,26
1657570534988,MATH 10B,A02,083208,Lim; Seonhee,9,0,35,26
1657570534988,MATH 10B,A03,093472,Lim; Seonhee,7,0,34,27
1657570534988,MATH 10B,B01,083739,Sinha; Shubham,12,0,30,18
1657570541015,MATH 18,A01,083743,Cinel; Cameron Alexander,7,0,30,23
1657570541015,MATH 18,A02,083744,Cinel; Cameron Alexander,17,0,30,13
1657570541015,MATH 18,A03,083745,Cinel; Cameron Alexander,9,0,30,21
1657570541015,MATH 18,B01,083748,Rideout; David Porter,5,0,37,32
1657570541015,MATH 18,B02,083749,Rideout; David Porter,5,0,36,31
1657570541015,MATH 18,B03,083750,Rideout; David Porter,3,0,37,34
1657570541015,MATH 18,B04,083751,Rideout; David Porter,6,0,36,30
1657570541015,MATH 18,B05,093473,Rideout; David Porter,6,0,36,30
1657570541015,MATH 18,B06,093474,Rideout; David Porter,6,0,36,30
1657570547049,MATH 20A,A01,083754,Zheng; Zequn,14,0,40,26
1657570553070,MATH 20B,A01,083756,Briones; Jor-el Thomas Caparas,4,0,36,32
1657570553070,MATH 20B,A02,083757,Briones; Jor-el Thomas Caparas,1,0,36,35
1657570553070,MATH 20B,A03,093475,Briones; Jor-el Thomas Caparas,2,0,36,34
1657570559101,MATH 20C,A01,083760,Briones; Jor-el Thomas Caparas,1,0,35,34
1657570559101,MATH 20C,A02,083761,Briones; Jor-el Thomas Caparas,8,0,35,27
1657570559101,MATH 20C,A03,093476,Briones; Jor-el Thomas Caparas,0,1,36,36
1657570559101,MATH 20C,B01,083762,Bach; Quang Tran,1,0,30,29
1657570565135,MATH 20D,A01,083765,Tran; Brian Kha,5,0,30,25
1657570565135,MATH 20D,A02,083766,Tran; Brian Kha,5,0,30,25
1657570565135,MATH 20D,A03,083767,Tran; Brian Kha,5,0,30,25
1657570571172,MATH 20E,A01,083771,Ganguly; Soumya,9,0,32,23
1657570571172,MATH 20E,A02,083772,Ganguly; Soumya,6,0,32,26
1657570571172,MATH 20E,B01,083773,Ciotti; Benjamin,20,0,35,15
1657570571172,MATH 20E,B02,083774,Ciotti; Benjamin,17,0,35,18
1657570577194,MATH 103A,A01,083777,Greenfeld; Be'Eri,3,0,36,33
1657570577194,MATH 103A,A02,083778,Greenfeld; Be'Eri,5,0,36,31
1657570577194,MATH 103A,A03,093561,Greenfeld; Be'Eri,5,0,36,31
1657570577194,MATH 103A,B01,083779,Greenfeld; Be'Eri,7,0,36,29
1657570577194,MATH 103A,B02,083780,Greenfeld; Be'Eri,4,0,36,32
1657570577194,MATH 103A,B03,093562,Greenfeld; Be'Eri,3,0,36,33
1657570583312,MATH 105,A01,085443,Carter; Anne Toulson,15,0,35,20
1657570583312,MATH 105,A02,093477,Carter; Anne Toulson,20,0,35,15
1657570589334,MATH 109,A01,083213,Ganzberger; Geoffrey Michael,2,0,34,32
1657570589334,MATH 109,A02,083214,Ganzberger; Geoffrey Michael,4,0,34,30
1657570589334,MATH 109,A03,093478,Ganzberger; Geoffrey Michael,2,0,34,32
1657570589334,MATH 109,B01,083215,Ganzberger; Geoffrey Michael,1,0,32,31
1657570589334,MATH 109,B02,083216,Ganzberger; Geoffrey Michael,2,0,32,30
1657570589334,MATH 109,B03,093479,Ganzberger; Geoffrey Michael,8,0,32,24
1657570595362,MATH 142A,A01,083219,Chow; Bennett,7,0,32,25
1657570595362,MATH 142A,A02,083220,Chow; Bennett,10,0,32,22
1657570595362,MATH 142A,A03,093480,Chow; Bennett,8,0,32,24
1657570595362,MATH 142A,B03,093481,Chow; Bennett,8,0,32,24
1657570595362,MATH 142A,B04,093558,Chow; Bennett,13,0,32,19
1657570595362,MATH 142A,B05,093559,Chow; Bennett,6,0,32,26
1657570601384,MATH 193A,A01,083224,Rotar; Vladimir,8,0,34,26
1657570601384,MATH 193A,A02,083225,Rotar; Vladimir,9,0,34,25
1657570601384,MATH 193A,A03,083781,Rotar; Vladimir,5,0,34,29
1657570601384,MATH 193A,A04,083782,Rotar; Vladimir,10,0,34,24
1657570601384,MATH 193A,A05,093482,Rotar; Vladimir,10,0,34,24
1657570607407,MATH 197,001,091859,McAuley; Julian John,9999,0,9999,0
1657570607407,MATH 197,002,095566,Kedlaya; Kiran S.,9997,0,9999,2
1657570607407,MATH 197,003,095567,Xiao; Ming,9999,0,9999,0
1657570607407,MATH 197,004,095571,Perols; Johan Lars,9998,0,9999,1
1657570614458,COGS 9,A01,083615,Shannon; Kyle Michael,9,0,75,66
1657570620481,COGS 11,A01,083617,Boyle; Mary E. T.,23,0,48,25
1657570626504,COGS 13,A01,083071,Bastos; Amalia Pinkusfeld,11,0,71,60
1657570632526,COGS 14A,A01,092681,Semenuks; Arturs,5,1,100,95
1657570638550,COGS 14B,A01,083073,Cheng; Tzu-Han,6,0,63,57
1657570644572,COGS 17,A01,092677,Semenuks; Arturs,6,0,81,75
1657570650595,COGS 100,A01,083619,Allen; Michael Gordon,17,0,70,53
1657570656618,COGS 101A,A01,083621,Davis; Joshua Daniel,9,0,68,59
1657570662653,COGS 101B,A01,091572,Allen; Michael Gordon,12,0,65,53
1657570668677,COGS 101C,A01,083625,Delgado; Tania,17,0,35,18
1657570674703,COGS 107A,A01,083627,Boyle; Mary E. T.,13,0,60,47
1657570680725,COGS 118A,A01,083075,Gupta; Anjum,21,0,76,55
1657570686755,CSE 3,A50,083646,Miranda; Gregory Joseph,24,0,50,26
1657570692791,CSE 8A,A50,083650,Miranda; Gregory Joseph,17,1,56,39
1657570698818,CSE 11,A01,083080,Cao; Yingjun,6,15,40,34
1657570704854,CSE 12,A01,083652,Krause-Levy; Sophia Louisa,28,1,120,92
1657570710881,CSE 15L,A01,083654,Morris; Justin Loren,9,0,50,41
1657570710881,CSE 15L,A02,083655,Morris; Justin Loren,9,0,50,41
1657570716905,CSE 20,A01,083657,Tran; Khoa Dang,39,0,80,41
1657570722933,CSE 21,A01,095574,Bach; Quang Tran,22,0,48,26
1657570728990,CSE 30,A01,083084,Eldon; John,5,0,80,75
1657570728990,CSE 30,B01,095061,Bhaskar; Nishant,9,0,50,41
1657570735017,CSE 100,A01,083659,Cao; Yingjun,5,4,70,65
1657570741047,CSE 134B,A01,083661,Powell; Thomas Allan,22,0,100,78
1657570747080,CSE 140,A01,083663,Gungor; Onat,15,0,85,70
1657570753103,CSE 140L,A01,083088,Eldon; John,21,0,100,79
1657570759129,CSE 175,A01,083665,Kumar; Rakesh,3,0,25,22
1657570765165,CSE 190,A00,092507,Dubnov; Shlomo,8,0,20,12
1657570771206,ECE 45,A01,083139,Congero; Spencer William,6,0,75,69
1657570777239,ECE 65,A50,083695,Saad; Andrew S,12,0,30,18
1657570777239,ECE 65,A51,095125,Saad; Andrew S,24,0,26,2
1657570783275,ECE 109,A01,091882,Touri; Behrouz,19,0,70,51
1657570789314,ECE 180,A00,083140,Abi Samra; Nicholas Camill,1,0,30,29
1657570789314,ECE 180,B00,083141,Abi Samra; Nicholas Camill,0,0,30,30
1657570795342,MATH 10A,A01,083735,Patchell; Gregory David,2,0,30,28
1657570795342,MATH 10A,A02,083736,Patchell; Gregory David,20,0,30,10
1657570795342,MATH 10A,A03,083737,Patchell; Gregory David,16,0,30,14
1657570801377,MATH 10B,A01,083207,Lim; Seonhee,8,0,34,26
1657570801377,MATH 10B,A02,083208,Lim; Seonhee,9,0,35,26
1657570801377,MATH 10B,A03,093472,Lim; Seonhee,7,0,34,27
1657570801377,MATH 10B,B01,083739,Sinha; Shubham,12,0,30,18
1657570807406,MATH 18,A01,083743,Cinel; Cameron Alexander,7,0,30,23
1657570807406,MATH 18,A02,083744,Cinel; Cameron Alexander,17,0,30,13
1657570807406,MATH 18,A03,083745,Cinel; Cameron Alexander,9,0,30,21
1657570807406,MATH 18,B01,083748,Rideout; David Porter,5,0,37,32
1657570807406,MATH 18,B02,083749,Rideout; David Porter,5,0,36,31
1657570807406,MATH 18,B03,083750,Rideout; David Porter,3,0,37,34
1657570807406,MATH 18,B04,083751,Rideout; David Porter,6,0,36,30
1657570807406,MATH 18,B05,093473,Rideout; David Porter,6,0,36,30
1657570807406,MATH 18,B06,093474,Rideout; David Porter,6,0,36,30
1657570813428,MATH 20A,A01,083754,Zheng; Zequn,14,0,40,26
1657570819455,MATH 20B,A01,083756,Briones; Jor-el Thomas Caparas,4,0,36,32
1657570819455,MATH 20B,A02,083757,Briones; Jor-el Thomas Caparas,1,0,36,35
1657570819455,MATH 20B,A03,093475,Briones; Jor-el Thomas Caparas,2,0,36,34
1657570825493,MATH 20C,A01,083760,Briones; Jor-el Thomas Caparas,1,0,35,34
1657570825493,MATH 20C,A02,083761,Briones; Jor-el Thomas Caparas,8,0,35,27
1657570825493,MATH 20C,A03,093476,Briones; Jor-el Thomas Caparas,0,1,36,36
1657570825493,MATH 20C,B01,083762,Bach; Quang Tran,1,0,30,29
1657570831520,MATH 20D,A01,083765,Tran; Brian Kha,5,0,30,25
1657570831520,MATH 20D,A02,083766,Tran; Brian Kha,5,0,30,25
1657570831520,MATH 20D,A03,083767,Tran; Brian Kha,5,0,30,25
1657570837548,MATH 20E,A01,083771,Ganguly; Soumya,9,0,32,23
1657570837548,MATH 20E,A02,083772,Ganguly; Soumya,6,0,32,26
1657570837548,MATH 20E,B01,083773,Ciotti; Benjamin,20,0,35,15
1657570837548,MATH 20E,B02,083774,Ciotti; Benjamin,17,0,35,18
1657570843571,MATH 103A,A01,083777,Greenfeld; Be'Eri,3,0,36,33
1657570843571,MATH 103A,A02,083778,Greenfeld; Be'Eri,5,0,36,31
1657570843571,MATH 103A,A03,093561,Greenfeld; Be'Eri,5,0,36,31
1657570843571,MATH 103A,B01,083779,Greenfeld; Be'Eri,7,0,36,29
1657570843571,MATH 103A,B02,083780,Greenfeld; Be'Eri,4,0,36,32
1657570843571,MATH 103A,B03,093562,Greenfeld; Be'Eri,3,0,36,33
1657570849598,MATH 105,A01,085443,Carter; Anne Toulson,15,0,35,20
1657570849598,MATH 105,A02,093477,Carter; Anne Toulson,20,0,35,15
1657570855620,MATH 109,A01,083213,Ganzberger; Geoffrey Michael,2,0,34,32
1657570855620,MATH 109,A02,083214,Ganzberger; Geoffrey Michael,4,0,34,30
1657570855620,MATH 109,A03,093478,Ganzberger; Geoffrey Michael,2,0,34,32
1657570855620,MATH 109,B01,083215,Ganzberger; Geoffrey Michael,1,0,32,31
1657570855620,MATH 109,B02,083216,Ganzberger; Geoffrey Michael,2,0,32,30
1657570855620,MATH 109,B03,093479,Ganzberger; Geoffrey Michael,8,0,32,24
1657570861643,MATH 142A,A01,083219,Chow; Bennett,7,0,32,25
1657570861643,MATH 142A,A02,083220,Chow; Bennett,10,0,32,22
1657570861643,MATH 142A,A03,093480,Chow; Bennett,8,0,32,24
1657570861643,MATH 142A,B03,093481,Chow; Bennett,8,0,32,24
1657570861643,MATH 142A,B04,093558,Chow; Bennett,13,0,32,19
1657570861643,MATH 142A,B05,093559,Chow; Bennett,6,0,32,26
1657570867671,MATH 193A,A01,083224,Rotar; Vladimir,8,0,34,26
1657570867671,MATH 193A,A02,083225,Rotar; Vladimir,9,0,34,25
1657570867671,MATH 193A,A03,083781,Rotar; Vladimir,5,0,34,29
1657570867671,MATH 193A,A04,083782,Rotar; Vladimir,10,0,34,24
1657570867671,MATH 193A,A05,093482,Rotar; Vladimir,10,0,34,24
1657570873693,MATH 197,001,091859,McAuley; Julian John,9999,0,9999,0
1657570873693,MATH 197,002,095566,Kedlaya; Kiran S.,9997,0,9999,2
1657570873693,MATH 197,003,095567,Xiao; Ming,9999,0,9999,0
1657570873693,MATH 197,004,095571,Perols; Johan Lars,9998,0,9999,1
1657570880766,COGS 9,A01,083615,Shannon; Kyle Michael,9,0,75,66
1657570886790,COGS 11,A01,083617,Boyle; Mary E. T.,23,0,48,25
1657570892813,COGS 13,A01,083071,Bastos; Amalia Pinkusfeld,11,0,71,60
1657570898839,COGS 14A,A01,092681,Semenuks; Arturs,5,1,100,95
1657570904863,COGS 14B,A01,083073,Cheng; Tzu-Han,6,0,63,57
1657570910897,COGS 17,A01,092677,Semenuks; Arturs,6,0,81,75
1657570916920,COGS 100,A01,083619,Allen; Michael Gordon,17,0,70,53
1657570922948,COGS 101A,A01,083621,Davis; Joshua Daniel,9,0,68,59
1657570928974,COGS 101B,A01,091572,Allen; Michael Gordon,12,0,65,53
1657570935004,COGS 101C,A01,083625,Delgado; Tania,17,0,35,18
1657570941030,COGS 107A,A01,083627,Boyle; Mary E. T.,13,0,60,47
1657570947052,COGS 118A,A01,083075,Gupta; Anjum,21,0,76,55
1657570953085,CSE 3,A50,083646,Miranda; Gregory Joseph,24,0,50,26
1657570959108,CSE 8A,A50,083650,Miranda; Gregory Joseph,17,1,56,39
1657570965135,CSE 11,A01,083080,Cao; Yingjun,6,15,40,34
1657570971170,CSE 12,A01,083652,Krause-Levy; Sophia Louisa,28,1,120,92
1657570977201,CSE 15L,A01,083654,Morris; Justin Loren,9,0,50,41
1657570977201,CSE 15L,A02,083655,Morris; Justin Loren,9,0,50,41
1657570983240,CSE 20,A01,083657,Tran; Khoa Dang,39,0,80,41
1657570989271,CSE 21,A01,095574,Bach; Quang Tran,22,0,48,26
1657570995293,CSE 30,A01,083084,Eldon; John,5,0,80,75
1657570995293,CSE 30,B01,095061,Bhaskar; Nishant,9,0,50,41
1657571001315,CSE 100,A01,083659,Cao; Yingjun,5,4,70,65
1657571007345,CSE 134B,A01,083661,Powell; Thomas Allan,22,0,100,78
1657571013369,CSE 140,A01,083663,Gungor; Onat,15,0,85,70
1657571019396,CSE 140L,A01,083088,Eldon; John,21,0,100,79
1657571025423,CSE 175,A01,083665,Kumar; Rakesh,3,0,25,22
1657571031448,CSE 190,A00,092507,Dubnov; Shlomo,8,0,20,12
1657571037477,ECE 45,A01,083139,Congero; Spencer William,6,0,75,69
1657571043500,ECE 65,A50,083695,Saad; Andrew S,12,0,30,18
1657571043500,ECE 65,A51,095125,Saad; Andrew S,24,0,26,2
1657571049523,ECE 109,A01,091882,Touri; Behrouz,19,0,70,51
1657571055548,ECE 180,A00,083140,Abi Samra; Nicholas Camill,1,0,30,29
1657571055548,ECE 180,B00,083141,Abi Samra; Nicholas Camill,0,0,30,30
1657571061579,MATH 10A,A01,083735,Patchell; Gregory David,2,0,30,28
1657571061579,MATH 10A,A02,083736,Patchell; Gregory David,20,0,30,10
1657571061579,MATH 10A,A03,083737,Patchell; Gregory David,16,0,30,14
1657571067608,MATH 10B,A01,083207,Lim; Seonhee,8,0,34,26
1657571067608,MATH 10B,A02,083208,Lim; Seonhee,9,0,35,26
1657571067608,MATH 10B,A03,093472,Lim; Seonhee,7,0,34,27
1657571067608,MATH 10B,B01,083739,Sinha; Shubham,12,0,30,18
1657571073649,MATH 18,A01,083743,Cinel; Cameron Alexander,7,0,30,23
1657571073649,MATH 18,A02,083744,Cinel; Cameron Alexander,17,0,30,13
1657571073649,MATH 18,A03,083745,Cinel; Cameron Alexander,9,0,30,21
1657571073649,MATH 18,B01,083748,Rideout; David Porter,5,0,37,32
1657571073649,MATH 18,B02,083749,Rideout; David Porter,5,0,36,31
1657571073649,MATH 18,B03,083750,Rideout; David Porter,3,0,37,34
1657571073649,MATH 18,B04,083751,Rideout; David Porter,6,0,36,30
1657571073649,MATH 18,B05,093473,Rideout; David Porter,6,0,36,30
1657571073649,MATH 18,B06,093474,Rideout; David Porter,6,0,36,30
1657571079675,MATH 20A,A01,083754,Zheng; Zequn,14,0,40,26
1657571085698,MATH 20B,A01,083756,Briones; Jor-el Thomas Caparas,4,0,36,32
1657571085698,MATH 20B,A02,083757,Briones; Jor-el Thomas Caparas,1,0,36,35
1657571085698,MATH 20B,A03,093475,Briones; Jor-el Thomas Caparas,2,0,36,34
1657571091719,MATH 20C,A01,083760,Briones; Jor-el Thomas Caparas,1,0,35,34
1657571091719,MATH 20C,A02,083761,Briones; Jor-el Thomas Caparas,8,0,35,27
1657571091719,MATH 20C,A03,093476,Briones; Jor-el Thomas Caparas,0,1,36,36
1657571091719,MATH 20C,B01,083762,Bach; Quang Tran,1,0,30,29
1657571097742,MATH 20D,A01,083765,Tran; Brian Kha,5,0,30,25
1657571097742,MATH 20D,A02,083766,Tran; Brian Kha,5,0,30,25
1657571097742,MATH 20D,A03,083767,Tran; Brian Kha,5,0,30,25
1657571103767,MATH 20E,A01,083771,Ganguly; Soumya,9,0,32,23
1657571103767,MATH 20E,A02,083772,Ganguly; Soumya,6,0,32,26
1657571103767,MATH 20E,B01,083773,Ciotti; Benjamin,20,0,35,15
1657571103767,MATH 20E,B02,083774,Ciotti; Benjamin,17,0,35,18
1657571109803,MATH 103A,A01,083777,Greenfeld; Be'Eri,3,0,36,33
1657571109803,MATH 103A,A02,083778,Greenfeld; Be'Eri,5,0,36,31
1657571109803,MATH 103A,A03,093561,Greenfeld; Be'Eri,5,0,36,31
1657571109803,MATH 103A,B01,083779,Greenfeld; Be'Eri,7,0,36,29
1657571109803,MATH 103A,B02,083780,Greenfeld; Be'Eri,4,0,36,32
1657571109803,MATH 103A,B03,093562,Greenfeld; Be'Eri,3,0,36,33
1657571115827,MATH 105,A01,085443,Carter; Anne Toulson,15,0,35,20
1657571115827,MATH 105,A02,093477,Carter; Anne Toulson,20,0,35,15
1657571121852,MATH 109,A01,083213,Ganzberger; Geoffrey Michael,2,0,34,32
1657571121852,MATH 109,A02,083214,Ganzberger; Geoffrey Michael,4,0,34,30
1657571121852,MATH 109,A03,093478,Ganzberger; Geoffrey Michael,2,0,34,32
1657571121852,MATH 109,B01,083215,Ganzberger; Geoffrey Michael,1,0,32,31
1657571121852,MATH 109,B02,083216,Ganzberger; Geoffrey Michael,2,0,32,30
1657571121852,MATH 109,B03,093479,Ganzberger; Geoffrey Michael,8,0,32,24
1657571127882,MATH 142A,A01,083219,Chow; Bennett,7,0,32,25
1657571127882,MATH 142A,A02,083220,Chow; Bennett,10,0,32,22
1657571127882,MATH 142A,A03,093480,Chow; Bennett,8,0,32,24
1657571127882,MATH 142A,B03,093481,Chow; Bennett,8,0,32,24
1657571127882,MATH 142A,B04,093558,Chow; Bennett,13,0,32,19
1657571127882,MATH 142A,B05,093559,Chow; Bennett,6,0,32,26
1657571133904,MATH 193A,A01,083224,Rotar; Vladimir,8,0,34,26
1657571133904,MATH 193A,A02,083225,Rotar; Vladimir,9,0,34,25
1657571133904,MATH 193A,A03,083781,Rotar; Vladimir,5,0,34,29
1657571133904,MATH 193A,A04,083782,Rotar; Vladimir,10,0,34,24
1657571133904,MATH 193A,A05,093482,Rotar; Vladimir,10,0,34,24
1657571139928,MATH 197,001,091859,McAuley; Julian John,9999,0,9999,0
1657571139928,MATH 197,002,095566,Kedlaya; Kiran S.,9997,0,9999,2
1657571139928,MATH 197,003,095567,Xiao; Ming,9999,0,9999,0
1657571139928,MATH 197,004,095571,Perols; Johan Lars,9998,0,9999,1
1657571147007,COGS 9,A01,083615,Shannon; Kyle Michael,9,0,75,66
1657571153031,COGS 11,A01,083617,Boyle; Mary E. T.,23,0,48,25
1657571159056,COGS 13,A01,083071,Bastos; Amalia Pinkusfeld,11,0,71,60
1657571165082,COGS 14A,A01,092681,Semenuks; Arturs,5,1,100,95
1657571171107,COGS 14B,A01,083073,Cheng; Tzu-Han,6,0,63,57
1657571177206,COGS 17,A01,092677,Semenuks; Arturs,6,0,81,75
1657571183229,COGS 100,A01,083619,Allen; Michael Gordon,17,0,70,53
1657571189252,COGS 101A,A01,083621,Davis; Joshua Daniel,9,0,68,59
1657571195291,COGS 101B,A01,091572,Allen; Michael Gordon,12,0,65,53
1657571201319,COGS 101C,A01,083625,Delgado; Tania,17,0,35,18
1657571207341,COGS 107A,A01,083627,Boyle; Mary E. T.,13,0,60,47
1657571213370,COGS 118A,A01,083075,Gupta; Anjum,21,0,76,55
1657571219394,CSE 3,A50,083646,Miranda; Gregory Joseph,24,0,50,26
1657571225418,CSE 8A,A50,083650,Miranda; Gregory Joseph,17,1,56,39
1657571231439,CSE 11,A01,083080,Cao; Yingjun,6,15,40,34
1657571237463,CSE 12,A01,083652,Krause-Levy; Sophia Louisa,28,1,120,92
1657571243486,CSE 15L,A01,083654,Morris; Justin Loren,9,0,50,41
1657571243486,CSE 15L,A02,083655,Morris; Justin Loren,9,0,50,41
1657571249511,CSE 20,A01,083657,Tran; Khoa Dang,39,0,80,41
1657571255544,CSE 21,A01,095574,Bach; Quang Tran,22,0,48,26
1657571261569,CSE 30,A01,083084,Eldon; John,5,0,80,75
1657571261569,CSE 30,B01,095061,Bhaskar; Nishant,9,0,50,41
1657571267591,CSE 100,A01,083659,Cao; Yingjun,5,4,70,65
1657571273615,CSE 134B,A01,083661,Powell; Thomas Allan,22,0,100,78
1657571279637,CSE 140,A01,083663,Gungor; Onat,15,0,85,70
1657571285659,CSE 140L,A01,083088,Eldon; John,21,0,100,79
1657571291683,CSE 175,A01,083665,Kumar; Rakesh,3,0,25,22
1657571297710,CSE 190,A00,092507,Dubnov; Shlomo,8,0,20,12
1657571303738,ECE 45,A01,083139,Congero; Spencer William,6,0,75,69
1657571309764,ECE 65,A50,083695,Saad; Andrew S,12,0,30,18
1657571309764,ECE 65,A51,095125,Saad; Andrew S,24,0,26,2
1657571315798,ECE 109,A01,091882,Touri; Behrouz,19,0,70,51
1657571321827,ECE 180,A00,083140,Abi Samra; Nicholas Camill,1,0,30,29
1657571321827,ECE 180,B00,083141,Abi Samra; Nicholas Camill,0,0,30,30
1657571327851,MATH 10A,A01,083735,Patchell; Gregory David,2,0,30,28
1657571327851,MATH 10A,A02,083736,Patchell; Gregory David,20,0,30,10
1657571327851,MATH 10A,A03,083737,Patchell; Gregory David,16,0,30,14
1657571333875,MATH 10B,A01,083207,Lim; Seonhee,8,0,34,26
1657571333875,MATH 10B,A02,083208,Lim; Seonhee,9,0,35,26
1657571333875,MATH 10B,A03,093472,Lim; Seonhee,7,0,34,27
1657571333875,MATH 10B,B01,083739,Sinha; Shubham,12,0,30,18
1657571339899,MATH 18,A01,083743,Cinel; Cameron Alexander,7,0,30,23
1657571339899,MATH 18,A02,083744,Cinel; Cameron Alexander,17,0,30,13
1657571339899,MATH 18,A03,083745,Cinel; Cameron Alexander,9,0,30,21
1657571339899,MATH 18,B01,083748,Rideout; David Porter,5,0,37,32
1657571339899,MATH 18,B02,083749,Rideout; David Porter,5,0,36,31
1657571339899,MATH 18,B03,083750,Rideout; David Porter,3,0,37,34
1657571339899,MATH 18,B04,083751,Rideout; David Porter,6,0,36,30
1657571339899,MATH 18,B05,093473,Rideout; David Porter,6,0,36,30
1657571339899,MATH 18,B06,093474,Rideout; David Porter,6,0,36,30
1657571345926,MATH 20A,A01,083754,Zheng; Zequn,14,0,40,26
1657571351952,MATH 20B,A01,083756,Briones; Jor-el Thomas Caparas,4,0,36,32
1657571351952,MATH 20B,A02,083757,Briones; Jor-el Thomas Caparas,1,0,36,35
1657571351952,MATH 20B,A03,093475,Briones; Jor-el Thomas Caparas,2,0,36,34
1657571358000,MATH 20C,A01,083760,Briones; Jor-el Thomas Caparas,1,0,35,34
1657571358000,MATH 20C,A02,083761,Briones; Jor-el Thomas Caparas,8,0,35,27
1657571358000,MATH 20C,A03,093476,Briones; Jor-el Thomas Caparas,0,1,36,36
1657571358000,MATH 20C,B01,083762,Bach; Quang Tran,1,0,30,29
1657571364024,MATH 20D,A01,083765,Tran; Brian Kha,5,0,30,25
1657571364024,MATH 20D,A02,083766,Tran; Brian Kha,5,0,30,25
1657571364024,MATH 20D,A03,083767,Tran; Brian Kha,5,0,30,25
1657571370056,MATH 20E,A01,083771,Ganguly; Soumya,9,0,32,23
1657571370056,MATH 20E,A02,083772,Ganguly; Soumya,6,0,32,26
1657571370056,MATH 20E,B01,083773,Ciotti; Benjamin,20,0,35,15
1657571370056,MATH 20E,B02,083774,Ciotti; Benjamin,17,0,35,18
1657571376096,MATH 103A,A01,083777,Greenfeld; Be'Eri,3,0,36,33
1657571376096,MATH 103A,A02,083778,Greenfeld; Be'Eri,5,0,36,31
1657571376096,MATH 103A,A03,093561,Greenfeld; Be'Eri,5,0,36,31
1657571376096,MATH 103A,B01,083779,Greenfeld; Be'Eri,7,0,36,29
1657571376096,MATH 103A,B02,083780,Greenfeld; Be'Eri,4,0,36,32
1657571376096,MATH 103A,B03,093562,Greenfeld; Be'Eri,3,0,36,33
1657571382124,MATH 105,A01,085443,Carter; Anne Toulson,15,0,35,20
1657571382124,MATH 105,A02,093477,Carter; Anne Toulson,20,0,35,15
1657571388155,MATH 109,A01,083213,Ganzberger; Geoffrey Michael,2,0,34,32
1657571388155,MATH 109,A02,083214,Ganzberger; Geoffrey Michael,4,0,34,30
1657571388155,MATH 109,A03,093478,Ganzberger; Geoffrey Michael,2,0,34,32
1657571388155,MATH 109,B01,083215,Ganzberger; Geoffrey Michael,1,0,32,31
1657571388155,MATH 109,B02,083216,Ganzberger; Geoffrey Michael,2,0,32,30
1657571388155,MATH 109,B03,093479,Ganzberger; Geoffrey Michael,8,0,32,24
1657571394183,MATH 142A,A01,083219,Chow; Bennett,7,0,32,25
1657571394183,MATH 142A,A02,083220,Chow; Bennett,10,0,32,22
1657571394183,MATH 142A,A03,093480,Chow; Bennett,8,0,32,24
1657571394183,MATH 142A,B03,093481,Chow; Bennett,8,0,32,24
1657571394183,MATH 142A,B04,093558,Chow; Bennett,13,0,32,19
1657571394183,MATH 142A,B05,093559,Chow; Bennett,6,0,32,26
1657571400211,MATH 193A,A01,083224,Rotar; Vladimir,8,0,34,26
1657571400211,MATH 193A,A02,083225,Rotar; Vladimir,9,0,34,25
1657571400211,MATH 193A,A03,083781,Rotar; Vladimir,5,0,34,29
1657571400211,MATH 193A,A04,083782,Rotar; Vladimir,10,0,34,24
1657571400211,MATH 193A,A05,093482,Rotar; Vladimir,10,0,34,24
1657571406241,MATH 197,001,091859,McAuley; Julian John,9999,0,9999,0
1657571406241,MATH 197,002,095566,Kedlaya; Kiran S.,9997,0,9999,2
1657571406241,MATH 197,003,095567,Xiao; Ming,9999,0,9999,0
1657571406241,MATH 197,004,095571,Perols; Johan Lars,9998,0,9999,1
1657571413301,COGS 9,A01,083615,Shannon; Kyle Michael,9,0,75,66
1657571419331,COGS 11,A01,083617,Boyle; Mary E. T.,23,0,48,25
1657571425358,COGS 13,A01,083071,Bastos; Amalia Pinkusfeld,11,0,71,60
1657571431383,COGS 14A,A01,092681,Semenuks; Arturs,5,1,100,95
1657571437416,COGS 14B,A01,083073,Cheng; Tzu-Han,6,0,63,57
1657571443437,COGS 17,A01,092677,Semenuks; Arturs,6,0,81,75
1657571449458,COGS 100,A01,083619,Allen; Michael Gordon,17,0,70,53
1657571455488,COGS 101A,A01,083621,Davis; Joshua Daniel,9,0,68,59
1657571461517,COGS 101B,A01,091572,Allen; Michael Gordon,12,0,65,53
1657571467553,COGS 101C,A01,083625,Delgado; Tania,17,0,35,18
1657571473576,COGS 107A,A01,083627,Boyle; Mary E. T.,13,0,60,47
1657571479602,COGS 118A,A01,083075,Gupta; Anjum,21,0,76,55
1657571485642,CSE 3,A50,083646,Miranda; Gregory Joseph,24,0,50,26
1657571491665,CSE 8A,A50,083650,Miranda; Gregory Joseph,17,1,56,39
1657571497693,CSE 11,A01,083080,Cao; Yingjun,6,15,40,34
1657571503716,CSE 12,A01,083652,Krause-Levy; Sophia Louisa,28,1,120,92
1657571509744,CSE 15L,A01,083654,Morris; Justin Loren,9,0,50,41
1657571509744,CSE 15L,A02,083655,Morris; Justin Loren,9,0,50,41
1657571515768,CSE 20,A01,083657,Tran; Khoa Dang,39,0,80,41
1657571521789,CSE 21,A01,095574,Bach; Quang Tran,22,0,48,26
1657571527811,CSE 30,A01,083084,Eldon; John,5,0,80,75
1657571527811,CSE 30,B01,095061,Bhaskar; Nishant,9,0,50,41
1657571533833,CSE 100,A01,083659,Cao; Yingjun,5,4,70,65
1657571539856,CSE 134B,A01,083661,Powell; Thomas Allan,22,0,100,78
1657571545877,CSE 140,A01,083663,Gungor; Onat,15,0,85,70
1657571551899,CSE 140L,A01,083088,Eldon; John,21,0,100,79
1657571557929,CSE 175,A01,083665,Kumar; Rakesh,3,0,25,22
1657571563956,CSE 190,A00,092507,Dubnov; Shlomo,8,0,20,12
1657571569979,ECE 45,A01,083139,Congero; Spencer William,6,0,75,69
1657571576002,ECE 65,A50,083695,Saad; Andrew S,12,0,30,18
1657571576002,ECE 65,A51,095125,Saad; Andrew S,24,0,26,2
1657571582028,ECE 109,A01,091882,Touri; Behrouz,19,0,70,51
1657571588065,ECE 180,A00,083140,Abi Samra; Nicholas Camill,1,0,30,29
1657571588065,ECE 180,B00,083141,Abi Samra; Nicholas Camill,0,0,30,30
1657571594087,MATH 10A,A01,083735,Patchell; Gregory David,2,0,30,28
1657571594087,MATH 10A,A02,083736,Patchell; Gregory David,20,0,30,10
1657571594087,MATH 10A,A03,083737,Patchell; Gregory David,16,0,30,14
1657571600116,MATH 10B,A01,083207,Lim; Seonhee,8,0,34,26
1657571600116,MATH 10B,A02,083208,Lim; Seonhee,9,0,35,26
1657571600116,MATH 10B,A03,093472,Lim; Seonhee,7,0,34,27
1657571600116,MATH 10B,B01,083739,Sinha; Shubham,12,0,30,18
1657571606151,MATH 18,A01,083743,Cinel; Cameron Alexander,7,0,30,23
1657571606151,MATH 18,A02,083744,Cinel; Cameron Alexander,17,0,30,13
1657571606151,MATH 18,A03,083745,Cinel; Cameron Alexander,9,0,30,21
1657571606151,MATH 18,B01,083748,Rideout; David Porter,5,0,37,32
1657571606151,MATH 18,B02,083749,Rideout; David Porter,5,0,36,31
1657571606151,MATH 18,B03,083750,Rideout; David Porter,3,0,37,34
1657571606151,MATH 18,B04,083751,Rideout; David Porter,6,0,36,30
1657571606151,MATH 18,B05,093473,Rideout; David Porter,6,0,36,30
1657571606151,MATH 18,B06,093474,Rideout; David Porter,6,0,36,30
1657571612172,MATH 20A,A01,083754,Zheng; Zequn,14,0,40,26
1657571618200,MATH 20B,A01,083756,Briones; Jor-el Thomas Caparas,4,0,36,32
1657571618200,MATH 20B,A02,083757,Briones; Jor-el Thomas Caparas,1,0,36,35
1657571618200,MATH 20B,A03,093475,Briones; Jor-el Thomas Caparas,2,0,36,34
1657571624224,MATH 20C,A01,083760,Briones; Jor-el Thomas Caparas,1,0,35,34
1657571624224,MATH 20C,A02,083761,Briones; Jor-el Thomas Caparas,8,0,35,27
1657571624224,MATH 20C,A03,093476,Briones; Jor-el Thomas Caparas,0,1,36,36
1657571624224,MATH 20C,B01,083762,Bach; Quang Tran,1,0,30,29
1657571630254,MATH 20D,A01,083765,Tran; Brian Kha,5,0,30,25
1657571630254,MATH 20D,A02,083766,Tran; Brian Kha,5,0,30,25
1657571630254,MATH 20D,A03,083767,Tran; Brian Kha,5,0,30,25
1657571636288,MATH 20E,A01,083771,Ganguly; Soumya,9,0,32,23
1657571636288,MATH 20E,A02,083772,Ganguly; Soumya,6,0,32,26
1657571636288,MATH 20E,B01,083773,Ciotti; Benjamin,20,0,35,15
1657571636288,MATH 20E,B02,083774,Ciotti; Benjamin,17,0,35,18
1657571642318,MATH 103A,A01,083777,Greenfeld; Be'Eri,3,0,36,33
1657571642318,MATH 103A,A02,083778,Greenfeld; Be'Eri,5,0,36,31
1657571642318,MATH 103A,A03,093561,Greenfeld; Be'Eri,5,0,36,31
1657571642318,MATH 103A,B01,083779,Greenfeld; Be'Eri,7,0,36,29
1657571642318,MATH 103A,B02,083780,Greenfeld; Be'Eri,4,0,36,32
1657571642318,MATH 103A,B03,093562,Greenfeld; Be'Eri,3,0,36,33
1657571648351,MATH 105,A01,085443,Carter; Anne Toulson,15,0,35,20
1657571648351,MATH 105,A02,093477,Carter; Anne Toulson,20,0,35,15
1657571654381,MATH 109,A01,083213,Ganzberger; Geoffrey Michael,2,0,34,32
1657571654381,MATH 109,A02,083214,Ganzberger; Geoffrey Michael,4,0,34,30
1657571654381,MATH 109,A03,093478,Ganzberger; Geoffrey Michael,2,0,34,32
1657571654381,MATH 109,B01,083215,Ganzberger; Geoffrey Michael,1,0,32,31
1657571654381,MATH 109,B02,083216,Ganzberger; Geoffrey Michael,2,0,32,30
1657571654381,MATH 109,B03,093479,Ganzberger; Geoffrey Michael,8,0,32,24
1657571660403,MATH 142A,A01,083219,Chow; Bennett,7,0,32,25
1657571660403,MATH 142A,A02,083220,Chow; Bennett,10,0,32,22
1657571660403,MATH 142A,A03,093480,Chow; Bennett,8,0,32,24
1657571660403,MATH 142A,B03,093481,Chow; Bennett,8,0,32,24
1657571660403,MATH 142A,B04,093558,Chow; Bennett,13,0,32,19
1657571660403,MATH 142A,B05,093559,Chow; Bennett,6,0,32,26
1657571666430,MATH 193A,A01,083224,Rotar; Vladimir,8,0,34,26
1657571666430,MATH 193A,A02,083225,Rotar; Vladimir,9,0,34,25
1657571666430,MATH 193A,A03,083781,Rotar; Vladimir,5,0,34,29
1657571666430,MATH 193A,A04,083782,Rotar; Vladimir,10,0,34,24
1657571666430,MATH 193A,A05,093482,Rotar; Vladimir,10,0,34,24
1657571672456,MATH 197,001,091859,McAuley; Julian John,9999,0,9999,0
1657571672456,MATH 197,002,095566,Kedlaya; Kiran S.,9997,0,9999,2
1657571672456,MATH 197,003,095567,Xiao; Ming,9999,0,9999,0
1657571672456,MATH 197,004,095571,Perols; Johan Lars,9998,0,9999,1
1657571679523,COGS 9,A01,083615,Shannon; Kyle Michael,9,0,75,66
1657571685547,COGS 11,A01,083617,Boyle; Mary E. T.,23,0,48,25
1657571691570,COGS 13,A01,083071,Bastos; Amalia Pinkusfeld,11,0,71,60
1657571697598,COGS 14A,A01,092681,Semenuks; Arturs,5,1,100,95
1657571703626,COGS 14B,A01,083073,Cheng; Tzu-Han,6,0,63,57
1657571709653,COGS 17,A01,092677,Semenuks; Arturs,6,0,81,75
1657571715678,COGS 100,A01,083619,Allen; Michael Gordon,17,0,70,53
1657571721701,COGS 101A,A01,083621,Davis; Joshua Daniel,9,0,68,59
1657571727728,COGS 101B,A01,091572,Allen; Michael Gordon,12,0,65,53
1657571733754,COGS 101C,A01,083625,Delgado; Tania,17,0,35,18
1657571739777,COGS 107A,A01,083627,Boyle; Mary E. T.,13,0,60,47
1657571745806,COGS 118A,A01,083075,Gupta; Anjum,21,0,76,55
1657571751831,CSE 3,A50,083646,Miranda; Gregory Joseph,24,0,50,26
1657571757858,CSE 8A,A50,083650,Miranda; Gregory Joseph,17,1,56,39
1657571763881,CSE 11,A01,083080,Cao; Yingjun,6,15,40,34
1657571769905,CSE 12,A01,083652,Krause-Levy; Sophia Louisa,28,1,120,92
1657571776019,CSE 15L,A01,083654,Morris; Justin Loren,9,0,50,41
1657571776019,CSE 15L,A02,083655,Morris; Justin Loren,9,0,50,41
1657571782047,CSE 20,A01,083657,Tran; Khoa Dang,39,0,80,41
1657571788070,CSE 21,A01,095574,Bach; Quang Tran,22,0,48,26
1657571794097,CSE 30,A01,083084,Eldon; John,5,0,80,75
1657571794097,CSE 30,B01,095061,Bhaskar; Nishant,9,0,50,41
1657571800124,CSE 100,A01,083659,Cao; Yingjun,5,4,70,65
1657571806145,CSE 134B,A01,083661,Powell; Thomas Allan,22,0,100,78
1657571812168,CSE 140,A01,083663,Gungor; Onat,15,0,85,70
1657571818192,CSE 140L,A01,083088,Eldon; John,21,0,100,79
1657571824220,CSE 175,A01,083665,Kumar; Rakesh,3,0,25,22
1657571830256,CSE 190,A00,092507,Dubnov; Shlomo,8,0,20,12
1657571836284,ECE 45,A01,083139,Congero; Spencer William,6,0,75,69
1657571842306,ECE 65,A50,083695,Saad; Andrew S,12,0,30,18
1657571842306,ECE 65,A51,095125,Saad; Andrew S,24,0,26,2
1657571848329,ECE 109,A01,091882,Touri; Behrouz,19,0,70,51
1657571854351,ECE 180,A00,083140,Abi Samra; Nicholas Camill,1,0,30,29
1657571854351,ECE 180,B00,083141,Abi Samra; Nicholas Camill,0,0,30,30
1657571860388,MATH 10A,A01,083735,Patchell; Gregory David,2,0,30,28
1657571860388,MATH 10A,A02,083736,Patchell; Gregory David,20,0,30,10
1657571860388,MATH 10A,A03,083737,Patchell; Gregory David,16,0,30,14
1657571866422,MATH 10B,A01,083207,Lim; Seonhee,8,0,34,26
1657571866422,MATH 10B,A02,083208,Lim; Seonhee,9,0,35,26
1657571866422,MATH 10B,A03,093472,Lim; Seonhee,7,0,34,27
1657571866422,MATH 10B,B01,083739,Sinha; Shubham,12,0,30,18
1657571872449,MATH 18,A01,083743,Cinel; Cameron Alexander,7,0,30,23
1657571872449,MATH 18,A02,083744,Cinel; Cameron Alexander,17,0,30,13
1657571872449,MATH 18,A03,083745,Cinel; Cameron Alexander,9,0,30,21
1657571872449,MATH 18,B01,083748,Rideout; David Porter,5,0,37,32
1657571872449,MATH 18,B02,083749,Rideout; David Porter,5,0,36,31
1657571872449,MATH 18,B03,083750,Rideout; David Porter,3,0,37,34
1657571872449,MATH 18,B04,083751,Rideout; David Porter,6,0,36,30
1657571872449,MATH 18,B05,093473,Rideout; David Porter,6,0,36,30
1657571872449,MATH 18,B06,093474,Rideout; David Porter,6,0,36,30
1657571878474,MATH 20A,A01,083754,Zheng; Zequn,14,0,40,26
1657571884504,MATH 20B,A01,083756,Briones; Jor-el Thomas Caparas,4,0,36,32
1657571884504,MATH 20B,A02,083757,Briones; Jor-el Thomas Caparas,1,0,36,35
1657571884504,MATH 20B,A03,093475,Briones; Jor-el Thomas Caparas,2,0,36,34
1657571890526,MATH 20C,A01,083760,Briones; Jor-el Thomas Caparas,1,0,35,34
1657571890526,MATH 20C,A02,083761,Briones; Jor-el Thomas Caparas,8,0,35,27
1657571890526,MATH 20C,A03,093476,Briones; Jor-el Thomas Caparas,0,1,36,36
1657571890526,MATH 20C,B01,083762,Bach; Quang Tran,1,0,30,29
1657571896549,MATH 20D,A01,083765,Tran; Brian Kha,5,0,30,25
1657571896549,MATH 20D,A02,083766,Tran; Brian Kha,5,0,30,25
1657571896549,MATH 20D,A03,083767,Tran; Brian Kha,5,0,30,25
1657571902572,MATH 20E,A01,083771,Ganguly; Soumya,9,0,32,23
1657571902572,MATH 20E,A02,083772,Ganguly; Soumya,6,0,32,26
1657571902572,MATH 20E,B01,083773,Ciotti; Benjamin,20,0,35,15
1657571902572,MATH 20E,B02,083774,Ciotti; Benjamin,17,0,35,18
1657571908594,MATH 103A,A01,083777,Greenfeld; Be'Eri,3,0,36,33
1657571908594,MATH 103A,A02,083778,Greenfeld; Be'Eri,5,0,36,31
1657571908594,MATH 103A,A03,093561,Greenfeld; Be'Eri,5,0,36,31
1657571908594,MATH 103A,B01,083779,Greenfeld; Be'Eri,7,0,36,29
1657571908594,MATH 103A,B02,083780,Greenfeld; Be'Eri,4,0,36,32
1657571908594,MATH 103A,B03,093562,Greenfeld; Be'Eri,3,0,36,33
1657571914623,MATH 105,A01,085443,Carter; Anne Toulson,15,0,35,20
1657571914623,MATH 105,A02,093477,Carter; Anne Toulson,20,0,35,15
1657571920647,MATH 109,A01,083213,Ganzberger; Geoffrey Michael,2,0,34,32
1657571920647,MATH 109,A02,083214,Ganzberger; Geoffrey Michael,4,0,34,30
1657571920647,MATH 109,A03,093478,Ganzberger; Geoffrey Michael,2,0,34,32
1657571920647,MATH 109,B01,083215,Ganzberger; Geoffrey Michael,1,0,32,31
1657571920647,MATH 109,B02,083216,Ganzberger; Geoffrey Michael,2,0,32,30
1657571920647,MATH 109,B03,093479,Ganzberger; Geoffrey Michael,8,0,32,24
1657571926675,MATH 142A,A01,083219,Chow; Bennett,7,0,32,25
1657571926675,MATH 142A,A02,083220,Chow; Bennett,10,0,32,22
1657571926675,MATH 142A,A03,093480,Chow; Bennett,8,0,32,24
1657571926675,MATH 142A,B03,093481,Chow; Bennett,8,0,32,24
1657571926675,MATH 142A,B04,093558,Chow; Bennett,13,0,32,19
1657571926675,MATH 142A,B05,093559,Chow; Bennett,6,0,32,26
1657571932697,MATH 193A,A01,083224,Rotar; Vladimir,8,0,34,26
1657571932697,MATH 193A,A02,083225,Rotar; Vladimir,9,0,34,25
1657571932697,MATH 193A,A03,083781,Rotar; Vladimir,5,0,34,29
1657571932697,MATH 193A,A04,083782,Rotar; Vladimir,10,0,34,24
1657571932697,MATH 193A,A05,093482,Rotar; Vladimir,10,0,34,24
1657571938723,MATH 197,001,091859,McAuley; Julian John,9999,0,9999,0
1657571938723,MATH 197,002,095566,Kedlaya; Kiran S.,9997,0,9999,2
1657571938723,MATH 197,003,095567,Xiao; Ming,9999,0,9999,0
1657571938723,MATH 197,004,095571,Perols; Johan Lars,9998,0,9999,1
1657571945780,COGS 9,A01,083615,Shannon; Kyle Michael,9,0,75,66
1657571951814,COGS 11,A01,083617,Boyle; Mary E. T.,23,0,48,25
1657571957836,COGS 13,A01,083071,Bastos; Amalia Pinkusfeld,11,0,71,60
1657571963866,COGS 14A,A01,092681,Semenuks; Arturs,5,1,100,95
1657571969893,COGS 14B,A01,083073,Cheng; Tzu-Han,6,0,63,57
1657571975924,COGS 17,A01,092677,Semenuks; Arturs,6,0,81,75
1657571981949,COGS 100,A01,083619,Allen; Michael Gordon,17,0,70,53
1657571987980,COGS 101A,A01,083621,Davis; Joshua Daniel,9,0,68,59
1657571994003,COGS 101B,A01,091572,Allen; Michael Gordon,12,0,65,53
1657572000037,COGS 101C,A01,083625,Delgado; Tania,17,0,35,18
1657572006066,COGS 107A,A01,083627,Boyle; Mary E. T.,13,0,60,47
1657572012089,COGS 118A,A01,083075,Gupta; Anjum,21,0,76,55
1657572018117,CSE 3,A50,083646,Miranda; Gregory Joseph,24,0,50,26
1657572024155,CSE 8A,A50,083650,Miranda; Gregory Joseph,17,1,56,39
1657572030178,CSE 11,A01,083080,Cao; Yingjun,6,15,40,34
1657572036213,CSE 12,A01,083652,Krause-Levy; Sophia Louisa,28,1,120,92
1657572042246,CSE 15L,A01,083654,Morris; Justin Loren,9,0,50,41
1657572042246,CSE 15L,A02,083655,Morris; Justin Loren,9,0,50,41
1657572048269,CSE 20,A01,083657,Tran; Khoa Dang,39,0,80,41
1657572054296,CSE 21,A01,095574,Bach; Quang Tran,22,0,48,26
1657572060322,CSE 30,A01,083084,Eldon; John,5,0,80,75
1657572060322,CSE 30,B01,095061,Bhaskar; Nishant,9,0,50,41
1657572066348,CSE 100,A01,083659,Cao; Yingjun,5,4,70,65
1657572072369,CSE 134B,A01,083661,Powell; Thomas Allan,22,0,100,78
1657572078398,CSE 140,A01,083663,Gungor; Onat,15,0,85,70
1657572084425,CSE 140L,A01,083088,Eldon; John,21,0,100,79
1657572090447,CSE 175,A01,083665,Kumar; Rakesh,3,0,25,22
1657572096472,CSE 190,A00,092507,Dubnov; Shlomo,8,0,20,12
1657572102506,ECE 45,A01,083139,Congero; Spencer William,6,0,75,69
1657572108528,ECE 65,A50,083695,Saad; Andrew S,12,0,30,18
1657572108528,ECE 65,A51,095125,Saad; Andrew S,24,0,26,2
1657572114553,ECE 109,A01,091882,Touri; Behrouz,19,0,70,51
1657572120577,ECE 180,A00,083140,Abi Samra; Nicholas Camill,1,0,30,29
1657572120577,ECE 180,B00,083141,Abi Samra; Nicholas Camill,0,0,30,30
1657572126615,MATH 10A,A01,083735,Patchell; Gregory David,2,0,30,28
1657572126615,MATH 10A,A02,083736,Patchell; Gregory David,20,0,30,10
1657572126615,MATH 10A,A03,083737,Patchell; Gregory David,16,0,30,14
1657572132653,MATH 10B,A01,083207,Lim; Seonhee,8,0,34,26
1657572132653,MATH 10B,A02,083208,Lim; Seonhee,9,0,35,26
1657572132653,MATH 10B,A03,093472,Lim; Seonhee,7,0,34,27
1657572132653,MATH 10B,B01,083739,Sinha; Shubham,12,0,30,18
1657572138677,MATH 18,A01,083743,Cinel; Cameron Alexander,7,0,30,23
1657572138677,MATH 18,A02,083744,Cinel; Cameron Alexander,17,0,30,13
1657572138677,MATH 18,A03,083745,Cinel; Cameron Alexander,9,0,30,21
1657572138677,MATH 18,B01,083748,Rideout; David Porter,5,0,37,32
1657572138677,MATH 18,B02,083749,Rideout; David Porter,5,0,36,31
1657572138677,MATH 18,B03,083750,Rideout; David Porter,3,0,37,34
1657572138677,MATH 18,B04,083751,Rideout; David Porter,6,0,36,30
1657572138677,MATH 18,B05,093473,Rideout; David Porter,6,0,36,30
1657572138677,MATH 18,B06,093474,Rideout; David Porter,6,0,36,30
1657572144706,MATH 20A,A01,083754,Zheng; Zequn,14,0,40,26
1657572150728,MATH 20B,A01,083756,Briones; Jor-el Thomas Caparas,4,0,36,32
1657572150728,MATH 20B,A02,083757,Briones; Jor-el Thomas Caparas,1,0,36,35
1657572150728,MATH 20B,A03,093475,Briones; Jor-el Thomas Caparas,2,0,36,34
1657572156753,MATH 20C,A01,083760,Briones; Jor-el Thomas Caparas,1,0,35,34
1657572156753,MATH 20C,A02,083761,Briones; Jor-el Thomas Caparas,8,0,35,27
1657572156753,MATH 20C,A03,093476,Briones; Jor-el Thomas Caparas,0,1,36,36
1657572156753,MATH 20C,B01,083762,Bach; Quang Tran,1,0,30,29
1657572162779,MATH 20D,A01,083765,Tran; Brian Kha,5,0,30,25
1657572162779,MATH 20D,A02,083766,Tran; Brian Kha,5,0,30,25
1657572162779,MATH 20D,A03,083767,Tran; Brian Kha,5,0,30,25
1657572168810,MATH 20E,A01,083771,Ganguly; Soumya,9,0,32,23
1657572168810,MATH 20E,A02,083772,Ganguly; Soumya,6,0,32,26
1657572168810,MATH 20E,B01,083773,Ciotti; Benjamin,20,0,35,15
1657572168810,MATH 20E,B02,083774,Ciotti; Benjamin,17,0,35,18
1657572174839,MATH 103A,A01,083777,Greenfeld; Be'Eri,3,0,36,33
1657572174839,MATH 103A,A02,083778,Greenfeld; Be'Eri,5,0,36,31
1657572174839,MATH 103A,A03,093561,Greenfeld; Be'Eri,5,0,36,31
1657572174839,MATH 103A,B01,083779,Greenfeld; Be'Eri,7,0,36,29
1657572174839,MATH 103A,B02,083780,Greenfeld; Be'Eri,4,0,36,32
1657572174839,MATH 103A,B03,093562,Greenfeld; Be'Eri,3,0,36,33
1657572180863,MATH 105,A01,085443,Carter; Anne Toulson,15,0,35,20
1657572180863,MATH 105,A02,093477,Carter; Anne Toulson,20,0,35,15
1657572186885,MATH 109,A01,083213,Ganzberger; Geoffrey Michael,2,0,34,32
1657572186885,MATH 109,A02,083214,Ganzberger; Geoffrey Michael,4,0,34,30
1657572186885,MATH 109,A03,093478,Ganzberger; Geoffrey Michael,2,0,34,32
1657572186885,MATH 109,B01,083215,Ganzberger; Geoffrey Michael,1,0,32,31
1657572186885,MATH 109,B02,083216,Ganzberger; Geoffrey Michael,2,0,32,30
1657572186885,MATH 109,B03,093479,Ganzberger; Geoffrey Michael,8,0,32,24
1657572192907,MATH 142A,A01,083219,Chow; Bennett,7,0,32,25
1657572192907,MATH 142A,A02,083220,Chow; Bennett,10,0,32,22
1657572192907,MATH 142A,A03,093480,Chow; Bennett,8,0,32,24
1657572192907,MATH 142A,B03,093481,Chow; Bennett,8,0,32,24
1657572192907,MATH 142A,B04,093558,Chow; Bennett,13,0,32,19
1657572192907,MATH 142A,B05,093559,Chow; Bennett,6,0,32,26
1657572198935,MATH 193A,A01,083224,Rotar; Vladimir,8,0,34,26
1657572198935,MATH 193A,A02,083225,Rotar; Vladimir,9,0,34,25
1657572198935,MATH 193A,A03,083781,Rotar; Vladimir,5,0,34,29
1657572198935,MATH 193A,A04,083782,Rotar; Vladimir,10,0,34,24
1657572198935,MATH 193A,A05,093482,Rotar; Vladimir,10,0,34,24
1657572204963,MATH 197,001,091859,McAuley; Julian John,9999,0,9999,0
1657572204963,MATH 197,002,095566,Kedlaya; Kiran S.,9997,0,9999,2
1657572204963,MATH 197,003,095567,Xiao; Ming,9999,0,9999,0
1657572204963,MATH 197,004,095571,Perols; Johan Lars,9998,0,9999,1
1657572212027,COGS 9,A01,083615,Shannon; Kyle Michael,9,0,75,66
1657572218049,COGS 11,A01,083617,Boyle; Mary E. T.,23,0,48,25
1657572224075,COGS 13,A01,083071,Bastos; Amalia Pinkusfeld,11,0,71,60
1657572230101,COGS 14A,A01,092681,Semenuks; Arturs,5,1,100,95
1657572236126,COGS 14B,A01,083073,Cheng; Tzu-Han,6,0,63,57
1657572242150,COGS 17,A01,092677,Semenuks; Arturs,6,0,81,75
1657572248173,COGS 100,A01,083619,Allen; Michael Gordon,17,0,70,53
1657572254208,COGS 101A,A01,083621,Davis; Joshua Daniel,9,0,68,59
1657572260231,COGS 101B,A01,091572,Allen; Michael Gordon,12,0,65,53
1657572266261,COGS 101C,A01,083625,Delgado; Tania,17,0,35,18
1657572272284,COGS 107A,A01,083627,Boyle; Mary E. T.,13,0,60,47
1657572278314,COGS 118A,A01,083075,Gupta; Anjum,21,0,76,55
1657572284338,CSE 3,A50,083646,Miranda; Gregory Joseph,24,0,50,26
1657572290366,CSE 8A,A50,083650,Miranda; Gregory Joseph,17,1,56,39
1657572296392,CSE 11,A01,083080,Cao; Yingjun,6,15,40,34
1657572302415,CSE 12,A01,083652,Krause-Levy; Sophia Louisa,28,1,120,92
1657572308438,CSE 15L,A01,083654,Morris; Justin Loren,9,0,50,41
1657572308438,CSE 15L,A02,083655,Morris; Justin Loren,9,0,50,41
1657572314463,CSE 20,A01,083657,Tran; Khoa Dang,39,0,80,41
1657572320489,CSE 21,A01,095574,Bach; Quang Tran,22,0,48,26
1657572326520,CSE 30,A01,083084,Eldon; John,5,0,80,75
1657572326520,CSE 30,B01,095061,Bhaskar; Nishant,9,0,50,41
1657572332547,CSE 100,A01,083659,Cao; Yingjun,5,4,70,65
1657572338572,CSE 134B,A01,083661,Powell; Thomas Allan,22,0,100,78
1657572344593,CSE 140,A01,083663,Gungor; Onat,15,0,85,70
1657572350620,CSE 140L,A01,083088,Eldon; John,21,0,100,79
1657572356645,CSE 175,A01,083665,Kumar; Rakesh,3,0,25,22
1657572362670,CSE 190,A00,092507,Dubnov; Shlomo,8,0,20,12
1657572368711,ECE 45,A01,083139,Congero; Spencer William,6,0,75,69
1657572374835,ECE 65,A50,083695,Saad; Andrew S,12,0,30,18
1657572374835,ECE 65,A51,095125,Saad; Andrew S,24,0,26,2
1657572380865,ECE 109,A01,091882,Touri; Behrouz,19,0,70,51
1657572386894,ECE 180,A00,083140,Abi Samra; Nicholas Camill,1,0,30,29
1657572386894,ECE 180,B00,083141,Abi Samra; Nicholas Camill,0,0,30,30
1657572392921,MATH 10A,A01,083735,Patchell; Gregory David,2,0,30,28
1657572392921,MATH 10A,A02,083736,Patchell; Gregory David,20,0,30,10
1657572392921,MATH 10A,A03,083737,Patchell; Gregory David,16,0,30,14
1657572398944,MATH 10B,A01,083207,Lim; Seonhee,8,0,34,26
1657572398944,MATH 10B,A02,083208,Lim; Seonhee,9,0,35,26
1657572398944,MATH 10B,A03,093472,Lim; Seonhee,7,0,34,27
1657572398944,MATH 10B,B01,083739,Sinha; Shubham,12,0,30,18
1657572404982,MATH 18,A01,083743,Cinel; Cameron Alexander,7,0,30,23
1657572404982,MATH 18,A02,083744,Cinel; Cameron Alexander,17,0,30,13
1657572404982,MATH 18,A03,083745,Cinel; Cameron Alexander,9,0,30,21
1657572404982,MATH 18,B01,083748,Rideout; David Porter,5,0,37,32
1657572404982,MATH 18,B02,083749,Rideout; David Porter,5,0,36,31
1657572404982,MATH 18,B03,083750,Rideout; David Porter,3,0,37,34
1657572404982,MATH 18,B04,083751,Rideout; David Porter,6,0,36,30
1657572404982,MATH 18,B05,093473,Rideout; David Porter,6,0,36,30
1657572404982,MATH 18,B06,093474,Rideout; David Porter,6,0,36,30
1657572411004,MATH 20A,A01,083754,Zheng; Zequn,14,0,40,26
1657572417031,MATH 20B,A01,083756,Briones; Jor-el Thomas Caparas,4,0,36,32
1657572417031,MATH 20B,A02,083757,Briones; Jor-el Thomas Caparas,1,0,36,35
1657572417031,MATH 20B,A03,093475,Briones; Jor-el Thomas Caparas,2,0,36,34
1657572423057,MATH 20C,A01,083760,Briones; Jor-el Thomas Caparas,1,0,35,34
1657572423057,MATH 20C,A02,083761,Briones; Jor-el Thomas Caparas,8,0,35,27
1657572423057,MATH 20C,A03,093476,Briones; Jor-el Thomas Caparas,0,1,36,36
1657572423057,MATH 20C,B01,083762,Bach; Quang Tran,1,0,30,29
1657572429087,MATH 20D,A01,083765,Tran; Brian Kha,5,0,30,25
1657572429087,MATH 20D,A02,083766,Tran; Brian Kha,5,0,30,25
1657572429087,MATH 20D,A03,083767,Tran; Brian Kha,5,0,30,25
1657572435117,MATH 20E,A01,083771,Ganguly; Soumya,9,0,32,23
1657572435117,MATH 20E,A02,083772,Ganguly; Soumya,6,0,32,26
1657572435117,MATH 20E,B01,083773,Ciotti; Benjamin,20,0,35,15
1657572435117,MATH 20E,B02,083774,Ciotti; Benjamin,17,0,35,18
1657572441141,MATH 103A,A01,083777,Greenfeld; Be'Eri,3,0,36,33
1657572441141,MATH 103A,A02,083778,Greenfeld; Be'Eri,5,0,36,31
1657572441141,MATH 103A,A03,093561,Greenfeld; Be'Eri,5,0,36,31
1657572441141,MATH 103A,B01,083779,Greenfeld; Be'Eri,7,0,36,29
1657572441141,MATH 103A,B02,083780,Greenfeld; Be'Eri,4,0,36,32
1657572441141,MATH 103A,B03,093562,Greenfeld; Be'Eri,3,0,36,33
1657572447162,MATH 105,A01,085443,Carter; Anne Toulson,15,0,35,20
1657572447162,MATH 105,A02,093477,Carter; Anne Toulson,20,0,35,15
1657572453196,MATH 109,A01,083213,Ganzberger; Geoffrey Michael,2,0,34,32
1657572453196,MATH 109,A02,083214,Ganzberger; Geoffrey Michael,4,0,34,30
1657572453196,MATH 109,A03,093478,Ganzberger; Geoffrey Michael,2,0,34,32
1657572453196,MATH 109,B01,083215,Ganzberger; Geoffrey Michael,1,0,32,31
1657572453196,MATH 109,B02,083216,Ganzberger; Geoffrey Michael,2,0,32,30
1657572453196,MATH 109,B03,093479,Ganzberger; Geoffrey Michael,8,0,32,24
1657572459223,MATH 142A,A01,083219,Chow; Bennett,7,0,32,25
1657572459223,MATH 142A,A02,083220,Chow; Bennett,10,0,32,22
1657572459223,MATH 142A,A03,093480,Chow; Bennett,8,0,32,24
1657572459223,MATH 142A,B03,093481,Chow; Bennett,8,0,32,24
1657572459223,MATH 142A,B04,093558,Chow; Bennett,13,0,32,19
1657572459223,MATH 142A,B05,093559,Chow; Bennett,6,0,32,26
1657572465246,MATH 193A,A01,083224,Rotar; Vladimir,8,0,34,26
1657572465246,MATH 193A,A02,083225,Rotar; Vladimir,9,0,34,25
1657572465246,MATH 193A,A03,083781,Rotar; Vladimir,5,0,34,29
1657572465246,MATH 193A,A04,083782,Rotar; Vladimir,10,0,34,24
1657572465246,MATH 193A,A05,093482,Rotar; Vladimir,10,0,34,24
1657572471284,MATH 197,001,091859,McAuley; Julian John,9999,0,9999,0
1657572471284,MATH 197,002,095566,Kedlaya; Kiran S.,9997,0,9999,2
1657572471284,MATH 197,003,095567,Xiao; Ming,9999,0,9999,0
1657572471284,MATH 197,004,095571,Perols; Johan Lars,9998,0,9999,1
1657572478363,COGS 9,A01,083615,Shannon; Kyle Michael,9,0,75,66
1657572484394,COGS 11,A01,083617,Boyle; Mary E. T.,23,0,48,25
1657572490416,COGS 13,A01,083071,Bastos; Amalia Pinkusfeld,11,0,71,60
1657572496442,COGS 14A,A01,092681,Semenuks; Arturs,5,1,100,95
1657572502464,COGS 14B,A01,083073,Cheng; Tzu-Han,6,0,63,57
1657572508488,COGS 17,A01,092677,Semenuks; Arturs,6,0,81,75
1657572514517,COGS 100,A01,083619,Allen; Michael Gordon,17,0,70,53
1657572520544,COGS 101A,A01,083621,Davis; Joshua Daniel,9,0,68,59
1657572526580,COGS 101B,A01,091572,Allen; Michael Gordon,12,0,65,53
1657572532606,COGS 101C,A01,083625,Delgado; Tania,17,0,35,18
1657572538644,COGS 107A,A01,083627,Boyle; Mary E. T.,13,0,60,47
1657572544669,COGS 118A,A01,083075,Gupta; Anjum,21,0,76,55
1657572550698,CSE 3,A50,083646,Miranda; Gregory Joseph,24,0,50,26
1657572556721,CSE 8A,A50,083650,Miranda; Gregory Joseph,17,1,56,39
1657572562746,CSE 11,A01,083080,Cao; Yingjun,6,15,40,34
1657572568770,CSE 12,A01,083652,Krause-Levy; Sophia Louisa,28,1,120,92
1657572574793,CSE 15L,A01,083654,Morris; Justin Loren,9,0,50,41
1657572574793,CSE 15L,A02,083655,Morris; Justin Loren,9,0,50,41
1657572580831,CSE 20,A01,083657,Tran; Khoa Dang,39,0,80,41
1657572586857,CSE 21,A01,095574,Bach; Quang Tran,22,0,48,26
1657572592884,CSE 30,A01,083084,Eldon; John,5,0,80,75
1657572592884,CSE 30,B01,095061,Bhaskar; Nishant,9,0,50,41
1657572598908,CSE 100,A01,083659,Cao; Yingjun,5,4,70,65
1657572604930,CSE 134B,A01,083661,Powell; Thomas Allan,22,0,100,78
1657572610956,CSE 140,A01,083663,Gungor; Onat,15,0,85,70
1657572616982,CSE 140L,A01,083088,Eldon; John,21,0,100,79
1657572623008,CSE 175,A01,083665,Kumar; Rakesh,3,0,25,22
1657572629033,CSE 190,A00,092507,Dubnov; Shlomo,8,0,20,12
1657572635066,ECE 45,A01,083139,Congero; Spencer William,6,0,75,69
1657572641106,ECE 65,A50,083695,Saad; Andrew S,12,0,30,18
1657572641106,ECE 65,A51,095125,Saad; Andrew S,24,0,26,2
1657572647126,ECE 109,A01,091882,Touri; Behrouz,19,0,70,51
1657572653150,ECE 180,A00,083140,Abi Samra; Nicholas Camill,1,0,30,29
1657572653150,ECE 180,B00,083141,Abi Samra; Nicholas Camill,0,0,30,30
1657572659178,MATH 10A,A01,083735,Patchell; Gregory David,2,0,30,28
1657572659178,MATH 10A,A02,083736,Patchell; Gregory David,20,0,30,10
1657572659178,MATH 10A,A03,083737,Patchell; Gregory David,16,0,30,14
1657572665214,MATH 10B,A01,083207,Lim; Seonhee,8,0,34,26
1657572665214,MATH 10B,A02,083208,Lim; Seonhee,9,0,35,26
1657572665214,MATH 10B,A03,093472,Lim; Seonhee,7,0,34,27
1657572665214,MATH 10B,B01,083739,Sinha; Shubham,12,0,30,18
1657572671238,MATH 18,A01,083743,Cinel; Cameron Alexander,7,0,30,23
1657572671238,MATH 18,A02,083744,Cinel; Cameron Alexander,17,0,30,13
1657572671238,MATH 18,A03,083745,Cinel; Cameron Alexander,9,0,30,21
1657572671238,MATH 18,B01,083748,Rideout; David Porter,5,0,37,32
1657572671238,MATH 18,B02,083749,Rideout; David Porter,5,0,36,31
1657572671238,MATH 18,B03,083750,Rideout; David Porter,3,0,37,34
1657572671238,MATH 18,B04,083751,Rideout; David Porter,6,0,36,30
1657572671238,MATH 18,B05,093473,Rideout; David Porter,6,0,36,30
1657572671238,MATH 18,B06,093474,Rideout; David Porter,6,0,36,30
1657572677262,MATH 20A,A01,083754,Zheng; Zequn,14,0,40,26
1657572683285,MATH 20B,A01,083756,Briones; Jor-el Thomas Caparas,4,0,36,32
1657572683285,MATH 20B,A02,083757,Briones; Jor-el Thomas Caparas,1,0,36,35
1657572683285,MATH 20B,A03,093475,Briones; Jor-el Thomas Caparas,2,0,36,34
1657572689310,MATH 20C,A01,083760,Briones; Jor-el Thomas Caparas,1,0,35,34
1657572689310,MATH 20C,A02,083761,Briones; Jor-el Thomas Caparas,8,0,35,27
1657572689310,MATH 20C,A03,093476,Briones; Jor-el Thomas Caparas,0,1,36,36
1657572689310,MATH 20C,B01,083762,Bach; Quang Tran,1,0,30,29
1657572695333,MATH 20D,A01,083765,Tran; Brian Kha,5,0,30,25
1657572695333,MATH 20D,A02,083766,Tran; Brian Kha,5,0,30,25
1657572695333,MATH 20D,A03,083767,Tran; Brian Kha,5,0,30,25
1657572701359,MATH 20E,A01,083771,Ganguly; Soumya,9,0,32,23
1657572701359,MATH 20E,A02,083772,Ganguly; Soumya,6,0,32,26
1657572701359,MATH 20E,B01,083773,Ciotti; Benjamin,20,0,35,15
1657572701359,MATH 20E,B02,083774,Ciotti; Benjamin,18,0,35,17
1657572707385,MATH 103A,A01,083777,Greenfeld; Be'Eri,3,0,36,33
1657572707385,MATH 103A,A02,083778,Greenfeld; Be'Eri,5,0,36,31
1657572707385,MATH 103A,A03,093561,Greenfeld; Be'Eri,5,0,36,31
1657572707385,MATH 103A,B01,083779,Greenfeld; Be'Eri,7,0,36,29
1657572707385,MATH 103A,B02,083780,Greenfeld; Be'Eri,4,0,36,32
1657572707385,MATH 103A,B03,093562,Greenfeld; Be'Eri,3,0,36,33
1657572713410,MATH 105,A01,085443,Carter; Anne Toulson,15,0,35,20
1657572713410,MATH 105,A02,093477,Carter; Anne Toulson,20,0,35,15
1657572719442,MATH 109,A01,083213,Ganzberger; Geoffrey Michael,2,0,34,32
1657572719442,MATH 109,A02,083214,Ganzberger; Geoffrey Michael,4,0,34,30
1657572719442,MATH 109,A03,093478,Ganzberger; Geoffrey Michael,2,0,34,32
1657572719442,MATH 109,B01,083215,Ganzberger; Geoffrey Michael,1,0,32,31
1657572719442,MATH 109,B02,083216,Ganzberger; Geoffrey Michael,2,0,32,30
1657572719442,MATH 109,B03,093479,Ganzberger; Geoffrey Michael,8,0,32,24
1657572725465,MATH 142A,A01,083219,Chow; Bennett,7,0,32,25
1657572725465,MATH 142A,A02,083220,Chow; Bennett,10,0,32,22
1657572725465,MATH 142A,A03,093480,Chow; Bennett,8,0,32,24
1657572725465,MATH 142A,B03,093481,Chow; Bennett,8,0,32,24
1657572725465,MATH 142A,B04,093558,Chow; Bennett,13,0,32,19
1657572725465,MATH 142A,B05,093559,Chow; Bennett,6,0,32,26
1657572731490,MATH 193A,A01,083224,Rotar; Vladimir,8,0,34,26
1657572731490,MATH 193A,A02,083225,Rotar; Vladimir,9,0,34,25
1657572731490,MATH 193A,A03,083781,Rotar; Vladimir,5,0,34,29
1657572731490,MATH 193A,A04,083782,Rotar; Vladimir,10,0,34,24
1657572731490,MATH 193A,A05,093482,Rotar; Vladimir,10,0,34,24
1657572737515,MATH 197,001,091859,McAuley; Julian John,9999,0,9999,0
1657572737515,MATH 197,002,095566,Kedlaya; Kiran S.,9997,0,9999,2
1657572737515,MATH 197,003,095567,Xiao; Ming,9999,0,9999,0
1657572737515,MATH 197,004,095571,Perols; Johan Lars,9998,0,9999,1
1657572744585,COGS 9,A01,083615,Shannon; Kyle Michael,9,0,75,66
1657572750611,COGS 11,A01,083617,Boyle; Mary E. T.,23,0,48,25
1657572756635,COGS 13,A01,083071,Bastos; Amalia Pinkusfeld,11,0,71,60
1657572762659,COGS 14A,A01,092681,Semenuks; Arturs,5,1,100,95
1657572768688,COGS 14B,A01,083073,Cheng; Tzu-Han,6,0,63,57
1657572774715,COGS 17,A01,092677,Semenuks; Arturs,6,0,81,75
1657572780737,COGS 100,A01,083619,Allen; Michael Gordon,17,0,70,53
1657572786773,COGS 101A,A01,083621,Davis; Joshua Daniel,9,0,68,59
1657572792798,COGS 101B,A01,091572,Allen; Michael Gordon,12,0,65,53
1657572798821,COGS 101C,A01,083625,Delgado; Tania,17,0,35,18
1657572804852,COGS 107A,A01,083627,Boyle; Mary E. T.,13,0,60,47
1657572810878,COGS 118A,A01,083075,Gupta; Anjum,21,0,76,55
1657572816908,CSE 3,A50,083646,Miranda; Gregory Joseph,24,0,50,26
1657572822935,CSE 8A,A50,083650,Miranda; Gregory Joseph,17,1,56,39
1657572828957,CSE 11,A01,083080,Cao; Yingjun,6,15,40,34
1657572834985,CSE 12,A01,083652,Krause-Levy; Sophia Louisa,28,1,120,92
1657572841018,CSE 15L,A01,083654,Morris; Justin Loren,9,0,50,41
1657572841018,CSE 15L,A02,083655,Morris; Justin Loren,9,0,50,41
1657572847049,CSE 20,A01,083657,Tran; Khoa Dang,39,0,80,41
1657572853076,CSE 21,A01,095574,Bach; Quang Tran,22,0,48,26
1657572867588,CSE 30,A01,083084,Eldon; John,5,0,80,75
1657572867588,CSE 30,B01,095061,Bhaskar; Nishant,9,0,50,41
1657572873612,CSE 100,A01,083659,Cao; Yingjun,5,4,70,65
1657572879635,CSE 134B,A01,083661,Powell; Thomas Allan,22,0,100,78
1657572885659,CSE 140,A01,083663,Gungor; Onat,15,0,85,70
1657572891682,CSE 140L,A01,083088,Eldon; John,21,0,100,79
1657572897727,CSE 175,A01,083665,Kumar; Rakesh,3,0,25,22
1657572903749,CSE 190,A00,092507,Dubnov; Shlomo,8,0,20,12
1657572909774,ECE 45,A01,083139,Congero; Spencer William,6,0,75,69
1657572915801,ECE 65,A50,083695,Saad; Andrew S,12,0,30,18
1657572915801,ECE 65,A51,095125,Saad; Andrew S,24,0,26,2
1657572921828,ECE 109,A01,091882,Touri; Behrouz,19,0,70,51
1657572927863,ECE 180,A00,083140,Abi Samra; Nicholas Camill,1,0,30,29
1657572927863,ECE 180,B00,083141,Abi Samra; Nicholas Camill,0,0,30,30
1657572933887,MATH 10A,A01,083735,Patchell; Gregory David,2,0,30,28
1657572933887,MATH 10A,A02,083736,Patchell; Gregory David,20,0,30,10
1657572933887,MATH 10A,A03,083737,Patchell; Gregory David,16,0,30,14
1657572939909,MATH 10B,A01,083207,Lim; Seonhee,8,0,34,26
1657572939909,MATH 10B,A02,083208,Lim; Seonhee,9,0,35,26
1657572939909,MATH 10B,A03,093472,Lim; Seonhee,7,0,34,27
1657572939909,MATH 10B,B01,083739,Sinha; Shubham,12,0,30,18
1657572945944,MATH 18,A01,083743,Cinel; Cameron Alexander,7,0,30,23
1657572945944,MATH 18,A02,083744,Cinel; Cameron Alexander,17,0,30,13
1657572945944,MATH 18,A03,083745,Cinel; Cameron Alexander,9,0,30,21
1657572945944,MATH 18,B01,083748,Rideout; David Porter,5,0,37,32
1657572945944,MATH 18,B02,083749,Rideout; David Porter,5,0,36,31
1657572945944,MATH 18,B03,083750,Rideout; David Porter,3,0,37,34
1657572945944,MATH 18,B04,083751,Rideout; David Porter,6,0,36,30
1657572945944,MATH 18,B05,093473,Rideout; David Porter,6,0,36,30
1657572945944,MATH 18,B06,093474,Rideout; David Porter,6,0,36,30
1657572951967,MATH 20A,A01,083754,Zheng; Zequn,14,0,40,26
1657572957996,MATH 20B,A01,083756,Briones; Jor-el Thomas Caparas,4,0,36,32
1657572957996,MATH 20B,A02,083757,Briones; Jor-el Thomas Caparas,1,0,36,35
1657572957996,MATH 20B,A03,093475,Briones; Jor-el Thomas Caparas,2,0,36,34
1657572964018,MATH 20C,A01,083760,Briones; Jor-el Thomas Caparas,1,0,35,34
1657572964018,MATH 20C,A02,083761,Briones; Jor-el Thomas Caparas,8,0,35,27
1657572964018,MATH 20C,A03,093476,Briones; Jor-el Thomas Caparas,0,1,36,36
1657572964018,MATH 20C,B01,083762,Bach; Quang Tran,1,0,30,29
1657572970045,MATH 20D,A01,083765,Tran; Brian Kha,5,0,30,25
1657572970045,MATH 20D,A02,083766,Tran; Brian Kha,5,0,30,25
1657572970045,MATH 20D,A03,083767,Tran; Brian Kha,5,0,30,25
1657572976075,MATH 20E,A01,083771,Ganguly; Soumya,9,0,32,23
1657572976075,MATH 20E,A02,083772,Ganguly; Soumya,6,0,32,26
1657572976075,MATH 20E,B01,083773,Ciotti; Benjamin,20,0,35,15
1657572976075,MATH 20E,B02,083774,Ciotti; Benjamin,18,0,35,17
1657572982172,MATH 103A,A01,083777,Greenfeld; Be'Eri,3,0,36,33
1657572982172,MATH 103A,A02,083778,Greenfeld; Be'Eri,5,0,36,31
1657572982172,MATH 103A,A03,093561,Greenfeld; Be'Eri,5,0,36,31
1657572982172,MATH 103A,B01,083779,Greenfeld; Be'Eri,7,0,36,29
1657572982172,MATH 103A,B02,083780,Greenfeld; Be'Eri,4,0,36,32
1657572982172,MATH 103A,B03,093562,Greenfeld; Be'Eri,3,0,36,33
1657572988196,MATH 105,A01,085443,Carter; Anne Toulson,15,0,35,20
1657572988196,MATH 105,A02,093477,Carter; Anne Toulson,20,0,35,15
1657572994226,MATH 109,A01,083213,Ganzberger; Geoffrey Michael,2,0,34,32
1657572994226,MATH 109,A02,083214,Ganzberger; Geoffrey Michael,4,0,34,30
1657572994226,MATH 109,A03,093478,Ganzberger; Geoffrey Michael,2,0,34,32
1657572994226,MATH 109,B01,083215,Ganzberger; Geoffrey Michael,1,0,32,31
1657572994226,MATH 109,B02,083216,Ganzberger; Geoffrey Michael,2,0,32,30
1657572994226,MATH 109,B03,093479,Ganzberger; Geoffrey Michael,8,0,32,24
1657573000249,MATH 142A,A01,083219,Chow; Bennett,7,0,32,25
1657573000249,MATH 142A,A02,083220,Chow; Bennett,10,0,32,22
1657573000249,MATH 142A,A03,093480,Chow; Bennett,8,0,32,24
1657573000249,MATH 142A,B03,093481,Chow; Bennett,8,0,32,24
1657573000249,MATH 142A,B04,093558,Chow; Bennett,13,0,32,19
1657573000249,MATH 142A,B05,093559,Chow; Bennett,6,0,32,26
1657573006272,MATH 193A,A01,083224,Rotar; Vladimir,8,0,34,26
1657573006272,MATH 193A,A02,083225,Rotar; Vladimir,9,0,34,25
1657573006272,MATH 193A,A03,083781,Rotar; Vladimir,5,0,34,29
1657573006272,MATH 193A,A04,083782,Rotar; Vladimir,10,0,34,24
1657573006272,MATH 193A,A05,093482,Rotar; Vladimir,10,0,34,24
1657573012293,MATH 197,001,091859,McAuley; Julian John,9999,0,9999,0
1657573012293,MATH 197,002,095566,Kedlaya; Kiran S.,9997,0,9999,2
1657573012293,MATH 197,003,095567,Xiao; Ming,9999,0,9999,0
1657573012293,MATH 197,004,095571,Perols; Johan Lars,9998,0,9999,1
1657573019347,COGS 9,A01,083615,Shannon; Kyle Michael,9,0,75,66
1657573025377,COGS 11,A01,083617,Boyle; Mary E. T.,23,0,48,25
1657573031403,COGS 13,A01,083071,Bastos; Amalia Pinkusfeld,11,0,71,60
1657573037424,COGS 14A,A01,092681,Semenuks; Arturs,5,1,100,95
1657573043449,COGS 14B,A01,083073,Cheng; Tzu-Han,6,0,63,57
1657573049473,COGS 17,A01,092677,Semenuks; Arturs,6,0,81,75
1657573055496,COGS 100,A01,083619,Allen; Michael Gordon,17,0,70,53
1657573061524,COGS 101A,A01,083621,Davis; Joshua Daniel,9,0,68,59
1657573067555,COGS 101B,A01,091572,Allen; Michael Gordon,12,0,65,53
1657573073583,COGS 101C,A01,083625,Delgado; Tania,17,0,35,18
1657573079612,COGS 107A,A01,083627,Boyle; Mary E. T.,13,0,60,47
1657573085643,COGS 118A,A01,083075,Gupta; Anjum,21,0,76,55
1657573091670,CSE 3,A50,083646,Miranda; Gregory Joseph,24,0,50,26
1657573097696,CSE 8A,A50,083650,Miranda; Gregory Joseph,17,1,56,39
1657573103719,CSE 11,A01,083080,Cao; Yingjun,6,15,40,34
1657573109749,CSE 12,A01,083652,Krause-Levy; Sophia Louisa,28,1,120,92
1657573115775,CSE 15L,A01,083654,Morris; Justin Loren,9,0,50,41
1657573115775,CSE 15L,A02,083655,Morris; Justin Loren,9,0,50,41
1657573121814,CSE 20,A01,083657,Tran; Khoa Dang,39,0,80,41
1657573127840,CSE 21,A01,095574,Bach; Quang Tran,22,0,48,26
1657573133868,CSE 30,A01,083084,Eldon; John,5,0,80,75
1657573133868,CSE 30,B01,095061,Bhaskar; Nishant,9,0,50,41
1657573139905,CSE 100,A01,083659,Cao; Yingjun,5,4,70,65
1657573145926,CSE 134B,A01,083661,Powell; Thomas Allan,22,0,100,78
1657573151949,CSE 140,A01,083663,Gungor; Onat,15,0,85,70
1657573157971,CSE 140L,A01,083088,Eldon; John,21,0,100,79
1657573163993,CSE 175,A01,083665,Kumar; Rakesh,3,0,25,22
1657573170017,CSE 190,A00,092507,Dubnov; Shlomo,8,0,20,12
1657573176055,ECE 45,A01,083139,Congero; Spencer William,6,0,75,69
1657573182082,ECE 65,A50,083695,Saad; Andrew S,12,0,30,18
1657573182082,ECE 65,A51,095125,Saad; Andrew S,24,0,26,2
1657573188104,ECE 109,A01,091882,Touri; Behrouz,19,0,70,51
1657573194144,ECE 180,A00,083140,Abi Samra; Nicholas Camill,1,0,30,29
1657573194144,ECE 180,B00,083141,Abi Samra; Nicholas Camill,0,0,30,30
1657573200165,MATH 10A,A01,083735,Patchell; Gregory David,2,0,30,28
1657573200165,MATH 10A,A02,083736,Patchell; Gregory David,20,0,30,10
1657573200165,MATH 10A,A03,083737,Patchell; Gregory David,16,0,30,14
1657573206188,MATH 10B,A01,083207,Lim; Seonhee,8,0,34,26
1657573206188,MATH 10B,A02,083208,Lim; Seonhee,9,0,35,26
1657573206188,MATH 10B,A03,093472,Lim; Seonhee,7,0,34,27
1657573206188,MATH 10B,B01,083739,Sinha; Shubham,12,0,30,18
1657573212213,MATH 18,A01,083743,Cinel; Cameron Alexander,7,0,30,23
1657573212213,MATH 18,A02,083744,Cinel; Cameron Alexander,17,0,30,13
1657573212213,MATH 18,A03,083745,Cinel; Cameron Alexander,9,0,30,21
1657573212213,MATH 18,B01,083748,Rideout; David Porter,5,0,37,32
1657573212213,MATH 18,B02,083749,Rideout; David Porter,5,0,36,31
1657573212213,MATH 18,B03,083750,Rideout; David Porter,3,0,37,34
1657573212213,MATH 18,B04,083751,Rideout; David Porter,6,0,36,30
1657573212213,MATH 18,B05,093473,Rideout; David Porter,6,0,36,30
1657573212213,MATH 18,B06,093474,Rideout; David Porter,6,0,36,30
1657573218242,MATH 20A,A01,083754,Zheng; Zequn,14,0,40,26
1657573224269,MATH 20B,A01,083756,Briones; Jor-el Thomas Caparas,4,0,36,32
1657573224269,MATH 20B,A02,083757,Briones; Jor-el Thomas Caparas,1,0,36,35
1657573224269,MATH 20B,A03,093475,Briones; Jor-el Thomas Caparas,2,0,36,34
1657573230290,MATH 20C,A01,083760,Briones; Jor-el Thomas Caparas,1,0,35,34
1657573230290,MATH 20C,A02,083761,Briones; Jor-el Thomas Caparas,8,0,35,27
1657573230290,MATH 20C,A03,093476,Briones; Jor-el Thomas Caparas,0,1,36,36
1657573230290,MATH 20C,B01,083762,Bach; Quang Tran,1,0,30,29
1657573236324,MATH 20D,A01,083765,Tran; Brian Kha,5,0,30,25
1657573236324,MATH 20D,A02,083766,Tran; Brian Kha,5,0,30,25
1657573236324,MATH 20D,A03,083767,Tran; Brian Kha,5,0,30,25
1657573242350,MATH 20E,A01,083771,Ganguly; Soumya,9,0,32,23
1657573242350,MATH 20E,A02,083772,Ganguly; Soumya,6,0,32,26
1657573242350,MATH 20E,B01,083773,Ciotti; Benjamin,20,0,35,15
1657573242350,MATH 20E,B02,083774,Ciotti; Benjamin,18,0,35,17
1657573248373,MATH 103A,A01,083777,Greenfeld; Be'Eri,3,0,36,33
1657573248373,MATH 103A,A02,083778,Greenfeld; Be'Eri,5,0,36,31
1657573248373,MATH 103A,A03,093561,Greenfeld; Be'Eri,5,0,36,31
1657573248373,MATH 103A,B01,083779,Greenfeld; Be'Eri,7,0,36,29
1657573248373,MATH 103A,B02,083780,Greenfeld; Be'Eri,4,0,36,32
1657573248373,MATH 103A,B03,093562,Greenfeld; Be'Eri,3,0,36,33
1657573254404,MATH 105,A01,085443,Carter; Anne Toulson,15,0,35,20
1657573254404,MATH 105,A02,093477,Carter; Anne Toulson,20,0,35,15
1657573260427,MATH 109,A01,083213,Ganzberger; Geoffrey Michael,2,0,34,32
1657573260427,MATH 109,A02,083214,Ganzberger; Geoffrey Michael,4,0,34,30
1657573260427,MATH 109,A03,093478,Ganzberger; Geoffrey Michael,2,0,34,32
1657573260427,MATH 109,B01,083215,Ganzberger; Geoffrey Michael,1,0,32,31
1657573260427,MATH 109,B02,083216,Ganzberger; Geoffrey Michael,2,0,32,30
1657573260427,MATH 109,B03,093479,Ganzberger; Geoffrey Michael,8,0,32,24
1657573266459,MATH 142A,A01,083219,Chow; Bennett,7,0,32,25
1657573266459,MATH 142A,A02,083220,Chow; Bennett,10,0,32,22
1657573266459,MATH 142A,A03,093480,Chow; Bennett,8,0,32,24
1657573266459,MATH 142A,B03,093481,Chow; Bennett,8,0,32,24
1657573266459,MATH 142A,B04,093558,Chow; Bennett,13,0,32,19
1657573266459,MATH 142A,B05,093559,Chow; Bennett,6,0,32,26
1657573272482,MATH 193A,A01,083224,Rotar; Vladimir,8,0,34,26
1657573272482,MATH 193A,A02,083225,Rotar; Vladimir,9,0,34,25
1657573272482,MATH 193A,A03,083781,Rotar; Vladimir,5,0,34,29
1657573272482,MATH 193A,A04,083782,Rotar; Vladimir,10,0,34,24
1657573272482,MATH 193A,A05,093482,Rotar; Vladimir,10,0,34,24
1657573278503,MATH 197,001,091859,McAuley; Julian John,9999,0,9999,0
1657573278503,MATH 197,002,095566,Kedlaya; Kiran S.,9997,0,9999,2
1657573278503,MATH 197,003,095567,Xiao; Ming,9999,0,9999,0
1657573278503,MATH 197,004,095571,Perols; Johan Lars,9998,0,9999,1
1657573285551,COGS 9,A01,083615,Shannon; Kyle Michael,9,0,75,66
1657573291574,COGS 11,A01,083617,Boyle; Mary E. T.,23,0,48,25
1657573297596,COGS 13,A01,083071,Bastos; Amalia Pinkusfeld,11,0,71,60
1657573303628,COGS 14A,A01,092681,Semenuks; Arturs,5,1,100,95
1657573309662,COGS 14B,A01,083073,Cheng; Tzu-Han,6,0,63,57
1657573315702,COGS 17,A01,092677,Semenuks; Arturs,6,0,81,75
1657573321733,COGS 100,A01,083619,Allen; Michael Gordon,17,0,70,53
1657573327755,COGS 101A,A01,083621,Davis; Joshua Daniel,9,0,68,59
1657573333785,COGS 101B,A01,091572,Allen; Michael Gordon,12,0,65,53
1657573339814,COGS 101C,A01,083625,Delgado; Tania,17,0,35,18
1657573345839,COGS 107A,A01,083627,Boyle; Mary E. T.,13,0,60,47
1657573351876,COGS 118A,A01,083075,Gupta; Anjum,21,0,76,55
1657573357905,CSE 3,A50,083646,Miranda; Gregory Joseph,24,0,50,26
1657573363927,CSE 8A,A50,083650,Miranda; Gregory Joseph,17,1,56,39
1657573369950,CSE 11,A01,083080,Cao; Yingjun,6,15,40,34
1657573375975,CSE 12,A01,083652,Krause-Levy; Sophia Louisa,28,1,120,92
1657573382003,CSE 15L,A01,083654,Morris; Justin Loren,9,0,50,41
1657573382003,CSE 15L,A02,083655,Morris; Justin Loren,9,0,50,41
1657573388024,CSE 20,A01,083657,Tran; Khoa Dang,39,0,80,41
1657573394047,CSE 21,A01,095574,Bach; Quang Tran,22,0,48,26
1657573400069,CSE 30,A01,083084,Eldon; John,5,0,80,75
1657573400069,CSE 30,B01,095061,Bhaskar; Nishant,9,0,50,41
1657573406094,CSE 100,A01,083659,Cao; Yingjun,5,4,70,65
1657573412117,CSE 134B,A01,083661,Powell; Thomas Allan,22,0,100,78
1657573418140,CSE 140,A01,083663,Gungor; Onat,15,0,85,70
1657573424166,CSE 140L,A01,083088,Eldon; John,21,0,100,79
1657573430190,CSE 175,A01,083665,Kumar; Rakesh,3,0,25,22
1657573436214,CSE 190,A00,092507,Dubnov; Shlomo,8,0,20,12
1657573442239,ECE 45,A01,083139,Congero; Spencer William,6,0,75,69
1657573448262,ECE 65,A50,083695,Saad; Andrew S,12,0,30,18
1657573448262,ECE 65,A51,095125,Saad; Andrew S,24,0,26,2
1657573454285,ECE 109,A01,091882,Touri; Behrouz,19,0,70,51
1657573460309,ECE 180,A00,083140,Abi Samra; Nicholas Camill,1,0,30,29
1657573460309,ECE 180,B00,083141,Abi Samra; Nicholas Camill,0,0,30,30
1657573466338,MATH 10A,A01,083735,Patchell; Gregory David,2,0,30,28
1657573466338,MATH 10A,A02,083736,Patchell; Gregory David,20,0,30,10
1657573466338,MATH 10A,A03,083737,Patchell; Gregory David,16,0,30,14
1657573472366,MATH 10B,A01,083207,Lim; Seonhee,8,0,34,26
1657573472366,MATH 10B,A02,083208,Lim; Seonhee,9,0,35,26
1657573472366,MATH 10B,A03,093472,Lim; Seonhee,7,0,34,27
1657573472366,MATH 10B,B01,083739,Sinha; Shubham,12,0,30,18
1657573478395,MATH 18,A01,083743,Cinel; Cameron Alexander,7,0,30,23
1657573478395,MATH 18,A02,083744,Cinel; Cameron Alexander,17,0,30,13
1657573478395,MATH 18,A03,083745,Cinel; Cameron Alexander,9,0,30,21
1657573478395,MATH 18,B01,083748,Rideout; David Porter,5,0,37,32
1657573478395,MATH 18,B02,083749,Rideout; David Porter,5,0,36,31
1657573478395,MATH 18,B03,083750,Rideout; David Porter,3,0,37,34
1657573478395,MATH 18,B04,083751,Rideout; David Porter,6,0,36,30
1657573478395,MATH 18,B05,093473,Rideout; David Porter,6,0,36,30
1657573478395,MATH 18,B06,093474,Rideout; David Porter,6,0,36,30
1657573484418,MATH 20A,A01,083754,Zheng; Zequn,14,0,40,26
1657573490440,MATH 20B,A01,083756,Briones; Jor-el Thomas Caparas,4,0,36,32
1657573490440,MATH 20B,A02,083757,Briones; Jor-el Thomas Caparas,1,0,36,35
1657573490440,MATH 20B,A03,093475,Briones; Jor-el Thomas Caparas,2,0,36,34
1657573496469,MATH 20C,A01,083760,Briones; Jor-el Thomas Caparas,1,0,35,34
1657573496469,MATH 20C,A02,083761,Briones; Jor-el Thomas Caparas,8,0,35,27
1657573496469,MATH 20C,A03,093476,Briones; Jor-el Thomas Caparas,0,1,36,36
1657573496469,MATH 20C,B01,083762,Bach; Quang Tran,1,0,30,29
1657573502498,MATH 20D,A01,083765,Tran; Brian Kha,5,0,30,25
1657573502498,MATH 20D,A02,083766,Tran; Brian Kha,5,0,30,25
1657573502498,MATH 20D,A03,083767,Tran; Brian Kha,5,0,30,25
1657573508522,MATH 20E,A01,083771,Ganguly; Soumya,9,0,32,23
1657573508522,MATH 20E,A02,083772,Ganguly; Soumya,6,0,32,26
1657573508522,MATH 20E,B01,083773,Ciotti; Benjamin,20,0,35,15
1657573508522,MATH 20E,B02,083774,Ciotti; Benjamin,18,0,35,17
1657573514545,MATH 103A,A01,083777,Greenfeld; Be'Eri,3,0,36,33
1657573514545,MATH 103A,A02,083778,Greenfeld; Be'Eri,5,0,36,31
1657573514545,MATH 103A,A03,093561,Greenfeld; Be'Eri,5,0,36,31
1657573514545,MATH 103A,B01,083779,Greenfeld; Be'Eri,7,0,36,29
1657573514545,MATH 103A,B02,083780,Greenfeld; Be'Eri,4,0,36,32
1657573514545,MATH 103A,B03,093562,Greenfeld; Be'Eri,3,0,36,33
1657573520574,MATH 105,A01,085443,Carter; Anne Toulson,15,0,35,20
1657573520574,MATH 105,A02,093477,Carter; Anne Toulson,20,0,35,15
1657573526608,MATH 109,A01,083213,Ganzberger; Geoffrey Michael,2,0,34,32
1657573526608,MATH 109,A02,083214,Ganzberger; Geoffrey Michael,4,0,34,30
1657573526608,MATH 109,A03,093478,Ganzberger; Geoffrey Michael,2,0,34,32
1657573526608,MATH 109,B01,083215,Ganzberger; Geoffrey Michael,1,0,32,31
1657573526608,MATH 109,B02,083216,Ganzberger; Geoffrey Michael,2,0,32,30
1657573526608,MATH 109,B03,093479,Ganzberger; Geoffrey Michael,8,0,32,24
1657573532638,MATH 142A,A01,083219,Chow; Bennett,7,0,32,25
1657573532638,MATH 142A,A02,083220,Chow; Bennett,10,0,32,22
1657573532638,MATH 142A,A03,093480,Chow; Bennett,8,0,32,24
1657573532638,MATH 142A,B03,093481,Chow; Bennett,8,0,32,24
1657573532638,MATH 142A,B04,093558,Chow; Bennett,13,0,32,19
1657573532638,MATH 142A,B05,093559,Chow; Bennett,6,0,32,26
1657573538669,MATH 193A,A01,083224,Rotar; Vladimir,8,0,34,26
1657573538669,MATH 193A,A02,083225,Rotar; Vladimir,9,0,34,25
1657573538669,MATH 193A,A03,083781,Rotar; Vladimir,5,0,34,29
1657573538669,MATH 193A,A04,083782,Rotar; Vladimir,10,0,34,24
1657573538669,MATH 193A,A05,093482,Rotar; Vladimir,10,0,34,24
1657573544697,MATH 197,001,091859,McAuley; Julian John,9999,0,9999,0
1657573544697,MATH 197,002,095566,Kedlaya; Kiran S.,9997,0,9999,2
1657573544697,MATH 197,003,095567,Xiao; Ming,9999,0,9999,0
1657573544697,MATH 197,004,095571,Perols; Johan Lars,9998,0,9999,1
1657573551781,COGS 9,A01,083615,Shannon; Kyle Michael,9,0,75,66
1657573557804,COGS 11,A01,083617,Boyle; Mary E. T.,23,0,48,25
1657573563830,COGS 13,A01,083071,Bastos; Amalia Pinkusfeld,11,0,71,60
1657573569851,COGS 14A,A01,092681,Semenuks; Arturs,5,1,100,95
1657573575961,COGS 14B,A01,083073,Cheng; Tzu-Han,6,0,63,57
1657573581996,COGS 17,A01,092677,Semenuks; Arturs,6,0,81,75
1657573588019,COGS 100,A01,083619,Allen; Michael Gordon,17,0,70,53
1657573594046,COGS 101A,A01,083621,Davis; Joshua Daniel,9,0,68,59
1657573600069,COGS 101B,A01,091572,Allen; Michael Gordon,12,0,65,53
1657573606095,COGS 101C,A01,083625,Delgado; Tania,17,0,35,18
1657573612123,COGS 107A,A01,083627,Boyle; Mary E. T.,13,0,60,47
1657573618149,COGS 118A,A01,083075,Gupta; Anjum,21,0,76,55
1657573624179,CSE 3,A50,083646,Miranda; Gregory Joseph,24,0,50,26
1657573630207,CSE 8A,A50,083650,Miranda; Gregory Joseph,17,1,56,39
1657573636238,CSE 11,A01,083080,Cao; Yingjun,6,15,40,34
1657573642277,CSE 12,A01,083652,Krause-Levy; Sophia Louisa,28,1,120,92
1657573648298,CSE 15L,A01,083654,Morris; Justin Loren,9,0,50,41
1657573648298,CSE 15L,A02,083655,Morris; Justin Loren,9,0,50,41
1657573654326,CSE 20,A01,083657,Tran; Khoa Dang,39,0,80,41
1657573660353,CSE 21,A01,095574,Bach; Quang Tran,22,0,48,26
1657573666381,CSE 30,A01,083084,Eldon; John,5,0,80,75
1657573666381,CSE 30,B01,095061,Bhaskar; Nishant,9,0,50,41
1657573672412,CSE 100,A01,083659,Cao; Yingjun,5,4,70,65
1657573678435,CSE 134B,A01,083661,Powell; Thomas Allan,22,0,100,78
1657573684462,CSE 140,A01,083663,Gungor; Onat,15,0,85,70
1657573690487,CSE 140L,A01,083088,Eldon; John,21,0,100,79
1657573696513,CSE 175,A01,083665,Kumar; Rakesh,3,0,25,22
1657573702538,CSE 190,A00,092507,Dubnov; Shlomo,8,0,20,12
1657573708568,ECE 45,A01,083139,Congero; Spencer William,6,0,75,69
1657573714595,ECE 65,A50,083695,Saad; Andrew S,12,0,30,18
1657573714595,ECE 65,A51,095125,Saad; Andrew S,24,0,26,2
1657573720618,ECE 109,A01,091882,Touri; Behrouz,19,0,70,51
1657573726648,ECE 180,A00,083140,Abi Samra; Nicholas Camill,1,0,30,29
1657573726648,ECE 180,B00,083141,Abi Samra; Nicholas Camill,0,0,30,30
1657573732670,MATH 10A,A01,083735,Patchell; Gregory David,2,0,30,28
1657573732670,MATH 10A,A02,083736,Patchell; Gregory David,20,0,30,10
1657573732670,MATH 10A,A03,083737,Patchell; Gregory David,16,0,30,14
1657573738697,MATH 10B,A01,083207,Lim; Seonhee,8,0,34,26
1657573738697,MATH 10B,A02,083208,Lim; Seonhee,9,0,35,26
1657573738697,MATH 10B,A03,093472,Lim; Seonhee,7,0,34,27
1657573738697,MATH 10B,B01,083739,Sinha; Shubham,12,0,30,18
1657573744719,MATH 18,A01,083743,Cinel; Cameron Alexander,7,0,30,23
1657573744719,MATH 18,A02,083744,Cinel; Cameron Alexander,17,0,30,13
1657573744719,MATH 18,A03,083745,Cinel; Cameron Alexander,9,0,30,21
1657573744719,MATH 18,B01,083748,Rideout; David Porter,5,0,37,32
1657573744719,MATH 18,B02,083749,Rideout; David Porter,5,0,36,31
1657573744719,MATH 18,B03,083750,Rideout; David Porter,3,0,37,34
1657573744719,MATH 18,B04,083751,Rideout; David Porter,6,0,36,30
1657573744719,MATH 18,B05,093473,Rideout; David Porter,6,0,36,30
1657573744719,MATH 18,B06,093474,Rideout; David Porter,6,0,36,30
1657573750748,MATH 20A,A01,083754,Zheng; Zequn,14,0,40,26
1657573756769,MATH 20B,A01,083756,Briones; Jor-el Thomas Caparas,4,0,36,32
1657573756769,MATH 20B,A02,083757,Briones; Jor-el Thomas Caparas,1,0,36,35
1657573756769,MATH 20B,A03,093475,Briones; Jor-el Thomas Caparas,2,0,36,34
1657573762797,MATH 20C,A01,083760,Briones; Jor-el Thomas Caparas,1,0,35,34
1657573762797,MATH 20C,A02,083761,Briones; Jor-el Thomas Caparas,8,0,35,27
1657573762797,MATH 20C,A03,093476,Briones; Jor-el Thomas Caparas,0,1,36,36
1657573762797,MATH 20C,B01,083762,Bach; Quang Tran,1,0,30,29
1657573768818,MATH 20D,A01,083765,Tran; Brian Kha,5,0,30,25
1657573768818,MATH 20D,A02,083766,Tran; Brian Kha,5,0,30,25
1657573768818,MATH 20D,A03,083767,Tran; Brian Kha,5,0,30,25
1657573774845,MATH 20E,A01,083771,Ganguly; Soumya,9,0,32,23
1657573774845,MATH 20E,A02,083772,Ganguly; Soumya,6,0,32,26
1657573774845,MATH 20E,B01,083773,Ciotti; Benjamin,20,0,35,15
1657573774845,MATH 20E,B02,083774,Ciotti; Benjamin,18,0,35,17
1657573780876,MATH 103A,A01,083777,Greenfeld; Be'Eri,3,0,36,33
1657573780876,MATH 103A,A02,083778,Greenfeld; Be'Eri,5,0,36,31
1657573780876,MATH 103A,A03,093561,Greenfeld; Be'Eri,5,0,36,31
1657573780876,MATH 103A,B01,083779,Greenfeld; Be'Eri,7,0,36,29
1657573780876,MATH 103A,B02,083780,Greenfeld; Be'Eri,4,0,36,32
1657573780876,MATH 103A,B03,093562,Greenfeld; Be'Eri,3,0,36,33
1657573786900,MATH 105,A01,085443,Carter; Anne Toulson,15,0,35,20
1657573786900,MATH 105,A02,093477,Carter; Anne Toulson,20,0,35,15
1657573792927,MATH 109,A01,083213,Ganzberger; Geoffrey Michael,2,0,34,32
1657573792927,MATH 109,A02,083214,Ganzberger; Geoffrey Michael,4,0,34,30
1657573792927,MATH 109,A03,093478,Ganzberger; Geoffrey Michael,2,0,34,32
1657573792927,MATH 109,B01,083215,Ganzberger; Geoffrey Michael,1,0,32,31
1657573792927,MATH 109,B02,083216,Ganzberger; Geoffrey Michael,2,0,32,30
1657573792927,MATH 109,B03,093479,Ganzberger; Geoffrey Michael,8,0,32,24
1657573798954,MATH 142A,A01,083219,Chow; Bennett,7,0,32,25
1657573798954,MATH 142A,A02,083220,Chow; Bennett,10,0,32,22
1657573798954,MATH 142A,A03,093480,Chow; Bennett,8,0,32,24
1657573798954,MATH 142A,B03,093481,Chow; Bennett,8,0,32,24
1657573798954,MATH 142A,B04,093558,Chow; Bennett,13,0,32,19
1657573798954,MATH 142A,B05,093559,Chow; Bennett,6,0,32,26
1657573804981,MATH 193A,A01,083224,Rotar; Vladimir,8,0,34,26
1657573804981,MATH 193A,A02,083225,Rotar; Vladimir,9,0,34,25
1657573804981,MATH 193A,A03,083781,Rotar; Vladimir,5,0,34,29
1657573804981,MATH 193A,A04,083782,Rotar; Vladimir,10,0,34,24
1657573804981,MATH 193A,A05,093482,Rotar; Vladimir,10,0,34,24
1657573811010,MATH 197,001,091859,McAuley; Julian John,9999,0,9999,0
1657573811010,MATH 197,002,095566,Kedlaya; Kiran S.,9997,0,9999,2
1657573811010,MATH 197,003,095567,Xiao; Ming,9999,0,9999,0
1657573811010,MATH 197,004,095571,Perols; Johan Lars,9998,0,9999,1
1657573818058,COGS 9,A01,083615,Shannon; Kyle Michael,9,0,75,66
1657573824081,COGS 11,A01,083617,Boyle; Mary E. T.,23,0,48,25
1657573830102,COGS 13,A01,083071,Bastos; Amalia Pinkusfeld,11,0,71,60
1657573836125,COGS 14A,A01,092681,Semenuks; Arturs,5,1,100,95
1657573842149,COGS 14B,A01,083073,Cheng; Tzu-Han,6,0,63,57
1657573848174,COGS 17,A01,092677,Semenuks; Arturs,6,0,81,75
1657573854201,COGS 100,A01,083619,Allen; Michael Gordon,17,0,70,53
1657573860223,COGS 101A,A01,083621,Davis; Joshua Daniel,9,0,68,59
1657573866249,COGS 101B,A01,091572,Allen; Michael Gordon,12,0,65,53
1657573872271,COGS 101C,A01,083625,Delgado; Tania,17,0,35,18
1657573878298,COGS 107A,A01,083627,Boyle; Mary E. T.,13,0,60,47
1657573884324,COGS 118A,A01,083075,Gupta; Anjum,21,0,76,55
1657573890347,CSE 3,A50,083646,Miranda; Gregory Joseph,24,0,50,26
1657573896370,CSE 8A,A50,083650,Miranda; Gregory Joseph,17,1,56,39
1657573902394,CSE 11,A01,083080,Cao; Yingjun,6,15,40,34
1657573908417,CSE 12,A01,083652,Krause-Levy; Sophia Louisa,28,1,120,92
1657573914446,CSE 15L,A01,083654,Morris; Justin Loren,9,0,50,41
1657573914446,CSE 15L,A02,083655,Morris; Justin Loren,9,0,50,41
1657573920470,CSE 20,A01,083657,Tran; Khoa Dang,39,0,80,41
1657573926501,CSE 21,A01,095574,Bach; Quang Tran,22,0,48,26
1657573932529,CSE 30,A01,083084,Eldon; John,5,0,80,75
1657573932529,CSE 30,B01,095061,Bhaskar; Nishant,9,0,50,41
1657573938551,CSE 100,A01,083659,Cao; Yingjun,5,4,70,65
1657573944580,CSE 134B,A01,083661,Powell; Thomas Allan,22,0,100,78
1657573950602,CSE 140,A01,083663,Gungor; Onat,15,0,85,70
1657573956628,CSE 140L,A01,083088,Eldon; John,21,0,100,79
1657573962651,CSE 175,A01,083665,Kumar; Rakesh,3,0,25,22
1657573968693,CSE 190,A00,092507,Dubnov; Shlomo,8,0,20,12
1657573974720,ECE 45,A01,083139,Congero; Spencer William,6,0,75,69
1657573980742,ECE 65,A50,083695,Saad; Andrew S,12,0,30,18
1657573980742,ECE 65,A51,095125,Saad; Andrew S,24,0,26,2
1657573986763,ECE 109,A01,091882,Touri; Behrouz,19,0,70,51
1657573992792,ECE 180,A00,083140,Abi Samra; Nicholas Camill,1,0,30,29
1657573992792,ECE 180,B00,083141,Abi Samra; Nicholas Camill,0,0,30,30
1657573998815,MATH 10A,A01,083735,Patchell; Gregory David,2,0,30,28
1657573998815,MATH 10A,A02,083736,Patchell; Gregory David,20,0,30,10
1657573998815,MATH 10A,A03,083737,Patchell; Gregory David,16,0,30,14
1657574004845,MATH 10B,A01,083207,Lim; Seonhee,8,0,34,26
1657574004845,MATH 10B,A02,083208,Lim; Seonhee,9,0,35,26
1657574004845,MATH 10B,A03,093472,Lim; Seonhee,7,0,34,27
1657574004845,MATH 10B,B01,083739,Sinha; Shubham,12,0,30,18
1657574010868,MATH 18,A01,083743,Cinel; Cameron Alexander,7,0,30,23
1657574010868,MATH 18,A02,083744,Cinel; Cameron Alexander,17,0,30,13
1657574010868,MATH 18,A03,083745,Cinel; Cameron Alexander,9,0,30,21
1657574010868,MATH 18,B01,083748,Rideout; David Porter,5,0,37,32
1657574010868,MATH 18,B02,083749,Rideout; David Porter,5,0,36,31
1657574010868,MATH 18,B03,083750,Rideout; David Porter,3,0,37,34
1657574010868,MATH 18,B04,083751,Rideout; David Porter,6,0,36,30
1657574010868,MATH 18,B05,093473,Rideout; David Porter,6,0,36,30
1657574010868,MATH 18,B06,093474,Rideout; David Porter,6,0,36,30
1657574016890,MATH 20A,A01,083754,Zheng; Zequn,14,0,40,26
1657574022917,MATH 20B,A01,083756,Briones; Jor-el Thomas Caparas,4,0,36,32
1657574022917,MATH 20B,A02,083757,Briones; Jor-el Thomas Caparas,1,0,36,35
1657574022917,MATH 20B,A03,093475,Briones; Jor-el Thomas Caparas,2,0,36,34
1657574028940,MATH 20C,A01,083760,Briones; Jor-el Thomas Caparas,1,0,35,34
1657574028940,MATH 20C,A02,083761,Briones; Jor-el Thomas Caparas,8,0,35,27
1657574028940,MATH 20C,A03,093476,Briones; Jor-el Thomas Caparas,0,1,36,36
1657574028940,MATH 20C,B01,083762,Bach; Quang Tran,1,0,30,29
1657574034981,MATH 20D,A01,083765,Tran; Brian Kha,5,0,30,25
1657574034981,MATH 20D,A02,083766,Tran; Brian Kha,5,0,30,25
1657574034981,MATH 20D,A03,083767,Tran; Brian Kha,5,0,30,25
1657574041005,MATH 20E,A01,083771,Ganguly; Soumya,9,0,32,23
1657574041005,MATH 20E,A02,083772,Ganguly; Soumya,6,0,32,26
1657574041005,MATH 20E,B01,083773,Ciotti; Benjamin,20,0,35,15
1657574041005,MATH 20E,B02,083774,Ciotti; Benjamin,18,0,35,17
1657574047029,MATH 103A,A01,083777,Greenfeld; Be'Eri,3,0,36,33
1657574047029,MATH 103A,A02,083778,Greenfeld; Be'Eri,5,0,36,31
1657574047029,MATH 103A,A03,093561,Greenfeld; Be'Eri,5,0,36,31
1657574047029,MATH 103A,B01,083779,Greenfeld; Be'Eri,7,0,36,29
1657574047029,MATH 103A,B02,083780,Greenfeld; Be'Eri,4,0,36,32
1657574047029,MATH 103A,B03,093562,Greenfeld; Be'Eri,3,0,36,33
1657574053056,MATH 105,A01,085443,Carter; Anne Toulson,15,0,35,20
1657574053056,MATH 105,A02,093477,Carter; Anne Toulson,20,0,35,15
1657574059080,MATH 109,A01,083213,Ganzberger; Geoffrey Michael,2,0,34,32
1657574059080,MATH 109,A02,083214,Ganzberger; Geoffrey Michael,4,0,34,30
1657574059080,MATH 109,A03,093478,Ganzberger; Geoffrey Michael,2,0,34,32
1657574059080,MATH 109,B01,083215,Ganzberger; Geoffrey Michael,1,0,32,31
1657574059080,MATH 109,B02,083216,Ganzberger; Geoffrey Michael,2,0,32,30
1657574059080,MATH 109,B03,093479,Ganzberger; Geoffrey Michael,8,0,32,24
1657574065103,MATH 142A,A01,083219,Chow; Bennett,7,0,32,25
1657574065103,MATH 142A,A02,083220,Chow; Bennett,10,0,32,22
1657574065103,MATH 142A,A03,093480,Chow; Bennett,8,0,32,24
1657574065103,MATH 142A,B03,093481,Chow; Bennett,8,0,32,24
1657574065103,MATH 142A,B04,093558,Chow; Bennett,13,0,32,19
1657574065103,MATH 142A,B05,093559,Chow; Bennett,6,0,32,26
1657574071139,MATH 193A,A01,083224,Rotar; Vladimir,8,0,34,26
1657574071139,MATH 193A,A02,083225,Rotar; Vladimir,9,0,34,25
1657574071139,MATH 193A,A03,083781,Rotar; Vladimir,5,0,34,29
1657574071139,MATH 193A,A04,083782,Rotar; Vladimir,10,0,34,24
1657574071139,MATH 193A,A05,093482,Rotar; Vladimir,10,0,34,24
1657574077172,MATH 197,001,091859,McAuley; Julian John,9999,0,9999,0
1657574077172,MATH 197,002,095566,Kedlaya; Kiran S.,9997,0,9999,2
1657574077172,MATH 197,003,095567,Xiao; Ming,9999,0,9999,0
1657574077172,MATH 197,004,095571,Perols; Johan Lars,9998,0,9999,1
1657574084219,COGS 9,A01,083615,Shannon; Kyle Michael,9,0,75,66
1657574090241,COGS 11,A01,083617,Boyle; Mary E. T.,23,0,48,25
1657574096262,COGS 13,A01,083071,Bastos; Amalia Pinkusfeld,11,0,71,60
1657574102285,COGS 14A,A01,092681,Semenuks; Arturs,5,1,100,95
1657574108308,COGS 14B,A01,083073,Cheng; Tzu-Han,6,0,63,57
1657574114330,COGS 17,A01,092677,Semenuks; Arturs,6,0,81,75
1657574120367,COGS 100,A01,083619,Allen; Michael Gordon,17,0,70,53
1657574126394,COGS 101A,A01,083621,Davis; Joshua Daniel,9,0,68,59
1657574132417,COGS 101B,A01,091572,Allen; Michael Gordon,12,0,65,53
1657574138440,COGS 101C,A01,083625,Delgado; Tania,17,0,35,18
1657574144475,COGS 107A,A01,083627,Boyle; Mary E. T.,13,0,60,47
1657574150503,COGS 118A,A01,083075,Gupta; Anjum,21,0,76,55
1657574156529,CSE 3,A50,083646,Miranda; Gregory Joseph,24,0,50,26
1657574162553,CSE 8A,A50,083650,Miranda; Gregory Joseph,17,1,56,39
1657574168586,CSE 11,A01,083080,Cao; Yingjun,6,15,40,34
1657574174700,CSE 12,A01,083652,Krause-Levy; Sophia Louisa,28,1,120,92
1657574180726,CSE 15L,A01,083654,Morris; Justin Loren,9,0,50,41
1657574180726,CSE 15L,A02,083655,Morris; Justin Loren,9,0,50,41
1657574186750,CSE 20,A01,083657,Tran; Khoa Dang,39,0,80,41
1657574192775,CSE 21,A01,095574,Bach; Quang Tran,22,0,48,26
1657574198799,CSE 30,A01,083084,Eldon; John,5,0,80,75
1657574198799,CSE 30,B01,095061,Bhaskar; Nishant,9,0,50,41
1657574204823,CSE 100,A01,083659,Cao; Yingjun,5,4,70,65
1657574210846,CSE 134B,A01,083661,Powell; Thomas Allan,22,0,100,78
1657574216876,CSE 140,A01,083663,Gungor; Onat,15,0,85,70
1657574222899,CSE 140L,A01,083088,Eldon; John,21,0,100,79
1657574228927,CSE 175,A01,083665,Kumar; Rakesh,3,0,25,22
1657574234965,CSE 190,A00,092507,Dubnov; Shlomo,8,0,20,12
1657574240988,ECE 45,A01,083139,Congero; Spencer William,6,0,75,69
1657574247013,ECE 65,A50,083695,Saad; Andrew S,12,0,30,18
1657574247013,ECE 65,A51,095125,Saad; Andrew S,24,0,26,2
1657574253047,ECE 109,A01,091882,Touri; Behrouz,19,0,70,51
1657574259078,ECE 180,A00,083140,Abi Samra; Nicholas Camill,1,0,30,29
1657574259078,ECE 180,B00,083141,Abi Samra; Nicholas Camill,0,0,30,30
1657574265101,MATH 10A,A01,083735,Patchell; Gregory David,2,0,30,28
1657574265101,MATH 10A,A02,083736,Patchell; Gregory David,20,0,30,10
1657574265101,MATH 10A,A03,083737,Patchell; Gregory David,16,0,30,14
1657574271133,MATH 10B,A01,083207,Lim; Seonhee,8,0,34,26
1657574271133,MATH 10B,A02,083208,Lim; Seonhee,9,0,35,26
1657574271133,MATH 10B,A03,093472,Lim; Seonhee,7,0,34,27
1657574271133,MATH 10B,B01,083739,Sinha; Shubham,12,0,30,18
1657574277163,MATH 18,A01,083743,Cinel; Cameron Alexander,7,0,30,23
1657574277163,MATH 18,A02,083744,Cinel; Cameron Alexander,17,0,30,13
1657574277163,MATH 18,A03,083745,Cinel; Cameron Alexander,9,0,30,21
1657574277163,MATH 18,B01,083748,Rideout; David Porter,5,0,37,32
1657574277163,MATH 18,B02,083749,Rideout; David Porter,5,0,36,31
1657574277163,MATH 18,B03,083750,Rideout; David Porter,3,0,37,34
1657574277163,MATH 18,B04,083751,Rideout; David Porter,6,0,36,30
1657574277163,MATH 18,B05,093473,Rideout; David Porter,6,0,36,30
1657574277163,MATH 18,B06,093474,Rideout; David Porter,6,0,36,30
1657574283186,MATH 20A,A01,083754,Zheng; Zequn,14,0,40,26
1657574289208,MATH 20B,A01,083756,Briones; Jor-el Thomas Caparas,4,0,36,32
1657574289208,MATH 20B,A02,083757,Briones; Jor-el Thomas Caparas,1,0,36,35
1657574289208,MATH 20B,A03,093475,Briones; Jor-el Thomas Caparas,2,0,36,34
1657574295236,MATH 20C,A01,083760,Briones; Jor-el Thomas Caparas,1,0,35,34
1657574295236,MATH 20C,A02,083761,Briones; Jor-el Thomas Caparas,8,0,35,27
1657574295236,MATH 20C,A03,093476,Briones; Jor-el Thomas Caparas,0,1,36,36
1657574295236,MATH 20C,B01,083762,Bach; Quang Tran,1,0,30,29
1657574301268,MATH 20D,A01,083765,Tran; Brian Kha,5,0,30,25
1657574301268,MATH 20D,A02,083766,Tran; Brian Kha,5,0,30,25
1657574301268,MATH 20D,A03,083767,Tran; Brian Kha,5,0,30,25
1657574307299,MATH 20E,A01,083771,Ganguly; Soumya,9,0,32,23
1657574307299,MATH 20E,A02,083772,Ganguly; Soumya,6,0,32,26
1657574307299,MATH 20E,B01,083773,Ciotti; Benjamin,20,0,35,15
1657574307299,MATH 20E,B02,083774,Ciotti; Benjamin,18,0,35,17
1657574313329,MATH 103A,A01,083777,Greenfeld; Be'Eri,3,0,36,33
1657574313329,MATH 103A,A02,083778,Greenfeld; Be'Eri,5,0,36,31
1657574313329,MATH 103A,A03,093561,Greenfeld; Be'Eri,5,0,36,31
1657574313329,MATH 103A,B01,083779,Greenfeld; Be'Eri,7,0,36,29
1657574313329,MATH 103A,B02,083780,Greenfeld; Be'Eri,4,0,36,32
1657574313329,MATH 103A,B03,093562,Greenfeld; Be'Eri,3,0,36,33
1657574319355,MATH 105,A01,085443,Carter; Anne Toulson,15,0,35,20
1657574319355,MATH 105,A02,093477,Carter; Anne Toulson,20,0,35,15
1657574325379,MATH 109,A01,083213,Ganzberger; Geoffrey Michael,2,0,34,32
1657574325379,MATH 109,A02,083214,Ganzberger; Geoffrey Michael,4,0,34,30
1657574325379,MATH 109,A03,093478,Ganzberger; Geoffrey Michael,2,0,34,32
1657574325379,MATH 109,B01,083215,Ganzberger; Geoffrey Michael,1,0,32,31
1657574325379,MATH 109,B02,083216,Ganzberger; Geoffrey Michael,2,0,32,30
1657574325379,MATH 109,B03,093479,Ganzberger; Geoffrey Michael,8,0,32,24
1657574331403,MATH 142A,A01,083219,Chow; Bennett,7,0,32,25
1657574331403,MATH 142A,A02,083220,Chow; Bennett,10,0,32,22
1657574331403,MATH 142A,A03,093480,Chow; Bennett,8,0,32,24
1657574331403,MATH 142A,B03,093481,Chow; Bennett,8,0,32,24
1657574331403,MATH 142A,B04,093558,Chow; Bennett,13,0,32,19
1657574331403,MATH 142A,B05,093559,Chow; Bennett,6,0,32,26
1657574337431,MATH 193A,A01,083224,Rotar; Vladimir,8,0,34,26
1657574337431,MATH 193A,A02,083225,Rotar; Vladimir,9,0,34,25
1657574337431,MATH 193A,A03,083781,Rotar; Vladimir,5,0,34,29
1657574337431,MATH 193A,A04,083782,Rotar; Vladimir,10,0,34,24
1657574337431,MATH 193A,A05,093482,Rotar; Vladimir,10,0,34,24
1657574343453,MATH 197,001,091859,McAuley; Julian John,9999,0,9999,0
1657574343453,MATH 197,002,095566,Kedlaya; Kiran S.,9997,0,9999,2
1657574343453,MATH 197,003,095567,Xiao; Ming,9999,0,9999,0
1657574343453,MATH 197,004,095571,Perols; Johan Lars,9998,0,9999,1
1657574350531,COGS 9,A01,083615,Shannon; Kyle Michael,9,0,75,66
1657574356617,COGS 11,A01,083617,Boyle; Mary E. T.,23,0,48,25
1657574362658,COGS 13,A01,083071,Bastos; Amalia Pinkusfeld,11,0,71,60
1657574368683,COGS 14A,A01,092681,Semenuks; Arturs,5,1,100,95
1657574374711,COGS 14B,A01,083073,Cheng; Tzu-Han,6,0,63,57
1657574380736,COGS 17,A01,092677,Semenuks; Arturs,6,0,81,75
1657574386759,COGS 100,A01,083619,Allen; Michael Gordon,17,0,70,53
1657574392794,COGS 101A,A01,083621,Davis; Joshua Daniel,9,0,68,59
1657574398833,COGS 101B,A01,091572,Allen; Michael Gordon,12,0,65,53
1657574404867,COGS 101C,A01,083625,Delgado; Tania,17,0,35,18
1657574410889,COGS 107A,A01,083627,Boyle; Mary E. T.,13,0,60,47
1657574416923,COGS 118A,A01,083075,Gupta; Anjum,21,0,76,55
1657574422951,CSE 3,A50,083646,Miranda; Gregory Joseph,24,0,50,26
1657574428972,CSE 8A,A50,083650,Miranda; Gregory Joseph,17,1,56,39
1657574435000,CSE 11,A01,083080,Cao; Yingjun,6,15,40,34
1657574441023,CSE 12,A01,083652,Krause-Levy; Sophia Louisa,28,1,120,92
1657574447053,CSE 15L,A01,083654,Morris; Justin Loren,9,0,50,41
1657574447053,CSE 15L,A02,083655,Morris; Justin Loren,9,0,50,41
1657574453075,CSE 20,A01,083657,Tran; Khoa Dang,39,0,80,41
1657574459104,CSE 21,A01,095574,Bach; Quang Tran,22,0,48,26
1657574465128,CSE 30,A01,083084,Eldon; John,5,0,80,75
1657574465128,CSE 30,B01,095061,Bhaskar; Nishant,9,0,50,41
1657574471152,CSE 100,A01,083659,Cao; Yingjun,5,4,70,65
1657574477176,CSE 134B,A01,083661,Powell; Thomas Allan,22,0,100,78
1657574483204,CSE 140,A01,083663,Gungor; Onat,15,0,85,70
1657574489228,CSE 140L,A01,083088,Eldon; John,21,0,100,79
1657574495252,CSE 175,A01,083665,Kumar; Rakesh,3,0,25,22
1657574501276,CSE 190,A00,092507,Dubnov; Shlomo,8,0,20,12
1657574507298,ECE 45,A01,083139,Congero; Spencer William,6,0,75,69
1657574513322,ECE 65,A50,083695,Saad; Andrew S,12,0,30,18
1657574513322,ECE 65,A51,095125,Saad; Andrew S,24,0,26,2
1657574519345,ECE 109,A01,091882,Touri; Behrouz,19,0,70,51
1657574525373,ECE 180,A00,083140,Abi Samra; Nicholas Camill,1,0,30,29
1657574525373,ECE 180,B00,083141,Abi Samra; Nicholas Camill,0,0,30,30
1657574531411,MATH 10A,A01,083735,Patchell; Gregory David,2,0,30,28
1657574531411,MATH 10A,A02,083736,Patchell; Gregory David,20,0,30,10
1657574531411,MATH 10A,A03,083737,Patchell; Gregory David,16,0,30,14
1657574537457,MATH 10B,A01,083207,Lim; Seonhee,8,0,34,26
1657574537457,MATH 10B,A02,083208,Lim; Seonhee,9,0,35,26
1657574537457,MATH 10B,A03,093472,Lim; Seonhee,7,0,34,27
1657574537457,MATH 10B,B01,083739,Sinha; Shubham,12,0,30,18
1657574543481,MATH 18,A01,083743,Cinel; Cameron Alexander,7,0,30,23
1657574543481,MATH 18,A02,083744,Cinel; Cameron Alexander,17,0,30,13
1657574543481,MATH 18,A03,083745,Cinel; Cameron Alexander,9,0,30,21
1657574543481,MATH 18,B01,083748,Rideout; David Porter,5,0,37,32
1657574543481,MATH 18,B02,083749,Rideout; David Porter,5,0,36,31
1657574543481,MATH 18,B03,083750,Rideout; David Porter,3,0,37,34
1657574543481,MATH 18,B04,083751,Rideout; David Porter,6,0,36,30
1657574543481,MATH 18,B05,093473,Rideout; David Porter,6,0,36,30
1657574543481,MATH 18,B06,093474,Rideout; David Porter,6,0,36,30
1657574549514,MATH 20A,A01,083754,Zheng; Zequn,14,0,40,26
1657574555537,MATH 20B,A01,083756,Briones; Jor-el Thomas Caparas,4,0,36,32
1657574555537,MATH 20B,A02,083757,Briones; Jor-el Thomas Caparas,1,0,36,35
1657574555537,MATH 20B,A03,093475,Briones; Jor-el Thomas Caparas,2,0,36,34
1657574561565,MATH 20C,A01,083760,Briones; Jor-el Thomas Caparas,1,0,35,34
1657574561565,MATH 20C,A02,083761,Briones; Jor-el Thomas Caparas,8,0,35,27
1657574561565,MATH 20C,A03,093476,Briones; Jor-el Thomas Caparas,0,1,36,36
1657574561565,MATH 20C,B01,083762,Bach; Quang Tran,1,0,30,29
1657574567603,MATH 20D,A01,083765,Tran; Brian Kha,5,0,30,25
1657574567603,MATH 20D,A02,083766,Tran; Brian Kha,5,0,30,25
1657574567603,MATH 20D,A03,083767,Tran; Brian Kha,5,0,30,25
1657574573626,MATH 20E,A01,083771,Ganguly; Soumya,9,0,32,23
1657574573626,MATH 20E,A02,083772,Ganguly; Soumya,6,0,32,26
1657574573626,MATH 20E,B01,083773,Ciotti; Benjamin,20,0,35,15
1657574573626,MATH 20E,B02,083774,Ciotti; Benjamin,18,0,35,17
1657574579653,MATH 103A,A01,083777,Greenfeld; Be'Eri,3,0,36,33
1657574579653,MATH 103A,A02,083778,Greenfeld; Be'Eri,5,0,36,31
1657574579653,MATH 103A,A03,093561,Greenfeld; Be'Eri,5,0,36,31
1657574579653,MATH 103A,B01,083779,Greenfeld; Be'Eri,7,0,36,29
1657574579653,MATH 103A,B02,083780,Greenfeld; Be'Eri,4,0,36,32
1657574579653,MATH 103A,B03,093562,Greenfeld; Be'Eri,3,0,36,33
1657574585676,MATH 105,A01,085443,Carter; Anne Toulson,15,0,35,20
1657574585676,MATH 105,A02,093477,Carter; Anne Toulson,20,0,35,15
1657574591707,MATH 109,A01,083213,Ganzberger; Geoffrey Michael,2,0,34,32
1657574591707,MATH 109,A02,083214,Ganzberger; Geoffrey Michael,4,0,34,30
1657574591707,MATH 109,A03,093478,Ganzberger; Geoffrey Michael,2,0,34,32
1657574591707,MATH 109,B01,083215,Ganzberger; Geoffrey Michael,1,0,32,31
1657574591707,MATH 109,B02,083216,Ganzberger; Geoffrey Michael,2,0,32,30
1657574591707,MATH 109,B03,093479,Ganzberger; Geoffrey Michael,8,0,32,24
1657574597731,MATH 142A,A01,083219,Chow; Bennett,7,0,32,25
1657574597731,MATH 142A,A02,083220,Chow; Bennett,10,0,32,22
1657574597731,MATH 142A,A03,093480,Chow; Bennett,8,0,32,24
1657574597731,MATH 142A,B03,093481,Chow; Bennett,8,0,32,24
1657574597731,MATH 142A,B04,093558,Chow; Bennett,13,0,32,19
1657574597731,MATH 142A,B05,093559,Chow; Bennett,6,0,32,26
1657574603759,MATH 193A,A01,083224,Rotar; Vladimir,8,0,34,26
1657574603759,MATH 193A,A02,083225,Rotar; Vladimir,9,0,34,25
1657574603759,MATH 193A,A03,083781,Rotar; Vladimir,5,0,34,29
1657574603759,MATH 193A,A04,083782,Rotar; Vladimir,10,0,34,24
1657574603759,MATH 193A,A05,093482,Rotar; Vladimir,10,0,34,24
1657574609786,MATH 197,001,091859,McAuley; Julian John,9999,0,9999,0
1657574609786,MATH 197,002,095566,Kedlaya; Kiran S.,9997,0,9999,2
1657574609786,MATH 197,003,095567,Xiao; Ming,9999,0,9999,0
1657574609786,MATH 197,004,095571,Perols; Johan Lars,9998,0,9999,1
1657574616847,COGS 9,A01,083615,Shannon; Kyle Michael,9,0,75,66
1657574622870,COGS 11,A01,083617,Boyle; Mary E. T.,23,0,48,25
1657574628893,COGS 13,A01,083071,Bastos; Amalia Pinkusfeld,11,0,71,60
1657574634918,COGS 14A,A01,092681,Semenuks; Arturs,5,1,100,95
1657574640949,COGS 14B,A01,083073,Cheng; Tzu-Han,6,0,63,57
1657574646973,COGS 17,A01,092677,Semenuks; Arturs,6,0,81,75
1657574652996,COGS 100,A01,083619,Allen; Michael Gordon,17,0,70,53
1657574659023,COGS 101A,A01,083621,Davis; Joshua Daniel,9,0,68,59
1657574665046,COGS 101B,A01,091572,Allen; Michael Gordon,12,0,65,53
1657574671069,COGS 101C,A01,083625,Delgado; Tania,17,0,35,18
1657574677093,COGS 107A,A01,083627,Boyle; Mary E. T.,13,0,60,47
1657574683119,COGS 118A,A01,083075,Gupta; Anjum,21,0,76,55
1657574689154,CSE 3,A50,083646,Miranda; Gregory Joseph,24,0,50,26
1657574695190,CSE 8A,A50,083650,Miranda; Gregory Joseph,17,1,56,39
1657574701212,CSE 11,A01,083080,Cao; Yingjun,6,15,40,34
1657574707242,CSE 12,A01,083652,Krause-Levy; Sophia Louisa,28,1,120,92
1657574713266,CSE 15L,A01,083654,Morris; Justin Loren,9,0,50,41
1657574713266,CSE 15L,A02,083655,Morris; Justin Loren,9,0,50,41
1657574719308,CSE 20,A01,083657,Tran; Khoa Dang,39,0,80,41
1657574725331,CSE 21,A01,095574,Bach; Quang Tran,22,0,48,26
1657574731353,CSE 30,A01,083084,Eldon; John,5,0,80,75
1657574731353,CSE 30,B01,095061,Bhaskar; Nishant,9,0,50,41
1657574737377,CSE 100,A01,083659,Cao; Yingjun,5,4,70,65
1657574743398,CSE 134B,A01,083661,Powell; Thomas Allan,22,0,100,78
1657574749433,CSE 140,A01,083663,Gungor; Onat,15,0,85,70
1657574755471,CSE 140L,A01,083088,Eldon; John,21,0,100,79
1657574761493,CSE 175,A01,083665,Kumar; Rakesh,3,0,25,22
1657574767519,CSE 190,A00,092507,Dubnov; Shlomo,8,0,20,12
1657574773623,ECE 45,A01,083139,Congero; Spencer William,6,0,75,69
1657574779650,ECE 65,A50,083695,Saad; Andrew S,12,0,30,18
1657574779650,ECE 65,A51,095125,Saad; Andrew S,24,0,26,2
1657574785676,ECE 109,A01,091882,Touri; Behrouz,19,0,70,51
1657574791706,ECE 180,A00,083140,Abi Samra; Nicholas Camill,1,0,30,29
1657574791706,ECE 180,B00,083141,Abi Samra; Nicholas Camill,0,0,30,30
1657574797731,MATH 10A,A01,083735,Patchell; Gregory David,2,0,30,28
1657574797731,MATH 10A,A02,083736,Patchell; Gregory David,20,0,30,10
1657574797731,MATH 10A,A03,083737,Patchell; Gregory David,16,0,30,14
1657574803773,MATH 10B,A01,083207,Lim; Seonhee,8,0,34,26
1657574803773,MATH 10B,A02,083208,Lim; Seonhee,9,0,35,26
1657574803773,MATH 10B,A03,093472,Lim; Seonhee,7,0,34,27
1657574803773,MATH 10B,B01,083739,Sinha; Shubham,12,0,30,18
1657574809796,MATH 18,A01,083743,Cinel; Cameron Alexander,7,0,30,23
1657574809796,MATH 18,A02,083744,Cinel; Cameron Alexander,17,0,30,13
1657574809796,MATH 18,A03,083745,Cinel; Cameron Alexander,9,0,30,21
1657574809796,MATH 18,B01,083748,Rideout; David Porter,5,0,37,32
1657574809796,MATH 18,B02,083749,Rideout; David Porter,5,0,36,31
1657574809796,MATH 18,B03,083750,Rideout; David Porter,3,0,37,34
1657574809796,MATH 18,B04,083751,Rideout; David Porter,6,0,36,30
1657574809796,MATH 18,B05,093473,Rideout; David Porter,6,0,36,30
1657574809796,MATH 18,B06,093474,Rideout; David Porter,6,0,36,30
1657574815823,MATH 20A,A01,083754,Zheng; Zequn,14,0,40,26
1657574821845,MATH 20B,A01,083756,Briones; Jor-el Thomas Caparas,4,0,36,32
1657574821845,MATH 20B,A02,083757,Briones; Jor-el Thomas Caparas,1,0,36,35
1657574821845,MATH 20B,A03,093475,Briones; Jor-el Thomas Caparas,2,0,36,34
1657574827874,MATH 20C,A01,083760,Briones; Jor-el Thomas Caparas,1,0,35,34
1657574827874,MATH 20C,A02,083761,Briones; Jor-el Thomas Caparas,8,0,35,27
1657574827874,MATH 20C,A03,093476,Briones; Jor-el Thomas Caparas,0,1,36,36
1657574827874,MATH 20C,B01,083762,Bach; Quang Tran,1,0,30,29
1657574833913,MATH 20D,A01,083765,Tran; Brian Kha,5,0,30,25
1657574833913,MATH 20D,A02,083766,Tran; Brian Kha,5,0,30,25
1657574833913,MATH 20D,A03,083767,Tran; Brian Kha,5,0,30,25
1657574839942,MATH 20E,A01,083771,Ganguly; Soumya,9,0,32,23
1657574839942,MATH 20E,A02,083772,Ganguly; Soumya,6,0,32,26
1657574839942,MATH 20E,B01,083773,Ciotti; Benjamin,20,0,35,15
1657574839942,MATH 20E,B02,083774,Ciotti; Benjamin,18,0,35,17
1657574845976,MATH 103A,A01,083777,Greenfeld; Be'Eri,3,0,36,33
1657574845976,MATH 103A,A02,083778,Greenfeld; Be'Eri,5,0,36,31
1657574845976,MATH 103A,A03,093561,Greenfeld; Be'Eri,5,0,36,31
1657574845976,MATH 103A,B01,083779,Greenfeld; Be'Eri,7,0,36,29
1657574845976,MATH 103A,B02,083780,Greenfeld; Be'Eri,4,0,36,32
1657574845976,MATH 103A,B03,093562,Greenfeld; Be'Eri,3,0,36,33
1657574852006,MATH 105,A01,085443,Carter; Anne Toulson,15,0,35,20
1657574852006,MATH 105,A02,093477,Carter; Anne Toulson,20,0,35,15
1657574858029,MATH 109,A01,083213,Ganzberger; Geoffrey Michael,2,0,34,32
1657574858029,MATH 109,A02,083214,Ganzberger; Geoffrey Michael,4,0,34,30
1657574858029,MATH 109,A03,093478,Ganzberger; Geoffrey Michael,2,0,34,32
1657574858029,MATH 109,B01,083215,Ganzberger; Geoffrey Michael,1,0,32,31
1657574858029,MATH 109,B02,083216,Ganzberger; Geoffrey Michael,2,0,32,30
1657574858029,MATH 109,B03,093479,Ganzberger; Geoffrey Michael,8,0,32,24
1657574864056,MATH 142A,A01,083219,Chow; Bennett,7,0,32,25
1657574864056,MATH 142A,A02,083220,Chow; Bennett,10,0,32,22
1657574864056,MATH 142A,A03,093480,Chow; Bennett,8,0,32,24
1657574864056,MATH 142A,B03,093481,Chow; Bennett,8,0,32,24
1657574864056,MATH 142A,B04,093558,Chow; Bennett,13,0,32,19
1657574864056,MATH 142A,B05,093559,Chow; Bennett,6,0,32,26
1657574870085,MATH 193A,A01,083224,Rotar; Vladimir,8,0,34,26
1657574870085,MATH 193A,A02,083225,Rotar; Vladimir,9,0,34,25
1657574870085,MATH 193A,A03,083781,Rotar; Vladimir,5,0,34,29
1657574870085,MATH 193A,A04,083782,Rotar; Vladimir,10,0,34,24
1657574870085,MATH 193A,A05,093482,Rotar; Vladimir,10,0,34,24
1657574876107,MATH 197,001,091859,McAuley; Julian John,9999,0,9999,0
1657574876107,MATH 197,002,095566,Kedlaya; Kiran S.,9997,0,9999,2
1657574876107,MATH 197,003,095567,Xiao; Ming,9999,0,9999,0
1657574876107,MATH 197,004,095571,Perols; Johan Lars,9998,0,9999,1
1657574883162,COGS 9,A01,083615,Shannon; Kyle Michael,9,0,75,66
1657574889186,COGS 11,A01,083617,Boyle; Mary E. T.,23,0,48,25
1657574895213,COGS 13,A01,083071,Bastos; Amalia Pinkusfeld,11,0,71,60
1657574901242,COGS 14A,A01,092681,Semenuks; Arturs,5,1,100,95
1657574907265,COGS 14B,A01,083073,Cheng; Tzu-Han,6,0,63,57
1657574913287,COGS 17,A01,092677,Semenuks; Arturs,6,0,81,75
1657574919317,COGS 100,A01,083619,Allen; Michael Gordon,17,0,70,53
1657574925339,COGS 101A,A01,083621,Davis; Joshua Daniel,9,0,68,59
1657574931366,COGS 101B,A01,091572,Allen; Michael Gordon,12,0,65,53
1657574937391,COGS 101C,A01,083625,Delgado; Tania,17,0,35,18
1657574943414,COGS 107A,A01,083627,Boyle; Mary E. T.,13,0,60,47
1657574949447,COGS 118A,A01,083075,Gupta; Anjum,21,0,76,55
1657574955487,CSE 3,A50,083646,Miranda; Gregory Joseph,24,0,50,26
1657574961516,CSE 8A,A50,083650,Miranda; Gregory Joseph,17,1,56,39
1657574967542,CSE 11,A01,083080,Cao; Yingjun,6,15,40,34
1657574973568,CSE 12,A01,083652,Krause-Levy; Sophia Louisa,28,1,120,92
1657574979591,CSE 15L,A01,083654,Morris; Justin Loren,9,0,50,41
1657574979591,CSE 15L,A02,083655,Morris; Justin Loren,9,0,50,41
1657574985612,CSE 20,A01,083657,Tran; Khoa Dang,39,0,80,41
1657574991634,CSE 21,A01,095574,Bach; Quang Tran,22,0,48,26
1657574997664,CSE 30,A01,083084,Eldon; John,5,0,80,75
1657574997664,CSE 30,B01,095061,Bhaskar; Nishant,9,0,50,41
1657575003700,CSE 100,A01,083659,Cao; Yingjun,5,4,70,65
1657575009723,CSE 134B,A01,083661,Powell; Thomas Allan,22,0,100,78
1657575015749,CSE 140,A01,083663,Gungor; Onat,15,0,85,70
1657575021775,CSE 140L,A01,083088,Eldon; John,21,0,100,79
1657575027797,CSE 175,A01,083665,Kumar; Rakesh,3,0,25,22
1657575033829,CSE 190,A00,092507,Dubnov; Shlomo,8,0,20,12
1657575039858,ECE 45,A01,083139,Congero; Spencer William,6,0,75,69
1657575045882,ECE 65,A50,083695,Saad; Andrew S,12,0,30,18
1657575045882,ECE 65,A51,095125,Saad; Andrew S,24,0,26,2
1657575051905,ECE 109,A01,091882,Touri; Behrouz,19,0,70,51
1657575057928,ECE 180,A00,083140,Abi Samra; Nicholas Camill,1,0,30,29
1657575057928,ECE 180,B00,083141,Abi Samra; Nicholas Camill,0,0,30,30
1657575063958,MATH 10A,A01,083735,Patchell; Gregory David,2,0,30,28
1657575063958,MATH 10A,A02,083736,Patchell; Gregory David,20,0,30,10
1657575063958,MATH 10A,A03,083737,Patchell; Gregory David,16,0,30,14
1657575069981,MATH 10B,A01,083207,Lim; Seonhee,8,0,34,26
1657575069981,MATH 10B,A02,083208,Lim; Seonhee,9,0,35,26
1657575069981,MATH 10B,A03,093472,Lim; Seonhee,7,0,34,27
1657575069981,MATH 10B,B01,083739,Sinha; Shubham,12,0,30,18
1657575076011,MATH 18,A01,083743,Cinel; Cameron Alexander,7,0,30,23
1657575076011,MATH 18,A02,083744,Cinel; Cameron Alexander,17,0,30,13
1657575076011,MATH 18,A03,083745,Cinel; Cameron Alexander,9,0,30,21
1657575076011,MATH 18,B01,083748,Rideout; David Porter,5,0,37,32
1657575076011,MATH 18,B02,083749,Rideout; David Porter,5,0,36,31
1657575076011,MATH 18,B03,083750,Rideout; David Porter,3,0,37,34
1657575076011,MATH 18,B04,083751,Rideout; David Porter,6,0,36,30
1657575076011,MATH 18,B05,093473,Rideout; David Porter,6,0,36,30
1657575076011,MATH 18,B06,093474,Rideout; David Porter,6,0,36,30
1657575082035,MATH 20A,A01,083754,Zheng; Zequn,14,0,40,26
1657575088062,MATH 20B,A01,083756,Briones; Jor-el Thomas Caparas,4,0,36,32
1657575088062,MATH 20B,A02,083757,Briones; Jor-el Thomas Caparas,1,0,36,35
1657575088062,MATH 20B,A03,093475,Briones; Jor-el Thomas Caparas,2,0,36,34
1657575094088,MATH 20C,A01,083760,Briones; Jor-el Thomas Caparas,1,0,35,34
1657575094088,MATH 20C,A02,083761,Briones; Jor-el Thomas Caparas,8,0,35,27
1657575094088,MATH 20C,A03,093476,Briones; Jor-el Thomas Caparas,0,1,36,36
1657575094088,MATH 20C,B01,083762,Bach; Quang Tran,1,0,30,29
1657575100117,MATH 20D,A01,083765,Tran; Brian Kha,5,0,30,25
1657575100117,MATH 20D,A02,083766,Tran; Brian Kha,5,0,30,25
1657575100117,MATH 20D,A03,083767,Tran; Brian Kha,5,0,30,25
1657575106144,MATH 20E,A01,083771,Ganguly; Soumya,9,0,32,23
1657575106144,MATH 20E,A02,083772,Ganguly; Soumya,6,0,32,26
1657575106144,MATH 20E,B01,083773,Ciotti; Benjamin,20,0,35,15
1657575106144,MATH 20E,B02,083774,Ciotti; Benjamin,18,0,35,17
1657575112168,MATH 103A,A01,083777,Greenfeld; Be'Eri,3,0,36,33
1657575112168,MATH 103A,A02,083778,Greenfeld; Be'Eri,5,0,36,31
1657575112168,MATH 103A,A03,093561,Greenfeld; Be'Eri,5,0,36,31
1657575112168,MATH 103A,B01,083779,Greenfeld; Be'Eri,7,0,36,29
1657575112168,MATH 103A,B02,083780,Greenfeld; Be'Eri,4,0,36,32
1657575112168,MATH 103A,B03,093562,Greenfeld; Be'Eri,3,0,36,33
1657575118190,MATH 105,A01,085443,Carter; Anne Toulson,15,0,35,20
1657575118190,MATH 105,A02,093477,Carter; Anne Toulson,20,0,35,15
1657575124223,MATH 109,A01,083213,Ganzberger; Geoffrey Michael,2,0,34,32
1657575124223,MATH 109,A02,083214,Ganzberger; Geoffrey Michael,4,0,34,30
1657575124223,MATH 109,A03,093478,Ganzberger; Geoffrey Michael,2,0,34,32
1657575124223,MATH 109,B01,083215,Ganzberger; Geoffrey Michael,1,0,32,31
1657575124223,MATH 109,B02,083216,Ganzberger; Geoffrey Michael,2,0,32,30
1657575124223,MATH 109,B03,093479,Ganzberger; Geoffrey Michael,8,0,32,24
1657575130246,MATH 142A,A01,083219,Chow; Bennett,7,0,32,25
1657575130246,MATH 142A,A02,083220,Chow; Bennett,10,0,32,22
1657575130246,MATH 142A,A03,093480,Chow; Bennett,8,0,32,24
1657575130246,MATH 142A,B03,093481,Chow; Bennett,8,0,32,24
1657575130246,MATH 142A,B04,093558,Chow; Bennett,13,0,32,19
1657575130246,MATH 142A,B05,093559,Chow; Bennett,6,0,32,26
1657575136275,MATH 193A,A01,083224,Rotar; Vladimir,8,0,34,26
1657575136275,MATH 193A,A02,083225,Rotar; Vladimir,9,0,34,25
1657575136275,MATH 193A,A03,083781,Rotar; Vladimir,5,0,34,29
1657575136275,MATH 193A,A04,083782,Rotar; Vladimir,10,0,34,24
1657575136275,MATH 193A,A05,093482,Rotar; Vladimir,10,0,34,24
1657575142304,MATH 197,001,091859,McAuley; Julian John,9999,0,9999,0
1657575142304,MATH 197,002,095566,Kedlaya; Kiran S.,9997,0,9999,2
1657575142304,MATH 197,003,095567,Xiao; Ming,9999,0,9999,0
1657575142304,MATH 197,004,095571,Perols; Johan Lars,9998,0,9999,1
1657575149361,COGS 9,A01,083615,Shannon; Kyle Michael,9,0,75,66
1657575155382,COGS 11,A01,083617,Boyle; Mary E. T.,23,0,48,25
1657575161404,COGS 13,A01,083071,Bastos; Amalia Pinkusfeld,11,0,71,60
1657575167435,COGS 14A,A01,092681,Semenuks; Arturs,5,1,100,95
1657575173456,COGS 14B,A01,083073,Cheng; Tzu-Han,6,0,63,57
1657575179493,COGS 17,A01,092677,Semenuks; Arturs,6,0,81,75
1657575185515,COGS 100,A01,083619,Allen; Michael Gordon,17,0,70,53
1657575191537,COGS 101A,A01,083621,Davis; Joshua Daniel,9,0,68,59
1657575197564,COGS 101B,A01,091572,Allen; Michael Gordon,12,0,65,53
1657575203586,COGS 101C,A01,083625,Delgado; Tania,17,0,35,18
1657575209618,COGS 107A,A01,083627,Boyle; Mary E. T.,13,0,60,47
1657575215640,COGS 118A,A01,083075,Gupta; Anjum,21,0,76,55
1657575221668,CSE 3,A50,083646,Miranda; Gregory Joseph,24,0,50,26
1657575227697,CSE 8A,A50,083650,Miranda; Gregory Joseph,17,1,56,39
1657575233724,CSE 11,A01,083080,Cao; Yingjun,6,15,40,34
1657575239749,CSE 12,A01,083652,Krause-Levy; Sophia Louisa,28,1,120,92
1657575245776,CSE 15L,A01,083654,Morris; Justin Loren,9,0,50,41
1657575245776,CSE 15L,A02,083655,Morris; Justin Loren,9,0,50,41
1657575251800,CSE 20,A01,083657,Tran; Khoa Dang,39,0,80,41
1657575257828,CSE 21,A01,095574,Bach; Quang Tran,22,0,48,26
1657575263854,CSE 30,A01,083084,Eldon; John,5,0,80,75
1657575263854,CSE 30,B01,095061,Bhaskar; Nishant,9,0,50,41
1657575269890,CSE 100,A01,083659,Cao; Yingjun,5,4,70,65
1657575275913,CSE 134B,A01,083661,Powell; Thomas Allan,22,0,100,78
1657575281939,CSE 140,A01,083663,Gungor; Onat,15,0,85,70
1657575287983,CSE 140L,A01,083088,Eldon; John,21,0,100,79
1657575294003,CSE 175,A01,083665,Kumar; Rakesh,3,0,25,22
1657575300028,CSE 190,A00,092507,Dubnov; Shlomo,8,0,20,12
1657575306055,ECE 45,A01,083139,Congero; Spencer William,6,0,75,69
1657575312080,ECE 65,A50,083695,Saad; Andrew S,12,0,30,18
1657575312080,ECE 65,A51,095125,Saad; Andrew S,24,0,26,2
1657575318106,ECE 109,A01,091882,Touri; Behrouz,19,0,70,51
1657575324132,ECE 180,A00,083140,Abi Samra; Nicholas Camill,1,0,30,29
1657575324132,ECE 180,B00,083141,Abi Samra; Nicholas Camill,0,0,30,30
1657575330159,MATH 10A,A01,083735,Patchell; Gregory David,2,0,30,28
1657575330159,MATH 10A,A02,083736,Patchell; Gregory David,20,0,30,10
1657575330159,MATH 10A,A03,083737,Patchell; Gregory David,16,0,30,14
1657575336187,MATH 10B,A01,083207,Lim; Seonhee,8,0,34,26
1657575336187,MATH 10B,A02,083208,Lim; Seonhee,9,0,35,26
1657575336187,MATH 10B,A03,093472,Lim; Seonhee,7,0,34,27
1657575336187,MATH 10B,B01,083739,Sinha; Shubham,12,0,30,18
1657575342210,MATH 18,A01,083743,Cinel; Cameron Alexander,7,0,30,23
1657575342210,MATH 18,A02,083744,Cinel; Cameron Alexander,17,0,30,13
1657575342210,MATH 18,A03,083745,Cinel; Cameron Alexander,9,0,30,21
1657575342210,MATH 18,B01,083748,Rideout; David Porter,5,0,37,32
1657575342210,MATH 18,B02,083749,Rideout; David Porter,5,0,36,31
1657575342210,MATH 18,B03,083750,Rideout; David Porter,3,0,37,34
1657575342210,MATH 18,B04,083751,Rideout; David Porter,6,0,36,30
1657575342210,MATH 18,B05,093473,Rideout; David Porter,6,0,36,30
1657575342210,MATH 18,B06,093474,Rideout; David Porter,6,0,36,30
1657575348232,MATH 20A,A01,083754,Zheng; Zequn,14,0,40,26
1657575354254,MATH 20B,A01,083756,Briones; Jor-el Thomas Caparas,4,0,36,32
1657575354254,MATH 20B,A02,083757,Briones; Jor-el Thomas Caparas,1,0,36,35
1657575354254,MATH 20B,A03,093475,Briones; Jor-el Thomas Caparas,2,0,36,34
1657575360281,MATH 20C,A01,083760,Briones; Jor-el Thomas Caparas,1,0,35,34
1657575360281,MATH 20C,A02,083761,Briones; Jor-el Thomas Caparas,8,0,35,27
1657575360281,MATH 20C,A03,093476,Briones; Jor-el Thomas Caparas,0,1,36,36
1657575360281,MATH 20C,B01,083762,Bach; Quang Tran,1,0,30,29
1657575366318,MATH 20D,A01,083765,Tran; Brian Kha,5,0,30,25
1657575366318,MATH 20D,A02,083766,Tran; Brian Kha,5,0,30,25
1657575366318,MATH 20D,A03,083767,Tran; Brian Kha,5,0,30,25
1657575372419,MATH 20E,A01,083771,Ganguly; Soumya,9,0,32,23
1657575372419,MATH 20E,A02,083772,Ganguly; Soumya,6,0,32,26
1657575372419,MATH 20E,B01,083773,Ciotti; Benjamin,20,0,35,15
1657575372419,MATH 20E,B02,083774,Ciotti; Benjamin,18,0,35,17
1657575378445,MATH 103A,A01,083777,Greenfeld; Be'Eri,3,0,36,33
1657575378445,MATH 103A,A02,083778,Greenfeld; Be'Eri,5,0,36,31
1657575378445,MATH 103A,A03,093561,Greenfeld; Be'Eri,5,0,36,31
1657575378445,MATH 103A,B01,083779,Greenfeld; Be'Eri,7,0,36,29
1657575378445,MATH 103A,B02,083780,Greenfeld; Be'Eri,4,0,36,32
1657575378445,MATH 103A,B03,093562,Greenfeld; Be'Eri,3,0,36,33
1657575384467,MATH 105,A01,085443,Carter; Anne Toulson,15,0,35,20
1657575384467,MATH 105,A02,093477,Carter; Anne Toulson,20,0,35,15
1657575390489,MATH 109,A01,083213,Ganzberger; Geoffrey Michael,2,0,34,32
1657575390489,MATH 109,A02,083214,Ganzberger; Geoffrey Michael,4,0,34,30
1657575390489,MATH 109,A03,093478,Ganzberger; Geoffrey Michael,2,0,34,32
1657575390489,MATH 109,B01,083215,Ganzberger; Geoffrey Michael,1,0,32,31
1657575390489,MATH 109,B02,083216,Ganzberger; Geoffrey Michael,2,0,32,30
1657575390489,MATH 109,B03,093479,Ganzberger; Geoffrey Michael,8,0,32,24
1657575396528,MATH 142A,A01,083219,Chow; Bennett,7,0,32,25
1657575396528,MATH 142A,A02,083220,Chow; Bennett,10,0,32,22
1657575396528,MATH 142A,A03,093480,Chow; Bennett,8,0,32,24
1657575396528,MATH 142A,B03,093481,Chow; Bennett,8,0,32,24
1657575396528,MATH 142A,B04,093558,Chow; Bennett,13,0,32,19
1657575396528,MATH 142A,B05,093559,Chow; Bennett,6,0,32,26
1657575402551,MATH 193A,A01,083224,Rotar; Vladimir,8,0,34,26
1657575402551,MATH 193A,A02,083225,Rotar; Vladimir,9,0,34,25
1657575402551,MATH 193A,A03,083781,Rotar; Vladimir,5,0,34,29
1657575402551,MATH 193A,A04,083782,Rotar; Vladimir,10,0,34,24
1657575402551,MATH 193A,A05,093482,Rotar; Vladimir,10,0,34,24
1657575408586,MATH 197,001,091859,McAuley; Julian John,9999,0,9999,0
1657575408586,MATH 197,002,095566,Kedlaya; Kiran S.,9997,0,9999,2
1657575408586,MATH 197,003,095567,Xiao; Ming,9999,0,9999,0
1657575408586,MATH 197,004,095571,Perols; Johan Lars,9998,0,9999,1
1657575415650,COGS 9,A01,083615,Shannon; Kyle Michael,9,0,75,66
1657575421676,COGS 11,A01,083617,Boyle; Mary E. T.,23,0,48,25
1657575427702,COGS 13,A01,083071,Bastos; Amalia Pinkusfeld,11,0,71,60
1657575433727,COGS 14A,A01,092681,Semenuks; Arturs,5,1,100,95
1657575439751,COGS 14B,A01,083073,Cheng; Tzu-Han,6,0,63,57
1657575445777,COGS 17,A01,092677,Semenuks; Arturs,6,0,81,75
1657575451801,COGS 100,A01,083619,Allen; Michael Gordon,17,0,70,53
1657575457832,COGS 101A,A01,083621,Davis; Joshua Daniel,9,0,68,59
1657575463857,COGS 101B,A01,091572,Allen; Michael Gordon,12,0,65,53
1657575469887,COGS 101C,A01,083625,Delgado; Tania,17,0,35,18
1657575475912,COGS 107A,A01,083627,Boyle; Mary E. T.,13,0,60,47
1657575481959,COGS 118A,A01,083075,Gupta; Anjum,21,0,76,55
1657575487985,CSE 3,A50,083646,Miranda; Gregory Joseph,24,0,50,26
1657575494013,CSE 8A,A50,083650,Miranda; Gregory Joseph,17,1,56,39
1657575500042,CSE 11,A01,083080,Cao; Yingjun,6,15,40,34
1657575506074,CSE 12,A01,083652,Krause-Levy; Sophia Louisa,28,1,120,92
1657575512098,CSE 15L,A01,083654,Morris; Justin Loren,9,0,50,41
1657575512098,CSE 15L,A02,083655,Morris; Justin Loren,9,0,50,41
1657575518120,CSE 20,A01,083657,Tran; Khoa Dang,39,0,80,41
1657575524142,CSE 21,A01,095574,Bach; Quang Tran,22,0,48,26
1657575530163,CSE 30,A01,083084,Eldon; John,5,0,80,75
1657575530163,CSE 30,B01,095061,Bhaskar; Nishant,9,0,50,41
1657575536196,CSE 100,A01,083659,Cao; Yingjun,5,4,70,65
1657575542232,CSE 134B,A01,083661,Powell; Thomas Allan,22,0,100,78
1657575548253,CSE 140,A01,083663,Gungor; Onat,15,0,85,70
1657575554282,CSE 140L,A01,083088,Eldon; John,21,0,100,79
1657575560304,CSE 175,A01,083665,Kumar; Rakesh,3,0,25,22
1657575566328,CSE 190,A00,092507,Dubnov; Shlomo,8,0,20,12
1657575572352,ECE 45,A01,083139,Congero; Spencer William,6,0,75,69
1657575578376,ECE 65,A50,083695,Saad; Andrew S,12,0,30,18
1657575578376,ECE 65,A51,095125,Saad; Andrew S,24,0,26,2
1657575584399,ECE 109,A01,091882,Touri; Behrouz,19,0,70,51
1657575590425,ECE 180,A00,083140,Abi Samra; Nicholas Camill,1,0,30,29
1657575590425,ECE 180,B00,083141,Abi Samra; Nicholas Camill,0,0,30,30
1657575596450,MATH 10A,A01,083735,Patchell; Gregory David,2,0,30,28
1657575596450,MATH 10A,A02,083736,Patchell; Gregory David,20,0,30,10
1657575596450,MATH 10A,A03,083737,Patchell; Gregory David,16,0,30,14
1657575602477,MATH 10B,A01,083207,Lim; Seonhee,8,0,34,26
1657575602477,MATH 10B,A02,083208,Lim; Seonhee,9,0,35,26
1657575602477,MATH 10B,A03,093472,Lim; Seonhee,7,0,34,27
1657575602477,MATH 10B,B01,083739,Sinha; Shubham,12,0,30,18
1657575608500,MATH 18,A01,083743,Cinel; Cameron Alexander,7,0,30,23
1657575608500,MATH 18,A02,083744,Cinel; Cameron Alexander,17,0,30,13
1657575608500,MATH 18,A03,083745,Cinel; Cameron Alexander,9,0,30,21
1657575608500,MATH 18,B01,083748,Rideout; David Porter,5,0,37,32
1657575608500,MATH 18,B02,083749,Rideout; David Porter,5,0,36,31
1657575608500,MATH 18,B03,083750,Rideout; David Porter,3,0,37,34
1657575608500,MATH 18,B04,083751,Rideout; David Porter,6,0,36,30
1657575608500,MATH 18,B05,093473,Rideout; David Porter,6,0,36,30
1657575608500,MATH 18,B06,093474,Rideout; David Porter,6,0,36,30
1657575614524,MATH 20A,A01,083754,Zheng; Zequn,14,0,40,26
1657575620547,MATH 20B,A01,083756,Briones; Jor-el Thomas Caparas,4,0,36,32
1657575620547,MATH 20B,A02,083757,Briones; Jor-el Thomas Caparas,1,0,36,35
1657575620547,MATH 20B,A03,093475,Briones; Jor-el Thomas Caparas,2,0,36,34
1657575626577,MATH 20C,A01,083760,Briones; Jor-el Thomas Caparas,1,0,35,34
1657575626577,MATH 20C,A02,083761,Briones; Jor-el Thomas Caparas,8,0,35,27
1657575626577,MATH 20C,A03,093476,Briones; Jor-el Thomas Caparas,0,1,36,36
1657575626577,MATH 20C,B01,083762,Bach; Quang Tran,1,0,30,29
1657575632599,MATH 20D,A01,083765,Tran; Brian Kha,5,0,30,25
1657575632599,MATH 20D,A02,083766,Tran; Brian Kha,5,0,30,25
1657575632599,MATH 20D,A03,083767,Tran; Brian Kha,5,0,30,25
1657575638626,MATH 20E,A01,083771,Ganguly; Soumya,9,0,32,23
1657575638626,MATH 20E,A02,083772,Ganguly; Soumya,6,0,32,26
1657575638626,MATH 20E,B01,083773,Ciotti; Benjamin,20,0,35,15
1657575638626,MATH 20E,B02,083774,Ciotti; Benjamin,18,0,35,17
1657575644654,MATH 103A,A01,083777,Greenfeld; Be'Eri,3,0,36,33
1657575644654,MATH 103A,A02,083778,Greenfeld; Be'Eri,5,0,36,31
1657575644654,MATH 103A,A03,093561,Greenfeld; Be'Eri,5,0,36,31
1657575644654,MATH 103A,B01,083779,Greenfeld; Be'Eri,7,0,36,29
1657575644654,MATH 103A,B02,083780,Greenfeld; Be'Eri,4,0,36,32
1657575644654,MATH 103A,B03,093562,Greenfeld; Be'Eri,3,0,36,33
1657575650690,MATH 105,A01,085443,Carter; Anne Toulson,15,0,35,20
1657575650690,MATH 105,A02,093477,Carter; Anne Toulson,20,0,35,15
1657575656714,MATH 109,A01,083213,Ganzberger; Geoffrey Michael,2,0,34,32
1657575656714,MATH 109,A02,083214,Ganzberger; Geoffrey Michael,4,0,34,30
1657575656714,MATH 109,A03,093478,Ganzberger; Geoffrey Michael,2,0,34,32
1657575656714,MATH 109,B01,083215,Ganzberger; Geoffrey Michael,1,0,32,31
1657575656714,MATH 109,B02,083216,Ganzberger; Geoffrey Michael,2,0,32,30
1657575656714,MATH 109,B03,093479,Ganzberger; Geoffrey Michael,8,0,32,24
1657575662755,MATH 142A,A01,083219,Chow; Bennett,7,0,32,25
1657575662755,MATH 142A,A02,083220,Chow; Bennett,10,0,32,22
1657575662755,MATH 142A,A03,093480,Chow; Bennett,8,0,32,24
1657575662755,MATH 142A,B03,093481,Chow; Bennett,8,0,32,24
1657575662755,MATH 142A,B04,093558,Chow; Bennett,13,0,32,19
1657575662755,MATH 142A,B05,093559,Chow; Bennett,6,0,32,26
1657575668778,MATH 193A,A01,083224,Rotar; Vladimir,8,0,34,26
1657575668778,MATH 193A,A02,083225,Rotar; Vladimir,9,0,34,25
1657575668778,MATH 193A,A03,083781,Rotar; Vladimir,5,0,34,29
1657575668778,MATH 193A,A04,083782,Rotar; Vladimir,10,0,34,24
1657575668778,MATH 193A,A05,093482,Rotar; Vladimir,10,0,34,24
1657575674801,MATH 197,001,091859,McAuley; Julian John,9999,0,9999,0
1657575674801,MATH 197,002,095566,Kedlaya; Kiran S.,9997,0,9999,2
1657575674801,MATH 197,003,095567,Xiao; Ming,9999,0,9999,0
1657575674801,MATH 197,004,095571,Perols; Johan Lars,9998,0,9999,1
1657575681871,COGS 9,A01,083615,Shannon; Kyle Michael,9,0,75,66
1657575687893,COGS 11,A01,083617,Boyle; Mary E. T.,23,0,48,25
1657575693917,COGS 13,A01,083071,Bastos; Amalia Pinkusfeld,11,0,71,60
1657575699941,COGS 14A,A01,092681,Semenuks; Arturs,5,1,100,95
1657575705974,COGS 14B,A01,083073,Cheng; Tzu-Han,6,0,63,57
1657575711999,COGS 17,A01,092677,Semenuks; Arturs,6,0,81,75
1657575718022,COGS 100,A01,083619,Allen; Michael Gordon,17,0,70,53
1657575724049,COGS 101A,A01,083621,Davis; Joshua Daniel,9,0,68,59
1657575730071,COGS 101B,A01,091572,Allen; Michael Gordon,12,0,65,53
1657575736094,COGS 101C,A01,083625,Delgado; Tania,17,0,35,18
1657575742119,COGS 107A,A01,083627,Boyle; Mary E. T.,13,0,60,47
1657575748147,COGS 118A,A01,083075,Gupta; Anjum,21,0,76,55
1657575754175,CSE 3,A50,083646,Miranda; Gregory Joseph,24,0,50,26
1657575760207,CSE 8A,A50,083650,Miranda; Gregory Joseph,17,1,56,39
1657575766232,CSE 11,A01,083080,Cao; Yingjun,6,15,40,34
1657575772256,CSE 12,A01,083652,Krause-Levy; Sophia Louisa,28,1,120,92
1657575778282,CSE 15L,A01,083654,Morris; Justin Loren,9,0,50,41
1657575778282,CSE 15L,A02,083655,Morris; Justin Loren,9,0,50,41
1657575784306,CSE 20,A01,083657,Tran; Khoa Dang,39,0,80,41
1657575790333,CSE 21,A01,095574,Bach; Quang Tran,22,0,48,26
1657575796357,CSE 30,A01,083084,Eldon; John,5,0,80,75
1657575796357,CSE 30,B01,095061,Bhaskar; Nishant,9,0,50,41
1657575802383,CSE 100,A01,083659,Cao; Yingjun,5,4,70,65
1657575808413,CSE 134B,A01,083661,Powell; Thomas Allan,22,0,100,78
1657575814439,CSE 140,A01,083663,Gungor; Onat,15,0,85,70
1657575820465,CSE 140L,A01,083088,Eldon; John,21,0,100,79
1657575826494,CSE 175,A01,083665,Kumar; Rakesh,3,0,25,22
1657575832523,CSE 190,A00,092507,Dubnov; Shlomo,8,0,20,12
1657575838547,ECE 45,A01,083139,Congero; Spencer William,6,0,75,69
1657575844571,ECE 65,A50,083695,Saad; Andrew S,12,0,30,18
1657575844571,ECE 65,A51,095125,Saad; Andrew S,24,0,26,2
1657575850607,ECE 109,A01,091882,Touri; Behrouz,19,0,70,51
1657575856640,ECE 180,A00,083140,Abi Samra; Nicholas Camill,1,0,30,29
1657575856640,ECE 180,B00,083141,Abi Samra; Nicholas Camill,0,0,30,30
1657575862666,MATH 10A,A01,083735,Patchell; Gregory David,2,0,30,28
1657575862666,MATH 10A,A02,083736,Patchell; Gregory David,20,0,30,10
1657575862666,MATH 10A,A03,083737,Patchell; Gregory David,16,0,30,14
1657575868702,MATH 10B,A01,083207,Lim; Seonhee,8,0,34,26
1657575868702,MATH 10B,A02,083208,Lim; Seonhee,9,0,35,26
1657575868702,MATH 10B,A03,093472,Lim; Seonhee,7,0,34,27
1657575868702,MATH 10B,B01,083739,Sinha; Shubham,12,0,30,18
1657575874726,MATH 18,A01,083743,Cinel; Cameron Alexander,7,0,30,23
1657575874726,MATH 18,A02,083744,Cinel; Cameron Alexander,17,0,30,13
1657575874726,MATH 18,A03,083745,Cinel; Cameron Alexander,9,0,30,21
1657575874726,MATH 18,B01,083748,Rideout; David Porter,5,0,37,32
1657575874726,MATH 18,B02,083749,Rideout; David Porter,5,0,36,31
1657575874726,MATH 18,B03,083750,Rideout; David Porter,3,0,37,34
1657575874726,MATH 18,B04,083751,Rideout; David Porter,6,0,36,30
1657575874726,MATH 18,B05,093473,Rideout; David Porter,6,0,36,30
1657575874726,MATH 18,B06,093474,Rideout; David Porter,6,0,36,30
1657575880751,MATH 20A,A01,083754,Zheng; Zequn,14,0,40,26
1657575886782,MATH 20B,A01,083756,Briones; Jor-el Thomas Caparas,4,0,36,32
1657575886782,MATH 20B,A02,083757,Briones; Jor-el Thomas Caparas,1,0,36,35
1657575886782,MATH 20B,A03,093475,Briones; Jor-el Thomas Caparas,2,0,36,34
1657575892804,MATH 20C,A01,083760,Briones; Jor-el Thomas Caparas,1,0,35,34
1657575892804,MATH 20C,A02,083761,Briones; Jor-el Thomas Caparas,8,0,35,27
1657575892804,MATH 20C,A03,093476,Briones; Jor-el Thomas Caparas,0,1,36,36
1657575892804,MATH 20C,B01,083762,Bach; Quang Tran,1,0,30,29
1657575898831,MATH 20D,A01,083765,Tran; Brian Kha,5,0,30,25
1657575898831,MATH 20D,A02,083766,Tran; Brian Kha,5,0,30,25
1657575898831,MATH 20D,A03,083767,Tran; Brian Kha,5,0,30,25
1657575904856,MATH 20E,A01,083771,Ganguly; Soumya,9,0,32,23
1657575904856,MATH 20E,A02,083772,Ganguly; Soumya,6,0,32,26
1657575904856,MATH 20E,B01,083773,Ciotti; Benjamin,20,0,35,15
1657575904856,MATH 20E,B02,083774,Ciotti; Benjamin,18,0,35,17
1657575910899,MATH 103A,A01,083777,Greenfeld; Be'Eri,3,0,36,33
1657575910899,MATH 103A,A02,083778,Greenfeld; Be'Eri,5,0,36,31
1657575910899,MATH 103A,A03,093561,Greenfeld; Be'Eri,5,0,36,31
1657575910899,MATH 103A,B01,083779,Greenfeld; Be'Eri,7,0,36,29
1657575910899,MATH 103A,B02,083780,Greenfeld; Be'Eri,4,0,36,32
1657575910899,MATH 103A,B03,093562,Greenfeld; Be'Eri,3,0,36,33
1657575916922,MATH 105,A01,085443,Carter; Anne Toulson,15,0,35,20
1657575916922,MATH 105,A02,093477,Carter; Anne Toulson,20,0,35,15
1657575922945,MATH 109,A01,083213,Ganzberger; Geoffrey Michael,2,0,34,32
1657575922945,MATH 109,A02,083214,Ganzberger; Geoffrey Michael,4,0,34,30
1657575922945,MATH 109,A03,093478,Ganzberger; Geoffrey Michael,2,0,34,32
1657575922945,MATH 109,B01,083215,Ganzberger; Geoffrey Michael,1,0,32,31
1657575922945,MATH 109,B02,083216,Ganzberger; Geoffrey Michael,2,0,32,30
1657575922945,MATH 109,B03,093479,Ganzberger; Geoffrey Michael,8,0,32,24
1657575928974,MATH 142A,A01,083219,Chow; Bennett,7,0,32,25
1657575928974,MATH 142A,A02,083220,Chow; Bennett,10,0,32,22
1657575928974,MATH 142A,A03,093480,Chow; Bennett,8,0,32,24
1657575928974,MATH 142A,B03,093481,Chow; Bennett,8,0,32,24
1657575928974,MATH 142A,B04,093558,Chow; Bennett,13,0,32,19
1657575928974,MATH 142A,B05,093559,Chow; Bennett,6,0,32,26
1657575935002,MATH 193A,A01,083224,Rotar; Vladimir,8,0,34,26
1657575935002,MATH 193A,A02,083225,Rotar; Vladimir,9,0,34,25
1657575935002,MATH 193A,A03,083781,Rotar; Vladimir,5,0,34,29
1657575935002,MATH 193A,A04,083782,Rotar; Vladimir,10,0,34,24
1657575935002,MATH 193A,A05,093482,Rotar; Vladimir,10,0,34,24
1657575941025,MATH 197,001,091859,McAuley; Julian John,9999,0,9999,0
1657575941025,MATH 197,002,095566,Kedlaya; Kiran S.,9997,0,9999,2
1657575941025,MATH 197,003,095567,Xiao; Ming,9999,0,9999,0
1657575941025,MATH 197,004,095571,Perols; Johan Lars,9998,0,9999,1
1657575948116,COGS 9,A01,083615,Shannon; Kyle Michael,9,0,75,66
1657575954144,COGS 11,A01,083617,Boyle; Mary E. T.,23,0,48,25
1657575960180,COGS 13,A01,083071,Bastos; Amalia Pinkusfeld,11,0,71,60
1657575966275,COGS 14A,A01,092681,Semenuks; Arturs,5,1,100,95
1657575972298,COGS 14B,A01,083073,Cheng; Tzu-Han,6,0,63,57
1657575978320,COGS 17,A01,092677,Semenuks; Arturs,6,0,81,75
1657575984349,COGS 100,A01,083619,Allen; Michael Gordon,17,0,70,53
1657575990386,COGS 101A,A01,083621,Davis; Joshua Daniel,9,0,68,59
1657575996415,COGS 101B,A01,091572,Allen; Michael Gordon,12,0,65,53
1657576002436,COGS 101C,A01,083625,Delgado; Tania,17,0,35,18
1657576008461,COGS 107A,A01,083627,Boyle; Mary E. T.,13,0,60,47
1657576014494,COGS 118A,A01,083075,Gupta; Anjum,21,0,76,55
1657576020524,CSE 3,A50,083646,Miranda; Gregory Joseph,24,0,50,26
1657576026550,CSE 8A,A50,083650,Miranda; Gregory Joseph,17,1,56,39
1657576032573,CSE 11,A01,083080,Cao; Yingjun,6,15,40,34
1657576038597,CSE 12,A01,083652,Krause-Levy; Sophia Louisa,28,1,120,92
1657576044620,CSE 15L,A01,083654,Morris; Justin Loren,9,0,50,41
1657576044620,CSE 15L,A02,083655,Morris; Justin Loren,9,0,50,41
1657576050643,CSE 20,A01,083657,Tran; Khoa Dang,39,0,80,41
1657576056667,CSE 21,A01,095574,Bach; Quang Tran,22,0,48,26
1657576062690,CSE 30,A01,083084,Eldon; John,5,0,80,75
1657576062690,CSE 30,B01,095061,Bhaskar; Nishant,9,0,50,41
1657576068717,CSE 100,A01,083659,Cao; Yingjun,5,4,70,65
1657576074743,CSE 134B,A01,083661,Powell; Thomas Allan,22,0,100,78
1657576080769,CSE 140,A01,083663,Gungor; Onat,15,0,85,70
1657576086794,CSE 140L,A01,083088,Eldon; John,21,0,100,79
1657576092816,CSE 175,A01,083665,Kumar; Rakesh,3,0,25,22
1657576098837,CSE 190,A00,092507,Dubnov; Shlomo,8,0,20,12
1657576104861,ECE 45,A01,083139,Congero; Spencer William,6,0,75,69
1657576110884,ECE 65,A50,083695,Saad; Andrew S,12,0,30,18
1657576110884,ECE 65,A51,095125,Saad; Andrew S,24,0,26,2
1657576116910,ECE 109,A01,091882,Touri; Behrouz,19,0,70,51
1657576122936,ECE 180,A00,083140,Abi Samra; Nicholas Camill,1,0,30,29
1657576122936,ECE 180,B00,083141,Abi Samra; Nicholas Camill,0,0,30,30
1657576128961,MATH 10A,A01,083735,Patchell; Gregory David,2,0,30,28
1657576128961,MATH 10A,A02,083736,Patchell; Gregory David,20,0,30,10
1657576128961,MATH 10A,A03,083737,Patchell; Gregory David,16,0,30,14
1657576134985,MATH 10B,A01,083207,Lim; Seonhee,8,0,34,26
1657576134985,MATH 10B,A02,083208,Lim; Seonhee,9,0,35,26
1657576134985,MATH 10B,A03,093472,Lim; Seonhee,7,0,34,27
1657576134985,MATH 10B,B01,083739,Sinha; Shubham,12,0,30,18
1657576141017,MATH 18,A01,083743,Cinel; Cameron Alexander,7,0,30,23
1657576141017,MATH 18,A02,083744,Cinel; Cameron Alexander,17,0,30,13
1657576141017,MATH 18,A03,083745,Cinel; Cameron Alexander,9,0,30,21
1657576141017,MATH 18,B01,083748,Rideout; David Porter,5,0,37,32
1657576141017,MATH 18,B02,083749,Rideout; David Porter,5,0,36,31
1657576141017,MATH 18,B03,083750,Rideout; David Porter,3,0,37,34
1657576141017,MATH 18,B04,083751,Rideout; David Porter,6,0,36,30
1657576141017,MATH 18,B05,093473,Rideout; David Porter,6,0,36,30
1657576141017,MATH 18,B06,093474,Rideout; David Porter,6,0,36,30
1657576147040,MATH 20A,A01,083754,Zheng; Zequn,14,0,40,26
1657576153066,MATH 20B,A01,083756,Briones; Jor-el Thomas Caparas,4,0,36,32
1657576153066,MATH 20B,A02,083757,Briones; Jor-el Thomas Caparas,1,0,36,35
1657576153066,MATH 20B,A03,093475,Briones; Jor-el Thomas Caparas,2,0,36,34
1657576159089,MATH 20C,A01,083760,Briones; Jor-el Thomas Caparas,1,0,35,34
1657576159089,MATH 20C,A02,083761,Briones; Jor-el Thomas Caparas,8,0,35,27
1657576159089,MATH 20C,A03,093476,Briones; Jor-el Thomas Caparas,0,1,36,36
1657576159089,MATH 20C,B01,083762,Bach; Quang Tran,1,0,30,29
1657576165128,MATH 20D,A01,083765,Tran; Brian Kha,5,0,30,25
1657576165128,MATH 20D,A02,083766,Tran; Brian Kha,5,0,30,25
1657576165128,MATH 20D,A03,083767,Tran; Brian Kha,5,0,30,25
1657576171154,MATH 20E,A01,083771,Ganguly; Soumya,9,0,32,23
1657576171154,MATH 20E,A02,083772,Ganguly; Soumya,6,0,32,26
1657576171154,MATH 20E,B01,083773,Ciotti; Benjamin,20,0,35,15
1657576171154,MATH 20E,B02,083774,Ciotti; Benjamin,18,0,35,17
1657576177183,MATH 103A,A01,083777,Greenfeld; Be'Eri,3,0,36,33
1657576177183,MATH 103A,A02,083778,Greenfeld; Be'Eri,5,0,36,31
1657576177183,MATH 103A,A03,093561,Greenfeld; Be'Eri,5,0,36,31
1657576177183,MATH 103A,B01,083779,Greenfeld; Be'Eri,7,0,36,29
1657576177183,MATH 103A,B02,083780,Greenfeld; Be'Eri,4,0,36,32
1657576177183,MATH 103A,B03,093562,Greenfeld; Be'Eri,3,0,36,33
1657576183218,MATH 105,A01,085443,Carter; Anne Toulson,15,0,35,20
1657576183218,MATH 105,A02,093477,Carter; Anne Toulson,20,0,35,15
1657576189242,MATH 109,A01,083213,Ganzberger; Geoffrey Michael,2,0,34,32
1657576189242,MATH 109,A02,083214,Ganzberger; Geoffrey Michael,4,0,34,30
1657576189242,MATH 109,A03,093478,Ganzberger; Geoffrey Michael,2,0,34,32
1657576189242,MATH 109,B01,083215,Ganzberger; Geoffrey Michael,1,0,32,31
1657576189242,MATH 109,B02,083216,Ganzberger; Geoffrey Michael,2,0,32,30
1657576189242,MATH 109,B03,093479,Ganzberger; Geoffrey Michael,8,0,32,24
1657576195267,MATH 142A,A01,083219,Chow; Bennett,7,0,32,25
1657576195267,MATH 142A,A02,083220,Chow; Bennett,10,0,32,22
1657576195267,MATH 142A,A03,093480,Chow; Bennett,8,0,32,24
1657576195267,MATH 142A,B03,093481,Chow; Bennett,8,0,32,24
1657576195267,MATH 142A,B04,093558,Chow; Bennett,13,0,32,19
1657576195267,MATH 142A,B05,093559,Chow; Bennett,6,0,32,26
1657576201299,MATH 193A,A01,083224,Rotar; Vladimir,8,0,34,26
1657576201299,MATH 193A,A02,083225,Rotar; Vladimir,9,0,34,25
1657576201299,MATH 193A,A03,083781,Rotar; Vladimir,5,0,34,29
1657576201299,MATH 193A,A04,083782,Rotar; Vladimir,10,0,34,24
1657576201299,MATH 193A,A05,093482,Rotar; Vladimir,10,0,34,24
1657576207325,MATH 197,001,091859,McAuley; Julian John,9999,0,9999,0
1657576207325,MATH 197,002,095566,Kedlaya; Kiran S.,9997,0,9999,2
1657576207325,MATH 197,003,095567,Xiao; Ming,9999,0,9999,0
1657576207325,MATH 197,004,095571,Perols; Johan Lars,9998,0,9999,1
1657576214396,COGS 9,A01,083615,Shannon; Kyle Michael,9,0,75,66
1657576220419,COGS 11,A01,083617,Boyle; Mary E. T.,23,0,48,25
1657576226441,COGS 13,A01,083071,Bastos; Amalia Pinkusfeld,11,0,71,60
1657576232466,COGS 14A,A01,092681,Semenuks; Arturs,5,1,100,95
1657576238488,COGS 14B,A01,083073,Cheng; Tzu-Han,6,0,63,57
1657576244519,COGS 17,A01,092677,Semenuks; Arturs,6,0,81,75
1657576250541,COGS 100,A01,083619,Allen; Michael Gordon,17,0,70,53
1657576256565,COGS 101A,A01,083621,Davis; Joshua Daniel,9,0,68,59
1657576262601,COGS 101B,A01,091572,Allen; Michael Gordon,12,0,65,53
1657576268624,COGS 101C,A01,083625,Delgado; Tania,17,0,35,18
1657576274647,COGS 107A,A01,083627,Boyle; Mary E. T.,13,0,60,47
1657576280670,COGS 118A,A01,083075,Gupta; Anjum,21,0,76,55
1657576286697,CSE 3,A50,083646,Miranda; Gregory Joseph,24,0,50,26
1657576292721,CSE 8A,A50,083650,Miranda; Gregory Joseph,17,1,56,39
1657576298749,CSE 11,A01,083080,Cao; Yingjun,6,15,40,34
1657576304775,CSE 12,A01,083652,Krause-Levy; Sophia Louisa,28,1,120,92
1657576310797,CSE 15L,A01,083654,Morris; Justin Loren,9,0,50,41
1657576310797,CSE 15L,A02,083655,Morris; Justin Loren,9,0,50,41
1657576316820,CSE 20,A01,083657,Tran; Khoa Dang,39,0,80,41
1657576322847,CSE 21,A01,095574,Bach; Quang Tran,22,0,48,26
1657576328873,CSE 30,A01,083084,Eldon; John,5,0,80,75
1657576328873,CSE 30,B01,095061,Bhaskar; Nishant,9,0,50,41
1657576334909,CSE 100,A01,083659,Cao; Yingjun,5,4,70,65
1657576340932,CSE 134B,A01,083661,Powell; Thomas Allan,22,0,100,78
1657576346955,CSE 140,A01,083663,Gungor; Onat,15,0,85,70
1657576352977,CSE 140L,A01,083088,Eldon; John,21,0,100,79
1657576359002,CSE 175,A01,083665,Kumar; Rakesh,3,0,25,22
1657576365037,CSE 190,A00,092507,Dubnov; Shlomo,8,0,20,12
1657576371059,ECE 45,A01,083139,Congero; Spencer William,6,0,75,69
1657576377082,ECE 65,A50,083695,Saad; Andrew S,12,0,30,18
1657576377082,ECE 65,A51,095125,Saad; Andrew S,24,0,26,2
1657576383104,ECE 109,A01,091882,Touri; Behrouz,19,0,70,51
1657576389134,ECE 180,A00,083140,Abi Samra; Nicholas Camill,1,0,30,29
1657576389134,ECE 180,B00,083141,Abi Samra; Nicholas Camill,0,0,30,30
1657576395162,MATH 10A,A01,083735,Patchell; Gregory David,2,0,30,28
1657576395162,MATH 10A,A02,083736,Patchell; Gregory David,20,0,30,10
1657576395162,MATH 10A,A03,083737,Patchell; Gregory David,16,0,30,14
1657576401190,MATH 10B,A01,083207,Lim; Seonhee,8,0,34,26
1657576401190,MATH 10B,A02,083208,Lim; Seonhee,9,0,35,26
1657576401190,MATH 10B,A03,093472,Lim; Seonhee,7,0,34,27
1657576401190,MATH 10B,B01,083739,Sinha; Shubham,12,0,30,18
1657576407216,MATH 18,A01,083743,Cinel; Cameron Alexander,7,0,30,23
1657576407216,MATH 18,A02,083744,Cinel; Cameron Alexander,17,0,30,13
1657576407216,MATH 18,A03,083745,Cinel; Cameron Alexander,9,0,30,21
1657576407216,MATH 18,B01,083748,Rideout; David Porter,5,0,37,32
1657576407216,MATH 18,B02,083749,Rideout; David Porter,5,0,36,31
1657576407216,MATH 18,B03,083750,Rideout; David Porter,3,0,37,34
1657576407216,MATH 18,B04,083751,Rideout; David Porter,6,0,36,30
1657576407216,MATH 18,B05,093473,Rideout; David Porter,6,0,36,30
1657576407216,MATH 18,B06,093474,Rideout; David Porter,6,0,36,30
1657576413241,MATH 20A,A01,083754,Zheng; Zequn,14,0,40,26
1657576419269,MATH 20B,A01,083756,Briones; Jor-el Thomas Caparas,4,0,36,32
1657576419269,MATH 20B,A02,083757,Briones; Jor-el Thomas Caparas,1,0,36,35
1657576419269,MATH 20B,A03,093475,Briones; Jor-el Thomas Caparas,2,0,36,34
1657576425296,MATH 20C,A01,083760,Briones; Jor-el Thomas Caparas,1,0,35,34
1657576425296,MATH 20C,A02,083761,Briones; Jor-el Thomas Caparas,8,0,35,27
1657576425296,MATH 20C,A03,093476,Briones; Jor-el Thomas Caparas,0,1,36,36
1657576425296,MATH 20C,B01,083762,Bach; Quang Tran,1,0,30,29
1657576431327,MATH 20D,A01,083765,Tran; Brian Kha,5,0,30,25
1657576431327,MATH 20D,A02,083766,Tran; Brian Kha,5,0,30,25
1657576431327,MATH 20D,A03,083767,Tran; Brian Kha,5,0,30,25
1657576437350,MATH 20E,A01,083771,Ganguly; Soumya,9,0,32,23
1657576437350,MATH 20E,A02,083772,Ganguly; Soumya,6,0,32,26
1657576437350,MATH 20E,B01,083773,Ciotti; Benjamin,20,0,35,15
1657576437350,MATH 20E,B02,083774,Ciotti; Benjamin,18,0,35,17
1657576443376,MATH 103A,A01,083777,Greenfeld; Be'Eri,3,0,36,33
1657576443376,MATH 103A,A02,083778,Greenfeld; Be'Eri,5,0,36,31
1657576443376,MATH 103A,A03,093561,Greenfeld; Be'Eri,5,0,36,31
1657576443376,MATH 103A,B01,083779,Greenfeld; Be'Eri,7,0,36,29
1657576443376,MATH 103A,B02,083780,Greenfeld; Be'Eri,4,0,36,32
1657576443376,MATH 103A,B03,093562,Greenfeld; Be'Eri,3,0,36,33
1657576449400,MATH 105,A01,085443,Carter; Anne Toulson,15,0,35,20
1657576449400,MATH 105,A02,093477,Carter; Anne Toulson,20,0,35,15
1657576455443,MATH 109,A01,083213,Ganzberger; Geoffrey Michael,2,0,34,32
1657576455443,MATH 109,A02,083214,Ganzberger; Geoffrey Michael,4,0,34,30
1657576455443,MATH 109,A03,093478,Ganzberger; Geoffrey Michael,2,0,34,32
1657576455443,MATH 109,B01,083215,Ganzberger; Geoffrey Michael,1,0,32,31
1657576455443,MATH 109,B02,083216,Ganzberger; Geoffrey Michael,2,0,32,30
1657576455443,MATH 109,B03,093479,Ganzberger; Geoffrey Michael,8,0,32,24
1657576461470,MATH 142A,A01,083219,Chow; Bennett,7,0,32,25
1657576461470,MATH 142A,A02,083220,Chow; Bennett,10,0,32,22
1657576461470,MATH 142A,A03,093480,Chow; Bennett,8,0,32,24
1657576461470,MATH 142A,B03,093481,Chow; Bennett,8,0,32,24
1657576461470,MATH 142A,B04,093558,Chow; Bennett,13,0,32,19
1657576461470,MATH 142A,B05,093559,Chow; Bennett,6,0,32,26
1657576467492,MATH 193A,A01,083224,Rotar; Vladimir,8,0,34,26
1657576467492,MATH 193A,A02,083225,Rotar; Vladimir,9,0,34,25
1657576467492,MATH 193A,A03,083781,Rotar; Vladimir,5,0,34,29
1657576467492,MATH 193A,A04,083782,Rotar; Vladimir,10,0,34,24
1657576467492,MATH 193A,A05,093482,Rotar; Vladimir,10,0,34,24
1657576473518,MATH 197,001,091859,McAuley; Julian John,9999,0,9999,0
1657576473518,MATH 197,002,095566,Kedlaya; Kiran S.,9997,0,9999,2
1657576473518,MATH 197,003,095567,Xiao; Ming,9999,0,9999,0
1657576473518,MATH 197,004,095571,Perols; Johan Lars,9998,0,9999,1
1657576480569,COGS 9,A01,083615,Shannon; Kyle Michael,9,0,75,66
1657576486598,COGS 11,A01,083617,Boyle; Mary E. T.,23,0,48,25
1657576492622,COGS 13,A01,083071,Bastos; Amalia Pinkusfeld,11,0,71,60
1657576498645,COGS 14A,A01,092681,Semenuks; Arturs,5,1,100,95
1657576504671,COGS 14B,A01,083073,Cheng; Tzu-Han,6,0,63,57
1657576510693,COGS 17,A01,092677,Semenuks; Arturs,6,0,81,75
1657576516718,COGS 100,A01,083619,Allen; Michael Gordon,17,0,70,53
1657576522745,COGS 101A,A01,083621,Davis; Joshua Daniel,9,0,68,59
1657576528768,COGS 101B,A01,091572,Allen; Michael Gordon,12,0,65,53
1657576534794,COGS 101C,A01,083625,Delgado; Tania,17,0,35,18
1657576540832,COGS 107A,A01,083627,Boyle; Mary E. T.,13,0,60,47
1657576546855,COGS 118A,A01,083075,Gupta; Anjum,21,0,76,55
1657576552885,CSE 3,A50,083646,Miranda; Gregory Joseph,24,0,50,26
1657576558936,CSE 8A,A50,083650,Miranda; Gregory Joseph,17,1,56,39
1657576565058,CSE 11,A01,083080,Cao; Yingjun,6,15,40,34
1657576571086,CSE 12,A01,083652,Krause-Levy; Sophia Louisa,28,1,120,92
1657576577111,CSE 15L,A01,083654,Morris; Justin Loren,9,0,50,41
1657576577111,CSE 15L,A02,083655,Morris; Justin Loren,9,0,50,41
1657576583159,CSE 20,A01,083657,Tran; Khoa Dang,39,0,80,41
1657576589183,CSE 21,A01,095574,Bach; Quang Tran,22,0,48,26
1657576595218,CSE 30,A01,083084,Eldon; John,5,0,80,75
1657576595218,CSE 30,B01,095061,Bhaskar; Nishant,9,0,50,41
1657576601242,CSE 100,A01,083659,Cao; Yingjun,5,4,70,65
1657576607269,CSE 134B,A01,083661,Powell; Thomas Allan,22,0,100,78
1657576613301,CSE 140,A01,083663,Gungor; Onat,15,0,85,70
1657576619324,CSE 140L,A01,083088,Eldon; John,21,0,100,79
1657576625349,CSE 175,A01,083665,Kumar; Rakesh,3,0,25,22
1657576631380,CSE 190,A00,092507,Dubnov; Shlomo,8,0,20,12
1657576637405,ECE 45,A01,083139,Congero; Spencer William,6,0,75,69
1657576643429,ECE 65,A50,083695,Saad; Andrew S,12,0,30,18
1657576643429,ECE 65,A51,095125,Saad; Andrew S,24,0,26,2
1657576649454,ECE 109,A01,091882,Touri; Behrouz,19,0,70,51
1657576655487,ECE 180,A00,083140,Abi Samra; Nicholas Camill,1,0,30,29
1657576655487,ECE 180,B00,083141,Abi Samra; Nicholas Camill,0,0,30,30
1657576661518,MATH 10A,A01,083735,Patchell; Gregory David,2,0,30,28
1657576661518,MATH 10A,A02,083736,Patchell; Gregory David,20,0,30,10
1657576661518,MATH 10A,A03,083737,Patchell; Gregory David,16,0,30,14
1657576667542,MATH 10B,A01,083207,Lim; Seonhee,8,0,34,26
1657576667542,MATH 10B,A02,083208,Lim; Seonhee,9,0,35,26
1657576667542,MATH 10B,A03,093472,Lim; Seonhee,7,0,34,27
1657576667542,MATH 10B,B01,083739,Sinha; Shubham,12,0,30,18
1657576673590,MATH 18,A01,083743,Cinel; Cameron Alexander,7,0,30,23
1657576673590,MATH 18,A02,083744,Cinel; Cameron Alexander,17,0,30,13
1657576673590,MATH 18,A03,083745,Cinel; Cameron Alexander,9,0,30,21
1657576673590,MATH 18,B01,083748,Rideout; David Porter,5,0,37,32
1657576673590,MATH 18,B02,083749,Rideout; David Porter,5,0,36,31
1657576673590,MATH 18,B03,083750,Rideout; David Porter,3,0,37,34
1657576673590,MATH 18,B04,083751,Rideout; David Porter,6,0,36,30
1657576673590,MATH 18,B05,093473,Rideout; David Porter,6,0,36,30
1657576673590,MATH 18,B06,093474,Rideout; David Porter,6,0,36,30
1657576679613,MATH 20A,A01,083754,Zheng; Zequn,14,0,40,26
1657576685657,MATH 20B,A01,083756,Briones; Jor-el Thomas Caparas,4,0,36,32
1657576685657,MATH 20B,A02,083757,Briones; Jor-el Thomas Caparas,1,0,36,35
1657576685657,MATH 20B,A03,093475,Briones; Jor-el Thomas Caparas,2,0,36,34
1657576691686,MATH 20C,A01,083760,Briones; Jor-el Thomas Caparas,1,0,35,34
1657576691686,MATH 20C,A02,083761,Briones; Jor-el Thomas Caparas,8,0,35,27
1657576691686,MATH 20C,A03,093476,Briones; Jor-el Thomas Caparas,0,1,36,36
1657576691686,MATH 20C,B01,083762,Bach; Quang Tran,1,0,30,29
1657576697709,MATH 20D,A01,083765,Tran; Brian Kha,5,0,30,25
1657576697709,MATH 20D,A02,083766,Tran; Brian Kha,5,0,30,25
1657576697709,MATH 20D,A03,083767,Tran; Brian Kha,5,0,30,25
1657576703735,MATH 20E,A01,083771,Ganguly; Soumya,9,0,32,23
1657576703735,MATH 20E,A02,083772,Ganguly; Soumya,6,0,32,26
1657576703735,MATH 20E,B01,083773,Ciotti; Benjamin,20,0,35,15
1657576703735,MATH 20E,B02,083774,Ciotti; Benjamin,18,0,35,17
1657576709759,MATH 103A,A01,083777,Greenfeld; Be'Eri,3,0,36,33
1657576709759,MATH 103A,A02,083778,Greenfeld; Be'Eri,5,0,36,31
1657576709759,MATH 103A,A03,093561,Greenfeld; Be'Eri,5,0,36,31
1657576709759,MATH 103A,B01,083779,Greenfeld; Be'Eri,7,0,36,29
1657576709759,MATH 103A,B02,083780,Greenfeld; Be'Eri,4,0,36,32
1657576709759,MATH 103A,B03,093562,Greenfeld; Be'Eri,3,0,36,33
1657576715784,MATH 105,A01,085443,Carter; Anne Toulson,15,0,35,20
1657576715784,MATH 105,A02,093477,Carter; Anne Toulson,20,0,35,15
1657576721808,MATH 109,A01,083213,Ganzberger; Geoffrey Michael,2,0,34,32
1657576721808,MATH 109,A02,083214,Ganzberger; Geoffrey Michael,4,0,34,30
1657576721808,MATH 109,A03,093478,Ganzberger; Geoffrey Michael,2,0,34,32
1657576721808,MATH 109,B01,083215,Ganzberger; Geoffrey Michael,1,0,32,31
1657576721808,MATH 109,B02,083216,Ganzberger; Geoffrey Michael,2,0,32,30
1657576721808,MATH 109,B03,093479,Ganzberger; Geoffrey Michael,8,0,32,24
1657576727839,MATH 142A,A01,083219,Chow; Bennett,7,0,32,25
1657576727839,MATH 142A,A02,083220,Chow; Bennett,10,0,32,22
1657576727839,MATH 142A,A03,093480,Chow; Bennett,8,0,32,24
1657576727839,MATH 142A,B03,093481,Chow; Bennett,8,0,32,24
1657576727839,MATH 142A,B04,093558,Chow; Bennett,13,0,32,19
1657576727839,MATH 142A,B05,093559,Chow; Bennett,6,0,32,26
1657576733860,MATH 193A,A01,083224,Rotar; Vladimir,8,0,34,26
1657576733860,MATH 193A,A02,083225,Rotar; Vladimir,9,0,34,25
1657576733860,MATH 193A,A03,083781,Rotar; Vladimir,5,0,34,29
1657576733860,MATH 193A,A04,083782,Rotar; Vladimir,10,0,34,24
1657576733860,MATH 193A,A05,093482,Rotar; Vladimir,10,0,34,24
1657576739887,MATH 197,001,091859,McAuley; Julian John,9999,0,9999,0
1657576739887,MATH 197,002,095566,Kedlaya; Kiran S.,9997,0,9999,2
1657576739887,MATH 197,003,095567,Xiao; Ming,9999,0,9999,0
1657576739887,MATH 197,004,095571,Perols; Johan Lars,9998,0,9999,1
1657576746943,COGS 9,A01,083615,Shannon; Kyle Michael,9,0,75,66
1657576752970,COGS 11,A01,083617,Boyle; Mary E. T.,23,0,48,25
1657576759005,COGS 13,A01,083071,Bastos; Amalia Pinkusfeld,11,0,71,60
1657576765044,COGS 14A,A01,092681,Semenuks; Arturs,5,1,100,95
1657576771072,COGS 14B,A01,083073,Cheng; Tzu-Han,6,0,63,57
1657576777099,COGS 17,A01,092677,Semenuks; Arturs,6,0,81,75
1657576783125,COGS 100,A01,083619,Allen; Michael Gordon,17,0,70,53
1657576789149,COGS 101A,A01,083621,Davis; Joshua Daniel,9,0,68,59
1657576795176,COGS 101B,A01,091572,Allen; Michael Gordon,12,0,65,53
1657576801213,COGS 101C,A01,083625,Delgado; Tania,17,0,35,18
1657576807238,COGS 107A,A01,083627,Boyle; Mary E. T.,13,0,60,47
1657576813279,COGS 118A,A01,083075,Gupta; Anjum,21,0,76,55
1657576819302,CSE 3,A50,083646,Miranda; Gregory Joseph,24,0,50,26
1657576825325,CSE 8A,A50,083650,Miranda; Gregory Joseph,17,1,56,39
1657576831350,CSE 11,A01,083080,Cao; Yingjun,6,15,40,34
1657576837377,CSE 12,A01,083652,Krause-Levy; Sophia Louisa,28,1,120,92
1657576843420,CSE 15L,A01,083654,Morris; Justin Loren,9,0,50,41
1657576843420,CSE 15L,A02,083655,Morris; Justin Loren,9,0,50,41
1657576849442,CSE 20,A01,083657,Tran; Khoa Dang,39,0,80,41
1657576855468,CSE 21,A01,095574,Bach; Quang Tran,22,0,48,26
1657576861491,CSE 30,A01,083084,Eldon; John,5,0,80,75
1657576861491,CSE 30,B01,095061,Bhaskar; Nishant,9,0,50,41
1657576867518,CSE 100,A01,083659,Cao; Yingjun,5,4,70,65
1657576873542,CSE 134B,A01,083661,Powell; Thomas Allan,22,0,100,78
1657576879565,CSE 140,A01,083663,Gungor; Onat,15,0,85,70
1657576885591,CSE 140L,A01,083088,Eldon; John,21,0,100,79
1657576891615,CSE 175,A01,083665,Kumar; Rakesh,3,0,25,22
1657576897644,CSE 190,A00,092507,Dubnov; Shlomo,8,0,20,12
1657576903668,ECE 45,A01,083139,Congero; Spencer William,6,0,75,69
1657576909691,ECE 65,A50,083695,Saad; Andrew S,12,0,30,18
1657576909691,ECE 65,A51,095125,Saad; Andrew S,24,0,26,2
1657576915714,ECE 109,A01,091882,Touri; Behrouz,19,0,70,51
1657576921748,ECE 180,A00,083140,Abi Samra; Nicholas Camill,1,0,30,29
1657576921748,ECE 180,B00,083141,Abi Samra; Nicholas Camill,0,0,30,30
1657576927771,MATH 10A,A01,083735,Patchell; Gregory David,2,0,30,28
1657576927771,MATH 10A,A02,083736,Patchell; Gregory David,20,0,30,10
1657576927771,MATH 10A,A03,083737,Patchell; Gregory David,16,0,30,14
1657576933794,MATH 10B,A01,083207,Lim; Seonhee,8,0,34,26
1657576933794,MATH 10B,A02,083208,Lim; Seonhee,9,0,35,26
1657576933794,MATH 10B,A03,093472,Lim; Seonhee,7,0,34,27
1657576933794,MATH 10B,B01,083739,Sinha; Shubham,12,0,30,18
1657576939824,MATH 18,A01,083743,Cinel; Cameron Alexander,7,0,30,23
1657576939824,MATH 18,A02,083744,Cinel; Cameron Alexander,17,0,30,13
1657576939824,MATH 18,A03,083745,Cinel; Cameron Alexander,9,0,30,21
1657576939824,MATH 18,B01,083748,Rideout; David Porter,5,0,37,32
1657576939824,MATH 18,B02,083749,Rideout; David Porter,5,0,36,31
1657576939824,MATH 18,B03,083750,Rideout; David Porter,3,0,37,34
1657576939824,MATH 18,B04,083751,Rideout; David Porter,6,0,36,30
1657576939824,MATH 18,B05,093473,Rideout; David Porter,6,0,36,30
1657576939824,MATH 18,B06,093474,Rideout; David Porter,6,0,36,30
1657576945848,MATH 20A,A01,083754,Zheng; Zequn,14,0,40,26
1657576951871,MATH 20B,A01,083756,Briones; Jor-el Thomas Caparas,4,0,36,32
1657576951871,MATH 20B,A02,083757,Briones; Jor-el Thomas Caparas,1,0,36,35
1657576951871,MATH 20B,A03,093475,Briones; Jor-el Thomas Caparas,2,0,36,34
1657576957903,MATH 20C,A01,083760,Briones; Jor-el Thomas Caparas,1,0,35,34
1657576957903,MATH 20C,A02,083761,Briones; Jor-el Thomas Caparas,8,0,35,27
1657576957903,MATH 20C,A03,093476,Briones; Jor-el Thomas Caparas,0,1,36,36
1657576957903,MATH 20C,B01,083762,Bach; Quang Tran,1,0,30,29
1657576963932,MATH 20D,A01,083765,Tran; Brian Kha,5,0,30,25
1657576963932,MATH 20D,A02,083766,Tran; Brian Kha,5,0,30,25
1657576963932,MATH 20D,A03,083767,Tran; Brian Kha,5,0,30,25
1657576969963,MATH 20E,A01,083771,Ganguly; Soumya,9,0,32,23
1657576969963,MATH 20E,A02,083772,Ganguly; Soumya,6,0,32,26
1657576969963,MATH 20E,B01,083773,Ciotti; Benjamin,20,0,35,15
1657576969963,MATH 20E,B02,083774,Ciotti; Benjamin,18,0,35,17
1657576975987,MATH 103A,A01,083777,Greenfeld; Be'Eri,3,0,36,33
1657576975987,MATH 103A,A02,083778,Greenfeld; Be'Eri,5,0,36,31
1657576975987,MATH 103A,A03,093561,Greenfeld; Be'Eri,5,0,36,31
1657576975987,MATH 103A,B01,083779,Greenfeld; Be'Eri,7,0,36,29
1657576975987,MATH 103A,B02,083780,Greenfeld; Be'Eri,4,0,36,32
1657576975987,MATH 103A,B03,093562,Greenfeld; Be'Eri,3,0,36,33
1657576982012,MATH 105,A01,085443,Carter; Anne Toulson,15,0,35,20
1657576982012,MATH 105,A02,093477,Carter; Anne Toulson,20,0,35,15
1657576988038,MATH 109,A01,083213,Ganzberger; Geoffrey Michael,2,0,34,32
1657576988038,MATH 109,A02,083214,Ganzberger; Geoffrey Michael,4,0,34,30
1657576988038,MATH 109,A03,093478,Ganzberger; Geoffrey Michael,2,0,34,32
1657576988038,MATH 109,B01,083215,Ganzberger; Geoffrey Michael,1,0,32,31
1657576988038,MATH 109,B02,083216,Ganzberger; Geoffrey Michael,2,0,32,30
1657576988038,MATH 109,B03,093479,Ganzberger; Geoffrey Michael,8,0,32,24
1657576994068,MATH 142A,A01,083219,Chow; Bennett,7,0,32,25
1657576994068,MATH 142A,A02,083220,Chow; Bennett,10,0,32,22
1657576994068,MATH 142A,A03,093480,Chow; Bennett,8,0,32,24
1657576994068,MATH 142A,B03,093481,Chow; Bennett,8,0,32,24
1657576994068,MATH 142A,B04,093558,Chow; Bennett,13,0,32,19
1657576994068,MATH 142A,B05,093559,Chow; Bennett,6,0,32,26
1657577000096,MATH 193A,A01,083224,Rotar; Vladimir,8,0,34,26
1657577000096,MATH 193A,A02,083225,Rotar; Vladimir,9,0,34,25
1657577000096,MATH 193A,A03,083781,Rotar; Vladimir,5,0,34,29
1657577000096,MATH 193A,A04,083782,Rotar; Vladimir,10,0,34,24
1657577000096,MATH 193A,A05,093482,Rotar; Vladimir,10,0,34,24
1657577006140,MATH 197,001,091859,McAuley; Julian John,9999,0,9999,0
1657577006140,MATH 197,002,095566,Kedlaya; Kiran S.,9997,0,9999,2
1657577006140,MATH 197,003,095567,Xiao; Ming,9999,0,9999,0
1657577006140,MATH 197,004,095571,Perols; Johan Lars,9998,0,9999,1
1657577013206,COGS 9,A01,083615,Shannon; Kyle Michael,9,0,75,66
1657577019232,COGS 11,A01,083617,Boyle; Mary E. T.,23,0,48,25
1657577025254,COGS 13,A01,083071,Bastos; Amalia Pinkusfeld,11,0,71,60
1657577031280,COGS 14A,A01,092681,Semenuks; Arturs,5,1,100,95
1657577037307,COGS 14B,A01,083073,Cheng; Tzu-Han,6,0,63,57
1657577043347,COGS 17,A01,092677,Semenuks; Arturs,6,0,81,75
1657577049380,COGS 100,A01,083619,Allen; Michael Gordon,17,0,70,53
1657577055409,COGS 101A,A01,083621,Davis; Joshua Daniel,9,0,68,59
1657577061446,COGS 101B,A01,091572,Allen; Michael Gordon,12,0,65,53
1657577067476,COGS 101C,A01,083625,Delgado; Tania,17,0,35,18
1657577073500,COGS 107A,A01,083627,Boyle; Mary E. T.,13,0,60,47
1657577079538,COGS 118A,A01,083075,Gupta; Anjum,21,0,76,55
1657577085564,CSE 3,A50,083646,Miranda; Gregory Joseph,24,0,50,26
1657577091591,CSE 8A,A50,083650,Miranda; Gregory Joseph,17,1,56,39
1657577097613,CSE 11,A01,083080,Cao; Yingjun,6,15,40,34
1657577103637,CSE 12,A01,083652,Krause-Levy; Sophia Louisa,28,1,120,92
1657577109660,CSE 15L,A01,083654,Morris; Justin Loren,9,0,50,41
1657577109660,CSE 15L,A02,083655,Morris; Justin Loren,9,0,50,41
1657577115686,CSE 20,A01,083657,Tran; Khoa Dang,39,0,80,41
1657577121711,CSE 21,A01,095574,Bach; Quang Tran,22,0,48,26
1657577127738,CSE 30,A01,083084,Eldon; John,5,0,80,75
1657577127738,CSE 30,B01,095061,Bhaskar; Nishant,9,0,50,41
1657577133764,CSE 100,A01,083659,Cao; Yingjun,5,4,70,65
1657577139787,CSE 134B,A01,083661,Powell; Thomas Allan,22,0,100,78
1657577145810,CSE 140,A01,083663,Gungor; Onat,15,0,85,70
1657577151834,CSE 140L,A01,083088,Eldon; John,21,0,100,79
1657577157857,CSE 175,A01,083665,Kumar; Rakesh,3,0,25,22
1657577163979,CSE 190,A00,092507,Dubnov; Shlomo,8,0,20,12
1657577170006,ECE 45,A01,083139,Congero; Spencer William,6,0,75,69
1657577176033,ECE 65,A50,083695,Saad; Andrew S,12,0,30,18
1657577176033,ECE 65,A51,095125,Saad; Andrew S,24,0,26,2
1657577182061,ECE 109,A01,091882,Touri; Behrouz,19,0,70,51
1657577188088,ECE 180,A00,083140,Abi Samra; Nicholas Camill,1,0,30,29
1657577188088,ECE 180,B00,083141,Abi Samra; Nicholas Camill,0,0,30,30
1657577194117,MATH 10A,A01,083735,Patchell; Gregory David,2,0,30,28
1657577194117,MATH 10A,A02,083736,Patchell; Gregory David,20,0,30,10
1657577194117,MATH 10A,A03,083737,Patchell; Gregory David,16,0,30,14
1657577200140,MATH 10B,A01,083207,Lim; Seonhee,8,0,34,26
1657577200140,MATH 10B,A02,083208,Lim; Seonhee,9,0,35,26
1657577200140,MATH 10B,A03,093472,Lim; Seonhee,7,0,34,27
1657577200140,MATH 10B,B01,083739,Sinha; Shubham,12,0,30,18
1657577206167,MATH 18,A01,083743,Cinel; Cameron Alexander,7,0,30,23
1657577206167,MATH 18,A02,083744,Cinel; Cameron Alexander,17,0,30,13
1657577206167,MATH 18,A03,083745,Cinel; Cameron Alexander,9,0,30,21
1657577206167,MATH 18,B01,083748,Rideout; David Porter,5,0,37,32
1657577206167,MATH 18,B02,083749,Rideout; David Porter,5,0,36,31
1657577206167,MATH 18,B03,083750,Rideout; David Porter,3,0,37,34
1657577206167,MATH 18,B04,083751,Rideout; David Porter,6,0,36,30
1657577206167,MATH 18,B05,093473,Rideout; David Porter,6,0,36,30
1657577206167,MATH 18,B06,093474,Rideout; David Porter,6,0,36,30
1657577212191,MATH 20A,A01,083754,Zheng; Zequn,14,0,40,26
1657577218214,MATH 20B,A01,083756,Briones; Jor-el Thomas Caparas,4,0,36,32
1657577218214,MATH 20B,A02,083757,Briones; Jor-el Thomas Caparas,1,0,36,35
1657577218214,MATH 20B,A03,093475,Briones; Jor-el Thomas Caparas,2,0,36,34
1657577224250,MATH 20C,A01,083760,Briones; Jor-el Thomas Caparas,1,0,35,34
1657577224250,MATH 20C,A02,083761,Briones; Jor-el Thomas Caparas,8,0,35,27
1657577224250,MATH 20C,A03,093476,Briones; Jor-el Thomas Caparas,0,1,36,36
1657577224250,MATH 20C,B01,083762,Bach; Quang Tran,1,0,30,29
1657577230279,MATH 20D,A01,083765,Tran; Brian Kha,5,0,30,25
1657577230279,MATH 20D,A02,083766,Tran; Brian Kha,5,0,30,25
1657577230279,MATH 20D,A03,083767,Tran; Brian Kha,5,0,30,25
1657577236304,MATH 20E,A01,083771,Ganguly; Soumya,9,0,32,23
1657577236304,MATH 20E,A02,083772,Ganguly; Soumya,6,0,32,26
1657577236304,MATH 20E,B01,083773,Ciotti; Benjamin,20,0,35,15
1657577236304,MATH 20E,B02,083774,Ciotti; Benjamin,18,0,35,17
1657577242334,MATH 103A,A01,083777,Greenfeld; Be'Eri,3,0,36,33
1657577242334,MATH 103A,A02,083778,Greenfeld; Be'Eri,5,0,36,31
1657577242334,MATH 103A,A03,093561,Greenfeld; Be'Eri,5,0,36,31
1657577242334,MATH 103A,B01,083779,Greenfeld; Be'Eri,7,0,36,29
1657577242334,MATH 103A,B02,083780,Greenfeld; Be'Eri,4,0,36,32
1657577242334,MATH 103A,B03,093562,Greenfeld; Be'Eri,3,0,36,33
1657577248361,MATH 105,A01,085443,Carter; Anne Toulson,15,0,35,20
1657577248361,MATH 105,A02,093477,Carter; Anne Toulson,20,0,35,15
1657577254389,MATH 109,A01,083213,Ganzberger; Geoffrey Michael,2,0,34,32
1657577254389,MATH 109,A02,083214,Ganzberger; Geoffrey Michael,4,0,34,30
1657577254389,MATH 109,A03,093478,Ganzberger; Geoffrey Michael,2,0,34,32
1657577254389,MATH 109,B01,083215,Ganzberger; Geoffrey Michael,1,0,32,31
1657577254389,MATH 109,B02,083216,Ganzberger; Geoffrey Michael,2,0,32,30
1657577254389,MATH 109,B03,093479,Ganzberger; Geoffrey Michael,8,0,32,24
1657577260413,MATH 142A,A01,083219,Chow; Bennett,7,0,32,25
1657577260413,MATH 142A,A02,083220,Chow; Bennett,10,0,32,22
1657577260413,MATH 142A,A03,093480,Chow; Bennett,8,0,32,24
1657577260413,MATH 142A,B03,093481,Chow; Bennett,8,0,32,24
1657577260413,MATH 142A,B04,093558,Chow; Bennett,13,0,32,19
1657577260413,MATH 142A,B05,093559,Chow; Bennett,6,0,32,26
1657577266440,MATH 193A,A01,083224,Rotar; Vladimir,8,0,34,26
1657577266440,MATH 193A,A02,083225,Rotar; Vladimir,9,0,34,25
1657577266440,MATH 193A,A03,083781,Rotar; Vladimir,5,0,34,29
1657577266440,MATH 193A,A04,083782,Rotar; Vladimir,10,0,34,24
1657577266440,MATH 193A,A05,093482,Rotar; Vladimir,10,0,34,24
1657577272463,MATH 197,001,091859,McAuley; Julian John,9999,0,9999,0
1657577272463,MATH 197,002,095566,Kedlaya; Kiran S.,9997,0,9999,2
1657577272463,MATH 197,003,095567,Xiao; Ming,9999,0,9999,0
1657577272463,MATH 197,004,095571,Perols; Johan Lars,9998,0,9999,1
1657577279527,COGS 9,A01,083615,Shannon; Kyle Michael,9,0,75,66
1657577285549,COGS 11,A01,083617,Boyle; Mary E. T.,23,0,48,25
1657577291572,COGS 13,A01,083071,Bastos; Amalia Pinkusfeld,11,0,71,60
1657577297607,COGS 14A,A01,092681,Semenuks; Arturs,5,1,100,95
1657577303631,COGS 14B,A01,083073,Cheng; Tzu-Han,6,0,63,57
1657577309653,COGS 17,A01,092677,Semenuks; Arturs,6,0,81,75
1657577315679,COGS 100,A01,083619,Allen; Michael Gordon,17,0,70,53
1657577321708,COGS 101A,A01,083621,Davis; Joshua Daniel,9,0,68,59
1657577327732,COGS 101B,A01,091572,Allen; Michael Gordon,12,0,65,53
1657577333765,COGS 101C,A01,083625,Delgado; Tania,17,0,35,18
1657577339790,COGS 107A,A01,083627,Boyle; Mary E. T.,13,0,60,47
1657577345824,COGS 118A,A01,083075,Gupta; Anjum,21,0,76,55
1657577351845,CSE 3,A50,083646,Miranda; Gregory Joseph,24,0,50,26
1657577357869,CSE 8A,A50,083650,Miranda; Gregory Joseph,17,1,56,39
1657577363895,CSE 11,A01,083080,Cao; Yingjun,6,15,40,34
1657577369923,CSE 12,A01,083652,Krause-Levy; Sophia Louisa,28,1,120,92
1657577375950,CSE 15L,A01,083654,Morris; Justin Loren,9,0,50,41
1657577375950,CSE 15L,A02,083655,Morris; Justin Loren,9,0,50,41
1657577381971,CSE 20,A01,083657,Tran; Khoa Dang,39,0,80,41
1657577387995,CSE 21,A01,095574,Bach; Quang Tran,22,0,48,26
1657577394019,CSE 30,A01,083084,Eldon; John,5,0,80,75
1657577394019,CSE 30,B01,095061,Bhaskar; Nishant,9,0,50,41
1657577400044,CSE 100,A01,083659,Cao; Yingjun,5,4,70,65
1657577406077,CSE 134B,A01,083661,Powell; Thomas Allan,22,0,100,78
1657577412103,CSE 140,A01,083663,Gungor; Onat,15,0,85,70
1657577418129,CSE 140L,A01,083088,Eldon; John,21,0,100,79
1657577424155,CSE 175,A01,083665,Kumar; Rakesh,3,0,25,22
1657577430181,CSE 190,A00,092507,Dubnov; Shlomo,8,0,20,12
1657577436209,ECE 45,A01,083139,Congero; Spencer William,6,0,75,69
1657577442236,ECE 65,A50,083695,Saad; Andrew S,12,0,30,18
1657577442236,ECE 65,A51,095125,Saad; Andrew S,24,0,26,2
1657577448271,ECE 109,A01,091882,Touri; Behrouz,19,0,70,51
1657577454299,ECE 180,A00,083140,Abi Samra; Nicholas Camill,1,0,30,29
1657577454299,ECE 180,B00,083141,Abi Samra; Nicholas Camill,0,0,30,30
1657577460326,MATH 10A,A01,083735,Patchell; Gregory David,2,0,30,28
1657577460326,MATH 10A,A02,083736,Patchell; Gregory David,20,0,30,10
1657577460326,MATH 10A,A03,083737,Patchell; Gregory David,16,0,30,14
1657577466353,MATH 10B,A01,083207,Lim; Seonhee,8,0,34,26
1657577466353,MATH 10B,A02,083208,Lim; Seonhee,9,0,35,26
1657577466353,MATH 10B,A03,093472,Lim; Seonhee,7,0,34,27
1657577466353,MATH 10B,B01,083739,Sinha; Shubham,12,0,30,18
1657577472382,MATH 18,A01,083743,Cinel; Cameron Alexander,7,0,30,23
1657577472382,MATH 18,A02,083744,Cinel; Cameron Alexander,17,0,30,13
1657577472382,MATH 18,A03,083745,Cinel; Cameron Alexander,9,0,30,21
1657577472382,MATH 18,B01,083748,Rideout; David Porter,5,0,37,32
1657577472382,MATH 18,B02,083749,Rideout; David Porter,5,0,36,31
1657577472382,MATH 18,B03,083750,Rideout; David Porter,3,0,37,34
1657577472382,MATH 18,B04,083751,Rideout; David Porter,6,0,36,30
1657577472382,MATH 18,B05,093473,Rideout; David Porter,6,0,36,30
1657577472382,MATH 18,B06,093474,Rideout; David Porter,6,0,36,30
1657577478404,MATH 20A,A01,083754,Zheng; Zequn,14,0,40,26
1657577484431,MATH 20B,A01,083756,Briones; Jor-el Thomas Caparas,4,0,36,32
1657577484431,MATH 20B,A02,083757,Briones; Jor-el Thomas Caparas,1,0,36,35
1657577484431,MATH 20B,A03,093475,Briones; Jor-el Thomas Caparas,2,0,36,34
1657577490460,MATH 20C,A01,083760,Briones; Jor-el Thomas Caparas,1,0,35,34
1657577490460,MATH 20C,A02,083761,Briones; Jor-el Thomas Caparas,8,0,35,27
1657577490460,MATH 20C,A03,093476,Briones; Jor-el Thomas Caparas,0,1,36,36
1657577490460,MATH 20C,B01,083762,Bach; Quang Tran,1,0,30,29
1657577496490,MATH 20D,A01,083765,Tran; Brian Kha,5,0,30,25
1657577496490,MATH 20D,A02,083766,Tran; Brian Kha,5,0,30,25
1657577496490,MATH 20D,A03,083767,Tran; Brian Kha,5,0,30,25
1657577502519,MATH 20E,A01,083771,Ganguly; Soumya,9,0,32,23
1657577502519,MATH 20E,A02,083772,Ganguly; Soumya,6,0,32,26
1657577502519,MATH 20E,B01,083773,Ciotti; Benjamin,20,0,35,15
1657577502519,MATH 20E,B02,083774,Ciotti; Benjamin,18,0,35,17
1657577508549,MATH 103A,A01,083777,Greenfeld; Be'Eri,3,0,36,33
1657577508549,MATH 103A,A02,083778,Greenfeld; Be'Eri,5,0,36,31
1657577508549,MATH 103A,A03,093561,Greenfeld; Be'Eri,5,0,36,31
1657577508549,MATH 103A,B01,083779,Greenfeld; Be'Eri,7,0,36,29
1657577508549,MATH 103A,B02,083780,Greenfeld; Be'Eri,4,0,36,32
1657577508549,MATH 103A,B03,093562,Greenfeld; Be'Eri,3,0,36,33
1657577514573,MATH 105,A01,085443,Carter; Anne Toulson,15,0,35,20
1657577514573,MATH 105,A02,093477,Carter; Anne Toulson,20,0,35,15
1657577520603,MATH 109,A01,083213,Ganzberger; Geoffrey Michael,2,0,34,32
1657577520603,MATH 109,A02,083214,Ganzberger; Geoffrey Michael,4,0,34,30
1657577520603,MATH 109,A03,093478,Ganzberger; Geoffrey Michael,2,0,34,32
1657577520603,MATH 109,B01,083215,Ganzberger; Geoffrey Michael,1,0,32,31
1657577520603,MATH 109,B02,083216,Ganzberger; Geoffrey Michael,2,0,32,30
1657577520603,MATH 109,B03,093479,Ganzberger; Geoffrey Michael,8,0,32,24
1657577526637,MATH 142A,A01,083219,Chow; Bennett,7,0,32,25
1657577526637,MATH 142A,A02,083220,Chow; Bennett,10,0,32,22
1657577526637,MATH 142A,A03,093480,Chow; Bennett,8,0,32,24
1657577526637,MATH 142A,B03,093481,Chow; Bennett,8,0,32,24
1657577526637,MATH 142A,B04,093558,Chow; Bennett,13,0,32,19
1657577526637,MATH 142A,B05,093559,Chow; Bennett,6,0,32,26
1657577532660,MATH 193A,A01,083224,Rotar; Vladimir,8,0,34,26
1657577532660,MATH 193A,A02,083225,Rotar; Vladimir,9,0,34,25
1657577532660,MATH 193A,A03,083781,Rotar; Vladimir,5,0,34,29
1657577532660,MATH 193A,A04,083782,Rotar; Vladimir,10,0,34,24
1657577532660,MATH 193A,A05,093482,Rotar; Vladimir,10,0,34,24
1657577538686,MATH 197,001,091859,McAuley; Julian John,9999,0,9999,0
1657577538686,MATH 197,002,095566,Kedlaya; Kiran S.,9997,0,9999,2
1657577538686,MATH 197,003,095567,Xiao; Ming,9999,0,9999,0
1657577538686,MATH 197,004,095571,Perols; Johan Lars,9998,0,9999,1
1657577545743,COGS 9,A01,083615,Shannon; Kyle Michael,9,0,75,66
1657577551768,COGS 11,A01,083617,Boyle; Mary E. T.,23,0,48,25
1657577557799,COGS 13,A01,083071,Bastos; Amalia Pinkusfeld,11,0,71,60
1657577563823,COGS 14A,A01,092681,Semenuks; Arturs,5,1,100,95
1657577569844,COGS 14B,A01,083073,Cheng; Tzu-Han,6,0,63,57
1657577575870,COGS 17,A01,092677,Semenuks; Arturs,6,0,81,75
1657577581896,COGS 100,A01,083619,Allen; Michael Gordon,17,0,70,53
1657577587922,COGS 101A,A01,083621,Davis; Joshua Daniel,9,0,68,59
1657577593947,COGS 101B,A01,091572,Allen; Michael Gordon,12,0,65,53
1657577599973,COGS 101C,A01,083625,Delgado; Tania,17,0,35,18
1657577605994,COGS 107A,A01,083627,Boyle; Mary E. T.,13,0,60,47
1657577612017,COGS 118A,A01,083075,Gupta; Anjum,21,0,76,55
1657577618062,CSE 3,A50,083646,Miranda; Gregory Joseph,24,0,50,26
1657577624092,CSE 8A,A50,083650,Miranda; Gregory Joseph,17,1,56,39
1657577630118,CSE 11,A01,083080,Cao; Yingjun,6,15,40,34
1657577636140,CSE 12,A01,083652,Krause-Levy; Sophia Louisa,28,1,120,92
1657577642163,CSE 15L,A01,083654,Morris; Justin Loren,9,0,50,41
1657577642163,CSE 15L,A02,083655,Morris; Justin Loren,9,0,50,41
1657577648196,CSE 20,A01,083657,Tran; Khoa Dang,39,0,80,41
1657577654232,CSE 21,A01,095574,Bach; Quang Tran,22,0,48,26
1657577660261,CSE 30,A01,083084,Eldon; John,5,0,80,75
1657577660261,CSE 30,B01,095061,Bhaskar; Nishant,9,0,50,41
1657577666287,CSE 100,A01,083659,Cao; Yingjun,5,4,70,65
1657577672311,CSE 134B,A01,083661,Powell; Thomas Allan,22,0,100,78
1657577678333,CSE 140,A01,083663,Gungor; Onat,15,0,85,70
1657577684355,CSE 140L,A01,083088,Eldon; John,21,0,100,79
1657577690385,CSE 175,A01,083665,Kumar; Rakesh,3,0,25,22
1657577696410,CSE 190,A00,092507,Dubnov; Shlomo,8,0,20,12
1657577702433,ECE 45,A01,083139,Congero; Spencer William,6,0,75,69
1657577708455,ECE 65,A50,083695,Saad; Andrew S,12,0,30,18
1657577708455,ECE 65,A51,095125,Saad; Andrew S,24,0,26,2
1657577714481,ECE 109,A01,091882,Touri; Behrouz,19,0,70,51
1657577720516,ECE 180,A00,083140,Abi Samra; Nicholas Camill,1,0,30,29
1657577720516,ECE 180,B00,083141,Abi Samra; Nicholas Camill,0,0,30,30
1657577726541,MATH 10A,A01,083735,Patchell; Gregory David,2,0,30,28
1657577726541,MATH 10A,A02,083736,Patchell; Gregory David,20,0,30,10
1657577726541,MATH 10A,A03,083737,Patchell; Gregory David,16,0,30,14
1657577732566,MATH 10B,A01,083207,Lim; Seonhee,8,0,34,26
1657577732566,MATH 10B,A02,083208,Lim; Seonhee,9,0,35,26
1657577732566,MATH 10B,A03,093472,Lim; Seonhee,7,0,34,27
1657577732566,MATH 10B,B01,083739,Sinha; Shubham,12,0,30,18
1657577738607,MATH 18,A01,083743,Cinel; Cameron Alexander,7,0,30,23
1657577738607,MATH 18,A02,083744,Cinel; Cameron Alexander,17,0,30,13
1657577738607,MATH 18,A03,083745,Cinel; Cameron Alexander,9,0,30,21
1657577738607,MATH 18,B01,083748,Rideout; David Porter,5,0,37,32
1657577738607,MATH 18,B02,083749,Rideout; David Porter,5,0,36,31
1657577738607,MATH 18,B03,083750,Rideout; David Porter,3,0,37,34
1657577738607,MATH 18,B04,083751,Rideout; David Porter,6,0,36,30
1657577738607,MATH 18,B05,093473,Rideout; David Porter,6,0,36,30
1657577738607,MATH 18,B06,093474,Rideout; David Porter,6,0,36,30
1657577744641,MATH 20A,A01,083754,Zheng; Zequn,14,0,40,26
1657577750671,MATH 20B,A01,083756,Briones; Jor-el Thomas Caparas,4,0,36,32
1657577750671,MATH 20B,A02,083757,Briones; Jor-el Thomas Caparas,1,0,36,35
1657577750671,MATH 20B,A03,093475,Briones; Jor-el Thomas Caparas,2,0,36,34
1657577756694,MATH 20C,A01,083760,Briones; Jor-el Thomas Caparas,1,0,35,34
1657577756694,MATH 20C,A02,083761,Briones; Jor-el Thomas Caparas,8,0,35,27
1657577756694,MATH 20C,A03,093476,Briones; Jor-el Thomas Caparas,0,1,36,36
1657577756694,MATH 20C,B01,083762,Bach; Quang Tran,1,0,30,29
1657577762806,MATH 20D,A01,083765,Tran; Brian Kha,5,0,30,25
1657577762806,MATH 20D,A02,083766,Tran; Brian Kha,5,0,30,25
1657577762806,MATH 20D,A03,083767,Tran; Brian Kha,5,0,30,25
1657577768838,MATH 20E,A01,083771,Ganguly; Soumya,9,0,32,23
1657577768838,MATH 20E,A02,083772,Ganguly; Soumya,6,0,32,26
1657577768838,MATH 20E,B01,083773,Ciotti; Benjamin,20,0,35,15
1657577768838,MATH 20E,B02,083774,Ciotti; Benjamin,18,0,35,17
1657577774871,MATH 103A,A01,083777,Greenfeld; Be'Eri,3,0,36,33
1657577774871,MATH 103A,A02,083778,Greenfeld; Be'Eri,5,0,36,31
1657577774871,MATH 103A,A03,093561,Greenfeld; Be'Eri,5,0,36,31
1657577774871,MATH 103A,B01,083779,Greenfeld; Be'Eri,7,0,36,29
1657577774871,MATH 103A,B02,083780,Greenfeld; Be'Eri,4,0,36,32
1657577774871,MATH 103A,B03,093562,Greenfeld; Be'Eri,3,0,36,33
1657577780900,MATH 105,A01,085443,Carter; Anne Toulson,15,0,35,20
1657577780900,MATH 105,A02,093477,Carter; Anne Toulson,20,0,35,15
1657577786926,MATH 109,A01,083213,Ganzberger; Geoffrey Michael,2,0,34,32
1657577786926,MATH 109,A02,083214,Ganzberger; Geoffrey Michael,4,0,34,30
1657577786926,MATH 109,A03,093478,Ganzberger; Geoffrey Michael,2,0,34,32
1657577786926,MATH 109,B01,083215,Ganzberger; Geoffrey Michael,1,0,32,31
1657577786926,MATH 109,B02,083216,Ganzberger; Geoffrey Michael,2,0,32,30
1657577786926,MATH 109,B03,093479,Ganzberger; Geoffrey Michael,8,0,32,24
1657577792954,MATH 142A,A01,083219,Chow; Bennett,7,0,32,25
1657577792954,MATH 142A,A02,083220,Chow; Bennett,10,0,32,22
1657577792954,MATH 142A,A03,093480,Chow; Bennett,8,0,32,24
1657577792954,MATH 142A,B03,093481,Chow; Bennett,8,0,32,24
1657577792954,MATH 142A,B04,093558,Chow; Bennett,13,0,32,19
1657577792954,MATH 142A,B05,093559,Chow; Bennett,6,0,32,26
1657577798985,MATH 193A,A01,083224,Rotar; Vladimir,8,0,34,26
1657577798985,MATH 193A,A02,083225,Rotar; Vladimir,9,0,34,25
1657577798985,MATH 193A,A03,083781,Rotar; Vladimir,5,0,34,29
1657577798985,MATH 193A,A04,083782,Rotar; Vladimir,10,0,34,24
1657577798985,MATH 193A,A05,093482,Rotar; Vladimir,10,0,34,24
1657577805012,MATH 197,001,091859,McAuley; Julian John,9999,0,9999,0
1657577805012,MATH 197,002,095566,Kedlaya; Kiran S.,9997,0,9999,2
1657577805012,MATH 197,003,095567,Xiao; Ming,9999,0,9999,0
1657577805012,MATH 197,004,095571,Perols; Johan Lars,9998,0,9999,1
1657577812094,COGS 9,A01,083615,Shannon; Kyle Michael,9,0,75,66
1657577818117,COGS 11,A01,083617,Boyle; Mary E. T.,23,0,48,25
1657577824150,COGS 13,A01,083071,Bastos; Amalia Pinkusfeld,11,0,71,60
1657577830180,COGS 14A,A01,092681,Semenuks; Arturs,5,1,100,95
1657577836215,COGS 14B,A01,083073,Cheng; Tzu-Han,6,0,63,57
1657577842235,COGS 17,A01,092677,Semenuks; Arturs,6,0,81,75
1657577848262,COGS 100,A01,083619,Allen; Michael Gordon,17,0,70,53
1657577854285,COGS 101A,A01,083621,Davis; Joshua Daniel,9,0,68,59
1657577860309,COGS 101B,A01,091572,Allen; Michael Gordon,12,0,65,53
1657577866335,COGS 101C,A01,083625,Delgado; Tania,17,0,35,18
1657577872362,COGS 107A,A01,083627,Boyle; Mary E. T.,13,0,60,47
1657577878393,COGS 118A,A01,083075,Gupta; Anjum,21,0,76,55
1657577884416,CSE 3,A50,083646,Miranda; Gregory Joseph,24,0,50,26
1657577890455,CSE 8A,A50,083650,Miranda; Gregory Joseph,17,1,56,39
1657577896477,CSE 11,A01,083080,Cao; Yingjun,6,15,40,34
1657577902506,CSE 12,A01,083652,Krause-Levy; Sophia Louisa,28,1,120,92
1657577908529,CSE 15L,A01,083654,Morris; Justin Loren,9,0,50,41
1657577908529,CSE 15L,A02,083655,Morris; Justin Loren,9,0,50,41
1657577914554,CSE 20,A01,083657,Tran; Khoa Dang,39,0,80,41
1657577920576,CSE 21,A01,095574,Bach; Quang Tran,22,0,48,26
1657577926600,CSE 30,A01,083084,Eldon; John,5,0,80,75
1657577926600,CSE 30,B01,095061,Bhaskar; Nishant,9,0,50,41
1657577932626,CSE 100,A01,083659,Cao; Yingjun,5,4,70,65
1657577938653,CSE 134B,A01,083661,Powell; Thomas Allan,22,0,100,78
1657577944687,CSE 140,A01,083663,Gungor; Onat,15,0,85,70
1657577950709,CSE 140L,A01,083088,Eldon; John,21,0,100,79
1657577956735,CSE 175,A01,083665,Kumar; Rakesh,3,0,25,22
1657577962760,CSE 190,A00,092507,Dubnov; Shlomo,8,0,20,12
1657577968786,ECE 45,A01,083139,Congero; Spencer William,6,0,75,69
1657577974814,ECE 65,A50,083695,Saad; Andrew S,12,0,30,18
1657577974814,ECE 65,A51,095125,Saad; Andrew S,24,0,26,2
1657577980836,ECE 109,A01,091882,Touri; Behrouz,19,0,70,51
1657577986864,ECE 180,A00,083140,Abi Samra; Nicholas Camill,1,0,30,29
1657577986864,ECE 180,B00,083141,Abi Samra; Nicholas Camill,0,0,30,30
1657577992889,MATH 10A,A01,083735,Patchell; Gregory David,2,0,30,28
1657577992889,MATH 10A,A02,083736,Patchell; Gregory David,20,0,30,10
1657577992889,MATH 10A,A03,083737,Patchell; Gregory David,16,0,30,14
1657577998914,MATH 10B,A01,083207,Lim; Seonhee,8,0,34,26
1657577998914,MATH 10B,A02,083208,Lim; Seonhee,9,0,35,26
1657577998914,MATH 10B,A03,093472,Lim; Seonhee,7,0,34,27
1657577998914,MATH 10B,B01,083739,Sinha; Shubham,12,0,30,18
1657578004946,MATH 18,A01,083743,Cinel; Cameron Alexander,7,0,30,23
1657578004946,MATH 18,A02,083744,Cinel; Cameron Alexander,17,0,30,13
1657578004946,MATH 18,A03,083745,Cinel; Cameron Alexander,9,0,30,21
1657578004946,MATH 18,B01,083748,Rideout; David Porter,5,0,37,32
1657578004946,MATH 18,B02,083749,Rideout; David Porter,5,0,36,31
1657578004946,MATH 18,B03,083750,Rideout; David Porter,3,0,37,34
1657578004946,MATH 18,B04,083751,Rideout; David Porter,6,0,36,30
1657578004946,MATH 18,B05,093473,Rideout; David Porter,6,0,36,30
1657578004946,MATH 18,B06,093474,Rideout; David Porter,6,0,36,30
1657578010969,MATH 20A,A01,083754,Zheng; Zequn,14,0,40,26
1657578017014,MATH 20B,A01,083756,Briones; Jor-el Thomas Caparas,4,0,36,32
1657578017014,MATH 20B,A02,083757,Briones; Jor-el Thomas Caparas,1,0,36,35
1657578017014,MATH 20B,A03,093475,Briones; Jor-el Thomas Caparas,2,0,36,34
1657578023040,MATH 20C,A01,083760,Briones; Jor-el Thomas Caparas,1,0,35,34
1657578023040,MATH 20C,A02,083761,Briones; Jor-el Thomas Caparas,8,0,35,27
1657578023040,MATH 20C,A03,093476,Briones; Jor-el Thomas Caparas,0,1,36,36
1657578023040,MATH 20C,B01,083762,Bach; Quang Tran,1,0,30,29
1657578029069,MATH 20D,A01,083765,Tran; Brian Kha,5,0,30,25
1657578029069,MATH 20D,A02,083766,Tran; Brian Kha,5,0,30,25
1657578029069,MATH 20D,A03,083767,Tran; Brian Kha,5,0,30,25
1657578035100,MATH 20E,A01,083771,Ganguly; Soumya,9,0,32,23
1657578035100,MATH 20E,A02,083772,Ganguly; Soumya,6,0,32,26
1657578035100,MATH 20E,B01,083773,Ciotti; Benjamin,20,0,35,15
1657578035100,MATH 20E,B02,083774,Ciotti; Benjamin,18,0,35,17
1657578041129,MATH 103A,A01,083777,Greenfeld; Be'Eri,3,0,36,33
1657578041129,MATH 103A,A02,083778,Greenfeld; Be'Eri,5,0,36,31
1657578041129,MATH 103A,A03,093561,Greenfeld; Be'Eri,5,0,36,31
1657578041129,MATH 103A,B01,083779,Greenfeld; Be'Eri,7,0,36,29
1657578041129,MATH 103A,B02,083780,Greenfeld; Be'Eri,4,0,36,32
1657578041129,MATH 103A,B03,093562,Greenfeld; Be'Eri,3,0,36,33
1657578047151,MATH 105,A01,085443,Carter; Anne Toulson,15,0,35,20
1657578047151,MATH 105,A02,093477,Carter; Anne Toulson,20,0,35,15
1657578053185,MATH 109,A01,083213,Ganzberger; Geoffrey Michael,2,0,34,32
1657578053185,MATH 109,A02,083214,Ganzberger; Geoffrey Michael,4,0,34,30
1657578053185,MATH 109,A03,093478,Ganzberger; Geoffrey Michael,2,0,34,32
1657578053185,MATH 109,B01,083215,Ganzberger; Geoffrey Michael,1,0,32,31
1657578053185,MATH 109,B02,083216,Ganzberger; Geoffrey Michael,2,0,32,30
1657578053185,MATH 109,B03,093479,Ganzberger; Geoffrey Michael,8,0,32,24
1657578059216,MATH 142A,A01,083219,Chow; Bennett,7,0,32,25
1657578059216,MATH 142A,A02,083220,Chow; Bennett,10,0,32,22
1657578059216,MATH 142A,A03,093480,Chow; Bennett,8,0,32,24
1657578059216,MATH 142A,B03,093481,Chow; Bennett,8,0,32,24
1657578059216,MATH 142A,B04,093558,Chow; Bennett,13,0,32,19
1657578059216,MATH 142A,B05,093559,Chow; Bennett,6,0,32,26
1657578065244,MATH 193A,A01,083224,Rotar; Vladimir,8,0,34,26
1657578065244,MATH 193A,A02,083225,Rotar; Vladimir,9,0,34,25
1657578065244,MATH 193A,A03,083781,Rotar; Vladimir,5,0,34,29
1657578065244,MATH 193A,A04,083782,Rotar; Vladimir,10,0,34,24
1657578065244,MATH 193A,A05,093482,Rotar; Vladimir,10,0,34,24
1657578071270,MATH 197,001,091859,McAuley; Julian John,9999,0,9999,0
1657578071270,MATH 197,002,095566,Kedlaya; Kiran S.,9997,0,9999,2
1657578071270,MATH 197,003,095567,Xiao; Ming,9999,0,9999,0
1657578071270,MATH 197,004,095571,Perols; Johan Lars,9998,0,9999,1
1657578078330,COGS 9,A01,083615,Shannon; Kyle Michael,9,0,75,66
1657578084353,COGS 11,A01,083617,Boyle; Mary E. T.,23,0,48,25
1657578090382,COGS 13,A01,083071,Bastos; Amalia Pinkusfeld,11,0,71,60
1657578096411,COGS 14A,A01,092681,Semenuks; Arturs,5,1,100,95
1657578102437,COGS 14B,A01,083073,Cheng; Tzu-Han,6,0,63,57
1657578108471,COGS 17,A01,092677,Semenuks; Arturs,6,0,81,75
1657578114498,COGS 100,A01,083619,Allen; Michael Gordon,17,0,70,53
1657578120521,COGS 101A,A01,083621,Davis; Joshua Daniel,9,0,68,59
1657578126546,COGS 101B,A01,091572,Allen; Michael Gordon,12,0,65,53
1657578132582,COGS 101C,A01,083625,Delgado; Tania,17,0,35,18
1657578138606,COGS 107A,A01,083627,Boyle; Mary E. T.,13,0,60,47
1657578144652,COGS 118A,A01,083075,Gupta; Anjum,21,0,76,55
1657578150684,CSE 3,A50,083646,Miranda; Gregory Joseph,24,0,50,26
1657578156710,CSE 8A,A50,083650,Miranda; Gregory Joseph,17,1,56,39
1657578162733,CSE 11,A01,083080,Cao; Yingjun,6,15,40,34
1657578168762,CSE 12,A01,083652,Krause-Levy; Sophia Louisa,28,1,120,92
1657578174789,CSE 15L,A01,083654,Morris; Justin Loren,9,0,50,41
1657578174789,CSE 15L,A02,083655,Morris; Justin Loren,9,0,50,41
1657578180815,CSE 20,A01,083657,Tran; Khoa Dang,39,0,80,41
1657578186842,CSE 21,A01,095574,Bach; Quang Tran,22,0,48,26
1657578192869,CSE 30,A01,083084,Eldon; John,5,0,80,75
1657578192869,CSE 30,B01,095061,Bhaskar; Nishant,9,0,50,41
1657578198890,CSE 100,A01,083659,Cao; Yingjun,5,4,70,65
1657578204917,CSE 134B,A01,083661,Powell; Thomas Allan,22,0,100,78
1657578210941,CSE 140,A01,083663,Gungor; Onat,15,0,85,70
1657578216965,CSE 140L,A01,083088,Eldon; John,21,0,100,79
1657578222992,CSE 175,A01,083665,Kumar; Rakesh,3,0,25,22
1657578229019,CSE 190,A00,092507,Dubnov; Shlomo,8,0,20,12
1657578235053,ECE 45,A01,083139,Congero; Spencer William,6,0,75,69
1657578241086,ECE 65,A50,083695,Saad; Andrew S,12,0,30,18
1657578241086,ECE 65,A51,095125,Saad; Andrew S,24,0,26,2
1657578247109,ECE 109,A01,091882,Touri; Behrouz,19,0,70,51
1657578253138,ECE 180,A00,083140,Abi Samra; Nicholas Camill,1,0,30,29
1657578253138,ECE 180,B00,083141,Abi Samra; Nicholas Camill,0,0,30,30
1657578259163,MATH 10A,A01,083735,Patchell; Gregory David,2,0,30,28
1657578259163,MATH 10A,A02,083736,Patchell; Gregory David,20,0,30,10
1657578259163,MATH 10A,A03,083737,Patchell; Gregory David,16,0,30,14
1657578265191,MATH 10B,A01,083207,Lim; Seonhee,8,0,34,26
1657578265191,MATH 10B,A02,083208,Lim; Seonhee,9,0,35,26
1657578265191,MATH 10B,A03,093472,Lim; Seonhee,7,0,34,27
1657578265191,MATH 10B,B01,083739,Sinha; Shubham,12,0,30,18
1657578271222,MATH 18,A01,083743,Cinel; Cameron Alexander,7,0,30,23
1657578271222,MATH 18,A02,083744,Cinel; Cameron Alexander,17,0,30,13
1657578271222,MATH 18,A03,083745,Cinel; Cameron Alexander,9,0,30,21
1657578271222,MATH 18,B01,083748,Rideout; David Porter,5,0,37,32
1657578271222,MATH 18,B02,083749,Rideout; David Porter,5,0,36,31
1657578271222,MATH 18,B03,083750,Rideout; David Porter,3,0,37,34
1657578271222,MATH 18,B04,083751,Rideout; David Porter,6,0,36,30
1657578271222,MATH 18,B05,093473,Rideout; David Porter,6,0,36,30
1657578271222,MATH 18,B06,093474,Rideout; David Porter,6,0,36,30
1657578277246,MATH 20A,A01,083754,Zheng; Zequn,14,0,40,26
1657578283274,MATH 20B,A01,083756,Briones; Jor-el Thomas Caparas,4,0,36,32
1657578283274,MATH 20B,A02,083757,Briones; Jor-el Thomas Caparas,1,0,36,35
1657578283274,MATH 20B,A03,093475,Briones; Jor-el Thomas Caparas,2,0,36,34
1657578289298,MATH 20C,A01,083760,Briones; Jor-el Thomas Caparas,1,0,35,34
1657578289298,MATH 20C,A02,083761,Briones; Jor-el Thomas Caparas,8,0,35,27
1657578289298,MATH 20C,A03,093476,Briones; Jor-el Thomas Caparas,0,1,36,36
1657578289298,MATH 20C,B01,083762,Bach; Quang Tran,1,0,30,29
1657578295324,MATH 20D,A01,083765,Tran; Brian Kha,5,0,30,25
1657578295324,MATH 20D,A02,083766,Tran; Brian Kha,5,0,30,25
1657578295324,MATH 20D,A03,083767,Tran; Brian Kha,5,0,30,25
1657578301358,MATH 20E,A01,083771,Ganguly; Soumya,9,0,32,23
1657578301358,MATH 20E,A02,083772,Ganguly; Soumya,6,0,32,26
1657578301358,MATH 20E,B01,083773,Ciotti; Benjamin,20,0,35,15
1657578301358,MATH 20E,B02,083774,Ciotti; Benjamin,18,0,35,17
1657578307387,MATH 103A,A01,083777,Greenfeld; Be'Eri,3,0,36,33
1657578307387,MATH 103A,A02,083778,Greenfeld; Be'Eri,5,0,36,31
1657578307387,MATH 103A,A03,093561,Greenfeld; Be'Eri,5,0,36,31
1657578307387,MATH 103A,B01,083779,Greenfeld; Be'Eri,7,0,36,29
1657578307387,MATH 103A,B02,083780,Greenfeld; Be'Eri,4,0,36,32
1657578307387,MATH 103A,B03,093562,Greenfeld; Be'Eri,3,0,36,33
1657578313411,MATH 105,A01,085443,Carter; Anne Toulson,15,0,35,20
1657578313411,MATH 105,A02,093477,Carter; Anne Toulson,20,0,35,15
1657578319434,MATH 109,A01,083213,Ganzberger; Geoffrey Michael,2,0,34,32
1657578319434,MATH 109,A02,083214,Ganzberger; Geoffrey Michael,4,0,34,30
1657578319434,MATH 109,A03,093478,Ganzberger; Geoffrey Michael,2,0,34,32
1657578319434,MATH 109,B01,083215,Ganzberger; Geoffrey Michael,1,0,32,31
1657578319434,MATH 109,B02,083216,Ganzberger; Geoffrey Michael,2,0,32,30
1657578319434,MATH 109,B03,093479,Ganzberger; Geoffrey Michael,8,0,32,24
1657578325466,MATH 142A,A01,083219,Chow; Bennett,7,0,32,25
1657578325466,MATH 142A,A02,083220,Chow; Bennett,10,0,32,22
1657578325466,MATH 142A,A03,093480,Chow; Bennett,8,0,32,24
1657578325466,MATH 142A,B03,093481,Chow; Bennett,8,0,32,24
1657578325466,MATH 142A,B04,093558,Chow; Bennett,13,0,32,19
1657578325466,MATH 142A,B05,093559,Chow; Bennett,6,0,32,26
1657578331490,MATH 193A,A01,083224,Rotar; Vladimir,8,0,34,26
1657578331490,MATH 193A,A02,083225,Rotar; Vladimir,9,0,34,25
1657578331490,MATH 193A,A03,083781,Rotar; Vladimir,5,0,34,29
1657578331490,MATH 193A,A04,083782,Rotar; Vladimir,10,0,34,24
1657578331490,MATH 193A,A05,093482,Rotar; Vladimir,10,0,34,24
1657578337512,MATH 197,001,091859,McAuley; Julian John,9999,0,9999,0
1657578337512,MATH 197,002,095566,Kedlaya; Kiran S.,9997,0,9999,2
1657578337512,MATH 197,003,095567,Xiao; Ming,9999,0,9999,0
1657578337512,MATH 197,004,095571,Perols; Johan Lars,9998,0,9999,1
1657578344570,COGS 9,A01,083615,Shannon; Kyle Michael,9,0,75,66
1657578350596,COGS 11,A01,083617,Boyle; Mary E. T.,23,0,48,25
1657578356695,COGS 13,A01,083071,Bastos; Amalia Pinkusfeld,11,0,71,60
1657578362720,COGS 14A,A01,092681,Semenuks; Arturs,5,1,100,95
1657578368742,COGS 14B,A01,083073,Cheng; Tzu-Han,6,0,63,57
1657578374770,COGS 17,A01,092677,Semenuks; Arturs,6,0,81,75
1657578380795,COGS 100,A01,083619,Allen; Michael Gordon,17,0,70,53
1657578386822,COGS 101A,A01,083621,Davis; Joshua Daniel,9,0,68,59
1657578392849,COGS 101B,A01,091572,Allen; Michael Gordon,12,0,65,53
1657578398875,COGS 101C,A01,083625,Delgado; Tania,17,0,35,18
1657578404901,COGS 107A,A01,083627,Boyle; Mary E. T.,13,0,60,47
1657578410923,COGS 118A,A01,083075,Gupta; Anjum,21,0,76,55
1657578416954,CSE 3,A50,083646,Miranda; Gregory Joseph,24,0,50,26
1657578422977,CSE 8A,A50,083650,Miranda; Gregory Joseph,17,1,56,39
1657578428999,CSE 11,A01,083080,Cao; Yingjun,6,15,40,34
1657578435020,CSE 12,A01,083652,Krause-Levy; Sophia Louisa,28,1,120,92
1657578441047,CSE 15L,A01,083654,Morris; Justin Loren,9,0,50,41
1657578441047,CSE 15L,A02,083655,Morris; Justin Loren,9,0,50,41
1657578447078,CSE 20,A01,083657,Tran; Khoa Dang,39,0,80,41
1657578453108,CSE 21,A01,095574,Bach; Quang Tran,22,0,48,26
1657578459132,CSE 30,A01,083084,Eldon; John,5,0,80,75
1657578459132,CSE 30,B01,095061,Bhaskar; Nishant,9,0,50,41
1657578465167,CSE 100,A01,083659,Cao; Yingjun,5,4,70,65
1657578471198,CSE 134B,A01,083661,Powell; Thomas Allan,22,0,100,78
1657578477228,CSE 140,A01,083663,Gungor; Onat,15,0,85,70
1657578483253,CSE 140L,A01,083088,Eldon; John,21,0,100,79
1657578489289,CSE 175,A01,083665,Kumar; Rakesh,3,0,25,22
1657578495318,CSE 190,A00,092507,Dubnov; Shlomo,8,0,20,12
1657578501342,ECE 45,A01,083139,Congero; Spencer William,6,0,75,69
1657578507373,ECE 65,A50,083695,Saad; Andrew S,12,0,30,18
1657578507373,ECE 65,A51,095125,Saad; Andrew S,24,0,26,2
1657578513398,ECE 109,A01,091882,Touri; Behrouz,19,0,70,51
1657578519424,ECE 180,A00,083140,Abi Samra; Nicholas Camill,1,0,30,29
1657578519424,ECE 180,B00,083141,Abi Samra; Nicholas Camill,0,0,30,30
1657578525446,MATH 10A,A01,083735,Patchell; Gregory David,2,0,30,28
1657578525446,MATH 10A,A02,083736,Patchell; Gregory David,20,0,30,10
1657578525446,MATH 10A,A03,083737,Patchell; Gregory David,16,0,30,14
1657578531480,MATH 10B,A01,083207,Lim; Seonhee,8,0,34,26
1657578531480,MATH 10B,A02,083208,Lim; Seonhee,9,0,35,26
1657578531480,MATH 10B,A03,093472,Lim; Seonhee,7,0,34,27
1657578531480,MATH 10B,B01,083739,Sinha; Shubham,12,0,30,18
1657578537504,MATH 18,A01,083743,Cinel; Cameron Alexander,7,0,30,23
1657578537504,MATH 18,A02,083744,Cinel; Cameron Alexander,17,0,30,13
1657578537504,MATH 18,A03,083745,Cinel; Cameron Alexander,9,0,30,21
1657578537504,MATH 18,B01,083748,Rideout; David Porter,5,0,37,32
1657578537504,MATH 18,B02,083749,Rideout; David Porter,5,0,36,31
1657578537504,MATH 18,B03,083750,Rideout; David Porter,3,0,37,34
1657578537504,MATH 18,B04,083751,Rideout; David Porter,6,0,36,30
1657578537504,MATH 18,B05,093473,Rideout; David Porter,6,0,36,30
1657578537504,MATH 18,B06,093474,Rideout; David Porter,6,0,36,30
1657578543531,MATH 20A,A01,083754,Zheng; Zequn,14,0,40,26
1657578549559,MATH 20B,A01,083756,Briones; Jor-el Thomas Caparas,4,0,36,32
1657578549559,MATH 20B,A02,083757,Briones; Jor-el Thomas Caparas,1,0,36,35
1657578549559,MATH 20B,A03,093475,Briones; Jor-el Thomas Caparas,2,0,36,34
1657578555582,MATH 20C,A01,083760,Briones; Jor-el Thomas Caparas,1,0,35,34
1657578555582,MATH 20C,A02,083761,Briones; Jor-el Thomas Caparas,8,0,35,27
1657578555582,MATH 20C,A03,093476,Briones; Jor-el Thomas Caparas,0,1,36,36
1657578555582,MATH 20C,B01,083762,Bach; Quang Tran,1,0,30,29
1657578561607,MATH 20D,A01,083765,Tran; Brian Kha,5,0,30,25
1657578561607,MATH 20D,A02,083766,Tran; Brian Kha,5,0,30,25
1657578561607,MATH 20D,A03,083767,Tran; Brian Kha,5,0,30,25
1657578567632,MATH 20E,A01,083771,Ganguly; Soumya,9,0,32,23
1657578567632,MATH 20E,A02,083772,Ganguly; Soumya,6,0,32,26
1657578567632,MATH 20E,B01,083773,Ciotti; Benjamin,20,0,35,15
1657578567632,MATH 20E,B02,083774,Ciotti; Benjamin,18,0,35,17
1657578573663,MATH 103A,A01,083777,Greenfeld; Be'Eri,3,0,36,33
1657578573663,MATH 103A,A02,083778,Greenfeld; Be'Eri,5,0,36,31
1657578573663,MATH 103A,A03,093561,Greenfeld; Be'Eri,5,0,36,31
1657578573663,MATH 103A,B01,083779,Greenfeld; Be'Eri,7,0,36,29
1657578573663,MATH 103A,B02,083780,Greenfeld; Be'Eri,4,0,36,32
1657578573663,MATH 103A,B03,093562,Greenfeld; Be'Eri,3,0,36,33
1657578579687,MATH 105,A01,085443,Carter; Anne Toulson,15,0,35,20
1657578579687,MATH 105,A02,093477,Carter; Anne Toulson,20,0,35,15
1657578585712,MATH 109,A01,083213,Ganzberger; Geoffrey Michael,2,0,34,32
1657578585712,MATH 109,A02,083214,Ganzberger; Geoffrey Michael,4,0,34,30
1657578585712,MATH 109,A03,093478,Ganzberger; Geoffrey Michael,2,0,34,32
1657578585712,MATH 109,B01,083215,Ganzberger; Geoffrey Michael,1,0,32,31
1657578585712,MATH 109,B02,083216,Ganzberger; Geoffrey Michael,2,0,32,30
1657578585712,MATH 109,B03,093479,Ganzberger; Geoffrey Michael,8,0,32,24
1657578591742,MATH 142A,A01,083219,Chow; Bennett,7,0,32,25
1657578591742,MATH 142A,A02,083220,Chow; Bennett,10,0,32,22
1657578591742,MATH 142A,A03,093480,Chow; Bennett,8,0,32,24
1657578591742,MATH 142A,B03,093481,Chow; Bennett,8,0,32,24
1657578591742,MATH 142A,B04,093558,Chow; Bennett,13,0,32,19
1657578591742,MATH 142A,B05,093559,Chow; Bennett,6,0,32,26
1657578597771,MATH 193A,A01,083224,Rotar; Vladimir,8,0,34,26
1657578597771,MATH 193A,A02,083225,Rotar; Vladimir,9,0,34,25
1657578597771,MATH 193A,A03,083781,Rotar; Vladimir,5,0,34,29
1657578597771,MATH 193A,A04,083782,Rotar; Vladimir,10,0,34,24
1657578597771,MATH 193A,A05,093482,Rotar; Vladimir,10,0,34,24
1657578603805,MATH 197,001,091859,McAuley; Julian John,9999,0,9999,0
1657578603805,MATH 197,002,095566,Kedlaya; Kiran S.,9997,0,9999,2
1657578603805,MATH 197,003,095567,Xiao; Ming,9999,0,9999,0
1657578603805,MATH 197,004,095571,Perols; Johan Lars,9998,0,9999,1
1657578610874,COGS 9,A01,083615,Shannon; Kyle Michael,9,0,75,66
1657578616902,COGS 11,A01,083617,Boyle; Mary E. T.,23,0,48,25
1657578622924,COGS 13,A01,083071,Bastos; Amalia Pinkusfeld,11,0,71,60
1657578628951,COGS 14A,A01,092681,Semenuks; Arturs,5,1,100,95
1657578634975,COGS 14B,A01,083073,Cheng; Tzu-Han,6,0,63,57
1657578640998,COGS 17,A01,092677,Semenuks; Arturs,6,0,81,75
1657578647031,COGS 100,A01,083619,Allen; Michael Gordon,17,0,70,53
1657578653054,COGS 101A,A01,083621,Davis; Joshua Daniel,9,0,68,59
1657578659084,COGS 101B,A01,091572,Allen; Michael Gordon,12,0,65,53
1657578665112,COGS 101C,A01,083625,Delgado; Tania,17,0,35,18
1657578671153,COGS 107A,A01,083627,Boyle; Mary E. T.,13,0,60,47
1657578677214,COGS 118A,A01,083075,Gupta; Anjum,21,0,76,55
1657578683241,CSE 3,A50,083646,Miranda; Gregory Joseph,24,0,50,26
1657578689264,CSE 8A,A50,083650,Miranda; Gregory Joseph,17,1,56,39
1657578695288,CSE 11,A01,083080,Cao; Yingjun,6,15,40,34
1657578701310,CSE 12,A01,083652,Krause-Levy; Sophia Louisa,28,1,120,92
1657578707333,CSE 15L,A01,083654,Morris; Justin Loren,9,0,50,41
1657578707333,CSE 15L,A02,083655,Morris; Justin Loren,9,0,50,41
1657578713357,CSE 20,A01,083657,Tran; Khoa Dang,39,0,80,41
1657578719380,CSE 21,A01,095574,Bach; Quang Tran,22,0,48,26
1657578725405,CSE 30,A01,083084,Eldon; John,5,0,80,75
1657578725405,CSE 30,B01,095061,Bhaskar; Nishant,9,0,50,41
1657578731441,CSE 100,A01,083659,Cao; Yingjun,5,4,70,65
1657578737464,CSE 134B,A01,083661,Powell; Thomas Allan,22,0,100,78
1657578743495,CSE 140,A01,083663,Gungor; Onat,15,0,85,70
1657578749521,CSE 140L,A01,083088,Eldon; John,21,0,100,79
1657578755546,CSE 175,A01,083665,Kumar; Rakesh,3,0,25,22
1657578761570,CSE 190,A00,092507,Dubnov; Shlomo,8,0,20,12
1657578767596,ECE 45,A01,083139,Congero; Spencer William,6,0,75,69
1657578773622,ECE 65,A50,083695,Saad; Andrew S,12,0,30,18
1657578773622,ECE 65,A51,095125,Saad; Andrew S,24,0,26,2
1657578779645,ECE 109,A01,091882,Touri; Behrouz,19,0,70,51
1657578785672,ECE 180,A00,083140,Abi Samra; Nicholas Camill,1,0,30,29
1657578785672,ECE 180,B00,083141,Abi Samra; Nicholas Camill,0,0,30,30
1657578791697,MATH 10A,A01,083735,Patchell; Gregory David,2,0,30,28
1657578791697,MATH 10A,A02,083736,Patchell; Gregory David,20,0,30,10
1657578791697,MATH 10A,A03,083737,Patchell; Gregory David,16,0,30,14
1657578797721,MATH 10B,A01,083207,Lim; Seonhee,8,0,34,26
1657578797721,MATH 10B,A02,083208,Lim; Seonhee,9,0,35,26
1657578797721,MATH 10B,A03,093472,Lim; Seonhee,7,0,34,27
1657578797721,MATH 10B,B01,083739,Sinha; Shubham,12,0,30,18
1657578803752,MATH 18,A01,083743,Cinel; Cameron Alexander,7,0,30,23
1657578803752,MATH 18,A02,083744,Cinel; Cameron Alexander,17,0,30,13
1657578803752,MATH 18,A03,083745,Cinel; Cameron Alexander,9,0,30,21
1657578803752,MATH 18,B01,083748,Rideout; David Porter,5,0,37,32
1657578803752,MATH 18,B02,083749,Rideout; David Porter,5,0,36,31
1657578803752,MATH 18,B03,083750,Rideout; David Porter,3,0,37,34
1657578803752,MATH 18,B04,083751,Rideout; David Porter,6,0,36,30
1657578803752,MATH 18,B05,093473,Rideout; David Porter,6,0,36,30
1657578803752,MATH 18,B06,093474,Rideout; David Porter,6,0,36,30
1657578809780,MATH 20A,A01,083754,Zheng; Zequn,14,0,40,26
1657578815819,MATH 20B,A01,083756,Briones; Jor-el Thomas Caparas,4,0,36,32
1657578815819,MATH 20B,A02,083757,Briones; Jor-el Thomas Caparas,1,0,36,35
1657578815819,MATH 20B,A03,093475,Briones; Jor-el Thomas Caparas,2,0,36,34
1657578821854,MATH 20C,A01,083760,Briones; Jor-el Thomas Caparas,1,0,35,34
1657578821854,MATH 20C,A02,083761,Briones; Jor-el Thomas Caparas,8,0,35,27
1657578821854,MATH 20C,A03,093476,Briones; Jor-el Thomas Caparas,0,1,36,36
1657578821854,MATH 20C,B01,083762,Bach; Quang Tran,1,0,30,29
1657578827878,MATH 20D,A01,083765,Tran; Brian Kha,5,0,30,25
1657578827878,MATH 20D,A02,083766,Tran; Brian Kha,5,0,30,25
1657578827878,MATH 20D,A03,083767,Tran; Brian Kha,5,0,30,25
1657578833905,MATH 20E,A01,083771,Ganguly; Soumya,9,0,32,23
1657578833905,MATH 20E,A02,083772,Ganguly; Soumya,6,0,32,26
1657578833905,MATH 20E,B01,083773,Ciotti; Benjamin,20,0,35,15
1657578833905,MATH 20E,B02,083774,Ciotti; Benjamin,18,0,35,17
1657578839929,MATH 103A,A01,083777,Greenfeld; Be'Eri,3,0,36,33
1657578839929,MATH 103A,A02,083778,Greenfeld; Be'Eri,5,0,36,31
1657578839929,MATH 103A,A03,093561,Greenfeld; Be'Eri,5,0,36,31
1657578839929,MATH 103A,B01,083779,Greenfeld; Be'Eri,7,0,36,29
1657578839929,MATH 103A,B02,083780,Greenfeld; Be'Eri,4,0,36,32
1657578839929,MATH 103A,B03,093562,Greenfeld; Be'Eri,3,0,36,33
1657578845952,MATH 105,A01,085443,Carter; Anne Toulson,15,0,35,20
1657578845952,MATH 105,A02,093477,Carter; Anne Toulson,20,0,35,15
1657578851975,MATH 109,A01,083213,Ganzberger; Geoffrey Michael,2,0,34,32
1657578851975,MATH 109,A02,083214,Ganzberger; Geoffrey Michael,4,0,34,30
1657578851975,MATH 109,A03,093478,Ganzberger; Geoffrey Michael,2,0,34,32
1657578851975,MATH 109,B01,083215,Ganzberger; Geoffrey Michael,1,0,32,31
1657578851975,MATH 109,B02,083216,Ganzberger; Geoffrey Michael,2,0,32,30
1657578851975,MATH 109,B03,093479,Ganzberger; Geoffrey Michael,8,0,32,24
1657578858011,MATH 142A,A01,083219,Chow; Bennett,7,0,32,25
1657578858011,MATH 142A,A02,083220,Chow; Bennett,10,0,32,22
1657578858011,MATH 142A,A03,093480,Chow; Bennett,8,0,32,24
1657578858011,MATH 142A,B03,093481,Chow; Bennett,8,0,32,24
1657578858011,MATH 142A,B04,093558,Chow; Bennett,13,0,32,19
1657578858011,MATH 142A,B05,093559,Chow; Bennett,6,0,32,26
1657578864034,MATH 193A,A01,083224,Rotar; Vladimir,8,0,34,26
1657578864034,MATH 193A,A02,083225,Rotar; Vladimir,9,0,34,25
1657578864034,MATH 193A,A03,083781,Rotar; Vladimir,5,0,34,29
1657578864034,MATH 193A,A04,083782,Rotar; Vladimir,10,0,34,24
1657578864034,MATH 193A,A05,093482,Rotar; Vladimir,10,0,34,24
1657578870073,MATH 197,001,091859,McAuley; Julian John,9999,0,9999,0
1657578870073,MATH 197,002,095566,Kedlaya; Kiran S.,9997,0,9999,2
1657578870073,MATH 197,003,095567,Xiao; Ming,9999,0,9999,0
1657578870073,MATH 197,004,095571,Perols; Johan Lars,9998,0,9999,1
1657578877130,COGS 9,A01,083615,Shannon; Kyle Michael,9,0,75,66
1657578883152,COGS 11,A01,083617,Boyle; Mary E. T.,23,0,48,25
1657578889174,COGS 13,A01,083071,Bastos; Amalia Pinkusfeld,11,0,71,60
1657578895202,COGS 14A,A01,092681,Semenuks; Arturs,5,1,100,95
1657578901230,COGS 14B,A01,083073,Cheng; Tzu-Han,6,0,63,57
1657578907254,COGS 17,A01,092677,Semenuks; Arturs,6,0,81,75
1657578913277,COGS 100,A01,083619,Allen; Michael Gordon,17,0,70,53
1657578919303,COGS 101A,A01,083621,Davis; Joshua Daniel,9,0,68,59
1657578925327,COGS 101B,A01,091572,Allen; Michael Gordon,12,0,65,53
1657578931363,COGS 101C,A01,083625,Delgado; Tania,17,0,35,18
1657578937386,COGS 107A,A01,083627,Boyle; Mary E. T.,13,0,60,47
1657578943411,COGS 118A,A01,083075,Gupta; Anjum,21,0,76,55
1657578949434,CSE 3,A50,083646,Miranda; Gregory Joseph,24,0,50,26
1657578955543,CSE 8A,A50,083650,Miranda; Gregory Joseph,17,1,56,39
1657578961570,CSE 11,A01,083080,Cao; Yingjun,6,15,40,34
1657578967601,CSE 12,A01,083652,Krause-Levy; Sophia Louisa,28,1,120,92
1657578973638,CSE 15L,A01,083654,Morris; Justin Loren,9,0,50,41
1657578973638,CSE 15L,A02,083655,Morris; Justin Loren,9,0,50,41
1657578979673,CSE 20,A01,083657,Tran; Khoa Dang,39,0,80,41
1657578985696,CSE 21,A01,095574,Bach; Quang Tran,22,0,48,26
1657578991723,CSE 30,A01,083084,Eldon; John,5,0,80,75
1657578991723,CSE 30,B01,095061,Bhaskar; Nishant,9,0,50,41
1657578997749,CSE 100,A01,083659,Cao; Yingjun,5,4,70,65
1657579003772,CSE 134B,A01,083661,Powell; Thomas Allan,22,0,100,78
1657579009795,CSE 140,A01,083663,Gungor; Onat,15,0,85,70
1657579015831,CSE 140L,A01,083088,Eldon; John,21,0,100,79
1657579021861,CSE 175,A01,083665,Kumar; Rakesh,3,0,25,22
1657579027886,CSE 190,A00,092507,Dubnov; Shlomo,8,0,20,12
1657579033916,ECE 45,A01,083139,Congero; Spencer William,6,0,75,69
1657579039938,ECE 65,A50,083695,Saad; Andrew S,12,0,30,18
1657579039938,ECE 65,A51,095125,Saad; Andrew S,24,0,26,2
1657579045961,ECE 109,A01,091882,Touri; Behrouz,19,0,70,51
1657579051996,ECE 180,A00,083140,Abi Samra; Nicholas Camill,1,0,30,29
1657579051996,ECE 180,B00,083141,Abi Samra; Nicholas Camill,0,0,30,30
1657579058023,MATH 10A,A01,083735,Patchell; Gregory David,2,0,30,28
1657579058023,MATH 10A,A02,083736,Patchell; Gregory David,20,0,30,10
1657579058023,MATH 10A,A03,083737,Patchell; Gregory David,16,0,30,14
1657579064056,MATH 10B,A01,083207,Lim; Seonhee,8,0,34,26
1657579064056,MATH 10B,A02,083208,Lim; Seonhee,9,0,35,26
1657579064056,MATH 10B,A03,093472,Lim; Seonhee,7,0,34,27
1657579064056,MATH 10B,B01,083739,Sinha; Shubham,12,0,30,18
1657579070080,MATH 18,A01,083743,Cinel; Cameron Alexander,7,0,30,23
1657579070080,MATH 18,A02,083744,Cinel; Cameron Alexander,17,0,30,13
1657579070080,MATH 18,A03,083745,Cinel; Cameron Alexander,9,0,30,21
1657579070080,MATH 18,B01,083748,Rideout; David Porter,5,0,37,32
1657579070080,MATH 18,B02,083749,Rideout; David Porter,5,0,36,31
1657579070080,MATH 18,B03,083750,Rideout; David Porter,3,0,37,34
1657579070080,MATH 18,B04,083751,Rideout; David Porter,6,0,36,30
1657579070080,MATH 18,B05,093473,Rideout; David Porter,6,0,36,30
1657579070080,MATH 18,B06,093474,Rideout; David Porter,6,0,36,30
1657579076107,MATH 20A,A01,083754,Zheng; Zequn,14,0,40,26
1657579082134,MATH 20B,A01,083756,Briones; Jor-el Thomas Caparas,4,0,36,32
1657579082134,MATH 20B,A02,083757,Briones; Jor-el Thomas Caparas,1,0,36,35
1657579082134,MATH 20B,A03,093475,Briones; Jor-el Thomas Caparas,2,0,36,34
1657579088163,MATH 20C,A01,083760,Briones; Jor-el Thomas Caparas,1,0,35,34
1657579088163,MATH 20C,A02,083761,Briones; Jor-el Thomas Caparas,8,0,35,27
1657579088163,MATH 20C,A03,093476,Briones; Jor-el Thomas Caparas,0,1,36,36
1657579088163,MATH 20C,B01,083762,Bach; Quang Tran,1,0,30,29
1657579094190,MATH 20D,A01,083765,Tran; Brian Kha,5,0,30,25
1657579094190,MATH 20D,A02,083766,Tran; Brian Kha,5,0,30,25
1657579094190,MATH 20D,A03,083767,Tran; Brian Kha,5,0,30,25
1657579100213,MATH 20E,A01,083771,Ganguly; Soumya,9,0,32,23
1657579100213,MATH 20E,A02,083772,Ganguly; Soumya,6,0,32,26
1657579100213,MATH 20E,B01,083773,Ciotti; Benjamin,20,0,35,15
1657579100213,MATH 20E,B02,083774,Ciotti; Benjamin,18,0,35,17
1657579106250,MATH 103A,A01,083777,Greenfeld; Be'Eri,3,0,36,33
1657579106250,MATH 103A,A02,083778,Greenfeld; Be'Eri,5,0,36,31
1657579106250,MATH 103A,A03,093561,Greenfeld; Be'Eri,5,0,36,31
1657579106250,MATH 103A,B01,083779,Greenfeld; Be'Eri,7,0,36,29
1657579106250,MATH 103A,B02,083780,Greenfeld; Be'Eri,4,0,36,32
1657579106250,MATH 103A,B03,093562,Greenfeld; Be'Eri,3,0,36,33
1657579112273,MATH 105,A01,085443,Carter; Anne Toulson,15,0,35,20
1657579112273,MATH 105,A02,093477,Carter; Anne Toulson,20,0,35,15
1657579118294,MATH 109,A01,083213,Ganzberger; Geoffrey Michael,2,0,34,32
1657579118294,MATH 109,A02,083214,Ganzberger; Geoffrey Michael,4,0,34,30
1657579118294,MATH 109,A03,093478,Ganzberger; Geoffrey Michael,2,0,34,32
1657579118294,MATH 109,B01,083215,Ganzberger; Geoffrey Michael,1,0,32,31
1657579118294,MATH 109,B02,083216,Ganzberger; Geoffrey Michael,2,0,32,30
1657579118294,MATH 109,B03,093479,Ganzberger; Geoffrey Michael,8,0,32,24
1657579124324,MATH 142A,A01,083219,Chow; Bennett,7,0,32,25
1657579124324,MATH 142A,A02,083220,Chow; Bennett,10,0,32,22
1657579124324,MATH 142A,A03,093480,Chow; Bennett,8,0,32,24
1657579124324,MATH 142A,B03,093481,Chow; Bennett,8,0,32,24
1657579124324,MATH 142A,B04,093558,Chow; Bennett,13,0,32,19
1657579124324,MATH 142A,B05,093559,Chow; Bennett,6,0,32,26
1657579130357,MATH 193A,A01,083224,Rotar; Vladimir,8,0,34,26
1657579130357,MATH 193A,A02,083225,Rotar; Vladimir,9,0,34,25
1657579130357,MATH 193A,A03,083781,Rotar; Vladimir,5,0,34,29
1657579130357,MATH 193A,A04,083782,Rotar; Vladimir,10,0,34,24
1657579130357,MATH 193A,A05,093482,Rotar; Vladimir,10,0,34,24
1657579136385,MATH 197,001,091859,McAuley; Julian John,9999,0,9999,0
1657579136385,MATH 197,002,095566,Kedlaya; Kiran S.,9997,0,9999,2
1657579136385,MATH 197,003,095567,Xiao; Ming,9999,0,9999,0
1657579136385,MATH 197,004,095571,Perols; Johan Lars,9998,0,9999,1
1657579143440,COGS 9,A01,083615,Shannon; Kyle Michael,9,0,75,66
1657579149467,COGS 11,A01,083617,Boyle; Mary E. T.,23,0,48,25
1657579155490,COGS 13,A01,083071,Bastos; Amalia Pinkusfeld,11,0,71,60
1657579161516,COGS 14A,A01,092681,Semenuks; Arturs,5,1,100,95
1657579167540,COGS 14B,A01,083073,Cheng; Tzu-Han,6,0,63,57
1657579173571,COGS 17,A01,092677,Semenuks; Arturs,6,0,81,75
1657579179596,COGS 100,A01,083619,Allen; Michael Gordon,17,0,70,53
1657579185621,COGS 101A,A01,083621,Davis; Joshua Daniel,9,0,68,59
1657579191655,COGS 101B,A01,091572,Allen; Michael Gordon,12,0,65,53
1657579197687,COGS 101C,A01,083625,Delgado; Tania,17,0,35,18
1657579203722,COGS 107A,A01,083627,Boyle; Mary E. T.,13,0,60,47
1657579209749,COGS 118A,A01,083075,Gupta; Anjum,21,0,76,55
1657579215772,CSE 3,A50,083646,Miranda; Gregory Joseph,24,0,50,26
1657579221795,CSE 8A,A50,083650,Miranda; Gregory Joseph,17,1,56,39
1657579227817,CSE 11,A01,083080,Cao; Yingjun,6,15,40,34
1657579233839,CSE 12,A01,083652,Krause-Levy; Sophia Louisa,28,1,120,92
1657579239862,CSE 15L,A01,083654,Morris; Justin Loren,9,0,50,41
1657579239862,CSE 15L,A02,083655,Morris; Justin Loren,9,0,50,41
1657579245890,CSE 20,A01,083657,Tran; Khoa Dang,39,0,80,41
1657579251914,CSE 21,A01,095574,Bach; Quang Tran,22,0,48,26
1657579257942,CSE 30,A01,083084,Eldon; John,5,0,80,75
1657579257942,CSE 30,B01,095061,Bhaskar; Nishant,9,0,50,41
1657579263968,CSE 100,A01,083659,Cao; Yingjun,5,4,70,65
1657579269989,CSE 134B,A01,083661,Powell; Thomas Allan,22,0,100,78
1657579276019,CSE 140,A01,083663,Gungor; Onat,15,0,85,70
1657579282047,CSE 140L,A01,083088,Eldon; John,21,0,100,79
1657579288069,CSE 175,A01,083665,Kumar; Rakesh,3,0,25,22
1657579294093,CSE 190,A00,092507,Dubnov; Shlomo,8,0,20,12
1657579300121,ECE 45,A01,083139,Congero; Spencer William,6,0,75,69
1657579306146,ECE 65,A50,083695,Saad; Andrew S,12,0,30,18
1657579306146,ECE 65,A51,095125,Saad; Andrew S,24,0,26,2
1657579312169,ECE 109,A01,091882,Touri; Behrouz,19,0,70,51
1657579318197,ECE 180,A00,083140,Abi Samra; Nicholas Camill,1,0,30,29
1657579318197,ECE 180,B00,083141,Abi Samra; Nicholas Camill,0,0,30,30
1657579324224,MATH 10A,A01,083735,Patchell; Gregory David,2,0,30,28
1657579324224,MATH 10A,A02,083736,Patchell; Gregory David,20,0,30,10
1657579324224,MATH 10A,A03,083737,Patchell; Gregory David,16,0,30,14
1657579330252,MATH 10B,A01,083207,Lim; Seonhee,8,0,34,26
1657579330252,MATH 10B,A02,083208,Lim; Seonhee,9,0,35,26
1657579330252,MATH 10B,A03,093472,Lim; Seonhee,7,0,34,27
1657579330252,MATH 10B,B01,083739,Sinha; Shubham,12,0,30,18
1657579336281,MATH 18,A01,083743,Cinel; Cameron Alexander,7,0,30,23
1657579336281,MATH 18,A02,083744,Cinel; Cameron Alexander,17,0,30,13
1657579336281,MATH 18,A03,083745,Cinel; Cameron Alexander,9,0,30,21
1657579336281,MATH 18,B01,083748,Rideout; David Porter,5,0,37,32
1657579336281,MATH 18,B02,083749,Rideout; David Porter,5,0,36,31
1657579336281,MATH 18,B03,083750,Rideout; David Porter,3,0,37,34
1657579336281,MATH 18,B04,083751,Rideout; David Porter,6,0,36,30
1657579336281,MATH 18,B05,093473,Rideout; David Porter,6,0,36,30
1657579336281,MATH 18,B06,093474,Rideout; David Porter,6,0,36,30
1657579342305,MATH 20A,A01,083754,Zheng; Zequn,14,0,40,26
1657579348333,MATH 20B,A01,083756,Briones; Jor-el Thomas Caparas,4,0,36,32
1657579348333,MATH 20B,A02,083757,Briones; Jor-el Thomas Caparas,1,0,36,35
1657579348333,MATH 20B,A03,093475,Briones; Jor-el Thomas Caparas,2,0,36,34
1657579354358,MATH 20C,A01,083760,Briones; Jor-el Thomas Caparas,1,0,35,34
1657579354358,MATH 20C,A02,083761,Briones; Jor-el Thomas Caparas,8,0,35,27
1657579354358,MATH 20C,A03,093476,Briones; Jor-el Thomas Caparas,0,1,36,36
1657579354358,MATH 20C,B01,083762,Bach; Quang Tran,1,0,30,29
1657579360386,MATH 20D,A01,083765,Tran; Brian Kha,5,0,30,25
1657579360386,MATH 20D,A02,083766,Tran; Brian Kha,5,0,30,25
1657579360386,MATH 20D,A03,083767,Tran; Brian Kha,5,0,30,25
1657579366411,MATH 20E,A01,083771,Ganguly; Soumya,9,0,32,23
1657579366411,MATH 20E,A02,083772,Ganguly; Soumya,6,0,32,26
1657579366411,MATH 20E,B01,083773,Ciotti; Benjamin,20,0,35,15
1657579366411,MATH 20E,B02,083774,Ciotti; Benjamin,18,0,35,17
1657579372440,MATH 103A,A01,083777,Greenfeld; Be'Eri,3,0,36,33
1657579372440,MATH 103A,A02,083778,Greenfeld; Be'Eri,5,0,36,31
1657579372440,MATH 103A,A03,093561,Greenfeld; Be'Eri,5,0,36,31
1657579372440,MATH 103A,B01,083779,Greenfeld; Be'Eri,7,0,36,29
1657579372440,MATH 103A,B02,083780,Greenfeld; Be'Eri,4,0,36,32
1657579372440,MATH 103A,B03,093562,Greenfeld; Be'Eri,3,0,36,33
1657579378463,MATH 105,A01,085443,Carter; Anne Toulson,15,0,35,20
1657579378463,MATH 105,A02,093477,Carter; Anne Toulson,20,0,35,15
1657579384505,MATH 109,A01,083213,Ganzberger; Geoffrey Michael,2,0,34,32
1657579384505,MATH 109,A02,083214,Ganzberger; Geoffrey Michael,4,0,34,30
1657579384505,MATH 109,A03,093478,Ganzberger; Geoffrey Michael,2,0,34,32
1657579384505,MATH 109,B01,083215,Ganzberger; Geoffrey Michael,1,0,32,31
1657579384505,MATH 109,B02,083216,Ganzberger; Geoffrey Michael,2,0,32,30
1657579384505,MATH 109,B03,093479,Ganzberger; Geoffrey Michael,8,0,32,24
1657579390530,MATH 142A,A01,083219,Chow; Bennett,7,0,32,25
1657579390530,MATH 142A,A02,083220,Chow; Bennett,10,0,32,22
1657579390530,MATH 142A,A03,093480,Chow; Bennett,8,0,32,24
1657579390530,MATH 142A,B03,093481,Chow; Bennett,8,0,32,24
1657579390530,MATH 142A,B04,093558,Chow; Bennett,13,0,32,19
1657579390530,MATH 142A,B05,093559,Chow; Bennett,6,0,32,26
1657579396556,MATH 193A,A01,083224,Rotar; Vladimir,8,0,34,26
1657579396556,MATH 193A,A02,083225,Rotar; Vladimir,9,0,34,25
1657579396556,MATH 193A,A03,083781,Rotar; Vladimir,5,0,34,29
1657579396556,MATH 193A,A04,083782,Rotar; Vladimir,10,0,34,24
1657579396556,MATH 193A,A05,093482,Rotar; Vladimir,10,0,34,24
1657579402578,MATH 197,001,091859,McAuley; Julian John,9999,0,9999,0
1657579402578,MATH 197,002,095566,Kedlaya; Kiran S.,9997,0,9999,2
1657579402578,MATH 197,003,095567,Xiao; Ming,9999,0,9999,0
1657579402578,MATH 197,004,095571,Perols; Johan Lars,9998,0,9999,1
1657579409644,COGS 9,A01,083615,Shannon; Kyle Michael,9,0,75,66
1657579415668,COGS 11,A01,083617,Boyle; Mary E. T.,23,0,48,25
1657579421690,COGS 13,A01,083071,Bastos; Amalia Pinkusfeld,11,0,71,60
1657579427714,COGS 14A,A01,092681,Semenuks; Arturs,5,1,100,95
1657579433742,COGS 14B,A01,083073,Cheng; Tzu-Han,6,0,63,57
1657579439764,COGS 17,A01,092677,Semenuks; Arturs,6,0,81,75
1657579445798,COGS 100,A01,083619,Allen; Michael Gordon,17,0,70,53
1657579451820,COGS 101A,A01,083621,Davis; Joshua Daniel,9,0,68,59
1657579457844,COGS 101B,A01,091572,Allen; Michael Gordon,12,0,65,53
1657579463866,COGS 101C,A01,083625,Delgado; Tania,17,0,35,18
1657579469894,COGS 107A,A01,083627,Boyle; Mary E. T.,13,0,60,47
1657579475917,COGS 118A,A01,083075,Gupta; Anjum,21,0,76,55
1657579481944,CSE 3,A50,083646,Miranda; Gregory Joseph,24,0,50,26
1657579487970,CSE 8A,A50,083650,Miranda; Gregory Joseph,17,1,56,39
1657579493992,CSE 11,A01,083080,Cao; Yingjun,6,15,40,34
1657579500015,CSE 12,A01,083652,Krause-Levy; Sophia Louisa,28,1,120,92
1657579506050,CSE 15L,A01,083654,Morris; Justin Loren,9,0,50,41
1657579506050,CSE 15L,A02,083655,Morris; Justin Loren,9,0,50,41
1657579512080,CSE 20,A01,083657,Tran; Khoa Dang,39,0,80,41
1657579518104,CSE 21,A01,095574,Bach; Quang Tran,22,0,48,26
1657579524128,CSE 30,A01,083084,Eldon; John,5,0,80,75
1657579524128,CSE 30,B01,095061,Bhaskar; Nishant,9,0,50,41
1657579530150,CSE 100,A01,083659,Cao; Yingjun,5,4,70,65
1657579536180,CSE 134B,A01,083661,Powell; Thomas Allan,22,0,100,78
1657579542202,CSE 140,A01,083663,Gungor; Onat,15,0,85,70
1657579548229,CSE 140L,A01,083088,Eldon; John,21,0,100,79
1657579554324,CSE 175,A01,083665,Kumar; Rakesh,3,0,25,22
1657579560348,CSE 190,A00,092507,Dubnov; Shlomo,8,0,20,12
1657579566372,ECE 45,A01,083139,Congero; Spencer William,6,0,75,69
1657579572398,ECE 65,A50,083695,Saad; Andrew S,12,0,30,18
1657579572398,ECE 65,A51,095125,Saad; Andrew S,24,0,26,2
1657579578426,ECE 109,A01,091882,Touri; Behrouz,19,0,70,51
1657579584455,ECE 180,A00,083140,Abi Samra; Nicholas Camill,1,0,30,29
1657579584455,ECE 180,B00,083141,Abi Samra; Nicholas Camill,0,0,30,30
1657579590480,MATH 10A,A01,083735,Patchell; Gregory David,2,0,30,28
1657579590480,MATH 10A,A02,083736,Patchell; Gregory David,20,0,30,10
1657579590480,MATH 10A,A03,083737,Patchell; Gregory David,16,0,30,14
1657579596508,MATH 10B,A01,083207,Lim; Seonhee,8,0,34,26
1657579596508,MATH 10B,A02,083208,Lim; Seonhee,9,0,35,26
1657579596508,MATH 10B,A03,093472,Lim; Seonhee,7,0,34,27
1657579596508,MATH 10B,B01,083739,Sinha; Shubham,12,0,30,18
1657579602537,MATH 18,A01,083743,Cinel; Cameron Alexander,7,0,30,23
1657579602537,MATH 18,A02,083744,Cinel; Cameron Alexander,17,0,30,13
1657579602537,MATH 18,A03,083745,Cinel; Cameron Alexander,9,0,30,21
1657579602537,MATH 18,B01,083748,Rideout; David Porter,5,0,37,32
1657579602537,MATH 18,B02,083749,Rideout; David Porter,5,0,36,31
1657579602537,MATH 18,B03,083750,Rideout; David Porter,3,0,37,34
1657579602537,MATH 18,B04,083751,Rideout; David Porter,6,0,36,30
1657579602537,MATH 18,B05,093473,Rideout; David Porter,6,0,36,30
1657579602537,MATH 18,B06,093474,Rideout; David Porter,6,0,36,30
1657579608561,MATH 20A,A01,083754,Zheng; Zequn,14,0,40,26
1657579614583,MATH 20B,A01,083756,Briones; Jor-el Thomas Caparas,4,0,36,32
1657579614583,MATH 20B,A02,083757,Briones; Jor-el Thomas Caparas,1,0,36,35
1657579614583,MATH 20B,A03,093475,Briones; Jor-el Thomas Caparas,2,0,36,34
1657579620618,MATH 20C,A01,083760,Briones; Jor-el Thomas Caparas,1,0,35,34
1657579620618,MATH 20C,A02,083761,Briones; Jor-el Thomas Caparas,8,0,35,27
1657579620618,MATH 20C,A03,093476,Briones; Jor-el Thomas Caparas,0,1,36,36
1657579620618,MATH 20C,B01,083762,Bach; Quang Tran,1,0,30,29
1657579626642,MATH 20D,A01,083765,Tran; Brian Kha,5,0,30,25
1657579626642,MATH 20D,A02,083766,Tran; Brian Kha,5,0,30,25
1657579626642,MATH 20D,A03,083767,Tran; Brian Kha,5,0,30,25
1657579632669,MATH 20E,A01,083771,Ganguly; Soumya,9,0,32,23
1657579632669,MATH 20E,A02,083772,Ganguly; Soumya,6,0,32,26
1657579632669,MATH 20E,B01,083773,Ciotti; Benjamin,20,0,35,15
1657579632669,MATH 20E,B02,083774,Ciotti; Benjamin,18,0,35,17
1657579638699,MATH 103A,A01,083777,Greenfeld; Be'Eri,3,0,36,33
1657579638699,MATH 103A,A02,083778,Greenfeld; Be'Eri,5,0,36,31
1657579638699,MATH 103A,A03,093561,Greenfeld; Be'Eri,5,0,36,31
1657579638699,MATH 103A,B01,083779,Greenfeld; Be'Eri,7,0,36,29
1657579638699,MATH 103A,B02,083780,Greenfeld; Be'Eri,4,0,36,32
1657579638699,MATH 103A,B03,093562,Greenfeld; Be'Eri,3,0,36,33
1657579644723,MATH 105,A01,085443,Carter; Anne Toulson,15,0,35,20
1657579644723,MATH 105,A02,093477,Carter; Anne Toulson,20,0,35,15
1657579650756,MATH 109,A01,083213,Ganzberger; Geoffrey Michael,2,0,34,32
1657579650756,MATH 109,A02,083214,Ganzberger; Geoffrey Michael,4,0,34,30
1657579650756,MATH 109,A03,093478,Ganzberger; Geoffrey Michael,2,0,34,32
1657579650756,MATH 109,B01,083215,Ganzberger; Geoffrey Michael,1,0,32,31
1657579650756,MATH 109,B02,083216,Ganzberger; Geoffrey Michael,2,0,32,30
1657579650756,MATH 109,B03,093479,Ganzberger; Geoffrey Michael,8,0,32,24
1657579656780,MATH 142A,A01,083219,Chow; Bennett,7,0,32,25
1657579656780,MATH 142A,A02,083220,Chow; Bennett,10,0,32,22
1657579656780,MATH 142A,A03,093480,Chow; Bennett,8,0,32,24
1657579656780,MATH 142A,B03,093481,Chow; Bennett,8,0,32,24
1657579656780,MATH 142A,B04,093558,Chow; Bennett,13,0,32,19
1657579656780,MATH 142A,B05,093559,Chow; Bennett,6,0,32,26
1657579662810,MATH 193A,A01,083224,Rotar; Vladimir,8,0,34,26
1657579662810,MATH 193A,A02,083225,Rotar; Vladimir,9,0,34,25
1657579662810,MATH 193A,A03,083781,Rotar; Vladimir,5,0,34,29
1657579662810,MATH 193A,A04,083782,Rotar; Vladimir,10,0,34,24
1657579662810,MATH 193A,A05,093482,Rotar; Vladimir,10,0,34,24
1657579668840,MATH 197,001,091859,McAuley; Julian John,9999,0,9999,0
1657579668840,MATH 197,002,095566,Kedlaya; Kiran S.,9997,0,9999,2
1657579668840,MATH 197,003,095567,Xiao; Ming,9999,0,9999,0
1657579668840,MATH 197,004,095571,Perols; Johan Lars,9998,0,9999,1
1657579675889,COGS 9,A01,083615,Shannon; Kyle Michael,9,0,75,66
1657579681912,COGS 11,A01,083617,Boyle; Mary E. T.,23,0,48,25
1657579687935,COGS 13,A01,083071,Bastos; Amalia Pinkusfeld,11,0,71,60
1657579693961,COGS 14A,A01,092681,Semenuks; Arturs,5,1,100,95
1657579699983,COGS 14B,A01,083073,Cheng; Tzu-Han,6,0,63,57
1657579706010,COGS 17,A01,092677,Semenuks; Arturs,6,0,81,75
1657579712031,COGS 100,A01,083619,Allen; Michael Gordon,17,0,70,53
1657579718059,COGS 101A,A01,083621,Davis; Joshua Daniel,9,0,68,59
1657579724082,COGS 101B,A01,091572,Allen; Michael Gordon,12,0,65,53
1657579730116,COGS 101C,A01,083625,Delgado; Tania,17,0,35,18
1657579736145,COGS 107A,A01,083627,Boyle; Mary E. T.,13,0,60,47
1657579742176,COGS 118A,A01,083075,Gupta; Anjum,21,0,76,55
1657579748200,CSE 3,A50,083646,Miranda; Gregory Joseph,24,0,50,26
1657579754232,CSE 8A,A50,083650,Miranda; Gregory Joseph,17,1,56,39
1657579760255,CSE 11,A01,083080,Cao; Yingjun,6,15,40,34
1657579766281,CSE 12,A01,083652,Krause-Levy; Sophia Louisa,28,1,120,92
1657579772303,CSE 15L,A01,083654,Morris; Justin Loren,9,0,50,41
1657579772303,CSE 15L,A02,083655,Morris; Justin Loren,9,0,50,41
1657579778326,CSE 20,A01,083657,Tran; Khoa Dang,39,0,80,41
1657579784348,CSE 21,A01,095574,Bach; Quang Tran,22,0,48,26
1657579790379,CSE 30,A01,083084,Eldon; John,5,0,80,75
1657579790379,CSE 30,B01,095061,Bhaskar; Nishant,9,0,50,41
1657579796414,CSE 100,A01,083659,Cao; Yingjun,5,4,70,65
1657579802439,CSE 134B,A01,083661,Powell; Thomas Allan,22,0,100,78
1657579808461,CSE 140,A01,083663,Gungor; Onat,15,0,85,70
1657579814482,CSE 140L,A01,083088,Eldon; John,21,0,100,79
1657579820514,CSE 175,A01,083665,Kumar; Rakesh,3,0,25,22
1657579826535,CSE 190,A00,092507,Dubnov; Shlomo,8,0,20,12
1657579832567,ECE 45,A01,083139,Congero; Spencer William,6,0,75,69
1657579838595,ECE 65,A50,083695,Saad; Andrew S,12,0,30,18
1657579838595,ECE 65,A51,095125,Saad; Andrew S,24,0,26,2
1657579844625,ECE 109,A01,091882,Touri; Behrouz,19,0,70,51
1657579850648,ECE 180,A00,083140,Abi Samra; Nicholas Camill,1,0,30,29
1657579850648,ECE 180,B00,083141,Abi Samra; Nicholas Camill,0,0,30,30
1657579856676,MATH 10A,A01,083735,Patchell; Gregory David,2,0,30,28
1657579856676,MATH 10A,A02,083736,Patchell; Gregory David,20,0,30,10
1657579856676,MATH 10A,A03,083737,Patchell; Gregory David,16,0,30,14
1657579862701,MATH 10B,A01,083207,Lim; Seonhee,8,0,34,26
1657579862701,MATH 10B,A02,083208,Lim; Seonhee,9,0,35,26
1657579862701,MATH 10B,A03,093472,Lim; Seonhee,7,0,34,27
1657579862701,MATH 10B,B01,083739,Sinha; Shubham,12,0,30,18
1657579868726,MATH 18,A01,083743,Cinel; Cameron Alexander,7,0,30,23
1657579868726,MATH 18,A02,083744,Cinel; Cameron Alexander,17,0,30,13
1657579868726,MATH 18,A03,083745,Cinel; Cameron Alexander,9,0,30,21
1657579868726,MATH 18,B01,083748,Rideout; David Porter,5,0,37,32
1657579868726,MATH 18,B02,083749,Rideout; David Porter,5,0,36,31
1657579868726,MATH 18,B03,083750,Rideout; David Porter,3,0,37,34
1657579868726,MATH 18,B04,083751,Rideout; David Porter,6,0,36,30
1657579868726,MATH 18,B05,093473,Rideout; David Porter,6,0,36,30
1657579868726,MATH 18,B06,093474,Rideout; David Porter,6,0,36,30
1657579874752,MATH 20A,A01,083754,Zheng; Zequn,14,0,40,26
1657579880776,MATH 20B,A01,083756,Briones; Jor-el Thomas Caparas,4,0,36,32
1657579880776,MATH 20B,A02,083757,Briones; Jor-el Thomas Caparas,1,0,36,35
1657579880776,MATH 20B,A03,093475,Briones; Jor-el Thomas Caparas,2,0,36,34
1657579886800,MATH 20C,A01,083760,Briones; Jor-el Thomas Caparas,1,0,35,34
1657579886800,MATH 20C,A02,083761,Briones; Jor-el Thomas Caparas,8,0,35,27
1657579886800,MATH 20C,A03,093476,Briones; Jor-el Thomas Caparas,0,1,36,36
1657579886800,MATH 20C,B01,083762,Bach; Quang Tran,1,0,30,29
1657579892825,MATH 20D,A01,083765,Tran; Brian Kha,5,0,30,25
1657579892825,MATH 20D,A02,083766,Tran; Brian Kha,5,0,30,25
1657579892825,MATH 20D,A03,083767,Tran; Brian Kha,5,0,30,25
1657579898848,MATH 20E,A01,083771,Ganguly; Soumya,9,0,32,23
1657579898848,MATH 20E,A02,083772,Ganguly; Soumya,6,0,32,26
1657579898848,MATH 20E,B01,083773,Ciotti; Benjamin,20,0,35,15
1657579898848,MATH 20E,B02,083774,Ciotti; Benjamin,18,0,35,17
1657579904876,MATH 103A,A01,083777,Greenfeld; Be'Eri,3,0,36,33
1657579904876,MATH 103A,A02,083778,Greenfeld; Be'Eri,5,0,36,31
1657579904876,MATH 103A,A03,093561,Greenfeld; Be'Eri,5,0,36,31
1657579904876,MATH 103A,B01,083779,Greenfeld; Be'Eri,7,0,36,29
1657579904876,MATH 103A,B02,083780,Greenfeld; Be'Eri,4,0,36,32
1657579904876,MATH 103A,B03,093562,Greenfeld; Be'Eri,3,0,36,33
1657579910904,MATH 105,A01,085443,Carter; Anne Toulson,15,0,35,20
1657579910904,MATH 105,A02,093477,Carter; Anne Toulson,20,0,35,15
1657579916928,MATH 109,A01,083213,Ganzberger; Geoffrey Michael,2,0,34,32
1657579916928,MATH 109,A02,083214,Ganzberger; Geoffrey Michael,4,0,34,30
1657579916928,MATH 109,A03,093478,Ganzberger; Geoffrey Michael,2,0,34,32
1657579916928,MATH 109,B01,083215,Ganzberger; Geoffrey Michael,1,0,32,31
1657579916928,MATH 109,B02,083216,Ganzberger; Geoffrey Michael,2,0,32,30
1657579916928,MATH 109,B03,093479,Ganzberger; Geoffrey Michael,8,0,32,24
1657579922953,MATH 142A,A01,083219,Chow; Bennett,7,0,32,25
1657579922953,MATH 142A,A02,083220,Chow; Bennett,10,0,32,22
1657579922953,MATH 142A,A03,093480,Chow; Bennett,8,0,32,24
1657579922953,MATH 142A,B03,093481,Chow; Bennett,8,0,32,24
1657579922953,MATH 142A,B04,093558,Chow; Bennett,13,0,32,19
1657579922953,MATH 142A,B05,093559,Chow; Bennett,6,0,32,26
1657579928984,MATH 193A,A01,083224,Rotar; Vladimir,8,0,34,26
1657579928984,MATH 193A,A02,083225,Rotar; Vladimir,9,0,34,25
1657579928984,MATH 193A,A03,083781,Rotar; Vladimir,5,0,34,29
1657579928984,MATH 193A,A04,083782,Rotar; Vladimir,10,0,34,24
1657579928984,MATH 193A,A05,093482,Rotar; Vladimir,10,0,34,24
1657579935008,MATH 197,001,091859,McAuley; Julian John,9999,0,9999,0
1657579935008,MATH 197,002,095566,Kedlaya; Kiran S.,9997,0,9999,2
1657579935008,MATH 197,003,095567,Xiao; Ming,9999,0,9999,0
1657579935008,MATH 197,004,095571,Perols; Johan Lars,9998,0,9999,1
1657579942067,COGS 9,A01,083615,Shannon; Kyle Michael,9,0,75,66
1657579948091,COGS 11,A01,083617,Boyle; Mary E. T.,23,0,48,25
1657579954116,COGS 13,A01,083071,Bastos; Amalia Pinkusfeld,11,0,71,60
1657579960139,COGS 14A,A01,092681,Semenuks; Arturs,5,1,100,95
1657579966165,COGS 14B,A01,083073,Cheng; Tzu-Han,6,0,63,57
1657579972191,COGS 17,A01,092677,Semenuks; Arturs,6,0,81,75
1657579978230,COGS 100,A01,083619,Allen; Michael Gordon,17,0,70,53
1657579984257,COGS 101A,A01,083621,Davis; Joshua Daniel,9,0,68,59
1657579990283,COGS 101B,A01,091572,Allen; Michael Gordon,12,0,65,53
1657579996306,COGS 101C,A01,083625,Delgado; Tania,17,0,35,18
1657580002333,COGS 107A,A01,083627,Boyle; Mary E. T.,13,0,60,47
1657580008366,COGS 118A,A01,083075,Gupta; Anjum,21,0,76,55
1657580021215,CSE 3,A50,083646,Miranda; Gregory Joseph,24,0,50,26
1657580027239,CSE 8A,A50,083650,Miranda; Gregory Joseph,17,1,56,39
1657580033261,CSE 11,A01,083080,Cao; Yingjun,6,15,40,34
1657580039286,CSE 12,A01,083652,Krause-Levy; Sophia Louisa,28,1,120,92
1657580045317,CSE 15L,A01,083654,Morris; Justin Loren,9,0,50,41
1657580045317,CSE 15L,A02,083655,Morris; Justin Loren,9,0,50,41
1657580051341,CSE 20,A01,083657,Tran; Khoa Dang,39,0,80,41
1657580057367,CSE 21,A01,095574,Bach; Quang Tran,22,0,48,26
1657580063395,CSE 30,A01,083084,Eldon; John,5,0,80,75
1657580063395,CSE 30,B01,095061,Bhaskar; Nishant,9,0,50,41
1657580069422,CSE 100,A01,083659,Cao; Yingjun,5,4,70,65
1657580075447,CSE 134B,A01,083661,Powell; Thomas Allan,22,0,100,78
1657580081469,CSE 140,A01,083663,Gungor; Onat,15,0,85,70
1657580087496,CSE 140L,A01,083088,Eldon; John,21,0,100,79
1657580093526,CSE 175,A01,083665,Kumar; Rakesh,3,0,25,22
1657580099553,CSE 190,A00,092507,Dubnov; Shlomo,8,0,20,12
1657580105579,ECE 45,A01,083139,Congero; Spencer William,6,0,75,69
1657580111608,ECE 65,A50,083695,Saad; Andrew S,12,0,30,18
1657580111608,ECE 65,A51,095125,Saad; Andrew S,24,0,26,2
1657580117637,ECE 109,A01,091882,Touri; Behrouz,19,0,70,51
1657580123663,ECE 180,A00,083140,Abi Samra; Nicholas Camill,1,0,30,29
1657580123663,ECE 180,B00,083141,Abi Samra; Nicholas Camill,0,0,30,30
1657580129690,MATH 10A,A01,083735,Patchell; Gregory David,2,0,30,28
1657580129690,MATH 10A,A02,083736,Patchell; Gregory David,20,0,30,10
1657580129690,MATH 10A,A03,083737,Patchell; Gregory David,16,0,30,14
1657580135723,MATH 10B,A01,083207,Lim; Seonhee,8,0,34,26
1657580135723,MATH 10B,A02,083208,Lim; Seonhee,9,0,35,26
1657580135723,MATH 10B,A03,093472,Lim; Seonhee,7,0,34,27
1657580135723,MATH 10B,B01,083739,Sinha; Shubham,12,0,30,18
1657580141753,MATH 18,A01,083743,Cinel; Cameron Alexander,7,0,30,23
1657580141753,MATH 18,A02,083744,Cinel; Cameron Alexander,17,0,30,13
1657580141753,MATH 18,A03,083745,Cinel; Cameron Alexander,9,0,30,21
1657580141753,MATH 18,B01,083748,Rideout; David Porter,5,0,37,32
1657580141753,MATH 18,B02,083749,Rideout; David Porter,5,0,36,31
1657580141753,MATH 18,B03,083750,Rideout; David Porter,3,0,37,34
1657580141753,MATH 18,B04,083751,Rideout; David Porter,6,0,36,30
1657580141753,MATH 18,B05,093473,Rideout; David Porter,6,0,36,30
1657580141753,MATH 18,B06,093474,Rideout; David Porter,6,0,36,30
1657580147777,MATH 20A,A01,083754,Zheng; Zequn,14,0,40,26
1657580153797,MATH 20B,A01,083756,Briones; Jor-el Thomas Caparas,4,0,36,32
1657580153797,MATH 20B,A02,083757,Briones; Jor-el Thomas Caparas,1,0,36,35
1657580153797,MATH 20B,A03,093475,Briones; Jor-el Thomas Caparas,2,0,36,34
1657580159927,MATH 20C,A01,083760,Briones; Jor-el Thomas Caparas,1,0,35,34
1657580159927,MATH 20C,A02,083761,Briones; Jor-el Thomas Caparas,8,0,35,27
1657580159927,MATH 20C,A03,093476,Briones; Jor-el Thomas Caparas,0,1,36,36
1657580159927,MATH 20C,B01,083762,Bach; Quang Tran,1,0,30,29
1657580165963,MATH 20D,A01,083765,Tran; Brian Kha,5,0,30,25
1657580165963,MATH 20D,A02,083766,Tran; Brian Kha,5,0,30,25
1657580165963,MATH 20D,A03,083767,Tran; Brian Kha,5,0,30,25
1657580171998,MATH 20E,A01,083771,Ganguly; Soumya,9,0,32,23
1657580171998,MATH 20E,A02,083772,Ganguly; Soumya,6,0,32,26
1657580171998,MATH 20E,B01,083773,Ciotti; Benjamin,20,0,35,15
1657580171998,MATH 20E,B02,083774,Ciotti; Benjamin,18,0,35,17
1657580178022,MATH 103A,A01,083777,Greenfeld; Be'Eri,3,0,36,33
1657580178022,MATH 103A,A02,083778,Greenfeld; Be'Eri,5,0,36,31
1657580178022,MATH 103A,A03,093561,Greenfeld; Be'Eri,5,0,36,31
1657580178022,MATH 103A,B01,083779,Greenfeld; Be'Eri,7,0,36,29
1657580178022,MATH 103A,B02,083780,Greenfeld; Be'Eri,4,0,36,32
1657580178022,MATH 103A,B03,093562,Greenfeld; Be'Eri,3,0,36,33
1657580184049,MATH 105,A01,085443,Carter; Anne Toulson,15,0,35,20
1657580184049,MATH 105,A02,093477,Carter; Anne Toulson,20,0,35,15
1657580190080,MATH 109,A01,083213,Ganzberger; Geoffrey Michael,2,0,34,32
1657580190080,MATH 109,A02,083214,Ganzberger; Geoffrey Michael,4,0,34,30
1657580190080,MATH 109,A03,093478,Ganzberger; Geoffrey Michael,2,0,34,32
1657580190080,MATH 109,B01,083215,Ganzberger; Geoffrey Michael,1,0,32,31
1657580190080,MATH 109,B02,083216,Ganzberger; Geoffrey Michael,2,0,32,30
1657580190080,MATH 109,B03,093479,Ganzberger; Geoffrey Michael,8,0,32,24
1657580196111,MATH 142A,A01,083219,Chow; Bennett,7,0,32,25
1657580196111,MATH 142A,A02,083220,Chow; Bennett,10,0,32,22
1657580196111,MATH 142A,A03,093480,Chow; Bennett,8,0,32,24
1657580196111,MATH 142A,B03,093481,Chow; Bennett,8,0,32,24
1657580196111,MATH 142A,B04,093558,Chow; Bennett,13,0,32,19
1657580196111,MATH 142A,B05,093559,Chow; Bennett,6,0,32,26
1657580202134,MATH 193A,A01,083224,Rotar; Vladimir,8,0,34,26
1657580202134,MATH 193A,A02,083225,Rotar; Vladimir,9,0,34,25
1657580202134,MATH 193A,A03,083781,Rotar; Vladimir,5,0,34,29
1657580202134,MATH 193A,A04,083782,Rotar; Vladimir,10,0,34,24
1657580202134,MATH 193A,A05,093482,Rotar; Vladimir,10,0,34,24
1657580208156,MATH 197,001,091859,McAuley; Julian John,9999,0,9999,0
1657580208156,MATH 197,002,095566,Kedlaya; Kiran S.,9997,0,9999,2
1657580208156,MATH 197,003,095567,Xiao; Ming,9999,0,9999,0
1657580208156,MATH 197,004,095571,Perols; Johan Lars,9998,0,9999,1
1657580215232,COGS 9,A01,083615,Shannon; Kyle Michael,9,0,75,66
1657580221258,COGS 11,A01,083617,Boyle; Mary E. T.,23,0,48,25
1657580227279,COGS 13,A01,083071,Bastos; Amalia Pinkusfeld,11,0,71,60
1657580233306,COGS 14A,A01,092681,Semenuks; Arturs,5,1,100,95
1657580239329,COGS 14B,A01,083073,Cheng; Tzu-Han,6,0,63,57
1657580245364,COGS 17,A01,092677,Semenuks; Arturs,6,0,81,75
1657580251387,COGS 100,A01,083619,Allen; Michael Gordon,17,0,70,53
1657580257411,COGS 101A,A01,083621,Davis; Joshua Daniel,9,0,68,59
1657580263433,COGS 101B,A01,091572,Allen; Michael Gordon,12,0,65,53
1657580269456,COGS 101C,A01,083625,Delgado; Tania,17,0,35,18
1657580275483,COGS 107A,A01,083627,Boyle; Mary E. T.,13,0,60,47
1657580281505,COGS 118A,A01,083075,Gupta; Anjum,21,0,76,55
1657580287532,CSE 3,A50,083646,Miranda; Gregory Joseph,24,0,50,26
1657580293579,CSE 8A,A50,083650,Miranda; Gregory Joseph,17,1,56,39
1657580299606,CSE 11,A01,083080,Cao; Yingjun,6,15,40,34
1657580305628,CSE 12,A01,083652,Krause-Levy; Sophia Louisa,28,1,120,92
1657580311653,CSE 15L,A01,083654,Morris; Justin Loren,9,0,50,41
1657580311653,CSE 15L,A02,083655,Morris; Justin Loren,9,0,50,41
1657580317680,CSE 20,A01,083657,Tran; Khoa Dang,39,0,80,41
1657580323703,CSE 21,A01,095574,Bach; Quang Tran,22,0,48,26
1657580329734,CSE 30,A01,083084,Eldon; John,5,0,80,75
1657580329734,CSE 30,B01,095061,Bhaskar; Nishant,9,0,50,41
1657580335762,CSE 100,A01,083659,Cao; Yingjun,5,4,70,65
1657580341787,CSE 134B,A01,083661,Powell; Thomas Allan,22,0,100,78
1657580347809,CSE 140,A01,083663,Gungor; Onat,15,0,85,70
1657580353834,CSE 140L,A01,083088,Eldon; John,21,0,100,79
1657580359861,CSE 175,A01,083665,Kumar; Rakesh,3,0,25,22
1657580365883,CSE 190,A00,092507,Dubnov; Shlomo,8,0,20,12
1657580371911,ECE 45,A01,083139,Congero; Spencer William,6,0,75,69
1657580377933,ECE 65,A50,083695,Saad; Andrew S,12,0,30,18
1657580377933,ECE 65,A51,095125,Saad; Andrew S,24,0,26,2
1657580383959,ECE 109,A01,091882,Touri; Behrouz,19,0,70,51
1657580389982,ECE 180,A00,083140,Abi Samra; Nicholas Camill,1,0,30,29
1657580389982,ECE 180,B00,083141,Abi Samra; Nicholas Camill,0,0,30,30
1657580396006,MATH 10A,A01,083735,Patchell; Gregory David,2,0,30,28
1657580396006,MATH 10A,A02,083736,Patchell; Gregory David,20,0,30,10
1657580396006,MATH 10A,A03,083737,Patchell; Gregory David,16,0,30,14
1657580402037,MATH 10B,A01,083207,Lim; Seonhee,8,0,34,26
1657580402037,MATH 10B,A02,083208,Lim; Seonhee,9,0,35,26
1657580402037,MATH 10B,A03,093472,Lim; Seonhee,7,0,34,27
1657580402037,MATH 10B,B01,083739,Sinha; Shubham,12,0,30,18
1657580408070,MATH 18,A01,083743,Cinel; Cameron Alexander,7,0,30,23
1657580408070,MATH 18,A02,083744,Cinel; Cameron Alexander,17,0,30,13
1657580408070,MATH 18,A03,083745,Cinel; Cameron Alexander,9,0,30,21
1657580408070,MATH 18,B01,083748,Rideout; David Porter,5,0,37,32
1657580408070,MATH 18,B02,083749,Rideout; David Porter,5,0,36,31
1657580408070,MATH 18,B03,083750,Rideout; David Porter,3,0,37,34
1657580408070,MATH 18,B04,083751,Rideout; David Porter,6,0,36,30
1657580408070,MATH 18,B05,093473,Rideout; David Porter,6,0,36,30
1657580408070,MATH 18,B06,093474,Rideout; David Porter,6,0,36,30
1657580414095,MATH 20A,A01,083754,Zheng; Zequn,14,0,40,26
1657580420127,MATH 20B,A01,083756,Briones; Jor-el Thomas Caparas,4,0,36,32
1657580420127,MATH 20B,A02,083757,Briones; Jor-el Thomas Caparas,1,0,36,35
1657580420127,MATH 20B,A03,093475,Briones; Jor-el Thomas Caparas,2,0,36,34
1657580426153,MATH 20C,A01,083760,Briones; Jor-el Thomas Caparas,1,0,35,34
1657580426153,MATH 20C,A02,083761,Briones; Jor-el Thomas Caparas,8,0,35,27
1657580426153,MATH 20C,A03,093476,Briones; Jor-el Thomas Caparas,0,1,36,36
1657580426153,MATH 20C,B01,083762,Bach; Quang Tran,1,0,30,29
1657580432177,MATH 20D,A01,083765,Tran; Brian Kha,5,0,30,25
1657580432177,MATH 20D,A02,083766,Tran; Brian Kha,5,0,30,25
1657580432177,MATH 20D,A03,083767,Tran; Brian Kha,5,0,30,25
1657580438202,MATH 20E,A01,083771,Ganguly; Soumya,9,0,32,23
1657580438202,MATH 20E,A02,083772,Ganguly; Soumya,6,0,32,26
1657580438202,MATH 20E,B01,083773,Ciotti; Benjamin,20,0,35,15
1657580438202,MATH 20E,B02,083774,Ciotti; Benjamin,18,0,35,17
1657580444225,MATH 103A,A01,083777,Greenfeld; Be'Eri,3,0,36,33
1657580444225,MATH 103A,A02,083778,Greenfeld; Be'Eri,5,0,36,31
1657580444225,MATH 103A,A03,093561,Greenfeld; Be'Eri,5,0,36,31
1657580444225,MATH 103A,B01,083779,Greenfeld; Be'Eri,7,0,36,29
1657580444225,MATH 103A,B02,083780,Greenfeld; Be'Eri,4,0,36,32
1657580444225,MATH 103A,B03,093562,Greenfeld; Be'Eri,3,0,36,33
1657580450253,MATH 105,A01,085443,Carter; Anne Toulson,15,0,35,20
1657580450253,MATH 105,A02,093477,Carter; Anne Toulson,20,0,35,15
1657580456280,MATH 109,A01,083213,Ganzberger; Geoffrey Michael,2,0,34,32
1657580456280,MATH 109,A02,083214,Ganzberger; Geoffrey Michael,4,0,34,30
1657580456280,MATH 109,A03,093478,Ganzberger; Geoffrey Michael,2,0,34,32
1657580456280,MATH 109,B01,083215,Ganzberger; Geoffrey Michael,1,0,32,31
1657580456280,MATH 109,B02,083216,Ganzberger; Geoffrey Michael,2,0,32,30
1657580456280,MATH 109,B03,093479,Ganzberger; Geoffrey Michael,8,0,32,24
1657580462304,MATH 142A,A01,083219,Chow; Bennett,7,0,32,25
1657580462304,MATH 142A,A02,083220,Chow; Bennett,10,0,32,22
1657580462304,MATH 142A,A03,093480,Chow; Bennett,8,0,32,24
1657580462304,MATH 142A,B03,093481,Chow; Bennett,8,0,32,24
1657580462304,MATH 142A,B04,093558,Chow; Bennett,13,0,32,19
1657580462304,MATH 142A,B05,093559,Chow; Bennett,6,0,32,26
1657580468327,MATH 193A,A01,083224,Rotar; Vladimir,8,0,34,26
1657580468327,MATH 193A,A02,083225,Rotar; Vladimir,9,0,34,25
1657580468327,MATH 193A,A03,083781,Rotar; Vladimir,5,0,34,29
1657580468327,MATH 193A,A04,083782,Rotar; Vladimir,10,0,34,24
1657580468327,MATH 193A,A05,093482,Rotar; Vladimir,10,0,34,24
1657580474356,MATH 197,001,091859,McAuley; Julian John,9999,0,9999,0
1657580474356,MATH 197,002,095566,Kedlaya; Kiran S.,9997,0,9999,2
1657580474356,MATH 197,003,095567,Xiao; Ming,9999,0,9999,0
1657580474356,MATH 197,004,095571,Perols; Johan Lars,9998,0,9999,1
1657580481414,COGS 9,A01,083615,Shannon; Kyle Michael,9,0,75,66
1657580487445,COGS 11,A01,083617,Boyle; Mary E. T.,23,0,48,25
1657580493470,COGS 13,A01,083071,Bastos; Amalia Pinkusfeld,11,0,71,60
1657580499495,COGS 14A,A01,092681,Semenuks; Arturs,5,1,100,95
1657580505518,COGS 14B,A01,083073,Cheng; Tzu-Han,6,0,63,57
1657580511540,COGS 17,A01,092677,Semenuks; Arturs,6,0,81,75
1657580517566,COGS 100,A01,083619,Allen; Michael Gordon,17,0,70,53
1657580523590,COGS 101A,A01,083621,Davis; Joshua Daniel,9,0,68,59
1657580529621,COGS 101B,A01,091572,Allen; Michael Gordon,12,0,65,53
1657580535654,COGS 101C,A01,083625,Delgado; Tania,17,0,35,18
1657580541688,COGS 107A,A01,083627,Boyle; Mary E. T.,13,0,60,47
1657580547713,COGS 118A,A01,083075,Gupta; Anjum,21,0,76,55
1657580553742,CSE 3,A50,083646,Miranda; Gregory Joseph,24,0,50,26
1657580559770,CSE 8A,A50,083650,Miranda; Gregory Joseph,17,1,56,39
1657580565797,CSE 11,A01,083080,Cao; Yingjun,6,15,40,34
1657580571820,CSE 12,A01,083652,Krause-Levy; Sophia Louisa,28,1,120,92
1657580577844,CSE 15L,A01,083654,Morris; Justin Loren,9,0,50,41
1657580577844,CSE 15L,A02,083655,Morris; Justin Loren,9,0,50,41
1657580583877,CSE 20,A01,083657,Tran; Khoa Dang,39,0,80,41
1657580589903,CSE 21,A01,095574,Bach; Quang Tran,22,0,48,26
1657580595937,CSE 30,A01,083084,Eldon; John,5,0,80,75
1657580595937,CSE 30,B01,095061,Bhaskar; Nishant,9,0,50,41
1657580601974,CSE 100,A01,083659,Cao; Yingjun,5,4,70,65
1657580607995,CSE 134B,A01,083661,Powell; Thomas Allan,22,0,100,78
1657580614021,CSE 140,A01,083663,Gungor; Onat,15,0,85,70
1657580620045,CSE 140L,A01,083088,Eldon; John,21,0,100,79
1657580626071,CSE 175,A01,083665,Kumar; Rakesh,3,0,25,22
1657580632095,CSE 190,A00,092507,Dubnov; Shlomo,8,0,20,12
1657580638122,ECE 45,A01,083139,Congero; Spencer William,6,0,75,69
1657580644147,ECE 65,A50,083695,Saad; Andrew S,12,0,30,18
1657580644147,ECE 65,A51,095125,Saad; Andrew S,24,0,26,2
1657580650169,ECE 109,A01,091882,Touri; Behrouz,19,0,70,51
1657580656203,ECE 180,A00,083140,Abi Samra; Nicholas Camill,1,0,30,29
1657580656203,ECE 180,B00,083141,Abi Samra; Nicholas Camill,0,0,30,30
1657580662230,MATH 10A,A01,083735,Patchell; Gregory David,2,0,30,28
1657580662230,MATH 10A,A02,083736,Patchell; Gregory David,20,0,30,10
1657580662230,MATH 10A,A03,083737,Patchell; Gregory David,16,0,30,14
1657580668255,MATH 10B,A01,083207,Lim; Seonhee,8,0,34,26
1657580668255,MATH 10B,A02,083208,Lim; Seonhee,9,0,35,26
1657580668255,MATH 10B,A03,093472,Lim; Seonhee,7,0,34,27
1657580668255,MATH 10B,B01,083739,Sinha; Shubham,12,0,30,18
1657580674287,MATH 18,A01,083743,Cinel; Cameron Alexander,7,0,30,23
1657580674287,MATH 18,A02,083744,Cinel; Cameron Alexander,17,0,30,13
1657580674287,MATH 18,A03,083745,Cinel; Cameron Alexander,9,0,30,21
1657580674287,MATH 18,B01,083748,Rideout; David Porter,5,0,37,32
1657580674287,MATH 18,B02,083749,Rideout; David Porter,5,0,36,31
1657580674287,MATH 18,B03,083750,Rideout; David Porter,3,0,37,34
1657580674287,MATH 18,B04,083751,Rideout; David Porter,6,0,36,30
1657580674287,MATH 18,B05,093473,Rideout; David Porter,6,0,36,30
1657580674287,MATH 18,B06,093474,Rideout; David Porter,6,0,36,30
1657580680313,MATH 20A,A01,083754,Zheng; Zequn,14,0,40,26
1657580686337,MATH 20B,A01,083756,Briones; Jor-el Thomas Caparas,4,0,36,32
1657580686337,MATH 20B,A02,083757,Briones; Jor-el Thomas Caparas,1,0,36,35
1657580686337,MATH 20B,A03,093475,Briones; Jor-el Thomas Caparas,2,0,36,34
1657580692359,MATH 20C,A01,083760,Briones; Jor-el Thomas Caparas,1,0,35,34
1657580692359,MATH 20C,A02,083761,Briones; Jor-el Thomas Caparas,8,0,35,27
1657580692359,MATH 20C,A03,093476,Briones; Jor-el Thomas Caparas,0,1,36,36
1657580692359,MATH 20C,B01,083762,Bach; Quang Tran,1,0,30,29
1657580698386,MATH 20D,A01,083765,Tran; Brian Kha,5,0,30,25
1657580698386,MATH 20D,A02,083766,Tran; Brian Kha,5,0,30,25
1657580698386,MATH 20D,A03,083767,Tran; Brian Kha,5,0,30,25
1657580704416,MATH 20E,A01,083771,Ganguly; Soumya,9,0,32,23
1657580704416,MATH 20E,A02,083772,Ganguly; Soumya,6,0,32,26
1657580704416,MATH 20E,B01,083773,Ciotti; Benjamin,20,0,35,15
1657580704416,MATH 20E,B02,083774,Ciotti; Benjamin,18,0,35,17
1657580710440,MATH 103A,A01,083777,Greenfeld; Be'Eri,3,0,36,33
1657580710440,MATH 103A,A02,083778,Greenfeld; Be'Eri,5,0,36,31
1657580710440,MATH 103A,A03,093561,Greenfeld; Be'Eri,5,0,36,31
1657580710440,MATH 103A,B01,083779,Greenfeld; Be'Eri,7,0,36,29
1657580710440,MATH 103A,B02,083780,Greenfeld; Be'Eri,4,0,36,32
1657580710440,MATH 103A,B03,093562,Greenfeld; Be'Eri,3,0,36,33
1657580716468,MATH 105,A01,085443,Carter; Anne Toulson,15,0,35,20
1657580716468,MATH 105,A02,093477,Carter; Anne Toulson,20,0,35,15
1657580722490,MATH 109,A01,083213,Ganzberger; Geoffrey Michael,2,0,34,32
1657580722490,MATH 109,A02,083214,Ganzberger; Geoffrey Michael,4,0,34,30
1657580722490,MATH 109,A03,093478,Ganzberger; Geoffrey Michael,2,0,34,32
1657580722490,MATH 109,B01,083215,Ganzberger; Geoffrey Michael,1,0,32,31
1657580722490,MATH 109,B02,083216,Ganzberger; Geoffrey Michael,2,0,32,30
1657580722490,MATH 109,B03,093479,Ganzberger; Geoffrey Michael,8,0,32,24
1657580728518,MATH 142A,A01,083219,Chow; Bennett,7,0,32,25
1657580728518,MATH 142A,A02,083220,Chow; Bennett,10,0,32,22
1657580728518,MATH 142A,A03,093480,Chow; Bennett,8,0,32,24
1657580728518,MATH 142A,B03,093481,Chow; Bennett,8,0,32,24
1657580728518,MATH 142A,B04,093558,Chow; Bennett,13,0,32,19
1657580728518,MATH 142A,B05,093559,Chow; Bennett,6,0,32,26
1657580734541,MATH 193A,A01,083224,Rotar; Vladimir,8,0,34,26
1657580734541,MATH 193A,A02,083225,Rotar; Vladimir,9,0,34,25
1657580734541,MATH 193A,A03,083781,Rotar; Vladimir,5,0,34,29
1657580734541,MATH 193A,A04,083782,Rotar; Vladimir,10,0,34,24
1657580734541,MATH 193A,A05,093482,Rotar; Vladimir,10,0,34,24
1657580740568,MATH 197,001,091859,McAuley; Julian John,9999,0,9999,0
1657580740568,MATH 197,002,095566,Kedlaya; Kiran S.,9997,0,9999,2
1657580740568,MATH 197,003,095567,Xiao; Ming,9999,0,9999,0
1657580740568,MATH 197,004,095571,Perols; Johan Lars,9998,0,9999,1
1657580747629,COGS 9,A01,083615,Shannon; Kyle Michael,9,0,75,66
1657580753745,COGS 11,A01,083617,Boyle; Mary E. T.,23,0,48,25
1657580759771,COGS 13,A01,083071,Bastos; Amalia Pinkusfeld,11,0,71,60
1657580765798,COGS 14A,A01,092681,Semenuks; Arturs,5,1,100,95
1657580771836,COGS 14B,A01,083073,Cheng; Tzu-Han,6,0,63,57
1657580777863,COGS 17,A01,092677,Semenuks; Arturs,6,0,81,75
1657580783886,COGS 100,A01,083619,Allen; Michael Gordon,17,0,70,53
1657580789907,COGS 101A,A01,083621,Davis; Joshua Daniel,9,0,68,59
1657580795932,COGS 101B,A01,091572,Allen; Michael Gordon,12,0,65,53
1657580801964,COGS 101C,A01,083625,Delgado; Tania,17,0,35,18
1657580807995,COGS 107A,A01,083627,Boyle; Mary E. T.,13,0,60,47
1657580814018,COGS 118A,A01,083075,Gupta; Anjum,21,0,76,55
1657580820057,CSE 3,A50,083646,Miranda; Gregory Joseph,24,0,50,26
1657580826080,CSE 8A,A50,083650,Miranda; Gregory Joseph,17,1,56,39
1657580832106,CSE 11,A01,083080,Cao; Yingjun,6,15,40,34
1657580838136,CSE 12,A01,083652,Krause-Levy; Sophia Louisa,28,1,120,92
1657580844157,CSE 15L,A01,083654,Morris; Justin Loren,9,0,50,41
1657580844157,CSE 15L,A02,083655,Morris; Justin Loren,9,0,50,41
1657580850186,CSE 20,A01,083657,Tran; Khoa Dang,39,0,80,41
1657580856208,CSE 21,A01,095574,Bach; Quang Tran,22,0,48,26
1657580862231,CSE 30,A01,083084,Eldon; John,5,0,80,75
1657580862231,CSE 30,B01,095061,Bhaskar; Nishant,9,0,50,41
1657580868257,CSE 100,A01,083659,Cao; Yingjun,5,4,70,65
1657580874281,CSE 134B,A01,083661,Powell; Thomas Allan,22,0,100,78
1657580880310,CSE 140,A01,083663,Gungor; Onat,15,0,85,70
1657580886333,CSE 140L,A01,083088,Eldon; John,21,0,100,79
1657580892355,CSE 175,A01,083665,Kumar; Rakesh,3,0,25,22
1657580898378,CSE 190,A00,092507,Dubnov; Shlomo,8,0,20,12
1657580904405,ECE 45,A01,083139,Congero; Spencer William,6,0,75,69
1657580910431,ECE 65,A50,083695,Saad; Andrew S,12,0,30,18
1657580910431,ECE 65,A51,095125,Saad; Andrew S,24,0,26,2
1657580916481,ECE 109,A01,091882,Touri; Behrouz,19,0,70,51
1657580922505,ECE 180,A00,083140,Abi Samra; Nicholas Camill,1,0,30,29
1657580922505,ECE 180,B00,083141,Abi Samra; Nicholas Camill,0,0,30,30
1657580928527,MATH 10A,A01,083735,Patchell; Gregory David,2,0,30,28
1657580928527,MATH 10A,A02,083736,Patchell; Gregory David,20,0,30,10
1657580928527,MATH 10A,A03,083737,Patchell; Gregory David,16,0,30,14
1657580934556,MATH 10B,A01,083207,Lim; Seonhee,8,0,34,26
1657580934556,MATH 10B,A02,083208,Lim; Seonhee,9,0,35,26
1657580934556,MATH 10B,A03,093472,Lim; Seonhee,7,0,34,27
1657580934556,MATH 10B,B01,083739,Sinha; Shubham,12,0,30,18
1657580940582,MATH 18,A01,083743,Cinel; Cameron Alexander,7,0,30,23
1657580940582,MATH 18,A02,083744,Cinel; Cameron Alexander,17,0,30,13
1657580940582,MATH 18,A03,083745,Cinel; Cameron Alexander,9,0,30,21
1657580940582,MATH 18,B01,083748,Rideout; David Porter,5,0,37,32
1657580940582,MATH 18,B02,083749,Rideout; David Porter,5,0,36,31
1657580940582,MATH 18,B03,083750,Rideout; David Porter,3,0,37,34
1657580940582,MATH 18,B04,083751,Rideout; David Porter,6,0,36,30
1657580940582,MATH 18,B05,093473,Rideout; David Porter,6,0,36,30
1657580940582,MATH 18,B06,093474,Rideout; David Porter,6,0,36,30
1657580946605,MATH 20A,A01,083754,Zheng; Zequn,14,0,40,26
1657580952633,MATH 20B,A01,083756,Briones; Jor-el Thomas Caparas,4,0,36,32
1657580952633,MATH 20B,A02,083757,Briones; Jor-el Thomas Caparas,1,0,36,35
1657580952633,MATH 20B,A03,093475,Briones; Jor-el Thomas Caparas,2,0,36,34
1657580958663,MATH 20C,A01,083760,Briones; Jor-el Thomas Caparas,1,0,35,34
1657580958663,MATH 20C,A02,083761,Briones; Jor-el Thomas Caparas,8,0,35,27
1657580958663,MATH 20C,A03,093476,Briones; Jor-el Thomas Caparas,0,1,36,36
1657580958663,MATH 20C,B01,083762,Bach; Quang Tran,1,0,30,29
1657580964687,MATH 20D,A01,083765,Tran; Brian Kha,5,0,30,25
1657580964687,MATH 20D,A02,083766,Tran; Brian Kha,5,0,30,25
1657580964687,MATH 20D,A03,083767,Tran; Brian Kha,5,0,30,25
1657580970726,MATH 20E,A01,083771,Ganguly; Soumya,9,0,32,23
1657580970726,MATH 20E,A02,083772,Ganguly; Soumya,6,0,32,26
1657580970726,MATH 20E,B01,083773,Ciotti; Benjamin,20,0,35,15
1657580970726,MATH 20E,B02,083774,Ciotti; Benjamin,18,0,35,17
1657580976755,MATH 103A,A01,083777,Greenfeld; Be'Eri,3,0,36,33
1657580976755,MATH 103A,A02,083778,Greenfeld; Be'Eri,5,0,36,31
1657580976755,MATH 103A,A03,093561,Greenfeld; Be'Eri,5,0,36,31
1657580976755,MATH 103A,B01,083779,Greenfeld; Be'Eri,7,0,36,29
1657580976755,MATH 103A,B02,083780,Greenfeld; Be'Eri,4,0,36,32
1657580976755,MATH 103A,B03,093562,Greenfeld; Be'Eri,3,0,36,33
1657580982778,MATH 105,A01,085443,Carter; Anne Toulson,15,0,35,20
1657580982778,MATH 105,A02,093477,Carter; Anne Toulson,20,0,35,15
1657580988806,MATH 109,A01,083213,Ganzberger; Geoffrey Michael,2,0,34,32
1657580988806,MATH 109,A02,083214,Ganzberger; Geoffrey Michael,4,0,34,30
1657580988806,MATH 109,A03,093478,Ganzberger; Geoffrey Michael,2,0,34,32
1657580988806,MATH 109,B01,083215,Ganzberger; Geoffrey Michael,1,0,32,31
1657580988806,MATH 109,B02,083216,Ganzberger; Geoffrey Michael,2,0,32,30
1657580988806,MATH 109,B03,093479,Ganzberger; Geoffrey Michael,8,0,32,24
1657580994831,MATH 142A,A01,083219,Chow; Bennett,7,0,32,25
1657580994831,MATH 142A,A02,083220,Chow; Bennett,10,0,32,22
1657580994831,MATH 142A,A03,093480,Chow; Bennett,8,0,32,24
1657580994831,MATH 142A,B03,093481,Chow; Bennett,8,0,32,24
1657580994831,MATH 142A,B04,093558,Chow; Bennett,13,0,32,19
1657580994831,MATH 142A,B05,093559,Chow; Bennett,6,0,32,26
1657581000862,MATH 193A,A01,083224,Rotar; Vladimir,8,0,34,26
1657581000862,MATH 193A,A02,083225,Rotar; Vladimir,9,0,34,25
1657581000862,MATH 193A,A03,083781,Rotar; Vladimir,5,0,34,29
1657581000862,MATH 193A,A04,083782,Rotar; Vladimir,10,0,34,24
1657581000862,MATH 193A,A05,093482,Rotar; Vladimir,10,0,34,24
1657581006886,MATH 197,001,091859,McAuley; Julian John,9999,0,9999,0
1657581006886,MATH 197,002,095566,Kedlaya; Kiran S.,9997,0,9999,2
1657581006886,MATH 197,003,095567,Xiao; Ming,9999,0,9999,0
1657581006886,MATH 197,004,095571,Perols; Johan Lars,9998,0,9999,1
1657581013953,COGS 9,A01,083615,Shannon; Kyle Michael,9,0,75,66
1657581019978,COGS 11,A01,083617,Boyle; Mary E. T.,23,0,48,25
1657581026001,COGS 13,A01,083071,Bastos; Amalia Pinkusfeld,11,0,71,60
1657581032048,COGS 14A,A01,092681,Semenuks; Arturs,5,1,100,95
1657581038074,COGS 14B,A01,083073,Cheng; Tzu-Han,6,0,63,57
1657581044100,COGS 17,A01,092677,Semenuks; Arturs,6,0,81,75
1657581050124,COGS 100,A01,083619,Allen; Michael Gordon,17,0,70,53
1657581056150,COGS 101A,A01,083621,Davis; Joshua Daniel,9,0,68,59
1657581062174,COGS 101B,A01,091572,Allen; Michael Gordon,12,0,65,53
1657581068205,COGS 101C,A01,083625,Delgado; Tania,17,0,35,18
1657581074227,COGS 107A,A01,083627,Boyle; Mary E. T.,13,0,60,47
1657581080250,COGS 118A,A01,083075,Gupta; Anjum,21,0,76,55
1657581086276,CSE 3,A50,083646,Miranda; Gregory Joseph,24,0,50,26
1657581092299,CSE 8A,A50,083650,Miranda; Gregory Joseph,17,1,56,39
1657581098328,CSE 11,A01,083080,Cao; Yingjun,6,15,40,34
1657581104350,CSE 12,A01,083652,Krause-Levy; Sophia Louisa,28,1,120,92
1657581110374,CSE 15L,A01,083654,Morris; Justin Loren,9,0,50,41
1657581110374,CSE 15L,A02,083655,Morris; Justin Loren,9,0,50,41
1657581116396,CSE 20,A01,083657,Tran; Khoa Dang,39,0,80,41
1657581122424,CSE 21,A01,095574,Bach; Quang Tran,22,0,48,26
1657581128447,CSE 30,A01,083084,Eldon; John,5,0,80,75
1657581128447,CSE 30,B01,095061,Bhaskar; Nishant,9,0,50,41
1657581134479,CSE 100,A01,083659,Cao; Yingjun,5,4,70,65
1657581140505,CSE 134B,A01,083661,Powell; Thomas Allan,22,0,100,78
1657581146528,CSE 140,A01,083663,Gungor; Onat,15,0,85,70
1657581152553,CSE 140L,A01,083088,Eldon; John,21,0,100,79
1657581158577,CSE 175,A01,083665,Kumar; Rakesh,3,0,25,22
1657581164600,CSE 190,A00,092507,Dubnov; Shlomo,8,0,20,12
1657581170627,ECE 45,A01,083139,Congero; Spencer William,6,0,75,69
1657581176655,ECE 65,A50,083695,Saad; Andrew S,12,0,30,18
1657581176655,ECE 65,A51,095125,Saad; Andrew S,24,0,26,2
1657581182682,ECE 109,A01,091882,Touri; Behrouz,19,0,70,51
1657581188708,ECE 180,A00,083140,Abi Samra; Nicholas Camill,1,0,30,29
1657581188708,ECE 180,B00,083141,Abi Samra; Nicholas Camill,0,0,30,30
1657581194732,MATH 10A,A01,083735,Patchell; Gregory David,2,0,30,28
1657581194732,MATH 10A,A02,083736,Patchell; Gregory David,20,0,30,10
1657581194732,MATH 10A,A03,083737,Patchell; Gregory David,16,0,30,14
1657581200764,MATH 10B,A01,083207,Lim; Seonhee,8,0,34,26
1657581200764,MATH 10B,A02,083208,Lim; Seonhee,9,0,35,26
1657581200764,MATH 10B,A03,093472,Lim; Seonhee,7,0,34,27
1657581200764,MATH 10B,B01,083739,Sinha; Shubham,12,0,30,18
1657581206789,MATH 18,A01,083743,Cinel; Cameron Alexander,7,0,30,23
1657581206789,MATH 18,A02,083744,Cinel; Cameron Alexander,17,0,30,13
1657581206789,MATH 18,A03,083745,Cinel; Cameron Alexander,9,0,30,21
1657581206789,MATH 18,B01,083748,Rideout; David Porter,5,0,37,32
1657581206789,MATH 18,B02,083749,Rideout; David Porter,5,0,36,31
1657581206789,MATH 18,B03,083750,Rideout; David Porter,3,0,37,34
1657581206789,MATH 18,B04,083751,Rideout; David Porter,6,0,36,30
1657581206789,MATH 18,B05,093473,Rideout; David Porter,6,0,36,30
1657581206789,MATH 18,B06,093474,Rideout; David Porter,6,0,36,30
1657581212812,MATH 20A,A01,083754,Zheng; Zequn,14,0,40,26
1657581218836,MATH 20B,A01,083756,Briones; Jor-el Thomas Caparas,4,0,36,32
1657581218836,MATH 20B,A02,083757,Briones; Jor-el Thomas Caparas,1,0,36,35
1657581218836,MATH 20B,A03,093475,Briones; Jor-el Thomas Caparas,2,0,36,34
1657581224869,MATH 20C,A01,083760,Briones; Jor-el Thomas Caparas,1,0,35,34
1657581224869,MATH 20C,A02,083761,Briones; Jor-el Thomas Caparas,8,0,35,27
1657581224869,MATH 20C,A03,093476,Briones; Jor-el Thomas Caparas,0,1,36,36
1657581224869,MATH 20C,B01,083762,Bach; Quang Tran,1,0,30,29
1657581230895,MATH 20D,A01,083765,Tran; Brian Kha,5,0,30,25
1657581230895,MATH 20D,A02,083766,Tran; Brian Kha,5,0,30,25
1657581230895,MATH 20D,A03,083767,Tran; Brian Kha,5,0,30,25
1657581236923,MATH 20E,A01,083771,Ganguly; Soumya,9,0,32,23
1657581236923,MATH 20E,A02,083772,Ganguly; Soumya,6,0,32,26
1657581236923,MATH 20E,B01,083773,Ciotti; Benjamin,20,0,35,15
1657581236923,MATH 20E,B02,083774,Ciotti; Benjamin,18,0,35,17
1657581242952,MATH 103A,A01,083777,Greenfeld; Be'Eri,3,0,36,33
1657581242952,MATH 103A,A02,083778,Greenfeld; Be'Eri,5,0,36,31
1657581242952,MATH 103A,A03,093561,Greenfeld; Be'Eri,5,0,36,31
1657581242952,MATH 103A,B01,083779,Greenfeld; Be'Eri,7,0,36,29
1657581242952,MATH 103A,B02,083780,Greenfeld; Be'Eri,4,0,36,32
1657581242952,MATH 103A,B03,093562,Greenfeld; Be'Eri,3,0,36,33
1657581248981,MATH 105,A01,085443,Carter; Anne Toulson,15,0,35,20
1657581248981,MATH 105,A02,093477,Carter; Anne Toulson,20,0,35,15
1657581255011,MATH 109,A01,083213,Ganzberger; Geoffrey Michael,2,0,34,32
1657581255011,MATH 109,A02,083214,Ganzberger; Geoffrey Michael,4,0,34,30
1657581255011,MATH 109,A03,093478,Ganzberger; Geoffrey Michael,2,0,34,32
1657581255011,MATH 109,B01,083215,Ganzberger; Geoffrey Michael,1,0,32,31
1657581255011,MATH 109,B02,083216,Ganzberger; Geoffrey Michael,2,0,32,30
1657581255011,MATH 109,B03,093479,Ganzberger; Geoffrey Michael,8,0,32,24
1657581261035,MATH 142A,A01,083219,Chow; Bennett,7,0,32,25
1657581261035,MATH 142A,A02,083220,Chow; Bennett,10,0,32,22
1657581261035,MATH 142A,A03,093480,Chow; Bennett,8,0,32,24
1657581261035,MATH 142A,B03,093481,Chow; Bennett,8,0,32,24
1657581261035,MATH 142A,B04,093558,Chow; Bennett,13,0,32,19
1657581261035,MATH 142A,B05,093559,Chow; Bennett,6,0,32,26
1657581267059,MATH 193A,A01,083224,Rotar; Vladimir,8,0,34,26
1657581267059,MATH 193A,A02,083225,Rotar; Vladimir,9,0,34,25
1657581267059,MATH 193A,A03,083781,Rotar; Vladimir,5,0,34,29
1657581267059,MATH 193A,A04,083782,Rotar; Vladimir,10,0,34,24
1657581267059,MATH 193A,A05,093482,Rotar; Vladimir,10,0,34,24
1657581273081,MATH 197,001,091859,McAuley; Julian John,9999,0,9999,0
1657581273081,MATH 197,002,095566,Kedlaya; Kiran S.,9997,0,9999,2
1657581273081,MATH 197,003,095567,Xiao; Ming,9999,0,9999,0
1657581273081,MATH 197,004,095571,Perols; Johan Lars,9998,0,9999,1
1657581280143,COGS 9,A01,083615,Shannon; Kyle Michael,9,0,75,66
1657581286166,COGS 11,A01,083617,Boyle; Mary E. T.,23,0,48,25
1657581292193,COGS 13,A01,083071,Bastos; Amalia Pinkusfeld,11,0,71,60
1657581298219,COGS 14A,A01,092681,Semenuks; Arturs,5,1,100,95
1657581304244,COGS 14B,A01,083073,Cheng; Tzu-Han,6,0,63,57
1657581310267,COGS 17,A01,092677,Semenuks; Arturs,6,0,81,75
1657581316288,COGS 100,A01,083619,Allen; Michael Gordon,17,0,70,53
1657581322314,COGS 101A,A01,083621,Davis; Joshua Daniel,9,0,68,59
1657581328351,COGS 101B,A01,091572,Allen; Michael Gordon,12,0,65,53
1657581334378,COGS 101C,A01,083625,Delgado; Tania,17,0,35,18
1657581340402,COGS 107A,A01,083627,Boyle; Mary E. T.,13,0,60,47
1657581346428,COGS 118A,A01,083075,Gupta; Anjum,21,0,76,55
1657581352528,CSE 3,A50,083646,Miranda; Gregory Joseph,24,0,50,26
1657581358555,CSE 8A,A50,083650,Miranda; Gregory Joseph,17,1,56,39
1657581364582,CSE 11,A01,083080,Cao; Yingjun,6,15,40,34
1657581370607,CSE 12,A01,083652,Krause-Levy; Sophia Louisa,28,1,120,92
1657581376631,CSE 15L,A01,083654,Morris; Justin Loren,9,0,50,41
1657581376631,CSE 15L,A02,083655,Morris; Justin Loren,9,0,50,41
1657581382652,CSE 20,A01,083657,Tran; Khoa Dang,39,0,80,41
1657581388678,CSE 21,A01,095574,Bach; Quang Tran,22,0,48,26
1657581394704,CSE 30,A01,083084,Eldon; John,5,0,80,75
1657581394704,CSE 30,B01,095061,Bhaskar; Nishant,9,0,50,41
1657581400726,CSE 100,A01,083659,Cao; Yingjun,5,4,70,65
1657581406752,CSE 134B,A01,083661,Powell; Thomas Allan,22,0,100,78
1657581412780,CSE 140,A01,083663,Gungor; Onat,15,0,85,70
1657581418802,CSE 140L,A01,083088,Eldon; John,21,0,100,79
1657581424836,CSE 175,A01,083665,Kumar; Rakesh,3,0,25,22
1657581430860,CSE 190,A00,092507,Dubnov; Shlomo,8,0,20,12
1657581436888,ECE 45,A01,083139,Congero; Spencer William,6,0,75,69
1657581442911,ECE 65,A50,083695,Saad; Andrew S,12,0,30,18
1657581442911,ECE 65,A51,095125,Saad; Andrew S,24,0,26,2
1657581448937,ECE 109,A01,091882,Touri; Behrouz,19,0,70,51
1657581454959,ECE 180,A00,083140,Abi Samra; Nicholas Camill,1,0,30,29
1657581454959,ECE 180,B00,083141,Abi Samra; Nicholas Camill,0,0,30,30
1657581460981,MATH 10A,A01,083735,Patchell; Gregory David,2,0,30,28
1657581460981,MATH 10A,A02,083736,Patchell; Gregory David,20,0,30,10
1657581460981,MATH 10A,A03,083737,Patchell; Gregory David,16,0,30,14
1657581467013,MATH 10B,A01,083207,Lim; Seonhee,8,0,34,26
1657581467013,MATH 10B,A02,083208,Lim; Seonhee,9,0,35,26
1657581467013,MATH 10B,A03,093472,Lim; Seonhee,7,0,34,27
1657581467013,MATH 10B,B01,083739,Sinha; Shubham,12,0,30,18
1657581473037,MATH 18,A01,083743,Cinel; Cameron Alexander,7,0,30,23
1657581473037,MATH 18,A02,083744,Cinel; Cameron Alexander,17,0,30,13
1657581473037,MATH 18,A03,083745,Cinel; Cameron Alexander,9,0,30,21
1657581473037,MATH 18,B01,083748,Rideout; David Porter,5,0,37,32
1657581473037,MATH 18,B02,083749,Rideout; David Porter,5,0,36,31
1657581473037,MATH 18,B03,083750,Rideout; David Porter,3,0,37,34
1657581473037,MATH 18,B04,083751,Rideout; David Porter,6,0,36,30
1657581473037,MATH 18,B05,093473,Rideout; David Porter,6,0,36,30
1657581473037,MATH 18,B06,093474,Rideout; David Porter,6,0,36,30
1657581479064,MATH 20A,A01,083754,Zheng; Zequn,14,0,40,26
1657581485096,MATH 20B,A01,083756,Briones; Jor-el Thomas Caparas,4,0,36,32
1657581485096,MATH 20B,A02,083757,Briones; Jor-el Thomas Caparas,1,0,36,35
1657581485096,MATH 20B,A03,093475,Briones; Jor-el Thomas Caparas,2,0,36,34
1657581491120,MATH 20C,A01,083760,Briones; Jor-el Thomas Caparas,1,0,35,34
1657581491120,MATH 20C,A02,083761,Briones; Jor-el Thomas Caparas,8,0,35,27
1657581491120,MATH 20C,A03,093476,Briones; Jor-el Thomas Caparas,0,1,36,36
1657581491120,MATH 20C,B01,083762,Bach; Quang Tran,1,0,30,29
1657581497143,MATH 20D,A01,083765,Tran; Brian Kha,5,0,30,25
1657581497143,MATH 20D,A02,083766,Tran; Brian Kha,5,0,30,25
1657581497143,MATH 20D,A03,083767,Tran; Brian Kha,5,0,30,25
1657581503167,MATH 20E,A01,083771,Ganguly; Soumya,9,0,32,23
1657581503167,MATH 20E,A02,083772,Ganguly; Soumya,6,0,32,26
1657581503167,MATH 20E,B01,083773,Ciotti; Benjamin,20,0,35,15
1657581503167,MATH 20E,B02,083774,Ciotti; Benjamin,18,0,35,17
1657581509199,MATH 103A,A01,083777,Greenfeld; Be'Eri,3,0,36,33
1657581509199,MATH 103A,A02,083778,Greenfeld; Be'Eri,5,0,36,31
1657581509199,MATH 103A,A03,093561,Greenfeld; Be'Eri,5,0,36,31
1657581509199,MATH 103A,B01,083779,Greenfeld; Be'Eri,7,0,36,29
1657581509199,MATH 103A,B02,083780,Greenfeld; Be'Eri,4,0,36,32
1657581509199,MATH 103A,B03,093562,Greenfeld; Be'Eri,3,0,36,33
1657581515225,MATH 105,A01,085443,Carter; Anne Toulson,15,0,35,20
1657581515225,MATH 105,A02,093477,Carter; Anne Toulson,20,0,35,15
1657581521261,MATH 109,A01,083213,Ganzberger; Geoffrey Michael,2,0,34,32
1657581521261,MATH 109,A02,083214,Ganzberger; Geoffrey Michael,4,0,34,30
1657581521261,MATH 109,A03,093478,Ganzberger; Geoffrey Michael,2,0,34,32
1657581521261,MATH 109,B01,083215,Ganzberger; Geoffrey Michael,1,0,32,31
1657581521261,MATH 109,B02,083216,Ganzberger; Geoffrey Michael,2,0,32,30
1657581521261,MATH 109,B03,093479,Ganzberger; Geoffrey Michael,8,0,32,24
1657581527297,MATH 142A,A01,083219,Chow; Bennett,7,0,32,25
1657581527297,MATH 142A,A02,083220,Chow; Bennett,10,0,32,22
1657581527297,MATH 142A,A03,093480,Chow; Bennett,8,0,32,24
1657581527297,MATH 142A,B03,093481,Chow; Bennett,8,0,32,24
1657581527297,MATH 142A,B04,093558,Chow; Bennett,13,0,32,19
1657581527297,MATH 142A,B05,093559,Chow; Bennett,6,0,32,26
1657581533320,MATH 193A,A01,083224,Rotar; Vladimir,8,0,34,26
1657581533320,MATH 193A,A02,083225,Rotar; Vladimir,9,0,34,25
1657581533320,MATH 193A,A03,083781,Rotar; Vladimir,5,0,34,29
1657581533320,MATH 193A,A04,083782,Rotar; Vladimir,10,0,34,24
1657581533320,MATH 193A,A05,093482,Rotar; Vladimir,10,0,34,24
1657581539348,MATH 197,001,091859,McAuley; Julian John,9999,0,9999,0
1657581539348,MATH 197,002,095566,Kedlaya; Kiran S.,9997,0,9999,2
1657581539348,MATH 197,003,095567,Xiao; Ming,9999,0,9999,0
1657581539348,MATH 197,004,095571,Perols; Johan Lars,9998,0,9999,1
1657581546411,COGS 9,A01,083615,Shannon; Kyle Michael,9,0,75,66
1657581552437,COGS 11,A01,083617,Boyle; Mary E. T.,23,0,48,25
1657581558465,COGS 13,A01,083071,Bastos; Amalia Pinkusfeld,11,0,71,60
1657581564486,COGS 14A,A01,092681,Semenuks; Arturs,5,1,100,95
1657581570512,COGS 14B,A01,083073,Cheng; Tzu-Han,6,0,63,57
1657581576535,COGS 17,A01,092677,Semenuks; Arturs,6,0,81,75
1657581582563,COGS 100,A01,083619,Allen; Michael Gordon,17,0,70,53
1657581588587,COGS 101A,A01,083621,Davis; Joshua Daniel,9,0,68,59
1657581594610,COGS 101B,A01,091572,Allen; Michael Gordon,12,0,65,53
1657581600638,COGS 101C,A01,083625,Delgado; Tania,17,0,35,18
1657581606667,COGS 107A,A01,083627,Boyle; Mary E. T.,13,0,60,47
1657581612703,COGS 118A,A01,083075,Gupta; Anjum,21,0,76,55
1657581618728,CSE 3,A50,083646,Miranda; Gregory Joseph,24,0,50,26
1657581624752,CSE 8A,A50,083650,Miranda; Gregory Joseph,17,1,56,39
1657581630779,CSE 11,A01,083080,Cao; Yingjun,6,15,40,34
1657581636801,CSE 12,A01,083652,Krause-Levy; Sophia Louisa,28,1,120,92
1657581642826,CSE 15L,A01,083654,Morris; Justin Loren,9,0,50,41
1657581642826,CSE 15L,A02,083655,Morris; Justin Loren,9,0,50,41
1657581648849,CSE 20,A01,083657,Tran; Khoa Dang,39,0,80,41
1657581654876,CSE 21,A01,095574,Bach; Quang Tran,22,0,48,26
1657581660901,CSE 30,A01,083084,Eldon; John,5,0,80,75
1657581660901,CSE 30,B01,095061,Bhaskar; Nishant,9,0,50,41
1657581666939,CSE 100,A01,083659,Cao; Yingjun,5,4,70,65
1657581672960,CSE 134B,A01,083661,Powell; Thomas Allan,22,0,100,78
1657581678984,CSE 140,A01,083663,Gungor; Onat,15,0,85,70
1657581685006,CSE 140L,A01,083088,Eldon; John,21,0,100,79
1657581691029,CSE 175,A01,083665,Kumar; Rakesh,3,0,25,22
1657581697051,CSE 190,A00,092507,Dubnov; Shlomo,8,0,20,12
1657581703075,ECE 45,A01,083139,Congero; Spencer William,6,0,75,69
1657581709107,ECE 65,A50,083695,Saad; Andrew S,12,0,30,18
1657581709107,ECE 65,A51,095125,Saad; Andrew S,24,0,26,2
1657581715132,ECE 109,A01,091882,Touri; Behrouz,19,0,70,51
1657581721165,ECE 180,A00,083140,Abi Samra; Nicholas Camill,1,0,30,29
1657581721165,ECE 180,B00,083141,Abi Samra; Nicholas Camill,0,0,30,30
1657581727188,MATH 10A,A01,083735,Patchell; Gregory David,2,0,30,28
1657581727188,MATH 10A,A02,083736,Patchell; Gregory David,20,0,30,10
1657581727188,MATH 10A,A03,083737,Patchell; Gregory David,16,0,30,14
1657581733216,MATH 10B,A01,083207,Lim; Seonhee,8,0,34,26
1657581733216,MATH 10B,A02,083208,Lim; Seonhee,9,0,35,26
1657581733216,MATH 10B,A03,093472,Lim; Seonhee,7,0,34,27
1657581733216,MATH 10B,B01,083739,Sinha; Shubham,12,0,30,18
1657581739250,MATH 18,A01,083743,Cinel; Cameron Alexander,7,0,30,23
1657581739250,MATH 18,A02,083744,Cinel; Cameron Alexander,17,0,30,13
1657581739250,MATH 18,A03,083745,Cinel; Cameron Alexander,9,0,30,21
1657581739250,MATH 18,B01,083748,Rideout; David Porter,5,0,37,32
1657581739250,MATH 18,B02,083749,Rideout; David Porter,5,0,36,31
1657581739250,MATH 18,B03,083750,Rideout; David Porter,3,0,37,34
1657581739250,MATH 18,B04,083751,Rideout; David Porter,6,0,36,30
1657581739250,MATH 18,B05,093473,Rideout; David Porter,6,0,36,30
1657581739250,MATH 18,B06,093474,Rideout; David Porter,6,0,36,30
1657581745272,MATH 20A,A01,083754,Zheng; Zequn,14,0,40,26
1657581751295,MATH 20B,A01,083756,Briones; Jor-el Thomas Caparas,4,0,36,32
1657581751295,MATH 20B,A02,083757,Briones; Jor-el Thomas Caparas,1,0,36,35
1657581751295,MATH 20B,A03,093475,Briones; Jor-el Thomas Caparas,2,0,36,34
1657581757319,MATH 20C,A01,083760,Briones; Jor-el Thomas Caparas,1,0,35,34
1657581757319,MATH 20C,A02,083761,Briones; Jor-el Thomas Caparas,8,0,35,27
1657581757319,MATH 20C,A03,093476,Briones; Jor-el Thomas Caparas,0,1,36,36
1657581757319,MATH 20C,B01,083762,Bach; Quang Tran,1,0,30,29
1657581763349,MATH 20D,A01,083765,Tran; Brian Kha,5,0,30,25
1657581763349,MATH 20D,A02,083766,Tran; Brian Kha,5,0,30,25
1657581763349,MATH 20D,A03,083767,Tran; Brian Kha,5,0,30,25
1657581769372,MATH 20E,A01,083771,Ganguly; Soumya,9,0,32,23
1657581769372,MATH 20E,A02,083772,Ganguly; Soumya,6,0,32,26
1657581769372,MATH 20E,B01,083773,Ciotti; Benjamin,20,0,35,15
1657581769372,MATH 20E,B02,083774,Ciotti; Benjamin,18,0,35,17
1657581775396,MATH 103A,A01,083777,Greenfeld; Be'Eri,3,0,36,33
1657581775396,MATH 103A,A02,083778,Greenfeld; Be'Eri,5,0,36,31
1657581775396,MATH 103A,A03,093561,Greenfeld; Be'Eri,5,0,36,31
1657581775396,MATH 103A,B01,083779,Greenfeld; Be'Eri,7,0,36,29
1657581775396,MATH 103A,B02,083780,Greenfeld; Be'Eri,4,0,36,32
1657581775396,MATH 103A,B03,093562,Greenfeld; Be'Eri,3,0,36,33
1657581781421,MATH 105,A01,085443,Carter; Anne Toulson,15,0,35,20
1657581781421,MATH 105,A02,093477,Carter; Anne Toulson,20,0,35,15
1657581787443,MATH 109,A01,083213,Ganzberger; Geoffrey Michael,2,0,34,32
1657581787443,MATH 109,A02,083214,Ganzberger; Geoffrey Michael,4,0,34,30
1657581787443,MATH 109,A03,093478,Ganzberger; Geoffrey Michael,2,0,34,32
1657581787443,MATH 109,B01,083215,Ganzberger; Geoffrey Michael,1,0,32,31
1657581787443,MATH 109,B02,083216,Ganzberger; Geoffrey Michael,2,0,32,30
1657581787443,MATH 109,B03,093479,Ganzberger; Geoffrey Michael,8,0,32,24
1657581793466,MATH 142A,A01,083219,Chow; Bennett,7,0,32,25
1657581793466,MATH 142A,A02,083220,Chow; Bennett,10,0,32,22
1657581793466,MATH 142A,A03,093480,Chow; Bennett,8,0,32,24
1657581793466,MATH 142A,B03,093481,Chow; Bennett,8,0,32,24
1657581793466,MATH 142A,B04,093558,Chow; Bennett,13,0,32,19
1657581793466,MATH 142A,B05,093559,Chow; Bennett,6,0,32,26
1657581799492,MATH 193A,A01,083224,Rotar; Vladimir,8,0,34,26
1657581799492,MATH 193A,A02,083225,Rotar; Vladimir,9,0,34,25
1657581799492,MATH 193A,A03,083781,Rotar; Vladimir,5,0,34,29
1657581799492,MATH 193A,A04,083782,Rotar; Vladimir,10,0,34,24
1657581799492,MATH 193A,A05,093482,Rotar; Vladimir,10,0,34,24
1657581805523,MATH 197,001,091859,McAuley; Julian John,9999,0,9999,0
1657581805523,MATH 197,002,095566,Kedlaya; Kiran S.,9997,0,9999,2
1657581805523,MATH 197,003,095567,Xiao; Ming,9999,0,9999,0
1657581805523,MATH 197,004,095571,Perols; Johan Lars,9998,0,9999,1
1657581812582,COGS 9,A01,083615,Shannon; Kyle Michael,9,0,75,66
1657581818618,COGS 11,A01,083617,Boyle; Mary E. T.,23,0,48,25
1657581824640,COGS 13,A01,083071,Bastos; Amalia Pinkusfeld,11,0,71,60
1657581830663,COGS 14A,A01,092681,Semenuks; Arturs,5,1,100,95
1657581836685,COGS 14B,A01,083073,Cheng; Tzu-Han,6,0,63,57
1657581842710,COGS 17,A01,092677,Semenuks; Arturs,6,0,81,75
1657581848733,COGS 100,A01,083619,Allen; Michael Gordon,17,0,70,53
1657581854761,COGS 101A,A01,083621,Davis; Joshua Daniel,9,0,68,59
1657581860783,COGS 101B,A01,091572,Allen; Michael Gordon,12,0,65,53
1657581866806,COGS 101C,A01,083625,Delgado; Tania,17,0,35,18
1657581872835,COGS 107A,A01,083627,Boyle; Mary E. T.,13,0,60,47
1657581878861,COGS 118A,A01,083075,Gupta; Anjum,21,0,76,55
1657581884883,CSE 3,A50,083646,Miranda; Gregory Joseph,24,0,50,26
1657581890907,CSE 8A,A50,083650,Miranda; Gregory Joseph,17,1,56,39
1657581896940,CSE 11,A01,083080,Cao; Yingjun,6,15,40,34
1657581902969,CSE 12,A01,083652,Krause-Levy; Sophia Louisa,28,1,120,92
1657581908998,CSE 15L,A01,083654,Morris; Justin Loren,9,0,50,41
1657581908998,CSE 15L,A02,083655,Morris; Justin Loren,9,0,50,41
1657581915024,CSE 20,A01,083657,Tran; Khoa Dang,39,0,80,41
1657581921047,CSE 21,A01,095574,Bach; Quang Tran,22,0,48,26
1657581927073,CSE 30,A01,083084,Eldon; John,5,0,80,75
1657581927073,CSE 30,B01,095061,Bhaskar; Nishant,9,0,50,41
1657581933101,CSE 100,A01,083659,Cao; Yingjun,5,4,70,65
1657581939129,CSE 134B,A01,083661,Powell; Thomas Allan,22,0,100,78
1657581945151,CSE 140,A01,083663,Gungor; Onat,15,0,85,70
1657581951272,CSE 140L,A01,083088,Eldon; John,21,0,100,79
1657581957297,CSE 175,A01,083665,Kumar; Rakesh,3,0,25,22
1657581963327,CSE 190,A00,092507,Dubnov; Shlomo,8,0,20,12
1657581969349,ECE 45,A01,083139,Congero; Spencer William,6,0,75,69
1657581975379,ECE 65,A50,083695,Saad; Andrew S,12,0,30,18
1657581975379,ECE 65,A51,095125,Saad; Andrew S,24,0,26,2
1657581981411,ECE 109,A01,091882,Touri; Behrouz,19,0,70,51
1657581987435,ECE 180,A00,083140,Abi Samra; Nicholas Camill,1,0,30,29
1657581987435,ECE 180,B00,083141,Abi Samra; Nicholas Camill,0,0,30,30
1657581993458,MATH 10A,A01,083735,Patchell; Gregory David,2,0,30,28
1657581993458,MATH 10A,A02,083736,Patchell; Gregory David,20,0,30,10
1657581993458,MATH 10A,A03,083737,Patchell; Gregory David,16,0,30,14
1657581999481,MATH 10B,A01,083207,Lim; Seonhee,8,0,34,26
1657581999481,MATH 10B,A02,083208,Lim; Seonhee,9,0,35,26
1657581999481,MATH 10B,A03,093472,Lim; Seonhee,7,0,34,27
1657581999481,MATH 10B,B01,083739,Sinha; Shubham,12,0,30,18
1657582005511,MATH 18,A01,083743,Cinel; Cameron Alexander,7,0,30,23
1657582005511,MATH 18,A02,083744,Cinel; Cameron Alexander,17,0,30,13
1657582005511,MATH 18,A03,083745,Cinel; Cameron Alexander,9,0,30,21
1657582005511,MATH 18,B01,083748,Rideout; David Porter,5,0,37,32
1657582005511,MATH 18,B02,083749,Rideout; David Porter,5,0,36,31
1657582005511,MATH 18,B03,083750,Rideout; David Porter,3,0,37,34
1657582005511,MATH 18,B04,083751,Rideout; David Porter,6,0,36,30
1657582005511,MATH 18,B05,093473,Rideout; David Porter,6,0,36,30
1657582005511,MATH 18,B06,093474,Rideout; David Porter,6,0,36,30
1657582011538,MATH 20A,A01,083754,Zheng; Zequn,14,0,40,26
1657582017563,MATH 20B,A01,083756,Briones; Jor-el Thomas Caparas,4,0,36,32
1657582017563,MATH 20B,A02,083757,Briones; Jor-el Thomas Caparas,1,0,36,35
1657582017563,MATH 20B,A03,093475,Briones; Jor-el Thomas Caparas,2,0,36,34
1657582023593,MATH 20C,A01,083760,Briones; Jor-el Thomas Caparas,1,0,35,34
1657582023593,MATH 20C,A02,083761,Briones; Jor-el Thomas Caparas,8,0,35,27
1657582023593,MATH 20C,A03,093476,Briones; Jor-el Thomas Caparas,0,1,36,36
1657582023593,MATH 20C,B01,083762,Bach; Quang Tran,1,0,30,29
1657582029620,MATH 20D,A01,083765,Tran; Brian Kha,5,0,30,25
1657582029620,MATH 20D,A02,083766,Tran; Brian Kha,5,0,30,25
1657582029620,MATH 20D,A03,083767,Tran; Brian Kha,5,0,30,25
1657582035661,MATH 20E,A01,083771,Ganguly; Soumya,9,0,32,23
1657582035661,MATH 20E,A02,083772,Ganguly; Soumya,6,0,32,26
1657582035661,MATH 20E,B01,083773,Ciotti; Benjamin,20,0,35,15
1657582035661,MATH 20E,B02,083774,Ciotti; Benjamin,18,0,35,17
1657582041693,MATH 103A,A01,083777,Greenfeld; Be'Eri,3,0,36,33
1657582041693,MATH 103A,A02,083778,Greenfeld; Be'Eri,5,0,36,31
1657582041693,MATH 103A,A03,093561,Greenfeld; Be'Eri,5,0,36,31
1657582041693,MATH 103A,B01,083779,Greenfeld; Be'Eri,7,0,36,29
1657582041693,MATH 103A,B02,083780,Greenfeld; Be'Eri,4,0,36,32
1657582041693,MATH 103A,B03,093562,Greenfeld; Be'Eri,3,0,36,33
1657582047721,MATH 105,A01,085443,Carter; Anne Toulson,15,0,35,20
1657582047721,MATH 105,A02,093477,Carter; Anne Toulson,20,0,35,15
1657582053747,MATH 109,A01,083213,Ganzberger; Geoffrey Michael,2,0,34,32
1657582053747,MATH 109,A02,083214,Ganzberger; Geoffrey Michael,4,0,34,30
1657582053747,MATH 109,A03,093478,Ganzberger; Geoffrey Michael,2,0,34,32
1657582053747,MATH 109,B01,083215,Ganzberger; Geoffrey Michael,1,0,32,31
1657582053747,MATH 109,B02,083216,Ganzberger; Geoffrey Michael,2,0,32,30
1657582053747,MATH 109,B03,093479,Ganzberger; Geoffrey Michael,8,0,32,24
1657582059771,MATH 142A,A01,083219,Chow; Bennett,7,0,32,25
1657582059771,MATH 142A,A02,083220,Chow; Bennett,10,0,32,22
1657582059771,MATH 142A,A03,093480,Chow; Bennett,8,0,32,24
1657582059771,MATH 142A,B03,093481,Chow; Bennett,8,0,32,24
1657582059771,MATH 142A,B04,093558,Chow; Bennett,13,0,32,19
1657582059771,MATH 142A,B05,093559,Chow; Bennett,6,0,32,26
1657582065794,MATH 193A,A01,083224,Rotar; Vladimir,8,0,34,26
1657582065794,MATH 193A,A02,083225,Rotar; Vladimir,9,0,34,25
1657582065794,MATH 193A,A03,083781,Rotar; Vladimir,5,0,34,29
1657582065794,MATH 193A,A04,083782,Rotar; Vladimir,10,0,34,24
1657582065794,MATH 193A,A05,093482,Rotar; Vladimir,10,0,34,24
1657582071817,MATH 197,001,091859,McAuley; Julian John,9999,0,9999,0
1657582071817,MATH 197,002,095566,Kedlaya; Kiran S.,9997,0,9999,2
1657582071817,MATH 197,003,095567,Xiao; Ming,9999,0,9999,0
1657582071817,MATH 197,004,095571,Perols; Johan Lars,9998,0,9999,1
1657582078877,COGS 9,A01,083615,Shannon; Kyle Michael,9,0,75,66
1657582084899,COGS 11,A01,083617,Boyle; Mary E. T.,23,0,48,25
1657582090925,COGS 13,A01,083071,Bastos; Amalia Pinkusfeld,11,0,71,60
1657582096947,COGS 14A,A01,092681,Semenuks; Arturs,5,1,100,95
1657582102969,COGS 14B,A01,083073,Cheng; Tzu-Han,6,0,63,57
1657582108995,COGS 17,A01,092677,Semenuks; Arturs,6,0,81,75
1657582115020,COGS 100,A01,083619,Allen; Michael Gordon,17,0,70,53
1657582121046,COGS 101A,A01,083621,Davis; Joshua Daniel,9,0,68,59
1657582127068,COGS 101B,A01,091572,Allen; Michael Gordon,12,0,65,53
1657582133094,COGS 101C,A01,083625,Delgado; Tania,17,0,35,18
1657582139117,COGS 107A,A01,083627,Boyle; Mary E. T.,13,0,60,47
1657582145139,COGS 118A,A01,083075,Gupta; Anjum,21,0,76,55
1657582151163,CSE 3,A50,083646,Miranda; Gregory Joseph,24,0,50,26
1657582157187,CSE 8A,A50,083650,Miranda; Gregory Joseph,17,1,56,39
1657582163212,CSE 11,A01,083080,Cao; Yingjun,6,15,40,34
1657582169237,CSE 12,A01,083652,Krause-Levy; Sophia Louisa,28,1,120,92
1657582175277,CSE 15L,A01,083654,Morris; Justin Loren,9,0,50,41
1657582175277,CSE 15L,A02,083655,Morris; Justin Loren,9,0,50,41
1657582181302,CSE 20,A01,083657,Tran; Khoa Dang,39,0,80,41
1657582187325,CSE 21,A01,095574,Bach; Quang Tran,22,0,48,26
1657582193349,CSE 30,A01,083084,Eldon; John,5,0,80,75
1657582193349,CSE 30,B01,095061,Bhaskar; Nishant,9,0,50,41
1657582199372,CSE 100,A01,083659,Cao; Yingjun,5,4,70,65
1657582205398,CSE 134B,A01,083661,Powell; Thomas Allan,22,0,100,78
1657582211421,CSE 140,A01,083663,Gungor; Onat,15,0,85,70
1657582217445,CSE 140L,A01,083088,Eldon; John,21,0,100,79
1657582223466,CSE 175,A01,083665,Kumar; Rakesh,3,0,25,22
1657582229490,CSE 190,A00,092507,Dubnov; Shlomo,8,0,20,12
1657582235512,ECE 45,A01,083139,Congero; Spencer William,6,0,75,69
1657582241535,ECE 65,A50,083695,Saad; Andrew S,12,0,30,18
1657582241535,ECE 65,A51,095125,Saad; Andrew S,24,0,26,2
1657582247556,ECE 109,A01,091882,Touri; Behrouz,19,0,70,51
1657582253578,ECE 180,A00,083140,Abi Samra; Nicholas Camill,1,0,30,29
1657582253578,ECE 180,B00,083141,Abi Samra; Nicholas Camill,0,0,30,30
1657582259602,MATH 10A,A01,083735,Patchell; Gregory David,2,0,30,28
1657582259602,MATH 10A,A02,083736,Patchell; Gregory David,20,0,30,10
1657582259602,MATH 10A,A03,083737,Patchell; Gregory David,16,0,30,14
1657582265625,MATH 10B,A01,083207,Lim; Seonhee,8,0,34,26
1657582265625,MATH 10B,A02,083208,Lim; Seonhee,9,0,35,26
1657582265625,MATH 10B,A03,093472,Lim; Seonhee,7,0,34,27
1657582265625,MATH 10B,B01,083739,Sinha; Shubham,12,0,30,18
1657582271650,MATH 18,A01,083743,Cinel; Cameron Alexander,7,0,30,23
1657582271650,MATH 18,A02,083744,Cinel; Cameron Alexander,17,0,30,13
1657582271650,MATH 18,A03,083745,Cinel; Cameron Alexander,9,0,30,21
1657582271650,MATH 18,B01,083748,Rideout; David Porter,5,0,37,32
1657582271650,MATH 18,B02,083749,Rideout; David Porter,5,0,36,31
1657582271650,MATH 18,B03,083750,Rideout; David Porter,3,0,37,34
1657582271650,MATH 18,B04,083751,Rideout; David Porter,6,0,36,30
1657582271650,MATH 18,B05,093473,Rideout; David Porter,6,0,36,30
1657582271650,MATH 18,B06,093474,Rideout; David Porter,6,0,36,30
1657582277677,MATH 20A,A01,083754,Zheng; Zequn,14,0,40,26
1657582283704,MATH 20B,A01,083756,Briones; Jor-el Thomas Caparas,4,0,36,32
1657582283704,MATH 20B,A02,083757,Briones; Jor-el Thomas Caparas,1,0,36,35
1657582283704,MATH 20B,A03,093475,Briones; Jor-el Thomas Caparas,2,0,36,34
1657582289732,MATH 20C,A01,083760,Briones; Jor-el Thomas Caparas,1,0,35,34
1657582289732,MATH 20C,A02,083761,Briones; Jor-el Thomas Caparas,8,0,35,27
1657582289732,MATH 20C,A03,093476,Briones; Jor-el Thomas Caparas,0,1,36,36
1657582289732,MATH 20C,B01,083762,Bach; Quang Tran,1,0,30,29
1657582295759,MATH 20D,A01,083765,Tran; Brian Kha,5,0,30,25
1657582295759,MATH 20D,A02,083766,Tran; Brian Kha,5,0,30,25
1657582295759,MATH 20D,A03,083767,Tran; Brian Kha,5,0,30,25
1657582301788,MATH 20E,A01,083771,Ganguly; Soumya,9,0,32,23
1657582301788,MATH 20E,A02,083772,Ganguly; Soumya,6,0,32,26
1657582301788,MATH 20E,B01,083773,Ciotti; Benjamin,20,0,35,15
1657582301788,MATH 20E,B02,083774,Ciotti; Benjamin,18,0,35,17
1657582307812,MATH 103A,A01,083777,Greenfeld; Be'Eri,3,0,36,33
1657582307812,MATH 103A,A02,083778,Greenfeld; Be'Eri,5,0,36,31
1657582307812,MATH 103A,A03,093561,Greenfeld; Be'Eri,5,0,36,31
1657582307812,MATH 103A,B01,083779,Greenfeld; Be'Eri,7,0,36,29
1657582307812,MATH 103A,B02,083780,Greenfeld; Be'Eri,4,0,36,32
1657582307812,MATH 103A,B03,093562,Greenfeld; Be'Eri,3,0,36,33
1657582313844,MATH 105,A01,085443,Carter; Anne Toulson,15,0,35,20
1657582313844,MATH 105,A02,093477,Carter; Anne Toulson,20,0,35,15
1657582319872,MATH 109,A01,083213,Ganzberger; Geoffrey Michael,2,0,34,32
1657582319872,MATH 109,A02,083214,Ganzberger; Geoffrey Michael,4,0,34,30
1657582319872,MATH 109,A03,093478,Ganzberger; Geoffrey Michael,2,0,34,32
1657582319872,MATH 109,B01,083215,Ganzberger; Geoffrey Michael,1,0,32,31
1657582319872,MATH 109,B02,083216,Ganzberger; Geoffrey Michael,2,0,32,30
1657582319872,MATH 109,B03,093479,Ganzberger; Geoffrey Michael,8,0,32,24
1657582325902,MATH 142A,A01,083219,Chow; Bennett,7,0,32,25
1657582325902,MATH 142A,A02,083220,Chow; Bennett,10,0,32,22
1657582325902,MATH 142A,A03,093480,Chow; Bennett,8,0,32,24
1657582325902,MATH 142A,B03,093481,Chow; Bennett,8,0,32,24
1657582325902,MATH 142A,B04,093558,Chow; Bennett,13,0,32,19
1657582325902,MATH 142A,B05,093559,Chow; Bennett,6,0,32,26
1657582331938,MATH 193A,A01,083224,Rotar; Vladimir,8,0,34,26
1657582331938,MATH 193A,A02,083225,Rotar; Vladimir,9,0,34,25
1657582331938,MATH 193A,A03,083781,Rotar; Vladimir,5,0,34,29
1657582331938,MATH 193A,A04,083782,Rotar; Vladimir,10,0,34,24
1657582331938,MATH 193A,A05,093482,Rotar; Vladimir,10,0,34,24
1657582337960,MATH 197,001,091859,McAuley; Julian John,9999,0,9999,0
1657582337960,MATH 197,002,095566,Kedlaya; Kiran S.,9997,0,9999,2
1657582337960,MATH 197,003,095567,Xiao; Ming,9999,0,9999,0
1657582337960,MATH 197,004,095571,Perols; Johan Lars,9998,0,9999,1
1657582345026,COGS 9,A01,083615,Shannon; Kyle Michael,9,0,75,66
1657582351052,COGS 11,A01,083617,Boyle; Mary E. T.,23,0,48,25
1657582357076,COGS 13,A01,083071,Bastos; Amalia Pinkusfeld,11,0,71,60
1657582363097,COGS 14A,A01,092681,Semenuks; Arturs,5,1,100,95
1657582369120,COGS 14B,A01,083073,Cheng; Tzu-Han,6,0,63,57
1657582375143,COGS 17,A01,092677,Semenuks; Arturs,6,0,81,75
1657582381166,COGS 100,A01,083619,Allen; Michael Gordon,17,0,70,53
1657582387200,COGS 101A,A01,083621,Davis; Joshua Daniel,9,0,68,59
1657582393222,COGS 101B,A01,091572,Allen; Michael Gordon,12,0,65,53
1657582399249,COGS 101C,A01,083625,Delgado; Tania,17,0,35,18
1657582405273,COGS 107A,A01,083627,Boyle; Mary E. T.,13,0,60,47
1657582411311,COGS 118A,A01,083075,Gupta; Anjum,21,0,76,55
1657582417345,CSE 3,A50,083646,Miranda; Gregory Joseph,24,0,50,26
1657582423371,CSE 8A,A50,083650,Miranda; Gregory Joseph,17,1,56,39
1657582429395,CSE 11,A01,083080,Cao; Yingjun,6,15,40,34
1657582435453,CSE 12,A01,083652,Krause-Levy; Sophia Louisa,28,1,120,92
1657582441478,CSE 15L,A01,083654,Morris; Justin Loren,9,0,50,41
1657582441478,CSE 15L,A02,083655,Morris; Justin Loren,9,0,50,41
1657582447505,CSE 20,A01,083657,Tran; Khoa Dang,39,0,80,41
1657582453533,CSE 21,A01,095574,Bach; Quang Tran,22,0,48,26
1657582459561,CSE 30,A01,083084,Eldon; John,5,0,80,75
1657582459561,CSE 30,B01,095061,Bhaskar; Nishant,9,0,50,41
1657582465591,CSE 100,A01,083659,Cao; Yingjun,5,4,70,65
1657582471612,CSE 134B,A01,083661,Powell; Thomas Allan,22,0,100,78
1657582477638,CSE 140,A01,083663,Gungor; Onat,15,0,85,70
1657582483660,CSE 140L,A01,083088,Eldon; John,21,0,100,79
1657582489683,CSE 175,A01,083665,Kumar; Rakesh,3,0,25,22
1657582495706,CSE 190,A00,092507,Dubnov; Shlomo,8,0,20,12
1657582501751,ECE 45,A01,083139,Congero; Spencer William,6,0,75,69
1657582507777,ECE 65,A50,083695,Saad; Andrew S,12,0,30,18
1657582507777,ECE 65,A51,095125,Saad; Andrew S,24,0,26,2
1657582513799,ECE 109,A01,091882,Touri; Behrouz,19,0,70,51
1657582519835,ECE 180,A00,083140,Abi Samra; Nicholas Camill,1,0,30,29
1657582519835,ECE 180,B00,083141,Abi Samra; Nicholas Camill,0,0,30,30
1657582525858,MATH 10A,A01,083735,Patchell; Gregory David,2,0,30,28
1657582525858,MATH 10A,A02,083736,Patchell; Gregory David,20,0,30,10
1657582525858,MATH 10A,A03,083737,Patchell; Gregory David,16,0,30,14
1657582531887,MATH 10B,A01,083207,Lim; Seonhee,8,0,34,26
1657582531887,MATH 10B,A02,083208,Lim; Seonhee,9,0,35,26
1657582531887,MATH 10B,A03,093472,Lim; Seonhee,7,0,34,27
1657582531887,MATH 10B,B01,083739,Sinha; Shubham,12,0,30,18
1657582537914,MATH 18,A01,083743,Cinel; Cameron Alexander,7,0,30,23
1657582537914,MATH 18,A02,083744,Cinel; Cameron Alexander,17,0,30,13
1657582537914,MATH 18,A03,083745,Cinel; Cameron Alexander,9,0,30,21
1657582537914,MATH 18,B01,083748,Rideout; David Porter,5,0,37,32
1657582537914,MATH 18,B02,083749,Rideout; David Porter,5,0,36,31
1657582537914,MATH 18,B03,083750,Rideout; David Porter,3,0,37,34
1657582537914,MATH 18,B04,083751,Rideout; David Porter,6,0,36,30
1657582537914,MATH 18,B05,093473,Rideout; David Porter,6,0,36,30
1657582537914,MATH 18,B06,093474,Rideout; David Porter,6,0,36,30
1657582543936,MATH 20A,A01,083754,Zheng; Zequn,14,0,40,26
1657582550051,MATH 20B,A01,083756,Briones; Jor-el Thomas Caparas,4,0,36,32
1657582550051,MATH 20B,A02,083757,Briones; Jor-el Thomas Caparas,1,0,36,35
1657582550051,MATH 20B,A03,093475,Briones; Jor-el Thomas Caparas,2,0,36,34
1657582556074,MATH 20C,A01,083760,Briones; Jor-el Thomas Caparas,1,0,35,34
1657582556074,MATH 20C,A02,083761,Briones; Jor-el Thomas Caparas,8,0,35,27
1657582556074,MATH 20C,A03,093476,Briones; Jor-el Thomas Caparas,0,1,36,36
1657582556074,MATH 20C,B01,083762,Bach; Quang Tran,1,0,30,29
1657582562106,MATH 20D,A01,083765,Tran; Brian Kha,5,0,30,25
1657582562106,MATH 20D,A02,083766,Tran; Brian Kha,5,0,30,25
1657582562106,MATH 20D,A03,083767,Tran; Brian Kha,5,0,30,25
1657582568148,MATH 20E,A01,083771,Ganguly; Soumya,9,0,32,23
1657582568148,MATH 20E,A02,083772,Ganguly; Soumya,6,0,32,26
1657582568148,MATH 20E,B01,083773,Ciotti; Benjamin,20,0,35,15
1657582568148,MATH 20E,B02,083774,Ciotti; Benjamin,18,0,35,17
1657582574172,MATH 103A,A01,083777,Greenfeld; Be'Eri,3,0,36,33
1657582574172,MATH 103A,A02,083778,Greenfeld; Be'Eri,5,0,36,31
1657582574172,MATH 103A,A03,093561,Greenfeld; Be'Eri,5,0,36,31
1657582574172,MATH 103A,B01,083779,Greenfeld; Be'Eri,7,0,36,29
1657582574172,MATH 103A,B02,083780,Greenfeld; Be'Eri,4,0,36,32
1657582574172,MATH 103A,B03,093562,Greenfeld; Be'Eri,3,0,36,33
1657582580196,MATH 105,A01,085443,Carter; Anne Toulson,15,0,35,20
1657582580196,MATH 105,A02,093477,Carter; Anne Toulson,20,0,35,15
1657582586219,MATH 109,A01,083213,Ganzberger; Geoffrey Michael,2,0,34,32
1657582586219,MATH 109,A02,083214,Ganzberger; Geoffrey Michael,4,0,34,30
1657582586219,MATH 109,A03,093478,Ganzberger; Geoffrey Michael,2,0,34,32
1657582586219,MATH 109,B01,083215,Ganzberger; Geoffrey Michael,1,0,32,31
1657582586219,MATH 109,B02,083216,Ganzberger; Geoffrey Michael,2,0,32,30
1657582586219,MATH 109,B03,093479,Ganzberger; Geoffrey Michael,8,0,32,24
1657582592243,MATH 142A,A01,083219,Chow; Bennett,7,0,32,25
1657582592243,MATH 142A,A02,083220,Chow; Bennett,10,0,32,22
1657582592243,MATH 142A,A03,093480,Chow; Bennett,8,0,32,24
1657582592243,MATH 142A,B03,093481,Chow; Bennett,8,0,32,24
1657582592243,MATH 142A,B04,093558,Chow; Bennett,13,0,32,19
1657582592243,MATH 142A,B05,093559,Chow; Bennett,6,0,32,26
1657582598271,MATH 193A,A01,083224,Rotar; Vladimir,8,0,34,26
1657582598271,MATH 193A,A02,083225,Rotar; Vladimir,9,0,34,25
1657582598271,MATH 193A,A03,083781,Rotar; Vladimir,5,0,34,29
1657582598271,MATH 193A,A04,083782,Rotar; Vladimir,10,0,34,24
1657582598271,MATH 193A,A05,093482,Rotar; Vladimir,10,0,34,24
1657582604294,MATH 197,001,091859,McAuley; Julian John,9999,0,9999,0
1657582604294,MATH 197,002,095566,Kedlaya; Kiran S.,9997,0,9999,2
1657582604294,MATH 197,003,095567,Xiao; Ming,9999,0,9999,0
1657582604294,MATH 197,004,095571,Perols; Johan Lars,9998,0,9999,1
1657582611361,COGS 9,A01,083615,Shannon; Kyle Michael,9,0,75,66
1657582617385,COGS 11,A01,083617,Boyle; Mary E. T.,23,0,48,25
1657582623408,COGS 13,A01,083071,Bastos; Amalia Pinkusfeld,11,0,71,60
1657582629432,COGS 14A,A01,092681,Semenuks; Arturs,5,1,100,95
1657582635459,COGS 14B,A01,083073,Cheng; Tzu-Han,6,0,63,57
1657582641485,COGS 17,A01,092677,Semenuks; Arturs,6,0,81,75
1657582647511,COGS 100,A01,083619,Allen; Michael Gordon,17,0,70,53
1657582653538,COGS 101A,A01,083621,Davis; Joshua Daniel,9,0,68,59
1657582659560,COGS 101B,A01,091572,Allen; Michael Gordon,12,0,65,53
1657582665582,COGS 101C,A01,083625,Delgado; Tania,17,0,35,18
1657582671628,COGS 107A,A01,083627,Boyle; Mary E. T.,13,0,60,47
1657582677651,COGS 118A,A01,083075,Gupta; Anjum,21,0,76,55
1657582683678,CSE 3,A50,083646,Miranda; Gregory Joseph,24,0,50,26
1657582689708,CSE 8A,A50,083650,Miranda; Gregory Joseph,17,1,56,39
1657582695740,CSE 11,A01,083080,Cao; Yingjun,6,15,40,34
1657582701763,CSE 12,A01,083652,Krause-Levy; Sophia Louisa,28,1,120,92
1657582707786,CSE 15L,A01,083654,Morris; Justin Loren,9,0,50,41
1657582707786,CSE 15L,A02,083655,Morris; Justin Loren,9,0,50,41
1657582713809,CSE 20,A01,083657,Tran; Khoa Dang,39,0,80,41
1657582719835,CSE 21,A01,095574,Bach; Quang Tran,22,0,48,26
1657582725868,CSE 30,A01,083084,Eldon; John,5,0,80,75
1657582725868,CSE 30,B01,095061,Bhaskar; Nishant,9,0,50,41
1657582731890,CSE 100,A01,083659,Cao; Yingjun,5,4,70,65
1657582737913,CSE 134B,A01,083661,Powell; Thomas Allan,22,0,100,78
1657582743938,CSE 140,A01,083663,Gungor; Onat,15,0,85,70
1657582749961,CSE 140L,A01,083088,Eldon; John,21,0,100,79
1657582755988,CSE 175,A01,083665,Kumar; Rakesh,3,0,25,22
1657582762010,CSE 190,A00,092507,Dubnov; Shlomo,8,0,20,12
1657582768043,ECE 45,A01,083139,Congero; Spencer William,6,0,75,69
1657582774065,ECE 65,A50,083695,Saad; Andrew S,12,0,30,18
1657582774065,ECE 65,A51,095125,Saad; Andrew S,24,0,26,2
1657582780098,ECE 109,A01,091882,Touri; Behrouz,19,0,70,51
1657582786124,ECE 180,A00,083140,Abi Samra; Nicholas Camill,1,0,30,29
1657582786124,ECE 180,B00,083141,Abi Samra; Nicholas Camill,0,0,30,30
1657582792153,MATH 10A,A01,083735,Patchell; Gregory David,2,0,30,28
1657582792153,MATH 10A,A02,083736,Patchell; Gregory David,20,0,30,10
1657582792153,MATH 10A,A03,083737,Patchell; Gregory David,16,0,30,14
1657582798181,MATH 10B,A01,083207,Lim; Seonhee,8,0,34,26
1657582798181,MATH 10B,A02,083208,Lim; Seonhee,9,0,35,26
1657582798181,MATH 10B,A03,093472,Lim; Seonhee,7,0,34,27
1657582798181,MATH 10B,B01,083739,Sinha; Shubham,12,0,30,18
1657582804206,MATH 18,A01,083743,Cinel; Cameron Alexander,7,0,30,23
1657582804206,MATH 18,A02,083744,Cinel; Cameron Alexander,17,0,30,13
1657582804206,MATH 18,A03,083745,Cinel; Cameron Alexander,9,0,30,21
1657582804206,MATH 18,B01,083748,Rideout; David Porter,5,0,37,32
1657582804206,MATH 18,B02,083749,Rideout; David Porter,5,0,36,31
1657582804206,MATH 18,B03,083750,Rideout; David Porter,3,0,37,34
1657582804206,MATH 18,B04,083751,Rideout; David Porter,6,0,36,30
1657582804206,MATH 18,B05,093473,Rideout; David Porter,6,0,36,30
1657582804206,MATH 18,B06,093474,Rideout; David Porter,6,0,36,30
1657582810227,MATH 20A,A01,083754,Zheng; Zequn,14,0,40,26
1657582816250,MATH 20B,A01,083756,Briones; Jor-el Thomas Caparas,4,0,36,32
1657582816250,MATH 20B,A02,083757,Briones; Jor-el Thomas Caparas,1,0,36,35
1657582816250,MATH 20B,A03,093475,Briones; Jor-el Thomas Caparas,2,0,36,34
1657582822280,MATH 20C,A01,083760,Briones; Jor-el Thomas Caparas,1,0,35,34
1657582822280,MATH 20C,A02,083761,Briones; Jor-el Thomas Caparas,8,0,35,27
1657582822280,MATH 20C,A03,093476,Briones; Jor-el Thomas Caparas,0,1,36,36
1657582822280,MATH 20C,B01,083762,Bach; Quang Tran,1,0,30,29
1657582828309,MATH 20D,A01,083765,Tran; Brian Kha,5,0,30,25
1657582828309,MATH 20D,A02,083766,Tran; Brian Kha,5,0,30,25
1657582828309,MATH 20D,A03,083767,Tran; Brian Kha,5,0,30,25
1657582834336,MATH 20E,A01,083771,Ganguly; Soumya,9,0,32,23
1657582834336,MATH 20E,A02,083772,Ganguly; Soumya,6,0,32,26
1657582834336,MATH 20E,B01,083773,Ciotti; Benjamin,20,0,35,15
1657582834336,MATH 20E,B02,083774,Ciotti; Benjamin,18,0,35,17
1657582840359,MATH 103A,A01,083777,Greenfeld; Be'Eri,3,0,36,33
1657582840359,MATH 103A,A02,083778,Greenfeld; Be'Eri,5,0,36,31
1657582840359,MATH 103A,A03,093561,Greenfeld; Be'Eri,5,0,36,31
1657582840359,MATH 103A,B01,083779,Greenfeld; Be'Eri,7,0,36,29
1657582840359,MATH 103A,B02,083780,Greenfeld; Be'Eri,4,0,36,32
1657582840359,MATH 103A,B03,093562,Greenfeld; Be'Eri,3,0,36,33
1657582846386,MATH 105,A01,085443,Carter; Anne Toulson,15,0,35,20
1657582846386,MATH 105,A02,093477,Carter; Anne Toulson,20,0,35,15
1657582852410,MATH 109,A01,083213,Ganzberger; Geoffrey Michael,2,0,34,32
1657582852410,MATH 109,A02,083214,Ganzberger; Geoffrey Michael,4,0,34,30
1657582852410,MATH 109,A03,093478,Ganzberger; Geoffrey Michael,2,0,34,32
1657582852410,MATH 109,B01,083215,Ganzberger; Geoffrey Michael,1,0,32,31
1657582852410,MATH 109,B02,083216,Ganzberger; Geoffrey Michael,2,0,32,30
1657582852410,MATH 109,B03,093479,Ganzberger; Geoffrey Michael,8,0,32,24
1657582858434,MATH 142A,A01,083219,Chow; Bennett,7,0,32,25
1657582858434,MATH 142A,A02,083220,Chow; Bennett,10,0,32,22
1657582858434,MATH 142A,A03,093480,Chow; Bennett,8,0,32,24
1657582858434,MATH 142A,B03,093481,Chow; Bennett,8,0,32,24
1657582858434,MATH 142A,B04,093558,Chow; Bennett,13,0,32,19
1657582858434,MATH 142A,B05,093559,Chow; Bennett,6,0,32,26
1657582864456,MATH 193A,A01,083224,Rotar; Vladimir,8,0,34,26
1657582864456,MATH 193A,A02,083225,Rotar; Vladimir,9,0,34,25
1657582864456,MATH 193A,A03,083781,Rotar; Vladimir,5,0,34,29
1657582864456,MATH 193A,A04,083782,Rotar; Vladimir,10,0,34,24
1657582864456,MATH 193A,A05,093482,Rotar; Vladimir,10,0,34,24
1657582870482,MATH 197,001,091859,McAuley; Julian John,9999,0,9999,0
1657582870482,MATH 197,002,095566,Kedlaya; Kiran S.,9997,0,9999,2
1657582870482,MATH 197,003,095567,Xiao; Ming,9999,0,9999,0
1657582870482,MATH 197,004,095571,Perols; Johan Lars,9998,0,9999,1
1657582877541,COGS 9,A01,083615,Shannon; Kyle Michael,9,0,75,66
1657582883563,COGS 11,A01,083617,Boyle; Mary E. T.,23,0,48,25
1657582889590,COGS 13,A01,083071,Bastos; Amalia Pinkusfeld,11,0,71,60
1657582895613,COGS 14A,A01,092681,Semenuks; Arturs,5,1,100,95
1657582901637,COGS 14B,A01,083073,Cheng; Tzu-Han,6,0,63,57
1657582907664,COGS 17,A01,092677,Semenuks; Arturs,6,0,81,75
1657582913686,COGS 100,A01,083619,Allen; Michael Gordon,17,0,70,53
1657582919710,COGS 101A,A01,083621,Davis; Joshua Daniel,9,0,68,59
1657582925735,COGS 101B,A01,091572,Allen; Michael Gordon,12,0,65,53
1657582931761,COGS 101C,A01,083625,Delgado; Tania,17,0,35,18
1657582937783,COGS 107A,A01,083627,Boyle; Mary E. T.,13,0,60,47
1657582943806,COGS 118A,A01,083075,Gupta; Anjum,21,0,76,55
1657582949830,CSE 3,A50,083646,Miranda; Gregory Joseph,24,0,50,26
1657582955854,CSE 8A,A50,083650,Miranda; Gregory Joseph,17,1,56,39
1657582961884,CSE 11,A01,083080,Cao; Yingjun,6,15,40,34
1657582967911,CSE 12,A01,083652,Krause-Levy; Sophia Louisa,28,1,120,92
1657582973935,CSE 15L,A01,083654,Morris; Justin Loren,9,0,50,41
1657582973935,CSE 15L,A02,083655,Morris; Justin Loren,9,0,50,41
1657582979963,CSE 20,A01,083657,Tran; Khoa Dang,39,0,80,41
1657582985986,CSE 21,A01,095574,Bach; Quang Tran,22,0,48,26
1657582992013,CSE 30,A01,083084,Eldon; John,5,0,80,75
1657582992013,CSE 30,B01,095061,Bhaskar; Nishant,9,0,50,41
1657582998036,CSE 100,A01,083659,Cao; Yingjun,5,4,70,65
1657583004058,CSE 134B,A01,083661,Powell; Thomas Allan,22,0,100,78
1657583010086,CSE 140,A01,083663,Gungor; Onat,15,0,85,70
1657583016108,CSE 140L,A01,083088,Eldon; John,21,0,100,79
1657583022135,CSE 175,A01,083665,Kumar; Rakesh,3,0,25,22
1657583028173,CSE 190,A00,092507,Dubnov; Shlomo,8,0,20,12
1657583034196,ECE 45,A01,083139,Congero; Spencer William,6,0,75,69
1657583040226,ECE 65,A50,083695,Saad; Andrew S,12,0,30,18
1657583040226,ECE 65,A51,095125,Saad; Andrew S,24,0,26,2
1657583046258,ECE 109,A01,091882,Touri; Behrouz,19,0,70,51
1657583052288,ECE 180,A00,083140,Abi Samra; Nicholas Camill,1,0,30,29
1657583052288,ECE 180,B00,083141,Abi Samra; Nicholas Camill,0,0,30,30
1657583058317,MATH 10A,A01,083735,Patchell; Gregory David,2,0,30,28
1657583058317,MATH 10A,A02,083736,Patchell; Gregory David,20,0,30,10
1657583058317,MATH 10A,A03,083737,Patchell; Gregory David,16,0,30,14
1657583064341,MATH 10B,A01,083207,Lim; Seonhee,8,0,34,26
1657583064341,MATH 10B,A02,083208,Lim; Seonhee,9,0,35,26
1657583064341,MATH 10B,A03,093472,Lim; Seonhee,7,0,34,27
1657583064341,MATH 10B,B01,083739,Sinha; Shubham,12,0,30,18
1657583070374,MATH 18,A01,083743,Cinel; Cameron Alexander,7,0,30,23
1657583070374,MATH 18,A02,083744,Cinel; Cameron Alexander,17,0,30,13
1657583070374,MATH 18,A03,083745,Cinel; Cameron Alexander,9,0,30,21
1657583070374,MATH 18,B01,083748,Rideout; David Porter,5,0,37,32
1657583070374,MATH 18,B02,083749,Rideout; David Porter,5,0,36,31
1657583070374,MATH 18,B03,083750,Rideout; David Porter,3,0,37,34
1657583070374,MATH 18,B04,083751,Rideout; David Porter,6,0,36,30
1657583070374,MATH 18,B05,093473,Rideout; David Porter,6,0,36,30
1657583070374,MATH 18,B06,093474,Rideout; David Porter,6,0,36,30
1657583076398,MATH 20A,A01,083754,Zheng; Zequn,14,0,40,26
1657583082433,MATH 20B,A01,083756,Briones; Jor-el Thomas Caparas,4,0,36,32
1657583082433,MATH 20B,A02,083757,Briones; Jor-el Thomas Caparas,1,0,36,35
1657583082433,MATH 20B,A03,093475,Briones; Jor-el Thomas Caparas,2,0,36,34
1657583088465,MATH 20C,A01,083760,Briones; Jor-el Thomas Caparas,1,0,35,34
1657583088465,MATH 20C,A02,083761,Briones; Jor-el Thomas Caparas,8,0,35,27
1657583088465,MATH 20C,A03,093476,Briones; Jor-el Thomas Caparas,0,1,36,36
1657583088465,MATH 20C,B01,083762,Bach; Quang Tran,1,0,30,29
1657583094504,MATH 20D,A01,083765,Tran; Brian Kha,5,0,30,25
1657583094504,MATH 20D,A02,083766,Tran; Brian Kha,5,0,30,25
1657583094504,MATH 20D,A03,083767,Tran; Brian Kha,5,0,30,25
1657583100544,MATH 20E,A01,083771,Ganguly; Soumya,9,0,32,23
1657583100544,MATH 20E,A02,083772,Ganguly; Soumya,6,0,32,26
1657583100544,MATH 20E,B01,083773,Ciotti; Benjamin,20,0,35,15
1657583100544,MATH 20E,B02,083774,Ciotti; Benjamin,18,0,35,17
1657583106566,MATH 103A,A01,083777,Greenfeld; Be'Eri,3,0,36,33
1657583106566,MATH 103A,A02,083778,Greenfeld; Be'Eri,5,0,36,31
1657583106566,MATH 103A,A03,093561,Greenfeld; Be'Eri,5,0,36,31
1657583106566,MATH 103A,B01,083779,Greenfeld; Be'Eri,7,0,36,29
1657583106566,MATH 103A,B02,083780,Greenfeld; Be'Eri,4,0,36,32
1657583106566,MATH 103A,B03,093562,Greenfeld; Be'Eri,3,0,36,33
1657583112591,MATH 105,A01,085443,Carter; Anne Toulson,15,0,35,20
1657583112591,MATH 105,A02,093477,Carter; Anne Toulson,20,0,35,15
1657583118620,MATH 109,A01,083213,Ganzberger; Geoffrey Michael,2,0,34,32
1657583118620,MATH 109,A02,083214,Ganzberger; Geoffrey Michael,4,0,34,30
1657583118620,MATH 109,A03,093478,Ganzberger; Geoffrey Michael,2,0,34,32
1657583118620,MATH 109,B01,083215,Ganzberger; Geoffrey Michael,1,0,32,31
1657583118620,MATH 109,B02,083216,Ganzberger; Geoffrey Michael,2,0,32,30
1657583118620,MATH 109,B03,093479,Ganzberger; Geoffrey Michael,8,0,32,24
1657583124649,MATH 142A,A01,083219,Chow; Bennett,7,0,32,25
1657583124649,MATH 142A,A02,083220,Chow; Bennett,10,0,32,22
1657583124649,MATH 142A,A03,093480,Chow; Bennett,8,0,32,24
1657583124649,MATH 142A,B03,093481,Chow; Bennett,8,0,32,24
1657583124649,MATH 142A,B04,093558,Chow; Bennett,13,0,32,19
1657583124649,MATH 142A,B05,093559,Chow; Bennett,6,0,32,26
1657583130673,MATH 193A,A01,083224,Rotar; Vladimir,8,0,34,26
1657583130673,MATH 193A,A02,083225,Rotar; Vladimir,9,0,34,25
1657583130673,MATH 193A,A03,083781,Rotar; Vladimir,5,0,34,29
1657583130673,MATH 193A,A04,083782,Rotar; Vladimir,10,0,34,24
1657583130673,MATH 193A,A05,093482,Rotar; Vladimir,10,0,34,24
1657583136695,MATH 197,001,091859,McAuley; Julian John,9999,0,9999,0
1657583136695,MATH 197,002,095566,Kedlaya; Kiran S.,9997,0,9999,2
1657583136695,MATH 197,003,095567,Xiao; Ming,9999,0,9999,0
1657583136695,MATH 197,004,095571,Perols; Johan Lars,9998,0,9999,1
1657583143831,COGS 9,A01,083615,Shannon; Kyle Michael,9,0,75,66
1657583149862,COGS 11,A01,083617,Boyle; Mary E. T.,23,0,48,25
1657583155886,COGS 13,A01,083071,Bastos; Amalia Pinkusfeld,11,0,71,60
1657583161920,COGS 14A,A01,092681,Semenuks; Arturs,5,1,100,95
1657583167948,COGS 14B,A01,083073,Cheng; Tzu-Han,6,0,63,57
1657583173974,COGS 17,A01,092677,Semenuks; Arturs,6,0,81,75
1657583179998,COGS 100,A01,083619,Allen; Michael Gordon,17,0,70,53
1657583186021,COGS 101A,A01,083621,Davis; Joshua Daniel,9,0,68,59
1657583192046,COGS 101B,A01,091572,Allen; Michael Gordon,12,0,65,53
1657583198072,COGS 101C,A01,083625,Delgado; Tania,17,0,35,18
1657583204099,COGS 107A,A01,083627,Boyle; Mary E. T.,13,0,60,47
1657583210123,COGS 118A,A01,083075,Gupta; Anjum,21,0,76,55
1657583216147,CSE 3,A50,083646,Miranda; Gregory Joseph,24,0,50,26
1657583222170,CSE 8A,A50,083650,Miranda; Gregory Joseph,17,1,56,39
1657583228195,CSE 11,A01,083080,Cao; Yingjun,6,15,40,34
1657583234219,CSE 12,A01,083652,Krause-Levy; Sophia Louisa,28,1,120,92
1657583240256,CSE 15L,A01,083654,Morris; Justin Loren,9,0,50,41
1657583240256,CSE 15L,A02,083655,Morris; Justin Loren,9,0,50,41
1657583246277,CSE 20,A01,083657,Tran; Khoa Dang,39,0,80,41
1657583252300,CSE 21,A01,095574,Bach; Quang Tran,22,0,48,26
1657583258344,CSE 30,A01,083084,Eldon; John,5,0,80,75
1657583258344,CSE 30,B01,095061,Bhaskar; Nishant,9,0,50,41
1657583264375,CSE 100,A01,083659,Cao; Yingjun,5,4,70,65
1657583270401,CSE 134B,A01,083661,Powell; Thomas Allan,22,0,100,78
1657583276423,CSE 140,A01,083663,Gungor; Onat,15,0,85,70
1657583282449,CSE 140L,A01,083088,Eldon; John,21,0,100,79
1657583288476,CSE 175,A01,083665,Kumar; Rakesh,3,0,25,22
1657583294501,CSE 190,A00,092507,Dubnov; Shlomo,8,0,20,12
1657583300525,ECE 45,A01,083139,Congero; Spencer William,6,0,75,69
1657583306548,ECE 65,A50,083695,Saad; Andrew S,12,0,30,18
1657583306548,ECE 65,A51,095125,Saad; Andrew S,24,0,26,2
1657583312570,ECE 109,A01,091882,Touri; Behrouz,19,0,70,51
1657583318598,ECE 180,A00,083140,Abi Samra; Nicholas Camill,1,0,30,29
1657583318598,ECE 180,B00,083141,Abi Samra; Nicholas Camill,0,0,30,30
1657583324624,MATH 10A,A01,083735,Patchell; Gregory David,2,0,30,28
1657583324624,MATH 10A,A02,083736,Patchell; Gregory David,20,0,30,10
1657583324624,MATH 10A,A03,083737,Patchell; Gregory David,16,0,30,14
1657583330651,MATH 10B,A01,083207,Lim; Seonhee,8,0,34,26
1657583330651,MATH 10B,A02,083208,Lim; Seonhee,9,0,35,26
1657583330651,MATH 10B,A03,093472,Lim; Seonhee,7,0,34,27
1657583330651,MATH 10B,B01,083739,Sinha; Shubham,12,0,30,18
1657583336681,MATH 18,A01,083743,Cinel; Cameron Alexander,7,0,30,23
1657583336681,MATH 18,A02,083744,Cinel; Cameron Alexander,17,0,30,13
1657583336681,MATH 18,A03,083745,Cinel; Cameron Alexander,9,0,30,21
1657583336681,MATH 18,B01,083748,Rideout; David Porter,5,0,37,32
1657583336681,MATH 18,B02,083749,Rideout; David Porter,5,0,36,31
1657583336681,MATH 18,B03,083750,Rideout; David Porter,3,0,37,34
1657583336681,MATH 18,B04,083751,Rideout; David Porter,6,0,36,30
1657583336681,MATH 18,B05,093473,Rideout; David Porter,6,0,36,30
1657583336681,MATH 18,B06,093474,Rideout; David Porter,6,0,36,30
1657583342703,MATH 20A,A01,083754,Zheng; Zequn,14,0,40,26
1657583348735,MATH 20B,A01,083756,Briones; Jor-el Thomas Caparas,4,0,36,32
1657583348735,MATH 20B,A02,083757,Briones; Jor-el Thomas Caparas,1,0,36,35
1657583348735,MATH 20B,A03,093475,Briones; Jor-el Thomas Caparas,2,0,36,34
1657583354758,MATH 20C,A01,083760,Briones; Jor-el Thomas Caparas,1,0,35,34
1657583354758,MATH 20C,A02,083761,Briones; Jor-el Thomas Caparas,8,0,35,27
1657583354758,MATH 20C,A03,093476,Briones; Jor-el Thomas Caparas,0,1,36,36
1657583354758,MATH 20C,B01,083762,Bach; Quang Tran,1,0,30,29
1657583360782,MATH 20D,A01,083765,Tran; Brian Kha,5,0,30,25
1657583360782,MATH 20D,A02,083766,Tran; Brian Kha,5,0,30,25
1657583360782,MATH 20D,A03,083767,Tran; Brian Kha,5,0,30,25
1657583366805,MATH 20E,A01,083771,Ganguly; Soumya,9,0,32,23
1657583366805,MATH 20E,A02,083772,Ganguly; Soumya,6,0,32,26
1657583366805,MATH 20E,B01,083773,Ciotti; Benjamin,20,0,35,15
1657583366805,MATH 20E,B02,083774,Ciotti; Benjamin,18,0,35,17
1657583372829,MATH 103A,A01,083777,Greenfeld; Be'Eri,3,0,36,33
1657583372829,MATH 103A,A02,083778,Greenfeld; Be'Eri,5,0,36,31
1657583372829,MATH 103A,A03,093561,Greenfeld; Be'Eri,5,0,36,31
1657583372829,MATH 103A,B01,083779,Greenfeld; Be'Eri,7,0,36,29
1657583372829,MATH 103A,B02,083780,Greenfeld; Be'Eri,4,0,36,32
1657583372829,MATH 103A,B03,093562,Greenfeld; Be'Eri,3,0,36,33
1657583378856,MATH 105,A01,085443,Carter; Anne Toulson,15,0,35,20
1657583378856,MATH 105,A02,093477,Carter; Anne Toulson,20,0,35,15
1657583384878,MATH 109,A01,083213,Ganzberger; Geoffrey Michael,2,0,34,32
1657583384878,MATH 109,A02,083214,Ganzberger; Geoffrey Michael,4,0,34,30
1657583384878,MATH 109,A03,093478,Ganzberger; Geoffrey Michael,2,0,34,32
1657583384878,MATH 109,B01,083215,Ganzberger; Geoffrey Michael,1,0,32,31
1657583384878,MATH 109,B02,083216,Ganzberger; Geoffrey Michael,2,0,32,30
1657583384878,MATH 109,B03,093479,Ganzberger; Geoffrey Michael,8,0,32,24
1657583390901,MATH 142A,A01,083219,Chow; Bennett,7,0,32,25
1657583390901,MATH 142A,A02,083220,Chow; Bennett,10,0,32,22
1657583390901,MATH 142A,A03,093480,Chow; Bennett,8,0,32,24
1657583390901,MATH 142A,B03,093481,Chow; Bennett,8,0,32,24
1657583390901,MATH 142A,B04,093558,Chow; Bennett,13,0,32,19
1657583390901,MATH 142A,B05,093559,Chow; Bennett,6,0,32,26
1657583396926,MATH 193A,A01,083224,Rotar; Vladimir,8,0,34,26
1657583396926,MATH 193A,A02,083225,Rotar; Vladimir,9,0,34,25
1657583396926,MATH 193A,A03,083781,Rotar; Vladimir,5,0,34,29
1657583396926,MATH 193A,A04,083782,Rotar; Vladimir,10,0,34,24
1657583396926,MATH 193A,A05,093482,Rotar; Vladimir,10,0,34,24
1657583402949,MATH 197,001,091859,McAuley; Julian John,9999,0,9999,0
1657583402949,MATH 197,002,095566,Kedlaya; Kiran S.,9997,0,9999,2
1657583402949,MATH 197,003,095567,Xiao; Ming,9999,0,9999,0
1657583402949,MATH 197,004,095571,Perols; Johan Lars,9998,0,9999,1
1657583410011,COGS 9,A01,083615,Shannon; Kyle Michael,9,0,75,66
1657583416037,COGS 11,A01,083617,Boyle; Mary E. T.,23,0,48,25
1657583422072,COGS 13,A01,083071,Bastos; Amalia Pinkusfeld,11,0,71,60
1657583428099,COGS 14A,A01,092681,Semenuks; Arturs,5,1,100,95
1657583434125,COGS 14B,A01,083073,Cheng; Tzu-Han,6,0,63,57
1657583440149,COGS 17,A01,092677,Semenuks; Arturs,6,0,81,75
1657583446170,COGS 100,A01,083619,Allen; Michael Gordon,17,0,70,53
1657583452194,COGS 101A,A01,083621,Davis; Joshua Daniel,9,0,68,59
1657583458217,COGS 101B,A01,091572,Allen; Michael Gordon,12,0,65,53
1657583464243,COGS 101C,A01,083625,Delgado; Tania,17,0,35,18
1657583470276,COGS 107A,A01,083627,Boyle; Mary E. T.,13,0,60,47
1657583476302,COGS 118A,A01,083075,Gupta; Anjum,21,0,76,55
1657583482328,CSE 3,A50,083646,Miranda; Gregory Joseph,24,0,50,26
1657583488355,CSE 8A,A50,083650,Miranda; Gregory Joseph,17,1,56,39
1657583494379,CSE 11,A01,083080,Cao; Yingjun,6,15,40,34
1657583500404,CSE 12,A01,083652,Krause-Levy; Sophia Louisa,28,1,120,92
1657583506431,CSE 15L,A01,083654,Morris; Justin Loren,9,0,50,41
1657583506431,CSE 15L,A02,083655,Morris; Justin Loren,9,0,50,41
1657583512463,CSE 20,A01,083657,Tran; Khoa Dang,39,0,80,41
1657583518490,CSE 21,A01,095574,Bach; Quang Tran,22,0,48,26
1657583524517,CSE 30,A01,083084,Eldon; John,5,0,80,75
1657583524517,CSE 30,B01,095061,Bhaskar; Nishant,9,0,50,41
1657583530540,CSE 100,A01,083659,Cao; Yingjun,5,4,70,65
1657583536563,CSE 134B,A01,083661,Powell; Thomas Allan,22,0,100,78
1657583542587,CSE 140,A01,083663,Gungor; Onat,15,0,85,70
1657583548612,CSE 140L,A01,083088,Eldon; John,21,0,100,79
1657583554640,CSE 175,A01,083665,Kumar; Rakesh,3,0,25,22
1657583560661,CSE 190,A00,092507,Dubnov; Shlomo,8,0,20,12
1657583566686,ECE 45,A01,083139,Congero; Spencer William,6,0,75,69
1657583572709,ECE 65,A50,083695,Saad; Andrew S,12,0,30,18
1657583572709,ECE 65,A51,095125,Saad; Andrew S,24,0,26,2
1657583578732,ECE 109,A01,091882,Touri; Behrouz,19,0,70,51
1657583584756,ECE 180,A00,083140,Abi Samra; Nicholas Camill,1,0,30,29
1657583584756,ECE 180,B00,083141,Abi Samra; Nicholas Camill,0,0,30,30
1657583590789,MATH 10A,A01,083735,Patchell; Gregory David,2,0,30,28
1657583590789,MATH 10A,A02,083736,Patchell; Gregory David,20,0,30,10
1657583590789,MATH 10A,A03,083737,Patchell; Gregory David,16,0,30,14
1657583596811,MATH 10B,A01,083207,Lim; Seonhee,8,0,34,26
1657583596811,MATH 10B,A02,083208,Lim; Seonhee,9,0,35,26
1657583596811,MATH 10B,A03,093472,Lim; Seonhee,7,0,34,27
1657583596811,MATH 10B,B01,083739,Sinha; Shubham,12,0,30,18
1657583602839,MATH 18,A01,083743,Cinel; Cameron Alexander,7,0,30,23
1657583602839,MATH 18,A02,083744,Cinel; Cameron Alexander,17,0,30,13
1657583602839,MATH 18,A03,083745,Cinel; Cameron Alexander,9,0,30,21
1657583602839,MATH 18,B01,083748,Rideout; David Porter,5,0,37,32
1657583602839,MATH 18,B02,083749,Rideout; David Porter,5,0,36,31
1657583602839,MATH 18,B03,083750,Rideout; David Porter,3,0,37,34
1657583602839,MATH 18,B04,083751,Rideout; David Porter,6,0,36,30
1657583602839,MATH 18,B05,093473,Rideout; David Porter,6,0,36,30
1657583602839,MATH 18,B06,093474,Rideout; David Porter,6,0,36,30
1657583608867,MATH 20A,A01,083754,Zheng; Zequn,14,0,40,26
1657583614893,MATH 20B,A01,083756,Briones; Jor-el Thomas Caparas,4,0,36,32
1657583614893,MATH 20B,A02,083757,Briones; Jor-el Thomas Caparas,1,0,36,35
1657583614893,MATH 20B,A03,093475,Briones; Jor-el Thomas Caparas,2,0,36,34
1657583620924,MATH 20C,A01,083760,Briones; Jor-el Thomas Caparas,1,0,35,34
1657583620924,MATH 20C,A02,083761,Briones; Jor-el Thomas Caparas,8,0,35,27
1657583620924,MATH 20C,A03,093476,Briones; Jor-el Thomas Caparas,0,1,36,36
1657583620924,MATH 20C,B01,083762,Bach; Quang Tran,1,0,30,29
1657583626954,MATH 20D,A01,083765,Tran; Brian Kha,5,0,30,25
1657583626954,MATH 20D,A02,083766,Tran; Brian Kha,5,0,30,25
1657583626954,MATH 20D,A03,083767,Tran; Brian Kha,5,0,30,25
1657583632979,MATH 20E,A01,083771,Ganguly; Soumya,9,0,32,23
1657583632979,MATH 20E,A02,083772,Ganguly; Soumya,6,0,32,26
1657583632979,MATH 20E,B01,083773,Ciotti; Benjamin,20,0,35,15
1657583632979,MATH 20E,B02,083774,Ciotti; Benjamin,18,0,35,17
1657583639006,MATH 103A,A01,083777,Greenfeld; Be'Eri,3,0,36,33
1657583639006,MATH 103A,A02,083778,Greenfeld; Be'Eri,5,0,36,31
1657583639006,MATH 103A,A03,093561,Greenfeld; Be'Eri,5,0,36,31
1657583639006,MATH 103A,B01,083779,Greenfeld; Be'Eri,7,0,36,29
1657583639006,MATH 103A,B02,083780,Greenfeld; Be'Eri,4,0,36,32
1657583639006,MATH 103A,B03,093562,Greenfeld; Be'Eri,3,0,36,33
1657583645032,MATH 105,A01,085443,Carter; Anne Toulson,15,0,35,20
1657583645032,MATH 105,A02,093477,Carter; Anne Toulson,20,0,35,15
1657583651058,MATH 109,A01,083213,Ganzberger; Geoffrey Michael,2,0,34,32
1657583651058,MATH 109,A02,083214,Ganzberger; Geoffrey Michael,4,0,34,30
1657583651058,MATH 109,A03,093478,Ganzberger; Geoffrey Michael,2,0,34,32
1657583651058,MATH 109,B01,083215,Ganzberger; Geoffrey Michael,1,0,32,31
1657583651058,MATH 109,B02,083216,Ganzberger; Geoffrey Michael,2,0,32,30
1657583651058,MATH 109,B03,093479,Ganzberger; Geoffrey Michael,8,0,32,24
1657583657082,MATH 142A,A01,083219,Chow; Bennett,7,0,32,25
1657583657082,MATH 142A,A02,083220,Chow; Bennett,10,0,32,22
1657583657082,MATH 142A,A03,093480,Chow; Bennett,8,0,32,24
1657583657082,MATH 142A,B03,093481,Chow; Bennett,8,0,32,24
1657583657082,MATH 142A,B04,093558,Chow; Bennett,13,0,32,19
1657583657082,MATH 142A,B05,093559,Chow; Bennett,6,0,32,26
1657583663112,MATH 193A,A01,083224,Rotar; Vladimir,8,0,34,26
1657583663112,MATH 193A,A02,083225,Rotar; Vladimir,9,0,34,25
1657583663112,MATH 193A,A03,083781,Rotar; Vladimir,5,0,34,29
1657583663112,MATH 193A,A04,083782,Rotar; Vladimir,10,0,34,24
1657583663112,MATH 193A,A05,093482,Rotar; Vladimir,10,0,34,24
1657583669133,MATH 197,001,091859,McAuley; Julian John,9999,0,9999,0
1657583669133,MATH 197,002,095566,Kedlaya; Kiran S.,9997,0,9999,2
1657583669133,MATH 197,003,095567,Xiao; Ming,9999,0,9999,0
1657583669133,MATH 197,004,095571,Perols; Johan Lars,9998,0,9999,1
1657583676195,COGS 9,A01,083615,Shannon; Kyle Michael,9,0,75,66
1657583682229,COGS 11,A01,083617,Boyle; Mary E. T.,23,0,48,25
1657583688256,COGS 13,A01,083071,Bastos; Amalia Pinkusfeld,11,0,71,60
1657583694280,COGS 14A,A01,092681,Semenuks; Arturs,5,1,100,95
1657583700309,COGS 14B,A01,083073,Cheng; Tzu-Han,6,0,63,57
1657583706332,COGS 17,A01,092677,Semenuks; Arturs,6,0,81,75
1657583712355,COGS 100,A01,083619,Allen; Michael Gordon,17,0,70,53
1657583718381,COGS 101A,A01,083621,Davis; Joshua Daniel,9,0,68,59
1657583724404,COGS 101B,A01,091572,Allen; Michael Gordon,12,0,65,53
1657583730428,COGS 101C,A01,083625,Delgado; Tania,17,0,35,18
1657583736466,COGS 107A,A01,083627,Boyle; Mary E. T.,13,0,60,47
1657583742584,COGS 118A,A01,083075,Gupta; Anjum,21,0,76,55
1657583748612,CSE 3,A50,083646,Miranda; Gregory Joseph,24,0,50,26
1657583754634,CSE 8A,A50,083650,Miranda; Gregory Joseph,17,1,56,39
1657583760658,CSE 11,A01,083080,Cao; Yingjun,6,15,40,34
1657583766685,CSE 12,A01,083652,Krause-Levy; Sophia Louisa,28,1,120,92
1657583772712,CSE 15L,A01,083654,Morris; Justin Loren,9,0,50,41
1657583772712,CSE 15L,A02,083655,Morris; Justin Loren,9,0,50,41
1657583778740,CSE 20,A01,083657,Tran; Khoa Dang,39,0,80,41
1657583784766,CSE 21,A01,095574,Bach; Quang Tran,22,0,48,26
1657583790794,CSE 30,A01,083084,Eldon; John,5,0,80,75
1657583790794,CSE 30,B01,095061,Bhaskar; Nishant,9,0,50,41
1657583796817,CSE 100,A01,083659,Cao; Yingjun,5,4,70,65
1657583802839,CSE 134B,A01,083661,Powell; Thomas Allan,22,0,100,78
1657583808873,CSE 140,A01,083663,Gungor; Onat,15,0,85,70
1657583814900,CSE 140L,A01,083088,Eldon; John,21,0,100,79
1657583820926,CSE 175,A01,083665,Kumar; Rakesh,3,0,25,22
1657583826951,CSE 190,A00,092507,Dubnov; Shlomo,8,0,20,12
1657583832977,ECE 45,A01,083139,Congero; Spencer William,6,0,75,69
1657583839001,ECE 65,A50,083695,Saad; Andrew S,12,0,30,18
1657583839001,ECE 65,A51,095125,Saad; Andrew S,24,0,26,2
1657583845024,ECE 109,A01,091882,Touri; Behrouz,19,0,70,51
1657583851050,ECE 180,A00,083140,Abi Samra; Nicholas Camill,1,0,30,29
1657583851050,ECE 180,B00,083141,Abi Samra; Nicholas Camill,0,0,30,30
1657583857084,MATH 10A,A01,083735,Patchell; Gregory David,2,0,30,28
1657583857084,MATH 10A,A02,083736,Patchell; Gregory David,20,0,30,10
1657583857084,MATH 10A,A03,083737,Patchell; Gregory David,16,0,30,14
1657583863113,MATH 10B,A01,083207,Lim; Seonhee,8,0,34,26
1657583863113,MATH 10B,A02,083208,Lim; Seonhee,9,0,35,26
1657583863113,MATH 10B,A03,093472,Lim; Seonhee,7,0,34,27
1657583863113,MATH 10B,B01,083739,Sinha; Shubham,12,0,30,18
1657583869140,MATH 18,A01,083743,Cinel; Cameron Alexander,7,0,30,23
1657583869140,MATH 18,A02,083744,Cinel; Cameron Alexander,17,0,30,13
1657583869140,MATH 18,A03,083745,Cinel; Cameron Alexander,9,0,30,21
1657583869140,MATH 18,B01,083748,Rideout; David Porter,5,0,37,32
1657583869140,MATH 18,B02,083749,Rideout; David Porter,5,0,36,31
1657583869140,MATH 18,B03,083750,Rideout; David Porter,3,0,37,34
1657583869140,MATH 18,B04,083751,Rideout; David Porter,6,0,36,30
1657583869140,MATH 18,B05,093473,Rideout; David Porter,6,0,36,30
1657583869140,MATH 18,B06,093474,Rideout; David Porter,6,0,36,30
1657583875164,MATH 20A,A01,083754,Zheng; Zequn,14,0,40,26
1657583881194,MATH 20B,A01,083756,Briones; Jor-el Thomas Caparas,4,0,36,32
1657583881194,MATH 20B,A02,083757,Briones; Jor-el Thomas Caparas,1,0,36,35
1657583881194,MATH 20B,A03,093475,Briones; Jor-el Thomas Caparas,2,0,36,34
1657583887232,MATH 20C,A01,083760,Briones; Jor-el Thomas Caparas,1,0,35,34
1657583887232,MATH 20C,A02,083761,Briones; Jor-el Thomas Caparas,8,0,35,27
1657583887232,MATH 20C,A03,093476,Briones; Jor-el Thomas Caparas,0,1,36,36
1657583887232,MATH 20C,B01,083762,Bach; Quang Tran,1,0,30,29
1657583893260,MATH 20D,A01,083765,Tran; Brian Kha,5,0,30,25
1657583893260,MATH 20D,A02,083766,Tran; Brian Kha,5,0,30,25
1657583893260,MATH 20D,A03,083767,Tran; Brian Kha,5,0,30,25
1657583899296,MATH 20E,A01,083771,Ganguly; Soumya,9,0,32,23
1657583899296,MATH 20E,A02,083772,Ganguly; Soumya,6,0,32,26
1657583899296,MATH 20E,B01,083773,Ciotti; Benjamin,20,0,35,15
1657583899296,MATH 20E,B02,083774,Ciotti; Benjamin,18,0,35,17
1657583905323,MATH 103A,A01,083777,Greenfeld; Be'Eri,3,0,36,33
1657583905323,MATH 103A,A02,083778,Greenfeld; Be'Eri,5,0,36,31
1657583905323,MATH 103A,A03,093561,Greenfeld; Be'Eri,5,0,36,31
1657583905323,MATH 103A,B01,083779,Greenfeld; Be'Eri,7,0,36,29
1657583905323,MATH 103A,B02,083780,Greenfeld; Be'Eri,4,0,36,32
1657583905323,MATH 103A,B03,093562,Greenfeld; Be'Eri,3,0,36,33
1657583911345,MATH 105,A01,085443,Carter; Anne Toulson,15,0,35,20
1657583911345,MATH 105,A02,093477,Carter; Anne Toulson,20,0,35,15
1657583917372,MATH 109,A01,083213,Ganzberger; Geoffrey Michael,2,0,34,32
1657583917372,MATH 109,A02,083214,Ganzberger; Geoffrey Michael,4,0,34,30
1657583917372,MATH 109,A03,093478,Ganzberger; Geoffrey Michael,2,0,34,32
1657583917372,MATH 109,B01,083215,Ganzberger; Geoffrey Michael,1,0,32,31
1657583917372,MATH 109,B02,083216,Ganzberger; Geoffrey Michael,2,0,32,30
1657583917372,MATH 109,B03,093479,Ganzberger; Geoffrey Michael,8,0,32,24
1657583923400,MATH 142A,A01,083219,Chow; Bennett,7,0,32,25
1657583923400,MATH 142A,A02,083220,Chow; Bennett,10,0,32,22
1657583923400,MATH 142A,A03,093480,Chow; Bennett,8,0,32,24
1657583923400,MATH 142A,B03,093481,Chow; Bennett,8,0,32,24
1657583923400,MATH 142A,B04,093558,Chow; Bennett,13,0,32,19
1657583923400,MATH 142A,B05,093559,Chow; Bennett,6,0,32,26
1657583929424,MATH 193A,A01,083224,Rotar; Vladimir,8,0,34,26
1657583929424,MATH 193A,A02,083225,Rotar; Vladimir,9,0,34,25
1657583929424,MATH 193A,A03,083781,Rotar; Vladimir,5,0,34,29
1657583929424,MATH 193A,A04,083782,Rotar; Vladimir,10,0,34,24
1657583929424,MATH 193A,A05,093482,Rotar; Vladimir,10,0,34,24
1657583935448,MATH 197,001,091859,McAuley; Julian John,9999,0,9999,0
1657583935448,MATH 197,002,095566,Kedlaya; Kiran S.,9997,0,9999,2
1657583935448,MATH 197,003,095567,Xiao; Ming,9999,0,9999,0
1657583935448,MATH 197,004,095571,Perols; Johan Lars,9998,0,9999,1
1657583942513,COGS 9,A01,083615,Shannon; Kyle Michael,9,0,75,66
1657583948539,COGS 11,A01,083617,Boyle; Mary E. T.,23,0,48,25
1657583954567,COGS 13,A01,083071,Bastos; Amalia Pinkusfeld,11,0,71,60
1657583960590,COGS 14A,A01,092681,Semenuks; Arturs,5,1,100,95
1657583966616,COGS 14B,A01,083073,Cheng; Tzu-Han,6,0,63,57
1657583972650,COGS 17,A01,092677,Semenuks; Arturs,6,0,81,75
1657583978674,COGS 100,A01,083619,Allen; Michael Gordon,17,0,70,53
1657583984695,COGS 101A,A01,083621,Davis; Joshua Daniel,9,0,68,59
1657583990726,COGS 101B,A01,091572,Allen; Michael Gordon,12,0,65,53
1657583996751,COGS 101C,A01,083625,Delgado; Tania,17,0,35,18
1657584002777,COGS 107A,A01,083627,Boyle; Mary E. T.,13,0,60,47
1657584008800,COGS 118A,A01,083075,Gupta; Anjum,21,0,76,55
1657584014831,CSE 3,A50,083646,Miranda; Gregory Joseph,24,0,50,26
1657584020858,CSE 8A,A50,083650,Miranda; Gregory Joseph,17,1,56,39
1657584026884,CSE 11,A01,083080,Cao; Yingjun,6,15,40,34
1657584032920,CSE 12,A01,083652,Krause-Levy; Sophia Louisa,28,1,120,92
1657584038946,CSE 15L,A01,083654,Morris; Justin Loren,9,0,50,41
1657584038946,CSE 15L,A02,083655,Morris; Justin Loren,9,0,50,41
1657584044972,CSE 20,A01,083657,Tran; Khoa Dang,39,0,80,41
1657584051001,CSE 21,A01,095574,Bach; Quang Tran,22,0,48,26
1657584057023,CSE 30,A01,083084,Eldon; John,5,0,80,75
1657584057023,CSE 30,B01,095061,Bhaskar; Nishant,9,0,50,41
1657584063045,CSE 100,A01,083659,Cao; Yingjun,5,4,70,65
1657584069068,CSE 134B,A01,083661,Powell; Thomas Allan,22,0,100,78
1657584075102,CSE 140,A01,083663,Gungor; Onat,15,0,85,70
1657584081134,CSE 140L,A01,083088,Eldon; John,21,0,100,79
1657584087160,CSE 175,A01,083665,Kumar; Rakesh,3,0,25,22
1657584093181,CSE 190,A00,092507,Dubnov; Shlomo,8,0,20,12
1657584099209,ECE 45,A01,083139,Congero; Spencer William,6,0,75,69
1657584105231,ECE 65,A50,083695,Saad; Andrew S,12,0,30,18
1657584105231,ECE 65,A51,095125,Saad; Andrew S,24,0,26,2
1657584111256,ECE 109,A01,091882,Touri; Behrouz,19,0,70,51
1657584117279,ECE 180,A00,083140,Abi Samra; Nicholas Camill,1,0,30,29
1657584117279,ECE 180,B00,083141,Abi Samra; Nicholas Camill,0,0,30,30
1657584123311,MATH 10A,A01,083735,Patchell; Gregory David,2,0,30,28
1657584123311,MATH 10A,A02,083736,Patchell; Gregory David,20,0,30,10
1657584123311,MATH 10A,A03,083737,Patchell; Gregory David,16,0,30,14
1657584129339,MATH 10B,A01,083207,Lim; Seonhee,8,0,34,26
1657584129339,MATH 10B,A02,083208,Lim; Seonhee,9,0,35,26
1657584129339,MATH 10B,A03,093472,Lim; Seonhee,7,0,34,27
1657584129339,MATH 10B,B01,083739,Sinha; Shubham,12,0,30,18
1657584135379,MATH 18,A01,083743,Cinel; Cameron Alexander,7,0,30,23
1657584135379,MATH 18,A02,083744,Cinel; Cameron Alexander,17,0,30,13
1657584135379,MATH 18,A03,083745,Cinel; Cameron Alexander,9,0,30,21
1657584135379,MATH 18,B01,083748,Rideout; David Porter,5,0,37,32
1657584135379,MATH 18,B02,083749,Rideout; David Porter,5,0,36,31
1657584135379,MATH 18,B03,083750,Rideout; David Porter,3,0,37,34
1657584135379,MATH 18,B04,083751,Rideout; David Porter,6,0,36,30
1657584135379,MATH 18,B05,093473,Rideout; David Porter,6,0,36,30
1657584135379,MATH 18,B06,093474,Rideout; David Porter,6,0,36,30
1657584141404,MATH 20A,A01,083754,Zheng; Zequn,14,0,40,26
1657584147426,MATH 20B,A01,083756,Briones; Jor-el Thomas Caparas,4,0,36,32
1657584147426,MATH 20B,A02,083757,Briones; Jor-el Thomas Caparas,1,0,36,35
1657584147426,MATH 20B,A03,093475,Briones; Jor-el Thomas Caparas,2,0,36,34
1657584153455,MATH 20C,A01,083760,Briones; Jor-el Thomas Caparas,1,0,35,34
1657584153455,MATH 20C,A02,083761,Briones; Jor-el Thomas Caparas,8,0,35,27
1657584153455,MATH 20C,A03,093476,Briones; Jor-el Thomas Caparas,0,1,36,36
1657584153455,MATH 20C,B01,083762,Bach; Quang Tran,1,0,30,29
1657584159484,MATH 20D,A01,083765,Tran; Brian Kha,5,0,30,25
1657584159484,MATH 20D,A02,083766,Tran; Brian Kha,5,0,30,25
1657584159484,MATH 20D,A03,083767,Tran; Brian Kha,5,0,30,25
1657584165507,MATH 20E,A01,083771,Ganguly; Soumya,9,0,32,23
1657584165507,MATH 20E,A02,083772,Ganguly; Soumya,6,0,32,26
1657584165507,MATH 20E,B01,083773,Ciotti; Benjamin,20,0,35,15
1657584165507,MATH 20E,B02,083774,Ciotti; Benjamin,18,0,35,17
1657584171530,MATH 103A,A01,083777,Greenfeld; Be'Eri,3,0,36,33
1657584171530,MATH 103A,A02,083778,Greenfeld; Be'Eri,5,0,36,31
1657584171530,MATH 103A,A03,093561,Greenfeld; Be'Eri,5,0,36,31
1657584171530,MATH 103A,B01,083779,Greenfeld; Be'Eri,7,0,36,29
1657584171530,MATH 103A,B02,083780,Greenfeld; Be'Eri,4,0,36,32
1657584171530,MATH 103A,B03,093562,Greenfeld; Be'Eri,3,0,36,33
1657584177559,MATH 105,A01,085443,Carter; Anne Toulson,15,0,35,20
1657584177559,MATH 105,A02,093477,Carter; Anne Toulson,20,0,35,15
1657584183583,MATH 109,A01,083213,Ganzberger; Geoffrey Michael,2,0,34,32
1657584183583,MATH 109,A02,083214,Ganzberger; Geoffrey Michael,4,0,34,30
1657584183583,MATH 109,A03,093478,Ganzberger; Geoffrey Michael,2,0,34,32
1657584183583,MATH 109,B01,083215,Ganzberger; Geoffrey Michael,1,0,32,31
1657584183583,MATH 109,B02,083216,Ganzberger; Geoffrey Michael,2,0,32,30
1657584183583,MATH 109,B03,093479,Ganzberger; Geoffrey Michael,8,0,32,24
1657584189613,MATH 142A,A01,083219,Chow; Bennett,7,0,32,25
1657584189613,MATH 142A,A02,083220,Chow; Bennett,10,0,32,22
1657584189613,MATH 142A,A03,093480,Chow; Bennett,8,0,32,24
1657584189613,MATH 142A,B03,093481,Chow; Bennett,8,0,32,24
1657584189613,MATH 142A,B04,093558,Chow; Bennett,13,0,32,19
1657584189613,MATH 142A,B05,093559,Chow; Bennett,6,0,32,26
1657584195638,MATH 193A,A01,083224,Rotar; Vladimir,8,0,34,26
1657584195638,MATH 193A,A02,083225,Rotar; Vladimir,9,0,34,25
1657584195638,MATH 193A,A03,083781,Rotar; Vladimir,5,0,34,29
1657584195638,MATH 193A,A04,083782,Rotar; Vladimir,10,0,34,24
1657584195638,MATH 193A,A05,093482,Rotar; Vladimir,10,0,34,24
1657584201678,MATH 197,001,091859,McAuley; Julian John,9999,0,9999,0
1657584201678,MATH 197,002,095566,Kedlaya; Kiran S.,9997,0,9999,2
1657584201678,MATH 197,003,095567,Xiao; Ming,9999,0,9999,0
1657584201678,MATH 197,004,095571,Perols; Johan Lars,9998,0,9999,1
1657584208746,COGS 9,A01,083615,Shannon; Kyle Michael,9,0,75,66
1657584214773,COGS 11,A01,083617,Boyle; Mary E. T.,23,0,48,25
1657584220796,COGS 13,A01,083071,Bastos; Amalia Pinkusfeld,11,0,71,60
1657584226821,COGS 14A,A01,092681,Semenuks; Arturs,5,1,100,95
1657584232846,COGS 14B,A01,083073,Cheng; Tzu-Han,6,0,63,57
1657584238881,COGS 17,A01,092677,Semenuks; Arturs,6,0,81,75
1657584244908,COGS 100,A01,083619,Allen; Michael Gordon,17,0,70,53
1657584250936,COGS 101A,A01,083621,Davis; Joshua Daniel,9,0,68,59
1657584256958,COGS 101B,A01,091572,Allen; Michael Gordon,12,0,65,53
1657584262979,COGS 101C,A01,083625,Delgado; Tania,17,0,35,18
1657584269001,COGS 107A,A01,083627,Boyle; Mary E. T.,13,0,60,47
1657584275035,COGS 118A,A01,083075,Gupta; Anjum,21,0,76,55
1657584281068,CSE 3,A50,083646,Miranda; Gregory Joseph,24,0,50,26
1657584287091,CSE 8A,A50,083650,Miranda; Gregory Joseph,17,1,56,39
1657584293120,CSE 11,A01,083080,Cao; Yingjun,6,15,40,34
1657584299146,CSE 12,A01,083652,Krause-Levy; Sophia Louisa,28,1,120,92
1657584305169,CSE 15L,A01,083654,Morris; Justin Loren,9,0,50,41
1657584305169,CSE 15L,A02,083655,Morris; Justin Loren,9,0,50,41
1657584311193,CSE 20,A01,083657,Tran; Khoa Dang,39,0,80,41
1657584317216,CSE 21,A01,095574,Bach; Quang Tran,22,0,48,26
1657584323240,CSE 30,A01,083084,Eldon; John,5,0,80,75
1657584323240,CSE 30,B01,095061,Bhaskar; Nishant,9,0,50,41
1657584329266,CSE 100,A01,083659,Cao; Yingjun,5,4,70,65
1657584335291,CSE 134B,A01,083661,Powell; Thomas Allan,22,0,100,78
1657584341394,CSE 140,A01,083663,Gungor; Onat,15,0,85,70
1657584347416,CSE 140L,A01,083088,Eldon; John,21,0,100,79
1657584353438,CSE 175,A01,083665,Kumar; Rakesh,3,0,25,22
1657584359467,CSE 190,A00,092507,Dubnov; Shlomo,8,0,20,12
1657584365504,ECE 45,A01,083139,Congero; Spencer William,6,0,75,69
1657584371541,ECE 65,A50,083695,Saad; Andrew S,12,0,30,18
1657584371541,ECE 65,A51,095125,Saad; Andrew S,24,0,26,2
1657584377565,ECE 109,A01,091882,Touri; Behrouz,19,0,70,51
1657584383588,ECE 180,A00,083140,Abi Samra; Nicholas Camill,1,0,30,29
1657584383588,ECE 180,B00,083141,Abi Samra; Nicholas Camill,0,0,30,30
1657584389612,MATH 10A,A01,083735,Patchell; Gregory David,2,0,30,28
1657584389612,MATH 10A,A02,083736,Patchell; Gregory David,20,0,30,10
1657584389612,MATH 10A,A03,083737,Patchell; Gregory David,16,0,30,14
1657584395641,MATH 10B,A01,083207,Lim; Seonhee,8,0,34,26
1657584395641,MATH 10B,A02,083208,Lim; Seonhee,9,0,35,26
1657584395641,MATH 10B,A03,093472,Lim; Seonhee,7,0,34,27
1657584395641,MATH 10B,B01,083739,Sinha; Shubham,12,0,30,18
1657584401671,MATH 18,A01,083743,Cinel; Cameron Alexander,7,0,30,23
1657584401671,MATH 18,A02,083744,Cinel; Cameron Alexander,17,0,30,13
1657584401671,MATH 18,A03,083745,Cinel; Cameron Alexander,9,0,30,21
1657584401671,MATH 18,B01,083748,Rideout; David Porter,5,0,37,32
1657584401671,MATH 18,B02,083749,Rideout; David Porter,5,0,36,31
1657584401671,MATH 18,B03,083750,Rideout; David Porter,3,0,37,34
1657584401671,MATH 18,B04,083751,Rideout; David Porter,6,0,36,30
1657584401671,MATH 18,B05,093473,Rideout; David Porter,6,0,36,30
1657584401671,MATH 18,B06,093474,Rideout; David Porter,6,0,36,30
1657584407693,MATH 20A,A01,083754,Zheng; Zequn,14,0,40,26
1657584413716,MATH 20B,A01,083756,Briones; Jor-el Thomas Caparas,4,0,36,32
1657584413716,MATH 20B,A02,083757,Briones; Jor-el Thomas Caparas,1,0,36,35
1657584413716,MATH 20B,A03,093475,Briones; Jor-el Thomas Caparas,2,0,36,34
1657584419752,MATH 20C,A01,083760,Briones; Jor-el Thomas Caparas,1,0,35,34
1657584419752,MATH 20C,A02,083761,Briones; Jor-el Thomas Caparas,8,0,35,27
1657584419752,MATH 20C,A03,093476,Briones; Jor-el Thomas Caparas,0,1,36,36
1657584419752,MATH 20C,B01,083762,Bach; Quang Tran,1,0,30,29
1657584425780,MATH 20D,A01,083765,Tran; Brian Kha,5,0,30,25
1657584425780,MATH 20D,A02,083766,Tran; Brian Kha,5,0,30,25
1657584425780,MATH 20D,A03,083767,Tran; Brian Kha,5,0,30,25
1657584431803,MATH 20E,A01,083771,Ganguly; Soumya,9,0,32,23
1657584431803,MATH 20E,A02,083772,Ganguly; Soumya,6,0,32,26
1657584431803,MATH 20E,B01,083773,Ciotti; Benjamin,20,0,35,15
1657584431803,MATH 20E,B02,083774,Ciotti; Benjamin,18,0,35,17
1657584437836,MATH 103A,A01,083777,Greenfeld; Be'Eri,3,0,36,33
1657584437836,MATH 103A,A02,083778,Greenfeld; Be'Eri,5,0,36,31
1657584437836,MATH 103A,A03,093561,Greenfeld; Be'Eri,5,0,36,31
1657584437836,MATH 103A,B01,083779,Greenfeld; Be'Eri,7,0,36,29
1657584437836,MATH 103A,B02,083780,Greenfeld; Be'Eri,4,0,36,32
1657584437836,MATH 103A,B03,093562,Greenfeld; Be'Eri,3,0,36,33
1657584443865,MATH 105,A01,085443,Carter; Anne Toulson,15,0,35,20
1657584443865,MATH 105,A02,093477,Carter; Anne Toulson,20,0,35,15
1657584449893,MATH 109,A01,083213,Ganzberger; Geoffrey Michael,2,0,34,32
1657584449893,MATH 109,A02,083214,Ganzberger; Geoffrey Michael,4,0,34,30
1657584449893,MATH 109,A03,093478,Ganzberger; Geoffrey Michael,2,0,34,32
1657584449893,MATH 109,B01,083215,Ganzberger; Geoffrey Michael,1,0,32,31
1657584449893,MATH 109,B02,083216,Ganzberger; Geoffrey Michael,2,0,32,30
1657584449893,MATH 109,B03,093479,Ganzberger; Geoffrey Michael,8,0,32,24
1657584455918,MATH 142A,A01,083219,Chow; Bennett,7,0,32,25
1657584455918,MATH 142A,A02,083220,Chow; Bennett,10,0,32,22
1657584455918,MATH 142A,A03,093480,Chow; Bennett,8,0,32,24
1657584455918,MATH 142A,B03,093481,Chow; Bennett,8,0,32,24
1657584455918,MATH 142A,B04,093558,Chow; Bennett,13,0,32,19
1657584455918,MATH 142A,B05,093559,Chow; Bennett,6,0,32,26
1657584461949,MATH 193A,A01,083224,Rotar; Vladimir,8,0,34,26
1657584461949,MATH 193A,A02,083225,Rotar; Vladimir,9,0,34,25
1657584461949,MATH 193A,A03,083781,Rotar; Vladimir,5,0,34,29
1657584461949,MATH 193A,A04,083782,Rotar; Vladimir,10,0,34,24
1657584461949,MATH 193A,A05,093482,Rotar; Vladimir,10,0,34,24
1657584467977,MATH 197,001,091859,McAuley; Julian John,9999,0,9999,0
1657584467977,MATH 197,002,095566,Kedlaya; Kiran S.,9997,0,9999,2
1657584467977,MATH 197,003,095567,Xiao; Ming,9999,0,9999,0
1657584467977,MATH 197,004,095571,Perols; Johan Lars,9998,0,9999,1
1657584475035,COGS 9,A01,083615,Shannon; Kyle Michael,9,0,75,66
1657584481058,COGS 11,A01,083617,Boyle; Mary E. T.,23,0,48,25
1657584487080,COGS 13,A01,083071,Bastos; Amalia Pinkusfeld,11,0,71,60
1657584493103,COGS 14A,A01,092681,Semenuks; Arturs,5,1,100,95
1657584499131,COGS 14B,A01,083073,Cheng; Tzu-Han,6,0,63,57
1657584505157,COGS 17,A01,092677,Semenuks; Arturs,6,0,81,75
1657584511189,COGS 100,A01,083619,Allen; Michael Gordon,17,0,70,53
1657584517212,COGS 101A,A01,083621,Davis; Joshua Daniel,9,0,68,59
1657584523239,COGS 101B,A01,091572,Allen; Michael Gordon,12,0,65,53
1657584529265,COGS 101C,A01,083625,Delgado; Tania,17,0,35,18
1657584535291,COGS 107A,A01,083627,Boyle; Mary E. T.,13,0,60,47
1657584541317,COGS 118A,A01,083075,Gupta; Anjum,21,0,76,55
1657584547348,CSE 3,A50,083646,Miranda; Gregory Joseph,24,0,50,26
1657584553378,CSE 8A,A50,083650,Miranda; Gregory Joseph,17,1,56,39
1657584559411,CSE 11,A01,083080,Cao; Yingjun,6,15,40,34
1657584565435,CSE 12,A01,083652,Krause-Levy; Sophia Louisa,28,1,120,92
1657584571457,CSE 15L,A01,083654,Morris; Justin Loren,9,0,50,41
1657584571457,CSE 15L,A02,083655,Morris; Justin Loren,9,0,50,41
1657584577480,CSE 20,A01,083657,Tran; Khoa Dang,39,0,80,41
1657584583508,CSE 21,A01,095574,Bach; Quang Tran,22,0,48,26
1657584589532,CSE 30,A01,083084,Eldon; John,5,0,80,75
1657584589532,CSE 30,B01,095061,Bhaskar; Nishant,9,0,50,41
1657584595556,CSE 100,A01,083659,Cao; Yingjun,5,4,70,65
1657584601591,CSE 134B,A01,083661,Powell; Thomas Allan,22,0,100,78
1657584607614,CSE 140,A01,083663,Gungor; Onat,15,0,85,70
1657584613643,CSE 140L,A01,083088,Eldon; John,21,0,100,79
1657584619667,CSE 175,A01,083665,Kumar; Rakesh,3,0,25,22
1657584625694,CSE 190,A00,092507,Dubnov; Shlomo,8,0,20,12
1657584631716,ECE 45,A01,083139,Congero; Spencer William,6,0,75,69
1657584637740,ECE 65,A50,083695,Saad; Andrew S,12,0,30,18
1657584637740,ECE 65,A51,095125,Saad; Andrew S,24,0,26,2
1657584643770,ECE 109,A01,091882,Touri; Behrouz,19,0,70,51
1657584649797,ECE 180,A00,083140,Abi Samra; Nicholas Camill,1,0,30,29
1657584649797,ECE 180,B00,083141,Abi Samra; Nicholas Camill,0,0,30,30
1657584655839,MATH 10A,A01,083735,Patchell; Gregory David,2,0,30,28
1657584655839,MATH 10A,A02,083736,Patchell; Gregory David,20,0,30,10
1657584655839,MATH 10A,A03,083737,Patchell; Gregory David,16,0,30,14
1657584661871,MATH 10B,A01,083207,Lim; Seonhee,8,0,34,26
1657584661871,MATH 10B,A02,083208,Lim; Seonhee,9,0,35,26
1657584661871,MATH 10B,A03,093472,Lim; Seonhee,7,0,34,27
1657584661871,MATH 10B,B01,083739,Sinha; Shubham,12,0,30,18
1657584667897,MATH 18,A01,083743,Cinel; Cameron Alexander,7,0,30,23
1657584667897,MATH 18,A02,083744,Cinel; Cameron Alexander,17,0,30,13
1657584667897,MATH 18,A03,083745,Cinel; Cameron Alexander,9,0,30,21
1657584667897,MATH 18,B01,083748,Rideout; David Porter,5,0,37,32
1657584667897,MATH 18,B02,083749,Rideout; David Porter,5,0,36,31
1657584667897,MATH 18,B03,083750,Rideout; David Porter,3,0,37,34
1657584667897,MATH 18,B04,083751,Rideout; David Porter,6,0,36,30
1657584667897,MATH 18,B05,093473,Rideout; David Porter,6,0,36,30
1657584667897,MATH 18,B06,093474,Rideout; David Porter,6,0,36,30
1657584673923,MATH 20A,A01,083754,Zheng; Zequn,14,0,40,26
1657584679951,MATH 20B,A01,083756,Briones; Jor-el Thomas Caparas,4,0,36,32
1657584679951,MATH 20B,A02,083757,Briones; Jor-el Thomas Caparas,1,0,36,35
1657584679951,MATH 20B,A03,093475,Briones; Jor-el Thomas Caparas,2,0,36,34
1657584685977,MATH 20C,A01,083760,Briones; Jor-el Thomas Caparas,1,0,35,34
1657584685977,MATH 20C,A02,083761,Briones; Jor-el Thomas Caparas,8,0,35,27
1657584685977,MATH 20C,A03,093476,Briones; Jor-el Thomas Caparas,0,1,36,36
1657584685977,MATH 20C,B01,083762,Bach; Quang Tran,1,0,30,29
1657584692021,MATH 20D,A01,083765,Tran; Brian Kha,5,0,30,25
1657584692021,MATH 20D,A02,083766,Tran; Brian Kha,5,0,30,25
1657584692021,MATH 20D,A03,083767,Tran; Brian Kha,5,0,30,25
1657584698046,MATH 20E,A01,083771,Ganguly; Soumya,9,0,32,23
1657584698046,MATH 20E,A02,083772,Ganguly; Soumya,6,0,32,26
1657584698046,MATH 20E,B01,083773,Ciotti; Benjamin,20,0,35,15
1657584698046,MATH 20E,B02,083774,Ciotti; Benjamin,18,0,35,17
1657584704077,MATH 103A,A01,083777,Greenfeld; Be'Eri,3,0,36,33
1657584704077,MATH 103A,A02,083778,Greenfeld; Be'Eri,5,0,36,31
1657584704077,MATH 103A,A03,093561,Greenfeld; Be'Eri,5,0,36,31
1657584704077,MATH 103A,B01,083779,Greenfeld; Be'Eri,7,0,36,29
1657584704077,MATH 103A,B02,083780,Greenfeld; Be'Eri,4,0,36,32
1657584704077,MATH 103A,B03,093562,Greenfeld; Be'Eri,3,0,36,33
1657584710101,MATH 105,A01,085443,Carter; Anne Toulson,15,0,35,20
1657584710101,MATH 105,A02,093477,Carter; Anne Toulson,20,0,35,15
1657584716124,MATH 109,A01,083213,Ganzberger; Geoffrey Michael,2,0,34,32
1657584716124,MATH 109,A02,083214,Ganzberger; Geoffrey Michael,4,0,34,30
1657584716124,MATH 109,A03,093478,Ganzberger; Geoffrey Michael,2,0,34,32
1657584716124,MATH 109,B01,083215,Ganzberger; Geoffrey Michael,1,0,32,31
1657584716124,MATH 109,B02,083216,Ganzberger; Geoffrey Michael,2,0,32,30
1657584716124,MATH 109,B03,093479,Ganzberger; Geoffrey Michael,8,0,32,24
1657584722156,MATH 142A,A01,083219,Chow; Bennett,7,0,32,25
1657584722156,MATH 142A,A02,083220,Chow; Bennett,10,0,32,22
1657584722156,MATH 142A,A03,093480,Chow; Bennett,8,0,32,24
1657584722156,MATH 142A,B03,093481,Chow; Bennett,8,0,32,24
1657584722156,MATH 142A,B04,093558,Chow; Bennett,13,0,32,19
1657584722156,MATH 142A,B05,093559,Chow; Bennett,6,0,32,26
1657584728179,MATH 193A,A01,083224,Rotar; Vladimir,8,0,34,26
1657584728179,MATH 193A,A02,083225,Rotar; Vladimir,9,0,34,25
1657584728179,MATH 193A,A03,083781,Rotar; Vladimir,5,0,34,29
1657584728179,MATH 193A,A04,083782,Rotar; Vladimir,10,0,34,24
1657584728179,MATH 193A,A05,093482,Rotar; Vladimir,10,0,34,24
1657584734215,MATH 197,001,091859,McAuley; Julian John,9999,0,9999,0
1657584734215,MATH 197,002,095566,Kedlaya; Kiran S.,9997,0,9999,2
1657584734215,MATH 197,003,095567,Xiao; Ming,9999,0,9999,0
1657584734215,MATH 197,004,095571,Perols; Johan Lars,9998,0,9999,1
1657584741287,COGS 9,A01,083615,Shannon; Kyle Michael,9,0,75,66
1657584747316,COGS 11,A01,083617,Boyle; Mary E. T.,23,0,48,25
1657584753345,COGS 13,A01,083071,Bastos; Amalia Pinkusfeld,11,0,71,60
1657584759371,COGS 14A,A01,092681,Semenuks; Arturs,5,1,100,95
1657584765397,COGS 14B,A01,083073,Cheng; Tzu-Han,6,0,63,57
1657584771421,COGS 17,A01,092677,Semenuks; Arturs,6,0,81,75
1657584777446,COGS 100,A01,083619,Allen; Michael Gordon,17,0,70,53
1657584783470,COGS 101A,A01,083621,Davis; Joshua Daniel,9,0,68,59
1657584789493,COGS 101B,A01,091572,Allen; Michael Gordon,12,0,65,53
1657584795515,COGS 101C,A01,083625,Delgado; Tania,17,0,35,18
1657584801543,COGS 107A,A01,083627,Boyle; Mary E. T.,13,0,60,47
1657584807570,COGS 118A,A01,083075,Gupta; Anjum,21,0,76,55
1657584813601,CSE 3,A50,083646,Miranda; Gregory Joseph,24,0,50,26
1657584819655,CSE 8A,A50,083650,Miranda; Gregory Joseph,17,1,56,39
1657584825693,CSE 11,A01,083080,Cao; Yingjun,6,15,40,34
1657584831722,CSE 12,A01,083652,Krause-Levy; Sophia Louisa,28,1,120,92
1657584837754,CSE 15L,A01,083654,Morris; Justin Loren,9,0,50,41
1657584837754,CSE 15L,A02,083655,Morris; Justin Loren,9,0,50,41
1657584843786,CSE 20,A01,083657,Tran; Khoa Dang,39,0,80,41
1657584849818,CSE 21,A01,095574,Bach; Quang Tran,22,0,48,26
1657584855845,CSE 30,A01,083084,Eldon; John,5,0,80,75
1657584855845,CSE 30,B01,095061,Bhaskar; Nishant,9,0,50,41
1657584861872,CSE 100,A01,083659,Cao; Yingjun,5,4,70,65
1657584867903,CSE 134B,A01,083661,Powell; Thomas Allan,22,0,100,78
1657584873927,CSE 140,A01,083663,Gungor; Onat,15,0,85,70
1657584879953,CSE 140L,A01,083088,Eldon; John,21,0,100,79
1657584885979,CSE 175,A01,083665,Kumar; Rakesh,3,0,25,22
1657584892003,CSE 190,A00,092507,Dubnov; Shlomo,8,0,20,12
1657584898030,ECE 45,A01,083139,Congero; Spencer William,6,0,75,69
1657584904053,ECE 65,A50,083695,Saad; Andrew S,12,0,30,18
1657584904053,ECE 65,A51,095125,Saad; Andrew S,24,0,26,2
1657584910076,ECE 109,A01,091882,Touri; Behrouz,19,0,70,51
1657584916100,ECE 180,A00,083140,Abi Samra; Nicholas Camill,1,0,30,29
1657584916100,ECE 180,B00,083141,Abi Samra; Nicholas Camill,0,0,30,30
1657584922130,MATH 10A,A01,083735,Patchell; Gregory David,2,0,30,28
1657584922130,MATH 10A,A02,083736,Patchell; Gregory David,20,0,30,10
1657584922130,MATH 10A,A03,083737,Patchell; Gregory David,16,0,30,14
1657584928163,MATH 10B,A01,083207,Lim; Seonhee,8,0,34,26
1657584928163,MATH 10B,A02,083208,Lim; Seonhee,9,0,35,26
1657584928163,MATH 10B,A03,093472,Lim; Seonhee,7,0,34,27
1657584928163,MATH 10B,B01,083739,Sinha; Shubham,12,0,30,18
1657584934189,MATH 18,A01,083743,Cinel; Cameron Alexander,7,0,30,23
1657584934189,MATH 18,A02,083744,Cinel; Cameron Alexander,17,0,30,13
1657584934189,MATH 18,A03,083745,Cinel; Cameron Alexander,9,0,30,21
1657584934189,MATH 18,B01,083748,Rideout; David Porter,5,0,37,32
1657584934189,MATH 18,B02,083749,Rideout; David Porter,5,0,36,31
1657584934189,MATH 18,B03,083750,Rideout; David Porter,3,0,37,34
1657584934189,MATH 18,B04,083751,Rideout; David Porter,6,0,36,30
1657584934189,MATH 18,B05,093473,Rideout; David Porter,6,0,36,30
1657584934189,MATH 18,B06,093474,Rideout; David Porter,6,0,36,30
1657584940293,MATH 20A,A01,083754,Zheng; Zequn,14,0,40,26
1657584946318,MATH 20B,A01,083756,Briones; Jor-el Thomas Caparas,4,0,36,32
1657584946318,MATH 20B,A02,083757,Briones; Jor-el Thomas Caparas,1,0,36,35
1657584946318,MATH 20B,A03,093475,Briones; Jor-el Thomas Caparas,2,0,36,34
1657584952345,MATH 20C,A01,083760,Briones; Jor-el Thomas Caparas,1,0,35,34
1657584952345,MATH 20C,A02,083761,Briones; Jor-el Thomas Caparas,8,0,35,27
1657584952345,MATH 20C,A03,093476,Briones; Jor-el Thomas Caparas,0,1,36,36
1657584952345,MATH 20C,B01,083762,Bach; Quang Tran,1,0,30,29
1657584958367,MATH 20D,A01,083765,Tran; Brian Kha,5,0,30,25
1657584958367,MATH 20D,A02,083766,Tran; Brian Kha,5,0,30,25
1657584958367,MATH 20D,A03,083767,Tran; Brian Kha,5,0,30,25
1657584964397,MATH 20E,A01,083771,Ganguly; Soumya,9,0,32,23
1657584964397,MATH 20E,A02,083772,Ganguly; Soumya,6,0,32,26
1657584964397,MATH 20E,B01,083773,Ciotti; Benjamin,20,0,35,15
1657584964397,MATH 20E,B02,083774,Ciotti; Benjamin,18,0,35,17
1657584970427,MATH 103A,A01,083777,Greenfeld; Be'Eri,3,0,36,33
1657584970427,MATH 103A,A02,083778,Greenfeld; Be'Eri,5,0,36,31
1657584970427,MATH 103A,A03,093561,Greenfeld; Be'Eri,5,0,36,31
1657584970427,MATH 103A,B01,083779,Greenfeld; Be'Eri,7,0,36,29
1657584970427,MATH 103A,B02,083780,Greenfeld; Be'Eri,4,0,36,32
1657584970427,MATH 103A,B03,093562,Greenfeld; Be'Eri,3,0,36,33
1657584976452,MATH 105,A01,085443,Carter; Anne Toulson,15,0,35,20
1657584976452,MATH 105,A02,093477,Carter; Anne Toulson,20,0,35,15
1657584982487,MATH 109,A01,083213,Ganzberger; Geoffrey Michael,2,0,34,32
1657584982487,MATH 109,A02,083214,Ganzberger; Geoffrey Michael,4,0,34,30
1657584982487,MATH 109,A03,093478,Ganzberger; Geoffrey Michael,2,0,34,32
1657584982487,MATH 109,B01,083215,Ganzberger; Geoffrey Michael,1,0,32,31
1657584982487,MATH 109,B02,083216,Ganzberger; Geoffrey Michael,2,0,32,30
1657584982487,MATH 109,B03,093479,Ganzberger; Geoffrey Michael,8,0,32,24
1657584988515,MATH 142A,A01,083219,Chow; Bennett,7,0,32,25
1657584988515,MATH 142A,A02,083220,Chow; Bennett,10,0,32,22
1657584988515,MATH 142A,A03,093480,Chow; Bennett,8,0,32,24
1657584988515,MATH 142A,B03,093481,Chow; Bennett,8,0,32,24
1657584988515,MATH 142A,B04,093558,Chow; Bennett,13,0,32,19
1657584988515,MATH 142A,B05,093559,Chow; Bennett,6,0,32,26
1657584994542,MATH 193A,A01,083224,Rotar; Vladimir,8,0,34,26
1657584994542,MATH 193A,A02,083225,Rotar; Vladimir,9,0,34,25
1657584994542,MATH 193A,A03,083781,Rotar; Vladimir,5,0,34,29
1657584994542,MATH 193A,A04,083782,Rotar; Vladimir,10,0,34,24
1657584994542,MATH 193A,A05,093482,Rotar; Vladimir,10,0,34,24
1657585000566,MATH 197,001,091859,McAuley; Julian John,9999,0,9999,0
1657585000566,MATH 197,002,095566,Kedlaya; Kiran S.,9997,0,9999,2
1657585000566,MATH 197,003,095567,Xiao; Ming,9999,0,9999,0
1657585000566,MATH 197,004,095571,Perols; Johan Lars,9998,0,9999,1
1657585007629,COGS 9,A01,083615,Shannon; Kyle Michael,9,0,75,66
1657585013657,COGS 11,A01,083617,Boyle; Mary E. T.,23,0,48,25
1657585019681,COGS 13,A01,083071,Bastos; Amalia Pinkusfeld,11,0,71,60
1657585025704,COGS 14A,A01,092681,Semenuks; Arturs,5,1,100,95
1657585031731,COGS 14B,A01,083073,Cheng; Tzu-Han,6,0,63,57
1657585037758,COGS 17,A01,092677,Semenuks; Arturs,6,0,81,75
1657585043782,COGS 100,A01,083619,Allen; Michael Gordon,17,0,70,53
1657585049804,COGS 101A,A01,083621,Davis; Joshua Daniel,9,0,68,59
1657585055826,COGS 101B,A01,091572,Allen; Michael Gordon,12,0,65,53
1657585061850,COGS 101C,A01,083625,Delgado; Tania,17,0,35,18
1657585067872,COGS 107A,A01,083627,Boyle; Mary E. T.,13,0,60,47
1657585073905,COGS 118A,A01,083075,Gupta; Anjum,21,0,76,55
1657585079933,CSE 3,A50,083646,Miranda; Gregory Joseph,24,0,50,26
1657585085964,CSE 8A,A50,083650,Miranda; Gregory Joseph,17,1,56,39
1657585091995,CSE 11,A01,083080,Cao; Yingjun,6,15,40,34
1657585098022,CSE 12,A01,083652,Krause-Levy; Sophia Louisa,28,1,120,92
1657585104044,CSE 15L,A01,083654,Morris; Justin Loren,9,0,50,41
1657585104044,CSE 15L,A02,083655,Morris; Justin Loren,9,0,50,41
1657585110071,CSE 20,A01,083657,Tran; Khoa Dang,39,0,80,41
1657585116093,CSE 21,A01,095574,Bach; Quang Tran,22,0,48,26
1657585122122,CSE 30,A01,083084,Eldon; John,5,0,80,75
1657585122122,CSE 30,B01,095061,Bhaskar; Nishant,9,0,50,41
1657585128144,CSE 100,A01,083659,Cao; Yingjun,5,4,70,65
1657585134178,CSE 134B,A01,083661,Powell; Thomas Allan,22,0,100,78
1657585140209,CSE 140,A01,083663,Gungor; Onat,15,0,85,70
1657585146235,CSE 140L,A01,083088,Eldon; John,21,0,100,79
1657585152265,CSE 175,A01,083665,Kumar; Rakesh,3,0,25,22
1657585158291,CSE 190,A00,092507,Dubnov; Shlomo,8,0,20,12
1657585164316,ECE 45,A01,083139,Congero; Spencer William,6,0,75,69
1657585170347,ECE 65,A50,083695,Saad; Andrew S,12,0,30,18
1657585170347,ECE 65,A51,095125,Saad; Andrew S,24,0,26,2
1657585176374,ECE 109,A01,091882,Touri; Behrouz,19,0,70,51
1657585182397,ECE 180,A00,083140,Abi Samra; Nicholas Camill,1,0,30,29
1657585182397,ECE 180,B00,083141,Abi Samra; Nicholas Camill,0,0,30,30
1657585188425,MATH 10A,A01,083735,Patchell; Gregory David,2,0,30,28
1657585188425,MATH 10A,A02,083736,Patchell; Gregory David,20,0,30,10
1657585188425,MATH 10A,A03,083737,Patchell; Gregory David,16,0,30,14
1657585194449,MATH 10B,A01,083207,Lim; Seonhee,8,0,34,26
1657585194449,MATH 10B,A02,083208,Lim; Seonhee,9,0,35,26
1657585194449,MATH 10B,A03,093472,Lim; Seonhee,7,0,34,27
1657585194449,MATH 10B,B01,083739,Sinha; Shubham,12,0,30,18
1657585200473,MATH 18,A01,083743,Cinel; Cameron Alexander,7,0,30,23
1657585200473,MATH 18,A02,083744,Cinel; Cameron Alexander,17,0,30,13
1657585200473,MATH 18,A03,083745,Cinel; Cameron Alexander,9,0,30,21
1657585200473,MATH 18,B01,083748,Rideout; David Porter,5,0,37,32
1657585200473,MATH 18,B02,083749,Rideout; David Porter,5,0,36,31
1657585200473,MATH 18,B03,083750,Rideout; David Porter,3,0,37,34
1657585200473,MATH 18,B04,083751,Rideout; David Porter,6,0,36,30
1657585200473,MATH 18,B05,093473,Rideout; David Porter,6,0,36,30
1657585200473,MATH 18,B06,093474,Rideout; David Porter,6,0,36,30
1657585206495,MATH 20A,A01,083754,Zheng; Zequn,14,0,40,26
1657585212518,MATH 20B,A01,083756,Briones; Jor-el Thomas Caparas,4,0,36,32
1657585212518,MATH 20B,A02,083757,Briones; Jor-el Thomas Caparas,1,0,36,35
1657585212518,MATH 20B,A03,093475,Briones; Jor-el Thomas Caparas,2,0,36,34
1657585218548,MATH 20C,A01,083760,Briones; Jor-el Thomas Caparas,1,0,35,34
1657585218548,MATH 20C,A02,083761,Briones; Jor-el Thomas Caparas,8,0,35,27
1657585218548,MATH 20C,A03,093476,Briones; Jor-el Thomas Caparas,0,1,36,36
1657585218548,MATH 20C,B01,083762,Bach; Quang Tran,1,0,30,29
1657585224573,MATH 20D,A01,083765,Tran; Brian Kha,5,0,30,25
1657585224573,MATH 20D,A02,083766,Tran; Brian Kha,5,0,30,25
1657585224573,MATH 20D,A03,083767,Tran; Brian Kha,5,0,30,25
1657585230599,MATH 20E,A01,083771,Ganguly; Soumya,9,0,32,23
1657585230599,MATH 20E,A02,083772,Ganguly; Soumya,6,0,32,26
1657585230599,MATH 20E,B01,083773,Ciotti; Benjamin,20,0,35,15
1657585230599,MATH 20E,B02,083774,Ciotti; Benjamin,18,0,35,17
1657585236627,MATH 103A,A01,083777,Greenfeld; Be'Eri,3,0,36,33
1657585236627,MATH 103A,A02,083778,Greenfeld; Be'Eri,5,0,36,31
1657585236627,MATH 103A,A03,093561,Greenfeld; Be'Eri,5,0,36,31
1657585236627,MATH 103A,B01,083779,Greenfeld; Be'Eri,7,0,36,29
1657585236627,MATH 103A,B02,083780,Greenfeld; Be'Eri,4,0,36,32
1657585236627,MATH 103A,B03,093562,Greenfeld; Be'Eri,3,0,36,33
1657585242663,MATH 105,A01,085443,Carter; Anne Toulson,15,0,35,20
1657585242663,MATH 105,A02,093477,Carter; Anne Toulson,20,0,35,15
1657585248696,MATH 109,A01,083213,Ganzberger; Geoffrey Michael,2,0,34,32
1657585248696,MATH 109,A02,083214,Ganzberger; Geoffrey Michael,4,0,34,30
1657585248696,MATH 109,A03,093478,Ganzberger; Geoffrey Michael,2,0,34,32
1657585248696,MATH 109,B01,083215,Ganzberger; Geoffrey Michael,1,0,32,31
1657585248696,MATH 109,B02,083216,Ganzberger; Geoffrey Michael,2,0,32,30
1657585248696,MATH 109,B03,093479,Ganzberger; Geoffrey Michael,8,0,32,24
1657585254721,MATH 142A,A01,083219,Chow; Bennett,7,0,32,25
1657585254721,MATH 142A,A02,083220,Chow; Bennett,10,0,32,22
1657585254721,MATH 142A,A03,093480,Chow; Bennett,8,0,32,24
1657585254721,MATH 142A,B03,093481,Chow; Bennett,8,0,32,24
1657585254721,MATH 142A,B04,093558,Chow; Bennett,13,0,32,19
1657585254721,MATH 142A,B05,093559,Chow; Bennett,6,0,32,26
1657585260748,MATH 193A,A01,083224,Rotar; Vladimir,8,0,34,26
1657585260748,MATH 193A,A02,083225,Rotar; Vladimir,9,0,34,25
1657585260748,MATH 193A,A03,083781,Rotar; Vladimir,5,0,34,29
1657585260748,MATH 193A,A04,083782,Rotar; Vladimir,10,0,34,24
1657585260748,MATH 193A,A05,093482,Rotar; Vladimir,10,0,34,24
1657585266774,MATH 197,001,091859,McAuley; Julian John,9999,0,9999,0
1657585266774,MATH 197,002,095566,Kedlaya; Kiran S.,9997,0,9999,2
1657585266774,MATH 197,003,095567,Xiao; Ming,9999,0,9999,0
1657585266774,MATH 197,004,095571,Perols; Johan Lars,9998,0,9999,1
1657585273831,COGS 9,A01,083615,Shannon; Kyle Michael,9,0,75,66
1657585279859,COGS 11,A01,083617,Boyle; Mary E. T.,23,0,48,25
1657585285886,COGS 13,A01,083071,Bastos; Amalia Pinkusfeld,11,0,71,60
1657585291909,COGS 14A,A01,092681,Semenuks; Arturs,5,1,100,95
1657585297931,COGS 14B,A01,083073,Cheng; Tzu-Han,6,0,63,57
1657585303955,COGS 17,A01,092677,Semenuks; Arturs,6,0,81,75
1657585309978,COGS 100,A01,083619,Allen; Michael Gordon,17,0,70,53
1657585316001,COGS 101A,A01,083621,Davis; Joshua Daniel,9,0,68,59
1657585322031,COGS 101B,A01,091572,Allen; Michael Gordon,12,0,65,53
1657585328054,COGS 101C,A01,083625,Delgado; Tania,17,0,35,18
1657585334078,COGS 107A,A01,083627,Boyle; Mary E. T.,13,0,60,47
1657585340112,COGS 118A,A01,083075,Gupta; Anjum,21,0,76,55
1657585346139,CSE 3,A50,083646,Miranda; Gregory Joseph,24,0,50,26
1657585352162,CSE 8A,A50,083650,Miranda; Gregory Joseph,17,1,56,39
1657585358206,CSE 11,A01,083080,Cao; Yingjun,6,15,40,34
1657585364231,CSE 12,A01,083652,Krause-Levy; Sophia Louisa,28,1,120,92
1657585370258,CSE 15L,A01,083654,Morris; Justin Loren,9,0,50,41
1657585370258,CSE 15L,A02,083655,Morris; Justin Loren,9,0,50,41
1657585376282,CSE 20,A01,083657,Tran; Khoa Dang,39,0,80,41
1657585382305,CSE 21,A01,095574,Bach; Quang Tran,22,0,48,26
1657585388328,CSE 30,A01,083084,Eldon; John,5,0,80,75
1657585388328,CSE 30,B01,095061,Bhaskar; Nishant,9,0,50,41
1657585394356,CSE 100,A01,083659,Cao; Yingjun,5,4,70,65
1657585400382,CSE 134B,A01,083661,Powell; Thomas Allan,22,0,100,78
1657585406403,CSE 140,A01,083663,Gungor; Onat,15,0,85,70
1657585412429,CSE 140L,A01,083088,Eldon; John,21,0,100,79
1657585418460,CSE 175,A01,083665,Kumar; Rakesh,3,0,25,22
1657585424487,CSE 190,A00,092507,Dubnov; Shlomo,8,0,20,12
1657585430511,ECE 45,A01,083139,Congero; Spencer William,6,0,75,69
1657585436537,ECE 65,A50,083695,Saad; Andrew S,12,0,30,18
1657585436537,ECE 65,A51,095125,Saad; Andrew S,24,0,26,2
1657585442567,ECE 109,A01,091882,Touri; Behrouz,19,0,70,51
1657585448594,ECE 180,A00,083140,Abi Samra; Nicholas Camill,1,0,30,29
1657585448594,ECE 180,B00,083141,Abi Samra; Nicholas Camill,0,0,30,30
1657585454625,MATH 10A,A01,083735,Patchell; Gregory David,2,0,30,28
1657585454625,MATH 10A,A02,083736,Patchell; Gregory David,20,0,30,10
1657585454625,MATH 10A,A03,083737,Patchell; Gregory David,16,0,30,14
1657585460650,MATH 10B,A01,083207,Lim; Seonhee,8,0,34,26
1657585460650,MATH 10B,A02,083208,Lim; Seonhee,9,0,35,26
1657585460650,MATH 10B,A03,093472,Lim; Seonhee,7,0,34,27
1657585460650,MATH 10B,B01,083739,Sinha; Shubham,12,0,30,18
1657585466675,MATH 18,A01,083743,Cinel; Cameron Alexander,7,0,30,23
1657585466675,MATH 18,A02,083744,Cinel; Cameron Alexander,17,0,30,13
1657585466675,MATH 18,A03,083745,Cinel; Cameron Alexander,9,0,30,21
1657585466675,MATH 18,B01,083748,Rideout; David Porter,5,0,37,32
1657585466675,MATH 18,B02,083749,Rideout; David Porter,5,0,36,31
1657585466675,MATH 18,B03,083750,Rideout; David Porter,3,0,37,34
1657585466675,MATH 18,B04,083751,Rideout; David Porter,6,0,36,30
1657585466675,MATH 18,B05,093473,Rideout; David Porter,6,0,36,30
1657585466675,MATH 18,B06,093474,Rideout; David Porter,6,0,36,30
1657585472698,MATH 20A,A01,083754,Zheng; Zequn,14,0,40,26
1657585478726,MATH 20B,A01,083756,Briones; Jor-el Thomas Caparas,4,0,36,32
1657585478726,MATH 20B,A02,083757,Briones; Jor-el Thomas Caparas,1,0,36,35
1657585478726,MATH 20B,A03,093475,Briones; Jor-el Thomas Caparas,2,0,36,34
1657585484749,MATH 20C,A01,083760,Briones; Jor-el Thomas Caparas,1,0,35,34
1657585484749,MATH 20C,A02,083761,Briones; Jor-el Thomas Caparas,8,0,35,27
1657585484749,MATH 20C,A03,093476,Briones; Jor-el Thomas Caparas,0,1,36,36
1657585484749,MATH 20C,B01,083762,Bach; Quang Tran,1,0,30,29
1657585490777,MATH 20D,A01,083765,Tran; Brian Kha,5,0,30,25
1657585490777,MATH 20D,A02,083766,Tran; Brian Kha,5,0,30,25
1657585490777,MATH 20D,A03,083767,Tran; Brian Kha,5,0,30,25
1657585496810,MATH 20E,A01,083771,Ganguly; Soumya,9,0,32,23
1657585496810,MATH 20E,A02,083772,Ganguly; Soumya,6,0,32,26
1657585496810,MATH 20E,B01,083773,Ciotti; Benjamin,20,0,35,15
1657585496810,MATH 20E,B02,083774,Ciotti; Benjamin,18,0,35,17
1657585502854,MATH 103A,A01,083777,Greenfeld; Be'Eri,3,0,36,33
1657585502854,MATH 103A,A02,083778,Greenfeld; Be'Eri,5,0,36,31
1657585502854,MATH 103A,A03,093561,Greenfeld; Be'Eri,5,0,36,31
1657585502854,MATH 103A,B01,083779,Greenfeld; Be'Eri,7,0,36,29
1657585502854,MATH 103A,B02,083780,Greenfeld; Be'Eri,4,0,36,32
1657585502854,MATH 103A,B03,093562,Greenfeld; Be'Eri,3,0,36,33
1657585508876,MATH 105,A01,085443,Carter; Anne Toulson,15,0,35,20
1657585508876,MATH 105,A02,093477,Carter; Anne Toulson,20,0,35,15
1657585514903,MATH 109,A01,083213,Ganzberger; Geoffrey Michael,2,0,34,32
1657585514903,MATH 109,A02,083214,Ganzberger; Geoffrey Michael,4,0,34,30
1657585514903,MATH 109,A03,093478,Ganzberger; Geoffrey Michael,2,0,34,32
1657585514903,MATH 109,B01,083215,Ganzberger; Geoffrey Michael,1,0,32,31
1657585514903,MATH 109,B02,083216,Ganzberger; Geoffrey Michael,2,0,32,30
1657585514903,MATH 109,B03,093479,Ganzberger; Geoffrey Michael,8,0,32,24
1657585520935,MATH 142A,A01,083219,Chow; Bennett,7,0,32,25
1657585520935,MATH 142A,A02,083220,Chow; Bennett,10,0,32,22
1657585520935,MATH 142A,A03,093480,Chow; Bennett,8,0,32,24
1657585520935,MATH 142A,B03,093481,Chow; Bennett,8,0,32,24
1657585520935,MATH 142A,B04,093558,Chow; Bennett,13,0,32,19
1657585520935,MATH 142A,B05,093559,Chow; Bennett,6,0,32,26
1657585526958,MATH 193A,A01,083224,Rotar; Vladimir,8,0,34,26
1657585526958,MATH 193A,A02,083225,Rotar; Vladimir,9,0,34,25
1657585526958,MATH 193A,A03,083781,Rotar; Vladimir,5,0,34,29
1657585526958,MATH 193A,A04,083782,Rotar; Vladimir,10,0,34,24
1657585526958,MATH 193A,A05,093482,Rotar; Vladimir,10,0,34,24
1657585532979,MATH 197,001,091859,McAuley; Julian John,9999,0,9999,0
1657585532979,MATH 197,002,095566,Kedlaya; Kiran S.,9997,0,9999,2
1657585532979,MATH 197,003,095567,Xiao; Ming,9999,0,9999,0
1657585532979,MATH 197,004,095571,Perols; Johan Lars,9998,0,9999,1
1657585540144,COGS 9,A01,083615,Shannon; Kyle Michael,9,0,75,66
1657585546171,COGS 11,A01,083617,Boyle; Mary E. T.,23,0,48,25
1657585552195,COGS 13,A01,083071,Bastos; Amalia Pinkusfeld,11,0,71,60
1657585558218,COGS 14A,A01,092681,Semenuks; Arturs,5,1,100,95
1657585564239,COGS 14B,A01,083073,Cheng; Tzu-Han,6,0,63,57
1657585570261,COGS 17,A01,092677,Semenuks; Arturs,6,0,81,75
1657585576292,COGS 100,A01,083619,Allen; Michael Gordon,17,0,70,53
1657585582315,COGS 101A,A01,083621,Davis; Joshua Daniel,9,0,68,59
1657585588336,COGS 101B,A01,091572,Allen; Michael Gordon,12,0,65,53
1657585594362,COGS 101C,A01,083625,Delgado; Tania,17,0,35,18
1657585600387,COGS 107A,A01,083627,Boyle; Mary E. T.,13,0,60,47
1657585606413,COGS 118A,A01,083075,Gupta; Anjum,21,0,76,55
1657585612436,CSE 3,A50,083646,Miranda; Gregory Joseph,24,0,50,26
1657585618460,CSE 8A,A50,083650,Miranda; Gregory Joseph,17,1,56,39
1657585624485,CSE 11,A01,083080,Cao; Yingjun,6,15,40,34
1657585630511,CSE 12,A01,083652,Krause-Levy; Sophia Louisa,28,1,120,92
1657585636534,CSE 15L,A01,083654,Morris; Justin Loren,9,0,50,41
1657585636534,CSE 15L,A02,083655,Morris; Justin Loren,9,0,50,41
1657585642556,CSE 20,A01,083657,Tran; Khoa Dang,39,0,80,41
1657585648591,CSE 21,A01,095574,Bach; Quang Tran,22,0,48,26
1657585654616,CSE 30,A01,083084,Eldon; John,5,0,80,75
1657585654616,CSE 30,B01,095061,Bhaskar; Nishant,9,0,50,41
1657585660639,CSE 100,A01,083659,Cao; Yingjun,5,4,70,65
1657585666667,CSE 134B,A01,083661,Powell; Thomas Allan,22,0,100,78
1657585672694,CSE 140,A01,083663,Gungor; Onat,15,0,85,70
1657585678721,CSE 140L,A01,083088,Eldon; John,21,0,100,79
1657585684745,CSE 175,A01,083665,Kumar; Rakesh,3,0,25,22
1657585690766,CSE 190,A00,092507,Dubnov; Shlomo,8,0,20,12
1657585696791,ECE 45,A01,083139,Congero; Spencer William,6,0,75,69
1657585702814,ECE 65,A50,083695,Saad; Andrew S,12,0,30,18
1657585702814,ECE 65,A51,095125,Saad; Andrew S,24,0,26,2
1657585708837,ECE 109,A01,091882,Touri; Behrouz,19,0,70,51
1657585714859,ECE 180,A00,083140,Abi Samra; Nicholas Camill,1,0,30,29
1657585714859,ECE 180,B00,083141,Abi Samra; Nicholas Camill,0,0,30,30
1657585720887,MATH 10A,A01,083735,Patchell; Gregory David,2,0,30,28
1657585720887,MATH 10A,A02,083736,Patchell; Gregory David,20,0,30,10
1657585720887,MATH 10A,A03,083737,Patchell; Gregory David,16,0,30,14
1657585726920,MATH 10B,A01,083207,Lim; Seonhee,8,0,34,26
1657585726920,MATH 10B,A02,083208,Lim; Seonhee,9,0,35,26
1657585726920,MATH 10B,A03,093472,Lim; Seonhee,7,0,34,27
1657585726920,MATH 10B,B01,083739,Sinha; Shubham,12,0,30,18
1657585732944,MATH 18,A01,083743,Cinel; Cameron Alexander,7,0,30,23
1657585732944,MATH 18,A02,083744,Cinel; Cameron Alexander,17,0,30,13
1657585732944,MATH 18,A03,083745,Cinel; Cameron Alexander,9,0,30,21
1657585732944,MATH 18,B01,083748,Rideout; David Porter,5,0,37,32
1657585732944,MATH 18,B02,083749,Rideout; David Porter,5,0,36,31
1657585732944,MATH 18,B03,083750,Rideout; David Porter,3,0,37,34
1657585732944,MATH 18,B04,083751,Rideout; David Porter,6,0,36,30
1657585732944,MATH 18,B05,093473,Rideout; David Porter,6,0,36,30
1657585732944,MATH 18,B06,093474,Rideout; David Porter,6,0,36,30
1657585738969,MATH 20A,A01,083754,Zheng; Zequn,14,0,40,26
1657585744992,MATH 20B,A01,083756,Briones; Jor-el Thomas Caparas,4,0,36,32
1657585744992,MATH 20B,A02,083757,Briones; Jor-el Thomas Caparas,1,0,36,35
1657585744992,MATH 20B,A03,093475,Briones; Jor-el Thomas Caparas,2,0,36,34
1657585751017,MATH 20C,A01,083760,Briones; Jor-el Thomas Caparas,1,0,35,34
1657585751017,MATH 20C,A02,083761,Briones; Jor-el Thomas Caparas,8,0,35,27
1657585751017,MATH 20C,A03,093476,Briones; Jor-el Thomas Caparas,0,1,36,36
1657585751017,MATH 20C,B01,083762,Bach; Quang Tran,1,0,30,29
1657585757041,MATH 20D,A01,083765,Tran; Brian Kha,5,0,30,25
1657585757041,MATH 20D,A02,083766,Tran; Brian Kha,5,0,30,25
1657585757041,MATH 20D,A03,083767,Tran; Brian Kha,5,0,30,25
1657585763064,MATH 20E,A01,083771,Ganguly; Soumya,9,0,32,23
1657585763064,MATH 20E,A02,083772,Ganguly; Soumya,6,0,32,26
1657585763064,MATH 20E,B01,083773,Ciotti; Benjamin,20,0,35,15
1657585763064,MATH 20E,B02,083774,Ciotti; Benjamin,18,0,35,17
1657585769089,MATH 103A,A01,083777,Greenfeld; Be'Eri,3,0,36,33
1657585769089,MATH 103A,A02,083778,Greenfeld; Be'Eri,5,0,36,31
1657585769089,MATH 103A,A03,093561,Greenfeld; Be'Eri,5,0,36,31
1657585769089,MATH 103A,B01,083779,Greenfeld; Be'Eri,7,0,36,29
1657585769089,MATH 103A,B02,083780,Greenfeld; Be'Eri,4,0,36,32
1657585769089,MATH 103A,B03,093562,Greenfeld; Be'Eri,3,0,36,33
1657585775112,MATH 105,A01,085443,Carter; Anne Toulson,15,0,35,20
1657585775112,MATH 105,A02,093477,Carter; Anne Toulson,20,0,35,15
1657585781144,MATH 109,A01,083213,Ganzberger; Geoffrey Michael,2,0,34,32
1657585781144,MATH 109,A02,083214,Ganzberger; Geoffrey Michael,4,0,34,30
1657585781144,MATH 109,A03,093478,Ganzberger; Geoffrey Michael,2,0,34,32
1657585781144,MATH 109,B01,083215,Ganzberger; Geoffrey Michael,1,0,32,31
1657585781144,MATH 109,B02,083216,Ganzberger; Geoffrey Michael,2,0,32,30
1657585781144,MATH 109,B03,093479,Ganzberger; Geoffrey Michael,8,0,32,24
1657585793174,MATH 142A,A01,083219,Chow; Bennett,7,0,32,25
1657585793174,MATH 142A,A02,083220,Chow; Bennett,10,0,32,22
1657585793174,MATH 142A,A03,093480,Chow; Bennett,8,0,32,24
1657585793174,MATH 142A,B03,093481,Chow; Bennett,8,0,32,24
1657585793174,MATH 142A,B04,093558,Chow; Bennett,13,0,32,19
1657585793174,MATH 142A,B05,093559,Chow; Bennett,6,0,32,26
1657585799202,MATH 193A,A01,083224,Rotar; Vladimir,8,0,34,26
1657585799202,MATH 193A,A02,083225,Rotar; Vladimir,9,0,34,25
1657585799202,MATH 193A,A03,083781,Rotar; Vladimir,5,0,34,29
1657585799202,MATH 193A,A04,083782,Rotar; Vladimir,10,0,34,24
1657585799202,MATH 193A,A05,093482,Rotar; Vladimir,10,0,34,24
1657585805224,MATH 197,001,091859,McAuley; Julian John,9999,0,9999,0
1657585805224,MATH 197,002,095566,Kedlaya; Kiran S.,9997,0,9999,2
1657585805224,MATH 197,003,095567,Xiao; Ming,9999,0,9999,0
1657585805224,MATH 197,004,095571,Perols; Johan Lars,9998,0,9999,1
1657585812272,COGS 9,A01,083615,Shannon; Kyle Michael,9,0,75,66
1657585818298,COGS 11,A01,083617,Boyle; Mary E. T.,23,0,48,25
1657585824322,COGS 13,A01,083071,Bastos; Amalia Pinkusfeld,11,0,71,60
1657585830345,COGS 14A,A01,092681,Semenuks; Arturs,5,1,100,95
1657585836370,COGS 14B,A01,083073,Cheng; Tzu-Han,6,0,63,57
1657585842394,COGS 17,A01,092677,Semenuks; Arturs,6,0,81,75
1657585848419,COGS 100,A01,083619,Allen; Michael Gordon,17,0,70,53
1657585854446,COGS 101A,A01,083621,Davis; Joshua Daniel,9,0,68,59
1657585860469,COGS 101B,A01,091572,Allen; Michael Gordon,12,0,65,53
1657585866493,COGS 101C,A01,083625,Delgado; Tania,17,0,35,18
1657585872521,COGS 107A,A01,083627,Boyle; Mary E. T.,13,0,60,47
1657585878546,COGS 118A,A01,083075,Gupta; Anjum,21,0,76,55
1657585884578,CSE 3,A50,083646,Miranda; Gregory Joseph,24,0,50,26
1657585890611,CSE 8A,A50,083650,Miranda; Gregory Joseph,17,1,56,39
1657585896640,CSE 11,A01,083080,Cao; Yingjun,6,15,40,34
1657585902673,CSE 12,A01,083652,Krause-Levy; Sophia Louisa,28,1,120,92
1657585908696,CSE 15L,A01,083654,Morris; Justin Loren,9,0,50,41
1657585908696,CSE 15L,A02,083655,Morris; Justin Loren,9,0,50,41
1657585914722,CSE 20,A01,083657,Tran; Khoa Dang,39,0,80,41
1657585920755,CSE 21,A01,095574,Bach; Quang Tran,22,0,48,26
1657585926777,CSE 30,A01,083084,Eldon; John,5,0,80,75
1657585926777,CSE 30,B01,095061,Bhaskar; Nishant,9,0,50,41
1657585932805,CSE 100,A01,083659,Cao; Yingjun,5,4,70,65
1657585938831,CSE 134B,A01,083661,Powell; Thomas Allan,22,0,100,78
1657585944858,CSE 140,A01,083663,Gungor; Onat,15,0,85,70
1657585950882,CSE 140L,A01,083088,Eldon; John,21,0,100,79
1657585956907,CSE 175,A01,083665,Kumar; Rakesh,3,0,25,22
1657585962929,CSE 190,A00,092507,Dubnov; Shlomo,8,0,20,12
1657585968952,ECE 45,A01,083139,Congero; Spencer William,6,0,75,69
1657585974977,ECE 65,A50,083695,Saad; Andrew S,12,0,30,18
1657585974977,ECE 65,A51,095125,Saad; Andrew S,24,0,26,2
1657585981004,ECE 109,A01,091882,Touri; Behrouz,19,0,70,51
1657585987029,ECE 180,A00,083140,Abi Samra; Nicholas Camill,1,0,30,29
1657585987029,ECE 180,B00,083141,Abi Samra; Nicholas Camill,0,0,30,30
1657585993053,MATH 10A,A01,083735,Patchell; Gregory David,2,0,30,28
1657585993053,MATH 10A,A02,083736,Patchell; Gregory David,20,0,30,10
1657585993053,MATH 10A,A03,083737,Patchell; Gregory David,16,0,30,14
1657585999082,MATH 10B,A01,083207,Lim; Seonhee,8,0,34,26
1657585999082,MATH 10B,A02,083208,Lim; Seonhee,9,0,35,26
1657585999082,MATH 10B,A03,093472,Lim; Seonhee,7,0,34,27
1657585999082,MATH 10B,B01,083739,Sinha; Shubham,12,0,30,18
1657586005113,MATH 18,A01,083743,Cinel; Cameron Alexander,7,0,30,23
1657586005113,MATH 18,A02,083744,Cinel; Cameron Alexander,17,0,30,13
1657586005113,MATH 18,A03,083745,Cinel; Cameron Alexander,9,0,30,21
1657586005113,MATH 18,B01,083748,Rideout; David Porter,5,0,37,32
1657586005113,MATH 18,B02,083749,Rideout; David Porter,5,0,36,31
1657586005113,MATH 18,B03,083750,Rideout; David Porter,3,0,37,34
1657586005113,MATH 18,B04,083751,Rideout; David Porter,6,0,36,30
1657586005113,MATH 18,B05,093473,Rideout; David Porter,6,0,36,30
1657586005113,MATH 18,B06,093474,Rideout; David Porter,6,0,36,30
1657586011135,MATH 20A,A01,083754,Zheng; Zequn,14,0,40,26
1657586017171,MATH 20B,A01,083756,Briones; Jor-el Thomas Caparas,4,0,36,32
1657586017171,MATH 20B,A02,083757,Briones; Jor-el Thomas Caparas,1,0,36,35
1657586017171,MATH 20B,A03,093475,Briones; Jor-el Thomas Caparas,2,0,36,34
1657586023198,MATH 20C,A01,083760,Briones; Jor-el Thomas Caparas,1,0,35,34
1657586023198,MATH 20C,A02,083761,Briones; Jor-el Thomas Caparas,8,0,35,27
1657586023198,MATH 20C,A03,093476,Briones; Jor-el Thomas Caparas,0,1,36,36
1657586023198,MATH 20C,B01,083762,Bach; Quang Tran,1,0,30,29
1657586029221,MATH 20D,A01,083765,Tran; Brian Kha,5,0,30,25
1657586029221,MATH 20D,A02,083766,Tran; Brian Kha,5,0,30,25
1657586029221,MATH 20D,A03,083767,Tran; Brian Kha,5,0,30,25
1657586035244,MATH 20E,A01,083771,Ganguly; Soumya,9,0,32,23
1657586035244,MATH 20E,A02,083772,Ganguly; Soumya,6,0,32,26
1657586035244,MATH 20E,B01,083773,Ciotti; Benjamin,20,0,35,15
1657586035244,MATH 20E,B02,083774,Ciotti; Benjamin,18,0,35,17
1657586041270,MATH 103A,A01,083777,Greenfeld; Be'Eri,3,0,36,33
1657586041270,MATH 103A,A02,083778,Greenfeld; Be'Eri,5,0,36,31
1657586041270,MATH 103A,A03,093561,Greenfeld; Be'Eri,5,0,36,31
1657586041270,MATH 103A,B01,083779,Greenfeld; Be'Eri,7,0,36,29
1657586041270,MATH 103A,B02,083780,Greenfeld; Be'Eri,4,0,36,32
1657586041270,MATH 103A,B03,093562,Greenfeld; Be'Eri,3,0,36,33
1657586047293,MATH 105,A01,085443,Carter; Anne Toulson,15,0,35,20
1657586047293,MATH 105,A02,093477,Carter; Anne Toulson,20,0,35,15
1657586053322,MATH 109,A01,083213,Ganzberger; Geoffrey Michael,2,0,34,32
1657586053322,MATH 109,A02,083214,Ganzberger; Geoffrey Michael,4,0,34,30
1657586053322,MATH 109,A03,093478,Ganzberger; Geoffrey Michael,2,0,34,32
1657586053322,MATH 109,B01,083215,Ganzberger; Geoffrey Michael,1,0,32,31
1657586053322,MATH 109,B02,083216,Ganzberger; Geoffrey Michael,2,0,32,30
1657586053322,MATH 109,B03,093479,Ganzberger; Geoffrey Michael,8,0,32,24
1657586059352,MATH 142A,A01,083219,Chow; Bennett,7,0,32,25
1657586059352,MATH 142A,A02,083220,Chow; Bennett,10,0,32,22
1657586059352,MATH 142A,A03,093480,Chow; Bennett,8,0,32,24
1657586059352,MATH 142A,B03,093481,Chow; Bennett,8,0,32,24
1657586059352,MATH 142A,B04,093558,Chow; Bennett,13,0,32,19
1657586059352,MATH 142A,B05,093559,Chow; Bennett,6,0,32,26
1657586065382,MATH 193A,A01,083224,Rotar; Vladimir,8,0,34,26
1657586065382,MATH 193A,A02,083225,Rotar; Vladimir,9,0,34,25
1657586065382,MATH 193A,A03,083781,Rotar; Vladimir,5,0,34,29
1657586065382,MATH 193A,A04,083782,Rotar; Vladimir,10,0,34,24
1657586065382,MATH 193A,A05,093482,Rotar; Vladimir,10,0,34,24
1657586071408,MATH 197,001,091859,McAuley; Julian John,9999,0,9999,0
1657586071408,MATH 197,002,095566,Kedlaya; Kiran S.,9997,0,9999,2
1657586071408,MATH 197,003,095567,Xiao; Ming,9999,0,9999,0
1657586071408,MATH 197,004,095571,Perols; Johan Lars,9998,0,9999,1
1657586078460,COGS 9,A01,083615,Shannon; Kyle Michael,9,0,75,66
1657586084484,COGS 11,A01,083617,Boyle; Mary E. T.,23,0,48,25
1657586090509,COGS 13,A01,083071,Bastos; Amalia Pinkusfeld,11,0,71,60
1657586096531,COGS 14A,A01,092681,Semenuks; Arturs,5,1,100,95
1657586102565,COGS 14B,A01,083073,Cheng; Tzu-Han,6,0,63,57
1657586108588,COGS 17,A01,092677,Semenuks; Arturs,6,0,81,75
1657586114614,COGS 100,A01,083619,Allen; Michael Gordon,17,0,70,53
1657586120636,COGS 101A,A01,083621,Davis; Joshua Daniel,9,0,68,59
1657586126659,COGS 101B,A01,091572,Allen; Michael Gordon,12,0,65,53
1657586132681,COGS 101C,A01,083625,Delgado; Tania,17,0,35,18
1657586138778,COGS 107A,A01,083627,Boyle; Mary E. T.,13,0,60,47
1657586144801,COGS 118A,A01,083075,Gupta; Anjum,21,0,76,55
1657586150824,CSE 3,A50,083646,Miranda; Gregory Joseph,24,0,50,26
1657586156852,CSE 8A,A50,083650,Miranda; Gregory Joseph,17,1,56,39
1657586162892,CSE 11,A01,083080,Cao; Yingjun,6,15,40,34
1657586168916,CSE 12,A01,083652,Krause-Levy; Sophia Louisa,28,1,120,92
1657586174939,CSE 15L,A01,083654,Morris; Justin Loren,9,0,50,41
1657586174939,CSE 15L,A02,083655,Morris; Justin Loren,9,0,50,41
1657586180962,CSE 20,A01,083657,Tran; Khoa Dang,39,0,80,41
1657586186996,CSE 21,A01,095574,Bach; Quang Tran,22,0,48,26
1657586193023,CSE 30,A01,083084,Eldon; John,5,0,80,75
1657586193023,CSE 30,B01,095061,Bhaskar; Nishant,9,0,50,41
1657586199050,CSE 100,A01,083659,Cao; Yingjun,5,4,70,65
1657586205078,CSE 134B,A01,083661,Powell; Thomas Allan,22,0,100,78
1657586211105,CSE 140,A01,083663,Gungor; Onat,15,0,85,70
1657586217129,CSE 140L,A01,083088,Eldon; John,21,0,100,79
1657586223152,CSE 175,A01,083665,Kumar; Rakesh,3,0,25,22
1657586229175,CSE 190,A00,092507,Dubnov; Shlomo,8,0,20,12
1657586235201,ECE 45,A01,083139,Congero; Spencer William,6,0,75,69
1657586241232,ECE 65,A50,083695,Saad; Andrew S,12,0,30,18
1657586241232,ECE 65,A51,095125,Saad; Andrew S,24,0,26,2
1657586247255,ECE 109,A01,091882,Touri; Behrouz,19,0,70,51
1657586253282,ECE 180,A00,083140,Abi Samra; Nicholas Camill,1,0,30,29
1657586253282,ECE 180,B00,083141,Abi Samra; Nicholas Camill,0,0,30,30
1657586259305,MATH 10A,A01,083735,Patchell; Gregory David,2,0,30,28
1657586259305,MATH 10A,A02,083736,Patchell; Gregory David,20,0,30,10
1657586259305,MATH 10A,A03,083737,Patchell; Gregory David,16,0,30,14
1657586265328,MATH 10B,A01,083207,Lim; Seonhee,8,0,34,26
1657586265328,MATH 10B,A02,083208,Lim; Seonhee,9,0,35,26
1657586265328,MATH 10B,A03,093472,Lim; Seonhee,7,0,34,27
1657586265328,MATH 10B,B01,083739,Sinha; Shubham,12,0,30,18
1657586271352,MATH 18,A01,083743,Cinel; Cameron Alexander,7,0,30,23
1657586271352,MATH 18,A02,083744,Cinel; Cameron Alexander,17,0,30,13
1657586271352,MATH 18,A03,083745,Cinel; Cameron Alexander,9,0,30,21
1657586271352,MATH 18,B01,083748,Rideout; David Porter,5,0,37,32
1657586271352,MATH 18,B02,083749,Rideout; David Porter,5,0,36,31
1657586271352,MATH 18,B03,083750,Rideout; David Porter,3,0,37,34
1657586271352,MATH 18,B04,083751,Rideout; David Porter,6,0,36,30
1657586271352,MATH 18,B05,093473,Rideout; David Porter,6,0,36,30
1657586271352,MATH 18,B06,093474,Rideout; David Porter,6,0,36,30
1657586277390,MATH 20A,A01,083754,Zheng; Zequn,14,0,40,26
1657586283414,MATH 20B,A01,083756,Briones; Jor-el Thomas Caparas,4,0,36,32
1657586283414,MATH 20B,A02,083757,Briones; Jor-el Thomas Caparas,1,0,36,35
1657586283414,MATH 20B,A03,093475,Briones; Jor-el Thomas Caparas,2,0,36,34
1657586289438,MATH 20C,A01,083760,Briones; Jor-el Thomas Caparas,1,0,35,34
1657586289438,MATH 20C,A02,083761,Briones; Jor-el Thomas Caparas,8,0,35,27
1657586289438,MATH 20C,A03,093476,Briones; Jor-el Thomas Caparas,0,1,36,36
1657586289438,MATH 20C,B01,083762,Bach; Quang Tran,1,0,30,29
1657586295466,MATH 20D,A01,083765,Tran; Brian Kha,5,0,30,25
1657586295466,MATH 20D,A02,083766,Tran; Brian Kha,5,0,30,25
1657586295466,MATH 20D,A03,083767,Tran; Brian Kha,5,0,30,25
1657586301490,MATH 20E,A01,083771,Ganguly; Soumya,9,0,32,23
1657586301490,MATH 20E,A02,083772,Ganguly; Soumya,6,0,32,26
1657586301490,MATH 20E,B01,083773,Ciotti; Benjamin,20,0,35,15
1657586301490,MATH 20E,B02,083774,Ciotti; Benjamin,18,0,35,17
1657586307518,MATH 103A,A01,083777,Greenfeld; Be'Eri,3,0,36,33
1657586307518,MATH 103A,A02,083778,Greenfeld; Be'Eri,5,0,36,31
1657586307518,MATH 103A,A03,093561,Greenfeld; Be'Eri,5,0,36,31
1657586307518,MATH 103A,B01,083779,Greenfeld; Be'Eri,7,0,36,29
1657586307518,MATH 103A,B02,083780,Greenfeld; Be'Eri,4,0,36,32
1657586307518,MATH 103A,B03,093562,Greenfeld; Be'Eri,3,0,36,33
1657586313545,MATH 105,A01,085443,Carter; Anne Toulson,15,0,35,20
1657586313545,MATH 105,A02,093477,Carter; Anne Toulson,20,0,35,15
1657586319568,MATH 109,A01,083213,Ganzberger; Geoffrey Michael,2,0,34,32
1657586319568,MATH 109,A02,083214,Ganzberger; Geoffrey Michael,4,0,34,30
1657586319568,MATH 109,A03,093478,Ganzberger; Geoffrey Michael,2,0,34,32
1657586319568,MATH 109,B01,083215,Ganzberger; Geoffrey Michael,1,0,32,31
1657586319568,MATH 109,B02,083216,Ganzberger; Geoffrey Michael,2,0,32,30
1657586319568,MATH 109,B03,093479,Ganzberger; Geoffrey Michael,8,0,32,24
1657586325597,MATH 142A,A01,083219,Chow; Bennett,7,0,32,25
1657586325597,MATH 142A,A02,083220,Chow; Bennett,10,0,32,22
1657586325597,MATH 142A,A03,093480,Chow; Bennett,8,0,32,24
1657586325597,MATH 142A,B03,093481,Chow; Bennett,8,0,32,24
1657586325597,MATH 142A,B04,093558,Chow; Bennett,13,0,32,19
1657586325597,MATH 142A,B05,093559,Chow; Bennett,6,0,32,26
1657586331620,MATH 193A,A01,083224,Rotar; Vladimir,8,0,34,26
1657586331620,MATH 193A,A02,083225,Rotar; Vladimir,9,0,34,25
1657586331620,MATH 193A,A03,083781,Rotar; Vladimir,5,0,34,29
1657586331620,MATH 193A,A04,083782,Rotar; Vladimir,10,0,34,24
1657586331620,MATH 193A,A05,093482,Rotar; Vladimir,10,0,34,24
1657586337645,MATH 197,001,091859,McAuley; Julian John,9999,0,9999,0
1657586337645,MATH 197,002,095566,Kedlaya; Kiran S.,9997,0,9999,2
1657586337645,MATH 197,003,095567,Xiao; Ming,9999,0,9999,0
1657586337645,MATH 197,004,095571,Perols; Johan Lars,9998,0,9999,1
1657586344758,COGS 9,A01,083615,Shannon; Kyle Michael,9,0,75,66
1657586350785,COGS 11,A01,083617,Boyle; Mary E. T.,23,0,48,25
1657586356820,COGS 13,A01,083071,Bastos; Amalia Pinkusfeld,11,0,71,60
1657586362842,COGS 14A,A01,092681,Semenuks; Arturs,5,1,100,95
1657586368870,COGS 14B,A01,083073,Cheng; Tzu-Han,6,0,63,57
1657586374895,COGS 17,A01,092677,Semenuks; Arturs,6,0,81,75
1657586380920,COGS 100,A01,083619,Allen; Michael Gordon,17,0,70,53
1657586386951,COGS 101A,A01,083621,Davis; Joshua Daniel,9,0,68,59
1657586392973,COGS 101B,A01,091572,Allen; Michael Gordon,12,0,65,53
1657586399010,COGS 101C,A01,083625,Delgado; Tania,17,0,35,18
1657586405037,COGS 107A,A01,083627,Boyle; Mary E. T.,13,0,60,47
1657586411058,COGS 118A,A01,083075,Gupta; Anjum,21,0,76,55
1657586417087,CSE 3,A50,083646,Miranda; Gregory Joseph,24,0,50,26
1657586423113,CSE 8A,A50,083650,Miranda; Gregory Joseph,17,1,56,39
1657586429136,CSE 11,A01,083080,Cao; Yingjun,6,15,40,34
1657586435159,CSE 12,A01,083652,Krause-Levy; Sophia Louisa,28,1,120,92
1657586441182,CSE 15L,A01,083654,Morris; Justin Loren,9,0,50,41
1657586441182,CSE 15L,A02,083655,Morris; Justin Loren,9,0,50,41
1657586447204,CSE 20,A01,083657,Tran; Khoa Dang,39,0,80,41
1657586453232,CSE 21,A01,095574,Bach; Quang Tran,22,0,48,26
1657586459258,CSE 30,A01,083084,Eldon; John,5,0,80,75
1657586459258,CSE 30,B01,095061,Bhaskar; Nishant,9,0,50,41
1657586465280,CSE 100,A01,083659,Cao; Yingjun,5,4,70,65
1657586471308,CSE 134B,A01,083661,Powell; Thomas Allan,22,0,100,78
1657586477334,CSE 140,A01,083663,Gungor; Onat,15,0,85,70
1657586483361,CSE 140L,A01,083088,Eldon; John,21,0,100,79
1657586489386,CSE 175,A01,083665,Kumar; Rakesh,3,0,25,22
1657586495409,CSE 190,A00,092507,Dubnov; Shlomo,8,0,20,12
1657586501437,ECE 45,A01,083139,Congero; Spencer William,6,0,75,69
1657586507458,ECE 65,A50,083695,Saad; Andrew S,12,0,30,18
1657586507458,ECE 65,A51,095125,Saad; Andrew S,24,0,26,2
1657586513481,ECE 109,A01,091882,Touri; Behrouz,19,0,70,51
1657586519508,ECE 180,A00,083140,Abi Samra; Nicholas Camill,1,0,30,29
1657586519508,ECE 180,B00,083141,Abi Samra; Nicholas Camill,0,0,30,30
1657586525532,MATH 10A,A01,083735,Patchell; Gregory David,2,0,30,28
1657586525532,MATH 10A,A02,083736,Patchell; Gregory David,20,0,30,10
1657586525532,MATH 10A,A03,083737,Patchell; Gregory David,16,0,30,14
1657586531567,MATH 10B,A01,083207,Lim; Seonhee,8,0,34,26
1657586531567,MATH 10B,A02,083208,Lim; Seonhee,9,0,35,26
1657586531567,MATH 10B,A03,093472,Lim; Seonhee,7,0,34,27
1657586531567,MATH 10B,B01,083739,Sinha; Shubham,12,0,30,18
1657586537605,MATH 18,A01,083743,Cinel; Cameron Alexander,7,0,30,23
1657586537605,MATH 18,A02,083744,Cinel; Cameron Alexander,17,0,30,13
1657586537605,MATH 18,A03,083745,Cinel; Cameron Alexander,9,0,30,21
1657586537605,MATH 18,B01,083748,Rideout; David Porter,5,0,37,32
1657586537605,MATH 18,B02,083749,Rideout; David Porter,5,0,36,31
1657586537605,MATH 18,B03,083750,Rideout; David Porter,3,0,37,34
1657586537605,MATH 18,B04,083751,Rideout; David Porter,6,0,36,30
1657586537605,MATH 18,B05,093473,Rideout; David Porter,6,0,36,30
1657586537605,MATH 18,B06,093474,Rideout; David Porter,6,0,36,30
1657586543629,MATH 20A,A01,083754,Zheng; Zequn,14,0,40,26
1657586549654,MATH 20B,A01,083756,Briones; Jor-el Thomas Caparas,4,0,36,32
1657586549654,MATH 20B,A02,083757,Briones; Jor-el Thomas Caparas,1,0,36,35
1657586549654,MATH 20B,A03,093475,Briones; Jor-el Thomas Caparas,2,0,36,34
1657586555681,MATH 20C,A01,083760,Briones; Jor-el Thomas Caparas,1,0,35,34
1657586555681,MATH 20C,A02,083761,Briones; Jor-el Thomas Caparas,8,0,35,27
1657586555681,MATH 20C,A03,093476,Briones; Jor-el Thomas Caparas,0,1,36,36
1657586555681,MATH 20C,B01,083762,Bach; Quang Tran,1,0,30,29
1657586561705,MATH 20D,A01,083765,Tran; Brian Kha,5,0,30,25
1657586561705,MATH 20D,A02,083766,Tran; Brian Kha,5,0,30,25
1657586561705,MATH 20D,A03,083767,Tran; Brian Kha,5,0,30,25
1657586567729,MATH 20E,A01,083771,Ganguly; Soumya,9,0,32,23
1657586567729,MATH 20E,A02,083772,Ganguly; Soumya,6,0,32,26
1657586567729,MATH 20E,B01,083773,Ciotti; Benjamin,20,0,35,15
1657586567729,MATH 20E,B02,083774,Ciotti; Benjamin,18,0,35,17
1657586573757,MATH 103A,A01,083777,Greenfeld; Be'Eri,3,0,36,33
1657586573757,MATH 103A,A02,083778,Greenfeld; Be'Eri,5,0,36,31
1657586573757,MATH 103A,A03,093561,Greenfeld; Be'Eri,5,0,36,31
1657586573757,MATH 103A,B01,083779,Greenfeld; Be'Eri,7,0,36,29
1657586573757,MATH 103A,B02,083780,Greenfeld; Be'Eri,4,0,36,32
1657586573757,MATH 103A,B03,093562,Greenfeld; Be'Eri,3,0,36,33
1657586579780,MATH 105,A01,085443,Carter; Anne Toulson,15,0,35,20
1657586579780,MATH 105,A02,093477,Carter; Anne Toulson,20,0,35,15
1657586585808,MATH 109,A01,083213,Ganzberger; Geoffrey Michael,2,0,34,32
1657586585808,MATH 109,A02,083214,Ganzberger; Geoffrey Michael,4,0,34,30
1657586585808,MATH 109,A03,093478,Ganzberger; Geoffrey Michael,2,0,34,32
1657586585808,MATH 109,B01,083215,Ganzberger; Geoffrey Michael,1,0,32,31
1657586585808,MATH 109,B02,083216,Ganzberger; Geoffrey Michael,2,0,32,30
1657586585808,MATH 109,B03,093479,Ganzberger; Geoffrey Michael,8,0,32,24
1657586591836,MATH 142A,A01,083219,Chow; Bennett,7,0,32,25
1657586591836,MATH 142A,A02,083220,Chow; Bennett,10,0,32,22
1657586591836,MATH 142A,A03,093480,Chow; Bennett,8,0,32,24
1657586591836,MATH 142A,B03,093481,Chow; Bennett,8,0,32,24
1657586591836,MATH 142A,B04,093558,Chow; Bennett,13,0,32,19
1657586591836,MATH 142A,B05,093559,Chow; Bennett,6,0,32,26
1657586597859,MATH 193A,A01,083224,Rotar; Vladimir,8,0,34,26
1657586597859,MATH 193A,A02,083225,Rotar; Vladimir,9,0,34,25
1657586597859,MATH 193A,A03,083781,Rotar; Vladimir,5,0,34,29
1657586597859,MATH 193A,A04,083782,Rotar; Vladimir,10,0,34,24
1657586597859,MATH 193A,A05,093482,Rotar; Vladimir,10,0,34,24
1657586603882,MATH 197,001,091859,McAuley; Julian John,9999,0,9999,0
1657586603882,MATH 197,002,095566,Kedlaya; Kiran S.,9997,0,9999,2
1657586603882,MATH 197,003,095567,Xiao; Ming,9999,0,9999,0
1657586603882,MATH 197,004,095571,Perols; Johan Lars,9998,0,9999,1
1657586610940,COGS 9,A01,083615,Shannon; Kyle Michael,9,0,75,66
1657586616964,COGS 11,A01,083617,Boyle; Mary E. T.,23,0,48,25
1657586622990,COGS 13,A01,083071,Bastos; Amalia Pinkusfeld,11,0,71,60
1657586629014,COGS 14A,A01,092681,Semenuks; Arturs,5,1,100,95
1657586635036,COGS 14B,A01,083073,Cheng; Tzu-Han,6,0,63,57
1657586641062,COGS 17,A01,092677,Semenuks; Arturs,6,0,81,75
1657586647089,COGS 100,A01,083619,Allen; Michael Gordon,17,0,70,53
1657586653124,COGS 101A,A01,083621,Davis; Joshua Daniel,9,0,68,59
1657586659149,COGS 101B,A01,091572,Allen; Michael Gordon,12,0,65,53
1657586665171,COGS 101C,A01,083625,Delgado; Tania,17,0,35,18
1657586671209,COGS 107A,A01,083627,Boyle; Mary E. T.,13,0,60,47
1657586677238,COGS 118A,A01,083075,Gupta; Anjum,21,0,76,55
1657586683262,CSE 3,A50,083646,Miranda; Gregory Joseph,24,0,50,26
1657586689290,CSE 8A,A50,083650,Miranda; Gregory Joseph,17,1,56,39
1657586695313,CSE 11,A01,083080,Cao; Yingjun,6,15,40,34
1657586701337,CSE 12,A01,083652,Krause-Levy; Sophia Louisa,28,1,120,92
1657586707364,CSE 15L,A01,083654,Morris; Justin Loren,9,0,50,41
1657586707364,CSE 15L,A02,083655,Morris; Justin Loren,9,0,50,41
1657586713386,CSE 20,A01,083657,Tran; Khoa Dang,39,0,80,41
1657586719410,CSE 21,A01,095574,Bach; Quang Tran,22,0,48,26
1657586725432,CSE 30,A01,083084,Eldon; John,5,0,80,75
1657586725432,CSE 30,B01,095061,Bhaskar; Nishant,9,0,50,41
1657586731454,CSE 100,A01,083659,Cao; Yingjun,5,4,70,65
1657586737576,CSE 134B,A01,083661,Powell; Thomas Allan,22,0,100,78
1657586743604,CSE 140,A01,083663,Gungor; Onat,15,0,85,70
1657586749631,CSE 140L,A01,083088,Eldon; John,21,0,100,79
1657586755658,CSE 175,A01,083665,Kumar; Rakesh,3,0,25,22
1657586761680,CSE 190,A00,092507,Dubnov; Shlomo,8,0,20,12
1657586767702,ECE 45,A01,083139,Congero; Spencer William,6,0,75,69
1657586773725,ECE 65,A50,083695,Saad; Andrew S,12,0,30,18
1657586773725,ECE 65,A51,095125,Saad; Andrew S,24,0,26,2
1657586779746,ECE 109,A01,091882,Touri; Behrouz,19,0,70,51
1657586785769,ECE 180,A00,083140,Abi Samra; Nicholas Camill,1,0,30,29
1657586785769,ECE 180,B00,083141,Abi Samra; Nicholas Camill,0,0,30,30
1657586791796,MATH 10A,A01,083735,Patchell; Gregory David,2,0,30,28
1657586791796,MATH 10A,A02,083736,Patchell; Gregory David,20,0,30,10
1657586791796,MATH 10A,A03,083737,Patchell; Gregory David,16,0,30,14
1657586797817,MATH 10B,A01,083207,Lim; Seonhee,8,0,34,26
1657586797817,MATH 10B,A02,083208,Lim; Seonhee,9,0,35,26
1657586797817,MATH 10B,A03,093472,Lim; Seonhee,7,0,34,27
1657586797817,MATH 10B,B01,083739,Sinha; Shubham,12,0,30,18
1657586803841,MATH 18,A01,083743,Cinel; Cameron Alexander,7,0,30,23
1657586803841,MATH 18,A02,083744,Cinel; Cameron Alexander,17,0,30,13
1657586803841,MATH 18,A03,083745,Cinel; Cameron Alexander,9,0,30,21
1657586803841,MATH 18,B01,083748,Rideout; David Porter,5,0,37,32
1657586803841,MATH 18,B02,083749,Rideout; David Porter,5,0,36,31
1657586803841,MATH 18,B03,083750,Rideout; David Porter,3,0,37,34
1657586803841,MATH 18,B04,083751,Rideout; David Porter,6,0,36,30
1657586803841,MATH 18,B05,093473,Rideout; David Porter,6,0,36,30
1657586803841,MATH 18,B06,093474,Rideout; David Porter,6,0,36,30
1657586809867,MATH 20A,A01,083754,Zheng; Zequn,14,0,40,26
1657586815890,MATH 20B,A01,083756,Briones; Jor-el Thomas Caparas,4,0,36,32
1657586815890,MATH 20B,A02,083757,Briones; Jor-el Thomas Caparas,1,0,36,35
1657586815890,MATH 20B,A03,093475,Briones; Jor-el Thomas Caparas,2,0,36,34
1657586821915,MATH 20C,A01,083760,Briones; Jor-el Thomas Caparas,1,0,35,34
1657586821915,MATH 20C,A02,083761,Briones; Jor-el Thomas Caparas,8,0,35,27
1657586821915,MATH 20C,A03,093476,Briones; Jor-el Thomas Caparas,0,1,36,36
1657586821915,MATH 20C,B01,083762,Bach; Quang Tran,1,0,30,29
1657586827938,MATH 20D,A01,083765,Tran; Brian Kha,5,0,30,25
1657586827938,MATH 20D,A02,083766,Tran; Brian Kha,5,0,30,25
1657586827938,MATH 20D,A03,083767,Tran; Brian Kha,5,0,30,25
1657586833969,MATH 20E,A01,083771,Ganguly; Soumya,9,0,32,23
1657586833969,MATH 20E,A02,083772,Ganguly; Soumya,6,0,32,26
1657586833969,MATH 20E,B01,083773,Ciotti; Benjamin,20,0,35,15
1657586833969,MATH 20E,B02,083774,Ciotti; Benjamin,18,0,35,17
1657586839993,MATH 103A,A01,083777,Greenfeld; Be'Eri,3,0,36,33
1657586839993,MATH 103A,A02,083778,Greenfeld; Be'Eri,5,0,36,31
1657586839993,MATH 103A,A03,093561,Greenfeld; Be'Eri,5,0,36,31
1657586839993,MATH 103A,B01,083779,Greenfeld; Be'Eri,7,0,36,29
1657586839993,MATH 103A,B02,083780,Greenfeld; Be'Eri,4,0,36,32
1657586839993,MATH 103A,B03,093562,Greenfeld; Be'Eri,3,0,36,33
1657586846016,MATH 105,A01,085443,Carter; Anne Toulson,15,0,35,20
1657586846016,MATH 105,A02,093477,Carter; Anne Toulson,20,0,35,15
1657586852049,MATH 109,A01,083213,Ganzberger; Geoffrey Michael,2,0,34,32
1657586852049,MATH 109,A02,083214,Ganzberger; Geoffrey Michael,4,0,34,30
1657586852049,MATH 109,A03,093478,Ganzberger; Geoffrey Michael,2,0,34,32
1657586852049,MATH 109,B01,083215,Ganzberger; Geoffrey Michael,1,0,32,31
1657586852049,MATH 109,B02,083216,Ganzberger; Geoffrey Michael,2,0,32,30
1657586852049,MATH 109,B03,093479,Ganzberger; Geoffrey Michael,8,0,32,24
1657586858079,MATH 142A,A01,083219,Chow; Bennett,7,0,32,25
1657586858079,MATH 142A,A02,083220,Chow; Bennett,10,0,32,22
1657586858079,MATH 142A,A03,093480,Chow; Bennett,8,0,32,24
1657586858079,MATH 142A,B03,093481,Chow; Bennett,8,0,32,24
1657586858079,MATH 142A,B04,093558,Chow; Bennett,13,0,32,19
1657586858079,MATH 142A,B05,093559,Chow; Bennett,6,0,32,26
1657586864106,MATH 193A,A01,083224,Rotar; Vladimir,8,0,34,26
1657586864106,MATH 193A,A02,083225,Rotar; Vladimir,9,0,34,25
1657586864106,MATH 193A,A03,083781,Rotar; Vladimir,5,0,34,29
1657586864106,MATH 193A,A04,083782,Rotar; Vladimir,10,0,34,24
1657586864106,MATH 193A,A05,093482,Rotar; Vladimir,10,0,34,24
1657586870135,MATH 197,001,091859,McAuley; Julian John,9999,0,9999,0
1657586870135,MATH 197,002,095566,Kedlaya; Kiran S.,9997,0,9999,2
1657586870135,MATH 197,003,095567,Xiao; Ming,9999,0,9999,0
1657586870135,MATH 197,004,095571,Perols; Johan Lars,9998,0,9999,1
1657586877187,COGS 9,A01,083615,Shannon; Kyle Michael,9,0,75,66
1657586883218,COGS 11,A01,083617,Boyle; Mary E. T.,23,0,48,25
1657586889249,COGS 13,A01,083071,Bastos; Amalia Pinkusfeld,11,0,71,60
1657586895282,COGS 14A,A01,092681,Semenuks; Arturs,5,1,100,95
1657586901310,COGS 14B,A01,083073,Cheng; Tzu-Han,6,0,63,57
1657586907331,COGS 17,A01,092677,Semenuks; Arturs,6,0,81,75
1657586913361,COGS 100,A01,083619,Allen; Michael Gordon,17,0,70,53
1657586919388,COGS 101A,A01,083621,Davis; Joshua Daniel,9,0,68,59
1657586925412,COGS 101B,A01,091572,Allen; Michael Gordon,12,0,65,53
1657586931436,COGS 101C,A01,083625,Delgado; Tania,17,0,35,18
1657586937458,COGS 107A,A01,083627,Boyle; Mary E. T.,13,0,60,47
1657586943484,COGS 118A,A01,083075,Gupta; Anjum,21,0,76,55
1657586949512,CSE 3,A50,083646,Miranda; Gregory Joseph,24,0,50,26
1657586955534,CSE 8A,A50,083650,Miranda; Gregory Joseph,17,1,56,39
1657586961560,CSE 11,A01,083080,Cao; Yingjun,6,15,40,34
1657586967586,CSE 12,A01,083652,Krause-Levy; Sophia Louisa,28,1,120,92
1657586973612,CSE 15L,A01,083654,Morris; Justin Loren,9,0,50,41
1657586973612,CSE 15L,A02,083655,Morris; Justin Loren,9,0,50,41
1657586979635,CSE 20,A01,083657,Tran; Khoa Dang,39,0,80,41
1657586985666,CSE 21,A01,095574,Bach; Quang Tran,22,0,48,26
1657586991693,CSE 30,A01,083084,Eldon; John,5,0,80,75
1657586991693,CSE 30,B01,095061,Bhaskar; Nishant,9,0,50,41
1657586997718,CSE 100,A01,083659,Cao; Yingjun,5,4,70,65
1657587003747,CSE 134B,A01,083661,Powell; Thomas Allan,22,0,100,78
1657587009774,CSE 140,A01,083663,Gungor; Onat,15,0,85,70
1657587015797,CSE 140L,A01,083088,Eldon; John,21,0,100,79
1657587021820,CSE 175,A01,083665,Kumar; Rakesh,3,0,25,22
1657587027845,CSE 190,A00,092507,Dubnov; Shlomo,8,0,20,12
1657587033873,ECE 45,A01,083139,Congero; Spencer William,6,0,75,69
1657587039896,ECE 65,A50,083695,Saad; Andrew S,12,0,30,18
1657587039896,ECE 65,A51,095125,Saad; Andrew S,24,0,26,2
1657587045921,ECE 109,A01,091882,Touri; Behrouz,19,0,70,51
1657587051943,ECE 180,A00,083140,Abi Samra; Nicholas Camill,1,0,30,29
1657587051943,ECE 180,B00,083141,Abi Samra; Nicholas Camill,0,0,30,30
1657587057971,MATH 10A,A01,083735,Patchell; Gregory David,2,0,30,28
1657587057971,MATH 10A,A02,083736,Patchell; Gregory David,20,0,30,10
1657587057971,MATH 10A,A03,083737,Patchell; Gregory David,16,0,30,14
1657587063995,MATH 10B,A01,083207,Lim; Seonhee,8,0,34,26
1657587063995,MATH 10B,A02,083208,Lim; Seonhee,9,0,35,26
1657587063995,MATH 10B,A03,093472,Lim; Seonhee,7,0,34,27
1657587063995,MATH 10B,B01,083739,Sinha; Shubham,12,0,30,18
1657587070020,MATH 18,A01,083743,Cinel; Cameron Alexander,7,0,30,23
1657587070020,MATH 18,A02,083744,Cinel; Cameron Alexander,17,0,30,13
1657587070020,MATH 18,A03,083745,Cinel; Cameron Alexander,9,0,30,21
1657587070020,MATH 18,B01,083748,Rideout; David Porter,5,0,37,32
1657587070020,MATH 18,B02,083749,Rideout; David Porter,5,0,36,31
1657587070020,MATH 18,B03,083750,Rideout; David Porter,3,0,37,34
1657587070020,MATH 18,B04,083751,Rideout; David Porter,6,0,36,30
1657587070020,MATH 18,B05,093473,Rideout; David Porter,6,0,36,30
1657587070020,MATH 18,B06,093474,Rideout; David Porter,6,0,36,30
1657587076042,MATH 20A,A01,083754,Zheng; Zequn,14,0,40,26
1657587082066,MATH 20B,A01,083756,Briones; Jor-el Thomas Caparas,4,0,36,32
1657587082066,MATH 20B,A02,083757,Briones; Jor-el Thomas Caparas,1,0,36,35
1657587082066,MATH 20B,A03,093475,Briones; Jor-el Thomas Caparas,2,0,36,34
1657587088098,MATH 20C,A01,083760,Briones; Jor-el Thomas Caparas,1,0,35,34
1657587088098,MATH 20C,A02,083761,Briones; Jor-el Thomas Caparas,8,0,35,27
1657587088098,MATH 20C,A03,093476,Briones; Jor-el Thomas Caparas,0,1,36,36
1657587088098,MATH 20C,B01,083762,Bach; Quang Tran,1,0,30,29
1657587094122,MATH 20D,A01,083765,Tran; Brian Kha,5,0,30,25
1657587094122,MATH 20D,A02,083766,Tran; Brian Kha,5,0,30,25
1657587094122,MATH 20D,A03,083767,Tran; Brian Kha,5,0,30,25
1657587100148,MATH 20E,A01,083771,Ganguly; Soumya,9,0,32,23
1657587100148,MATH 20E,A02,083772,Ganguly; Soumya,6,0,32,26
1657587100148,MATH 20E,B01,083773,Ciotti; Benjamin,20,0,35,15
1657587100148,MATH 20E,B02,083774,Ciotti; Benjamin,18,0,35,17
1657587106177,MATH 103A,A01,083777,Greenfeld; Be'Eri,3,0,36,33
1657587106177,MATH 103A,A02,083778,Greenfeld; Be'Eri,5,0,36,31
1657587106177,MATH 103A,A03,093561,Greenfeld; Be'Eri,5,0,36,31
1657587106177,MATH 103A,B01,083779,Greenfeld; Be'Eri,7,0,36,29
1657587106177,MATH 103A,B02,083780,Greenfeld; Be'Eri,4,0,36,32
1657587106177,MATH 103A,B03,093562,Greenfeld; Be'Eri,3,0,36,33
1657587112198,MATH 105,A01,085443,Carter; Anne Toulson,15,0,35,20
1657587112198,MATH 105,A02,093477,Carter; Anne Toulson,20,0,35,15
1657587118230,MATH 109,A01,083213,Ganzberger; Geoffrey Michael,2,0,34,32
1657587118230,MATH 109,A02,083214,Ganzberger; Geoffrey Michael,4,0,34,30
1657587118230,MATH 109,A03,093478,Ganzberger; Geoffrey Michael,2,0,34,32
1657587118230,MATH 109,B01,083215,Ganzberger; Geoffrey Michael,1,0,32,31
1657587118230,MATH 109,B02,083216,Ganzberger; Geoffrey Michael,2,0,32,30
1657587118230,MATH 109,B03,093479,Ganzberger; Geoffrey Michael,8,0,32,24
1657587124260,MATH 142A,A01,083219,Chow; Bennett,7,0,32,25
1657587124260,MATH 142A,A02,083220,Chow; Bennett,10,0,32,22
1657587124260,MATH 142A,A03,093480,Chow; Bennett,8,0,32,24
1657587124260,MATH 142A,B03,093481,Chow; Bennett,8,0,32,24
1657587124260,MATH 142A,B04,093558,Chow; Bennett,13,0,32,19
1657587124260,MATH 142A,B05,093559,Chow; Bennett,6,0,32,26
1657587130287,MATH 193A,A01,083224,Rotar; Vladimir,8,0,34,26
1657587130287,MATH 193A,A02,083225,Rotar; Vladimir,9,0,34,25
1657587130287,MATH 193A,A03,083781,Rotar; Vladimir,5,0,34,29
1657587130287,MATH 193A,A04,083782,Rotar; Vladimir,10,0,34,24
1657587130287,MATH 193A,A05,093482,Rotar; Vladimir,10,0,34,24
1657587136313,MATH 197,001,091859,McAuley; Julian John,9999,0,9999,0
1657587136313,MATH 197,002,095566,Kedlaya; Kiran S.,9997,0,9999,2
1657587136313,MATH 197,003,095567,Xiao; Ming,9999,0,9999,0
1657587136313,MATH 197,004,095571,Perols; Johan Lars,9998,0,9999,1
1657587143363,COGS 9,A01,083615,Shannon; Kyle Michael,9,0,75,66
1657587149389,COGS 11,A01,083617,Boyle; Mary E. T.,23,0,48,25
1657587155411,COGS 13,A01,083071,Bastos; Amalia Pinkusfeld,11,0,71,60
1657587161432,COGS 14A,A01,092681,Semenuks; Arturs,5,1,100,95
1657587167455,COGS 14B,A01,083073,Cheng; Tzu-Han,6,0,63,57
1657587173484,COGS 17,A01,092677,Semenuks; Arturs,6,0,81,75
1657587179506,COGS 100,A01,083619,Allen; Michael Gordon,17,0,70,53
1657587185530,COGS 101A,A01,083621,Davis; Joshua Daniel,9,0,68,59
1657587191556,COGS 101B,A01,091572,Allen; Michael Gordon,12,0,65,53
1657587197586,COGS 101C,A01,083625,Delgado; Tania,17,0,35,18
1657587203613,COGS 107A,A01,083627,Boyle; Mary E. T.,13,0,60,47
1657587209636,COGS 118A,A01,083075,Gupta; Anjum,21,0,76,55
1657587215665,CSE 3,A50,083646,Miranda; Gregory Joseph,24,0,50,26
1657587221693,CSE 8A,A50,083650,Miranda; Gregory Joseph,17,1,56,39
1657587227719,CSE 11,A01,083080,Cao; Yingjun,6,15,40,34
1657587233741,CSE 12,A01,083652,Krause-Levy; Sophia Louisa,28,1,120,92
1657587239766,CSE 15L,A01,083654,Morris; Justin Loren,9,0,50,41
1657587239766,CSE 15L,A02,083655,Morris; Justin Loren,9,0,50,41
1657587245798,CSE 20,A01,083657,Tran; Khoa Dang,39,0,80,41
1657587251820,CSE 21,A01,095574,Bach; Quang Tran,22,0,48,26
1657587257848,CSE 30,A01,083084,Eldon; John,5,0,80,75
1657587257848,CSE 30,B01,095061,Bhaskar; Nishant,9,0,50,41
1657587263874,CSE 100,A01,083659,Cao; Yingjun,5,4,70,65
1657587269898,CSE 134B,A01,083661,Powell; Thomas Allan,22,0,100,78
1657587275922,CSE 140,A01,083663,Gungor; Onat,15,0,85,70
1657587281950,CSE 140L,A01,083088,Eldon; John,21,0,100,79
1657587287973,CSE 175,A01,083665,Kumar; Rakesh,3,0,25,22
1657587293996,CSE 190,A00,092507,Dubnov; Shlomo,8,0,20,12
1657587300024,ECE 45,A01,083139,Congero; Spencer William,6,0,75,69
1657587306047,ECE 65,A50,083695,Saad; Andrew S,12,0,30,18
1657587306047,ECE 65,A51,095125,Saad; Andrew S,24,0,26,2
1657587312072,ECE 109,A01,091882,Touri; Behrouz,19,0,70,51
1657587318096,ECE 180,A00,083140,Abi Samra; Nicholas Camill,1,0,30,29
1657587318096,ECE 180,B00,083141,Abi Samra; Nicholas Camill,0,0,30,30
1657587324119,MATH 10A,A01,083735,Patchell; Gregory David,2,0,30,28
1657587324119,MATH 10A,A02,083736,Patchell; Gregory David,20,0,30,10
1657587324119,MATH 10A,A03,083737,Patchell; Gregory David,16,0,30,14
1657587330146,MATH 10B,A01,083207,Lim; Seonhee,8,0,34,26
1657587330146,MATH 10B,A02,083208,Lim; Seonhee,9,0,35,26
1657587330146,MATH 10B,A03,093472,Lim; Seonhee,7,0,34,27
1657587330146,MATH 10B,B01,083739,Sinha; Shubham,12,0,30,18
1657587336265,MATH 18,A01,083743,Cinel; Cameron Alexander,7,0,30,23
1657587336265,MATH 18,A02,083744,Cinel; Cameron Alexander,17,0,30,13
1657587336265,MATH 18,A03,083745,Cinel; Cameron Alexander,9,0,30,21
1657587336265,MATH 18,B01,083748,Rideout; David Porter,5,0,37,32
1657587336265,MATH 18,B02,083749,Rideout; David Porter,5,0,36,31
1657587336265,MATH 18,B03,083750,Rideout; David Porter,3,0,37,34
1657587336265,MATH 18,B04,083751,Rideout; David Porter,6,0,36,30
1657587336265,MATH 18,B05,093473,Rideout; David Porter,6,0,36,30
1657587336265,MATH 18,B06,093474,Rideout; David Porter,6,0,36,30
1657587342295,MATH 20A,A01,083754,Zheng; Zequn,14,0,40,26
1657587348321,MATH 20B,A01,083756,Briones; Jor-el Thomas Caparas,4,0,36,32
1657587348321,MATH 20B,A02,083757,Briones; Jor-el Thomas Caparas,1,0,36,35
1657587348321,MATH 20B,A03,093475,Briones; Jor-el Thomas Caparas,2,0,36,34
1657587354347,MATH 20C,A01,083760,Briones; Jor-el Thomas Caparas,1,0,35,34
1657587354347,MATH 20C,A02,083761,Briones; Jor-el Thomas Caparas,8,0,35,27
1657587354347,MATH 20C,A03,093476,Briones; Jor-el Thomas Caparas,0,1,36,36
1657587354347,MATH 20C,B01,083762,Bach; Quang Tran,1,0,30,29
1657587360374,MATH 20D,A01,083765,Tran; Brian Kha,5,0,30,25
1657587360374,MATH 20D,A02,083766,Tran; Brian Kha,5,0,30,25
1657587360374,MATH 20D,A03,083767,Tran; Brian Kha,5,0,30,25
1657587366398,MATH 20E,A01,083771,Ganguly; Soumya,9,0,32,23
1657587366398,MATH 20E,A02,083772,Ganguly; Soumya,6,0,32,26
1657587366398,MATH 20E,B01,083773,Ciotti; Benjamin,20,0,35,15
1657587366398,MATH 20E,B02,083774,Ciotti; Benjamin,18,0,35,17
1657587372434,MATH 103A,A01,083777,Greenfeld; Be'Eri,3,0,36,33
1657587372434,MATH 103A,A02,083778,Greenfeld; Be'Eri,5,0,36,31
1657587372434,MATH 103A,A03,093561,Greenfeld; Be'Eri,5,0,36,31
1657587372434,MATH 103A,B01,083779,Greenfeld; Be'Eri,7,0,36,29
1657587372434,MATH 103A,B02,083780,Greenfeld; Be'Eri,4,0,36,32
1657587372434,MATH 103A,B03,093562,Greenfeld; Be'Eri,3,0,36,33
1657587378460,MATH 105,A01,085443,Carter; Anne Toulson,15,0,35,20
1657587378460,MATH 105,A02,093477,Carter; Anne Toulson,20,0,35,15
1657587384488,MATH 109,A01,083213,Ganzberger; Geoffrey Michael,2,0,34,32
1657587384488,MATH 109,A02,083214,Ganzberger; Geoffrey Michael,4,0,34,30
1657587384488,MATH 109,A03,093478,Ganzberger; Geoffrey Michael,2,0,34,32
1657587384488,MATH 109,B01,083215,Ganzberger; Geoffrey Michael,1,0,32,31
1657587384488,MATH 109,B02,083216,Ganzberger; Geoffrey Michael,2,0,32,30
1657587384488,MATH 109,B03,093479,Ganzberger; Geoffrey Michael,8,0,32,24
1657587390515,MATH 142A,A01,083219,Chow; Bennett,7,0,32,25
1657587390515,MATH 142A,A02,083220,Chow; Bennett,10,0,32,22
1657587390515,MATH 142A,A03,093480,Chow; Bennett,8,0,32,24
1657587390515,MATH 142A,B03,093481,Chow; Bennett,8,0,32,24
1657587390515,MATH 142A,B04,093558,Chow; Bennett,13,0,32,19
1657587390515,MATH 142A,B05,093559,Chow; Bennett,6,0,32,26
1657587396539,MATH 193A,A01,083224,Rotar; Vladimir,8,0,34,26
1657587396539,MATH 193A,A02,083225,Rotar; Vladimir,9,0,34,25
1657587396539,MATH 193A,A03,083781,Rotar; Vladimir,5,0,34,29
1657587396539,MATH 193A,A04,083782,Rotar; Vladimir,10,0,34,24
1657587396539,MATH 193A,A05,093482,Rotar; Vladimir,10,0,34,24
1657587402561,MATH 197,001,091859,McAuley; Julian John,9999,0,9999,0
1657587402561,MATH 197,002,095566,Kedlaya; Kiran S.,9997,0,9999,2
1657587402561,MATH 197,003,095567,Xiao; Ming,9999,0,9999,0
1657587402561,MATH 197,004,095571,Perols; Johan Lars,9998,0,9999,1
1657587409627,COGS 9,A01,083615,Shannon; Kyle Michael,9,0,75,66
1657587415651,COGS 11,A01,083617,Boyle; Mary E. T.,23,0,48,25
1657587421678,COGS 13,A01,083071,Bastos; Amalia Pinkusfeld,11,0,71,60
1657587427701,COGS 14A,A01,092681,Semenuks; Arturs,5,1,100,95
1657587433723,COGS 14B,A01,083073,Cheng; Tzu-Han,6,0,63,57
1657587439747,COGS 17,A01,092677,Semenuks; Arturs,6,0,81,75
1657587445777,COGS 100,A01,083619,Allen; Michael Gordon,17,0,70,53
1657587451804,COGS 101A,A01,083621,Davis; Joshua Daniel,9,0,68,59
1657587457826,COGS 101B,A01,091572,Allen; Michael Gordon,12,0,65,53
1657587463848,COGS 101C,A01,083625,Delgado; Tania,17,0,35,18
1657587469874,COGS 107A,A01,083627,Boyle; Mary E. T.,13,0,60,47
1657587475901,COGS 118A,A01,083075,Gupta; Anjum,21,0,76,55
1657587481929,CSE 3,A50,083646,Miranda; Gregory Joseph,24,0,50,26
1657587487951,CSE 8A,A50,083650,Miranda; Gregory Joseph,17,1,56,39
1657587493976,CSE 11,A01,083080,Cao; Yingjun,6,15,40,34
1657587499999,CSE 12,A01,083652,Krause-Levy; Sophia Louisa,28,1,120,92
1657587506023,CSE 15L,A01,083654,Morris; Justin Loren,9,0,50,41
1657587506023,CSE 15L,A02,083655,Morris; Justin Loren,9,0,50,41
1657587512047,CSE 20,A01,083657,Tran; Khoa Dang,39,0,80,41
1657587518075,CSE 21,A01,095574,Bach; Quang Tran,22,0,48,26
1657587524098,CSE 30,A01,083084,Eldon; John,5,0,80,75
1657587524098,CSE 30,B01,095061,Bhaskar; Nishant,9,0,50,41
1657587530120,CSE 100,A01,083659,Cao; Yingjun,5,4,70,65
1657587536146,CSE 134B,A01,083661,Powell; Thomas Allan,22,0,100,78
1657587542168,CSE 140,A01,083663,Gungor; Onat,15,0,85,70
1657587548190,CSE 140L,A01,083088,Eldon; John,21,0,100,79
1657587554215,CSE 175,A01,083665,Kumar; Rakesh,3,0,25,22
1657587560238,CSE 190,A00,092507,Dubnov; Shlomo,8,0,20,12
1657587566265,ECE 45,A01,083139,Congero; Spencer William,6,0,75,69
1657587572292,ECE 65,A50,083695,Saad; Andrew S,12,0,30,18
1657587572292,ECE 65,A51,095125,Saad; Andrew S,24,0,26,2
1657587578323,ECE 109,A01,091882,Touri; Behrouz,19,0,70,51
1657587584346,ECE 180,A00,083140,Abi Samra; Nicholas Camill,1,0,30,29
1657587584346,ECE 180,B00,083141,Abi Samra; Nicholas Camill,0,0,30,30
1657587590370,MATH 10A,A01,083735,Patchell; Gregory David,2,0,30,28
1657587590370,MATH 10A,A02,083736,Patchell; Gregory David,20,0,30,10
1657587590370,MATH 10A,A03,083737,Patchell; Gregory David,16,0,30,14
1657587596398,MATH 10B,A01,083207,Lim; Seonhee,8,0,34,26
1657587596398,MATH 10B,A02,083208,Lim; Seonhee,9,0,35,26
1657587596398,MATH 10B,A03,093472,Lim; Seonhee,7,0,34,27
1657587596398,MATH 10B,B01,083739,Sinha; Shubham,12,0,30,18
1657587602423,MATH 18,A01,083743,Cinel; Cameron Alexander,7,0,30,23
1657587602423,MATH 18,A02,083744,Cinel; Cameron Alexander,17,0,30,13
1657587602423,MATH 18,A03,083745,Cinel; Cameron Alexander,9,0,30,21
1657587602423,MATH 18,B01,083748,Rideout; David Porter,5,0,37,32
1657587602423,MATH 18,B02,083749,Rideout; David Porter,5,0,36,31
1657587602423,MATH 18,B03,083750,Rideout; David Porter,3,0,37,34
1657587602423,MATH 18,B04,083751,Rideout; David Porter,6,0,36,30
1657587602423,MATH 18,B05,093473,Rideout; David Porter,6,0,36,30
1657587602423,MATH 18,B06,093474,Rideout; David Porter,6,0,36,30
1657587608456,MATH 20A,A01,083754,Zheng; Zequn,14,0,40,26
1657587614492,MATH 20B,A01,083756,Briones; Jor-el Thomas Caparas,4,0,36,32
1657587614492,MATH 20B,A02,083757,Briones; Jor-el Thomas Caparas,1,0,36,35
1657587614492,MATH 20B,A03,093475,Briones; Jor-el Thomas Caparas,2,0,36,34
1657587620516,MATH 20C,A01,083760,Briones; Jor-el Thomas Caparas,1,0,35,34
1657587620516,MATH 20C,A02,083761,Briones; Jor-el Thomas Caparas,8,0,35,27
1657587620516,MATH 20C,A03,093476,Briones; Jor-el Thomas Caparas,0,1,36,36
1657587620516,MATH 20C,B01,083762,Bach; Quang Tran,1,0,30,29
1657587626540,MATH 20D,A01,083765,Tran; Brian Kha,5,0,30,25
1657587626540,MATH 20D,A02,083766,Tran; Brian Kha,5,0,30,25
1657587626540,MATH 20D,A03,083767,Tran; Brian Kha,5,0,30,25
1657587632583,MATH 20E,A01,083771,Ganguly; Soumya,9,0,32,23
1657587632583,MATH 20E,A02,083772,Ganguly; Soumya,6,0,32,26
1657587632583,MATH 20E,B01,083773,Ciotti; Benjamin,20,0,35,15
1657587632583,MATH 20E,B02,083774,Ciotti; Benjamin,18,0,35,17
1657587638606,MATH 103A,A01,083777,Greenfeld; Be'Eri,3,0,36,33
1657587638606,MATH 103A,A02,083778,Greenfeld; Be'Eri,5,0,36,31
1657587638606,MATH 103A,A03,093561,Greenfeld; Be'Eri,5,0,36,31
1657587638606,MATH 103A,B01,083779,Greenfeld; Be'Eri,7,0,36,29
1657587638606,MATH 103A,B02,083780,Greenfeld; Be'Eri,4,0,36,32
1657587638606,MATH 103A,B03,093562,Greenfeld; Be'Eri,3,0,36,33
1657587644629,MATH 105,A01,085443,Carter; Anne Toulson,15,0,35,20
1657587644629,MATH 105,A02,093477,Carter; Anne Toulson,20,0,35,15
1657587650657,MATH 109,A01,083213,Ganzberger; Geoffrey Michael,2,0,34,32
1657587650657,MATH 109,A02,083214,Ganzberger; Geoffrey Michael,4,0,34,30
1657587650657,MATH 109,A03,093478,Ganzberger; Geoffrey Michael,2,0,34,32
1657587650657,MATH 109,B01,083215,Ganzberger; Geoffrey Michael,1,0,32,31
1657587650657,MATH 109,B02,083216,Ganzberger; Geoffrey Michael,2,0,32,30
1657587650657,MATH 109,B03,093479,Ganzberger; Geoffrey Michael,8,0,32,24
1657587656686,MATH 142A,A01,083219,Chow; Bennett,7,0,32,25
1657587656686,MATH 142A,A02,083220,Chow; Bennett,10,0,32,22
1657587656686,MATH 142A,A03,093480,Chow; Bennett,8,0,32,24
1657587656686,MATH 142A,B03,093481,Chow; Bennett,8,0,32,24
1657587656686,MATH 142A,B04,093558,Chow; Bennett,13,0,32,19
1657587656686,MATH 142A,B05,093559,Chow; Bennett,6,0,32,26
1657587662716,MATH 193A,A01,083224,Rotar; Vladimir,8,0,34,26
1657587662716,MATH 193A,A02,083225,Rotar; Vladimir,9,0,34,25
1657587662716,MATH 193A,A03,083781,Rotar; Vladimir,5,0,34,29
1657587662716,MATH 193A,A04,083782,Rotar; Vladimir,10,0,34,24
1657587662716,MATH 193A,A05,093482,Rotar; Vladimir,10,0,34,24
1657587668739,MATH 197,001,091859,McAuley; Julian John,9999,0,9999,0
1657587668739,MATH 197,002,095566,Kedlaya; Kiran S.,9997,0,9999,2
1657587668739,MATH 197,003,095567,Xiao; Ming,9999,0,9999,0
1657587668739,MATH 197,004,095571,Perols; Johan Lars,9998,0,9999,1
1657587675793,COGS 9,A01,083615,Shannon; Kyle Michael,9,0,75,66
1657587681819,COGS 11,A01,083617,Boyle; Mary E. T.,23,0,48,25
1657587687842,COGS 13,A01,083071,Bastos; Amalia Pinkusfeld,11,0,71,60
1657587693865,COGS 14A,A01,092681,Semenuks; Arturs,5,1,100,95
1657587699887,COGS 14B,A01,083073,Cheng; Tzu-Han,6,0,63,57
1657587705918,COGS 17,A01,092677,Semenuks; Arturs,6,0,81,75
1657587711945,COGS 100,A01,083619,Allen; Michael Gordon,17,0,70,53
1657587717979,COGS 101A,A01,083621,Davis; Joshua Daniel,9,0,68,59
1657587724007,COGS 101B,A01,091572,Allen; Michael Gordon,12,0,65,53
1657587730031,COGS 101C,A01,083625,Delgado; Tania,17,0,35,18
1657587736065,COGS 107A,A01,083627,Boyle; Mary E. T.,13,0,60,47
1657587742093,COGS 118A,A01,083075,Gupta; Anjum,21,0,76,55
1657587748121,CSE 3,A50,083646,Miranda; Gregory Joseph,24,0,50,26
1657587754143,CSE 8A,A50,083650,Miranda; Gregory Joseph,17,1,56,39
1657587760171,CSE 11,A01,083080,Cao; Yingjun,6,15,40,34
1657587766193,CSE 12,A01,083652,Krause-Levy; Sophia Louisa,28,1,120,92
1657587772216,CSE 15L,A01,083654,Morris; Justin Loren,9,0,50,41
1657587772216,CSE 15L,A02,083655,Morris; Justin Loren,9,0,50,41
1657587778239,CSE 20,A01,083657,Tran; Khoa Dang,39,0,80,41
1657587784266,CSE 21,A01,095574,Bach; Quang Tran,22,0,48,26
1657587790292,CSE 30,A01,083084,Eldon; John,5,0,80,75
1657587790292,CSE 30,B01,095061,Bhaskar; Nishant,9,0,50,41
1657587796323,CSE 100,A01,083659,Cao; Yingjun,5,4,70,65
1657587802349,CSE 134B,A01,083661,Powell; Thomas Allan,22,0,100,78
1657587808372,CSE 140,A01,083663,Gungor; Onat,15,0,85,70
1657587814395,CSE 140L,A01,083088,Eldon; John,21,0,100,79
1657587820417,CSE 175,A01,083665,Kumar; Rakesh,3,0,25,22
1657587826449,CSE 190,A00,092507,Dubnov; Shlomo,8,0,20,12
1657587832472,ECE 45,A01,083139,Congero; Spencer William,6,0,75,69
1657587838494,ECE 65,A50,083695,Saad; Andrew S,12,0,30,18
1657587838494,ECE 65,A51,095125,Saad; Andrew S,24,0,26,2
1657587844516,ECE 109,A01,091882,Touri; Behrouz,19,0,70,51
1657587850541,ECE 180,A00,083140,Abi Samra; Nicholas Camill,1,0,30,29
1657587850541,ECE 180,B00,083141,Abi Samra; Nicholas Camill,0,0,30,30
1657587856569,MATH 10A,A01,083735,Patchell; Gregory David,2,0,30,28
1657587856569,MATH 10A,A02,083736,Patchell; Gregory David,20,0,30,10
1657587856569,MATH 10A,A03,083737,Patchell; Gregory David,16,0,30,14
1657587862593,MATH 10B,A01,083207,Lim; Seonhee,8,0,34,26
1657587862593,MATH 10B,A02,083208,Lim; Seonhee,9,0,35,26
1657587862593,MATH 10B,A03,093472,Lim; Seonhee,7,0,34,27
1657587862593,MATH 10B,B01,083739,Sinha; Shubham,12,0,30,18
1657587868630,MATH 18,A01,083743,Cinel; Cameron Alexander,7,0,30,23
1657587868630,MATH 18,A02,083744,Cinel; Cameron Alexander,17,0,30,13
1657587868630,MATH 18,A03,083745,Cinel; Cameron Alexander,9,0,30,21
1657587868630,MATH 18,B01,083748,Rideout; David Porter,5,0,37,32
1657587868630,MATH 18,B02,083749,Rideout; David Porter,5,0,36,31
1657587868630,MATH 18,B03,083750,Rideout; David Porter,3,0,37,34
1657587868630,MATH 18,B04,083751,Rideout; David Porter,6,0,36,30
1657587868630,MATH 18,B05,093473,Rideout; David Porter,6,0,36,30
1657587868630,MATH 18,B06,093474,Rideout; David Porter,6,0,36,30
1657587874658,MATH 20A,A01,083754,Zheng; Zequn,14,0,40,26
1657587880685,MATH 20B,A01,083756,Briones; Jor-el Thomas Caparas,4,0,36,32
1657587880685,MATH 20B,A02,083757,Briones; Jor-el Thomas Caparas,1,0,36,35
1657587880685,MATH 20B,A03,093475,Briones; Jor-el Thomas Caparas,2,0,36,34
1657587886709,MATH 20C,A01,083760,Briones; Jor-el Thomas Caparas,1,0,35,34
1657587886709,MATH 20C,A02,083761,Briones; Jor-el Thomas Caparas,8,0,35,27
1657587886709,MATH 20C,A03,093476,Briones; Jor-el Thomas Caparas,0,1,36,36
1657587886709,MATH 20C,B01,083762,Bach; Quang Tran,1,0,30,29
1657587892736,MATH 20D,A01,083765,Tran; Brian Kha,5,0,30,25
1657587892736,MATH 20D,A02,083766,Tran; Brian Kha,5,0,30,25
1657587892736,MATH 20D,A03,083767,Tran; Brian Kha,5,0,30,25
1657587898759,MATH 20E,A01,083771,Ganguly; Soumya,9,0,32,23
1657587898759,MATH 20E,A02,083772,Ganguly; Soumya,6,0,32,26
1657587898759,MATH 20E,B01,083773,Ciotti; Benjamin,20,0,35,15
1657587898759,MATH 20E,B02,083774,Ciotti; Benjamin,18,0,35,17
1657587904783,MATH 103A,A01,083777,Greenfeld; Be'Eri,3,0,36,33
1657587904783,MATH 103A,A02,083778,Greenfeld; Be'Eri,5,0,36,31
1657587904783,MATH 103A,A03,093561,Greenfeld; Be'Eri,5,0,36,31
1657587904783,MATH 103A,B01,083779,Greenfeld; Be'Eri,7,0,36,29
1657587904783,MATH 103A,B02,083780,Greenfeld; Be'Eri,4,0,36,32
1657587904783,MATH 103A,B03,093562,Greenfeld; Be'Eri,3,0,36,33
1657587910809,MATH 105,A01,085443,Carter; Anne Toulson,15,0,35,20
1657587910809,MATH 105,A02,093477,Carter; Anne Toulson,20,0,35,15
1657587916837,MATH 109,A01,083213,Ganzberger; Geoffrey Michael,2,0,34,32
1657587916837,MATH 109,A02,083214,Ganzberger; Geoffrey Michael,4,0,34,30
1657587916837,MATH 109,A03,093478,Ganzberger; Geoffrey Michael,2,0,34,32
1657587916837,MATH 109,B01,083215,Ganzberger; Geoffrey Michael,1,0,32,31
1657587916837,MATH 109,B02,083216,Ganzberger; Geoffrey Michael,2,0,32,30
1657587916837,MATH 109,B03,093479,Ganzberger; Geoffrey Michael,8,0,32,24
1657587922861,MATH 142A,A01,083219,Chow; Bennett,7,0,32,25
1657587922861,MATH 142A,A02,083220,Chow; Bennett,10,0,32,22
1657587922861,MATH 142A,A03,093480,Chow; Bennett,8,0,32,24
1657587922861,MATH 142A,B03,093481,Chow; Bennett,8,0,32,24
1657587922861,MATH 142A,B04,093558,Chow; Bennett,13,0,32,19
1657587922861,MATH 142A,B05,093559,Chow; Bennett,6,0,32,26
1657587928884,MATH 193A,A01,083224,Rotar; Vladimir,8,0,34,26
1657587928884,MATH 193A,A02,083225,Rotar; Vladimir,9,0,34,25
1657587928884,MATH 193A,A03,083781,Rotar; Vladimir,5,0,34,29
1657587928884,MATH 193A,A04,083782,Rotar; Vladimir,10,0,34,24
1657587928884,MATH 193A,A05,093482,Rotar; Vladimir,10,0,34,24
1657587934977,MATH 197,001,091859,McAuley; Julian John,9999,0,9999,0
1657587934977,MATH 197,002,095566,Kedlaya; Kiran S.,9997,0,9999,2
1657587934977,MATH 197,003,095567,Xiao; Ming,9999,0,9999,0
1657587934977,MATH 197,004,095571,Perols; Johan Lars,9998,0,9999,1
1657587942032,COGS 9,A01,083615,Shannon; Kyle Michael,9,0,75,66
1657587948054,COGS 11,A01,083617,Boyle; Mary E. T.,23,0,48,25
1657587954077,COGS 13,A01,083071,Bastos; Amalia Pinkusfeld,11,0,71,60
1657587960100,COGS 14A,A01,092681,Semenuks; Arturs,5,1,100,95
1657587966121,COGS 14B,A01,083073,Cheng; Tzu-Han,6,0,63,57
1657587972154,COGS 17,A01,092677,Semenuks; Arturs,6,0,81,75
1657587978181,COGS 100,A01,083619,Allen; Michael Gordon,17,0,70,53
1657587984204,COGS 101A,A01,083621,Davis; Joshua Daniel,9,0,68,59
1657587990227,COGS 101B,A01,091572,Allen; Michael Gordon,12,0,65,53
1657587996253,COGS 101C,A01,083625,Delgado; Tania,17,0,35,18
1657588002282,COGS 107A,A01,083627,Boyle; Mary E. T.,13,0,60,47
1657588008305,COGS 118A,A01,083075,Gupta; Anjum,21,0,76,55
1657588014333,CSE 3,A50,083646,Miranda; Gregory Joseph,24,0,50,26
1657588020355,CSE 8A,A50,083650,Miranda; Gregory Joseph,17,1,56,39
1657588026378,CSE 11,A01,083080,Cao; Yingjun,6,15,40,34
1657588032403,CSE 12,A01,083652,Krause-Levy; Sophia Louisa,28,1,120,92
1657588038429,CSE 15L,A01,083654,Morris; Justin Loren,9,0,50,41
1657588038429,CSE 15L,A02,083655,Morris; Justin Loren,9,0,50,41
1657588044451,CSE 20,A01,083657,Tran; Khoa Dang,39,0,80,41
1657588050474,CSE 21,A01,095574,Bach; Quang Tran,22,0,48,26
1657588056498,CSE 30,A01,083084,Eldon; John,5,0,80,75
1657588056498,CSE 30,B01,095061,Bhaskar; Nishant,9,0,50,41
1657588062520,CSE 100,A01,083659,Cao; Yingjun,5,4,70,65
1657588068546,CSE 134B,A01,083661,Powell; Thomas Allan,22,0,100,78
1657588074570,CSE 140,A01,083663,Gungor; Onat,15,0,85,70
1657588080599,CSE 140L,A01,083088,Eldon; John,21,0,100,79
1657588086626,CSE 175,A01,083665,Kumar; Rakesh,3,0,25,22
1657588092652,CSE 190,A00,092507,Dubnov; Shlomo,8,0,20,12
1657588098681,ECE 45,A01,083139,Congero; Spencer William,6,0,75,69
1657588104716,ECE 65,A50,083695,Saad; Andrew S,12,0,30,18
1657588104716,ECE 65,A51,095125,Saad; Andrew S,24,0,26,2
1657588110739,ECE 109,A01,091882,Touri; Behrouz,19,0,70,51
1657588116771,ECE 180,A00,083140,Abi Samra; Nicholas Camill,1,0,30,29
1657588116771,ECE 180,B00,083141,Abi Samra; Nicholas Camill,0,0,30,30
1657588122803,MATH 10A,A01,083735,Patchell; Gregory David,2,0,30,28
1657588122803,MATH 10A,A02,083736,Patchell; Gregory David,20,0,30,10
1657588122803,MATH 10A,A03,083737,Patchell; Gregory David,16,0,30,14
1657588128830,MATH 10B,A01,083207,Lim; Seonhee,8,0,34,26
1657588128830,MATH 10B,A02,083208,Lim; Seonhee,9,0,35,26
1657588128830,MATH 10B,A03,093472,Lim; Seonhee,7,0,34,27
1657588128830,MATH 10B,B01,083739,Sinha; Shubham,12,0,30,18
1657588134854,MATH 18,A01,083743,Cinel; Cameron Alexander,7,0,30,23
1657588134854,MATH 18,A02,083744,Cinel; Cameron Alexander,17,0,30,13
1657588134854,MATH 18,A03,083745,Cinel; Cameron Alexander,9,0,30,21
1657588134854,MATH 18,B01,083748,Rideout; David Porter,5,0,37,32
1657588134854,MATH 18,B02,083749,Rideout; David Porter,5,0,36,31
1657588134854,MATH 18,B03,083750,Rideout; David Porter,3,0,37,34
1657588134854,MATH 18,B04,083751,Rideout; David Porter,6,0,36,30
1657588134854,MATH 18,B05,093473,Rideout; David Porter,6,0,36,30
1657588134854,MATH 18,B06,093474,Rideout; David Porter,6,0,36,30
1657588140880,MATH 20A,A01,083754,Zheng; Zequn,14,0,40,26
1657588146904,MATH 20B,A01,083756,Briones; Jor-el Thomas Caparas,4,0,36,32
1657588146904,MATH 20B,A02,083757,Briones; Jor-el Thomas Caparas,1,0,36,35
1657588146904,MATH 20B,A03,093475,Briones; Jor-el Thomas Caparas,2,0,36,34
1657588152931,MATH 20C,A01,083760,Briones; Jor-el Thomas Caparas,1,0,35,34
1657588152931,MATH 20C,A02,083761,Briones; Jor-el Thomas Caparas,8,0,35,27
1657588152931,MATH 20C,A03,093476,Briones; Jor-el Thomas Caparas,0,1,36,36
1657588152931,MATH 20C,B01,083762,Bach; Quang Tran,1,0,30,29
1657588158955,MATH 20D,A01,083765,Tran; Brian Kha,5,0,30,25
1657588158955,MATH 20D,A02,083766,Tran; Brian Kha,5,0,30,25
1657588158955,MATH 20D,A03,083767,Tran; Brian Kha,5,0,30,25
1657588164979,MATH 20E,A01,083771,Ganguly; Soumya,9,0,32,23
1657588164979,MATH 20E,A02,083772,Ganguly; Soumya,6,0,32,26
1657588164979,MATH 20E,B01,083773,Ciotti; Benjamin,20,0,35,15
1657588164979,MATH 20E,B02,083774,Ciotti; Benjamin,18,0,35,17
1657588171008,MATH 103A,A01,083777,Greenfeld; Be'Eri,3,0,36,33
1657588171008,MATH 103A,A02,083778,Greenfeld; Be'Eri,5,0,36,31
1657588171008,MATH 103A,A03,093561,Greenfeld; Be'Eri,5,0,36,31
1657588171008,MATH 103A,B01,083779,Greenfeld; Be'Eri,7,0,36,29
1657588171008,MATH 103A,B02,083780,Greenfeld; Be'Eri,4,0,36,32
1657588171008,MATH 103A,B03,093562,Greenfeld; Be'Eri,3,0,36,33
1657588177034,MATH 105,A01,085443,Carter; Anne Toulson,15,0,35,20
1657588177034,MATH 105,A02,093477,Carter; Anne Toulson,20,0,35,15
1657588183063,MATH 109,A01,083213,Ganzberger; Geoffrey Michael,2,0,34,32
1657588183063,MATH 109,A02,083214,Ganzberger; Geoffrey Michael,4,0,34,30
1657588183063,MATH 109,A03,093478,Ganzberger; Geoffrey Michael,2,0,34,32
1657588183063,MATH 109,B01,083215,Ganzberger; Geoffrey Michael,1,0,32,31
1657588183063,MATH 109,B02,083216,Ganzberger; Geoffrey Michael,2,0,32,30
1657588183063,MATH 109,B03,093479,Ganzberger; Geoffrey Michael,8,0,32,24
1657588189086,MATH 142A,A01,083219,Chow; Bennett,7,0,32,25
1657588189086,MATH 142A,A02,083220,Chow; Bennett,10,0,32,22
1657588189086,MATH 142A,A03,093480,Chow; Bennett,8,0,32,24
1657588189086,MATH 142A,B03,093481,Chow; Bennett,8,0,32,24
1657588189086,MATH 142A,B04,093558,Chow; Bennett,13,0,32,19
1657588189086,MATH 142A,B05,093559,Chow; Bennett,6,0,32,26
1657588195111,MATH 193A,A01,083224,Rotar; Vladimir,8,0,34,26
1657588195111,MATH 193A,A02,083225,Rotar; Vladimir,9,0,34,25
1657588195111,MATH 193A,A03,083781,Rotar; Vladimir,5,0,34,29
1657588195111,MATH 193A,A04,083782,Rotar; Vladimir,10,0,34,24
1657588195111,MATH 193A,A05,093482,Rotar; Vladimir,10,0,34,24
1657588201134,MATH 197,001,091859,McAuley; Julian John,9999,0,9999,0
1657588201134,MATH 197,002,095566,Kedlaya; Kiran S.,9997,0,9999,2
1657588201134,MATH 197,003,095567,Xiao; Ming,9999,0,9999,0
1657588201134,MATH 197,004,095571,Perols; Johan Lars,9998,0,9999,1
1657588208185,COGS 9,A01,083615,Shannon; Kyle Michael,9,0,75,66
1657588214217,COGS 11,A01,083617,Boyle; Mary E. T.,23,0,48,25
1657588220240,COGS 13,A01,083071,Bastos; Amalia Pinkusfeld,11,0,71,60
1657588226270,COGS 14A,A01,092681,Semenuks; Arturs,5,1,100,95
1657588232302,COGS 14B,A01,083073,Cheng; Tzu-Han,6,0,63,57
1657588238325,COGS 17,A01,092677,Semenuks; Arturs,6,0,81,75
1657588244348,COGS 100,A01,083619,Allen; Michael Gordon,17,0,70,53
1657588250376,COGS 101A,A01,083621,Davis; Joshua Daniel,9,0,68,59
1657588256403,COGS 101B,A01,091572,Allen; Michael Gordon,12,0,65,53
1657588262430,COGS 101C,A01,083625,Delgado; Tania,17,0,35,18
1657588268452,COGS 107A,A01,083627,Boyle; Mary E. T.,13,0,60,47
1657588274478,COGS 118A,A01,083075,Gupta; Anjum,21,0,76,55
1657588280502,CSE 3,A50,083646,Miranda; Gregory Joseph,24,0,50,26
1657588286530,CSE 8A,A50,083650,Miranda; Gregory Joseph,17,1,56,39
1657588292557,CSE 11,A01,083080,Cao; Yingjun,6,15,40,34
1657588298580,CSE 12,A01,083652,Krause-Levy; Sophia Louisa,28,1,120,92
1657588304603,CSE 15L,A01,083654,Morris; Justin Loren,9,0,50,41
1657588304603,CSE 15L,A02,083655,Morris; Justin Loren,9,0,50,41
1657588310630,CSE 20,A01,083657,Tran; Khoa Dang,39,0,80,41
1657588316653,CSE 21,A01,095574,Bach; Quang Tran,22,0,48,26
1657588322685,CSE 30,A01,083084,Eldon; John,5,0,80,75
1657588322685,CSE 30,B01,095061,Bhaskar; Nishant,9,0,50,41
1657588328711,CSE 100,A01,083659,Cao; Yingjun,5,4,70,65
1657588334734,CSE 134B,A01,083661,Powell; Thomas Allan,22,0,100,78
1657588340761,CSE 140,A01,083663,Gungor; Onat,15,0,85,70
1657588346787,CSE 140L,A01,083088,Eldon; John,21,0,100,79
1657588352810,CSE 175,A01,083665,Kumar; Rakesh,3,0,25,22
1657588358835,CSE 190,A00,092507,Dubnov; Shlomo,8,0,20,12
1657588364859,ECE 45,A01,083139,Congero; Spencer William,6,0,75,69
1657588370881,ECE 65,A50,083695,Saad; Andrew S,12,0,30,18
1657588370881,ECE 65,A51,095125,Saad; Andrew S,24,0,26,2
1657588376919,ECE 109,A01,091882,Touri; Behrouz,19,0,70,51
1657588382943,ECE 180,A00,083140,Abi Samra; Nicholas Camill,1,0,30,29
1657588382943,ECE 180,B00,083141,Abi Samra; Nicholas Camill,0,0,30,30
1657588388966,MATH 10A,A01,083735,Patchell; Gregory David,2,0,30,28
1657588388966,MATH 10A,A02,083736,Patchell; Gregory David,20,0,30,10
1657588388966,MATH 10A,A03,083737,Patchell; Gregory David,16,0,30,14
1657588394989,MATH 10B,A01,083207,Lim; Seonhee,8,0,34,26
1657588394989,MATH 10B,A02,083208,Lim; Seonhee,9,0,35,26
1657588394989,MATH 10B,A03,093472,Lim; Seonhee,7,0,34,27
1657588394989,MATH 10B,B01,083739,Sinha; Shubham,12,0,30,18
1657588401012,MATH 18,A01,083743,Cinel; Cameron Alexander,7,0,30,23
1657588401012,MATH 18,A02,083744,Cinel; Cameron Alexander,17,0,30,13
1657588401012,MATH 18,A03,083745,Cinel; Cameron Alexander,9,0,30,21
1657588401012,MATH 18,B01,083748,Rideout; David Porter,5,0,37,32
1657588401012,MATH 18,B02,083749,Rideout; David Porter,5,0,36,31
1657588401012,MATH 18,B03,083750,Rideout; David Porter,3,0,37,34
1657588401012,MATH 18,B04,083751,Rideout; David Porter,6,0,36,30
1657588401012,MATH 18,B05,093473,Rideout; David Porter,6,0,36,30
1657588401012,MATH 18,B06,093474,Rideout; David Porter,6,0,36,30
1657588407035,MATH 20A,A01,083754,Zheng; Zequn,14,0,40,26
1657588413058,MATH 20B,A01,083756,Briones; Jor-el Thomas Caparas,4,0,36,32
1657588413058,MATH 20B,A02,083757,Briones; Jor-el Thomas Caparas,1,0,36,35
1657588413058,MATH 20B,A03,093475,Briones; Jor-el Thomas Caparas,2,0,36,34
1657588419081,MATH 20C,A01,083760,Briones; Jor-el Thomas Caparas,1,0,35,34
1657588419081,MATH 20C,A02,083761,Briones; Jor-el Thomas Caparas,8,0,35,27
1657588419081,MATH 20C,A03,093476,Briones; Jor-el Thomas Caparas,0,1,36,36
1657588419081,MATH 20C,B01,083762,Bach; Quang Tran,1,0,30,29
1657588425110,MATH 20D,A01,083765,Tran; Brian Kha,5,0,30,25
1657588425110,MATH 20D,A02,083766,Tran; Brian Kha,5,0,30,25
1657588425110,MATH 20D,A03,083767,Tran; Brian Kha,5,0,30,25
1657588431142,MATH 20E,A01,083771,Ganguly; Soumya,9,0,32,23
1657588431142,MATH 20E,A02,083772,Ganguly; Soumya,6,0,32,26
1657588431142,MATH 20E,B01,083773,Ciotti; Benjamin,20,0,35,15
1657588431142,MATH 20E,B02,083774,Ciotti; Benjamin,18,0,35,17
1657588437165,MATH 103A,A01,083777,Greenfeld; Be'Eri,3,0,36,33
1657588437165,MATH 103A,A02,083778,Greenfeld; Be'Eri,5,0,36,31
1657588437165,MATH 103A,A03,093561,Greenfeld; Be'Eri,5,0,36,31
1657588437165,MATH 103A,B01,083779,Greenfeld; Be'Eri,7,0,36,29
1657588437165,MATH 103A,B02,083780,Greenfeld; Be'Eri,4,0,36,32
1657588437165,MATH 103A,B03,093562,Greenfeld; Be'Eri,3,0,36,33
1657588443188,MATH 105,A01,085443,Carter; Anne Toulson,15,0,35,20
1657588443188,MATH 105,A02,093477,Carter; Anne Toulson,20,0,35,15
1657588449212,MATH 109,A01,083213,Ganzberger; Geoffrey Michael,2,0,34,32
1657588449212,MATH 109,A02,083214,Ganzberger; Geoffrey Michael,4,0,34,30
1657588449212,MATH 109,A03,093478,Ganzberger; Geoffrey Michael,2,0,34,32
1657588449212,MATH 109,B01,083215,Ganzberger; Geoffrey Michael,1,0,32,31
1657588449212,MATH 109,B02,083216,Ganzberger; Geoffrey Michael,2,0,32,30
1657588449212,MATH 109,B03,093479,Ganzberger; Geoffrey Michael,8,0,32,24
1657588455238,MATH 142A,A01,083219,Chow; Bennett,7,0,32,25
1657588455238,MATH 142A,A02,083220,Chow; Bennett,10,0,32,22
1657588455238,MATH 142A,A03,093480,Chow; Bennett,8,0,32,24
1657588455238,MATH 142A,B03,093481,Chow; Bennett,8,0,32,24
1657588455238,MATH 142A,B04,093558,Chow; Bennett,13,0,32,19
1657588455238,MATH 142A,B05,093559,Chow; Bennett,6,0,32,26
1657588461261,MATH 193A,A01,083224,Rotar; Vladimir,8,0,34,26
1657588461261,MATH 193A,A02,083225,Rotar; Vladimir,9,0,34,25
1657588461261,MATH 193A,A03,083781,Rotar; Vladimir,5,0,34,29
1657588461261,MATH 193A,A04,083782,Rotar; Vladimir,10,0,34,24
1657588461261,MATH 193A,A05,093482,Rotar; Vladimir,10,0,34,24
1657588467284,MATH 197,001,091859,McAuley; Julian John,9999,0,9999,0
1657588467284,MATH 197,002,095566,Kedlaya; Kiran S.,9997,0,9999,2
1657588467284,MATH 197,003,095567,Xiao; Ming,9999,0,9999,0
1657588467284,MATH 197,004,095571,Perols; Johan Lars,9998,0,9999,1
1657588474350,COGS 9,A01,083615,Shannon; Kyle Michael,9,0,75,66
1657588480378,COGS 11,A01,083617,Boyle; Mary E. T.,23,0,48,25
1657588486403,COGS 13,A01,083071,Bastos; Amalia Pinkusfeld,11,0,71,60
1657588492425,COGS 14A,A01,092681,Semenuks; Arturs,5,1,100,95
1657588498450,COGS 14B,A01,083073,Cheng; Tzu-Han,6,0,63,57
1657588504472,COGS 17,A01,092677,Semenuks; Arturs,6,0,81,75
1657588510499,COGS 100,A01,083619,Allen; Michael Gordon,17,0,70,53
1657588516526,COGS 101A,A01,083621,Davis; Joshua Daniel,9,0,68,59
1657588522549,COGS 101B,A01,091572,Allen; Michael Gordon,12,0,65,53
1657588528654,COGS 101C,A01,083625,Delgado; Tania,17,0,35,18
1657588534678,COGS 107A,A01,083627,Boyle; Mary E. T.,13,0,60,47
1657588540701,COGS 118A,A01,083075,Gupta; Anjum,21,0,76,55
1657588546733,CSE 3,A50,083646,Miranda; Gregory Joseph,24,0,50,26
1657588552755,CSE 8A,A50,083650,Miranda; Gregory Joseph,17,1,56,39
1657588558776,CSE 11,A01,083080,Cao; Yingjun,6,15,40,34
1657588564806,CSE 12,A01,083652,Krause-Levy; Sophia Louisa,28,1,120,92
1657588570832,CSE 15L,A01,083654,Morris; Justin Loren,9,0,50,41
1657588570832,CSE 15L,A02,083655,Morris; Justin Loren,9,0,50,41
1657588576857,CSE 20,A01,083657,Tran; Khoa Dang,39,0,80,41
1657588582879,CSE 21,A01,095574,Bach; Quang Tran,22,0,48,26
1657588588916,CSE 30,A01,083084,Eldon; John,5,0,80,75
1657588588916,CSE 30,B01,095061,Bhaskar; Nishant,9,0,50,41
1657588594943,CSE 100,A01,083659,Cao; Yingjun,5,4,70,65
1657588600965,CSE 134B,A01,083661,Powell; Thomas Allan,22,0,100,78
1657588606989,CSE 140,A01,083663,Gungor; Onat,15,0,85,70
1657588613017,CSE 140L,A01,083088,Eldon; John,21,0,100,79
1657588619039,CSE 175,A01,083665,Kumar; Rakesh,3,0,25,22
1657588625064,CSE 190,A00,092507,Dubnov; Shlomo,8,0,20,12
1657588631102,ECE 45,A01,083139,Congero; Spencer William,6,0,75,69
1657588637129,ECE 65,A50,083695,Saad; Andrew S,12,0,30,18
1657588637129,ECE 65,A51,095125,Saad; Andrew S,24,0,26,2
1657588643152,ECE 109,A01,091882,Touri; Behrouz,19,0,70,51
1657588649174,ECE 180,A00,083140,Abi Samra; Nicholas Camill,1,0,30,29
1657588649174,ECE 180,B00,083141,Abi Samra; Nicholas Camill,0,0,30,30
1657588655202,MATH 10A,A01,083735,Patchell; Gregory David,2,0,30,28
1657588655202,MATH 10A,A02,083736,Patchell; Gregory David,20,0,30,10
1657588655202,MATH 10A,A03,083737,Patchell; Gregory David,16,0,30,14
1657588661227,MATH 10B,A01,083207,Lim; Seonhee,8,0,34,26
1657588661227,MATH 10B,A02,083208,Lim; Seonhee,9,0,35,26
1657588661227,MATH 10B,A03,093472,Lim; Seonhee,7,0,34,27
1657588661227,MATH 10B,B01,083739,Sinha; Shubham,12,0,30,18
1657588667269,MATH 18,A01,083743,Cinel; Cameron Alexander,7,0,30,23
1657588667269,MATH 18,A02,083744,Cinel; Cameron Alexander,17,0,30,13
1657588667269,MATH 18,A03,083745,Cinel; Cameron Alexander,9,0,30,21
1657588667269,MATH 18,B01,083748,Rideout; David Porter,5,0,37,32
1657588667269,MATH 18,B02,083749,Rideout; David Porter,5,0,36,31
1657588667269,MATH 18,B03,083750,Rideout; David Porter,3,0,37,34
1657588667269,MATH 18,B04,083751,Rideout; David Porter,6,0,36,30
1657588667269,MATH 18,B05,093473,Rideout; David Porter,6,0,36,30
1657588667269,MATH 18,B06,093474,Rideout; David Porter,6,0,36,30
1657588673302,MATH 20A,A01,083754,Zheng; Zequn,14,0,40,26
1657588679327,MATH 20B,A01,083756,Briones; Jor-el Thomas Caparas,4,0,36,32
1657588679327,MATH 20B,A02,083757,Briones; Jor-el Thomas Caparas,1,0,36,35
1657588679327,MATH 20B,A03,093475,Briones; Jor-el Thomas Caparas,2,0,36,34
1657588685351,MATH 20C,A01,083760,Briones; Jor-el Thomas Caparas,1,0,35,34
1657588685351,MATH 20C,A02,083761,Briones; Jor-el Thomas Caparas,8,0,35,27
1657588685351,MATH 20C,A03,093476,Briones; Jor-el Thomas Caparas,0,1,36,36
1657588685351,MATH 20C,B01,083762,Bach; Quang Tran,1,0,30,29
1657588691379,MATH 20D,A01,083765,Tran; Brian Kha,5,0,30,25
1657588691379,MATH 20D,A02,083766,Tran; Brian Kha,5,0,30,25
1657588691379,MATH 20D,A03,083767,Tran; Brian Kha,5,0,30,25
1657588697402,MATH 20E,A01,083771,Ganguly; Soumya,9,0,32,23
1657588697402,MATH 20E,A02,083772,Ganguly; Soumya,6,0,32,26
1657588697402,MATH 20E,B01,083773,Ciotti; Benjamin,20,0,35,15
1657588697402,MATH 20E,B02,083774,Ciotti; Benjamin,18,0,35,17
1657588703427,MATH 103A,A01,083777,Greenfeld; Be'Eri,3,0,36,33
1657588703427,MATH 103A,A02,083778,Greenfeld; Be'Eri,5,0,36,31
1657588703427,MATH 103A,A03,093561,Greenfeld; Be'Eri,5,0,36,31
1657588703427,MATH 103A,B01,083779,Greenfeld; Be'Eri,7,0,36,29
1657588703427,MATH 103A,B02,083780,Greenfeld; Be'Eri,4,0,36,32
1657588703427,MATH 103A,B03,093562,Greenfeld; Be'Eri,3,0,36,33
1657588709451,MATH 105,A01,085443,Carter; Anne Toulson,15,0,35,20
1657588709451,MATH 105,A02,093477,Carter; Anne Toulson,20,0,35,15
1657588715486,MATH 109,A01,083213,Ganzberger; Geoffrey Michael,2,0,34,32
1657588715486,MATH 109,A02,083214,Ganzberger; Geoffrey Michael,4,0,34,30
1657588715486,MATH 109,A03,093478,Ganzberger; Geoffrey Michael,2,0,34,32
1657588715486,MATH 109,B01,083215,Ganzberger; Geoffrey Michael,1,0,32,31
1657588715486,MATH 109,B02,083216,Ganzberger; Geoffrey Michael,2,0,32,30
1657588715486,MATH 109,B03,093479,Ganzberger; Geoffrey Michael,8,0,32,24
1657588721510,MATH 142A,A01,083219,Chow; Bennett,7,0,32,25
1657588721510,MATH 142A,A02,083220,Chow; Bennett,10,0,32,22
1657588721510,MATH 142A,A03,093480,Chow; Bennett,8,0,32,24
1657588721510,MATH 142A,B03,093481,Chow; Bennett,8,0,32,24
1657588721510,MATH 142A,B04,093558,Chow; Bennett,13,0,32,19
1657588721510,MATH 142A,B05,093559,Chow; Bennett,6,0,32,26
1657588727538,MATH 193A,A01,083224,Rotar; Vladimir,8,0,34,26
1657588727538,MATH 193A,A02,083225,Rotar; Vladimir,9,0,34,25
1657588727538,MATH 193A,A03,083781,Rotar; Vladimir,5,0,34,29
1657588727538,MATH 193A,A04,083782,Rotar; Vladimir,10,0,34,24
1657588727538,MATH 193A,A05,093482,Rotar; Vladimir,10,0,34,24
1657588733561,MATH 197,001,091859,McAuley; Julian John,9999,0,9999,0
1657588733561,MATH 197,002,095566,Kedlaya; Kiran S.,9997,0,9999,2
1657588733561,MATH 197,003,095567,Xiao; Ming,9999,0,9999,0
1657588733561,MATH 197,004,095571,Perols; Johan Lars,9998,0,9999,1
1657588740612,COGS 9,A01,083615,Shannon; Kyle Michael,9,0,75,66
1657588746637,COGS 11,A01,083617,Boyle; Mary E. T.,23,0,48,25
1657588752661,COGS 13,A01,083071,Bastos; Amalia Pinkusfeld,11,0,71,60
1657588758694,COGS 14A,A01,092681,Semenuks; Arturs,5,1,100,95
1657588764716,COGS 14B,A01,083073,Cheng; Tzu-Han,6,0,63,57
1657588770743,COGS 17,A01,092677,Semenuks; Arturs,6,0,81,75
1657588776766,COGS 100,A01,083619,Allen; Michael Gordon,17,0,70,53
1657588782792,COGS 101A,A01,083621,Davis; Joshua Daniel,9,0,68,59
1657588788818,COGS 101B,A01,091572,Allen; Michael Gordon,12,0,65,53
1657588794841,COGS 101C,A01,083625,Delgado; Tania,17,0,35,18
1657588800864,COGS 107A,A01,083627,Boyle; Mary E. T.,13,0,60,47
1657588806887,COGS 118A,A01,083075,Gupta; Anjum,21,0,76,55
1657588812914,CSE 3,A50,083646,Miranda; Gregory Joseph,24,0,50,26
1657588818939,CSE 8A,A50,083650,Miranda; Gregory Joseph,17,1,56,39
1657588824962,CSE 11,A01,083080,Cao; Yingjun,6,15,40,34
1657588830985,CSE 12,A01,083652,Krause-Levy; Sophia Louisa,28,1,120,92
1657588837008,CSE 15L,A01,083654,Morris; Justin Loren,9,0,50,41
1657588837008,CSE 15L,A02,083655,Morris; Justin Loren,9,0,50,41
1657588843031,CSE 20,A01,083657,Tran; Khoa Dang,39,0,80,41
1657588849052,CSE 21,A01,095574,Bach; Quang Tran,22,0,48,26
1657588855076,CSE 30,A01,083084,Eldon; John,5,0,80,75
1657588855076,CSE 30,B01,095061,Bhaskar; Nishant,9,0,50,41
1657588861100,CSE 100,A01,083659,Cao; Yingjun,5,4,70,65
1657588867123,CSE 134B,A01,083661,Powell; Thomas Allan,22,0,100,78
1657588873149,CSE 140,A01,083663,Gungor; Onat,15,0,85,70
1657588879173,CSE 140L,A01,083088,Eldon; John,21,0,100,79
1657588885195,CSE 175,A01,083665,Kumar; Rakesh,3,0,25,22
1657588891223,CSE 190,A00,092507,Dubnov; Shlomo,8,0,20,12
1657588897261,ECE 45,A01,083139,Congero; Spencer William,6,0,75,69
1657588903293,ECE 65,A50,083695,Saad; Andrew S,12,0,30,18
1657588903293,ECE 65,A51,095125,Saad; Andrew S,24,0,26,2
1657588909320,ECE 109,A01,091882,Touri; Behrouz,19,0,70,51
1657588915347,ECE 180,A00,083140,Abi Samra; Nicholas Camill,1,0,30,29
1657588915347,ECE 180,B00,083141,Abi Samra; Nicholas Camill,0,0,30,30
1657588921371,MATH 10A,A01,083735,Patchell; Gregory David,2,0,30,28
1657588921371,MATH 10A,A02,083736,Patchell; Gregory David,20,0,30,10
1657588921371,MATH 10A,A03,083737,Patchell; Gregory David,16,0,30,14
1657588927399,MATH 10B,A01,083207,Lim; Seonhee,8,0,34,26
1657588927399,MATH 10B,A02,083208,Lim; Seonhee,9,0,35,26
1657588927399,MATH 10B,A03,093472,Lim; Seonhee,7,0,34,27
1657588927399,MATH 10B,B01,083739,Sinha; Shubham,12,0,30,18
1657588933422,MATH 18,A01,083743,Cinel; Cameron Alexander,7,0,30,23
1657588933422,MATH 18,A02,083744,Cinel; Cameron Alexander,17,0,30,13
1657588933422,MATH 18,A03,083745,Cinel; Cameron Alexander,9,0,30,21
1657588933422,MATH 18,B01,083748,Rideout; David Porter,5,0,37,32
1657588933422,MATH 18,B02,083749,Rideout; David Porter,5,0,36,31
1657588933422,MATH 18,B03,083750,Rideout; David Porter,3,0,37,34
1657588933422,MATH 18,B04,083751,Rideout; David Porter,6,0,36,30
1657588933422,MATH 18,B05,093473,Rideout; David Porter,6,0,36,30
1657588933422,MATH 18,B06,093474,Rideout; David Porter,6,0,36,30
1657588939445,MATH 20A,A01,083754,Zheng; Zequn,14,0,40,26
1657588945476,MATH 20B,A01,083756,Briones; Jor-el Thomas Caparas,4,0,36,32
1657588945476,MATH 20B,A02,083757,Briones; Jor-el Thomas Caparas,1,0,36,35
1657588945476,MATH 20B,A03,093475,Briones; Jor-el Thomas Caparas,2,0,36,34
1657588951504,MATH 20C,A01,083760,Briones; Jor-el Thomas Caparas,1,0,35,34
1657588951504,MATH 20C,A02,083761,Briones; Jor-el Thomas Caparas,8,0,35,27
1657588951504,MATH 20C,A03,093476,Briones; Jor-el Thomas Caparas,0,1,36,36
1657588951504,MATH 20C,B01,083762,Bach; Quang Tran,1,0,30,29
1657588957529,MATH 20D,A01,083765,Tran; Brian Kha,5,0,30,25
1657588957529,MATH 20D,A02,083766,Tran; Brian Kha,5,0,30,25
1657588957529,MATH 20D,A03,083767,Tran; Brian Kha,5,0,30,25
1657588963553,MATH 20E,A01,083771,Ganguly; Soumya,9,0,32,23
1657588963553,MATH 20E,A02,083772,Ganguly; Soumya,6,0,32,26
1657588963553,MATH 20E,B01,083773,Ciotti; Benjamin,20,0,35,15
1657588963553,MATH 20E,B02,083774,Ciotti; Benjamin,18,0,35,17
1657588969578,MATH 103A,A01,083777,Greenfeld; Be'Eri,3,0,36,33
1657588969578,MATH 103A,A02,083778,Greenfeld; Be'Eri,5,0,36,31
1657588969578,MATH 103A,A03,093561,Greenfeld; Be'Eri,5,0,36,31
1657588969578,MATH 103A,B01,083779,Greenfeld; Be'Eri,7,0,36,29
1657588969578,MATH 103A,B02,083780,Greenfeld; Be'Eri,4,0,36,32
1657588969578,MATH 103A,B03,093562,Greenfeld; Be'Eri,3,0,36,33
1657588975600,MATH 105,A01,085443,Carter; Anne Toulson,15,0,35,20
1657588975600,MATH 105,A02,093477,Carter; Anne Toulson,20,0,35,15
1657588981624,MATH 109,A01,083213,Ganzberger; Geoffrey Michael,2,0,34,32
1657588981624,MATH 109,A02,083214,Ganzberger; Geoffrey Michael,4,0,34,30
1657588981624,MATH 109,A03,093478,Ganzberger; Geoffrey Michael,2,0,34,32
1657588981624,MATH 109,B01,083215,Ganzberger; Geoffrey Michael,1,0,32,31
1657588981624,MATH 109,B02,083216,Ganzberger; Geoffrey Michael,2,0,32,30
1657588981624,MATH 109,B03,093479,Ganzberger; Geoffrey Michael,8,0,32,24
1657588987654,MATH 142A,A01,083219,Chow; Bennett,7,0,32,25
1657588987654,MATH 142A,A02,083220,Chow; Bennett,10,0,32,22
1657588987654,MATH 142A,A03,093480,Chow; Bennett,8,0,32,24
1657588987654,MATH 142A,B03,093481,Chow; Bennett,8,0,32,24
1657588987654,MATH 142A,B04,093558,Chow; Bennett,13,0,32,19
1657588987654,MATH 142A,B05,093559,Chow; Bennett,6,0,32,26
1657588993676,MATH 193A,A01,083224,Rotar; Vladimir,8,0,34,26
1657588993676,MATH 193A,A02,083225,Rotar; Vladimir,9,0,34,25
1657588993676,MATH 193A,A03,083781,Rotar; Vladimir,5,0,34,29
1657588993676,MATH 193A,A04,083782,Rotar; Vladimir,10,0,34,24
1657588993676,MATH 193A,A05,093482,Rotar; Vladimir,10,0,34,24
1657588999701,MATH 197,001,091859,McAuley; Julian John,9999,0,9999,0
1657588999701,MATH 197,002,095566,Kedlaya; Kiran S.,9997,0,9999,2
1657588999701,MATH 197,003,095567,Xiao; Ming,9999,0,9999,0
1657588999701,MATH 197,004,095571,Perols; Johan Lars,9998,0,9999,1
1657589006763,COGS 9,A01,083615,Shannon; Kyle Michael,9,0,75,66
1657589012787,COGS 11,A01,083617,Boyle; Mary E. T.,23,0,48,25
1657589018809,COGS 13,A01,083071,Bastos; Amalia Pinkusfeld,11,0,71,60
1657589024831,COGS 14A,A01,092681,Semenuks; Arturs,5,1,100,95
1657589030861,COGS 14B,A01,083073,Cheng; Tzu-Han,6,0,63,57
1657589036885,COGS 17,A01,092677,Semenuks; Arturs,6,0,81,75
1657589042914,COGS 100,A01,083619,Allen; Michael Gordon,17,0,70,53
1657589048937,COGS 101A,A01,083621,Davis; Joshua Daniel,9,0,68,59
1657589054964,COGS 101B,A01,091572,Allen; Michael Gordon,12,0,65,53
1657589060993,COGS 101C,A01,083625,Delgado; Tania,17,0,35,18
1657589067029,COGS 107A,A01,083627,Boyle; Mary E. T.,13,0,60,47
1657589073057,COGS 118A,A01,083075,Gupta; Anjum,21,0,76,55
1657589079078,CSE 3,A50,083646,Miranda; Gregory Joseph,24,0,50,26
1657589085101,CSE 8A,A50,083650,Miranda; Gregory Joseph,17,1,56,39
1657589091128,CSE 11,A01,083080,Cao; Yingjun,6,15,40,34
1657589097150,CSE 12,A01,083652,Krause-Levy; Sophia Louisa,28,1,120,92
1657589103172,CSE 15L,A01,083654,Morris; Justin Loren,9,0,50,41
1657589103172,CSE 15L,A02,083655,Morris; Justin Loren,9,0,50,41
1657589109197,CSE 20,A01,083657,Tran; Khoa Dang,39,0,80,41
1657589115218,CSE 21,A01,095574,Bach; Quang Tran,22,0,48,26
1657589121240,CSE 30,A01,083084,Eldon; John,5,0,80,75
1657589121240,CSE 30,B01,095061,Bhaskar; Nishant,9,0,50,41
1657589127344,CSE 100,A01,083659,Cao; Yingjun,5,4,70,65
1657589133373,CSE 134B,A01,083661,Powell; Thomas Allan,22,0,100,78
1657589139395,CSE 140,A01,083663,Gungor; Onat,15,0,85,70
1657589145429,CSE 140L,A01,083088,Eldon; John,21,0,100,79
1657589151454,CSE 175,A01,083665,Kumar; Rakesh,3,0,25,22
1657589157487,CSE 190,A00,092507,Dubnov; Shlomo,8,0,20,12
1657589163518,ECE 45,A01,083139,Congero; Spencer William,6,0,75,69
1657589169542,ECE 65,A50,083695,Saad; Andrew S,12,0,30,18
1657589169542,ECE 65,A51,095125,Saad; Andrew S,24,0,26,2
1657589175564,ECE 109,A01,091882,Touri; Behrouz,19,0,70,51
1657589181586,ECE 180,A00,083140,Abi Samra; Nicholas Camill,1,0,30,29
1657589181586,ECE 180,B00,083141,Abi Samra; Nicholas Camill,0,0,30,30
1657589187619,MATH 10A,A01,083735,Patchell; Gregory David,2,0,30,28
1657589187619,MATH 10A,A02,083736,Patchell; Gregory David,20,0,30,10
1657589187619,MATH 10A,A03,083737,Patchell; Gregory David,16,0,30,14
1657589193650,MATH 10B,A01,083207,Lim; Seonhee,8,0,34,26
1657589193650,MATH 10B,A02,083208,Lim; Seonhee,9,0,35,26
1657589193650,MATH 10B,A03,093472,Lim; Seonhee,7,0,34,27
1657589193650,MATH 10B,B01,083739,Sinha; Shubham,12,0,30,18
1657589199674,MATH 18,A01,083743,Cinel; Cameron Alexander,7,0,30,23
1657589199674,MATH 18,A02,083744,Cinel; Cameron Alexander,17,0,30,13
1657589199674,MATH 18,A03,083745,Cinel; Cameron Alexander,9,0,30,21
1657589199674,MATH 18,B01,083748,Rideout; David Porter,5,0,37,32
1657589199674,MATH 18,B02,083749,Rideout; David Porter,5,0,36,31
1657589199674,MATH 18,B03,083750,Rideout; David Porter,3,0,37,34
1657589199674,MATH 18,B04,083751,Rideout; David Porter,6,0,36,30
1657589199674,MATH 18,B05,093473,Rideout; David Porter,6,0,36,30
1657589199674,MATH 18,B06,093474,Rideout; David Porter,6,0,36,30
1657589205700,MATH 20A,A01,083754,Zheng; Zequn,14,0,40,26
1657589211725,MATH 20B,A01,083756,Briones; Jor-el Thomas Caparas,4,0,36,32
1657589211725,MATH 20B,A02,083757,Briones; Jor-el Thomas Caparas,1,0,36,35
1657589211725,MATH 20B,A03,093475,Briones; Jor-el Thomas Caparas,2,0,36,34
1657589217750,MATH 20C,A01,083760,Briones; Jor-el Thomas Caparas,1,0,35,34
1657589217750,MATH 20C,A02,083761,Briones; Jor-el Thomas Caparas,8,0,35,27
1657589217750,MATH 20C,A03,093476,Briones; Jor-el Thomas Caparas,0,1,36,36
1657589217750,MATH 20C,B01,083762,Bach; Quang Tran,1,0,30,29
1657589223774,MATH 20D,A01,083765,Tran; Brian Kha,5,0,30,25
1657589223774,MATH 20D,A02,083766,Tran; Brian Kha,5,0,30,25
1657589223774,MATH 20D,A03,083767,Tran; Brian Kha,5,0,30,25
1657589229801,MATH 20E,A01,083771,Ganguly; Soumya,9,0,32,23
1657589229801,MATH 20E,A02,083772,Ganguly; Soumya,6,0,32,26
1657589229801,MATH 20E,B01,083773,Ciotti; Benjamin,20,0,35,15
1657589229801,MATH 20E,B02,083774,Ciotti; Benjamin,18,0,35,17
1657589235831,MATH 103A,A01,083777,Greenfeld; Be'Eri,3,0,36,33
1657589235831,MATH 103A,A02,083778,Greenfeld; Be'Eri,5,0,36,31
1657589235831,MATH 103A,A03,093561,Greenfeld; Be'Eri,5,0,36,31
1657589235831,MATH 103A,B01,083779,Greenfeld; Be'Eri,7,0,36,29
1657589235831,MATH 103A,B02,083780,Greenfeld; Be'Eri,4,0,36,32
1657589235831,MATH 103A,B03,093562,Greenfeld; Be'Eri,3,0,36,33
1657589241855,MATH 105,A01,085443,Carter; Anne Toulson,15,0,35,20
1657589241855,MATH 105,A02,093477,Carter; Anne Toulson,20,0,35,15
1657589247878,MATH 109,A01,083213,Ganzberger; Geoffrey Michael,2,0,34,32
1657589247878,MATH 109,A02,083214,Ganzberger; Geoffrey Michael,4,0,34,30
1657589247878,MATH 109,A03,093478,Ganzberger; Geoffrey Michael,2,0,34,32
1657589247878,MATH 109,B01,083215,Ganzberger; Geoffrey Michael,1,0,32,31
1657589247878,MATH 109,B02,083216,Ganzberger; Geoffrey Michael,2,0,32,30
1657589247878,MATH 109,B03,093479,Ganzberger; Geoffrey Michael,8,0,32,24
1657589253909,MATH 142A,A01,083219,Chow; Bennett,7,0,32,25
1657589253909,MATH 142A,A02,083220,Chow; Bennett,10,0,32,22
1657589253909,MATH 142A,A03,093480,Chow; Bennett,8,0,32,24
1657589253909,MATH 142A,B03,093481,Chow; Bennett,8,0,32,24
1657589253909,MATH 142A,B04,093558,Chow; Bennett,13,0,32,19
1657589253909,MATH 142A,B05,093559,Chow; Bennett,6,0,32,26
1657589259938,MATH 193A,A01,083224,Rotar; Vladimir,8,0,34,26
1657589259938,MATH 193A,A02,083225,Rotar; Vladimir,9,0,34,25
1657589259938,MATH 193A,A03,083781,Rotar; Vladimir,5,0,34,29
1657589259938,MATH 193A,A04,083782,Rotar; Vladimir,10,0,34,24
1657589259938,MATH 193A,A05,093482,Rotar; Vladimir,10,0,34,24
1657589265966,MATH 197,001,091859,McAuley; Julian John,9999,0,9999,0
1657589265966,MATH 197,002,095566,Kedlaya; Kiran S.,9997,0,9999,2
1657589265966,MATH 197,003,095567,Xiao; Ming,9999,0,9999,0
1657589265966,MATH 197,004,095571,Perols; Johan Lars,9998,0,9999,1
1657589273027,COGS 9,A01,083615,Shannon; Kyle Michael,9,0,75,66
1657589279049,COGS 11,A01,083617,Boyle; Mary E. T.,23,0,48,25
1657589285071,COGS 13,A01,083071,Bastos; Amalia Pinkusfeld,11,0,71,60
1657589291094,COGS 14A,A01,092681,Semenuks; Arturs,5,1,100,95
1657589297119,COGS 14B,A01,083073,Cheng; Tzu-Han,6,0,63,57
1657589303146,COGS 17,A01,092677,Semenuks; Arturs,6,0,81,75
1657589309170,COGS 100,A01,083619,Allen; Michael Gordon,17,0,70,53
1657589315192,COGS 101A,A01,083621,Davis; Joshua Daniel,9,0,68,59
1657589321216,COGS 101B,A01,091572,Allen; Michael Gordon,12,0,65,53
1657589327245,COGS 101C,A01,083625,Delgado; Tania,17,0,35,18
1657589333273,COGS 107A,A01,083627,Boyle; Mary E. T.,13,0,60,47
1657589339294,COGS 118A,A01,083075,Gupta; Anjum,21,0,76,55
1657589345321,CSE 3,A50,083646,Miranda; Gregory Joseph,24,0,50,26
1657589351345,CSE 8A,A50,083650,Miranda; Gregory Joseph,17,1,56,39
1657589357367,CSE 11,A01,083080,Cao; Yingjun,6,15,40,34
1657589363396,CSE 12,A01,083652,Krause-Levy; Sophia Louisa,28,1,120,92
1657589369422,CSE 15L,A01,083654,Morris; Justin Loren,9,0,50,41
1657589369422,CSE 15L,A02,083655,Morris; Justin Loren,9,0,50,41
1657589375446,CSE 20,A01,083657,Tran; Khoa Dang,39,0,80,41
1657589381472,CSE 21,A01,095574,Bach; Quang Tran,22,0,48,26
1657589387501,CSE 30,A01,083084,Eldon; John,5,0,80,75
1657589387501,CSE 30,B01,095061,Bhaskar; Nishant,9,0,50,41
1657589393522,CSE 100,A01,083659,Cao; Yingjun,5,4,70,65
1657589399545,CSE 134B,A01,083661,Powell; Thomas Allan,22,0,100,78
1657589405572,CSE 140,A01,083663,Gungor; Onat,15,0,85,70
1657589411596,CSE 140L,A01,083088,Eldon; John,21,0,100,79
1657589417620,CSE 175,A01,083665,Kumar; Rakesh,3,0,25,22
1657589423655,CSE 190,A00,092507,Dubnov; Shlomo,8,0,20,12
1657589429678,ECE 45,A01,083139,Congero; Spencer William,6,0,75,69
1657589435704,ECE 65,A50,083695,Saad; Andrew S,12,0,30,18
1657589435704,ECE 65,A51,095125,Saad; Andrew S,24,0,26,2
1657589441727,ECE 109,A01,091882,Touri; Behrouz,19,0,70,51
1657589447751,ECE 180,A00,083140,Abi Samra; Nicholas Camill,1,0,30,29
1657589447751,ECE 180,B00,083141,Abi Samra; Nicholas Camill,0,0,30,30
1657589453774,MATH 10A,A01,083735,Patchell; Gregory David,2,0,30,28
1657589453774,MATH 10A,A02,083736,Patchell; Gregory David,20,0,30,10
1657589453774,MATH 10A,A03,083737,Patchell; Gregory David,16,0,30,14
1657589459797,MATH 10B,A01,083207,Lim; Seonhee,8,0,34,26
1657589459797,MATH 10B,A02,083208,Lim; Seonhee,9,0,35,26
1657589459797,MATH 10B,A03,093472,Lim; Seonhee,7,0,34,27
1657589459797,MATH 10B,B01,083739,Sinha; Shubham,12,0,30,18
1657589465822,MATH 18,A01,083743,Cinel; Cameron Alexander,7,0,30,23
1657589465822,MATH 18,A02,083744,Cinel; Cameron Alexander,17,0,30,13
1657589465822,MATH 18,A03,083745,Cinel; Cameron Alexander,9,0,30,21
1657589465822,MATH 18,B01,083748,Rideout; David Porter,5,0,37,32
1657589465822,MATH 18,B02,083749,Rideout; David Porter,5,0,36,31
1657589465822,MATH 18,B03,083750,Rideout; David Porter,3,0,37,34
1657589465822,MATH 18,B04,083751,Rideout; David Porter,6,0,36,30
1657589465822,MATH 18,B05,093473,Rideout; David Porter,6,0,36,30
1657589465822,MATH 18,B06,093474,Rideout; David Porter,6,0,36,30
1657589471850,MATH 20A,A01,083754,Zheng; Zequn,14,0,40,26
1657589477881,MATH 20B,A01,083756,Briones; Jor-el Thomas Caparas,4,0,36,32
1657589477881,MATH 20B,A02,083757,Briones; Jor-el Thomas Caparas,1,0,36,35
1657589477881,MATH 20B,A03,093475,Briones; Jor-el Thomas Caparas,2,0,36,34
1657589483904,MATH 20C,A01,083760,Briones; Jor-el Thomas Caparas,1,0,35,34
1657589483904,MATH 20C,A02,083761,Briones; Jor-el Thomas Caparas,8,0,35,27
1657589483904,MATH 20C,A03,093476,Briones; Jor-el Thomas Caparas,0,1,36,36
1657589483904,MATH 20C,B01,083762,Bach; Quang Tran,1,0,30,29
1657589489927,MATH 20D,A01,083765,Tran; Brian Kha,5,0,30,25
1657589489927,MATH 20D,A02,083766,Tran; Brian Kha,5,0,30,25
1657589489927,MATH 20D,A03,083767,Tran; Brian Kha,5,0,30,25
1657589495956,MATH 20E,A01,083771,Ganguly; Soumya,9,0,32,23
1657589495956,MATH 20E,A02,083772,Ganguly; Soumya,6,0,32,26
1657589495956,MATH 20E,B01,083773,Ciotti; Benjamin,20,0,35,15
1657589495956,MATH 20E,B02,083774,Ciotti; Benjamin,18,0,35,17
1657589501981,MATH 103A,A01,083777,Greenfeld; Be'Eri,3,0,36,33
1657589501981,MATH 103A,A02,083778,Greenfeld; Be'Eri,5,0,36,31
1657589501981,MATH 103A,A03,093561,Greenfeld; Be'Eri,5,0,36,31
1657589501981,MATH 103A,B01,083779,Greenfeld; Be'Eri,7,0,36,29
1657589501981,MATH 103A,B02,083780,Greenfeld; Be'Eri,4,0,36,32
1657589501981,MATH 103A,B03,093562,Greenfeld; Be'Eri,3,0,36,33
1657589508011,MATH 105,A01,085443,Carter; Anne Toulson,15,0,35,20
1657589508011,MATH 105,A02,093477,Carter; Anne Toulson,20,0,35,15
1657589514034,MATH 109,A01,083213,Ganzberger; Geoffrey Michael,2,0,34,32
1657589514034,MATH 109,A02,083214,Ganzberger; Geoffrey Michael,4,0,34,30
1657589514034,MATH 109,A03,093478,Ganzberger; Geoffrey Michael,2,0,34,32
1657589514034,MATH 109,B01,083215,Ganzberger; Geoffrey Michael,1,0,32,31
1657589514034,MATH 109,B02,083216,Ganzberger; Geoffrey Michael,2,0,32,30
1657589514034,MATH 109,B03,093479,Ganzberger; Geoffrey Michael,8,0,32,24
1657589520059,MATH 142A,A01,083219,Chow; Bennett,7,0,32,25
1657589520059,MATH 142A,A02,083220,Chow; Bennett,10,0,32,22
1657589520059,MATH 142A,A03,093480,Chow; Bennett,8,0,32,24
1657589520059,MATH 142A,B03,093481,Chow; Bennett,8,0,32,24
1657589520059,MATH 142A,B04,093558,Chow; Bennett,13,0,32,19
1657589520059,MATH 142A,B05,093559,Chow; Bennett,6,0,32,26
1657589526082,MATH 193A,A01,083224,Rotar; Vladimir,8,0,34,26
1657589526082,MATH 193A,A02,083225,Rotar; Vladimir,9,0,34,25
1657589526082,MATH 193A,A03,083781,Rotar; Vladimir,5,0,34,29
1657589526082,MATH 193A,A04,083782,Rotar; Vladimir,10,0,34,24
1657589526082,MATH 193A,A05,093482,Rotar; Vladimir,10,0,34,24
1657589532109,MATH 197,001,091859,McAuley; Julian John,9999,0,9999,0
1657589532109,MATH 197,002,095566,Kedlaya; Kiran S.,9997,0,9999,2
1657589532109,MATH 197,003,095567,Xiao; Ming,9999,0,9999,0
1657589532109,MATH 197,004,095571,Perols; Johan Lars,9998,0,9999,1
1657589539169,COGS 9,A01,083615,Shannon; Kyle Michael,9,0,75,66
1657589545196,COGS 11,A01,083617,Boyle; Mary E. T.,23,0,48,25
1657589551224,COGS 13,A01,083071,Bastos; Amalia Pinkusfeld,11,0,71,60
1657589557248,COGS 14A,A01,092681,Semenuks; Arturs,5,1,100,95
1657589563272,COGS 14B,A01,083073,Cheng; Tzu-Han,6,0,63,57
1657589569298,COGS 17,A01,092677,Semenuks; Arturs,6,0,81,75
1657589575322,COGS 100,A01,083619,Allen; Michael Gordon,17,0,70,53
1657589581351,COGS 101A,A01,083621,Davis; Joshua Daniel,9,0,68,59
1657589587377,COGS 101B,A01,091572,Allen; Michael Gordon,12,0,65,53
1657589593404,COGS 101C,A01,083625,Delgado; Tania,17,0,35,18
1657589599426,COGS 107A,A01,083627,Boyle; Mary E. T.,13,0,60,47
1657589605450,COGS 118A,A01,083075,Gupta; Anjum,21,0,76,55
1657589611475,CSE 3,A50,083646,Miranda; Gregory Joseph,24,0,50,26
1657589617498,CSE 8A,A50,083650,Miranda; Gregory Joseph,17,1,56,39
1657589623522,CSE 11,A01,083080,Cao; Yingjun,6,15,40,34
1657589629549,CSE 12,A01,083652,Krause-Levy; Sophia Louisa,28,1,120,92
1657589635575,CSE 15L,A01,083654,Morris; Justin Loren,9,0,50,41
1657589635575,CSE 15L,A02,083655,Morris; Justin Loren,9,0,50,41
1657589641598,CSE 20,A01,083657,Tran; Khoa Dang,39,0,80,41
1657589647620,CSE 21,A01,095574,Bach; Quang Tran,22,0,48,26
1657589653645,CSE 30,A01,083084,Eldon; John,5,0,80,75
1657589653645,CSE 30,B01,095061,Bhaskar; Nishant,9,0,50,41
1657589659672,CSE 100,A01,083659,Cao; Yingjun,5,4,70,65
1657589665700,CSE 134B,A01,083661,Powell; Thomas Allan,22,0,100,78
1657589671722,CSE 140,A01,083663,Gungor; Onat,15,0,85,70
1657589677749,CSE 140L,A01,083088,Eldon; John,21,0,100,79
1657589683770,CSE 175,A01,083665,Kumar; Rakesh,3,0,25,22
1657589689793,CSE 190,A00,092507,Dubnov; Shlomo,8,0,20,12
1657589695815,ECE 45,A01,083139,Congero; Spencer William,6,0,75,69
1657589701841,ECE 65,A50,083695,Saad; Andrew S,12,0,30,18
1657589701841,ECE 65,A51,095125,Saad; Andrew S,24,0,26,2
1657589707864,ECE 109,A01,091882,Touri; Behrouz,19,0,70,51
1657589713888,ECE 180,A00,083140,Abi Samra; Nicholas Camill,1,0,30,29
1657589713888,ECE 180,B00,083141,Abi Samra; Nicholas Camill,0,0,30,30
1657589719917,MATH 10A,A01,083735,Patchell; Gregory David,2,0,30,28
1657589719917,MATH 10A,A02,083736,Patchell; Gregory David,20,0,30,10
1657589719917,MATH 10A,A03,083737,Patchell; Gregory David,16,0,30,14
1657589726021,MATH 10B,A01,083207,Lim; Seonhee,8,0,34,26
1657589726021,MATH 10B,A02,083208,Lim; Seonhee,9,0,35,26
1657589726021,MATH 10B,A03,093472,Lim; Seonhee,7,0,34,27
1657589726021,MATH 10B,B01,083739,Sinha; Shubham,12,0,30,18
1657589732060,MATH 18,A01,083743,Cinel; Cameron Alexander,7,0,30,23
1657589732060,MATH 18,A02,083744,Cinel; Cameron Alexander,17,0,30,13
1657589732060,MATH 18,A03,083745,Cinel; Cameron Alexander,9,0,30,21
1657589732060,MATH 18,B01,083748,Rideout; David Porter,5,0,37,32
1657589732060,MATH 18,B02,083749,Rideout; David Porter,5,0,36,31
1657589732060,MATH 18,B03,083750,Rideout; David Porter,3,0,37,34
1657589732060,MATH 18,B04,083751,Rideout; David Porter,6,0,36,30
1657589732060,MATH 18,B05,093473,Rideout; David Porter,6,0,36,30
1657589732060,MATH 18,B06,093474,Rideout; David Porter,6,0,36,30
1657589738093,MATH 20A,A01,083754,Zheng; Zequn,14,0,40,26
1657589744121,MATH 20B,A01,083756,Briones; Jor-el Thomas Caparas,4,0,36,32
1657589744121,MATH 20B,A02,083757,Briones; Jor-el Thomas Caparas,1,0,36,35
1657589744121,MATH 20B,A03,093475,Briones; Jor-el Thomas Caparas,2,0,36,34
1657589750150,MATH 20C,A01,083760,Briones; Jor-el Thomas Caparas,1,0,35,34
1657589750150,MATH 20C,A02,083761,Briones; Jor-el Thomas Caparas,8,0,35,27
1657589750150,MATH 20C,A03,093476,Briones; Jor-el Thomas Caparas,0,1,36,36
1657589750150,MATH 20C,B01,083762,Bach; Quang Tran,1,0,30,29
1657589756174,MATH 20D,A01,083765,Tran; Brian Kha,5,0,30,25
1657589756174,MATH 20D,A02,083766,Tran; Brian Kha,5,0,30,25
1657589756174,MATH 20D,A03,083767,Tran; Brian Kha,5,0,30,25
1657589762197,MATH 20E,A01,083771,Ganguly; Soumya,9,0,32,23
1657589762197,MATH 20E,A02,083772,Ganguly; Soumya,6,0,32,26
1657589762197,MATH 20E,B01,083773,Ciotti; Benjamin,20,0,35,15
1657589762197,MATH 20E,B02,083774,Ciotti; Benjamin,18,0,35,17
1657589768220,MATH 103A,A01,083777,Greenfeld; Be'Eri,3,0,36,33
1657589768220,MATH 103A,A02,083778,Greenfeld; Be'Eri,5,0,36,31
1657589768220,MATH 103A,A03,093561,Greenfeld; Be'Eri,5,0,36,31
1657589768220,MATH 103A,B01,083779,Greenfeld; Be'Eri,7,0,36,29
1657589768220,MATH 103A,B02,083780,Greenfeld; Be'Eri,4,0,36,32
1657589768220,MATH 103A,B03,093562,Greenfeld; Be'Eri,3,0,36,33
1657589774246,MATH 105,A01,085443,Carter; Anne Toulson,15,0,35,20
1657589774246,MATH 105,A02,093477,Carter; Anne Toulson,20,0,35,15
1657589780268,MATH 109,A01,083213,Ganzberger; Geoffrey Michael,2,0,34,32
1657589780268,MATH 109,A02,083214,Ganzberger; Geoffrey Michael,4,0,34,30
1657589780268,MATH 109,A03,093478,Ganzberger; Geoffrey Michael,2,0,34,32
1657589780268,MATH 109,B01,083215,Ganzberger; Geoffrey Michael,1,0,32,31
1657589780268,MATH 109,B02,083216,Ganzberger; Geoffrey Michael,2,0,32,30
1657589780268,MATH 109,B03,093479,Ganzberger; Geoffrey Michael,8,0,32,24
1657589786298,MATH 142A,A01,083219,Chow; Bennett,7,0,32,25
1657589786298,MATH 142A,A02,083220,Chow; Bennett,10,0,32,22
1657589786298,MATH 142A,A03,093480,Chow; Bennett,8,0,32,24
1657589786298,MATH 142A,B03,093481,Chow; Bennett,8,0,32,24
1657589786298,MATH 142A,B04,093558,Chow; Bennett,13,0,32,19
1657589786298,MATH 142A,B05,093559,Chow; Bennett,6,0,32,26
1657589792326,MATH 193A,A01,083224,Rotar; Vladimir,8,0,34,26
1657589792326,MATH 193A,A02,083225,Rotar; Vladimir,9,0,34,25
1657589792326,MATH 193A,A03,083781,Rotar; Vladimir,5,0,34,29
1657589792326,MATH 193A,A04,083782,Rotar; Vladimir,10,0,34,24
1657589792326,MATH 193A,A05,093482,Rotar; Vladimir,10,0,34,24
1657589798347,MATH 197,001,091859,McAuley; Julian John,9999,0,9999,0
1657589798347,MATH 197,002,095566,Kedlaya; Kiran S.,9997,0,9999,2
1657589798347,MATH 197,003,095567,Xiao; Ming,9999,0,9999,0
1657589798347,MATH 197,004,095571,Perols; Johan Lars,9998,0,9999,1
1657589805398,COGS 9,A01,083615,Shannon; Kyle Michael,9,0,75,66
1657589811420,COGS 11,A01,083617,Boyle; Mary E. T.,23,0,48,25
1657589817443,COGS 13,A01,083071,Bastos; Amalia Pinkusfeld,11,0,71,60
1657589823466,COGS 14A,A01,092681,Semenuks; Arturs,5,1,100,95
1657589829497,COGS 14B,A01,083073,Cheng; Tzu-Han,6,0,63,57
1657589835520,COGS 17,A01,092677,Semenuks; Arturs,6,0,81,75
1657589841544,COGS 100,A01,083619,Allen; Michael Gordon,17,0,70,53
1657589847571,COGS 101A,A01,083621,Davis; Joshua Daniel,9,0,68,59
1657589853598,COGS 101B,A01,091572,Allen; Michael Gordon,12,0,65,53
1657589859623,COGS 101C,A01,083625,Delgado; Tania,17,0,35,18
1657589865645,COGS 107A,A01,083627,Boyle; Mary E. T.,13,0,60,47
1657589871671,COGS 118A,A01,083075,Gupta; Anjum,21,0,76,55
1657589877698,CSE 3,A50,083646,Miranda; Gregory Joseph,24,0,50,26
1657589883725,CSE 8A,A50,083650,Miranda; Gregory Joseph,17,1,56,39
1657589889752,CSE 11,A01,083080,Cao; Yingjun,6,15,40,34
1657589895773,CSE 12,A01,083652,Krause-Levy; Sophia Louisa,28,1,120,92
1657589901799,CSE 15L,A01,083654,Morris; Justin Loren,9,0,50,41
1657589901799,CSE 15L,A02,083655,Morris; Justin Loren,9,0,50,41
1657589907822,CSE 20,A01,083657,Tran; Khoa Dang,39,0,80,41
1657589913847,CSE 21,A01,095574,Bach; Quang Tran,22,0,48,26
1657589919873,CSE 30,A01,083084,Eldon; John,5,0,80,75
1657589919873,CSE 30,B01,095061,Bhaskar; Nishant,9,0,50,41
1657589925897,CSE 100,A01,083659,Cao; Yingjun,5,4,70,65
1657589931922,CSE 134B,A01,083661,Powell; Thomas Allan,22,0,100,78
1657589937950,CSE 140,A01,083663,Gungor; Onat,15,0,85,70
1657589943976,CSE 140L,A01,083088,Eldon; John,21,0,100,79
1657589949999,CSE 175,A01,083665,Kumar; Rakesh,3,0,25,22
1657589956022,CSE 190,A00,092507,Dubnov; Shlomo,8,0,20,12
1657589962045,ECE 45,A01,083139,Congero; Spencer William,6,0,75,69
1657589968069,ECE 65,A50,083695,Saad; Andrew S,12,0,30,18
1657589968069,ECE 65,A51,095125,Saad; Andrew S,24,0,26,2
1657589974095,ECE 109,A01,091882,Touri; Behrouz,19,0,70,51
1657589980118,ECE 180,A00,083140,Abi Samra; Nicholas Camill,1,0,30,29
1657589980118,ECE 180,B00,083141,Abi Samra; Nicholas Camill,0,0,30,30
1657589986145,MATH 10A,A01,083735,Patchell; Gregory David,2,0,30,28
1657589986145,MATH 10A,A02,083736,Patchell; Gregory David,20,0,30,10
1657589986145,MATH 10A,A03,083737,Patchell; Gregory David,16,0,30,14
1657589992174,MATH 10B,A01,083207,Lim; Seonhee,8,0,34,26
1657589992174,MATH 10B,A02,083208,Lim; Seonhee,9,0,35,26
1657589992174,MATH 10B,A03,093472,Lim; Seonhee,7,0,34,27
1657589992174,MATH 10B,B01,083739,Sinha; Shubham,12,0,30,18
1657589998200,MATH 18,A01,083743,Cinel; Cameron Alexander,7,0,30,23
1657589998200,MATH 18,A02,083744,Cinel; Cameron Alexander,17,0,30,13
1657589998200,MATH 18,A03,083745,Cinel; Cameron Alexander,9,0,30,21
1657589998200,MATH 18,B01,083748,Rideout; David Porter,5,0,37,32
1657589998200,MATH 18,B02,083749,Rideout; David Porter,5,0,36,31
1657589998200,MATH 18,B03,083750,Rideout; David Porter,3,0,37,34
1657589998200,MATH 18,B04,083751,Rideout; David Porter,6,0,36,30
1657589998200,MATH 18,B05,093473,Rideout; David Porter,6,0,36,30
1657589998200,MATH 18,B06,093474,Rideout; David Porter,6,0,36,30
1657590004221,MATH 20A,A01,083754,Zheng; Zequn,14,0,40,26
1657590010248,MATH 20B,A01,083756,Briones; Jor-el Thomas Caparas,4,0,36,32
1657590010248,MATH 20B,A02,083757,Briones; Jor-el Thomas Caparas,1,0,36,35
1657590010248,MATH 20B,A03,093475,Briones; Jor-el Thomas Caparas,2,0,36,34
1657590016279,MATH 20C,A01,083760,Briones; Jor-el Thomas Caparas,1,0,35,34
1657590016279,MATH 20C,A02,083761,Briones; Jor-el Thomas Caparas,8,0,35,27
1657590016279,MATH 20C,A03,093476,Briones; Jor-el Thomas Caparas,0,1,36,36
1657590016279,MATH 20C,B01,083762,Bach; Quang Tran,1,0,30,29
1657590022306,MATH 20D,A01,083765,Tran; Brian Kha,5,0,30,25
1657590022306,MATH 20D,A02,083766,Tran; Brian Kha,5,0,30,25
1657590022306,MATH 20D,A03,083767,Tran; Brian Kha,5,0,30,25
1657590028328,MATH 20E,A01,083771,Ganguly; Soumya,9,0,32,23
1657590028328,MATH 20E,A02,083772,Ganguly; Soumya,6,0,32,26
1657590028328,MATH 20E,B01,083773,Ciotti; Benjamin,20,0,35,15
1657590028328,MATH 20E,B02,083774,Ciotti; Benjamin,18,0,35,17
1657590034353,MATH 103A,A01,083777,Greenfeld; Be'Eri,3,0,36,33
1657590034353,MATH 103A,A02,083778,Greenfeld; Be'Eri,5,0,36,31
1657590034353,MATH 103A,A03,093561,Greenfeld; Be'Eri,5,0,36,31
1657590034353,MATH 103A,B01,083779,Greenfeld; Be'Eri,7,0,36,29
1657590034353,MATH 103A,B02,083780,Greenfeld; Be'Eri,4,0,36,32
1657590034353,MATH 103A,B03,093562,Greenfeld; Be'Eri,3,0,36,33
1657590040376,MATH 105,A01,085443,Carter; Anne Toulson,15,0,35,20
1657590040376,MATH 105,A02,093477,Carter; Anne Toulson,20,0,35,15
1657590046406,MATH 109,A01,083213,Ganzberger; Geoffrey Michael,2,0,34,32
1657590046406,MATH 109,A02,083214,Ganzberger; Geoffrey Michael,4,0,34,30
1657590046406,MATH 109,A03,093478,Ganzberger; Geoffrey Michael,2,0,34,32
1657590046406,MATH 109,B01,083215,Ganzberger; Geoffrey Michael,1,0,32,31
1657590046406,MATH 109,B02,083216,Ganzberger; Geoffrey Michael,2,0,32,30
1657590046406,MATH 109,B03,093479,Ganzberger; Geoffrey Michael,8,0,32,24
1657590052435,MATH 142A,A01,083219,Chow; Bennett,7,0,32,25
1657590052435,MATH 142A,A02,083220,Chow; Bennett,10,0,32,22
1657590052435,MATH 142A,A03,093480,Chow; Bennett,8,0,32,24
1657590052435,MATH 142A,B03,093481,Chow; Bennett,8,0,32,24
1657590052435,MATH 142A,B04,093558,Chow; Bennett,13,0,32,19
1657590052435,MATH 142A,B05,093559,Chow; Bennett,6,0,32,26
1657590058463,MATH 193A,A01,083224,Rotar; Vladimir,8,0,34,26
1657590058463,MATH 193A,A02,083225,Rotar; Vladimir,9,0,34,25
1657590058463,MATH 193A,A03,083781,Rotar; Vladimir,5,0,34,29
1657590058463,MATH 193A,A04,083782,Rotar; Vladimir,10,0,34,24
1657590058463,MATH 193A,A05,093482,Rotar; Vladimir,10,0,34,24
1657590064485,MATH 197,001,091859,McAuley; Julian John,9999,0,9999,0
1657590064485,MATH 197,002,095566,Kedlaya; Kiran S.,9997,0,9999,2
1657590064485,MATH 197,003,095567,Xiao; Ming,9999,0,9999,0
1657590064485,MATH 197,004,095571,Perols; Johan Lars,9998,0,9999,1
1657590071537,COGS 9,A01,083615,Shannon; Kyle Michael,9,0,75,66
1657590077559,COGS 11,A01,083617,Boyle; Mary E. T.,23,0,48,25
1657590083582,COGS 13,A01,083071,Bastos; Amalia Pinkusfeld,11,0,71,60
1657590089608,COGS 14A,A01,092681,Semenuks; Arturs,5,1,100,95
1657590095639,COGS 14B,A01,083073,Cheng; Tzu-Han,6,0,63,57
1657590101665,COGS 17,A01,092677,Semenuks; Arturs,6,0,81,75
1657590107698,COGS 100,A01,083619,Allen; Michael Gordon,17,0,70,53
1657590113721,COGS 101A,A01,083621,Davis; Joshua Daniel,9,0,68,59
1657590119741,COGS 101B,A01,091572,Allen; Michael Gordon,12,0,65,53
1657590125768,COGS 101C,A01,083625,Delgado; Tania,17,0,35,18
1657590131790,COGS 107A,A01,083627,Boyle; Mary E. T.,13,0,60,47
1657590137818,COGS 118A,A01,083075,Gupta; Anjum,21,0,76,55
1657590143852,CSE 3,A50,083646,Miranda; Gregory Joseph,24,0,50,26
1657590149875,CSE 8A,A50,083650,Miranda; Gregory Joseph,17,1,56,39
1657590155900,CSE 11,A01,083080,Cao; Yingjun,6,15,40,34
1657590161923,CSE 12,A01,083652,Krause-Levy; Sophia Louisa,28,1,120,92
1657590167949,CSE 15L,A01,083654,Morris; Justin Loren,9,0,50,41
1657590167949,CSE 15L,A02,083655,Morris; Justin Loren,9,0,50,41
1657590173972,CSE 20,A01,083657,Tran; Khoa Dang,39,0,80,41
1657590180006,CSE 21,A01,095574,Bach; Quang Tran,22,0,48,26
1657590186039,CSE 30,A01,083084,Eldon; John,5,0,80,75
1657590186039,CSE 30,B01,095061,Bhaskar; Nishant,9,0,50,41
1657590192061,CSE 100,A01,083659,Cao; Yingjun,5,4,70,65
1657590198086,CSE 134B,A01,083661,Powell; Thomas Allan,22,0,100,78
1657590204118,CSE 140,A01,083663,Gungor; Onat,15,0,85,70
1657590210145,CSE 140L,A01,083088,Eldon; John,21,0,100,79
1657590216172,CSE 175,A01,083665,Kumar; Rakesh,3,0,25,22
1657590222199,CSE 190,A00,092507,Dubnov; Shlomo,8,0,20,12
1657590228221,ECE 45,A01,083139,Congero; Spencer William,6,0,75,69
1657590234247,ECE 65,A50,083695,Saad; Andrew S,12,0,30,18
1657590234247,ECE 65,A51,095125,Saad; Andrew S,24,0,26,2
1657590240281,ECE 109,A01,091882,Touri; Behrouz,19,0,70,51
1657590246306,ECE 180,A00,083140,Abi Samra; Nicholas Camill,1,0,30,29
1657590246306,ECE 180,B00,083141,Abi Samra; Nicholas Camill,0,0,30,30
1657590252333,MATH 10A,A01,083735,Patchell; Gregory David,2,0,30,28
1657590252333,MATH 10A,A02,083736,Patchell; Gregory David,20,0,30,10
1657590252333,MATH 10A,A03,083737,Patchell; Gregory David,16,0,30,14
1657590258358,MATH 10B,A01,083207,Lim; Seonhee,8,0,34,26
1657590258358,MATH 10B,A02,083208,Lim; Seonhee,9,0,35,26
1657590258358,MATH 10B,A03,093472,Lim; Seonhee,7,0,34,27
1657590258358,MATH 10B,B01,083739,Sinha; Shubham,12,0,30,18
1657590264383,MATH 18,A01,083743,Cinel; Cameron Alexander,7,0,30,23
1657590264383,MATH 18,A02,083744,Cinel; Cameron Alexander,17,0,30,13
1657590264383,MATH 18,A03,083745,Cinel; Cameron Alexander,9,0,30,21
1657590264383,MATH 18,B01,083748,Rideout; David Porter,5,0,37,32
1657590264383,MATH 18,B02,083749,Rideout; David Porter,5,0,36,31
1657590264383,MATH 18,B03,083750,Rideout; David Porter,3,0,37,34
1657590264383,MATH 18,B04,083751,Rideout; David Porter,6,0,36,30
1657590264383,MATH 18,B05,093473,Rideout; David Porter,6,0,36,30
1657590264383,MATH 18,B06,093474,Rideout; David Porter,6,0,36,30
1657590270408,MATH 20A,A01,083754,Zheng; Zequn,14,0,40,26
1657590276431,MATH 20B,A01,083756,Briones; Jor-el Thomas Caparas,4,0,36,32
1657590276431,MATH 20B,A02,083757,Briones; Jor-el Thomas Caparas,1,0,36,35
1657590276431,MATH 20B,A03,093475,Briones; Jor-el Thomas Caparas,2,0,36,34
1657590282459,MATH 20C,A01,083760,Briones; Jor-el Thomas Caparas,1,0,35,34
1657590282459,MATH 20C,A02,083761,Briones; Jor-el Thomas Caparas,8,0,35,27
1657590282459,MATH 20C,A03,093476,Briones; Jor-el Thomas Caparas,0,1,36,36
1657590282459,MATH 20C,B01,083762,Bach; Quang Tran,1,0,30,29
1657590288482,MATH 20D,A01,083765,Tran; Brian Kha,5,0,30,25
1657590288482,MATH 20D,A02,083766,Tran; Brian Kha,5,0,30,25
1657590288482,MATH 20D,A03,083767,Tran; Brian Kha,5,0,30,25
1657590294505,MATH 20E,A01,083771,Ganguly; Soumya,9,0,32,23
1657590294505,MATH 20E,A02,083772,Ganguly; Soumya,6,0,32,26
1657590294505,MATH 20E,B01,083773,Ciotti; Benjamin,20,0,35,15
1657590294505,MATH 20E,B02,083774,Ciotti; Benjamin,18,0,35,17
1657590300534,MATH 103A,A01,083777,Greenfeld; Be'Eri,3,0,36,33
1657590300534,MATH 103A,A02,083778,Greenfeld; Be'Eri,5,0,36,31
1657590300534,MATH 103A,A03,093561,Greenfeld; Be'Eri,5,0,36,31
1657590300534,MATH 103A,B01,083779,Greenfeld; Be'Eri,7,0,36,29
1657590300534,MATH 103A,B02,083780,Greenfeld; Be'Eri,4,0,36,32
1657590300534,MATH 103A,B03,093562,Greenfeld; Be'Eri,3,0,36,33
1657590306560,MATH 105,A01,085443,Carter; Anne Toulson,15,0,35,20
1657590306560,MATH 105,A02,093477,Carter; Anne Toulson,20,0,35,15
1657590312589,MATH 109,A01,083213,Ganzberger; Geoffrey Michael,2,0,34,32
1657590312589,MATH 109,A02,083214,Ganzberger; Geoffrey Michael,4,0,34,30
1657590312589,MATH 109,A03,093478,Ganzberger; Geoffrey Michael,2,0,34,32
1657590312589,MATH 109,B01,083215,Ganzberger; Geoffrey Michael,1,0,32,31
1657590312589,MATH 109,B02,083216,Ganzberger; Geoffrey Michael,2,0,32,30
1657590312589,MATH 109,B03,093479,Ganzberger; Geoffrey Michael,8,0,32,24
1657590318612,MATH 142A,A01,083219,Chow; Bennett,7,0,32,25
1657590318612,MATH 142A,A02,083220,Chow; Bennett,10,0,32,22
1657590318612,MATH 142A,A03,093480,Chow; Bennett,8,0,32,24
1657590318612,MATH 142A,B03,093481,Chow; Bennett,8,0,32,24
1657590318612,MATH 142A,B04,093558,Chow; Bennett,13,0,32,19
1657590318612,MATH 142A,B05,093559,Chow; Bennett,6,0,32,26
1657590324711,MATH 193A,A01,083224,Rotar; Vladimir,8,0,34,26
1657590324711,MATH 193A,A02,083225,Rotar; Vladimir,9,0,34,25
1657590324711,MATH 193A,A03,083781,Rotar; Vladimir,5,0,34,29
1657590324711,MATH 193A,A04,083782,Rotar; Vladimir,10,0,34,24
1657590324711,MATH 193A,A05,093482,Rotar; Vladimir,10,0,34,24
1657590330742,MATH 197,001,091859,McAuley; Julian John,9999,0,9999,0
1657590330742,MATH 197,002,095566,Kedlaya; Kiran S.,9997,0,9999,2
1657590330742,MATH 197,003,095567,Xiao; Ming,9999,0,9999,0
1657590330742,MATH 197,004,095571,Perols; Johan Lars,9998,0,9999,1
1657590337803,COGS 9,A01,083615,Shannon; Kyle Michael,9,0,75,66
1657590343825,COGS 11,A01,083617,Boyle; Mary E. T.,23,0,48,25
1657590349851,COGS 13,A01,083071,Bastos; Amalia Pinkusfeld,11,0,71,60
1657590355876,COGS 14A,A01,092681,Semenuks; Arturs,5,1,100,95
1657590361897,COGS 14B,A01,083073,Cheng; Tzu-Han,6,0,63,57
1657590367920,COGS 17,A01,092677,Semenuks; Arturs,6,0,81,75
1657590373945,COGS 100,A01,083619,Allen; Michael Gordon,17,0,70,53
1657590379969,COGS 101A,A01,083621,Davis; Joshua Daniel,9,0,68,59
1657590385991,COGS 101B,A01,091572,Allen; Michael Gordon,12,0,65,53
1657590392014,COGS 101C,A01,083625,Delgado; Tania,17,0,35,18
1657590398037,COGS 107A,A01,083627,Boyle; Mary E. T.,13,0,60,47
1657590404059,COGS 118A,A01,083075,Gupta; Anjum,21,0,76,55
1657590410083,CSE 3,A50,083646,Miranda; Gregory Joseph,24,0,50,26
1657590416112,CSE 8A,A50,083650,Miranda; Gregory Joseph,17,1,56,39
1657590422134,CSE 11,A01,083080,Cao; Yingjun,6,15,40,34
1657590428160,CSE 12,A01,083652,Krause-Levy; Sophia Louisa,28,1,120,92
1657590434184,CSE 15L,A01,083654,Morris; Justin Loren,9,0,50,41
1657590434184,CSE 15L,A02,083655,Morris; Justin Loren,9,0,50,41
1657590440207,CSE 20,A01,083657,Tran; Khoa Dang,39,0,80,41
1657590446235,CSE 21,A01,095574,Bach; Quang Tran,22,0,48,26
1657590452261,CSE 30,A01,083084,Eldon; John,5,0,80,75
1657590452261,CSE 30,B01,095061,Bhaskar; Nishant,9,0,50,41
1657590458297,CSE 100,A01,083659,Cao; Yingjun,5,4,70,65
1657590464320,CSE 134B,A01,083661,Powell; Thomas Allan,22,0,100,78
1657590470346,CSE 140,A01,083663,Gungor; Onat,15,0,85,70
1657590476369,CSE 140L,A01,083088,Eldon; John,21,0,100,79
1657590482398,CSE 175,A01,083665,Kumar; Rakesh,3,0,25,22
1657590488419,CSE 190,A00,092507,Dubnov; Shlomo,8,0,20,12
1657590494442,ECE 45,A01,083139,Congero; Spencer William,6,0,75,69
1657590500469,ECE 65,A50,083695,Saad; Andrew S,12,0,30,18
1657590500469,ECE 65,A51,095125,Saad; Andrew S,24,0,26,2
1657590506494,ECE 109,A01,091882,Touri; Behrouz,19,0,70,51
1657590512524,ECE 180,A00,083140,Abi Samra; Nicholas Camill,1,0,30,29
1657590512524,ECE 180,B00,083141,Abi Samra; Nicholas Camill,0,0,30,30
1657590518548,MATH 10A,A01,083735,Patchell; Gregory David,2,0,30,28
1657590518548,MATH 10A,A02,083736,Patchell; Gregory David,20,0,30,10
1657590518548,MATH 10A,A03,083737,Patchell; Gregory David,16,0,30,14
1657590524572,MATH 10B,A01,083207,Lim; Seonhee,8,0,34,26
1657590524572,MATH 10B,A02,083208,Lim; Seonhee,9,0,35,26
1657590524572,MATH 10B,A03,093472,Lim; Seonhee,7,0,34,27
1657590524572,MATH 10B,B01,083739,Sinha; Shubham,12,0,30,18
1657590530603,MATH 18,A01,083743,Cinel; Cameron Alexander,7,0,30,23
1657590530603,MATH 18,A02,083744,Cinel; Cameron Alexander,17,0,30,13
1657590530603,MATH 18,A03,083745,Cinel; Cameron Alexander,9,0,30,21
1657590530603,MATH 18,B01,083748,Rideout; David Porter,5,0,37,32
1657590530603,MATH 18,B02,083749,Rideout; David Porter,5,0,36,31
1657590530603,MATH 18,B03,083750,Rideout; David Porter,3,0,37,34
1657590530603,MATH 18,B04,083751,Rideout; David Porter,6,0,36,30
1657590530603,MATH 18,B05,093473,Rideout; David Porter,6,0,36,30
1657590530603,MATH 18,B06,093474,Rideout; David Porter,6,0,36,30
1657590536629,MATH 20A,A01,083754,Zheng; Zequn,14,0,40,26
1657590542656,MATH 20B,A01,083756,Briones; Jor-el Thomas Caparas,4,0,36,32
1657590542656,MATH 20B,A02,083757,Briones; Jor-el Thomas Caparas,1,0,36,35
1657590542656,MATH 20B,A03,093475,Briones; Jor-el Thomas Caparas,2,0,36,34
1657590548684,MATH 20C,A01,083760,Briones; Jor-el Thomas Caparas,1,0,35,34
1657590548684,MATH 20C,A02,083761,Briones; Jor-el Thomas Caparas,8,0,35,27
1657590548684,MATH 20C,A03,093476,Briones; Jor-el Thomas Caparas,0,1,36,36
1657590548684,MATH 20C,B01,083762,Bach; Quang Tran,1,0,30,29
1657590554718,MATH 20D,A01,083765,Tran; Brian Kha,5,0,30,25
1657590554718,MATH 20D,A02,083766,Tran; Brian Kha,5,0,30,25
1657590554718,MATH 20D,A03,083767,Tran; Brian Kha,5,0,30,25
1657590560747,MATH 20E,A01,083771,Ganguly; Soumya,9,0,32,23
1657590560747,MATH 20E,A02,083772,Ganguly; Soumya,6,0,32,26
1657590560747,MATH 20E,B01,083773,Ciotti; Benjamin,20,0,35,15
1657590560747,MATH 20E,B02,083774,Ciotti; Benjamin,18,0,35,17
1657590566774,MATH 103A,A01,083777,Greenfeld; Be'Eri,3,0,36,33
1657590566774,MATH 103A,A02,083778,Greenfeld; Be'Eri,5,0,36,31
1657590566774,MATH 103A,A03,093561,Greenfeld; Be'Eri,5,0,36,31
1657590566774,MATH 103A,B01,083779,Greenfeld; Be'Eri,7,0,36,29
1657590566774,MATH 103A,B02,083780,Greenfeld; Be'Eri,4,0,36,32
1657590566774,MATH 103A,B03,093562,Greenfeld; Be'Eri,3,0,36,33
1657590572797,MATH 105,A01,085443,Carter; Anne Toulson,15,0,35,20
1657590572797,MATH 105,A02,093477,Carter; Anne Toulson,20,0,35,15
1657590578820,MATH 109,A01,083213,Ganzberger; Geoffrey Michael,2,0,34,32
1657590578820,MATH 109,A02,083214,Ganzberger; Geoffrey Michael,4,0,34,30
1657590578820,MATH 109,A03,093478,Ganzberger; Geoffrey Michael,2,0,34,32
1657590578820,MATH 109,B01,083215,Ganzberger; Geoffrey Michael,1,0,32,31
1657590578820,MATH 109,B02,083216,Ganzberger; Geoffrey Michael,2,0,32,30
1657590578820,MATH 109,B03,093479,Ganzberger; Geoffrey Michael,8,0,32,24
1657590584848,MATH 142A,A01,083219,Chow; Bennett,7,0,32,25
1657590584848,MATH 142A,A02,083220,Chow; Bennett,10,0,32,22
1657590584848,MATH 142A,A03,093480,Chow; Bennett,8,0,32,24
1657590584848,MATH 142A,B03,093481,Chow; Bennett,8,0,32,24
1657590584848,MATH 142A,B04,093558,Chow; Bennett,13,0,32,19
1657590584848,MATH 142A,B05,093559,Chow; Bennett,6,0,32,26
1657590590871,MATH 193A,A01,083224,Rotar; Vladimir,8,0,34,26
1657590590871,MATH 193A,A02,083225,Rotar; Vladimir,9,0,34,25
1657590590871,MATH 193A,A03,083781,Rotar; Vladimir,5,0,34,29
1657590590871,MATH 193A,A04,083782,Rotar; Vladimir,10,0,34,24
1657590590871,MATH 193A,A05,093482,Rotar; Vladimir,10,0,34,24
1657590596897,MATH 197,001,091859,McAuley; Julian John,9999,0,9999,0
1657590596897,MATH 197,002,095566,Kedlaya; Kiran S.,9997,0,9999,2
1657590596897,MATH 197,003,095567,Xiao; Ming,9999,0,9999,0
1657590596897,MATH 197,004,095571,Perols; Johan Lars,9998,0,9999,1
1657590603952,COGS 9,A01,083615,Shannon; Kyle Michael,9,0,75,66
1657590609974,COGS 11,A01,083617,Boyle; Mary E. T.,23,0,48,25
1657590616000,COGS 13,A01,083071,Bastos; Amalia Pinkusfeld,11,0,71,60
1657590622038,COGS 14A,A01,092681,Semenuks; Arturs,5,1,100,95
1657590628062,COGS 14B,A01,083073,Cheng; Tzu-Han,6,0,63,57
1657590634086,COGS 17,A01,092677,Semenuks; Arturs,6,0,81,75
1657590640113,COGS 100,A01,083619,Allen; Michael Gordon,17,0,70,53
1657590646140,COGS 101A,A01,083621,Davis; Joshua Daniel,9,0,68,59
1657590652163,COGS 101B,A01,091572,Allen; Michael Gordon,12,0,65,53
1657590658185,COGS 101C,A01,083625,Delgado; Tania,17,0,35,18
1657590664212,COGS 107A,A01,083627,Boyle; Mary E. T.,13,0,60,47
1657590670239,COGS 118A,A01,083075,Gupta; Anjum,21,0,76,55
1657590676274,CSE 3,A50,083646,Miranda; Gregory Joseph,24,0,50,26
1657590682300,CSE 8A,A50,083650,Miranda; Gregory Joseph,17,1,56,39
1657590688328,CSE 11,A01,083080,Cao; Yingjun,6,15,40,34
1657590694351,CSE 12,A01,083652,Krause-Levy; Sophia Louisa,28,1,120,92
1657590700374,CSE 15L,A01,083654,Morris; Justin Loren,9,0,50,41
1657590700374,CSE 15L,A02,083655,Morris; Justin Loren,9,0,50,41
1657590706397,CSE 20,A01,083657,Tran; Khoa Dang,39,0,80,41
1657590712419,CSE 21,A01,095574,Bach; Quang Tran,22,0,48,26
1657590718448,CSE 30,A01,083084,Eldon; John,5,0,80,75
1657590718448,CSE 30,B01,095061,Bhaskar; Nishant,9,0,50,41
1657590724475,CSE 100,A01,083659,Cao; Yingjun,5,4,70,65
1657590730502,CSE 134B,A01,083661,Powell; Thomas Allan,22,0,100,78
1657590736529,CSE 140,A01,083663,Gungor; Onat,15,0,85,70
1657590742551,CSE 140L,A01,083088,Eldon; John,21,0,100,79
1657590748577,CSE 175,A01,083665,Kumar; Rakesh,3,0,25,22
1657590754601,CSE 190,A00,092507,Dubnov; Shlomo,8,0,20,12
1657590760627,ECE 45,A01,083139,Congero; Spencer William,6,0,75,69
1657590766660,ECE 65,A50,083695,Saad; Andrew S,12,0,30,18
1657590766660,ECE 65,A51,095125,Saad; Andrew S,24,0,26,2
1657590772685,ECE 109,A01,091882,Touri; Behrouz,19,0,70,51
1657590778708,ECE 180,A00,083140,Abi Samra; Nicholas Camill,1,0,30,29
1657590778708,ECE 180,B00,083141,Abi Samra; Nicholas Camill,0,0,30,30
1657590784736,MATH 10A,A01,083735,Patchell; Gregory David,2,0,30,28
1657590784736,MATH 10A,A02,083736,Patchell; Gregory David,20,0,30,10
1657590784736,MATH 10A,A03,083737,Patchell; Gregory David,16,0,30,14
1657590790758,MATH 10B,A01,083207,Lim; Seonhee,8,0,34,26
1657590790758,MATH 10B,A02,083208,Lim; Seonhee,9,0,35,26
1657590790758,MATH 10B,A03,093472,Lim; Seonhee,7,0,34,27
1657590790758,MATH 10B,B01,083739,Sinha; Shubham,12,0,30,18
1657590796787,MATH 18,A01,083743,Cinel; Cameron Alexander,7,0,30,23
1657590796787,MATH 18,A02,083744,Cinel; Cameron Alexander,17,0,30,13
1657590796787,MATH 18,A03,083745,Cinel; Cameron Alexander,9,0,30,21
1657590796787,MATH 18,B01,083748,Rideout; David Porter,5,0,37,32
1657590796787,MATH 18,B02,083749,Rideout; David Porter,5,0,36,31
1657590796787,MATH 18,B03,083750,Rideout; David Porter,3,0,37,34
1657590796787,MATH 18,B04,083751,Rideout; David Porter,6,0,36,30
1657590796787,MATH 18,B05,093473,Rideout; David Porter,6,0,36,30
1657590796787,MATH 18,B06,093474,Rideout; David Porter,6,0,36,30
1657590802811,MATH 20A,A01,083754,Zheng; Zequn,14,0,40,26
1657590808834,MATH 20B,A01,083756,Briones; Jor-el Thomas Caparas,4,0,36,32
1657590808834,MATH 20B,A02,083757,Briones; Jor-el Thomas Caparas,1,0,36,35
1657590808834,MATH 20B,A03,093475,Briones; Jor-el Thomas Caparas,2,0,36,34
1657590814857,MATH 20C,A01,083760,Briones; Jor-el Thomas Caparas,1,0,35,34
1657590814857,MATH 20C,A02,083761,Briones; Jor-el Thomas Caparas,8,0,35,27
1657590814857,MATH 20C,A03,093476,Briones; Jor-el Thomas Caparas,0,1,36,36
1657590814857,MATH 20C,B01,083762,Bach; Quang Tran,1,0,30,29
1657590820885,MATH 20D,A01,083765,Tran; Brian Kha,5,0,30,25
1657590820885,MATH 20D,A02,083766,Tran; Brian Kha,5,0,30,25
1657590820885,MATH 20D,A03,083767,Tran; Brian Kha,5,0,30,25
1657590826913,MATH 20E,A01,083771,Ganguly; Soumya,9,0,32,23
1657590826913,MATH 20E,A02,083772,Ganguly; Soumya,6,0,32,26
1657590826913,MATH 20E,B01,083773,Ciotti; Benjamin,20,0,35,15
1657590826913,MATH 20E,B02,083774,Ciotti; Benjamin,18,0,35,17
1657590832937,MATH 103A,A01,083777,Greenfeld; Be'Eri,3,0,36,33
1657590832937,MATH 103A,A02,083778,Greenfeld; Be'Eri,5,0,36,31
1657590832937,MATH 103A,A03,093561,Greenfeld; Be'Eri,5,0,36,31
1657590832937,MATH 103A,B01,083779,Greenfeld; Be'Eri,7,0,36,29
1657590832937,MATH 103A,B02,083780,Greenfeld; Be'Eri,4,0,36,32
1657590832937,MATH 103A,B03,093562,Greenfeld; Be'Eri,3,0,36,33
1657590838964,MATH 105,A01,085443,Carter; Anne Toulson,15,0,35,20
1657590838964,MATH 105,A02,093477,Carter; Anne Toulson,20,0,35,15
1657590844996,MATH 109,A01,083213,Ganzberger; Geoffrey Michael,2,0,34,32
1657590844996,MATH 109,A02,083214,Ganzberger; Geoffrey Michael,4,0,34,30
1657590844996,MATH 109,A03,093478,Ganzberger; Geoffrey Michael,2,0,34,32
1657590844996,MATH 109,B01,083215,Ganzberger; Geoffrey Michael,1,0,32,31
1657590844996,MATH 109,B02,083216,Ganzberger; Geoffrey Michael,2,0,32,30
1657590844996,MATH 109,B03,093479,Ganzberger; Geoffrey Michael,8,0,32,24
1657590851036,MATH 142A,A01,083219,Chow; Bennett,7,0,32,25
1657590851036,MATH 142A,A02,083220,Chow; Bennett,10,0,32,22
1657590851036,MATH 142A,A03,093480,Chow; Bennett,8,0,32,24
1657590851036,MATH 142A,B03,093481,Chow; Bennett,8,0,32,24
1657590851036,MATH 142A,B04,093558,Chow; Bennett,13,0,32,19
1657590851036,MATH 142A,B05,093559,Chow; Bennett,6,0,32,26
1657590857061,MATH 193A,A01,083224,Rotar; Vladimir,8,0,34,26
1657590857061,MATH 193A,A02,083225,Rotar; Vladimir,9,0,34,25
1657590857061,MATH 193A,A03,083781,Rotar; Vladimir,5,0,34,29
1657590857061,MATH 193A,A04,083782,Rotar; Vladimir,10,0,34,24
1657590857061,MATH 193A,A05,093482,Rotar; Vladimir,10,0,34,24
1657590863086,MATH 197,001,091859,McAuley; Julian John,9999,0,9999,0
1657590863086,MATH 197,002,095566,Kedlaya; Kiran S.,9997,0,9999,2
1657590863086,MATH 197,003,095567,Xiao; Ming,9999,0,9999,0
1657590863086,MATH 197,004,095571,Perols; Johan Lars,9998,0,9999,1
1657590870137,COGS 9,A01,083615,Shannon; Kyle Michael,9,0,75,66
1657590876160,COGS 11,A01,083617,Boyle; Mary E. T.,23,0,48,25
1657590882183,COGS 13,A01,083071,Bastos; Amalia Pinkusfeld,11,0,71,60
1657590888214,COGS 14A,A01,092681,Semenuks; Arturs,5,1,100,95
1657590894237,COGS 14B,A01,083073,Cheng; Tzu-Han,6,0,63,57
1657590900260,COGS 17,A01,092677,Semenuks; Arturs,6,0,81,75
1657590906282,COGS 100,A01,083619,Allen; Michael Gordon,17,0,70,53
1657590912307,COGS 101A,A01,083621,Davis; Joshua Daniel,9,0,68,59
1657590918409,COGS 101B,A01,091572,Allen; Michael Gordon,12,0,65,53
1657590924436,COGS 101C,A01,083625,Delgado; Tania,17,0,35,18
1657590930458,COGS 107A,A01,083627,Boyle; Mary E. T.,13,0,60,47
1657590936483,COGS 118A,A01,083075,Gupta; Anjum,21,0,76,55
1657590942510,CSE 3,A50,083646,Miranda; Gregory Joseph,24,0,50,26
1657590948537,CSE 8A,A50,083650,Miranda; Gregory Joseph,17,1,56,39
1657590954565,CSE 11,A01,083080,Cao; Yingjun,6,15,40,34
1657590960590,CSE 12,A01,083652,Krause-Levy; Sophia Louisa,28,1,120,92
1657590966618,CSE 15L,A01,083654,Morris; Justin Loren,9,0,50,41
1657590966618,CSE 15L,A02,083655,Morris; Justin Loren,9,0,50,41
1657590972642,CSE 20,A01,083657,Tran; Khoa Dang,39,0,80,41
1657590978668,CSE 21,A01,095574,Bach; Quang Tran,22,0,48,26
1657590984692,CSE 30,A01,083084,Eldon; John,5,0,80,75
1657590984692,CSE 30,B01,095061,Bhaskar; Nishant,9,0,50,41
1657590990719,CSE 100,A01,083659,Cao; Yingjun,5,4,70,65
1657590996743,CSE 134B,A01,083661,Powell; Thomas Allan,22,0,100,78
1657591002769,CSE 140,A01,083663,Gungor; Onat,15,0,85,70
1657591008791,CSE 140L,A01,083088,Eldon; John,21,0,100,79
1657591014815,CSE 175,A01,083665,Kumar; Rakesh,3,0,25,22
1657591020842,CSE 190,A00,092507,Dubnov; Shlomo,8,0,20,12
1657591026885,ECE 45,A01,083139,Congero; Spencer William,6,0,75,69
1657591032909,ECE 65,A50,083695,Saad; Andrew S,12,0,30,18
1657591032909,ECE 65,A51,095125,Saad; Andrew S,24,0,26,2
1657591038931,ECE 109,A01,091882,Touri; Behrouz,19,0,70,51
1657591044960,ECE 180,A00,083140,Abi Samra; Nicholas Camill,1,0,30,29
1657591044960,ECE 180,B00,083141,Abi Samra; Nicholas Camill,0,0,30,30
1657591050983,MATH 10A,A01,083735,Patchell; Gregory David,2,0,30,28
1657591050983,MATH 10A,A02,083736,Patchell; Gregory David,20,0,30,10
1657591050983,MATH 10A,A03,083737,Patchell; Gregory David,16,0,30,14
1657591057011,MATH 10B,A01,083207,Lim; Seonhee,8,0,34,26
1657591057011,MATH 10B,A02,083208,Lim; Seonhee,9,0,35,26
1657591057011,MATH 10B,A03,093472,Lim; Seonhee,7,0,34,27
1657591057011,MATH 10B,B01,083739,Sinha; Shubham,12,0,30,18
1657591063044,MATH 18,A01,083743,Cinel; Cameron Alexander,7,0,30,23
1657591063044,MATH 18,A02,083744,Cinel; Cameron Alexander,17,0,30,13
1657591063044,MATH 18,A03,083745,Cinel; Cameron Alexander,9,0,30,21
1657591063044,MATH 18,B01,083748,Rideout; David Porter,5,0,37,32
1657591063044,MATH 18,B02,083749,Rideout; David Porter,5,0,36,31
1657591063044,MATH 18,B03,083750,Rideout; David Porter,3,0,37,34
1657591063044,MATH 18,B04,083751,Rideout; David Porter,6,0,36,30
1657591063044,MATH 18,B05,093473,Rideout; David Porter,6,0,36,30
1657591063044,MATH 18,B06,093474,Rideout; David Porter,6,0,36,30
1657591069067,MATH 20A,A01,083754,Zheng; Zequn,14,0,40,26
1657591075090,MATH 20B,A01,083756,Briones; Jor-el Thomas Caparas,4,0,36,32
1657591075090,MATH 20B,A02,083757,Briones; Jor-el Thomas Caparas,1,0,36,35
1657591075090,MATH 20B,A03,093475,Briones; Jor-el Thomas Caparas,2,0,36,34
1657591081125,MATH 20C,A01,083760,Briones; Jor-el Thomas Caparas,1,0,35,34
1657591081125,MATH 20C,A02,083761,Briones; Jor-el Thomas Caparas,8,0,35,27
1657591081125,MATH 20C,A03,093476,Briones; Jor-el Thomas Caparas,0,1,36,36
1657591081125,MATH 20C,B01,083762,Bach; Quang Tran,1,0,30,29
1657591087150,MATH 20D,A01,083765,Tran; Brian Kha,5,0,30,25
1657591087150,MATH 20D,A02,083766,Tran; Brian Kha,5,0,30,25
1657591087150,MATH 20D,A03,083767,Tran; Brian Kha,5,0,30,25
1657591093172,MATH 20E,A01,083771,Ganguly; Soumya,9,0,32,23
1657591093172,MATH 20E,A02,083772,Ganguly; Soumya,6,0,32,26
1657591093172,MATH 20E,B01,083773,Ciotti; Benjamin,20,0,35,15
1657591093172,MATH 20E,B02,083774,Ciotti; Benjamin,18,0,35,17
1657591099196,MATH 103A,A01,083777,Greenfeld; Be'Eri,3,0,36,33
1657591099196,MATH 103A,A02,083778,Greenfeld; Be'Eri,5,0,36,31
1657591099196,MATH 103A,A03,093561,Greenfeld; Be'Eri,5,0,36,31
1657591099196,MATH 103A,B01,083779,Greenfeld; Be'Eri,7,0,36,29
1657591099196,MATH 103A,B02,083780,Greenfeld; Be'Eri,4,0,36,32
1657591099196,MATH 103A,B03,093562,Greenfeld; Be'Eri,3,0,36,33
1657591105221,MATH 105,A01,085443,Carter; Anne Toulson,15,0,35,20
1657591105221,MATH 105,A02,093477,Carter; Anne Toulson,20,0,35,15
1657591111246,MATH 109,A01,083213,Ganzberger; Geoffrey Michael,2,0,34,32
1657591111246,MATH 109,A02,083214,Ganzberger; Geoffrey Michael,4,0,34,30
1657591111246,MATH 109,A03,093478,Ganzberger; Geoffrey Michael,2,0,34,32
1657591111246,MATH 109,B01,083215,Ganzberger; Geoffrey Michael,1,0,32,31
1657591111246,MATH 109,B02,083216,Ganzberger; Geoffrey Michael,2,0,32,30
1657591111246,MATH 109,B03,093479,Ganzberger; Geoffrey Michael,8,0,32,24
1657591117277,MATH 142A,A01,083219,Chow; Bennett,7,0,32,25
1657591117277,MATH 142A,A02,083220,Chow; Bennett,10,0,32,22
1657591117277,MATH 142A,A03,093480,Chow; Bennett,8,0,32,24
1657591117277,MATH 142A,B03,093481,Chow; Bennett,8,0,32,24
1657591117277,MATH 142A,B04,093558,Chow; Bennett,13,0,32,19
1657591117277,MATH 142A,B05,093559,Chow; Bennett,6,0,32,26
1657591123300,MATH 193A,A01,083224,Rotar; Vladimir,8,0,34,26
1657591123300,MATH 193A,A02,083225,Rotar; Vladimir,9,0,34,25
1657591123300,MATH 193A,A03,083781,Rotar; Vladimir,5,0,34,29
1657591123300,MATH 193A,A04,083782,Rotar; Vladimir,10,0,34,24
1657591123300,MATH 193A,A05,093482,Rotar; Vladimir,10,0,34,24
1657591129322,MATH 197,001,091859,McAuley; Julian John,9999,0,9999,0
1657591129322,MATH 197,002,095566,Kedlaya; Kiran S.,9997,0,9999,2
1657591129322,MATH 197,003,095567,Xiao; Ming,9999,0,9999,0
1657591129322,MATH 197,004,095571,Perols; Johan Lars,9998,0,9999,1
1657591136383,COGS 9,A01,083615,Shannon; Kyle Michael,9,0,75,66
1657591142414,COGS 11,A01,083617,Boyle; Mary E. T.,23,0,48,25
1657591148444,COGS 13,A01,083071,Bastos; Amalia Pinkusfeld,11,0,71,60
1657591154466,COGS 14A,A01,092681,Semenuks; Arturs,5,1,100,95
1657591160491,COGS 14B,A01,083073,Cheng; Tzu-Han,6,0,63,57
1657591166514,COGS 17,A01,092677,Semenuks; Arturs,6,0,81,75
1657591172542,COGS 100,A01,083619,Allen; Michael Gordon,17,0,70,53
1657591178564,COGS 101A,A01,083621,Davis; Joshua Daniel,9,0,68,59
1657591184590,COGS 101B,A01,091572,Allen; Michael Gordon,12,0,65,53
1657591190616,COGS 101C,A01,083625,Delgado; Tania,17,0,35,18
1657591196647,COGS 107A,A01,083627,Boyle; Mary E. T.,13,0,60,47
1657591202670,COGS 118A,A01,083075,Gupta; Anjum,21,0,76,55
1657591208704,CSE 3,A50,083646,Miranda; Gregory Joseph,24,0,50,26
1657591214730,CSE 8A,A50,083650,Miranda; Gregory Joseph,17,1,56,39
1657591220758,CSE 11,A01,083080,Cao; Yingjun,6,15,40,34
1657591226784,CSE 12,A01,083652,Krause-Levy; Sophia Louisa,28,1,120,92
1657591232811,CSE 15L,A01,083654,Morris; Justin Loren,9,0,50,41
1657591232811,CSE 15L,A02,083655,Morris; Justin Loren,9,0,50,41
1657591238835,CSE 20,A01,083657,Tran; Khoa Dang,39,0,80,41
1657591244858,CSE 21,A01,095574,Bach; Quang Tran,22,0,48,26
1657591250890,CSE 30,A01,083084,Eldon; John,5,0,80,75
1657591250890,CSE 30,B01,095061,Bhaskar; Nishant,9,0,50,41
1657591256916,CSE 100,A01,083659,Cao; Yingjun,5,4,70,65
1657591262939,CSE 134B,A01,083661,Powell; Thomas Allan,22,0,100,78
1657591268971,CSE 140,A01,083663,Gungor; Onat,15,0,85,70
1657591274998,CSE 140L,A01,083088,Eldon; John,21,0,100,79
1657591281025,CSE 175,A01,083665,Kumar; Rakesh,3,0,25,22
1657591287051,CSE 190,A00,092507,Dubnov; Shlomo,8,0,20,12
1657591293091,ECE 45,A01,083139,Congero; Spencer William,6,0,75,69
1657591299119,ECE 65,A50,083695,Saad; Andrew S,12,0,30,18
1657591299119,ECE 65,A51,095125,Saad; Andrew S,24,0,26,2
1657591305141,ECE 109,A01,091882,Touri; Behrouz,19,0,70,51
1657591311166,ECE 180,A00,083140,Abi Samra; Nicholas Camill,1,0,30,29
1657591311166,ECE 180,B00,083141,Abi Samra; Nicholas Camill,0,0,30,30
1657591317193,MATH 10A,A01,083735,Patchell; Gregory David,2,0,30,28
1657591317193,MATH 10A,A02,083736,Patchell; Gregory David,20,0,30,10
1657591317193,MATH 10A,A03,083737,Patchell; Gregory David,16,0,30,14
1657591323223,MATH 10B,A01,083207,Lim; Seonhee,8,0,34,26
1657591323223,MATH 10B,A02,083208,Lim; Seonhee,9,0,35,26
1657591323223,MATH 10B,A03,093472,Lim; Seonhee,7,0,34,27
1657591323223,MATH 10B,B01,083739,Sinha; Shubham,12,0,30,18
1657591329253,MATH 18,A01,083743,Cinel; Cameron Alexander,7,0,30,23
1657591329253,MATH 18,A02,083744,Cinel; Cameron Alexander,17,0,30,13
1657591329253,MATH 18,A03,083745,Cinel; Cameron Alexander,9,0,30,21
1657591329253,MATH 18,B01,083748,Rideout; David Porter,5,0,37,32
1657591329253,MATH 18,B02,083749,Rideout; David Porter,5,0,36,31
1657591329253,MATH 18,B03,083750,Rideout; David Porter,3,0,37,34
1657591329253,MATH 18,B04,083751,Rideout; David Porter,6,0,36,30
1657591329253,MATH 18,B05,093473,Rideout; David Porter,6,0,36,30
1657591329253,MATH 18,B06,093474,Rideout; David Porter,6,0,36,30
1657591335280,MATH 20A,A01,083754,Zheng; Zequn,14,0,40,26
1657591341305,MATH 20B,A01,083756,Briones; Jor-el Thomas Caparas,4,0,36,32
1657591341305,MATH 20B,A02,083757,Briones; Jor-el Thomas Caparas,1,0,36,35
1657591341305,MATH 20B,A03,093475,Briones; Jor-el Thomas Caparas,2,0,36,34
1657591347332,MATH 20C,A01,083760,Briones; Jor-el Thomas Caparas,1,0,35,34
1657591347332,MATH 20C,A02,083761,Briones; Jor-el Thomas Caparas,8,0,35,27
1657591347332,MATH 20C,A03,093476,Briones; Jor-el Thomas Caparas,0,1,36,36
1657591347332,MATH 20C,B01,083762,Bach; Quang Tran,1,0,30,29
1657591353365,MATH 20D,A01,083765,Tran; Brian Kha,5,0,30,25
1657591353365,MATH 20D,A02,083766,Tran; Brian Kha,5,0,30,25
1657591353365,MATH 20D,A03,083767,Tran; Brian Kha,5,0,30,25
1657591359397,MATH 20E,A01,083771,Ganguly; Soumya,9,0,32,23
1657591359397,MATH 20E,A02,083772,Ganguly; Soumya,6,0,32,26
1657591359397,MATH 20E,B01,083773,Ciotti; Benjamin,20,0,35,15
1657591359397,MATH 20E,B02,083774,Ciotti; Benjamin,18,0,35,17
1657591365421,MATH 103A,A01,083777,Greenfeld; Be'Eri,3,0,36,33
1657591365421,MATH 103A,A02,083778,Greenfeld; Be'Eri,5,0,36,31
1657591365421,MATH 103A,A03,093561,Greenfeld; Be'Eri,5,0,36,31
1657591365421,MATH 103A,B01,083779,Greenfeld; Be'Eri,7,0,36,29
1657591365421,MATH 103A,B02,083780,Greenfeld; Be'Eri,4,0,36,32
1657591365421,MATH 103A,B03,093562,Greenfeld; Be'Eri,3,0,36,33
1657591371448,MATH 105,A01,085443,Carter; Anne Toulson,15,0,35,20
1657591371448,MATH 105,A02,093477,Carter; Anne Toulson,20,0,35,15
1657591377470,MATH 109,A01,083213,Ganzberger; Geoffrey Michael,2,0,34,32
1657591377470,MATH 109,A02,083214,Ganzberger; Geoffrey Michael,4,0,34,30
1657591377470,MATH 109,A03,093478,Ganzberger; Geoffrey Michael,2,0,34,32
1657591377470,MATH 109,B01,083215,Ganzberger; Geoffrey Michael,1,0,32,31
1657591377470,MATH 109,B02,083216,Ganzberger; Geoffrey Michael,2,0,32,30
1657591377470,MATH 109,B03,093479,Ganzberger; Geoffrey Michael,8,0,32,24
1657591383509,MATH 142A,A01,083219,Chow; Bennett,7,0,32,25
1657591383509,MATH 142A,A02,083220,Chow; Bennett,10,0,32,22
1657591383509,MATH 142A,A03,093480,Chow; Bennett,8,0,32,24
1657591383509,MATH 142A,B03,093481,Chow; Bennett,8,0,32,24
1657591383509,MATH 142A,B04,093558,Chow; Bennett,13,0,32,19
1657591383509,MATH 142A,B05,093559,Chow; Bennett,6,0,32,26
1657591389537,MATH 193A,A01,083224,Rotar; Vladimir,8,0,34,26
1657591389537,MATH 193A,A02,083225,Rotar; Vladimir,9,0,34,25
1657591389537,MATH 193A,A03,083781,Rotar; Vladimir,5,0,34,29
1657591389537,MATH 193A,A04,083782,Rotar; Vladimir,10,0,34,24
1657591389537,MATH 193A,A05,093482,Rotar; Vladimir,10,0,34,24
1657591395562,MATH 197,001,091859,McAuley; Julian John,9999,0,9999,0
1657591395562,MATH 197,002,095566,Kedlaya; Kiran S.,9997,0,9999,2
1657591395562,MATH 197,003,095567,Xiao; Ming,9999,0,9999,0
1657591395562,MATH 197,004,095571,Perols; Johan Lars,9998,0,9999,1
1657591402629,COGS 9,A01,083615,Shannon; Kyle Michael,9,0,75,66
1657591408653,COGS 11,A01,083617,Boyle; Mary E. T.,23,0,48,25
1657591414680,COGS 13,A01,083071,Bastos; Amalia Pinkusfeld,11,0,71,60
1657591420702,COGS 14A,A01,092681,Semenuks; Arturs,5,1,100,95
1657591426726,COGS 14B,A01,083073,Cheng; Tzu-Han,6,0,63,57
1657591432747,COGS 17,A01,092677,Semenuks; Arturs,6,0,81,75
1657591438770,COGS 100,A01,083619,Allen; Michael Gordon,17,0,70,53
1657591444791,COGS 101A,A01,083621,Davis; Joshua Daniel,9,0,68,59
1657591450813,COGS 101B,A01,091572,Allen; Michael Gordon,12,0,65,53
1657591456836,COGS 101C,A01,083625,Delgado; Tania,17,0,35,18
1657591462862,COGS 107A,A01,083627,Boyle; Mary E. T.,13,0,60,47
1657591468888,COGS 118A,A01,083075,Gupta; Anjum,21,0,76,55
1657591474911,CSE 3,A50,083646,Miranda; Gregory Joseph,24,0,50,26
1657591480934,CSE 8A,A50,083650,Miranda; Gregory Joseph,17,1,56,39
1657591486957,CSE 11,A01,083080,Cao; Yingjun,6,15,40,34
1657591492980,CSE 12,A01,083652,Krause-Levy; Sophia Louisa,28,1,120,92
1657591499004,CSE 15L,A01,083654,Morris; Justin Loren,9,0,50,41
1657591499004,CSE 15L,A02,083655,Morris; Justin Loren,9,0,50,41
1657591505029,CSE 20,A01,083657,Tran; Khoa Dang,39,0,80,41
1657591511052,CSE 21,A01,095574,Bach; Quang Tran,22,0,48,26
1657591517161,CSE 30,A01,083084,Eldon; John,5,0,80,75
1657591517161,CSE 30,B01,095061,Bhaskar; Nishant,9,0,50,41
1657591523188,CSE 100,A01,083659,Cao; Yingjun,5,4,70,65
1657591529209,CSE 134B,A01,083661,Powell; Thomas Allan,22,0,100,78
1657591535236,CSE 140,A01,083663,Gungor; Onat,15,0,85,70
1657591541258,CSE 140L,A01,083088,Eldon; John,21,0,100,79
1657591547294,CSE 175,A01,083665,Kumar; Rakesh,3,0,25,22
1657591553317,CSE 190,A00,092507,Dubnov; Shlomo,8,0,20,12
1657591559344,ECE 45,A01,083139,Congero; Spencer William,6,0,75,69
1657591565380,ECE 65,A50,083695,Saad; Andrew S,12,0,30,18
1657591565380,ECE 65,A51,095125,Saad; Andrew S,24,0,26,2
1657591571409,ECE 109,A01,091882,Touri; Behrouz,19,0,70,51
1657591577438,ECE 180,A00,083140,Abi Samra; Nicholas Camill,1,0,30,29
1657591577438,ECE 180,B00,083141,Abi Samra; Nicholas Camill,0,0,30,30
1657591583465,MATH 10A,A01,083735,Patchell; Gregory David,2,0,30,28
1657591583465,MATH 10A,A02,083736,Patchell; Gregory David,20,0,30,10
1657591583465,MATH 10A,A03,083737,Patchell; Gregory David,16,0,30,14
1657591589489,MATH 10B,A01,083207,Lim; Seonhee,8,0,34,26
1657591589489,MATH 10B,A02,083208,Lim; Seonhee,9,0,35,26
1657591589489,MATH 10B,A03,093472,Lim; Seonhee,7,0,34,27
1657591589489,MATH 10B,B01,083739,Sinha; Shubham,12,0,30,18
1657591595511,MATH 18,A01,083743,Cinel; Cameron Alexander,7,0,30,23
1657591595511,MATH 18,A02,083744,Cinel; Cameron Alexander,17,0,30,13
1657591595511,MATH 18,A03,083745,Cinel; Cameron Alexander,9,0,30,21
1657591595511,MATH 18,B01,083748,Rideout; David Porter,5,0,37,32
1657591595511,MATH 18,B02,083749,Rideout; David Porter,5,0,36,31
1657591595511,MATH 18,B03,083750,Rideout; David Porter,3,0,37,34
1657591595511,MATH 18,B04,083751,Rideout; David Porter,6,0,36,30
1657591595511,MATH 18,B05,093473,Rideout; David Porter,6,0,36,30
1657591595511,MATH 18,B06,093474,Rideout; David Porter,6,0,36,30
1657591601536,MATH 20A,A01,083754,Zheng; Zequn,14,0,40,26
1657591607559,MATH 20B,A01,083756,Briones; Jor-el Thomas Caparas,4,0,36,32
1657591607559,MATH 20B,A02,083757,Briones; Jor-el Thomas Caparas,1,0,36,35
1657591607559,MATH 20B,A03,093475,Briones; Jor-el Thomas Caparas,2,0,36,34
1657591613585,MATH 20C,A01,083760,Briones; Jor-el Thomas Caparas,1,0,35,34
1657591613585,MATH 20C,A02,083761,Briones; Jor-el Thomas Caparas,8,0,35,27
1657591613585,MATH 20C,A03,093476,Briones; Jor-el Thomas Caparas,0,1,36,36
1657591613585,MATH 20C,B01,083762,Bach; Quang Tran,1,0,30,29
1657591619609,MATH 20D,A01,083765,Tran; Brian Kha,5,0,30,25
1657591619609,MATH 20D,A02,083766,Tran; Brian Kha,5,0,30,25
1657591619609,MATH 20D,A03,083767,Tran; Brian Kha,5,0,30,25
1657591625632,MATH 20E,A01,083771,Ganguly; Soumya,9,0,32,23
1657591625632,MATH 20E,A02,083772,Ganguly; Soumya,6,0,32,26
1657591625632,MATH 20E,B01,083773,Ciotti; Benjamin,20,0,35,15
1657591625632,MATH 20E,B02,083774,Ciotti; Benjamin,18,0,35,17
1657591631660,MATH 103A,A01,083777,Greenfeld; Be'Eri,3,0,36,33
1657591631660,MATH 103A,A02,083778,Greenfeld; Be'Eri,5,0,36,31
1657591631660,MATH 103A,A03,093561,Greenfeld; Be'Eri,5,0,36,31
1657591631660,MATH 103A,B01,083779,Greenfeld; Be'Eri,7,0,36,29
1657591631660,MATH 103A,B02,083780,Greenfeld; Be'Eri,4,0,36,32
1657591631660,MATH 103A,B03,093562,Greenfeld; Be'Eri,3,0,36,33
1657591637683,MATH 105,A01,085443,Carter; Anne Toulson,15,0,35,20
1657591637683,MATH 105,A02,093477,Carter; Anne Toulson,20,0,35,15
1657591643707,MATH 109,A01,083213,Ganzberger; Geoffrey Michael,2,0,34,32
1657591643707,MATH 109,A02,083214,Ganzberger; Geoffrey Michael,4,0,34,30
1657591643707,MATH 109,A03,093478,Ganzberger; Geoffrey Michael,2,0,34,32
1657591643707,MATH 109,B01,083215,Ganzberger; Geoffrey Michael,1,0,32,31
1657591643707,MATH 109,B02,083216,Ganzberger; Geoffrey Michael,2,0,32,30
1657591643707,MATH 109,B03,093479,Ganzberger; Geoffrey Michael,8,0,32,24
1657591649732,MATH 142A,A01,083219,Chow; Bennett,7,0,32,25
1657591649732,MATH 142A,A02,083220,Chow; Bennett,10,0,32,22
1657591649732,MATH 142A,A03,093480,Chow; Bennett,8,0,32,24
1657591649732,MATH 142A,B03,093481,Chow; Bennett,8,0,32,24
1657591649732,MATH 142A,B04,093558,Chow; Bennett,13,0,32,19
1657591649732,MATH 142A,B05,093559,Chow; Bennett,6,0,32,26
1657591655760,MATH 193A,A01,083224,Rotar; Vladimir,8,0,34,26
1657591655760,MATH 193A,A02,083225,Rotar; Vladimir,9,0,34,25
1657591655760,MATH 193A,A03,083781,Rotar; Vladimir,5,0,34,29
1657591655760,MATH 193A,A04,083782,Rotar; Vladimir,10,0,34,24
1657591655760,MATH 193A,A05,093482,Rotar; Vladimir,10,0,34,24
1657591661784,MATH 197,001,091859,McAuley; Julian John,9999,0,9999,0
1657591661784,MATH 197,002,095566,Kedlaya; Kiran S.,9997,0,9999,2
1657591661784,MATH 197,003,095567,Xiao; Ming,9999,0,9999,0
1657591661784,MATH 197,004,095571,Perols; Johan Lars,9998,0,9999,1
1657591668847,COGS 9,A01,083615,Shannon; Kyle Michael,9,0,75,66
1657591674887,COGS 11,A01,083617,Boyle; Mary E. T.,23,0,48,25
1657591680911,COGS 13,A01,083071,Bastos; Amalia Pinkusfeld,11,0,71,60
1657591686936,COGS 14A,A01,092681,Semenuks; Arturs,5,1,100,95
1657591692961,COGS 14B,A01,083073,Cheng; Tzu-Han,6,0,63,57
1657591698983,COGS 17,A01,092677,Semenuks; Arturs,6,0,81,75
1657591705007,COGS 100,A01,083619,Allen; Michael Gordon,17,0,70,53
1657591711029,COGS 101A,A01,083621,Davis; Joshua Daniel,9,0,68,59
1657591717053,COGS 101B,A01,091572,Allen; Michael Gordon,12,0,65,53
1657591723077,COGS 101C,A01,083625,Delgado; Tania,17,0,35,18
1657591729100,COGS 107A,A01,083627,Boyle; Mary E. T.,13,0,60,47
1657591735126,COGS 118A,A01,083075,Gupta; Anjum,21,0,76,55
1657591741154,CSE 3,A50,083646,Miranda; Gregory Joseph,24,0,50,26
1657591747177,CSE 8A,A50,083650,Miranda; Gregory Joseph,17,1,56,39
1657591753202,CSE 11,A01,083080,Cao; Yingjun,6,15,40,34
1657591759226,CSE 12,A01,083652,Krause-Levy; Sophia Louisa,28,1,120,92
1657591765250,CSE 15L,A01,083654,Morris; Justin Loren,9,0,50,41
1657591765250,CSE 15L,A02,083655,Morris; Justin Loren,9,0,50,41
1657591771272,CSE 20,A01,083657,Tran; Khoa Dang,39,0,80,41
1657591777310,CSE 21,A01,095574,Bach; Quang Tran,22,0,48,26
1657591783341,CSE 30,A01,083084,Eldon; John,5,0,80,75
1657591783341,CSE 30,B01,095061,Bhaskar; Nishant,9,0,50,41
1657591789368,CSE 100,A01,083659,Cao; Yingjun,5,4,70,65
1657591795396,CSE 134B,A01,083661,Powell; Thomas Allan,22,0,100,78
1657591801430,CSE 140,A01,083663,Gungor; Onat,15,0,85,70
1657591807453,CSE 140L,A01,083088,Eldon; John,21,0,100,79
1657591813474,CSE 175,A01,083665,Kumar; Rakesh,3,0,25,22
1657591819500,CSE 190,A00,092507,Dubnov; Shlomo,8,0,20,12
1657591825529,ECE 45,A01,083139,Congero; Spencer William,6,0,75,69
1657591831552,ECE 65,A50,083695,Saad; Andrew S,12,0,30,18
1657591831552,ECE 65,A51,095125,Saad; Andrew S,24,0,26,2
1657591837574,ECE 109,A01,091882,Touri; Behrouz,19,0,70,51
1657591843602,ECE 180,A00,083140,Abi Samra; Nicholas Camill,1,0,30,29
1657591843602,ECE 180,B00,083141,Abi Samra; Nicholas Camill,0,0,30,30
1657591849629,MATH 10A,A01,083735,Patchell; Gregory David,2,0,30,28
1657591849629,MATH 10A,A02,083736,Patchell; Gregory David,20,0,30,10
1657591849629,MATH 10A,A03,083737,Patchell; Gregory David,16,0,30,14
1657591855658,MATH 10B,A01,083207,Lim; Seonhee,8,0,34,26
1657591855658,MATH 10B,A02,083208,Lim; Seonhee,9,0,35,26
1657591855658,MATH 10B,A03,093472,Lim; Seonhee,7,0,34,27
1657591855658,MATH 10B,B01,083739,Sinha; Shubham,12,0,30,18
1657591861688,MATH 18,A01,083743,Cinel; Cameron Alexander,7,0,30,23
1657591861688,MATH 18,A02,083744,Cinel; Cameron Alexander,17,0,30,13
1657591861688,MATH 18,A03,083745,Cinel; Cameron Alexander,9,0,30,21
1657591861688,MATH 18,B01,083748,Rideout; David Porter,5,0,37,32
1657591861688,MATH 18,B02,083749,Rideout; David Porter,5,0,36,31
1657591861688,MATH 18,B03,083750,Rideout; David Porter,3,0,37,34
1657591861688,MATH 18,B04,083751,Rideout; David Porter,6,0,36,30
1657591861688,MATH 18,B05,093473,Rideout; David Porter,6,0,36,30
1657591861688,MATH 18,B06,093474,Rideout; David Porter,6,0,36,30
1657591867710,MATH 20A,A01,083754,Zheng; Zequn,14,0,40,26
1657591873752,MATH 20B,A01,083756,Briones; Jor-el Thomas Caparas,4,0,36,32
1657591873752,MATH 20B,A02,083757,Briones; Jor-el Thomas Caparas,1,0,36,35
1657591873752,MATH 20B,A03,093475,Briones; Jor-el Thomas Caparas,2,0,36,34
1657591879783,MATH 20C,A01,083760,Briones; Jor-el Thomas Caparas,1,0,35,34
1657591879783,MATH 20C,A02,083761,Briones; Jor-el Thomas Caparas,8,0,35,27
1657591879783,MATH 20C,A03,093476,Briones; Jor-el Thomas Caparas,0,1,36,36
1657591879783,MATH 20C,B01,083762,Bach; Quang Tran,1,0,30,29
1657591885805,MATH 20D,A01,083765,Tran; Brian Kha,5,0,30,25
1657591885805,MATH 20D,A02,083766,Tran; Brian Kha,5,0,30,25
1657591885805,MATH 20D,A03,083767,Tran; Brian Kha,5,0,30,25
1657591891834,MATH 20E,A01,083771,Ganguly; Soumya,9,0,32,23
1657591891834,MATH 20E,A02,083772,Ganguly; Soumya,6,0,32,26
1657591891834,MATH 20E,B01,083773,Ciotti; Benjamin,20,0,35,15
1657591891834,MATH 20E,B02,083774,Ciotti; Benjamin,18,0,35,17
1657591897857,MATH 103A,A01,083777,Greenfeld; Be'Eri,3,0,36,33
1657591897857,MATH 103A,A02,083778,Greenfeld; Be'Eri,5,0,36,31
1657591897857,MATH 103A,A03,093561,Greenfeld; Be'Eri,5,0,36,31
1657591897857,MATH 103A,B01,083779,Greenfeld; Be'Eri,7,0,36,29
1657591897857,MATH 103A,B02,083780,Greenfeld; Be'Eri,4,0,36,32
1657591897857,MATH 103A,B03,093562,Greenfeld; Be'Eri,3,0,36,33
1657591903878,MATH 105,A01,085443,Carter; Anne Toulson,15,0,35,20
1657591903878,MATH 105,A02,093477,Carter; Anne Toulson,20,0,35,15
1657591909902,MATH 109,A01,083213,Ganzberger; Geoffrey Michael,2,0,34,32
1657591909902,MATH 109,A02,083214,Ganzberger; Geoffrey Michael,4,0,34,30
1657591909902,MATH 109,A03,093478,Ganzberger; Geoffrey Michael,2,0,34,32
1657591909902,MATH 109,B01,083215,Ganzberger; Geoffrey Michael,1,0,32,31
1657591909902,MATH 109,B02,083216,Ganzberger; Geoffrey Michael,2,0,32,30
1657591909902,MATH 109,B03,093479,Ganzberger; Geoffrey Michael,8,0,32,24
1657591915931,MATH 142A,A01,083219,Chow; Bennett,7,0,32,25
1657591915931,MATH 142A,A02,083220,Chow; Bennett,10,0,32,22
1657591915931,MATH 142A,A03,093480,Chow; Bennett,8,0,32,24
1657591915931,MATH 142A,B03,093481,Chow; Bennett,8,0,32,24
1657591915931,MATH 142A,B04,093558,Chow; Bennett,13,0,32,19
1657591915931,MATH 142A,B05,093559,Chow; Bennett,6,0,32,26
1657591921971,MATH 193A,A01,083224,Rotar; Vladimir,8,0,34,26
1657591921971,MATH 193A,A02,083225,Rotar; Vladimir,9,0,34,25
1657591921971,MATH 193A,A03,083781,Rotar; Vladimir,5,0,34,29
1657591921971,MATH 193A,A04,083782,Rotar; Vladimir,10,0,34,24
1657591921971,MATH 193A,A05,093482,Rotar; Vladimir,10,0,34,24
1657591927996,MATH 197,001,091859,McAuley; Julian John,9999,0,9999,0
1657591927996,MATH 197,002,095566,Kedlaya; Kiran S.,9997,0,9999,2
1657591927996,MATH 197,003,095567,Xiao; Ming,9999,0,9999,0
1657591927996,MATH 197,004,095571,Perols; Johan Lars,9998,0,9999,1
1657591935059,COGS 9,A01,083615,Shannon; Kyle Michael,9,0,75,66
1657591941090,COGS 11,A01,083617,Boyle; Mary E. T.,23,0,48,25
1657591947113,COGS 13,A01,083071,Bastos; Amalia Pinkusfeld,11,0,71,60
1657591953140,COGS 14A,A01,092681,Semenuks; Arturs,5,1,100,95
1657591959170,COGS 14B,A01,083073,Cheng; Tzu-Han,6,0,63,57
1657591965193,COGS 17,A01,092677,Semenuks; Arturs,6,0,81,75
1657591971216,COGS 100,A01,083619,Allen; Michael Gordon,17,0,70,53
1657591977246,COGS 101A,A01,083621,Davis; Joshua Daniel,9,0,68,59
1657591983270,COGS 101B,A01,091572,Allen; Michael Gordon,12,0,65,53
1657591989292,COGS 101C,A01,083625,Delgado; Tania,17,0,35,18
1657591995313,COGS 107A,A01,083627,Boyle; Mary E. T.,13,0,60,47
1657592001336,COGS 118A,A01,083075,Gupta; Anjum,21,0,76,55
1657592007362,CSE 3,A50,083646,Miranda; Gregory Joseph,24,0,50,26
1657592013389,CSE 8A,A50,083650,Miranda; Gregory Joseph,17,1,56,39
1657592019411,CSE 11,A01,083080,Cao; Yingjun,6,15,40,34
1657592025443,CSE 12,A01,083652,Krause-Levy; Sophia Louisa,28,1,120,92
1657592031474,CSE 15L,A01,083654,Morris; Justin Loren,9,0,50,41
1657592031474,CSE 15L,A02,083655,Morris; Justin Loren,9,0,50,41
1657592037501,CSE 20,A01,083657,Tran; Khoa Dang,39,0,80,41
1657592043528,CSE 21,A01,095574,Bach; Quang Tran,22,0,48,26
1657592049556,CSE 30,A01,083084,Eldon; John,5,0,80,75
1657592049556,CSE 30,B01,095061,Bhaskar; Nishant,9,0,50,41
1657592055578,CSE 100,A01,083659,Cao; Yingjun,5,4,70,65
1657592061606,CSE 134B,A01,083661,Powell; Thomas Allan,22,0,100,78
1657592067630,CSE 140,A01,083663,Gungor; Onat,15,0,85,70
1657592073652,CSE 140L,A01,083088,Eldon; John,21,0,100,79
1657592079676,CSE 175,A01,083665,Kumar; Rakesh,3,0,25,22
1657592085701,CSE 190,A00,092507,Dubnov; Shlomo,8,0,20,12
1657592091725,ECE 45,A01,083139,Congero; Spencer William,6,0,75,69
1657592097750,ECE 65,A50,083695,Saad; Andrew S,12,0,30,18
1657592097750,ECE 65,A51,095125,Saad; Andrew S,24,0,26,2
1657592103777,ECE 109,A01,091882,Touri; Behrouz,19,0,70,51
1657592109803,ECE 180,A00,083140,Abi Samra; Nicholas Camill,1,0,30,29
1657592109803,ECE 180,B00,083141,Abi Samra; Nicholas Camill,0,0,30,30
1657592115915,MATH 10A,A01,083735,Patchell; Gregory David,2,0,30,28
1657592115915,MATH 10A,A02,083736,Patchell; Gregory David,20,0,30,10
1657592115915,MATH 10A,A03,083737,Patchell; Gregory David,16,0,30,14
1657592121939,MATH 10B,A01,083207,Lim; Seonhee,8,0,34,26
1657592121939,MATH 10B,A02,083208,Lim; Seonhee,9,0,35,26
1657592121939,MATH 10B,A03,093472,Lim; Seonhee,7,0,34,27
1657592121939,MATH 10B,B01,083739,Sinha; Shubham,12,0,30,18
1657592127964,MATH 18,A01,083743,Cinel; Cameron Alexander,7,0,30,23
1657592127964,MATH 18,A02,083744,Cinel; Cameron Alexander,17,0,30,13
1657592127964,MATH 18,A03,083745,Cinel; Cameron Alexander,9,0,30,21
1657592127964,MATH 18,B01,083748,Rideout; David Porter,5,0,37,32
1657592127964,MATH 18,B02,083749,Rideout; David Porter,5,0,36,31
1657592127964,MATH 18,B03,083750,Rideout; David Porter,3,0,37,34
1657592127964,MATH 18,B04,083751,Rideout; David Porter,6,0,36,30
1657592127964,MATH 18,B05,093473,Rideout; David Porter,6,0,36,30
1657592127964,MATH 18,B06,093474,Rideout; David Porter,6,0,36,30
1657592133986,MATH 20A,A01,083754,Zheng; Zequn,14,0,40,26
1657592140013,MATH 20B,A01,083756,Briones; Jor-el Thomas Caparas,4,0,36,32
1657592140013,MATH 20B,A02,083757,Briones; Jor-el Thomas Caparas,1,0,36,35
1657592140013,MATH 20B,A03,093475,Briones; Jor-el Thomas Caparas,2,0,36,34
1657592146038,MATH 20C,A01,083760,Briones; Jor-el Thomas Caparas,1,0,35,34
1657592146038,MATH 20C,A02,083761,Briones; Jor-el Thomas Caparas,8,0,35,27
1657592146038,MATH 20C,A03,093476,Briones; Jor-el Thomas Caparas,0,1,36,36
1657592146038,MATH 20C,B01,083762,Bach; Quang Tran,1,0,30,29
1657592152063,MATH 20D,A01,083765,Tran; Brian Kha,5,0,30,25
1657592152063,MATH 20D,A02,083766,Tran; Brian Kha,5,0,30,25
1657592152063,MATH 20D,A03,083767,Tran; Brian Kha,5,0,30,25
1657592158090,MATH 20E,A01,083771,Ganguly; Soumya,9,0,32,23
1657592158090,MATH 20E,A02,083772,Ganguly; Soumya,6,0,32,26
1657592158090,MATH 20E,B01,083773,Ciotti; Benjamin,20,0,35,15
1657592158090,MATH 20E,B02,083774,Ciotti; Benjamin,18,0,35,17
1657592164132,MATH 103A,A01,083777,Greenfeld; Be'Eri,3,0,36,33
1657592164132,MATH 103A,A02,083778,Greenfeld; Be'Eri,5,0,36,31
1657592164132,MATH 103A,A03,093561,Greenfeld; Be'Eri,5,0,36,31
1657592164132,MATH 103A,B01,083779,Greenfeld; Be'Eri,7,0,36,29
1657592164132,MATH 103A,B02,083780,Greenfeld; Be'Eri,4,0,36,32
1657592164132,MATH 103A,B03,093562,Greenfeld; Be'Eri,3,0,36,33
1657592170157,MATH 105,A01,085443,Carter; Anne Toulson,15,0,35,20
1657592170157,MATH 105,A02,093477,Carter; Anne Toulson,20,0,35,15
1657592176179,MATH 109,A01,083213,Ganzberger; Geoffrey Michael,2,0,34,32
1657592176179,MATH 109,A02,083214,Ganzberger; Geoffrey Michael,4,0,34,30
1657592176179,MATH 109,A03,093478,Ganzberger; Geoffrey Michael,2,0,34,32
1657592176179,MATH 109,B01,083215,Ganzberger; Geoffrey Michael,1,0,32,31
1657592176179,MATH 109,B02,083216,Ganzberger; Geoffrey Michael,2,0,32,30
1657592176179,MATH 109,B03,093479,Ganzberger; Geoffrey Michael,8,0,32,24
1657592182207,MATH 142A,A01,083219,Chow; Bennett,7,0,32,25
1657592182207,MATH 142A,A02,083220,Chow; Bennett,10,0,32,22
1657592182207,MATH 142A,A03,093480,Chow; Bennett,8,0,32,24
1657592182207,MATH 142A,B03,093481,Chow; Bennett,8,0,32,24
1657592182207,MATH 142A,B04,093558,Chow; Bennett,13,0,32,19
1657592182207,MATH 142A,B05,093559,Chow; Bennett,6,0,32,26
1657592188232,MATH 193A,A01,083224,Rotar; Vladimir,8,0,34,26
1657592188232,MATH 193A,A02,083225,Rotar; Vladimir,9,0,34,25
1657592188232,MATH 193A,A03,083781,Rotar; Vladimir,5,0,34,29
1657592188232,MATH 193A,A04,083782,Rotar; Vladimir,10,0,34,24
1657592188232,MATH 193A,A05,093482,Rotar; Vladimir,10,0,34,24
1657592194259,MATH 197,001,091859,McAuley; Julian John,9999,0,9999,0
1657592194259,MATH 197,002,095566,Kedlaya; Kiran S.,9997,0,9999,2
1657592194259,MATH 197,003,095567,Xiao; Ming,9999,0,9999,0
1657592194259,MATH 197,004,095571,Perols; Johan Lars,9998,0,9999,1
1657592201308,COGS 9,A01,083615,Shannon; Kyle Michael,9,0,75,66
1657592207330,COGS 11,A01,083617,Boyle; Mary E. T.,23,0,48,25
1657592213351,COGS 13,A01,083071,Bastos; Amalia Pinkusfeld,11,0,71,60
1657592219375,COGS 14A,A01,092681,Semenuks; Arturs,5,1,100,95
1657592225397,COGS 14B,A01,083073,Cheng; Tzu-Han,6,0,63,57
1657592231423,COGS 17,A01,092677,Semenuks; Arturs,6,0,81,75
1657592237445,COGS 100,A01,083619,Allen; Michael Gordon,17,0,70,53
1657592243472,COGS 101A,A01,083621,Davis; Joshua Daniel,9,0,68,59
1657592249498,COGS 101B,A01,091572,Allen; Michael Gordon,12,0,65,53
1657592255521,COGS 101C,A01,083625,Delgado; Tania,17,0,35,18
1657592261554,COGS 107A,A01,083627,Boyle; Mary E. T.,13,0,60,47
1657592267578,COGS 118A,A01,083075,Gupta; Anjum,21,0,76,55
1657592273612,CSE 3,A50,083646,Miranda; Gregory Joseph,24,0,50,26
1657592279639,CSE 8A,A50,083650,Miranda; Gregory Joseph,17,1,56,39
1657592285667,CSE 11,A01,083080,Cao; Yingjun,6,15,40,34
1657592291695,CSE 12,A01,083652,Krause-Levy; Sophia Louisa,28,1,120,92
1657592297721,CSE 15L,A01,083654,Morris; Justin Loren,9,0,50,41
1657592297721,CSE 15L,A02,083655,Morris; Justin Loren,9,0,50,41
1657592303744,CSE 20,A01,083657,Tran; Khoa Dang,39,0,80,41
1657592309779,CSE 21,A01,095574,Bach; Quang Tran,22,0,48,26
1657592315804,CSE 30,A01,083084,Eldon; John,5,0,80,75
1657592315804,CSE 30,B01,095061,Bhaskar; Nishant,9,0,50,41
1657592321834,CSE 100,A01,083659,Cao; Yingjun,5,4,70,65
1657592327856,CSE 134B,A01,083661,Powell; Thomas Allan,22,0,100,78
1657592333880,CSE 140,A01,083663,Gungor; Onat,15,0,85,70
1657592339915,CSE 140L,A01,083088,Eldon; John,21,0,100,79
1657592345936,CSE 175,A01,083665,Kumar; Rakesh,3,0,25,22
1657592351959,CSE 190,A00,092507,Dubnov; Shlomo,8,0,20,12
1657592357986,ECE 45,A01,083139,Congero; Spencer William,6,0,75,69
1657592364010,ECE 65,A50,083695,Saad; Andrew S,12,0,30,18
1657592364010,ECE 65,A51,095125,Saad; Andrew S,24,0,26,2
1657592370032,ECE 109,A01,091882,Touri; Behrouz,19,0,70,51
1657592376059,ECE 180,A00,083140,Abi Samra; Nicholas Camill,1,0,30,29
1657592376059,ECE 180,B00,083141,Abi Samra; Nicholas Camill,0,0,30,30
1657592382083,MATH 10A,A01,083735,Patchell; Gregory David,2,0,30,28
1657592382083,MATH 10A,A02,083736,Patchell; Gregory David,20,0,30,10
1657592382083,MATH 10A,A03,083737,Patchell; Gregory David,16,0,30,14
1657592388107,MATH 10B,A01,083207,Lim; Seonhee,8,0,34,26
1657592388107,MATH 10B,A02,083208,Lim; Seonhee,9,0,35,26
1657592388107,MATH 10B,A03,093472,Lim; Seonhee,7,0,34,27
1657592388107,MATH 10B,B01,083739,Sinha; Shubham,12,0,30,18
1657592394130,MATH 18,A01,083743,Cinel; Cameron Alexander,7,0,30,23
1657592394130,MATH 18,A02,083744,Cinel; Cameron Alexander,17,0,30,13
1657592394130,MATH 18,A03,083745,Cinel; Cameron Alexander,9,0,30,21
1657592394130,MATH 18,B01,083748,Rideout; David Porter,5,0,37,32
1657592394130,MATH 18,B02,083749,Rideout; David Porter,5,0,36,31
1657592394130,MATH 18,B03,083750,Rideout; David Porter,3,0,37,34
1657592394130,MATH 18,B04,083751,Rideout; David Porter,6,0,36,30
1657592394130,MATH 18,B05,093473,Rideout; David Porter,6,0,36,30
1657592394130,MATH 18,B06,093474,Rideout; David Porter,6,0,36,30
1657592400154,MATH 20A,A01,083754,Zheng; Zequn,14,0,40,26
1657592406191,MATH 20B,A01,083756,Briones; Jor-el Thomas Caparas,4,0,36,32
1657592406191,MATH 20B,A02,083757,Briones; Jor-el Thomas Caparas,1,0,36,35
1657592406191,MATH 20B,A03,093475,Briones; Jor-el Thomas Caparas,2,0,36,34
1657592412215,MATH 20C,A01,083760,Briones; Jor-el Thomas Caparas,1,0,35,34
1657592412215,MATH 20C,A02,083761,Briones; Jor-el Thomas Caparas,8,0,35,27
1657592412215,MATH 20C,A03,093476,Briones; Jor-el Thomas Caparas,0,1,36,36
1657592412215,MATH 20C,B01,083762,Bach; Quang Tran,1,0,30,29
1657592418242,MATH 20D,A01,083765,Tran; Brian Kha,5,0,30,25
1657592418242,MATH 20D,A02,083766,Tran; Brian Kha,5,0,30,25
1657592418242,MATH 20D,A03,083767,Tran; Brian Kha,5,0,30,25
1657592424269,MATH 20E,A01,083771,Ganguly; Soumya,9,0,32,23
1657592424269,MATH 20E,A02,083772,Ganguly; Soumya,6,0,32,26
1657592424269,MATH 20E,B01,083773,Ciotti; Benjamin,20,0,35,15
1657592424269,MATH 20E,B02,083774,Ciotti; Benjamin,18,0,35,17
1657592430293,MATH 103A,A01,083777,Greenfeld; Be'Eri,3,0,36,33
1657592430293,MATH 103A,A02,083778,Greenfeld; Be'Eri,5,0,36,31
1657592430293,MATH 103A,A03,093561,Greenfeld; Be'Eri,6,0,36,30
1657592430293,MATH 103A,B01,083779,Greenfeld; Be'Eri,7,0,36,29
1657592430293,MATH 103A,B02,083780,Greenfeld; Be'Eri,4,0,36,32
1657592430293,MATH 103A,B03,093562,Greenfeld; Be'Eri,3,0,36,33
1657592436315,MATH 105,A01,085443,Carter; Anne Toulson,15,0,35,20
1657592436315,MATH 105,A02,093477,Carter; Anne Toulson,20,0,35,15
1657592442347,MATH 109,A01,083213,Ganzberger; Geoffrey Michael,2,0,34,32
1657592442347,MATH 109,A02,083214,Ganzberger; Geoffrey Michael,4,0,34,30
1657592442347,MATH 109,A03,093478,Ganzberger; Geoffrey Michael,2,0,34,32
1657592442347,MATH 109,B01,083215,Ganzberger; Geoffrey Michael,1,0,32,31
1657592442347,MATH 109,B02,083216,Ganzberger; Geoffrey Michael,2,0,32,30
1657592442347,MATH 109,B03,093479,Ganzberger; Geoffrey Michael,8,0,32,24
1657592448375,MATH 142A,A01,083219,Chow; Bennett,7,0,32,25
1657592448375,MATH 142A,A02,083220,Chow; Bennett,10,0,32,22
1657592448375,MATH 142A,A03,093480,Chow; Bennett,9,0,32,23
1657592448375,MATH 142A,B03,093481,Chow; Bennett,8,0,32,24
1657592448375,MATH 142A,B04,093558,Chow; Bennett,13,0,32,19
1657592448375,MATH 142A,B05,093559,Chow; Bennett,6,0,32,26
1657592454408,MATH 193A,A01,083224,Rotar; Vladimir,8,0,34,26
1657592454408,MATH 193A,A02,083225,Rotar; Vladimir,9,0,34,25
1657592454408,MATH 193A,A03,083781,Rotar; Vladimir,5,0,34,29
1657592454408,MATH 193A,A04,083782,Rotar; Vladimir,10,0,34,24
1657592454408,MATH 193A,A05,093482,Rotar; Vladimir,10,0,34,24
1657592460431,MATH 197,001,091859,McAuley; Julian John,9999,0,9999,0
1657592460431,MATH 197,002,095566,Kedlaya; Kiran S.,9997,0,9999,2
1657592460431,MATH 197,003,095567,Xiao; Ming,9999,0,9999,0
1657592460431,MATH 197,004,095571,Perols; Johan Lars,9998,0,9999,1
1657592467529,COGS 9,A01,083615,Shannon; Kyle Michael,9,0,75,66
1657592473557,COGS 11,A01,083617,Boyle; Mary E. T.,23,0,48,25
1657592479590,COGS 13,A01,083071,Bastos; Amalia Pinkusfeld,11,0,71,60
1657592485613,COGS 14A,A01,092681,Semenuks; Arturs,5,1,100,95
1657592491641,COGS 14B,A01,083073,Cheng; Tzu-Han,6,0,63,57
1657592497663,COGS 17,A01,092677,Semenuks; Arturs,6,0,81,75
1657592503691,COGS 100,A01,083619,Allen; Michael Gordon,17,0,70,53
1657592509716,COGS 101A,A01,083621,Davis; Joshua Daniel,9,0,68,59
1657592515744,COGS 101B,A01,091572,Allen; Michael Gordon,12,0,65,53
1657592521776,COGS 101C,A01,083625,Delgado; Tania,17,0,35,18
1657592527799,COGS 107A,A01,083627,Boyle; Mary E. T.,13,0,60,47
1657592533834,COGS 118A,A01,083075,Gupta; Anjum,21,0,76,55
1657592539860,CSE 3,A50,083646,Miranda; Gregory Joseph,24,0,50,26
1657592545884,CSE 8A,A50,083650,Miranda; Gregory Joseph,17,1,56,39
1657592551911,CSE 11,A01,083080,Cao; Yingjun,6,15,40,34
1657592557933,CSE 12,A01,083652,Krause-Levy; Sophia Louisa,28,1,120,92
1657592563957,CSE 15L,A01,083654,Morris; Justin Loren,9,0,50,41
1657592563957,CSE 15L,A02,083655,Morris; Justin Loren,9,0,50,41
1657592569982,CSE 20,A01,083657,Tran; Khoa Dang,39,0,80,41
1657592576006,CSE 21,A01,095574,Bach; Quang Tran,22,0,48,26
1657592582029,CSE 30,A01,083084,Eldon; John,5,0,80,75
1657592582029,CSE 30,B01,095061,Bhaskar; Nishant,9,0,50,41
1657592588053,CSE 100,A01,083659,Cao; Yingjun,5,4,70,65
1657592594078,CSE 134B,A01,083661,Powell; Thomas Allan,22,0,100,78
1657592600106,CSE 140,A01,083663,Gungor; Onat,15,0,85,70
1657592606127,CSE 140L,A01,083088,Eldon; John,21,0,100,79
1657592612150,CSE 175,A01,083665,Kumar; Rakesh,3,0,25,22
1657592618173,CSE 190,A00,092507,Dubnov; Shlomo,8,0,20,12
1657592624203,ECE 45,A01,083139,Congero; Spencer William,6,0,75,69
1657592630232,ECE 65,A50,083695,Saad; Andrew S,12,0,30,18
1657592630232,ECE 65,A51,095125,Saad; Andrew S,24,0,26,2
1657592636258,ECE 109,A01,091882,Touri; Behrouz,19,0,70,51
1657592642283,ECE 180,A00,083140,Abi Samra; Nicholas Camill,1,0,30,29
1657592642283,ECE 180,B00,083141,Abi Samra; Nicholas Camill,0,0,30,30
1657592648309,MATH 10A,A01,083735,Patchell; Gregory David,2,0,30,28
1657592648309,MATH 10A,A02,083736,Patchell; Gregory David,20,0,30,10
1657592648309,MATH 10A,A03,083737,Patchell; Gregory David,16,0,30,14
1657592654344,MATH 10B,A01,083207,Lim; Seonhee,8,0,34,26
1657592654344,MATH 10B,A02,083208,Lim; Seonhee,9,0,35,26
1657592654344,MATH 10B,A03,093472,Lim; Seonhee,7,0,34,27
1657592654344,MATH 10B,B01,083739,Sinha; Shubham,12,0,30,18
1657592660372,MATH 18,A01,083743,Cinel; Cameron Alexander,7,0,30,23
1657592660372,MATH 18,A02,083744,Cinel; Cameron Alexander,17,0,30,13
1657592660372,MATH 18,A03,083745,Cinel; Cameron Alexander,9,0,30,21
1657592660372,MATH 18,B01,083748,Rideout; David Porter,5,0,37,32
1657592660372,MATH 18,B02,083749,Rideout; David Porter,5,0,36,31
1657592660372,MATH 18,B03,083750,Rideout; David Porter,3,0,37,34
1657592660372,MATH 18,B04,083751,Rideout; David Porter,6,0,36,30
1657592660372,MATH 18,B05,093473,Rideout; David Porter,6,0,36,30
1657592660372,MATH 18,B06,093474,Rideout; David Porter,6,0,36,30
1657592666397,MATH 20A,A01,083754,Zheng; Zequn,14,0,40,26
1657592672422,MATH 20B,A01,083756,Briones; Jor-el Thomas Caparas,4,0,36,32
1657592672422,MATH 20B,A02,083757,Briones; Jor-el Thomas Caparas,1,0,36,35
1657592672422,MATH 20B,A03,093475,Briones; Jor-el Thomas Caparas,2,0,36,34
1657592678446,MATH 20C,A01,083760,Briones; Jor-el Thomas Caparas,1,0,35,34
1657592678446,MATH 20C,A02,083761,Briones; Jor-el Thomas Caparas,8,0,35,27
1657592678446,MATH 20C,A03,093476,Briones; Jor-el Thomas Caparas,0,1,36,36
1657592678446,MATH 20C,B01,083762,Bach; Quang Tran,1,0,30,29
1657592684475,MATH 20D,A01,083765,Tran; Brian Kha,5,0,30,25
1657592684475,MATH 20D,A02,083766,Tran; Brian Kha,5,0,30,25
1657592684475,MATH 20D,A03,083767,Tran; Brian Kha,5,0,30,25
1657592690515,MATH 20E,A01,083771,Ganguly; Soumya,9,0,32,23
1657592690515,MATH 20E,A02,083772,Ganguly; Soumya,6,0,32,26
1657592690515,MATH 20E,B01,083773,Ciotti; Benjamin,20,0,35,15
1657592690515,MATH 20E,B02,083774,Ciotti; Benjamin,18,0,35,17
1657592696539,MATH 103A,A01,083777,Greenfeld; Be'Eri,3,0,36,33
1657592696539,MATH 103A,A02,083778,Greenfeld; Be'Eri,5,0,36,31
1657592696539,MATH 103A,A03,093561,Greenfeld; Be'Eri,6,0,36,30
1657592696539,MATH 103A,B01,083779,Greenfeld; Be'Eri,7,0,36,29
1657592696539,MATH 103A,B02,083780,Greenfeld; Be'Eri,4,0,36,32
1657592696539,MATH 103A,B03,093562,Greenfeld; Be'Eri,3,0,36,33
1657592702566,MATH 105,A01,085443,Carter; Anne Toulson,15,0,35,20
1657592702566,MATH 105,A02,093477,Carter; Anne Toulson,20,0,35,15
1657592708591,MATH 109,A01,083213,Ganzberger; Geoffrey Michael,2,0,34,32
1657592708591,MATH 109,A02,083214,Ganzberger; Geoffrey Michael,4,0,34,30
1657592708591,MATH 109,A03,093478,Ganzberger; Geoffrey Michael,2,0,34,32
1657592708591,MATH 109,B01,083215,Ganzberger; Geoffrey Michael,1,0,32,31
1657592708591,MATH 109,B02,083216,Ganzberger; Geoffrey Michael,2,0,32,30
1657592708591,MATH 109,B03,093479,Ganzberger; Geoffrey Michael,8,0,32,24
1657592714707,MATH 142A,A01,083219,Chow; Bennett,7,0,32,25
1657592714707,MATH 142A,A02,083220,Chow; Bennett,10,0,32,22
1657592714707,MATH 142A,A03,093480,Chow; Bennett,9,0,32,23
1657592714707,MATH 142A,B03,093481,Chow; Bennett,8,0,32,24
1657592714707,MATH 142A,B04,093558,Chow; Bennett,13,0,32,19
1657592714707,MATH 142A,B05,093559,Chow; Bennett,6,0,32,26
1657592720730,MATH 193A,A01,083224,Rotar; Vladimir,8,0,34,26
1657592720730,MATH 193A,A02,083225,Rotar; Vladimir,9,0,34,25
1657592720730,MATH 193A,A03,083781,Rotar; Vladimir,5,0,34,29
1657592720730,MATH 193A,A04,083782,Rotar; Vladimir,10,0,34,24
1657592720730,MATH 193A,A05,093482,Rotar; Vladimir,10,0,34,24
1657592726753,MATH 197,001,091859,McAuley; Julian John,9999,0,9999,0
1657592726753,MATH 197,002,095566,Kedlaya; Kiran S.,9997,0,9999,2
1657592726753,MATH 197,003,095567,Xiao; Ming,9999,0,9999,0
1657592726753,MATH 197,004,095571,Perols; Johan Lars,9998,0,9999,1
1657592733806,COGS 9,A01,083615,Shannon; Kyle Michael,9,0,75,66
1657592739834,COGS 11,A01,083617,Boyle; Mary E. T.,23,0,48,25
1657592745856,COGS 13,A01,083071,Bastos; Amalia Pinkusfeld,11,0,71,60
1657592751886,COGS 14A,A01,092681,Semenuks; Arturs,5,1,100,95
1657592757909,COGS 14B,A01,083073,Cheng; Tzu-Han,6,0,63,57
1657592763932,COGS 17,A01,092677,Semenuks; Arturs,6,0,81,75
1657592769953,COGS 100,A01,083619,Allen; Michael Gordon,17,0,70,53
1657592775976,COGS 101A,A01,083621,Davis; Joshua Daniel,9,0,68,59
1657592782003,COGS 101B,A01,091572,Allen; Michael Gordon,12,0,65,53
1657592788030,COGS 101C,A01,083625,Delgado; Tania,17,0,35,18
1657592794057,COGS 107A,A01,083627,Boyle; Mary E. T.,13,0,60,47
1657592800080,COGS 118A,A01,083075,Gupta; Anjum,21,0,76,55
1657592806104,CSE 3,A50,083646,Miranda; Gregory Joseph,24,0,50,26
1657592812126,CSE 8A,A50,083650,Miranda; Gregory Joseph,17,1,56,39
1657592818154,CSE 11,A01,083080,Cao; Yingjun,6,15,40,34
1657592824177,CSE 12,A01,083652,Krause-Levy; Sophia Louisa,28,1,120,92
1657592830209,CSE 15L,A01,083654,Morris; Justin Loren,9,0,50,41
1657592830209,CSE 15L,A02,083655,Morris; Justin Loren,9,0,50,41
1657592836236,CSE 20,A01,083657,Tran; Khoa Dang,39,0,80,41
1657592842259,CSE 21,A01,095574,Bach; Quang Tran,22,0,48,26
1657592848283,CSE 30,A01,083084,Eldon; John,5,0,80,75
1657592848283,CSE 30,B01,095061,Bhaskar; Nishant,9,0,50,41
1657592854307,CSE 100,A01,083659,Cao; Yingjun,5,4,70,65
1657592860330,CSE 134B,A01,083661,Powell; Thomas Allan,22,0,100,78
1657592866353,CSE 140,A01,083663,Gungor; Onat,15,0,85,70
1657592872390,CSE 140L,A01,083088,Eldon; John,21,0,100,79
1657592878415,CSE 175,A01,083665,Kumar; Rakesh,3,0,25,22
1657592884441,CSE 190,A00,092507,Dubnov; Shlomo,8,0,20,12
1657592890471,ECE 45,A01,083139,Congero; Spencer William,6,0,75,69
1657592896498,ECE 65,A50,083695,Saad; Andrew S,12,0,30,18
1657592896498,ECE 65,A51,095125,Saad; Andrew S,24,0,26,2
1657592902522,ECE 109,A01,091882,Touri; Behrouz,19,0,70,51
1657592908548,ECE 180,A00,083140,Abi Samra; Nicholas Camill,1,0,30,29
1657592908548,ECE 180,B00,083141,Abi Samra; Nicholas Camill,0,0,30,30
1657592914572,MATH 10A,A01,083735,Patchell; Gregory David,2,0,30,28
1657592914572,MATH 10A,A02,083736,Patchell; Gregory David,20,0,30,10
1657592914572,MATH 10A,A03,083737,Patchell; Gregory David,16,0,30,14
1657592920599,MATH 10B,A01,083207,Lim; Seonhee,8,0,34,26
1657592920599,MATH 10B,A02,083208,Lim; Seonhee,9,0,35,26
1657592920599,MATH 10B,A03,093472,Lim; Seonhee,7,0,34,27
1657592920599,MATH 10B,B01,083739,Sinha; Shubham,12,0,30,18
1657592926621,MATH 18,A01,083743,Cinel; Cameron Alexander,7,0,30,23
1657592926621,MATH 18,A02,083744,Cinel; Cameron Alexander,17,0,30,13
1657592926621,MATH 18,A03,083745,Cinel; Cameron Alexander,9,0,30,21
1657592926621,MATH 18,B01,083748,Rideout; David Porter,5,0,37,32
1657592926621,MATH 18,B02,083749,Rideout; David Porter,5,0,36,31
1657592926621,MATH 18,B03,083750,Rideout; David Porter,3,0,37,34
1657592926621,MATH 18,B04,083751,Rideout; David Porter,6,0,36,30
1657592926621,MATH 18,B05,093473,Rideout; David Porter,6,0,36,30
1657592926621,MATH 18,B06,093474,Rideout; David Porter,6,0,36,30
1657592932646,MATH 20A,A01,083754,Zheng; Zequn,14,0,40,26
1657592938668,MATH 20B,A01,083756,Briones; Jor-el Thomas Caparas,4,0,36,32
1657592938668,MATH 20B,A02,083757,Briones; Jor-el Thomas Caparas,1,0,36,35
1657592938668,MATH 20B,A03,093475,Briones; Jor-el Thomas Caparas,2,0,36,34
1657592944692,MATH 20C,A01,083760,Briones; Jor-el Thomas Caparas,1,0,35,34
1657592944692,MATH 20C,A02,083761,Briones; Jor-el Thomas Caparas,8,0,35,27
1657592944692,MATH 20C,A03,093476,Briones; Jor-el Thomas Caparas,0,1,36,36
1657592944692,MATH 20C,B01,083762,Bach; Quang Tran,1,0,30,29
1657592950715,MATH 20D,A01,083765,Tran; Brian Kha,5,0,30,25
1657592950715,MATH 20D,A02,083766,Tran; Brian Kha,5,0,30,25
1657592950715,MATH 20D,A03,083767,Tran; Brian Kha,5,0,30,25
1657592956742,MATH 20E,A01,083771,Ganguly; Soumya,9,0,32,23
1657592956742,MATH 20E,A02,083772,Ganguly; Soumya,6,0,32,26
1657592956742,MATH 20E,B01,083773,Ciotti; Benjamin,20,0,35,15
1657592956742,MATH 20E,B02,083774,Ciotti; Benjamin,18,0,35,17
1657592962765,MATH 103A,A01,083777,Greenfeld; Be'Eri,3,0,36,33
1657592962765,MATH 103A,A02,083778,Greenfeld; Be'Eri,5,0,36,31
1657592962765,MATH 103A,A03,093561,Greenfeld; Be'Eri,6,0,36,30
1657592962765,MATH 103A,B01,083779,Greenfeld; Be'Eri,7,0,36,29
1657592962765,MATH 103A,B02,083780,Greenfeld; Be'Eri,4,0,36,32
1657592962765,MATH 103A,B03,093562,Greenfeld; Be'Eri,3,0,36,33
1657592968792,MATH 105,A01,085443,Carter; Anne Toulson,15,0,35,20
1657592968792,MATH 105,A02,093477,Carter; Anne Toulson,20,0,35,15
1657592974815,MATH 109,A01,083213,Ganzberger; Geoffrey Michael,2,0,34,32
1657592974815,MATH 109,A02,083214,Ganzberger; Geoffrey Michael,4,0,34,30
1657592974815,MATH 109,A03,093478,Ganzberger; Geoffrey Michael,2,0,34,32
1657592974815,MATH 109,B01,083215,Ganzberger; Geoffrey Michael,1,0,32,31
1657592974815,MATH 109,B02,083216,Ganzberger; Geoffrey Michael,2,0,32,30
1657592974815,MATH 109,B03,093479,Ganzberger; Geoffrey Michael,8,0,32,24
1657592980837,MATH 142A,A01,083219,Chow; Bennett,7,0,32,25
1657592980837,MATH 142A,A02,083220,Chow; Bennett,10,0,32,22
1657592980837,MATH 142A,A03,093480,Chow; Bennett,9,0,32,23
1657592980837,MATH 142A,B03,093481,Chow; Bennett,8,0,32,24
1657592980837,MATH 142A,B04,093558,Chow; Bennett,13,0,32,19
1657592980837,MATH 142A,B05,093559,Chow; Bennett,6,0,32,26
1657592986861,MATH 193A,A01,083224,Rotar; Vladimir,8,0,34,26
1657592986861,MATH 193A,A02,083225,Rotar; Vladimir,9,0,34,25
1657592986861,MATH 193A,A03,083781,Rotar; Vladimir,5,0,34,29
1657592986861,MATH 193A,A04,083782,Rotar; Vladimir,10,0,34,24
1657592986861,MATH 193A,A05,093482,Rotar; Vladimir,10,0,34,24
1657592992885,MATH 197,001,091859,McAuley; Julian John,9999,0,9999,0
1657592992885,MATH 197,002,095566,Kedlaya; Kiran S.,9997,0,9999,2
1657592992885,MATH 197,003,095567,Xiao; Ming,9999,0,9999,0
1657592992885,MATH 197,004,095571,Perols; Johan Lars,9998,0,9999,1
1657592999938,COGS 9,A01,083615,Shannon; Kyle Michael,9,0,75,66
1657593006059,COGS 11,A01,083617,Boyle; Mary E. T.,23,0,48,25
1657593012083,COGS 13,A01,083071,Bastos; Amalia Pinkusfeld,11,0,71,60
1657593018109,COGS 14A,A01,092681,Semenuks; Arturs,5,1,100,95
1657593024131,COGS 14B,A01,083073,Cheng; Tzu-Han,6,0,63,57
1657593030164,COGS 17,A01,092677,Semenuks; Arturs,6,0,81,75
1657593036189,COGS 100,A01,083619,Allen; Michael Gordon,17,0,70,53
1657593042216,COGS 101A,A01,083621,Davis; Joshua Daniel,9,0,68,59
1657593048239,COGS 101B,A01,091572,Allen; Michael Gordon,12,0,65,53
1657593054266,COGS 101C,A01,083625,Delgado; Tania,17,0,35,18
1657593060290,COGS 107A,A01,083627,Boyle; Mary E. T.,13,0,60,47
1657593066316,COGS 118A,A01,083075,Gupta; Anjum,21,0,76,55
1657593072344,CSE 3,A50,083646,Miranda; Gregory Joseph,24,0,50,26
1657593078372,CSE 8A,A50,083650,Miranda; Gregory Joseph,17,1,56,39
1657593084398,CSE 11,A01,083080,Cao; Yingjun,6,15,40,34
1657593090420,CSE 12,A01,083652,Krause-Levy; Sophia Louisa,28,1,120,92
1657593096451,CSE 15L,A01,083654,Morris; Justin Loren,9,0,50,41
1657593096451,CSE 15L,A02,083655,Morris; Justin Loren,9,0,50,41
1657593102473,CSE 20,A01,083657,Tran; Khoa Dang,39,0,80,41
1657593108501,CSE 21,A01,095574,Bach; Quang Tran,22,0,48,26
1657593114536,CSE 30,A01,083084,Eldon; John,5,0,80,75
1657593114536,CSE 30,B01,095061,Bhaskar; Nishant,9,0,50,41
1657593120558,CSE 100,A01,083659,Cao; Yingjun,5,4,70,65
1657593126586,CSE 134B,A01,083661,Powell; Thomas Allan,22,0,100,78
1657593132619,CSE 140,A01,083663,Gungor; Onat,15,0,85,70
1657593138640,CSE 140L,A01,083088,Eldon; John,21,0,100,79
1657593144663,CSE 175,A01,083665,Kumar; Rakesh,3,0,25,22
1657593150688,CSE 190,A00,092507,Dubnov; Shlomo,8,0,20,12
1657593156713,ECE 45,A01,083139,Congero; Spencer William,6,0,75,69
1657593162737,ECE 65,A50,083695,Saad; Andrew S,12,0,30,18
1657593162737,ECE 65,A51,095125,Saad; Andrew S,24,0,26,2
1657593168760,ECE 109,A01,091882,Touri; Behrouz,19,0,70,51
1657593174789,ECE 180,A00,083140,Abi Samra; Nicholas Camill,1,0,30,29
1657593174789,ECE 180,B00,083141,Abi Samra; Nicholas Camill,0,0,30,30
1657593180810,MATH 10A,A01,083735,Patchell; Gregory David,2,0,30,28
1657593180810,MATH 10A,A02,083736,Patchell; Gregory David,20,0,30,10
1657593180810,MATH 10A,A03,083737,Patchell; Gregory David,16,0,30,14
1657593186849,MATH 10B,A01,083207,Lim; Seonhee,8,0,34,26
1657593186849,MATH 10B,A02,083208,Lim; Seonhee,9,0,35,26
1657593186849,MATH 10B,A03,093472,Lim; Seonhee,7,0,34,27
1657593186849,MATH 10B,B01,083739,Sinha; Shubham,12,0,30,18
1657593192889,MATH 18,A01,083743,Cinel; Cameron Alexander,7,0,30,23
1657593192889,MATH 18,A02,083744,Cinel; Cameron Alexander,17,0,30,13
1657593192889,MATH 18,A03,083745,Cinel; Cameron Alexander,9,0,30,21
1657593192889,MATH 18,B01,083748,Rideout; David Porter,5,0,37,32
1657593192889,MATH 18,B02,083749,Rideout; David Porter,5,0,36,31
1657593192889,MATH 18,B03,083750,Rideout; David Porter,3,0,37,34
1657593192889,MATH 18,B04,083751,Rideout; David Porter,6,0,36,30
1657593192889,MATH 18,B05,093473,Rideout; David Porter,6,0,36,30
1657593192889,MATH 18,B06,093474,Rideout; David Porter,6,0,36,30
1657593198912,MATH 20A,A01,083754,Zheng; Zequn,14,0,40,26
1657593204939,MATH 20B,A01,083756,Briones; Jor-el Thomas Caparas,4,0,36,32
1657593204939,MATH 20B,A02,083757,Briones; Jor-el Thomas Caparas,1,0,36,35
1657593204939,MATH 20B,A03,093475,Briones; Jor-el Thomas Caparas,2,0,36,34
1657593210963,MATH 20C,A01,083760,Briones; Jor-el Thomas Caparas,1,0,35,34
1657593210963,MATH 20C,A02,083761,Briones; Jor-el Thomas Caparas,8,0,35,27
1657593210963,MATH 20C,A03,093476,Briones; Jor-el Thomas Caparas,0,1,36,36
1657593210963,MATH 20C,B01,083762,Bach; Quang Tran,1,0,30,29
1657593217000,MATH 20D,A01,083765,Tran; Brian Kha,5,0,30,25
1657593217000,MATH 20D,A02,083766,Tran; Brian Kha,5,0,30,25
1657593217000,MATH 20D,A03,083767,Tran; Brian Kha,5,0,30,25
1657593223021,MATH 20E,A01,083771,Ganguly; Soumya,9,0,32,23
1657593223021,MATH 20E,A02,083772,Ganguly; Soumya,6,0,32,26
1657593223021,MATH 20E,B01,083773,Ciotti; Benjamin,20,0,35,15
1657593223021,MATH 20E,B02,083774,Ciotti; Benjamin,18,0,35,17
1657593229045,MATH 103A,A01,083777,Greenfeld; Be'Eri,3,0,36,33
1657593229045,MATH 103A,A02,083778,Greenfeld; Be'Eri,5,0,36,31
1657593229045,MATH 103A,A03,093561,Greenfeld; Be'Eri,6,0,36,30
1657593229045,MATH 103A,B01,083779,Greenfeld; Be'Eri,7,0,36,29
1657593229045,MATH 103A,B02,083780,Greenfeld; Be'Eri,4,0,36,32
1657593229045,MATH 103A,B03,093562,Greenfeld; Be'Eri,3,0,36,33
1657593235070,MATH 105,A01,085443,Carter; Anne Toulson,15,0,35,20
1657593235070,MATH 105,A02,093477,Carter; Anne Toulson,20,0,35,15
1657593241097,MATH 109,A01,083213,Ganzberger; Geoffrey Michael,2,0,34,32
1657593241097,MATH 109,A02,083214,Ganzberger; Geoffrey Michael,4,0,34,30
1657593241097,MATH 109,A03,093478,Ganzberger; Geoffrey Michael,2,0,34,32
1657593241097,MATH 109,B01,083215,Ganzberger; Geoffrey Michael,1,0,32,31
1657593241097,MATH 109,B02,083216,Ganzberger; Geoffrey Michael,2,0,32,30
1657593241097,MATH 109,B03,093479,Ganzberger; Geoffrey Michael,8,0,32,24
1657593247120,MATH 142A,A01,083219,Chow; Bennett,7,0,32,25
1657593247120,MATH 142A,A02,083220,Chow; Bennett,10,0,32,22
1657593247120,MATH 142A,A03,093480,Chow; Bennett,9,0,32,23
1657593247120,MATH 142A,B03,093481,Chow; Bennett,8,0,32,24
1657593247120,MATH 142A,B04,093558,Chow; Bennett,13,0,32,19
1657593247120,MATH 142A,B05,093559,Chow; Bennett,6,0,32,26
1657593253148,MATH 193A,A01,083224,Rotar; Vladimir,8,0,34,26
1657593253148,MATH 193A,A02,083225,Rotar; Vladimir,9,0,34,25
1657593253148,MATH 193A,A03,083781,Rotar; Vladimir,5,0,34,29
1657593253148,MATH 193A,A04,083782,Rotar; Vladimir,10,0,34,24
1657593253148,MATH 193A,A05,093482,Rotar; Vladimir,10,0,34,24
1657593259174,MATH 197,001,091859,McAuley; Julian John,9999,0,9999,0
1657593259174,MATH 197,002,095566,Kedlaya; Kiran S.,9997,0,9999,2
1657593259174,MATH 197,003,095567,Xiao; Ming,9999,0,9999,0
1657593259174,MATH 197,004,095571,Perols; Johan Lars,9998,0,9999,1
1657593266225,COGS 9,A01,083615,Shannon; Kyle Michael,9,0,75,66
1657593272248,COGS 11,A01,083617,Boyle; Mary E. T.,23,0,48,25
1657593278274,COGS 13,A01,083071,Bastos; Amalia Pinkusfeld,11,0,71,60
1657593284297,COGS 14A,A01,092681,Semenuks; Arturs,5,1,100,95
1657593290321,COGS 14B,A01,083073,Cheng; Tzu-Han,6,0,63,57
1657593296343,COGS 17,A01,092677,Semenuks; Arturs,6,0,81,75
1657593302372,COGS 100,A01,083619,Allen; Michael Gordon,17,0,70,53
1657593308467,COGS 101A,A01,083621,Davis; Joshua Daniel,9,0,68,59
1657593314496,COGS 101B,A01,091572,Allen; Michael Gordon,12,0,65,53
1657593320522,COGS 101C,A01,083625,Delgado; Tania,17,0,35,18
1657593326548,COGS 107A,A01,083627,Boyle; Mary E. T.,13,0,60,47
1657593332576,COGS 118A,A01,083075,Gupta; Anjum,21,0,76,55
1657593338601,CSE 3,A50,083646,Miranda; Gregory Joseph,24,0,50,26
1657593344628,CSE 8A,A50,083650,Miranda; Gregory Joseph,17,1,56,39
1657593350657,CSE 11,A01,083080,Cao; Yingjun,6,15,40,34
1657593356680,CSE 12,A01,083652,Krause-Levy; Sophia Louisa,28,1,120,92
1657593362707,CSE 15L,A01,083654,Morris; Justin Loren,9,0,50,41
1657593362707,CSE 15L,A02,083655,Morris; Justin Loren,9,0,50,41
1657593368728,CSE 20,A01,083657,Tran; Khoa Dang,39,0,80,41
1657593374751,CSE 21,A01,095574,Bach; Quang Tran,22,0,48,26
1657593380777,CSE 30,A01,083084,Eldon; John,5,0,80,75
1657593380777,CSE 30,B01,095061,Bhaskar; Nishant,9,0,50,41
1657593386802,CSE 100,A01,083659,Cao; Yingjun,5,4,70,65
1657593392824,CSE 134B,A01,083661,Powell; Thomas Allan,22,0,100,78
1657593398846,CSE 140,A01,083663,Gungor; Onat,15,0,85,70
1657593404870,CSE 140L,A01,083088,Eldon; John,21,0,100,79
1657593410893,CSE 175,A01,083665,Kumar; Rakesh,3,0,25,22
1657593416920,CSE 190,A00,092507,Dubnov; Shlomo,8,0,20,12
1657593422946,ECE 45,A01,083139,Congero; Spencer William,6,0,75,69
1657593428970,ECE 65,A50,083695,Saad; Andrew S,12,0,30,18
1657593428970,ECE 65,A51,095125,Saad; Andrew S,24,0,26,2
1657593434995,ECE 109,A01,091882,Touri; Behrouz,19,0,70,51
1657593441021,ECE 180,A00,083140,Abi Samra; Nicholas Camill,1,0,30,29
1657593441021,ECE 180,B00,083141,Abi Samra; Nicholas Camill,0,0,30,30
1657593447044,MATH 10A,A01,083735,Patchell; Gregory David,2,0,30,28
1657593447044,MATH 10A,A02,083736,Patchell; Gregory David,20,0,30,10
1657593447044,MATH 10A,A03,083737,Patchell; Gregory David,16,0,30,14
1657593453073,MATH 10B,A01,083207,Lim; Seonhee,8,0,34,26
1657593453073,MATH 10B,A02,083208,Lim; Seonhee,9,0,35,26
1657593453073,MATH 10B,A03,093472,Lim; Seonhee,7,0,34,27
1657593453073,MATH 10B,B01,083739,Sinha; Shubham,12,0,30,18
1657593459097,MATH 18,A01,083743,Cinel; Cameron Alexander,7,0,30,23
1657593459097,MATH 18,A02,083744,Cinel; Cameron Alexander,17,0,30,13
1657593459097,MATH 18,A03,083745,Cinel; Cameron Alexander,9,0,30,21
1657593459097,MATH 18,B01,083748,Rideout; David Porter,5,0,37,32
1657593459097,MATH 18,B02,083749,Rideout; David Porter,5,0,36,31
1657593459097,MATH 18,B03,083750,Rideout; David Porter,3,0,37,34
1657593459097,MATH 18,B04,083751,Rideout; David Porter,6,0,36,30
1657593459097,MATH 18,B05,093473,Rideout; David Porter,6,0,36,30
1657593459097,MATH 18,B06,093474,Rideout; David Porter,6,0,36,30
1657593465120,MATH 20A,A01,083754,Zheng; Zequn,14,0,40,26
1657593471142,MATH 20B,A01,083756,Briones; Jor-el Thomas Caparas,4,0,36,32
1657593471142,MATH 20B,A02,083757,Briones; Jor-el Thomas Caparas,1,0,36,35
1657593471142,MATH 20B,A03,093475,Briones; Jor-el Thomas Caparas,2,0,36,34
1657593477166,MATH 20C,A01,083760,Briones; Jor-el Thomas Caparas,1,0,35,34
1657593477166,MATH 20C,A02,083761,Briones; Jor-el Thomas Caparas,8,0,35,27
1657593477166,MATH 20C,A03,093476,Briones; Jor-el Thomas Caparas,0,1,36,36
1657593477166,MATH 20C,B01,083762,Bach; Quang Tran,1,0,30,29
1657593483188,MATH 20D,A01,083765,Tran; Brian Kha,5,0,30,25
1657593483188,MATH 20D,A02,083766,Tran; Brian Kha,5,0,30,25
1657593483188,MATH 20D,A03,083767,Tran; Brian Kha,5,0,30,25
1657593489212,MATH 20E,A01,083771,Ganguly; Soumya,9,0,32,23
1657593489212,MATH 20E,A02,083772,Ganguly; Soumya,6,0,32,26
1657593489212,MATH 20E,B01,083773,Ciotti; Benjamin,20,0,35,15
1657593489212,MATH 20E,B02,083774,Ciotti; Benjamin,18,0,35,17
1657593495235,MATH 103A,A01,083777,Greenfeld; Be'Eri,3,0,36,33
1657593495235,MATH 103A,A02,083778,Greenfeld; Be'Eri,5,0,36,31
1657593495235,MATH 103A,A03,093561,Greenfeld; Be'Eri,6,0,36,30
1657593495235,MATH 103A,B01,083779,Greenfeld; Be'Eri,7,0,36,29
1657593495235,MATH 103A,B02,083780,Greenfeld; Be'Eri,4,0,36,32
1657593495235,MATH 103A,B03,093562,Greenfeld; Be'Eri,3,0,36,33
1657593501263,MATH 105,A01,085443,Carter; Anne Toulson,15,0,35,20
1657593501263,MATH 105,A02,093477,Carter; Anne Toulson,20,0,35,15
1657593507290,MATH 109,A01,083213,Ganzberger; Geoffrey Michael,2,0,34,32
1657593507290,MATH 109,A02,083214,Ganzberger; Geoffrey Michael,4,0,34,30
1657593507290,MATH 109,A03,093478,Ganzberger; Geoffrey Michael,2,0,34,32
1657593507290,MATH 109,B01,083215,Ganzberger; Geoffrey Michael,1,0,32,31
1657593507290,MATH 109,B02,083216,Ganzberger; Geoffrey Michael,2,0,32,30
1657593507290,MATH 109,B03,093479,Ganzberger; Geoffrey Michael,8,0,32,24
1657593513313,MATH 142A,A01,083219,Chow; Bennett,7,0,32,25
1657593513313,MATH 142A,A02,083220,Chow; Bennett,10,0,32,22
1657593513313,MATH 142A,A03,093480,Chow; Bennett,9,0,32,23
1657593513313,MATH 142A,B03,093481,Chow; Bennett,8,0,32,24
1657593513313,MATH 142A,B04,093558,Chow; Bennett,13,0,32,19
1657593513313,MATH 142A,B05,093559,Chow; Bennett,6,0,32,26
1657593519336,MATH 193A,A01,083224,Rotar; Vladimir,8,0,34,26
1657593519336,MATH 193A,A02,083225,Rotar; Vladimir,9,0,34,25
1657593519336,MATH 193A,A03,083781,Rotar; Vladimir,5,0,34,29
1657593519336,MATH 193A,A04,083782,Rotar; Vladimir,10,0,34,24
1657593519336,MATH 193A,A05,093482,Rotar; Vladimir,10,0,34,24
1657593525358,MATH 197,001,091859,McAuley; Julian John,9999,0,9999,0
1657593525358,MATH 197,002,095566,Kedlaya; Kiran S.,9997,0,9999,2
1657593525358,MATH 197,003,095567,Xiao; Ming,9999,0,9999,0
1657593525358,MATH 197,004,095571,Perols; Johan Lars,9998,0,9999,1
1657593532411,COGS 9,A01,083615,Shannon; Kyle Michael,9,0,75,66
1657593538438,COGS 11,A01,083617,Boyle; Mary E. T.,23,0,48,25
1657593544460,COGS 13,A01,083071,Bastos; Amalia Pinkusfeld,11,0,71,60
1657593550486,COGS 14A,A01,092681,Semenuks; Arturs,5,1,100,95
1657593556509,COGS 14B,A01,083073,Cheng; Tzu-Han,6,0,63,57
1657593562532,COGS 17,A01,092677,Semenuks; Arturs,6,0,81,75
1657593568556,COGS 100,A01,083619,Allen; Michael Gordon,17,0,70,53
1657593574583,COGS 101A,A01,083621,Davis; Joshua Daniel,9,0,68,59
1657593580610,COGS 101B,A01,091572,Allen; Michael Gordon,12,0,65,53
1657593586634,COGS 101C,A01,083625,Delgado; Tania,17,0,35,18
1657593592658,COGS 107A,A01,083627,Boyle; Mary E. T.,13,0,60,47
1657593598681,COGS 118A,A01,083075,Gupta; Anjum,21,0,76,55
1657593604704,CSE 3,A50,083646,Miranda; Gregory Joseph,24,0,50,26
1657593610730,CSE 8A,A50,083650,Miranda; Gregory Joseph,17,1,56,39
1657593616755,CSE 11,A01,083080,Cao; Yingjun,6,15,40,34
1657593622786,CSE 12,A01,083652,Krause-Levy; Sophia Louisa,28,1,120,92
1657593628813,CSE 15L,A01,083654,Morris; Justin Loren,9,0,50,41
1657593628813,CSE 15L,A02,083655,Morris; Justin Loren,9,0,50,41
1657593634842,CSE 20,A01,083657,Tran; Khoa Dang,39,0,80,41
1657593640865,CSE 21,A01,095574,Bach; Quang Tran,22,0,48,26
1657593646891,CSE 30,A01,083084,Eldon; John,5,0,80,75
1657593646891,CSE 30,B01,095061,Bhaskar; Nishant,9,0,50,41
1657593652917,CSE 100,A01,083659,Cao; Yingjun,5,4,70,65
1657593658943,CSE 134B,A01,083661,Powell; Thomas Allan,22,0,100,78
1657593664965,CSE 140,A01,083663,Gungor; Onat,15,0,85,70
1657593670990,CSE 140L,A01,083088,Eldon; John,21,0,100,79
1657593677022,CSE 175,A01,083665,Kumar; Rakesh,3,0,25,22
1657593683045,CSE 190,A00,092507,Dubnov; Shlomo,8,0,20,12
1657593689070,ECE 45,A01,083139,Congero; Spencer William,6,0,75,69
1657593695093,ECE 65,A50,083695,Saad; Andrew S,12,0,30,18
1657593695093,ECE 65,A51,095125,Saad; Andrew S,24,0,26,2
1657593701117,ECE 109,A01,091882,Touri; Behrouz,19,0,70,51
1657593707146,ECE 180,A00,083140,Abi Samra; Nicholas Camill,1,0,30,29
1657593707146,ECE 180,B00,083141,Abi Samra; Nicholas Camill,0,0,30,30
1657593713178,MATH 10A,A01,083735,Patchell; Gregory David,2,0,30,28
1657593713178,MATH 10A,A02,083736,Patchell; Gregory David,20,0,30,10
1657593713178,MATH 10A,A03,083737,Patchell; Gregory David,16,0,30,14
1657593719205,MATH 10B,A01,083207,Lim; Seonhee,8,0,34,26
1657593719205,MATH 10B,A02,083208,Lim; Seonhee,9,0,35,26
1657593719205,MATH 10B,A03,093472,Lim; Seonhee,7,0,34,27
1657593719205,MATH 10B,B01,083739,Sinha; Shubham,12,0,30,18
1657593725231,MATH 18,A01,083743,Cinel; Cameron Alexander,7,0,30,23
1657593725231,MATH 18,A02,083744,Cinel; Cameron Alexander,17,0,30,13
1657593725231,MATH 18,A03,083745,Cinel; Cameron Alexander,9,0,30,21
1657593725231,MATH 18,B01,083748,Rideout; David Porter,5,0,37,32
1657593725231,MATH 18,B02,083749,Rideout; David Porter,5,0,36,31
1657593725231,MATH 18,B03,083750,Rideout; David Porter,3,0,37,34
1657593725231,MATH 18,B04,083751,Rideout; David Porter,6,0,36,30
1657593725231,MATH 18,B05,093473,Rideout; David Porter,6,0,36,30
1657593725231,MATH 18,B06,093474,Rideout; David Porter,6,0,36,30
1657593731257,MATH 20A,A01,083754,Zheng; Zequn,14,0,40,26
1657593737287,MATH 20B,A01,083756,Briones; Jor-el Thomas Caparas,4,0,36,32
1657593737287,MATH 20B,A02,083757,Briones; Jor-el Thomas Caparas,1,0,36,35
1657593737287,MATH 20B,A03,093475,Briones; Jor-el Thomas Caparas,2,0,36,34
1657593743318,MATH 20C,A01,083760,Briones; Jor-el Thomas Caparas,1,0,35,34
1657593743318,MATH 20C,A02,083761,Briones; Jor-el Thomas Caparas,8,0,35,27
1657593743318,MATH 20C,A03,093476,Briones; Jor-el Thomas Caparas,0,1,36,36
1657593743318,MATH 20C,B01,083762,Bach; Quang Tran,1,0,30,29
1657593749346,MATH 20D,A01,083765,Tran; Brian Kha,5,0,30,25
1657593749346,MATH 20D,A02,083766,Tran; Brian Kha,5,0,30,25
1657593749346,MATH 20D,A03,083767,Tran; Brian Kha,5,0,30,25
1657593755375,MATH 20E,A01,083771,Ganguly; Soumya,9,0,32,23
1657593755375,MATH 20E,A02,083772,Ganguly; Soumya,6,0,32,26
1657593755375,MATH 20E,B01,083773,Ciotti; Benjamin,20,0,35,15
1657593755375,MATH 20E,B02,083774,Ciotti; Benjamin,18,0,35,17
1657593761399,MATH 103A,A01,083777,Greenfeld; Be'Eri,3,0,36,33
1657593761399,MATH 103A,A02,083778,Greenfeld; Be'Eri,5,0,36,31
1657593761399,MATH 103A,A03,093561,Greenfeld; Be'Eri,6,0,36,30
1657593761399,MATH 103A,B01,083779,Greenfeld; Be'Eri,7,0,36,29
1657593761399,MATH 103A,B02,083780,Greenfeld; Be'Eri,4,0,36,32
1657593761399,MATH 103A,B03,093562,Greenfeld; Be'Eri,3,0,36,33
1657593767421,MATH 105,A01,085443,Carter; Anne Toulson,15,0,35,20
1657593767421,MATH 105,A02,093477,Carter; Anne Toulson,20,0,35,15
1657593773447,MATH 109,A01,083213,Ganzberger; Geoffrey Michael,2,0,34,32
1657593773447,MATH 109,A02,083214,Ganzberger; Geoffrey Michael,4,0,34,30
1657593773447,MATH 109,A03,093478,Ganzberger; Geoffrey Michael,2,0,34,32
1657593773447,MATH 109,B01,083215,Ganzberger; Geoffrey Michael,1,0,32,31
1657593773447,MATH 109,B02,083216,Ganzberger; Geoffrey Michael,2,0,32,30
1657593773447,MATH 109,B03,093479,Ganzberger; Geoffrey Michael,8,0,32,24
1657593779469,MATH 142A,A01,083219,Chow; Bennett,7,0,32,25
1657593779469,MATH 142A,A02,083220,Chow; Bennett,10,0,32,22
1657593779469,MATH 142A,A03,093480,Chow; Bennett,9,0,32,23
1657593779469,MATH 142A,B03,093481,Chow; Bennett,8,0,32,24
1657593779469,MATH 142A,B04,093558,Chow; Bennett,13,0,32,19
1657593779469,MATH 142A,B05,093559,Chow; Bennett,6,0,32,26
1657593785492,MATH 193A,A01,083224,Rotar; Vladimir,8,0,34,26
1657593785492,MATH 193A,A02,083225,Rotar; Vladimir,9,0,34,25
1657593785492,MATH 193A,A03,083781,Rotar; Vladimir,5,0,34,29
1657593785492,MATH 193A,A04,083782,Rotar; Vladimir,10,0,34,24
1657593785492,MATH 193A,A05,093482,Rotar; Vladimir,10,0,34,24
1657593791520,MATH 197,001,091859,McAuley; Julian John,9999,0,9999,0
1657593791520,MATH 197,002,095566,Kedlaya; Kiran S.,9997,0,9999,2
1657593791520,MATH 197,003,095567,Xiao; Ming,9999,0,9999,0
1657593791520,MATH 197,004,095571,Perols; Johan Lars,9998,0,9999,1
1657593798574,COGS 9,A01,083615,Shannon; Kyle Michael,9,0,75,66
1657593804597,COGS 11,A01,083617,Boyle; Mary E. T.,23,0,48,25
1657593810619,COGS 13,A01,083071,Bastos; Amalia Pinkusfeld,11,0,71,60
1657593816643,COGS 14A,A01,092681,Semenuks; Arturs,5,1,100,95
1657593822674,COGS 14B,A01,083073,Cheng; Tzu-Han,6,0,63,57
1657593828698,COGS 17,A01,092677,Semenuks; Arturs,6,0,81,75
1657593834725,COGS 100,A01,083619,Allen; Michael Gordon,17,0,70,53
1657593840749,COGS 101A,A01,083621,Davis; Joshua Daniel,9,0,68,59
1657593846779,COGS 101B,A01,091572,Allen; Michael Gordon,12,0,65,53
1657593852801,COGS 101C,A01,083625,Delgado; Tania,17,0,35,18
1657593858825,COGS 107A,A01,083627,Boyle; Mary E. T.,13,0,60,47
1657593864851,COGS 118A,A01,083075,Gupta; Anjum,21,0,76,55
1657593870875,CSE 3,A50,083646,Miranda; Gregory Joseph,24,0,50,26
1657593876898,CSE 8A,A50,083650,Miranda; Gregory Joseph,17,1,56,39
1657593882922,CSE 11,A01,083080,Cao; Yingjun,6,15,40,34
1657593888950,CSE 12,A01,083652,Krause-Levy; Sophia Louisa,28,1,120,92
1657593894973,CSE 15L,A01,083654,Morris; Justin Loren,9,0,50,41
1657593894973,CSE 15L,A02,083655,Morris; Justin Loren,9,0,50,41
1657593900996,CSE 20,A01,083657,Tran; Khoa Dang,39,0,80,41
1657593907117,CSE 21,A01,095574,Bach; Quang Tran,22,0,48,26
1657593913143,CSE 30,A01,083084,Eldon; John,5,0,80,75
1657593913143,CSE 30,B01,095061,Bhaskar; Nishant,9,0,50,41
1657593919165,CSE 100,A01,083659,Cao; Yingjun,5,4,70,65
1657593925190,CSE 134B,A01,083661,Powell; Thomas Allan,22,0,100,78
1657593931215,CSE 140,A01,083663,Gungor; Onat,15,0,85,70
1657593937238,CSE 140L,A01,083088,Eldon; John,21,0,100,79
1657593943262,CSE 175,A01,083665,Kumar; Rakesh,3,0,25,22
1657593949285,CSE 190,A00,092507,Dubnov; Shlomo,8,0,20,12
1657593955310,ECE 45,A01,083139,Congero; Spencer William,6,0,75,69
1657593961337,ECE 65,A50,083695,Saad; Andrew S,12,0,30,18
1657593961337,ECE 65,A51,095125,Saad; Andrew S,24,0,26,2
1657593967364,ECE 109,A01,091882,Touri; Behrouz,19,0,70,51
1657593973391,ECE 180,A00,083140,Abi Samra; Nicholas Camill,1,0,30,29
1657593973391,ECE 180,B00,083141,Abi Samra; Nicholas Camill,0,0,30,30
1657593979414,MATH 10A,A01,083735,Patchell; Gregory David,2,0,30,28
1657593979414,MATH 10A,A02,083736,Patchell; Gregory David,20,0,30,10
1657593979414,MATH 10A,A03,083737,Patchell; Gregory David,16,0,30,14
1657593985444,MATH 10B,A01,083207,Lim; Seonhee,8,0,34,26
1657593985444,MATH 10B,A02,083208,Lim; Seonhee,9,0,35,26
1657593985444,MATH 10B,A03,093472,Lim; Seonhee,7,0,34,27
1657593985444,MATH 10B,B01,083739,Sinha; Shubham,12,0,30,18
1657593991474,MATH 18,A01,083743,Cinel; Cameron Alexander,7,0,30,23
1657593991474,MATH 18,A02,083744,Cinel; Cameron Alexander,17,0,30,13
1657593991474,MATH 18,A03,083745,Cinel; Cameron Alexander,9,0,30,21
1657593991474,MATH 18,B01,083748,Rideout; David Porter,5,0,37,32
1657593991474,MATH 18,B02,083749,Rideout; David Porter,5,0,36,31
1657593991474,MATH 18,B03,083750,Rideout; David Porter,3,0,37,34
1657593991474,MATH 18,B04,083751,Rideout; David Porter,6,0,36,30
1657593991474,MATH 18,B05,093473,Rideout; David Porter,6,0,36,30
1657593991474,MATH 18,B06,093474,Rideout; David Porter,6,0,36,30
1657593997497,MATH 20A,A01,083754,Zheng; Zequn,14,0,40,26
1657594003522,MATH 20B,A01,083756,Briones; Jor-el Thomas Caparas,4,0,36,32
1657594003522,MATH 20B,A02,083757,Briones; Jor-el Thomas Caparas,1,0,36,35
1657594003522,MATH 20B,A03,093475,Briones; Jor-el Thomas Caparas,2,0,36,34
1657594009553,MATH 20C,A01,083760,Briones; Jor-el Thomas Caparas,1,0,35,34
1657594009553,MATH 20C,A02,083761,Briones; Jor-el Thomas Caparas,8,0,35,27
1657594009553,MATH 20C,A03,093476,Briones; Jor-el Thomas Caparas,0,1,36,36
1657594009553,MATH 20C,B01,083762,Bach; Quang Tran,1,0,30,29
1657594015580,MATH 20D,A01,083765,Tran; Brian Kha,5,0,30,25
1657594015580,MATH 20D,A02,083766,Tran; Brian Kha,5,0,30,25
1657594015580,MATH 20D,A03,083767,Tran; Brian Kha,5,0,30,25
1657594021603,MATH 20E,A01,083771,Ganguly; Soumya,9,0,32,23
1657594021603,MATH 20E,A02,083772,Ganguly; Soumya,6,0,32,26
1657594021603,MATH 20E,B01,083773,Ciotti; Benjamin,20,0,35,15
1657594021603,MATH 20E,B02,083774,Ciotti; Benjamin,18,0,35,17
1657594027632,MATH 103A,A01,083777,Greenfeld; Be'Eri,3,0,36,33
1657594027632,MATH 103A,A02,083778,Greenfeld; Be'Eri,5,0,36,31
1657594027632,MATH 103A,A03,093561,Greenfeld; Be'Eri,6,0,36,30
1657594027632,MATH 103A,B01,083779,Greenfeld; Be'Eri,7,0,36,29
1657594027632,MATH 103A,B02,083780,Greenfeld; Be'Eri,4,0,36,32
1657594027632,MATH 103A,B03,093562,Greenfeld; Be'Eri,3,0,36,33
1657594033660,MATH 105,A01,085443,Carter; Anne Toulson,15,0,35,20
1657594033660,MATH 105,A02,093477,Carter; Anne Toulson,20,0,35,15
1657594039684,MATH 109,A01,083213,Ganzberger; Geoffrey Michael,2,0,34,32
1657594039684,MATH 109,A02,083214,Ganzberger; Geoffrey Michael,4,0,34,30
1657594039684,MATH 109,A03,093478,Ganzberger; Geoffrey Michael,2,0,34,32
1657594039684,MATH 109,B01,083215,Ganzberger; Geoffrey Michael,1,0,32,31
1657594039684,MATH 109,B02,083216,Ganzberger; Geoffrey Michael,2,0,32,30
1657594039684,MATH 109,B03,093479,Ganzberger; Geoffrey Michael,8,0,32,24
1657594045714,MATH 142A,A01,083219,Chow; Bennett,7,0,32,25
1657594045714,MATH 142A,A02,083220,Chow; Bennett,10,0,32,22
1657594045714,MATH 142A,A03,093480,Chow; Bennett,9,0,32,23
1657594045714,MATH 142A,B03,093481,Chow; Bennett,8,0,32,24
1657594045714,MATH 142A,B04,093558,Chow; Bennett,13,0,32,19
1657594045714,MATH 142A,B05,093559,Chow; Bennett,6,0,32,26
1657594051736,MATH 193A,A01,083224,Rotar; Vladimir,8,0,34,26
1657594051736,MATH 193A,A02,083225,Rotar; Vladimir,9,0,34,25
1657594051736,MATH 193A,A03,083781,Rotar; Vladimir,5,0,34,29
1657594051736,MATH 193A,A04,083782,Rotar; Vladimir,10,0,34,24
1657594051736,MATH 193A,A05,093482,Rotar; Vladimir,10,0,34,24
1657594057762,MATH 197,001,091859,McAuley; Julian John,9999,0,9999,0
1657594057762,MATH 197,002,095566,Kedlaya; Kiran S.,9997,0,9999,2
1657594057762,MATH 197,003,095567,Xiao; Ming,9999,0,9999,0
1657594057762,MATH 197,004,095571,Perols; Johan Lars,9998,0,9999,1
1657594064815,COGS 9,A01,083615,Shannon; Kyle Michael,9,0,75,66
1657594070841,COGS 11,A01,083617,Boyle; Mary E. T.,23,0,48,25
1657594076867,COGS 13,A01,083071,Bastos; Amalia Pinkusfeld,11,0,71,60
1657594082895,COGS 14A,A01,092681,Semenuks; Arturs,5,1,100,95
1657594088917,COGS 14B,A01,083073,Cheng; Tzu-Han,6,0,63,57
1657594094939,COGS 17,A01,092677,Semenuks; Arturs,6,0,81,75
1657594100961,COGS 100,A01,083619,Allen; Michael Gordon,17,0,70,53
1657594106987,COGS 101A,A01,083621,Davis; Joshua Daniel,9,0,68,59
1657594113012,COGS 101B,A01,091572,Allen; Michael Gordon,12,0,65,53
1657594119034,COGS 101C,A01,083625,Delgado; Tania,17,0,35,18
1657594125059,COGS 107A,A01,083627,Boyle; Mary E. T.,13,0,60,47
1657594131082,COGS 118A,A01,083075,Gupta; Anjum,21,0,76,55
1657594137109,CSE 3,A50,083646,Miranda; Gregory Joseph,24,0,50,26
1657594143133,CSE 8A,A50,083650,Miranda; Gregory Joseph,17,1,56,39
1657594149157,CSE 11,A01,083080,Cao; Yingjun,6,15,40,34
1657594155179,CSE 12,A01,083652,Krause-Levy; Sophia Louisa,28,1,120,92
1657594161200,CSE 15L,A01,083654,Morris; Justin Loren,9,0,50,41
1657594161200,CSE 15L,A02,083655,Morris; Justin Loren,9,0,50,41
1657594167227,CSE 20,A01,083657,Tran; Khoa Dang,39,0,80,41
1657594173250,CSE 21,A01,095574,Bach; Quang Tran,22,0,48,26
1657594179274,CSE 30,A01,083084,Eldon; John,5,0,80,75
1657594179274,CSE 30,B01,095061,Bhaskar; Nishant,9,0,50,41
1657594185298,CSE 100,A01,083659,Cao; Yingjun,5,4,70,65
1657594191320,CSE 134B,A01,083661,Powell; Thomas Allan,22,0,100,78
1657594197348,CSE 140,A01,083663,Gungor; Onat,15,0,85,70
1657594203377,CSE 140L,A01,083088,Eldon; John,21,0,100,79
1657594209402,CSE 175,A01,083665,Kumar; Rakesh,3,0,25,22
1657594215425,CSE 190,A00,092507,Dubnov; Shlomo,8,0,20,12
1657594221447,ECE 45,A01,083139,Congero; Spencer William,6,0,75,69
1657594227469,ECE 65,A50,083695,Saad; Andrew S,12,0,30,18
1657594227469,ECE 65,A51,095125,Saad; Andrew S,24,0,26,2
1657594233500,ECE 109,A01,091882,Touri; Behrouz,19,0,70,51
1657594239528,ECE 180,A00,083140,Abi Samra; Nicholas Camill,1,0,30,29
1657594239528,ECE 180,B00,083141,Abi Samra; Nicholas Camill,0,0,30,30
1657594245550,MATH 10A,A01,083735,Patchell; Gregory David,2,0,30,28
1657594245550,MATH 10A,A02,083736,Patchell; Gregory David,20,0,30,10
1657594245550,MATH 10A,A03,083737,Patchell; Gregory David,16,0,30,14
1657594251579,MATH 10B,A01,083207,Lim; Seonhee,8,0,34,26
1657594251579,MATH 10B,A02,083208,Lim; Seonhee,9,0,35,26
1657594251579,MATH 10B,A03,093472,Lim; Seonhee,7,0,34,27
1657594251579,MATH 10B,B01,083739,Sinha; Shubham,12,0,30,18
1657594257611,MATH 18,A01,083743,Cinel; Cameron Alexander,7,0,30,23
1657594257611,MATH 18,A02,083744,Cinel; Cameron Alexander,17,0,30,13
1657594257611,MATH 18,A03,083745,Cinel; Cameron Alexander,9,0,30,21
1657594257611,MATH 18,B01,083748,Rideout; David Porter,5,0,37,32
1657594257611,MATH 18,B02,083749,Rideout; David Porter,5,0,36,31
1657594257611,MATH 18,B03,083750,Rideout; David Porter,3,0,37,34
1657594257611,MATH 18,B04,083751,Rideout; David Porter,6,0,36,30
1657594257611,MATH 18,B05,093473,Rideout; David Porter,6,0,36,30
1657594257611,MATH 18,B06,093474,Rideout; David Porter,6,0,36,30
1657594263641,MATH 20A,A01,083754,Zheng; Zequn,14,0,40,26
1657594269667,MATH 20B,A01,083756,Briones; Jor-el Thomas Caparas,4,0,36,32
1657594269667,MATH 20B,A02,083757,Briones; Jor-el Thomas Caparas,1,0,36,35
1657594269667,MATH 20B,A03,093475,Briones; Jor-el Thomas Caparas,2,0,36,34
1657594275718,MATH 20C,A01,083760,Briones; Jor-el Thomas Caparas,1,0,35,34
1657594275718,MATH 20C,A02,083761,Briones; Jor-el Thomas Caparas,8,0,35,27
1657594275718,MATH 20C,A03,093476,Briones; Jor-el Thomas Caparas,0,1,36,36
1657594275718,MATH 20C,B01,083762,Bach; Quang Tran,1,0,30,29
1657594281742,MATH 20D,A01,083765,Tran; Brian Kha,5,0,30,25
1657594281742,MATH 20D,A02,083766,Tran; Brian Kha,5,0,30,25
1657594281742,MATH 20D,A03,083767,Tran; Brian Kha,5,0,30,25
1657594287776,MATH 20E,A01,083771,Ganguly; Soumya,9,0,32,23
1657594287776,MATH 20E,A02,083772,Ganguly; Soumya,6,0,32,26
1657594287776,MATH 20E,B01,083773,Ciotti; Benjamin,20,0,35,15
1657594287776,MATH 20E,B02,083774,Ciotti; Benjamin,18,0,35,17
1657594293799,MATH 103A,A01,083777,Greenfeld; Be'Eri,3,0,36,33
1657594293799,MATH 103A,A02,083778,Greenfeld; Be'Eri,5,0,36,31
1657594293799,MATH 103A,A03,093561,Greenfeld; Be'Eri,6,0,36,30
1657594293799,MATH 103A,B01,083779,Greenfeld; Be'Eri,7,0,36,29
1657594293799,MATH 103A,B02,083780,Greenfeld; Be'Eri,4,0,36,32
1657594293799,MATH 103A,B03,093562,Greenfeld; Be'Eri,3,0,36,33
1657594299822,MATH 105,A01,085443,Carter; Anne Toulson,15,0,35,20
1657594299822,MATH 105,A02,093477,Carter; Anne Toulson,20,0,35,15
1657594305847,MATH 109,A01,083213,Ganzberger; Geoffrey Michael,2,0,34,32
1657594305847,MATH 109,A02,083214,Ganzberger; Geoffrey Michael,4,0,34,30
1657594305847,MATH 109,A03,093478,Ganzberger; Geoffrey Michael,2,0,34,32
1657594305847,MATH 109,B01,083215,Ganzberger; Geoffrey Michael,1,0,32,31
1657594305847,MATH 109,B02,083216,Ganzberger; Geoffrey Michael,2,0,32,30
1657594305847,MATH 109,B03,093479,Ganzberger; Geoffrey Michael,8,0,32,24
1657594311884,MATH 142A,A01,083219,Chow; Bennett,7,0,32,25
1657594311884,MATH 142A,A02,083220,Chow; Bennett,10,0,32,22
1657594311884,MATH 142A,A03,093480,Chow; Bennett,9,0,32,23
1657594311884,MATH 142A,B03,093481,Chow; Bennett,8,0,32,24
1657594311884,MATH 142A,B04,093558,Chow; Bennett,13,0,32,19
1657594311884,MATH 142A,B05,093559,Chow; Bennett,6,0,32,26
1657594317911,MATH 193A,A01,083224,Rotar; Vladimir,8,0,34,26
1657594317911,MATH 193A,A02,083225,Rotar; Vladimir,9,0,34,25
1657594317911,MATH 193A,A03,083781,Rotar; Vladimir,5,0,34,29
1657594317911,MATH 193A,A04,083782,Rotar; Vladimir,10,0,34,24
1657594317911,MATH 193A,A05,093482,Rotar; Vladimir,10,0,34,24
1657594323937,MATH 197,001,091859,McAuley; Julian John,9999,0,9999,0
1657594323937,MATH 197,002,095566,Kedlaya; Kiran S.,9997,0,9999,2
1657594323937,MATH 197,003,095567,Xiao; Ming,9999,0,9999,0
1657594323937,MATH 197,004,095571,Perols; Johan Lars,9998,0,9999,1
1657594330985,COGS 9,A01,083615,Shannon; Kyle Michael,9,0,75,66
1657594337010,COGS 11,A01,083617,Boyle; Mary E. T.,23,0,48,25
1657594343036,COGS 13,A01,083071,Bastos; Amalia Pinkusfeld,11,0,71,60
1657594349062,COGS 14A,A01,092681,Semenuks; Arturs,5,1,100,95
1657594355088,COGS 14B,A01,083073,Cheng; Tzu-Han,6,0,63,57
1657594361123,COGS 17,A01,092677,Semenuks; Arturs,6,0,81,75
1657594367149,COGS 100,A01,083619,Allen; Michael Gordon,17,0,70,53
1657594373178,COGS 101A,A01,083621,Davis; Joshua Daniel,9,0,68,59
1657594379205,COGS 101B,A01,091572,Allen; Michael Gordon,12,0,65,53
1657594385229,COGS 101C,A01,083625,Delgado; Tania,17,0,35,18
1657594391255,COGS 107A,A01,083627,Boyle; Mary E. T.,13,0,60,47
1657594397276,COGS 118A,A01,083075,Gupta; Anjum,21,0,76,55
1657594403303,CSE 3,A50,083646,Miranda; Gregory Joseph,24,0,50,26
1657594409326,CSE 8A,A50,083650,Miranda; Gregory Joseph,17,1,56,39
1657594415349,CSE 11,A01,083080,Cao; Yingjun,6,15,40,34
1657594421385,CSE 12,A01,083652,Krause-Levy; Sophia Louisa,28,1,120,92
1657594427412,CSE 15L,A01,083654,Morris; Justin Loren,9,0,50,41
1657594427412,CSE 15L,A02,083655,Morris; Justin Loren,9,0,50,41
1657594433433,CSE 20,A01,083657,Tran; Khoa Dang,39,0,80,41
1657594444664,CSE 21,A01,095574,Bach; Quang Tran,22,0,48,26
1657594450689,CSE 30,A01,083084,Eldon; John,5,0,80,75
1657594450689,CSE 30,B01,095061,Bhaskar; Nishant,9,0,50,41
1657594456714,CSE 100,A01,083659,Cao; Yingjun,5,4,70,65
1657594462739,CSE 134B,A01,083661,Powell; Thomas Allan,22,0,100,78
1657594468762,CSE 140,A01,083663,Gungor; Onat,15,0,85,70
1657594474783,CSE 140L,A01,083088,Eldon; John,21,0,100,79
1657594480809,CSE 175,A01,083665,Kumar; Rakesh,3,0,25,22
1657594486834,CSE 190,A00,092507,Dubnov; Shlomo,8,0,20,12
1657594492867,ECE 45,A01,083139,Congero; Spencer William,6,0,75,69
1657594498893,ECE 65,A50,083695,Saad; Andrew S,12,0,30,18
1657594498893,ECE 65,A51,095125,Saad; Andrew S,24,0,26,2
1657594504916,ECE 109,A01,091882,Touri; Behrouz,19,0,70,51
1657594511015,ECE 180,A00,083140,Abi Samra; Nicholas Camill,1,0,30,29
1657594511015,ECE 180,B00,083141,Abi Samra; Nicholas Camill,0,0,30,30
1657594517042,MATH 10A,A01,083735,Patchell; Gregory David,2,0,30,28
1657594517042,MATH 10A,A02,083736,Patchell; Gregory David,20,0,30,10
1657594517042,MATH 10A,A03,083737,Patchell; Gregory David,16,0,30,14
1657594523065,MATH 10B,A01,083207,Lim; Seonhee,8,0,34,26
1657594523065,MATH 10B,A02,083208,Lim; Seonhee,9,0,35,26
1657594523065,MATH 10B,A03,093472,Lim; Seonhee,7,0,34,27
1657594523065,MATH 10B,B01,083739,Sinha; Shubham,12,0,30,18
1657594529088,MATH 18,A01,083743,Cinel; Cameron Alexander,7,0,30,23
1657594529088,MATH 18,A02,083744,Cinel; Cameron Alexander,17,0,30,13
1657594529088,MATH 18,A03,083745,Cinel; Cameron Alexander,9,0,30,21
1657594529088,MATH 18,B01,083748,Rideout; David Porter,5,0,37,32
1657594529088,MATH 18,B02,083749,Rideout; David Porter,5,0,36,31
1657594529088,MATH 18,B03,083750,Rideout; David Porter,3,0,37,34
1657594529088,MATH 18,B04,083751,Rideout; David Porter,6,0,36,30
1657594529088,MATH 18,B05,093473,Rideout; David Porter,6,0,36,30
1657594529088,MATH 18,B06,093474,Rideout; David Porter,6,0,36,30
1657594535120,MATH 20A,A01,083754,Zheng; Zequn,14,0,40,26
1657594541148,MATH 20B,A01,083756,Briones; Jor-el Thomas Caparas,4,0,36,32
1657594541148,MATH 20B,A02,083757,Briones; Jor-el Thomas Caparas,1,0,36,35
1657594541148,MATH 20B,A03,093475,Briones; Jor-el Thomas Caparas,2,0,36,34
1657594547171,MATH 20C,A01,083760,Briones; Jor-el Thomas Caparas,1,0,35,34
1657594547171,MATH 20C,A02,083761,Briones; Jor-el Thomas Caparas,8,0,35,27
1657594547171,MATH 20C,A03,093476,Briones; Jor-el Thomas Caparas,0,1,36,36
1657594547171,MATH 20C,B01,083762,Bach; Quang Tran,1,0,30,29
1657594553195,MATH 20D,A01,083765,Tran; Brian Kha,5,0,30,25
1657594553195,MATH 20D,A02,083766,Tran; Brian Kha,5,0,30,25
1657594553195,MATH 20D,A03,083767,Tran; Brian Kha,5,0,30,25
1657594559223,MATH 20E,A01,083771,Ganguly; Soumya,9,0,32,23
1657594559223,MATH 20E,A02,083772,Ganguly; Soumya,6,0,32,26
1657594559223,MATH 20E,B01,083773,Ciotti; Benjamin,20,0,35,15
1657594559223,MATH 20E,B02,083774,Ciotti; Benjamin,18,0,35,17
1657594565254,MATH 103A,A01,083777,Greenfeld; Be'Eri,3,0,36,33
1657594565254,MATH 103A,A02,083778,Greenfeld; Be'Eri,5,0,36,31
1657594565254,MATH 103A,A03,093561,Greenfeld; Be'Eri,6,0,36,30
1657594565254,MATH 103A,B01,083779,Greenfeld; Be'Eri,7,0,36,29
1657594565254,MATH 103A,B02,083780,Greenfeld; Be'Eri,4,0,36,32
1657594565254,MATH 103A,B03,093562,Greenfeld; Be'Eri,3,0,36,33
1657594571276,MATH 105,A01,085443,Carter; Anne Toulson,15,0,35,20
1657594571276,MATH 105,A02,093477,Carter; Anne Toulson,20,0,35,15
1657594577307,MATH 109,A01,083213,Ganzberger; Geoffrey Michael,2,0,34,32
1657594577307,MATH 109,A02,083214,Ganzberger; Geoffrey Michael,4,0,34,30
1657594577307,MATH 109,A03,093478,Ganzberger; Geoffrey Michael,2,0,34,32
1657594577307,MATH 109,B01,083215,Ganzberger; Geoffrey Michael,1,0,32,31
1657594577307,MATH 109,B02,083216,Ganzberger; Geoffrey Michael,2,0,32,30
1657594577307,MATH 109,B03,093479,Ganzberger; Geoffrey Michael,8,0,32,24
1657594583338,MATH 142A,A01,083219,Chow; Bennett,7,0,32,25
1657594583338,MATH 142A,A02,083220,Chow; Bennett,10,0,32,22
1657594583338,MATH 142A,A03,093480,Chow; Bennett,9,0,32,23
1657594583338,MATH 142A,B03,093481,Chow; Bennett,8,0,32,24
1657594583338,MATH 142A,B04,093558,Chow; Bennett,13,0,32,19
1657594583338,MATH 142A,B05,093559,Chow; Bennett,6,0,32,26
1657594589375,MATH 193A,A01,083224,Rotar; Vladimir,8,0,34,26
1657594589375,MATH 193A,A02,083225,Rotar; Vladimir,9,0,34,25
1657594589375,MATH 193A,A03,083781,Rotar; Vladimir,5,0,34,29
1657594589375,MATH 193A,A04,083782,Rotar; Vladimir,10,0,34,24
1657594589375,MATH 193A,A05,093482,Rotar; Vladimir,10,0,34,24
1657594595398,MATH 197,001,091859,McAuley; Julian John,9999,0,9999,0
1657594595398,MATH 197,002,095566,Kedlaya; Kiran S.,9997,0,9999,2
1657594595398,MATH 197,003,095567,Xiao; Ming,9999,0,9999,0
1657594595398,MATH 197,004,095571,Perols; Johan Lars,9998,0,9999,1
1657594602457,COGS 9,A01,083615,Shannon; Kyle Michael,9,0,75,66
1657594608484,COGS 11,A01,083617,Boyle; Mary E. T.,23,0,48,25
1657594614506,COGS 13,A01,083071,Bastos; Amalia Pinkusfeld,11,0,71,60
1657594620535,COGS 14A,A01,092681,Semenuks; Arturs,5,1,100,95
1657594626557,COGS 14B,A01,083073,Cheng; Tzu-Han,6,0,63,57
1657594632582,COGS 17,A01,092677,Semenuks; Arturs,6,0,81,75
1657594638604,COGS 100,A01,083619,Allen; Michael Gordon,17,0,70,53
1657594644632,COGS 101A,A01,083621,Davis; Joshua Daniel,9,0,68,59
1657594650660,COGS 101B,A01,091572,Allen; Michael Gordon,12,0,65,53
1657594656686,COGS 101C,A01,083625,Delgado; Tania,17,0,35,18
1657594662718,COGS 107A,A01,083627,Boyle; Mary E. T.,13,0,60,47
1657594668741,COGS 118A,A01,083075,Gupta; Anjum,21,0,76,55
1657594674769,CSE 3,A50,083646,Miranda; Gregory Joseph,24,0,50,26
1657594680797,CSE 8A,A50,083650,Miranda; Gregory Joseph,17,1,56,39
1657594686823,CSE 11,A01,083080,Cao; Yingjun,6,15,40,34
1657594692849,CSE 12,A01,083652,Krause-Levy; Sophia Louisa,28,1,120,92
1657594698875,CSE 15L,A01,083654,Morris; Justin Loren,9,0,50,41
1657594698875,CSE 15L,A02,083655,Morris; Justin Loren,9,0,50,41
1657594704903,CSE 20,A01,083657,Tran; Khoa Dang,39,0,80,41
1657594710928,CSE 21,A01,095574,Bach; Quang Tran,22,0,48,26
1657594716951,CSE 30,A01,083084,Eldon; John,5,0,80,75
1657594716951,CSE 30,B01,095061,Bhaskar; Nishant,9,0,50,41
1657594722985,CSE 100,A01,083659,Cao; Yingjun,5,4,70,65
1657594729007,CSE 134B,A01,083661,Powell; Thomas Allan,22,0,100,78
1657594735032,CSE 140,A01,083663,Gungor; Onat,15,0,85,70
1657594741058,CSE 140L,A01,083088,Eldon; John,21,0,100,79
1657594747081,CSE 175,A01,083665,Kumar; Rakesh,3,0,25,22
1657594753105,CSE 190,A00,092507,Dubnov; Shlomo,8,0,20,12
1657594759133,ECE 45,A01,083139,Congero; Spencer William,6,0,75,69
1657594765179,ECE 65,A50,083695,Saad; Andrew S,12,0,30,18
1657594765179,ECE 65,A51,095125,Saad; Andrew S,24,0,26,2
1657594771203,ECE 109,A01,091882,Touri; Behrouz,19,0,70,51
1657594777227,ECE 180,A00,083140,Abi Samra; Nicholas Camill,1,0,30,29
1657594777227,ECE 180,B00,083141,Abi Samra; Nicholas Camill,0,0,30,30
1657594783250,MATH 10A,A01,083735,Patchell; Gregory David,2,0,30,28
1657594783250,MATH 10A,A02,083736,Patchell; Gregory David,20,0,30,10
1657594783250,MATH 10A,A03,083737,Patchell; Gregory David,16,0,30,14
1657594789273,MATH 10B,A01,083207,Lim; Seonhee,8,0,34,26
1657594789273,MATH 10B,A02,083208,Lim; Seonhee,9,0,35,26
1657594789273,MATH 10B,A03,093472,Lim; Seonhee,7,0,34,27
1657594789273,MATH 10B,B01,083739,Sinha; Shubham,12,0,30,18
1657594795297,MATH 18,A01,083743,Cinel; Cameron Alexander,7,0,30,23
1657594795297,MATH 18,A02,083744,Cinel; Cameron Alexander,17,0,30,13
1657594795297,MATH 18,A03,083745,Cinel; Cameron Alexander,9,0,30,21
1657594795297,MATH 18,B01,083748,Rideout; David Porter,5,0,37,32
1657594795297,MATH 18,B02,083749,Rideout; David Porter,5,0,36,31
1657594795297,MATH 18,B03,083750,Rideout; David Porter,3,0,37,34
1657594795297,MATH 18,B04,083751,Rideout; David Porter,6,0,36,30
1657594795297,MATH 18,B05,093473,Rideout; David Porter,6,0,36,30
1657594795297,MATH 18,B06,093474,Rideout; David Porter,6,0,36,30
1657594801319,MATH 20A,A01,083754,Zheng; Zequn,14,0,40,26
1657594807345,MATH 20B,A01,083756,Briones; Jor-el Thomas Caparas,4,0,36,32
1657594807345,MATH 20B,A02,083757,Briones; Jor-el Thomas Caparas,1,0,36,35
1657594807345,MATH 20B,A03,093475,Briones; Jor-el Thomas Caparas,2,0,36,34
1657594813368,MATH 20C,A01,083760,Briones; Jor-el Thomas Caparas,1,0,35,34
1657594813368,MATH 20C,A02,083761,Briones; Jor-el Thomas Caparas,8,0,35,27
1657594813368,MATH 20C,A03,093476,Briones; Jor-el Thomas Caparas,0,1,36,36
1657594813368,MATH 20C,B01,083762,Bach; Quang Tran,1,0,30,29
1657594819391,MATH 20D,A01,083765,Tran; Brian Kha,5,0,30,25
1657594819391,MATH 20D,A02,083766,Tran; Brian Kha,5,0,30,25
1657594819391,MATH 20D,A03,083767,Tran; Brian Kha,5,0,30,25
1657594825413,MATH 20E,A01,083771,Ganguly; Soumya,9,0,32,23
1657594825413,MATH 20E,A02,083772,Ganguly; Soumya,6,0,32,26
1657594825413,MATH 20E,B01,083773,Ciotti; Benjamin,20,0,35,15
1657594825413,MATH 20E,B02,083774,Ciotti; Benjamin,18,0,35,17
1657594831437,MATH 103A,A01,083777,Greenfeld; Be'Eri,3,0,36,33
1657594831437,MATH 103A,A02,083778,Greenfeld; Be'Eri,5,0,36,31
1657594831437,MATH 103A,A03,093561,Greenfeld; Be'Eri,6,0,36,30
1657594831437,MATH 103A,B01,083779,Greenfeld; Be'Eri,7,0,36,29
1657594831437,MATH 103A,B02,083780,Greenfeld; Be'Eri,4,0,36,32
1657594831437,MATH 103A,B03,093562,Greenfeld; Be'Eri,3,0,36,33
1657594837464,MATH 105,A01,085443,Carter; Anne Toulson,15,0,35,20
1657594837464,MATH 105,A02,093477,Carter; Anne Toulson,20,0,35,15
1657594843486,MATH 109,A01,083213,Ganzberger; Geoffrey Michael,2,0,34,32
1657594843486,MATH 109,A02,083214,Ganzberger; Geoffrey Michael,4,0,34,30
1657594843486,MATH 109,A03,093478,Ganzberger; Geoffrey Michael,2,0,34,32
1657594843486,MATH 109,B01,083215,Ganzberger; Geoffrey Michael,1,0,32,31
1657594843486,MATH 109,B02,083216,Ganzberger; Geoffrey Michael,2,0,32,30
1657594843486,MATH 109,B03,093479,Ganzberger; Geoffrey Michael,8,0,32,24
1657594849510,MATH 142A,A01,083219,Chow; Bennett,7,0,32,25
1657594849510,MATH 142A,A02,083220,Chow; Bennett,10,0,32,22
1657594849510,MATH 142A,A03,093480,Chow; Bennett,9,0,32,23
1657594849510,MATH 142A,B03,093481,Chow; Bennett,8,0,32,24
1657594849510,MATH 142A,B04,093558,Chow; Bennett,13,0,32,19
1657594849510,MATH 142A,B05,093559,Chow; Bennett,6,0,32,26
1657594855538,MATH 193A,A01,083224,Rotar; Vladimir,8,0,34,26
1657594855538,MATH 193A,A02,083225,Rotar; Vladimir,9,0,34,25
1657594855538,MATH 193A,A03,083781,Rotar; Vladimir,5,0,34,29
1657594855538,MATH 193A,A04,083782,Rotar; Vladimir,10,0,34,24
1657594855538,MATH 193A,A05,093482,Rotar; Vladimir,10,0,34,24
1657594861561,MATH 197,001,091859,McAuley; Julian John,9999,0,9999,0
1657594861561,MATH 197,002,095566,Kedlaya; Kiran S.,9997,0,9999,2
1657594861561,MATH 197,003,095567,Xiao; Ming,9999,0,9999,0
1657594861561,MATH 197,004,095571,Perols; Johan Lars,9998,0,9999,1
1657594868616,COGS 9,A01,083615,Shannon; Kyle Michael,9,0,75,66
1657594874638,COGS 11,A01,083617,Boyle; Mary E. T.,23,0,48,25
1657594880675,COGS 13,A01,083071,Bastos; Amalia Pinkusfeld,11,0,71,60
1657594886698,COGS 14A,A01,092681,Semenuks; Arturs,5,1,100,95
1657594892724,COGS 14B,A01,083073,Cheng; Tzu-Han,6,0,63,57
1657594898759,COGS 17,A01,092677,Semenuks; Arturs,6,0,81,75
1657594904782,COGS 100,A01,083619,Allen; Michael Gordon,17,0,70,53
1657594910805,COGS 101A,A01,083621,Davis; Joshua Daniel,9,0,68,59
1657594916829,COGS 101B,A01,091572,Allen; Michael Gordon,12,0,65,53
1657594922861,COGS 101C,A01,083625,Delgado; Tania,17,0,35,18
1657594928890,COGS 107A,A01,083627,Boyle; Mary E. T.,13,0,60,47
1657594934912,COGS 118A,A01,083075,Gupta; Anjum,21,0,76,55
1657594940940,CSE 3,A50,083646,Miranda; Gregory Joseph,24,0,50,26
1657594946961,CSE 8A,A50,083650,Miranda; Gregory Joseph,17,1,56,39
1657594952992,CSE 11,A01,083080,Cao; Yingjun,6,15,40,34
1657594959020,CSE 12,A01,083652,Krause-Levy; Sophia Louisa,28,1,120,92
1657594965047,CSE 15L,A01,083654,Morris; Justin Loren,9,0,50,41
1657594965047,CSE 15L,A02,083655,Morris; Justin Loren,9,0,50,41
1657594971071,CSE 20,A01,083657,Tran; Khoa Dang,39,0,80,41
1657594977097,CSE 21,A01,095574,Bach; Quang Tran,22,0,48,26
1657594983123,CSE 30,A01,083084,Eldon; John,5,0,80,75
1657594983123,CSE 30,B01,095061,Bhaskar; Nishant,9,0,50,41
1657594989149,CSE 100,A01,083659,Cao; Yingjun,5,4,70,65
1657594995172,CSE 134B,A01,083661,Powell; Thomas Allan,22,0,100,78
1657595001195,CSE 140,A01,083663,Gungor; Onat,15,0,85,70
1657595007219,CSE 140L,A01,083088,Eldon; John,21,0,100,79
1657595013251,CSE 175,A01,083665,Kumar; Rakesh,3,0,25,22
1657595019278,CSE 190,A00,092507,Dubnov; Shlomo,8,0,20,12
1657595025304,ECE 45,A01,083139,Congero; Spencer William,6,0,75,69
1657595031335,ECE 65,A50,083695,Saad; Andrew S,12,0,30,18
1657595031335,ECE 65,A51,095125,Saad; Andrew S,24,0,26,2
1657595037359,ECE 109,A01,091882,Touri; Behrouz,19,0,70,51
1657595043384,ECE 180,A00,083140,Abi Samra; Nicholas Camill,1,0,30,29
1657595043384,ECE 180,B00,083141,Abi Samra; Nicholas Camill,0,0,30,30
1657595049412,MATH 10A,A01,083735,Patchell; Gregory David,2,0,30,28
1657595049412,MATH 10A,A02,083736,Patchell; Gregory David,20,0,30,10
1657595049412,MATH 10A,A03,083737,Patchell; Gregory David,16,0,30,14
1657595055434,MATH 10B,A01,083207,Lim; Seonhee,8,0,34,26
1657595055434,MATH 10B,A02,083208,Lim; Seonhee,9,0,35,26
1657595055434,MATH 10B,A03,093472,Lim; Seonhee,7,0,34,27
1657595055434,MATH 10B,B01,083739,Sinha; Shubham,12,0,30,18
1657595061460,MATH 18,A01,083743,Cinel; Cameron Alexander,7,0,30,23
1657595061460,MATH 18,A02,083744,Cinel; Cameron Alexander,17,0,30,13
1657595061460,MATH 18,A03,083745,Cinel; Cameron Alexander,9,0,30,21
1657595061460,MATH 18,B01,083748,Rideout; David Porter,5,0,37,32
1657595061460,MATH 18,B02,083749,Rideout; David Porter,5,0,36,31
1657595061460,MATH 18,B03,083750,Rideout; David Porter,3,0,37,34
1657595061460,MATH 18,B04,083751,Rideout; David Porter,6,0,36,30
1657595061460,MATH 18,B05,093473,Rideout; David Porter,6,0,36,30
1657595061460,MATH 18,B06,093474,Rideout; David Porter,6,0,36,30
1657595067482,MATH 20A,A01,083754,Zheng; Zequn,14,0,40,26
1657595073506,MATH 20B,A01,083756,Briones; Jor-el Thomas Caparas,4,0,36,32
1657595073506,MATH 20B,A02,083757,Briones; Jor-el Thomas Caparas,1,0,36,35
1657595073506,MATH 20B,A03,093475,Briones; Jor-el Thomas Caparas,2,0,36,34
1657595079531,MATH 20C,A01,083760,Briones; Jor-el Thomas Caparas,1,0,35,34
1657595079531,MATH 20C,A02,083761,Briones; Jor-el Thomas Caparas,8,0,35,27
1657595079531,MATH 20C,A03,093476,Briones; Jor-el Thomas Caparas,0,1,36,36
1657595079531,MATH 20C,B01,083762,Bach; Quang Tran,1,0,30,29
1657595085554,MATH 20D,A01,083765,Tran; Brian Kha,5,0,30,25
1657595085554,MATH 20D,A02,083766,Tran; Brian Kha,5,0,30,25
1657595085554,MATH 20D,A03,083767,Tran; Brian Kha,5,0,30,25
1657595091578,MATH 20E,A01,083771,Ganguly; Soumya,9,0,32,23
1657595091578,MATH 20E,A02,083772,Ganguly; Soumya,6,0,32,26
1657595091578,MATH 20E,B01,083773,Ciotti; Benjamin,20,0,35,15
1657595091578,MATH 20E,B02,083774,Ciotti; Benjamin,18,0,35,17
1657595097601,MATH 103A,A01,083777,Greenfeld; Be'Eri,3,0,36,33
1657595097601,MATH 103A,A02,083778,Greenfeld; Be'Eri,5,0,36,31
1657595097601,MATH 103A,A03,093561,Greenfeld; Be'Eri,6,0,36,30
1657595097601,MATH 103A,B01,083779,Greenfeld; Be'Eri,7,0,36,29
1657595097601,MATH 103A,B02,083780,Greenfeld; Be'Eri,4,0,36,32
1657595097601,MATH 103A,B03,093562,Greenfeld; Be'Eri,3,0,36,33
1657595103628,MATH 105,A01,085443,Carter; Anne Toulson,15,0,35,20
1657595103628,MATH 105,A02,093477,Carter; Anne Toulson,20,0,35,15
1657595109728,MATH 109,A01,083213,Ganzberger; Geoffrey Michael,2,0,34,32
1657595109728,MATH 109,A02,083214,Ganzberger; Geoffrey Michael,4,0,34,30
1657595109728,MATH 109,A03,093478,Ganzberger; Geoffrey Michael,2,0,34,32
1657595109728,MATH 109,B01,083215,Ganzberger; Geoffrey Michael,1,0,32,31
1657595109728,MATH 109,B02,083216,Ganzberger; Geoffrey Michael,2,0,32,30
1657595109728,MATH 109,B03,093479,Ganzberger; Geoffrey Michael,8,0,32,24
1657595115753,MATH 142A,A01,083219,Chow; Bennett,7,0,32,25
1657595115753,MATH 142A,A02,083220,Chow; Bennett,10,0,32,22
1657595115753,MATH 142A,A03,093480,Chow; Bennett,9,0,32,23
1657595115753,MATH 142A,B03,093481,Chow; Bennett,8,0,32,24
1657595115753,MATH 142A,B04,093558,Chow; Bennett,13,0,32,19
1657595115753,MATH 142A,B05,093559,Chow; Bennett,6,0,32,26
1657595121777,MATH 193A,A01,083224,Rotar; Vladimir,8,0,34,26
1657595121777,MATH 193A,A02,083225,Rotar; Vladimir,9,0,34,25
1657595121777,MATH 193A,A03,083781,Rotar; Vladimir,5,0,34,29
1657595121777,MATH 193A,A04,083782,Rotar; Vladimir,10,0,34,24
1657595121777,MATH 193A,A05,093482,Rotar; Vladimir,10,0,34,24
1657595127800,MATH 197,001,091859,McAuley; Julian John,9999,0,9999,0
1657595127800,MATH 197,002,095566,Kedlaya; Kiran S.,9997,0,9999,2
1657595127800,MATH 197,003,095567,Xiao; Ming,9999,0,9999,0
1657595127800,MATH 197,004,095571,Perols; Johan Lars,9998,0,9999,1
1657595134873,COGS 9,A01,083615,Shannon; Kyle Michael,9,0,75,66
1657595140900,COGS 11,A01,083617,Boyle; Mary E. T.,23,0,48,25
1657595146928,COGS 13,A01,083071,Bastos; Amalia Pinkusfeld,11,0,71,60
1657595152950,COGS 14A,A01,092681,Semenuks; Arturs,5,1,100,95
1657595158976,COGS 14B,A01,083073,Cheng; Tzu-Han,6,0,63,57
1657595165002,COGS 17,A01,092677,Semenuks; Arturs,6,0,81,75
1657595171025,COGS 100,A01,083619,Allen; Michael Gordon,17,0,70,53
1657595177052,COGS 101A,A01,083621,Davis; Joshua Daniel,9,0,68,59
1657595183079,COGS 101B,A01,091572,Allen; Michael Gordon,12,0,65,53
1657595189107,COGS 101C,A01,083625,Delgado; Tania,17,0,35,18
1657595195137,COGS 107A,A01,083627,Boyle; Mary E. T.,13,0,60,47
1657595201162,COGS 118A,A01,083075,Gupta; Anjum,21,0,76,55
1657595207186,CSE 3,A50,083646,Miranda; Gregory Joseph,24,0,50,26
1657595213209,CSE 8A,A50,083650,Miranda; Gregory Joseph,17,1,56,39
1657595219237,CSE 11,A01,083080,Cao; Yingjun,6,15,40,34
1657595225272,CSE 12,A01,083652,Krause-Levy; Sophia Louisa,28,1,120,92
1657595231296,CSE 15L,A01,083654,Morris; Justin Loren,9,0,50,41
1657595231296,CSE 15L,A02,083655,Morris; Justin Loren,9,0,50,41
1657595237325,CSE 20,A01,083657,Tran; Khoa Dang,39,0,80,41
1657595243348,CSE 21,A01,095574,Bach; Quang Tran,22,0,48,26
1657595249370,CSE 30,A01,083084,Eldon; John,5,0,80,75
1657595249370,CSE 30,B01,095061,Bhaskar; Nishant,9,0,50,41
1657595255394,CSE 100,A01,083659,Cao; Yingjun,5,4,70,65
1657595261422,CSE 134B,A01,083661,Powell; Thomas Allan,22,0,100,78
1657595267447,CSE 140,A01,083663,Gungor; Onat,15,0,85,70
1657595273480,CSE 140L,A01,083088,Eldon; John,21,0,100,79
1657595279504,CSE 175,A01,083665,Kumar; Rakesh,3,0,25,22
1657595285528,CSE 190,A00,092507,Dubnov; Shlomo,8,0,20,12
1657595291550,ECE 45,A01,083139,Congero; Spencer William,6,0,75,69
1657595297585,ECE 65,A50,083695,Saad; Andrew S,12,0,30,18
1657595297585,ECE 65,A51,095125,Saad; Andrew S,24,0,26,2
1657595303608,ECE 109,A01,091882,Touri; Behrouz,19,0,70,51
1657595309630,ECE 180,A00,083140,Abi Samra; Nicholas Camill,1,0,30,29
1657595309630,ECE 180,B00,083141,Abi Samra; Nicholas Camill,0,0,30,30
1657595315657,MATH 10A,A01,083735,Patchell; Gregory David,2,0,30,28
1657595315657,MATH 10A,A02,083736,Patchell; Gregory David,20,0,30,10
1657595315657,MATH 10A,A03,083737,Patchell; Gregory David,16,0,30,14
1657595321692,MATH 10B,A01,083207,Lim; Seonhee,8,0,34,26
1657595321692,MATH 10B,A02,083208,Lim; Seonhee,9,0,35,26
1657595321692,MATH 10B,A03,093472,Lim; Seonhee,7,0,34,27
1657595321692,MATH 10B,B01,083739,Sinha; Shubham,12,0,30,18
1657595327730,MATH 18,A01,083743,Cinel; Cameron Alexander,7,0,30,23
1657595327730,MATH 18,A02,083744,Cinel; Cameron Alexander,17,0,30,13
1657595327730,MATH 18,A03,083745,Cinel; Cameron Alexander,9,0,30,21
1657595327730,MATH 18,B01,083748,Rideout; David Porter,5,0,37,32
1657595327730,MATH 18,B02,083749,Rideout; David Porter,5,0,36,31
1657595327730,MATH 18,B03,083750,Rideout; David Porter,3,0,37,34
1657595327730,MATH 18,B04,083751,Rideout; David Porter,6,0,36,30
1657595327730,MATH 18,B05,093473,Rideout; David Porter,6,0,36,30
1657595327730,MATH 18,B06,093474,Rideout; David Porter,6,0,36,30
1657595333759,MATH 20A,A01,083754,Zheng; Zequn,14,0,40,26
1657595339783,MATH 20B,A01,083756,Briones; Jor-el Thomas Caparas,4,0,36,32
1657595339783,MATH 20B,A02,083757,Briones; Jor-el Thomas Caparas,1,0,36,35
1657595339783,MATH 20B,A03,093475,Briones; Jor-el Thomas Caparas,2,0,36,34
1657595345805,MATH 20C,A01,083760,Briones; Jor-el Thomas Caparas,1,0,35,34
1657595345805,MATH 20C,A02,083761,Briones; Jor-el Thomas Caparas,8,0,35,27
1657595345805,MATH 20C,A03,093476,Briones; Jor-el Thomas Caparas,0,1,36,36
1657595345805,MATH 20C,B01,083762,Bach; Quang Tran,1,0,30,29
1657595351848,MATH 20D,A01,083765,Tran; Brian Kha,5,0,30,25
1657595351848,MATH 20D,A02,083766,Tran; Brian Kha,5,0,30,25
1657595351848,MATH 20D,A03,083767,Tran; Brian Kha,5,0,30,25
1657595357875,MATH 20E,A01,083771,Ganguly; Soumya,9,0,32,23
1657595357875,MATH 20E,A02,083772,Ganguly; Soumya,6,0,32,26
1657595357875,MATH 20E,B01,083773,Ciotti; Benjamin,20,0,35,15
1657595357875,MATH 20E,B02,083774,Ciotti; Benjamin,18,0,35,17
1657595363899,MATH 103A,A01,083777,Greenfeld; Be'Eri,3,0,36,33
1657595363899,MATH 103A,A02,083778,Greenfeld; Be'Eri,5,0,36,31
1657595363899,MATH 103A,A03,093561,Greenfeld; Be'Eri,6,0,36,30
1657595363899,MATH 103A,B01,083779,Greenfeld; Be'Eri,7,0,36,29
1657595363899,MATH 103A,B02,083780,Greenfeld; Be'Eri,4,0,36,32
1657595363899,MATH 103A,B03,093562,Greenfeld; Be'Eri,3,0,36,33
1657595369926,MATH 105,A01,085443,Carter; Anne Toulson,15,0,35,20
1657595369926,MATH 105,A02,093477,Carter; Anne Toulson,20,0,35,15
1657595375953,MATH 109,A01,083213,Ganzberger; Geoffrey Michael,2,0,34,32
1657595375953,MATH 109,A02,083214,Ganzberger; Geoffrey Michael,4,0,34,30
1657595375953,MATH 109,A03,093478,Ganzberger; Geoffrey Michael,2,0,34,32
1657595375953,MATH 109,B01,083215,Ganzberger; Geoffrey Michael,1,0,32,31
1657595375953,MATH 109,B02,083216,Ganzberger; Geoffrey Michael,2,0,32,30
1657595375953,MATH 109,B03,093479,Ganzberger; Geoffrey Michael,8,0,32,24
1657595381982,MATH 142A,A01,083219,Chow; Bennett,7,0,32,25
1657595381982,MATH 142A,A02,083220,Chow; Bennett,10,0,32,22
1657595381982,MATH 142A,A03,093480,Chow; Bennett,9,0,32,23
1657595381982,MATH 142A,B03,093481,Chow; Bennett,8,0,32,24
1657595381982,MATH 142A,B04,093558,Chow; Bennett,13,0,32,19
1657595381982,MATH 142A,B05,093559,Chow; Bennett,6,0,32,26
1657595388019,MATH 193A,A01,083224,Rotar; Vladimir,8,0,34,26
1657595388019,MATH 193A,A02,083225,Rotar; Vladimir,9,0,34,25
1657595388019,MATH 193A,A03,083781,Rotar; Vladimir,5,0,34,29
1657595388019,MATH 193A,A04,083782,Rotar; Vladimir,10,0,34,24
1657595388019,MATH 193A,A05,093482,Rotar; Vladimir,10,0,34,24
1657595394051,MATH 197,001,091859,McAuley; Julian John,9999,0,9999,0
1657595394051,MATH 197,002,095566,Kedlaya; Kiran S.,9997,0,9999,2
1657595394051,MATH 197,003,095567,Xiao; Ming,9999,0,9999,0
1657595394051,MATH 197,004,095571,Perols; Johan Lars,9998,0,9999,1
1657595401111,COGS 9,A01,083615,Shannon; Kyle Michael,9,0,75,66
1657595407137,COGS 11,A01,083617,Boyle; Mary E. T.,23,0,48,25
1657595413169,COGS 13,A01,083071,Bastos; Amalia Pinkusfeld,11,0,71,60
1657595419192,COGS 14A,A01,092681,Semenuks; Arturs,5,1,100,95
1657595425214,COGS 14B,A01,083073,Cheng; Tzu-Han,6,0,63,57
1657595431241,COGS 17,A01,092677,Semenuks; Arturs,6,0,81,75
1657595437269,COGS 100,A01,083619,Allen; Michael Gordon,17,0,70,53
1657595443291,COGS 101A,A01,083621,Davis; Joshua Daniel,9,0,68,59
1657595449319,COGS 101B,A01,091572,Allen; Michael Gordon,12,0,65,53
1657595455358,COGS 101C,A01,083625,Delgado; Tania,17,0,35,18
1657595461385,COGS 107A,A01,083627,Boyle; Mary E. T.,13,0,60,47
1657595467407,COGS 118A,A01,083075,Gupta; Anjum,21,0,76,55
1657595473435,CSE 3,A50,083646,Miranda; Gregory Joseph,24,0,50,26
1657595479462,CSE 8A,A50,083650,Miranda; Gregory Joseph,17,1,56,39
1657595485486,CSE 11,A01,083080,Cao; Yingjun,6,15,40,34
1657595491513,CSE 12,A01,083652,Krause-Levy; Sophia Louisa,28,1,120,92
1657595497537,CSE 15L,A01,083654,Morris; Justin Loren,9,0,50,41
1657595497537,CSE 15L,A02,083655,Morris; Justin Loren,9,0,50,41
1657595503563,CSE 20,A01,083657,Tran; Khoa Dang,39,0,80,41
1657595509585,CSE 21,A01,095574,Bach; Quang Tran,22,0,48,26
1657595515610,CSE 30,A01,083084,Eldon; John,5,0,80,75
1657595515610,CSE 30,B01,095061,Bhaskar; Nishant,9,0,50,41
1657595521634,CSE 100,A01,083659,Cao; Yingjun,5,4,70,65
1657595527658,CSE 134B,A01,083661,Powell; Thomas Allan,22,0,100,78
1657595533681,CSE 140,A01,083663,Gungor; Onat,15,0,85,70
1657595539704,CSE 140L,A01,083088,Eldon; John,21,0,100,79
1657595545729,CSE 175,A01,083665,Kumar; Rakesh,3,0,25,22
1657595551752,CSE 190,A00,092507,Dubnov; Shlomo,8,0,20,12
1657595557778,ECE 45,A01,083139,Congero; Spencer William,6,0,75,69
1657595563802,ECE 65,A50,083695,Saad; Andrew S,12,0,30,18
1657595563802,ECE 65,A51,095125,Saad; Andrew S,24,0,26,2
1657595569826,ECE 109,A01,091882,Touri; Behrouz,19,0,70,51
1657595575864,ECE 180,A00,083140,Abi Samra; Nicholas Camill,1,0,30,29
1657595575864,ECE 180,B00,083141,Abi Samra; Nicholas Camill,0,0,30,30
1657595581889,MATH 10A,A01,083735,Patchell; Gregory David,2,0,30,28
1657595581889,MATH 10A,A02,083736,Patchell; Gregory David,20,0,30,10
1657595581889,MATH 10A,A03,083737,Patchell; Gregory David,16,0,30,14
1657595587911,MATH 10B,A01,083207,Lim; Seonhee,8,0,34,26
1657595587911,MATH 10B,A02,083208,Lim; Seonhee,9,0,35,26
1657595587911,MATH 10B,A03,093472,Lim; Seonhee,7,0,34,27
1657595587911,MATH 10B,B01,083739,Sinha; Shubham,12,0,30,18
1657595593950,MATH 18,A01,083743,Cinel; Cameron Alexander,7,0,30,23
1657595593950,MATH 18,A02,083744,Cinel; Cameron Alexander,17,0,30,13
1657595593950,MATH 18,A03,083745,Cinel; Cameron Alexander,9,0,30,21
1657595593950,MATH 18,B01,083748,Rideout; David Porter,5,0,37,32
1657595593950,MATH 18,B02,083749,Rideout; David Porter,5,0,36,31
1657595593950,MATH 18,B03,083750,Rideout; David Porter,3,0,37,34
1657595593950,MATH 18,B04,083751,Rideout; David Porter,6,0,36,30
1657595593950,MATH 18,B05,093473,Rideout; David Porter,6,0,36,30
1657595593950,MATH 18,B06,093474,Rideout; David Porter,6,0,36,30
1657595599973,MATH 20A,A01,083754,Zheng; Zequn,14,0,40,26
1657595606003,MATH 20B,A01,083756,Briones; Jor-el Thomas Caparas,4,0,36,32
1657595606003,MATH 20B,A02,083757,Briones; Jor-el Thomas Caparas,1,0,36,35
1657595606003,MATH 20B,A03,093475,Briones; Jor-el Thomas Caparas,2,0,36,34
1657595612029,MATH 20C,A01,083760,Briones; Jor-el Thomas Caparas,1,0,35,34
1657595612029,MATH 20C,A02,083761,Briones; Jor-el Thomas Caparas,8,0,35,27
1657595612029,MATH 20C,A03,093476,Briones; Jor-el Thomas Caparas,0,1,36,36
1657595612029,MATH 20C,B01,083762,Bach; Quang Tran,1,0,30,29
1657595618054,MATH 20D,A01,083765,Tran; Brian Kha,5,0,30,25
1657595618054,MATH 20D,A02,083766,Tran; Brian Kha,5,0,30,25
1657595618054,MATH 20D,A03,083767,Tran; Brian Kha,5,0,30,25
1657595624077,MATH 20E,A01,083771,Ganguly; Soumya,9,0,32,23
1657595624077,MATH 20E,A02,083772,Ganguly; Soumya,6,0,32,26
1657595624077,MATH 20E,B01,083773,Ciotti; Benjamin,20,0,35,15
1657595624077,MATH 20E,B02,083774,Ciotti; Benjamin,18,0,35,17
1657595630103,MATH 103A,A01,083777,Greenfeld; Be'Eri,3,0,36,33
1657595630103,MATH 103A,A02,083778,Greenfeld; Be'Eri,5,0,36,31
1657595630103,MATH 103A,A03,093561,Greenfeld; Be'Eri,6,0,36,30
1657595630103,MATH 103A,B01,083779,Greenfeld; Be'Eri,7,0,36,29
1657595630103,MATH 103A,B02,083780,Greenfeld; Be'Eri,4,0,36,32
1657595630103,MATH 103A,B03,093562,Greenfeld; Be'Eri,3,0,36,33
1657595636128,MATH 105,A01,085443,Carter; Anne Toulson,15,0,35,20
1657595636128,MATH 105,A02,093477,Carter; Anne Toulson,20,0,35,15
1657595642161,MATH 109,A01,083213,Ganzberger; Geoffrey Michael,2,0,34,32
1657595642161,MATH 109,A02,083214,Ganzberger; Geoffrey Michael,4,0,34,30
1657595642161,MATH 109,A03,093478,Ganzberger; Geoffrey Michael,2,0,34,32
1657595642161,MATH 109,B01,083215,Ganzberger; Geoffrey Michael,1,0,32,31
1657595642161,MATH 109,B02,083216,Ganzberger; Geoffrey Michael,2,0,32,30
1657595642161,MATH 109,B03,093479,Ganzberger; Geoffrey Michael,8,0,32,24
1657595648190,MATH 142A,A01,083219,Chow; Bennett,7,0,32,25
1657595648190,MATH 142A,A02,083220,Chow; Bennett,10,0,32,22
1657595648190,MATH 142A,A03,093480,Chow; Bennett,9,0,32,23
1657595648190,MATH 142A,B03,093481,Chow; Bennett,8,0,32,24
1657595648190,MATH 142A,B04,093558,Chow; Bennett,13,0,32,19
1657595648190,MATH 142A,B05,093559,Chow; Bennett,6,0,32,26
1657595654215,MATH 193A,A01,083224,Rotar; Vladimir,8,0,34,26
1657595654215,MATH 193A,A02,083225,Rotar; Vladimir,9,0,34,25
1657595654215,MATH 193A,A03,083781,Rotar; Vladimir,5,0,34,29
1657595654215,MATH 193A,A04,083782,Rotar; Vladimir,10,0,34,24
1657595654215,MATH 193A,A05,093482,Rotar; Vladimir,10,0,34,24
1657595660237,MATH 197,001,091859,McAuley; Julian John,9999,0,9999,0
1657595660237,MATH 197,002,095566,Kedlaya; Kiran S.,9997,0,9999,2
1657595660237,MATH 197,003,095567,Xiao; Ming,9999,0,9999,0
1657595660237,MATH 197,004,095571,Perols; Johan Lars,9998,0,9999,1
1657595667305,COGS 9,A01,083615,Shannon; Kyle Michael,9,0,75,66
1657595673327,COGS 11,A01,083617,Boyle; Mary E. T.,23,0,48,25
1657595679355,COGS 13,A01,083071,Bastos; Amalia Pinkusfeld,11,0,71,60
1657595685376,COGS 14A,A01,092681,Semenuks; Arturs,5,1,100,95
1657595691403,COGS 14B,A01,083073,Cheng; Tzu-Han,6,0,63,57
1657595697426,COGS 17,A01,092677,Semenuks; Arturs,6,0,81,75
1657595703540,COGS 100,A01,083619,Allen; Michael Gordon,17,0,70,53
1657595709563,COGS 101A,A01,083621,Davis; Joshua Daniel,9,0,68,59
1657595715589,COGS 101B,A01,091572,Allen; Michael Gordon,12,0,65,53
1657595721614,COGS 101C,A01,083625,Delgado; Tania,17,0,35,18
1657595727640,COGS 107A,A01,083627,Boyle; Mary E. T.,13,0,60,47
1657595733664,COGS 118A,A01,083075,Gupta; Anjum,21,0,76,55
1657595739688,CSE 3,A50,083646,Miranda; Gregory Joseph,24,0,50,26
1657595745712,CSE 8A,A50,083650,Miranda; Gregory Joseph,17,1,56,39
1657595751739,CSE 11,A01,083080,Cao; Yingjun,6,15,40,34
1657595757762,CSE 12,A01,083652,Krause-Levy; Sophia Louisa,28,1,120,92
1657595763798,CSE 15L,A01,083654,Morris; Justin Loren,9,0,50,41
1657595763798,CSE 15L,A02,083655,Morris; Justin Loren,9,0,50,41
1657595769829,CSE 20,A01,083657,Tran; Khoa Dang,39,0,80,41
1657595775856,CSE 21,A01,095574,Bach; Quang Tran,22,0,48,26
1657595781882,CSE 30,A01,083084,Eldon; John,5,0,80,75
1657595781882,CSE 30,B01,095061,Bhaskar; Nishant,9,0,50,41
1657595787913,CSE 100,A01,083659,Cao; Yingjun,5,4,70,65
1657595793935,CSE 134B,A01,083661,Powell; Thomas Allan,22,0,100,78
1657595799961,CSE 140,A01,083663,Gungor; Onat,15,0,85,70
1657595805985,CSE 140L,A01,083088,Eldon; John,21,0,100,79
1657595812007,CSE 175,A01,083665,Kumar; Rakesh,3,0,25,22
1657595818033,CSE 190,A00,092507,Dubnov; Shlomo,8,0,20,12
1657595824060,ECE 45,A01,083139,Congero; Spencer William,6,0,75,69
1657595830084,ECE 65,A50,083695,Saad; Andrew S,12,0,30,18
1657595830084,ECE 65,A51,095125,Saad; Andrew S,24,0,26,2
1657595836106,ECE 109,A01,091882,Touri; Behrouz,19,0,70,51
1657595842129,ECE 180,A00,083140,Abi Samra; Nicholas Camill,1,0,30,29
1657595842129,ECE 180,B00,083141,Abi Samra; Nicholas Camill,0,0,30,30
1657595848154,MATH 10A,A01,083735,Patchell; Gregory David,2,0,30,28
1657595848154,MATH 10A,A02,083736,Patchell; Gregory David,20,0,30,10
1657595848154,MATH 10A,A03,083737,Patchell; Gregory David,16,0,30,14
1657595854182,MATH 10B,A01,083207,Lim; Seonhee,8,0,34,26
1657595854182,MATH 10B,A02,083208,Lim; Seonhee,9,0,35,26
1657595854182,MATH 10B,A03,093472,Lim; Seonhee,7,0,34,27
1657595854182,MATH 10B,B01,083739,Sinha; Shubham,12,0,30,18
1657595860213,MATH 18,A01,083743,Cinel; Cameron Alexander,7,0,30,23
1657595860213,MATH 18,A02,083744,Cinel; Cameron Alexander,17,0,30,13
1657595860213,MATH 18,A03,083745,Cinel; Cameron Alexander,9,0,30,21
1657595860213,MATH 18,B01,083748,Rideout; David Porter,5,0,37,32
1657595860213,MATH 18,B02,083749,Rideout; David Porter,5,0,36,31
1657595860213,MATH 18,B03,083750,Rideout; David Porter,3,0,37,34
1657595860213,MATH 18,B04,083751,Rideout; David Porter,6,0,36,30
1657595860213,MATH 18,B05,093473,Rideout; David Porter,6,0,36,30
1657595860213,MATH 18,B06,093474,Rideout; David Porter,6,0,36,30
1657595866236,MATH 20A,A01,083754,Zheng; Zequn,14,0,40,26
1657595872264,MATH 20B,A01,083756,Briones; Jor-el Thomas Caparas,4,0,36,32
1657595872264,MATH 20B,A02,083757,Briones; Jor-el Thomas Caparas,1,0,36,35
1657595872264,MATH 20B,A03,093475,Briones; Jor-el Thomas Caparas,2,0,36,34
1657595878287,MATH 20C,A01,083760,Briones; Jor-el Thomas Caparas,1,0,35,34
1657595878287,MATH 20C,A02,083761,Briones; Jor-el Thomas Caparas,8,0,35,27
1657595878287,MATH 20C,A03,093476,Briones; Jor-el Thomas Caparas,0,1,36,36
1657595878287,MATH 20C,B01,083762,Bach; Quang Tran,1,0,30,29
1657595884312,MATH 20D,A01,083765,Tran; Brian Kha,5,0,30,25
1657595884312,MATH 20D,A02,083766,Tran; Brian Kha,5,0,30,25
1657595884312,MATH 20D,A03,083767,Tran; Brian Kha,5,0,30,25
1657595890337,MATH 20E,A01,083771,Ganguly; Soumya,9,0,32,23
1657595890337,MATH 20E,A02,083772,Ganguly; Soumya,6,0,32,26
1657595890337,MATH 20E,B01,083773,Ciotti; Benjamin,20,0,35,15
1657595890337,MATH 20E,B02,083774,Ciotti; Benjamin,18,0,35,17
1657595896359,MATH 103A,A01,083777,Greenfeld; Be'Eri,3,0,36,33
1657595896359,MATH 103A,A02,083778,Greenfeld; Be'Eri,5,0,36,31
1657595896359,MATH 103A,A03,093561,Greenfeld; Be'Eri,6,0,36,30
1657595896359,MATH 103A,B01,083779,Greenfeld; Be'Eri,7,0,36,29
1657595896359,MATH 103A,B02,083780,Greenfeld; Be'Eri,4,0,36,32
1657595896359,MATH 103A,B03,093562,Greenfeld; Be'Eri,3,0,36,33
1657595902383,MATH 105,A01,085443,Carter; Anne Toulson,15,0,35,20
1657595902383,MATH 105,A02,093477,Carter; Anne Toulson,20,0,35,15
1657595908406,MATH 109,A01,083213,Ganzberger; Geoffrey Michael,2,0,34,32
1657595908406,MATH 109,A02,083214,Ganzberger; Geoffrey Michael,4,0,34,30
1657595908406,MATH 109,A03,093478,Ganzberger; Geoffrey Michael,2,0,34,32
1657595908406,MATH 109,B01,083215,Ganzberger; Geoffrey Michael,1,0,32,31
1657595908406,MATH 109,B02,083216,Ganzberger; Geoffrey Michael,2,0,32,30
1657595908406,MATH 109,B03,093479,Ganzberger; Geoffrey Michael,8,0,32,24
1657595914430,MATH 142A,A01,083219,Chow; Bennett,7,0,32,25
1657595914430,MATH 142A,A02,083220,Chow; Bennett,10,0,32,22
1657595914430,MATH 142A,A03,093480,Chow; Bennett,9,0,32,23
1657595914430,MATH 142A,B03,093481,Chow; Bennett,8,0,32,24
1657595914430,MATH 142A,B04,093558,Chow; Bennett,13,0,32,19
1657595914430,MATH 142A,B05,093559,Chow; Bennett,6,0,32,26
1657595920453,MATH 193A,A01,083224,Rotar; Vladimir,8,0,34,26
1657595920453,MATH 193A,A02,083225,Rotar; Vladimir,9,0,34,25
1657595920453,MATH 193A,A03,083781,Rotar; Vladimir,5,0,34,29
1657595920453,MATH 193A,A04,083782,Rotar; Vladimir,10,0,34,24
1657595920453,MATH 193A,A05,093482,Rotar; Vladimir,10,0,34,24
1657595926480,MATH 197,001,091859,McAuley; Julian John,9999,0,9999,0
1657595926480,MATH 197,002,095566,Kedlaya; Kiran S.,9997,0,9999,2
1657595926480,MATH 197,003,095567,Xiao; Ming,9999,0,9999,0
1657595926480,MATH 197,004,095571,Perols; Johan Lars,9998,0,9999,1
1657595933545,COGS 9,A01,083615,Shannon; Kyle Michael,9,0,75,66
1657595939566,COGS 11,A01,083617,Boyle; Mary E. T.,23,0,48,25
1657595945595,COGS 13,A01,083071,Bastos; Amalia Pinkusfeld,11,0,71,60
1657595951618,COGS 14A,A01,092681,Semenuks; Arturs,5,1,100,95
1657595957641,COGS 14B,A01,083073,Cheng; Tzu-Han,6,0,63,57
1657595963665,COGS 17,A01,092677,Semenuks; Arturs,6,0,81,75
1657595969692,COGS 100,A01,083619,Allen; Michael Gordon,17,0,70,53
1657595975716,COGS 101A,A01,083621,Davis; Joshua Daniel,9,0,68,59
1657595981743,COGS 101B,A01,091572,Allen; Michael Gordon,12,0,65,53
1657595987770,COGS 101C,A01,083625,Delgado; Tania,17,0,35,18
1657595993793,COGS 107A,A01,083627,Boyle; Mary E. T.,13,0,60,47
1657595999816,COGS 118A,A01,083075,Gupta; Anjum,21,0,76,55
1657596005844,CSE 3,A50,083646,Miranda; Gregory Joseph,24,0,50,26
1657596011872,CSE 8A,A50,083650,Miranda; Gregory Joseph,17,1,56,39
1657596017899,CSE 11,A01,083080,Cao; Yingjun,6,15,40,34
1657596023921,CSE 12,A01,083652,Krause-Levy; Sophia Louisa,28,1,120,92
1657596029959,CSE 15L,A01,083654,Morris; Justin Loren,9,0,50,41
1657596029959,CSE 15L,A02,083655,Morris; Justin Loren,9,0,50,41
1657596035995,CSE 20,A01,083657,Tran; Khoa Dang,39,0,80,41
1657596042019,CSE 21,A01,095574,Bach; Quang Tran,22,0,48,26
1657596048045,CSE 30,A01,083084,Eldon; John,5,0,80,75
1657596048045,CSE 30,B01,095061,Bhaskar; Nishant,9,0,50,41
1657596054069,CSE 100,A01,083659,Cao; Yingjun,5,4,70,65
1657596060096,CSE 134B,A01,083661,Powell; Thomas Allan,22,0,100,78
1657596066121,CSE 140,A01,083663,Gungor; Onat,15,0,85,70
1657596072147,CSE 140L,A01,083088,Eldon; John,21,0,100,79
1657596078178,CSE 175,A01,083665,Kumar; Rakesh,3,0,25,22
1657596084200,CSE 190,A00,092507,Dubnov; Shlomo,8,0,20,12
1657596090223,ECE 45,A01,083139,Congero; Spencer William,6,0,75,69
1657596096267,ECE 65,A50,083695,Saad; Andrew S,12,0,30,18
1657596096267,ECE 65,A51,095125,Saad; Andrew S,24,0,26,2
1657596102295,ECE 109,A01,091882,Touri; Behrouz,19,0,70,51
1657596108318,ECE 180,A00,083140,Abi Samra; Nicholas Camill,1,0,30,29
1657596108318,ECE 180,B00,083141,Abi Samra; Nicholas Camill,0,0,30,30
1657596114351,MATH 10A,A01,083735,Patchell; Gregory David,2,0,30,28
1657596114351,MATH 10A,A02,083736,Patchell; Gregory David,20,0,30,10
1657596114351,MATH 10A,A03,083737,Patchell; Gregory David,16,0,30,14
1657596120375,MATH 10B,A01,083207,Lim; Seonhee,8,0,34,26
1657596120375,MATH 10B,A02,083208,Lim; Seonhee,9,0,35,26
1657596120375,MATH 10B,A03,093472,Lim; Seonhee,7,0,34,27
1657596120375,MATH 10B,B01,083739,Sinha; Shubham,12,0,30,18
1657596126398,MATH 18,A01,083743,Cinel; Cameron Alexander,7,0,30,23
1657596126398,MATH 18,A02,083744,Cinel; Cameron Alexander,17,0,30,13
1657596126398,MATH 18,A03,083745,Cinel; Cameron Alexander,9,0,30,21
1657596126398,MATH 18,B01,083748,Rideout; David Porter,5,0,37,32
1657596126398,MATH 18,B02,083749,Rideout; David Porter,5,0,36,31
1657596126398,MATH 18,B03,083750,Rideout; David Porter,3,0,37,34
1657596126398,MATH 18,B04,083751,Rideout; David Porter,6,0,36,30
1657596126398,MATH 18,B05,093473,Rideout; David Porter,6,0,36,30
1657596126398,MATH 18,B06,093474,Rideout; David Porter,6,0,36,30
1657596132422,MATH 20A,A01,083754,Zheng; Zequn,14,0,40,26
1657596138445,MATH 20B,A01,083756,Briones; Jor-el Thomas Caparas,4,0,36,32
1657596138445,MATH 20B,A02,083757,Briones; Jor-el Thomas Caparas,1,0,36,35
1657596138445,MATH 20B,A03,093475,Briones; Jor-el Thomas Caparas,2,0,36,34
1657596144472,MATH 20C,A01,083760,Briones; Jor-el Thomas Caparas,1,0,35,34
1657596144472,MATH 20C,A02,083761,Briones; Jor-el Thomas Caparas,8,0,35,27
1657596144472,MATH 20C,A03,093476,Briones; Jor-el Thomas Caparas,0,1,36,36
1657596144472,MATH 20C,B01,083762,Bach; Quang Tran,1,0,30,29
1657596150519,MATH 20D,A01,083765,Tran; Brian Kha,5,0,30,25
1657596150519,MATH 20D,A02,083766,Tran; Brian Kha,5,0,30,25
1657596150519,MATH 20D,A03,083767,Tran; Brian Kha,5,0,30,25
1657596156565,MATH 20E,A01,083771,Ganguly; Soumya,9,0,32,23
1657596156565,MATH 20E,A02,083772,Ganguly; Soumya,6,0,32,26
1657596156565,MATH 20E,B01,083773,Ciotti; Benjamin,20,0,35,15
1657596156565,MATH 20E,B02,083774,Ciotti; Benjamin,18,0,35,17
1657596162589,MATH 103A,A01,083777,Greenfeld; Be'Eri,3,0,36,33
1657596162589,MATH 103A,A02,083778,Greenfeld; Be'Eri,5,0,36,31
1657596162589,MATH 103A,A03,093561,Greenfeld; Be'Eri,6,0,36,30
1657596162589,MATH 103A,B01,083779,Greenfeld; Be'Eri,7,0,36,29
1657596162589,MATH 103A,B02,083780,Greenfeld; Be'Eri,4,0,36,32
1657596162589,MATH 103A,B03,093562,Greenfeld; Be'Eri,3,0,36,33
1657596168612,MATH 105,A01,085443,Carter; Anne Toulson,15,0,35,20
1657596168612,MATH 105,A02,093477,Carter; Anne Toulson,20,0,35,15
1657596174649,MATH 109,A01,083213,Ganzberger; Geoffrey Michael,2,0,34,32
1657596174649,MATH 109,A02,083214,Ganzberger; Geoffrey Michael,4,0,34,30
1657596174649,MATH 109,A03,093478,Ganzberger; Geoffrey Michael,2,0,34,32
1657596174649,MATH 109,B01,083215,Ganzberger; Geoffrey Michael,1,0,32,31
1657596174649,MATH 109,B02,083216,Ganzberger; Geoffrey Michael,2,0,32,30
1657596174649,MATH 109,B03,093479,Ganzberger; Geoffrey Michael,8,0,32,24
1657596180683,MATH 142A,A01,083219,Chow; Bennett,7,0,32,25
1657596180683,MATH 142A,A02,083220,Chow; Bennett,10,0,32,22
1657596180683,MATH 142A,A03,093480,Chow; Bennett,9,0,32,23
1657596180683,MATH 142A,B03,093481,Chow; Bennett,8,0,32,24
1657596180683,MATH 142A,B04,093558,Chow; Bennett,13,0,32,19
1657596180683,MATH 142A,B05,093559,Chow; Bennett,6,0,32,26
1657596186708,MATH 193A,A01,083224,Rotar; Vladimir,8,0,34,26
1657596186708,MATH 193A,A02,083225,Rotar; Vladimir,9,0,34,25
1657596186708,MATH 193A,A03,083781,Rotar; Vladimir,5,0,34,29
1657596186708,MATH 193A,A04,083782,Rotar; Vladimir,10,0,34,24
1657596186708,MATH 193A,A05,093482,Rotar; Vladimir,10,0,34,24
1657596192739,MATH 197,001,091859,McAuley; Julian John,9999,0,9999,0
1657596192739,MATH 197,002,095566,Kedlaya; Kiran S.,9997,0,9999,2
1657596192739,MATH 197,003,095567,Xiao; Ming,9999,0,9999,0
1657596192739,MATH 197,004,095571,Perols; Johan Lars,9998,0,9999,1
1657596199791,COGS 9,A01,083615,Shannon; Kyle Michael,9,0,75,66
1657596205824,COGS 11,A01,083617,Boyle; Mary E. T.,23,0,48,25
1657596211849,COGS 13,A01,083071,Bastos; Amalia Pinkusfeld,11,0,71,60
1657596217873,COGS 14A,A01,092681,Semenuks; Arturs,5,1,100,95
1657596223897,COGS 14B,A01,083073,Cheng; Tzu-Han,6,0,63,57
1657596229919,COGS 17,A01,092677,Semenuks; Arturs,6,0,81,75
1657596235944,COGS 100,A01,083619,Allen; Michael Gordon,17,0,70,53
1657596241968,COGS 101A,A01,083621,Davis; Joshua Daniel,9,0,68,59
1657596247991,COGS 101B,A01,091572,Allen; Michael Gordon,12,0,65,53
1657596254016,COGS 101C,A01,083625,Delgado; Tania,17,0,35,18
1657596260039,COGS 107A,A01,083627,Boyle; Mary E. T.,13,0,60,47
1657596266066,COGS 118A,A01,083075,Gupta; Anjum,21,0,76,55
1657596272088,CSE 3,A50,083646,Miranda; Gregory Joseph,24,0,50,26
1657596278110,CSE 8A,A50,083650,Miranda; Gregory Joseph,17,1,56,39
1657596284134,CSE 11,A01,083080,Cao; Yingjun,6,15,40,34
1657596290160,CSE 12,A01,083652,Krause-Levy; Sophia Louisa,28,1,120,92
1657596296182,CSE 15L,A01,083654,Morris; Justin Loren,9,0,50,41
1657596296182,CSE 15L,A02,083655,Morris; Justin Loren,9,0,50,41
1657596302296,CSE 20,A01,083657,Tran; Khoa Dang,39,0,80,41
1657596308323,CSE 21,A01,095574,Bach; Quang Tran,22,0,48,26
1657596314349,CSE 30,A01,083084,Eldon; John,5,0,80,75
1657596314349,CSE 30,B01,095061,Bhaskar; Nishant,9,0,50,41
1657596320371,CSE 100,A01,083659,Cao; Yingjun,5,4,70,65
1657596326398,CSE 134B,A01,083661,Powell; Thomas Allan,22,0,100,78
1657596332423,CSE 140,A01,083663,Gungor; Onat,15,0,85,70
1657596338446,CSE 140L,A01,083088,Eldon; John,21,0,100,79
1657596344468,CSE 175,A01,083665,Kumar; Rakesh,3,0,25,22
1657596350494,CSE 190,A00,092507,Dubnov; Shlomo,8,0,20,12
1657596356520,ECE 45,A01,083139,Congero; Spencer William,6,0,75,69
1657596362544,ECE 65,A50,083695,Saad; Andrew S,12,0,30,18
1657596362544,ECE 65,A51,095125,Saad; Andrew S,24,0,26,2
1657596368565,ECE 109,A01,091882,Touri; Behrouz,19,0,70,51
1657596374588,ECE 180,A00,083140,Abi Samra; Nicholas Camill,1,0,30,29
1657596374588,ECE 180,B00,083141,Abi Samra; Nicholas Camill,0,0,30,30
1657596380619,MATH 10A,A01,083735,Patchell; Gregory David,2,0,30,28
1657596380619,MATH 10A,A02,083736,Patchell; Gregory David,20,0,30,10
1657596380619,MATH 10A,A03,083737,Patchell; Gregory David,16,0,30,14
1657596386641,MATH 10B,A01,083207,Lim; Seonhee,8,0,34,26
1657596386641,MATH 10B,A02,083208,Lim; Seonhee,9,0,35,26
1657596386641,MATH 10B,A03,093472,Lim; Seonhee,7,0,34,27
1657596386641,MATH 10B,B01,083739,Sinha; Shubham,12,0,30,18
1657596392666,MATH 18,A01,083743,Cinel; Cameron Alexander,7,0,30,23
1657596392666,MATH 18,A02,083744,Cinel; Cameron Alexander,17,0,30,13
1657596392666,MATH 18,A03,083745,Cinel; Cameron Alexander,9,0,30,21
1657596392666,MATH 18,B01,083748,Rideout; David Porter,5,0,37,32
1657596392666,MATH 18,B02,083749,Rideout; David Porter,5,0,36,31
1657596392666,MATH 18,B03,083750,Rideout; David Porter,3,0,37,34
1657596392666,MATH 18,B04,083751,Rideout; David Porter,6,0,36,30
1657596392666,MATH 18,B05,093473,Rideout; David Porter,6,0,36,30
1657596392666,MATH 18,B06,093474,Rideout; David Porter,6,0,36,30
1657596398690,MATH 20A,A01,083754,Zheng; Zequn,14,0,40,26
1657596404714,MATH 20B,A01,083756,Briones; Jor-el Thomas Caparas,4,0,36,32
1657596404714,MATH 20B,A02,083757,Briones; Jor-el Thomas Caparas,1,0,36,35
1657596404714,MATH 20B,A03,093475,Briones; Jor-el Thomas Caparas,2,0,36,34
1657596410743,MATH 20C,A01,083760,Briones; Jor-el Thomas Caparas,1,0,35,34
1657596410743,MATH 20C,A02,083761,Briones; Jor-el Thomas Caparas,8,0,35,27
1657596410743,MATH 20C,A03,093476,Briones; Jor-el Thomas Caparas,0,1,36,36
1657596410743,MATH 20C,B01,083762,Bach; Quang Tran,1,0,30,29
1657596416771,MATH 20D,A01,083765,Tran; Brian Kha,5,0,30,25
1657596416771,MATH 20D,A02,083766,Tran; Brian Kha,5,0,30,25
1657596416771,MATH 20D,A03,083767,Tran; Brian Kha,5,0,30,25
1657596422799,MATH 20E,A01,083771,Ganguly; Soumya,9,0,32,23
1657596422799,MATH 20E,A02,083772,Ganguly; Soumya,6,0,32,26
1657596422799,MATH 20E,B01,083773,Ciotti; Benjamin,20,0,35,15
1657596422799,MATH 20E,B02,083774,Ciotti; Benjamin,18,0,35,17
1657596428838,MATH 103A,A01,083777,Greenfeld; Be'Eri,3,0,36,33
1657596428838,MATH 103A,A02,083778,Greenfeld; Be'Eri,5,0,36,31
1657596428838,MATH 103A,A03,093561,Greenfeld; Be'Eri,6,0,36,30
1657596428838,MATH 103A,B01,083779,Greenfeld; Be'Eri,7,0,36,29
1657596428838,MATH 103A,B02,083780,Greenfeld; Be'Eri,4,0,36,32
1657596428838,MATH 103A,B03,093562,Greenfeld; Be'Eri,3,0,36,33
1657596434865,MATH 105,A01,085443,Carter; Anne Toulson,15,0,35,20
1657596434865,MATH 105,A02,093477,Carter; Anne Toulson,20,0,35,15
1657596440904,MATH 109,A01,083213,Ganzberger; Geoffrey Michael,2,0,34,32
1657596440904,MATH 109,A02,083214,Ganzberger; Geoffrey Michael,4,0,34,30
1657596440904,MATH 109,A03,093478,Ganzberger; Geoffrey Michael,2,0,34,32
1657596440904,MATH 109,B01,083215,Ganzberger; Geoffrey Michael,1,0,32,31
1657596440904,MATH 109,B02,083216,Ganzberger; Geoffrey Michael,2,0,32,30
1657596440904,MATH 109,B03,093479,Ganzberger; Geoffrey Michael,8,0,32,24
1657596446928,MATH 142A,A01,083219,Chow; Bennett,7,0,32,25
1657596446928,MATH 142A,A02,083220,Chow; Bennett,10,0,32,22
1657596446928,MATH 142A,A03,093480,Chow; Bennett,9,0,32,23
1657596446928,MATH 142A,B03,093481,Chow; Bennett,8,0,32,24
1657596446928,MATH 142A,B04,093558,Chow; Bennett,13,0,32,19
1657596446928,MATH 142A,B05,093559,Chow; Bennett,6,0,32,26
1657596452956,MATH 193A,A01,083224,Rotar; Vladimir,8,0,34,26
1657596452956,MATH 193A,A02,083225,Rotar; Vladimir,9,0,34,25
1657596452956,MATH 193A,A03,083781,Rotar; Vladimir,5,0,34,29
1657596452956,MATH 193A,A04,083782,Rotar; Vladimir,10,0,34,24
1657596452956,MATH 193A,A05,093482,Rotar; Vladimir,10,0,34,24
1657596458983,MATH 197,001,091859,McAuley; Julian John,9999,0,9999,0
1657596458983,MATH 197,002,095566,Kedlaya; Kiran S.,9997,0,9999,2
1657596458983,MATH 197,003,095567,Xiao; Ming,9999,0,9999,0
1657596458983,MATH 197,004,095571,Perols; Johan Lars,9998,0,9999,1
1657596466037,COGS 9,A01,083615,Shannon; Kyle Michael,9,0,75,66
1657596472067,COGS 11,A01,083617,Boyle; Mary E. T.,23,0,48,25
1657596478096,COGS 13,A01,083071,Bastos; Amalia Pinkusfeld,11,0,71,60
1657596484124,COGS 14A,A01,092681,Semenuks; Arturs,5,1,100,95
1657596490149,COGS 14B,A01,083073,Cheng; Tzu-Han,6,0,63,57
1657596496173,COGS 17,A01,092677,Semenuks; Arturs,6,0,81,75
1657596502196,COGS 100,A01,083619,Allen; Michael Gordon,17,0,70,53
1657596508218,COGS 101A,A01,083621,Davis; Joshua Daniel,9,0,68,59
1657596514240,COGS 101B,A01,091572,Allen; Michael Gordon,12,0,65,53
1657596520262,COGS 101C,A01,083625,Delgado; Tania,17,0,35,18
1657596526292,COGS 107A,A01,083627,Boyle; Mary E. T.,13,0,60,47
1657596532319,COGS 118A,A01,083075,Gupta; Anjum,21,0,76,55
1657596538344,CSE 3,A50,083646,Miranda; Gregory Joseph,24,0,50,26
1657596544376,CSE 8A,A50,083650,Miranda; Gregory Joseph,17,1,56,39
1657596550405,CSE 11,A01,083080,Cao; Yingjun,6,15,40,34
1657596556436,CSE 12,A01,083652,Krause-Levy; Sophia Louisa,28,1,120,92
1657596562459,CSE 15L,A01,083654,Morris; Justin Loren,9,0,50,41
1657596562459,CSE 15L,A02,083655,Morris; Justin Loren,9,0,50,41
1657596568483,CSE 20,A01,083657,Tran; Khoa Dang,39,0,80,41
1657596574509,CSE 21,A01,095574,Bach; Quang Tran,22,0,48,26
1657596580535,CSE 30,A01,083084,Eldon; John,5,0,80,75
1657596580535,CSE 30,B01,095061,Bhaskar; Nishant,9,0,50,41
1657596586559,CSE 100,A01,083659,Cao; Yingjun,5,4,70,65
1657596592582,CSE 134B,A01,083661,Powell; Thomas Allan,22,0,100,78
1657596598606,CSE 140,A01,083663,Gungor; Onat,15,0,85,70
1657596604629,CSE 140L,A01,083088,Eldon; John,21,0,100,79
1657596610656,CSE 175,A01,083665,Kumar; Rakesh,3,0,25,22
1657596616677,CSE 190,A00,092507,Dubnov; Shlomo,8,0,20,12
1657596622700,ECE 45,A01,083139,Congero; Spencer William,6,0,75,69
1657596628725,ECE 65,A50,083695,Saad; Andrew S,12,0,30,18
1657596628725,ECE 65,A51,095125,Saad; Andrew S,24,0,26,2
1657596634751,ECE 109,A01,091882,Touri; Behrouz,19,0,70,51
1657596640777,ECE 180,A00,083140,Abi Samra; Nicholas Camill,1,0,30,29
1657596640777,ECE 180,B00,083141,Abi Samra; Nicholas Camill,0,0,30,30
1657596646801,MATH 10A,A01,083735,Patchell; Gregory David,2,0,30,28
1657596646801,MATH 10A,A02,083736,Patchell; Gregory David,20,0,30,10
1657596646801,MATH 10A,A03,083737,Patchell; Gregory David,16,0,30,14
1657596652828,MATH 10B,A01,083207,Lim; Seonhee,8,0,34,26
1657596652828,MATH 10B,A02,083208,Lim; Seonhee,9,0,35,26
1657596652828,MATH 10B,A03,093472,Lim; Seonhee,7,0,34,27
1657596652828,MATH 10B,B01,083739,Sinha; Shubham,12,0,30,18
1657596658858,MATH 18,A01,083743,Cinel; Cameron Alexander,7,0,30,23
1657596658858,MATH 18,A02,083744,Cinel; Cameron Alexander,17,0,30,13
1657596658858,MATH 18,A03,083745,Cinel; Cameron Alexander,9,0,30,21
1657596658858,MATH 18,B01,083748,Rideout; David Porter,5,0,37,32
1657596658858,MATH 18,B02,083749,Rideout; David Porter,5,0,36,31
1657596658858,MATH 18,B03,083750,Rideout; David Porter,3,0,37,34
1657596658858,MATH 18,B04,083751,Rideout; David Porter,6,0,36,30
1657596658858,MATH 18,B05,093473,Rideout; David Porter,6,0,36,30
1657596658858,MATH 18,B06,093474,Rideout; David Porter,6,0,36,30
1657596664880,MATH 20A,A01,083754,Zheng; Zequn,14,0,40,26
1657596670909,MATH 20B,A01,083756,Briones; Jor-el Thomas Caparas,4,0,36,32
1657596670909,MATH 20B,A02,083757,Briones; Jor-el Thomas Caparas,1,0,36,35
1657596670909,MATH 20B,A03,093475,Briones; Jor-el Thomas Caparas,2,0,36,34
1657596676932,MATH 20C,A01,083760,Briones; Jor-el Thomas Caparas,1,0,35,34
1657596676932,MATH 20C,A02,083761,Briones; Jor-el Thomas Caparas,8,0,35,27
1657596676932,MATH 20C,A03,093476,Briones; Jor-el Thomas Caparas,0,1,36,36
1657596676932,MATH 20C,B01,083762,Bach; Quang Tran,1,0,30,29
1657596682957,MATH 20D,A01,083765,Tran; Brian Kha,5,0,30,25
1657596682957,MATH 20D,A02,083766,Tran; Brian Kha,5,0,30,25
1657596682957,MATH 20D,A03,083767,Tran; Brian Kha,5,0,30,25
1657596688982,MATH 20E,A01,083771,Ganguly; Soumya,9,0,32,23
1657596688982,MATH 20E,A02,083772,Ganguly; Soumya,6,0,32,26
1657596688982,MATH 20E,B01,083773,Ciotti; Benjamin,20,0,35,15
1657596688982,MATH 20E,B02,083774,Ciotti; Benjamin,18,0,35,17
1657596695009,MATH 103A,A01,083777,Greenfeld; Be'Eri,3,0,36,33
1657596695009,MATH 103A,A02,083778,Greenfeld; Be'Eri,5,0,36,31
1657596695009,MATH 103A,A03,093561,Greenfeld; Be'Eri,6,0,36,30
1657596695009,MATH 103A,B01,083779,Greenfeld; Be'Eri,7,0,36,29
1657596695009,MATH 103A,B02,083780,Greenfeld; Be'Eri,4,0,36,32
1657596695009,MATH 103A,B03,093562,Greenfeld; Be'Eri,3,0,36,33
1657596701033,MATH 105,A01,085443,Carter; Anne Toulson,15,0,35,20
1657596701033,MATH 105,A02,093477,Carter; Anne Toulson,20,0,35,15
1657596707062,MATH 109,A01,083213,Ganzberger; Geoffrey Michael,2,0,34,32
1657596707062,MATH 109,A02,083214,Ganzberger; Geoffrey Michael,4,0,34,30
1657596707062,MATH 109,A03,093478,Ganzberger; Geoffrey Michael,2,0,34,32
1657596707062,MATH 109,B01,083215,Ganzberger; Geoffrey Michael,1,0,32,31
1657596707062,MATH 109,B02,083216,Ganzberger; Geoffrey Michael,2,0,32,30
1657596707062,MATH 109,B03,093479,Ganzberger; Geoffrey Michael,8,0,32,24
1657596713097,MATH 142A,A01,083219,Chow; Bennett,7,0,32,25
1657596713097,MATH 142A,A02,083220,Chow; Bennett,10,0,32,22
1657596713097,MATH 142A,A03,093480,Chow; Bennett,9,0,32,23
1657596713097,MATH 142A,B03,093481,Chow; Bennett,8,0,32,24
1657596713097,MATH 142A,B04,093558,Chow; Bennett,13,0,32,19
1657596713097,MATH 142A,B05,093559,Chow; Bennett,6,0,32,26
1657596719127,MATH 193A,A01,083224,Rotar; Vladimir,8,0,34,26
1657596719127,MATH 193A,A02,083225,Rotar; Vladimir,9,0,34,25
1657596719127,MATH 193A,A03,083781,Rotar; Vladimir,5,0,34,29
1657596719127,MATH 193A,A04,083782,Rotar; Vladimir,10,0,34,24
1657596719127,MATH 193A,A05,093482,Rotar; Vladimir,10,0,34,24
1657596725151,MATH 197,001,091859,McAuley; Julian John,9999,0,9999,0
1657596725151,MATH 197,002,095566,Kedlaya; Kiran S.,9997,0,9999,2
1657596725151,MATH 197,003,095567,Xiao; Ming,9999,0,9999,0
1657596725151,MATH 197,004,095571,Perols; Johan Lars,9998,0,9999,1
1657596732211,COGS 9,A01,083615,Shannon; Kyle Michael,9,0,75,66
1657596738238,COGS 11,A01,083617,Boyle; Mary E. T.,23,0,48,25
1657596744262,COGS 13,A01,083071,Bastos; Amalia Pinkusfeld,11,0,71,60
1657596750287,COGS 14A,A01,092681,Semenuks; Arturs,5,1,100,95
1657596756311,COGS 14B,A01,083073,Cheng; Tzu-Han,6,0,63,57
1657596762336,COGS 17,A01,092677,Semenuks; Arturs,6,0,81,75
1657596768364,COGS 100,A01,083619,Allen; Michael Gordon,17,0,70,53
1657596774390,COGS 101A,A01,083621,Davis; Joshua Daniel,9,0,68,59
1657596780416,COGS 101B,A01,091572,Allen; Michael Gordon,12,0,65,53
1657596786440,COGS 101C,A01,083625,Delgado; Tania,17,0,35,18
1657596792468,COGS 107A,A01,083627,Boyle; Mary E. T.,13,0,60,47
1657596798494,COGS 118A,A01,083075,Gupta; Anjum,21,0,76,55
1657596804523,CSE 3,A50,083646,Miranda; Gregory Joseph,24,0,50,26
1657596810550,CSE 8A,A50,083650,Miranda; Gregory Joseph,17,1,56,39
1657596816572,CSE 11,A01,083080,Cao; Yingjun,6,15,40,34
1657596822600,CSE 12,A01,083652,Krause-Levy; Sophia Louisa,28,1,120,92
1657596828629,CSE 15L,A01,083654,Morris; Justin Loren,9,0,50,41
1657596828629,CSE 15L,A02,083655,Morris; Justin Loren,9,0,50,41
1657596834676,CSE 20,A01,083657,Tran; Khoa Dang,39,0,80,41
1657596840701,CSE 21,A01,095574,Bach; Quang Tran,22,0,48,26
1657596846726,CSE 30,A01,083084,Eldon; John,5,0,80,75
1657596846726,CSE 30,B01,095061,Bhaskar; Nishant,9,0,50,41
1657596852749,CSE 100,A01,083659,Cao; Yingjun,5,4,70,65
1657596858776,CSE 134B,A01,083661,Powell; Thomas Allan,22,0,100,78
1657596864799,CSE 140,A01,083663,Gungor; Onat,15,0,85,70
1657596870827,CSE 140L,A01,083088,Eldon; John,21,0,100,79
1657596876853,CSE 175,A01,083665,Kumar; Rakesh,3,0,25,22
1657596882880,CSE 190,A00,092507,Dubnov; Shlomo,8,0,20,12
1657596888906,ECE 45,A01,083139,Congero; Spencer William,6,0,75,69
1657596894930,ECE 65,A50,083695,Saad; Andrew S,12,0,30,18
1657596894930,ECE 65,A51,095125,Saad; Andrew S,24,0,26,2
1657596901025,ECE 109,A01,091882,Touri; Behrouz,19,0,70,51
1657596907052,ECE 180,A00,083140,Abi Samra; Nicholas Camill,1,0,30,29
1657596907052,ECE 180,B00,083141,Abi Samra; Nicholas Camill,0,0,30,30
1657596913079,MATH 10A,A01,083735,Patchell; Gregory David,2,0,30,28
1657596913079,MATH 10A,A02,083736,Patchell; Gregory David,20,0,30,10
1657596913079,MATH 10A,A03,083737,Patchell; Gregory David,16,0,30,14
1657596919105,MATH 10B,A01,083207,Lim; Seonhee,8,0,34,26
1657596919105,MATH 10B,A02,083208,Lim; Seonhee,9,0,35,26
1657596919105,MATH 10B,A03,093472,Lim; Seonhee,7,0,34,27
1657596919105,MATH 10B,B01,083739,Sinha; Shubham,12,0,30,18
1657596925129,MATH 18,A01,083743,Cinel; Cameron Alexander,7,0,30,23
1657596925129,MATH 18,A02,083744,Cinel; Cameron Alexander,17,0,30,13
1657596925129,MATH 18,A03,083745,Cinel; Cameron Alexander,9,0,30,21
1657596925129,MATH 18,B01,083748,Rideout; David Porter,5,0,37,32
1657596925129,MATH 18,B02,083749,Rideout; David Porter,5,0,36,31
1657596925129,MATH 18,B03,083750,Rideout; David Porter,3,0,37,34
1657596925129,MATH 18,B04,083751,Rideout; David Porter,6,0,36,30
1657596925129,MATH 18,B05,093473,Rideout; David Porter,6,0,36,30
1657596925129,MATH 18,B06,093474,Rideout; David Porter,6,0,36,30
1657596931155,MATH 20A,A01,083754,Zheng; Zequn,14,0,40,26
1657596937185,MATH 20B,A01,083756,Briones; Jor-el Thomas Caparas,4,0,36,32
1657596937185,MATH 20B,A02,083757,Briones; Jor-el Thomas Caparas,1,0,36,35
1657596937185,MATH 20B,A03,093475,Briones; Jor-el Thomas Caparas,2,0,36,34
1657596943207,MATH 20C,A01,083760,Briones; Jor-el Thomas Caparas,1,0,35,34
1657596943207,MATH 20C,A02,083761,Briones; Jor-el Thomas Caparas,8,0,35,27
1657596943207,MATH 20C,A03,093476,Briones; Jor-el Thomas Caparas,0,1,36,36
1657596943207,MATH 20C,B01,083762,Bach; Quang Tran,1,0,30,29
1657596949234,MATH 20D,A01,083765,Tran; Brian Kha,5,0,30,25
1657596949234,MATH 20D,A02,083766,Tran; Brian Kha,5,0,30,25
1657596949234,MATH 20D,A03,083767,Tran; Brian Kha,5,0,30,25
1657596955258,MATH 20E,A01,083771,Ganguly; Soumya,9,0,32,23
1657596955258,MATH 20E,A02,083772,Ganguly; Soumya,6,0,32,26
1657596955258,MATH 20E,B01,083773,Ciotti; Benjamin,20,0,35,15
1657596955258,MATH 20E,B02,083774,Ciotti; Benjamin,18,0,35,17
1657596961302,MATH 103A,A01,083777,Greenfeld; Be'Eri,3,0,36,33
1657596961302,MATH 103A,A02,083778,Greenfeld; Be'Eri,5,0,36,31
1657596961302,MATH 103A,A03,093561,Greenfeld; Be'Eri,6,0,36,30
1657596961302,MATH 103A,B01,083779,Greenfeld; Be'Eri,7,0,36,29
1657596961302,MATH 103A,B02,083780,Greenfeld; Be'Eri,4,0,36,32
1657596961302,MATH 103A,B03,093562,Greenfeld; Be'Eri,3,0,36,33
1657596967337,MATH 105,A01,085443,Carter; Anne Toulson,15,0,35,20
1657596967337,MATH 105,A02,093477,Carter; Anne Toulson,20,0,35,15
1657596973367,MATH 109,A01,083213,Ganzberger; Geoffrey Michael,2,0,34,32
1657596973367,MATH 109,A02,083214,Ganzberger; Geoffrey Michael,4,0,34,30
1657596973367,MATH 109,A03,093478,Ganzberger; Geoffrey Michael,2,0,34,32
1657596973367,MATH 109,B01,083215,Ganzberger; Geoffrey Michael,1,0,32,31
1657596973367,MATH 109,B02,083216,Ganzberger; Geoffrey Michael,2,0,32,30
1657596973367,MATH 109,B03,093479,Ganzberger; Geoffrey Michael,8,0,32,24
1657596979397,MATH 142A,A01,083219,Chow; Bennett,7,0,32,25
1657596979397,MATH 142A,A02,083220,Chow; Bennett,10,0,32,22
1657596979397,MATH 142A,A03,093480,Chow; Bennett,9,0,32,23
1657596979397,MATH 142A,B03,093481,Chow; Bennett,8,0,32,24
1657596979397,MATH 142A,B04,093558,Chow; Bennett,13,0,32,19
1657596979397,MATH 142A,B05,093559,Chow; Bennett,6,0,32,26
1657596985420,MATH 193A,A01,083224,Rotar; Vladimir,8,0,34,26
1657596985420,MATH 193A,A02,083225,Rotar; Vladimir,9,0,34,25
1657596985420,MATH 193A,A03,083781,Rotar; Vladimir,5,0,34,29
1657596985420,MATH 193A,A04,083782,Rotar; Vladimir,10,0,34,24
1657596985420,MATH 193A,A05,093482,Rotar; Vladimir,10,0,34,24
1657596991456,MATH 197,001,091859,McAuley; Julian John,9999,0,9999,0
1657596991456,MATH 197,002,095566,Kedlaya; Kiran S.,9997,0,9999,2
1657596991456,MATH 197,003,095567,Xiao; Ming,9999,0,9999,0
1657596991456,MATH 197,004,095571,Perols; Johan Lars,9998,0,9999,1
1657596998519,COGS 9,A01,083615,Shannon; Kyle Michael,9,0,75,66
1657597004559,COGS 11,A01,083617,Boyle; Mary E. T.,23,0,48,25
1657597010586,COGS 13,A01,083071,Bastos; Amalia Pinkusfeld,11,0,71,60
1657597016609,COGS 14A,A01,092681,Semenuks; Arturs,5,1,100,95
1657597022633,COGS 14B,A01,083073,Cheng; Tzu-Han,6,0,63,57
1657597028657,COGS 17,A01,092677,Semenuks; Arturs,6,0,81,75
1657597034691,COGS 100,A01,083619,Allen; Michael Gordon,17,0,70,53
1657597040719,COGS 101A,A01,083621,Davis; Joshua Daniel,9,0,68,59
1657597046739,COGS 101B,A01,091572,Allen; Michael Gordon,12,0,65,53
1657597052777,COGS 101C,A01,083625,Delgado; Tania,17,0,35,18
1657597058800,COGS 107A,A01,083627,Boyle; Mary E. T.,13,0,60,47
1657597064827,COGS 118A,A01,083075,Gupta; Anjum,21,0,76,55
1657597070850,CSE 3,A50,083646,Miranda; Gregory Joseph,24,0,50,26
1657597076872,CSE 8A,A50,083650,Miranda; Gregory Joseph,17,1,56,39
1657597082896,CSE 11,A01,083080,Cao; Yingjun,6,15,40,34
1657597088917,CSE 12,A01,083652,Krause-Levy; Sophia Louisa,28,1,120,92
1657597094959,CSE 15L,A01,083654,Morris; Justin Loren,9,0,50,41
1657597094959,CSE 15L,A02,083655,Morris; Justin Loren,9,0,50,41
1657597100985,CSE 20,A01,083657,Tran; Khoa Dang,39,0,80,41
1657597107014,CSE 21,A01,095574,Bach; Quang Tran,22,0,48,26
1657597113040,CSE 30,A01,083084,Eldon; John,5,0,80,75
1657597113040,CSE 30,B01,095061,Bhaskar; Nishant,9,0,50,41
1657597119061,CSE 100,A01,083659,Cao; Yingjun,5,4,70,65
1657597125085,CSE 134B,A01,083661,Powell; Thomas Allan,22,0,100,78
1657597131112,CSE 140,A01,083663,Gungor; Onat,15,0,85,70
1657597137136,CSE 140L,A01,083088,Eldon; John,21,0,100,79
1657597143163,CSE 175,A01,083665,Kumar; Rakesh,3,0,25,22
1657597149190,CSE 190,A00,092507,Dubnov; Shlomo,8,0,20,12
1657597155214,ECE 45,A01,083139,Congero; Spencer William,6,0,75,69
1657597161238,ECE 65,A50,083695,Saad; Andrew S,12,0,30,18
1657597161238,ECE 65,A51,095125,Saad; Andrew S,24,0,26,2
1657597167260,ECE 109,A01,091882,Touri; Behrouz,19,0,70,51
1657597173286,ECE 180,A00,083140,Abi Samra; Nicholas Camill,1,0,30,29
1657597173286,ECE 180,B00,083141,Abi Samra; Nicholas Camill,0,0,30,30
1657597179311,MATH 10A,A01,083735,Patchell; Gregory David,2,0,30,28
1657597179311,MATH 10A,A02,083736,Patchell; Gregory David,20,0,30,10
1657597179311,MATH 10A,A03,083737,Patchell; Gregory David,16,0,30,14
1657597185334,MATH 10B,A01,083207,Lim; Seonhee,8,0,34,26
1657597185334,MATH 10B,A02,083208,Lim; Seonhee,9,0,35,26
1657597185334,MATH 10B,A03,093472,Lim; Seonhee,7,0,34,27
1657597185334,MATH 10B,B01,083739,Sinha; Shubham,12,0,30,18
1657597191359,MATH 18,A01,083743,Cinel; Cameron Alexander,7,0,30,23
1657597191359,MATH 18,A02,083744,Cinel; Cameron Alexander,17,0,30,13
1657597191359,MATH 18,A03,083745,Cinel; Cameron Alexander,9,0,30,21
1657597191359,MATH 18,B01,083748,Rideout; David Porter,5,0,37,32
1657597191359,MATH 18,B02,083749,Rideout; David Porter,5,0,36,31
1657597191359,MATH 18,B03,083750,Rideout; David Porter,3,0,37,34
1657597191359,MATH 18,B04,083751,Rideout; David Porter,6,0,36,30
1657597191359,MATH 18,B05,093473,Rideout; David Porter,6,0,36,30
1657597191359,MATH 18,B06,093474,Rideout; David Porter,6,0,36,30
1657597197384,MATH 20A,A01,083754,Zheng; Zequn,14,0,40,26
1657597203415,MATH 20B,A01,083756,Briones; Jor-el Thomas Caparas,4,0,36,32
1657597203415,MATH 20B,A02,083757,Briones; Jor-el Thomas Caparas,1,0,36,35
1657597203415,MATH 20B,A03,093475,Briones; Jor-el Thomas Caparas,2,0,36,34
1657597209437,MATH 20C,A01,083760,Briones; Jor-el Thomas Caparas,1,0,35,34
1657597209437,MATH 20C,A02,083761,Briones; Jor-el Thomas Caparas,8,0,35,27
1657597209437,MATH 20C,A03,093476,Briones; Jor-el Thomas Caparas,0,1,36,36
1657597209437,MATH 20C,B01,083762,Bach; Quang Tran,1,0,30,29
1657597215461,MATH 20D,A01,083765,Tran; Brian Kha,5,0,30,25
1657597215461,MATH 20D,A02,083766,Tran; Brian Kha,5,0,30,25
1657597215461,MATH 20D,A03,083767,Tran; Brian Kha,5,0,30,25
1657597221484,MATH 20E,A01,083771,Ganguly; Soumya,9,0,32,23
1657597221484,MATH 20E,A02,083772,Ganguly; Soumya,6,0,32,26
1657597221484,MATH 20E,B01,083773,Ciotti; Benjamin,20,0,35,15
1657597221484,MATH 20E,B02,083774,Ciotti; Benjamin,18,0,35,17
1657597227513,MATH 103A,A01,083777,Greenfeld; Be'Eri,3,0,36,33
1657597227513,MATH 103A,A02,083778,Greenfeld; Be'Eri,5,0,36,31
1657597227513,MATH 103A,A03,093561,Greenfeld; Be'Eri,6,0,36,30
1657597227513,MATH 103A,B01,083779,Greenfeld; Be'Eri,7,0,36,29
1657597227513,MATH 103A,B02,083780,Greenfeld; Be'Eri,4,0,36,32
1657597227513,MATH 103A,B03,093562,Greenfeld; Be'Eri,3,0,36,33
1657597233542,MATH 105,A01,085443,Carter; Anne Toulson,15,0,35,20
1657597233542,MATH 105,A02,093477,Carter; Anne Toulson,20,0,35,15
1657597239569,MATH 109,A01,083213,Ganzberger; Geoffrey Michael,2,0,34,32
1657597239569,MATH 109,A02,083214,Ganzberger; Geoffrey Michael,4,0,34,30
1657597239569,MATH 109,A03,093478,Ganzberger; Geoffrey Michael,2,0,34,32
1657597239569,MATH 109,B01,083215,Ganzberger; Geoffrey Michael,1,0,32,31
1657597239569,MATH 109,B02,083216,Ganzberger; Geoffrey Michael,2,0,32,30
1657597239569,MATH 109,B03,093479,Ganzberger; Geoffrey Michael,8,0,32,24
1657597245598,MATH 142A,A01,083219,Chow; Bennett,7,0,32,25
1657597245598,MATH 142A,A02,083220,Chow; Bennett,10,0,32,22
1657597245598,MATH 142A,A03,093480,Chow; Bennett,9,0,32,23
1657597245598,MATH 142A,B03,093481,Chow; Bennett,8,0,32,24
1657597245598,MATH 142A,B04,093558,Chow; Bennett,13,0,32,19
1657597245598,MATH 142A,B05,093559,Chow; Bennett,6,0,32,26
1657597251621,MATH 193A,A01,083224,Rotar; Vladimir,8,0,34,26
1657597251621,MATH 193A,A02,083225,Rotar; Vladimir,9,0,34,25
1657597251621,MATH 193A,A03,083781,Rotar; Vladimir,5,0,34,29
1657597251621,MATH 193A,A04,083782,Rotar; Vladimir,10,0,34,24
1657597251621,MATH 193A,A05,093482,Rotar; Vladimir,10,0,34,24
1657597257644,MATH 197,001,091859,McAuley; Julian John,9999,0,9999,0
1657597257644,MATH 197,002,095566,Kedlaya; Kiran S.,9997,0,9999,2
1657597257644,MATH 197,003,095567,Xiao; Ming,9999,0,9999,0
1657597257644,MATH 197,004,095571,Perols; Johan Lars,9998,0,9999,1
1657597264697,COGS 9,A01,083615,Shannon; Kyle Michael,9,0,75,66
1657597270720,COGS 11,A01,083617,Boyle; Mary E. T.,23,0,48,25
1657597276743,COGS 13,A01,083071,Bastos; Amalia Pinkusfeld,11,0,71,60
1657597282765,COGS 14A,A01,092681,Semenuks; Arturs,5,1,100,95
1657597288791,COGS 14B,A01,083073,Cheng; Tzu-Han,6,0,63,57
1657597294823,COGS 17,A01,092677,Semenuks; Arturs,6,0,81,75
1657597300854,COGS 100,A01,083619,Allen; Michael Gordon,17,0,70,53
1657597306880,COGS 101A,A01,083621,Davis; Joshua Daniel,9,0,68,59
1657597312902,COGS 101B,A01,091572,Allen; Michael Gordon,12,0,65,53
1657597318929,COGS 101C,A01,083625,Delgado; Tania,17,0,35,18
1657597324951,COGS 107A,A01,083627,Boyle; Mary E. T.,13,0,60,47
1657597330973,COGS 118A,A01,083075,Gupta; Anjum,21,0,76,55
1657597337016,CSE 3,A50,083646,Miranda; Gregory Joseph,24,0,50,26
1657597343044,CSE 8A,A50,083650,Miranda; Gregory Joseph,17,1,56,39
1657597349072,CSE 11,A01,083080,Cao; Yingjun,6,15,40,34
1657597355102,CSE 12,A01,083652,Krause-Levy; Sophia Louisa,28,1,120,92
1657597361130,CSE 15L,A01,083654,Morris; Justin Loren,9,0,50,41
1657597361130,CSE 15L,A02,083655,Morris; Justin Loren,9,0,50,41
1657597367161,CSE 20,A01,083657,Tran; Khoa Dang,39,0,80,41
1657597373186,CSE 21,A01,095574,Bach; Quang Tran,22,0,48,26
1657597379210,CSE 30,A01,083084,Eldon; John,5,0,80,75
1657597379210,CSE 30,B01,095061,Bhaskar; Nishant,9,0,50,41
1657597385243,CSE 100,A01,083659,Cao; Yingjun,5,4,70,65
1657597391266,CSE 134B,A01,083661,Powell; Thomas Allan,22,0,100,78
1657597397289,CSE 140,A01,083663,Gungor; Onat,15,0,85,70
1657597403316,CSE 140L,A01,083088,Eldon; John,21,0,100,79
1657597409338,CSE 175,A01,083665,Kumar; Rakesh,3,0,25,22
1657597415364,CSE 190,A00,092507,Dubnov; Shlomo,8,0,20,12
1657597421388,ECE 45,A01,083139,Congero; Spencer William,6,0,75,69
1657597427410,ECE 65,A50,083695,Saad; Andrew S,12,0,30,18
1657597427410,ECE 65,A51,095125,Saad; Andrew S,24,0,26,2
1657597433436,ECE 109,A01,091882,Touri; Behrouz,19,0,70,51
1657597439458,ECE 180,A00,083140,Abi Samra; Nicholas Camill,1,0,30,29
1657597439458,ECE 180,B00,083141,Abi Samra; Nicholas Camill,0,0,30,30
1657597445481,MATH 10A,A01,083735,Patchell; Gregory David,2,0,30,28
1657597445481,MATH 10A,A02,083736,Patchell; Gregory David,20,0,30,10
1657597445481,MATH 10A,A03,083737,Patchell; Gregory David,16,0,30,14
1657597451528,MATH 10B,A01,083207,Lim; Seonhee,8,0,34,26
1657597451528,MATH 10B,A02,083208,Lim; Seonhee,9,0,35,26
1657597451528,MATH 10B,A03,093472,Lim; Seonhee,7,0,34,27
1657597451528,MATH 10B,B01,083739,Sinha; Shubham,12,0,30,18
1657597457558,MATH 18,A01,083743,Cinel; Cameron Alexander,7,0,30,23
1657597457558,MATH 18,A02,083744,Cinel; Cameron Alexander,17,0,30,13
1657597457558,MATH 18,A03,083745,Cinel; Cameron Alexander,9,0,30,21
1657597457558,MATH 18,B01,083748,Rideout; David Porter,5,0,37,32
1657597457558,MATH 18,B02,083749,Rideout; David Porter,5,0,36,31
1657597457558,MATH 18,B03,083750,Rideout; David Porter,3,0,37,34
1657597457558,MATH 18,B04,083751,Rideout; David Porter,6,0,36,30
1657597457558,MATH 18,B05,093473,Rideout; David Porter,6,0,36,30
1657597457558,MATH 18,B06,093474,Rideout; David Porter,6,0,36,30
1657597463584,MATH 20A,A01,083754,Zheng; Zequn,14,0,40,26
1657597469605,MATH 20B,A01,083756,Briones; Jor-el Thomas Caparas,4,0,36,32
1657597469605,MATH 20B,A02,083757,Briones; Jor-el Thomas Caparas,1,0,36,35
1657597469605,MATH 20B,A03,093475,Briones; Jor-el Thomas Caparas,2,0,36,34
1657597475637,MATH 20C,A01,083760,Briones; Jor-el Thomas Caparas,1,0,35,34
1657597475637,MATH 20C,A02,083761,Briones; Jor-el Thomas Caparas,8,0,35,27
1657597475637,MATH 20C,A03,093476,Briones; Jor-el Thomas Caparas,0,1,36,36
1657597475637,MATH 20C,B01,083762,Bach; Quang Tran,1,0,30,29
1657597481662,MATH 20D,A01,083765,Tran; Brian Kha,5,0,30,25
1657597481662,MATH 20D,A02,083766,Tran; Brian Kha,5,0,30,25
1657597481662,MATH 20D,A03,083767,Tran; Brian Kha,5,0,30,25
1657597487692,MATH 20E,A01,083771,Ganguly; Soumya,9,0,32,23
1657597487692,MATH 20E,A02,083772,Ganguly; Soumya,6,0,32,26
1657597487692,MATH 20E,B01,083773,Ciotti; Benjamin,20,0,35,15
1657597487692,MATH 20E,B02,083774,Ciotti; Benjamin,18,0,35,17
1657597493716,MATH 103A,A01,083777,Greenfeld; Be'Eri,3,0,36,33
1657597493716,MATH 103A,A02,083778,Greenfeld; Be'Eri,5,0,36,31
1657597493716,MATH 103A,A03,093561,Greenfeld; Be'Eri,6,0,36,30
1657597493716,MATH 103A,B01,083779,Greenfeld; Be'Eri,7,0,36,29
1657597493716,MATH 103A,B02,083780,Greenfeld; Be'Eri,4,0,36,32
1657597493716,MATH 103A,B03,093562,Greenfeld; Be'Eri,3,0,36,33
1657597499831,MATH 105,A01,085443,Carter; Anne Toulson,15,0,35,20
1657597499831,MATH 105,A02,093477,Carter; Anne Toulson,20,0,35,15
1657597505859,MATH 109,A01,083213,Ganzberger; Geoffrey Michael,2,0,34,32
1657597505859,MATH 109,A02,083214,Ganzberger; Geoffrey Michael,4,0,34,30
1657597505859,MATH 109,A03,093478,Ganzberger; Geoffrey Michael,2,0,34,32
1657597505859,MATH 109,B01,083215,Ganzberger; Geoffrey Michael,1,0,32,31
1657597505859,MATH 109,B02,083216,Ganzberger; Geoffrey Michael,2,0,32,30
1657597505859,MATH 109,B03,093479,Ganzberger; Geoffrey Michael,8,0,32,24
1657597511882,MATH 142A,A01,083219,Chow; Bennett,7,0,32,25
1657597511882,MATH 142A,A02,083220,Chow; Bennett,10,0,32,22
1657597511882,MATH 142A,A03,093480,Chow; Bennett,9,0,32,23
1657597511882,MATH 142A,B03,093481,Chow; Bennett,8,0,32,24
1657597511882,MATH 142A,B04,093558,Chow; Bennett,13,0,32,19
1657597511882,MATH 142A,B05,093559,Chow; Bennett,6,0,32,26
1657597517904,MATH 193A,A01,083224,Rotar; Vladimir,8,0,34,26
1657597517904,MATH 193A,A02,083225,Rotar; Vladimir,9,0,34,25
1657597517904,MATH 193A,A03,083781,Rotar; Vladimir,5,0,34,29
1657597517904,MATH 193A,A04,083782,Rotar; Vladimir,10,0,34,24
1657597517904,MATH 193A,A05,093482,Rotar; Vladimir,10,0,34,24
1657597523927,MATH 197,001,091859,McAuley; Julian John,9999,0,9999,0
1657597523927,MATH 197,002,095566,Kedlaya; Kiran S.,9997,0,9999,2
1657597523927,MATH 197,003,095567,Xiao; Ming,9999,0,9999,0
1657597523927,MATH 197,004,095571,Perols; Johan Lars,9998,0,9999,1
1657597530989,COGS 9,A01,083615,Shannon; Kyle Michael,9,0,75,66
1657597537015,COGS 11,A01,083617,Boyle; Mary E. T.,23,0,48,25
1657597543043,COGS 13,A01,083071,Bastos; Amalia Pinkusfeld,11,0,71,60
1657597549069,COGS 14A,A01,092681,Semenuks; Arturs,5,1,100,95
1657597555101,COGS 14B,A01,083073,Cheng; Tzu-Han,6,0,63,57
1657597561129,COGS 17,A01,092677,Semenuks; Arturs,6,0,81,75
1657597567151,COGS 100,A01,083619,Allen; Michael Gordon,17,0,70,53
1657597573178,COGS 101A,A01,083621,Davis; Joshua Daniel,9,0,68,59
1657597579201,COGS 101B,A01,091572,Allen; Michael Gordon,12,0,65,53
1657597585225,COGS 101C,A01,083625,Delgado; Tania,17,0,35,18
1657597591248,COGS 107A,A01,083627,Boyle; Mary E. T.,13,0,60,47
1657597597270,COGS 118A,A01,083075,Gupta; Anjum,21,0,76,55
1657597603294,CSE 3,A50,083646,Miranda; Gregory Joseph,24,0,50,26
1657597609321,CSE 8A,A50,083650,Miranda; Gregory Joseph,17,1,56,39
1657597615343,CSE 11,A01,083080,Cao; Yingjun,6,15,40,34
1657597621380,CSE 12,A01,083652,Krause-Levy; Sophia Louisa,28,1,120,92
1657597627405,CSE 15L,A01,083654,Morris; Justin Loren,9,0,50,41
1657597627405,CSE 15L,A02,083655,Morris; Justin Loren,9,0,50,41
1657597633428,CSE 20,A01,083657,Tran; Khoa Dang,39,0,80,41
1657597639450,CSE 21,A01,095574,Bach; Quang Tran,22,0,48,26
1657597645474,CSE 30,A01,083084,Eldon; John,5,0,80,75
1657597645474,CSE 30,B01,095061,Bhaskar; Nishant,9,0,50,41
1657597651497,CSE 100,A01,083659,Cao; Yingjun,5,4,70,65
1657597657521,CSE 134B,A01,083661,Powell; Thomas Allan,22,0,100,78
1657597663544,CSE 140,A01,083663,Gungor; Onat,15,0,85,70
1657597669567,CSE 140L,A01,083088,Eldon; John,21,0,100,79
1657597675589,CSE 175,A01,083665,Kumar; Rakesh,3,0,25,22
1657597681614,CSE 190,A00,092507,Dubnov; Shlomo,8,0,20,12
1657597687637,ECE 45,A01,083139,Congero; Spencer William,6,0,75,69
1657597693664,ECE 65,A50,083695,Saad; Andrew S,12,0,30,18
1657597693664,ECE 65,A51,095125,Saad; Andrew S,24,0,26,2
1657597699687,ECE 109,A01,091882,Touri; Behrouz,19,0,70,51
1657597705712,ECE 180,A00,083140,Abi Samra; Nicholas Camill,1,0,30,29
1657597705712,ECE 180,B00,083141,Abi Samra; Nicholas Camill,0,0,30,30
1657597711738,MATH 10A,A01,083735,Patchell; Gregory David,2,0,30,28
1657597711738,MATH 10A,A02,083736,Patchell; Gregory David,20,0,30,10
1657597711738,MATH 10A,A03,083737,Patchell; Gregory David,16,0,30,14
1657597717764,MATH 10B,A01,083207,Lim; Seonhee,8,0,34,26
1657597717764,MATH 10B,A02,083208,Lim; Seonhee,9,0,35,26
1657597717764,MATH 10B,A03,093472,Lim; Seonhee,7,0,34,27
1657597717764,MATH 10B,B01,083739,Sinha; Shubham,12,0,30,18
1657597723795,MATH 18,A01,083743,Cinel; Cameron Alexander,7,0,30,23
1657597723795,MATH 18,A02,083744,Cinel; Cameron Alexander,17,0,30,13
1657597723795,MATH 18,A03,083745,Cinel; Cameron Alexander,9,0,30,21
1657597723795,MATH 18,B01,083748,Rideout; David Porter,5,0,37,32
1657597723795,MATH 18,B02,083749,Rideout; David Porter,5,0,36,31
1657597723795,MATH 18,B03,083750,Rideout; David Porter,3,0,37,34
1657597723795,MATH 18,B04,083751,Rideout; David Porter,6,0,36,30
1657597723795,MATH 18,B05,093473,Rideout; David Porter,6,0,36,30
1657597723795,MATH 18,B06,093474,Rideout; David Porter,6,0,36,30
1657597729833,MATH 20A,A01,083754,Zheng; Zequn,14,0,40,26
1657597735863,MATH 20B,A01,083756,Briones; Jor-el Thomas Caparas,4,0,36,32
1657597735863,MATH 20B,A02,083757,Briones; Jor-el Thomas Caparas,1,0,36,35
1657597735863,MATH 20B,A03,093475,Briones; Jor-el Thomas Caparas,2,0,36,34
1657597741886,MATH 20C,A01,083760,Briones; Jor-el Thomas Caparas,1,0,35,34
1657597741886,MATH 20C,A02,083761,Briones; Jor-el Thomas Caparas,8,0,35,27
1657597741886,MATH 20C,A03,093476,Briones; Jor-el Thomas Caparas,0,1,36,36
1657597741886,MATH 20C,B01,083762,Bach; Quang Tran,1,0,30,29
1657597747909,MATH 20D,A01,083765,Tran; Brian Kha,5,0,30,25
1657597747909,MATH 20D,A02,083766,Tran; Brian Kha,5,0,30,25
1657597747909,MATH 20D,A03,083767,Tran; Brian Kha,5,0,30,25
1657597753931,MATH 20E,A01,083771,Ganguly; Soumya,9,0,32,23
1657597753931,MATH 20E,A02,083772,Ganguly; Soumya,6,0,32,26
1657597753931,MATH 20E,B01,083773,Ciotti; Benjamin,20,0,35,15
1657597753931,MATH 20E,B02,083774,Ciotti; Benjamin,18,0,35,17
1657597759960,MATH 103A,A01,083777,Greenfeld; Be'Eri,3,0,36,33
1657597759960,MATH 103A,A02,083778,Greenfeld; Be'Eri,5,0,36,31
1657597759960,MATH 103A,A03,093561,Greenfeld; Be'Eri,6,0,36,30
1657597759960,MATH 103A,B01,083779,Greenfeld; Be'Eri,7,0,36,29
1657597759960,MATH 103A,B02,083780,Greenfeld; Be'Eri,4,0,36,32
1657597759960,MATH 103A,B03,093562,Greenfeld; Be'Eri,3,0,36,33
1657597765983,MATH 105,A01,085443,Carter; Anne Toulson,15,0,35,20
1657597765983,MATH 105,A02,093477,Carter; Anne Toulson,20,0,35,15
1657597772007,MATH 109,A01,083213,Ganzberger; Geoffrey Michael,2,0,34,32
1657597772007,MATH 109,A02,083214,Ganzberger; Geoffrey Michael,4,0,34,30
1657597772007,MATH 109,A03,093478,Ganzberger; Geoffrey Michael,2,0,34,32
1657597772007,MATH 109,B01,083215,Ganzberger; Geoffrey Michael,1,0,32,31
1657597772007,MATH 109,B02,083216,Ganzberger; Geoffrey Michael,2,0,32,30
1657597772007,MATH 109,B03,093479,Ganzberger; Geoffrey Michael,8,0,32,24
1657597778038,MATH 142A,A01,083219,Chow; Bennett,7,0,32,25
1657597778038,MATH 142A,A02,083220,Chow; Bennett,10,0,32,22
1657597778038,MATH 142A,A03,093480,Chow; Bennett,9,0,32,23
1657597778038,MATH 142A,B03,093481,Chow; Bennett,8,0,32,24
1657597778038,MATH 142A,B04,093558,Chow; Bennett,13,0,32,19
1657597778038,MATH 142A,B05,093559,Chow; Bennett,6,0,32,26
1657597784081,MATH 193A,A01,083224,Rotar; Vladimir,8,0,34,26
1657597784081,MATH 193A,A02,083225,Rotar; Vladimir,9,0,34,25
1657597784081,MATH 193A,A03,083781,Rotar; Vladimir,5,0,34,29
1657597784081,MATH 193A,A04,083782,Rotar; Vladimir,10,0,34,24
1657597784081,MATH 193A,A05,093482,Rotar; Vladimir,10,0,34,24
1657597790105,MATH 197,001,091859,McAuley; Julian John,9999,0,9999,0
1657597790105,MATH 197,002,095566,Kedlaya; Kiran S.,9997,0,9999,2
1657597790105,MATH 197,003,095567,Xiao; Ming,9999,0,9999,0
1657597790105,MATH 197,004,095571,Perols; Johan Lars,9998,0,9999,1
1657597797173,COGS 9,A01,083615,Shannon; Kyle Michael,9,0,75,66
1657597803201,COGS 11,A01,083617,Boyle; Mary E. T.,23,0,48,25
1657597809226,COGS 13,A01,083071,Bastos; Amalia Pinkusfeld,11,0,71,60
1657597815254,COGS 14A,A01,092681,Semenuks; Arturs,5,1,100,95
1657597821278,COGS 14B,A01,083073,Cheng; Tzu-Han,6,0,63,57
1657597827303,COGS 17,A01,092677,Semenuks; Arturs,6,0,81,75
1657597833334,COGS 100,A01,083619,Allen; Michael Gordon,17,0,70,53
1657597839358,COGS 101A,A01,083621,Davis; Joshua Daniel,9,0,68,59
1657597845381,COGS 101B,A01,091572,Allen; Michael Gordon,12,0,65,53
1657597851412,COGS 101C,A01,083625,Delgado; Tania,17,0,35,18
1657597857436,COGS 107A,A01,083627,Boyle; Mary E. T.,13,0,60,47
1657597863466,COGS 118A,A01,083075,Gupta; Anjum,21,0,76,55
1657597869489,CSE 3,A50,083646,Miranda; Gregory Joseph,24,0,50,26
1657597875520,CSE 8A,A50,083650,Miranda; Gregory Joseph,17,1,56,39
1657597881562,CSE 11,A01,083080,Cao; Yingjun,6,15,40,34
1657597887589,CSE 12,A01,083652,Krause-Levy; Sophia Louisa,28,1,120,92
1657597893614,CSE 15L,A01,083654,Morris; Justin Loren,9,0,50,41
1657597893614,CSE 15L,A02,083655,Morris; Justin Loren,9,0,50,41
1657597899636,CSE 20,A01,083657,Tran; Khoa Dang,39,0,80,41
1657597905662,CSE 21,A01,095574,Bach; Quang Tran,22,0,48,26
1657597911687,CSE 30,A01,083084,Eldon; John,5,0,80,75
1657597911687,CSE 30,B01,095061,Bhaskar; Nishant,9,0,50,41
1657597917709,CSE 100,A01,083659,Cao; Yingjun,5,4,70,65
1657597923731,CSE 134B,A01,083661,Powell; Thomas Allan,22,0,100,78
1657597929758,CSE 140,A01,083663,Gungor; Onat,15,0,85,70
1657597935783,CSE 140L,A01,083088,Eldon; John,21,0,100,79
1657597941808,CSE 175,A01,083665,Kumar; Rakesh,3,0,25,22
1657597947834,CSE 190,A00,092507,Dubnov; Shlomo,8,0,20,12
1657597953858,ECE 45,A01,083139,Congero; Spencer William,6,0,75,69
1657597959885,ECE 65,A50,083695,Saad; Andrew S,12,0,30,18
1657597959885,ECE 65,A51,095125,Saad; Andrew S,24,0,26,2
1657597965908,ECE 109,A01,091882,Touri; Behrouz,19,0,70,51
1657597971931,ECE 180,A00,083140,Abi Samra; Nicholas Camill,1,0,30,29
1657597971931,ECE 180,B00,083141,Abi Samra; Nicholas Camill,0,0,30,30
1657597977962,MATH 10A,A01,083735,Patchell; Gregory David,2,0,30,28
1657597977962,MATH 10A,A02,083736,Patchell; Gregory David,20,0,30,10
1657597977962,MATH 10A,A03,083737,Patchell; Gregory David,16,0,30,14
1657597983984,MATH 10B,A01,083207,Lim; Seonhee,8,0,34,26
1657597983984,MATH 10B,A02,083208,Lim; Seonhee,9,0,35,26
1657597983984,MATH 10B,A03,093472,Lim; Seonhee,7,0,34,27
1657597983984,MATH 10B,B01,083739,Sinha; Shubham,12,0,30,18
1657597990007,MATH 18,A01,083743,Cinel; Cameron Alexander,7,0,30,23
1657597990007,MATH 18,A02,083744,Cinel; Cameron Alexander,17,0,30,13
1657597990007,MATH 18,A03,083745,Cinel; Cameron Alexander,9,0,30,21
1657597990007,MATH 18,B01,083748,Rideout; David Porter,5,0,37,32
1657597990007,MATH 18,B02,083749,Rideout; David Porter,5,0,36,31
1657597990007,MATH 18,B03,083750,Rideout; David Porter,3,0,37,34
1657597990007,MATH 18,B04,083751,Rideout; David Porter,6,0,36,30
1657597990007,MATH 18,B05,093473,Rideout; David Porter,6,0,36,30
1657597990007,MATH 18,B06,093474,Rideout; David Porter,6,0,36,30
1657597996029,MATH 20A,A01,083754,Zheng; Zequn,14,0,40,26
1657598002057,MATH 20B,A01,083756,Briones; Jor-el Thomas Caparas,4,0,36,32
1657598002057,MATH 20B,A02,083757,Briones; Jor-el Thomas Caparas,1,0,36,35
1657598002057,MATH 20B,A03,093475,Briones; Jor-el Thomas Caparas,2,0,36,34
1657598008080,MATH 20C,A01,083760,Briones; Jor-el Thomas Caparas,1,0,35,34
1657598008080,MATH 20C,A02,083761,Briones; Jor-el Thomas Caparas,8,0,35,27
1657598008080,MATH 20C,A03,093476,Briones; Jor-el Thomas Caparas,0,1,36,36
1657598008080,MATH 20C,B01,083762,Bach; Quang Tran,1,0,30,29
1657598014106,MATH 20D,A01,083765,Tran; Brian Kha,5,0,30,25
1657598014106,MATH 20D,A02,083766,Tran; Brian Kha,5,0,30,25
1657598014106,MATH 20D,A03,083767,Tran; Brian Kha,5,0,30,25
1657598020141,MATH 20E,A01,083771,Ganguly; Soumya,9,0,32,23
1657598020141,MATH 20E,A02,083772,Ganguly; Soumya,6,0,32,26
1657598020141,MATH 20E,B01,083773,Ciotti; Benjamin,20,0,35,15
1657598020141,MATH 20E,B02,083774,Ciotti; Benjamin,18,0,35,17
1657598026167,MATH 103A,A01,083777,Greenfeld; Be'Eri,3,0,36,33
1657598026167,MATH 103A,A02,083778,Greenfeld; Be'Eri,5,0,36,31
1657598026167,MATH 103A,A03,093561,Greenfeld; Be'Eri,6,0,36,30
1657598026167,MATH 103A,B01,083779,Greenfeld; Be'Eri,7,0,36,29
1657598026167,MATH 103A,B02,083780,Greenfeld; Be'Eri,4,0,36,32
1657598026167,MATH 103A,B03,093562,Greenfeld; Be'Eri,3,0,36,33
1657598032191,MATH 105,A01,085443,Carter; Anne Toulson,15,0,35,20
1657598032191,MATH 105,A02,093477,Carter; Anne Toulson,20,0,35,15
1657598038217,MATH 109,A01,083213,Ganzberger; Geoffrey Michael,2,0,34,32
1657598038217,MATH 109,A02,083214,Ganzberger; Geoffrey Michael,4,0,34,30
1657598038217,MATH 109,A03,093478,Ganzberger; Geoffrey Michael,2,0,34,32
1657598038217,MATH 109,B01,083215,Ganzberger; Geoffrey Michael,1,0,32,31
1657598038217,MATH 109,B02,083216,Ganzberger; Geoffrey Michael,2,0,32,30
1657598038217,MATH 109,B03,093479,Ganzberger; Geoffrey Michael,8,0,32,24
1657598044242,MATH 142A,A01,083219,Chow; Bennett,7,0,32,25
1657598044242,MATH 142A,A02,083220,Chow; Bennett,10,0,32,22
1657598044242,MATH 142A,A03,093480,Chow; Bennett,9,0,32,23
1657598044242,MATH 142A,B03,093481,Chow; Bennett,8,0,32,24
1657598044242,MATH 142A,B04,093558,Chow; Bennett,13,0,32,19
1657598044242,MATH 142A,B05,093559,Chow; Bennett,6,0,32,26
1657598050271,MATH 193A,A01,083224,Rotar; Vladimir,8,0,34,26
1657598050271,MATH 193A,A02,083225,Rotar; Vladimir,9,0,34,25
1657598050271,MATH 193A,A03,083781,Rotar; Vladimir,5,0,34,29
1657598050271,MATH 193A,A04,083782,Rotar; Vladimir,10,0,34,24
1657598050271,MATH 193A,A05,093482,Rotar; Vladimir,10,0,34,24
1657598056292,MATH 197,001,091859,McAuley; Julian John,9999,0,9999,0
1657598056292,MATH 197,002,095566,Kedlaya; Kiran S.,9997,0,9999,2
1657598056292,MATH 197,003,095567,Xiao; Ming,9999,0,9999,0
1657598056292,MATH 197,004,095571,Perols; Johan Lars,9998,0,9999,1
1657598063352,COGS 9,A01,083615,Shannon; Kyle Michael,9,0,75,66
1657598069378,COGS 11,A01,083617,Boyle; Mary E. T.,23,0,48,25
1657598075405,COGS 13,A01,083071,Bastos; Amalia Pinkusfeld,11,0,71,60
1657598081438,COGS 14A,A01,092681,Semenuks; Arturs,5,1,100,95
1657598087460,COGS 14B,A01,083073,Cheng; Tzu-Han,6,0,63,57
1657598093575,COGS 17,A01,092677,Semenuks; Arturs,6,0,81,75
1657598099606,COGS 100,A01,083619,Allen; Michael Gordon,17,0,70,53
1657598105629,COGS 101A,A01,083621,Davis; Joshua Daniel,9,0,68,59
1657598111650,COGS 101B,A01,091572,Allen; Michael Gordon,12,0,65,53
1657598117677,COGS 101C,A01,083625,Delgado; Tania,17,0,35,18
1657598123697,COGS 107A,A01,083627,Boyle; Mary E. T.,13,0,60,47
1657598129738,COGS 118A,A01,083075,Gupta; Anjum,21,0,76,55
1657598135761,CSE 3,A50,083646,Miranda; Gregory Joseph,24,0,50,26
1657598141783,CSE 8A,A50,083650,Miranda; Gregory Joseph,17,1,56,39
1657598147805,CSE 11,A01,083080,Cao; Yingjun,6,15,40,34
1657598153827,CSE 12,A01,083652,Krause-Levy; Sophia Louisa,28,1,120,92
1657598159851,CSE 15L,A01,083654,Morris; Justin Loren,9,0,50,41
1657598159851,CSE 15L,A02,083655,Morris; Justin Loren,9,0,50,41
1657598165874,CSE 20,A01,083657,Tran; Khoa Dang,39,0,80,41
1657598171899,CSE 21,A01,095574,Bach; Quang Tran,22,0,48,26
1657598177922,CSE 30,A01,083084,Eldon; John,5,0,80,75
1657598177922,CSE 30,B01,095061,Bhaskar; Nishant,9,0,50,41
1657598183945,CSE 100,A01,083659,Cao; Yingjun,5,4,70,65
1657598189971,CSE 134B,A01,083661,Powell; Thomas Allan,22,0,100,78
1657598195992,CSE 140,A01,083663,Gungor; Onat,15,0,85,70
1657598202018,CSE 140L,A01,083088,Eldon; John,21,0,100,79
1657598208044,CSE 175,A01,083665,Kumar; Rakesh,3,0,25,22
1657598214075,CSE 190,A00,092507,Dubnov; Shlomo,8,0,20,12
1657598220102,ECE 45,A01,083139,Congero; Spencer William,6,0,75,69
1657598226137,ECE 65,A50,083695,Saad; Andrew S,12,0,30,18
1657598226137,ECE 65,A51,095125,Saad; Andrew S,24,0,26,2
1657598232160,ECE 109,A01,091882,Touri; Behrouz,19,0,70,51
1657598238184,ECE 180,A00,083140,Abi Samra; Nicholas Camill,1,0,30,29
1657598238184,ECE 180,B00,083141,Abi Samra; Nicholas Camill,0,0,30,30
1657598244212,MATH 10A,A01,083735,Patchell; Gregory David,2,0,30,28
1657598244212,MATH 10A,A02,083736,Patchell; Gregory David,20,0,30,10
1657598244212,MATH 10A,A03,083737,Patchell; Gregory David,16,0,30,14
1657598250237,MATH 10B,A01,083207,Lim; Seonhee,8,0,34,26
1657598250237,MATH 10B,A02,083208,Lim; Seonhee,9,0,35,26
1657598250237,MATH 10B,A03,093472,Lim; Seonhee,7,0,34,27
1657598250237,MATH 10B,B01,083739,Sinha; Shubham,12,0,30,18
1657598256269,MATH 18,A01,083743,Cinel; Cameron Alexander,7,0,30,23
1657598256269,MATH 18,A02,083744,Cinel; Cameron Alexander,17,0,30,13
1657598256269,MATH 18,A03,083745,Cinel; Cameron Alexander,9,0,30,21
1657598256269,MATH 18,B01,083748,Rideout; David Porter,5,0,37,32
1657598256269,MATH 18,B02,083749,Rideout; David Porter,5,0,36,31
1657598256269,MATH 18,B03,083750,Rideout; David Porter,3,0,37,34
1657598256269,MATH 18,B04,083751,Rideout; David Porter,6,0,36,30
1657598256269,MATH 18,B05,093473,Rideout; David Porter,6,0,36,30
1657598256269,MATH 18,B06,093474,Rideout; David Porter,6,0,36,30
1657598262299,MATH 20A,A01,083754,Zheng; Zequn,14,0,40,26
1657598268326,MATH 20B,A01,083756,Briones; Jor-el Thomas Caparas,4,0,36,32
1657598268326,MATH 20B,A02,083757,Briones; Jor-el Thomas Caparas,1,0,36,35
1657598268326,MATH 20B,A03,093475,Briones; Jor-el Thomas Caparas,2,0,36,34
1657598274353,MATH 20C,A01,083760,Briones; Jor-el Thomas Caparas,1,0,35,34
1657598274353,MATH 20C,A02,083761,Briones; Jor-el Thomas Caparas,8,0,35,27
1657598274353,MATH 20C,A03,093476,Briones; Jor-el Thomas Caparas,0,1,36,36
1657598274353,MATH 20C,B01,083762,Bach; Quang Tran,1,0,30,29
1657598280375,MATH 20D,A01,083765,Tran; Brian Kha,5,0,30,25
1657598280375,MATH 20D,A02,083766,Tran; Brian Kha,5,0,30,25
1657598280375,MATH 20D,A03,083767,Tran; Brian Kha,5,0,30,25
1657598286403,MATH 20E,A01,083771,Ganguly; Soumya,9,0,32,23
1657598286403,MATH 20E,A02,083772,Ganguly; Soumya,6,0,32,26
1657598286403,MATH 20E,B01,083773,Ciotti; Benjamin,20,0,35,15
1657598286403,MATH 20E,B02,083774,Ciotti; Benjamin,18,0,35,17
1657598292432,MATH 103A,A01,083777,Greenfeld; Be'Eri,3,0,36,33
1657598292432,MATH 103A,A02,083778,Greenfeld; Be'Eri,5,0,36,31
1657598292432,MATH 103A,A03,093561,Greenfeld; Be'Eri,6,0,36,30
1657598292432,MATH 103A,B01,083779,Greenfeld; Be'Eri,7,0,36,29
1657598292432,MATH 103A,B02,083780,Greenfeld; Be'Eri,4,0,36,32
1657598292432,MATH 103A,B03,093562,Greenfeld; Be'Eri,3,0,36,33
1657598298454,MATH 105,A01,085443,Carter; Anne Toulson,15,0,35,20
1657598298454,MATH 105,A02,093477,Carter; Anne Toulson,20,0,35,15
1657598304482,MATH 109,A01,083213,Ganzberger; Geoffrey Michael,2,0,34,32
1657598304482,MATH 109,A02,083214,Ganzberger; Geoffrey Michael,4,0,34,30
1657598304482,MATH 109,A03,093478,Ganzberger; Geoffrey Michael,2,0,34,32
1657598304482,MATH 109,B01,083215,Ganzberger; Geoffrey Michael,1,0,32,31
1657598304482,MATH 109,B02,083216,Ganzberger; Geoffrey Michael,2,0,32,30
1657598304482,MATH 109,B03,093479,Ganzberger; Geoffrey Michael,8,0,32,24
1657598310508,MATH 142A,A01,083219,Chow; Bennett,7,0,32,25
1657598310508,MATH 142A,A02,083220,Chow; Bennett,10,0,32,22
1657598310508,MATH 142A,A03,093480,Chow; Bennett,9,0,32,23
1657598310508,MATH 142A,B03,093481,Chow; Bennett,8,0,32,24
1657598310508,MATH 142A,B04,093558,Chow; Bennett,13,0,32,19
1657598310508,MATH 142A,B05,093559,Chow; Bennett,6,0,32,26
1657598316532,MATH 193A,A01,083224,Rotar; Vladimir,8,0,34,26
1657598316532,MATH 193A,A02,083225,Rotar; Vladimir,9,0,34,25
1657598316532,MATH 193A,A03,083781,Rotar; Vladimir,5,0,34,29
1657598316532,MATH 193A,A04,083782,Rotar; Vladimir,10,0,34,24
1657598316532,MATH 193A,A05,093482,Rotar; Vladimir,10,0,34,24
1657598322556,MATH 197,001,091859,McAuley; Julian John,9999,0,9999,0
1657598322556,MATH 197,002,095566,Kedlaya; Kiran S.,9997,0,9999,2
1657598322556,MATH 197,003,095567,Xiao; Ming,9999,0,9999,0
1657598322556,MATH 197,004,095571,Perols; Johan Lars,9998,0,9999,1
1657598329615,COGS 9,A01,083615,Shannon; Kyle Michael,9,0,75,66
1657598335638,COGS 11,A01,083617,Boyle; Mary E. T.,23,0,48,25
1657598341662,COGS 13,A01,083071,Bastos; Amalia Pinkusfeld,11,0,71,60
1657598347683,COGS 14A,A01,092681,Semenuks; Arturs,5,1,100,95
1657598353706,COGS 14B,A01,083073,Cheng; Tzu-Han,6,0,63,57
1657598359731,COGS 17,A01,092677,Semenuks; Arturs,6,0,81,75
1657598365755,COGS 100,A01,083619,Allen; Michael Gordon,17,0,70,53
1657598371781,COGS 101A,A01,083621,Davis; Joshua Daniel,9,0,68,59
1657598377802,COGS 101B,A01,091572,Allen; Michael Gordon,12,0,65,53
1657598383829,COGS 101C,A01,083625,Delgado; Tania,17,0,35,18
1657598389853,COGS 107A,A01,083627,Boyle; Mary E. T.,13,0,60,47
1657598395876,COGS 118A,A01,083075,Gupta; Anjum,21,0,76,55
1657598401899,CSE 3,A50,083646,Miranda; Gregory Joseph,24,0,50,26
1657598407921,CSE 8A,A50,083650,Miranda; Gregory Joseph,17,1,56,39
1657598413944,CSE 11,A01,083080,Cao; Yingjun,6,15,40,34
1657598419969,CSE 12,A01,083652,Krause-Levy; Sophia Louisa,28,1,120,92
1657598425994,CSE 15L,A01,083654,Morris; Justin Loren,9,0,50,41
1657598425994,CSE 15L,A02,083655,Morris; Justin Loren,9,0,50,41
1657598432016,CSE 20,A01,083657,Tran; Khoa Dang,39,0,80,41
1657598438039,CSE 21,A01,095574,Bach; Quang Tran,22,0,48,26
1657598444064,CSE 30,A01,083084,Eldon; John,5,0,80,75
1657598444064,CSE 30,B01,095061,Bhaskar; Nishant,9,0,50,41
1657598450087,CSE 100,A01,083659,Cao; Yingjun,5,4,70,65
1657598456114,CSE 134B,A01,083661,Powell; Thomas Allan,22,0,100,78
1657598462136,CSE 140,A01,083663,Gungor; Onat,15,0,85,70
1657598468163,CSE 140L,A01,083088,Eldon; John,21,0,100,79
1657598474187,CSE 175,A01,083665,Kumar; Rakesh,3,0,25,22
1657598480216,CSE 190,A00,092507,Dubnov; Shlomo,8,0,20,12
1657598486240,ECE 45,A01,083139,Congero; Spencer William,6,0,75,69
1657598492268,ECE 65,A50,083695,Saad; Andrew S,12,0,30,18
1657598492268,ECE 65,A51,095125,Saad; Andrew S,24,0,26,2
1657598498290,ECE 109,A01,091882,Touri; Behrouz,19,0,70,51
1657598504316,ECE 180,A00,083140,Abi Samra; Nicholas Camill,1,0,30,29
1657598504316,ECE 180,B00,083141,Abi Samra; Nicholas Camill,0,0,30,30
1657598510344,MATH 10A,A01,083735,Patchell; Gregory David,2,0,30,28
1657598510344,MATH 10A,A02,083736,Patchell; Gregory David,20,0,30,10
1657598510344,MATH 10A,A03,083737,Patchell; Gregory David,16,0,30,14
1657598516372,MATH 10B,A01,083207,Lim; Seonhee,8,0,34,26
1657598516372,MATH 10B,A02,083208,Lim; Seonhee,9,0,35,26
1657598516372,MATH 10B,A03,093472,Lim; Seonhee,7,0,34,27
1657598516372,MATH 10B,B01,083739,Sinha; Shubham,12,0,30,18
1657598522403,MATH 18,A01,083743,Cinel; Cameron Alexander,7,0,30,23
1657598522403,MATH 18,A02,083744,Cinel; Cameron Alexander,17,0,30,13
1657598522403,MATH 18,A03,083745,Cinel; Cameron Alexander,9,0,30,21
1657598522403,MATH 18,B01,083748,Rideout; David Porter,5,0,37,32
1657598522403,MATH 18,B02,083749,Rideout; David Porter,5,0,36,31
1657598522403,MATH 18,B03,083750,Rideout; David Porter,3,0,37,34
1657598522403,MATH 18,B04,083751,Rideout; David Porter,6,0,36,30
1657598522403,MATH 18,B05,093473,Rideout; David Porter,6,0,36,30
1657598522403,MATH 18,B06,093474,Rideout; David Porter,6,0,36,30
1657598528425,MATH 20A,A01,083754,Zheng; Zequn,14,0,40,26
1657598534449,MATH 20B,A01,083756,Briones; Jor-el Thomas Caparas,4,0,36,32
1657598534449,MATH 20B,A02,083757,Briones; Jor-el Thomas Caparas,1,0,36,35
1657598534449,MATH 20B,A03,093475,Briones; Jor-el Thomas Caparas,2,0,36,34
1657598540470,MATH 20C,A01,083760,Briones; Jor-el Thomas Caparas,1,0,35,34
1657598540470,MATH 20C,A02,083761,Briones; Jor-el Thomas Caparas,8,0,35,27
1657598540470,MATH 20C,A03,093476,Briones; Jor-el Thomas Caparas,0,1,36,36
1657598540470,MATH 20C,B01,083762,Bach; Quang Tran,1,0,30,29
1657598546498,MATH 20D,A01,083765,Tran; Brian Kha,5,0,30,25
1657598546498,MATH 20D,A02,083766,Tran; Brian Kha,5,0,30,25
1657598546498,MATH 20D,A03,083767,Tran; Brian Kha,5,0,30,25
1657598552526,MATH 20E,A01,083771,Ganguly; Soumya,9,0,32,23
1657598552526,MATH 20E,A02,083772,Ganguly; Soumya,6,0,32,26
1657598552526,MATH 20E,B01,083773,Ciotti; Benjamin,20,0,35,15
1657598552526,MATH 20E,B02,083774,Ciotti; Benjamin,18,0,35,17
1657598558556,MATH 103A,A01,083777,Greenfeld; Be'Eri,3,0,36,33
1657598558556,MATH 103A,A02,083778,Greenfeld; Be'Eri,5,0,36,31
1657598558556,MATH 103A,A03,093561,Greenfeld; Be'Eri,6,0,36,30
1657598558556,MATH 103A,B01,083779,Greenfeld; Be'Eri,7,0,36,29
1657598558556,MATH 103A,B02,083780,Greenfeld; Be'Eri,4,0,36,32
1657598558556,MATH 103A,B03,093562,Greenfeld; Be'Eri,3,0,36,33
1657598564579,MATH 105,A01,085443,Carter; Anne Toulson,15,0,35,20
1657598564579,MATH 105,A02,093477,Carter; Anne Toulson,20,0,35,15
1657598570608,MATH 109,A01,083213,Ganzberger; Geoffrey Michael,2,0,34,32
1657598570608,MATH 109,A02,083214,Ganzberger; Geoffrey Michael,4,0,34,30
1657598570608,MATH 109,A03,093478,Ganzberger; Geoffrey Michael,2,0,34,32
1657598570608,MATH 109,B01,083215,Ganzberger; Geoffrey Michael,1,0,32,31
1657598570608,MATH 109,B02,083216,Ganzberger; Geoffrey Michael,2,0,32,30
1657598570608,MATH 109,B03,093479,Ganzberger; Geoffrey Michael,8,0,32,24
1657598576638,MATH 142A,A01,083219,Chow; Bennett,7,0,32,25
1657598576638,MATH 142A,A02,083220,Chow; Bennett,10,0,32,22
1657598576638,MATH 142A,A03,093480,Chow; Bennett,9,0,32,23
1657598576638,MATH 142A,B03,093481,Chow; Bennett,8,0,32,24
1657598576638,MATH 142A,B04,093558,Chow; Bennett,13,0,32,19
1657598576638,MATH 142A,B05,093559,Chow; Bennett,6,0,32,26
1657598582662,MATH 193A,A01,083224,Rotar; Vladimir,8,0,34,26
1657598582662,MATH 193A,A02,083225,Rotar; Vladimir,9,0,34,25
1657598582662,MATH 193A,A03,083781,Rotar; Vladimir,5,0,34,29
1657598582662,MATH 193A,A04,083782,Rotar; Vladimir,10,0,34,24
1657598582662,MATH 193A,A05,093482,Rotar; Vladimir,10,0,34,24
1657598588684,MATH 197,001,091859,McAuley; Julian John,9999,0,9999,0
1657598588684,MATH 197,002,095566,Kedlaya; Kiran S.,9997,0,9999,2
1657598588684,MATH 197,003,095567,Xiao; Ming,9999,0,9999,0
1657598588684,MATH 197,004,095571,Perols; Johan Lars,9998,0,9999,1
1657598595732,COGS 9,A01,083615,Shannon; Kyle Michael,9,0,75,66
1657598601760,COGS 11,A01,083617,Boyle; Mary E. T.,23,0,48,25
1657598607783,COGS 13,A01,083071,Bastos; Amalia Pinkusfeld,11,0,71,60
1657598613824,COGS 14A,A01,092681,Semenuks; Arturs,5,1,100,95
1657598619849,COGS 14B,A01,083073,Cheng; Tzu-Han,6,0,63,57
1657598625877,COGS 17,A01,092677,Semenuks; Arturs,6,0,81,75
1657598631900,COGS 100,A01,083619,Allen; Michael Gordon,17,0,70,53
1657598637924,COGS 101A,A01,083621,Davis; Joshua Daniel,9,0,68,59
1657598643950,COGS 101B,A01,091572,Allen; Michael Gordon,12,0,65,53
1657598649973,COGS 101C,A01,083625,Delgado; Tania,17,0,35,18
1657598655997,COGS 107A,A01,083627,Boyle; Mary E. T.,13,0,60,47
1657598662036,COGS 118A,A01,083075,Gupta; Anjum,21,0,76,55
1657598668059,CSE 3,A50,083646,Miranda; Gregory Joseph,24,0,50,26
1657598674082,CSE 8A,A50,083650,Miranda; Gregory Joseph,17,1,56,39
1657598680110,CSE 11,A01,083080,Cao; Yingjun,6,15,40,34
1657598686135,CSE 12,A01,083652,Krause-Levy; Sophia Louisa,28,1,120,92
1657598692230,CSE 15L,A01,083654,Morris; Justin Loren,9,0,50,41
1657598692230,CSE 15L,A02,083655,Morris; Justin Loren,9,0,50,41
1657598698254,CSE 20,A01,083657,Tran; Khoa Dang,39,0,80,41
1657598704281,CSE 21,A01,095574,Bach; Quang Tran,22,0,48,26
1657598710304,CSE 30,A01,083084,Eldon; John,5,0,80,75
1657598710304,CSE 30,B01,095061,Bhaskar; Nishant,9,0,50,41
1657598716329,CSE 100,A01,083659,Cao; Yingjun,5,4,70,65
1657598722354,CSE 134B,A01,083661,Powell; Thomas Allan,22,0,100,78
1657598728378,CSE 140,A01,083663,Gungor; Onat,15,0,85,70
1657598734401,CSE 140L,A01,083088,Eldon; John,21,0,100,79
1657598740423,CSE 175,A01,083665,Kumar; Rakesh,3,0,25,22
1657598746449,CSE 190,A00,092507,Dubnov; Shlomo,8,0,20,12
1657598752483,ECE 45,A01,083139,Congero; Spencer William,6,0,75,69
1657598758510,ECE 65,A50,083695,Saad; Andrew S,12,0,30,18
1657598758510,ECE 65,A51,095125,Saad; Andrew S,24,0,26,2
1657598764531,ECE 109,A01,091882,Touri; Behrouz,19,0,70,51
1657598770561,ECE 180,A00,083140,Abi Samra; Nicholas Camill,1,0,30,29
1657598770561,ECE 180,B00,083141,Abi Samra; Nicholas Camill,0,0,30,30
1657598776586,MATH 10A,A01,083735,Patchell; Gregory David,2,0,30,28
1657598776586,MATH 10A,A02,083736,Patchell; Gregory David,20,0,30,10
1657598776586,MATH 10A,A03,083737,Patchell; Gregory David,16,0,30,14
1657598782610,MATH 10B,A01,083207,Lim; Seonhee,8,0,34,26
1657598782610,MATH 10B,A02,083208,Lim; Seonhee,9,0,35,26
1657598782610,MATH 10B,A03,093472,Lim; Seonhee,7,0,34,27
1657598782610,MATH 10B,B01,083739,Sinha; Shubham,12,0,30,18
1657598788633,MATH 18,A01,083743,Cinel; Cameron Alexander,7,0,30,23
1657598788633,MATH 18,A02,083744,Cinel; Cameron Alexander,17,0,30,13
1657598788633,MATH 18,A03,083745,Cinel; Cameron Alexander,9,0,30,21
1657598788633,MATH 18,B01,083748,Rideout; David Porter,5,0,37,32
1657598788633,MATH 18,B02,083749,Rideout; David Porter,5,0,36,31
1657598788633,MATH 18,B03,083750,Rideout; David Porter,3,0,37,34
1657598788633,MATH 18,B04,083751,Rideout; David Porter,6,0,36,30
1657598788633,MATH 18,B05,093473,Rideout; David Porter,6,0,36,30
1657598788633,MATH 18,B06,093474,Rideout; David Porter,6,0,36,30
1657598794662,MATH 20A,A01,083754,Zheng; Zequn,14,0,40,26
1657598800688,MATH 20B,A01,083756,Briones; Jor-el Thomas Caparas,4,0,36,32
1657598800688,MATH 20B,A02,083757,Briones; Jor-el Thomas Caparas,1,0,36,35
1657598800688,MATH 20B,A03,093475,Briones; Jor-el Thomas Caparas,2,0,36,34
1657598806715,MATH 20C,A01,083760,Briones; Jor-el Thomas Caparas,1,0,35,34
1657598806715,MATH 20C,A02,083761,Briones; Jor-el Thomas Caparas,8,0,35,27
1657598806715,MATH 20C,A03,093476,Briones; Jor-el Thomas Caparas,0,1,36,36
1657598806715,MATH 20C,B01,083762,Bach; Quang Tran,1,0,30,29
1657598812743,MATH 20D,A01,083765,Tran; Brian Kha,5,0,30,25
1657598812743,MATH 20D,A02,083766,Tran; Brian Kha,5,0,30,25
1657598812743,MATH 20D,A03,083767,Tran; Brian Kha,5,0,30,25
1657598818778,MATH 20E,A01,083771,Ganguly; Soumya,9,0,32,23
1657598818778,MATH 20E,A02,083772,Ganguly; Soumya,6,0,32,26
1657598818778,MATH 20E,B01,083773,Ciotti; Benjamin,20,0,35,15
1657598818778,MATH 20E,B02,083774,Ciotti; Benjamin,18,0,35,17
1657598824806,MATH 103A,A01,083777,Greenfeld; Be'Eri,3,0,36,33
1657598824806,MATH 103A,A02,083778,Greenfeld; Be'Eri,5,0,36,31
1657598824806,MATH 103A,A03,093561,Greenfeld; Be'Eri,6,0,36,30
1657598824806,MATH 103A,B01,083779,Greenfeld; Be'Eri,7,0,36,29
1657598824806,MATH 103A,B02,083780,Greenfeld; Be'Eri,4,0,36,32
1657598824806,MATH 103A,B03,093562,Greenfeld; Be'Eri,3,0,36,33
1657598830834,MATH 105,A01,085443,Carter; Anne Toulson,15,0,35,20
1657598830834,MATH 105,A02,093477,Carter; Anne Toulson,20,0,35,15
1657598836858,MATH 109,A01,083213,Ganzberger; Geoffrey Michael,2,0,34,32
1657598836858,MATH 109,A02,083214,Ganzberger; Geoffrey Michael,4,0,34,30
1657598836858,MATH 109,A03,093478,Ganzberger; Geoffrey Michael,2,0,34,32
1657598836858,MATH 109,B01,083215,Ganzberger; Geoffrey Michael,1,0,32,31
1657598836858,MATH 109,B02,083216,Ganzberger; Geoffrey Michael,2,0,32,30
1657598836858,MATH 109,B03,093479,Ganzberger; Geoffrey Michael,8,0,32,24
1657598842886,MATH 142A,A01,083219,Chow; Bennett,7,0,32,25
1657598842886,MATH 142A,A02,083220,Chow; Bennett,10,0,32,22
1657598842886,MATH 142A,A03,093480,Chow; Bennett,9,0,32,23
1657598842886,MATH 142A,B03,093481,Chow; Bennett,8,0,32,24
1657598842886,MATH 142A,B04,093558,Chow; Bennett,13,0,32,19
1657598842886,MATH 142A,B05,093559,Chow; Bennett,6,0,32,26
1657598848910,MATH 193A,A01,083224,Rotar; Vladimir,8,0,34,26
1657598848910,MATH 193A,A02,083225,Rotar; Vladimir,9,0,34,25
1657598848910,MATH 193A,A03,083781,Rotar; Vladimir,5,0,34,29
1657598848910,MATH 193A,A04,083782,Rotar; Vladimir,10,0,34,24
1657598848910,MATH 193A,A05,093482,Rotar; Vladimir,10,0,34,24
1657598854931,MATH 197,001,091859,McAuley; Julian John,9999,0,9999,0
1657598854931,MATH 197,002,095566,Kedlaya; Kiran S.,9997,0,9999,2
1657598854931,MATH 197,003,095567,Xiao; Ming,9999,0,9999,0
1657598854931,MATH 197,004,095571,Perols; Johan Lars,9998,0,9999,1
1657598862006,COGS 9,A01,083615,Shannon; Kyle Michael,9,0,75,66
1657598868037,COGS 11,A01,083617,Boyle; Mary E. T.,23,0,48,25
1657598874061,COGS 13,A01,083071,Bastos; Amalia Pinkusfeld,11,0,71,60
1657598880086,COGS 14A,A01,092681,Semenuks; Arturs,5,1,100,95
1657598886109,COGS 14B,A01,083073,Cheng; Tzu-Han,6,0,63,57
1657598892134,COGS 17,A01,092677,Semenuks; Arturs,6,0,81,75
1657598898158,COGS 100,A01,083619,Allen; Michael Gordon,17,0,70,53
1657598904182,COGS 101A,A01,083621,Davis; Joshua Daniel,9,0,68,59
1657598910205,COGS 101B,A01,091572,Allen; Michael Gordon,12,0,65,53
1657598916233,COGS 101C,A01,083625,Delgado; Tania,17,0,35,18
1657598922271,COGS 107A,A01,083627,Boyle; Mary E. T.,13,0,60,47
1657598928294,COGS 118A,A01,083075,Gupta; Anjum,21,0,76,55
1657598934322,CSE 3,A50,083646,Miranda; Gregory Joseph,24,0,50,26
1657598940349,CSE 8A,A50,083650,Miranda; Gregory Joseph,17,1,56,39
1657598946382,CSE 11,A01,083080,Cao; Yingjun,6,15,40,34
1657598952405,CSE 12,A01,083652,Krause-Levy; Sophia Louisa,28,1,120,92
1657598958433,CSE 15L,A01,083654,Morris; Justin Loren,9,0,50,41
1657598958433,CSE 15L,A02,083655,Morris; Justin Loren,9,0,50,41
1657598964455,CSE 20,A01,083657,Tran; Khoa Dang,39,0,80,41
1657598970477,CSE 21,A01,095574,Bach; Quang Tran,22,0,48,26
1657598976505,CSE 30,A01,083084,Eldon; John,5,0,80,75
1657598976505,CSE 30,B01,095061,Bhaskar; Nishant,9,0,50,41
1657598982539,CSE 100,A01,083659,Cao; Yingjun,5,4,70,65
1657598988560,CSE 134B,A01,083661,Powell; Thomas Allan,22,0,100,78
1657598994593,CSE 140,A01,083663,Gungor; Onat,15,0,85,70
1657599000615,CSE 140L,A01,083088,Eldon; John,21,0,100,79
1657599006637,CSE 175,A01,083665,Kumar; Rakesh,3,0,25,22
1657599012661,CSE 190,A00,092507,Dubnov; Shlomo,8,0,20,12
1657599018687,ECE 45,A01,083139,Congero; Spencer William,6,0,75,69
1657599024715,ECE 65,A50,083695,Saad; Andrew S,12,0,30,18
1657599024715,ECE 65,A51,095125,Saad; Andrew S,24,0,26,2
1657599030741,ECE 109,A01,091882,Touri; Behrouz,19,0,70,51
1657599036774,ECE 180,A00,083140,Abi Samra; Nicholas Camill,1,0,30,29
1657599036774,ECE 180,B00,083141,Abi Samra; Nicholas Camill,0,0,30,30
1657599042798,MATH 10A,A01,083735,Patchell; Gregory David,2,0,30,28
1657599042798,MATH 10A,A02,083736,Patchell; Gregory David,20,0,30,10
1657599042798,MATH 10A,A03,083737,Patchell; Gregory David,16,0,30,14
1657599048821,MATH 10B,A01,083207,Lim; Seonhee,8,0,34,26
1657599048821,MATH 10B,A02,083208,Lim; Seonhee,9,0,35,26
1657599048821,MATH 10B,A03,093472,Lim; Seonhee,7,0,34,27
1657599048821,MATH 10B,B01,083739,Sinha; Shubham,12,0,30,18
1657599054844,MATH 18,A01,083743,Cinel; Cameron Alexander,7,0,30,23
1657599054844,MATH 18,A02,083744,Cinel; Cameron Alexander,17,0,30,13
1657599054844,MATH 18,A03,083745,Cinel; Cameron Alexander,9,0,30,21
1657599054844,MATH 18,B01,083748,Rideout; David Porter,5,0,37,32
1657599054844,MATH 18,B02,083749,Rideout; David Porter,5,0,36,31
1657599054844,MATH 18,B03,083750,Rideout; David Porter,3,0,37,34
1657599054844,MATH 18,B04,083751,Rideout; David Porter,6,0,36,30
1657599054844,MATH 18,B05,093473,Rideout; David Porter,6,0,36,30
1657599054844,MATH 18,B06,093474,Rideout; David Porter,6,0,36,30
1657599060866,MATH 20A,A01,083754,Zheng; Zequn,14,0,40,26
1657599066889,MATH 20B,A01,083756,Briones; Jor-el Thomas Caparas,4,0,36,32
1657599066889,MATH 20B,A02,083757,Briones; Jor-el Thomas Caparas,1,0,36,35
1657599066889,MATH 20B,A03,093475,Briones; Jor-el Thomas Caparas,2,0,36,34
1657599072913,MATH 20C,A01,083760,Briones; Jor-el Thomas Caparas,1,0,35,34
1657599072913,MATH 20C,A02,083761,Briones; Jor-el Thomas Caparas,8,0,35,27
1657599072913,MATH 20C,A03,093476,Briones; Jor-el Thomas Caparas,0,1,36,36
1657599072913,MATH 20C,B01,083762,Bach; Quang Tran,1,0,30,29
1657599078941,MATH 20D,A01,083765,Tran; Brian Kha,5,0,30,25
1657599078941,MATH 20D,A02,083766,Tran; Brian Kha,5,0,30,25
1657599078941,MATH 20D,A03,083767,Tran; Brian Kha,5,0,30,25
1657599084968,MATH 20E,A01,083771,Ganguly; Soumya,9,0,32,23
1657599084968,MATH 20E,A02,083772,Ganguly; Soumya,6,0,32,26
1657599084968,MATH 20E,B01,083773,Ciotti; Benjamin,20,0,35,15
1657599084968,MATH 20E,B02,083774,Ciotti; Benjamin,18,0,35,17
1657599090999,MATH 103A,A01,083777,Greenfeld; Be'Eri,3,0,36,33
1657599090999,MATH 103A,A02,083778,Greenfeld; Be'Eri,5,0,36,31
1657599090999,MATH 103A,A03,093561,Greenfeld; Be'Eri,6,0,36,30
1657599090999,MATH 103A,B01,083779,Greenfeld; Be'Eri,7,0,36,29
1657599090999,MATH 103A,B02,083780,Greenfeld; Be'Eri,4,0,36,32
1657599090999,MATH 103A,B03,093562,Greenfeld; Be'Eri,3,0,36,33
1657599097022,MATH 105,A01,085443,Carter; Anne Toulson,15,0,35,20
1657599097022,MATH 105,A02,093477,Carter; Anne Toulson,20,0,35,15
1657599103044,MATH 109,A01,083213,Ganzberger; Geoffrey Michael,2,0,34,32
1657599103044,MATH 109,A02,083214,Ganzberger; Geoffrey Michael,4,0,34,30
1657599103044,MATH 109,A03,093478,Ganzberger; Geoffrey Michael,2,0,34,32
1657599103044,MATH 109,B01,083215,Ganzberger; Geoffrey Michael,1,0,32,31
1657599103044,MATH 109,B02,083216,Ganzberger; Geoffrey Michael,2,0,32,30
1657599103044,MATH 109,B03,093479,Ganzberger; Geoffrey Michael,8,0,32,24
1657599109082,MATH 142A,A01,083219,Chow; Bennett,7,0,32,25
1657599109082,MATH 142A,A02,083220,Chow; Bennett,10,0,32,22
1657599109082,MATH 142A,A03,093480,Chow; Bennett,9,0,32,23
1657599109082,MATH 142A,B03,093481,Chow; Bennett,8,0,32,24
1657599109082,MATH 142A,B04,093558,Chow; Bennett,13,0,32,19
1657599109082,MATH 142A,B05,093559,Chow; Bennett,6,0,32,26
1657599115105,MATH 193A,A01,083224,Rotar; Vladimir,8,0,34,26
1657599115105,MATH 193A,A02,083225,Rotar; Vladimir,9,0,34,25
1657599115105,MATH 193A,A03,083781,Rotar; Vladimir,5,0,34,29
1657599115105,MATH 193A,A04,083782,Rotar; Vladimir,10,0,34,24
1657599115105,MATH 193A,A05,093482,Rotar; Vladimir,10,0,34,24
1657599121131,MATH 197,001,091859,McAuley; Julian John,9999,0,9999,0
1657599121131,MATH 197,002,095566,Kedlaya; Kiran S.,9997,0,9999,2
1657599121131,MATH 197,003,095567,Xiao; Ming,9999,0,9999,0
1657599121131,MATH 197,004,095571,Perols; Johan Lars,9998,0,9999,1
1657599128191,COGS 9,A01,083615,Shannon; Kyle Michael,9,0,75,66
1657599134218,COGS 11,A01,083617,Boyle; Mary E. T.,23,0,48,25
1657599140243,COGS 13,A01,083071,Bastos; Amalia Pinkusfeld,11,0,71,60
1657599146273,COGS 14A,A01,092681,Semenuks; Arturs,5,1,100,95
1657599152296,COGS 14B,A01,083073,Cheng; Tzu-Han,6,0,63,57
1657599158320,COGS 17,A01,092677,Semenuks; Arturs,6,0,81,75
1657599164344,COGS 100,A01,083619,Allen; Michael Gordon,17,0,70,53
1657599170372,COGS 101A,A01,083621,Davis; Joshua Daniel,9,0,68,59
1657599176398,COGS 101B,A01,091572,Allen; Michael Gordon,12,0,65,53
1657599182420,COGS 101C,A01,083625,Delgado; Tania,17,0,35,18
1657599188447,COGS 107A,A01,083627,Boyle; Mary E. T.,13,0,60,47
1657599194470,COGS 118A,A01,083075,Gupta; Anjum,21,0,76,55
1657599200493,CSE 3,A50,083646,Miranda; Gregory Joseph,24,0,50,26
1657599206515,CSE 8A,A50,083650,Miranda; Gregory Joseph,17,1,56,39
1657599212539,CSE 11,A01,083080,Cao; Yingjun,6,15,40,34
1657599218579,CSE 12,A01,083652,Krause-Levy; Sophia Louisa,28,1,120,92
1657599224606,CSE 15L,A01,083654,Morris; Justin Loren,9,0,50,41
1657599224606,CSE 15L,A02,083655,Morris; Justin Loren,9,0,50,41
1657599230628,CSE 20,A01,083657,Tran; Khoa Dang,39,0,80,41
1657599236652,CSE 21,A01,095574,Bach; Quang Tran,22,0,48,26
1657599242675,CSE 30,A01,083084,Eldon; John,5,0,80,75
1657599242675,CSE 30,B01,095061,Bhaskar; Nishant,9,0,50,41
1657599248698,CSE 100,A01,083659,Cao; Yingjun,5,4,70,65
1657599254722,CSE 134B,A01,083661,Powell; Thomas Allan,22,0,100,78
1657599260746,CSE 140,A01,083663,Gungor; Onat,15,0,85,70
1657599266769,CSE 140L,A01,083088,Eldon; John,21,0,100,79
1657599272797,CSE 175,A01,083665,Kumar; Rakesh,3,0,25,22
1657599278821,CSE 190,A00,092507,Dubnov; Shlomo,8,0,20,12
1657599284849,ECE 45,A01,083139,Congero; Spencer William,6,0,75,69
1657599290970,ECE 65,A50,083695,Saad; Andrew S,12,0,30,18
1657599290970,ECE 65,A51,095125,Saad; Andrew S,24,0,26,2
1657599296995,ECE 109,A01,091882,Touri; Behrouz,19,0,70,51
1657599303018,ECE 180,A00,083140,Abi Samra; Nicholas Camill,1,0,30,29
1657599303018,ECE 180,B00,083141,Abi Samra; Nicholas Camill,0,0,30,30
1657599309042,MATH 10A,A01,083735,Patchell; Gregory David,2,0,30,28
1657599309042,MATH 10A,A02,083736,Patchell; Gregory David,20,0,30,10
1657599309042,MATH 10A,A03,083737,Patchell; Gregory David,16,0,30,14
1657599315065,MATH 10B,A01,083207,Lim; Seonhee,8,0,34,26
1657599315065,MATH 10B,A02,083208,Lim; Seonhee,9,0,35,26
1657599315065,MATH 10B,A03,093472,Lim; Seonhee,7,0,34,27
1657599315065,MATH 10B,B01,083739,Sinha; Shubham,12,0,30,18
1657599321094,MATH 18,A01,083743,Cinel; Cameron Alexander,7,0,30,23
1657599321094,MATH 18,A02,083744,Cinel; Cameron Alexander,17,0,30,13
1657599321094,MATH 18,A03,083745,Cinel; Cameron Alexander,9,0,30,21
1657599321094,MATH 18,B01,083748,Rideout; David Porter,5,0,37,32
1657599321094,MATH 18,B02,083749,Rideout; David Porter,5,0,36,31
1657599321094,MATH 18,B03,083750,Rideout; David Porter,3,0,37,34
1657599321094,MATH 18,B04,083751,Rideout; David Porter,6,0,36,30
1657599321094,MATH 18,B05,093473,Rideout; David Porter,6,0,36,30
1657599321094,MATH 18,B06,093474,Rideout; David Porter,6,0,36,30
1657599327116,MATH 20A,A01,083754,Zheng; Zequn,14,0,40,26
1657599333140,MATH 20B,A01,083756,Briones; Jor-el Thomas Caparas,4,0,36,32
1657599333140,MATH 20B,A02,083757,Briones; Jor-el Thomas Caparas,1,0,36,35
1657599333140,MATH 20B,A03,093475,Briones; Jor-el Thomas Caparas,2,0,36,34
1657599339172,MATH 20C,A01,083760,Briones; Jor-el Thomas Caparas,1,0,35,34
1657599339172,MATH 20C,A02,083761,Briones; Jor-el Thomas Caparas,8,0,35,27
1657599339172,MATH 20C,A03,093476,Briones; Jor-el Thomas Caparas,0,1,36,36
1657599339172,MATH 20C,B01,083762,Bach; Quang Tran,1,0,30,29
1657599345200,MATH 20D,A01,083765,Tran; Brian Kha,5,0,30,25
1657599345200,MATH 20D,A02,083766,Tran; Brian Kha,5,0,30,25
1657599345200,MATH 20D,A03,083767,Tran; Brian Kha,5,0,30,25
1657599351224,MATH 20E,A01,083771,Ganguly; Soumya,9,0,32,23
1657599351224,MATH 20E,A02,083772,Ganguly; Soumya,6,0,32,26
1657599351224,MATH 20E,B01,083773,Ciotti; Benjamin,20,0,35,15
1657599351224,MATH 20E,B02,083774,Ciotti; Benjamin,18,0,35,17
1657599357248,MATH 103A,A01,083777,Greenfeld; Be'Eri,3,0,36,33
1657599357248,MATH 103A,A02,083778,Greenfeld; Be'Eri,5,0,36,31
1657599357248,MATH 103A,A03,093561,Greenfeld; Be'Eri,6,0,36,30
1657599357248,MATH 103A,B01,083779,Greenfeld; Be'Eri,7,0,36,29
1657599357248,MATH 103A,B02,083780,Greenfeld; Be'Eri,4,0,36,32
1657599357248,MATH 103A,B03,093562,Greenfeld; Be'Eri,3,0,36,33
1657599363276,MATH 105,A01,085443,Carter; Anne Toulson,15,0,35,20
1657599363276,MATH 105,A02,093477,Carter; Anne Toulson,20,0,35,15
1657599369304,MATH 109,A01,083213,Ganzberger; Geoffrey Michael,2,0,34,32
1657599369304,MATH 109,A02,083214,Ganzberger; Geoffrey Michael,4,0,34,30
1657599369304,MATH 109,A03,093478,Ganzberger; Geoffrey Michael,2,0,34,32
1657599369304,MATH 109,B01,083215,Ganzberger; Geoffrey Michael,1,0,32,31
1657599369304,MATH 109,B02,083216,Ganzberger; Geoffrey Michael,2,0,32,30
1657599369304,MATH 109,B03,093479,Ganzberger; Geoffrey Michael,8,0,32,24
1657599375332,MATH 142A,A01,083219,Chow; Bennett,7,0,32,25
1657599375332,MATH 142A,A02,083220,Chow; Bennett,10,0,32,22
1657599375332,MATH 142A,A03,093480,Chow; Bennett,9,0,32,23
1657599375332,MATH 142A,B03,093481,Chow; Bennett,8,0,32,24
1657599375332,MATH 142A,B04,093558,Chow; Bennett,13,0,32,19
1657599375332,MATH 142A,B05,093559,Chow; Bennett,6,0,32,26
1657599381355,MATH 193A,A01,083224,Rotar; Vladimir,8,0,34,26
1657599381355,MATH 193A,A02,083225,Rotar; Vladimir,9,0,34,25
1657599381355,MATH 193A,A03,083781,Rotar; Vladimir,5,0,34,29
1657599381355,MATH 193A,A04,083782,Rotar; Vladimir,10,0,34,24
1657599381355,MATH 193A,A05,093482,Rotar; Vladimir,10,0,34,24
1657599387376,MATH 197,001,091859,McAuley; Julian John,9999,0,9999,0
1657599387376,MATH 197,002,095566,Kedlaya; Kiran S.,9997,0,9999,2
1657599387376,MATH 197,003,095567,Xiao; Ming,9999,0,9999,0
1657599387376,MATH 197,004,095571,Perols; Johan Lars,9998,0,9999,1
1657599394436,COGS 9,A01,083615,Shannon; Kyle Michael,9,0,75,66
1657599400457,COGS 11,A01,083617,Boyle; Mary E. T.,23,0,48,25
1657599406485,COGS 13,A01,083071,Bastos; Amalia Pinkusfeld,11,0,71,60
1657599412508,COGS 14A,A01,092681,Semenuks; Arturs,5,1,100,95
1657599418532,COGS 14B,A01,083073,Cheng; Tzu-Han,6,0,63,57
1657599424556,COGS 17,A01,092677,Semenuks; Arturs,6,0,81,75
1657599430579,COGS 100,A01,083619,Allen; Michael Gordon,17,0,70,53
1657599436602,COGS 101A,A01,083621,Davis; Joshua Daniel,9,0,68,59
1657599442626,COGS 101B,A01,091572,Allen; Michael Gordon,12,0,65,53
1657599448653,COGS 101C,A01,083625,Delgado; Tania,17,0,35,18
1657599454677,COGS 107A,A01,083627,Boyle; Mary E. T.,13,0,60,47
1657599460710,COGS 118A,A01,083075,Gupta; Anjum,21,0,76,55
1657599466733,CSE 3,A50,083646,Miranda; Gregory Joseph,24,0,50,26
1657599472759,CSE 8A,A50,083650,Miranda; Gregory Joseph,17,1,56,39
1657599478785,CSE 11,A01,083080,Cao; Yingjun,6,15,40,34
1657599484806,CSE 12,A01,083652,Krause-Levy; Sophia Louisa,28,1,120,92
1657599490832,CSE 15L,A01,083654,Morris; Justin Loren,9,0,50,41
1657599490832,CSE 15L,A02,083655,Morris; Justin Loren,9,0,50,41
1657599496856,CSE 20,A01,083657,Tran; Khoa Dang,39,0,80,41
1657599502882,CSE 21,A01,095574,Bach; Quang Tran,22,0,48,26
1657599508906,CSE 30,A01,083084,Eldon; John,5,0,80,75
1657599508906,CSE 30,B01,095061,Bhaskar; Nishant,9,0,50,41
1657599514930,CSE 100,A01,083659,Cao; Yingjun,5,4,70,65
1657599520954,CSE 134B,A01,083661,Powell; Thomas Allan,22,0,100,78
1657599526983,CSE 140,A01,083663,Gungor; Onat,15,0,85,70
1657599533009,CSE 140L,A01,083088,Eldon; John,21,0,100,79
1657599539038,CSE 175,A01,083665,Kumar; Rakesh,3,0,25,22
1657599545071,CSE 190,A00,092507,Dubnov; Shlomo,8,0,20,12
1657599551098,ECE 45,A01,083139,Congero; Spencer William,6,0,75,69
1657599557121,ECE 65,A50,083695,Saad; Andrew S,12,0,30,18
1657599557121,ECE 65,A51,095125,Saad; Andrew S,24,0,26,2
1657599563145,ECE 109,A01,091882,Touri; Behrouz,19,0,70,51
1657599569168,ECE 180,A00,083140,Abi Samra; Nicholas Camill,1,0,30,29
1657599569168,ECE 180,B00,083141,Abi Samra; Nicholas Camill,0,0,30,30
1657599575190,MATH 10A,A01,083735,Patchell; Gregory David,2,0,30,28
1657599575190,MATH 10A,A02,083736,Patchell; Gregory David,20,0,30,10
1657599575190,MATH 10A,A03,083737,Patchell; Gregory David,16,0,30,14
1657599581220,MATH 10B,A01,083207,Lim; Seonhee,8,0,34,26
1657599581220,MATH 10B,A02,083208,Lim; Seonhee,9,0,35,26
1657599581220,MATH 10B,A03,093472,Lim; Seonhee,7,0,34,27
1657599581220,MATH 10B,B01,083739,Sinha; Shubham,12,0,30,18
1657599587245,MATH 18,A01,083743,Cinel; Cameron Alexander,7,0,30,23
1657599587245,MATH 18,A02,083744,Cinel; Cameron Alexander,17,0,30,13
1657599587245,MATH 18,A03,083745,Cinel; Cameron Alexander,9,0,30,21
1657599587245,MATH 18,B01,083748,Rideout; David Porter,5,0,37,32
1657599587245,MATH 18,B02,083749,Rideout; David Porter,5,0,36,31
1657599587245,MATH 18,B03,083750,Rideout; David Porter,3,0,37,34
1657599587245,MATH 18,B04,083751,Rideout; David Porter,6,0,36,30
1657599587245,MATH 18,B05,093473,Rideout; David Porter,6,0,36,30
1657599587245,MATH 18,B06,093474,Rideout; David Porter,6,0,36,30
1657599593268,MATH 20A,A01,083754,Zheng; Zequn,14,0,40,26
1657599599290,MATH 20B,A01,083756,Briones; Jor-el Thomas Caparas,4,0,36,32
1657599599290,MATH 20B,A02,083757,Briones; Jor-el Thomas Caparas,1,0,36,35
1657599599290,MATH 20B,A03,093475,Briones; Jor-el Thomas Caparas,2,0,36,34
1657599605319,MATH 20C,A01,083760,Briones; Jor-el Thomas Caparas,1,0,35,34
1657599605319,MATH 20C,A02,083761,Briones; Jor-el Thomas Caparas,8,0,35,27
1657599605319,MATH 20C,A03,093476,Briones; Jor-el Thomas Caparas,0,1,36,36
1657599605319,MATH 20C,B01,083762,Bach; Quang Tran,1,0,30,29
1657599611349,MATH 20D,A01,083765,Tran; Brian Kha,5,0,30,25
1657599611349,MATH 20D,A02,083766,Tran; Brian Kha,5,0,30,25
1657599611349,MATH 20D,A03,083767,Tran; Brian Kha,5,0,30,25
1657599617372,MATH 20E,A01,083771,Ganguly; Soumya,9,0,32,23
1657599617372,MATH 20E,A02,083772,Ganguly; Soumya,6,0,32,26
1657599617372,MATH 20E,B01,083773,Ciotti; Benjamin,20,0,35,15
1657599617372,MATH 20E,B02,083774,Ciotti; Benjamin,18,0,35,17
1657599623395,MATH 103A,A01,083777,Greenfeld; Be'Eri,3,0,36,33
1657599623395,MATH 103A,A02,083778,Greenfeld; Be'Eri,5,0,36,31
1657599623395,MATH 103A,A03,093561,Greenfeld; Be'Eri,6,0,36,30
1657599623395,MATH 103A,B01,083779,Greenfeld; Be'Eri,7,0,36,29
1657599623395,MATH 103A,B02,083780,Greenfeld; Be'Eri,4,0,36,32
1657599623395,MATH 103A,B03,093562,Greenfeld; Be'Eri,3,0,36,33
1657599629421,MATH 105,A01,085443,Carter; Anne Toulson,15,0,35,20
1657599629421,MATH 105,A02,093477,Carter; Anne Toulson,20,0,35,15
1657599635446,MATH 109,A01,083213,Ganzberger; Geoffrey Michael,2,0,34,32
1657599635446,MATH 109,A02,083214,Ganzberger; Geoffrey Michael,4,0,34,30
1657599635446,MATH 109,A03,093478,Ganzberger; Geoffrey Michael,2,0,34,32
1657599635446,MATH 109,B01,083215,Ganzberger; Geoffrey Michael,1,0,32,31
1657599635446,MATH 109,B02,083216,Ganzberger; Geoffrey Michael,2,0,32,30
1657599635446,MATH 109,B03,093479,Ganzberger; Geoffrey Michael,8,0,32,24
1657599641472,MATH 142A,A01,083219,Chow; Bennett,7,0,32,25
1657599641472,MATH 142A,A02,083220,Chow; Bennett,10,0,32,22
1657599641472,MATH 142A,A03,093480,Chow; Bennett,9,0,32,23
1657599641472,MATH 142A,B03,093481,Chow; Bennett,8,0,32,24
1657599641472,MATH 142A,B04,093558,Chow; Bennett,13,0,32,19
1657599641472,MATH 142A,B05,093559,Chow; Bennett,6,0,32,26
1657599647499,MATH 193A,A01,083224,Rotar; Vladimir,8,0,34,26
1657599647499,MATH 193A,A02,083225,Rotar; Vladimir,9,0,34,25
1657599647499,MATH 193A,A03,083781,Rotar; Vladimir,5,0,34,29
1657599647499,MATH 193A,A04,083782,Rotar; Vladimir,10,0,34,24
1657599647499,MATH 193A,A05,093482,Rotar; Vladimir,10,0,34,24
1657599653521,MATH 197,001,091859,McAuley; Julian John,9999,0,9999,0
1657599653521,MATH 197,002,095566,Kedlaya; Kiran S.,9997,0,9999,2
1657599653521,MATH 197,003,095567,Xiao; Ming,9999,0,9999,0
1657599653521,MATH 197,004,095571,Perols; Johan Lars,9998,0,9999,1
1657599660578,COGS 9,A01,083615,Shannon; Kyle Michael,9,0,75,66
1657599666614,COGS 11,A01,083617,Boyle; Mary E. T.,23,0,48,25
1657599672638,COGS 13,A01,083071,Bastos; Amalia Pinkusfeld,11,0,71,60
1657599678670,COGS 14A,A01,092681,Semenuks; Arturs,5,1,100,95
1657599684698,COGS 14B,A01,083073,Cheng; Tzu-Han,6,0,63,57
1657599690720,COGS 17,A01,092677,Semenuks; Arturs,6,0,81,75
1657599696743,COGS 100,A01,083619,Allen; Michael Gordon,17,0,70,53
1657599702768,COGS 101A,A01,083621,Davis; Joshua Daniel,9,0,68,59
1657599708794,COGS 101B,A01,091572,Allen; Michael Gordon,12,0,65,53
1657599714823,COGS 101C,A01,083625,Delgado; Tania,17,0,35,18
1657599720847,COGS 107A,A01,083627,Boyle; Mary E. T.,13,0,60,47
1657599726877,COGS 118A,A01,083075,Gupta; Anjum,21,0,76,55
1657599732902,CSE 3,A50,083646,Miranda; Gregory Joseph,24,0,50,26
1657599738931,CSE 8A,A50,083650,Miranda; Gregory Joseph,17,1,56,39
1657599744954,CSE 11,A01,083080,Cao; Yingjun,6,15,40,34
1657599750980,CSE 12,A01,083652,Krause-Levy; Sophia Louisa,28,1,120,92
1657599757003,CSE 15L,A01,083654,Morris; Justin Loren,9,0,50,41
1657599757003,CSE 15L,A02,083655,Morris; Justin Loren,9,0,50,41
1657599763026,CSE 20,A01,083657,Tran; Khoa Dang,39,0,80,41
1657599769047,CSE 21,A01,095574,Bach; Quang Tran,22,0,48,26
1657599775071,CSE 30,A01,083084,Eldon; John,5,0,80,75
1657599775071,CSE 30,B01,095061,Bhaskar; Nishant,9,0,50,41
1657599781098,CSE 100,A01,083659,Cao; Yingjun,5,4,70,65
1657599787122,CSE 134B,A01,083661,Powell; Thomas Allan,22,0,100,78
1657599793148,CSE 140,A01,083663,Gungor; Onat,15,0,85,70
1657599799172,CSE 140L,A01,083088,Eldon; John,21,0,100,79
1657599805200,CSE 175,A01,083665,Kumar; Rakesh,3,0,25,22
1657599811226,CSE 190,A00,092507,Dubnov; Shlomo,8,0,20,12
1657599817249,ECE 45,A01,083139,Congero; Spencer William,6,0,75,69
1657599823274,ECE 65,A50,083695,Saad; Andrew S,12,0,30,18
1657599823274,ECE 65,A51,095125,Saad; Andrew S,24,0,26,2
1657599829299,ECE 109,A01,091882,Touri; Behrouz,19,0,70,51
1657599835325,ECE 180,A00,083140,Abi Samra; Nicholas Camill,1,0,30,29
1657599835325,ECE 180,B00,083141,Abi Samra; Nicholas Camill,0,0,30,30
1657599841353,MATH 10A,A01,083735,Patchell; Gregory David,2,0,30,28
1657599841353,MATH 10A,A02,083736,Patchell; Gregory David,20,0,30,10
1657599841353,MATH 10A,A03,083737,Patchell; Gregory David,16,0,30,14
1657599847380,MATH 10B,A01,083207,Lim; Seonhee,8,0,34,26
1657599847380,MATH 10B,A02,083208,Lim; Seonhee,9,0,35,26
1657599847380,MATH 10B,A03,093472,Lim; Seonhee,7,0,34,27
1657599847380,MATH 10B,B01,083739,Sinha; Shubham,12,0,30,18
1657599853409,MATH 18,A01,083743,Cinel; Cameron Alexander,7,0,30,23
1657599853409,MATH 18,A02,083744,Cinel; Cameron Alexander,17,0,30,13
1657599853409,MATH 18,A03,083745,Cinel; Cameron Alexander,9,0,30,21
1657599853409,MATH 18,B01,083748,Rideout; David Porter,5,0,37,32
1657599853409,MATH 18,B02,083749,Rideout; David Porter,5,0,36,31
1657599853409,MATH 18,B03,083750,Rideout; David Porter,3,0,37,34
1657599853409,MATH 18,B04,083751,Rideout; David Porter,6,0,36,30
1657599853409,MATH 18,B05,093473,Rideout; David Porter,6,0,36,30
1657599853409,MATH 18,B06,093474,Rideout; David Porter,6,0,36,30
1657599859431,MATH 20A,A01,083754,Zheng; Zequn,14,0,40,26
1657599865466,MATH 20B,A01,083756,Briones; Jor-el Thomas Caparas,4,0,36,32
1657599865466,MATH 20B,A02,083757,Briones; Jor-el Thomas Caparas,1,0,36,35
1657599865466,MATH 20B,A03,093475,Briones; Jor-el Thomas Caparas,2,0,36,34
1657599871489,MATH 20C,A01,083760,Briones; Jor-el Thomas Caparas,1,0,35,34
1657599871489,MATH 20C,A02,083761,Briones; Jor-el Thomas Caparas,8,0,35,27
1657599871489,MATH 20C,A03,093476,Briones; Jor-el Thomas Caparas,0,1,36,36
1657599871489,MATH 20C,B01,083762,Bach; Quang Tran,1,0,30,29
1657599877517,MATH 20D,A01,083765,Tran; Brian Kha,5,0,30,25
1657599877517,MATH 20D,A02,083766,Tran; Brian Kha,5,0,30,25
1657599877517,MATH 20D,A03,083767,Tran; Brian Kha,5,0,30,25
1657599883545,MATH 20E,A01,083771,Ganguly; Soumya,9,0,32,23
1657599883545,MATH 20E,A02,083772,Ganguly; Soumya,6,0,32,26
1657599883545,MATH 20E,B01,083773,Ciotti; Benjamin,20,0,35,15
1657599883545,MATH 20E,B02,083774,Ciotti; Benjamin,18,0,35,17
1657599889663,MATH 103A,A01,083777,Greenfeld; Be'Eri,3,0,36,33
1657599889663,MATH 103A,A02,083778,Greenfeld; Be'Eri,5,0,36,31
1657599889663,MATH 103A,A03,093561,Greenfeld; Be'Eri,6,0,36,30
1657599889663,MATH 103A,B01,083779,Greenfeld; Be'Eri,7,0,36,29
1657599889663,MATH 103A,B02,083780,Greenfeld; Be'Eri,4,0,36,32
1657599889663,MATH 103A,B03,093562,Greenfeld; Be'Eri,3,0,36,33
1657599895686,MATH 105,A01,085443,Carter; Anne Toulson,15,0,35,20
1657599895686,MATH 105,A02,093477,Carter; Anne Toulson,20,0,35,15
1657599901711,MATH 109,A01,083213,Ganzberger; Geoffrey Michael,2,0,34,32
1657599901711,MATH 109,A02,083214,Ganzberger; Geoffrey Michael,4,0,34,30
1657599901711,MATH 109,A03,093478,Ganzberger; Geoffrey Michael,2,0,34,32
1657599901711,MATH 109,B01,083215,Ganzberger; Geoffrey Michael,1,0,32,31
1657599901711,MATH 109,B02,083216,Ganzberger; Geoffrey Michael,2,0,32,30
1657599901711,MATH 109,B03,093479,Ganzberger; Geoffrey Michael,8,0,32,24
1657599907735,MATH 142A,A01,083219,Chow; Bennett,7,0,32,25
1657599907735,MATH 142A,A02,083220,Chow; Bennett,10,0,32,22
1657599907735,MATH 142A,A03,093480,Chow; Bennett,9,0,32,23
1657599907735,MATH 142A,B03,093481,Chow; Bennett,8,0,32,24
1657599907735,MATH 142A,B04,093558,Chow; Bennett,13,0,32,19
1657599907735,MATH 142A,B05,093559,Chow; Bennett,6,0,32,26
1657599913757,MATH 193A,A01,083224,Rotar; Vladimir,8,0,34,26
1657599913757,MATH 193A,A02,083225,Rotar; Vladimir,9,0,34,25
1657599913757,MATH 193A,A03,083781,Rotar; Vladimir,5,0,34,29
1657599913757,MATH 193A,A04,083782,Rotar; Vladimir,10,0,34,24
1657599913757,MATH 193A,A05,093482,Rotar; Vladimir,10,0,34,24
1657599919780,MATH 197,001,091859,McAuley; Julian John,9999,0,9999,0
1657599919780,MATH 197,002,095566,Kedlaya; Kiran S.,9997,0,9999,2
1657599919780,MATH 197,003,095567,Xiao; Ming,9999,0,9999,0
1657599919780,MATH 197,004,095571,Perols; Johan Lars,9998,0,9999,1
1657599926840,COGS 9,A01,083615,Shannon; Kyle Michael,9,0,75,66
1657599932862,COGS 11,A01,083617,Boyle; Mary E. T.,23,0,48,25
1657599938886,COGS 13,A01,083071,Bastos; Amalia Pinkusfeld,11,0,71,60
1657599944913,COGS 14A,A01,092681,Semenuks; Arturs,5,1,100,95
1657599950939,COGS 14B,A01,083073,Cheng; Tzu-Han,6,0,63,57
1657599956977,COGS 17,A01,092677,Semenuks; Arturs,6,0,81,75
1657599963005,COGS 100,A01,083619,Allen; Michael Gordon,17,0,70,53
1657599969026,COGS 101A,A01,083621,Davis; Joshua Daniel,9,0,68,59
1657599975057,COGS 101B,A01,091572,Allen; Michael Gordon,12,0,65,53
1657599981079,COGS 101C,A01,083625,Delgado; Tania,17,0,35,18
1657599987103,COGS 107A,A01,083627,Boyle; Mary E. T.,13,0,60,47
1657599993129,COGS 118A,A01,083075,Gupta; Anjum,21,0,76,55
1657599999160,CSE 3,A50,083646,Miranda; Gregory Joseph,24,0,50,26
1657600005183,CSE 8A,A50,083650,Miranda; Gregory Joseph,17,1,56,39
1657600011211,CSE 11,A01,083080,Cao; Yingjun,6,15,40,34
1657600017234,CSE 12,A01,083652,Krause-Levy; Sophia Louisa,28,1,120,92
1657600023257,CSE 15L,A01,083654,Morris; Justin Loren,9,0,50,41
1657600023257,CSE 15L,A02,083655,Morris; Justin Loren,9,0,50,41
1657600029282,CSE 20,A01,083657,Tran; Khoa Dang,39,0,80,41
1657600035309,CSE 21,A01,095574,Bach; Quang Tran,22,0,48,26
1657600041332,CSE 30,A01,083084,Eldon; John,5,0,80,75
1657600041332,CSE 30,B01,095061,Bhaskar; Nishant,9,0,50,41
1657600047355,CSE 100,A01,083659,Cao; Yingjun,5,4,70,65
1657600053378,CSE 134B,A01,083661,Powell; Thomas Allan,22,0,100,78
1657600059403,CSE 140,A01,083663,Gungor; Onat,15,0,85,70
1657600065431,CSE 140L,A01,083088,Eldon; John,21,0,100,79
1657600071454,CSE 175,A01,083665,Kumar; Rakesh,3,0,25,22
1657600077478,CSE 190,A00,092507,Dubnov; Shlomo,8,0,20,12
1657600083501,ECE 45,A01,083139,Congero; Spencer William,6,0,75,69
1657600089525,ECE 65,A50,083695,Saad; Andrew S,12,0,30,18
1657600089525,ECE 65,A51,095125,Saad; Andrew S,24,0,26,2
1657600095551,ECE 109,A01,091882,Touri; Behrouz,19,0,70,51
1657600101576,ECE 180,A00,083140,Abi Samra; Nicholas Camill,1,0,30,29
1657600101576,ECE 180,B00,083141,Abi Samra; Nicholas Camill,0,0,30,30
1657600107602,MATH 10A,A01,083735,Patchell; Gregory David,2,0,30,28
1657600107602,MATH 10A,A02,083736,Patchell; Gregory David,20,0,30,10
1657600107602,MATH 10A,A03,083737,Patchell; Gregory David,16,0,30,14
1657600113630,MATH 10B,A01,083207,Lim; Seonhee,8,0,34,26
1657600113630,MATH 10B,A02,083208,Lim; Seonhee,9,0,35,26
1657600113630,MATH 10B,A03,093472,Lim; Seonhee,7,0,34,27
1657600113630,MATH 10B,B01,083739,Sinha; Shubham,12,0,30,18
1657600119653,MATH 18,A01,083743,Cinel; Cameron Alexander,7,0,30,23
1657600119653,MATH 18,A02,083744,Cinel; Cameron Alexander,17,0,30,13
1657600119653,MATH 18,A03,083745,Cinel; Cameron Alexander,9,0,30,21
1657600119653,MATH 18,B01,083748,Rideout; David Porter,5,0,37,32
1657600119653,MATH 18,B02,083749,Rideout; David Porter,5,0,36,31
1657600119653,MATH 18,B03,083750,Rideout; David Porter,3,0,37,34
1657600119653,MATH 18,B04,083751,Rideout; David Porter,6,0,36,30
1657600119653,MATH 18,B05,093473,Rideout; David Porter,6,0,36,30
1657600119653,MATH 18,B06,093474,Rideout; David Porter,6,0,36,30
1657600125678,MATH 20A,A01,083754,Zheng; Zequn,14,0,40,26
1657600131711,MATH 20B,A01,083756,Briones; Jor-el Thomas Caparas,4,0,36,32
1657600131711,MATH 20B,A02,083757,Briones; Jor-el Thomas Caparas,1,0,36,35
1657600131711,MATH 20B,A03,093475,Briones; Jor-el Thomas Caparas,2,0,36,34
1657600137734,MATH 20C,A01,083760,Briones; Jor-el Thomas Caparas,1,0,35,34
1657600137734,MATH 20C,A02,083761,Briones; Jor-el Thomas Caparas,8,0,35,27
1657600137734,MATH 20C,A03,093476,Briones; Jor-el Thomas Caparas,0,1,36,36
1657600137734,MATH 20C,B01,083762,Bach; Quang Tran,1,0,30,29
1657600143761,MATH 20D,A01,083765,Tran; Brian Kha,5,0,30,25
1657600143761,MATH 20D,A02,083766,Tran; Brian Kha,5,0,30,25
1657600143761,MATH 20D,A03,083767,Tran; Brian Kha,5,0,30,25
1657600149784,MATH 20E,A01,083771,Ganguly; Soumya,9,0,32,23
1657600149784,MATH 20E,A02,083772,Ganguly; Soumya,6,0,32,26
1657600149784,MATH 20E,B01,083773,Ciotti; Benjamin,20,0,35,15
1657600149784,MATH 20E,B02,083774,Ciotti; Benjamin,18,0,35,17
1657600155813,MATH 103A,A01,083777,Greenfeld; Be'Eri,3,0,36,33
1657600155813,MATH 103A,A02,083778,Greenfeld; Be'Eri,5,0,36,31
1657600155813,MATH 103A,A03,093561,Greenfeld; Be'Eri,6,0,36,30
1657600155813,MATH 103A,B01,083779,Greenfeld; Be'Eri,7,0,36,29
1657600155813,MATH 103A,B02,083780,Greenfeld; Be'Eri,4,0,36,32
1657600155813,MATH 103A,B03,093562,Greenfeld; Be'Eri,3,0,36,33
1657600161840,MATH 105,A01,085443,Carter; Anne Toulson,15,0,35,20
1657600161840,MATH 105,A02,093477,Carter; Anne Toulson,20,0,35,15
1657600167868,MATH 109,A01,083213,Ganzberger; Geoffrey Michael,2,0,34,32
1657600167868,MATH 109,A02,083214,Ganzberger; Geoffrey Michael,4,0,34,30
1657600167868,MATH 109,A03,093478,Ganzberger; Geoffrey Michael,2,0,34,32
1657600167868,MATH 109,B01,083215,Ganzberger; Geoffrey Michael,1,0,32,31
1657600167868,MATH 109,B02,083216,Ganzberger; Geoffrey Michael,2,0,32,30
1657600167868,MATH 109,B03,093479,Ganzberger; Geoffrey Michael,8,0,32,24
1657600173897,MATH 142A,A01,083219,Chow; Bennett,7,0,32,25
1657600173897,MATH 142A,A02,083220,Chow; Bennett,10,0,32,22
1657600173897,MATH 142A,A03,093480,Chow; Bennett,9,0,32,23
1657600173897,MATH 142A,B03,093481,Chow; Bennett,8,0,32,24
1657600173897,MATH 142A,B04,093558,Chow; Bennett,13,0,32,19
1657600173897,MATH 142A,B05,093559,Chow; Bennett,6,0,32,26
1657600179926,MATH 193A,A01,083224,Rotar; Vladimir,8,0,34,26
1657600179926,MATH 193A,A02,083225,Rotar; Vladimir,9,0,34,25
1657600179926,MATH 193A,A03,083781,Rotar; Vladimir,5,0,34,29
1657600179926,MATH 193A,A04,083782,Rotar; Vladimir,10,0,34,24
1657600179926,MATH 193A,A05,093482,Rotar; Vladimir,10,0,34,24
1657600185957,MATH 197,001,091859,McAuley; Julian John,9999,0,9999,0
1657600185957,MATH 197,002,095566,Kedlaya; Kiran S.,9997,0,9999,2
1657600185957,MATH 197,003,095567,Xiao; Ming,9999,0,9999,0
1657600185957,MATH 197,004,095571,Perols; Johan Lars,9998,0,9999,1
1657600193025,COGS 9,A01,083615,Shannon; Kyle Michael,9,0,75,66
1657600199046,COGS 11,A01,083617,Boyle; Mary E. T.,23,0,48,25
1657600205079,COGS 13,A01,083071,Bastos; Amalia Pinkusfeld,11,0,71,60
1657600211101,COGS 14A,A01,092681,Semenuks; Arturs,5,1,100,95
1657600217124,COGS 14B,A01,083073,Cheng; Tzu-Han,6,0,63,57
1657600223149,COGS 17,A01,092677,Semenuks; Arturs,6,0,81,75
1657600229172,COGS 100,A01,083619,Allen; Michael Gordon,17,0,70,53
1657600235195,COGS 101A,A01,083621,Davis; Joshua Daniel,9,0,68,59
1657600241221,COGS 101B,A01,091572,Allen; Michael Gordon,12,0,65,53
1657600247243,COGS 101C,A01,083625,Delgado; Tania,17,0,35,18
1657600253267,COGS 107A,A01,083627,Boyle; Mary E. T.,13,0,60,47
1657600259298,COGS 118A,A01,083075,Gupta; Anjum,21,0,76,55
1657600265327,CSE 3,A50,083646,Miranda; Gregory Joseph,24,0,50,26
1657600271353,CSE 8A,A50,083650,Miranda; Gregory Joseph,17,1,56,39
1657600277379,CSE 11,A01,083080,Cao; Yingjun,6,15,40,34
1657600283404,CSE 12,A01,083652,Krause-Levy; Sophia Louisa,28,1,120,92
1657600289429,CSE 15L,A01,083654,Morris; Justin Loren,9,0,50,41
1657600289429,CSE 15L,A02,083655,Morris; Justin Loren,9,0,50,41
1657600295455,CSE 20,A01,083657,Tran; Khoa Dang,39,0,80,41
1657600301482,CSE 21,A01,095574,Bach; Quang Tran,22,0,48,26
1657600307511,CSE 30,A01,083084,Eldon; John,5,0,80,75
1657600307511,CSE 30,B01,095061,Bhaskar; Nishant,9,0,50,41
1657600313536,CSE 100,A01,083659,Cao; Yingjun,5,4,70,65
1657600319564,CSE 134B,A01,083661,Powell; Thomas Allan,22,0,100,78
1657600325589,CSE 140,A01,083663,Gungor; Onat,15,0,85,70
1657600331612,CSE 140L,A01,083088,Eldon; John,21,0,100,79
1657600337639,CSE 175,A01,083665,Kumar; Rakesh,3,0,25,22
1657600343661,CSE 190,A00,092507,Dubnov; Shlomo,8,0,20,12
1657600349685,ECE 45,A01,083139,Congero; Spencer William,6,0,75,69
1657600355710,ECE 65,A50,083695,Saad; Andrew S,12,0,30,18
1657600355710,ECE 65,A51,095125,Saad; Andrew S,24,0,26,2
1657600361734,ECE 109,A01,091882,Touri; Behrouz,19,0,70,51
1657600367757,ECE 180,A00,083140,Abi Samra; Nicholas Camill,1,0,30,29
1657600367757,ECE 180,B00,083141,Abi Samra; Nicholas Camill,0,0,30,30
1657600373781,MATH 10A,A01,083735,Patchell; Gregory David,2,0,30,28
1657600373781,MATH 10A,A02,083736,Patchell; Gregory David,20,0,30,10
1657600373781,MATH 10A,A03,083737,Patchell; Gregory David,16,0,30,14
1657600379813,MATH 10B,A01,083207,Lim; Seonhee,8,0,34,26
1657600379813,MATH 10B,A02,083208,Lim; Seonhee,9,0,35,26
1657600379813,MATH 10B,A03,093472,Lim; Seonhee,7,0,34,27
1657600379813,MATH 10B,B01,083739,Sinha; Shubham,12,0,30,18
1657600385843,MATH 18,A01,083743,Cinel; Cameron Alexander,7,0,30,23
1657600385843,MATH 18,A02,083744,Cinel; Cameron Alexander,17,0,30,13
1657600385843,MATH 18,A03,083745,Cinel; Cameron Alexander,9,0,30,21
1657600385843,MATH 18,B01,083748,Rideout; David Porter,5,0,37,32
1657600385843,MATH 18,B02,083749,Rideout; David Porter,5,0,36,31
1657600385843,MATH 18,B03,083750,Rideout; David Porter,3,0,37,34
1657600385843,MATH 18,B04,083751,Rideout; David Porter,6,0,36,30
1657600385843,MATH 18,B05,093473,Rideout; David Porter,6,0,36,30
1657600385843,MATH 18,B06,093474,Rideout; David Porter,6,0,36,30
1657600391865,MATH 20A,A01,083754,Zheng; Zequn,14,0,40,26
1657600397892,MATH 20B,A01,083756,Briones; Jor-el Thomas Caparas,4,0,36,32
1657600397892,MATH 20B,A02,083757,Briones; Jor-el Thomas Caparas,1,0,36,35
1657600397892,MATH 20B,A03,093475,Briones; Jor-el Thomas Caparas,2,0,36,34
1657600403916,MATH 20C,A01,083760,Briones; Jor-el Thomas Caparas,1,0,35,34
1657600403916,MATH 20C,A02,083761,Briones; Jor-el Thomas Caparas,8,0,35,27
1657600403916,MATH 20C,A03,093476,Briones; Jor-el Thomas Caparas,0,1,36,36
1657600403916,MATH 20C,B01,083762,Bach; Quang Tran,1,0,30,29
1657600409939,MATH 20D,A01,083765,Tran; Brian Kha,5,0,30,25
1657600409939,MATH 20D,A02,083766,Tran; Brian Kha,5,0,30,25
1657600409939,MATH 20D,A03,083767,Tran; Brian Kha,5,0,30,25
1657600415963,MATH 20E,A01,083771,Ganguly; Soumya,9,0,32,23
1657600415963,MATH 20E,A02,083772,Ganguly; Soumya,6,0,32,26
1657600415963,MATH 20E,B01,083773,Ciotti; Benjamin,20,0,35,15
1657600415963,MATH 20E,B02,083774,Ciotti; Benjamin,18,0,35,17
1657600421987,MATH 103A,A01,083777,Greenfeld; Be'Eri,3,0,36,33
1657600421987,MATH 103A,A02,083778,Greenfeld; Be'Eri,5,0,36,31
1657600421987,MATH 103A,A03,093561,Greenfeld; Be'Eri,6,0,36,30
1657600421987,MATH 103A,B01,083779,Greenfeld; Be'Eri,7,0,36,29
1657600421987,MATH 103A,B02,083780,Greenfeld; Be'Eri,4,0,36,32
1657600421987,MATH 103A,B03,093562,Greenfeld; Be'Eri,3,0,36,33
1657600428010,MATH 105,A01,085443,Carter; Anne Toulson,15,0,35,20
1657600428010,MATH 105,A02,093477,Carter; Anne Toulson,20,0,35,15
1657600434034,MATH 109,A01,083213,Ganzberger; Geoffrey Michael,2,0,34,32
1657600434034,MATH 109,A02,083214,Ganzberger; Geoffrey Michael,4,0,34,30
1657600434034,MATH 109,A03,093478,Ganzberger; Geoffrey Michael,2,0,34,32
1657600434034,MATH 109,B01,083215,Ganzberger; Geoffrey Michael,1,0,32,31
1657600434034,MATH 109,B02,083216,Ganzberger; Geoffrey Michael,2,0,32,30
1657600434034,MATH 109,B03,093479,Ganzberger; Geoffrey Michael,8,0,32,24
1657600440063,MATH 142A,A01,083219,Chow; Bennett,7,0,32,25
1657600440063,MATH 142A,A02,083220,Chow; Bennett,10,0,32,22
1657600440063,MATH 142A,A03,093480,Chow; Bennett,9,0,32,23
1657600440063,MATH 142A,B03,093481,Chow; Bennett,8,0,32,24
1657600440063,MATH 142A,B04,093558,Chow; Bennett,13,0,32,19
1657600440063,MATH 142A,B05,093559,Chow; Bennett,6,0,32,26
1657600446091,MATH 193A,A01,083224,Rotar; Vladimir,8,0,34,26
1657600446091,MATH 193A,A02,083225,Rotar; Vladimir,9,0,34,25
1657600446091,MATH 193A,A03,083781,Rotar; Vladimir,5,0,34,29
1657600446091,MATH 193A,A04,083782,Rotar; Vladimir,10,0,34,24
1657600446091,MATH 193A,A05,093482,Rotar; Vladimir,10,0,34,24
1657600452113,MATH 197,001,091859,McAuley; Julian John,9999,0,9999,0
1657600452113,MATH 197,002,095566,Kedlaya; Kiran S.,9997,0,9999,2
1657600452113,MATH 197,003,095567,Xiao; Ming,9999,0,9999,0
1657600452113,MATH 197,004,095571,Perols; Johan Lars,9998,0,9999,1
1657600459170,COGS 9,A01,083615,Shannon; Kyle Michael,9,0,75,66
1657600465192,COGS 11,A01,083617,Boyle; Mary E. T.,23,0,48,25
1657600471234,COGS 13,A01,083071,Bastos; Amalia Pinkusfeld,11,0,71,60
1657600477262,COGS 14A,A01,092681,Semenuks; Arturs,5,1,100,95
1657600483376,COGS 14B,A01,083073,Cheng; Tzu-Han,6,0,63,57
1657600489399,COGS 17,A01,092677,Semenuks; Arturs,6,0,81,75
1657600495422,COGS 100,A01,083619,Allen; Michael Gordon,17,0,70,53
1657600501446,COGS 101A,A01,083621,Davis; Joshua Daniel,9,0,68,59
1657600507470,COGS 101B,A01,091572,Allen; Michael Gordon,12,0,65,53
1657600513495,COGS 101C,A01,083625,Delgado; Tania,17,0,35,18
1657600519525,COGS 107A,A01,083627,Boyle; Mary E. T.,13,0,60,47
1657600525551,COGS 118A,A01,083075,Gupta; Anjum,21,0,76,55
1657600531577,CSE 3,A50,083646,Miranda; Gregory Joseph,24,0,50,26
1657600537608,CSE 8A,A50,083650,Miranda; Gregory Joseph,17,1,56,39
1657600543635,CSE 11,A01,083080,Cao; Yingjun,6,15,40,34
1657600549667,CSE 12,A01,083652,Krause-Levy; Sophia Louisa,28,1,120,92
1657600555702,CSE 15L,A01,083654,Morris; Justin Loren,9,0,50,41
1657600555702,CSE 15L,A02,083655,Morris; Justin Loren,9,0,50,41
1657600561726,CSE 20,A01,083657,Tran; Khoa Dang,39,0,80,41
1657600567753,CSE 21,A01,095574,Bach; Quang Tran,22,0,48,26
1657600573776,CSE 30,A01,083084,Eldon; John,5,0,80,75
1657600573776,CSE 30,B01,095061,Bhaskar; Nishant,9,0,50,41
1657600579803,CSE 100,A01,083659,Cao; Yingjun,5,4,70,65
1657600585829,CSE 134B,A01,083661,Powell; Thomas Allan,22,0,100,78
1657600591852,CSE 140,A01,083663,Gungor; Onat,15,0,85,70
1657600597873,CSE 140L,A01,083088,Eldon; John,21,0,100,79
1657600603899,CSE 175,A01,083665,Kumar; Rakesh,3,0,25,22
1657600609922,CSE 190,A00,092507,Dubnov; Shlomo,8,0,20,12
1657600615947,ECE 45,A01,083139,Congero; Spencer William,6,0,75,69
1657600621970,ECE 65,A50,083695,Saad; Andrew S,12,0,30,18
1657600621970,ECE 65,A51,095125,Saad; Andrew S,24,0,26,2
1657600628012,ECE 109,A01,091882,Touri; Behrouz,19,0,70,51
1657600634039,ECE 180,A00,083140,Abi Samra; Nicholas Camill,1,0,30,29
1657600634039,ECE 180,B00,083141,Abi Samra; Nicholas Camill,0,0,30,30
1657600640062,MATH 10A,A01,083735,Patchell; Gregory David,2,0,30,28
1657600640062,MATH 10A,A02,083736,Patchell; Gregory David,20,0,30,10
1657600640062,MATH 10A,A03,083737,Patchell; Gregory David,16,0,30,14
1657600646086,MATH 10B,A01,083207,Lim; Seonhee,8,0,34,26
1657600646086,MATH 10B,A02,083208,Lim; Seonhee,9,0,35,26
1657600646086,MATH 10B,A03,093472,Lim; Seonhee,7,0,34,27
1657600646086,MATH 10B,B01,083739,Sinha; Shubham,12,0,30,18
1657600652116,MATH 18,A01,083743,Cinel; Cameron Alexander,7,0,30,23
1657600652116,MATH 18,A02,083744,Cinel; Cameron Alexander,17,0,30,13
1657600652116,MATH 18,A03,083745,Cinel; Cameron Alexander,9,0,30,21
1657600652116,MATH 18,B01,083748,Rideout; David Porter,5,0,37,32
1657600652116,MATH 18,B02,083749,Rideout; David Porter,5,0,36,31
1657600652116,MATH 18,B03,083750,Rideout; David Porter,3,0,37,34
1657600652116,MATH 18,B04,083751,Rideout; David Porter,6,0,36,30
1657600652116,MATH 18,B05,093473,Rideout; David Porter,6,0,36,30
1657600652116,MATH 18,B06,093474,Rideout; David Porter,6,0,36,30
1657600658143,MATH 20A,A01,083754,Zheng; Zequn,14,0,40,26
1657600664169,MATH 20B,A01,083756,Briones; Jor-el Thomas Caparas,4,0,36,32
1657600664169,MATH 20B,A02,083757,Briones; Jor-el Thomas Caparas,1,0,36,35
1657600664169,MATH 20B,A03,093475,Briones; Jor-el Thomas Caparas,2,0,36,34
1657600670193,MATH 20C,A01,083760,Briones; Jor-el Thomas Caparas,1,0,35,34
1657600670193,MATH 20C,A02,083761,Briones; Jor-el Thomas Caparas,8,0,35,27
1657600670193,MATH 20C,A03,093476,Briones; Jor-el Thomas Caparas,0,1,36,36
1657600670193,MATH 20C,B01,083762,Bach; Quang Tran,1,0,30,29
1657600676216,MATH 20D,A01,083765,Tran; Brian Kha,5,0,30,25
1657600676216,MATH 20D,A02,083766,Tran; Brian Kha,5,0,30,25
1657600676216,MATH 20D,A03,083767,Tran; Brian Kha,5,0,30,25
1657600682247,MATH 20E,A01,083771,Ganguly; Soumya,9,0,32,23
1657600682247,MATH 20E,A02,083772,Ganguly; Soumya,6,0,32,26
1657600682247,MATH 20E,B01,083773,Ciotti; Benjamin,20,0,35,15
1657600682247,MATH 20E,B02,083774,Ciotti; Benjamin,18,0,35,17
1657600688275,MATH 103A,A01,083777,Greenfeld; Be'Eri,3,0,36,33
1657600688275,MATH 103A,A02,083778,Greenfeld; Be'Eri,5,0,36,31
1657600688275,MATH 103A,A03,093561,Greenfeld; Be'Eri,6,0,36,30
1657600688275,MATH 103A,B01,083779,Greenfeld; Be'Eri,7,0,36,29
1657600688275,MATH 103A,B02,083780,Greenfeld; Be'Eri,4,0,36,32
1657600688275,MATH 103A,B03,093562,Greenfeld; Be'Eri,3,0,36,33
1657600694301,MATH 105,A01,085443,Carter; Anne Toulson,15,0,35,20
1657600694301,MATH 105,A02,093477,Carter; Anne Toulson,20,0,35,15
1657600700332,MATH 109,A01,083213,Ganzberger; Geoffrey Michael,2,0,34,32
1657600700332,MATH 109,A02,083214,Ganzberger; Geoffrey Michael,4,0,34,30
1657600700332,MATH 109,A03,093478,Ganzberger; Geoffrey Michael,2,0,34,32
1657600700332,MATH 109,B01,083215,Ganzberger; Geoffrey Michael,1,0,32,31
1657600700332,MATH 109,B02,083216,Ganzberger; Geoffrey Michael,2,0,32,30
1657600700332,MATH 109,B03,093479,Ganzberger; Geoffrey Michael,8,0,32,24
1657600706356,MATH 142A,A01,083219,Chow; Bennett,7,0,32,25
1657600706356,MATH 142A,A02,083220,Chow; Bennett,10,0,32,22
1657600706356,MATH 142A,A03,093480,Chow; Bennett,9,0,32,23
1657600706356,MATH 142A,B03,093481,Chow; Bennett,8,0,32,24
1657600706356,MATH 142A,B04,093558,Chow; Bennett,13,0,32,19
1657600706356,MATH 142A,B05,093559,Chow; Bennett,6,0,32,26
1657600712384,MATH 193A,A01,083224,Rotar; Vladimir,8,0,34,26
1657600712384,MATH 193A,A02,083225,Rotar; Vladimir,9,0,34,25
1657600712384,MATH 193A,A03,083781,Rotar; Vladimir,5,0,34,29
1657600712384,MATH 193A,A04,083782,Rotar; Vladimir,10,0,34,24
1657600712384,MATH 193A,A05,093482,Rotar; Vladimir,10,0,34,24
1657600718410,MATH 197,001,091859,McAuley; Julian John,9999,0,9999,0
1657600718410,MATH 197,002,095566,Kedlaya; Kiran S.,9997,0,9999,2
1657600718410,MATH 197,003,095567,Xiao; Ming,9999,0,9999,0
1657600718410,MATH 197,004,095571,Perols; Johan Lars,9998,0,9999,1
1657600725476,COGS 9,A01,083615,Shannon; Kyle Michael,9,0,75,66
1657600731500,COGS 11,A01,083617,Boyle; Mary E. T.,23,0,48,25
1657600737526,COGS 13,A01,083071,Bastos; Amalia Pinkusfeld,11,0,71,60
1657600743557,COGS 14A,A01,092681,Semenuks; Arturs,5,1,100,95
1657600749579,COGS 14B,A01,083073,Cheng; Tzu-Han,6,0,63,57
1657600755602,COGS 17,A01,092677,Semenuks; Arturs,6,0,81,75
1657600761629,COGS 100,A01,083619,Allen; Michael Gordon,17,0,70,53
1657600767658,COGS 101A,A01,083621,Davis; Joshua Daniel,9,0,68,59
1657600773680,COGS 101B,A01,091572,Allen; Michael Gordon,12,0,65,53
1657600779702,COGS 101C,A01,083625,Delgado; Tania,17,0,35,18
1657600785725,COGS 107A,A01,083627,Boyle; Mary E. T.,13,0,60,47
1657600791750,COGS 118A,A01,083075,Gupta; Anjum,21,0,76,55
1657600797774,CSE 3,A50,083646,Miranda; Gregory Joseph,24,0,50,26
1657600803811,CSE 8A,A50,083650,Miranda; Gregory Joseph,17,1,56,39
1657600809850,CSE 11,A01,083080,Cao; Yingjun,6,15,40,34
1657600815872,CSE 12,A01,083652,Krause-Levy; Sophia Louisa,28,1,120,92
1657600821894,CSE 15L,A01,083654,Morris; Justin Loren,9,0,50,41
1657600821894,CSE 15L,A02,083655,Morris; Justin Loren,9,0,50,41
1657600827917,CSE 20,A01,083657,Tran; Khoa Dang,39,0,80,41
1657600833944,CSE 21,A01,095574,Bach; Quang Tran,22,0,48,26
1657600839971,CSE 30,A01,083084,Eldon; John,5,0,80,75
1657600839971,CSE 30,B01,095061,Bhaskar; Nishant,9,0,50,41
1657600845994,CSE 100,A01,083659,Cao; Yingjun,5,4,70,65
1657600852019,CSE 134B,A01,083661,Powell; Thomas Allan,22,0,100,78
1657600858053,CSE 140,A01,083663,Gungor; Onat,15,0,85,70
1657600864080,CSE 140L,A01,083088,Eldon; John,21,0,100,79
1657600870118,CSE 175,A01,083665,Kumar; Rakesh,3,0,25,22
1657600876141,CSE 190,A00,092507,Dubnov; Shlomo,8,0,20,12
1657600882169,ECE 45,A01,083139,Congero; Spencer William,6,0,75,69
1657600888197,ECE 65,A50,083695,Saad; Andrew S,12,0,30,18
1657600888197,ECE 65,A51,095125,Saad; Andrew S,24,0,26,2
1657600894221,ECE 109,A01,091882,Touri; Behrouz,19,0,70,51
1657600900250,ECE 180,A00,083140,Abi Samra; Nicholas Camill,1,0,30,29
1657600900250,ECE 180,B00,083141,Abi Samra; Nicholas Camill,0,0,30,30
1657600906279,MATH 10A,A01,083735,Patchell; Gregory David,2,0,30,28
1657600906279,MATH 10A,A02,083736,Patchell; Gregory David,20,0,30,10
1657600906279,MATH 10A,A03,083737,Patchell; Gregory David,16,0,30,14
1657600912308,MATH 10B,A01,083207,Lim; Seonhee,8,0,34,26
1657600912308,MATH 10B,A02,083208,Lim; Seonhee,9,0,35,26
1657600912308,MATH 10B,A03,093472,Lim; Seonhee,7,0,34,27
1657600912308,MATH 10B,B01,083739,Sinha; Shubham,12,0,30,18
1657600918344,MATH 18,A01,083743,Cinel; Cameron Alexander,7,0,30,23
1657600918344,MATH 18,A02,083744,Cinel; Cameron Alexander,17,0,30,13
1657600918344,MATH 18,A03,083745,Cinel; Cameron Alexander,9,0,30,21
1657600918344,MATH 18,B01,083748,Rideout; David Porter,5,0,37,32
1657600918344,MATH 18,B02,083749,Rideout; David Porter,5,0,36,31
1657600918344,MATH 18,B03,083750,Rideout; David Porter,3,0,37,34
1657600918344,MATH 18,B04,083751,Rideout; David Porter,6,0,36,30
1657600918344,MATH 18,B05,093473,Rideout; David Porter,6,0,36,30
1657600918344,MATH 18,B06,093474,Rideout; David Porter,6,0,36,30
1657600924372,MATH 20A,A01,083754,Zheng; Zequn,14,0,40,26
1657600930397,MATH 20B,A01,083756,Briones; Jor-el Thomas Caparas,4,0,36,32
1657600930397,MATH 20B,A02,083757,Briones; Jor-el Thomas Caparas,1,0,36,35
1657600930397,MATH 20B,A03,093475,Briones; Jor-el Thomas Caparas,2,0,36,34
1657600936426,MATH 20C,A01,083760,Briones; Jor-el Thomas Caparas,1,0,35,34
1657600936426,MATH 20C,A02,083761,Briones; Jor-el Thomas Caparas,8,0,35,27
1657600936426,MATH 20C,A03,093476,Briones; Jor-el Thomas Caparas,0,1,36,36
1657600936426,MATH 20C,B01,083762,Bach; Quang Tran,1,0,30,29
1657600942454,MATH 20D,A01,083765,Tran; Brian Kha,5,0,30,25
1657600942454,MATH 20D,A02,083766,Tran; Brian Kha,5,0,30,25
1657600942454,MATH 20D,A03,083767,Tran; Brian Kha,5,0,30,25
1657600948476,MATH 20E,A01,083771,Ganguly; Soumya,9,0,32,23
1657600948476,MATH 20E,A02,083772,Ganguly; Soumya,6,0,32,26
1657600948476,MATH 20E,B01,083773,Ciotti; Benjamin,20,0,35,15
1657600948476,MATH 20E,B02,083774,Ciotti; Benjamin,18,0,35,17
1657600954507,MATH 103A,A01,083777,Greenfeld; Be'Eri,3,0,36,33
1657600954507,MATH 103A,A02,083778,Greenfeld; Be'Eri,5,0,36,31
1657600954507,MATH 103A,A03,093561,Greenfeld; Be'Eri,6,0,36,30
1657600954507,MATH 103A,B01,083779,Greenfeld; Be'Eri,7,0,36,29
1657600954507,MATH 103A,B02,083780,Greenfeld; Be'Eri,4,0,36,32
1657600954507,MATH 103A,B03,093562,Greenfeld; Be'Eri,3,0,36,33
1657600960532,MATH 105,A01,085443,Carter; Anne Toulson,15,0,35,20
1657600960532,MATH 105,A02,093477,Carter; Anne Toulson,20,0,35,15
1657600966561,MATH 109,A01,083213,Ganzberger; Geoffrey Michael,2,0,34,32
1657600966561,MATH 109,A02,083214,Ganzberger; Geoffrey Michael,4,0,34,30
1657600966561,MATH 109,A03,093478,Ganzberger; Geoffrey Michael,2,0,34,32
1657600966561,MATH 109,B01,083215,Ganzberger; Geoffrey Michael,1,0,32,31
1657600966561,MATH 109,B02,083216,Ganzberger; Geoffrey Michael,2,0,32,30
1657600966561,MATH 109,B03,093479,Ganzberger; Geoffrey Michael,8,0,32,24
1657600972586,MATH 142A,A01,083219,Chow; Bennett,7,0,32,25
1657600972586,MATH 142A,A02,083220,Chow; Bennett,10,0,32,22
1657600972586,MATH 142A,A03,093480,Chow; Bennett,9,0,32,23
1657600972586,MATH 142A,B03,093481,Chow; Bennett,8,0,32,24
1657600972586,MATH 142A,B04,093558,Chow; Bennett,13,0,32,19
1657600972586,MATH 142A,B05,093559,Chow; Bennett,6,0,32,26
1657600978613,MATH 193A,A01,083224,Rotar; Vladimir,8,0,34,26
1657600978613,MATH 193A,A02,083225,Rotar; Vladimir,9,0,34,25
1657600978613,MATH 193A,A03,083781,Rotar; Vladimir,5,0,34,29
1657600978613,MATH 193A,A04,083782,Rotar; Vladimir,10,0,34,24
1657600978613,MATH 193A,A05,093482,Rotar; Vladimir,10,0,34,24
1657600984640,MATH 197,001,091859,McAuley; Julian John,9999,0,9999,0
1657600984640,MATH 197,002,095566,Kedlaya; Kiran S.,9997,0,9999,2
1657600984640,MATH 197,003,095567,Xiao; Ming,9999,0,9999,0
1657600984640,MATH 197,004,095571,Perols; Johan Lars,9998,0,9999,1
1657600991699,COGS 9,A01,083615,Shannon; Kyle Michael,9,0,75,66
1657600997724,COGS 11,A01,083617,Boyle; Mary E. T.,23,0,48,25
1657601003747,COGS 13,A01,083071,Bastos; Amalia Pinkusfeld,11,0,71,60
1657601009768,COGS 14A,A01,092681,Semenuks; Arturs,5,1,100,95
1657601015793,COGS 14B,A01,083073,Cheng; Tzu-Han,6,0,63,57
1657601021816,COGS 17,A01,092677,Semenuks; Arturs,6,0,81,75
1657601027839,COGS 100,A01,083619,Allen; Michael Gordon,17,0,70,53
1657601033863,COGS 101A,A01,083621,Davis; Joshua Daniel,9,0,68,59
1657601039890,COGS 101B,A01,091572,Allen; Michael Gordon,12,0,65,53
1657601045916,COGS 101C,A01,083625,Delgado; Tania,17,0,35,18
1657601051942,COGS 107A,A01,083627,Boyle; Mary E. T.,13,0,60,47
1657601057966,COGS 118A,A01,083075,Gupta; Anjum,21,0,76,55
1657601063991,CSE 3,A50,083646,Miranda; Gregory Joseph,24,0,50,26
1657601070014,CSE 8A,A50,083650,Miranda; Gregory Joseph,17,1,56,39
1657601076037,CSE 11,A01,083080,Cao; Yingjun,6,15,40,34
1657601082135,CSE 12,A01,083652,Krause-Levy; Sophia Louisa,28,1,120,92
1657601088158,CSE 15L,A01,083654,Morris; Justin Loren,9,0,50,41
1657601088158,CSE 15L,A02,083655,Morris; Justin Loren,9,0,50,41
1657601094183,CSE 20,A01,083657,Tran; Khoa Dang,39,0,80,41
1657601100212,CSE 21,A01,095574,Bach; Quang Tran,22,0,48,26
1657601106236,CSE 30,A01,083084,Eldon; John,5,0,80,75
1657601106236,CSE 30,B01,095061,Bhaskar; Nishant,9,0,50,41
1657601112259,CSE 100,A01,083659,Cao; Yingjun,5,4,70,65
1657601118283,CSE 134B,A01,083661,Powell; Thomas Allan,22,0,100,78
1657601124307,CSE 140,A01,083663,Gungor; Onat,15,0,85,70
1657601130334,CSE 140L,A01,083088,Eldon; John,21,0,100,79
1657601136357,CSE 175,A01,083665,Kumar; Rakesh,3,0,25,22
1657601142379,CSE 190,A00,092507,Dubnov; Shlomo,8,0,20,12
1657601148407,ECE 45,A01,083139,Congero; Spencer William,6,0,75,69
1657601154431,ECE 65,A50,083695,Saad; Andrew S,12,0,30,18
1657601154431,ECE 65,A51,095125,Saad; Andrew S,24,0,26,2
1657601160455,ECE 109,A01,091882,Touri; Behrouz,19,0,70,51
1657601166479,ECE 180,A00,083140,Abi Samra; Nicholas Camill,1,0,30,29
1657601166479,ECE 180,B00,083141,Abi Samra; Nicholas Camill,0,0,30,30
1657601172502,MATH 10A,A01,083735,Patchell; Gregory David,2,0,30,28
1657601172502,MATH 10A,A02,083736,Patchell; Gregory David,20,0,30,10
1657601172502,MATH 10A,A03,083737,Patchell; Gregory David,16,0,30,14
1657601178527,MATH 10B,A01,083207,Lim; Seonhee,8,0,34,26
1657601178527,MATH 10B,A02,083208,Lim; Seonhee,9,0,35,26
1657601178527,MATH 10B,A03,093472,Lim; Seonhee,7,0,34,27
1657601178527,MATH 10B,B01,083739,Sinha; Shubham,12,0,30,18
1657601184555,MATH 18,A01,083743,Cinel; Cameron Alexander,7,0,30,23
1657601184555,MATH 18,A02,083744,Cinel; Cameron Alexander,17,0,30,13
1657601184555,MATH 18,A03,083745,Cinel; Cameron Alexander,9,0,30,21
1657601184555,MATH 18,B01,083748,Rideout; David Porter,5,0,37,32
1657601184555,MATH 18,B02,083749,Rideout; David Porter,5,0,36,31
1657601184555,MATH 18,B03,083750,Rideout; David Porter,3,0,37,34
1657601184555,MATH 18,B04,083751,Rideout; David Porter,6,0,36,30
1657601184555,MATH 18,B05,093473,Rideout; David Porter,6,0,36,30
1657601184555,MATH 18,B06,093474,Rideout; David Porter,6,0,36,30
1657601190580,MATH 20A,A01,083754,Zheng; Zequn,14,0,40,26
1657601196609,MATH 20B,A01,083756,Briones; Jor-el Thomas Caparas,4,0,36,32
1657601196609,MATH 20B,A02,083757,Briones; Jor-el Thomas Caparas,1,0,36,35
1657601196609,MATH 20B,A03,093475,Briones; Jor-el Thomas Caparas,2,0,36,34
1657601202636,MATH 20C,A01,083760,Briones; Jor-el Thomas Caparas,1,0,35,34
1657601202636,MATH 20C,A02,083761,Briones; Jor-el Thomas Caparas,8,0,35,27
1657601202636,MATH 20C,A03,093476,Briones; Jor-el Thomas Caparas,0,1,36,36
1657601202636,MATH 20C,B01,083762,Bach; Quang Tran,1,0,30,29
1657601208662,MATH 20D,A01,083765,Tran; Brian Kha,5,0,30,25
1657601208662,MATH 20D,A02,083766,Tran; Brian Kha,5,0,30,25
1657601208662,MATH 20D,A03,083767,Tran; Brian Kha,5,0,30,25
1657601214690,MATH 20E,A01,083771,Ganguly; Soumya,9,0,32,23
1657601214690,MATH 20E,A02,083772,Ganguly; Soumya,6,0,32,26
1657601214690,MATH 20E,B01,083773,Ciotti; Benjamin,20,0,35,15
1657601214690,MATH 20E,B02,083774,Ciotti; Benjamin,18,0,35,17
1657601220716,MATH 103A,A01,083777,Greenfeld; Be'Eri,3,0,36,33
1657601220716,MATH 103A,A02,083778,Greenfeld; Be'Eri,5,0,36,31
1657601220716,MATH 103A,A03,093561,Greenfeld; Be'Eri,6,0,36,30
1657601220716,MATH 103A,B01,083779,Greenfeld; Be'Eri,7,0,36,29
1657601220716,MATH 103A,B02,083780,Greenfeld; Be'Eri,4,0,36,32
1657601220716,MATH 103A,B03,093562,Greenfeld; Be'Eri,3,0,36,33
1657601226744,MATH 105,A01,085443,Carter; Anne Toulson,15,0,35,20
1657601226744,MATH 105,A02,093477,Carter; Anne Toulson,20,0,35,15
1657601232772,MATH 109,A01,083213,Ganzberger; Geoffrey Michael,2,0,34,32
1657601232772,MATH 109,A02,083214,Ganzberger; Geoffrey Michael,4,0,34,30
1657601232772,MATH 109,A03,093478,Ganzberger; Geoffrey Michael,2,0,34,32
1657601232772,MATH 109,B01,083215,Ganzberger; Geoffrey Michael,1,0,32,31
1657601232772,MATH 109,B02,083216,Ganzberger; Geoffrey Michael,2,0,32,30
1657601232772,MATH 109,B03,093479,Ganzberger; Geoffrey Michael,8,0,32,24
1657601238805,MATH 142A,A01,083219,Chow; Bennett,7,0,32,25
1657601238805,MATH 142A,A02,083220,Chow; Bennett,10,0,32,22
1657601238805,MATH 142A,A03,093480,Chow; Bennett,9,0,32,23
1657601238805,MATH 142A,B03,093481,Chow; Bennett,8,0,32,24
1657601238805,MATH 142A,B04,093558,Chow; Bennett,13,0,32,19
1657601238805,MATH 142A,B05,093559,Chow; Bennett,6,0,32,26
1657601244831,MATH 193A,A01,083224,Rotar; Vladimir,8,0,34,26
1657601244831,MATH 193A,A02,083225,Rotar; Vladimir,9,0,34,25
1657601244831,MATH 193A,A03,083781,Rotar; Vladimir,5,0,34,29
1657601244831,MATH 193A,A04,083782,Rotar; Vladimir,10,0,34,24
1657601244831,MATH 193A,A05,093482,Rotar; Vladimir,10,0,34,24
1657601250856,MATH 197,001,091859,McAuley; Julian John,9999,0,9999,0
1657601250856,MATH 197,002,095566,Kedlaya; Kiran S.,9997,0,9999,2
1657601250856,MATH 197,003,095567,Xiao; Ming,9999,0,9999,0
1657601250856,MATH 197,004,095571,Perols; Johan Lars,9998,0,9999,1
1657601257908,COGS 9,A01,083615,Shannon; Kyle Michael,9,0,75,66
1657601263934,COGS 11,A01,083617,Boyle; Mary E. T.,23,0,48,25
1657601269958,COGS 13,A01,083071,Bastos; Amalia Pinkusfeld,11,0,71,60
1657601275982,COGS 14A,A01,092681,Semenuks; Arturs,5,1,100,95
1657601282010,COGS 14B,A01,083073,Cheng; Tzu-Han,6,0,63,57
1657601288031,COGS 17,A01,092677,Semenuks; Arturs,6,0,81,75
1657601294057,COGS 100,A01,083619,Allen; Michael Gordon,17,0,70,53
1657601300079,COGS 101A,A01,083621,Davis; Joshua Daniel,9,0,68,59
1657601306102,COGS 101B,A01,091572,Allen; Michael Gordon,12,0,65,53
1657601312135,COGS 101C,A01,083625,Delgado; Tania,17,0,35,18
1657601318161,COGS 107A,A01,083627,Boyle; Mary E. T.,13,0,60,47
1657601324186,COGS 118A,A01,083075,Gupta; Anjum,21,0,76,55
1657601330212,CSE 3,A50,083646,Miranda; Gregory Joseph,24,0,50,26
1657601336238,CSE 8A,A50,083650,Miranda; Gregory Joseph,17,1,56,39
1657601342263,CSE 11,A01,083080,Cao; Yingjun,6,15,40,34
1657601348291,CSE 12,A01,083652,Krause-Levy; Sophia Louisa,28,1,120,92
1657601354312,CSE 15L,A01,083654,Morris; Justin Loren,9,0,50,41
1657601354312,CSE 15L,A02,083655,Morris; Justin Loren,9,0,50,41
1657601360345,CSE 20,A01,083657,Tran; Khoa Dang,39,0,80,41
1657601366376,CSE 21,A01,095574,Bach; Quang Tran,22,0,48,26
1657601372404,CSE 30,A01,083084,Eldon; John,5,0,80,75
1657601372404,CSE 30,B01,095061,Bhaskar; Nishant,9,0,50,41
1657601378428,CSE 100,A01,083659,Cao; Yingjun,5,4,70,65
1657601384452,CSE 134B,A01,083661,Powell; Thomas Allan,22,0,100,78
1657601390476,CSE 140,A01,083663,Gungor; Onat,15,0,85,70
1657601396503,CSE 140L,A01,083088,Eldon; John,21,0,100,79
1657601402526,CSE 175,A01,083665,Kumar; Rakesh,3,0,25,22
1657601408549,CSE 190,A00,092507,Dubnov; Shlomo,8,0,20,12
1657601414575,ECE 45,A01,083139,Congero; Spencer William,6,0,75,69
1657601420602,ECE 65,A50,083695,Saad; Andrew S,12,0,30,18
1657601420602,ECE 65,A51,095125,Saad; Andrew S,24,0,26,2
1657601426628,ECE 109,A01,091882,Touri; Behrouz,19,0,70,51
1657601432650,ECE 180,A00,083140,Abi Samra; Nicholas Camill,1,0,30,29
1657601432650,ECE 180,B00,083141,Abi Samra; Nicholas Camill,0,0,30,30
1657601438683,MATH 10A,A01,083735,Patchell; Gregory David,2,0,30,28
1657601438683,MATH 10A,A02,083736,Patchell; Gregory David,20,0,30,10
1657601438683,MATH 10A,A03,083737,Patchell; Gregory David,16,0,30,14
1657601444712,MATH 10B,A01,083207,Lim; Seonhee,8,0,34,26
1657601444712,MATH 10B,A02,083208,Lim; Seonhee,9,0,35,26
1657601444712,MATH 10B,A03,093472,Lim; Seonhee,7,0,34,27
1657601444712,MATH 10B,B01,083739,Sinha; Shubham,12,0,30,18
1657601450744,MATH 18,A01,083743,Cinel; Cameron Alexander,7,0,30,23
1657601450744,MATH 18,A02,083744,Cinel; Cameron Alexander,17,0,30,13
1657601450744,MATH 18,A03,083745,Cinel; Cameron Alexander,9,0,30,21
1657601450744,MATH 18,B01,083748,Rideout; David Porter,5,0,37,32
1657601450744,MATH 18,B02,083749,Rideout; David Porter,5,0,36,31
1657601450744,MATH 18,B03,083750,Rideout; David Porter,3,0,37,34
1657601450744,MATH 18,B04,083751,Rideout; David Porter,6,0,36,30
1657601450744,MATH 18,B05,093473,Rideout; David Porter,6,0,36,30
1657601450744,MATH 18,B06,093474,Rideout; David Porter,6,0,36,30
1657601456768,MATH 20A,A01,083754,Zheng; Zequn,14,0,40,26
1657601462791,MATH 20B,A01,083756,Briones; Jor-el Thomas Caparas,4,0,36,32
1657601462791,MATH 20B,A02,083757,Briones; Jor-el Thomas Caparas,1,0,36,35
1657601462791,MATH 20B,A03,093475,Briones; Jor-el Thomas Caparas,2,0,36,34
1657601468821,MATH 20C,A01,083760,Briones; Jor-el Thomas Caparas,1,0,35,34
1657601468821,MATH 20C,A02,083761,Briones; Jor-el Thomas Caparas,8,0,35,27
1657601468821,MATH 20C,A03,093476,Briones; Jor-el Thomas Caparas,0,1,36,36
1657601468821,MATH 20C,B01,083762,Bach; Quang Tran,1,0,30,29
1657601474855,MATH 20D,A01,083765,Tran; Brian Kha,5,0,30,25
1657601474855,MATH 20D,A02,083766,Tran; Brian Kha,5,0,30,25
1657601474855,MATH 20D,A03,083767,Tran; Brian Kha,5,0,30,25
1657601480879,MATH 20E,A01,083771,Ganguly; Soumya,9,0,32,23
1657601480879,MATH 20E,A02,083772,Ganguly; Soumya,6,0,32,26
1657601480879,MATH 20E,B01,083773,Ciotti; Benjamin,20,0,35,15
1657601480879,MATH 20E,B02,083774,Ciotti; Benjamin,18,0,35,17
1657601486902,MATH 103A,A01,083777,Greenfeld; Be'Eri,3,0,36,33
1657601486902,MATH 103A,A02,083778,Greenfeld; Be'Eri,5,0,36,31
1657601486902,MATH 103A,A03,093561,Greenfeld; Be'Eri,6,0,36,30
1657601486902,MATH 103A,B01,083779,Greenfeld; Be'Eri,7,0,36,29
1657601486902,MATH 103A,B02,083780,Greenfeld; Be'Eri,4,0,36,32
1657601486902,MATH 103A,B03,093562,Greenfeld; Be'Eri,3,0,36,33
1657601492927,MATH 105,A01,085443,Carter; Anne Toulson,15,0,35,20
1657601492927,MATH 105,A02,093477,Carter; Anne Toulson,20,0,35,15
1657601498951,MATH 109,A01,083213,Ganzberger; Geoffrey Michael,2,0,34,32
1657601498951,MATH 109,A02,083214,Ganzberger; Geoffrey Michael,4,0,34,30
1657601498951,MATH 109,A03,093478,Ganzberger; Geoffrey Michael,2,0,34,32
1657601498951,MATH 109,B01,083215,Ganzberger; Geoffrey Michael,1,0,32,31
1657601498951,MATH 109,B02,083216,Ganzberger; Geoffrey Michael,2,0,32,30
1657601498951,MATH 109,B03,093479,Ganzberger; Geoffrey Michael,8,0,32,24
1657601504990,MATH 142A,A01,083219,Chow; Bennett,7,0,32,25
1657601504990,MATH 142A,A02,083220,Chow; Bennett,10,0,32,22
1657601504990,MATH 142A,A03,093480,Chow; Bennett,9,0,32,23
1657601504990,MATH 142A,B03,093481,Chow; Bennett,8,0,32,24
1657601504990,MATH 142A,B04,093558,Chow; Bennett,13,0,32,19
1657601504990,MATH 142A,B05,093559,Chow; Bennett,6,0,32,26
1657601511018,MATH 193A,A01,083224,Rotar; Vladimir,8,0,34,26
1657601511018,MATH 193A,A02,083225,Rotar; Vladimir,9,0,34,25
1657601511018,MATH 193A,A03,083781,Rotar; Vladimir,5,0,34,29
1657601511018,MATH 193A,A04,083782,Rotar; Vladimir,10,0,34,24
1657601511018,MATH 193A,A05,093482,Rotar; Vladimir,10,0,34,24
1657601517040,MATH 197,001,091859,McAuley; Julian John,9999,0,9999,0
1657601517040,MATH 197,002,095566,Kedlaya; Kiran S.,9997,0,9999,2
1657601517040,MATH 197,003,095567,Xiao; Ming,9999,0,9999,0
1657601517040,MATH 197,004,095571,Perols; Johan Lars,9998,0,9999,1
1657601524091,COGS 9,A01,083615,Shannon; Kyle Michael,9,0,75,66
1657601530124,COGS 11,A01,083617,Boyle; Mary E. T.,23,0,48,25
1657601536147,COGS 13,A01,083071,Bastos; Amalia Pinkusfeld,11,0,71,60
1657601542172,COGS 14A,A01,092681,Semenuks; Arturs,5,1,100,95
1657601548194,COGS 14B,A01,083073,Cheng; Tzu-Han,6,0,63,57
1657601554217,COGS 17,A01,092677,Semenuks; Arturs,6,0,81,75
1657601560243,COGS 100,A01,083619,Allen; Michael Gordon,17,0,70,53
1657601566266,COGS 101A,A01,083621,Davis; Joshua Daniel,9,0,68,59
1657601572293,COGS 101B,A01,091572,Allen; Michael Gordon,12,0,65,53
1657601578319,COGS 101C,A01,083625,Delgado; Tania,17,0,35,18
1657601584350,COGS 107A,A01,083627,Boyle; Mary E. T.,13,0,60,47
1657601590376,COGS 118A,A01,083075,Gupta; Anjum,21,0,76,55
1657601596398,CSE 3,A50,083646,Miranda; Gregory Joseph,24,0,50,26
1657601602422,CSE 8A,A50,083650,Miranda; Gregory Joseph,17,1,56,39
1657601608445,CSE 11,A01,083080,Cao; Yingjun,6,15,40,34
1657601614468,CSE 12,A01,083652,Krause-Levy; Sophia Louisa,28,1,120,92
1657601620495,CSE 15L,A01,083654,Morris; Justin Loren,9,0,50,41
1657601620495,CSE 15L,A02,083655,Morris; Justin Loren,9,0,50,41
1657601626526,CSE 20,A01,083657,Tran; Khoa Dang,39,0,80,41
1657601632550,CSE 21,A01,095574,Bach; Quang Tran,22,0,48,26
1657601638575,CSE 30,A01,083084,Eldon; John,5,0,80,75
1657601638575,CSE 30,B01,095061,Bhaskar; Nishant,9,0,50,41
1657601644600,CSE 100,A01,083659,Cao; Yingjun,5,4,70,65
1657601650624,CSE 134B,A01,083661,Powell; Thomas Allan,22,0,100,78
1657601656651,CSE 140,A01,083663,Gungor; Onat,15,0,85,70
1657601662674,CSE 140L,A01,083088,Eldon; John,21,0,100,79
1657601668697,CSE 175,A01,083665,Kumar; Rakesh,3,0,25,22
1657601674719,CSE 190,A00,092507,Dubnov; Shlomo,8,0,20,12
1657601680831,ECE 45,A01,083139,Congero; Spencer William,6,0,75,69
1657601686856,ECE 65,A50,083695,Saad; Andrew S,12,0,30,18
1657601686856,ECE 65,A51,095125,Saad; Andrew S,24,0,26,2
1657601692879,ECE 109,A01,091882,Touri; Behrouz,19,0,70,51
1657601698901,ECE 180,A00,083140,Abi Samra; Nicholas Camill,1,0,30,29
1657601698901,ECE 180,B00,083141,Abi Samra; Nicholas Camill,0,0,30,30
1657601704930,MATH 10A,A01,083735,Patchell; Gregory David,2,0,30,28
1657601704930,MATH 10A,A02,083736,Patchell; Gregory David,20,0,30,10
1657601704930,MATH 10A,A03,083737,Patchell; Gregory David,16,0,30,14
1657601710958,MATH 10B,A01,083207,Lim; Seonhee,8,0,34,26
1657601710958,MATH 10B,A02,083208,Lim; Seonhee,9,0,35,26
1657601710958,MATH 10B,A03,093472,Lim; Seonhee,7,0,34,27
1657601710958,MATH 10B,B01,083739,Sinha; Shubham,12,0,30,18
1657601716987,MATH 18,A01,083743,Cinel; Cameron Alexander,7,0,30,23
1657601716987,MATH 18,A02,083744,Cinel; Cameron Alexander,17,0,30,13
1657601716987,MATH 18,A03,083745,Cinel; Cameron Alexander,9,0,30,21
1657601716987,MATH 18,B01,083748,Rideout; David Porter,5,0,37,32
1657601716987,MATH 18,B02,083749,Rideout; David Porter,5,0,36,31
1657601716987,MATH 18,B03,083750,Rideout; David Porter,3,0,37,34
1657601716987,MATH 18,B04,083751,Rideout; David Porter,6,0,36,30
1657601716987,MATH 18,B05,093473,Rideout; David Porter,6,0,36,30
1657601716987,MATH 18,B06,093474,Rideout; David Porter,6,0,36,30
1657601723013,MATH 20A,A01,083754,Zheng; Zequn,14,0,40,26
1657601729045,MATH 20B,A01,083756,Briones; Jor-el Thomas Caparas,4,0,36,32
1657601729045,MATH 20B,A02,083757,Briones; Jor-el Thomas Caparas,1,0,36,35
1657601729045,MATH 20B,A03,093475,Briones; Jor-el Thomas Caparas,2,0,36,34
1657601735067,MATH 20C,A01,083760,Briones; Jor-el Thomas Caparas,1,0,35,34
1657601735067,MATH 20C,A02,083761,Briones; Jor-el Thomas Caparas,8,0,35,27
1657601735067,MATH 20C,A03,093476,Briones; Jor-el Thomas Caparas,0,1,36,36
1657601735067,MATH 20C,B01,083762,Bach; Quang Tran,1,0,30,29
1657601741091,MATH 20D,A01,083765,Tran; Brian Kha,5,0,30,25
1657601741091,MATH 20D,A02,083766,Tran; Brian Kha,5,0,30,25
1657601741091,MATH 20D,A03,083767,Tran; Brian Kha,5,0,30,25
1657601747114,MATH 20E,A01,083771,Ganguly; Soumya,9,0,32,23
1657601747114,MATH 20E,A02,083772,Ganguly; Soumya,6,0,32,26
1657601747114,MATH 20E,B01,083773,Ciotti; Benjamin,20,0,35,15
1657601747114,MATH 20E,B02,083774,Ciotti; Benjamin,18,0,35,17
1657601753138,MATH 103A,A01,083777,Greenfeld; Be'Eri,3,0,36,33
1657601753138,MATH 103A,A02,083778,Greenfeld; Be'Eri,5,0,36,31
1657601753138,MATH 103A,A03,093561,Greenfeld; Be'Eri,6,0,36,30
1657601753138,MATH 103A,B01,083779,Greenfeld; Be'Eri,7,0,36,29
1657601753138,MATH 103A,B02,083780,Greenfeld; Be'Eri,4,0,36,32
1657601753138,MATH 103A,B03,093562,Greenfeld; Be'Eri,3,0,36,33
1657601759170,MATH 105,A01,085443,Carter; Anne Toulson,15,0,35,20
1657601759170,MATH 105,A02,093477,Carter; Anne Toulson,20,0,35,15
1657601765195,MATH 109,A01,083213,Ganzberger; Geoffrey Michael,2,0,34,32
1657601765195,MATH 109,A02,083214,Ganzberger; Geoffrey Michael,4,0,34,30
1657601765195,MATH 109,A03,093478,Ganzberger; Geoffrey Michael,2,0,34,32
1657601765195,MATH 109,B01,083215,Ganzberger; Geoffrey Michael,1,0,32,31
1657601765195,MATH 109,B02,083216,Ganzberger; Geoffrey Michael,2,0,32,30
1657601765195,MATH 109,B03,093479,Ganzberger; Geoffrey Michael,8,0,32,24
1657601771224,MATH 142A,A01,083219,Chow; Bennett,7,0,32,25
1657601771224,MATH 142A,A02,083220,Chow; Bennett,10,0,32,22
1657601771224,MATH 142A,A03,093480,Chow; Bennett,9,0,32,23
1657601771224,MATH 142A,B03,093481,Chow; Bennett,8,0,32,24
1657601771224,MATH 142A,B04,093558,Chow; Bennett,13,0,32,19
1657601771224,MATH 142A,B05,093559,Chow; Bennett,6,0,32,26
1657601777251,MATH 193A,A01,083224,Rotar; Vladimir,8,0,34,26
1657601777251,MATH 193A,A02,083225,Rotar; Vladimir,9,0,34,25
1657601777251,MATH 193A,A03,083781,Rotar; Vladimir,5,0,34,29
1657601777251,MATH 193A,A04,083782,Rotar; Vladimir,10,0,34,24
1657601777251,MATH 193A,A05,093482,Rotar; Vladimir,10,0,34,24
1657601783277,MATH 197,001,091859,McAuley; Julian John,9999,0,9999,0
1657601783277,MATH 197,002,095566,Kedlaya; Kiran S.,9997,0,9999,2
1657601783277,MATH 197,003,095567,Xiao; Ming,9999,0,9999,0
1657601783277,MATH 197,004,095571,Perols; Johan Lars,9998,0,9999,1
1657601790327,COGS 9,A01,083615,Shannon; Kyle Michael,9,0,75,66
1657601796352,COGS 11,A01,083617,Boyle; Mary E. T.,23,0,48,25
1657601802374,COGS 13,A01,083071,Bastos; Amalia Pinkusfeld,11,0,71,60
1657601808402,COGS 14A,A01,092681,Semenuks; Arturs,5,1,100,95
1657601814429,COGS 14B,A01,083073,Cheng; Tzu-Han,6,0,63,57
1657601820457,COGS 17,A01,092677,Semenuks; Arturs,6,0,81,75
1657601826481,COGS 100,A01,083619,Allen; Michael Gordon,17,0,70,53
1657601832507,COGS 101A,A01,083621,Davis; Joshua Daniel,9,0,68,59
1657601838532,COGS 101B,A01,091572,Allen; Michael Gordon,12,0,65,53
1657601844555,COGS 101C,A01,083625,Delgado; Tania,17,0,35,18
1657601850578,COGS 107A,A01,083627,Boyle; Mary E. T.,13,0,60,47
1657601856605,COGS 118A,A01,083075,Gupta; Anjum,21,0,76,55
1657601862629,CSE 3,A50,083646,Miranda; Gregory Joseph,24,0,50,26
1657601868655,CSE 8A,A50,083650,Miranda; Gregory Joseph,17,1,56,39
1657601874677,CSE 11,A01,083080,Cao; Yingjun,6,15,40,34
1657601880699,CSE 12,A01,083652,Krause-Levy; Sophia Louisa,28,1,120,92
1657601886727,CSE 15L,A01,083654,Morris; Justin Loren,9,0,50,41
1657601886727,CSE 15L,A02,083655,Morris; Justin Loren,9,0,50,41
1657601892759,CSE 20,A01,083657,Tran; Khoa Dang,39,0,80,41
1657601898782,CSE 21,A01,095574,Bach; Quang Tran,22,0,48,26
1657601904804,CSE 30,A01,083084,Eldon; John,5,0,80,75
1657601904804,CSE 30,B01,095061,Bhaskar; Nishant,9,0,50,41
1657601910832,CSE 100,A01,083659,Cao; Yingjun,5,4,70,65
1657601916856,CSE 134B,A01,083661,Powell; Thomas Allan,22,0,100,78
1657601922878,CSE 140,A01,083663,Gungor; Onat,15,0,85,70
1657601928904,CSE 140L,A01,083088,Eldon; John,21,0,100,79
1657601934927,CSE 175,A01,083665,Kumar; Rakesh,3,0,25,22
1657601940951,CSE 190,A00,092507,Dubnov; Shlomo,8,0,20,12
1657601946977,ECE 45,A01,083139,Congero; Spencer William,6,0,75,69
1657601953000,ECE 65,A50,083695,Saad; Andrew S,12,0,30,18
1657601953000,ECE 65,A51,095125,Saad; Andrew S,24,0,26,2
1657601959033,ECE 109,A01,091882,Touri; Behrouz,19,0,70,51
1657601965065,ECE 180,A00,083140,Abi Samra; Nicholas Camill,1,0,30,29
1657601965065,ECE 180,B00,083141,Abi Samra; Nicholas Camill,0,0,30,30
1657601971094,MATH 10A,A01,083735,Patchell; Gregory David,2,0,30,28
1657601971094,MATH 10A,A02,083736,Patchell; Gregory David,20,0,30,10
1657601971094,MATH 10A,A03,083737,Patchell; Gregory David,16,0,30,14
1657601977118,MATH 10B,A01,083207,Lim; Seonhee,8,0,34,26
1657601977118,MATH 10B,A02,083208,Lim; Seonhee,9,0,35,26
1657601977118,MATH 10B,A03,093472,Lim; Seonhee,7,0,34,27
1657601977118,MATH 10B,B01,083739,Sinha; Shubham,12,0,30,18
1657601983141,MATH 18,A01,083743,Cinel; Cameron Alexander,7,0,30,23
1657601983141,MATH 18,A02,083744,Cinel; Cameron Alexander,17,0,30,13
1657601983141,MATH 18,A03,083745,Cinel; Cameron Alexander,9,0,30,21
1657601983141,MATH 18,B01,083748,Rideout; David Porter,5,0,37,32
1657601983141,MATH 18,B02,083749,Rideout; David Porter,5,0,36,31
1657601983141,MATH 18,B03,083750,Rideout; David Porter,3,0,37,34
1657601983141,MATH 18,B04,083751,Rideout; David Porter,6,0,36,30
1657601983141,MATH 18,B05,093473,Rideout; David Porter,6,0,36,30
1657601983141,MATH 18,B06,093474,Rideout; David Porter,6,0,36,30
1657601989169,MATH 20A,A01,083754,Zheng; Zequn,14,0,40,26
1657601995192,MATH 20B,A01,083756,Briones; Jor-el Thomas Caparas,4,0,36,32
1657601995192,MATH 20B,A02,083757,Briones; Jor-el Thomas Caparas,1,0,36,35
1657601995192,MATH 20B,A03,093475,Briones; Jor-el Thomas Caparas,2,0,36,34
1657602001215,MATH 20C,A01,083760,Briones; Jor-el Thomas Caparas,1,0,35,34
1657602001215,MATH 20C,A02,083761,Briones; Jor-el Thomas Caparas,8,0,35,27
1657602001215,MATH 20C,A03,093476,Briones; Jor-el Thomas Caparas,0,1,36,36
1657602001215,MATH 20C,B01,083762,Bach; Quang Tran,1,0,30,29
1657602007246,MATH 20D,A01,083765,Tran; Brian Kha,5,0,30,25
1657602007246,MATH 20D,A02,083766,Tran; Brian Kha,5,0,30,25
1657602007246,MATH 20D,A03,083767,Tran; Brian Kha,5,0,30,25
1657602013270,MATH 20E,A01,083771,Ganguly; Soumya,9,0,32,23
1657602013270,MATH 20E,A02,083772,Ganguly; Soumya,6,0,32,26
1657602013270,MATH 20E,B01,083773,Ciotti; Benjamin,20,0,35,15
1657602013270,MATH 20E,B02,083774,Ciotti; Benjamin,18,0,35,17
1657602019292,MATH 103A,A01,083777,Greenfeld; Be'Eri,3,0,36,33
1657602019292,MATH 103A,A02,083778,Greenfeld; Be'Eri,5,0,36,31
1657602019292,MATH 103A,A03,093561,Greenfeld; Be'Eri,6,0,36,30
1657602019292,MATH 103A,B01,083779,Greenfeld; Be'Eri,7,0,36,29
1657602019292,MATH 103A,B02,083780,Greenfeld; Be'Eri,4,0,36,32
1657602019292,MATH 103A,B03,093562,Greenfeld; Be'Eri,3,0,36,33
1657602025316,MATH 105,A01,085443,Carter; Anne Toulson,15,0,35,20
1657602025316,MATH 105,A02,093477,Carter; Anne Toulson,20,0,35,15
1657602031339,MATH 109,A01,083213,Ganzberger; Geoffrey Michael,2,0,34,32
1657602031339,MATH 109,A02,083214,Ganzberger; Geoffrey Michael,4,0,34,30
1657602031339,MATH 109,A03,093478,Ganzberger; Geoffrey Michael,2,0,34,32
1657602031339,MATH 109,B01,083215,Ganzberger; Geoffrey Michael,1,0,32,31
1657602031339,MATH 109,B02,083216,Ganzberger; Geoffrey Michael,2,0,32,30
1657602031339,MATH 109,B03,093479,Ganzberger; Geoffrey Michael,8,0,32,24
1657602037362,MATH 142A,A01,083219,Chow; Bennett,7,0,32,25
1657602037362,MATH 142A,A02,083220,Chow; Bennett,10,0,32,22
1657602037362,MATH 142A,A03,093480,Chow; Bennett,9,0,32,23
1657602037362,MATH 142A,B03,093481,Chow; Bennett,8,0,32,24
1657602037362,MATH 142A,B04,093558,Chow; Bennett,13,0,32,19
1657602037362,MATH 142A,B05,093559,Chow; Bennett,6,0,32,26
1657602043386,MATH 193A,A01,083224,Rotar; Vladimir,8,0,34,26
1657602043386,MATH 193A,A02,083225,Rotar; Vladimir,9,0,34,25
1657602043386,MATH 193A,A03,083781,Rotar; Vladimir,5,0,34,29
1657602043386,MATH 193A,A04,083782,Rotar; Vladimir,10,0,34,24
1657602043386,MATH 193A,A05,093482,Rotar; Vladimir,10,0,34,24
1657602049410,MATH 197,001,091859,McAuley; Julian John,9999,0,9999,0
1657602049410,MATH 197,002,095566,Kedlaya; Kiran S.,9997,0,9999,2
1657602049410,MATH 197,003,095567,Xiao; Ming,9999,0,9999,0
1657602049410,MATH 197,004,095571,Perols; Johan Lars,9998,0,9999,1
1657602056479,COGS 9,A01,083615,Shannon; Kyle Michael,9,0,75,66
1657602062505,COGS 11,A01,083617,Boyle; Mary E. T.,23,0,48,25
1657602068536,COGS 13,A01,083071,Bastos; Amalia Pinkusfeld,11,0,71,60
1657602074567,COGS 14A,A01,092681,Semenuks; Arturs,5,1,100,95
1657602080589,COGS 14B,A01,083073,Cheng; Tzu-Han,6,0,63,57
1657602086612,COGS 17,A01,092677,Semenuks; Arturs,6,0,81,75
1657602092638,COGS 100,A01,083619,Allen; Michael Gordon,17,0,70,53
1657602098664,COGS 101A,A01,083621,Davis; Joshua Daniel,9,0,68,59
1657602104687,COGS 101B,A01,091572,Allen; Michael Gordon,12,0,65,53
1657602110714,COGS 101C,A01,083625,Delgado; Tania,17,0,35,18
1657602116741,COGS 107A,A01,083627,Boyle; Mary E. T.,13,0,60,47
1657602122765,COGS 118A,A01,083075,Gupta; Anjum,21,0,76,55
1657602128789,CSE 3,A50,083646,Miranda; Gregory Joseph,24,0,50,26
1657602134813,CSE 8A,A50,083650,Miranda; Gregory Joseph,17,1,56,39
1657602140840,CSE 11,A01,083080,Cao; Yingjun,6,15,40,34
1657602146870,CSE 12,A01,083652,Krause-Levy; Sophia Louisa,28,1,120,92
1657602152901,CSE 15L,A01,083654,Morris; Justin Loren,9,0,50,41
1657602152901,CSE 15L,A02,083655,Morris; Justin Loren,9,0,50,41
1657602158923,CSE 20,A01,083657,Tran; Khoa Dang,39,0,80,41
1657602164950,CSE 21,A01,095574,Bach; Quang Tran,22,0,48,26
1657602170973,CSE 30,A01,083084,Eldon; John,5,0,80,75
1657602170973,CSE 30,B01,095061,Bhaskar; Nishant,9,0,50,41
1657602177001,CSE 100,A01,083659,Cao; Yingjun,5,4,70,65
1657602183027,CSE 134B,A01,083661,Powell; Thomas Allan,22,0,100,78
1657602189050,CSE 140,A01,083663,Gungor; Onat,15,0,85,70
1657602195079,CSE 140L,A01,083088,Eldon; John,21,0,100,79
1657602201103,CSE 175,A01,083665,Kumar; Rakesh,3,0,25,22
1657602207129,CSE 190,A00,092507,Dubnov; Shlomo,8,0,20,12
1657602213163,ECE 45,A01,083139,Congero; Spencer William,6,0,75,69
1657602219190,ECE 65,A50,083695,Saad; Andrew S,12,0,30,18
1657602219190,ECE 65,A51,095125,Saad; Andrew S,24,0,26,2
1657602225217,ECE 109,A01,091882,Touri; Behrouz,19,0,70,51
1657602231239,ECE 180,A00,083140,Abi Samra; Nicholas Camill,1,0,30,29
1657602231239,ECE 180,B00,083141,Abi Samra; Nicholas Camill,0,0,30,30
1657602237264,MATH 10A,A01,083735,Patchell; Gregory David,2,0,30,28
1657602237264,MATH 10A,A02,083736,Patchell; Gregory David,20,0,30,10
1657602237264,MATH 10A,A03,083737,Patchell; Gregory David,16,0,30,14
1657602243293,MATH 10B,A01,083207,Lim; Seonhee,8,0,34,26
1657602243293,MATH 10B,A02,083208,Lim; Seonhee,9,0,35,26
1657602243293,MATH 10B,A03,093472,Lim; Seonhee,7,0,34,27
1657602243293,MATH 10B,B01,083739,Sinha; Shubham,12,0,30,18
1657602249319,MATH 18,A01,083743,Cinel; Cameron Alexander,7,0,30,23
1657602249319,MATH 18,A02,083744,Cinel; Cameron Alexander,17,0,30,13
1657602249319,MATH 18,A03,083745,Cinel; Cameron Alexander,9,0,30,21
1657602249319,MATH 18,B01,083748,Rideout; David Porter,5,0,37,32
1657602249319,MATH 18,B02,083749,Rideout; David Porter,5,0,36,31
1657602249319,MATH 18,B03,083750,Rideout; David Porter,3,0,37,34
1657602249319,MATH 18,B04,083751,Rideout; David Porter,6,0,36,30
1657602249319,MATH 18,B05,093473,Rideout; David Porter,6,0,36,30
1657602249319,MATH 18,B06,093474,Rideout; David Porter,6,0,36,30
1657602255345,MATH 20A,A01,083754,Zheng; Zequn,14,0,40,26
1657602261373,MATH 20B,A01,083756,Briones; Jor-el Thomas Caparas,4,0,36,32
1657602261373,MATH 20B,A02,083757,Briones; Jor-el Thomas Caparas,1,0,36,35
1657602261373,MATH 20B,A03,093475,Briones; Jor-el Thomas Caparas,2,0,36,34
1657602267395,MATH 20C,A01,083760,Briones; Jor-el Thomas Caparas,1,0,35,34
1657602267395,MATH 20C,A02,083761,Briones; Jor-el Thomas Caparas,8,0,35,27
1657602267395,MATH 20C,A03,093476,Briones; Jor-el Thomas Caparas,0,1,36,36
1657602267395,MATH 20C,B01,083762,Bach; Quang Tran,1,0,30,29
1657602273439,MATH 20D,A01,083765,Tran; Brian Kha,5,0,30,25
1657602273439,MATH 20D,A02,083766,Tran; Brian Kha,5,0,30,25
1657602273439,MATH 20D,A03,083767,Tran; Brian Kha,5,0,30,25
1657602279546,MATH 20E,A01,083771,Ganguly; Soumya,9,0,32,23
1657602279546,MATH 20E,A02,083772,Ganguly; Soumya,6,0,32,26
1657602279546,MATH 20E,B01,083773,Ciotti; Benjamin,20,0,35,15
1657602279546,MATH 20E,B02,083774,Ciotti; Benjamin,18,0,35,17
1657602285588,MATH 103A,A01,083777,Greenfeld; Be'Eri,3,0,36,33
1657602285588,MATH 103A,A02,083778,Greenfeld; Be'Eri,5,0,36,31
1657602285588,MATH 103A,A03,093561,Greenfeld; Be'Eri,6,0,36,30
1657602285588,MATH 103A,B01,083779,Greenfeld; Be'Eri,7,0,36,29
1657602285588,MATH 103A,B02,083780,Greenfeld; Be'Eri,4,0,36,32
1657602285588,MATH 103A,B03,093562,Greenfeld; Be'Eri,3,0,36,33
1657602291621,MATH 105,A01,085443,Carter; Anne Toulson,15,0,35,20
1657602291621,MATH 105,A02,093477,Carter; Anne Toulson,20,0,35,15
1657602297655,MATH 109,A01,083213,Ganzberger; Geoffrey Michael,2,0,34,32
1657602297655,MATH 109,A02,083214,Ganzberger; Geoffrey Michael,4,0,34,30
1657602297655,MATH 109,A03,093478,Ganzberger; Geoffrey Michael,2,0,34,32
1657602297655,MATH 109,B01,083215,Ganzberger; Geoffrey Michael,1,0,32,31
1657602297655,MATH 109,B02,083216,Ganzberger; Geoffrey Michael,2,0,32,30
1657602297655,MATH 109,B03,093479,Ganzberger; Geoffrey Michael,8,0,32,24
1657602303677,MATH 142A,A01,083219,Chow; Bennett,7,0,32,25
1657602303677,MATH 142A,A02,083220,Chow; Bennett,10,0,32,22
1657602303677,MATH 142A,A03,093480,Chow; Bennett,9,0,32,23
1657602303677,MATH 142A,B03,093481,Chow; Bennett,8,0,32,24
1657602303677,MATH 142A,B04,093558,Chow; Bennett,13,0,32,19
1657602303677,MATH 142A,B05,093559,Chow; Bennett,6,0,32,26
1657602309701,MATH 193A,A01,083224,Rotar; Vladimir,8,0,34,26
1657602309701,MATH 193A,A02,083225,Rotar; Vladimir,9,0,34,25
1657602309701,MATH 193A,A03,083781,Rotar; Vladimir,5,0,34,29
1657602309701,MATH 193A,A04,083782,Rotar; Vladimir,10,0,34,24
1657602309701,MATH 193A,A05,093482,Rotar; Vladimir,10,0,34,24
1657602315727,MATH 197,001,091859,McAuley; Julian John,9999,0,9999,0
1657602315727,MATH 197,002,095566,Kedlaya; Kiran S.,9997,0,9999,2
1657602315727,MATH 197,003,095567,Xiao; Ming,9999,0,9999,0
1657602315727,MATH 197,004,095571,Perols; Johan Lars,9998,0,9999,1
1657602322789,COGS 9,A01,083615,Shannon; Kyle Michael,9,0,75,66
1657602328815,COGS 11,A01,083617,Boyle; Mary E. T.,23,0,48,25
1657602334838,COGS 13,A01,083071,Bastos; Amalia Pinkusfeld,11,0,71,60
1657602340861,COGS 14A,A01,092681,Semenuks; Arturs,5,1,100,95
1657602346884,COGS 14B,A01,083073,Cheng; Tzu-Han,6,0,63,57
1657602352910,COGS 17,A01,092677,Semenuks; Arturs,6,0,81,75
1657602358933,COGS 100,A01,083619,Allen; Michael Gordon,17,0,70,53
1657602364966,COGS 101A,A01,083621,Davis; Joshua Daniel,9,0,68,59
1657602370995,COGS 101B,A01,091572,Allen; Michael Gordon,12,0,65,53
1657602377019,COGS 101C,A01,083625,Delgado; Tania,17,0,35,18
1657602383043,COGS 107A,A01,083627,Boyle; Mary E. T.,13,0,60,47
1657602389073,COGS 118A,A01,083075,Gupta; Anjum,21,0,76,55
1657602395102,CSE 3,A50,083646,Miranda; Gregory Joseph,24,0,50,26
1657602401125,CSE 8A,A50,083650,Miranda; Gregory Joseph,17,1,56,39
1657602407147,CSE 11,A01,083080,Cao; Yingjun,6,15,40,34
1657602413178,CSE 12,A01,083652,Krause-Levy; Sophia Louisa,28,1,120,92
1657602419202,CSE 15L,A01,083654,Morris; Justin Loren,9,0,50,41
1657602419202,CSE 15L,A02,083655,Morris; Justin Loren,9,0,50,41
1657602425231,CSE 20,A01,083657,Tran; Khoa Dang,39,0,80,41
1657602431255,CSE 21,A01,095574,Bach; Quang Tran,22,0,48,26
1657602437284,CSE 30,A01,083084,Eldon; John,5,0,80,75
1657602437284,CSE 30,B01,095061,Bhaskar; Nishant,9,0,50,41
1657602443311,CSE 100,A01,083659,Cao; Yingjun,5,4,70,65
1657602449334,CSE 134B,A01,083661,Powell; Thomas Allan,22,0,100,78
1657602455359,CSE 140,A01,083663,Gungor; Onat,15,0,85,70
1657602461387,CSE 140L,A01,083088,Eldon; John,21,0,100,79
1657602467413,CSE 175,A01,083665,Kumar; Rakesh,3,0,25,22
1657602473439,CSE 190,A00,092507,Dubnov; Shlomo,8,0,20,12
1657602479461,ECE 45,A01,083139,Congero; Spencer William,6,0,75,69
1657602485487,ECE 65,A50,083695,Saad; Andrew S,12,0,30,18
1657602485487,ECE 65,A51,095125,Saad; Andrew S,24,0,26,2
1657602491508,ECE 109,A01,091882,Touri; Behrouz,19,0,70,51
1657602497535,ECE 180,A00,083140,Abi Samra; Nicholas Camill,1,0,30,29
1657602497535,ECE 180,B00,083141,Abi Samra; Nicholas Camill,0,0,30,30
1657602503561,MATH 10A,A01,083735,Patchell; Gregory David,2,0,30,28
1657602503561,MATH 10A,A02,083736,Patchell; Gregory David,20,0,30,10
1657602503561,MATH 10A,A03,083737,Patchell; Gregory David,16,0,30,14
1657602509589,MATH 10B,A01,083207,Lim; Seonhee,8,0,34,26
1657602509589,MATH 10B,A02,083208,Lim; Seonhee,9,0,35,26
1657602509589,MATH 10B,A03,093472,Lim; Seonhee,7,0,34,27
1657602509589,MATH 10B,B01,083739,Sinha; Shubham,12,0,30,18
1657602515616,MATH 18,A01,083743,Cinel; Cameron Alexander,7,0,30,23
1657602515616,MATH 18,A02,083744,Cinel; Cameron Alexander,17,0,30,13
1657602515616,MATH 18,A03,083745,Cinel; Cameron Alexander,9,0,30,21
1657602515616,MATH 18,B01,083748,Rideout; David Porter,5,0,37,32
1657602515616,MATH 18,B02,083749,Rideout; David Porter,5,0,36,31
1657602515616,MATH 18,B03,083750,Rideout; David Porter,3,0,37,34
1657602515616,MATH 18,B04,083751,Rideout; David Porter,6,0,36,30
1657602515616,MATH 18,B05,093473,Rideout; David Porter,6,0,36,30
1657602515616,MATH 18,B06,093474,Rideout; David Porter,6,0,36,30
1657602521643,MATH 20A,A01,083754,Zheng; Zequn,14,0,40,26
1657602527664,MATH 20B,A01,083756,Briones; Jor-el Thomas Caparas,4,0,36,32
1657602527664,MATH 20B,A02,083757,Briones; Jor-el Thomas Caparas,1,0,36,35
1657602527664,MATH 20B,A03,093475,Briones; Jor-el Thomas Caparas,2,0,36,34
1657602533687,MATH 20C,A01,083760,Briones; Jor-el Thomas Caparas,1,0,35,34
1657602533687,MATH 20C,A02,083761,Briones; Jor-el Thomas Caparas,8,0,35,27
1657602533687,MATH 20C,A03,093476,Briones; Jor-el Thomas Caparas,0,1,36,36
1657602533687,MATH 20C,B01,083762,Bach; Quang Tran,1,0,30,29
1657602539711,MATH 20D,A01,083765,Tran; Brian Kha,5,0,30,25
1657602539711,MATH 20D,A02,083766,Tran; Brian Kha,5,0,30,25
1657602539711,MATH 20D,A03,083767,Tran; Brian Kha,5,0,30,25
1657602545741,MATH 20E,A01,083771,Ganguly; Soumya,9,0,32,23
1657602545741,MATH 20E,A02,083772,Ganguly; Soumya,6,0,32,26
1657602545741,MATH 20E,B01,083773,Ciotti; Benjamin,20,0,35,15
1657602545741,MATH 20E,B02,083774,Ciotti; Benjamin,18,0,35,17
1657602551783,MATH 103A,A01,083777,Greenfeld; Be'Eri,3,0,36,33
1657602551783,MATH 103A,A02,083778,Greenfeld; Be'Eri,5,0,36,31
1657602551783,MATH 103A,A03,093561,Greenfeld; Be'Eri,6,0,36,30
1657602551783,MATH 103A,B01,083779,Greenfeld; Be'Eri,7,0,36,29
1657602551783,MATH 103A,B02,083780,Greenfeld; Be'Eri,4,0,36,32
1657602551783,MATH 103A,B03,093562,Greenfeld; Be'Eri,3,0,36,33
1657602557804,MATH 105,A01,085443,Carter; Anne Toulson,15,0,35,20
1657602557804,MATH 105,A02,093477,Carter; Anne Toulson,20,0,35,15
1657602563832,MATH 109,A01,083213,Ganzberger; Geoffrey Michael,2,0,34,32
1657602563832,MATH 109,A02,083214,Ganzberger; Geoffrey Michael,4,0,34,30
1657602563832,MATH 109,A03,093478,Ganzberger; Geoffrey Michael,2,0,34,32
1657602563832,MATH 109,B01,083215,Ganzberger; Geoffrey Michael,1,0,32,31
1657602563832,MATH 109,B02,083216,Ganzberger; Geoffrey Michael,2,0,32,30
1657602563832,MATH 109,B03,093479,Ganzberger; Geoffrey Michael,8,0,32,24
1657602569856,MATH 142A,A01,083219,Chow; Bennett,7,0,32,25
1657602569856,MATH 142A,A02,083220,Chow; Bennett,10,0,32,22
1657602569856,MATH 142A,A03,093480,Chow; Bennett,9,0,32,23
1657602569856,MATH 142A,B03,093481,Chow; Bennett,8,0,32,24
1657602569856,MATH 142A,B04,093558,Chow; Bennett,13,0,32,19
1657602569856,MATH 142A,B05,093559,Chow; Bennett,6,0,32,26
1657602575879,MATH 193A,A01,083224,Rotar; Vladimir,8,0,34,26
1657602575879,MATH 193A,A02,083225,Rotar; Vladimir,9,0,34,25
1657602575879,MATH 193A,A03,083781,Rotar; Vladimir,5,0,34,29
1657602575879,MATH 193A,A04,083782,Rotar; Vladimir,10,0,34,24
1657602575879,MATH 193A,A05,093482,Rotar; Vladimir,10,0,34,24
1657602581903,MATH 197,001,091859,McAuley; Julian John,9999,0,9999,0
1657602581903,MATH 197,002,095566,Kedlaya; Kiran S.,9997,0,9999,2
1657602581903,MATH 197,003,095567,Xiao; Ming,9999,0,9999,0
1657602581903,MATH 197,004,095571,Perols; Johan Lars,9998,0,9999,1
1657602588968,COGS 9,A01,083615,Shannon; Kyle Michael,9,0,75,66
1657602594992,COGS 11,A01,083617,Boyle; Mary E. T.,23,0,48,25
1657602601020,COGS 13,A01,083071,Bastos; Amalia Pinkusfeld,11,0,71,60
1657602607045,COGS 14A,A01,092681,Semenuks; Arturs,5,1,100,95
1657602613068,COGS 14B,A01,083073,Cheng; Tzu-Han,6,0,63,57
1657602619095,COGS 17,A01,092677,Semenuks; Arturs,6,0,81,75
1657602625121,COGS 100,A01,083619,Allen; Michael Gordon,17,0,70,53
1657602631143,COGS 101A,A01,083621,Davis; Joshua Daniel,9,0,68,59
1657602637173,COGS 101B,A01,091572,Allen; Michael Gordon,12,0,65,53
1657602643196,COGS 101C,A01,083625,Delgado; Tania,17,0,35,18
1657602649224,COGS 107A,A01,083627,Boyle; Mary E. T.,13,0,60,47
1657602655247,COGS 118A,A01,083075,Gupta; Anjum,21,0,76,55
1657602661273,CSE 3,A50,083646,Miranda; Gregory Joseph,24,0,50,26
1657602667296,CSE 8A,A50,083650,Miranda; Gregory Joseph,17,1,56,39
1657602673323,CSE 11,A01,083080,Cao; Yingjun,6,15,40,34
1657602679347,CSE 12,A01,083652,Krause-Levy; Sophia Louisa,28,1,120,92
1657602685374,CSE 15L,A01,083654,Morris; Justin Loren,9,0,50,41
1657602685374,CSE 15L,A02,083655,Morris; Justin Loren,9,0,50,41
1657602691403,CSE 20,A01,083657,Tran; Khoa Dang,39,0,80,41
1657602697430,CSE 21,A01,095574,Bach; Quang Tran,22,0,48,26
1657602703456,CSE 30,A01,083084,Eldon; John,5,0,80,75
1657602703456,CSE 30,B01,095061,Bhaskar; Nishant,9,0,50,41
1657602709480,CSE 100,A01,083659,Cao; Yingjun,5,4,70,65
1657602715505,CSE 134B,A01,083661,Powell; Thomas Allan,22,0,100,78
1657602721530,CSE 140,A01,083663,Gungor; Onat,15,0,85,70
1657602727555,CSE 140L,A01,083088,Eldon; John,21,0,100,79
1657602733578,CSE 175,A01,083665,Kumar; Rakesh,3,0,25,22
1657602739600,CSE 190,A00,092507,Dubnov; Shlomo,8,0,20,12
1657602745625,ECE 45,A01,083139,Congero; Spencer William,6,0,75,69
1657602751659,ECE 65,A50,083695,Saad; Andrew S,12,0,30,18
1657602751659,ECE 65,A51,095125,Saad; Andrew S,24,0,26,2
1657602757682,ECE 109,A01,091882,Touri; Behrouz,19,0,70,51
1657602763708,ECE 180,A00,083140,Abi Samra; Nicholas Camill,1,0,30,29
1657602763708,ECE 180,B00,083141,Abi Samra; Nicholas Camill,0,0,30,30
1657602769734,MATH 10A,A01,083735,Patchell; Gregory David,2,0,30,28
1657602769734,MATH 10A,A02,083736,Patchell; Gregory David,20,0,30,10
1657602769734,MATH 10A,A03,083737,Patchell; Gregory David,16,0,30,14
1657602775757,MATH 10B,A01,083207,Lim; Seonhee,8,0,34,26
1657602775757,MATH 10B,A02,083208,Lim; Seonhee,9,0,35,26
1657602775757,MATH 10B,A03,093472,Lim; Seonhee,7,0,34,27
1657602775757,MATH 10B,B01,083739,Sinha; Shubham,12,0,30,18
1657602781792,MATH 18,A01,083743,Cinel; Cameron Alexander,7,0,30,23
1657602781792,MATH 18,A02,083744,Cinel; Cameron Alexander,17,0,30,13
1657602781792,MATH 18,A03,083745,Cinel; Cameron Alexander,9,0,30,21
1657602781792,MATH 18,B01,083748,Rideout; David Porter,5,0,37,32
1657602781792,MATH 18,B02,083749,Rideout; David Porter,5,0,36,31
1657602781792,MATH 18,B03,083750,Rideout; David Porter,3,0,37,34
1657602781792,MATH 18,B04,083751,Rideout; David Porter,6,0,36,30
1657602781792,MATH 18,B05,093473,Rideout; David Porter,6,0,36,30
1657602781792,MATH 18,B06,093474,Rideout; David Porter,6,0,36,30
1657602787815,MATH 20A,A01,083754,Zheng; Zequn,14,0,40,26
1657602794195,MATH 20B,A01,083756,Briones; Jor-el Thomas Caparas,4,0,36,32
1657602794195,MATH 20B,A02,083757,Briones; Jor-el Thomas Caparas,1,0,36,35
1657602794195,MATH 20B,A03,093475,Briones; Jor-el Thomas Caparas,2,0,36,34
1657602800223,MATH 20C,A01,083760,Briones; Jor-el Thomas Caparas,1,0,35,34
1657602800223,MATH 20C,A02,083761,Briones; Jor-el Thomas Caparas,8,0,35,27
1657602800223,MATH 20C,A03,093476,Briones; Jor-el Thomas Caparas,0,1,36,36
1657602800223,MATH 20C,B01,083762,Bach; Quang Tran,1,0,30,29
1657602806246,MATH 20D,A01,083765,Tran; Brian Kha,5,0,30,25
1657602806246,MATH 20D,A02,083766,Tran; Brian Kha,5,0,30,25
1657602806246,MATH 20D,A03,083767,Tran; Brian Kha,5,0,30,25
1657602812269,MATH 20E,A01,083771,Ganguly; Soumya,9,0,32,23
1657602812269,MATH 20E,A02,083772,Ganguly; Soumya,6,0,32,26
1657602812269,MATH 20E,B01,083773,Ciotti; Benjamin,20,0,35,15
1657602812269,MATH 20E,B02,083774,Ciotti; Benjamin,18,0,35,17
1657602818293,MATH 103A,A01,083777,Greenfeld; Be'Eri,3,0,36,33
1657602818293,MATH 103A,A02,083778,Greenfeld; Be'Eri,5,0,36,31
1657602818293,MATH 103A,A03,093561,Greenfeld; Be'Eri,6,0,36,30
1657602818293,MATH 103A,B01,083779,Greenfeld; Be'Eri,7,0,36,29
1657602818293,MATH 103A,B02,083780,Greenfeld; Be'Eri,4,0,36,32
1657602818293,MATH 103A,B03,093562,Greenfeld; Be'Eri,3,0,36,33
1657602824321,MATH 105,A01,085443,Carter; Anne Toulson,15,0,35,20
1657602824321,MATH 105,A02,093477,Carter; Anne Toulson,20,0,35,15
1657602830346,MATH 109,A01,083213,Ganzberger; Geoffrey Michael,2,0,34,32
1657602830346,MATH 109,A02,083214,Ganzberger; Geoffrey Michael,4,0,34,30
1657602830346,MATH 109,A03,093478,Ganzberger; Geoffrey Michael,2,0,34,32
1657602830346,MATH 109,B01,083215,Ganzberger; Geoffrey Michael,1,0,32,31
1657602830346,MATH 109,B02,083216,Ganzberger; Geoffrey Michael,2,0,32,30
1657602830346,MATH 109,B03,093479,Ganzberger; Geoffrey Michael,8,0,32,24
1657602836376,MATH 142A,A01,083219,Chow; Bennett,7,0,32,25
1657602836376,MATH 142A,A02,083220,Chow; Bennett,10,0,32,22
1657602836376,MATH 142A,A03,093480,Chow; Bennett,9,0,32,23
1657602836376,MATH 142A,B03,093481,Chow; Bennett,8,0,32,24
1657602836376,MATH 142A,B04,093558,Chow; Bennett,13,0,32,19
1657602836376,MATH 142A,B05,093559,Chow; Bennett,6,0,32,26
1657602842417,MATH 193A,A01,083224,Rotar; Vladimir,8,0,34,26
1657602842417,MATH 193A,A02,083225,Rotar; Vladimir,9,0,34,25
1657602842417,MATH 193A,A03,083781,Rotar; Vladimir,5,0,34,29
1657602842417,MATH 193A,A04,083782,Rotar; Vladimir,10,0,34,24
1657602842417,MATH 193A,A05,093482,Rotar; Vladimir,10,0,34,24
1657602848446,MATH 197,001,091859,McAuley; Julian John,9999,0,9999,0
1657602848446,MATH 197,002,095566,Kedlaya; Kiran S.,9997,0,9999,2
1657602848446,MATH 197,003,095567,Xiao; Ming,9999,0,9999,0
1657602848446,MATH 197,004,095571,Perols; Johan Lars,9998,0,9999,1
1657602855517,COGS 9,A01,083615,Shannon; Kyle Michael,9,0,75,66
1657602861547,COGS 11,A01,083617,Boyle; Mary E. T.,23,0,48,25
1657602867571,COGS 13,A01,083071,Bastos; Amalia Pinkusfeld,11,0,71,60
1657602873688,COGS 14A,A01,092681,Semenuks; Arturs,5,1,100,95
1657602879718,COGS 14B,A01,083073,Cheng; Tzu-Han,6,0,63,57
1657602885747,COGS 17,A01,092677,Semenuks; Arturs,6,0,81,75
1657602891774,COGS 100,A01,083619,Allen; Michael Gordon,17,0,70,53
1657602897798,COGS 101A,A01,083621,Davis; Joshua Daniel,9,0,68,59
1657602903825,COGS 101B,A01,091572,Allen; Michael Gordon,12,0,65,53
1657602909848,COGS 101C,A01,083625,Delgado; Tania,17,0,35,18
1657602915871,COGS 107A,A01,083627,Boyle; Mary E. T.,13,0,60,47
1657602921894,COGS 118A,A01,083075,Gupta; Anjum,21,0,76,55
1657602927924,CSE 3,A50,083646,Miranda; Gregory Joseph,24,0,50,26
1657602933953,CSE 8A,A50,083650,Miranda; Gregory Joseph,17,1,56,39
1657602939974,CSE 11,A01,083080,Cao; Yingjun,6,15,40,34
1657602946001,CSE 12,A01,083652,Krause-Levy; Sophia Louisa,28,1,120,92
1657602952028,CSE 15L,A01,083654,Morris; Justin Loren,9,0,50,41
1657602952028,CSE 15L,A02,083655,Morris; Justin Loren,9,0,50,41
1657602958054,CSE 20,A01,083657,Tran; Khoa Dang,39,0,80,41
1657602964080,CSE 21,A01,095574,Bach; Quang Tran,22,0,48,26
1657602970107,CSE 30,A01,083084,Eldon; John,5,0,80,75
1657602970107,CSE 30,B01,095061,Bhaskar; Nishant,9,0,50,41
1657602976131,CSE 100,A01,083659,Cao; Yingjun,5,4,70,65
1657602982157,CSE 134B,A01,083661,Powell; Thomas Allan,22,0,100,78
1657602988183,CSE 140,A01,083663,Gungor; Onat,15,0,85,70
1657602994207,CSE 140L,A01,083088,Eldon; John,21,0,100,79
1657603000229,CSE 175,A01,083665,Kumar; Rakesh,3,0,25,22
1657603006262,CSE 190,A00,092507,Dubnov; Shlomo,8,0,20,12
1657603012289,ECE 45,A01,083139,Congero; Spencer William,6,0,75,69
1657603018317,ECE 65,A50,083695,Saad; Andrew S,12,0,30,18
1657603018317,ECE 65,A51,095125,Saad; Andrew S,24,0,26,2
1657603024349,ECE 109,A01,091882,Touri; Behrouz,19,0,70,51
1657603030373,ECE 180,A00,083140,Abi Samra; Nicholas Camill,1,0,30,29
1657603030373,ECE 180,B00,083141,Abi Samra; Nicholas Camill,0,0,30,30
1657603036396,MATH 10A,A01,083735,Patchell; Gregory David,2,0,30,28
1657603036396,MATH 10A,A02,083736,Patchell; Gregory David,20,0,30,10
1657603036396,MATH 10A,A03,083737,Patchell; Gregory David,16,0,30,14
1657603042425,MATH 10B,A01,083207,Lim; Seonhee,8,0,34,26
1657603042425,MATH 10B,A02,083208,Lim; Seonhee,9,0,35,26
1657603042425,MATH 10B,A03,093472,Lim; Seonhee,7,0,34,27
1657603042425,MATH 10B,B01,083739,Sinha; Shubham,12,0,30,18
1657603048457,MATH 18,A01,083743,Cinel; Cameron Alexander,7,0,30,23
1657603048457,MATH 18,A02,083744,Cinel; Cameron Alexander,17,0,30,13
1657603048457,MATH 18,A03,083745,Cinel; Cameron Alexander,9,0,30,21
1657603048457,MATH 18,B01,083748,Rideout; David Porter,5,0,37,32
1657603048457,MATH 18,B02,083749,Rideout; David Porter,5,0,36,31
1657603048457,MATH 18,B03,083750,Rideout; David Porter,3,0,37,34
1657603048457,MATH 18,B04,083751,Rideout; David Porter,6,0,36,30
1657603048457,MATH 18,B05,093473,Rideout; David Porter,6,0,36,30
1657603048457,MATH 18,B06,093474,Rideout; David Porter,6,0,36,30
1657603054491,MATH 20A,A01,083754,Zheng; Zequn,14,0,40,26
1657603060513,MATH 20B,A01,083756,Briones; Jor-el Thomas Caparas,4,0,36,32
1657603060513,MATH 20B,A02,083757,Briones; Jor-el Thomas Caparas,1,0,36,35
1657603060513,MATH 20B,A03,093475,Briones; Jor-el Thomas Caparas,2,0,36,34
1657603066537,MATH 20C,A01,083760,Briones; Jor-el Thomas Caparas,1,0,35,34
1657603066537,MATH 20C,A02,083761,Briones; Jor-el Thomas Caparas,8,0,35,27
1657603066537,MATH 20C,A03,093476,Briones; Jor-el Thomas Caparas,0,1,36,36
1657603066537,MATH 20C,B01,083762,Bach; Quang Tran,1,0,30,29
1657603072565,MATH 20D,A01,083765,Tran; Brian Kha,5,0,30,25
1657603072565,MATH 20D,A02,083766,Tran; Brian Kha,5,0,30,25
1657603072565,MATH 20D,A03,083767,Tran; Brian Kha,5,0,30,25
1657603078588,MATH 20E,A01,083771,Ganguly; Soumya,9,0,32,23
1657603078588,MATH 20E,A02,083772,Ganguly; Soumya,6,0,32,26
1657603078588,MATH 20E,B01,083773,Ciotti; Benjamin,20,0,35,15
1657603078588,MATH 20E,B02,083774,Ciotti; Benjamin,18,0,35,17
1657603084616,MATH 103A,A01,083777,Greenfeld; Be'Eri,3,0,36,33
1657603084616,MATH 103A,A02,083778,Greenfeld; Be'Eri,5,0,36,31
1657603084616,MATH 103A,A03,093561,Greenfeld; Be'Eri,6,0,36,30
1657603084616,MATH 103A,B01,083779,Greenfeld; Be'Eri,7,0,36,29
1657603084616,MATH 103A,B02,083780,Greenfeld; Be'Eri,4,0,36,32
1657603084616,MATH 103A,B03,093562,Greenfeld; Be'Eri,3,0,36,33
1657603090640,MATH 105,A01,085443,Carter; Anne Toulson,15,0,35,20
1657603090640,MATH 105,A02,093477,Carter; Anne Toulson,20,0,35,15
1657603096663,MATH 109,A01,083213,Ganzberger; Geoffrey Michael,2,0,34,32
1657603096663,MATH 109,A02,083214,Ganzberger; Geoffrey Michael,4,0,34,30
1657603096663,MATH 109,A03,093478,Ganzberger; Geoffrey Michael,2,0,34,32
1657603096663,MATH 109,B01,083215,Ganzberger; Geoffrey Michael,1,0,32,31
1657603096663,MATH 109,B02,083216,Ganzberger; Geoffrey Michael,2,0,32,30
1657603096663,MATH 109,B03,093479,Ganzberger; Geoffrey Michael,8,0,32,24
1657603102685,MATH 142A,A01,083219,Chow; Bennett,7,0,32,25
1657603102685,MATH 142A,A02,083220,Chow; Bennett,10,0,32,22
1657603102685,MATH 142A,A03,093480,Chow; Bennett,9,0,32,23
1657603102685,MATH 142A,B03,093481,Chow; Bennett,8,0,32,24
1657603102685,MATH 142A,B04,093558,Chow; Bennett,13,0,32,19
1657603102685,MATH 142A,B05,093559,Chow; Bennett,6,0,32,26
1657603108709,MATH 193A,A01,083224,Rotar; Vladimir,8,0,34,26
1657603108709,MATH 193A,A02,083225,Rotar; Vladimir,9,0,34,25
1657603108709,MATH 193A,A03,083781,Rotar; Vladimir,5,0,34,29
1657603108709,MATH 193A,A04,083782,Rotar; Vladimir,10,0,34,24
1657603108709,MATH 193A,A05,093482,Rotar; Vladimir,10,0,34,24
1657603114736,MATH 197,001,091859,McAuley; Julian John,9999,0,9999,0
1657603114736,MATH 197,002,095566,Kedlaya; Kiran S.,9997,0,9999,2
1657603114736,MATH 197,003,095567,Xiao; Ming,9999,0,9999,0
1657603114736,MATH 197,004,095571,Perols; Johan Lars,9998,0,9999,1
1657603121802,COGS 9,A01,083615,Shannon; Kyle Michael,9,0,75,66
1657603127825,COGS 11,A01,083617,Boyle; Mary E. T.,23,0,48,25
1657603133856,COGS 13,A01,083071,Bastos; Amalia Pinkusfeld,11,0,71,60
1657603139878,COGS 14A,A01,092681,Semenuks; Arturs,5,1,100,95
1657603145901,COGS 14B,A01,083073,Cheng; Tzu-Han,6,0,63,57
1657603151924,COGS 17,A01,092677,Semenuks; Arturs,6,0,81,75
1657603157951,COGS 100,A01,083619,Allen; Michael Gordon,17,0,70,53
1657603163975,COGS 101A,A01,083621,Davis; Joshua Daniel,9,0,68,59
1657603170007,COGS 101B,A01,091572,Allen; Michael Gordon,12,0,65,53
1657603176032,COGS 101C,A01,083625,Delgado; Tania,17,0,35,18
1657603182061,COGS 107A,A01,083627,Boyle; Mary E. T.,13,0,60,47
1657603188094,COGS 118A,A01,083075,Gupta; Anjum,21,0,76,55
1657603194119,CSE 3,A50,083646,Miranda; Gregory Joseph,24,0,50,26
1657603200146,CSE 8A,A50,083650,Miranda; Gregory Joseph,17,1,56,39
1657603206170,CSE 11,A01,083080,Cao; Yingjun,6,15,40,34
1657603212198,CSE 12,A01,083652,Krause-Levy; Sophia Louisa,28,1,120,92
1657603218221,CSE 15L,A01,083654,Morris; Justin Loren,9,0,50,41
1657603218221,CSE 15L,A02,083655,Morris; Justin Loren,9,0,50,41
1657603224249,CSE 20,A01,083657,Tran; Khoa Dang,39,0,80,41
1657603230272,CSE 21,A01,095574,Bach; Quang Tran,22,0,48,26
1657603236299,CSE 30,A01,083084,Eldon; John,5,0,80,75
1657603236299,CSE 30,B01,095061,Bhaskar; Nishant,9,0,50,41
1657603242324,CSE 100,A01,083659,Cao; Yingjun,5,4,70,65
1657603248349,CSE 134B,A01,083661,Powell; Thomas Allan,22,0,100,78
1657603254373,CSE 140,A01,083663,Gungor; Onat,15,0,85,70
1657603260397,CSE 140L,A01,083088,Eldon; John,21,0,100,79
1657603266419,CSE 175,A01,083665,Kumar; Rakesh,3,0,25,22
1657603272443,CSE 190,A00,092507,Dubnov; Shlomo,8,0,20,12
1657603278470,ECE 45,A01,083139,Congero; Spencer William,6,0,75,69
1657603284494,ECE 65,A50,083695,Saad; Andrew S,12,0,30,18
1657603284494,ECE 65,A51,095125,Saad; Andrew S,24,0,26,2
1657603290519,ECE 109,A01,091882,Touri; Behrouz,19,0,70,51
1657603296543,ECE 180,A00,083140,Abi Samra; Nicholas Camill,1,0,30,29
1657603296543,ECE 180,B00,083141,Abi Samra; Nicholas Camill,0,0,30,30
1657603302572,MATH 10A,A01,083735,Patchell; Gregory David,2,0,30,28
1657603302572,MATH 10A,A02,083736,Patchell; Gregory David,20,0,30,10
1657603302572,MATH 10A,A03,083737,Patchell; Gregory David,16,0,30,14
1657603308596,MATH 10B,A01,083207,Lim; Seonhee,8,0,34,26
1657603308596,MATH 10B,A02,083208,Lim; Seonhee,9,0,35,26
1657603308596,MATH 10B,A03,093472,Lim; Seonhee,7,0,34,27
1657603308596,MATH 10B,B01,083739,Sinha; Shubham,12,0,30,18
1657603314621,MATH 18,A01,083743,Cinel; Cameron Alexander,7,0,30,23
1657603314621,MATH 18,A02,083744,Cinel; Cameron Alexander,17,0,30,13
1657603314621,MATH 18,A03,083745,Cinel; Cameron Alexander,9,0,30,21
1657603314621,MATH 18,B01,083748,Rideout; David Porter,5,0,37,32
1657603314621,MATH 18,B02,083749,Rideout; David Porter,5,0,36,31
1657603314621,MATH 18,B03,083750,Rideout; David Porter,3,0,37,34
1657603314621,MATH 18,B04,083751,Rideout; David Porter,6,0,36,30
1657603314621,MATH 18,B05,093473,Rideout; David Porter,6,0,36,30
1657603314621,MATH 18,B06,093474,Rideout; David Porter,6,0,36,30
1657603320648,MATH 20A,A01,083754,Zheng; Zequn,14,0,40,26
1657603326676,MATH 20B,A01,083756,Briones; Jor-el Thomas Caparas,4,0,36,32
1657603326676,MATH 20B,A02,083757,Briones; Jor-el Thomas Caparas,1,0,36,35
1657603326676,MATH 20B,A03,093475,Briones; Jor-el Thomas Caparas,2,0,36,34
1657603332700,MATH 20C,A01,083760,Briones; Jor-el Thomas Caparas,1,0,35,34
1657603332700,MATH 20C,A02,083761,Briones; Jor-el Thomas Caparas,8,0,35,27
1657603332700,MATH 20C,A03,093476,Briones; Jor-el Thomas Caparas,0,1,36,36
1657603332700,MATH 20C,B01,083762,Bach; Quang Tran,1,0,30,29
1657603338722,MATH 20D,A01,083765,Tran; Brian Kha,5,0,30,25
1657603338722,MATH 20D,A02,083766,Tran; Brian Kha,5,0,30,25
1657603338722,MATH 20D,A03,083767,Tran; Brian Kha,5,0,30,25
1657603344747,MATH 20E,A01,083771,Ganguly; Soumya,9,0,32,23
1657603344747,MATH 20E,A02,083772,Ganguly; Soumya,6,0,32,26
1657603344747,MATH 20E,B01,083773,Ciotti; Benjamin,20,0,35,15
1657603344747,MATH 20E,B02,083774,Ciotti; Benjamin,18,0,35,17
1657603350771,MATH 103A,A01,083777,Greenfeld; Be'Eri,3,0,36,33
1657603350771,MATH 103A,A02,083778,Greenfeld; Be'Eri,5,0,36,31
1657603350771,MATH 103A,A03,093561,Greenfeld; Be'Eri,6,0,36,30
1657603350771,MATH 103A,B01,083779,Greenfeld; Be'Eri,7,0,36,29
1657603350771,MATH 103A,B02,083780,Greenfeld; Be'Eri,4,0,36,32
1657603350771,MATH 103A,B03,093562,Greenfeld; Be'Eri,3,0,36,33
1657603356796,MATH 105,A01,085443,Carter; Anne Toulson,15,0,35,20
1657603356796,MATH 105,A02,093477,Carter; Anne Toulson,20,0,35,15
1657603362819,MATH 109,A01,083213,Ganzberger; Geoffrey Michael,2,0,34,32
1657603362819,MATH 109,A02,083214,Ganzberger; Geoffrey Michael,4,0,34,30
1657603362819,MATH 109,A03,093478,Ganzberger; Geoffrey Michael,2,0,34,32
1657603362819,MATH 109,B01,083215,Ganzberger; Geoffrey Michael,1,0,32,31
1657603362819,MATH 109,B02,083216,Ganzberger; Geoffrey Michael,2,0,32,30
1657603362819,MATH 109,B03,093479,Ganzberger; Geoffrey Michael,8,0,32,24
1657603368848,MATH 142A,A01,083219,Chow; Bennett,7,0,32,25
1657603368848,MATH 142A,A02,083220,Chow; Bennett,10,0,32,22
1657603368848,MATH 142A,A03,093480,Chow; Bennett,9,0,32,23
1657603368848,MATH 142A,B03,093481,Chow; Bennett,8,0,32,24
1657603368848,MATH 142A,B04,093558,Chow; Bennett,13,0,32,19
1657603368848,MATH 142A,B05,093559,Chow; Bennett,6,0,32,26
1657603374871,MATH 193A,A01,083224,Rotar; Vladimir,8,0,34,26
1657603374871,MATH 193A,A02,083225,Rotar; Vladimir,9,0,34,25
1657603374871,MATH 193A,A03,083781,Rotar; Vladimir,5,0,34,29
1657603374871,MATH 193A,A04,083782,Rotar; Vladimir,10,0,34,24
1657603374871,MATH 193A,A05,093482,Rotar; Vladimir,10,0,34,24
1657603380895,MATH 197,001,091859,McAuley; Julian John,9999,0,9999,0
1657603380895,MATH 197,002,095566,Kedlaya; Kiran S.,9997,0,9999,2
1657603380895,MATH 197,003,095567,Xiao; Ming,9999,0,9999,0
1657603380895,MATH 197,004,095571,Perols; Johan Lars,9998,0,9999,1
1657603387948,COGS 9,A01,083615,Shannon; Kyle Michael,9,0,75,66
1657603393975,COGS 11,A01,083617,Boyle; Mary E. T.,23,0,48,25
1657603400001,COGS 13,A01,083071,Bastos; Amalia Pinkusfeld,11,0,71,60
1657603406025,COGS 14A,A01,092681,Semenuks; Arturs,5,1,100,95
1657603412059,COGS 14B,A01,083073,Cheng; Tzu-Han,6,0,63,57
1657603418096,COGS 17,A01,092677,Semenuks; Arturs,6,0,81,75
1657603424121,COGS 100,A01,083619,Allen; Michael Gordon,17,0,70,53
1657603430152,COGS 101A,A01,083621,Davis; Joshua Daniel,9,0,68,59
1657603436182,COGS 101B,A01,091572,Allen; Michael Gordon,12,0,65,53
1657603442205,COGS 101C,A01,083625,Delgado; Tania,17,0,35,18
1657603448233,COGS 107A,A01,083627,Boyle; Mary E. T.,13,0,60,47
1657603454262,COGS 118A,A01,083075,Gupta; Anjum,21,0,76,55
1657603460285,CSE 3,A50,083646,Miranda; Gregory Joseph,24,0,50,26
1657603466309,CSE 8A,A50,083650,Miranda; Gregory Joseph,17,1,56,39
1657603472435,CSE 11,A01,083080,Cao; Yingjun,6,15,40,34
1657603478459,CSE 12,A01,083652,Krause-Levy; Sophia Louisa,28,1,120,92
1657603484488,CSE 15L,A01,083654,Morris; Justin Loren,9,0,50,41
1657603484488,CSE 15L,A02,083655,Morris; Justin Loren,9,0,50,41
1657603490511,CSE 20,A01,083657,Tran; Khoa Dang,39,0,80,41
1657603496538,CSE 21,A01,095574,Bach; Quang Tran,22,0,48,26
1657603502565,CSE 30,A01,083084,Eldon; John,5,0,80,75
1657603502565,CSE 30,B01,095061,Bhaskar; Nishant,9,0,50,41
1657603508596,CSE 100,A01,083659,Cao; Yingjun,5,4,70,65
1657603514620,CSE 134B,A01,083661,Powell; Thomas Allan,22,0,100,78
1657603520650,CSE 140,A01,083663,Gungor; Onat,15,0,85,70
1657603526673,CSE 140L,A01,083088,Eldon; John,21,0,100,79
1657603532694,CSE 175,A01,083665,Kumar; Rakesh,3,0,25,22
1657603538723,CSE 190,A00,092507,Dubnov; Shlomo,8,0,20,12
1657603544749,ECE 45,A01,083139,Congero; Spencer William,6,0,75,69
1657603550774,ECE 65,A50,083695,Saad; Andrew S,12,0,30,18
1657603550774,ECE 65,A51,095125,Saad; Andrew S,24,0,26,2
1657603556798,ECE 109,A01,091882,Touri; Behrouz,19,0,70,51
1657603562825,ECE 180,A00,083140,Abi Samra; Nicholas Camill,1,0,30,29
1657603562825,ECE 180,B00,083141,Abi Samra; Nicholas Camill,0,0,30,30
1657603568855,MATH 10A,A01,083735,Patchell; Gregory David,2,0,30,28
1657603568855,MATH 10A,A02,083736,Patchell; Gregory David,20,0,30,10
1657603568855,MATH 10A,A03,083737,Patchell; Gregory David,16,0,30,14
1657603574879,MATH 10B,A01,083207,Lim; Seonhee,8,0,34,26
1657603574879,MATH 10B,A02,083208,Lim; Seonhee,9,0,35,26
1657603574879,MATH 10B,A03,093472,Lim; Seonhee,7,0,34,27
1657603574879,MATH 10B,B01,083739,Sinha; Shubham,12,0,30,18
1657603580903,MATH 18,A01,083743,Cinel; Cameron Alexander,7,0,30,23
1657603580903,MATH 18,A02,083744,Cinel; Cameron Alexander,17,0,30,13
1657603580903,MATH 18,A03,083745,Cinel; Cameron Alexander,9,0,30,21
1657603580903,MATH 18,B01,083748,Rideout; David Porter,5,0,37,32
1657603580903,MATH 18,B02,083749,Rideout; David Porter,5,0,36,31
1657603580903,MATH 18,B03,083750,Rideout; David Porter,3,0,37,34
1657603580903,MATH 18,B04,083751,Rideout; David Porter,6,0,36,30
1657603580903,MATH 18,B05,093473,Rideout; David Porter,6,0,36,30
1657603580903,MATH 18,B06,093474,Rideout; David Porter,6,0,36,30
1657603586925,MATH 20A,A01,083754,Zheng; Zequn,14,0,40,26
1657603592949,MATH 20B,A01,083756,Briones; Jor-el Thomas Caparas,4,0,36,32
1657603592949,MATH 20B,A02,083757,Briones; Jor-el Thomas Caparas,1,0,36,35
1657603592949,MATH 20B,A03,093475,Briones; Jor-el Thomas Caparas,2,0,36,34
1657603598978,MATH 20C,A01,083760,Briones; Jor-el Thomas Caparas,1,0,35,34
1657603598978,MATH 20C,A02,083761,Briones; Jor-el Thomas Caparas,8,0,35,27
1657603598978,MATH 20C,A03,093476,Briones; Jor-el Thomas Caparas,0,1,36,36
1657603598978,MATH 20C,B01,083762,Bach; Quang Tran,1,0,30,29
1657603605006,MATH 20D,A01,083765,Tran; Brian Kha,5,0,30,25
1657603605006,MATH 20D,A02,083766,Tran; Brian Kha,5,0,30,25
1657603605006,MATH 20D,A03,083767,Tran; Brian Kha,5,0,30,25
1657603611035,MATH 20E,A01,083771,Ganguly; Soumya,9,0,32,23
1657603611035,MATH 20E,A02,083772,Ganguly; Soumya,6,0,32,26
1657603611035,MATH 20E,B01,083773,Ciotti; Benjamin,20,0,35,15
1657603611035,MATH 20E,B02,083774,Ciotti; Benjamin,18,0,35,17
1657603617060,MATH 103A,A01,083777,Greenfeld; Be'Eri,3,0,36,33
1657603617060,MATH 103A,A02,083778,Greenfeld; Be'Eri,5,0,36,31
1657603617060,MATH 103A,A03,093561,Greenfeld; Be'Eri,6,0,36,30
1657603617060,MATH 103A,B01,083779,Greenfeld; Be'Eri,7,0,36,29
1657603617060,MATH 103A,B02,083780,Greenfeld; Be'Eri,4,0,36,32
1657603617060,MATH 103A,B03,093562,Greenfeld; Be'Eri,3,0,36,33
1657603623083,MATH 105,A01,085443,Carter; Anne Toulson,15,0,35,20
1657603623083,MATH 105,A02,093477,Carter; Anne Toulson,20,0,35,15
1657603629107,MATH 109,A01,083213,Ganzberger; Geoffrey Michael,2,0,34,32
1657603629107,MATH 109,A02,083214,Ganzberger; Geoffrey Michael,4,0,34,30
1657603629107,MATH 109,A03,093478,Ganzberger; Geoffrey Michael,2,0,34,32
1657603629107,MATH 109,B01,083215,Ganzberger; Geoffrey Michael,1,0,32,31
1657603629107,MATH 109,B02,083216,Ganzberger; Geoffrey Michael,2,0,32,30
1657603629107,MATH 109,B03,093479,Ganzberger; Geoffrey Michael,8,0,32,24
1657603635135,MATH 142A,A01,083219,Chow; Bennett,7,0,32,25
1657603635135,MATH 142A,A02,083220,Chow; Bennett,10,0,32,22
1657603635135,MATH 142A,A03,093480,Chow; Bennett,9,0,32,23
1657603635135,MATH 142A,B03,093481,Chow; Bennett,8,0,32,24
1657603635135,MATH 142A,B04,093558,Chow; Bennett,13,0,32,19
1657603635135,MATH 142A,B05,093559,Chow; Bennett,6,0,32,26
1657603641161,MATH 193A,A01,083224,Rotar; Vladimir,8,0,34,26
1657603641161,MATH 193A,A02,083225,Rotar; Vladimir,9,0,34,25
1657603641161,MATH 193A,A03,083781,Rotar; Vladimir,5,0,34,29
1657603641161,MATH 193A,A04,083782,Rotar; Vladimir,10,0,34,24
1657603641161,MATH 193A,A05,093482,Rotar; Vladimir,10,0,34,24
1657603647187,MATH 197,001,091859,McAuley; Julian John,9999,0,9999,0
1657603647187,MATH 197,002,095566,Kedlaya; Kiran S.,9997,0,9999,2
1657603647187,MATH 197,003,095567,Xiao; Ming,9999,0,9999,0
1657603647187,MATH 197,004,095571,Perols; Johan Lars,9998,0,9999,1
1657603654238,COGS 9,A01,083615,Shannon; Kyle Michael,9,0,75,66
1657603660263,COGS 11,A01,083617,Boyle; Mary E. T.,23,0,48,25
1657603666287,COGS 13,A01,083071,Bastos; Amalia Pinkusfeld,11,0,71,60
1657603672314,COGS 14A,A01,092681,Semenuks; Arturs,5,1,100,95
1657603678342,COGS 14B,A01,083073,Cheng; Tzu-Han,6,0,63,57
1657603684378,COGS 17,A01,092677,Semenuks; Arturs,6,0,81,75
1657603690405,COGS 100,A01,083619,Allen; Michael Gordon,17,0,70,53
1657603696431,COGS 101A,A01,083621,Davis; Joshua Daniel,9,0,68,59
1657603702453,COGS 101B,A01,091572,Allen; Michael Gordon,12,0,65,53
1657603708475,COGS 101C,A01,083625,Delgado; Tania,17,0,35,18
1657603714497,COGS 107A,A01,083627,Boyle; Mary E. T.,13,0,60,47
1657603720520,COGS 118A,A01,083075,Gupta; Anjum,21,0,76,55
1657603726552,CSE 3,A50,083646,Miranda; Gregory Joseph,24,0,50,26
1657603732579,CSE 8A,A50,083650,Miranda; Gregory Joseph,17,1,56,39
1657603738601,CSE 11,A01,083080,Cao; Yingjun,6,15,40,34
1657603744625,CSE 12,A01,083652,Krause-Levy; Sophia Louisa,28,1,120,92
1657603750650,CSE 15L,A01,083654,Morris; Justin Loren,9,0,50,41
1657603750650,CSE 15L,A02,083655,Morris; Justin Loren,9,0,50,41
1657603756676,CSE 20,A01,083657,Tran; Khoa Dang,39,0,80,41
1657603762704,CSE 21,A01,095574,Bach; Quang Tran,22,0,48,26
1657603768729,CSE 30,A01,083084,Eldon; John,5,0,80,75
1657603768729,CSE 30,B01,095061,Bhaskar; Nishant,9,0,50,41
1657603774750,CSE 100,A01,083659,Cao; Yingjun,5,4,70,65
1657603780780,CSE 134B,A01,083661,Powell; Thomas Allan,22,0,100,78
1657603786806,CSE 140,A01,083663,Gungor; Onat,15,0,85,70
1657603792833,CSE 140L,A01,083088,Eldon; John,21,0,100,79
1657603798857,CSE 175,A01,083665,Kumar; Rakesh,3,0,25,22
1657603804884,CSE 190,A00,092507,Dubnov; Shlomo,8,0,20,12
1657603810908,ECE 45,A01,083139,Congero; Spencer William,6,0,75,69
1657603816933,ECE 65,A50,083695,Saad; Andrew S,12,0,30,18
1657603816933,ECE 65,A51,095125,Saad; Andrew S,24,0,26,2
1657603822966,ECE 109,A01,091882,Touri; Behrouz,19,0,70,51
1657603828988,ECE 180,A00,083140,Abi Samra; Nicholas Camill,1,0,30,29
1657603828988,ECE 180,B00,083141,Abi Samra; Nicholas Camill,0,0,30,30
1657603835012,MATH 10A,A01,083735,Patchell; Gregory David,2,0,30,28
1657603835012,MATH 10A,A02,083736,Patchell; Gregory David,20,0,30,10
1657603835012,MATH 10A,A03,083737,Patchell; Gregory David,16,0,30,14
1657603841035,MATH 10B,A01,083207,Lim; Seonhee,8,0,34,26
1657603841035,MATH 10B,A02,083208,Lim; Seonhee,9,0,35,26
1657603841035,MATH 10B,A03,093472,Lim; Seonhee,7,0,34,27
1657603841035,MATH 10B,B01,083739,Sinha; Shubham,12,0,30,18
1657603847064,MATH 18,A01,083743,Cinel; Cameron Alexander,7,0,30,23
1657603847064,MATH 18,A02,083744,Cinel; Cameron Alexander,17,0,30,13
1657603847064,MATH 18,A03,083745,Cinel; Cameron Alexander,9,0,30,21
1657603847064,MATH 18,B01,083748,Rideout; David Porter,5,0,37,32
1657603847064,MATH 18,B02,083749,Rideout; David Porter,5,0,36,31
1657603847064,MATH 18,B03,083750,Rideout; David Porter,3,0,37,34
1657603847064,MATH 18,B04,083751,Rideout; David Porter,6,0,36,30
1657603847064,MATH 18,B05,093473,Rideout; David Porter,6,0,36,30
1657603847064,MATH 18,B06,093474,Rideout; David Porter,6,0,36,30
1657603853091,MATH 20A,A01,083754,Zheng; Zequn,14,0,40,26
1657603859113,MATH 20B,A01,083756,Briones; Jor-el Thomas Caparas,4,0,36,32
1657603859113,MATH 20B,A02,083757,Briones; Jor-el Thomas Caparas,1,0,36,35
1657603859113,MATH 20B,A03,093475,Briones; Jor-el Thomas Caparas,2,0,36,34
1657603865147,MATH 20C,A01,083760,Briones; Jor-el Thomas Caparas,1,0,35,34
1657603865147,MATH 20C,A02,083761,Briones; Jor-el Thomas Caparas,8,0,35,27
1657603865147,MATH 20C,A03,093476,Briones; Jor-el Thomas Caparas,0,1,36,36
1657603865147,MATH 20C,B01,083762,Bach; Quang Tran,1,0,30,29
1657603871170,MATH 20D,A01,083765,Tran; Brian Kha,5,0,30,25
1657603871170,MATH 20D,A02,083766,Tran; Brian Kha,5,0,30,25
1657603871170,MATH 20D,A03,083767,Tran; Brian Kha,5,0,30,25
1657603877198,MATH 20E,A01,083771,Ganguly; Soumya,9,0,32,23
1657603877198,MATH 20E,A02,083772,Ganguly; Soumya,6,0,32,26
1657603877198,MATH 20E,B01,083773,Ciotti; Benjamin,20,0,35,15
1657603877198,MATH 20E,B02,083774,Ciotti; Benjamin,18,0,35,17
1657603883221,MATH 103A,A01,083777,Greenfeld; Be'Eri,3,0,36,33
1657603883221,MATH 103A,A02,083778,Greenfeld; Be'Eri,5,0,36,31
1657603883221,MATH 103A,A03,093561,Greenfeld; Be'Eri,6,0,36,30
1657603883221,MATH 103A,B01,083779,Greenfeld; Be'Eri,7,0,36,29
1657603883221,MATH 103A,B02,083780,Greenfeld; Be'Eri,4,0,36,32
1657603883221,MATH 103A,B03,093562,Greenfeld; Be'Eri,3,0,36,33
1657603889243,MATH 105,A01,085443,Carter; Anne Toulson,15,0,35,20
1657603889243,MATH 105,A02,093477,Carter; Anne Toulson,20,0,35,15
1657603895271,MATH 109,A01,083213,Ganzberger; Geoffrey Michael,2,0,34,32
1657603895271,MATH 109,A02,083214,Ganzberger; Geoffrey Michael,4,0,34,30
1657603895271,MATH 109,A03,093478,Ganzberger; Geoffrey Michael,2,0,34,32
1657603895271,MATH 109,B01,083215,Ganzberger; Geoffrey Michael,1,0,32,31
1657603895271,MATH 109,B02,083216,Ganzberger; Geoffrey Michael,2,0,32,30
1657603895271,MATH 109,B03,093479,Ganzberger; Geoffrey Michael,8,0,32,24
1657603901302,MATH 142A,A01,083219,Chow; Bennett,7,0,32,25
1657603901302,MATH 142A,A02,083220,Chow; Bennett,10,0,32,22
1657603901302,MATH 142A,A03,093480,Chow; Bennett,9,0,32,23
1657603901302,MATH 142A,B03,093481,Chow; Bennett,8,0,32,24
1657603901302,MATH 142A,B04,093558,Chow; Bennett,13,0,32,19
1657603901302,MATH 142A,B05,093559,Chow; Bennett,6,0,32,26
1657603907332,MATH 193A,A01,083224,Rotar; Vladimir,8,0,34,26
1657603907332,MATH 193A,A02,083225,Rotar; Vladimir,9,0,34,25
1657603907332,MATH 193A,A03,083781,Rotar; Vladimir,5,0,34,29
1657603907332,MATH 193A,A04,083782,Rotar; Vladimir,10,0,34,24
1657603907332,MATH 193A,A05,093482,Rotar; Vladimir,10,0,34,24
1657603913354,MATH 197,001,091859,McAuley; Julian John,9999,0,9999,0
1657603913354,MATH 197,002,095566,Kedlaya; Kiran S.,9997,0,9999,2
1657603913354,MATH 197,003,095567,Xiao; Ming,9999,0,9999,0
1657603913354,MATH 197,004,095571,Perols; Johan Lars,9998,0,9999,1
1657603920421,COGS 9,A01,083615,Shannon; Kyle Michael,9,0,75,66
1657603926442,COGS 11,A01,083617,Boyle; Mary E. T.,23,0,48,25
1657603932465,COGS 13,A01,083071,Bastos; Amalia Pinkusfeld,11,0,71,60
1657603938492,COGS 14A,A01,092681,Semenuks; Arturs,5,1,100,95
1657603944513,COGS 14B,A01,083073,Cheng; Tzu-Han,6,0,63,57
1657603950538,COGS 17,A01,092677,Semenuks; Arturs,6,0,81,75
1657603956560,COGS 100,A01,083619,Allen; Michael Gordon,17,0,70,53
1657603962581,COGS 101A,A01,083621,Davis; Joshua Daniel,9,0,68,59
1657603968606,COGS 101B,A01,091572,Allen; Michael Gordon,12,0,65,53
1657603974639,COGS 101C,A01,083625,Delgado; Tania,17,0,35,18
1657603980663,COGS 107A,A01,083627,Boyle; Mary E. T.,13,0,60,47
1657603986689,COGS 118A,A01,083075,Gupta; Anjum,21,0,76,55
1657603992711,CSE 3,A50,083646,Miranda; Gregory Joseph,24,0,50,26
1657603998738,CSE 8A,A50,083650,Miranda; Gregory Joseph,17,1,56,39
1657604004759,CSE 11,A01,083080,Cao; Yingjun,6,15,40,34
1657604010787,CSE 12,A01,083652,Krause-Levy; Sophia Louisa,28,1,120,92
1657604016816,CSE 15L,A01,083654,Morris; Justin Loren,9,0,50,41
1657604016816,CSE 15L,A02,083655,Morris; Justin Loren,9,0,50,41
1657604022843,CSE 20,A01,083657,Tran; Khoa Dang,39,0,80,41
1657604028865,CSE 21,A01,095574,Bach; Quang Tran,22,0,48,26
1657604034892,CSE 30,A01,083084,Eldon; John,5,0,80,75
1657604034892,CSE 30,B01,095061,Bhaskar; Nishant,9,0,50,41
1657604040917,CSE 100,A01,083659,Cao; Yingjun,5,4,70,65
1657604046952,CSE 134B,A01,083661,Powell; Thomas Allan,22,0,100,78
1657604052977,CSE 140,A01,083663,Gungor; Onat,15,0,85,70
1657604059005,CSE 140L,A01,083088,Eldon; John,21,0,100,79
1657604065034,CSE 175,A01,083665,Kumar; Rakesh,3,0,25,22
1657604071145,CSE 190,A00,092507,Dubnov; Shlomo,8,0,20,12
1657604077175,ECE 45,A01,083139,Congero; Spencer William,6,0,75,69
1657604083199,ECE 65,A50,083695,Saad; Andrew S,12,0,30,18
1657604083199,ECE 65,A51,095125,Saad; Andrew S,24,0,26,2
1657604089225,ECE 109,A01,091882,Touri; Behrouz,19,0,70,51
1657604095248,ECE 180,A00,083140,Abi Samra; Nicholas Camill,1,0,30,29
1657604095248,ECE 180,B00,083141,Abi Samra; Nicholas Camill,0,0,30,30
1657604101272,MATH 10A,A01,083735,Patchell; Gregory David,2,0,30,28
1657604101272,MATH 10A,A02,083736,Patchell; Gregory David,20,0,30,10
1657604101272,MATH 10A,A03,083737,Patchell; Gregory David,16,0,30,14
1657604107294,MATH 10B,A01,083207,Lim; Seonhee,8,0,34,26
1657604107294,MATH 10B,A02,083208,Lim; Seonhee,9,0,35,26
1657604107294,MATH 10B,A03,093472,Lim; Seonhee,7,0,34,27
1657604107294,MATH 10B,B01,083739,Sinha; Shubham,12,0,30,18
1657604113316,MATH 18,A01,083743,Cinel; Cameron Alexander,7,0,30,23
1657604113316,MATH 18,A02,083744,Cinel; Cameron Alexander,17,0,30,13
1657604113316,MATH 18,A03,083745,Cinel; Cameron Alexander,9,0,30,21
1657604113316,MATH 18,B01,083748,Rideout; David Porter,5,0,37,32
1657604113316,MATH 18,B02,083749,Rideout; David Porter,5,0,36,31
1657604113316,MATH 18,B03,083750,Rideout; David Porter,3,0,37,34
1657604113316,MATH 18,B04,083751,Rideout; David Porter,6,0,36,30
1657604113316,MATH 18,B05,093473,Rideout; David Porter,6,0,36,30
1657604113316,MATH 18,B06,093474,Rideout; David Porter,6,0,36,30
1657604119342,MATH 20A,A01,083754,Zheng; Zequn,14,0,40,26
1657604125381,MATH 20B,A01,083756,Briones; Jor-el Thomas Caparas,4,0,36,32
1657604125381,MATH 20B,A02,083757,Briones; Jor-el Thomas Caparas,1,0,36,35
1657604125381,MATH 20B,A03,093475,Briones; Jor-el Thomas Caparas,2,0,36,34
1657604131404,MATH 20C,A01,083760,Briones; Jor-el Thomas Caparas,1,0,35,34
1657604131404,MATH 20C,A02,083761,Briones; Jor-el Thomas Caparas,8,0,35,27
1657604131404,MATH 20C,A03,093476,Briones; Jor-el Thomas Caparas,0,1,36,36
1657604131404,MATH 20C,B01,083762,Bach; Quang Tran,1,0,30,29
1657604137428,MATH 20D,A01,083765,Tran; Brian Kha,5,0,30,25
1657604137428,MATH 20D,A02,083766,Tran; Brian Kha,5,0,30,25
1657604137428,MATH 20D,A03,083767,Tran; Brian Kha,5,0,30,25
1657604143457,MATH 20E,A01,083771,Ganguly; Soumya,9,0,32,23
1657604143457,MATH 20E,A02,083772,Ganguly; Soumya,6,0,32,26
1657604143457,MATH 20E,B01,083773,Ciotti; Benjamin,20,0,35,15
1657604143457,MATH 20E,B02,083774,Ciotti; Benjamin,18,0,35,17
1657604149482,MATH 103A,A01,083777,Greenfeld; Be'Eri,3,0,36,33
1657604149482,MATH 103A,A02,083778,Greenfeld; Be'Eri,5,0,36,31
1657604149482,MATH 103A,A03,093561,Greenfeld; Be'Eri,6,0,36,30
1657604149482,MATH 103A,B01,083779,Greenfeld; Be'Eri,7,0,36,29
1657604149482,MATH 103A,B02,083780,Greenfeld; Be'Eri,4,0,36,32
1657604149482,MATH 103A,B03,093562,Greenfeld; Be'Eri,3,0,36,33
1657604155507,MATH 105,A01,085443,Carter; Anne Toulson,15,0,35,20
1657604155507,MATH 105,A02,093477,Carter; Anne Toulson,20,0,35,15
1657604161530,MATH 109,A01,083213,Ganzberger; Geoffrey Michael,2,0,34,32
1657604161530,MATH 109,A02,083214,Ganzberger; Geoffrey Michael,4,0,34,30
1657604161530,MATH 109,A03,093478,Ganzberger; Geoffrey Michael,2,0,34,32
1657604161530,MATH 109,B01,083215,Ganzberger; Geoffrey Michael,1,0,32,31
1657604161530,MATH 109,B02,083216,Ganzberger; Geoffrey Michael,2,0,32,30
1657604161530,MATH 109,B03,093479,Ganzberger; Geoffrey Michael,8,0,32,24
1657604167561,MATH 142A,A01,083219,Chow; Bennett,7,0,32,25
1657604167561,MATH 142A,A02,083220,Chow; Bennett,10,0,32,22
1657604167561,MATH 142A,A03,093480,Chow; Bennett,9,0,32,23
1657604167561,MATH 142A,B03,093481,Chow; Bennett,8,0,32,24
1657604167561,MATH 142A,B04,093558,Chow; Bennett,13,0,32,19
1657604167561,MATH 142A,B05,093559,Chow; Bennett,6,0,32,26
1657604173583,MATH 193A,A01,083224,Rotar; Vladimir,8,0,34,26
1657604173583,MATH 193A,A02,083225,Rotar; Vladimir,9,0,34,25
1657604173583,MATH 193A,A03,083781,Rotar; Vladimir,5,0,34,29
1657604173583,MATH 193A,A04,083782,Rotar; Vladimir,10,0,34,24
1657604173583,MATH 193A,A05,093482,Rotar; Vladimir,10,0,34,24
1657604179605,MATH 197,001,091859,McAuley; Julian John,9999,0,9999,0
1657604179605,MATH 197,002,095566,Kedlaya; Kiran S.,9997,0,9999,2
1657604179605,MATH 197,003,095567,Xiao; Ming,9999,0,9999,0
1657604179605,MATH 197,004,095571,Perols; Johan Lars,9998,0,9999,1
1657604186658,COGS 9,A01,083615,Shannon; Kyle Michael,9,0,75,66
1657604192680,COGS 11,A01,083617,Boyle; Mary E. T.,23,0,48,25
1657604198707,COGS 13,A01,083071,Bastos; Amalia Pinkusfeld,11,0,71,60
1657604204754,COGS 14A,A01,092681,Semenuks; Arturs,5,1,100,95
1657604210777,COGS 14B,A01,083073,Cheng; Tzu-Han,6,0,63,57
1657604216800,COGS 17,A01,092677,Semenuks; Arturs,6,0,81,75
1657604222833,COGS 100,A01,083619,Allen; Michael Gordon,17,0,70,53
1657604228855,COGS 101A,A01,083621,Davis; Joshua Daniel,9,0,68,59
1657604234880,COGS 101B,A01,091572,Allen; Michael Gordon,12,0,65,53
1657604240904,COGS 101C,A01,083625,Delgado; Tania,17,0,35,18
1657604246942,COGS 107A,A01,083627,Boyle; Mary E. T.,13,0,60,47
1657604252966,COGS 118A,A01,083075,Gupta; Anjum,21,0,76,55
1657604258989,CSE 3,A50,083646,Miranda; Gregory Joseph,24,0,50,26
1657604265012,CSE 8A,A50,083650,Miranda; Gregory Joseph,17,1,56,39
1657604271035,CSE 11,A01,083080,Cao; Yingjun,6,15,40,34
1657604277060,CSE 12,A01,083652,Krause-Levy; Sophia Louisa,28,1,120,92
1657604283083,CSE 15L,A01,083654,Morris; Justin Loren,9,0,50,41
1657604283083,CSE 15L,A02,083655,Morris; Justin Loren,9,0,50,41
1657604289108,CSE 20,A01,083657,Tran; Khoa Dang,39,0,80,41
1657604295131,CSE 21,A01,095574,Bach; Quang Tran,22,0,48,26
1657604301156,CSE 30,A01,083084,Eldon; John,5,0,80,75
1657604301156,CSE 30,B01,095061,Bhaskar; Nishant,9,0,50,41
1657604307179,CSE 100,A01,083659,Cao; Yingjun,5,4,70,65
1657604313203,CSE 134B,A01,083661,Powell; Thomas Allan,22,0,100,78
1657604319232,CSE 140,A01,083663,Gungor; Onat,15,0,85,70
1657604325264,CSE 140L,A01,083088,Eldon; John,21,0,100,79
1657604331286,CSE 175,A01,083665,Kumar; Rakesh,3,0,25,22
1657604337308,CSE 190,A00,092507,Dubnov; Shlomo,8,0,20,12
1657604343333,ECE 45,A01,083139,Congero; Spencer William,6,0,75,69
1657604349356,ECE 65,A50,083695,Saad; Andrew S,12,0,30,18
1657604349356,ECE 65,A51,095125,Saad; Andrew S,24,0,26,2
1657604355379,ECE 109,A01,091882,Touri; Behrouz,19,0,70,51
1657604361410,ECE 180,A00,083140,Abi Samra; Nicholas Camill,1,0,30,29
1657604361410,ECE 180,B00,083141,Abi Samra; Nicholas Camill,0,0,30,30
1657604367468,MATH 10A,A01,083735,Patchell; Gregory David,2,0,30,28
1657604367468,MATH 10A,A02,083736,Patchell; Gregory David,20,0,30,10
1657604367468,MATH 10A,A03,083737,Patchell; Gregory David,16,0,30,14
1657604373500,MATH 10B,A01,083207,Lim; Seonhee,8,0,34,26
1657604373500,MATH 10B,A02,083208,Lim; Seonhee,9,0,35,26
1657604373500,MATH 10B,A03,093472,Lim; Seonhee,7,0,34,27
1657604373500,MATH 10B,B01,083739,Sinha; Shubham,12,0,30,18
1657604379530,MATH 18,A01,083743,Cinel; Cameron Alexander,7,0,30,23
1657604379530,MATH 18,A02,083744,Cinel; Cameron Alexander,17,0,30,13
1657604379530,MATH 18,A03,083745,Cinel; Cameron Alexander,9,0,30,21
1657604379530,MATH 18,B01,083748,Rideout; David Porter,5,0,37,32
1657604379530,MATH 18,B02,083749,Rideout; David Porter,5,0,36,31
1657604379530,MATH 18,B03,083750,Rideout; David Porter,3,0,37,34
1657604379530,MATH 18,B04,083751,Rideout; David Porter,6,0,36,30
1657604379530,MATH 18,B05,093473,Rideout; David Porter,6,0,36,30
1657604379530,MATH 18,B06,093474,Rideout; David Porter,6,0,36,30
1657604385555,MATH 20A,A01,083754,Zheng; Zequn,14,0,40,26
1657604391579,MATH 20B,A01,083756,Briones; Jor-el Thomas Caparas,4,0,36,32
1657604391579,MATH 20B,A02,083757,Briones; Jor-el Thomas Caparas,1,0,36,35
1657604391579,MATH 20B,A03,093475,Briones; Jor-el Thomas Caparas,2,0,36,34
1657604397615,MATH 20C,A01,083760,Briones; Jor-el Thomas Caparas,1,0,35,34
1657604397615,MATH 20C,A02,083761,Briones; Jor-el Thomas Caparas,8,0,35,27
1657604397615,MATH 20C,A03,093476,Briones; Jor-el Thomas Caparas,0,1,36,36
1657604397615,MATH 20C,B01,083762,Bach; Quang Tran,1,0,30,29
1657604403637,MATH 20D,A01,083765,Tran; Brian Kha,5,0,30,25
1657604403637,MATH 20D,A02,083766,Tran; Brian Kha,5,0,30,25
1657604403637,MATH 20D,A03,083767,Tran; Brian Kha,5,0,30,25
1657604409660,MATH 20E,A01,083771,Ganguly; Soumya,9,0,32,23
1657604409660,MATH 20E,A02,083772,Ganguly; Soumya,6,0,32,26
1657604409660,MATH 20E,B01,083773,Ciotti; Benjamin,20,0,35,15
1657604409660,MATH 20E,B02,083774,Ciotti; Benjamin,18,0,35,17
1657604415685,MATH 103A,A01,083777,Greenfeld; Be'Eri,3,0,36,33
1657604415685,MATH 103A,A02,083778,Greenfeld; Be'Eri,5,0,36,31
1657604415685,MATH 103A,A03,093561,Greenfeld; Be'Eri,6,0,36,30
1657604415685,MATH 103A,B01,083779,Greenfeld; Be'Eri,7,0,36,29
1657604415685,MATH 103A,B02,083780,Greenfeld; Be'Eri,4,0,36,32
1657604415685,MATH 103A,B03,093562,Greenfeld; Be'Eri,3,0,36,33
1657604421711,MATH 105,A01,085443,Carter; Anne Toulson,15,0,35,20
1657604421711,MATH 105,A02,093477,Carter; Anne Toulson,20,0,35,15
1657604427734,MATH 109,A01,083213,Ganzberger; Geoffrey Michael,2,0,34,32
1657604427734,MATH 109,A02,083214,Ganzberger; Geoffrey Michael,4,0,34,30
1657604427734,MATH 109,A03,093478,Ganzberger; Geoffrey Michael,2,0,34,32
1657604427734,MATH 109,B01,083215,Ganzberger; Geoffrey Michael,1,0,32,31
1657604427734,MATH 109,B02,083216,Ganzberger; Geoffrey Michael,2,0,32,30
1657604427734,MATH 109,B03,093479,Ganzberger; Geoffrey Michael,8,0,32,24
1657604433756,MATH 142A,A01,083219,Chow; Bennett,7,0,32,25
1657604433756,MATH 142A,A02,083220,Chow; Bennett,10,0,32,22
1657604433756,MATH 142A,A03,093480,Chow; Bennett,9,0,32,23
1657604433756,MATH 142A,B03,093481,Chow; Bennett,8,0,32,24
1657604433756,MATH 142A,B04,093558,Chow; Bennett,13,0,32,19
1657604433756,MATH 142A,B05,093559,Chow; Bennett,6,0,32,26
1657604439779,MATH 193A,A01,083224,Rotar; Vladimir,8,0,34,26
1657604439779,MATH 193A,A02,083225,Rotar; Vladimir,9,0,34,25
1657604439779,MATH 193A,A03,083781,Rotar; Vladimir,5,0,34,29
1657604439779,MATH 193A,A04,083782,Rotar; Vladimir,10,0,34,24
1657604439779,MATH 193A,A05,093482,Rotar; Vladimir,10,0,34,24
1657604445806,MATH 197,001,091859,McAuley; Julian John,9999,0,9999,0
1657604445806,MATH 197,002,095566,Kedlaya; Kiran S.,9997,0,9999,2
1657604445806,MATH 197,003,095567,Xiao; Ming,9999,0,9999,0
1657604445806,MATH 197,004,095571,Perols; Johan Lars,9998,0,9999,1
1657604452858,COGS 9,A01,083615,Shannon; Kyle Michael,9,0,75,66
1657604458880,COGS 11,A01,083617,Boyle; Mary E. T.,23,0,48,25
1657604464917,COGS 13,A01,083071,Bastos; Amalia Pinkusfeld,11,0,71,60
1657604470943,COGS 14A,A01,092681,Semenuks; Arturs,5,1,100,95
1657604476970,COGS 14B,A01,083073,Cheng; Tzu-Han,6,0,63,57
1657604483011,COGS 17,A01,092677,Semenuks; Arturs,6,0,81,75
1657604489037,COGS 100,A01,083619,Allen; Michael Gordon,17,0,70,53
1657604495059,COGS 101A,A01,083621,Davis; Joshua Daniel,9,0,68,59
1657604501082,COGS 101B,A01,091572,Allen; Michael Gordon,12,0,65,53
1657604507109,COGS 101C,A01,083625,Delgado; Tania,17,0,35,18
1657604513137,COGS 107A,A01,083627,Boyle; Mary E. T.,13,0,60,47
1657604519161,COGS 118A,A01,083075,Gupta; Anjum,21,0,76,55
1657604525184,CSE 3,A50,083646,Miranda; Gregory Joseph,24,0,50,26
1657604531211,CSE 8A,A50,083650,Miranda; Gregory Joseph,17,1,56,39
1657604537238,CSE 11,A01,083080,Cao; Yingjun,6,15,40,34
1657604543265,CSE 12,A01,083652,Krause-Levy; Sophia Louisa,28,1,120,92
1657604549297,CSE 15L,A01,083654,Morris; Justin Loren,9,0,50,41
1657604549297,CSE 15L,A02,083655,Morris; Justin Loren,9,0,50,41
1657604555324,CSE 20,A01,083657,Tran; Khoa Dang,39,0,80,41
1657604561348,CSE 21,A01,095574,Bach; Quang Tran,22,0,48,26
1657604567374,CSE 30,A01,083084,Eldon; John,5,0,80,75
1657604567374,CSE 30,B01,095061,Bhaskar; Nishant,9,0,50,41
1657604573397,CSE 100,A01,083659,Cao; Yingjun,5,4,70,65
1657604579420,CSE 134B,A01,083661,Powell; Thomas Allan,22,0,100,78
1657604585444,CSE 140,A01,083663,Gungor; Onat,15,0,85,70
1657604591469,CSE 140L,A01,083088,Eldon; John,21,0,100,79
1657604597494,CSE 175,A01,083665,Kumar; Rakesh,3,0,25,22
1657604603526,CSE 190,A00,092507,Dubnov; Shlomo,8,0,20,12
1657604609548,ECE 45,A01,083139,Congero; Spencer William,6,0,75,69
1657604615572,ECE 65,A50,083695,Saad; Andrew S,12,0,30,18
1657604615572,ECE 65,A51,095125,Saad; Andrew S,24,0,26,2
1657604621598,ECE 109,A01,091882,Touri; Behrouz,19,0,70,51
1657604627622,ECE 180,A00,083140,Abi Samra; Nicholas Camill,1,0,30,29
1657604627622,ECE 180,B00,083141,Abi Samra; Nicholas Camill,0,0,30,30
1657604633649,MATH 10A,A01,083735,Patchell; Gregory David,2,0,30,28
1657604633649,MATH 10A,A02,083736,Patchell; Gregory David,20,0,30,10
1657604633649,MATH 10A,A03,083737,Patchell; Gregory David,16,0,30,14
1657604639673,MATH 10B,A01,083207,Lim; Seonhee,8,0,34,26
1657604639673,MATH 10B,A02,083208,Lim; Seonhee,9,0,35,26
1657604639673,MATH 10B,A03,093472,Lim; Seonhee,7,0,34,27
1657604639673,MATH 10B,B01,083739,Sinha; Shubham,12,0,30,18
1657604645704,MATH 18,A01,083743,Cinel; Cameron Alexander,7,0,30,23
1657604645704,MATH 18,A02,083744,Cinel; Cameron Alexander,17,0,30,13
1657604645704,MATH 18,A03,083745,Cinel; Cameron Alexander,9,0,30,21
1657604645704,MATH 18,B01,083748,Rideout; David Porter,5,0,37,32
1657604645704,MATH 18,B02,083749,Rideout; David Porter,5,0,36,31
1657604645704,MATH 18,B03,083750,Rideout; David Porter,3,0,37,34
1657604645704,MATH 18,B04,083751,Rideout; David Porter,6,0,36,30
1657604645704,MATH 18,B05,093473,Rideout; David Porter,6,0,36,30
1657604645704,MATH 18,B06,093474,Rideout; David Porter,6,0,36,30
1657604651727,MATH 20A,A01,083754,Zheng; Zequn,14,0,40,26
1657604657751,MATH 20B,A01,083756,Briones; Jor-el Thomas Caparas,4,0,36,32
1657604657751,MATH 20B,A02,083757,Briones; Jor-el Thomas Caparas,1,0,36,35
1657604657751,MATH 20B,A03,093475,Briones; Jor-el Thomas Caparas,2,0,36,34
1657604663775,MATH 20C,A01,083760,Briones; Jor-el Thomas Caparas,1,0,35,34
1657604663775,MATH 20C,A02,083761,Briones; Jor-el Thomas Caparas,8,0,35,27
1657604663775,MATH 20C,A03,093476,Briones; Jor-el Thomas Caparas,0,1,36,36
1657604663775,MATH 20C,B01,083762,Bach; Quang Tran,1,0,30,29
1657604669923,MATH 20D,A01,083765,Tran; Brian Kha,5,0,30,25
1657604669923,MATH 20D,A02,083766,Tran; Brian Kha,5,0,30,25
1657604669923,MATH 20D,A03,083767,Tran; Brian Kha,5,0,30,25
1657604675956,MATH 20E,A01,083771,Ganguly; Soumya,9,0,32,23
1657604675956,MATH 20E,A02,083772,Ganguly; Soumya,6,0,32,26
1657604675956,MATH 20E,B01,083773,Ciotti; Benjamin,20,0,35,15
1657604675956,MATH 20E,B02,083774,Ciotti; Benjamin,18,0,35,17
1657604681984,MATH 103A,A01,083777,Greenfeld; Be'Eri,3,0,36,33
1657604681984,MATH 103A,A02,083778,Greenfeld; Be'Eri,5,0,36,31
1657604681984,MATH 103A,A03,093561,Greenfeld; Be'Eri,6,0,36,30
1657604681984,MATH 103A,B01,083779,Greenfeld; Be'Eri,7,0,36,29
1657604681984,MATH 103A,B02,083780,Greenfeld; Be'Eri,4,0,36,32
1657604681984,MATH 103A,B03,093562,Greenfeld; Be'Eri,3,0,36,33
1657604688009,MATH 105,A01,085443,Carter; Anne Toulson,15,0,35,20
1657604688009,MATH 105,A02,093477,Carter; Anne Toulson,20,0,35,15
1657604694036,MATH 109,A01,083213,Ganzberger; Geoffrey Michael,2,0,34,32
1657604694036,MATH 109,A02,083214,Ganzberger; Geoffrey Michael,4,0,34,30
1657604694036,MATH 109,A03,093478,Ganzberger; Geoffrey Michael,2,0,34,32
1657604694036,MATH 109,B01,083215,Ganzberger; Geoffrey Michael,1,0,32,31
1657604694036,MATH 109,B02,083216,Ganzberger; Geoffrey Michael,2,0,32,30
1657604694036,MATH 109,B03,093479,Ganzberger; Geoffrey Michael,8,0,32,24
1657604700060,MATH 142A,A01,083219,Chow; Bennett,7,0,32,25
1657604700060,MATH 142A,A02,083220,Chow; Bennett,10,0,32,22
1657604700060,MATH 142A,A03,093480,Chow; Bennett,9,0,32,23
1657604700060,MATH 142A,B03,093481,Chow; Bennett,8,0,32,24
1657604700060,MATH 142A,B04,093558,Chow; Bennett,13,0,32,19
1657604700060,MATH 142A,B05,093559,Chow; Bennett,6,0,32,26
1657604706084,MATH 193A,A01,083224,Rotar; Vladimir,8,0,34,26
1657604706084,MATH 193A,A02,083225,Rotar; Vladimir,9,0,34,25
1657604706084,MATH 193A,A03,083781,Rotar; Vladimir,5,0,34,29
1657604706084,MATH 193A,A04,083782,Rotar; Vladimir,10,0,34,24
1657604706084,MATH 193A,A05,093482,Rotar; Vladimir,10,0,34,24
1657604712109,MATH 197,001,091859,McAuley; Julian John,9999,0,9999,0
1657604712109,MATH 197,002,095566,Kedlaya; Kiran S.,9997,0,9999,2
1657604712109,MATH 197,003,095567,Xiao; Ming,9999,0,9999,0
1657604712109,MATH 197,004,095571,Perols; Johan Lars,9998,0,9999,1
1657604719174,COGS 9,A01,083615,Shannon; Kyle Michael,9,0,75,66
1657604725198,COGS 11,A01,083617,Boyle; Mary E. T.,23,0,48,25
1657604731222,COGS 13,A01,083071,Bastos; Amalia Pinkusfeld,11,0,71,60
1657604737244,COGS 14A,A01,092681,Semenuks; Arturs,5,1,100,95
1657604743267,COGS 14B,A01,083073,Cheng; Tzu-Han,6,0,63,57
1657604749292,COGS 17,A01,092677,Semenuks; Arturs,6,0,81,75
1657604755318,COGS 100,A01,083619,Allen; Michael Gordon,17,0,70,53
1657604761343,COGS 101A,A01,083621,Davis; Joshua Daniel,9,0,68,59
1657604767370,COGS 101B,A01,091572,Allen; Michael Gordon,12,0,65,53
1657604773394,COGS 101C,A01,083625,Delgado; Tania,17,0,35,18
1657604779420,COGS 107A,A01,083627,Boyle; Mary E. T.,13,0,60,47
1657604785469,COGS 118A,A01,083075,Gupta; Anjum,21,0,76,55
1657604791492,CSE 3,A50,083646,Miranda; Gregory Joseph,24,0,50,26
1657604797523,CSE 8A,A50,083650,Miranda; Gregory Joseph,17,1,56,39
1657604803552,CSE 11,A01,083080,Cao; Yingjun,6,15,40,34
1657604809574,CSE 12,A01,083652,Krause-Levy; Sophia Louisa,28,1,120,92
1657604815601,CSE 15L,A01,083654,Morris; Justin Loren,9,0,50,41
1657604815601,CSE 15L,A02,083655,Morris; Justin Loren,9,0,50,41
1657604821625,CSE 20,A01,083657,Tran; Khoa Dang,39,0,80,41
1657604827651,CSE 21,A01,095574,Bach; Quang Tran,22,0,48,26
1657604833672,CSE 30,A01,083084,Eldon; John,5,0,80,75
1657604833672,CSE 30,B01,095061,Bhaskar; Nishant,9,0,50,41
1657604839694,CSE 100,A01,083659,Cao; Yingjun,5,4,70,65
1657604845715,CSE 134B,A01,083661,Powell; Thomas Allan,22,0,100,78
1657604851737,CSE 140,A01,083663,Gungor; Onat,15,0,85,70
1657604857759,CSE 140L,A01,083088,Eldon; John,21,0,100,79
1657604863780,CSE 175,A01,083665,Kumar; Rakesh,3,0,25,22
1657604869803,CSE 190,A00,092507,Dubnov; Shlomo,8,0,20,12
1657604875833,ECE 45,A01,083139,Congero; Spencer William,6,0,75,69
1657604881860,ECE 65,A50,083695,Saad; Andrew S,12,0,30,18
1657604881860,ECE 65,A51,095125,Saad; Andrew S,24,0,26,2
1657604887884,ECE 109,A01,091882,Touri; Behrouz,19,0,70,51
1657604893910,ECE 180,A00,083140,Abi Samra; Nicholas Camill,1,0,30,29
1657604893910,ECE 180,B00,083141,Abi Samra; Nicholas Camill,0,0,30,30
1657604899933,MATH 10A,A01,083735,Patchell; Gregory David,2,0,30,28
1657604899933,MATH 10A,A02,083736,Patchell; Gregory David,20,0,30,10
1657604899933,MATH 10A,A03,083737,Patchell; Gregory David,16,0,30,14
1657604905961,MATH 10B,A01,083207,Lim; Seonhee,8,0,34,26
1657604905961,MATH 10B,A02,083208,Lim; Seonhee,9,0,35,26
1657604905961,MATH 10B,A03,093472,Lim; Seonhee,7,0,34,27
1657604905961,MATH 10B,B01,083739,Sinha; Shubham,12,0,30,18
1657604911989,MATH 18,A01,083743,Cinel; Cameron Alexander,7,0,30,23
1657604911989,MATH 18,A02,083744,Cinel; Cameron Alexander,17,0,30,13
1657604911989,MATH 18,A03,083745,Cinel; Cameron Alexander,9,0,30,21
1657604911989,MATH 18,B01,083748,Rideout; David Porter,5,0,37,32
1657604911989,MATH 18,B02,083749,Rideout; David Porter,5,0,36,31
1657604911989,MATH 18,B03,083750,Rideout; David Porter,3,0,37,34
1657604911989,MATH 18,B04,083751,Rideout; David Porter,6,0,36,30
1657604911989,MATH 18,B05,093473,Rideout; David Porter,6,0,36,30
1657604911989,MATH 18,B06,093474,Rideout; David Porter,6,0,36,30
1657604918014,MATH 20A,A01,083754,Zheng; Zequn,14,0,40,26
1657604924042,MATH 20B,A01,083756,Briones; Jor-el Thomas Caparas,4,0,36,32
1657604924042,MATH 20B,A02,083757,Briones; Jor-el Thomas Caparas,1,0,36,35
1657604924042,MATH 20B,A03,093475,Briones; Jor-el Thomas Caparas,2,0,36,34
1657604930064,MATH 20C,A01,083760,Briones; Jor-el Thomas Caparas,1,0,35,34
1657604930064,MATH 20C,A02,083761,Briones; Jor-el Thomas Caparas,8,0,35,27
1657604930064,MATH 20C,A03,093476,Briones; Jor-el Thomas Caparas,0,1,36,36
1657604930064,MATH 20C,B01,083762,Bach; Quang Tran,1,0,30,29
1657604936088,MATH 20D,A01,083765,Tran; Brian Kha,5,0,30,25
1657604936088,MATH 20D,A02,083766,Tran; Brian Kha,5,0,30,25
1657604936088,MATH 20D,A03,083767,Tran; Brian Kha,5,0,30,25
1657604942118,MATH 20E,A01,083771,Ganguly; Soumya,9,0,32,23
1657604942118,MATH 20E,A02,083772,Ganguly; Soumya,6,0,32,26
1657604942118,MATH 20E,B01,083773,Ciotti; Benjamin,20,0,35,15
1657604942118,MATH 20E,B02,083774,Ciotti; Benjamin,18,0,35,17
1657604948140,MATH 103A,A01,083777,Greenfeld; Be'Eri,3,0,36,33
1657604948140,MATH 103A,A02,083778,Greenfeld; Be'Eri,5,0,36,31
1657604948140,MATH 103A,A03,093561,Greenfeld; Be'Eri,6,0,36,30
1657604948140,MATH 103A,B01,083779,Greenfeld; Be'Eri,7,0,36,29
1657604948140,MATH 103A,B02,083780,Greenfeld; Be'Eri,4,0,36,32
1657604948140,MATH 103A,B03,093562,Greenfeld; Be'Eri,3,0,36,33
1657604954163,MATH 105,A01,085443,Carter; Anne Toulson,15,0,35,20
1657604954163,MATH 105,A02,093477,Carter; Anne Toulson,20,0,35,15
1657604960193,MATH 109,A01,083213,Ganzberger; Geoffrey Michael,2,0,34,32
1657604960193,MATH 109,A02,083214,Ganzberger; Geoffrey Michael,4,0,34,30
1657604960193,MATH 109,A03,093478,Ganzberger; Geoffrey Michael,2,0,34,32
1657604960193,MATH 109,B01,083215,Ganzberger; Geoffrey Michael,1,0,32,31
1657604960193,MATH 109,B02,083216,Ganzberger; Geoffrey Michael,2,0,32,30
1657604960193,MATH 109,B03,093479,Ganzberger; Geoffrey Michael,8,0,32,24
1657604966216,MATH 142A,A01,083219,Chow; Bennett,7,0,32,25
1657604966216,MATH 142A,A02,083220,Chow; Bennett,10,0,32,22
1657604966216,MATH 142A,A03,093480,Chow; Bennett,9,0,32,23
1657604966216,MATH 142A,B03,093481,Chow; Bennett,8,0,32,24
1657604966216,MATH 142A,B04,093558,Chow; Bennett,13,0,32,19
1657604966216,MATH 142A,B05,093559,Chow; Bennett,6,0,32,26
1657604972242,MATH 193A,A01,083224,Rotar; Vladimir,8,0,34,26
1657604972242,MATH 193A,A02,083225,Rotar; Vladimir,9,0,34,25
1657604972242,MATH 193A,A03,083781,Rotar; Vladimir,5,0,34,29
1657604972242,MATH 193A,A04,083782,Rotar; Vladimir,10,0,34,24
1657604972242,MATH 193A,A05,093482,Rotar; Vladimir,10,0,34,24
1657604978266,MATH 197,001,091859,McAuley; Julian John,9999,0,9999,0
1657604978266,MATH 197,002,095566,Kedlaya; Kiran S.,9997,0,9999,2
1657604978266,MATH 197,003,095567,Xiao; Ming,9999,0,9999,0
1657604978266,MATH 197,004,095571,Perols; Johan Lars,9998,0,9999,1
1657604985361,COGS 9,A01,083615,Shannon; Kyle Michael,9,0,75,66
1657604991386,COGS 11,A01,083617,Boyle; Mary E. T.,23,0,48,25
1657604997416,COGS 13,A01,083071,Bastos; Amalia Pinkusfeld,11,0,71,60
1657605003441,COGS 14A,A01,092681,Semenuks; Arturs,5,1,100,95
1657605009463,COGS 14B,A01,083073,Cheng; Tzu-Han,6,0,63,57
1657605015489,COGS 17,A01,092677,Semenuks; Arturs,6,0,81,75
1657605021520,COGS 100,A01,083619,Allen; Michael Gordon,17,0,70,53
1657605027549,COGS 101A,A01,083621,Davis; Joshua Daniel,9,0,68,59
1657605033576,COGS 101B,A01,091572,Allen; Michael Gordon,12,0,65,53
1657605039599,COGS 101C,A01,083625,Delgado; Tania,17,0,35,18
1657605045623,COGS 107A,A01,083627,Boyle; Mary E. T.,13,0,60,47
1657605051655,COGS 118A,A01,083075,Gupta; Anjum,21,0,76,55
1657605057679,CSE 3,A50,083646,Miranda; Gregory Joseph,24,0,50,26
1657605063701,CSE 8A,A50,083650,Miranda; Gregory Joseph,17,1,56,39
1657605069724,CSE 11,A01,083080,Cao; Yingjun,6,15,40,34
1657605075746,CSE 12,A01,083652,Krause-Levy; Sophia Louisa,28,1,120,92
1657605081773,CSE 15L,A01,083654,Morris; Justin Loren,9,0,50,41
1657605081773,CSE 15L,A02,083655,Morris; Justin Loren,9,0,50,41
1657605087795,CSE 20,A01,083657,Tran; Khoa Dang,39,0,80,41
1657605093819,CSE 21,A01,095574,Bach; Quang Tran,22,0,48,26
1657605099845,CSE 30,A01,083084,Eldon; John,5,0,80,75
1657605099845,CSE 30,B01,095061,Bhaskar; Nishant,9,0,50,41
1657605105868,CSE 100,A01,083659,Cao; Yingjun,5,4,70,65
1657605111891,CSE 134B,A01,083661,Powell; Thomas Allan,22,0,100,78
1657605117912,CSE 140,A01,083663,Gungor; Onat,15,0,85,70
1657605123937,CSE 140L,A01,083088,Eldon; John,21,0,100,79
1657605129959,CSE 175,A01,083665,Kumar; Rakesh,3,0,25,22
1657605135982,CSE 190,A00,092507,Dubnov; Shlomo,8,0,20,12
1657605142010,ECE 45,A01,083139,Congero; Spencer William,6,0,75,69
1657605148032,ECE 65,A50,083695,Saad; Andrew S,12,0,30,18
1657605148032,ECE 65,A51,095125,Saad; Andrew S,24,0,26,2
1657605154056,ECE 109,A01,091882,Touri; Behrouz,19,0,70,51
1657605160083,ECE 180,A00,083140,Abi Samra; Nicholas Camill,1,0,30,29
1657605160083,ECE 180,B00,083141,Abi Samra; Nicholas Camill,0,0,30,30
1657605166112,MATH 10A,A01,083735,Patchell; Gregory David,2,0,30,28
1657605166112,MATH 10A,A02,083736,Patchell; Gregory David,20,0,30,10
1657605166112,MATH 10A,A03,083737,Patchell; Gregory David,16,0,30,14
1657605172135,MATH 10B,A01,083207,Lim; Seonhee,8,0,34,26
1657605172135,MATH 10B,A02,083208,Lim; Seonhee,9,0,35,26
1657605172135,MATH 10B,A03,093472,Lim; Seonhee,7,0,34,27
1657605172135,MATH 10B,B01,083739,Sinha; Shubham,12,0,30,18
1657605178167,MATH 18,A01,083743,Cinel; Cameron Alexander,7,0,30,23
1657605178167,MATH 18,A02,083744,Cinel; Cameron Alexander,17,0,30,13
1657605178167,MATH 18,A03,083745,Cinel; Cameron Alexander,9,0,30,21
1657605178167,MATH 18,B01,083748,Rideout; David Porter,5,0,37,32
1657605178167,MATH 18,B02,083749,Rideout; David Porter,5,0,36,31
1657605178167,MATH 18,B03,083750,Rideout; David Porter,3,0,37,34
1657605178167,MATH 18,B04,083751,Rideout; David Porter,6,0,36,30
1657605178167,MATH 18,B05,093473,Rideout; David Porter,6,0,36,30
1657605178167,MATH 18,B06,093474,Rideout; David Porter,6,0,36,30
1657605184193,MATH 20A,A01,083754,Zheng; Zequn,14,0,40,26
1657605190216,MATH 20B,A01,083756,Briones; Jor-el Thomas Caparas,4,0,36,32
1657605190216,MATH 20B,A02,083757,Briones; Jor-el Thomas Caparas,1,0,36,35
1657605190216,MATH 20B,A03,093475,Briones; Jor-el Thomas Caparas,2,0,36,34
1657605196246,MATH 20C,A01,083760,Briones; Jor-el Thomas Caparas,1,0,35,34
1657605196246,MATH 20C,A02,083761,Briones; Jor-el Thomas Caparas,8,0,35,27
1657605196246,MATH 20C,A03,093476,Briones; Jor-el Thomas Caparas,0,1,36,36
1657605196246,MATH 20C,B01,083762,Bach; Quang Tran,1,0,30,29
1657605202268,MATH 20D,A01,083765,Tran; Brian Kha,5,0,30,25
1657605202268,MATH 20D,A02,083766,Tran; Brian Kha,5,0,30,25
1657605202268,MATH 20D,A03,083767,Tran; Brian Kha,5,0,30,25
1657605208304,MATH 20E,A01,083771,Ganguly; Soumya,9,0,32,23
1657605208304,MATH 20E,A02,083772,Ganguly; Soumya,6,0,32,26
1657605208304,MATH 20E,B01,083773,Ciotti; Benjamin,20,0,35,15
1657605208304,MATH 20E,B02,083774,Ciotti; Benjamin,18,0,35,17
1657605214327,MATH 103A,A01,083777,Greenfeld; Be'Eri,3,0,36,33
1657605214327,MATH 103A,A02,083778,Greenfeld; Be'Eri,5,0,36,31
1657605214327,MATH 103A,A03,093561,Greenfeld; Be'Eri,6,0,36,30
1657605214327,MATH 103A,B01,083779,Greenfeld; Be'Eri,7,0,36,29
1657605214327,MATH 103A,B02,083780,Greenfeld; Be'Eri,4,0,36,32
1657605214327,MATH 103A,B03,093562,Greenfeld; Be'Eri,3,0,36,33
1657605220350,MATH 105,A01,085443,Carter; Anne Toulson,15,0,35,20
1657605220350,MATH 105,A02,093477,Carter; Anne Toulson,20,0,35,15
1657605226372,MATH 109,A01,083213,Ganzberger; Geoffrey Michael,2,0,34,32
1657605226372,MATH 109,A02,083214,Ganzberger; Geoffrey Michael,4,0,34,30
1657605226372,MATH 109,A03,093478,Ganzberger; Geoffrey Michael,2,0,34,32
1657605226372,MATH 109,B01,083215,Ganzberger; Geoffrey Michael,1,0,32,31
1657605226372,MATH 109,B02,083216,Ganzberger; Geoffrey Michael,2,0,32,30
1657605226372,MATH 109,B03,093479,Ganzberger; Geoffrey Michael,8,0,32,24
1657605232395,MATH 142A,A01,083219,Chow; Bennett,7,0,32,25
1657605232395,MATH 142A,A02,083220,Chow; Bennett,10,0,32,22
1657605232395,MATH 142A,A03,093480,Chow; Bennett,9,0,32,23
1657605232395,MATH 142A,B03,093481,Chow; Bennett,8,0,32,24
1657605232395,MATH 142A,B04,093558,Chow; Bennett,13,0,32,19
1657605232395,MATH 142A,B05,093559,Chow; Bennett,6,0,32,26
1657605238425,MATH 193A,A01,083224,Rotar; Vladimir,8,0,34,26
1657605238425,MATH 193A,A02,083225,Rotar; Vladimir,9,0,34,25
1657605238425,MATH 193A,A03,083781,Rotar; Vladimir,5,0,34,29
1657605238425,MATH 193A,A04,083782,Rotar; Vladimir,10,0,34,24
1657605238425,MATH 193A,A05,093482,Rotar; Vladimir,10,0,34,24
1657605244445,MATH 197,001,091859,McAuley; Julian John,9999,0,9999,0
1657605244445,MATH 197,002,095566,Kedlaya; Kiran S.,9997,0,9999,2
1657605244445,MATH 197,003,095567,Xiao; Ming,9999,0,9999,0
1657605244445,MATH 197,004,095571,Perols; Johan Lars,9998,0,9999,1
1657605251500,COGS 9,A01,083615,Shannon; Kyle Michael,9,0,75,66
1657605257526,COGS 11,A01,083617,Boyle; Mary E. T.,23,0,48,25
1657605263623,COGS 13,A01,083071,Bastos; Amalia Pinkusfeld,11,0,71,60
1657605269651,COGS 14A,A01,092681,Semenuks; Arturs,5,1,100,95
1657605275677,COGS 14B,A01,083073,Cheng; Tzu-Han,6,0,63,57
1657605281701,COGS 17,A01,092677,Semenuks; Arturs,6,0,81,75
1657605287729,COGS 100,A01,083619,Allen; Michael Gordon,17,0,70,53
1657605293752,COGS 101A,A01,083621,Davis; Joshua Daniel,9,0,68,59
1657605299774,COGS 101B,A01,091572,Allen; Michael Gordon,12,0,65,53
1657605305796,COGS 101C,A01,083625,Delgado; Tania,17,0,35,18
1657605311817,COGS 107A,A01,083627,Boyle; Mary E. T.,13,0,60,47
1657605317839,COGS 118A,A01,083075,Gupta; Anjum,21,0,76,55
1657605323864,CSE 3,A50,083646,Miranda; Gregory Joseph,24,0,50,26
1657605329893,CSE 8A,A50,083650,Miranda; Gregory Joseph,17,1,56,39
1657605335916,CSE 11,A01,083080,Cao; Yingjun,6,15,40,34
1657605341940,CSE 12,A01,083652,Krause-Levy; Sophia Louisa,28,1,120,92
1657605347963,CSE 15L,A01,083654,Morris; Justin Loren,9,0,50,41
1657605347963,CSE 15L,A02,083655,Morris; Justin Loren,9,0,50,41
1657605353987,CSE 20,A01,083657,Tran; Khoa Dang,39,0,80,41
1657605360013,CSE 21,A01,095574,Bach; Quang Tran,22,0,48,26
1657605366036,CSE 30,A01,083084,Eldon; John,5,0,80,75
1657605366036,CSE 30,B01,095061,Bhaskar; Nishant,9,0,50,41
1657605372059,CSE 100,A01,083659,Cao; Yingjun,5,4,70,65
1657605378084,CSE 134B,A01,083661,Powell; Thomas Allan,22,0,100,78
1657605384119,CSE 140,A01,083663,Gungor; Onat,15,0,85,70
1657605390142,CSE 140L,A01,083088,Eldon; John,21,0,100,79
1657605396164,CSE 175,A01,083665,Kumar; Rakesh,3,0,25,22
1657605402186,CSE 190,A00,092507,Dubnov; Shlomo,8,0,20,12
1657605408207,ECE 45,A01,083139,Congero; Spencer William,6,0,75,69
1657605414235,ECE 65,A50,083695,Saad; Andrew S,12,0,30,18
1657605414235,ECE 65,A51,095125,Saad; Andrew S,24,0,26,2
1657605420257,ECE 109,A01,091882,Touri; Behrouz,19,0,70,51
1657605426284,ECE 180,A00,083140,Abi Samra; Nicholas Camill,1,0,30,29
1657605426284,ECE 180,B00,083141,Abi Samra; Nicholas Camill,0,0,30,30
1657605432308,MATH 10A,A01,083735,Patchell; Gregory David,2,0,30,28
1657605432308,MATH 10A,A02,083736,Patchell; Gregory David,20,0,30,10
1657605432308,MATH 10A,A03,083737,Patchell; Gregory David,16,0,30,14
1657605438332,MATH 10B,A01,083207,Lim; Seonhee,8,0,34,26
1657605438332,MATH 10B,A02,083208,Lim; Seonhee,9,0,35,26
1657605438332,MATH 10B,A03,093472,Lim; Seonhee,7,0,34,27
1657605438332,MATH 10B,B01,083739,Sinha; Shubham,12,0,30,18
1657605444365,MATH 18,A01,083743,Cinel; Cameron Alexander,7,0,30,23
1657605444365,MATH 18,A02,083744,Cinel; Cameron Alexander,17,0,30,13
1657605444365,MATH 18,A03,083745,Cinel; Cameron Alexander,9,0,30,21
1657605444365,MATH 18,B01,083748,Rideout; David Porter,5,0,37,32
1657605444365,MATH 18,B02,083749,Rideout; David Porter,5,0,36,31
1657605444365,MATH 18,B03,083750,Rideout; David Porter,3,0,37,34
1657605444365,MATH 18,B04,083751,Rideout; David Porter,6,0,36,30
1657605444365,MATH 18,B05,093473,Rideout; David Porter,6,0,36,30
1657605444365,MATH 18,B06,093474,Rideout; David Porter,6,0,36,30
1657605450390,MATH 20A,A01,083754,Zheng; Zequn,14,0,40,26
1657605456413,MATH 20B,A01,083756,Briones; Jor-el Thomas Caparas,4,0,36,32
1657605456413,MATH 20B,A02,083757,Briones; Jor-el Thomas Caparas,1,0,36,35
1657605456413,MATH 20B,A03,093475,Briones; Jor-el Thomas Caparas,2,0,36,34
1657605462436,MATH 20C,A01,083760,Briones; Jor-el Thomas Caparas,1,0,35,34
1657605462436,MATH 20C,A02,083761,Briones; Jor-el Thomas Caparas,8,0,35,27
1657605462436,MATH 20C,A03,093476,Briones; Jor-el Thomas Caparas,0,1,36,36
1657605462436,MATH 20C,B01,083762,Bach; Quang Tran,1,0,30,29
1657605468463,MATH 20D,A01,083765,Tran; Brian Kha,5,0,30,25
1657605468463,MATH 20D,A02,083766,Tran; Brian Kha,5,0,30,25
1657605468463,MATH 20D,A03,083767,Tran; Brian Kha,5,0,30,25
1657605474491,MATH 20E,A01,083771,Ganguly; Soumya,9,0,32,23
1657605474491,MATH 20E,A02,083772,Ganguly; Soumya,6,0,32,26
1657605474491,MATH 20E,B01,083773,Ciotti; Benjamin,20,0,35,15
1657605474491,MATH 20E,B02,083774,Ciotti; Benjamin,18,0,35,17
1657605480516,MATH 103A,A01,083777,Greenfeld; Be'Eri,3,0,36,33
1657605480516,MATH 103A,A02,083778,Greenfeld; Be'Eri,5,0,36,31
1657605480516,MATH 103A,A03,093561,Greenfeld; Be'Eri,6,0,36,30
1657605480516,MATH 103A,B01,083779,Greenfeld; Be'Eri,7,0,36,29
1657605480516,MATH 103A,B02,083780,Greenfeld; Be'Eri,4,0,36,32
1657605480516,MATH 103A,B03,093562,Greenfeld; Be'Eri,3,0,36,33
1657605486541,MATH 105,A01,085443,Carter; Anne Toulson,15,0,35,20
1657605486541,MATH 105,A02,093477,Carter; Anne Toulson,20,0,35,15
1657605492567,MATH 109,A01,083213,Ganzberger; Geoffrey Michael,2,0,34,32
1657605492567,MATH 109,A02,083214,Ganzberger; Geoffrey Michael,4,0,34,30
1657605492567,MATH 109,A03,093478,Ganzberger; Geoffrey Michael,2,0,34,32
1657605492567,MATH 109,B01,083215,Ganzberger; Geoffrey Michael,1,0,32,31
1657605492567,MATH 109,B02,083216,Ganzberger; Geoffrey Michael,2,0,32,30
1657605492567,MATH 109,B03,093479,Ganzberger; Geoffrey Michael,8,0,32,24
1657605498593,MATH 142A,A01,083219,Chow; Bennett,7,0,32,25
1657605498593,MATH 142A,A02,083220,Chow; Bennett,10,0,32,22
1657605498593,MATH 142A,A03,093480,Chow; Bennett,9,0,32,23
1657605498593,MATH 142A,B03,093481,Chow; Bennett,8,0,32,24
1657605498593,MATH 142A,B04,093558,Chow; Bennett,13,0,32,19
1657605498593,MATH 142A,B05,093559,Chow; Bennett,6,0,32,26
1657605504619,MATH 193A,A01,083224,Rotar; Vladimir,8,0,34,26
1657605504619,MATH 193A,A02,083225,Rotar; Vladimir,9,0,34,25
1657605504619,MATH 193A,A03,083781,Rotar; Vladimir,5,0,34,29
1657605504619,MATH 193A,A04,083782,Rotar; Vladimir,10,0,34,24
1657605504619,MATH 193A,A05,093482,Rotar; Vladimir,10,0,34,24
1657605510642,MATH 197,001,091859,McAuley; Julian John,9999,0,9999,0
1657605510642,MATH 197,002,095566,Kedlaya; Kiran S.,9997,0,9999,2
1657605510642,MATH 197,003,095567,Xiao; Ming,9999,0,9999,0
1657605510642,MATH 197,004,095571,Perols; Johan Lars,9998,0,9999,1
1657605517698,COGS 9,A01,083615,Shannon; Kyle Michael,9,0,75,66
1657605523723,COGS 11,A01,083617,Boyle; Mary E. T.,23,0,48,25
1657605529746,COGS 13,A01,083071,Bastos; Amalia Pinkusfeld,11,0,71,60
1657605535773,COGS 14A,A01,092681,Semenuks; Arturs,5,1,100,95
1657605541794,COGS 14B,A01,083073,Cheng; Tzu-Han,6,0,63,57
1657605547816,COGS 17,A01,092677,Semenuks; Arturs,6,0,81,75
1657605553843,COGS 100,A01,083619,Allen; Michael Gordon,17,0,70,53
1657605559873,COGS 101A,A01,083621,Davis; Joshua Daniel,9,0,68,59
1657605565896,COGS 101B,A01,091572,Allen; Michael Gordon,12,0,65,53
1657605571918,COGS 101C,A01,083625,Delgado; Tania,17,0,35,18
1657605577947,COGS 107A,A01,083627,Boyle; Mary E. T.,13,0,60,47
1657605583971,COGS 118A,A01,083075,Gupta; Anjum,21,0,76,55
1657605590003,CSE 3,A50,083646,Miranda; Gregory Joseph,24,0,50,26
1657605596026,CSE 8A,A50,083650,Miranda; Gregory Joseph,17,1,56,39
1657605602050,CSE 11,A01,083080,Cao; Yingjun,6,15,40,34
1657605620963,CSE 12,A01,083652,Krause-Levy; Sophia Louisa,28,1,120,92
1657605626988,CSE 15L,A01,083654,Morris; Justin Loren,9,0,50,41
1657605626988,CSE 15L,A02,083655,Morris; Justin Loren,9,0,50,41
1657605633011,CSE 20,A01,083657,Tran; Khoa Dang,39,0,80,41
1657605639035,CSE 21,A01,095574,Bach; Quang Tran,22,0,48,26
1657605645061,CSE 30,A01,083084,Eldon; John,5,0,80,75
1657605645061,CSE 30,B01,095061,Bhaskar; Nishant,9,0,50,41
1657605651083,CSE 100,A01,083659,Cao; Yingjun,5,4,70,65
1657605657106,CSE 134B,A01,083661,Powell; Thomas Allan,22,0,100,78
1657605663137,CSE 140,A01,083663,Gungor; Onat,15,0,85,70
1657605669160,CSE 140L,A01,083088,Eldon; John,21,0,100,79
1657605675187,CSE 175,A01,083665,Kumar; Rakesh,3,0,25,22
1657605681215,CSE 190,A00,092507,Dubnov; Shlomo,8,0,20,12
1657605687250,ECE 45,A01,083139,Congero; Spencer William,6,0,75,69
1657605693276,ECE 65,A50,083695,Saad; Andrew S,12,0,30,18
1657605693276,ECE 65,A51,095125,Saad; Andrew S,24,0,26,2
1657605699301,ECE 109,A01,091882,Touri; Behrouz,19,0,70,51
1657605705327,ECE 180,A00,083140,Abi Samra; Nicholas Camill,1,0,30,29
1657605705327,ECE 180,B00,083141,Abi Samra; Nicholas Camill,0,0,30,30
1657605711357,MATH 10A,A01,083735,Patchell; Gregory David,2,0,30,28
1657605711357,MATH 10A,A02,083736,Patchell; Gregory David,20,0,30,10
1657605711357,MATH 10A,A03,083737,Patchell; Gregory David,16,0,30,14
1657605717392,MATH 10B,A01,083207,Lim; Seonhee,8,0,34,26
1657605717392,MATH 10B,A02,083208,Lim; Seonhee,9,0,35,26
1657605717392,MATH 10B,A03,093472,Lim; Seonhee,7,0,34,27
1657605717392,MATH 10B,B01,083739,Sinha; Shubham,12,0,30,18
1657605723428,MATH 18,A01,083743,Cinel; Cameron Alexander,7,0,30,23
1657605723428,MATH 18,A02,083744,Cinel; Cameron Alexander,17,0,30,13
1657605723428,MATH 18,A03,083745,Cinel; Cameron Alexander,9,0,30,21
1657605723428,MATH 18,B01,083748,Rideout; David Porter,5,0,37,32
1657605723428,MATH 18,B02,083749,Rideout; David Porter,5,0,36,31
1657605723428,MATH 18,B03,083750,Rideout; David Porter,3,0,37,34
1657605723428,MATH 18,B04,083751,Rideout; David Porter,6,0,36,30
1657605723428,MATH 18,B05,093473,Rideout; David Porter,6,0,36,30
1657605723428,MATH 18,B06,093474,Rideout; David Porter,6,0,36,30
1657605729452,MATH 20A,A01,083754,Zheng; Zequn,14,0,40,26
1657605735478,MATH 20B,A01,083756,Briones; Jor-el Thomas Caparas,4,0,36,32
1657605735478,MATH 20B,A02,083757,Briones; Jor-el Thomas Caparas,1,0,36,35
1657605735478,MATH 20B,A03,093475,Briones; Jor-el Thomas Caparas,2,0,36,34
1657605741510,MATH 20C,A01,083760,Briones; Jor-el Thomas Caparas,1,0,35,34
1657605741510,MATH 20C,A02,083761,Briones; Jor-el Thomas Caparas,8,0,35,27
1657605741510,MATH 20C,A03,093476,Briones; Jor-el Thomas Caparas,0,1,36,36
1657605741510,MATH 20C,B01,083762,Bach; Quang Tran,1,0,30,29
1657605747542,MATH 20D,A01,083765,Tran; Brian Kha,5,0,30,25
1657605747542,MATH 20D,A02,083766,Tran; Brian Kha,5,0,30,25
1657605747542,MATH 20D,A03,083767,Tran; Brian Kha,5,0,30,25
1657605753570,MATH 20E,A01,083771,Ganguly; Soumya,9,0,32,23
1657605753570,MATH 20E,A02,083772,Ganguly; Soumya,6,0,32,26
1657605753570,MATH 20E,B01,083773,Ciotti; Benjamin,20,0,35,15
1657605753570,MATH 20E,B02,083774,Ciotti; Benjamin,18,0,35,17
1657605759595,MATH 103A,A01,083777,Greenfeld; Be'Eri,3,0,36,33
1657605759595,MATH 103A,A02,083778,Greenfeld; Be'Eri,5,0,36,31
1657605759595,MATH 103A,A03,093561,Greenfeld; Be'Eri,6,0,36,30
1657605759595,MATH 103A,B01,083779,Greenfeld; Be'Eri,7,0,36,29
1657605759595,MATH 103A,B02,083780,Greenfeld; Be'Eri,4,0,36,32
1657605759595,MATH 103A,B03,093562,Greenfeld; Be'Eri,3,0,36,33
1657605765619,MATH 105,A01,085443,Carter; Anne Toulson,15,0,35,20
1657605765619,MATH 105,A02,093477,Carter; Anne Toulson,20,0,35,15
1657605771643,MATH 109,A01,083213,Ganzberger; Geoffrey Michael,2,0,34,32
1657605771643,MATH 109,A02,083214,Ganzberger; Geoffrey Michael,4,0,34,30
1657605771643,MATH 109,A03,093478,Ganzberger; Geoffrey Michael,2,0,34,32
1657605771643,MATH 109,B01,083215,Ganzberger; Geoffrey Michael,1,0,32,31
1657605771643,MATH 109,B02,083216,Ganzberger; Geoffrey Michael,2,0,32,30
1657605771643,MATH 109,B03,093479,Ganzberger; Geoffrey Michael,8,0,32,24
1657605777666,MATH 142A,A01,083219,Chow; Bennett,7,0,32,25
1657605777666,MATH 142A,A02,083220,Chow; Bennett,10,0,32,22
1657605777666,MATH 142A,A03,093480,Chow; Bennett,9,0,32,23
1657605777666,MATH 142A,B03,093481,Chow; Bennett,8,0,32,24
1657605777666,MATH 142A,B04,093558,Chow; Bennett,13,0,32,19
1657605777666,MATH 142A,B05,093559,Chow; Bennett,6,0,32,26
1657605783694,MATH 193A,A01,083224,Rotar; Vladimir,8,0,34,26
1657605783694,MATH 193A,A02,083225,Rotar; Vladimir,9,0,34,25
1657605783694,MATH 193A,A03,083781,Rotar; Vladimir,5,0,34,29
1657605783694,MATH 193A,A04,083782,Rotar; Vladimir,10,0,34,24
1657605783694,MATH 193A,A05,093482,Rotar; Vladimir,10,0,34,24
1657605789722,MATH 197,001,091859,McAuley; Julian John,9999,0,9999,0
1657605789722,MATH 197,002,095566,Kedlaya; Kiran S.,9997,0,9999,2
1657605789722,MATH 197,003,095567,Xiao; Ming,9999,0,9999,0
1657605789722,MATH 197,004,095571,Perols; Johan Lars,9998,0,9999,1
1657605796788,COGS 9,A01,083615,Shannon; Kyle Michael,9,0,75,66
1657605802810,COGS 11,A01,083617,Boyle; Mary E. T.,23,0,48,25
1657605808849,COGS 13,A01,083071,Bastos; Amalia Pinkusfeld,11,0,71,60
1657605814871,COGS 14A,A01,092681,Semenuks; Arturs,5,1,100,95
1657605820895,COGS 14B,A01,083073,Cheng; Tzu-Han,6,0,63,57
1657605826920,COGS 17,A01,092677,Semenuks; Arturs,6,0,81,75
1657605832959,COGS 100,A01,083619,Allen; Michael Gordon,17,0,70,53
1657605838982,COGS 101A,A01,083621,Davis; Joshua Daniel,9,0,68,59
1657605845018,COGS 101B,A01,091572,Allen; Michael Gordon,12,0,65,53
1657605851043,COGS 101C,A01,083625,Delgado; Tania,17,0,35,18
1657605857067,COGS 107A,A01,083627,Boyle; Mary E. T.,13,0,60,47
1657605863095,COGS 118A,A01,083075,Gupta; Anjum,21,0,76,55
1657605869121,CSE 3,A50,083646,Miranda; Gregory Joseph,24,0,50,26
1657605875238,CSE 8A,A50,083650,Miranda; Gregory Joseph,17,1,56,39
1657605881264,CSE 11,A01,083080,Cao; Yingjun,6,15,40,34
1657605887287,CSE 12,A01,083652,Krause-Levy; Sophia Louisa,28,1,120,92
1657605893312,CSE 15L,A01,083654,Morris; Justin Loren,9,0,50,41
1657605893312,CSE 15L,A02,083655,Morris; Justin Loren,9,0,50,41
1657605899336,CSE 20,A01,083657,Tran; Khoa Dang,39,0,80,41
1657605905363,CSE 21,A01,095574,Bach; Quang Tran,22,0,48,26
1657605911388,CSE 30,A01,083084,Eldon; John,5,0,80,75
1657605911388,CSE 30,B01,095061,Bhaskar; Nishant,9,0,50,41
1657605917415,CSE 100,A01,083659,Cao; Yingjun,5,4,70,65
1657605923454,CSE 134B,A01,083661,Powell; Thomas Allan,22,0,100,78
1657605929485,CSE 140,A01,083663,Gungor; Onat,15,0,85,70
1657605935513,CSE 140L,A01,083088,Eldon; John,21,0,100,79
1657605941537,CSE 175,A01,083665,Kumar; Rakesh,3,0,25,22
1657605947558,CSE 190,A00,092507,Dubnov; Shlomo,8,0,20,12
1657605953583,ECE 45,A01,083139,Congero; Spencer William,6,0,75,69
1657605959606,ECE 65,A50,083695,Saad; Andrew S,12,0,30,18
1657605959606,ECE 65,A51,095125,Saad; Andrew S,24,0,26,2
1657605965633,ECE 109,A01,091882,Touri; Behrouz,19,0,70,51
1657605971660,ECE 180,A00,083140,Abi Samra; Nicholas Camill,1,0,30,29
1657605971660,ECE 180,B00,083141,Abi Samra; Nicholas Camill,0,0,30,30
1657605977689,MATH 10A,A01,083735,Patchell; Gregory David,2,0,30,28
1657605977689,MATH 10A,A02,083736,Patchell; Gregory David,20,0,30,10
1657605977689,MATH 10A,A03,083737,Patchell; Gregory David,16,0,30,14
1657605983717,MATH 10B,A01,083207,Lim; Seonhee,8,0,34,26
1657605983717,MATH 10B,A02,083208,Lim; Seonhee,9,0,35,26
1657605983717,MATH 10B,A03,093472,Lim; Seonhee,7,0,34,27
1657605983717,MATH 10B,B01,083739,Sinha; Shubham,12,0,30,18
1657605989743,MATH 18,A01,083743,Cinel; Cameron Alexander,7,0,30,23
1657605989743,MATH 18,A02,083744,Cinel; Cameron Alexander,17,0,30,13
1657605989743,MATH 18,A03,083745,Cinel; Cameron Alexander,9,0,30,21
1657605989743,MATH 18,B01,083748,Rideout; David Porter,5,0,37,32
1657605989743,MATH 18,B02,083749,Rideout; David Porter,5,0,36,31
1657605989743,MATH 18,B03,083750,Rideout; David Porter,3,0,37,34
1657605989743,MATH 18,B04,083751,Rideout; David Porter,6,0,36,30
1657605989743,MATH 18,B05,093473,Rideout; David Porter,6,0,36,30
1657605989743,MATH 18,B06,093474,Rideout; David Porter,6,0,36,30
1657605995766,MATH 20A,A01,083754,Zheng; Zequn,14,0,40,26
1657606001792,MATH 20B,A01,083756,Briones; Jor-el Thomas Caparas,4,0,36,32
1657606001792,MATH 20B,A02,083757,Briones; Jor-el Thomas Caparas,1,0,36,35
1657606001792,MATH 20B,A03,093475,Briones; Jor-el Thomas Caparas,2,0,36,34
1657606007819,MATH 20C,A01,083760,Briones; Jor-el Thomas Caparas,1,0,35,34
1657606007819,MATH 20C,A02,083761,Briones; Jor-el Thomas Caparas,8,0,35,27
1657606007819,MATH 20C,A03,093476,Briones; Jor-el Thomas Caparas,0,1,36,36
1657606007819,MATH 20C,B01,083762,Bach; Quang Tran,1,0,30,29
1657606013843,MATH 20D,A01,083765,Tran; Brian Kha,5,0,30,25
1657606013843,MATH 20D,A02,083766,Tran; Brian Kha,5,0,30,25
1657606013843,MATH 20D,A03,083767,Tran; Brian Kha,5,0,30,25
1657606019868,MATH 20E,A01,083771,Ganguly; Soumya,9,0,32,23
1657606019868,MATH 20E,A02,083772,Ganguly; Soumya,6,0,32,26
1657606019868,MATH 20E,B01,083773,Ciotti; Benjamin,20,0,35,15
1657606019868,MATH 20E,B02,083774,Ciotti; Benjamin,18,0,35,17
1657606025899,MATH 103A,A01,083777,Greenfeld; Be'Eri,3,0,36,33
1657606025899,MATH 103A,A02,083778,Greenfeld; Be'Eri,5,0,36,31
1657606025899,MATH 103A,A03,093561,Greenfeld; Be'Eri,6,0,36,30
1657606025899,MATH 103A,B01,083779,Greenfeld; Be'Eri,7,0,36,29
1657606025899,MATH 103A,B02,083780,Greenfeld; Be'Eri,4,0,36,32
1657606025899,MATH 103A,B03,093562,Greenfeld; Be'Eri,3,0,36,33
1657606031923,MATH 105,A01,085443,Carter; Anne Toulson,15,0,35,20
1657606031923,MATH 105,A02,093477,Carter; Anne Toulson,20,0,35,15
1657606037946,MATH 109,A01,083213,Ganzberger; Geoffrey Michael,2,0,34,32
1657606037946,MATH 109,A02,083214,Ganzberger; Geoffrey Michael,4,0,34,30
1657606037946,MATH 109,A03,093478,Ganzberger; Geoffrey Michael,2,0,34,32
1657606037946,MATH 109,B01,083215,Ganzberger; Geoffrey Michael,1,0,32,31
1657606037946,MATH 109,B02,083216,Ganzberger; Geoffrey Michael,2,0,32,30
1657606037946,MATH 109,B03,093479,Ganzberger; Geoffrey Michael,8,0,32,24
1657606043976,MATH 142A,A01,083219,Chow; Bennett,7,0,32,25
1657606043976,MATH 142A,A02,083220,Chow; Bennett,10,0,32,22
1657606043976,MATH 142A,A03,093480,Chow; Bennett,9,0,32,23
1657606043976,MATH 142A,B03,093481,Chow; Bennett,8,0,32,24
1657606043976,MATH 142A,B04,093558,Chow; Bennett,13,0,32,19
1657606043976,MATH 142A,B05,093559,Chow; Bennett,6,0,32,26
1657606050001,MATH 193A,A01,083224,Rotar; Vladimir,8,0,34,26
1657606050001,MATH 193A,A02,083225,Rotar; Vladimir,9,0,34,25
1657606050001,MATH 193A,A03,083781,Rotar; Vladimir,5,0,34,29
1657606050001,MATH 193A,A04,083782,Rotar; Vladimir,10,0,34,24
1657606050001,MATH 193A,A05,093482,Rotar; Vladimir,10,0,34,24
1657606056035,MATH 197,001,091859,McAuley; Julian John,9999,0,9999,0
1657606056035,MATH 197,002,095566,Kedlaya; Kiran S.,9997,0,9999,2
1657606056035,MATH 197,003,095567,Xiao; Ming,9999,0,9999,0
1657606056035,MATH 197,004,095571,Perols; Johan Lars,9998,0,9999,1
1657606063095,COGS 9,A01,083615,Shannon; Kyle Michael,9,0,75,66
1657606069126,COGS 11,A01,083617,Boyle; Mary E. T.,23,0,48,25
1657606075154,COGS 13,A01,083071,Bastos; Amalia Pinkusfeld,11,0,71,60
1657606081184,COGS 14A,A01,092681,Semenuks; Arturs,5,1,100,95
1657606087218,COGS 14B,A01,083073,Cheng; Tzu-Han,6,0,63,57
1657606093241,COGS 17,A01,092677,Semenuks; Arturs,6,0,81,75
1657606099265,COGS 100,A01,083619,Allen; Michael Gordon,17,0,70,53
1657606105293,COGS 101A,A01,083621,Davis; Joshua Daniel,9,0,68,59
1657606111319,COGS 101B,A01,091572,Allen; Michael Gordon,12,0,65,53
1657606117342,COGS 101C,A01,083625,Delgado; Tania,17,0,35,18
1657606123366,COGS 107A,A01,083627,Boyle; Mary E. T.,13,0,60,47
1657606129390,COGS 118A,A01,083075,Gupta; Anjum,21,0,76,55
1657606135420,CSE 3,A50,083646,Miranda; Gregory Joseph,24,0,50,26
1657606141446,CSE 8A,A50,083650,Miranda; Gregory Joseph,17,1,56,39
1657606147471,CSE 11,A01,083080,Cao; Yingjun,6,15,40,34
1657606153494,CSE 12,A01,083652,Krause-Levy; Sophia Louisa,28,1,120,92
1657606159523,CSE 15L,A01,083654,Morris; Justin Loren,9,0,50,41
1657606159523,CSE 15L,A02,083655,Morris; Justin Loren,9,0,50,41
1657606165545,CSE 20,A01,083657,Tran; Khoa Dang,39,0,80,41
1657606171568,CSE 21,A01,095574,Bach; Quang Tran,22,0,48,26
1657606177592,CSE 30,A01,083084,Eldon; John,5,0,80,75
1657606177592,CSE 30,B01,095061,Bhaskar; Nishant,9,0,50,41
1657606183617,CSE 100,A01,083659,Cao; Yingjun,5,4,70,65
1657606189642,CSE 134B,A01,083661,Powell; Thomas Allan,22,0,100,78
1657606195676,CSE 140,A01,083663,Gungor; Onat,15,0,85,70
1657606201699,CSE 140L,A01,083088,Eldon; John,21,0,100,79
1657606207722,CSE 175,A01,083665,Kumar; Rakesh,3,0,25,22
1657606213746,CSE 190,A00,092507,Dubnov; Shlomo,8,0,20,12
1657606219779,ECE 45,A01,083139,Congero; Spencer William,6,0,75,69
1657606225801,ECE 65,A50,083695,Saad; Andrew S,12,0,30,18
1657606225801,ECE 65,A51,095125,Saad; Andrew S,24,0,26,2
1657606231822,ECE 109,A01,091882,Touri; Behrouz,19,0,70,51
1657606237851,ECE 180,A00,083140,Abi Samra; Nicholas Camill,1,0,30,29
1657606237851,ECE 180,B00,083141,Abi Samra; Nicholas Camill,0,0,30,30
1657606243880,MATH 10A,A01,083735,Patchell; Gregory David,2,0,30,28
1657606243880,MATH 10A,A02,083736,Patchell; Gregory David,20,0,30,10
1657606243880,MATH 10A,A03,083737,Patchell; Gregory David,16,0,30,14
1657606249912,MATH 10B,A01,083207,Lim; Seonhee,8,0,34,26
1657606249912,MATH 10B,A02,083208,Lim; Seonhee,9,0,35,26
1657606249912,MATH 10B,A03,093472,Lim; Seonhee,7,0,34,27
1657606249912,MATH 10B,B01,083739,Sinha; Shubham,12,0,30,18
1657606255945,MATH 18,A01,083743,Cinel; Cameron Alexander,7,0,30,23
1657606255945,MATH 18,A02,083744,Cinel; Cameron Alexander,17,0,30,13
1657606255945,MATH 18,A03,083745,Cinel; Cameron Alexander,9,0,30,21
1657606255945,MATH 18,B01,083748,Rideout; David Porter,5,0,37,32
1657606255945,MATH 18,B02,083749,Rideout; David Porter,5,0,36,31
1657606255945,MATH 18,B03,083750,Rideout; David Porter,3,0,37,34
1657606255945,MATH 18,B04,083751,Rideout; David Porter,6,0,36,30
1657606255945,MATH 18,B05,093473,Rideout; David Porter,6,0,36,30
1657606255945,MATH 18,B06,093474,Rideout; David Porter,6,0,36,30
1657606261969,MATH 20A,A01,083754,Zheng; Zequn,14,0,40,26
1657606267996,MATH 20B,A01,083756,Briones; Jor-el Thomas Caparas,4,0,36,32
1657606267996,MATH 20B,A02,083757,Briones; Jor-el Thomas Caparas,1,0,36,35
1657606267996,MATH 20B,A03,093475,Briones; Jor-el Thomas Caparas,2,0,36,34
1657606274027,MATH 20C,A01,083760,Briones; Jor-el Thomas Caparas,1,0,35,34
1657606274027,MATH 20C,A02,083761,Briones; Jor-el Thomas Caparas,8,0,35,27
1657606274027,MATH 20C,A03,093476,Briones; Jor-el Thomas Caparas,0,1,36,36
1657606274027,MATH 20C,B01,083762,Bach; Quang Tran,1,0,30,29
1657606280053,MATH 20D,A01,083765,Tran; Brian Kha,5,0,30,25
1657606280053,MATH 20D,A02,083766,Tran; Brian Kha,5,0,30,25
1657606280053,MATH 20D,A03,083767,Tran; Brian Kha,5,0,30,25
1657606286081,MATH 20E,A01,083771,Ganguly; Soumya,9,0,32,23
1657606286081,MATH 20E,A02,083772,Ganguly; Soumya,6,0,32,26
1657606286081,MATH 20E,B01,083773,Ciotti; Benjamin,20,0,35,15
1657606286081,MATH 20E,B02,083774,Ciotti; Benjamin,18,0,35,17
1657606292105,MATH 103A,A01,083777,Greenfeld; Be'Eri,3,0,36,33
1657606292105,MATH 103A,A02,083778,Greenfeld; Be'Eri,5,0,36,31
1657606292105,MATH 103A,A03,093561,Greenfeld; Be'Eri,6,0,36,30
1657606292105,MATH 103A,B01,083779,Greenfeld; Be'Eri,7,0,36,29
1657606292105,MATH 103A,B02,083780,Greenfeld; Be'Eri,4,0,36,32
1657606292105,MATH 103A,B03,093562,Greenfeld; Be'Eri,3,0,36,33
1657606298129,MATH 105,A01,085443,Carter; Anne Toulson,15,0,35,20
1657606298129,MATH 105,A02,093477,Carter; Anne Toulson,20,0,35,15
1657606304154,MATH 109,A01,083213,Ganzberger; Geoffrey Michael,2,0,34,32
1657606304154,MATH 109,A02,083214,Ganzberger; Geoffrey Michael,4,0,34,30
1657606304154,MATH 109,A03,093478,Ganzberger; Geoffrey Michael,2,0,34,32
1657606304154,MATH 109,B01,083215,Ganzberger; Geoffrey Michael,1,0,32,31
1657606304154,MATH 109,B02,083216,Ganzberger; Geoffrey Michael,2,0,32,30
1657606304154,MATH 109,B03,093479,Ganzberger; Geoffrey Michael,8,0,32,24
1657606310183,MATH 142A,A01,083219,Chow; Bennett,7,0,32,25
1657606310183,MATH 142A,A02,083220,Chow; Bennett,10,0,32,22
1657606310183,MATH 142A,A03,093480,Chow; Bennett,9,0,32,23
1657606310183,MATH 142A,B03,093481,Chow; Bennett,8,0,32,24
1657606310183,MATH 142A,B04,093558,Chow; Bennett,13,0,32,19
1657606310183,MATH 142A,B05,093559,Chow; Bennett,6,0,32,26
1657606316208,MATH 193A,A01,083224,Rotar; Vladimir,8,0,34,26
1657606316208,MATH 193A,A02,083225,Rotar; Vladimir,9,0,34,25
1657606316208,MATH 193A,A03,083781,Rotar; Vladimir,5,0,34,29
1657606316208,MATH 193A,A04,083782,Rotar; Vladimir,10,0,34,24
1657606316208,MATH 193A,A05,093482,Rotar; Vladimir,10,0,34,24
1657606322230,MATH 197,001,091859,McAuley; Julian John,9999,0,9999,0
1657606322230,MATH 197,002,095566,Kedlaya; Kiran S.,9997,0,9999,2
1657606322230,MATH 197,003,095567,Xiao; Ming,9999,0,9999,0
1657606322230,MATH 197,004,095571,Perols; Johan Lars,9998,0,9999,1
1657606329300,COGS 9,A01,083615,Shannon; Kyle Michael,9,0,75,66
1657606335324,COGS 11,A01,083617,Boyle; Mary E. T.,23,0,48,25
1657606341351,COGS 13,A01,083071,Bastos; Amalia Pinkusfeld,11,0,71,60
1657606347379,COGS 14A,A01,092681,Semenuks; Arturs,5,1,100,95
1657606353403,COGS 14B,A01,083073,Cheng; Tzu-Han,6,0,63,57
1657606359426,COGS 17,A01,092677,Semenuks; Arturs,6,0,81,75
1657606365452,COGS 100,A01,083619,Allen; Michael Gordon,17,0,70,53
1657606371482,COGS 101A,A01,083621,Davis; Joshua Daniel,9,0,68,59
1657606377517,COGS 101B,A01,091572,Allen; Michael Gordon,12,0,65,53
1657606383543,COGS 101C,A01,083625,Delgado; Tania,17,0,35,18
1657606389566,COGS 107A,A01,083627,Boyle; Mary E. T.,13,0,60,47
1657606395593,COGS 118A,A01,083075,Gupta; Anjum,21,0,76,55
1657606401618,CSE 3,A50,083646,Miranda; Gregory Joseph,24,0,50,26
1657606407646,CSE 8A,A50,083650,Miranda; Gregory Joseph,17,1,56,39
1657606413672,CSE 11,A01,083080,Cao; Yingjun,6,15,40,34
1657606419697,CSE 12,A01,083652,Krause-Levy; Sophia Louisa,28,1,120,92
1657606425719,CSE 15L,A01,083654,Morris; Justin Loren,9,0,50,41
1657606425719,CSE 15L,A02,083655,Morris; Justin Loren,9,0,50,41
1657606431743,CSE 20,A01,083657,Tran; Khoa Dang,39,0,80,41
1657606437765,CSE 21,A01,095574,Bach; Quang Tran,22,0,48,26
1657606443794,CSE 30,A01,083084,Eldon; John,5,0,80,75
1657606443794,CSE 30,B01,095061,Bhaskar; Nishant,9,0,50,41
1657606449816,CSE 100,A01,083659,Cao; Yingjun,5,4,70,65
1657606455839,CSE 134B,A01,083661,Powell; Thomas Allan,22,0,100,78
1657606461863,CSE 140,A01,083663,Gungor; Onat,15,0,85,70
1657606467886,CSE 140L,A01,083088,Eldon; John,21,0,100,79
1657606473997,CSE 175,A01,083665,Kumar; Rakesh,3,0,25,22
1657606480023,CSE 190,A00,092507,Dubnov; Shlomo,8,0,20,12
1657606486047,ECE 45,A01,083139,Congero; Spencer William,6,0,75,69
1657606492082,ECE 65,A50,083695,Saad; Andrew S,12,0,30,18
1657606492082,ECE 65,A51,095125,Saad; Andrew S,24,0,26,2
1657606498108,ECE 109,A01,091882,Touri; Behrouz,19,0,70,51
1657606504134,ECE 180,A00,083140,Abi Samra; Nicholas Camill,1,0,30,29
1657606504134,ECE 180,B00,083141,Abi Samra; Nicholas Camill,0,0,30,30
1657606510159,MATH 10A,A01,083735,Patchell; Gregory David,2,0,30,28
1657606510159,MATH 10A,A02,083736,Patchell; Gregory David,20,0,30,10
1657606510159,MATH 10A,A03,083737,Patchell; Gregory David,16,0,30,14
1657606516183,MATH 10B,A01,083207,Lim; Seonhee,8,0,34,26
1657606516183,MATH 10B,A02,083208,Lim; Seonhee,9,0,35,26
1657606516183,MATH 10B,A03,093472,Lim; Seonhee,7,0,34,27
1657606516183,MATH 10B,B01,083739,Sinha; Shubham,12,0,30,18
1657606522209,MATH 18,A01,083743,Cinel; Cameron Alexander,7,0,30,23
1657606522209,MATH 18,A02,083744,Cinel; Cameron Alexander,17,0,30,13
1657606522209,MATH 18,A03,083745,Cinel; Cameron Alexander,9,0,30,21
1657606522209,MATH 18,B01,083748,Rideout; David Porter,5,0,37,32
1657606522209,MATH 18,B02,083749,Rideout; David Porter,5,0,36,31
1657606522209,MATH 18,B03,083750,Rideout; David Porter,3,0,37,34
1657606522209,MATH 18,B04,083751,Rideout; David Porter,6,0,36,30
1657606522209,MATH 18,B05,093473,Rideout; David Porter,6,0,36,30
1657606522209,MATH 18,B06,093474,Rideout; David Porter,6,0,36,30
1657606528236,MATH 20A,A01,083754,Zheng; Zequn,14,0,40,26
1657606534272,MATH 20B,A01,083756,Briones; Jor-el Thomas Caparas,4,0,36,32
1657606534272,MATH 20B,A02,083757,Briones; Jor-el Thomas Caparas,1,0,36,35
1657606534272,MATH 20B,A03,093475,Briones; Jor-el Thomas Caparas,2,0,36,34
1657606540296,MATH 20C,A01,083760,Briones; Jor-el Thomas Caparas,1,0,35,34
1657606540296,MATH 20C,A02,083761,Briones; Jor-el Thomas Caparas,8,0,35,27
1657606540296,MATH 20C,A03,093476,Briones; Jor-el Thomas Caparas,0,1,36,36
1657606540296,MATH 20C,B01,083762,Bach; Quang Tran,1,0,30,29
1657606546325,MATH 20D,A01,083765,Tran; Brian Kha,5,0,30,25
1657606546325,MATH 20D,A02,083766,Tran; Brian Kha,5,0,30,25
1657606546325,MATH 20D,A03,083767,Tran; Brian Kha,5,0,30,25
1657606552357,MATH 20E,A01,083771,Ganguly; Soumya,9,0,32,23
1657606552357,MATH 20E,A02,083772,Ganguly; Soumya,6,0,32,26
1657606552357,MATH 20E,B01,083773,Ciotti; Benjamin,20,0,35,15
1657606552357,MATH 20E,B02,083774,Ciotti; Benjamin,18,0,35,17
1657606558382,MATH 103A,A01,083777,Greenfeld; Be'Eri,3,0,36,33
1657606558382,MATH 103A,A02,083778,Greenfeld; Be'Eri,5,0,36,31
1657606558382,MATH 103A,A03,093561,Greenfeld; Be'Eri,6,0,36,30
1657606558382,MATH 103A,B01,083779,Greenfeld; Be'Eri,7,0,36,29
1657606558382,MATH 103A,B02,083780,Greenfeld; Be'Eri,4,0,36,32
1657606558382,MATH 103A,B03,093562,Greenfeld; Be'Eri,3,0,36,33
1657606564407,MATH 105,A01,085443,Carter; Anne Toulson,15,0,35,20
1657606564407,MATH 105,A02,093477,Carter; Anne Toulson,20,0,35,15
1657606570435,MATH 109,A01,083213,Ganzberger; Geoffrey Michael,2,0,34,32
1657606570435,MATH 109,A02,083214,Ganzberger; Geoffrey Michael,4,0,34,30
1657606570435,MATH 109,A03,093478,Ganzberger; Geoffrey Michael,2,0,34,32
1657606570435,MATH 109,B01,083215,Ganzberger; Geoffrey Michael,1,0,32,31
1657606570435,MATH 109,B02,083216,Ganzberger; Geoffrey Michael,2,0,32,30
1657606570435,MATH 109,B03,093479,Ganzberger; Geoffrey Michael,8,0,32,24
1657606576467,MATH 142A,A01,083219,Chow; Bennett,7,0,32,25
1657606576467,MATH 142A,A02,083220,Chow; Bennett,10,0,32,22
1657606576467,MATH 142A,A03,093480,Chow; Bennett,9,0,32,23
1657606576467,MATH 142A,B03,093481,Chow; Bennett,8,0,32,24
1657606576467,MATH 142A,B04,093558,Chow; Bennett,13,0,32,19
1657606576467,MATH 142A,B05,093559,Chow; Bennett,6,0,32,26
1657606582498,MATH 193A,A01,083224,Rotar; Vladimir,8,0,34,26
1657606582498,MATH 193A,A02,083225,Rotar; Vladimir,9,0,34,25
1657606582498,MATH 193A,A03,083781,Rotar; Vladimir,5,0,34,29
1657606582498,MATH 193A,A04,083782,Rotar; Vladimir,10,0,34,24
1657606582498,MATH 193A,A05,093482,Rotar; Vladimir,10,0,34,24
1657606588524,MATH 197,001,091859,McAuley; Julian John,9999,0,9999,0
1657606588524,MATH 197,002,095566,Kedlaya; Kiran S.,9997,0,9999,2
1657606588524,MATH 197,003,095567,Xiao; Ming,9999,0,9999,0
1657606588524,MATH 197,004,095571,Perols; Johan Lars,9998,0,9999,1
1657606595575,COGS 9,A01,083615,Shannon; Kyle Michael,9,0,75,66
1657606601598,COGS 11,A01,083617,Boyle; Mary E. T.,23,0,48,25
1657606607625,COGS 13,A01,083071,Bastos; Amalia Pinkusfeld,11,0,71,60
1657606613648,COGS 14A,A01,092681,Semenuks; Arturs,5,1,100,95
1657606619677,COGS 14B,A01,083073,Cheng; Tzu-Han,6,0,63,57
1657606625706,COGS 17,A01,092677,Semenuks; Arturs,6,0,81,75
1657606631728,COGS 100,A01,083619,Allen; Michael Gordon,17,0,70,53
1657606637755,COGS 101A,A01,083621,Davis; Joshua Daniel,9,0,68,59
1657606643782,COGS 101B,A01,091572,Allen; Michael Gordon,12,0,65,53
1657606649804,COGS 101C,A01,083625,Delgado; Tania,17,0,35,18
1657606655832,COGS 107A,A01,083627,Boyle; Mary E. T.,13,0,60,47
1657606661856,COGS 118A,A01,083075,Gupta; Anjum,21,0,76,55
1657606667882,CSE 3,A50,083646,Miranda; Gregory Joseph,24,0,50,26
1657606673910,CSE 8A,A50,083650,Miranda; Gregory Joseph,17,1,56,39
1657606679934,CSE 11,A01,083080,Cao; Yingjun,6,15,40,34
1657606685963,CSE 12,A01,083652,Krause-Levy; Sophia Louisa,28,1,120,92
1657606691990,CSE 15L,A01,083654,Morris; Justin Loren,9,0,50,41
1657606691990,CSE 15L,A02,083655,Morris; Justin Loren,9,0,50,41
1657606698013,CSE 20,A01,083657,Tran; Khoa Dang,39,0,80,41
1657606704038,CSE 21,A01,095574,Bach; Quang Tran,22,0,48,26
1657606710061,CSE 30,A01,083084,Eldon; John,5,0,80,75
1657606710061,CSE 30,B01,095061,Bhaskar; Nishant,9,0,50,41
1657606716087,CSE 100,A01,083659,Cao; Yingjun,5,4,70,65
1657606722111,CSE 134B,A01,083661,Powell; Thomas Allan,22,0,100,78
1657606728133,CSE 140,A01,083663,Gungor; Onat,15,0,85,70
1657606734159,CSE 140L,A01,083088,Eldon; John,21,0,100,79
1657606740184,CSE 175,A01,083665,Kumar; Rakesh,3,0,25,22
1657606746207,CSE 190,A00,092507,Dubnov; Shlomo,8,0,20,12
1657606752234,ECE 45,A01,083139,Congero; Spencer William,6,0,75,69
1657606758261,ECE 65,A50,083695,Saad; Andrew S,12,0,30,18
1657606758261,ECE 65,A51,095125,Saad; Andrew S,24,0,26,2
1657606764286,ECE 109,A01,091882,Touri; Behrouz,19,0,70,51
1657606770310,ECE 180,A00,083140,Abi Samra; Nicholas Camill,1,0,30,29
1657606770310,ECE 180,B00,083141,Abi Samra; Nicholas Camill,0,0,30,30
1657606776334,MATH 10A,A01,083735,Patchell; Gregory David,2,0,30,28
1657606776334,MATH 10A,A02,083736,Patchell; Gregory David,20,0,30,10
1657606776334,MATH 10A,A03,083737,Patchell; Gregory David,16,0,30,14
1657606782363,MATH 10B,A01,083207,Lim; Seonhee,8,0,34,26
1657606782363,MATH 10B,A02,083208,Lim; Seonhee,9,0,35,26
1657606782363,MATH 10B,A03,093472,Lim; Seonhee,7,0,34,27
1657606782363,MATH 10B,B01,083739,Sinha; Shubham,12,0,30,18
1657606788388,MATH 18,A01,083743,Cinel; Cameron Alexander,7,0,30,23
1657606788388,MATH 18,A02,083744,Cinel; Cameron Alexander,17,0,30,13
1657606788388,MATH 18,A03,083745,Cinel; Cameron Alexander,9,0,30,21
1657606788388,MATH 18,B01,083748,Rideout; David Porter,5,0,37,32
1657606788388,MATH 18,B02,083749,Rideout; David Porter,5,0,36,31
1657606788388,MATH 18,B03,083750,Rideout; David Porter,3,0,37,34
1657606788388,MATH 18,B04,083751,Rideout; David Porter,6,0,36,30
1657606788388,MATH 18,B05,093473,Rideout; David Porter,6,0,36,30
1657606788388,MATH 18,B06,093474,Rideout; David Porter,6,0,36,30
1657606794411,MATH 20A,A01,083754,Zheng; Zequn,14,0,40,26
1657606800445,MATH 20B,A01,083756,Briones; Jor-el Thomas Caparas,4,0,36,32
1657606800445,MATH 20B,A02,083757,Briones; Jor-el Thomas Caparas,1,0,36,35
1657606800445,MATH 20B,A03,093475,Briones; Jor-el Thomas Caparas,2,0,36,34
1657606806470,MATH 20C,A01,083760,Briones; Jor-el Thomas Caparas,1,0,35,34
1657606806470,MATH 20C,A02,083761,Briones; Jor-el Thomas Caparas,8,0,35,27
1657606806470,MATH 20C,A03,093476,Briones; Jor-el Thomas Caparas,0,1,36,36
1657606806470,MATH 20C,B01,083762,Bach; Quang Tran,1,0,30,29
1657606812493,MATH 20D,A01,083765,Tran; Brian Kha,5,0,30,25
1657606812493,MATH 20D,A02,083766,Tran; Brian Kha,5,0,30,25
1657606812493,MATH 20D,A03,083767,Tran; Brian Kha,5,0,30,25
1657606818516,MATH 20E,A01,083771,Ganguly; Soumya,9,0,32,23
1657606818516,MATH 20E,A02,083772,Ganguly; Soumya,6,0,32,26
1657606818516,MATH 20E,B01,083773,Ciotti; Benjamin,20,0,35,15
1657606818516,MATH 20E,B02,083774,Ciotti; Benjamin,18,0,35,17
1657606824550,MATH 103A,A01,083777,Greenfeld; Be'Eri,3,0,36,33
1657606824550,MATH 103A,A02,083778,Greenfeld; Be'Eri,5,0,36,31
1657606824550,MATH 103A,A03,093561,Greenfeld; Be'Eri,6,0,36,30
1657606824550,MATH 103A,B01,083779,Greenfeld; Be'Eri,7,0,36,29
1657606824550,MATH 103A,B02,083780,Greenfeld; Be'Eri,4,0,36,32
1657606824550,MATH 103A,B03,093562,Greenfeld; Be'Eri,3,0,36,33
1657606830582,MATH 105,A01,085443,Carter; Anne Toulson,15,0,35,20
1657606830582,MATH 105,A02,093477,Carter; Anne Toulson,20,0,35,15
1657606836611,MATH 109,A01,083213,Ganzberger; Geoffrey Michael,2,0,34,32
1657606836611,MATH 109,A02,083214,Ganzberger; Geoffrey Michael,4,0,34,30
1657606836611,MATH 109,A03,093478,Ganzberger; Geoffrey Michael,2,0,34,32
1657606836611,MATH 109,B01,083215,Ganzberger; Geoffrey Michael,1,0,32,31
1657606836611,MATH 109,B02,083216,Ganzberger; Geoffrey Michael,2,0,32,30
1657606836611,MATH 109,B03,093479,Ganzberger; Geoffrey Michael,8,0,32,24
1657606842636,MATH 142A,A01,083219,Chow; Bennett,7,0,32,25
1657606842636,MATH 142A,A02,083220,Chow; Bennett,10,0,32,22
1657606842636,MATH 142A,A03,093480,Chow; Bennett,9,0,32,23
1657606842636,MATH 142A,B03,093481,Chow; Bennett,8,0,32,24
1657606842636,MATH 142A,B04,093558,Chow; Bennett,13,0,32,19
1657606842636,MATH 142A,B05,093559,Chow; Bennett,6,0,32,26
1657606848658,MATH 193A,A01,083224,Rotar; Vladimir,8,0,34,26
1657606848658,MATH 193A,A02,083225,Rotar; Vladimir,9,0,34,25
1657606848658,MATH 193A,A03,083781,Rotar; Vladimir,5,0,34,29
1657606848658,MATH 193A,A04,083782,Rotar; Vladimir,10,0,34,24
1657606848658,MATH 193A,A05,093482,Rotar; Vladimir,10,0,34,24
1657606854681,MATH 197,001,091859,McAuley; Julian John,9999,0,9999,0
1657606854681,MATH 197,002,095566,Kedlaya; Kiran S.,9997,0,9999,2
1657606854681,MATH 197,003,095567,Xiao; Ming,9999,0,9999,0
1657606854681,MATH 197,004,095571,Perols; Johan Lars,9998,0,9999,1
1657606861755,COGS 9,A01,083615,Shannon; Kyle Michael,9,0,75,66
1657606867778,COGS 11,A01,083617,Boyle; Mary E. T.,23,0,48,25
1657606873806,COGS 13,A01,083071,Bastos; Amalia Pinkusfeld,11,0,71,60
1657606879837,COGS 14A,A01,092681,Semenuks; Arturs,5,1,100,95
1657606885862,COGS 14B,A01,083073,Cheng; Tzu-Han,6,0,63,57
1657606891886,COGS 17,A01,092677,Semenuks; Arturs,6,0,81,75
1657606897911,COGS 100,A01,083619,Allen; Michael Gordon,17,0,70,53
1657606903939,COGS 101A,A01,083621,Davis; Joshua Daniel,9,0,68,59
1657606909974,COGS 101B,A01,091572,Allen; Michael Gordon,12,0,65,53
1657606915997,COGS 101C,A01,083625,Delgado; Tania,17,0,35,18
1657606922024,COGS 107A,A01,083627,Boyle; Mary E. T.,13,0,60,47
1657606928051,COGS 118A,A01,083075,Gupta; Anjum,21,0,76,55
1657606934076,CSE 3,A50,083646,Miranda; Gregory Joseph,24,0,50,26
1657606940098,CSE 8A,A50,083650,Miranda; Gregory Joseph,17,1,56,39
1657606946121,CSE 11,A01,083080,Cao; Yingjun,6,15,40,34
1657606952145,CSE 12,A01,083652,Krause-Levy; Sophia Louisa,28,1,120,92
1657606958169,CSE 15L,A01,083654,Morris; Justin Loren,9,0,50,41
1657606958169,CSE 15L,A02,083655,Morris; Justin Loren,9,0,50,41
1657606964194,CSE 20,A01,083657,Tran; Khoa Dang,39,0,80,41
1657606970216,CSE 21,A01,095574,Bach; Quang Tran,22,0,48,26
1657606976240,CSE 30,A01,083084,Eldon; John,5,0,80,75
1657606976240,CSE 30,B01,095061,Bhaskar; Nishant,9,0,50,41
1657606982264,CSE 100,A01,083659,Cao; Yingjun,5,4,70,65
1657606988290,CSE 134B,A01,083661,Powell; Thomas Allan,22,0,100,78
1657606994313,CSE 140,A01,083663,Gungor; Onat,15,0,85,70
1657607000338,CSE 140L,A01,083088,Eldon; John,21,0,100,79
1657607006361,CSE 175,A01,083665,Kumar; Rakesh,3,0,25,22
1657607012390,CSE 190,A00,092507,Dubnov; Shlomo,8,0,20,12
1657607018414,ECE 45,A01,083139,Congero; Spencer William,6,0,75,69
1657607024441,ECE 65,A50,083695,Saad; Andrew S,12,0,30,18
1657607024441,ECE 65,A51,095125,Saad; Andrew S,24,0,26,2
1657607030468,ECE 109,A01,091882,Touri; Behrouz,19,0,70,51
1657607036495,ECE 180,A00,083140,Abi Samra; Nicholas Camill,1,0,30,29
1657607036495,ECE 180,B00,083141,Abi Samra; Nicholas Camill,0,0,30,30
1657607042519,MATH 10A,A01,083735,Patchell; Gregory David,2,0,30,28
1657607042519,MATH 10A,A02,083736,Patchell; Gregory David,20,0,30,10
1657607042519,MATH 10A,A03,083737,Patchell; Gregory David,16,0,30,14
1657607048543,MATH 10B,A01,083207,Lim; Seonhee,8,0,34,26
1657607048543,MATH 10B,A02,083208,Lim; Seonhee,9,0,35,26
1657607048543,MATH 10B,A03,093472,Lim; Seonhee,7,0,34,27
1657607048543,MATH 10B,B01,083739,Sinha; Shubham,12,0,30,18
1657607054576,MATH 18,A01,083743,Cinel; Cameron Alexander,7,0,30,23
1657607054576,MATH 18,A02,083744,Cinel; Cameron Alexander,17,0,30,13
1657607054576,MATH 18,A03,083745,Cinel; Cameron Alexander,9,0,30,21
1657607054576,MATH 18,B01,083748,Rideout; David Porter,5,0,37,32
1657607054576,MATH 18,B02,083749,Rideout; David Porter,5,0,36,31
1657607054576,MATH 18,B03,083750,Rideout; David Porter,3,0,37,34
1657607054576,MATH 18,B04,083751,Rideout; David Porter,6,0,36,30
1657607054576,MATH 18,B05,093473,Rideout; David Porter,6,0,36,30
1657607054576,MATH 18,B06,093474,Rideout; David Porter,6,0,36,30
1657607060599,MATH 20A,A01,083754,Zheng; Zequn,14,0,40,26
1657607066627,MATH 20B,A01,083756,Briones; Jor-el Thomas Caparas,4,0,36,32
1657607066627,MATH 20B,A02,083757,Briones; Jor-el Thomas Caparas,1,0,36,35
1657607066627,MATH 20B,A03,093475,Briones; Jor-el Thomas Caparas,2,0,36,34
1657607072723,MATH 20C,A01,083760,Briones; Jor-el Thomas Caparas,1,0,35,34
1657607072723,MATH 20C,A02,083761,Briones; Jor-el Thomas Caparas,8,0,35,27
1657607072723,MATH 20C,A03,093476,Briones; Jor-el Thomas Caparas,0,1,36,36
1657607072723,MATH 20C,B01,083762,Bach; Quang Tran,1,0,30,29
1657607078746,MATH 20D,A01,083765,Tran; Brian Kha,5,0,30,25
1657607078746,MATH 20D,A02,083766,Tran; Brian Kha,5,0,30,25
1657607078746,MATH 20D,A03,083767,Tran; Brian Kha,5,0,30,25
1657607084767,MATH 20E,A01,083771,Ganguly; Soumya,9,0,32,23
1657607084767,MATH 20E,A02,083772,Ganguly; Soumya,6,0,32,26
1657607084767,MATH 20E,B01,083773,Ciotti; Benjamin,20,0,35,15
1657607084767,MATH 20E,B02,083774,Ciotti; Benjamin,18,0,35,17
1657607090791,MATH 103A,A01,083777,Greenfeld; Be'Eri,3,0,36,33
1657607090791,MATH 103A,A02,083778,Greenfeld; Be'Eri,5,0,36,31
1657607090791,MATH 103A,A03,093561,Greenfeld; Be'Eri,6,0,36,30
1657607090791,MATH 103A,B01,083779,Greenfeld; Be'Eri,7,0,36,29
1657607090791,MATH 103A,B02,083780,Greenfeld; Be'Eri,4,0,36,32
1657607090791,MATH 103A,B03,093562,Greenfeld; Be'Eri,3,0,36,33
1657607096821,MATH 105,A01,085443,Carter; Anne Toulson,15,0,35,20
1657607096821,MATH 105,A02,093477,Carter; Anne Toulson,20,0,35,15
1657607102846,MATH 109,A01,083213,Ganzberger; Geoffrey Michael,2,0,34,32
1657607102846,MATH 109,A02,083214,Ganzberger; Geoffrey Michael,4,0,34,30
1657607102846,MATH 109,A03,093478,Ganzberger; Geoffrey Michael,2,0,34,32
1657607102846,MATH 109,B01,083215,Ganzberger; Geoffrey Michael,1,0,32,31
1657607102846,MATH 109,B02,083216,Ganzberger; Geoffrey Michael,2,0,32,30
1657607102846,MATH 109,B03,093479,Ganzberger; Geoffrey Michael,8,0,32,24
1657607108869,MATH 142A,A01,083219,Chow; Bennett,7,0,32,25
1657607108869,MATH 142A,A02,083220,Chow; Bennett,10,0,32,22
1657607108869,MATH 142A,A03,093480,Chow; Bennett,9,0,32,23
1657607108869,MATH 142A,B03,093481,Chow; Bennett,8,0,32,24
1657607108869,MATH 142A,B04,093558,Chow; Bennett,13,0,32,19
1657607108869,MATH 142A,B05,093559,Chow; Bennett,6,0,32,26
1657607114892,MATH 193A,A01,083224,Rotar; Vladimir,8,0,34,26
1657607114892,MATH 193A,A02,083225,Rotar; Vladimir,9,0,34,25
1657607114892,MATH 193A,A03,083781,Rotar; Vladimir,5,0,34,29
1657607114892,MATH 193A,A04,083782,Rotar; Vladimir,10,0,34,24
1657607114892,MATH 193A,A05,093482,Rotar; Vladimir,10,0,34,24
1657607120919,MATH 197,001,091859,McAuley; Julian John,9999,0,9999,0
1657607120919,MATH 197,002,095566,Kedlaya; Kiran S.,9997,0,9999,2
1657607120919,MATH 197,003,095567,Xiao; Ming,9999,0,9999,0
1657607120919,MATH 197,004,095571,Perols; Johan Lars,9998,0,9999,1
1657607127984,COGS 9,A01,083615,Shannon; Kyle Michael,9,0,75,66
1657607134007,COGS 11,A01,083617,Boyle; Mary E. T.,23,0,48,25
1657607140035,COGS 13,A01,083071,Bastos; Amalia Pinkusfeld,11,0,71,60
1657607146062,COGS 14A,A01,092681,Semenuks; Arturs,5,1,100,95
1657607152084,COGS 14B,A01,083073,Cheng; Tzu-Han,6,0,63,57
1657607158108,COGS 17,A01,092677,Semenuks; Arturs,6,0,81,75
1657607164147,COGS 100,A01,083619,Allen; Michael Gordon,17,0,70,53
1657607170174,COGS 101A,A01,083621,Davis; Joshua Daniel,9,0,68,59
1657607176197,COGS 101B,A01,091572,Allen; Michael Gordon,12,0,65,53
1657607182221,COGS 101C,A01,083625,Delgado; Tania,17,0,35,18
1657607188245,COGS 107A,A01,083627,Boyle; Mary E. T.,13,0,60,47
1657607194271,COGS 118A,A01,083075,Gupta; Anjum,21,0,76,55
1657607200305,CSE 3,A50,083646,Miranda; Gregory Joseph,24,0,50,26
1657607206334,CSE 8A,A50,083650,Miranda; Gregory Joseph,17,1,56,39
1657607212360,CSE 11,A01,083080,Cao; Yingjun,6,15,40,34
1657607218384,CSE 12,A01,083652,Krause-Levy; Sophia Louisa,28,1,120,92
1657607224408,CSE 15L,A01,083654,Morris; Justin Loren,9,0,50,41
1657607224408,CSE 15L,A02,083655,Morris; Justin Loren,9,0,50,41
1657607230433,CSE 20,A01,083657,Tran; Khoa Dang,39,0,80,41
1657607236459,CSE 21,A01,095574,Bach; Quang Tran,22,0,48,26
1657607242487,CSE 30,A01,083084,Eldon; John,5,0,80,75
1657607242487,CSE 30,B01,095061,Bhaskar; Nishant,9,0,50,41
1657607248514,CSE 100,A01,083659,Cao; Yingjun,5,4,70,65
1657607254546,CSE 134B,A01,083661,Powell; Thomas Allan,22,0,100,78
1657607260573,CSE 140,A01,083663,Gungor; Onat,15,0,85,70
1657607266596,CSE 140L,A01,083088,Eldon; John,21,0,100,79
1657607272626,CSE 175,A01,083665,Kumar; Rakesh,3,0,25,22
1657607278650,CSE 190,A00,092507,Dubnov; Shlomo,8,0,20,12
1657607284671,ECE 45,A01,083139,Congero; Spencer William,6,0,75,69
1657607290694,ECE 65,A50,083695,Saad; Andrew S,12,0,30,18
1657607290694,ECE 65,A51,095125,Saad; Andrew S,24,0,26,2
1657607296720,ECE 109,A01,091882,Touri; Behrouz,19,0,70,51
1657607302744,ECE 180,A00,083140,Abi Samra; Nicholas Camill,1,0,30,29
1657607302744,ECE 180,B00,083141,Abi Samra; Nicholas Camill,0,0,30,30
1657607308772,MATH 10A,A01,083735,Patchell; Gregory David,2,0,30,28
1657607308772,MATH 10A,A02,083736,Patchell; Gregory David,20,0,30,10
1657607308772,MATH 10A,A03,083737,Patchell; Gregory David,16,0,30,14
1657607314802,MATH 10B,A01,083207,Lim; Seonhee,8,0,34,26
1657607314802,MATH 10B,A02,083208,Lim; Seonhee,9,0,35,26
1657607314802,MATH 10B,A03,093472,Lim; Seonhee,7,0,34,27
1657607314802,MATH 10B,B01,083739,Sinha; Shubham,12,0,30,18
1657607320832,MATH 18,A01,083743,Cinel; Cameron Alexander,7,0,30,23
1657607320832,MATH 18,A02,083744,Cinel; Cameron Alexander,17,0,30,13
1657607320832,MATH 18,A03,083745,Cinel; Cameron Alexander,9,0,30,21
1657607320832,MATH 18,B01,083748,Rideout; David Porter,5,0,37,32
1657607320832,MATH 18,B02,083749,Rideout; David Porter,5,0,36,31
1657607320832,MATH 18,B03,083750,Rideout; David Porter,3,0,37,34
1657607320832,MATH 18,B04,083751,Rideout; David Porter,6,0,36,30
1657607320832,MATH 18,B05,093473,Rideout; David Porter,6,0,36,30
1657607320832,MATH 18,B06,093474,Rideout; David Porter,6,0,36,30
1657607326859,MATH 20A,A01,083754,Zheng; Zequn,14,0,40,26
1657607332889,MATH 20B,A01,083756,Briones; Jor-el Thomas Caparas,4,0,36,32
1657607332889,MATH 20B,A02,083757,Briones; Jor-el Thomas Caparas,1,0,36,35
1657607332889,MATH 20B,A03,093475,Briones; Jor-el Thomas Caparas,2,0,36,34
1657607338917,MATH 20C,A01,083760,Briones; Jor-el Thomas Caparas,1,0,35,34
1657607338917,MATH 20C,A02,083761,Briones; Jor-el Thomas Caparas,8,0,35,27
1657607338917,MATH 20C,A03,093476,Briones; Jor-el Thomas Caparas,0,1,36,36
1657607338917,MATH 20C,B01,083762,Bach; Quang Tran,1,0,30,29
1657607344940,MATH 20D,A01,083765,Tran; Brian Kha,5,0,30,25
1657607344940,MATH 20D,A02,083766,Tran; Brian Kha,5,0,30,25
1657607344940,MATH 20D,A03,083767,Tran; Brian Kha,5,0,30,25
1657607350963,MATH 20E,A01,083771,Ganguly; Soumya,9,0,32,23
1657607350963,MATH 20E,A02,083772,Ganguly; Soumya,6,0,32,26
1657607350963,MATH 20E,B01,083773,Ciotti; Benjamin,20,0,35,15
1657607350963,MATH 20E,B02,083774,Ciotti; Benjamin,18,0,35,17
1657607356993,MATH 103A,A01,083777,Greenfeld; Be'Eri,3,0,36,33
1657607356993,MATH 103A,A02,083778,Greenfeld; Be'Eri,5,0,36,31
1657607356993,MATH 103A,A03,093561,Greenfeld; Be'Eri,6,0,36,30
1657607356993,MATH 103A,B01,083779,Greenfeld; Be'Eri,7,0,36,29
1657607356993,MATH 103A,B02,083780,Greenfeld; Be'Eri,4,0,36,32
1657607356993,MATH 103A,B03,093562,Greenfeld; Be'Eri,3,0,36,33
1657607363019,MATH 105,A01,085443,Carter; Anne Toulson,15,0,35,20
1657607363019,MATH 105,A02,093477,Carter; Anne Toulson,20,0,35,15
1657607369047,MATH 109,A01,083213,Ganzberger; Geoffrey Michael,2,0,34,32
1657607369047,MATH 109,A02,083214,Ganzberger; Geoffrey Michael,4,0,34,30
1657607369047,MATH 109,A03,093478,Ganzberger; Geoffrey Michael,2,0,34,32
1657607369047,MATH 109,B01,083215,Ganzberger; Geoffrey Michael,1,0,32,31
1657607369047,MATH 109,B02,083216,Ganzberger; Geoffrey Michael,2,0,32,30
1657607369047,MATH 109,B03,093479,Ganzberger; Geoffrey Michael,8,0,32,24
1657607375075,MATH 142A,A01,083219,Chow; Bennett,7,0,32,25
1657607375075,MATH 142A,A02,083220,Chow; Bennett,10,0,32,22
1657607375075,MATH 142A,A03,093480,Chow; Bennett,9,0,32,23
1657607375075,MATH 142A,B03,093481,Chow; Bennett,8,0,32,24
1657607375075,MATH 142A,B04,093558,Chow; Bennett,13,0,32,19
1657607375075,MATH 142A,B05,093559,Chow; Bennett,6,0,32,26
1657607381097,MATH 193A,A01,083224,Rotar; Vladimir,8,0,34,26
1657607381097,MATH 193A,A02,083225,Rotar; Vladimir,9,0,34,25
1657607381097,MATH 193A,A03,083781,Rotar; Vladimir,5,0,34,29
1657607381097,MATH 193A,A04,083782,Rotar; Vladimir,10,0,34,24
1657607381097,MATH 193A,A05,093482,Rotar; Vladimir,10,0,34,24
1657607387122,MATH 197,001,091859,McAuley; Julian John,9999,0,9999,0
1657607387122,MATH 197,002,095566,Kedlaya; Kiran S.,9997,0,9999,2
1657607387122,MATH 197,003,095567,Xiao; Ming,9999,0,9999,0
1657607387122,MATH 197,004,095571,Perols; Johan Lars,9998,0,9999,1
1657607394193,COGS 9,A01,083615,Shannon; Kyle Michael,9,0,75,66
1657607400215,COGS 11,A01,083617,Boyle; Mary E. T.,23,0,48,25
1657607406239,COGS 13,A01,083071,Bastos; Amalia Pinkusfeld,11,0,71,60
1657607412262,COGS 14A,A01,092681,Semenuks; Arturs,5,1,100,95
1657607418284,COGS 14B,A01,083073,Cheng; Tzu-Han,6,0,63,57
1657607424309,COGS 17,A01,092677,Semenuks; Arturs,6,0,81,75
1657607430332,COGS 100,A01,083619,Allen; Michael Gordon,17,0,70,53
1657607436357,COGS 101A,A01,083621,Davis; Joshua Daniel,9,0,68,59
1657607442397,COGS 101B,A01,091572,Allen; Michael Gordon,12,0,65,53
1657607448427,COGS 101C,A01,083625,Delgado; Tania,17,0,35,18
1657607454453,COGS 107A,A01,083627,Boyle; Mary E. T.,13,0,60,47
1657607460480,COGS 118A,A01,083075,Gupta; Anjum,21,0,76,55
1657607466510,CSE 3,A50,083646,Miranda; Gregory Joseph,24,0,50,26
1657607472532,CSE 8A,A50,083650,Miranda; Gregory Joseph,17,1,56,39
1657607478554,CSE 11,A01,083080,Cao; Yingjun,6,15,40,34
1657607484578,CSE 12,A01,083652,Krause-Levy; Sophia Louisa,28,1,120,92
1657607490603,CSE 15L,A01,083654,Morris; Justin Loren,9,0,50,41
1657607490603,CSE 15L,A02,083655,Morris; Justin Loren,9,0,50,41
1657607496627,CSE 20,A01,083657,Tran; Khoa Dang,39,0,80,41
1657607502650,CSE 21,A01,095574,Bach; Quang Tran,22,0,48,26
1657607508674,CSE 30,A01,083084,Eldon; John,5,0,80,75
1657607508674,CSE 30,B01,095061,Bhaskar; Nishant,9,0,50,41
1657607514698,CSE 100,A01,083659,Cao; Yingjun,5,4,70,65
1657607520721,CSE 134B,A01,083661,Powell; Thomas Allan,22,0,100,78
1657607526745,CSE 140,A01,083663,Gungor; Onat,15,0,85,70
1657607532767,CSE 140L,A01,083088,Eldon; John,21,0,100,79
1657607538792,CSE 175,A01,083665,Kumar; Rakesh,3,0,25,22
1657607544822,CSE 190,A00,092507,Dubnov; Shlomo,8,0,20,12
1657607550846,ECE 45,A01,083139,Congero; Spencer William,6,0,75,69
1657607556875,ECE 65,A50,083695,Saad; Andrew S,12,0,30,18
1657607556875,ECE 65,A51,095125,Saad; Andrew S,24,0,26,2
1657607562906,ECE 109,A01,091882,Touri; Behrouz,19,0,70,51
1657607568933,ECE 180,A00,083140,Abi Samra; Nicholas Camill,1,0,30,29
1657607568933,ECE 180,B00,083141,Abi Samra; Nicholas Camill,0,0,30,30
1657607574957,MATH 10A,A01,083735,Patchell; Gregory David,2,0,30,28
1657607574957,MATH 10A,A02,083736,Patchell; Gregory David,20,0,30,10
1657607574957,MATH 10A,A03,083737,Patchell; Gregory David,16,0,30,14
1657607580980,MATH 10B,A01,083207,Lim; Seonhee,8,0,34,26
1657607580980,MATH 10B,A02,083208,Lim; Seonhee,9,0,35,26
1657607580980,MATH 10B,A03,093472,Lim; Seonhee,7,0,34,27
1657607580980,MATH 10B,B01,083739,Sinha; Shubham,12,0,30,18
1657607587004,MATH 18,A01,083743,Cinel; Cameron Alexander,7,0,30,23
1657607587004,MATH 18,A02,083744,Cinel; Cameron Alexander,17,0,30,13
1657607587004,MATH 18,A03,083745,Cinel; Cameron Alexander,9,0,30,21
1657607587004,MATH 18,B01,083748,Rideout; David Porter,5,0,37,32
1657607587004,MATH 18,B02,083749,Rideout; David Porter,5,0,36,31
1657607587004,MATH 18,B03,083750,Rideout; David Porter,3,0,37,34
1657607587004,MATH 18,B04,083751,Rideout; David Porter,6,0,36,30
1657607587004,MATH 18,B05,093473,Rideout; David Porter,6,0,36,30
1657607587004,MATH 18,B06,093474,Rideout; David Porter,6,0,36,30
1657607593026,MATH 20A,A01,083754,Zheng; Zequn,14,0,40,26
1657607599049,MATH 20B,A01,083756,Briones; Jor-el Thomas Caparas,4,0,36,32
1657607599049,MATH 20B,A02,083757,Briones; Jor-el Thomas Caparas,1,0,36,35
1657607599049,MATH 20B,A03,093475,Briones; Jor-el Thomas Caparas,2,0,36,34
1657607605078,MATH 20C,A01,083760,Briones; Jor-el Thomas Caparas,1,0,35,34
1657607605078,MATH 20C,A02,083761,Briones; Jor-el Thomas Caparas,8,0,35,27
1657607605078,MATH 20C,A03,093476,Briones; Jor-el Thomas Caparas,0,1,36,36
1657607605078,MATH 20C,B01,083762,Bach; Quang Tran,1,0,30,29
1657607611107,MATH 20D,A01,083765,Tran; Brian Kha,5,0,30,25
1657607611107,MATH 20D,A02,083766,Tran; Brian Kha,5,0,30,25
1657607611107,MATH 20D,A03,083767,Tran; Brian Kha,5,0,30,25
1657607617129,MATH 20E,A01,083771,Ganguly; Soumya,9,0,32,23
1657607617129,MATH 20E,A02,083772,Ganguly; Soumya,6,0,32,26
1657607617129,MATH 20E,B01,083773,Ciotti; Benjamin,20,0,35,15
1657607617129,MATH 20E,B02,083774,Ciotti; Benjamin,18,0,35,17
1657607623154,MATH 103A,A01,083777,Greenfeld; Be'Eri,3,0,36,33
1657607623154,MATH 103A,A02,083778,Greenfeld; Be'Eri,5,0,36,31
1657607623154,MATH 103A,A03,093561,Greenfeld; Be'Eri,6,0,36,30
1657607623154,MATH 103A,B01,083779,Greenfeld; Be'Eri,7,0,36,29
1657607623154,MATH 103A,B02,083780,Greenfeld; Be'Eri,4,0,36,32
1657607623154,MATH 103A,B03,093562,Greenfeld; Be'Eri,3,0,36,33
1657607629180,MATH 105,A01,085443,Carter; Anne Toulson,15,0,35,20
1657607629180,MATH 105,A02,093477,Carter; Anne Toulson,20,0,35,15
1657607635208,MATH 109,A01,083213,Ganzberger; Geoffrey Michael,2,0,34,32
1657607635208,MATH 109,A02,083214,Ganzberger; Geoffrey Michael,4,0,34,30
1657607635208,MATH 109,A03,093478,Ganzberger; Geoffrey Michael,2,0,34,32
1657607635208,MATH 109,B01,083215,Ganzberger; Geoffrey Michael,1,0,32,31
1657607635208,MATH 109,B02,083216,Ganzberger; Geoffrey Michael,2,0,32,30
1657607635208,MATH 109,B03,093479,Ganzberger; Geoffrey Michael,8,0,32,24
1657607641239,MATH 142A,A01,083219,Chow; Bennett,7,0,32,25
1657607641239,MATH 142A,A02,083220,Chow; Bennett,10,0,32,22
1657607641239,MATH 142A,A03,093480,Chow; Bennett,9,0,32,23
1657607641239,MATH 142A,B03,093481,Chow; Bennett,8,0,32,24
1657607641239,MATH 142A,B04,093558,Chow; Bennett,13,0,32,19
1657607641239,MATH 142A,B05,093559,Chow; Bennett,6,0,32,26
1657607647263,MATH 193A,A01,083224,Rotar; Vladimir,8,0,34,26
1657607647263,MATH 193A,A02,083225,Rotar; Vladimir,9,0,34,25
1657607647263,MATH 193A,A03,083781,Rotar; Vladimir,5,0,34,29
1657607647263,MATH 193A,A04,083782,Rotar; Vladimir,10,0,34,24
1657607647263,MATH 193A,A05,093482,Rotar; Vladimir,10,0,34,24
1657607653292,MATH 197,001,091859,McAuley; Julian John,9999,0,9999,0
1657607653292,MATH 197,002,095566,Kedlaya; Kiran S.,9997,0,9999,2
1657607653292,MATH 197,003,095567,Xiao; Ming,9999,0,9999,0
1657607653292,MATH 197,004,095571,Perols; Johan Lars,9998,0,9999,1
1657607660349,COGS 9,A01,083615,Shannon; Kyle Michael,9,0,75,66
1657607666467,COGS 11,A01,083617,Boyle; Mary E. T.,23,0,48,25
1657607672501,COGS 13,A01,083071,Bastos; Amalia Pinkusfeld,11,0,71,60
1657607678525,COGS 14A,A01,092681,Semenuks; Arturs,5,1,100,95
1657607684553,COGS 14B,A01,083073,Cheng; Tzu-Han,6,0,63,57
1657607690577,COGS 17,A01,092677,Semenuks; Arturs,6,0,81,75
1657607696618,COGS 100,A01,083619,Allen; Michael Gordon,17,0,70,53
1657607702646,COGS 101A,A01,083621,Davis; Joshua Daniel,9,0,68,59
1657607708669,COGS 101B,A01,091572,Allen; Michael Gordon,12,0,65,53
1657607714696,COGS 101C,A01,083625,Delgado; Tania,17,0,35,18
1657607720718,COGS 107A,A01,083627,Boyle; Mary E. T.,13,0,60,47
1657607726743,COGS 118A,A01,083075,Gupta; Anjum,21,0,76,55
1657607732766,CSE 3,A50,083646,Miranda; Gregory Joseph,24,0,50,26
1657607738791,CSE 8A,A50,083650,Miranda; Gregory Joseph,17,1,56,39
1657607744818,CSE 11,A01,083080,Cao; Yingjun,6,15,40,34
1657607750848,CSE 12,A01,083652,Krause-Levy; Sophia Louisa,28,1,120,92
1657607756871,CSE 15L,A01,083654,Morris; Justin Loren,9,0,50,41
1657607756871,CSE 15L,A02,083655,Morris; Justin Loren,9,0,50,41
1657607762895,CSE 20,A01,083657,Tran; Khoa Dang,39,0,80,41
1657607768919,CSE 21,A01,095574,Bach; Quang Tran,22,0,48,26
1657607774942,CSE 30,A01,083084,Eldon; John,5,0,80,75
1657607774942,CSE 30,B01,095061,Bhaskar; Nishant,9,0,50,41
1657607780966,CSE 100,A01,083659,Cao; Yingjun,5,4,70,65
1657607786990,CSE 134B,A01,083661,Powell; Thomas Allan,22,0,100,78
1657607793014,CSE 140,A01,083663,Gungor; Onat,15,0,85,70
1657607799040,CSE 140L,A01,083088,Eldon; John,21,0,100,79
1657607805067,CSE 175,A01,083665,Kumar; Rakesh,3,0,25,22
1657607811089,CSE 190,A00,092507,Dubnov; Shlomo,8,0,20,12
1657607817114,ECE 45,A01,083139,Congero; Spencer William,6,0,75,69
1657607823147,ECE 65,A50,083695,Saad; Andrew S,12,0,30,18
1657607823147,ECE 65,A51,095125,Saad; Andrew S,24,0,26,2
1657607829174,ECE 109,A01,091882,Touri; Behrouz,19,0,70,51
1657607835199,ECE 180,A00,083140,Abi Samra; Nicholas Camill,1,0,30,29
1657607835199,ECE 180,B00,083141,Abi Samra; Nicholas Camill,0,0,30,30
1657607841225,MATH 10A,A01,083735,Patchell; Gregory David,2,0,30,28
1657607841225,MATH 10A,A02,083736,Patchell; Gregory David,20,0,30,10
1657607841225,MATH 10A,A03,083737,Patchell; Gregory David,16,0,30,14
1657607847258,MATH 10B,A01,083207,Lim; Seonhee,8,0,34,26
1657607847258,MATH 10B,A02,083208,Lim; Seonhee,9,0,35,26
1657607847258,MATH 10B,A03,093472,Lim; Seonhee,7,0,34,27
1657607847258,MATH 10B,B01,083739,Sinha; Shubham,12,0,30,18
1657607853291,MATH 18,A01,083743,Cinel; Cameron Alexander,7,0,30,23
1657607853291,MATH 18,A02,083744,Cinel; Cameron Alexander,17,0,30,13
1657607853291,MATH 18,A03,083745,Cinel; Cameron Alexander,9,0,30,21
1657607853291,MATH 18,B01,083748,Rideout; David Porter,5,0,37,32
1657607853291,MATH 18,B02,083749,Rideout; David Porter,5,0,36,31
1657607853291,MATH 18,B03,083750,Rideout; David Porter,3,0,37,34
1657607853291,MATH 18,B04,083751,Rideout; David Porter,6,0,36,30
1657607853291,MATH 18,B05,093473,Rideout; David Porter,6,0,36,30
1657607853291,MATH 18,B06,093474,Rideout; David Porter,6,0,36,30
1657607859318,MATH 20A,A01,083754,Zheng; Zequn,14,0,40,26
1657607865342,MATH 20B,A01,083756,Briones; Jor-el Thomas Caparas,4,0,36,32
1657607865342,MATH 20B,A02,083757,Briones; Jor-el Thomas Caparas,1,0,36,35
1657607865342,MATH 20B,A03,093475,Briones; Jor-el Thomas Caparas,2,0,36,34
1657607871364,MATH 20C,A01,083760,Briones; Jor-el Thomas Caparas,1,0,35,34
1657607871364,MATH 20C,A02,083761,Briones; Jor-el Thomas Caparas,8,0,35,27
1657607871364,MATH 20C,A03,093476,Briones; Jor-el Thomas Caparas,0,1,36,36
1657607871364,MATH 20C,B01,083762,Bach; Quang Tran,1,0,30,29
1657607877388,MATH 20D,A01,083765,Tran; Brian Kha,5,0,30,25
1657607877388,MATH 20D,A02,083766,Tran; Brian Kha,5,0,30,25
1657607877388,MATH 20D,A03,083767,Tran; Brian Kha,5,0,30,25
1657607883417,MATH 20E,A01,083771,Ganguly; Soumya,9,0,32,23
1657607883417,MATH 20E,A02,083772,Ganguly; Soumya,6,0,32,26
1657607883417,MATH 20E,B01,083773,Ciotti; Benjamin,20,0,35,15
1657607883417,MATH 20E,B02,083774,Ciotti; Benjamin,18,0,35,17
1657607889445,MATH 103A,A01,083777,Greenfeld; Be'Eri,3,0,36,33
1657607889445,MATH 103A,A02,083778,Greenfeld; Be'Eri,5,0,36,31
1657607889445,MATH 103A,A03,093561,Greenfeld; Be'Eri,6,0,36,30
1657607889445,MATH 103A,B01,083779,Greenfeld; Be'Eri,7,0,36,29
1657607889445,MATH 103A,B02,083780,Greenfeld; Be'Eri,4,0,36,32
1657607889445,MATH 103A,B03,093562,Greenfeld; Be'Eri,3,0,36,33
1657607895470,MATH 105,A01,085443,Carter; Anne Toulson,15,0,35,20
1657607895470,MATH 105,A02,093477,Carter; Anne Toulson,20,0,35,15
1657607901492,MATH 109,A01,083213,Ganzberger; Geoffrey Michael,2,0,34,32
1657607901492,MATH 109,A02,083214,Ganzberger; Geoffrey Michael,4,0,34,30
1657607901492,MATH 109,A03,093478,Ganzberger; Geoffrey Michael,2,0,34,32
1657607901492,MATH 109,B01,083215,Ganzberger; Geoffrey Michael,1,0,32,31
1657607901492,MATH 109,B02,083216,Ganzberger; Geoffrey Michael,2,0,32,30
1657607901492,MATH 109,B03,093479,Ganzberger; Geoffrey Michael,8,0,32,24
1657607907515,MATH 142A,A01,083219,Chow; Bennett,7,0,32,25
1657607907515,MATH 142A,A02,083220,Chow; Bennett,10,0,32,22
1657607907515,MATH 142A,A03,093480,Chow; Bennett,9,0,32,23
1657607907515,MATH 142A,B03,093481,Chow; Bennett,8,0,32,24
1657607907515,MATH 142A,B04,093558,Chow; Bennett,13,0,32,19
1657607907515,MATH 142A,B05,093559,Chow; Bennett,6,0,32,26
1657607913540,MATH 193A,A01,083224,Rotar; Vladimir,8,0,34,26
1657607913540,MATH 193A,A02,083225,Rotar; Vladimir,9,0,34,25
1657607913540,MATH 193A,A03,083781,Rotar; Vladimir,5,0,34,29
1657607913540,MATH 193A,A04,083782,Rotar; Vladimir,10,0,34,24
1657607913540,MATH 193A,A05,093482,Rotar; Vladimir,10,0,34,24
1657607919565,MATH 197,001,091859,McAuley; Julian John,9999,0,9999,0
1657607919565,MATH 197,002,095566,Kedlaya; Kiran S.,9997,0,9999,2
1657607919565,MATH 197,003,095567,Xiao; Ming,9999,0,9999,0
1657607919565,MATH 197,004,095571,Perols; Johan Lars,9998,0,9999,1
1657607926620,COGS 9,A01,083615,Shannon; Kyle Michael,9,0,75,66
1657607932653,COGS 11,A01,083617,Boyle; Mary E. T.,23,0,48,25
1657607938676,COGS 13,A01,083071,Bastos; Amalia Pinkusfeld,11,0,71,60
1657607944702,COGS 14A,A01,092681,Semenuks; Arturs,5,1,100,95
1657607950725,COGS 14B,A01,083073,Cheng; Tzu-Han,6,0,63,57
1657607956750,COGS 17,A01,092677,Semenuks; Arturs,6,0,81,75
1657607962775,COGS 100,A01,083619,Allen; Michael Gordon,17,0,70,53
1657607968797,COGS 101A,A01,083621,Davis; Joshua Daniel,9,0,68,59
1657607974820,COGS 101B,A01,091572,Allen; Michael Gordon,12,0,65,53
1657607980846,COGS 101C,A01,083625,Delgado; Tania,17,0,35,18
1657607986869,COGS 107A,A01,083627,Boyle; Mary E. T.,13,0,60,47
1657607992892,COGS 118A,A01,083075,Gupta; Anjum,21,0,76,55
1657607998917,CSE 3,A50,083646,Miranda; Gregory Joseph,24,0,50,26
1657608004940,CSE 8A,A50,083650,Miranda; Gregory Joseph,17,1,56,39
1657608010967,CSE 11,A01,083080,Cao; Yingjun,6,15,40,34
1657608016991,CSE 12,A01,083652,Krause-Levy; Sophia Louisa,28,1,120,92
1657608023018,CSE 15L,A01,083654,Morris; Justin Loren,9,0,50,41
1657608023018,CSE 15L,A02,083655,Morris; Justin Loren,9,0,50,41
1657608029047,CSE 20,A01,083657,Tran; Khoa Dang,39,0,80,41
1657608035073,CSE 21,A01,095574,Bach; Quang Tran,22,0,48,26
1657608041102,CSE 30,A01,083084,Eldon; John,5,0,80,75
1657608041102,CSE 30,B01,095061,Bhaskar; Nishant,9,0,50,41
1657608047124,CSE 100,A01,083659,Cao; Yingjun,5,4,70,65
1657608053148,CSE 134B,A01,083661,Powell; Thomas Allan,22,0,100,78
1657608059172,CSE 140,A01,083663,Gungor; Onat,15,0,85,70
1657608065196,CSE 140L,A01,083088,Eldon; John,21,0,100,79
1657608071219,CSE 175,A01,083665,Kumar; Rakesh,3,0,25,22
1657608077243,CSE 190,A00,092507,Dubnov; Shlomo,8,0,20,12
1657608083268,ECE 45,A01,083139,Congero; Spencer William,6,0,75,69
1657608089292,ECE 65,A50,083695,Saad; Andrew S,12,0,30,18
1657608089292,ECE 65,A51,095125,Saad; Andrew S,24,0,26,2
1657608095319,ECE 109,A01,091882,Touri; Behrouz,19,0,70,51
1657608101345,ECE 180,A00,083140,Abi Samra; Nicholas Camill,1,0,30,29
1657608101345,ECE 180,B00,083141,Abi Samra; Nicholas Camill,0,0,30,30
1657608107369,MATH 10A,A01,083735,Patchell; Gregory David,2,0,30,28
1657608107369,MATH 10A,A02,083736,Patchell; Gregory David,20,0,30,10
1657608107369,MATH 10A,A03,083737,Patchell; Gregory David,16,0,30,14
1657608113398,MATH 10B,A01,083207,Lim; Seonhee,8,0,34,26
1657608113398,MATH 10B,A02,083208,Lim; Seonhee,9,0,35,26
1657608113398,MATH 10B,A03,093472,Lim; Seonhee,7,0,34,27
1657608113398,MATH 10B,B01,083739,Sinha; Shubham,12,0,30,18
1657608119428,MATH 18,A01,083743,Cinel; Cameron Alexander,7,0,30,23
1657608119428,MATH 18,A02,083744,Cinel; Cameron Alexander,17,0,30,13
1657608119428,MATH 18,A03,083745,Cinel; Cameron Alexander,9,0,30,21
1657608119428,MATH 18,B01,083748,Rideout; David Porter,5,0,37,32
1657608119428,MATH 18,B02,083749,Rideout; David Porter,5,0,36,31
1657608119428,MATH 18,B03,083750,Rideout; David Porter,3,0,37,34
1657608119428,MATH 18,B04,083751,Rideout; David Porter,6,0,36,30
1657608119428,MATH 18,B05,093473,Rideout; David Porter,6,0,36,30
1657608119428,MATH 18,B06,093474,Rideout; David Porter,6,0,36,30
1657608125455,MATH 20A,A01,083754,Zheng; Zequn,14,0,40,26
1657608131477,MATH 20B,A01,083756,Briones; Jor-el Thomas Caparas,4,0,36,32
1657608131477,MATH 20B,A02,083757,Briones; Jor-el Thomas Caparas,1,0,36,35
1657608131477,MATH 20B,A03,093475,Briones; Jor-el Thomas Caparas,2,0,36,34
1657608137502,MATH 20C,A01,083760,Briones; Jor-el Thomas Caparas,1,0,35,34
1657608137502,MATH 20C,A02,083761,Briones; Jor-el Thomas Caparas,8,0,35,27
1657608137502,MATH 20C,A03,093476,Briones; Jor-el Thomas Caparas,0,1,36,36
1657608137502,MATH 20C,B01,083762,Bach; Quang Tran,1,0,30,29
1657608143525,MATH 20D,A01,083765,Tran; Brian Kha,5,0,30,25
1657608143525,MATH 20D,A02,083766,Tran; Brian Kha,5,0,30,25
1657608143525,MATH 20D,A03,083767,Tran; Brian Kha,5,0,30,25
1657608149549,MATH 20E,A01,083771,Ganguly; Soumya,9,0,32,23
1657608149549,MATH 20E,A02,083772,Ganguly; Soumya,6,0,32,26
1657608149549,MATH 20E,B01,083773,Ciotti; Benjamin,20,0,35,15
1657608149549,MATH 20E,B02,083774,Ciotti; Benjamin,18,0,35,17
1657608155589,MATH 103A,A01,083777,Greenfeld; Be'Eri,3,0,36,33
1657608155589,MATH 103A,A02,083778,Greenfeld; Be'Eri,5,0,36,31
1657608155589,MATH 103A,A03,093561,Greenfeld; Be'Eri,6,0,36,30
1657608155589,MATH 103A,B01,083779,Greenfeld; Be'Eri,7,0,36,29
1657608155589,MATH 103A,B02,083780,Greenfeld; Be'Eri,4,0,36,32
1657608155589,MATH 103A,B03,093562,Greenfeld; Be'Eri,3,0,36,33
1657608161613,MATH 105,A01,085443,Carter; Anne Toulson,15,0,35,20
1657608161613,MATH 105,A02,093477,Carter; Anne Toulson,20,0,35,15
1657608167646,MATH 109,A01,083213,Ganzberger; Geoffrey Michael,2,0,34,32
1657608167646,MATH 109,A02,083214,Ganzberger; Geoffrey Michael,4,0,34,30
1657608167646,MATH 109,A03,093478,Ganzberger; Geoffrey Michael,2,0,34,32
1657608167646,MATH 109,B01,083215,Ganzberger; Geoffrey Michael,1,0,32,31
1657608167646,MATH 109,B02,083216,Ganzberger; Geoffrey Michael,2,0,32,30
1657608167646,MATH 109,B03,093479,Ganzberger; Geoffrey Michael,8,0,32,24
1657608173669,MATH 142A,A01,083219,Chow; Bennett,7,0,32,25
1657608173669,MATH 142A,A02,083220,Chow; Bennett,10,0,32,22
1657608173669,MATH 142A,A03,093480,Chow; Bennett,9,0,32,23
1657608173669,MATH 142A,B03,093481,Chow; Bennett,8,0,32,24
1657608173669,MATH 142A,B04,093558,Chow; Bennett,13,0,32,19
1657608173669,MATH 142A,B05,093559,Chow; Bennett,6,0,32,26
1657608179692,MATH 193A,A01,083224,Rotar; Vladimir,8,0,34,26
1657608179692,MATH 193A,A02,083225,Rotar; Vladimir,9,0,34,25
1657608179692,MATH 193A,A03,083781,Rotar; Vladimir,5,0,34,29
1657608179692,MATH 193A,A04,083782,Rotar; Vladimir,10,0,34,24
1657608179692,MATH 193A,A05,093482,Rotar; Vladimir,10,0,34,24
1657608185720,MATH 197,001,091859,McAuley; Julian John,9999,0,9999,0
1657608185720,MATH 197,002,095566,Kedlaya; Kiran S.,9997,0,9999,2
1657608185720,MATH 197,003,095567,Xiao; Ming,9999,0,9999,0
1657608185720,MATH 197,004,095571,Perols; Johan Lars,9998,0,9999,1
1657608192785,COGS 9,A01,083615,Shannon; Kyle Michael,9,0,75,66
1657608198807,COGS 11,A01,083617,Boyle; Mary E. T.,23,0,48,25
1657608204830,COGS 13,A01,083071,Bastos; Amalia Pinkusfeld,11,0,71,60
1657608210858,COGS 14A,A01,092681,Semenuks; Arturs,5,1,100,95
1657608216883,COGS 14B,A01,083073,Cheng; Tzu-Han,6,0,63,57
1657608222906,COGS 17,A01,092677,Semenuks; Arturs,6,0,81,75
1657608228932,COGS 100,A01,083619,Allen; Michael Gordon,17,0,70,53
1657608234960,COGS 101A,A01,083621,Davis; Joshua Daniel,9,0,68,59
1657608240984,COGS 101B,A01,091572,Allen; Michael Gordon,12,0,65,53
1657608247006,COGS 101C,A01,083625,Delgado; Tania,17,0,35,18
1657608253029,COGS 107A,A01,083627,Boyle; Mary E. T.,13,0,60,47
1657608259057,COGS 118A,A01,083075,Gupta; Anjum,21,0,76,55
1657608265169,CSE 3,A50,083646,Miranda; Gregory Joseph,24,0,50,26
1657608271213,CSE 8A,A50,083650,Miranda; Gregory Joseph,17,1,56,39
1657608277256,CSE 11,A01,083080,Cao; Yingjun,6,15,40,34
1657608283279,CSE 12,A01,083652,Krause-Levy; Sophia Louisa,28,1,120,92
1657608289312,CSE 15L,A01,083654,Morris; Justin Loren,9,0,50,41
1657608289312,CSE 15L,A02,083655,Morris; Justin Loren,9,0,50,41
1657608295350,CSE 20,A01,083657,Tran; Khoa Dang,39,0,80,41
1657608301377,CSE 21,A01,095574,Bach; Quang Tran,22,0,48,26
1657608307401,CSE 30,A01,083084,Eldon; John,5,0,80,75
1657608307401,CSE 30,B01,095061,Bhaskar; Nishant,9,0,50,41
1657608313424,CSE 100,A01,083659,Cao; Yingjun,5,4,70,65
1657608319450,CSE 134B,A01,083661,Powell; Thomas Allan,22,0,100,78
1657608325475,CSE 140,A01,083663,Gungor; Onat,15,0,85,70
1657608331499,CSE 140L,A01,083088,Eldon; John,21,0,100,79
1657608337524,CSE 175,A01,083665,Kumar; Rakesh,3,0,25,22
1657608343546,CSE 190,A00,092507,Dubnov; Shlomo,8,0,20,12
1657608349569,ECE 45,A01,083139,Congero; Spencer William,6,0,75,69
1657608355596,ECE 65,A50,083695,Saad; Andrew S,12,0,30,18
1657608355596,ECE 65,A51,095125,Saad; Andrew S,24,0,26,2
1657608361624,ECE 109,A01,091882,Touri; Behrouz,19,0,70,51
1657608367646,ECE 180,A00,083140,Abi Samra; Nicholas Camill,1,0,30,29
1657608367646,ECE 180,B00,083141,Abi Samra; Nicholas Camill,0,0,30,30
1657608373675,MATH 10A,A01,083735,Patchell; Gregory David,2,0,30,28
1657608373675,MATH 10A,A02,083736,Patchell; Gregory David,20,0,30,10
1657608373675,MATH 10A,A03,083737,Patchell; Gregory David,16,0,30,14
1657608379698,MATH 10B,A01,083207,Lim; Seonhee,8,0,34,26
1657608379698,MATH 10B,A02,083208,Lim; Seonhee,9,0,35,26
1657608379698,MATH 10B,A03,093472,Lim; Seonhee,7,0,34,27
1657608379698,MATH 10B,B01,083739,Sinha; Shubham,12,0,30,18
1657608385728,MATH 18,A01,083743,Cinel; Cameron Alexander,7,0,30,23
1657608385728,MATH 18,A02,083744,Cinel; Cameron Alexander,17,0,30,13
1657608385728,MATH 18,A03,083745,Cinel; Cameron Alexander,9,0,30,21
1657608385728,MATH 18,B01,083748,Rideout; David Porter,5,0,37,32
1657608385728,MATH 18,B02,083749,Rideout; David Porter,5,0,36,31
1657608385728,MATH 18,B03,083750,Rideout; David Porter,3,0,37,34
1657608385728,MATH 18,B04,083751,Rideout; David Porter,6,0,36,30
1657608385728,MATH 18,B05,093473,Rideout; David Porter,6,0,36,30
1657608385728,MATH 18,B06,093474,Rideout; David Porter,6,0,36,30
1657608391753,MATH 20A,A01,083754,Zheng; Zequn,14,0,40,26
1657608397777,MATH 20B,A01,083756,Briones; Jor-el Thomas Caparas,4,0,36,32
1657608397777,MATH 20B,A02,083757,Briones; Jor-el Thomas Caparas,1,0,36,35
1657608397777,MATH 20B,A03,093475,Briones; Jor-el Thomas Caparas,2,0,36,34
1657608403801,MATH 20C,A01,083760,Briones; Jor-el Thomas Caparas,1,0,35,34
1657608403801,MATH 20C,A02,083761,Briones; Jor-el Thomas Caparas,8,0,35,27
1657608403801,MATH 20C,A03,093476,Briones; Jor-el Thomas Caparas,0,1,36,36
1657608403801,MATH 20C,B01,083762,Bach; Quang Tran,1,0,30,29
1657608409824,MATH 20D,A01,083765,Tran; Brian Kha,5,0,30,25
1657608409824,MATH 20D,A02,083766,Tran; Brian Kha,5,0,30,25
1657608409824,MATH 20D,A03,083767,Tran; Brian Kha,5,0,30,25
1657608415848,MATH 20E,A01,083771,Ganguly; Soumya,9,0,32,23
1657608415848,MATH 20E,A02,083772,Ganguly; Soumya,6,0,32,26
1657608415848,MATH 20E,B01,083773,Ciotti; Benjamin,20,0,35,15
1657608415848,MATH 20E,B02,083774,Ciotti; Benjamin,18,0,35,17
1657608421878,MATH 103A,A01,083777,Greenfeld; Be'Eri,3,0,36,33
1657608421878,MATH 103A,A02,083778,Greenfeld; Be'Eri,5,0,36,31
1657608421878,MATH 103A,A03,093561,Greenfeld; Be'Eri,6,0,36,30
1657608421878,MATH 103A,B01,083779,Greenfeld; Be'Eri,7,0,36,29
1657608421878,MATH 103A,B02,083780,Greenfeld; Be'Eri,4,0,36,32
1657608421878,MATH 103A,B03,093562,Greenfeld; Be'Eri,3,0,36,33
1657608427900,MATH 105,A01,085443,Carter; Anne Toulson,15,0,35,20
1657608427900,MATH 105,A02,093477,Carter; Anne Toulson,20,0,35,15
1657608433925,MATH 109,A01,083213,Ganzberger; Geoffrey Michael,2,0,34,32
1657608433925,MATH 109,A02,083214,Ganzberger; Geoffrey Michael,4,0,34,30
1657608433925,MATH 109,A03,093478,Ganzberger; Geoffrey Michael,2,0,34,32
1657608433925,MATH 109,B01,083215,Ganzberger; Geoffrey Michael,1,0,32,31
1657608433925,MATH 109,B02,083216,Ganzberger; Geoffrey Michael,2,0,32,30
1657608433925,MATH 109,B03,093479,Ganzberger; Geoffrey Michael,8,0,32,24
1657608439948,MATH 142A,A01,083219,Chow; Bennett,7,0,32,25
1657608439948,MATH 142A,A02,083220,Chow; Bennett,10,0,32,22
1657608439948,MATH 142A,A03,093480,Chow; Bennett,9,0,32,23
1657608439948,MATH 142A,B03,093481,Chow; Bennett,8,0,32,24
1657608439948,MATH 142A,B04,093558,Chow; Bennett,13,0,32,19
1657608439948,MATH 142A,B05,093559,Chow; Bennett,6,0,32,26
1657608445975,MATH 193A,A01,083224,Rotar; Vladimir,8,0,34,26
1657608445975,MATH 193A,A02,083225,Rotar; Vladimir,9,0,34,25
1657608445975,MATH 193A,A03,083781,Rotar; Vladimir,5,0,34,29
1657608445975,MATH 193A,A04,083782,Rotar; Vladimir,10,0,34,24
1657608445975,MATH 193A,A05,093482,Rotar; Vladimir,10,0,34,24
1657608451999,MATH 197,001,091859,McAuley; Julian John,9999,0,9999,0
1657608451999,MATH 197,002,095566,Kedlaya; Kiran S.,9997,0,9999,2
1657608451999,MATH 197,003,095567,Xiao; Ming,9999,0,9999,0
1657608451999,MATH 197,004,095571,Perols; Johan Lars,9998,0,9999,1
1657608459053,COGS 9,A01,083615,Shannon; Kyle Michael,9,0,75,66
1657608465075,COGS 11,A01,083617,Boyle; Mary E. T.,23,0,48,25
1657608471104,COGS 13,A01,083071,Bastos; Amalia Pinkusfeld,11,0,71,60
1657608477127,COGS 14A,A01,092681,Semenuks; Arturs,5,1,100,95
1657608483155,COGS 14B,A01,083073,Cheng; Tzu-Han,6,0,63,57
1657608489181,COGS 17,A01,092677,Semenuks; Arturs,6,0,81,75
1657608495206,COGS 100,A01,083619,Allen; Michael Gordon,17,0,70,53
1657608501230,COGS 101A,A01,083621,Davis; Joshua Daniel,9,0,68,59
1657608507257,COGS 101B,A01,091572,Allen; Michael Gordon,12,0,65,53
1657608513278,COGS 101C,A01,083625,Delgado; Tania,17,0,35,18
1657608519305,COGS 107A,A01,083627,Boyle; Mary E. T.,13,0,60,47
1657608525326,COGS 118A,A01,083075,Gupta; Anjum,21,0,76,55
1657608531354,CSE 3,A50,083646,Miranda; Gregory Joseph,24,0,50,26
1657608537378,CSE 8A,A50,083650,Miranda; Gregory Joseph,17,1,56,39
1657608543404,CSE 11,A01,083080,Cao; Yingjun,6,15,40,34
1657608549428,CSE 12,A01,083652,Krause-Levy; Sophia Louisa,28,1,120,92
1657608555450,CSE 15L,A01,083654,Morris; Justin Loren,9,0,50,41
1657608555450,CSE 15L,A02,083655,Morris; Justin Loren,9,0,50,41
1657608561473,CSE 20,A01,083657,Tran; Khoa Dang,39,0,80,41
1657608567496,CSE 21,A01,095574,Bach; Quang Tran,22,0,48,26
1657608573522,CSE 30,A01,083084,Eldon; John,5,0,80,75
1657608573522,CSE 30,B01,095061,Bhaskar; Nishant,9,0,50,41
1657608579551,CSE 100,A01,083659,Cao; Yingjun,5,4,70,65
1657608585574,CSE 134B,A01,083661,Powell; Thomas Allan,22,0,100,78
1657608591601,CSE 140,A01,083663,Gungor; Onat,15,0,85,70
1657608597633,CSE 140L,A01,083088,Eldon; John,21,0,100,79
1657608603657,CSE 175,A01,083665,Kumar; Rakesh,3,0,25,22
1657608609682,CSE 190,A00,092507,Dubnov; Shlomo,8,0,20,12
1657608615710,ECE 45,A01,083139,Congero; Spencer William,6,0,75,69
1657608621736,ECE 65,A50,083695,Saad; Andrew S,12,0,30,18
1657608621736,ECE 65,A51,095125,Saad; Andrew S,24,0,26,2
1657608627759,ECE 109,A01,091882,Touri; Behrouz,19,0,70,51
1657608633785,ECE 180,A00,083140,Abi Samra; Nicholas Camill,1,0,30,29
1657608633785,ECE 180,B00,083141,Abi Samra; Nicholas Camill,0,0,30,30
1657608639811,MATH 10A,A01,083735,Patchell; Gregory David,2,0,30,28
1657608639811,MATH 10A,A02,083736,Patchell; Gregory David,20,0,30,10
1657608639811,MATH 10A,A03,083737,Patchell; Gregory David,16,0,30,14
1657608645841,MATH 10B,A01,083207,Lim; Seonhee,8,0,34,26
1657608645841,MATH 10B,A02,083208,Lim; Seonhee,9,0,35,26
1657608645841,MATH 10B,A03,093472,Lim; Seonhee,7,0,34,27
1657608645841,MATH 10B,B01,083739,Sinha; Shubham,12,0,30,18
1657608651865,MATH 18,A01,083743,Cinel; Cameron Alexander,7,0,30,23
1657608651865,MATH 18,A02,083744,Cinel; Cameron Alexander,17,0,30,13
1657608651865,MATH 18,A03,083745,Cinel; Cameron Alexander,9,0,30,21
1657608651865,MATH 18,B01,083748,Rideout; David Porter,5,0,37,32
1657608651865,MATH 18,B02,083749,Rideout; David Porter,5,0,36,31
1657608651865,MATH 18,B03,083750,Rideout; David Porter,3,0,37,34
1657608651865,MATH 18,B04,083751,Rideout; David Porter,6,0,36,30
1657608651865,MATH 18,B05,093473,Rideout; David Porter,6,0,36,30
1657608651865,MATH 18,B06,093474,Rideout; David Porter,6,0,36,30
1657608657889,MATH 20A,A01,083754,Zheng; Zequn,14,0,40,26
1657608663917,MATH 20B,A01,083756,Briones; Jor-el Thomas Caparas,4,0,36,32
1657608663917,MATH 20B,A02,083757,Briones; Jor-el Thomas Caparas,1,0,36,35
1657608663917,MATH 20B,A03,093475,Briones; Jor-el Thomas Caparas,2,0,36,34
1657608669940,MATH 20C,A01,083760,Briones; Jor-el Thomas Caparas,1,0,35,34
1657608669940,MATH 20C,A02,083761,Briones; Jor-el Thomas Caparas,8,0,35,27
1657608669940,MATH 20C,A03,093476,Briones; Jor-el Thomas Caparas,0,1,36,36
1657608669940,MATH 20C,B01,083762,Bach; Quang Tran,1,0,30,29
1657608675967,MATH 20D,A01,083765,Tran; Brian Kha,5,0,30,25
1657608675967,MATH 20D,A02,083766,Tran; Brian Kha,5,0,30,25
1657608675967,MATH 20D,A03,083767,Tran; Brian Kha,5,0,30,25
1657608681999,MATH 20E,A01,083771,Ganguly; Soumya,9,0,32,23
1657608681999,MATH 20E,A02,083772,Ganguly; Soumya,6,0,32,26
1657608681999,MATH 20E,B01,083773,Ciotti; Benjamin,20,0,35,15
1657608681999,MATH 20E,B02,083774,Ciotti; Benjamin,18,0,35,17
1657608688027,MATH 103A,A01,083777,Greenfeld; Be'Eri,3,0,36,33
1657608688027,MATH 103A,A02,083778,Greenfeld; Be'Eri,5,0,36,31
1657608688027,MATH 103A,A03,093561,Greenfeld; Be'Eri,6,0,36,30
1657608688027,MATH 103A,B01,083779,Greenfeld; Be'Eri,7,0,36,29
1657608688027,MATH 103A,B02,083780,Greenfeld; Be'Eri,4,0,36,32
1657608688027,MATH 103A,B03,093562,Greenfeld; Be'Eri,3,0,36,33
1657608694053,MATH 105,A01,085443,Carter; Anne Toulson,15,0,35,20
1657608694053,MATH 105,A02,093477,Carter; Anne Toulson,20,0,35,15
1657608700082,MATH 109,A01,083213,Ganzberger; Geoffrey Michael,2,0,34,32
1657608700082,MATH 109,A02,083214,Ganzberger; Geoffrey Michael,4,0,34,30
1657608700082,MATH 109,A03,093478,Ganzberger; Geoffrey Michael,2,0,34,32
1657608700082,MATH 109,B01,083215,Ganzberger; Geoffrey Michael,1,0,32,31
1657608700082,MATH 109,B02,083216,Ganzberger; Geoffrey Michael,2,0,32,30
1657608700082,MATH 109,B03,093479,Ganzberger; Geoffrey Michael,8,0,32,24
1657608706106,MATH 142A,A01,083219,Chow; Bennett,7,0,32,25
1657608706106,MATH 142A,A02,083220,Chow; Bennett,10,0,32,22
1657608706106,MATH 142A,A03,093480,Chow; Bennett,9,0,32,23
1657608706106,MATH 142A,B03,093481,Chow; Bennett,8,0,32,24
1657608706106,MATH 142A,B04,093558,Chow; Bennett,13,0,32,19
1657608706106,MATH 142A,B05,093559,Chow; Bennett,6,0,32,26
1657608712129,MATH 193A,A01,083224,Rotar; Vladimir,8,0,34,26
1657608712129,MATH 193A,A02,083225,Rotar; Vladimir,9,0,34,25
1657608712129,MATH 193A,A03,083781,Rotar; Vladimir,5,0,34,29
1657608712129,MATH 193A,A04,083782,Rotar; Vladimir,10,0,34,24
1657608712129,MATH 193A,A05,093482,Rotar; Vladimir,10,0,34,24
1657608718155,MATH 197,001,091859,McAuley; Julian John,9999,0,9999,0
1657608718155,MATH 197,002,095566,Kedlaya; Kiran S.,9997,0,9999,2
1657608718155,MATH 197,003,095567,Xiao; Ming,9999,0,9999,0
1657608718155,MATH 197,004,095571,Perols; Johan Lars,9998,0,9999,1
1657608725209,COGS 9,A01,083615,Shannon; Kyle Michael,9,0,75,66
1657608731245,COGS 11,A01,083617,Boyle; Mary E. T.,23,0,48,25
1657608737272,COGS 13,A01,083071,Bastos; Amalia Pinkusfeld,11,0,71,60
1657608743296,COGS 14A,A01,092681,Semenuks; Arturs,5,1,100,95
1657608749320,COGS 14B,A01,083073,Cheng; Tzu-Han,6,0,63,57
1657608755348,COGS 17,A01,092677,Semenuks; Arturs,6,0,81,75
1657608761374,COGS 100,A01,083619,Allen; Michael Gordon,17,0,70,53
1657608767401,COGS 101A,A01,083621,Davis; Joshua Daniel,9,0,68,59
1657608773428,COGS 101B,A01,091572,Allen; Michael Gordon,12,0,65,53
1657608779453,COGS 101C,A01,083625,Delgado; Tania,17,0,35,18
1657608785481,COGS 107A,A01,083627,Boyle; Mary E. T.,13,0,60,47
1657608791506,COGS 118A,A01,083075,Gupta; Anjum,21,0,76,55
1657608797529,CSE 3,A50,083646,Miranda; Gregory Joseph,24,0,50,26
1657608804157,CSE 8A,A50,083650,Miranda; Gregory Joseph,17,1,56,39
1657608810183,CSE 11,A01,083080,Cao; Yingjun,6,15,40,34
1657608816211,CSE 12,A01,083652,Krause-Levy; Sophia Louisa,28,1,120,92
1657608822239,CSE 15L,A01,083654,Morris; Justin Loren,9,0,50,41
1657608822239,CSE 15L,A02,083655,Morris; Justin Loren,9,0,50,41
1657608828265,CSE 20,A01,083657,Tran; Khoa Dang,39,0,80,41
1657608834289,CSE 21,A01,095574,Bach; Quang Tran,22,0,48,26
1657608840316,CSE 30,A01,083084,Eldon; John,5,0,80,75
1657608840316,CSE 30,B01,095061,Bhaskar; Nishant,9,0,50,41
1657608846341,CSE 100,A01,083659,Cao; Yingjun,5,4,70,65
1657608852368,CSE 134B,A01,083661,Powell; Thomas Allan,22,0,100,78
1657608858392,CSE 140,A01,083663,Gungor; Onat,15,0,85,70
1657608864511,CSE 140L,A01,083088,Eldon; John,21,0,100,79
1657608870535,CSE 175,A01,083665,Kumar; Rakesh,3,0,25,22
1657608876560,CSE 190,A00,092507,Dubnov; Shlomo,8,0,20,12
1657608882582,ECE 45,A01,083139,Congero; Spencer William,6,0,75,69
1657608888605,ECE 65,A50,083695,Saad; Andrew S,12,0,30,18
1657608888605,ECE 65,A51,095125,Saad; Andrew S,24,0,26,2
1657608894630,ECE 109,A01,091882,Touri; Behrouz,19,0,70,51
1657608900663,ECE 180,A00,083140,Abi Samra; Nicholas Camill,1,0,30,29
1657608900663,ECE 180,B00,083141,Abi Samra; Nicholas Camill,0,0,30,30
1657608906694,MATH 10A,A01,083735,Patchell; Gregory David,2,0,30,28
1657608906694,MATH 10A,A02,083736,Patchell; Gregory David,20,0,30,10
1657608906694,MATH 10A,A03,083737,Patchell; Gregory David,16,0,30,14
1657608912723,MATH 10B,A01,083207,Lim; Seonhee,8,0,34,26
1657608912723,MATH 10B,A02,083208,Lim; Seonhee,9,0,35,26
1657608912723,MATH 10B,A03,093472,Lim; Seonhee,7,0,34,27
1657608912723,MATH 10B,B01,083739,Sinha; Shubham,12,0,30,18
1657608918754,MATH 18,A01,083743,Cinel; Cameron Alexander,7,0,30,23
1657608918754,MATH 18,A02,083744,Cinel; Cameron Alexander,17,0,30,13
1657608918754,MATH 18,A03,083745,Cinel; Cameron Alexander,9,0,30,21
1657608918754,MATH 18,B01,083748,Rideout; David Porter,5,0,37,32
1657608918754,MATH 18,B02,083749,Rideout; David Porter,5,0,36,31
1657608918754,MATH 18,B03,083750,Rideout; David Porter,3,0,37,34
1657608918754,MATH 18,B04,083751,Rideout; David Porter,6,0,36,30
1657608918754,MATH 18,B05,093473,Rideout; David Porter,6,0,36,30
1657608918754,MATH 18,B06,093474,Rideout; David Porter,6,0,36,30
1657608924775,MATH 20A,A01,083754,Zheng; Zequn,14,0,40,26
1657608930802,MATH 20B,A01,083756,Briones; Jor-el Thomas Caparas,4,0,36,32
1657608930802,MATH 20B,A02,083757,Briones; Jor-el Thomas Caparas,1,0,36,35
1657608930802,MATH 20B,A03,093475,Briones; Jor-el Thomas Caparas,2,0,36,34
1657608936830,MATH 20C,A01,083760,Briones; Jor-el Thomas Caparas,1,0,35,34
1657608936830,MATH 20C,A02,083761,Briones; Jor-el Thomas Caparas,8,0,35,27
1657608936830,MATH 20C,A03,093476,Briones; Jor-el Thomas Caparas,0,1,36,36
1657608936830,MATH 20C,B01,083762,Bach; Quang Tran,1,0,30,29
1657608942858,MATH 20D,A01,083765,Tran; Brian Kha,5,0,30,25
1657608942858,MATH 20D,A02,083766,Tran; Brian Kha,5,0,30,25
1657608942858,MATH 20D,A03,083767,Tran; Brian Kha,5,0,30,25
1657608948880,MATH 20E,A01,083771,Ganguly; Soumya,9,0,32,23
1657608948880,MATH 20E,A02,083772,Ganguly; Soumya,6,0,32,26
1657608948880,MATH 20E,B01,083773,Ciotti; Benjamin,20,0,35,15
1657608948880,MATH 20E,B02,083774,Ciotti; Benjamin,18,0,35,17
1657608954902,MATH 103A,A01,083777,Greenfeld; Be'Eri,3,0,36,33
1657608954902,MATH 103A,A02,083778,Greenfeld; Be'Eri,5,0,36,31
1657608954902,MATH 103A,A03,093561,Greenfeld; Be'Eri,6,0,36,30
1657608954902,MATH 103A,B01,083779,Greenfeld; Be'Eri,7,0,36,29
1657608954902,MATH 103A,B02,083780,Greenfeld; Be'Eri,4,0,36,32
1657608954902,MATH 103A,B03,093562,Greenfeld; Be'Eri,3,0,36,33
1657608960923,MATH 105,A01,085443,Carter; Anne Toulson,15,0,35,20
1657608960923,MATH 105,A02,093477,Carter; Anne Toulson,20,0,35,15
1657608966952,MATH 109,A01,083213,Ganzberger; Geoffrey Michael,2,0,34,32
1657608966952,MATH 109,A02,083214,Ganzberger; Geoffrey Michael,4,0,34,30
1657608966952,MATH 109,A03,093478,Ganzberger; Geoffrey Michael,2,0,34,32
1657608966952,MATH 109,B01,083215,Ganzberger; Geoffrey Michael,1,0,32,31
1657608966952,MATH 109,B02,083216,Ganzberger; Geoffrey Michael,2,0,32,30
1657608966952,MATH 109,B03,093479,Ganzberger; Geoffrey Michael,8,0,32,24
1657608972975,MATH 142A,A01,083219,Chow; Bennett,7,0,32,25
1657608972975,MATH 142A,A02,083220,Chow; Bennett,10,0,32,22
1657608972975,MATH 142A,A03,093480,Chow; Bennett,9,0,32,23
1657608972975,MATH 142A,B03,093481,Chow; Bennett,8,0,32,24
1657608972975,MATH 142A,B04,093558,Chow; Bennett,13,0,32,19
1657608972975,MATH 142A,B05,093559,Chow; Bennett,6,0,32,26
1657608978998,MATH 193A,A01,083224,Rotar; Vladimir,8,0,34,26
1657608978998,MATH 193A,A02,083225,Rotar; Vladimir,9,0,34,25
1657608978998,MATH 193A,A03,083781,Rotar; Vladimir,5,0,34,29
1657608978998,MATH 193A,A04,083782,Rotar; Vladimir,10,0,34,24
1657608978998,MATH 193A,A05,093482,Rotar; Vladimir,10,0,34,24
1657608985025,MATH 197,001,091859,McAuley; Julian John,9999,0,9999,0
1657608985025,MATH 197,002,095566,Kedlaya; Kiran S.,9997,0,9999,2
1657608985025,MATH 197,003,095567,Xiao; Ming,9999,0,9999,0
1657608985025,MATH 197,004,095571,Perols; Johan Lars,9998,0,9999,1
1657608992079,COGS 9,A01,083615,Shannon; Kyle Michael,9,0,75,66
1657608998111,COGS 11,A01,083617,Boyle; Mary E. T.,23,0,48,25
1657609004132,COGS 13,A01,083071,Bastos; Amalia Pinkusfeld,11,0,71,60
1657609010155,COGS 14A,A01,092681,Semenuks; Arturs,5,1,100,95
1657609016182,COGS 14B,A01,083073,Cheng; Tzu-Han,6,0,63,57
1657609022210,COGS 17,A01,092677,Semenuks; Arturs,6,0,81,75
1657609028233,COGS 100,A01,083619,Allen; Michael Gordon,17,0,70,53
1657609034259,COGS 101A,A01,083621,Davis; Joshua Daniel,9,0,68,59
1657609040282,COGS 101B,A01,091572,Allen; Michael Gordon,12,0,65,53
1657609046305,COGS 101C,A01,083625,Delgado; Tania,17,0,35,18
1657609052328,COGS 107A,A01,083627,Boyle; Mary E. T.,13,0,60,47
1657609058354,COGS 118A,A01,083075,Gupta; Anjum,21,0,76,55
1657609064381,CSE 3,A50,083646,Miranda; Gregory Joseph,24,0,50,26
1657609070405,CSE 8A,A50,083650,Miranda; Gregory Joseph,17,1,56,39
1657609076434,CSE 11,A01,083080,Cao; Yingjun,6,15,40,34
1657609082460,CSE 12,A01,083652,Krause-Levy; Sophia Louisa,28,1,120,92
1657609088486,CSE 15L,A01,083654,Morris; Justin Loren,9,0,50,41
1657609088486,CSE 15L,A02,083655,Morris; Justin Loren,9,0,50,41
1657609094509,CSE 20,A01,083657,Tran; Khoa Dang,39,0,80,41
1657609100531,CSE 21,A01,095574,Bach; Quang Tran,22,0,48,26
1657609106553,CSE 30,A01,083084,Eldon; John,5,0,80,75
1657609106553,CSE 30,B01,095061,Bhaskar; Nishant,9,0,50,41
1657609112579,CSE 100,A01,083659,Cao; Yingjun,5,4,70,65
1657609118611,CSE 134B,A01,083661,Powell; Thomas Allan,22,0,100,78
1657609124635,CSE 140,A01,083663,Gungor; Onat,15,0,85,70
1657609130659,CSE 140L,A01,083088,Eldon; John,21,0,100,79
1657609136683,CSE 175,A01,083665,Kumar; Rakesh,3,0,25,22
1657609142707,CSE 190,A00,092507,Dubnov; Shlomo,8,0,20,12
1657609148731,ECE 45,A01,083139,Congero; Spencer William,6,0,75,69
1657609154758,ECE 65,A50,083695,Saad; Andrew S,12,0,30,18
1657609154758,ECE 65,A51,095125,Saad; Andrew S,24,0,26,2
1657609160797,ECE 109,A01,091882,Touri; Behrouz,19,0,70,51
1657609166824,ECE 180,A00,083140,Abi Samra; Nicholas Camill,1,0,30,29
1657609166824,ECE 180,B00,083141,Abi Samra; Nicholas Camill,0,0,30,30
1657609172852,MATH 10A,A01,083735,Patchell; Gregory David,2,0,30,28
1657609172852,MATH 10A,A02,083736,Patchell; Gregory David,20,0,30,10
1657609172852,MATH 10A,A03,083737,Patchell; Gregory David,16,0,30,14
1657609178880,MATH 10B,A01,083207,Lim; Seonhee,8,0,34,26
1657609178880,MATH 10B,A02,083208,Lim; Seonhee,9,0,35,26
1657609178880,MATH 10B,A03,093472,Lim; Seonhee,7,0,34,27
1657609178880,MATH 10B,B01,083739,Sinha; Shubham,12,0,30,18
1657609184905,MATH 18,A01,083743,Cinel; Cameron Alexander,7,0,30,23
1657609184905,MATH 18,A02,083744,Cinel; Cameron Alexander,17,0,30,13
1657609184905,MATH 18,A03,083745,Cinel; Cameron Alexander,9,0,30,21
1657609184905,MATH 18,B01,083748,Rideout; David Porter,5,0,37,32
1657609184905,MATH 18,B02,083749,Rideout; David Porter,5,0,36,31
1657609184905,MATH 18,B03,083750,Rideout; David Porter,3,0,37,34
1657609184905,MATH 18,B04,083751,Rideout; David Porter,6,0,36,30
1657609184905,MATH 18,B05,093473,Rideout; David Porter,6,0,36,30
1657609184905,MATH 18,B06,093474,Rideout; David Porter,6,0,36,30
1657609190927,MATH 20A,A01,083754,Zheng; Zequn,14,0,40,26
1657609196963,MATH 20B,A01,083756,Briones; Jor-el Thomas Caparas,4,0,36,32
1657609196963,MATH 20B,A02,083757,Briones; Jor-el Thomas Caparas,1,0,36,35
1657609196963,MATH 20B,A03,093475,Briones; Jor-el Thomas Caparas,2,0,36,34
1657609202985,MATH 20C,A01,083760,Briones; Jor-el Thomas Caparas,1,0,35,34
1657609202985,MATH 20C,A02,083761,Briones; Jor-el Thomas Caparas,8,0,35,27
1657609202985,MATH 20C,A03,093476,Briones; Jor-el Thomas Caparas,0,1,36,36
1657609202985,MATH 20C,B01,083762,Bach; Quang Tran,1,0,30,29
1657609209009,MATH 20D,A01,083765,Tran; Brian Kha,5,0,30,25
1657609209009,MATH 20D,A02,083766,Tran; Brian Kha,5,0,30,25
1657609209009,MATH 20D,A03,083767,Tran; Brian Kha,5,0,30,25
1657609215032,MATH 20E,A01,083771,Ganguly; Soumya,9,0,32,23
1657609215032,MATH 20E,A02,083772,Ganguly; Soumya,6,0,32,26
1657609215032,MATH 20E,B01,083773,Ciotti; Benjamin,20,0,35,15
1657609215032,MATH 20E,B02,083774,Ciotti; Benjamin,18,0,35,17
1657609221064,MATH 103A,A01,083777,Greenfeld; Be'Eri,3,0,36,33
1657609221064,MATH 103A,A02,083778,Greenfeld; Be'Eri,5,0,36,31
1657609221064,MATH 103A,A03,093561,Greenfeld; Be'Eri,6,0,36,30
1657609221064,MATH 103A,B01,083779,Greenfeld; Be'Eri,7,0,36,29
1657609221064,MATH 103A,B02,083780,Greenfeld; Be'Eri,4,0,36,32
1657609221064,MATH 103A,B03,093562,Greenfeld; Be'Eri,3,0,36,33
1657609227088,MATH 105,A01,085443,Carter; Anne Toulson,15,0,35,20
1657609227088,MATH 105,A02,093477,Carter; Anne Toulson,20,0,35,15
1657609233112,MATH 109,A01,083213,Ganzberger; Geoffrey Michael,2,0,34,32
1657609233112,MATH 109,A02,083214,Ganzberger; Geoffrey Michael,4,0,34,30
1657609233112,MATH 109,A03,093478,Ganzberger; Geoffrey Michael,2,0,34,32
1657609233112,MATH 109,B01,083215,Ganzberger; Geoffrey Michael,1,0,32,31
1657609233112,MATH 109,B02,083216,Ganzberger; Geoffrey Michael,2,0,32,30
1657609233112,MATH 109,B03,093479,Ganzberger; Geoffrey Michael,8,0,32,24
1657609239142,MATH 142A,A01,083219,Chow; Bennett,7,0,32,25
1657609239142,MATH 142A,A02,083220,Chow; Bennett,10,0,32,22
1657609239142,MATH 142A,A03,093480,Chow; Bennett,9,0,32,23
1657609239142,MATH 142A,B03,093481,Chow; Bennett,8,0,32,24
1657609239142,MATH 142A,B04,093558,Chow; Bennett,13,0,32,19
1657609239142,MATH 142A,B05,093559,Chow; Bennett,6,0,32,26
1657609245171,MATH 193A,A01,083224,Rotar; Vladimir,8,0,34,26
1657609245171,MATH 193A,A02,083225,Rotar; Vladimir,9,0,34,25
1657609245171,MATH 193A,A03,083781,Rotar; Vladimir,5,0,34,29
1657609245171,MATH 193A,A04,083782,Rotar; Vladimir,10,0,34,24
1657609245171,MATH 193A,A05,093482,Rotar; Vladimir,10,0,34,24
1657609251199,MATH 197,001,091859,McAuley; Julian John,9999,0,9999,0
1657609251199,MATH 197,002,095566,Kedlaya; Kiran S.,9997,0,9999,2
1657609251199,MATH 197,003,095567,Xiao; Ming,9999,0,9999,0
1657609251199,MATH 197,004,095571,Perols; Johan Lars,9998,0,9999,1
1657609258256,COGS 9,A01,083615,Shannon; Kyle Michael,9,0,75,66
1657609264279,COGS 11,A01,083617,Boyle; Mary E. T.,23,0,48,25
1657609270302,COGS 13,A01,083071,Bastos; Amalia Pinkusfeld,11,0,71,60
1657609276328,COGS 14A,A01,092681,Semenuks; Arturs,5,1,100,95
1657609282352,COGS 14B,A01,083073,Cheng; Tzu-Han,6,0,63,57
1657609288381,COGS 17,A01,092677,Semenuks; Arturs,6,0,81,75
1657609294405,COGS 100,A01,083619,Allen; Michael Gordon,17,0,70,53
1657609300435,COGS 101A,A01,083621,Davis; Joshua Daniel,9,0,68,59
1657609306465,COGS 101B,A01,091572,Allen; Michael Gordon,12,0,65,53
1657609312495,COGS 101C,A01,083625,Delgado; Tania,17,0,35,18
1657609318521,COGS 107A,A01,083627,Boyle; Mary E. T.,13,0,60,47
1657609324545,COGS 118A,A01,083075,Gupta; Anjum,21,0,76,55
1657609330569,CSE 3,A50,083646,Miranda; Gregory Joseph,24,0,50,26
1657609336592,CSE 8A,A50,083650,Miranda; Gregory Joseph,17,1,56,39
1657609342615,CSE 11,A01,083080,Cao; Yingjun,6,15,40,34
1657609348645,CSE 12,A01,083652,Krause-Levy; Sophia Louisa,28,1,120,92
1657609354670,CSE 15L,A01,083654,Morris; Justin Loren,9,0,50,41
1657609354670,CSE 15L,A02,083655,Morris; Justin Loren,9,0,50,41
1657609360701,CSE 20,A01,083657,Tran; Khoa Dang,39,0,80,41
1657609366730,CSE 21,A01,095574,Bach; Quang Tran,22,0,48,26
1657609372754,CSE 30,A01,083084,Eldon; John,5,0,80,75
1657609372754,CSE 30,B01,095061,Bhaskar; Nishant,9,0,50,41
1657609378783,CSE 100,A01,083659,Cao; Yingjun,5,4,70,65
1657609384812,CSE 134B,A01,083661,Powell; Thomas Allan,22,0,100,78
1657609390836,CSE 140,A01,083663,Gungor; Onat,15,0,85,70
1657609396859,CSE 140L,A01,083088,Eldon; John,21,0,100,79
1657609402882,CSE 175,A01,083665,Kumar; Rakesh,3,0,25,22
1657609408914,CSE 190,A00,092507,Dubnov; Shlomo,8,0,20,12
1657609414939,ECE 45,A01,083139,Congero; Spencer William,6,0,75,69
1657609420971,ECE 65,A50,083695,Saad; Andrew S,12,0,30,18
1657609420971,ECE 65,A51,095125,Saad; Andrew S,24,0,26,2
1657609426994,ECE 109,A01,091882,Touri; Behrouz,19,0,70,51
1657609433022,ECE 180,A00,083140,Abi Samra; Nicholas Camill,1,0,30,29
1657609433022,ECE 180,B00,083141,Abi Samra; Nicholas Camill,0,0,30,30
1657609439046,MATH 10A,A01,083735,Patchell; Gregory David,2,0,30,28
1657609439046,MATH 10A,A02,083736,Patchell; Gregory David,20,0,30,10
1657609439046,MATH 10A,A03,083737,Patchell; Gregory David,16,0,30,14
1657609445076,MATH 10B,A01,083207,Lim; Seonhee,8,0,34,26
1657609445076,MATH 10B,A02,083208,Lim; Seonhee,9,0,35,26
1657609445076,MATH 10B,A03,093472,Lim; Seonhee,7,0,34,27
1657609445076,MATH 10B,B01,083739,Sinha; Shubham,12,0,30,18
1657609451100,MATH 18,A01,083743,Cinel; Cameron Alexander,7,0,30,23
1657609451100,MATH 18,A02,083744,Cinel; Cameron Alexander,17,0,30,13
1657609451100,MATH 18,A03,083745,Cinel; Cameron Alexander,9,0,30,21
1657609451100,MATH 18,B01,083748,Rideout; David Porter,5,0,37,32
1657609451100,MATH 18,B02,083749,Rideout; David Porter,5,0,36,31
1657609451100,MATH 18,B03,083750,Rideout; David Porter,3,0,37,34
1657609451100,MATH 18,B04,083751,Rideout; David Porter,6,0,36,30
1657609451100,MATH 18,B05,093473,Rideout; David Porter,6,0,36,30
1657609451100,MATH 18,B06,093474,Rideout; David Porter,6,0,36,30
1657609457125,MATH 20A,A01,083754,Zheng; Zequn,14,0,40,26
1657609463249,MATH 20B,A01,083756,Briones; Jor-el Thomas Caparas,4,0,36,32
1657609463249,MATH 20B,A02,083757,Briones; Jor-el Thomas Caparas,1,0,36,35
1657609463249,MATH 20B,A03,093475,Briones; Jor-el Thomas Caparas,2,0,36,34
1657609469274,MATH 20C,A01,083760,Briones; Jor-el Thomas Caparas,1,0,35,34
1657609469274,MATH 20C,A02,083761,Briones; Jor-el Thomas Caparas,8,0,35,27
1657609469274,MATH 20C,A03,093476,Briones; Jor-el Thomas Caparas,0,1,36,36
1657609469274,MATH 20C,B01,083762,Bach; Quang Tran,1,0,30,29
1657609475299,MATH 20D,A01,083765,Tran; Brian Kha,5,0,30,25
1657609475299,MATH 20D,A02,083766,Tran; Brian Kha,5,0,30,25
1657609475299,MATH 20D,A03,083767,Tran; Brian Kha,5,0,30,25
1657609481331,MATH 20E,A01,083771,Ganguly; Soumya,9,0,32,23
1657609481331,MATH 20E,A02,083772,Ganguly; Soumya,6,0,32,26
1657609481331,MATH 20E,B01,083773,Ciotti; Benjamin,20,0,35,15
1657609481331,MATH 20E,B02,083774,Ciotti; Benjamin,18,0,35,17
1657609487362,MATH 103A,A01,083777,Greenfeld; Be'Eri,3,0,36,33
1657609487362,MATH 103A,A02,083778,Greenfeld; Be'Eri,5,0,36,31
1657609487362,MATH 103A,A03,093561,Greenfeld; Be'Eri,6,0,36,30
1657609487362,MATH 103A,B01,083779,Greenfeld; Be'Eri,7,0,36,29
1657609487362,MATH 103A,B02,083780,Greenfeld; Be'Eri,4,0,36,32
1657609487362,MATH 103A,B03,093562,Greenfeld; Be'Eri,3,0,36,33
1657609493384,MATH 105,A01,085443,Carter; Anne Toulson,15,0,35,20
1657609493384,MATH 105,A02,093477,Carter; Anne Toulson,20,0,35,15
1657609499408,MATH 109,A01,083213,Ganzberger; Geoffrey Michael,2,0,34,32
1657609499408,MATH 109,A02,083214,Ganzberger; Geoffrey Michael,4,0,34,30
1657609499408,MATH 109,A03,093478,Ganzberger; Geoffrey Michael,2,0,34,32
1657609499408,MATH 109,B01,083215,Ganzberger; Geoffrey Michael,1,0,32,31
1657609499408,MATH 109,B02,083216,Ganzberger; Geoffrey Michael,2,0,32,30
1657609499408,MATH 109,B03,093479,Ganzberger; Geoffrey Michael,8,0,32,24
1657609505442,MATH 142A,A01,083219,Chow; Bennett,7,0,32,25
1657609505442,MATH 142A,A02,083220,Chow; Bennett,10,0,32,22
1657609505442,MATH 142A,A03,093480,Chow; Bennett,9,0,32,23
1657609505442,MATH 142A,B03,093481,Chow; Bennett,8,0,32,24
1657609505442,MATH 142A,B04,093558,Chow; Bennett,13,0,32,19
1657609505442,MATH 142A,B05,093559,Chow; Bennett,6,0,32,26
1657609511466,MATH 193A,A01,083224,Rotar; Vladimir,8,0,34,26
1657609511466,MATH 193A,A02,083225,Rotar; Vladimir,9,0,34,25
1657609511466,MATH 193A,A03,083781,Rotar; Vladimir,5,0,34,29
1657609511466,MATH 193A,A04,083782,Rotar; Vladimir,10,0,34,24
1657609511466,MATH 193A,A05,093482,Rotar; Vladimir,10,0,34,24
1657609517488,MATH 197,001,091859,McAuley; Julian John,9999,0,9999,0
1657609517488,MATH 197,002,095566,Kedlaya; Kiran S.,9997,0,9999,2
1657609517488,MATH 197,003,095567,Xiao; Ming,9999,0,9999,0
1657609517488,MATH 197,004,095571,Perols; Johan Lars,9998,0,9999,1
1657609524565,COGS 9,A01,083615,Shannon; Kyle Michael,9,0,75,66
1657609530588,COGS 11,A01,083617,Boyle; Mary E. T.,23,0,48,25
1657609536611,COGS 13,A01,083071,Bastos; Amalia Pinkusfeld,11,0,71,60
1657609542637,COGS 14A,A01,092681,Semenuks; Arturs,5,1,100,95
1657609548667,COGS 14B,A01,083073,Cheng; Tzu-Han,6,0,63,57
1657609554691,COGS 17,A01,092677,Semenuks; Arturs,6,0,81,75
1657609560720,COGS 100,A01,083619,Allen; Michael Gordon,17,0,70,53
1657609566752,COGS 101A,A01,083621,Davis; Joshua Daniel,9,0,68,59
1657609572778,COGS 101B,A01,091572,Allen; Michael Gordon,12,0,65,53
1657609578812,COGS 101C,A01,083625,Delgado; Tania,17,0,35,18
1657609584849,COGS 107A,A01,083627,Boyle; Mary E. T.,13,0,60,47
1657609590871,COGS 118A,A01,083075,Gupta; Anjum,21,0,76,55
1657609596895,CSE 3,A50,083646,Miranda; Gregory Joseph,24,0,50,26
1657609602928,CSE 8A,A50,083650,Miranda; Gregory Joseph,17,1,56,39
1657609608953,CSE 11,A01,083080,Cao; Yingjun,6,15,40,34
1657609614977,CSE 12,A01,083652,Krause-Levy; Sophia Louisa,28,1,120,92
1657609621004,CSE 15L,A01,083654,Morris; Justin Loren,9,0,50,41
1657609621004,CSE 15L,A02,083655,Morris; Justin Loren,9,0,50,41
1657609627028,CSE 20,A01,083657,Tran; Khoa Dang,39,0,80,41
1657609633051,CSE 21,A01,095574,Bach; Quang Tran,22,0,48,26
1657609639080,CSE 30,A01,083084,Eldon; John,5,0,80,75
1657609639080,CSE 30,B01,095061,Bhaskar; Nishant,9,0,50,41
1657609645107,CSE 100,A01,083659,Cao; Yingjun,5,4,70,65
1657609651129,CSE 134B,A01,083661,Powell; Thomas Allan,22,0,100,78
1657609657158,CSE 140,A01,083663,Gungor; Onat,15,0,85,70
1657609663183,CSE 140L,A01,083088,Eldon; John,21,0,100,79
1657609669206,CSE 175,A01,083665,Kumar; Rakesh,3,0,25,22
1657609675228,CSE 190,A00,092507,Dubnov; Shlomo,8,0,20,12
1657609681255,ECE 45,A01,083139,Congero; Spencer William,6,0,75,69
1657609687285,ECE 65,A50,083695,Saad; Andrew S,12,0,30,18
1657609687285,ECE 65,A51,095125,Saad; Andrew S,24,0,26,2
1657609693313,ECE 109,A01,091882,Touri; Behrouz,19,0,70,51
1657609699350,ECE 180,A00,083140,Abi Samra; Nicholas Camill,1,0,30,29
1657609699350,ECE 180,B00,083141,Abi Samra; Nicholas Camill,0,0,30,30
1657609705379,MATH 10A,A01,083735,Patchell; Gregory David,2,0,30,28
1657609705379,MATH 10A,A02,083736,Patchell; Gregory David,20,0,30,10
1657609705379,MATH 10A,A03,083737,Patchell; Gregory David,16,0,30,14
1657609711406,MATH 10B,A01,083207,Lim; Seonhee,8,0,34,26
1657609711406,MATH 10B,A02,083208,Lim; Seonhee,9,0,35,26
1657609711406,MATH 10B,A03,093472,Lim; Seonhee,7,0,34,27
1657609711406,MATH 10B,B01,083739,Sinha; Shubham,12,0,30,18
1657609717433,MATH 18,A01,083743,Cinel; Cameron Alexander,7,0,30,23
1657609717433,MATH 18,A02,083744,Cinel; Cameron Alexander,17,0,30,13
1657609717433,MATH 18,A03,083745,Cinel; Cameron Alexander,9,0,30,21
1657609717433,MATH 18,B01,083748,Rideout; David Porter,5,0,37,32
1657609717433,MATH 18,B02,083749,Rideout; David Porter,5,0,36,31
1657609717433,MATH 18,B03,083750,Rideout; David Porter,3,0,37,34
1657609717433,MATH 18,B04,083751,Rideout; David Porter,6,0,36,30
1657609717433,MATH 18,B05,093473,Rideout; David Porter,6,0,36,30
1657609717433,MATH 18,B06,093474,Rideout; David Porter,6,0,36,30
1657609723463,MATH 20A,A01,083754,Zheng; Zequn,14,0,40,26
1657609729487,MATH 20B,A01,083756,Briones; Jor-el Thomas Caparas,4,0,36,32
1657609729487,MATH 20B,A02,083757,Briones; Jor-el Thomas Caparas,1,0,36,35
1657609729487,MATH 20B,A03,093475,Briones; Jor-el Thomas Caparas,2,0,36,34
1657609735517,MATH 20C,A01,083760,Briones; Jor-el Thomas Caparas,1,0,35,34
1657609735517,MATH 20C,A02,083761,Briones; Jor-el Thomas Caparas,8,0,35,27
1657609735517,MATH 20C,A03,093476,Briones; Jor-el Thomas Caparas,0,1,36,36
1657609735517,MATH 20C,B01,083762,Bach; Quang Tran,1,0,30,29
1657609741549,MATH 20D,A01,083765,Tran; Brian Kha,5,0,30,25
1657609741549,MATH 20D,A02,083766,Tran; Brian Kha,5,0,30,25
1657609741549,MATH 20D,A03,083767,Tran; Brian Kha,5,0,30,25
1657609747581,MATH 20E,A01,083771,Ganguly; Soumya,9,0,32,23
1657609747581,MATH 20E,A02,083772,Ganguly; Soumya,6,0,32,26
1657609747581,MATH 20E,B01,083773,Ciotti; Benjamin,20,0,35,15
1657609747581,MATH 20E,B02,083774,Ciotti; Benjamin,18,0,35,17
1657609753604,MATH 103A,A01,083777,Greenfeld; Be'Eri,3,0,36,33
1657609753604,MATH 103A,A02,083778,Greenfeld; Be'Eri,5,0,36,31
1657609753604,MATH 103A,A03,093561,Greenfeld; Be'Eri,6,0,36,30
1657609753604,MATH 103A,B01,083779,Greenfeld; Be'Eri,7,0,36,29
1657609753604,MATH 103A,B02,083780,Greenfeld; Be'Eri,4,0,36,32
1657609753604,MATH 103A,B03,093562,Greenfeld; Be'Eri,3,0,36,33
1657609759637,MATH 105,A01,085443,Carter; Anne Toulson,15,0,35,20
1657609759637,MATH 105,A02,093477,Carter; Anne Toulson,20,0,35,15
1657609765668,MATH 109,A01,083213,Ganzberger; Geoffrey Michael,2,0,34,32
1657609765668,MATH 109,A02,083214,Ganzberger; Geoffrey Michael,4,0,34,30
1657609765668,MATH 109,A03,093478,Ganzberger; Geoffrey Michael,2,0,34,32
1657609765668,MATH 109,B01,083215,Ganzberger; Geoffrey Michael,1,0,32,31
1657609765668,MATH 109,B02,083216,Ganzberger; Geoffrey Michael,2,0,32,30
1657609765668,MATH 109,B03,093479,Ganzberger; Geoffrey Michael,8,0,32,24
1657609771694,MATH 142A,A01,083219,Chow; Bennett,7,0,32,25
1657609771694,MATH 142A,A02,083220,Chow; Bennett,10,0,32,22
1657609771694,MATH 142A,A03,093480,Chow; Bennett,9,0,32,23
1657609771694,MATH 142A,B03,093481,Chow; Bennett,8,0,32,24
1657609771694,MATH 142A,B04,093558,Chow; Bennett,13,0,32,19
1657609771694,MATH 142A,B05,093559,Chow; Bennett,6,0,32,26
1657609777728,MATH 193A,A01,083224,Rotar; Vladimir,8,0,34,26
1657609777728,MATH 193A,A02,083225,Rotar; Vladimir,9,0,34,25
1657609777728,MATH 193A,A03,083781,Rotar; Vladimir,5,0,34,29
1657609777728,MATH 193A,A04,083782,Rotar; Vladimir,10,0,34,24
1657609777728,MATH 193A,A05,093482,Rotar; Vladimir,10,0,34,24
1657609783754,MATH 197,001,091859,McAuley; Julian John,9999,0,9999,0
1657609783754,MATH 197,002,095566,Kedlaya; Kiran S.,9997,0,9999,2
1657609783754,MATH 197,003,095567,Xiao; Ming,9999,0,9999,0
1657609783754,MATH 197,004,095571,Perols; Johan Lars,9998,0,9999,1
1657609790808,COGS 9,A01,083615,Shannon; Kyle Michael,9,0,75,66
1657609796832,COGS 11,A01,083617,Boyle; Mary E. T.,23,0,48,25
1657609802856,COGS 13,A01,083071,Bastos; Amalia Pinkusfeld,11,0,71,60
1657609808879,COGS 14A,A01,092681,Semenuks; Arturs,5,1,100,95
1657609814901,COGS 14B,A01,083073,Cheng; Tzu-Han,6,0,63,57
1657609820924,COGS 17,A01,092677,Semenuks; Arturs,6,0,81,75
1657609826950,COGS 100,A01,083619,Allen; Michael Gordon,17,0,70,53
1657609832974,COGS 101A,A01,083621,Davis; Joshua Daniel,9,0,68,59
1657609839012,COGS 101B,A01,091572,Allen; Michael Gordon,12,0,65,53
1657609845042,COGS 101C,A01,083625,Delgado; Tania,17,0,35,18
1657609851073,COGS 107A,A01,083627,Boyle; Mary E. T.,13,0,60,47
1657609857100,COGS 118A,A01,083075,Gupta; Anjum,21,0,76,55
1657609863130,CSE 3,A50,083646,Miranda; Gregory Joseph,24,0,50,26
1657609869154,CSE 8A,A50,083650,Miranda; Gregory Joseph,17,1,56,39
1657609875192,CSE 11,A01,083080,Cao; Yingjun,6,15,40,34
1657609881218,CSE 12,A01,083652,Krause-Levy; Sophia Louisa,28,1,120,92
1657609887241,CSE 15L,A01,083654,Morris; Justin Loren,9,0,50,41
1657609887241,CSE 15L,A02,083655,Morris; Justin Loren,9,0,50,41
1657609893301,CSE 20,A01,083657,Tran; Khoa Dang,39,0,80,41
1657609899327,CSE 21,A01,095574,Bach; Quang Tran,22,0,48,26
1657609905466,CSE 30,A01,083084,Eldon; John,5,0,80,75
1657609905466,CSE 30,B01,095061,Bhaskar; Nishant,9,0,50,41
1657609911658,CSE 100,A01,083659,Cao; Yingjun,5,4,70,65
1657609917742,CSE 134B,A01,083661,Powell; Thomas Allan,22,0,100,78
1657609923787,CSE 140,A01,083663,Gungor; Onat,15,0,85,70
1657609929811,CSE 140L,A01,083088,Eldon; John,21,0,100,79
1657609935834,CSE 175,A01,083665,Kumar; Rakesh,3,0,25,22
1657609941860,CSE 190,A00,092507,Dubnov; Shlomo,8,0,20,12
1657609947884,ECE 45,A01,083139,Congero; Spencer William,6,0,75,69
1657609953910,ECE 65,A50,083695,Saad; Andrew S,12,0,30,18
1657609953910,ECE 65,A51,095125,Saad; Andrew S,24,0,26,2
1657609959935,ECE 109,A01,091882,Touri; Behrouz,19,0,70,51
1657609965958,ECE 180,A00,083140,Abi Samra; Nicholas Camill,1,0,30,29
1657609965958,ECE 180,B00,083141,Abi Samra; Nicholas Camill,0,0,30,30
1657609971988,MATH 10A,A01,083735,Patchell; Gregory David,2,0,30,28
1657609971988,MATH 10A,A02,083736,Patchell; Gregory David,20,0,30,10
1657609971988,MATH 10A,A03,083737,Patchell; Gregory David,16,0,30,14
1657609978021,MATH 10B,A01,083207,Lim; Seonhee,8,0,34,26
1657609978021,MATH 10B,A02,083208,Lim; Seonhee,9,0,35,26
1657609978021,MATH 10B,A03,093472,Lim; Seonhee,7,0,34,27
1657609978021,MATH 10B,B01,083739,Sinha; Shubham,12,0,30,18
1657609984045,MATH 18,A01,083743,Cinel; Cameron Alexander,7,0,30,23
1657609984045,MATH 18,A02,083744,Cinel; Cameron Alexander,17,0,30,13
1657609984045,MATH 18,A03,083745,Cinel; Cameron Alexander,9,0,30,21
1657609984045,MATH 18,B01,083748,Rideout; David Porter,5,0,37,32
1657609984045,MATH 18,B02,083749,Rideout; David Porter,5,0,36,31
1657609984045,MATH 18,B03,083750,Rideout; David Porter,3,0,37,34
1657609984045,MATH 18,B04,083751,Rideout; David Porter,6,0,36,30
1657609984045,MATH 18,B05,093473,Rideout; David Porter,6,0,36,30
1657609984045,MATH 18,B06,093474,Rideout; David Porter,6,0,36,30
1657609990082,MATH 20A,A01,083754,Zheng; Zequn,14,0,40,26
1657609996112,MATH 20B,A01,083756,Briones; Jor-el Thomas Caparas,4,0,36,32
1657609996112,MATH 20B,A02,083757,Briones; Jor-el Thomas Caparas,1,0,36,35
1657609996112,MATH 20B,A03,093475,Briones; Jor-el Thomas Caparas,2,0,36,34
1657610002136,MATH 20C,A01,083760,Briones; Jor-el Thomas Caparas,1,0,35,34
1657610002136,MATH 20C,A02,083761,Briones; Jor-el Thomas Caparas,8,0,35,27
1657610002136,MATH 20C,A03,093476,Briones; Jor-el Thomas Caparas,0,1,36,36
1657610002136,MATH 20C,B01,083762,Bach; Quang Tran,1,0,30,29
1657610008170,MATH 20D,A01,083765,Tran; Brian Kha,5,0,30,25
1657610008170,MATH 20D,A02,083766,Tran; Brian Kha,5,0,30,25
1657610008170,MATH 20D,A03,083767,Tran; Brian Kha,5,0,30,25
1657610014200,MATH 20E,A01,083771,Ganguly; Soumya,9,0,32,23
1657610014200,MATH 20E,A02,083772,Ganguly; Soumya,6,0,32,26
1657610014200,MATH 20E,B01,083773,Ciotti; Benjamin,20,0,35,15
1657610014200,MATH 20E,B02,083774,Ciotti; Benjamin,18,0,35,17
1657610020235,MATH 103A,A01,083777,Greenfeld; Be'Eri,3,0,36,33
1657610020235,MATH 103A,A02,083778,Greenfeld; Be'Eri,5,0,36,31
1657610020235,MATH 103A,A03,093561,Greenfeld; Be'Eri,6,0,36,30
1657610020235,MATH 103A,B01,083779,Greenfeld; Be'Eri,7,0,36,29
1657610020235,MATH 103A,B02,083780,Greenfeld; Be'Eri,4,0,36,32
1657610020235,MATH 103A,B03,093562,Greenfeld; Be'Eri,3,0,36,33
1657610026260,MATH 105,A01,085443,Carter; Anne Toulson,15,0,35,20
1657610026260,MATH 105,A02,093477,Carter; Anne Toulson,20,0,35,15
1657610032293,MATH 109,A01,083213,Ganzberger; Geoffrey Michael,2,0,34,32
1657610032293,MATH 109,A02,083214,Ganzberger; Geoffrey Michael,4,0,34,30
1657610032293,MATH 109,A03,093478,Ganzberger; Geoffrey Michael,2,0,34,32
1657610032293,MATH 109,B01,083215,Ganzberger; Geoffrey Michael,1,0,32,31
1657610032293,MATH 109,B02,083216,Ganzberger; Geoffrey Michael,2,0,32,30
1657610032293,MATH 109,B03,093479,Ganzberger; Geoffrey Michael,8,0,32,24
1657610038319,MATH 142A,A01,083219,Chow; Bennett,7,0,32,25
1657610038319,MATH 142A,A02,083220,Chow; Bennett,10,0,32,22
1657610038319,MATH 142A,A03,093480,Chow; Bennett,9,0,32,23
1657610038319,MATH 142A,B03,093481,Chow; Bennett,8,0,32,24
1657610038319,MATH 142A,B04,093558,Chow; Bennett,13,0,32,19
1657610038319,MATH 142A,B05,093559,Chow; Bennett,6,0,32,26
1657610044344,MATH 193A,A01,083224,Rotar; Vladimir,8,0,34,26
1657610044344,MATH 193A,A02,083225,Rotar; Vladimir,9,0,34,25
1657610044344,MATH 193A,A03,083781,Rotar; Vladimir,5,0,34,29
1657610044344,MATH 193A,A04,083782,Rotar; Vladimir,10,0,34,24
1657610044344,MATH 193A,A05,093482,Rotar; Vladimir,10,0,34,24
1657610050368,MATH 197,001,091859,McAuley; Julian John,9999,0,9999,0
1657610050368,MATH 197,002,095566,Kedlaya; Kiran S.,9997,0,9999,2
1657610050368,MATH 197,003,095567,Xiao; Ming,9999,0,9999,0
1657610050368,MATH 197,004,095571,Perols; Johan Lars,9998,0,9999,1
1657610057500,COGS 9,A01,083615,Shannon; Kyle Michael,9,0,75,66
1657610063542,COGS 11,A01,083617,Boyle; Mary E. T.,23,0,48,25
1657610069571,COGS 13,A01,083071,Bastos; Amalia Pinkusfeld,11,0,71,60
1657610075595,COGS 14A,A01,092681,Semenuks; Arturs,5,1,100,95
1657610081618,COGS 14B,A01,083073,Cheng; Tzu-Han,6,0,63,57
1657610087650,COGS 17,A01,092677,Semenuks; Arturs,6,0,81,75
1657610093680,COGS 100,A01,083619,Allen; Michael Gordon,17,0,70,53
1657610099712,COGS 101A,A01,083621,Davis; Joshua Daniel,9,0,68,59
1657610105742,COGS 101B,A01,091572,Allen; Michael Gordon,12,0,65,53
1657610111780,COGS 101C,A01,083625,Delgado; Tania,17,0,35,18
1657610117807,COGS 107A,A01,083627,Boyle; Mary E. T.,13,0,60,47
1657610123838,COGS 118A,A01,083075,Gupta; Anjum,21,0,76,55
1657610129872,CSE 3,A50,083646,Miranda; Gregory Joseph,24,0,50,26
1657610135895,CSE 8A,A50,083650,Miranda; Gregory Joseph,17,1,56,39
1657610141918,CSE 11,A01,083080,Cao; Yingjun,6,15,40,34
1657610147948,CSE 12,A01,083652,Krause-Levy; Sophia Louisa,28,1,120,92
1657610153978,CSE 15L,A01,083654,Morris; Justin Loren,9,0,50,41
1657610153978,CSE 15L,A02,083655,Morris; Justin Loren,9,0,50,41
1657610160010,CSE 20,A01,083657,Tran; Khoa Dang,39,0,80,41
1657610166047,CSE 21,A01,095574,Bach; Quang Tran,22,0,48,26
1657610172096,CSE 30,A01,083084,Eldon; John,5,0,80,75
1657610172096,CSE 30,B01,095061,Bhaskar; Nishant,9,0,50,41
1657610178129,CSE 100,A01,083659,Cao; Yingjun,5,4,70,65
1657610184155,CSE 134B,A01,083661,Powell; Thomas Allan,22,0,100,78
1657610190180,CSE 140,A01,083663,Gungor; Onat,15,0,85,70
1657610196214,CSE 140L,A01,083088,Eldon; John,21,0,100,79
1657610202247,CSE 175,A01,083665,Kumar; Rakesh,3,0,25,22
1657610208283,CSE 190,A00,092507,Dubnov; Shlomo,8,0,20,12
1657610214310,ECE 45,A01,083139,Congero; Spencer William,6,0,75,69
1657610220341,ECE 65,A50,083695,Saad; Andrew S,12,0,30,18
1657610220341,ECE 65,A51,095125,Saad; Andrew S,24,0,26,2
1657610226375,ECE 109,A01,091882,Touri; Behrouz,19,0,70,51
1657610232407,ECE 180,A00,083140,Abi Samra; Nicholas Camill,1,0,30,29
1657610232407,ECE 180,B00,083141,Abi Samra; Nicholas Camill,0,0,30,30
1657610238456,MATH 10A,A01,083735,Patchell; Gregory David,2,0,30,28
1657610238456,MATH 10A,A02,083736,Patchell; Gregory David,20,0,30,10
1657610238456,MATH 10A,A03,083737,Patchell; Gregory David,16,0,30,14
1657610244492,MATH 10B,A01,083207,Lim; Seonhee,8,0,34,26
1657610244492,MATH 10B,A02,083208,Lim; Seonhee,9,0,35,26
1657610244492,MATH 10B,A03,093472,Lim; Seonhee,7,0,34,27
1657610244492,MATH 10B,B01,083739,Sinha; Shubham,12,0,30,18
1657610250532,MATH 18,A01,083743,Cinel; Cameron Alexander,7,0,30,23
1657610250532,MATH 18,A02,083744,Cinel; Cameron Alexander,17,0,30,13
1657610250532,MATH 18,A03,083745,Cinel; Cameron Alexander,9,0,30,21
1657610250532,MATH 18,B01,083748,Rideout; David Porter,5,0,37,32
1657610250532,MATH 18,B02,083749,Rideout; David Porter,5,0,36,31
1657610250532,MATH 18,B03,083750,Rideout; David Porter,3,0,37,34
1657610250532,MATH 18,B04,083751,Rideout; David Porter,6,0,36,30
1657610250532,MATH 18,B05,093473,Rideout; David Porter,6,0,36,30
1657610250532,MATH 18,B06,093474,Rideout; David Porter,6,0,36,30
1657610256564,MATH 20A,A01,083754,Zheng; Zequn,14,0,40,26
1657610262597,MATH 20B,A01,083756,Briones; Jor-el Thomas Caparas,4,0,36,32
1657610262597,MATH 20B,A02,083757,Briones; Jor-el Thomas Caparas,1,0,36,35
1657610262597,MATH 20B,A03,093475,Briones; Jor-el Thomas Caparas,2,0,36,34
1657610268620,MATH 20C,A01,083760,Briones; Jor-el Thomas Caparas,1,0,35,34
1657610268620,MATH 20C,A02,083761,Briones; Jor-el Thomas Caparas,8,0,35,27
1657610268620,MATH 20C,A03,093476,Briones; Jor-el Thomas Caparas,0,1,36,36
1657610268620,MATH 20C,B01,083762,Bach; Quang Tran,1,0,30,29
1657610274648,MATH 20D,A01,083765,Tran; Brian Kha,5,0,30,25
1657610274648,MATH 20D,A02,083766,Tran; Brian Kha,5,0,30,25
1657610274648,MATH 20D,A03,083767,Tran; Brian Kha,5,0,30,25
1657610280675,MATH 20E,A01,083771,Ganguly; Soumya,9,0,32,23
1657610280675,MATH 20E,A02,083772,Ganguly; Soumya,6,0,32,26
1657610280675,MATH 20E,B01,083773,Ciotti; Benjamin,20,0,35,15
1657610280675,MATH 20E,B02,083774,Ciotti; Benjamin,18,0,35,17
1657610286702,MATH 103A,A01,083777,Greenfeld; Be'Eri,3,0,36,33
1657610286702,MATH 103A,A02,083778,Greenfeld; Be'Eri,5,0,36,31
1657610286702,MATH 103A,A03,093561,Greenfeld; Be'Eri,6,0,36,30
1657610286702,MATH 103A,B01,083779,Greenfeld; Be'Eri,7,0,36,29
1657610286702,MATH 103A,B02,083780,Greenfeld; Be'Eri,4,0,36,32
1657610286702,MATH 103A,B03,093562,Greenfeld; Be'Eri,3,0,36,33
1657610292727,MATH 105,A01,085443,Carter; Anne Toulson,15,0,35,20
1657610292727,MATH 105,A02,093477,Carter; Anne Toulson,20,0,35,15
1657610298760,MATH 109,A01,083213,Ganzberger; Geoffrey Michael,2,0,34,32
1657610298760,MATH 109,A02,083214,Ganzberger; Geoffrey Michael,4,0,34,30
1657610298760,MATH 109,A03,093478,Ganzberger; Geoffrey Michael,2,0,34,32
1657610298760,MATH 109,B01,083215,Ganzberger; Geoffrey Michael,1,0,32,31
1657610298760,MATH 109,B02,083216,Ganzberger; Geoffrey Michael,2,0,32,30
1657610298760,MATH 109,B03,093479,Ganzberger; Geoffrey Michael,8,0,32,24
1657610304786,MATH 142A,A01,083219,Chow; Bennett,7,0,32,25
1657610304786,MATH 142A,A02,083220,Chow; Bennett,10,0,32,22
1657610304786,MATH 142A,A03,093480,Chow; Bennett,9,0,32,23
1657610304786,MATH 142A,B03,093481,Chow; Bennett,8,0,32,24
1657610304786,MATH 142A,B04,093558,Chow; Bennett,13,0,32,19
1657610304786,MATH 142A,B05,093559,Chow; Bennett,6,0,32,26
1657610310810,MATH 193A,A01,083224,Rotar; Vladimir,8,0,34,26
1657610310810,MATH 193A,A02,083225,Rotar; Vladimir,9,0,34,25
1657610310810,MATH 193A,A03,083781,Rotar; Vladimir,5,0,34,29
1657610310810,MATH 193A,A04,083782,Rotar; Vladimir,10,0,34,24
1657610310810,MATH 193A,A05,093482,Rotar; Vladimir,10,0,34,24
1657610316838,MATH 197,001,091859,McAuley; Julian John,9999,0,9999,0
1657610316838,MATH 197,002,095566,Kedlaya; Kiran S.,9997,0,9999,2
1657610316838,MATH 197,003,095567,Xiao; Ming,9999,0,9999,0
1657610316838,MATH 197,004,095571,Perols; Johan Lars,9998,0,9999,1
1657610323917,COGS 9,A01,083615,Shannon; Kyle Michael,9,0,75,66
1657610329942,COGS 11,A01,083617,Boyle; Mary E. T.,23,0,48,25
1657610335968,COGS 13,A01,083071,Bastos; Amalia Pinkusfeld,11,0,71,60
1657610341997,COGS 14A,A01,092681,Semenuks; Arturs,5,1,100,95
1657610348021,COGS 14B,A01,083073,Cheng; Tzu-Han,6,0,63,57
1657610354055,COGS 17,A01,092677,Semenuks; Arturs,6,0,81,75
1657610360085,COGS 100,A01,083619,Allen; Michael Gordon,17,0,70,53
1657610366114,COGS 101A,A01,083621,Davis; Joshua Daniel,9,0,68,59
1657610372138,COGS 101B,A01,091572,Allen; Michael Gordon,12,0,65,53
1657610378161,COGS 101C,A01,083625,Delgado; Tania,17,0,35,18
1657610384200,COGS 107A,A01,083627,Boyle; Mary E. T.,13,0,60,47
1657610390224,COGS 118A,A01,083075,Gupta; Anjum,21,0,76,55
1657610396250,CSE 3,A50,083646,Miranda; Gregory Joseph,24,0,50,26
1657610402272,CSE 8A,A50,083650,Miranda; Gregory Joseph,17,1,56,39
1657610408300,CSE 11,A01,083080,Cao; Yingjun,6,15,40,34
1657610414332,CSE 12,A01,083652,Krause-Levy; Sophia Louisa,28,1,120,92
1657610420358,CSE 15L,A01,083654,Morris; Justin Loren,9,0,50,41
1657610420358,CSE 15L,A02,083655,Morris; Justin Loren,9,0,50,41
1657610426382,CSE 20,A01,083657,Tran; Khoa Dang,39,0,80,41
1657610432428,CSE 21,A01,095574,Bach; Quang Tran,22,0,48,26
1657610438453,CSE 30,A01,083084,Eldon; John,5,0,80,75
1657610438453,CSE 30,B01,095061,Bhaskar; Nishant,9,0,50,41
1657610444481,CSE 100,A01,083659,Cao; Yingjun,5,4,70,65
1657610450507,CSE 134B,A01,083661,Powell; Thomas Allan,22,0,100,78
1657610456529,CSE 140,A01,083663,Gungor; Onat,15,0,85,70
1657610462553,CSE 140L,A01,083088,Eldon; John,21,0,100,79
1657610468577,CSE 175,A01,083665,Kumar; Rakesh,3,0,25,22
1657610474604,CSE 190,A00,092507,Dubnov; Shlomo,8,0,20,12
1657610480630,ECE 45,A01,083139,Congero; Spencer William,6,0,75,69
1657610486657,ECE 65,A50,083695,Saad; Andrew S,12,0,30,18
1657610486657,ECE 65,A51,095125,Saad; Andrew S,24,0,26,2
1657610492680,ECE 109,A01,091882,Touri; Behrouz,19,0,70,51
1657610498712,ECE 180,A00,083140,Abi Samra; Nicholas Camill,1,0,30,29
1657610498712,ECE 180,B00,083141,Abi Samra; Nicholas Camill,0,0,30,30
1657610504747,MATH 10A,A01,083735,Patchell; Gregory David,2,0,30,28
1657610504747,MATH 10A,A02,083736,Patchell; Gregory David,20,0,30,10
1657610504747,MATH 10A,A03,083737,Patchell; Gregory David,16,0,30,14
1657610510777,MATH 10B,A01,083207,Lim; Seonhee,8,0,34,26
1657610510777,MATH 10B,A02,083208,Lim; Seonhee,9,0,35,26
1657610510777,MATH 10B,A03,093472,Lim; Seonhee,7,0,34,27
1657610510777,MATH 10B,B01,083739,Sinha; Shubham,12,0,30,18
1657610516810,MATH 18,A01,083743,Cinel; Cameron Alexander,7,0,30,23
1657610516810,MATH 18,A02,083744,Cinel; Cameron Alexander,17,0,30,13
1657610516810,MATH 18,A03,083745,Cinel; Cameron Alexander,9,0,30,21
1657610516810,MATH 18,B01,083748,Rideout; David Porter,5,0,37,32
1657610516810,MATH 18,B02,083749,Rideout; David Porter,5,0,36,31
1657610516810,MATH 18,B03,083750,Rideout; David Porter,3,0,37,34
1657610516810,MATH 18,B04,083751,Rideout; David Porter,6,0,36,30
1657610516810,MATH 18,B05,093473,Rideout; David Porter,6,0,36,30
1657610516810,MATH 18,B06,093474,Rideout; David Porter,6,0,36,30
1657610522846,MATH 20A,A01,083754,Zheng; Zequn,14,0,40,26
1657610528872,MATH 20B,A01,083756,Briones; Jor-el Thomas Caparas,4,0,36,32
1657610528872,MATH 20B,A02,083757,Briones; Jor-el Thomas Caparas,1,0,36,35
1657610528872,MATH 20B,A03,093475,Briones; Jor-el Thomas Caparas,2,0,36,34
1657610534897,MATH 20C,A01,083760,Briones; Jor-el Thomas Caparas,1,0,35,34
1657610534897,MATH 20C,A02,083761,Briones; Jor-el Thomas Caparas,8,0,35,27
1657610534897,MATH 20C,A03,093476,Briones; Jor-el Thomas Caparas,0,1,36,36
1657610534897,MATH 20C,B01,083762,Bach; Quang Tran,1,0,30,29
1657610540921,MATH 20D,A01,083765,Tran; Brian Kha,5,0,30,25
1657610540921,MATH 20D,A02,083766,Tran; Brian Kha,5,0,30,25
1657610540921,MATH 20D,A03,083767,Tran; Brian Kha,5,0,30,25
1657610546947,MATH 20E,A01,083771,Ganguly; Soumya,9,0,32,23
1657610546947,MATH 20E,A02,083772,Ganguly; Soumya,6,0,32,26
1657610546947,MATH 20E,B01,083773,Ciotti; Benjamin,20,0,35,15
1657610546947,MATH 20E,B02,083774,Ciotti; Benjamin,18,0,35,17
1657610552973,MATH 103A,A01,083777,Greenfeld; Be'Eri,3,0,36,33
1657610552973,MATH 103A,A02,083778,Greenfeld; Be'Eri,5,0,36,31
1657610552973,MATH 103A,A03,093561,Greenfeld; Be'Eri,6,0,36,30
1657610552973,MATH 103A,B01,083779,Greenfeld; Be'Eri,7,0,36,29
1657610552973,MATH 103A,B02,083780,Greenfeld; Be'Eri,4,0,36,32
1657610552973,MATH 103A,B03,093562,Greenfeld; Be'Eri,3,0,36,33
1657610558998,MATH 105,A01,085443,Carter; Anne Toulson,15,0,35,20
1657610558998,MATH 105,A02,093477,Carter; Anne Toulson,20,0,35,15
1657610565023,MATH 109,A01,083213,Ganzberger; Geoffrey Michael,2,0,34,32
1657610565023,MATH 109,A02,083214,Ganzberger; Geoffrey Michael,4,0,34,30
1657610565023,MATH 109,A03,093478,Ganzberger; Geoffrey Michael,2,0,34,32
1657610565023,MATH 109,B01,083215,Ganzberger; Geoffrey Michael,1,0,32,31
1657610565023,MATH 109,B02,083216,Ganzberger; Geoffrey Michael,2,0,32,30
1657610565023,MATH 109,B03,093479,Ganzberger; Geoffrey Michael,8,0,32,24
1657610571056,MATH 142A,A01,083219,Chow; Bennett,7,0,32,25
1657610571056,MATH 142A,A02,083220,Chow; Bennett,10,0,32,22
1657610571056,MATH 142A,A03,093480,Chow; Bennett,9,0,32,23
1657610571056,MATH 142A,B03,093481,Chow; Bennett,8,0,32,24
1657610571056,MATH 142A,B04,093558,Chow; Bennett,13,0,32,19
1657610571056,MATH 142A,B05,093559,Chow; Bennett,6,0,32,26
1657610577090,MATH 193A,A01,083224,Rotar; Vladimir,8,0,34,26
1657610577090,MATH 193A,A02,083225,Rotar; Vladimir,9,0,34,25
1657610577090,MATH 193A,A03,083781,Rotar; Vladimir,5,0,34,29
1657610577090,MATH 193A,A04,083782,Rotar; Vladimir,10,0,34,24
1657610577090,MATH 193A,A05,093482,Rotar; Vladimir,10,0,34,24
1657610583115,MATH 197,001,091859,McAuley; Julian John,9999,0,9999,0
1657610583115,MATH 197,002,095566,Kedlaya; Kiran S.,9997,0,9999,2
1657610583115,MATH 197,003,095567,Xiao; Ming,9999,0,9999,0
1657610583115,MATH 197,004,095571,Perols; Johan Lars,9998,0,9999,1
1657610590192,COGS 9,A01,083615,Shannon; Kyle Michael,9,0,75,66
1657610596214,COGS 11,A01,083617,Boyle; Mary E. T.,23,0,48,25
1657610602239,COGS 13,A01,083071,Bastos; Amalia Pinkusfeld,11,0,71,60
1657610608268,COGS 14A,A01,092681,Semenuks; Arturs,5,1,100,95
1657610614303,COGS 14B,A01,083073,Cheng; Tzu-Han,6,0,63,57
1657610620327,COGS 17,A01,092677,Semenuks; Arturs,6,0,81,75
1657610626352,COGS 100,A01,083619,Allen; Michael Gordon,17,0,70,53
1657610632381,COGS 101A,A01,083621,Davis; Joshua Daniel,9,0,68,59
1657610638405,COGS 101B,A01,091572,Allen; Michael Gordon,12,0,65,53
1657610644428,COGS 101C,A01,083625,Delgado; Tania,17,0,35,18
1657610650453,COGS 107A,A01,083627,Boyle; Mary E. T.,13,0,60,47
1657610656548,COGS 118A,A01,083075,Gupta; Anjum,21,0,76,55
1657610662574,CSE 3,A50,083646,Miranda; Gregory Joseph,24,0,50,26
1657610668607,CSE 8A,A50,083650,Miranda; Gregory Joseph,17,1,56,39
1657610674638,CSE 11,A01,083080,Cao; Yingjun,6,15,40,34
1657610680663,CSE 12,A01,083652,Krause-Levy; Sophia Louisa,28,1,120,92
1657610686689,CSE 15L,A01,083654,Morris; Justin Loren,9,0,50,41
1657610686689,CSE 15L,A02,083655,Morris; Justin Loren,9,0,50,41
1657610692712,CSE 20,A01,083657,Tran; Khoa Dang,39,0,80,41
1657610698740,CSE 21,A01,095574,Bach; Quang Tran,22,0,48,26
1657610704767,CSE 30,A01,083084,Eldon; John,5,0,80,75
1657610704767,CSE 30,B01,095061,Bhaskar; Nishant,9,0,50,41
1657610710789,CSE 100,A01,083659,Cao; Yingjun,5,4,70,65
1657610716812,CSE 134B,A01,083661,Powell; Thomas Allan,22,0,100,78
1657610722867,CSE 140,A01,083663,Gungor; Onat,15,0,85,70
1657610728892,CSE 140L,A01,083088,Eldon; John,21,0,100,79
1657610734920,CSE 175,A01,083665,Kumar; Rakesh,3,0,25,22
1657610740962,CSE 190,A00,092507,Dubnov; Shlomo,8,0,20,12
1657610746995,ECE 45,A01,083139,Congero; Spencer William,6,0,75,69
1657610753033,ECE 65,A50,083695,Saad; Andrew S,12,0,30,18
1657610753033,ECE 65,A51,095125,Saad; Andrew S,24,0,26,2
1657610759057,ECE 109,A01,091882,Touri; Behrouz,19,0,70,51
1657610765081,ECE 180,A00,083140,Abi Samra; Nicholas Camill,1,0,30,29
1657610765081,ECE 180,B00,083141,Abi Samra; Nicholas Camill,0,0,30,30
1657610771105,MATH 10A,A01,083735,Patchell; Gregory David,2,0,30,28
1657610771105,MATH 10A,A02,083736,Patchell; Gregory David,20,0,30,10
1657610771105,MATH 10A,A03,083737,Patchell; Gregory David,16,0,30,14
1657610777129,MATH 10B,A01,083207,Lim; Seonhee,8,0,34,26
1657610777129,MATH 10B,A02,083208,Lim; Seonhee,9,0,35,26
1657610777129,MATH 10B,A03,093472,Lim; Seonhee,7,0,34,27
1657610777129,MATH 10B,B01,083739,Sinha; Shubham,12,0,30,18
1657610783156,MATH 18,A01,083743,Cinel; Cameron Alexander,7,0,30,23
1657610783156,MATH 18,A02,083744,Cinel; Cameron Alexander,17,0,30,13
1657610783156,MATH 18,A03,083745,Cinel; Cameron Alexander,9,0,30,21
1657610783156,MATH 18,B01,083748,Rideout; David Porter,5,0,37,32
1657610783156,MATH 18,B02,083749,Rideout; David Porter,5,0,36,31
1657610783156,MATH 18,B03,083750,Rideout; David Porter,3,0,37,34
1657610783156,MATH 18,B04,083751,Rideout; David Porter,6,0,36,30
1657610783156,MATH 18,B05,093473,Rideout; David Porter,6,0,36,30
1657610783156,MATH 18,B06,093474,Rideout; David Porter,6,0,36,30
1657610789185,MATH 20A,A01,083754,Zheng; Zequn,14,0,40,26
1657610795211,MATH 20B,A01,083756,Briones; Jor-el Thomas Caparas,4,0,36,32
1657610795211,MATH 20B,A02,083757,Briones; Jor-el Thomas Caparas,1,0,36,35
1657610795211,MATH 20B,A03,093475,Briones; Jor-el Thomas Caparas,2,0,36,34
1657610801241,MATH 20C,A01,083760,Briones; Jor-el Thomas Caparas,1,0,35,34
1657610801241,MATH 20C,A02,083761,Briones; Jor-el Thomas Caparas,8,0,35,27
1657610801241,MATH 20C,A03,093476,Briones; Jor-el Thomas Caparas,0,1,36,36
1657610801241,MATH 20C,B01,083762,Bach; Quang Tran,1,0,30,29
1657610807271,MATH 20D,A01,083765,Tran; Brian Kha,5,0,30,25
1657610807271,MATH 20D,A02,083766,Tran; Brian Kha,5,0,30,25
1657610807271,MATH 20D,A03,083767,Tran; Brian Kha,5,0,30,25
1657610813297,MATH 20E,A01,083771,Ganguly; Soumya,9,0,32,23
1657610813297,MATH 20E,A02,083772,Ganguly; Soumya,6,0,32,26
1657610813297,MATH 20E,B01,083773,Ciotti; Benjamin,20,0,35,15
1657610813297,MATH 20E,B02,083774,Ciotti; Benjamin,18,0,35,17
1657610819320,MATH 103A,A01,083777,Greenfeld; Be'Eri,3,0,36,33
1657610819320,MATH 103A,A02,083778,Greenfeld; Be'Eri,5,0,36,31
1657610819320,MATH 103A,A03,093561,Greenfeld; Be'Eri,6,0,36,30
1657610819320,MATH 103A,B01,083779,Greenfeld; Be'Eri,7,0,36,29
1657610819320,MATH 103A,B02,083780,Greenfeld; Be'Eri,4,0,36,32
1657610819320,MATH 103A,B03,093562,Greenfeld; Be'Eri,3,0,36,33
1657610825358,MATH 105,A01,085443,Carter; Anne Toulson,15,0,35,20
1657610825358,MATH 105,A02,093477,Carter; Anne Toulson,20,0,35,15
1657610831390,MATH 109,A01,083213,Ganzberger; Geoffrey Michael,2,0,34,32
1657610831390,MATH 109,A02,083214,Ganzberger; Geoffrey Michael,4,0,34,30
1657610831390,MATH 109,A03,093478,Ganzberger; Geoffrey Michael,2,0,34,32
1657610831390,MATH 109,B01,083215,Ganzberger; Geoffrey Michael,1,0,32,31
1657610831390,MATH 109,B02,083216,Ganzberger; Geoffrey Michael,2,0,32,30
1657610831390,MATH 109,B03,093479,Ganzberger; Geoffrey Michael,8,0,32,24
1657610837414,MATH 142A,A01,083219,Chow; Bennett,7,0,32,25
1657610837414,MATH 142A,A02,083220,Chow; Bennett,10,0,32,22
1657610837414,MATH 142A,A03,093480,Chow; Bennett,9,0,32,23
1657610837414,MATH 142A,B03,093481,Chow; Bennett,8,0,32,24
1657610837414,MATH 142A,B04,093558,Chow; Bennett,13,0,32,19
1657610837414,MATH 142A,B05,093559,Chow; Bennett,6,0,32,26
1657610843439,MATH 193A,A01,083224,Rotar; Vladimir,8,0,34,26
1657610843439,MATH 193A,A02,083225,Rotar; Vladimir,9,0,34,25
1657610843439,MATH 193A,A03,083781,Rotar; Vladimir,5,0,34,29
1657610843439,MATH 193A,A04,083782,Rotar; Vladimir,10,0,34,24
1657610843439,MATH 193A,A05,093482,Rotar; Vladimir,10,0,34,24
1657610849464,MATH 197,001,091859,McAuley; Julian John,9999,0,9999,0
1657610849464,MATH 197,002,095566,Kedlaya; Kiran S.,9997,0,9999,2
1657610849464,MATH 197,003,095567,Xiao; Ming,9999,0,9999,0
1657610849464,MATH 197,004,095571,Perols; Johan Lars,9998,0,9999,1
1657610856548,COGS 9,A01,083615,Shannon; Kyle Michael,9,0,75,66
1657610862580,COGS 11,A01,083617,Boyle; Mary E. T.,23,0,48,25
1657610868604,COGS 13,A01,083071,Bastos; Amalia Pinkusfeld,11,0,71,60
1657610874626,COGS 14A,A01,092681,Semenuks; Arturs,5,1,100,95
1657610880649,COGS 14B,A01,083073,Cheng; Tzu-Han,6,0,63,57
1657610886673,COGS 17,A01,092677,Semenuks; Arturs,6,0,81,75
1657610892695,COGS 100,A01,083619,Allen; Michael Gordon,17,0,70,53
1657610898726,COGS 101A,A01,083621,Davis; Joshua Daniel,9,0,68,59
1657610904749,COGS 101B,A01,091572,Allen; Michael Gordon,12,0,65,53
1657610910776,COGS 101C,A01,083625,Delgado; Tania,17,0,35,18
1657610916800,COGS 107A,A01,083627,Boyle; Mary E. T.,13,0,60,47
1657610922824,COGS 118A,A01,083075,Gupta; Anjum,21,0,76,55
1657610928855,CSE 3,A50,083646,Miranda; Gregory Joseph,24,0,50,26
1657610934882,CSE 8A,A50,083650,Miranda; Gregory Joseph,17,1,56,39
1657610940907,CSE 11,A01,083080,Cao; Yingjun,6,15,40,34
1657610947002,CSE 12,A01,083652,Krause-Levy; Sophia Louisa,28,1,120,92
1657610953031,CSE 15L,A01,083654,Morris; Justin Loren,9,0,50,41
1657610953031,CSE 15L,A02,083655,Morris; Justin Loren,9,0,50,41
1657610959053,CSE 20,A01,083657,Tran; Khoa Dang,39,0,80,41
1657610965079,CSE 21,A01,095574,Bach; Quang Tran,22,0,48,26
1657610971103,CSE 30,A01,083084,Eldon; John,5,0,80,75
1657610971103,CSE 30,B01,095061,Bhaskar; Nishant,9,0,50,41
1657610977129,CSE 100,A01,083659,Cao; Yingjun,5,4,70,65
1657610983155,CSE 134B,A01,083661,Powell; Thomas Allan,22,0,100,78
1657610989178,CSE 140,A01,083663,Gungor; Onat,15,0,85,70
1657610995201,CSE 140L,A01,083088,Eldon; John,21,0,100,79
1657611001223,CSE 175,A01,083665,Kumar; Rakesh,3,0,25,22
1657611007245,CSE 190,A00,092507,Dubnov; Shlomo,8,0,20,12
1657611013269,ECE 45,A01,083139,Congero; Spencer William,6,0,75,69
1657611019293,ECE 65,A50,083695,Saad; Andrew S,12,0,30,18
1657611019293,ECE 65,A51,095125,Saad; Andrew S,24,0,26,2
1657611025321,ECE 109,A01,091882,Touri; Behrouz,19,0,70,51
1657611031345,ECE 180,A00,083140,Abi Samra; Nicholas Camill,1,0,30,29
1657611031345,ECE 180,B00,083141,Abi Samra; Nicholas Camill,0,0,30,30
1657611037372,MATH 10A,A01,083735,Patchell; Gregory David,2,0,30,28
1657611037372,MATH 10A,A02,083736,Patchell; Gregory David,20,0,30,10
1657611037372,MATH 10A,A03,083737,Patchell; Gregory David,16,0,30,14
1657611043401,MATH 10B,A01,083207,Lim; Seonhee,8,0,34,26
1657611043401,MATH 10B,A02,083208,Lim; Seonhee,9,0,35,26
1657611043401,MATH 10B,A03,093472,Lim; Seonhee,7,0,34,27
1657611043401,MATH 10B,B01,083739,Sinha; Shubham,12,0,30,18
1657611049431,MATH 18,A01,083743,Cinel; Cameron Alexander,7,0,30,23
1657611049431,MATH 18,A02,083744,Cinel; Cameron Alexander,17,0,30,13
1657611049431,MATH 18,A03,083745,Cinel; Cameron Alexander,9,0,30,21
1657611049431,MATH 18,B01,083748,Rideout; David Porter,5,0,37,32
1657611049431,MATH 18,B02,083749,Rideout; David Porter,5,0,36,31
1657611049431,MATH 18,B03,083750,Rideout; David Porter,3,0,37,34
1657611049431,MATH 18,B04,083751,Rideout; David Porter,6,0,36,30
1657611049431,MATH 18,B05,093473,Rideout; David Porter,6,0,36,30
1657611049431,MATH 18,B06,093474,Rideout; David Porter,6,0,36,30
1657611055466,MATH 20A,A01,083754,Zheng; Zequn,14,0,40,26
1657611061490,MATH 20B,A01,083756,Briones; Jor-el Thomas Caparas,4,0,36,32
1657611061490,MATH 20B,A02,083757,Briones; Jor-el Thomas Caparas,1,0,36,35
1657611061490,MATH 20B,A03,093475,Briones; Jor-el Thomas Caparas,2,0,36,34
1657611067522,MATH 20C,A01,083760,Briones; Jor-el Thomas Caparas,1,0,35,34
1657611067522,MATH 20C,A02,083761,Briones; Jor-el Thomas Caparas,8,0,35,27
1657611067522,MATH 20C,A03,093476,Briones; Jor-el Thomas Caparas,0,1,36,36
1657611067522,MATH 20C,B01,083762,Bach; Quang Tran,1,0,30,29
1657611073551,MATH 20D,A01,083765,Tran; Brian Kha,5,0,30,25
1657611073551,MATH 20D,A02,083766,Tran; Brian Kha,5,0,30,25
1657611073551,MATH 20D,A03,083767,Tran; Brian Kha,5,0,30,25
1657611079576,MATH 20E,A01,083771,Ganguly; Soumya,9,0,32,23
1657611079576,MATH 20E,A02,083772,Ganguly; Soumya,6,0,32,26
1657611079576,MATH 20E,B01,083773,Ciotti; Benjamin,20,0,35,15
1657611079576,MATH 20E,B02,083774,Ciotti; Benjamin,18,0,35,17
1657611085601,MATH 103A,A01,083777,Greenfeld; Be'Eri,3,0,36,33
1657611085601,MATH 103A,A02,083778,Greenfeld; Be'Eri,5,0,36,31
1657611085601,MATH 103A,A03,093561,Greenfeld; Be'Eri,6,0,36,30
1657611085601,MATH 103A,B01,083779,Greenfeld; Be'Eri,7,0,36,29
1657611085601,MATH 103A,B02,083780,Greenfeld; Be'Eri,4,0,36,32
1657611085601,MATH 103A,B03,093562,Greenfeld; Be'Eri,3,0,36,33
1657611091626,MATH 105,A01,085443,Carter; Anne Toulson,15,0,35,20
1657611091626,MATH 105,A02,093477,Carter; Anne Toulson,20,0,35,15
1657611097654,MATH 109,A01,083213,Ganzberger; Geoffrey Michael,2,0,34,32
1657611097654,MATH 109,A02,083214,Ganzberger; Geoffrey Michael,4,0,34,30
1657611097654,MATH 109,A03,093478,Ganzberger; Geoffrey Michael,2,0,34,32
1657611097654,MATH 109,B01,083215,Ganzberger; Geoffrey Michael,1,0,32,31
1657611097654,MATH 109,B02,083216,Ganzberger; Geoffrey Michael,2,0,32,30
1657611097654,MATH 109,B03,093479,Ganzberger; Geoffrey Michael,8,0,32,24
1657611103682,MATH 142A,A01,083219,Chow; Bennett,7,0,32,25
1657611103682,MATH 142A,A02,083220,Chow; Bennett,10,0,32,22
1657611103682,MATH 142A,A03,093480,Chow; Bennett,9,0,32,23
1657611103682,MATH 142A,B03,093481,Chow; Bennett,8,0,32,24
1657611103682,MATH 142A,B04,093558,Chow; Bennett,13,0,32,19
1657611103682,MATH 142A,B05,093559,Chow; Bennett,6,0,32,26
1657611109713,MATH 193A,A01,083224,Rotar; Vladimir,8,0,34,26
1657611109713,MATH 193A,A02,083225,Rotar; Vladimir,9,0,34,25
1657611109713,MATH 193A,A03,083781,Rotar; Vladimir,5,0,34,29
1657611109713,MATH 193A,A04,083782,Rotar; Vladimir,10,0,34,24
1657611109713,MATH 193A,A05,093482,Rotar; Vladimir,10,0,34,24
1657611115740,MATH 197,001,091859,McAuley; Julian John,9999,0,9999,0
1657611115740,MATH 197,002,095566,Kedlaya; Kiran S.,9997,0,9999,2
1657611115740,MATH 197,003,095567,Xiao; Ming,9999,0,9999,0
1657611115740,MATH 197,004,095571,Perols; Johan Lars,9998,0,9999,1
1657611122812,COGS 9,A01,083615,Shannon; Kyle Michael,9,0,75,66
1657611128834,COGS 11,A01,083617,Boyle; Mary E. T.,23,0,48,25
1657611134862,COGS 13,A01,083071,Bastos; Amalia Pinkusfeld,11,0,71,60
1657611140887,COGS 14A,A01,092681,Semenuks; Arturs,5,1,100,95
1657611146910,COGS 14B,A01,083073,Cheng; Tzu-Han,6,0,63,57
1657611152937,COGS 17,A01,092677,Semenuks; Arturs,6,0,81,75
1657611158970,COGS 100,A01,083619,Allen; Michael Gordon,17,0,70,53
1657611164996,COGS 101A,A01,083621,Davis; Joshua Daniel,9,0,68,59
1657611171020,COGS 101B,A01,091572,Allen; Michael Gordon,12,0,65,53
1657611177049,COGS 101C,A01,083625,Delgado; Tania,17,0,35,18
1657611183097,COGS 107A,A01,083627,Boyle; Mary E. T.,13,0,60,47
1657611189120,COGS 118A,A01,083075,Gupta; Anjum,21,0,76,55
1657611195155,CSE 3,A50,083646,Miranda; Gregory Joseph,24,0,50,26
1657611201186,CSE 8A,A50,083650,Miranda; Gregory Joseph,17,1,56,39
1657611207212,CSE 11,A01,083080,Cao; Yingjun,6,15,40,34
1657611213237,CSE 12,A01,083652,Krause-Levy; Sophia Louisa,28,1,120,92
1657611219261,CSE 15L,A01,083654,Morris; Justin Loren,9,0,50,41
1657611219261,CSE 15L,A02,083655,Morris; Justin Loren,9,0,50,41
1657611225289,CSE 20,A01,083657,Tran; Khoa Dang,39,0,80,41
1657611231312,CSE 21,A01,095574,Bach; Quang Tran,22,0,48,26
1657611237345,CSE 30,A01,083084,Eldon; John,5,0,80,75
1657611237345,CSE 30,B01,095061,Bhaskar; Nishant,9,0,50,41
1657611243375,CSE 100,A01,083659,Cao; Yingjun,5,4,70,65
1657611249405,CSE 134B,A01,083661,Powell; Thomas Allan,22,0,100,78
1657611255508,CSE 140,A01,083663,Gungor; Onat,15,0,85,70
1657611261535,CSE 140L,A01,083088,Eldon; John,21,0,100,79
1657611267562,CSE 175,A01,083665,Kumar; Rakesh,3,0,25,22
1657611273585,CSE 190,A00,092507,Dubnov; Shlomo,8,0,20,12
1657611279614,ECE 45,A01,083139,Congero; Spencer William,6,0,75,69
1657611285639,ECE 65,A50,083695,Saad; Andrew S,12,0,30,18
1657611285639,ECE 65,A51,095125,Saad; Andrew S,24,0,26,2
1657611291668,ECE 109,A01,091882,Touri; Behrouz,19,0,70,51
1657611297692,ECE 180,A00,083140,Abi Samra; Nicholas Camill,1,0,30,29
1657611297692,ECE 180,B00,083141,Abi Samra; Nicholas Camill,0,0,30,30
1657611303726,MATH 10A,A01,083735,Patchell; Gregory David,2,0,30,28
1657611303726,MATH 10A,A02,083736,Patchell; Gregory David,20,0,30,10
1657611303726,MATH 10A,A03,083737,Patchell; Gregory David,16,0,30,14
1657611309755,MATH 10B,A01,083207,Lim; Seonhee,8,0,34,26
1657611309755,MATH 10B,A02,083208,Lim; Seonhee,9,0,35,26
1657611309755,MATH 10B,A03,093472,Lim; Seonhee,7,0,34,27
1657611309755,MATH 10B,B01,083739,Sinha; Shubham,12,0,30,18
1657611315783,MATH 18,A01,083743,Cinel; Cameron Alexander,7,0,30,23
1657611315783,MATH 18,A02,083744,Cinel; Cameron Alexander,17,0,30,13
1657611315783,MATH 18,A03,083745,Cinel; Cameron Alexander,9,0,30,21
1657611315783,MATH 18,B01,083748,Rideout; David Porter,5,0,37,32
1657611315783,MATH 18,B02,083749,Rideout; David Porter,5,0,36,31
1657611315783,MATH 18,B03,083750,Rideout; David Porter,3,0,37,34
1657611315783,MATH 18,B04,083751,Rideout; David Porter,6,0,36,30
1657611315783,MATH 18,B05,093473,Rideout; David Porter,6,0,36,30
1657611315783,MATH 18,B06,093474,Rideout; David Porter,6,0,36,30
1657611321816,MATH 20A,A01,083754,Zheng; Zequn,14,0,40,26
1657611327846,MATH 20B,A01,083756,Briones; Jor-el Thomas Caparas,4,0,36,32
1657611327846,MATH 20B,A02,083757,Briones; Jor-el Thomas Caparas,1,0,36,35
1657611327846,MATH 20B,A03,093475,Briones; Jor-el Thomas Caparas,2,0,36,34
1657611333874,MATH 20C,A01,083760,Briones; Jor-el Thomas Caparas,1,0,35,34
1657611333874,MATH 20C,A02,083761,Briones; Jor-el Thomas Caparas,8,0,35,27
1657611333874,MATH 20C,A03,093476,Briones; Jor-el Thomas Caparas,0,1,36,36
1657611333874,MATH 20C,B01,083762,Bach; Quang Tran,1,0,30,29
1657611339906,MATH 20D,A01,083765,Tran; Brian Kha,5,0,30,25
1657611339906,MATH 20D,A02,083766,Tran; Brian Kha,5,0,30,25
1657611339906,MATH 20D,A03,083767,Tran; Brian Kha,5,0,30,25
1657611345934,MATH 20E,A01,083771,Ganguly; Soumya,9,0,32,23
1657611345934,MATH 20E,A02,083772,Ganguly; Soumya,6,0,32,26
1657611345934,MATH 20E,B01,083773,Ciotti; Benjamin,20,0,35,15
1657611345934,MATH 20E,B02,083774,Ciotti; Benjamin,18,0,35,17
1657611351968,MATH 103A,A01,083777,Greenfeld; Be'Eri,3,0,36,33
1657611351968,MATH 103A,A02,083778,Greenfeld; Be'Eri,5,0,36,31
1657611351968,MATH 103A,A03,093561,Greenfeld; Be'Eri,6,0,36,30
1657611351968,MATH 103A,B01,083779,Greenfeld; Be'Eri,7,0,36,29
1657611351968,MATH 103A,B02,083780,Greenfeld; Be'Eri,4,0,36,32
1657611351968,MATH 103A,B03,093562,Greenfeld; Be'Eri,3,0,36,33
1657611357992,MATH 105,A01,085443,Carter; Anne Toulson,15,0,35,20
1657611357992,MATH 105,A02,093477,Carter; Anne Toulson,20,0,35,15
1657611364017,MATH 109,A01,083213,Ganzberger; Geoffrey Michael,2,0,34,32
1657611364017,MATH 109,A02,083214,Ganzberger; Geoffrey Michael,4,0,34,30
1657611364017,MATH 109,A03,093478,Ganzberger; Geoffrey Michael,2,0,34,32
1657611364017,MATH 109,B01,083215,Ganzberger; Geoffrey Michael,1,0,32,31
1657611364017,MATH 109,B02,083216,Ganzberger; Geoffrey Michael,2,0,32,30
1657611364017,MATH 109,B03,093479,Ganzberger; Geoffrey Michael,8,0,32,24
1657611370044,MATH 142A,A01,083219,Chow; Bennett,7,0,32,25
1657611370044,MATH 142A,A02,083220,Chow; Bennett,10,0,32,22
1657611370044,MATH 142A,A03,093480,Chow; Bennett,9,0,32,23
1657611370044,MATH 142A,B03,093481,Chow; Bennett,8,0,32,24
1657611370044,MATH 142A,B04,093558,Chow; Bennett,13,0,32,19
1657611370044,MATH 142A,B05,093559,Chow; Bennett,6,0,32,26
1657611376075,MATH 193A,A01,083224,Rotar; Vladimir,8,0,34,26
1657611376075,MATH 193A,A02,083225,Rotar; Vladimir,9,0,34,25
1657611376075,MATH 193A,A03,083781,Rotar; Vladimir,5,0,34,29
1657611376075,MATH 193A,A04,083782,Rotar; Vladimir,10,0,34,24
1657611376075,MATH 193A,A05,093482,Rotar; Vladimir,10,0,34,24
1657611382107,MATH 197,001,091859,McAuley; Julian John,9999,0,9999,0
1657611382107,MATH 197,002,095566,Kedlaya; Kiran S.,9997,0,9999,2
1657611382107,MATH 197,003,095567,Xiao; Ming,9999,0,9999,0
1657611382107,MATH 197,004,095571,Perols; Johan Lars,9998,0,9999,1
1657611389180,COGS 9,A01,083615,Shannon; Kyle Michael,9,0,75,66
1657611395205,COGS 11,A01,083617,Boyle; Mary E. T.,23,0,48,25
1657611401237,COGS 13,A01,083071,Bastos; Amalia Pinkusfeld,11,0,71,60
1657611407267,COGS 14A,A01,092681,Semenuks; Arturs,5,1,100,95
1657611413292,COGS 14B,A01,083073,Cheng; Tzu-Han,6,0,63,57
1657611419315,COGS 17,A01,092677,Semenuks; Arturs,6,0,81,75
1657611425348,COGS 100,A01,083619,Allen; Michael Gordon,17,0,70,53
1657611431371,COGS 101A,A01,083621,Davis; Joshua Daniel,9,0,68,59
1657611437396,COGS 101B,A01,091572,Allen; Michael Gordon,12,0,65,53
1657611443427,COGS 101C,A01,083625,Delgado; Tania,17,0,35,18
1657611449452,COGS 107A,A01,083627,Boyle; Mary E. T.,13,0,60,47
1657611455476,COGS 118A,A01,083075,Gupta; Anjum,21,0,76,55
1657611461502,CSE 3,A50,083646,Miranda; Gregory Joseph,24,0,50,26
1657611467530,CSE 8A,A50,083650,Miranda; Gregory Joseph,17,1,56,39
1657611473553,CSE 11,A01,083080,Cao; Yingjun,6,15,40,34
1657611479577,CSE 12,A01,083652,Krause-Levy; Sophia Louisa,28,1,120,92
1657611485603,CSE 15L,A01,083654,Morris; Justin Loren,9,0,50,41
1657611485603,CSE 15L,A02,083655,Morris; Justin Loren,9,0,50,41
1657611491633,CSE 20,A01,083657,Tran; Khoa Dang,39,0,80,41
1657611497658,CSE 21,A01,095574,Bach; Quang Tran,22,0,48,26
1657611503685,CSE 30,A01,083084,Eldon; John,5,0,80,75
1657611503685,CSE 30,B01,095061,Bhaskar; Nishant,9,0,50,41
1657611509709,CSE 100,A01,083659,Cao; Yingjun,5,4,70,65
1657611515737,CSE 134B,A01,083661,Powell; Thomas Allan,22,0,100,78
1657611521761,CSE 140,A01,083663,Gungor; Onat,15,0,85,70
1657611527786,CSE 140L,A01,083088,Eldon; John,21,0,100,79
1657611533812,CSE 175,A01,083665,Kumar; Rakesh,3,0,25,22
1657611539842,CSE 190,A00,092507,Dubnov; Shlomo,8,0,20,12
1657611545867,ECE 45,A01,083139,Congero; Spencer William,6,0,75,69
1657611551895,ECE 65,A50,083695,Saad; Andrew S,12,0,30,18
1657611551895,ECE 65,A51,095125,Saad; Andrew S,24,0,26,2
1657611557921,ECE 109,A01,091882,Touri; Behrouz,19,0,70,51
1657611563945,ECE 180,A00,083140,Abi Samra; Nicholas Camill,1,0,30,29
1657611563945,ECE 180,B00,083141,Abi Samra; Nicholas Camill,0,0,30,30
1657611569979,MATH 10A,A01,083735,Patchell; Gregory David,2,0,30,28
1657611569979,MATH 10A,A02,083736,Patchell; Gregory David,20,0,30,10
1657611569979,MATH 10A,A03,083737,Patchell; Gregory David,16,0,30,14
1657611576011,MATH 10B,A01,083207,Lim; Seonhee,8,0,34,26
1657611576011,MATH 10B,A02,083208,Lim; Seonhee,9,0,35,26
1657611576011,MATH 10B,A03,093472,Lim; Seonhee,7,0,34,27
1657611576011,MATH 10B,B01,083739,Sinha; Shubham,12,0,30,18
1657611582052,MATH 18,A01,083743,Cinel; Cameron Alexander,7,0,30,23
1657611582052,MATH 18,A02,083744,Cinel; Cameron Alexander,17,0,30,13
1657611582052,MATH 18,A03,083745,Cinel; Cameron Alexander,9,0,30,21
1657611582052,MATH 18,B01,083748,Rideout; David Porter,5,0,37,32
1657611582052,MATH 18,B02,083749,Rideout; David Porter,5,0,36,31
1657611582052,MATH 18,B03,083750,Rideout; David Porter,3,0,37,34
1657611582052,MATH 18,B04,083751,Rideout; David Porter,6,0,36,30
1657611582052,MATH 18,B05,093473,Rideout; David Porter,6,0,36,30
1657611582052,MATH 18,B06,093474,Rideout; David Porter,6,0,36,30
1657611588077,MATH 20A,A01,083754,Zheng; Zequn,14,0,40,26
1657611594106,MATH 20B,A01,083756,Briones; Jor-el Thomas Caparas,4,0,36,32
1657611594106,MATH 20B,A02,083757,Briones; Jor-el Thomas Caparas,1,0,36,35
1657611594106,MATH 20B,A03,093475,Briones; Jor-el Thomas Caparas,2,0,36,34
1657611600131,MATH 20C,A01,083760,Briones; Jor-el Thomas Caparas,1,0,35,34
1657611600131,MATH 20C,A02,083761,Briones; Jor-el Thomas Caparas,8,0,35,27
1657611600131,MATH 20C,A03,093476,Briones; Jor-el Thomas Caparas,0,1,36,36
1657611600131,MATH 20C,B01,083762,Bach; Quang Tran,1,0,30,29
1657611606161,MATH 20D,A01,083765,Tran; Brian Kha,5,0,30,25
1657611606161,MATH 20D,A02,083766,Tran; Brian Kha,5,0,30,25
1657611606161,MATH 20D,A03,083767,Tran; Brian Kha,5,0,30,25
1657611612189,MATH 20E,A01,083771,Ganguly; Soumya,9,0,32,23
1657611612189,MATH 20E,A02,083772,Ganguly; Soumya,6,0,32,26
1657611612189,MATH 20E,B01,083773,Ciotti; Benjamin,20,0,35,15
1657611612189,MATH 20E,B02,083774,Ciotti; Benjamin,18,0,35,17
1657611618218,MATH 103A,A01,083777,Greenfeld; Be'Eri,3,0,36,33
1657611618218,MATH 103A,A02,083778,Greenfeld; Be'Eri,5,0,36,31
1657611618218,MATH 103A,A03,093561,Greenfeld; Be'Eri,6,0,36,30
1657611618218,MATH 103A,B01,083779,Greenfeld; Be'Eri,7,0,36,29
1657611618218,MATH 103A,B02,083780,Greenfeld; Be'Eri,4,0,36,32
1657611618218,MATH 103A,B03,093562,Greenfeld; Be'Eri,3,0,36,33
1657611624251,MATH 105,A01,085443,Carter; Anne Toulson,15,0,35,20
1657611624251,MATH 105,A02,093477,Carter; Anne Toulson,20,0,35,15
1657611630283,MATH 109,A01,083213,Ganzberger; Geoffrey Michael,2,0,34,32
1657611630283,MATH 109,A02,083214,Ganzberger; Geoffrey Michael,4,0,34,30
1657611630283,MATH 109,A03,093478,Ganzberger; Geoffrey Michael,2,0,34,32
1657611630283,MATH 109,B01,083215,Ganzberger; Geoffrey Michael,1,0,32,31
1657611630283,MATH 109,B02,083216,Ganzberger; Geoffrey Michael,2,0,32,30
1657611630283,MATH 109,B03,093479,Ganzberger; Geoffrey Michael,8,0,32,24
1657611636318,MATH 142A,A01,083219,Chow; Bennett,7,0,32,25
1657611636318,MATH 142A,A02,083220,Chow; Bennett,10,0,32,22
1657611636318,MATH 142A,A03,093480,Chow; Bennett,9,0,32,23
1657611636318,MATH 142A,B03,093481,Chow; Bennett,8,0,32,24
1657611636318,MATH 142A,B04,093558,Chow; Bennett,13,0,32,19
1657611636318,MATH 142A,B05,093559,Chow; Bennett,6,0,32,26
1657611642344,MATH 193A,A01,083224,Rotar; Vladimir,8,0,34,26
1657611642344,MATH 193A,A02,083225,Rotar; Vladimir,9,0,34,25
1657611642344,MATH 193A,A03,083781,Rotar; Vladimir,5,0,34,29
1657611642344,MATH 193A,A04,083782,Rotar; Vladimir,10,0,34,24
1657611642344,MATH 193A,A05,093482,Rotar; Vladimir,10,0,34,24
1657611648372,MATH 197,001,091859,McAuley; Julian John,9999,0,9999,0
1657611648372,MATH 197,002,095566,Kedlaya; Kiran S.,9997,0,9999,2
1657611648372,MATH 197,003,095567,Xiao; Ming,9999,0,9999,0
1657611648372,MATH 197,004,095571,Perols; Johan Lars,9998,0,9999,1
1657611655448,COGS 9,A01,083615,Shannon; Kyle Michael,9,0,75,66
1657611661473,COGS 11,A01,083617,Boyle; Mary E. T.,23,0,48,25
1657611667502,COGS 13,A01,083071,Bastos; Amalia Pinkusfeld,11,0,71,60
1657611673532,COGS 14A,A01,092681,Semenuks; Arturs,5,1,100,95
1657611679556,COGS 14B,A01,083073,Cheng; Tzu-Han,6,0,63,57
1657611685578,COGS 17,A01,092677,Semenuks; Arturs,6,0,81,75
1657611691604,COGS 100,A01,083619,Allen; Michael Gordon,17,0,70,53
1657611697628,COGS 101A,A01,083621,Davis; Joshua Daniel,9,0,68,59
1657611703668,COGS 101B,A01,091572,Allen; Michael Gordon,12,0,65,53
1657611709699,COGS 101C,A01,083625,Delgado; Tania,17,0,35,18
1657611715721,COGS 107A,A01,083627,Boyle; Mary E. T.,13,0,60,47
1657611721753,COGS 118A,A01,083075,Gupta; Anjum,21,0,76,55
1657611727778,CSE 3,A50,083646,Miranda; Gregory Joseph,24,0,50,26
1657611733808,CSE 8A,A50,083650,Miranda; Gregory Joseph,17,1,56,39
1657611739834,CSE 11,A01,083080,Cao; Yingjun,6,15,40,34
1657611745863,CSE 12,A01,083652,Krause-Levy; Sophia Louisa,28,1,120,92
1657611751887,CSE 15L,A01,083654,Morris; Justin Loren,9,0,50,41
1657611751887,CSE 15L,A02,083655,Morris; Justin Loren,9,0,50,41
1657611757918,CSE 20,A01,083657,Tran; Khoa Dang,39,0,80,41
1657611763948,CSE 21,A01,095574,Bach; Quang Tran,22,0,48,26
1657611769982,CSE 30,A01,083084,Eldon; John,5,0,80,75
1657611769982,CSE 30,B01,095061,Bhaskar; Nishant,9,0,50,41
1657611776008,CSE 100,A01,083659,Cao; Yingjun,5,4,70,65
1657611782032,CSE 134B,A01,083661,Powell; Thomas Allan,22,0,100,78
1657611788073,CSE 140,A01,083663,Gungor; Onat,15,0,85,70
1657611794098,CSE 140L,A01,083088,Eldon; John,21,0,100,79
1657611800128,CSE 175,A01,083665,Kumar; Rakesh,3,0,25,22
1657611806155,CSE 190,A00,092507,Dubnov; Shlomo,8,0,20,12
1657611812181,ECE 45,A01,083139,Congero; Spencer William,6,0,75,69
1657611818220,ECE 65,A50,083695,Saad; Andrew S,12,0,30,18
1657611818220,ECE 65,A51,095125,Saad; Andrew S,24,0,26,2
1657611824246,ECE 109,A01,091882,Touri; Behrouz,19,0,70,51
1657611830275,ECE 180,A00,083140,Abi Samra; Nicholas Camill,1,0,30,29
1657611830275,ECE 180,B00,083141,Abi Samra; Nicholas Camill,0,0,30,30
1657611836304,MATH 10A,A01,083735,Patchell; Gregory David,2,0,30,28
1657611836304,MATH 10A,A02,083736,Patchell; Gregory David,20,0,30,10
1657611836304,MATH 10A,A03,083737,Patchell; Gregory David,16,0,30,14
1657611842334,MATH 10B,A01,083207,Lim; Seonhee,8,0,34,26
1657611842334,MATH 10B,A02,083208,Lim; Seonhee,9,0,35,26
1657611842334,MATH 10B,A03,093472,Lim; Seonhee,7,0,34,27
1657611842334,MATH 10B,B01,083739,Sinha; Shubham,12,0,30,18
1657611848376,MATH 18,A01,083743,Cinel; Cameron Alexander,7,0,30,23
1657611848376,MATH 18,A02,083744,Cinel; Cameron Alexander,17,0,30,13
1657611848376,MATH 18,A03,083745,Cinel; Cameron Alexander,9,0,30,21
1657611848376,MATH 18,B01,083748,Rideout; David Porter,5,0,37,32
1657611848376,MATH 18,B02,083749,Rideout; David Porter,5,0,36,31
1657611848376,MATH 18,B03,083750,Rideout; David Porter,3,0,37,34
1657611848376,MATH 18,B04,083751,Rideout; David Porter,6,0,36,30
1657611848376,MATH 18,B05,093473,Rideout; David Porter,6,0,36,30
1657611848376,MATH 18,B06,093474,Rideout; David Porter,6,0,36,30
1657611854498,MATH 20A,A01,083754,Zheng; Zequn,14,0,40,26
1657611860524,MATH 20B,A01,083756,Briones; Jor-el Thomas Caparas,4,0,36,32
1657611860524,MATH 20B,A02,083757,Briones; Jor-el Thomas Caparas,1,0,36,35
1657611860524,MATH 20B,A03,093475,Briones; Jor-el Thomas Caparas,2,0,36,34
1657611866558,MATH 20C,A01,083760,Briones; Jor-el Thomas Caparas,1,0,35,34
1657611866558,MATH 20C,A02,083761,Briones; Jor-el Thomas Caparas,8,0,35,27
1657611866558,MATH 20C,A03,093476,Briones; Jor-el Thomas Caparas,0,1,36,36
1657611866558,MATH 20C,B01,083762,Bach; Quang Tran,1,0,30,29
1657611872589,MATH 20D,A01,083765,Tran; Brian Kha,5,0,30,25
1657611872589,MATH 20D,A02,083766,Tran; Brian Kha,5,0,30,25
1657611872589,MATH 20D,A03,083767,Tran; Brian Kha,5,0,30,25
1657611878623,MATH 20E,A01,083771,Ganguly; Soumya,9,0,32,23
1657611878623,MATH 20E,A02,083772,Ganguly; Soumya,6,0,32,26
1657611878623,MATH 20E,B01,083773,Ciotti; Benjamin,20,0,35,15
1657611878623,MATH 20E,B02,083774,Ciotti; Benjamin,18,0,35,17
1657611884650,MATH 103A,A01,083777,Greenfeld; Be'Eri,3,0,36,33
1657611884650,MATH 103A,A02,083778,Greenfeld; Be'Eri,5,0,36,31
1657611884650,MATH 103A,A03,093561,Greenfeld; Be'Eri,6,0,36,30
1657611884650,MATH 103A,B01,083779,Greenfeld; Be'Eri,7,0,36,29
1657611884650,MATH 103A,B02,083780,Greenfeld; Be'Eri,4,0,36,32
1657611884650,MATH 103A,B03,093562,Greenfeld; Be'Eri,3,0,36,33
1657611890676,MATH 105,A01,085443,Carter; Anne Toulson,15,0,35,20
1657611890676,MATH 105,A02,093477,Carter; Anne Toulson,20,0,35,15
1657611896710,MATH 109,A01,083213,Ganzberger; Geoffrey Michael,2,0,34,32
1657611896710,MATH 109,A02,083214,Ganzberger; Geoffrey Michael,4,0,34,30
1657611896710,MATH 109,A03,093478,Ganzberger; Geoffrey Michael,2,0,34,32
1657611896710,MATH 109,B01,083215,Ganzberger; Geoffrey Michael,1,0,32,31
1657611896710,MATH 109,B02,083216,Ganzberger; Geoffrey Michael,2,0,32,30
1657611896710,MATH 109,B03,093479,Ganzberger; Geoffrey Michael,8,0,32,24
1657611902744,MATH 142A,A01,083219,Chow; Bennett,7,0,32,25
1657611902744,MATH 142A,A02,083220,Chow; Bennett,10,0,32,22
1657611902744,MATH 142A,A03,093480,Chow; Bennett,9,0,32,23
1657611902744,MATH 142A,B03,093481,Chow; Bennett,8,0,32,24
1657611902744,MATH 142A,B04,093558,Chow; Bennett,13,0,32,19
1657611902744,MATH 142A,B05,093559,Chow; Bennett,6,0,32,26
1657611908769,MATH 193A,A01,083224,Rotar; Vladimir,8,0,34,26
1657611908769,MATH 193A,A02,083225,Rotar; Vladimir,9,0,34,25
1657611908769,MATH 193A,A03,083781,Rotar; Vladimir,5,0,34,29
1657611908769,MATH 193A,A04,083782,Rotar; Vladimir,10,0,34,24
1657611908769,MATH 193A,A05,093482,Rotar; Vladimir,10,0,34,24
1657611914795,MATH 197,001,091859,McAuley; Julian John,9999,0,9999,0
1657611914795,MATH 197,002,095566,Kedlaya; Kiran S.,9997,0,9999,2
1657611914795,MATH 197,003,095567,Xiao; Ming,9999,0,9999,0
1657611914795,MATH 197,004,095571,Perols; Johan Lars,9998,0,9999,1
1657611921868,COGS 9,A01,083615,Shannon; Kyle Michael,9,0,75,66
1657611927894,COGS 11,A01,083617,Boyle; Mary E. T.,23,0,48,25
1657611933924,COGS 13,A01,083071,Bastos; Amalia Pinkusfeld,11,0,71,60
1657611939948,COGS 14A,A01,092681,Semenuks; Arturs,5,1,100,95
1657611945984,COGS 14B,A01,083073,Cheng; Tzu-Han,6,0,63,57
1657611952008,COGS 17,A01,092677,Semenuks; Arturs,6,0,81,75
1657611958032,COGS 100,A01,083619,Allen; Michael Gordon,17,0,70,53
1657611964057,COGS 101A,A01,083621,Davis; Joshua Daniel,9,0,68,59
1657611970088,COGS 101B,A01,091572,Allen; Michael Gordon,12,0,65,53
1657611976113,COGS 101C,A01,083625,Delgado; Tania,17,0,35,18
1657611982149,COGS 107A,A01,083627,Boyle; Mary E. T.,13,0,60,47
1657611988179,COGS 118A,A01,083075,Gupta; Anjum,21,0,76,55
1657611994212,CSE 3,A50,083646,Miranda; Gregory Joseph,24,0,50,26
1657612000243,CSE 8A,A50,083650,Miranda; Gregory Joseph,17,1,56,39
1657612006266,CSE 11,A01,083080,Cao; Yingjun,6,15,40,34
1657612012291,CSE 12,A01,083652,Krause-Levy; Sophia Louisa,28,1,120,92
1657612018323,CSE 15L,A01,083654,Morris; Justin Loren,9,0,50,41
1657612018323,CSE 15L,A02,083655,Morris; Justin Loren,9,0,50,41
1657612024352,CSE 20,A01,083657,Tran; Khoa Dang,39,0,80,41
1657612030375,CSE 21,A01,095574,Bach; Quang Tran,22,0,48,26
1657612036402,CSE 30,A01,083084,Eldon; John,5,0,80,75
1657612036402,CSE 30,B01,095061,Bhaskar; Nishant,9,0,50,41
1657612042426,CSE 100,A01,083659,Cao; Yingjun,5,4,70,65
1657612048455,CSE 134B,A01,083661,Powell; Thomas Allan,22,0,100,78
1657612054486,CSE 140,A01,083663,Gungor; Onat,15,0,85,70
1657612060521,CSE 140L,A01,083088,Eldon; John,21,0,100,79
1657612066549,CSE 175,A01,083665,Kumar; Rakesh,3,0,25,22
1657612072573,CSE 190,A00,092507,Dubnov; Shlomo,8,0,20,12
1657612078600,ECE 45,A01,083139,Congero; Spencer William,6,0,75,69
1657612084627,ECE 65,A50,083695,Saad; Andrew S,12,0,30,18
1657612084627,ECE 65,A51,095125,Saad; Andrew S,24,0,26,2
1657612090669,ECE 109,A01,091882,Touri; Behrouz,19,0,70,51
1657612096694,ECE 180,A00,083140,Abi Samra; Nicholas Camill,1,0,30,29
1657612096694,ECE 180,B00,083141,Abi Samra; Nicholas Camill,0,0,30,30
1657612102722,MATH 10A,A01,083735,Patchell; Gregory David,2,0,30,28
1657612102722,MATH 10A,A02,083736,Patchell; Gregory David,20,0,30,10
1657612102722,MATH 10A,A03,083737,Patchell; Gregory David,16,0,30,14
1657612108765,MATH 10B,A01,083207,Lim; Seonhee,8,0,34,26
1657612108765,MATH 10B,A02,083208,Lim; Seonhee,9,0,35,26
1657612108765,MATH 10B,A03,093472,Lim; Seonhee,7,0,34,27
1657612108765,MATH 10B,B01,083739,Sinha; Shubham,12,0,30,18
1657612114805,MATH 18,A01,083743,Cinel; Cameron Alexander,7,0,30,23
1657612114805,MATH 18,A02,083744,Cinel; Cameron Alexander,17,0,30,13
1657612114805,MATH 18,A03,083745,Cinel; Cameron Alexander,9,0,30,21
1657612114805,MATH 18,B01,083748,Rideout; David Porter,5,0,37,32
1657612114805,MATH 18,B02,083749,Rideout; David Porter,5,0,36,31
1657612114805,MATH 18,B03,083750,Rideout; David Porter,3,0,37,34
1657612114805,MATH 18,B04,083751,Rideout; David Porter,6,0,36,30
1657612114805,MATH 18,B05,093473,Rideout; David Porter,6,0,36,30
1657612114805,MATH 18,B06,093474,Rideout; David Porter,6,0,36,30
1657612120830,MATH 20A,A01,083754,Zheng; Zequn,14,0,40,26
1657612126865,MATH 20B,A01,083756,Briones; Jor-el Thomas Caparas,4,0,36,32
1657612126865,MATH 20B,A02,083757,Briones; Jor-el Thomas Caparas,1,0,36,35
1657612126865,MATH 20B,A03,093475,Briones; Jor-el Thomas Caparas,2,0,36,34
1657612132892,MATH 20C,A01,083760,Briones; Jor-el Thomas Caparas,1,0,35,34
1657612132892,MATH 20C,A02,083761,Briones; Jor-el Thomas Caparas,8,0,35,27
1657612132892,MATH 20C,A03,093476,Briones; Jor-el Thomas Caparas,0,1,36,36
1657612132892,MATH 20C,B01,083762,Bach; Quang Tran,1,0,30,29
1657612138920,MATH 20D,A01,083765,Tran; Brian Kha,5,0,30,25
1657612138920,MATH 20D,A02,083766,Tran; Brian Kha,5,0,30,25
1657612138920,MATH 20D,A03,083767,Tran; Brian Kha,5,0,30,25
1657612144965,MATH 20E,A01,083771,Ganguly; Soumya,9,0,32,23
1657612144965,MATH 20E,A02,083772,Ganguly; Soumya,6,0,32,26
1657612144965,MATH 20E,B01,083773,Ciotti; Benjamin,20,0,35,15
1657612144965,MATH 20E,B02,083774,Ciotti; Benjamin,18,0,35,17
1657612151007,MATH 103A,A01,083777,Greenfeld; Be'Eri,3,0,36,33
1657612151007,MATH 103A,A02,083778,Greenfeld; Be'Eri,5,0,36,31
1657612151007,MATH 103A,A03,093561,Greenfeld; Be'Eri,6,0,36,30
1657612151007,MATH 103A,B01,083779,Greenfeld; Be'Eri,7,0,36,29
1657612151007,MATH 103A,B02,083780,Greenfeld; Be'Eri,4,0,36,32
1657612151007,MATH 103A,B03,093562,Greenfeld; Be'Eri,3,0,36,33
1657612157033,MATH 105,A01,085443,Carter; Anne Toulson,15,0,35,20
1657612157033,MATH 105,A02,093477,Carter; Anne Toulson,20,0,35,15
1657612163059,MATH 109,A01,083213,Ganzberger; Geoffrey Michael,2,0,34,32
1657612163059,MATH 109,A02,083214,Ganzberger; Geoffrey Michael,4,0,34,30
1657612163059,MATH 109,A03,093478,Ganzberger; Geoffrey Michael,2,0,34,32
1657612163059,MATH 109,B01,083215,Ganzberger; Geoffrey Michael,1,0,32,31
1657612163059,MATH 109,B02,083216,Ganzberger; Geoffrey Michael,2,0,32,30
1657612163059,MATH 109,B03,093479,Ganzberger; Geoffrey Michael,8,0,32,24
1657612169095,MATH 142A,A01,083219,Chow; Bennett,7,0,32,25
1657612169095,MATH 142A,A02,083220,Chow; Bennett,10,0,32,22
1657612169095,MATH 142A,A03,093480,Chow; Bennett,9,0,32,23
1657612169095,MATH 142A,B03,093481,Chow; Bennett,8,0,32,24
1657612169095,MATH 142A,B04,093558,Chow; Bennett,13,0,32,19
1657612169095,MATH 142A,B05,093559,Chow; Bennett,6,0,32,26
1657612175132,MATH 193A,A01,083224,Rotar; Vladimir,8,0,34,26
1657612175132,MATH 193A,A02,083225,Rotar; Vladimir,9,0,34,25
1657612175132,MATH 193A,A03,083781,Rotar; Vladimir,5,0,34,29
1657612175132,MATH 193A,A04,083782,Rotar; Vladimir,10,0,34,24
1657612175132,MATH 193A,A05,093482,Rotar; Vladimir,10,0,34,24
1657612181159,MATH 197,001,091859,McAuley; Julian John,9999,0,9999,0
1657612181159,MATH 197,002,095566,Kedlaya; Kiran S.,9997,0,9999,2
1657612181159,MATH 197,003,095567,Xiao; Ming,9999,0,9999,0
1657612181159,MATH 197,004,095571,Perols; Johan Lars,9998,0,9999,1
1657612188243,COGS 9,A01,083615,Shannon; Kyle Michael,9,0,75,66
1657612194292,COGS 11,A01,083617,Boyle; Mary E. T.,23,0,48,25
1657612200326,COGS 13,A01,083071,Bastos; Amalia Pinkusfeld,11,0,71,60
1657612206357,COGS 14A,A01,092681,Semenuks; Arturs,5,1,100,95
1657612212381,COGS 14B,A01,083073,Cheng; Tzu-Han,6,0,63,57
1657612218404,COGS 17,A01,092677,Semenuks; Arturs,6,0,81,75
1657612224430,COGS 100,A01,083619,Allen; Michael Gordon,17,0,70,53
1657612230461,COGS 101A,A01,083621,Davis; Joshua Daniel,9,0,68,59
1657612236487,COGS 101B,A01,091572,Allen; Michael Gordon,12,0,65,53
1657612242517,COGS 101C,A01,083625,Delgado; Tania,17,0,35,18
1657612248541,COGS 107A,A01,083627,Boyle; Mary E. T.,13,0,60,47
1657612254570,COGS 118A,A01,083075,Gupta; Anjum,21,0,76,55
1657612260610,CSE 3,A50,083646,Miranda; Gregory Joseph,24,0,50,26
1657612266641,CSE 8A,A50,083650,Miranda; Gregory Joseph,17,1,56,39
1657612272670,CSE 11,A01,083080,Cao; Yingjun,6,15,40,34
1657612278699,CSE 12,A01,083652,Krause-Levy; Sophia Louisa,28,1,120,92
1657612284725,CSE 15L,A01,083654,Morris; Justin Loren,9,0,50,41
1657612284725,CSE 15L,A02,083655,Morris; Justin Loren,9,0,50,41
1657612290749,CSE 20,A01,083657,Tran; Khoa Dang,39,0,80,41
1657612296794,CSE 21,A01,095574,Bach; Quang Tran,22,0,48,26
1657612302832,CSE 30,A01,083084,Eldon; John,5,0,80,75
1657612302832,CSE 30,B01,095061,Bhaskar; Nishant,9,0,50,41
1657612308857,CSE 100,A01,083659,Cao; Yingjun,5,4,70,65
1657612314888,CSE 134B,A01,083661,Powell; Thomas Allan,22,0,100,78
1657612320914,CSE 140,A01,083663,Gungor; Onat,15,0,85,70
1657612326937,CSE 140L,A01,083088,Eldon; John,21,0,100,79
1657612332965,CSE 175,A01,083665,Kumar; Rakesh,3,0,25,22
1657612338989,CSE 190,A00,092507,Dubnov; Shlomo,8,0,20,12
1657612345014,ECE 45,A01,083139,Congero; Spencer William,6,0,75,69
1657612351041,ECE 65,A50,083695,Saad; Andrew S,12,0,30,18
1657612351041,ECE 65,A51,095125,Saad; Andrew S,24,0,26,2
1657612357068,ECE 109,A01,091882,Touri; Behrouz,19,0,70,51
1657612363098,ECE 180,A00,083140,Abi Samra; Nicholas Camill,1,0,30,29
1657612363098,ECE 180,B00,083141,Abi Samra; Nicholas Camill,0,0,30,30
1657612369132,MATH 10A,A01,083735,Patchell; Gregory David,2,0,30,28
1657612369132,MATH 10A,A02,083736,Patchell; Gregory David,20,0,30,10
1657612369132,MATH 10A,A03,083737,Patchell; Gregory David,16,0,30,14
1657612375173,MATH 10B,A01,083207,Lim; Seonhee,8,0,34,26
1657612375173,MATH 10B,A02,083208,Lim; Seonhee,9,0,35,26
1657612375173,MATH 10B,A03,093472,Lim; Seonhee,7,0,34,27
1657612375173,MATH 10B,B01,083739,Sinha; Shubham,12,0,30,18
1657612381215,MATH 18,A01,083743,Cinel; Cameron Alexander,7,0,30,23
1657612381215,MATH 18,A02,083744,Cinel; Cameron Alexander,17,0,30,13
1657612381215,MATH 18,A03,083745,Cinel; Cameron Alexander,9,0,30,21
1657612381215,MATH 18,B01,083748,Rideout; David Porter,5,0,37,32
1657612381215,MATH 18,B02,083749,Rideout; David Porter,5,0,36,31
1657612381215,MATH 18,B03,083750,Rideout; David Porter,3,0,37,34
1657612381215,MATH 18,B04,083751,Rideout; David Porter,6,0,36,30
1657612381215,MATH 18,B05,093473,Rideout; David Porter,6,0,36,30
1657612381215,MATH 18,B06,093474,Rideout; David Porter,6,0,36,30
1657612387239,MATH 20A,A01,083754,Zheng; Zequn,14,0,40,26
1657612393277,MATH 20B,A01,083756,Briones; Jor-el Thomas Caparas,4,0,36,32
1657612393277,MATH 20B,A02,083757,Briones; Jor-el Thomas Caparas,1,0,36,35
1657612393277,MATH 20B,A03,093475,Briones; Jor-el Thomas Caparas,2,0,36,34
1657612399303,MATH 20C,A01,083760,Briones; Jor-el Thomas Caparas,1,0,35,34
1657612399303,MATH 20C,A02,083761,Briones; Jor-el Thomas Caparas,8,0,35,27
1657612399303,MATH 20C,A03,093476,Briones; Jor-el Thomas Caparas,0,1,36,36
1657612399303,MATH 20C,B01,083762,Bach; Quang Tran,1,0,30,29
1657612405329,MATH 20D,A01,083765,Tran; Brian Kha,5,0,30,25
1657612405329,MATH 20D,A02,083766,Tran; Brian Kha,5,0,30,25
1657612405329,MATH 20D,A03,083767,Tran; Brian Kha,5,0,30,25
1657612411356,MATH 20E,A01,083771,Ganguly; Soumya,9,0,32,23
1657612411356,MATH 20E,A02,083772,Ganguly; Soumya,6,0,32,26
1657612411356,MATH 20E,B01,083773,Ciotti; Benjamin,20,0,35,15
1657612411356,MATH 20E,B02,083774,Ciotti; Benjamin,18,0,35,17
1657612417382,MATH 103A,A01,083777,Greenfeld; Be'Eri,3,0,36,33
1657612417382,MATH 103A,A02,083778,Greenfeld; Be'Eri,5,0,36,31
1657612417382,MATH 103A,A03,093561,Greenfeld; Be'Eri,6,0,36,30
1657612417382,MATH 103A,B01,083779,Greenfeld; Be'Eri,7,0,36,29
1657612417382,MATH 103A,B02,083780,Greenfeld; Be'Eri,4,0,36,32
1657612417382,MATH 103A,B03,093562,Greenfeld; Be'Eri,3,0,36,33
1657612423420,MATH 105,A01,085443,Carter; Anne Toulson,15,0,35,20
1657612423420,MATH 105,A02,093477,Carter; Anne Toulson,20,0,35,15
1657612429446,MATH 109,A01,083213,Ganzberger; Geoffrey Michael,2,0,34,32
1657612429446,MATH 109,A02,083214,Ganzberger; Geoffrey Michael,4,0,34,30
1657612429446,MATH 109,A03,093478,Ganzberger; Geoffrey Michael,2,0,34,32
1657612429446,MATH 109,B01,083215,Ganzberger; Geoffrey Michael,1,0,32,31
1657612429446,MATH 109,B02,083216,Ganzberger; Geoffrey Michael,2,0,32,30
1657612429446,MATH 109,B03,093479,Ganzberger; Geoffrey Michael,8,0,32,24
1657612435479,MATH 142A,A01,083219,Chow; Bennett,7,0,32,25
1657612435479,MATH 142A,A02,083220,Chow; Bennett,10,0,32,22
1657612435479,MATH 142A,A03,093480,Chow; Bennett,9,0,32,23
1657612435479,MATH 142A,B03,093481,Chow; Bennett,8,0,32,24
1657612435479,MATH 142A,B04,093558,Chow; Bennett,13,0,32,19
1657612435479,MATH 142A,B05,093559,Chow; Bennett,6,0,32,26
1657612441504,MATH 193A,A01,083224,Rotar; Vladimir,8,0,34,26
1657612441504,MATH 193A,A02,083225,Rotar; Vladimir,9,0,34,25
1657612441504,MATH 193A,A03,083781,Rotar; Vladimir,5,0,34,29
1657612441504,MATH 193A,A04,083782,Rotar; Vladimir,10,0,34,24
1657612441504,MATH 193A,A05,093482,Rotar; Vladimir,10,0,34,24
1657612447530,MATH 197,001,091859,McAuley; Julian John,9999,0,9999,0
1657612447530,MATH 197,002,095566,Kedlaya; Kiran S.,9997,0,9999,2
1657612447530,MATH 197,003,095567,Xiao; Ming,9999,0,9999,0
1657612447530,MATH 197,004,095571,Perols; Johan Lars,9998,0,9999,1
1657612454694,COGS 9,A01,083615,Shannon; Kyle Michael,9,0,75,66
1657612460724,COGS 11,A01,083617,Boyle; Mary E. T.,23,0,48,25
1657612466750,COGS 13,A01,083071,Bastos; Amalia Pinkusfeld,11,0,71,60
1657612472778,COGS 14A,A01,092681,Semenuks; Arturs,5,1,100,95
1657612478807,COGS 14B,A01,083073,Cheng; Tzu-Han,6,0,63,57
1657612484831,COGS 17,A01,092677,Semenuks; Arturs,6,0,81,75
1657612490854,COGS 100,A01,083619,Allen; Michael Gordon,17,0,70,53
1657612496877,COGS 101A,A01,083621,Davis; Joshua Daniel,9,0,68,59
1657612502902,COGS 101B,A01,091572,Allen; Michael Gordon,12,0,65,53
1657612508936,COGS 101C,A01,083625,Delgado; Tania,17,0,35,18
1657612514966,COGS 107A,A01,083627,Boyle; Mary E. T.,13,0,60,47
1657612520997,COGS 118A,A01,083075,Gupta; Anjum,21,0,76,55
1657612527036,CSE 3,A50,083646,Miranda; Gregory Joseph,24,0,50,26
1657612533060,CSE 8A,A50,083650,Miranda; Gregory Joseph,17,1,56,39
1657612539090,CSE 11,A01,083080,Cao; Yingjun,6,15,40,34
1657612545114,CSE 12,A01,083652,Krause-Levy; Sophia Louisa,28,1,120,92
1657612551144,CSE 15L,A01,083654,Morris; Justin Loren,9,0,50,41
1657612551144,CSE 15L,A02,083655,Morris; Justin Loren,9,0,50,41
1657612557169,CSE 20,A01,083657,Tran; Khoa Dang,39,0,80,41
1657612563202,CSE 21,A01,095574,Bach; Quang Tran,22,0,48,26
1657612569227,CSE 30,A01,083084,Eldon; John,5,0,80,75
1657612569227,CSE 30,B01,095061,Bhaskar; Nishant,9,0,50,41
1657612575266,CSE 100,A01,083659,Cao; Yingjun,5,4,70,65
1657612581292,CSE 134B,A01,083661,Powell; Thomas Allan,22,0,100,78
1657612587316,CSE 140,A01,083663,Gungor; Onat,15,0,85,70
1657612593341,CSE 140L,A01,083088,Eldon; John,21,0,100,79
1657612599369,CSE 175,A01,083665,Kumar; Rakesh,3,0,25,22
1657612605396,CSE 190,A00,092507,Dubnov; Shlomo,8,0,20,12
1657612611422,ECE 45,A01,083139,Congero; Spencer William,6,0,75,69
1657612617457,ECE 65,A50,083695,Saad; Andrew S,12,0,30,18
1657612617457,ECE 65,A51,095125,Saad; Andrew S,24,0,26,2
1657612623484,ECE 109,A01,091882,Touri; Behrouz,19,0,70,51
1657612629513,ECE 180,A00,083140,Abi Samra; Nicholas Camill,1,0,30,29
1657612629513,ECE 180,B00,083141,Abi Samra; Nicholas Camill,0,0,30,30
1657612635539,MATH 10A,A01,083735,Patchell; Gregory David,2,0,30,28
1657612635539,MATH 10A,A02,083736,Patchell; Gregory David,20,0,30,10
1657612635539,MATH 10A,A03,083737,Patchell; Gregory David,16,0,30,14
1657612641581,MATH 10B,A01,083207,Lim; Seonhee,8,0,34,26
1657612641581,MATH 10B,A02,083208,Lim; Seonhee,9,0,35,26
1657612641581,MATH 10B,A03,093472,Lim; Seonhee,7,0,34,27
1657612641581,MATH 10B,B01,083739,Sinha; Shubham,12,0,30,18
1657612647617,MATH 18,A01,083743,Cinel; Cameron Alexander,7,0,30,23
1657612647617,MATH 18,A02,083744,Cinel; Cameron Alexander,17,0,30,13
1657612647617,MATH 18,A03,083745,Cinel; Cameron Alexander,9,0,30,21
1657612647617,MATH 18,B01,083748,Rideout; David Porter,5,0,37,32
1657612647617,MATH 18,B02,083749,Rideout; David Porter,5,0,36,31
1657612647617,MATH 18,B03,083750,Rideout; David Porter,3,0,37,34
1657612647617,MATH 18,B04,083751,Rideout; David Porter,6,0,36,30
1657612647617,MATH 18,B05,093473,Rideout; David Porter,6,0,36,30
1657612647617,MATH 18,B06,093474,Rideout; David Porter,6,0,36,30
1657612653641,MATH 20A,A01,083754,Zheng; Zequn,14,0,40,26
1657612659666,MATH 20B,A01,083756,Briones; Jor-el Thomas Caparas,4,0,36,32
1657612659666,MATH 20B,A02,083757,Briones; Jor-el Thomas Caparas,1,0,36,35
1657612659666,MATH 20B,A03,093475,Briones; Jor-el Thomas Caparas,2,0,36,34
1657612665698,MATH 20C,A01,083760,Briones; Jor-el Thomas Caparas,1,0,35,34
1657612665698,MATH 20C,A02,083761,Briones; Jor-el Thomas Caparas,8,0,35,27
1657612665698,MATH 20C,A03,093476,Briones; Jor-el Thomas Caparas,0,1,36,36
1657612665698,MATH 20C,B01,083762,Bach; Quang Tran,1,0,30,29
1657612671730,MATH 20D,A01,083765,Tran; Brian Kha,5,0,30,25
1657612671730,MATH 20D,A02,083766,Tran; Brian Kha,5,0,30,25
1657612671730,MATH 20D,A03,083767,Tran; Brian Kha,5,0,30,25
1657612677758,MATH 20E,A01,083771,Ganguly; Soumya,9,0,32,23
1657612677758,MATH 20E,A02,083772,Ganguly; Soumya,6,0,32,26
1657612677758,MATH 20E,B01,083773,Ciotti; Benjamin,20,0,35,15
1657612677758,MATH 20E,B02,083774,Ciotti; Benjamin,18,0,35,17
1657612683784,MATH 103A,A01,083777,Greenfeld; Be'Eri,3,0,36,33
1657612683784,MATH 103A,A02,083778,Greenfeld; Be'Eri,5,0,36,31
1657612683784,MATH 103A,A03,093561,Greenfeld; Be'Eri,6,0,36,30
1657612683784,MATH 103A,B01,083779,Greenfeld; Be'Eri,7,0,36,29
1657612683784,MATH 103A,B02,083780,Greenfeld; Be'Eri,4,0,36,32
1657612683784,MATH 103A,B03,093562,Greenfeld; Be'Eri,3,0,36,33
1657612689812,MATH 105,A01,085443,Carter; Anne Toulson,15,0,35,20
1657612689812,MATH 105,A02,093477,Carter; Anne Toulson,20,0,35,15
1657612695844,MATH 109,A01,083213,Ganzberger; Geoffrey Michael,2,0,34,32
1657612695844,MATH 109,A02,083214,Ganzberger; Geoffrey Michael,4,0,34,30
1657612695844,MATH 109,A03,093478,Ganzberger; Geoffrey Michael,2,0,34,32
1657612695844,MATH 109,B01,083215,Ganzberger; Geoffrey Michael,1,0,32,31
1657612695844,MATH 109,B02,083216,Ganzberger; Geoffrey Michael,2,0,32,30
1657612695844,MATH 109,B03,093479,Ganzberger; Geoffrey Michael,8,0,32,24
1657612701877,MATH 142A,A01,083219,Chow; Bennett,7,0,32,25
1657612701877,MATH 142A,A02,083220,Chow; Bennett,10,0,32,22
1657612701877,MATH 142A,A03,093480,Chow; Bennett,9,0,32,23
1657612701877,MATH 142A,B03,093481,Chow; Bennett,8,0,32,24
1657612701877,MATH 142A,B04,093558,Chow; Bennett,13,0,32,19
1657612701877,MATH 142A,B05,093559,Chow; Bennett,6,0,32,26
1657612707904,MATH 193A,A01,083224,Rotar; Vladimir,8,0,34,26
1657612707904,MATH 193A,A02,083225,Rotar; Vladimir,9,0,34,25
1657612707904,MATH 193A,A03,083781,Rotar; Vladimir,5,0,34,29
1657612707904,MATH 193A,A04,083782,Rotar; Vladimir,10,0,34,24
1657612707904,MATH 193A,A05,093482,Rotar; Vladimir,10,0,34,24
1657612713931,MATH 197,001,091859,McAuley; Julian John,9999,0,9999,0
1657612713931,MATH 197,002,095566,Kedlaya; Kiran S.,9997,0,9999,2
1657612713931,MATH 197,003,095567,Xiao; Ming,9999,0,9999,0
1657612713931,MATH 197,004,095571,Perols; Johan Lars,9998,0,9999,1
1657612721016,COGS 9,A01,083615,Shannon; Kyle Michael,9,0,75,66
1657612727040,COGS 11,A01,083617,Boyle; Mary E. T.,23,0,48,25
1657612733070,COGS 13,A01,083071,Bastos; Amalia Pinkusfeld,11,0,71,60
1657612739098,COGS 14A,A01,092681,Semenuks; Arturs,5,1,100,95
1657612745129,COGS 14B,A01,083073,Cheng; Tzu-Han,6,0,63,57
1657612751155,COGS 17,A01,092677,Semenuks; Arturs,6,0,81,75
1657612757180,COGS 100,A01,083619,Allen; Michael Gordon,17,0,70,53
1657612763214,COGS 101A,A01,083621,Davis; Joshua Daniel,9,0,68,59
1657612769239,COGS 101B,A01,091572,Allen; Michael Gordon,12,0,65,53
1657612775265,COGS 101C,A01,083625,Delgado; Tania,17,0,35,18
1657612781291,COGS 107A,A01,083627,Boyle; Mary E. T.,13,0,60,47
1657612787321,COGS 118A,A01,083075,Gupta; Anjum,21,0,76,55
1657612793350,CSE 3,A50,083646,Miranda; Gregory Joseph,24,0,50,26
1657612799390,CSE 8A,A50,083650,Miranda; Gregory Joseph,17,1,56,39
1657612805423,CSE 11,A01,083080,Cao; Yingjun,6,15,40,34
1657612811450,CSE 12,A01,083652,Krause-Levy; Sophia Louisa,28,1,120,92
1657612817487,CSE 15L,A01,083654,Morris; Justin Loren,9,0,50,41
1657612817487,CSE 15L,A02,083655,Morris; Justin Loren,9,0,50,41
1657612823512,CSE 20,A01,083657,Tran; Khoa Dang,39,0,80,41
1657612829535,CSE 21,A01,095574,Bach; Quang Tran,22,0,48,26
1657612835564,CSE 30,A01,083084,Eldon; John,5,0,80,75
1657612835564,CSE 30,B01,095061,Bhaskar; Nishant,9,0,50,41
1657612841589,CSE 100,A01,083659,Cao; Yingjun,5,4,70,65
1657612847619,CSE 134B,A01,083661,Powell; Thomas Allan,22,0,100,78
1657612853645,CSE 140,A01,083663,Gungor; Onat,15,0,85,70
1657612859668,CSE 140L,A01,083088,Eldon; John,21,0,100,79
1657612865692,CSE 175,A01,083665,Kumar; Rakesh,3,0,25,22
1657612871721,CSE 190,A00,092507,Dubnov; Shlomo,8,0,20,12
1657612877755,ECE 45,A01,083139,Congero; Spencer William,6,0,75,69
1657612883788,ECE 65,A50,083695,Saad; Andrew S,12,0,30,18
1657612883788,ECE 65,A51,095125,Saad; Andrew S,24,0,26,2
1657612889811,ECE 109,A01,091882,Touri; Behrouz,19,0,70,51
1657612895836,ECE 180,A00,083140,Abi Samra; Nicholas Camill,1,0,30,29
1657612895836,ECE 180,B00,083141,Abi Samra; Nicholas Camill,0,0,30,30
1657612901860,MATH 10A,A01,083735,Patchell; Gregory David,2,0,30,28
1657612901860,MATH 10A,A02,083736,Patchell; Gregory David,20,0,30,10
1657612901860,MATH 10A,A03,083737,Patchell; Gregory David,16,0,30,14
1657612907887,MATH 10B,A01,083207,Lim; Seonhee,8,0,34,26
1657612907887,MATH 10B,A02,083208,Lim; Seonhee,9,0,35,26
1657612907887,MATH 10B,A03,093472,Lim; Seonhee,7,0,34,27
1657612907887,MATH 10B,B01,083739,Sinha; Shubham,12,0,30,18
1657612913924,MATH 18,A01,083743,Cinel; Cameron Alexander,7,0,30,23
1657612913924,MATH 18,A02,083744,Cinel; Cameron Alexander,17,0,30,13
1657612913924,MATH 18,A03,083745,Cinel; Cameron Alexander,9,0,30,21
1657612913924,MATH 18,B01,083748,Rideout; David Porter,5,0,37,32
1657612913924,MATH 18,B02,083749,Rideout; David Porter,5,0,36,31
1657612913924,MATH 18,B03,083750,Rideout; David Porter,3,0,37,34
1657612913924,MATH 18,B04,083751,Rideout; David Porter,6,0,36,30
1657612913924,MATH 18,B05,093473,Rideout; David Porter,6,0,36,30
1657612913924,MATH 18,B06,093474,Rideout; David Porter,6,0,36,30
1657612919949,MATH 20A,A01,083754,Zheng; Zequn,14,0,40,26
1657612925980,MATH 20B,A01,083756,Briones; Jor-el Thomas Caparas,4,0,36,32
1657612925980,MATH 20B,A02,083757,Briones; Jor-el Thomas Caparas,1,0,36,35
1657612925980,MATH 20B,A03,093475,Briones; Jor-el Thomas Caparas,2,0,36,34
1657612932008,MATH 20C,A01,083760,Briones; Jor-el Thomas Caparas,1,0,35,34
1657612932008,MATH 20C,A02,083761,Briones; Jor-el Thomas Caparas,8,0,35,27
1657612932008,MATH 20C,A03,093476,Briones; Jor-el Thomas Caparas,0,1,36,36
1657612932008,MATH 20C,B01,083762,Bach; Quang Tran,1,0,30,29
1657612938032,MATH 20D,A01,083765,Tran; Brian Kha,5,0,30,25
1657612938032,MATH 20D,A02,083766,Tran; Brian Kha,5,0,30,25
1657612938032,MATH 20D,A03,083767,Tran; Brian Kha,5,0,30,25
1657612944065,MATH 20E,A01,083771,Ganguly; Soumya,9,0,32,23
1657612944065,MATH 20E,A02,083772,Ganguly; Soumya,6,0,32,26
1657612944065,MATH 20E,B01,083773,Ciotti; Benjamin,20,0,35,15
1657612944065,MATH 20E,B02,083774,Ciotti; Benjamin,18,0,35,17
1657612950090,MATH 103A,A01,083777,Greenfeld; Be'Eri,3,0,36,33
1657612950090,MATH 103A,A02,083778,Greenfeld; Be'Eri,5,0,36,31
1657612950090,MATH 103A,A03,093561,Greenfeld; Be'Eri,6,0,36,30
1657612950090,MATH 103A,B01,083779,Greenfeld; Be'Eri,7,0,36,29
1657612950090,MATH 103A,B02,083780,Greenfeld; Be'Eri,4,0,36,32
1657612950090,MATH 103A,B03,093562,Greenfeld; Be'Eri,3,0,36,33
1657612956114,MATH 105,A01,085443,Carter; Anne Toulson,15,0,35,20
1657612956114,MATH 105,A02,093477,Carter; Anne Toulson,20,0,35,15
1657612962137,MATH 109,A01,083213,Ganzberger; Geoffrey Michael,2,0,34,32
1657612962137,MATH 109,A02,083214,Ganzberger; Geoffrey Michael,4,0,34,30
1657612962137,MATH 109,A03,093478,Ganzberger; Geoffrey Michael,2,0,34,32
1657612962137,MATH 109,B01,083215,Ganzberger; Geoffrey Michael,1,0,32,31
1657612962137,MATH 109,B02,083216,Ganzberger; Geoffrey Michael,2,0,32,30
1657612962137,MATH 109,B03,093479,Ganzberger; Geoffrey Michael,8,0,32,24
1657612968172,MATH 142A,A01,083219,Chow; Bennett,7,0,32,25
1657612968172,MATH 142A,A02,083220,Chow; Bennett,10,0,32,22
1657612968172,MATH 142A,A03,093480,Chow; Bennett,9,0,32,23
1657612968172,MATH 142A,B03,093481,Chow; Bennett,8,0,32,24
1657612968172,MATH 142A,B04,093558,Chow; Bennett,13,0,32,19
1657612968172,MATH 142A,B05,093559,Chow; Bennett,6,0,32,26
1657612974196,MATH 193A,A01,083224,Rotar; Vladimir,8,0,34,26
1657612974196,MATH 193A,A02,083225,Rotar; Vladimir,9,0,34,25
1657612974196,MATH 193A,A03,083781,Rotar; Vladimir,5,0,34,29
1657612974196,MATH 193A,A04,083782,Rotar; Vladimir,10,0,34,24
1657612974196,MATH 193A,A05,093482,Rotar; Vladimir,10,0,34,24
1657612980226,MATH 197,001,091859,McAuley; Julian John,9999,0,9999,0
1657612980226,MATH 197,002,095566,Kedlaya; Kiran S.,9997,0,9999,2
1657612980226,MATH 197,003,095567,Xiao; Ming,9999,0,9999,0
1657612980226,MATH 197,004,095571,Perols; Johan Lars,9998,0,9999,1
1657612987289,COGS 9,A01,083615,Shannon; Kyle Michael,9,0,75,66
1657612993313,COGS 11,A01,083617,Boyle; Mary E. T.,23,0,48,25
1657612999344,COGS 13,A01,083071,Bastos; Amalia Pinkusfeld,11,0,71,60
1657613005371,COGS 14A,A01,092681,Semenuks; Arturs,5,1,100,95
1657613011401,COGS 14B,A01,083073,Cheng; Tzu-Han,6,0,63,57
1657613017424,COGS 17,A01,092677,Semenuks; Arturs,6,0,81,75
1657613023448,COGS 100,A01,083619,Allen; Michael Gordon,17,0,70,53
1657613029477,COGS 101A,A01,083621,Davis; Joshua Daniel,9,0,68,59
1657613035505,COGS 101B,A01,091572,Allen; Michael Gordon,12,0,65,53
1657613041531,COGS 101C,A01,083625,Delgado; Tania,17,0,35,18
1657613047627,COGS 107A,A01,083627,Boyle; Mary E. T.,13,0,60,47
1657613053651,COGS 118A,A01,083075,Gupta; Anjum,21,0,76,55
1657613059689,CSE 3,A50,083646,Miranda; Gregory Joseph,24,0,50,26
1657613065712,CSE 8A,A50,083650,Miranda; Gregory Joseph,17,1,56,39
1657613071738,CSE 11,A01,083080,Cao; Yingjun,6,15,40,34
1657613077766,CSE 12,A01,083652,Krause-Levy; Sophia Louisa,28,1,120,92
1657613083789,CSE 15L,A01,083654,Morris; Justin Loren,9,0,50,41
1657613083789,CSE 15L,A02,083655,Morris; Justin Loren,9,0,50,41
1657613089813,CSE 20,A01,083657,Tran; Khoa Dang,39,0,80,41
1657613095838,CSE 21,A01,095574,Bach; Quang Tran,22,0,48,26
1657613101868,CSE 30,A01,083084,Eldon; John,5,0,80,75
1657613101868,CSE 30,B01,095061,Bhaskar; Nishant,9,0,50,41
1657613107891,CSE 100,A01,083659,Cao; Yingjun,5,4,70,65
1657613113918,CSE 134B,A01,083661,Powell; Thomas Allan,22,0,100,78
1657613119942,CSE 140,A01,083663,Gungor; Onat,15,0,85,70
1657613125965,CSE 140L,A01,083088,Eldon; John,21,0,100,79
1657613131992,CSE 175,A01,083665,Kumar; Rakesh,3,0,25,22
1657613138016,CSE 190,A00,092507,Dubnov; Shlomo,8,0,20,12
1657613144044,ECE 45,A01,083139,Congero; Spencer William,6,0,75,69
1657613150068,ECE 65,A50,083695,Saad; Andrew S,12,0,30,18
1657613150068,ECE 65,A51,095125,Saad; Andrew S,24,0,26,2
1657613156093,ECE 109,A01,091882,Touri; Behrouz,19,0,70,51
1657613162119,ECE 180,A00,083140,Abi Samra; Nicholas Camill,1,0,30,29
1657613162119,ECE 180,B00,083141,Abi Samra; Nicholas Camill,0,0,30,30
1657613168144,MATH 10A,A01,083735,Patchell; Gregory David,2,0,30,28
1657613168144,MATH 10A,A02,083736,Patchell; Gregory David,20,0,30,10
1657613168144,MATH 10A,A03,083737,Patchell; Gregory David,16,0,30,14
1657613174169,MATH 10B,A01,083207,Lim; Seonhee,8,0,34,26
1657613174169,MATH 10B,A02,083208,Lim; Seonhee,9,0,35,26
1657613174169,MATH 10B,A03,093472,Lim; Seonhee,7,0,34,27
1657613174169,MATH 10B,B01,083739,Sinha; Shubham,12,0,30,18
1657613180194,MATH 18,A01,083743,Cinel; Cameron Alexander,7,0,30,23
1657613180194,MATH 18,A02,083744,Cinel; Cameron Alexander,17,0,30,13
1657613180194,MATH 18,A03,083745,Cinel; Cameron Alexander,9,0,30,21
1657613180194,MATH 18,B01,083748,Rideout; David Porter,5,0,37,32
1657613180194,MATH 18,B02,083749,Rideout; David Porter,5,0,36,31
1657613180194,MATH 18,B03,083750,Rideout; David Porter,3,0,37,34
1657613180194,MATH 18,B04,083751,Rideout; David Porter,6,0,36,30
1657613180194,MATH 18,B05,093473,Rideout; David Porter,6,0,36,30
1657613180194,MATH 18,B06,093474,Rideout; David Porter,6,0,36,30
1657613186219,MATH 20A,A01,083754,Zheng; Zequn,14,0,40,26
1657613192244,MATH 20B,A01,083756,Briones; Jor-el Thomas Caparas,4,0,36,32
1657613192244,MATH 20B,A02,083757,Briones; Jor-el Thomas Caparas,1,0,36,35
1657613192244,MATH 20B,A03,093475,Briones; Jor-el Thomas Caparas,2,0,36,34
1657613198267,MATH 20C,A01,083760,Briones; Jor-el Thomas Caparas,1,0,35,34
1657613198267,MATH 20C,A02,083761,Briones; Jor-el Thomas Caparas,8,0,35,27
1657613198267,MATH 20C,A03,093476,Briones; Jor-el Thomas Caparas,0,1,36,36
1657613198267,MATH 20C,B01,083762,Bach; Quang Tran,1,0,30,29
1657613204291,MATH 20D,A01,083765,Tran; Brian Kha,5,0,30,25
1657613204291,MATH 20D,A02,083766,Tran; Brian Kha,5,0,30,25
1657613204291,MATH 20D,A03,083767,Tran; Brian Kha,5,0,30,25
1657613210318,MATH 20E,A01,083771,Ganguly; Soumya,9,0,32,23
1657613210318,MATH 20E,A02,083772,Ganguly; Soumya,6,0,32,26
1657613210318,MATH 20E,B01,083773,Ciotti; Benjamin,20,0,35,15
1657613210318,MATH 20E,B02,083774,Ciotti; Benjamin,18,0,35,17
1657613216346,MATH 103A,A01,083777,Greenfeld; Be'Eri,3,0,36,33
1657613216346,MATH 103A,A02,083778,Greenfeld; Be'Eri,5,0,36,31
1657613216346,MATH 103A,A03,093561,Greenfeld; Be'Eri,6,0,36,30
1657613216346,MATH 103A,B01,083779,Greenfeld; Be'Eri,7,0,36,29
1657613216346,MATH 103A,B02,083780,Greenfeld; Be'Eri,4,0,36,32
1657613216346,MATH 103A,B03,093562,Greenfeld; Be'Eri,3,0,36,33
1657613222376,MATH 105,A01,085443,Carter; Anne Toulson,15,0,35,20
1657613222376,MATH 105,A02,093477,Carter; Anne Toulson,20,0,35,15
1657613228403,MATH 109,A01,083213,Ganzberger; Geoffrey Michael,2,0,34,32
1657613228403,MATH 109,A02,083214,Ganzberger; Geoffrey Michael,4,0,34,30
1657613228403,MATH 109,A03,093478,Ganzberger; Geoffrey Michael,2,0,34,32
1657613228403,MATH 109,B01,083215,Ganzberger; Geoffrey Michael,1,0,32,31
1657613228403,MATH 109,B02,083216,Ganzberger; Geoffrey Michael,2,0,32,30
1657613228403,MATH 109,B03,093479,Ganzberger; Geoffrey Michael,8,0,32,24
1657613234430,MATH 142A,A01,083219,Chow; Bennett,7,0,32,25
1657613234430,MATH 142A,A02,083220,Chow; Bennett,10,0,32,22
1657613234430,MATH 142A,A03,093480,Chow; Bennett,9,0,32,23
1657613234430,MATH 142A,B03,093481,Chow; Bennett,8,0,32,24
1657613234430,MATH 142A,B04,093558,Chow; Bennett,13,0,32,19
1657613234430,MATH 142A,B05,093559,Chow; Bennett,6,0,32,26
1657613240453,MATH 193A,A01,083224,Rotar; Vladimir,8,0,34,26
1657613240453,MATH 193A,A02,083225,Rotar; Vladimir,9,0,34,25
1657613240453,MATH 193A,A03,083781,Rotar; Vladimir,5,0,34,29
1657613240453,MATH 193A,A04,083782,Rotar; Vladimir,10,0,34,24
1657613240453,MATH 193A,A05,093482,Rotar; Vladimir,10,0,34,24
1657613246479,MATH 197,001,091859,McAuley; Julian John,9999,0,9999,0
1657613246479,MATH 197,002,095566,Kedlaya; Kiran S.,9997,0,9999,2
1657613246479,MATH 197,003,095567,Xiao; Ming,9999,0,9999,0
1657613246479,MATH 197,004,095571,Perols; Johan Lars,9998,0,9999,1
1657613253539,COGS 9,A01,083615,Shannon; Kyle Michael,9,0,75,66
1657613259567,COGS 11,A01,083617,Boyle; Mary E. T.,23,0,48,25
1657613265588,COGS 13,A01,083071,Bastos; Amalia Pinkusfeld,11,0,71,60
1657613271611,COGS 14A,A01,092681,Semenuks; Arturs,5,1,100,95
1657613277639,COGS 14B,A01,083073,Cheng; Tzu-Han,6,0,63,57
1657613283663,COGS 17,A01,092677,Semenuks; Arturs,6,0,81,75
1657613289690,COGS 100,A01,083619,Allen; Michael Gordon,17,0,70,53
1657613295716,COGS 101A,A01,083621,Davis; Joshua Daniel,9,0,68,59
1657613301742,COGS 101B,A01,091572,Allen; Michael Gordon,12,0,65,53
1657613307765,COGS 101C,A01,083625,Delgado; Tania,17,0,35,18
1657613313790,COGS 107A,A01,083627,Boyle; Mary E. T.,13,0,60,47
1657613319811,COGS 118A,A01,083075,Gupta; Anjum,21,0,76,55
1657613325835,CSE 3,A50,083646,Miranda; Gregory Joseph,24,0,50,26
1657613331870,CSE 8A,A50,083650,Miranda; Gregory Joseph,17,1,56,39
1657613337895,CSE 11,A01,083080,Cao; Yingjun,6,15,40,34
1657613343926,CSE 12,A01,083652,Krause-Levy; Sophia Louisa,28,1,120,92
1657613349952,CSE 15L,A01,083654,Morris; Justin Loren,9,0,50,41
1657613349952,CSE 15L,A02,083655,Morris; Justin Loren,9,0,50,41
1657613355976,CSE 20,A01,083657,Tran; Khoa Dang,39,0,80,41
1657613362001,CSE 21,A01,095574,Bach; Quang Tran,22,0,48,26
1657613368038,CSE 30,A01,083084,Eldon; John,5,0,80,75
1657613368038,CSE 30,B01,095061,Bhaskar; Nishant,9,0,50,41
1657613374066,CSE 100,A01,083659,Cao; Yingjun,5,4,70,65
1657613380091,CSE 134B,A01,083661,Powell; Thomas Allan,22,0,100,78
1657613386114,CSE 140,A01,083663,Gungor; Onat,15,0,85,70
1657613392137,CSE 140L,A01,083088,Eldon; John,21,0,100,79
1657613398167,CSE 175,A01,083665,Kumar; Rakesh,3,0,25,22
1657613404191,CSE 190,A00,092507,Dubnov; Shlomo,8,0,20,12
1657613410226,ECE 45,A01,083139,Congero; Spencer William,6,0,75,69
1657613416252,ECE 65,A50,083695,Saad; Andrew S,12,0,30,18
1657613416252,ECE 65,A51,095125,Saad; Andrew S,24,0,26,2
1657613422284,ECE 109,A01,091882,Touri; Behrouz,19,0,70,51
1657613428312,ECE 180,A00,083140,Abi Samra; Nicholas Camill,1,0,30,29
1657613428312,ECE 180,B00,083141,Abi Samra; Nicholas Camill,0,0,30,30
1657613434336,MATH 10A,A01,083735,Patchell; Gregory David,2,0,30,28
1657613434336,MATH 10A,A02,083736,Patchell; Gregory David,20,0,30,10
1657613434336,MATH 10A,A03,083737,Patchell; Gregory David,16,0,30,14
1657613440359,MATH 10B,A01,083207,Lim; Seonhee,8,0,34,26
1657613440359,MATH 10B,A02,083208,Lim; Seonhee,9,0,35,26
1657613440359,MATH 10B,A03,093472,Lim; Seonhee,7,0,34,27
1657613440359,MATH 10B,B01,083739,Sinha; Shubham,12,0,30,18
1657613446393,MATH 18,A01,083743,Cinel; Cameron Alexander,7,0,30,23
1657613446393,MATH 18,A02,083744,Cinel; Cameron Alexander,17,0,30,13
1657613446393,MATH 18,A03,083745,Cinel; Cameron Alexander,9,0,30,21
1657613446393,MATH 18,B01,083748,Rideout; David Porter,5,0,37,32
1657613446393,MATH 18,B02,083749,Rideout; David Porter,5,0,36,31
1657613446393,MATH 18,B03,083750,Rideout; David Porter,3,0,37,34
1657613446393,MATH 18,B04,083751,Rideout; David Porter,6,0,36,30
1657613446393,MATH 18,B05,093473,Rideout; David Porter,6,0,36,30
1657613446393,MATH 18,B06,093474,Rideout; David Porter,6,0,36,30
1657613452430,MATH 20A,A01,083754,Zheng; Zequn,14,0,40,26
1657613458456,MATH 20B,A01,083756,Briones; Jor-el Thomas Caparas,4,0,36,32
1657613458456,MATH 20B,A02,083757,Briones; Jor-el Thomas Caparas,1,0,36,35
1657613458456,MATH 20B,A03,093475,Briones; Jor-el Thomas Caparas,2,0,36,34
1657613464480,MATH 20C,A01,083760,Briones; Jor-el Thomas Caparas,1,0,35,34
1657613464480,MATH 20C,A02,083761,Briones; Jor-el Thomas Caparas,8,0,35,27
1657613464480,MATH 20C,A03,093476,Briones; Jor-el Thomas Caparas,0,1,36,36
1657613464480,MATH 20C,B01,083762,Bach; Quang Tran,1,0,30,29
1657613470511,MATH 20D,A01,083765,Tran; Brian Kha,5,0,30,25
1657613470511,MATH 20D,A02,083766,Tran; Brian Kha,5,0,30,25
1657613470511,MATH 20D,A03,083767,Tran; Brian Kha,5,0,30,25
1657613476536,MATH 20E,A01,083771,Ganguly; Soumya,9,0,32,23
1657613476536,MATH 20E,A02,083772,Ganguly; Soumya,6,0,32,26
1657613476536,MATH 20E,B01,083773,Ciotti; Benjamin,20,0,35,15
1657613476536,MATH 20E,B02,083774,Ciotti; Benjamin,18,0,35,17
1657613482573,MATH 103A,A01,083777,Greenfeld; Be'Eri,3,0,36,33
1657613482573,MATH 103A,A02,083778,Greenfeld; Be'Eri,5,0,36,31
1657613482573,MATH 103A,A03,093561,Greenfeld; Be'Eri,6,0,36,30
1657613482573,MATH 103A,B01,083779,Greenfeld; Be'Eri,7,0,36,29
1657613482573,MATH 103A,B02,083780,Greenfeld; Be'Eri,4,0,36,32
1657613482573,MATH 103A,B03,093562,Greenfeld; Be'Eri,3,0,36,33
1657613488605,MATH 105,A01,085443,Carter; Anne Toulson,15,0,35,20
1657613488605,MATH 105,A02,093477,Carter; Anne Toulson,20,0,35,15
1657613494631,MATH 109,A01,083213,Ganzberger; Geoffrey Michael,2,0,34,32
1657613494631,MATH 109,A02,083214,Ganzberger; Geoffrey Michael,4,0,34,30
1657613494631,MATH 109,A03,093478,Ganzberger; Geoffrey Michael,2,0,34,32
1657613494631,MATH 109,B01,083215,Ganzberger; Geoffrey Michael,1,0,32,31
1657613494631,MATH 109,B02,083216,Ganzberger; Geoffrey Michael,2,0,32,30
1657613494631,MATH 109,B03,093479,Ganzberger; Geoffrey Michael,8,0,32,24
1657613500659,MATH 142A,A01,083219,Chow; Bennett,7,0,32,25
1657613500659,MATH 142A,A02,083220,Chow; Bennett,10,0,32,22
1657613500659,MATH 142A,A03,093480,Chow; Bennett,9,0,32,23
1657613500659,MATH 142A,B03,093481,Chow; Bennett,8,0,32,24
1657613500659,MATH 142A,B04,093558,Chow; Bennett,13,0,32,19
1657613500659,MATH 142A,B05,093559,Chow; Bennett,6,0,32,26
1657613506693,MATH 193A,A01,083224,Rotar; Vladimir,8,0,34,26
1657613506693,MATH 193A,A02,083225,Rotar; Vladimir,9,0,34,25
1657613506693,MATH 193A,A03,083781,Rotar; Vladimir,5,0,34,29
1657613506693,MATH 193A,A04,083782,Rotar; Vladimir,10,0,34,24
1657613506693,MATH 193A,A05,093482,Rotar; Vladimir,10,0,34,24
1657613512717,MATH 197,001,091859,McAuley; Julian John,9999,0,9999,0
1657613512717,MATH 197,002,095566,Kedlaya; Kiran S.,9997,0,9999,2
1657613512717,MATH 197,003,095567,Xiao; Ming,9999,0,9999,0
1657613512717,MATH 197,004,095571,Perols; Johan Lars,9998,0,9999,1
1657613519789,COGS 9,A01,083615,Shannon; Kyle Michael,9,0,75,66
1657613525816,COGS 11,A01,083617,Boyle; Mary E. T.,23,0,48,25
1657613531856,COGS 13,A01,083071,Bastos; Amalia Pinkusfeld,11,0,71,60
1657613537885,COGS 14A,A01,092681,Semenuks; Arturs,5,1,100,95
1657613543914,COGS 14B,A01,083073,Cheng; Tzu-Han,6,0,63,57
1657613549943,COGS 17,A01,092677,Semenuks; Arturs,6,0,81,75
1657613555974,COGS 100,A01,083619,Allen; Michael Gordon,17,0,70,53
1657613561998,COGS 101A,A01,083621,Davis; Joshua Daniel,9,0,68,59
1657613568030,COGS 101B,A01,091572,Allen; Michael Gordon,12,0,65,53
1657613574059,COGS 101C,A01,083625,Delgado; Tania,17,0,35,18
1657613580083,COGS 107A,A01,083627,Boyle; Mary E. T.,13,0,60,47
1657613586108,COGS 118A,A01,083075,Gupta; Anjum,21,0,76,55
1657613592142,CSE 3,A50,083646,Miranda; Gregory Joseph,24,0,50,26
1657613598170,CSE 8A,A50,083650,Miranda; Gregory Joseph,17,1,56,39
1657613604192,CSE 11,A01,083080,Cao; Yingjun,6,15,40,34
1657613610217,CSE 12,A01,083652,Krause-Levy; Sophia Louisa,28,1,120,92
1657613616246,CSE 15L,A01,083654,Morris; Justin Loren,9,0,50,41
1657613616246,CSE 15L,A02,083655,Morris; Justin Loren,9,0,50,41
1657613622271,CSE 20,A01,083657,Tran; Khoa Dang,39,0,80,41
1657613628300,CSE 21,A01,095574,Bach; Quang Tran,22,0,48,26
1657613634331,CSE 30,A01,083084,Eldon; John,5,0,80,75
1657613634331,CSE 30,B01,095061,Bhaskar; Nishant,9,0,50,41
1657613640356,CSE 100,A01,083659,Cao; Yingjun,5,4,70,65
1657613646474,CSE 134B,A01,083661,Powell; Thomas Allan,22,0,100,78
1657613652499,CSE 140,A01,083663,Gungor; Onat,15,0,85,70
1657613658527,CSE 140L,A01,083088,Eldon; John,21,0,100,79
1657613664552,CSE 175,A01,083665,Kumar; Rakesh,3,0,25,22
1657613670576,CSE 190,A00,092507,Dubnov; Shlomo,8,0,20,12
1657613676602,ECE 45,A01,083139,Congero; Spencer William,6,0,75,69
1657613682639,ECE 65,A50,083695,Saad; Andrew S,12,0,30,18
1657613682639,ECE 65,A51,095125,Saad; Andrew S,24,0,26,2
1657613688669,ECE 109,A01,091882,Touri; Behrouz,19,0,70,51
1657613694693,ECE 180,A00,083140,Abi Samra; Nicholas Camill,1,0,30,29
1657613694693,ECE 180,B00,083141,Abi Samra; Nicholas Camill,0,0,30,30
1657613700718,MATH 10A,A01,083735,Patchell; Gregory David,2,0,30,28
1657613700718,MATH 10A,A02,083736,Patchell; Gregory David,20,0,30,10
1657613700718,MATH 10A,A03,083737,Patchell; Gregory David,16,0,30,14
1657613706755,MATH 10B,A01,083207,Lim; Seonhee,8,0,34,26
1657613706755,MATH 10B,A02,083208,Lim; Seonhee,9,0,35,26
1657613706755,MATH 10B,A03,093472,Lim; Seonhee,7,0,34,27
1657613706755,MATH 10B,B01,083739,Sinha; Shubham,12,0,30,18
1657613712782,MATH 18,A01,083743,Cinel; Cameron Alexander,7,0,30,23
1657613712782,MATH 18,A02,083744,Cinel; Cameron Alexander,17,0,30,13
1657613712782,MATH 18,A03,083745,Cinel; Cameron Alexander,9,0,30,21
1657613712782,MATH 18,B01,083748,Rideout; David Porter,5,0,37,32
1657613712782,MATH 18,B02,083749,Rideout; David Porter,5,0,36,31
1657613712782,MATH 18,B03,083750,Rideout; David Porter,3,0,37,34
1657613712782,MATH 18,B04,083751,Rideout; David Porter,6,0,36,30
1657613712782,MATH 18,B05,093473,Rideout; David Porter,6,0,36,30
1657613712782,MATH 18,B06,093474,Rideout; David Porter,6,0,36,30
1657613718811,MATH 20A,A01,083754,Zheng; Zequn,14,0,40,26
1657613724836,MATH 20B,A01,083756,Briones; Jor-el Thomas Caparas,4,0,36,32
1657613724836,MATH 20B,A02,083757,Briones; Jor-el Thomas Caparas,1,0,36,35
1657613724836,MATH 20B,A03,093475,Briones; Jor-el Thomas Caparas,2,0,36,34
1657613730861,MATH 20C,A01,083760,Briones; Jor-el Thomas Caparas,1,0,35,34
1657613730861,MATH 20C,A02,083761,Briones; Jor-el Thomas Caparas,8,0,35,27
1657613730861,MATH 20C,A03,093476,Briones; Jor-el Thomas Caparas,0,1,36,36
1657613730861,MATH 20C,B01,083762,Bach; Quang Tran,1,0,30,29
1657613736886,MATH 20D,A01,083765,Tran; Brian Kha,5,0,30,25
1657613736886,MATH 20D,A02,083766,Tran; Brian Kha,5,0,30,25
1657613736886,MATH 20D,A03,083767,Tran; Brian Kha,5,0,30,25
1657613742919,MATH 20E,A01,083771,Ganguly; Soumya,9,0,32,23
1657613742919,MATH 20E,A02,083772,Ganguly; Soumya,6,0,32,26
1657613742919,MATH 20E,B01,083773,Ciotti; Benjamin,20,0,35,15
1657613742919,MATH 20E,B02,083774,Ciotti; Benjamin,18,0,35,17
1657613748946,MATH 103A,A01,083777,Greenfeld; Be'Eri,3,0,36,33
1657613748946,MATH 103A,A02,083778,Greenfeld; Be'Eri,5,0,36,31
1657613748946,MATH 103A,A03,093561,Greenfeld; Be'Eri,6,0,36,30
1657613748946,MATH 103A,B01,083779,Greenfeld; Be'Eri,7,0,36,29
1657613748946,MATH 103A,B02,083780,Greenfeld; Be'Eri,4,0,36,32
1657613748946,MATH 103A,B03,093562,Greenfeld; Be'Eri,3,0,36,33
1657613754978,MATH 105,A01,085443,Carter; Anne Toulson,15,0,35,20
1657613754978,MATH 105,A02,093477,Carter; Anne Toulson,20,0,35,15
1657613761003,MATH 109,A01,083213,Ganzberger; Geoffrey Michael,2,0,34,32
1657613761003,MATH 109,A02,083214,Ganzberger; Geoffrey Michael,4,0,34,30
1657613761003,MATH 109,A03,093478,Ganzberger; Geoffrey Michael,2,0,34,32
1657613761003,MATH 109,B01,083215,Ganzberger; Geoffrey Michael,1,0,32,31
1657613761003,MATH 109,B02,083216,Ganzberger; Geoffrey Michael,2,0,32,30
1657613761003,MATH 109,B03,093479,Ganzberger; Geoffrey Michael,8,0,32,24
1657613767029,MATH 142A,A01,083219,Chow; Bennett,7,0,32,25
1657613767029,MATH 142A,A02,083220,Chow; Bennett,10,0,32,22
1657613767029,MATH 142A,A03,093480,Chow; Bennett,9,0,32,23
1657613767029,MATH 142A,B03,093481,Chow; Bennett,8,0,32,24
1657613767029,MATH 142A,B04,093558,Chow; Bennett,13,0,32,19
1657613767029,MATH 142A,B05,093559,Chow; Bennett,6,0,32,26
1657613773060,MATH 193A,A01,083224,Rotar; Vladimir,8,0,34,26
1657613773060,MATH 193A,A02,083225,Rotar; Vladimir,9,0,34,25
1657613773060,MATH 193A,A03,083781,Rotar; Vladimir,5,0,34,29
1657613773060,MATH 193A,A04,083782,Rotar; Vladimir,10,0,34,24
1657613773060,MATH 193A,A05,093482,Rotar; Vladimir,10,0,34,24
1657613779090,MATH 197,001,091859,McAuley; Julian John,9999,0,9999,0
1657613779090,MATH 197,002,095566,Kedlaya; Kiran S.,9997,0,9999,2
1657613779090,MATH 197,003,095567,Xiao; Ming,9999,0,9999,0
1657613779090,MATH 197,004,095571,Perols; Johan Lars,9998,0,9999,1
1657613786168,COGS 9,A01,083615,Shannon; Kyle Michael,9,0,75,66
1657613792205,COGS 11,A01,083617,Boyle; Mary E. T.,23,0,48,25
1657613798229,COGS 13,A01,083071,Bastos; Amalia Pinkusfeld,11,0,71,60
1657613804259,COGS 14A,A01,092681,Semenuks; Arturs,5,1,100,95
1657613810282,COGS 14B,A01,083073,Cheng; Tzu-Han,6,0,63,57
1657613816305,COGS 17,A01,092677,Semenuks; Arturs,6,0,81,75
1657613822332,COGS 100,A01,083619,Allen; Michael Gordon,17,0,70,53
1657613828360,COGS 101A,A01,083621,Davis; Joshua Daniel,9,0,68,59
1657613834390,COGS 101B,A01,091572,Allen; Michael Gordon,12,0,65,53
1657613840413,COGS 101C,A01,083625,Delgado; Tania,17,0,35,18
1657613846438,COGS 107A,A01,083627,Boyle; Mary E. T.,13,0,60,47
1657613852468,COGS 118A,A01,083075,Gupta; Anjum,21,0,76,55
1657613858493,CSE 3,A50,083646,Miranda; Gregory Joseph,24,0,50,26
1657613864521,CSE 8A,A50,083650,Miranda; Gregory Joseph,17,1,56,39
1657613870548,CSE 11,A01,083080,Cao; Yingjun,6,15,40,34
1657613876571,CSE 12,A01,083652,Krause-Levy; Sophia Louisa,28,1,120,92
1657613882594,CSE 15L,A01,083654,Morris; Justin Loren,9,0,50,41
1657613882594,CSE 15L,A02,083655,Morris; Justin Loren,9,0,50,41
1657613888618,CSE 20,A01,083657,Tran; Khoa Dang,39,0,80,41
1657613894645,CSE 21,A01,095574,Bach; Quang Tran,22,0,48,26
1657613900676,CSE 30,A01,083084,Eldon; John,5,0,80,75
1657613900676,CSE 30,B01,095061,Bhaskar; Nishant,9,0,50,41
1657613906701,CSE 100,A01,083659,Cao; Yingjun,5,4,70,65
1657613912725,CSE 134B,A01,083661,Powell; Thomas Allan,22,0,100,78
1657613918748,CSE 140,A01,083663,Gungor; Onat,15,0,85,70
1657613924775,CSE 140L,A01,083088,Eldon; John,21,0,100,79
1657613930799,CSE 175,A01,083665,Kumar; Rakesh,3,0,25,22
1657613936824,CSE 190,A00,092507,Dubnov; Shlomo,8,0,20,12
1657613942850,ECE 45,A01,083139,Congero; Spencer William,6,0,75,69
1657613948888,ECE 65,A50,083695,Saad; Andrew S,12,0,30,18
1657613948888,ECE 65,A51,095125,Saad; Andrew S,24,0,26,2
1657613954914,ECE 109,A01,091882,Touri; Behrouz,19,0,70,51
1657613960940,ECE 180,A00,083140,Abi Samra; Nicholas Camill,1,0,30,29
1657613960940,ECE 180,B00,083141,Abi Samra; Nicholas Camill,0,0,30,30
1657613966964,MATH 10A,A01,083735,Patchell; Gregory David,2,0,30,28
1657613966964,MATH 10A,A02,083736,Patchell; Gregory David,20,0,30,10
1657613966964,MATH 10A,A03,083737,Patchell; Gregory David,16,0,30,14
1657613972989,MATH 10B,A01,083207,Lim; Seonhee,8,0,34,26
1657613972989,MATH 10B,A02,083208,Lim; Seonhee,9,0,35,26
1657613972989,MATH 10B,A03,093472,Lim; Seonhee,7,0,34,27
1657613972989,MATH 10B,B01,083739,Sinha; Shubham,12,0,30,18
1657613979026,MATH 18,A01,083743,Cinel; Cameron Alexander,7,0,30,23
1657613979026,MATH 18,A02,083744,Cinel; Cameron Alexander,17,0,30,13
1657613979026,MATH 18,A03,083745,Cinel; Cameron Alexander,9,0,30,21
1657613979026,MATH 18,B01,083748,Rideout; David Porter,5,0,37,32
1657613979026,MATH 18,B02,083749,Rideout; David Porter,5,0,36,31
1657613979026,MATH 18,B03,083750,Rideout; David Porter,3,0,37,34
1657613979026,MATH 18,B04,083751,Rideout; David Porter,6,0,36,30
1657613979026,MATH 18,B05,093473,Rideout; David Porter,6,0,36,30
1657613979026,MATH 18,B06,093474,Rideout; David Porter,6,0,36,30
1657613985049,MATH 20A,A01,083754,Zheng; Zequn,14,0,40,26
1657613991080,MATH 20B,A01,083756,Briones; Jor-el Thomas Caparas,4,0,36,32
1657613991080,MATH 20B,A02,083757,Briones; Jor-el Thomas Caparas,1,0,36,35
1657613991080,MATH 20B,A03,093475,Briones; Jor-el Thomas Caparas,2,0,36,34
1657613997109,MATH 20C,A01,083760,Briones; Jor-el Thomas Caparas,1,0,35,34
1657613997109,MATH 20C,A02,083761,Briones; Jor-el Thomas Caparas,8,0,35,27
1657613997109,MATH 20C,A03,093476,Briones; Jor-el Thomas Caparas,0,1,36,36
1657613997109,MATH 20C,B01,083762,Bach; Quang Tran,1,0,30,29
1657614003134,MATH 20D,A01,083765,Tran; Brian Kha,5,0,30,25
1657614003134,MATH 20D,A02,083766,Tran; Brian Kha,5,0,30,25
1657614003134,MATH 20D,A03,083767,Tran; Brian Kha,5,0,30,25
1657614009164,MATH 20E,A01,083771,Ganguly; Soumya,9,0,32,23
1657614009164,MATH 20E,A02,083772,Ganguly; Soumya,6,0,32,26
1657614009164,MATH 20E,B01,083773,Ciotti; Benjamin,20,0,35,15
1657614009164,MATH 20E,B02,083774,Ciotti; Benjamin,18,0,35,17
1657614015201,MATH 103A,A01,083777,Greenfeld; Be'Eri,3,0,36,33
1657614015201,MATH 103A,A02,083778,Greenfeld; Be'Eri,5,0,36,31
1657614015201,MATH 103A,A03,093561,Greenfeld; Be'Eri,6,0,36,30
1657614015201,MATH 103A,B01,083779,Greenfeld; Be'Eri,7,0,36,29
1657614015201,MATH 103A,B02,083780,Greenfeld; Be'Eri,4,0,36,32
1657614015201,MATH 103A,B03,093562,Greenfeld; Be'Eri,3,0,36,33
1657614021231,MATH 105,A01,085443,Carter; Anne Toulson,15,0,35,20
1657614021231,MATH 105,A02,093477,Carter; Anne Toulson,20,0,35,15
1657614027253,MATH 109,A01,083213,Ganzberger; Geoffrey Michael,2,0,34,32
1657614027253,MATH 109,A02,083214,Ganzberger; Geoffrey Michael,4,0,34,30
1657614027253,MATH 109,A03,093478,Ganzberger; Geoffrey Michael,2,0,34,32
1657614027253,MATH 109,B01,083215,Ganzberger; Geoffrey Michael,1,0,32,31
1657614027253,MATH 109,B02,083216,Ganzberger; Geoffrey Michael,2,0,32,30
1657614027253,MATH 109,B03,093479,Ganzberger; Geoffrey Michael,8,0,32,24
1657614033282,MATH 142A,A01,083219,Chow; Bennett,7,0,32,25
1657614033282,MATH 142A,A02,083220,Chow; Bennett,10,0,32,22
1657614033282,MATH 142A,A03,093480,Chow; Bennett,9,0,32,23
1657614033282,MATH 142A,B03,093481,Chow; Bennett,8,0,32,24
1657614033282,MATH 142A,B04,093558,Chow; Bennett,13,0,32,19
1657614033282,MATH 142A,B05,093559,Chow; Bennett,6,0,32,26
1657614039316,MATH 193A,A01,083224,Rotar; Vladimir,8,0,34,26
1657614039316,MATH 193A,A02,083225,Rotar; Vladimir,9,0,34,25
1657614039316,MATH 193A,A03,083781,Rotar; Vladimir,5,0,34,29
1657614039316,MATH 193A,A04,083782,Rotar; Vladimir,10,0,34,24
1657614039316,MATH 193A,A05,093482,Rotar; Vladimir,10,0,34,24
1657614045339,MATH 197,001,091859,McAuley; Julian John,9999,0,9999,0
1657614045339,MATH 197,002,095566,Kedlaya; Kiran S.,9997,0,9999,2
1657614045339,MATH 197,003,095567,Xiao; Ming,9999,0,9999,0
1657614045339,MATH 197,004,095571,Perols; Johan Lars,9998,0,9999,1
1657614052397,COGS 9,A01,083615,Shannon; Kyle Michael,9,0,75,66
1657614058421,COGS 11,A01,083617,Boyle; Mary E. T.,23,0,48,25
1657614064442,COGS 13,A01,083071,Bastos; Amalia Pinkusfeld,11,0,71,60
1657614070465,COGS 14A,A01,092681,Semenuks; Arturs,5,1,100,95
1657614076492,COGS 14B,A01,083073,Cheng; Tzu-Han,6,0,63,57
1657614082515,COGS 17,A01,092677,Semenuks; Arturs,6,0,81,75
1657614088538,COGS 100,A01,083619,Allen; Michael Gordon,17,0,70,53
1657614094563,COGS 101A,A01,083621,Davis; Joshua Daniel,9,0,68,59
1657614100587,COGS 101B,A01,091572,Allen; Michael Gordon,12,0,65,53
1657614106611,COGS 101C,A01,083625,Delgado; Tania,17,0,35,18
1657614112633,COGS 107A,A01,083627,Boyle; Mary E. T.,13,0,60,47
1657614118658,COGS 118A,A01,083075,Gupta; Anjum,21,0,76,55
1657614124688,CSE 3,A50,083646,Miranda; Gregory Joseph,24,0,50,26
1657614130713,CSE 8A,A50,083650,Miranda; Gregory Joseph,17,1,56,39
1657614136739,CSE 11,A01,083080,Cao; Yingjun,6,15,40,34
1657614142772,CSE 12,A01,083652,Krause-Levy; Sophia Louisa,28,1,120,92
1657614148806,CSE 15L,A01,083654,Morris; Justin Loren,9,0,50,41
1657614148806,CSE 15L,A02,083655,Morris; Justin Loren,9,0,50,41
1657614154831,CSE 20,A01,083657,Tran; Khoa Dang,39,0,80,41
1657614160856,CSE 21,A01,095574,Bach; Quang Tran,22,0,48,26
1657614166890,CSE 30,A01,083084,Eldon; John,5,0,80,75
1657614166890,CSE 30,B01,095061,Bhaskar; Nishant,9,0,50,41
1657614172919,CSE 100,A01,083659,Cao; Yingjun,5,4,70,65
1657614178942,CSE 134B,A01,083661,Powell; Thomas Allan,22,0,100,78
1657614184966,CSE 140,A01,083663,Gungor; Onat,15,0,85,70
1657614190991,CSE 140L,A01,083088,Eldon; John,21,0,100,79
1657614197018,CSE 175,A01,083665,Kumar; Rakesh,3,0,25,22
1657614203041,CSE 190,A00,092507,Dubnov; Shlomo,8,0,20,12
1657614209071,ECE 45,A01,083139,Congero; Spencer William,6,0,75,69
1657614215098,ECE 65,A50,083695,Saad; Andrew S,12,0,30,18
1657614215098,ECE 65,A51,095125,Saad; Andrew S,24,0,26,2
1657614221128,ECE 109,A01,091882,Touri; Behrouz,19,0,70,51
1657614227155,ECE 180,A00,083140,Abi Samra; Nicholas Camill,1,0,30,29
1657614227155,ECE 180,B00,083141,Abi Samra; Nicholas Camill,0,0,30,30
1657614233182,MATH 10A,A01,083735,Patchell; Gregory David,2,0,30,28
1657614233182,MATH 10A,A02,083736,Patchell; Gregory David,20,0,30,10
1657614233182,MATH 10A,A03,083737,Patchell; Gregory David,16,0,30,14
1657614239227,MATH 10B,A01,083207,Lim; Seonhee,8,0,34,26
1657614239227,MATH 10B,A02,083208,Lim; Seonhee,9,0,35,26
1657614239227,MATH 10B,A03,093472,Lim; Seonhee,7,0,34,27
1657614239227,MATH 10B,B01,083739,Sinha; Shubham,12,0,30,18
1657614245338,MATH 18,A01,083743,Cinel; Cameron Alexander,7,0,30,23
1657614245338,MATH 18,A02,083744,Cinel; Cameron Alexander,17,0,30,13
1657614245338,MATH 18,A03,083745,Cinel; Cameron Alexander,9,0,30,21
1657614245338,MATH 18,B01,083748,Rideout; David Porter,5,0,37,32
1657614245338,MATH 18,B02,083749,Rideout; David Porter,5,0,36,31
1657614245338,MATH 18,B03,083750,Rideout; David Porter,3,0,37,34
1657614245338,MATH 18,B04,083751,Rideout; David Porter,6,0,36,30
1657614245338,MATH 18,B05,093473,Rideout; David Porter,6,0,36,30
1657614245338,MATH 18,B06,093474,Rideout; David Porter,6,0,36,30
1657614251371,MATH 20A,A01,083754,Zheng; Zequn,14,0,40,26
1657614257403,MATH 20B,A01,083756,Briones; Jor-el Thomas Caparas,4,0,36,32
1657614257403,MATH 20B,A02,083757,Briones; Jor-el Thomas Caparas,1,0,36,35
1657614257403,MATH 20B,A03,093475,Briones; Jor-el Thomas Caparas,2,0,36,34
1657614263427,MATH 20C,A01,083760,Briones; Jor-el Thomas Caparas,1,0,35,34
1657614263427,MATH 20C,A02,083761,Briones; Jor-el Thomas Caparas,8,0,35,27
1657614263427,MATH 20C,A03,093476,Briones; Jor-el Thomas Caparas,0,1,36,36
1657614263427,MATH 20C,B01,083762,Bach; Quang Tran,1,0,30,29
1657614269455,MATH 20D,A01,083765,Tran; Brian Kha,5,0,30,25
1657614269455,MATH 20D,A02,083766,Tran; Brian Kha,5,0,30,25
1657614269455,MATH 20D,A03,083767,Tran; Brian Kha,5,0,30,25
1657614275481,MATH 20E,A01,083771,Ganguly; Soumya,9,0,32,23
1657614275481,MATH 20E,A02,083772,Ganguly; Soumya,6,0,32,26
1657614275481,MATH 20E,B01,083773,Ciotti; Benjamin,20,0,35,15
1657614275481,MATH 20E,B02,083774,Ciotti; Benjamin,18,0,35,17
1657614281510,MATH 103A,A01,083777,Greenfeld; Be'Eri,3,0,36,33
1657614281510,MATH 103A,A02,083778,Greenfeld; Be'Eri,5,0,36,31
1657614281510,MATH 103A,A03,093561,Greenfeld; Be'Eri,6,0,36,30
1657614281510,MATH 103A,B01,083779,Greenfeld; Be'Eri,7,0,36,29
1657614281510,MATH 103A,B02,083780,Greenfeld; Be'Eri,4,0,36,32
1657614281510,MATH 103A,B03,093562,Greenfeld; Be'Eri,3,0,36,33
1657614287543,MATH 105,A01,085443,Carter; Anne Toulson,15,0,35,20
1657614287543,MATH 105,A02,093477,Carter; Anne Toulson,20,0,35,15
1657614293577,MATH 109,A01,083213,Ganzberger; Geoffrey Michael,2,0,34,32
1657614293577,MATH 109,A02,083214,Ganzberger; Geoffrey Michael,4,0,34,30
1657614293577,MATH 109,A03,093478,Ganzberger; Geoffrey Michael,2,0,34,32
1657614293577,MATH 109,B01,083215,Ganzberger; Geoffrey Michael,1,0,32,31
1657614293577,MATH 109,B02,083216,Ganzberger; Geoffrey Michael,2,0,32,30
1657614293577,MATH 109,B03,093479,Ganzberger; Geoffrey Michael,8,0,32,24
1657614299604,MATH 142A,A01,083219,Chow; Bennett,7,0,32,25
1657614299604,MATH 142A,A02,083220,Chow; Bennett,10,0,32,22
1657614299604,MATH 142A,A03,093480,Chow; Bennett,9,0,32,23
1657614299604,MATH 142A,B03,093481,Chow; Bennett,8,0,32,24
1657614299604,MATH 142A,B04,093558,Chow; Bennett,13,0,32,19
1657614299604,MATH 142A,B05,093559,Chow; Bennett,6,0,32,26
1657614305629,MATH 193A,A01,083224,Rotar; Vladimir,8,0,34,26
1657614305629,MATH 193A,A02,083225,Rotar; Vladimir,9,0,34,25
1657614305629,MATH 193A,A03,083781,Rotar; Vladimir,5,0,34,29
1657614305629,MATH 193A,A04,083782,Rotar; Vladimir,10,0,34,24
1657614305629,MATH 193A,A05,093482,Rotar; Vladimir,10,0,34,24
1657614311655,MATH 197,001,091859,McAuley; Julian John,9999,0,9999,0
1657614311655,MATH 197,002,095566,Kedlaya; Kiran S.,9997,0,9999,2
1657614311655,MATH 197,003,095567,Xiao; Ming,9999,0,9999,0
1657614311655,MATH 197,004,095571,Perols; Johan Lars,9998,0,9999,1
1657614318740,COGS 9,A01,083615,Shannon; Kyle Michael,9,0,75,66
1657614324765,COGS 11,A01,083617,Boyle; Mary E. T.,23,0,48,25
1657614330789,COGS 13,A01,083071,Bastos; Amalia Pinkusfeld,11,0,71,60
1657614336815,COGS 14A,A01,092681,Semenuks; Arturs,5,1,100,95
1657614342843,COGS 14B,A01,083073,Cheng; Tzu-Han,6,0,63,57
1657614348866,COGS 17,A01,092677,Semenuks; Arturs,6,0,81,75
1657614354891,COGS 100,A01,083619,Allen; Michael Gordon,17,0,70,53
1657614360921,COGS 101A,A01,083621,Davis; Joshua Daniel,9,0,68,59
1657614366951,COGS 101B,A01,091572,Allen; Michael Gordon,12,0,65,53
1657614372982,COGS 101C,A01,083625,Delgado; Tania,17,0,35,18
1657614379006,COGS 107A,A01,083627,Boyle; Mary E. T.,13,0,60,47
1657614385038,COGS 118A,A01,083075,Gupta; Anjum,21,0,76,55
1657614391080,CSE 3,A50,083646,Miranda; Gregory Joseph,24,0,50,26
1657614397110,CSE 8A,A50,083650,Miranda; Gregory Joseph,17,1,56,39
1657614403136,CSE 11,A01,083080,Cao; Yingjun,6,15,40,34
1657614409168,CSE 12,A01,083652,Krause-Levy; Sophia Louisa,28,1,120,92
1657614415197,CSE 15L,A01,083654,Morris; Justin Loren,9,0,50,41
1657614415197,CSE 15L,A02,083655,Morris; Justin Loren,9,0,50,41
1657614421226,CSE 20,A01,083657,Tran; Khoa Dang,39,0,80,41
1657614427251,CSE 21,A01,095574,Bach; Quang Tran,22,0,48,26
1657614433277,CSE 30,A01,083084,Eldon; John,5,0,80,75
1657614433277,CSE 30,B01,095061,Bhaskar; Nishant,9,0,50,41
1657614439303,CSE 100,A01,083659,Cao; Yingjun,5,4,70,65
1657614445330,CSE 134B,A01,083661,Powell; Thomas Allan,22,0,100,78
1657614451354,CSE 140,A01,083663,Gungor; Onat,15,0,85,70
1657614457380,CSE 140L,A01,083088,Eldon; John,21,0,100,79
1657614463404,CSE 175,A01,083665,Kumar; Rakesh,3,0,25,22
1657614469429,CSE 190,A00,092507,Dubnov; Shlomo,8,0,20,12
1657614475469,ECE 45,A01,083139,Congero; Spencer William,6,0,75,69
1657614481507,ECE 65,A50,083695,Saad; Andrew S,12,0,30,18
1657614481507,ECE 65,A51,095125,Saad; Andrew S,24,0,26,2
1657614487536,ECE 109,A01,091882,Touri; Behrouz,19,0,70,51
1657614493560,ECE 180,A00,083140,Abi Samra; Nicholas Camill,1,0,30,29
1657614493560,ECE 180,B00,083141,Abi Samra; Nicholas Camill,0,0,30,30
1657614499587,MATH 10A,A01,083735,Patchell; Gregory David,2,0,30,28
1657614499587,MATH 10A,A02,083736,Patchell; Gregory David,20,0,30,10
1657614499587,MATH 10A,A03,083737,Patchell; Gregory David,16,0,30,14
1657614505624,MATH 10B,A01,083207,Lim; Seonhee,8,0,34,26
1657614505624,MATH 10B,A02,083208,Lim; Seonhee,9,0,35,26
1657614505624,MATH 10B,A03,093472,Lim; Seonhee,7,0,34,27
1657614505624,MATH 10B,B01,083739,Sinha; Shubham,12,0,30,18
1657614511652,MATH 18,A01,083743,Cinel; Cameron Alexander,7,0,30,23
1657614511652,MATH 18,A02,083744,Cinel; Cameron Alexander,17,0,30,13
1657614511652,MATH 18,A03,083745,Cinel; Cameron Alexander,9,0,30,21
1657614511652,MATH 18,B01,083748,Rideout; David Porter,5,0,37,32
1657614511652,MATH 18,B02,083749,Rideout; David Porter,5,0,36,31
1657614511652,MATH 18,B03,083750,Rideout; David Porter,3,0,37,34
1657614511652,MATH 18,B04,083751,Rideout; David Porter,6,0,36,30
1657614511652,MATH 18,B05,093473,Rideout; David Porter,6,0,36,30
1657614511652,MATH 18,B06,093474,Rideout; David Porter,6,0,36,30
1657614517687,MATH 20A,A01,083754,Zheng; Zequn,14,0,40,26
1657614523726,MATH 20B,A01,083756,Briones; Jor-el Thomas Caparas,4,0,36,32
1657614523726,MATH 20B,A02,083757,Briones; Jor-el Thomas Caparas,1,0,36,35
1657614523726,MATH 20B,A03,093475,Briones; Jor-el Thomas Caparas,2,0,36,34
1657614529755,MATH 20C,A01,083760,Briones; Jor-el Thomas Caparas,1,0,35,34
1657614529755,MATH 20C,A02,083761,Briones; Jor-el Thomas Caparas,8,0,35,27
1657614529755,MATH 20C,A03,093476,Briones; Jor-el Thomas Caparas,0,1,36,36
1657614529755,MATH 20C,B01,083762,Bach; Quang Tran,1,0,30,29
1657614535780,MATH 20D,A01,083765,Tran; Brian Kha,5,0,30,25
1657614535780,MATH 20D,A02,083766,Tran; Brian Kha,5,0,30,25
1657614535780,MATH 20D,A03,083767,Tran; Brian Kha,5,0,30,25
1657614541805,MATH 20E,A01,083771,Ganguly; Soumya,9,0,32,23
1657614541805,MATH 20E,A02,083772,Ganguly; Soumya,6,0,32,26
1657614541805,MATH 20E,B01,083773,Ciotti; Benjamin,20,0,35,15
1657614541805,MATH 20E,B02,083774,Ciotti; Benjamin,18,0,35,17
1657614547832,MATH 103A,A01,083777,Greenfeld; Be'Eri,3,0,36,33
1657614547832,MATH 103A,A02,083778,Greenfeld; Be'Eri,5,0,36,31
1657614547832,MATH 103A,A03,093561,Greenfeld; Be'Eri,6,0,36,30
1657614547832,MATH 103A,B01,083779,Greenfeld; Be'Eri,7,0,36,29
1657614547832,MATH 103A,B02,083780,Greenfeld; Be'Eri,4,0,36,32
1657614547832,MATH 103A,B03,093562,Greenfeld; Be'Eri,3,0,36,33
1657614553870,MATH 105,A01,085443,Carter; Anne Toulson,15,0,35,20
1657614553870,MATH 105,A02,093477,Carter; Anne Toulson,20,0,35,15
1657614559905,MATH 109,A01,083213,Ganzberger; Geoffrey Michael,2,0,34,32
1657614559905,MATH 109,A02,083214,Ganzberger; Geoffrey Michael,4,0,34,30
1657614559905,MATH 109,A03,093478,Ganzberger; Geoffrey Michael,2,0,34,32
1657614559905,MATH 109,B01,083215,Ganzberger; Geoffrey Michael,1,0,32,31
1657614559905,MATH 109,B02,083216,Ganzberger; Geoffrey Michael,2,0,32,30
1657614559905,MATH 109,B03,093479,Ganzberger; Geoffrey Michael,8,0,32,24
1657614565932,MATH 142A,A01,083219,Chow; Bennett,7,0,32,25
1657614565932,MATH 142A,A02,083220,Chow; Bennett,10,0,32,22
1657614565932,MATH 142A,A03,093480,Chow; Bennett,9,0,32,23
1657614565932,MATH 142A,B03,093481,Chow; Bennett,8,0,32,24
1657614565932,MATH 142A,B04,093558,Chow; Bennett,13,0,32,19
1657614565932,MATH 142A,B05,093559,Chow; Bennett,6,0,32,26
1657614571971,MATH 193A,A01,083224,Rotar; Vladimir,8,0,34,26
1657614571971,MATH 193A,A02,083225,Rotar; Vladimir,9,0,34,25
1657614571971,MATH 193A,A03,083781,Rotar; Vladimir,5,0,34,29
1657614571971,MATH 193A,A04,083782,Rotar; Vladimir,10,0,34,24
1657614571971,MATH 193A,A05,093482,Rotar; Vladimir,10,0,34,24
1657614577997,MATH 197,001,091859,McAuley; Julian John,9999,0,9999,0
1657614577997,MATH 197,002,095566,Kedlaya; Kiran S.,9997,0,9999,2
1657614577997,MATH 197,003,095567,Xiao; Ming,9999,0,9999,0
1657614577997,MATH 197,004,095571,Perols; Johan Lars,9998,0,9999,1
1657614585066,COGS 9,A01,083615,Shannon; Kyle Michael,9,0,75,66
1657614591093,COGS 11,A01,083617,Boyle; Mary E. T.,23,0,48,25
1657614597118,COGS 13,A01,083071,Bastos; Amalia Pinkusfeld,11,0,71,60
1657614603149,COGS 14A,A01,092681,Semenuks; Arturs,5,1,100,95
1657614609173,COGS 14B,A01,083073,Cheng; Tzu-Han,6,0,63,57
1657614615198,COGS 17,A01,092677,Semenuks; Arturs,6,0,81,75
1657614621228,COGS 100,A01,083619,Allen; Michael Gordon,17,0,70,53
1657614627258,COGS 101A,A01,083621,Davis; Joshua Daniel,9,0,68,59
1657614633293,COGS 101B,A01,091572,Allen; Michael Gordon,12,0,65,53
1657614639323,COGS 101C,A01,083625,Delgado; Tania,17,0,35,18
1657614645347,COGS 107A,A01,083627,Boyle; Mary E. T.,13,0,60,47
1657614651377,COGS 118A,A01,083075,Gupta; Anjum,21,0,76,55
1657614657404,CSE 3,A50,083646,Miranda; Gregory Joseph,24,0,50,26
1657614663432,CSE 8A,A50,083650,Miranda; Gregory Joseph,17,1,56,39
1657614669482,CSE 11,A01,083080,Cao; Yingjun,6,15,40,34
1657614675510,CSE 12,A01,083652,Krause-Levy; Sophia Louisa,28,1,120,92
1657614681542,CSE 15L,A01,083654,Morris; Justin Loren,9,0,50,41
1657614681542,CSE 15L,A02,083655,Morris; Justin Loren,9,0,50,41
1657614687570,CSE 20,A01,083657,Tran; Khoa Dang,39,0,80,41
1657614693595,CSE 21,A01,095574,Bach; Quang Tran,22,0,48,26
1657614699621,CSE 30,A01,083084,Eldon; John,5,0,80,75
1657614699621,CSE 30,B01,095061,Bhaskar; Nishant,9,0,50,41
1657614705647,CSE 100,A01,083659,Cao; Yingjun,5,4,70,65
1657614711676,CSE 134B,A01,083661,Powell; Thomas Allan,22,0,100,78
1657614717702,CSE 140,A01,083663,Gungor; Onat,15,0,85,70
1657614723730,CSE 140L,A01,083088,Eldon; John,21,0,100,79
1657614729767,CSE 175,A01,083665,Kumar; Rakesh,3,0,25,22
1657614735797,CSE 190,A00,092507,Dubnov; Shlomo,8,0,20,12
1657614741824,ECE 45,A01,083139,Congero; Spencer William,6,0,75,69
1657614747849,ECE 65,A50,083695,Saad; Andrew S,12,0,30,18
1657614747849,ECE 65,A51,095125,Saad; Andrew S,24,0,26,2
1657614753881,ECE 109,A01,091882,Touri; Behrouz,19,0,70,51
1657614759924,ECE 180,A00,083140,Abi Samra; Nicholas Camill,1,0,30,29
1657614759924,ECE 180,B00,083141,Abi Samra; Nicholas Camill,0,0,30,30
1657614765956,MATH 10A,A01,083735,Patchell; Gregory David,2,0,30,28
1657614765956,MATH 10A,A02,083736,Patchell; Gregory David,20,0,30,10
1657614765956,MATH 10A,A03,083737,Patchell; Gregory David,16,0,30,14
1657614771985,MATH 10B,A01,083207,Lim; Seonhee,8,0,34,26
1657614771985,MATH 10B,A02,083208,Lim; Seonhee,9,0,35,26
1657614771985,MATH 10B,A03,093472,Lim; Seonhee,7,0,34,27
1657614771985,MATH 10B,B01,083739,Sinha; Shubham,12,0,30,18
1657614778029,MATH 18,A01,083743,Cinel; Cameron Alexander,7,0,30,23
1657614778029,MATH 18,A02,083744,Cinel; Cameron Alexander,17,0,30,13
1657614778029,MATH 18,A03,083745,Cinel; Cameron Alexander,9,0,30,21
1657614778029,MATH 18,B01,083748,Rideout; David Porter,5,0,37,32
1657614778029,MATH 18,B02,083749,Rideout; David Porter,5,0,36,31
1657614778029,MATH 18,B03,083750,Rideout; David Porter,3,0,37,34
1657614778029,MATH 18,B04,083751,Rideout; David Porter,6,0,36,30
1657614778029,MATH 18,B05,093473,Rideout; David Porter,6,0,36,30
1657614778029,MATH 18,B06,093474,Rideout; David Porter,6,0,36,30
1657614784052,MATH 20A,A01,083754,Zheng; Zequn,14,0,40,26
1657614790079,MATH 20B,A01,083756,Briones; Jor-el Thomas Caparas,4,0,36,32
1657614790079,MATH 20B,A02,083757,Briones; Jor-el Thomas Caparas,1,0,36,35
1657614790079,MATH 20B,A03,093475,Briones; Jor-el Thomas Caparas,2,0,36,34
1657614796104,MATH 20C,A01,083760,Briones; Jor-el Thomas Caparas,1,0,35,34
1657614796104,MATH 20C,A02,083761,Briones; Jor-el Thomas Caparas,8,0,35,27
1657614796104,MATH 20C,A03,093476,Briones; Jor-el Thomas Caparas,0,1,36,36
1657614796104,MATH 20C,B01,083762,Bach; Quang Tran,1,0,30,29
1657614802133,MATH 20D,A01,083765,Tran; Brian Kha,5,0,30,25
1657614802133,MATH 20D,A02,083766,Tran; Brian Kha,5,0,30,25
1657614802133,MATH 20D,A03,083767,Tran; Brian Kha,5,0,30,25
1657614808161,MATH 20E,A01,083771,Ganguly; Soumya,9,0,32,23
1657614808161,MATH 20E,A02,083772,Ganguly; Soumya,6,0,32,26
1657614808161,MATH 20E,B01,083773,Ciotti; Benjamin,20,0,35,15
1657614808161,MATH 20E,B02,083774,Ciotti; Benjamin,18,0,35,17
1657614814190,MATH 103A,A01,083777,Greenfeld; Be'Eri,3,0,36,33
1657614814190,MATH 103A,A02,083778,Greenfeld; Be'Eri,5,0,36,31
1657614814190,MATH 103A,A03,093561,Greenfeld; Be'Eri,6,0,36,30
1657614814190,MATH 103A,B01,083779,Greenfeld; Be'Eri,7,0,36,29
1657614814190,MATH 103A,B02,083780,Greenfeld; Be'Eri,4,0,36,32
1657614814190,MATH 103A,B03,093562,Greenfeld; Be'Eri,3,0,36,33
1657614820222,MATH 105,A01,085443,Carter; Anne Toulson,15,0,35,20
1657614820222,MATH 105,A02,093477,Carter; Anne Toulson,20,0,35,15
1657614826247,MATH 109,A01,083213,Ganzberger; Geoffrey Michael,2,0,34,32
1657614826247,MATH 109,A02,083214,Ganzberger; Geoffrey Michael,4,0,34,30
1657614826247,MATH 109,A03,093478,Ganzberger; Geoffrey Michael,2,0,34,32
1657614826247,MATH 109,B01,083215,Ganzberger; Geoffrey Michael,1,0,32,31
1657614826247,MATH 109,B02,083216,Ganzberger; Geoffrey Michael,2,0,32,30
1657614826247,MATH 109,B03,093479,Ganzberger; Geoffrey Michael,8,0,32,24
1657614832275,MATH 142A,A01,083219,Chow; Bennett,7,0,32,25
1657614832275,MATH 142A,A02,083220,Chow; Bennett,10,0,32,22
1657614832275,MATH 142A,A03,093480,Chow; Bennett,9,0,32,23
1657614832275,MATH 142A,B03,093481,Chow; Bennett,8,0,32,24
1657614832275,MATH 142A,B04,093558,Chow; Bennett,13,0,32,19
1657614832275,MATH 142A,B05,093559,Chow; Bennett,6,0,32,26
1657614838305,MATH 193A,A01,083224,Rotar; Vladimir,8,0,34,26
1657614838305,MATH 193A,A02,083225,Rotar; Vladimir,9,0,34,25
1657614838305,MATH 193A,A03,083781,Rotar; Vladimir,5,0,34,29
1657614838305,MATH 193A,A04,083782,Rotar; Vladimir,10,0,34,24
1657614838305,MATH 193A,A05,093482,Rotar; Vladimir,10,0,34,24
1657614844405,MATH 197,001,091859,McAuley; Julian John,9999,0,9999,0
1657614844405,MATH 197,002,095566,Kedlaya; Kiran S.,9997,0,9999,2
1657614844405,MATH 197,003,095567,Xiao; Ming,9999,0,9999,0
1657614844405,MATH 197,004,095571,Perols; Johan Lars,9998,0,9999,1
1657614851466,COGS 9,A01,083615,Shannon; Kyle Michael,9,0,75,66
1657614857489,COGS 11,A01,083617,Boyle; Mary E. T.,23,0,48,25
1657614863517,COGS 13,A01,083071,Bastos; Amalia Pinkusfeld,11,0,71,60
1657614869542,COGS 14A,A01,092681,Semenuks; Arturs,5,1,100,95
1657614875565,COGS 14B,A01,083073,Cheng; Tzu-Han,6,0,63,57
1657614881589,COGS 17,A01,092677,Semenuks; Arturs,6,0,81,75
1657614887614,COGS 100,A01,083619,Allen; Michael Gordon,17,0,70,53
1657614893641,COGS 101A,A01,083621,Davis; Joshua Daniel,9,0,68,59
1657614899668,COGS 101B,A01,091572,Allen; Michael Gordon,12,0,65,53
1657614905696,COGS 101C,A01,083625,Delgado; Tania,17,0,35,18
1657614911723,COGS 107A,A01,083627,Boyle; Mary E. T.,13,0,60,47
1657614917748,COGS 118A,A01,083075,Gupta; Anjum,21,0,76,55
1657614923777,CSE 3,A50,083646,Miranda; Gregory Joseph,24,0,50,26
1657614929801,CSE 8A,A50,083650,Miranda; Gregory Joseph,17,1,56,39
1657614935825,CSE 11,A01,083080,Cao; Yingjun,6,15,40,34
1657614941849,CSE 12,A01,083652,Krause-Levy; Sophia Louisa,28,1,120,92
1657614947875,CSE 15L,A01,083654,Morris; Justin Loren,9,0,50,41
1657614947875,CSE 15L,A02,083655,Morris; Justin Loren,9,0,50,41
1657614953902,CSE 20,A01,083657,Tran; Khoa Dang,39,0,80,41
1657614959931,CSE 21,A01,095574,Bach; Quang Tran,22,0,48,26
1657614965957,CSE 30,A01,083084,Eldon; John,5,0,80,75
1657614965957,CSE 30,B01,095061,Bhaskar; Nishant,9,0,50,41
1657614971996,CSE 100,A01,083659,Cao; Yingjun,5,4,70,65
1657614978024,CSE 134B,A01,083661,Powell; Thomas Allan,22,0,100,78
1657614984047,CSE 140,A01,083663,Gungor; Onat,15,0,85,70
1657614990073,CSE 140L,A01,083088,Eldon; John,21,0,100,79
1657614996099,CSE 175,A01,083665,Kumar; Rakesh,3,0,25,22
1657615002125,CSE 190,A00,092507,Dubnov; Shlomo,8,0,20,12
1657615008155,ECE 45,A01,083139,Congero; Spencer William,6,0,75,69
1657615014180,ECE 65,A50,083695,Saad; Andrew S,12,0,30,18
1657615014180,ECE 65,A51,095125,Saad; Andrew S,24,0,26,2
1657615020205,ECE 109,A01,091882,Touri; Behrouz,19,0,70,51
1657615026226,ECE 180,A00,083140,Abi Samra; Nicholas Camill,1,0,30,29
1657615026226,ECE 180,B00,083141,Abi Samra; Nicholas Camill,0,0,30,30
1657615032252,MATH 10A,A01,083735,Patchell; Gregory David,2,0,30,28
1657615032252,MATH 10A,A02,083736,Patchell; Gregory David,20,0,30,10
1657615032252,MATH 10A,A03,083737,Patchell; Gregory David,16,0,30,14
1657615038279,MATH 10B,A01,083207,Lim; Seonhee,8,0,34,26
1657615038279,MATH 10B,A02,083208,Lim; Seonhee,9,0,35,26
1657615038279,MATH 10B,A03,093472,Lim; Seonhee,7,0,34,27
1657615038279,MATH 10B,B01,083739,Sinha; Shubham,12,0,30,18
1657615044309,MATH 18,A01,083743,Cinel; Cameron Alexander,7,0,30,23
1657615044309,MATH 18,A02,083744,Cinel; Cameron Alexander,17,0,30,13
1657615044309,MATH 18,A03,083745,Cinel; Cameron Alexander,9,0,30,21
1657615044309,MATH 18,B01,083748,Rideout; David Porter,5,0,37,32
1657615044309,MATH 18,B02,083749,Rideout; David Porter,5,0,36,31
1657615044309,MATH 18,B03,083750,Rideout; David Porter,3,0,37,34
1657615044309,MATH 18,B04,083751,Rideout; David Porter,6,0,36,30
1657615044309,MATH 18,B05,093473,Rideout; David Porter,6,0,36,30
1657615044309,MATH 18,B06,093474,Rideout; David Porter,6,0,36,30
1657615050331,MATH 20A,A01,083754,Zheng; Zequn,14,0,40,26
1657615056358,MATH 20B,A01,083756,Briones; Jor-el Thomas Caparas,4,0,36,32
1657615056358,MATH 20B,A02,083757,Briones; Jor-el Thomas Caparas,1,0,36,35
1657615056358,MATH 20B,A03,093475,Briones; Jor-el Thomas Caparas,2,0,36,34
1657615062388,MATH 20C,A01,083760,Briones; Jor-el Thomas Caparas,1,0,35,34
1657615062388,MATH 20C,A02,083761,Briones; Jor-el Thomas Caparas,8,0,35,27
1657615062388,MATH 20C,A03,093476,Briones; Jor-el Thomas Caparas,0,1,36,36
1657615062388,MATH 20C,B01,083762,Bach; Quang Tran,1,0,30,29
1657615068418,MATH 20D,A01,083765,Tran; Brian Kha,5,0,30,25
1657615068418,MATH 20D,A02,083766,Tran; Brian Kha,5,0,30,25
1657615068418,MATH 20D,A03,083767,Tran; Brian Kha,5,0,30,25
1657615074451,MATH 20E,A01,083771,Ganguly; Soumya,9,0,32,23
1657615074451,MATH 20E,A02,083772,Ganguly; Soumya,6,0,32,26
1657615074451,MATH 20E,B01,083773,Ciotti; Benjamin,20,0,35,15
1657615074451,MATH 20E,B02,083774,Ciotti; Benjamin,18,0,35,17
1657615080473,MATH 103A,A01,083777,Greenfeld; Be'Eri,3,0,36,33
1657615080473,MATH 103A,A02,083778,Greenfeld; Be'Eri,5,0,36,31
1657615080473,MATH 103A,A03,093561,Greenfeld; Be'Eri,6,0,36,30
1657615080473,MATH 103A,B01,083779,Greenfeld; Be'Eri,7,0,36,29
1657615080473,MATH 103A,B02,083780,Greenfeld; Be'Eri,4,0,36,32
1657615080473,MATH 103A,B03,093562,Greenfeld; Be'Eri,3,0,36,33
1657615086500,MATH 105,A01,085443,Carter; Anne Toulson,15,0,35,20
1657615086500,MATH 105,A02,093477,Carter; Anne Toulson,20,0,35,15
1657615092523,MATH 109,A01,083213,Ganzberger; Geoffrey Michael,2,0,34,32
1657615092523,MATH 109,A02,083214,Ganzberger; Geoffrey Michael,4,0,34,30
1657615092523,MATH 109,A03,093478,Ganzberger; Geoffrey Michael,2,0,34,32
1657615092523,MATH 109,B01,083215,Ganzberger; Geoffrey Michael,1,0,32,31
1657615092523,MATH 109,B02,083216,Ganzberger; Geoffrey Michael,2,0,32,30
1657615092523,MATH 109,B03,093479,Ganzberger; Geoffrey Michael,8,0,32,24
1657615098547,MATH 142A,A01,083219,Chow; Bennett,7,0,32,25
1657615098547,MATH 142A,A02,083220,Chow; Bennett,10,0,32,22
1657615098547,MATH 142A,A03,093480,Chow; Bennett,9,0,32,23
1657615098547,MATH 142A,B03,093481,Chow; Bennett,8,0,32,24
1657615098547,MATH 142A,B04,093558,Chow; Bennett,13,0,32,19
1657615098547,MATH 142A,B05,093559,Chow; Bennett,6,0,32,26
1657615104584,MATH 193A,A01,083224,Rotar; Vladimir,8,0,34,26
1657615104584,MATH 193A,A02,083225,Rotar; Vladimir,9,0,34,25
1657615104584,MATH 193A,A03,083781,Rotar; Vladimir,5,0,34,29
1657615104584,MATH 193A,A04,083782,Rotar; Vladimir,10,0,34,24
1657615104584,MATH 193A,A05,093482,Rotar; Vladimir,10,0,34,24
1657615110606,MATH 197,001,091859,McAuley; Julian John,9999,0,9999,0
1657615110606,MATH 197,002,095566,Kedlaya; Kiran S.,9997,0,9999,2
1657615110606,MATH 197,003,095567,Xiao; Ming,9999,0,9999,0
1657615110606,MATH 197,004,095571,Perols; Johan Lars,9998,0,9999,1
1657615117669,COGS 9,A01,083615,Shannon; Kyle Michael,9,0,75,66
1657615123698,COGS 11,A01,083617,Boyle; Mary E. T.,23,0,48,25
1657615129722,COGS 13,A01,083071,Bastos; Amalia Pinkusfeld,11,0,71,60
1657615135754,COGS 14A,A01,092681,Semenuks; Arturs,5,1,100,95
1657615141781,COGS 14B,A01,083073,Cheng; Tzu-Han,6,0,63,57
1657615147802,COGS 17,A01,092677,Semenuks; Arturs,6,0,81,75
1657615153823,COGS 100,A01,083619,Allen; Michael Gordon,17,0,70,53
1657615159853,COGS 101A,A01,083621,Davis; Joshua Daniel,9,0,68,59
1657615165884,COGS 101B,A01,091572,Allen; Michael Gordon,12,0,65,53
1657615171912,COGS 101C,A01,083625,Delgado; Tania,17,0,35,18
1657615177934,COGS 107A,A01,083627,Boyle; Mary E. T.,13,0,60,47
1657615183959,COGS 118A,A01,083075,Gupta; Anjum,21,0,76,55
1657615189984,CSE 3,A50,083646,Miranda; Gregory Joseph,24,0,50,26
1657615196012,CSE 8A,A50,083650,Miranda; Gregory Joseph,17,1,56,39
1657615202034,CSE 11,A01,083080,Cao; Yingjun,6,15,40,34
1657615208061,CSE 12,A01,083652,Krause-Levy; Sophia Louisa,28,1,120,92
1657615214086,CSE 15L,A01,083654,Morris; Justin Loren,9,0,50,41
1657615214086,CSE 15L,A02,083655,Morris; Justin Loren,9,0,50,41
1657615220112,CSE 20,A01,083657,Tran; Khoa Dang,39,0,80,41
1657615226135,CSE 21,A01,095574,Bach; Quang Tran,22,0,48,26
1657615232158,CSE 30,A01,083084,Eldon; John,5,0,80,75
1657615232158,CSE 30,B01,095061,Bhaskar; Nishant,9,0,50,41
1657615238183,CSE 100,A01,083659,Cao; Yingjun,5,4,70,65
1657615244206,CSE 134B,A01,083661,Powell; Thomas Allan,22,0,100,78
1657615250230,CSE 140,A01,083663,Gungor; Onat,15,0,85,70
1657615256255,CSE 140L,A01,083088,Eldon; John,21,0,100,79
1657615262282,CSE 175,A01,083665,Kumar; Rakesh,3,0,25,22
1657615268304,CSE 190,A00,092507,Dubnov; Shlomo,8,0,20,12
1657615274327,ECE 45,A01,083139,Congero; Spencer William,6,0,75,69
1657615280355,ECE 65,A50,083695,Saad; Andrew S,12,0,30,18
1657615280355,ECE 65,A51,095125,Saad; Andrew S,24,0,26,2
1657615286385,ECE 109,A01,091882,Touri; Behrouz,19,0,70,51
1657615292418,ECE 180,A00,083140,Abi Samra; Nicholas Camill,1,0,30,29
1657615292418,ECE 180,B00,083141,Abi Samra; Nicholas Camill,0,0,30,30
1657615298445,MATH 10A,A01,083735,Patchell; Gregory David,2,0,30,28
1657615298445,MATH 10A,A02,083736,Patchell; Gregory David,20,0,30,10
1657615298445,MATH 10A,A03,083737,Patchell; Gregory David,16,0,30,14
1657615304476,MATH 10B,A01,083207,Lim; Seonhee,8,0,34,26
1657615304476,MATH 10B,A02,083208,Lim; Seonhee,9,0,35,26
1657615304476,MATH 10B,A03,093472,Lim; Seonhee,7,0,34,27
1657615304476,MATH 10B,B01,083739,Sinha; Shubham,12,0,30,18
1657615310503,MATH 18,A01,083743,Cinel; Cameron Alexander,7,0,30,23
1657615310503,MATH 18,A02,083744,Cinel; Cameron Alexander,17,0,30,13
1657615310503,MATH 18,A03,083745,Cinel; Cameron Alexander,9,0,30,21
1657615310503,MATH 18,B01,083748,Rideout; David Porter,5,0,37,32
1657615310503,MATH 18,B02,083749,Rideout; David Porter,5,0,36,31
1657615310503,MATH 18,B03,083750,Rideout; David Porter,3,0,37,34
1657615310503,MATH 18,B04,083751,Rideout; David Porter,6,0,36,30
1657615310503,MATH 18,B05,093473,Rideout; David Porter,6,0,36,30
1657615310503,MATH 18,B06,093474,Rideout; David Porter,6,0,36,30
1657615316540,MATH 20A,A01,083754,Zheng; Zequn,14,0,40,26
1657615322569,MATH 20B,A01,083756,Briones; Jor-el Thomas Caparas,4,0,36,32
1657615322569,MATH 20B,A02,083757,Briones; Jor-el Thomas Caparas,1,0,36,35
1657615322569,MATH 20B,A03,093475,Briones; Jor-el Thomas Caparas,2,0,36,34
1657615328596,MATH 20C,A01,083760,Briones; Jor-el Thomas Caparas,1,0,35,34
1657615328596,MATH 20C,A02,083761,Briones; Jor-el Thomas Caparas,8,0,35,27
1657615328596,MATH 20C,A03,093476,Briones; Jor-el Thomas Caparas,0,1,36,36
1657615328596,MATH 20C,B01,083762,Bach; Quang Tran,1,0,30,29
1657615334622,MATH 20D,A01,083765,Tran; Brian Kha,5,0,30,25
1657615334622,MATH 20D,A02,083766,Tran; Brian Kha,5,0,30,25
1657615334622,MATH 20D,A03,083767,Tran; Brian Kha,5,0,30,25
1657615340649,MATH 20E,A01,083771,Ganguly; Soumya,9,0,32,23
1657615340649,MATH 20E,A02,083772,Ganguly; Soumya,6,0,32,26
1657615340649,MATH 20E,B01,083773,Ciotti; Benjamin,20,0,35,15
1657615340649,MATH 20E,B02,083774,Ciotti; Benjamin,18,0,35,17
1657615346674,MATH 103A,A01,083777,Greenfeld; Be'Eri,3,0,36,33
1657615346674,MATH 103A,A02,083778,Greenfeld; Be'Eri,5,0,36,31
1657615346674,MATH 103A,A03,093561,Greenfeld; Be'Eri,6,0,36,30
1657615346674,MATH 103A,B01,083779,Greenfeld; Be'Eri,7,0,36,29
1657615346674,MATH 103A,B02,083780,Greenfeld; Be'Eri,4,0,36,32
1657615346674,MATH 103A,B03,093562,Greenfeld; Be'Eri,3,0,36,33
1657615352700,MATH 105,A01,085443,Carter; Anne Toulson,15,0,35,20
1657615352700,MATH 105,A02,093477,Carter; Anne Toulson,20,0,35,15
1657615358731,MATH 109,A01,083213,Ganzberger; Geoffrey Michael,2,0,34,32
1657615358731,MATH 109,A02,083214,Ganzberger; Geoffrey Michael,4,0,34,30
1657615358731,MATH 109,A03,093478,Ganzberger; Geoffrey Michael,2,0,34,32
1657615358731,MATH 109,B01,083215,Ganzberger; Geoffrey Michael,1,0,32,31
1657615358731,MATH 109,B02,083216,Ganzberger; Geoffrey Michael,2,0,32,30
1657615358731,MATH 109,B03,093479,Ganzberger; Geoffrey Michael,8,0,32,24
1657615364760,MATH 142A,A01,083219,Chow; Bennett,7,0,32,25
1657615364760,MATH 142A,A02,083220,Chow; Bennett,10,0,32,22
1657615364760,MATH 142A,A03,093480,Chow; Bennett,9,0,32,23
1657615364760,MATH 142A,B03,093481,Chow; Bennett,8,0,32,24
1657615364760,MATH 142A,B04,093558,Chow; Bennett,13,0,32,19
1657615364760,MATH 142A,B05,093559,Chow; Bennett,6,0,32,26
1657615370788,MATH 193A,A01,083224,Rotar; Vladimir,8,0,34,26
1657615370788,MATH 193A,A02,083225,Rotar; Vladimir,9,0,34,25
1657615370788,MATH 193A,A03,083781,Rotar; Vladimir,5,0,34,29
1657615370788,MATH 193A,A04,083782,Rotar; Vladimir,10,0,34,24
1657615370788,MATH 193A,A05,093482,Rotar; Vladimir,10,0,34,24
1657615376813,MATH 197,001,091859,McAuley; Julian John,9999,0,9999,0
1657615376813,MATH 197,002,095566,Kedlaya; Kiran S.,9997,0,9999,2
1657615376813,MATH 197,003,095567,Xiao; Ming,9999,0,9999,0
1657615376813,MATH 197,004,095571,Perols; Johan Lars,9998,0,9999,1
1657615383888,COGS 9,A01,083615,Shannon; Kyle Michael,9,0,75,66
1657615389916,COGS 11,A01,083617,Boyle; Mary E. T.,23,0,48,25
1657615395943,COGS 13,A01,083071,Bastos; Amalia Pinkusfeld,11,0,71,60
1657615401967,COGS 14A,A01,092681,Semenuks; Arturs,5,1,100,95
1657615407994,COGS 14B,A01,083073,Cheng; Tzu-Han,6,0,63,57
1657615414020,COGS 17,A01,092677,Semenuks; Arturs,6,0,81,75
1657615420045,COGS 100,A01,083619,Allen; Michael Gordon,17,0,70,53
1657615426071,COGS 101A,A01,083621,Davis; Joshua Daniel,9,0,68,59
1657615432096,COGS 101B,A01,091572,Allen; Michael Gordon,12,0,65,53
1657615438198,COGS 101C,A01,083625,Delgado; Tania,17,0,35,18
1657615444221,COGS 107A,A01,083627,Boyle; Mary E. T.,13,0,60,47
1657615450248,COGS 118A,A01,083075,Gupta; Anjum,21,0,76,55
1657615456273,CSE 3,A50,083646,Miranda; Gregory Joseph,24,0,50,26
1657615462295,CSE 8A,A50,083650,Miranda; Gregory Joseph,17,1,56,39
1657615468320,CSE 11,A01,083080,Cao; Yingjun,6,15,40,34
1657615474344,CSE 12,A01,083652,Krause-Levy; Sophia Louisa,28,1,120,92
1657615480379,CSE 15L,A01,083654,Morris; Justin Loren,9,0,50,41
1657615480379,CSE 15L,A02,083655,Morris; Justin Loren,9,0,50,41
1657615486407,CSE 20,A01,083657,Tran; Khoa Dang,39,0,80,41
1657615492435,CSE 21,A01,095574,Bach; Quang Tran,22,0,48,26
1657615498458,CSE 30,A01,083084,Eldon; John,6,0,80,74
1657615498458,CSE 30,B01,095061,Bhaskar; Nishant,9,0,50,41
1657615504483,CSE 100,A01,083659,Cao; Yingjun,5,4,70,65
1657615510509,CSE 134B,A01,083661,Powell; Thomas Allan,22,0,100,78
1657615516532,CSE 140,A01,083663,Gungor; Onat,15,0,85,70
1657615522553,CSE 140L,A01,083088,Eldon; John,21,0,100,79
1657615528580,CSE 175,A01,083665,Kumar; Rakesh,3,0,25,22
1657615534606,CSE 190,A00,092507,Dubnov; Shlomo,8,0,20,12
1657615540633,ECE 45,A01,083139,Congero; Spencer William,6,0,75,69
1657615546661,ECE 65,A50,083695,Saad; Andrew S,12,0,30,18
1657615546661,ECE 65,A51,095125,Saad; Andrew S,24,0,26,2
1657615552688,ECE 109,A01,091882,Touri; Behrouz,19,0,70,51
1657615558715,ECE 180,A00,083140,Abi Samra; Nicholas Camill,1,0,30,29
1657615558715,ECE 180,B00,083141,Abi Samra; Nicholas Camill,0,0,30,30
1657615564749,MATH 10A,A01,083735,Patchell; Gregory David,2,0,30,28
1657615564749,MATH 10A,A02,083736,Patchell; Gregory David,20,0,30,10
1657615564749,MATH 10A,A03,083737,Patchell; Gregory David,16,0,30,14
1657615570773,MATH 10B,A01,083207,Lim; Seonhee,8,0,34,26
1657615570773,MATH 10B,A02,083208,Lim; Seonhee,9,0,35,26
1657615570773,MATH 10B,A03,093472,Lim; Seonhee,7,0,34,27
1657615570773,MATH 10B,B01,083739,Sinha; Shubham,12,0,30,18
1657615576804,MATH 18,A01,083743,Cinel; Cameron Alexander,7,0,30,23
1657615576804,MATH 18,A02,083744,Cinel; Cameron Alexander,17,0,30,13
1657615576804,MATH 18,A03,083745,Cinel; Cameron Alexander,9,0,30,21
1657615576804,MATH 18,B01,083748,Rideout; David Porter,5,0,37,32
1657615576804,MATH 18,B02,083749,Rideout; David Porter,5,0,36,31
1657615576804,MATH 18,B03,083750,Rideout; David Porter,3,0,37,34
1657615576804,MATH 18,B04,083751,Rideout; David Porter,6,0,36,30
1657615576804,MATH 18,B05,093473,Rideout; David Porter,6,0,36,30
1657615576804,MATH 18,B06,093474,Rideout; David Porter,6,0,36,30
1657615582833,MATH 20A,A01,083754,Zheng; Zequn,14,0,40,26
1657615588858,MATH 20B,A01,083756,Briones; Jor-el Thomas Caparas,4,0,36,32
1657615588858,MATH 20B,A02,083757,Briones; Jor-el Thomas Caparas,1,0,36,35
1657615588858,MATH 20B,A03,093475,Briones; Jor-el Thomas Caparas,2,0,36,34
1657615594882,MATH 20C,A01,083760,Briones; Jor-el Thomas Caparas,1,0,35,34
1657615594882,MATH 20C,A02,083761,Briones; Jor-el Thomas Caparas,8,0,35,27
1657615594882,MATH 20C,A03,093476,Briones; Jor-el Thomas Caparas,0,1,36,36
1657615594882,MATH 20C,B01,083762,Bach; Quang Tran,1,0,30,29
1657615600907,MATH 20D,A01,083765,Tran; Brian Kha,5,0,30,25
1657615600907,MATH 20D,A02,083766,Tran; Brian Kha,5,0,30,25
1657615600907,MATH 20D,A03,083767,Tran; Brian Kha,5,0,30,25
1657615606931,MATH 20E,A01,083771,Ganguly; Soumya,9,0,32,23
1657615606931,MATH 20E,A02,083772,Ganguly; Soumya,6,0,32,26
1657615606931,MATH 20E,B01,083773,Ciotti; Benjamin,20,0,35,15
1657615606931,MATH 20E,B02,083774,Ciotti; Benjamin,18,0,35,17
1657615612962,MATH 103A,A01,083777,Greenfeld; Be'Eri,3,0,36,33
1657615612962,MATH 103A,A02,083778,Greenfeld; Be'Eri,5,0,36,31
1657615612962,MATH 103A,A03,093561,Greenfeld; Be'Eri,6,0,36,30
1657615612962,MATH 103A,B01,083779,Greenfeld; Be'Eri,7,0,36,29
1657615612962,MATH 103A,B02,083780,Greenfeld; Be'Eri,4,0,36,32
1657615612962,MATH 103A,B03,093562,Greenfeld; Be'Eri,3,0,36,33
1657615618987,MATH 105,A01,085443,Carter; Anne Toulson,15,0,35,20
1657615618987,MATH 105,A02,093477,Carter; Anne Toulson,20,0,35,15
1657615625011,MATH 109,A01,083213,Ganzberger; Geoffrey Michael,2,0,34,32
1657615625011,MATH 109,A02,083214,Ganzberger; Geoffrey Michael,4,0,34,30
1657615625011,MATH 109,A03,093478,Ganzberger; Geoffrey Michael,2,0,34,32
1657615625011,MATH 109,B01,083215,Ganzberger; Geoffrey Michael,1,0,32,31
1657615625011,MATH 109,B02,083216,Ganzberger; Geoffrey Michael,2,0,32,30
1657615625011,MATH 109,B03,093479,Ganzberger; Geoffrey Michael,8,0,32,24
1657615631041,MATH 142A,A01,083219,Chow; Bennett,7,0,32,25
1657615631041,MATH 142A,A02,083220,Chow; Bennett,10,0,32,22
1657615631041,MATH 142A,A03,093480,Chow; Bennett,9,0,32,23
1657615631041,MATH 142A,B03,093481,Chow; Bennett,8,0,32,24
1657615631041,MATH 142A,B04,093558,Chow; Bennett,13,0,32,19
1657615631041,MATH 142A,B05,093559,Chow; Bennett,6,0,32,26
1657615637065,MATH 193A,A01,083224,Rotar; Vladimir,8,0,34,26
1657615637065,MATH 193A,A02,083225,Rotar; Vladimir,9,0,34,25
1657615637065,MATH 193A,A03,083781,Rotar; Vladimir,5,0,34,29
1657615637065,MATH 193A,A04,083782,Rotar; Vladimir,10,0,34,24
1657615637065,MATH 193A,A05,093482,Rotar; Vladimir,10,0,34,24
1657615643090,MATH 197,001,091859,McAuley; Julian John,9999,0,9999,0
1657615643090,MATH 197,002,095566,Kedlaya; Kiran S.,9997,0,9999,2
1657615643090,MATH 197,003,095567,Xiao; Ming,9999,0,9999,0
1657615643090,MATH 197,004,095571,Perols; Johan Lars,9998,0,9999,1
1657615650148,COGS 9,A01,083615,Shannon; Kyle Michael,9,0,75,66
1657615656170,COGS 11,A01,083617,Boyle; Mary E. T.,23,0,48,25
1657615662195,COGS 13,A01,083071,Bastos; Amalia Pinkusfeld,11,0,71,60
1657615668223,COGS 14A,A01,092681,Semenuks; Arturs,5,1,100,95
1657615674249,COGS 14B,A01,083073,Cheng; Tzu-Han,6,0,63,57
1657615680272,COGS 17,A01,092677,Semenuks; Arturs,6,0,81,75
1657615686299,COGS 100,A01,083619,Allen; Michael Gordon,17,0,70,53
1657615692325,COGS 101A,A01,083621,Davis; Joshua Daniel,9,0,68,59
1657615698351,COGS 101B,A01,091572,Allen; Michael Gordon,12,0,65,53
1657615704374,COGS 101C,A01,083625,Delgado; Tania,17,0,35,18
1657615710398,COGS 107A,A01,083627,Boyle; Mary E. T.,13,0,60,47
1657615716421,COGS 118A,A01,083075,Gupta; Anjum,21,0,76,55
1657615722443,CSE 3,A50,083646,Miranda; Gregory Joseph,24,0,50,26
1657615728467,CSE 8A,A50,083650,Miranda; Gregory Joseph,17,1,56,39
1657615734489,CSE 11,A01,083080,Cao; Yingjun,6,15,40,34
1657615740512,CSE 12,A01,083652,Krause-Levy; Sophia Louisa,28,1,120,92
1657615746534,CSE 15L,A01,083654,Morris; Justin Loren,9,0,50,41
1657615746534,CSE 15L,A02,083655,Morris; Justin Loren,9,0,50,41
1657615752556,CSE 20,A01,083657,Tran; Khoa Dang,39,0,80,41
1657615758580,CSE 21,A01,095574,Bach; Quang Tran,22,0,48,26
1657615764607,CSE 30,A01,083084,Eldon; John,6,0,80,74
1657615764607,CSE 30,B01,095061,Bhaskar; Nishant,9,0,50,41
1657615770635,CSE 100,A01,083659,Cao; Yingjun,5,4,70,65
1657615776664,CSE 134B,A01,083661,Powell; Thomas Allan,22,0,100,78
1657615782706,CSE 140,A01,083663,Gungor; Onat,15,0,85,70
1657615788730,CSE 140L,A01,083088,Eldon; John,21,0,100,79
1657615794754,CSE 175,A01,083665,Kumar; Rakesh,3,0,25,22
1657615800780,CSE 190,A00,092507,Dubnov; Shlomo,8,0,20,12
1657615806812,ECE 45,A01,083139,Congero; Spencer William,6,0,75,69
1657615812836,ECE 65,A50,083695,Saad; Andrew S,12,0,30,18
1657615812836,ECE 65,A51,095125,Saad; Andrew S,24,0,26,2
1657615818864,ECE 109,A01,091882,Touri; Behrouz,19,0,70,51
1657615824887,ECE 180,A00,083140,Abi Samra; Nicholas Camill,1,0,30,29
1657615824887,ECE 180,B00,083141,Abi Samra; Nicholas Camill,0,0,30,30
1657615830916,MATH 10A,A01,083735,Patchell; Gregory David,2,0,30,28
1657615830916,MATH 10A,A02,083736,Patchell; Gregory David,20,0,30,10
1657615830916,MATH 10A,A03,083737,Patchell; Gregory David,16,0,30,14
1657615836946,MATH 10B,A01,083207,Lim; Seonhee,8,0,34,26
1657615836946,MATH 10B,A02,083208,Lim; Seonhee,9,0,35,26
1657615836946,MATH 10B,A03,093472,Lim; Seonhee,7,0,34,27
1657615836946,MATH 10B,B01,083739,Sinha; Shubham,12,0,30,18
1657615842974,MATH 18,A01,083743,Cinel; Cameron Alexander,7,0,30,23
1657615842974,MATH 18,A02,083744,Cinel; Cameron Alexander,17,0,30,13
1657615842974,MATH 18,A03,083745,Cinel; Cameron Alexander,9,0,30,21
1657615842974,MATH 18,B01,083748,Rideout; David Porter,5,0,37,32
1657615842974,MATH 18,B02,083749,Rideout; David Porter,5,0,36,31
1657615842974,MATH 18,B03,083750,Rideout; David Porter,3,0,37,34
1657615842974,MATH 18,B04,083751,Rideout; David Porter,6,0,36,30
1657615842974,MATH 18,B05,093473,Rideout; David Porter,6,0,36,30
1657615842974,MATH 18,B06,093474,Rideout; David Porter,6,0,36,30
1657615849002,MATH 20A,A01,083754,Zheng; Zequn,14,0,40,26
1657615855030,MATH 20B,A01,083756,Briones; Jor-el Thomas Caparas,4,0,36,32
1657615855030,MATH 20B,A02,083757,Briones; Jor-el Thomas Caparas,1,0,36,35
1657615855030,MATH 20B,A03,093475,Briones; Jor-el Thomas Caparas,2,0,36,34
1657615861061,MATH 20C,A01,083760,Briones; Jor-el Thomas Caparas,1,0,35,34
1657615861061,MATH 20C,A02,083761,Briones; Jor-el Thomas Caparas,8,0,35,27
1657615861061,MATH 20C,A03,093476,Briones; Jor-el Thomas Caparas,0,1,36,36
1657615861061,MATH 20C,B01,083762,Bach; Quang Tran,1,0,30,29
1657615867104,MATH 20D,A01,083765,Tran; Brian Kha,5,0,30,25
1657615867104,MATH 20D,A02,083766,Tran; Brian Kha,5,0,30,25
1657615867104,MATH 20D,A03,083767,Tran; Brian Kha,5,0,30,25
1657615873144,MATH 20E,A01,083771,Ganguly; Soumya,9,0,32,23
1657615873144,MATH 20E,A02,083772,Ganguly; Soumya,6,0,32,26
1657615873144,MATH 20E,B01,083773,Ciotti; Benjamin,20,0,35,15
1657615873144,MATH 20E,B02,083774,Ciotti; Benjamin,18,0,35,17
1657615879173,MATH 103A,A01,083777,Greenfeld; Be'Eri,3,0,36,33
1657615879173,MATH 103A,A02,083778,Greenfeld; Be'Eri,5,0,36,31
1657615879173,MATH 103A,A03,093561,Greenfeld; Be'Eri,6,0,36,30
1657615879173,MATH 103A,B01,083779,Greenfeld; Be'Eri,7,0,36,29
1657615879173,MATH 103A,B02,083780,Greenfeld; Be'Eri,4,0,36,32
1657615879173,MATH 103A,B03,093562,Greenfeld; Be'Eri,3,0,36,33
1657615885197,MATH 105,A01,085443,Carter; Anne Toulson,15,0,35,20
1657615885197,MATH 105,A02,093477,Carter; Anne Toulson,20,0,35,15
1657615891236,MATH 109,A01,083213,Ganzberger; Geoffrey Michael,2,0,34,32
1657615891236,MATH 109,A02,083214,Ganzberger; Geoffrey Michael,4,0,34,30
1657615891236,MATH 109,A03,093478,Ganzberger; Geoffrey Michael,2,0,34,32
1657615891236,MATH 109,B01,083215,Ganzberger; Geoffrey Michael,1,0,32,31
1657615891236,MATH 109,B02,083216,Ganzberger; Geoffrey Michael,2,0,32,30
1657615891236,MATH 109,B03,093479,Ganzberger; Geoffrey Michael,8,0,32,24
1657615897262,MATH 142A,A01,083219,Chow; Bennett,7,0,32,25
1657615897262,MATH 142A,A02,083220,Chow; Bennett,10,0,32,22
1657615897262,MATH 142A,A03,093480,Chow; Bennett,9,0,32,23
1657615897262,MATH 142A,B03,093481,Chow; Bennett,8,0,32,24
1657615897262,MATH 142A,B04,093558,Chow; Bennett,13,0,32,19
1657615897262,MATH 142A,B05,093559,Chow; Bennett,6,0,32,26
1657615903288,MATH 193A,A01,083224,Rotar; Vladimir,8,0,34,26
1657615903288,MATH 193A,A02,083225,Rotar; Vladimir,9,0,34,25
1657615903288,MATH 193A,A03,083781,Rotar; Vladimir,5,0,34,29
1657615903288,MATH 193A,A04,083782,Rotar; Vladimir,10,0,34,24
1657615903288,MATH 193A,A05,093482,Rotar; Vladimir,10,0,34,24
1657615909317,MATH 197,001,091859,McAuley; Julian John,9999,0,9999,0
1657615909317,MATH 197,002,095566,Kedlaya; Kiran S.,9997,0,9999,2
1657615909317,MATH 197,003,095567,Xiao; Ming,9999,0,9999,0
1657615909317,MATH 197,004,095571,Perols; Johan Lars,9998,0,9999,1
1657615916383,COGS 9,A01,083615,Shannon; Kyle Michael,9,0,75,66
1657615922406,COGS 11,A01,083617,Boyle; Mary E. T.,23,0,48,25
1657615928430,COGS 13,A01,083071,Bastos; Amalia Pinkusfeld,11,0,71,60
1657615934454,COGS 14A,A01,092681,Semenuks; Arturs,5,1,100,95
1657615940478,COGS 14B,A01,083073,Cheng; Tzu-Han,6,0,63,57
1657615946502,COGS 17,A01,092677,Semenuks; Arturs,6,0,81,75
1657615952525,COGS 100,A01,083619,Allen; Michael Gordon,17,0,70,53
1657615958553,COGS 101A,A01,083621,Davis; Joshua Daniel,9,0,68,59
1657615964580,COGS 101B,A01,091572,Allen; Michael Gordon,12,0,65,53
1657615970607,COGS 101C,A01,083625,Delgado; Tania,17,0,35,18
1657615976633,COGS 107A,A01,083627,Boyle; Mary E. T.,13,0,60,47
1657615982661,COGS 118A,A01,083075,Gupta; Anjum,21,0,76,55
1657615988693,CSE 3,A50,083646,Miranda; Gregory Joseph,24,0,50,26
1657615994720,CSE 8A,A50,083650,Miranda; Gregory Joseph,17,1,56,39
1657616000746,CSE 11,A01,083080,Cao; Yingjun,6,15,40,34
1657616006768,CSE 12,A01,083652,Krause-Levy; Sophia Louisa,28,1,120,92
1657616012794,CSE 15L,A01,083654,Morris; Justin Loren,9,0,50,41
1657616012794,CSE 15L,A02,083655,Morris; Justin Loren,9,0,50,41
1657616018822,CSE 20,A01,083657,Tran; Khoa Dang,39,0,80,41
1657616024844,CSE 21,A01,095574,Bach; Quang Tran,22,0,48,26
1657616030869,CSE 30,A01,083084,Eldon; John,6,0,80,74
1657616030869,CSE 30,B01,095061,Bhaskar; Nishant,9,0,50,41
1657616036992,CSE 100,A01,083659,Cao; Yingjun,5,4,70,65
1657616043016,CSE 134B,A01,083661,Powell; Thomas Allan,22,0,100,78
1657616049054,CSE 140,A01,083663,Gungor; Onat,15,0,85,70
1657616055078,CSE 140L,A01,083088,Eldon; John,21,0,100,79
1657616061109,CSE 175,A01,083665,Kumar; Rakesh,3,0,25,22
1657616067132,CSE 190,A00,092507,Dubnov; Shlomo,8,0,20,12
1657616073160,ECE 45,A01,083139,Congero; Spencer William,6,0,75,69
1657616079198,ECE 65,A50,083695,Saad; Andrew S,12,0,30,18
1657616079198,ECE 65,A51,095125,Saad; Andrew S,24,0,26,2
1657616085222,ECE 109,A01,091882,Touri; Behrouz,19,0,70,51
1657616091245,ECE 180,A00,083140,Abi Samra; Nicholas Camill,1,0,30,29
1657616091245,ECE 180,B00,083141,Abi Samra; Nicholas Camill,0,0,30,30
1657616097269,MATH 10A,A01,083735,Patchell; Gregory David,2,0,30,28
1657616097269,MATH 10A,A02,083736,Patchell; Gregory David,20,0,30,10
1657616097269,MATH 10A,A03,083737,Patchell; Gregory David,16,0,30,14
1657616103303,MATH 10B,A01,083207,Lim; Seonhee,8,0,34,26
1657616103303,MATH 10B,A02,083208,Lim; Seonhee,9,0,35,26
1657616103303,MATH 10B,A03,093472,Lim; Seonhee,7,0,34,27
1657616103303,MATH 10B,B01,083739,Sinha; Shubham,12,0,30,18
1657616109331,MATH 18,A01,083743,Cinel; Cameron Alexander,7,0,30,23
1657616109331,MATH 18,A02,083744,Cinel; Cameron Alexander,17,0,30,13
1657616109331,MATH 18,A03,083745,Cinel; Cameron Alexander,9,0,30,21
1657616109331,MATH 18,B01,083748,Rideout; David Porter,5,0,37,32
1657616109331,MATH 18,B02,083749,Rideout; David Porter,5,0,36,31
1657616109331,MATH 18,B03,083750,Rideout; David Porter,3,0,37,34
1657616109331,MATH 18,B04,083751,Rideout; David Porter,6,0,36,30
1657616109331,MATH 18,B05,093473,Rideout; David Porter,6,0,36,30
1657616109331,MATH 18,B06,093474,Rideout; David Porter,6,0,36,30
1657616115354,MATH 20A,A01,083754,Zheng; Zequn,14,0,40,26
1657616121383,MATH 20B,A01,083756,Briones; Jor-el Thomas Caparas,4,0,36,32
1657616121383,MATH 20B,A02,083757,Briones; Jor-el Thomas Caparas,1,0,36,35
1657616121383,MATH 20B,A03,093475,Briones; Jor-el Thomas Caparas,2,0,36,34
1657616127414,MATH 20C,A01,083760,Briones; Jor-el Thomas Caparas,1,0,35,34
1657616127414,MATH 20C,A02,083761,Briones; Jor-el Thomas Caparas,8,0,35,27
1657616127414,MATH 20C,A03,093476,Briones; Jor-el Thomas Caparas,0,1,36,36
1657616127414,MATH 20C,B01,083762,Bach; Quang Tran,1,0,30,29
1657616133445,MATH 20D,A01,083765,Tran; Brian Kha,5,0,30,25
1657616133445,MATH 20D,A02,083766,Tran; Brian Kha,5,0,30,25
1657616133445,MATH 20D,A03,083767,Tran; Brian Kha,5,0,30,25
1657616139478,MATH 20E,A01,083771,Ganguly; Soumya,9,0,32,23
1657616139478,MATH 20E,A02,083772,Ganguly; Soumya,6,0,32,26
1657616139478,MATH 20E,B01,083773,Ciotti; Benjamin,20,0,35,15
1657616139478,MATH 20E,B02,083774,Ciotti; Benjamin,18,0,35,17
1657616145504,MATH 103A,A01,083777,Greenfeld; Be'Eri,3,0,36,33
1657616145504,MATH 103A,A02,083778,Greenfeld; Be'Eri,5,0,36,31
1657616145504,MATH 103A,A03,093561,Greenfeld; Be'Eri,6,0,36,30
1657616145504,MATH 103A,B01,083779,Greenfeld; Be'Eri,7,0,36,29
1657616145504,MATH 103A,B02,083780,Greenfeld; Be'Eri,4,0,36,32
1657616145504,MATH 103A,B03,093562,Greenfeld; Be'Eri,3,0,36,33
1657616151527,MATH 105,A01,085443,Carter; Anne Toulson,15,0,35,20
1657616151527,MATH 105,A02,093477,Carter; Anne Toulson,20,0,35,15
1657616157555,MATH 109,A01,083213,Ganzberger; Geoffrey Michael,2,0,34,32
1657616157555,MATH 109,A02,083214,Ganzberger; Geoffrey Michael,4,0,34,30
1657616157555,MATH 109,A03,093478,Ganzberger; Geoffrey Michael,2,0,34,32
1657616157555,MATH 109,B01,083215,Ganzberger; Geoffrey Michael,1,0,32,31
1657616157555,MATH 109,B02,083216,Ganzberger; Geoffrey Michael,2,0,32,30
1657616157555,MATH 109,B03,093479,Ganzberger; Geoffrey Michael,8,0,32,24
1657616163589,MATH 142A,A01,083219,Chow; Bennett,7,0,32,25
1657616163589,MATH 142A,A02,083220,Chow; Bennett,10,0,32,22
1657616163589,MATH 142A,A03,093480,Chow; Bennett,9,0,32,23
1657616163589,MATH 142A,B03,093481,Chow; Bennett,8,0,32,24
1657616163589,MATH 142A,B04,093558,Chow; Bennett,13,0,32,19
1657616163589,MATH 142A,B05,093559,Chow; Bennett,6,0,32,26
1657616169613,MATH 193A,A01,083224,Rotar; Vladimir,8,0,34,26
1657616169613,MATH 193A,A02,083225,Rotar; Vladimir,9,0,34,25
1657616169613,MATH 193A,A03,083781,Rotar; Vladimir,5,0,34,29
1657616169613,MATH 193A,A04,083782,Rotar; Vladimir,10,0,34,24
1657616169613,MATH 193A,A05,093482,Rotar; Vladimir,10,0,34,24
1657616175639,MATH 197,001,091859,McAuley; Julian John,9999,0,9999,0
1657616175639,MATH 197,002,095566,Kedlaya; Kiran S.,9997,0,9999,2
1657616175639,MATH 197,003,095567,Xiao; Ming,9999,0,9999,0
1657616175639,MATH 197,004,095571,Perols; Johan Lars,9998,0,9999,1
1657616182696,COGS 9,A01,083615,Shannon; Kyle Michael,9,0,75,66
1657616188721,COGS 11,A01,083617,Boyle; Mary E. T.,23,0,48,25
1657616194744,COGS 13,A01,083071,Bastos; Amalia Pinkusfeld,11,0,71,60
1657616200772,COGS 14A,A01,092681,Semenuks; Arturs,5,1,100,95
1657616206801,COGS 14B,A01,083073,Cheng; Tzu-Han,6,0,63,57
1657616212831,COGS 17,A01,092677,Semenuks; Arturs,6,0,81,75
1657616218859,COGS 100,A01,083619,Allen; Michael Gordon,17,0,70,53
1657616224889,COGS 101A,A01,083621,Davis; Joshua Daniel,9,0,68,59
1657616230912,COGS 101B,A01,091572,Allen; Michael Gordon,12,0,65,53
1657616236936,COGS 101C,A01,083625,Delgado; Tania,17,0,35,18
1657616242963,COGS 107A,A01,083627,Boyle; Mary E. T.,13,0,60,47
1657616248989,COGS 118A,A01,083075,Gupta; Anjum,21,0,76,55
1657616255027,CSE 3,A50,083646,Miranda; Gregory Joseph,24,0,50,26
1657616261057,CSE 8A,A50,083650,Miranda; Gregory Joseph,17,1,56,39
1657616267085,CSE 11,A01,083080,Cao; Yingjun,6,15,40,34
1657616273118,CSE 12,A01,083652,Krause-Levy; Sophia Louisa,28,1,120,92
1657616279141,CSE 15L,A01,083654,Morris; Justin Loren,9,0,50,41
1657616279141,CSE 15L,A02,083655,Morris; Justin Loren,9,0,50,41
1657616285166,CSE 20,A01,083657,Tran; Khoa Dang,39,0,80,41
1657616291191,CSE 21,A01,095574,Bach; Quang Tran,22,0,48,26
1657616297220,CSE 30,A01,083084,Eldon; John,6,0,80,74
1657616297220,CSE 30,B01,095061,Bhaskar; Nishant,9,0,50,41
1657616303243,CSE 100,A01,083659,Cao; Yingjun,5,4,70,65
1657616309268,CSE 134B,A01,083661,Powell; Thomas Allan,22,0,100,78
1657616315296,CSE 140,A01,083663,Gungor; Onat,15,0,85,70
1657616321322,CSE 140L,A01,083088,Eldon; John,21,0,100,79
1657616327347,CSE 175,A01,083665,Kumar; Rakesh,3,0,25,22
1657616333376,CSE 190,A00,092507,Dubnov; Shlomo,8,0,20,12
1657616339407,ECE 45,A01,083139,Congero; Spencer William,6,0,75,69
1657616345433,ECE 65,A50,083695,Saad; Andrew S,12,0,30,18
1657616345433,ECE 65,A51,095125,Saad; Andrew S,24,0,26,2
1657616351456,ECE 109,A01,091882,Touri; Behrouz,19,0,70,51
1657616357484,ECE 180,A00,083140,Abi Samra; Nicholas Camill,1,0,30,29
1657616357484,ECE 180,B00,083141,Abi Samra; Nicholas Camill,0,0,30,30
1657616363509,MATH 10A,A01,083735,Patchell; Gregory David,2,0,30,28
1657616363509,MATH 10A,A02,083736,Patchell; Gregory David,20,0,30,10
1657616363509,MATH 10A,A03,083737,Patchell; Gregory David,16,0,30,14
1657616369533,MATH 10B,A01,083207,Lim; Seonhee,8,0,34,26
1657616369533,MATH 10B,A02,083208,Lim; Seonhee,9,0,35,26
1657616369533,MATH 10B,A03,093472,Lim; Seonhee,7,0,34,27
1657616369533,MATH 10B,B01,083739,Sinha; Shubham,12,0,30,18
1657616375567,MATH 18,A01,083743,Cinel; Cameron Alexander,7,0,30,23
1657616375567,MATH 18,A02,083744,Cinel; Cameron Alexander,17,0,30,13
1657616375567,MATH 18,A03,083745,Cinel; Cameron Alexander,9,0,30,21
1657616375567,MATH 18,B01,083748,Rideout; David Porter,5,0,37,32
1657616375567,MATH 18,B02,083749,Rideout; David Porter,5,0,36,31
1657616375567,MATH 18,B03,083750,Rideout; David Porter,3,0,37,34
1657616375567,MATH 18,B04,083751,Rideout; David Porter,6,0,36,30
1657616375567,MATH 18,B05,093473,Rideout; David Porter,6,0,36,30
1657616375567,MATH 18,B06,093474,Rideout; David Porter,6,0,36,30
1657616381593,MATH 20A,A01,083754,Zheng; Zequn,14,0,40,26
1657616387617,MATH 20B,A01,083756,Briones; Jor-el Thomas Caparas,4,0,36,32
1657616387617,MATH 20B,A02,083757,Briones; Jor-el Thomas Caparas,1,0,36,35
1657616387617,MATH 20B,A03,093475,Briones; Jor-el Thomas Caparas,2,0,36,34
1657616393639,MATH 20C,A01,083760,Briones; Jor-el Thomas Caparas,1,0,35,34
1657616393639,MATH 20C,A02,083761,Briones; Jor-el Thomas Caparas,8,0,35,27
1657616393639,MATH 20C,A03,093476,Briones; Jor-el Thomas Caparas,0,1,36,36
1657616393639,MATH 20C,B01,083762,Bach; Quang Tran,1,0,30,29
1657616399671,MATH 20D,A01,083765,Tran; Brian Kha,5,0,30,25
1657616399671,MATH 20D,A02,083766,Tran; Brian Kha,5,0,30,25
1657616399671,MATH 20D,A03,083767,Tran; Brian Kha,5,0,30,25
1657616405709,MATH 20E,A01,083771,Ganguly; Soumya,9,0,32,23
1657616405709,MATH 20E,A02,083772,Ganguly; Soumya,6,0,32,26
1657616405709,MATH 20E,B01,083773,Ciotti; Benjamin,20,0,35,15
1657616405709,MATH 20E,B02,083774,Ciotti; Benjamin,18,0,35,17
1657616411750,MATH 103A,A01,083777,Greenfeld; Be'Eri,3,0,36,33
1657616411750,MATH 103A,A02,083778,Greenfeld; Be'Eri,5,0,36,31
1657616411750,MATH 103A,A03,093561,Greenfeld; Be'Eri,6,0,36,30
1657616411750,MATH 103A,B01,083779,Greenfeld; Be'Eri,7,0,36,29
1657616411750,MATH 103A,B02,083780,Greenfeld; Be'Eri,4,0,36,32
1657616411750,MATH 103A,B03,093562,Greenfeld; Be'Eri,3,0,36,33
1657616417787,MATH 105,A01,085443,Carter; Anne Toulson,15,0,35,20
1657616417787,MATH 105,A02,093477,Carter; Anne Toulson,20,0,35,15
1657616423815,MATH 109,A01,083213,Ganzberger; Geoffrey Michael,2,0,34,32
1657616423815,MATH 109,A02,083214,Ganzberger; Geoffrey Michael,4,0,34,30
1657616423815,MATH 109,A03,093478,Ganzberger; Geoffrey Michael,2,0,34,32
1657616423815,MATH 109,B01,083215,Ganzberger; Geoffrey Michael,1,0,32,31
1657616423815,MATH 109,B02,083216,Ganzberger; Geoffrey Michael,2,0,32,30
1657616423815,MATH 109,B03,093479,Ganzberger; Geoffrey Michael,8,0,32,24
1657616429839,MATH 142A,A01,083219,Chow; Bennett,7,0,32,25
1657616429839,MATH 142A,A02,083220,Chow; Bennett,10,0,32,22
1657616429839,MATH 142A,A03,093480,Chow; Bennett,9,0,32,23
1657616429839,MATH 142A,B03,093481,Chow; Bennett,8,0,32,24
1657616429839,MATH 142A,B04,093558,Chow; Bennett,13,0,32,19
1657616429839,MATH 142A,B05,093559,Chow; Bennett,6,0,32,26
1657616435863,MATH 193A,A01,083224,Rotar; Vladimir,8,0,34,26
1657616435863,MATH 193A,A02,083225,Rotar; Vladimir,9,0,34,25
1657616435863,MATH 193A,A03,083781,Rotar; Vladimir,5,0,34,29
1657616435863,MATH 193A,A04,083782,Rotar; Vladimir,10,0,34,24
1657616435863,MATH 193A,A05,093482,Rotar; Vladimir,10,0,34,24
1657616441890,MATH 197,001,091859,McAuley; Julian John,9999,0,9999,0
1657616441890,MATH 197,002,095566,Kedlaya; Kiran S.,9997,0,9999,2
1657616441890,MATH 197,003,095567,Xiao; Ming,9999,0,9999,0
1657616441890,MATH 197,004,095571,Perols; Johan Lars,9998,0,9999,1
1657616448948,COGS 9,A01,083615,Shannon; Kyle Michael,9,0,75,66
1657616454976,COGS 11,A01,083617,Boyle; Mary E. T.,23,0,48,25
1657616460999,COGS 13,A01,083071,Bastos; Amalia Pinkusfeld,11,0,71,60
1657616467027,COGS 14A,A01,092681,Semenuks; Arturs,5,1,100,95
1657616473057,COGS 14B,A01,083073,Cheng; Tzu-Han,6,0,63,57
1657616479091,COGS 17,A01,092677,Semenuks; Arturs,6,0,81,75
1657616485119,COGS 100,A01,083619,Allen; Michael Gordon,17,0,70,53
1657616491151,COGS 101A,A01,083621,Davis; Joshua Daniel,9,0,68,59
1657616497177,COGS 101B,A01,091572,Allen; Michael Gordon,12,0,65,53
1657616503203,COGS 101C,A01,083625,Delgado; Tania,17,0,35,18
1657616509233,COGS 107A,A01,083627,Boyle; Mary E. T.,13,0,60,47
1657616515258,COGS 118A,A01,083075,Gupta; Anjum,21,0,76,55
1657616521281,CSE 3,A50,083646,Miranda; Gregory Joseph,24,0,50,26
1657616527311,CSE 8A,A50,083650,Miranda; Gregory Joseph,17,1,56,39
1657616533336,CSE 11,A01,083080,Cao; Yingjun,6,15,40,34
1657616539366,CSE 12,A01,083652,Krause-Levy; Sophia Louisa,28,1,120,92
1657616545389,CSE 15L,A01,083654,Morris; Justin Loren,9,0,50,41
1657616545389,CSE 15L,A02,083655,Morris; Justin Loren,9,0,50,41
1657616551413,CSE 20,A01,083657,Tran; Khoa Dang,39,0,80,41
1657616557437,CSE 21,A01,095574,Bach; Quang Tran,22,0,48,26
1657616563469,CSE 30,A01,083084,Eldon; John,6,0,80,74
1657616563469,CSE 30,B01,095061,Bhaskar; Nishant,9,0,50,41
1657616569500,CSE 100,A01,083659,Cao; Yingjun,5,4,70,65
1657616575523,CSE 134B,A01,083661,Powell; Thomas Allan,22,0,100,78
1657616581547,CSE 140,A01,083663,Gungor; Onat,15,0,85,70
1657616587572,CSE 140L,A01,083088,Eldon; John,21,0,100,79
1657616593605,CSE 175,A01,083665,Kumar; Rakesh,3,0,25,22
1657616599629,CSE 190,A00,092507,Dubnov; Shlomo,8,0,20,12
1657616605664,ECE 45,A01,083139,Congero; Spencer William,6,0,75,69
1657616611694,ECE 65,A50,083695,Saad; Andrew S,12,0,30,18
1657616611694,ECE 65,A51,095125,Saad; Andrew S,24,0,26,2
1657616617721,ECE 109,A01,091882,Touri; Behrouz,19,0,70,51
1657616623743,ECE 180,A00,083140,Abi Samra; Nicholas Camill,1,0,30,29
1657616623743,ECE 180,B00,083141,Abi Samra; Nicholas Camill,0,0,30,30
1657616629774,MATH 10A,A01,083735,Patchell; Gregory David,2,0,30,28
1657616629774,MATH 10A,A02,083736,Patchell; Gregory David,20,0,30,10
1657616629774,MATH 10A,A03,083737,Patchell; Gregory David,16,0,30,14
1657616635875,MATH 10B,A01,083207,Lim; Seonhee,8,0,34,26
1657616635875,MATH 10B,A02,083208,Lim; Seonhee,9,0,35,26
1657616635875,MATH 10B,A03,093472,Lim; Seonhee,7,0,34,27
1657616635875,MATH 10B,B01,083739,Sinha; Shubham,12,0,30,18
1657616641909,MATH 18,A01,083743,Cinel; Cameron Alexander,7,0,30,23
1657616641909,MATH 18,A02,083744,Cinel; Cameron Alexander,17,0,30,13
1657616641909,MATH 18,A03,083745,Cinel; Cameron Alexander,9,0,30,21
1657616641909,MATH 18,B01,083748,Rideout; David Porter,5,0,37,32
1657616641909,MATH 18,B02,083749,Rideout; David Porter,5,0,36,31
1657616641909,MATH 18,B03,083750,Rideout; David Porter,3,0,37,34
1657616641909,MATH 18,B04,083751,Rideout; David Porter,6,0,36,30
1657616641909,MATH 18,B05,093473,Rideout; David Porter,6,0,36,30
1657616641909,MATH 18,B06,093474,Rideout; David Porter,6,0,36,30
1657616647935,MATH 20A,A01,083754,Zheng; Zequn,14,0,40,26
1657616653967,MATH 20B,A01,083756,Briones; Jor-el Thomas Caparas,4,0,36,32
1657616653967,MATH 20B,A02,083757,Briones; Jor-el Thomas Caparas,1,0,36,35
1657616653967,MATH 20B,A03,093475,Briones; Jor-el Thomas Caparas,2,0,36,34
1657616659993,MATH 20C,A01,083760,Briones; Jor-el Thomas Caparas,1,0,35,34
1657616659993,MATH 20C,A02,083761,Briones; Jor-el Thomas Caparas,8,0,35,27
1657616659993,MATH 20C,A03,093476,Briones; Jor-el Thomas Caparas,0,1,36,36
1657616659993,MATH 20C,B01,083762,Bach; Quang Tran,1,0,30,29
1657616666023,MATH 20D,A01,083765,Tran; Brian Kha,5,0,30,25
1657616666023,MATH 20D,A02,083766,Tran; Brian Kha,5,0,30,25
1657616666023,MATH 20D,A03,083767,Tran; Brian Kha,5,0,30,25
1657616672054,MATH 20E,A01,083771,Ganguly; Soumya,9,0,32,23
1657616672054,MATH 20E,A02,083772,Ganguly; Soumya,6,0,32,26
1657616672054,MATH 20E,B01,083773,Ciotti; Benjamin,20,0,35,15
1657616672054,MATH 20E,B02,083774,Ciotti; Benjamin,18,0,35,17
1657616678081,MATH 103A,A01,083777,Greenfeld; Be'Eri,3,0,36,33
1657616678081,MATH 103A,A02,083778,Greenfeld; Be'Eri,5,0,36,31
1657616678081,MATH 103A,A03,093561,Greenfeld; Be'Eri,6,0,36,30
1657616678081,MATH 103A,B01,083779,Greenfeld; Be'Eri,7,0,36,29
1657616678081,MATH 103A,B02,083780,Greenfeld; Be'Eri,4,0,36,32
1657616678081,MATH 103A,B03,093562,Greenfeld; Be'Eri,3,0,36,33
1657616684105,MATH 105,A01,085443,Carter; Anne Toulson,15,0,35,20
1657616684105,MATH 105,A02,093477,Carter; Anne Toulson,20,0,35,15
1657616690136,MATH 109,A01,083213,Ganzberger; Geoffrey Michael,2,0,34,32
1657616690136,MATH 109,A02,083214,Ganzberger; Geoffrey Michael,4,0,34,30
1657616690136,MATH 109,A03,093478,Ganzberger; Geoffrey Michael,2,0,34,32
1657616690136,MATH 109,B01,083215,Ganzberger; Geoffrey Michael,1,0,32,31
1657616690136,MATH 109,B02,083216,Ganzberger; Geoffrey Michael,2,0,32,30
1657616690136,MATH 109,B03,093479,Ganzberger; Geoffrey Michael,8,0,32,24
1657616696165,MATH 142A,A01,083219,Chow; Bennett,7,0,32,25
1657616696165,MATH 142A,A02,083220,Chow; Bennett,10,0,32,22
1657616696165,MATH 142A,A03,093480,Chow; Bennett,9,0,32,23
1657616696165,MATH 142A,B03,093481,Chow; Bennett,8,0,32,24
1657616696165,MATH 142A,B04,093558,Chow; Bennett,13,0,32,19
1657616696165,MATH 142A,B05,093559,Chow; Bennett,6,0,32,26
1657616702190,MATH 193A,A01,083224,Rotar; Vladimir,8,0,34,26
1657616702190,MATH 193A,A02,083225,Rotar; Vladimir,9,0,34,25
1657616702190,MATH 193A,A03,083781,Rotar; Vladimir,5,0,34,29
1657616702190,MATH 193A,A04,083782,Rotar; Vladimir,10,0,34,24
1657616702190,MATH 193A,A05,093482,Rotar; Vladimir,10,0,34,24
1657616708216,MATH 197,001,091859,McAuley; Julian John,9999,0,9999,0
1657616708216,MATH 197,002,095566,Kedlaya; Kiran S.,9997,0,9999,2
1657616708216,MATH 197,003,095567,Xiao; Ming,9999,0,9999,0
1657616708216,MATH 197,004,095571,Perols; Johan Lars,9998,0,9999,1
1657616715290,COGS 9,A01,083615,Shannon; Kyle Michael,9,0,75,66
1657616721313,COGS 11,A01,083617,Boyle; Mary E. T.,23,0,48,25
1657616727337,COGS 13,A01,083071,Bastos; Amalia Pinkusfeld,11,0,71,60
1657616733361,COGS 14A,A01,092681,Semenuks; Arturs,5,1,100,95
1657616739387,COGS 14B,A01,083073,Cheng; Tzu-Han,6,0,63,57
1657616745409,COGS 17,A01,092677,Semenuks; Arturs,6,0,81,75
1657616751436,COGS 100,A01,083619,Allen; Michael Gordon,17,0,70,53
1657616757461,COGS 101A,A01,083621,Davis; Joshua Daniel,9,0,68,59
1657616763484,COGS 101B,A01,091572,Allen; Michael Gordon,12,0,65,53
1657616769512,COGS 101C,A01,083625,Delgado; Tania,17,0,35,18
1657616775534,COGS 107A,A01,083627,Boyle; Mary E. T.,13,0,60,47
1657616781558,COGS 118A,A01,083075,Gupta; Anjum,21,0,76,55
1657616787580,CSE 3,A50,083646,Miranda; Gregory Joseph,24,0,50,26
1657616793612,CSE 8A,A50,083650,Miranda; Gregory Joseph,17,1,56,39
1657616799635,CSE 11,A01,083080,Cao; Yingjun,6,15,40,34
1657616805667,CSE 12,A01,083652,Krause-Levy; Sophia Louisa,28,1,120,92
1657616811691,CSE 15L,A01,083654,Morris; Justin Loren,9,0,50,41
1657616811691,CSE 15L,A02,083655,Morris; Justin Loren,9,0,50,41
1657616817715,CSE 20,A01,083657,Tran; Khoa Dang,39,0,80,41
1657616823739,CSE 21,A01,095574,Bach; Quang Tran,22,0,48,26
1657616829767,CSE 30,A01,083084,Eldon; John,6,0,80,74
1657616829767,CSE 30,B01,095061,Bhaskar; Nishant,9,0,50,41
1657616835789,CSE 100,A01,083659,Cao; Yingjun,5,4,70,65
1657616841813,CSE 134B,A01,083661,Powell; Thomas Allan,22,0,100,78
1657616847843,CSE 140,A01,083663,Gungor; Onat,15,0,85,70
1657616853871,CSE 140L,A01,083088,Eldon; John,21,0,100,79
1657616859899,CSE 175,A01,083665,Kumar; Rakesh,3,0,25,22
1657616865925,CSE 190,A00,092507,Dubnov; Shlomo,8,0,20,12
1657616871949,ECE 45,A01,083139,Congero; Spencer William,6,0,75,69
1657616877974,ECE 65,A50,083695,Saad; Andrew S,12,0,30,18
1657616877974,ECE 65,A51,095125,Saad; Andrew S,24,0,26,2
1657616883999,ECE 109,A01,091882,Touri; Behrouz,19,0,70,51
1657616890024,ECE 180,A00,083140,Abi Samra; Nicholas Camill,1,0,30,29
1657616890024,ECE 180,B00,083141,Abi Samra; Nicholas Camill,0,0,30,30
1657616896048,MATH 10A,A01,083735,Patchell; Gregory David,2,0,30,28
1657616896048,MATH 10A,A02,083736,Patchell; Gregory David,20,0,30,10
1657616896048,MATH 10A,A03,083737,Patchell; Gregory David,16,0,30,14
1657616902082,MATH 10B,A01,083207,Lim; Seonhee,8,0,34,26
1657616902082,MATH 10B,A02,083208,Lim; Seonhee,9,0,35,26
1657616902082,MATH 10B,A03,093472,Lim; Seonhee,7,0,34,27
1657616902082,MATH 10B,B01,083739,Sinha; Shubham,12,0,30,18
1657616908116,MATH 18,A01,083743,Cinel; Cameron Alexander,7,0,30,23
1657616908116,MATH 18,A02,083744,Cinel; Cameron Alexander,17,0,30,13
1657616908116,MATH 18,A03,083745,Cinel; Cameron Alexander,9,0,30,21
1657616908116,MATH 18,B01,083748,Rideout; David Porter,5,0,37,32
1657616908116,MATH 18,B02,083749,Rideout; David Porter,5,0,36,31
1657616908116,MATH 18,B03,083750,Rideout; David Porter,3,0,37,34
1657616908116,MATH 18,B04,083751,Rideout; David Porter,6,0,36,30
1657616908116,MATH 18,B05,093473,Rideout; David Porter,6,0,36,30
1657616908116,MATH 18,B06,093474,Rideout; David Porter,6,0,36,30
1657616914145,MATH 20A,A01,083754,Zheng; Zequn,14,0,40,26
1657616920184,MATH 20B,A01,083756,Briones; Jor-el Thomas Caparas,4,0,36,32
1657616920184,MATH 20B,A02,083757,Briones; Jor-el Thomas Caparas,1,0,36,35
1657616920184,MATH 20B,A03,093475,Briones; Jor-el Thomas Caparas,2,0,36,34
1657616926208,MATH 20C,A01,083760,Briones; Jor-el Thomas Caparas,1,0,35,34
1657616926208,MATH 20C,A02,083761,Briones; Jor-el Thomas Caparas,8,0,35,27
1657616926208,MATH 20C,A03,093476,Briones; Jor-el Thomas Caparas,0,1,36,36
1657616926208,MATH 20C,B01,083762,Bach; Quang Tran,1,0,30,29
1657616932239,MATH 20D,A01,083765,Tran; Brian Kha,5,0,30,25
1657616932239,MATH 20D,A02,083766,Tran; Brian Kha,5,0,30,25
1657616932239,MATH 20D,A03,083767,Tran; Brian Kha,5,0,30,25
1657616938266,MATH 20E,A01,083771,Ganguly; Soumya,9,0,32,23
1657616938266,MATH 20E,A02,083772,Ganguly; Soumya,6,0,32,26
1657616938266,MATH 20E,B01,083773,Ciotti; Benjamin,20,0,35,15
1657616938266,MATH 20E,B02,083774,Ciotti; Benjamin,18,0,35,17
1657616944298,MATH 103A,A01,083777,Greenfeld; Be'Eri,3,0,36,33
1657616944298,MATH 103A,A02,083778,Greenfeld; Be'Eri,5,0,36,31
1657616944298,MATH 103A,A03,093561,Greenfeld; Be'Eri,6,0,36,30
1657616944298,MATH 103A,B01,083779,Greenfeld; Be'Eri,7,0,36,29
1657616944298,MATH 103A,B02,083780,Greenfeld; Be'Eri,4,0,36,32
1657616944298,MATH 103A,B03,093562,Greenfeld; Be'Eri,3,0,36,33
1657616950327,MATH 105,A01,085443,Carter; Anne Toulson,15,0,35,20
1657616950327,MATH 105,A02,093477,Carter; Anne Toulson,20,0,35,15
1657616956358,MATH 109,A01,083213,Ganzberger; Geoffrey Michael,2,0,34,32
1657616956358,MATH 109,A02,083214,Ganzberger; Geoffrey Michael,4,0,34,30
1657616956358,MATH 109,A03,093478,Ganzberger; Geoffrey Michael,2,0,34,32
1657616956358,MATH 109,B01,083215,Ganzberger; Geoffrey Michael,1,0,32,31
1657616956358,MATH 109,B02,083216,Ganzberger; Geoffrey Michael,2,0,32,30
1657616956358,MATH 109,B03,093479,Ganzberger; Geoffrey Michael,8,0,32,24
1657616962384,MATH 142A,A01,083219,Chow; Bennett,7,0,32,25
1657616962384,MATH 142A,A02,083220,Chow; Bennett,10,0,32,22
1657616962384,MATH 142A,A03,093480,Chow; Bennett,9,0,32,23
1657616962384,MATH 142A,B03,093481,Chow; Bennett,8,0,32,24
1657616962384,MATH 142A,B04,093558,Chow; Bennett,13,0,32,19
1657616962384,MATH 142A,B05,093559,Chow; Bennett,6,0,32,26
1657616968409,MATH 193A,A01,083224,Rotar; Vladimir,8,0,34,26
1657616968409,MATH 193A,A02,083225,Rotar; Vladimir,9,0,34,25
1657616968409,MATH 193A,A03,083781,Rotar; Vladimir,5,0,34,29
1657616968409,MATH 193A,A04,083782,Rotar; Vladimir,10,0,34,24
1657616968409,MATH 193A,A05,093482,Rotar; Vladimir,10,0,34,24
1657616974433,MATH 197,001,091859,McAuley; Julian John,9999,0,9999,0
1657616974433,MATH 197,002,095566,Kedlaya; Kiran S.,9997,0,9999,2
1657616974433,MATH 197,003,095567,Xiao; Ming,9999,0,9999,0
1657616974433,MATH 197,004,095571,Perols; Johan Lars,9998,0,9999,1
1657616981491,COGS 9,A01,083615,Shannon; Kyle Michael,9,0,75,66
1657616987519,COGS 11,A01,083617,Boyle; Mary E. T.,23,0,48,25
1657616993543,COGS 13,A01,083071,Bastos; Amalia Pinkusfeld,11,0,71,60
1657616999570,COGS 14A,A01,092681,Semenuks; Arturs,5,1,100,95
1657617005595,COGS 14B,A01,083073,Cheng; Tzu-Han,6,0,63,57
1657617011618,COGS 17,A01,092677,Semenuks; Arturs,6,0,81,75
1657617017642,COGS 100,A01,083619,Allen; Michael Gordon,17,0,70,53
1657617023666,COGS 101A,A01,083621,Davis; Joshua Daniel,9,0,68,59
1657617029688,COGS 101B,A01,091572,Allen; Michael Gordon,12,0,65,53
1657617035719,COGS 101C,A01,083625,Delgado; Tania,17,0,35,18
1657617041746,COGS 107A,A01,083627,Boyle; Mary E. T.,13,0,60,47
1657617047777,COGS 118A,A01,083075,Gupta; Anjum,21,0,76,55
1657617053802,CSE 3,A50,083646,Miranda; Gregory Joseph,24,0,50,26
1657617059830,CSE 8A,A50,083650,Miranda; Gregory Joseph,17,1,56,39
1657617065855,CSE 11,A01,083080,Cao; Yingjun,6,15,40,34
1657617071886,CSE 12,A01,083652,Krause-Levy; Sophia Louisa,28,1,120,92
1657617077909,CSE 15L,A01,083654,Morris; Justin Loren,9,0,50,41
1657617077909,CSE 15L,A02,083655,Morris; Justin Loren,9,0,50,41
1657617083935,CSE 20,A01,083657,Tran; Khoa Dang,39,0,80,41
1657617089961,CSE 21,A01,095574,Bach; Quang Tran,22,0,48,26
1657617095985,CSE 30,A01,083084,Eldon; John,6,0,80,74
1657617095985,CSE 30,B01,095061,Bhaskar; Nishant,9,0,50,41
1657617102007,CSE 100,A01,083659,Cao; Yingjun,5,4,70,65
1657617108039,CSE 134B,A01,083661,Powell; Thomas Allan,22,0,100,78
1657617114062,CSE 140,A01,083663,Gungor; Onat,15,0,85,70
1657617120088,CSE 140L,A01,083088,Eldon; John,21,0,100,79
1657617126111,CSE 175,A01,083665,Kumar; Rakesh,3,0,25,22
1657617132135,CSE 190,A00,092507,Dubnov; Shlomo,8,0,20,12
1657617138162,ECE 45,A01,083139,Congero; Spencer William,6,0,75,69
1657617144192,ECE 65,A50,083695,Saad; Andrew S,12,0,30,18
1657617144192,ECE 65,A51,095125,Saad; Andrew S,24,0,26,2
1657617150219,ECE 109,A01,091882,Touri; Behrouz,19,0,70,51
1657617156247,ECE 180,A00,083140,Abi Samra; Nicholas Camill,1,0,30,29
1657617156247,ECE 180,B00,083141,Abi Samra; Nicholas Camill,0,0,30,30
1657617162271,MATH 10A,A01,083735,Patchell; Gregory David,2,0,30,28
1657617162271,MATH 10A,A02,083736,Patchell; Gregory David,20,0,30,10
1657617162271,MATH 10A,A03,083737,Patchell; Gregory David,16,0,30,14
1657617168311,MATH 10B,A01,083207,Lim; Seonhee,8,0,34,26
1657617168311,MATH 10B,A02,083208,Lim; Seonhee,9,0,35,26
1657617168311,MATH 10B,A03,093472,Lim; Seonhee,7,0,34,27
1657617168311,MATH 10B,B01,083739,Sinha; Shubham,12,0,30,18
1657617174338,MATH 18,A01,083743,Cinel; Cameron Alexander,7,0,30,23
1657617174338,MATH 18,A02,083744,Cinel; Cameron Alexander,17,0,30,13
1657617174338,MATH 18,A03,083745,Cinel; Cameron Alexander,9,0,30,21
1657617174338,MATH 18,B01,083748,Rideout; David Porter,5,0,37,32
1657617174338,MATH 18,B02,083749,Rideout; David Porter,5,0,36,31
1657617174338,MATH 18,B03,083750,Rideout; David Porter,3,0,37,34
1657617174338,MATH 18,B04,083751,Rideout; David Porter,6,0,36,30
1657617174338,MATH 18,B05,093473,Rideout; David Porter,6,0,36,30
1657617174338,MATH 18,B06,093474,Rideout; David Porter,6,0,36,30
1657617180366,MATH 20A,A01,083754,Zheng; Zequn,14,0,40,26
1657617186390,MATH 20B,A01,083756,Briones; Jor-el Thomas Caparas,4,0,36,32
1657617186390,MATH 20B,A02,083757,Briones; Jor-el Thomas Caparas,1,0,36,35
1657617186390,MATH 20B,A03,093475,Briones; Jor-el Thomas Caparas,2,0,36,34
1657617192413,MATH 20C,A01,083760,Briones; Jor-el Thomas Caparas,1,0,35,34
1657617192413,MATH 20C,A02,083761,Briones; Jor-el Thomas Caparas,8,0,35,27
1657617192413,MATH 20C,A03,093476,Briones; Jor-el Thomas Caparas,0,1,36,36
1657617192413,MATH 20C,B01,083762,Bach; Quang Tran,1,0,30,29
1657617198438,MATH 20D,A01,083765,Tran; Brian Kha,5,0,30,25
1657617198438,MATH 20D,A02,083766,Tran; Brian Kha,5,0,30,25
1657617198438,MATH 20D,A03,083767,Tran; Brian Kha,5,0,30,25
1657617204469,MATH 20E,A01,083771,Ganguly; Soumya,9,0,32,23
1657617204469,MATH 20E,A02,083772,Ganguly; Soumya,6,0,32,26
1657617204469,MATH 20E,B01,083773,Ciotti; Benjamin,20,0,35,15
1657617204469,MATH 20E,B02,083774,Ciotti; Benjamin,18,0,35,17
1657617210495,MATH 103A,A01,083777,Greenfeld; Be'Eri,3,0,36,33
1657617210495,MATH 103A,A02,083778,Greenfeld; Be'Eri,5,0,36,31
1657617210495,MATH 103A,A03,093561,Greenfeld; Be'Eri,6,0,36,30
1657617210495,MATH 103A,B01,083779,Greenfeld; Be'Eri,7,0,36,29
1657617210495,MATH 103A,B02,083780,Greenfeld; Be'Eri,4,0,36,32
1657617210495,MATH 103A,B03,093562,Greenfeld; Be'Eri,3,0,36,33
1657617216518,MATH 105,A01,085443,Carter; Anne Toulson,15,0,35,20
1657617216518,MATH 105,A02,093477,Carter; Anne Toulson,20,0,35,15
1657617222542,MATH 109,A01,083213,Ganzberger; Geoffrey Michael,2,0,34,32
1657617222542,MATH 109,A02,083214,Ganzberger; Geoffrey Michael,4,0,34,30
1657617222542,MATH 109,A03,093478,Ganzberger; Geoffrey Michael,2,0,34,32
1657617222542,MATH 109,B01,083215,Ganzberger; Geoffrey Michael,1,0,32,31
1657617222542,MATH 109,B02,083216,Ganzberger; Geoffrey Michael,2,0,32,30
1657617222542,MATH 109,B03,093479,Ganzberger; Geoffrey Michael,8,0,32,24
1657617228566,MATH 142A,A01,083219,Chow; Bennett,7,0,32,25
1657617228566,MATH 142A,A02,083220,Chow; Bennett,10,0,32,22
1657617228566,MATH 142A,A03,093480,Chow; Bennett,9,0,32,23
1657617228566,MATH 142A,B03,093481,Chow; Bennett,8,0,32,24
1657617228566,MATH 142A,B04,093558,Chow; Bennett,13,0,32,19
1657617228566,MATH 142A,B05,093559,Chow; Bennett,6,0,32,26
1657617234680,MATH 193A,A01,083224,Rotar; Vladimir,8,0,34,26
1657617234680,MATH 193A,A02,083225,Rotar; Vladimir,9,0,34,25
1657617234680,MATH 193A,A03,083781,Rotar; Vladimir,5,0,34,29
1657617234680,MATH 193A,A04,083782,Rotar; Vladimir,10,0,34,24
1657617234680,MATH 193A,A05,093482,Rotar; Vladimir,10,0,34,24
1657617240704,MATH 197,001,091859,McAuley; Julian John,9999,0,9999,0
1657617240704,MATH 197,002,095566,Kedlaya; Kiran S.,9997,0,9999,2
1657617240704,MATH 197,003,095567,Xiao; Ming,9999,0,9999,0
1657617240704,MATH 197,004,095571,Perols; Johan Lars,9998,0,9999,1
1657617247766,COGS 9,A01,083615,Shannon; Kyle Michael,9,0,75,66
1657617253789,COGS 11,A01,083617,Boyle; Mary E. T.,23,0,48,25
1657617259815,COGS 13,A01,083071,Bastos; Amalia Pinkusfeld,11,0,71,60
1657617265839,COGS 14A,A01,092681,Semenuks; Arturs,5,1,100,95
1657617271862,COGS 14B,A01,083073,Cheng; Tzu-Han,6,0,63,57
1657617277886,COGS 17,A01,092677,Semenuks; Arturs,6,0,81,75
1657617283910,COGS 100,A01,083619,Allen; Michael Gordon,17,0,70,53
1657617289937,COGS 101A,A01,083621,Davis; Joshua Daniel,9,0,68,59
1657617295963,COGS 101B,A01,091572,Allen; Michael Gordon,12,0,65,53
1657617301984,COGS 101C,A01,083625,Delgado; Tania,17,0,35,18
1657617308007,COGS 107A,A01,083627,Boyle; Mary E. T.,13,0,60,47
1657617314031,COGS 118A,A01,083075,Gupta; Anjum,21,0,76,55
1657617320056,CSE 3,A50,083646,Miranda; Gregory Joseph,24,0,50,26
1657617326083,CSE 8A,A50,083650,Miranda; Gregory Joseph,17,1,56,39
1657617332110,CSE 11,A01,083080,Cao; Yingjun,6,15,40,34
1657617338133,CSE 12,A01,083652,Krause-Levy; Sophia Louisa,28,1,120,92
1657617344158,CSE 15L,A01,083654,Morris; Justin Loren,9,0,50,41
1657617344158,CSE 15L,A02,083655,Morris; Justin Loren,9,0,50,41
1657617350182,CSE 20,A01,083657,Tran; Khoa Dang,39,0,80,41
1657617356208,CSE 21,A01,095574,Bach; Quang Tran,22,0,48,26
1657617362232,CSE 30,A01,083084,Eldon; John,6,0,80,74
1657617362232,CSE 30,B01,095061,Bhaskar; Nishant,9,0,50,41
1657617368261,CSE 100,A01,083659,Cao; Yingjun,5,4,70,65
1657617374284,CSE 134B,A01,083661,Powell; Thomas Allan,22,0,100,78
1657617380307,CSE 140,A01,083663,Gungor; Onat,15,0,85,70
1657617386332,CSE 140L,A01,083088,Eldon; John,21,0,100,79
1657617392355,CSE 175,A01,083665,Kumar; Rakesh,3,0,25,22
1657617398381,CSE 190,A00,092507,Dubnov; Shlomo,8,0,20,12
1657617404404,ECE 45,A01,083139,Congero; Spencer William,6,0,75,69
1657617410428,ECE 65,A50,083695,Saad; Andrew S,12,0,30,18
1657617410428,ECE 65,A51,095125,Saad; Andrew S,24,0,26,2
1657617416455,ECE 109,A01,091882,Touri; Behrouz,19,0,70,51
1657617422478,ECE 180,A00,083140,Abi Samra; Nicholas Camill,1,0,30,29
1657617422478,ECE 180,B00,083141,Abi Samra; Nicholas Camill,0,0,30,30
1657617428502,MATH 10A,A01,083735,Patchell; Gregory David,2,0,30,28
1657617428502,MATH 10A,A02,083736,Patchell; Gregory David,20,0,30,10
1657617428502,MATH 10A,A03,083737,Patchell; Gregory David,16,0,30,14
1657617434531,MATH 10B,A01,083207,Lim; Seonhee,8,0,34,26
1657617434531,MATH 10B,A02,083208,Lim; Seonhee,9,0,35,26
1657617434531,MATH 10B,A03,093472,Lim; Seonhee,7,0,34,27
1657617434531,MATH 10B,B01,083739,Sinha; Shubham,12,0,30,18
1657617440556,MATH 18,A01,083743,Cinel; Cameron Alexander,7,0,30,23
1657617440556,MATH 18,A02,083744,Cinel; Cameron Alexander,17,0,30,13
1657617440556,MATH 18,A03,083745,Cinel; Cameron Alexander,9,0,30,21
1657617440556,MATH 18,B01,083748,Rideout; David Porter,5,0,37,32
1657617440556,MATH 18,B02,083749,Rideout; David Porter,5,0,36,31
1657617440556,MATH 18,B03,083750,Rideout; David Porter,3,0,37,34
1657617440556,MATH 18,B04,083751,Rideout; David Porter,6,0,36,30
1657617440556,MATH 18,B05,093473,Rideout; David Porter,6,0,36,30
1657617440556,MATH 18,B06,093474,Rideout; David Porter,6,0,36,30
1657617446582,MATH 20A,A01,083754,Zheng; Zequn,14,0,40,26
1657617452610,MATH 20B,A01,083756,Briones; Jor-el Thomas Caparas,4,0,36,32
1657617452610,MATH 20B,A02,083757,Briones; Jor-el Thomas Caparas,1,0,36,35
1657617452610,MATH 20B,A03,093475,Briones; Jor-el Thomas Caparas,2,0,36,34
1657617458635,MATH 20C,A01,083760,Briones; Jor-el Thomas Caparas,1,0,35,34
1657617458635,MATH 20C,A02,083761,Briones; Jor-el Thomas Caparas,8,0,35,27
1657617458635,MATH 20C,A03,093476,Briones; Jor-el Thomas Caparas,0,1,36,36
1657617458635,MATH 20C,B01,083762,Bach; Quang Tran,1,0,30,29
1657617464657,MATH 20D,A01,083765,Tran; Brian Kha,5,0,30,25
1657617464657,MATH 20D,A02,083766,Tran; Brian Kha,5,0,30,25
1657617464657,MATH 20D,A03,083767,Tran; Brian Kha,5,0,30,25
1657617470688,MATH 20E,A01,083771,Ganguly; Soumya,9,0,32,23
1657617470688,MATH 20E,A02,083772,Ganguly; Soumya,6,0,32,26
1657617470688,MATH 20E,B01,083773,Ciotti; Benjamin,20,0,35,15
1657617470688,MATH 20E,B02,083774,Ciotti; Benjamin,18,0,35,17
1657617476713,MATH 103A,A01,083777,Greenfeld; Be'Eri,3,0,36,33
1657617476713,MATH 103A,A02,083778,Greenfeld; Be'Eri,5,0,36,31
1657617476713,MATH 103A,A03,093561,Greenfeld; Be'Eri,6,0,36,30
1657617476713,MATH 103A,B01,083779,Greenfeld; Be'Eri,7,0,36,29
1657617476713,MATH 103A,B02,083780,Greenfeld; Be'Eri,4,0,36,32
1657617476713,MATH 103A,B03,093562,Greenfeld; Be'Eri,3,0,36,33
1657617482738,MATH 105,A01,085443,Carter; Anne Toulson,15,0,35,20
1657617482738,MATH 105,A02,093477,Carter; Anne Toulson,20,0,35,15
1657617488765,MATH 109,A01,083213,Ganzberger; Geoffrey Michael,2,0,34,32
1657617488765,MATH 109,A02,083214,Ganzberger; Geoffrey Michael,4,0,34,30
1657617488765,MATH 109,A03,093478,Ganzberger; Geoffrey Michael,2,0,34,32
1657617488765,MATH 109,B01,083215,Ganzberger; Geoffrey Michael,1,0,32,31
1657617488765,MATH 109,B02,083216,Ganzberger; Geoffrey Michael,2,0,32,30
1657617488765,MATH 109,B03,093479,Ganzberger; Geoffrey Michael,8,0,32,24
1657617494790,MATH 142A,A01,083219,Chow; Bennett,7,0,32,25
1657617494790,MATH 142A,A02,083220,Chow; Bennett,10,0,32,22
1657617494790,MATH 142A,A03,093480,Chow; Bennett,9,0,32,23
1657617494790,MATH 142A,B03,093481,Chow; Bennett,8,0,32,24
1657617494790,MATH 142A,B04,093558,Chow; Bennett,13,0,32,19
1657617494790,MATH 142A,B05,093559,Chow; Bennett,6,0,32,26
1657617500815,MATH 193A,A01,083224,Rotar; Vladimir,8,0,34,26
1657617500815,MATH 193A,A02,083225,Rotar; Vladimir,9,0,34,25
1657617500815,MATH 193A,A03,083781,Rotar; Vladimir,5,0,34,29
1657617500815,MATH 193A,A04,083782,Rotar; Vladimir,10,0,34,24
1657617500815,MATH 193A,A05,093482,Rotar; Vladimir,10,0,34,24
1657617506838,MATH 197,001,091859,McAuley; Julian John,9999,0,9999,0
1657617506838,MATH 197,002,095566,Kedlaya; Kiran S.,9997,0,9999,2
1657617506838,MATH 197,003,095567,Xiao; Ming,9999,0,9999,0
1657617506838,MATH 197,004,095571,Perols; Johan Lars,9998,0,9999,1
1657617513906,COGS 9,A01,083615,Shannon; Kyle Michael,9,0,75,66
1657617519933,COGS 11,A01,083617,Boyle; Mary E. T.,23,0,48,25
1657617525956,COGS 13,A01,083071,Bastos; Amalia Pinkusfeld,11,0,71,60
1657617531980,COGS 14A,A01,092681,Semenuks; Arturs,5,1,100,95
1657617538004,COGS 14B,A01,083073,Cheng; Tzu-Han,6,0,63,57
1657617544027,COGS 17,A01,092677,Semenuks; Arturs,6,0,81,75
1657617550051,COGS 100,A01,083619,Allen; Michael Gordon,17,0,70,53
1657617556075,COGS 101A,A01,083621,Davis; Joshua Daniel,9,0,68,59
1657617562102,COGS 101B,A01,091572,Allen; Michael Gordon,12,0,65,53
1657617568128,COGS 101C,A01,083625,Delgado; Tania,17,0,35,18
1657617574153,COGS 107A,A01,083627,Boyle; Mary E. T.,13,0,60,47
1657617580181,COGS 118A,A01,083075,Gupta; Anjum,21,0,76,55
1657617586208,CSE 3,A50,083646,Miranda; Gregory Joseph,24,0,50,26
1657617592233,CSE 8A,A50,083650,Miranda; Gregory Joseph,17,1,56,39
1657617598256,CSE 11,A01,083080,Cao; Yingjun,6,15,40,34
1657617604279,CSE 12,A01,083652,Krause-Levy; Sophia Louisa,28,1,120,92
1657617610303,CSE 15L,A01,083654,Morris; Justin Loren,9,0,50,41
1657617610303,CSE 15L,A02,083655,Morris; Justin Loren,9,0,50,41
1657617616333,CSE 20,A01,083657,Tran; Khoa Dang,39,0,80,41
1657617622357,CSE 21,A01,095574,Bach; Quang Tran,22,0,48,26
1657617628380,CSE 30,A01,083084,Eldon; John,6,0,80,74
1657617628380,CSE 30,B01,095061,Bhaskar; Nishant,9,0,50,41
1657617634405,CSE 100,A01,083659,Cao; Yingjun,5,4,70,65
1657617640429,CSE 134B,A01,083661,Powell; Thomas Allan,22,0,100,78
1657617646455,CSE 140,A01,083663,Gungor; Onat,15,0,85,70
1657617652482,CSE 140L,A01,083088,Eldon; John,21,0,100,79
1657617658509,CSE 175,A01,083665,Kumar; Rakesh,3,0,25,22
1657617664536,CSE 190,A00,092507,Dubnov; Shlomo,8,0,20,12
1657617670560,ECE 45,A01,083139,Congero; Spencer William,6,0,75,69
1657617676584,ECE 65,A50,083695,Saad; Andrew S,12,0,30,18
1657617676584,ECE 65,A51,095125,Saad; Andrew S,24,0,26,2
1657617682607,ECE 109,A01,091882,Touri; Behrouz,19,0,70,51
1657617688632,ECE 180,A00,083140,Abi Samra; Nicholas Camill,1,0,30,29
1657617688632,ECE 180,B00,083141,Abi Samra; Nicholas Camill,0,0,30,30
1657617694654,MATH 10A,A01,083735,Patchell; Gregory David,2,0,30,28
1657617694654,MATH 10A,A02,083736,Patchell; Gregory David,20,0,30,10
1657617694654,MATH 10A,A03,083737,Patchell; Gregory David,16,0,30,14
1657617700678,MATH 10B,A01,083207,Lim; Seonhee,8,0,34,26
1657617700678,MATH 10B,A02,083208,Lim; Seonhee,9,0,35,26
1657617700678,MATH 10B,A03,093472,Lim; Seonhee,7,0,34,27
1657617700678,MATH 10B,B01,083739,Sinha; Shubham,12,0,30,18
1657617706709,MATH 18,A01,083743,Cinel; Cameron Alexander,7,0,30,23
1657617706709,MATH 18,A02,083744,Cinel; Cameron Alexander,17,0,30,13
1657617706709,MATH 18,A03,083745,Cinel; Cameron Alexander,9,0,30,21
1657617706709,MATH 18,B01,083748,Rideout; David Porter,5,0,37,32
1657617706709,MATH 18,B02,083749,Rideout; David Porter,5,0,36,31
1657617706709,MATH 18,B03,083750,Rideout; David Porter,3,0,37,34
1657617706709,MATH 18,B04,083751,Rideout; David Porter,6,0,36,30
1657617706709,MATH 18,B05,093473,Rideout; David Porter,6,0,36,30
1657617706709,MATH 18,B06,093474,Rideout; David Porter,6,0,36,30
1657617712730,MATH 20A,A01,083754,Zheng; Zequn,14,0,40,26
1657617718753,MATH 20B,A01,083756,Briones; Jor-el Thomas Caparas,4,0,36,32
1657617718753,MATH 20B,A02,083757,Briones; Jor-el Thomas Caparas,1,0,36,35
1657617718753,MATH 20B,A03,093475,Briones; Jor-el Thomas Caparas,2,0,36,34
1657617724776,MATH 20C,A01,083760,Briones; Jor-el Thomas Caparas,1,0,35,34
1657617724776,MATH 20C,A02,083761,Briones; Jor-el Thomas Caparas,8,0,35,27
1657617724776,MATH 20C,A03,093476,Briones; Jor-el Thomas Caparas,0,1,36,36
1657617724776,MATH 20C,B01,083762,Bach; Quang Tran,1,0,30,29
1657617730801,MATH 20D,A01,083765,Tran; Brian Kha,5,0,30,25
1657617730801,MATH 20D,A02,083766,Tran; Brian Kha,5,0,30,25
1657617730801,MATH 20D,A03,083767,Tran; Brian Kha,5,0,30,25
1657617736825,MATH 20E,A01,083771,Ganguly; Soumya,9,0,32,23
1657617736825,MATH 20E,A02,083772,Ganguly; Soumya,6,0,32,26
1657617736825,MATH 20E,B01,083773,Ciotti; Benjamin,20,0,35,15
1657617736825,MATH 20E,B02,083774,Ciotti; Benjamin,18,0,35,17
1657617742855,MATH 103A,A01,083777,Greenfeld; Be'Eri,3,0,36,33
1657617742855,MATH 103A,A02,083778,Greenfeld; Be'Eri,5,0,36,31
1657617742855,MATH 103A,A03,093561,Greenfeld; Be'Eri,6,0,36,30
1657617742855,MATH 103A,B01,083779,Greenfeld; Be'Eri,7,0,36,29
1657617742855,MATH 103A,B02,083780,Greenfeld; Be'Eri,4,0,36,32
1657617742855,MATH 103A,B03,093562,Greenfeld; Be'Eri,3,0,36,33
1657617748877,MATH 105,A01,085443,Carter; Anne Toulson,15,0,35,20
1657617748877,MATH 105,A02,093477,Carter; Anne Toulson,20,0,35,15
1657617754902,MATH 109,A01,083213,Ganzberger; Geoffrey Michael,2,0,34,32
1657617754902,MATH 109,A02,083214,Ganzberger; Geoffrey Michael,4,0,34,30
1657617754902,MATH 109,A03,093478,Ganzberger; Geoffrey Michael,2,0,34,32
1657617754902,MATH 109,B01,083215,Ganzberger; Geoffrey Michael,1,0,32,31
1657617754902,MATH 109,B02,083216,Ganzberger; Geoffrey Michael,2,0,32,30
1657617754902,MATH 109,B03,093479,Ganzberger; Geoffrey Michael,8,0,32,24
1657617760931,MATH 142A,A01,083219,Chow; Bennett,7,0,32,25
1657617760931,MATH 142A,A02,083220,Chow; Bennett,10,0,32,22
1657617760931,MATH 142A,A03,093480,Chow; Bennett,9,0,32,23
1657617760931,MATH 142A,B03,093481,Chow; Bennett,8,0,32,24
1657617760931,MATH 142A,B04,093558,Chow; Bennett,13,0,32,19
1657617760931,MATH 142A,B05,093559,Chow; Bennett,6,0,32,26
1657617766959,MATH 193A,A01,083224,Rotar; Vladimir,8,0,34,26
1657617766959,MATH 193A,A02,083225,Rotar; Vladimir,9,0,34,25
1657617766959,MATH 193A,A03,083781,Rotar; Vladimir,5,0,34,29
1657617766959,MATH 193A,A04,083782,Rotar; Vladimir,10,0,34,24
1657617766959,MATH 193A,A05,093482,Rotar; Vladimir,10,0,34,24
1657617772983,MATH 197,001,091859,McAuley; Julian John,9999,0,9999,0
1657617772983,MATH 197,002,095566,Kedlaya; Kiran S.,9997,0,9999,2
1657617772983,MATH 197,003,095567,Xiao; Ming,9999,0,9999,0
1657617772983,MATH 197,004,095571,Perols; Johan Lars,9998,0,9999,1
1657617780045,COGS 9,A01,083615,Shannon; Kyle Michael,9,0,75,66
1657617786067,COGS 11,A01,083617,Boyle; Mary E. T.,23,0,48,25
1657617792091,COGS 13,A01,083071,Bastos; Amalia Pinkusfeld,11,0,71,60
1657617798113,COGS 14A,A01,092681,Semenuks; Arturs,5,1,100,95
1657617804138,COGS 14B,A01,083073,Cheng; Tzu-Han,6,0,63,57
1657617810166,COGS 17,A01,092677,Semenuks; Arturs,6,0,81,75
1657617816189,COGS 100,A01,083619,Allen; Michael Gordon,17,0,70,53
1657617822214,COGS 101A,A01,083621,Davis; Joshua Daniel,9,0,68,59
1657617828311,COGS 101B,A01,091572,Allen; Michael Gordon,12,0,65,53
1657617834335,COGS 101C,A01,083625,Delgado; Tania,17,0,35,18
1657617840363,COGS 107A,A01,083627,Boyle; Mary E. T.,13,0,60,47
1657617846385,COGS 118A,A01,083075,Gupta; Anjum,21,0,76,55
1657617852412,CSE 3,A50,083646,Miranda; Gregory Joseph,24,0,50,26
1657617858436,CSE 8A,A50,083650,Miranda; Gregory Joseph,17,1,56,39
1657617864459,CSE 11,A01,083080,Cao; Yingjun,6,15,40,34
1657617870487,CSE 12,A01,083652,Krause-Levy; Sophia Louisa,28,1,120,92
1657617876512,CSE 15L,A01,083654,Morris; Justin Loren,9,0,50,41
1657617876512,CSE 15L,A02,083655,Morris; Justin Loren,9,0,50,41
1657617882537,CSE 20,A01,083657,Tran; Khoa Dang,39,0,80,41
1657617888563,CSE 21,A01,095574,Bach; Quang Tran,22,0,48,26
1657617894587,CSE 30,A01,083084,Eldon; John,6,0,80,74
1657617894587,CSE 30,B01,095061,Bhaskar; Nishant,9,0,50,41
1657617900613,CSE 100,A01,083659,Cao; Yingjun,5,4,70,65
1657617906635,CSE 134B,A01,083661,Powell; Thomas Allan,22,0,100,78
1657617912660,CSE 140,A01,083663,Gungor; Onat,15,0,85,70
1657617918683,CSE 140L,A01,083088,Eldon; John,21,0,100,79
1657617924708,CSE 175,A01,083665,Kumar; Rakesh,3,0,25,22
1657617930734,CSE 190,A00,092507,Dubnov; Shlomo,8,0,20,12
1657617936761,ECE 45,A01,083139,Congero; Spencer William,6,0,75,69
1657617942784,ECE 65,A50,083695,Saad; Andrew S,12,0,30,18
1657617942784,ECE 65,A51,095125,Saad; Andrew S,24,0,26,2
1657617948806,ECE 109,A01,091882,Touri; Behrouz,19,0,70,51
1657617954834,ECE 180,A00,083140,Abi Samra; Nicholas Camill,1,0,30,29
1657617954834,ECE 180,B00,083141,Abi Samra; Nicholas Camill,0,0,30,30
1657617960862,MATH 10A,A01,083735,Patchell; Gregory David,2,0,30,28
1657617960862,MATH 10A,A02,083736,Patchell; Gregory David,20,0,30,10
1657617960862,MATH 10A,A03,083737,Patchell; Gregory David,16,0,30,14
1657617966887,MATH 10B,A01,083207,Lim; Seonhee,8,0,34,26
1657617966887,MATH 10B,A02,083208,Lim; Seonhee,9,0,35,26
1657617966887,MATH 10B,A03,093472,Lim; Seonhee,7,0,34,27
1657617966887,MATH 10B,B01,083739,Sinha; Shubham,12,0,30,18
1657617972912,MATH 18,A01,083743,Cinel; Cameron Alexander,7,0,30,23
1657617972912,MATH 18,A02,083744,Cinel; Cameron Alexander,17,0,30,13
1657617972912,MATH 18,A03,083745,Cinel; Cameron Alexander,9,0,30,21
1657617972912,MATH 18,B01,083748,Rideout; David Porter,5,0,37,32
1657617972912,MATH 18,B02,083749,Rideout; David Porter,5,0,36,31
1657617972912,MATH 18,B03,083750,Rideout; David Porter,3,0,37,34
1657617972912,MATH 18,B04,083751,Rideout; David Porter,6,0,36,30
1657617972912,MATH 18,B05,093473,Rideout; David Porter,6,0,36,30
1657617972912,MATH 18,B06,093474,Rideout; David Porter,6,0,36,30
1657617978935,MATH 20A,A01,083754,Zheng; Zequn,14,0,40,26
1657617984964,MATH 20B,A01,083756,Briones; Jor-el Thomas Caparas,4,0,36,32
1657617984964,MATH 20B,A02,083757,Briones; Jor-el Thomas Caparas,1,0,36,35
1657617984964,MATH 20B,A03,093475,Briones; Jor-el Thomas Caparas,2,0,36,34
1657617990991,MATH 20C,A01,083760,Briones; Jor-el Thomas Caparas,1,0,35,34
1657617990991,MATH 20C,A02,083761,Briones; Jor-el Thomas Caparas,8,0,35,27
1657617990991,MATH 20C,A03,093476,Briones; Jor-el Thomas Caparas,0,1,36,36
1657617990991,MATH 20C,B01,083762,Bach; Quang Tran,1,0,30,29
1657617997014,MATH 20D,A01,083765,Tran; Brian Kha,5,0,30,25
1657617997014,MATH 20D,A02,083766,Tran; Brian Kha,5,0,30,25
1657617997014,MATH 20D,A03,083767,Tran; Brian Kha,5,0,30,25
1657618003042,MATH 20E,A01,083771,Ganguly; Soumya,9,0,32,23
1657618003042,MATH 20E,A02,083772,Ganguly; Soumya,6,0,32,26
1657618003042,MATH 20E,B01,083773,Ciotti; Benjamin,20,0,35,15
1657618003042,MATH 20E,B02,083774,Ciotti; Benjamin,18,0,35,17
1657618009070,MATH 103A,A01,083777,Greenfeld; Be'Eri,3,0,36,33
1657618009070,MATH 103A,A02,083778,Greenfeld; Be'Eri,5,0,36,31
1657618009070,MATH 103A,A03,093561,Greenfeld; Be'Eri,6,0,36,30
1657618009070,MATH 103A,B01,083779,Greenfeld; Be'Eri,7,0,36,29
1657618009070,MATH 103A,B02,083780,Greenfeld; Be'Eri,4,0,36,32
1657618009070,MATH 103A,B03,093562,Greenfeld; Be'Eri,3,0,36,33
1657618015094,MATH 105,A01,085443,Carter; Anne Toulson,15,0,35,20
1657618015094,MATH 105,A02,093477,Carter; Anne Toulson,20,0,35,15
1657618021119,MATH 109,A01,083213,Ganzberger; Geoffrey Michael,2,0,34,32
1657618021119,MATH 109,A02,083214,Ganzberger; Geoffrey Michael,4,0,34,30
1657618021119,MATH 109,A03,093478,Ganzberger; Geoffrey Michael,2,0,34,32
1657618021119,MATH 109,B01,083215,Ganzberger; Geoffrey Michael,1,0,32,31
1657618021119,MATH 109,B02,083216,Ganzberger; Geoffrey Michael,2,0,32,30
1657618021119,MATH 109,B03,093479,Ganzberger; Geoffrey Michael,8,0,32,24
1657618027150,MATH 142A,A01,083219,Chow; Bennett,7,0,32,25
1657618027150,MATH 142A,A02,083220,Chow; Bennett,10,0,32,22
1657618027150,MATH 142A,A03,093480,Chow; Bennett,9,0,32,23
1657618027150,MATH 142A,B03,093481,Chow; Bennett,8,0,32,24
1657618027150,MATH 142A,B04,093558,Chow; Bennett,13,0,32,19
1657618027150,MATH 142A,B05,093559,Chow; Bennett,6,0,32,26
1657618033183,MATH 193A,A01,083224,Rotar; Vladimir,8,0,34,26
1657618033183,MATH 193A,A02,083225,Rotar; Vladimir,9,0,34,25
1657618033183,MATH 193A,A03,083781,Rotar; Vladimir,5,0,34,29
1657618033183,MATH 193A,A04,083782,Rotar; Vladimir,10,0,34,24
1657618033183,MATH 193A,A05,093482,Rotar; Vladimir,10,0,34,24
1657618039205,MATH 197,001,091859,McAuley; Julian John,9999,0,9999,0
1657618039205,MATH 197,002,095566,Kedlaya; Kiran S.,9997,0,9999,2
1657618039205,MATH 197,003,095567,Xiao; Ming,9999,0,9999,0
1657618039205,MATH 197,004,095571,Perols; Johan Lars,9998,0,9999,1
1657618046263,COGS 9,A01,083615,Shannon; Kyle Michael,9,0,75,66
1657618052289,COGS 11,A01,083617,Boyle; Mary E. T.,23,0,48,25
1657618058316,COGS 13,A01,083071,Bastos; Amalia Pinkusfeld,11,0,71,60
1657618064342,COGS 14A,A01,092681,Semenuks; Arturs,5,1,100,95
1657618070365,COGS 14B,A01,083073,Cheng; Tzu-Han,6,0,63,57
1657618076389,COGS 17,A01,092677,Semenuks; Arturs,6,0,81,75
1657618082413,COGS 100,A01,083619,Allen; Michael Gordon,17,0,70,53
1657618088439,COGS 101A,A01,083621,Davis; Joshua Daniel,9,0,68,59
1657618094463,COGS 101B,A01,091572,Allen; Michael Gordon,12,0,65,53
1657618100490,COGS 101C,A01,083625,Delgado; Tania,17,0,35,18
1657618106513,COGS 107A,A01,083627,Boyle; Mary E. T.,13,0,60,47
1657618112535,COGS 118A,A01,083075,Gupta; Anjum,21,0,76,55
1657618118563,CSE 3,A50,083646,Miranda; Gregory Joseph,24,0,50,26
1657618124590,CSE 8A,A50,083650,Miranda; Gregory Joseph,17,1,56,39
1657618130618,CSE 11,A01,083080,Cao; Yingjun,6,15,40,34
1657618136644,CSE 12,A01,083652,Krause-Levy; Sophia Louisa,28,1,120,92
1657618142668,CSE 15L,A01,083654,Morris; Justin Loren,9,0,50,41
1657618142668,CSE 15L,A02,083655,Morris; Justin Loren,9,0,50,41
1657618148704,CSE 20,A01,083657,Tran; Khoa Dang,39,0,80,41
1657618154743,CSE 21,A01,095574,Bach; Quang Tran,22,0,48,26
1657618160774,CSE 30,A01,083084,Eldon; John,6,0,80,74
1657618160774,CSE 30,B01,095061,Bhaskar; Nishant,9,0,50,41
1657618166797,CSE 100,A01,083659,Cao; Yingjun,5,4,70,65
1657618172823,CSE 134B,A01,083661,Powell; Thomas Allan,22,0,100,78
1657618178847,CSE 140,A01,083663,Gungor; Onat,15,0,85,70
1657618184871,CSE 140L,A01,083088,Eldon; John,21,0,100,79
1657618190898,CSE 175,A01,083665,Kumar; Rakesh,3,0,25,22
1657618196925,CSE 190,A00,092507,Dubnov; Shlomo,8,0,20,12
1657618202948,ECE 45,A01,083139,Congero; Spencer William,6,0,75,69
1657618208971,ECE 65,A50,083695,Saad; Andrew S,12,0,30,18
1657618208971,ECE 65,A51,095125,Saad; Andrew S,24,0,26,2
1657618214995,ECE 109,A01,091882,Touri; Behrouz,19,0,70,51
1657618221020,ECE 180,A00,083140,Abi Samra; Nicholas Camill,1,0,30,29
1657618221020,ECE 180,B00,083141,Abi Samra; Nicholas Camill,0,0,30,30
1657618227045,MATH 10A,A01,083735,Patchell; Gregory David,2,0,30,28
1657618227045,MATH 10A,A02,083736,Patchell; Gregory David,20,0,30,10
1657618227045,MATH 10A,A03,083737,Patchell; Gregory David,16,0,30,14
1657618233071,MATH 10B,A01,083207,Lim; Seonhee,8,0,34,26
1657618233071,MATH 10B,A02,083208,Lim; Seonhee,9,0,35,26
1657618233071,MATH 10B,A03,093472,Lim; Seonhee,7,0,34,27
1657618233071,MATH 10B,B01,083739,Sinha; Shubham,12,0,30,18
1657618239107,MATH 18,A01,083743,Cinel; Cameron Alexander,7,0,30,23
1657618239107,MATH 18,A02,083744,Cinel; Cameron Alexander,17,0,30,13
1657618239107,MATH 18,A03,083745,Cinel; Cameron Alexander,9,0,30,21
1657618239107,MATH 18,B01,083748,Rideout; David Porter,5,0,37,32
1657618239107,MATH 18,B02,083749,Rideout; David Porter,5,0,36,31
1657618239107,MATH 18,B03,083750,Rideout; David Porter,3,0,37,34
1657618239107,MATH 18,B04,083751,Rideout; David Porter,6,0,36,30
1657618239107,MATH 18,B05,093473,Rideout; David Porter,6,0,36,30
1657618239107,MATH 18,B06,093474,Rideout; David Porter,6,0,36,30
1657618245139,MATH 20A,A01,083754,Zheng; Zequn,14,0,40,26
1657618251167,MATH 20B,A01,083756,Briones; Jor-el Thomas Caparas,4,0,36,32
1657618251167,MATH 20B,A02,083757,Briones; Jor-el Thomas Caparas,1,0,36,35
1657618251167,MATH 20B,A03,093475,Briones; Jor-el Thomas Caparas,2,0,36,34
1657618257195,MATH 20C,A01,083760,Briones; Jor-el Thomas Caparas,1,0,35,34
1657618257195,MATH 20C,A02,083761,Briones; Jor-el Thomas Caparas,8,0,35,27
1657618257195,MATH 20C,A03,093476,Briones; Jor-el Thomas Caparas,0,1,36,36
1657618257195,MATH 20C,B01,083762,Bach; Quang Tran,1,0,30,29
1657618263224,MATH 20D,A01,083765,Tran; Brian Kha,5,0,30,25
1657618263224,MATH 20D,A02,083766,Tran; Brian Kha,5,0,30,25
1657618263224,MATH 20D,A03,083767,Tran; Brian Kha,5,0,30,25
1657618269248,MATH 20E,A01,083771,Ganguly; Soumya,9,0,32,23
1657618269248,MATH 20E,A02,083772,Ganguly; Soumya,6,0,32,26
1657618269248,MATH 20E,B01,083773,Ciotti; Benjamin,20,0,35,15
1657618269248,MATH 20E,B02,083774,Ciotti; Benjamin,18,0,35,17
1657618275293,MATH 103A,A01,083777,Greenfeld; Be'Eri,3,0,36,33
1657618275293,MATH 103A,A02,083778,Greenfeld; Be'Eri,5,0,36,31
1657618275293,MATH 103A,A03,093561,Greenfeld; Be'Eri,6,0,36,30
1657618275293,MATH 103A,B01,083779,Greenfeld; Be'Eri,7,0,36,29
1657618275293,MATH 103A,B02,083780,Greenfeld; Be'Eri,4,0,36,32
1657618275293,MATH 103A,B03,093562,Greenfeld; Be'Eri,3,0,36,33
1657618281320,MATH 105,A01,085443,Carter; Anne Toulson,15,0,35,20
1657618281320,MATH 105,A02,093477,Carter; Anne Toulson,20,0,35,15
1657618287349,MATH 109,A01,083213,Ganzberger; Geoffrey Michael,2,0,34,32
1657618287349,MATH 109,A02,083214,Ganzberger; Geoffrey Michael,4,0,34,30
1657618287349,MATH 109,A03,093478,Ganzberger; Geoffrey Michael,2,0,34,32
1657618287349,MATH 109,B01,083215,Ganzberger; Geoffrey Michael,1,0,32,31
1657618287349,MATH 109,B02,083216,Ganzberger; Geoffrey Michael,2,0,32,30
1657618287349,MATH 109,B03,093479,Ganzberger; Geoffrey Michael,8,0,32,24
1657618293372,MATH 142A,A01,083219,Chow; Bennett,7,0,32,25
1657618293372,MATH 142A,A02,083220,Chow; Bennett,10,0,32,22
1657618293372,MATH 142A,A03,093480,Chow; Bennett,9,0,32,23
1657618293372,MATH 142A,B03,093481,Chow; Bennett,8,0,32,24
1657618293372,MATH 142A,B04,093558,Chow; Bennett,13,0,32,19
1657618293372,MATH 142A,B05,093559,Chow; Bennett,6,0,32,26
1657618299398,MATH 193A,A01,083224,Rotar; Vladimir,8,0,34,26
1657618299398,MATH 193A,A02,083225,Rotar; Vladimir,9,0,34,25
1657618299398,MATH 193A,A03,083781,Rotar; Vladimir,5,0,34,29
1657618299398,MATH 193A,A04,083782,Rotar; Vladimir,10,0,34,24
1657618299398,MATH 193A,A05,093482,Rotar; Vladimir,10,0,34,24
1657618305423,MATH 197,001,091859,McAuley; Julian John,9999,0,9999,0
1657618305423,MATH 197,002,095566,Kedlaya; Kiran S.,9997,0,9999,2
1657618305423,MATH 197,003,095567,Xiao; Ming,9999,0,9999,0
1657618305423,MATH 197,004,095571,Perols; Johan Lars,9998,0,9999,1
1657618312493,COGS 9,A01,083615,Shannon; Kyle Michael,9,0,75,66
1657618318517,COGS 11,A01,083617,Boyle; Mary E. T.,23,0,48,25
1657618324542,COGS 13,A01,083071,Bastos; Amalia Pinkusfeld,11,0,71,60
1657618330569,COGS 14A,A01,092681,Semenuks; Arturs,5,1,100,95
1657618336596,COGS 14B,A01,083073,Cheng; Tzu-Han,6,0,63,57
1657618342620,COGS 17,A01,092677,Semenuks; Arturs,6,0,81,75
1657618348644,COGS 100,A01,083619,Allen; Michael Gordon,17,0,70,53
1657618354672,COGS 101A,A01,083621,Davis; Joshua Daniel,9,0,68,59
1657618360696,COGS 101B,A01,091572,Allen; Michael Gordon,12,0,65,53
1657618366720,COGS 101C,A01,083625,Delgado; Tania,17,0,35,18
1657618372749,COGS 107A,A01,083627,Boyle; Mary E. T.,13,0,60,47
1657618378771,COGS 118A,A01,083075,Gupta; Anjum,21,0,76,55
1657618384795,CSE 3,A50,083646,Miranda; Gregory Joseph,24,0,50,26
1657618390822,CSE 8A,A50,083650,Miranda; Gregory Joseph,17,1,56,39
1657618396845,CSE 11,A01,083080,Cao; Yingjun,6,15,40,34
1657618402867,CSE 12,A01,083652,Krause-Levy; Sophia Louisa,28,1,120,92
1657618408892,CSE 15L,A01,083654,Morris; Justin Loren,9,0,50,41
1657618408892,CSE 15L,A02,083655,Morris; Justin Loren,9,0,50,41
1657618414919,CSE 20,A01,083657,Tran; Khoa Dang,39,0,80,41
1657618420945,CSE 21,A01,095574,Bach; Quang Tran,22,0,48,26
1657618427058,CSE 30,A01,083084,Eldon; John,6,0,80,74
1657618427058,CSE 30,B01,095061,Bhaskar; Nishant,9,0,50,41
1657618433082,CSE 100,A01,083659,Cao; Yingjun,5,4,70,65
1657618439105,CSE 134B,A01,083661,Powell; Thomas Allan,22,0,100,78
1657618445135,CSE 140,A01,083663,Gungor; Onat,15,0,85,70
1657618451159,CSE 140L,A01,083088,Eldon; John,21,0,100,79
1657618457184,CSE 175,A01,083665,Kumar; Rakesh,3,0,25,22
1657618463211,CSE 190,A00,092507,Dubnov; Shlomo,8,0,20,12
1657618469234,ECE 45,A01,083139,Congero; Spencer William,6,0,75,69
1657618475257,ECE 65,A50,083695,Saad; Andrew S,12,0,30,18
1657618475257,ECE 65,A51,095125,Saad; Andrew S,24,0,26,2
1657618481280,ECE 109,A01,091882,Touri; Behrouz,19,0,70,51
1657618487307,ECE 180,A00,083140,Abi Samra; Nicholas Camill,1,0,30,29
1657618487307,ECE 180,B00,083141,Abi Samra; Nicholas Camill,0,0,30,30
1657618493335,MATH 10A,A01,083735,Patchell; Gregory David,2,0,30,28
1657618493335,MATH 10A,A02,083736,Patchell; Gregory David,20,0,30,10
1657618493335,MATH 10A,A03,083737,Patchell; Gregory David,16,0,30,14
1657618499362,MATH 10B,A01,083207,Lim; Seonhee,8,0,34,26
1657618499362,MATH 10B,A02,083208,Lim; Seonhee,9,0,35,26
1657618499362,MATH 10B,A03,093472,Lim; Seonhee,7,0,34,27
1657618499362,MATH 10B,B01,083739,Sinha; Shubham,12,0,30,18
1657618505386,MATH 18,A01,083743,Cinel; Cameron Alexander,7,0,30,23
1657618505386,MATH 18,A02,083744,Cinel; Cameron Alexander,17,0,30,13
1657618505386,MATH 18,A03,083745,Cinel; Cameron Alexander,9,0,30,21
1657618505386,MATH 18,B01,083748,Rideout; David Porter,5,0,37,32
1657618505386,MATH 18,B02,083749,Rideout; David Porter,5,0,36,31
1657618505386,MATH 18,B03,083750,Rideout; David Porter,3,0,37,34
1657618505386,MATH 18,B04,083751,Rideout; David Porter,6,0,36,30
1657618505386,MATH 18,B05,093473,Rideout; David Porter,6,0,36,30
1657618505386,MATH 18,B06,093474,Rideout; David Porter,6,0,36,30
1657618511413,MATH 20A,A01,083754,Zheng; Zequn,14,0,40,26
1657618517439,MATH 20B,A01,083756,Briones; Jor-el Thomas Caparas,4,0,36,32
1657618517439,MATH 20B,A02,083757,Briones; Jor-el Thomas Caparas,1,0,36,35
1657618517439,MATH 20B,A03,093475,Briones; Jor-el Thomas Caparas,2,0,36,34
1657618523463,MATH 20C,A01,083760,Briones; Jor-el Thomas Caparas,1,0,35,34
1657618523463,MATH 20C,A02,083761,Briones; Jor-el Thomas Caparas,8,0,35,27
1657618523463,MATH 20C,A03,093476,Briones; Jor-el Thomas Caparas,0,1,36,36
1657618523463,MATH 20C,B01,083762,Bach; Quang Tran,1,0,30,29
1657618529486,MATH 20D,A01,083765,Tran; Brian Kha,5,0,30,25
1657618529486,MATH 20D,A02,083766,Tran; Brian Kha,5,0,30,25
1657618529486,MATH 20D,A03,083767,Tran; Brian Kha,5,0,30,25
1657618535508,MATH 20E,A01,083771,Ganguly; Soumya,9,0,32,23
1657618535508,MATH 20E,A02,083772,Ganguly; Soumya,6,0,32,26
1657618535508,MATH 20E,B01,083773,Ciotti; Benjamin,20,0,35,15
1657618535508,MATH 20E,B02,083774,Ciotti; Benjamin,18,0,35,17
1657618541538,MATH 103A,A01,083777,Greenfeld; Be'Eri,3,0,36,33
1657618541538,MATH 103A,A02,083778,Greenfeld; Be'Eri,5,0,36,31
1657618541538,MATH 103A,A03,093561,Greenfeld; Be'Eri,6,0,36,30
1657618541538,MATH 103A,B01,083779,Greenfeld; Be'Eri,7,0,36,29
1657618541538,MATH 103A,B02,083780,Greenfeld; Be'Eri,4,0,36,32
1657618541538,MATH 103A,B03,093562,Greenfeld; Be'Eri,3,0,36,33
1657618547565,MATH 105,A01,085443,Carter; Anne Toulson,15,0,35,20
1657618547565,MATH 105,A02,093477,Carter; Anne Toulson,20,0,35,15
1657618553591,MATH 109,A01,083213,Ganzberger; Geoffrey Michael,2,0,34,32
1657618553591,MATH 109,A02,083214,Ganzberger; Geoffrey Michael,4,0,34,30
1657618553591,MATH 109,A03,093478,Ganzberger; Geoffrey Michael,2,0,34,32
1657618553591,MATH 109,B01,083215,Ganzberger; Geoffrey Michael,1,0,32,31
1657618553591,MATH 109,B02,083216,Ganzberger; Geoffrey Michael,2,0,32,30
1657618553591,MATH 109,B03,093479,Ganzberger; Geoffrey Michael,8,0,32,24
1657618559615,MATH 142A,A01,083219,Chow; Bennett,7,0,32,25
1657618559615,MATH 142A,A02,083220,Chow; Bennett,10,0,32,22
1657618559615,MATH 142A,A03,093480,Chow; Bennett,9,0,32,23
1657618559615,MATH 142A,B03,093481,Chow; Bennett,8,0,32,24
1657618559615,MATH 142A,B04,093558,Chow; Bennett,13,0,32,19
1657618559615,MATH 142A,B05,093559,Chow; Bennett,6,0,32,26
1657618565639,MATH 193A,A01,083224,Rotar; Vladimir,8,0,34,26
1657618565639,MATH 193A,A02,083225,Rotar; Vladimir,9,0,34,25
1657618565639,MATH 193A,A03,083781,Rotar; Vladimir,5,0,34,29
1657618565639,MATH 193A,A04,083782,Rotar; Vladimir,10,0,34,24
1657618565639,MATH 193A,A05,093482,Rotar; Vladimir,10,0,34,24
1657618571662,MATH 197,001,091859,McAuley; Julian John,9999,0,9999,0
1657618571662,MATH 197,002,095566,Kedlaya; Kiran S.,9997,0,9999,2
1657618571662,MATH 197,003,095567,Xiao; Ming,9999,0,9999,0
1657618571662,MATH 197,004,095571,Perols; Johan Lars,9998,0,9999,1
1657618578724,COGS 9,A01,083615,Shannon; Kyle Michael,9,0,75,66
1657618584748,COGS 11,A01,083617,Boyle; Mary E. T.,23,0,48,25
1657618590775,COGS 13,A01,083071,Bastos; Amalia Pinkusfeld,11,0,71,60
1657618596798,COGS 14A,A01,092681,Semenuks; Arturs,5,1,100,95
1657618602821,COGS 14B,A01,083073,Cheng; Tzu-Han,6,0,63,57
1657618608842,COGS 17,A01,092677,Semenuks; Arturs,6,0,81,75
1657618614865,COGS 100,A01,083619,Allen; Michael Gordon,17,0,70,53
1657618620888,COGS 101A,A01,083621,Davis; Joshua Daniel,9,0,68,59
1657618626924,COGS 101B,A01,091572,Allen; Michael Gordon,12,0,65,53
1657618632951,COGS 101C,A01,083625,Delgado; Tania,17,0,35,18
1657618638977,COGS 107A,A01,083627,Boyle; Mary E. T.,13,0,60,47
1657618644999,COGS 118A,A01,083075,Gupta; Anjum,21,0,76,55
1657618651025,CSE 3,A50,083646,Miranda; Gregory Joseph,24,0,50,26
1657618657048,CSE 8A,A50,083650,Miranda; Gregory Joseph,17,1,56,39
1657618663072,CSE 11,A01,083080,Cao; Yingjun,6,15,40,34
1657618669097,CSE 12,A01,083652,Krause-Levy; Sophia Louisa,28,1,120,92
1657618675120,CSE 15L,A01,083654,Morris; Justin Loren,9,0,50,41
1657618675120,CSE 15L,A02,083655,Morris; Justin Loren,9,0,50,41
1657618681145,CSE 20,A01,083657,Tran; Khoa Dang,39,0,80,41
1657618687168,CSE 21,A01,095574,Bach; Quang Tran,22,0,48,26
1657618693195,CSE 30,A01,083084,Eldon; John,6,0,80,74
1657618693195,CSE 30,B01,095061,Bhaskar; Nishant,9,0,50,41
1657618699223,CSE 100,A01,083659,Cao; Yingjun,5,4,70,65
1657618705250,CSE 134B,A01,083661,Powell; Thomas Allan,22,0,100,78
1657618711273,CSE 140,A01,083663,Gungor; Onat,15,0,85,70
1657618717299,CSE 140L,A01,083088,Eldon; John,21,0,100,79
1657618723321,CSE 175,A01,083665,Kumar; Rakesh,3,0,25,22
1657618729348,CSE 190,A00,092507,Dubnov; Shlomo,8,0,20,12
1657618735372,ECE 45,A01,083139,Congero; Spencer William,6,0,75,69
1657618741400,ECE 65,A50,083695,Saad; Andrew S,12,0,30,18
1657618741400,ECE 65,A51,095125,Saad; Andrew S,24,0,26,2
1657618747422,ECE 109,A01,091882,Touri; Behrouz,19,0,70,51
1657618753449,ECE 180,A00,083140,Abi Samra; Nicholas Camill,1,0,30,29
1657618753449,ECE 180,B00,083141,Abi Samra; Nicholas Camill,0,0,30,30
1657618759471,MATH 10A,A01,083735,Patchell; Gregory David,2,0,30,28
1657618759471,MATH 10A,A02,083736,Patchell; Gregory David,20,0,30,10
1657618759471,MATH 10A,A03,083737,Patchell; Gregory David,16,0,30,14
1657618765495,MATH 10B,A01,083207,Lim; Seonhee,8,0,34,26
1657618765495,MATH 10B,A02,083208,Lim; Seonhee,9,0,35,26
1657618765495,MATH 10B,A03,093472,Lim; Seonhee,7,0,34,27
1657618765495,MATH 10B,B01,083739,Sinha; Shubham,12,0,30,18
1657618771517,MATH 18,A01,083743,Cinel; Cameron Alexander,7,0,30,23
1657618771517,MATH 18,A02,083744,Cinel; Cameron Alexander,17,0,30,13
1657618771517,MATH 18,A03,083745,Cinel; Cameron Alexander,9,0,30,21
1657618771517,MATH 18,B01,083748,Rideout; David Porter,5,0,37,32
1657618771517,MATH 18,B02,083749,Rideout; David Porter,5,0,36,31
1657618771517,MATH 18,B03,083750,Rideout; David Porter,3,0,37,34
1657618771517,MATH 18,B04,083751,Rideout; David Porter,6,0,36,30
1657618771517,MATH 18,B05,093473,Rideout; David Porter,6,0,36,30
1657618771517,MATH 18,B06,093474,Rideout; David Porter,6,0,36,30
1657618777543,MATH 20A,A01,083754,Zheng; Zequn,14,0,40,26
1657618783566,MATH 20B,A01,083756,Briones; Jor-el Thomas Caparas,4,0,36,32
1657618783566,MATH 20B,A02,083757,Briones; Jor-el Thomas Caparas,1,0,36,35
1657618783566,MATH 20B,A03,093475,Briones; Jor-el Thomas Caparas,2,0,36,34
1657618789594,MATH 20C,A01,083760,Briones; Jor-el Thomas Caparas,1,0,35,34
1657618789594,MATH 20C,A02,083761,Briones; Jor-el Thomas Caparas,8,0,35,27
1657618789594,MATH 20C,A03,093476,Briones; Jor-el Thomas Caparas,0,1,36,36
1657618789594,MATH 20C,B01,083762,Bach; Quang Tran,1,0,30,29
1657618795621,MATH 20D,A01,083765,Tran; Brian Kha,5,0,30,25
1657618795621,MATH 20D,A02,083766,Tran; Brian Kha,5,0,30,25
1657618795621,MATH 20D,A03,083767,Tran; Brian Kha,5,0,30,25
1657618801646,MATH 20E,A01,083771,Ganguly; Soumya,9,0,32,23
1657618801646,MATH 20E,A02,083772,Ganguly; Soumya,6,0,32,26
1657618801646,MATH 20E,B01,083773,Ciotti; Benjamin,20,0,35,15
1657618801646,MATH 20E,B02,083774,Ciotti; Benjamin,18,0,35,17
1657618807674,MATH 103A,A01,083777,Greenfeld; Be'Eri,3,0,36,33
1657618807674,MATH 103A,A02,083778,Greenfeld; Be'Eri,5,0,36,31
1657618807674,MATH 103A,A03,093561,Greenfeld; Be'Eri,6,0,36,30
1657618807674,MATH 103A,B01,083779,Greenfeld; Be'Eri,7,0,36,29
1657618807674,MATH 103A,B02,083780,Greenfeld; Be'Eri,4,0,36,32
1657618807674,MATH 103A,B03,093562,Greenfeld; Be'Eri,3,0,36,33
1657618813699,MATH 105,A01,085443,Carter; Anne Toulson,15,0,35,20
1657618813699,MATH 105,A02,093477,Carter; Anne Toulson,20,0,35,15
1657618819726,MATH 109,A01,083213,Ganzberger; Geoffrey Michael,2,0,34,32
1657618819726,MATH 109,A02,083214,Ganzberger; Geoffrey Michael,4,0,34,30
1657618819726,MATH 109,A03,093478,Ganzberger; Geoffrey Michael,2,0,34,32
1657618819726,MATH 109,B01,083215,Ganzberger; Geoffrey Michael,1,0,32,31
1657618819726,MATH 109,B02,083216,Ganzberger; Geoffrey Michael,2,0,32,30
1657618819726,MATH 109,B03,093479,Ganzberger; Geoffrey Michael,8,0,32,24
1657618825750,MATH 142A,A01,083219,Chow; Bennett,7,0,32,25
1657618825750,MATH 142A,A02,083220,Chow; Bennett,10,0,32,22
1657618825750,MATH 142A,A03,093480,Chow; Bennett,9,0,32,23
1657618825750,MATH 142A,B03,093481,Chow; Bennett,8,0,32,24
1657618825750,MATH 142A,B04,093558,Chow; Bennett,13,0,32,19
1657618825750,MATH 142A,B05,093559,Chow; Bennett,6,0,32,26
1657618831772,MATH 193A,A01,083224,Rotar; Vladimir,8,0,34,26
1657618831772,MATH 193A,A02,083225,Rotar; Vladimir,9,0,34,25
1657618831772,MATH 193A,A03,083781,Rotar; Vladimir,5,0,34,29
1657618831772,MATH 193A,A04,083782,Rotar; Vladimir,10,0,34,24
1657618831772,MATH 193A,A05,093482,Rotar; Vladimir,10,0,34,24
1657618837797,MATH 197,001,091859,McAuley; Julian John,9999,0,9999,0
1657618837797,MATH 197,002,095566,Kedlaya; Kiran S.,9997,0,9999,2
1657618837797,MATH 197,003,095567,Xiao; Ming,9999,0,9999,0
1657618837797,MATH 197,004,095571,Perols; Johan Lars,9998,0,9999,1
1657618844861,COGS 9,A01,083615,Shannon; Kyle Michael,9,0,75,66
1657618850884,COGS 11,A01,083617,Boyle; Mary E. T.,23,0,48,25
1657618856907,COGS 13,A01,083071,Bastos; Amalia Pinkusfeld,11,0,71,60
1657618862931,COGS 14A,A01,092681,Semenuks; Arturs,5,1,100,95
1657618868955,COGS 14B,A01,083073,Cheng; Tzu-Han,6,0,63,57
1657618874978,COGS 17,A01,092677,Semenuks; Arturs,6,0,81,75
1657618881000,COGS 100,A01,083619,Allen; Michael Gordon,17,0,70,53
1657618887024,COGS 101A,A01,083621,Davis; Joshua Daniel,9,0,68,59
1657618893047,COGS 101B,A01,091572,Allen; Michael Gordon,12,0,65,53
1657618899081,COGS 101C,A01,083625,Delgado; Tania,17,0,35,18
1657618905105,COGS 107A,A01,083627,Boyle; Mary E. T.,13,0,60,47
1657618911132,COGS 118A,A01,083075,Gupta; Anjum,21,0,76,55
1657618917156,CSE 3,A50,083646,Miranda; Gregory Joseph,24,0,50,26
1657618923184,CSE 8A,A50,083650,Miranda; Gregory Joseph,17,1,56,39
1657618929207,CSE 11,A01,083080,Cao; Yingjun,6,15,40,34
1657618935232,CSE 12,A01,083652,Krause-Levy; Sophia Louisa,28,1,120,92
1657618941256,CSE 15L,A01,083654,Morris; Justin Loren,9,0,50,41
1657618941256,CSE 15L,A02,083655,Morris; Justin Loren,9,0,50,41
1657618947282,CSE 20,A01,083657,Tran; Khoa Dang,39,0,80,41
1657618953307,CSE 21,A01,095574,Bach; Quang Tran,22,0,48,26
1657618959331,CSE 30,A01,083084,Eldon; John,6,0,80,74
1657618959331,CSE 30,B01,095061,Bhaskar; Nishant,9,0,50,41
1657618965355,CSE 100,A01,083659,Cao; Yingjun,5,4,70,65
1657618971378,CSE 134B,A01,083661,Powell; Thomas Allan,22,0,100,78
1657618977400,CSE 140,A01,083663,Gungor; Onat,15,0,85,70
1657618983424,CSE 140L,A01,083088,Eldon; John,21,0,100,79
1657618989447,CSE 175,A01,083665,Kumar; Rakesh,3,0,25,22
1657618995469,CSE 190,A00,092507,Dubnov; Shlomo,8,0,20,12
1657619001494,ECE 45,A01,083139,Congero; Spencer William,6,0,75,69
1657619007518,ECE 65,A50,083695,Saad; Andrew S,12,0,30,18
1657619007518,ECE 65,A51,095125,Saad; Andrew S,24,0,26,2
1657619013539,ECE 109,A01,091882,Touri; Behrouz,19,0,70,51
1657619019563,ECE 180,A00,083140,Abi Samra; Nicholas Camill,1,0,30,29
1657619019563,ECE 180,B00,083141,Abi Samra; Nicholas Camill,0,0,30,30
1657619025671,MATH 10A,A01,083735,Patchell; Gregory David,2,0,30,28
1657619025671,MATH 10A,A02,083736,Patchell; Gregory David,20,0,30,10
1657619025671,MATH 10A,A03,083737,Patchell; Gregory David,16,0,30,14
1657619031694,MATH 10B,A01,083207,Lim; Seonhee,8,0,34,26
1657619031694,MATH 10B,A02,083208,Lim; Seonhee,9,0,35,26
1657619031694,MATH 10B,A03,093472,Lim; Seonhee,7,0,34,27
1657619031694,MATH 10B,B01,083739,Sinha; Shubham,12,0,30,18
1657619037718,MATH 18,A01,083743,Cinel; Cameron Alexander,7,0,30,23
1657619037718,MATH 18,A02,083744,Cinel; Cameron Alexander,17,0,30,13
1657619037718,MATH 18,A03,083745,Cinel; Cameron Alexander,9,0,30,21
1657619037718,MATH 18,B01,083748,Rideout; David Porter,5,0,37,32
1657619037718,MATH 18,B02,083749,Rideout; David Porter,5,0,36,31
1657619037718,MATH 18,B03,083750,Rideout; David Porter,3,0,37,34
1657619037718,MATH 18,B04,083751,Rideout; David Porter,6,0,36,30
1657619037718,MATH 18,B05,093473,Rideout; David Porter,6,0,36,30
1657619037718,MATH 18,B06,093474,Rideout; David Porter,6,0,36,30
1657619043742,MATH 20A,A01,083754,Zheng; Zequn,14,0,40,26
1657619049764,MATH 20B,A01,083756,Briones; Jor-el Thomas Caparas,4,0,36,32
1657619049764,MATH 20B,A02,083757,Briones; Jor-el Thomas Caparas,1,0,36,35
1657619049764,MATH 20B,A03,093475,Briones; Jor-el Thomas Caparas,2,0,36,34
1657619055787,MATH 20C,A01,083760,Briones; Jor-el Thomas Caparas,1,0,35,34
1657619055787,MATH 20C,A02,083761,Briones; Jor-el Thomas Caparas,8,0,35,27
1657619055787,MATH 20C,A03,093476,Briones; Jor-el Thomas Caparas,0,1,36,36
1657619055787,MATH 20C,B01,083762,Bach; Quang Tran,1,0,30,29
1657619061810,MATH 20D,A01,083765,Tran; Brian Kha,5,0,30,25
1657619061810,MATH 20D,A02,083766,Tran; Brian Kha,5,0,30,25
1657619061810,MATH 20D,A03,083767,Tran; Brian Kha,5,0,30,25
1657619067847,MATH 20E,A01,083771,Ganguly; Soumya,9,0,32,23
1657619067847,MATH 20E,A02,083772,Ganguly; Soumya,6,0,32,26
1657619067847,MATH 20E,B01,083773,Ciotti; Benjamin,20,0,35,15
1657619067847,MATH 20E,B02,083774,Ciotti; Benjamin,18,0,35,17
1657619073871,MATH 103A,A01,083777,Greenfeld; Be'Eri,3,0,36,33
1657619073871,MATH 103A,A02,083778,Greenfeld; Be'Eri,5,0,36,31
1657619073871,MATH 103A,A03,093561,Greenfeld; Be'Eri,6,0,36,30
1657619073871,MATH 103A,B01,083779,Greenfeld; Be'Eri,7,0,36,29
1657619073871,MATH 103A,B02,083780,Greenfeld; Be'Eri,4,0,36,32
1657619073871,MATH 103A,B03,093562,Greenfeld; Be'Eri,3,0,36,33
1657619079899,MATH 105,A01,085443,Carter; Anne Toulson,15,0,35,20
1657619079899,MATH 105,A02,093477,Carter; Anne Toulson,20,0,35,15
1657619085928,MATH 109,A01,083213,Ganzberger; Geoffrey Michael,2,0,34,32
1657619085928,MATH 109,A02,083214,Ganzberger; Geoffrey Michael,4,0,34,30
1657619085928,MATH 109,A03,093478,Ganzberger; Geoffrey Michael,2,0,34,32
1657619085928,MATH 109,B01,083215,Ganzberger; Geoffrey Michael,1,0,32,31
1657619085928,MATH 109,B02,083216,Ganzberger; Geoffrey Michael,2,0,32,30
1657619085928,MATH 109,B03,093479,Ganzberger; Geoffrey Michael,8,0,32,24
1657619091957,MATH 142A,A01,083219,Chow; Bennett,7,0,32,25
1657619091957,MATH 142A,A02,083220,Chow; Bennett,10,0,32,22
1657619091957,MATH 142A,A03,093480,Chow; Bennett,9,0,32,23
1657619091957,MATH 142A,B03,093481,Chow; Bennett,8,0,32,24
1657619091957,MATH 142A,B04,093558,Chow; Bennett,13,0,32,19
1657619091957,MATH 142A,B05,093559,Chow; Bennett,6,0,32,26
1657619097981,MATH 193A,A01,083224,Rotar; Vladimir,8,0,34,26
1657619097981,MATH 193A,A02,083225,Rotar; Vladimir,9,0,34,25
1657619097981,MATH 193A,A03,083781,Rotar; Vladimir,5,0,34,29
1657619097981,MATH 193A,A04,083782,Rotar; Vladimir,10,0,34,24
1657619097981,MATH 193A,A05,093482,Rotar; Vladimir,10,0,34,24
1657619104003,MATH 197,001,091859,McAuley; Julian John,9999,0,9999,0
1657619104003,MATH 197,002,095566,Kedlaya; Kiran S.,9997,0,9999,2
1657619104003,MATH 197,003,095567,Xiao; Ming,9999,0,9999,0
1657619104003,MATH 197,004,095571,Perols; Johan Lars,9998,0,9999,1
1657619111067,COGS 9,A01,083615,Shannon; Kyle Michael,9,0,75,66
1657619117091,COGS 11,A01,083617,Boyle; Mary E. T.,23,0,48,25
1657619123118,COGS 13,A01,083071,Bastos; Amalia Pinkusfeld,11,0,71,60
1657619129141,COGS 14A,A01,092681,Semenuks; Arturs,5,1,100,95
1657619135164,COGS 14B,A01,083073,Cheng; Tzu-Han,6,0,63,57
1657619141188,COGS 17,A01,092677,Semenuks; Arturs,6,0,81,75
1657619147214,COGS 100,A01,083619,Allen; Michael Gordon,17,0,70,53
1657619153246,COGS 101A,A01,083621,Davis; Joshua Daniel,9,0,68,59
1657619159273,COGS 101B,A01,091572,Allen; Michael Gordon,12,0,65,53
1657619165297,COGS 101C,A01,083625,Delgado; Tania,17,0,35,18
1657619171321,COGS 107A,A01,083627,Boyle; Mary E. T.,13,0,60,47
1657619177347,COGS 118A,A01,083075,Gupta; Anjum,21,0,76,55
1657619183374,CSE 3,A50,083646,Miranda; Gregory Joseph,24,0,50,26
1657619189396,CSE 8A,A50,083650,Miranda; Gregory Joseph,17,1,56,39
1657619195422,CSE 11,A01,083080,Cao; Yingjun,6,15,40,34
1657619201449,CSE 12,A01,083652,Krause-Levy; Sophia Louisa,28,1,120,92
1657619207472,CSE 15L,A01,083654,Morris; Justin Loren,9,0,50,41
1657619207472,CSE 15L,A02,083655,Morris; Justin Loren,9,0,50,41
1657619213496,CSE 20,A01,083657,Tran; Khoa Dang,39,0,80,41
1657619219523,CSE 21,A01,095574,Bach; Quang Tran,22,0,48,26
1657619225545,CSE 30,A01,083084,Eldon; John,6,0,80,74
1657619225545,CSE 30,B01,095061,Bhaskar; Nishant,9,0,50,41
1657619231574,CSE 100,A01,083659,Cao; Yingjun,5,4,70,65
1657619237598,CSE 134B,A01,083661,Powell; Thomas Allan,22,0,100,78
1657619243626,CSE 140,A01,083663,Gungor; Onat,15,0,85,70
1657619249650,CSE 140L,A01,083088,Eldon; John,21,0,100,79
1657619255672,CSE 175,A01,083665,Kumar; Rakesh,3,0,25,22
1657619261702,CSE 190,A00,092507,Dubnov; Shlomo,8,0,20,12
1657619267727,ECE 45,A01,083139,Congero; Spencer William,6,0,75,69
1657619273754,ECE 65,A50,083695,Saad; Andrew S,12,0,30,18
1657619273754,ECE 65,A51,095125,Saad; Andrew S,24,0,26,2
1657619279777,ECE 109,A01,091882,Touri; Behrouz,19,0,70,51
1657619285799,ECE 180,A00,083140,Abi Samra; Nicholas Camill,1,0,30,29
1657619285799,ECE 180,B00,083141,Abi Samra; Nicholas Camill,0,0,30,30
1657619291822,MATH 10A,A01,083735,Patchell; Gregory David,2,0,30,28
1657619291822,MATH 10A,A02,083736,Patchell; Gregory David,20,0,30,10
1657619291822,MATH 10A,A03,083737,Patchell; Gregory David,16,0,30,14
1657619297849,MATH 10B,A01,083207,Lim; Seonhee,8,0,34,26
1657619297849,MATH 10B,A02,083208,Lim; Seonhee,9,0,35,26
1657619297849,MATH 10B,A03,093472,Lim; Seonhee,7,0,34,27
1657619297849,MATH 10B,B01,083739,Sinha; Shubham,12,0,30,18
1657619303875,MATH 18,A01,083743,Cinel; Cameron Alexander,7,0,30,23
1657619303875,MATH 18,A02,083744,Cinel; Cameron Alexander,17,0,30,13
1657619303875,MATH 18,A03,083745,Cinel; Cameron Alexander,9,0,30,21
1657619303875,MATH 18,B01,083748,Rideout; David Porter,5,0,37,32
1657619303875,MATH 18,B02,083749,Rideout; David Porter,5,0,36,31
1657619303875,MATH 18,B03,083750,Rideout; David Porter,3,0,37,34
1657619303875,MATH 18,B04,083751,Rideout; David Porter,6,0,36,30
1657619303875,MATH 18,B05,093473,Rideout; David Porter,6,0,36,30
1657619303875,MATH 18,B06,093474,Rideout; David Porter,6,0,36,30
1657619309900,MATH 20A,A01,083754,Zheng; Zequn,14,0,40,26
1657619315927,MATH 20B,A01,083756,Briones; Jor-el Thomas Caparas,4,0,36,32
1657619315927,MATH 20B,A02,083757,Briones; Jor-el Thomas Caparas,1,0,36,35
1657619315927,MATH 20B,A03,093475,Briones; Jor-el Thomas Caparas,2,0,36,34
1657619321952,MATH 20C,A01,083760,Briones; Jor-el Thomas Caparas,1,0,35,34
1657619321952,MATH 20C,A02,083761,Briones; Jor-el Thomas Caparas,8,0,35,27
1657619321952,MATH 20C,A03,093476,Briones; Jor-el Thomas Caparas,0,1,36,36
1657619321952,MATH 20C,B01,083762,Bach; Quang Tran,1,0,30,29
1657619327983,MATH 20D,A01,083765,Tran; Brian Kha,5,0,30,25
1657619327983,MATH 20D,A02,083766,Tran; Brian Kha,5,0,30,25
1657619327983,MATH 20D,A03,083767,Tran; Brian Kha,5,0,30,25
1657619334008,MATH 20E,A01,083771,Ganguly; Soumya,9,0,32,23
1657619334008,MATH 20E,A02,083772,Ganguly; Soumya,6,0,32,26
1657619334008,MATH 20E,B01,083773,Ciotti; Benjamin,20,0,35,15
1657619334008,MATH 20E,B02,083774,Ciotti; Benjamin,18,0,35,17
1657619340032,MATH 103A,A01,083777,Greenfeld; Be'Eri,3,0,36,33
1657619340032,MATH 103A,A02,083778,Greenfeld; Be'Eri,5,0,36,31
1657619340032,MATH 103A,A03,093561,Greenfeld; Be'Eri,6,0,36,30
1657619340032,MATH 103A,B01,083779,Greenfeld; Be'Eri,7,0,36,29
1657619340032,MATH 103A,B02,083780,Greenfeld; Be'Eri,4,0,36,32
1657619340032,MATH 103A,B03,093562,Greenfeld; Be'Eri,3,0,36,33
1657619346054,MATH 105,A01,085443,Carter; Anne Toulson,15,0,35,20
1657619346054,MATH 105,A02,093477,Carter; Anne Toulson,20,0,35,15
1657619352079,MATH 109,A01,083213,Ganzberger; Geoffrey Michael,2,0,34,32
1657619352079,MATH 109,A02,083214,Ganzberger; Geoffrey Michael,4,0,34,30
1657619352079,MATH 109,A03,093478,Ganzberger; Geoffrey Michael,2,0,34,32
1657619352079,MATH 109,B01,083215,Ganzberger; Geoffrey Michael,1,0,32,31
1657619352079,MATH 109,B02,083216,Ganzberger; Geoffrey Michael,2,0,32,30
1657619352079,MATH 109,B03,093479,Ganzberger; Geoffrey Michael,8,0,32,24
1657619358116,MATH 142A,A01,083219,Chow; Bennett,7,0,32,25
1657619358116,MATH 142A,A02,083220,Chow; Bennett,10,0,32,22
1657619358116,MATH 142A,A03,093480,Chow; Bennett,9,0,32,23
1657619358116,MATH 142A,B03,093481,Chow; Bennett,8,0,32,24
1657619358116,MATH 142A,B04,093558,Chow; Bennett,13,0,32,19
1657619358116,MATH 142A,B05,093559,Chow; Bennett,6,0,32,26
1657619364139,MATH 193A,A01,083224,Rotar; Vladimir,8,0,34,26
1657619364139,MATH 193A,A02,083225,Rotar; Vladimir,9,0,34,25
1657619364139,MATH 193A,A03,083781,Rotar; Vladimir,5,0,34,29
1657619364139,MATH 193A,A04,083782,Rotar; Vladimir,10,0,34,24
1657619364139,MATH 193A,A05,093482,Rotar; Vladimir,10,0,34,24
1657619370164,MATH 197,001,091859,McAuley; Julian John,9999,0,9999,0
1657619370164,MATH 197,002,095566,Kedlaya; Kiran S.,9997,0,9999,2
1657619370164,MATH 197,003,095567,Xiao; Ming,9999,0,9999,0
1657619370164,MATH 197,004,095571,Perols; Johan Lars,9998,0,9999,1
1657619377214,COGS 9,A01,083615,Shannon; Kyle Michael,9,0,75,66
1657619383237,COGS 11,A01,083617,Boyle; Mary E. T.,23,0,48,25
1657619389260,COGS 13,A01,083071,Bastos; Amalia Pinkusfeld,11,0,71,60
1657619395288,COGS 14A,A01,092681,Semenuks; Arturs,5,1,100,95
1657619401313,COGS 14B,A01,083073,Cheng; Tzu-Han,6,0,63,57
1657619407337,COGS 17,A01,092677,Semenuks; Arturs,6,0,81,75
1657619413359,COGS 100,A01,083619,Allen; Michael Gordon,17,0,70,53
1657619419381,COGS 101A,A01,083621,Davis; Joshua Daniel,9,0,68,59
1657619425408,COGS 101B,A01,091572,Allen; Michael Gordon,12,0,65,53
1657619431435,COGS 101C,A01,083625,Delgado; Tania,17,0,35,18
1657619437459,COGS 107A,A01,083627,Boyle; Mary E. T.,13,0,60,47
1657619443484,COGS 118A,A01,083075,Gupta; Anjum,21,0,76,55
1657619449510,CSE 3,A50,083646,Miranda; Gregory Joseph,24,0,50,26
1657619455535,CSE 8A,A50,083650,Miranda; Gregory Joseph,17,1,56,39
1657619461558,CSE 11,A01,083080,Cao; Yingjun,6,15,40,34
1657619467580,CSE 12,A01,083652,Krause-Levy; Sophia Louisa,28,1,120,92
1657619473606,CSE 15L,A01,083654,Morris; Justin Loren,9,0,50,41
1657619473606,CSE 15L,A02,083655,Morris; Justin Loren,9,0,50,41
1657619479627,CSE 20,A01,083657,Tran; Khoa Dang,39,0,80,41
1657619485649,CSE 21,A01,095574,Bach; Quang Tran,22,0,48,26
1657619491675,CSE 30,A01,083084,Eldon; John,6,0,80,74
1657619491675,CSE 30,B01,095061,Bhaskar; Nishant,9,0,50,41
1657619497701,CSE 100,A01,083659,Cao; Yingjun,5,4,70,65
1657619503728,CSE 134B,A01,083661,Powell; Thomas Allan,22,0,100,78
1657619509750,CSE 140,A01,083663,Gungor; Onat,15,0,85,70
1657619515775,CSE 140L,A01,083088,Eldon; John,21,0,100,79
1657619521803,CSE 175,A01,083665,Kumar; Rakesh,3,0,25,22
1657619527827,CSE 190,A00,092507,Dubnov; Shlomo,8,0,20,12
1657619533853,ECE 45,A01,083139,Congero; Spencer William,6,0,75,69
1657619539880,ECE 65,A50,083695,Saad; Andrew S,12,0,30,18
1657619539880,ECE 65,A51,095125,Saad; Andrew S,24,0,26,2
1657619545905,ECE 109,A01,091882,Touri; Behrouz,19,0,70,51
1657619551932,ECE 180,A00,083140,Abi Samra; Nicholas Camill,1,0,30,29
1657619551932,ECE 180,B00,083141,Abi Samra; Nicholas Camill,0,0,30,30
1657619557955,MATH 10A,A01,083735,Patchell; Gregory David,2,0,30,28
1657619557955,MATH 10A,A02,083736,Patchell; Gregory David,20,0,30,10
1657619557955,MATH 10A,A03,083737,Patchell; Gregory David,16,0,30,14
1657619563978,MATH 10B,A01,083207,Lim; Seonhee,8,0,34,26
1657619563978,MATH 10B,A02,083208,Lim; Seonhee,9,0,35,26
1657619563978,MATH 10B,A03,093472,Lim; Seonhee,7,0,34,27
1657619563978,MATH 10B,B01,083739,Sinha; Shubham,12,0,30,18
1657619570009,MATH 18,A01,083743,Cinel; Cameron Alexander,7,0,30,23
1657619570009,MATH 18,A02,083744,Cinel; Cameron Alexander,17,0,30,13
1657619570009,MATH 18,A03,083745,Cinel; Cameron Alexander,9,0,30,21
1657619570009,MATH 18,B01,083748,Rideout; David Porter,5,0,37,32
1657619570009,MATH 18,B02,083749,Rideout; David Porter,5,0,36,31
1657619570009,MATH 18,B03,083750,Rideout; David Porter,3,0,37,34
1657619570009,MATH 18,B04,083751,Rideout; David Porter,6,0,36,30
1657619570009,MATH 18,B05,093473,Rideout; David Porter,6,0,36,30
1657619570009,MATH 18,B06,093474,Rideout; David Porter,6,0,36,30
1657619576031,MATH 20A,A01,083754,Zheng; Zequn,14,0,40,26
1657619582058,MATH 20B,A01,083756,Briones; Jor-el Thomas Caparas,4,0,36,32
1657619582058,MATH 20B,A02,083757,Briones; Jor-el Thomas Caparas,1,0,36,35
1657619582058,MATH 20B,A03,093475,Briones; Jor-el Thomas Caparas,2,0,36,34
1657619588115,MATH 20C,A01,083760,Briones; Jor-el Thomas Caparas,1,0,35,34
1657619588115,MATH 20C,A02,083761,Briones; Jor-el Thomas Caparas,8,0,35,27
1657619588115,MATH 20C,A03,093476,Briones; Jor-el Thomas Caparas,0,1,36,36
1657619588115,MATH 20C,B01,083762,Bach; Quang Tran,1,0,30,29
1657619594137,MATH 20D,A01,083765,Tran; Brian Kha,5,0,30,25
1657619594137,MATH 20D,A02,083766,Tran; Brian Kha,5,0,30,25
1657619594137,MATH 20D,A03,083767,Tran; Brian Kha,5,0,30,25
1657619600164,MATH 20E,A01,083771,Ganguly; Soumya,9,0,32,23
1657619600164,MATH 20E,A02,083772,Ganguly; Soumya,6,0,32,26
1657619600164,MATH 20E,B01,083773,Ciotti; Benjamin,20,0,35,15
1657619600164,MATH 20E,B02,083774,Ciotti; Benjamin,18,0,35,17
1657619606192,MATH 103A,A01,083777,Greenfeld; Be'Eri,3,0,36,33
1657619606192,MATH 103A,A02,083778,Greenfeld; Be'Eri,5,0,36,31
1657619606192,MATH 103A,A03,093561,Greenfeld; Be'Eri,6,0,36,30
1657619606192,MATH 103A,B01,083779,Greenfeld; Be'Eri,7,0,36,29
1657619606192,MATH 103A,B02,083780,Greenfeld; Be'Eri,4,0,36,32
1657619606192,MATH 103A,B03,093562,Greenfeld; Be'Eri,3,0,36,33
1657619612220,MATH 105,A01,085443,Carter; Anne Toulson,15,0,35,20
1657619612220,MATH 105,A02,093477,Carter; Anne Toulson,20,0,35,15
1657619618249,MATH 109,A01,083213,Ganzberger; Geoffrey Michael,2,0,34,32
1657619618249,MATH 109,A02,083214,Ganzberger; Geoffrey Michael,4,0,34,30
1657619618249,MATH 109,A03,093478,Ganzberger; Geoffrey Michael,2,0,34,32
1657619618249,MATH 109,B01,083215,Ganzberger; Geoffrey Michael,1,0,32,31
1657619618249,MATH 109,B02,083216,Ganzberger; Geoffrey Michael,2,0,32,30
1657619618249,MATH 109,B03,093479,Ganzberger; Geoffrey Michael,8,0,32,24
1657619624363,MATH 142A,A01,083219,Chow; Bennett,7,0,32,25
1657619624363,MATH 142A,A02,083220,Chow; Bennett,10,0,32,22
1657619624363,MATH 142A,A03,093480,Chow; Bennett,9,0,32,23
1657619624363,MATH 142A,B03,093481,Chow; Bennett,8,0,32,24
1657619624363,MATH 142A,B04,093558,Chow; Bennett,13,0,32,19
1657619624363,MATH 142A,B05,093559,Chow; Bennett,6,0,32,26
1657619630387,MATH 193A,A01,083224,Rotar; Vladimir,8,0,34,26
1657619630387,MATH 193A,A02,083225,Rotar; Vladimir,9,0,34,25
1657619630387,MATH 193A,A03,083781,Rotar; Vladimir,5,0,34,29
1657619630387,MATH 193A,A04,083782,Rotar; Vladimir,10,0,34,24
1657619630387,MATH 193A,A05,093482,Rotar; Vladimir,10,0,34,24
1657619636410,MATH 197,001,091859,McAuley; Julian John,9999,0,9999,0
1657619636410,MATH 197,002,095566,Kedlaya; Kiran S.,9997,0,9999,2
1657619636410,MATH 197,003,095567,Xiao; Ming,9999,0,9999,0
1657619636410,MATH 197,004,095571,Perols; Johan Lars,9998,0,9999,1
1657619643464,COGS 9,A01,083615,Shannon; Kyle Michael,9,0,75,66
1657619649489,COGS 11,A01,083617,Boyle; Mary E. T.,23,0,48,25
1657619655512,COGS 13,A01,083071,Bastos; Amalia Pinkusfeld,11,0,71,60
1657619661540,COGS 14A,A01,092681,Semenuks; Arturs,5,1,100,95
1657619667564,COGS 14B,A01,083073,Cheng; Tzu-Han,6,0,63,57
1657619673590,COGS 17,A01,092677,Semenuks; Arturs,6,0,81,75
1657619679614,COGS 100,A01,083619,Allen; Michael Gordon,17,0,70,53
1657619685637,COGS 101A,A01,083621,Davis; Joshua Daniel,9,0,68,59
1657619691659,COGS 101B,A01,091572,Allen; Michael Gordon,12,0,65,53
1657619697686,COGS 101C,A01,083625,Delgado; Tania,17,0,35,18
1657619703708,COGS 107A,A01,083627,Boyle; Mary E. T.,13,0,60,47
1657619709734,COGS 118A,A01,083075,Gupta; Anjum,21,0,76,55
1657619715758,CSE 3,A50,083646,Miranda; Gregory Joseph,24,0,50,26
1657619721780,CSE 8A,A50,083650,Miranda; Gregory Joseph,17,1,56,39
1657619727805,CSE 11,A01,083080,Cao; Yingjun,6,15,40,34
1657619733827,CSE 12,A01,083652,Krause-Levy; Sophia Louisa,28,1,120,92
1657619739851,CSE 15L,A01,083654,Morris; Justin Loren,9,0,50,41
1657619739851,CSE 15L,A02,083655,Morris; Justin Loren,9,0,50,41
1657619745876,CSE 20,A01,083657,Tran; Khoa Dang,39,0,80,41
1657619751900,CSE 21,A01,095574,Bach; Quang Tran,22,0,48,26
1657619757923,CSE 30,A01,083084,Eldon; John,6,0,80,74
1657619757923,CSE 30,B01,095061,Bhaskar; Nishant,9,0,50,41
1657619763950,CSE 100,A01,083659,Cao; Yingjun,5,4,70,65
1657619769974,CSE 134B,A01,083661,Powell; Thomas Allan,22,0,100,78
1657619775997,CSE 140,A01,083663,Gungor; Onat,15,0,85,70
1657619782031,CSE 140L,A01,083088,Eldon; John,21,0,100,79
1657619788054,CSE 175,A01,083665,Kumar; Rakesh,3,0,25,22
1657619794076,CSE 190,A00,092507,Dubnov; Shlomo,8,0,20,12
1657619800104,ECE 45,A01,083139,Congero; Spencer William,6,0,75,69
1657619806126,ECE 65,A50,083695,Saad; Andrew S,12,0,30,18
1657619806126,ECE 65,A51,095125,Saad; Andrew S,24,0,26,2
1657619812149,ECE 109,A01,091882,Touri; Behrouz,19,0,70,51
1657619818172,ECE 180,A00,083140,Abi Samra; Nicholas Camill,1,0,30,29
1657619818172,ECE 180,B00,083141,Abi Samra; Nicholas Camill,0,0,30,30
1657619824200,MATH 10A,A01,083735,Patchell; Gregory David,2,0,30,28
1657619824200,MATH 10A,A02,083736,Patchell; Gregory David,20,0,30,10
1657619824200,MATH 10A,A03,083737,Patchell; Gregory David,16,0,30,14
1657619830229,MATH 10B,A01,083207,Lim; Seonhee,8,0,34,26
1657619830229,MATH 10B,A02,083208,Lim; Seonhee,9,0,35,26
1657619830229,MATH 10B,A03,093472,Lim; Seonhee,7,0,34,27
1657619830229,MATH 10B,B01,083739,Sinha; Shubham,12,0,30,18
1657619836252,MATH 18,A01,083743,Cinel; Cameron Alexander,7,0,30,23
1657619836252,MATH 18,A02,083744,Cinel; Cameron Alexander,17,0,30,13
1657619836252,MATH 18,A03,083745,Cinel; Cameron Alexander,9,0,30,21
1657619836252,MATH 18,B01,083748,Rideout; David Porter,5,0,37,32
1657619836252,MATH 18,B02,083749,Rideout; David Porter,5,0,36,31
1657619836252,MATH 18,B03,083750,Rideout; David Porter,3,0,37,34
1657619836252,MATH 18,B04,083751,Rideout; David Porter,6,0,36,30
1657619836252,MATH 18,B05,093473,Rideout; David Porter,6,0,36,30
1657619836252,MATH 18,B06,093474,Rideout; David Porter,6,0,36,30
1657619842279,MATH 20A,A01,083754,Zheng; Zequn,14,0,40,26
1657619848303,MATH 20B,A01,083756,Briones; Jor-el Thomas Caparas,4,0,36,32
1657619848303,MATH 20B,A02,083757,Briones; Jor-el Thomas Caparas,1,0,36,35
1657619848303,MATH 20B,A03,093475,Briones; Jor-el Thomas Caparas,2,0,36,34
1657619854331,MATH 20C,A01,083760,Briones; Jor-el Thomas Caparas,1,0,35,34
1657619854331,MATH 20C,A02,083761,Briones; Jor-el Thomas Caparas,8,0,35,27
1657619854331,MATH 20C,A03,093476,Briones; Jor-el Thomas Caparas,0,1,36,36
1657619854331,MATH 20C,B01,083762,Bach; Quang Tran,1,0,30,29
1657619860354,MATH 20D,A01,083765,Tran; Brian Kha,5,0,30,25
1657619860354,MATH 20D,A02,083766,Tran; Brian Kha,5,0,30,25
1657619860354,MATH 20D,A03,083767,Tran; Brian Kha,5,0,30,25
1657619866379,MATH 20E,A01,083771,Ganguly; Soumya,9,0,32,23
1657619866379,MATH 20E,A02,083772,Ganguly; Soumya,6,0,32,26
1657619866379,MATH 20E,B01,083773,Ciotti; Benjamin,20,0,35,15
1657619866379,MATH 20E,B02,083774,Ciotti; Benjamin,18,0,35,17
1657619872407,MATH 103A,A01,083777,Greenfeld; Be'Eri,3,0,36,33
1657619872407,MATH 103A,A02,083778,Greenfeld; Be'Eri,5,0,36,31
1657619872407,MATH 103A,A03,093561,Greenfeld; Be'Eri,6,0,36,30
1657619872407,MATH 103A,B01,083779,Greenfeld; Be'Eri,7,0,36,29
1657619872407,MATH 103A,B02,083780,Greenfeld; Be'Eri,4,0,36,32
1657619872407,MATH 103A,B03,093562,Greenfeld; Be'Eri,3,0,36,33
1657619878431,MATH 105,A01,085443,Carter; Anne Toulson,15,0,35,20
1657619878431,MATH 105,A02,093477,Carter; Anne Toulson,20,0,35,15
1657619884458,MATH 109,A01,083213,Ganzberger; Geoffrey Michael,2,0,34,32
1657619884458,MATH 109,A02,083214,Ganzberger; Geoffrey Michael,4,0,34,30
1657619884458,MATH 109,A03,093478,Ganzberger; Geoffrey Michael,2,0,34,32
1657619884458,MATH 109,B01,083215,Ganzberger; Geoffrey Michael,1,0,32,31
1657619884458,MATH 109,B02,083216,Ganzberger; Geoffrey Michael,2,0,32,30
1657619884458,MATH 109,B03,093479,Ganzberger; Geoffrey Michael,8,0,32,24
1657619890482,MATH 142A,A01,083219,Chow; Bennett,7,0,32,25
1657619890482,MATH 142A,A02,083220,Chow; Bennett,10,0,32,22
1657619890482,MATH 142A,A03,093480,Chow; Bennett,9,0,32,23
1657619890482,MATH 142A,B03,093481,Chow; Bennett,8,0,32,24
1657619890482,MATH 142A,B04,093558,Chow; Bennett,13,0,32,19
1657619890482,MATH 142A,B05,093559,Chow; Bennett,6,0,32,26
1657619896510,MATH 193A,A01,083224,Rotar; Vladimir,8,0,34,26
1657619896510,MATH 193A,A02,083225,Rotar; Vladimir,9,0,34,25
1657619896510,MATH 193A,A03,083781,Rotar; Vladimir,5,0,34,29
1657619896510,MATH 193A,A04,083782,Rotar; Vladimir,10,0,34,24
1657619896510,MATH 193A,A05,093482,Rotar; Vladimir,10,0,34,24
1657619902536,MATH 197,001,091859,McAuley; Julian John,9999,0,9999,0
1657619902536,MATH 197,002,095566,Kedlaya; Kiran S.,9997,0,9999,2
1657619902536,MATH 197,003,095567,Xiao; Ming,9999,0,9999,0
1657619902536,MATH 197,004,095571,Perols; Johan Lars,9998,0,9999,1
1657619909588,COGS 9,A01,083615,Shannon; Kyle Michael,9,0,75,66
1657619915616,COGS 11,A01,083617,Boyle; Mary E. T.,23,0,48,25
1657619921644,COGS 13,A01,083071,Bastos; Amalia Pinkusfeld,11,0,71,60
1657619927675,COGS 14A,A01,092681,Semenuks; Arturs,5,1,100,95
1657619933702,COGS 14B,A01,083073,Cheng; Tzu-Han,6,0,63,57
1657619939729,COGS 17,A01,092677,Semenuks; Arturs,6,0,81,75
1657619945755,COGS 100,A01,083619,Allen; Michael Gordon,17,0,70,53
1657619951779,COGS 101A,A01,083621,Davis; Joshua Daniel,9,0,68,59
1657619957804,COGS 101B,A01,091572,Allen; Michael Gordon,12,0,65,53
1657619963830,COGS 101C,A01,083625,Delgado; Tania,17,0,35,18
1657619969854,COGS 107A,A01,083627,Boyle; Mary E. T.,13,0,60,47
1657619975878,COGS 118A,A01,083075,Gupta; Anjum,21,0,76,55
1657619981899,CSE 3,A50,083646,Miranda; Gregory Joseph,24,0,50,26
1657619987924,CSE 8A,A50,083650,Miranda; Gregory Joseph,17,1,56,39
1657619993951,CSE 11,A01,083080,Cao; Yingjun,6,15,40,34
1657619999978,CSE 12,A01,083652,Krause-Levy; Sophia Louisa,28,1,120,92
1657620006002,CSE 15L,A01,083654,Morris; Justin Loren,9,0,50,41
1657620006002,CSE 15L,A02,083655,Morris; Justin Loren,9,0,50,41
1657620012025,CSE 20,A01,083657,Tran; Khoa Dang,39,0,80,41
1657620018051,CSE 21,A01,095574,Bach; Quang Tran,22,0,48,26
1657620024073,CSE 30,A01,083084,Eldon; John,6,0,80,74
1657620024073,CSE 30,B01,095061,Bhaskar; Nishant,9,0,50,41
1657620030096,CSE 100,A01,083659,Cao; Yingjun,5,4,70,65
1657620036120,CSE 134B,A01,083661,Powell; Thomas Allan,22,0,100,78
1657620042147,CSE 140,A01,083663,Gungor; Onat,15,0,85,70
1657620048169,CSE 140L,A01,083088,Eldon; John,21,0,100,79
1657620054192,CSE 175,A01,083665,Kumar; Rakesh,3,0,25,22
1657620060215,CSE 190,A00,092507,Dubnov; Shlomo,8,0,20,12
1657620066243,ECE 45,A01,083139,Congero; Spencer William,6,0,75,69
1657620072270,ECE 65,A50,083695,Saad; Andrew S,12,0,30,18
1657620072270,ECE 65,A51,095125,Saad; Andrew S,24,0,26,2
1657620078294,ECE 109,A01,091882,Touri; Behrouz,19,0,70,51
1657620084316,ECE 180,A00,083140,Abi Samra; Nicholas Camill,1,0,30,29
1657620084316,ECE 180,B00,083141,Abi Samra; Nicholas Camill,0,0,30,30
1657620090339,MATH 10A,A01,083735,Patchell; Gregory David,2,0,30,28
1657620090339,MATH 10A,A02,083736,Patchell; Gregory David,20,0,30,10
1657620090339,MATH 10A,A03,083737,Patchell; Gregory David,16,0,30,14
1657620096367,MATH 10B,A01,083207,Lim; Seonhee,8,0,34,26
1657620096367,MATH 10B,A02,083208,Lim; Seonhee,9,0,35,26
1657620096367,MATH 10B,A03,093472,Lim; Seonhee,7,0,34,27
1657620096367,MATH 10B,B01,083739,Sinha; Shubham,12,0,30,18
1657620102393,MATH 18,A01,083743,Cinel; Cameron Alexander,7,0,30,23
1657620102393,MATH 18,A02,083744,Cinel; Cameron Alexander,17,0,30,13
1657620102393,MATH 18,A03,083745,Cinel; Cameron Alexander,9,0,30,21
1657620102393,MATH 18,B01,083748,Rideout; David Porter,5,0,37,32
1657620102393,MATH 18,B02,083749,Rideout; David Porter,5,0,36,31
1657620102393,MATH 18,B03,083750,Rideout; David Porter,3,0,37,34
1657620102393,MATH 18,B04,083751,Rideout; David Porter,6,0,36,30
1657620102393,MATH 18,B05,093473,Rideout; David Porter,6,0,36,30
1657620102393,MATH 18,B06,093474,Rideout; David Porter,6,0,36,30
1657620108416,MATH 20A,A01,083754,Zheng; Zequn,14,0,40,26
1657620114438,MATH 20B,A01,083756,Briones; Jor-el Thomas Caparas,4,0,36,32
1657620114438,MATH 20B,A02,083757,Briones; Jor-el Thomas Caparas,1,0,36,35
1657620114438,MATH 20B,A03,093475,Briones; Jor-el Thomas Caparas,2,0,36,34
1657620120467,MATH 20C,A01,083760,Briones; Jor-el Thomas Caparas,1,0,35,34
1657620120467,MATH 20C,A02,083761,Briones; Jor-el Thomas Caparas,8,0,35,27
1657620120467,MATH 20C,A03,093476,Briones; Jor-el Thomas Caparas,0,1,36,36
1657620120467,MATH 20C,B01,083762,Bach; Quang Tran,1,0,30,29
1657620126492,MATH 20D,A01,083765,Tran; Brian Kha,5,0,30,25
1657620126492,MATH 20D,A02,083766,Tran; Brian Kha,5,0,30,25
1657620126492,MATH 20D,A03,083767,Tran; Brian Kha,5,0,30,25
1657620132514,MATH 20E,A01,083771,Ganguly; Soumya,9,0,32,23
1657620132514,MATH 20E,A02,083772,Ganguly; Soumya,6,0,32,26
1657620132514,MATH 20E,B01,083773,Ciotti; Benjamin,20,0,35,15
1657620132514,MATH 20E,B02,083774,Ciotti; Benjamin,18,0,35,17
1657620138544,MATH 103A,A01,083777,Greenfeld; Be'Eri,3,0,36,33
1657620138544,MATH 103A,A02,083778,Greenfeld; Be'Eri,5,0,36,31
1657620138544,MATH 103A,A03,093561,Greenfeld; Be'Eri,6,0,36,30
1657620138544,MATH 103A,B01,083779,Greenfeld; Be'Eri,7,0,36,29
1657620138544,MATH 103A,B02,083780,Greenfeld; Be'Eri,4,0,36,32
1657620138544,MATH 103A,B03,093562,Greenfeld; Be'Eri,3,0,36,33
1657620144566,MATH 105,A01,085443,Carter; Anne Toulson,15,0,35,20
1657620144566,MATH 105,A02,093477,Carter; Anne Toulson,20,0,35,15
1657620150594,MATH 109,A01,083213,Ganzberger; Geoffrey Michael,2,0,34,32
1657620150594,MATH 109,A02,083214,Ganzberger; Geoffrey Michael,4,0,34,30
1657620150594,MATH 109,A03,093478,Ganzberger; Geoffrey Michael,2,0,34,32
1657620150594,MATH 109,B01,083215,Ganzberger; Geoffrey Michael,1,0,32,31
1657620150594,MATH 109,B02,083216,Ganzberger; Geoffrey Michael,2,0,32,30
1657620150594,MATH 109,B03,093479,Ganzberger; Geoffrey Michael,8,0,32,24
1657620156622,MATH 142A,A01,083219,Chow; Bennett,7,0,32,25
1657620156622,MATH 142A,A02,083220,Chow; Bennett,10,0,32,22
1657620156622,MATH 142A,A03,093480,Chow; Bennett,9,0,32,23
1657620156622,MATH 142A,B03,093481,Chow; Bennett,8,0,32,24
1657620156622,MATH 142A,B04,093558,Chow; Bennett,13,0,32,19
1657620156622,MATH 142A,B05,093559,Chow; Bennett,6,0,32,26
1657620162647,MATH 193A,A01,083224,Rotar; Vladimir,8,0,34,26
1657620162647,MATH 193A,A02,083225,Rotar; Vladimir,9,0,34,25
1657620162647,MATH 193A,A03,083781,Rotar; Vladimir,5,0,34,29
1657620162647,MATH 193A,A04,083782,Rotar; Vladimir,10,0,34,24
1657620162647,MATH 193A,A05,093482,Rotar; Vladimir,10,0,34,24
1657620168674,MATH 197,001,091859,McAuley; Julian John,9999,0,9999,0
1657620168674,MATH 197,002,095566,Kedlaya; Kiran S.,9997,0,9999,2
1657620168674,MATH 197,003,095567,Xiao; Ming,9999,0,9999,0
1657620168674,MATH 197,004,095571,Perols; Johan Lars,9998,0,9999,1
1657620175729,COGS 9,A01,083615,Shannon; Kyle Michael,9,0,75,66
1657620181751,COGS 11,A01,083617,Boyle; Mary E. T.,23,0,48,25
1657620187778,COGS 13,A01,083071,Bastos; Amalia Pinkusfeld,11,0,71,60
1657620193806,COGS 14A,A01,092681,Semenuks; Arturs,5,1,100,95
1657620199829,COGS 14B,A01,083073,Cheng; Tzu-Han,6,0,63,57
1657620205850,COGS 17,A01,092677,Semenuks; Arturs,6,0,81,75
1657620211873,COGS 100,A01,083619,Allen; Michael Gordon,17,0,70,53
1657620217983,COGS 101A,A01,083621,Davis; Joshua Daniel,9,0,68,59
1657620224007,COGS 101B,A01,091572,Allen; Michael Gordon,12,0,65,53
1657620230032,COGS 101C,A01,083625,Delgado; Tania,17,0,35,18
1657620236056,COGS 107A,A01,083627,Boyle; Mary E. T.,13,0,60,47
1657620242078,COGS 118A,A01,083075,Gupta; Anjum,21,0,76,55
1657620248103,CSE 3,A50,083646,Miranda; Gregory Joseph,24,0,50,26
1657620254130,CSE 8A,A50,083650,Miranda; Gregory Joseph,17,1,56,39
1657620260152,CSE 11,A01,083080,Cao; Yingjun,6,15,40,34
1657620266179,CSE 12,A01,083652,Krause-Levy; Sophia Louisa,28,1,120,92
1657620272202,CSE 15L,A01,083654,Morris; Justin Loren,9,0,50,41
1657620272202,CSE 15L,A02,083655,Morris; Justin Loren,9,0,50,41
1657620278228,CSE 20,A01,083657,Tran; Khoa Dang,39,0,80,41
1657620284251,CSE 21,A01,095574,Bach; Quang Tran,22,0,48,26
1657620290279,CSE 30,A01,083084,Eldon; John,6,0,80,74
1657620290279,CSE 30,B01,095061,Bhaskar; Nishant,9,0,50,41
1657620296302,CSE 100,A01,083659,Cao; Yingjun,5,4,70,65
1657620302323,CSE 134B,A01,083661,Powell; Thomas Allan,22,0,100,78
1657620308350,CSE 140,A01,083663,Gungor; Onat,15,0,85,70
1657620314374,CSE 140L,A01,083088,Eldon; John,21,0,100,79
1657620320395,CSE 175,A01,083665,Kumar; Rakesh,3,0,25,22
1657620326422,CSE 190,A00,092507,Dubnov; Shlomo,8,0,20,12
1657620332444,ECE 45,A01,083139,Congero; Spencer William,6,0,75,69
1657620338469,ECE 65,A50,083695,Saad; Andrew S,12,0,30,18
1657620338469,ECE 65,A51,095125,Saad; Andrew S,24,0,26,2
1657620344493,ECE 109,A01,091882,Touri; Behrouz,19,0,70,51
1657620350515,ECE 180,A00,083140,Abi Samra; Nicholas Camill,1,0,30,29
1657620350515,ECE 180,B00,083141,Abi Samra; Nicholas Camill,0,0,30,30
1657620356540,MATH 10A,A01,083735,Patchell; Gregory David,2,0,30,28
1657620356540,MATH 10A,A02,083736,Patchell; Gregory David,20,0,30,10
1657620356540,MATH 10A,A03,083737,Patchell; Gregory David,16,0,30,14
1657620362564,MATH 10B,A01,083207,Lim; Seonhee,8,0,34,26
1657620362564,MATH 10B,A02,083208,Lim; Seonhee,9,0,35,26
1657620362564,MATH 10B,A03,093472,Lim; Seonhee,7,0,34,27
1657620362564,MATH 10B,B01,083739,Sinha; Shubham,12,0,30,18
1657620368595,MATH 18,A01,083743,Cinel; Cameron Alexander,7,0,30,23
1657620368595,MATH 18,A02,083744,Cinel; Cameron Alexander,17,0,30,13
1657620368595,MATH 18,A03,083745,Cinel; Cameron Alexander,9,0,30,21
1657620368595,MATH 18,B01,083748,Rideout; David Porter,5,0,37,32
1657620368595,MATH 18,B02,083749,Rideout; David Porter,5,0,36,31
1657620368595,MATH 18,B03,083750,Rideout; David Porter,3,0,37,34
1657620368595,MATH 18,B04,083751,Rideout; David Porter,6,0,36,30
1657620368595,MATH 18,B05,093473,Rideout; David Porter,6,0,36,30
1657620368595,MATH 18,B06,093474,Rideout; David Porter,6,0,36,30
1657620374622,MATH 20A,A01,083754,Zheng; Zequn,14,0,40,26
1657620380645,MATH 20B,A01,083756,Briones; Jor-el Thomas Caparas,4,0,36,32
1657620380645,MATH 20B,A02,083757,Briones; Jor-el Thomas Caparas,1,0,36,35
1657620380645,MATH 20B,A03,093475,Briones; Jor-el Thomas Caparas,2,0,36,34
1657620386674,MATH 20C,A01,083760,Briones; Jor-el Thomas Caparas,1,0,35,34
1657620386674,MATH 20C,A02,083761,Briones; Jor-el Thomas Caparas,8,0,35,27
1657620386674,MATH 20C,A03,093476,Briones; Jor-el Thomas Caparas,0,1,36,36
1657620386674,MATH 20C,B01,083762,Bach; Quang Tran,1,0,30,29
1657620392701,MATH 20D,A01,083765,Tran; Brian Kha,5,0,30,25
1657620392701,MATH 20D,A02,083766,Tran; Brian Kha,5,0,30,25
1657620392701,MATH 20D,A03,083767,Tran; Brian Kha,5,0,30,25
1657620398725,MATH 20E,A01,083771,Ganguly; Soumya,9,0,32,23
1657620398725,MATH 20E,A02,083772,Ganguly; Soumya,6,0,32,26
1657620398725,MATH 20E,B01,083773,Ciotti; Benjamin,20,0,35,15
1657620398725,MATH 20E,B02,083774,Ciotti; Benjamin,18,0,35,17
1657620404748,MATH 103A,A01,083777,Greenfeld; Be'Eri,3,0,36,33
1657620404748,MATH 103A,A02,083778,Greenfeld; Be'Eri,5,0,36,31
1657620404748,MATH 103A,A03,093561,Greenfeld; Be'Eri,6,0,36,30
1657620404748,MATH 103A,B01,083779,Greenfeld; Be'Eri,7,0,36,29
1657620404748,MATH 103A,B02,083780,Greenfeld; Be'Eri,4,0,36,32
1657620404748,MATH 103A,B03,093562,Greenfeld; Be'Eri,3,0,36,33
1657620410775,MATH 105,A01,085443,Carter; Anne Toulson,15,0,35,20
1657620410775,MATH 105,A02,093477,Carter; Anne Toulson,20,0,35,15
1657620416799,MATH 109,A01,083213,Ganzberger; Geoffrey Michael,2,0,34,32
1657620416799,MATH 109,A02,083214,Ganzberger; Geoffrey Michael,4,0,34,30
1657620416799,MATH 109,A03,093478,Ganzberger; Geoffrey Michael,2,0,34,32
1657620416799,MATH 109,B01,083215,Ganzberger; Geoffrey Michael,1,0,32,31
1657620416799,MATH 109,B02,083216,Ganzberger; Geoffrey Michael,2,0,32,30
1657620416799,MATH 109,B03,093479,Ganzberger; Geoffrey Michael,8,0,32,24
1657620422823,MATH 142A,A01,083219,Chow; Bennett,7,0,32,25
1657620422823,MATH 142A,A02,083220,Chow; Bennett,10,0,32,22
1657620422823,MATH 142A,A03,093480,Chow; Bennett,9,0,32,23
1657620422823,MATH 142A,B03,093481,Chow; Bennett,8,0,32,24
1657620422823,MATH 142A,B04,093558,Chow; Bennett,13,0,32,19
1657620422823,MATH 142A,B05,093559,Chow; Bennett,6,0,32,26
1657620428848,MATH 193A,A01,083224,Rotar; Vladimir,8,0,34,26
1657620428848,MATH 193A,A02,083225,Rotar; Vladimir,9,0,34,25
1657620428848,MATH 193A,A03,083781,Rotar; Vladimir,5,0,34,29
1657620428848,MATH 193A,A04,083782,Rotar; Vladimir,10,0,34,24
1657620428848,MATH 193A,A05,093482,Rotar; Vladimir,10,0,34,24
1657620434875,MATH 197,001,091859,McAuley; Julian John,9999,0,9999,0
1657620434875,MATH 197,002,095566,Kedlaya; Kiran S.,9997,0,9999,2
1657620434875,MATH 197,003,095567,Xiao; Ming,9999,0,9999,0
1657620434875,MATH 197,004,095571,Perols; Johan Lars,9998,0,9999,1
1657620441926,COGS 9,A01,083615,Shannon; Kyle Michael,9,0,75,66
1657620447950,COGS 11,A01,083617,Boyle; Mary E. T.,23,0,48,25
1657620453973,COGS 13,A01,083071,Bastos; Amalia Pinkusfeld,11,0,71,60
1657620460009,COGS 14A,A01,092681,Semenuks; Arturs,5,1,100,95
1657620466034,COGS 14B,A01,083073,Cheng; Tzu-Han,6,0,63,57
1657620472063,COGS 17,A01,092677,Semenuks; Arturs,6,0,81,75
1657620478087,COGS 100,A01,083619,Allen; Michael Gordon,17,0,70,53
1657620484111,COGS 101A,A01,083621,Davis; Joshua Daniel,9,0,68,59
1657620490135,COGS 101B,A01,091572,Allen; Michael Gordon,12,0,65,53
1657620496157,COGS 101C,A01,083625,Delgado; Tania,17,0,35,18
1657620502190,COGS 107A,A01,083627,Boyle; Mary E. T.,13,0,60,47
1657620508212,COGS 118A,A01,083075,Gupta; Anjum,21,0,76,55
1657620514240,CSE 3,A50,083646,Miranda; Gregory Joseph,24,0,50,26
1657620520266,CSE 8A,A50,083650,Miranda; Gregory Joseph,17,1,56,39
1657620526292,CSE 11,A01,083080,Cao; Yingjun,6,15,40,34
1657620532321,CSE 12,A01,083652,Krause-Levy; Sophia Louisa,28,1,120,92
1657620538344,CSE 15L,A01,083654,Morris; Justin Loren,9,0,50,41
1657620538344,CSE 15L,A02,083655,Morris; Justin Loren,9,0,50,41
1657620544367,CSE 20,A01,083657,Tran; Khoa Dang,39,0,80,41
1657620550391,CSE 21,A01,095574,Bach; Quang Tran,22,0,48,26
1657620556414,CSE 30,A01,083084,Eldon; John,6,0,80,74
1657620556414,CSE 30,B01,095061,Bhaskar; Nishant,9,0,50,41
1657620562439,CSE 100,A01,083659,Cao; Yingjun,5,4,70,65
1657620568462,CSE 134B,A01,083661,Powell; Thomas Allan,22,0,100,78
1657620574484,CSE 140,A01,083663,Gungor; Onat,15,0,85,70
1657620580513,CSE 140L,A01,083088,Eldon; John,21,0,100,79
1657620586538,CSE 175,A01,083665,Kumar; Rakesh,3,0,25,22
1657620592562,CSE 190,A00,092507,Dubnov; Shlomo,8,0,20,12
1657620598585,ECE 45,A01,083139,Congero; Spencer William,6,0,75,69
1657620604611,ECE 65,A50,083695,Saad; Andrew S,12,0,30,18
1657620604611,ECE 65,A51,095125,Saad; Andrew S,24,0,26,2
1657620610634,ECE 109,A01,091882,Touri; Behrouz,19,0,70,51
1657620616656,ECE 180,A00,083140,Abi Samra; Nicholas Camill,1,0,30,29
1657620616656,ECE 180,B00,083141,Abi Samra; Nicholas Camill,0,0,30,30
1657620622679,MATH 10A,A01,083735,Patchell; Gregory David,2,0,30,28
1657620622679,MATH 10A,A02,083736,Patchell; Gregory David,20,0,30,10
1657620622679,MATH 10A,A03,083737,Patchell; Gregory David,16,0,30,14
1657620628701,MATH 10B,A01,083207,Lim; Seonhee,8,0,34,26
1657620628701,MATH 10B,A02,083208,Lim; Seonhee,9,0,35,26
1657620628701,MATH 10B,A03,093472,Lim; Seonhee,7,0,34,27
1657620628701,MATH 10B,B01,083739,Sinha; Shubham,12,0,30,18
1657620634726,MATH 18,A01,083743,Cinel; Cameron Alexander,7,0,30,23
1657620634726,MATH 18,A02,083744,Cinel; Cameron Alexander,17,0,30,13
1657620634726,MATH 18,A03,083745,Cinel; Cameron Alexander,9,0,30,21
1657620634726,MATH 18,B01,083748,Rideout; David Porter,5,0,37,32
1657620634726,MATH 18,B02,083749,Rideout; David Porter,5,0,36,31
1657620634726,MATH 18,B03,083750,Rideout; David Porter,3,0,37,34
1657620634726,MATH 18,B04,083751,Rideout; David Porter,6,0,36,30
1657620634726,MATH 18,B05,093473,Rideout; David Porter,6,0,36,30
1657620634726,MATH 18,B06,093474,Rideout; David Porter,6,0,36,30
1657620640752,MATH 20A,A01,083754,Zheng; Zequn,14,0,40,26
1657620646775,MATH 20B,A01,083756,Briones; Jor-el Thomas Caparas,4,0,36,32
1657620646775,MATH 20B,A02,083757,Briones; Jor-el Thomas Caparas,1,0,36,35
1657620646775,MATH 20B,A03,093475,Briones; Jor-el Thomas Caparas,2,0,36,34
1657620652802,MATH 20C,A01,083760,Briones; Jor-el Thomas Caparas,1,0,35,34
1657620652802,MATH 20C,A02,083761,Briones; Jor-el Thomas Caparas,8,0,35,27
1657620652802,MATH 20C,A03,093476,Briones; Jor-el Thomas Caparas,0,1,36,36
1657620652802,MATH 20C,B01,083762,Bach; Quang Tran,1,0,30,29
1657620658825,MATH 20D,A01,083765,Tran; Brian Kha,5,0,30,25
1657620658825,MATH 20D,A02,083766,Tran; Brian Kha,5,0,30,25
1657620658825,MATH 20D,A03,083767,Tran; Brian Kha,5,0,30,25
1657620664854,MATH 20E,A01,083771,Ganguly; Soumya,9,0,32,23
1657620664854,MATH 20E,A02,083772,Ganguly; Soumya,6,0,32,26
1657620664854,MATH 20E,B01,083773,Ciotti; Benjamin,20,0,35,15
1657620664854,MATH 20E,B02,083774,Ciotti; Benjamin,18,0,35,17
1657620670892,MATH 103A,A01,083777,Greenfeld; Be'Eri,3,0,36,33
1657620670892,MATH 103A,A02,083778,Greenfeld; Be'Eri,5,0,36,31
1657620670892,MATH 103A,A03,093561,Greenfeld; Be'Eri,6,0,36,30
1657620670892,MATH 103A,B01,083779,Greenfeld; Be'Eri,7,0,36,29
1657620670892,MATH 103A,B02,083780,Greenfeld; Be'Eri,4,0,36,32
1657620670892,MATH 103A,B03,093562,Greenfeld; Be'Eri,3,0,36,33
1657620676915,MATH 105,A01,085443,Carter; Anne Toulson,15,0,35,20
1657620676915,MATH 105,A02,093477,Carter; Anne Toulson,20,0,35,15
1657620682938,MATH 109,A01,083213,Ganzberger; Geoffrey Michael,2,0,34,32
1657620682938,MATH 109,A02,083214,Ganzberger; Geoffrey Michael,4,0,34,30
1657620682938,MATH 109,A03,093478,Ganzberger; Geoffrey Michael,2,0,34,32
1657620682938,MATH 109,B01,083215,Ganzberger; Geoffrey Michael,1,0,32,31
1657620682938,MATH 109,B02,083216,Ganzberger; Geoffrey Michael,2,0,32,30
1657620682938,MATH 109,B03,093479,Ganzberger; Geoffrey Michael,8,0,32,24
1657620688968,MATH 142A,A01,083219,Chow; Bennett,7,0,32,25
1657620688968,MATH 142A,A02,083220,Chow; Bennett,10,0,32,22
1657620688968,MATH 142A,A03,093480,Chow; Bennett,9,0,32,23
1657620688968,MATH 142A,B03,093481,Chow; Bennett,8,0,32,24
1657620688968,MATH 142A,B04,093558,Chow; Bennett,13,0,32,19
1657620688968,MATH 142A,B05,093559,Chow; Bennett,6,0,32,26
1657620694991,MATH 193A,A01,083224,Rotar; Vladimir,8,0,34,26
1657620694991,MATH 193A,A02,083225,Rotar; Vladimir,9,0,34,25
1657620694991,MATH 193A,A03,083781,Rotar; Vladimir,5,0,34,29
1657620694991,MATH 193A,A04,083782,Rotar; Vladimir,10,0,34,24
1657620694991,MATH 193A,A05,093482,Rotar; Vladimir,10,0,34,24
1657620701014,MATH 197,001,091859,McAuley; Julian John,9999,0,9999,0
1657620701014,MATH 197,002,095566,Kedlaya; Kiran S.,9997,0,9999,2
1657620701014,MATH 197,003,095567,Xiao; Ming,9999,0,9999,0
1657620701014,MATH 197,004,095571,Perols; Johan Lars,9998,0,9999,1
1657620708067,COGS 9,A01,083615,Shannon; Kyle Michael,9,0,75,66
1657620714095,COGS 11,A01,083617,Boyle; Mary E. T.,23,0,48,25
1657620720117,COGS 13,A01,083071,Bastos; Amalia Pinkusfeld,11,0,71,60
1657620726150,COGS 14A,A01,092681,Semenuks; Arturs,5,1,100,95
1657620732172,COGS 14B,A01,083073,Cheng; Tzu-Han,6,0,63,57
1657620738198,COGS 17,A01,092677,Semenuks; Arturs,6,0,81,75
1657620744225,COGS 100,A01,083619,Allen; Michael Gordon,17,0,70,53
1657620750252,COGS 101A,A01,083621,Davis; Joshua Daniel,9,0,68,59
1657620756278,COGS 101B,A01,091572,Allen; Michael Gordon,12,0,65,53
1657620762319,COGS 101C,A01,083625,Delgado; Tania,17,0,35,18
1657620768347,COGS 107A,A01,083627,Boyle; Mary E. T.,13,0,60,47
1657620774374,COGS 118A,A01,083075,Gupta; Anjum,21,0,76,55
1657620780397,CSE 3,A50,083646,Miranda; Gregory Joseph,24,0,50,26
1657620786425,CSE 8A,A50,083650,Miranda; Gregory Joseph,17,1,56,39
1657620792450,CSE 11,A01,083080,Cao; Yingjun,6,15,40,34
1657620798476,CSE 12,A01,083652,Krause-Levy; Sophia Louisa,28,1,120,92
1657620804498,CSE 15L,A01,083654,Morris; Justin Loren,9,0,50,41
1657620804498,CSE 15L,A02,083655,Morris; Justin Loren,9,0,50,41
1657620810522,CSE 20,A01,083657,Tran; Khoa Dang,39,0,80,41
1657620816617,CSE 21,A01,095574,Bach; Quang Tran,22,0,48,26
1657620822639,CSE 30,A01,083084,Eldon; John,6,0,80,74
1657620822639,CSE 30,B01,095061,Bhaskar; Nishant,9,0,50,41
1657620828666,CSE 100,A01,083659,Cao; Yingjun,5,4,70,65
1657620834694,CSE 134B,A01,083661,Powell; Thomas Allan,22,0,100,78
1657620840718,CSE 140,A01,083663,Gungor; Onat,15,0,85,70
1657620846741,CSE 140L,A01,083088,Eldon; John,21,0,100,79
1657620852764,CSE 175,A01,083665,Kumar; Rakesh,3,0,25,22
1657620858790,CSE 190,A00,092507,Dubnov; Shlomo,8,0,20,12
1657620864818,ECE 45,A01,083139,Congero; Spencer William,6,0,75,69
1657620870846,ECE 65,A50,083695,Saad; Andrew S,12,0,30,18
1657620870846,ECE 65,A51,095125,Saad; Andrew S,24,0,26,2
1657620876873,ECE 109,A01,091882,Touri; Behrouz,19,0,70,51
1657620882899,ECE 180,A00,083140,Abi Samra; Nicholas Camill,1,0,30,29
1657620882899,ECE 180,B00,083141,Abi Samra; Nicholas Camill,0,0,30,30
1657620888927,MATH 10A,A01,083735,Patchell; Gregory David,2,0,30,28
1657620888927,MATH 10A,A02,083736,Patchell; Gregory David,20,0,30,10
1657620888927,MATH 10A,A03,083737,Patchell; Gregory David,16,0,30,14
1657620894955,MATH 10B,A01,083207,Lim; Seonhee,8,0,34,26
1657620894955,MATH 10B,A02,083208,Lim; Seonhee,9,0,35,26
1657620894955,MATH 10B,A03,093472,Lim; Seonhee,7,0,34,27
1657620894955,MATH 10B,B01,083739,Sinha; Shubham,12,0,30,18
1657620900980,MATH 18,A01,083743,Cinel; Cameron Alexander,7,0,30,23
1657620900980,MATH 18,A02,083744,Cinel; Cameron Alexander,17,0,30,13
1657620900980,MATH 18,A03,083745,Cinel; Cameron Alexander,9,0,30,21
1657620900980,MATH 18,B01,083748,Rideout; David Porter,5,0,37,32
1657620900980,MATH 18,B02,083749,Rideout; David Porter,5,0,36,31
1657620900980,MATH 18,B03,083750,Rideout; David Porter,3,0,37,34
1657620900980,MATH 18,B04,083751,Rideout; David Porter,6,0,36,30
1657620900980,MATH 18,B05,093473,Rideout; David Porter,6,0,36,30
1657620900980,MATH 18,B06,093474,Rideout; David Porter,6,0,36,30
1657620907002,MATH 20A,A01,083754,Zheng; Zequn,14,0,40,26
1657620913025,MATH 20B,A01,083756,Briones; Jor-el Thomas Caparas,4,0,36,32
1657620913025,MATH 20B,A02,083757,Briones; Jor-el Thomas Caparas,1,0,36,35
1657620913025,MATH 20B,A03,093475,Briones; Jor-el Thomas Caparas,2,0,36,34
1657620919054,MATH 20C,A01,083760,Briones; Jor-el Thomas Caparas,1,0,35,34
1657620919054,MATH 20C,A02,083761,Briones; Jor-el Thomas Caparas,8,0,35,27
1657620919054,MATH 20C,A03,093476,Briones; Jor-el Thomas Caparas,0,1,36,36
1657620919054,MATH 20C,B01,083762,Bach; Quang Tran,1,0,30,29
1657620925080,MATH 20D,A01,083765,Tran; Brian Kha,5,0,30,25
1657620925080,MATH 20D,A02,083766,Tran; Brian Kha,5,0,30,25
1657620925080,MATH 20D,A03,083767,Tran; Brian Kha,5,0,30,25
1657620931104,MATH 20E,A01,083771,Ganguly; Soumya,9,0,32,23
1657620931104,MATH 20E,A02,083772,Ganguly; Soumya,6,0,32,26
1657620931104,MATH 20E,B01,083773,Ciotti; Benjamin,20,0,35,15
1657620931104,MATH 20E,B02,083774,Ciotti; Benjamin,18,0,35,17
1657620937129,MATH 103A,A01,083777,Greenfeld; Be'Eri,3,0,36,33
1657620937129,MATH 103A,A02,083778,Greenfeld; Be'Eri,5,0,36,31
1657620937129,MATH 103A,A03,093561,Greenfeld; Be'Eri,6,0,36,30
1657620937129,MATH 103A,B01,083779,Greenfeld; Be'Eri,7,0,36,29
1657620937129,MATH 103A,B02,083780,Greenfeld; Be'Eri,4,0,36,32
1657620937129,MATH 103A,B03,093562,Greenfeld; Be'Eri,3,0,36,33
1657620943151,MATH 105,A01,085443,Carter; Anne Toulson,15,0,35,20
1657620943151,MATH 105,A02,093477,Carter; Anne Toulson,20,0,35,15
1657620949180,MATH 109,A01,083213,Ganzberger; Geoffrey Michael,2,0,34,32
1657620949180,MATH 109,A02,083214,Ganzberger; Geoffrey Michael,4,0,34,30
1657620949180,MATH 109,A03,093478,Ganzberger; Geoffrey Michael,2,0,34,32
1657620949180,MATH 109,B01,083215,Ganzberger; Geoffrey Michael,1,0,32,31
1657620949180,MATH 109,B02,083216,Ganzberger; Geoffrey Michael,2,0,32,30
1657620949180,MATH 109,B03,093479,Ganzberger; Geoffrey Michael,8,0,32,24
1657620955204,MATH 142A,A01,083219,Chow; Bennett,7,0,32,25
1657620955204,MATH 142A,A02,083220,Chow; Bennett,10,0,32,22
1657620955204,MATH 142A,A03,093480,Chow; Bennett,9,0,32,23
1657620955204,MATH 142A,B03,093481,Chow; Bennett,8,0,32,24
1657620955204,MATH 142A,B04,093558,Chow; Bennett,13,0,32,19
1657620955204,MATH 142A,B05,093559,Chow; Bennett,6,0,32,26
1657620961234,MATH 193A,A01,083224,Rotar; Vladimir,8,0,34,26
1657620961234,MATH 193A,A02,083225,Rotar; Vladimir,9,0,34,25
1657620961234,MATH 193A,A03,083781,Rotar; Vladimir,5,0,34,29
1657620961234,MATH 193A,A04,083782,Rotar; Vladimir,10,0,34,24
1657620961234,MATH 193A,A05,093482,Rotar; Vladimir,10,0,34,24
1657620967264,MATH 197,001,091859,McAuley; Julian John,9999,0,9999,0
1657620967264,MATH 197,002,095566,Kedlaya; Kiran S.,9997,0,9999,2
1657620967264,MATH 197,003,095567,Xiao; Ming,9999,0,9999,0
1657620967264,MATH 197,004,095571,Perols; Johan Lars,9998,0,9999,1
1657620974320,COGS 9,A01,083615,Shannon; Kyle Michael,9,0,75,66
1657620980344,COGS 11,A01,083617,Boyle; Mary E. T.,23,0,48,25
1657620986369,COGS 13,A01,083071,Bastos; Amalia Pinkusfeld,11,0,71,60
1657620992396,COGS 14A,A01,092681,Semenuks; Arturs,5,1,100,95
1657620998420,COGS 14B,A01,083073,Cheng; Tzu-Han,6,0,63,57
1657621004454,COGS 17,A01,092677,Semenuks; Arturs,6,0,81,75
1657621010481,COGS 100,A01,083619,Allen; Michael Gordon,17,0,70,53
1657621016505,COGS 101A,A01,083621,Davis; Joshua Daniel,9,0,68,59
1657621022528,COGS 101B,A01,091572,Allen; Michael Gordon,12,0,65,53
1657621028551,COGS 101C,A01,083625,Delgado; Tania,17,0,35,18
1657621034574,COGS 107A,A01,083627,Boyle; Mary E. T.,13,0,60,47
1657621040599,COGS 118A,A01,083075,Gupta; Anjum,21,0,76,55
1657621046632,CSE 3,A50,083646,Miranda; Gregory Joseph,24,0,50,26
1657621052656,CSE 8A,A50,083650,Miranda; Gregory Joseph,17,1,56,39
1657621058682,CSE 11,A01,083080,Cao; Yingjun,6,15,40,34
1657621064706,CSE 12,A01,083652,Krause-Levy; Sophia Louisa,28,1,120,92
1657621070733,CSE 15L,A01,083654,Morris; Justin Loren,9,0,50,41
1657621070733,CSE 15L,A02,083655,Morris; Justin Loren,9,0,50,41
1657621076763,CSE 20,A01,083657,Tran; Khoa Dang,39,0,80,41
1657621082786,CSE 21,A01,095574,Bach; Quang Tran,22,0,48,26
1657621088809,CSE 30,A01,083084,Eldon; John,6,0,80,74
1657621088809,CSE 30,B01,095061,Bhaskar; Nishant,9,0,50,41
1657621094843,CSE 100,A01,083659,Cao; Yingjun,5,4,70,65
1657621100866,CSE 134B,A01,083661,Powell; Thomas Allan,22,0,100,78
1657621106892,CSE 140,A01,083663,Gungor; Onat,15,0,85,70
1657621112918,CSE 140L,A01,083088,Eldon; John,21,0,100,79
1657621118959,CSE 175,A01,083665,Kumar; Rakesh,3,0,25,22
1657621124984,CSE 190,A00,092507,Dubnov; Shlomo,8,0,20,12
1657621131007,ECE 45,A01,083139,Congero; Spencer William,6,0,75,69
1657621137040,ECE 65,A50,083695,Saad; Andrew S,12,0,30,18
1657621137040,ECE 65,A51,095125,Saad; Andrew S,24,0,26,2
1657621143063,ECE 109,A01,091882,Touri; Behrouz,19,0,70,51
