time,subj_course_id,sec_code,sec_id,prof,available,waitlist,total,enrolled_ct
1657710775859,COGS 9,A01,083615,Shannon; Kyle Michael,9,0,75,66
1657710781889,COGS 11,A01,083617,Boyle; Mary E. T.,23,0,48,25
1657710787923,COGS 13,A01,083071,Bastos; Amalia Pinkusfeld,11,0,71,60
1657710793952,COGS 14A,A01,092681,Semenuks; Arturs,5,1,100,95
1657710799990,COGS 14B,A01,083073,Cheng; Tzu-Han,6,0,63,57
1657710806020,COGS 17,A01,092677,Semenuks; Arturs,6,0,81,75
1657710812050,COGS 100,A01,083619,Allen; Michael Gordon,17,0,70,53
1657710818081,COGS 101A,A01,083621,Davis; Joshua Daniel,9,0,68,59
1657710824114,COGS 101B,A01,091572,Allen; Michael Gordon,12,0,65,53
1657710830146,COGS 101C,A01,083625,Delgado; Tania,17,0,35,18
1657710836182,COGS 107A,A01,083627,Boyle; Mary E. T.,13,0,60,47
1657710842213,COGS 118A,A01,083075,Gupta; Anjum,21,0,76,55
1657710848243,CSE 3,A50,083646,Miranda; Gregory Joseph,24,0,50,26
1657710854276,CSE 8A,A50,083650,Miranda; Gregory Joseph,17,1,56,39
1657710860308,CSE 11,A01,083080,Cao; Yingjun,6,15,40,34
1657710866339,CSE 12,A01,083652,Krause-Levy; Sophia Louisa,28,1,120,92
1657710872373,CSE 15L,A01,083654,Morris; Justin Loren,9,0,50,41
1657710872373,CSE 15L,A02,083655,Morris; Justin Loren,9,0,50,41
1657710878408,CSE 20,A01,083657,Tran; Khoa Dang,39,0,80,41
1657710884437,CSE 21,A01,095574,Bach; Quang Tran,22,0,48,26
1657710890466,CSE 30,A01,083084,Eldon; John,6,0,80,74
1657710890466,CSE 30,B01,095061,Bhaskar; Nishant,9,0,50,41
1657710896498,CSE 100,A01,083659,Cao; Yingjun,5,4,70,65
1657710902526,CSE 134B,A01,083661,Powell; Thomas Allan,23,0,100,77
1657710908556,CSE 140,A01,083663,Gungor; Onat,15,0,85,70
1657710914584,CSE 140L,A01,083088,Eldon; John,23,0,100,77
1657710920611,CSE 175,A01,083665,Kumar; Rakesh,3,0,25,22
1657710926638,CSE 190,A00,092507,Dubnov; Shlomo,8,0,20,12
1657710932665,ECE 45,A01,083139,Congero; Spencer William,6,0,75,69
1657710938711,ECE 65,A50,083695,Saad; Andrew S,12,0,30,18
1657710938711,ECE 65,A51,095125,Saad; Andrew S,24,0,26,2
1657710944747,ECE 109,A01,091882,Touri; Behrouz,20,0,70,50
1657710950776,ECE 180,A00,083140,Abi Samra; Nicholas Camill,1,0,30,29
1657710950776,ECE 180,B00,083141,Abi Samra; Nicholas Camill,0,0,30,30
1657710956809,MATH 10A,A01,083735,Patchell; Gregory David,2,0,30,28
1657710956809,MATH 10A,A02,083736,Patchell; Gregory David,20,0,30,10
1657710956809,MATH 10A,A03,083737,Patchell; Gregory David,16,0,30,14
1657710962844,MATH 10B,A01,083207,Lim; Seonhee,8,0,34,26
1657710962844,MATH 10B,A02,083208,Lim; Seonhee,9,0,35,26
1657710962844,MATH 10B,A03,093472,Lim; Seonhee,7,0,34,27
1657710962844,MATH 10B,B01,083739,Sinha; Shubham,13,0,30,17
1657710968890,MATH 18,A01,083743,Cinel; Cameron Alexander,8,0,30,22
1657710968890,MATH 18,A02,083744,Cinel; Cameron Alexander,17,0,30,13
1657710968890,MATH 18,A03,083745,Cinel; Cameron Alexander,10,0,30,20
1657710968890,MATH 18,B01,083748,Rideout; David Porter,5,0,37,32
1657710968890,MATH 18,B02,083749,Rideout; David Porter,5,0,36,31
1657710968890,MATH 18,B03,083750,Rideout; David Porter,3,0,37,34
1657710968890,MATH 18,B04,083751,Rideout; David Porter,6,0,36,30
1657710968890,MATH 18,B05,093473,Rideout; David Porter,6,0,36,30
1657710968890,MATH 18,B06,093474,Rideout; David Porter,6,0,36,30
1657710974919,MATH 20A,A01,083754,Zheng; Zequn,14,0,40,26
1657710980952,MATH 20B,A01,083756,Briones; Jor-el Thomas Caparas,4,0,36,32
1657710980952,MATH 20B,A02,083757,Briones; Jor-el Thomas Caparas,1,0,36,35
1657710980952,MATH 20B,A03,093475,Briones; Jor-el Thomas Caparas,2,0,36,34
1657710986987,MATH 20C,A01,083760,Briones; Jor-el Thomas Caparas,1,0,35,34
1657710986987,MATH 20C,A02,083761,Briones; Jor-el Thomas Caparas,8,0,35,27
1657710986987,MATH 20C,A03,093476,Briones; Jor-el Thomas Caparas,0,1,36,36
1657710986987,MATH 20C,B01,083762,Bach; Quang Tran,1,0,30,29
1657710993018,MATH 20D,A01,083765,Tran; Brian Kha,5,0,30,25
1657710993018,MATH 20D,A02,083766,Tran; Brian Kha,5,0,30,25
1657710993018,MATH 20D,A03,083767,Tran; Brian Kha,5,0,30,25
1657710999077,MATH 20E,A01,083771,Ganguly; Soumya,9,0,32,23
1657710999077,MATH 20E,A02,083772,Ganguly; Soumya,6,0,32,26
1657710999077,MATH 20E,B01,083773,Ciotti; Benjamin,20,0,35,15
1657710999077,MATH 20E,B02,083774,Ciotti; Benjamin,18,0,35,17
1657711005108,MATH 103A,A01,083777,Greenfeld; Be'Eri,3,0,36,33
1657711005108,MATH 103A,A02,083778,Greenfeld; Be'Eri,5,0,36,31
1657711005108,MATH 103A,A03,093561,Greenfeld; Be'Eri,6,0,36,30
1657711005108,MATH 103A,B01,083779,Greenfeld; Be'Eri,7,0,36,29
1657711005108,MATH 103A,B02,083780,Greenfeld; Be'Eri,4,0,36,32
1657711005108,MATH 103A,B03,093562,Greenfeld; Be'Eri,3,0,36,33
1657711011140,MATH 105,A01,085443,Carter; Anne Toulson,15,0,35,20
1657711011140,MATH 105,A02,093477,Carter; Anne Toulson,20,0,35,15
1657711017169,MATH 109,A01,083213,Ganzberger; Geoffrey Michael,2,0,34,32
1657711017169,MATH 109,A02,083214,Ganzberger; Geoffrey Michael,4,0,34,30
1657711017169,MATH 109,A03,093478,Ganzberger; Geoffrey Michael,2,0,34,32
1657711017169,MATH 109,B01,083215,Ganzberger; Geoffrey Michael,1,0,32,31
1657711017169,MATH 109,B02,083216,Ganzberger; Geoffrey Michael,2,0,32,30
1657711017169,MATH 109,B03,093479,Ganzberger; Geoffrey Michael,8,0,32,24
1657711023209,MATH 142A,A01,083219,Chow; Bennett,7,0,32,25
1657711023209,MATH 142A,A02,083220,Chow; Bennett,10,0,32,22
1657711023209,MATH 142A,A03,093480,Chow; Bennett,9,0,32,23
1657711023209,MATH 142A,B03,093481,Chow; Bennett,8,0,32,24
1657711023209,MATH 142A,B04,093558,Chow; Bennett,13,0,32,19
1657711023209,MATH 142A,B05,093559,Chow; Bennett,6,0,32,26
1657711029240,MATH 193A,A01,083224,Rotar; Vladimir,8,0,34,26
1657711029240,MATH 193A,A02,083225,Rotar; Vladimir,9,0,34,25
1657711029240,MATH 193A,A03,083781,Rotar; Vladimir,5,0,34,29
1657711029240,MATH 193A,A04,083782,Rotar; Vladimir,10,0,34,24
1657711029240,MATH 193A,A05,093482,Rotar; Vladimir,10,0,34,24
1657711035282,MATH 197,001,091859,McAuley; Julian John,9999,0,9999,0
1657711035282,MATH 197,002,095566,Kedlaya; Kiran S.,9997,0,9999,2
1657711035282,MATH 197,003,095567,Xiao; Ming,9999,0,9999,0
1657711035282,MATH 197,004,095571,Perols; Johan Lars,9998,0,9999,1
1657711042351,COGS 9,A01,083615,Shannon; Kyle Michael,9,0,75,66
1657711048382,COGS 11,A01,083617,Boyle; Mary E. T.,23,0,48,25
1657711054409,COGS 13,A01,083071,Bastos; Amalia Pinkusfeld,11,0,71,60
1657711060439,COGS 14A,A01,092681,Semenuks; Arturs,5,1,100,95
1657711066468,COGS 14B,A01,083073,Cheng; Tzu-Han,6,0,63,57
1657711072497,COGS 17,A01,092677,Semenuks; Arturs,6,0,81,75
1657711078527,COGS 100,A01,083619,Allen; Michael Gordon,17,0,70,53
1657711084559,COGS 101A,A01,083621,Davis; Joshua Daniel,9,0,68,59
1657711090596,COGS 101B,A01,091572,Allen; Michael Gordon,12,0,65,53
1657711096740,COGS 101C,A01,083625,Delgado; Tania,17,0,35,18
1657711102771,COGS 107A,A01,083627,Boyle; Mary E. T.,13,0,60,47
1657711108800,COGS 118A,A01,083075,Gupta; Anjum,21,0,76,55
1657711114840,CSE 3,A50,083646,Miranda; Gregory Joseph,24,0,50,26
1657711120867,CSE 8A,A50,083650,Miranda; Gregory Joseph,17,1,56,39
1657711126896,CSE 11,A01,083080,Cao; Yingjun,6,15,40,34
1657711132928,CSE 12,A01,083652,Krause-Levy; Sophia Louisa,28,1,120,92
1657711138961,CSE 15L,A01,083654,Morris; Justin Loren,9,0,50,41
1657711138961,CSE 15L,A02,083655,Morris; Justin Loren,9,0,50,41
1657711144995,CSE 20,A01,083657,Tran; Khoa Dang,39,0,80,41
1657711151025,CSE 21,A01,095574,Bach; Quang Tran,22,0,48,26
1657711163616,CSE 30,A01,083084,Eldon; John,6,0,80,74
1657711163616,CSE 30,B01,095061,Bhaskar; Nishant,9,0,50,41
1657711169758,CSE 100,A01,083659,Cao; Yingjun,5,4,70,65
1657711184092,CSE 134B,A01,083661,Powell; Thomas Allan,23,0,100,77
1657711190130,CSE 140,A01,083663,Gungor; Onat,15,0,85,70
1657711204398,CSE 140L,A01,083088,Eldon; John,23,0,100,77
1657711210427,CSE 175,A01,083665,Kumar; Rakesh,3,0,25,22
1657711225712,CSE 190,A00,092507,Dubnov; Shlomo,8,0,20,12
1657711231743,ECE 45,A01,083139,Congero; Spencer William,6,0,75,69
1657711246416,ECE 65,A50,083695,Saad; Andrew S,12,0,30,18
1657711246416,ECE 65,A51,095125,Saad; Andrew S,24,0,26,2
1657711252451,ECE 109,A01,091882,Touri; Behrouz,20,0,70,50
1657711266957,ECE 180,A00,083140,Abi Samra; Nicholas Camill,1,0,30,29
1657711266957,ECE 180,B00,083141,Abi Samra; Nicholas Camill,0,0,30,30
1657711272997,MATH 10A,A01,083735,Patchell; Gregory David,2,0,30,28
1657711272997,MATH 10A,A02,083736,Patchell; Gregory David,20,0,30,10
1657711272997,MATH 10A,A03,083737,Patchell; Gregory David,16,0,30,14
1657711280787,MATH 10B,A01,083207,Lim; Seonhee,8,0,34,26
1657711280787,MATH 10B,A02,083208,Lim; Seonhee,9,0,35,26
1657711280787,MATH 10B,A03,093472,Lim; Seonhee,7,0,34,27
1657711280787,MATH 10B,B01,083739,Sinha; Shubham,13,0,30,17
1657711286822,MATH 18,A01,083743,Cinel; Cameron Alexander,8,0,30,22
1657711286822,MATH 18,A02,083744,Cinel; Cameron Alexander,17,0,30,13
1657711286822,MATH 18,A03,083745,Cinel; Cameron Alexander,10,0,30,20
1657711286822,MATH 18,B01,083748,Rideout; David Porter,5,0,37,32
1657711286822,MATH 18,B02,083749,Rideout; David Porter,5,0,36,31
1657711286822,MATH 18,B03,083750,Rideout; David Porter,3,0,37,34
1657711286822,MATH 18,B04,083751,Rideout; David Porter,6,0,36,30
1657711286822,MATH 18,B05,093473,Rideout; David Porter,6,0,36,30
1657711286822,MATH 18,B06,093474,Rideout; David Porter,6,0,36,30
1657711292849,MATH 20A,A01,083754,Zheng; Zequn,14,0,40,26
1657711298880,MATH 20B,A01,083756,Briones; Jor-el Thomas Caparas,4,0,36,32
1657711298880,MATH 20B,A02,083757,Briones; Jor-el Thomas Caparas,1,0,36,35
1657711298880,MATH 20B,A03,093475,Briones; Jor-el Thomas Caparas,2,0,36,34
1657711304912,MATH 20C,A01,083760,Briones; Jor-el Thomas Caparas,1,0,35,34
1657711304912,MATH 20C,A02,083761,Briones; Jor-el Thomas Caparas,8,0,35,27
1657711304912,MATH 20C,A03,093476,Briones; Jor-el Thomas Caparas,0,1,36,36
1657711304912,MATH 20C,B01,083762,Bach; Quang Tran,1,0,30,29
1657711310942,MATH 20D,A01,083765,Tran; Brian Kha,5,0,30,25
1657711310942,MATH 20D,A02,083766,Tran; Brian Kha,5,0,30,25
1657711310942,MATH 20D,A03,083767,Tran; Brian Kha,5,0,30,25
1657711316974,MATH 20E,A01,083771,Ganguly; Soumya,9,0,32,23
1657711316974,MATH 20E,A02,083772,Ganguly; Soumya,6,0,32,26
1657711316974,MATH 20E,B01,083773,Ciotti; Benjamin,20,0,35,15
1657711316974,MATH 20E,B02,083774,Ciotti; Benjamin,18,0,35,17
1657711323009,MATH 103A,A01,083777,Greenfeld; Be'Eri,3,0,36,33
1657711323009,MATH 103A,A02,083778,Greenfeld; Be'Eri,5,0,36,31
1657711323009,MATH 103A,A03,093561,Greenfeld; Be'Eri,6,0,36,30
1657711323009,MATH 103A,B01,083779,Greenfeld; Be'Eri,7,0,36,29
1657711323009,MATH 103A,B02,083780,Greenfeld; Be'Eri,4,0,36,32
1657711323009,MATH 103A,B03,093562,Greenfeld; Be'Eri,3,0,36,33
1657711329045,MATH 105,A01,085443,Carter; Anne Toulson,15,0,35,20
1657711329045,MATH 105,A02,093477,Carter; Anne Toulson,20,0,35,15
1657711335078,MATH 109,A01,083213,Ganzberger; Geoffrey Michael,2,0,34,32
1657711335078,MATH 109,A02,083214,Ganzberger; Geoffrey Michael,4,0,34,30
1657711335078,MATH 109,A03,093478,Ganzberger; Geoffrey Michael,2,0,34,32
1657711335078,MATH 109,B01,083215,Ganzberger; Geoffrey Michael,1,0,32,31
1657711335078,MATH 109,B02,083216,Ganzberger; Geoffrey Michael,2,0,32,30
1657711335078,MATH 109,B03,093479,Ganzberger; Geoffrey Michael,8,0,32,24
1657711341109,MATH 142A,A01,083219,Chow; Bennett,7,0,32,25
1657711341109,MATH 142A,A02,083220,Chow; Bennett,10,0,32,22
1657711341109,MATH 142A,A03,093480,Chow; Bennett,9,0,32,23
1657711341109,MATH 142A,B03,093481,Chow; Bennett,8,0,32,24
1657711341109,MATH 142A,B04,093558,Chow; Bennett,13,0,32,19
1657711341109,MATH 142A,B05,093559,Chow; Bennett,6,0,32,26
1657711347141,MATH 193A,A01,083224,Rotar; Vladimir,8,0,34,26
1657711347141,MATH 193A,A02,083225,Rotar; Vladimir,9,0,34,25
1657711347141,MATH 193A,A03,083781,Rotar; Vladimir,5,0,34,29
1657711347141,MATH 193A,A04,083782,Rotar; Vladimir,10,0,34,24
1657711347141,MATH 193A,A05,093482,Rotar; Vladimir,10,0,34,24
1657711353180,MATH 197,001,091859,McAuley; Julian John,9999,0,9999,0
1657711353180,MATH 197,002,095566,Kedlaya; Kiran S.,9997,0,9999,2
1657711353180,MATH 197,003,095567,Xiao; Ming,9999,0,9999,0
1657711353180,MATH 197,004,095571,Perols; Johan Lars,9998,0,9999,1
1657711360295,COGS 9,A01,083615,Shannon; Kyle Michael,9,0,75,66
1657711366330,COGS 11,A01,083617,Boyle; Mary E. T.,23,0,48,25
1657711372364,COGS 13,A01,083071,Bastos; Amalia Pinkusfeld,11,0,71,60
1657711378402,COGS 14A,A01,092681,Semenuks; Arturs,5,1,100,95
1657711384431,COGS 14B,A01,083073,Cheng; Tzu-Han,6,0,63,57
1657711390460,COGS 17,A01,092677,Semenuks; Arturs,6,0,81,75
1657711396491,COGS 100,A01,083619,Allen; Michael Gordon,17,0,70,53
1657711402598,COGS 101A,A01,083621,Davis; Joshua Daniel,9,0,68,59
1657711408630,COGS 101B,A01,091572,Allen; Michael Gordon,12,0,65,53
1657711414665,COGS 101C,A01,083625,Delgado; Tania,17,0,35,18
1657711420698,COGS 107A,A01,083627,Boyle; Mary E. T.,13,0,60,47
1657711426732,COGS 118A,A01,083075,Gupta; Anjum,21,0,76,55
1657711432767,CSE 3,A50,083646,Miranda; Gregory Joseph,24,0,50,26
1657711438792,CSE 8A,A50,083650,Miranda; Gregory Joseph,17,1,56,39
1657711444820,CSE 11,A01,083080,Cao; Yingjun,6,15,40,34
1657711450853,CSE 12,A01,083652,Krause-Levy; Sophia Louisa,28,1,120,92
1657711456888,CSE 15L,A01,083654,Morris; Justin Loren,9,0,50,41
1657711456888,CSE 15L,A02,083655,Morris; Justin Loren,9,0,50,41
1657711462922,CSE 20,A01,083657,Tran; Khoa Dang,39,0,80,41
1657711468957,CSE 21,A01,095574,Bach; Quang Tran,22,0,48,26
1657711474995,CSE 30,A01,083084,Eldon; John,6,0,80,74
1657711474995,CSE 30,B01,095061,Bhaskar; Nishant,9,0,50,41
1657711481023,CSE 100,A01,083659,Cao; Yingjun,5,4,70,65
1657711487053,CSE 134B,A01,083661,Powell; Thomas Allan,23,0,100,77
1657711493082,CSE 140,A01,083663,Gungor; Onat,15,0,85,70
1657711499110,CSE 140L,A01,083088,Eldon; John,23,0,100,77
1657711505139,CSE 175,A01,083665,Kumar; Rakesh,3,0,25,22
1657711511180,CSE 190,A00,092507,Dubnov; Shlomo,8,0,20,12
1657711517209,ECE 45,A01,083139,Congero; Spencer William,6,0,75,69
1657711523249,ECE 65,A50,083695,Saad; Andrew S,12,0,30,18
1657711523249,ECE 65,A51,095125,Saad; Andrew S,24,0,26,2
1657711529285,ECE 109,A01,091882,Touri; Behrouz,20,0,70,50
1657711535316,ECE 180,A00,083140,Abi Samra; Nicholas Camill,1,0,30,29
1657711535316,ECE 180,B00,083141,Abi Samra; Nicholas Camill,0,0,30,30
1657711541347,MATH 10A,A01,083735,Patchell; Gregory David,2,0,30,28
1657711541347,MATH 10A,A02,083736,Patchell; Gregory David,20,0,30,10
1657711541347,MATH 10A,A03,083737,Patchell; Gregory David,16,0,30,14
1657711547380,MATH 10B,A01,083207,Lim; Seonhee,8,0,34,26
1657711547380,MATH 10B,A02,083208,Lim; Seonhee,9,0,35,26
1657711547380,MATH 10B,A03,093472,Lim; Seonhee,7,0,34,27
1657711547380,MATH 10B,B01,083739,Sinha; Shubham,13,0,30,17
1657711553413,MATH 18,A01,083743,Cinel; Cameron Alexander,8,0,30,22
1657711553413,MATH 18,A02,083744,Cinel; Cameron Alexander,17,0,30,13
1657711553413,MATH 18,A03,083745,Cinel; Cameron Alexander,10,0,30,20
1657711553413,MATH 18,B01,083748,Rideout; David Porter,5,0,37,32
1657711553413,MATH 18,B02,083749,Rideout; David Porter,5,0,36,31
1657711553413,MATH 18,B03,083750,Rideout; David Porter,3,0,37,34
1657711553413,MATH 18,B04,083751,Rideout; David Porter,6,0,36,30
1657711553413,MATH 18,B05,093473,Rideout; David Porter,6,0,36,30
1657711553413,MATH 18,B06,093474,Rideout; David Porter,6,0,36,30
1657711559440,MATH 20A,A01,083754,Zheng; Zequn,14,0,40,26
1657711565479,MATH 20B,A01,083756,Briones; Jor-el Thomas Caparas,4,0,36,32
1657711565479,MATH 20B,A02,083757,Briones; Jor-el Thomas Caparas,1,0,36,35
1657711565479,MATH 20B,A03,093475,Briones; Jor-el Thomas Caparas,2,0,36,34
1657711571510,MATH 20C,A01,083760,Briones; Jor-el Thomas Caparas,1,0,35,34
1657711571510,MATH 20C,A02,083761,Briones; Jor-el Thomas Caparas,8,0,35,27
1657711571510,MATH 20C,A03,093476,Briones; Jor-el Thomas Caparas,0,1,36,36
1657711571510,MATH 20C,B01,083762,Bach; Quang Tran,1,0,30,29
1657711577542,MATH 20D,A01,083765,Tran; Brian Kha,5,0,30,25
1657711577542,MATH 20D,A02,083766,Tran; Brian Kha,5,0,30,25
1657711577542,MATH 20D,A03,083767,Tran; Brian Kha,5,0,30,25
1657711583579,MATH 20E,A01,083771,Ganguly; Soumya,9,0,32,23
1657711583579,MATH 20E,A02,083772,Ganguly; Soumya,6,0,32,26
1657711583579,MATH 20E,B01,083773,Ciotti; Benjamin,20,0,35,15
1657711583579,MATH 20E,B02,083774,Ciotti; Benjamin,18,0,35,17
1657711589610,MATH 103A,A01,083777,Greenfeld; Be'Eri,3,0,36,33
1657711589610,MATH 103A,A02,083778,Greenfeld; Be'Eri,5,0,36,31
1657711589610,MATH 103A,A03,093561,Greenfeld; Be'Eri,6,0,36,30
1657711589610,MATH 103A,B01,083779,Greenfeld; Be'Eri,7,0,36,29
1657711589610,MATH 103A,B02,083780,Greenfeld; Be'Eri,4,0,36,32
1657711589610,MATH 103A,B03,093562,Greenfeld; Be'Eri,3,0,36,33
1657711595635,MATH 105,A01,085443,Carter; Anne Toulson,15,0,35,20
1657711595635,MATH 105,A02,093477,Carter; Anne Toulson,20,0,35,15
1657711601668,MATH 109,A01,083213,Ganzberger; Geoffrey Michael,2,0,34,32
1657711601668,MATH 109,A02,083214,Ganzberger; Geoffrey Michael,4,0,34,30
1657711601668,MATH 109,A03,093478,Ganzberger; Geoffrey Michael,2,0,34,32
1657711601668,MATH 109,B01,083215,Ganzberger; Geoffrey Michael,1,0,32,31
1657711601668,MATH 109,B02,083216,Ganzberger; Geoffrey Michael,2,0,32,30
1657711601668,MATH 109,B03,093479,Ganzberger; Geoffrey Michael,8,0,32,24
1657711607698,MATH 142A,A01,083219,Chow; Bennett,7,0,32,25
1657711607698,MATH 142A,A02,083220,Chow; Bennett,10,0,32,22
1657711607698,MATH 142A,A03,093480,Chow; Bennett,9,0,32,23
1657711607698,MATH 142A,B03,093481,Chow; Bennett,8,0,32,24
1657711607698,MATH 142A,B04,093558,Chow; Bennett,13,0,32,19
1657711607698,MATH 142A,B05,093559,Chow; Bennett,6,0,32,26
1657711613726,MATH 193A,A01,083224,Rotar; Vladimir,8,0,34,26
1657711613726,MATH 193A,A02,083225,Rotar; Vladimir,9,0,34,25
1657711613726,MATH 193A,A03,083781,Rotar; Vladimir,5,0,34,29
1657711613726,MATH 193A,A04,083782,Rotar; Vladimir,10,0,34,24
1657711613726,MATH 193A,A05,093482,Rotar; Vladimir,10,0,34,24
1657711619756,MATH 197,001,091859,McAuley; Julian John,9999,0,9999,0
1657711619756,MATH 197,002,095566,Kedlaya; Kiran S.,9997,0,9999,2
1657711619756,MATH 197,003,095567,Xiao; Ming,9999,0,9999,0
1657711619756,MATH 197,004,095571,Perols; Johan Lars,9998,0,9999,1
1657711626838,COGS 9,A01,083615,Shannon; Kyle Michael,9,0,75,66
1657711632864,COGS 11,A01,083617,Boyle; Mary E. T.,23,0,48,25
1657711638900,COGS 13,A01,083071,Bastos; Amalia Pinkusfeld,11,0,71,60
1657711644940,COGS 14A,A01,092681,Semenuks; Arturs,5,1,100,95
1657711650966,COGS 14B,A01,083073,Cheng; Tzu-Han,6,0,63,57
1657711656991,COGS 17,A01,092677,Semenuks; Arturs,6,0,81,75
1657711663019,COGS 100,A01,083619,Allen; Michael Gordon,17,0,70,53
1657711669050,COGS 101A,A01,083621,Davis; Joshua Daniel,9,0,68,59
1657711675084,COGS 101B,A01,091572,Allen; Michael Gordon,12,0,65,53
1657711681114,COGS 101C,A01,083625,Delgado; Tania,17,0,35,18
1657711687144,COGS 107A,A01,083627,Boyle; Mary E. T.,13,0,60,47
1657711698877,COGS 118A,A01,083075,Gupta; Anjum,21,0,76,55
1657711704958,CSE 3,A50,083646,Miranda; Gregory Joseph,24,0,50,26
1657711713044,CSE 8A,A50,083650,Miranda; Gregory Joseph,17,1,56,39
1657711719073,CSE 11,A01,083080,Cao; Yingjun,6,15,40,34
1657711725101,CSE 12,A01,083652,Krause-Levy; Sophia Louisa,28,1,120,92
1657711731130,CSE 15L,A01,083654,Morris; Justin Loren,9,0,50,41
1657711731130,CSE 15L,A02,083655,Morris; Justin Loren,9,0,50,41
1657711737158,CSE 20,A01,083657,Tran; Khoa Dang,39,0,80,41
1657711743193,CSE 21,A01,095574,Bach; Quang Tran,22,0,48,26
1657711749230,CSE 30,A01,083084,Eldon; John,6,0,80,74
1657711749230,CSE 30,B01,095061,Bhaskar; Nishant,9,0,50,41
1657711755269,CSE 100,A01,083659,Cao; Yingjun,5,4,70,65
1657711761298,CSE 134B,A01,083661,Powell; Thomas Allan,23,0,100,77
1657711767338,CSE 140,A01,083663,Gungor; Onat,15,0,85,70
1657711773366,CSE 140L,A01,083088,Eldon; John,23,0,100,77
1657711779400,CSE 175,A01,083665,Kumar; Rakesh,3,0,25,22
1657711785430,CSE 190,A00,092507,Dubnov; Shlomo,8,0,20,12
1657711791465,ECE 45,A01,083139,Congero; Spencer William,6,0,75,69
1657711797497,ECE 65,A50,083695,Saad; Andrew S,12,0,30,18
1657711797497,ECE 65,A51,095125,Saad; Andrew S,24,0,26,2
1657711803532,ECE 109,A01,091882,Touri; Behrouz,20,0,70,50
1657711809561,ECE 180,A00,083140,Abi Samra; Nicholas Camill,1,0,30,29
1657711809561,ECE 180,B00,083141,Abi Samra; Nicholas Camill,0,0,30,30
1657711815590,MATH 10A,A01,083735,Patchell; Gregory David,2,0,30,28
1657711815590,MATH 10A,A02,083736,Patchell; Gregory David,20,0,30,10
1657711815590,MATH 10A,A03,083737,Patchell; Gregory David,16,0,30,14
1657711821620,MATH 10B,A01,083207,Lim; Seonhee,8,0,34,26
1657711821620,MATH 10B,A02,083208,Lim; Seonhee,9,0,35,26
1657711821620,MATH 10B,A03,093472,Lim; Seonhee,7,0,34,27
1657711821620,MATH 10B,B01,083739,Sinha; Shubham,13,0,30,17
1657711827662,MATH 18,A01,083743,Cinel; Cameron Alexander,8,0,30,22
1657711827662,MATH 18,A02,083744,Cinel; Cameron Alexander,17,0,30,13
1657711827662,MATH 18,A03,083745,Cinel; Cameron Alexander,10,0,30,20
1657711827662,MATH 18,B01,083748,Rideout; David Porter,5,0,37,32
1657711827662,MATH 18,B02,083749,Rideout; David Porter,5,0,36,31
1657711827662,MATH 18,B03,083750,Rideout; David Porter,3,0,37,34
1657711827662,MATH 18,B04,083751,Rideout; David Porter,6,0,36,30
1657711827662,MATH 18,B05,093473,Rideout; David Porter,6,0,36,30
1657711827662,MATH 18,B06,093474,Rideout; David Porter,6,0,36,30
1657711833690,MATH 20A,A01,083754,Zheng; Zequn,14,0,40,26
1657711839720,MATH 20B,A01,083756,Briones; Jor-el Thomas Caparas,4,0,36,32
1657711839720,MATH 20B,A02,083757,Briones; Jor-el Thomas Caparas,1,0,36,35
1657711839720,MATH 20B,A03,093475,Briones; Jor-el Thomas Caparas,2,0,36,34
1657711845749,MATH 20C,A01,083760,Briones; Jor-el Thomas Caparas,1,0,35,34
1657711845749,MATH 20C,A02,083761,Briones; Jor-el Thomas Caparas,8,0,35,27
1657711845749,MATH 20C,A03,093476,Briones; Jor-el Thomas Caparas,0,1,36,36
1657711845749,MATH 20C,B01,083762,Bach; Quang Tran,1,0,30,29
1657711851776,MATH 20D,A01,083765,Tran; Brian Kha,5,0,30,25
1657711851776,MATH 20D,A02,083766,Tran; Brian Kha,5,0,30,25
1657711851776,MATH 20D,A03,083767,Tran; Brian Kha,5,0,30,25
1657711857807,MATH 20E,A01,083771,Ganguly; Soumya,9,0,32,23
1657711857807,MATH 20E,A02,083772,Ganguly; Soumya,6,0,32,26
1657711857807,MATH 20E,B01,083773,Ciotti; Benjamin,20,0,35,15
1657711857807,MATH 20E,B02,083774,Ciotti; Benjamin,18,0,35,17
1657711863837,MATH 103A,A01,083777,Greenfeld; Be'Eri,3,0,36,33
1657711863837,MATH 103A,A02,083778,Greenfeld; Be'Eri,5,0,36,31
1657711863837,MATH 103A,A03,093561,Greenfeld; Be'Eri,6,0,36,30
1657711863837,MATH 103A,B01,083779,Greenfeld; Be'Eri,7,0,36,29
1657711863837,MATH 103A,B02,083780,Greenfeld; Be'Eri,4,0,36,32
1657711863837,MATH 103A,B03,093562,Greenfeld; Be'Eri,3,0,36,33
1657711869875,MATH 105,A01,085443,Carter; Anne Toulson,15,0,35,20
1657711869875,MATH 105,A02,093477,Carter; Anne Toulson,20,0,35,15
1657711875903,MATH 109,A01,083213,Ganzberger; Geoffrey Michael,2,0,34,32
1657711875903,MATH 109,A02,083214,Ganzberger; Geoffrey Michael,4,0,34,30
1657711875903,MATH 109,A03,093478,Ganzberger; Geoffrey Michael,2,0,34,32
1657711875903,MATH 109,B01,083215,Ganzberger; Geoffrey Michael,1,0,32,31
1657711875903,MATH 109,B02,083216,Ganzberger; Geoffrey Michael,2,0,32,30
1657711875903,MATH 109,B03,093479,Ganzberger; Geoffrey Michael,8,0,32,24
1657711881937,MATH 142A,A01,083219,Chow; Bennett,7,0,32,25
1657711881937,MATH 142A,A02,083220,Chow; Bennett,10,0,32,22
1657711881937,MATH 142A,A03,093480,Chow; Bennett,9,0,32,23
1657711881937,MATH 142A,B03,093481,Chow; Bennett,8,0,32,24
1657711881937,MATH 142A,B04,093558,Chow; Bennett,13,0,32,19
1657711881937,MATH 142A,B05,093559,Chow; Bennett,6,0,32,26
1657711887970,MATH 193A,A01,083224,Rotar; Vladimir,8,0,34,26
1657711887970,MATH 193A,A02,083225,Rotar; Vladimir,9,0,34,25
1657711887970,MATH 193A,A03,083781,Rotar; Vladimir,5,0,34,29
1657711887970,MATH 193A,A04,083782,Rotar; Vladimir,10,0,34,24
1657711887970,MATH 193A,A05,093482,Rotar; Vladimir,10,0,34,24
1657711894001,MATH 197,001,091859,McAuley; Julian John,9999,0,9999,0
1657711894001,MATH 197,002,095566,Kedlaya; Kiran S.,9997,0,9999,2
1657711894001,MATH 197,003,095567,Xiao; Ming,9999,0,9999,0
1657711894001,MATH 197,004,095571,Perols; Johan Lars,9998,0,9999,1
1657711901085,COGS 9,A01,083615,Shannon; Kyle Michael,9,0,75,66
1657711907111,COGS 11,A01,083617,Boyle; Mary E. T.,23,0,48,25
1657711913137,COGS 13,A01,083071,Bastos; Amalia Pinkusfeld,11,0,71,60
1657711919172,COGS 14A,A01,092681,Semenuks; Arturs,5,1,100,95
1657711925198,COGS 14B,A01,083073,Cheng; Tzu-Han,6,0,63,57
1657711931227,COGS 17,A01,092677,Semenuks; Arturs,6,0,81,75
1657711937254,COGS 100,A01,083619,Allen; Michael Gordon,17,0,70,53
1657711943285,COGS 101A,A01,083621,Davis; Joshua Daniel,9,0,68,59
1657711949312,COGS 101B,A01,091572,Allen; Michael Gordon,12,0,65,53
1657711955347,COGS 101C,A01,083625,Delgado; Tania,17,0,35,18
1657711961379,COGS 107A,A01,083627,Boyle; Mary E. T.,13,0,60,47
1657711967407,COGS 118A,A01,083075,Gupta; Anjum,21,0,76,55
1657711973441,CSE 3,A50,083646,Miranda; Gregory Joseph,24,0,50,26
1657711979467,CSE 8A,A50,083650,Miranda; Gregory Joseph,17,1,56,39
1657711985497,CSE 11,A01,083080,Cao; Yingjun,6,15,40,34
1657711991529,CSE 12,A01,083652,Krause-Levy; Sophia Louisa,28,1,120,92
1657711997556,CSE 15L,A01,083654,Morris; Justin Loren,9,0,50,41
1657711997556,CSE 15L,A02,083655,Morris; Justin Loren,9,0,50,41
1657712003583,CSE 20,A01,083657,Tran; Khoa Dang,39,0,80,41
1657712009710,CSE 21,A01,095574,Bach; Quang Tran,22,0,48,26
1657712015751,CSE 30,A01,083084,Eldon; John,6,0,80,74
1657712015751,CSE 30,B01,095061,Bhaskar; Nishant,9,0,50,41
1657712021782,CSE 100,A01,083659,Cao; Yingjun,5,4,70,65
1657712027813,CSE 134B,A01,083661,Powell; Thomas Allan,23,0,100,77
1657712033839,CSE 140,A01,083663,Gungor; Onat,15,0,85,70
1657712039866,CSE 140L,A01,083088,Eldon; John,23,0,100,77
1657712045898,CSE 175,A01,083665,Kumar; Rakesh,3,0,25,22
1657712051926,CSE 190,A00,092507,Dubnov; Shlomo,8,0,20,12
1657712057958,ECE 45,A01,083139,Congero; Spencer William,6,0,75,69
1657712063990,ECE 65,A50,083695,Saad; Andrew S,12,0,30,18
1657712063990,ECE 65,A51,095125,Saad; Andrew S,24,0,26,2
1657712070021,ECE 109,A01,091882,Touri; Behrouz,20,0,70,50
1657712076054,ECE 180,A00,083140,Abi Samra; Nicholas Camill,1,0,30,29
1657712076054,ECE 180,B00,083141,Abi Samra; Nicholas Camill,0,0,30,30
1657712082090,MATH 10A,A01,083735,Patchell; Gregory David,2,0,30,28
1657712082090,MATH 10A,A02,083736,Patchell; Gregory David,20,0,30,10
1657712082090,MATH 10A,A03,083737,Patchell; Gregory David,16,0,30,14
1657712088121,MATH 10B,A01,083207,Lim; Seonhee,8,0,34,26
1657712088121,MATH 10B,A02,083208,Lim; Seonhee,9,0,35,26
1657712088121,MATH 10B,A03,093472,Lim; Seonhee,7,0,34,27
1657712088121,MATH 10B,B01,083739,Sinha; Shubham,13,0,30,17
1657712094156,MATH 18,A01,083743,Cinel; Cameron Alexander,8,0,30,22
1657712094156,MATH 18,A02,083744,Cinel; Cameron Alexander,17,0,30,13
1657712094156,MATH 18,A03,083745,Cinel; Cameron Alexander,10,0,30,20
1657712094156,MATH 18,B01,083748,Rideout; David Porter,5,0,37,32
1657712094156,MATH 18,B02,083749,Rideout; David Porter,5,0,36,31
1657712094156,MATH 18,B03,083750,Rideout; David Porter,3,0,37,34
1657712094156,MATH 18,B04,083751,Rideout; David Porter,6,0,36,30
1657712094156,MATH 18,B05,093473,Rideout; David Porter,6,0,36,30
1657712094156,MATH 18,B06,093474,Rideout; David Porter,6,0,36,30
1657712100188,MATH 20A,A01,083754,Zheng; Zequn,14,0,40,26
1657712106224,MATH 20B,A01,083756,Briones; Jor-el Thomas Caparas,4,0,36,32
1657712106224,MATH 20B,A02,083757,Briones; Jor-el Thomas Caparas,1,0,36,35
1657712106224,MATH 20B,A03,093475,Briones; Jor-el Thomas Caparas,2,0,36,34
1657712112250,MATH 20C,A01,083760,Briones; Jor-el Thomas Caparas,1,0,35,34
1657712112250,MATH 20C,A02,083761,Briones; Jor-el Thomas Caparas,8,0,35,27
1657712112250,MATH 20C,A03,093476,Briones; Jor-el Thomas Caparas,0,1,36,36
1657712112250,MATH 20C,B01,083762,Bach; Quang Tran,1,0,30,29
1657712118282,MATH 20D,A01,083765,Tran; Brian Kha,5,0,30,25
1657712118282,MATH 20D,A02,083766,Tran; Brian Kha,5,0,30,25
1657712118282,MATH 20D,A03,083767,Tran; Brian Kha,5,0,30,25
1657712124309,MATH 20E,A01,083771,Ganguly; Soumya,9,0,32,23
1657712124309,MATH 20E,A02,083772,Ganguly; Soumya,6,0,32,26
1657712124309,MATH 20E,B01,083773,Ciotti; Benjamin,20,0,35,15
1657712124309,MATH 20E,B02,083774,Ciotti; Benjamin,18,0,35,17
1657712130338,MATH 103A,A01,083777,Greenfeld; Be'Eri,3,0,36,33
1657712130338,MATH 103A,A02,083778,Greenfeld; Be'Eri,5,0,36,31
1657712130338,MATH 103A,A03,093561,Greenfeld; Be'Eri,6,0,36,30
1657712130338,MATH 103A,B01,083779,Greenfeld; Be'Eri,7,0,36,29
1657712130338,MATH 103A,B02,083780,Greenfeld; Be'Eri,4,0,36,32
1657712130338,MATH 103A,B03,093562,Greenfeld; Be'Eri,3,0,36,33
1657712136367,MATH 105,A01,085443,Carter; Anne Toulson,15,0,35,20
1657712136367,MATH 105,A02,093477,Carter; Anne Toulson,20,0,35,15
1657712142403,MATH 109,A01,083213,Ganzberger; Geoffrey Michael,2,0,34,32
1657712142403,MATH 109,A02,083214,Ganzberger; Geoffrey Michael,4,0,34,30
1657712142403,MATH 109,A03,093478,Ganzberger; Geoffrey Michael,2,0,34,32
1657712142403,MATH 109,B01,083215,Ganzberger; Geoffrey Michael,1,0,32,31
1657712142403,MATH 109,B02,083216,Ganzberger; Geoffrey Michael,2,0,32,30
1657712142403,MATH 109,B03,093479,Ganzberger; Geoffrey Michael,8,0,32,24
1657712148446,MATH 142A,A01,083219,Chow; Bennett,7,0,32,25
1657712148446,MATH 142A,A02,083220,Chow; Bennett,10,0,32,22
1657712148446,MATH 142A,A03,093480,Chow; Bennett,9,0,32,23
1657712148446,MATH 142A,B03,093481,Chow; Bennett,8,0,32,24
1657712148446,MATH 142A,B04,093558,Chow; Bennett,13,0,32,19
1657712148446,MATH 142A,B05,093559,Chow; Bennett,6,0,32,26
1657712154473,MATH 193A,A01,083224,Rotar; Vladimir,8,0,34,26
1657712154473,MATH 193A,A02,083225,Rotar; Vladimir,9,0,34,25
1657712154473,MATH 193A,A03,083781,Rotar; Vladimir,5,0,34,29
1657712154473,MATH 193A,A04,083782,Rotar; Vladimir,10,0,34,24
1657712154473,MATH 193A,A05,093482,Rotar; Vladimir,10,0,34,24
1657712160499,MATH 197,001,091859,McAuley; Julian John,9999,0,9999,0
1657712160499,MATH 197,002,095566,Kedlaya; Kiran S.,9997,0,9999,2
1657712160499,MATH 197,003,095567,Xiao; Ming,9999,0,9999,0
1657712160499,MATH 197,004,095571,Perols; Johan Lars,9998,0,9999,1
1657712167580,COGS 9,A01,083615,Shannon; Kyle Michael,9,0,75,66
1657712173607,COGS 11,A01,083617,Boyle; Mary E. T.,23,0,48,25
1657712179631,COGS 13,A01,083071,Bastos; Amalia Pinkusfeld,11,0,71,60
1657712185664,COGS 14A,A01,092681,Semenuks; Arturs,5,1,100,95
1657712191695,COGS 14B,A01,083073,Cheng; Tzu-Han,6,0,63,57
1657712197720,COGS 17,A01,092677,Semenuks; Arturs,6,0,81,75
1657712203753,COGS 100,A01,083619,Allen; Michael Gordon,17,0,70,53
1657712209780,COGS 101A,A01,083621,Davis; Joshua Daniel,9,0,68,59
1657712215813,COGS 101B,A01,091572,Allen; Michael Gordon,12,0,65,53
1657712221840,COGS 101C,A01,083625,Delgado; Tania,17,0,35,18
1657712227864,COGS 107A,A01,083627,Boyle; Mary E. T.,13,0,60,47
1657712233890,COGS 118A,A01,083075,Gupta; Anjum,21,0,76,55
1657712239928,CSE 3,A50,083646,Miranda; Gregory Joseph,24,0,50,26
1657712245953,CSE 8A,A50,083650,Miranda; Gregory Joseph,17,1,56,39
1657712251983,CSE 11,A01,083080,Cao; Yingjun,6,15,40,34
1657712258012,CSE 12,A01,083652,Krause-Levy; Sophia Louisa,28,1,120,92
1657712264041,CSE 15L,A01,083654,Morris; Justin Loren,9,0,50,41
1657712264041,CSE 15L,A02,083655,Morris; Justin Loren,9,0,50,41
1657712270069,CSE 20,A01,083657,Tran; Khoa Dang,39,0,80,41
1657712276095,CSE 21,A01,095574,Bach; Quang Tran,22,0,48,26
1657712282123,CSE 30,A01,083084,Eldon; John,6,0,80,74
1657712282123,CSE 30,B01,095061,Bhaskar; Nishant,9,0,50,41
1657712288156,CSE 100,A01,083659,Cao; Yingjun,5,4,70,65
1657712294182,CSE 134B,A01,083661,Powell; Thomas Allan,23,0,100,77
1657712300207,CSE 140,A01,083663,Gungor; Onat,15,0,85,70
1657712306241,CSE 140L,A01,083088,Eldon; John,23,0,100,77
1657712312268,CSE 175,A01,083665,Kumar; Rakesh,3,0,25,22
1657712318293,CSE 190,A00,092507,Dubnov; Shlomo,8,0,20,12
1657712324327,ECE 45,A01,083139,Congero; Spencer William,6,0,75,69
1657712330361,ECE 65,A50,083695,Saad; Andrew S,12,0,30,18
1657712330361,ECE 65,A51,095125,Saad; Andrew S,24,0,26,2
1657712336394,ECE 109,A01,091882,Touri; Behrouz,20,0,70,50
1657712342427,ECE 180,A00,083140,Abi Samra; Nicholas Camill,1,0,30,29
1657712342427,ECE 180,B00,083141,Abi Samra; Nicholas Camill,0,0,30,30
1657712348456,MATH 10A,A01,083735,Patchell; Gregory David,2,0,30,28
1657712348456,MATH 10A,A02,083736,Patchell; Gregory David,20,0,30,10
1657712348456,MATH 10A,A03,083737,Patchell; Gregory David,16,0,30,14
1657712354486,MATH 10B,A01,083207,Lim; Seonhee,8,0,34,26
1657712354486,MATH 10B,A02,083208,Lim; Seonhee,9,0,35,26
1657712354486,MATH 10B,A03,093472,Lim; Seonhee,7,0,34,27
1657712354486,MATH 10B,B01,083739,Sinha; Shubham,13,0,30,17
1657712360519,MATH 18,A01,083743,Cinel; Cameron Alexander,8,0,30,22
1657712360519,MATH 18,A02,083744,Cinel; Cameron Alexander,17,0,30,13
1657712360519,MATH 18,A03,083745,Cinel; Cameron Alexander,10,0,30,20
1657712360519,MATH 18,B01,083748,Rideout; David Porter,5,0,37,32
1657712360519,MATH 18,B02,083749,Rideout; David Porter,5,0,36,31
1657712360519,MATH 18,B03,083750,Rideout; David Porter,3,0,37,34
1657712360519,MATH 18,B04,083751,Rideout; David Porter,6,0,36,30
1657712360519,MATH 18,B05,093473,Rideout; David Porter,6,0,36,30
1657712360519,MATH 18,B06,093474,Rideout; David Porter,6,0,36,30
1657712366545,MATH 20A,A01,083754,Zheng; Zequn,14,0,40,26
1657712372579,MATH 20B,A01,083756,Briones; Jor-el Thomas Caparas,4,0,36,32
1657712372579,MATH 20B,A02,083757,Briones; Jor-el Thomas Caparas,1,0,36,35
1657712372579,MATH 20B,A03,093475,Briones; Jor-el Thomas Caparas,2,0,36,34
1657712378611,MATH 20C,A01,083760,Briones; Jor-el Thomas Caparas,1,0,35,34
1657712378611,MATH 20C,A02,083761,Briones; Jor-el Thomas Caparas,8,0,35,27
1657712378611,MATH 20C,A03,093476,Briones; Jor-el Thomas Caparas,0,1,36,36
1657712378611,MATH 20C,B01,083762,Bach; Quang Tran,1,0,30,29
1657712384640,MATH 20D,A01,083765,Tran; Brian Kha,5,0,30,25
1657712384640,MATH 20D,A02,083766,Tran; Brian Kha,5,0,30,25
1657712384640,MATH 20D,A03,083767,Tran; Brian Kha,5,0,30,25
1657712390675,MATH 20E,A01,083771,Ganguly; Soumya,9,0,32,23
1657712390675,MATH 20E,A02,083772,Ganguly; Soumya,6,0,32,26
1657712390675,MATH 20E,B01,083773,Ciotti; Benjamin,20,0,35,15
1657712390675,MATH 20E,B02,083774,Ciotti; Benjamin,18,0,35,17
1657712396714,MATH 103A,A01,083777,Greenfeld; Be'Eri,3,0,36,33
1657712396714,MATH 103A,A02,083778,Greenfeld; Be'Eri,5,0,36,31
1657712396714,MATH 103A,A03,093561,Greenfeld; Be'Eri,6,0,36,30
1657712396714,MATH 103A,B01,083779,Greenfeld; Be'Eri,7,0,36,29
1657712396714,MATH 103A,B02,083780,Greenfeld; Be'Eri,4,0,36,32
1657712396714,MATH 103A,B03,093562,Greenfeld; Be'Eri,3,0,36,33
1657712402748,MATH 105,A01,085443,Carter; Anne Toulson,15,0,35,20
1657712402748,MATH 105,A02,093477,Carter; Anne Toulson,20,0,35,15
1657712408779,MATH 109,A01,083213,Ganzberger; Geoffrey Michael,2,0,34,32
1657712408779,MATH 109,A02,083214,Ganzberger; Geoffrey Michael,4,0,34,30
1657712408779,MATH 109,A03,093478,Ganzberger; Geoffrey Michael,2,0,34,32
1657712408779,MATH 109,B01,083215,Ganzberger; Geoffrey Michael,1,0,32,31
1657712408779,MATH 109,B02,083216,Ganzberger; Geoffrey Michael,2,0,32,30
1657712408779,MATH 109,B03,093479,Ganzberger; Geoffrey Michael,8,0,32,24
1657712414809,MATH 142A,A01,083219,Chow; Bennett,7,0,32,25
1657712414809,MATH 142A,A02,083220,Chow; Bennett,10,0,32,22
1657712414809,MATH 142A,A03,093480,Chow; Bennett,9,0,32,23
1657712414809,MATH 142A,B03,093481,Chow; Bennett,8,0,32,24
1657712414809,MATH 142A,B04,093558,Chow; Bennett,13,0,32,19
1657712414809,MATH 142A,B05,093559,Chow; Bennett,6,0,32,26
1657712420839,MATH 193A,A01,083224,Rotar; Vladimir,8,0,34,26
1657712420839,MATH 193A,A02,083225,Rotar; Vladimir,9,0,34,25
1657712420839,MATH 193A,A03,083781,Rotar; Vladimir,5,0,34,29
1657712420839,MATH 193A,A04,083782,Rotar; Vladimir,10,0,34,24
1657712420839,MATH 193A,A05,093482,Rotar; Vladimir,10,0,34,24
1657712426867,MATH 197,001,091859,McAuley; Julian John,9999,0,9999,0
1657712426867,MATH 197,002,095566,Kedlaya; Kiran S.,9997,0,9999,2
1657712426867,MATH 197,003,095567,Xiao; Ming,9999,0,9999,0
1657712426867,MATH 197,004,095571,Perols; Johan Lars,9998,0,9999,1
1657712433934,COGS 9,A01,083615,Shannon; Kyle Michael,9,0,75,66
1657712439959,COGS 11,A01,083617,Boyle; Mary E. T.,23,0,48,25
1657712445983,COGS 13,A01,083071,Bastos; Amalia Pinkusfeld,11,0,71,60
1657712452016,COGS 14A,A01,092681,Semenuks; Arturs,5,1,100,95
1657712458044,COGS 14B,A01,083073,Cheng; Tzu-Han,6,0,63,57
1657712464069,COGS 17,A01,092677,Semenuks; Arturs,6,0,81,75
1657712470097,COGS 100,A01,083619,Allen; Michael Gordon,17,0,70,53
1657712476130,COGS 101A,A01,083621,Davis; Joshua Daniel,9,0,68,59
1657712482156,COGS 101B,A01,091572,Allen; Michael Gordon,12,0,65,53
1657712488186,COGS 101C,A01,083625,Delgado; Tania,17,0,35,18
1657712494212,COGS 107A,A01,083627,Boyle; Mary E. T.,13,0,60,47
1657712500243,COGS 118A,A01,083075,Gupta; Anjum,21,0,76,55
1657712506269,CSE 3,A50,083646,Miranda; Gregory Joseph,24,0,50,26
1657712512300,CSE 8A,A50,083650,Miranda; Gregory Joseph,17,1,56,39
1657712518326,CSE 11,A01,083080,Cao; Yingjun,6,15,40,34
1657712524357,CSE 12,A01,083652,Krause-Levy; Sophia Louisa,28,1,120,92
1657712530386,CSE 15L,A01,083654,Morris; Justin Loren,9,0,50,41
1657712530386,CSE 15L,A02,083655,Morris; Justin Loren,9,0,50,41
1657712536417,CSE 20,A01,083657,Tran; Khoa Dang,39,0,80,41
1657712542444,CSE 21,A01,095574,Bach; Quang Tran,22,0,48,26
1657712548472,CSE 30,A01,083084,Eldon; John,6,0,80,74
1657712548472,CSE 30,B01,095061,Bhaskar; Nishant,9,0,50,41
1657712554504,CSE 100,A01,083659,Cao; Yingjun,5,4,70,65
1657712560531,CSE 134B,A01,083661,Powell; Thomas Allan,23,0,100,77
1657712566558,CSE 140,A01,083663,Gungor; Onat,15,0,85,70
1657712572592,CSE 140L,A01,083088,Eldon; John,23,0,100,77
1657712578617,CSE 175,A01,083665,Kumar; Rakesh,3,0,25,22
1657712584645,CSE 190,A00,092507,Dubnov; Shlomo,8,0,20,12
1657712590676,ECE 45,A01,083139,Congero; Spencer William,6,0,75,69
1657712596704,ECE 65,A50,083695,Saad; Andrew S,12,0,30,18
1657712596704,ECE 65,A51,095125,Saad; Andrew S,24,0,26,2
1657712602731,ECE 109,A01,091882,Touri; Behrouz,20,0,70,50
1657712608851,ECE 180,A00,083140,Abi Samra; Nicholas Camill,1,0,30,29
1657712608851,ECE 180,B00,083141,Abi Samra; Nicholas Camill,0,0,30,30
1657712614881,MATH 10A,A01,083735,Patchell; Gregory David,2,0,30,28
1657712614881,MATH 10A,A02,083736,Patchell; Gregory David,20,0,30,10
1657712614881,MATH 10A,A03,083737,Patchell; Gregory David,16,0,30,14
1657712620911,MATH 10B,A01,083207,Lim; Seonhee,8,0,34,26
1657712620911,MATH 10B,A02,083208,Lim; Seonhee,9,0,35,26
1657712620911,MATH 10B,A03,093472,Lim; Seonhee,7,0,34,27
1657712620911,MATH 10B,B01,083739,Sinha; Shubham,13,0,30,17
1657712626942,MATH 18,A01,083743,Cinel; Cameron Alexander,8,0,30,22
1657712626942,MATH 18,A02,083744,Cinel; Cameron Alexander,17,0,30,13
1657712626942,MATH 18,A03,083745,Cinel; Cameron Alexander,10,0,30,20
1657712626942,MATH 18,B01,083748,Rideout; David Porter,5,0,37,32
1657712626942,MATH 18,B02,083749,Rideout; David Porter,5,0,36,31
1657712626942,MATH 18,B03,083750,Rideout; David Porter,3,0,37,34
1657712626942,MATH 18,B04,083751,Rideout; David Porter,6,0,36,30
1657712626942,MATH 18,B05,093473,Rideout; David Porter,6,0,36,30
1657712626942,MATH 18,B06,093474,Rideout; David Porter,6,0,36,30
1657712632968,MATH 20A,A01,083754,Zheng; Zequn,14,0,40,26
1657712639002,MATH 20B,A01,083756,Briones; Jor-el Thomas Caparas,4,0,36,32
1657712639002,MATH 20B,A02,083757,Briones; Jor-el Thomas Caparas,1,0,36,35
1657712639002,MATH 20B,A03,093475,Briones; Jor-el Thomas Caparas,2,0,36,34
1657712645028,MATH 20C,A01,083760,Briones; Jor-el Thomas Caparas,1,0,35,34
1657712645028,MATH 20C,A02,083761,Briones; Jor-el Thomas Caparas,8,0,35,27
1657712645028,MATH 20C,A03,093476,Briones; Jor-el Thomas Caparas,0,1,36,36
1657712645028,MATH 20C,B01,083762,Bach; Quang Tran,1,0,30,29
1657712651063,MATH 20D,A01,083765,Tran; Brian Kha,5,0,30,25
1657712651063,MATH 20D,A02,083766,Tran; Brian Kha,5,0,30,25
1657712651063,MATH 20D,A03,083767,Tran; Brian Kha,5,0,30,25
1657712657098,MATH 20E,A01,083771,Ganguly; Soumya,9,0,32,23
1657712657098,MATH 20E,A02,083772,Ganguly; Soumya,6,0,32,26
1657712657098,MATH 20E,B01,083773,Ciotti; Benjamin,20,0,35,15
1657712657098,MATH 20E,B02,083774,Ciotti; Benjamin,18,0,35,17
1657712663138,MATH 103A,A01,083777,Greenfeld; Be'Eri,3,0,36,33
1657712663138,MATH 103A,A02,083778,Greenfeld; Be'Eri,5,0,36,31
1657712663138,MATH 103A,A03,093561,Greenfeld; Be'Eri,6,0,36,30
1657712663138,MATH 103A,B01,083779,Greenfeld; Be'Eri,7,0,36,29
1657712663138,MATH 103A,B02,083780,Greenfeld; Be'Eri,4,0,36,32
1657712663138,MATH 103A,B03,093562,Greenfeld; Be'Eri,3,0,36,33
1657712669168,MATH 105,A01,085443,Carter; Anne Toulson,15,0,35,20
1657712669168,MATH 105,A02,093477,Carter; Anne Toulson,20,0,35,15
1657712675200,MATH 109,A01,083213,Ganzberger; Geoffrey Michael,2,0,34,32
1657712675200,MATH 109,A02,083214,Ganzberger; Geoffrey Michael,4,0,34,30
1657712675200,MATH 109,A03,093478,Ganzberger; Geoffrey Michael,2,0,34,32
1657712675200,MATH 109,B01,083215,Ganzberger; Geoffrey Michael,1,0,32,31
1657712675200,MATH 109,B02,083216,Ganzberger; Geoffrey Michael,2,0,32,30
1657712675200,MATH 109,B03,093479,Ganzberger; Geoffrey Michael,8,0,32,24
1657712681229,MATH 142A,A01,083219,Chow; Bennett,7,0,32,25
1657712681229,MATH 142A,A02,083220,Chow; Bennett,10,0,32,22
1657712681229,MATH 142A,A03,093480,Chow; Bennett,9,0,32,23
1657712681229,MATH 142A,B03,093481,Chow; Bennett,8,0,32,24
1657712681229,MATH 142A,B04,093558,Chow; Bennett,13,0,32,19
1657712681229,MATH 142A,B05,093559,Chow; Bennett,6,0,32,26
1657712687257,MATH 193A,A01,083224,Rotar; Vladimir,8,0,34,26
1657712687257,MATH 193A,A02,083225,Rotar; Vladimir,9,0,34,25
1657712687257,MATH 193A,A03,083781,Rotar; Vladimir,5,0,34,29
1657712687257,MATH 193A,A04,083782,Rotar; Vladimir,10,0,34,24
1657712687257,MATH 193A,A05,093482,Rotar; Vladimir,10,0,34,24
1657712693284,MATH 197,001,091859,McAuley; Julian John,9999,0,9999,0
1657712693284,MATH 197,002,095566,Kedlaya; Kiran S.,9997,0,9999,2
1657712693284,MATH 197,003,095567,Xiao; Ming,9999,0,9999,0
1657712693284,MATH 197,004,095571,Perols; Johan Lars,9998,0,9999,1
1657712700362,COGS 9,A01,083615,Shannon; Kyle Michael,9,0,75,66
1657712706392,COGS 11,A01,083617,Boyle; Mary E. T.,23,0,48,25
1657712712419,COGS 13,A01,083071,Bastos; Amalia Pinkusfeld,11,0,71,60
1657712718447,COGS 14A,A01,092681,Semenuks; Arturs,5,1,100,95
1657712724475,COGS 14B,A01,083073,Cheng; Tzu-Han,6,0,63,57
1657712730502,COGS 17,A01,092677,Semenuks; Arturs,6,0,81,75
1657712736530,COGS 100,A01,083619,Allen; Michael Gordon,17,0,70,53
1657712742563,COGS 101A,A01,083621,Davis; Joshua Daniel,9,0,68,59
1657712748589,COGS 101B,A01,091572,Allen; Michael Gordon,12,0,65,53
1657712754617,COGS 101C,A01,083625,Delgado; Tania,17,0,35,18
1657712760642,COGS 107A,A01,083627,Boyle; Mary E. T.,13,0,60,47
1657712766669,COGS 118A,A01,083075,Gupta; Anjum,21,0,76,55
1657712772696,CSE 3,A50,083646,Miranda; Gregory Joseph,24,0,50,26
1657712778722,CSE 8A,A50,083650,Miranda; Gregory Joseph,17,1,56,39
1657712784752,CSE 11,A01,083080,Cao; Yingjun,6,15,40,34
1657712790786,CSE 12,A01,083652,Krause-Levy; Sophia Louisa,28,1,120,92
1657712796817,CSE 15L,A01,083654,Morris; Justin Loren,9,0,50,41
1657712796817,CSE 15L,A02,083655,Morris; Justin Loren,9,0,50,41
1657712802851,CSE 20,A01,083657,Tran; Khoa Dang,39,0,80,41
1657712808875,CSE 21,A01,095574,Bach; Quang Tran,22,0,48,26
1657712814902,CSE 30,A01,083084,Eldon; John,6,0,80,74
1657712814902,CSE 30,B01,095061,Bhaskar; Nishant,9,0,50,41
1657712820932,CSE 100,A01,083659,Cao; Yingjun,5,4,70,65
1657712826961,CSE 134B,A01,083661,Powell; Thomas Allan,23,0,100,77
1657712832987,CSE 140,A01,083663,Gungor; Onat,15,0,85,70
1657712839019,CSE 140L,A01,083088,Eldon; John,23,0,100,77
1657712845047,CSE 175,A01,083665,Kumar; Rakesh,3,0,25,22
1657712851075,CSE 190,A00,092507,Dubnov; Shlomo,8,0,20,12
1657712857111,ECE 45,A01,083139,Congero; Spencer William,6,0,75,69
1657712863139,ECE 65,A50,083695,Saad; Andrew S,12,0,30,18
1657712863139,ECE 65,A51,095125,Saad; Andrew S,24,0,26,2
1657712869166,ECE 109,A01,091882,Touri; Behrouz,20,0,70,50
1657712875197,ECE 180,A00,083140,Abi Samra; Nicholas Camill,1,0,30,29
1657712875197,ECE 180,B00,083141,Abi Samra; Nicholas Camill,0,0,30,30
1657712881231,MATH 10A,A01,083735,Patchell; Gregory David,2,0,30,28
1657712881231,MATH 10A,A02,083736,Patchell; Gregory David,20,0,30,10
1657712881231,MATH 10A,A03,083737,Patchell; Gregory David,16,0,30,14
1657712887260,MATH 10B,A01,083207,Lim; Seonhee,8,0,34,26
1657712887260,MATH 10B,A02,083208,Lim; Seonhee,9,0,35,26
1657712887260,MATH 10B,A03,093472,Lim; Seonhee,7,0,34,27
1657712887260,MATH 10B,B01,083739,Sinha; Shubham,13,0,30,17
1657712893302,MATH 18,A01,083743,Cinel; Cameron Alexander,8,0,30,22
1657712893302,MATH 18,A02,083744,Cinel; Cameron Alexander,17,0,30,13
1657712893302,MATH 18,A03,083745,Cinel; Cameron Alexander,10,0,30,20
1657712893302,MATH 18,B01,083748,Rideout; David Porter,5,0,37,32
1657712893302,MATH 18,B02,083749,Rideout; David Porter,5,0,36,31
1657712893302,MATH 18,B03,083750,Rideout; David Porter,3,0,37,34
1657712893302,MATH 18,B04,083751,Rideout; David Porter,6,0,36,30
1657712893302,MATH 18,B05,093473,Rideout; David Porter,6,0,36,30
1657712893302,MATH 18,B06,093474,Rideout; David Porter,6,0,36,30
1657712899327,MATH 20A,A01,083754,Zheng; Zequn,14,0,40,26
1657712905364,MATH 20B,A01,083756,Briones; Jor-el Thomas Caparas,4,0,36,32
1657712905364,MATH 20B,A02,083757,Briones; Jor-el Thomas Caparas,1,0,36,35
1657712905364,MATH 20B,A03,093475,Briones; Jor-el Thomas Caparas,2,0,36,34
1657712911391,MATH 20C,A01,083760,Briones; Jor-el Thomas Caparas,1,0,35,34
1657712911391,MATH 20C,A02,083761,Briones; Jor-el Thomas Caparas,8,0,35,27
1657712911391,MATH 20C,A03,093476,Briones; Jor-el Thomas Caparas,0,1,36,36
1657712911391,MATH 20C,B01,083762,Bach; Quang Tran,1,0,30,29
1657712917415,MATH 20D,A01,083765,Tran; Brian Kha,5,0,30,25
1657712917415,MATH 20D,A02,083766,Tran; Brian Kha,5,0,30,25
1657712917415,MATH 20D,A03,083767,Tran; Brian Kha,5,0,30,25
1657712923450,MATH 20E,A01,083771,Ganguly; Soumya,9,0,32,23
1657712923450,MATH 20E,A02,083772,Ganguly; Soumya,6,0,32,26
1657712923450,MATH 20E,B01,083773,Ciotti; Benjamin,20,0,35,15
1657712923450,MATH 20E,B02,083774,Ciotti; Benjamin,18,0,35,17
1657712929480,MATH 103A,A01,083777,Greenfeld; Be'Eri,3,0,36,33
1657712929480,MATH 103A,A02,083778,Greenfeld; Be'Eri,5,0,36,31
1657712929480,MATH 103A,A03,093561,Greenfeld; Be'Eri,6,0,36,30
1657712929480,MATH 103A,B01,083779,Greenfeld; Be'Eri,7,0,36,29
1657712929480,MATH 103A,B02,083780,Greenfeld; Be'Eri,4,0,36,32
1657712929480,MATH 103A,B03,093562,Greenfeld; Be'Eri,3,0,36,33
1657712935506,MATH 105,A01,085443,Carter; Anne Toulson,15,0,35,20
1657712935506,MATH 105,A02,093477,Carter; Anne Toulson,20,0,35,15
1657712941540,MATH 109,A01,083213,Ganzberger; Geoffrey Michael,2,0,34,32
1657712941540,MATH 109,A02,083214,Ganzberger; Geoffrey Michael,4,0,34,30
1657712941540,MATH 109,A03,093478,Ganzberger; Geoffrey Michael,2,0,34,32
1657712941540,MATH 109,B01,083215,Ganzberger; Geoffrey Michael,1,0,32,31
1657712941540,MATH 109,B02,083216,Ganzberger; Geoffrey Michael,2,0,32,30
1657712941540,MATH 109,B03,093479,Ganzberger; Geoffrey Michael,8,0,32,24
1657712947569,MATH 142A,A01,083219,Chow; Bennett,7,0,32,25
1657712947569,MATH 142A,A02,083220,Chow; Bennett,10,0,32,22
1657712947569,MATH 142A,A03,093480,Chow; Bennett,9,0,32,23
1657712947569,MATH 142A,B03,093481,Chow; Bennett,8,0,32,24
1657712947569,MATH 142A,B04,093558,Chow; Bennett,13,0,32,19
1657712947569,MATH 142A,B05,093559,Chow; Bennett,6,0,32,26
1657712953605,MATH 193A,A01,083224,Rotar; Vladimir,8,0,34,26
1657712953605,MATH 193A,A02,083225,Rotar; Vladimir,9,0,34,25
1657712953605,MATH 193A,A03,083781,Rotar; Vladimir,5,0,34,29
1657712953605,MATH 193A,A04,083782,Rotar; Vladimir,10,0,34,24
1657712953605,MATH 193A,A05,093482,Rotar; Vladimir,10,0,34,24
1657712959632,MATH 197,001,091859,McAuley; Julian John,9999,0,9999,0
1657712959632,MATH 197,002,095566,Kedlaya; Kiran S.,9997,0,9999,2
1657712959632,MATH 197,003,095567,Xiao; Ming,9999,0,9999,0
1657712959632,MATH 197,004,095571,Perols; Johan Lars,9998,0,9999,1
1657712966712,COGS 9,A01,083615,Shannon; Kyle Michael,9,0,75,66
1657712972755,COGS 11,A01,083617,Boyle; Mary E. T.,23,0,48,25
1657712978786,COGS 13,A01,083071,Bastos; Amalia Pinkusfeld,11,0,71,60
1657712984812,COGS 14A,A01,092681,Semenuks; Arturs,5,1,100,95
1657712990842,COGS 14B,A01,083073,Cheng; Tzu-Han,6,0,63,57
1657712996872,COGS 17,A01,092677,Semenuks; Arturs,6,0,81,75
1657713002902,COGS 100,A01,083619,Allen; Michael Gordon,17,0,70,53
1657713008932,COGS 101A,A01,083621,Davis; Joshua Daniel,9,0,68,59
1657713014956,COGS 101B,A01,091572,Allen; Michael Gordon,12,0,65,53
1657713020984,COGS 101C,A01,083625,Delgado; Tania,17,0,35,18
1657713027020,COGS 107A,A01,083627,Boyle; Mary E. T.,13,0,60,47
1657713033045,COGS 118A,A01,083075,Gupta; Anjum,21,0,76,55
1657713039072,CSE 3,A50,083646,Miranda; Gregory Joseph,24,0,50,26
1657713045099,CSE 8A,A50,083650,Miranda; Gregory Joseph,17,1,56,39
1657713051124,CSE 11,A01,083080,Cao; Yingjun,6,15,40,34
1657713057155,CSE 12,A01,083652,Krause-Levy; Sophia Louisa,28,1,120,92
1657713063179,CSE 15L,A01,083654,Morris; Justin Loren,9,0,50,41
1657713063179,CSE 15L,A02,083655,Morris; Justin Loren,9,0,50,41
1657713069209,CSE 20,A01,083657,Tran; Khoa Dang,39,0,80,41
1657713075235,CSE 21,A01,095574,Bach; Quang Tran,22,0,48,26
1657713081262,CSE 30,A01,083084,Eldon; John,6,0,80,74
1657713081262,CSE 30,B01,095061,Bhaskar; Nishant,9,0,50,41
1657713087294,CSE 100,A01,083659,Cao; Yingjun,5,4,70,65
1657713093321,CSE 134B,A01,083661,Powell; Thomas Allan,23,0,100,77
1657713099347,CSE 140,A01,083663,Gungor; Onat,15,0,85,70
1657713105377,CSE 140L,A01,083088,Eldon; John,23,0,100,77
1657713111405,CSE 175,A01,083665,Kumar; Rakesh,3,0,25,22
1657713117432,CSE 190,A00,092507,Dubnov; Shlomo,8,0,20,12
1657713123459,ECE 45,A01,083139,Congero; Spencer William,6,0,75,69
1657713129494,ECE 65,A50,083695,Saad; Andrew S,12,0,30,18
1657713129494,ECE 65,A51,095125,Saad; Andrew S,24,0,26,2
1657713135521,ECE 109,A01,091882,Touri; Behrouz,20,0,70,50
1657713141552,ECE 180,A00,083140,Abi Samra; Nicholas Camill,1,0,30,29
1657713141552,ECE 180,B00,083141,Abi Samra; Nicholas Camill,0,0,30,30
1657713147580,MATH 10A,A01,083735,Patchell; Gregory David,2,0,30,28
1657713147580,MATH 10A,A02,083736,Patchell; Gregory David,20,0,30,10
1657713147580,MATH 10A,A03,083737,Patchell; Gregory David,16,0,30,14
1657713153610,MATH 10B,A01,083207,Lim; Seonhee,8,0,34,26
1657713153610,MATH 10B,A02,083208,Lim; Seonhee,9,0,35,26
1657713153610,MATH 10B,A03,093472,Lim; Seonhee,7,0,34,27
1657713153610,MATH 10B,B01,083739,Sinha; Shubham,13,0,30,17
1657713159649,MATH 18,A01,083743,Cinel; Cameron Alexander,8,0,30,22
1657713159649,MATH 18,A02,083744,Cinel; Cameron Alexander,17,0,30,13
1657713159649,MATH 18,A03,083745,Cinel; Cameron Alexander,10,0,30,20
1657713159649,MATH 18,B01,083748,Rideout; David Porter,5,0,37,32
1657713159649,MATH 18,B02,083749,Rideout; David Porter,5,0,36,31
1657713159649,MATH 18,B03,083750,Rideout; David Porter,3,0,37,34
1657713159649,MATH 18,B04,083751,Rideout; David Porter,6,0,36,30
1657713159649,MATH 18,B05,093473,Rideout; David Porter,6,0,36,30
1657713159649,MATH 18,B06,093474,Rideout; David Porter,6,0,36,30
1657713165675,MATH 20A,A01,083754,Zheng; Zequn,14,0,40,26
1657713171705,MATH 20B,A01,083756,Briones; Jor-el Thomas Caparas,4,0,36,32
1657713171705,MATH 20B,A02,083757,Briones; Jor-el Thomas Caparas,1,0,36,35
1657713171705,MATH 20B,A03,093475,Briones; Jor-el Thomas Caparas,2,0,36,34
1657713177732,MATH 20C,A01,083760,Briones; Jor-el Thomas Caparas,1,0,35,34
1657713177732,MATH 20C,A02,083761,Briones; Jor-el Thomas Caparas,8,0,35,27
1657713177732,MATH 20C,A03,093476,Briones; Jor-el Thomas Caparas,0,1,36,36
1657713177732,MATH 20C,B01,083762,Bach; Quang Tran,1,0,30,29
1657713183765,MATH 20D,A01,083765,Tran; Brian Kha,5,0,30,25
1657713183765,MATH 20D,A02,083766,Tran; Brian Kha,5,0,30,25
1657713183765,MATH 20D,A03,083767,Tran; Brian Kha,5,0,30,25
1657713189799,MATH 20E,A01,083771,Ganguly; Soumya,9,0,32,23
1657713189799,MATH 20E,A02,083772,Ganguly; Soumya,6,0,32,26
1657713189799,MATH 20E,B01,083773,Ciotti; Benjamin,20,0,35,15
1657713189799,MATH 20E,B02,083774,Ciotti; Benjamin,18,0,35,17
1657713195833,MATH 103A,A01,083777,Greenfeld; Be'Eri,3,0,36,33
1657713195833,MATH 103A,A02,083778,Greenfeld; Be'Eri,5,0,36,31
1657713195833,MATH 103A,A03,093561,Greenfeld; Be'Eri,6,0,36,30
1657713195833,MATH 103A,B01,083779,Greenfeld; Be'Eri,7,0,36,29
1657713195833,MATH 103A,B02,083780,Greenfeld; Be'Eri,4,0,36,32
1657713195833,MATH 103A,B03,093562,Greenfeld; Be'Eri,3,0,36,33
1657713201860,MATH 105,A01,085443,Carter; Anne Toulson,15,0,35,20
1657713201860,MATH 105,A02,093477,Carter; Anne Toulson,20,0,35,15
1657713207974,MATH 109,A01,083213,Ganzberger; Geoffrey Michael,2,0,34,32
1657713207974,MATH 109,A02,083214,Ganzberger; Geoffrey Michael,4,0,34,30
1657713207974,MATH 109,A03,093478,Ganzberger; Geoffrey Michael,2,0,34,32
1657713207974,MATH 109,B01,083215,Ganzberger; Geoffrey Michael,1,0,32,31
1657713207974,MATH 109,B02,083216,Ganzberger; Geoffrey Michael,2,0,32,30
1657713207974,MATH 109,B03,093479,Ganzberger; Geoffrey Michael,8,0,32,24
1657713214002,MATH 142A,A01,083219,Chow; Bennett,7,0,32,25
1657713214002,MATH 142A,A02,083220,Chow; Bennett,10,0,32,22
1657713214002,MATH 142A,A03,093480,Chow; Bennett,9,0,32,23
1657713214002,MATH 142A,B03,093481,Chow; Bennett,8,0,32,24
1657713214002,MATH 142A,B04,093558,Chow; Bennett,13,0,32,19
1657713214002,MATH 142A,B05,093559,Chow; Bennett,6,0,32,26
1657713220040,MATH 193A,A01,083224,Rotar; Vladimir,8,0,34,26
1657713220040,MATH 193A,A02,083225,Rotar; Vladimir,9,0,34,25
1657713220040,MATH 193A,A03,083781,Rotar; Vladimir,5,0,34,29
1657713220040,MATH 193A,A04,083782,Rotar; Vladimir,10,0,34,24
1657713220040,MATH 193A,A05,093482,Rotar; Vladimir,10,0,34,24
1657713226071,MATH 197,001,091859,McAuley; Julian John,9999,0,9999,0
1657713226071,MATH 197,002,095566,Kedlaya; Kiran S.,9997,0,9999,2
1657713226071,MATH 197,003,095567,Xiao; Ming,9999,0,9999,0
1657713226071,MATH 197,004,095571,Perols; Johan Lars,9998,0,9999,1
1657713233184,COGS 9,A01,083615,Shannon; Kyle Michael,9,0,75,66
1657713239218,COGS 11,A01,083617,Boyle; Mary E. T.,23,0,48,25
1657713245253,COGS 13,A01,083071,Bastos; Amalia Pinkusfeld,11,0,71,60
1657713251277,COGS 14A,A01,092681,Semenuks; Arturs,5,1,100,95
1657713257307,COGS 14B,A01,083073,Cheng; Tzu-Han,6,0,63,57
1657713263332,COGS 17,A01,092677,Semenuks; Arturs,6,0,81,75
1657713269358,COGS 100,A01,083619,Allen; Michael Gordon,17,0,70,53
1657713275391,COGS 101A,A01,083621,Davis; Joshua Daniel,9,0,68,59
1657713281417,COGS 101B,A01,091572,Allen; Michael Gordon,12,0,65,53
1657713287446,COGS 101C,A01,083625,Delgado; Tania,17,0,35,18
1657713293471,COGS 107A,A01,083627,Boyle; Mary E. T.,13,0,60,47
1657713299498,COGS 118A,A01,083075,Gupta; Anjum,21,0,76,55
1657713305530,CSE 3,A50,083646,Miranda; Gregory Joseph,24,0,50,26
1657713311557,CSE 8A,A50,083650,Miranda; Gregory Joseph,17,1,56,39
1657713317582,CSE 11,A01,083080,Cao; Yingjun,6,15,40,34
1657713323609,CSE 12,A01,083652,Krause-Levy; Sophia Louisa,28,1,120,92
1657713329635,CSE 15L,A01,083654,Morris; Justin Loren,9,0,50,41
1657713329635,CSE 15L,A02,083655,Morris; Justin Loren,9,0,50,41
1657713335668,CSE 20,A01,083657,Tran; Khoa Dang,39,0,80,41
1657713341699,CSE 21,A01,095574,Bach; Quang Tran,22,0,48,26
1657713347728,CSE 30,A01,083084,Eldon; John,6,0,80,74
1657713347728,CSE 30,B01,095061,Bhaskar; Nishant,9,0,50,41
1657713353752,CSE 100,A01,083659,Cao; Yingjun,5,4,70,65
1657713359778,CSE 134B,A01,083661,Powell; Thomas Allan,23,0,100,77
1657713365803,CSE 140,A01,083663,Gungor; Onat,15,0,85,70
1657713371828,CSE 140L,A01,083088,Eldon; John,23,0,100,77
1657713377856,CSE 175,A01,083665,Kumar; Rakesh,3,0,25,22
1657713383886,CSE 190,A00,092507,Dubnov; Shlomo,8,0,20,12
1657713389921,ECE 45,A01,083139,Congero; Spencer William,6,0,75,69
1657713395957,ECE 65,A50,083695,Saad; Andrew S,12,0,30,18
1657713395957,ECE 65,A51,095125,Saad; Andrew S,24,0,26,2
1657713401985,ECE 109,A01,091882,Touri; Behrouz,20,0,70,50
1657713408019,ECE 180,A00,083140,Abi Samra; Nicholas Camill,1,0,30,29
1657713408019,ECE 180,B00,083141,Abi Samra; Nicholas Camill,0,0,30,30
1657713414046,MATH 10A,A01,083735,Patchell; Gregory David,2,0,30,28
1657713414046,MATH 10A,A02,083736,Patchell; Gregory David,20,0,30,10
1657713414046,MATH 10A,A03,083737,Patchell; Gregory David,16,0,30,14
1657713420093,MATH 10B,A01,083207,Lim; Seonhee,8,0,34,26
1657713420093,MATH 10B,A02,083208,Lim; Seonhee,9,0,35,26
1657713420093,MATH 10B,A03,093472,Lim; Seonhee,7,0,34,27
1657713420093,MATH 10B,B01,083739,Sinha; Shubham,13,0,30,17
1657713426125,MATH 18,A01,083743,Cinel; Cameron Alexander,8,0,30,22
1657713426125,MATH 18,A02,083744,Cinel; Cameron Alexander,17,0,30,13
1657713426125,MATH 18,A03,083745,Cinel; Cameron Alexander,10,0,30,20
1657713426125,MATH 18,B01,083748,Rideout; David Porter,5,0,37,32
1657713426125,MATH 18,B02,083749,Rideout; David Porter,5,0,36,31
1657713426125,MATH 18,B03,083750,Rideout; David Porter,3,0,37,34
1657713426125,MATH 18,B04,083751,Rideout; David Porter,6,0,36,30
1657713426125,MATH 18,B05,093473,Rideout; David Porter,6,0,36,30
1657713426125,MATH 18,B06,093474,Rideout; David Porter,6,0,36,30
1657713432152,MATH 20A,A01,083754,Zheng; Zequn,14,0,40,26
1657713438191,MATH 20B,A01,083756,Briones; Jor-el Thomas Caparas,4,0,36,32
1657713438191,MATH 20B,A02,083757,Briones; Jor-el Thomas Caparas,1,0,36,35
1657713438191,MATH 20B,A03,093475,Briones; Jor-el Thomas Caparas,2,0,36,34
1657713444220,MATH 20C,A01,083760,Briones; Jor-el Thomas Caparas,1,0,35,34
1657713444220,MATH 20C,A02,083761,Briones; Jor-el Thomas Caparas,8,0,35,27
1657713444220,MATH 20C,A03,093476,Briones; Jor-el Thomas Caparas,0,1,36,36
1657713444220,MATH 20C,B01,083762,Bach; Quang Tran,1,0,30,29
1657713450256,MATH 20D,A01,083765,Tran; Brian Kha,5,0,30,25
1657713450256,MATH 20D,A02,083766,Tran; Brian Kha,5,0,30,25
1657713450256,MATH 20D,A03,083767,Tran; Brian Kha,5,0,30,25
1657713456293,MATH 20E,A01,083771,Ganguly; Soumya,9,0,32,23
1657713456293,MATH 20E,A02,083772,Ganguly; Soumya,6,0,32,26
1657713456293,MATH 20E,B01,083773,Ciotti; Benjamin,20,0,35,15
1657713456293,MATH 20E,B02,083774,Ciotti; Benjamin,18,0,35,17
1657713462322,MATH 103A,A01,083777,Greenfeld; Be'Eri,3,0,36,33
1657713462322,MATH 103A,A02,083778,Greenfeld; Be'Eri,5,0,36,31
1657713462322,MATH 103A,A03,093561,Greenfeld; Be'Eri,6,0,36,30
1657713462322,MATH 103A,B01,083779,Greenfeld; Be'Eri,7,0,36,29
1657713462322,MATH 103A,B02,083780,Greenfeld; Be'Eri,4,0,36,32
1657713462322,MATH 103A,B03,093562,Greenfeld; Be'Eri,3,0,36,33
1657713468351,MATH 105,A01,085443,Carter; Anne Toulson,15,0,35,20
1657713468351,MATH 105,A02,093477,Carter; Anne Toulson,20,0,35,15
1657713474387,MATH 109,A01,083213,Ganzberger; Geoffrey Michael,2,0,34,32
1657713474387,MATH 109,A02,083214,Ganzberger; Geoffrey Michael,4,0,34,30
1657713474387,MATH 109,A03,093478,Ganzberger; Geoffrey Michael,2,0,34,32
1657713474387,MATH 109,B01,083215,Ganzberger; Geoffrey Michael,1,0,32,31
1657713474387,MATH 109,B02,083216,Ganzberger; Geoffrey Michael,2,0,32,30
1657713474387,MATH 109,B03,093479,Ganzberger; Geoffrey Michael,8,0,32,24
1657713480422,MATH 142A,A01,083219,Chow; Bennett,7,0,32,25
1657713480422,MATH 142A,A02,083220,Chow; Bennett,10,0,32,22
1657713480422,MATH 142A,A03,093480,Chow; Bennett,9,0,32,23
1657713480422,MATH 142A,B03,093481,Chow; Bennett,8,0,32,24
1657713480422,MATH 142A,B04,093558,Chow; Bennett,13,0,32,19
1657713480422,MATH 142A,B05,093559,Chow; Bennett,6,0,32,26
1657713486449,MATH 193A,A01,083224,Rotar; Vladimir,8,0,34,26
1657713486449,MATH 193A,A02,083225,Rotar; Vladimir,9,0,34,25
1657713486449,MATH 193A,A03,083781,Rotar; Vladimir,5,0,34,29
1657713486449,MATH 193A,A04,083782,Rotar; Vladimir,10,0,34,24
1657713486449,MATH 193A,A05,093482,Rotar; Vladimir,10,0,34,24
1657713492487,MATH 197,001,091859,McAuley; Julian John,9999,0,9999,0
1657713492487,MATH 197,002,095566,Kedlaya; Kiran S.,9997,0,9999,2
1657713492487,MATH 197,003,095567,Xiao; Ming,9999,0,9999,0
1657713492487,MATH 197,004,095571,Perols; Johan Lars,9998,0,9999,1
1657713499583,COGS 9,A01,083615,Shannon; Kyle Michael,9,0,75,66
1657713505620,COGS 11,A01,083617,Boyle; Mary E. T.,23,0,48,25
1657713511657,COGS 13,A01,083071,Bastos; Amalia Pinkusfeld,11,0,71,60
1657713517685,COGS 14A,A01,092681,Semenuks; Arturs,5,1,100,95
1657713523718,COGS 14B,A01,083073,Cheng; Tzu-Han,6,0,63,57
1657713529744,COGS 17,A01,092677,Semenuks; Arturs,6,0,81,75
1657713535775,COGS 100,A01,083619,Allen; Michael Gordon,17,0,70,53
1657713541801,COGS 101A,A01,083621,Davis; Joshua Daniel,9,0,68,59
1657713547830,COGS 101B,A01,091572,Allen; Michael Gordon,12,0,65,53
1657713553862,COGS 101C,A01,083625,Delgado; Tania,17,0,35,18
1657713559886,COGS 107A,A01,083627,Boyle; Mary E. T.,13,0,60,47
1657713565916,COGS 118A,A01,083075,Gupta; Anjum,21,0,76,55
1657713571944,CSE 3,A50,083646,Miranda; Gregory Joseph,24,0,50,26
1657713577974,CSE 8A,A50,083650,Miranda; Gregory Joseph,17,1,56,39
1657713584002,CSE 11,A01,083080,Cao; Yingjun,6,15,40,34
1657713590028,CSE 12,A01,083652,Krause-Levy; Sophia Louisa,28,1,120,92
1657713596057,CSE 15L,A01,083654,Morris; Justin Loren,9,0,50,41
1657713596057,CSE 15L,A02,083655,Morris; Justin Loren,9,0,50,41
1657713602094,CSE 20,A01,083657,Tran; Khoa Dang,39,0,80,41
1657713608129,CSE 21,A01,095574,Bach; Quang Tran,22,0,48,26
1657713614154,CSE 30,A01,083084,Eldon; John,6,0,80,74
1657713614154,CSE 30,B01,095061,Bhaskar; Nishant,9,0,50,41
1657713620179,CSE 100,A01,083659,Cao; Yingjun,5,4,70,65
1657713626211,CSE 134B,A01,083661,Powell; Thomas Allan,23,0,100,77
1657713632237,CSE 140,A01,083663,Gungor; Onat,15,0,85,70
1657713638277,CSE 140L,A01,083088,Eldon; John,23,0,100,77
1657713644300,CSE 175,A01,083665,Kumar; Rakesh,3,0,25,22
1657713650325,CSE 190,A00,092507,Dubnov; Shlomo,8,0,20,12
1657713656350,ECE 45,A01,083139,Congero; Spencer William,6,0,75,69
1657713662409,ECE 65,A50,083695,Saad; Andrew S,12,0,30,18
1657713662409,ECE 65,A51,095125,Saad; Andrew S,24,0,26,2
1657713668434,ECE 109,A01,091882,Touri; Behrouz,20,0,70,50
1657713674462,ECE 180,A00,083140,Abi Samra; Nicholas Camill,1,0,30,29
1657713674462,ECE 180,B00,083141,Abi Samra; Nicholas Camill,0,0,30,30
1657713680487,MATH 10A,A01,083735,Patchell; Gregory David,2,0,30,28
1657713680487,MATH 10A,A02,083736,Patchell; Gregory David,20,0,30,10
1657713680487,MATH 10A,A03,083737,Patchell; Gregory David,16,0,30,14
1657713686528,MATH 10B,A01,083207,Lim; Seonhee,8,0,34,26
1657713686528,MATH 10B,A02,083208,Lim; Seonhee,9,0,35,26
1657713686528,MATH 10B,A03,093472,Lim; Seonhee,7,0,34,27
1657713686528,MATH 10B,B01,083739,Sinha; Shubham,13,0,30,17
1657713692571,MATH 18,A01,083743,Cinel; Cameron Alexander,8,0,30,22
1657713692571,MATH 18,A02,083744,Cinel; Cameron Alexander,17,0,30,13
1657713692571,MATH 18,A03,083745,Cinel; Cameron Alexander,10,0,30,20
1657713692571,MATH 18,B01,083748,Rideout; David Porter,5,0,37,32
1657713692571,MATH 18,B02,083749,Rideout; David Porter,5,0,36,31
1657713692571,MATH 18,B03,083750,Rideout; David Porter,3,0,37,34
1657713692571,MATH 18,B04,083751,Rideout; David Porter,6,0,36,30
1657713692571,MATH 18,B05,093473,Rideout; David Porter,6,0,36,30
1657713692571,MATH 18,B06,093474,Rideout; David Porter,6,0,36,30
1657713698601,MATH 20A,A01,083754,Zheng; Zequn,14,0,40,26
1657713704632,MATH 20B,A01,083756,Briones; Jor-el Thomas Caparas,4,0,36,32
1657713704632,MATH 20B,A02,083757,Briones; Jor-el Thomas Caparas,1,0,36,35
1657713704632,MATH 20B,A03,093475,Briones; Jor-el Thomas Caparas,2,0,36,34
1657713710660,MATH 20C,A01,083760,Briones; Jor-el Thomas Caparas,1,0,35,34
1657713710660,MATH 20C,A02,083761,Briones; Jor-el Thomas Caparas,8,0,35,27
1657713710660,MATH 20C,A03,093476,Briones; Jor-el Thomas Caparas,0,1,36,36
1657713710660,MATH 20C,B01,083762,Bach; Quang Tran,1,0,30,29
1657713716687,MATH 20D,A01,083765,Tran; Brian Kha,5,0,30,25
1657713716687,MATH 20D,A02,083766,Tran; Brian Kha,5,0,30,25
1657713716687,MATH 20D,A03,083767,Tran; Brian Kha,5,0,30,25
1657713722716,MATH 20E,A01,083771,Ganguly; Soumya,9,0,32,23
1657713722716,MATH 20E,A02,083772,Ganguly; Soumya,6,0,32,26
1657713722716,MATH 20E,B01,083773,Ciotti; Benjamin,20,0,35,15
1657713722716,MATH 20E,B02,083774,Ciotti; Benjamin,18,0,35,17
1657713728753,MATH 103A,A01,083777,Greenfeld; Be'Eri,3,0,36,33
1657713728753,MATH 103A,A02,083778,Greenfeld; Be'Eri,5,0,36,31
1657713728753,MATH 103A,A03,093561,Greenfeld; Be'Eri,6,0,36,30
1657713728753,MATH 103A,B01,083779,Greenfeld; Be'Eri,7,0,36,29
1657713728753,MATH 103A,B02,083780,Greenfeld; Be'Eri,4,0,36,32
1657713728753,MATH 103A,B03,093562,Greenfeld; Be'Eri,3,0,36,33
1657713734784,MATH 105,A01,085443,Carter; Anne Toulson,15,0,35,20
1657713734784,MATH 105,A02,093477,Carter; Anne Toulson,20,0,35,15
1657713740817,MATH 109,A01,083213,Ganzberger; Geoffrey Michael,2,0,34,32
1657713740817,MATH 109,A02,083214,Ganzberger; Geoffrey Michael,4,0,34,30
1657713740817,MATH 109,A03,093478,Ganzberger; Geoffrey Michael,2,0,34,32
1657713740817,MATH 109,B01,083215,Ganzberger; Geoffrey Michael,1,0,32,31
1657713740817,MATH 109,B02,083216,Ganzberger; Geoffrey Michael,2,0,32,30
1657713740817,MATH 109,B03,093479,Ganzberger; Geoffrey Michael,8,0,32,24
1657713746852,MATH 142A,A01,083219,Chow; Bennett,7,0,32,25
1657713746852,MATH 142A,A02,083220,Chow; Bennett,10,0,32,22
1657713746852,MATH 142A,A03,093480,Chow; Bennett,9,0,32,23
1657713746852,MATH 142A,B03,093481,Chow; Bennett,8,0,32,24
1657713746852,MATH 142A,B04,093558,Chow; Bennett,13,0,32,19
1657713746852,MATH 142A,B05,093559,Chow; Bennett,6,0,32,26
1657713752885,MATH 193A,A01,083224,Rotar; Vladimir,8,0,34,26
1657713752885,MATH 193A,A02,083225,Rotar; Vladimir,9,0,34,25
1657713752885,MATH 193A,A03,083781,Rotar; Vladimir,5,0,34,29
1657713752885,MATH 193A,A04,083782,Rotar; Vladimir,10,0,34,24
1657713752885,MATH 193A,A05,093482,Rotar; Vladimir,10,0,34,24
1657713758921,MATH 197,001,091859,McAuley; Julian John,9999,0,9999,0
1657713758921,MATH 197,002,095566,Kedlaya; Kiran S.,9997,0,9999,2
1657713758921,MATH 197,003,095567,Xiao; Ming,9999,0,9999,0
1657713758921,MATH 197,004,095571,Perols; Johan Lars,9998,0,9999,1
1657713765981,COGS 9,A01,083615,Shannon; Kyle Michael,9,0,75,66
1657713772006,COGS 11,A01,083617,Boyle; Mary E. T.,23,0,48,25
1657713778039,COGS 13,A01,083071,Bastos; Amalia Pinkusfeld,11,0,71,60
1657713784070,COGS 14A,A01,092681,Semenuks; Arturs,5,1,100,95
1657713790098,COGS 14B,A01,083073,Cheng; Tzu-Han,6,0,63,57
1657713796129,COGS 17,A01,092677,Semenuks; Arturs,6,0,81,75
1657713802263,COGS 100,A01,083619,Allen; Michael Gordon,17,0,70,53
1657713808299,COGS 101A,A01,083621,Davis; Joshua Daniel,9,0,68,59
1657713814327,COGS 101B,A01,091572,Allen; Michael Gordon,12,0,65,53
1657713820356,COGS 101C,A01,083625,Delgado; Tania,17,0,35,18
1657713826382,COGS 107A,A01,083627,Boyle; Mary E. T.,13,0,60,47
1657713832413,COGS 118A,A01,083075,Gupta; Anjum,21,0,76,55
1657713838450,CSE 3,A50,083646,Miranda; Gregory Joseph,24,0,50,26
1657713844477,CSE 8A,A50,083650,Miranda; Gregory Joseph,17,1,56,39
1657713850509,CSE 11,A01,083080,Cao; Yingjun,6,15,40,34
1657713856545,CSE 12,A01,083652,Krause-Levy; Sophia Louisa,28,1,120,92
1657713862578,CSE 15L,A01,083654,Morris; Justin Loren,9,0,50,41
1657713862578,CSE 15L,A02,083655,Morris; Justin Loren,9,0,50,41
1657713868603,CSE 20,A01,083657,Tran; Khoa Dang,39,0,80,41
1657713874630,CSE 21,A01,095574,Bach; Quang Tran,22,0,48,26
1657713880670,CSE 30,A01,083084,Eldon; John,6,0,80,74
1657713880670,CSE 30,B01,095061,Bhaskar; Nishant,9,0,50,41
1657713886698,CSE 100,A01,083659,Cao; Yingjun,5,4,70,65
1657713892725,CSE 134B,A01,083661,Powell; Thomas Allan,23,0,100,77
1657713898759,CSE 140,A01,083663,Gungor; Onat,15,0,85,70
1657713904785,CSE 140L,A01,083088,Eldon; John,23,0,100,77
1657713910816,CSE 175,A01,083665,Kumar; Rakesh,3,0,25,22
1657713916845,CSE 190,A00,092507,Dubnov; Shlomo,8,0,20,12
1657713922876,ECE 45,A01,083139,Congero; Spencer William,6,0,75,69
1657713928911,ECE 65,A50,083695,Saad; Andrew S,12,0,30,18
1657713928911,ECE 65,A51,095125,Saad; Andrew S,24,0,26,2
1657713934939,ECE 109,A01,091882,Touri; Behrouz,20,0,70,50
1657713940968,ECE 180,A00,083140,Abi Samra; Nicholas Camill,1,0,30,29
1657713940968,ECE 180,B00,083141,Abi Samra; Nicholas Camill,0,0,30,30
1657713947007,MATH 10A,A01,083735,Patchell; Gregory David,2,0,30,28
1657713947007,MATH 10A,A02,083736,Patchell; Gregory David,20,0,30,10
1657713947007,MATH 10A,A03,083737,Patchell; Gregory David,16,0,30,14
1657713953035,MATH 10B,A01,083207,Lim; Seonhee,8,0,34,26
1657713953035,MATH 10B,A02,083208,Lim; Seonhee,9,0,35,26
1657713953035,MATH 10B,A03,093472,Lim; Seonhee,7,0,34,27
1657713953035,MATH 10B,B01,083739,Sinha; Shubham,13,0,30,17
1657713959073,MATH 18,A01,083743,Cinel; Cameron Alexander,8,0,30,22
1657713959073,MATH 18,A02,083744,Cinel; Cameron Alexander,17,0,30,13
1657713959073,MATH 18,A03,083745,Cinel; Cameron Alexander,10,0,30,20
1657713959073,MATH 18,B01,083748,Rideout; David Porter,5,0,37,32
1657713959073,MATH 18,B02,083749,Rideout; David Porter,5,0,36,31
1657713959073,MATH 18,B03,083750,Rideout; David Porter,3,0,37,34
1657713959073,MATH 18,B04,083751,Rideout; David Porter,6,0,36,30
1657713959073,MATH 18,B05,093473,Rideout; David Porter,6,0,36,30
1657713959073,MATH 18,B06,093474,Rideout; David Porter,6,0,36,30
1657713965100,MATH 20A,A01,083754,Zheng; Zequn,14,0,40,26
1657713971128,MATH 20B,A01,083756,Briones; Jor-el Thomas Caparas,4,0,36,32
1657713971128,MATH 20B,A02,083757,Briones; Jor-el Thomas Caparas,1,0,36,35
1657713971128,MATH 20B,A03,093475,Briones; Jor-el Thomas Caparas,2,0,36,34
1657713977162,MATH 20C,A01,083760,Briones; Jor-el Thomas Caparas,1,0,35,34
1657713977162,MATH 20C,A02,083761,Briones; Jor-el Thomas Caparas,8,0,35,27
1657713977162,MATH 20C,A03,093476,Briones; Jor-el Thomas Caparas,0,1,36,36
1657713977162,MATH 20C,B01,083762,Bach; Quang Tran,1,0,30,29
1657713983194,MATH 20D,A01,083765,Tran; Brian Kha,5,0,30,25
1657713983194,MATH 20D,A02,083766,Tran; Brian Kha,5,0,30,25
1657713983194,MATH 20D,A03,083767,Tran; Brian Kha,5,0,30,25
1657713989222,MATH 20E,A01,083771,Ganguly; Soumya,9,0,32,23
1657713989222,MATH 20E,A02,083772,Ganguly; Soumya,6,0,32,26
1657713989222,MATH 20E,B01,083773,Ciotti; Benjamin,20,0,35,15
1657713989222,MATH 20E,B02,083774,Ciotti; Benjamin,18,0,35,17
1657713995261,MATH 103A,A01,083777,Greenfeld; Be'Eri,3,0,36,33
1657713995261,MATH 103A,A02,083778,Greenfeld; Be'Eri,5,0,36,31
1657713995261,MATH 103A,A03,093561,Greenfeld; Be'Eri,6,0,36,30
1657713995261,MATH 103A,B01,083779,Greenfeld; Be'Eri,7,0,36,29
1657713995261,MATH 103A,B02,083780,Greenfeld; Be'Eri,4,0,36,32
1657713995261,MATH 103A,B03,093562,Greenfeld; Be'Eri,3,0,36,33
1657714001295,MATH 105,A01,085443,Carter; Anne Toulson,15,0,35,20
1657714001295,MATH 105,A02,093477,Carter; Anne Toulson,20,0,35,15
1657714007332,MATH 109,A01,083213,Ganzberger; Geoffrey Michael,2,0,34,32
1657714007332,MATH 109,A02,083214,Ganzberger; Geoffrey Michael,4,0,34,30
1657714007332,MATH 109,A03,093478,Ganzberger; Geoffrey Michael,2,0,34,32
1657714007332,MATH 109,B01,083215,Ganzberger; Geoffrey Michael,1,0,32,31
1657714007332,MATH 109,B02,083216,Ganzberger; Geoffrey Michael,2,0,32,30
1657714007332,MATH 109,B03,093479,Ganzberger; Geoffrey Michael,8,0,32,24
1657714013364,MATH 142A,A01,083219,Chow; Bennett,7,0,32,25
1657714013364,MATH 142A,A02,083220,Chow; Bennett,10,0,32,22
1657714013364,MATH 142A,A03,093480,Chow; Bennett,9,0,32,23
1657714013364,MATH 142A,B03,093481,Chow; Bennett,8,0,32,24
1657714013364,MATH 142A,B04,093558,Chow; Bennett,13,0,32,19
1657714013364,MATH 142A,B05,093559,Chow; Bennett,6,0,32,26
1657714019390,MATH 193A,A01,083224,Rotar; Vladimir,8,0,34,26
1657714019390,MATH 193A,A02,083225,Rotar; Vladimir,9,0,34,25
1657714019390,MATH 193A,A03,083781,Rotar; Vladimir,5,0,34,29
1657714019390,MATH 193A,A04,083782,Rotar; Vladimir,10,0,34,24
1657714019390,MATH 193A,A05,093482,Rotar; Vladimir,10,0,34,24
1657714025422,MATH 197,001,091859,McAuley; Julian John,9999,0,9999,0
1657714025422,MATH 197,002,095566,Kedlaya; Kiran S.,9997,0,9999,2
1657714025422,MATH 197,003,095567,Xiao; Ming,9999,0,9999,0
1657714025422,MATH 197,004,095571,Perols; Johan Lars,9998,0,9999,1
1657714032494,COGS 9,A01,083615,Shannon; Kyle Michael,9,0,75,66
1657714038520,COGS 11,A01,083617,Boyle; Mary E. T.,23,0,48,25
1657714044547,COGS 13,A01,083071,Bastos; Amalia Pinkusfeld,11,0,71,60
1657714050576,COGS 14A,A01,092681,Semenuks; Arturs,5,1,100,95
1657714056603,COGS 14B,A01,083073,Cheng; Tzu-Han,6,0,63,57
1657714062633,COGS 17,A01,092677,Semenuks; Arturs,6,0,81,75
1657714068660,COGS 100,A01,083619,Allen; Michael Gordon,17,0,70,53
1657714074687,COGS 101A,A01,083621,Davis; Joshua Daniel,9,0,68,59
1657714080720,COGS 101B,A01,091572,Allen; Michael Gordon,12,0,65,53
1657714086747,COGS 101C,A01,083625,Delgado; Tania,17,0,35,18
1657714092772,COGS 107A,A01,083627,Boyle; Mary E. T.,13,0,60,47
1657714098797,COGS 118A,A01,083075,Gupta; Anjum,21,0,76,55
1657714104828,CSE 3,A50,083646,Miranda; Gregory Joseph,24,0,50,26
1657714110853,CSE 8A,A50,083650,Miranda; Gregory Joseph,17,1,56,39
1657714116888,CSE 11,A01,083080,Cao; Yingjun,6,15,40,34
1657714122913,CSE 12,A01,083652,Krause-Levy; Sophia Louisa,28,1,120,92
1657714128951,CSE 15L,A01,083654,Morris; Justin Loren,9,0,50,41
1657714128951,CSE 15L,A02,083655,Morris; Justin Loren,9,0,50,41
1657714134980,CSE 20,A01,083657,Tran; Khoa Dang,39,0,80,41
1657714141007,CSE 21,A01,095574,Bach; Quang Tran,22,0,48,26
1657714147034,CSE 30,A01,083084,Eldon; John,6,0,80,74
1657714147034,CSE 30,B01,095061,Bhaskar; Nishant,9,0,50,41
1657714153072,CSE 100,A01,083659,Cao; Yingjun,5,4,70,65
1657714159096,CSE 134B,A01,083661,Powell; Thomas Allan,23,0,100,77
1657714165122,CSE 140,A01,083663,Gungor; Onat,15,0,85,70
1657714171153,CSE 140L,A01,083088,Eldon; John,23,0,100,77
1657714177180,CSE 175,A01,083665,Kumar; Rakesh,3,0,25,22
1657714183207,CSE 190,A00,092507,Dubnov; Shlomo,8,0,20,12
1657714189241,ECE 45,A01,083139,Congero; Spencer William,6,0,75,69
1657714195273,ECE 65,A50,083695,Saad; Andrew S,12,0,30,18
1657714195273,ECE 65,A51,095125,Saad; Andrew S,24,0,26,2
1657714201302,ECE 109,A01,091882,Touri; Behrouz,20,0,70,50
1657714207335,ECE 180,A00,083140,Abi Samra; Nicholas Camill,1,0,30,29
1657714207335,ECE 180,B00,083141,Abi Samra; Nicholas Camill,0,0,30,30
1657714213363,MATH 10A,A01,083735,Patchell; Gregory David,2,0,30,28
1657714213363,MATH 10A,A02,083736,Patchell; Gregory David,20,0,30,10
1657714213363,MATH 10A,A03,083737,Patchell; Gregory David,16,0,30,14
1657714219391,MATH 10B,A01,083207,Lim; Seonhee,8,0,34,26
1657714219391,MATH 10B,A02,083208,Lim; Seonhee,9,0,35,26
1657714219391,MATH 10B,A03,093472,Lim; Seonhee,7,0,34,27
1657714219391,MATH 10B,B01,083739,Sinha; Shubham,13,0,30,17
1657714225439,MATH 18,A01,083743,Cinel; Cameron Alexander,8,0,30,22
1657714225439,MATH 18,A02,083744,Cinel; Cameron Alexander,17,0,30,13
1657714225439,MATH 18,A03,083745,Cinel; Cameron Alexander,10,0,30,20
1657714225439,MATH 18,B01,083748,Rideout; David Porter,5,0,37,32
1657714225439,MATH 18,B02,083749,Rideout; David Porter,5,0,36,31
1657714225439,MATH 18,B03,083750,Rideout; David Porter,3,0,37,34
1657714225439,MATH 18,B04,083751,Rideout; David Porter,6,0,36,30
1657714225439,MATH 18,B05,093473,Rideout; David Porter,6,0,36,30
1657714225439,MATH 18,B06,093474,Rideout; David Porter,6,0,36,30
1657714231479,MATH 20A,A01,083754,Zheng; Zequn,14,0,40,26
1657714237515,MATH 20B,A01,083756,Briones; Jor-el Thomas Caparas,4,0,36,32
1657714237515,MATH 20B,A02,083757,Briones; Jor-el Thomas Caparas,1,0,36,35
1657714237515,MATH 20B,A03,093475,Briones; Jor-el Thomas Caparas,2,0,36,34
1657714243550,MATH 20C,A01,083760,Briones; Jor-el Thomas Caparas,1,0,35,34
1657714243550,MATH 20C,A02,083761,Briones; Jor-el Thomas Caparas,8,0,35,27
1657714243550,MATH 20C,A03,093476,Briones; Jor-el Thomas Caparas,0,1,36,36
1657714243550,MATH 20C,B01,083762,Bach; Quang Tran,1,0,30,29
1657714249582,MATH 20D,A01,083765,Tran; Brian Kha,5,0,30,25
1657714249582,MATH 20D,A02,083766,Tran; Brian Kha,5,0,30,25
1657714249582,MATH 20D,A03,083767,Tran; Brian Kha,5,0,30,25
1657714255609,MATH 20E,A01,083771,Ganguly; Soumya,9,0,32,23
1657714255609,MATH 20E,A02,083772,Ganguly; Soumya,6,0,32,26
1657714255609,MATH 20E,B01,083773,Ciotti; Benjamin,20,0,35,15
1657714255609,MATH 20E,B02,083774,Ciotti; Benjamin,18,0,35,17
1657714261640,MATH 103A,A01,083777,Greenfeld; Be'Eri,3,0,36,33
1657714261640,MATH 103A,A02,083778,Greenfeld; Be'Eri,5,0,36,31
1657714261640,MATH 103A,A03,093561,Greenfeld; Be'Eri,6,0,36,30
1657714261640,MATH 103A,B01,083779,Greenfeld; Be'Eri,7,0,36,29
1657714261640,MATH 103A,B02,083780,Greenfeld; Be'Eri,4,0,36,32
1657714261640,MATH 103A,B03,093562,Greenfeld; Be'Eri,3,0,36,33
1657714267667,MATH 105,A01,085443,Carter; Anne Toulson,15,0,35,20
1657714267667,MATH 105,A02,093477,Carter; Anne Toulson,20,0,35,15
1657714273704,MATH 109,A01,083213,Ganzberger; Geoffrey Michael,2,0,34,32
1657714273704,MATH 109,A02,083214,Ganzberger; Geoffrey Michael,4,0,34,30
1657714273704,MATH 109,A03,093478,Ganzberger; Geoffrey Michael,2,0,34,32
1657714273704,MATH 109,B01,083215,Ganzberger; Geoffrey Michael,1,0,32,31
1657714273704,MATH 109,B02,083216,Ganzberger; Geoffrey Michael,2,0,32,30
1657714273704,MATH 109,B03,093479,Ganzberger; Geoffrey Michael,8,0,32,24
1657714279730,MATH 142A,A01,083219,Chow; Bennett,7,0,32,25
1657714279730,MATH 142A,A02,083220,Chow; Bennett,10,0,32,22
1657714279730,MATH 142A,A03,093480,Chow; Bennett,9,0,32,23
1657714279730,MATH 142A,B03,093481,Chow; Bennett,8,0,32,24
1657714279730,MATH 142A,B04,093558,Chow; Bennett,13,0,32,19
1657714279730,MATH 142A,B05,093559,Chow; Bennett,6,0,32,26
1657714285771,MATH 193A,A01,083224,Rotar; Vladimir,8,0,34,26
1657714285771,MATH 193A,A02,083225,Rotar; Vladimir,9,0,34,25
1657714285771,MATH 193A,A03,083781,Rotar; Vladimir,5,0,34,29
1657714285771,MATH 193A,A04,083782,Rotar; Vladimir,10,0,34,24
1657714285771,MATH 193A,A05,093482,Rotar; Vladimir,10,0,34,24
1657714291796,MATH 197,001,091859,McAuley; Julian John,9999,0,9999,0
1657714291796,MATH 197,002,095566,Kedlaya; Kiran S.,9997,0,9999,2
1657714291796,MATH 197,003,095567,Xiao; Ming,9999,0,9999,0
1657714291796,MATH 197,004,095571,Perols; Johan Lars,9998,0,9999,1
1657714298875,COGS 9,A01,083615,Shannon; Kyle Michael,9,0,75,66
1657714304899,COGS 11,A01,083617,Boyle; Mary E. T.,23,0,48,25
1657714310928,COGS 13,A01,083071,Bastos; Amalia Pinkusfeld,11,0,71,60
1657714316957,COGS 14A,A01,092681,Semenuks; Arturs,5,1,100,95
1657714322981,COGS 14B,A01,083073,Cheng; Tzu-Han,6,0,63,57
1657714329011,COGS 17,A01,092677,Semenuks; Arturs,6,0,81,75
1657714335037,COGS 100,A01,083619,Allen; Michael Gordon,17,0,70,53
1657714341068,COGS 101A,A01,083621,Davis; Joshua Daniel,9,0,68,59
1657714347094,COGS 101B,A01,091572,Allen; Michael Gordon,12,0,65,53
1657714353120,COGS 101C,A01,083625,Delgado; Tania,17,0,35,18
1657714359150,COGS 107A,A01,083627,Boyle; Mary E. T.,13,0,60,47
1657714365179,COGS 118A,A01,083075,Gupta; Anjum,21,0,76,55
1657714371212,CSE 3,A50,083646,Miranda; Gregory Joseph,24,0,50,26
1657714377238,CSE 8A,A50,083650,Miranda; Gregory Joseph,17,1,56,39
1657714383267,CSE 11,A01,083080,Cao; Yingjun,6,15,40,34
1657714389299,CSE 12,A01,083652,Krause-Levy; Sophia Louisa,28,1,120,92
1657714395332,CSE 15L,A01,083654,Morris; Justin Loren,9,0,50,41
1657714395332,CSE 15L,A02,083655,Morris; Justin Loren,9,0,50,41
1657714401437,CSE 20,A01,083657,Tran; Khoa Dang,39,0,80,41
1657714407484,CSE 21,A01,095574,Bach; Quang Tran,22,0,48,26
1657714413510,CSE 30,A01,083084,Eldon; John,6,0,80,74
1657714413510,CSE 30,B01,095061,Bhaskar; Nishant,9,0,50,41
1657714419540,CSE 100,A01,083659,Cao; Yingjun,5,4,70,65
1657714425568,CSE 134B,A01,083661,Powell; Thomas Allan,23,0,100,77
1657714431597,CSE 140,A01,083663,Gungor; Onat,15,0,85,70
1657714437632,CSE 140L,A01,083088,Eldon; John,23,0,100,77
1657714443667,CSE 175,A01,083665,Kumar; Rakesh,3,0,25,22
1657714449697,CSE 190,A00,092507,Dubnov; Shlomo,8,0,20,12
1657714455736,ECE 45,A01,083139,Congero; Spencer William,6,0,75,69
1657714461763,ECE 65,A50,083695,Saad; Andrew S,12,0,30,18
1657714461763,ECE 65,A51,095125,Saad; Andrew S,24,0,26,2
1657714467800,ECE 109,A01,091882,Touri; Behrouz,20,0,70,50
1657714473831,ECE 180,A00,083140,Abi Samra; Nicholas Camill,1,0,30,29
1657714473831,ECE 180,B00,083141,Abi Samra; Nicholas Camill,0,0,30,30
1657714479861,MATH 10A,A01,083735,Patchell; Gregory David,2,0,30,28
1657714479861,MATH 10A,A02,083736,Patchell; Gregory David,20,0,30,10
1657714479861,MATH 10A,A03,083737,Patchell; Gregory David,16,0,30,14
1657714485903,MATH 10B,A01,083207,Lim; Seonhee,8,0,34,26
1657714485903,MATH 10B,A02,083208,Lim; Seonhee,9,0,35,26
1657714485903,MATH 10B,A03,093472,Lim; Seonhee,7,0,34,27
1657714485903,MATH 10B,B01,083739,Sinha; Shubham,13,0,30,17
1657714491934,MATH 18,A01,083743,Cinel; Cameron Alexander,8,0,30,22
1657714491934,MATH 18,A02,083744,Cinel; Cameron Alexander,17,0,30,13
1657714491934,MATH 18,A03,083745,Cinel; Cameron Alexander,10,0,30,20
1657714491934,MATH 18,B01,083748,Rideout; David Porter,5,0,37,32
1657714491934,MATH 18,B02,083749,Rideout; David Porter,5,0,36,31
1657714491934,MATH 18,B03,083750,Rideout; David Porter,3,0,37,34
1657714491934,MATH 18,B04,083751,Rideout; David Porter,6,0,36,30
1657714491934,MATH 18,B05,093473,Rideout; David Porter,6,0,36,30
1657714491934,MATH 18,B06,093474,Rideout; David Porter,6,0,36,30
1657714497959,MATH 20A,A01,083754,Zheng; Zequn,14,0,40,26
1657714503986,MATH 20B,A01,083756,Briones; Jor-el Thomas Caparas,4,0,36,32
1657714503986,MATH 20B,A02,083757,Briones; Jor-el Thomas Caparas,1,0,36,35
1657714503986,MATH 20B,A03,093475,Briones; Jor-el Thomas Caparas,2,0,36,34
1657714510020,MATH 20C,A01,083760,Briones; Jor-el Thomas Caparas,1,0,35,34
1657714510020,MATH 20C,A02,083761,Briones; Jor-el Thomas Caparas,8,0,35,27
1657714510020,MATH 20C,A03,093476,Briones; Jor-el Thomas Caparas,0,1,36,36
1657714510020,MATH 20C,B01,083762,Bach; Quang Tran,1,0,30,29
1657714516046,MATH 20D,A01,083765,Tran; Brian Kha,5,0,30,25
1657714516046,MATH 20D,A02,083766,Tran; Brian Kha,5,0,30,25
1657714516046,MATH 20D,A03,083767,Tran; Brian Kha,5,0,30,25
1657714522075,MATH 20E,A01,083771,Ganguly; Soumya,9,0,32,23
1657714522075,MATH 20E,A02,083772,Ganguly; Soumya,6,0,32,26
1657714522075,MATH 20E,B01,083773,Ciotti; Benjamin,20,0,35,15
1657714522075,MATH 20E,B02,083774,Ciotti; Benjamin,18,0,35,17
1657714528111,MATH 103A,A01,083777,Greenfeld; Be'Eri,3,0,36,33
1657714528111,MATH 103A,A02,083778,Greenfeld; Be'Eri,5,0,36,31
1657714528111,MATH 103A,A03,093561,Greenfeld; Be'Eri,6,0,36,30
1657714528111,MATH 103A,B01,083779,Greenfeld; Be'Eri,7,0,36,29
1657714528111,MATH 103A,B02,083780,Greenfeld; Be'Eri,4,0,36,32
1657714528111,MATH 103A,B03,093562,Greenfeld; Be'Eri,3,0,36,33
1657714534143,MATH 105,A01,085443,Carter; Anne Toulson,15,0,35,20
1657714534143,MATH 105,A02,093477,Carter; Anne Toulson,20,0,35,15
1657714540170,MATH 109,A01,083213,Ganzberger; Geoffrey Michael,2,0,34,32
1657714540170,MATH 109,A02,083214,Ganzberger; Geoffrey Michael,4,0,34,30
1657714540170,MATH 109,A03,093478,Ganzberger; Geoffrey Michael,2,0,34,32
1657714540170,MATH 109,B01,083215,Ganzberger; Geoffrey Michael,1,0,32,31
1657714540170,MATH 109,B02,083216,Ganzberger; Geoffrey Michael,2,0,32,30
1657714540170,MATH 109,B03,093479,Ganzberger; Geoffrey Michael,8,0,32,24
1657714546197,MATH 142A,A01,083219,Chow; Bennett,7,0,32,25
1657714546197,MATH 142A,A02,083220,Chow; Bennett,10,0,32,22
1657714546197,MATH 142A,A03,093480,Chow; Bennett,9,0,32,23
1657714546197,MATH 142A,B03,093481,Chow; Bennett,8,0,32,24
1657714546197,MATH 142A,B04,093558,Chow; Bennett,13,0,32,19
1657714546197,MATH 142A,B05,093559,Chow; Bennett,6,0,32,26
1657714552222,MATH 193A,A01,083224,Rotar; Vladimir,8,0,34,26
1657714552222,MATH 193A,A02,083225,Rotar; Vladimir,9,0,34,25
1657714552222,MATH 193A,A03,083781,Rotar; Vladimir,5,0,34,29
1657714552222,MATH 193A,A04,083782,Rotar; Vladimir,10,0,34,24
1657714552222,MATH 193A,A05,093482,Rotar; Vladimir,10,0,34,24
1657714558250,MATH 197,001,091859,McAuley; Julian John,9999,0,9999,0
1657714558250,MATH 197,002,095566,Kedlaya; Kiran S.,9997,0,9999,2
1657714558250,MATH 197,003,095567,Xiao; Ming,9999,0,9999,0
1657714558250,MATH 197,004,095571,Perols; Johan Lars,9998,0,9999,1
1657714565325,COGS 9,A01,083615,Shannon; Kyle Michael,9,0,75,66
1657714571352,COGS 11,A01,083617,Boyle; Mary E. T.,23,0,48,25
1657714577376,COGS 13,A01,083071,Bastos; Amalia Pinkusfeld,11,0,71,60
1657714583400,COGS 14A,A01,092681,Semenuks; Arturs,5,1,100,95
1657714589425,COGS 14B,A01,083073,Cheng; Tzu-Han,6,0,63,57
1657714595451,COGS 17,A01,092677,Semenuks; Arturs,6,0,81,75
1657714601477,COGS 100,A01,083619,Allen; Michael Gordon,17,0,70,53
1657714607519,COGS 101A,A01,083621,Davis; Joshua Daniel,9,0,68,59
1657714613551,COGS 101B,A01,091572,Allen; Michael Gordon,12,0,65,53
1657714619584,COGS 101C,A01,083625,Delgado; Tania,17,0,35,18
1657714625617,COGS 107A,A01,083627,Boyle; Mary E. T.,13,0,60,47
1657714631652,COGS 118A,A01,083075,Gupta; Anjum,21,0,76,55
1657714637686,CSE 3,A50,083646,Miranda; Gregory Joseph,24,0,50,26
1657714643716,CSE 8A,A50,083650,Miranda; Gregory Joseph,17,1,56,39
1657714649747,CSE 11,A01,083080,Cao; Yingjun,6,15,40,34
1657714655776,CSE 12,A01,083652,Krause-Levy; Sophia Louisa,28,1,120,92
1657714661813,CSE 15L,A01,083654,Morris; Justin Loren,9,0,50,41
1657714661813,CSE 15L,A02,083655,Morris; Justin Loren,9,0,50,41
1657714667850,CSE 20,A01,083657,Tran; Khoa Dang,39,0,80,41
1657714673878,CSE 21,A01,095574,Bach; Quang Tran,22,0,48,26
1657714679905,CSE 30,A01,083084,Eldon; John,6,0,80,74
1657714679905,CSE 30,B01,095061,Bhaskar; Nishant,9,0,50,41
1657714685930,CSE 100,A01,083659,Cao; Yingjun,5,4,70,65
1657714691956,CSE 134B,A01,083661,Powell; Thomas Allan,23,0,100,77
1657714697988,CSE 140,A01,083663,Gungor; Onat,15,0,85,70
1657714704014,CSE 140L,A01,083088,Eldon; John,23,0,100,77
1657714710041,CSE 175,A01,083665,Kumar; Rakesh,3,0,25,22
1657714716069,CSE 190,A00,092507,Dubnov; Shlomo,8,0,20,12
1657714722096,ECE 45,A01,083139,Congero; Spencer William,6,0,75,69
1657714728138,ECE 65,A50,083695,Saad; Andrew S,12,0,30,18
1657714728138,ECE 65,A51,095125,Saad; Andrew S,24,0,26,2
1657714734168,ECE 109,A01,091882,Touri; Behrouz,20,0,70,50
1657714740197,ECE 180,A00,083140,Abi Samra; Nicholas Camill,1,0,30,29
1657714740197,ECE 180,B00,083141,Abi Samra; Nicholas Camill,0,0,30,30
1657714746230,MATH 10A,A01,083735,Patchell; Gregory David,2,0,30,28
1657714746230,MATH 10A,A02,083736,Patchell; Gregory David,20,0,30,10
1657714746230,MATH 10A,A03,083737,Patchell; Gregory David,16,0,30,14
1657714752268,MATH 10B,A01,083207,Lim; Seonhee,8,0,34,26
1657714752268,MATH 10B,A02,083208,Lim; Seonhee,9,0,35,26
1657714752268,MATH 10B,A03,093472,Lim; Seonhee,7,0,34,27
1657714752268,MATH 10B,B01,083739,Sinha; Shubham,13,0,30,17
1657714758298,MATH 18,A01,083743,Cinel; Cameron Alexander,8,0,30,22
1657714758298,MATH 18,A02,083744,Cinel; Cameron Alexander,17,0,30,13
1657714758298,MATH 18,A03,083745,Cinel; Cameron Alexander,10,0,30,20
1657714758298,MATH 18,B01,083748,Rideout; David Porter,5,0,37,32
1657714758298,MATH 18,B02,083749,Rideout; David Porter,5,0,36,31
1657714758298,MATH 18,B03,083750,Rideout; David Porter,3,0,37,34
1657714758298,MATH 18,B04,083751,Rideout; David Porter,6,0,36,30
1657714758298,MATH 18,B05,093473,Rideout; David Porter,6,0,36,30
1657714758298,MATH 18,B06,093474,Rideout; David Porter,6,0,36,30
1657714764328,MATH 20A,A01,083754,Zheng; Zequn,14,0,40,26
1657714770361,MATH 20B,A01,083756,Briones; Jor-el Thomas Caparas,4,0,36,32
1657714770361,MATH 20B,A02,083757,Briones; Jor-el Thomas Caparas,1,0,36,35
1657714770361,MATH 20B,A03,093475,Briones; Jor-el Thomas Caparas,2,0,36,34
1657714776391,MATH 20C,A01,083760,Briones; Jor-el Thomas Caparas,1,0,35,34
1657714776391,MATH 20C,A02,083761,Briones; Jor-el Thomas Caparas,8,0,35,27
1657714776391,MATH 20C,A03,093476,Briones; Jor-el Thomas Caparas,0,1,36,36
1657714776391,MATH 20C,B01,083762,Bach; Quang Tran,1,0,30,29
1657714782424,MATH 20D,A01,083765,Tran; Brian Kha,5,0,30,25
1657714782424,MATH 20D,A02,083766,Tran; Brian Kha,5,0,30,25
1657714782424,MATH 20D,A03,083767,Tran; Brian Kha,5,0,30,25
1657714788453,MATH 20E,A01,083771,Ganguly; Soumya,9,0,32,23
1657714788453,MATH 20E,A02,083772,Ganguly; Soumya,6,0,32,26
1657714788453,MATH 20E,B01,083773,Ciotti; Benjamin,20,0,35,15
1657714788453,MATH 20E,B02,083774,Ciotti; Benjamin,18,0,35,17
1657714794496,MATH 103A,A01,083777,Greenfeld; Be'Eri,3,0,36,33
1657714794496,MATH 103A,A02,083778,Greenfeld; Be'Eri,5,0,36,31
1657714794496,MATH 103A,A03,093561,Greenfeld; Be'Eri,6,0,36,30
1657714794496,MATH 103A,B01,083779,Greenfeld; Be'Eri,7,0,36,29
1657714794496,MATH 103A,B02,083780,Greenfeld; Be'Eri,4,0,36,32
1657714794496,MATH 103A,B03,093562,Greenfeld; Be'Eri,3,0,36,33
1657714800520,MATH 105,A01,085443,Carter; Anne Toulson,15,0,35,20
1657714800520,MATH 105,A02,093477,Carter; Anne Toulson,20,0,35,15
1657714806551,MATH 109,A01,083213,Ganzberger; Geoffrey Michael,2,0,34,32
1657714806551,MATH 109,A02,083214,Ganzberger; Geoffrey Michael,4,0,34,30
1657714806551,MATH 109,A03,093478,Ganzberger; Geoffrey Michael,2,0,34,32
1657714806551,MATH 109,B01,083215,Ganzberger; Geoffrey Michael,1,0,32,31
1657714806551,MATH 109,B02,083216,Ganzberger; Geoffrey Michael,2,0,32,30
1657714806551,MATH 109,B03,093479,Ganzberger; Geoffrey Michael,8,0,32,24
1657714812591,MATH 142A,A01,083219,Chow; Bennett,7,0,32,25
1657714812591,MATH 142A,A02,083220,Chow; Bennett,10,0,32,22
1657714812591,MATH 142A,A03,093480,Chow; Bennett,9,0,32,23
1657714812591,MATH 142A,B03,093481,Chow; Bennett,8,0,32,24
1657714812591,MATH 142A,B04,093558,Chow; Bennett,13,0,32,19
1657714812591,MATH 142A,B05,093559,Chow; Bennett,6,0,32,26
1657714818617,MATH 193A,A01,083224,Rotar; Vladimir,8,0,34,26
1657714818617,MATH 193A,A02,083225,Rotar; Vladimir,9,0,34,25
1657714818617,MATH 193A,A03,083781,Rotar; Vladimir,5,0,34,29
1657714818617,MATH 193A,A04,083782,Rotar; Vladimir,10,0,34,24
1657714818617,MATH 193A,A05,093482,Rotar; Vladimir,10,0,34,24
1657714824642,MATH 197,001,091859,McAuley; Julian John,9999,0,9999,0
1657714824642,MATH 197,002,095566,Kedlaya; Kiran S.,9997,0,9999,2
1657714824642,MATH 197,003,095567,Xiao; Ming,9999,0,9999,0
1657714824642,MATH 197,004,095571,Perols; Johan Lars,9998,0,9999,1
1657714831710,COGS 9,A01,083615,Shannon; Kyle Michael,9,0,75,66
1657714837734,COGS 11,A01,083617,Boyle; Mary E. T.,23,0,48,25
1657714843761,COGS 13,A01,083071,Bastos; Amalia Pinkusfeld,11,0,71,60
1657714849784,COGS 14A,A01,092681,Semenuks; Arturs,5,1,100,95
1657714855815,COGS 14B,A01,083073,Cheng; Tzu-Han,6,0,63,57
1657714861841,COGS 17,A01,092677,Semenuks; Arturs,6,0,81,75
1657714867864,COGS 100,A01,083619,Allen; Michael Gordon,17,0,70,53
1657714873890,COGS 101A,A01,083621,Davis; Joshua Daniel,9,0,68,59
1657714879917,COGS 101B,A01,091572,Allen; Michael Gordon,12,0,65,53
1657714885945,COGS 101C,A01,083625,Delgado; Tania,17,0,35,18
1657714891974,COGS 107A,A01,083627,Boyle; Mary E. T.,13,0,60,47
1657714897999,COGS 118A,A01,083075,Gupta; Anjum,21,0,76,55
1657714904027,CSE 3,A50,083646,Miranda; Gregory Joseph,24,0,50,26
1657714910054,CSE 8A,A50,083650,Miranda; Gregory Joseph,17,1,56,39
1657714916081,CSE 11,A01,083080,Cao; Yingjun,6,15,40,34
1657714922111,CSE 12,A01,083652,Krause-Levy; Sophia Louisa,28,1,120,92
1657714928147,CSE 15L,A01,083654,Morris; Justin Loren,9,0,50,41
1657714928147,CSE 15L,A02,083655,Morris; Justin Loren,9,0,50,41
1657714934172,CSE 20,A01,083657,Tran; Khoa Dang,39,0,80,41
1657714940199,CSE 21,A01,095574,Bach; Quang Tran,22,0,48,26
1657714946223,CSE 30,A01,083084,Eldon; John,6,0,80,74
1657714946223,CSE 30,B01,095061,Bhaskar; Nishant,9,0,50,41
1657714952249,CSE 100,A01,083659,Cao; Yingjun,5,4,70,65
1657714958275,CSE 134B,A01,083661,Powell; Thomas Allan,23,0,100,77
1657714964302,CSE 140,A01,083663,Gungor; Onat,15,0,85,70
1657714970326,CSE 140L,A01,083088,Eldon; John,23,0,100,77
1657714976351,CSE 175,A01,083665,Kumar; Rakesh,3,0,25,22
1657714982380,CSE 190,A00,092507,Dubnov; Shlomo,8,0,20,12
1657714988413,ECE 45,A01,083139,Congero; Spencer William,6,0,75,69
1657714994442,ECE 65,A50,083695,Saad; Andrew S,12,0,30,18
1657714994442,ECE 65,A51,095125,Saad; Andrew S,24,0,26,2
1657715000542,ECE 109,A01,091882,Touri; Behrouz,20,0,70,50
1657715006569,ECE 180,A00,083140,Abi Samra; Nicholas Camill,1,0,30,29
1657715006569,ECE 180,B00,083141,Abi Samra; Nicholas Camill,0,0,30,30
1657715012595,MATH 10A,A01,083735,Patchell; Gregory David,2,0,30,28
1657715012595,MATH 10A,A02,083736,Patchell; Gregory David,20,0,30,10
1657715012595,MATH 10A,A03,083737,Patchell; Gregory David,16,0,30,14
1657715018619,MATH 10B,A01,083207,Lim; Seonhee,8,0,34,26
1657715018619,MATH 10B,A02,083208,Lim; Seonhee,9,0,35,26
1657715018619,MATH 10B,A03,093472,Lim; Seonhee,7,0,34,27
1657715018619,MATH 10B,B01,083739,Sinha; Shubham,13,0,30,17
1657715024646,MATH 18,A01,083743,Cinel; Cameron Alexander,8,0,30,22
1657715024646,MATH 18,A02,083744,Cinel; Cameron Alexander,17,0,30,13
1657715024646,MATH 18,A03,083745,Cinel; Cameron Alexander,10,0,30,20
1657715024646,MATH 18,B01,083748,Rideout; David Porter,5,0,37,32
1657715024646,MATH 18,B02,083749,Rideout; David Porter,5,0,36,31
1657715024646,MATH 18,B03,083750,Rideout; David Porter,3,0,37,34
1657715024646,MATH 18,B04,083751,Rideout; David Porter,6,0,36,30
1657715024646,MATH 18,B05,093473,Rideout; David Porter,6,0,36,30
1657715024646,MATH 18,B06,093474,Rideout; David Porter,6,0,36,30
1657715030687,MATH 20A,A01,083754,Zheng; Zequn,14,0,40,26
1657715036714,MATH 20B,A01,083756,Briones; Jor-el Thomas Caparas,4,0,36,32
1657715036714,MATH 20B,A02,083757,Briones; Jor-el Thomas Caparas,1,0,36,35
1657715036714,MATH 20B,A03,093475,Briones; Jor-el Thomas Caparas,2,0,36,34
1657715042741,MATH 20C,A01,083760,Briones; Jor-el Thomas Caparas,1,0,35,34
1657715042741,MATH 20C,A02,083761,Briones; Jor-el Thomas Caparas,8,0,35,27
1657715042741,MATH 20C,A03,093476,Briones; Jor-el Thomas Caparas,0,1,36,36
1657715042741,MATH 20C,B01,083762,Bach; Quang Tran,1,0,30,29
1657715048767,MATH 20D,A01,083765,Tran; Brian Kha,5,0,30,25
1657715048767,MATH 20D,A02,083766,Tran; Brian Kha,5,0,30,25
1657715048767,MATH 20D,A03,083767,Tran; Brian Kha,5,0,30,25
1657715054795,MATH 20E,A01,083771,Ganguly; Soumya,9,0,32,23
1657715054795,MATH 20E,A02,083772,Ganguly; Soumya,6,0,32,26
1657715054795,MATH 20E,B01,083773,Ciotti; Benjamin,20,0,35,15
1657715054795,MATH 20E,B02,083774,Ciotti; Benjamin,18,0,35,17
1657715060828,MATH 103A,A01,083777,Greenfeld; Be'Eri,3,0,36,33
1657715060828,MATH 103A,A02,083778,Greenfeld; Be'Eri,5,0,36,31
1657715060828,MATH 103A,A03,093561,Greenfeld; Be'Eri,6,0,36,30
1657715060828,MATH 103A,B01,083779,Greenfeld; Be'Eri,7,0,36,29
1657715060828,MATH 103A,B02,083780,Greenfeld; Be'Eri,4,0,36,32
1657715060828,MATH 103A,B03,093562,Greenfeld; Be'Eri,3,0,36,33
1657715066858,MATH 105,A01,085443,Carter; Anne Toulson,15,0,35,20
1657715066858,MATH 105,A02,093477,Carter; Anne Toulson,20,0,35,15
1657715072884,MATH 109,A01,083213,Ganzberger; Geoffrey Michael,2,0,34,32
1657715072884,MATH 109,A02,083214,Ganzberger; Geoffrey Michael,4,0,34,30
1657715072884,MATH 109,A03,093478,Ganzberger; Geoffrey Michael,2,0,34,32
1657715072884,MATH 109,B01,083215,Ganzberger; Geoffrey Michael,1,0,32,31
1657715072884,MATH 109,B02,083216,Ganzberger; Geoffrey Michael,2,0,32,30
1657715072884,MATH 109,B03,093479,Ganzberger; Geoffrey Michael,8,0,32,24
1657715078918,MATH 142A,A01,083219,Chow; Bennett,7,0,32,25
1657715078918,MATH 142A,A02,083220,Chow; Bennett,10,0,32,22
1657715078918,MATH 142A,A03,093480,Chow; Bennett,9,0,32,23
1657715078918,MATH 142A,B03,093481,Chow; Bennett,8,0,32,24
1657715078918,MATH 142A,B04,093558,Chow; Bennett,13,0,32,19
1657715078918,MATH 142A,B05,093559,Chow; Bennett,6,0,32,26
1657715084947,MATH 193A,A01,083224,Rotar; Vladimir,8,0,34,26
1657715084947,MATH 193A,A02,083225,Rotar; Vladimir,9,0,34,25
1657715084947,MATH 193A,A03,083781,Rotar; Vladimir,5,0,34,29
1657715084947,MATH 193A,A04,083782,Rotar; Vladimir,10,0,34,24
1657715084947,MATH 193A,A05,093482,Rotar; Vladimir,10,0,34,24
1657715090975,MATH 197,001,091859,McAuley; Julian John,9999,0,9999,0
1657715090975,MATH 197,002,095566,Kedlaya; Kiran S.,9997,0,9999,2
1657715090975,MATH 197,003,095567,Xiao; Ming,9999,0,9999,0
1657715090975,MATH 197,004,095571,Perols; Johan Lars,9998,0,9999,1
1657715098060,COGS 9,A01,083615,Shannon; Kyle Michael,9,0,75,66
1657715104089,COGS 11,A01,083617,Boyle; Mary E. T.,23,0,48,25
1657715110118,COGS 13,A01,083071,Bastos; Amalia Pinkusfeld,11,0,71,60
1657715116146,COGS 14A,A01,092681,Semenuks; Arturs,5,1,100,95
1657715122171,COGS 14B,A01,083073,Cheng; Tzu-Han,6,0,63,57
1657715128194,COGS 17,A01,092677,Semenuks; Arturs,6,0,81,75
1657715134225,COGS 100,A01,083619,Allen; Michael Gordon,17,0,70,53
1657715140249,COGS 101A,A01,083621,Davis; Joshua Daniel,9,0,68,59
1657715146277,COGS 101B,A01,091572,Allen; Michael Gordon,12,0,65,53
1657715152301,COGS 101C,A01,083625,Delgado; Tania,17,0,35,18
1657715158327,COGS 107A,A01,083627,Boyle; Mary E. T.,13,0,60,47
1657715164355,COGS 118A,A01,083075,Gupta; Anjum,21,0,76,55
1657715170378,CSE 3,A50,083646,Miranda; Gregory Joseph,24,0,50,26
1657715176407,CSE 8A,A50,083650,Miranda; Gregory Joseph,17,1,56,39
1657715182432,CSE 11,A01,083080,Cao; Yingjun,6,15,40,34
1657715188457,CSE 12,A01,083652,Krause-Levy; Sophia Louisa,28,1,120,92
1657715194485,CSE 15L,A01,083654,Morris; Justin Loren,9,0,50,41
1657715194485,CSE 15L,A02,083655,Morris; Justin Loren,9,0,50,41
1657715200510,CSE 20,A01,083657,Tran; Khoa Dang,39,0,80,41
1657715206539,CSE 21,A01,095574,Bach; Quang Tran,22,0,48,26
1657715212565,CSE 30,A01,083084,Eldon; John,6,0,80,74
1657715212565,CSE 30,B01,095061,Bhaskar; Nishant,9,0,50,41
1657715218588,CSE 100,A01,083659,Cao; Yingjun,5,4,70,65
1657715224613,CSE 134B,A01,083661,Powell; Thomas Allan,23,0,100,77
1657715230640,CSE 140,A01,083663,Gungor; Onat,15,0,85,70
1657715236669,CSE 140L,A01,083088,Eldon; John,23,0,100,77
1657715242695,CSE 175,A01,083665,Kumar; Rakesh,3,0,25,22
1657715248736,CSE 190,A00,092507,Dubnov; Shlomo,8,0,20,12
1657715254769,ECE 45,A01,083139,Congero; Spencer William,6,0,75,69
1657715260804,ECE 65,A50,083695,Saad; Andrew S,12,0,30,18
1657715260804,ECE 65,A51,095125,Saad; Andrew S,24,0,26,2
1657715266830,ECE 109,A01,091882,Touri; Behrouz,20,0,70,50
1657715272854,ECE 180,A00,083140,Abi Samra; Nicholas Camill,1,0,30,29
1657715272854,ECE 180,B00,083141,Abi Samra; Nicholas Camill,0,0,30,30
1657715278879,MATH 10A,A01,083735,Patchell; Gregory David,2,0,30,28
1657715278879,MATH 10A,A02,083736,Patchell; Gregory David,20,0,30,10
1657715278879,MATH 10A,A03,083737,Patchell; Gregory David,16,0,30,14
1657715284914,MATH 10B,A01,083207,Lim; Seonhee,8,0,34,26
1657715284914,MATH 10B,A02,083208,Lim; Seonhee,9,0,35,26
1657715284914,MATH 10B,A03,093472,Lim; Seonhee,7,0,34,27
1657715284914,MATH 10B,B01,083739,Sinha; Shubham,13,0,30,17
1657715290954,MATH 18,A01,083743,Cinel; Cameron Alexander,8,0,30,22
1657715290954,MATH 18,A02,083744,Cinel; Cameron Alexander,17,0,30,13
1657715290954,MATH 18,A03,083745,Cinel; Cameron Alexander,10,0,30,20
1657715290954,MATH 18,B01,083748,Rideout; David Porter,5,0,37,32
1657715290954,MATH 18,B02,083749,Rideout; David Porter,5,0,36,31
1657715290954,MATH 18,B03,083750,Rideout; David Porter,3,0,37,34
1657715290954,MATH 18,B04,083751,Rideout; David Porter,6,0,36,30
1657715290954,MATH 18,B05,093473,Rideout; David Porter,6,0,36,30
1657715290954,MATH 18,B06,093474,Rideout; David Porter,6,0,36,30
1657715296977,MATH 20A,A01,083754,Zheng; Zequn,14,0,40,26
1657715303002,MATH 20B,A01,083756,Briones; Jor-el Thomas Caparas,4,0,36,32
1657715303002,MATH 20B,A02,083757,Briones; Jor-el Thomas Caparas,1,0,36,35
1657715303002,MATH 20B,A03,093475,Briones; Jor-el Thomas Caparas,2,0,36,34
1657715309033,MATH 20C,A01,083760,Briones; Jor-el Thomas Caparas,1,0,35,34
1657715309033,MATH 20C,A02,083761,Briones; Jor-el Thomas Caparas,8,0,35,27
1657715309033,MATH 20C,A03,093476,Briones; Jor-el Thomas Caparas,0,1,36,36
1657715309033,MATH 20C,B01,083762,Bach; Quang Tran,1,0,30,29
1657715315064,MATH 20D,A01,083765,Tran; Brian Kha,5,0,30,25
1657715315064,MATH 20D,A02,083766,Tran; Brian Kha,5,0,30,25
1657715315064,MATH 20D,A03,083767,Tran; Brian Kha,5,0,30,25
1657715321099,MATH 20E,A01,083771,Ganguly; Soumya,9,0,32,23
1657715321099,MATH 20E,A02,083772,Ganguly; Soumya,6,0,32,26
1657715321099,MATH 20E,B01,083773,Ciotti; Benjamin,20,0,35,15
1657715321099,MATH 20E,B02,083774,Ciotti; Benjamin,18,0,35,17
1657715327131,MATH 103A,A01,083777,Greenfeld; Be'Eri,3,0,36,33
1657715327131,MATH 103A,A02,083778,Greenfeld; Be'Eri,5,0,36,31
1657715327131,MATH 103A,A03,093561,Greenfeld; Be'Eri,6,0,36,30
1657715327131,MATH 103A,B01,083779,Greenfeld; Be'Eri,7,0,36,29
1657715327131,MATH 103A,B02,083780,Greenfeld; Be'Eri,4,0,36,32
1657715327131,MATH 103A,B03,093562,Greenfeld; Be'Eri,3,0,36,33
1657715333155,MATH 105,A01,085443,Carter; Anne Toulson,15,0,35,20
1657715333155,MATH 105,A02,093477,Carter; Anne Toulson,20,0,35,15
1657715339181,MATH 109,A01,083213,Ganzberger; Geoffrey Michael,2,0,34,32
1657715339181,MATH 109,A02,083214,Ganzberger; Geoffrey Michael,4,0,34,30
1657715339181,MATH 109,A03,093478,Ganzberger; Geoffrey Michael,2,0,34,32
1657715339181,MATH 109,B01,083215,Ganzberger; Geoffrey Michael,1,0,32,31
1657715339181,MATH 109,B02,083216,Ganzberger; Geoffrey Michael,2,0,32,30
1657715339181,MATH 109,B03,093479,Ganzberger; Geoffrey Michael,8,0,32,24
1657715345207,MATH 142A,A01,083219,Chow; Bennett,7,0,32,25
1657715345207,MATH 142A,A02,083220,Chow; Bennett,10,0,32,22
1657715345207,MATH 142A,A03,093480,Chow; Bennett,9,0,32,23
1657715345207,MATH 142A,B03,093481,Chow; Bennett,8,0,32,24
1657715345207,MATH 142A,B04,093558,Chow; Bennett,13,0,32,19
1657715345207,MATH 142A,B05,093559,Chow; Bennett,6,0,32,26
1657715351237,MATH 193A,A01,083224,Rotar; Vladimir,8,0,34,26
1657715351237,MATH 193A,A02,083225,Rotar; Vladimir,9,0,34,25
1657715351237,MATH 193A,A03,083781,Rotar; Vladimir,5,0,34,29
1657715351237,MATH 193A,A04,083782,Rotar; Vladimir,10,0,34,24
1657715351237,MATH 193A,A05,093482,Rotar; Vladimir,10,0,34,24
1657715357266,MATH 197,001,091859,McAuley; Julian John,9999,0,9999,0
1657715357266,MATH 197,002,095566,Kedlaya; Kiran S.,9997,0,9999,2
1657715357266,MATH 197,003,095567,Xiao; Ming,9999,0,9999,0
1657715357266,MATH 197,004,095571,Perols; Johan Lars,9998,0,9999,1
1657715364343,COGS 9,A01,083615,Shannon; Kyle Michael,9,0,75,66
1657715370369,COGS 11,A01,083617,Boyle; Mary E. T.,23,0,48,25
1657715376398,COGS 13,A01,083071,Bastos; Amalia Pinkusfeld,11,0,71,60
1657715382424,COGS 14A,A01,092681,Semenuks; Arturs,5,1,100,95
1657715388449,COGS 14B,A01,083073,Cheng; Tzu-Han,6,0,63,57
1657715394478,COGS 17,A01,092677,Semenuks; Arturs,6,0,81,75
1657715400508,COGS 100,A01,083619,Allen; Michael Gordon,17,0,70,53
1657715406537,COGS 101A,A01,083621,Davis; Joshua Daniel,9,0,68,59
1657715412574,COGS 101B,A01,091572,Allen; Michael Gordon,12,0,65,53
1657715418605,COGS 101C,A01,083625,Delgado; Tania,17,0,35,18
1657715424633,COGS 107A,A01,083627,Boyle; Mary E. T.,13,0,60,47
1657715430658,COGS 118A,A01,083075,Gupta; Anjum,21,0,76,55
1657715436684,CSE 3,A50,083646,Miranda; Gregory Joseph,24,0,50,26
1657715442728,CSE 8A,A50,083650,Miranda; Gregory Joseph,17,1,56,39
1657715448753,CSE 11,A01,083080,Cao; Yingjun,6,15,40,34
1657715454782,CSE 12,A01,083652,Krause-Levy; Sophia Louisa,28,1,120,92
1657715460812,CSE 15L,A01,083654,Morris; Justin Loren,9,0,50,41
1657715460812,CSE 15L,A02,083655,Morris; Justin Loren,9,0,50,41
1657715466838,CSE 20,A01,083657,Tran; Khoa Dang,39,0,80,41
1657715472867,CSE 21,A01,095574,Bach; Quang Tran,22,0,48,26
1657715478901,CSE 30,A01,083084,Eldon; John,6,0,80,74
1657715478901,CSE 30,B01,095061,Bhaskar; Nishant,9,0,50,41
1657715484929,CSE 100,A01,083659,Cao; Yingjun,5,4,70,65
1657715490962,CSE 134B,A01,083661,Powell; Thomas Allan,23,0,100,77
1657715497002,CSE 140,A01,083663,Gungor; Onat,15,0,85,70
1657715503030,CSE 140L,A01,083088,Eldon; John,23,0,100,77
1657715509056,CSE 175,A01,083665,Kumar; Rakesh,3,0,25,22
1657715515084,CSE 190,A00,092507,Dubnov; Shlomo,8,0,20,12
1657715521113,ECE 45,A01,083139,Congero; Spencer William,6,0,75,69
1657715527139,ECE 65,A50,083695,Saad; Andrew S,12,0,30,18
1657715527139,ECE 65,A51,095125,Saad; Andrew S,24,0,26,2
1657715533167,ECE 109,A01,091882,Touri; Behrouz,20,0,70,50
1657715539200,ECE 180,A00,083140,Abi Samra; Nicholas Camill,1,0,30,29
1657715539200,ECE 180,B00,083141,Abi Samra; Nicholas Camill,0,0,30,30
1657715545236,MATH 10A,A01,083735,Patchell; Gregory David,2,0,30,28
1657715545236,MATH 10A,A02,083736,Patchell; Gregory David,20,0,30,10
1657715545236,MATH 10A,A03,083737,Patchell; Gregory David,16,0,30,14
1657715551269,MATH 10B,A01,083207,Lim; Seonhee,8,0,34,26
1657715551269,MATH 10B,A02,083208,Lim; Seonhee,9,0,35,26
1657715551269,MATH 10B,A03,093472,Lim; Seonhee,7,0,34,27
1657715551269,MATH 10B,B01,083739,Sinha; Shubham,13,0,30,17
1657715557300,MATH 18,A01,083743,Cinel; Cameron Alexander,8,0,30,22
1657715557300,MATH 18,A02,083744,Cinel; Cameron Alexander,17,0,30,13
1657715557300,MATH 18,A03,083745,Cinel; Cameron Alexander,10,0,30,20
1657715557300,MATH 18,B01,083748,Rideout; David Porter,5,0,37,32
1657715557300,MATH 18,B02,083749,Rideout; David Porter,5,0,36,31
1657715557300,MATH 18,B03,083750,Rideout; David Porter,3,0,37,34
1657715557300,MATH 18,B04,083751,Rideout; David Porter,6,0,36,30
1657715557300,MATH 18,B05,093473,Rideout; David Porter,6,0,36,30
1657715557300,MATH 18,B06,093474,Rideout; David Porter,6,0,36,30
1657715563332,MATH 20A,A01,083754,Zheng; Zequn,14,0,40,26
1657715569368,MATH 20B,A01,083756,Briones; Jor-el Thomas Caparas,4,0,36,32
1657715569368,MATH 20B,A02,083757,Briones; Jor-el Thomas Caparas,1,0,36,35
1657715569368,MATH 20B,A03,093475,Briones; Jor-el Thomas Caparas,2,0,36,34
1657715575405,MATH 20C,A01,083760,Briones; Jor-el Thomas Caparas,1,0,35,34
1657715575405,MATH 20C,A02,083761,Briones; Jor-el Thomas Caparas,8,0,35,27
1657715575405,MATH 20C,A03,093476,Briones; Jor-el Thomas Caparas,0,1,36,36
1657715575405,MATH 20C,B01,083762,Bach; Quang Tran,1,0,30,29
1657715581446,MATH 20D,A01,083765,Tran; Brian Kha,5,0,30,25
1657715581446,MATH 20D,A02,083766,Tran; Brian Kha,5,0,30,25
1657715581446,MATH 20D,A03,083767,Tran; Brian Kha,5,0,30,25
1657715587474,MATH 20E,A01,083771,Ganguly; Soumya,9,0,32,23
1657715587474,MATH 20E,A02,083772,Ganguly; Soumya,6,0,32,26
1657715587474,MATH 20E,B01,083773,Ciotti; Benjamin,20,0,35,15
1657715587474,MATH 20E,B02,083774,Ciotti; Benjamin,18,0,35,17
1657715593503,MATH 103A,A01,083777,Greenfeld; Be'Eri,3,0,36,33
1657715593503,MATH 103A,A02,083778,Greenfeld; Be'Eri,5,0,36,31
1657715593503,MATH 103A,A03,093561,Greenfeld; Be'Eri,6,0,36,30
1657715593503,MATH 103A,B01,083779,Greenfeld; Be'Eri,7,0,36,29
1657715593503,MATH 103A,B02,083780,Greenfeld; Be'Eri,4,0,36,32
1657715593503,MATH 103A,B03,093562,Greenfeld; Be'Eri,3,0,36,33
1657715599604,MATH 105,A01,085443,Carter; Anne Toulson,15,0,35,20
1657715599604,MATH 105,A02,093477,Carter; Anne Toulson,20,0,35,15
1657715605636,MATH 109,A01,083213,Ganzberger; Geoffrey Michael,2,0,34,32
1657715605636,MATH 109,A02,083214,Ganzberger; Geoffrey Michael,4,0,34,30
1657715605636,MATH 109,A03,093478,Ganzberger; Geoffrey Michael,2,0,34,32
1657715605636,MATH 109,B01,083215,Ganzberger; Geoffrey Michael,1,0,32,31
1657715605636,MATH 109,B02,083216,Ganzberger; Geoffrey Michael,2,0,32,30
1657715605636,MATH 109,B03,093479,Ganzberger; Geoffrey Michael,8,0,32,24
1657715611679,MATH 142A,A01,083219,Chow; Bennett,7,0,32,25
1657715611679,MATH 142A,A02,083220,Chow; Bennett,10,0,32,22
1657715611679,MATH 142A,A03,093480,Chow; Bennett,9,0,32,23
1657715611679,MATH 142A,B03,093481,Chow; Bennett,8,0,32,24
1657715611679,MATH 142A,B04,093558,Chow; Bennett,13,0,32,19
1657715611679,MATH 142A,B05,093559,Chow; Bennett,6,0,32,26
1657715617711,MATH 193A,A01,083224,Rotar; Vladimir,8,0,34,26
1657715617711,MATH 193A,A02,083225,Rotar; Vladimir,9,0,34,25
1657715617711,MATH 193A,A03,083781,Rotar; Vladimir,5,0,34,29
1657715617711,MATH 193A,A04,083782,Rotar; Vladimir,10,0,34,24
1657715617711,MATH 193A,A05,093482,Rotar; Vladimir,10,0,34,24
1657715623756,MATH 197,001,091859,McAuley; Julian John,9999,0,9999,0
1657715623756,MATH 197,002,095566,Kedlaya; Kiran S.,9997,0,9999,2
1657715623756,MATH 197,003,095567,Xiao; Ming,9999,0,9999,0
1657715623756,MATH 197,004,095571,Perols; Johan Lars,9998,0,9999,1
1657715630875,COGS 9,A01,083615,Shannon; Kyle Michael,9,0,75,66
1657715636909,COGS 11,A01,083617,Boyle; Mary E. T.,23,0,48,25
1657715642947,COGS 13,A01,083071,Bastos; Amalia Pinkusfeld,11,0,71,60
1657715648987,COGS 14A,A01,092681,Semenuks; Arturs,5,1,100,95
1657715655019,COGS 14B,A01,083073,Cheng; Tzu-Han,6,0,63,57
1657715661055,COGS 17,A01,092677,Semenuks; Arturs,6,0,81,75
1657715667080,COGS 100,A01,083619,Allen; Michael Gordon,17,0,70,53
1657715673107,COGS 101A,A01,083621,Davis; Joshua Daniel,9,0,68,59
1657715679132,COGS 101B,A01,091572,Allen; Michael Gordon,12,0,65,53
1657715685171,COGS 101C,A01,083625,Delgado; Tania,17,0,35,18
1657715691199,COGS 107A,A01,083627,Boyle; Mary E. T.,13,0,60,47
1657715697227,COGS 118A,A01,083075,Gupta; Anjum,21,0,76,55
1657715703260,CSE 3,A50,083646,Miranda; Gregory Joseph,24,0,50,26
1657715709289,CSE 8A,A50,083650,Miranda; Gregory Joseph,17,1,56,39
1657715715313,CSE 11,A01,083080,Cao; Yingjun,6,15,40,34
1657715721353,CSE 12,A01,083652,Krause-Levy; Sophia Louisa,28,1,120,92
1657715727379,CSE 15L,A01,083654,Morris; Justin Loren,9,0,50,41
1657715727379,CSE 15L,A02,083655,Morris; Justin Loren,9,0,50,41
1657715733409,CSE 20,A01,083657,Tran; Khoa Dang,39,0,80,41
1657715739438,CSE 21,A01,095574,Bach; Quang Tran,22,0,48,26
1657715745468,CSE 30,A01,083084,Eldon; John,6,0,80,74
1657715745468,CSE 30,B01,095061,Bhaskar; Nishant,9,0,50,41
1657715751502,CSE 100,A01,083659,Cao; Yingjun,5,4,70,65
1657715757528,CSE 134B,A01,083661,Powell; Thomas Allan,23,0,100,77
1657715763563,CSE 140,A01,083663,Gungor; Onat,15,0,85,70
1657715769590,CSE 140L,A01,083088,Eldon; John,23,0,100,77
1657715775618,CSE 175,A01,083665,Kumar; Rakesh,3,0,25,22
1657715781650,CSE 190,A00,092507,Dubnov; Shlomo,8,0,20,12
1657715787680,ECE 45,A01,083139,Congero; Spencer William,6,0,75,69
1657715793714,ECE 65,A50,083695,Saad; Andrew S,12,0,30,18
1657715793714,ECE 65,A51,095125,Saad; Andrew S,24,0,26,2
1657715799747,ECE 109,A01,091882,Touri; Behrouz,20,0,70,50
1657715805774,ECE 180,A00,083140,Abi Samra; Nicholas Camill,1,0,30,29
1657715805774,ECE 180,B00,083141,Abi Samra; Nicholas Camill,0,0,30,30
1657715811808,MATH 10A,A01,083735,Patchell; Gregory David,2,0,30,28
1657715811808,MATH 10A,A02,083736,Patchell; Gregory David,20,0,30,10
1657715811808,MATH 10A,A03,083737,Patchell; Gregory David,16,0,30,14
1657715817838,MATH 10B,A01,083207,Lim; Seonhee,8,0,34,26
1657715817838,MATH 10B,A02,083208,Lim; Seonhee,9,0,35,26
1657715817838,MATH 10B,A03,093472,Lim; Seonhee,7,0,34,27
1657715817838,MATH 10B,B01,083739,Sinha; Shubham,13,0,30,17
1657715823868,MATH 18,A01,083743,Cinel; Cameron Alexander,8,0,30,22
1657715823868,MATH 18,A02,083744,Cinel; Cameron Alexander,17,0,30,13
1657715823868,MATH 18,A03,083745,Cinel; Cameron Alexander,10,0,30,20
1657715823868,MATH 18,B01,083748,Rideout; David Porter,5,0,37,32
1657715823868,MATH 18,B02,083749,Rideout; David Porter,5,0,36,31
1657715823868,MATH 18,B03,083750,Rideout; David Porter,3,0,37,34
1657715823868,MATH 18,B04,083751,Rideout; David Porter,6,0,36,30
1657715823868,MATH 18,B05,093473,Rideout; David Porter,6,0,36,30
1657715823868,MATH 18,B06,093474,Rideout; David Porter,6,0,36,30
1657715829895,MATH 20A,A01,083754,Zheng; Zequn,14,0,40,26
1657715835928,MATH 20B,A01,083756,Briones; Jor-el Thomas Caparas,4,0,36,32
1657715835928,MATH 20B,A02,083757,Briones; Jor-el Thomas Caparas,1,0,36,35
1657715835928,MATH 20B,A03,093475,Briones; Jor-el Thomas Caparas,2,0,36,34
1657715841960,MATH 20C,A01,083760,Briones; Jor-el Thomas Caparas,1,0,35,34
1657715841960,MATH 20C,A02,083761,Briones; Jor-el Thomas Caparas,8,0,35,27
1657715841960,MATH 20C,A03,093476,Briones; Jor-el Thomas Caparas,0,1,36,36
1657715841960,MATH 20C,B01,083762,Bach; Quang Tran,1,0,30,29
1657715847988,MATH 20D,A01,083765,Tran; Brian Kha,5,0,30,25
1657715847988,MATH 20D,A02,083766,Tran; Brian Kha,5,0,30,25
1657715847988,MATH 20D,A03,083767,Tran; Brian Kha,5,0,30,25
1657715854017,MATH 20E,A01,083771,Ganguly; Soumya,9,0,32,23
1657715854017,MATH 20E,A02,083772,Ganguly; Soumya,6,0,32,26
1657715854017,MATH 20E,B01,083773,Ciotti; Benjamin,20,0,35,15
1657715854017,MATH 20E,B02,083774,Ciotti; Benjamin,18,0,35,17
1657715860053,MATH 103A,A01,083777,Greenfeld; Be'Eri,3,0,36,33
1657715860053,MATH 103A,A02,083778,Greenfeld; Be'Eri,5,0,36,31
1657715860053,MATH 103A,A03,093561,Greenfeld; Be'Eri,6,0,36,30
1657715860053,MATH 103A,B01,083779,Greenfeld; Be'Eri,7,0,36,29
1657715860053,MATH 103A,B02,083780,Greenfeld; Be'Eri,4,0,36,32
1657715860053,MATH 103A,B03,093562,Greenfeld; Be'Eri,3,0,36,33
1657715866081,MATH 105,A01,085443,Carter; Anne Toulson,15,0,35,20
1657715866081,MATH 105,A02,093477,Carter; Anne Toulson,20,0,35,15
1657715872115,MATH 109,A01,083213,Ganzberger; Geoffrey Michael,2,0,34,32
1657715872115,MATH 109,A02,083214,Ganzberger; Geoffrey Michael,4,0,34,30
1657715872115,MATH 109,A03,093478,Ganzberger; Geoffrey Michael,2,0,34,32
1657715872115,MATH 109,B01,083215,Ganzberger; Geoffrey Michael,1,0,32,31
1657715872115,MATH 109,B02,083216,Ganzberger; Geoffrey Michael,2,0,32,30
1657715872115,MATH 109,B03,093479,Ganzberger; Geoffrey Michael,8,0,32,24
1657715878143,MATH 142A,A01,083219,Chow; Bennett,7,0,32,25
1657715878143,MATH 142A,A02,083220,Chow; Bennett,10,0,32,22
1657715878143,MATH 142A,A03,093480,Chow; Bennett,9,0,32,23
1657715878143,MATH 142A,B03,093481,Chow; Bennett,8,0,32,24
1657715878143,MATH 142A,B04,093558,Chow; Bennett,13,0,32,19
1657715878143,MATH 142A,B05,093559,Chow; Bennett,6,0,32,26
1657715884174,MATH 193A,A01,083224,Rotar; Vladimir,8,0,34,26
1657715884174,MATH 193A,A02,083225,Rotar; Vladimir,9,0,34,25
1657715884174,MATH 193A,A03,083781,Rotar; Vladimir,5,0,34,29
1657715884174,MATH 193A,A04,083782,Rotar; Vladimir,10,0,34,24
1657715884174,MATH 193A,A05,093482,Rotar; Vladimir,10,0,34,24
1657715890203,MATH 197,001,091859,McAuley; Julian John,9999,0,9999,0
1657715890203,MATH 197,002,095566,Kedlaya; Kiran S.,9997,0,9999,2
1657715890203,MATH 197,003,095567,Xiao; Ming,9999,0,9999,0
1657715890203,MATH 197,004,095571,Perols; Johan Lars,9998,0,9999,1
1657715897306,COGS 9,A01,083615,Shannon; Kyle Michael,9,0,75,66
1657715903338,COGS 11,A01,083617,Boyle; Mary E. T.,23,0,48,25
1657715909365,COGS 13,A01,083071,Bastos; Amalia Pinkusfeld,11,0,71,60
1657715915390,COGS 14A,A01,092681,Semenuks; Arturs,5,1,100,95
1657715921418,COGS 14B,A01,083073,Cheng; Tzu-Han,6,0,63,57
1657715927444,COGS 17,A01,092677,Semenuks; Arturs,6,0,81,75
1657715933476,COGS 100,A01,083619,Allen; Michael Gordon,17,0,70,53
1657715939506,COGS 101A,A01,083621,Davis; Joshua Daniel,9,0,68,59
1657715945538,COGS 101B,A01,091572,Allen; Michael Gordon,12,0,65,53
1657715951572,COGS 101C,A01,083625,Delgado; Tania,17,0,35,18
1657715957599,COGS 107A,A01,083627,Boyle; Mary E. T.,13,0,60,47
1657715963624,COGS 118A,A01,083075,Gupta; Anjum,21,0,76,55
1657715969652,CSE 3,A50,083646,Miranda; Gregory Joseph,24,0,50,26
1657715975678,CSE 8A,A50,083650,Miranda; Gregory Joseph,17,1,56,39
1657715981706,CSE 11,A01,083080,Cao; Yingjun,6,15,40,34
1657715987734,CSE 12,A01,083652,Krause-Levy; Sophia Louisa,28,1,120,92
1657715993765,CSE 15L,A01,083654,Morris; Justin Loren,9,0,50,41
1657715993765,CSE 15L,A02,083655,Morris; Justin Loren,9,0,50,41
1657715999793,CSE 20,A01,083657,Tran; Khoa Dang,39,0,80,41
1657716005818,CSE 21,A01,095574,Bach; Quang Tran,22,0,48,26
1657716011844,CSE 30,A01,083084,Eldon; John,6,0,80,74
1657716011844,CSE 30,B01,095061,Bhaskar; Nishant,9,0,50,41
1657716017868,CSE 100,A01,083659,Cao; Yingjun,5,4,70,65
1657716023896,CSE 134B,A01,083661,Powell; Thomas Allan,23,0,100,77
1657716029927,CSE 140,A01,083663,Gungor; Onat,15,0,85,70
1657716035952,CSE 140L,A01,083088,Eldon; John,23,0,100,77
1657716041977,CSE 175,A01,083665,Kumar; Rakesh,3,0,25,22
1657716048006,CSE 190,A00,092507,Dubnov; Shlomo,8,0,20,12
1657716054038,ECE 45,A01,083139,Congero; Spencer William,6,0,75,69
1657716060069,ECE 65,A50,083695,Saad; Andrew S,12,0,30,18
1657716060069,ECE 65,A51,095125,Saad; Andrew S,24,0,26,2
1657716066100,ECE 109,A01,091882,Touri; Behrouz,20,0,70,50
1657716072126,ECE 180,A00,083140,Abi Samra; Nicholas Camill,1,0,30,29
1657716072126,ECE 180,B00,083141,Abi Samra; Nicholas Camill,0,0,30,30
1657716078151,MATH 10A,A01,083735,Patchell; Gregory David,2,0,30,28
1657716078151,MATH 10A,A02,083736,Patchell; Gregory David,20,0,30,10
1657716078151,MATH 10A,A03,083737,Patchell; Gregory David,16,0,30,14
1657716084181,MATH 10B,A01,083207,Lim; Seonhee,8,0,34,26
1657716084181,MATH 10B,A02,083208,Lim; Seonhee,9,0,35,26
1657716084181,MATH 10B,A03,093472,Lim; Seonhee,7,0,34,27
1657716084181,MATH 10B,B01,083739,Sinha; Shubham,13,0,30,17
1657716090211,MATH 18,A01,083743,Cinel; Cameron Alexander,8,0,30,22
1657716090211,MATH 18,A02,083744,Cinel; Cameron Alexander,17,0,30,13
1657716090211,MATH 18,A03,083745,Cinel; Cameron Alexander,10,0,30,20
1657716090211,MATH 18,B01,083748,Rideout; David Porter,5,0,37,32
1657716090211,MATH 18,B02,083749,Rideout; David Porter,5,0,36,31
1657716090211,MATH 18,B03,083750,Rideout; David Porter,3,0,37,34
1657716090211,MATH 18,B04,083751,Rideout; David Porter,6,0,36,30
1657716090211,MATH 18,B05,093473,Rideout; David Porter,6,0,36,30
1657716090211,MATH 18,B06,093474,Rideout; David Porter,6,0,36,30
1657716096242,MATH 20A,A01,083754,Zheng; Zequn,14,0,40,26
1657716102271,MATH 20B,A01,083756,Briones; Jor-el Thomas Caparas,4,0,36,32
1657716102271,MATH 20B,A02,083757,Briones; Jor-el Thomas Caparas,1,0,36,35
1657716102271,MATH 20B,A03,093475,Briones; Jor-el Thomas Caparas,2,0,36,34
1657716108296,MATH 20C,A01,083760,Briones; Jor-el Thomas Caparas,1,0,35,34
1657716108296,MATH 20C,A02,083761,Briones; Jor-el Thomas Caparas,8,0,35,27
1657716108296,MATH 20C,A03,093476,Briones; Jor-el Thomas Caparas,0,1,36,36
1657716108296,MATH 20C,B01,083762,Bach; Quang Tran,1,0,30,29
1657716114327,MATH 20D,A01,083765,Tran; Brian Kha,5,0,30,25
1657716114327,MATH 20D,A02,083766,Tran; Brian Kha,5,0,30,25
1657716114327,MATH 20D,A03,083767,Tran; Brian Kha,5,0,30,25
1657716120361,MATH 20E,A01,083771,Ganguly; Soumya,9,0,32,23
1657716120361,MATH 20E,A02,083772,Ganguly; Soumya,6,0,32,26
1657716120361,MATH 20E,B01,083773,Ciotti; Benjamin,20,0,35,15
1657716120361,MATH 20E,B02,083774,Ciotti; Benjamin,18,0,35,17
1657716126398,MATH 103A,A01,083777,Greenfeld; Be'Eri,3,0,36,33
1657716126398,MATH 103A,A02,083778,Greenfeld; Be'Eri,5,0,36,31
1657716126398,MATH 103A,A03,093561,Greenfeld; Be'Eri,6,0,36,30
1657716126398,MATH 103A,B01,083779,Greenfeld; Be'Eri,7,0,36,29
1657716126398,MATH 103A,B02,083780,Greenfeld; Be'Eri,4,0,36,32
1657716126398,MATH 103A,B03,093562,Greenfeld; Be'Eri,3,0,36,33
1657716132425,MATH 105,A01,085443,Carter; Anne Toulson,15,0,35,20
1657716132425,MATH 105,A02,093477,Carter; Anne Toulson,20,0,35,15
1657716138459,MATH 109,A01,083213,Ganzberger; Geoffrey Michael,2,0,34,32
1657716138459,MATH 109,A02,083214,Ganzberger; Geoffrey Michael,4,0,34,30
1657716138459,MATH 109,A03,093478,Ganzberger; Geoffrey Michael,2,0,34,32
1657716138459,MATH 109,B01,083215,Ganzberger; Geoffrey Michael,1,0,32,31
1657716138459,MATH 109,B02,083216,Ganzberger; Geoffrey Michael,2,0,32,30
1657716138459,MATH 109,B03,093479,Ganzberger; Geoffrey Michael,8,0,32,24
1657716144492,MATH 142A,A01,083219,Chow; Bennett,7,0,32,25
1657716144492,MATH 142A,A02,083220,Chow; Bennett,10,0,32,22
1657716144492,MATH 142A,A03,093480,Chow; Bennett,9,0,32,23
1657716144492,MATH 142A,B03,093481,Chow; Bennett,8,0,32,24
1657716144492,MATH 142A,B04,093558,Chow; Bennett,13,0,32,19
1657716144492,MATH 142A,B05,093559,Chow; Bennett,6,0,32,26
1657716150520,MATH 193A,A01,083224,Rotar; Vladimir,8,0,34,26
1657716150520,MATH 193A,A02,083225,Rotar; Vladimir,9,0,34,25
1657716150520,MATH 193A,A03,083781,Rotar; Vladimir,5,0,34,29
1657716150520,MATH 193A,A04,083782,Rotar; Vladimir,10,0,34,24
1657716150520,MATH 193A,A05,093482,Rotar; Vladimir,10,0,34,24
1657716156553,MATH 197,001,091859,McAuley; Julian John,9999,0,9999,0
1657716156553,MATH 197,002,095566,Kedlaya; Kiran S.,9997,0,9999,2
1657716156553,MATH 197,003,095567,Xiao; Ming,9999,0,9999,0
1657716156553,MATH 197,004,095571,Perols; Johan Lars,9998,0,9999,1
1657716163634,COGS 9,A01,083615,Shannon; Kyle Michael,9,0,75,66
1657716169660,COGS 11,A01,083617,Boyle; Mary E. T.,23,0,48,25
1657716175684,COGS 13,A01,083071,Bastos; Amalia Pinkusfeld,11,0,71,60
1657716181717,COGS 14A,A01,092681,Semenuks; Arturs,5,1,100,95
1657716187742,COGS 14B,A01,083073,Cheng; Tzu-Han,6,0,63,57
1657716193838,COGS 17,A01,092677,Semenuks; Arturs,6,0,81,75
1657716199864,COGS 100,A01,083619,Allen; Michael Gordon,17,0,70,53
1657716205890,COGS 101A,A01,083621,Davis; Joshua Daniel,9,0,68,59
1657716211922,COGS 101B,A01,091572,Allen; Michael Gordon,12,0,65,53
1657716217948,COGS 101C,A01,083625,Delgado; Tania,17,0,35,18
1657716223976,COGS 107A,A01,083627,Boyle; Mary E. T.,13,0,60,47
1657716230007,COGS 118A,A01,083075,Gupta; Anjum,21,0,76,55
1657716236032,CSE 3,A50,083646,Miranda; Gregory Joseph,24,0,50,26
1657716242065,CSE 8A,A50,083650,Miranda; Gregory Joseph,17,1,56,39
1657716248090,CSE 11,A01,083080,Cao; Yingjun,6,15,40,34
1657716254117,CSE 12,A01,083652,Krause-Levy; Sophia Louisa,28,1,120,92
1657716260142,CSE 15L,A01,083654,Morris; Justin Loren,9,0,50,41
1657716260142,CSE 15L,A02,083655,Morris; Justin Loren,9,0,50,41
1657716266175,CSE 20,A01,083657,Tran; Khoa Dang,39,0,80,41
1657716272214,CSE 21,A01,095574,Bach; Quang Tran,22,0,48,26
1657716278251,CSE 30,A01,083084,Eldon; John,6,0,80,74
1657716278251,CSE 30,B01,095061,Bhaskar; Nishant,9,0,50,41
1657716284286,CSE 100,A01,083659,Cao; Yingjun,5,4,70,65
1657716290312,CSE 134B,A01,083661,Powell; Thomas Allan,23,0,100,77
1657716296338,CSE 140,A01,083663,Gungor; Onat,15,0,85,70
1657716302372,CSE 140L,A01,083088,Eldon; John,23,0,100,77
1657716308399,CSE 175,A01,083665,Kumar; Rakesh,3,0,25,22
1657716314428,CSE 190,A00,092507,Dubnov; Shlomo,8,0,20,12
1657716320457,ECE 45,A01,083139,Congero; Spencer William,6,0,75,69
1657716326483,ECE 65,A50,083695,Saad; Andrew S,12,0,30,18
1657716326483,ECE 65,A51,095125,Saad; Andrew S,24,0,26,2
1657716332510,ECE 109,A01,091882,Touri; Behrouz,20,0,70,50
1657716338542,ECE 180,A00,083140,Abi Samra; Nicholas Camill,1,0,30,29
1657716338542,ECE 180,B00,083141,Abi Samra; Nicholas Camill,0,0,30,30
1657716344569,MATH 10A,A01,083735,Patchell; Gregory David,2,0,30,28
1657716344569,MATH 10A,A02,083736,Patchell; Gregory David,20,0,30,10
1657716344569,MATH 10A,A03,083737,Patchell; Gregory David,16,0,30,14
1657716350596,MATH 10B,A01,083207,Lim; Seonhee,8,0,34,26
1657716350596,MATH 10B,A02,083208,Lim; Seonhee,9,0,35,26
1657716350596,MATH 10B,A03,093472,Lim; Seonhee,7,0,34,27
1657716350596,MATH 10B,B01,083739,Sinha; Shubham,13,0,30,17
1657716356624,MATH 18,A01,083743,Cinel; Cameron Alexander,8,0,30,22
1657716356624,MATH 18,A02,083744,Cinel; Cameron Alexander,17,0,30,13
1657716356624,MATH 18,A03,083745,Cinel; Cameron Alexander,10,0,30,20
1657716356624,MATH 18,B01,083748,Rideout; David Porter,5,0,37,32
1657716356624,MATH 18,B02,083749,Rideout; David Porter,5,0,36,31
1657716356624,MATH 18,B03,083750,Rideout; David Porter,3,0,37,34
1657716356624,MATH 18,B04,083751,Rideout; David Porter,6,0,36,30
1657716356624,MATH 18,B05,093473,Rideout; David Porter,6,0,36,30
1657716356624,MATH 18,B06,093474,Rideout; David Porter,6,0,36,30
1657716362653,MATH 20A,A01,083754,Zheng; Zequn,14,0,40,26
1657716368684,MATH 20B,A01,083756,Briones; Jor-el Thomas Caparas,4,0,36,32
1657716368684,MATH 20B,A02,083757,Briones; Jor-el Thomas Caparas,1,0,36,35
1657716368684,MATH 20B,A03,093475,Briones; Jor-el Thomas Caparas,2,0,36,34
1657716374710,MATH 20C,A01,083760,Briones; Jor-el Thomas Caparas,1,0,35,34
1657716374710,MATH 20C,A02,083761,Briones; Jor-el Thomas Caparas,8,0,35,27
1657716374710,MATH 20C,A03,093476,Briones; Jor-el Thomas Caparas,0,1,36,36
1657716374710,MATH 20C,B01,083762,Bach; Quang Tran,1,0,30,29
1657716380742,MATH 20D,A01,083765,Tran; Brian Kha,5,0,30,25
1657716380742,MATH 20D,A02,083766,Tran; Brian Kha,5,0,30,25
1657716380742,MATH 20D,A03,083767,Tran; Brian Kha,5,0,30,25
1657716386768,MATH 20E,A01,083771,Ganguly; Soumya,9,0,32,23
1657716386768,MATH 20E,A02,083772,Ganguly; Soumya,6,0,32,26
1657716386768,MATH 20E,B01,083773,Ciotti; Benjamin,20,0,35,15
1657716386768,MATH 20E,B02,083774,Ciotti; Benjamin,18,0,35,17
1657716392792,MATH 103A,A01,083777,Greenfeld; Be'Eri,3,0,36,33
1657716392792,MATH 103A,A02,083778,Greenfeld; Be'Eri,5,0,36,31
1657716392792,MATH 103A,A03,093561,Greenfeld; Be'Eri,6,0,36,30
1657716392792,MATH 103A,B01,083779,Greenfeld; Be'Eri,7,0,36,29
1657716392792,MATH 103A,B02,083780,Greenfeld; Be'Eri,4,0,36,32
1657716392792,MATH 103A,B03,093562,Greenfeld; Be'Eri,3,0,36,33
1657716398822,MATH 105,A01,085443,Carter; Anne Toulson,15,0,35,20
1657716398822,MATH 105,A02,093477,Carter; Anne Toulson,20,0,35,15
1657716404853,MATH 109,A01,083213,Ganzberger; Geoffrey Michael,2,0,34,32
1657716404853,MATH 109,A02,083214,Ganzberger; Geoffrey Michael,4,0,34,30
1657716404853,MATH 109,A03,093478,Ganzberger; Geoffrey Michael,2,0,34,32
1657716404853,MATH 109,B01,083215,Ganzberger; Geoffrey Michael,1,0,32,31
1657716404853,MATH 109,B02,083216,Ganzberger; Geoffrey Michael,2,0,32,30
1657716404853,MATH 109,B03,093479,Ganzberger; Geoffrey Michael,8,0,32,24
1657716410881,MATH 142A,A01,083219,Chow; Bennett,7,0,32,25
1657716410881,MATH 142A,A02,083220,Chow; Bennett,10,0,32,22
1657716410881,MATH 142A,A03,093480,Chow; Bennett,9,0,32,23
1657716410881,MATH 142A,B03,093481,Chow; Bennett,8,0,32,24
1657716410881,MATH 142A,B04,093558,Chow; Bennett,13,0,32,19
1657716410881,MATH 142A,B05,093559,Chow; Bennett,6,0,32,26
1657716416909,MATH 193A,A01,083224,Rotar; Vladimir,8,0,34,26
1657716416909,MATH 193A,A02,083225,Rotar; Vladimir,9,0,34,25
1657716416909,MATH 193A,A03,083781,Rotar; Vladimir,5,0,34,29
1657716416909,MATH 193A,A04,083782,Rotar; Vladimir,10,0,34,24
1657716416909,MATH 193A,A05,093482,Rotar; Vladimir,10,0,34,24
1657716422936,MATH 197,001,091859,McAuley; Julian John,9999,0,9999,0
1657716422936,MATH 197,002,095566,Kedlaya; Kiran S.,9997,0,9999,2
1657716422936,MATH 197,003,095567,Xiao; Ming,9999,0,9999,0
1657716422936,MATH 197,004,095571,Perols; Johan Lars,9998,0,9999,1
1657716430006,COGS 9,A01,083615,Shannon; Kyle Michael,9,0,75,66
1657716436035,COGS 11,A01,083617,Boyle; Mary E. T.,23,0,48,25
1657716442066,COGS 13,A01,083071,Bastos; Amalia Pinkusfeld,11,0,71,60
1657716448093,COGS 14A,A01,092681,Semenuks; Arturs,5,1,100,95
1657716454123,COGS 14B,A01,083073,Cheng; Tzu-Han,6,0,63,57
1657716460148,COGS 17,A01,092677,Semenuks; Arturs,6,0,81,75
1657716466179,COGS 100,A01,083619,Allen; Michael Gordon,17,0,70,53
1657716472219,COGS 101A,A01,083621,Davis; Joshua Daniel,9,0,68,59
1657716478251,COGS 101B,A01,091572,Allen; Michael Gordon,12,0,65,53
1657716484282,COGS 101C,A01,083625,Delgado; Tania,17,0,35,18
1657716490309,COGS 107A,A01,083627,Boyle; Mary E. T.,13,0,60,47
1657716496339,COGS 118A,A01,083075,Gupta; Anjum,21,0,76,55
1657716502375,CSE 3,A50,083646,Miranda; Gregory Joseph,24,0,50,26
1657716508406,CSE 8A,A50,083650,Miranda; Gregory Joseph,17,1,56,39
1657716514432,CSE 11,A01,083080,Cao; Yingjun,6,15,40,34
1657716520459,CSE 12,A01,083652,Krause-Levy; Sophia Louisa,28,1,120,92
1657716526495,CSE 15L,A01,083654,Morris; Justin Loren,9,0,50,41
1657716526495,CSE 15L,A02,083655,Morris; Justin Loren,9,0,50,41
1657716532520,CSE 20,A01,083657,Tran; Khoa Dang,39,0,80,41
1657716538553,CSE 21,A01,095574,Bach; Quang Tran,22,0,48,26
1657716544586,CSE 30,A01,083084,Eldon; John,6,0,80,74
1657716544586,CSE 30,B01,095061,Bhaskar; Nishant,9,0,50,41
1657716550610,CSE 100,A01,083659,Cao; Yingjun,5,4,70,65
1657716556637,CSE 134B,A01,083661,Powell; Thomas Allan,23,0,100,77
1657716562667,CSE 140,A01,083663,Gungor; Onat,15,0,85,70
1657716568693,CSE 140L,A01,083088,Eldon; John,23,0,100,77
1657716574723,CSE 175,A01,083665,Kumar; Rakesh,3,0,25,22
1657716580747,CSE 190,A00,092507,Dubnov; Shlomo,8,0,20,12
1657716586773,ECE 45,A01,083139,Congero; Spencer William,6,0,75,69
1657716592805,ECE 65,A50,083695,Saad; Andrew S,12,0,30,18
1657716592805,ECE 65,A51,095125,Saad; Andrew S,24,0,26,2
1657716598837,ECE 109,A01,091882,Touri; Behrouz,20,0,70,50
1657716604865,ECE 180,A00,083140,Abi Samra; Nicholas Camill,1,0,30,29
1657716604865,ECE 180,B00,083141,Abi Samra; Nicholas Camill,0,0,30,30
1657716610895,MATH 10A,A01,083735,Patchell; Gregory David,2,0,30,28
1657716610895,MATH 10A,A02,083736,Patchell; Gregory David,20,0,30,10
1657716610895,MATH 10A,A03,083737,Patchell; Gregory David,16,0,30,14
1657716616922,MATH 10B,A01,083207,Lim; Seonhee,8,0,34,26
1657716616922,MATH 10B,A02,083208,Lim; Seonhee,9,0,35,26
1657716616922,MATH 10B,A03,093472,Lim; Seonhee,7,0,34,27
1657716616922,MATH 10B,B01,083739,Sinha; Shubham,13,0,30,17
1657716622952,MATH 18,A01,083743,Cinel; Cameron Alexander,8,0,30,22
1657716622952,MATH 18,A02,083744,Cinel; Cameron Alexander,17,0,30,13
1657716622952,MATH 18,A03,083745,Cinel; Cameron Alexander,10,0,30,20
1657716622952,MATH 18,B01,083748,Rideout; David Porter,5,0,37,32
1657716622952,MATH 18,B02,083749,Rideout; David Porter,5,0,36,31
1657716622952,MATH 18,B03,083750,Rideout; David Porter,3,0,37,34
1657716622952,MATH 18,B04,083751,Rideout; David Porter,6,0,36,30
1657716622952,MATH 18,B05,093473,Rideout; David Porter,6,0,36,30
1657716622952,MATH 18,B06,093474,Rideout; David Porter,6,0,36,30
1657716628978,MATH 20A,A01,083754,Zheng; Zequn,14,0,40,26
1657716635003,MATH 20B,A01,083756,Briones; Jor-el Thomas Caparas,4,0,36,32
1657716635003,MATH 20B,A02,083757,Briones; Jor-el Thomas Caparas,1,0,36,35
1657716635003,MATH 20B,A03,093475,Briones; Jor-el Thomas Caparas,2,0,36,34
1657716641031,MATH 20C,A01,083760,Briones; Jor-el Thomas Caparas,1,0,35,34
1657716641031,MATH 20C,A02,083761,Briones; Jor-el Thomas Caparas,8,0,35,27
1657716641031,MATH 20C,A03,093476,Briones; Jor-el Thomas Caparas,0,1,36,36
1657716641031,MATH 20C,B01,083762,Bach; Quang Tran,1,0,30,29
1657716647069,MATH 20D,A01,083765,Tran; Brian Kha,5,0,30,25
1657716647069,MATH 20D,A02,083766,Tran; Brian Kha,5,0,30,25
1657716647069,MATH 20D,A03,083767,Tran; Brian Kha,5,0,30,25
1657716653104,MATH 20E,A01,083771,Ganguly; Soumya,9,0,32,23
1657716653104,MATH 20E,A02,083772,Ganguly; Soumya,6,0,32,26
1657716653104,MATH 20E,B01,083773,Ciotti; Benjamin,20,0,35,15
1657716653104,MATH 20E,B02,083774,Ciotti; Benjamin,18,0,35,17
1657716659148,MATH 103A,A01,083777,Greenfeld; Be'Eri,3,0,36,33
1657716659148,MATH 103A,A02,083778,Greenfeld; Be'Eri,5,0,36,31
1657716659148,MATH 103A,A03,093561,Greenfeld; Be'Eri,6,0,36,30
1657716659148,MATH 103A,B01,083779,Greenfeld; Be'Eri,7,0,36,29
1657716659148,MATH 103A,B02,083780,Greenfeld; Be'Eri,4,0,36,32
1657716659148,MATH 103A,B03,093562,Greenfeld; Be'Eri,3,0,36,33
1657716665180,MATH 105,A01,085443,Carter; Anne Toulson,15,0,35,20
1657716665180,MATH 105,A02,093477,Carter; Anne Toulson,20,0,35,15
1657716671205,MATH 109,A01,083213,Ganzberger; Geoffrey Michael,2,0,34,32
1657716671205,MATH 109,A02,083214,Ganzberger; Geoffrey Michael,4,0,34,30
1657716671205,MATH 109,A03,093478,Ganzberger; Geoffrey Michael,2,0,34,32
1657716671205,MATH 109,B01,083215,Ganzberger; Geoffrey Michael,1,0,32,31
1657716671205,MATH 109,B02,083216,Ganzberger; Geoffrey Michael,2,0,32,30
1657716671205,MATH 109,B03,093479,Ganzberger; Geoffrey Michael,8,0,32,24
1657716677231,MATH 142A,A01,083219,Chow; Bennett,7,0,32,25
1657716677231,MATH 142A,A02,083220,Chow; Bennett,10,0,32,22
1657716677231,MATH 142A,A03,093480,Chow; Bennett,9,0,32,23
1657716677231,MATH 142A,B03,093481,Chow; Bennett,8,0,32,24
1657716677231,MATH 142A,B04,093558,Chow; Bennett,13,0,32,19
1657716677231,MATH 142A,B05,093559,Chow; Bennett,6,0,32,26
1657716683263,MATH 193A,A01,083224,Rotar; Vladimir,8,0,34,26
1657716683263,MATH 193A,A02,083225,Rotar; Vladimir,9,0,34,25
1657716683263,MATH 193A,A03,083781,Rotar; Vladimir,5,0,34,29
1657716683263,MATH 193A,A04,083782,Rotar; Vladimir,10,0,34,24
1657716683263,MATH 193A,A05,093482,Rotar; Vladimir,10,0,34,24
1657716689295,MATH 197,001,091859,McAuley; Julian John,9999,0,9999,0
1657716689295,MATH 197,002,095566,Kedlaya; Kiran S.,9997,0,9999,2
1657716689295,MATH 197,003,095567,Xiao; Ming,9999,0,9999,0
1657716689295,MATH 197,004,095571,Perols; Johan Lars,9998,0,9999,1
1657716696376,COGS 9,A01,083615,Shannon; Kyle Michael,9,0,75,66
1657716702402,COGS 11,A01,083617,Boyle; Mary E. T.,23,0,48,25
1657716708436,COGS 13,A01,083071,Bastos; Amalia Pinkusfeld,11,0,71,60
1657716714463,COGS 14A,A01,092681,Semenuks; Arturs,5,1,100,95
1657716720500,COGS 14B,A01,083073,Cheng; Tzu-Han,6,0,63,57
1657716726528,COGS 17,A01,092677,Semenuks; Arturs,6,0,81,75
1657716732560,COGS 100,A01,083619,Allen; Michael Gordon,17,0,70,53
1657716738589,COGS 101A,A01,083621,Davis; Joshua Daniel,9,0,68,59
1657716744627,COGS 101B,A01,091572,Allen; Michael Gordon,12,0,65,53
1657716750658,COGS 101C,A01,083625,Delgado; Tania,17,0,35,18
1657716756683,COGS 107A,A01,083627,Boyle; Mary E. T.,13,0,60,47
1657716762709,COGS 118A,A01,083075,Gupta; Anjum,21,0,76,55
1657716768738,CSE 3,A50,083646,Miranda; Gregory Joseph,24,0,50,26
1657716774770,CSE 8A,A50,083650,Miranda; Gregory Joseph,17,1,56,39
1657716780801,CSE 11,A01,083080,Cao; Yingjun,6,15,40,34
1657716786828,CSE 12,A01,083652,Krause-Levy; Sophia Louisa,28,1,120,92
1657716792941,CSE 15L,A01,083654,Morris; Justin Loren,9,0,50,41
1657716792941,CSE 15L,A02,083655,Morris; Justin Loren,9,0,50,41
1657716798966,CSE 20,A01,083657,Tran; Khoa Dang,39,0,80,41
1657716805004,CSE 21,A01,095574,Bach; Quang Tran,22,0,48,26
1657716811052,CSE 30,A01,083084,Eldon; John,6,0,80,74
1657716811052,CSE 30,B01,095061,Bhaskar; Nishant,9,0,50,41
1657716817078,CSE 100,A01,083659,Cao; Yingjun,5,4,70,65
1657716823110,CSE 134B,A01,083661,Powell; Thomas Allan,23,0,100,77
1657716829142,CSE 140,A01,083663,Gungor; Onat,15,0,85,70
1657716835168,CSE 140L,A01,083088,Eldon; John,23,0,100,77
1657716841194,CSE 175,A01,083665,Kumar; Rakesh,3,0,25,22
1657716847218,CSE 190,A00,092507,Dubnov; Shlomo,8,0,20,12
1657716853248,ECE 45,A01,083139,Congero; Spencer William,6,0,75,69
1657716859284,ECE 65,A50,083695,Saad; Andrew S,12,0,30,18
1657716859284,ECE 65,A51,095125,Saad; Andrew S,24,0,26,2
1657716865311,ECE 109,A01,091882,Touri; Behrouz,20,0,70,50
1657716871336,ECE 180,A00,083140,Abi Samra; Nicholas Camill,1,0,30,29
1657716871336,ECE 180,B00,083141,Abi Samra; Nicholas Camill,0,0,30,30
1657716877364,MATH 10A,A01,083735,Patchell; Gregory David,2,0,30,28
1657716877364,MATH 10A,A02,083736,Patchell; Gregory David,20,0,30,10
1657716877364,MATH 10A,A03,083737,Patchell; Gregory David,16,0,30,14
1657716883395,MATH 10B,A01,083207,Lim; Seonhee,8,0,34,26
1657716883395,MATH 10B,A02,083208,Lim; Seonhee,9,0,35,26
1657716883395,MATH 10B,A03,093472,Lim; Seonhee,7,0,34,27
1657716883395,MATH 10B,B01,083739,Sinha; Shubham,13,0,30,17
1657716889425,MATH 18,A01,083743,Cinel; Cameron Alexander,8,0,30,22
1657716889425,MATH 18,A02,083744,Cinel; Cameron Alexander,17,0,30,13
1657716889425,MATH 18,A03,083745,Cinel; Cameron Alexander,10,0,30,20
1657716889425,MATH 18,B01,083748,Rideout; David Porter,5,0,37,32
1657716889425,MATH 18,B02,083749,Rideout; David Porter,5,0,36,31
1657716889425,MATH 18,B03,083750,Rideout; David Porter,3,0,37,34
1657716889425,MATH 18,B04,083751,Rideout; David Porter,6,0,36,30
1657716889425,MATH 18,B05,093473,Rideout; David Porter,6,0,36,30
1657716889425,MATH 18,B06,093474,Rideout; David Porter,6,0,36,30
1657716895452,MATH 20A,A01,083754,Zheng; Zequn,14,0,40,26
1657716901487,MATH 20B,A01,083756,Briones; Jor-el Thomas Caparas,4,0,36,32
1657716901487,MATH 20B,A02,083757,Briones; Jor-el Thomas Caparas,1,0,36,35
1657716901487,MATH 20B,A03,093475,Briones; Jor-el Thomas Caparas,2,0,36,34
1657716907513,MATH 20C,A01,083760,Briones; Jor-el Thomas Caparas,1,0,35,34
1657716907513,MATH 20C,A02,083761,Briones; Jor-el Thomas Caparas,8,0,35,27
1657716907513,MATH 20C,A03,093476,Briones; Jor-el Thomas Caparas,0,1,36,36
1657716907513,MATH 20C,B01,083762,Bach; Quang Tran,1,0,30,29
1657716913541,MATH 20D,A01,083765,Tran; Brian Kha,5,0,30,25
1657716913541,MATH 20D,A02,083766,Tran; Brian Kha,5,0,30,25
1657716913541,MATH 20D,A03,083767,Tran; Brian Kha,5,0,30,25
1657716919568,MATH 20E,A01,083771,Ganguly; Soumya,9,0,32,23
1657716919568,MATH 20E,A02,083772,Ganguly; Soumya,6,0,32,26
1657716919568,MATH 20E,B01,083773,Ciotti; Benjamin,20,0,35,15
1657716919568,MATH 20E,B02,083774,Ciotti; Benjamin,18,0,35,17
1657716925596,MATH 103A,A01,083777,Greenfeld; Be'Eri,3,0,36,33
1657716925596,MATH 103A,A02,083778,Greenfeld; Be'Eri,5,0,36,31
1657716925596,MATH 103A,A03,093561,Greenfeld; Be'Eri,6,0,36,30
1657716925596,MATH 103A,B01,083779,Greenfeld; Be'Eri,7,0,36,29
1657716925596,MATH 103A,B02,083780,Greenfeld; Be'Eri,4,0,36,32
1657716925596,MATH 103A,B03,093562,Greenfeld; Be'Eri,3,0,36,33
1657716931623,MATH 105,A01,085443,Carter; Anne Toulson,15,0,35,20
1657716931623,MATH 105,A02,093477,Carter; Anne Toulson,20,0,35,15
1657716937655,MATH 109,A01,083213,Ganzberger; Geoffrey Michael,2,0,34,32
1657716937655,MATH 109,A02,083214,Ganzberger; Geoffrey Michael,4,0,34,30
1657716937655,MATH 109,A03,093478,Ganzberger; Geoffrey Michael,2,0,34,32
1657716937655,MATH 109,B01,083215,Ganzberger; Geoffrey Michael,1,0,32,31
1657716937655,MATH 109,B02,083216,Ganzberger; Geoffrey Michael,2,0,32,30
1657716937655,MATH 109,B03,093479,Ganzberger; Geoffrey Michael,8,0,32,24
1657716943681,MATH 142A,A01,083219,Chow; Bennett,7,0,32,25
1657716943681,MATH 142A,A02,083220,Chow; Bennett,10,0,32,22
1657716943681,MATH 142A,A03,093480,Chow; Bennett,9,0,32,23
1657716943681,MATH 142A,B03,093481,Chow; Bennett,8,0,32,24
1657716943681,MATH 142A,B04,093558,Chow; Bennett,13,0,32,19
1657716943681,MATH 142A,B05,093559,Chow; Bennett,6,0,32,26
1657716949707,MATH 193A,A01,083224,Rotar; Vladimir,8,0,34,26
1657716949707,MATH 193A,A02,083225,Rotar; Vladimir,9,0,34,25
1657716949707,MATH 193A,A03,083781,Rotar; Vladimir,5,0,34,29
1657716949707,MATH 193A,A04,083782,Rotar; Vladimir,10,0,34,24
1657716949707,MATH 193A,A05,093482,Rotar; Vladimir,10,0,34,24
1657716955743,MATH 197,001,091859,McAuley; Julian John,9999,0,9999,0
1657716955743,MATH 197,002,095566,Kedlaya; Kiran S.,9997,0,9999,2
1657716955743,MATH 197,003,095567,Xiao; Ming,9999,0,9999,0
1657716955743,MATH 197,004,095571,Perols; Johan Lars,9998,0,9999,1
1657716962840,COGS 9,A01,083615,Shannon; Kyle Michael,9,0,75,66
1657716968866,COGS 11,A01,083617,Boyle; Mary E. T.,23,0,48,25
1657716974900,COGS 13,A01,083071,Bastos; Amalia Pinkusfeld,11,0,71,60
1657716980933,COGS 14A,A01,092681,Semenuks; Arturs,5,1,100,95
1657716986958,COGS 14B,A01,083073,Cheng; Tzu-Han,6,0,63,57
1657716992984,COGS 17,A01,092677,Semenuks; Arturs,6,0,81,75
1657716999009,COGS 100,A01,083619,Allen; Michael Gordon,17,0,70,53
1657717005035,COGS 101A,A01,083621,Davis; Joshua Daniel,9,0,68,59
1657717011067,COGS 101B,A01,091572,Allen; Michael Gordon,12,0,65,53
1657717017094,COGS 101C,A01,083625,Delgado; Tania,17,0,35,18
1657717023124,COGS 107A,A01,083627,Boyle; Mary E. T.,13,0,60,47
1657717029155,COGS 118A,A01,083075,Gupta; Anjum,21,0,76,55
1657717035190,CSE 3,A50,083646,Miranda; Gregory Joseph,24,0,50,26
1657717041217,CSE 8A,A50,083650,Miranda; Gregory Joseph,17,1,56,39
1657717047249,CSE 11,A01,083080,Cao; Yingjun,6,15,40,34
1657717053277,CSE 12,A01,083652,Krause-Levy; Sophia Louisa,28,1,120,92
1657717059303,CSE 15L,A01,083654,Morris; Justin Loren,9,0,50,41
1657717059303,CSE 15L,A02,083655,Morris; Justin Loren,9,0,50,41
1657717065330,CSE 20,A01,083657,Tran; Khoa Dang,39,0,80,41
1657717071361,CSE 21,A01,095574,Bach; Quang Tran,22,0,48,26
1657717077392,CSE 30,A01,083084,Eldon; John,6,0,80,74
1657717077392,CSE 30,B01,095061,Bhaskar; Nishant,9,0,50,41
1657717083422,CSE 100,A01,083659,Cao; Yingjun,5,4,70,65
1657717089447,CSE 134B,A01,083661,Powell; Thomas Allan,23,0,100,77
1657717095481,CSE 140,A01,083663,Gungor; Onat,15,0,85,70
1657717101512,CSE 140L,A01,083088,Eldon; John,23,0,100,77
1657717107538,CSE 175,A01,083665,Kumar; Rakesh,3,0,25,22
1657717113563,CSE 190,A00,092507,Dubnov; Shlomo,8,0,20,12
1657717119589,ECE 45,A01,083139,Congero; Spencer William,6,0,75,69
1657717125627,ECE 65,A50,083695,Saad; Andrew S,12,0,30,18
1657717125627,ECE 65,A51,095125,Saad; Andrew S,24,0,26,2
1657717131658,ECE 109,A01,091882,Touri; Behrouz,20,0,70,50
1657717137689,ECE 180,A00,083140,Abi Samra; Nicholas Camill,1,0,30,29
1657717137689,ECE 180,B00,083141,Abi Samra; Nicholas Camill,0,0,30,30
1657717143716,MATH 10A,A01,083735,Patchell; Gregory David,2,0,30,28
1657717143716,MATH 10A,A02,083736,Patchell; Gregory David,20,0,30,10
1657717143716,MATH 10A,A03,083737,Patchell; Gregory David,16,0,30,14
1657717149754,MATH 10B,A01,083207,Lim; Seonhee,8,0,34,26
1657717149754,MATH 10B,A02,083208,Lim; Seonhee,9,0,35,26
1657717149754,MATH 10B,A03,093472,Lim; Seonhee,7,0,34,27
1657717149754,MATH 10B,B01,083739,Sinha; Shubham,13,0,30,17
1657717155806,MATH 18,A01,083743,Cinel; Cameron Alexander,8,0,30,22
1657717155806,MATH 18,A02,083744,Cinel; Cameron Alexander,17,0,30,13
1657717155806,MATH 18,A03,083745,Cinel; Cameron Alexander,10,0,30,20
1657717155806,MATH 18,B01,083748,Rideout; David Porter,5,0,37,32
1657717155806,MATH 18,B02,083749,Rideout; David Porter,5,0,36,31
1657717155806,MATH 18,B03,083750,Rideout; David Porter,3,0,37,34
1657717155806,MATH 18,B04,083751,Rideout; David Porter,6,0,36,30
1657717155806,MATH 18,B05,093473,Rideout; David Porter,6,0,36,30
1657717155806,MATH 18,B06,093474,Rideout; David Porter,6,0,36,30
1657717161831,MATH 20A,A01,083754,Zheng; Zequn,14,0,40,26
1657717167859,MATH 20B,A01,083756,Briones; Jor-el Thomas Caparas,4,0,36,32
1657717167859,MATH 20B,A02,083757,Briones; Jor-el Thomas Caparas,1,0,36,35
1657717167859,MATH 20B,A03,093475,Briones; Jor-el Thomas Caparas,2,0,36,34
1657717173892,MATH 20C,A01,083760,Briones; Jor-el Thomas Caparas,1,0,35,34
1657717173892,MATH 20C,A02,083761,Briones; Jor-el Thomas Caparas,8,0,35,27
1657717173892,MATH 20C,A03,093476,Briones; Jor-el Thomas Caparas,0,1,36,36
1657717173892,MATH 20C,B01,083762,Bach; Quang Tran,1,0,30,29
1657717179920,MATH 20D,A01,083765,Tran; Brian Kha,5,0,30,25
1657717179920,MATH 20D,A02,083766,Tran; Brian Kha,5,0,30,25
1657717179920,MATH 20D,A03,083767,Tran; Brian Kha,5,0,30,25
1657717185952,MATH 20E,A01,083771,Ganguly; Soumya,9,0,32,23
1657717185952,MATH 20E,A02,083772,Ganguly; Soumya,6,0,32,26
1657717185952,MATH 20E,B01,083773,Ciotti; Benjamin,20,0,35,15
1657717185952,MATH 20E,B02,083774,Ciotti; Benjamin,18,0,35,17
1657717191979,MATH 103A,A01,083777,Greenfeld; Be'Eri,3,0,36,33
1657717191979,MATH 103A,A02,083778,Greenfeld; Be'Eri,5,0,36,31
1657717191979,MATH 103A,A03,093561,Greenfeld; Be'Eri,6,0,36,30
1657717191979,MATH 103A,B01,083779,Greenfeld; Be'Eri,7,0,36,29
1657717191979,MATH 103A,B02,083780,Greenfeld; Be'Eri,4,0,36,32
1657717191979,MATH 103A,B03,093562,Greenfeld; Be'Eri,3,0,36,33
1657717198016,MATH 105,A01,085443,Carter; Anne Toulson,15,0,35,20
1657717198016,MATH 105,A02,093477,Carter; Anne Toulson,20,0,35,15
1657717204042,MATH 109,A01,083213,Ganzberger; Geoffrey Michael,2,0,34,32
1657717204042,MATH 109,A02,083214,Ganzberger; Geoffrey Michael,4,0,34,30
1657717204042,MATH 109,A03,093478,Ganzberger; Geoffrey Michael,2,0,34,32
1657717204042,MATH 109,B01,083215,Ganzberger; Geoffrey Michael,1,0,32,31
1657717204042,MATH 109,B02,083216,Ganzberger; Geoffrey Michael,2,0,32,30
1657717204042,MATH 109,B03,093479,Ganzberger; Geoffrey Michael,8,0,32,24
1657717210071,MATH 142A,A01,083219,Chow; Bennett,7,0,32,25
1657717210071,MATH 142A,A02,083220,Chow; Bennett,10,0,32,22
1657717210071,MATH 142A,A03,093480,Chow; Bennett,9,0,32,23
1657717210071,MATH 142A,B03,093481,Chow; Bennett,8,0,32,24
1657717210071,MATH 142A,B04,093558,Chow; Bennett,13,0,32,19
1657717210071,MATH 142A,B05,093559,Chow; Bennett,6,0,32,26
1657717216104,MATH 193A,A01,083224,Rotar; Vladimir,8,0,34,26
1657717216104,MATH 193A,A02,083225,Rotar; Vladimir,9,0,34,25
1657717216104,MATH 193A,A03,083781,Rotar; Vladimir,5,0,34,29
1657717216104,MATH 193A,A04,083782,Rotar; Vladimir,10,0,34,24
1657717216104,MATH 193A,A05,093482,Rotar; Vladimir,10,0,34,24
1657717222129,MATH 197,001,091859,McAuley; Julian John,9999,0,9999,0
1657717222129,MATH 197,002,095566,Kedlaya; Kiran S.,9997,0,9999,2
1657717222129,MATH 197,003,095567,Xiao; Ming,9999,0,9999,0
1657717222129,MATH 197,004,095571,Perols; Johan Lars,9998,0,9999,1
1657717229206,COGS 9,A01,083615,Shannon; Kyle Michael,9,0,75,66
1657717235231,COGS 11,A01,083617,Boyle; Mary E. T.,23,0,48,25
1657717241257,COGS 13,A01,083071,Bastos; Amalia Pinkusfeld,11,0,71,60
1657717247294,COGS 14A,A01,092681,Semenuks; Arturs,5,1,100,95
1657717253318,COGS 14B,A01,083073,Cheng; Tzu-Han,6,0,63,57
1657717259345,COGS 17,A01,092677,Semenuks; Arturs,6,0,81,75
1657717265382,COGS 100,A01,083619,Allen; Michael Gordon,17,0,70,53
1657717271415,COGS 101A,A01,083621,Davis; Joshua Daniel,9,0,68,59
1657717277444,COGS 101B,A01,091572,Allen; Michael Gordon,12,0,65,53
1657717283470,COGS 101C,A01,083625,Delgado; Tania,17,0,35,18
1657717289498,COGS 107A,A01,083627,Boyle; Mary E. T.,13,0,60,47
1657717295532,COGS 118A,A01,083075,Gupta; Anjum,21,0,76,55
1657717301565,CSE 3,A50,083646,Miranda; Gregory Joseph,24,0,50,26
1657717307590,CSE 8A,A50,083650,Miranda; Gregory Joseph,17,1,56,39
1657717313620,CSE 11,A01,083080,Cao; Yingjun,6,15,40,34
1657717319647,CSE 12,A01,083652,Krause-Levy; Sophia Louisa,28,1,120,92
1657717325679,CSE 15L,A01,083654,Morris; Justin Loren,9,0,50,41
1657717325679,CSE 15L,A02,083655,Morris; Justin Loren,9,0,50,41
1657717331706,CSE 20,A01,083657,Tran; Khoa Dang,39,0,80,41
1657717337733,CSE 21,A01,095574,Bach; Quang Tran,22,0,48,26
1657717343759,CSE 30,A01,083084,Eldon; John,6,0,80,74
1657717343759,CSE 30,B01,095061,Bhaskar; Nishant,9,0,50,41
1657717349788,CSE 100,A01,083659,Cao; Yingjun,5,4,70,65
1657717355820,CSE 134B,A01,083661,Powell; Thomas Allan,23,0,100,77
1657717361854,CSE 140,A01,083663,Gungor; Onat,15,0,85,70
1657717367879,CSE 140L,A01,083088,Eldon; John,23,0,100,77
1657717373907,CSE 175,A01,083665,Kumar; Rakesh,3,0,25,22
1657717379934,CSE 190,A00,092507,Dubnov; Shlomo,8,0,20,12
1657717385967,ECE 45,A01,083139,Congero; Spencer William,6,0,75,69
1657717392082,ECE 65,A50,083695,Saad; Andrew S,12,0,30,18
1657717392082,ECE 65,A51,095125,Saad; Andrew S,24,0,26,2
1657717398113,ECE 109,A01,091882,Touri; Behrouz,20,0,70,50
1657717404140,ECE 180,A00,083140,Abi Samra; Nicholas Camill,1,0,30,29
1657717404140,ECE 180,B00,083141,Abi Samra; Nicholas Camill,0,0,30,30
1657717410175,MATH 10A,A01,083735,Patchell; Gregory David,2,0,30,28
1657717410175,MATH 10A,A02,083736,Patchell; Gregory David,20,0,30,10
1657717410175,MATH 10A,A03,083737,Patchell; Gregory David,16,0,30,14
1657717416203,MATH 10B,A01,083207,Lim; Seonhee,8,0,34,26
1657717416203,MATH 10B,A02,083208,Lim; Seonhee,9,0,35,26
1657717416203,MATH 10B,A03,093472,Lim; Seonhee,7,0,34,27
1657717416203,MATH 10B,B01,083739,Sinha; Shubham,13,0,30,17
1657717422238,MATH 18,A01,083743,Cinel; Cameron Alexander,8,0,30,22
1657717422238,MATH 18,A02,083744,Cinel; Cameron Alexander,17,0,30,13
1657717422238,MATH 18,A03,083745,Cinel; Cameron Alexander,10,0,30,20
1657717422238,MATH 18,B01,083748,Rideout; David Porter,5,0,37,32
1657717422238,MATH 18,B02,083749,Rideout; David Porter,5,0,36,31
1657717422238,MATH 18,B03,083750,Rideout; David Porter,3,0,37,34
1657717422238,MATH 18,B04,083751,Rideout; David Porter,6,0,36,30
1657717422238,MATH 18,B05,093473,Rideout; David Porter,6,0,36,30
1657717422238,MATH 18,B06,093474,Rideout; David Porter,6,0,36,30
1657717428264,MATH 20A,A01,083754,Zheng; Zequn,14,0,40,26
1657717434295,MATH 20B,A01,083756,Briones; Jor-el Thomas Caparas,4,0,36,32
1657717434295,MATH 20B,A02,083757,Briones; Jor-el Thomas Caparas,1,0,36,35
1657717434295,MATH 20B,A03,093475,Briones; Jor-el Thomas Caparas,2,0,36,34
1657717440322,MATH 20C,A01,083760,Briones; Jor-el Thomas Caparas,1,0,35,34
1657717440322,MATH 20C,A02,083761,Briones; Jor-el Thomas Caparas,8,0,35,27
1657717440322,MATH 20C,A03,093476,Briones; Jor-el Thomas Caparas,0,1,36,36
1657717440322,MATH 20C,B01,083762,Bach; Quang Tran,1,0,30,29
1657717446351,MATH 20D,A01,083765,Tran; Brian Kha,5,0,30,25
1657717446351,MATH 20D,A02,083766,Tran; Brian Kha,5,0,30,25
1657717446351,MATH 20D,A03,083767,Tran; Brian Kha,5,0,30,25
1657717452386,MATH 20E,A01,083771,Ganguly; Soumya,9,0,32,23
1657717452386,MATH 20E,A02,083772,Ganguly; Soumya,6,0,32,26
1657717452386,MATH 20E,B01,083773,Ciotti; Benjamin,20,0,35,15
1657717452386,MATH 20E,B02,083774,Ciotti; Benjamin,18,0,35,17
1657717458427,MATH 103A,A01,083777,Greenfeld; Be'Eri,3,0,36,33
1657717458427,MATH 103A,A02,083778,Greenfeld; Be'Eri,5,0,36,31
1657717458427,MATH 103A,A03,093561,Greenfeld; Be'Eri,6,0,36,30
1657717458427,MATH 103A,B01,083779,Greenfeld; Be'Eri,7,0,36,29
1657717458427,MATH 103A,B02,083780,Greenfeld; Be'Eri,4,0,36,32
1657717458427,MATH 103A,B03,093562,Greenfeld; Be'Eri,3,0,36,33
1657717464461,MATH 105,A01,085443,Carter; Anne Toulson,15,0,35,20
1657717464461,MATH 105,A02,093477,Carter; Anne Toulson,20,0,35,15
1657717470497,MATH 109,A01,083213,Ganzberger; Geoffrey Michael,2,0,34,32
1657717470497,MATH 109,A02,083214,Ganzberger; Geoffrey Michael,4,0,34,30
1657717470497,MATH 109,A03,093478,Ganzberger; Geoffrey Michael,2,0,34,32
1657717470497,MATH 109,B01,083215,Ganzberger; Geoffrey Michael,1,0,32,31
1657717470497,MATH 109,B02,083216,Ganzberger; Geoffrey Michael,2,0,32,30
1657717470497,MATH 109,B03,093479,Ganzberger; Geoffrey Michael,8,0,32,24
1657717476526,MATH 142A,A01,083219,Chow; Bennett,7,0,32,25
1657717476526,MATH 142A,A02,083220,Chow; Bennett,10,0,32,22
1657717476526,MATH 142A,A03,093480,Chow; Bennett,9,0,32,23
1657717476526,MATH 142A,B03,093481,Chow; Bennett,8,0,32,24
1657717476526,MATH 142A,B04,093558,Chow; Bennett,13,0,32,19
1657717476526,MATH 142A,B05,093559,Chow; Bennett,6,0,32,26
1657717482565,MATH 193A,A01,083224,Rotar; Vladimir,8,0,34,26
1657717482565,MATH 193A,A02,083225,Rotar; Vladimir,9,0,34,25
1657717482565,MATH 193A,A03,083781,Rotar; Vladimir,5,0,34,29
1657717482565,MATH 193A,A04,083782,Rotar; Vladimir,10,0,34,24
1657717482565,MATH 193A,A05,093482,Rotar; Vladimir,10,0,34,24
1657717488591,MATH 197,001,091859,McAuley; Julian John,9999,0,9999,0
1657717488591,MATH 197,002,095566,Kedlaya; Kiran S.,9997,0,9999,2
1657717488591,MATH 197,003,095567,Xiao; Ming,9999,0,9999,0
1657717488591,MATH 197,004,095571,Perols; Johan Lars,9998,0,9999,1
1657717495672,COGS 9,A01,083615,Shannon; Kyle Michael,9,0,75,66
1657717501702,COGS 11,A01,083617,Boyle; Mary E. T.,23,0,48,25
1657717507728,COGS 13,A01,083071,Bastos; Amalia Pinkusfeld,11,0,71,60
1657717513761,COGS 14A,A01,092681,Semenuks; Arturs,5,1,100,95
1657717519785,COGS 14B,A01,083073,Cheng; Tzu-Han,6,0,63,57
1657717525817,COGS 17,A01,092677,Semenuks; Arturs,6,0,81,75
1657717531848,COGS 100,A01,083619,Allen; Michael Gordon,17,0,70,53
1657717537874,COGS 101A,A01,083621,Davis; Joshua Daniel,9,0,68,59
1657717543905,COGS 101B,A01,091572,Allen; Michael Gordon,12,0,65,53
1657717549932,COGS 101C,A01,083625,Delgado; Tania,17,0,35,18
1657717555961,COGS 107A,A01,083627,Boyle; Mary E. T.,13,0,60,47
1657717561992,COGS 118A,A01,083075,Gupta; Anjum,21,0,76,55
1657717568017,CSE 3,A50,083646,Miranda; Gregory Joseph,24,0,50,26
1657717574042,CSE 8A,A50,083650,Miranda; Gregory Joseph,17,1,56,39
1657717580074,CSE 11,A01,083080,Cao; Yingjun,6,15,40,34
1657717586107,CSE 12,A01,083652,Krause-Levy; Sophia Louisa,28,1,120,92
1657717592134,CSE 15L,A01,083654,Morris; Justin Loren,9,0,50,41
1657717592134,CSE 15L,A02,083655,Morris; Justin Loren,9,0,50,41
1657717598162,CSE 20,A01,083657,Tran; Khoa Dang,39,0,80,41
1657717604187,CSE 21,A01,095574,Bach; Quang Tran,22,0,48,26
1657717610215,CSE 30,A01,083084,Eldon; John,6,0,80,74
1657717610215,CSE 30,B01,095061,Bhaskar; Nishant,9,0,50,41
1657717616247,CSE 100,A01,083659,Cao; Yingjun,5,4,70,65
1657717622273,CSE 134B,A01,083661,Powell; Thomas Allan,23,0,100,77
1657717628300,CSE 140,A01,083663,Gungor; Onat,15,0,85,70
1657717634325,CSE 140L,A01,083088,Eldon; John,23,0,100,77
1657717640359,CSE 175,A01,083665,Kumar; Rakesh,3,0,25,22
1657717646389,CSE 190,A00,092507,Dubnov; Shlomo,8,0,20,12
1657717652431,ECE 45,A01,083139,Congero; Spencer William,6,0,75,69
1657717658461,ECE 65,A50,083695,Saad; Andrew S,12,0,30,18
1657717658461,ECE 65,A51,095125,Saad; Andrew S,24,0,26,2
1657717664496,ECE 109,A01,091882,Touri; Behrouz,20,0,70,50
1657717670522,ECE 180,A00,083140,Abi Samra; Nicholas Camill,1,0,30,29
1657717670522,ECE 180,B00,083141,Abi Samra; Nicholas Camill,0,0,30,30
1657717676550,MATH 10A,A01,083735,Patchell; Gregory David,2,0,30,28
1657717676550,MATH 10A,A02,083736,Patchell; Gregory David,20,0,30,10
1657717676550,MATH 10A,A03,083737,Patchell; Gregory David,16,0,30,14
1657717682587,MATH 10B,A01,083207,Lim; Seonhee,8,0,34,26
1657717682587,MATH 10B,A02,083208,Lim; Seonhee,9,0,35,26
1657717682587,MATH 10B,A03,093472,Lim; Seonhee,7,0,34,27
1657717682587,MATH 10B,B01,083739,Sinha; Shubham,13,0,30,17
1657717688625,MATH 18,A01,083743,Cinel; Cameron Alexander,8,0,30,22
1657717688625,MATH 18,A02,083744,Cinel; Cameron Alexander,17,0,30,13
1657717688625,MATH 18,A03,083745,Cinel; Cameron Alexander,10,0,30,20
1657717688625,MATH 18,B01,083748,Rideout; David Porter,5,0,37,32
1657717688625,MATH 18,B02,083749,Rideout; David Porter,5,0,36,31
1657717688625,MATH 18,B03,083750,Rideout; David Porter,3,0,37,34
1657717688625,MATH 18,B04,083751,Rideout; David Porter,6,0,36,30
1657717688625,MATH 18,B05,093473,Rideout; David Porter,6,0,36,30
1657717688625,MATH 18,B06,093474,Rideout; David Porter,6,0,36,30
1657717694649,MATH 20A,A01,083754,Zheng; Zequn,14,0,40,26
1657717700683,MATH 20B,A01,083756,Briones; Jor-el Thomas Caparas,4,0,36,32
1657717700683,MATH 20B,A02,083757,Briones; Jor-el Thomas Caparas,1,0,36,35
1657717700683,MATH 20B,A03,093475,Briones; Jor-el Thomas Caparas,2,0,36,34
1657717706711,MATH 20C,A01,083760,Briones; Jor-el Thomas Caparas,1,0,35,34
1657717706711,MATH 20C,A02,083761,Briones; Jor-el Thomas Caparas,8,0,35,27
1657717706711,MATH 20C,A03,093476,Briones; Jor-el Thomas Caparas,0,1,36,36
1657717706711,MATH 20C,B01,083762,Bach; Quang Tran,1,0,30,29
1657717712737,MATH 20D,A01,083765,Tran; Brian Kha,5,0,30,25
1657717712737,MATH 20D,A02,083766,Tran; Brian Kha,5,0,30,25
1657717712737,MATH 20D,A03,083767,Tran; Brian Kha,5,0,30,25
1657717718776,MATH 20E,A01,083771,Ganguly; Soumya,9,0,32,23
1657717718776,MATH 20E,A02,083772,Ganguly; Soumya,6,0,32,26
1657717718776,MATH 20E,B01,083773,Ciotti; Benjamin,20,0,35,15
1657717718776,MATH 20E,B02,083774,Ciotti; Benjamin,18,0,35,17
1657717724813,MATH 103A,A01,083777,Greenfeld; Be'Eri,3,0,36,33
1657717724813,MATH 103A,A02,083778,Greenfeld; Be'Eri,5,0,36,31
1657717724813,MATH 103A,A03,093561,Greenfeld; Be'Eri,6,0,36,30
1657717724813,MATH 103A,B01,083779,Greenfeld; Be'Eri,7,0,36,29
1657717724813,MATH 103A,B02,083780,Greenfeld; Be'Eri,4,0,36,32
1657717724813,MATH 103A,B03,093562,Greenfeld; Be'Eri,3,0,36,33
1657717730847,MATH 105,A01,085443,Carter; Anne Toulson,15,0,35,20
1657717730847,MATH 105,A02,093477,Carter; Anne Toulson,20,0,35,15
1657717736877,MATH 109,A01,083213,Ganzberger; Geoffrey Michael,2,0,34,32
1657717736877,MATH 109,A02,083214,Ganzberger; Geoffrey Michael,4,0,34,30
1657717736877,MATH 109,A03,093478,Ganzberger; Geoffrey Michael,2,0,34,32
1657717736877,MATH 109,B01,083215,Ganzberger; Geoffrey Michael,1,0,32,31
1657717736877,MATH 109,B02,083216,Ganzberger; Geoffrey Michael,2,0,32,30
1657717736877,MATH 109,B03,093479,Ganzberger; Geoffrey Michael,8,0,32,24
1657717742903,MATH 142A,A01,083219,Chow; Bennett,7,0,32,25
1657717742903,MATH 142A,A02,083220,Chow; Bennett,10,0,32,22
1657717742903,MATH 142A,A03,093480,Chow; Bennett,9,0,32,23
1657717742903,MATH 142A,B03,093481,Chow; Bennett,8,0,32,24
1657717742903,MATH 142A,B04,093558,Chow; Bennett,13,0,32,19
1657717742903,MATH 142A,B05,093559,Chow; Bennett,6,0,32,26
1657717748929,MATH 193A,A01,083224,Rotar; Vladimir,8,0,34,26
1657717748929,MATH 193A,A02,083225,Rotar; Vladimir,9,0,34,25
1657717748929,MATH 193A,A03,083781,Rotar; Vladimir,5,0,34,29
1657717748929,MATH 193A,A04,083782,Rotar; Vladimir,10,0,34,24
1657717748929,MATH 193A,A05,093482,Rotar; Vladimir,10,0,34,24
1657717754958,MATH 197,001,091859,McAuley; Julian John,9999,0,9999,0
1657717754958,MATH 197,002,095566,Kedlaya; Kiran S.,9997,0,9999,2
1657717754958,MATH 197,003,095567,Xiao; Ming,9999,0,9999,0
1657717754958,MATH 197,004,095571,Perols; Johan Lars,9998,0,9999,1
1657717762029,COGS 9,A01,083615,Shannon; Kyle Michael,9,0,75,66
1657717768055,COGS 11,A01,083617,Boyle; Mary E. T.,23,0,48,25
1657717774083,COGS 13,A01,083071,Bastos; Amalia Pinkusfeld,11,0,71,60
1657717780122,COGS 14A,A01,092681,Semenuks; Arturs,5,1,100,95
1657717786153,COGS 14B,A01,083073,Cheng; Tzu-Han,6,0,63,57
1657717792182,COGS 17,A01,092677,Semenuks; Arturs,6,0,81,75
1657717798208,COGS 100,A01,083619,Allen; Michael Gordon,17,0,70,53
1657717804232,COGS 101A,A01,083621,Davis; Joshua Daniel,9,0,68,59
1657717810258,COGS 101B,A01,091572,Allen; Michael Gordon,12,0,65,53
1657717816289,COGS 101C,A01,083625,Delgado; Tania,17,0,35,18
1657717822313,COGS 107A,A01,083627,Boyle; Mary E. T.,13,0,60,47
1657717828337,COGS 118A,A01,083075,Gupta; Anjum,21,0,76,55
1657717834369,CSE 3,A50,083646,Miranda; Gregory Joseph,24,0,50,26
1657717840400,CSE 8A,A50,083650,Miranda; Gregory Joseph,17,1,56,39
1657717846427,CSE 11,A01,083080,Cao; Yingjun,6,15,40,34
1657717852458,CSE 12,A01,083652,Krause-Levy; Sophia Louisa,28,1,120,92
1657717858491,CSE 15L,A01,083654,Morris; Justin Loren,9,0,50,41
1657717858491,CSE 15L,A02,083655,Morris; Justin Loren,9,0,50,41
1657717864518,CSE 20,A01,083657,Tran; Khoa Dang,39,0,80,41
1657717870541,CSE 21,A01,095574,Bach; Quang Tran,22,0,48,26
1657717876568,CSE 30,A01,083084,Eldon; John,6,0,80,74
1657717876568,CSE 30,B01,095061,Bhaskar; Nishant,9,0,50,41
1657717882596,CSE 100,A01,083659,Cao; Yingjun,5,4,70,65
1657717888621,CSE 134B,A01,083661,Powell; Thomas Allan,23,0,100,77
1657717894648,CSE 140,A01,083663,Gungor; Onat,15,0,85,70
1657717900675,CSE 140L,A01,083088,Eldon; John,23,0,100,77
1657717906701,CSE 175,A01,083665,Kumar; Rakesh,3,0,25,22
1657717912727,CSE 190,A00,092507,Dubnov; Shlomo,8,0,20,12
1657717918757,ECE 45,A01,083139,Congero; Spencer William,6,0,75,69
1657717924805,ECE 65,A50,083695,Saad; Andrew S,12,0,30,18
1657717924805,ECE 65,A51,095125,Saad; Andrew S,24,0,26,2
1657717930837,ECE 109,A01,091882,Touri; Behrouz,20,0,70,50
1657717936862,ECE 180,A00,083140,Abi Samra; Nicholas Camill,1,0,30,29
1657717936862,ECE 180,B00,083141,Abi Samra; Nicholas Camill,0,0,30,30
1657717942896,MATH 10A,A01,083735,Patchell; Gregory David,2,0,30,28
1657717942896,MATH 10A,A02,083736,Patchell; Gregory David,20,0,30,10
1657717942896,MATH 10A,A03,083737,Patchell; Gregory David,16,0,30,14
1657717948924,MATH 10B,A01,083207,Lim; Seonhee,8,0,34,26
1657717948924,MATH 10B,A02,083208,Lim; Seonhee,9,0,35,26
1657717948924,MATH 10B,A03,093472,Lim; Seonhee,7,0,34,27
1657717948924,MATH 10B,B01,083739,Sinha; Shubham,13,0,30,17
1657717954953,MATH 18,A01,083743,Cinel; Cameron Alexander,8,0,30,22
1657717954953,MATH 18,A02,083744,Cinel; Cameron Alexander,17,0,30,13
1657717954953,MATH 18,A03,083745,Cinel; Cameron Alexander,10,0,30,20
1657717954953,MATH 18,B01,083748,Rideout; David Porter,5,0,37,32
1657717954953,MATH 18,B02,083749,Rideout; David Porter,5,0,36,31
1657717954953,MATH 18,B03,083750,Rideout; David Porter,3,0,37,34
1657717954953,MATH 18,B04,083751,Rideout; David Porter,6,0,36,30
1657717954953,MATH 18,B05,093473,Rideout; David Porter,6,0,36,30
1657717954953,MATH 18,B06,093474,Rideout; David Porter,6,0,36,30
1657717960984,MATH 20A,A01,083754,Zheng; Zequn,14,0,40,26
1657717967014,MATH 20B,A01,083756,Briones; Jor-el Thomas Caparas,4,0,36,32
1657717967014,MATH 20B,A02,083757,Briones; Jor-el Thomas Caparas,1,0,36,35
1657717967014,MATH 20B,A03,093475,Briones; Jor-el Thomas Caparas,2,0,36,34
1657717973042,MATH 20C,A01,083760,Briones; Jor-el Thomas Caparas,1,0,35,34
1657717973042,MATH 20C,A02,083761,Briones; Jor-el Thomas Caparas,8,0,35,27
1657717973042,MATH 20C,A03,093476,Briones; Jor-el Thomas Caparas,0,1,36,36
1657717973042,MATH 20C,B01,083762,Bach; Quang Tran,1,0,30,29
1657717979077,MATH 20D,A01,083765,Tran; Brian Kha,5,0,30,25
1657717979077,MATH 20D,A02,083766,Tran; Brian Kha,5,0,30,25
1657717979077,MATH 20D,A03,083767,Tran; Brian Kha,5,0,30,25
1657717985116,MATH 20E,A01,083771,Ganguly; Soumya,9,0,32,23
1657717985116,MATH 20E,A02,083772,Ganguly; Soumya,6,0,32,26
1657717985116,MATH 20E,B01,083773,Ciotti; Benjamin,20,0,35,15
1657717985116,MATH 20E,B02,083774,Ciotti; Benjamin,18,0,35,17
1657717991219,MATH 103A,A01,083777,Greenfeld; Be'Eri,3,0,36,33
1657717991219,MATH 103A,A02,083778,Greenfeld; Be'Eri,5,0,36,31
1657717991219,MATH 103A,A03,093561,Greenfeld; Be'Eri,6,0,36,30
1657717991219,MATH 103A,B01,083779,Greenfeld; Be'Eri,7,0,36,29
1657717991219,MATH 103A,B02,083780,Greenfeld; Be'Eri,4,0,36,32
1657717991219,MATH 103A,B03,093562,Greenfeld; Be'Eri,3,0,36,33
1657717997245,MATH 105,A01,085443,Carter; Anne Toulson,15,0,35,20
1657717997245,MATH 105,A02,093477,Carter; Anne Toulson,20,0,35,15
1657718003276,MATH 109,A01,083213,Ganzberger; Geoffrey Michael,2,0,34,32
1657718003276,MATH 109,A02,083214,Ganzberger; Geoffrey Michael,4,0,34,30
1657718003276,MATH 109,A03,093478,Ganzberger; Geoffrey Michael,2,0,34,32
1657718003276,MATH 109,B01,083215,Ganzberger; Geoffrey Michael,1,0,32,31
1657718003276,MATH 109,B02,083216,Ganzberger; Geoffrey Michael,2,0,32,30
1657718003276,MATH 109,B03,093479,Ganzberger; Geoffrey Michael,8,0,32,24
1657718009310,MATH 142A,A01,083219,Chow; Bennett,7,0,32,25
1657718009310,MATH 142A,A02,083220,Chow; Bennett,10,0,32,22
1657718009310,MATH 142A,A03,093480,Chow; Bennett,9,0,32,23
1657718009310,MATH 142A,B03,093481,Chow; Bennett,8,0,32,24
1657718009310,MATH 142A,B04,093558,Chow; Bennett,13,0,32,19
1657718009310,MATH 142A,B05,093559,Chow; Bennett,6,0,32,26
1657718015337,MATH 193A,A01,083224,Rotar; Vladimir,8,0,34,26
1657718015337,MATH 193A,A02,083225,Rotar; Vladimir,9,0,34,25
1657718015337,MATH 193A,A03,083781,Rotar; Vladimir,5,0,34,29
1657718015337,MATH 193A,A04,083782,Rotar; Vladimir,10,0,34,24
1657718015337,MATH 193A,A05,093482,Rotar; Vladimir,10,0,34,24
1657718021363,MATH 197,001,091859,McAuley; Julian John,9999,0,9999,0
1657718021363,MATH 197,002,095566,Kedlaya; Kiran S.,9997,0,9999,2
1657718021363,MATH 197,003,095567,Xiao; Ming,9999,0,9999,0
1657718021363,MATH 197,004,095571,Perols; Johan Lars,9998,0,9999,1
1657718028461,COGS 9,A01,083615,Shannon; Kyle Michael,9,0,75,66
1657718034487,COGS 11,A01,083617,Boyle; Mary E. T.,23,0,48,25
1657718040517,COGS 13,A01,083071,Bastos; Amalia Pinkusfeld,11,0,71,60
1657718046542,COGS 14A,A01,092681,Semenuks; Arturs,5,1,100,95
1657718052572,COGS 14B,A01,083073,Cheng; Tzu-Han,6,0,63,57
1657718058600,COGS 17,A01,092677,Semenuks; Arturs,6,0,81,75
1657718064634,COGS 100,A01,083619,Allen; Michael Gordon,17,0,70,53
1657718070664,COGS 101A,A01,083621,Davis; Joshua Daniel,9,0,68,59
1657718076694,COGS 101B,A01,091572,Allen; Michael Gordon,12,0,65,53
1657718082717,COGS 101C,A01,083625,Delgado; Tania,17,0,35,18
1657718088745,COGS 107A,A01,083627,Boyle; Mary E. T.,13,0,60,47
1657718094781,COGS 118A,A01,083075,Gupta; Anjum,21,0,76,55
1657718100809,CSE 3,A50,083646,Miranda; Gregory Joseph,24,0,50,26
1657718106832,CSE 8A,A50,083650,Miranda; Gregory Joseph,17,1,56,39
1657718112857,CSE 11,A01,083080,Cao; Yingjun,6,15,40,34
1657718118885,CSE 12,A01,083652,Krause-Levy; Sophia Louisa,28,1,120,92
1657718124921,CSE 15L,A01,083654,Morris; Justin Loren,9,0,50,41
1657718124921,CSE 15L,A02,083655,Morris; Justin Loren,9,0,50,41
1657718130947,CSE 20,A01,083657,Tran; Khoa Dang,39,0,80,41
1657718136971,CSE 21,A01,095574,Bach; Quang Tran,22,0,48,26
1657718143004,CSE 30,A01,083084,Eldon; John,6,0,80,74
1657718143004,CSE 30,B01,095061,Bhaskar; Nishant,9,0,50,41
1657718149031,CSE 100,A01,083659,Cao; Yingjun,5,4,70,65
1657718155073,CSE 134B,A01,083661,Powell; Thomas Allan,23,0,100,77
1657718161100,CSE 140,A01,083663,Gungor; Onat,15,0,85,70
1657718167131,CSE 140L,A01,083088,Eldon; John,23,0,100,77
1657718173159,CSE 175,A01,083665,Kumar; Rakesh,3,0,25,22
1657718179189,CSE 190,A00,092507,Dubnov; Shlomo,8,0,20,12
1657718185214,ECE 45,A01,083139,Congero; Spencer William,6,0,75,69
1657718191242,ECE 65,A50,083695,Saad; Andrew S,12,0,30,18
1657718191242,ECE 65,A51,095125,Saad; Andrew S,24,0,26,2
1657718197269,ECE 109,A01,091882,Touri; Behrouz,20,0,70,50
1657718203302,ECE 180,A00,083140,Abi Samra; Nicholas Camill,1,0,30,29
1657718203302,ECE 180,B00,083141,Abi Samra; Nicholas Camill,0,0,30,30
1657718209326,MATH 10A,A01,083735,Patchell; Gregory David,2,0,30,28
1657718209326,MATH 10A,A02,083736,Patchell; Gregory David,20,0,30,10
1657718209326,MATH 10A,A03,083737,Patchell; Gregory David,16,0,30,14
1657718215352,MATH 10B,A01,083207,Lim; Seonhee,8,0,34,26
1657718215352,MATH 10B,A02,083208,Lim; Seonhee,9,0,35,26
1657718215352,MATH 10B,A03,093472,Lim; Seonhee,7,0,34,27
1657718215352,MATH 10B,B01,083739,Sinha; Shubham,13,0,30,17
1657718221380,MATH 18,A01,083743,Cinel; Cameron Alexander,8,0,30,22
1657718221380,MATH 18,A02,083744,Cinel; Cameron Alexander,17,0,30,13
1657718221380,MATH 18,A03,083745,Cinel; Cameron Alexander,10,0,30,20
1657718221380,MATH 18,B01,083748,Rideout; David Porter,5,0,37,32
1657718221380,MATH 18,B02,083749,Rideout; David Porter,5,0,36,31
1657718221380,MATH 18,B03,083750,Rideout; David Porter,3,0,37,34
1657718221380,MATH 18,B04,083751,Rideout; David Porter,6,0,36,30
1657718221380,MATH 18,B05,093473,Rideout; David Porter,6,0,36,30
1657718221380,MATH 18,B06,093474,Rideout; David Porter,6,0,36,30
1657718227411,MATH 20A,A01,083754,Zheng; Zequn,14,0,40,26
1657718233437,MATH 20B,A01,083756,Briones; Jor-el Thomas Caparas,4,0,36,32
1657718233437,MATH 20B,A02,083757,Briones; Jor-el Thomas Caparas,1,0,36,35
1657718233437,MATH 20B,A03,093475,Briones; Jor-el Thomas Caparas,2,0,36,34
1657718239469,MATH 20C,A01,083760,Briones; Jor-el Thomas Caparas,1,0,35,34
1657718239469,MATH 20C,A02,083761,Briones; Jor-el Thomas Caparas,8,0,35,27
1657718239469,MATH 20C,A03,093476,Briones; Jor-el Thomas Caparas,0,1,36,36
1657718239469,MATH 20C,B01,083762,Bach; Quang Tran,1,0,30,29
1657718245495,MATH 20D,A01,083765,Tran; Brian Kha,5,0,30,25
1657718245495,MATH 20D,A02,083766,Tran; Brian Kha,5,0,30,25
1657718245495,MATH 20D,A03,083767,Tran; Brian Kha,5,0,30,25
1657718251521,MATH 20E,A01,083771,Ganguly; Soumya,9,0,32,23
1657718251521,MATH 20E,A02,083772,Ganguly; Soumya,6,0,32,26
1657718251521,MATH 20E,B01,083773,Ciotti; Benjamin,20,0,35,15
1657718251521,MATH 20E,B02,083774,Ciotti; Benjamin,18,0,35,17
1657718257556,MATH 103A,A01,083777,Greenfeld; Be'Eri,3,0,36,33
1657718257556,MATH 103A,A02,083778,Greenfeld; Be'Eri,5,0,36,31
1657718257556,MATH 103A,A03,093561,Greenfeld; Be'Eri,6,0,36,30
1657718257556,MATH 103A,B01,083779,Greenfeld; Be'Eri,7,0,36,29
1657718257556,MATH 103A,B02,083780,Greenfeld; Be'Eri,4,0,36,32
1657718257556,MATH 103A,B03,093562,Greenfeld; Be'Eri,3,0,36,33
1657718263588,MATH 105,A01,085443,Carter; Anne Toulson,15,0,35,20
1657718263588,MATH 105,A02,093477,Carter; Anne Toulson,20,0,35,15
1657718269621,MATH 109,A01,083213,Ganzberger; Geoffrey Michael,2,0,34,32
1657718269621,MATH 109,A02,083214,Ganzberger; Geoffrey Michael,4,0,34,30
1657718269621,MATH 109,A03,093478,Ganzberger; Geoffrey Michael,2,0,34,32
1657718269621,MATH 109,B01,083215,Ganzberger; Geoffrey Michael,1,0,32,31
1657718269621,MATH 109,B02,083216,Ganzberger; Geoffrey Michael,2,0,32,30
1657718269621,MATH 109,B03,093479,Ganzberger; Geoffrey Michael,8,0,32,24
1657718275647,MATH 142A,A01,083219,Chow; Bennett,7,0,32,25
1657718275647,MATH 142A,A02,083220,Chow; Bennett,10,0,32,22
1657718275647,MATH 142A,A03,093480,Chow; Bennett,9,0,32,23
1657718275647,MATH 142A,B03,093481,Chow; Bennett,8,0,32,24
1657718275647,MATH 142A,B04,093558,Chow; Bennett,13,0,32,19
1657718275647,MATH 142A,B05,093559,Chow; Bennett,6,0,32,26
1657718281675,MATH 193A,A01,083224,Rotar; Vladimir,8,0,34,26
1657718281675,MATH 193A,A02,083225,Rotar; Vladimir,9,0,34,25
1657718281675,MATH 193A,A03,083781,Rotar; Vladimir,5,0,34,29
1657718281675,MATH 193A,A04,083782,Rotar; Vladimir,10,0,34,24
1657718281675,MATH 193A,A05,093482,Rotar; Vladimir,10,0,34,24
1657718287701,MATH 197,001,091859,McAuley; Julian John,9999,0,9999,0
1657718287701,MATH 197,002,095566,Kedlaya; Kiran S.,9997,0,9999,2
1657718287701,MATH 197,003,095567,Xiao; Ming,9999,0,9999,0
1657718287701,MATH 197,004,095571,Perols; Johan Lars,9998,0,9999,1
1657718294762,COGS 9,A01,083615,Shannon; Kyle Michael,9,0,75,66
1657718300789,COGS 11,A01,083617,Boyle; Mary E. T.,23,0,48,25
1657718306819,COGS 13,A01,083071,Bastos; Amalia Pinkusfeld,11,0,71,60
1657718312843,COGS 14A,A01,092681,Semenuks; Arturs,5,1,100,95
1657718318874,COGS 14B,A01,083073,Cheng; Tzu-Han,6,0,63,57
1657718324901,COGS 17,A01,092677,Semenuks; Arturs,6,0,81,75
1657718330943,COGS 100,A01,083619,Allen; Michael Gordon,17,0,70,53
1657718336976,COGS 101A,A01,083621,Davis; Joshua Daniel,9,0,68,59
1657718343004,COGS 101B,A01,091572,Allen; Michael Gordon,12,0,65,53
1657718349028,COGS 101C,A01,083625,Delgado; Tania,17,0,35,18
1657718355061,COGS 107A,A01,083627,Boyle; Mary E. T.,13,0,60,47
1657718361101,COGS 118A,A01,083075,Gupta; Anjum,21,0,76,55
1657718367140,CSE 3,A50,083646,Miranda; Gregory Joseph,24,0,50,26
1657718373166,CSE 8A,A50,083650,Miranda; Gregory Joseph,17,1,56,39
1657718379191,CSE 11,A01,083080,Cao; Yingjun,6,15,40,34
1657718385221,CSE 12,A01,083652,Krause-Levy; Sophia Louisa,28,1,120,92
1657718391249,CSE 15L,A01,083654,Morris; Justin Loren,9,0,50,41
1657718391249,CSE 15L,A02,083655,Morris; Justin Loren,9,0,50,41
1657718397274,CSE 20,A01,083657,Tran; Khoa Dang,39,0,80,41
1657718403302,CSE 21,A01,095574,Bach; Quang Tran,22,0,48,26
1657718409331,CSE 30,A01,083084,Eldon; John,6,0,80,74
1657718409331,CSE 30,B01,095061,Bhaskar; Nishant,9,0,50,41
1657718415357,CSE 100,A01,083659,Cao; Yingjun,5,4,70,65
1657718421381,CSE 134B,A01,083661,Powell; Thomas Allan,23,0,100,77
1657718427413,CSE 140,A01,083663,Gungor; Onat,15,0,85,70
1657718433439,CSE 140L,A01,083088,Eldon; John,23,0,100,77
1657718439470,CSE 175,A01,083665,Kumar; Rakesh,3,0,25,22
1657718445496,CSE 190,A00,092507,Dubnov; Shlomo,8,0,20,12
1657718451525,ECE 45,A01,083139,Congero; Spencer William,6,0,75,69
1657718457551,ECE 65,A50,083695,Saad; Andrew S,12,0,30,18
1657718457551,ECE 65,A51,095125,Saad; Andrew S,24,0,26,2
1657718463577,ECE 109,A01,091882,Touri; Behrouz,20,0,70,50
1657718469614,ECE 180,A00,083140,Abi Samra; Nicholas Camill,1,0,30,29
1657718469614,ECE 180,B00,083141,Abi Samra; Nicholas Camill,0,0,30,30
1657718475640,MATH 10A,A01,083735,Patchell; Gregory David,2,0,30,28
1657718475640,MATH 10A,A02,083736,Patchell; Gregory David,20,0,30,10
1657718475640,MATH 10A,A03,083737,Patchell; Gregory David,16,0,30,14
1657718481666,MATH 10B,A01,083207,Lim; Seonhee,8,0,34,26
1657718481666,MATH 10B,A02,083208,Lim; Seonhee,9,0,35,26
1657718481666,MATH 10B,A03,093472,Lim; Seonhee,7,0,34,27
1657718481666,MATH 10B,B01,083739,Sinha; Shubham,13,0,30,17
1657718487703,MATH 18,A01,083743,Cinel; Cameron Alexander,8,0,30,22
1657718487703,MATH 18,A02,083744,Cinel; Cameron Alexander,17,0,30,13
1657718487703,MATH 18,A03,083745,Cinel; Cameron Alexander,10,0,30,20
1657718487703,MATH 18,B01,083748,Rideout; David Porter,5,0,37,32
1657718487703,MATH 18,B02,083749,Rideout; David Porter,5,0,36,31
1657718487703,MATH 18,B03,083750,Rideout; David Porter,3,0,37,34
1657718487703,MATH 18,B04,083751,Rideout; David Porter,6,0,36,30
1657718487703,MATH 18,B05,093473,Rideout; David Porter,6,0,36,30
1657718487703,MATH 18,B06,093474,Rideout; David Porter,6,0,36,30
1657718493741,MATH 20A,A01,083754,Zheng; Zequn,14,0,40,26
1657718499772,MATH 20B,A01,083756,Briones; Jor-el Thomas Caparas,4,0,36,32
1657718499772,MATH 20B,A02,083757,Briones; Jor-el Thomas Caparas,1,0,36,35
1657718499772,MATH 20B,A03,093475,Briones; Jor-el Thomas Caparas,2,0,36,34
1657718505795,MATH 20C,A01,083760,Briones; Jor-el Thomas Caparas,1,0,35,34
1657718505795,MATH 20C,A02,083761,Briones; Jor-el Thomas Caparas,8,0,35,27
1657718505795,MATH 20C,A03,093476,Briones; Jor-el Thomas Caparas,0,1,36,36
1657718505795,MATH 20C,B01,083762,Bach; Quang Tran,1,0,30,29
1657718511837,MATH 20D,A01,083765,Tran; Brian Kha,5,0,30,25
1657718511837,MATH 20D,A02,083766,Tran; Brian Kha,5,0,30,25
1657718511837,MATH 20D,A03,083767,Tran; Brian Kha,5,0,30,25
1657718517868,MATH 20E,A01,083771,Ganguly; Soumya,9,0,32,23
1657718517868,MATH 20E,A02,083772,Ganguly; Soumya,6,0,32,26
1657718517868,MATH 20E,B01,083773,Ciotti; Benjamin,20,0,35,15
1657718517868,MATH 20E,B02,083774,Ciotti; Benjamin,18,0,35,17
1657718523911,MATH 103A,A01,083777,Greenfeld; Be'Eri,3,0,36,33
1657718523911,MATH 103A,A02,083778,Greenfeld; Be'Eri,5,0,36,31
1657718523911,MATH 103A,A03,093561,Greenfeld; Be'Eri,6,0,36,30
1657718523911,MATH 103A,B01,083779,Greenfeld; Be'Eri,7,0,36,29
1657718523911,MATH 103A,B02,083780,Greenfeld; Be'Eri,4,0,36,32
1657718523911,MATH 103A,B03,093562,Greenfeld; Be'Eri,3,0,36,33
1657718529940,MATH 105,A01,085443,Carter; Anne Toulson,15,0,35,20
1657718529940,MATH 105,A02,093477,Carter; Anne Toulson,20,0,35,15
1657718535963,MATH 109,A01,083213,Ganzberger; Geoffrey Michael,2,0,34,32
1657718535963,MATH 109,A02,083214,Ganzberger; Geoffrey Michael,4,0,34,30
1657718535963,MATH 109,A03,093478,Ganzberger; Geoffrey Michael,2,0,34,32
1657718535963,MATH 109,B01,083215,Ganzberger; Geoffrey Michael,1,0,32,31
1657718535963,MATH 109,B02,083216,Ganzberger; Geoffrey Michael,2,0,32,30
1657718535963,MATH 109,B03,093479,Ganzberger; Geoffrey Michael,8,0,32,24
1657718541993,MATH 142A,A01,083219,Chow; Bennett,7,0,32,25
1657718541993,MATH 142A,A02,083220,Chow; Bennett,10,0,32,22
1657718541993,MATH 142A,A03,093480,Chow; Bennett,9,0,32,23
1657718541993,MATH 142A,B03,093481,Chow; Bennett,8,0,32,24
1657718541993,MATH 142A,B04,093558,Chow; Bennett,13,0,32,19
1657718541993,MATH 142A,B05,093559,Chow; Bennett,6,0,32,26
1657718548023,MATH 193A,A01,083224,Rotar; Vladimir,8,0,34,26
1657718548023,MATH 193A,A02,083225,Rotar; Vladimir,9,0,34,25
1657718548023,MATH 193A,A03,083781,Rotar; Vladimir,5,0,34,29
1657718548023,MATH 193A,A04,083782,Rotar; Vladimir,10,0,34,24
1657718548023,MATH 193A,A05,093482,Rotar; Vladimir,10,0,34,24
1657718554053,MATH 197,001,091859,McAuley; Julian John,9999,0,9999,0
1657718554053,MATH 197,002,095566,Kedlaya; Kiran S.,9997,0,9999,2
1657718554053,MATH 197,003,095567,Xiao; Ming,9999,0,9999,0
1657718554053,MATH 197,004,095571,Perols; Johan Lars,9998,0,9999,1
1657718561121,COGS 9,A01,083615,Shannon; Kyle Michael,9,0,75,66
1657718567148,COGS 11,A01,083617,Boyle; Mary E. T.,23,0,48,25
1657718573185,COGS 13,A01,083071,Bastos; Amalia Pinkusfeld,11,0,71,60
1657718579210,COGS 14A,A01,092681,Semenuks; Arturs,5,1,100,95
1657718585319,COGS 14B,A01,083073,Cheng; Tzu-Han,6,0,63,57
1657718591348,COGS 17,A01,092677,Semenuks; Arturs,6,0,81,75
1657718597375,COGS 100,A01,083619,Allen; Michael Gordon,17,0,70,53
1657718603402,COGS 101A,A01,083621,Davis; Joshua Daniel,9,0,68,59
1657718609426,COGS 101B,A01,091572,Allen; Michael Gordon,12,0,65,53
1657718615460,COGS 101C,A01,083625,Delgado; Tania,17,0,35,18
1657718621483,COGS 107A,A01,083627,Boyle; Mary E. T.,13,0,60,47
1657718627507,COGS 118A,A01,083075,Gupta; Anjum,21,0,76,55
1657718633532,CSE 3,A50,083646,Miranda; Gregory Joseph,24,0,50,26
1657718639557,CSE 8A,A50,083650,Miranda; Gregory Joseph,17,1,56,39
1657718645580,CSE 11,A01,083080,Cao; Yingjun,6,15,40,34
1657718651605,CSE 12,A01,083652,Krause-Levy; Sophia Louisa,28,1,120,92
1657718657635,CSE 15L,A01,083654,Morris; Justin Loren,9,0,50,41
1657718657635,CSE 15L,A02,083655,Morris; Justin Loren,9,0,50,41
1657718663665,CSE 20,A01,083657,Tran; Khoa Dang,39,0,80,41
1657718669696,CSE 21,A01,095574,Bach; Quang Tran,22,0,48,26
1657718675725,CSE 30,A01,083084,Eldon; John,6,0,80,74
1657718675725,CSE 30,B01,095061,Bhaskar; Nishant,9,0,50,41
1657718681751,CSE 100,A01,083659,Cao; Yingjun,5,4,70,65
1657718687782,CSE 134B,A01,083661,Powell; Thomas Allan,23,0,100,77
1657718693811,CSE 140,A01,083663,Gungor; Onat,15,0,85,70
1657718699841,CSE 140L,A01,083088,Eldon; John,23,0,100,77
1657718705864,CSE 175,A01,083665,Kumar; Rakesh,3,0,25,22
1657718711888,CSE 190,A00,092507,Dubnov; Shlomo,8,0,20,12
1657718717918,ECE 45,A01,083139,Congero; Spencer William,6,0,75,69
1657718723950,ECE 65,A50,083695,Saad; Andrew S,12,0,30,18
1657718723950,ECE 65,A51,095125,Saad; Andrew S,24,0,26,2
1657718729979,ECE 109,A01,091882,Touri; Behrouz,20,0,70,50
1657718736004,ECE 180,A00,083140,Abi Samra; Nicholas Camill,1,0,30,29
1657718736004,ECE 180,B00,083141,Abi Samra; Nicholas Camill,0,0,30,30
1657718742036,MATH 10A,A01,083735,Patchell; Gregory David,2,0,30,28
1657718742036,MATH 10A,A02,083736,Patchell; Gregory David,20,0,30,10
1657718742036,MATH 10A,A03,083737,Patchell; Gregory David,16,0,30,14
1657718748065,MATH 10B,A01,083207,Lim; Seonhee,8,0,34,26
1657718748065,MATH 10B,A02,083208,Lim; Seonhee,9,0,35,26
1657718748065,MATH 10B,A03,093472,Lim; Seonhee,7,0,34,27
1657718748065,MATH 10B,B01,083739,Sinha; Shubham,13,0,30,17
1657718754092,MATH 18,A01,083743,Cinel; Cameron Alexander,8,0,30,22
1657718754092,MATH 18,A02,083744,Cinel; Cameron Alexander,17,0,30,13
1657718754092,MATH 18,A03,083745,Cinel; Cameron Alexander,10,0,30,20
1657718754092,MATH 18,B01,083748,Rideout; David Porter,5,0,37,32
1657718754092,MATH 18,B02,083749,Rideout; David Porter,5,0,36,31
1657718754092,MATH 18,B03,083750,Rideout; David Porter,3,0,37,34
1657718754092,MATH 18,B04,083751,Rideout; David Porter,6,0,36,30
1657718754092,MATH 18,B05,093473,Rideout; David Porter,6,0,36,30
1657718754092,MATH 18,B06,093474,Rideout; David Porter,6,0,36,30
1657718760119,MATH 20A,A01,083754,Zheng; Zequn,14,0,40,26
1657718766152,MATH 20B,A01,083756,Briones; Jor-el Thomas Caparas,4,0,36,32
1657718766152,MATH 20B,A02,083757,Briones; Jor-el Thomas Caparas,1,0,36,35
1657718766152,MATH 20B,A03,093475,Briones; Jor-el Thomas Caparas,2,0,36,34
1657718772186,MATH 20C,A01,083760,Briones; Jor-el Thomas Caparas,1,0,35,34
1657718772186,MATH 20C,A02,083761,Briones; Jor-el Thomas Caparas,8,0,35,27
1657718772186,MATH 20C,A03,093476,Briones; Jor-el Thomas Caparas,0,1,36,36
1657718772186,MATH 20C,B01,083762,Bach; Quang Tran,1,0,30,29
1657718778215,MATH 20D,A01,083765,Tran; Brian Kha,5,0,30,25
1657718778215,MATH 20D,A02,083766,Tran; Brian Kha,5,0,30,25
1657718778215,MATH 20D,A03,083767,Tran; Brian Kha,5,0,30,25
1657718784249,MATH 20E,A01,083771,Ganguly; Soumya,9,0,32,23
1657718784249,MATH 20E,A02,083772,Ganguly; Soumya,6,0,32,26
1657718784249,MATH 20E,B01,083773,Ciotti; Benjamin,20,0,35,15
1657718784249,MATH 20E,B02,083774,Ciotti; Benjamin,18,0,35,17
1657718790289,MATH 103A,A01,083777,Greenfeld; Be'Eri,3,0,36,33
1657718790289,MATH 103A,A02,083778,Greenfeld; Be'Eri,5,0,36,31
1657718790289,MATH 103A,A03,093561,Greenfeld; Be'Eri,6,0,36,30
1657718790289,MATH 103A,B01,083779,Greenfeld; Be'Eri,7,0,36,29
1657718790289,MATH 103A,B02,083780,Greenfeld; Be'Eri,4,0,36,32
1657718790289,MATH 103A,B03,093562,Greenfeld; Be'Eri,3,0,36,33
1657718796315,MATH 105,A01,085443,Carter; Anne Toulson,15,0,35,20
1657718796315,MATH 105,A02,093477,Carter; Anne Toulson,20,0,35,15
1657718802343,MATH 109,A01,083213,Ganzberger; Geoffrey Michael,2,0,34,32
1657718802343,MATH 109,A02,083214,Ganzberger; Geoffrey Michael,4,0,34,30
1657718802343,MATH 109,A03,093478,Ganzberger; Geoffrey Michael,2,0,34,32
1657718802343,MATH 109,B01,083215,Ganzberger; Geoffrey Michael,1,0,32,31
1657718802343,MATH 109,B02,083216,Ganzberger; Geoffrey Michael,2,0,32,30
1657718802343,MATH 109,B03,093479,Ganzberger; Geoffrey Michael,8,0,32,24
1657718808370,MATH 142A,A01,083219,Chow; Bennett,7,0,32,25
1657718808370,MATH 142A,A02,083220,Chow; Bennett,10,0,32,22
1657718808370,MATH 142A,A03,093480,Chow; Bennett,9,0,32,23
1657718808370,MATH 142A,B03,093481,Chow; Bennett,8,0,32,24
1657718808370,MATH 142A,B04,093558,Chow; Bennett,13,0,32,19
1657718808370,MATH 142A,B05,093559,Chow; Bennett,6,0,32,26
1657718814400,MATH 193A,A01,083224,Rotar; Vladimir,8,0,34,26
1657718814400,MATH 193A,A02,083225,Rotar; Vladimir,9,0,34,25
1657718814400,MATH 193A,A03,083781,Rotar; Vladimir,5,0,34,29
1657718814400,MATH 193A,A04,083782,Rotar; Vladimir,10,0,34,24
1657718814400,MATH 193A,A05,093482,Rotar; Vladimir,10,0,34,24
1657718820429,MATH 197,001,091859,McAuley; Julian John,9999,0,9999,0
1657718820429,MATH 197,002,095566,Kedlaya; Kiran S.,9997,0,9999,2
1657718820429,MATH 197,003,095567,Xiao; Ming,9999,0,9999,0
1657718820429,MATH 197,004,095571,Perols; Johan Lars,9998,0,9999,1
1657718827507,COGS 9,A01,083615,Shannon; Kyle Michael,9,0,75,66
1657718833541,COGS 11,A01,083617,Boyle; Mary E. T.,23,0,48,25
1657718839572,COGS 13,A01,083071,Bastos; Amalia Pinkusfeld,11,0,71,60
1657718845600,COGS 14A,A01,092681,Semenuks; Arturs,5,1,100,95
1657718851630,COGS 14B,A01,083073,Cheng; Tzu-Han,6,0,63,57
1657718857654,COGS 17,A01,092677,Semenuks; Arturs,6,0,81,75
1657718863683,COGS 100,A01,083619,Allen; Michael Gordon,17,0,70,53
1657718869710,COGS 101A,A01,083621,Davis; Joshua Daniel,9,0,68,59
1657718875733,COGS 101B,A01,091572,Allen; Michael Gordon,12,0,65,53
1657718881764,COGS 101C,A01,083625,Delgado; Tania,17,0,35,18
1657718887788,COGS 107A,A01,083627,Boyle; Mary E. T.,13,0,60,47
1657718893812,COGS 118A,A01,083075,Gupta; Anjum,21,0,76,55
1657718899837,CSE 3,A50,083646,Miranda; Gregory Joseph,24,0,50,26
1657718905862,CSE 8A,A50,083650,Miranda; Gregory Joseph,17,1,56,39
1657718911887,CSE 11,A01,083080,Cao; Yingjun,6,15,40,34
1657718917920,CSE 12,A01,083652,Krause-Levy; Sophia Louisa,28,1,120,92
1657718923945,CSE 15L,A01,083654,Morris; Justin Loren,9,0,50,41
1657718923945,CSE 15L,A02,083655,Morris; Justin Loren,9,0,50,41
1657718929971,CSE 20,A01,083657,Tran; Khoa Dang,39,0,80,41
1657718935996,CSE 21,A01,095574,Bach; Quang Tran,22,0,48,26
1657718942021,CSE 30,A01,083084,Eldon; John,6,0,80,74
1657718942021,CSE 30,B01,095061,Bhaskar; Nishant,9,0,50,41
1657718948046,CSE 100,A01,083659,Cao; Yingjun,5,4,70,65
1657718954074,CSE 134B,A01,083661,Powell; Thomas Allan,23,0,100,77
1657718960103,CSE 140,A01,083663,Gungor; Onat,15,0,85,70
1657718966127,CSE 140L,A01,083088,Eldon; John,23,0,100,77
1657718972164,CSE 175,A01,083665,Kumar; Rakesh,3,0,25,22
1657718978203,CSE 190,A00,092507,Dubnov; Shlomo,8,0,20,12
1657718984235,ECE 45,A01,083139,Congero; Spencer William,6,0,75,69
1657718990261,ECE 65,A50,083695,Saad; Andrew S,12,0,30,18
1657718990261,ECE 65,A51,095125,Saad; Andrew S,24,0,26,2
1657718996286,ECE 109,A01,091882,Touri; Behrouz,20,0,70,50
1657719002315,ECE 180,A00,083140,Abi Samra; Nicholas Camill,1,0,30,29
1657719002315,ECE 180,B00,083141,Abi Samra; Nicholas Camill,0,0,30,30
1657719008339,MATH 10A,A01,083735,Patchell; Gregory David,2,0,30,28
1657719008339,MATH 10A,A02,083736,Patchell; Gregory David,20,0,30,10
1657719008339,MATH 10A,A03,083737,Patchell; Gregory David,16,0,30,14
1657719014365,MATH 10B,A01,083207,Lim; Seonhee,8,0,34,26
1657719014365,MATH 10B,A02,083208,Lim; Seonhee,9,0,35,26
1657719014365,MATH 10B,A03,093472,Lim; Seonhee,7,0,34,27
1657719014365,MATH 10B,B01,083739,Sinha; Shubham,13,0,30,17
1657719020412,MATH 18,A01,083743,Cinel; Cameron Alexander,8,0,30,22
1657719020412,MATH 18,A02,083744,Cinel; Cameron Alexander,17,0,30,13
1657719020412,MATH 18,A03,083745,Cinel; Cameron Alexander,10,0,30,20
1657719020412,MATH 18,B01,083748,Rideout; David Porter,5,0,37,32
1657719020412,MATH 18,B02,083749,Rideout; David Porter,5,0,36,31
1657719020412,MATH 18,B03,083750,Rideout; David Porter,3,0,37,34
1657719020412,MATH 18,B04,083751,Rideout; David Porter,6,0,36,30
1657719020412,MATH 18,B05,093473,Rideout; David Porter,6,0,36,30
1657719020412,MATH 18,B06,093474,Rideout; David Porter,6,0,36,30
1657719026450,MATH 20A,A01,083754,Zheng; Zequn,14,0,40,26
1657719032475,MATH 20B,A01,083756,Briones; Jor-el Thomas Caparas,4,0,36,32
1657719032475,MATH 20B,A02,083757,Briones; Jor-el Thomas Caparas,1,0,36,35
1657719032475,MATH 20B,A03,093475,Briones; Jor-el Thomas Caparas,2,0,36,34
1657719038499,MATH 20C,A01,083760,Briones; Jor-el Thomas Caparas,1,0,35,34
1657719038499,MATH 20C,A02,083761,Briones; Jor-el Thomas Caparas,8,0,35,27
1657719038499,MATH 20C,A03,093476,Briones; Jor-el Thomas Caparas,0,1,36,36
1657719038499,MATH 20C,B01,083762,Bach; Quang Tran,1,0,30,29
1657719044523,MATH 20D,A01,083765,Tran; Brian Kha,5,0,30,25
1657719044523,MATH 20D,A02,083766,Tran; Brian Kha,5,0,30,25
1657719044523,MATH 20D,A03,083767,Tran; Brian Kha,5,0,30,25
1657719050550,MATH 20E,A01,083771,Ganguly; Soumya,9,0,32,23
1657719050550,MATH 20E,A02,083772,Ganguly; Soumya,6,0,32,26
1657719050550,MATH 20E,B01,083773,Ciotti; Benjamin,20,0,35,15
1657719050550,MATH 20E,B02,083774,Ciotti; Benjamin,18,0,35,17
1657719056580,MATH 103A,A01,083777,Greenfeld; Be'Eri,3,0,36,33
1657719056580,MATH 103A,A02,083778,Greenfeld; Be'Eri,5,0,36,31
1657719056580,MATH 103A,A03,093561,Greenfeld; Be'Eri,6,0,36,30
1657719056580,MATH 103A,B01,083779,Greenfeld; Be'Eri,7,0,36,29
1657719056580,MATH 103A,B02,083780,Greenfeld; Be'Eri,4,0,36,32
1657719056580,MATH 103A,B03,093562,Greenfeld; Be'Eri,3,0,36,33
1657719062608,MATH 105,A01,085443,Carter; Anne Toulson,15,0,35,20
1657719062608,MATH 105,A02,093477,Carter; Anne Toulson,20,0,35,15
1657719068640,MATH 109,A01,083213,Ganzberger; Geoffrey Michael,2,0,34,32
1657719068640,MATH 109,A02,083214,Ganzberger; Geoffrey Michael,4,0,34,30
1657719068640,MATH 109,A03,093478,Ganzberger; Geoffrey Michael,2,0,34,32
1657719068640,MATH 109,B01,083215,Ganzberger; Geoffrey Michael,1,0,32,31
1657719068640,MATH 109,B02,083216,Ganzberger; Geoffrey Michael,2,0,32,30
1657719068640,MATH 109,B03,093479,Ganzberger; Geoffrey Michael,8,0,32,24
1657719074671,MATH 142A,A01,083219,Chow; Bennett,7,0,32,25
1657719074671,MATH 142A,A02,083220,Chow; Bennett,10,0,32,22
1657719074671,MATH 142A,A03,093480,Chow; Bennett,9,0,32,23
1657719074671,MATH 142A,B03,093481,Chow; Bennett,8,0,32,24
1657719074671,MATH 142A,B04,093558,Chow; Bennett,13,0,32,19
1657719074671,MATH 142A,B05,093559,Chow; Bennett,6,0,32,26
1657719080704,MATH 193A,A01,083224,Rotar; Vladimir,8,0,34,26
1657719080704,MATH 193A,A02,083225,Rotar; Vladimir,9,0,34,25
1657719080704,MATH 193A,A03,083781,Rotar; Vladimir,5,0,34,29
1657719080704,MATH 193A,A04,083782,Rotar; Vladimir,10,0,34,24
1657719080704,MATH 193A,A05,093482,Rotar; Vladimir,10,0,34,24
1657719086728,MATH 197,001,091859,McAuley; Julian John,9999,0,9999,0
1657719086728,MATH 197,002,095566,Kedlaya; Kiran S.,9997,0,9999,2
1657719086728,MATH 197,003,095567,Xiao; Ming,9999,0,9999,0
1657719086728,MATH 197,004,095571,Perols; Johan Lars,9998,0,9999,1
1657719093803,COGS 9,A01,083615,Shannon; Kyle Michael,9,0,75,66
1657719099827,COGS 11,A01,083617,Boyle; Mary E. T.,23,0,48,25
1657719105857,COGS 13,A01,083071,Bastos; Amalia Pinkusfeld,11,0,71,60
1657719111886,COGS 14A,A01,092681,Semenuks; Arturs,5,1,100,95
1657719117909,COGS 14B,A01,083073,Cheng; Tzu-Han,6,0,63,57
1657719123954,COGS 17,A01,092677,Semenuks; Arturs,6,0,81,75
1657719129977,COGS 100,A01,083619,Allen; Michael Gordon,17,0,70,53
1657719136003,COGS 101A,A01,083621,Davis; Joshua Daniel,9,0,68,59
1657719142027,COGS 101B,A01,091572,Allen; Michael Gordon,12,0,65,53
1657719148053,COGS 101C,A01,083625,Delgado; Tania,17,0,35,18
1657719154089,COGS 107A,A01,083627,Boyle; Mary E. T.,13,0,60,47
1657719160119,COGS 118A,A01,083075,Gupta; Anjum,21,0,76,55
1657719166152,CSE 3,A50,083646,Miranda; Gregory Joseph,24,0,50,26
1657719172182,CSE 8A,A50,083650,Miranda; Gregory Joseph,17,1,56,39
1657719178211,CSE 11,A01,083080,Cao; Yingjun,6,15,40,34
1657719184311,CSE 12,A01,083652,Krause-Levy; Sophia Louisa,28,1,120,92
1657719190337,CSE 15L,A01,083654,Morris; Justin Loren,9,0,50,41
1657719190337,CSE 15L,A02,083655,Morris; Justin Loren,9,0,50,41
1657719196362,CSE 20,A01,083657,Tran; Khoa Dang,39,0,80,41
1657719202387,CSE 21,A01,095574,Bach; Quang Tran,22,0,48,26
1657719208413,CSE 30,A01,083084,Eldon; John,6,0,80,74
1657719208413,CSE 30,B01,095061,Bhaskar; Nishant,9,0,50,41
1657719214440,CSE 100,A01,083659,Cao; Yingjun,5,4,70,65
1657719220464,CSE 134B,A01,083661,Powell; Thomas Allan,23,0,100,77
1657719226488,CSE 140,A01,083663,Gungor; Onat,15,0,85,70
1657719232517,CSE 140L,A01,083088,Eldon; John,23,0,100,77
1657719238542,CSE 175,A01,083665,Kumar; Rakesh,3,0,25,22
1657719244568,CSE 190,A00,092507,Dubnov; Shlomo,8,0,20,12
1657719250600,ECE 45,A01,083139,Congero; Spencer William,6,0,75,69
1657719256632,ECE 65,A50,083695,Saad; Andrew S,12,0,30,18
1657719256632,ECE 65,A51,095125,Saad; Andrew S,24,0,26,2
1657719262657,ECE 109,A01,091882,Touri; Behrouz,20,0,70,50
1657719268681,ECE 180,A00,083140,Abi Samra; Nicholas Camill,1,0,30,29
1657719268681,ECE 180,B00,083141,Abi Samra; Nicholas Camill,0,0,30,30
1657719274719,MATH 10A,A01,083735,Patchell; Gregory David,2,0,30,28
1657719274719,MATH 10A,A02,083736,Patchell; Gregory David,20,0,30,10
1657719274719,MATH 10A,A03,083737,Patchell; Gregory David,16,0,30,14
1657719280743,MATH 10B,A01,083207,Lim; Seonhee,8,0,34,26
1657719280743,MATH 10B,A02,083208,Lim; Seonhee,9,0,35,26
1657719280743,MATH 10B,A03,093472,Lim; Seonhee,7,0,34,27
1657719280743,MATH 10B,B01,083739,Sinha; Shubham,13,0,30,17
1657719286775,MATH 18,A01,083743,Cinel; Cameron Alexander,8,0,30,22
1657719286775,MATH 18,A02,083744,Cinel; Cameron Alexander,17,0,30,13
1657719286775,MATH 18,A03,083745,Cinel; Cameron Alexander,10,0,30,20
1657719286775,MATH 18,B01,083748,Rideout; David Porter,5,0,37,32
1657719286775,MATH 18,B02,083749,Rideout; David Porter,5,0,36,31
1657719286775,MATH 18,B03,083750,Rideout; David Porter,3,0,37,34
1657719286775,MATH 18,B04,083751,Rideout; David Porter,6,0,36,30
1657719286775,MATH 18,B05,093473,Rideout; David Porter,6,0,36,30
1657719286775,MATH 18,B06,093474,Rideout; David Porter,6,0,36,30
1657719292799,MATH 20A,A01,083754,Zheng; Zequn,14,0,40,26
1657719298828,MATH 20B,A01,083756,Briones; Jor-el Thomas Caparas,4,0,36,32
1657719298828,MATH 20B,A02,083757,Briones; Jor-el Thomas Caparas,1,0,36,35
1657719298828,MATH 20B,A03,093475,Briones; Jor-el Thomas Caparas,2,0,36,34
1657719304859,MATH 20C,A01,083760,Briones; Jor-el Thomas Caparas,1,0,35,34
1657719304859,MATH 20C,A02,083761,Briones; Jor-el Thomas Caparas,8,0,35,27
1657719304859,MATH 20C,A03,093476,Briones; Jor-el Thomas Caparas,0,1,36,36
1657719304859,MATH 20C,B01,083762,Bach; Quang Tran,1,0,30,29
1657719310882,MATH 20D,A01,083765,Tran; Brian Kha,5,0,30,25
1657719310882,MATH 20D,A02,083766,Tran; Brian Kha,5,0,30,25
1657719310882,MATH 20D,A03,083767,Tran; Brian Kha,5,0,30,25
1657719316908,MATH 20E,A01,083771,Ganguly; Soumya,9,0,32,23
1657719316908,MATH 20E,A02,083772,Ganguly; Soumya,6,0,32,26
1657719316908,MATH 20E,B01,083773,Ciotti; Benjamin,20,0,35,15
1657719316908,MATH 20E,B02,083774,Ciotti; Benjamin,18,0,35,17
1657719322935,MATH 103A,A01,083777,Greenfeld; Be'Eri,3,0,36,33
1657719322935,MATH 103A,A02,083778,Greenfeld; Be'Eri,5,0,36,31
1657719322935,MATH 103A,A03,093561,Greenfeld; Be'Eri,6,0,36,30
1657719322935,MATH 103A,B01,083779,Greenfeld; Be'Eri,7,0,36,29
1657719322935,MATH 103A,B02,083780,Greenfeld; Be'Eri,4,0,36,32
1657719322935,MATH 103A,B03,093562,Greenfeld; Be'Eri,3,0,36,33
1657719328960,MATH 105,A01,085443,Carter; Anne Toulson,15,0,35,20
1657719328960,MATH 105,A02,093477,Carter; Anne Toulson,20,0,35,15
1657719334989,MATH 109,A01,083213,Ganzberger; Geoffrey Michael,2,0,34,32
1657719334989,MATH 109,A02,083214,Ganzberger; Geoffrey Michael,4,0,34,30
1657719334989,MATH 109,A03,093478,Ganzberger; Geoffrey Michael,2,0,34,32
1657719334989,MATH 109,B01,083215,Ganzberger; Geoffrey Michael,1,0,32,31
1657719334989,MATH 109,B02,083216,Ganzberger; Geoffrey Michael,2,0,32,30
1657719334989,MATH 109,B03,093479,Ganzberger; Geoffrey Michael,8,0,32,24
1657719341019,MATH 142A,A01,083219,Chow; Bennett,7,0,32,25
1657719341019,MATH 142A,A02,083220,Chow; Bennett,10,0,32,22
1657719341019,MATH 142A,A03,093480,Chow; Bennett,9,0,32,23
1657719341019,MATH 142A,B03,093481,Chow; Bennett,8,0,32,24
1657719341019,MATH 142A,B04,093558,Chow; Bennett,13,0,32,19
1657719341019,MATH 142A,B05,093559,Chow; Bennett,6,0,32,26
1657719347049,MATH 193A,A01,083224,Rotar; Vladimir,8,0,34,26
1657719347049,MATH 193A,A02,083225,Rotar; Vladimir,9,0,34,25
1657719347049,MATH 193A,A03,083781,Rotar; Vladimir,5,0,34,29
1657719347049,MATH 193A,A04,083782,Rotar; Vladimir,10,0,34,24
1657719347049,MATH 193A,A05,093482,Rotar; Vladimir,10,0,34,24
1657719353077,MATH 197,001,091859,McAuley; Julian John,9999,0,9999,0
1657719353077,MATH 197,002,095566,Kedlaya; Kiran S.,9997,0,9999,2
1657719353077,MATH 197,003,095567,Xiao; Ming,9999,0,9999,0
1657719353077,MATH 197,004,095571,Perols; Johan Lars,9998,0,9999,1
1657719360141,COGS 9,A01,083615,Shannon; Kyle Michael,9,0,75,66
1657719366170,COGS 11,A01,083617,Boyle; Mary E. T.,23,0,48,25
1657719372194,COGS 13,A01,083071,Bastos; Amalia Pinkusfeld,11,0,71,60
1657719378224,COGS 14A,A01,092681,Semenuks; Arturs,5,1,100,95
1657719384248,COGS 14B,A01,083073,Cheng; Tzu-Han,6,0,63,57
1657719390272,COGS 17,A01,092677,Semenuks; Arturs,6,0,81,75
1657719396296,COGS 100,A01,083619,Allen; Michael Gordon,17,0,70,53
1657719402323,COGS 101A,A01,083621,Davis; Joshua Daniel,9,0,68,59
1657719408353,COGS 101B,A01,091572,Allen; Michael Gordon,12,0,65,53
1657719414383,COGS 101C,A01,083625,Delgado; Tania,17,0,35,18
1657719420411,COGS 107A,A01,083627,Boyle; Mary E. T.,13,0,60,47
1657719426436,COGS 118A,A01,083075,Gupta; Anjum,21,0,76,55
1657719432471,CSE 3,A50,083646,Miranda; Gregory Joseph,24,0,50,26
1657719438498,CSE 8A,A50,083650,Miranda; Gregory Joseph,17,1,56,39
1657719444524,CSE 11,A01,083080,Cao; Yingjun,6,15,40,34
1657719450553,CSE 12,A01,083652,Krause-Levy; Sophia Louisa,28,1,120,92
1657719456577,CSE 15L,A01,083654,Morris; Justin Loren,9,0,50,41
1657719456577,CSE 15L,A02,083655,Morris; Justin Loren,9,0,50,41
1657719462603,CSE 20,A01,083657,Tran; Khoa Dang,39,0,80,41
1657719468631,CSE 21,A01,095574,Bach; Quang Tran,22,0,48,26
1657719474660,CSE 30,A01,083084,Eldon; John,6,0,80,74
1657719474660,CSE 30,B01,095061,Bhaskar; Nishant,9,0,50,41
1657719480690,CSE 100,A01,083659,Cao; Yingjun,5,4,70,65
1657719486715,CSE 134B,A01,083661,Powell; Thomas Allan,23,0,100,77
1657719492737,CSE 140,A01,083663,Gungor; Onat,15,0,85,70
1657719498764,CSE 140L,A01,083088,Eldon; John,23,0,100,77
1657719504787,CSE 175,A01,083665,Kumar; Rakesh,3,0,25,22
1657719510813,CSE 190,A00,092507,Dubnov; Shlomo,8,0,20,12
1657719516839,ECE 45,A01,083139,Congero; Spencer William,6,0,75,69
1657719522868,ECE 65,A50,083695,Saad; Andrew S,12,0,30,18
1657719522868,ECE 65,A51,095125,Saad; Andrew S,24,0,26,2
1657719528891,ECE 109,A01,091882,Touri; Behrouz,20,0,70,50
1657719534923,ECE 180,A00,083140,Abi Samra; Nicholas Camill,1,0,30,29
1657719534923,ECE 180,B00,083141,Abi Samra; Nicholas Camill,0,0,30,30
1657719540947,MATH 10A,A01,083735,Patchell; Gregory David,2,0,30,28
1657719540947,MATH 10A,A02,083736,Patchell; Gregory David,20,0,30,10
1657719540947,MATH 10A,A03,083737,Patchell; Gregory David,16,0,30,14
1657719546971,MATH 10B,A01,083207,Lim; Seonhee,8,0,34,26
1657719546971,MATH 10B,A02,083208,Lim; Seonhee,9,0,35,26
1657719546971,MATH 10B,A03,093472,Lim; Seonhee,7,0,34,27
1657719546971,MATH 10B,B01,083739,Sinha; Shubham,13,0,30,17
1657719553004,MATH 18,A01,083743,Cinel; Cameron Alexander,8,0,30,22
1657719553004,MATH 18,A02,083744,Cinel; Cameron Alexander,17,0,30,13
1657719553004,MATH 18,A03,083745,Cinel; Cameron Alexander,10,0,30,20
1657719553004,MATH 18,B01,083748,Rideout; David Porter,5,0,37,32
1657719553004,MATH 18,B02,083749,Rideout; David Porter,5,0,36,31
1657719553004,MATH 18,B03,083750,Rideout; David Porter,3,0,37,34
1657719553004,MATH 18,B04,083751,Rideout; David Porter,6,0,36,30
1657719553004,MATH 18,B05,093473,Rideout; David Porter,6,0,36,30
1657719553004,MATH 18,B06,093474,Rideout; David Porter,6,0,36,30
1657719559036,MATH 20A,A01,083754,Zheng; Zequn,14,0,40,26
1657719565065,MATH 20B,A01,083756,Briones; Jor-el Thomas Caparas,4,0,36,32
1657719565065,MATH 20B,A02,083757,Briones; Jor-el Thomas Caparas,1,0,36,35
1657719565065,MATH 20B,A03,093475,Briones; Jor-el Thomas Caparas,2,0,36,34
1657719571095,MATH 20C,A01,083760,Briones; Jor-el Thomas Caparas,1,0,35,34
1657719571095,MATH 20C,A02,083761,Briones; Jor-el Thomas Caparas,8,0,35,27
1657719571095,MATH 20C,A03,093476,Briones; Jor-el Thomas Caparas,0,1,36,36
1657719571095,MATH 20C,B01,083762,Bach; Quang Tran,1,0,30,29
1657719577121,MATH 20D,A01,083765,Tran; Brian Kha,5,0,30,25
1657719577121,MATH 20D,A02,083766,Tran; Brian Kha,5,0,30,25
1657719577121,MATH 20D,A03,083767,Tran; Brian Kha,5,0,30,25
1657719583149,MATH 20E,A01,083771,Ganguly; Soumya,9,0,32,23
1657719583149,MATH 20E,A02,083772,Ganguly; Soumya,6,0,32,26
1657719583149,MATH 20E,B01,083773,Ciotti; Benjamin,20,0,35,15
1657719583149,MATH 20E,B02,083774,Ciotti; Benjamin,18,0,35,17
1657719589175,MATH 103A,A01,083777,Greenfeld; Be'Eri,3,0,36,33
1657719589175,MATH 103A,A02,083778,Greenfeld; Be'Eri,5,0,36,31
1657719589175,MATH 103A,A03,093561,Greenfeld; Be'Eri,6,0,36,30
1657719589175,MATH 103A,B01,083779,Greenfeld; Be'Eri,7,0,36,29
1657719589175,MATH 103A,B02,083780,Greenfeld; Be'Eri,4,0,36,32
1657719589175,MATH 103A,B03,093562,Greenfeld; Be'Eri,3,0,36,33
1657719595216,MATH 105,A01,085443,Carter; Anne Toulson,15,0,35,20
1657719595216,MATH 105,A02,093477,Carter; Anne Toulson,20,0,35,15
1657719601246,MATH 109,A01,083213,Ganzberger; Geoffrey Michael,2,0,34,32
1657719601246,MATH 109,A02,083214,Ganzberger; Geoffrey Michael,4,0,34,30
1657719601246,MATH 109,A03,093478,Ganzberger; Geoffrey Michael,2,0,34,32
1657719601246,MATH 109,B01,083215,Ganzberger; Geoffrey Michael,1,0,32,31
1657719601246,MATH 109,B02,083216,Ganzberger; Geoffrey Michael,2,0,32,30
1657719601246,MATH 109,B03,093479,Ganzberger; Geoffrey Michael,8,0,32,24
1657719607269,MATH 142A,A01,083219,Chow; Bennett,7,0,32,25
1657719607269,MATH 142A,A02,083220,Chow; Bennett,10,0,32,22
1657719607269,MATH 142A,A03,093480,Chow; Bennett,9,0,32,23
1657719607269,MATH 142A,B03,093481,Chow; Bennett,8,0,32,24
1657719607269,MATH 142A,B04,093558,Chow; Bennett,13,0,32,19
1657719607269,MATH 142A,B05,093559,Chow; Bennett,6,0,32,26
1657719613307,MATH 193A,A01,083224,Rotar; Vladimir,8,0,34,26
1657719613307,MATH 193A,A02,083225,Rotar; Vladimir,9,0,34,25
1657719613307,MATH 193A,A03,083781,Rotar; Vladimir,5,0,34,29
1657719613307,MATH 193A,A04,083782,Rotar; Vladimir,10,0,34,24
1657719613307,MATH 193A,A05,093482,Rotar; Vladimir,10,0,34,24
1657719619329,MATH 197,001,091859,McAuley; Julian John,9999,0,9999,0
1657719619329,MATH 197,002,095566,Kedlaya; Kiran S.,9997,0,9999,2
1657719619329,MATH 197,003,095567,Xiao; Ming,9999,0,9999,0
1657719619329,MATH 197,004,095571,Perols; Johan Lars,9998,0,9999,1
1657719626392,COGS 9,A01,083615,Shannon; Kyle Michael,9,0,75,66
1657719632422,COGS 11,A01,083617,Boyle; Mary E. T.,23,0,48,25
1657719638444,COGS 13,A01,083071,Bastos; Amalia Pinkusfeld,11,0,71,60
1657719644473,COGS 14A,A01,092681,Semenuks; Arturs,5,1,100,95
1657719650497,COGS 14B,A01,083073,Cheng; Tzu-Han,6,0,63,57
1657719656536,COGS 17,A01,092677,Semenuks; Arturs,6,0,81,75
1657719662560,COGS 100,A01,083619,Allen; Michael Gordon,17,0,70,53
1657719668585,COGS 101A,A01,083621,Davis; Joshua Daniel,9,0,68,59
1657719674610,COGS 101B,A01,091572,Allen; Michael Gordon,12,0,65,53
1657719680636,COGS 101C,A01,083625,Delgado; Tania,17,0,35,18
1657719686660,COGS 107A,A01,083627,Boyle; Mary E. T.,13,0,60,47
1657719692685,COGS 118A,A01,083075,Gupta; Anjum,21,0,76,55
1657719698714,CSE 3,A50,083646,Miranda; Gregory Joseph,24,0,50,26
1657719704742,CSE 8A,A50,083650,Miranda; Gregory Joseph,17,1,56,39
1657719710766,CSE 11,A01,083080,Cao; Yingjun,6,15,40,34
1657719716800,CSE 12,A01,083652,Krause-Levy; Sophia Louisa,28,1,120,92
1657719722834,CSE 15L,A01,083654,Morris; Justin Loren,9,0,50,41
1657719722834,CSE 15L,A02,083655,Morris; Justin Loren,9,0,50,41
1657719728856,CSE 20,A01,083657,Tran; Khoa Dang,39,0,80,41
1657719734884,CSE 21,A01,095574,Bach; Quang Tran,22,0,48,26
1657719740908,CSE 30,A01,083084,Eldon; John,6,0,80,74
1657719740908,CSE 30,B01,095061,Bhaskar; Nishant,9,0,50,41
1657719746937,CSE 100,A01,083659,Cao; Yingjun,5,4,70,65
1657719752964,CSE 134B,A01,083661,Powell; Thomas Allan,23,0,100,77
1657719758990,CSE 140,A01,083663,Gungor; Onat,15,0,85,70
1657719765013,CSE 140L,A01,083088,Eldon; John,23,0,100,77
1657719771038,CSE 175,A01,083665,Kumar; Rakesh,3,0,25,22
1657719777062,CSE 190,A00,092507,Dubnov; Shlomo,8,0,20,12
1657719783201,ECE 45,A01,083139,Congero; Spencer William,6,0,75,69
1657719789226,ECE 65,A50,083695,Saad; Andrew S,12,0,30,18
1657719789226,ECE 65,A51,095125,Saad; Andrew S,24,0,26,2
1657719795264,ECE 109,A01,091882,Touri; Behrouz,20,0,70,50
1657719801296,ECE 180,A00,083140,Abi Samra; Nicholas Camill,1,0,30,29
1657719801296,ECE 180,B00,083141,Abi Samra; Nicholas Camill,0,0,30,30
1657719807321,MATH 10A,A01,083735,Patchell; Gregory David,2,0,30,28
1657719807321,MATH 10A,A02,083736,Patchell; Gregory David,20,0,30,10
1657719807321,MATH 10A,A03,083737,Patchell; Gregory David,16,0,30,14
1657719813348,MATH 10B,A01,083207,Lim; Seonhee,8,0,34,26
1657719813348,MATH 10B,A02,083208,Lim; Seonhee,9,0,35,26
1657719813348,MATH 10B,A03,093472,Lim; Seonhee,7,0,34,27
1657719813348,MATH 10B,B01,083739,Sinha; Shubham,13,0,30,17
1657719819381,MATH 18,A01,083743,Cinel; Cameron Alexander,8,0,30,22
1657719819381,MATH 18,A02,083744,Cinel; Cameron Alexander,17,0,30,13
1657719819381,MATH 18,A03,083745,Cinel; Cameron Alexander,10,0,30,20
1657719819381,MATH 18,B01,083748,Rideout; David Porter,5,0,37,32
1657719819381,MATH 18,B02,083749,Rideout; David Porter,5,0,36,31
1657719819381,MATH 18,B03,083750,Rideout; David Porter,3,0,37,34
1657719819381,MATH 18,B04,083751,Rideout; David Porter,6,0,36,30
1657719819381,MATH 18,B05,093473,Rideout; David Porter,6,0,36,30
1657719819381,MATH 18,B06,093474,Rideout; David Porter,6,0,36,30
1657719825408,MATH 20A,A01,083754,Zheng; Zequn,14,0,40,26
1657719831440,MATH 20B,A01,083756,Briones; Jor-el Thomas Caparas,4,0,36,32
1657719831440,MATH 20B,A02,083757,Briones; Jor-el Thomas Caparas,1,0,36,35
1657719831440,MATH 20B,A03,093475,Briones; Jor-el Thomas Caparas,2,0,36,34
1657719837463,MATH 20C,A01,083760,Briones; Jor-el Thomas Caparas,1,0,35,34
1657719837463,MATH 20C,A02,083761,Briones; Jor-el Thomas Caparas,8,0,35,27
1657719837463,MATH 20C,A03,093476,Briones; Jor-el Thomas Caparas,0,1,36,36
1657719837463,MATH 20C,B01,083762,Bach; Quang Tran,1,0,30,29
1657719843488,MATH 20D,A01,083765,Tran; Brian Kha,5,0,30,25
1657719843488,MATH 20D,A02,083766,Tran; Brian Kha,5,0,30,25
1657719843488,MATH 20D,A03,083767,Tran; Brian Kha,5,0,30,25
1657719849518,MATH 20E,A01,083771,Ganguly; Soumya,9,0,32,23
1657719849518,MATH 20E,A02,083772,Ganguly; Soumya,6,0,32,26
1657719849518,MATH 20E,B01,083773,Ciotti; Benjamin,20,0,35,15
1657719849518,MATH 20E,B02,083774,Ciotti; Benjamin,18,0,35,17
1657719855550,MATH 103A,A01,083777,Greenfeld; Be'Eri,3,0,36,33
1657719855550,MATH 103A,A02,083778,Greenfeld; Be'Eri,5,0,36,31
1657719855550,MATH 103A,A03,093561,Greenfeld; Be'Eri,6,0,36,30
1657719855550,MATH 103A,B01,083779,Greenfeld; Be'Eri,7,0,36,29
1657719855550,MATH 103A,B02,083780,Greenfeld; Be'Eri,4,0,36,32
1657719855550,MATH 103A,B03,093562,Greenfeld; Be'Eri,3,0,36,33
1657719861575,MATH 105,A01,085443,Carter; Anne Toulson,15,0,35,20
1657719861575,MATH 105,A02,093477,Carter; Anne Toulson,20,0,35,15
1657719867604,MATH 109,A01,083213,Ganzberger; Geoffrey Michael,2,0,34,32
1657719867604,MATH 109,A02,083214,Ganzberger; Geoffrey Michael,4,0,34,30
1657719867604,MATH 109,A03,093478,Ganzberger; Geoffrey Michael,2,0,34,32
1657719867604,MATH 109,B01,083215,Ganzberger; Geoffrey Michael,1,0,32,31
1657719867604,MATH 109,B02,083216,Ganzberger; Geoffrey Michael,2,0,32,30
1657719867604,MATH 109,B03,093479,Ganzberger; Geoffrey Michael,8,0,32,24
1657719873632,MATH 142A,A01,083219,Chow; Bennett,7,0,32,25
1657719873632,MATH 142A,A02,083220,Chow; Bennett,10,0,32,22
1657719873632,MATH 142A,A03,093480,Chow; Bennett,9,0,32,23
1657719873632,MATH 142A,B03,093481,Chow; Bennett,8,0,32,24
1657719873632,MATH 142A,B04,093558,Chow; Bennett,13,0,32,19
1657719873632,MATH 142A,B05,093559,Chow; Bennett,6,0,32,26
1657719879662,MATH 193A,A01,083224,Rotar; Vladimir,8,0,34,26
1657719879662,MATH 193A,A02,083225,Rotar; Vladimir,9,0,34,25
1657719879662,MATH 193A,A03,083781,Rotar; Vladimir,5,0,34,29
1657719879662,MATH 193A,A04,083782,Rotar; Vladimir,10,0,34,24
1657719879662,MATH 193A,A05,093482,Rotar; Vladimir,10,0,34,24
1657719885687,MATH 197,001,091859,McAuley; Julian John,9999,0,9999,0
1657719885687,MATH 197,002,095566,Kedlaya; Kiran S.,9997,0,9999,2
1657719885687,MATH 197,003,095567,Xiao; Ming,9999,0,9999,0
1657719885687,MATH 197,004,095571,Perols; Johan Lars,9998,0,9999,1
1657719892746,COGS 9,A01,083615,Shannon; Kyle Michael,9,0,75,66
1657719898771,COGS 11,A01,083617,Boyle; Mary E. T.,23,0,48,25
1657719904797,COGS 13,A01,083071,Bastos; Amalia Pinkusfeld,11,0,71,60
1657719910824,COGS 14A,A01,092681,Semenuks; Arturs,5,1,100,95
1657719916847,COGS 14B,A01,083073,Cheng; Tzu-Han,6,0,63,57
1657719922870,COGS 17,A01,092677,Semenuks; Arturs,6,0,81,75
1657719928894,COGS 100,A01,083619,Allen; Michael Gordon,17,0,70,53
1657719934927,COGS 101A,A01,083621,Davis; Joshua Daniel,9,0,68,59
1657719940950,COGS 101B,A01,091572,Allen; Michael Gordon,12,0,65,53
1657719946974,COGS 101C,A01,083625,Delgado; Tania,17,0,35,18
1657719953002,COGS 107A,A01,083627,Boyle; Mary E. T.,13,0,60,47
1657719959027,COGS 118A,A01,083075,Gupta; Anjum,21,0,76,55
1657719965050,CSE 3,A50,083646,Miranda; Gregory Joseph,24,0,50,26
1657719971075,CSE 8A,A50,083650,Miranda; Gregory Joseph,17,1,56,39
1657719977103,CSE 11,A01,083080,Cao; Yingjun,6,15,40,34
1657719983132,CSE 12,A01,083652,Krause-Levy; Sophia Louisa,28,1,120,92
1657719989155,CSE 15L,A01,083654,Morris; Justin Loren,9,0,50,41
1657719989155,CSE 15L,A02,083655,Morris; Justin Loren,9,0,50,41
1657719995182,CSE 20,A01,083657,Tran; Khoa Dang,39,0,80,41
1657720001208,CSE 21,A01,095574,Bach; Quang Tran,22,0,48,26
1657720007236,CSE 30,A01,083084,Eldon; John,6,0,80,74
1657720007236,CSE 30,B01,095061,Bhaskar; Nishant,9,0,50,41
1657720013261,CSE 100,A01,083659,Cao; Yingjun,5,4,70,65
1657720019290,CSE 134B,A01,083661,Powell; Thomas Allan,23,0,100,77
1657720025318,CSE 140,A01,083663,Gungor; Onat,15,0,85,70
1657720031342,CSE 140L,A01,083088,Eldon; John,23,0,100,77
1657720037367,CSE 175,A01,083665,Kumar; Rakesh,3,0,25,22
1657720043390,CSE 190,A00,092507,Dubnov; Shlomo,8,0,20,12
1657720049414,ECE 45,A01,083139,Congero; Spencer William,6,0,75,69
1657720055438,ECE 65,A50,083695,Saad; Andrew S,12,0,30,18
1657720055438,ECE 65,A51,095125,Saad; Andrew S,24,0,26,2
1657720061463,ECE 109,A01,091882,Touri; Behrouz,20,0,70,50
1657720067493,ECE 180,A00,083140,Abi Samra; Nicholas Camill,1,0,30,29
1657720067493,ECE 180,B00,083141,Abi Samra; Nicholas Camill,0,0,30,30
1657720073517,MATH 10A,A01,083735,Patchell; Gregory David,2,0,30,28
1657720073517,MATH 10A,A02,083736,Patchell; Gregory David,20,0,30,10
1657720073517,MATH 10A,A03,083737,Patchell; Gregory David,16,0,30,14
1657720079543,MATH 10B,A01,083207,Lim; Seonhee,8,0,34,26
1657720079543,MATH 10B,A02,083208,Lim; Seonhee,9,0,35,26
1657720079543,MATH 10B,A03,093472,Lim; Seonhee,7,0,34,27
1657720079543,MATH 10B,B01,083739,Sinha; Shubham,13,0,30,17
1657720085572,MATH 18,A01,083743,Cinel; Cameron Alexander,8,0,30,22
1657720085572,MATH 18,A02,083744,Cinel; Cameron Alexander,17,0,30,13
1657720085572,MATH 18,A03,083745,Cinel; Cameron Alexander,10,0,30,20
1657720085572,MATH 18,B01,083748,Rideout; David Porter,5,0,37,32
1657720085572,MATH 18,B02,083749,Rideout; David Porter,5,0,36,31
1657720085572,MATH 18,B03,083750,Rideout; David Porter,3,0,37,34
1657720085572,MATH 18,B04,083751,Rideout; David Porter,6,0,36,30
1657720085572,MATH 18,B05,093473,Rideout; David Porter,6,0,36,30
1657720085572,MATH 18,B06,093474,Rideout; David Porter,6,0,36,30
1657720091600,MATH 20A,A01,083754,Zheng; Zequn,14,0,40,26
1657720097625,MATH 20B,A01,083756,Briones; Jor-el Thomas Caparas,4,0,36,32
1657720097625,MATH 20B,A02,083757,Briones; Jor-el Thomas Caparas,1,0,36,35
1657720097625,MATH 20B,A03,093475,Briones; Jor-el Thomas Caparas,2,0,36,34
1657720103649,MATH 20C,A01,083760,Briones; Jor-el Thomas Caparas,1,0,35,34
1657720103649,MATH 20C,A02,083761,Briones; Jor-el Thomas Caparas,8,0,35,27
1657720103649,MATH 20C,A03,093476,Briones; Jor-el Thomas Caparas,0,1,36,36
1657720103649,MATH 20C,B01,083762,Bach; Quang Tran,1,0,30,29
1657720109672,MATH 20D,A01,083765,Tran; Brian Kha,5,0,30,25
1657720109672,MATH 20D,A02,083766,Tran; Brian Kha,5,0,30,25
1657720109672,MATH 20D,A03,083767,Tran; Brian Kha,5,0,30,25
1657720115701,MATH 20E,A01,083771,Ganguly; Soumya,9,0,32,23
1657720115701,MATH 20E,A02,083772,Ganguly; Soumya,6,0,32,26
1657720115701,MATH 20E,B01,083773,Ciotti; Benjamin,20,0,35,15
1657720115701,MATH 20E,B02,083774,Ciotti; Benjamin,18,0,35,17
1657720121743,MATH 103A,A01,083777,Greenfeld; Be'Eri,3,0,36,33
1657720121743,MATH 103A,A02,083778,Greenfeld; Be'Eri,5,0,36,31
1657720121743,MATH 103A,A03,093561,Greenfeld; Be'Eri,6,0,36,30
1657720121743,MATH 103A,B01,083779,Greenfeld; Be'Eri,7,0,36,29
1657720121743,MATH 103A,B02,083780,Greenfeld; Be'Eri,4,0,36,32
1657720121743,MATH 103A,B03,093562,Greenfeld; Be'Eri,3,0,36,33
1657720127768,MATH 105,A01,085443,Carter; Anne Toulson,15,0,35,20
1657720127768,MATH 105,A02,093477,Carter; Anne Toulson,20,0,35,15
1657720133798,MATH 109,A01,083213,Ganzberger; Geoffrey Michael,2,0,34,32
1657720133798,MATH 109,A02,083214,Ganzberger; Geoffrey Michael,4,0,34,30
1657720133798,MATH 109,A03,093478,Ganzberger; Geoffrey Michael,2,0,34,32
1657720133798,MATH 109,B01,083215,Ganzberger; Geoffrey Michael,1,0,32,31
1657720133798,MATH 109,B02,083216,Ganzberger; Geoffrey Michael,2,0,32,30
1657720133798,MATH 109,B03,093479,Ganzberger; Geoffrey Michael,8,0,32,24
1657720139826,MATH 142A,A01,083219,Chow; Bennett,7,0,32,25
1657720139826,MATH 142A,A02,083220,Chow; Bennett,10,0,32,22
1657720139826,MATH 142A,A03,093480,Chow; Bennett,9,0,32,23
1657720139826,MATH 142A,B03,093481,Chow; Bennett,8,0,32,24
1657720139826,MATH 142A,B04,093558,Chow; Bennett,13,0,32,19
1657720139826,MATH 142A,B05,093559,Chow; Bennett,6,0,32,26
1657720145849,MATH 193A,A01,083224,Rotar; Vladimir,8,0,34,26
1657720145849,MATH 193A,A02,083225,Rotar; Vladimir,9,0,34,25
1657720145849,MATH 193A,A03,083781,Rotar; Vladimir,5,0,34,29
1657720145849,MATH 193A,A04,083782,Rotar; Vladimir,10,0,34,24
1657720145849,MATH 193A,A05,093482,Rotar; Vladimir,10,0,34,24
1657720151877,MATH 197,001,091859,McAuley; Julian John,9999,0,9999,0
1657720151877,MATH 197,002,095566,Kedlaya; Kiran S.,9997,0,9999,2
1657720151877,MATH 197,003,095567,Xiao; Ming,9999,0,9999,0
1657720151877,MATH 197,004,095571,Perols; Johan Lars,9998,0,9999,1
1657720158932,COGS 9,A01,083615,Shannon; Kyle Michael,9,0,75,66
1657720164959,COGS 11,A01,083617,Boyle; Mary E. T.,23,0,48,25
1657720170982,COGS 13,A01,083071,Bastos; Amalia Pinkusfeld,11,0,71,60
1657720177011,COGS 14A,A01,092681,Semenuks; Arturs,5,1,100,95
1657720183034,COGS 14B,A01,083073,Cheng; Tzu-Han,6,0,63,57
1657720189060,COGS 17,A01,092677,Semenuks; Arturs,6,0,81,75
1657720195091,COGS 100,A01,083619,Allen; Michael Gordon,17,0,70,53
1657720201117,COGS 101A,A01,083621,Davis; Joshua Daniel,9,0,68,59
1657720207143,COGS 101B,A01,091572,Allen; Michael Gordon,12,0,65,53
1657720213169,COGS 101C,A01,083625,Delgado; Tania,17,0,35,18
1657720219201,COGS 107A,A01,083627,Boyle; Mary E. T.,13,0,60,47
1657720225230,COGS 118A,A01,083075,Gupta; Anjum,21,0,76,55
1657720231252,CSE 3,A50,083646,Miranda; Gregory Joseph,24,0,50,26
1657720237278,CSE 8A,A50,083650,Miranda; Gregory Joseph,17,1,56,39
1657720243305,CSE 11,A01,083080,Cao; Yingjun,6,15,40,34
1657720249334,CSE 12,A01,083652,Krause-Levy; Sophia Louisa,28,1,120,92
1657720255364,CSE 15L,A01,083654,Morris; Justin Loren,9,0,50,41
1657720255364,CSE 15L,A02,083655,Morris; Justin Loren,9,0,50,41
1657720261387,CSE 20,A01,083657,Tran; Khoa Dang,39,0,80,41
1657720267418,CSE 21,A01,095574,Bach; Quang Tran,22,0,48,26
1657720273443,CSE 30,A01,083084,Eldon; John,6,0,80,74
1657720273443,CSE 30,B01,095061,Bhaskar; Nishant,9,0,50,41
1657720279471,CSE 100,A01,083659,Cao; Yingjun,5,4,70,65
1657720285495,CSE 134B,A01,083661,Powell; Thomas Allan,23,0,100,77
1657720291526,CSE 140,A01,083663,Gungor; Onat,15,0,85,70
1657720297553,CSE 140L,A01,083088,Eldon; John,23,0,100,77
1657720303581,CSE 175,A01,083665,Kumar; Rakesh,3,0,25,22
1657720309606,CSE 190,A00,092507,Dubnov; Shlomo,8,0,20,12
1657720315633,ECE 45,A01,083139,Congero; Spencer William,6,0,75,69
1657720321663,ECE 65,A50,083695,Saad; Andrew S,12,0,30,18
1657720321663,ECE 65,A51,095125,Saad; Andrew S,24,0,26,2
1657720327690,ECE 109,A01,091882,Touri; Behrouz,20,0,70,50
1657720333719,ECE 180,A00,083140,Abi Samra; Nicholas Camill,1,0,30,29
1657720333719,ECE 180,B00,083141,Abi Samra; Nicholas Camill,0,0,30,30
1657720339746,MATH 10A,A01,083735,Patchell; Gregory David,2,0,30,28
1657720339746,MATH 10A,A02,083736,Patchell; Gregory David,20,0,30,10
1657720339746,MATH 10A,A03,083737,Patchell; Gregory David,16,0,30,14
1657720345782,MATH 10B,A01,083207,Lim; Seonhee,8,0,34,26
1657720345782,MATH 10B,A02,083208,Lim; Seonhee,9,0,35,26
1657720345782,MATH 10B,A03,093472,Lim; Seonhee,7,0,34,27
1657720345782,MATH 10B,B01,083739,Sinha; Shubham,13,0,30,17
1657720351825,MATH 18,A01,083743,Cinel; Cameron Alexander,8,0,30,22
1657720351825,MATH 18,A02,083744,Cinel; Cameron Alexander,17,0,30,13
1657720351825,MATH 18,A03,083745,Cinel; Cameron Alexander,10,0,30,20
1657720351825,MATH 18,B01,083748,Rideout; David Porter,5,0,37,32
1657720351825,MATH 18,B02,083749,Rideout; David Porter,5,0,36,31
1657720351825,MATH 18,B03,083750,Rideout; David Porter,3,0,37,34
1657720351825,MATH 18,B04,083751,Rideout; David Porter,6,0,36,30
1657720351825,MATH 18,B05,093473,Rideout; David Porter,6,0,36,30
1657720351825,MATH 18,B06,093474,Rideout; David Porter,6,0,36,30
1657720357847,MATH 20A,A01,083754,Zheng; Zequn,14,0,40,26
1657720363873,MATH 20B,A01,083756,Briones; Jor-el Thomas Caparas,4,0,36,32
1657720363873,MATH 20B,A02,083757,Briones; Jor-el Thomas Caparas,1,0,36,35
1657720363873,MATH 20B,A03,093475,Briones; Jor-el Thomas Caparas,2,0,36,34
1657720369898,MATH 20C,A01,083760,Briones; Jor-el Thomas Caparas,1,0,35,34
1657720369898,MATH 20C,A02,083761,Briones; Jor-el Thomas Caparas,8,0,35,27
1657720369898,MATH 20C,A03,093476,Briones; Jor-el Thomas Caparas,0,1,36,36
1657720369898,MATH 20C,B01,083762,Bach; Quang Tran,1,0,30,29
1657720375925,MATH 20D,A01,083765,Tran; Brian Kha,5,0,30,25
1657720375925,MATH 20D,A02,083766,Tran; Brian Kha,5,0,30,25
1657720375925,MATH 20D,A03,083767,Tran; Brian Kha,5,0,30,25
1657720382037,MATH 20E,A01,083771,Ganguly; Soumya,9,0,32,23
1657720382037,MATH 20E,A02,083772,Ganguly; Soumya,6,0,32,26
1657720382037,MATH 20E,B01,083773,Ciotti; Benjamin,20,0,35,15
1657720382037,MATH 20E,B02,083774,Ciotti; Benjamin,18,0,35,17
1657720388069,MATH 103A,A01,083777,Greenfeld; Be'Eri,3,0,36,33
1657720388069,MATH 103A,A02,083778,Greenfeld; Be'Eri,5,0,36,31
1657720388069,MATH 103A,A03,093561,Greenfeld; Be'Eri,6,0,36,30
1657720388069,MATH 103A,B01,083779,Greenfeld; Be'Eri,7,0,36,29
1657720388069,MATH 103A,B02,083780,Greenfeld; Be'Eri,4,0,36,32
1657720388069,MATH 103A,B03,093562,Greenfeld; Be'Eri,3,0,36,33
1657720394093,MATH 105,A01,085443,Carter; Anne Toulson,15,0,35,20
1657720394093,MATH 105,A02,093477,Carter; Anne Toulson,20,0,35,15
1657720400133,MATH 109,A01,083213,Ganzberger; Geoffrey Michael,2,0,34,32
1657720400133,MATH 109,A02,083214,Ganzberger; Geoffrey Michael,4,0,34,30
1657720400133,MATH 109,A03,093478,Ganzberger; Geoffrey Michael,2,0,34,32
1657720400133,MATH 109,B01,083215,Ganzberger; Geoffrey Michael,1,0,32,31
1657720400133,MATH 109,B02,083216,Ganzberger; Geoffrey Michael,2,0,32,30
1657720400133,MATH 109,B03,093479,Ganzberger; Geoffrey Michael,8,0,32,24
1657720406161,MATH 142A,A01,083219,Chow; Bennett,7,0,32,25
1657720406161,MATH 142A,A02,083220,Chow; Bennett,10,0,32,22
1657720406161,MATH 142A,A03,093480,Chow; Bennett,9,0,32,23
1657720406161,MATH 142A,B03,093481,Chow; Bennett,8,0,32,24
1657720406161,MATH 142A,B04,093558,Chow; Bennett,13,0,32,19
1657720406161,MATH 142A,B05,093559,Chow; Bennett,6,0,32,26
1657720412192,MATH 193A,A01,083224,Rotar; Vladimir,8,0,34,26
1657720412192,MATH 193A,A02,083225,Rotar; Vladimir,9,0,34,25
1657720412192,MATH 193A,A03,083781,Rotar; Vladimir,5,0,34,29
1657720412192,MATH 193A,A04,083782,Rotar; Vladimir,10,0,34,24
1657720412192,MATH 193A,A05,093482,Rotar; Vladimir,10,0,34,24
1657720418219,MATH 197,001,091859,McAuley; Julian John,9999,0,9999,0
1657720418219,MATH 197,002,095566,Kedlaya; Kiran S.,9997,0,9999,2
1657720418219,MATH 197,003,095567,Xiao; Ming,9999,0,9999,0
1657720418219,MATH 197,004,095571,Perols; Johan Lars,9998,0,9999,1
1657720425290,COGS 9,A01,083615,Shannon; Kyle Michael,9,0,75,66
1657720431319,COGS 11,A01,083617,Boyle; Mary E. T.,23,0,48,25
1657720437344,COGS 13,A01,083071,Bastos; Amalia Pinkusfeld,11,0,71,60
1657720443382,COGS 14A,A01,092681,Semenuks; Arturs,5,1,100,95
1657720449407,COGS 14B,A01,083073,Cheng; Tzu-Han,6,0,63,57
1657720455432,COGS 17,A01,092677,Semenuks; Arturs,6,0,81,75
1657720461457,COGS 100,A01,083619,Allen; Michael Gordon,17,0,70,53
1657720467481,COGS 101A,A01,083621,Davis; Joshua Daniel,9,0,68,59
1657720473511,COGS 101B,A01,091572,Allen; Michael Gordon,12,0,65,53
1657720479534,COGS 101C,A01,083625,Delgado; Tania,17,0,35,18
1657720485570,COGS 107A,A01,083627,Boyle; Mary E. T.,13,0,60,47
1657720491595,COGS 118A,A01,083075,Gupta; Anjum,21,0,76,55
1657720497627,CSE 3,A50,083646,Miranda; Gregory Joseph,24,0,50,26
1657720503652,CSE 8A,A50,083650,Miranda; Gregory Joseph,17,1,56,39
1657720509677,CSE 11,A01,083080,Cao; Yingjun,6,15,40,34
1657720515701,CSE 12,A01,083652,Krause-Levy; Sophia Louisa,28,1,120,92
1657720521729,CSE 15L,A01,083654,Morris; Justin Loren,9,0,50,41
1657720521729,CSE 15L,A02,083655,Morris; Justin Loren,9,0,50,41
1657720527758,CSE 20,A01,083657,Tran; Khoa Dang,39,0,80,41
1657720533786,CSE 21,A01,095574,Bach; Quang Tran,22,0,48,26
1657720539829,CSE 30,A01,083084,Eldon; John,6,0,80,74
1657720539829,CSE 30,B01,095061,Bhaskar; Nishant,9,0,50,41
1657720545857,CSE 100,A01,083659,Cao; Yingjun,5,4,70,65
1657720551882,CSE 134B,A01,083661,Powell; Thomas Allan,23,0,100,77
1657720557911,CSE 140,A01,083663,Gungor; Onat,15,0,85,70
1657720563939,CSE 140L,A01,083088,Eldon; John,23,0,100,77
1657720569962,CSE 175,A01,083665,Kumar; Rakesh,3,0,25,22
1657720575985,CSE 190,A00,092507,Dubnov; Shlomo,8,0,20,12
1657720582010,ECE 45,A01,083139,Congero; Spencer William,6,0,75,69
1657720588040,ECE 65,A50,083695,Saad; Andrew S,12,0,30,18
1657720588040,ECE 65,A51,095125,Saad; Andrew S,24,0,26,2
1657720594065,ECE 109,A01,091882,Touri; Behrouz,20,0,70,50
1657720600094,ECE 180,A00,083140,Abi Samra; Nicholas Camill,1,0,30,29
1657720600094,ECE 180,B00,083141,Abi Samra; Nicholas Camill,0,0,30,30
1657720606124,MATH 10A,A01,083735,Patchell; Gregory David,2,0,30,28
1657720606124,MATH 10A,A02,083736,Patchell; Gregory David,20,0,30,10
1657720606124,MATH 10A,A03,083737,Patchell; Gregory David,16,0,30,14
1657720612153,MATH 10B,A01,083207,Lim; Seonhee,8,0,34,26
1657720612153,MATH 10B,A02,083208,Lim; Seonhee,9,0,35,26
1657720612153,MATH 10B,A03,093472,Lim; Seonhee,7,0,34,27
1657720612153,MATH 10B,B01,083739,Sinha; Shubham,13,0,30,17
1657720618187,MATH 18,A01,083743,Cinel; Cameron Alexander,8,0,30,22
1657720618187,MATH 18,A02,083744,Cinel; Cameron Alexander,17,0,30,13
1657720618187,MATH 18,A03,083745,Cinel; Cameron Alexander,10,0,30,20
1657720618187,MATH 18,B01,083748,Rideout; David Porter,5,0,37,32
1657720618187,MATH 18,B02,083749,Rideout; David Porter,5,0,36,31
1657720618187,MATH 18,B03,083750,Rideout; David Porter,3,0,37,34
1657720618187,MATH 18,B04,083751,Rideout; David Porter,6,0,36,30
1657720618187,MATH 18,B05,093473,Rideout; David Porter,6,0,36,30
1657720618187,MATH 18,B06,093474,Rideout; David Porter,6,0,36,30
1657720624212,MATH 20A,A01,083754,Zheng; Zequn,14,0,40,26
1657720630241,MATH 20B,A01,083756,Briones; Jor-el Thomas Caparas,4,0,36,32
1657720630241,MATH 20B,A02,083757,Briones; Jor-el Thomas Caparas,1,0,36,35
1657720630241,MATH 20B,A03,093475,Briones; Jor-el Thomas Caparas,2,0,36,34
1657720636273,MATH 20C,A01,083760,Briones; Jor-el Thomas Caparas,1,0,35,34
1657720636273,MATH 20C,A02,083761,Briones; Jor-el Thomas Caparas,8,0,35,27
1657720636273,MATH 20C,A03,093476,Briones; Jor-el Thomas Caparas,0,1,36,36
1657720636273,MATH 20C,B01,083762,Bach; Quang Tran,1,0,30,29
1657720642299,MATH 20D,A01,083765,Tran; Brian Kha,5,0,30,25
1657720642299,MATH 20D,A02,083766,Tran; Brian Kha,5,0,30,25
1657720642299,MATH 20D,A03,083767,Tran; Brian Kha,5,0,30,25
1657720648326,MATH 20E,A01,083771,Ganguly; Soumya,9,0,32,23
1657720648326,MATH 20E,A02,083772,Ganguly; Soumya,6,0,32,26
1657720648326,MATH 20E,B01,083773,Ciotti; Benjamin,20,0,35,15
1657720648326,MATH 20E,B02,083774,Ciotti; Benjamin,18,0,35,17
1657720654351,MATH 103A,A01,083777,Greenfeld; Be'Eri,3,0,36,33
1657720654351,MATH 103A,A02,083778,Greenfeld; Be'Eri,5,0,36,31
1657720654351,MATH 103A,A03,093561,Greenfeld; Be'Eri,6,0,36,30
1657720654351,MATH 103A,B01,083779,Greenfeld; Be'Eri,7,0,36,29
1657720654351,MATH 103A,B02,083780,Greenfeld; Be'Eri,4,0,36,32
1657720654351,MATH 103A,B03,093562,Greenfeld; Be'Eri,3,0,36,33
1657720660382,MATH 105,A01,085443,Carter; Anne Toulson,15,0,35,20
1657720660382,MATH 105,A02,093477,Carter; Anne Toulson,20,0,35,15
1657720666407,MATH 109,A01,083213,Ganzberger; Geoffrey Michael,2,0,34,32
1657720666407,MATH 109,A02,083214,Ganzberger; Geoffrey Michael,4,0,34,30
1657720666407,MATH 109,A03,093478,Ganzberger; Geoffrey Michael,2,0,34,32
1657720666407,MATH 109,B01,083215,Ganzberger; Geoffrey Michael,1,0,32,31
1657720666407,MATH 109,B02,083216,Ganzberger; Geoffrey Michael,2,0,32,30
1657720666407,MATH 109,B03,093479,Ganzberger; Geoffrey Michael,8,0,32,24
1657720672441,MATH 142A,A01,083219,Chow; Bennett,7,0,32,25
1657720672441,MATH 142A,A02,083220,Chow; Bennett,10,0,32,22
1657720672441,MATH 142A,A03,093480,Chow; Bennett,9,0,32,23
1657720672441,MATH 142A,B03,093481,Chow; Bennett,8,0,32,24
1657720672441,MATH 142A,B04,093558,Chow; Bennett,13,0,32,19
1657720672441,MATH 142A,B05,093559,Chow; Bennett,6,0,32,26
1657720678465,MATH 193A,A01,083224,Rotar; Vladimir,8,0,34,26
1657720678465,MATH 193A,A02,083225,Rotar; Vladimir,9,0,34,25
1657720678465,MATH 193A,A03,083781,Rotar; Vladimir,5,0,34,29
1657720678465,MATH 193A,A04,083782,Rotar; Vladimir,10,0,34,24
1657720678465,MATH 193A,A05,093482,Rotar; Vladimir,10,0,34,24
1657720684490,MATH 197,001,091859,McAuley; Julian John,9999,0,9999,0
1657720684490,MATH 197,002,095566,Kedlaya; Kiran S.,9997,0,9999,2
1657720684490,MATH 197,003,095567,Xiao; Ming,9999,0,9999,0
1657720684490,MATH 197,004,095571,Perols; Johan Lars,9998,0,9999,1
1657720691559,COGS 9,A01,083615,Shannon; Kyle Michael,9,0,75,66
1657720697587,COGS 11,A01,083617,Boyle; Mary E. T.,23,0,48,25
1657720703612,COGS 13,A01,083071,Bastos; Amalia Pinkusfeld,11,0,71,60
1657720709641,COGS 14A,A01,092681,Semenuks; Arturs,5,1,100,95
1657720715668,COGS 14B,A01,083073,Cheng; Tzu-Han,6,0,63,57
1657720721692,COGS 17,A01,092677,Semenuks; Arturs,6,0,81,75
1657720727715,COGS 100,A01,083619,Allen; Michael Gordon,17,0,70,53
1657720733743,COGS 101A,A01,083621,Davis; Joshua Daniel,9,0,68,59
1657720739772,COGS 101B,A01,091572,Allen; Michael Gordon,12,0,65,53
1657720745796,COGS 101C,A01,083625,Delgado; Tania,17,0,35,18
1657720751826,COGS 107A,A01,083627,Boyle; Mary E. T.,13,0,60,47
1657720757849,COGS 118A,A01,083075,Gupta; Anjum,21,0,76,55
1657720763878,CSE 3,A50,083646,Miranda; Gregory Joseph,24,0,50,26
1657720769903,CSE 8A,A50,083650,Miranda; Gregory Joseph,17,1,56,39
1657720775929,CSE 11,A01,083080,Cao; Yingjun,6,15,40,34
1657720781956,CSE 12,A01,083652,Krause-Levy; Sophia Louisa,28,1,120,92
1657720787983,CSE 15L,A01,083654,Morris; Justin Loren,9,0,50,41
1657720787983,CSE 15L,A02,083655,Morris; Justin Loren,9,0,50,41
1657720794008,CSE 20,A01,083657,Tran; Khoa Dang,39,0,80,41
1657720800037,CSE 21,A01,095574,Bach; Quang Tran,22,0,48,26
1657720806064,CSE 30,A01,083084,Eldon; John,6,0,80,74
1657720806064,CSE 30,B01,095061,Bhaskar; Nishant,9,0,50,41
1657720812093,CSE 100,A01,083659,Cao; Yingjun,5,4,70,65
1657720818116,CSE 134B,A01,083661,Powell; Thomas Allan,23,0,100,77
1657720824139,CSE 140,A01,083663,Gungor; Onat,15,0,85,70
1657720830163,CSE 140L,A01,083088,Eldon; John,23,0,100,77
1657720836191,CSE 175,A01,083665,Kumar; Rakesh,3,0,25,22
1657720842215,CSE 190,A00,092507,Dubnov; Shlomo,8,0,20,12
1657720848248,ECE 45,A01,083139,Congero; Spencer William,6,0,75,69
1657720854275,ECE 65,A50,083695,Saad; Andrew S,12,0,30,18
1657720854275,ECE 65,A51,095125,Saad; Andrew S,24,0,26,2
1657720860298,ECE 109,A01,091882,Touri; Behrouz,20,0,70,50
1657720866324,ECE 180,A00,083140,Abi Samra; Nicholas Camill,1,0,30,29
1657720866324,ECE 180,B00,083141,Abi Samra; Nicholas Camill,0,0,30,30
1657720872355,MATH 10A,A01,083735,Patchell; Gregory David,2,0,30,28
1657720872355,MATH 10A,A02,083736,Patchell; Gregory David,20,0,30,10
1657720872355,MATH 10A,A03,083737,Patchell; Gregory David,16,0,30,14
1657720878383,MATH 10B,A01,083207,Lim; Seonhee,8,0,34,26
1657720878383,MATH 10B,A02,083208,Lim; Seonhee,9,0,35,26
1657720878383,MATH 10B,A03,093472,Lim; Seonhee,7,0,34,27
1657720878383,MATH 10B,B01,083739,Sinha; Shubham,13,0,30,17
1657720884418,MATH 18,A01,083743,Cinel; Cameron Alexander,8,0,30,22
1657720884418,MATH 18,A02,083744,Cinel; Cameron Alexander,17,0,30,13
1657720884418,MATH 18,A03,083745,Cinel; Cameron Alexander,10,0,30,20
1657720884418,MATH 18,B01,083748,Rideout; David Porter,5,0,37,32
1657720884418,MATH 18,B02,083749,Rideout; David Porter,5,0,36,31
1657720884418,MATH 18,B03,083750,Rideout; David Porter,3,0,37,34
1657720884418,MATH 18,B04,083751,Rideout; David Porter,6,0,36,30
1657720884418,MATH 18,B05,093473,Rideout; David Porter,6,0,36,30
1657720884418,MATH 18,B06,093474,Rideout; David Porter,6,0,36,30
1657720890441,MATH 20A,A01,083754,Zheng; Zequn,14,0,40,26
1657720896466,MATH 20B,A01,083756,Briones; Jor-el Thomas Caparas,4,0,36,32
1657720896466,MATH 20B,A02,083757,Briones; Jor-el Thomas Caparas,1,0,36,35
1657720896466,MATH 20B,A03,093475,Briones; Jor-el Thomas Caparas,2,0,36,34
1657720902490,MATH 20C,A01,083760,Briones; Jor-el Thomas Caparas,1,0,35,34
1657720902490,MATH 20C,A02,083761,Briones; Jor-el Thomas Caparas,8,0,35,27
1657720902490,MATH 20C,A03,093476,Briones; Jor-el Thomas Caparas,0,1,36,36
1657720902490,MATH 20C,B01,083762,Bach; Quang Tran,1,0,30,29
1657720908520,MATH 20D,A01,083765,Tran; Brian Kha,5,0,30,25
1657720908520,MATH 20D,A02,083766,Tran; Brian Kha,5,0,30,25
1657720908520,MATH 20D,A03,083767,Tran; Brian Kha,5,0,30,25
1657720914552,MATH 20E,A01,083771,Ganguly; Soumya,9,0,32,23
1657720914552,MATH 20E,A02,083772,Ganguly; Soumya,6,0,32,26
1657720914552,MATH 20E,B01,083773,Ciotti; Benjamin,20,0,35,15
1657720914552,MATH 20E,B02,083774,Ciotti; Benjamin,18,0,35,17
1657720920577,MATH 103A,A01,083777,Greenfeld; Be'Eri,3,0,36,33
1657720920577,MATH 103A,A02,083778,Greenfeld; Be'Eri,5,0,36,31
1657720920577,MATH 103A,A03,093561,Greenfeld; Be'Eri,6,0,36,30
1657720920577,MATH 103A,B01,083779,Greenfeld; Be'Eri,7,0,36,29
1657720920577,MATH 103A,B02,083780,Greenfeld; Be'Eri,4,0,36,32
1657720920577,MATH 103A,B03,093562,Greenfeld; Be'Eri,3,0,36,33
1657720926601,MATH 105,A01,085443,Carter; Anne Toulson,15,0,35,20
1657720926601,MATH 105,A02,093477,Carter; Anne Toulson,20,0,35,15
1657720932635,MATH 109,A01,083213,Ganzberger; Geoffrey Michael,2,0,34,32
1657720932635,MATH 109,A02,083214,Ganzberger; Geoffrey Michael,4,0,34,30
1657720932635,MATH 109,A03,093478,Ganzberger; Geoffrey Michael,2,0,34,32
1657720932635,MATH 109,B01,083215,Ganzberger; Geoffrey Michael,1,0,32,31
1657720932635,MATH 109,B02,083216,Ganzberger; Geoffrey Michael,2,0,32,30
1657720932635,MATH 109,B03,093479,Ganzberger; Geoffrey Michael,8,0,32,24
1657720938669,MATH 142A,A01,083219,Chow; Bennett,7,0,32,25
1657720938669,MATH 142A,A02,083220,Chow; Bennett,10,0,32,22
1657720938669,MATH 142A,A03,093480,Chow; Bennett,9,0,32,23
1657720938669,MATH 142A,B03,093481,Chow; Bennett,8,0,32,24
1657720938669,MATH 142A,B04,093558,Chow; Bennett,13,0,32,19
1657720938669,MATH 142A,B05,093559,Chow; Bennett,6,0,32,26
1657720944701,MATH 193A,A01,083224,Rotar; Vladimir,8,0,34,26
1657720944701,MATH 193A,A02,083225,Rotar; Vladimir,9,0,34,25
1657720944701,MATH 193A,A03,083781,Rotar; Vladimir,5,0,34,29
1657720944701,MATH 193A,A04,083782,Rotar; Vladimir,10,0,34,24
1657720944701,MATH 193A,A05,093482,Rotar; Vladimir,10,0,34,24
1657720950731,MATH 197,001,091859,McAuley; Julian John,9999,0,9999,0
1657720950731,MATH 197,002,095566,Kedlaya; Kiran S.,9997,0,9999,2
1657720950731,MATH 197,003,095567,Xiao; Ming,9999,0,9999,0
1657720950731,MATH 197,004,095571,Perols; Johan Lars,9998,0,9999,1
1657720957790,COGS 9,A01,083615,Shannon; Kyle Michael,9,0,75,66
1657720963824,COGS 11,A01,083617,Boyle; Mary E. T.,23,0,48,25
1657720969851,COGS 13,A01,083071,Bastos; Amalia Pinkusfeld,11,0,71,60
1657720975964,COGS 14A,A01,092681,Semenuks; Arturs,5,1,100,95
1657720982000,COGS 14B,A01,083073,Cheng; Tzu-Han,6,0,63,57
1657720988028,COGS 17,A01,092677,Semenuks; Arturs,6,0,81,75
1657720994056,COGS 100,A01,083619,Allen; Michael Gordon,17,0,70,53
1657721000081,COGS 101A,A01,083621,Davis; Joshua Daniel,9,0,68,59
1657721006106,COGS 101B,A01,091572,Allen; Michael Gordon,12,0,65,53
1657721012143,COGS 101C,A01,083625,Delgado; Tania,17,0,35,18
1657721018171,COGS 107A,A01,083627,Boyle; Mary E. T.,13,0,60,47
1657721024198,COGS 118A,A01,083075,Gupta; Anjum,21,0,76,55
1657721030232,CSE 3,A50,083646,Miranda; Gregory Joseph,24,0,50,26
1657721036319,CSE 8A,A50,083650,Miranda; Gregory Joseph,17,1,56,39
1657721042345,CSE 11,A01,083080,Cao; Yingjun,6,15,40,34
1657721048377,CSE 12,A01,083652,Krause-Levy; Sophia Louisa,28,1,120,92
1657721054406,CSE 15L,A01,083654,Morris; Justin Loren,9,0,50,41
1657721054406,CSE 15L,A02,083655,Morris; Justin Loren,9,0,50,41
1657721060438,CSE 20,A01,083657,Tran; Khoa Dang,39,0,80,41
1657721066468,CSE 21,A01,095574,Bach; Quang Tran,22,0,48,26
1657721072499,CSE 30,A01,083084,Eldon; John,6,0,80,74
1657721072499,CSE 30,B01,095061,Bhaskar; Nishant,9,0,50,41
1657721078542,CSE 100,A01,083659,Cao; Yingjun,5,4,70,65
1657721084567,CSE 134B,A01,083661,Powell; Thomas Allan,23,0,100,77
1657721090593,CSE 140,A01,083663,Gungor; Onat,15,0,85,70
1657721096620,CSE 140L,A01,083088,Eldon; John,23,0,100,77
1657721102646,CSE 175,A01,083665,Kumar; Rakesh,3,0,25,22
1657721108671,CSE 190,A00,092507,Dubnov; Shlomo,8,0,20,12
1657721114695,ECE 45,A01,083139,Congero; Spencer William,6,0,75,69
1657721120722,ECE 65,A50,083695,Saad; Andrew S,12,0,30,18
1657721120722,ECE 65,A51,095125,Saad; Andrew S,24,0,26,2
1657721126751,ECE 109,A01,091882,Touri; Behrouz,20,0,70,50
1657721132777,ECE 180,A00,083140,Abi Samra; Nicholas Camill,1,0,30,29
1657721132777,ECE 180,B00,083141,Abi Samra; Nicholas Camill,0,0,30,30
1657721138802,MATH 10A,A01,083735,Patchell; Gregory David,2,0,30,28
1657721138802,MATH 10A,A02,083736,Patchell; Gregory David,20,0,30,10
1657721138802,MATH 10A,A03,083737,Patchell; Gregory David,16,0,30,14
1657721144832,MATH 10B,A01,083207,Lim; Seonhee,8,0,34,26
1657721144832,MATH 10B,A02,083208,Lim; Seonhee,9,0,35,26
1657721144832,MATH 10B,A03,093472,Lim; Seonhee,7,0,34,27
1657721144832,MATH 10B,B01,083739,Sinha; Shubham,13,0,30,17
1657721150857,MATH 18,A01,083743,Cinel; Cameron Alexander,8,0,30,22
1657721150857,MATH 18,A02,083744,Cinel; Cameron Alexander,17,0,30,13
1657721150857,MATH 18,A03,083745,Cinel; Cameron Alexander,10,0,30,20
1657721150857,MATH 18,B01,083748,Rideout; David Porter,5,0,37,32
1657721150857,MATH 18,B02,083749,Rideout; David Porter,5,0,36,31
1657721150857,MATH 18,B03,083750,Rideout; David Porter,3,0,37,34
1657721150857,MATH 18,B04,083751,Rideout; David Porter,6,0,36,30
1657721150857,MATH 18,B05,093473,Rideout; David Porter,6,0,36,30
1657721150857,MATH 18,B06,093474,Rideout; David Porter,6,0,36,30
1657721156884,MATH 20A,A01,083754,Zheng; Zequn,14,0,40,26
1657721162908,MATH 20B,A01,083756,Briones; Jor-el Thomas Caparas,4,0,36,32
1657721162908,MATH 20B,A02,083757,Briones; Jor-el Thomas Caparas,1,0,36,35
1657721162908,MATH 20B,A03,093475,Briones; Jor-el Thomas Caparas,2,0,36,34
1657721168936,MATH 20C,A01,083760,Briones; Jor-el Thomas Caparas,1,0,35,34
1657721168936,MATH 20C,A02,083761,Briones; Jor-el Thomas Caparas,8,0,35,27
1657721168936,MATH 20C,A03,093476,Briones; Jor-el Thomas Caparas,0,1,36,36
1657721168936,MATH 20C,B01,083762,Bach; Quang Tran,1,0,30,29
1657721174967,MATH 20D,A01,083765,Tran; Brian Kha,5,0,30,25
1657721174967,MATH 20D,A02,083766,Tran; Brian Kha,5,0,30,25
1657721174967,MATH 20D,A03,083767,Tran; Brian Kha,5,0,30,25
1657721181000,MATH 20E,A01,083771,Ganguly; Soumya,9,0,32,23
1657721181000,MATH 20E,A02,083772,Ganguly; Soumya,6,0,32,26
1657721181000,MATH 20E,B01,083773,Ciotti; Benjamin,20,0,35,15
1657721181000,MATH 20E,B02,083774,Ciotti; Benjamin,18,0,35,17
1657721187029,MATH 103A,A01,083777,Greenfeld; Be'Eri,3,0,36,33
1657721187029,MATH 103A,A02,083778,Greenfeld; Be'Eri,5,0,36,31
1657721187029,MATH 103A,A03,093561,Greenfeld; Be'Eri,6,0,36,30
1657721187029,MATH 103A,B01,083779,Greenfeld; Be'Eri,7,0,36,29
1657721187029,MATH 103A,B02,083780,Greenfeld; Be'Eri,4,0,36,32
1657721187029,MATH 103A,B03,093562,Greenfeld; Be'Eri,3,0,36,33
1657721193057,MATH 105,A01,085443,Carter; Anne Toulson,15,0,35,20
1657721193057,MATH 105,A02,093477,Carter; Anne Toulson,20,0,35,15
1657721199091,MATH 109,A01,083213,Ganzberger; Geoffrey Michael,2,0,34,32
1657721199091,MATH 109,A02,083214,Ganzberger; Geoffrey Michael,4,0,34,30
1657721199091,MATH 109,A03,093478,Ganzberger; Geoffrey Michael,2,0,34,32
1657721199091,MATH 109,B01,083215,Ganzberger; Geoffrey Michael,1,0,32,31
1657721199091,MATH 109,B02,083216,Ganzberger; Geoffrey Michael,2,0,32,30
1657721199091,MATH 109,B03,093479,Ganzberger; Geoffrey Michael,8,0,32,24
1657721205116,MATH 142A,A01,083219,Chow; Bennett,7,0,32,25
1657721205116,MATH 142A,A02,083220,Chow; Bennett,10,0,32,22
1657721205116,MATH 142A,A03,093480,Chow; Bennett,9,0,32,23
1657721205116,MATH 142A,B03,093481,Chow; Bennett,8,0,32,24
1657721205116,MATH 142A,B04,093558,Chow; Bennett,13,0,32,19
1657721205116,MATH 142A,B05,093559,Chow; Bennett,6,0,32,26
1657721211148,MATH 193A,A01,083224,Rotar; Vladimir,8,0,34,26
1657721211148,MATH 193A,A02,083225,Rotar; Vladimir,9,0,34,25
1657721211148,MATH 193A,A03,083781,Rotar; Vladimir,5,0,34,29
1657721211148,MATH 193A,A04,083782,Rotar; Vladimir,10,0,34,24
1657721211148,MATH 193A,A05,093482,Rotar; Vladimir,10,0,34,24
1657721217172,MATH 197,001,091859,McAuley; Julian John,9999,0,9999,0
1657721217172,MATH 197,002,095566,Kedlaya; Kiran S.,9997,0,9999,2
1657721217172,MATH 197,003,095567,Xiao; Ming,9999,0,9999,0
1657721217172,MATH 197,004,095571,Perols; Johan Lars,9998,0,9999,1
1657721224237,COGS 9,A01,083615,Shannon; Kyle Michael,9,0,75,66
1657721230263,COGS 11,A01,083617,Boyle; Mary E. T.,23,0,48,25
1657721236291,COGS 13,A01,083071,Bastos; Amalia Pinkusfeld,11,0,71,60
1657721242315,COGS 14A,A01,092681,Semenuks; Arturs,5,1,100,95
1657721248342,COGS 14B,A01,083073,Cheng; Tzu-Han,6,0,63,57
1657721254368,COGS 17,A01,092677,Semenuks; Arturs,6,0,81,75
1657721260392,COGS 100,A01,083619,Allen; Michael Gordon,17,0,70,53
1657721266420,COGS 101A,A01,083621,Davis; Joshua Daniel,9,0,68,59
1657721272444,COGS 101B,A01,091572,Allen; Michael Gordon,12,0,65,53
1657721278469,COGS 101C,A01,083625,Delgado; Tania,17,0,35,18
1657721284493,COGS 107A,A01,083627,Boyle; Mary E. T.,13,0,60,47
1657721290521,COGS 118A,A01,083075,Gupta; Anjum,21,0,76,55
1657721296544,CSE 3,A50,083646,Miranda; Gregory Joseph,24,0,50,26
1657721302572,CSE 8A,A50,083650,Miranda; Gregory Joseph,17,1,56,39
1657721308602,CSE 11,A01,083080,Cao; Yingjun,6,15,40,34
1657721314629,CSE 12,A01,083652,Krause-Levy; Sophia Louisa,28,1,120,92
1657721320657,CSE 15L,A01,083654,Morris; Justin Loren,9,0,50,41
1657721320657,CSE 15L,A02,083655,Morris; Justin Loren,9,0,50,41
1657721326688,CSE 20,A01,083657,Tran; Khoa Dang,39,0,80,41
1657721332717,CSE 21,A01,095574,Bach; Quang Tran,22,0,48,26
1657721338741,CSE 30,A01,083084,Eldon; John,6,0,80,74
1657721338741,CSE 30,B01,095061,Bhaskar; Nishant,9,0,50,41
1657721344769,CSE 100,A01,083659,Cao; Yingjun,5,4,70,65
1657721350791,CSE 134B,A01,083661,Powell; Thomas Allan,23,0,100,77
1657721356815,CSE 140,A01,083663,Gungor; Onat,15,0,85,70
1657721362846,CSE 140L,A01,083088,Eldon; John,23,0,100,77
1657721368872,CSE 175,A01,083665,Kumar; Rakesh,3,0,25,22
1657721374898,CSE 190,A00,092507,Dubnov; Shlomo,8,0,20,12
1657721380929,ECE 45,A01,083139,Congero; Spencer William,6,0,75,69
1657721386952,ECE 65,A50,083695,Saad; Andrew S,12,0,30,18
1657721386952,ECE 65,A51,095125,Saad; Andrew S,24,0,26,2
1657721392976,ECE 109,A01,091882,Touri; Behrouz,20,0,70,50
1657721399008,ECE 180,A00,083140,Abi Samra; Nicholas Camill,1,0,30,29
1657721399008,ECE 180,B00,083141,Abi Samra; Nicholas Camill,0,0,30,30
1657721405035,MATH 10A,A01,083735,Patchell; Gregory David,2,0,30,28
1657721405035,MATH 10A,A02,083736,Patchell; Gregory David,20,0,30,10
1657721405035,MATH 10A,A03,083737,Patchell; Gregory David,16,0,30,14
1657721411064,MATH 10B,A01,083207,Lim; Seonhee,8,0,34,26
1657721411064,MATH 10B,A02,083208,Lim; Seonhee,9,0,35,26
1657721411064,MATH 10B,A03,093472,Lim; Seonhee,7,0,34,27
1657721411064,MATH 10B,B01,083739,Sinha; Shubham,13,0,30,17
1657721417096,MATH 18,A01,083743,Cinel; Cameron Alexander,8,0,30,22
1657721417096,MATH 18,A02,083744,Cinel; Cameron Alexander,17,0,30,13
1657721417096,MATH 18,A03,083745,Cinel; Cameron Alexander,10,0,30,20
1657721417096,MATH 18,B01,083748,Rideout; David Porter,5,0,37,32
1657721417096,MATH 18,B02,083749,Rideout; David Porter,5,0,36,31
1657721417096,MATH 18,B03,083750,Rideout; David Porter,3,0,37,34
1657721417096,MATH 18,B04,083751,Rideout; David Porter,6,0,36,30
1657721417096,MATH 18,B05,093473,Rideout; David Porter,6,0,36,30
1657721417096,MATH 18,B06,093474,Rideout; David Porter,6,0,36,30
1657721423121,MATH 20A,A01,083754,Zheng; Zequn,14,0,40,26
1657721429151,MATH 20B,A01,083756,Briones; Jor-el Thomas Caparas,4,0,36,32
1657721429151,MATH 20B,A02,083757,Briones; Jor-el Thomas Caparas,1,0,36,35
1657721429151,MATH 20B,A03,093475,Briones; Jor-el Thomas Caparas,2,0,36,34
1657721435178,MATH 20C,A01,083760,Briones; Jor-el Thomas Caparas,1,0,35,34
1657721435178,MATH 20C,A02,083761,Briones; Jor-el Thomas Caparas,8,0,35,27
1657721435178,MATH 20C,A03,093476,Briones; Jor-el Thomas Caparas,0,1,36,36
1657721435178,MATH 20C,B01,083762,Bach; Quang Tran,1,0,30,29
1657721441201,MATH 20D,A01,083765,Tran; Brian Kha,5,0,30,25
1657721441201,MATH 20D,A02,083766,Tran; Brian Kha,5,0,30,25
1657721441201,MATH 20D,A03,083767,Tran; Brian Kha,5,0,30,25
1657721447230,MATH 20E,A01,083771,Ganguly; Soumya,9,0,32,23
1657721447230,MATH 20E,A02,083772,Ganguly; Soumya,6,0,32,26
1657721447230,MATH 20E,B01,083773,Ciotti; Benjamin,20,0,35,15
1657721447230,MATH 20E,B02,083774,Ciotti; Benjamin,18,0,35,17
1657721453257,MATH 103A,A01,083777,Greenfeld; Be'Eri,3,0,36,33
1657721453257,MATH 103A,A02,083778,Greenfeld; Be'Eri,5,0,36,31
1657721453257,MATH 103A,A03,093561,Greenfeld; Be'Eri,6,0,36,30
1657721453257,MATH 103A,B01,083779,Greenfeld; Be'Eri,7,0,36,29
1657721453257,MATH 103A,B02,083780,Greenfeld; Be'Eri,4,0,36,32
1657721453257,MATH 103A,B03,093562,Greenfeld; Be'Eri,3,0,36,33
1657721459281,MATH 105,A01,085443,Carter; Anne Toulson,15,0,35,20
1657721459281,MATH 105,A02,093477,Carter; Anne Toulson,20,0,35,15
1657721465311,MATH 109,A01,083213,Ganzberger; Geoffrey Michael,2,0,34,32
1657721465311,MATH 109,A02,083214,Ganzberger; Geoffrey Michael,4,0,34,30
1657721465311,MATH 109,A03,093478,Ganzberger; Geoffrey Michael,2,0,34,32
1657721465311,MATH 109,B01,083215,Ganzberger; Geoffrey Michael,1,0,32,31
1657721465311,MATH 109,B02,083216,Ganzberger; Geoffrey Michael,2,0,32,30
1657721465311,MATH 109,B03,093479,Ganzberger; Geoffrey Michael,8,0,32,24
1657721471336,MATH 142A,A01,083219,Chow; Bennett,7,0,32,25
1657721471336,MATH 142A,A02,083220,Chow; Bennett,10,0,32,22
1657721471336,MATH 142A,A03,093480,Chow; Bennett,9,0,32,23
1657721471336,MATH 142A,B03,093481,Chow; Bennett,8,0,32,24
1657721471336,MATH 142A,B04,093558,Chow; Bennett,13,0,32,19
1657721471336,MATH 142A,B05,093559,Chow; Bennett,6,0,32,26
1657721477361,MATH 193A,A01,083224,Rotar; Vladimir,8,0,34,26
1657721477361,MATH 193A,A02,083225,Rotar; Vladimir,9,0,34,25
1657721477361,MATH 193A,A03,083781,Rotar; Vladimir,5,0,34,29
1657721477361,MATH 193A,A04,083782,Rotar; Vladimir,10,0,34,24
1657721477361,MATH 193A,A05,093482,Rotar; Vladimir,10,0,34,24
1657721483385,MATH 197,001,091859,McAuley; Julian John,9999,0,9999,0
1657721483385,MATH 197,002,095566,Kedlaya; Kiran S.,9997,0,9999,2
1657721483385,MATH 197,003,095567,Xiao; Ming,9999,0,9999,0
1657721483385,MATH 197,004,095571,Perols; Johan Lars,9998,0,9999,1
1657721490447,COGS 9,A01,083615,Shannon; Kyle Michael,9,0,75,66
1657721496475,COGS 11,A01,083617,Boyle; Mary E. T.,23,0,48,25
1657721502499,COGS 13,A01,083071,Bastos; Amalia Pinkusfeld,11,0,71,60
1657721508522,COGS 14A,A01,092681,Semenuks; Arturs,5,1,100,95
1657721514544,COGS 14B,A01,083073,Cheng; Tzu-Han,6,0,63,57
1657721520567,COGS 17,A01,092677,Semenuks; Arturs,6,0,81,75
1657721526592,COGS 100,A01,083619,Allen; Michael Gordon,17,0,70,53
1657721532620,COGS 101A,A01,083621,Davis; Joshua Daniel,9,0,68,59
1657721538643,COGS 101B,A01,091572,Allen; Michael Gordon,12,0,65,53
1657721544672,COGS 101C,A01,083625,Delgado; Tania,17,0,35,18
1657721550698,COGS 107A,A01,083627,Boyle; Mary E. T.,13,0,60,47
1657721556723,COGS 118A,A01,083075,Gupta; Anjum,21,0,76,55
1657721562754,CSE 3,A50,083646,Miranda; Gregory Joseph,24,0,50,26
1657721568782,CSE 8A,A50,083650,Miranda; Gregory Joseph,17,1,56,39
1657721574876,CSE 11,A01,083080,Cao; Yingjun,6,15,40,34
1657721580899,CSE 12,A01,083652,Krause-Levy; Sophia Louisa,28,1,120,92
1657721586929,CSE 15L,A01,083654,Morris; Justin Loren,9,0,50,41
1657721586929,CSE 15L,A02,083655,Morris; Justin Loren,9,0,50,41
1657721592959,CSE 20,A01,083657,Tran; Khoa Dang,39,0,80,41
1657721598986,CSE 21,A01,095574,Bach; Quang Tran,22,0,48,26
1657721605012,CSE 30,A01,083084,Eldon; John,6,0,80,74
1657721605012,CSE 30,B01,095061,Bhaskar; Nishant,9,0,50,41
1657721611038,CSE 100,A01,083659,Cao; Yingjun,5,4,70,65
1657721617078,CSE 134B,A01,083661,Powell; Thomas Allan,23,0,100,77
1657721623102,CSE 140,A01,083663,Gungor; Onat,15,0,85,70
1657721629131,CSE 140L,A01,083088,Eldon; John,23,0,100,77
1657721635158,CSE 175,A01,083665,Kumar; Rakesh,3,0,25,22
1657721641182,CSE 190,A00,092507,Dubnov; Shlomo,8,0,20,12
1657721647207,ECE 45,A01,083139,Congero; Spencer William,6,0,75,69
1657721653231,ECE 65,A50,083695,Saad; Andrew S,12,0,30,18
1657721653231,ECE 65,A51,095125,Saad; Andrew S,24,0,26,2
1657721659254,ECE 109,A01,091882,Touri; Behrouz,20,0,70,50
1657721665278,ECE 180,A00,083140,Abi Samra; Nicholas Camill,1,0,30,29
1657721665278,ECE 180,B00,083141,Abi Samra; Nicholas Camill,0,0,30,30
1657721671304,MATH 10A,A01,083735,Patchell; Gregory David,2,0,30,28
1657721671304,MATH 10A,A02,083736,Patchell; Gregory David,20,0,30,10
1657721671304,MATH 10A,A03,083737,Patchell; Gregory David,16,0,30,14
1657721677329,MATH 10B,A01,083207,Lim; Seonhee,8,0,34,26
1657721677329,MATH 10B,A02,083208,Lim; Seonhee,9,0,35,26
1657721677329,MATH 10B,A03,093472,Lim; Seonhee,7,0,34,27
1657721677329,MATH 10B,B01,083739,Sinha; Shubham,13,0,30,17
1657721683372,MATH 18,A01,083743,Cinel; Cameron Alexander,8,0,30,22
1657721683372,MATH 18,A02,083744,Cinel; Cameron Alexander,17,0,30,13
1657721683372,MATH 18,A03,083745,Cinel; Cameron Alexander,10,0,30,20
1657721683372,MATH 18,B01,083748,Rideout; David Porter,5,0,37,32
1657721683372,MATH 18,B02,083749,Rideout; David Porter,5,0,36,31
1657721683372,MATH 18,B03,083750,Rideout; David Porter,3,0,37,34
1657721683372,MATH 18,B04,083751,Rideout; David Porter,6,0,36,30
1657721683372,MATH 18,B05,093473,Rideout; David Porter,6,0,36,30
1657721683372,MATH 18,B06,093474,Rideout; David Porter,6,0,36,30
1657721689395,MATH 20A,A01,083754,Zheng; Zequn,14,0,40,26
1657721695422,MATH 20B,A01,083756,Briones; Jor-el Thomas Caparas,4,0,36,32
1657721695422,MATH 20B,A02,083757,Briones; Jor-el Thomas Caparas,1,0,36,35
1657721695422,MATH 20B,A03,093475,Briones; Jor-el Thomas Caparas,2,0,36,34
1657721701454,MATH 20C,A01,083760,Briones; Jor-el Thomas Caparas,1,0,35,34
1657721701454,MATH 20C,A02,083761,Briones; Jor-el Thomas Caparas,8,0,35,27
1657721701454,MATH 20C,A03,093476,Briones; Jor-el Thomas Caparas,0,1,36,36
1657721701454,MATH 20C,B01,083762,Bach; Quang Tran,1,0,30,29
1657721707477,MATH 20D,A01,083765,Tran; Brian Kha,5,0,30,25
1657721707477,MATH 20D,A02,083766,Tran; Brian Kha,5,0,30,25
1657721707477,MATH 20D,A03,083767,Tran; Brian Kha,5,0,30,25
1657721713506,MATH 20E,A01,083771,Ganguly; Soumya,9,0,32,23
1657721713506,MATH 20E,A02,083772,Ganguly; Soumya,6,0,32,26
1657721713506,MATH 20E,B01,083773,Ciotti; Benjamin,20,0,35,15
1657721713506,MATH 20E,B02,083774,Ciotti; Benjamin,18,0,35,17
1657721719534,MATH 103A,A01,083777,Greenfeld; Be'Eri,3,0,36,33
1657721719534,MATH 103A,A02,083778,Greenfeld; Be'Eri,5,0,36,31
1657721719534,MATH 103A,A03,093561,Greenfeld; Be'Eri,6,0,36,30
1657721719534,MATH 103A,B01,083779,Greenfeld; Be'Eri,7,0,36,29
1657721719534,MATH 103A,B02,083780,Greenfeld; Be'Eri,4,0,36,32
1657721719534,MATH 103A,B03,093562,Greenfeld; Be'Eri,3,0,36,33
1657721725563,MATH 105,A01,085443,Carter; Anne Toulson,15,0,35,20
1657721725563,MATH 105,A02,093477,Carter; Anne Toulson,20,0,35,15
1657721731589,MATH 109,A01,083213,Ganzberger; Geoffrey Michael,2,0,34,32
1657721731589,MATH 109,A02,083214,Ganzberger; Geoffrey Michael,4,0,34,30
1657721731589,MATH 109,A03,093478,Ganzberger; Geoffrey Michael,2,0,34,32
1657721731589,MATH 109,B01,083215,Ganzberger; Geoffrey Michael,1,0,32,31
1657721731589,MATH 109,B02,083216,Ganzberger; Geoffrey Michael,2,0,32,30
1657721731589,MATH 109,B03,093479,Ganzberger; Geoffrey Michael,8,0,32,24
1657721737614,MATH 142A,A01,083219,Chow; Bennett,7,0,32,25
1657721737614,MATH 142A,A02,083220,Chow; Bennett,10,0,32,22
1657721737614,MATH 142A,A03,093480,Chow; Bennett,9,0,32,23
1657721737614,MATH 142A,B03,093481,Chow; Bennett,8,0,32,24
1657721737614,MATH 142A,B04,093558,Chow; Bennett,13,0,32,19
1657721737614,MATH 142A,B05,093559,Chow; Bennett,6,0,32,26
1657721743643,MATH 193A,A01,083224,Rotar; Vladimir,8,0,34,26
1657721743643,MATH 193A,A02,083225,Rotar; Vladimir,9,0,34,25
1657721743643,MATH 193A,A03,083781,Rotar; Vladimir,5,0,34,29
1657721743643,MATH 193A,A04,083782,Rotar; Vladimir,10,0,34,24
1657721743643,MATH 193A,A05,093482,Rotar; Vladimir,10,0,34,24
1657721749668,MATH 197,001,091859,McAuley; Julian John,9999,0,9999,0
1657721749668,MATH 197,002,095566,Kedlaya; Kiran S.,9997,0,9999,2
1657721749668,MATH 197,003,095567,Xiao; Ming,9999,0,9999,0
1657721749668,MATH 197,004,095571,Perols; Johan Lars,9998,0,9999,1
1657721756735,COGS 9,A01,083615,Shannon; Kyle Michael,9,0,75,66
1657721762766,COGS 11,A01,083617,Boyle; Mary E. T.,23,0,48,25
1657721768789,COGS 13,A01,083071,Bastos; Amalia Pinkusfeld,11,0,71,60
1657721774825,COGS 14A,A01,092681,Semenuks; Arturs,5,1,100,95
1657721780849,COGS 14B,A01,083073,Cheng; Tzu-Han,6,0,63,57
1657721786877,COGS 17,A01,092677,Semenuks; Arturs,6,0,81,75
1657721792901,COGS 100,A01,083619,Allen; Michael Gordon,17,0,70,53
1657721798925,COGS 101A,A01,083621,Davis; Joshua Daniel,9,0,68,59
1657721804957,COGS 101B,A01,091572,Allen; Michael Gordon,12,0,65,53
1657721810984,COGS 101C,A01,083625,Delgado; Tania,17,0,35,18
1657721817007,COGS 107A,A01,083627,Boyle; Mary E. T.,13,0,60,47
1657721823030,COGS 118A,A01,083075,Gupta; Anjum,21,0,76,55
1657721829064,CSE 3,A50,083646,Miranda; Gregory Joseph,24,0,50,26
1657721835088,CSE 8A,A50,083650,Miranda; Gregory Joseph,17,1,56,39
1657721841111,CSE 11,A01,083080,Cao; Yingjun,6,15,40,34
1657721847135,CSE 12,A01,083652,Krause-Levy; Sophia Louisa,28,1,120,92
1657721853160,CSE 15L,A01,083654,Morris; Justin Loren,9,0,50,41
1657721853160,CSE 15L,A02,083655,Morris; Justin Loren,9,0,50,41
1657721859185,CSE 20,A01,083657,Tran; Khoa Dang,39,0,80,41
1657721865209,CSE 21,A01,095574,Bach; Quang Tran,22,0,48,26
1657721871236,CSE 30,A01,083084,Eldon; John,6,0,80,74
1657721871236,CSE 30,B01,095061,Bhaskar; Nishant,9,0,50,41
1657721877287,CSE 100,A01,083659,Cao; Yingjun,5,4,70,65
1657721883322,CSE 134B,A01,083661,Powell; Thomas Allan,23,0,100,77
1657721889352,CSE 140,A01,083663,Gungor; Onat,15,0,85,70
1657721895377,CSE 140L,A01,083088,Eldon; John,23,0,100,77
1657721901401,CSE 175,A01,083665,Kumar; Rakesh,3,0,25,22
1657721907428,CSE 190,A00,092507,Dubnov; Shlomo,8,0,20,12
1657721913456,ECE 45,A01,083139,Congero; Spencer William,6,0,75,69
1657721919483,ECE 65,A50,083695,Saad; Andrew S,12,0,30,18
1657721919483,ECE 65,A51,095125,Saad; Andrew S,24,0,26,2
1657721925507,ECE 109,A01,091882,Touri; Behrouz,20,0,70,50
1657721931535,ECE 180,A00,083140,Abi Samra; Nicholas Camill,1,0,30,29
1657721931535,ECE 180,B00,083141,Abi Samra; Nicholas Camill,0,0,30,30
1657721937568,MATH 10A,A01,083735,Patchell; Gregory David,2,0,30,28
1657721937568,MATH 10A,A02,083736,Patchell; Gregory David,20,0,30,10
1657721937568,MATH 10A,A03,083737,Patchell; Gregory David,16,0,30,14
1657721943592,MATH 10B,A01,083207,Lim; Seonhee,8,0,34,26
1657721943592,MATH 10B,A02,083208,Lim; Seonhee,9,0,35,26
1657721943592,MATH 10B,A03,093472,Lim; Seonhee,7,0,34,27
1657721943592,MATH 10B,B01,083739,Sinha; Shubham,13,0,30,17
1657721949623,MATH 18,A01,083743,Cinel; Cameron Alexander,8,0,30,22
1657721949623,MATH 18,A02,083744,Cinel; Cameron Alexander,17,0,30,13
1657721949623,MATH 18,A03,083745,Cinel; Cameron Alexander,10,0,30,20
1657721949623,MATH 18,B01,083748,Rideout; David Porter,5,0,37,32
1657721949623,MATH 18,B02,083749,Rideout; David Porter,5,0,36,31
1657721949623,MATH 18,B03,083750,Rideout; David Porter,3,0,37,34
1657721949623,MATH 18,B04,083751,Rideout; David Porter,6,0,36,30
1657721949623,MATH 18,B05,093473,Rideout; David Porter,6,0,36,30
1657721949623,MATH 18,B06,093474,Rideout; David Porter,6,0,36,30
1657721955646,MATH 20A,A01,083754,Zheng; Zequn,14,0,40,26
1657721961677,MATH 20B,A01,083756,Briones; Jor-el Thomas Caparas,4,0,36,32
1657721961677,MATH 20B,A02,083757,Briones; Jor-el Thomas Caparas,1,0,36,35
1657721961677,MATH 20B,A03,093475,Briones; Jor-el Thomas Caparas,2,0,36,34
1657721967704,MATH 20C,A01,083760,Briones; Jor-el Thomas Caparas,1,0,35,34
1657721967704,MATH 20C,A02,083761,Briones; Jor-el Thomas Caparas,8,0,35,27
1657721967704,MATH 20C,A03,093476,Briones; Jor-el Thomas Caparas,0,1,36,36
1657721967704,MATH 20C,B01,083762,Bach; Quang Tran,1,0,30,29
1657721973734,MATH 20D,A01,083765,Tran; Brian Kha,5,0,30,25
1657721973734,MATH 20D,A02,083766,Tran; Brian Kha,5,0,30,25
1657721973734,MATH 20D,A03,083767,Tran; Brian Kha,5,0,30,25
1657721979759,MATH 20E,A01,083771,Ganguly; Soumya,9,0,32,23
1657721979759,MATH 20E,A02,083772,Ganguly; Soumya,6,0,32,26
1657721979759,MATH 20E,B01,083773,Ciotti; Benjamin,20,0,35,15
1657721979759,MATH 20E,B02,083774,Ciotti; Benjamin,18,0,35,17
1657721985788,MATH 103A,A01,083777,Greenfeld; Be'Eri,3,0,36,33
1657721985788,MATH 103A,A02,083778,Greenfeld; Be'Eri,5,0,36,31
1657721985788,MATH 103A,A03,093561,Greenfeld; Be'Eri,6,0,36,30
1657721985788,MATH 103A,B01,083779,Greenfeld; Be'Eri,7,0,36,29
1657721985788,MATH 103A,B02,083780,Greenfeld; Be'Eri,4,0,36,32
1657721985788,MATH 103A,B03,093562,Greenfeld; Be'Eri,3,0,36,33
1657721991811,MATH 105,A01,085443,Carter; Anne Toulson,15,0,35,20
1657721991811,MATH 105,A02,093477,Carter; Anne Toulson,20,0,35,15
1657721997837,MATH 109,A01,083213,Ganzberger; Geoffrey Michael,2,0,34,32
1657721997837,MATH 109,A02,083214,Ganzberger; Geoffrey Michael,4,0,34,30
1657721997837,MATH 109,A03,093478,Ganzberger; Geoffrey Michael,2,0,34,32
1657721997837,MATH 109,B01,083215,Ganzberger; Geoffrey Michael,1,0,32,31
1657721997837,MATH 109,B02,083216,Ganzberger; Geoffrey Michael,2,0,32,30
1657721997837,MATH 109,B03,093479,Ganzberger; Geoffrey Michael,8,0,32,24
1657722003872,MATH 142A,A01,083219,Chow; Bennett,7,0,32,25
1657722003872,MATH 142A,A02,083220,Chow; Bennett,10,0,32,22
1657722003872,MATH 142A,A03,093480,Chow; Bennett,9,0,32,23
1657722003872,MATH 142A,B03,093481,Chow; Bennett,8,0,32,24
1657722003872,MATH 142A,B04,093558,Chow; Bennett,13,0,32,19
1657722003872,MATH 142A,B05,093559,Chow; Bennett,6,0,32,26
1657722009898,MATH 193A,A01,083224,Rotar; Vladimir,8,0,34,26
1657722009898,MATH 193A,A02,083225,Rotar; Vladimir,9,0,34,25
1657722009898,MATH 193A,A03,083781,Rotar; Vladimir,5,0,34,29
1657722009898,MATH 193A,A04,083782,Rotar; Vladimir,10,0,34,24
1657722009898,MATH 193A,A05,093482,Rotar; Vladimir,10,0,34,24
1657722015924,MATH 197,001,091859,McAuley; Julian John,9999,0,9999,0
1657722015924,MATH 197,002,095566,Kedlaya; Kiran S.,9997,0,9999,2
1657722015924,MATH 197,003,095567,Xiao; Ming,9999,0,9999,0
1657722015924,MATH 197,004,095571,Perols; Johan Lars,9998,0,9999,1
1657722022990,COGS 9,A01,083615,Shannon; Kyle Michael,9,0,75,66
1657722029013,COGS 11,A01,083617,Boyle; Mary E. T.,23,0,48,25
1657722035042,COGS 13,A01,083071,Bastos; Amalia Pinkusfeld,11,0,71,60
1657722041066,COGS 14A,A01,092681,Semenuks; Arturs,5,1,100,95
1657722047094,COGS 14B,A01,083073,Cheng; Tzu-Han,6,0,63,57
1657722053135,COGS 17,A01,092677,Semenuks; Arturs,6,0,81,75
1657722059159,COGS 100,A01,083619,Allen; Michael Gordon,17,0,70,53
1657722065186,COGS 101A,A01,083621,Davis; Joshua Daniel,9,0,68,59
1657722071212,COGS 101B,A01,091572,Allen; Michael Gordon,12,0,65,53
1657722077236,COGS 101C,A01,083625,Delgado; Tania,17,0,35,18
1657722083266,COGS 107A,A01,083627,Boyle; Mary E. T.,13,0,60,47
1657722089295,COGS 118A,A01,083075,Gupta; Anjum,21,0,76,55
1657722095326,CSE 3,A50,083646,Miranda; Gregory Joseph,24,0,50,26
1657722101350,CSE 8A,A50,083650,Miranda; Gregory Joseph,17,1,56,39
1657722107384,CSE 11,A01,083080,Cao; Yingjun,6,15,40,34
1657722113413,CSE 12,A01,083652,Krause-Levy; Sophia Louisa,28,1,120,92
1657722119436,CSE 15L,A01,083654,Morris; Justin Loren,9,0,50,41
1657722119436,CSE 15L,A02,083655,Morris; Justin Loren,9,0,50,41
1657722125459,CSE 20,A01,083657,Tran; Khoa Dang,39,0,80,41
1657722131502,CSE 21,A01,095574,Bach; Quang Tran,22,0,48,26
1657722137531,CSE 30,A01,083084,Eldon; John,6,0,80,74
1657722137531,CSE 30,B01,095061,Bhaskar; Nishant,9,0,50,41
1657722143560,CSE 100,A01,083659,Cao; Yingjun,5,4,70,65
1657722149586,CSE 134B,A01,083661,Powell; Thomas Allan,23,0,100,77
1657722155611,CSE 140,A01,083663,Gungor; Onat,15,0,85,70
1657722161639,CSE 140L,A01,083088,Eldon; John,23,0,100,77
1657722167664,CSE 175,A01,083665,Kumar; Rakesh,3,0,25,22
1657722173755,CSE 190,A00,092507,Dubnov; Shlomo,8,0,20,12
1657722179780,ECE 45,A01,083139,Congero; Spencer William,6,0,75,69
1657722185806,ECE 65,A50,083695,Saad; Andrew S,12,0,30,18
1657722185806,ECE 65,A51,095125,Saad; Andrew S,24,0,26,2
1657722191830,ECE 109,A01,091882,Touri; Behrouz,20,0,70,50
1657722197857,ECE 180,A00,083140,Abi Samra; Nicholas Camill,1,0,30,29
1657722197857,ECE 180,B00,083141,Abi Samra; Nicholas Camill,0,0,30,30
1657722203885,MATH 10A,A01,083735,Patchell; Gregory David,2,0,30,28
1657722203885,MATH 10A,A02,083736,Patchell; Gregory David,20,0,30,10
1657722203885,MATH 10A,A03,083737,Patchell; Gregory David,16,0,30,14
1657722209910,MATH 10B,A01,083207,Lim; Seonhee,8,0,34,26
1657722209910,MATH 10B,A02,083208,Lim; Seonhee,9,0,35,26
1657722209910,MATH 10B,A03,093472,Lim; Seonhee,7,0,34,27
1657722209910,MATH 10B,B01,083739,Sinha; Shubham,13,0,30,17
1657722215941,MATH 18,A01,083743,Cinel; Cameron Alexander,8,0,30,22
1657722215941,MATH 18,A02,083744,Cinel; Cameron Alexander,17,0,30,13
1657722215941,MATH 18,A03,083745,Cinel; Cameron Alexander,10,0,30,20
1657722215941,MATH 18,B01,083748,Rideout; David Porter,5,0,37,32
1657722215941,MATH 18,B02,083749,Rideout; David Porter,5,0,36,31
1657722215941,MATH 18,B03,083750,Rideout; David Porter,3,0,37,34
1657722215941,MATH 18,B04,083751,Rideout; David Porter,6,0,36,30
1657722215941,MATH 18,B05,093473,Rideout; David Porter,6,0,36,30
1657722215941,MATH 18,B06,093474,Rideout; David Porter,6,0,36,30
1657722221968,MATH 20A,A01,083754,Zheng; Zequn,14,0,40,26
1657722227991,MATH 20B,A01,083756,Briones; Jor-el Thomas Caparas,4,0,36,32
1657722227991,MATH 20B,A02,083757,Briones; Jor-el Thomas Caparas,1,0,36,35
1657722227991,MATH 20B,A03,093475,Briones; Jor-el Thomas Caparas,2,0,36,34
1657722234015,MATH 20C,A01,083760,Briones; Jor-el Thomas Caparas,1,0,35,34
1657722234015,MATH 20C,A02,083761,Briones; Jor-el Thomas Caparas,8,0,35,27
1657722234015,MATH 20C,A03,093476,Briones; Jor-el Thomas Caparas,0,1,36,36
1657722234015,MATH 20C,B01,083762,Bach; Quang Tran,1,0,30,29
1657722240047,MATH 20D,A01,083765,Tran; Brian Kha,5,0,30,25
1657722240047,MATH 20D,A02,083766,Tran; Brian Kha,5,0,30,25
1657722240047,MATH 20D,A03,083767,Tran; Brian Kha,5,0,30,25
1657722246079,MATH 20E,A01,083771,Ganguly; Soumya,9,0,32,23
1657722246079,MATH 20E,A02,083772,Ganguly; Soumya,6,0,32,26
1657722246079,MATH 20E,B01,083773,Ciotti; Benjamin,20,0,35,15
1657722246079,MATH 20E,B02,083774,Ciotti; Benjamin,18,0,35,17
1657722252106,MATH 103A,A01,083777,Greenfeld; Be'Eri,3,0,36,33
1657722252106,MATH 103A,A02,083778,Greenfeld; Be'Eri,5,0,36,31
1657722252106,MATH 103A,A03,093561,Greenfeld; Be'Eri,6,0,36,30
1657722252106,MATH 103A,B01,083779,Greenfeld; Be'Eri,7,0,36,29
1657722252106,MATH 103A,B02,083780,Greenfeld; Be'Eri,4,0,36,32
1657722252106,MATH 103A,B03,093562,Greenfeld; Be'Eri,3,0,36,33
1657722258131,MATH 105,A01,085443,Carter; Anne Toulson,15,0,35,20
1657722258131,MATH 105,A02,093477,Carter; Anne Toulson,20,0,35,15
1657722264155,MATH 109,A01,083213,Ganzberger; Geoffrey Michael,2,0,34,32
1657722264155,MATH 109,A02,083214,Ganzberger; Geoffrey Michael,4,0,34,30
1657722264155,MATH 109,A03,093478,Ganzberger; Geoffrey Michael,2,0,34,32
1657722264155,MATH 109,B01,083215,Ganzberger; Geoffrey Michael,1,0,32,31
1657722264155,MATH 109,B02,083216,Ganzberger; Geoffrey Michael,2,0,32,30
1657722264155,MATH 109,B03,093479,Ganzberger; Geoffrey Michael,8,0,32,24
1657722270186,MATH 142A,A01,083219,Chow; Bennett,7,0,32,25
1657722270186,MATH 142A,A02,083220,Chow; Bennett,10,0,32,22
1657722270186,MATH 142A,A03,093480,Chow; Bennett,9,0,32,23
1657722270186,MATH 142A,B03,093481,Chow; Bennett,8,0,32,24
1657722270186,MATH 142A,B04,093558,Chow; Bennett,13,0,32,19
1657722270186,MATH 142A,B05,093559,Chow; Bennett,6,0,32,26
1657722276211,MATH 193A,A01,083224,Rotar; Vladimir,8,0,34,26
1657722276211,MATH 193A,A02,083225,Rotar; Vladimir,9,0,34,25
1657722276211,MATH 193A,A03,083781,Rotar; Vladimir,5,0,34,29
1657722276211,MATH 193A,A04,083782,Rotar; Vladimir,10,0,34,24
1657722276211,MATH 193A,A05,093482,Rotar; Vladimir,10,0,34,24
1657722282238,MATH 197,001,091859,McAuley; Julian John,9999,0,9999,0
1657722282238,MATH 197,002,095566,Kedlaya; Kiran S.,9997,0,9999,2
1657722282238,MATH 197,003,095567,Xiao; Ming,9999,0,9999,0
1657722282238,MATH 197,004,095571,Perols; Johan Lars,9998,0,9999,1
1657722289292,COGS 9,A01,083615,Shannon; Kyle Michael,9,0,75,66
1657722295317,COGS 11,A01,083617,Boyle; Mary E. T.,23,0,48,25
1657722301346,COGS 13,A01,083071,Bastos; Amalia Pinkusfeld,11,0,71,60
1657722307374,COGS 14A,A01,092681,Semenuks; Arturs,5,1,100,95
1657722313412,COGS 14B,A01,083073,Cheng; Tzu-Han,6,0,63,57
1657722319443,COGS 17,A01,092677,Semenuks; Arturs,6,0,81,75
1657722325468,COGS 100,A01,083619,Allen; Michael Gordon,17,0,70,53
1657722331492,COGS 101A,A01,083621,Davis; Joshua Daniel,9,0,68,59
1657722337518,COGS 101B,A01,091572,Allen; Michael Gordon,12,0,65,53
1657722343544,COGS 101C,A01,083625,Delgado; Tania,17,0,35,18
1657722349567,COGS 107A,A01,083627,Boyle; Mary E. T.,13,0,60,47
1657722355588,COGS 118A,A01,083075,Gupta; Anjum,21,0,76,55
1657722361615,CSE 3,A50,083646,Miranda; Gregory Joseph,24,0,50,26
1657722367637,CSE 8A,A50,083650,Miranda; Gregory Joseph,17,1,56,39
1657722373659,CSE 11,A01,083080,Cao; Yingjun,6,15,40,34
1657722379686,CSE 12,A01,083652,Krause-Levy; Sophia Louisa,28,1,120,92
1657722385714,CSE 15L,A01,083654,Morris; Justin Loren,9,0,50,41
1657722385714,CSE 15L,A02,083655,Morris; Justin Loren,9,0,50,41
1657722391741,CSE 20,A01,083657,Tran; Khoa Dang,39,0,80,41
1657722397764,CSE 21,A01,095574,Bach; Quang Tran,22,0,48,26
1657722403791,CSE 30,A01,083084,Eldon; John,6,0,80,74
1657722403791,CSE 30,B01,095061,Bhaskar; Nishant,9,0,50,41
1657722409813,CSE 100,A01,083659,Cao; Yingjun,5,4,70,65
1657722415839,CSE 134B,A01,083661,Powell; Thomas Allan,23,0,100,77
1657722421861,CSE 140,A01,083663,Gungor; Onat,15,0,85,70
1657722427887,CSE 140L,A01,083088,Eldon; John,23,0,100,77
1657722433911,CSE 175,A01,083665,Kumar; Rakesh,3,0,25,22
1657722439934,CSE 190,A00,092507,Dubnov; Shlomo,8,0,20,12
1657722445964,ECE 45,A01,083139,Congero; Spencer William,6,0,75,69
1657722451988,ECE 65,A50,083695,Saad; Andrew S,12,0,30,18
1657722451988,ECE 65,A51,095125,Saad; Andrew S,24,0,26,2
1657722458011,ECE 109,A01,091882,Touri; Behrouz,20,0,70,50
1657722464037,ECE 180,A00,083140,Abi Samra; Nicholas Camill,1,0,30,29
1657722464037,ECE 180,B00,083141,Abi Samra; Nicholas Camill,0,0,30,30
1657722470066,MATH 10A,A01,083735,Patchell; Gregory David,2,0,30,28
1657722470066,MATH 10A,A02,083736,Patchell; Gregory David,20,0,30,10
1657722470066,MATH 10A,A03,083737,Patchell; Gregory David,16,0,30,14
1657722476089,MATH 10B,A01,083207,Lim; Seonhee,8,0,34,26
1657722476089,MATH 10B,A02,083208,Lim; Seonhee,9,0,35,26
1657722476089,MATH 10B,A03,093472,Lim; Seonhee,7,0,34,27
1657722476089,MATH 10B,B01,083739,Sinha; Shubham,13,0,30,17
1657722482115,MATH 18,A01,083743,Cinel; Cameron Alexander,8,0,30,22
1657722482115,MATH 18,A02,083744,Cinel; Cameron Alexander,17,0,30,13
1657722482115,MATH 18,A03,083745,Cinel; Cameron Alexander,10,0,30,20
1657722482115,MATH 18,B01,083748,Rideout; David Porter,5,0,37,32
1657722482115,MATH 18,B02,083749,Rideout; David Porter,5,0,36,31
1657722482115,MATH 18,B03,083750,Rideout; David Porter,3,0,37,34
1657722482115,MATH 18,B04,083751,Rideout; David Porter,6,0,36,30
1657722482115,MATH 18,B05,093473,Rideout; David Porter,6,0,36,30
1657722482115,MATH 18,B06,093474,Rideout; David Porter,6,0,36,30
1657722488144,MATH 20A,A01,083754,Zheng; Zequn,14,0,40,26
1657722494176,MATH 20B,A01,083756,Briones; Jor-el Thomas Caparas,4,0,36,32
1657722494176,MATH 20B,A02,083757,Briones; Jor-el Thomas Caparas,1,0,36,35
1657722494176,MATH 20B,A03,093475,Briones; Jor-el Thomas Caparas,2,0,36,34
1657722500204,MATH 20C,A01,083760,Briones; Jor-el Thomas Caparas,1,0,35,34
1657722500204,MATH 20C,A02,083761,Briones; Jor-el Thomas Caparas,8,0,35,27
1657722500204,MATH 20C,A03,093476,Briones; Jor-el Thomas Caparas,0,1,36,36
1657722500204,MATH 20C,B01,083762,Bach; Quang Tran,1,0,30,29
1657722506234,MATH 20D,A01,083765,Tran; Brian Kha,5,0,30,25
1657722506234,MATH 20D,A02,083766,Tran; Brian Kha,5,0,30,25
1657722506234,MATH 20D,A03,083767,Tran; Brian Kha,5,0,30,25
1657722512259,MATH 20E,A01,083771,Ganguly; Soumya,9,0,32,23
1657722512259,MATH 20E,A02,083772,Ganguly; Soumya,6,0,32,26
1657722512259,MATH 20E,B01,083773,Ciotti; Benjamin,20,0,35,15
1657722512259,MATH 20E,B02,083774,Ciotti; Benjamin,18,0,35,17
1657722518284,MATH 103A,A01,083777,Greenfeld; Be'Eri,3,0,36,33
1657722518284,MATH 103A,A02,083778,Greenfeld; Be'Eri,5,0,36,31
1657722518284,MATH 103A,A03,093561,Greenfeld; Be'Eri,6,0,36,30
1657722518284,MATH 103A,B01,083779,Greenfeld; Be'Eri,7,0,36,29
1657722518284,MATH 103A,B02,083780,Greenfeld; Be'Eri,4,0,36,32
1657722518284,MATH 103A,B03,093562,Greenfeld; Be'Eri,3,0,36,33
1657722524311,MATH 105,A01,085443,Carter; Anne Toulson,15,0,35,20
1657722524311,MATH 105,A02,093477,Carter; Anne Toulson,20,0,35,15
1657722530336,MATH 109,A01,083213,Ganzberger; Geoffrey Michael,2,0,34,32
1657722530336,MATH 109,A02,083214,Ganzberger; Geoffrey Michael,4,0,34,30
1657722530336,MATH 109,A03,093478,Ganzberger; Geoffrey Michael,2,0,34,32
1657722530336,MATH 109,B01,083215,Ganzberger; Geoffrey Michael,1,0,32,31
1657722530336,MATH 109,B02,083216,Ganzberger; Geoffrey Michael,2,0,32,30
1657722530336,MATH 109,B03,093479,Ganzberger; Geoffrey Michael,8,0,32,24
1657722536370,MATH 142A,A01,083219,Chow; Bennett,7,0,32,25
1657722536370,MATH 142A,A02,083220,Chow; Bennett,10,0,32,22
1657722536370,MATH 142A,A03,093480,Chow; Bennett,9,0,32,23
1657722536370,MATH 142A,B03,093481,Chow; Bennett,8,0,32,24
1657722536370,MATH 142A,B04,093558,Chow; Bennett,13,0,32,19
1657722536370,MATH 142A,B05,093559,Chow; Bennett,6,0,32,26
1657722542416,MATH 193A,A01,083224,Rotar; Vladimir,8,0,34,26
1657722542416,MATH 193A,A02,083225,Rotar; Vladimir,9,0,34,25
1657722542416,MATH 193A,A03,083781,Rotar; Vladimir,5,0,34,29
1657722542416,MATH 193A,A04,083782,Rotar; Vladimir,10,0,34,24
1657722542416,MATH 193A,A05,093482,Rotar; Vladimir,10,0,34,24
1657722548446,MATH 197,001,091859,McAuley; Julian John,9999,0,9999,0
1657722548446,MATH 197,002,095566,Kedlaya; Kiran S.,9997,0,9999,2
1657722548446,MATH 197,003,095567,Xiao; Ming,9999,0,9999,0
1657722548446,MATH 197,004,095571,Perols; Johan Lars,9998,0,9999,1
1657722555516,COGS 9,A01,083615,Shannon; Kyle Michael,9,0,75,66
1657722561543,COGS 11,A01,083617,Boyle; Mary E. T.,23,0,48,25
1657722567571,COGS 13,A01,083071,Bastos; Amalia Pinkusfeld,11,0,71,60
1657722573597,COGS 14A,A01,092681,Semenuks; Arturs,5,1,100,95
1657722579621,COGS 14B,A01,083073,Cheng; Tzu-Han,6,0,63,57
1657722585645,COGS 17,A01,092677,Semenuks; Arturs,6,0,81,75
1657722591672,COGS 100,A01,083619,Allen; Michael Gordon,17,0,70,53
1657722597700,COGS 101A,A01,083621,Davis; Joshua Daniel,9,0,68,59
1657722603723,COGS 101B,A01,091572,Allen; Michael Gordon,12,0,65,53
1657722609747,COGS 101C,A01,083625,Delgado; Tania,17,0,35,18
1657722615775,COGS 107A,A01,083627,Boyle; Mary E. T.,13,0,60,47
1657722621798,COGS 118A,A01,083075,Gupta; Anjum,21,0,76,55
1657722627821,CSE 3,A50,083646,Miranda; Gregory Joseph,24,0,50,26
1657722633846,CSE 8A,A50,083650,Miranda; Gregory Joseph,17,1,56,39
1657722639874,CSE 11,A01,083080,Cao; Yingjun,6,15,40,34
1657722645901,CSE 12,A01,083652,Krause-Levy; Sophia Louisa,28,1,120,92
1657722651929,CSE 15L,A01,083654,Morris; Justin Loren,9,0,50,41
1657722651929,CSE 15L,A02,083655,Morris; Justin Loren,9,0,50,41
1657722657956,CSE 20,A01,083657,Tran; Khoa Dang,39,0,80,41
1657722663984,CSE 21,A01,095574,Bach; Quang Tran,22,0,48,26
1657722670013,CSE 30,A01,083084,Eldon; John,6,0,80,74
1657722670013,CSE 30,B01,095061,Bhaskar; Nishant,9,0,50,41
1657722676038,CSE 100,A01,083659,Cao; Yingjun,5,4,70,65
1657722682070,CSE 134B,A01,083661,Powell; Thomas Allan,23,0,100,77
1657722688097,CSE 140,A01,083663,Gungor; Onat,15,0,85,70
1657722694126,CSE 140L,A01,083088,Eldon; John,23,0,100,77
1657722700153,CSE 175,A01,083665,Kumar; Rakesh,3,0,25,22
1657722706180,CSE 190,A00,092507,Dubnov; Shlomo,8,0,20,12
1657722712206,ECE 45,A01,083139,Congero; Spencer William,6,0,75,69
1657722718233,ECE 65,A50,083695,Saad; Andrew S,12,0,30,18
1657722718233,ECE 65,A51,095125,Saad; Andrew S,24,0,26,2
1657722724259,ECE 109,A01,091882,Touri; Behrouz,20,0,70,50
1657722730286,ECE 180,A00,083140,Abi Samra; Nicholas Camill,1,0,30,29
1657722730286,ECE 180,B00,083141,Abi Samra; Nicholas Camill,0,0,30,30
1657722736319,MATH 10A,A01,083735,Patchell; Gregory David,2,0,30,28
1657722736319,MATH 10A,A02,083736,Patchell; Gregory David,20,0,30,10
1657722736319,MATH 10A,A03,083737,Patchell; Gregory David,16,0,30,14
1657722742344,MATH 10B,A01,083207,Lim; Seonhee,8,0,34,26
1657722742344,MATH 10B,A02,083208,Lim; Seonhee,9,0,35,26
1657722742344,MATH 10B,A03,093472,Lim; Seonhee,7,0,34,27
1657722742344,MATH 10B,B01,083739,Sinha; Shubham,13,0,30,17
1657722748376,MATH 18,A01,083743,Cinel; Cameron Alexander,8,0,30,22
1657722748376,MATH 18,A02,083744,Cinel; Cameron Alexander,17,0,30,13
1657722748376,MATH 18,A03,083745,Cinel; Cameron Alexander,10,0,30,20
1657722748376,MATH 18,B01,083748,Rideout; David Porter,5,0,37,32
1657722748376,MATH 18,B02,083749,Rideout; David Porter,5,0,36,31
1657722748376,MATH 18,B03,083750,Rideout; David Porter,3,0,37,34
1657722748376,MATH 18,B04,083751,Rideout; David Porter,6,0,36,30
1657722748376,MATH 18,B05,093473,Rideout; David Porter,6,0,36,30
1657722748376,MATH 18,B06,093474,Rideout; David Porter,6,0,36,30
1657722754399,MATH 20A,A01,083754,Zheng; Zequn,14,0,40,26
1657722760437,MATH 20B,A01,083756,Briones; Jor-el Thomas Caparas,4,0,36,32
1657722760437,MATH 20B,A02,083757,Briones; Jor-el Thomas Caparas,1,0,36,35
1657722760437,MATH 20B,A03,093475,Briones; Jor-el Thomas Caparas,2,0,36,34
1657722766467,MATH 20C,A01,083760,Briones; Jor-el Thomas Caparas,1,0,35,34
1657722766467,MATH 20C,A02,083761,Briones; Jor-el Thomas Caparas,8,0,35,27
1657722766467,MATH 20C,A03,093476,Briones; Jor-el Thomas Caparas,0,1,36,36
1657722766467,MATH 20C,B01,083762,Bach; Quang Tran,1,0,30,29
1657722772571,MATH 20D,A01,083765,Tran; Brian Kha,5,0,30,25
1657722772571,MATH 20D,A02,083766,Tran; Brian Kha,5,0,30,25
1657722772571,MATH 20D,A03,083767,Tran; Brian Kha,5,0,30,25
1657722778598,MATH 20E,A01,083771,Ganguly; Soumya,9,0,32,23
1657722778598,MATH 20E,A02,083772,Ganguly; Soumya,6,0,32,26
1657722778598,MATH 20E,B01,083773,Ciotti; Benjamin,20,0,35,15
1657722778598,MATH 20E,B02,083774,Ciotti; Benjamin,18,0,35,17
1657722784622,MATH 103A,A01,083777,Greenfeld; Be'Eri,3,0,36,33
1657722784622,MATH 103A,A02,083778,Greenfeld; Be'Eri,5,0,36,31
1657722784622,MATH 103A,A03,093561,Greenfeld; Be'Eri,6,0,36,30
1657722784622,MATH 103A,B01,083779,Greenfeld; Be'Eri,7,0,36,29
1657722784622,MATH 103A,B02,083780,Greenfeld; Be'Eri,4,0,36,32
1657722784622,MATH 103A,B03,093562,Greenfeld; Be'Eri,3,0,36,33
1657722790644,MATH 105,A01,085443,Carter; Anne Toulson,15,0,35,20
1657722790644,MATH 105,A02,093477,Carter; Anne Toulson,20,0,35,15
1657722796674,MATH 109,A01,083213,Ganzberger; Geoffrey Michael,2,0,34,32
1657722796674,MATH 109,A02,083214,Ganzberger; Geoffrey Michael,4,0,34,30
1657722796674,MATH 109,A03,093478,Ganzberger; Geoffrey Michael,2,0,34,32
1657722796674,MATH 109,B01,083215,Ganzberger; Geoffrey Michael,1,0,32,31
1657722796674,MATH 109,B02,083216,Ganzberger; Geoffrey Michael,2,0,32,30
1657722796674,MATH 109,B03,093479,Ganzberger; Geoffrey Michael,8,0,32,24
1657722802704,MATH 142A,A01,083219,Chow; Bennett,7,0,32,25
1657722802704,MATH 142A,A02,083220,Chow; Bennett,10,0,32,22
1657722802704,MATH 142A,A03,093480,Chow; Bennett,9,0,32,23
1657722802704,MATH 142A,B03,093481,Chow; Bennett,8,0,32,24
1657722802704,MATH 142A,B04,093558,Chow; Bennett,13,0,32,19
1657722802704,MATH 142A,B05,093559,Chow; Bennett,6,0,32,26
1657722808726,MATH 193A,A01,083224,Rotar; Vladimir,8,0,34,26
1657722808726,MATH 193A,A02,083225,Rotar; Vladimir,9,0,34,25
1657722808726,MATH 193A,A03,083781,Rotar; Vladimir,5,0,34,29
1657722808726,MATH 193A,A04,083782,Rotar; Vladimir,10,0,34,24
1657722808726,MATH 193A,A05,093482,Rotar; Vladimir,10,0,34,24
1657722814750,MATH 197,001,091859,McAuley; Julian John,9999,0,9999,0
1657722814750,MATH 197,002,095566,Kedlaya; Kiran S.,9997,0,9999,2
1657722814750,MATH 197,003,095567,Xiao; Ming,9999,0,9999,0
1657722814750,MATH 197,004,095571,Perols; Johan Lars,9998,0,9999,1
1657722821812,COGS 9,A01,083615,Shannon; Kyle Michael,9,0,75,66
1657722827837,COGS 11,A01,083617,Boyle; Mary E. T.,23,0,48,25
1657722833864,COGS 13,A01,083071,Bastos; Amalia Pinkusfeld,11,0,71,60
1657722839891,COGS 14A,A01,092681,Semenuks; Arturs,5,1,100,95
1657722845914,COGS 14B,A01,083073,Cheng; Tzu-Han,6,0,63,57
1657722851941,COGS 17,A01,092677,Semenuks; Arturs,6,0,81,75
1657722857969,COGS 100,A01,083619,Allen; Michael Gordon,17,0,70,53
1657722863995,COGS 101A,A01,083621,Davis; Joshua Daniel,9,0,68,59
1657722870019,COGS 101B,A01,091572,Allen; Michael Gordon,12,0,65,53
1657722876043,COGS 101C,A01,083625,Delgado; Tania,17,0,35,18
1657722882067,COGS 107A,A01,083627,Boyle; Mary E. T.,13,0,60,47
1657722888098,COGS 118A,A01,083075,Gupta; Anjum,21,0,76,55
1657722894126,CSE 3,A50,083646,Miranda; Gregory Joseph,24,0,50,26
1657722900150,CSE 8A,A50,083650,Miranda; Gregory Joseph,17,1,56,39
1657722906174,CSE 11,A01,083080,Cao; Yingjun,6,15,40,34
1657722912201,CSE 12,A01,083652,Krause-Levy; Sophia Louisa,28,1,120,92
1657722918224,CSE 15L,A01,083654,Morris; Justin Loren,9,0,50,41
1657722918224,CSE 15L,A02,083655,Morris; Justin Loren,9,0,50,41
1657722924249,CSE 20,A01,083657,Tran; Khoa Dang,39,0,80,41
1657722930272,CSE 21,A01,095574,Bach; Quang Tran,22,0,48,26
1657722936297,CSE 30,A01,083084,Eldon; John,6,0,80,74
1657722936297,CSE 30,B01,095061,Bhaskar; Nishant,9,0,50,41
1657722942323,CSE 100,A01,083659,Cao; Yingjun,5,4,70,65
1657722948351,CSE 134B,A01,083661,Powell; Thomas Allan,23,0,100,77
1657722954383,CSE 140,A01,083663,Gungor; Onat,15,0,85,70
1657722960407,CSE 140L,A01,083088,Eldon; John,23,0,100,77
1657722966432,CSE 175,A01,083665,Kumar; Rakesh,3,0,25,22
1657722972458,CSE 190,A00,092507,Dubnov; Shlomo,8,0,20,12
1657722978481,ECE 45,A01,083139,Congero; Spencer William,6,0,75,69
1657722984512,ECE 65,A50,083695,Saad; Andrew S,12,0,30,18
1657722984512,ECE 65,A51,095125,Saad; Andrew S,24,0,26,2
1657722990538,ECE 109,A01,091882,Touri; Behrouz,20,0,70,50
1657722996565,ECE 180,A00,083140,Abi Samra; Nicholas Camill,1,0,30,29
1657722996565,ECE 180,B00,083141,Abi Samra; Nicholas Camill,0,0,30,30
1657723002590,MATH 10A,A01,083735,Patchell; Gregory David,2,0,30,28
1657723002590,MATH 10A,A02,083736,Patchell; Gregory David,20,0,30,10
1657723002590,MATH 10A,A03,083737,Patchell; Gregory David,16,0,30,14
1657723008631,MATH 10B,A01,083207,Lim; Seonhee,8,0,34,26
1657723008631,MATH 10B,A02,083208,Lim; Seonhee,9,0,35,26
1657723008631,MATH 10B,A03,093472,Lim; Seonhee,7,0,34,27
1657723008631,MATH 10B,B01,083739,Sinha; Shubham,13,0,30,17
1657723014662,MATH 18,A01,083743,Cinel; Cameron Alexander,8,0,30,22
1657723014662,MATH 18,A02,083744,Cinel; Cameron Alexander,17,0,30,13
1657723014662,MATH 18,A03,083745,Cinel; Cameron Alexander,10,0,30,20
1657723014662,MATH 18,B01,083748,Rideout; David Porter,5,0,37,32
1657723014662,MATH 18,B02,083749,Rideout; David Porter,5,0,36,31
1657723014662,MATH 18,B03,083750,Rideout; David Porter,3,0,37,34
1657723014662,MATH 18,B04,083751,Rideout; David Porter,6,0,36,30
1657723014662,MATH 18,B05,093473,Rideout; David Porter,6,0,36,30
1657723014662,MATH 18,B06,093474,Rideout; David Porter,6,0,36,30
1657723020686,MATH 20A,A01,083754,Zheng; Zequn,14,0,40,26
1657723026726,MATH 20B,A01,083756,Briones; Jor-el Thomas Caparas,4,0,36,32
1657723026726,MATH 20B,A02,083757,Briones; Jor-el Thomas Caparas,1,0,36,35
1657723026726,MATH 20B,A03,093475,Briones; Jor-el Thomas Caparas,2,0,36,34
1657723032759,MATH 20C,A01,083760,Briones; Jor-el Thomas Caparas,1,0,35,34
1657723032759,MATH 20C,A02,083761,Briones; Jor-el Thomas Caparas,8,0,35,27
1657723032759,MATH 20C,A03,093476,Briones; Jor-el Thomas Caparas,0,1,36,36
1657723032759,MATH 20C,B01,083762,Bach; Quang Tran,1,0,30,29
1657723038785,MATH 20D,A01,083765,Tran; Brian Kha,5,0,30,25
1657723038785,MATH 20D,A02,083766,Tran; Brian Kha,5,0,30,25
1657723038785,MATH 20D,A03,083767,Tran; Brian Kha,5,0,30,25
1657723044810,MATH 20E,A01,083771,Ganguly; Soumya,9,0,32,23
1657723044810,MATH 20E,A02,083772,Ganguly; Soumya,6,0,32,26
1657723044810,MATH 20E,B01,083773,Ciotti; Benjamin,20,0,35,15
1657723044810,MATH 20E,B02,083774,Ciotti; Benjamin,18,0,35,17
1657723050835,MATH 103A,A01,083777,Greenfeld; Be'Eri,3,0,36,33
1657723050835,MATH 103A,A02,083778,Greenfeld; Be'Eri,5,0,36,31
1657723050835,MATH 103A,A03,093561,Greenfeld; Be'Eri,6,0,36,30
1657723050835,MATH 103A,B01,083779,Greenfeld; Be'Eri,7,0,36,29
1657723050835,MATH 103A,B02,083780,Greenfeld; Be'Eri,4,0,36,32
1657723050835,MATH 103A,B03,093562,Greenfeld; Be'Eri,3,0,36,33
1657723056858,MATH 105,A01,085443,Carter; Anne Toulson,15,0,35,20
1657723056858,MATH 105,A02,093477,Carter; Anne Toulson,20,0,35,15
1657723062904,MATH 109,A01,083213,Ganzberger; Geoffrey Michael,2,0,34,32
1657723062904,MATH 109,A02,083214,Ganzberger; Geoffrey Michael,4,0,34,30
1657723062904,MATH 109,A03,093478,Ganzberger; Geoffrey Michael,2,0,34,32
1657723062904,MATH 109,B01,083215,Ganzberger; Geoffrey Michael,1,0,32,31
1657723062904,MATH 109,B02,083216,Ganzberger; Geoffrey Michael,2,0,32,30
1657723062904,MATH 109,B03,093479,Ganzberger; Geoffrey Michael,8,0,32,24
1657723068926,MATH 142A,A01,083219,Chow; Bennett,7,0,32,25
1657723068926,MATH 142A,A02,083220,Chow; Bennett,10,0,32,22
1657723068926,MATH 142A,A03,093480,Chow; Bennett,9,0,32,23
1657723068926,MATH 142A,B03,093481,Chow; Bennett,8,0,32,24
1657723068926,MATH 142A,B04,093558,Chow; Bennett,13,0,32,19
1657723068926,MATH 142A,B05,093559,Chow; Bennett,6,0,32,26
1657723074950,MATH 193A,A01,083224,Rotar; Vladimir,8,0,34,26
1657723074950,MATH 193A,A02,083225,Rotar; Vladimir,9,0,34,25
1657723074950,MATH 193A,A03,083781,Rotar; Vladimir,5,0,34,29
1657723074950,MATH 193A,A04,083782,Rotar; Vladimir,10,0,34,24
1657723074950,MATH 193A,A05,093482,Rotar; Vladimir,10,0,34,24
1657723080977,MATH 197,001,091859,McAuley; Julian John,9999,0,9999,0
1657723080977,MATH 197,002,095566,Kedlaya; Kiran S.,9997,0,9999,2
1657723080977,MATH 197,003,095567,Xiao; Ming,9999,0,9999,0
1657723080977,MATH 197,004,095571,Perols; Johan Lars,9998,0,9999,1
1657723088038,COGS 9,A01,083615,Shannon; Kyle Michael,9,0,75,66
1657723094062,COGS 11,A01,083617,Boyle; Mary E. T.,23,0,48,25
1657723100097,COGS 13,A01,083071,Bastos; Amalia Pinkusfeld,11,0,71,60
1657723106122,COGS 14A,A01,092681,Semenuks; Arturs,5,1,100,95
1657723112149,COGS 14B,A01,083073,Cheng; Tzu-Han,6,0,63,57
1657723118174,COGS 17,A01,092677,Semenuks; Arturs,6,0,81,75
1657723124201,COGS 100,A01,083619,Allen; Michael Gordon,17,0,70,53
1657723130227,COGS 101A,A01,083621,Davis; Joshua Daniel,9,0,68,59
1657723136256,COGS 101B,A01,091572,Allen; Michael Gordon,12,0,65,53
1657723142285,COGS 101C,A01,083625,Delgado; Tania,17,0,35,18
1657723148315,COGS 107A,A01,083627,Boyle; Mary E. T.,13,0,60,47
1657723154340,COGS 118A,A01,083075,Gupta; Anjum,21,0,76,55
1657723160364,CSE 3,A50,083646,Miranda; Gregory Joseph,24,0,50,26
1657723166388,CSE 8A,A50,083650,Miranda; Gregory Joseph,17,1,56,39
1657723172410,CSE 11,A01,083080,Cao; Yingjun,6,15,40,34
1657723178437,CSE 12,A01,083652,Krause-Levy; Sophia Louisa,28,1,120,92
1657723184462,CSE 15L,A01,083654,Morris; Justin Loren,9,0,50,41
1657723184462,CSE 15L,A02,083655,Morris; Justin Loren,9,0,50,41
1657723190486,CSE 20,A01,083657,Tran; Khoa Dang,39,0,80,41
1657723196514,CSE 21,A01,095574,Bach; Quang Tran,22,0,48,26
1657723202541,CSE 30,A01,083084,Eldon; John,6,0,80,74
1657723202541,CSE 30,B01,095061,Bhaskar; Nishant,9,0,50,41
1657723208567,CSE 100,A01,083659,Cao; Yingjun,5,4,70,65
1657723214595,CSE 134B,A01,083661,Powell; Thomas Allan,23,0,100,77
1657723220622,CSE 140,A01,083663,Gungor; Onat,15,0,85,70
1657723226646,CSE 140L,A01,083088,Eldon; John,23,0,100,77
1657723232670,CSE 175,A01,083665,Kumar; Rakesh,3,0,25,22
1657723238697,CSE 190,A00,092507,Dubnov; Shlomo,8,0,20,12
1657723244723,ECE 45,A01,083139,Congero; Spencer William,6,0,75,69
1657723250748,ECE 65,A50,083695,Saad; Andrew S,12,0,30,18
1657723250748,ECE 65,A51,095125,Saad; Andrew S,24,0,26,2
1657723256778,ECE 109,A01,091882,Touri; Behrouz,20,0,70,50
1657723262808,ECE 180,A00,083140,Abi Samra; Nicholas Camill,1,0,30,29
1657723262808,ECE 180,B00,083141,Abi Samra; Nicholas Camill,0,0,30,30
1657723268834,MATH 10A,A01,083735,Patchell; Gregory David,2,0,30,28
1657723268834,MATH 10A,A02,083736,Patchell; Gregory David,20,0,30,10
1657723268834,MATH 10A,A03,083737,Patchell; Gregory David,16,0,30,14
1657723274858,MATH 10B,A01,083207,Lim; Seonhee,8,0,34,26
1657723274858,MATH 10B,A02,083208,Lim; Seonhee,9,0,35,26
1657723274858,MATH 10B,A03,093472,Lim; Seonhee,7,0,34,27
1657723274858,MATH 10B,B01,083739,Sinha; Shubham,13,0,30,17
1657723280884,MATH 18,A01,083743,Cinel; Cameron Alexander,8,0,30,22
1657723280884,MATH 18,A02,083744,Cinel; Cameron Alexander,17,0,30,13
1657723280884,MATH 18,A03,083745,Cinel; Cameron Alexander,10,0,30,20
1657723280884,MATH 18,B01,083748,Rideout; David Porter,5,0,37,32
1657723280884,MATH 18,B02,083749,Rideout; David Porter,5,0,36,31
1657723280884,MATH 18,B03,083750,Rideout; David Porter,3,0,37,34
1657723280884,MATH 18,B04,083751,Rideout; David Porter,6,0,36,30
1657723280884,MATH 18,B05,093473,Rideout; David Porter,6,0,36,30
1657723280884,MATH 18,B06,093474,Rideout; David Porter,6,0,36,30
1657723286918,MATH 20A,A01,083754,Zheng; Zequn,14,0,40,26
1657723292949,MATH 20B,A01,083756,Briones; Jor-el Thomas Caparas,4,0,36,32
1657723292949,MATH 20B,A02,083757,Briones; Jor-el Thomas Caparas,1,0,36,35
1657723292949,MATH 20B,A03,093475,Briones; Jor-el Thomas Caparas,2,0,36,34
1657723298972,MATH 20C,A01,083760,Briones; Jor-el Thomas Caparas,1,0,35,34
1657723298972,MATH 20C,A02,083761,Briones; Jor-el Thomas Caparas,8,0,35,27
1657723298972,MATH 20C,A03,093476,Briones; Jor-el Thomas Caparas,0,1,36,36
1657723298972,MATH 20C,B01,083762,Bach; Quang Tran,1,0,30,29
1657723304996,MATH 20D,A01,083765,Tran; Brian Kha,5,0,30,25
1657723304996,MATH 20D,A02,083766,Tran; Brian Kha,5,0,30,25
1657723304996,MATH 20D,A03,083767,Tran; Brian Kha,5,0,30,25
1657723311026,MATH 20E,A01,083771,Ganguly; Soumya,9,0,32,23
1657723311026,MATH 20E,A02,083772,Ganguly; Soumya,6,0,32,26
1657723311026,MATH 20E,B01,083773,Ciotti; Benjamin,20,0,35,15
1657723311026,MATH 20E,B02,083774,Ciotti; Benjamin,18,0,35,17
1657723317058,MATH 103A,A01,083777,Greenfeld; Be'Eri,3,0,36,33
1657723317058,MATH 103A,A02,083778,Greenfeld; Be'Eri,5,0,36,31
1657723317058,MATH 103A,A03,093561,Greenfeld; Be'Eri,6,0,36,30
1657723317058,MATH 103A,B01,083779,Greenfeld; Be'Eri,7,0,36,29
1657723317058,MATH 103A,B02,083780,Greenfeld; Be'Eri,4,0,36,32
1657723317058,MATH 103A,B03,093562,Greenfeld; Be'Eri,3,0,36,33
1657723323082,MATH 105,A01,085443,Carter; Anne Toulson,15,0,35,20
1657723323082,MATH 105,A02,093477,Carter; Anne Toulson,20,0,35,15
1657723329110,MATH 109,A01,083213,Ganzberger; Geoffrey Michael,2,0,34,32
1657723329110,MATH 109,A02,083214,Ganzberger; Geoffrey Michael,4,0,34,30
1657723329110,MATH 109,A03,093478,Ganzberger; Geoffrey Michael,2,0,34,32
1657723329110,MATH 109,B01,083215,Ganzberger; Geoffrey Michael,1,0,32,31
1657723329110,MATH 109,B02,083216,Ganzberger; Geoffrey Michael,2,0,32,30
1657723329110,MATH 109,B03,093479,Ganzberger; Geoffrey Michael,8,0,32,24
1657723335143,MATH 142A,A01,083219,Chow; Bennett,7,0,32,25
1657723335143,MATH 142A,A02,083220,Chow; Bennett,10,0,32,22
1657723335143,MATH 142A,A03,093480,Chow; Bennett,9,0,32,23
1657723335143,MATH 142A,B03,093481,Chow; Bennett,8,0,32,24
1657723335143,MATH 142A,B04,093558,Chow; Bennett,13,0,32,19
1657723335143,MATH 142A,B05,093559,Chow; Bennett,6,0,32,26
1657723341167,MATH 193A,A01,083224,Rotar; Vladimir,8,0,34,26
1657723341167,MATH 193A,A02,083225,Rotar; Vladimir,9,0,34,25
1657723341167,MATH 193A,A03,083781,Rotar; Vladimir,5,0,34,29
1657723341167,MATH 193A,A04,083782,Rotar; Vladimir,10,0,34,24
1657723341167,MATH 193A,A05,093482,Rotar; Vladimir,10,0,34,24
1657723347192,MATH 197,001,091859,McAuley; Julian John,9999,0,9999,0
1657723347192,MATH 197,002,095566,Kedlaya; Kiran S.,9997,0,9999,2
1657723347192,MATH 197,003,095567,Xiao; Ming,9999,0,9999,0
1657723347192,MATH 197,004,095571,Perols; Johan Lars,9998,0,9999,1
1657723354252,COGS 9,A01,083615,Shannon; Kyle Michael,9,0,75,66
1657723360276,COGS 11,A01,083617,Boyle; Mary E. T.,23,0,48,25
1657723366375,COGS 13,A01,083071,Bastos; Amalia Pinkusfeld,11,0,71,60
1657723372397,COGS 14A,A01,092681,Semenuks; Arturs,5,1,100,95
1657723378420,COGS 14B,A01,083073,Cheng; Tzu-Han,6,0,63,57
1657723384449,COGS 17,A01,092677,Semenuks; Arturs,6,0,81,75
1657723390472,COGS 100,A01,083619,Allen; Michael Gordon,17,0,70,53
1657723396496,COGS 101A,A01,083621,Davis; Joshua Daniel,9,0,68,59
1657723402522,COGS 101B,A01,091572,Allen; Michael Gordon,12,0,65,53
1657723408546,COGS 101C,A01,083625,Delgado; Tania,17,0,35,18
1657723414570,COGS 107A,A01,083627,Boyle; Mary E. T.,13,0,60,47
1657723420593,COGS 118A,A01,083075,Gupta; Anjum,21,0,76,55
1657723426617,CSE 3,A50,083646,Miranda; Gregory Joseph,24,0,50,26
1657723432640,CSE 8A,A50,083650,Miranda; Gregory Joseph,17,1,56,39
1657723438665,CSE 11,A01,083080,Cao; Yingjun,6,15,40,34
1657723444690,CSE 12,A01,083652,Krause-Levy; Sophia Louisa,28,1,120,92
1657723450717,CSE 15L,A01,083654,Morris; Justin Loren,9,0,50,41
1657723450717,CSE 15L,A02,083655,Morris; Justin Loren,9,0,50,41
1657723456748,CSE 20,A01,083657,Tran; Khoa Dang,39,0,80,41
1657723462771,CSE 21,A01,095574,Bach; Quang Tran,22,0,48,26
1657723468797,CSE 30,A01,083084,Eldon; John,6,0,80,74
1657723468797,CSE 30,B01,095061,Bhaskar; Nishant,9,0,50,41
1657723474819,CSE 100,A01,083659,Cao; Yingjun,5,4,70,65
1657723480847,CSE 134B,A01,083661,Powell; Thomas Allan,23,0,100,77
1657723486873,CSE 140,A01,083663,Gungor; Onat,15,0,85,70
1657723492897,CSE 140L,A01,083088,Eldon; John,23,0,100,77
1657723498926,CSE 175,A01,083665,Kumar; Rakesh,3,0,25,22
1657723504951,CSE 190,A00,092507,Dubnov; Shlomo,8,0,20,12
1657723510978,ECE 45,A01,083139,Congero; Spencer William,6,0,75,69
1657723517001,ECE 65,A50,083695,Saad; Andrew S,12,0,30,18
1657723517001,ECE 65,A51,095125,Saad; Andrew S,24,0,26,2
1657723523025,ECE 109,A01,091882,Touri; Behrouz,20,0,70,50
1657723529053,ECE 180,A00,083140,Abi Samra; Nicholas Camill,1,0,30,29
1657723529053,ECE 180,B00,083141,Abi Samra; Nicholas Camill,0,0,30,30
1657723535078,MATH 10A,A01,083735,Patchell; Gregory David,2,0,30,28
1657723535078,MATH 10A,A02,083736,Patchell; Gregory David,20,0,30,10
1657723535078,MATH 10A,A03,083737,Patchell; Gregory David,16,0,30,14
1657723541106,MATH 10B,A01,083207,Lim; Seonhee,8,0,34,26
1657723541106,MATH 10B,A02,083208,Lim; Seonhee,9,0,35,26
1657723541106,MATH 10B,A03,093472,Lim; Seonhee,7,0,34,27
1657723541106,MATH 10B,B01,083739,Sinha; Shubham,13,0,30,17
1657723547131,MATH 18,A01,083743,Cinel; Cameron Alexander,8,0,30,22
1657723547131,MATH 18,A02,083744,Cinel; Cameron Alexander,17,0,30,13
1657723547131,MATH 18,A03,083745,Cinel; Cameron Alexander,10,0,30,20
1657723547131,MATH 18,B01,083748,Rideout; David Porter,5,0,37,32
1657723547131,MATH 18,B02,083749,Rideout; David Porter,5,0,36,31
1657723547131,MATH 18,B03,083750,Rideout; David Porter,3,0,37,34
1657723547131,MATH 18,B04,083751,Rideout; David Porter,6,0,36,30
1657723547131,MATH 18,B05,093473,Rideout; David Porter,6,0,36,30
1657723547131,MATH 18,B06,093474,Rideout; David Porter,6,0,36,30
1657723553155,MATH 20A,A01,083754,Zheng; Zequn,14,0,40,26
1657723559177,MATH 20B,A01,083756,Briones; Jor-el Thomas Caparas,4,0,36,32
1657723559177,MATH 20B,A02,083757,Briones; Jor-el Thomas Caparas,1,0,36,35
1657723559177,MATH 20B,A03,093475,Briones; Jor-el Thomas Caparas,2,0,36,34
1657723565211,MATH 20C,A01,083760,Briones; Jor-el Thomas Caparas,1,0,35,34
1657723565211,MATH 20C,A02,083761,Briones; Jor-el Thomas Caparas,8,0,35,27
1657723565211,MATH 20C,A03,093476,Briones; Jor-el Thomas Caparas,0,1,36,36
1657723565211,MATH 20C,B01,083762,Bach; Quang Tran,1,0,30,29
1657723571242,MATH 20D,A01,083765,Tran; Brian Kha,5,0,30,25
1657723571242,MATH 20D,A02,083766,Tran; Brian Kha,5,0,30,25
1657723571242,MATH 20D,A03,083767,Tran; Brian Kha,5,0,30,25
1657723577271,MATH 20E,A01,083771,Ganguly; Soumya,9,0,32,23
1657723577271,MATH 20E,A02,083772,Ganguly; Soumya,6,0,32,26
1657723577271,MATH 20E,B01,083773,Ciotti; Benjamin,20,0,35,15
1657723577271,MATH 20E,B02,083774,Ciotti; Benjamin,18,0,35,17
1657723583303,MATH 103A,A01,083777,Greenfeld; Be'Eri,3,0,36,33
1657723583303,MATH 103A,A02,083778,Greenfeld; Be'Eri,5,0,36,31
1657723583303,MATH 103A,A03,093561,Greenfeld; Be'Eri,6,0,36,30
1657723583303,MATH 103A,B01,083779,Greenfeld; Be'Eri,7,0,36,29
1657723583303,MATH 103A,B02,083780,Greenfeld; Be'Eri,4,0,36,32
1657723583303,MATH 103A,B03,093562,Greenfeld; Be'Eri,3,0,36,33
1657723589326,MATH 105,A01,085443,Carter; Anne Toulson,15,0,35,20
1657723589326,MATH 105,A02,093477,Carter; Anne Toulson,20,0,35,15
1657723595361,MATH 109,A01,083213,Ganzberger; Geoffrey Michael,2,0,34,32
1657723595361,MATH 109,A02,083214,Ganzberger; Geoffrey Michael,4,0,34,30
1657723595361,MATH 109,A03,093478,Ganzberger; Geoffrey Michael,2,0,34,32
1657723595361,MATH 109,B01,083215,Ganzberger; Geoffrey Michael,1,0,32,31
1657723595361,MATH 109,B02,083216,Ganzberger; Geoffrey Michael,2,0,32,30
1657723595361,MATH 109,B03,093479,Ganzberger; Geoffrey Michael,8,0,32,24
1657723601384,MATH 142A,A01,083219,Chow; Bennett,7,0,32,25
1657723601384,MATH 142A,A02,083220,Chow; Bennett,10,0,32,22
1657723601384,MATH 142A,A03,093480,Chow; Bennett,9,0,32,23
1657723601384,MATH 142A,B03,093481,Chow; Bennett,8,0,32,24
1657723601384,MATH 142A,B04,093558,Chow; Bennett,13,0,32,19
1657723601384,MATH 142A,B05,093559,Chow; Bennett,6,0,32,26
1657723607416,MATH 193A,A01,083224,Rotar; Vladimir,8,0,34,26
1657723607416,MATH 193A,A02,083225,Rotar; Vladimir,9,0,34,25
1657723607416,MATH 193A,A03,083781,Rotar; Vladimir,5,0,34,29
1657723607416,MATH 193A,A04,083782,Rotar; Vladimir,10,0,34,24
1657723607416,MATH 193A,A05,093482,Rotar; Vladimir,10,0,34,24
1657723613470,MATH 197,001,091859,McAuley; Julian John,9999,0,9999,0
1657723613470,MATH 197,002,095566,Kedlaya; Kiran S.,9997,0,9999,2
1657723613470,MATH 197,003,095567,Xiao; Ming,9999,0,9999,0
1657723613470,MATH 197,004,095571,Perols; Johan Lars,9998,0,9999,1
1657723620536,COGS 9,A01,083615,Shannon; Kyle Michael,9,0,75,66
1657723626558,COGS 11,A01,083617,Boyle; Mary E. T.,23,0,48,25
1657723632584,COGS 13,A01,083071,Bastos; Amalia Pinkusfeld,11,0,71,60
1657723638611,COGS 14A,A01,092681,Semenuks; Arturs,5,1,100,95
1657723644639,COGS 14B,A01,083073,Cheng; Tzu-Han,6,0,63,57
1657723650660,COGS 17,A01,092677,Semenuks; Arturs,6,0,81,75
1657723656684,COGS 100,A01,083619,Allen; Michael Gordon,17,0,70,53
1657723662709,COGS 101A,A01,083621,Davis; Joshua Daniel,9,0,68,59
1657723668734,COGS 101B,A01,091572,Allen; Michael Gordon,12,0,65,53
1657723674762,COGS 101C,A01,083625,Delgado; Tania,17,0,35,18
1657723680797,COGS 107A,A01,083627,Boyle; Mary E. T.,13,0,60,47
1657723686825,COGS 118A,A01,083075,Gupta; Anjum,21,0,76,55
1657723692851,CSE 3,A50,083646,Miranda; Gregory Joseph,24,0,50,26
1657723698873,CSE 8A,A50,083650,Miranda; Gregory Joseph,17,1,56,39
1657723704898,CSE 11,A01,083080,Cao; Yingjun,6,15,40,34
1657723710922,CSE 12,A01,083652,Krause-Levy; Sophia Louisa,28,1,120,92
1657723716950,CSE 15L,A01,083654,Morris; Justin Loren,9,0,50,41
1657723716950,CSE 15L,A02,083655,Morris; Justin Loren,9,0,50,41
1657723722972,CSE 20,A01,083657,Tran; Khoa Dang,39,0,80,41
1657723729002,CSE 21,A01,095574,Bach; Quang Tran,22,0,48,26
1657723735028,CSE 30,A01,083084,Eldon; John,6,0,80,74
1657723735028,CSE 30,B01,095061,Bhaskar; Nishant,9,0,50,41
1657723741056,CSE 100,A01,083659,Cao; Yingjun,5,4,70,65
1657723747080,CSE 134B,A01,083661,Powell; Thomas Allan,23,0,100,77
1657723753109,CSE 140,A01,083663,Gungor; Onat,15,0,85,70
1657723759138,CSE 140L,A01,083088,Eldon; John,23,0,100,77
1657723765166,CSE 175,A01,083665,Kumar; Rakesh,3,0,25,22
1657723771190,CSE 190,A00,092507,Dubnov; Shlomo,8,0,20,12
1657723777257,ECE 45,A01,083139,Congero; Spencer William,6,0,75,69
1657723783282,ECE 65,A50,083695,Saad; Andrew S,12,0,30,18
1657723783282,ECE 65,A51,095125,Saad; Andrew S,24,0,26,2
1657723789305,ECE 109,A01,091882,Touri; Behrouz,20,0,70,50
1657723795328,ECE 180,A00,083140,Abi Samra; Nicholas Camill,1,0,30,29
1657723795328,ECE 180,B00,083141,Abi Samra; Nicholas Camill,0,0,30,30
1657723801356,MATH 10A,A01,083735,Patchell; Gregory David,2,0,30,28
1657723801356,MATH 10A,A02,083736,Patchell; Gregory David,20,0,30,10
1657723801356,MATH 10A,A03,083737,Patchell; Gregory David,16,0,30,14
1657723807384,MATH 10B,A01,083207,Lim; Seonhee,8,0,34,26
1657723807384,MATH 10B,A02,083208,Lim; Seonhee,9,0,35,26
1657723807384,MATH 10B,A03,093472,Lim; Seonhee,7,0,34,27
1657723807384,MATH 10B,B01,083739,Sinha; Shubham,13,0,30,17
1657723813411,MATH 18,A01,083743,Cinel; Cameron Alexander,8,0,30,22
1657723813411,MATH 18,A02,083744,Cinel; Cameron Alexander,17,0,30,13
1657723813411,MATH 18,A03,083745,Cinel; Cameron Alexander,10,0,30,20
1657723813411,MATH 18,B01,083748,Rideout; David Porter,5,0,37,32
1657723813411,MATH 18,B02,083749,Rideout; David Porter,5,0,36,31
1657723813411,MATH 18,B03,083750,Rideout; David Porter,3,0,37,34
1657723813411,MATH 18,B04,083751,Rideout; David Porter,6,0,36,30
1657723813411,MATH 18,B05,093473,Rideout; David Porter,6,0,36,30
1657723813411,MATH 18,B06,093474,Rideout; David Porter,6,0,36,30
1657723819435,MATH 20A,A01,083754,Zheng; Zequn,14,0,40,26
1657723825458,MATH 20B,A01,083756,Briones; Jor-el Thomas Caparas,4,0,36,32
1657723825458,MATH 20B,A02,083757,Briones; Jor-el Thomas Caparas,1,0,36,35
1657723825458,MATH 20B,A03,093475,Briones; Jor-el Thomas Caparas,2,0,36,34
1657723831488,MATH 20C,A01,083760,Briones; Jor-el Thomas Caparas,1,0,35,34
1657723831488,MATH 20C,A02,083761,Briones; Jor-el Thomas Caparas,8,0,35,27
1657723831488,MATH 20C,A03,093476,Briones; Jor-el Thomas Caparas,0,1,36,36
1657723831488,MATH 20C,B01,083762,Bach; Quang Tran,1,0,30,29
1657723837514,MATH 20D,A01,083765,Tran; Brian Kha,5,0,30,25
1657723837514,MATH 20D,A02,083766,Tran; Brian Kha,5,0,30,25
1657723837514,MATH 20D,A03,083767,Tran; Brian Kha,5,0,30,25
1657723843538,MATH 20E,A01,083771,Ganguly; Soumya,9,0,32,23
1657723843538,MATH 20E,A02,083772,Ganguly; Soumya,6,0,32,26
1657723843538,MATH 20E,B01,083773,Ciotti; Benjamin,20,0,35,15
1657723843538,MATH 20E,B02,083774,Ciotti; Benjamin,18,0,35,17
1657723849568,MATH 103A,A01,083777,Greenfeld; Be'Eri,3,0,36,33
1657723849568,MATH 103A,A02,083778,Greenfeld; Be'Eri,5,0,36,31
1657723849568,MATH 103A,A03,093561,Greenfeld; Be'Eri,6,0,36,30
1657723849568,MATH 103A,B01,083779,Greenfeld; Be'Eri,7,0,36,29
1657723849568,MATH 103A,B02,083780,Greenfeld; Be'Eri,4,0,36,32
1657723849568,MATH 103A,B03,093562,Greenfeld; Be'Eri,3,0,36,33
1657723855593,MATH 105,A01,085443,Carter; Anne Toulson,15,0,35,20
1657723855593,MATH 105,A02,093477,Carter; Anne Toulson,20,0,35,15
1657723861621,MATH 109,A01,083213,Ganzberger; Geoffrey Michael,2,0,34,32
1657723861621,MATH 109,A02,083214,Ganzberger; Geoffrey Michael,4,0,34,30
1657723861621,MATH 109,A03,093478,Ganzberger; Geoffrey Michael,2,0,34,32
1657723861621,MATH 109,B01,083215,Ganzberger; Geoffrey Michael,1,0,32,31
1657723861621,MATH 109,B02,083216,Ganzberger; Geoffrey Michael,2,0,32,30
1657723861621,MATH 109,B03,093479,Ganzberger; Geoffrey Michael,8,0,32,24
1657723867644,MATH 142A,A01,083219,Chow; Bennett,7,0,32,25
1657723867644,MATH 142A,A02,083220,Chow; Bennett,10,0,32,22
1657723867644,MATH 142A,A03,093480,Chow; Bennett,9,0,32,23
1657723867644,MATH 142A,B03,093481,Chow; Bennett,8,0,32,24
1657723867644,MATH 142A,B04,093558,Chow; Bennett,13,0,32,19
1657723867644,MATH 142A,B05,093559,Chow; Bennett,6,0,32,26
1657723873666,MATH 193A,A01,083224,Rotar; Vladimir,8,0,34,26
1657723873666,MATH 193A,A02,083225,Rotar; Vladimir,9,0,34,25
1657723873666,MATH 193A,A03,083781,Rotar; Vladimir,5,0,34,29
1657723873666,MATH 193A,A04,083782,Rotar; Vladimir,10,0,34,24
1657723873666,MATH 193A,A05,093482,Rotar; Vladimir,10,0,34,24
1657723879689,MATH 197,001,091859,McAuley; Julian John,9999,0,9999,0
1657723879689,MATH 197,002,095566,Kedlaya; Kiran S.,9997,0,9999,2
1657723879689,MATH 197,003,095567,Xiao; Ming,9999,0,9999,0
1657723879689,MATH 197,004,095571,Perols; Johan Lars,9998,0,9999,1
1657723886747,COGS 9,A01,083615,Shannon; Kyle Michael,9,0,75,66
1657723892778,COGS 11,A01,083617,Boyle; Mary E. T.,23,0,48,25
1657723898812,COGS 13,A01,083071,Bastos; Amalia Pinkusfeld,11,0,71,60
1657723904838,COGS 14A,A01,092681,Semenuks; Arturs,5,1,100,95
1657723910872,COGS 14B,A01,083073,Cheng; Tzu-Han,6,0,63,57
1657723916900,COGS 17,A01,092677,Semenuks; Arturs,6,0,81,75
1657723922925,COGS 100,A01,083619,Allen; Michael Gordon,17,0,70,53
1657723928949,COGS 101A,A01,083621,Davis; Joshua Daniel,9,0,68,59
1657723934982,COGS 101B,A01,091572,Allen; Michael Gordon,12,0,65,53
1657723941009,COGS 101C,A01,083625,Delgado; Tania,17,0,35,18
1657723947056,COGS 107A,A01,083627,Boyle; Mary E. T.,13,0,60,47
1657723953083,COGS 118A,A01,083075,Gupta; Anjum,21,0,76,55
1657723959112,CSE 3,A50,083646,Miranda; Gregory Joseph,24,0,50,26
1657723965209,CSE 8A,A50,083650,Miranda; Gregory Joseph,17,1,56,39
1657723971234,CSE 11,A01,083080,Cao; Yingjun,6,15,40,34
1657723977263,CSE 12,A01,083652,Krause-Levy; Sophia Louisa,28,1,120,92
1657723983294,CSE 15L,A01,083654,Morris; Justin Loren,9,0,50,41
1657723983294,CSE 15L,A02,083655,Morris; Justin Loren,9,0,50,41
1657723989321,CSE 20,A01,083657,Tran; Khoa Dang,39,0,80,41
1657723995348,CSE 21,A01,095574,Bach; Quang Tran,22,0,48,26
1657724001372,CSE 30,A01,083084,Eldon; John,6,0,80,74
1657724001372,CSE 30,B01,095061,Bhaskar; Nishant,9,0,50,41
1657724007397,CSE 100,A01,083659,Cao; Yingjun,5,4,70,65
1657724013421,CSE 134B,A01,083661,Powell; Thomas Allan,23,0,100,77
1657724019447,CSE 140,A01,083663,Gungor; Onat,15,0,85,70
1657724025475,CSE 140L,A01,083088,Eldon; John,23,0,100,77
1657724031498,CSE 175,A01,083665,Kumar; Rakesh,3,0,25,22
1657724037524,CSE 190,A00,092507,Dubnov; Shlomo,8,0,20,12
1657724043551,ECE 45,A01,083139,Congero; Spencer William,6,0,75,69
1657724049593,ECE 65,A50,083695,Saad; Andrew S,12,0,30,18
1657724049593,ECE 65,A51,095125,Saad; Andrew S,24,0,26,2
1657724055618,ECE 109,A01,091882,Touri; Behrouz,20,0,70,50
1657724061642,ECE 180,A00,083140,Abi Samra; Nicholas Camill,1,0,30,29
1657724061642,ECE 180,B00,083141,Abi Samra; Nicholas Camill,0,0,30,30
1657724067670,MATH 10A,A01,083735,Patchell; Gregory David,2,0,30,28
1657724067670,MATH 10A,A02,083736,Patchell; Gregory David,20,0,30,10
1657724067670,MATH 10A,A03,083737,Patchell; Gregory David,16,0,30,14
1657724073701,MATH 10B,A01,083207,Lim; Seonhee,8,0,34,26
1657724073701,MATH 10B,A02,083208,Lim; Seonhee,9,0,35,26
1657724073701,MATH 10B,A03,093472,Lim; Seonhee,7,0,34,27
1657724073701,MATH 10B,B01,083739,Sinha; Shubham,13,0,30,17
1657724079733,MATH 18,A01,083743,Cinel; Cameron Alexander,8,0,30,22
1657724079733,MATH 18,A02,083744,Cinel; Cameron Alexander,17,0,30,13
1657724079733,MATH 18,A03,083745,Cinel; Cameron Alexander,10,0,30,20
1657724079733,MATH 18,B01,083748,Rideout; David Porter,5,0,37,32
1657724079733,MATH 18,B02,083749,Rideout; David Porter,5,0,36,31
1657724079733,MATH 18,B03,083750,Rideout; David Porter,3,0,37,34
1657724079733,MATH 18,B04,083751,Rideout; David Porter,6,0,36,30
1657724079733,MATH 18,B05,093473,Rideout; David Porter,6,0,36,30
1657724079733,MATH 18,B06,093474,Rideout; David Porter,6,0,36,30
1657724085760,MATH 20A,A01,083754,Zheng; Zequn,14,0,40,26
1657724091797,MATH 20B,A01,083756,Briones; Jor-el Thomas Caparas,4,0,36,32
1657724091797,MATH 20B,A02,083757,Briones; Jor-el Thomas Caparas,1,0,36,35
1657724091797,MATH 20B,A03,093475,Briones; Jor-el Thomas Caparas,2,0,36,34
1657724097819,MATH 20C,A01,083760,Briones; Jor-el Thomas Caparas,1,0,35,34
1657724097819,MATH 20C,A02,083761,Briones; Jor-el Thomas Caparas,8,0,35,27
1657724097819,MATH 20C,A03,093476,Briones; Jor-el Thomas Caparas,0,1,36,36
1657724097819,MATH 20C,B01,083762,Bach; Quang Tran,1,0,30,29
1657724103844,MATH 20D,A01,083765,Tran; Brian Kha,5,0,30,25
1657724103844,MATH 20D,A02,083766,Tran; Brian Kha,5,0,30,25
1657724103844,MATH 20D,A03,083767,Tran; Brian Kha,5,0,30,25
1657724109867,MATH 20E,A01,083771,Ganguly; Soumya,9,0,32,23
1657724109867,MATH 20E,A02,083772,Ganguly; Soumya,6,0,32,26
1657724109867,MATH 20E,B01,083773,Ciotti; Benjamin,20,0,35,15
1657724109867,MATH 20E,B02,083774,Ciotti; Benjamin,18,0,35,17
1657724115893,MATH 103A,A01,083777,Greenfeld; Be'Eri,3,0,36,33
1657724115893,MATH 103A,A02,083778,Greenfeld; Be'Eri,5,0,36,31
1657724115893,MATH 103A,A03,093561,Greenfeld; Be'Eri,6,0,36,30
1657724115893,MATH 103A,B01,083779,Greenfeld; Be'Eri,7,0,36,29
1657724115893,MATH 103A,B02,083780,Greenfeld; Be'Eri,4,0,36,32
1657724115893,MATH 103A,B03,093562,Greenfeld; Be'Eri,3,0,36,33
1657724121922,MATH 105,A01,085443,Carter; Anne Toulson,15,0,35,20
1657724121922,MATH 105,A02,093477,Carter; Anne Toulson,20,0,35,15
1657724127946,MATH 109,A01,083213,Ganzberger; Geoffrey Michael,2,0,34,32
1657724127946,MATH 109,A02,083214,Ganzberger; Geoffrey Michael,4,0,34,30
1657724127946,MATH 109,A03,093478,Ganzberger; Geoffrey Michael,2,0,34,32
1657724127946,MATH 109,B01,083215,Ganzberger; Geoffrey Michael,1,0,32,31
1657724127946,MATH 109,B02,083216,Ganzberger; Geoffrey Michael,2,0,32,30
1657724127946,MATH 109,B03,093479,Ganzberger; Geoffrey Michael,8,0,32,24
1657724133982,MATH 142A,A01,083219,Chow; Bennett,7,0,32,25
1657724133982,MATH 142A,A02,083220,Chow; Bennett,10,0,32,22
1657724133982,MATH 142A,A03,093480,Chow; Bennett,9,0,32,23
1657724133982,MATH 142A,B03,093481,Chow; Bennett,8,0,32,24
1657724133982,MATH 142A,B04,093558,Chow; Bennett,13,0,32,19
1657724133982,MATH 142A,B05,093559,Chow; Bennett,6,0,32,26
1657724140005,MATH 193A,A01,083224,Rotar; Vladimir,8,0,34,26
1657724140005,MATH 193A,A02,083225,Rotar; Vladimir,9,0,34,25
1657724140005,MATH 193A,A03,083781,Rotar; Vladimir,5,0,34,29
1657724140005,MATH 193A,A04,083782,Rotar; Vladimir,10,0,34,24
1657724140005,MATH 193A,A05,093482,Rotar; Vladimir,10,0,34,24
1657724146035,MATH 197,001,091859,McAuley; Julian John,9999,0,9999,0
1657724146035,MATH 197,002,095566,Kedlaya; Kiran S.,9997,0,9999,2
1657724146035,MATH 197,003,095567,Xiao; Ming,9999,0,9999,0
1657724146035,MATH 197,004,095571,Perols; Johan Lars,9998,0,9999,1
1657724153105,COGS 9,A01,083615,Shannon; Kyle Michael,9,0,75,66
1657724159132,COGS 11,A01,083617,Boyle; Mary E. T.,23,0,48,25
1657724165162,COGS 13,A01,083071,Bastos; Amalia Pinkusfeld,11,0,71,60
1657724171186,COGS 14A,A01,092681,Semenuks; Arturs,5,1,100,95
1657724177210,COGS 14B,A01,083073,Cheng; Tzu-Han,6,0,63,57
1657724183237,COGS 17,A01,092677,Semenuks; Arturs,6,0,81,75
1657724189260,COGS 100,A01,083619,Allen; Michael Gordon,17,0,70,53
1657724195289,COGS 101A,A01,083621,Davis; Joshua Daniel,9,0,68,59
1657724201317,COGS 101B,A01,091572,Allen; Michael Gordon,12,0,65,53
1657724207343,COGS 101C,A01,083625,Delgado; Tania,17,0,35,18
1657724213370,COGS 107A,A01,083627,Boyle; Mary E. T.,13,0,60,47
1657724219393,COGS 118A,A01,083075,Gupta; Anjum,21,0,76,55
1657724225417,CSE 3,A50,083646,Miranda; Gregory Joseph,24,0,50,26
1657724231444,CSE 8A,A50,083650,Miranda; Gregory Joseph,17,1,56,39
1657724237470,CSE 11,A01,083080,Cao; Yingjun,6,15,40,34
1657724243494,CSE 12,A01,083652,Krause-Levy; Sophia Louisa,28,1,120,92
1657724249518,CSE 15L,A01,083654,Morris; Justin Loren,9,0,50,41
1657724249518,CSE 15L,A02,083655,Morris; Justin Loren,9,0,50,41
1657724255548,CSE 20,A01,083657,Tran; Khoa Dang,39,0,80,41
1657724261577,CSE 21,A01,095574,Bach; Quang Tran,22,0,48,26
1657724267613,CSE 30,A01,083084,Eldon; John,6,0,80,74
1657724267613,CSE 30,B01,095061,Bhaskar; Nishant,9,0,50,41
1657724273641,CSE 100,A01,083659,Cao; Yingjun,5,4,70,65
1657724279669,CSE 134B,A01,083661,Powell; Thomas Allan,23,0,100,77
1657724285692,CSE 140,A01,083663,Gungor; Onat,15,0,85,70
1657724291714,CSE 140L,A01,083088,Eldon; John,23,0,100,77
1657724297739,CSE 175,A01,083665,Kumar; Rakesh,3,0,25,22
1657724303769,CSE 190,A00,092507,Dubnov; Shlomo,8,0,20,12
1657724309793,ECE 45,A01,083139,Congero; Spencer William,6,0,75,69
1657724315816,ECE 65,A50,083695,Saad; Andrew S,12,0,30,18
1657724315816,ECE 65,A51,095125,Saad; Andrew S,24,0,26,2
1657724321840,ECE 109,A01,091882,Touri; Behrouz,20,0,70,50
1657724327865,ECE 180,A00,083140,Abi Samra; Nicholas Camill,1,0,30,29
1657724327865,ECE 180,B00,083141,Abi Samra; Nicholas Camill,0,0,30,30
1657724333896,MATH 10A,A01,083735,Patchell; Gregory David,2,0,30,28
1657724333896,MATH 10A,A02,083736,Patchell; Gregory David,20,0,30,10
1657724333896,MATH 10A,A03,083737,Patchell; Gregory David,16,0,30,14
1657724339926,MATH 10B,A01,083207,Lim; Seonhee,8,0,34,26
1657724339926,MATH 10B,A02,083208,Lim; Seonhee,9,0,35,26
1657724339926,MATH 10B,A03,093472,Lim; Seonhee,7,0,34,27
1657724339926,MATH 10B,B01,083739,Sinha; Shubham,13,0,30,17
1657724345957,MATH 18,A01,083743,Cinel; Cameron Alexander,8,0,30,22
1657724345957,MATH 18,A02,083744,Cinel; Cameron Alexander,17,0,30,13
1657724345957,MATH 18,A03,083745,Cinel; Cameron Alexander,10,0,30,20
1657724345957,MATH 18,B01,083748,Rideout; David Porter,5,0,37,32
1657724345957,MATH 18,B02,083749,Rideout; David Porter,5,0,36,31
1657724345957,MATH 18,B03,083750,Rideout; David Porter,3,0,37,34
1657724345957,MATH 18,B04,083751,Rideout; David Porter,6,0,36,30
1657724345957,MATH 18,B05,093473,Rideout; David Porter,6,0,36,30
1657724345957,MATH 18,B06,093474,Rideout; David Porter,6,0,36,30
1657724351980,MATH 20A,A01,083754,Zheng; Zequn,14,0,40,26
1657724358008,MATH 20B,A01,083756,Briones; Jor-el Thomas Caparas,4,0,36,32
1657724358008,MATH 20B,A02,083757,Briones; Jor-el Thomas Caparas,1,0,36,35
1657724358008,MATH 20B,A03,093475,Briones; Jor-el Thomas Caparas,2,0,36,34
1657724364033,MATH 20C,A01,083760,Briones; Jor-el Thomas Caparas,1,0,35,34
1657724364033,MATH 20C,A02,083761,Briones; Jor-el Thomas Caparas,8,0,35,27
1657724364033,MATH 20C,A03,093476,Briones; Jor-el Thomas Caparas,0,1,36,36
1657724364033,MATH 20C,B01,083762,Bach; Quang Tran,1,0,30,29
1657724370056,MATH 20D,A01,083765,Tran; Brian Kha,5,0,30,25
1657724370056,MATH 20D,A02,083766,Tran; Brian Kha,5,0,30,25
1657724370056,MATH 20D,A03,083767,Tran; Brian Kha,5,0,30,25
1657724376082,MATH 20E,A01,083771,Ganguly; Soumya,9,0,32,23
1657724376082,MATH 20E,A02,083772,Ganguly; Soumya,6,0,32,26
1657724376082,MATH 20E,B01,083773,Ciotti; Benjamin,20,0,35,15
1657724376082,MATH 20E,B02,083774,Ciotti; Benjamin,18,0,35,17
1657724382112,MATH 103A,A01,083777,Greenfeld; Be'Eri,3,0,36,33
1657724382112,MATH 103A,A02,083778,Greenfeld; Be'Eri,5,0,36,31
1657724382112,MATH 103A,A03,093561,Greenfeld; Be'Eri,6,0,36,30
1657724382112,MATH 103A,B01,083779,Greenfeld; Be'Eri,7,0,36,29
1657724382112,MATH 103A,B02,083780,Greenfeld; Be'Eri,4,0,36,32
1657724382112,MATH 103A,B03,093562,Greenfeld; Be'Eri,3,0,36,33
1657724388140,MATH 105,A01,085443,Carter; Anne Toulson,15,0,35,20
1657724388140,MATH 105,A02,093477,Carter; Anne Toulson,20,0,35,15
1657724394165,MATH 109,A01,083213,Ganzberger; Geoffrey Michael,2,0,34,32
1657724394165,MATH 109,A02,083214,Ganzberger; Geoffrey Michael,4,0,34,30
1657724394165,MATH 109,A03,093478,Ganzberger; Geoffrey Michael,2,0,34,32
1657724394165,MATH 109,B01,083215,Ganzberger; Geoffrey Michael,1,0,32,31
1657724394165,MATH 109,B02,083216,Ganzberger; Geoffrey Michael,2,0,32,30
1657724394165,MATH 109,B03,093479,Ganzberger; Geoffrey Michael,8,0,32,24
1657724400205,MATH 142A,A01,083219,Chow; Bennett,7,0,32,25
1657724400205,MATH 142A,A02,083220,Chow; Bennett,10,0,32,22
1657724400205,MATH 142A,A03,093480,Chow; Bennett,9,0,32,23
1657724400205,MATH 142A,B03,093481,Chow; Bennett,8,0,32,24
1657724400205,MATH 142A,B04,093558,Chow; Bennett,13,0,32,19
1657724400205,MATH 142A,B05,093559,Chow; Bennett,6,0,32,26
1657724406234,MATH 193A,A01,083224,Rotar; Vladimir,8,0,34,26
1657724406234,MATH 193A,A02,083225,Rotar; Vladimir,9,0,34,25
1657724406234,MATH 193A,A03,083781,Rotar; Vladimir,5,0,34,29
1657724406234,MATH 193A,A04,083782,Rotar; Vladimir,10,0,34,24
1657724406234,MATH 193A,A05,093482,Rotar; Vladimir,10,0,34,24
1657724412261,MATH 197,001,091859,McAuley; Julian John,9999,0,9999,0
1657724412261,MATH 197,002,095566,Kedlaya; Kiran S.,9997,0,9999,2
1657724412261,MATH 197,003,095567,Xiao; Ming,9999,0,9999,0
1657724412261,MATH 197,004,095571,Perols; Johan Lars,9998,0,9999,1
1657724419311,COGS 9,A01,083615,Shannon; Kyle Michael,9,0,75,66
1657724425335,COGS 11,A01,083617,Boyle; Mary E. T.,23,0,48,25
1657724431367,COGS 13,A01,083071,Bastos; Amalia Pinkusfeld,11,0,71,60
1657724437394,COGS 14A,A01,092681,Semenuks; Arturs,5,1,100,95
1657724443418,COGS 14B,A01,083073,Cheng; Tzu-Han,6,0,63,57
1657724449451,COGS 17,A01,092677,Semenuks; Arturs,6,0,81,75
1657724455478,COGS 100,A01,083619,Allen; Michael Gordon,17,0,70,53
1657724461505,COGS 101A,A01,083621,Davis; Joshua Daniel,9,0,68,59
1657724467533,COGS 101B,A01,091572,Allen; Michael Gordon,12,0,65,53
1657724473560,COGS 101C,A01,083625,Delgado; Tania,17,0,35,18
1657724479587,COGS 107A,A01,083627,Boyle; Mary E. T.,13,0,60,47
1657724485613,COGS 118A,A01,083075,Gupta; Anjum,21,0,76,55
1657724491639,CSE 3,A50,083646,Miranda; Gregory Joseph,24,0,50,26
1657724497674,CSE 8A,A50,083650,Miranda; Gregory Joseph,17,1,56,39
1657724503697,CSE 11,A01,083080,Cao; Yingjun,6,15,40,34
1657724509720,CSE 12,A01,083652,Krause-Levy; Sophia Louisa,28,1,120,92
1657724515744,CSE 15L,A01,083654,Morris; Justin Loren,9,0,50,41
1657724515744,CSE 15L,A02,083655,Morris; Justin Loren,9,0,50,41
1657724521766,CSE 20,A01,083657,Tran; Khoa Dang,39,0,80,41
1657724527796,CSE 21,A01,095574,Bach; Quang Tran,22,0,48,26
1657724533824,CSE 30,A01,083084,Eldon; John,6,0,80,74
1657724533824,CSE 30,B01,095061,Bhaskar; Nishant,9,0,50,41
1657724539866,CSE 100,A01,083659,Cao; Yingjun,5,4,70,65
1657724545888,CSE 134B,A01,083661,Powell; Thomas Allan,23,0,100,77
1657724551912,CSE 140,A01,083663,Gungor; Onat,15,0,85,70
1657724557939,CSE 140L,A01,083088,Eldon; John,23,0,100,77
1657724564040,CSE 175,A01,083665,Kumar; Rakesh,3,0,25,22
1657724570063,CSE 190,A00,092507,Dubnov; Shlomo,8,0,20,12
1657724576090,ECE 45,A01,083139,Congero; Spencer William,6,0,75,69
1657724582121,ECE 65,A50,083695,Saad; Andrew S,12,0,30,18
1657724582121,ECE 65,A51,095125,Saad; Andrew S,24,0,26,2
1657724588153,ECE 109,A01,091882,Touri; Behrouz,20,0,70,50
1657724594180,ECE 180,A00,083140,Abi Samra; Nicholas Camill,1,0,30,29
1657724594180,ECE 180,B00,083141,Abi Samra; Nicholas Camill,0,0,30,30
1657724600203,MATH 10A,A01,083735,Patchell; Gregory David,2,0,30,28
1657724600203,MATH 10A,A02,083736,Patchell; Gregory David,20,0,30,10
1657724600203,MATH 10A,A03,083737,Patchell; Gregory David,16,0,30,14
1657724606232,MATH 10B,A01,083207,Lim; Seonhee,8,0,34,26
1657724606232,MATH 10B,A02,083208,Lim; Seonhee,9,0,35,26
1657724606232,MATH 10B,A03,093472,Lim; Seonhee,7,0,34,27
1657724606232,MATH 10B,B01,083739,Sinha; Shubham,13,0,30,17
1657724612257,MATH 18,A01,083743,Cinel; Cameron Alexander,8,0,30,22
1657724612257,MATH 18,A02,083744,Cinel; Cameron Alexander,17,0,30,13
1657724612257,MATH 18,A03,083745,Cinel; Cameron Alexander,10,0,30,20
1657724612257,MATH 18,B01,083748,Rideout; David Porter,5,0,37,32
1657724612257,MATH 18,B02,083749,Rideout; David Porter,5,0,36,31
1657724612257,MATH 18,B03,083750,Rideout; David Porter,3,0,37,34
1657724612257,MATH 18,B04,083751,Rideout; David Porter,6,0,36,30
1657724612257,MATH 18,B05,093473,Rideout; David Porter,6,0,36,30
1657724612257,MATH 18,B06,093474,Rideout; David Porter,6,0,36,30
1657724618284,MATH 20A,A01,083754,Zheng; Zequn,14,0,40,26
1657724624308,MATH 20B,A01,083756,Briones; Jor-el Thomas Caparas,4,0,36,32
1657724624308,MATH 20B,A02,083757,Briones; Jor-el Thomas Caparas,1,0,36,35
1657724624308,MATH 20B,A03,093475,Briones; Jor-el Thomas Caparas,2,0,36,34
1657724630338,MATH 20C,A01,083760,Briones; Jor-el Thomas Caparas,1,0,35,34
1657724630338,MATH 20C,A02,083761,Briones; Jor-el Thomas Caparas,8,0,35,27
1657724630338,MATH 20C,A03,093476,Briones; Jor-el Thomas Caparas,0,1,36,36
1657724630338,MATH 20C,B01,083762,Bach; Quang Tran,1,0,30,29
1657724636363,MATH 20D,A01,083765,Tran; Brian Kha,5,0,30,25
1657724636363,MATH 20D,A02,083766,Tran; Brian Kha,5,0,30,25
1657724636363,MATH 20D,A03,083767,Tran; Brian Kha,5,0,30,25
1657724642392,MATH 20E,A01,083771,Ganguly; Soumya,9,0,32,23
1657724642392,MATH 20E,A02,083772,Ganguly; Soumya,6,0,32,26
1657724642392,MATH 20E,B01,083773,Ciotti; Benjamin,20,0,35,15
1657724642392,MATH 20E,B02,083774,Ciotti; Benjamin,18,0,35,17
1657724648418,MATH 103A,A01,083777,Greenfeld; Be'Eri,3,0,36,33
1657724648418,MATH 103A,A02,083778,Greenfeld; Be'Eri,5,0,36,31
1657724648418,MATH 103A,A03,093561,Greenfeld; Be'Eri,6,0,36,30
1657724648418,MATH 103A,B01,083779,Greenfeld; Be'Eri,7,0,36,29
1657724648418,MATH 103A,B02,083780,Greenfeld; Be'Eri,4,0,36,32
1657724648418,MATH 103A,B03,093562,Greenfeld; Be'Eri,3,0,36,33
1657724654444,MATH 105,A01,085443,Carter; Anne Toulson,15,0,35,20
1657724654444,MATH 105,A02,093477,Carter; Anne Toulson,20,0,35,15
1657724660468,MATH 109,A01,083213,Ganzberger; Geoffrey Michael,2,0,34,32
1657724660468,MATH 109,A02,083214,Ganzberger; Geoffrey Michael,4,0,34,30
1657724660468,MATH 109,A03,093478,Ganzberger; Geoffrey Michael,2,0,34,32
1657724660468,MATH 109,B01,083215,Ganzberger; Geoffrey Michael,1,0,32,31
1657724660468,MATH 109,B02,083216,Ganzberger; Geoffrey Michael,2,0,32,30
1657724660468,MATH 109,B03,093479,Ganzberger; Geoffrey Michael,8,0,32,24
1657724666498,MATH 142A,A01,083219,Chow; Bennett,7,0,32,25
1657724666498,MATH 142A,A02,083220,Chow; Bennett,10,0,32,22
1657724666498,MATH 142A,A03,093480,Chow; Bennett,9,0,32,23
1657724666498,MATH 142A,B03,093481,Chow; Bennett,8,0,32,24
1657724666498,MATH 142A,B04,093558,Chow; Bennett,13,0,32,19
1657724666498,MATH 142A,B05,093559,Chow; Bennett,6,0,32,26
1657724672523,MATH 193A,A01,083224,Rotar; Vladimir,8,0,34,26
1657724672523,MATH 193A,A02,083225,Rotar; Vladimir,9,0,34,25
1657724672523,MATH 193A,A03,083781,Rotar; Vladimir,5,0,34,29
1657724672523,MATH 193A,A04,083782,Rotar; Vladimir,10,0,34,24
1657724672523,MATH 193A,A05,093482,Rotar; Vladimir,10,0,34,24
1657724678545,MATH 197,001,091859,McAuley; Julian John,9999,0,9999,0
1657724678545,MATH 197,002,095566,Kedlaya; Kiran S.,9997,0,9999,2
1657724678545,MATH 197,003,095567,Xiao; Ming,9999,0,9999,0
1657724678545,MATH 197,004,095571,Perols; Johan Lars,9998,0,9999,1
1657724685598,COGS 9,A01,083615,Shannon; Kyle Michael,9,0,75,66
1657724691626,COGS 11,A01,083617,Boyle; Mary E. T.,23,0,48,25
1657724697654,COGS 13,A01,083071,Bastos; Amalia Pinkusfeld,11,0,71,60
1657724703683,COGS 14A,A01,092681,Semenuks; Arturs,5,1,100,95
1657724709707,COGS 14B,A01,083073,Cheng; Tzu-Han,6,0,63,57
1657724715731,COGS 17,A01,092677,Semenuks; Arturs,6,0,81,75
1657724721754,COGS 100,A01,083619,Allen; Michael Gordon,17,0,70,53
1657724727782,COGS 101A,A01,083621,Davis; Joshua Daniel,9,0,68,59
1657724733808,COGS 101B,A01,091572,Allen; Michael Gordon,12,0,65,53
1657724739832,COGS 101C,A01,083625,Delgado; Tania,17,0,35,18
1657724745856,COGS 107A,A01,083627,Boyle; Mary E. T.,13,0,60,47
1657724751884,COGS 118A,A01,083075,Gupta; Anjum,21,0,76,55
1657724757908,CSE 3,A50,083646,Miranda; Gregory Joseph,24,0,50,26
1657724763931,CSE 8A,A50,083650,Miranda; Gregory Joseph,17,1,56,39
1657724769965,CSE 11,A01,083080,Cao; Yingjun,6,15,40,34
1657724775988,CSE 12,A01,083652,Krause-Levy; Sophia Louisa,28,1,120,92
1657724782012,CSE 15L,A01,083654,Morris; Justin Loren,9,0,50,41
1657724782012,CSE 15L,A02,083655,Morris; Justin Loren,9,0,50,41
1657724788045,CSE 20,A01,083657,Tran; Khoa Dang,39,0,80,41
1657724794071,CSE 21,A01,095574,Bach; Quang Tran,22,0,48,26
1657724800097,CSE 30,A01,083084,Eldon; John,6,0,80,74
1657724800097,CSE 30,B01,095061,Bhaskar; Nishant,9,0,50,41
1657724806121,CSE 100,A01,083659,Cao; Yingjun,5,4,70,65
1657724812149,CSE 134B,A01,083661,Powell; Thomas Allan,23,0,100,77
1657724818175,CSE 140,A01,083663,Gungor; Onat,15,0,85,70
1657724824202,CSE 140L,A01,083088,Eldon; John,23,0,100,77
1657724830226,CSE 175,A01,083665,Kumar; Rakesh,3,0,25,22
1657724836248,CSE 190,A00,092507,Dubnov; Shlomo,8,0,20,12
1657724842272,ECE 45,A01,083139,Congero; Spencer William,6,0,75,69
1657724848298,ECE 65,A50,083695,Saad; Andrew S,12,0,30,18
1657724848298,ECE 65,A51,095125,Saad; Andrew S,24,0,26,2
1657724854322,ECE 109,A01,091882,Touri; Behrouz,20,0,70,50
1657724860344,ECE 180,A00,083140,Abi Samra; Nicholas Camill,1,0,30,29
1657724860344,ECE 180,B00,083141,Abi Samra; Nicholas Camill,0,0,30,30
1657724866367,MATH 10A,A01,083735,Patchell; Gregory David,2,0,30,28
1657724866367,MATH 10A,A02,083736,Patchell; Gregory David,20,0,30,10
1657724866367,MATH 10A,A03,083737,Patchell; Gregory David,16,0,30,14
1657724872392,MATH 10B,A01,083207,Lim; Seonhee,8,0,34,26
1657724872392,MATH 10B,A02,083208,Lim; Seonhee,9,0,35,26
1657724872392,MATH 10B,A03,093472,Lim; Seonhee,7,0,34,27
1657724872392,MATH 10B,B01,083739,Sinha; Shubham,13,0,30,17
1657724878417,MATH 18,A01,083743,Cinel; Cameron Alexander,8,0,30,22
1657724878417,MATH 18,A02,083744,Cinel; Cameron Alexander,17,0,30,13
1657724878417,MATH 18,A03,083745,Cinel; Cameron Alexander,10,0,30,20
1657724878417,MATH 18,B01,083748,Rideout; David Porter,5,0,37,32
1657724878417,MATH 18,B02,083749,Rideout; David Porter,5,0,36,31
1657724878417,MATH 18,B03,083750,Rideout; David Porter,3,0,37,34
1657724878417,MATH 18,B04,083751,Rideout; David Porter,6,0,36,30
1657724878417,MATH 18,B05,093473,Rideout; David Porter,6,0,36,30
1657724878417,MATH 18,B06,093474,Rideout; David Porter,6,0,36,30
1657724884440,MATH 20A,A01,083754,Zheng; Zequn,14,0,40,26
1657724890464,MATH 20B,A01,083756,Briones; Jor-el Thomas Caparas,4,0,36,32
1657724890464,MATH 20B,A02,083757,Briones; Jor-el Thomas Caparas,1,0,36,35
1657724890464,MATH 20B,A03,093475,Briones; Jor-el Thomas Caparas,2,0,36,34
1657724896487,MATH 20C,A01,083760,Briones; Jor-el Thomas Caparas,1,0,35,34
1657724896487,MATH 20C,A02,083761,Briones; Jor-el Thomas Caparas,8,0,35,27
1657724896487,MATH 20C,A03,093476,Briones; Jor-el Thomas Caparas,0,1,36,36
1657724896487,MATH 20C,B01,083762,Bach; Quang Tran,1,0,30,29
1657724902514,MATH 20D,A01,083765,Tran; Brian Kha,5,0,30,25
1657724902514,MATH 20D,A02,083766,Tran; Brian Kha,5,0,30,25
1657724902514,MATH 20D,A03,083767,Tran; Brian Kha,5,0,30,25
1657724908544,MATH 20E,A01,083771,Ganguly; Soumya,9,0,32,23
1657724908544,MATH 20E,A02,083772,Ganguly; Soumya,6,0,32,26
1657724908544,MATH 20E,B01,083773,Ciotti; Benjamin,20,0,35,15
1657724908544,MATH 20E,B02,083774,Ciotti; Benjamin,18,0,35,17
1657724914569,MATH 103A,A01,083777,Greenfeld; Be'Eri,3,0,36,33
1657724914569,MATH 103A,A02,083778,Greenfeld; Be'Eri,5,0,36,31
1657724914569,MATH 103A,A03,093561,Greenfeld; Be'Eri,6,0,36,30
1657724914569,MATH 103A,B01,083779,Greenfeld; Be'Eri,7,0,36,29
1657724914569,MATH 103A,B02,083780,Greenfeld; Be'Eri,4,0,36,32
1657724914569,MATH 103A,B03,093562,Greenfeld; Be'Eri,3,0,36,33
1657724920591,MATH 105,A01,085443,Carter; Anne Toulson,15,0,35,20
1657724920591,MATH 105,A02,093477,Carter; Anne Toulson,20,0,35,15
1657724926618,MATH 109,A01,083213,Ganzberger; Geoffrey Michael,2,0,34,32
1657724926618,MATH 109,A02,083214,Ganzberger; Geoffrey Michael,4,0,34,30
1657724926618,MATH 109,A03,093478,Ganzberger; Geoffrey Michael,2,0,34,32
1657724926618,MATH 109,B01,083215,Ganzberger; Geoffrey Michael,1,0,32,31
1657724926618,MATH 109,B02,083216,Ganzberger; Geoffrey Michael,2,0,32,30
1657724926618,MATH 109,B03,093479,Ganzberger; Geoffrey Michael,8,0,32,24
1657724932650,MATH 142A,A01,083219,Chow; Bennett,7,0,32,25
1657724932650,MATH 142A,A02,083220,Chow; Bennett,10,0,32,22
1657724932650,MATH 142A,A03,093480,Chow; Bennett,9,0,32,23
1657724932650,MATH 142A,B03,093481,Chow; Bennett,8,0,32,24
1657724932650,MATH 142A,B04,093558,Chow; Bennett,13,0,32,19
1657724932650,MATH 142A,B05,093559,Chow; Bennett,6,0,32,26
1657724938680,MATH 193A,A01,083224,Rotar; Vladimir,8,0,34,26
1657724938680,MATH 193A,A02,083225,Rotar; Vladimir,9,0,34,25
1657724938680,MATH 193A,A03,083781,Rotar; Vladimir,5,0,34,29
1657724938680,MATH 193A,A04,083782,Rotar; Vladimir,10,0,34,24
1657724938680,MATH 193A,A05,093482,Rotar; Vladimir,10,0,34,24
1657724944716,MATH 197,001,091859,McAuley; Julian John,9999,0,9999,0
1657724944716,MATH 197,002,095566,Kedlaya; Kiran S.,9997,0,9999,2
1657724944716,MATH 197,003,095567,Xiao; Ming,9999,0,9999,0
1657724944716,MATH 197,004,095571,Perols; Johan Lars,9998,0,9999,1
1657724951782,COGS 9,A01,083615,Shannon; Kyle Michael,9,0,75,66
1657724957808,COGS 11,A01,083617,Boyle; Mary E. T.,23,0,48,25
1657724963837,COGS 13,A01,083071,Bastos; Amalia Pinkusfeld,11,0,71,60
1657724969864,COGS 14A,A01,092681,Semenuks; Arturs,5,1,100,95
1657724975893,COGS 14B,A01,083073,Cheng; Tzu-Han,6,0,63,57
1657724981918,COGS 17,A01,092677,Semenuks; Arturs,6,0,81,75
1657724987948,COGS 100,A01,083619,Allen; Michael Gordon,17,0,70,53
1657724993970,COGS 101A,A01,083621,Davis; Joshua Daniel,9,0,68,59
1657724999999,COGS 101B,A01,091572,Allen; Michael Gordon,12,0,65,53
1657725006022,COGS 101C,A01,083625,Delgado; Tania,17,0,35,18
1657725012056,COGS 107A,A01,083627,Boyle; Mary E. T.,13,0,60,47
1657725018079,COGS 118A,A01,083075,Gupta; Anjum,21,0,76,55
1657725024106,CSE 3,A50,083646,Miranda; Gregory Joseph,24,0,50,26
1657725030135,CSE 8A,A50,083650,Miranda; Gregory Joseph,17,1,56,39
1657725036159,CSE 11,A01,083080,Cao; Yingjun,6,15,40,34
1657725042185,CSE 12,A01,083652,Krause-Levy; Sophia Louisa,28,1,120,92
1657725048209,CSE 15L,A01,083654,Morris; Justin Loren,9,0,50,41
1657725048209,CSE 15L,A02,083655,Morris; Justin Loren,9,0,50,41
1657725054232,CSE 20,A01,083657,Tran; Khoa Dang,39,0,80,41
1657725060260,CSE 21,A01,095574,Bach; Quang Tran,22,0,48,26
1657725066282,CSE 30,A01,083084,Eldon; John,6,0,80,74
1657725066282,CSE 30,B01,095061,Bhaskar; Nishant,9,0,50,41
1657725072309,CSE 100,A01,083659,Cao; Yingjun,5,4,70,65
1657725078334,CSE 134B,A01,083661,Powell; Thomas Allan,23,0,100,77
1657725084360,CSE 140,A01,083663,Gungor; Onat,15,0,85,70
1657725090385,CSE 140L,A01,083088,Eldon; John,23,0,100,77
1657725096419,CSE 175,A01,083665,Kumar; Rakesh,3,0,25,22
1657725102448,CSE 190,A00,092507,Dubnov; Shlomo,8,0,20,12
1657725108472,ECE 45,A01,083139,Congero; Spencer William,6,0,75,69
1657725114500,ECE 65,A50,083695,Saad; Andrew S,12,0,30,18
1657725114500,ECE 65,A51,095125,Saad; Andrew S,24,0,26,2
1657725120533,ECE 109,A01,091882,Touri; Behrouz,20,0,70,50
1657725126558,ECE 180,A00,083140,Abi Samra; Nicholas Camill,1,0,30,29
1657725126558,ECE 180,B00,083141,Abi Samra; Nicholas Camill,0,0,30,30
1657725132588,MATH 10A,A01,083735,Patchell; Gregory David,2,0,30,28
1657725132588,MATH 10A,A02,083736,Patchell; Gregory David,20,0,30,10
1657725132588,MATH 10A,A03,083737,Patchell; Gregory David,16,0,30,14
1657725138612,MATH 10B,A01,083207,Lim; Seonhee,8,0,34,26
1657725138612,MATH 10B,A02,083208,Lim; Seonhee,9,0,35,26
1657725138612,MATH 10B,A03,093472,Lim; Seonhee,7,0,34,27
1657725138612,MATH 10B,B01,083739,Sinha; Shubham,13,0,30,17
1657725144652,MATH 18,A01,083743,Cinel; Cameron Alexander,8,0,30,22
1657725144652,MATH 18,A02,083744,Cinel; Cameron Alexander,17,0,30,13
1657725144652,MATH 18,A03,083745,Cinel; Cameron Alexander,10,0,30,20
1657725144652,MATH 18,B01,083748,Rideout; David Porter,5,0,37,32
1657725144652,MATH 18,B02,083749,Rideout; David Porter,5,0,36,31
1657725144652,MATH 18,B03,083750,Rideout; David Porter,3,0,37,34
1657725144652,MATH 18,B04,083751,Rideout; David Porter,6,0,36,30
1657725144652,MATH 18,B05,093473,Rideout; David Porter,6,0,36,30
1657725144652,MATH 18,B06,093474,Rideout; David Porter,6,0,36,30
1657725150676,MATH 20A,A01,083754,Zheng; Zequn,14,0,40,26
1657725156707,MATH 20B,A01,083756,Briones; Jor-el Thomas Caparas,4,0,36,32
1657725156707,MATH 20B,A02,083757,Briones; Jor-el Thomas Caparas,1,0,36,35
1657725156707,MATH 20B,A03,093475,Briones; Jor-el Thomas Caparas,2,0,36,34
1657725162822,MATH 20C,A01,083760,Briones; Jor-el Thomas Caparas,1,0,35,34
1657725162822,MATH 20C,A02,083761,Briones; Jor-el Thomas Caparas,8,0,35,27
1657725162822,MATH 20C,A03,093476,Briones; Jor-el Thomas Caparas,0,1,36,36
1657725162822,MATH 20C,B01,083762,Bach; Quang Tran,1,0,30,29
1657725168847,MATH 20D,A01,083765,Tran; Brian Kha,5,0,30,25
1657725168847,MATH 20D,A02,083766,Tran; Brian Kha,5,0,30,25
1657725168847,MATH 20D,A03,083767,Tran; Brian Kha,5,0,30,25
1657725174873,MATH 20E,A01,083771,Ganguly; Soumya,9,0,32,23
1657725174873,MATH 20E,A02,083772,Ganguly; Soumya,6,0,32,26
1657725174873,MATH 20E,B01,083773,Ciotti; Benjamin,20,0,35,15
1657725174873,MATH 20E,B02,083774,Ciotti; Benjamin,18,0,35,17
1657725180898,MATH 103A,A01,083777,Greenfeld; Be'Eri,3,0,36,33
1657725180898,MATH 103A,A02,083778,Greenfeld; Be'Eri,5,0,36,31
1657725180898,MATH 103A,A03,093561,Greenfeld; Be'Eri,6,0,36,30
1657725180898,MATH 103A,B01,083779,Greenfeld; Be'Eri,7,0,36,29
1657725180898,MATH 103A,B02,083780,Greenfeld; Be'Eri,4,0,36,32
1657725180898,MATH 103A,B03,093562,Greenfeld; Be'Eri,3,0,36,33
1657725186922,MATH 105,A01,085443,Carter; Anne Toulson,15,0,35,20
1657725186922,MATH 105,A02,093477,Carter; Anne Toulson,20,0,35,15
1657725192950,MATH 109,A01,083213,Ganzberger; Geoffrey Michael,2,0,34,32
1657725192950,MATH 109,A02,083214,Ganzberger; Geoffrey Michael,4,0,34,30
1657725192950,MATH 109,A03,093478,Ganzberger; Geoffrey Michael,2,0,34,32
1657725192950,MATH 109,B01,083215,Ganzberger; Geoffrey Michael,1,0,32,31
1657725192950,MATH 109,B02,083216,Ganzberger; Geoffrey Michael,2,0,32,30
1657725192950,MATH 109,B03,093479,Ganzberger; Geoffrey Michael,8,0,32,24
1657725198980,MATH 142A,A01,083219,Chow; Bennett,7,0,32,25
1657725198980,MATH 142A,A02,083220,Chow; Bennett,10,0,32,22
1657725198980,MATH 142A,A03,093480,Chow; Bennett,9,0,32,23
1657725198980,MATH 142A,B03,093481,Chow; Bennett,8,0,32,24
1657725198980,MATH 142A,B04,093558,Chow; Bennett,13,0,32,19
1657725198980,MATH 142A,B05,093559,Chow; Bennett,6,0,32,26
1657725205009,MATH 193A,A01,083224,Rotar; Vladimir,8,0,34,26
1657725205009,MATH 193A,A02,083225,Rotar; Vladimir,9,0,34,25
1657725205009,MATH 193A,A03,083781,Rotar; Vladimir,5,0,34,29
1657725205009,MATH 193A,A04,083782,Rotar; Vladimir,10,0,34,24
1657725205009,MATH 193A,A05,093482,Rotar; Vladimir,10,0,34,24
1657725211036,MATH 197,001,091859,McAuley; Julian John,9999,0,9999,0
1657725211036,MATH 197,002,095566,Kedlaya; Kiran S.,9997,0,9999,2
1657725211036,MATH 197,003,095567,Xiao; Ming,9999,0,9999,0
1657725211036,MATH 197,004,095571,Perols; Johan Lars,9998,0,9999,1
1657725218090,COGS 9,A01,083615,Shannon; Kyle Michael,9,0,75,66
1657725224113,COGS 11,A01,083617,Boyle; Mary E. T.,23,0,48,25
1657725230139,COGS 13,A01,083071,Bastos; Amalia Pinkusfeld,11,0,71,60
1657725236162,COGS 14A,A01,092681,Semenuks; Arturs,5,1,100,95
1657725242186,COGS 14B,A01,083073,Cheng; Tzu-Han,6,0,63,57
1657725248211,COGS 17,A01,092677,Semenuks; Arturs,6,0,81,75
1657725254236,COGS 100,A01,083619,Allen; Michael Gordon,17,0,70,53
1657725260262,COGS 101A,A01,083621,Davis; Joshua Daniel,9,0,68,59
1657725266290,COGS 101B,A01,091572,Allen; Michael Gordon,12,0,65,53
1657725272318,COGS 101C,A01,083625,Delgado; Tania,17,0,35,18
1657725278345,COGS 107A,A01,083627,Boyle; Mary E. T.,13,0,60,47
1657725284375,COGS 118A,A01,083075,Gupta; Anjum,21,0,76,55
1657725290399,CSE 3,A50,083646,Miranda; Gregory Joseph,24,0,50,26
1657725296435,CSE 8A,A50,083650,Miranda; Gregory Joseph,17,1,56,39
1657725302461,CSE 11,A01,083080,Cao; Yingjun,6,15,40,34
1657725308485,CSE 12,A01,083652,Krause-Levy; Sophia Louisa,28,1,120,92
1657725314507,CSE 15L,A01,083654,Morris; Justin Loren,9,0,50,41
1657725314507,CSE 15L,A02,083655,Morris; Justin Loren,9,0,50,41
1657725320529,CSE 20,A01,083657,Tran; Khoa Dang,39,0,80,41
1657725326551,CSE 21,A01,095574,Bach; Quang Tran,22,0,48,26
1657725332581,CSE 30,A01,083084,Eldon; John,6,0,80,74
1657725332581,CSE 30,B01,095061,Bhaskar; Nishant,9,0,50,41
1657725338605,CSE 100,A01,083659,Cao; Yingjun,5,4,70,65
1657725344636,CSE 134B,A01,083661,Powell; Thomas Allan,23,0,100,77
1657725350659,CSE 140,A01,083663,Gungor; Onat,15,0,85,70
1657725356693,CSE 140L,A01,083088,Eldon; John,23,0,100,77
1657725362746,CSE 175,A01,083665,Kumar; Rakesh,3,0,25,22
1657725368770,CSE 190,A00,092507,Dubnov; Shlomo,8,0,20,12
1657725374792,ECE 45,A01,083139,Congero; Spencer William,6,0,75,69
1657725380818,ECE 65,A50,083695,Saad; Andrew S,12,0,30,18
1657725380818,ECE 65,A51,095125,Saad; Andrew S,24,0,26,2
1657725386845,ECE 109,A01,091882,Touri; Behrouz,20,0,70,50
1657725392871,ECE 180,A00,083140,Abi Samra; Nicholas Camill,1,0,30,29
1657725392871,ECE 180,B00,083141,Abi Samra; Nicholas Camill,0,0,30,30
1657725398896,MATH 10A,A01,083735,Patchell; Gregory David,2,0,30,28
1657725398896,MATH 10A,A02,083736,Patchell; Gregory David,20,0,30,10
1657725398896,MATH 10A,A03,083737,Patchell; Gregory David,16,0,30,14
1657725404922,MATH 10B,A01,083207,Lim; Seonhee,8,0,34,26
1657725404922,MATH 10B,A02,083208,Lim; Seonhee,9,0,35,26
1657725404922,MATH 10B,A03,093472,Lim; Seonhee,7,0,34,27
1657725404922,MATH 10B,B01,083739,Sinha; Shubham,13,0,30,17
1657725410945,MATH 18,A01,083743,Cinel; Cameron Alexander,8,0,30,22
1657725410945,MATH 18,A02,083744,Cinel; Cameron Alexander,17,0,30,13
1657725410945,MATH 18,A03,083745,Cinel; Cameron Alexander,10,0,30,20
1657725410945,MATH 18,B01,083748,Rideout; David Porter,5,0,37,32
1657725410945,MATH 18,B02,083749,Rideout; David Porter,5,0,36,31
1657725410945,MATH 18,B03,083750,Rideout; David Porter,3,0,37,34
1657725410945,MATH 18,B04,083751,Rideout; David Porter,6,0,36,30
1657725410945,MATH 18,B05,093473,Rideout; David Porter,6,0,36,30
1657725410945,MATH 18,B06,093474,Rideout; David Porter,6,0,36,30
1657725416967,MATH 20A,A01,083754,Zheng; Zequn,14,0,40,26
1657725422990,MATH 20B,A01,083756,Briones; Jor-el Thomas Caparas,4,0,36,32
1657725422990,MATH 20B,A02,083757,Briones; Jor-el Thomas Caparas,1,0,36,35
1657725422990,MATH 20B,A03,093475,Briones; Jor-el Thomas Caparas,2,0,36,34
1657725429013,MATH 20C,A01,083760,Briones; Jor-el Thomas Caparas,1,0,35,34
1657725429013,MATH 20C,A02,083761,Briones; Jor-el Thomas Caparas,8,0,35,27
1657725429013,MATH 20C,A03,093476,Briones; Jor-el Thomas Caparas,0,1,36,36
1657725429013,MATH 20C,B01,083762,Bach; Quang Tran,1,0,30,29
1657725435043,MATH 20D,A01,083765,Tran; Brian Kha,5,0,30,25
1657725435043,MATH 20D,A02,083766,Tran; Brian Kha,5,0,30,25
1657725435043,MATH 20D,A03,083767,Tran; Brian Kha,5,0,30,25
1657725441067,MATH 20E,A01,083771,Ganguly; Soumya,9,0,32,23
1657725441067,MATH 20E,A02,083772,Ganguly; Soumya,6,0,32,26
1657725441067,MATH 20E,B01,083773,Ciotti; Benjamin,20,0,35,15
1657725441067,MATH 20E,B02,083774,Ciotti; Benjamin,18,0,35,17
1657725447101,MATH 103A,A01,083777,Greenfeld; Be'Eri,3,0,36,33
1657725447101,MATH 103A,A02,083778,Greenfeld; Be'Eri,5,0,36,31
1657725447101,MATH 103A,A03,093561,Greenfeld; Be'Eri,6,0,36,30
1657725447101,MATH 103A,B01,083779,Greenfeld; Be'Eri,7,0,36,29
1657725447101,MATH 103A,B02,083780,Greenfeld; Be'Eri,4,0,36,32
1657725447101,MATH 103A,B03,093562,Greenfeld; Be'Eri,3,0,36,33
1657725453129,MATH 105,A01,085443,Carter; Anne Toulson,15,0,35,20
1657725453129,MATH 105,A02,093477,Carter; Anne Toulson,20,0,35,15
1657725459156,MATH 109,A01,083213,Ganzberger; Geoffrey Michael,2,0,34,32
1657725459156,MATH 109,A02,083214,Ganzberger; Geoffrey Michael,4,0,34,30
1657725459156,MATH 109,A03,093478,Ganzberger; Geoffrey Michael,2,0,34,32
1657725459156,MATH 109,B01,083215,Ganzberger; Geoffrey Michael,1,0,32,31
1657725459156,MATH 109,B02,083216,Ganzberger; Geoffrey Michael,2,0,32,30
1657725459156,MATH 109,B03,093479,Ganzberger; Geoffrey Michael,8,0,32,24
1657725465187,MATH 142A,A01,083219,Chow; Bennett,7,0,32,25
1657725465187,MATH 142A,A02,083220,Chow; Bennett,10,0,32,22
1657725465187,MATH 142A,A03,093480,Chow; Bennett,9,0,32,23
1657725465187,MATH 142A,B03,093481,Chow; Bennett,8,0,32,24
1657725465187,MATH 142A,B04,093558,Chow; Bennett,13,0,32,19
1657725465187,MATH 142A,B05,093559,Chow; Bennett,6,0,32,26
1657725471211,MATH 193A,A01,083224,Rotar; Vladimir,8,0,34,26
1657725471211,MATH 193A,A02,083225,Rotar; Vladimir,9,0,34,25
1657725471211,MATH 193A,A03,083781,Rotar; Vladimir,5,0,34,29
1657725471211,MATH 193A,A04,083782,Rotar; Vladimir,10,0,34,24
1657725471211,MATH 193A,A05,093482,Rotar; Vladimir,10,0,34,24
1657725477235,MATH 197,001,091859,McAuley; Julian John,9999,0,9999,0
1657725477235,MATH 197,002,095566,Kedlaya; Kiran S.,9997,0,9999,2
1657725477235,MATH 197,003,095567,Xiao; Ming,9999,0,9999,0
1657725477235,MATH 197,004,095571,Perols; Johan Lars,9998,0,9999,1
1657725484302,COGS 9,A01,083615,Shannon; Kyle Michael,9,0,75,66
1657725490334,COGS 11,A01,083617,Boyle; Mary E. T.,23,0,48,25
1657725496361,COGS 13,A01,083071,Bastos; Amalia Pinkusfeld,11,0,71,60
1657725502389,COGS 14A,A01,092681,Semenuks; Arturs,5,1,100,95
1657725508416,COGS 14B,A01,083073,Cheng; Tzu-Han,6,0,63,57
1657725514440,COGS 17,A01,092677,Semenuks; Arturs,6,0,81,75
1657725520467,COGS 100,A01,083619,Allen; Michael Gordon,17,0,70,53
1657725526504,COGS 101A,A01,083621,Davis; Joshua Daniel,9,0,68,59
1657725532540,COGS 101B,A01,091572,Allen; Michael Gordon,12,0,65,53
1657725538568,COGS 101C,A01,083625,Delgado; Tania,17,0,35,18
1657725544593,COGS 107A,A01,083627,Boyle; Mary E. T.,13,0,60,47
1657725550618,COGS 118A,A01,083075,Gupta; Anjum,21,0,76,55
1657725556642,CSE 3,A50,083646,Miranda; Gregory Joseph,24,0,50,26
1657725562677,CSE 8A,A50,083650,Miranda; Gregory Joseph,17,1,56,39
1657725568698,CSE 11,A01,083080,Cao; Yingjun,6,15,40,34
1657725574722,CSE 12,A01,083652,Krause-Levy; Sophia Louisa,28,1,120,92
1657725580746,CSE 15L,A01,083654,Morris; Justin Loren,9,0,50,41
1657725580746,CSE 15L,A02,083655,Morris; Justin Loren,9,0,50,41
1657725586773,CSE 20,A01,083657,Tran; Khoa Dang,39,0,80,41
1657725592802,CSE 21,A01,095574,Bach; Quang Tran,22,0,48,26
1657725598830,CSE 30,A01,083084,Eldon; John,6,0,80,74
1657725598830,CSE 30,B01,095061,Bhaskar; Nishant,9,0,50,41
1657725604857,CSE 100,A01,083659,Cao; Yingjun,5,4,70,65
1657725610883,CSE 134B,A01,083661,Powell; Thomas Allan,23,0,100,77
1657725616910,CSE 140,A01,083663,Gungor; Onat,15,0,85,70
1657725622934,CSE 140L,A01,083088,Eldon; John,23,0,100,77
1657725628959,CSE 175,A01,083665,Kumar; Rakesh,3,0,25,22
1657725634980,CSE 190,A00,092507,Dubnov; Shlomo,8,0,20,12
1657725641008,ECE 45,A01,083139,Congero; Spencer William,6,0,75,69
1657725647036,ECE 65,A50,083695,Saad; Andrew S,12,0,30,18
1657725647036,ECE 65,A51,095125,Saad; Andrew S,24,0,26,2
1657725653078,ECE 109,A01,091882,Touri; Behrouz,20,0,70,50
1657725659111,ECE 180,A00,083140,Abi Samra; Nicholas Camill,1,0,30,29
1657725659111,ECE 180,B00,083141,Abi Samra; Nicholas Camill,0,0,30,30
1657725665135,MATH 10A,A01,083735,Patchell; Gregory David,2,0,30,28
1657725665135,MATH 10A,A02,083736,Patchell; Gregory David,20,0,30,10
1657725665135,MATH 10A,A03,083737,Patchell; Gregory David,16,0,30,14
1657725671160,MATH 10B,A01,083207,Lim; Seonhee,8,0,34,26
1657725671160,MATH 10B,A02,083208,Lim; Seonhee,9,0,35,26
1657725671160,MATH 10B,A03,093472,Lim; Seonhee,7,0,34,27
1657725671160,MATH 10B,B01,083739,Sinha; Shubham,13,0,30,17
1657725677189,MATH 18,A01,083743,Cinel; Cameron Alexander,8,0,30,22
1657725677189,MATH 18,A02,083744,Cinel; Cameron Alexander,17,0,30,13
1657725677189,MATH 18,A03,083745,Cinel; Cameron Alexander,10,0,30,20
1657725677189,MATH 18,B01,083748,Rideout; David Porter,5,0,37,32
1657725677189,MATH 18,B02,083749,Rideout; David Porter,5,0,36,31
1657725677189,MATH 18,B03,083750,Rideout; David Porter,3,0,37,34
1657725677189,MATH 18,B04,083751,Rideout; David Porter,6,0,36,30
1657725677189,MATH 18,B05,093473,Rideout; David Porter,6,0,36,30
1657725677189,MATH 18,B06,093474,Rideout; David Porter,6,0,36,30
1657725683212,MATH 20A,A01,083754,Zheng; Zequn,14,0,40,26
1657725689236,MATH 20B,A01,083756,Briones; Jor-el Thomas Caparas,4,0,36,32
1657725689236,MATH 20B,A02,083757,Briones; Jor-el Thomas Caparas,1,0,36,35
1657725689236,MATH 20B,A03,093475,Briones; Jor-el Thomas Caparas,2,0,36,34
1657725695258,MATH 20C,A01,083760,Briones; Jor-el Thomas Caparas,1,0,35,34
1657725695258,MATH 20C,A02,083761,Briones; Jor-el Thomas Caparas,8,0,35,27
1657725695258,MATH 20C,A03,093476,Briones; Jor-el Thomas Caparas,0,1,36,36
1657725695258,MATH 20C,B01,083762,Bach; Quang Tran,1,0,30,29
1657725701283,MATH 20D,A01,083765,Tran; Brian Kha,5,0,30,25
1657725701283,MATH 20D,A02,083766,Tran; Brian Kha,5,0,30,25
1657725701283,MATH 20D,A03,083767,Tran; Brian Kha,5,0,30,25
1657725707307,MATH 20E,A01,083771,Ganguly; Soumya,9,0,32,23
1657725707307,MATH 20E,A02,083772,Ganguly; Soumya,6,0,32,26
1657725707307,MATH 20E,B01,083773,Ciotti; Benjamin,20,0,35,15
1657725707307,MATH 20E,B02,083774,Ciotti; Benjamin,18,0,35,17
1657725713332,MATH 103A,A01,083777,Greenfeld; Be'Eri,3,0,36,33
1657725713332,MATH 103A,A02,083778,Greenfeld; Be'Eri,5,0,36,31
1657725713332,MATH 103A,A03,093561,Greenfeld; Be'Eri,6,0,36,30
1657725713332,MATH 103A,B01,083779,Greenfeld; Be'Eri,7,0,36,29
1657725713332,MATH 103A,B02,083780,Greenfeld; Be'Eri,4,0,36,32
1657725713332,MATH 103A,B03,093562,Greenfeld; Be'Eri,3,0,36,33
1657725719356,MATH 105,A01,085443,Carter; Anne Toulson,15,0,35,20
1657725719356,MATH 105,A02,093477,Carter; Anne Toulson,20,0,35,15
1657725725409,MATH 109,A01,083213,Ganzberger; Geoffrey Michael,2,0,34,32
1657725725409,MATH 109,A02,083214,Ganzberger; Geoffrey Michael,4,0,34,30
1657725725409,MATH 109,A03,093478,Ganzberger; Geoffrey Michael,2,0,34,32
1657725725409,MATH 109,B01,083215,Ganzberger; Geoffrey Michael,1,0,32,31
1657725725409,MATH 109,B02,083216,Ganzberger; Geoffrey Michael,2,0,32,30
1657725725409,MATH 109,B03,093479,Ganzberger; Geoffrey Michael,8,0,32,24
1657725731436,MATH 142A,A01,083219,Chow; Bennett,7,0,32,25
1657725731436,MATH 142A,A02,083220,Chow; Bennett,10,0,32,22
1657725731436,MATH 142A,A03,093480,Chow; Bennett,9,0,32,23
1657725731436,MATH 142A,B03,093481,Chow; Bennett,8,0,32,24
1657725731436,MATH 142A,B04,093558,Chow; Bennett,13,0,32,19
1657725731436,MATH 142A,B05,093559,Chow; Bennett,6,0,32,26
1657725737462,MATH 193A,A01,083224,Rotar; Vladimir,8,0,34,26
1657725737462,MATH 193A,A02,083225,Rotar; Vladimir,9,0,34,25
1657725737462,MATH 193A,A03,083781,Rotar; Vladimir,5,0,34,29
1657725737462,MATH 193A,A04,083782,Rotar; Vladimir,10,0,34,24
1657725737462,MATH 193A,A05,093482,Rotar; Vladimir,10,0,34,24
1657725743490,MATH 197,001,091859,McAuley; Julian John,9999,0,9999,0
1657725743490,MATH 197,002,095566,Kedlaya; Kiran S.,9997,0,9999,2
1657725743490,MATH 197,003,095567,Xiao; Ming,9999,0,9999,0
1657725743490,MATH 197,004,095571,Perols; Johan Lars,9998,0,9999,1
1657725750556,COGS 9,A01,083615,Shannon; Kyle Michael,9,0,75,66
1657725756653,COGS 11,A01,083617,Boyle; Mary E. T.,23,0,48,25
1657725762677,COGS 13,A01,083071,Bastos; Amalia Pinkusfeld,11,0,71,60
1657725768703,COGS 14A,A01,092681,Semenuks; Arturs,5,1,100,95
1657725774728,COGS 14B,A01,083073,Cheng; Tzu-Han,6,0,63,57
1657725780752,COGS 17,A01,092677,Semenuks; Arturs,6,0,81,75
1657725786781,COGS 100,A01,083619,Allen; Michael Gordon,17,0,70,53
1657725792806,COGS 101A,A01,083621,Davis; Joshua Daniel,9,0,68,59
1657725798836,COGS 101B,A01,091572,Allen; Michael Gordon,12,0,65,53
1657725804861,COGS 101C,A01,083625,Delgado; Tania,17,0,35,18
1657725810891,COGS 107A,A01,083627,Boyle; Mary E. T.,13,0,60,47
1657725816916,COGS 118A,A01,083075,Gupta; Anjum,21,0,76,55
1657725822946,CSE 3,A50,083646,Miranda; Gregory Joseph,24,0,50,26
1657725828970,CSE 8A,A50,083650,Miranda; Gregory Joseph,17,1,56,39
1657725834992,CSE 11,A01,083080,Cao; Yingjun,6,15,40,34
1657725841019,CSE 12,A01,083652,Krause-Levy; Sophia Louisa,28,1,120,92
1657725847050,CSE 15L,A01,083654,Morris; Justin Loren,9,0,50,41
1657725847050,CSE 15L,A02,083655,Morris; Justin Loren,9,0,50,41
1657725853073,CSE 20,A01,083657,Tran; Khoa Dang,39,0,80,41
1657725859098,CSE 21,A01,095574,Bach; Quang Tran,22,0,48,26
1657725865127,CSE 30,A01,083084,Eldon; John,6,0,80,74
1657725865127,CSE 30,B01,095061,Bhaskar; Nishant,9,0,50,41
1657725871150,CSE 100,A01,083659,Cao; Yingjun,5,4,70,65
1657725877178,CSE 134B,A01,083661,Powell; Thomas Allan,23,0,100,77
1657725883201,CSE 140,A01,083663,Gungor; Onat,15,0,85,70
1657725889230,CSE 140L,A01,083088,Eldon; John,23,0,100,77
1657725895258,CSE 175,A01,083665,Kumar; Rakesh,3,0,25,22
1657725901283,CSE 190,A00,092507,Dubnov; Shlomo,8,0,20,12
1657725907307,ECE 45,A01,083139,Congero; Spencer William,6,0,75,69
1657725913331,ECE 65,A50,083695,Saad; Andrew S,12,0,30,18
1657725913331,ECE 65,A51,095125,Saad; Andrew S,24,0,26,2
1657725919357,ECE 109,A01,091882,Touri; Behrouz,20,0,70,50
1657725925383,ECE 180,A00,083140,Abi Samra; Nicholas Camill,1,0,30,29
1657725925383,ECE 180,B00,083141,Abi Samra; Nicholas Camill,0,0,30,30
1657725931419,MATH 10A,A01,083735,Patchell; Gregory David,2,0,30,28
1657725931419,MATH 10A,A02,083736,Patchell; Gregory David,20,0,30,10
1657725931419,MATH 10A,A03,083737,Patchell; Gregory David,16,0,30,14
1657725937444,MATH 10B,A01,083207,Lim; Seonhee,8,0,34,26
1657725937444,MATH 10B,A02,083208,Lim; Seonhee,9,0,35,26
1657725937444,MATH 10B,A03,093472,Lim; Seonhee,7,0,34,27
1657725937444,MATH 10B,B01,083739,Sinha; Shubham,13,0,30,17
1657725943471,MATH 18,A01,083743,Cinel; Cameron Alexander,8,0,30,22
1657725943471,MATH 18,A02,083744,Cinel; Cameron Alexander,17,0,30,13
1657725943471,MATH 18,A03,083745,Cinel; Cameron Alexander,10,0,30,20
1657725943471,MATH 18,B01,083748,Rideout; David Porter,5,0,37,32
1657725943471,MATH 18,B02,083749,Rideout; David Porter,5,0,36,31
1657725943471,MATH 18,B03,083750,Rideout; David Porter,3,0,37,34
1657725943471,MATH 18,B04,083751,Rideout; David Porter,6,0,36,30
1657725943471,MATH 18,B05,093473,Rideout; David Porter,6,0,36,30
1657725943471,MATH 18,B06,093474,Rideout; David Porter,6,0,36,30
1657725949504,MATH 20A,A01,083754,Zheng; Zequn,14,0,40,26
1657725955532,MATH 20B,A01,083756,Briones; Jor-el Thomas Caparas,4,0,36,32
1657725955532,MATH 20B,A02,083757,Briones; Jor-el Thomas Caparas,1,0,36,35
1657725955532,MATH 20B,A03,093475,Briones; Jor-el Thomas Caparas,2,0,36,34
1657725961572,MATH 20C,A01,083760,Briones; Jor-el Thomas Caparas,1,0,35,34
1657725961572,MATH 20C,A02,083761,Briones; Jor-el Thomas Caparas,8,0,35,27
1657725961572,MATH 20C,A03,093476,Briones; Jor-el Thomas Caparas,0,1,36,36
1657725961572,MATH 20C,B01,083762,Bach; Quang Tran,1,0,30,29
1657725967609,MATH 20D,A01,083765,Tran; Brian Kha,5,0,30,25
1657725967609,MATH 20D,A02,083766,Tran; Brian Kha,5,0,30,25
1657725967609,MATH 20D,A03,083767,Tran; Brian Kha,5,0,30,25
1657725973639,MATH 20E,A01,083771,Ganguly; Soumya,9,0,32,23
1657725973639,MATH 20E,A02,083772,Ganguly; Soumya,6,0,32,26
1657725973639,MATH 20E,B01,083773,Ciotti; Benjamin,20,0,35,15
1657725973639,MATH 20E,B02,083774,Ciotti; Benjamin,18,0,35,17
1657725979663,MATH 103A,A01,083777,Greenfeld; Be'Eri,3,0,36,33
1657725979663,MATH 103A,A02,083778,Greenfeld; Be'Eri,5,0,36,31
1657725979663,MATH 103A,A03,093561,Greenfeld; Be'Eri,6,0,36,30
1657725979663,MATH 103A,B01,083779,Greenfeld; Be'Eri,7,0,36,29
1657725979663,MATH 103A,B02,083780,Greenfeld; Be'Eri,4,0,36,32
1657725979663,MATH 103A,B03,093562,Greenfeld; Be'Eri,3,0,36,33
1657725985690,MATH 105,A01,085443,Carter; Anne Toulson,15,0,35,20
1657725985690,MATH 105,A02,093477,Carter; Anne Toulson,20,0,35,15
1657725991729,MATH 109,A01,083213,Ganzberger; Geoffrey Michael,2,0,34,32
1657725991729,MATH 109,A02,083214,Ganzberger; Geoffrey Michael,4,0,34,30
1657725991729,MATH 109,A03,093478,Ganzberger; Geoffrey Michael,2,0,34,32
1657725991729,MATH 109,B01,083215,Ganzberger; Geoffrey Michael,1,0,32,31
1657725991729,MATH 109,B02,083216,Ganzberger; Geoffrey Michael,2,0,32,30
1657725991729,MATH 109,B03,093479,Ganzberger; Geoffrey Michael,8,0,32,24
1657725997757,MATH 142A,A01,083219,Chow; Bennett,7,0,32,25
1657725997757,MATH 142A,A02,083220,Chow; Bennett,10,0,32,22
1657725997757,MATH 142A,A03,093480,Chow; Bennett,9,0,32,23
1657725997757,MATH 142A,B03,093481,Chow; Bennett,8,0,32,24
1657725997757,MATH 142A,B04,093558,Chow; Bennett,13,0,32,19
1657725997757,MATH 142A,B05,093559,Chow; Bennett,6,0,32,26
1657726003780,MATH 193A,A01,083224,Rotar; Vladimir,8,0,34,26
1657726003780,MATH 193A,A02,083225,Rotar; Vladimir,9,0,34,25
1657726003780,MATH 193A,A03,083781,Rotar; Vladimir,5,0,34,29
1657726003780,MATH 193A,A04,083782,Rotar; Vladimir,10,0,34,24
1657726003780,MATH 193A,A05,093482,Rotar; Vladimir,10,0,34,24
1657726009805,MATH 197,001,091859,McAuley; Julian John,9999,0,9999,0
1657726009805,MATH 197,002,095566,Kedlaya; Kiran S.,9997,0,9999,2
1657726009805,MATH 197,003,095567,Xiao; Ming,9999,0,9999,0
1657726009805,MATH 197,004,095571,Perols; Johan Lars,9998,0,9999,1
1657726016863,COGS 9,A01,083615,Shannon; Kyle Michael,9,0,75,66
1657726022886,COGS 11,A01,083617,Boyle; Mary E. T.,23,0,48,25
1657726028914,COGS 13,A01,083071,Bastos; Amalia Pinkusfeld,11,0,71,60
1657726034939,COGS 14A,A01,092681,Semenuks; Arturs,5,1,100,95
1657726040967,COGS 14B,A01,083073,Cheng; Tzu-Han,6,0,63,57
1657726047000,COGS 17,A01,092677,Semenuks; Arturs,6,0,81,75
1657726053024,COGS 100,A01,083619,Allen; Michael Gordon,17,0,70,53
1657726059050,COGS 101A,A01,083621,Davis; Joshua Daniel,9,0,68,59
1657726065072,COGS 101B,A01,091572,Allen; Michael Gordon,12,0,65,53
1657726071095,COGS 101C,A01,083625,Delgado; Tania,17,0,35,18
1657726077130,COGS 107A,A01,083627,Boyle; Mary E. T.,13,0,60,47
1657726083153,COGS 118A,A01,083075,Gupta; Anjum,21,0,76,55
1657726089180,CSE 3,A50,083646,Miranda; Gregory Joseph,24,0,50,26
1657726095214,CSE 8A,A50,083650,Miranda; Gregory Joseph,17,1,56,39
1657726101240,CSE 11,A01,083080,Cao; Yingjun,6,15,40,34
1657726107273,CSE 12,A01,083652,Krause-Levy; Sophia Louisa,28,1,120,92
1657726113298,CSE 15L,A01,083654,Morris; Justin Loren,9,0,50,41
1657726113298,CSE 15L,A02,083655,Morris; Justin Loren,9,0,50,41
1657726119321,CSE 20,A01,083657,Tran; Khoa Dang,39,0,80,41
1657726125350,CSE 21,A01,095574,Bach; Quang Tran,22,0,48,26
1657726131375,CSE 30,A01,083084,Eldon; John,6,0,80,74
1657726131375,CSE 30,B01,095061,Bhaskar; Nishant,9,0,50,41
1657726137411,CSE 100,A01,083659,Cao; Yingjun,5,4,70,65
1657726143436,CSE 134B,A01,083661,Powell; Thomas Allan,23,0,100,77
1657726149459,CSE 140,A01,083663,Gungor; Onat,15,0,85,70
1657726155483,CSE 140L,A01,083088,Eldon; John,23,0,100,77
1657726161505,CSE 175,A01,083665,Kumar; Rakesh,3,0,25,22
1657726167531,CSE 190,A00,092507,Dubnov; Shlomo,8,0,20,12
1657726173566,ECE 45,A01,083139,Congero; Spencer William,6,0,75,69
1657726179596,ECE 65,A50,083695,Saad; Andrew S,12,0,30,18
1657726179596,ECE 65,A51,095125,Saad; Andrew S,24,0,26,2
1657726185619,ECE 109,A01,091882,Touri; Behrouz,20,0,70,50
1657726191641,ECE 180,A00,083140,Abi Samra; Nicholas Camill,1,0,30,29
1657726191641,ECE 180,B00,083141,Abi Samra; Nicholas Camill,0,0,30,30
1657726197666,MATH 10A,A01,083735,Patchell; Gregory David,2,0,30,28
1657726197666,MATH 10A,A02,083736,Patchell; Gregory David,20,0,30,10
1657726197666,MATH 10A,A03,083737,Patchell; Gregory David,16,0,30,14
1657726203689,MATH 10B,A01,083207,Lim; Seonhee,8,0,34,26
1657726203689,MATH 10B,A02,083208,Lim; Seonhee,9,0,35,26
1657726203689,MATH 10B,A03,093472,Lim; Seonhee,7,0,34,27
1657726203689,MATH 10B,B01,083739,Sinha; Shubham,13,0,30,17
1657726209731,MATH 18,A01,083743,Cinel; Cameron Alexander,8,0,30,22
1657726209731,MATH 18,A02,083744,Cinel; Cameron Alexander,17,0,30,13
1657726209731,MATH 18,A03,083745,Cinel; Cameron Alexander,10,0,30,20
1657726209731,MATH 18,B01,083748,Rideout; David Porter,5,0,37,32
1657726209731,MATH 18,B02,083749,Rideout; David Porter,5,0,36,31
1657726209731,MATH 18,B03,083750,Rideout; David Porter,3,0,37,34
1657726209731,MATH 18,B04,083751,Rideout; David Porter,6,0,36,30
1657726209731,MATH 18,B05,093473,Rideout; David Porter,6,0,36,30
1657726209731,MATH 18,B06,093474,Rideout; David Porter,6,0,36,30
1657726215759,MATH 20A,A01,083754,Zheng; Zequn,14,0,40,26
1657726221785,MATH 20B,A01,083756,Briones; Jor-el Thomas Caparas,4,0,36,32
1657726221785,MATH 20B,A02,083757,Briones; Jor-el Thomas Caparas,1,0,36,35
1657726221785,MATH 20B,A03,093475,Briones; Jor-el Thomas Caparas,2,0,36,34
1657726227816,MATH 20C,A01,083760,Briones; Jor-el Thomas Caparas,1,0,35,34
1657726227816,MATH 20C,A02,083761,Briones; Jor-el Thomas Caparas,8,0,35,27
1657726227816,MATH 20C,A03,093476,Briones; Jor-el Thomas Caparas,0,1,36,36
1657726227816,MATH 20C,B01,083762,Bach; Quang Tran,1,0,30,29
1657726233850,MATH 20D,A01,083765,Tran; Brian Kha,5,0,30,25
1657726233850,MATH 20D,A02,083766,Tran; Brian Kha,5,0,30,25
1657726233850,MATH 20D,A03,083767,Tran; Brian Kha,5,0,30,25
1657726239879,MATH 20E,A01,083771,Ganguly; Soumya,9,0,32,23
1657726239879,MATH 20E,A02,083772,Ganguly; Soumya,6,0,32,26
1657726239879,MATH 20E,B01,083773,Ciotti; Benjamin,20,0,35,15
1657726239879,MATH 20E,B02,083774,Ciotti; Benjamin,18,0,35,17
1657726245903,MATH 103A,A01,083777,Greenfeld; Be'Eri,3,0,36,33
1657726245903,MATH 103A,A02,083778,Greenfeld; Be'Eri,5,0,36,31
1657726245903,MATH 103A,A03,093561,Greenfeld; Be'Eri,6,0,36,30
1657726245903,MATH 103A,B01,083779,Greenfeld; Be'Eri,7,0,36,29
1657726245903,MATH 103A,B02,083780,Greenfeld; Be'Eri,4,0,36,32
1657726245903,MATH 103A,B03,093562,Greenfeld; Be'Eri,3,0,36,33
1657726251928,MATH 105,A01,085443,Carter; Anne Toulson,15,0,35,20
1657726251928,MATH 105,A02,093477,Carter; Anne Toulson,20,0,35,15
1657726257951,MATH 109,A01,083213,Ganzberger; Geoffrey Michael,2,0,34,32
1657726257951,MATH 109,A02,083214,Ganzberger; Geoffrey Michael,4,0,34,30
1657726257951,MATH 109,A03,093478,Ganzberger; Geoffrey Michael,2,0,34,32
1657726257951,MATH 109,B01,083215,Ganzberger; Geoffrey Michael,1,0,32,31
1657726257951,MATH 109,B02,083216,Ganzberger; Geoffrey Michael,2,0,32,30
1657726257951,MATH 109,B03,093479,Ganzberger; Geoffrey Michael,8,0,32,24
1657726263974,MATH 142A,A01,083219,Chow; Bennett,7,0,32,25
1657726263974,MATH 142A,A02,083220,Chow; Bennett,10,0,32,22
1657726263974,MATH 142A,A03,093480,Chow; Bennett,9,0,32,23
1657726263974,MATH 142A,B03,093481,Chow; Bennett,8,0,32,24
1657726263974,MATH 142A,B04,093558,Chow; Bennett,13,0,32,19
1657726263974,MATH 142A,B05,093559,Chow; Bennett,6,0,32,26
1657726270001,MATH 193A,A01,083224,Rotar; Vladimir,8,0,34,26
1657726270001,MATH 193A,A02,083225,Rotar; Vladimir,9,0,34,25
1657726270001,MATH 193A,A03,083781,Rotar; Vladimir,5,0,34,29
1657726270001,MATH 193A,A04,083782,Rotar; Vladimir,10,0,34,24
1657726270001,MATH 193A,A05,093482,Rotar; Vladimir,10,0,34,24
1657726276028,MATH 197,001,091859,McAuley; Julian John,9999,0,9999,0
1657726276028,MATH 197,002,095566,Kedlaya; Kiran S.,9997,0,9999,2
1657726276028,MATH 197,003,095567,Xiao; Ming,9999,0,9999,0
1657726276028,MATH 197,004,095571,Perols; Johan Lars,9998,0,9999,1
1657726283101,COGS 9,A01,083615,Shannon; Kyle Michael,9,0,75,66
1657726289125,COGS 11,A01,083617,Boyle; Mary E. T.,23,0,48,25
1657726295155,COGS 13,A01,083071,Bastos; Amalia Pinkusfeld,11,0,71,60
1657726301181,COGS 14A,A01,092681,Semenuks; Arturs,5,1,100,95
1657726307220,COGS 14B,A01,083073,Cheng; Tzu-Han,6,0,63,57
1657726313246,COGS 17,A01,092677,Semenuks; Arturs,6,0,81,75
1657726319271,COGS 100,A01,083619,Allen; Michael Gordon,17,0,70,53
1657726325294,COGS 101A,A01,083621,Davis; Joshua Daniel,9,0,68,59
1657726331318,COGS 101B,A01,091572,Allen; Michael Gordon,12,0,65,53
1657726337344,COGS 101C,A01,083625,Delgado; Tania,17,0,35,18
1657726343372,COGS 107A,A01,083627,Boyle; Mary E. T.,13,0,60,47
1657726349398,COGS 118A,A01,083075,Gupta; Anjum,21,0,76,55
1657726355509,CSE 3,A50,083646,Miranda; Gregory Joseph,24,0,50,26
1657726361536,CSE 8A,A50,083650,Miranda; Gregory Joseph,17,1,56,39
1657726367565,CSE 11,A01,083080,Cao; Yingjun,6,15,40,34
1657726373589,CSE 12,A01,083652,Krause-Levy; Sophia Louisa,28,1,120,92
1657726379615,CSE 15L,A01,083654,Morris; Justin Loren,9,0,50,41
1657726379615,CSE 15L,A02,083655,Morris; Justin Loren,9,0,50,41
1657726385642,CSE 20,A01,083657,Tran; Khoa Dang,39,0,80,41
1657726391666,CSE 21,A01,095574,Bach; Quang Tran,22,0,48,26
1657726397689,CSE 30,A01,083084,Eldon; John,6,0,80,74
1657726397689,CSE 30,B01,095061,Bhaskar; Nishant,9,0,50,41
1657726403717,CSE 100,A01,083659,Cao; Yingjun,5,4,70,65
1657726409740,CSE 134B,A01,083661,Powell; Thomas Allan,23,0,100,77
1657726415766,CSE 140,A01,083663,Gungor; Onat,15,0,85,70
1657726421790,CSE 140L,A01,083088,Eldon; John,23,0,100,77
1657726427820,CSE 175,A01,083665,Kumar; Rakesh,3,0,25,22
1657726433841,CSE 190,A00,092507,Dubnov; Shlomo,8,0,20,12
1657726439870,ECE 45,A01,083139,Congero; Spencer William,6,0,75,69
1657726445896,ECE 65,A50,083695,Saad; Andrew S,12,0,30,18
1657726445896,ECE 65,A51,095125,Saad; Andrew S,24,0,26,2
1657726451920,ECE 109,A01,091882,Touri; Behrouz,20,0,70,50
1657726457946,ECE 180,A00,083140,Abi Samra; Nicholas Camill,1,0,30,29
1657726457946,ECE 180,B00,083141,Abi Samra; Nicholas Camill,0,0,30,30
1657726463974,MATH 10A,A01,083735,Patchell; Gregory David,2,0,30,28
1657726463974,MATH 10A,A02,083736,Patchell; Gregory David,20,0,30,10
1657726463974,MATH 10A,A03,083737,Patchell; Gregory David,16,0,30,14
1657726470008,MATH 10B,A01,083207,Lim; Seonhee,8,0,34,26
1657726470008,MATH 10B,A02,083208,Lim; Seonhee,9,0,35,26
1657726470008,MATH 10B,A03,093472,Lim; Seonhee,7,0,34,27
1657726470008,MATH 10B,B01,083739,Sinha; Shubham,13,0,30,17
1657726476034,MATH 18,A01,083743,Cinel; Cameron Alexander,8,0,30,22
1657726476034,MATH 18,A02,083744,Cinel; Cameron Alexander,17,0,30,13
1657726476034,MATH 18,A03,083745,Cinel; Cameron Alexander,10,0,30,20
1657726476034,MATH 18,B01,083748,Rideout; David Porter,5,0,37,32
1657726476034,MATH 18,B02,083749,Rideout; David Porter,5,0,36,31
1657726476034,MATH 18,B03,083750,Rideout; David Porter,3,0,37,34
1657726476034,MATH 18,B04,083751,Rideout; David Porter,6,0,36,30
1657726476034,MATH 18,B05,093473,Rideout; David Porter,6,0,36,30
1657726476034,MATH 18,B06,093474,Rideout; David Porter,6,0,36,30
1657726482065,MATH 20A,A01,083754,Zheng; Zequn,14,0,40,26
1657726488089,MATH 20B,A01,083756,Briones; Jor-el Thomas Caparas,4,0,36,32
1657726488089,MATH 20B,A02,083757,Briones; Jor-el Thomas Caparas,1,0,36,35
1657726488089,MATH 20B,A03,093475,Briones; Jor-el Thomas Caparas,2,0,36,34
1657726494114,MATH 20C,A01,083760,Briones; Jor-el Thomas Caparas,1,0,35,34
1657726494114,MATH 20C,A02,083761,Briones; Jor-el Thomas Caparas,8,0,35,27
1657726494114,MATH 20C,A03,093476,Briones; Jor-el Thomas Caparas,0,1,36,36
1657726494114,MATH 20C,B01,083762,Bach; Quang Tran,1,0,30,29
1657726500138,MATH 20D,A01,083765,Tran; Brian Kha,5,0,30,25
1657726500138,MATH 20D,A02,083766,Tran; Brian Kha,5,0,30,25
1657726500138,MATH 20D,A03,083767,Tran; Brian Kha,5,0,30,25
1657726506165,MATH 20E,A01,083771,Ganguly; Soumya,9,0,32,23
1657726506165,MATH 20E,A02,083772,Ganguly; Soumya,6,0,32,26
1657726506165,MATH 20E,B01,083773,Ciotti; Benjamin,20,0,35,15
1657726506165,MATH 20E,B02,083774,Ciotti; Benjamin,18,0,35,17
1657726512200,MATH 103A,A01,083777,Greenfeld; Be'Eri,3,0,36,33
1657726512200,MATH 103A,A02,083778,Greenfeld; Be'Eri,5,0,36,31
1657726512200,MATH 103A,A03,093561,Greenfeld; Be'Eri,6,0,36,30
1657726512200,MATH 103A,B01,083779,Greenfeld; Be'Eri,7,0,36,29
1657726512200,MATH 103A,B02,083780,Greenfeld; Be'Eri,4,0,36,32
1657726512200,MATH 103A,B03,093562,Greenfeld; Be'Eri,3,0,36,33
1657726518225,MATH 105,A01,085443,Carter; Anne Toulson,15,0,35,20
1657726518225,MATH 105,A02,093477,Carter; Anne Toulson,20,0,35,15
1657726524249,MATH 109,A01,083213,Ganzberger; Geoffrey Michael,2,0,34,32
1657726524249,MATH 109,A02,083214,Ganzberger; Geoffrey Michael,4,0,34,30
1657726524249,MATH 109,A03,093478,Ganzberger; Geoffrey Michael,2,0,34,32
1657726524249,MATH 109,B01,083215,Ganzberger; Geoffrey Michael,1,0,32,31
1657726524249,MATH 109,B02,083216,Ganzberger; Geoffrey Michael,2,0,32,30
1657726524249,MATH 109,B03,093479,Ganzberger; Geoffrey Michael,8,0,32,24
1657726530277,MATH 142A,A01,083219,Chow; Bennett,7,0,32,25
1657726530277,MATH 142A,A02,083220,Chow; Bennett,10,0,32,22
1657726530277,MATH 142A,A03,093480,Chow; Bennett,9,0,32,23
1657726530277,MATH 142A,B03,093481,Chow; Bennett,8,0,32,24
1657726530277,MATH 142A,B04,093558,Chow; Bennett,13,0,32,19
1657726530277,MATH 142A,B05,093559,Chow; Bennett,6,0,32,26
1657726536301,MATH 193A,A01,083224,Rotar; Vladimir,8,0,34,26
1657726536301,MATH 193A,A02,083225,Rotar; Vladimir,9,0,34,25
1657726536301,MATH 193A,A03,083781,Rotar; Vladimir,5,0,34,29
1657726536301,MATH 193A,A04,083782,Rotar; Vladimir,10,0,34,24
1657726536301,MATH 193A,A05,093482,Rotar; Vladimir,10,0,34,24
1657726542328,MATH 197,001,091859,McAuley; Julian John,9999,0,9999,0
1657726542328,MATH 197,002,095566,Kedlaya; Kiran S.,9997,0,9999,2
1657726542328,MATH 197,003,095567,Xiao; Ming,9999,0,9999,0
1657726542328,MATH 197,004,095571,Perols; Johan Lars,9998,0,9999,1
1657726549392,COGS 9,A01,083615,Shannon; Kyle Michael,9,0,75,66
1657726555416,COGS 11,A01,083617,Boyle; Mary E. T.,23,0,48,25
1657726561444,COGS 13,A01,083071,Bastos; Amalia Pinkusfeld,11,0,71,60
1657726567468,COGS 14A,A01,092681,Semenuks; Arturs,5,1,100,95
1657726573493,COGS 14B,A01,083073,Cheng; Tzu-Han,6,0,63,57
1657726579515,COGS 17,A01,092677,Semenuks; Arturs,6,0,81,75
1657726585540,COGS 100,A01,083619,Allen; Michael Gordon,17,0,70,53
1657726591565,COGS 101A,A01,083621,Davis; Joshua Daniel,9,0,68,59
1657726597588,COGS 101B,A01,091572,Allen; Michael Gordon,12,0,65,53
1657726603615,COGS 101C,A01,083625,Delgado; Tania,17,0,35,18
1657726609640,COGS 107A,A01,083627,Boyle; Mary E. T.,13,0,60,47
1657726615663,COGS 118A,A01,083075,Gupta; Anjum,21,0,76,55
1657726621690,CSE 3,A50,083646,Miranda; Gregory Joseph,24,0,50,26
1657726627716,CSE 8A,A50,083650,Miranda; Gregory Joseph,17,1,56,39
1657726633739,CSE 11,A01,083080,Cao; Yingjun,6,15,40,34
1657726639769,CSE 12,A01,083652,Krause-Levy; Sophia Louisa,28,1,120,92
1657726645792,CSE 15L,A01,083654,Morris; Justin Loren,9,0,50,41
1657726645792,CSE 15L,A02,083655,Morris; Justin Loren,9,0,50,41
1657726651817,CSE 20,A01,083657,Tran; Khoa Dang,39,0,80,41
1657726657844,CSE 21,A01,095574,Bach; Quang Tran,22,0,48,26
1657726663871,CSE 30,A01,083084,Eldon; John,6,0,80,74
1657726663871,CSE 30,B01,095061,Bhaskar; Nishant,9,0,50,41
1657726669897,CSE 100,A01,083659,Cao; Yingjun,5,4,70,65
1657726675920,CSE 134B,A01,083661,Powell; Thomas Allan,23,0,100,77
1657726681949,CSE 140,A01,083663,Gungor; Onat,15,0,85,70
1657726687972,CSE 140L,A01,083088,Eldon; John,23,0,100,77
1657726693997,CSE 175,A01,083665,Kumar; Rakesh,3,0,25,22
1657726700023,CSE 190,A00,092507,Dubnov; Shlomo,8,0,20,12
1657726706060,ECE 45,A01,083139,Congero; Spencer William,6,0,75,69
1657726712082,ECE 65,A50,083695,Saad; Andrew S,12,0,30,18
1657726712082,ECE 65,A51,095125,Saad; Andrew S,24,0,26,2
1657726718107,ECE 109,A01,091882,Touri; Behrouz,20,0,70,50
1657726724142,ECE 180,A00,083140,Abi Samra; Nicholas Camill,1,0,30,29
1657726724142,ECE 180,B00,083141,Abi Samra; Nicholas Camill,0,0,30,30
1657726730167,MATH 10A,A01,083735,Patchell; Gregory David,2,0,30,28
1657726730167,MATH 10A,A02,083736,Patchell; Gregory David,20,0,30,10
1657726730167,MATH 10A,A03,083737,Patchell; Gregory David,16,0,30,14
1657726736193,MATH 10B,A01,083207,Lim; Seonhee,8,0,34,26
1657726736193,MATH 10B,A02,083208,Lim; Seonhee,9,0,35,26
1657726736193,MATH 10B,A03,093472,Lim; Seonhee,7,0,34,27
1657726736193,MATH 10B,B01,083739,Sinha; Shubham,13,0,30,17
1657726742216,MATH 18,A01,083743,Cinel; Cameron Alexander,8,0,30,22
1657726742216,MATH 18,A02,083744,Cinel; Cameron Alexander,17,0,30,13
1657726742216,MATH 18,A03,083745,Cinel; Cameron Alexander,10,0,30,20
1657726742216,MATH 18,B01,083748,Rideout; David Porter,5,0,37,32
1657726742216,MATH 18,B02,083749,Rideout; David Porter,5,0,36,31
1657726742216,MATH 18,B03,083750,Rideout; David Porter,3,0,37,34
1657726742216,MATH 18,B04,083751,Rideout; David Porter,6,0,36,30
1657726742216,MATH 18,B05,093473,Rideout; David Porter,6,0,36,30
1657726742216,MATH 18,B06,093474,Rideout; David Porter,6,0,36,30
1657726748243,MATH 20A,A01,083754,Zheng; Zequn,14,0,40,26
1657726754279,MATH 20B,A01,083756,Briones; Jor-el Thomas Caparas,4,0,36,32
1657726754279,MATH 20B,A02,083757,Briones; Jor-el Thomas Caparas,1,0,36,35
1657726754279,MATH 20B,A03,093475,Briones; Jor-el Thomas Caparas,2,0,36,34
1657726760314,MATH 20C,A01,083760,Briones; Jor-el Thomas Caparas,1,0,35,34
1657726760314,MATH 20C,A02,083761,Briones; Jor-el Thomas Caparas,8,0,35,27
1657726760314,MATH 20C,A03,093476,Briones; Jor-el Thomas Caparas,0,1,36,36
1657726760314,MATH 20C,B01,083762,Bach; Quang Tran,1,0,30,29
1657726766350,MATH 20D,A01,083765,Tran; Brian Kha,5,0,30,25
1657726766350,MATH 20D,A02,083766,Tran; Brian Kha,5,0,30,25
1657726766350,MATH 20D,A03,083767,Tran; Brian Kha,5,0,30,25
1657726772376,MATH 20E,A01,083771,Ganguly; Soumya,9,0,32,23
1657726772376,MATH 20E,A02,083772,Ganguly; Soumya,6,0,32,26
1657726772376,MATH 20E,B01,083773,Ciotti; Benjamin,20,0,35,15
1657726772376,MATH 20E,B02,083774,Ciotti; Benjamin,18,0,35,17
1657726778399,MATH 103A,A01,083777,Greenfeld; Be'Eri,3,0,36,33
1657726778399,MATH 103A,A02,083778,Greenfeld; Be'Eri,5,0,36,31
1657726778399,MATH 103A,A03,093561,Greenfeld; Be'Eri,6,0,36,30
1657726778399,MATH 103A,B01,083779,Greenfeld; Be'Eri,7,0,36,29
1657726778399,MATH 103A,B02,083780,Greenfeld; Be'Eri,4,0,36,32
1657726778399,MATH 103A,B03,093562,Greenfeld; Be'Eri,3,0,36,33
1657726784424,MATH 105,A01,085443,Carter; Anne Toulson,15,0,35,20
1657726784424,MATH 105,A02,093477,Carter; Anne Toulson,20,0,35,15
1657726790449,MATH 109,A01,083213,Ganzberger; Geoffrey Michael,2,0,34,32
1657726790449,MATH 109,A02,083214,Ganzberger; Geoffrey Michael,4,0,34,30
1657726790449,MATH 109,A03,093478,Ganzberger; Geoffrey Michael,2,0,34,32
1657726790449,MATH 109,B01,083215,Ganzberger; Geoffrey Michael,1,0,32,31
1657726790449,MATH 109,B02,083216,Ganzberger; Geoffrey Michael,2,0,32,30
1657726790449,MATH 109,B03,093479,Ganzberger; Geoffrey Michael,8,0,32,24
1657726796472,MATH 142A,A01,083219,Chow; Bennett,7,0,32,25
1657726796472,MATH 142A,A02,083220,Chow; Bennett,10,0,32,22
1657726796472,MATH 142A,A03,093480,Chow; Bennett,9,0,32,23
1657726796472,MATH 142A,B03,093481,Chow; Bennett,8,0,32,24
1657726796472,MATH 142A,B04,093558,Chow; Bennett,13,0,32,19
1657726796472,MATH 142A,B05,093559,Chow; Bennett,6,0,32,26
1657726802499,MATH 193A,A01,083224,Rotar; Vladimir,8,0,34,26
1657726802499,MATH 193A,A02,083225,Rotar; Vladimir,9,0,34,25
1657726802499,MATH 193A,A03,083781,Rotar; Vladimir,5,0,34,29
1657726802499,MATH 193A,A04,083782,Rotar; Vladimir,10,0,34,24
1657726802499,MATH 193A,A05,093482,Rotar; Vladimir,10,0,34,24
1657726808527,MATH 197,001,091859,McAuley; Julian John,9999,0,9999,0
1657726808527,MATH 197,002,095566,Kedlaya; Kiran S.,9997,0,9999,2
1657726808527,MATH 197,003,095567,Xiao; Ming,9999,0,9999,0
1657726808527,MATH 197,004,095571,Perols; Johan Lars,9998,0,9999,1
1657726815587,COGS 9,A01,083615,Shannon; Kyle Michael,9,0,75,66
1657726821612,COGS 11,A01,083617,Boyle; Mary E. T.,23,0,48,25
1657726827636,COGS 13,A01,083071,Bastos; Amalia Pinkusfeld,11,0,71,60
1657726833662,COGS 14A,A01,092681,Semenuks; Arturs,5,1,100,95
1657726839685,COGS 14B,A01,083073,Cheng; Tzu-Han,6,0,63,57
1657726845711,COGS 17,A01,092677,Semenuks; Arturs,6,0,81,75
1657726851740,COGS 100,A01,083619,Allen; Michael Gordon,17,0,70,53
1657726857765,COGS 101A,A01,083621,Davis; Joshua Daniel,9,0,68,59
1657726863789,COGS 101B,A01,091572,Allen; Michael Gordon,12,0,65,53
1657726869815,COGS 101C,A01,083625,Delgado; Tania,17,0,35,18
1657726875845,COGS 107A,A01,083627,Boyle; Mary E. T.,13,0,60,47
1657726881869,COGS 118A,A01,083075,Gupta; Anjum,21,0,76,55
1657726887893,CSE 3,A50,083646,Miranda; Gregory Joseph,24,0,50,26
1657726893920,CSE 8A,A50,083650,Miranda; Gregory Joseph,17,1,56,39
1657726899943,CSE 11,A01,083080,Cao; Yingjun,6,15,40,34
1657726905967,CSE 12,A01,083652,Krause-Levy; Sophia Louisa,28,1,120,92
1657726911993,CSE 15L,A01,083654,Morris; Justin Loren,9,0,50,41
1657726911993,CSE 15L,A02,083655,Morris; Justin Loren,9,0,50,41
1657726918017,CSE 20,A01,083657,Tran; Khoa Dang,39,0,80,41
1657726924041,CSE 21,A01,095574,Bach; Quang Tran,22,0,48,26
1657726930069,CSE 30,A01,083084,Eldon; John,6,0,80,74
1657726930069,CSE 30,B01,095061,Bhaskar; Nishant,9,0,50,41
1657726936119,CSE 100,A01,083659,Cao; Yingjun,5,4,70,65
1657726942142,CSE 134B,A01,083661,Powell; Thomas Allan,23,0,100,77
1657726948167,CSE 140,A01,083663,Gungor; Onat,15,0,85,70
1657726954264,CSE 140L,A01,083088,Eldon; John,23,0,100,77
1657726960287,CSE 175,A01,083665,Kumar; Rakesh,3,0,25,22
1657726966311,CSE 190,A00,092507,Dubnov; Shlomo,8,0,20,12
1657726972339,ECE 45,A01,083139,Congero; Spencer William,6,0,75,69
1657726978363,ECE 65,A50,083695,Saad; Andrew S,12,0,30,18
1657726978363,ECE 65,A51,095125,Saad; Andrew S,24,0,26,2
1657726984387,ECE 109,A01,091882,Touri; Behrouz,20,0,70,50
1657726990411,ECE 180,A00,083140,Abi Samra; Nicholas Camill,1,0,30,29
1657726990411,ECE 180,B00,083141,Abi Samra; Nicholas Camill,0,0,30,30
1657726996435,MATH 10A,A01,083735,Patchell; Gregory David,2,0,30,28
1657726996435,MATH 10A,A02,083736,Patchell; Gregory David,20,0,30,10
1657726996435,MATH 10A,A03,083737,Patchell; Gregory David,16,0,30,14
1657727002465,MATH 10B,A01,083207,Lim; Seonhee,8,0,34,26
1657727002465,MATH 10B,A02,083208,Lim; Seonhee,9,0,35,26
1657727002465,MATH 10B,A03,093472,Lim; Seonhee,7,0,34,27
1657727002465,MATH 10B,B01,083739,Sinha; Shubham,13,0,30,17
1657727008492,MATH 18,A01,083743,Cinel; Cameron Alexander,8,0,30,22
1657727008492,MATH 18,A02,083744,Cinel; Cameron Alexander,17,0,30,13
1657727008492,MATH 18,A03,083745,Cinel; Cameron Alexander,10,0,30,20
1657727008492,MATH 18,B01,083748,Rideout; David Porter,5,0,37,32
1657727008492,MATH 18,B02,083749,Rideout; David Porter,5,0,36,31
1657727008492,MATH 18,B03,083750,Rideout; David Porter,3,0,37,34
1657727008492,MATH 18,B04,083751,Rideout; David Porter,6,0,36,30
1657727008492,MATH 18,B05,093473,Rideout; David Porter,6,0,36,30
1657727008492,MATH 18,B06,093474,Rideout; David Porter,6,0,36,30
1657727014519,MATH 20A,A01,083754,Zheng; Zequn,14,0,40,26
1657727020543,MATH 20B,A01,083756,Briones; Jor-el Thomas Caparas,4,0,36,32
1657727020543,MATH 20B,A02,083757,Briones; Jor-el Thomas Caparas,1,0,36,35
1657727020543,MATH 20B,A03,093475,Briones; Jor-el Thomas Caparas,2,0,36,34
1657727026569,MATH 20C,A01,083760,Briones; Jor-el Thomas Caparas,1,0,35,34
1657727026569,MATH 20C,A02,083761,Briones; Jor-el Thomas Caparas,8,0,35,27
1657727026569,MATH 20C,A03,093476,Briones; Jor-el Thomas Caparas,0,1,36,36
1657727026569,MATH 20C,B01,083762,Bach; Quang Tran,1,0,30,29
1657727032597,MATH 20D,A01,083765,Tran; Brian Kha,5,0,30,25
1657727032597,MATH 20D,A02,083766,Tran; Brian Kha,5,0,30,25
1657727032597,MATH 20D,A03,083767,Tran; Brian Kha,5,0,30,25
1657727038631,MATH 20E,A01,083771,Ganguly; Soumya,9,0,32,23
1657727038631,MATH 20E,A02,083772,Ganguly; Soumya,6,0,32,26
1657727038631,MATH 20E,B01,083773,Ciotti; Benjamin,20,0,35,15
1657727038631,MATH 20E,B02,083774,Ciotti; Benjamin,18,0,35,17
1657727044655,MATH 103A,A01,083777,Greenfeld; Be'Eri,3,0,36,33
1657727044655,MATH 103A,A02,083778,Greenfeld; Be'Eri,5,0,36,31
1657727044655,MATH 103A,A03,093561,Greenfeld; Be'Eri,6,0,36,30
1657727044655,MATH 103A,B01,083779,Greenfeld; Be'Eri,7,0,36,29
1657727044655,MATH 103A,B02,083780,Greenfeld; Be'Eri,4,0,36,32
1657727044655,MATH 103A,B03,093562,Greenfeld; Be'Eri,3,0,36,33
1657727050681,MATH 105,A01,085443,Carter; Anne Toulson,15,0,35,20
1657727050681,MATH 105,A02,093477,Carter; Anne Toulson,20,0,35,15
1657727056704,MATH 109,A01,083213,Ganzberger; Geoffrey Michael,2,0,34,32
1657727056704,MATH 109,A02,083214,Ganzberger; Geoffrey Michael,4,0,34,30
1657727056704,MATH 109,A03,093478,Ganzberger; Geoffrey Michael,2,0,34,32
1657727056704,MATH 109,B01,083215,Ganzberger; Geoffrey Michael,1,0,32,31
1657727056704,MATH 109,B02,083216,Ganzberger; Geoffrey Michael,2,0,32,30
1657727056704,MATH 109,B03,093479,Ganzberger; Geoffrey Michael,8,0,32,24
1657727062727,MATH 142A,A01,083219,Chow; Bennett,7,0,32,25
1657727062727,MATH 142A,A02,083220,Chow; Bennett,10,0,32,22
1657727062727,MATH 142A,A03,093480,Chow; Bennett,9,0,32,23
1657727062727,MATH 142A,B03,093481,Chow; Bennett,8,0,32,24
1657727062727,MATH 142A,B04,093558,Chow; Bennett,13,0,32,19
1657727062727,MATH 142A,B05,093559,Chow; Bennett,6,0,32,26
1657727068763,MATH 193A,A01,083224,Rotar; Vladimir,8,0,34,26
1657727068763,MATH 193A,A02,083225,Rotar; Vladimir,9,0,34,25
1657727068763,MATH 193A,A03,083781,Rotar; Vladimir,5,0,34,29
1657727068763,MATH 193A,A04,083782,Rotar; Vladimir,10,0,34,24
1657727068763,MATH 193A,A05,093482,Rotar; Vladimir,10,0,34,24
1657727074793,MATH 197,001,091859,McAuley; Julian John,9999,0,9999,0
1657727074793,MATH 197,002,095566,Kedlaya; Kiran S.,9997,0,9999,2
1657727074793,MATH 197,003,095567,Xiao; Ming,9999,0,9999,0
1657727074793,MATH 197,004,095571,Perols; Johan Lars,9998,0,9999,1
1657727081870,COGS 9,A01,083615,Shannon; Kyle Michael,9,0,75,66
1657727087896,COGS 11,A01,083617,Boyle; Mary E. T.,23,0,48,25
1657727093922,COGS 13,A01,083071,Bastos; Amalia Pinkusfeld,11,0,71,60
1657727099952,COGS 14A,A01,092681,Semenuks; Arturs,5,1,100,95
1657727105976,COGS 14B,A01,083073,Cheng; Tzu-Han,6,0,63,57
1657727111999,COGS 17,A01,092677,Semenuks; Arturs,6,0,81,75
1657727118027,COGS 100,A01,083619,Allen; Michael Gordon,17,0,70,53
1657727124054,COGS 101A,A01,083621,Davis; Joshua Daniel,9,0,68,59
1657727130087,COGS 101B,A01,091572,Allen; Michael Gordon,12,0,65,53
1657727136114,COGS 101C,A01,083625,Delgado; Tania,17,0,35,18
1657727142138,COGS 107A,A01,083627,Boyle; Mary E. T.,13,0,60,47
1657727148165,COGS 118A,A01,083075,Gupta; Anjum,21,0,76,55
1657727154195,CSE 3,A50,083646,Miranda; Gregory Joseph,24,0,50,26
1657727160224,CSE 8A,A50,083650,Miranda; Gregory Joseph,17,1,56,39
1657727166252,CSE 11,A01,083080,Cao; Yingjun,6,15,40,34
1657727172277,CSE 12,A01,083652,Krause-Levy; Sophia Louisa,28,1,120,92
1657727178303,CSE 15L,A01,083654,Morris; Justin Loren,9,0,50,41
1657727178303,CSE 15L,A02,083655,Morris; Justin Loren,9,0,50,41
1657727184330,CSE 20,A01,083657,Tran; Khoa Dang,39,0,80,41
1657727190353,CSE 21,A01,095574,Bach; Quang Tran,22,0,48,26
1657727196375,CSE 30,A01,083084,Eldon; John,6,0,80,74
1657727196375,CSE 30,B01,095061,Bhaskar; Nishant,9,0,50,41
1657727202399,CSE 100,A01,083659,Cao; Yingjun,5,4,70,65
1657727208428,CSE 134B,A01,083661,Powell; Thomas Allan,23,0,100,77
1657727214458,CSE 140,A01,083663,Gungor; Onat,15,0,85,70
1657727220483,CSE 140L,A01,083088,Eldon; John,23,0,100,77
1657727226511,CSE 175,A01,083665,Kumar; Rakesh,3,0,25,22
1657727232536,CSE 190,A00,092507,Dubnov; Shlomo,8,0,20,12
1657727238561,ECE 45,A01,083139,Congero; Spencer William,6,0,75,69
1657727244582,ECE 65,A50,083695,Saad; Andrew S,12,0,30,18
1657727244582,ECE 65,A51,095125,Saad; Andrew S,24,0,26,2
1657727250606,ECE 109,A01,091882,Touri; Behrouz,20,0,70,50
1657727256637,ECE 180,A00,083140,Abi Samra; Nicholas Camill,1,0,30,29
1657727256637,ECE 180,B00,083141,Abi Samra; Nicholas Camill,0,0,30,30
1657727262667,MATH 10A,A01,083735,Patchell; Gregory David,2,0,30,28
1657727262667,MATH 10A,A02,083736,Patchell; Gregory David,20,0,30,10
1657727262667,MATH 10A,A03,083737,Patchell; Gregory David,16,0,30,14
1657727268689,MATH 10B,A01,083207,Lim; Seonhee,8,0,34,26
1657727268689,MATH 10B,A02,083208,Lim; Seonhee,9,0,35,26
1657727268689,MATH 10B,A03,093472,Lim; Seonhee,7,0,34,27
1657727268689,MATH 10B,B01,083739,Sinha; Shubham,13,0,30,17
1657727274716,MATH 18,A01,083743,Cinel; Cameron Alexander,8,0,30,22
1657727274716,MATH 18,A02,083744,Cinel; Cameron Alexander,17,0,30,13
1657727274716,MATH 18,A03,083745,Cinel; Cameron Alexander,10,0,30,20
1657727274716,MATH 18,B01,083748,Rideout; David Porter,5,0,37,32
1657727274716,MATH 18,B02,083749,Rideout; David Porter,5,0,36,31
1657727274716,MATH 18,B03,083750,Rideout; David Porter,3,0,37,34
1657727274716,MATH 18,B04,083751,Rideout; David Porter,6,0,36,30
1657727274716,MATH 18,B05,093473,Rideout; David Porter,6,0,36,30
1657727274716,MATH 18,B06,093474,Rideout; David Porter,6,0,36,30
1657727280742,MATH 20A,A01,083754,Zheng; Zequn,14,0,40,26
1657727286773,MATH 20B,A01,083756,Briones; Jor-el Thomas Caparas,4,0,36,32
1657727286773,MATH 20B,A02,083757,Briones; Jor-el Thomas Caparas,1,0,36,35
1657727286773,MATH 20B,A03,093475,Briones; Jor-el Thomas Caparas,2,0,36,34
1657727292811,MATH 20C,A01,083760,Briones; Jor-el Thomas Caparas,1,0,35,34
1657727292811,MATH 20C,A02,083761,Briones; Jor-el Thomas Caparas,8,0,35,27
1657727292811,MATH 20C,A03,093476,Briones; Jor-el Thomas Caparas,0,1,36,36
1657727292811,MATH 20C,B01,083762,Bach; Quang Tran,1,0,30,29
1657727298836,MATH 20D,A01,083765,Tran; Brian Kha,5,0,30,25
1657727298836,MATH 20D,A02,083766,Tran; Brian Kha,5,0,30,25
1657727298836,MATH 20D,A03,083767,Tran; Brian Kha,5,0,30,25
1657727304865,MATH 20E,A01,083771,Ganguly; Soumya,9,0,32,23
1657727304865,MATH 20E,A02,083772,Ganguly; Soumya,6,0,32,26
1657727304865,MATH 20E,B01,083773,Ciotti; Benjamin,20,0,35,15
1657727304865,MATH 20E,B02,083774,Ciotti; Benjamin,18,0,35,17
1657727310894,MATH 103A,A01,083777,Greenfeld; Be'Eri,3,0,36,33
1657727310894,MATH 103A,A02,083778,Greenfeld; Be'Eri,5,0,36,31
1657727310894,MATH 103A,A03,093561,Greenfeld; Be'Eri,6,0,36,30
1657727310894,MATH 103A,B01,083779,Greenfeld; Be'Eri,7,0,36,29
1657727310894,MATH 103A,B02,083780,Greenfeld; Be'Eri,4,0,36,32
1657727310894,MATH 103A,B03,093562,Greenfeld; Be'Eri,3,0,36,33
1657727316927,MATH 105,A01,085443,Carter; Anne Toulson,15,0,35,20
1657727316927,MATH 105,A02,093477,Carter; Anne Toulson,20,0,35,15
1657727322949,MATH 109,A01,083213,Ganzberger; Geoffrey Michael,2,0,34,32
1657727322949,MATH 109,A02,083214,Ganzberger; Geoffrey Michael,4,0,34,30
1657727322949,MATH 109,A03,093478,Ganzberger; Geoffrey Michael,2,0,34,32
1657727322949,MATH 109,B01,083215,Ganzberger; Geoffrey Michael,1,0,32,31
1657727322949,MATH 109,B02,083216,Ganzberger; Geoffrey Michael,2,0,32,30
1657727322949,MATH 109,B03,093479,Ganzberger; Geoffrey Michael,8,0,32,24
1657727328978,MATH 142A,A01,083219,Chow; Bennett,7,0,32,25
1657727328978,MATH 142A,A02,083220,Chow; Bennett,10,0,32,22
1657727328978,MATH 142A,A03,093480,Chow; Bennett,9,0,32,23
1657727328978,MATH 142A,B03,093481,Chow; Bennett,8,0,32,24
1657727328978,MATH 142A,B04,093558,Chow; Bennett,13,0,32,19
1657727328978,MATH 142A,B05,093559,Chow; Bennett,6,0,32,26
1657727335001,MATH 193A,A01,083224,Rotar; Vladimir,8,0,34,26
1657727335001,MATH 193A,A02,083225,Rotar; Vladimir,9,0,34,25
1657727335001,MATH 193A,A03,083781,Rotar; Vladimir,5,0,34,29
1657727335001,MATH 193A,A04,083782,Rotar; Vladimir,10,0,34,24
1657727335001,MATH 193A,A05,093482,Rotar; Vladimir,10,0,34,24
1657727341028,MATH 197,001,091859,McAuley; Julian John,9999,0,9999,0
1657727341028,MATH 197,002,095566,Kedlaya; Kiran S.,9997,0,9999,2
1657727341028,MATH 197,003,095567,Xiao; Ming,9999,0,9999,0
1657727341028,MATH 197,004,095571,Perols; Johan Lars,9998,0,9999,1
1657727348089,COGS 9,A01,083615,Shannon; Kyle Michael,9,0,75,66
1657727354111,COGS 11,A01,083617,Boyle; Mary E. T.,23,0,48,25
1657727360138,COGS 13,A01,083071,Bastos; Amalia Pinkusfeld,11,0,71,60
1657727366165,COGS 14A,A01,092681,Semenuks; Arturs,5,1,100,95
1657727372215,COGS 14B,A01,083073,Cheng; Tzu-Han,6,0,63,57
1657727378240,COGS 17,A01,092677,Semenuks; Arturs,6,0,81,75
1657727384269,COGS 100,A01,083619,Allen; Michael Gordon,17,0,70,53
1657727390295,COGS 101A,A01,083621,Davis; Joshua Daniel,9,0,68,59
1657727396321,COGS 101B,A01,091572,Allen; Michael Gordon,12,0,65,53
1657727402348,COGS 101C,A01,083625,Delgado; Tania,17,0,35,18
1657727408374,COGS 107A,A01,083627,Boyle; Mary E. T.,13,0,60,47
1657727414398,COGS 118A,A01,083075,Gupta; Anjum,21,0,76,55
1657727420426,CSE 3,A50,083646,Miranda; Gregory Joseph,24,0,50,26
1657727426455,CSE 8A,A50,083650,Miranda; Gregory Joseph,17,1,56,39
1657727432486,CSE 11,A01,083080,Cao; Yingjun,6,15,40,34
1657727438513,CSE 12,A01,083652,Krause-Levy; Sophia Louisa,28,1,120,92
1657727444539,CSE 15L,A01,083654,Morris; Justin Loren,9,0,50,41
1657727444539,CSE 15L,A02,083655,Morris; Justin Loren,9,0,50,41
1657727450562,CSE 20,A01,083657,Tran; Khoa Dang,39,0,80,41
1657727456588,CSE 21,A01,095574,Bach; Quang Tran,22,0,48,26
1657727462613,CSE 30,A01,083084,Eldon; John,6,0,80,74
1657727462613,CSE 30,B01,095061,Bhaskar; Nishant,9,0,50,41
1657727468638,CSE 100,A01,083659,Cao; Yingjun,5,4,70,65
1657727474668,CSE 134B,A01,083661,Powell; Thomas Allan,23,0,100,77
1657727480705,CSE 140,A01,083663,Gungor; Onat,15,0,85,70
1657727486731,CSE 140L,A01,083088,Eldon; John,23,0,100,77
1657727492758,CSE 175,A01,083665,Kumar; Rakesh,3,0,25,22
1657727498784,CSE 190,A00,092507,Dubnov; Shlomo,8,0,20,12
1657727504818,ECE 45,A01,083139,Congero; Spencer William,6,0,75,69
1657727510843,ECE 65,A50,083695,Saad; Andrew S,12,0,30,18
1657727510843,ECE 65,A51,095125,Saad; Andrew S,24,0,26,2
1657727516866,ECE 109,A01,091882,Touri; Behrouz,20,0,70,50
1657727522897,ECE 180,A00,083140,Abi Samra; Nicholas Camill,1,0,30,29
1657727522897,ECE 180,B00,083141,Abi Samra; Nicholas Camill,0,0,30,30
1657727528921,MATH 10A,A01,083735,Patchell; Gregory David,2,0,30,28
1657727528921,MATH 10A,A02,083736,Patchell; Gregory David,20,0,30,10
1657727528921,MATH 10A,A03,083737,Patchell; Gregory David,16,0,30,14
1657727534951,MATH 10B,A01,083207,Lim; Seonhee,8,0,34,26
1657727534951,MATH 10B,A02,083208,Lim; Seonhee,9,0,35,26
1657727534951,MATH 10B,A03,093472,Lim; Seonhee,7,0,34,27
1657727534951,MATH 10B,B01,083739,Sinha; Shubham,13,0,30,17
1657727540985,MATH 18,A01,083743,Cinel; Cameron Alexander,8,0,30,22
1657727540985,MATH 18,A02,083744,Cinel; Cameron Alexander,17,0,30,13
1657727540985,MATH 18,A03,083745,Cinel; Cameron Alexander,10,0,30,20
1657727540985,MATH 18,B01,083748,Rideout; David Porter,5,0,37,32
1657727540985,MATH 18,B02,083749,Rideout; David Porter,5,0,36,31
1657727540985,MATH 18,B03,083750,Rideout; David Porter,3,0,37,34
1657727540985,MATH 18,B04,083751,Rideout; David Porter,6,0,36,30
1657727540985,MATH 18,B05,093473,Rideout; David Porter,6,0,36,30
1657727540985,MATH 18,B06,093474,Rideout; David Porter,6,0,36,30
1657727547010,MATH 20A,A01,083754,Zheng; Zequn,14,0,40,26
1657727553110,MATH 20B,A01,083756,Briones; Jor-el Thomas Caparas,4,0,36,32
1657727553110,MATH 20B,A02,083757,Briones; Jor-el Thomas Caparas,1,0,36,35
1657727553110,MATH 20B,A03,093475,Briones; Jor-el Thomas Caparas,2,0,36,34
1657727559138,MATH 20C,A01,083760,Briones; Jor-el Thomas Caparas,1,0,35,34
1657727559138,MATH 20C,A02,083761,Briones; Jor-el Thomas Caparas,8,0,35,27
1657727559138,MATH 20C,A03,093476,Briones; Jor-el Thomas Caparas,0,1,36,36
1657727559138,MATH 20C,B01,083762,Bach; Quang Tran,1,0,30,29
1657727565166,MATH 20D,A01,083765,Tran; Brian Kha,5,0,30,25
1657727565166,MATH 20D,A02,083766,Tran; Brian Kha,5,0,30,25
1657727565166,MATH 20D,A03,083767,Tran; Brian Kha,5,0,30,25
1657727571200,MATH 20E,A01,083771,Ganguly; Soumya,9,0,32,23
1657727571200,MATH 20E,A02,083772,Ganguly; Soumya,6,0,32,26
1657727571200,MATH 20E,B01,083773,Ciotti; Benjamin,20,0,35,15
1657727571200,MATH 20E,B02,083774,Ciotti; Benjamin,18,0,35,17
1657727577230,MATH 103A,A01,083777,Greenfeld; Be'Eri,3,0,36,33
1657727577230,MATH 103A,A02,083778,Greenfeld; Be'Eri,5,0,36,31
1657727577230,MATH 103A,A03,093561,Greenfeld; Be'Eri,6,0,36,30
1657727577230,MATH 103A,B01,083779,Greenfeld; Be'Eri,7,0,36,29
1657727577230,MATH 103A,B02,083780,Greenfeld; Be'Eri,4,0,36,32
1657727577230,MATH 103A,B03,093562,Greenfeld; Be'Eri,3,0,36,33
1657727583254,MATH 105,A01,085443,Carter; Anne Toulson,15,0,35,20
1657727583254,MATH 105,A02,093477,Carter; Anne Toulson,20,0,35,15
1657727589284,MATH 109,A01,083213,Ganzberger; Geoffrey Michael,2,0,34,32
1657727589284,MATH 109,A02,083214,Ganzberger; Geoffrey Michael,4,0,34,30
1657727589284,MATH 109,A03,093478,Ganzberger; Geoffrey Michael,2,0,34,32
1657727589284,MATH 109,B01,083215,Ganzberger; Geoffrey Michael,1,0,32,31
1657727589284,MATH 109,B02,083216,Ganzberger; Geoffrey Michael,2,0,32,30
1657727589284,MATH 109,B03,093479,Ganzberger; Geoffrey Michael,8,0,32,24
1657727595318,MATH 142A,A01,083219,Chow; Bennett,7,0,32,25
1657727595318,MATH 142A,A02,083220,Chow; Bennett,10,0,32,22
1657727595318,MATH 142A,A03,093480,Chow; Bennett,9,0,32,23
1657727595318,MATH 142A,B03,093481,Chow; Bennett,8,0,32,24
1657727595318,MATH 142A,B04,093558,Chow; Bennett,13,0,32,19
1657727595318,MATH 142A,B05,093559,Chow; Bennett,6,0,32,26
1657727601345,MATH 193A,A01,083224,Rotar; Vladimir,8,0,34,26
1657727601345,MATH 193A,A02,083225,Rotar; Vladimir,9,0,34,25
1657727601345,MATH 193A,A03,083781,Rotar; Vladimir,5,0,34,29
1657727601345,MATH 193A,A04,083782,Rotar; Vladimir,10,0,34,24
1657727601345,MATH 193A,A05,093482,Rotar; Vladimir,10,0,34,24
1657727607369,MATH 197,001,091859,McAuley; Julian John,9999,0,9999,0
1657727607369,MATH 197,002,095566,Kedlaya; Kiran S.,9997,0,9999,2
1657727607369,MATH 197,003,095567,Xiao; Ming,9999,0,9999,0
1657727607369,MATH 197,004,095571,Perols; Johan Lars,9998,0,9999,1
1657727614418,COGS 9,A01,083615,Shannon; Kyle Michael,9,0,75,66
1657727620446,COGS 11,A01,083617,Boyle; Mary E. T.,23,0,48,25
1657727626473,COGS 13,A01,083071,Bastos; Amalia Pinkusfeld,11,0,71,60
1657727632497,COGS 14A,A01,092681,Semenuks; Arturs,5,1,100,95
1657727638518,COGS 14B,A01,083073,Cheng; Tzu-Han,6,0,63,57
1657727644543,COGS 17,A01,092677,Semenuks; Arturs,6,0,81,75
1657727650566,COGS 100,A01,083619,Allen; Michael Gordon,17,0,70,53
1657727656594,COGS 101A,A01,083621,Davis; Joshua Daniel,9,0,68,59
1657727662622,COGS 101B,A01,091572,Allen; Michael Gordon,12,0,65,53
1657727668648,COGS 101C,A01,083625,Delgado; Tania,17,0,35,18
1657727674678,COGS 107A,A01,083627,Boyle; Mary E. T.,13,0,60,47
1657727680706,COGS 118A,A01,083075,Gupta; Anjum,21,0,76,55
1657727686734,CSE 3,A50,083646,Miranda; Gregory Joseph,24,0,50,26
1657727692759,CSE 8A,A50,083650,Miranda; Gregory Joseph,17,1,56,39
1657727698784,CSE 11,A01,083080,Cao; Yingjun,6,15,40,34
1657727704809,CSE 12,A01,083652,Krause-Levy; Sophia Louisa,28,1,120,92
1657727710841,CSE 15L,A01,083654,Morris; Justin Loren,9,0,50,41
1657727710841,CSE 15L,A02,083655,Morris; Justin Loren,9,0,50,41
1657727716867,CSE 20,A01,083657,Tran; Khoa Dang,39,0,80,41
1657727722889,CSE 21,A01,095574,Bach; Quang Tran,22,0,48,26
1657727728912,CSE 30,A01,083084,Eldon; John,6,0,80,74
1657727728912,CSE 30,B01,095061,Bhaskar; Nishant,9,0,50,41
1657727734935,CSE 100,A01,083659,Cao; Yingjun,5,4,70,65
1657727740975,CSE 134B,A01,083661,Powell; Thomas Allan,23,0,100,77
1657727746999,CSE 140,A01,083663,Gungor; Onat,15,0,85,70
1657727753025,CSE 140L,A01,083088,Eldon; John,23,0,100,77
1657727759051,CSE 175,A01,083665,Kumar; Rakesh,3,0,25,22
1657727765074,CSE 190,A00,092507,Dubnov; Shlomo,8,0,20,12
1657727771102,ECE 45,A01,083139,Congero; Spencer William,6,0,75,69
1657727777124,ECE 65,A50,083695,Saad; Andrew S,12,0,30,18
1657727777124,ECE 65,A51,095125,Saad; Andrew S,24,0,26,2
1657727783147,ECE 109,A01,091882,Touri; Behrouz,20,0,70,50
1657727789172,ECE 180,A00,083140,Abi Samra; Nicholas Camill,1,0,30,29
1657727789172,ECE 180,B00,083141,Abi Samra; Nicholas Camill,0,0,30,30
1657727795200,MATH 10A,A01,083735,Patchell; Gregory David,2,0,30,28
1657727795200,MATH 10A,A02,083736,Patchell; Gregory David,20,0,30,10
1657727795200,MATH 10A,A03,083737,Patchell; Gregory David,16,0,30,14
1657727801237,MATH 10B,A01,083207,Lim; Seonhee,8,0,34,26
1657727801237,MATH 10B,A02,083208,Lim; Seonhee,9,0,35,26
1657727801237,MATH 10B,A03,093472,Lim; Seonhee,7,0,34,27
1657727801237,MATH 10B,B01,083739,Sinha; Shubham,13,0,30,17
1657727807289,MATH 18,A01,083743,Cinel; Cameron Alexander,8,0,30,22
1657727807289,MATH 18,A02,083744,Cinel; Cameron Alexander,17,0,30,13
1657727807289,MATH 18,A03,083745,Cinel; Cameron Alexander,10,0,30,20
1657727807289,MATH 18,B01,083748,Rideout; David Porter,5,0,37,32
1657727807289,MATH 18,B02,083749,Rideout; David Porter,5,0,36,31
1657727807289,MATH 18,B03,083750,Rideout; David Porter,3,0,37,34
1657727807289,MATH 18,B04,083751,Rideout; David Porter,6,0,36,30
1657727807289,MATH 18,B05,093473,Rideout; David Porter,6,0,36,30
1657727807289,MATH 18,B06,093474,Rideout; David Porter,6,0,36,30
1657727813319,MATH 20A,A01,083754,Zheng; Zequn,14,0,40,26
1657727819346,MATH 20B,A01,083756,Briones; Jor-el Thomas Caparas,4,0,36,32
1657727819346,MATH 20B,A02,083757,Briones; Jor-el Thomas Caparas,1,0,36,35
1657727819346,MATH 20B,A03,093475,Briones; Jor-el Thomas Caparas,2,0,36,34
1657727825373,MATH 20C,A01,083760,Briones; Jor-el Thomas Caparas,1,0,35,34
1657727825373,MATH 20C,A02,083761,Briones; Jor-el Thomas Caparas,8,0,35,27
1657727825373,MATH 20C,A03,093476,Briones; Jor-el Thomas Caparas,0,1,36,36
1657727825373,MATH 20C,B01,083762,Bach; Quang Tran,1,0,30,29
1657727831398,MATH 20D,A01,083765,Tran; Brian Kha,5,0,30,25
1657727831398,MATH 20D,A02,083766,Tran; Brian Kha,5,0,30,25
1657727831398,MATH 20D,A03,083767,Tran; Brian Kha,5,0,30,25
1657727837421,MATH 20E,A01,083771,Ganguly; Soumya,9,0,32,23
1657727837421,MATH 20E,A02,083772,Ganguly; Soumya,6,0,32,26
1657727837421,MATH 20E,B01,083773,Ciotti; Benjamin,20,0,35,15
1657727837421,MATH 20E,B02,083774,Ciotti; Benjamin,18,0,35,17
1657727843455,MATH 103A,A01,083777,Greenfeld; Be'Eri,3,0,36,33
1657727843455,MATH 103A,A02,083778,Greenfeld; Be'Eri,5,0,36,31
1657727843455,MATH 103A,A03,093561,Greenfeld; Be'Eri,6,0,36,30
1657727843455,MATH 103A,B01,083779,Greenfeld; Be'Eri,7,0,36,29
1657727843455,MATH 103A,B02,083780,Greenfeld; Be'Eri,4,0,36,32
1657727843455,MATH 103A,B03,093562,Greenfeld; Be'Eri,3,0,36,33
1657727849484,MATH 105,A01,085443,Carter; Anne Toulson,15,0,35,20
1657727849484,MATH 105,A02,093477,Carter; Anne Toulson,20,0,35,15
1657727855516,MATH 109,A01,083213,Ganzberger; Geoffrey Michael,2,0,34,32
1657727855516,MATH 109,A02,083214,Ganzberger; Geoffrey Michael,4,0,34,30
1657727855516,MATH 109,A03,093478,Ganzberger; Geoffrey Michael,2,0,34,32
1657727855516,MATH 109,B01,083215,Ganzberger; Geoffrey Michael,1,0,32,31
1657727855516,MATH 109,B02,083216,Ganzberger; Geoffrey Michael,2,0,32,30
1657727855516,MATH 109,B03,093479,Ganzberger; Geoffrey Michael,8,0,32,24
1657727861541,MATH 142A,A01,083219,Chow; Bennett,7,0,32,25
1657727861541,MATH 142A,A02,083220,Chow; Bennett,10,0,32,22
1657727861541,MATH 142A,A03,093480,Chow; Bennett,9,0,32,23
1657727861541,MATH 142A,B03,093481,Chow; Bennett,8,0,32,24
1657727861541,MATH 142A,B04,093558,Chow; Bennett,13,0,32,19
1657727861541,MATH 142A,B05,093559,Chow; Bennett,6,0,32,26
1657727867565,MATH 193A,A01,083224,Rotar; Vladimir,8,0,34,26
1657727867565,MATH 193A,A02,083225,Rotar; Vladimir,9,0,34,25
1657727867565,MATH 193A,A03,083781,Rotar; Vladimir,5,0,34,29
1657727867565,MATH 193A,A04,083782,Rotar; Vladimir,10,0,34,24
1657727867565,MATH 193A,A05,093482,Rotar; Vladimir,10,0,34,24
1657727873588,MATH 197,001,091859,McAuley; Julian John,9999,0,9999,0
1657727873588,MATH 197,002,095566,Kedlaya; Kiran S.,9997,0,9999,2
1657727873588,MATH 197,003,095567,Xiao; Ming,9999,0,9999,0
1657727873588,MATH 197,004,095571,Perols; Johan Lars,9998,0,9999,1
1657727880645,COGS 9,A01,083615,Shannon; Kyle Michael,9,0,75,66
1657727886671,COGS 11,A01,083617,Boyle; Mary E. T.,23,0,48,25
1657727892694,COGS 13,A01,083071,Bastos; Amalia Pinkusfeld,11,0,71,60
1657727898729,COGS 14A,A01,092681,Semenuks; Arturs,5,1,100,95
1657727904760,COGS 14B,A01,083073,Cheng; Tzu-Han,6,0,63,57
1657727910783,COGS 17,A01,092677,Semenuks; Arturs,6,0,81,75
1657727916811,COGS 100,A01,083619,Allen; Michael Gordon,17,0,70,53
1657727922833,COGS 101A,A01,083621,Davis; Joshua Daniel,9,0,68,59
1657727928864,COGS 101B,A01,091572,Allen; Michael Gordon,12,0,65,53
1657727934887,COGS 101C,A01,083625,Delgado; Tania,17,0,35,18
1657727940914,COGS 107A,A01,083627,Boyle; Mary E. T.,13,0,60,47
1657727946939,COGS 118A,A01,083075,Gupta; Anjum,21,0,76,55
1657727952962,CSE 3,A50,083646,Miranda; Gregory Joseph,24,0,50,26
1657727958985,CSE 8A,A50,083650,Miranda; Gregory Joseph,17,1,56,39
1657727965009,CSE 11,A01,083080,Cao; Yingjun,6,15,40,34
1657727971033,CSE 12,A01,083652,Krause-Levy; Sophia Louisa,28,1,120,92
1657727977055,CSE 15L,A01,083654,Morris; Justin Loren,9,0,50,41
1657727977055,CSE 15L,A02,083655,Morris; Justin Loren,9,0,50,41
1657727983079,CSE 20,A01,083657,Tran; Khoa Dang,39,0,80,41
1657727989108,CSE 21,A01,095574,Bach; Quang Tran,22,0,48,26
1657727995147,CSE 30,A01,083084,Eldon; John,6,0,80,74
1657727995147,CSE 30,B01,095061,Bhaskar; Nishant,9,0,50,41
1657728001185,CSE 100,A01,083659,Cao; Yingjun,5,4,70,65
1657728007219,CSE 134B,A01,083661,Powell; Thomas Allan,23,0,100,77
1657728013259,CSE 140,A01,083663,Gungor; Onat,15,0,85,70
1657728019285,CSE 140L,A01,083088,Eldon; John,23,0,100,77
1657728025314,CSE 175,A01,083665,Kumar; Rakesh,3,0,25,22
1657728031342,CSE 190,A00,092507,Dubnov; Shlomo,8,0,20,12
1657728037371,ECE 45,A01,083139,Congero; Spencer William,6,0,75,69
1657728043393,ECE 65,A50,083695,Saad; Andrew S,12,0,30,18
1657728043393,ECE 65,A51,095125,Saad; Andrew S,24,0,26,2
1657728049415,ECE 109,A01,091882,Touri; Behrouz,20,0,70,50
1657728055442,ECE 180,A00,083140,Abi Samra; Nicholas Camill,1,0,30,29
1657728055442,ECE 180,B00,083141,Abi Samra; Nicholas Camill,0,0,30,30
1657728061463,MATH 10A,A01,083735,Patchell; Gregory David,2,0,30,28
1657728061463,MATH 10A,A02,083736,Patchell; Gregory David,20,0,30,10
1657728061463,MATH 10A,A03,083737,Patchell; Gregory David,16,0,30,14
1657728067487,MATH 10B,A01,083207,Lim; Seonhee,8,0,34,26
1657728067487,MATH 10B,A02,083208,Lim; Seonhee,9,0,35,26
1657728067487,MATH 10B,A03,093472,Lim; Seonhee,7,0,34,27
1657728067487,MATH 10B,B01,083739,Sinha; Shubham,13,0,30,17
1657728073521,MATH 18,A01,083743,Cinel; Cameron Alexander,9,0,30,21
1657728073521,MATH 18,A02,083744,Cinel; Cameron Alexander,17,0,30,13
1657728073521,MATH 18,A03,083745,Cinel; Cameron Alexander,10,0,30,20
1657728073521,MATH 18,B01,083748,Rideout; David Porter,5,0,37,32
1657728073521,MATH 18,B02,083749,Rideout; David Porter,5,0,36,31
1657728073521,MATH 18,B03,083750,Rideout; David Porter,3,0,37,34
1657728073521,MATH 18,B04,083751,Rideout; David Porter,6,0,36,30
1657728073521,MATH 18,B05,093473,Rideout; David Porter,6,0,36,30
1657728073521,MATH 18,B06,093474,Rideout; David Porter,6,0,36,30
1657728079547,MATH 20A,A01,083754,Zheng; Zequn,14,0,40,26
1657728085570,MATH 20B,A01,083756,Briones; Jor-el Thomas Caparas,4,0,36,32
1657728085570,MATH 20B,A02,083757,Briones; Jor-el Thomas Caparas,1,0,36,35
1657728085570,MATH 20B,A03,093475,Briones; Jor-el Thomas Caparas,2,0,36,34
1657728091598,MATH 20C,A01,083760,Briones; Jor-el Thomas Caparas,1,0,35,34
1657728091598,MATH 20C,A02,083761,Briones; Jor-el Thomas Caparas,8,0,35,27
1657728091598,MATH 20C,A03,093476,Briones; Jor-el Thomas Caparas,0,1,36,36
1657728091598,MATH 20C,B01,083762,Bach; Quang Tran,1,0,30,29
1657728097620,MATH 20D,A01,083765,Tran; Brian Kha,5,0,30,25
1657728097620,MATH 20D,A02,083766,Tran; Brian Kha,5,0,30,25
1657728097620,MATH 20D,A03,083767,Tran; Brian Kha,5,0,30,25
1657728103642,MATH 20E,A01,083771,Ganguly; Soumya,9,0,32,23
1657728103642,MATH 20E,A02,083772,Ganguly; Soumya,6,0,32,26
1657728103642,MATH 20E,B01,083773,Ciotti; Benjamin,20,0,35,15
1657728103642,MATH 20E,B02,083774,Ciotti; Benjamin,18,0,35,17
1657728109667,MATH 103A,A01,083777,Greenfeld; Be'Eri,3,0,36,33
1657728109667,MATH 103A,A02,083778,Greenfeld; Be'Eri,5,0,36,31
1657728109667,MATH 103A,A03,093561,Greenfeld; Be'Eri,6,0,36,30
1657728109667,MATH 103A,B01,083779,Greenfeld; Be'Eri,7,0,36,29
1657728109667,MATH 103A,B02,083780,Greenfeld; Be'Eri,4,0,36,32
1657728109667,MATH 103A,B03,093562,Greenfeld; Be'Eri,3,0,36,33
1657728115691,MATH 105,A01,085443,Carter; Anne Toulson,15,0,35,20
1657728115691,MATH 105,A02,093477,Carter; Anne Toulson,20,0,35,15
1657728121720,MATH 109,A01,083213,Ganzberger; Geoffrey Michael,2,0,34,32
1657728121720,MATH 109,A02,083214,Ganzberger; Geoffrey Michael,4,0,34,30
1657728121720,MATH 109,A03,093478,Ganzberger; Geoffrey Michael,2,0,34,32
1657728121720,MATH 109,B01,083215,Ganzberger; Geoffrey Michael,1,0,32,31
1657728121720,MATH 109,B02,083216,Ganzberger; Geoffrey Michael,2,0,32,30
1657728121720,MATH 109,B03,093479,Ganzberger; Geoffrey Michael,8,0,32,24
1657728127747,MATH 142A,A01,083219,Chow; Bennett,7,0,32,25
1657728127747,MATH 142A,A02,083220,Chow; Bennett,10,0,32,22
1657728127747,MATH 142A,A03,093480,Chow; Bennett,9,0,32,23
1657728127747,MATH 142A,B03,093481,Chow; Bennett,8,0,32,24
1657728127747,MATH 142A,B04,093558,Chow; Bennett,13,0,32,19
1657728127747,MATH 142A,B05,093559,Chow; Bennett,6,0,32,26
1657728133769,MATH 193A,A01,083224,Rotar; Vladimir,8,0,34,26
1657728133769,MATH 193A,A02,083225,Rotar; Vladimir,9,0,34,25
1657728133769,MATH 193A,A03,083781,Rotar; Vladimir,5,0,34,29
1657728133769,MATH 193A,A04,083782,Rotar; Vladimir,10,0,34,24
1657728133769,MATH 193A,A05,093482,Rotar; Vladimir,10,0,34,24
1657728139793,MATH 197,001,091859,McAuley; Julian John,9999,0,9999,0
1657728139793,MATH 197,002,095566,Kedlaya; Kiran S.,9997,0,9999,2
1657728139793,MATH 197,003,095567,Xiao; Ming,9999,0,9999,0
1657728139793,MATH 197,004,095571,Perols; Johan Lars,9998,0,9999,1
1657728146935,COGS 9,A01,083615,Shannon; Kyle Michael,9,0,75,66
1657728152958,COGS 11,A01,083617,Boyle; Mary E. T.,23,0,48,25
1657728158981,COGS 13,A01,083071,Bastos; Amalia Pinkusfeld,11,0,71,60
1657728165011,COGS 14A,A01,092681,Semenuks; Arturs,5,1,100,95
1657728171034,COGS 14B,A01,083073,Cheng; Tzu-Han,6,0,63,57
1657728177058,COGS 17,A01,092677,Semenuks; Arturs,6,0,81,75
1657728183083,COGS 100,A01,083619,Allen; Michael Gordon,17,0,70,53
1657728189110,COGS 101A,A01,083621,Davis; Joshua Daniel,9,0,68,59
1657728195133,COGS 101B,A01,091572,Allen; Michael Gordon,12,0,65,53
1657728201169,COGS 101C,A01,083625,Delgado; Tania,17,0,35,18
1657728207192,COGS 107A,A01,083627,Boyle; Mary E. T.,13,0,60,47
1657728213223,COGS 118A,A01,083075,Gupta; Anjum,21,0,76,55
1657728219248,CSE 3,A50,083646,Miranda; Gregory Joseph,24,0,50,26
1657728225272,CSE 8A,A50,083650,Miranda; Gregory Joseph,17,1,56,39
1657728231295,CSE 11,A01,083080,Cao; Yingjun,6,15,40,34
1657728237316,CSE 12,A01,083652,Krause-Levy; Sophia Louisa,28,1,120,92
1657728243339,CSE 15L,A01,083654,Morris; Justin Loren,9,0,50,41
1657728243339,CSE 15L,A02,083655,Morris; Justin Loren,9,0,50,41
1657728249375,CSE 20,A01,083657,Tran; Khoa Dang,39,0,80,41
1657728255405,CSE 21,A01,095574,Bach; Quang Tran,22,0,48,26
1657728261427,CSE 30,A01,083084,Eldon; John,6,0,80,74
1657728261427,CSE 30,B01,095061,Bhaskar; Nishant,9,0,50,41
1657728267450,CSE 100,A01,083659,Cao; Yingjun,5,4,70,65
1657728273487,CSE 134B,A01,083661,Powell; Thomas Allan,23,0,100,77
1657728279517,CSE 140,A01,083663,Gungor; Onat,15,0,85,70
1657728285541,CSE 140L,A01,083088,Eldon; John,23,0,100,77
1657728291566,CSE 175,A01,083665,Kumar; Rakesh,3,0,25,22
1657728297600,CSE 190,A00,092507,Dubnov; Shlomo,8,0,20,12
1657728303627,ECE 45,A01,083139,Congero; Spencer William,6,0,75,69
1657728309662,ECE 65,A50,083695,Saad; Andrew S,12,0,30,18
1657728309662,ECE 65,A51,095125,Saad; Andrew S,24,0,26,2
1657728315684,ECE 109,A01,091882,Touri; Behrouz,20,0,70,50
1657728321717,ECE 180,A00,083140,Abi Samra; Nicholas Camill,1,0,30,29
1657728321717,ECE 180,B00,083141,Abi Samra; Nicholas Camill,0,0,30,30
1657728327741,MATH 10A,A01,083735,Patchell; Gregory David,2,0,30,28
1657728327741,MATH 10A,A02,083736,Patchell; Gregory David,20,0,30,10
1657728327741,MATH 10A,A03,083737,Patchell; Gregory David,16,0,30,14
1657728333773,MATH 10B,A01,083207,Lim; Seonhee,8,0,34,26
1657728333773,MATH 10B,A02,083208,Lim; Seonhee,9,0,35,26
1657728333773,MATH 10B,A03,093472,Lim; Seonhee,7,0,34,27
1657728333773,MATH 10B,B01,083739,Sinha; Shubham,13,0,30,17
1657728339807,MATH 18,A01,083743,Cinel; Cameron Alexander,9,0,30,21
1657728339807,MATH 18,A02,083744,Cinel; Cameron Alexander,17,0,30,13
1657728339807,MATH 18,A03,083745,Cinel; Cameron Alexander,10,0,30,20
1657728339807,MATH 18,B01,083748,Rideout; David Porter,5,0,37,32
1657728339807,MATH 18,B02,083749,Rideout; David Porter,5,0,36,31
1657728339807,MATH 18,B03,083750,Rideout; David Porter,3,0,37,34
1657728339807,MATH 18,B04,083751,Rideout; David Porter,6,0,36,30
1657728339807,MATH 18,B05,093473,Rideout; David Porter,6,0,36,30
1657728339807,MATH 18,B06,093474,Rideout; David Porter,6,0,36,30
1657728345830,MATH 20A,A01,083754,Zheng; Zequn,14,0,40,26
1657728351854,MATH 20B,A01,083756,Briones; Jor-el Thomas Caparas,4,0,36,32
1657728351854,MATH 20B,A02,083757,Briones; Jor-el Thomas Caparas,1,0,36,35
1657728351854,MATH 20B,A03,093475,Briones; Jor-el Thomas Caparas,2,0,36,34
1657728357879,MATH 20C,A01,083760,Briones; Jor-el Thomas Caparas,1,0,35,34
1657728357879,MATH 20C,A02,083761,Briones; Jor-el Thomas Caparas,8,0,35,27
1657728357879,MATH 20C,A03,093476,Briones; Jor-el Thomas Caparas,0,1,36,36
1657728357879,MATH 20C,B01,083762,Bach; Quang Tran,1,0,30,29
1657728363916,MATH 20D,A01,083765,Tran; Brian Kha,5,0,30,25
1657728363916,MATH 20D,A02,083766,Tran; Brian Kha,5,0,30,25
1657728363916,MATH 20D,A03,083767,Tran; Brian Kha,5,0,30,25
1657728369951,MATH 20E,A01,083771,Ganguly; Soumya,9,0,32,23
1657728369951,MATH 20E,A02,083772,Ganguly; Soumya,6,0,32,26
1657728369951,MATH 20E,B01,083773,Ciotti; Benjamin,20,0,35,15
1657728369951,MATH 20E,B02,083774,Ciotti; Benjamin,18,0,35,17
1657728375973,MATH 103A,A01,083777,Greenfeld; Be'Eri,3,0,36,33
1657728375973,MATH 103A,A02,083778,Greenfeld; Be'Eri,5,0,36,31
1657728375973,MATH 103A,A03,093561,Greenfeld; Be'Eri,6,0,36,30
1657728375973,MATH 103A,B01,083779,Greenfeld; Be'Eri,7,0,36,29
1657728375973,MATH 103A,B02,083780,Greenfeld; Be'Eri,4,0,36,32
1657728375973,MATH 103A,B03,093562,Greenfeld; Be'Eri,3,0,36,33
1657728381998,MATH 105,A01,085443,Carter; Anne Toulson,15,0,35,20
1657728381998,MATH 105,A02,093477,Carter; Anne Toulson,20,0,35,15
1657728388030,MATH 109,A01,083213,Ganzberger; Geoffrey Michael,2,0,34,32
1657728388030,MATH 109,A02,083214,Ganzberger; Geoffrey Michael,4,0,34,30
1657728388030,MATH 109,A03,093478,Ganzberger; Geoffrey Michael,2,0,34,32
1657728388030,MATH 109,B01,083215,Ganzberger; Geoffrey Michael,1,0,32,31
1657728388030,MATH 109,B02,083216,Ganzberger; Geoffrey Michael,2,0,32,30
1657728388030,MATH 109,B03,093479,Ganzberger; Geoffrey Michael,8,0,32,24
1657728394055,MATH 142A,A01,083219,Chow; Bennett,7,0,32,25
1657728394055,MATH 142A,A02,083220,Chow; Bennett,10,0,32,22
1657728394055,MATH 142A,A03,093480,Chow; Bennett,9,0,32,23
1657728394055,MATH 142A,B03,093481,Chow; Bennett,8,0,32,24
1657728394055,MATH 142A,B04,093558,Chow; Bennett,13,0,32,19
1657728394055,MATH 142A,B05,093559,Chow; Bennett,6,0,32,26
1657728400087,MATH 193A,A01,083224,Rotar; Vladimir,8,0,34,26
1657728400087,MATH 193A,A02,083225,Rotar; Vladimir,9,0,34,25
1657728400087,MATH 193A,A03,083781,Rotar; Vladimir,5,0,34,29
1657728400087,MATH 193A,A04,083782,Rotar; Vladimir,10,0,34,24
1657728400087,MATH 193A,A05,093482,Rotar; Vladimir,10,0,34,24
1657728406110,MATH 197,001,091859,McAuley; Julian John,9999,0,9999,0
1657728406110,MATH 197,002,095566,Kedlaya; Kiran S.,9997,0,9999,2
1657728406110,MATH 197,003,095567,Xiao; Ming,9999,0,9999,0
1657728406110,MATH 197,004,095571,Perols; Johan Lars,9998,0,9999,1
1657728413161,COGS 9,A01,083615,Shannon; Kyle Michael,9,0,75,66
1657728419188,COGS 11,A01,083617,Boyle; Mary E. T.,23,0,48,25
1657728425213,COGS 13,A01,083071,Bastos; Amalia Pinkusfeld,11,0,71,60
1657728431245,COGS 14A,A01,092681,Semenuks; Arturs,5,1,100,95
1657728437269,COGS 14B,A01,083073,Cheng; Tzu-Han,6,0,63,57
1657728443302,COGS 17,A01,092677,Semenuks; Arturs,6,0,81,75
1657728449329,COGS 100,A01,083619,Allen; Michael Gordon,17,0,70,53
1657728455350,COGS 101A,A01,083621,Davis; Joshua Daniel,9,0,68,59
1657728461384,COGS 101B,A01,091572,Allen; Michael Gordon,12,0,65,53
1657728467407,COGS 101C,A01,083625,Delgado; Tania,17,0,35,18
1657728473433,COGS 107A,A01,083627,Boyle; Mary E. T.,13,0,60,47
1657728479454,COGS 118A,A01,083075,Gupta; Anjum,21,0,76,55
1657728485483,CSE 3,A50,083646,Miranda; Gregory Joseph,24,0,50,26
1657728491507,CSE 8A,A50,083650,Miranda; Gregory Joseph,17,1,56,39
1657728497530,CSE 11,A01,083080,Cao; Yingjun,6,15,40,34
1657728503556,CSE 12,A01,083652,Krause-Levy; Sophia Louisa,28,1,120,92
1657728509586,CSE 15L,A01,083654,Morris; Justin Loren,9,0,50,41
1657728509586,CSE 15L,A02,083655,Morris; Justin Loren,9,0,50,41
1657728515608,CSE 20,A01,083657,Tran; Khoa Dang,39,0,80,41
1657728521635,CSE 21,A01,095574,Bach; Quang Tran,22,0,48,26
1657728527661,CSE 30,A01,083084,Eldon; John,6,0,80,74
1657728527661,CSE 30,B01,095061,Bhaskar; Nishant,9,0,50,41
1657728533693,CSE 100,A01,083659,Cao; Yingjun,5,4,70,65
1657728539719,CSE 134B,A01,083661,Powell; Thomas Allan,23,0,100,77
1657728545744,CSE 140,A01,083663,Gungor; Onat,15,0,85,70
1657728551772,CSE 140L,A01,083088,Eldon; John,23,0,100,77
1657728557801,CSE 175,A01,083665,Kumar; Rakesh,3,0,25,22
1657728563831,CSE 190,A00,092507,Dubnov; Shlomo,8,0,20,12
1657728569855,ECE 45,A01,083139,Congero; Spencer William,6,0,75,69
1657728575877,ECE 65,A50,083695,Saad; Andrew S,12,0,30,18
1657728575877,ECE 65,A51,095125,Saad; Andrew S,24,0,26,2
1657728581983,ECE 109,A01,091882,Touri; Behrouz,20,0,70,50
1657728588018,ECE 180,A00,083140,Abi Samra; Nicholas Camill,1,0,30,29
1657728588018,ECE 180,B00,083141,Abi Samra; Nicholas Camill,0,0,30,30
1657728594042,MATH 10A,A01,083735,Patchell; Gregory David,2,0,30,28
1657728594042,MATH 10A,A02,083736,Patchell; Gregory David,20,0,30,10
1657728594042,MATH 10A,A03,083737,Patchell; Gregory David,16,0,30,14
1657728600066,MATH 10B,A01,083207,Lim; Seonhee,8,0,34,26
1657728600066,MATH 10B,A02,083208,Lim; Seonhee,9,0,35,26
1657728600066,MATH 10B,A03,093472,Lim; Seonhee,7,0,34,27
1657728600066,MATH 10B,B01,083739,Sinha; Shubham,13,0,30,17
1657728606101,MATH 18,A01,083743,Cinel; Cameron Alexander,9,0,30,21
1657728606101,MATH 18,A02,083744,Cinel; Cameron Alexander,17,0,30,13
1657728606101,MATH 18,A03,083745,Cinel; Cameron Alexander,10,0,30,20
1657728606101,MATH 18,B01,083748,Rideout; David Porter,5,0,37,32
1657728606101,MATH 18,B02,083749,Rideout; David Porter,5,0,36,31
1657728606101,MATH 18,B03,083750,Rideout; David Porter,3,0,37,34
1657728606101,MATH 18,B04,083751,Rideout; David Porter,6,0,36,30
1657728606101,MATH 18,B05,093473,Rideout; David Porter,6,0,36,30
1657728606101,MATH 18,B06,093474,Rideout; David Porter,6,0,36,30
1657728612126,MATH 20A,A01,083754,Zheng; Zequn,14,0,40,26
1657728618152,MATH 20B,A01,083756,Briones; Jor-el Thomas Caparas,4,0,36,32
1657728618152,MATH 20B,A02,083757,Briones; Jor-el Thomas Caparas,1,0,36,35
1657728618152,MATH 20B,A03,093475,Briones; Jor-el Thomas Caparas,2,0,36,34
1657728624175,MATH 20C,A01,083760,Briones; Jor-el Thomas Caparas,1,0,35,34
1657728624175,MATH 20C,A02,083761,Briones; Jor-el Thomas Caparas,8,0,35,27
1657728624175,MATH 20C,A03,093476,Briones; Jor-el Thomas Caparas,0,1,36,36
1657728624175,MATH 20C,B01,083762,Bach; Quang Tran,1,0,30,29
1657728630200,MATH 20D,A01,083765,Tran; Brian Kha,5,0,30,25
1657728630200,MATH 20D,A02,083766,Tran; Brian Kha,5,0,30,25
1657728630200,MATH 20D,A03,083767,Tran; Brian Kha,5,0,30,25
1657728636224,MATH 20E,A01,083771,Ganguly; Soumya,9,0,32,23
1657728636224,MATH 20E,A02,083772,Ganguly; Soumya,6,0,32,26
1657728636224,MATH 20E,B01,083773,Ciotti; Benjamin,20,0,35,15
1657728636224,MATH 20E,B02,083774,Ciotti; Benjamin,18,0,35,17
1657728642255,MATH 103A,A01,083777,Greenfeld; Be'Eri,3,0,36,33
1657728642255,MATH 103A,A02,083778,Greenfeld; Be'Eri,5,0,36,31
1657728642255,MATH 103A,A03,093561,Greenfeld; Be'Eri,6,0,36,30
1657728642255,MATH 103A,B01,083779,Greenfeld; Be'Eri,7,0,36,29
1657728642255,MATH 103A,B02,083780,Greenfeld; Be'Eri,4,0,36,32
1657728642255,MATH 103A,B03,093562,Greenfeld; Be'Eri,3,0,36,33
1657728648290,MATH 105,A01,085443,Carter; Anne Toulson,15,0,35,20
1657728648290,MATH 105,A02,093477,Carter; Anne Toulson,20,0,35,15
1657728654313,MATH 109,A01,083213,Ganzberger; Geoffrey Michael,2,0,34,32
1657728654313,MATH 109,A02,083214,Ganzberger; Geoffrey Michael,4,0,34,30
1657728654313,MATH 109,A03,093478,Ganzberger; Geoffrey Michael,2,0,34,32
1657728654313,MATH 109,B01,083215,Ganzberger; Geoffrey Michael,1,0,32,31
1657728654313,MATH 109,B02,083216,Ganzberger; Geoffrey Michael,2,0,32,30
1657728654313,MATH 109,B03,093479,Ganzberger; Geoffrey Michael,8,0,32,24
1657728660338,MATH 142A,A01,083219,Chow; Bennett,7,0,32,25
1657728660338,MATH 142A,A02,083220,Chow; Bennett,10,0,32,22
1657728660338,MATH 142A,A03,093480,Chow; Bennett,9,0,32,23
1657728660338,MATH 142A,B03,093481,Chow; Bennett,8,0,32,24
1657728660338,MATH 142A,B04,093558,Chow; Bennett,13,0,32,19
1657728660338,MATH 142A,B05,093559,Chow; Bennett,6,0,32,26
1657728666372,MATH 193A,A01,083224,Rotar; Vladimir,8,0,34,26
1657728666372,MATH 193A,A02,083225,Rotar; Vladimir,9,0,34,25
1657728666372,MATH 193A,A03,083781,Rotar; Vladimir,5,0,34,29
1657728666372,MATH 193A,A04,083782,Rotar; Vladimir,10,0,34,24
1657728666372,MATH 193A,A05,093482,Rotar; Vladimir,10,0,34,24
1657728672395,MATH 197,001,091859,McAuley; Julian John,9999,0,9999,0
1657728672395,MATH 197,002,095566,Kedlaya; Kiran S.,9997,0,9999,2
1657728672395,MATH 197,003,095567,Xiao; Ming,9999,0,9999,0
1657728672395,MATH 197,004,095571,Perols; Johan Lars,9998,0,9999,1
1657728679468,COGS 9,A01,083615,Shannon; Kyle Michael,9,0,75,66
1657728685495,COGS 11,A01,083617,Boyle; Mary E. T.,23,0,48,25
1657728691517,COGS 13,A01,083071,Bastos; Amalia Pinkusfeld,11,0,71,60
1657728697542,COGS 14A,A01,092681,Semenuks; Arturs,5,1,100,95
1657728703577,COGS 14B,A01,083073,Cheng; Tzu-Han,6,0,63,57
1657728709598,COGS 17,A01,092677,Semenuks; Arturs,6,0,81,75
1657728715626,COGS 100,A01,083619,Allen; Michael Gordon,17,0,70,53
1657728721649,COGS 101A,A01,083621,Davis; Joshua Daniel,9,0,68,59
1657728727679,COGS 101B,A01,091572,Allen; Michael Gordon,12,0,65,53
1657728733703,COGS 101C,A01,083625,Delgado; Tania,17,0,35,18
1657728739731,COGS 107A,A01,083627,Boyle; Mary E. T.,13,0,60,47
1657728745825,COGS 118A,A01,083075,Gupta; Anjum,21,0,76,55
1657728751851,CSE 3,A50,083646,Miranda; Gregory Joseph,24,0,50,26
1657728757888,CSE 8A,A50,083650,Miranda; Gregory Joseph,17,1,56,39
1657728763924,CSE 11,A01,083080,Cao; Yingjun,6,15,40,34
1657728769946,CSE 12,A01,083652,Krause-Levy; Sophia Louisa,28,1,120,92
1657728775980,CSE 15L,A01,083654,Morris; Justin Loren,9,0,50,41
1657728775980,CSE 15L,A02,083655,Morris; Justin Loren,9,0,50,41
1657728782002,CSE 20,A01,083657,Tran; Khoa Dang,39,0,80,41
1657728788031,CSE 21,A01,095574,Bach; Quang Tran,22,0,48,26
1657728794068,CSE 30,A01,083084,Eldon; John,6,0,80,74
1657728794068,CSE 30,B01,095061,Bhaskar; Nishant,9,0,50,41
1657728800096,CSE 100,A01,083659,Cao; Yingjun,5,4,70,65
1657728806126,CSE 134B,A01,083661,Powell; Thomas Allan,23,0,100,77
1657728812158,CSE 140,A01,083663,Gungor; Onat,15,0,85,70
1657728818184,CSE 140L,A01,083088,Eldon; John,23,0,100,77
1657728824209,CSE 175,A01,083665,Kumar; Rakesh,3,0,25,22
1657728830232,CSE 190,A00,092507,Dubnov; Shlomo,8,0,20,12
1657728836259,ECE 45,A01,083139,Congero; Spencer William,6,0,75,69
1657728842283,ECE 65,A50,083695,Saad; Andrew S,12,0,30,18
1657728842283,ECE 65,A51,095125,Saad; Andrew S,24,0,26,2
1657728848311,ECE 109,A01,091882,Touri; Behrouz,20,0,70,50
1657728854340,ECE 180,A00,083140,Abi Samra; Nicholas Camill,1,0,30,29
1657728854340,ECE 180,B00,083141,Abi Samra; Nicholas Camill,0,0,30,30
1657728860362,MATH 10A,A01,083735,Patchell; Gregory David,2,0,30,28
1657728860362,MATH 10A,A02,083736,Patchell; Gregory David,20,0,30,10
1657728860362,MATH 10A,A03,083737,Patchell; Gregory David,16,0,30,14
1657728866388,MATH 10B,A01,083207,Lim; Seonhee,8,0,34,26
1657728866388,MATH 10B,A02,083208,Lim; Seonhee,9,0,35,26
1657728866388,MATH 10B,A03,093472,Lim; Seonhee,7,0,34,27
1657728866388,MATH 10B,B01,083739,Sinha; Shubham,13,0,30,17
1657728872414,MATH 18,A01,083743,Cinel; Cameron Alexander,9,0,30,21
1657728872414,MATH 18,A02,083744,Cinel; Cameron Alexander,17,0,30,13
1657728872414,MATH 18,A03,083745,Cinel; Cameron Alexander,10,0,30,20
1657728872414,MATH 18,B01,083748,Rideout; David Porter,5,0,37,32
1657728872414,MATH 18,B02,083749,Rideout; David Porter,5,0,36,31
1657728872414,MATH 18,B03,083750,Rideout; David Porter,3,0,37,34
1657728872414,MATH 18,B04,083751,Rideout; David Porter,6,0,36,30
1657728872414,MATH 18,B05,093473,Rideout; David Porter,6,0,36,30
1657728872414,MATH 18,B06,093474,Rideout; David Porter,6,0,36,30
1657728878446,MATH 20A,A01,083754,Zheng; Zequn,14,0,40,26
1657728884470,MATH 20B,A01,083756,Briones; Jor-el Thomas Caparas,4,0,36,32
1657728884470,MATH 20B,A02,083757,Briones; Jor-el Thomas Caparas,1,0,36,35
1657728884470,MATH 20B,A03,093475,Briones; Jor-el Thomas Caparas,2,0,36,34
1657728890505,MATH 20C,A01,083760,Briones; Jor-el Thomas Caparas,1,0,35,34
1657728890505,MATH 20C,A02,083761,Briones; Jor-el Thomas Caparas,8,0,35,27
1657728890505,MATH 20C,A03,093476,Briones; Jor-el Thomas Caparas,0,1,36,36
1657728890505,MATH 20C,B01,083762,Bach; Quang Tran,1,0,30,29
1657728896528,MATH 20D,A01,083765,Tran; Brian Kha,5,0,30,25
1657728896528,MATH 20D,A02,083766,Tran; Brian Kha,5,0,30,25
1657728896528,MATH 20D,A03,083767,Tran; Brian Kha,5,0,30,25
1657728902561,MATH 20E,A01,083771,Ganguly; Soumya,9,0,32,23
1657728902561,MATH 20E,A02,083772,Ganguly; Soumya,6,0,32,26
1657728902561,MATH 20E,B01,083773,Ciotti; Benjamin,20,0,35,15
1657728902561,MATH 20E,B02,083774,Ciotti; Benjamin,18,0,35,17
1657728908590,MATH 103A,A01,083777,Greenfeld; Be'Eri,3,0,36,33
1657728908590,MATH 103A,A02,083778,Greenfeld; Be'Eri,5,0,36,31
1657728908590,MATH 103A,A03,093561,Greenfeld; Be'Eri,6,0,36,30
1657728908590,MATH 103A,B01,083779,Greenfeld; Be'Eri,7,0,36,29
1657728908590,MATH 103A,B02,083780,Greenfeld; Be'Eri,4,0,36,32
1657728908590,MATH 103A,B03,093562,Greenfeld; Be'Eri,3,0,36,33
1657728914624,MATH 105,A01,085443,Carter; Anne Toulson,15,0,35,20
1657728914624,MATH 105,A02,093477,Carter; Anne Toulson,20,0,35,15
1657728920652,MATH 109,A01,083213,Ganzberger; Geoffrey Michael,2,0,34,32
1657728920652,MATH 109,A02,083214,Ganzberger; Geoffrey Michael,4,0,34,30
1657728920652,MATH 109,A03,093478,Ganzberger; Geoffrey Michael,2,0,34,32
1657728920652,MATH 109,B01,083215,Ganzberger; Geoffrey Michael,1,0,32,31
1657728920652,MATH 109,B02,083216,Ganzberger; Geoffrey Michael,2,0,32,30
1657728920652,MATH 109,B03,093479,Ganzberger; Geoffrey Michael,8,0,32,24
1657728926680,MATH 142A,A01,083219,Chow; Bennett,7,0,32,25
1657728926680,MATH 142A,A02,083220,Chow; Bennett,10,0,32,22
1657728926680,MATH 142A,A03,093480,Chow; Bennett,9,0,32,23
1657728926680,MATH 142A,B03,093481,Chow; Bennett,8,0,32,24
1657728926680,MATH 142A,B04,093558,Chow; Bennett,13,0,32,19
1657728926680,MATH 142A,B05,093559,Chow; Bennett,6,0,32,26
1657728932703,MATH 193A,A01,083224,Rotar; Vladimir,8,0,34,26
1657728932703,MATH 193A,A02,083225,Rotar; Vladimir,9,0,34,25
1657728932703,MATH 193A,A03,083781,Rotar; Vladimir,5,0,34,29
1657728932703,MATH 193A,A04,083782,Rotar; Vladimir,10,0,34,24
1657728932703,MATH 193A,A05,093482,Rotar; Vladimir,10,0,34,24
1657728938728,MATH 197,001,091859,McAuley; Julian John,9999,0,9999,0
1657728938728,MATH 197,002,095566,Kedlaya; Kiran S.,9997,0,9999,2
1657728938728,MATH 197,003,095567,Xiao; Ming,9999,0,9999,0
1657728938728,MATH 197,004,095571,Perols; Johan Lars,9998,0,9999,1
1657728945782,COGS 9,A01,083615,Shannon; Kyle Michael,9,0,75,66
1657728951808,COGS 11,A01,083617,Boyle; Mary E. T.,23,0,48,25
1657728957837,COGS 13,A01,083071,Bastos; Amalia Pinkusfeld,11,0,71,60
1657728963862,COGS 14A,A01,092681,Semenuks; Arturs,5,1,100,95
1657728969894,COGS 14B,A01,083073,Cheng; Tzu-Han,6,0,63,57
1657728975917,COGS 17,A01,092677,Semenuks; Arturs,6,0,81,75
1657728981941,COGS 100,A01,083619,Allen; Michael Gordon,17,0,70,53
1657728987962,COGS 101A,A01,083621,Davis; Joshua Daniel,9,0,68,59
1657728993985,COGS 101B,A01,091572,Allen; Michael Gordon,12,0,65,53
1657729000018,COGS 101C,A01,083625,Delgado; Tania,17,0,35,18
1657729006045,COGS 107A,A01,083627,Boyle; Mary E. T.,13,0,60,47
1657729012069,COGS 118A,A01,083075,Gupta; Anjum,21,0,76,55
1657729018092,CSE 3,A50,083646,Miranda; Gregory Joseph,24,0,50,26
1657729024120,CSE 8A,A50,083650,Miranda; Gregory Joseph,17,1,56,39
1657729030142,CSE 11,A01,083080,Cao; Yingjun,6,15,40,34
1657729036166,CSE 12,A01,083652,Krause-Levy; Sophia Louisa,28,1,120,92
1657729042189,CSE 15L,A01,083654,Morris; Justin Loren,9,0,50,41
1657729042189,CSE 15L,A02,083655,Morris; Justin Loren,9,0,50,41
1657729048211,CSE 20,A01,083657,Tran; Khoa Dang,39,0,80,41
1657729054247,CSE 21,A01,095574,Bach; Quang Tran,22,0,48,26
1657729060280,CSE 30,A01,083084,Eldon; John,6,0,80,74
1657729060280,CSE 30,B01,095061,Bhaskar; Nishant,9,0,50,41
1657729066305,CSE 100,A01,083659,Cao; Yingjun,5,4,70,65
1657729072329,CSE 134B,A01,083661,Powell; Thomas Allan,23,0,100,77
1657729078356,CSE 140,A01,083663,Gungor; Onat,15,0,85,70
1657729084378,CSE 140L,A01,083088,Eldon; John,23,0,100,77
1657729090402,CSE 175,A01,083665,Kumar; Rakesh,3,0,25,22
1657729096435,CSE 190,A00,092507,Dubnov; Shlomo,8,0,20,12
1657729102462,ECE 45,A01,083139,Congero; Spencer William,6,0,75,69
1657729108484,ECE 65,A50,083695,Saad; Andrew S,12,0,30,18
1657729108484,ECE 65,A51,095125,Saad; Andrew S,24,0,26,2
1657729114508,ECE 109,A01,091882,Touri; Behrouz,20,0,70,50
1657729120534,ECE 180,A00,083140,Abi Samra; Nicholas Camill,1,0,30,29
1657729120534,ECE 180,B00,083141,Abi Samra; Nicholas Camill,0,0,30,30
1657729126575,MATH 10A,A01,083735,Patchell; Gregory David,2,0,30,28
1657729126575,MATH 10A,A02,083736,Patchell; Gregory David,20,0,30,10
1657729126575,MATH 10A,A03,083737,Patchell; Gregory David,16,0,30,14
1657729132602,MATH 10B,A01,083207,Lim; Seonhee,8,0,34,26
1657729132602,MATH 10B,A02,083208,Lim; Seonhee,9,0,35,26
1657729132602,MATH 10B,A03,093472,Lim; Seonhee,7,0,34,27
1657729132602,MATH 10B,B01,083739,Sinha; Shubham,13,0,30,17
1657729138626,MATH 18,A01,083743,Cinel; Cameron Alexander,9,0,30,21
1657729138626,MATH 18,A02,083744,Cinel; Cameron Alexander,17,0,30,13
1657729138626,MATH 18,A03,083745,Cinel; Cameron Alexander,10,0,30,20
1657729138626,MATH 18,B01,083748,Rideout; David Porter,5,0,37,32
1657729138626,MATH 18,B02,083749,Rideout; David Porter,5,0,36,31
1657729138626,MATH 18,B03,083750,Rideout; David Porter,3,0,37,34
1657729138626,MATH 18,B04,083751,Rideout; David Porter,6,0,36,30
1657729138626,MATH 18,B05,093473,Rideout; David Porter,6,0,36,30
1657729138626,MATH 18,B06,093474,Rideout; David Porter,6,0,36,30
1657729144650,MATH 20A,A01,083754,Zheng; Zequn,14,0,40,26
1657729150673,MATH 20B,A01,083756,Briones; Jor-el Thomas Caparas,4,0,36,32
1657729150673,MATH 20B,A02,083757,Briones; Jor-el Thomas Caparas,1,0,36,35
1657729150673,MATH 20B,A03,093475,Briones; Jor-el Thomas Caparas,2,0,36,34
1657729156696,MATH 20C,A01,083760,Briones; Jor-el Thomas Caparas,1,0,35,34
1657729156696,MATH 20C,A02,083761,Briones; Jor-el Thomas Caparas,8,0,35,27
1657729156696,MATH 20C,A03,093476,Briones; Jor-el Thomas Caparas,0,1,36,36
1657729156696,MATH 20C,B01,083762,Bach; Quang Tran,1,0,30,29
1657729162725,MATH 20D,A01,083765,Tran; Brian Kha,5,0,30,25
1657729162725,MATH 20D,A02,083766,Tran; Brian Kha,5,0,30,25
1657729162725,MATH 20D,A03,083767,Tran; Brian Kha,5,0,30,25
1657729168753,MATH 20E,A01,083771,Ganguly; Soumya,9,0,32,23
1657729168753,MATH 20E,A02,083772,Ganguly; Soumya,6,0,32,26
1657729168753,MATH 20E,B01,083773,Ciotti; Benjamin,20,0,35,15
1657729168753,MATH 20E,B02,083774,Ciotti; Benjamin,18,0,35,17
1657729174781,MATH 103A,A01,083777,Greenfeld; Be'Eri,3,0,36,33
1657729174781,MATH 103A,A02,083778,Greenfeld; Be'Eri,5,0,36,31
1657729174781,MATH 103A,A03,093561,Greenfeld; Be'Eri,6,0,36,30
1657729174781,MATH 103A,B01,083779,Greenfeld; Be'Eri,7,0,36,29
1657729174781,MATH 103A,B02,083780,Greenfeld; Be'Eri,4,0,36,32
1657729174781,MATH 103A,B03,093562,Greenfeld; Be'Eri,3,0,36,33
1657729180823,MATH 105,A01,085443,Carter; Anne Toulson,15,0,35,20
1657729180823,MATH 105,A02,093477,Carter; Anne Toulson,20,0,35,15
1657729186852,MATH 109,A01,083213,Ganzberger; Geoffrey Michael,2,0,34,32
1657729186852,MATH 109,A02,083214,Ganzberger; Geoffrey Michael,4,0,34,30
1657729186852,MATH 109,A03,093478,Ganzberger; Geoffrey Michael,2,0,34,32
1657729186852,MATH 109,B01,083215,Ganzberger; Geoffrey Michael,1,0,32,31
1657729186852,MATH 109,B02,083216,Ganzberger; Geoffrey Michael,2,0,32,30
1657729186852,MATH 109,B03,093479,Ganzberger; Geoffrey Michael,8,0,32,24
1657729192876,MATH 142A,A01,083219,Chow; Bennett,7,0,32,25
1657729192876,MATH 142A,A02,083220,Chow; Bennett,10,0,32,22
1657729192876,MATH 142A,A03,093480,Chow; Bennett,9,0,32,23
1657729192876,MATH 142A,B03,093481,Chow; Bennett,8,0,32,24
1657729192876,MATH 142A,B04,093558,Chow; Bennett,13,0,32,19
1657729192876,MATH 142A,B05,093559,Chow; Bennett,6,0,32,26
1657729198903,MATH 193A,A01,083224,Rotar; Vladimir,8,0,34,26
1657729198903,MATH 193A,A02,083225,Rotar; Vladimir,9,0,34,25
1657729198903,MATH 193A,A03,083781,Rotar; Vladimir,5,0,34,29
1657729198903,MATH 193A,A04,083782,Rotar; Vladimir,10,0,34,24
1657729198903,MATH 193A,A05,093482,Rotar; Vladimir,10,0,34,24
1657729204927,MATH 197,001,091859,McAuley; Julian John,9999,0,9999,0
1657729204927,MATH 197,002,095566,Kedlaya; Kiran S.,9997,0,9999,2
1657729204927,MATH 197,003,095567,Xiao; Ming,9999,0,9999,0
1657729204927,MATH 197,004,095571,Perols; Johan Lars,9998,0,9999,1
1657729211994,COGS 9,A01,083615,Shannon; Kyle Michael,9,0,75,66
1657729218032,COGS 11,A01,083617,Boyle; Mary E. T.,23,0,48,25
1657729224067,COGS 13,A01,083071,Bastos; Amalia Pinkusfeld,11,0,71,60
1657729230090,COGS 14A,A01,092681,Semenuks; Arturs,5,1,100,95
1657729236114,COGS 14B,A01,083073,Cheng; Tzu-Han,6,0,63,57
1657729242137,COGS 17,A01,092677,Semenuks; Arturs,6,0,81,75
1657729248164,COGS 100,A01,083619,Allen; Michael Gordon,17,0,70,53
1657729254186,COGS 101A,A01,083621,Davis; Joshua Daniel,9,0,68,59
1657729260214,COGS 101B,A01,091572,Allen; Michael Gordon,12,0,65,53
1657729266250,COGS 101C,A01,083625,Delgado; Tania,17,0,35,18
1657729272277,COGS 107A,A01,083627,Boyle; Mary E. T.,13,0,60,47
1657729278313,COGS 118A,A01,083075,Gupta; Anjum,21,0,76,55
1657729284351,CSE 3,A50,083646,Miranda; Gregory Joseph,24,0,50,26
1657729290374,CSE 8A,A50,083650,Miranda; Gregory Joseph,17,1,56,39
1657729296411,CSE 11,A01,083080,Cao; Yingjun,6,15,40,34
1657729302440,CSE 12,A01,083652,Krause-Levy; Sophia Louisa,28,1,120,92
1657729308467,CSE 15L,A01,083654,Morris; Justin Loren,9,0,50,41
1657729308467,CSE 15L,A02,083655,Morris; Justin Loren,9,0,50,41
1657729314489,CSE 20,A01,083657,Tran; Khoa Dang,39,0,80,41
1657729320519,CSE 21,A01,095574,Bach; Quang Tran,22,0,48,26
1657729326543,CSE 30,A01,083084,Eldon; John,6,0,80,74
1657729326543,CSE 30,B01,095061,Bhaskar; Nishant,9,0,50,41
1657729332575,CSE 100,A01,083659,Cao; Yingjun,5,4,70,65
1657729338605,CSE 134B,A01,083661,Powell; Thomas Allan,23,0,100,77
1657729344700,CSE 140,A01,083663,Gungor; Onat,15,0,85,70
1657729350729,CSE 140L,A01,083088,Eldon; John,23,0,100,77
1657729356763,CSE 175,A01,083665,Kumar; Rakesh,3,0,25,22
1657729362786,CSE 190,A00,092507,Dubnov; Shlomo,8,0,20,12
1657729368811,ECE 45,A01,083139,Congero; Spencer William,6,0,75,69
1657729374841,ECE 65,A50,083695,Saad; Andrew S,12,0,30,18
1657729374841,ECE 65,A51,095125,Saad; Andrew S,24,0,26,2
1657729380867,ECE 109,A01,091882,Touri; Behrouz,20,0,70,50
1657729386890,ECE 180,A00,083140,Abi Samra; Nicholas Camill,1,0,30,29
1657729386890,ECE 180,B00,083141,Abi Samra; Nicholas Camill,0,0,30,30
1657729392919,MATH 10A,A01,083735,Patchell; Gregory David,2,0,30,28
1657729392919,MATH 10A,A02,083736,Patchell; Gregory David,20,0,30,10
1657729392919,MATH 10A,A03,083737,Patchell; Gregory David,16,0,30,14
1657729398944,MATH 10B,A01,083207,Lim; Seonhee,8,0,34,26
1657729398944,MATH 10B,A02,083208,Lim; Seonhee,9,0,35,26
1657729398944,MATH 10B,A03,093472,Lim; Seonhee,7,0,34,27
1657729398944,MATH 10B,B01,083739,Sinha; Shubham,13,0,30,17
1657729404974,MATH 18,A01,083743,Cinel; Cameron Alexander,9,0,30,21
1657729404974,MATH 18,A02,083744,Cinel; Cameron Alexander,17,0,30,13
1657729404974,MATH 18,A03,083745,Cinel; Cameron Alexander,10,0,30,20
1657729404974,MATH 18,B01,083748,Rideout; David Porter,5,0,37,32
1657729404974,MATH 18,B02,083749,Rideout; David Porter,5,0,36,31
1657729404974,MATH 18,B03,083750,Rideout; David Porter,3,0,37,34
1657729404974,MATH 18,B04,083751,Rideout; David Porter,6,0,36,30
1657729404974,MATH 18,B05,093473,Rideout; David Porter,6,0,36,30
1657729404974,MATH 18,B06,093474,Rideout; David Porter,6,0,36,30
1657729411000,MATH 20A,A01,083754,Zheng; Zequn,14,0,40,26
1657729417025,MATH 20B,A01,083756,Briones; Jor-el Thomas Caparas,4,0,36,32
1657729417025,MATH 20B,A02,083757,Briones; Jor-el Thomas Caparas,1,0,36,35
1657729417025,MATH 20B,A03,093475,Briones; Jor-el Thomas Caparas,2,0,36,34
1657729423047,MATH 20C,A01,083760,Briones; Jor-el Thomas Caparas,1,0,35,34
1657729423047,MATH 20C,A02,083761,Briones; Jor-el Thomas Caparas,8,0,35,27
1657729423047,MATH 20C,A03,093476,Briones; Jor-el Thomas Caparas,0,1,36,36
1657729423047,MATH 20C,B01,083762,Bach; Quang Tran,1,0,30,29
1657729429072,MATH 20D,A01,083765,Tran; Brian Kha,5,0,30,25
1657729429072,MATH 20D,A02,083766,Tran; Brian Kha,5,0,30,25
1657729429072,MATH 20D,A03,083767,Tran; Brian Kha,5,0,30,25
1657729435094,MATH 20E,A01,083771,Ganguly; Soumya,9,0,32,23
1657729435094,MATH 20E,A02,083772,Ganguly; Soumya,6,0,32,26
1657729435094,MATH 20E,B01,083773,Ciotti; Benjamin,20,0,35,15
1657729435094,MATH 20E,B02,083774,Ciotti; Benjamin,18,0,35,17
1657729441119,MATH 103A,A01,083777,Greenfeld; Be'Eri,3,0,36,33
1657729441119,MATH 103A,A02,083778,Greenfeld; Be'Eri,5,0,36,31
1657729441119,MATH 103A,A03,093561,Greenfeld; Be'Eri,6,0,36,30
1657729441119,MATH 103A,B01,083779,Greenfeld; Be'Eri,7,0,36,29
1657729441119,MATH 103A,B02,083780,Greenfeld; Be'Eri,4,0,36,32
1657729441119,MATH 103A,B03,093562,Greenfeld; Be'Eri,3,0,36,33
1657729447146,MATH 105,A01,085443,Carter; Anne Toulson,15,0,35,20
1657729447146,MATH 105,A02,093477,Carter; Anne Toulson,20,0,35,15
1657729453170,MATH 109,A01,083213,Ganzberger; Geoffrey Michael,2,0,34,32
1657729453170,MATH 109,A02,083214,Ganzberger; Geoffrey Michael,4,0,34,30
1657729453170,MATH 109,A03,093478,Ganzberger; Geoffrey Michael,2,0,34,32
1657729453170,MATH 109,B01,083215,Ganzberger; Geoffrey Michael,1,0,32,31
1657729453170,MATH 109,B02,083216,Ganzberger; Geoffrey Michael,2,0,32,30
1657729453170,MATH 109,B03,093479,Ganzberger; Geoffrey Michael,8,0,32,24
1657729459201,MATH 142A,A01,083219,Chow; Bennett,7,0,32,25
1657729459201,MATH 142A,A02,083220,Chow; Bennett,10,0,32,22
1657729459201,MATH 142A,A03,093480,Chow; Bennett,9,0,32,23
1657729459201,MATH 142A,B03,093481,Chow; Bennett,8,0,32,24
1657729459201,MATH 142A,B04,093558,Chow; Bennett,13,0,32,19
1657729459201,MATH 142A,B05,093559,Chow; Bennett,6,0,32,26
1657729465225,MATH 193A,A01,083224,Rotar; Vladimir,8,0,34,26
1657729465225,MATH 193A,A02,083225,Rotar; Vladimir,9,0,34,25
1657729465225,MATH 193A,A03,083781,Rotar; Vladimir,5,0,34,29
1657729465225,MATH 193A,A04,083782,Rotar; Vladimir,10,0,34,24
1657729465225,MATH 193A,A05,093482,Rotar; Vladimir,10,0,34,24
1657729471252,MATH 197,001,091859,McAuley; Julian John,9999,0,9999,0
1657729471252,MATH 197,002,095566,Kedlaya; Kiran S.,9997,0,9999,2
1657729471252,MATH 197,003,095567,Xiao; Ming,9999,0,9999,0
1657729471252,MATH 197,004,095571,Perols; Johan Lars,9998,0,9999,1
1657729478319,COGS 9,A01,083615,Shannon; Kyle Michael,9,0,75,66
1657729484342,COGS 11,A01,083617,Boyle; Mary E. T.,23,0,48,25
1657729490365,COGS 13,A01,083071,Bastos; Amalia Pinkusfeld,11,0,71,60
1657729496392,COGS 14A,A01,092681,Semenuks; Arturs,5,1,100,95
1657729502427,COGS 14B,A01,083073,Cheng; Tzu-Han,6,0,63,57
1657729508449,COGS 17,A01,092677,Semenuks; Arturs,6,0,81,75
1657729514473,COGS 100,A01,083619,Allen; Michael Gordon,17,0,70,53
1657729520496,COGS 101A,A01,083621,Davis; Joshua Daniel,9,0,68,59
1657729526522,COGS 101B,A01,091572,Allen; Michael Gordon,12,0,65,53
1657729532549,COGS 101C,A01,083625,Delgado; Tania,17,0,35,18
1657729538580,COGS 107A,A01,083627,Boyle; Mary E. T.,13,0,60,47
1657729544604,COGS 118A,A01,083075,Gupta; Anjum,21,0,76,55
1657729550630,CSE 3,A50,083646,Miranda; Gregory Joseph,24,0,50,26
1657729556660,CSE 8A,A50,083650,Miranda; Gregory Joseph,17,1,56,39
1657729562688,CSE 11,A01,083080,Cao; Yingjun,6,15,40,34
1657729568712,CSE 12,A01,083652,Krause-Levy; Sophia Louisa,28,1,120,92
1657729574743,CSE 15L,A01,083654,Morris; Justin Loren,9,0,50,41
1657729574743,CSE 15L,A02,083655,Morris; Justin Loren,9,0,50,41
1657729580777,CSE 20,A01,083657,Tran; Khoa Dang,39,0,80,41
1657729586800,CSE 21,A01,095574,Bach; Quang Tran,22,0,48,26
1657729592829,CSE 30,A01,083084,Eldon; John,6,0,80,74
1657729592829,CSE 30,B01,095061,Bhaskar; Nishant,9,0,50,41
1657729598851,CSE 100,A01,083659,Cao; Yingjun,5,4,70,65
1657729604873,CSE 134B,A01,083661,Powell; Thomas Allan,23,0,100,77
1657729610907,CSE 140,A01,083663,Gungor; Onat,15,0,85,70
1657729616940,CSE 140L,A01,083088,Eldon; John,23,0,100,77
1657729622969,CSE 175,A01,083665,Kumar; Rakesh,3,0,25,22
1657729628996,CSE 190,A00,092507,Dubnov; Shlomo,8,0,20,12
1657729635018,ECE 45,A01,083139,Congero; Spencer William,6,0,75,69
1657729641047,ECE 65,A50,083695,Saad; Andrew S,12,0,30,18
1657729641047,ECE 65,A51,095125,Saad; Andrew S,24,0,26,2
1657729647070,ECE 109,A01,091882,Touri; Behrouz,20,0,70,50
1657729653119,ECE 180,A00,083140,Abi Samra; Nicholas Camill,1,0,30,29
1657729653119,ECE 180,B00,083141,Abi Samra; Nicholas Camill,0,0,30,30
1657729659145,MATH 10A,A01,083735,Patchell; Gregory David,2,0,30,28
1657729659145,MATH 10A,A02,083736,Patchell; Gregory David,20,0,30,10
1657729659145,MATH 10A,A03,083737,Patchell; Gregory David,16,0,30,14
1657729665170,MATH 10B,A01,083207,Lim; Seonhee,8,0,34,26
1657729665170,MATH 10B,A02,083208,Lim; Seonhee,9,0,35,26
1657729665170,MATH 10B,A03,093472,Lim; Seonhee,7,0,34,27
1657729665170,MATH 10B,B01,083739,Sinha; Shubham,13,0,30,17
1657729671202,MATH 18,A01,083743,Cinel; Cameron Alexander,9,0,30,21
1657729671202,MATH 18,A02,083744,Cinel; Cameron Alexander,17,0,30,13
1657729671202,MATH 18,A03,083745,Cinel; Cameron Alexander,10,0,30,20
1657729671202,MATH 18,B01,083748,Rideout; David Porter,5,0,37,32
1657729671202,MATH 18,B02,083749,Rideout; David Porter,5,0,36,31
1657729671202,MATH 18,B03,083750,Rideout; David Porter,3,0,37,34
1657729671202,MATH 18,B04,083751,Rideout; David Porter,6,0,36,30
1657729671202,MATH 18,B05,093473,Rideout; David Porter,6,0,36,30
1657729671202,MATH 18,B06,093474,Rideout; David Porter,6,0,36,30
1657729677226,MATH 20A,A01,083754,Zheng; Zequn,14,0,40,26
1657729683254,MATH 20B,A01,083756,Briones; Jor-el Thomas Caparas,4,0,36,32
1657729683254,MATH 20B,A02,083757,Briones; Jor-el Thomas Caparas,1,0,36,35
1657729683254,MATH 20B,A03,093475,Briones; Jor-el Thomas Caparas,2,0,36,34
1657729689281,MATH 20C,A01,083760,Briones; Jor-el Thomas Caparas,1,0,35,34
1657729689281,MATH 20C,A02,083761,Briones; Jor-el Thomas Caparas,8,0,35,27
1657729689281,MATH 20C,A03,093476,Briones; Jor-el Thomas Caparas,0,1,36,36
1657729689281,MATH 20C,B01,083762,Bach; Quang Tran,1,0,30,29
1657729695305,MATH 20D,A01,083765,Tran; Brian Kha,5,0,30,25
1657729695305,MATH 20D,A02,083766,Tran; Brian Kha,5,0,30,25
1657729695305,MATH 20D,A03,083767,Tran; Brian Kha,5,0,30,25
1657729701338,MATH 20E,A01,083771,Ganguly; Soumya,9,0,32,23
1657729701338,MATH 20E,A02,083772,Ganguly; Soumya,6,0,32,26
1657729701338,MATH 20E,B01,083773,Ciotti; Benjamin,20,0,35,15
1657729701338,MATH 20E,B02,083774,Ciotti; Benjamin,18,0,35,17
1657729707368,MATH 103A,A01,083777,Greenfeld; Be'Eri,3,0,36,33
1657729707368,MATH 103A,A02,083778,Greenfeld; Be'Eri,5,0,36,31
1657729707368,MATH 103A,A03,093561,Greenfeld; Be'Eri,6,0,36,30
1657729707368,MATH 103A,B01,083779,Greenfeld; Be'Eri,7,0,36,29
1657729707368,MATH 103A,B02,083780,Greenfeld; Be'Eri,4,0,36,32
1657729707368,MATH 103A,B03,093562,Greenfeld; Be'Eri,3,0,36,33
1657729713392,MATH 105,A01,085443,Carter; Anne Toulson,15,0,35,20
1657729713392,MATH 105,A02,093477,Carter; Anne Toulson,20,0,35,15
1657729719416,MATH 109,A01,083213,Ganzberger; Geoffrey Michael,2,0,34,32
1657729719416,MATH 109,A02,083214,Ganzberger; Geoffrey Michael,4,0,34,30
1657729719416,MATH 109,A03,093478,Ganzberger; Geoffrey Michael,2,0,34,32
1657729719416,MATH 109,B01,083215,Ganzberger; Geoffrey Michael,1,0,32,31
1657729719416,MATH 109,B02,083216,Ganzberger; Geoffrey Michael,2,0,32,30
1657729719416,MATH 109,B03,093479,Ganzberger; Geoffrey Michael,8,0,32,24
1657729725445,MATH 142A,A01,083219,Chow; Bennett,7,0,32,25
1657729725445,MATH 142A,A02,083220,Chow; Bennett,10,0,32,22
1657729725445,MATH 142A,A03,093480,Chow; Bennett,9,0,32,23
1657729725445,MATH 142A,B03,093481,Chow; Bennett,8,0,32,24
1657729725445,MATH 142A,B04,093558,Chow; Bennett,13,0,32,19
1657729725445,MATH 142A,B05,093559,Chow; Bennett,6,0,32,26
1657729731468,MATH 193A,A01,083224,Rotar; Vladimir,8,0,34,26
1657729731468,MATH 193A,A02,083225,Rotar; Vladimir,9,0,34,25
1657729731468,MATH 193A,A03,083781,Rotar; Vladimir,5,0,34,29
1657729731468,MATH 193A,A04,083782,Rotar; Vladimir,10,0,34,24
1657729731468,MATH 193A,A05,093482,Rotar; Vladimir,10,0,34,24
1657729737529,MATH 197,001,091859,McAuley; Julian John,9999,0,9999,0
1657729737529,MATH 197,002,095566,Kedlaya; Kiran S.,9997,0,9999,2
1657729737529,MATH 197,003,095567,Xiao; Ming,9999,0,9999,0
1657729737529,MATH 197,004,095571,Perols; Johan Lars,9998,0,9999,1
1657729744589,COGS 9,A01,083615,Shannon; Kyle Michael,9,0,75,66
1657729750612,COGS 11,A01,083617,Boyle; Mary E. T.,23,0,48,25
1657729756639,COGS 13,A01,083071,Bastos; Amalia Pinkusfeld,11,0,71,60
1657729762675,COGS 14A,A01,092681,Semenuks; Arturs,5,1,100,95
1657729768698,COGS 14B,A01,083073,Cheng; Tzu-Han,6,0,63,57
1657729774720,COGS 17,A01,092677,Semenuks; Arturs,6,0,81,75
1657729780747,COGS 100,A01,083619,Allen; Michael Gordon,17,0,70,53
1657729786775,COGS 101A,A01,083621,Davis; Joshua Daniel,9,0,68,59
1657729792797,COGS 101B,A01,091572,Allen; Michael Gordon,12,0,65,53
1657729798823,COGS 101C,A01,083625,Delgado; Tania,17,0,35,18
1657729804849,COGS 107A,A01,083627,Boyle; Mary E. T.,13,0,60,47
1657729810874,COGS 118A,A01,083075,Gupta; Anjum,21,0,76,55
1657729816896,CSE 3,A50,083646,Miranda; Gregory Joseph,24,0,50,26
1657729822921,CSE 8A,A50,083650,Miranda; Gregory Joseph,17,1,56,39
1657729828955,CSE 11,A01,083080,Cao; Yingjun,6,15,40,34
1657729834987,CSE 12,A01,083652,Krause-Levy; Sophia Louisa,28,1,120,92
1657729841010,CSE 15L,A01,083654,Morris; Justin Loren,9,0,50,41
1657729841010,CSE 15L,A02,083655,Morris; Justin Loren,9,0,50,41
1657729847038,CSE 20,A01,083657,Tran; Khoa Dang,39,0,80,41
1657729853065,CSE 21,A01,095574,Bach; Quang Tran,22,0,48,26
1657729859097,CSE 30,A01,083084,Eldon; John,6,0,80,74
1657729859097,CSE 30,B01,095061,Bhaskar; Nishant,9,0,50,41
1657729865119,CSE 100,A01,083659,Cao; Yingjun,5,4,70,65
1657729871147,CSE 134B,A01,083661,Powell; Thomas Allan,23,0,100,77
1657729877179,CSE 140,A01,083663,Gungor; Onat,15,0,85,70
1657729883202,CSE 140L,A01,083088,Eldon; John,23,0,100,77
1657729889228,CSE 175,A01,083665,Kumar; Rakesh,3,0,25,22
1657729895250,CSE 190,A00,092507,Dubnov; Shlomo,8,0,20,12
1657729901272,ECE 45,A01,083139,Congero; Spencer William,6,0,75,69
1657729907306,ECE 65,A50,083695,Saad; Andrew S,12,0,30,18
1657729907306,ECE 65,A51,095125,Saad; Andrew S,24,0,26,2
1657729913340,ECE 109,A01,091882,Touri; Behrouz,20,0,70,50
1657729919367,ECE 180,A00,083140,Abi Samra; Nicholas Camill,1,0,30,29
1657729919367,ECE 180,B00,083141,Abi Samra; Nicholas Camill,0,0,30,30
1657729925388,MATH 10A,A01,083735,Patchell; Gregory David,2,0,30,28
1657729925388,MATH 10A,A02,083736,Patchell; Gregory David,20,0,30,10
1657729925388,MATH 10A,A03,083737,Patchell; Gregory David,16,0,30,14
1657729931423,MATH 10B,A01,083207,Lim; Seonhee,8,0,34,26
1657729931423,MATH 10B,A02,083208,Lim; Seonhee,9,0,35,26
1657729931423,MATH 10B,A03,093472,Lim; Seonhee,7,0,34,27
1657729931423,MATH 10B,B01,083739,Sinha; Shubham,13,0,30,17
1657729937453,MATH 18,A01,083743,Cinel; Cameron Alexander,9,0,30,21
1657729937453,MATH 18,A02,083744,Cinel; Cameron Alexander,17,0,30,13
1657729937453,MATH 18,A03,083745,Cinel; Cameron Alexander,10,0,30,20
1657729937453,MATH 18,B01,083748,Rideout; David Porter,5,0,37,32
1657729937453,MATH 18,B02,083749,Rideout; David Porter,5,0,36,31
1657729937453,MATH 18,B03,083750,Rideout; David Porter,3,0,37,34
1657729937453,MATH 18,B04,083751,Rideout; David Porter,6,0,36,30
1657729937453,MATH 18,B05,093473,Rideout; David Porter,6,0,36,30
1657729937453,MATH 18,B06,093474,Rideout; David Porter,6,0,36,30
1657729943563,MATH 20A,A01,083754,Zheng; Zequn,14,0,40,26
1657729949589,MATH 20B,A01,083756,Briones; Jor-el Thomas Caparas,4,0,36,32
1657729949589,MATH 20B,A02,083757,Briones; Jor-el Thomas Caparas,1,0,36,35
1657729949589,MATH 20B,A03,093475,Briones; Jor-el Thomas Caparas,2,0,36,34
1657729955613,MATH 20C,A01,083760,Briones; Jor-el Thomas Caparas,1,0,35,34
1657729955613,MATH 20C,A02,083761,Briones; Jor-el Thomas Caparas,8,0,35,27
1657729955613,MATH 20C,A03,093476,Briones; Jor-el Thomas Caparas,0,1,36,36
1657729955613,MATH 20C,B01,083762,Bach; Quang Tran,1,0,30,29
1657729961636,MATH 20D,A01,083765,Tran; Brian Kha,5,0,30,25
1657729961636,MATH 20D,A02,083766,Tran; Brian Kha,5,0,30,25
1657729961636,MATH 20D,A03,083767,Tran; Brian Kha,5,0,30,25
1657729967674,MATH 20E,A01,083771,Ganguly; Soumya,9,0,32,23
1657729967674,MATH 20E,A02,083772,Ganguly; Soumya,6,0,32,26
1657729967674,MATH 20E,B01,083773,Ciotti; Benjamin,20,0,35,15
1657729967674,MATH 20E,B02,083774,Ciotti; Benjamin,18,0,35,17
1657729973697,MATH 103A,A01,083777,Greenfeld; Be'Eri,3,0,36,33
1657729973697,MATH 103A,A02,083778,Greenfeld; Be'Eri,5,0,36,31
1657729973697,MATH 103A,A03,093561,Greenfeld; Be'Eri,6,0,36,30
1657729973697,MATH 103A,B01,083779,Greenfeld; Be'Eri,7,0,36,29
1657729973697,MATH 103A,B02,083780,Greenfeld; Be'Eri,4,0,36,32
1657729973697,MATH 103A,B03,093562,Greenfeld; Be'Eri,3,0,36,33
1657729979720,MATH 105,A01,085443,Carter; Anne Toulson,15,0,35,20
1657729979720,MATH 105,A02,093477,Carter; Anne Toulson,20,0,35,15
1657729985743,MATH 109,A01,083213,Ganzberger; Geoffrey Michael,2,0,34,32
1657729985743,MATH 109,A02,083214,Ganzberger; Geoffrey Michael,4,0,34,30
1657729985743,MATH 109,A03,093478,Ganzberger; Geoffrey Michael,2,0,34,32
1657729985743,MATH 109,B01,083215,Ganzberger; Geoffrey Michael,1,0,32,31
1657729985743,MATH 109,B02,083216,Ganzberger; Geoffrey Michael,2,0,32,30
1657729985743,MATH 109,B03,093479,Ganzberger; Geoffrey Michael,8,0,32,24
1657729991769,MATH 142A,A01,083219,Chow; Bennett,7,0,32,25
1657729991769,MATH 142A,A02,083220,Chow; Bennett,10,0,32,22
1657729991769,MATH 142A,A03,093480,Chow; Bennett,9,0,32,23
1657729991769,MATH 142A,B03,093481,Chow; Bennett,8,0,32,24
1657729991769,MATH 142A,B04,093558,Chow; Bennett,13,0,32,19
1657729991769,MATH 142A,B05,093559,Chow; Bennett,6,0,32,26
1657729997794,MATH 193A,A01,083224,Rotar; Vladimir,8,0,34,26
1657729997794,MATH 193A,A02,083225,Rotar; Vladimir,9,0,34,25
1657729997794,MATH 193A,A03,083781,Rotar; Vladimir,5,0,34,29
1657729997794,MATH 193A,A04,083782,Rotar; Vladimir,10,0,34,24
1657729997794,MATH 193A,A05,093482,Rotar; Vladimir,10,0,34,24
1657730003817,MATH 197,001,091859,McAuley; Julian John,9999,0,9999,0
1657730003817,MATH 197,002,095566,Kedlaya; Kiran S.,9997,0,9999,2
1657730003817,MATH 197,003,095567,Xiao; Ming,9999,0,9999,0
1657730003817,MATH 197,004,095571,Perols; Johan Lars,9998,0,9999,1
1657730010891,COGS 9,A01,083615,Shannon; Kyle Michael,9,0,75,66
1657730016914,COGS 11,A01,083617,Boyle; Mary E. T.,23,0,48,25
1657730023022,COGS 13,A01,083071,Bastos; Amalia Pinkusfeld,11,0,71,60
1657730029054,COGS 14A,A01,092681,Semenuks; Arturs,5,1,100,95
1657730035078,COGS 14B,A01,083073,Cheng; Tzu-Han,6,0,63,57
1657730041101,COGS 17,A01,092677,Semenuks; Arturs,6,0,81,75
1657730047142,COGS 100,A01,083619,Allen; Michael Gordon,17,0,70,53
1657730053165,COGS 101A,A01,083621,Davis; Joshua Daniel,9,0,68,59
1657730059186,COGS 101B,A01,091572,Allen; Michael Gordon,12,0,65,53
1657730065214,COGS 101C,A01,083625,Delgado; Tania,17,0,35,18
1657730071240,COGS 107A,A01,083627,Boyle; Mary E. T.,13,0,60,47
1657730077262,COGS 118A,A01,083075,Gupta; Anjum,21,0,76,55
1657730083289,CSE 3,A50,083646,Miranda; Gregory Joseph,24,0,50,26
1657730089317,CSE 8A,A50,083650,Miranda; Gregory Joseph,17,1,56,39
1657730095341,CSE 11,A01,083080,Cao; Yingjun,6,15,40,34
1657730101365,CSE 12,A01,083652,Krause-Levy; Sophia Louisa,28,1,120,92
1657730107388,CSE 15L,A01,083654,Morris; Justin Loren,9,0,50,41
1657730107388,CSE 15L,A02,083655,Morris; Justin Loren,9,0,50,41
1657730113414,CSE 20,A01,083657,Tran; Khoa Dang,39,0,80,41
1657730119437,CSE 21,A01,095574,Bach; Quang Tran,22,0,48,26
1657730125461,CSE 30,A01,083084,Eldon; John,6,0,80,74
1657730125461,CSE 30,B01,095061,Bhaskar; Nishant,9,0,50,41
1657730131486,CSE 100,A01,083659,Cao; Yingjun,5,4,70,65
1657730137512,CSE 134B,A01,083661,Powell; Thomas Allan,23,0,100,77
1657730143538,CSE 140,A01,083663,Gungor; Onat,15,0,85,70
1657730149560,CSE 140L,A01,083088,Eldon; John,23,0,100,77
1657730155591,CSE 175,A01,083665,Kumar; Rakesh,3,0,25,22
1657730161618,CSE 190,A00,092507,Dubnov; Shlomo,8,0,20,12
1657730167640,ECE 45,A01,083139,Congero; Spencer William,6,0,75,69
1657730173664,ECE 65,A50,083695,Saad; Andrew S,12,0,30,18
1657730173664,ECE 65,A51,095125,Saad; Andrew S,24,0,26,2
1657730179689,ECE 109,A01,091882,Touri; Behrouz,20,0,70,50
1657730185712,ECE 180,A00,083140,Abi Samra; Nicholas Camill,1,0,30,29
1657730185712,ECE 180,B00,083141,Abi Samra; Nicholas Camill,0,0,30,30
1657730191738,MATH 10A,A01,083735,Patchell; Gregory David,2,0,30,28
1657730191738,MATH 10A,A02,083736,Patchell; Gregory David,20,0,30,10
1657730191738,MATH 10A,A03,083737,Patchell; Gregory David,16,0,30,14
1657730197768,MATH 10B,A01,083207,Lim; Seonhee,8,0,34,26
1657730197768,MATH 10B,A02,083208,Lim; Seonhee,9,0,35,26
1657730197768,MATH 10B,A03,093472,Lim; Seonhee,7,0,34,27
1657730197768,MATH 10B,B01,083739,Sinha; Shubham,13,0,30,17
1657730203798,MATH 18,A01,083743,Cinel; Cameron Alexander,9,0,30,21
1657730203798,MATH 18,A02,083744,Cinel; Cameron Alexander,17,0,30,13
1657730203798,MATH 18,A03,083745,Cinel; Cameron Alexander,10,0,30,20
1657730203798,MATH 18,B01,083748,Rideout; David Porter,5,0,37,32
1657730203798,MATH 18,B02,083749,Rideout; David Porter,5,0,36,31
1657730203798,MATH 18,B03,083750,Rideout; David Porter,3,0,37,34
1657730203798,MATH 18,B04,083751,Rideout; David Porter,6,0,36,30
1657730203798,MATH 18,B05,093473,Rideout; David Porter,6,0,36,30
1657730203798,MATH 18,B06,093474,Rideout; David Porter,6,0,36,30
1657730209821,MATH 20A,A01,083754,Zheng; Zequn,14,0,40,26
1657730215843,MATH 20B,A01,083756,Briones; Jor-el Thomas Caparas,4,0,36,32
1657730215843,MATH 20B,A02,083757,Briones; Jor-el Thomas Caparas,1,0,36,35
1657730215843,MATH 20B,A03,093475,Briones; Jor-el Thomas Caparas,2,0,36,34
1657730221871,MATH 20C,A01,083760,Briones; Jor-el Thomas Caparas,1,0,35,34
1657730221871,MATH 20C,A02,083761,Briones; Jor-el Thomas Caparas,8,0,35,27
1657730221871,MATH 20C,A03,093476,Briones; Jor-el Thomas Caparas,0,1,36,36
1657730221871,MATH 20C,B01,083762,Bach; Quang Tran,1,0,30,29
1657730227899,MATH 20D,A01,083765,Tran; Brian Kha,5,0,30,25
1657730227899,MATH 20D,A02,083766,Tran; Brian Kha,5,0,30,25
1657730227899,MATH 20D,A03,083767,Tran; Brian Kha,5,0,30,25
1657730233923,MATH 20E,A01,083771,Ganguly; Soumya,9,0,32,23
1657730233923,MATH 20E,A02,083772,Ganguly; Soumya,6,0,32,26
1657730233923,MATH 20E,B01,083773,Ciotti; Benjamin,20,0,35,15
1657730233923,MATH 20E,B02,083774,Ciotti; Benjamin,18,0,35,17
1657730239946,MATH 103A,A01,083777,Greenfeld; Be'Eri,3,0,36,33
1657730239946,MATH 103A,A02,083778,Greenfeld; Be'Eri,5,0,36,31
1657730239946,MATH 103A,A03,093561,Greenfeld; Be'Eri,6,0,36,30
1657730239946,MATH 103A,B01,083779,Greenfeld; Be'Eri,7,0,36,29
1657730239946,MATH 103A,B02,083780,Greenfeld; Be'Eri,4,0,36,32
1657730239946,MATH 103A,B03,093562,Greenfeld; Be'Eri,3,0,36,33
1657730245968,MATH 105,A01,085443,Carter; Anne Toulson,15,0,35,20
1657730245968,MATH 105,A02,093477,Carter; Anne Toulson,20,0,35,15
1657730252004,MATH 109,A01,083213,Ganzberger; Geoffrey Michael,2,0,34,32
1657730252004,MATH 109,A02,083214,Ganzberger; Geoffrey Michael,4,0,34,30
1657730252004,MATH 109,A03,093478,Ganzberger; Geoffrey Michael,2,0,34,32
1657730252004,MATH 109,B01,083215,Ganzberger; Geoffrey Michael,1,0,32,31
1657730252004,MATH 109,B02,083216,Ganzberger; Geoffrey Michael,2,0,32,30
1657730252004,MATH 109,B03,093479,Ganzberger; Geoffrey Michael,8,0,32,24
1657730258028,MATH 142A,A01,083219,Chow; Bennett,7,0,32,25
1657730258028,MATH 142A,A02,083220,Chow; Bennett,10,0,32,22
1657730258028,MATH 142A,A03,093480,Chow; Bennett,9,0,32,23
1657730258028,MATH 142A,B03,093481,Chow; Bennett,8,0,32,24
1657730258028,MATH 142A,B04,093558,Chow; Bennett,13,0,32,19
1657730258028,MATH 142A,B05,093559,Chow; Bennett,6,0,32,26
1657730264057,MATH 193A,A01,083224,Rotar; Vladimir,8,0,34,26
1657730264057,MATH 193A,A02,083225,Rotar; Vladimir,9,0,34,25
1657730264057,MATH 193A,A03,083781,Rotar; Vladimir,5,0,34,29
1657730264057,MATH 193A,A04,083782,Rotar; Vladimir,10,0,34,24
1657730264057,MATH 193A,A05,093482,Rotar; Vladimir,10,0,34,24
1657730270083,MATH 197,001,091859,McAuley; Julian John,9999,0,9999,0
1657730270083,MATH 197,002,095566,Kedlaya; Kiran S.,9997,0,9999,2
1657730270083,MATH 197,003,095567,Xiao; Ming,9999,0,9999,0
1657730270083,MATH 197,004,095571,Perols; Johan Lars,9998,0,9999,1
1657730277159,COGS 9,A01,083615,Shannon; Kyle Michael,9,0,75,66
1657730283181,COGS 11,A01,083617,Boyle; Mary E. T.,23,0,48,25
1657730289207,COGS 13,A01,083071,Bastos; Amalia Pinkusfeld,11,0,71,60
1657730295233,COGS 14A,A01,092681,Semenuks; Arturs,5,1,100,95
1657730301259,COGS 14B,A01,083073,Cheng; Tzu-Han,6,0,63,57
1657730307282,COGS 17,A01,092677,Semenuks; Arturs,6,0,81,75
1657730313309,COGS 100,A01,083619,Allen; Michael Gordon,17,0,70,53
1657730319332,COGS 101A,A01,083621,Davis; Joshua Daniel,9,0,68,59
1657730325355,COGS 101B,A01,091572,Allen; Michael Gordon,12,0,65,53
1657730331381,COGS 101C,A01,083625,Delgado; Tania,17,0,35,18
1657730337417,COGS 107A,A01,083627,Boyle; Mary E. T.,13,0,60,47
1657730343444,COGS 118A,A01,083075,Gupta; Anjum,21,0,76,55
1657730349467,CSE 3,A50,083646,Miranda; Gregory Joseph,24,0,50,26
1657730355494,CSE 8A,A50,083650,Miranda; Gregory Joseph,17,1,56,39
1657730361525,CSE 11,A01,083080,Cao; Yingjun,6,15,40,34
1657730367568,CSE 12,A01,083652,Krause-Levy; Sophia Louisa,28,1,120,92
1657730373591,CSE 15L,A01,083654,Morris; Justin Loren,9,0,50,41
1657730373591,CSE 15L,A02,083655,Morris; Justin Loren,9,0,50,41
1657730379613,CSE 20,A01,083657,Tran; Khoa Dang,39,0,80,41
1657730385640,CSE 21,A01,095574,Bach; Quang Tran,22,0,48,26
1657730391674,CSE 30,A01,083084,Eldon; John,6,0,80,74
1657730391674,CSE 30,B01,095061,Bhaskar; Nishant,9,0,50,41
1657730397702,CSE 100,A01,083659,Cao; Yingjun,5,4,70,65
1657730403733,CSE 134B,A01,083661,Powell; Thomas Allan,23,0,100,77
1657730409756,CSE 140,A01,083663,Gungor; Onat,15,0,85,70
1657730415788,CSE 140L,A01,083088,Eldon; John,23,0,100,77
1657730421810,CSE 175,A01,083665,Kumar; Rakesh,3,0,25,22
1657730427837,CSE 190,A00,092507,Dubnov; Shlomo,8,0,20,12
1657730433859,ECE 45,A01,083139,Congero; Spencer William,6,0,75,69
1657730439897,ECE 65,A50,083695,Saad; Andrew S,12,0,30,18
1657730439897,ECE 65,A51,095125,Saad; Andrew S,24,0,26,2
1657730445927,ECE 109,A01,091882,Touri; Behrouz,20,0,70,50
1657730451949,ECE 180,A00,083140,Abi Samra; Nicholas Camill,1,0,30,29
1657730451949,ECE 180,B00,083141,Abi Samra; Nicholas Camill,0,0,30,30
1657730457990,MATH 10A,A01,083735,Patchell; Gregory David,2,0,30,28
1657730457990,MATH 10A,A02,083736,Patchell; Gregory David,20,0,30,10
1657730457990,MATH 10A,A03,083737,Patchell; Gregory David,16,0,30,14
1657730464014,MATH 10B,A01,083207,Lim; Seonhee,8,0,34,26
1657730464014,MATH 10B,A02,083208,Lim; Seonhee,9,0,35,26
1657730464014,MATH 10B,A03,093472,Lim; Seonhee,7,0,34,27
1657730464014,MATH 10B,B01,083739,Sinha; Shubham,13,0,30,17
1657730470045,MATH 18,A01,083743,Cinel; Cameron Alexander,9,0,30,21
1657730470045,MATH 18,A02,083744,Cinel; Cameron Alexander,17,0,30,13
1657730470045,MATH 18,A03,083745,Cinel; Cameron Alexander,10,0,30,20
1657730470045,MATH 18,B01,083748,Rideout; David Porter,5,0,37,32
1657730470045,MATH 18,B02,083749,Rideout; David Porter,5,0,36,31
1657730470045,MATH 18,B03,083750,Rideout; David Porter,3,0,37,34
1657730470045,MATH 18,B04,083751,Rideout; David Porter,6,0,36,30
1657730470045,MATH 18,B05,093473,Rideout; David Porter,6,0,36,30
1657730470045,MATH 18,B06,093474,Rideout; David Porter,6,0,36,30
1657730476070,MATH 20A,A01,083754,Zheng; Zequn,14,0,40,26
1657730482094,MATH 20B,A01,083756,Briones; Jor-el Thomas Caparas,4,0,36,32
1657730482094,MATH 20B,A02,083757,Briones; Jor-el Thomas Caparas,1,0,36,35
1657730482094,MATH 20B,A03,093475,Briones; Jor-el Thomas Caparas,2,0,36,34
1657730488122,MATH 20C,A01,083760,Briones; Jor-el Thomas Caparas,1,0,35,34
1657730488122,MATH 20C,A02,083761,Briones; Jor-el Thomas Caparas,8,0,35,27
1657730488122,MATH 20C,A03,093476,Briones; Jor-el Thomas Caparas,0,1,36,36
1657730488122,MATH 20C,B01,083762,Bach; Quang Tran,1,0,30,29
1657730494162,MATH 20D,A01,083765,Tran; Brian Kha,5,0,30,25
1657730494162,MATH 20D,A02,083766,Tran; Brian Kha,5,0,30,25
1657730494162,MATH 20D,A03,083767,Tran; Brian Kha,5,0,30,25
1657730500184,MATH 20E,A01,083771,Ganguly; Soumya,9,0,32,23
1657730500184,MATH 20E,A02,083772,Ganguly; Soumya,6,0,32,26
1657730500184,MATH 20E,B01,083773,Ciotti; Benjamin,20,0,35,15
1657730500184,MATH 20E,B02,083774,Ciotti; Benjamin,18,0,35,17
1657730506207,MATH 103A,A01,083777,Greenfeld; Be'Eri,3,0,36,33
1657730506207,MATH 103A,A02,083778,Greenfeld; Be'Eri,5,0,36,31
1657730506207,MATH 103A,A03,093561,Greenfeld; Be'Eri,6,0,36,30
1657730506207,MATH 103A,B01,083779,Greenfeld; Be'Eri,7,0,36,29
1657730506207,MATH 103A,B02,083780,Greenfeld; Be'Eri,4,0,36,32
1657730506207,MATH 103A,B03,093562,Greenfeld; Be'Eri,3,0,36,33
1657730512233,MATH 105,A01,085443,Carter; Anne Toulson,15,0,35,20
1657730512233,MATH 105,A02,093477,Carter; Anne Toulson,20,0,35,15
1657730518260,MATH 109,A01,083213,Ganzberger; Geoffrey Michael,2,0,34,32
1657730518260,MATH 109,A02,083214,Ganzberger; Geoffrey Michael,4,0,34,30
1657730518260,MATH 109,A03,093478,Ganzberger; Geoffrey Michael,2,0,34,32
1657730518260,MATH 109,B01,083215,Ganzberger; Geoffrey Michael,1,0,32,31
1657730518260,MATH 109,B02,083216,Ganzberger; Geoffrey Michael,2,0,32,30
1657730518260,MATH 109,B03,093479,Ganzberger; Geoffrey Michael,8,0,32,24
1657730524285,MATH 142A,A01,083219,Chow; Bennett,7,0,32,25
1657730524285,MATH 142A,A02,083220,Chow; Bennett,10,0,32,22
1657730524285,MATH 142A,A03,093480,Chow; Bennett,9,0,32,23
1657730524285,MATH 142A,B03,093481,Chow; Bennett,8,0,32,24
1657730524285,MATH 142A,B04,093558,Chow; Bennett,13,0,32,19
1657730524285,MATH 142A,B05,093559,Chow; Bennett,6,0,32,26
1657730530314,MATH 193A,A01,083224,Rotar; Vladimir,8,0,34,26
1657730530314,MATH 193A,A02,083225,Rotar; Vladimir,9,0,34,25
1657730530314,MATH 193A,A03,083781,Rotar; Vladimir,5,0,34,29
1657730530314,MATH 193A,A04,083782,Rotar; Vladimir,10,0,34,24
1657730530314,MATH 193A,A05,093482,Rotar; Vladimir,10,0,34,24
1657730536341,MATH 197,001,091859,McAuley; Julian John,9999,0,9999,0
1657730536341,MATH 197,002,095566,Kedlaya; Kiran S.,9997,0,9999,2
1657730536341,MATH 197,003,095567,Xiao; Ming,9999,0,9999,0
1657730536341,MATH 197,004,095571,Perols; Johan Lars,9998,0,9999,1
1657730543516,COGS 9,A01,083615,Shannon; Kyle Michael,9,0,75,66
1657730549542,COGS 11,A01,083617,Boyle; Mary E. T.,23,0,48,25
1657730555568,COGS 13,A01,083071,Bastos; Amalia Pinkusfeld,11,0,71,60
1657730561602,COGS 14A,A01,092681,Semenuks; Arturs,5,1,100,95
1657730567625,COGS 14B,A01,083073,Cheng; Tzu-Han,6,0,63,57
1657730573647,COGS 17,A01,092677,Semenuks; Arturs,6,0,81,75
1657730579671,COGS 100,A01,083619,Allen; Michael Gordon,17,0,70,53
1657730585699,COGS 101A,A01,083621,Davis; Joshua Daniel,9,0,68,59
1657730591723,COGS 101B,A01,091572,Allen; Michael Gordon,12,0,65,53
1657730597744,COGS 101C,A01,083625,Delgado; Tania,17,0,35,18
1657730603771,COGS 107A,A01,083627,Boyle; Mary E. T.,13,0,60,47
1657730609800,COGS 118A,A01,083075,Gupta; Anjum,21,0,76,55
1657730615827,CSE 3,A50,083646,Miranda; Gregory Joseph,24,0,50,26
1657730621853,CSE 8A,A50,083650,Miranda; Gregory Joseph,17,1,56,39
1657730627876,CSE 11,A01,083080,Cao; Yingjun,6,15,40,34
1657730633905,CSE 12,A01,083652,Krause-Levy; Sophia Louisa,28,1,120,92
1657730639928,CSE 15L,A01,083654,Morris; Justin Loren,9,0,50,41
1657730639928,CSE 15L,A02,083655,Morris; Justin Loren,9,0,50,41
1657730645962,CSE 20,A01,083657,Tran; Khoa Dang,39,0,80,41
1657730651987,CSE 21,A01,095574,Bach; Quang Tran,22,0,48,26
1657730658010,CSE 30,A01,083084,Eldon; John,6,0,80,74
1657730658010,CSE 30,B01,095061,Bhaskar; Nishant,9,0,50,41
1657730664033,CSE 100,A01,083659,Cao; Yingjun,5,4,70,65
1657730670057,CSE 134B,A01,083661,Powell; Thomas Allan,23,0,100,77
1657730676081,CSE 140,A01,083663,Gungor; Onat,15,0,85,70
1657730682103,CSE 140L,A01,083088,Eldon; John,23,0,100,77
1657730688132,CSE 175,A01,083665,Kumar; Rakesh,3,0,25,22
1657730694158,CSE 190,A00,092507,Dubnov; Shlomo,8,0,20,12
1657730700192,ECE 45,A01,083139,Congero; Spencer William,6,0,75,69
1657730706213,ECE 65,A50,083695,Saad; Andrew S,12,0,30,18
1657730706213,ECE 65,A51,095125,Saad; Andrew S,24,0,26,2
1657730712240,ECE 109,A01,091882,Touri; Behrouz,20,0,70,50
1657730718262,ECE 180,A00,083140,Abi Samra; Nicholas Camill,1,0,30,29
1657730718262,ECE 180,B00,083141,Abi Samra; Nicholas Camill,0,0,30,30
1657730724287,MATH 10A,A01,083735,Patchell; Gregory David,2,0,30,28
1657730724287,MATH 10A,A02,083736,Patchell; Gregory David,20,0,30,10
1657730724287,MATH 10A,A03,083737,Patchell; Gregory David,16,0,30,14
1657730730310,MATH 10B,A01,083207,Lim; Seonhee,8,0,34,26
1657730730310,MATH 10B,A02,083208,Lim; Seonhee,9,0,35,26
1657730730310,MATH 10B,A03,093472,Lim; Seonhee,7,0,34,27
1657730730310,MATH 10B,B01,083739,Sinha; Shubham,13,0,30,17
1657730736335,MATH 18,A01,083743,Cinel; Cameron Alexander,9,0,30,21
1657730736335,MATH 18,A02,083744,Cinel; Cameron Alexander,17,0,30,13
1657730736335,MATH 18,A03,083745,Cinel; Cameron Alexander,10,0,30,20
1657730736335,MATH 18,B01,083748,Rideout; David Porter,5,0,37,32
1657730736335,MATH 18,B02,083749,Rideout; David Porter,5,0,36,31
1657730736335,MATH 18,B03,083750,Rideout; David Porter,3,0,37,34
1657730736335,MATH 18,B04,083751,Rideout; David Porter,6,0,36,30
1657730736335,MATH 18,B05,093473,Rideout; David Porter,6,0,36,30
1657730736335,MATH 18,B06,093474,Rideout; David Porter,6,0,36,30
1657730742369,MATH 20A,A01,083754,Zheng; Zequn,14,0,40,26
1657730748393,MATH 20B,A01,083756,Briones; Jor-el Thomas Caparas,4,0,36,32
1657730748393,MATH 20B,A02,083757,Briones; Jor-el Thomas Caparas,1,0,36,35
1657730748393,MATH 20B,A03,093475,Briones; Jor-el Thomas Caparas,2,0,36,34
1657730754423,MATH 20C,A01,083760,Briones; Jor-el Thomas Caparas,1,0,35,34
1657730754423,MATH 20C,A02,083761,Briones; Jor-el Thomas Caparas,8,0,35,27
1657730754423,MATH 20C,A03,093476,Briones; Jor-el Thomas Caparas,0,1,36,36
1657730754423,MATH 20C,B01,083762,Bach; Quang Tran,1,0,30,29
1657730760447,MATH 20D,A01,083765,Tran; Brian Kha,5,0,30,25
1657730760447,MATH 20D,A02,083766,Tran; Brian Kha,5,0,30,25
1657730760447,MATH 20D,A03,083767,Tran; Brian Kha,5,0,30,25
1657730766482,MATH 20E,A01,083771,Ganguly; Soumya,9,0,32,23
1657730766482,MATH 20E,A02,083772,Ganguly; Soumya,6,0,32,26
1657730766482,MATH 20E,B01,083773,Ciotti; Benjamin,20,0,35,15
1657730766482,MATH 20E,B02,083774,Ciotti; Benjamin,18,0,35,17
1657730772507,MATH 103A,A01,083777,Greenfeld; Be'Eri,3,0,36,33
1657730772507,MATH 103A,A02,083778,Greenfeld; Be'Eri,5,0,36,31
1657730772507,MATH 103A,A03,093561,Greenfeld; Be'Eri,6,0,36,30
1657730772507,MATH 103A,B01,083779,Greenfeld; Be'Eri,7,0,36,29
1657730772507,MATH 103A,B02,083780,Greenfeld; Be'Eri,4,0,36,32
1657730772507,MATH 103A,B03,093562,Greenfeld; Be'Eri,3,0,36,33
1657730778540,MATH 105,A01,085443,Carter; Anne Toulson,15,0,35,20
1657730778540,MATH 105,A02,093477,Carter; Anne Toulson,20,0,35,15
1657730784571,MATH 109,A01,083213,Ganzberger; Geoffrey Michael,2,0,34,32
1657730784571,MATH 109,A02,083214,Ganzberger; Geoffrey Michael,4,0,34,30
1657730784571,MATH 109,A03,093478,Ganzberger; Geoffrey Michael,2,0,34,32
1657730784571,MATH 109,B01,083215,Ganzberger; Geoffrey Michael,1,0,32,31
1657730784571,MATH 109,B02,083216,Ganzberger; Geoffrey Michael,2,0,32,30
1657730784571,MATH 109,B03,093479,Ganzberger; Geoffrey Michael,8,0,32,24
1657730790595,MATH 142A,A01,083219,Chow; Bennett,7,0,32,25
1657730790595,MATH 142A,A02,083220,Chow; Bennett,10,0,32,22
1657730790595,MATH 142A,A03,093480,Chow; Bennett,9,0,32,23
1657730790595,MATH 142A,B03,093481,Chow; Bennett,8,0,32,24
1657730790595,MATH 142A,B04,093558,Chow; Bennett,13,0,32,19
1657730790595,MATH 142A,B05,093559,Chow; Bennett,6,0,32,26
1657730796619,MATH 193A,A01,083224,Rotar; Vladimir,8,0,34,26
1657730796619,MATH 193A,A02,083225,Rotar; Vladimir,9,0,34,25
1657730796619,MATH 193A,A03,083781,Rotar; Vladimir,5,0,34,29
1657730796619,MATH 193A,A04,083782,Rotar; Vladimir,10,0,34,24
1657730796619,MATH 193A,A05,093482,Rotar; Vladimir,10,0,34,24
1657730802645,MATH 197,001,091859,McAuley; Julian John,9999,0,9999,0
1657730802645,MATH 197,002,095566,Kedlaya; Kiran S.,9997,0,9999,2
1657730802645,MATH 197,003,095567,Xiao; Ming,9999,0,9999,0
1657730802645,MATH 197,004,095571,Perols; Johan Lars,9998,0,9999,1
1657730809733,COGS 9,A01,083615,Shannon; Kyle Michael,9,0,75,66
1657730815762,COGS 11,A01,083617,Boyle; Mary E. T.,23,0,48,25
1657730821786,COGS 13,A01,083071,Bastos; Amalia Pinkusfeld,11,0,71,60
1657730827816,COGS 14A,A01,092681,Semenuks; Arturs,5,1,100,95
1657730833843,COGS 14B,A01,083073,Cheng; Tzu-Han,6,0,63,57
1657730839866,COGS 17,A01,092677,Semenuks; Arturs,6,0,81,75
1657730845889,COGS 100,A01,083619,Allen; Michael Gordon,17,0,70,53
1657730851919,COGS 101A,A01,083621,Davis; Joshua Daniel,9,0,68,59
1657730857941,COGS 101B,A01,091572,Allen; Michael Gordon,12,0,65,53
1657730863975,COGS 101C,A01,083625,Delgado; Tania,17,0,35,18
1657730870015,COGS 107A,A01,083627,Boyle; Mary E. T.,13,0,60,47
1657730876039,COGS 118A,A01,083075,Gupta; Anjum,21,0,76,55
1657730882073,CSE 3,A50,083646,Miranda; Gregory Joseph,24,0,50,26
1657730888096,CSE 8A,A50,083650,Miranda; Gregory Joseph,17,1,56,39
1657730894122,CSE 11,A01,083080,Cao; Yingjun,6,15,40,34
1657730900146,CSE 12,A01,083652,Krause-Levy; Sophia Louisa,28,1,120,92
1657730906172,CSE 15L,A01,083654,Morris; Justin Loren,9,0,50,41
1657730906172,CSE 15L,A02,083655,Morris; Justin Loren,9,0,50,41
1657730912195,CSE 20,A01,083657,Tran; Khoa Dang,39,0,80,41
1657730918218,CSE 21,A01,095574,Bach; Quang Tran,22,0,48,26
1657730924241,CSE 30,A01,083084,Eldon; John,6,0,80,74
1657730924241,CSE 30,B01,095061,Bhaskar; Nishant,9,0,50,41
1657730930273,CSE 100,A01,083659,Cao; Yingjun,5,4,70,65
1657730936297,CSE 134B,A01,083661,Powell; Thomas Allan,23,0,100,77
1657730942320,CSE 140,A01,083663,Gungor; Onat,15,0,85,70
1657730948350,CSE 140L,A01,083088,Eldon; John,23,0,100,77
1657730954373,CSE 175,A01,083665,Kumar; Rakesh,3,0,25,22
1657730960400,CSE 190,A00,092507,Dubnov; Shlomo,8,0,20,12
1657730966440,ECE 45,A01,083139,Congero; Spencer William,6,0,75,69
1657730972465,ECE 65,A50,083695,Saad; Andrew S,12,0,30,18
1657730972465,ECE 65,A51,095125,Saad; Andrew S,24,0,26,2
1657730978489,ECE 109,A01,091882,Touri; Behrouz,20,0,70,50
1657730984515,ECE 180,A00,083140,Abi Samra; Nicholas Camill,1,0,30,29
1657730984515,ECE 180,B00,083141,Abi Samra; Nicholas Camill,0,0,30,30
1657730990542,MATH 10A,A01,083735,Patchell; Gregory David,2,0,30,28
1657730990542,MATH 10A,A02,083736,Patchell; Gregory David,20,0,30,10
1657730990542,MATH 10A,A03,083737,Patchell; Gregory David,16,0,30,14
1657730996568,MATH 10B,A01,083207,Lim; Seonhee,8,0,34,26
1657730996568,MATH 10B,A02,083208,Lim; Seonhee,9,0,35,26
1657730996568,MATH 10B,A03,093472,Lim; Seonhee,7,0,34,27
1657730996568,MATH 10B,B01,083739,Sinha; Shubham,13,0,30,17
1657731002592,MATH 18,A01,083743,Cinel; Cameron Alexander,9,0,30,21
1657731002592,MATH 18,A02,083744,Cinel; Cameron Alexander,17,0,30,13
1657731002592,MATH 18,A03,083745,Cinel; Cameron Alexander,10,0,30,20
1657731002592,MATH 18,B01,083748,Rideout; David Porter,5,0,37,32
1657731002592,MATH 18,B02,083749,Rideout; David Porter,5,0,36,31
1657731002592,MATH 18,B03,083750,Rideout; David Porter,3,0,37,34
1657731002592,MATH 18,B04,083751,Rideout; David Porter,6,0,36,30
1657731002592,MATH 18,B05,093473,Rideout; David Porter,6,0,36,30
1657731002592,MATH 18,B06,093474,Rideout; David Porter,6,0,36,30
1657731008616,MATH 20A,A01,083754,Zheng; Zequn,14,0,40,26
1657731014642,MATH 20B,A01,083756,Briones; Jor-el Thomas Caparas,4,0,36,32
1657731014642,MATH 20B,A02,083757,Briones; Jor-el Thomas Caparas,1,0,36,35
1657731014642,MATH 20B,A03,093475,Briones; Jor-el Thomas Caparas,2,0,36,34
1657731020671,MATH 20C,A01,083760,Briones; Jor-el Thomas Caparas,1,0,35,34
1657731020671,MATH 20C,A02,083761,Briones; Jor-el Thomas Caparas,8,0,35,27
1657731020671,MATH 20C,A03,093476,Briones; Jor-el Thomas Caparas,0,1,36,36
1657731020671,MATH 20C,B01,083762,Bach; Quang Tran,1,0,30,29
1657731026698,MATH 20D,A01,083765,Tran; Brian Kha,5,0,30,25
1657731026698,MATH 20D,A02,083766,Tran; Brian Kha,5,0,30,25
1657731026698,MATH 20D,A03,083767,Tran; Brian Kha,5,0,30,25
1657731032725,MATH 20E,A01,083771,Ganguly; Soumya,9,0,32,23
1657731032725,MATH 20E,A02,083772,Ganguly; Soumya,6,0,32,26
1657731032725,MATH 20E,B01,083773,Ciotti; Benjamin,20,0,35,15
1657731032725,MATH 20E,B02,083774,Ciotti; Benjamin,18,0,35,17
1657731038759,MATH 103A,A01,083777,Greenfeld; Be'Eri,3,0,36,33
1657731038759,MATH 103A,A02,083778,Greenfeld; Be'Eri,5,0,36,31
1657731038759,MATH 103A,A03,093561,Greenfeld; Be'Eri,6,0,36,30
1657731038759,MATH 103A,B01,083779,Greenfeld; Be'Eri,7,0,36,29
1657731038759,MATH 103A,B02,083780,Greenfeld; Be'Eri,4,0,36,32
1657731038759,MATH 103A,B03,093562,Greenfeld; Be'Eri,3,0,36,33
1657731044788,MATH 105,A01,085443,Carter; Anne Toulson,15,0,35,20
1657731044788,MATH 105,A02,093477,Carter; Anne Toulson,20,0,35,15
1657731050826,MATH 109,A01,083213,Ganzberger; Geoffrey Michael,2,0,34,32
1657731050826,MATH 109,A02,083214,Ganzberger; Geoffrey Michael,4,0,34,30
1657731050826,MATH 109,A03,093478,Ganzberger; Geoffrey Michael,2,0,34,32
1657731050826,MATH 109,B01,083215,Ganzberger; Geoffrey Michael,1,0,32,31
1657731050826,MATH 109,B02,083216,Ganzberger; Geoffrey Michael,2,0,32,30
1657731050826,MATH 109,B03,093479,Ganzberger; Geoffrey Michael,8,0,32,24
1657731056851,MATH 142A,A01,083219,Chow; Bennett,7,0,32,25
1657731056851,MATH 142A,A02,083220,Chow; Bennett,10,0,32,22
1657731056851,MATH 142A,A03,093480,Chow; Bennett,9,0,32,23
1657731056851,MATH 142A,B03,093481,Chow; Bennett,8,0,32,24
1657731056851,MATH 142A,B04,093558,Chow; Bennett,13,0,32,19
1657731056851,MATH 142A,B05,093559,Chow; Bennett,6,0,32,26
1657731062880,MATH 193A,A01,083224,Rotar; Vladimir,8,0,34,26
1657731062880,MATH 193A,A02,083225,Rotar; Vladimir,9,0,34,25
1657731062880,MATH 193A,A03,083781,Rotar; Vladimir,5,0,34,29
1657731062880,MATH 193A,A04,083782,Rotar; Vladimir,10,0,34,24
1657731062880,MATH 193A,A05,093482,Rotar; Vladimir,10,0,34,24
1657731068902,MATH 197,001,091859,McAuley; Julian John,9999,0,9999,0
1657731068902,MATH 197,002,095566,Kedlaya; Kiran S.,9997,0,9999,2
1657731068902,MATH 197,003,095567,Xiao; Ming,9999,0,9999,0
1657731068902,MATH 197,004,095571,Perols; Johan Lars,9998,0,9999,1
1657731075964,COGS 9,A01,083615,Shannon; Kyle Michael,9,0,75,66
1657731081990,COGS 11,A01,083617,Boyle; Mary E. T.,23,0,48,25
1657731088017,COGS 13,A01,083071,Bastos; Amalia Pinkusfeld,11,0,71,60
1657731094043,COGS 14A,A01,092681,Semenuks; Arturs,5,1,100,95
1657731100070,COGS 14B,A01,083073,Cheng; Tzu-Han,6,0,63,57
1657731106104,COGS 17,A01,092677,Semenuks; Arturs,6,0,81,75
1657731112127,COGS 100,A01,083619,Allen; Michael Gordon,17,0,70,53
1657731118156,COGS 101A,A01,083621,Davis; Joshua Daniel,9,0,68,59
1657731124187,COGS 101B,A01,091572,Allen; Michael Gordon,12,0,65,53
1657731130214,COGS 101C,A01,083625,Delgado; Tania,17,0,35,18
1657731136334,COGS 107A,A01,083627,Boyle; Mary E. T.,13,0,60,47
1657731142358,COGS 118A,A01,083075,Gupta; Anjum,21,0,76,55
1657731148398,CSE 3,A50,083646,Miranda; Gregory Joseph,24,0,50,26
1657731154427,CSE 8A,A50,083650,Miranda; Gregory Joseph,17,1,56,39
1657731160450,CSE 11,A01,083080,Cao; Yingjun,6,15,40,34
1657731166473,CSE 12,A01,083652,Krause-Levy; Sophia Louisa,28,1,120,92
1657731172502,CSE 15L,A01,083654,Morris; Justin Loren,9,0,50,41
1657731172502,CSE 15L,A02,083655,Morris; Justin Loren,9,0,50,41
1657731178525,CSE 20,A01,083657,Tran; Khoa Dang,39,0,80,41
1657731184549,CSE 21,A01,095574,Bach; Quang Tran,22,0,48,26
1657731190591,CSE 30,A01,083084,Eldon; John,6,0,80,74
1657731190591,CSE 30,B01,095061,Bhaskar; Nishant,9,0,50,41
1657731196616,CSE 100,A01,083659,Cao; Yingjun,5,4,70,65
1657731202637,CSE 134B,A01,083661,Powell; Thomas Allan,23,0,100,77
1657731208662,CSE 140,A01,083663,Gungor; Onat,15,0,85,70
1657731214696,CSE 140L,A01,083088,Eldon; John,23,0,100,77
1657731220726,CSE 175,A01,083665,Kumar; Rakesh,3,0,25,22
1657731226753,CSE 190,A00,092507,Dubnov; Shlomo,8,0,20,12
1657731232775,ECE 45,A01,083139,Congero; Spencer William,6,0,75,69
1657731238797,ECE 65,A50,083695,Saad; Andrew S,12,0,30,18
1657731238797,ECE 65,A51,095125,Saad; Andrew S,24,0,26,2
1657731244820,ECE 109,A01,091882,Touri; Behrouz,20,0,70,50
1657731250846,ECE 180,A00,083140,Abi Samra; Nicholas Camill,1,0,30,29
1657731250846,ECE 180,B00,083141,Abi Samra; Nicholas Camill,0,0,30,30
1657731256871,MATH 10A,A01,083735,Patchell; Gregory David,2,0,30,28
1657731256871,MATH 10A,A02,083736,Patchell; Gregory David,20,0,30,10
1657731256871,MATH 10A,A03,083737,Patchell; Gregory David,16,0,30,14
1657731262902,MATH 10B,A01,083207,Lim; Seonhee,8,0,34,26
1657731262902,MATH 10B,A02,083208,Lim; Seonhee,9,0,35,26
1657731262902,MATH 10B,A03,093472,Lim; Seonhee,7,0,34,27
1657731262902,MATH 10B,B01,083739,Sinha; Shubham,13,0,30,17
1657731268926,MATH 18,A01,083743,Cinel; Cameron Alexander,9,0,30,21
1657731268926,MATH 18,A02,083744,Cinel; Cameron Alexander,17,0,30,13
1657731268926,MATH 18,A03,083745,Cinel; Cameron Alexander,10,0,30,20
1657731268926,MATH 18,B01,083748,Rideout; David Porter,5,0,37,32
1657731268926,MATH 18,B02,083749,Rideout; David Porter,5,0,36,31
1657731268926,MATH 18,B03,083750,Rideout; David Porter,3,0,37,34
1657731268926,MATH 18,B04,083751,Rideout; David Porter,6,0,36,30
1657731268926,MATH 18,B05,093473,Rideout; David Porter,6,0,36,30
1657731268926,MATH 18,B06,093474,Rideout; David Porter,6,0,36,30
1657731274947,MATH 20A,A01,083754,Zheng; Zequn,14,0,40,26
1657731280986,MATH 20B,A01,083756,Briones; Jor-el Thomas Caparas,4,0,36,32
1657731280986,MATH 20B,A02,083757,Briones; Jor-el Thomas Caparas,1,0,36,35
1657731280986,MATH 20B,A03,093475,Briones; Jor-el Thomas Caparas,2,0,36,34
1657731287014,MATH 20C,A01,083760,Briones; Jor-el Thomas Caparas,1,0,35,34
1657731287014,MATH 20C,A02,083761,Briones; Jor-el Thomas Caparas,8,0,35,27
1657731287014,MATH 20C,A03,093476,Briones; Jor-el Thomas Caparas,0,1,36,36
1657731287014,MATH 20C,B01,083762,Bach; Quang Tran,1,0,30,29
1657731293053,MATH 20D,A01,083765,Tran; Brian Kha,5,0,30,25
1657731293053,MATH 20D,A02,083766,Tran; Brian Kha,5,0,30,25
1657731293053,MATH 20D,A03,083767,Tran; Brian Kha,5,0,30,25
1657731299081,MATH 20E,A01,083771,Ganguly; Soumya,9,0,32,23
1657731299081,MATH 20E,A02,083772,Ganguly; Soumya,6,0,32,26
1657731299081,MATH 20E,B01,083773,Ciotti; Benjamin,20,0,35,15
1657731299081,MATH 20E,B02,083774,Ciotti; Benjamin,18,0,35,17
1657731305112,MATH 103A,A01,083777,Greenfeld; Be'Eri,3,0,36,33
1657731305112,MATH 103A,A02,083778,Greenfeld; Be'Eri,5,0,36,31
1657731305112,MATH 103A,A03,093561,Greenfeld; Be'Eri,6,0,36,30
1657731305112,MATH 103A,B01,083779,Greenfeld; Be'Eri,7,0,36,29
1657731305112,MATH 103A,B02,083780,Greenfeld; Be'Eri,4,0,36,32
1657731305112,MATH 103A,B03,093562,Greenfeld; Be'Eri,3,0,36,33
1657731311141,MATH 105,A01,085443,Carter; Anne Toulson,15,0,35,20
1657731311141,MATH 105,A02,093477,Carter; Anne Toulson,20,0,35,15
1657731317172,MATH 109,A01,083213,Ganzberger; Geoffrey Michael,2,0,34,32
1657731317172,MATH 109,A02,083214,Ganzberger; Geoffrey Michael,4,0,34,30
1657731317172,MATH 109,A03,093478,Ganzberger; Geoffrey Michael,2,0,34,32
1657731317172,MATH 109,B01,083215,Ganzberger; Geoffrey Michael,1,0,32,31
1657731317172,MATH 109,B02,083216,Ganzberger; Geoffrey Michael,2,0,32,30
1657731317172,MATH 109,B03,093479,Ganzberger; Geoffrey Michael,8,0,32,24
1657731323201,MATH 142A,A01,083219,Chow; Bennett,7,0,32,25
1657731323201,MATH 142A,A02,083220,Chow; Bennett,10,0,32,22
1657731323201,MATH 142A,A03,093480,Chow; Bennett,9,0,32,23
1657731323201,MATH 142A,B03,093481,Chow; Bennett,8,0,32,24
1657731323201,MATH 142A,B04,093558,Chow; Bennett,13,0,32,19
1657731323201,MATH 142A,B05,093559,Chow; Bennett,6,0,32,26
1657731329230,MATH 193A,A01,083224,Rotar; Vladimir,8,0,34,26
1657731329230,MATH 193A,A02,083225,Rotar; Vladimir,9,0,34,25
1657731329230,MATH 193A,A03,083781,Rotar; Vladimir,5,0,34,29
1657731329230,MATH 193A,A04,083782,Rotar; Vladimir,10,0,34,24
1657731329230,MATH 193A,A05,093482,Rotar; Vladimir,10,0,34,24
1657731335261,MATH 197,001,091859,McAuley; Julian John,9999,0,9999,0
1657731335261,MATH 197,002,095566,Kedlaya; Kiran S.,9997,0,9999,2
1657731335261,MATH 197,003,095567,Xiao; Ming,9999,0,9999,0
1657731335261,MATH 197,004,095571,Perols; Johan Lars,9998,0,9999,1
1657731342317,COGS 9,A01,083615,Shannon; Kyle Michael,9,0,75,66
1657731348341,COGS 11,A01,083617,Boyle; Mary E. T.,23,0,48,25
1657731354365,COGS 13,A01,083071,Bastos; Amalia Pinkusfeld,11,0,71,60
1657731360400,COGS 14A,A01,092681,Semenuks; Arturs,5,1,100,95
1657731366426,COGS 14B,A01,083073,Cheng; Tzu-Han,6,0,63,57
1657731372452,COGS 17,A01,092677,Semenuks; Arturs,6,0,81,75
1657731378475,COGS 100,A01,083619,Allen; Michael Gordon,17,0,70,53
1657731384500,COGS 101A,A01,083621,Davis; Joshua Daniel,9,0,68,59
1657731390522,COGS 101B,A01,091572,Allen; Michael Gordon,12,0,65,53
1657731396545,COGS 101C,A01,083625,Delgado; Tania,17,0,35,18
1657731402568,COGS 107A,A01,083627,Boyle; Mary E. T.,13,0,60,47
1657731408592,COGS 118A,A01,083075,Gupta; Anjum,21,0,76,55
1657731414617,CSE 3,A50,083646,Miranda; Gregory Joseph,24,0,50,26
1657731420654,CSE 8A,A50,083650,Miranda; Gregory Joseph,17,1,56,39
1657731426683,CSE 11,A01,083080,Cao; Yingjun,6,15,40,34
1657731432706,CSE 12,A01,083652,Krause-Levy; Sophia Louisa,28,1,120,92
1657731438733,CSE 15L,A01,083654,Morris; Justin Loren,9,0,50,41
1657731438733,CSE 15L,A02,083655,Morris; Justin Loren,9,0,50,41
1657731444755,CSE 20,A01,083657,Tran; Khoa Dang,39,0,80,41
1657731450790,CSE 21,A01,095574,Bach; Quang Tran,22,0,48,26
1657731456814,CSE 30,A01,083084,Eldon; John,6,0,80,74
1657731456814,CSE 30,B01,095061,Bhaskar; Nishant,9,0,50,41
1657731462845,CSE 100,A01,083659,Cao; Yingjun,5,4,70,65
1657731468866,CSE 134B,A01,083661,Powell; Thomas Allan,23,0,100,77
1657731474892,CSE 140,A01,083663,Gungor; Onat,15,0,85,70
1657731480923,CSE 140L,A01,083088,Eldon; John,23,0,100,77
1657731486951,CSE 175,A01,083665,Kumar; Rakesh,3,0,25,22
1657731492986,CSE 190,A00,092507,Dubnov; Shlomo,8,0,20,12
1657731499011,ECE 45,A01,083139,Congero; Spencer William,6,0,75,69
1657731505035,ECE 65,A50,083695,Saad; Andrew S,12,0,30,18
1657731505035,ECE 65,A51,095125,Saad; Andrew S,24,0,26,2
1657731511063,ECE 109,A01,091882,Touri; Behrouz,20,0,70,50
1657731517087,ECE 180,A00,083140,Abi Samra; Nicholas Camill,1,0,30,29
1657731517087,ECE 180,B00,083141,Abi Samra; Nicholas Camill,0,0,30,30
1657731523112,MATH 10A,A01,083735,Patchell; Gregory David,2,0,30,28
1657731523112,MATH 10A,A02,083736,Patchell; Gregory David,20,0,30,10
1657731523112,MATH 10A,A03,083737,Patchell; Gregory David,16,0,30,14
1657731529137,MATH 10B,A01,083207,Lim; Seonhee,8,0,34,26
1657731529137,MATH 10B,A02,083208,Lim; Seonhee,9,0,35,26
1657731529137,MATH 10B,A03,093472,Lim; Seonhee,7,0,34,27
1657731529137,MATH 10B,B01,083739,Sinha; Shubham,13,0,30,17
1657731535170,MATH 18,A01,083743,Cinel; Cameron Alexander,9,0,30,21
1657731535170,MATH 18,A02,083744,Cinel; Cameron Alexander,17,0,30,13
1657731535170,MATH 18,A03,083745,Cinel; Cameron Alexander,10,0,30,20
1657731535170,MATH 18,B01,083748,Rideout; David Porter,5,0,37,32
1657731535170,MATH 18,B02,083749,Rideout; David Porter,5,0,36,31
1657731535170,MATH 18,B03,083750,Rideout; David Porter,3,0,37,34
1657731535170,MATH 18,B04,083751,Rideout; David Porter,6,0,36,30
1657731535170,MATH 18,B05,093473,Rideout; David Porter,6,0,36,30
1657731535170,MATH 18,B06,093474,Rideout; David Porter,6,0,36,30
1657731541199,MATH 20A,A01,083754,Zheng; Zequn,14,0,40,26
1657731547224,MATH 20B,A01,083756,Briones; Jor-el Thomas Caparas,4,0,36,32
1657731547224,MATH 20B,A02,083757,Briones; Jor-el Thomas Caparas,1,0,36,35
1657731547224,MATH 20B,A03,093475,Briones; Jor-el Thomas Caparas,2,0,36,34
1657731553262,MATH 20C,A01,083760,Briones; Jor-el Thomas Caparas,1,0,35,34
1657731553262,MATH 20C,A02,083761,Briones; Jor-el Thomas Caparas,8,0,35,27
1657731553262,MATH 20C,A03,093476,Briones; Jor-el Thomas Caparas,0,1,36,36
1657731553262,MATH 20C,B01,083762,Bach; Quang Tran,1,0,30,29
1657731559290,MATH 20D,A01,083765,Tran; Brian Kha,5,0,30,25
1657731559290,MATH 20D,A02,083766,Tran; Brian Kha,5,0,30,25
1657731559290,MATH 20D,A03,083767,Tran; Brian Kha,5,0,30,25
1657731565317,MATH 20E,A01,083771,Ganguly; Soumya,9,0,32,23
1657731565317,MATH 20E,A02,083772,Ganguly; Soumya,6,0,32,26
1657731565317,MATH 20E,B01,083773,Ciotti; Benjamin,20,0,35,15
1657731565317,MATH 20E,B02,083774,Ciotti; Benjamin,18,0,35,17
1657731571353,MATH 103A,A01,083777,Greenfeld; Be'Eri,3,0,36,33
1657731571353,MATH 103A,A02,083778,Greenfeld; Be'Eri,5,0,36,31
1657731571353,MATH 103A,A03,093561,Greenfeld; Be'Eri,6,0,36,30
1657731571353,MATH 103A,B01,083779,Greenfeld; Be'Eri,7,0,36,29
1657731571353,MATH 103A,B02,083780,Greenfeld; Be'Eri,4,0,36,32
1657731571353,MATH 103A,B03,093562,Greenfeld; Be'Eri,3,0,36,33
1657731577377,MATH 105,A01,085443,Carter; Anne Toulson,15,0,35,20
1657731577377,MATH 105,A02,093477,Carter; Anne Toulson,20,0,35,15
1657731583401,MATH 109,A01,083213,Ganzberger; Geoffrey Michael,2,0,34,32
1657731583401,MATH 109,A02,083214,Ganzberger; Geoffrey Michael,4,0,34,30
1657731583401,MATH 109,A03,093478,Ganzberger; Geoffrey Michael,2,0,34,32
1657731583401,MATH 109,B01,083215,Ganzberger; Geoffrey Michael,1,0,32,31
1657731583401,MATH 109,B02,083216,Ganzberger; Geoffrey Michael,2,0,32,30
1657731583401,MATH 109,B03,093479,Ganzberger; Geoffrey Michael,8,0,32,24
1657731589431,MATH 142A,A01,083219,Chow; Bennett,7,0,32,25
1657731589431,MATH 142A,A02,083220,Chow; Bennett,10,0,32,22
1657731589431,MATH 142A,A03,093480,Chow; Bennett,9,0,32,23
1657731589431,MATH 142A,B03,093481,Chow; Bennett,8,0,32,24
1657731589431,MATH 142A,B04,093558,Chow; Bennett,13,0,32,19
1657731589431,MATH 142A,B05,093559,Chow; Bennett,6,0,32,26
1657731595459,MATH 193A,A01,083224,Rotar; Vladimir,8,0,34,26
1657731595459,MATH 193A,A02,083225,Rotar; Vladimir,9,0,34,25
1657731595459,MATH 193A,A03,083781,Rotar; Vladimir,5,0,34,29
1657731595459,MATH 193A,A04,083782,Rotar; Vladimir,10,0,34,24
1657731595459,MATH 193A,A05,093482,Rotar; Vladimir,10,0,34,24
1657731601482,MATH 197,001,091859,McAuley; Julian John,9999,0,9999,0
1657731601482,MATH 197,002,095566,Kedlaya; Kiran S.,9997,0,9999,2
1657731601482,MATH 197,003,095567,Xiao; Ming,9999,0,9999,0
1657731601482,MATH 197,004,095571,Perols; Johan Lars,9998,0,9999,1
1657731608537,COGS 9,A01,083615,Shannon; Kyle Michael,9,0,75,66
1657731614567,COGS 11,A01,083617,Boyle; Mary E. T.,23,0,48,25
1657731620596,COGS 13,A01,083071,Bastos; Amalia Pinkusfeld,11,0,71,60
1657731626618,COGS 14A,A01,092681,Semenuks; Arturs,5,1,100,95
1657731632641,COGS 14B,A01,083073,Cheng; Tzu-Han,6,0,63,57
1657731638672,COGS 17,A01,092677,Semenuks; Arturs,6,0,81,75
1657731644695,COGS 100,A01,083619,Allen; Michael Gordon,17,0,70,53
1657731650728,COGS 101A,A01,083621,Davis; Joshua Daniel,9,0,68,59
1657731656754,COGS 101B,A01,091572,Allen; Michael Gordon,12,0,65,53
1657731662778,COGS 101C,A01,083625,Delgado; Tania,17,0,35,18
1657731668800,COGS 107A,A01,083627,Boyle; Mary E. T.,13,0,60,47
1657731674825,COGS 118A,A01,083075,Gupta; Anjum,21,0,76,55
1657731680859,CSE 3,A50,083646,Miranda; Gregory Joseph,24,0,50,26
1657731686891,CSE 8A,A50,083650,Miranda; Gregory Joseph,17,1,56,39
1657731692917,CSE 11,A01,083080,Cao; Yingjun,6,15,40,34
1657731698939,CSE 12,A01,083652,Krause-Levy; Sophia Louisa,28,1,120,92
1657731704974,CSE 15L,A01,083654,Morris; Justin Loren,9,0,50,41
1657731704974,CSE 15L,A02,083655,Morris; Justin Loren,9,0,50,41
1657731711000,CSE 20,A01,083657,Tran; Khoa Dang,39,0,80,41
1657731717028,CSE 21,A01,095574,Bach; Quang Tran,22,0,48,26
1657731723066,CSE 30,A01,083084,Eldon; John,6,0,80,74
1657731723066,CSE 30,B01,095061,Bhaskar; Nishant,9,0,50,41
1657731729098,CSE 100,A01,083659,Cao; Yingjun,5,4,70,65
1657731735208,CSE 134B,A01,083661,Powell; Thomas Allan,23,0,100,77
1657731741231,CSE 140,A01,083663,Gungor; Onat,15,0,85,70
1657731747263,CSE 140L,A01,083088,Eldon; John,23,0,100,77
1657731753289,CSE 175,A01,083665,Kumar; Rakesh,3,0,25,22
1657731759315,CSE 190,A00,092507,Dubnov; Shlomo,8,0,20,12
1657731765345,ECE 45,A01,083139,Congero; Spencer William,6,0,75,69
1657731771370,ECE 65,A50,083695,Saad; Andrew S,12,0,30,18
1657731771370,ECE 65,A51,095125,Saad; Andrew S,24,0,26,2
1657731777395,ECE 109,A01,091882,Touri; Behrouz,20,0,70,50
1657731783418,ECE 180,A00,083140,Abi Samra; Nicholas Camill,1,0,30,29
1657731783418,ECE 180,B00,083141,Abi Samra; Nicholas Camill,0,0,30,30
1657731789440,MATH 10A,A01,083735,Patchell; Gregory David,2,0,30,28
1657731789440,MATH 10A,A02,083736,Patchell; Gregory David,20,0,30,10
1657731789440,MATH 10A,A03,083737,Patchell; Gregory David,16,0,30,14
1657731795462,MATH 10B,A01,083207,Lim; Seonhee,8,0,34,26
1657731795462,MATH 10B,A02,083208,Lim; Seonhee,9,0,35,26
1657731795462,MATH 10B,A03,093472,Lim; Seonhee,7,0,34,27
1657731795462,MATH 10B,B01,083739,Sinha; Shubham,13,0,30,17
1657731801491,MATH 18,A01,083743,Cinel; Cameron Alexander,9,0,30,21
1657731801491,MATH 18,A02,083744,Cinel; Cameron Alexander,17,0,30,13
1657731801491,MATH 18,A03,083745,Cinel; Cameron Alexander,10,0,30,20
1657731801491,MATH 18,B01,083748,Rideout; David Porter,5,0,37,32
1657731801491,MATH 18,B02,083749,Rideout; David Porter,5,0,36,31
1657731801491,MATH 18,B03,083750,Rideout; David Porter,3,0,37,34
1657731801491,MATH 18,B04,083751,Rideout; David Porter,6,0,36,30
1657731801491,MATH 18,B05,093473,Rideout; David Porter,6,0,36,30
1657731801491,MATH 18,B06,093474,Rideout; David Porter,6,0,36,30
1657731807513,MATH 20A,A01,083754,Zheng; Zequn,14,0,40,26
1657731813551,MATH 20B,A01,083756,Briones; Jor-el Thomas Caparas,4,0,36,32
1657731813551,MATH 20B,A02,083757,Briones; Jor-el Thomas Caparas,1,0,36,35
1657731813551,MATH 20B,A03,093475,Briones; Jor-el Thomas Caparas,2,0,36,34
1657731819587,MATH 20C,A01,083760,Briones; Jor-el Thomas Caparas,1,0,35,34
1657731819587,MATH 20C,A02,083761,Briones; Jor-el Thomas Caparas,8,0,35,27
1657731819587,MATH 20C,A03,093476,Briones; Jor-el Thomas Caparas,0,1,36,36
1657731819587,MATH 20C,B01,083762,Bach; Quang Tran,1,0,30,29
1657731825613,MATH 20D,A01,083765,Tran; Brian Kha,5,0,30,25
1657731825613,MATH 20D,A02,083766,Tran; Brian Kha,5,0,30,25
1657731825613,MATH 20D,A03,083767,Tran; Brian Kha,5,0,30,25
1657731831638,MATH 20E,A01,083771,Ganguly; Soumya,9,0,32,23
1657731831638,MATH 20E,A02,083772,Ganguly; Soumya,6,0,32,26
1657731831638,MATH 20E,B01,083773,Ciotti; Benjamin,20,0,35,15
1657731831638,MATH 20E,B02,083774,Ciotti; Benjamin,18,0,35,17
1657731837674,MATH 103A,A01,083777,Greenfeld; Be'Eri,3,0,36,33
1657731837674,MATH 103A,A02,083778,Greenfeld; Be'Eri,5,0,36,31
1657731837674,MATH 103A,A03,093561,Greenfeld; Be'Eri,6,0,36,30
1657731837674,MATH 103A,B01,083779,Greenfeld; Be'Eri,7,0,36,29
1657731837674,MATH 103A,B02,083780,Greenfeld; Be'Eri,4,0,36,32
1657731837674,MATH 103A,B03,093562,Greenfeld; Be'Eri,3,0,36,33
1657731843704,MATH 105,A01,085443,Carter; Anne Toulson,15,0,35,20
1657731843704,MATH 105,A02,093477,Carter; Anne Toulson,20,0,35,15
1657731849727,MATH 109,A01,083213,Ganzberger; Geoffrey Michael,2,0,34,32
1657731849727,MATH 109,A02,083214,Ganzberger; Geoffrey Michael,4,0,34,30
1657731849727,MATH 109,A03,093478,Ganzberger; Geoffrey Michael,2,0,34,32
1657731849727,MATH 109,B01,083215,Ganzberger; Geoffrey Michael,1,0,32,31
1657731849727,MATH 109,B02,083216,Ganzberger; Geoffrey Michael,2,0,32,30
1657731849727,MATH 109,B03,093479,Ganzberger; Geoffrey Michael,8,0,32,24
1657731855768,MATH 142A,A01,083219,Chow; Bennett,7,0,32,25
1657731855768,MATH 142A,A02,083220,Chow; Bennett,10,0,32,22
1657731855768,MATH 142A,A03,093480,Chow; Bennett,9,0,32,23
1657731855768,MATH 142A,B03,093481,Chow; Bennett,8,0,32,24
1657731855768,MATH 142A,B04,093558,Chow; Bennett,13,0,32,19
1657731855768,MATH 142A,B05,093559,Chow; Bennett,6,0,32,26
1657731861793,MATH 193A,A01,083224,Rotar; Vladimir,8,0,34,26
1657731861793,MATH 193A,A02,083225,Rotar; Vladimir,9,0,34,25
1657731861793,MATH 193A,A03,083781,Rotar; Vladimir,5,0,34,29
1657731861793,MATH 193A,A04,083782,Rotar; Vladimir,10,0,34,24
1657731861793,MATH 193A,A05,093482,Rotar; Vladimir,10,0,34,24
1657731867826,MATH 197,001,091859,McAuley; Julian John,9999,0,9999,0
1657731867826,MATH 197,002,095566,Kedlaya; Kiran S.,9997,0,9999,2
1657731867826,MATH 197,003,095567,Xiao; Ming,9999,0,9999,0
1657731867826,MATH 197,004,095571,Perols; Johan Lars,9998,0,9999,1
1657731874894,COGS 9,A01,083615,Shannon; Kyle Michael,9,0,75,66
1657731880918,COGS 11,A01,083617,Boyle; Mary E. T.,23,0,48,25
1657731886954,COGS 13,A01,083071,Bastos; Amalia Pinkusfeld,11,0,71,60
1657731892976,COGS 14A,A01,092681,Semenuks; Arturs,5,1,100,95
1657731899015,COGS 14B,A01,083073,Cheng; Tzu-Han,6,0,63,57
1657731905038,COGS 17,A01,092677,Semenuks; Arturs,6,0,81,75
1657731911064,COGS 100,A01,083619,Allen; Michael Gordon,17,0,70,53
1657731917088,COGS 101A,A01,083621,Davis; Joshua Daniel,9,0,68,59
1657731923122,COGS 101B,A01,091572,Allen; Michael Gordon,12,0,65,53
1657731929145,COGS 101C,A01,083625,Delgado; Tania,17,0,35,18
1657731935170,COGS 107A,A01,083627,Boyle; Mary E. T.,13,0,60,47
1657731941195,COGS 118A,A01,083075,Gupta; Anjum,21,0,76,55
1657731947217,CSE 3,A50,083646,Miranda; Gregory Joseph,24,0,50,26
1657731953252,CSE 8A,A50,083650,Miranda; Gregory Joseph,17,1,56,39
1657731959281,CSE 11,A01,083080,Cao; Yingjun,6,15,40,34
1657731965304,CSE 12,A01,083652,Krause-Levy; Sophia Louisa,28,1,120,92
1657731971329,CSE 15L,A01,083654,Morris; Justin Loren,9,0,50,41
1657731971329,CSE 15L,A02,083655,Morris; Justin Loren,9,0,50,41
1657731977365,CSE 20,A01,083657,Tran; Khoa Dang,39,0,80,41
1657731983388,CSE 21,A01,095574,Bach; Quang Tran,22,0,48,26
1657731989421,CSE 30,A01,083084,Eldon; John,6,0,80,74
1657731989421,CSE 30,B01,095061,Bhaskar; Nishant,9,0,50,41
1657731995447,CSE 100,A01,083659,Cao; Yingjun,5,4,70,65
1657732001471,CSE 134B,A01,083661,Powell; Thomas Allan,23,0,100,77
1657732007494,CSE 140,A01,083663,Gungor; Onat,15,0,85,70
1657732013517,CSE 140L,A01,083088,Eldon; John,23,0,100,77
1657732019539,CSE 175,A01,083665,Kumar; Rakesh,3,0,25,22
1657732025561,CSE 190,A00,092507,Dubnov; Shlomo,8,0,20,12
1657732031584,ECE 45,A01,083139,Congero; Spencer William,6,0,75,69
1657732037607,ECE 65,A50,083695,Saad; Andrew S,12,0,30,18
1657732037607,ECE 65,A51,095125,Saad; Andrew S,24,0,26,2
1657732043632,ECE 109,A01,091882,Touri; Behrouz,20,0,70,50
1657732049660,ECE 180,A00,083140,Abi Samra; Nicholas Camill,1,0,30,29
1657732049660,ECE 180,B00,083141,Abi Samra; Nicholas Camill,0,0,30,30
1657732055684,MATH 10A,A01,083735,Patchell; Gregory David,2,0,30,28
1657732055684,MATH 10A,A02,083736,Patchell; Gregory David,20,0,30,10
1657732055684,MATH 10A,A03,083737,Patchell; Gregory David,16,0,30,14
1657732061711,MATH 10B,A01,083207,Lim; Seonhee,8,0,34,26
1657732061711,MATH 10B,A02,083208,Lim; Seonhee,9,0,35,26
1657732061711,MATH 10B,A03,093472,Lim; Seonhee,7,0,34,27
1657732061711,MATH 10B,B01,083739,Sinha; Shubham,13,0,30,17
1657732067744,MATH 18,A01,083743,Cinel; Cameron Alexander,9,0,30,21
1657732067744,MATH 18,A02,083744,Cinel; Cameron Alexander,17,0,30,13
1657732067744,MATH 18,A03,083745,Cinel; Cameron Alexander,10,0,30,20
1657732067744,MATH 18,B01,083748,Rideout; David Porter,5,0,37,32
1657732067744,MATH 18,B02,083749,Rideout; David Porter,5,0,36,31
1657732067744,MATH 18,B03,083750,Rideout; David Porter,3,0,37,34
1657732067744,MATH 18,B04,083751,Rideout; David Porter,6,0,36,30
1657732067744,MATH 18,B05,093473,Rideout; David Porter,6,0,36,30
1657732067744,MATH 18,B06,093474,Rideout; David Porter,6,0,36,30
1657732073770,MATH 20A,A01,083754,Zheng; Zequn,14,0,40,26
1657732079799,MATH 20B,A01,083756,Briones; Jor-el Thomas Caparas,4,0,36,32
1657732079799,MATH 20B,A02,083757,Briones; Jor-el Thomas Caparas,1,0,36,35
1657732079799,MATH 20B,A03,093475,Briones; Jor-el Thomas Caparas,2,0,36,34
1657732085822,MATH 20C,A01,083760,Briones; Jor-el Thomas Caparas,1,0,35,34
1657732085822,MATH 20C,A02,083761,Briones; Jor-el Thomas Caparas,8,0,35,27
1657732085822,MATH 20C,A03,093476,Briones; Jor-el Thomas Caparas,0,1,36,36
1657732085822,MATH 20C,B01,083762,Bach; Quang Tran,1,0,30,29
1657732091845,MATH 20D,A01,083765,Tran; Brian Kha,5,0,30,25
1657732091845,MATH 20D,A02,083766,Tran; Brian Kha,5,0,30,25
1657732091845,MATH 20D,A03,083767,Tran; Brian Kha,5,0,30,25
1657732097869,MATH 20E,A01,083771,Ganguly; Soumya,9,0,32,23
1657732097869,MATH 20E,A02,083772,Ganguly; Soumya,6,0,32,26
1657732097869,MATH 20E,B01,083773,Ciotti; Benjamin,20,0,35,15
1657732097869,MATH 20E,B02,083774,Ciotti; Benjamin,18,0,35,17
1657732103894,MATH 103A,A01,083777,Greenfeld; Be'Eri,3,0,36,33
1657732103894,MATH 103A,A02,083778,Greenfeld; Be'Eri,5,0,36,31
1657732103894,MATH 103A,A03,093561,Greenfeld; Be'Eri,6,0,36,30
1657732103894,MATH 103A,B01,083779,Greenfeld; Be'Eri,7,0,36,29
1657732103894,MATH 103A,B02,083780,Greenfeld; Be'Eri,4,0,36,32
1657732103894,MATH 103A,B03,093562,Greenfeld; Be'Eri,3,0,36,33
1657732109920,MATH 105,A01,085443,Carter; Anne Toulson,15,0,35,20
1657732109920,MATH 105,A02,093477,Carter; Anne Toulson,20,0,35,15
1657732115942,MATH 109,A01,083213,Ganzberger; Geoffrey Michael,2,0,34,32
1657732115942,MATH 109,A02,083214,Ganzberger; Geoffrey Michael,4,0,34,30
1657732115942,MATH 109,A03,093478,Ganzberger; Geoffrey Michael,2,0,34,32
1657732115942,MATH 109,B01,083215,Ganzberger; Geoffrey Michael,1,0,32,31
1657732115942,MATH 109,B02,083216,Ganzberger; Geoffrey Michael,2,0,32,30
1657732115942,MATH 109,B03,093479,Ganzberger; Geoffrey Michael,8,0,32,24
1657732121966,MATH 142A,A01,083219,Chow; Bennett,7,0,32,25
1657732121966,MATH 142A,A02,083220,Chow; Bennett,10,0,32,22
1657732121966,MATH 142A,A03,093480,Chow; Bennett,9,0,32,23
1657732121966,MATH 142A,B03,093481,Chow; Bennett,8,0,32,24
1657732121966,MATH 142A,B04,093558,Chow; Bennett,13,0,32,19
1657732121966,MATH 142A,B05,093559,Chow; Bennett,6,0,32,26
1657732127987,MATH 193A,A01,083224,Rotar; Vladimir,8,0,34,26
1657732127987,MATH 193A,A02,083225,Rotar; Vladimir,9,0,34,25
1657732127987,MATH 193A,A03,083781,Rotar; Vladimir,5,0,34,29
1657732127987,MATH 193A,A04,083782,Rotar; Vladimir,10,0,34,24
1657732127987,MATH 193A,A05,093482,Rotar; Vladimir,10,0,34,24
1657732134009,MATH 197,001,091859,McAuley; Julian John,9999,0,9999,0
1657732134009,MATH 197,002,095566,Kedlaya; Kiran S.,9997,0,9999,2
1657732134009,MATH 197,003,095567,Xiao; Ming,9999,0,9999,0
1657732134009,MATH 197,004,095571,Perols; Johan Lars,9998,0,9999,1
1657732141063,COGS 9,A01,083615,Shannon; Kyle Michael,9,0,75,66
1657732147090,COGS 11,A01,083617,Boyle; Mary E. T.,23,0,48,25
1657732153126,COGS 13,A01,083071,Bastos; Amalia Pinkusfeld,11,0,71,60
1657732159149,COGS 14A,A01,092681,Semenuks; Arturs,5,1,100,95
1657732165176,COGS 14B,A01,083073,Cheng; Tzu-Han,6,0,63,57
1657732171204,COGS 17,A01,092677,Semenuks; Arturs,6,0,81,75
1657732177232,COGS 100,A01,083619,Allen; Michael Gordon,17,0,70,53
1657732183256,COGS 101A,A01,083621,Davis; Joshua Daniel,9,0,68,59
1657732189279,COGS 101B,A01,091572,Allen; Michael Gordon,12,0,65,53
1657732195315,COGS 101C,A01,083625,Delgado; Tania,17,0,35,18
1657732201336,COGS 107A,A01,083627,Boyle; Mary E. T.,13,0,60,47
1657732207363,COGS 118A,A01,083075,Gupta; Anjum,21,0,76,55
1657732213385,CSE 3,A50,083646,Miranda; Gregory Joseph,24,0,50,26
1657732219414,CSE 8A,A50,083650,Miranda; Gregory Joseph,17,1,56,39
1657732225440,CSE 11,A01,083080,Cao; Yingjun,6,15,40,34
1657732231471,CSE 12,A01,083652,Krause-Levy; Sophia Louisa,28,1,120,92
1657732237494,CSE 15L,A01,083654,Morris; Justin Loren,9,0,50,41
1657732237494,CSE 15L,A02,083655,Morris; Justin Loren,9,0,50,41
1657732243517,CSE 20,A01,083657,Tran; Khoa Dang,39,0,80,41
1657732249546,CSE 21,A01,095574,Bach; Quang Tran,22,0,48,26
1657732255568,CSE 30,A01,083084,Eldon; John,6,0,80,74
1657732255568,CSE 30,B01,095061,Bhaskar; Nishant,9,0,50,41
1657732261592,CSE 100,A01,083659,Cao; Yingjun,5,4,70,65
1657732267621,CSE 134B,A01,083661,Powell; Thomas Allan,23,0,100,77
1657732273647,CSE 140,A01,083663,Gungor; Onat,15,0,85,70
1657732279670,CSE 140L,A01,083088,Eldon; John,23,0,100,77
1657732285696,CSE 175,A01,083665,Kumar; Rakesh,3,0,25,22
1657732291729,CSE 190,A00,092507,Dubnov; Shlomo,8,0,20,12
1657732297755,ECE 45,A01,083139,Congero; Spencer William,6,0,75,69
1657732303785,ECE 65,A50,083695,Saad; Andrew S,12,0,30,18
1657732303785,ECE 65,A51,095125,Saad; Andrew S,24,0,26,2
1657732309807,ECE 109,A01,091882,Touri; Behrouz,20,0,70,50
1657732315831,ECE 180,A00,083140,Abi Samra; Nicholas Camill,1,0,30,29
1657732315831,ECE 180,B00,083141,Abi Samra; Nicholas Camill,0,0,30,30
1657732321856,MATH 10A,A01,083735,Patchell; Gregory David,2,0,30,28
1657732321856,MATH 10A,A02,083736,Patchell; Gregory David,20,0,30,10
1657732321856,MATH 10A,A03,083737,Patchell; Gregory David,16,0,30,14
1657732327881,MATH 10B,A01,083207,Lim; Seonhee,8,0,34,26
1657732327881,MATH 10B,A02,083208,Lim; Seonhee,9,0,35,26
1657732327881,MATH 10B,A03,093472,Lim; Seonhee,7,0,34,27
1657732327881,MATH 10B,B01,083739,Sinha; Shubham,13,0,30,17
1657732334012,MATH 18,A01,083743,Cinel; Cameron Alexander,9,0,30,21
1657732334012,MATH 18,A02,083744,Cinel; Cameron Alexander,17,0,30,13
1657732334012,MATH 18,A03,083745,Cinel; Cameron Alexander,10,0,30,20
1657732334012,MATH 18,B01,083748,Rideout; David Porter,5,0,37,32
1657732334012,MATH 18,B02,083749,Rideout; David Porter,5,0,36,31
1657732334012,MATH 18,B03,083750,Rideout; David Porter,3,0,37,34
1657732334012,MATH 18,B04,083751,Rideout; David Porter,6,0,36,30
1657732334012,MATH 18,B05,093473,Rideout; David Porter,6,0,36,30
1657732334012,MATH 18,B06,093474,Rideout; David Porter,6,0,36,30
1657732340049,MATH 20A,A01,083754,Zheng; Zequn,14,0,40,26
1657732346071,MATH 20B,A01,083756,Briones; Jor-el Thomas Caparas,4,0,36,32
1657732346071,MATH 20B,A02,083757,Briones; Jor-el Thomas Caparas,1,0,36,35
1657732346071,MATH 20B,A03,093475,Briones; Jor-el Thomas Caparas,2,0,36,34
1657732352102,MATH 20C,A01,083760,Briones; Jor-el Thomas Caparas,1,0,35,34
1657732352102,MATH 20C,A02,083761,Briones; Jor-el Thomas Caparas,8,0,35,27
1657732352102,MATH 20C,A03,093476,Briones; Jor-el Thomas Caparas,0,1,36,36
1657732352102,MATH 20C,B01,083762,Bach; Quang Tran,1,0,30,29
1657732358141,MATH 20D,A01,083765,Tran; Brian Kha,5,0,30,25
1657732358141,MATH 20D,A02,083766,Tran; Brian Kha,5,0,30,25
1657732358141,MATH 20D,A03,083767,Tran; Brian Kha,5,0,30,25
1657732364164,MATH 20E,A01,083771,Ganguly; Soumya,9,0,32,23
1657732364164,MATH 20E,A02,083772,Ganguly; Soumya,6,0,32,26
1657732364164,MATH 20E,B01,083773,Ciotti; Benjamin,20,0,35,15
1657732364164,MATH 20E,B02,083774,Ciotti; Benjamin,18,0,35,17
1657732370188,MATH 103A,A01,083777,Greenfeld; Be'Eri,3,0,36,33
1657732370188,MATH 103A,A02,083778,Greenfeld; Be'Eri,5,0,36,31
1657732370188,MATH 103A,A03,093561,Greenfeld; Be'Eri,6,0,36,30
1657732370188,MATH 103A,B01,083779,Greenfeld; Be'Eri,7,0,36,29
1657732370188,MATH 103A,B02,083780,Greenfeld; Be'Eri,4,0,36,32
1657732370188,MATH 103A,B03,093562,Greenfeld; Be'Eri,3,0,36,33
1657732376211,MATH 105,A01,085443,Carter; Anne Toulson,15,0,35,20
1657732376211,MATH 105,A02,093477,Carter; Anne Toulson,20,0,35,15
1657732382234,MATH 109,A01,083213,Ganzberger; Geoffrey Michael,2,0,34,32
1657732382234,MATH 109,A02,083214,Ganzberger; Geoffrey Michael,4,0,34,30
1657732382234,MATH 109,A03,093478,Ganzberger; Geoffrey Michael,2,0,34,32
1657732382234,MATH 109,B01,083215,Ganzberger; Geoffrey Michael,1,0,32,31
1657732382234,MATH 109,B02,083216,Ganzberger; Geoffrey Michael,2,0,32,30
1657732382234,MATH 109,B03,093479,Ganzberger; Geoffrey Michael,8,0,32,24
1657732388260,MATH 142A,A01,083219,Chow; Bennett,7,0,32,25
1657732388260,MATH 142A,A02,083220,Chow; Bennett,10,0,32,22
1657732388260,MATH 142A,A03,093480,Chow; Bennett,9,0,32,23
1657732388260,MATH 142A,B03,093481,Chow; Bennett,8,0,32,24
1657732388260,MATH 142A,B04,093558,Chow; Bennett,13,0,32,19
1657732388260,MATH 142A,B05,093559,Chow; Bennett,6,0,32,26
1657732394282,MATH 193A,A01,083224,Rotar; Vladimir,8,0,34,26
1657732394282,MATH 193A,A02,083225,Rotar; Vladimir,9,0,34,25
1657732394282,MATH 193A,A03,083781,Rotar; Vladimir,5,0,34,29
1657732394282,MATH 193A,A04,083782,Rotar; Vladimir,10,0,34,24
1657732394282,MATH 193A,A05,093482,Rotar; Vladimir,10,0,34,24
1657732400306,MATH 197,001,091859,McAuley; Julian John,9999,0,9999,0
1657732400306,MATH 197,002,095566,Kedlaya; Kiran S.,9997,0,9999,2
1657732400306,MATH 197,003,095567,Xiao; Ming,9999,0,9999,0
1657732400306,MATH 197,004,095571,Perols; Johan Lars,9998,0,9999,1
1657732407358,COGS 9,A01,083615,Shannon; Kyle Michael,9,0,75,66
1657732413380,COGS 11,A01,083617,Boyle; Mary E. T.,23,0,48,25
1657732419411,COGS 13,A01,083071,Bastos; Amalia Pinkusfeld,11,0,71,60
1657732425437,COGS 14A,A01,092681,Semenuks; Arturs,5,1,100,95
1657732431463,COGS 14B,A01,083073,Cheng; Tzu-Han,6,0,63,57
1657732437487,COGS 17,A01,092677,Semenuks; Arturs,6,0,81,75
1657732443514,COGS 100,A01,083619,Allen; Michael Gordon,17,0,70,53
1657732449538,COGS 101A,A01,083621,Davis; Joshua Daniel,9,0,68,59
1657732455559,COGS 101B,A01,091572,Allen; Michael Gordon,12,0,65,53
1657732461592,COGS 101C,A01,083625,Delgado; Tania,17,0,35,18
1657732467631,COGS 107A,A01,083627,Boyle; Mary E. T.,13,0,60,47
1657732473656,COGS 118A,A01,083075,Gupta; Anjum,21,0,76,55
1657732479681,CSE 3,A50,083646,Miranda; Gregory Joseph,24,0,50,26
1657732485709,CSE 8A,A50,083650,Miranda; Gregory Joseph,17,1,56,39
1657732491735,CSE 11,A01,083080,Cao; Yingjun,6,15,40,34
1657732497758,CSE 12,A01,083652,Krause-Levy; Sophia Louisa,28,1,120,92
1657732503780,CSE 15L,A01,083654,Morris; Justin Loren,9,0,50,41
1657732503780,CSE 15L,A02,083655,Morris; Justin Loren,9,0,50,41
1657732509803,CSE 20,A01,083657,Tran; Khoa Dang,39,0,80,41
1657732515829,CSE 21,A01,095574,Bach; Quang Tran,22,0,48,26
1657732521865,CSE 30,A01,083084,Eldon; John,6,0,80,74
1657732521865,CSE 30,B01,095061,Bhaskar; Nishant,9,0,50,41
1657732527888,CSE 100,A01,083659,Cao; Yingjun,5,4,70,65
1657732533916,CSE 134B,A01,083661,Powell; Thomas Allan,23,0,100,77
1657732539949,CSE 140,A01,083663,Gungor; Onat,15,0,85,70
1657732545976,CSE 140L,A01,083088,Eldon; John,23,0,100,77
1657732551999,CSE 175,A01,083665,Kumar; Rakesh,3,0,25,22
1657732558022,CSE 190,A00,092507,Dubnov; Shlomo,8,0,20,12
1657732564048,ECE 45,A01,083139,Congero; Spencer William,6,0,75,69
1657732570081,ECE 65,A50,083695,Saad; Andrew S,12,0,30,18
1657732570081,ECE 65,A51,095125,Saad; Andrew S,24,0,26,2
1657732576104,ECE 109,A01,091882,Touri; Behrouz,20,0,70,50
1657732582142,ECE 180,A00,083140,Abi Samra; Nicholas Camill,1,0,30,29
1657732582142,ECE 180,B00,083141,Abi Samra; Nicholas Camill,0,0,30,30
1657732588165,MATH 10A,A01,083735,Patchell; Gregory David,2,0,30,28
1657732588165,MATH 10A,A02,083736,Patchell; Gregory David,20,0,30,10
1657732588165,MATH 10A,A03,083737,Patchell; Gregory David,16,0,30,14
1657732594189,MATH 10B,A01,083207,Lim; Seonhee,8,0,34,26
1657732594189,MATH 10B,A02,083208,Lim; Seonhee,9,0,35,26
1657732594189,MATH 10B,A03,093472,Lim; Seonhee,7,0,34,27
1657732594189,MATH 10B,B01,083739,Sinha; Shubham,13,0,30,17
1657732600214,MATH 18,A01,083743,Cinel; Cameron Alexander,9,0,30,21
1657732600214,MATH 18,A02,083744,Cinel; Cameron Alexander,17,0,30,13
1657732600214,MATH 18,A03,083745,Cinel; Cameron Alexander,10,0,30,20
1657732600214,MATH 18,B01,083748,Rideout; David Porter,5,0,37,32
1657732600214,MATH 18,B02,083749,Rideout; David Porter,5,0,36,31
1657732600214,MATH 18,B03,083750,Rideout; David Porter,3,0,37,34
1657732600214,MATH 18,B04,083751,Rideout; David Porter,6,0,36,30
1657732600214,MATH 18,B05,093473,Rideout; David Porter,6,0,36,30
1657732600214,MATH 18,B06,093474,Rideout; David Porter,6,0,36,30
1657732606242,MATH 20A,A01,083754,Zheng; Zequn,14,0,40,26
1657732612270,MATH 20B,A01,083756,Briones; Jor-el Thomas Caparas,4,0,36,32
1657732612270,MATH 20B,A02,083757,Briones; Jor-el Thomas Caparas,1,0,36,35
1657732612270,MATH 20B,A03,093475,Briones; Jor-el Thomas Caparas,2,0,36,34
1657732618299,MATH 20C,A01,083760,Briones; Jor-el Thomas Caparas,1,0,35,34
1657732618299,MATH 20C,A02,083761,Briones; Jor-el Thomas Caparas,8,0,35,27
1657732618299,MATH 20C,A03,093476,Briones; Jor-el Thomas Caparas,0,1,36,36
1657732618299,MATH 20C,B01,083762,Bach; Quang Tran,1,0,30,29
1657732624328,MATH 20D,A01,083765,Tran; Brian Kha,5,0,30,25
1657732624328,MATH 20D,A02,083766,Tran; Brian Kha,5,0,30,25
1657732624328,MATH 20D,A03,083767,Tran; Brian Kha,5,0,30,25
1657732630360,MATH 20E,A01,083771,Ganguly; Soumya,9,0,32,23
1657732630360,MATH 20E,A02,083772,Ganguly; Soumya,6,0,32,26
1657732630360,MATH 20E,B01,083773,Ciotti; Benjamin,20,0,35,15
1657732630360,MATH 20E,B02,083774,Ciotti; Benjamin,18,0,35,17
1657732636384,MATH 103A,A01,083777,Greenfeld; Be'Eri,3,0,36,33
1657732636384,MATH 103A,A02,083778,Greenfeld; Be'Eri,5,0,36,31
1657732636384,MATH 103A,A03,093561,Greenfeld; Be'Eri,6,0,36,30
1657732636384,MATH 103A,B01,083779,Greenfeld; Be'Eri,7,0,36,29
1657732636384,MATH 103A,B02,083780,Greenfeld; Be'Eri,4,0,36,32
1657732636384,MATH 103A,B03,093562,Greenfeld; Be'Eri,3,0,36,33
1657732642409,MATH 105,A01,085443,Carter; Anne Toulson,15,0,35,20
1657732642409,MATH 105,A02,093477,Carter; Anne Toulson,20,0,35,15
1657732648432,MATH 109,A01,083213,Ganzberger; Geoffrey Michael,2,0,34,32
1657732648432,MATH 109,A02,083214,Ganzberger; Geoffrey Michael,4,0,34,30
1657732648432,MATH 109,A03,093478,Ganzberger; Geoffrey Michael,2,0,34,32
1657732648432,MATH 109,B01,083215,Ganzberger; Geoffrey Michael,1,0,32,31
1657732648432,MATH 109,B02,083216,Ganzberger; Geoffrey Michael,2,0,32,30
1657732648432,MATH 109,B03,093479,Ganzberger; Geoffrey Michael,8,0,32,24
1657732654457,MATH 142A,A01,083219,Chow; Bennett,7,0,32,25
1657732654457,MATH 142A,A02,083220,Chow; Bennett,10,0,32,22
1657732654457,MATH 142A,A03,093480,Chow; Bennett,9,0,32,23
1657732654457,MATH 142A,B03,093481,Chow; Bennett,8,0,32,24
1657732654457,MATH 142A,B04,093558,Chow; Bennett,13,0,32,19
1657732654457,MATH 142A,B05,093559,Chow; Bennett,6,0,32,26
1657732660480,MATH 193A,A01,083224,Rotar; Vladimir,8,0,34,26
1657732660480,MATH 193A,A02,083225,Rotar; Vladimir,9,0,34,25
1657732660480,MATH 193A,A03,083781,Rotar; Vladimir,5,0,34,29
1657732660480,MATH 193A,A04,083782,Rotar; Vladimir,10,0,34,24
1657732660480,MATH 193A,A05,093482,Rotar; Vladimir,10,0,34,24
1657732666503,MATH 197,001,091859,McAuley; Julian John,9999,0,9999,0
1657732666503,MATH 197,002,095566,Kedlaya; Kiran S.,9997,0,9999,2
1657732666503,MATH 197,003,095567,Xiao; Ming,9999,0,9999,0
1657732666503,MATH 197,004,095571,Perols; Johan Lars,9998,0,9999,1
1657732673561,COGS 9,A01,083615,Shannon; Kyle Michael,9,0,75,66
1657732679584,COGS 11,A01,083617,Boyle; Mary E. T.,23,0,48,25
1657732685607,COGS 13,A01,083071,Bastos; Amalia Pinkusfeld,11,0,71,60
1657732691632,COGS 14A,A01,092681,Semenuks; Arturs,5,1,100,95
1657732697654,COGS 14B,A01,083073,Cheng; Tzu-Han,6,0,63,57
1657732703677,COGS 17,A01,092677,Semenuks; Arturs,6,0,81,75
1657732709701,COGS 100,A01,083619,Allen; Michael Gordon,17,0,70,53
1657732715728,COGS 101A,A01,083621,Davis; Joshua Daniel,9,0,68,59
1657732721757,COGS 101B,A01,091572,Allen; Michael Gordon,12,0,65,53
1657732727780,COGS 101C,A01,083625,Delgado; Tania,17,0,35,18
1657732733814,COGS 107A,A01,083627,Boyle; Mary E. T.,13,0,60,47
1657732739841,COGS 118A,A01,083075,Gupta; Anjum,21,0,76,55
1657732745869,CSE 3,A50,083646,Miranda; Gregory Joseph,24,0,50,26
1657732751912,CSE 8A,A50,083650,Miranda; Gregory Joseph,17,1,56,39
1657732757935,CSE 11,A01,083080,Cao; Yingjun,6,15,40,34
1657732763962,CSE 12,A01,083652,Krause-Levy; Sophia Louisa,28,1,120,92
1657732769988,CSE 15L,A01,083654,Morris; Justin Loren,9,0,50,41
1657732769988,CSE 15L,A02,083655,Morris; Justin Loren,9,0,50,41
1657732776020,CSE 20,A01,083657,Tran; Khoa Dang,39,0,80,41
1657732782045,CSE 21,A01,095574,Bach; Quang Tran,22,0,48,26
1657732788088,CSE 30,A01,083084,Eldon; John,6,0,80,74
1657732788088,CSE 30,B01,095061,Bhaskar; Nishant,9,0,50,41
1657732794129,CSE 100,A01,083659,Cao; Yingjun,5,4,70,65
1657732800159,CSE 134B,A01,083661,Powell; Thomas Allan,23,0,100,77
1657732806187,CSE 140,A01,083663,Gungor; Onat,15,0,85,70
1657732812213,CSE 140L,A01,083088,Eldon; John,23,0,100,77
1657732818244,CSE 175,A01,083665,Kumar; Rakesh,3,0,25,22
1657732824274,CSE 190,A00,092507,Dubnov; Shlomo,8,0,20,12
1657732830301,ECE 45,A01,083139,Congero; Spencer William,6,0,75,69
1657732836326,ECE 65,A50,083695,Saad; Andrew S,12,0,30,18
1657732836326,ECE 65,A51,095125,Saad; Andrew S,24,0,26,2
1657732842352,ECE 109,A01,091882,Touri; Behrouz,20,0,70,50
1657732848375,ECE 180,A00,083140,Abi Samra; Nicholas Camill,1,0,30,29
1657732848375,ECE 180,B00,083141,Abi Samra; Nicholas Camill,0,0,30,30
1657732854398,MATH 10A,A01,083735,Patchell; Gregory David,2,0,30,28
1657732854398,MATH 10A,A02,083736,Patchell; Gregory David,20,0,30,10
1657732854398,MATH 10A,A03,083737,Patchell; Gregory David,16,0,30,14
1657732860421,MATH 10B,A01,083207,Lim; Seonhee,8,0,34,26
1657732860421,MATH 10B,A02,083208,Lim; Seonhee,9,0,35,26
1657732860421,MATH 10B,A03,093472,Lim; Seonhee,7,0,34,27
1657732860421,MATH 10B,B01,083739,Sinha; Shubham,13,0,30,17
1657732866446,MATH 18,A01,083743,Cinel; Cameron Alexander,9,0,30,21
1657732866446,MATH 18,A02,083744,Cinel; Cameron Alexander,17,0,30,13
1657732866446,MATH 18,A03,083745,Cinel; Cameron Alexander,10,0,30,20
1657732866446,MATH 18,B01,083748,Rideout; David Porter,5,0,37,32
1657732866446,MATH 18,B02,083749,Rideout; David Porter,5,0,36,31
1657732866446,MATH 18,B03,083750,Rideout; David Porter,3,0,37,34
1657732866446,MATH 18,B04,083751,Rideout; David Porter,6,0,36,30
1657732866446,MATH 18,B05,093473,Rideout; David Porter,6,0,36,30
1657732866446,MATH 18,B06,093474,Rideout; David Porter,6,0,36,30
1657732872469,MATH 20A,A01,083754,Zheng; Zequn,14,0,40,26
1657732878491,MATH 20B,A01,083756,Briones; Jor-el Thomas Caparas,4,0,36,32
1657732878491,MATH 20B,A02,083757,Briones; Jor-el Thomas Caparas,1,0,36,35
1657732878491,MATH 20B,A03,093475,Briones; Jor-el Thomas Caparas,2,0,36,34
1657732884520,MATH 20C,A01,083760,Briones; Jor-el Thomas Caparas,1,0,35,34
1657732884520,MATH 20C,A02,083761,Briones; Jor-el Thomas Caparas,8,0,35,27
1657732884520,MATH 20C,A03,093476,Briones; Jor-el Thomas Caparas,0,1,36,36
1657732884520,MATH 20C,B01,083762,Bach; Quang Tran,1,0,30,29
1657732890548,MATH 20D,A01,083765,Tran; Brian Kha,5,0,30,25
1657732890548,MATH 20D,A02,083766,Tran; Brian Kha,5,0,30,25
1657732890548,MATH 20D,A03,083767,Tran; Brian Kha,5,0,30,25
1657732896576,MATH 20E,A01,083771,Ganguly; Soumya,9,0,32,23
1657732896576,MATH 20E,A02,083772,Ganguly; Soumya,6,0,32,26
1657732896576,MATH 20E,B01,083773,Ciotti; Benjamin,20,0,35,15
1657732896576,MATH 20E,B02,083774,Ciotti; Benjamin,18,0,35,17
1657732902608,MATH 103A,A01,083777,Greenfeld; Be'Eri,3,0,36,33
1657732902608,MATH 103A,A02,083778,Greenfeld; Be'Eri,5,0,36,31
1657732902608,MATH 103A,A03,093561,Greenfeld; Be'Eri,6,0,36,30
1657732902608,MATH 103A,B01,083779,Greenfeld; Be'Eri,7,0,36,29
1657732902608,MATH 103A,B02,083780,Greenfeld; Be'Eri,4,0,36,32
1657732902608,MATH 103A,B03,093562,Greenfeld; Be'Eri,3,0,36,33
1657732908639,MATH 105,A01,085443,Carter; Anne Toulson,15,0,35,20
1657732908639,MATH 105,A02,093477,Carter; Anne Toulson,20,0,35,15
1657732914664,MATH 109,A01,083213,Ganzberger; Geoffrey Michael,2,0,34,32
1657732914664,MATH 109,A02,083214,Ganzberger; Geoffrey Michael,4,0,34,30
1657732914664,MATH 109,A03,093478,Ganzberger; Geoffrey Michael,2,0,34,32
1657732914664,MATH 109,B01,083215,Ganzberger; Geoffrey Michael,1,0,32,31
1657732914664,MATH 109,B02,083216,Ganzberger; Geoffrey Michael,2,0,32,30
1657732914664,MATH 109,B03,093479,Ganzberger; Geoffrey Michael,8,0,32,24
1657732920696,MATH 142A,A01,083219,Chow; Bennett,7,0,32,25
1657732920696,MATH 142A,A02,083220,Chow; Bennett,10,0,32,22
1657732920696,MATH 142A,A03,093480,Chow; Bennett,9,0,32,23
1657732920696,MATH 142A,B03,093481,Chow; Bennett,8,0,32,24
1657732920696,MATH 142A,B04,093558,Chow; Bennett,13,0,32,19
1657732920696,MATH 142A,B05,093559,Chow; Bennett,6,0,32,26
1657732926726,MATH 193A,A01,083224,Rotar; Vladimir,8,0,34,26
1657732926726,MATH 193A,A02,083225,Rotar; Vladimir,9,0,34,25
1657732926726,MATH 193A,A03,083781,Rotar; Vladimir,5,0,34,29
1657732926726,MATH 193A,A04,083782,Rotar; Vladimir,10,0,34,24
1657732926726,MATH 193A,A05,093482,Rotar; Vladimir,10,0,34,24
1657732932826,MATH 197,001,091859,McAuley; Julian John,9999,0,9999,0
1657732932826,MATH 197,002,095566,Kedlaya; Kiran S.,9997,0,9999,2
1657732932826,MATH 197,003,095567,Xiao; Ming,9999,0,9999,0
1657732932826,MATH 197,004,095571,Perols; Johan Lars,9998,0,9999,1
1657732939892,COGS 9,A01,083615,Shannon; Kyle Michael,9,0,75,66
1657732945915,COGS 11,A01,083617,Boyle; Mary E. T.,23,0,48,25
1657732951943,COGS 13,A01,083071,Bastos; Amalia Pinkusfeld,11,0,71,60
1657732957974,COGS 14A,A01,092681,Semenuks; Arturs,5,1,100,95
1657732964002,COGS 14B,A01,083073,Cheng; Tzu-Han,6,0,63,57
1657732970038,COGS 17,A01,092677,Semenuks; Arturs,6,0,81,75
1657732976061,COGS 100,A01,083619,Allen; Michael Gordon,17,0,70,53
1657732982086,COGS 101A,A01,083621,Davis; Joshua Daniel,9,0,68,59
1657732988113,COGS 101B,A01,091572,Allen; Michael Gordon,12,0,65,53
1657732994139,COGS 101C,A01,083625,Delgado; Tania,17,0,35,18
1657733000168,COGS 107A,A01,083627,Boyle; Mary E. T.,13,0,60,47
1657733006194,COGS 118A,A01,083075,Gupta; Anjum,21,0,76,55
1657733012217,CSE 3,A50,083646,Miranda; Gregory Joseph,24,0,50,26
1657733018244,CSE 8A,A50,083650,Miranda; Gregory Joseph,17,1,56,39
1657733024270,CSE 11,A01,083080,Cao; Yingjun,6,15,40,34
1657733030297,CSE 12,A01,083652,Krause-Levy; Sophia Louisa,28,1,120,92
1657733036321,CSE 15L,A01,083654,Morris; Justin Loren,9,0,50,41
1657733036321,CSE 15L,A02,083655,Morris; Justin Loren,9,0,50,41
1657733042351,CSE 20,A01,083657,Tran; Khoa Dang,39,0,80,41
1657733048377,CSE 21,A01,095574,Bach; Quang Tran,22,0,48,26
1657733054406,CSE 30,A01,083084,Eldon; John,6,0,80,74
1657733054406,CSE 30,B01,095061,Bhaskar; Nishant,9,0,50,41
1657733060429,CSE 100,A01,083659,Cao; Yingjun,5,4,70,65
1657733066456,CSE 134B,A01,083661,Powell; Thomas Allan,23,0,100,77
1657733072480,CSE 140,A01,083663,Gungor; Onat,15,0,85,70
1657733078506,CSE 140L,A01,083088,Eldon; John,23,0,100,77
1657733084537,CSE 175,A01,083665,Kumar; Rakesh,3,0,25,22
1657733090564,CSE 190,A00,092507,Dubnov; Shlomo,8,0,20,12
1657733096595,ECE 45,A01,083139,Congero; Spencer William,6,0,75,69
1657733102619,ECE 65,A50,083695,Saad; Andrew S,12,0,30,18
1657733102619,ECE 65,A51,095125,Saad; Andrew S,24,0,26,2
1657733108642,ECE 109,A01,091882,Touri; Behrouz,20,0,70,50
1657733114668,ECE 180,A00,083140,Abi Samra; Nicholas Camill,1,0,30,29
1657733114668,ECE 180,B00,083141,Abi Samra; Nicholas Camill,0,0,30,30
1657733120691,MATH 10A,A01,083735,Patchell; Gregory David,2,0,30,28
1657733120691,MATH 10A,A02,083736,Patchell; Gregory David,20,0,30,10
1657733120691,MATH 10A,A03,083737,Patchell; Gregory David,16,0,30,14
1657733126720,MATH 10B,A01,083207,Lim; Seonhee,8,0,34,26
1657733126720,MATH 10B,A02,083208,Lim; Seonhee,9,0,35,26
1657733126720,MATH 10B,A03,093472,Lim; Seonhee,7,0,34,27
1657733126720,MATH 10B,B01,083739,Sinha; Shubham,13,0,30,17
1657733132744,MATH 18,A01,083743,Cinel; Cameron Alexander,9,0,30,21
1657733132744,MATH 18,A02,083744,Cinel; Cameron Alexander,17,0,30,13
1657733132744,MATH 18,A03,083745,Cinel; Cameron Alexander,10,0,30,20
1657733132744,MATH 18,B01,083748,Rideout; David Porter,5,0,37,32
1657733132744,MATH 18,B02,083749,Rideout; David Porter,5,0,36,31
1657733132744,MATH 18,B03,083750,Rideout; David Porter,3,0,37,34
1657733132744,MATH 18,B04,083751,Rideout; David Porter,6,0,36,30
1657733132744,MATH 18,B05,093473,Rideout; David Porter,6,0,36,30
1657733132744,MATH 18,B06,093474,Rideout; David Porter,6,0,36,30
1657733138767,MATH 20A,A01,083754,Zheng; Zequn,14,0,40,26
1657733144796,MATH 20B,A01,083756,Briones; Jor-el Thomas Caparas,4,0,36,32
1657733144796,MATH 20B,A02,083757,Briones; Jor-el Thomas Caparas,1,0,36,35
1657733144796,MATH 20B,A03,093475,Briones; Jor-el Thomas Caparas,2,0,36,34
1657733150822,MATH 20C,A01,083760,Briones; Jor-el Thomas Caparas,1,0,35,34
1657733150822,MATH 20C,A02,083761,Briones; Jor-el Thomas Caparas,8,0,35,27
1657733150822,MATH 20C,A03,093476,Briones; Jor-el Thomas Caparas,0,1,36,36
1657733150822,MATH 20C,B01,083762,Bach; Quang Tran,1,0,30,29
1657733156849,MATH 20D,A01,083765,Tran; Brian Kha,5,0,30,25
1657733156849,MATH 20D,A02,083766,Tran; Brian Kha,5,0,30,25
1657733156849,MATH 20D,A03,083767,Tran; Brian Kha,5,0,30,25
1657733162872,MATH 20E,A01,083771,Ganguly; Soumya,9,0,32,23
1657733162872,MATH 20E,A02,083772,Ganguly; Soumya,6,0,32,26
1657733162872,MATH 20E,B01,083773,Ciotti; Benjamin,20,0,35,15
1657733162872,MATH 20E,B02,083774,Ciotti; Benjamin,18,0,35,17
1657733168896,MATH 103A,A01,083777,Greenfeld; Be'Eri,3,0,36,33
1657733168896,MATH 103A,A02,083778,Greenfeld; Be'Eri,5,0,36,31
1657733168896,MATH 103A,A03,093561,Greenfeld; Be'Eri,6,0,36,30
1657733168896,MATH 103A,B01,083779,Greenfeld; Be'Eri,7,0,36,29
1657733168896,MATH 103A,B02,083780,Greenfeld; Be'Eri,4,0,36,32
1657733168896,MATH 103A,B03,093562,Greenfeld; Be'Eri,3,0,36,33
1657733174920,MATH 105,A01,085443,Carter; Anne Toulson,15,0,35,20
1657733174920,MATH 105,A02,093477,Carter; Anne Toulson,20,0,35,15
1657733180948,MATH 109,A01,083213,Ganzberger; Geoffrey Michael,2,0,34,32
1657733180948,MATH 109,A02,083214,Ganzberger; Geoffrey Michael,4,0,34,30
1657733180948,MATH 109,A03,093478,Ganzberger; Geoffrey Michael,2,0,34,32
1657733180948,MATH 109,B01,083215,Ganzberger; Geoffrey Michael,1,0,32,31
1657733180948,MATH 109,B02,083216,Ganzberger; Geoffrey Michael,2,0,32,30
1657733180948,MATH 109,B03,093479,Ganzberger; Geoffrey Michael,8,0,32,24
1657733186970,MATH 142A,A01,083219,Chow; Bennett,7,0,32,25
1657733186970,MATH 142A,A02,083220,Chow; Bennett,10,0,32,22
1657733186970,MATH 142A,A03,093480,Chow; Bennett,9,0,32,23
1657733186970,MATH 142A,B03,093481,Chow; Bennett,8,0,32,24
1657733186970,MATH 142A,B04,093558,Chow; Bennett,13,0,32,19
1657733186970,MATH 142A,B05,093559,Chow; Bennett,6,0,32,26
1657733192995,MATH 193A,A01,083224,Rotar; Vladimir,8,0,34,26
1657733192995,MATH 193A,A02,083225,Rotar; Vladimir,9,0,34,25
1657733192995,MATH 193A,A03,083781,Rotar; Vladimir,5,0,34,29
1657733192995,MATH 193A,A04,083782,Rotar; Vladimir,10,0,34,24
1657733192995,MATH 193A,A05,093482,Rotar; Vladimir,10,0,34,24
1657733199023,MATH 197,001,091859,McAuley; Julian John,9999,0,9999,0
1657733199023,MATH 197,002,095566,Kedlaya; Kiran S.,9997,0,9999,2
1657733199023,MATH 197,003,095567,Xiao; Ming,9999,0,9999,0
1657733199023,MATH 197,004,095571,Perols; Johan Lars,9998,0,9999,1
1657733206075,COGS 9,A01,083615,Shannon; Kyle Michael,9,0,75,66
1657733212100,COGS 11,A01,083617,Boyle; Mary E. T.,23,0,48,25
1657733218124,COGS 13,A01,083071,Bastos; Amalia Pinkusfeld,11,0,71,60
1657733224147,COGS 14A,A01,092681,Semenuks; Arturs,5,1,100,95
1657733230177,COGS 14B,A01,083073,Cheng; Tzu-Han,6,0,63,57
1657733236201,COGS 17,A01,092677,Semenuks; Arturs,6,0,81,75
1657733242230,COGS 100,A01,083619,Allen; Michael Gordon,17,0,70,53
1657733248266,COGS 101A,A01,083621,Davis; Joshua Daniel,9,0,68,59
1657733254292,COGS 101B,A01,091572,Allen; Michael Gordon,12,0,65,53
1657733260320,COGS 101C,A01,083625,Delgado; Tania,17,0,35,18
1657733266347,COGS 107A,A01,083627,Boyle; Mary E. T.,13,0,60,47
1657733272378,COGS 118A,A01,083075,Gupta; Anjum,21,0,76,55
1657733278402,CSE 3,A50,083646,Miranda; Gregory Joseph,24,0,50,26
1657733284424,CSE 8A,A50,083650,Miranda; Gregory Joseph,17,1,56,39
1657733290460,CSE 11,A01,083080,Cao; Yingjun,6,15,40,34
1657733296494,CSE 12,A01,083652,Krause-Levy; Sophia Louisa,28,1,120,92
1657733302521,CSE 15L,A01,083654,Morris; Justin Loren,9,0,50,41
1657733302521,CSE 15L,A02,083655,Morris; Justin Loren,9,0,50,41
1657733308547,CSE 20,A01,083657,Tran; Khoa Dang,39,0,80,41
1657733314574,CSE 21,A01,095574,Bach; Quang Tran,22,0,48,26
1657733320596,CSE 30,A01,083084,Eldon; John,6,0,80,74
1657733320596,CSE 30,B01,095061,Bhaskar; Nishant,9,0,50,41
1657733326620,CSE 100,A01,083659,Cao; Yingjun,5,4,70,65
1657733332647,CSE 134B,A01,083661,Powell; Thomas Allan,23,0,100,77
1657733338671,CSE 140,A01,083663,Gungor; Onat,15,0,85,70
1657733344695,CSE 140L,A01,083088,Eldon; John,23,0,100,77
1657733350721,CSE 175,A01,083665,Kumar; Rakesh,3,0,25,22
1657733356755,CSE 190,A00,092507,Dubnov; Shlomo,8,0,20,12
1657733362777,ECE 45,A01,083139,Congero; Spencer William,6,0,75,69
1657733368801,ECE 65,A50,083695,Saad; Andrew S,12,0,30,18
1657733368801,ECE 65,A51,095125,Saad; Andrew S,24,0,26,2
1657733374826,ECE 109,A01,091882,Touri; Behrouz,20,0,70,50
1657733380857,ECE 180,A00,083140,Abi Samra; Nicholas Camill,1,0,30,29
1657733380857,ECE 180,B00,083141,Abi Samra; Nicholas Camill,0,0,30,30
1657733386885,MATH 10A,A01,083735,Patchell; Gregory David,2,0,30,28
1657733386885,MATH 10A,A02,083736,Patchell; Gregory David,20,0,30,10
1657733386885,MATH 10A,A03,083737,Patchell; Gregory David,16,0,30,14
1657733392910,MATH 10B,A01,083207,Lim; Seonhee,8,0,34,26
1657733392910,MATH 10B,A02,083208,Lim; Seonhee,9,0,35,26
1657733392910,MATH 10B,A03,093472,Lim; Seonhee,7,0,34,27
1657733392910,MATH 10B,B01,083739,Sinha; Shubham,13,0,30,17
1657733398934,MATH 18,A01,083743,Cinel; Cameron Alexander,9,0,30,21
1657733398934,MATH 18,A02,083744,Cinel; Cameron Alexander,17,0,30,13
1657733398934,MATH 18,A03,083745,Cinel; Cameron Alexander,10,0,30,20
1657733398934,MATH 18,B01,083748,Rideout; David Porter,5,0,37,32
1657733398934,MATH 18,B02,083749,Rideout; David Porter,5,0,36,31
1657733398934,MATH 18,B03,083750,Rideout; David Porter,3,0,37,34
1657733398934,MATH 18,B04,083751,Rideout; David Porter,6,0,36,30
1657733398934,MATH 18,B05,093473,Rideout; David Porter,6,0,36,30
1657733398934,MATH 18,B06,093474,Rideout; David Porter,6,0,36,30
1657733404960,MATH 20A,A01,083754,Zheng; Zequn,14,0,40,26
1657733410985,MATH 20B,A01,083756,Briones; Jor-el Thomas Caparas,4,0,36,32
1657733410985,MATH 20B,A02,083757,Briones; Jor-el Thomas Caparas,1,0,36,35
1657733410985,MATH 20B,A03,093475,Briones; Jor-el Thomas Caparas,2,0,36,34
1657733417011,MATH 20C,A01,083760,Briones; Jor-el Thomas Caparas,1,0,35,34
1657733417011,MATH 20C,A02,083761,Briones; Jor-el Thomas Caparas,8,0,35,27
1657733417011,MATH 20C,A03,093476,Briones; Jor-el Thomas Caparas,0,1,36,36
1657733417011,MATH 20C,B01,083762,Bach; Quang Tran,1,0,30,29
1657733423041,MATH 20D,A01,083765,Tran; Brian Kha,5,0,30,25
1657733423041,MATH 20D,A02,083766,Tran; Brian Kha,5,0,30,25
1657733423041,MATH 20D,A03,083767,Tran; Brian Kha,5,0,30,25
1657733429068,MATH 20E,A01,083771,Ganguly; Soumya,9,0,32,23
1657733429068,MATH 20E,A02,083772,Ganguly; Soumya,6,0,32,26
1657733429068,MATH 20E,B01,083773,Ciotti; Benjamin,20,0,35,15
1657733429068,MATH 20E,B02,083774,Ciotti; Benjamin,18,0,35,17
1657733435091,MATH 103A,A01,083777,Greenfeld; Be'Eri,3,0,36,33
1657733435091,MATH 103A,A02,083778,Greenfeld; Be'Eri,5,0,36,31
1657733435091,MATH 103A,A03,093561,Greenfeld; Be'Eri,6,0,36,30
1657733435091,MATH 103A,B01,083779,Greenfeld; Be'Eri,7,0,36,29
1657733435091,MATH 103A,B02,083780,Greenfeld; Be'Eri,4,0,36,32
1657733435091,MATH 103A,B03,093562,Greenfeld; Be'Eri,3,0,36,33
1657733441129,MATH 105,A01,085443,Carter; Anne Toulson,15,0,35,20
1657733441129,MATH 105,A02,093477,Carter; Anne Toulson,20,0,35,15
1657733447160,MATH 109,A01,083213,Ganzberger; Geoffrey Michael,2,0,34,32
1657733447160,MATH 109,A02,083214,Ganzberger; Geoffrey Michael,4,0,34,30
1657733447160,MATH 109,A03,093478,Ganzberger; Geoffrey Michael,2,0,34,32
1657733447160,MATH 109,B01,083215,Ganzberger; Geoffrey Michael,1,0,32,31
1657733447160,MATH 109,B02,083216,Ganzberger; Geoffrey Michael,2,0,32,30
1657733447160,MATH 109,B03,093479,Ganzberger; Geoffrey Michael,8,0,32,24
1657733453202,MATH 142A,A01,083219,Chow; Bennett,7,0,32,25
1657733453202,MATH 142A,A02,083220,Chow; Bennett,10,0,32,22
1657733453202,MATH 142A,A03,093480,Chow; Bennett,9,0,32,23
1657733453202,MATH 142A,B03,093481,Chow; Bennett,8,0,32,24
1657733453202,MATH 142A,B04,093558,Chow; Bennett,13,0,32,19
1657733453202,MATH 142A,B05,093559,Chow; Bennett,6,0,32,26
1657733459228,MATH 193A,A01,083224,Rotar; Vladimir,8,0,34,26
1657733459228,MATH 193A,A02,083225,Rotar; Vladimir,9,0,34,25
1657733459228,MATH 193A,A03,083781,Rotar; Vladimir,5,0,34,29
1657733459228,MATH 193A,A04,083782,Rotar; Vladimir,10,0,34,24
1657733459228,MATH 193A,A05,093482,Rotar; Vladimir,10,0,34,24
1657733465256,MATH 197,001,091859,McAuley; Julian John,9999,0,9999,0
1657733465256,MATH 197,002,095566,Kedlaya; Kiran S.,9997,0,9999,2
1657733465256,MATH 197,003,095567,Xiao; Ming,9999,0,9999,0
1657733465256,MATH 197,004,095571,Perols; Johan Lars,9998,0,9999,1
1657733472323,COGS 9,A01,083615,Shannon; Kyle Michael,9,0,75,66
1657733478349,COGS 11,A01,083617,Boyle; Mary E. T.,23,0,48,25
1657733484372,COGS 13,A01,083071,Bastos; Amalia Pinkusfeld,11,0,71,60
1657733490395,COGS 14A,A01,092681,Semenuks; Arturs,5,1,100,95
1657733496417,COGS 14B,A01,083073,Cheng; Tzu-Han,6,0,63,57
1657733502440,COGS 17,A01,092677,Semenuks; Arturs,6,0,81,75
1657733508462,COGS 100,A01,083619,Allen; Michael Gordon,17,0,70,53
1657733514498,COGS 101A,A01,083621,Davis; Joshua Daniel,9,0,68,59
1657733520527,COGS 101B,A01,091572,Allen; Michael Gordon,12,0,65,53
1657733526625,COGS 101C,A01,083625,Delgado; Tania,17,0,35,18
1657733532648,COGS 107A,A01,083627,Boyle; Mary E. T.,13,0,60,47
1657733538675,COGS 118A,A01,083075,Gupta; Anjum,21,0,76,55
1657733544710,CSE 3,A50,083646,Miranda; Gregory Joseph,24,0,50,26
1657733550738,CSE 8A,A50,083650,Miranda; Gregory Joseph,17,1,56,39
1657733556761,CSE 11,A01,083080,Cao; Yingjun,6,15,40,34
1657733562791,CSE 12,A01,083652,Krause-Levy; Sophia Louisa,28,1,120,92
1657733568813,CSE 15L,A01,083654,Morris; Justin Loren,9,0,50,41
1657733568813,CSE 15L,A02,083655,Morris; Justin Loren,9,0,50,41
1657733574841,CSE 20,A01,083657,Tran; Khoa Dang,39,0,80,41
1657733580881,CSE 21,A01,095574,Bach; Quang Tran,22,0,48,26
1657733586916,CSE 30,A01,083084,Eldon; John,6,0,80,74
1657733586916,CSE 30,B01,095061,Bhaskar; Nishant,9,0,50,41
1657733592939,CSE 100,A01,083659,Cao; Yingjun,5,4,70,65
1657733598961,CSE 134B,A01,083661,Powell; Thomas Allan,23,0,100,77
1657733604988,CSE 140,A01,083663,Gungor; Onat,15,0,85,70
1657733611023,CSE 140L,A01,083088,Eldon; John,23,0,100,77
1657733617046,CSE 175,A01,083665,Kumar; Rakesh,3,0,25,22
1657733623069,CSE 190,A00,092507,Dubnov; Shlomo,8,0,20,12
1657733629096,ECE 45,A01,083139,Congero; Spencer William,6,0,75,69
1657733635121,ECE 65,A50,083695,Saad; Andrew S,12,0,30,18
1657733635121,ECE 65,A51,095125,Saad; Andrew S,24,0,26,2
1657733641156,ECE 109,A01,091882,Touri; Behrouz,20,0,70,50
1657733647184,ECE 180,A00,083140,Abi Samra; Nicholas Camill,1,0,30,29
1657733647184,ECE 180,B00,083141,Abi Samra; Nicholas Camill,0,0,30,30
1657733666769,MATH 10A,A01,083735,Patchell; Gregory David,2,0,30,28
1657733666769,MATH 10A,A02,083736,Patchell; Gregory David,20,0,30,10
1657733666769,MATH 10A,A03,083737,Patchell; Gregory David,16,0,30,14
1657733672803,MATH 10B,A01,083207,Lim; Seonhee,8,0,34,26
1657733672803,MATH 10B,A02,083208,Lim; Seonhee,9,0,35,26
1657733672803,MATH 10B,A03,093472,Lim; Seonhee,7,0,34,27
1657733672803,MATH 10B,B01,083739,Sinha; Shubham,13,0,30,17
1657733678830,MATH 18,A01,083743,Cinel; Cameron Alexander,9,0,30,21
1657733678830,MATH 18,A02,083744,Cinel; Cameron Alexander,17,0,30,13
1657733678830,MATH 18,A03,083745,Cinel; Cameron Alexander,10,0,30,20
1657733678830,MATH 18,B01,083748,Rideout; David Porter,5,0,37,32
1657733678830,MATH 18,B02,083749,Rideout; David Porter,5,0,36,31
1657733678830,MATH 18,B03,083750,Rideout; David Porter,3,0,37,34
1657733678830,MATH 18,B04,083751,Rideout; David Porter,6,0,36,30
1657733678830,MATH 18,B05,093473,Rideout; David Porter,6,0,36,30
1657733678830,MATH 18,B06,093474,Rideout; David Porter,6,0,36,30
1657733684857,MATH 20A,A01,083754,Zheng; Zequn,14,0,40,26
1657733690895,MATH 20B,A01,083756,Briones; Jor-el Thomas Caparas,4,0,36,32
1657733690895,MATH 20B,A02,083757,Briones; Jor-el Thomas Caparas,1,0,36,35
1657733690895,MATH 20B,A03,093475,Briones; Jor-el Thomas Caparas,2,0,36,34
1657733696925,MATH 20C,A01,083760,Briones; Jor-el Thomas Caparas,1,0,35,34
1657733696925,MATH 20C,A02,083761,Briones; Jor-el Thomas Caparas,8,0,35,27
1657733696925,MATH 20C,A03,093476,Briones; Jor-el Thomas Caparas,0,1,36,36
1657733696925,MATH 20C,B01,083762,Bach; Quang Tran,1,0,30,29
1657733702948,MATH 20D,A01,083765,Tran; Brian Kha,5,0,30,25
1657733702948,MATH 20D,A02,083766,Tran; Brian Kha,5,0,30,25
1657733702948,MATH 20D,A03,083767,Tran; Brian Kha,5,0,30,25
1657733708970,MATH 20E,A01,083771,Ganguly; Soumya,9,0,32,23
1657733708970,MATH 20E,A02,083772,Ganguly; Soumya,6,0,32,26
1657733708970,MATH 20E,B01,083773,Ciotti; Benjamin,20,0,35,15
1657733708970,MATH 20E,B02,083774,Ciotti; Benjamin,18,0,35,17
1657733714999,MATH 103A,A01,083777,Greenfeld; Be'Eri,3,0,36,33
1657733714999,MATH 103A,A02,083778,Greenfeld; Be'Eri,5,0,36,31
1657733714999,MATH 103A,A03,093561,Greenfeld; Be'Eri,6,0,36,30
1657733714999,MATH 103A,B01,083779,Greenfeld; Be'Eri,7,0,36,29
1657733714999,MATH 103A,B02,083780,Greenfeld; Be'Eri,4,0,36,32
1657733714999,MATH 103A,B03,093562,Greenfeld; Be'Eri,3,0,36,33
1657733721022,MATH 105,A01,085443,Carter; Anne Toulson,15,0,35,20
1657733721022,MATH 105,A02,093477,Carter; Anne Toulson,20,0,35,15
1657733727056,MATH 109,A01,083213,Ganzberger; Geoffrey Michael,2,0,34,32
1657733727056,MATH 109,A02,083214,Ganzberger; Geoffrey Michael,4,0,34,30
1657733727056,MATH 109,A03,093478,Ganzberger; Geoffrey Michael,2,0,34,32
1657733727056,MATH 109,B01,083215,Ganzberger; Geoffrey Michael,1,0,32,31
1657733727056,MATH 109,B02,083216,Ganzberger; Geoffrey Michael,2,0,32,30
1657733727056,MATH 109,B03,093479,Ganzberger; Geoffrey Michael,8,0,32,24
1657733733090,MATH 142A,A01,083219,Chow; Bennett,7,0,32,25
1657733733090,MATH 142A,A02,083220,Chow; Bennett,10,0,32,22
1657733733090,MATH 142A,A03,093480,Chow; Bennett,9,0,32,23
1657733733090,MATH 142A,B03,093481,Chow; Bennett,8,0,32,24
1657733733090,MATH 142A,B04,093558,Chow; Bennett,13,0,32,19
1657733733090,MATH 142A,B05,093559,Chow; Bennett,6,0,32,26
1657733739118,MATH 193A,A01,083224,Rotar; Vladimir,8,0,34,26
1657733739118,MATH 193A,A02,083225,Rotar; Vladimir,9,0,34,25
1657733739118,MATH 193A,A03,083781,Rotar; Vladimir,5,0,34,29
1657733739118,MATH 193A,A04,083782,Rotar; Vladimir,10,0,34,24
1657733739118,MATH 193A,A05,093482,Rotar; Vladimir,10,0,34,24
1657733745141,MATH 197,001,091859,McAuley; Julian John,9999,0,9999,0
1657733745141,MATH 197,002,095566,Kedlaya; Kiran S.,9997,0,9999,2
1657733745141,MATH 197,003,095567,Xiao; Ming,9999,0,9999,0
1657733745141,MATH 197,004,095571,Perols; Johan Lars,9998,0,9999,1
1657733752205,COGS 9,A01,083615,Shannon; Kyle Michael,9,0,75,66
1657733758231,COGS 11,A01,083617,Boyle; Mary E. T.,23,0,48,25
1657733764257,COGS 13,A01,083071,Bastos; Amalia Pinkusfeld,11,0,71,60
1657733770283,COGS 14A,A01,092681,Semenuks; Arturs,5,1,100,95
1657733776305,COGS 14B,A01,083073,Cheng; Tzu-Han,6,0,63,57
1657733782331,COGS 17,A01,092677,Semenuks; Arturs,6,0,81,75
1657733788362,COGS 100,A01,083619,Allen; Michael Gordon,17,0,70,53
1657733794386,COGS 101A,A01,083621,Davis; Joshua Daniel,9,0,68,59
1657733800412,COGS 101B,A01,091572,Allen; Michael Gordon,12,0,65,53
1657733806440,COGS 101C,A01,083625,Delgado; Tania,17,0,35,18
1657733812463,COGS 107A,A01,083627,Boyle; Mary E. T.,13,0,60,47
1657733818486,COGS 118A,A01,083075,Gupta; Anjum,21,0,76,55
1657733824516,CSE 3,A50,083646,Miranda; Gregory Joseph,24,0,50,26
1657733830543,CSE 8A,A50,083650,Miranda; Gregory Joseph,17,1,56,39
1657733836572,CSE 11,A01,083080,Cao; Yingjun,6,15,40,34
1657733842596,CSE 12,A01,083652,Krause-Levy; Sophia Louisa,28,1,120,92
1657733848619,CSE 15L,A01,083654,Morris; Justin Loren,9,0,50,41
1657733848619,CSE 15L,A02,083655,Morris; Justin Loren,9,0,50,41
1657733854647,CSE 20,A01,083657,Tran; Khoa Dang,39,0,80,41
1657733860676,CSE 21,A01,095574,Bach; Quang Tran,22,0,48,26
1657733866708,CSE 30,A01,083084,Eldon; John,6,0,80,74
1657733866708,CSE 30,B01,095061,Bhaskar; Nishant,9,0,50,41
1657733872734,CSE 100,A01,083659,Cao; Yingjun,5,4,70,65
1657733878759,CSE 134B,A01,083661,Powell; Thomas Allan,23,0,100,77
1657733884780,CSE 140,A01,083663,Gungor; Onat,15,0,85,70
1657733890806,CSE 140L,A01,083088,Eldon; John,23,0,100,77
1657733896830,CSE 175,A01,083665,Kumar; Rakesh,3,0,25,22
1657733902856,CSE 190,A00,092507,Dubnov; Shlomo,8,0,20,12
1657733908883,ECE 45,A01,083139,Congero; Spencer William,6,0,75,69
1657733914917,ECE 65,A50,083695,Saad; Andrew S,12,0,30,18
1657733914917,ECE 65,A51,095125,Saad; Andrew S,24,0,26,2
1657733920943,ECE 109,A01,091882,Touri; Behrouz,20,0,70,50
1657733926979,ECE 180,A00,083140,Abi Samra; Nicholas Camill,1,0,30,29
1657733926979,ECE 180,B00,083141,Abi Samra; Nicholas Camill,0,0,30,30
1657733933004,MATH 10A,A01,083735,Patchell; Gregory David,2,0,30,28
1657733933004,MATH 10A,A02,083736,Patchell; Gregory David,20,0,30,10
1657733933004,MATH 10A,A03,083737,Patchell; Gregory David,16,0,30,14
1657733939032,MATH 10B,A01,083207,Lim; Seonhee,8,0,34,26
1657733939032,MATH 10B,A02,083208,Lim; Seonhee,9,0,35,26
1657733939032,MATH 10B,A03,093472,Lim; Seonhee,7,0,34,27
1657733939032,MATH 10B,B01,083739,Sinha; Shubham,13,0,30,17
1657733945062,MATH 18,A01,083743,Cinel; Cameron Alexander,9,0,30,21
1657733945062,MATH 18,A02,083744,Cinel; Cameron Alexander,17,0,30,13
1657733945062,MATH 18,A03,083745,Cinel; Cameron Alexander,10,0,30,20
1657733945062,MATH 18,B01,083748,Rideout; David Porter,5,0,37,32
1657733945062,MATH 18,B02,083749,Rideout; David Porter,5,0,36,31
1657733945062,MATH 18,B03,083750,Rideout; David Porter,3,0,37,34
1657733945062,MATH 18,B04,083751,Rideout; David Porter,6,0,36,30
1657733945062,MATH 18,B05,093473,Rideout; David Porter,6,0,36,30
1657733945062,MATH 18,B06,093474,Rideout; David Porter,6,0,36,30
1657733951087,MATH 20A,A01,083754,Zheng; Zequn,14,0,40,26
1657733957111,MATH 20B,A01,083756,Briones; Jor-el Thomas Caparas,4,0,36,32
1657733957111,MATH 20B,A02,083757,Briones; Jor-el Thomas Caparas,1,0,36,35
1657733957111,MATH 20B,A03,093475,Briones; Jor-el Thomas Caparas,2,0,36,34
1657733963150,MATH 20C,A01,083760,Briones; Jor-el Thomas Caparas,1,0,35,34
1657733963150,MATH 20C,A02,083761,Briones; Jor-el Thomas Caparas,8,0,35,27
1657733963150,MATH 20C,A03,093476,Briones; Jor-el Thomas Caparas,0,1,36,36
1657733963150,MATH 20C,B01,083762,Bach; Quang Tran,1,0,30,29
1657733969187,MATH 20D,A01,083765,Tran; Brian Kha,5,0,30,25
1657733969187,MATH 20D,A02,083766,Tran; Brian Kha,5,0,30,25
1657733969187,MATH 20D,A03,083767,Tran; Brian Kha,5,0,30,25
1657733975210,MATH 20E,A01,083771,Ganguly; Soumya,9,0,32,23
1657733975210,MATH 20E,A02,083772,Ganguly; Soumya,6,0,32,26
1657733975210,MATH 20E,B01,083773,Ciotti; Benjamin,20,0,35,15
1657733975210,MATH 20E,B02,083774,Ciotti; Benjamin,18,0,35,17
1657733981244,MATH 103A,A01,083777,Greenfeld; Be'Eri,3,0,36,33
1657733981244,MATH 103A,A02,083778,Greenfeld; Be'Eri,5,0,36,31
1657733981244,MATH 103A,A03,093561,Greenfeld; Be'Eri,6,0,36,30
1657733981244,MATH 103A,B01,083779,Greenfeld; Be'Eri,7,0,36,29
1657733981244,MATH 103A,B02,083780,Greenfeld; Be'Eri,4,0,36,32
1657733981244,MATH 103A,B03,093562,Greenfeld; Be'Eri,3,0,36,33
1657733987270,MATH 105,A01,085443,Carter; Anne Toulson,15,0,35,20
1657733987270,MATH 105,A02,093477,Carter; Anne Toulson,20,0,35,15
1657733993297,MATH 109,A01,083213,Ganzberger; Geoffrey Michael,2,0,34,32
1657733993297,MATH 109,A02,083214,Ganzberger; Geoffrey Michael,4,0,34,30
1657733993297,MATH 109,A03,093478,Ganzberger; Geoffrey Michael,2,0,34,32
1657733993297,MATH 109,B01,083215,Ganzberger; Geoffrey Michael,1,0,32,31
1657733993297,MATH 109,B02,083216,Ganzberger; Geoffrey Michael,2,0,32,30
1657733993297,MATH 109,B03,093479,Ganzberger; Geoffrey Michael,8,0,32,24
1657733999326,MATH 142A,A01,083219,Chow; Bennett,7,0,32,25
1657733999326,MATH 142A,A02,083220,Chow; Bennett,10,0,32,22
1657733999326,MATH 142A,A03,093480,Chow; Bennett,9,0,32,23
1657733999326,MATH 142A,B03,093481,Chow; Bennett,8,0,32,24
1657733999326,MATH 142A,B04,093558,Chow; Bennett,13,0,32,19
1657733999326,MATH 142A,B05,093559,Chow; Bennett,6,0,32,26
1657734005355,MATH 193A,A01,083224,Rotar; Vladimir,8,0,34,26
1657734005355,MATH 193A,A02,083225,Rotar; Vladimir,9,0,34,25
1657734005355,MATH 193A,A03,083781,Rotar; Vladimir,5,0,34,29
1657734005355,MATH 193A,A04,083782,Rotar; Vladimir,10,0,34,24
1657734005355,MATH 193A,A05,093482,Rotar; Vladimir,10,0,34,24
1657734011385,MATH 197,001,091859,McAuley; Julian John,9999,0,9999,0
1657734011385,MATH 197,002,095566,Kedlaya; Kiran S.,9997,0,9999,2
1657734011385,MATH 197,003,095567,Xiao; Ming,9999,0,9999,0
1657734011385,MATH 197,004,095571,Perols; Johan Lars,9998,0,9999,1
1657734018448,COGS 9,A01,083615,Shannon; Kyle Michael,9,0,75,66
1657734024479,COGS 11,A01,083617,Boyle; Mary E. T.,23,0,48,25
1657734030509,COGS 13,A01,083071,Bastos; Amalia Pinkusfeld,11,0,71,60
1657734036545,COGS 14A,A01,092681,Semenuks; Arturs,5,1,100,95
1657734042572,COGS 14B,A01,083073,Cheng; Tzu-Han,6,0,63,57
1657734048599,COGS 17,A01,092677,Semenuks; Arturs,6,0,81,75
1657734054626,COGS 100,A01,083619,Allen; Michael Gordon,17,0,70,53
1657734060655,COGS 101A,A01,083621,Davis; Joshua Daniel,9,0,68,59
1657734066686,COGS 101B,A01,091572,Allen; Michael Gordon,12,0,65,53
1657734072709,COGS 101C,A01,083625,Delgado; Tania,17,0,35,18
1657734078737,COGS 107A,A01,083627,Boyle; Mary E. T.,13,0,60,47
1657734084763,COGS 118A,A01,083075,Gupta; Anjum,21,0,76,55
1657734090791,CSE 3,A50,083646,Miranda; Gregory Joseph,24,0,50,26
1657734096817,CSE 8A,A50,083650,Miranda; Gregory Joseph,17,1,56,39
1657734102840,CSE 11,A01,083080,Cao; Yingjun,6,15,40,34
1657734108863,CSE 12,A01,083652,Krause-Levy; Sophia Louisa,28,1,120,92
1657734114890,CSE 15L,A01,083654,Morris; Justin Loren,9,0,50,41
1657734114890,CSE 15L,A02,083655,Morris; Justin Loren,9,0,50,41
1657734120923,CSE 20,A01,083657,Tran; Khoa Dang,39,0,80,41
1657734126972,CSE 21,A01,095574,Bach; Quang Tran,22,0,48,26
1657734133006,CSE 30,A01,083084,Eldon; John,6,0,80,74
1657734133006,CSE 30,B01,095061,Bhaskar; Nishant,9,0,50,41
1657734139110,CSE 100,A01,083659,Cao; Yingjun,5,4,70,65
1657734145139,CSE 134B,A01,083661,Powell; Thomas Allan,23,0,100,77
1657734151166,CSE 140,A01,083663,Gungor; Onat,15,0,85,70
1657734157205,CSE 140L,A01,083088,Eldon; John,23,0,100,77
1657734163231,CSE 175,A01,083665,Kumar; Rakesh,3,0,25,22
1657734169257,CSE 190,A00,092507,Dubnov; Shlomo,8,0,20,12
1657734175283,ECE 45,A01,083139,Congero; Spencer William,6,0,75,69
1657734181306,ECE 65,A50,083695,Saad; Andrew S,12,0,30,18
1657734181306,ECE 65,A51,095125,Saad; Andrew S,24,0,26,2
1657734187333,ECE 109,A01,091882,Touri; Behrouz,20,0,70,50
1657734193355,ECE 180,A00,083140,Abi Samra; Nicholas Camill,1,0,30,29
1657734193355,ECE 180,B00,083141,Abi Samra; Nicholas Camill,0,0,30,30
1657734199379,MATH 10A,A01,083735,Patchell; Gregory David,2,0,30,28
1657734199379,MATH 10A,A02,083736,Patchell; Gregory David,20,0,30,10
1657734199379,MATH 10A,A03,083737,Patchell; Gregory David,16,0,30,14
1657734205405,MATH 10B,A01,083207,Lim; Seonhee,8,0,34,26
1657734205405,MATH 10B,A02,083208,Lim; Seonhee,9,0,35,26
1657734205405,MATH 10B,A03,093472,Lim; Seonhee,7,0,34,27
1657734205405,MATH 10B,B01,083739,Sinha; Shubham,13,0,30,17
1657734211439,MATH 18,A01,083743,Cinel; Cameron Alexander,9,0,30,21
1657734211439,MATH 18,A02,083744,Cinel; Cameron Alexander,17,0,30,13
1657734211439,MATH 18,A03,083745,Cinel; Cameron Alexander,10,0,30,20
1657734211439,MATH 18,B01,083748,Rideout; David Porter,5,0,37,32
1657734211439,MATH 18,B02,083749,Rideout; David Porter,5,0,36,31
1657734211439,MATH 18,B03,083750,Rideout; David Porter,3,0,37,34
1657734211439,MATH 18,B04,083751,Rideout; David Porter,6,0,36,30
1657734211439,MATH 18,B05,093473,Rideout; David Porter,6,0,36,30
1657734211439,MATH 18,B06,093474,Rideout; David Porter,6,0,36,30
1657734217461,MATH 20A,A01,083754,Zheng; Zequn,14,0,40,26
1657734223501,MATH 20B,A01,083756,Briones; Jor-el Thomas Caparas,4,0,36,32
1657734223501,MATH 20B,A02,083757,Briones; Jor-el Thomas Caparas,1,0,36,35
1657734223501,MATH 20B,A03,093475,Briones; Jor-el Thomas Caparas,2,0,36,34
1657734229526,MATH 20C,A01,083760,Briones; Jor-el Thomas Caparas,1,0,35,34
1657734229526,MATH 20C,A02,083761,Briones; Jor-el Thomas Caparas,8,0,35,27
1657734229526,MATH 20C,A03,093476,Briones; Jor-el Thomas Caparas,0,1,36,36
1657734229526,MATH 20C,B01,083762,Bach; Quang Tran,1,0,30,29
1657734235554,MATH 20D,A01,083765,Tran; Brian Kha,5,0,30,25
1657734235554,MATH 20D,A02,083766,Tran; Brian Kha,5,0,30,25
1657734235554,MATH 20D,A03,083767,Tran; Brian Kha,5,0,30,25
1657734241585,MATH 20E,A01,083771,Ganguly; Soumya,9,0,32,23
1657734241585,MATH 20E,A02,083772,Ganguly; Soumya,6,0,32,26
1657734241585,MATH 20E,B01,083773,Ciotti; Benjamin,20,0,35,15
1657734241585,MATH 20E,B02,083774,Ciotti; Benjamin,18,0,35,17
1657734247610,MATH 103A,A01,083777,Greenfeld; Be'Eri,3,0,36,33
1657734247610,MATH 103A,A02,083778,Greenfeld; Be'Eri,5,0,36,31
1657734247610,MATH 103A,A03,093561,Greenfeld; Be'Eri,6,0,36,30
1657734247610,MATH 103A,B01,083779,Greenfeld; Be'Eri,7,0,36,29
1657734247610,MATH 103A,B02,083780,Greenfeld; Be'Eri,4,0,36,32
1657734247610,MATH 103A,B03,093562,Greenfeld; Be'Eri,3,0,36,33
1657734253631,MATH 105,A01,085443,Carter; Anne Toulson,15,0,35,20
1657734253631,MATH 105,A02,093477,Carter; Anne Toulson,20,0,35,15
1657734259658,MATH 109,A01,083213,Ganzberger; Geoffrey Michael,2,0,34,32
1657734259658,MATH 109,A02,083214,Ganzberger; Geoffrey Michael,4,0,34,30
1657734259658,MATH 109,A03,093478,Ganzberger; Geoffrey Michael,2,0,34,32
1657734259658,MATH 109,B01,083215,Ganzberger; Geoffrey Michael,1,0,32,31
1657734259658,MATH 109,B02,083216,Ganzberger; Geoffrey Michael,2,0,32,30
1657734259658,MATH 109,B03,093479,Ganzberger; Geoffrey Michael,8,0,32,24
1657734265681,MATH 142A,A01,083219,Chow; Bennett,7,0,32,25
1657734265681,MATH 142A,A02,083220,Chow; Bennett,10,0,32,22
1657734265681,MATH 142A,A03,093480,Chow; Bennett,9,0,32,23
1657734265681,MATH 142A,B03,093481,Chow; Bennett,8,0,32,24
1657734265681,MATH 142A,B04,093558,Chow; Bennett,13,0,32,19
1657734265681,MATH 142A,B05,093559,Chow; Bennett,6,0,32,26
1657734271704,MATH 193A,A01,083224,Rotar; Vladimir,8,0,34,26
1657734271704,MATH 193A,A02,083225,Rotar; Vladimir,9,0,34,25
1657734271704,MATH 193A,A03,083781,Rotar; Vladimir,5,0,34,29
1657734271704,MATH 193A,A04,083782,Rotar; Vladimir,10,0,34,24
1657734271704,MATH 193A,A05,093482,Rotar; Vladimir,10,0,34,24
1657734277734,MATH 197,001,091859,McAuley; Julian John,9999,0,9999,0
1657734277734,MATH 197,002,095566,Kedlaya; Kiran S.,9997,0,9999,2
1657734277734,MATH 197,003,095567,Xiao; Ming,9999,0,9999,0
1657734277734,MATH 197,004,095571,Perols; Johan Lars,9998,0,9999,1
1657734284788,COGS 9,A01,083615,Shannon; Kyle Michael,9,0,75,66
1657734290816,COGS 11,A01,083617,Boyle; Mary E. T.,23,0,48,25
1657734296845,COGS 13,A01,083071,Bastos; Amalia Pinkusfeld,11,0,71,60
1657734302874,COGS 14A,A01,092681,Semenuks; Arturs,5,1,100,95
1657734308914,COGS 14B,A01,083073,Cheng; Tzu-Han,6,0,63,57
1657734314947,COGS 17,A01,092677,Semenuks; Arturs,6,0,81,75
1657734320980,COGS 100,A01,083619,Allen; Michael Gordon,17,0,70,53
1657734327008,COGS 101A,A01,083621,Davis; Joshua Daniel,9,0,68,59
1657734333031,COGS 101B,A01,091572,Allen; Michael Gordon,12,0,65,53
1657734339060,COGS 101C,A01,083625,Delgado; Tania,17,0,35,18
1657734345087,COGS 107A,A01,083627,Boyle; Mary E. T.,13,0,60,47
1657734351113,COGS 118A,A01,083075,Gupta; Anjum,21,0,76,55
1657734357149,CSE 3,A50,083646,Miranda; Gregory Joseph,24,0,50,26
1657734363197,CSE 8A,A50,083650,Miranda; Gregory Joseph,17,1,56,39
1657734369223,CSE 11,A01,083080,Cao; Yingjun,6,15,40,34
1657734375244,CSE 12,A01,083652,Krause-Levy; Sophia Louisa,28,1,120,92
1657734381268,CSE 15L,A01,083654,Morris; Justin Loren,9,0,50,41
1657734381268,CSE 15L,A02,083655,Morris; Justin Loren,9,0,50,41
1657734387292,CSE 20,A01,083657,Tran; Khoa Dang,39,0,80,41
1657734393318,CSE 21,A01,095574,Bach; Quang Tran,22,0,48,26
1657734399344,CSE 30,A01,083084,Eldon; John,6,0,80,74
1657734399344,CSE 30,B01,095061,Bhaskar; Nishant,9,0,50,41
1657734405373,CSE 100,A01,083659,Cao; Yingjun,5,4,70,65
1657734411400,CSE 134B,A01,083661,Powell; Thomas Allan,23,0,100,77
1657734417423,CSE 140,A01,083663,Gungor; Onat,15,0,85,70
1657734423447,CSE 140L,A01,083088,Eldon; John,23,0,100,77
1657734429473,CSE 175,A01,083665,Kumar; Rakesh,3,0,25,22
1657734435496,CSE 190,A00,092507,Dubnov; Shlomo,8,0,20,12
1657734441519,ECE 45,A01,083139,Congero; Spencer William,6,0,75,69
1657734447544,ECE 65,A50,083695,Saad; Andrew S,12,0,30,18
1657734447544,ECE 65,A51,095125,Saad; Andrew S,24,0,26,2
1657734453569,ECE 109,A01,091882,Touri; Behrouz,20,0,70,50
1657734459596,ECE 180,A00,083140,Abi Samra; Nicholas Camill,1,0,30,29
1657734459596,ECE 180,B00,083141,Abi Samra; Nicholas Camill,0,0,30,30
1657734465634,MATH 10A,A01,083735,Patchell; Gregory David,2,0,30,28
1657734465634,MATH 10A,A02,083736,Patchell; Gregory David,20,0,30,10
1657734465634,MATH 10A,A03,083737,Patchell; Gregory David,16,0,30,14
1657734471675,MATH 10B,A01,083207,Lim; Seonhee,8,0,34,26
1657734471675,MATH 10B,A02,083208,Lim; Seonhee,9,0,35,26
1657734471675,MATH 10B,A03,093472,Lim; Seonhee,7,0,34,27
1657734471675,MATH 10B,B01,083739,Sinha; Shubham,13,0,30,17
1657734477700,MATH 18,A01,083743,Cinel; Cameron Alexander,9,0,30,21
1657734477700,MATH 18,A02,083744,Cinel; Cameron Alexander,17,0,30,13
1657734477700,MATH 18,A03,083745,Cinel; Cameron Alexander,10,0,30,20
1657734477700,MATH 18,B01,083748,Rideout; David Porter,5,0,37,32
1657734477700,MATH 18,B02,083749,Rideout; David Porter,5,0,36,31
1657734477700,MATH 18,B03,083750,Rideout; David Porter,3,0,37,34
1657734477700,MATH 18,B04,083751,Rideout; David Porter,6,0,36,30
1657734477700,MATH 18,B05,093473,Rideout; David Porter,6,0,36,30
1657734477700,MATH 18,B06,093474,Rideout; David Porter,6,0,36,30
1657734483724,MATH 20A,A01,083754,Zheng; Zequn,14,0,40,26
1657734489754,MATH 20B,A01,083756,Briones; Jor-el Thomas Caparas,4,0,36,32
1657734489754,MATH 20B,A02,083757,Briones; Jor-el Thomas Caparas,1,0,36,35
1657734489754,MATH 20B,A03,093475,Briones; Jor-el Thomas Caparas,2,0,36,34
1657734495780,MATH 20C,A01,083760,Briones; Jor-el Thomas Caparas,1,0,35,34
1657734495780,MATH 20C,A02,083761,Briones; Jor-el Thomas Caparas,8,0,35,27
1657734495780,MATH 20C,A03,093476,Briones; Jor-el Thomas Caparas,0,1,36,36
1657734495780,MATH 20C,B01,083762,Bach; Quang Tran,1,0,30,29
1657734501813,MATH 20D,A01,083765,Tran; Brian Kha,5,0,30,25
1657734501813,MATH 20D,A02,083766,Tran; Brian Kha,5,0,30,25
1657734501813,MATH 20D,A03,083767,Tran; Brian Kha,5,0,30,25
1657734507847,MATH 20E,A01,083771,Ganguly; Soumya,9,0,32,23
1657734507847,MATH 20E,A02,083772,Ganguly; Soumya,6,0,32,26
1657734507847,MATH 20E,B01,083773,Ciotti; Benjamin,20,0,35,15
1657734507847,MATH 20E,B02,083774,Ciotti; Benjamin,18,0,35,17
1657734513873,MATH 103A,A01,083777,Greenfeld; Be'Eri,3,0,36,33
1657734513873,MATH 103A,A02,083778,Greenfeld; Be'Eri,5,0,36,31
1657734513873,MATH 103A,A03,093561,Greenfeld; Be'Eri,6,0,36,30
1657734513873,MATH 103A,B01,083779,Greenfeld; Be'Eri,7,0,36,29
1657734513873,MATH 103A,B02,083780,Greenfeld; Be'Eri,4,0,36,32
1657734513873,MATH 103A,B03,093562,Greenfeld; Be'Eri,3,0,36,33
1657734519908,MATH 105,A01,085443,Carter; Anne Toulson,15,0,35,20
1657734519908,MATH 105,A02,093477,Carter; Anne Toulson,20,0,35,15
1657734525951,MATH 109,A01,083213,Ganzberger; Geoffrey Michael,2,0,34,32
1657734525951,MATH 109,A02,083214,Ganzberger; Geoffrey Michael,4,0,34,30
1657734525951,MATH 109,A03,093478,Ganzberger; Geoffrey Michael,2,0,34,32
1657734525951,MATH 109,B01,083215,Ganzberger; Geoffrey Michael,1,0,32,31
1657734525951,MATH 109,B02,083216,Ganzberger; Geoffrey Michael,2,0,32,30
1657734525951,MATH 109,B03,093479,Ganzberger; Geoffrey Michael,8,0,32,24
1657734531981,MATH 142A,A01,083219,Chow; Bennett,7,0,32,25
1657734531981,MATH 142A,A02,083220,Chow; Bennett,10,0,32,22
1657734531981,MATH 142A,A03,093480,Chow; Bennett,9,0,32,23
1657734531981,MATH 142A,B03,093481,Chow; Bennett,8,0,32,24
1657734531981,MATH 142A,B04,093558,Chow; Bennett,13,0,32,19
1657734531981,MATH 142A,B05,093559,Chow; Bennett,6,0,32,26
1657734538009,MATH 193A,A01,083224,Rotar; Vladimir,8,0,34,26
1657734538009,MATH 193A,A02,083225,Rotar; Vladimir,9,0,34,25
1657734538009,MATH 193A,A03,083781,Rotar; Vladimir,5,0,34,29
1657734538009,MATH 193A,A04,083782,Rotar; Vladimir,10,0,34,24
1657734538009,MATH 193A,A05,093482,Rotar; Vladimir,10,0,34,24
1657734544032,MATH 197,001,091859,McAuley; Julian John,9999,0,9999,0
1657734544032,MATH 197,002,095566,Kedlaya; Kiran S.,9997,0,9999,2
1657734544032,MATH 197,003,095567,Xiao; Ming,9999,0,9999,0
1657734544032,MATH 197,004,095571,Perols; Johan Lars,9998,0,9999,1
1657734551090,COGS 9,A01,083615,Shannon; Kyle Michael,9,0,75,66
1657734557113,COGS 11,A01,083617,Boyle; Mary E. T.,23,0,48,25
1657734563141,COGS 13,A01,083071,Bastos; Amalia Pinkusfeld,11,0,71,60
1657734569171,COGS 14A,A01,092681,Semenuks; Arturs,5,1,100,95
1657734575193,COGS 14B,A01,083073,Cheng; Tzu-Han,6,0,63,57
1657734581217,COGS 17,A01,092677,Semenuks; Arturs,6,0,81,75
1657734587241,COGS 100,A01,083619,Allen; Michael Gordon,17,0,70,53
1657734593266,COGS 101A,A01,083621,Davis; Joshua Daniel,9,0,68,59
1657734599293,COGS 101B,A01,091572,Allen; Michael Gordon,12,0,65,53
1657734605316,COGS 101C,A01,083625,Delgado; Tania,17,0,35,18
1657734611338,COGS 107A,A01,083627,Boyle; Mary E. T.,13,0,60,47
1657734617362,COGS 118A,A01,083075,Gupta; Anjum,21,0,76,55
1657734623385,CSE 3,A50,083646,Miranda; Gregory Joseph,24,0,50,26
1657734629414,CSE 8A,A50,083650,Miranda; Gregory Joseph,17,1,56,39
1657734635440,CSE 11,A01,083080,Cao; Yingjun,6,15,40,34
1657734641464,CSE 12,A01,083652,Krause-Levy; Sophia Louisa,28,1,120,92
1657734647492,CSE 15L,A01,083654,Morris; Justin Loren,9,0,50,41
1657734647492,CSE 15L,A02,083655,Morris; Justin Loren,9,0,50,41
1657734653518,CSE 20,A01,083657,Tran; Khoa Dang,39,0,80,41
1657734659541,CSE 21,A01,095574,Bach; Quang Tran,22,0,48,26
1657734665565,CSE 30,A01,083084,Eldon; John,6,0,80,74
1657734665565,CSE 30,B01,095061,Bhaskar; Nishant,9,0,50,41
1657734671588,CSE 100,A01,083659,Cao; Yingjun,5,4,70,65
1657734677610,CSE 134B,A01,083661,Powell; Thomas Allan,23,0,100,77
1657734683647,CSE 140,A01,083663,Gungor; Onat,15,0,85,70
1657734689674,CSE 140L,A01,083088,Eldon; John,23,0,100,77
1657734695698,CSE 175,A01,083665,Kumar; Rakesh,3,0,25,22
1657734701724,CSE 190,A00,092507,Dubnov; Shlomo,8,0,20,12
1657734707753,ECE 45,A01,083139,Congero; Spencer William,6,0,75,69
1657734713779,ECE 65,A50,083695,Saad; Andrew S,12,0,30,18
1657734713779,ECE 65,A51,095125,Saad; Andrew S,24,0,26,2
1657734719802,ECE 109,A01,091882,Touri; Behrouz,20,0,70,50
1657734725826,ECE 180,A00,083140,Abi Samra; Nicholas Camill,1,0,30,29
1657734725826,ECE 180,B00,083141,Abi Samra; Nicholas Camill,0,0,30,30
1657734731869,MATH 10A,A01,083735,Patchell; Gregory David,2,0,30,28
1657734731869,MATH 10A,A02,083736,Patchell; Gregory David,20,0,30,10
1657734731869,MATH 10A,A03,083737,Patchell; Gregory David,16,0,30,14
1657734737989,MATH 10B,A01,083207,Lim; Seonhee,8,0,34,26
1657734737989,MATH 10B,A02,083208,Lim; Seonhee,9,0,35,26
1657734737989,MATH 10B,A03,093472,Lim; Seonhee,7,0,34,27
1657734737989,MATH 10B,B01,083739,Sinha; Shubham,13,0,30,17
1657734744012,MATH 18,A01,083743,Cinel; Cameron Alexander,9,0,30,21
1657734744012,MATH 18,A02,083744,Cinel; Cameron Alexander,17,0,30,13
1657734744012,MATH 18,A03,083745,Cinel; Cameron Alexander,10,0,30,20
1657734744012,MATH 18,B01,083748,Rideout; David Porter,5,0,37,32
1657734744012,MATH 18,B02,083749,Rideout; David Porter,5,0,36,31
1657734744012,MATH 18,B03,083750,Rideout; David Porter,3,0,37,34
1657734744012,MATH 18,B04,083751,Rideout; David Porter,6,0,36,30
1657734744012,MATH 18,B05,093473,Rideout; David Porter,6,0,36,30
1657734744012,MATH 18,B06,093474,Rideout; David Porter,6,0,36,30
1657734750036,MATH 20A,A01,083754,Zheng; Zequn,14,0,40,26
1657734756066,MATH 20B,A01,083756,Briones; Jor-el Thomas Caparas,4,0,36,32
1657734756066,MATH 20B,A02,083757,Briones; Jor-el Thomas Caparas,1,0,36,35
1657734756066,MATH 20B,A03,093475,Briones; Jor-el Thomas Caparas,2,0,36,34
1657734762097,MATH 20C,A01,083760,Briones; Jor-el Thomas Caparas,1,0,35,34
1657734762097,MATH 20C,A02,083761,Briones; Jor-el Thomas Caparas,8,0,35,27
1657734762097,MATH 20C,A03,093476,Briones; Jor-el Thomas Caparas,0,1,36,36
1657734762097,MATH 20C,B01,083762,Bach; Quang Tran,1,0,30,29
1657734768129,MATH 20D,A01,083765,Tran; Brian Kha,5,0,30,25
1657734768129,MATH 20D,A02,083766,Tran; Brian Kha,5,0,30,25
1657734768129,MATH 20D,A03,083767,Tran; Brian Kha,5,0,30,25
1657734774158,MATH 20E,A01,083771,Ganguly; Soumya,9,0,32,23
1657734774158,MATH 20E,A02,083772,Ganguly; Soumya,6,0,32,26
1657734774158,MATH 20E,B01,083773,Ciotti; Benjamin,20,0,35,15
1657734774158,MATH 20E,B02,083774,Ciotti; Benjamin,18,0,35,17
1657734780189,MATH 103A,A01,083777,Greenfeld; Be'Eri,3,0,36,33
1657734780189,MATH 103A,A02,083778,Greenfeld; Be'Eri,5,0,36,31
1657734780189,MATH 103A,A03,093561,Greenfeld; Be'Eri,6,0,36,30
1657734780189,MATH 103A,B01,083779,Greenfeld; Be'Eri,7,0,36,29
1657734780189,MATH 103A,B02,083780,Greenfeld; Be'Eri,4,0,36,32
1657734780189,MATH 103A,B03,093562,Greenfeld; Be'Eri,3,0,36,33
1657734786215,MATH 105,A01,085443,Carter; Anne Toulson,15,0,35,20
1657734786215,MATH 105,A02,093477,Carter; Anne Toulson,20,0,35,15
1657734792240,MATH 109,A01,083213,Ganzberger; Geoffrey Michael,2,0,34,32
1657734792240,MATH 109,A02,083214,Ganzberger; Geoffrey Michael,4,0,34,30
1657734792240,MATH 109,A03,093478,Ganzberger; Geoffrey Michael,2,0,34,32
1657734792240,MATH 109,B01,083215,Ganzberger; Geoffrey Michael,1,0,32,31
1657734792240,MATH 109,B02,083216,Ganzberger; Geoffrey Michael,2,0,32,30
1657734792240,MATH 109,B03,093479,Ganzberger; Geoffrey Michael,8,0,32,24
1657734798268,MATH 142A,A01,083219,Chow; Bennett,7,0,32,25
1657734798268,MATH 142A,A02,083220,Chow; Bennett,10,0,32,22
1657734798268,MATH 142A,A03,093480,Chow; Bennett,9,0,32,23
1657734798268,MATH 142A,B03,093481,Chow; Bennett,8,0,32,24
1657734798268,MATH 142A,B04,093558,Chow; Bennett,13,0,32,19
1657734798268,MATH 142A,B05,093559,Chow; Bennett,6,0,32,26
1657734804292,MATH 193A,A01,083224,Rotar; Vladimir,8,0,34,26
1657734804292,MATH 193A,A02,083225,Rotar; Vladimir,9,0,34,25
1657734804292,MATH 193A,A03,083781,Rotar; Vladimir,5,0,34,29
1657734804292,MATH 193A,A04,083782,Rotar; Vladimir,10,0,34,24
1657734804292,MATH 193A,A05,093482,Rotar; Vladimir,10,0,34,24
1657734810328,MATH 197,001,091859,McAuley; Julian John,9999,0,9999,0
1657734810328,MATH 197,002,095566,Kedlaya; Kiran S.,9997,0,9999,2
1657734810328,MATH 197,003,095567,Xiao; Ming,9999,0,9999,0
1657734810328,MATH 197,004,095571,Perols; Johan Lars,9998,0,9999,1
1657734817395,COGS 9,A01,083615,Shannon; Kyle Michael,9,0,75,66
1657734823419,COGS 11,A01,083617,Boyle; Mary E. T.,23,0,48,25
1657734829448,COGS 13,A01,083071,Bastos; Amalia Pinkusfeld,11,0,71,60
1657734835470,COGS 14A,A01,092681,Semenuks; Arturs,5,1,100,95
1657734841494,COGS 14B,A01,083073,Cheng; Tzu-Han,6,0,63,57
1657734847527,COGS 17,A01,092677,Semenuks; Arturs,6,0,81,75
1657734853553,COGS 100,A01,083619,Allen; Michael Gordon,17,0,70,53
1657734859576,COGS 101A,A01,083621,Davis; Joshua Daniel,9,0,68,59
1657734865605,COGS 101B,A01,091572,Allen; Michael Gordon,12,0,65,53
1657734871628,COGS 101C,A01,083625,Delgado; Tania,17,0,35,18
1657734877653,COGS 107A,A01,083627,Boyle; Mary E. T.,13,0,60,47
1657734883677,COGS 118A,A01,083075,Gupta; Anjum,21,0,76,55
1657734889702,CSE 3,A50,083646,Miranda; Gregory Joseph,24,0,50,26
1657734895729,CSE 8A,A50,083650,Miranda; Gregory Joseph,17,1,56,39
1657734901755,CSE 11,A01,083080,Cao; Yingjun,6,15,40,34
1657734907781,CSE 12,A01,083652,Krause-Levy; Sophia Louisa,28,1,120,92
1657734913806,CSE 15L,A01,083654,Morris; Justin Loren,9,0,50,41
1657734913806,CSE 15L,A02,083655,Morris; Justin Loren,9,0,50,41
1657734919831,CSE 20,A01,083657,Tran; Khoa Dang,39,0,80,41
1657734925857,CSE 21,A01,095574,Bach; Quang Tran,22,0,48,26
1657734931885,CSE 30,A01,083084,Eldon; John,6,0,80,74
1657734931885,CSE 30,B01,095061,Bhaskar; Nishant,9,0,50,41
1657734937910,CSE 100,A01,083659,Cao; Yingjun,5,4,70,65
1657734943933,CSE 134B,A01,083661,Powell; Thomas Allan,23,0,100,77
1657734949956,CSE 140,A01,083663,Gungor; Onat,15,0,85,70
1657734955982,CSE 140L,A01,083088,Eldon; John,23,0,100,77
1657734962009,CSE 175,A01,083665,Kumar; Rakesh,3,0,25,22
1657734968034,CSE 190,A00,092507,Dubnov; Shlomo,8,0,20,12
1657734974061,ECE 45,A01,083139,Congero; Spencer William,6,0,75,69
1657734980090,ECE 65,A50,083695,Saad; Andrew S,12,0,30,18
1657734980090,ECE 65,A51,095125,Saad; Andrew S,24,0,26,2
1657734986112,ECE 109,A01,091882,Touri; Behrouz,20,0,70,50
1657734992140,ECE 180,A00,083140,Abi Samra; Nicholas Camill,1,0,30,29
1657734992140,ECE 180,B00,083141,Abi Samra; Nicholas Camill,0,0,30,30
1657734998162,MATH 10A,A01,083735,Patchell; Gregory David,2,0,30,28
1657734998162,MATH 10A,A02,083736,Patchell; Gregory David,20,0,30,10
1657734998162,MATH 10A,A03,083737,Patchell; Gregory David,16,0,30,14
1657735004186,MATH 10B,A01,083207,Lim; Seonhee,8,0,34,26
1657735004186,MATH 10B,A02,083208,Lim; Seonhee,9,0,35,26
1657735004186,MATH 10B,A03,093472,Lim; Seonhee,7,0,34,27
1657735004186,MATH 10B,B01,083739,Sinha; Shubham,13,0,30,17
1657735010216,MATH 18,A01,083743,Cinel; Cameron Alexander,9,0,30,21
1657735010216,MATH 18,A02,083744,Cinel; Cameron Alexander,17,0,30,13
1657735010216,MATH 18,A03,083745,Cinel; Cameron Alexander,10,0,30,20
1657735010216,MATH 18,B01,083748,Rideout; David Porter,5,0,37,32
1657735010216,MATH 18,B02,083749,Rideout; David Porter,5,0,36,31
1657735010216,MATH 18,B03,083750,Rideout; David Porter,3,0,37,34
1657735010216,MATH 18,B04,083751,Rideout; David Porter,6,0,36,30
1657735010216,MATH 18,B05,093473,Rideout; David Porter,6,0,36,30
1657735010216,MATH 18,B06,093474,Rideout; David Porter,6,0,36,30
1657735016252,MATH 20A,A01,083754,Zheng; Zequn,14,0,40,26
1657735022281,MATH 20B,A01,083756,Briones; Jor-el Thomas Caparas,4,0,36,32
1657735022281,MATH 20B,A02,083757,Briones; Jor-el Thomas Caparas,1,0,36,35
1657735022281,MATH 20B,A03,093475,Briones; Jor-el Thomas Caparas,2,0,36,34
1657735028316,MATH 20C,A01,083760,Briones; Jor-el Thomas Caparas,1,0,35,34
1657735028316,MATH 20C,A02,083761,Briones; Jor-el Thomas Caparas,8,0,35,27
1657735028316,MATH 20C,A03,093476,Briones; Jor-el Thomas Caparas,0,1,36,36
1657735028316,MATH 20C,B01,083762,Bach; Quang Tran,1,0,30,29
1657735034341,MATH 20D,A01,083765,Tran; Brian Kha,5,0,30,25
1657735034341,MATH 20D,A02,083766,Tran; Brian Kha,5,0,30,25
1657735034341,MATH 20D,A03,083767,Tran; Brian Kha,5,0,30,25
1657735040380,MATH 20E,A01,083771,Ganguly; Soumya,9,0,32,23
1657735040380,MATH 20E,A02,083772,Ganguly; Soumya,6,0,32,26
1657735040380,MATH 20E,B01,083773,Ciotti; Benjamin,20,0,35,15
1657735040380,MATH 20E,B02,083774,Ciotti; Benjamin,18,0,35,17
1657735046413,MATH 103A,A01,083777,Greenfeld; Be'Eri,3,0,36,33
1657735046413,MATH 103A,A02,083778,Greenfeld; Be'Eri,5,0,36,31
1657735046413,MATH 103A,A03,093561,Greenfeld; Be'Eri,6,0,36,30
1657735046413,MATH 103A,B01,083779,Greenfeld; Be'Eri,7,0,36,29
1657735046413,MATH 103A,B02,083780,Greenfeld; Be'Eri,4,0,36,32
1657735046413,MATH 103A,B03,093562,Greenfeld; Be'Eri,3,0,36,33
1657735052437,MATH 105,A01,085443,Carter; Anne Toulson,15,0,35,20
1657735052437,MATH 105,A02,093477,Carter; Anne Toulson,20,0,35,15
1657735058491,MATH 109,A01,083213,Ganzberger; Geoffrey Michael,2,0,34,32
1657735058491,MATH 109,A02,083214,Ganzberger; Geoffrey Michael,4,0,34,30
1657735058491,MATH 109,A03,093478,Ganzberger; Geoffrey Michael,2,0,34,32
1657735058491,MATH 109,B01,083215,Ganzberger; Geoffrey Michael,1,0,32,31
1657735058491,MATH 109,B02,083216,Ganzberger; Geoffrey Michael,2,0,32,30
1657735058491,MATH 109,B03,093479,Ganzberger; Geoffrey Michael,8,0,32,24
1657735064520,MATH 142A,A01,083219,Chow; Bennett,7,0,32,25
1657735064520,MATH 142A,A02,083220,Chow; Bennett,10,0,32,22
1657735064520,MATH 142A,A03,093480,Chow; Bennett,9,0,32,23
1657735064520,MATH 142A,B03,093481,Chow; Bennett,8,0,32,24
1657735064520,MATH 142A,B04,093558,Chow; Bennett,13,0,32,19
1657735064520,MATH 142A,B05,093559,Chow; Bennett,6,0,32,26
1657735070543,MATH 193A,A01,083224,Rotar; Vladimir,8,0,34,26
1657735070543,MATH 193A,A02,083225,Rotar; Vladimir,9,0,34,25
1657735070543,MATH 193A,A03,083781,Rotar; Vladimir,5,0,34,29
1657735070543,MATH 193A,A04,083782,Rotar; Vladimir,10,0,34,24
1657735070543,MATH 193A,A05,093482,Rotar; Vladimir,10,0,34,24
1657735076565,MATH 197,001,091859,McAuley; Julian John,9999,0,9999,0
1657735076565,MATH 197,002,095566,Kedlaya; Kiran S.,9997,0,9999,2
1657735076565,MATH 197,003,095567,Xiao; Ming,9999,0,9999,0
1657735076565,MATH 197,004,095571,Perols; Johan Lars,9998,0,9999,1
1657735083625,COGS 9,A01,083615,Shannon; Kyle Michael,9,0,75,66
1657735089649,COGS 11,A01,083617,Boyle; Mary E. T.,23,0,48,25
1657735095672,COGS 13,A01,083071,Bastos; Amalia Pinkusfeld,11,0,71,60
1657735101695,COGS 14A,A01,092681,Semenuks; Arturs,5,1,100,95
1657735107719,COGS 14B,A01,083073,Cheng; Tzu-Han,6,0,63,57
1657735113742,COGS 17,A01,092677,Semenuks; Arturs,6,0,81,75
1657735119772,COGS 100,A01,083619,Allen; Michael Gordon,17,0,70,53
1657735125801,COGS 101A,A01,083621,Davis; Joshua Daniel,9,0,68,59
1657735131833,COGS 101B,A01,091572,Allen; Michael Gordon,12,0,65,53
1657735137857,COGS 101C,A01,083625,Delgado; Tania,17,0,35,18
1657735143880,COGS 107A,A01,083627,Boyle; Mary E. T.,13,0,60,47
1657735149905,COGS 118A,A01,083075,Gupta; Anjum,21,0,76,55
1657735155929,CSE 3,A50,083646,Miranda; Gregory Joseph,24,0,50,26
1657735161960,CSE 8A,A50,083650,Miranda; Gregory Joseph,17,1,56,39
1657735167983,CSE 11,A01,083080,Cao; Yingjun,6,15,40,34
1657735174009,CSE 12,A01,083652,Krause-Levy; Sophia Louisa,28,1,120,92
1657735180038,CSE 15L,A01,083654,Morris; Justin Loren,9,0,50,41
1657735180038,CSE 15L,A02,083655,Morris; Justin Loren,9,0,50,41
1657735186066,CSE 20,A01,083657,Tran; Khoa Dang,39,0,80,41
1657735192095,CSE 21,A01,095574,Bach; Quang Tran,22,0,48,26
1657735198119,CSE 30,A01,083084,Eldon; John,6,0,80,74
1657735198119,CSE 30,B01,095061,Bhaskar; Nishant,9,0,50,41
1657735204145,CSE 100,A01,083659,Cao; Yingjun,5,4,70,65
1657735210168,CSE 134B,A01,083661,Powell; Thomas Allan,23,0,100,77
1657735216190,CSE 140,A01,083663,Gungor; Onat,15,0,85,70
1657735222211,CSE 140L,A01,083088,Eldon; John,23,0,100,77
1657735228242,CSE 175,A01,083665,Kumar; Rakesh,3,0,25,22
1657735234265,CSE 190,A00,092507,Dubnov; Shlomo,8,0,20,12
1657735240290,ECE 45,A01,083139,Congero; Spencer William,6,0,75,69
1657735246321,ECE 65,A50,083695,Saad; Andrew S,12,0,30,18
1657735246321,ECE 65,A51,095125,Saad; Andrew S,24,0,26,2
1657735252344,ECE 109,A01,091882,Touri; Behrouz,20,0,70,50
1657735258368,ECE 180,A00,083140,Abi Samra; Nicholas Camill,1,0,30,29
1657735258368,ECE 180,B00,083141,Abi Samra; Nicholas Camill,0,0,30,30
1657735264399,MATH 10A,A01,083735,Patchell; Gregory David,2,0,30,28
1657735264399,MATH 10A,A02,083736,Patchell; Gregory David,20,0,30,10
1657735264399,MATH 10A,A03,083737,Patchell; Gregory David,16,0,30,14
1657735270426,MATH 10B,A01,083207,Lim; Seonhee,8,0,34,26
1657735270426,MATH 10B,A02,083208,Lim; Seonhee,9,0,35,26
1657735270426,MATH 10B,A03,093472,Lim; Seonhee,7,0,34,27
1657735270426,MATH 10B,B01,083739,Sinha; Shubham,13,0,30,17
1657735276456,MATH 18,A01,083743,Cinel; Cameron Alexander,9,0,30,21
1657735276456,MATH 18,A02,083744,Cinel; Cameron Alexander,17,0,30,13
1657735276456,MATH 18,A03,083745,Cinel; Cameron Alexander,10,0,30,20
1657735276456,MATH 18,B01,083748,Rideout; David Porter,5,0,37,32
1657735276456,MATH 18,B02,083749,Rideout; David Porter,5,0,36,31
1657735276456,MATH 18,B03,083750,Rideout; David Porter,3,0,37,34
1657735276456,MATH 18,B04,083751,Rideout; David Porter,6,0,36,30
1657735276456,MATH 18,B05,093473,Rideout; David Porter,6,0,36,30
1657735276456,MATH 18,B06,093474,Rideout; David Porter,6,0,36,30
1657735282478,MATH 20A,A01,083754,Zheng; Zequn,14,0,40,26
1657735288503,MATH 20B,A01,083756,Briones; Jor-el Thomas Caparas,4,0,36,32
1657735288503,MATH 20B,A02,083757,Briones; Jor-el Thomas Caparas,1,0,36,35
1657735288503,MATH 20B,A03,093475,Briones; Jor-el Thomas Caparas,2,0,36,34
1657735294531,MATH 20C,A01,083760,Briones; Jor-el Thomas Caparas,1,0,35,34
1657735294531,MATH 20C,A02,083761,Briones; Jor-el Thomas Caparas,8,0,35,27
1657735294531,MATH 20C,A03,093476,Briones; Jor-el Thomas Caparas,0,1,36,36
1657735294531,MATH 20C,B01,083762,Bach; Quang Tran,1,0,30,29
1657735300555,MATH 20D,A01,083765,Tran; Brian Kha,5,0,30,25
1657735300555,MATH 20D,A02,083766,Tran; Brian Kha,5,0,30,25
1657735300555,MATH 20D,A03,083767,Tran; Brian Kha,5,0,30,25
1657735306579,MATH 20E,A01,083771,Ganguly; Soumya,9,0,32,23
1657735306579,MATH 20E,A02,083772,Ganguly; Soumya,6,0,32,26
1657735306579,MATH 20E,B01,083773,Ciotti; Benjamin,20,0,35,15
1657735306579,MATH 20E,B02,083774,Ciotti; Benjamin,18,0,35,17
1657735312606,MATH 103A,A01,083777,Greenfeld; Be'Eri,3,0,36,33
1657735312606,MATH 103A,A02,083778,Greenfeld; Be'Eri,5,0,36,31
1657735312606,MATH 103A,A03,093561,Greenfeld; Be'Eri,6,0,36,30
1657735312606,MATH 103A,B01,083779,Greenfeld; Be'Eri,7,0,36,29
1657735312606,MATH 103A,B02,083780,Greenfeld; Be'Eri,4,0,36,32
1657735312606,MATH 103A,B03,093562,Greenfeld; Be'Eri,3,0,36,33
1657735318634,MATH 105,A01,085443,Carter; Anne Toulson,15,0,35,20
1657735318634,MATH 105,A02,093477,Carter; Anne Toulson,20,0,35,15
1657735324671,MATH 109,A01,083213,Ganzberger; Geoffrey Michael,2,0,34,32
1657735324671,MATH 109,A02,083214,Ganzberger; Geoffrey Michael,4,0,34,30
1657735324671,MATH 109,A03,093478,Ganzberger; Geoffrey Michael,2,0,34,32
1657735324671,MATH 109,B01,083215,Ganzberger; Geoffrey Michael,1,0,32,31
1657735324671,MATH 109,B02,083216,Ganzberger; Geoffrey Michael,2,0,32,30
1657735324671,MATH 109,B03,093479,Ganzberger; Geoffrey Michael,8,0,32,24
1657735330706,MATH 142A,A01,083219,Chow; Bennett,7,0,32,25
1657735330706,MATH 142A,A02,083220,Chow; Bennett,10,0,32,22
1657735330706,MATH 142A,A03,093480,Chow; Bennett,9,0,32,23
1657735330706,MATH 142A,B03,093481,Chow; Bennett,8,0,32,24
1657735330706,MATH 142A,B04,093558,Chow; Bennett,13,0,32,19
1657735330706,MATH 142A,B05,093559,Chow; Bennett,6,0,32,26
1657735336802,MATH 193A,A01,083224,Rotar; Vladimir,8,0,34,26
1657735336802,MATH 193A,A02,083225,Rotar; Vladimir,9,0,34,25
1657735336802,MATH 193A,A03,083781,Rotar; Vladimir,5,0,34,29
1657735336802,MATH 193A,A04,083782,Rotar; Vladimir,10,0,34,24
1657735336802,MATH 193A,A05,093482,Rotar; Vladimir,10,0,34,24
1657735342823,MATH 197,001,091859,McAuley; Julian John,9999,0,9999,0
1657735342823,MATH 197,002,095566,Kedlaya; Kiran S.,9997,0,9999,2
1657735342823,MATH 197,003,095567,Xiao; Ming,9999,0,9999,0
1657735342823,MATH 197,004,095571,Perols; Johan Lars,9998,0,9999,1
1657735349884,COGS 9,A01,083615,Shannon; Kyle Michael,9,0,75,66
1657735355925,COGS 11,A01,083617,Boyle; Mary E. T.,23,0,48,25
1657735361952,COGS 13,A01,083071,Bastos; Amalia Pinkusfeld,11,0,71,60
1657735367976,COGS 14A,A01,092681,Semenuks; Arturs,5,1,100,95
1657735374008,COGS 14B,A01,083073,Cheng; Tzu-Han,6,0,63,57
1657735380034,COGS 17,A01,092677,Semenuks; Arturs,6,0,81,75
1657735386056,COGS 100,A01,083619,Allen; Michael Gordon,17,0,70,53
1657735392081,COGS 101A,A01,083621,Davis; Joshua Daniel,9,0,68,59
1657735398103,COGS 101B,A01,091572,Allen; Michael Gordon,12,0,65,53
1657735404124,COGS 101C,A01,083625,Delgado; Tania,17,0,35,18
1657735410147,COGS 107A,A01,083627,Boyle; Mary E. T.,13,0,60,47
1657735416171,COGS 118A,A01,083075,Gupta; Anjum,21,0,76,55
1657735422198,CSE 3,A50,083646,Miranda; Gregory Joseph,24,0,50,26
1657735428222,CSE 8A,A50,083650,Miranda; Gregory Joseph,17,1,56,39
1657735434245,CSE 11,A01,083080,Cao; Yingjun,6,15,40,34
1657735440279,CSE 12,A01,083652,Krause-Levy; Sophia Louisa,28,1,120,92
1657735446304,CSE 15L,A01,083654,Morris; Justin Loren,9,0,50,41
1657735446304,CSE 15L,A02,083655,Morris; Justin Loren,9,0,50,41
1657735452328,CSE 20,A01,083657,Tran; Khoa Dang,39,0,80,41
1657735458350,CSE 21,A01,095574,Bach; Quang Tran,22,0,48,26
1657735464375,CSE 30,A01,083084,Eldon; John,6,0,80,74
1657735464375,CSE 30,B01,095061,Bhaskar; Nishant,9,0,50,41
1657735470404,CSE 100,A01,083659,Cao; Yingjun,5,4,70,65
1657735476426,CSE 134B,A01,083661,Powell; Thomas Allan,23,0,100,77
1657735482450,CSE 140,A01,083663,Gungor; Onat,15,0,85,70
1657735488476,CSE 140L,A01,083088,Eldon; John,23,0,100,77
1657735494499,CSE 175,A01,083665,Kumar; Rakesh,3,0,25,22
1657735500526,CSE 190,A00,092507,Dubnov; Shlomo,8,0,20,12
1657735506548,ECE 45,A01,083139,Congero; Spencer William,6,0,75,69
1657735512574,ECE 65,A50,083695,Saad; Andrew S,12,0,30,18
1657735512574,ECE 65,A51,095125,Saad; Andrew S,24,0,26,2
1657735518601,ECE 109,A01,091882,Touri; Behrouz,20,0,70,50
1657735524627,ECE 180,A00,083140,Abi Samra; Nicholas Camill,1,0,30,29
1657735524627,ECE 180,B00,083141,Abi Samra; Nicholas Camill,0,0,30,30
1657735530649,MATH 10A,A01,083735,Patchell; Gregory David,2,0,30,28
1657735530649,MATH 10A,A02,083736,Patchell; Gregory David,20,0,30,10
1657735530649,MATH 10A,A03,083737,Patchell; Gregory David,16,0,30,14
1657735536682,MATH 10B,A01,083207,Lim; Seonhee,8,0,34,26
1657735536682,MATH 10B,A02,083208,Lim; Seonhee,9,0,35,26
1657735536682,MATH 10B,A03,093472,Lim; Seonhee,7,0,34,27
1657735536682,MATH 10B,B01,083739,Sinha; Shubham,13,0,30,17
1657735542713,MATH 18,A01,083743,Cinel; Cameron Alexander,9,0,30,21
1657735542713,MATH 18,A02,083744,Cinel; Cameron Alexander,17,0,30,13
1657735542713,MATH 18,A03,083745,Cinel; Cameron Alexander,10,0,30,20
1657735542713,MATH 18,B01,083748,Rideout; David Porter,5,0,37,32
1657735542713,MATH 18,B02,083749,Rideout; David Porter,5,0,36,31
1657735542713,MATH 18,B03,083750,Rideout; David Porter,3,0,37,34
1657735542713,MATH 18,B04,083751,Rideout; David Porter,6,0,36,30
1657735542713,MATH 18,B05,093473,Rideout; David Porter,6,0,36,30
1657735542713,MATH 18,B06,093474,Rideout; David Porter,6,0,36,30
1657735548736,MATH 20A,A01,083754,Zheng; Zequn,14,0,40,26
1657735554759,MATH 20B,A01,083756,Briones; Jor-el Thomas Caparas,4,0,36,32
1657735554759,MATH 20B,A02,083757,Briones; Jor-el Thomas Caparas,1,0,36,35
1657735554759,MATH 20B,A03,093475,Briones; Jor-el Thomas Caparas,2,0,36,34
1657735560789,MATH 20C,A01,083760,Briones; Jor-el Thomas Caparas,1,0,35,34
1657735560789,MATH 20C,A02,083761,Briones; Jor-el Thomas Caparas,8,0,35,27
1657735560789,MATH 20C,A03,093476,Briones; Jor-el Thomas Caparas,0,1,36,36
1657735560789,MATH 20C,B01,083762,Bach; Quang Tran,1,0,30,29
1657735566819,MATH 20D,A01,083765,Tran; Brian Kha,5,0,30,25
1657735566819,MATH 20D,A02,083766,Tran; Brian Kha,5,0,30,25
1657735566819,MATH 20D,A03,083767,Tran; Brian Kha,5,0,30,25
1657735572850,MATH 20E,A01,083771,Ganguly; Soumya,9,0,32,23
1657735572850,MATH 20E,A02,083772,Ganguly; Soumya,6,0,32,26
1657735572850,MATH 20E,B01,083773,Ciotti; Benjamin,20,0,35,15
1657735572850,MATH 20E,B02,083774,Ciotti; Benjamin,18,0,35,17
1657735578889,MATH 103A,A01,083777,Greenfeld; Be'Eri,3,0,36,33
1657735578889,MATH 103A,A02,083778,Greenfeld; Be'Eri,5,0,36,31
1657735578889,MATH 103A,A03,093561,Greenfeld; Be'Eri,6,0,36,30
1657735578889,MATH 103A,B01,083779,Greenfeld; Be'Eri,7,0,36,29
1657735578889,MATH 103A,B02,083780,Greenfeld; Be'Eri,4,0,36,32
1657735578889,MATH 103A,B03,093562,Greenfeld; Be'Eri,3,0,36,33
1657735584913,MATH 105,A01,085443,Carter; Anne Toulson,15,0,35,20
1657735584913,MATH 105,A02,093477,Carter; Anne Toulson,20,0,35,15
1657735590937,MATH 109,A01,083213,Ganzberger; Geoffrey Michael,2,0,34,32
1657735590937,MATH 109,A02,083214,Ganzberger; Geoffrey Michael,4,0,34,30
1657735590937,MATH 109,A03,093478,Ganzberger; Geoffrey Michael,2,0,34,32
1657735590937,MATH 109,B01,083215,Ganzberger; Geoffrey Michael,1,0,32,31
1657735590937,MATH 109,B02,083216,Ganzberger; Geoffrey Michael,2,0,32,30
1657735590937,MATH 109,B03,093479,Ganzberger; Geoffrey Michael,8,0,32,24
1657735596962,MATH 142A,A01,083219,Chow; Bennett,7,0,32,25
1657735596962,MATH 142A,A02,083220,Chow; Bennett,10,0,32,22
1657735596962,MATH 142A,A03,093480,Chow; Bennett,9,0,32,23
1657735596962,MATH 142A,B03,093481,Chow; Bennett,8,0,32,24
1657735596962,MATH 142A,B04,093558,Chow; Bennett,13,0,32,19
1657735596962,MATH 142A,B05,093559,Chow; Bennett,6,0,32,26
1657735603001,MATH 193A,A01,083224,Rotar; Vladimir,8,0,34,26
1657735603001,MATH 193A,A02,083225,Rotar; Vladimir,9,0,34,25
1657735603001,MATH 193A,A03,083781,Rotar; Vladimir,5,0,34,29
1657735603001,MATH 193A,A04,083782,Rotar; Vladimir,10,0,34,24
1657735603001,MATH 193A,A05,093482,Rotar; Vladimir,10,0,34,24
1657735609026,MATH 197,001,091859,McAuley; Julian John,9999,0,9999,0
1657735609026,MATH 197,002,095566,Kedlaya; Kiran S.,9997,0,9999,2
1657735609026,MATH 197,003,095567,Xiao; Ming,9999,0,9999,0
1657735609026,MATH 197,004,095571,Perols; Johan Lars,9998,0,9999,1
1657735616078,COGS 9,A01,083615,Shannon; Kyle Michael,9,0,75,66
1657735622109,COGS 11,A01,083617,Boyle; Mary E. T.,23,0,48,25
1657735628131,COGS 13,A01,083071,Bastos; Amalia Pinkusfeld,11,0,71,60
1657735634153,COGS 14A,A01,092681,Semenuks; Arturs,5,1,100,95
1657735640186,COGS 14B,A01,083073,Cheng; Tzu-Han,6,0,63,57
1657735646211,COGS 17,A01,092677,Semenuks; Arturs,6,0,81,75
1657735652238,COGS 100,A01,083619,Allen; Michael Gordon,17,0,70,53
1657735658269,COGS 101A,A01,083621,Davis; Joshua Daniel,9,0,68,59
1657735664295,COGS 101B,A01,091572,Allen; Michael Gordon,12,0,65,53
1657735670319,COGS 101C,A01,083625,Delgado; Tania,17,0,35,18
1657735676356,COGS 107A,A01,083627,Boyle; Mary E. T.,13,0,60,47
1657735682379,COGS 118A,A01,083075,Gupta; Anjum,21,0,76,55
1657735688405,CSE 3,A50,083646,Miranda; Gregory Joseph,24,0,50,26
1657735694434,CSE 8A,A50,083650,Miranda; Gregory Joseph,17,1,56,39
1657735700456,CSE 11,A01,083080,Cao; Yingjun,6,15,40,34
1657735706483,CSE 12,A01,083652,Krause-Levy; Sophia Louisa,28,1,120,92
1657735712505,CSE 15L,A01,083654,Morris; Justin Loren,9,0,50,41
1657735712505,CSE 15L,A02,083655,Morris; Justin Loren,9,0,50,41
1657735718528,CSE 20,A01,083657,Tran; Khoa Dang,39,0,80,41
1657735724554,CSE 21,A01,095574,Bach; Quang Tran,22,0,48,26
1657735730581,CSE 30,A01,083084,Eldon; John,6,0,80,74
1657735730581,CSE 30,B01,095061,Bhaskar; Nishant,9,0,50,41
1657735736623,CSE 100,A01,083659,Cao; Yingjun,5,4,70,65
1657735742647,CSE 134B,A01,083661,Powell; Thomas Allan,23,0,100,77
1657735748671,CSE 140,A01,083663,Gungor; Onat,15,0,85,70
1657735754694,CSE 140L,A01,083088,Eldon; John,23,0,100,77
1657735760725,CSE 175,A01,083665,Kumar; Rakesh,3,0,25,22
1657735766750,CSE 190,A00,092507,Dubnov; Shlomo,8,0,20,12
1657735772778,ECE 45,A01,083139,Congero; Spencer William,6,0,75,69
1657735778819,ECE 65,A50,083695,Saad; Andrew S,12,0,30,18
1657735778819,ECE 65,A51,095125,Saad; Andrew S,24,0,26,2
1657735784842,ECE 109,A01,091882,Touri; Behrouz,20,0,70,50
1657735790874,ECE 180,A00,083140,Abi Samra; Nicholas Camill,1,0,30,29
1657735790874,ECE 180,B00,083141,Abi Samra; Nicholas Camill,0,0,30,30
1657735796896,MATH 10A,A01,083735,Patchell; Gregory David,2,0,30,28
1657735796896,MATH 10A,A02,083736,Patchell; Gregory David,20,0,30,10
1657735796896,MATH 10A,A03,083737,Patchell; Gregory David,16,0,30,14
1657735802920,MATH 10B,A01,083207,Lim; Seonhee,8,0,34,26
1657735802920,MATH 10B,A02,083208,Lim; Seonhee,9,0,35,26
1657735802920,MATH 10B,A03,093472,Lim; Seonhee,7,0,34,27
1657735802920,MATH 10B,B01,083739,Sinha; Shubham,13,0,30,17
1657735808944,MATH 18,A01,083743,Cinel; Cameron Alexander,9,0,30,21
1657735808944,MATH 18,A02,083744,Cinel; Cameron Alexander,17,0,30,13
1657735808944,MATH 18,A03,083745,Cinel; Cameron Alexander,10,0,30,20
1657735808944,MATH 18,B01,083748,Rideout; David Porter,5,0,37,32
1657735808944,MATH 18,B02,083749,Rideout; David Porter,5,0,36,31
1657735808944,MATH 18,B03,083750,Rideout; David Porter,3,0,37,34
1657735808944,MATH 18,B04,083751,Rideout; David Porter,6,0,36,30
1657735808944,MATH 18,B05,093473,Rideout; David Porter,6,0,36,30
1657735808944,MATH 18,B06,093474,Rideout; David Porter,6,0,36,30
1657735814967,MATH 20A,A01,083754,Zheng; Zequn,14,0,40,26
1657735820990,MATH 20B,A01,083756,Briones; Jor-el Thomas Caparas,4,0,36,32
1657735820990,MATH 20B,A02,083757,Briones; Jor-el Thomas Caparas,1,0,36,35
1657735820990,MATH 20B,A03,093475,Briones; Jor-el Thomas Caparas,2,0,36,34
1657735827014,MATH 20C,A01,083760,Briones; Jor-el Thomas Caparas,1,0,35,34
1657735827014,MATH 20C,A02,083761,Briones; Jor-el Thomas Caparas,8,0,35,27
1657735827014,MATH 20C,A03,093476,Briones; Jor-el Thomas Caparas,0,1,36,36
1657735827014,MATH 20C,B01,083762,Bach; Quang Tran,1,0,30,29
1657735833040,MATH 20D,A01,083765,Tran; Brian Kha,5,0,30,25
1657735833040,MATH 20D,A02,083766,Tran; Brian Kha,5,0,30,25
1657735833040,MATH 20D,A03,083767,Tran; Brian Kha,5,0,30,25
1657735839065,MATH 20E,A01,083771,Ganguly; Soumya,9,0,32,23
1657735839065,MATH 20E,A02,083772,Ganguly; Soumya,6,0,32,26
1657735839065,MATH 20E,B01,083773,Ciotti; Benjamin,20,0,35,15
1657735839065,MATH 20E,B02,083774,Ciotti; Benjamin,18,0,35,17
1657735845096,MATH 103A,A01,083777,Greenfeld; Be'Eri,3,0,36,33
1657735845096,MATH 103A,A02,083778,Greenfeld; Be'Eri,5,0,36,31
1657735845096,MATH 103A,A03,093561,Greenfeld; Be'Eri,6,0,36,30
1657735845096,MATH 103A,B01,083779,Greenfeld; Be'Eri,7,0,36,29
1657735845096,MATH 103A,B02,083780,Greenfeld; Be'Eri,4,0,36,32
1657735845096,MATH 103A,B03,093562,Greenfeld; Be'Eri,3,0,36,33
1657735851125,MATH 105,A01,085443,Carter; Anne Toulson,15,0,35,20
1657735851125,MATH 105,A02,093477,Carter; Anne Toulson,20,0,35,15
1657735857170,MATH 109,A01,083213,Ganzberger; Geoffrey Michael,2,0,34,32
1657735857170,MATH 109,A02,083214,Ganzberger; Geoffrey Michael,4,0,34,30
1657735857170,MATH 109,A03,093478,Ganzberger; Geoffrey Michael,2,0,34,32
1657735857170,MATH 109,B01,083215,Ganzberger; Geoffrey Michael,1,0,32,31
1657735857170,MATH 109,B02,083216,Ganzberger; Geoffrey Michael,2,0,32,30
1657735857170,MATH 109,B03,093479,Ganzberger; Geoffrey Michael,8,0,32,24
1657735863199,MATH 142A,A01,083219,Chow; Bennett,7,0,32,25
1657735863199,MATH 142A,A02,083220,Chow; Bennett,10,0,32,22
1657735863199,MATH 142A,A03,093480,Chow; Bennett,9,0,32,23
1657735863199,MATH 142A,B03,093481,Chow; Bennett,8,0,32,24
1657735863199,MATH 142A,B04,093558,Chow; Bennett,13,0,32,19
1657735863199,MATH 142A,B05,093559,Chow; Bennett,6,0,32,26
1657735869227,MATH 193A,A01,083224,Rotar; Vladimir,8,0,34,26
1657735869227,MATH 193A,A02,083225,Rotar; Vladimir,9,0,34,25
1657735869227,MATH 193A,A03,083781,Rotar; Vladimir,5,0,34,29
1657735869227,MATH 193A,A04,083782,Rotar; Vladimir,10,0,34,24
1657735869227,MATH 193A,A05,093482,Rotar; Vladimir,10,0,34,24
1657735875252,MATH 197,001,091859,McAuley; Julian John,9999,0,9999,0
1657735875252,MATH 197,002,095566,Kedlaya; Kiran S.,9997,0,9999,2
1657735875252,MATH 197,003,095567,Xiao; Ming,9999,0,9999,0
1657735875252,MATH 197,004,095571,Perols; Johan Lars,9998,0,9999,1
1657735882302,COGS 9,A01,083615,Shannon; Kyle Michael,9,0,75,66
1657735888324,COGS 11,A01,083617,Boyle; Mary E. T.,23,0,48,25
1657735894351,COGS 13,A01,083071,Bastos; Amalia Pinkusfeld,11,0,71,60
1657735900377,COGS 14A,A01,092681,Semenuks; Arturs,5,1,100,95
1657735906398,COGS 14B,A01,083073,Cheng; Tzu-Han,6,0,63,57
1657735912425,COGS 17,A01,092677,Semenuks; Arturs,6,0,81,75
1657735918451,COGS 100,A01,083619,Allen; Michael Gordon,17,0,70,53
1657735924475,COGS 101A,A01,083621,Davis; Joshua Daniel,9,0,68,59
1657735930575,COGS 101B,A01,091572,Allen; Michael Gordon,12,0,65,53
1657735936600,COGS 101C,A01,083625,Delgado; Tania,17,0,35,18
1657735942626,COGS 107A,A01,083627,Boyle; Mary E. T.,13,0,60,47
1657735948660,COGS 118A,A01,083075,Gupta; Anjum,21,0,76,55
1657735954686,CSE 3,A50,083646,Miranda; Gregory Joseph,24,0,50,26
1657735960708,CSE 8A,A50,083650,Miranda; Gregory Joseph,17,1,56,39
1657735966733,CSE 11,A01,083080,Cao; Yingjun,6,15,40,34
1657735972764,CSE 12,A01,083652,Krause-Levy; Sophia Louisa,28,1,120,92
1657735978785,CSE 15L,A01,083654,Morris; Justin Loren,9,0,50,41
1657735978785,CSE 15L,A02,083655,Morris; Justin Loren,9,0,50,41
1657735984812,CSE 20,A01,083657,Tran; Khoa Dang,39,0,80,41
1657735990834,CSE 21,A01,095574,Bach; Quang Tran,22,0,48,26
1657735996870,CSE 30,A01,083084,Eldon; John,6,0,80,74
1657735996870,CSE 30,B01,095061,Bhaskar; Nishant,9,0,50,41
1657736002892,CSE 100,A01,083659,Cao; Yingjun,5,4,70,65
1657736008917,CSE 134B,A01,083661,Powell; Thomas Allan,23,0,100,77
1657736014940,CSE 140,A01,083663,Gungor; Onat,15,0,85,70
1657736020964,CSE 140L,A01,083088,Eldon; John,23,0,100,77
1657736026989,CSE 175,A01,083665,Kumar; Rakesh,3,0,25,22
1657736033013,CSE 190,A00,092507,Dubnov; Shlomo,8,0,20,12
1657736039037,ECE 45,A01,083139,Congero; Spencer William,6,0,75,69
1657736045064,ECE 65,A50,083695,Saad; Andrew S,12,0,30,18
1657736045064,ECE 65,A51,095125,Saad; Andrew S,24,0,26,2
1657736051099,ECE 109,A01,091882,Touri; Behrouz,20,0,70,50
1657736057122,ECE 180,A00,083140,Abi Samra; Nicholas Camill,1,0,30,29
1657736057122,ECE 180,B00,083141,Abi Samra; Nicholas Camill,0,0,30,30
1657736063150,MATH 10A,A01,083735,Patchell; Gregory David,2,0,30,28
1657736063150,MATH 10A,A02,083736,Patchell; Gregory David,20,0,30,10
1657736063150,MATH 10A,A03,083737,Patchell; Gregory David,16,0,30,14
1657736069175,MATH 10B,A01,083207,Lim; Seonhee,8,0,34,26
1657736069175,MATH 10B,A02,083208,Lim; Seonhee,9,0,35,26
1657736069175,MATH 10B,A03,093472,Lim; Seonhee,7,0,34,27
1657736069175,MATH 10B,B01,083739,Sinha; Shubham,13,0,30,17
1657736075203,MATH 18,A01,083743,Cinel; Cameron Alexander,9,0,30,21
1657736075203,MATH 18,A02,083744,Cinel; Cameron Alexander,17,0,30,13
1657736075203,MATH 18,A03,083745,Cinel; Cameron Alexander,10,0,30,20
1657736075203,MATH 18,B01,083748,Rideout; David Porter,5,0,37,32
1657736075203,MATH 18,B02,083749,Rideout; David Porter,5,0,36,31
1657736075203,MATH 18,B03,083750,Rideout; David Porter,3,0,37,34
1657736075203,MATH 18,B04,083751,Rideout; David Porter,6,0,36,30
1657736075203,MATH 18,B05,093473,Rideout; David Porter,6,0,36,30
1657736075203,MATH 18,B06,093474,Rideout; David Porter,6,0,36,30
1657736081230,MATH 20A,A01,083754,Zheng; Zequn,14,0,40,26
1657736087271,MATH 20B,A01,083756,Briones; Jor-el Thomas Caparas,4,0,36,32
1657736087271,MATH 20B,A02,083757,Briones; Jor-el Thomas Caparas,1,0,36,35
1657736087271,MATH 20B,A03,093475,Briones; Jor-el Thomas Caparas,2,0,36,34
1657736093293,MATH 20C,A01,083760,Briones; Jor-el Thomas Caparas,1,0,35,34
1657736093293,MATH 20C,A02,083761,Briones; Jor-el Thomas Caparas,8,0,35,27
1657736093293,MATH 20C,A03,093476,Briones; Jor-el Thomas Caparas,0,1,36,36
1657736093293,MATH 20C,B01,083762,Bach; Quang Tran,1,0,30,29
1657736099320,MATH 20D,A01,083765,Tran; Brian Kha,5,0,30,25
1657736099320,MATH 20D,A02,083766,Tran; Brian Kha,5,0,30,25
1657736099320,MATH 20D,A03,083767,Tran; Brian Kha,5,0,30,25
1657736105350,MATH 20E,A01,083771,Ganguly; Soumya,9,0,32,23
1657736105350,MATH 20E,A02,083772,Ganguly; Soumya,6,0,32,26
1657736105350,MATH 20E,B01,083773,Ciotti; Benjamin,20,0,35,15
1657736105350,MATH 20E,B02,083774,Ciotti; Benjamin,18,0,35,17
1657736111386,MATH 103A,A01,083777,Greenfeld; Be'Eri,3,0,36,33
1657736111386,MATH 103A,A02,083778,Greenfeld; Be'Eri,5,0,36,31
1657736111386,MATH 103A,A03,093561,Greenfeld; Be'Eri,6,0,36,30
1657736111386,MATH 103A,B01,083779,Greenfeld; Be'Eri,7,0,36,29
1657736111386,MATH 103A,B02,083780,Greenfeld; Be'Eri,4,0,36,32
1657736111386,MATH 103A,B03,093562,Greenfeld; Be'Eri,3,0,36,33
1657736117425,MATH 105,A01,085443,Carter; Anne Toulson,15,0,35,20
1657736117425,MATH 105,A02,093477,Carter; Anne Toulson,20,0,35,15
1657736123448,MATH 109,A01,083213,Ganzberger; Geoffrey Michael,2,0,34,32
1657736123448,MATH 109,A02,083214,Ganzberger; Geoffrey Michael,4,0,34,30
1657736123448,MATH 109,A03,093478,Ganzberger; Geoffrey Michael,2,0,34,32
1657736123448,MATH 109,B01,083215,Ganzberger; Geoffrey Michael,1,0,32,31
1657736123448,MATH 109,B02,083216,Ganzberger; Geoffrey Michael,2,0,32,30
1657736123448,MATH 109,B03,093479,Ganzberger; Geoffrey Michael,8,0,32,24
1657736129472,MATH 142A,A01,083219,Chow; Bennett,7,0,32,25
1657736129472,MATH 142A,A02,083220,Chow; Bennett,10,0,32,22
1657736129472,MATH 142A,A03,093480,Chow; Bennett,9,0,32,23
1657736129472,MATH 142A,B03,093481,Chow; Bennett,8,0,32,24
1657736129472,MATH 142A,B04,093558,Chow; Bennett,13,0,32,19
1657736129472,MATH 142A,B05,093559,Chow; Bennett,6,0,32,26
1657736135493,MATH 193A,A01,083224,Rotar; Vladimir,8,0,34,26
1657736135493,MATH 193A,A02,083225,Rotar; Vladimir,9,0,34,25
1657736135493,MATH 193A,A03,083781,Rotar; Vladimir,5,0,34,29
1657736135493,MATH 193A,A04,083782,Rotar; Vladimir,10,0,34,24
1657736135493,MATH 193A,A05,093482,Rotar; Vladimir,10,0,34,24
1657736141527,MATH 197,001,091859,McAuley; Julian John,9999,0,9999,0
1657736141527,MATH 197,002,095566,Kedlaya; Kiran S.,9997,0,9999,2
1657736141527,MATH 197,003,095567,Xiao; Ming,9999,0,9999,0
1657736141527,MATH 197,004,095571,Perols; Johan Lars,9998,0,9999,1
1657736148578,COGS 9,A01,083615,Shannon; Kyle Michael,9,0,75,66
1657736154618,COGS 11,A01,083617,Boyle; Mary E. T.,23,0,48,25
1657736160643,COGS 13,A01,083071,Bastos; Amalia Pinkusfeld,11,0,71,60
1657736166668,COGS 14A,A01,092681,Semenuks; Arturs,5,1,100,95
1657736172697,COGS 14B,A01,083073,Cheng; Tzu-Han,6,0,63,57
1657736178719,COGS 17,A01,092677,Semenuks; Arturs,6,0,81,75
1657736184747,COGS 100,A01,083619,Allen; Michael Gordon,17,0,70,53
1657736190776,COGS 101A,A01,083621,Davis; Joshua Daniel,9,0,68,59
1657736196800,COGS 101B,A01,091572,Allen; Michael Gordon,12,0,65,53
1657736202824,COGS 101C,A01,083625,Delgado; Tania,17,0,35,18
1657736208846,COGS 107A,A01,083627,Boyle; Mary E. T.,13,0,60,47
1657736214871,COGS 118A,A01,083075,Gupta; Anjum,21,0,76,55
1657736220893,CSE 3,A50,083646,Miranda; Gregory Joseph,24,0,50,26
1657736226920,CSE 8A,A50,083650,Miranda; Gregory Joseph,17,1,56,39
1657736232946,CSE 11,A01,083080,Cao; Yingjun,6,15,40,34
1657736238974,CSE 12,A01,083652,Krause-Levy; Sophia Louisa,28,1,120,92
1657736245001,CSE 15L,A01,083654,Morris; Justin Loren,9,0,50,41
1657736245001,CSE 15L,A02,083655,Morris; Justin Loren,9,0,50,41
1657736251026,CSE 20,A01,083657,Tran; Khoa Dang,39,0,80,41
1657736257052,CSE 21,A01,095574,Bach; Quang Tran,22,0,48,26
1657736263079,CSE 30,A01,083084,Eldon; John,6,0,80,74
1657736263079,CSE 30,B01,095061,Bhaskar; Nishant,9,0,50,41
1657736269115,CSE 100,A01,083659,Cao; Yingjun,5,4,70,65
1657736275140,CSE 134B,A01,083661,Powell; Thomas Allan,23,0,100,77
1657736281163,CSE 140,A01,083663,Gungor; Onat,15,0,85,70
1657736287186,CSE 140L,A01,083088,Eldon; John,23,0,100,77
1657736293212,CSE 175,A01,083665,Kumar; Rakesh,3,0,25,22
1657736299235,CSE 190,A00,092507,Dubnov; Shlomo,8,0,20,12
1657736305262,ECE 45,A01,083139,Congero; Spencer William,6,0,75,69
1657736311283,ECE 65,A50,083695,Saad; Andrew S,12,0,30,18
1657736311283,ECE 65,A51,095125,Saad; Andrew S,24,0,26,2
1657736317320,ECE 109,A01,091882,Touri; Behrouz,20,0,70,50
1657736323345,ECE 180,A00,083140,Abi Samra; Nicholas Camill,1,0,30,29
1657736323345,ECE 180,B00,083141,Abi Samra; Nicholas Camill,0,0,30,30
1657736329369,MATH 10A,A01,083735,Patchell; Gregory David,2,0,30,28
1657736329369,MATH 10A,A02,083736,Patchell; Gregory David,20,0,30,10
1657736329369,MATH 10A,A03,083737,Patchell; Gregory David,16,0,30,14
1657736335397,MATH 10B,A01,083207,Lim; Seonhee,8,0,34,26
1657736335397,MATH 10B,A02,083208,Lim; Seonhee,9,0,35,26
1657736335397,MATH 10B,A03,093472,Lim; Seonhee,7,0,34,27
1657736335397,MATH 10B,B01,083739,Sinha; Shubham,13,0,30,17
1657736341428,MATH 18,A01,083743,Cinel; Cameron Alexander,9,0,30,21
1657736341428,MATH 18,A02,083744,Cinel; Cameron Alexander,17,0,30,13
1657736341428,MATH 18,A03,083745,Cinel; Cameron Alexander,10,0,30,20
1657736341428,MATH 18,B01,083748,Rideout; David Porter,5,0,37,32
1657736341428,MATH 18,B02,083749,Rideout; David Porter,5,0,36,31
1657736341428,MATH 18,B03,083750,Rideout; David Porter,3,0,37,34
1657736341428,MATH 18,B04,083751,Rideout; David Porter,6,0,36,30
1657736341428,MATH 18,B05,093473,Rideout; David Porter,6,0,36,30
1657736341428,MATH 18,B06,093474,Rideout; David Porter,6,0,36,30
1657736347454,MATH 20A,A01,083754,Zheng; Zequn,14,0,40,26
1657736353488,MATH 20B,A01,083756,Briones; Jor-el Thomas Caparas,4,0,36,32
1657736353488,MATH 20B,A02,083757,Briones; Jor-el Thomas Caparas,1,0,36,35
1657736353488,MATH 20B,A03,093475,Briones; Jor-el Thomas Caparas,2,0,36,34
1657736359521,MATH 20C,A01,083760,Briones; Jor-el Thomas Caparas,1,0,35,34
1657736359521,MATH 20C,A02,083761,Briones; Jor-el Thomas Caparas,8,0,35,27
1657736359521,MATH 20C,A03,093476,Briones; Jor-el Thomas Caparas,0,1,36,36
1657736359521,MATH 20C,B01,083762,Bach; Quang Tran,1,0,30,29
1657736365546,MATH 20D,A01,083765,Tran; Brian Kha,5,0,30,25
1657736365546,MATH 20D,A02,083766,Tran; Brian Kha,5,0,30,25
1657736365546,MATH 20D,A03,083767,Tran; Brian Kha,5,0,30,25
1657736371580,MATH 20E,A01,083771,Ganguly; Soumya,9,0,32,23
1657736371580,MATH 20E,A02,083772,Ganguly; Soumya,6,0,32,26
1657736371580,MATH 20E,B01,083773,Ciotti; Benjamin,20,0,35,15
1657736371580,MATH 20E,B02,083774,Ciotti; Benjamin,18,0,35,17
1657736377607,MATH 103A,A01,083777,Greenfeld; Be'Eri,3,0,36,33
1657736377607,MATH 103A,A02,083778,Greenfeld; Be'Eri,5,0,36,31
1657736377607,MATH 103A,A03,093561,Greenfeld; Be'Eri,6,0,36,30
1657736377607,MATH 103A,B01,083779,Greenfeld; Be'Eri,7,0,36,29
1657736377607,MATH 103A,B02,083780,Greenfeld; Be'Eri,4,0,36,32
1657736377607,MATH 103A,B03,093562,Greenfeld; Be'Eri,3,0,36,33
1657736383643,MATH 105,A01,085443,Carter; Anne Toulson,15,0,35,20
1657736383643,MATH 105,A02,093477,Carter; Anne Toulson,20,0,35,15
1657736389669,MATH 109,A01,083213,Ganzberger; Geoffrey Michael,2,0,34,32
1657736389669,MATH 109,A02,083214,Ganzberger; Geoffrey Michael,4,0,34,30
1657736389669,MATH 109,A03,093478,Ganzberger; Geoffrey Michael,2,0,34,32
1657736389669,MATH 109,B01,083215,Ganzberger; Geoffrey Michael,1,0,32,31
1657736389669,MATH 109,B02,083216,Ganzberger; Geoffrey Michael,2,0,32,30
1657736389669,MATH 109,B03,093479,Ganzberger; Geoffrey Michael,8,0,32,24
1657736395697,MATH 142A,A01,083219,Chow; Bennett,7,0,32,25
1657736395697,MATH 142A,A02,083220,Chow; Bennett,10,0,32,22
1657736395697,MATH 142A,A03,093480,Chow; Bennett,9,0,32,23
1657736395697,MATH 142A,B03,093481,Chow; Bennett,8,0,32,24
1657736395697,MATH 142A,B04,093558,Chow; Bennett,13,0,32,19
1657736395697,MATH 142A,B05,093559,Chow; Bennett,6,0,32,26
1657736401719,MATH 193A,A01,083224,Rotar; Vladimir,8,0,34,26
1657736401719,MATH 193A,A02,083225,Rotar; Vladimir,9,0,34,25
1657736401719,MATH 193A,A03,083781,Rotar; Vladimir,5,0,34,29
1657736401719,MATH 193A,A04,083782,Rotar; Vladimir,10,0,34,24
1657736401719,MATH 193A,A05,093482,Rotar; Vladimir,10,0,34,24
1657736407748,MATH 197,001,091859,McAuley; Julian John,9999,0,9999,0
1657736407748,MATH 197,002,095566,Kedlaya; Kiran S.,9997,0,9999,2
1657736407748,MATH 197,003,095567,Xiao; Ming,9999,0,9999,0
1657736407748,MATH 197,004,095571,Perols; Johan Lars,9998,0,9999,1
1657736414809,COGS 9,A01,083615,Shannon; Kyle Michael,9,0,75,66
1657736420840,COGS 11,A01,083617,Boyle; Mary E. T.,23,0,48,25
1657736426864,COGS 13,A01,083071,Bastos; Amalia Pinkusfeld,11,0,71,60
1657736432888,COGS 14A,A01,092681,Semenuks; Arturs,5,1,100,95
1657736438913,COGS 14B,A01,083073,Cheng; Tzu-Han,6,0,63,57
1657736444949,COGS 17,A01,092677,Semenuks; Arturs,6,0,81,75
1657736450976,COGS 100,A01,083619,Allen; Michael Gordon,17,0,70,53
1657736457005,COGS 101A,A01,083621,Davis; Joshua Daniel,9,0,68,59
1657736463031,COGS 101B,A01,091572,Allen; Michael Gordon,12,0,65,53
1657736469055,COGS 101C,A01,083625,Delgado; Tania,17,0,35,18
1657736475083,COGS 107A,A01,083627,Boyle; Mary E. T.,13,0,60,47
1657736481110,COGS 118A,A01,083075,Gupta; Anjum,21,0,76,55
1657736487137,CSE 3,A50,083646,Miranda; Gregory Joseph,24,0,50,26
1657736493163,CSE 8A,A50,083650,Miranda; Gregory Joseph,17,1,56,39
1657736499187,CSE 11,A01,083080,Cao; Yingjun,6,15,40,34
1657736505209,CSE 12,A01,083652,Krause-Levy; Sophia Louisa,28,1,120,92
1657736511233,CSE 15L,A01,083654,Morris; Justin Loren,9,0,50,41
1657736511233,CSE 15L,A02,083655,Morris; Justin Loren,9,0,50,41
1657736517260,CSE 20,A01,083657,Tran; Khoa Dang,39,0,80,41
1657736523287,CSE 21,A01,095574,Bach; Quang Tran,22,0,48,26
1657736529386,CSE 30,A01,083084,Eldon; John,6,0,80,74
1657736529386,CSE 30,B01,095061,Bhaskar; Nishant,9,0,50,41
1657736535415,CSE 100,A01,083659,Cao; Yingjun,5,4,70,65
1657736541443,CSE 134B,A01,083661,Powell; Thomas Allan,23,0,100,77
1657736547470,CSE 140,A01,083663,Gungor; Onat,15,0,85,70
1657736553495,CSE 140L,A01,083088,Eldon; John,23,0,100,77
1657736559524,CSE 175,A01,083665,Kumar; Rakesh,3,0,25,22
1657736565550,CSE 190,A00,092507,Dubnov; Shlomo,8,0,20,12
1657736571574,ECE 45,A01,083139,Congero; Spencer William,6,0,75,69
1657736577599,ECE 65,A50,083695,Saad; Andrew S,12,0,30,18
1657736577599,ECE 65,A51,095125,Saad; Andrew S,24,0,26,2
1657736583625,ECE 109,A01,091882,Touri; Behrouz,20,0,70,50
1657736589659,ECE 180,A00,083140,Abi Samra; Nicholas Camill,1,0,30,29
1657736589659,ECE 180,B00,083141,Abi Samra; Nicholas Camill,0,0,30,30
1657736595683,MATH 10A,A01,083735,Patchell; Gregory David,2,0,30,28
1657736595683,MATH 10A,A02,083736,Patchell; Gregory David,20,0,30,10
1657736595683,MATH 10A,A03,083737,Patchell; Gregory David,16,0,30,14
1657736601706,MATH 10B,A01,083207,Lim; Seonhee,8,0,34,26
1657736601706,MATH 10B,A02,083208,Lim; Seonhee,9,0,35,26
1657736601706,MATH 10B,A03,093472,Lim; Seonhee,7,0,34,27
1657736601706,MATH 10B,B01,083739,Sinha; Shubham,13,0,30,17
1657736607737,MATH 18,A01,083743,Cinel; Cameron Alexander,9,0,30,21
1657736607737,MATH 18,A02,083744,Cinel; Cameron Alexander,17,0,30,13
1657736607737,MATH 18,A03,083745,Cinel; Cameron Alexander,10,0,30,20
1657736607737,MATH 18,B01,083748,Rideout; David Porter,5,0,37,32
1657736607737,MATH 18,B02,083749,Rideout; David Porter,5,0,36,31
1657736607737,MATH 18,B03,083750,Rideout; David Porter,3,0,37,34
1657736607737,MATH 18,B04,083751,Rideout; David Porter,6,0,36,30
1657736607737,MATH 18,B05,093473,Rideout; David Porter,6,0,36,30
1657736607737,MATH 18,B06,093474,Rideout; David Porter,6,0,36,30
1657736613763,MATH 20A,A01,083754,Zheng; Zequn,14,0,40,26
1657736619786,MATH 20B,A01,083756,Briones; Jor-el Thomas Caparas,4,0,36,32
1657736619786,MATH 20B,A02,083757,Briones; Jor-el Thomas Caparas,1,0,36,35
1657736619786,MATH 20B,A03,093475,Briones; Jor-el Thomas Caparas,2,0,36,34
1657736625815,MATH 20C,A01,083760,Briones; Jor-el Thomas Caparas,1,0,35,34
1657736625815,MATH 20C,A02,083761,Briones; Jor-el Thomas Caparas,8,0,35,27
1657736625815,MATH 20C,A03,093476,Briones; Jor-el Thomas Caparas,0,1,36,36
1657736625815,MATH 20C,B01,083762,Bach; Quang Tran,1,0,30,29
1657736631846,MATH 20D,A01,083765,Tran; Brian Kha,5,0,30,25
1657736631846,MATH 20D,A02,083766,Tran; Brian Kha,5,0,30,25
1657736631846,MATH 20D,A03,083767,Tran; Brian Kha,5,0,30,25
1657736637870,MATH 20E,A01,083771,Ganguly; Soumya,9,0,32,23
1657736637870,MATH 20E,A02,083772,Ganguly; Soumya,6,0,32,26
1657736637870,MATH 20E,B01,083773,Ciotti; Benjamin,20,0,35,15
1657736637870,MATH 20E,B02,083774,Ciotti; Benjamin,18,0,35,17
1657736643893,MATH 103A,A01,083777,Greenfeld; Be'Eri,3,0,36,33
1657736643893,MATH 103A,A02,083778,Greenfeld; Be'Eri,5,0,36,31
1657736643893,MATH 103A,A03,093561,Greenfeld; Be'Eri,6,0,36,30
1657736643893,MATH 103A,B01,083779,Greenfeld; Be'Eri,7,0,36,29
1657736643893,MATH 103A,B02,083780,Greenfeld; Be'Eri,4,0,36,32
1657736643893,MATH 103A,B03,093562,Greenfeld; Be'Eri,3,0,36,33
1657736649920,MATH 105,A01,085443,Carter; Anne Toulson,15,0,35,20
1657736649920,MATH 105,A02,093477,Carter; Anne Toulson,20,0,35,15
1657736655945,MATH 109,A01,083213,Ganzberger; Geoffrey Michael,2,0,34,32
1657736655945,MATH 109,A02,083214,Ganzberger; Geoffrey Michael,4,0,34,30
1657736655945,MATH 109,A03,093478,Ganzberger; Geoffrey Michael,2,0,34,32
1657736655945,MATH 109,B01,083215,Ganzberger; Geoffrey Michael,1,0,32,31
1657736655945,MATH 109,B02,083216,Ganzberger; Geoffrey Michael,2,0,32,30
1657736655945,MATH 109,B03,093479,Ganzberger; Geoffrey Michael,8,0,32,24
1657736661975,MATH 142A,A01,083219,Chow; Bennett,7,0,32,25
1657736661975,MATH 142A,A02,083220,Chow; Bennett,10,0,32,22
1657736661975,MATH 142A,A03,093480,Chow; Bennett,9,0,32,23
1657736661975,MATH 142A,B03,093481,Chow; Bennett,8,0,32,24
1657736661975,MATH 142A,B04,093558,Chow; Bennett,13,0,32,19
1657736661975,MATH 142A,B05,093559,Chow; Bennett,6,0,32,26
1657736667998,MATH 193A,A01,083224,Rotar; Vladimir,8,0,34,26
1657736667998,MATH 193A,A02,083225,Rotar; Vladimir,9,0,34,25
1657736667998,MATH 193A,A03,083781,Rotar; Vladimir,5,0,34,29
1657736667998,MATH 193A,A04,083782,Rotar; Vladimir,10,0,34,24
1657736667998,MATH 193A,A05,093482,Rotar; Vladimir,10,0,34,24
1657736674022,MATH 197,001,091859,McAuley; Julian John,9999,0,9999,0
1657736674022,MATH 197,002,095566,Kedlaya; Kiran S.,9997,0,9999,2
1657736674022,MATH 197,003,095567,Xiao; Ming,9999,0,9999,0
1657736674022,MATH 197,004,095571,Perols; Johan Lars,9998,0,9999,1
1657736681079,COGS 9,A01,083615,Shannon; Kyle Michael,9,0,75,66
1657736687105,COGS 11,A01,083617,Boyle; Mary E. T.,23,0,48,25
1657736693128,COGS 13,A01,083071,Bastos; Amalia Pinkusfeld,11,0,71,60
1657736699161,COGS 14A,A01,092681,Semenuks; Arturs,5,1,100,95
1657736705184,COGS 14B,A01,083073,Cheng; Tzu-Han,6,0,63,57
1657736711212,COGS 17,A01,092677,Semenuks; Arturs,6,0,81,75
1657736717241,COGS 100,A01,083619,Allen; Michael Gordon,17,0,70,53
1657736723267,COGS 101A,A01,083621,Davis; Joshua Daniel,9,0,68,59
1657736729295,COGS 101B,A01,091572,Allen; Michael Gordon,12,0,65,53
1657736735325,COGS 101C,A01,083625,Delgado; Tania,17,0,35,18
1657736741353,COGS 107A,A01,083627,Boyle; Mary E. T.,13,0,60,47
1657736747380,COGS 118A,A01,083075,Gupta; Anjum,21,0,76,55
1657736753404,CSE 3,A50,083646,Miranda; Gregory Joseph,24,0,50,26
1657736759427,CSE 8A,A50,083650,Miranda; Gregory Joseph,17,1,56,39
1657736765449,CSE 11,A01,083080,Cao; Yingjun,6,15,40,34
1657736771474,CSE 12,A01,083652,Krause-Levy; Sophia Louisa,28,1,120,92
1657736777499,CSE 15L,A01,083654,Morris; Justin Loren,9,0,50,41
1657736777499,CSE 15L,A02,083655,Morris; Justin Loren,9,0,50,41
1657736783526,CSE 20,A01,083657,Tran; Khoa Dang,39,0,80,41
1657736789562,CSE 21,A01,095574,Bach; Quang Tran,22,0,48,26
1657736795584,CSE 30,A01,083084,Eldon; John,6,0,80,74
1657736795584,CSE 30,B01,095061,Bhaskar; Nishant,9,0,50,41
1657736801609,CSE 100,A01,083659,Cao; Yingjun,5,4,70,65
1657736807635,CSE 134B,A01,083661,Powell; Thomas Allan,23,0,100,77
1657736813660,CSE 140,A01,083663,Gungor; Onat,15,0,85,70
1657736819701,CSE 140L,A01,083088,Eldon; John,23,0,100,77
1657736825724,CSE 175,A01,083665,Kumar; Rakesh,3,0,25,22
1657736831748,CSE 190,A00,092507,Dubnov; Shlomo,8,0,20,12
1657736837779,ECE 45,A01,083139,Congero; Spencer William,6,0,75,69
1657736843807,ECE 65,A50,083695,Saad; Andrew S,12,0,30,18
1657736843807,ECE 65,A51,095125,Saad; Andrew S,24,0,26,2
1657736849831,ECE 109,A01,091882,Touri; Behrouz,20,0,70,50
1657736855862,ECE 180,A00,083140,Abi Samra; Nicholas Camill,1,0,30,29
1657736855862,ECE 180,B00,083141,Abi Samra; Nicholas Camill,0,0,30,30
1657736861895,MATH 10A,A01,083735,Patchell; Gregory David,2,0,30,28
1657736861895,MATH 10A,A02,083736,Patchell; Gregory David,20,0,30,10
1657736861895,MATH 10A,A03,083737,Patchell; Gregory David,16,0,30,14
1657736867923,MATH 10B,A01,083207,Lim; Seonhee,8,0,34,26
1657736867923,MATH 10B,A02,083208,Lim; Seonhee,9,0,35,26
1657736867923,MATH 10B,A03,093472,Lim; Seonhee,7,0,34,27
1657736867923,MATH 10B,B01,083739,Sinha; Shubham,13,0,30,17
1657736873948,MATH 18,A01,083743,Cinel; Cameron Alexander,9,0,30,21
1657736873948,MATH 18,A02,083744,Cinel; Cameron Alexander,17,0,30,13
1657736873948,MATH 18,A03,083745,Cinel; Cameron Alexander,10,0,30,20
1657736873948,MATH 18,B01,083748,Rideout; David Porter,5,0,37,32
1657736873948,MATH 18,B02,083749,Rideout; David Porter,5,0,36,31
1657736873948,MATH 18,B03,083750,Rideout; David Porter,3,0,37,34
1657736873948,MATH 18,B04,083751,Rideout; David Porter,6,0,36,30
1657736873948,MATH 18,B05,093473,Rideout; David Porter,6,0,36,30
1657736873948,MATH 18,B06,093474,Rideout; David Porter,6,0,36,30
1657736879973,MATH 20A,A01,083754,Zheng; Zequn,14,0,40,26
1657736886014,MATH 20B,A01,083756,Briones; Jor-el Thomas Caparas,4,0,36,32
1657736886014,MATH 20B,A02,083757,Briones; Jor-el Thomas Caparas,1,0,36,35
1657736886014,MATH 20B,A03,093475,Briones; Jor-el Thomas Caparas,2,0,36,34
1657736892038,MATH 20C,A01,083760,Briones; Jor-el Thomas Caparas,1,0,35,34
1657736892038,MATH 20C,A02,083761,Briones; Jor-el Thomas Caparas,8,0,35,27
1657736892038,MATH 20C,A03,093476,Briones; Jor-el Thomas Caparas,0,1,36,36
1657736892038,MATH 20C,B01,083762,Bach; Quang Tran,1,0,30,29
1657736898075,MATH 20D,A01,083765,Tran; Brian Kha,5,0,30,25
1657736898075,MATH 20D,A02,083766,Tran; Brian Kha,5,0,30,25
1657736898075,MATH 20D,A03,083767,Tran; Brian Kha,5,0,30,25
1657736904103,MATH 20E,A01,083771,Ganguly; Soumya,9,0,32,23
1657736904103,MATH 20E,A02,083772,Ganguly; Soumya,6,0,32,26
1657736904103,MATH 20E,B01,083773,Ciotti; Benjamin,20,0,35,15
1657736904103,MATH 20E,B02,083774,Ciotti; Benjamin,18,0,35,17
1657736910133,MATH 103A,A01,083777,Greenfeld; Be'Eri,3,0,36,33
1657736910133,MATH 103A,A02,083778,Greenfeld; Be'Eri,5,0,36,31
1657736910133,MATH 103A,A03,093561,Greenfeld; Be'Eri,6,0,36,30
1657736910133,MATH 103A,B01,083779,Greenfeld; Be'Eri,7,0,36,29
1657736910133,MATH 103A,B02,083780,Greenfeld; Be'Eri,4,0,36,32
1657736910133,MATH 103A,B03,093562,Greenfeld; Be'Eri,3,0,36,33
1657736916157,MATH 105,A01,085443,Carter; Anne Toulson,15,0,35,20
1657736916157,MATH 105,A02,093477,Carter; Anne Toulson,20,0,35,15
1657736922182,MATH 109,A01,083213,Ganzberger; Geoffrey Michael,2,0,34,32
1657736922182,MATH 109,A02,083214,Ganzberger; Geoffrey Michael,4,0,34,30
1657736922182,MATH 109,A03,093478,Ganzberger; Geoffrey Michael,2,0,34,32
1657736922182,MATH 109,B01,083215,Ganzberger; Geoffrey Michael,1,0,32,31
1657736922182,MATH 109,B02,083216,Ganzberger; Geoffrey Michael,2,0,32,30
1657736922182,MATH 109,B03,093479,Ganzberger; Geoffrey Michael,8,0,32,24
1657736928205,MATH 142A,A01,083219,Chow; Bennett,7,0,32,25
1657736928205,MATH 142A,A02,083220,Chow; Bennett,10,0,32,22
1657736928205,MATH 142A,A03,093480,Chow; Bennett,9,0,32,23
1657736928205,MATH 142A,B03,093481,Chow; Bennett,8,0,32,24
1657736928205,MATH 142A,B04,093558,Chow; Bennett,13,0,32,19
1657736928205,MATH 142A,B05,093559,Chow; Bennett,6,0,32,26
1657736934235,MATH 193A,A01,083224,Rotar; Vladimir,8,0,34,26
1657736934235,MATH 193A,A02,083225,Rotar; Vladimir,9,0,34,25
1657736934235,MATH 193A,A03,083781,Rotar; Vladimir,5,0,34,29
1657736934235,MATH 193A,A04,083782,Rotar; Vladimir,10,0,34,24
1657736934235,MATH 193A,A05,093482,Rotar; Vladimir,10,0,34,24
1657736940275,MATH 197,001,091859,McAuley; Julian John,9999,0,9999,0
1657736940275,MATH 197,002,095566,Kedlaya; Kiran S.,9997,0,9999,2
1657736940275,MATH 197,003,095567,Xiao; Ming,9999,0,9999,0
1657736940275,MATH 197,004,095571,Perols; Johan Lars,9998,0,9999,1
1657736947341,COGS 9,A01,083615,Shannon; Kyle Michael,9,0,75,66
1657736953365,COGS 11,A01,083617,Boyle; Mary E. T.,23,0,48,25
1657736959388,COGS 13,A01,083071,Bastos; Amalia Pinkusfeld,11,0,71,60
1657736965410,COGS 14A,A01,092681,Semenuks; Arturs,5,1,100,95
1657736971432,COGS 14B,A01,083073,Cheng; Tzu-Han,6,0,63,57
1657736977459,COGS 17,A01,092677,Semenuks; Arturs,6,0,81,75
1657736983499,COGS 100,A01,083619,Allen; Michael Gordon,17,0,70,53
1657736989528,COGS 101A,A01,083621,Davis; Joshua Daniel,9,0,68,59
1657736995558,COGS 101B,A01,091572,Allen; Michael Gordon,12,0,65,53
1657737001598,COGS 101C,A01,083625,Delgado; Tania,17,0,35,18
1657737007621,COGS 107A,A01,083627,Boyle; Mary E. T.,13,0,60,47
1657737013647,COGS 118A,A01,083075,Gupta; Anjum,21,0,76,55
1657737019670,CSE 3,A50,083646,Miranda; Gregory Joseph,24,0,50,26
1657737025697,CSE 8A,A50,083650,Miranda; Gregory Joseph,17,1,56,39
1657737031719,CSE 11,A01,083080,Cao; Yingjun,6,15,40,34
1657737037745,CSE 12,A01,083652,Krause-Levy; Sophia Louisa,28,1,120,92
1657737043772,CSE 15L,A01,083654,Morris; Justin Loren,9,0,50,41
1657737043772,CSE 15L,A02,083655,Morris; Justin Loren,9,0,50,41
1657737049798,CSE 20,A01,083657,Tran; Khoa Dang,39,0,80,41
1657737055833,CSE 21,A01,095574,Bach; Quang Tran,22,0,48,26
1657737061857,CSE 30,A01,083084,Eldon; John,6,0,80,74
1657737061857,CSE 30,B01,095061,Bhaskar; Nishant,9,0,50,41
1657737067883,CSE 100,A01,083659,Cao; Yingjun,5,4,70,65
1657737073911,CSE 134B,A01,083661,Powell; Thomas Allan,23,0,100,77
1657737079936,CSE 140,A01,083663,Gungor; Onat,15,0,85,70
1657737085959,CSE 140L,A01,083088,Eldon; John,23,0,100,77
1657737091987,CSE 175,A01,083665,Kumar; Rakesh,3,0,25,22
1657737098016,CSE 190,A00,092507,Dubnov; Shlomo,8,0,20,12
1657737104039,ECE 45,A01,083139,Congero; Spencer William,6,0,75,69
1657737110065,ECE 65,A50,083695,Saad; Andrew S,12,0,30,18
1657737110065,ECE 65,A51,095125,Saad; Andrew S,24,0,26,2
1657737116093,ECE 109,A01,091882,Touri; Behrouz,20,0,70,50
1657737122116,ECE 180,A00,083140,Abi Samra; Nicholas Camill,1,0,30,29
1657737122116,ECE 180,B00,083141,Abi Samra; Nicholas Camill,0,0,30,30
1657737128229,MATH 10A,A01,083735,Patchell; Gregory David,2,0,30,28
1657737128229,MATH 10A,A02,083736,Patchell; Gregory David,20,0,30,10
1657737128229,MATH 10A,A03,083737,Patchell; Gregory David,16,0,30,14
1657737134251,MATH 10B,A01,083207,Lim; Seonhee,8,0,34,26
1657737134251,MATH 10B,A02,083208,Lim; Seonhee,9,0,35,26
1657737134251,MATH 10B,A03,093472,Lim; Seonhee,7,0,34,27
1657737134251,MATH 10B,B01,083739,Sinha; Shubham,13,0,30,17
1657737140276,MATH 18,A01,083743,Cinel; Cameron Alexander,9,0,30,21
1657737140276,MATH 18,A02,083744,Cinel; Cameron Alexander,17,0,30,13
1657737140276,MATH 18,A03,083745,Cinel; Cameron Alexander,10,0,30,20
1657737140276,MATH 18,B01,083748,Rideout; David Porter,5,0,37,32
1657737140276,MATH 18,B02,083749,Rideout; David Porter,5,0,36,31
1657737140276,MATH 18,B03,083750,Rideout; David Porter,3,0,37,34
1657737140276,MATH 18,B04,083751,Rideout; David Porter,6,0,36,30
1657737140276,MATH 18,B05,093473,Rideout; David Porter,6,0,36,30
1657737140276,MATH 18,B06,093474,Rideout; David Porter,6,0,36,30
1657737146302,MATH 20A,A01,083754,Zheng; Zequn,14,0,40,26
1657737152329,MATH 20B,A01,083756,Briones; Jor-el Thomas Caparas,4,0,36,32
1657737152329,MATH 20B,A02,083757,Briones; Jor-el Thomas Caparas,1,0,36,35
1657737152329,MATH 20B,A03,093475,Briones; Jor-el Thomas Caparas,2,0,36,34
1657737158351,MATH 20C,A01,083760,Briones; Jor-el Thomas Caparas,1,0,35,34
1657737158351,MATH 20C,A02,083761,Briones; Jor-el Thomas Caparas,8,0,35,27
1657737158351,MATH 20C,A03,093476,Briones; Jor-el Thomas Caparas,0,1,36,36
1657737158351,MATH 20C,B01,083762,Bach; Quang Tran,1,0,30,29
1657737164379,MATH 20D,A01,083765,Tran; Brian Kha,5,0,30,25
1657737164379,MATH 20D,A02,083766,Tran; Brian Kha,5,0,30,25
1657737164379,MATH 20D,A03,083767,Tran; Brian Kha,5,0,30,25
1657737170407,MATH 20E,A01,083771,Ganguly; Soumya,9,0,32,23
1657737170407,MATH 20E,A02,083772,Ganguly; Soumya,6,0,32,26
1657737170407,MATH 20E,B01,083773,Ciotti; Benjamin,20,0,35,15
1657737170407,MATH 20E,B02,083774,Ciotti; Benjamin,18,0,35,17
1657737176437,MATH 103A,A01,083777,Greenfeld; Be'Eri,3,0,36,33
1657737176437,MATH 103A,A02,083778,Greenfeld; Be'Eri,5,0,36,31
1657737176437,MATH 103A,A03,093561,Greenfeld; Be'Eri,6,0,36,30
1657737176437,MATH 103A,B01,083779,Greenfeld; Be'Eri,7,0,36,29
1657737176437,MATH 103A,B02,083780,Greenfeld; Be'Eri,4,0,36,32
1657737176437,MATH 103A,B03,093562,Greenfeld; Be'Eri,3,0,36,33
1657737182461,MATH 105,A01,085443,Carter; Anne Toulson,15,0,35,20
1657737182461,MATH 105,A02,093477,Carter; Anne Toulson,20,0,35,15
1657737188485,MATH 109,A01,083213,Ganzberger; Geoffrey Michael,2,0,34,32
1657737188485,MATH 109,A02,083214,Ganzberger; Geoffrey Michael,4,0,34,30
1657737188485,MATH 109,A03,093478,Ganzberger; Geoffrey Michael,2,0,34,32
1657737188485,MATH 109,B01,083215,Ganzberger; Geoffrey Michael,1,0,32,31
1657737188485,MATH 109,B02,083216,Ganzberger; Geoffrey Michael,2,0,32,30
1657737188485,MATH 109,B03,093479,Ganzberger; Geoffrey Michael,8,0,32,24
1657737194514,MATH 142A,A01,083219,Chow; Bennett,7,0,32,25
1657737194514,MATH 142A,A02,083220,Chow; Bennett,10,0,32,22
1657737194514,MATH 142A,A03,093480,Chow; Bennett,9,0,32,23
1657737194514,MATH 142A,B03,093481,Chow; Bennett,8,0,32,24
1657737194514,MATH 142A,B04,093558,Chow; Bennett,13,0,32,19
1657737194514,MATH 142A,B05,093559,Chow; Bennett,6,0,32,26
1657737200536,MATH 193A,A01,083224,Rotar; Vladimir,8,0,34,26
1657737200536,MATH 193A,A02,083225,Rotar; Vladimir,9,0,34,25
1657737200536,MATH 193A,A03,083781,Rotar; Vladimir,5,0,34,29
1657737200536,MATH 193A,A04,083782,Rotar; Vladimir,10,0,34,24
1657737200536,MATH 193A,A05,093482,Rotar; Vladimir,10,0,34,24
1657737206558,MATH 197,001,091859,McAuley; Julian John,9999,0,9999,0
1657737206558,MATH 197,002,095566,Kedlaya; Kiran S.,9997,0,9999,2
1657737206558,MATH 197,003,095567,Xiao; Ming,9999,0,9999,0
1657737206558,MATH 197,004,095571,Perols; Johan Lars,9998,0,9999,1
1657737213612,COGS 9,A01,083615,Shannon; Kyle Michael,9,0,75,66
1657737219640,COGS 11,A01,083617,Boyle; Mary E. T.,23,0,48,25
1657737225670,COGS 13,A01,083071,Bastos; Amalia Pinkusfeld,11,0,71,60
1657737231694,COGS 14A,A01,092681,Semenuks; Arturs,5,1,100,95
1657737237723,COGS 14B,A01,083073,Cheng; Tzu-Han,6,0,63,57
1657737243745,COGS 17,A01,092677,Semenuks; Arturs,6,0,81,75
1657737249770,COGS 100,A01,083619,Allen; Michael Gordon,17,0,70,53
1657737255799,COGS 101A,A01,083621,Davis; Joshua Daniel,9,0,68,59
1657737261827,COGS 101B,A01,091572,Allen; Michael Gordon,12,0,65,53
1657737267854,COGS 101C,A01,083625,Delgado; Tania,17,0,35,18
1657737273877,COGS 107A,A01,083627,Boyle; Mary E. T.,13,0,60,47
1657737279901,COGS 118A,A01,083075,Gupta; Anjum,21,0,76,55
1657737285930,CSE 3,A50,083646,Miranda; Gregory Joseph,24,0,50,26
1657737291956,CSE 8A,A50,083650,Miranda; Gregory Joseph,17,1,56,39
1657737297983,CSE 11,A01,083080,Cao; Yingjun,6,15,40,34
1657737304015,CSE 12,A01,083652,Krause-Levy; Sophia Louisa,28,1,120,92
1657737310037,CSE 15L,A01,083654,Morris; Justin Loren,9,0,50,41
1657737310037,CSE 15L,A02,083655,Morris; Justin Loren,9,0,50,41
1657737316060,CSE 20,A01,083657,Tran; Khoa Dang,39,0,80,41
1657737322082,CSE 21,A01,095574,Bach; Quang Tran,22,0,48,26
1657737328108,CSE 30,A01,083084,Eldon; John,6,0,80,74
1657737328108,CSE 30,B01,095061,Bhaskar; Nishant,9,0,50,41
1657737334130,CSE 100,A01,083659,Cao; Yingjun,5,4,70,65
1657737340153,CSE 134B,A01,083661,Powell; Thomas Allan,23,0,100,77
1657737346175,CSE 140,A01,083663,Gungor; Onat,15,0,85,70
1657737352198,CSE 140L,A01,083088,Eldon; John,23,0,100,77
1657737358221,CSE 175,A01,083665,Kumar; Rakesh,3,0,25,22
1657737364253,CSE 190,A00,092507,Dubnov; Shlomo,8,0,20,12
1657737370282,ECE 45,A01,083139,Congero; Spencer William,6,0,75,69
1657737376310,ECE 65,A50,083695,Saad; Andrew S,12,0,30,18
1657737376310,ECE 65,A51,095125,Saad; Andrew S,24,0,26,2
1657737382336,ECE 109,A01,091882,Touri; Behrouz,20,0,70,50
1657737388360,ECE 180,A00,083140,Abi Samra; Nicholas Camill,1,0,30,29
1657737388360,ECE 180,B00,083141,Abi Samra; Nicholas Camill,0,0,30,30
1657737394387,MATH 10A,A01,083735,Patchell; Gregory David,2,0,30,28
1657737394387,MATH 10A,A02,083736,Patchell; Gregory David,20,0,30,10
1657737394387,MATH 10A,A03,083737,Patchell; Gregory David,16,0,30,14
1657737400412,MATH 10B,A01,083207,Lim; Seonhee,8,0,34,26
1657737400412,MATH 10B,A02,083208,Lim; Seonhee,9,0,35,26
1657737400412,MATH 10B,A03,093472,Lim; Seonhee,7,0,34,27
1657737400412,MATH 10B,B01,083739,Sinha; Shubham,13,0,30,17
1657737406437,MATH 18,A01,083743,Cinel; Cameron Alexander,9,0,30,21
1657737406437,MATH 18,A02,083744,Cinel; Cameron Alexander,17,0,30,13
1657737406437,MATH 18,A03,083745,Cinel; Cameron Alexander,10,0,30,20
1657737406437,MATH 18,B01,083748,Rideout; David Porter,5,0,37,32
1657737406437,MATH 18,B02,083749,Rideout; David Porter,5,0,36,31
1657737406437,MATH 18,B03,083750,Rideout; David Porter,3,0,37,34
1657737406437,MATH 18,B04,083751,Rideout; David Porter,6,0,36,30
1657737406437,MATH 18,B05,093473,Rideout; David Porter,6,0,36,30
1657737406437,MATH 18,B06,093474,Rideout; David Porter,6,0,36,30
1657737412458,MATH 20A,A01,083754,Zheng; Zequn,14,0,40,26
1657737418482,MATH 20B,A01,083756,Briones; Jor-el Thomas Caparas,4,0,36,32
1657737418482,MATH 20B,A02,083757,Briones; Jor-el Thomas Caparas,1,0,36,35
1657737418482,MATH 20B,A03,093475,Briones; Jor-el Thomas Caparas,2,0,36,34
1657737424504,MATH 20C,A01,083760,Briones; Jor-el Thomas Caparas,1,0,35,34
1657737424504,MATH 20C,A02,083761,Briones; Jor-el Thomas Caparas,8,0,35,27
1657737424504,MATH 20C,A03,093476,Briones; Jor-el Thomas Caparas,0,1,36,36
1657737424504,MATH 20C,B01,083762,Bach; Quang Tran,1,0,30,29
1657737430531,MATH 20D,A01,083765,Tran; Brian Kha,5,0,30,25
1657737430531,MATH 20D,A02,083766,Tran; Brian Kha,5,0,30,25
1657737430531,MATH 20D,A03,083767,Tran; Brian Kha,5,0,30,25
1657737436557,MATH 20E,A01,083771,Ganguly; Soumya,9,0,32,23
1657737436557,MATH 20E,A02,083772,Ganguly; Soumya,6,0,32,26
1657737436557,MATH 20E,B01,083773,Ciotti; Benjamin,20,0,35,15
1657737436557,MATH 20E,B02,083774,Ciotti; Benjamin,18,0,35,17
1657737442585,MATH 103A,A01,083777,Greenfeld; Be'Eri,3,0,36,33
1657737442585,MATH 103A,A02,083778,Greenfeld; Be'Eri,5,0,36,31
1657737442585,MATH 103A,A03,093561,Greenfeld; Be'Eri,6,0,36,30
1657737442585,MATH 103A,B01,083779,Greenfeld; Be'Eri,7,0,36,29
1657737442585,MATH 103A,B02,083780,Greenfeld; Be'Eri,4,0,36,32
1657737442585,MATH 103A,B03,093562,Greenfeld; Be'Eri,3,0,36,33
1657737448614,MATH 105,A01,085443,Carter; Anne Toulson,15,0,35,20
1657737448614,MATH 105,A02,093477,Carter; Anne Toulson,20,0,35,15
1657737454642,MATH 109,A01,083213,Ganzberger; Geoffrey Michael,2,0,34,32
1657737454642,MATH 109,A02,083214,Ganzberger; Geoffrey Michael,4,0,34,30
1657737454642,MATH 109,A03,093478,Ganzberger; Geoffrey Michael,2,0,34,32
1657737454642,MATH 109,B01,083215,Ganzberger; Geoffrey Michael,1,0,32,31
1657737454642,MATH 109,B02,083216,Ganzberger; Geoffrey Michael,2,0,32,30
1657737454642,MATH 109,B03,093479,Ganzberger; Geoffrey Michael,8,0,32,24
1657737460666,MATH 142A,A01,083219,Chow; Bennett,7,0,32,25
1657737460666,MATH 142A,A02,083220,Chow; Bennett,10,0,32,22
1657737460666,MATH 142A,A03,093480,Chow; Bennett,9,0,32,23
1657737460666,MATH 142A,B03,093481,Chow; Bennett,8,0,32,24
1657737460666,MATH 142A,B04,093558,Chow; Bennett,13,0,32,19
1657737460666,MATH 142A,B05,093559,Chow; Bennett,6,0,32,26
1657737466692,MATH 193A,A01,083224,Rotar; Vladimir,8,0,34,26
1657737466692,MATH 193A,A02,083225,Rotar; Vladimir,9,0,34,25
1657737466692,MATH 193A,A03,083781,Rotar; Vladimir,5,0,34,29
1657737466692,MATH 193A,A04,083782,Rotar; Vladimir,10,0,34,24
1657737466692,MATH 193A,A05,093482,Rotar; Vladimir,10,0,34,24
1657737472718,MATH 197,001,091859,McAuley; Julian John,9999,0,9999,0
1657737472718,MATH 197,002,095566,Kedlaya; Kiran S.,9997,0,9999,2
1657737472718,MATH 197,003,095567,Xiao; Ming,9999,0,9999,0
1657737472718,MATH 197,004,095571,Perols; Johan Lars,9998,0,9999,1
1657737479779,COGS 9,A01,083615,Shannon; Kyle Michael,9,0,75,66
1657737485806,COGS 11,A01,083617,Boyle; Mary E. T.,23,0,48,25
1657737491836,COGS 13,A01,083071,Bastos; Amalia Pinkusfeld,11,0,71,60
1657737497864,COGS 14A,A01,092681,Semenuks; Arturs,5,1,100,95
1657737503887,COGS 14B,A01,083073,Cheng; Tzu-Han,6,0,63,57
1657737509909,COGS 17,A01,092677,Semenuks; Arturs,6,0,81,75
1657737515936,COGS 100,A01,083619,Allen; Michael Gordon,17,0,70,53
1657737521960,COGS 101A,A01,083621,Davis; Joshua Daniel,9,0,68,59
1657737527982,COGS 101B,A01,091572,Allen; Michael Gordon,12,0,65,53
1657737534006,COGS 101C,A01,083625,Delgado; Tania,17,0,35,18
1657737540030,COGS 107A,A01,083627,Boyle; Mary E. T.,13,0,60,47
1657737546053,COGS 118A,A01,083075,Gupta; Anjum,21,0,76,55
1657737552077,CSE 3,A50,083646,Miranda; Gregory Joseph,24,0,50,26
1657737558104,CSE 8A,A50,083650,Miranda; Gregory Joseph,17,1,56,39
1657737564127,CSE 11,A01,083080,Cao; Yingjun,6,15,40,34
1657737570162,CSE 12,A01,083652,Krause-Levy; Sophia Louisa,28,1,120,92
1657737576184,CSE 15L,A01,083654,Morris; Justin Loren,9,0,50,41
1657737576184,CSE 15L,A02,083655,Morris; Justin Loren,9,0,50,41
1657737582218,CSE 20,A01,083657,Tran; Khoa Dang,39,0,80,41
1657737588240,CSE 21,A01,095574,Bach; Quang Tran,22,0,48,26
1657737594263,CSE 30,A01,083084,Eldon; John,6,0,80,74
1657737594263,CSE 30,B01,095061,Bhaskar; Nishant,9,0,50,41
1657737600306,CSE 100,A01,083659,Cao; Yingjun,5,4,70,65
1657737606333,CSE 134B,A01,083661,Powell; Thomas Allan,23,0,100,77
1657737612360,CSE 140,A01,083663,Gungor; Onat,15,0,85,70
1657737618395,CSE 140L,A01,083088,Eldon; John,23,0,100,77
1657737624419,CSE 175,A01,083665,Kumar; Rakesh,3,0,25,22
1657737630441,CSE 190,A00,092507,Dubnov; Shlomo,8,0,20,12
1657737636468,ECE 45,A01,083139,Congero; Spencer William,6,0,75,69
1657737642498,ECE 65,A50,083695,Saad; Andrew S,12,0,30,18
1657737642498,ECE 65,A51,095125,Saad; Andrew S,24,0,26,2
1657737648527,ECE 109,A01,091882,Touri; Behrouz,20,0,70,50
1657737654550,ECE 180,A00,083140,Abi Samra; Nicholas Camill,1,0,30,29
1657737654550,ECE 180,B00,083141,Abi Samra; Nicholas Camill,0,0,30,30
1657737660582,MATH 10A,A01,083735,Patchell; Gregory David,2,0,30,28
1657737660582,MATH 10A,A02,083736,Patchell; Gregory David,20,0,30,10
1657737660582,MATH 10A,A03,083737,Patchell; Gregory David,16,0,30,14
1657737666615,MATH 10B,A01,083207,Lim; Seonhee,8,0,34,26
1657737666615,MATH 10B,A02,083208,Lim; Seonhee,9,0,35,26
1657737666615,MATH 10B,A03,093472,Lim; Seonhee,7,0,34,27
1657737666615,MATH 10B,B01,083739,Sinha; Shubham,13,0,30,17
1657737672641,MATH 18,A01,083743,Cinel; Cameron Alexander,9,0,30,21
1657737672641,MATH 18,A02,083744,Cinel; Cameron Alexander,17,0,30,13
1657737672641,MATH 18,A03,083745,Cinel; Cameron Alexander,10,0,30,20
1657737672641,MATH 18,B01,083748,Rideout; David Porter,5,0,37,32
1657737672641,MATH 18,B02,083749,Rideout; David Porter,5,0,36,31
1657737672641,MATH 18,B03,083750,Rideout; David Porter,3,0,37,34
1657737672641,MATH 18,B04,083751,Rideout; David Porter,6,0,36,30
1657737672641,MATH 18,B05,093473,Rideout; David Porter,6,0,36,30
1657737672641,MATH 18,B06,093474,Rideout; David Porter,6,0,36,30
1657737678671,MATH 20A,A01,083754,Zheng; Zequn,14,0,40,26
1657737684698,MATH 20B,A01,083756,Briones; Jor-el Thomas Caparas,4,0,36,32
1657737684698,MATH 20B,A02,083757,Briones; Jor-el Thomas Caparas,1,0,36,35
1657737684698,MATH 20B,A03,093475,Briones; Jor-el Thomas Caparas,2,0,36,34
1657737690726,MATH 20C,A01,083760,Briones; Jor-el Thomas Caparas,1,0,35,34
1657737690726,MATH 20C,A02,083761,Briones; Jor-el Thomas Caparas,8,0,35,27
1657737690726,MATH 20C,A03,093476,Briones; Jor-el Thomas Caparas,0,1,36,36
1657737690726,MATH 20C,B01,083762,Bach; Quang Tran,1,0,30,29
1657737696749,MATH 20D,A01,083765,Tran; Brian Kha,5,0,30,25
1657737696749,MATH 20D,A02,083766,Tran; Brian Kha,5,0,30,25
1657737696749,MATH 20D,A03,083767,Tran; Brian Kha,5,0,30,25
1657737702774,MATH 20E,A01,083771,Ganguly; Soumya,9,0,32,23
1657737702774,MATH 20E,A02,083772,Ganguly; Soumya,6,0,32,26
1657737702774,MATH 20E,B01,083773,Ciotti; Benjamin,20,0,35,15
1657737702774,MATH 20E,B02,083774,Ciotti; Benjamin,18,0,35,17
1657737708818,MATH 103A,A01,083777,Greenfeld; Be'Eri,3,0,36,33
1657737708818,MATH 103A,A02,083778,Greenfeld; Be'Eri,5,0,36,31
1657737708818,MATH 103A,A03,093561,Greenfeld; Be'Eri,6,0,36,30
1657737708818,MATH 103A,B01,083779,Greenfeld; Be'Eri,7,0,36,29
1657737708818,MATH 103A,B02,083780,Greenfeld; Be'Eri,4,0,36,32
1657737708818,MATH 103A,B03,093562,Greenfeld; Be'Eri,3,0,36,33
1657737714842,MATH 105,A01,085443,Carter; Anne Toulson,15,0,35,20
1657737714842,MATH 105,A02,093477,Carter; Anne Toulson,20,0,35,15
1657737720867,MATH 109,A01,083213,Ganzberger; Geoffrey Michael,2,0,34,32
1657737720867,MATH 109,A02,083214,Ganzberger; Geoffrey Michael,4,0,34,30
1657737720867,MATH 109,A03,093478,Ganzberger; Geoffrey Michael,2,0,34,32
1657737720867,MATH 109,B01,083215,Ganzberger; Geoffrey Michael,1,0,32,31
1657737720867,MATH 109,B02,083216,Ganzberger; Geoffrey Michael,2,0,32,30
1657737720867,MATH 109,B03,093479,Ganzberger; Geoffrey Michael,8,0,32,24
1657737726983,MATH 142A,A01,083219,Chow; Bennett,7,0,32,25
1657737726983,MATH 142A,A02,083220,Chow; Bennett,10,0,32,22
1657737726983,MATH 142A,A03,093480,Chow; Bennett,9,0,32,23
1657737726983,MATH 142A,B03,093481,Chow; Bennett,8,0,32,24
1657737726983,MATH 142A,B04,093558,Chow; Bennett,13,0,32,19
1657737726983,MATH 142A,B05,093559,Chow; Bennett,6,0,32,26
1657737733017,MATH 193A,A01,083224,Rotar; Vladimir,8,0,34,26
1657737733017,MATH 193A,A02,083225,Rotar; Vladimir,9,0,34,25
1657737733017,MATH 193A,A03,083781,Rotar; Vladimir,5,0,34,29
1657737733017,MATH 193A,A04,083782,Rotar; Vladimir,10,0,34,24
1657737733017,MATH 193A,A05,093482,Rotar; Vladimir,10,0,34,24
1657737739045,MATH 197,001,091859,McAuley; Julian John,9999,0,9999,0
1657737739045,MATH 197,002,095566,Kedlaya; Kiran S.,9997,0,9999,2
1657737739045,MATH 197,003,095567,Xiao; Ming,9999,0,9999,0
1657737739045,MATH 197,004,095571,Perols; Johan Lars,9998,0,9999,1
1657737746113,COGS 9,A01,083615,Shannon; Kyle Michael,9,0,75,66
1657737752145,COGS 11,A01,083617,Boyle; Mary E. T.,23,0,48,25
1657737758176,COGS 13,A01,083071,Bastos; Amalia Pinkusfeld,11,0,71,60
1657737764202,COGS 14A,A01,092681,Semenuks; Arturs,5,1,100,95
1657737770224,COGS 14B,A01,083073,Cheng; Tzu-Han,6,0,63,57
1657737776259,COGS 17,A01,092677,Semenuks; Arturs,6,0,81,75
1657737782287,COGS 100,A01,083619,Allen; Michael Gordon,17,0,70,53
1657737788311,COGS 101A,A01,083621,Davis; Joshua Daniel,9,0,68,59
1657737794332,COGS 101B,A01,091572,Allen; Michael Gordon,12,0,65,53
1657737800366,COGS 101C,A01,083625,Delgado; Tania,17,0,35,18
1657737806395,COGS 107A,A01,083627,Boyle; Mary E. T.,13,0,60,47
1657737812420,COGS 118A,A01,083075,Gupta; Anjum,21,0,76,55
1657737818448,CSE 3,A50,083646,Miranda; Gregory Joseph,24,0,50,26
1657737824477,CSE 8A,A50,083650,Miranda; Gregory Joseph,17,1,56,39
1657737830512,CSE 11,A01,083080,Cao; Yingjun,6,15,40,34
1657737836534,CSE 12,A01,083652,Krause-Levy; Sophia Louisa,28,1,120,92
1657737842556,CSE 15L,A01,083654,Morris; Justin Loren,9,0,50,41
1657737842556,CSE 15L,A02,083655,Morris; Justin Loren,9,0,50,41
1657737848582,CSE 20,A01,083657,Tran; Khoa Dang,39,0,80,41
1657737854608,CSE 21,A01,095574,Bach; Quang Tran,22,0,48,26
1657737860634,CSE 30,A01,083084,Eldon; John,6,0,80,74
1657737860634,CSE 30,B01,095061,Bhaskar; Nishant,9,0,50,41
1657737866657,CSE 100,A01,083659,Cao; Yingjun,5,4,70,65
1657737872684,CSE 134B,A01,083661,Powell; Thomas Allan,23,0,100,77
1657737878707,CSE 140,A01,083663,Gungor; Onat,15,0,85,70
1657737884733,CSE 140L,A01,083088,Eldon; John,23,0,100,77
1657737890758,CSE 175,A01,083665,Kumar; Rakesh,3,0,25,22
1657737896781,CSE 190,A00,092507,Dubnov; Shlomo,8,0,20,12
1657737902805,ECE 45,A01,083139,Congero; Spencer William,6,0,75,69
1657737908827,ECE 65,A50,083695,Saad; Andrew S,12,0,30,18
1657737908827,ECE 65,A51,095125,Saad; Andrew S,24,0,26,2
1657737914850,ECE 109,A01,091882,Touri; Behrouz,20,0,70,50
1657737920875,ECE 180,A00,083140,Abi Samra; Nicholas Camill,1,0,30,29
1657737920875,ECE 180,B00,083141,Abi Samra; Nicholas Camill,0,0,30,30
1657737926898,MATH 10A,A01,083735,Patchell; Gregory David,2,0,30,28
1657737926898,MATH 10A,A02,083736,Patchell; Gregory David,20,0,30,10
1657737926898,MATH 10A,A03,083737,Patchell; Gregory David,16,0,30,14
1657737932922,MATH 10B,A01,083207,Lim; Seonhee,8,0,34,26
1657737932922,MATH 10B,A02,083208,Lim; Seonhee,9,0,35,26
1657737932922,MATH 10B,A03,093472,Lim; Seonhee,7,0,34,27
1657737932922,MATH 10B,B01,083739,Sinha; Shubham,13,0,30,17
1657737938947,MATH 18,A01,083743,Cinel; Cameron Alexander,9,0,30,21
1657737938947,MATH 18,A02,083744,Cinel; Cameron Alexander,17,0,30,13
1657737938947,MATH 18,A03,083745,Cinel; Cameron Alexander,10,0,30,20
1657737938947,MATH 18,B01,083748,Rideout; David Porter,5,0,37,32
1657737938947,MATH 18,B02,083749,Rideout; David Porter,5,0,36,31
1657737938947,MATH 18,B03,083750,Rideout; David Porter,3,0,37,34
1657737938947,MATH 18,B04,083751,Rideout; David Porter,6,0,36,30
1657737938947,MATH 18,B05,093473,Rideout; David Porter,6,0,36,30
1657737938947,MATH 18,B06,093474,Rideout; David Porter,6,0,36,30
1657737944975,MATH 20A,A01,083754,Zheng; Zequn,14,0,40,26
1657737951001,MATH 20B,A01,083756,Briones; Jor-el Thomas Caparas,4,0,36,32
1657737951001,MATH 20B,A02,083757,Briones; Jor-el Thomas Caparas,1,0,36,35
1657737951001,MATH 20B,A03,093475,Briones; Jor-el Thomas Caparas,2,0,36,34
1657737957025,MATH 20C,A01,083760,Briones; Jor-el Thomas Caparas,1,0,35,34
1657737957025,MATH 20C,A02,083761,Briones; Jor-el Thomas Caparas,8,0,35,27
1657737957025,MATH 20C,A03,093476,Briones; Jor-el Thomas Caparas,0,1,36,36
1657737957025,MATH 20C,B01,083762,Bach; Quang Tran,1,0,30,29
1657737963052,MATH 20D,A01,083765,Tran; Brian Kha,5,0,30,25
1657737963052,MATH 20D,A02,083766,Tran; Brian Kha,5,0,30,25
1657737963052,MATH 20D,A03,083767,Tran; Brian Kha,5,0,30,25
1657737969085,MATH 20E,A01,083771,Ganguly; Soumya,9,0,32,23
1657737969085,MATH 20E,A02,083772,Ganguly; Soumya,6,0,32,26
1657737969085,MATH 20E,B01,083773,Ciotti; Benjamin,20,0,35,15
1657737969085,MATH 20E,B02,083774,Ciotti; Benjamin,18,0,35,17
1657737975109,MATH 103A,A01,083777,Greenfeld; Be'Eri,3,0,36,33
1657737975109,MATH 103A,A02,083778,Greenfeld; Be'Eri,5,0,36,31
1657737975109,MATH 103A,A03,093561,Greenfeld; Be'Eri,6,0,36,30
1657737975109,MATH 103A,B01,083779,Greenfeld; Be'Eri,7,0,36,29
1657737975109,MATH 103A,B02,083780,Greenfeld; Be'Eri,4,0,36,32
1657737975109,MATH 103A,B03,093562,Greenfeld; Be'Eri,3,0,36,33
1657737981131,MATH 105,A01,085443,Carter; Anne Toulson,15,0,35,20
1657737981131,MATH 105,A02,093477,Carter; Anne Toulson,20,0,35,15
1657737987155,MATH 109,A01,083213,Ganzberger; Geoffrey Michael,2,0,34,32
1657737987155,MATH 109,A02,083214,Ganzberger; Geoffrey Michael,4,0,34,30
1657737987155,MATH 109,A03,093478,Ganzberger; Geoffrey Michael,2,0,34,32
1657737987155,MATH 109,B01,083215,Ganzberger; Geoffrey Michael,1,0,32,31
1657737987155,MATH 109,B02,083216,Ganzberger; Geoffrey Michael,2,0,32,30
1657737987155,MATH 109,B03,093479,Ganzberger; Geoffrey Michael,8,0,32,24
1657737993182,MATH 142A,A01,083219,Chow; Bennett,7,0,32,25
1657737993182,MATH 142A,A02,083220,Chow; Bennett,10,0,32,22
1657737993182,MATH 142A,A03,093480,Chow; Bennett,9,0,32,23
1657737993182,MATH 142A,B03,093481,Chow; Bennett,8,0,32,24
1657737993182,MATH 142A,B04,093558,Chow; Bennett,13,0,32,19
1657737993182,MATH 142A,B05,093559,Chow; Bennett,6,0,32,26
1657737999212,MATH 193A,A01,083224,Rotar; Vladimir,8,0,34,26
1657737999212,MATH 193A,A02,083225,Rotar; Vladimir,9,0,34,25
1657737999212,MATH 193A,A03,083781,Rotar; Vladimir,5,0,34,29
1657737999212,MATH 193A,A04,083782,Rotar; Vladimir,10,0,34,24
1657737999212,MATH 193A,A05,093482,Rotar; Vladimir,10,0,34,24
1657738005241,MATH 197,001,091859,McAuley; Julian John,9999,0,9999,0
1657738005241,MATH 197,002,095566,Kedlaya; Kiran S.,9997,0,9999,2
1657738005241,MATH 197,003,095567,Xiao; Ming,9999,0,9999,0
1657738005241,MATH 197,004,095571,Perols; Johan Lars,9998,0,9999,1
1657738012293,COGS 9,A01,083615,Shannon; Kyle Michael,9,0,75,66
1657738018317,COGS 11,A01,083617,Boyle; Mary E. T.,23,0,48,25
1657738024350,COGS 13,A01,083071,Bastos; Amalia Pinkusfeld,11,0,71,60
1657738030376,COGS 14A,A01,092681,Semenuks; Arturs,5,1,100,95
1657738036406,COGS 14B,A01,083073,Cheng; Tzu-Han,6,0,63,57
1657738042437,COGS 17,A01,092677,Semenuks; Arturs,6,0,81,75
1657738048469,COGS 100,A01,083619,Allen; Michael Gordon,17,0,70,53
1657738054494,COGS 101A,A01,083621,Davis; Joshua Daniel,9,0,68,59
1657738060517,COGS 101B,A01,091572,Allen; Michael Gordon,12,0,65,53
1657738066540,COGS 101C,A01,083625,Delgado; Tania,17,0,35,18
1657738072565,COGS 107A,A01,083627,Boyle; Mary E. T.,13,0,60,47
1657738078589,COGS 118A,A01,083075,Gupta; Anjum,21,0,76,55
1657738084616,CSE 3,A50,083646,Miranda; Gregory Joseph,24,0,50,26
1657738090650,CSE 8A,A50,083650,Miranda; Gregory Joseph,17,1,56,39
1657738096673,CSE 11,A01,083080,Cao; Yingjun,6,15,40,34
1657738102698,CSE 12,A01,083652,Krause-Levy; Sophia Louisa,28,1,120,92
1657738108721,CSE 15L,A01,083654,Morris; Justin Loren,9,0,50,41
1657738108721,CSE 15L,A02,083655,Morris; Justin Loren,9,0,50,41
1657738114747,CSE 20,A01,083657,Tran; Khoa Dang,39,0,80,41
1657738120787,CSE 21,A01,095574,Bach; Quang Tran,22,0,48,26
1657738126814,CSE 30,A01,083084,Eldon; John,6,0,80,74
1657738126814,CSE 30,B01,095061,Bhaskar; Nishant,9,0,50,41
1657738132848,CSE 100,A01,083659,Cao; Yingjun,5,4,70,65
1657738138872,CSE 134B,A01,083661,Powell; Thomas Allan,23,0,100,77
1657738144898,CSE 140,A01,083663,Gungor; Onat,15,0,85,70
1657738150921,CSE 140L,A01,083088,Eldon; John,23,0,100,77
1657738156943,CSE 175,A01,083665,Kumar; Rakesh,3,0,25,22
1657738162975,CSE 190,A00,092507,Dubnov; Shlomo,8,0,20,12
1657738169009,ECE 45,A01,083139,Congero; Spencer William,6,0,75,69
1657738175037,ECE 65,A50,083695,Saad; Andrew S,12,0,30,18
1657738175037,ECE 65,A51,095125,Saad; Andrew S,24,0,26,2
1657738181058,ECE 109,A01,091882,Touri; Behrouz,20,0,70,50
1657738187082,ECE 180,A00,083140,Abi Samra; Nicholas Camill,1,0,30,29
1657738187082,ECE 180,B00,083141,Abi Samra; Nicholas Camill,0,0,30,30
1657738193110,MATH 10A,A01,083735,Patchell; Gregory David,2,0,30,28
1657738193110,MATH 10A,A02,083736,Patchell; Gregory David,20,0,30,10
1657738193110,MATH 10A,A03,083737,Patchell; Gregory David,16,0,30,14
1657738199135,MATH 10B,A01,083207,Lim; Seonhee,8,0,34,26
1657738199135,MATH 10B,A02,083208,Lim; Seonhee,9,0,35,26
1657738199135,MATH 10B,A03,093472,Lim; Seonhee,7,0,34,27
1657738199135,MATH 10B,B01,083739,Sinha; Shubham,13,0,30,17
1657738205165,MATH 18,A01,083743,Cinel; Cameron Alexander,9,0,30,21
1657738205165,MATH 18,A02,083744,Cinel; Cameron Alexander,17,0,30,13
1657738205165,MATH 18,A03,083745,Cinel; Cameron Alexander,10,0,30,20
1657738205165,MATH 18,B01,083748,Rideout; David Porter,5,0,37,32
1657738205165,MATH 18,B02,083749,Rideout; David Porter,5,0,36,31
1657738205165,MATH 18,B03,083750,Rideout; David Porter,3,0,37,34
1657738205165,MATH 18,B04,083751,Rideout; David Porter,6,0,36,30
1657738205165,MATH 18,B05,093473,Rideout; David Porter,6,0,36,30
1657738205165,MATH 18,B06,093474,Rideout; David Porter,6,0,36,30
1657738211188,MATH 20A,A01,083754,Zheng; Zequn,14,0,40,26
1657738217214,MATH 20B,A01,083756,Briones; Jor-el Thomas Caparas,4,0,36,32
1657738217214,MATH 20B,A02,083757,Briones; Jor-el Thomas Caparas,1,0,36,35
1657738217214,MATH 20B,A03,093475,Briones; Jor-el Thomas Caparas,2,0,36,34
1657738223241,MATH 20C,A01,083760,Briones; Jor-el Thomas Caparas,1,0,35,34
1657738223241,MATH 20C,A02,083761,Briones; Jor-el Thomas Caparas,8,0,35,27
1657738223241,MATH 20C,A03,093476,Briones; Jor-el Thomas Caparas,0,1,36,36
1657738223241,MATH 20C,B01,083762,Bach; Quang Tran,1,0,30,29
1657738229266,MATH 20D,A01,083765,Tran; Brian Kha,5,0,30,25
1657738229266,MATH 20D,A02,083766,Tran; Brian Kha,5,0,30,25
1657738229266,MATH 20D,A03,083767,Tran; Brian Kha,5,0,30,25
1657738235301,MATH 20E,A01,083771,Ganguly; Soumya,9,0,32,23
1657738235301,MATH 20E,A02,083772,Ganguly; Soumya,6,0,32,26
1657738235301,MATH 20E,B01,083773,Ciotti; Benjamin,20,0,35,15
1657738235301,MATH 20E,B02,083774,Ciotti; Benjamin,18,0,35,17
1657738241327,MATH 103A,A01,083777,Greenfeld; Be'Eri,3,0,36,33
1657738241327,MATH 103A,A02,083778,Greenfeld; Be'Eri,5,0,36,31
1657738241327,MATH 103A,A03,093561,Greenfeld; Be'Eri,6,0,36,30
1657738241327,MATH 103A,B01,083779,Greenfeld; Be'Eri,7,0,36,29
1657738241327,MATH 103A,B02,083780,Greenfeld; Be'Eri,4,0,36,32
1657738241327,MATH 103A,B03,093562,Greenfeld; Be'Eri,3,0,36,33
1657738247353,MATH 105,A01,085443,Carter; Anne Toulson,15,0,35,20
1657738247353,MATH 105,A02,093477,Carter; Anne Toulson,20,0,35,15
1657738253390,MATH 109,A01,083213,Ganzberger; Geoffrey Michael,2,0,34,32
1657738253390,MATH 109,A02,083214,Ganzberger; Geoffrey Michael,4,0,34,30
1657738253390,MATH 109,A03,093478,Ganzberger; Geoffrey Michael,2,0,34,32
1657738253390,MATH 109,B01,083215,Ganzberger; Geoffrey Michael,1,0,32,31
1657738253390,MATH 109,B02,083216,Ganzberger; Geoffrey Michael,2,0,32,30
1657738253390,MATH 109,B03,093479,Ganzberger; Geoffrey Michael,8,0,32,24
1657738259415,MATH 142A,A01,083219,Chow; Bennett,7,0,32,25
1657738259415,MATH 142A,A02,083220,Chow; Bennett,10,0,32,22
1657738259415,MATH 142A,A03,093480,Chow; Bennett,9,0,32,23
1657738259415,MATH 142A,B03,093481,Chow; Bennett,8,0,32,24
1657738259415,MATH 142A,B04,093558,Chow; Bennett,13,0,32,19
1657738259415,MATH 142A,B05,093559,Chow; Bennett,6,0,32,26
1657738265438,MATH 193A,A01,083224,Rotar; Vladimir,8,0,34,26
1657738265438,MATH 193A,A02,083225,Rotar; Vladimir,9,0,34,25
1657738265438,MATH 193A,A03,083781,Rotar; Vladimir,5,0,34,29
1657738265438,MATH 193A,A04,083782,Rotar; Vladimir,10,0,34,24
1657738265438,MATH 193A,A05,093482,Rotar; Vladimir,10,0,34,24
1657738271463,MATH 197,001,091859,McAuley; Julian John,9999,0,9999,0
1657738271463,MATH 197,002,095566,Kedlaya; Kiran S.,9997,0,9999,2
1657738271463,MATH 197,003,095567,Xiao; Ming,9999,0,9999,0
1657738271463,MATH 197,004,095571,Perols; Johan Lars,9998,0,9999,1
1657738278516,COGS 9,A01,083615,Shannon; Kyle Michael,9,0,75,66
1657738284543,COGS 11,A01,083617,Boyle; Mary E. T.,23,0,48,25
1657738290582,COGS 13,A01,083071,Bastos; Amalia Pinkusfeld,11,0,71,60
1657738296612,COGS 14A,A01,092681,Semenuks; Arturs,5,1,100,95
1657738302639,COGS 14B,A01,083073,Cheng; Tzu-Han,6,0,63,57
1657738308667,COGS 17,A01,092677,Semenuks; Arturs,6,0,81,75
1657738314696,COGS 100,A01,083619,Allen; Michael Gordon,17,0,70,53
1657738320797,COGS 101A,A01,083621,Davis; Joshua Daniel,9,0,68,59
1657738326822,COGS 101B,A01,091572,Allen; Michael Gordon,12,0,65,53
1657738332850,COGS 101C,A01,083625,Delgado; Tania,17,0,35,18
1657738338884,COGS 107A,A01,083627,Boyle; Mary E. T.,13,0,60,47
1657738344910,COGS 118A,A01,083075,Gupta; Anjum,21,0,76,55
1657738350937,CSE 3,A50,083646,Miranda; Gregory Joseph,24,0,50,26
1657738356967,CSE 8A,A50,083650,Miranda; Gregory Joseph,17,1,56,39
1657738362994,CSE 11,A01,083080,Cao; Yingjun,6,15,40,34
1657738369022,CSE 12,A01,083652,Krause-Levy; Sophia Louisa,28,1,120,92
1657738375048,CSE 15L,A01,083654,Morris; Justin Loren,9,0,50,41
1657738375048,CSE 15L,A02,083655,Morris; Justin Loren,9,0,50,41
1657738381075,CSE 20,A01,083657,Tran; Khoa Dang,39,0,80,41
1657738387098,CSE 21,A01,095574,Bach; Quang Tran,22,0,48,26
1657738393121,CSE 30,A01,083084,Eldon; John,6,0,80,74
1657738393121,CSE 30,B01,095061,Bhaskar; Nishant,9,0,50,41
1657738399152,CSE 100,A01,083659,Cao; Yingjun,5,4,70,65
1657738405175,CSE 134B,A01,083661,Powell; Thomas Allan,23,0,100,77
1657738411199,CSE 140,A01,083663,Gungor; Onat,15,0,85,70
1657738417224,CSE 140L,A01,083088,Eldon; John,23,0,100,77
1657738423248,CSE 175,A01,083665,Kumar; Rakesh,3,0,25,22
1657738429274,CSE 190,A00,092507,Dubnov; Shlomo,8,0,20,12
1657738435303,ECE 45,A01,083139,Congero; Spencer William,6,0,75,69
1657738441329,ECE 65,A50,083695,Saad; Andrew S,12,0,30,18
1657738441329,ECE 65,A51,095125,Saad; Andrew S,24,0,26,2
1657738447352,ECE 109,A01,091882,Touri; Behrouz,20,0,70,50
1657738453375,ECE 180,A00,083140,Abi Samra; Nicholas Camill,1,0,30,29
1657738453375,ECE 180,B00,083141,Abi Samra; Nicholas Camill,0,0,30,30
1657738459397,MATH 10A,A01,083735,Patchell; Gregory David,2,0,30,28
1657738459397,MATH 10A,A02,083736,Patchell; Gregory David,20,0,30,10
1657738459397,MATH 10A,A03,083737,Patchell; Gregory David,16,0,30,14
1657738465421,MATH 10B,A01,083207,Lim; Seonhee,8,0,34,26
1657738465421,MATH 10B,A02,083208,Lim; Seonhee,9,0,35,26
1657738465421,MATH 10B,A03,093472,Lim; Seonhee,7,0,34,27
1657738465421,MATH 10B,B01,083739,Sinha; Shubham,13,0,30,17
1657738471453,MATH 18,A01,083743,Cinel; Cameron Alexander,9,0,30,21
1657738471453,MATH 18,A02,083744,Cinel; Cameron Alexander,17,0,30,13
1657738471453,MATH 18,A03,083745,Cinel; Cameron Alexander,10,0,30,20
1657738471453,MATH 18,B01,083748,Rideout; David Porter,5,0,37,32
1657738471453,MATH 18,B02,083749,Rideout; David Porter,5,0,36,31
1657738471453,MATH 18,B03,083750,Rideout; David Porter,3,0,37,34
1657738471453,MATH 18,B04,083751,Rideout; David Porter,6,0,36,30
1657738471453,MATH 18,B05,093473,Rideout; David Porter,6,0,36,30
1657738471453,MATH 18,B06,093474,Rideout; David Porter,6,0,36,30
1657738477480,MATH 20A,A01,083754,Zheng; Zequn,14,0,40,26
1657738483515,MATH 20B,A01,083756,Briones; Jor-el Thomas Caparas,4,0,36,32
1657738483515,MATH 20B,A02,083757,Briones; Jor-el Thomas Caparas,1,0,36,35
1657738483515,MATH 20B,A03,093475,Briones; Jor-el Thomas Caparas,2,0,36,34
1657738489544,MATH 20C,A01,083760,Briones; Jor-el Thomas Caparas,1,0,35,34
1657738489544,MATH 20C,A02,083761,Briones; Jor-el Thomas Caparas,8,0,35,27
1657738489544,MATH 20C,A03,093476,Briones; Jor-el Thomas Caparas,0,1,36,36
1657738489544,MATH 20C,B01,083762,Bach; Quang Tran,1,0,30,29
1657738495567,MATH 20D,A01,083765,Tran; Brian Kha,5,0,30,25
1657738495567,MATH 20D,A02,083766,Tran; Brian Kha,5,0,30,25
1657738495567,MATH 20D,A03,083767,Tran; Brian Kha,5,0,30,25
1657738501590,MATH 20E,A01,083771,Ganguly; Soumya,9,0,32,23
1657738501590,MATH 20E,A02,083772,Ganguly; Soumya,6,0,32,26
1657738501590,MATH 20E,B01,083773,Ciotti; Benjamin,20,0,35,15
1657738501590,MATH 20E,B02,083774,Ciotti; Benjamin,18,0,35,17
1657738507620,MATH 103A,A01,083777,Greenfeld; Be'Eri,3,0,36,33
1657738507620,MATH 103A,A02,083778,Greenfeld; Be'Eri,5,0,36,31
1657738507620,MATH 103A,A03,093561,Greenfeld; Be'Eri,6,0,36,30
1657738507620,MATH 103A,B01,083779,Greenfeld; Be'Eri,7,0,36,29
1657738507620,MATH 103A,B02,083780,Greenfeld; Be'Eri,4,0,36,32
1657738507620,MATH 103A,B03,093562,Greenfeld; Be'Eri,3,0,36,33
1657738513643,MATH 105,A01,085443,Carter; Anne Toulson,15,0,35,20
1657738513643,MATH 105,A02,093477,Carter; Anne Toulson,20,0,35,15
1657738519672,MATH 109,A01,083213,Ganzberger; Geoffrey Michael,2,0,34,32
1657738519672,MATH 109,A02,083214,Ganzberger; Geoffrey Michael,4,0,34,30
1657738519672,MATH 109,A03,093478,Ganzberger; Geoffrey Michael,2,0,34,32
1657738519672,MATH 109,B01,083215,Ganzberger; Geoffrey Michael,1,0,32,31
1657738519672,MATH 109,B02,083216,Ganzberger; Geoffrey Michael,2,0,32,30
1657738519672,MATH 109,B03,093479,Ganzberger; Geoffrey Michael,8,0,32,24
1657738525701,MATH 142A,A01,083219,Chow; Bennett,7,0,32,25
1657738525701,MATH 142A,A02,083220,Chow; Bennett,10,0,32,22
1657738525701,MATH 142A,A03,093480,Chow; Bennett,9,0,32,23
1657738525701,MATH 142A,B03,093481,Chow; Bennett,8,0,32,24
1657738525701,MATH 142A,B04,093558,Chow; Bennett,13,0,32,19
1657738525701,MATH 142A,B05,093559,Chow; Bennett,6,0,32,26
1657738531723,MATH 193A,A01,083224,Rotar; Vladimir,8,0,34,26
1657738531723,MATH 193A,A02,083225,Rotar; Vladimir,9,0,34,25
1657738531723,MATH 193A,A03,083781,Rotar; Vladimir,5,0,34,29
1657738531723,MATH 193A,A04,083782,Rotar; Vladimir,10,0,34,24
1657738531723,MATH 193A,A05,093482,Rotar; Vladimir,10,0,34,24
1657738537745,MATH 197,001,091859,McAuley; Julian John,9999,0,9999,0
1657738537745,MATH 197,002,095566,Kedlaya; Kiran S.,9997,0,9999,2
1657738537745,MATH 197,003,095567,Xiao; Ming,9999,0,9999,0
1657738537745,MATH 197,004,095571,Perols; Johan Lars,9998,0,9999,1
1657738544816,COGS 9,A01,083615,Shannon; Kyle Michael,9,0,75,66
1657738550838,COGS 11,A01,083617,Boyle; Mary E. T.,23,0,48,25
1657738556865,COGS 13,A01,083071,Bastos; Amalia Pinkusfeld,11,0,71,60
1657738562888,COGS 14A,A01,092681,Semenuks; Arturs,5,1,100,95
1657738568917,COGS 14B,A01,083073,Cheng; Tzu-Han,6,0,63,57
1657738574946,COGS 17,A01,092677,Semenuks; Arturs,6,0,81,75
1657738580968,COGS 100,A01,083619,Allen; Michael Gordon,17,0,70,53
1657738586990,COGS 101A,A01,083621,Davis; Joshua Daniel,9,0,68,59
1657738593021,COGS 101B,A01,091572,Allen; Michael Gordon,12,0,65,53
1657738599050,COGS 101C,A01,083625,Delgado; Tania,17,0,35,18
1657738605077,COGS 107A,A01,083627,Boyle; Mary E. T.,13,0,60,47
1657738611108,COGS 118A,A01,083075,Gupta; Anjum,21,0,76,55
1657738617135,CSE 3,A50,083646,Miranda; Gregory Joseph,24,0,50,26
1657738623161,CSE 8A,A50,083650,Miranda; Gregory Joseph,17,1,56,39
1657738629191,CSE 11,A01,083080,Cao; Yingjun,6,15,40,34
1657738635214,CSE 12,A01,083652,Krause-Levy; Sophia Louisa,28,1,120,92
1657738641242,CSE 15L,A01,083654,Morris; Justin Loren,9,0,50,41
1657738641242,CSE 15L,A02,083655,Morris; Justin Loren,9,0,50,41
1657738647265,CSE 20,A01,083657,Tran; Khoa Dang,39,0,80,41
1657738653298,CSE 21,A01,095574,Bach; Quang Tran,22,0,48,26
1657738659324,CSE 30,A01,083084,Eldon; John,6,0,80,74
1657738659324,CSE 30,B01,095061,Bhaskar; Nishant,9,0,50,41
1657738665348,CSE 100,A01,083659,Cao; Yingjun,5,4,70,65
1657738671373,CSE 134B,A01,083661,Powell; Thomas Allan,23,0,100,77
1657738677398,CSE 140,A01,083663,Gungor; Onat,15,0,85,70
1657738683420,CSE 140L,A01,083088,Eldon; John,23,0,100,77
1657738689442,CSE 175,A01,083665,Kumar; Rakesh,3,0,25,22
1657738695463,CSE 190,A00,092507,Dubnov; Shlomo,8,0,20,12
1657738701490,ECE 45,A01,083139,Congero; Spencer William,6,0,75,69
1657738707512,ECE 65,A50,083695,Saad; Andrew S,12,0,30,18
1657738707512,ECE 65,A51,095125,Saad; Andrew S,24,0,26,2
1657738713535,ECE 109,A01,091882,Touri; Behrouz,20,0,70,50
1657738719558,ECE 180,A00,083140,Abi Samra; Nicholas Camill,1,0,30,29
1657738719558,ECE 180,B00,083141,Abi Samra; Nicholas Camill,0,0,30,30
1657738725585,MATH 10A,A01,083735,Patchell; Gregory David,2,0,30,28
1657738725585,MATH 10A,A02,083736,Patchell; Gregory David,20,0,30,10
1657738725585,MATH 10A,A03,083737,Patchell; Gregory David,16,0,30,14
1657738731616,MATH 10B,A01,083207,Lim; Seonhee,8,0,34,26
1657738731616,MATH 10B,A02,083208,Lim; Seonhee,9,0,35,26
1657738731616,MATH 10B,A03,093472,Lim; Seonhee,7,0,34,27
1657738731616,MATH 10B,B01,083739,Sinha; Shubham,13,0,30,17
1657738737654,MATH 18,A01,083743,Cinel; Cameron Alexander,9,0,30,21
1657738737654,MATH 18,A02,083744,Cinel; Cameron Alexander,17,0,30,13
1657738737654,MATH 18,A03,083745,Cinel; Cameron Alexander,10,0,30,20
1657738737654,MATH 18,B01,083748,Rideout; David Porter,5,0,37,32
1657738737654,MATH 18,B02,083749,Rideout; David Porter,5,0,36,31
1657738737654,MATH 18,B03,083750,Rideout; David Porter,3,0,37,34
1657738737654,MATH 18,B04,083751,Rideout; David Porter,6,0,36,30
1657738737654,MATH 18,B05,093473,Rideout; David Porter,6,0,36,30
1657738737654,MATH 18,B06,093474,Rideout; David Porter,6,0,36,30
1657738743677,MATH 20A,A01,083754,Zheng; Zequn,14,0,40,26
1657738749701,MATH 20B,A01,083756,Briones; Jor-el Thomas Caparas,4,0,36,32
1657738749701,MATH 20B,A02,083757,Briones; Jor-el Thomas Caparas,1,0,36,35
1657738749701,MATH 20B,A03,093475,Briones; Jor-el Thomas Caparas,2,0,36,34
1657738755725,MATH 20C,A01,083760,Briones; Jor-el Thomas Caparas,1,0,35,34
1657738755725,MATH 20C,A02,083761,Briones; Jor-el Thomas Caparas,8,0,35,27
1657738755725,MATH 20C,A03,093476,Briones; Jor-el Thomas Caparas,0,1,36,36
1657738755725,MATH 20C,B01,083762,Bach; Quang Tran,1,0,30,29
1657738761753,MATH 20D,A01,083765,Tran; Brian Kha,5,0,30,25
1657738761753,MATH 20D,A02,083766,Tran; Brian Kha,5,0,30,25
1657738761753,MATH 20D,A03,083767,Tran; Brian Kha,5,0,30,25
1657738767777,MATH 20E,A01,083771,Ganguly; Soumya,9,0,32,23
1657738767777,MATH 20E,A02,083772,Ganguly; Soumya,6,0,32,26
1657738767777,MATH 20E,B01,083773,Ciotti; Benjamin,20,0,35,15
1657738767777,MATH 20E,B02,083774,Ciotti; Benjamin,18,0,35,17
1657738773802,MATH 103A,A01,083777,Greenfeld; Be'Eri,3,0,36,33
1657738773802,MATH 103A,A02,083778,Greenfeld; Be'Eri,5,0,36,31
1657738773802,MATH 103A,A03,093561,Greenfeld; Be'Eri,6,0,36,30
1657738773802,MATH 103A,B01,083779,Greenfeld; Be'Eri,7,0,36,29
1657738773802,MATH 103A,B02,083780,Greenfeld; Be'Eri,4,0,36,32
1657738773802,MATH 103A,B03,093562,Greenfeld; Be'Eri,3,0,36,33
1657738779832,MATH 105,A01,085443,Carter; Anne Toulson,15,0,35,20
1657738779832,MATH 105,A02,093477,Carter; Anne Toulson,20,0,35,15
1657738785857,MATH 109,A01,083213,Ganzberger; Geoffrey Michael,2,0,34,32
1657738785857,MATH 109,A02,083214,Ganzberger; Geoffrey Michael,4,0,34,30
1657738785857,MATH 109,A03,093478,Ganzberger; Geoffrey Michael,2,0,34,32
1657738785857,MATH 109,B01,083215,Ganzberger; Geoffrey Michael,1,0,32,31
1657738785857,MATH 109,B02,083216,Ganzberger; Geoffrey Michael,2,0,32,30
1657738785857,MATH 109,B03,093479,Ganzberger; Geoffrey Michael,8,0,32,24
1657738791886,MATH 142A,A01,083219,Chow; Bennett,7,0,32,25
1657738791886,MATH 142A,A02,083220,Chow; Bennett,10,0,32,22
1657738791886,MATH 142A,A03,093480,Chow; Bennett,9,0,32,23
1657738791886,MATH 142A,B03,093481,Chow; Bennett,8,0,32,24
1657738791886,MATH 142A,B04,093558,Chow; Bennett,13,0,32,19
1657738791886,MATH 142A,B05,093559,Chow; Bennett,6,0,32,26
1657738797917,MATH 193A,A01,083224,Rotar; Vladimir,8,0,34,26
1657738797917,MATH 193A,A02,083225,Rotar; Vladimir,9,0,34,25
1657738797917,MATH 193A,A03,083781,Rotar; Vladimir,5,0,34,29
1657738797917,MATH 193A,A04,083782,Rotar; Vladimir,10,0,34,24
1657738797917,MATH 193A,A05,093482,Rotar; Vladimir,10,0,34,24
1657738803944,MATH 197,001,091859,McAuley; Julian John,9999,0,9999,0
1657738803944,MATH 197,002,095566,Kedlaya; Kiran S.,9997,0,9999,2
1657738803944,MATH 197,003,095567,Xiao; Ming,9999,0,9999,0
1657738803944,MATH 197,004,095571,Perols; Johan Lars,9998,0,9999,1
1657738810996,COGS 9,A01,083615,Shannon; Kyle Michael,9,0,75,66
1657738817018,COGS 11,A01,083617,Boyle; Mary E. T.,23,0,48,25
1657738823041,COGS 13,A01,083071,Bastos; Amalia Pinkusfeld,11,0,71,60
1657738829076,COGS 14A,A01,092681,Semenuks; Arturs,5,1,100,95
1657738835107,COGS 14B,A01,083073,Cheng; Tzu-Han,6,0,63,57
1657738841133,COGS 17,A01,092677,Semenuks; Arturs,6,0,81,75
1657738847160,COGS 100,A01,083619,Allen; Michael Gordon,17,0,70,53
1657738853186,COGS 101A,A01,083621,Davis; Joshua Daniel,9,0,68,59
1657738859212,COGS 101B,A01,091572,Allen; Michael Gordon,12,0,65,53
1657738865240,COGS 101C,A01,083625,Delgado; Tania,17,0,35,18
1657738871268,COGS 107A,A01,083627,Boyle; Mary E. T.,13,0,60,47
1657738877301,COGS 118A,A01,083075,Gupta; Anjum,21,0,76,55
1657738883323,CSE 3,A50,083646,Miranda; Gregory Joseph,24,0,50,26
1657738889351,CSE 8A,A50,083650,Miranda; Gregory Joseph,17,1,56,39
1657738895378,CSE 11,A01,083080,Cao; Yingjun,6,15,40,34
1657738901409,CSE 12,A01,083652,Krause-Levy; Sophia Louisa,28,1,120,92
1657738907431,CSE 15L,A01,083654,Morris; Justin Loren,9,0,50,41
1657738907431,CSE 15L,A02,083655,Morris; Justin Loren,9,0,50,41
1657738913467,CSE 20,A01,083657,Tran; Khoa Dang,39,0,80,41
1657738919570,CSE 21,A01,095574,Bach; Quang Tran,22,0,48,26
1657738925593,CSE 30,A01,083084,Eldon; John,6,0,80,74
1657738925593,CSE 30,B01,095061,Bhaskar; Nishant,9,0,50,41
1657738931616,CSE 100,A01,083659,Cao; Yingjun,5,4,70,65
1657738937647,CSE 134B,A01,083661,Powell; Thomas Allan,23,0,100,77
1657738943670,CSE 140,A01,083663,Gungor; Onat,15,0,85,70
1657738949697,CSE 140L,A01,083088,Eldon; John,23,0,100,77
1657738955723,CSE 175,A01,083665,Kumar; Rakesh,3,0,25,22
1657738961747,CSE 190,A00,092507,Dubnov; Shlomo,8,0,20,12
1657738967774,ECE 45,A01,083139,Congero; Spencer William,6,0,75,69
1657738973801,ECE 65,A50,083695,Saad; Andrew S,12,0,30,18
1657738973801,ECE 65,A51,095125,Saad; Andrew S,24,0,26,2
1657738979824,ECE 109,A01,091882,Touri; Behrouz,20,0,70,50
1657738985851,ECE 180,A00,083140,Abi Samra; Nicholas Camill,1,0,30,29
1657738985851,ECE 180,B00,083141,Abi Samra; Nicholas Camill,0,0,30,30
1657738991880,MATH 10A,A01,083735,Patchell; Gregory David,2,0,30,28
1657738991880,MATH 10A,A02,083736,Patchell; Gregory David,20,0,30,10
1657738991880,MATH 10A,A03,083737,Patchell; Gregory David,16,0,30,14
1657738997903,MATH 10B,A01,083207,Lim; Seonhee,8,0,34,26
1657738997903,MATH 10B,A02,083208,Lim; Seonhee,9,0,35,26
1657738997903,MATH 10B,A03,093472,Lim; Seonhee,7,0,34,27
1657738997903,MATH 10B,B01,083739,Sinha; Shubham,13,0,30,17
1657739003933,MATH 18,A01,083743,Cinel; Cameron Alexander,9,0,30,21
1657739003933,MATH 18,A02,083744,Cinel; Cameron Alexander,17,0,30,13
1657739003933,MATH 18,A03,083745,Cinel; Cameron Alexander,10,0,30,20
1657739003933,MATH 18,B01,083748,Rideout; David Porter,5,0,37,32
1657739003933,MATH 18,B02,083749,Rideout; David Porter,5,0,36,31
1657739003933,MATH 18,B03,083750,Rideout; David Porter,3,0,37,34
1657739003933,MATH 18,B04,083751,Rideout; David Porter,6,0,36,30
1657739003933,MATH 18,B05,093473,Rideout; David Porter,6,0,36,30
1657739003933,MATH 18,B06,093474,Rideout; David Porter,6,0,36,30
1657739009957,MATH 20A,A01,083754,Zheng; Zequn,14,0,40,26
1657739015979,MATH 20B,A01,083756,Briones; Jor-el Thomas Caparas,4,0,36,32
1657739015979,MATH 20B,A02,083757,Briones; Jor-el Thomas Caparas,1,0,36,35
1657739015979,MATH 20B,A03,093475,Briones; Jor-el Thomas Caparas,2,0,36,34
1657739022004,MATH 20C,A01,083760,Briones; Jor-el Thomas Caparas,1,0,35,34
1657739022004,MATH 20C,A02,083761,Briones; Jor-el Thomas Caparas,8,0,35,27
1657739022004,MATH 20C,A03,093476,Briones; Jor-el Thomas Caparas,0,1,36,36
1657739022004,MATH 20C,B01,083762,Bach; Quang Tran,1,0,30,29
1657739028040,MATH 20D,A01,083765,Tran; Brian Kha,5,0,30,25
1657739028040,MATH 20D,A02,083766,Tran; Brian Kha,5,0,30,25
1657739028040,MATH 20D,A03,083767,Tran; Brian Kha,5,0,30,25
1657739034067,MATH 20E,A01,083771,Ganguly; Soumya,9,0,32,23
1657739034067,MATH 20E,A02,083772,Ganguly; Soumya,6,0,32,26
1657739034067,MATH 20E,B01,083773,Ciotti; Benjamin,20,0,35,15
1657739034067,MATH 20E,B02,083774,Ciotti; Benjamin,18,0,35,17
1657739040092,MATH 103A,A01,083777,Greenfeld; Be'Eri,3,0,36,33
1657739040092,MATH 103A,A02,083778,Greenfeld; Be'Eri,5,0,36,31
1657739040092,MATH 103A,A03,093561,Greenfeld; Be'Eri,6,0,36,30
1657739040092,MATH 103A,B01,083779,Greenfeld; Be'Eri,7,0,36,29
1657739040092,MATH 103A,B02,083780,Greenfeld; Be'Eri,4,0,36,32
1657739040092,MATH 103A,B03,093562,Greenfeld; Be'Eri,3,0,36,33
1657739046116,MATH 105,A01,085443,Carter; Anne Toulson,15,0,35,20
1657739046116,MATH 105,A02,093477,Carter; Anne Toulson,20,0,35,15
1657739052141,MATH 109,A01,083213,Ganzberger; Geoffrey Michael,2,0,34,32
1657739052141,MATH 109,A02,083214,Ganzberger; Geoffrey Michael,4,0,34,30
1657739052141,MATH 109,A03,093478,Ganzberger; Geoffrey Michael,2,0,34,32
1657739052141,MATH 109,B01,083215,Ganzberger; Geoffrey Michael,1,0,32,31
1657739052141,MATH 109,B02,083216,Ganzberger; Geoffrey Michael,2,0,32,30
1657739052141,MATH 109,B03,093479,Ganzberger; Geoffrey Michael,8,0,32,24
1657739058164,MATH 142A,A01,083219,Chow; Bennett,7,0,32,25
1657739058164,MATH 142A,A02,083220,Chow; Bennett,10,0,32,22
1657739058164,MATH 142A,A03,093480,Chow; Bennett,9,0,32,23
1657739058164,MATH 142A,B03,093481,Chow; Bennett,8,0,32,24
1657739058164,MATH 142A,B04,093558,Chow; Bennett,13,0,32,19
1657739058164,MATH 142A,B05,093559,Chow; Bennett,6,0,32,26
1657739064193,MATH 193A,A01,083224,Rotar; Vladimir,8,0,34,26
1657739064193,MATH 193A,A02,083225,Rotar; Vladimir,9,0,34,25
1657739064193,MATH 193A,A03,083781,Rotar; Vladimir,5,0,34,29
1657739064193,MATH 193A,A04,083782,Rotar; Vladimir,10,0,34,24
1657739064193,MATH 193A,A05,093482,Rotar; Vladimir,10,0,34,24
1657739070219,MATH 197,001,091859,McAuley; Julian John,9999,0,9999,0
1657739070219,MATH 197,002,095566,Kedlaya; Kiran S.,9997,0,9999,2
1657739070219,MATH 197,003,095567,Xiao; Ming,9999,0,9999,0
1657739070219,MATH 197,004,095571,Perols; Johan Lars,9998,0,9999,1
1657739077280,COGS 9,A01,083615,Shannon; Kyle Michael,9,0,75,66
1657739083307,COGS 11,A01,083617,Boyle; Mary E. T.,23,0,48,25
1657739089337,COGS 13,A01,083071,Bastos; Amalia Pinkusfeld,11,0,71,60
1657739095364,COGS 14A,A01,092681,Semenuks; Arturs,5,1,100,95
1657739101389,COGS 14B,A01,083073,Cheng; Tzu-Han,6,0,63,57
1657739107426,COGS 17,A01,092677,Semenuks; Arturs,6,0,81,75
1657739113452,COGS 100,A01,083619,Allen; Michael Gordon,17,0,70,53
1657739119479,COGS 101A,A01,083621,Davis; Joshua Daniel,9,0,68,59
1657739125506,COGS 101B,A01,091572,Allen; Michael Gordon,12,0,65,53
1657739131527,COGS 101C,A01,083625,Delgado; Tania,17,0,35,18
1657739137550,COGS 107A,A01,083627,Boyle; Mary E. T.,13,0,60,47
1657739143578,COGS 118A,A01,083075,Gupta; Anjum,21,0,76,55
1657739149606,CSE 3,A50,083646,Miranda; Gregory Joseph,24,0,50,26
1657739155629,CSE 8A,A50,083650,Miranda; Gregory Joseph,17,1,56,39
1657739161659,CSE 11,A01,083080,Cao; Yingjun,6,15,40,34
1657739167680,CSE 12,A01,083652,Krause-Levy; Sophia Louisa,28,1,120,92
1657739173706,CSE 15L,A01,083654,Morris; Justin Loren,9,0,50,41
1657739173706,CSE 15L,A02,083655,Morris; Justin Loren,9,0,50,41
1657739179728,CSE 20,A01,083657,Tran; Khoa Dang,39,0,80,41
1657739185749,CSE 21,A01,095574,Bach; Quang Tran,22,0,48,26
1657739191776,CSE 30,A01,083084,Eldon; John,6,0,80,74
1657739191776,CSE 30,B01,095061,Bhaskar; Nishant,9,0,50,41
1657739197806,CSE 100,A01,083659,Cao; Yingjun,5,4,70,65
1657739203831,CSE 134B,A01,083661,Powell; Thomas Allan,23,0,100,77
1657739209854,CSE 140,A01,083663,Gungor; Onat,15,0,85,70
1657739215876,CSE 140L,A01,083088,Eldon; John,23,0,100,77
1657739221902,CSE 175,A01,083665,Kumar; Rakesh,3,0,25,22
1657739227924,CSE 190,A00,092507,Dubnov; Shlomo,8,0,20,12
1657739233949,ECE 45,A01,083139,Congero; Spencer William,6,0,75,69
1657739239973,ECE 65,A50,083695,Saad; Andrew S,12,0,30,18
1657739239973,ECE 65,A51,095125,Saad; Andrew S,24,0,26,2
1657739246007,ECE 109,A01,091882,Touri; Behrouz,20,0,70,50
1657739252049,ECE 180,A00,083140,Abi Samra; Nicholas Camill,1,0,30,29
1657739252049,ECE 180,B00,083141,Abi Samra; Nicholas Camill,0,0,30,30
1657739258078,MATH 10A,A01,083735,Patchell; Gregory David,2,0,30,28
1657739258078,MATH 10A,A02,083736,Patchell; Gregory David,20,0,30,10
1657739258078,MATH 10A,A03,083737,Patchell; Gregory David,16,0,30,14
1657739264106,MATH 10B,A01,083207,Lim; Seonhee,8,0,34,26
1657739264106,MATH 10B,A02,083208,Lim; Seonhee,9,0,35,26
1657739264106,MATH 10B,A03,093472,Lim; Seonhee,7,0,34,27
1657739264106,MATH 10B,B01,083739,Sinha; Shubham,13,0,30,17
1657739270134,MATH 18,A01,083743,Cinel; Cameron Alexander,9,0,30,21
1657739270134,MATH 18,A02,083744,Cinel; Cameron Alexander,17,0,30,13
1657739270134,MATH 18,A03,083745,Cinel; Cameron Alexander,10,0,30,20
1657739270134,MATH 18,B01,083748,Rideout; David Porter,5,0,37,32
1657739270134,MATH 18,B02,083749,Rideout; David Porter,5,0,36,31
1657739270134,MATH 18,B03,083750,Rideout; David Porter,3,0,37,34
1657739270134,MATH 18,B04,083751,Rideout; David Porter,6,0,36,30
1657739270134,MATH 18,B05,093473,Rideout; David Porter,6,0,36,30
1657739270134,MATH 18,B06,093474,Rideout; David Porter,6,0,36,30
1657739276156,MATH 20A,A01,083754,Zheng; Zequn,14,0,40,26
1657739282184,MATH 20B,A01,083756,Briones; Jor-el Thomas Caparas,4,0,36,32
1657739282184,MATH 20B,A02,083757,Briones; Jor-el Thomas Caparas,1,0,36,35
1657739282184,MATH 20B,A03,093475,Briones; Jor-el Thomas Caparas,2,0,36,34
1657739288207,MATH 20C,A01,083760,Briones; Jor-el Thomas Caparas,1,0,35,34
1657739288207,MATH 20C,A02,083761,Briones; Jor-el Thomas Caparas,8,0,35,27
1657739288207,MATH 20C,A03,093476,Briones; Jor-el Thomas Caparas,0,1,36,36
1657739288207,MATH 20C,B01,083762,Bach; Quang Tran,1,0,30,29
1657739294232,MATH 20D,A01,083765,Tran; Brian Kha,5,0,30,25
1657739294232,MATH 20D,A02,083766,Tran; Brian Kha,5,0,30,25
1657739294232,MATH 20D,A03,083767,Tran; Brian Kha,5,0,30,25
1657739300256,MATH 20E,A01,083771,Ganguly; Soumya,9,0,32,23
1657739300256,MATH 20E,A02,083772,Ganguly; Soumya,6,0,32,26
1657739300256,MATH 20E,B01,083773,Ciotti; Benjamin,20,0,35,15
1657739300256,MATH 20E,B02,083774,Ciotti; Benjamin,18,0,35,17
1657739306283,MATH 103A,A01,083777,Greenfeld; Be'Eri,3,0,36,33
1657739306283,MATH 103A,A02,083778,Greenfeld; Be'Eri,5,0,36,31
1657739306283,MATH 103A,A03,093561,Greenfeld; Be'Eri,6,0,36,30
1657739306283,MATH 103A,B01,083779,Greenfeld; Be'Eri,7,0,36,29
1657739306283,MATH 103A,B02,083780,Greenfeld; Be'Eri,4,0,36,32
1657739306283,MATH 103A,B03,093562,Greenfeld; Be'Eri,3,0,36,33
1657739312311,MATH 105,A01,085443,Carter; Anne Toulson,15,0,35,20
1657739312311,MATH 105,A02,093477,Carter; Anne Toulson,20,0,35,15
1657739318341,MATH 109,A01,083213,Ganzberger; Geoffrey Michael,2,0,34,32
1657739318341,MATH 109,A02,083214,Ganzberger; Geoffrey Michael,4,0,34,30
1657739318341,MATH 109,A03,093478,Ganzberger; Geoffrey Michael,2,0,34,32
1657739318341,MATH 109,B01,083215,Ganzberger; Geoffrey Michael,1,0,32,31
1657739318341,MATH 109,B02,083216,Ganzberger; Geoffrey Michael,2,0,32,30
1657739318341,MATH 109,B03,093479,Ganzberger; Geoffrey Michael,8,0,32,24
1657739324366,MATH 142A,A01,083219,Chow; Bennett,7,0,32,25
1657739324366,MATH 142A,A02,083220,Chow; Bennett,10,0,32,22
1657739324366,MATH 142A,A03,093480,Chow; Bennett,9,0,32,23
1657739324366,MATH 142A,B03,093481,Chow; Bennett,8,0,32,24
1657739324366,MATH 142A,B04,093558,Chow; Bennett,13,0,32,19
1657739324366,MATH 142A,B05,093559,Chow; Bennett,6,0,32,26
1657739330388,MATH 193A,A01,083224,Rotar; Vladimir,8,0,34,26
1657739330388,MATH 193A,A02,083225,Rotar; Vladimir,9,0,34,25
1657739330388,MATH 193A,A03,083781,Rotar; Vladimir,5,0,34,29
1657739330388,MATH 193A,A04,083782,Rotar; Vladimir,10,0,34,24
1657739330388,MATH 193A,A05,093482,Rotar; Vladimir,10,0,34,24
1657739336411,MATH 197,001,091859,McAuley; Julian John,9999,0,9999,0
1657739336411,MATH 197,002,095566,Kedlaya; Kiran S.,9997,0,9999,2
1657739336411,MATH 197,003,095567,Xiao; Ming,9999,0,9999,0
1657739336411,MATH 197,004,095571,Perols; Johan Lars,9998,0,9999,1
1657739343468,COGS 9,A01,083615,Shannon; Kyle Michael,9,0,75,66
1657739349490,COGS 11,A01,083617,Boyle; Mary E. T.,23,0,48,25
1657739355513,COGS 13,A01,083071,Bastos; Amalia Pinkusfeld,11,0,71,60
1657739361536,COGS 14A,A01,092681,Semenuks; Arturs,5,1,100,95
1657739367558,COGS 14B,A01,083073,Cheng; Tzu-Han,6,0,63,57
1657739373586,COGS 17,A01,092677,Semenuks; Arturs,6,0,81,75
1657739379610,COGS 100,A01,083619,Allen; Michael Gordon,17,0,70,53
1657739385638,COGS 101A,A01,083621,Davis; Joshua Daniel,9,0,68,59
1657739391663,COGS 101B,A01,091572,Allen; Michael Gordon,12,0,65,53
1657739397691,COGS 101C,A01,083625,Delgado; Tania,17,0,35,18
1657739403721,COGS 107A,A01,083627,Boyle; Mary E. T.,13,0,60,47
1657739409748,COGS 118A,A01,083075,Gupta; Anjum,21,0,76,55
1657739415770,CSE 3,A50,083646,Miranda; Gregory Joseph,24,0,50,26
1657739421799,CSE 8A,A50,083650,Miranda; Gregory Joseph,17,1,56,39
1657739427822,CSE 11,A01,083080,Cao; Yingjun,6,15,40,34
1657739433844,CSE 12,A01,083652,Krause-Levy; Sophia Louisa,28,1,120,92
1657739439867,CSE 15L,A01,083654,Morris; Justin Loren,9,0,50,41
1657739439867,CSE 15L,A02,083655,Morris; Justin Loren,9,0,50,41
1657739445892,CSE 20,A01,083657,Tran; Khoa Dang,39,0,80,41
1657739451918,CSE 21,A01,095574,Bach; Quang Tran,22,0,48,26
1657739457942,CSE 30,A01,083084,Eldon; John,6,0,80,74
1657739457942,CSE 30,B01,095061,Bhaskar; Nishant,9,0,50,41
1657739463964,CSE 100,A01,083659,Cao; Yingjun,5,4,70,65
1657739469987,CSE 134B,A01,083661,Powell; Thomas Allan,23,0,100,77
1657739476013,CSE 140,A01,083663,Gungor; Onat,15,0,85,70
1657739482036,CSE 140L,A01,083088,Eldon; John,23,0,100,77
1657739488068,CSE 175,A01,083665,Kumar; Rakesh,3,0,25,22
1657739494091,CSE 190,A00,092507,Dubnov; Shlomo,8,0,20,12
1657739500114,ECE 45,A01,083139,Congero; Spencer William,6,0,75,69
1657739506136,ECE 65,A50,083695,Saad; Andrew S,12,0,30,18
1657739506136,ECE 65,A51,095125,Saad; Andrew S,24,0,26,2
1657739512161,ECE 109,A01,091882,Touri; Behrouz,20,0,70,50
1657739518255,ECE 180,A00,083140,Abi Samra; Nicholas Camill,1,0,30,29
1657739518255,ECE 180,B00,083141,Abi Samra; Nicholas Camill,0,0,30,30
1657739524279,MATH 10A,A01,083735,Patchell; Gregory David,2,0,30,28
1657739524279,MATH 10A,A02,083736,Patchell; Gregory David,20,0,30,10
1657739524279,MATH 10A,A03,083737,Patchell; Gregory David,16,0,30,14
1657739530307,MATH 10B,A01,083207,Lim; Seonhee,8,0,34,26
1657739530307,MATH 10B,A02,083208,Lim; Seonhee,9,0,35,26
1657739530307,MATH 10B,A03,093472,Lim; Seonhee,7,0,34,27
1657739530307,MATH 10B,B01,083739,Sinha; Shubham,13,0,30,17
1657739536332,MATH 18,A01,083743,Cinel; Cameron Alexander,9,0,30,21
1657739536332,MATH 18,A02,083744,Cinel; Cameron Alexander,17,0,30,13
1657739536332,MATH 18,A03,083745,Cinel; Cameron Alexander,10,0,30,20
1657739536332,MATH 18,B01,083748,Rideout; David Porter,5,0,37,32
1657739536332,MATH 18,B02,083749,Rideout; David Porter,5,0,36,31
1657739536332,MATH 18,B03,083750,Rideout; David Porter,3,0,37,34
1657739536332,MATH 18,B04,083751,Rideout; David Porter,6,0,36,30
1657739536332,MATH 18,B05,093473,Rideout; David Porter,6,0,36,30
1657739536332,MATH 18,B06,093474,Rideout; David Porter,6,0,36,30
1657739542355,MATH 20A,A01,083754,Zheng; Zequn,14,0,40,26
1657739548381,MATH 20B,A01,083756,Briones; Jor-el Thomas Caparas,4,0,36,32
1657739548381,MATH 20B,A02,083757,Briones; Jor-el Thomas Caparas,1,0,36,35
1657739548381,MATH 20B,A03,093475,Briones; Jor-el Thomas Caparas,2,0,36,34
1657739554405,MATH 20C,A01,083760,Briones; Jor-el Thomas Caparas,1,0,35,34
1657739554405,MATH 20C,A02,083761,Briones; Jor-el Thomas Caparas,8,0,35,27
1657739554405,MATH 20C,A03,093476,Briones; Jor-el Thomas Caparas,0,1,36,36
1657739554405,MATH 20C,B01,083762,Bach; Quang Tran,1,0,30,29
1657739560428,MATH 20D,A01,083765,Tran; Brian Kha,5,0,30,25
1657739560428,MATH 20D,A02,083766,Tran; Brian Kha,5,0,30,25
1657739560428,MATH 20D,A03,083767,Tran; Brian Kha,5,0,30,25
1657739566455,MATH 20E,A01,083771,Ganguly; Soumya,9,0,32,23
1657739566455,MATH 20E,A02,083772,Ganguly; Soumya,6,0,32,26
1657739566455,MATH 20E,B01,083773,Ciotti; Benjamin,20,0,35,15
1657739566455,MATH 20E,B02,083774,Ciotti; Benjamin,18,0,35,17
1657739572497,MATH 103A,A01,083777,Greenfeld; Be'Eri,3,0,36,33
1657739572497,MATH 103A,A02,083778,Greenfeld; Be'Eri,5,0,36,31
1657739572497,MATH 103A,A03,093561,Greenfeld; Be'Eri,6,0,36,30
1657739572497,MATH 103A,B01,083779,Greenfeld; Be'Eri,7,0,36,29
1657739572497,MATH 103A,B02,083780,Greenfeld; Be'Eri,4,0,36,32
1657739572497,MATH 103A,B03,093562,Greenfeld; Be'Eri,3,0,36,33
1657739578521,MATH 105,A01,085443,Carter; Anne Toulson,15,0,35,20
1657739578521,MATH 105,A02,093477,Carter; Anne Toulson,20,0,35,15
1657739584546,MATH 109,A01,083213,Ganzberger; Geoffrey Michael,2,0,34,32
1657739584546,MATH 109,A02,083214,Ganzberger; Geoffrey Michael,4,0,34,30
1657739584546,MATH 109,A03,093478,Ganzberger; Geoffrey Michael,2,0,34,32
1657739584546,MATH 109,B01,083215,Ganzberger; Geoffrey Michael,1,0,32,31
1657739584546,MATH 109,B02,083216,Ganzberger; Geoffrey Michael,2,0,32,30
1657739584546,MATH 109,B03,093479,Ganzberger; Geoffrey Michael,8,0,32,24
1657739590572,MATH 142A,A01,083219,Chow; Bennett,7,0,32,25
1657739590572,MATH 142A,A02,083220,Chow; Bennett,10,0,32,22
1657739590572,MATH 142A,A03,093480,Chow; Bennett,9,0,32,23
1657739590572,MATH 142A,B03,093481,Chow; Bennett,8,0,32,24
1657739590572,MATH 142A,B04,093558,Chow; Bennett,13,0,32,19
1657739590572,MATH 142A,B05,093559,Chow; Bennett,6,0,32,26
1657739596598,MATH 193A,A01,083224,Rotar; Vladimir,8,0,34,26
1657739596598,MATH 193A,A02,083225,Rotar; Vladimir,9,0,34,25
1657739596598,MATH 193A,A03,083781,Rotar; Vladimir,5,0,34,29
1657739596598,MATH 193A,A04,083782,Rotar; Vladimir,10,0,34,24
1657739596598,MATH 193A,A05,093482,Rotar; Vladimir,10,0,34,24
1657739602627,MATH 197,001,091859,McAuley; Julian John,9999,0,9999,0
1657739602627,MATH 197,002,095566,Kedlaya; Kiran S.,9997,0,9999,2
1657739602627,MATH 197,003,095567,Xiao; Ming,9999,0,9999,0
1657739602627,MATH 197,004,095571,Perols; Johan Lars,9998,0,9999,1
1657739609676,COGS 9,A01,083615,Shannon; Kyle Michael,9,0,75,66
1657739615703,COGS 11,A01,083617,Boyle; Mary E. T.,23,0,48,25
1657739621730,COGS 13,A01,083071,Bastos; Amalia Pinkusfeld,11,0,71,60
1657739627764,COGS 14A,A01,092681,Semenuks; Arturs,5,1,100,95
1657739633787,COGS 14B,A01,083073,Cheng; Tzu-Han,6,0,63,57
1657739639816,COGS 17,A01,092677,Semenuks; Arturs,6,0,81,75
1657739645840,COGS 100,A01,083619,Allen; Michael Gordon,17,0,70,53
1657739651864,COGS 101A,A01,083621,Davis; Joshua Daniel,9,0,68,59
1657739657886,COGS 101B,A01,091572,Allen; Michael Gordon,12,0,65,53
1657739663912,COGS 101C,A01,083625,Delgado; Tania,17,0,35,18
1657739669934,COGS 107A,A01,083627,Boyle; Mary E. T.,13,0,60,47
1657739675957,COGS 118A,A01,083075,Gupta; Anjum,21,0,76,55
1657739681985,CSE 3,A50,083646,Miranda; Gregory Joseph,24,0,50,26
1657739688007,CSE 8A,A50,083650,Miranda; Gregory Joseph,17,1,56,39
1657739694032,CSE 11,A01,083080,Cao; Yingjun,6,15,40,34
1657739700060,CSE 12,A01,083652,Krause-Levy; Sophia Louisa,28,1,120,92
1657739706091,CSE 15L,A01,083654,Morris; Justin Loren,9,0,50,41
1657739706091,CSE 15L,A02,083655,Morris; Justin Loren,9,0,50,41
1657739712121,CSE 20,A01,083657,Tran; Khoa Dang,39,0,80,41
1657739718144,CSE 21,A01,095574,Bach; Quang Tran,22,0,48,26
1657739724170,CSE 30,A01,083084,Eldon; John,6,0,80,74
1657739724170,CSE 30,B01,095061,Bhaskar; Nishant,9,0,50,41
1657739730194,CSE 100,A01,083659,Cao; Yingjun,5,4,70,65
1657739736217,CSE 134B,A01,083661,Powell; Thomas Allan,23,0,100,77
1657739742239,CSE 140,A01,083663,Gungor; Onat,15,0,85,70
1657739748261,CSE 140L,A01,083088,Eldon; John,23,0,100,77
1657739754285,CSE 175,A01,083665,Kumar; Rakesh,3,0,25,22
1657739760312,CSE 190,A00,092507,Dubnov; Shlomo,8,0,20,12
1657739766337,ECE 45,A01,083139,Congero; Spencer William,6,0,75,69
1657739772371,ECE 65,A50,083695,Saad; Andrew S,12,0,30,18
1657739772371,ECE 65,A51,095125,Saad; Andrew S,24,0,26,2
1657739778398,ECE 109,A01,091882,Touri; Behrouz,20,0,70,50
1657739784427,ECE 180,A00,083140,Abi Samra; Nicholas Camill,1,0,30,29
1657739784427,ECE 180,B00,083141,Abi Samra; Nicholas Camill,0,0,30,30
1657739790454,MATH 10A,A01,083735,Patchell; Gregory David,2,0,30,28
1657739790454,MATH 10A,A02,083736,Patchell; Gregory David,20,0,30,10
1657739790454,MATH 10A,A03,083737,Patchell; Gregory David,16,0,30,14
1657739796485,MATH 10B,A01,083207,Lim; Seonhee,8,0,34,26
1657739796485,MATH 10B,A02,083208,Lim; Seonhee,9,0,35,26
1657739796485,MATH 10B,A03,093472,Lim; Seonhee,7,0,34,27
1657739796485,MATH 10B,B01,083739,Sinha; Shubham,13,0,30,17
1657739802508,MATH 18,A01,083743,Cinel; Cameron Alexander,9,0,30,21
1657739802508,MATH 18,A02,083744,Cinel; Cameron Alexander,17,0,30,13
1657739802508,MATH 18,A03,083745,Cinel; Cameron Alexander,10,0,30,20
1657739802508,MATH 18,B01,083748,Rideout; David Porter,5,0,37,32
1657739802508,MATH 18,B02,083749,Rideout; David Porter,5,0,36,31
1657739802508,MATH 18,B03,083750,Rideout; David Porter,3,0,37,34
1657739802508,MATH 18,B04,083751,Rideout; David Porter,6,0,36,30
1657739802508,MATH 18,B05,093473,Rideout; David Porter,6,0,36,30
1657739802508,MATH 18,B06,093474,Rideout; David Porter,6,0,36,30
1657739808535,MATH 20A,A01,083754,Zheng; Zequn,14,0,40,26
1657739814570,MATH 20B,A01,083756,Briones; Jor-el Thomas Caparas,4,0,36,32
1657739814570,MATH 20B,A02,083757,Briones; Jor-el Thomas Caparas,1,0,36,35
1657739814570,MATH 20B,A03,093475,Briones; Jor-el Thomas Caparas,2,0,36,34
1657739820597,MATH 20C,A01,083760,Briones; Jor-el Thomas Caparas,1,0,35,34
1657739820597,MATH 20C,A02,083761,Briones; Jor-el Thomas Caparas,8,0,35,27
1657739820597,MATH 20C,A03,093476,Briones; Jor-el Thomas Caparas,0,1,36,36
1657739820597,MATH 20C,B01,083762,Bach; Quang Tran,1,0,30,29
1657739826621,MATH 20D,A01,083765,Tran; Brian Kha,5,0,30,25
1657739826621,MATH 20D,A02,083766,Tran; Brian Kha,5,0,30,25
1657739826621,MATH 20D,A03,083767,Tran; Brian Kha,5,0,30,25
1657739832651,MATH 20E,A01,083771,Ganguly; Soumya,9,0,32,23
1657739832651,MATH 20E,A02,083772,Ganguly; Soumya,6,0,32,26
1657739832651,MATH 20E,B01,083773,Ciotti; Benjamin,20,0,35,15
1657739832651,MATH 20E,B02,083774,Ciotti; Benjamin,18,0,35,17
1657739838675,MATH 103A,A01,083777,Greenfeld; Be'Eri,3,0,36,33
1657739838675,MATH 103A,A02,083778,Greenfeld; Be'Eri,5,0,36,31
1657739838675,MATH 103A,A03,093561,Greenfeld; Be'Eri,6,0,36,30
1657739838675,MATH 103A,B01,083779,Greenfeld; Be'Eri,7,0,36,29
1657739838675,MATH 103A,B02,083780,Greenfeld; Be'Eri,4,0,36,32
1657739838675,MATH 103A,B03,093562,Greenfeld; Be'Eri,3,0,36,33
1657739844707,MATH 105,A01,085443,Carter; Anne Toulson,15,0,35,20
1657739844707,MATH 105,A02,093477,Carter; Anne Toulson,20,0,35,15
1657739850733,MATH 109,A01,083213,Ganzberger; Geoffrey Michael,2,0,34,32
1657739850733,MATH 109,A02,083214,Ganzberger; Geoffrey Michael,4,0,34,30
1657739850733,MATH 109,A03,093478,Ganzberger; Geoffrey Michael,2,0,34,32
1657739850733,MATH 109,B01,083215,Ganzberger; Geoffrey Michael,1,0,32,31
1657739850733,MATH 109,B02,083216,Ganzberger; Geoffrey Michael,2,0,32,30
1657739850733,MATH 109,B03,093479,Ganzberger; Geoffrey Michael,8,0,32,24
1657739856763,MATH 142A,A01,083219,Chow; Bennett,7,0,32,25
1657739856763,MATH 142A,A02,083220,Chow; Bennett,10,0,32,22
1657739856763,MATH 142A,A03,093480,Chow; Bennett,9,0,32,23
1657739856763,MATH 142A,B03,093481,Chow; Bennett,8,0,32,24
1657739856763,MATH 142A,B04,093558,Chow; Bennett,13,0,32,19
1657739856763,MATH 142A,B05,093559,Chow; Bennett,6,0,32,26
1657739862788,MATH 193A,A01,083224,Rotar; Vladimir,8,0,34,26
1657739862788,MATH 193A,A02,083225,Rotar; Vladimir,9,0,34,25
1657739862788,MATH 193A,A03,083781,Rotar; Vladimir,5,0,34,29
1657739862788,MATH 193A,A04,083782,Rotar; Vladimir,10,0,34,24
1657739862788,MATH 193A,A05,093482,Rotar; Vladimir,10,0,34,24
1657739868811,MATH 197,001,091859,McAuley; Julian John,9999,0,9999,0
1657739868811,MATH 197,002,095566,Kedlaya; Kiran S.,9997,0,9999,2
1657739868811,MATH 197,003,095567,Xiao; Ming,9999,0,9999,0
1657739868811,MATH 197,004,095571,Perols; Johan Lars,9998,0,9999,1
1657739875862,COGS 9,A01,083615,Shannon; Kyle Michael,9,0,75,66
1657739881900,COGS 11,A01,083617,Boyle; Mary E. T.,23,0,48,25
1657739887926,COGS 13,A01,083071,Bastos; Amalia Pinkusfeld,11,0,71,60
1657739893952,COGS 14A,A01,092681,Semenuks; Arturs,5,1,100,95
1657739899976,COGS 14B,A01,083073,Cheng; Tzu-Han,6,0,63,57
1657739906010,COGS 17,A01,092677,Semenuks; Arturs,6,0,81,75
1657739912034,COGS 100,A01,083619,Allen; Michael Gordon,17,0,70,53
1657739918062,COGS 101A,A01,083621,Davis; Joshua Daniel,9,0,68,59
1657739924090,COGS 101B,A01,091572,Allen; Michael Gordon,12,0,65,53
1657739930123,COGS 101C,A01,083625,Delgado; Tania,17,0,35,18
1657739936153,COGS 107A,A01,083627,Boyle; Mary E. T.,13,0,60,47
1657739942182,COGS 118A,A01,083075,Gupta; Anjum,21,0,76,55
1657739948210,CSE 3,A50,083646,Miranda; Gregory Joseph,24,0,50,26
1657739954234,CSE 8A,A50,083650,Miranda; Gregory Joseph,17,1,56,39
1657739960258,CSE 11,A01,083080,Cao; Yingjun,6,15,40,34
1657739966289,CSE 12,A01,083652,Krause-Levy; Sophia Louisa,28,1,120,92
1657739972313,CSE 15L,A01,083654,Morris; Justin Loren,9,0,50,41
1657739972313,CSE 15L,A02,083655,Morris; Justin Loren,9,0,50,41
1657739978341,CSE 20,A01,083657,Tran; Khoa Dang,39,0,80,41
1657739984366,CSE 21,A01,095574,Bach; Quang Tran,22,0,48,26
1657739990390,CSE 30,A01,083084,Eldon; John,6,0,80,74
1657739990390,CSE 30,B01,095061,Bhaskar; Nishant,9,0,50,41
1657739996414,CSE 100,A01,083659,Cao; Yingjun,5,4,70,65
1657740002437,CSE 134B,A01,083661,Powell; Thomas Allan,23,0,100,77
1657740008470,CSE 140,A01,083663,Gungor; Onat,15,0,85,70
1657740014503,CSE 140L,A01,083088,Eldon; John,23,0,100,77
1657740020528,CSE 175,A01,083665,Kumar; Rakesh,3,0,25,22
1657740026567,CSE 190,A00,092507,Dubnov; Shlomo,8,0,20,12
1657740032595,ECE 45,A01,083139,Congero; Spencer William,6,0,75,69
1657740038623,ECE 65,A50,083695,Saad; Andrew S,12,0,30,18
1657740038623,ECE 65,A51,095125,Saad; Andrew S,24,0,26,2
1657740044650,ECE 109,A01,091882,Touri; Behrouz,20,0,70,50
1657740050674,ECE 180,A00,083140,Abi Samra; Nicholas Camill,1,0,30,29
1657740050674,ECE 180,B00,083141,Abi Samra; Nicholas Camill,0,0,30,30
1657740056699,MATH 10A,A01,083735,Patchell; Gregory David,2,0,30,28
1657740056699,MATH 10A,A02,083736,Patchell; Gregory David,20,0,30,10
1657740056699,MATH 10A,A03,083737,Patchell; Gregory David,16,0,30,14
1657740062733,MATH 10B,A01,083207,Lim; Seonhee,8,0,34,26
1657740062733,MATH 10B,A02,083208,Lim; Seonhee,9,0,35,26
1657740062733,MATH 10B,A03,093472,Lim; Seonhee,7,0,34,27
1657740062733,MATH 10B,B01,083739,Sinha; Shubham,13,0,30,17
1657740068767,MATH 18,A01,083743,Cinel; Cameron Alexander,9,0,30,21
1657740068767,MATH 18,A02,083744,Cinel; Cameron Alexander,17,0,30,13
1657740068767,MATH 18,A03,083745,Cinel; Cameron Alexander,10,0,30,20
1657740068767,MATH 18,B01,083748,Rideout; David Porter,5,0,37,32
1657740068767,MATH 18,B02,083749,Rideout; David Porter,5,0,36,31
1657740068767,MATH 18,B03,083750,Rideout; David Porter,3,0,37,34
1657740068767,MATH 18,B04,083751,Rideout; David Porter,6,0,36,30
1657740068767,MATH 18,B05,093473,Rideout; David Porter,6,0,36,30
1657740068767,MATH 18,B06,093474,Rideout; David Porter,6,0,36,30
1657740074793,MATH 20A,A01,083754,Zheng; Zequn,14,0,40,26
1657740080821,MATH 20B,A01,083756,Briones; Jor-el Thomas Caparas,4,0,36,32
1657740080821,MATH 20B,A02,083757,Briones; Jor-el Thomas Caparas,1,0,36,35
1657740080821,MATH 20B,A03,093475,Briones; Jor-el Thomas Caparas,2,0,36,34
1657740086862,MATH 20C,A01,083760,Briones; Jor-el Thomas Caparas,1,0,35,34
1657740086862,MATH 20C,A02,083761,Briones; Jor-el Thomas Caparas,8,0,35,27
1657740086862,MATH 20C,A03,093476,Briones; Jor-el Thomas Caparas,0,1,36,36
1657740086862,MATH 20C,B01,083762,Bach; Quang Tran,1,0,30,29
1657740092890,MATH 20D,A01,083765,Tran; Brian Kha,5,0,30,25
1657740092890,MATH 20D,A02,083766,Tran; Brian Kha,5,0,30,25
1657740092890,MATH 20D,A03,083767,Tran; Brian Kha,5,0,30,25
1657740098915,MATH 20E,A01,083771,Ganguly; Soumya,9,0,32,23
1657740098915,MATH 20E,A02,083772,Ganguly; Soumya,6,0,32,26
1657740098915,MATH 20E,B01,083773,Ciotti; Benjamin,20,0,35,15
1657740098915,MATH 20E,B02,083774,Ciotti; Benjamin,18,0,35,17
1657740104939,MATH 103A,A01,083777,Greenfeld; Be'Eri,3,0,36,33
1657740104939,MATH 103A,A02,083778,Greenfeld; Be'Eri,5,0,36,31
1657740104939,MATH 103A,A03,093561,Greenfeld; Be'Eri,6,0,36,30
1657740104939,MATH 103A,B01,083779,Greenfeld; Be'Eri,7,0,36,29
1657740104939,MATH 103A,B02,083780,Greenfeld; Be'Eri,4,0,36,32
1657740104939,MATH 103A,B03,093562,Greenfeld; Be'Eri,3,0,36,33
1657740110967,MATH 105,A01,085443,Carter; Anne Toulson,15,0,35,20
1657740110967,MATH 105,A02,093477,Carter; Anne Toulson,20,0,35,15
1657740117069,MATH 109,A01,083213,Ganzberger; Geoffrey Michael,2,0,34,32
1657740117069,MATH 109,A02,083214,Ganzberger; Geoffrey Michael,4,0,34,30
1657740117069,MATH 109,A03,093478,Ganzberger; Geoffrey Michael,2,0,34,32
1657740117069,MATH 109,B01,083215,Ganzberger; Geoffrey Michael,1,0,32,31
1657740117069,MATH 109,B02,083216,Ganzberger; Geoffrey Michael,2,0,32,30
1657740117069,MATH 109,B03,093479,Ganzberger; Geoffrey Michael,8,0,32,24
1657740123099,MATH 142A,A01,083219,Chow; Bennett,7,0,32,25
1657740123099,MATH 142A,A02,083220,Chow; Bennett,10,0,32,22
1657740123099,MATH 142A,A03,093480,Chow; Bennett,9,0,32,23
1657740123099,MATH 142A,B03,093481,Chow; Bennett,8,0,32,24
1657740123099,MATH 142A,B04,093558,Chow; Bennett,13,0,32,19
1657740123099,MATH 142A,B05,093559,Chow; Bennett,6,0,32,26
1657740129122,MATH 193A,A01,083224,Rotar; Vladimir,8,0,34,26
1657740129122,MATH 193A,A02,083225,Rotar; Vladimir,9,0,34,25
1657740129122,MATH 193A,A03,083781,Rotar; Vladimir,5,0,34,29
1657740129122,MATH 193A,A04,083782,Rotar; Vladimir,10,0,34,24
1657740129122,MATH 193A,A05,093482,Rotar; Vladimir,10,0,34,24
1657740135150,MATH 197,001,091859,McAuley; Julian John,9999,0,9999,0
1657740135150,MATH 197,002,095566,Kedlaya; Kiran S.,9997,0,9999,2
1657740135150,MATH 197,003,095567,Xiao; Ming,9999,0,9999,0
1657740135150,MATH 197,004,095571,Perols; Johan Lars,9998,0,9999,1
1657740142212,COGS 9,A01,083615,Shannon; Kyle Michael,9,0,75,66
1657740148236,COGS 11,A01,083617,Boyle; Mary E. T.,23,0,48,25
1657740154260,COGS 13,A01,083071,Bastos; Amalia Pinkusfeld,11,0,71,60
1657740160298,COGS 14A,A01,092681,Semenuks; Arturs,5,1,100,95
1657740166320,COGS 14B,A01,083073,Cheng; Tzu-Han,6,0,63,57
1657740172344,COGS 17,A01,092677,Semenuks; Arturs,6,0,81,75
1657740178375,COGS 100,A01,083619,Allen; Michael Gordon,17,0,70,53
1657740184403,COGS 101A,A01,083621,Davis; Joshua Daniel,9,0,68,59
1657740190426,COGS 101B,A01,091572,Allen; Michael Gordon,12,0,65,53
1657740196456,COGS 101C,A01,083625,Delgado; Tania,17,0,35,18
1657740202479,COGS 107A,A01,083627,Boyle; Mary E. T.,13,0,60,47
1657740208501,COGS 118A,A01,083075,Gupta; Anjum,21,0,76,55
1657740214526,CSE 3,A50,083646,Miranda; Gregory Joseph,24,0,50,26
1657740220550,CSE 8A,A50,083650,Miranda; Gregory Joseph,17,1,56,39
1657740226572,CSE 11,A01,083080,Cao; Yingjun,6,15,40,34
1657740232610,CSE 12,A01,083652,Krause-Levy; Sophia Louisa,28,1,120,92
1657740238633,CSE 15L,A01,083654,Morris; Justin Loren,9,0,50,41
1657740238633,CSE 15L,A02,083655,Morris; Justin Loren,9,0,50,41
1657740244661,CSE 20,A01,083657,Tran; Khoa Dang,39,0,80,41
1657740250687,CSE 21,A01,095574,Bach; Quang Tran,22,0,48,26
1657740256713,CSE 30,A01,083084,Eldon; John,6,0,80,74
1657740256713,CSE 30,B01,095061,Bhaskar; Nishant,9,0,50,41
1657740262741,CSE 100,A01,083659,Cao; Yingjun,5,4,70,65
1657740268766,CSE 134B,A01,083661,Powell; Thomas Allan,23,0,100,77
1657740274787,CSE 140,A01,083663,Gungor; Onat,15,0,85,70
1657740280809,CSE 140L,A01,083088,Eldon; John,23,0,100,77
1657740286832,CSE 175,A01,083665,Kumar; Rakesh,3,0,25,22
1657740292856,CSE 190,A00,092507,Dubnov; Shlomo,8,0,20,12
1657740298884,ECE 45,A01,083139,Congero; Spencer William,6,0,75,69
1657740304907,ECE 65,A50,083695,Saad; Andrew S,12,0,30,18
1657740304907,ECE 65,A51,095125,Saad; Andrew S,24,0,26,2
1657740310929,ECE 109,A01,091882,Touri; Behrouz,20,0,70,50
1657740316952,ECE 180,A00,083140,Abi Samra; Nicholas Camill,1,0,30,29
1657740316952,ECE 180,B00,083141,Abi Samra; Nicholas Camill,0,0,30,30
1657740322979,MATH 10A,A01,083735,Patchell; Gregory David,2,0,30,28
1657740322979,MATH 10A,A02,083736,Patchell; Gregory David,20,0,30,10
1657740322979,MATH 10A,A03,083737,Patchell; Gregory David,16,0,30,14
1657740329009,MATH 10B,A01,083207,Lim; Seonhee,8,0,34,26
1657740329009,MATH 10B,A02,083208,Lim; Seonhee,9,0,35,26
1657740329009,MATH 10B,A03,093472,Lim; Seonhee,7,0,34,27
1657740329009,MATH 10B,B01,083739,Sinha; Shubham,13,0,30,17
1657740335040,MATH 18,A01,083743,Cinel; Cameron Alexander,9,0,30,21
1657740335040,MATH 18,A02,083744,Cinel; Cameron Alexander,17,0,30,13
1657740335040,MATH 18,A03,083745,Cinel; Cameron Alexander,10,0,30,20
1657740335040,MATH 18,B01,083748,Rideout; David Porter,5,0,37,32
1657740335040,MATH 18,B02,083749,Rideout; David Porter,5,0,36,31
1657740335040,MATH 18,B03,083750,Rideout; David Porter,3,0,37,34
1657740335040,MATH 18,B04,083751,Rideout; David Porter,6,0,36,30
1657740335040,MATH 18,B05,093473,Rideout; David Porter,6,0,36,30
1657740335040,MATH 18,B06,093474,Rideout; David Porter,6,0,36,30
1657740341062,MATH 20A,A01,083754,Zheng; Zequn,14,0,40,26
1657740347086,MATH 20B,A01,083756,Briones; Jor-el Thomas Caparas,4,0,36,32
1657740347086,MATH 20B,A02,083757,Briones; Jor-el Thomas Caparas,1,0,36,35
1657740347086,MATH 20B,A03,093475,Briones; Jor-el Thomas Caparas,2,0,36,34
1657740353108,MATH 20C,A01,083760,Briones; Jor-el Thomas Caparas,1,0,35,34
1657740353108,MATH 20C,A02,083761,Briones; Jor-el Thomas Caparas,8,0,35,27
1657740353108,MATH 20C,A03,093476,Briones; Jor-el Thomas Caparas,0,1,36,36
1657740353108,MATH 20C,B01,083762,Bach; Quang Tran,1,0,30,29
1657740359132,MATH 20D,A01,083765,Tran; Brian Kha,5,0,30,25
1657740359132,MATH 20D,A02,083766,Tran; Brian Kha,5,0,30,25
1657740359132,MATH 20D,A03,083767,Tran; Brian Kha,5,0,30,25
1657740365157,MATH 20E,A01,083771,Ganguly; Soumya,9,0,32,23
1657740365157,MATH 20E,A02,083772,Ganguly; Soumya,6,0,32,26
1657740365157,MATH 20E,B01,083773,Ciotti; Benjamin,20,0,35,15
1657740365157,MATH 20E,B02,083774,Ciotti; Benjamin,18,0,35,17
1657740371180,MATH 103A,A01,083777,Greenfeld; Be'Eri,3,0,36,33
1657740371180,MATH 103A,A02,083778,Greenfeld; Be'Eri,5,0,36,31
1657740371180,MATH 103A,A03,093561,Greenfeld; Be'Eri,6,0,36,30
1657740371180,MATH 103A,B01,083779,Greenfeld; Be'Eri,7,0,36,29
1657740371180,MATH 103A,B02,083780,Greenfeld; Be'Eri,4,0,36,32
1657740371180,MATH 103A,B03,093562,Greenfeld; Be'Eri,3,0,36,33
1657740377202,MATH 105,A01,085443,Carter; Anne Toulson,15,0,35,20
1657740377202,MATH 105,A02,093477,Carter; Anne Toulson,20,0,35,15
1657740383230,MATH 109,A01,083213,Ganzberger; Geoffrey Michael,2,0,34,32
1657740383230,MATH 109,A02,083214,Ganzberger; Geoffrey Michael,4,0,34,30
1657740383230,MATH 109,A03,093478,Ganzberger; Geoffrey Michael,2,0,34,32
1657740383230,MATH 109,B01,083215,Ganzberger; Geoffrey Michael,1,0,32,31
1657740383230,MATH 109,B02,083216,Ganzberger; Geoffrey Michael,2,0,32,30
1657740383230,MATH 109,B03,093479,Ganzberger; Geoffrey Michael,8,0,32,24
1657740389258,MATH 142A,A01,083219,Chow; Bennett,7,0,32,25
1657740389258,MATH 142A,A02,083220,Chow; Bennett,10,0,32,22
1657740389258,MATH 142A,A03,093480,Chow; Bennett,9,0,32,23
1657740389258,MATH 142A,B03,093481,Chow; Bennett,8,0,32,24
1657740389258,MATH 142A,B04,093558,Chow; Bennett,13,0,32,19
1657740389258,MATH 142A,B05,093559,Chow; Bennett,6,0,32,26
1657740395281,MATH 193A,A01,083224,Rotar; Vladimir,8,0,34,26
1657740395281,MATH 193A,A02,083225,Rotar; Vladimir,9,0,34,25
1657740395281,MATH 193A,A03,083781,Rotar; Vladimir,5,0,34,29
1657740395281,MATH 193A,A04,083782,Rotar; Vladimir,10,0,34,24
1657740395281,MATH 193A,A05,093482,Rotar; Vladimir,10,0,34,24
1657740401315,MATH 197,001,091859,McAuley; Julian John,9999,0,9999,0
1657740401315,MATH 197,002,095566,Kedlaya; Kiran S.,9997,0,9999,2
1657740401315,MATH 197,003,095567,Xiao; Ming,9999,0,9999,0
1657740401315,MATH 197,004,095571,Perols; Johan Lars,9998,0,9999,1
1657740408395,COGS 9,A01,083615,Shannon; Kyle Michael,9,0,75,66
1657740414418,COGS 11,A01,083617,Boyle; Mary E. T.,23,0,48,25
1657740420443,COGS 13,A01,083071,Bastos; Amalia Pinkusfeld,11,0,71,60
1657740426466,COGS 14A,A01,092681,Semenuks; Arturs,5,1,100,95
1657740432489,COGS 14B,A01,083073,Cheng; Tzu-Han,6,0,63,57
1657740438513,COGS 17,A01,092677,Semenuks; Arturs,6,0,81,75
1657740444539,COGS 100,A01,083619,Allen; Michael Gordon,17,0,70,53
1657740450561,COGS 101A,A01,083621,Davis; Joshua Daniel,9,0,68,59
1657740456592,COGS 101B,A01,091572,Allen; Michael Gordon,12,0,65,53
1657740462616,COGS 101C,A01,083625,Delgado; Tania,17,0,35,18
1657740468640,COGS 107A,A01,083627,Boyle; Mary E. T.,13,0,60,47
1657740474664,COGS 118A,A01,083075,Gupta; Anjum,21,0,76,55
1657740480689,CSE 3,A50,083646,Miranda; Gregory Joseph,24,0,50,26
1657740486722,CSE 8A,A50,083650,Miranda; Gregory Joseph,17,1,56,39
1657740492748,CSE 11,A01,083080,Cao; Yingjun,6,15,40,34
1657740498771,CSE 12,A01,083652,Krause-Levy; Sophia Louisa,28,1,120,92
1657740504800,CSE 15L,A01,083654,Morris; Justin Loren,9,0,50,41
1657740504800,CSE 15L,A02,083655,Morris; Justin Loren,9,0,50,41
1657740510824,CSE 20,A01,083657,Tran; Khoa Dang,39,0,80,41
1657740516846,CSE 21,A01,095574,Bach; Quang Tran,22,0,48,26
1657740522870,CSE 30,A01,083084,Eldon; John,6,0,80,74
1657740522870,CSE 30,B01,095061,Bhaskar; Nishant,9,0,50,41
1657740528892,CSE 100,A01,083659,Cao; Yingjun,5,4,70,65
1657740534920,CSE 134B,A01,083661,Powell; Thomas Allan,23,0,100,77
1657740540953,CSE 140,A01,083663,Gungor; Onat,15,0,85,70
1657740546979,CSE 140L,A01,083088,Eldon; John,23,0,100,77
1657740553003,CSE 175,A01,083665,Kumar; Rakesh,3,0,25,22
1657740559026,CSE 190,A00,092507,Dubnov; Shlomo,8,0,20,12
1657740565056,ECE 45,A01,083139,Congero; Spencer William,6,0,75,69
1657740571080,ECE 65,A50,083695,Saad; Andrew S,12,0,30,18
1657740571080,ECE 65,A51,095125,Saad; Andrew S,24,0,26,2
1657740577102,ECE 109,A01,091882,Touri; Behrouz,20,0,70,50
1657740583124,ECE 180,A00,083140,Abi Samra; Nicholas Camill,1,0,30,29
1657740583124,ECE 180,B00,083141,Abi Samra; Nicholas Camill,0,0,30,30
1657740589155,MATH 10A,A01,083735,Patchell; Gregory David,2,0,30,28
1657740589155,MATH 10A,A02,083736,Patchell; Gregory David,20,0,30,10
1657740589155,MATH 10A,A03,083737,Patchell; Gregory David,16,0,30,14
1657740595178,MATH 10B,A01,083207,Lim; Seonhee,8,0,34,26
1657740595178,MATH 10B,A02,083208,Lim; Seonhee,9,0,35,26
1657740595178,MATH 10B,A03,093472,Lim; Seonhee,7,0,34,27
1657740595178,MATH 10B,B01,083739,Sinha; Shubham,13,0,30,17
1657740601210,MATH 18,A01,083743,Cinel; Cameron Alexander,9,0,30,21
1657740601210,MATH 18,A02,083744,Cinel; Cameron Alexander,17,0,30,13
1657740601210,MATH 18,A03,083745,Cinel; Cameron Alexander,10,0,30,20
1657740601210,MATH 18,B01,083748,Rideout; David Porter,5,0,37,32
1657740601210,MATH 18,B02,083749,Rideout; David Porter,5,0,36,31
1657740601210,MATH 18,B03,083750,Rideout; David Porter,3,0,37,34
1657740601210,MATH 18,B04,083751,Rideout; David Porter,6,0,36,30
1657740601210,MATH 18,B05,093473,Rideout; David Porter,6,0,36,30
1657740601210,MATH 18,B06,093474,Rideout; David Porter,6,0,36,30
1657740607233,MATH 20A,A01,083754,Zheng; Zequn,14,0,40,26
1657740613260,MATH 20B,A01,083756,Briones; Jor-el Thomas Caparas,4,0,36,32
1657740613260,MATH 20B,A02,083757,Briones; Jor-el Thomas Caparas,1,0,36,35
1657740613260,MATH 20B,A03,093475,Briones; Jor-el Thomas Caparas,2,0,36,34
1657740619283,MATH 20C,A01,083760,Briones; Jor-el Thomas Caparas,1,0,35,34
1657740619283,MATH 20C,A02,083761,Briones; Jor-el Thomas Caparas,8,0,35,27
1657740619283,MATH 20C,A03,093476,Briones; Jor-el Thomas Caparas,0,1,36,36
1657740619283,MATH 20C,B01,083762,Bach; Quang Tran,1,0,30,29
1657740625311,MATH 20D,A01,083765,Tran; Brian Kha,5,0,30,25
1657740625311,MATH 20D,A02,083766,Tran; Brian Kha,5,0,30,25
1657740625311,MATH 20D,A03,083767,Tran; Brian Kha,5,0,30,25
1657740631334,MATH 20E,A01,083771,Ganguly; Soumya,9,0,32,23
1657740631334,MATH 20E,A02,083772,Ganguly; Soumya,6,0,32,26
1657740631334,MATH 20E,B01,083773,Ciotti; Benjamin,20,0,35,15
1657740631334,MATH 20E,B02,083774,Ciotti; Benjamin,18,0,35,17
1657740637366,MATH 103A,A01,083777,Greenfeld; Be'Eri,3,0,36,33
1657740637366,MATH 103A,A02,083778,Greenfeld; Be'Eri,5,0,36,31
1657740637366,MATH 103A,A03,093561,Greenfeld; Be'Eri,6,0,36,30
1657740637366,MATH 103A,B01,083779,Greenfeld; Be'Eri,7,0,36,29
1657740637366,MATH 103A,B02,083780,Greenfeld; Be'Eri,4,0,36,32
1657740637366,MATH 103A,B03,093562,Greenfeld; Be'Eri,3,0,36,33
1657740643390,MATH 105,A01,085443,Carter; Anne Toulson,15,0,35,20
1657740643390,MATH 105,A02,093477,Carter; Anne Toulson,20,0,35,15
1657740649413,MATH 109,A01,083213,Ganzberger; Geoffrey Michael,2,0,34,32
1657740649413,MATH 109,A02,083214,Ganzberger; Geoffrey Michael,4,0,34,30
1657740649413,MATH 109,A03,093478,Ganzberger; Geoffrey Michael,2,0,34,32
1657740649413,MATH 109,B01,083215,Ganzberger; Geoffrey Michael,1,0,32,31
1657740649413,MATH 109,B02,083216,Ganzberger; Geoffrey Michael,2,0,32,30
1657740649413,MATH 109,B03,093479,Ganzberger; Geoffrey Michael,8,0,32,24
1657740655443,MATH 142A,A01,083219,Chow; Bennett,7,0,32,25
1657740655443,MATH 142A,A02,083220,Chow; Bennett,10,0,32,22
1657740655443,MATH 142A,A03,093480,Chow; Bennett,9,0,32,23
1657740655443,MATH 142A,B03,093481,Chow; Bennett,8,0,32,24
1657740655443,MATH 142A,B04,093558,Chow; Bennett,13,0,32,19
1657740655443,MATH 142A,B05,093559,Chow; Bennett,6,0,32,26
1657740661472,MATH 193A,A01,083224,Rotar; Vladimir,8,0,34,26
1657740661472,MATH 193A,A02,083225,Rotar; Vladimir,9,0,34,25
1657740661472,MATH 193A,A03,083781,Rotar; Vladimir,5,0,34,29
1657740661472,MATH 193A,A04,083782,Rotar; Vladimir,10,0,34,24
1657740661472,MATH 193A,A05,093482,Rotar; Vladimir,10,0,34,24
1657740667498,MATH 197,001,091859,McAuley; Julian John,9999,0,9999,0
1657740667498,MATH 197,002,095566,Kedlaya; Kiran S.,9997,0,9999,2
1657740667498,MATH 197,003,095567,Xiao; Ming,9999,0,9999,0
1657740667498,MATH 197,004,095571,Perols; Johan Lars,9998,0,9999,1
1657740674556,COGS 9,A01,083615,Shannon; Kyle Michael,9,0,75,66
1657740680592,COGS 11,A01,083617,Boyle; Mary E. T.,23,0,48,25
1657740686626,COGS 13,A01,083071,Bastos; Amalia Pinkusfeld,11,0,71,60
1657740692654,COGS 14A,A01,092681,Semenuks; Arturs,5,1,100,95
1657740698677,COGS 14B,A01,083073,Cheng; Tzu-Han,6,0,63,57
1657740704701,COGS 17,A01,092677,Semenuks; Arturs,6,0,81,75
1657740710801,COGS 100,A01,083619,Allen; Michael Gordon,17,0,70,53
1657740716829,COGS 101A,A01,083621,Davis; Joshua Daniel,9,0,68,59
1657740722852,COGS 101B,A01,091572,Allen; Michael Gordon,12,0,65,53
1657740728880,COGS 101C,A01,083625,Delgado; Tania,17,0,35,18
1657740734903,COGS 107A,A01,083627,Boyle; Mary E. T.,13,0,60,47
1657740740927,COGS 118A,A01,083075,Gupta; Anjum,21,0,76,55
1657740746955,CSE 3,A50,083646,Miranda; Gregory Joseph,24,0,50,26
1657740752981,CSE 8A,A50,083650,Miranda; Gregory Joseph,17,1,56,39
1657740759005,CSE 11,A01,083080,Cao; Yingjun,6,15,40,34
1657740765033,CSE 12,A01,083652,Krause-Levy; Sophia Louisa,28,1,120,92
1657740771057,CSE 15L,A01,083654,Morris; Justin Loren,9,0,50,41
1657740771057,CSE 15L,A02,083655,Morris; Justin Loren,9,0,50,41
1657740777084,CSE 20,A01,083657,Tran; Khoa Dang,39,0,80,41
1657740783110,CSE 21,A01,095574,Bach; Quang Tran,22,0,48,26
1657740789137,CSE 30,A01,083084,Eldon; John,6,0,80,74
1657740789137,CSE 30,B01,095061,Bhaskar; Nishant,9,0,50,41
1657740795160,CSE 100,A01,083659,Cao; Yingjun,5,4,70,65
1657740801189,CSE 134B,A01,083661,Powell; Thomas Allan,23,0,100,77
1657740807218,CSE 140,A01,083663,Gungor; Onat,15,0,85,70
1657740813245,CSE 140L,A01,083088,Eldon; John,23,0,100,77
1657740819272,CSE 175,A01,083665,Kumar; Rakesh,3,0,25,22
1657740825299,CSE 190,A00,092507,Dubnov; Shlomo,8,0,20,12
1657740831323,ECE 45,A01,083139,Congero; Spencer William,6,0,75,69
1657740837349,ECE 65,A50,083695,Saad; Andrew S,12,0,30,18
1657740837349,ECE 65,A51,095125,Saad; Andrew S,24,0,26,2
1657740843402,ECE 109,A01,091882,Touri; Behrouz,20,0,70,50
1657740849436,ECE 180,A00,083140,Abi Samra; Nicholas Camill,1,0,30,29
1657740849436,ECE 180,B00,083141,Abi Samra; Nicholas Camill,0,0,30,30
1657740855462,MATH 10A,A01,083735,Patchell; Gregory David,2,0,30,28
1657740855462,MATH 10A,A02,083736,Patchell; Gregory David,20,0,30,10
1657740855462,MATH 10A,A03,083737,Patchell; Gregory David,16,0,30,14
1657740861499,MATH 10B,A01,083207,Lim; Seonhee,8,0,34,26
1657740861499,MATH 10B,A02,083208,Lim; Seonhee,9,0,35,26
1657740861499,MATH 10B,A03,093472,Lim; Seonhee,7,0,34,27
1657740861499,MATH 10B,B01,083739,Sinha; Shubham,13,0,30,17
1657740867522,MATH 18,A01,083743,Cinel; Cameron Alexander,9,0,30,21
1657740867522,MATH 18,A02,083744,Cinel; Cameron Alexander,17,0,30,13
1657740867522,MATH 18,A03,083745,Cinel; Cameron Alexander,10,0,30,20
1657740867522,MATH 18,B01,083748,Rideout; David Porter,5,0,37,32
1657740867522,MATH 18,B02,083749,Rideout; David Porter,5,0,36,31
1657740867522,MATH 18,B03,083750,Rideout; David Porter,3,0,37,34
1657740867522,MATH 18,B04,083751,Rideout; David Porter,6,0,36,30
1657740867522,MATH 18,B05,093473,Rideout; David Porter,6,0,36,30
1657740867522,MATH 18,B06,093474,Rideout; David Porter,6,0,36,30
1657740873544,MATH 20A,A01,083754,Zheng; Zequn,14,0,40,26
1657740879571,MATH 20B,A01,083756,Briones; Jor-el Thomas Caparas,4,0,36,32
1657740879571,MATH 20B,A02,083757,Briones; Jor-el Thomas Caparas,1,0,36,35
1657740879571,MATH 20B,A03,093475,Briones; Jor-el Thomas Caparas,2,0,36,34
1657740885597,MATH 20C,A01,083760,Briones; Jor-el Thomas Caparas,1,0,35,34
1657740885597,MATH 20C,A02,083761,Briones; Jor-el Thomas Caparas,8,0,35,27
1657740885597,MATH 20C,A03,093476,Briones; Jor-el Thomas Caparas,0,1,36,36
1657740885597,MATH 20C,B01,083762,Bach; Quang Tran,1,0,30,29
1657740891632,MATH 20D,A01,083765,Tran; Brian Kha,5,0,30,25
1657740891632,MATH 20D,A02,083766,Tran; Brian Kha,5,0,30,25
1657740891632,MATH 20D,A03,083767,Tran; Brian Kha,5,0,30,25
1657740897671,MATH 20E,A01,083771,Ganguly; Soumya,9,0,32,23
1657740897671,MATH 20E,A02,083772,Ganguly; Soumya,6,0,32,26
1657740897671,MATH 20E,B01,083773,Ciotti; Benjamin,20,0,35,15
1657740897671,MATH 20E,B02,083774,Ciotti; Benjamin,18,0,35,17
1657740903702,MATH 103A,A01,083777,Greenfeld; Be'Eri,3,0,36,33
1657740903702,MATH 103A,A02,083778,Greenfeld; Be'Eri,5,0,36,31
1657740903702,MATH 103A,A03,093561,Greenfeld; Be'Eri,6,0,36,30
1657740903702,MATH 103A,B01,083779,Greenfeld; Be'Eri,7,0,36,29
1657740903702,MATH 103A,B02,083780,Greenfeld; Be'Eri,4,0,36,32
1657740903702,MATH 103A,B03,093562,Greenfeld; Be'Eri,3,0,36,33
1657740909726,MATH 105,A01,085443,Carter; Anne Toulson,15,0,35,20
1657740909726,MATH 105,A02,093477,Carter; Anne Toulson,20,0,35,15
1657740915756,MATH 109,A01,083213,Ganzberger; Geoffrey Michael,2,0,34,32
1657740915756,MATH 109,A02,083214,Ganzberger; Geoffrey Michael,4,0,34,30
1657740915756,MATH 109,A03,093478,Ganzberger; Geoffrey Michael,2,0,34,32
1657740915756,MATH 109,B01,083215,Ganzberger; Geoffrey Michael,1,0,32,31
1657740915756,MATH 109,B02,083216,Ganzberger; Geoffrey Michael,2,0,32,30
1657740915756,MATH 109,B03,093479,Ganzberger; Geoffrey Michael,8,0,32,24
1657740921783,MATH 142A,A01,083219,Chow; Bennett,7,0,32,25
1657740921783,MATH 142A,A02,083220,Chow; Bennett,10,0,32,22
1657740921783,MATH 142A,A03,093480,Chow; Bennett,9,0,32,23
1657740921783,MATH 142A,B03,093481,Chow; Bennett,8,0,32,24
1657740921783,MATH 142A,B04,093558,Chow; Bennett,13,0,32,19
1657740921783,MATH 142A,B05,093559,Chow; Bennett,6,0,32,26
1657740927811,MATH 193A,A01,083224,Rotar; Vladimir,8,0,34,26
1657740927811,MATH 193A,A02,083225,Rotar; Vladimir,9,0,34,25
1657740927811,MATH 193A,A03,083781,Rotar; Vladimir,5,0,34,29
1657740927811,MATH 193A,A04,083782,Rotar; Vladimir,10,0,34,24
1657740927811,MATH 193A,A05,093482,Rotar; Vladimir,10,0,34,24
1657740933838,MATH 197,001,091859,McAuley; Julian John,9999,0,9999,0
1657740933838,MATH 197,002,095566,Kedlaya; Kiran S.,9997,0,9999,2
1657740933838,MATH 197,003,095567,Xiao; Ming,9999,0,9999,0
1657740933838,MATH 197,004,095571,Perols; Johan Lars,9998,0,9999,1
1657740940905,COGS 9,A01,083615,Shannon; Kyle Michael,9,0,75,66
1657740946938,COGS 11,A01,083617,Boyle; Mary E. T.,23,0,48,25
1657740952980,COGS 13,A01,083071,Bastos; Amalia Pinkusfeld,11,0,71,60
1657740959003,COGS 14A,A01,092681,Semenuks; Arturs,5,1,100,95
1657740965056,COGS 14B,A01,083073,Cheng; Tzu-Han,6,0,63,57
1657740971082,COGS 17,A01,092677,Semenuks; Arturs,6,0,81,75
1657740977109,COGS 100,A01,083619,Allen; Michael Gordon,17,0,70,53
1657740983133,COGS 101A,A01,083621,Davis; Joshua Daniel,9,0,68,59
1657740989160,COGS 101B,A01,091572,Allen; Michael Gordon,12,0,65,53
1657740995192,COGS 101C,A01,083625,Delgado; Tania,17,0,35,18
1657741001216,COGS 107A,A01,083627,Boyle; Mary E. T.,13,0,60,47
1657741007243,COGS 118A,A01,083075,Gupta; Anjum,21,0,76,55
1657741013268,CSE 3,A50,083646,Miranda; Gregory Joseph,24,0,50,26
1657741019292,CSE 8A,A50,083650,Miranda; Gregory Joseph,17,1,56,39
1657741025316,CSE 11,A01,083080,Cao; Yingjun,6,15,40,34
1657741031344,CSE 12,A01,083652,Krause-Levy; Sophia Louisa,28,1,120,92
1657741037371,CSE 15L,A01,083654,Morris; Justin Loren,9,0,50,41
1657741037371,CSE 15L,A02,083655,Morris; Justin Loren,9,0,50,41
1657741043395,CSE 20,A01,083657,Tran; Khoa Dang,39,0,80,41
1657741049419,CSE 21,A01,095574,Bach; Quang Tran,22,0,48,26
1657741055461,CSE 30,A01,083084,Eldon; John,6,0,80,74
1657741055461,CSE 30,B01,095061,Bhaskar; Nishant,9,0,50,41
1657741061491,CSE 100,A01,083659,Cao; Yingjun,5,4,70,65
1657741067514,CSE 134B,A01,083661,Powell; Thomas Allan,23,0,100,77
1657741073540,CSE 140,A01,083663,Gungor; Onat,15,0,85,70
1657741079563,CSE 140L,A01,083088,Eldon; John,23,0,100,77
1657741085586,CSE 175,A01,083665,Kumar; Rakesh,3,0,25,22
1657741091615,CSE 190,A00,092507,Dubnov; Shlomo,8,0,20,12
1657741097636,ECE 45,A01,083139,Congero; Spencer William,6,0,75,69
1657741103660,ECE 65,A50,083695,Saad; Andrew S,12,0,30,18
1657741103660,ECE 65,A51,095125,Saad; Andrew S,24,0,26,2
1657741109685,ECE 109,A01,091882,Touri; Behrouz,20,0,70,50
1657741115710,ECE 180,A00,083140,Abi Samra; Nicholas Camill,1,0,30,29
1657741115710,ECE 180,B00,083141,Abi Samra; Nicholas Camill,0,0,30,30
1657741121734,MATH 10A,A01,083735,Patchell; Gregory David,2,0,30,28
1657741121734,MATH 10A,A02,083736,Patchell; Gregory David,20,0,30,10
1657741121734,MATH 10A,A03,083737,Patchell; Gregory David,16,0,30,14
1657741127764,MATH 10B,A01,083207,Lim; Seonhee,8,0,34,26
1657741127764,MATH 10B,A02,083208,Lim; Seonhee,9,0,35,26
1657741127764,MATH 10B,A03,093472,Lim; Seonhee,7,0,34,27
1657741127764,MATH 10B,B01,083739,Sinha; Shubham,13,0,30,17
1657741133795,MATH 18,A01,083743,Cinel; Cameron Alexander,9,0,30,21
1657741133795,MATH 18,A02,083744,Cinel; Cameron Alexander,17,0,30,13
1657741133795,MATH 18,A03,083745,Cinel; Cameron Alexander,10,0,30,20
1657741133795,MATH 18,B01,083748,Rideout; David Porter,5,0,37,32
1657741133795,MATH 18,B02,083749,Rideout; David Porter,5,0,36,31
1657741133795,MATH 18,B03,083750,Rideout; David Porter,3,0,37,34
1657741133795,MATH 18,B04,083751,Rideout; David Porter,6,0,36,30
1657741133795,MATH 18,B05,093473,Rideout; David Porter,6,0,36,30
1657741133795,MATH 18,B06,093474,Rideout; David Porter,6,0,36,30
1657741139818,MATH 20A,A01,083754,Zheng; Zequn,14,0,40,26
1657741145842,MATH 20B,A01,083756,Briones; Jor-el Thomas Caparas,4,0,36,32
1657741145842,MATH 20B,A02,083757,Briones; Jor-el Thomas Caparas,1,0,36,35
1657741145842,MATH 20B,A03,093475,Briones; Jor-el Thomas Caparas,2,0,36,34
1657741151866,MATH 20C,A01,083760,Briones; Jor-el Thomas Caparas,1,0,35,34
1657741151866,MATH 20C,A02,083761,Briones; Jor-el Thomas Caparas,8,0,35,27
1657741151866,MATH 20C,A03,093476,Briones; Jor-el Thomas Caparas,0,1,36,36
1657741151866,MATH 20C,B01,083762,Bach; Quang Tran,1,0,30,29
1657741157889,MATH 20D,A01,083765,Tran; Brian Kha,5,0,30,25
1657741157889,MATH 20D,A02,083766,Tran; Brian Kha,5,0,30,25
1657741157889,MATH 20D,A03,083767,Tran; Brian Kha,5,0,30,25
1657741163916,MATH 20E,A01,083771,Ganguly; Soumya,9,0,32,23
1657741163916,MATH 20E,A02,083772,Ganguly; Soumya,6,0,32,26
1657741163916,MATH 20E,B01,083773,Ciotti; Benjamin,20,0,35,15
1657741163916,MATH 20E,B02,083774,Ciotti; Benjamin,18,0,35,17
1657741169953,MATH 103A,A01,083777,Greenfeld; Be'Eri,3,0,36,33
1657741169953,MATH 103A,A02,083778,Greenfeld; Be'Eri,5,0,36,31
1657741169953,MATH 103A,A03,093561,Greenfeld; Be'Eri,6,0,36,30
1657741169953,MATH 103A,B01,083779,Greenfeld; Be'Eri,7,0,36,29
1657741169953,MATH 103A,B02,083780,Greenfeld; Be'Eri,4,0,36,32
1657741169953,MATH 103A,B03,093562,Greenfeld; Be'Eri,3,0,36,33
1657741175981,MATH 105,A01,085443,Carter; Anne Toulson,15,0,35,20
1657741175981,MATH 105,A02,093477,Carter; Anne Toulson,20,0,35,15
1657741182011,MATH 109,A01,083213,Ganzberger; Geoffrey Michael,2,0,34,32
1657741182011,MATH 109,A02,083214,Ganzberger; Geoffrey Michael,4,0,34,30
1657741182011,MATH 109,A03,093478,Ganzberger; Geoffrey Michael,2,0,34,32
1657741182011,MATH 109,B01,083215,Ganzberger; Geoffrey Michael,1,0,32,31
1657741182011,MATH 109,B02,083216,Ganzberger; Geoffrey Michael,2,0,32,30
1657741182011,MATH 109,B03,093479,Ganzberger; Geoffrey Michael,8,0,32,24
1657741188040,MATH 142A,A01,083219,Chow; Bennett,7,0,32,25
1657741188040,MATH 142A,A02,083220,Chow; Bennett,10,0,32,22
1657741188040,MATH 142A,A03,093480,Chow; Bennett,9,0,32,23
1657741188040,MATH 142A,B03,093481,Chow; Bennett,8,0,32,24
1657741188040,MATH 142A,B04,093558,Chow; Bennett,13,0,32,19
1657741188040,MATH 142A,B05,093559,Chow; Bennett,6,0,32,26
1657741194069,MATH 193A,A01,083224,Rotar; Vladimir,8,0,34,26
1657741194069,MATH 193A,A02,083225,Rotar; Vladimir,9,0,34,25
1657741194069,MATH 193A,A03,083781,Rotar; Vladimir,5,0,34,29
1657741194069,MATH 193A,A04,083782,Rotar; Vladimir,10,0,34,24
1657741194069,MATH 193A,A05,093482,Rotar; Vladimir,10,0,34,24
1657741200096,MATH 197,001,091859,McAuley; Julian John,9999,0,9999,0
1657741200096,MATH 197,002,095566,Kedlaya; Kiran S.,9997,0,9999,2
1657741200096,MATH 197,003,095567,Xiao; Ming,9999,0,9999,0
1657741200096,MATH 197,004,095571,Perols; Johan Lars,9998,0,9999,1
1657741207163,COGS 9,A01,083615,Shannon; Kyle Michael,9,0,75,66
1657741213200,COGS 11,A01,083617,Boyle; Mary E. T.,23,0,48,25
1657741219226,COGS 13,A01,083071,Bastos; Amalia Pinkusfeld,11,0,71,60
1657741225256,COGS 14A,A01,092681,Semenuks; Arturs,5,1,100,95
1657741231290,COGS 14B,A01,083073,Cheng; Tzu-Han,6,0,63,57
1657741237321,COGS 17,A01,092677,Semenuks; Arturs,6,0,81,75
1657741243349,COGS 100,A01,083619,Allen; Michael Gordon,17,0,70,53
1657741249371,COGS 101A,A01,083621,Davis; Joshua Daniel,9,0,68,59
1657741255398,COGS 101B,A01,091572,Allen; Michael Gordon,12,0,65,53
1657741261428,COGS 101C,A01,083625,Delgado; Tania,17,0,35,18
1657741267461,COGS 107A,A01,083627,Boyle; Mary E. T.,13,0,60,47
1657741273490,COGS 118A,A01,083075,Gupta; Anjum,21,0,76,55
1657741279522,CSE 3,A50,083646,Miranda; Gregory Joseph,24,0,50,26
1657741285551,CSE 8A,A50,083650,Miranda; Gregory Joseph,17,1,56,39
1657741291582,CSE 11,A01,083080,Cao; Yingjun,6,15,40,34
1657741297609,CSE 12,A01,083652,Krause-Levy; Sophia Louisa,28,1,120,92
1657741303631,CSE 15L,A01,083654,Morris; Justin Loren,9,0,50,41
1657741303631,CSE 15L,A02,083655,Morris; Justin Loren,9,0,50,41
1657741309742,CSE 20,A01,083657,Tran; Khoa Dang,39,0,80,41
1657741315774,CSE 21,A01,095574,Bach; Quang Tran,22,0,48,26
1657741321806,CSE 30,A01,083084,Eldon; John,6,0,80,74
1657741321806,CSE 30,B01,095061,Bhaskar; Nishant,9,0,50,41
1657741327831,CSE 100,A01,083659,Cao; Yingjun,5,4,70,65
1657741333856,CSE 134B,A01,083661,Powell; Thomas Allan,23,0,100,77
1657741339882,CSE 140,A01,083663,Gungor; Onat,15,0,85,70
1657741345911,CSE 140L,A01,083088,Eldon; John,23,0,100,77
1657741351941,CSE 175,A01,083665,Kumar; Rakesh,3,0,25,22
1657741357974,CSE 190,A00,092507,Dubnov; Shlomo,8,0,20,12
1657741364000,ECE 45,A01,083139,Congero; Spencer William,6,0,75,69
1657741370024,ECE 65,A50,083695,Saad; Andrew S,12,0,30,18
1657741370024,ECE 65,A51,095125,Saad; Andrew S,24,0,26,2
1657741376048,ECE 109,A01,091882,Touri; Behrouz,20,0,70,50
1657741382072,ECE 180,A00,083140,Abi Samra; Nicholas Camill,1,0,30,29
1657741382072,ECE 180,B00,083141,Abi Samra; Nicholas Camill,0,0,30,30
1657741388098,MATH 10A,A01,083735,Patchell; Gregory David,2,0,30,28
1657741388098,MATH 10A,A02,083736,Patchell; Gregory David,20,0,30,10
1657741388098,MATH 10A,A03,083737,Patchell; Gregory David,16,0,30,14
1657741394121,MATH 10B,A01,083207,Lim; Seonhee,8,0,34,26
1657741394121,MATH 10B,A02,083208,Lim; Seonhee,9,0,35,26
1657741394121,MATH 10B,A03,093472,Lim; Seonhee,7,0,34,27
1657741394121,MATH 10B,B01,083739,Sinha; Shubham,13,0,30,17
1657741400153,MATH 18,A01,083743,Cinel; Cameron Alexander,9,0,30,21
1657741400153,MATH 18,A02,083744,Cinel; Cameron Alexander,18,0,30,12
1657741400153,MATH 18,A03,083745,Cinel; Cameron Alexander,10,0,30,20
1657741400153,MATH 18,B01,083748,Rideout; David Porter,5,0,37,32
1657741400153,MATH 18,B02,083749,Rideout; David Porter,5,0,36,31
1657741400153,MATH 18,B03,083750,Rideout; David Porter,3,0,37,34
1657741400153,MATH 18,B04,083751,Rideout; David Porter,6,0,36,30
1657741400153,MATH 18,B05,093473,Rideout; David Porter,6,0,36,30
1657741400153,MATH 18,B06,093474,Rideout; David Porter,6,0,36,30
1657741406180,MATH 20A,A01,083754,Zheng; Zequn,14,0,40,26
1657741412202,MATH 20B,A01,083756,Briones; Jor-el Thomas Caparas,4,0,36,32
1657741412202,MATH 20B,A02,083757,Briones; Jor-el Thomas Caparas,1,0,36,35
1657741412202,MATH 20B,A03,093475,Briones; Jor-el Thomas Caparas,2,0,36,34
1657741418225,MATH 20C,A01,083760,Briones; Jor-el Thomas Caparas,1,0,35,34
1657741418225,MATH 20C,A02,083761,Briones; Jor-el Thomas Caparas,8,0,35,27
1657741418225,MATH 20C,A03,093476,Briones; Jor-el Thomas Caparas,0,1,36,36
1657741418225,MATH 20C,B01,083762,Bach; Quang Tran,1,0,30,29
1657741424249,MATH 20D,A01,083765,Tran; Brian Kha,5,0,30,25
1657741424249,MATH 20D,A02,083766,Tran; Brian Kha,5,0,30,25
1657741424249,MATH 20D,A03,083767,Tran; Brian Kha,5,0,30,25
1657741430277,MATH 20E,A01,083771,Ganguly; Soumya,9,0,32,23
1657741430277,MATH 20E,A02,083772,Ganguly; Soumya,6,0,32,26
1657741430277,MATH 20E,B01,083773,Ciotti; Benjamin,20,0,35,15
1657741430277,MATH 20E,B02,083774,Ciotti; Benjamin,18,0,35,17
1657741436305,MATH 103A,A01,083777,Greenfeld; Be'Eri,3,0,36,33
1657741436305,MATH 103A,A02,083778,Greenfeld; Be'Eri,5,0,36,31
1657741436305,MATH 103A,A03,093561,Greenfeld; Be'Eri,6,0,36,30
1657741436305,MATH 103A,B01,083779,Greenfeld; Be'Eri,7,0,36,29
1657741436305,MATH 103A,B02,083780,Greenfeld; Be'Eri,4,0,36,32
1657741436305,MATH 103A,B03,093562,Greenfeld; Be'Eri,3,0,36,33
1657741442339,MATH 105,A01,085443,Carter; Anne Toulson,15,0,35,20
1657741442339,MATH 105,A02,093477,Carter; Anne Toulson,20,0,35,15
1657741448370,MATH 109,A01,083213,Ganzberger; Geoffrey Michael,2,0,34,32
1657741448370,MATH 109,A02,083214,Ganzberger; Geoffrey Michael,4,0,34,30
1657741448370,MATH 109,A03,093478,Ganzberger; Geoffrey Michael,2,0,34,32
1657741448370,MATH 109,B01,083215,Ganzberger; Geoffrey Michael,1,0,32,31
1657741448370,MATH 109,B02,083216,Ganzberger; Geoffrey Michael,2,0,32,30
1657741448370,MATH 109,B03,093479,Ganzberger; Geoffrey Michael,8,0,32,24
1657741454395,MATH 142A,A01,083219,Chow; Bennett,7,0,32,25
1657741454395,MATH 142A,A02,083220,Chow; Bennett,10,0,32,22
1657741454395,MATH 142A,A03,093480,Chow; Bennett,9,0,32,23
1657741454395,MATH 142A,B03,093481,Chow; Bennett,8,0,32,24
1657741454395,MATH 142A,B04,093558,Chow; Bennett,13,0,32,19
1657741454395,MATH 142A,B05,093559,Chow; Bennett,6,0,32,26
1657741460419,MATH 193A,A01,083224,Rotar; Vladimir,8,0,34,26
1657741460419,MATH 193A,A02,083225,Rotar; Vladimir,9,0,34,25
1657741460419,MATH 193A,A03,083781,Rotar; Vladimir,5,0,34,29
1657741460419,MATH 193A,A04,083782,Rotar; Vladimir,10,0,34,24
1657741460419,MATH 193A,A05,093482,Rotar; Vladimir,10,0,34,24
1657741466441,MATH 197,001,091859,McAuley; Julian John,9999,0,9999,0
1657741466441,MATH 197,002,095566,Kedlaya; Kiran S.,9997,0,9999,2
1657741466441,MATH 197,003,095567,Xiao; Ming,9999,0,9999,0
1657741466441,MATH 197,004,095571,Perols; Johan Lars,9998,0,9999,1
1657741473499,COGS 9,A01,083615,Shannon; Kyle Michael,9,0,75,66
1657741479522,COGS 11,A01,083617,Boyle; Mary E. T.,23,0,48,25
1657741485548,COGS 13,A01,083071,Bastos; Amalia Pinkusfeld,11,0,71,60
1657741491575,COGS 14A,A01,092681,Semenuks; Arturs,5,1,100,95
1657741497600,COGS 14B,A01,083073,Cheng; Tzu-Han,6,0,63,57
1657741503623,COGS 17,A01,092677,Semenuks; Arturs,6,0,81,75
1657741509646,COGS 100,A01,083619,Allen; Michael Gordon,17,0,70,53
1657741515671,COGS 101A,A01,083621,Davis; Joshua Daniel,9,0,68,59
1657741521694,COGS 101B,A01,091572,Allen; Michael Gordon,12,0,65,53
1657741527720,COGS 101C,A01,083625,Delgado; Tania,17,0,35,18
1657741533746,COGS 107A,A01,083627,Boyle; Mary E. T.,13,0,60,47
1657741539769,COGS 118A,A01,083075,Gupta; Anjum,21,0,76,55
1657741545797,CSE 3,A50,083646,Miranda; Gregory Joseph,24,0,50,26
1657741551824,CSE 8A,A50,083650,Miranda; Gregory Joseph,17,1,56,39
1657741557853,CSE 11,A01,083080,Cao; Yingjun,6,15,40,34
1657741563877,CSE 12,A01,083652,Krause-Levy; Sophia Louisa,28,1,120,92
1657741569899,CSE 15L,A01,083654,Morris; Justin Loren,9,0,50,41
1657741569899,CSE 15L,A02,083655,Morris; Justin Loren,9,0,50,41
1657741575925,CSE 20,A01,083657,Tran; Khoa Dang,39,0,80,41
1657741581950,CSE 21,A01,095574,Bach; Quang Tran,22,0,48,26
1657741587974,CSE 30,A01,083084,Eldon; John,6,0,80,74
1657741587974,CSE 30,B01,095061,Bhaskar; Nishant,9,0,50,41
1657741594001,CSE 100,A01,083659,Cao; Yingjun,5,4,70,65
1657741600025,CSE 134B,A01,083661,Powell; Thomas Allan,23,0,100,77
1657741606048,CSE 140,A01,083663,Gungor; Onat,15,0,85,70
1657741612075,CSE 140L,A01,083088,Eldon; John,23,0,100,77
1657741618101,CSE 175,A01,083665,Kumar; Rakesh,3,0,25,22
1657741624128,CSE 190,A00,092507,Dubnov; Shlomo,8,0,20,12
1657741630151,ECE 45,A01,083139,Congero; Spencer William,6,0,75,69
1657741636175,ECE 65,A50,083695,Saad; Andrew S,12,0,30,18
1657741636175,ECE 65,A51,095125,Saad; Andrew S,24,0,26,2
1657741642199,ECE 109,A01,091882,Touri; Behrouz,20,0,70,50
1657741648243,ECE 180,A00,083140,Abi Samra; Nicholas Camill,1,0,30,29
1657741648243,ECE 180,B00,083141,Abi Samra; Nicholas Camill,0,0,30,30
1657741654272,MATH 10A,A01,083735,Patchell; Gregory David,2,0,30,28
1657741654272,MATH 10A,A02,083736,Patchell; Gregory David,20,0,30,10
1657741654272,MATH 10A,A03,083737,Patchell; Gregory David,16,0,30,14
1657741660301,MATH 10B,A01,083207,Lim; Seonhee,8,0,34,26
1657741660301,MATH 10B,A02,083208,Lim; Seonhee,9,0,35,26
1657741660301,MATH 10B,A03,093472,Lim; Seonhee,7,0,34,27
1657741660301,MATH 10B,B01,083739,Sinha; Shubham,13,0,30,17
1657741666343,MATH 18,A01,083743,Cinel; Cameron Alexander,9,0,30,21
1657741666343,MATH 18,A02,083744,Cinel; Cameron Alexander,18,0,30,12
1657741666343,MATH 18,A03,083745,Cinel; Cameron Alexander,10,0,30,20
1657741666343,MATH 18,B01,083748,Rideout; David Porter,5,0,37,32
1657741666343,MATH 18,B02,083749,Rideout; David Porter,5,0,36,31
1657741666343,MATH 18,B03,083750,Rideout; David Porter,3,0,37,34
1657741666343,MATH 18,B04,083751,Rideout; David Porter,6,0,36,30
1657741666343,MATH 18,B05,093473,Rideout; David Porter,6,0,36,30
1657741666343,MATH 18,B06,093474,Rideout; David Porter,6,0,36,30
1657741672365,MATH 20A,A01,083754,Zheng; Zequn,14,0,40,26
1657741678389,MATH 20B,A01,083756,Briones; Jor-el Thomas Caparas,4,0,36,32
1657741678389,MATH 20B,A02,083757,Briones; Jor-el Thomas Caparas,1,0,36,35
1657741678389,MATH 20B,A03,093475,Briones; Jor-el Thomas Caparas,2,0,36,34
1657741684412,MATH 20C,A01,083760,Briones; Jor-el Thomas Caparas,1,0,35,34
1657741684412,MATH 20C,A02,083761,Briones; Jor-el Thomas Caparas,8,0,35,27
1657741684412,MATH 20C,A03,093476,Briones; Jor-el Thomas Caparas,0,1,36,36
1657741684412,MATH 20C,B01,083762,Bach; Quang Tran,1,0,30,29
1657741690442,MATH 20D,A01,083765,Tran; Brian Kha,5,0,30,25
1657741690442,MATH 20D,A02,083766,Tran; Brian Kha,5,0,30,25
1657741690442,MATH 20D,A03,083767,Tran; Brian Kha,5,0,30,25
1657741696479,MATH 20E,A01,083771,Ganguly; Soumya,9,0,32,23
1657741696479,MATH 20E,A02,083772,Ganguly; Soumya,6,0,32,26
1657741696479,MATH 20E,B01,083773,Ciotti; Benjamin,20,0,35,15
1657741696479,MATH 20E,B02,083774,Ciotti; Benjamin,18,0,35,17
1657741702503,MATH 103A,A01,083777,Greenfeld; Be'Eri,3,0,36,33
1657741702503,MATH 103A,A02,083778,Greenfeld; Be'Eri,5,0,36,31
1657741702503,MATH 103A,A03,093561,Greenfeld; Be'Eri,6,0,36,30
1657741702503,MATH 103A,B01,083779,Greenfeld; Be'Eri,7,0,36,29
1657741702503,MATH 103A,B02,083780,Greenfeld; Be'Eri,4,0,36,32
1657741702503,MATH 103A,B03,093562,Greenfeld; Be'Eri,3,0,36,33
1657741708526,MATH 105,A01,085443,Carter; Anne Toulson,15,0,35,20
1657741708526,MATH 105,A02,093477,Carter; Anne Toulson,20,0,35,15
1657741714552,MATH 109,A01,083213,Ganzberger; Geoffrey Michael,2,0,34,32
1657741714552,MATH 109,A02,083214,Ganzberger; Geoffrey Michael,4,0,34,30
1657741714552,MATH 109,A03,093478,Ganzberger; Geoffrey Michael,2,0,34,32
1657741714552,MATH 109,B01,083215,Ganzberger; Geoffrey Michael,1,0,32,31
1657741714552,MATH 109,B02,083216,Ganzberger; Geoffrey Michael,2,0,32,30
1657741714552,MATH 109,B03,093479,Ganzberger; Geoffrey Michael,8,0,32,24
1657741720581,MATH 142A,A01,083219,Chow; Bennett,7,0,32,25
1657741720581,MATH 142A,A02,083220,Chow; Bennett,10,0,32,22
1657741720581,MATH 142A,A03,093480,Chow; Bennett,9,0,32,23
1657741720581,MATH 142A,B03,093481,Chow; Bennett,8,0,32,24
1657741720581,MATH 142A,B04,093558,Chow; Bennett,13,0,32,19
1657741720581,MATH 142A,B05,093559,Chow; Bennett,6,0,32,26
1657741726605,MATH 193A,A01,083224,Rotar; Vladimir,8,0,34,26
1657741726605,MATH 193A,A02,083225,Rotar; Vladimir,9,0,34,25
1657741726605,MATH 193A,A03,083781,Rotar; Vladimir,5,0,34,29
1657741726605,MATH 193A,A04,083782,Rotar; Vladimir,10,0,34,24
1657741726605,MATH 193A,A05,093482,Rotar; Vladimir,10,0,34,24
1657741732628,MATH 197,001,091859,McAuley; Julian John,9999,0,9999,0
1657741732628,MATH 197,002,095566,Kedlaya; Kiran S.,9997,0,9999,2
1657741732628,MATH 197,003,095567,Xiao; Ming,9999,0,9999,0
1657741732628,MATH 197,004,095571,Perols; Johan Lars,9998,0,9999,1
1657741739705,COGS 9,A01,083615,Shannon; Kyle Michael,9,0,75,66
1657741745733,COGS 11,A01,083617,Boyle; Mary E. T.,23,0,48,25
1657741751760,COGS 13,A01,083071,Bastos; Amalia Pinkusfeld,11,0,71,60
1657741757790,COGS 14A,A01,092681,Semenuks; Arturs,5,1,100,95
1657741763813,COGS 14B,A01,083073,Cheng; Tzu-Han,6,0,63,57
1657741769840,COGS 17,A01,092677,Semenuks; Arturs,6,0,81,75
1657741775870,COGS 100,A01,083619,Allen; Michael Gordon,17,0,70,53
1657741781893,COGS 101A,A01,083621,Davis; Joshua Daniel,9,0,68,59
1657741787917,COGS 101B,A01,091572,Allen; Michael Gordon,12,0,65,53
1657741793942,COGS 101C,A01,083625,Delgado; Tania,17,0,35,18
1657741799965,COGS 107A,A01,083627,Boyle; Mary E. T.,13,0,60,47
1657741805995,COGS 118A,A01,083075,Gupta; Anjum,21,0,76,55
1657741812018,CSE 3,A50,083646,Miranda; Gregory Joseph,24,0,50,26
1657741818046,CSE 8A,A50,083650,Miranda; Gregory Joseph,17,1,56,39
1657741824072,CSE 11,A01,083080,Cao; Yingjun,6,15,40,34
1657741830098,CSE 12,A01,083652,Krause-Levy; Sophia Louisa,28,1,120,92
1657741836120,CSE 15L,A01,083654,Morris; Justin Loren,9,0,50,41
1657741836120,CSE 15L,A02,083655,Morris; Justin Loren,9,0,50,41
1657741842142,CSE 20,A01,083657,Tran; Khoa Dang,39,0,80,41
1657741848164,CSE 21,A01,095574,Bach; Quang Tran,22,0,48,26
1657741854190,CSE 30,A01,083084,Eldon; John,6,0,80,74
1657741854190,CSE 30,B01,095061,Bhaskar; Nishant,9,0,50,41
1657741860217,CSE 100,A01,083659,Cao; Yingjun,5,4,70,65
1657741866239,CSE 134B,A01,083661,Powell; Thomas Allan,23,0,100,77
1657741872266,CSE 140,A01,083663,Gungor; Onat,15,0,85,70
1657741878292,CSE 140L,A01,083088,Eldon; John,23,0,100,77
1657741884314,CSE 175,A01,083665,Kumar; Rakesh,3,0,25,22
1657741890347,CSE 190,A00,092507,Dubnov; Shlomo,8,0,20,12
1657741896394,ECE 45,A01,083139,Congero; Spencer William,6,0,75,69
1657741902421,ECE 65,A50,083695,Saad; Andrew S,12,0,30,18
1657741902421,ECE 65,A51,095125,Saad; Andrew S,24,0,26,2
1657741908516,ECE 109,A01,091882,Touri; Behrouz,20,0,70,50
1657741914538,ECE 180,A00,083140,Abi Samra; Nicholas Camill,1,0,30,29
1657741914538,ECE 180,B00,083141,Abi Samra; Nicholas Camill,0,0,30,30
1657741920566,MATH 10A,A01,083735,Patchell; Gregory David,2,0,30,28
1657741920566,MATH 10A,A02,083736,Patchell; Gregory David,20,0,30,10
1657741920566,MATH 10A,A03,083737,Patchell; Gregory David,16,0,30,14
1657741926597,MATH 10B,A01,083207,Lim; Seonhee,8,0,34,26
1657741926597,MATH 10B,A02,083208,Lim; Seonhee,9,0,35,26
1657741926597,MATH 10B,A03,093472,Lim; Seonhee,7,0,34,27
1657741926597,MATH 10B,B01,083739,Sinha; Shubham,13,0,30,17
1657741932622,MATH 18,A01,083743,Cinel; Cameron Alexander,9,0,30,21
1657741932622,MATH 18,A02,083744,Cinel; Cameron Alexander,18,0,30,12
1657741932622,MATH 18,A03,083745,Cinel; Cameron Alexander,10,0,30,20
1657741932622,MATH 18,B01,083748,Rideout; David Porter,5,0,37,32
1657741932622,MATH 18,B02,083749,Rideout; David Porter,5,0,36,31
1657741932622,MATH 18,B03,083750,Rideout; David Porter,3,0,37,34
1657741932622,MATH 18,B04,083751,Rideout; David Porter,6,0,36,30
1657741932622,MATH 18,B05,093473,Rideout; David Porter,6,0,36,30
1657741932622,MATH 18,B06,093474,Rideout; David Porter,6,0,36,30
1657741938656,MATH 20A,A01,083754,Zheng; Zequn,14,0,40,26
1657741944688,MATH 20B,A01,083756,Briones; Jor-el Thomas Caparas,4,0,36,32
1657741944688,MATH 20B,A02,083757,Briones; Jor-el Thomas Caparas,1,0,36,35
1657741944688,MATH 20B,A03,093475,Briones; Jor-el Thomas Caparas,2,0,36,34
1657741950712,MATH 20C,A01,083760,Briones; Jor-el Thomas Caparas,1,0,35,34
1657741950712,MATH 20C,A02,083761,Briones; Jor-el Thomas Caparas,8,0,35,27
1657741950712,MATH 20C,A03,093476,Briones; Jor-el Thomas Caparas,0,1,36,36
1657741950712,MATH 20C,B01,083762,Bach; Quang Tran,1,0,30,29
1657741956735,MATH 20D,A01,083765,Tran; Brian Kha,5,0,30,25
1657741956735,MATH 20D,A02,083766,Tran; Brian Kha,5,0,30,25
1657741956735,MATH 20D,A03,083767,Tran; Brian Kha,5,0,30,25
1657741962762,MATH 20E,A01,083771,Ganguly; Soumya,9,0,32,23
1657741962762,MATH 20E,A02,083772,Ganguly; Soumya,6,0,32,26
1657741962762,MATH 20E,B01,083773,Ciotti; Benjamin,20,0,35,15
1657741962762,MATH 20E,B02,083774,Ciotti; Benjamin,18,0,35,17
1657741968785,MATH 103A,A01,083777,Greenfeld; Be'Eri,3,0,36,33
1657741968785,MATH 103A,A02,083778,Greenfeld; Be'Eri,5,0,36,31
1657741968785,MATH 103A,A03,093561,Greenfeld; Be'Eri,6,0,36,30
1657741968785,MATH 103A,B01,083779,Greenfeld; Be'Eri,7,0,36,29
1657741968785,MATH 103A,B02,083780,Greenfeld; Be'Eri,4,0,36,32
1657741968785,MATH 103A,B03,093562,Greenfeld; Be'Eri,3,0,36,33
1657741974824,MATH 105,A01,085443,Carter; Anne Toulson,15,0,35,20
1657741974824,MATH 105,A02,093477,Carter; Anne Toulson,20,0,35,15
1657741980856,MATH 109,A01,083213,Ganzberger; Geoffrey Michael,2,0,34,32
1657741980856,MATH 109,A02,083214,Ganzberger; Geoffrey Michael,4,0,34,30
1657741980856,MATH 109,A03,093478,Ganzberger; Geoffrey Michael,2,0,34,32
1657741980856,MATH 109,B01,083215,Ganzberger; Geoffrey Michael,1,0,32,31
1657741980856,MATH 109,B02,083216,Ganzberger; Geoffrey Michael,2,0,32,30
1657741980856,MATH 109,B03,093479,Ganzberger; Geoffrey Michael,8,0,32,24
1657741986887,MATH 142A,A01,083219,Chow; Bennett,7,0,32,25
1657741986887,MATH 142A,A02,083220,Chow; Bennett,10,0,32,22
1657741986887,MATH 142A,A03,093480,Chow; Bennett,9,0,32,23
1657741986887,MATH 142A,B03,093481,Chow; Bennett,8,0,32,24
1657741986887,MATH 142A,B04,093558,Chow; Bennett,13,0,32,19
1657741986887,MATH 142A,B05,093559,Chow; Bennett,6,0,32,26
1657741992909,MATH 193A,A01,083224,Rotar; Vladimir,8,0,34,26
1657741992909,MATH 193A,A02,083225,Rotar; Vladimir,9,0,34,25
1657741992909,MATH 193A,A03,083781,Rotar; Vladimir,5,0,34,29
1657741992909,MATH 193A,A04,083782,Rotar; Vladimir,10,0,34,24
1657741992909,MATH 193A,A05,093482,Rotar; Vladimir,10,0,34,24
1657741998947,MATH 197,001,091859,McAuley; Julian John,9999,0,9999,0
1657741998947,MATH 197,002,095566,Kedlaya; Kiran S.,9997,0,9999,2
1657741998947,MATH 197,003,095567,Xiao; Ming,9999,0,9999,0
1657741998947,MATH 197,004,095571,Perols; Johan Lars,9998,0,9999,1
1657742006001,COGS 9,A01,083615,Shannon; Kyle Michael,9,0,75,66
1657742012029,COGS 11,A01,083617,Boyle; Mary E. T.,23,0,48,25
1657742018053,COGS 13,A01,083071,Bastos; Amalia Pinkusfeld,11,0,71,60
1657742024076,COGS 14A,A01,092681,Semenuks; Arturs,5,1,100,95
1657742030102,COGS 14B,A01,083073,Cheng; Tzu-Han,6,0,63,57
1657742036143,COGS 17,A01,092677,Semenuks; Arturs,6,0,81,75
1657742042168,COGS 100,A01,083619,Allen; Michael Gordon,17,0,70,53
1657742048192,COGS 101A,A01,083621,Davis; Joshua Daniel,9,0,68,59
1657742054215,COGS 101B,A01,091572,Allen; Michael Gordon,12,0,65,53
1657742060243,COGS 101C,A01,083625,Delgado; Tania,17,0,35,18
1657742066271,COGS 107A,A01,083627,Boyle; Mary E. T.,13,0,60,47
1657742072303,COGS 118A,A01,083075,Gupta; Anjum,21,0,76,55
1657742078327,CSE 3,A50,083646,Miranda; Gregory Joseph,24,0,50,26
1657742084351,CSE 8A,A50,083650,Miranda; Gregory Joseph,17,1,56,39
1657742090374,CSE 11,A01,083080,Cao; Yingjun,6,15,40,34
1657742096402,CSE 12,A01,083652,Krause-Levy; Sophia Louisa,28,1,120,92
1657742102426,CSE 15L,A01,083654,Morris; Justin Loren,9,0,50,41
1657742102426,CSE 15L,A02,083655,Morris; Justin Loren,9,0,50,41
1657742108452,CSE 20,A01,083657,Tran; Khoa Dang,39,0,80,41
1657742114483,CSE 21,A01,095574,Bach; Quang Tran,22,0,48,26
1657742120513,CSE 30,A01,083084,Eldon; John,6,0,80,74
1657742120513,CSE 30,B01,095061,Bhaskar; Nishant,9,0,50,41
1657742126534,CSE 100,A01,083659,Cao; Yingjun,5,4,70,65
1657742132557,CSE 134B,A01,083661,Powell; Thomas Allan,23,0,100,77
1657742138586,CSE 140,A01,083663,Gungor; Onat,15,0,85,70
1657742144617,CSE 140L,A01,083088,Eldon; John,23,0,100,77
1657742150639,CSE 175,A01,083665,Kumar; Rakesh,3,0,25,22
1657742156665,CSE 190,A00,092507,Dubnov; Shlomo,8,0,20,12
1657742162696,ECE 45,A01,083139,Congero; Spencer William,6,0,75,69
1657742168734,ECE 65,A50,083695,Saad; Andrew S,12,0,30,18
1657742168734,ECE 65,A51,095125,Saad; Andrew S,24,0,26,2
1657742174760,ECE 109,A01,091882,Touri; Behrouz,20,0,70,50
1657742180782,ECE 180,A00,083140,Abi Samra; Nicholas Camill,1,0,30,29
1657742180782,ECE 180,B00,083141,Abi Samra; Nicholas Camill,0,0,30,30
1657742186804,MATH 10A,A01,083735,Patchell; Gregory David,2,0,30,28
1657742186804,MATH 10A,A02,083736,Patchell; Gregory David,20,0,30,10
1657742186804,MATH 10A,A03,083737,Patchell; Gregory David,16,0,30,14
1657742192833,MATH 10B,A01,083207,Lim; Seonhee,8,0,34,26
1657742192833,MATH 10B,A02,083208,Lim; Seonhee,9,0,35,26
1657742192833,MATH 10B,A03,093472,Lim; Seonhee,7,0,34,27
1657742192833,MATH 10B,B01,083739,Sinha; Shubham,13,0,30,17
1657742198856,MATH 18,A01,083743,Cinel; Cameron Alexander,9,0,30,21
1657742198856,MATH 18,A02,083744,Cinel; Cameron Alexander,18,0,30,12
1657742198856,MATH 18,A03,083745,Cinel; Cameron Alexander,10,0,30,20
1657742198856,MATH 18,B01,083748,Rideout; David Porter,5,0,37,32
1657742198856,MATH 18,B02,083749,Rideout; David Porter,5,0,36,31
1657742198856,MATH 18,B03,083750,Rideout; David Porter,3,0,37,34
1657742198856,MATH 18,B04,083751,Rideout; David Porter,6,0,36,30
1657742198856,MATH 18,B05,093473,Rideout; David Porter,6,0,36,30
1657742198856,MATH 18,B06,093474,Rideout; David Porter,6,0,36,30
1657742204883,MATH 20A,A01,083754,Zheng; Zequn,14,0,40,26
1657742210910,MATH 20B,A01,083756,Briones; Jor-el Thomas Caparas,4,0,36,32
1657742210910,MATH 20B,A02,083757,Briones; Jor-el Thomas Caparas,1,0,36,35
1657742210910,MATH 20B,A03,093475,Briones; Jor-el Thomas Caparas,2,0,36,34
1657742216934,MATH 20C,A01,083760,Briones; Jor-el Thomas Caparas,1,0,35,34
1657742216934,MATH 20C,A02,083761,Briones; Jor-el Thomas Caparas,8,0,35,27
1657742216934,MATH 20C,A03,093476,Briones; Jor-el Thomas Caparas,0,1,36,36
1657742216934,MATH 20C,B01,083762,Bach; Quang Tran,1,0,30,29
1657742222957,MATH 20D,A01,083765,Tran; Brian Kha,5,0,30,25
1657742222957,MATH 20D,A02,083766,Tran; Brian Kha,5,0,30,25
1657742222957,MATH 20D,A03,083767,Tran; Brian Kha,5,0,30,25
1657742228992,MATH 20E,A01,083771,Ganguly; Soumya,9,0,32,23
1657742228992,MATH 20E,A02,083772,Ganguly; Soumya,6,0,32,26
1657742228992,MATH 20E,B01,083773,Ciotti; Benjamin,20,0,35,15
1657742228992,MATH 20E,B02,083774,Ciotti; Benjamin,18,0,35,17
1657742235018,MATH 103A,A01,083777,Greenfeld; Be'Eri,3,0,36,33
1657742235018,MATH 103A,A02,083778,Greenfeld; Be'Eri,5,0,36,31
1657742235018,MATH 103A,A03,093561,Greenfeld; Be'Eri,6,0,36,30
1657742235018,MATH 103A,B01,083779,Greenfeld; Be'Eri,7,0,36,29
1657742235018,MATH 103A,B02,083780,Greenfeld; Be'Eri,4,0,36,32
1657742235018,MATH 103A,B03,093562,Greenfeld; Be'Eri,3,0,36,33
1657742241046,MATH 105,A01,085443,Carter; Anne Toulson,15,0,35,20
1657742241046,MATH 105,A02,093477,Carter; Anne Toulson,20,0,35,15
1657742247070,MATH 109,A01,083213,Ganzberger; Geoffrey Michael,3,0,34,31
1657742247070,MATH 109,A02,083214,Ganzberger; Geoffrey Michael,4,0,34,30
1657742247070,MATH 109,A03,093478,Ganzberger; Geoffrey Michael,2,0,34,32
1657742247070,MATH 109,B01,083215,Ganzberger; Geoffrey Michael,1,0,32,31
1657742247070,MATH 109,B02,083216,Ganzberger; Geoffrey Michael,2,0,32,30
1657742247070,MATH 109,B03,093479,Ganzberger; Geoffrey Michael,8,0,32,24
1657742253094,MATH 142A,A01,083219,Chow; Bennett,7,0,32,25
1657742253094,MATH 142A,A02,083220,Chow; Bennett,10,0,32,22
1657742253094,MATH 142A,A03,093480,Chow; Bennett,9,0,32,23
1657742253094,MATH 142A,B03,093481,Chow; Bennett,8,0,32,24
1657742253094,MATH 142A,B04,093558,Chow; Bennett,13,0,32,19
1657742253094,MATH 142A,B05,093559,Chow; Bennett,6,0,32,26
1657742259122,MATH 193A,A01,083224,Rotar; Vladimir,8,0,34,26
1657742259122,MATH 193A,A02,083225,Rotar; Vladimir,9,0,34,25
1657742259122,MATH 193A,A03,083781,Rotar; Vladimir,5,0,34,29
1657742259122,MATH 193A,A04,083782,Rotar; Vladimir,10,0,34,24
1657742259122,MATH 193A,A05,093482,Rotar; Vladimir,10,0,34,24
1657742265153,MATH 197,001,091859,McAuley; Julian John,9999,0,9999,0
1657742265153,MATH 197,002,095566,Kedlaya; Kiran S.,9997,0,9999,2
1657742265153,MATH 197,003,095567,Xiao; Ming,9999,0,9999,0
1657742265153,MATH 197,004,095571,Perols; Johan Lars,9998,0,9999,1
1657742272210,COGS 9,A01,083615,Shannon; Kyle Michael,9,0,75,66
1657742278236,COGS 11,A01,083617,Boyle; Mary E. T.,23,0,48,25
1657742284264,COGS 13,A01,083071,Bastos; Amalia Pinkusfeld,11,0,71,60
1657742290286,COGS 14A,A01,092681,Semenuks; Arturs,5,1,100,95
1657742296311,COGS 14B,A01,083073,Cheng; Tzu-Han,6,0,63,57
1657742302333,COGS 17,A01,092677,Semenuks; Arturs,6,0,81,75
1657742308364,COGS 100,A01,083619,Allen; Michael Gordon,17,0,70,53
1657742314396,COGS 101A,A01,083621,Davis; Joshua Daniel,9,0,68,59
1657742320421,COGS 101B,A01,091572,Allen; Michael Gordon,12,0,65,53
1657742326452,COGS 101C,A01,083625,Delgado; Tania,17,0,35,18
1657742332477,COGS 107A,A01,083627,Boyle; Mary E. T.,13,0,60,47
1657742338499,COGS 118A,A01,083075,Gupta; Anjum,21,0,76,55
1657742344534,CSE 3,A50,083646,Miranda; Gregory Joseph,24,0,50,26
1657742350558,CSE 8A,A50,083650,Miranda; Gregory Joseph,17,1,56,39
1657742356585,CSE 11,A01,083080,Cao; Yingjun,6,15,40,34
1657742362612,CSE 12,A01,083652,Krause-Levy; Sophia Louisa,28,1,120,92
1657742368638,CSE 15L,A01,083654,Morris; Justin Loren,9,0,50,41
1657742368638,CSE 15L,A02,083655,Morris; Justin Loren,9,0,50,41
1657742374664,CSE 20,A01,083657,Tran; Khoa Dang,39,0,80,41
1657742380689,CSE 21,A01,095574,Bach; Quang Tran,22,0,48,26
1657742386713,CSE 30,A01,083084,Eldon; John,6,0,80,74
1657742386713,CSE 30,B01,095061,Bhaskar; Nishant,9,0,50,41
1657742392735,CSE 100,A01,083659,Cao; Yingjun,5,4,70,65
1657742398760,CSE 134B,A01,083661,Powell; Thomas Allan,23,0,100,77
1657742404784,CSE 140,A01,083663,Gungor; Onat,15,0,85,70
1657742410814,CSE 140L,A01,083088,Eldon; John,23,0,100,77
1657742416837,CSE 175,A01,083665,Kumar; Rakesh,3,0,25,22
1657742422864,CSE 190,A00,092507,Dubnov; Shlomo,8,0,20,12
1657742428889,ECE 45,A01,083139,Congero; Spencer William,6,0,75,69
1657742434915,ECE 65,A50,083695,Saad; Andrew S,12,0,30,18
1657742434915,ECE 65,A51,095125,Saad; Andrew S,24,0,26,2
1657742440938,ECE 109,A01,091882,Touri; Behrouz,20,0,70,50
1657742446963,ECE 180,A00,083140,Abi Samra; Nicholas Camill,1,0,30,29
1657742446963,ECE 180,B00,083141,Abi Samra; Nicholas Camill,0,0,30,30
1657742452991,MATH 10A,A01,083735,Patchell; Gregory David,2,0,30,28
1657742452991,MATH 10A,A02,083736,Patchell; Gregory David,20,0,30,10
1657742452991,MATH 10A,A03,083737,Patchell; Gregory David,16,0,30,14
1657742459014,MATH 10B,A01,083207,Lim; Seonhee,8,0,34,26
1657742459014,MATH 10B,A02,083208,Lim; Seonhee,9,0,35,26
1657742459014,MATH 10B,A03,093472,Lim; Seonhee,7,0,34,27
1657742459014,MATH 10B,B01,083739,Sinha; Shubham,13,0,30,17
1657742465038,MATH 18,A01,083743,Cinel; Cameron Alexander,9,0,30,21
1657742465038,MATH 18,A02,083744,Cinel; Cameron Alexander,18,0,30,12
1657742465038,MATH 18,A03,083745,Cinel; Cameron Alexander,10,0,30,20
1657742465038,MATH 18,B01,083748,Rideout; David Porter,5,0,37,32
1657742465038,MATH 18,B02,083749,Rideout; David Porter,5,0,36,31
1657742465038,MATH 18,B03,083750,Rideout; David Porter,3,0,37,34
1657742465038,MATH 18,B04,083751,Rideout; David Porter,6,0,36,30
1657742465038,MATH 18,B05,093473,Rideout; David Porter,6,0,36,30
1657742465038,MATH 18,B06,093474,Rideout; David Porter,6,0,36,30
1657742471065,MATH 20A,A01,083754,Zheng; Zequn,14,0,40,26
1657742477089,MATH 20B,A01,083756,Briones; Jor-el Thomas Caparas,4,0,36,32
1657742477089,MATH 20B,A02,083757,Briones; Jor-el Thomas Caparas,1,0,36,35
1657742477089,MATH 20B,A03,093475,Briones; Jor-el Thomas Caparas,2,0,36,34
1657742483111,MATH 20C,A01,083760,Briones; Jor-el Thomas Caparas,1,0,35,34
1657742483111,MATH 20C,A02,083761,Briones; Jor-el Thomas Caparas,8,0,35,27
1657742483111,MATH 20C,A03,093476,Briones; Jor-el Thomas Caparas,0,1,36,36
1657742483111,MATH 20C,B01,083762,Bach; Quang Tran,1,0,30,29
1657742489133,MATH 20D,A01,083765,Tran; Brian Kha,5,0,30,25
1657742489133,MATH 20D,A02,083766,Tran; Brian Kha,5,0,30,25
1657742489133,MATH 20D,A03,083767,Tran; Brian Kha,5,0,30,25
1657742495160,MATH 20E,A01,083771,Ganguly; Soumya,9,0,32,23
1657742495160,MATH 20E,A02,083772,Ganguly; Soumya,6,0,32,26
1657742495160,MATH 20E,B01,083773,Ciotti; Benjamin,20,0,35,15
1657742495160,MATH 20E,B02,083774,Ciotti; Benjamin,18,0,35,17
1657742501189,MATH 103A,A01,083777,Greenfeld; Be'Eri,3,0,36,33
1657742501189,MATH 103A,A02,083778,Greenfeld; Be'Eri,5,0,36,31
1657742501189,MATH 103A,A03,093561,Greenfeld; Be'Eri,6,0,36,30
1657742501189,MATH 103A,B01,083779,Greenfeld; Be'Eri,7,0,36,29
1657742501189,MATH 103A,B02,083780,Greenfeld; Be'Eri,4,0,36,32
1657742501189,MATH 103A,B03,093562,Greenfeld; Be'Eri,3,0,36,33
1657742507287,MATH 105,A01,085443,Carter; Anne Toulson,15,0,35,20
1657742507287,MATH 105,A02,093477,Carter; Anne Toulson,20,0,35,15
1657742513312,MATH 109,A01,083213,Ganzberger; Geoffrey Michael,3,0,34,31
1657742513312,MATH 109,A02,083214,Ganzberger; Geoffrey Michael,4,0,34,30
1657742513312,MATH 109,A03,093478,Ganzberger; Geoffrey Michael,2,0,34,32
1657742513312,MATH 109,B01,083215,Ganzberger; Geoffrey Michael,1,0,32,31
1657742513312,MATH 109,B02,083216,Ganzberger; Geoffrey Michael,2,0,32,30
1657742513312,MATH 109,B03,093479,Ganzberger; Geoffrey Michael,8,0,32,24
1657742519335,MATH 142A,A01,083219,Chow; Bennett,7,0,32,25
1657742519335,MATH 142A,A02,083220,Chow; Bennett,10,0,32,22
1657742519335,MATH 142A,A03,093480,Chow; Bennett,9,0,32,23
1657742519335,MATH 142A,B03,093481,Chow; Bennett,8,0,32,24
1657742519335,MATH 142A,B04,093558,Chow; Bennett,13,0,32,19
1657742519335,MATH 142A,B05,093559,Chow; Bennett,6,0,32,26
1657742525364,MATH 193A,A01,083224,Rotar; Vladimir,8,0,34,26
1657742525364,MATH 193A,A02,083225,Rotar; Vladimir,9,0,34,25
1657742525364,MATH 193A,A03,083781,Rotar; Vladimir,5,0,34,29
1657742525364,MATH 193A,A04,083782,Rotar; Vladimir,10,0,34,24
1657742525364,MATH 193A,A05,093482,Rotar; Vladimir,10,0,34,24
1657742531387,MATH 197,001,091859,McAuley; Julian John,9999,0,9999,0
1657742531387,MATH 197,002,095566,Kedlaya; Kiran S.,9997,0,9999,2
1657742531387,MATH 197,003,095567,Xiao; Ming,9999,0,9999,0
1657742531387,MATH 197,004,095571,Perols; Johan Lars,9998,0,9999,1
1657742538455,COGS 9,A01,083615,Shannon; Kyle Michael,9,0,75,66
1657742544480,COGS 11,A01,083617,Boyle; Mary E. T.,23,0,48,25
1657742550503,COGS 13,A01,083071,Bastos; Amalia Pinkusfeld,11,0,71,60
1657742556528,COGS 14A,A01,092681,Semenuks; Arturs,5,1,100,95
1657742562555,COGS 14B,A01,083073,Cheng; Tzu-Han,6,0,63,57
1657742568582,COGS 17,A01,092677,Semenuks; Arturs,6,0,81,75
1657742574607,COGS 100,A01,083619,Allen; Michael Gordon,17,0,70,53
1657742580632,COGS 101A,A01,083621,Davis; Joshua Daniel,9,0,68,59
1657742586681,COGS 101B,A01,091572,Allen; Michael Gordon,12,0,65,53
1657742592704,COGS 101C,A01,083625,Delgado; Tania,17,0,35,18
1657742598726,COGS 107A,A01,083627,Boyle; Mary E. T.,13,0,60,47
1657742604747,COGS 118A,A01,083075,Gupta; Anjum,21,0,76,55
1657742610774,CSE 3,A50,083646,Miranda; Gregory Joseph,24,0,50,26
1657742616802,CSE 8A,A50,083650,Miranda; Gregory Joseph,17,1,56,39
1657742622825,CSE 11,A01,083080,Cao; Yingjun,6,15,40,34
1657742628850,CSE 12,A01,083652,Krause-Levy; Sophia Louisa,28,1,120,92
1657742634877,CSE 15L,A01,083654,Morris; Justin Loren,9,0,50,41
1657742634877,CSE 15L,A02,083655,Morris; Justin Loren,9,0,50,41
1657742640900,CSE 20,A01,083657,Tran; Khoa Dang,39,0,80,41
1657742646921,CSE 21,A01,095574,Bach; Quang Tran,22,0,48,26
1657742652948,CSE 30,A01,083084,Eldon; John,6,0,80,74
1657742652948,CSE 30,B01,095061,Bhaskar; Nishant,9,0,50,41
1657742658971,CSE 100,A01,083659,Cao; Yingjun,5,4,70,65
1657742664997,CSE 134B,A01,083661,Powell; Thomas Allan,23,0,100,77
1657742671020,CSE 140,A01,083663,Gungor; Onat,15,0,85,70
1657742677043,CSE 140L,A01,083088,Eldon; John,23,0,100,77
1657742683066,CSE 175,A01,083665,Kumar; Rakesh,3,0,25,22
1657742689089,CSE 190,A00,092507,Dubnov; Shlomo,8,0,20,12
1657742695117,ECE 45,A01,083139,Congero; Spencer William,6,0,75,69
1657742701143,ECE 65,A50,083695,Saad; Andrew S,12,0,30,18
1657742701143,ECE 65,A51,095125,Saad; Andrew S,24,0,26,2
1657742707166,ECE 109,A01,091882,Touri; Behrouz,20,0,70,50
1657742713192,ECE 180,A00,083140,Abi Samra; Nicholas Camill,1,0,30,29
1657742713192,ECE 180,B00,083141,Abi Samra; Nicholas Camill,0,0,30,30
1657742719219,MATH 10A,A01,083735,Patchell; Gregory David,2,0,30,28
1657742719219,MATH 10A,A02,083736,Patchell; Gregory David,20,0,30,10
1657742719219,MATH 10A,A03,083737,Patchell; Gregory David,16,0,30,14
1657742725242,MATH 10B,A01,083207,Lim; Seonhee,8,0,34,26
1657742725242,MATH 10B,A02,083208,Lim; Seonhee,9,0,35,26
1657742725242,MATH 10B,A03,093472,Lim; Seonhee,7,0,34,27
1657742725242,MATH 10B,B01,083739,Sinha; Shubham,13,0,30,17
1657742731265,MATH 18,A01,083743,Cinel; Cameron Alexander,9,0,30,21
1657742731265,MATH 18,A02,083744,Cinel; Cameron Alexander,18,0,30,12
1657742731265,MATH 18,A03,083745,Cinel; Cameron Alexander,10,0,30,20
1657742731265,MATH 18,B01,083748,Rideout; David Porter,5,0,37,32
1657742731265,MATH 18,B02,083749,Rideout; David Porter,5,0,36,31
1657742731265,MATH 18,B03,083750,Rideout; David Porter,3,0,37,34
1657742731265,MATH 18,B04,083751,Rideout; David Porter,6,0,36,30
1657742731265,MATH 18,B05,093473,Rideout; David Porter,6,0,36,30
1657742731265,MATH 18,B06,093474,Rideout; David Porter,6,0,36,30
1657742737288,MATH 20A,A01,083754,Zheng; Zequn,14,0,40,26
1657742743316,MATH 20B,A01,083756,Briones; Jor-el Thomas Caparas,4,0,36,32
1657742743316,MATH 20B,A02,083757,Briones; Jor-el Thomas Caparas,1,0,36,35
1657742743316,MATH 20B,A03,093475,Briones; Jor-el Thomas Caparas,2,0,36,34
1657742749345,MATH 20C,A01,083760,Briones; Jor-el Thomas Caparas,1,0,35,34
1657742749345,MATH 20C,A02,083761,Briones; Jor-el Thomas Caparas,8,0,35,27
1657742749345,MATH 20C,A03,093476,Briones; Jor-el Thomas Caparas,0,1,36,36
1657742749345,MATH 20C,B01,083762,Bach; Quang Tran,1,0,30,29
1657742755370,MATH 20D,A01,083765,Tran; Brian Kha,5,0,30,25
1657742755370,MATH 20D,A02,083766,Tran; Brian Kha,5,0,30,25
1657742755370,MATH 20D,A03,083767,Tran; Brian Kha,5,0,30,25
1657742761398,MATH 20E,A01,083771,Ganguly; Soumya,9,0,32,23
1657742761398,MATH 20E,A02,083772,Ganguly; Soumya,6,0,32,26
1657742761398,MATH 20E,B01,083773,Ciotti; Benjamin,20,0,35,15
1657742761398,MATH 20E,B02,083774,Ciotti; Benjamin,18,0,35,17
1657742767427,MATH 103A,A01,083777,Greenfeld; Be'Eri,3,0,36,33
1657742767427,MATH 103A,A02,083778,Greenfeld; Be'Eri,5,0,36,31
1657742767427,MATH 103A,A03,093561,Greenfeld; Be'Eri,6,0,36,30
1657742767427,MATH 103A,B01,083779,Greenfeld; Be'Eri,7,0,36,29
1657742767427,MATH 103A,B02,083780,Greenfeld; Be'Eri,4,0,36,32
1657742767427,MATH 103A,B03,093562,Greenfeld; Be'Eri,3,0,36,33
1657742773467,MATH 105,A01,085443,Carter; Anne Toulson,15,0,35,20
1657742773467,MATH 105,A02,093477,Carter; Anne Toulson,20,0,35,15
1657742779489,MATH 109,A01,083213,Ganzberger; Geoffrey Michael,3,0,34,31
1657742779489,MATH 109,A02,083214,Ganzberger; Geoffrey Michael,4,0,34,30
1657742779489,MATH 109,A03,093478,Ganzberger; Geoffrey Michael,2,0,34,32
1657742779489,MATH 109,B01,083215,Ganzberger; Geoffrey Michael,1,0,32,31
1657742779489,MATH 109,B02,083216,Ganzberger; Geoffrey Michael,2,0,32,30
1657742779489,MATH 109,B03,093479,Ganzberger; Geoffrey Michael,8,0,32,24
1657742785518,MATH 142A,A01,083219,Chow; Bennett,7,0,32,25
1657742785518,MATH 142A,A02,083220,Chow; Bennett,10,0,32,22
1657742785518,MATH 142A,A03,093480,Chow; Bennett,9,0,32,23
1657742785518,MATH 142A,B03,093481,Chow; Bennett,8,0,32,24
1657742785518,MATH 142A,B04,093558,Chow; Bennett,13,0,32,19
1657742785518,MATH 142A,B05,093559,Chow; Bennett,6,0,32,26
1657742791542,MATH 193A,A01,083224,Rotar; Vladimir,8,0,34,26
1657742791542,MATH 193A,A02,083225,Rotar; Vladimir,9,0,34,25
1657742791542,MATH 193A,A03,083781,Rotar; Vladimir,5,0,34,29
1657742791542,MATH 193A,A04,083782,Rotar; Vladimir,10,0,34,24
1657742791542,MATH 193A,A05,093482,Rotar; Vladimir,10,0,34,24
1657742797569,MATH 197,001,091859,McAuley; Julian John,9999,0,9999,0
1657742797569,MATH 197,002,095566,Kedlaya; Kiran S.,9997,0,9999,2
1657742797569,MATH 197,003,095567,Xiao; Ming,9999,0,9999,0
1657742797569,MATH 197,004,095571,Perols; Johan Lars,9998,0,9999,1
1657742804620,COGS 9,A01,083615,Shannon; Kyle Michael,9,0,75,66
1657742810646,COGS 11,A01,083617,Boyle; Mary E. T.,23,0,48,25
1657742816677,COGS 13,A01,083071,Bastos; Amalia Pinkusfeld,11,0,71,60
1657742822702,COGS 14A,A01,092681,Semenuks; Arturs,5,1,100,95
1657742828737,COGS 14B,A01,083073,Cheng; Tzu-Han,6,0,63,57
1657742834760,COGS 17,A01,092677,Semenuks; Arturs,6,0,81,75
1657742840787,COGS 100,A01,083619,Allen; Michael Gordon,17,0,70,53
1657742846810,COGS 101A,A01,083621,Davis; Joshua Daniel,9,0,68,59
1657742852836,COGS 101B,A01,091572,Allen; Michael Gordon,12,0,65,53
1657742858861,COGS 101C,A01,083625,Delgado; Tania,17,0,35,18
1657742864901,COGS 107A,A01,083627,Boyle; Mary E. T.,13,0,60,47
1657742870922,COGS 118A,A01,083075,Gupta; Anjum,21,0,76,55
1657742876952,CSE 3,A50,083646,Miranda; Gregory Joseph,24,0,50,26
1657742882989,CSE 8A,A50,083650,Miranda; Gregory Joseph,17,1,56,39
1657742889022,CSE 11,A01,083080,Cao; Yingjun,6,15,40,34
1657742895048,CSE 12,A01,083652,Krause-Levy; Sophia Louisa,28,1,120,92
1657742901071,CSE 15L,A01,083654,Morris; Justin Loren,9,0,50,41
1657742901071,CSE 15L,A02,083655,Morris; Justin Loren,9,0,50,41
1657742907102,CSE 20,A01,083657,Tran; Khoa Dang,39,0,80,41
1657742913134,CSE 21,A01,095574,Bach; Quang Tran,22,0,48,26
1657742919165,CSE 30,A01,083084,Eldon; John,6,0,80,74
1657742919165,CSE 30,B01,095061,Bhaskar; Nishant,9,0,50,41
1657742925192,CSE 100,A01,083659,Cao; Yingjun,5,4,70,65
1657742931216,CSE 134B,A01,083661,Powell; Thomas Allan,23,0,100,77
1657742937241,CSE 140,A01,083663,Gungor; Onat,15,0,85,70
1657742943272,CSE 140L,A01,083088,Eldon; John,23,0,100,77
1657742949299,CSE 175,A01,083665,Kumar; Rakesh,3,0,25,22
1657742955330,CSE 190,A00,092507,Dubnov; Shlomo,8,0,20,12
1657742961358,ECE 45,A01,083139,Congero; Spencer William,6,0,75,69
1657742967385,ECE 65,A50,083695,Saad; Andrew S,12,0,30,18
1657742967385,ECE 65,A51,095125,Saad; Andrew S,24,0,26,2
1657742973420,ECE 109,A01,091882,Touri; Behrouz,20,0,70,50
1657742979443,ECE 180,A00,083140,Abi Samra; Nicholas Camill,1,0,30,29
1657742979443,ECE 180,B00,083141,Abi Samra; Nicholas Camill,0,0,30,30
1657742985472,MATH 10A,A01,083735,Patchell; Gregory David,2,0,30,28
1657742985472,MATH 10A,A02,083736,Patchell; Gregory David,20,0,30,10
1657742985472,MATH 10A,A03,083737,Patchell; Gregory David,16,0,30,14
1657742991503,MATH 10B,A01,083207,Lim; Seonhee,8,0,34,26
1657742991503,MATH 10B,A02,083208,Lim; Seonhee,9,0,35,26
1657742991503,MATH 10B,A03,093472,Lim; Seonhee,7,0,34,27
1657742991503,MATH 10B,B01,083739,Sinha; Shubham,13,0,30,17
1657742997526,MATH 18,A01,083743,Cinel; Cameron Alexander,9,0,30,21
1657742997526,MATH 18,A02,083744,Cinel; Cameron Alexander,18,0,30,12
1657742997526,MATH 18,A03,083745,Cinel; Cameron Alexander,10,0,30,20
1657742997526,MATH 18,B01,083748,Rideout; David Porter,5,0,37,32
1657742997526,MATH 18,B02,083749,Rideout; David Porter,5,0,36,31
1657742997526,MATH 18,B03,083750,Rideout; David Porter,3,0,37,34
1657742997526,MATH 18,B04,083751,Rideout; David Porter,6,0,36,30
1657742997526,MATH 18,B05,093473,Rideout; David Porter,6,0,36,30
1657742997526,MATH 18,B06,093474,Rideout; David Porter,6,0,36,30
1657743003549,MATH 20A,A01,083754,Zheng; Zequn,14,0,40,26
1657743009571,MATH 20B,A01,083756,Briones; Jor-el Thomas Caparas,4,0,36,32
1657743009571,MATH 20B,A02,083757,Briones; Jor-el Thomas Caparas,1,0,36,35
1657743009571,MATH 20B,A03,093475,Briones; Jor-el Thomas Caparas,2,0,36,34
1657743015603,MATH 20C,A01,083760,Briones; Jor-el Thomas Caparas,1,0,35,34
1657743015603,MATH 20C,A02,083761,Briones; Jor-el Thomas Caparas,8,0,35,27
1657743015603,MATH 20C,A03,093476,Briones; Jor-el Thomas Caparas,0,1,36,36
1657743015603,MATH 20C,B01,083762,Bach; Quang Tran,1,0,30,29
1657743021631,MATH 20D,A01,083765,Tran; Brian Kha,5,0,30,25
1657743021631,MATH 20D,A02,083766,Tran; Brian Kha,5,0,30,25
1657743021631,MATH 20D,A03,083767,Tran; Brian Kha,5,0,30,25
1657743027667,MATH 20E,A01,083771,Ganguly; Soumya,9,0,32,23
1657743027667,MATH 20E,A02,083772,Ganguly; Soumya,6,0,32,26
1657743027667,MATH 20E,B01,083773,Ciotti; Benjamin,20,0,35,15
1657743027667,MATH 20E,B02,083774,Ciotti; Benjamin,18,0,35,17
1657743041409,MATH 103A,A01,083777,Greenfeld; Be'Eri,3,0,36,33
1657743041409,MATH 103A,A02,083778,Greenfeld; Be'Eri,5,0,36,31
1657743041409,MATH 103A,A03,093561,Greenfeld; Be'Eri,6,0,36,30
1657743041409,MATH 103A,B01,083779,Greenfeld; Be'Eri,7,0,36,29
1657743041409,MATH 103A,B02,083780,Greenfeld; Be'Eri,4,0,36,32
1657743041409,MATH 103A,B03,093562,Greenfeld; Be'Eri,3,0,36,33
1657743047440,MATH 105,A01,085443,Carter; Anne Toulson,15,0,35,20
1657743047440,MATH 105,A02,093477,Carter; Anne Toulson,20,0,35,15
1657743053469,MATH 109,A01,083213,Ganzberger; Geoffrey Michael,3,0,34,31
1657743053469,MATH 109,A02,083214,Ganzberger; Geoffrey Michael,4,0,34,30
1657743053469,MATH 109,A03,093478,Ganzberger; Geoffrey Michael,2,0,34,32
1657743053469,MATH 109,B01,083215,Ganzberger; Geoffrey Michael,1,0,32,31
1657743053469,MATH 109,B02,083216,Ganzberger; Geoffrey Michael,2,0,32,30
1657743053469,MATH 109,B03,093479,Ganzberger; Geoffrey Michael,8,0,32,24
1657743059496,MATH 142A,A01,083219,Chow; Bennett,7,0,32,25
1657743059496,MATH 142A,A02,083220,Chow; Bennett,10,0,32,22
1657743059496,MATH 142A,A03,093480,Chow; Bennett,9,0,32,23
1657743059496,MATH 142A,B03,093481,Chow; Bennett,8,0,32,24
1657743059496,MATH 142A,B04,093558,Chow; Bennett,13,0,32,19
1657743059496,MATH 142A,B05,093559,Chow; Bennett,6,0,32,26
1657743065525,MATH 193A,A01,083224,Rotar; Vladimir,8,0,34,26
1657743065525,MATH 193A,A02,083225,Rotar; Vladimir,9,0,34,25
1657743065525,MATH 193A,A03,083781,Rotar; Vladimir,5,0,34,29
1657743065525,MATH 193A,A04,083782,Rotar; Vladimir,10,0,34,24
1657743065525,MATH 193A,A05,093482,Rotar; Vladimir,10,0,34,24
1657743071546,MATH 197,001,091859,McAuley; Julian John,9999,0,9999,0
1657743071546,MATH 197,002,095566,Kedlaya; Kiran S.,9997,0,9999,2
1657743071546,MATH 197,003,095567,Xiao; Ming,9999,0,9999,0
1657743071546,MATH 197,004,095571,Perols; Johan Lars,9998,0,9999,1
1657743078596,COGS 9,A01,083615,Shannon; Kyle Michael,9,0,75,66
1657743084622,COGS 11,A01,083617,Boyle; Mary E. T.,23,0,48,25
1657743090649,COGS 13,A01,083071,Bastos; Amalia Pinkusfeld,11,0,71,60
1657743096673,COGS 14A,A01,092681,Semenuks; Arturs,5,1,100,95
1657743102698,COGS 14B,A01,083073,Cheng; Tzu-Han,6,0,63,57
1657743108809,COGS 17,A01,092677,Semenuks; Arturs,6,0,81,75
1657743114836,COGS 100,A01,083619,Allen; Michael Gordon,17,0,70,53
1657743120862,COGS 101A,A01,083621,Davis; Joshua Daniel,9,0,68,59
1657743126884,COGS 101B,A01,091572,Allen; Michael Gordon,12,0,65,53
1657743132924,COGS 101C,A01,083625,Delgado; Tania,17,0,35,18
1657743138951,COGS 107A,A01,083627,Boyle; Mary E. T.,13,0,60,47
1657743144986,COGS 118A,A01,083075,Gupta; Anjum,21,0,76,55
1657743151014,CSE 3,A50,083646,Miranda; Gregory Joseph,24,0,50,26
1657743157052,CSE 8A,A50,083650,Miranda; Gregory Joseph,17,1,56,39
1657743163077,CSE 11,A01,083080,Cao; Yingjun,6,15,40,34
1657743169102,CSE 12,A01,083652,Krause-Levy; Sophia Louisa,28,1,120,92
1657743175124,CSE 15L,A01,083654,Morris; Justin Loren,9,0,50,41
1657743175124,CSE 15L,A02,083655,Morris; Justin Loren,9,0,50,41
1657743181146,CSE 20,A01,083657,Tran; Khoa Dang,39,0,80,41
1657743187169,CSE 21,A01,095574,Bach; Quang Tran,22,0,48,26
1657743193206,CSE 30,A01,083084,Eldon; John,6,0,80,74
1657743193206,CSE 30,B01,095061,Bhaskar; Nishant,9,0,50,41
1657743199235,CSE 100,A01,083659,Cao; Yingjun,5,4,70,65
1657743205271,CSE 134B,A01,083661,Powell; Thomas Allan,23,0,100,77
1657743211297,CSE 140,A01,083663,Gungor; Onat,15,0,85,70
1657743217320,CSE 140L,A01,083088,Eldon; John,23,0,100,77
1657743223345,CSE 175,A01,083665,Kumar; Rakesh,3,0,25,22
1657743229367,CSE 190,A00,092507,Dubnov; Shlomo,8,0,20,12
1657743235392,ECE 45,A01,083139,Congero; Spencer William,6,0,75,69
1657743241416,ECE 65,A50,083695,Saad; Andrew S,12,0,30,18
1657743241416,ECE 65,A51,095125,Saad; Andrew S,24,0,26,2
1657743247456,ECE 109,A01,091882,Touri; Behrouz,20,0,70,50
1657743253486,ECE 180,A00,083140,Abi Samra; Nicholas Camill,1,0,30,29
1657743253486,ECE 180,B00,083141,Abi Samra; Nicholas Camill,0,0,30,30
1657743259514,MATH 10A,A01,083735,Patchell; Gregory David,2,0,30,28
1657743259514,MATH 10A,A02,083736,Patchell; Gregory David,20,0,30,10
1657743259514,MATH 10A,A03,083737,Patchell; Gregory David,16,0,30,14
1657743265538,MATH 10B,A01,083207,Lim; Seonhee,8,0,34,26
1657743265538,MATH 10B,A02,083208,Lim; Seonhee,9,0,35,26
1657743265538,MATH 10B,A03,093472,Lim; Seonhee,7,0,34,27
1657743265538,MATH 10B,B01,083739,Sinha; Shubham,13,0,30,17
1657743271561,MATH 18,A01,083743,Cinel; Cameron Alexander,9,0,30,21
1657743271561,MATH 18,A02,083744,Cinel; Cameron Alexander,18,0,30,12
1657743271561,MATH 18,A03,083745,Cinel; Cameron Alexander,10,0,30,20
1657743271561,MATH 18,B01,083748,Rideout; David Porter,5,0,37,32
1657743271561,MATH 18,B02,083749,Rideout; David Porter,5,0,36,31
1657743271561,MATH 18,B03,083750,Rideout; David Porter,3,0,37,34
1657743271561,MATH 18,B04,083751,Rideout; David Porter,6,0,36,30
1657743271561,MATH 18,B05,093473,Rideout; David Porter,6,0,36,30
1657743271561,MATH 18,B06,093474,Rideout; David Porter,6,0,36,30
1657743277583,MATH 20A,A01,083754,Zheng; Zequn,14,0,40,26
1657743283617,MATH 20B,A01,083756,Briones; Jor-el Thomas Caparas,4,0,36,32
1657743283617,MATH 20B,A02,083757,Briones; Jor-el Thomas Caparas,1,0,36,35
1657743283617,MATH 20B,A03,093475,Briones; Jor-el Thomas Caparas,2,0,36,34
1657743289641,MATH 20C,A01,083760,Briones; Jor-el Thomas Caparas,1,0,35,34
1657743289641,MATH 20C,A02,083761,Briones; Jor-el Thomas Caparas,8,0,35,27
1657743289641,MATH 20C,A03,093476,Briones; Jor-el Thomas Caparas,0,1,36,36
1657743289641,MATH 20C,B01,083762,Bach; Quang Tran,1,0,30,29
1657743295670,MATH 20D,A01,083765,Tran; Brian Kha,5,0,30,25
1657743295670,MATH 20D,A02,083766,Tran; Brian Kha,5,0,30,25
1657743295670,MATH 20D,A03,083767,Tran; Brian Kha,5,0,30,25
1657743301701,MATH 20E,A01,083771,Ganguly; Soumya,9,0,32,23
1657743301701,MATH 20E,A02,083772,Ganguly; Soumya,6,0,32,26
1657743301701,MATH 20E,B01,083773,Ciotti; Benjamin,20,0,35,15
1657743301701,MATH 20E,B02,083774,Ciotti; Benjamin,18,0,35,17
1657743307734,MATH 103A,A01,083777,Greenfeld; Be'Eri,3,0,36,33
1657743307734,MATH 103A,A02,083778,Greenfeld; Be'Eri,5,0,36,31
1657743307734,MATH 103A,A03,093561,Greenfeld; Be'Eri,6,0,36,30
1657743307734,MATH 103A,B01,083779,Greenfeld; Be'Eri,7,0,36,29
1657743307734,MATH 103A,B02,083780,Greenfeld; Be'Eri,4,0,36,32
1657743307734,MATH 103A,B03,093562,Greenfeld; Be'Eri,3,0,36,33
1657743313760,MATH 105,A01,085443,Carter; Anne Toulson,15,0,35,20
1657743313760,MATH 105,A02,093477,Carter; Anne Toulson,20,0,35,15
1657743319788,MATH 109,A01,083213,Ganzberger; Geoffrey Michael,3,0,34,31
1657743319788,MATH 109,A02,083214,Ganzberger; Geoffrey Michael,4,0,34,30
1657743319788,MATH 109,A03,093478,Ganzberger; Geoffrey Michael,2,0,34,32
1657743319788,MATH 109,B01,083215,Ganzberger; Geoffrey Michael,1,0,32,31
1657743319788,MATH 109,B02,083216,Ganzberger; Geoffrey Michael,2,0,32,30
1657743319788,MATH 109,B03,093479,Ganzberger; Geoffrey Michael,8,0,32,24
1657743325815,MATH 142A,A01,083219,Chow; Bennett,7,0,32,25
1657743325815,MATH 142A,A02,083220,Chow; Bennett,10,0,32,22
1657743325815,MATH 142A,A03,093480,Chow; Bennett,9,0,32,23
1657743325815,MATH 142A,B03,093481,Chow; Bennett,8,0,32,24
1657743325815,MATH 142A,B04,093558,Chow; Bennett,13,0,32,19
1657743325815,MATH 142A,B05,093559,Chow; Bennett,6,0,32,26
1657743331842,MATH 193A,A01,083224,Rotar; Vladimir,8,0,34,26
1657743331842,MATH 193A,A02,083225,Rotar; Vladimir,9,0,34,25
1657743331842,MATH 193A,A03,083781,Rotar; Vladimir,5,0,34,29
1657743331842,MATH 193A,A04,083782,Rotar; Vladimir,10,0,34,24
1657743331842,MATH 193A,A05,093482,Rotar; Vladimir,10,0,34,24
1657743337865,MATH 197,001,091859,McAuley; Julian John,9999,0,9999,0
1657743337865,MATH 197,002,095566,Kedlaya; Kiran S.,9997,0,9999,2
1657743337865,MATH 197,003,095567,Xiao; Ming,9999,0,9999,0
1657743337865,MATH 197,004,095571,Perols; Johan Lars,9998,0,9999,1
1657743344918,COGS 9,A01,083615,Shannon; Kyle Michael,9,0,75,66
1657743350942,COGS 11,A01,083617,Boyle; Mary E. T.,23,0,48,25
1657743356965,COGS 13,A01,083071,Bastos; Amalia Pinkusfeld,11,0,71,60
1657743363003,COGS 14A,A01,092681,Semenuks; Arturs,5,1,100,95
1657743369029,COGS 14B,A01,083073,Cheng; Tzu-Han,6,0,63,57
1657743375056,COGS 17,A01,092677,Semenuks; Arturs,6,0,81,75
1657743381093,COGS 100,A01,083619,Allen; Michael Gordon,17,0,70,53
1657743387120,COGS 101A,A01,083621,Davis; Joshua Daniel,9,0,68,59
1657743393143,COGS 101B,A01,091572,Allen; Michael Gordon,12,0,65,53
1657743399166,COGS 101C,A01,083625,Delgado; Tania,17,0,35,18
1657743405188,COGS 107A,A01,083627,Boyle; Mary E. T.,13,0,60,47
1657743411214,COGS 118A,A01,083075,Gupta; Anjum,21,0,76,55
1657743417245,CSE 3,A50,083646,Miranda; Gregory Joseph,24,0,50,26
1657743423268,CSE 8A,A50,083650,Miranda; Gregory Joseph,17,1,56,39
1657743429294,CSE 11,A01,083080,Cao; Yingjun,6,15,40,34
1657743435317,CSE 12,A01,083652,Krause-Levy; Sophia Louisa,28,1,120,92
1657743441346,CSE 15L,A01,083654,Morris; Justin Loren,9,0,50,41
1657743441346,CSE 15L,A02,083655,Morris; Justin Loren,9,0,50,41
1657743447388,CSE 20,A01,083657,Tran; Khoa Dang,39,0,80,41
1657743453412,CSE 21,A01,095574,Bach; Quang Tran,22,0,48,26
1657743459438,CSE 30,A01,083084,Eldon; John,6,0,80,74
1657743459438,CSE 30,B01,095061,Bhaskar; Nishant,9,0,50,41
1657743465465,CSE 100,A01,083659,Cao; Yingjun,5,4,70,65
1657743471490,CSE 134B,A01,083661,Powell; Thomas Allan,23,0,100,77
1657743477525,CSE 140,A01,083663,Gungor; Onat,15,0,85,70
1657743483550,CSE 140L,A01,083088,Eldon; John,23,0,100,77
1657743489574,CSE 175,A01,083665,Kumar; Rakesh,3,0,25,22
1657743495599,CSE 190,A00,092507,Dubnov; Shlomo,8,0,20,12
1657743501641,ECE 45,A01,083139,Congero; Spencer William,6,0,75,69
1657743507666,ECE 65,A50,083695,Saad; Andrew S,12,0,30,18
1657743507666,ECE 65,A51,095125,Saad; Andrew S,24,0,26,2
1657743513692,ECE 109,A01,091882,Touri; Behrouz,20,0,70,50
1657743519719,ECE 180,A00,083140,Abi Samra; Nicholas Camill,1,0,30,29
1657743519719,ECE 180,B00,083141,Abi Samra; Nicholas Camill,0,0,30,30
1657743525754,MATH 10A,A01,083735,Patchell; Gregory David,2,0,30,28
1657743525754,MATH 10A,A02,083736,Patchell; Gregory David,20,0,30,10
1657743525754,MATH 10A,A03,083737,Patchell; Gregory David,16,0,30,14
1657743531790,MATH 10B,A01,083207,Lim; Seonhee,8,0,34,26
1657743531790,MATH 10B,A02,083208,Lim; Seonhee,9,0,35,26
1657743531790,MATH 10B,A03,093472,Lim; Seonhee,7,0,34,27
1657743531790,MATH 10B,B01,083739,Sinha; Shubham,13,0,30,17
1657743537820,MATH 18,A01,083743,Cinel; Cameron Alexander,9,0,30,21
1657743537820,MATH 18,A02,083744,Cinel; Cameron Alexander,18,0,30,12
1657743537820,MATH 18,A03,083745,Cinel; Cameron Alexander,10,0,30,20
1657743537820,MATH 18,B01,083748,Rideout; David Porter,5,0,37,32
1657743537820,MATH 18,B02,083749,Rideout; David Porter,5,0,36,31
1657743537820,MATH 18,B03,083750,Rideout; David Porter,3,0,37,34
1657743537820,MATH 18,B04,083751,Rideout; David Porter,6,0,36,30
1657743537820,MATH 18,B05,093473,Rideout; David Porter,6,0,36,30
1657743537820,MATH 18,B06,093474,Rideout; David Porter,6,0,36,30
1657743543849,MATH 20A,A01,083754,Zheng; Zequn,14,0,40,26
1657743549872,MATH 20B,A01,083756,Briones; Jor-el Thomas Caparas,4,0,36,32
1657743549872,MATH 20B,A02,083757,Briones; Jor-el Thomas Caparas,1,0,36,35
1657743549872,MATH 20B,A03,093475,Briones; Jor-el Thomas Caparas,2,0,36,34
1657743555901,MATH 20C,A01,083760,Briones; Jor-el Thomas Caparas,1,0,35,34
1657743555901,MATH 20C,A02,083761,Briones; Jor-el Thomas Caparas,8,0,35,27
1657743555901,MATH 20C,A03,093476,Briones; Jor-el Thomas Caparas,0,1,36,36
1657743555901,MATH 20C,B01,083762,Bach; Quang Tran,1,0,30,29
1657743561928,MATH 20D,A01,083765,Tran; Brian Kha,5,0,30,25
1657743561928,MATH 20D,A02,083766,Tran; Brian Kha,5,0,30,25
1657743561928,MATH 20D,A03,083767,Tran; Brian Kha,5,0,30,25
1657743567969,MATH 20E,A01,083771,Ganguly; Soumya,9,0,32,23
1657743567969,MATH 20E,A02,083772,Ganguly; Soumya,6,0,32,26
1657743567969,MATH 20E,B01,083773,Ciotti; Benjamin,20,0,35,15
1657743567969,MATH 20E,B02,083774,Ciotti; Benjamin,18,0,35,17
1657743573994,MATH 103A,A01,083777,Greenfeld; Be'Eri,3,0,36,33
1657743573994,MATH 103A,A02,083778,Greenfeld; Be'Eri,5,0,36,31
1657743573994,MATH 103A,A03,093561,Greenfeld; Be'Eri,6,0,36,30
1657743573994,MATH 103A,B01,083779,Greenfeld; Be'Eri,7,0,36,29
1657743573994,MATH 103A,B02,083780,Greenfeld; Be'Eri,4,0,36,32
1657743573994,MATH 103A,B03,093562,Greenfeld; Be'Eri,3,0,36,33
1657743580031,MATH 105,A01,085443,Carter; Anne Toulson,15,0,35,20
1657743580031,MATH 105,A02,093477,Carter; Anne Toulson,20,0,35,15
1657743586055,MATH 109,A01,083213,Ganzberger; Geoffrey Michael,3,0,34,31
1657743586055,MATH 109,A02,083214,Ganzberger; Geoffrey Michael,4,0,34,30
1657743586055,MATH 109,A03,093478,Ganzberger; Geoffrey Michael,2,0,34,32
1657743586055,MATH 109,B01,083215,Ganzberger; Geoffrey Michael,1,0,32,31
1657743586055,MATH 109,B02,083216,Ganzberger; Geoffrey Michael,2,0,32,30
1657743586055,MATH 109,B03,093479,Ganzberger; Geoffrey Michael,8,0,32,24
1657743592080,MATH 142A,A01,083219,Chow; Bennett,7,0,32,25
1657743592080,MATH 142A,A02,083220,Chow; Bennett,10,0,32,22
1657743592080,MATH 142A,A03,093480,Chow; Bennett,9,0,32,23
1657743592080,MATH 142A,B03,093481,Chow; Bennett,8,0,32,24
1657743592080,MATH 142A,B04,093558,Chow; Bennett,13,0,32,19
1657743592080,MATH 142A,B05,093559,Chow; Bennett,6,0,32,26
1657743598108,MATH 193A,A01,083224,Rotar; Vladimir,8,0,34,26
1657743598108,MATH 193A,A02,083225,Rotar; Vladimir,9,0,34,25
1657743598108,MATH 193A,A03,083781,Rotar; Vladimir,5,0,34,29
1657743598108,MATH 193A,A04,083782,Rotar; Vladimir,10,0,34,24
1657743598108,MATH 193A,A05,093482,Rotar; Vladimir,10,0,34,24
1657743604131,MATH 197,001,091859,McAuley; Julian John,9999,0,9999,0
1657743604131,MATH 197,002,095566,Kedlaya; Kiran S.,9997,0,9999,2
1657743604131,MATH 197,003,095567,Xiao; Ming,9999,0,9999,0
1657743604131,MATH 197,004,095571,Perols; Johan Lars,9998,0,9999,1
1657743611210,COGS 9,A01,083615,Shannon; Kyle Michael,9,0,75,66
1657743617237,COGS 11,A01,083617,Boyle; Mary E. T.,23,0,48,25
1657743623273,COGS 13,A01,083071,Bastos; Amalia Pinkusfeld,11,0,71,60
1657743629309,COGS 14A,A01,092681,Semenuks; Arturs,5,1,100,95
1657743635337,COGS 14B,A01,083073,Cheng; Tzu-Han,6,0,63,57
1657743641360,COGS 17,A01,092677,Semenuks; Arturs,6,0,81,75
1657743647386,COGS 100,A01,083619,Allen; Michael Gordon,17,0,70,53
1657743653415,COGS 101A,A01,083621,Davis; Joshua Daniel,9,0,68,59
1657743659442,COGS 101B,A01,091572,Allen; Michael Gordon,12,0,65,53
1657743665470,COGS 101C,A01,083625,Delgado; Tania,17,0,35,18
1657743671497,COGS 107A,A01,083627,Boyle; Mary E. T.,13,0,60,47
1657743677528,COGS 118A,A01,083075,Gupta; Anjum,21,0,76,55
1657743683556,CSE 3,A50,083646,Miranda; Gregory Joseph,24,0,50,26
1657743689590,CSE 8A,A50,083650,Miranda; Gregory Joseph,17,1,56,39
1657743695620,CSE 11,A01,083080,Cao; Yingjun,6,15,40,34
1657743701650,CSE 12,A01,083652,Krause-Levy; Sophia Louisa,28,1,120,92
1657743707766,CSE 15L,A01,083654,Morris; Justin Loren,9,0,50,41
1657743707766,CSE 15L,A02,083655,Morris; Justin Loren,9,0,50,41
1657743713798,CSE 20,A01,083657,Tran; Khoa Dang,39,0,80,41
1657743719825,CSE 21,A01,095574,Bach; Quang Tran,22,0,48,26
1657743725854,CSE 30,A01,083084,Eldon; John,6,0,80,74
1657743725854,CSE 30,B01,095061,Bhaskar; Nishant,9,0,50,41
1657743731878,CSE 100,A01,083659,Cao; Yingjun,5,4,70,65
1657743737902,CSE 134B,A01,083661,Powell; Thomas Allan,23,0,100,77
1657743743925,CSE 140,A01,083663,Gungor; Onat,15,0,85,70
1657743749955,CSE 140L,A01,083088,Eldon; John,23,0,100,77
1657743755984,CSE 175,A01,083665,Kumar; Rakesh,3,0,25,22
1657743762007,CSE 190,A00,092507,Dubnov; Shlomo,8,0,20,12
1657743768039,ECE 45,A01,083139,Congero; Spencer William,6,0,75,69
1657743774061,ECE 65,A50,083695,Saad; Andrew S,12,0,30,18
1657743774061,ECE 65,A51,095125,Saad; Andrew S,24,0,26,2
1657743780090,ECE 109,A01,091882,Touri; Behrouz,20,0,70,50
1657743786113,ECE 180,A00,083140,Abi Samra; Nicholas Camill,1,0,30,29
1657743786113,ECE 180,B00,083141,Abi Samra; Nicholas Camill,0,0,30,30
1657743792141,MATH 10A,A01,083735,Patchell; Gregory David,2,0,30,28
1657743792141,MATH 10A,A02,083736,Patchell; Gregory David,20,0,30,10
1657743792141,MATH 10A,A03,083737,Patchell; Gregory David,16,0,30,14
1657743798163,MATH 10B,A01,083207,Lim; Seonhee,8,0,34,26
1657743798163,MATH 10B,A02,083208,Lim; Seonhee,9,0,35,26
1657743798163,MATH 10B,A03,093472,Lim; Seonhee,7,0,34,27
1657743798163,MATH 10B,B01,083739,Sinha; Shubham,13,0,30,17
1657743804188,MATH 18,A01,083743,Cinel; Cameron Alexander,9,0,30,21
1657743804188,MATH 18,A02,083744,Cinel; Cameron Alexander,18,0,30,12
1657743804188,MATH 18,A03,083745,Cinel; Cameron Alexander,10,0,30,20
1657743804188,MATH 18,B01,083748,Rideout; David Porter,5,0,37,32
1657743804188,MATH 18,B02,083749,Rideout; David Porter,5,0,36,31
1657743804188,MATH 18,B03,083750,Rideout; David Porter,3,0,37,34
1657743804188,MATH 18,B04,083751,Rideout; David Porter,6,0,36,30
1657743804188,MATH 18,B05,093473,Rideout; David Porter,6,0,36,30
1657743804188,MATH 18,B06,093474,Rideout; David Porter,6,0,36,30
1657743810214,MATH 20A,A01,083754,Zheng; Zequn,14,0,40,26
1657743816240,MATH 20B,A01,083756,Briones; Jor-el Thomas Caparas,4,0,36,32
1657743816240,MATH 20B,A02,083757,Briones; Jor-el Thomas Caparas,1,0,36,35
1657743816240,MATH 20B,A03,093475,Briones; Jor-el Thomas Caparas,2,0,36,34
1657743822263,MATH 20C,A01,083760,Briones; Jor-el Thomas Caparas,1,0,35,34
1657743822263,MATH 20C,A02,083761,Briones; Jor-el Thomas Caparas,8,0,35,27
1657743822263,MATH 20C,A03,093476,Briones; Jor-el Thomas Caparas,0,1,36,36
1657743822263,MATH 20C,B01,083762,Bach; Quang Tran,1,0,30,29
1657743828288,MATH 20D,A01,083765,Tran; Brian Kha,5,0,30,25
1657743828288,MATH 20D,A02,083766,Tran; Brian Kha,5,0,30,25
1657743828288,MATH 20D,A03,083767,Tran; Brian Kha,5,0,30,25
1657743834317,MATH 20E,A01,083771,Ganguly; Soumya,9,0,32,23
1657743834317,MATH 20E,A02,083772,Ganguly; Soumya,6,0,32,26
1657743834317,MATH 20E,B01,083773,Ciotti; Benjamin,20,0,35,15
1657743834317,MATH 20E,B02,083774,Ciotti; Benjamin,18,0,35,17
1657743840355,MATH 103A,A01,083777,Greenfeld; Be'Eri,3,0,36,33
1657743840355,MATH 103A,A02,083778,Greenfeld; Be'Eri,5,0,36,31
1657743840355,MATH 103A,A03,093561,Greenfeld; Be'Eri,6,0,36,30
1657743840355,MATH 103A,B01,083779,Greenfeld; Be'Eri,7,0,36,29
1657743840355,MATH 103A,B02,083780,Greenfeld; Be'Eri,4,0,36,32
1657743840355,MATH 103A,B03,093562,Greenfeld; Be'Eri,3,0,36,33
1657743846384,MATH 105,A01,085443,Carter; Anne Toulson,15,0,35,20
1657743846384,MATH 105,A02,093477,Carter; Anne Toulson,20,0,35,15
1657743852423,MATH 109,A01,083213,Ganzberger; Geoffrey Michael,3,0,34,31
1657743852423,MATH 109,A02,083214,Ganzberger; Geoffrey Michael,4,0,34,30
1657743852423,MATH 109,A03,093478,Ganzberger; Geoffrey Michael,2,0,34,32
1657743852423,MATH 109,B01,083215,Ganzberger; Geoffrey Michael,1,0,32,31
1657743852423,MATH 109,B02,083216,Ganzberger; Geoffrey Michael,2,0,32,30
1657743852423,MATH 109,B03,093479,Ganzberger; Geoffrey Michael,8,0,32,24
1657743858448,MATH 142A,A01,083219,Chow; Bennett,7,0,32,25
1657743858448,MATH 142A,A02,083220,Chow; Bennett,10,0,32,22
1657743858448,MATH 142A,A03,093480,Chow; Bennett,9,0,32,23
1657743858448,MATH 142A,B03,093481,Chow; Bennett,8,0,32,24
1657743858448,MATH 142A,B04,093558,Chow; Bennett,13,0,32,19
1657743858448,MATH 142A,B05,093559,Chow; Bennett,6,0,32,26
1657743864470,MATH 193A,A01,083224,Rotar; Vladimir,8,0,34,26
1657743864470,MATH 193A,A02,083225,Rotar; Vladimir,9,0,34,25
1657743864470,MATH 193A,A03,083781,Rotar; Vladimir,5,0,34,29
1657743864470,MATH 193A,A04,083782,Rotar; Vladimir,10,0,34,24
1657743864470,MATH 193A,A05,093482,Rotar; Vladimir,10,0,34,24
1657743870499,MATH 197,001,091859,McAuley; Julian John,9999,0,9999,0
1657743870499,MATH 197,002,095566,Kedlaya; Kiran S.,9997,0,9999,2
1657743870499,MATH 197,003,095567,Xiao; Ming,9999,0,9999,0
1657743870499,MATH 197,004,095571,Perols; Johan Lars,9998,0,9999,1
1657743877558,COGS 9,A01,083615,Shannon; Kyle Michael,9,0,75,66
1657743883587,COGS 11,A01,083617,Boyle; Mary E. T.,23,0,48,25
1657743889615,COGS 13,A01,083071,Bastos; Amalia Pinkusfeld,11,0,71,60
1657743895638,COGS 14A,A01,092681,Semenuks; Arturs,5,1,100,95
1657743901661,COGS 14B,A01,083073,Cheng; Tzu-Han,6,0,63,57
1657743907682,COGS 17,A01,092677,Semenuks; Arturs,6,0,81,75
1657743913719,COGS 100,A01,083619,Allen; Michael Gordon,17,0,70,53
1657743919742,COGS 101A,A01,083621,Davis; Joshua Daniel,9,0,68,59
1657743925764,COGS 101B,A01,091572,Allen; Michael Gordon,12,0,65,53
1657743931792,COGS 101C,A01,083625,Delgado; Tania,17,0,35,18
1657743937819,COGS 107A,A01,083627,Boyle; Mary E. T.,13,0,60,47
1657743943843,COGS 118A,A01,083075,Gupta; Anjum,21,0,76,55
1657743949869,CSE 3,A50,083646,Miranda; Gregory Joseph,24,0,50,26
1657743955894,CSE 8A,A50,083650,Miranda; Gregory Joseph,17,1,56,39
1657743961923,CSE 11,A01,083080,Cao; Yingjun,6,15,40,34
1657743967957,CSE 12,A01,083652,Krause-Levy; Sophia Louisa,28,1,120,92
1657743973988,CSE 15L,A01,083654,Morris; Justin Loren,9,0,50,41
1657743973988,CSE 15L,A02,083655,Morris; Justin Loren,9,0,50,41
1657743980017,CSE 20,A01,083657,Tran; Khoa Dang,39,0,80,41
1657743986065,CSE 21,A01,095574,Bach; Quang Tran,22,0,48,26
1657743992097,CSE 30,A01,083084,Eldon; John,6,0,80,74
1657743992097,CSE 30,B01,095061,Bhaskar; Nishant,9,0,50,41
1657743998119,CSE 100,A01,083659,Cao; Yingjun,5,4,70,65
1657744004154,CSE 134B,A01,083661,Powell; Thomas Allan,23,0,100,77
1657744010195,CSE 140,A01,083663,Gungor; Onat,15,0,85,70
1657744016221,CSE 140L,A01,083088,Eldon; John,23,0,100,77
1657744022247,CSE 175,A01,083665,Kumar; Rakesh,3,0,25,22
1657744028277,CSE 190,A00,092507,Dubnov; Shlomo,8,0,20,12
1657744034304,ECE 45,A01,083139,Congero; Spencer William,6,0,75,69
1657744040331,ECE 65,A50,083695,Saad; Andrew S,12,0,30,18
1657744040331,ECE 65,A51,095125,Saad; Andrew S,24,0,26,2
1657744046370,ECE 109,A01,091882,Touri; Behrouz,20,0,70,50
1657744052396,ECE 180,A00,083140,Abi Samra; Nicholas Camill,1,0,30,29
1657744052396,ECE 180,B00,083141,Abi Samra; Nicholas Camill,0,0,30,30
1657744058424,MATH 10A,A01,083735,Patchell; Gregory David,2,0,30,28
1657744058424,MATH 10A,A02,083736,Patchell; Gregory David,20,0,30,10
1657744058424,MATH 10A,A03,083737,Patchell; Gregory David,16,0,30,14
1657744064468,MATH 10B,A01,083207,Lim; Seonhee,8,0,34,26
1657744064468,MATH 10B,A02,083208,Lim; Seonhee,9,0,35,26
1657744064468,MATH 10B,A03,093472,Lim; Seonhee,7,0,34,27
1657744064468,MATH 10B,B01,083739,Sinha; Shubham,13,0,30,17
1657744070502,MATH 18,A01,083743,Cinel; Cameron Alexander,9,0,30,21
1657744070502,MATH 18,A02,083744,Cinel; Cameron Alexander,18,0,30,12
1657744070502,MATH 18,A03,083745,Cinel; Cameron Alexander,10,0,30,20
1657744070502,MATH 18,B01,083748,Rideout; David Porter,5,0,37,32
1657744070502,MATH 18,B02,083749,Rideout; David Porter,5,0,36,31
1657744070502,MATH 18,B03,083750,Rideout; David Porter,3,0,37,34
1657744070502,MATH 18,B04,083751,Rideout; David Porter,6,0,36,30
1657744070502,MATH 18,B05,093473,Rideout; David Porter,6,0,36,30
1657744070502,MATH 18,B06,093474,Rideout; David Porter,6,0,36,30
1657744076524,MATH 20A,A01,083754,Zheng; Zequn,14,0,40,26
1657744082551,MATH 20B,A01,083756,Briones; Jor-el Thomas Caparas,4,0,36,32
1657744082551,MATH 20B,A02,083757,Briones; Jor-el Thomas Caparas,1,0,36,35
1657744082551,MATH 20B,A03,093475,Briones; Jor-el Thomas Caparas,2,0,36,34
1657744088580,MATH 20C,A01,083760,Briones; Jor-el Thomas Caparas,1,0,35,34
1657744088580,MATH 20C,A02,083761,Briones; Jor-el Thomas Caparas,8,0,35,27
1657744088580,MATH 20C,A03,093476,Briones; Jor-el Thomas Caparas,0,1,36,36
1657744088580,MATH 20C,B01,083762,Bach; Quang Tran,1,0,30,29
1657744094608,MATH 20D,A01,083765,Tran; Brian Kha,5,0,30,25
1657744094608,MATH 20D,A02,083766,Tran; Brian Kha,5,0,30,25
1657744094608,MATH 20D,A03,083767,Tran; Brian Kha,5,0,30,25
1657744100634,MATH 20E,A01,083771,Ganguly; Soumya,9,0,32,23
1657744100634,MATH 20E,A02,083772,Ganguly; Soumya,6,0,32,26
1657744100634,MATH 20E,B01,083773,Ciotti; Benjamin,20,0,35,15
1657744100634,MATH 20E,B02,083774,Ciotti; Benjamin,18,0,35,17
1657744106656,MATH 103A,A01,083777,Greenfeld; Be'Eri,3,0,36,33
1657744106656,MATH 103A,A02,083778,Greenfeld; Be'Eri,5,0,36,31
1657744106656,MATH 103A,A03,093561,Greenfeld; Be'Eri,6,0,36,30
1657744106656,MATH 103A,B01,083779,Greenfeld; Be'Eri,7,0,36,29
1657744106656,MATH 103A,B02,083780,Greenfeld; Be'Eri,4,0,36,32
1657744106656,MATH 103A,B03,093562,Greenfeld; Be'Eri,3,0,36,33
1657744112679,MATH 105,A01,085443,Carter; Anne Toulson,15,0,35,20
1657744112679,MATH 105,A02,093477,Carter; Anne Toulson,20,0,35,15
1657744118703,MATH 109,A01,083213,Ganzberger; Geoffrey Michael,3,0,34,31
1657744118703,MATH 109,A02,083214,Ganzberger; Geoffrey Michael,4,0,34,30
1657744118703,MATH 109,A03,093478,Ganzberger; Geoffrey Michael,2,0,34,32
1657744118703,MATH 109,B01,083215,Ganzberger; Geoffrey Michael,1,0,32,31
1657744118703,MATH 109,B02,083216,Ganzberger; Geoffrey Michael,2,0,32,30
1657744118703,MATH 109,B03,093479,Ganzberger; Geoffrey Michael,8,0,32,24
1657744124732,MATH 142A,A01,083219,Chow; Bennett,7,0,32,25
1657744124732,MATH 142A,A02,083220,Chow; Bennett,10,0,32,22
1657744124732,MATH 142A,A03,093480,Chow; Bennett,9,0,32,23
1657744124732,MATH 142A,B03,093481,Chow; Bennett,8,0,32,24
1657744124732,MATH 142A,B04,093558,Chow; Bennett,13,0,32,19
1657744124732,MATH 142A,B05,093559,Chow; Bennett,6,0,32,26
1657744130754,MATH 193A,A01,083224,Rotar; Vladimir,8,0,34,26
1657744130754,MATH 193A,A02,083225,Rotar; Vladimir,9,0,34,25
1657744130754,MATH 193A,A03,083781,Rotar; Vladimir,5,0,34,29
1657744130754,MATH 193A,A04,083782,Rotar; Vladimir,10,0,34,24
1657744130754,MATH 193A,A05,093482,Rotar; Vladimir,10,0,34,24
1657744136778,MATH 197,001,091859,McAuley; Julian John,9999,0,9999,0
1657744136778,MATH 197,002,095566,Kedlaya; Kiran S.,9997,0,9999,2
1657744136778,MATH 197,003,095567,Xiao; Ming,9999,0,9999,0
1657744136778,MATH 197,004,095571,Perols; Johan Lars,9998,0,9999,1
1657744143837,COGS 9,A01,083615,Shannon; Kyle Michael,9,0,75,66
1657744149865,COGS 11,A01,083617,Boyle; Mary E. T.,23,0,48,25
1657744155896,COGS 13,A01,083071,Bastos; Amalia Pinkusfeld,11,0,71,60
1657744161921,COGS 14A,A01,092681,Semenuks; Arturs,5,1,100,95
1657744167946,COGS 14B,A01,083073,Cheng; Tzu-Han,6,0,63,57
1657744173980,COGS 17,A01,092677,Semenuks; Arturs,6,0,81,75
1657744180014,COGS 100,A01,083619,Allen; Michael Gordon,17,0,70,53
1657744186036,COGS 101A,A01,083621,Davis; Joshua Daniel,9,0,68,59
1657744192059,COGS 101B,A01,091572,Allen; Michael Gordon,12,0,65,53
1657744198082,COGS 101C,A01,083625,Delgado; Tania,17,0,35,18
1657744204105,COGS 107A,A01,083627,Boyle; Mary E. T.,13,0,60,47
1657744210141,COGS 118A,A01,083075,Gupta; Anjum,21,0,76,55
1657744216171,CSE 3,A50,083646,Miranda; Gregory Joseph,24,0,50,26
1657744222193,CSE 8A,A50,083650,Miranda; Gregory Joseph,17,1,56,39
1657744228218,CSE 11,A01,083080,Cao; Yingjun,6,15,40,34
1657744234240,CSE 12,A01,083652,Krause-Levy; Sophia Louisa,28,1,120,92
1657744240266,CSE 15L,A01,083654,Morris; Justin Loren,9,0,50,41
1657744240266,CSE 15L,A02,083655,Morris; Justin Loren,9,0,50,41
1657744246291,CSE 20,A01,083657,Tran; Khoa Dang,39,0,80,41
1657744252319,CSE 21,A01,095574,Bach; Quang Tran,22,0,48,26
1657744258353,CSE 30,A01,083084,Eldon; John,6,0,80,74
1657744258353,CSE 30,B01,095061,Bhaskar; Nishant,9,0,50,41
1657744264376,CSE 100,A01,083659,Cao; Yingjun,5,4,70,65
1657744270400,CSE 134B,A01,083661,Powell; Thomas Allan,23,0,100,77
1657744276426,CSE 140,A01,083663,Gungor; Onat,15,0,85,70
1657744282460,CSE 140L,A01,083088,Eldon; John,23,0,100,77
1657744288492,CSE 175,A01,083665,Kumar; Rakesh,3,0,25,22
1657744294514,CSE 190,A00,092507,Dubnov; Shlomo,8,0,20,12
1657744300545,ECE 45,A01,083139,Congero; Spencer William,6,0,75,69
1657744306639,ECE 65,A50,083695,Saad; Andrew S,12,0,30,18
1657744306639,ECE 65,A51,095125,Saad; Andrew S,24,0,26,2
1657744312661,ECE 109,A01,091882,Touri; Behrouz,20,0,70,50
1657744318685,ECE 180,A00,083140,Abi Samra; Nicholas Camill,1,0,30,29
1657744318685,ECE 180,B00,083141,Abi Samra; Nicholas Camill,0,0,30,30
1657744324714,MATH 10A,A01,083735,Patchell; Gregory David,2,0,30,28
1657744324714,MATH 10A,A02,083736,Patchell; Gregory David,20,0,30,10
1657744324714,MATH 10A,A03,083737,Patchell; Gregory David,16,0,30,14
1657744330737,MATH 10B,A01,083207,Lim; Seonhee,8,0,34,26
1657744330737,MATH 10B,A02,083208,Lim; Seonhee,9,0,35,26
1657744330737,MATH 10B,A03,093472,Lim; Seonhee,7,0,34,27
1657744330737,MATH 10B,B01,083739,Sinha; Shubham,13,0,30,17
1657744336761,MATH 18,A01,083743,Cinel; Cameron Alexander,9,0,30,21
1657744336761,MATH 18,A02,083744,Cinel; Cameron Alexander,18,0,30,12
1657744336761,MATH 18,A03,083745,Cinel; Cameron Alexander,10,0,30,20
1657744336761,MATH 18,B01,083748,Rideout; David Porter,5,0,37,32
1657744336761,MATH 18,B02,083749,Rideout; David Porter,5,0,36,31
1657744336761,MATH 18,B03,083750,Rideout; David Porter,3,0,37,34
1657744336761,MATH 18,B04,083751,Rideout; David Porter,6,0,36,30
1657744336761,MATH 18,B05,093473,Rideout; David Porter,6,0,36,30
1657744336761,MATH 18,B06,093474,Rideout; David Porter,6,0,36,30
1657744342783,MATH 20A,A01,083754,Zheng; Zequn,14,0,40,26
1657744348805,MATH 20B,A01,083756,Briones; Jor-el Thomas Caparas,4,0,36,32
1657744348805,MATH 20B,A02,083757,Briones; Jor-el Thomas Caparas,1,0,36,35
1657744348805,MATH 20B,A03,093475,Briones; Jor-el Thomas Caparas,2,0,36,34
1657744354827,MATH 20C,A01,083760,Briones; Jor-el Thomas Caparas,1,0,35,34
1657744354827,MATH 20C,A02,083761,Briones; Jor-el Thomas Caparas,8,0,35,27
1657744354827,MATH 20C,A03,093476,Briones; Jor-el Thomas Caparas,0,1,36,36
1657744354827,MATH 20C,B01,083762,Bach; Quang Tran,1,0,30,29
1657744360854,MATH 20D,A01,083765,Tran; Brian Kha,5,0,30,25
1657744360854,MATH 20D,A02,083766,Tran; Brian Kha,5,0,30,25
1657744360854,MATH 20D,A03,083767,Tran; Brian Kha,5,0,30,25
1657744366885,MATH 20E,A01,083771,Ganguly; Soumya,9,0,32,23
1657744366885,MATH 20E,A02,083772,Ganguly; Soumya,6,0,32,26
1657744366885,MATH 20E,B01,083773,Ciotti; Benjamin,20,0,35,15
1657744366885,MATH 20E,B02,083774,Ciotti; Benjamin,18,0,35,17
1657744372908,MATH 103A,A01,083777,Greenfeld; Be'Eri,3,0,36,33
1657744372908,MATH 103A,A02,083778,Greenfeld; Be'Eri,5,0,36,31
1657744372908,MATH 103A,A03,093561,Greenfeld; Be'Eri,6,0,36,30
1657744372908,MATH 103A,B01,083779,Greenfeld; Be'Eri,7,0,36,29
1657744372908,MATH 103A,B02,083780,Greenfeld; Be'Eri,4,0,36,32
1657744372908,MATH 103A,B03,093562,Greenfeld; Be'Eri,3,0,36,33
1657744378938,MATH 105,A01,085443,Carter; Anne Toulson,15,0,35,20
1657744378938,MATH 105,A02,093477,Carter; Anne Toulson,20,0,35,15
1657744384966,MATH 109,A01,083213,Ganzberger; Geoffrey Michael,3,0,34,31
1657744384966,MATH 109,A02,083214,Ganzberger; Geoffrey Michael,4,0,34,30
1657744384966,MATH 109,A03,093478,Ganzberger; Geoffrey Michael,2,0,34,32
1657744384966,MATH 109,B01,083215,Ganzberger; Geoffrey Michael,1,0,32,31
1657744384966,MATH 109,B02,083216,Ganzberger; Geoffrey Michael,2,0,32,30
1657744384966,MATH 109,B03,093479,Ganzberger; Geoffrey Michael,8,0,32,24
1657744390998,MATH 142A,A01,083219,Chow; Bennett,7,0,32,25
1657744390998,MATH 142A,A02,083220,Chow; Bennett,10,0,32,22
1657744390998,MATH 142A,A03,093480,Chow; Bennett,9,0,32,23
1657744390998,MATH 142A,B03,093481,Chow; Bennett,8,0,32,24
1657744390998,MATH 142A,B04,093558,Chow; Bennett,13,0,32,19
1657744390998,MATH 142A,B05,093559,Chow; Bennett,6,0,32,26
1657744397021,MATH 193A,A01,083224,Rotar; Vladimir,8,0,34,26
1657744397021,MATH 193A,A02,083225,Rotar; Vladimir,9,0,34,25
1657744397021,MATH 193A,A03,083781,Rotar; Vladimir,5,0,34,29
1657744397021,MATH 193A,A04,083782,Rotar; Vladimir,10,0,34,24
1657744397021,MATH 193A,A05,093482,Rotar; Vladimir,10,0,34,24
1657744403043,MATH 197,001,091859,McAuley; Julian John,9999,0,9999,0
1657744403043,MATH 197,002,095566,Kedlaya; Kiran S.,9997,0,9999,2
1657744403043,MATH 197,003,095567,Xiao; Ming,9999,0,9999,0
1657744403043,MATH 197,004,095571,Perols; Johan Lars,9998,0,9999,1
1657744410109,COGS 9,A01,083615,Shannon; Kyle Michael,9,0,75,66
1657744416136,COGS 11,A01,083617,Boyle; Mary E. T.,23,0,48,25
1657744422162,COGS 13,A01,083071,Bastos; Amalia Pinkusfeld,11,0,71,60
1657744428192,COGS 14A,A01,092681,Semenuks; Arturs,5,1,100,95
1657744434219,COGS 14B,A01,083073,Cheng; Tzu-Han,6,0,63,57
1657744440251,COGS 17,A01,092677,Semenuks; Arturs,6,0,81,75
1657744446278,COGS 100,A01,083619,Allen; Michael Gordon,17,0,70,53
1657744452301,COGS 101A,A01,083621,Davis; Joshua Daniel,9,0,68,59
1657744458340,COGS 101B,A01,091572,Allen; Michael Gordon,12,0,65,53
1657744464362,COGS 101C,A01,083625,Delgado; Tania,17,0,35,18
1657744470386,COGS 107A,A01,083627,Boyle; Mary E. T.,13,0,60,47
1657744476411,COGS 118A,A01,083075,Gupta; Anjum,21,0,76,55
1657744482435,CSE 3,A50,083646,Miranda; Gregory Joseph,24,0,50,26
1657744488461,CSE 8A,A50,083650,Miranda; Gregory Joseph,17,1,56,39
1657744494499,CSE 11,A01,083080,Cao; Yingjun,6,15,40,34
1657744500534,CSE 12,A01,083652,Krause-Levy; Sophia Louisa,28,1,120,92
1657744506557,CSE 15L,A01,083654,Morris; Justin Loren,9,0,50,41
1657744506557,CSE 15L,A02,083655,Morris; Justin Loren,9,0,50,41
1657744512583,CSE 20,A01,083657,Tran; Khoa Dang,39,0,80,41
1657744518609,CSE 21,A01,095574,Bach; Quang Tran,22,0,48,26
1657744524635,CSE 30,A01,083084,Eldon; John,6,0,80,74
1657744524635,CSE 30,B01,095061,Bhaskar; Nishant,9,0,50,41
1657744530657,CSE 100,A01,083659,Cao; Yingjun,5,4,70,65
1657744536707,CSE 134B,A01,083661,Powell; Thomas Allan,24,0,100,76
1657744542730,CSE 140,A01,083663,Gungor; Onat,15,0,85,70
1657744548753,CSE 140L,A01,083088,Eldon; John,23,0,100,77
1657744554775,CSE 175,A01,083665,Kumar; Rakesh,3,0,25,22
1657744560799,CSE 190,A00,092507,Dubnov; Shlomo,8,0,20,12
1657744566826,ECE 45,A01,083139,Congero; Spencer William,6,0,75,69
1657744572855,ECE 65,A50,083695,Saad; Andrew S,12,0,30,18
1657744572855,ECE 65,A51,095125,Saad; Andrew S,24,0,26,2
1657744578877,ECE 109,A01,091882,Touri; Behrouz,20,0,70,50
1657744584902,ECE 180,A00,083140,Abi Samra; Nicholas Camill,1,0,30,29
1657744584902,ECE 180,B00,083141,Abi Samra; Nicholas Camill,0,0,30,30
1657744590927,MATH 10A,A01,083735,Patchell; Gregory David,2,0,30,28
1657744590927,MATH 10A,A02,083736,Patchell; Gregory David,20,0,30,10
1657744590927,MATH 10A,A03,083737,Patchell; Gregory David,16,0,30,14
1657744596955,MATH 10B,A01,083207,Lim; Seonhee,8,0,34,26
1657744596955,MATH 10B,A02,083208,Lim; Seonhee,9,0,35,26
1657744596955,MATH 10B,A03,093472,Lim; Seonhee,7,0,34,27
1657744596955,MATH 10B,B01,083739,Sinha; Shubham,13,0,30,17
1657744602986,MATH 18,A01,083743,Cinel; Cameron Alexander,9,0,30,21
1657744602986,MATH 18,A02,083744,Cinel; Cameron Alexander,18,0,30,12
1657744602986,MATH 18,A03,083745,Cinel; Cameron Alexander,10,0,30,20
1657744602986,MATH 18,B01,083748,Rideout; David Porter,5,0,37,32
1657744602986,MATH 18,B02,083749,Rideout; David Porter,5,0,36,31
1657744602986,MATH 18,B03,083750,Rideout; David Porter,3,0,37,34
1657744602986,MATH 18,B04,083751,Rideout; David Porter,6,0,36,30
1657744602986,MATH 18,B05,093473,Rideout; David Porter,6,0,36,30
1657744602986,MATH 18,B06,093474,Rideout; David Porter,6,0,36,30
1657744609012,MATH 20A,A01,083754,Zheng; Zequn,14,0,40,26
1657744615037,MATH 20B,A01,083756,Briones; Jor-el Thomas Caparas,4,0,36,32
1657744615037,MATH 20B,A02,083757,Briones; Jor-el Thomas Caparas,1,0,36,35
1657744615037,MATH 20B,A03,093475,Briones; Jor-el Thomas Caparas,2,0,36,34
1657744621060,MATH 20C,A01,083760,Briones; Jor-el Thomas Caparas,1,0,35,34
1657744621060,MATH 20C,A02,083761,Briones; Jor-el Thomas Caparas,8,0,35,27
1657744621060,MATH 20C,A03,093476,Briones; Jor-el Thomas Caparas,0,1,36,36
1657744621060,MATH 20C,B01,083762,Bach; Quang Tran,1,0,30,29
1657744627085,MATH 20D,A01,083765,Tran; Brian Kha,5,0,30,25
1657744627085,MATH 20D,A02,083766,Tran; Brian Kha,5,0,30,25
1657744627085,MATH 20D,A03,083767,Tran; Brian Kha,5,0,30,25
1657744633113,MATH 20E,A01,083771,Ganguly; Soumya,9,0,32,23
1657744633113,MATH 20E,A02,083772,Ganguly; Soumya,6,0,32,26
1657744633113,MATH 20E,B01,083773,Ciotti; Benjamin,20,0,35,15
1657744633113,MATH 20E,B02,083774,Ciotti; Benjamin,18,0,35,17
1657744639142,MATH 103A,A01,083777,Greenfeld; Be'Eri,3,0,36,33
1657744639142,MATH 103A,A02,083778,Greenfeld; Be'Eri,5,0,36,31
1657744639142,MATH 103A,A03,093561,Greenfeld; Be'Eri,6,0,36,30
1657744639142,MATH 103A,B01,083779,Greenfeld; Be'Eri,7,0,36,29
1657744639142,MATH 103A,B02,083780,Greenfeld; Be'Eri,4,0,36,32
1657744639142,MATH 103A,B03,093562,Greenfeld; Be'Eri,3,0,36,33
1657744645164,MATH 105,A01,085443,Carter; Anne Toulson,15,0,35,20
1657744645164,MATH 105,A02,093477,Carter; Anne Toulson,20,0,35,15
1657744651195,MATH 109,A01,083213,Ganzberger; Geoffrey Michael,3,0,34,31
1657744651195,MATH 109,A02,083214,Ganzberger; Geoffrey Michael,4,0,34,30
1657744651195,MATH 109,A03,093478,Ganzberger; Geoffrey Michael,2,0,34,32
1657744651195,MATH 109,B01,083215,Ganzberger; Geoffrey Michael,1,0,32,31
1657744651195,MATH 109,B02,083216,Ganzberger; Geoffrey Michael,2,0,32,30
1657744651195,MATH 109,B03,093479,Ganzberger; Geoffrey Michael,8,0,32,24
1657744657223,MATH 142A,A01,083219,Chow; Bennett,7,0,32,25
1657744657223,MATH 142A,A02,083220,Chow; Bennett,10,0,32,22
1657744657223,MATH 142A,A03,093480,Chow; Bennett,9,0,32,23
1657744657223,MATH 142A,B03,093481,Chow; Bennett,8,0,32,24
1657744657223,MATH 142A,B04,093558,Chow; Bennett,13,0,32,19
1657744657223,MATH 142A,B05,093559,Chow; Bennett,6,0,32,26
1657744663263,MATH 193A,A01,083224,Rotar; Vladimir,8,0,34,26
1657744663263,MATH 193A,A02,083225,Rotar; Vladimir,9,0,34,25
1657744663263,MATH 193A,A03,083781,Rotar; Vladimir,5,0,34,29
1657744663263,MATH 193A,A04,083782,Rotar; Vladimir,10,0,34,24
1657744663263,MATH 193A,A05,093482,Rotar; Vladimir,10,0,34,24
1657744669290,MATH 197,001,091859,McAuley; Julian John,9999,0,9999,0
1657744669290,MATH 197,002,095566,Kedlaya; Kiran S.,9997,0,9999,2
1657744669290,MATH 197,003,095567,Xiao; Ming,9999,0,9999,0
1657744669290,MATH 197,004,095571,Perols; Johan Lars,9998,0,9999,1
1657744676360,COGS 9,A01,083615,Shannon; Kyle Michael,9,0,75,66
1657744682388,COGS 11,A01,083617,Boyle; Mary E. T.,23,0,48,25
1657744688413,COGS 13,A01,083071,Bastos; Amalia Pinkusfeld,11,0,71,60
1657744694440,COGS 14A,A01,092681,Semenuks; Arturs,5,1,100,95
1657744700464,COGS 14B,A01,083073,Cheng; Tzu-Han,6,0,63,57
1657744706491,COGS 17,A01,092677,Semenuks; Arturs,6,0,81,75
1657744712512,COGS 100,A01,083619,Allen; Michael Gordon,17,0,70,53
1657744718540,COGS 101A,A01,083621,Davis; Joshua Daniel,9,0,68,59
1657744724565,COGS 101B,A01,091572,Allen; Michael Gordon,12,0,65,53
1657744730595,COGS 101C,A01,083625,Delgado; Tania,17,0,35,18
1657744736618,COGS 107A,A01,083627,Boyle; Mary E. T.,13,0,60,47
1657744742640,COGS 118A,A01,083075,Gupta; Anjum,21,0,76,55
1657744748668,CSE 3,A50,083646,Miranda; Gregory Joseph,24,0,50,26
1657744754692,CSE 8A,A50,083650,Miranda; Gregory Joseph,17,1,56,39
1657744760724,CSE 11,A01,083080,Cao; Yingjun,6,15,40,34
1657744766748,CSE 12,A01,083652,Krause-Levy; Sophia Louisa,28,1,120,92
1657744772770,CSE 15L,A01,083654,Morris; Justin Loren,9,0,50,41
1657744772770,CSE 15L,A02,083655,Morris; Justin Loren,9,0,50,41
1657744778793,CSE 20,A01,083657,Tran; Khoa Dang,39,0,80,41
1657744784818,CSE 21,A01,095574,Bach; Quang Tran,22,0,48,26
1657744790842,CSE 30,A01,083084,Eldon; John,6,0,80,74
1657744790842,CSE 30,B01,095061,Bhaskar; Nishant,9,0,50,41
1657744796866,CSE 100,A01,083659,Cao; Yingjun,5,4,70,65
1657744802891,CSE 134B,A01,083661,Powell; Thomas Allan,24,0,100,76
1657744808929,CSE 140,A01,083663,Gungor; Onat,15,0,85,70
1657744814963,CSE 140L,A01,083088,Eldon; John,23,0,100,77
1657744820991,CSE 175,A01,083665,Kumar; Rakesh,3,0,25,22
1657744827017,CSE 190,A00,092507,Dubnov; Shlomo,8,0,20,12
1657744833048,ECE 45,A01,083139,Congero; Spencer William,6,0,75,69
1657744839076,ECE 65,A50,083695,Saad; Andrew S,12,0,30,18
1657744839076,ECE 65,A51,095125,Saad; Andrew S,24,0,26,2
1657744845098,ECE 109,A01,091882,Touri; Behrouz,20,0,70,50
1657744851124,ECE 180,A00,083140,Abi Samra; Nicholas Camill,1,0,30,29
1657744851124,ECE 180,B00,083141,Abi Samra; Nicholas Camill,0,0,30,30
1657744857150,MATH 10A,A01,083735,Patchell; Gregory David,2,0,30,28
1657744857150,MATH 10A,A02,083736,Patchell; Gregory David,20,0,30,10
1657744857150,MATH 10A,A03,083737,Patchell; Gregory David,16,0,30,14
1657744863177,MATH 10B,A01,083207,Lim; Seonhee,8,0,34,26
1657744863177,MATH 10B,A02,083208,Lim; Seonhee,9,0,35,26
1657744863177,MATH 10B,A03,093472,Lim; Seonhee,7,0,34,27
1657744863177,MATH 10B,B01,083739,Sinha; Shubham,13,0,30,17
1657744869212,MATH 18,A01,083743,Cinel; Cameron Alexander,9,0,30,21
1657744869212,MATH 18,A02,083744,Cinel; Cameron Alexander,18,0,30,12
1657744869212,MATH 18,A03,083745,Cinel; Cameron Alexander,10,0,30,20
1657744869212,MATH 18,B01,083748,Rideout; David Porter,5,0,37,32
1657744869212,MATH 18,B02,083749,Rideout; David Porter,5,0,36,31
1657744869212,MATH 18,B03,083750,Rideout; David Porter,3,0,37,34
1657744869212,MATH 18,B04,083751,Rideout; David Porter,6,0,36,30
1657744869212,MATH 18,B05,093473,Rideout; David Porter,6,0,36,30
1657744869212,MATH 18,B06,093474,Rideout; David Porter,6,0,36,30
1657744875240,MATH 20A,A01,083754,Zheng; Zequn,14,0,40,26
1657744881269,MATH 20B,A01,083756,Briones; Jor-el Thomas Caparas,4,0,36,32
1657744881269,MATH 20B,A02,083757,Briones; Jor-el Thomas Caparas,1,0,36,35
1657744881269,MATH 20B,A03,093475,Briones; Jor-el Thomas Caparas,2,0,36,34
1657744887298,MATH 20C,A01,083760,Briones; Jor-el Thomas Caparas,1,0,35,34
1657744887298,MATH 20C,A02,083761,Briones; Jor-el Thomas Caparas,8,0,35,27
1657744887298,MATH 20C,A03,093476,Briones; Jor-el Thomas Caparas,0,1,36,36
1657744887298,MATH 20C,B01,083762,Bach; Quang Tran,1,0,30,29
1657744893341,MATH 20D,A01,083765,Tran; Brian Kha,5,0,30,25
1657744893341,MATH 20D,A02,083766,Tran; Brian Kha,5,0,30,25
1657744893341,MATH 20D,A03,083767,Tran; Brian Kha,5,0,30,25
1657744899364,MATH 20E,A01,083771,Ganguly; Soumya,9,0,32,23
1657744899364,MATH 20E,A02,083772,Ganguly; Soumya,6,0,32,26
1657744899364,MATH 20E,B01,083773,Ciotti; Benjamin,20,0,35,15
1657744899364,MATH 20E,B02,083774,Ciotti; Benjamin,18,0,35,17
1657744905484,MATH 103A,A01,083777,Greenfeld; Be'Eri,3,0,36,33
1657744905484,MATH 103A,A02,083778,Greenfeld; Be'Eri,5,0,36,31
1657744905484,MATH 103A,A03,093561,Greenfeld; Be'Eri,6,0,36,30
1657744905484,MATH 103A,B01,083779,Greenfeld; Be'Eri,7,0,36,29
1657744905484,MATH 103A,B02,083780,Greenfeld; Be'Eri,4,0,36,32
1657744905484,MATH 103A,B03,093562,Greenfeld; Be'Eri,3,0,36,33
1657744911507,MATH 105,A01,085443,Carter; Anne Toulson,15,0,35,20
1657744911507,MATH 105,A02,093477,Carter; Anne Toulson,20,0,35,15
1657744917532,MATH 109,A01,083213,Ganzberger; Geoffrey Michael,3,0,34,31
1657744917532,MATH 109,A02,083214,Ganzberger; Geoffrey Michael,4,0,34,30
1657744917532,MATH 109,A03,093478,Ganzberger; Geoffrey Michael,2,0,34,32
1657744917532,MATH 109,B01,083215,Ganzberger; Geoffrey Michael,1,0,32,31
1657744917532,MATH 109,B02,083216,Ganzberger; Geoffrey Michael,2,0,32,30
1657744917532,MATH 109,B03,093479,Ganzberger; Geoffrey Michael,8,0,32,24
1657744923556,MATH 142A,A01,083219,Chow; Bennett,7,0,32,25
1657744923556,MATH 142A,A02,083220,Chow; Bennett,10,0,32,22
1657744923556,MATH 142A,A03,093480,Chow; Bennett,9,0,32,23
1657744923556,MATH 142A,B03,093481,Chow; Bennett,8,0,32,24
1657744923556,MATH 142A,B04,093558,Chow; Bennett,13,0,32,19
1657744923556,MATH 142A,B05,093559,Chow; Bennett,6,0,32,26
1657744929595,MATH 193A,A01,083224,Rotar; Vladimir,8,0,34,26
1657744929595,MATH 193A,A02,083225,Rotar; Vladimir,9,0,34,25
1657744929595,MATH 193A,A03,083781,Rotar; Vladimir,5,0,34,29
1657744929595,MATH 193A,A04,083782,Rotar; Vladimir,10,0,34,24
1657744929595,MATH 193A,A05,093482,Rotar; Vladimir,10,0,34,24
1657744935622,MATH 197,001,091859,McAuley; Julian John,9999,0,9999,0
1657744935622,MATH 197,002,095566,Kedlaya; Kiran S.,9997,0,9999,2
1657744935622,MATH 197,003,095567,Xiao; Ming,9999,0,9999,0
1657744935622,MATH 197,004,095571,Perols; Johan Lars,9998,0,9999,1
1657744942679,COGS 9,A01,083615,Shannon; Kyle Michael,9,0,75,66
1657744948704,COGS 11,A01,083617,Boyle; Mary E. T.,23,0,48,25
1657744954732,COGS 13,A01,083071,Bastos; Amalia Pinkusfeld,11,0,71,60
1657744960755,COGS 14A,A01,092681,Semenuks; Arturs,5,1,100,95
1657744966788,COGS 14B,A01,083073,Cheng; Tzu-Han,6,0,63,57
1657744972815,COGS 17,A01,092677,Semenuks; Arturs,6,0,81,75
1657744978837,COGS 100,A01,083619,Allen; Michael Gordon,17,0,70,53
1657744984860,COGS 101A,A01,083621,Davis; Joshua Daniel,9,0,68,59
1657744990889,COGS 101B,A01,091572,Allen; Michael Gordon,12,0,65,53
1657744996911,COGS 101C,A01,083625,Delgado; Tania,17,0,35,18
1657745002933,COGS 107A,A01,083627,Boyle; Mary E. T.,13,0,60,47
1657745008969,COGS 118A,A01,083075,Gupta; Anjum,21,0,76,55
1657745014996,CSE 3,A50,083646,Miranda; Gregory Joseph,24,0,50,26
1657745021026,CSE 8A,A50,083650,Miranda; Gregory Joseph,17,1,56,39
1657745027052,CSE 11,A01,083080,Cao; Yingjun,6,15,40,34
1657745033086,CSE 12,A01,083652,Krause-Levy; Sophia Louisa,28,1,120,92
1657745039109,CSE 15L,A01,083654,Morris; Justin Loren,9,0,50,41
1657745039109,CSE 15L,A02,083655,Morris; Justin Loren,9,0,50,41
1657745045158,CSE 20,A01,083657,Tran; Khoa Dang,39,0,80,41
1657745051184,CSE 21,A01,095574,Bach; Quang Tran,22,0,48,26
1657745057212,CSE 30,A01,083084,Eldon; John,6,0,80,74
1657745057212,CSE 30,B01,095061,Bhaskar; Nishant,9,0,50,41
1657745063235,CSE 100,A01,083659,Cao; Yingjun,5,4,70,65
1657745069263,CSE 134B,A01,083661,Powell; Thomas Allan,24,0,100,76
1657745075286,CSE 140,A01,083663,Gungor; Onat,15,0,85,70
1657745081308,CSE 140L,A01,083088,Eldon; John,23,0,100,77
1657745087332,CSE 175,A01,083665,Kumar; Rakesh,3,0,25,22
1657745093355,CSE 190,A00,092507,Dubnov; Shlomo,8,0,20,12
1657745099388,ECE 45,A01,083139,Congero; Spencer William,6,0,75,69
1657745105411,ECE 65,A50,083695,Saad; Andrew S,12,0,30,18
1657745105411,ECE 65,A51,095125,Saad; Andrew S,24,0,26,2
1657745111433,ECE 109,A01,091882,Touri; Behrouz,20,0,70,50
1657745117459,ECE 180,A00,083140,Abi Samra; Nicholas Camill,1,0,30,29
1657745117459,ECE 180,B00,083141,Abi Samra; Nicholas Camill,0,0,30,30
1657745123486,MATH 10A,A01,083735,Patchell; Gregory David,2,0,30,28
1657745123486,MATH 10A,A02,083736,Patchell; Gregory David,20,0,30,10
1657745123486,MATH 10A,A03,083737,Patchell; Gregory David,16,0,30,14
1657745129513,MATH 10B,A01,083207,Lim; Seonhee,8,0,34,26
1657745129513,MATH 10B,A02,083208,Lim; Seonhee,9,0,35,26
1657745129513,MATH 10B,A03,093472,Lim; Seonhee,7,0,34,27
1657745129513,MATH 10B,B01,083739,Sinha; Shubham,13,0,30,17
1657745135550,MATH 18,A01,083743,Cinel; Cameron Alexander,9,0,30,21
1657745135550,MATH 18,A02,083744,Cinel; Cameron Alexander,18,0,30,12
1657745135550,MATH 18,A03,083745,Cinel; Cameron Alexander,10,0,30,20
1657745135550,MATH 18,B01,083748,Rideout; David Porter,5,0,37,32
1657745135550,MATH 18,B02,083749,Rideout; David Porter,5,0,36,31
1657745135550,MATH 18,B03,083750,Rideout; David Porter,3,0,37,34
1657745135550,MATH 18,B04,083751,Rideout; David Porter,6,0,36,30
1657745135550,MATH 18,B05,093473,Rideout; David Porter,6,0,36,30
1657745135550,MATH 18,B06,093474,Rideout; David Porter,6,0,36,30
1657745141574,MATH 20A,A01,083754,Zheng; Zequn,14,0,40,26
1657745147598,MATH 20B,A01,083756,Briones; Jor-el Thomas Caparas,4,0,36,32
1657745147598,MATH 20B,A02,083757,Briones; Jor-el Thomas Caparas,1,0,36,35
1657745147598,MATH 20B,A03,093475,Briones; Jor-el Thomas Caparas,2,0,36,34
1657745153622,MATH 20C,A01,083760,Briones; Jor-el Thomas Caparas,1,0,35,34
1657745153622,MATH 20C,A02,083761,Briones; Jor-el Thomas Caparas,8,0,35,27
1657745153622,MATH 20C,A03,093476,Briones; Jor-el Thomas Caparas,0,1,36,36
1657745153622,MATH 20C,B01,083762,Bach; Quang Tran,1,0,30,29
1657745159650,MATH 20D,A01,083765,Tran; Brian Kha,5,0,30,25
1657745159650,MATH 20D,A02,083766,Tran; Brian Kha,5,0,30,25
1657745159650,MATH 20D,A03,083767,Tran; Brian Kha,5,0,30,25
1657745165673,MATH 20E,A01,083771,Ganguly; Soumya,9,0,32,23
1657745165673,MATH 20E,A02,083772,Ganguly; Soumya,6,0,32,26
1657745165673,MATH 20E,B01,083773,Ciotti; Benjamin,20,0,35,15
1657745165673,MATH 20E,B02,083774,Ciotti; Benjamin,18,0,35,17
1657745171702,MATH 103A,A01,083777,Greenfeld; Be'Eri,3,0,36,33
1657745171702,MATH 103A,A02,083778,Greenfeld; Be'Eri,5,0,36,31
1657745171702,MATH 103A,A03,093561,Greenfeld; Be'Eri,6,0,36,30
1657745171702,MATH 103A,B01,083779,Greenfeld; Be'Eri,7,0,36,29
1657745171702,MATH 103A,B02,083780,Greenfeld; Be'Eri,4,0,36,32
1657745171702,MATH 103A,B03,093562,Greenfeld; Be'Eri,3,0,36,33
1657745177725,MATH 105,A01,085443,Carter; Anne Toulson,15,0,35,20
1657745177725,MATH 105,A02,093477,Carter; Anne Toulson,20,0,35,15
1657745183748,MATH 109,A01,083213,Ganzberger; Geoffrey Michael,3,0,34,31
1657745183748,MATH 109,A02,083214,Ganzberger; Geoffrey Michael,4,0,34,30
1657745183748,MATH 109,A03,093478,Ganzberger; Geoffrey Michael,2,0,34,32
1657745183748,MATH 109,B01,083215,Ganzberger; Geoffrey Michael,1,0,32,31
1657745183748,MATH 109,B02,083216,Ganzberger; Geoffrey Michael,2,0,32,30
1657745183748,MATH 109,B03,093479,Ganzberger; Geoffrey Michael,8,0,32,24
1657745189782,MATH 142A,A01,083219,Chow; Bennett,7,0,32,25
1657745189782,MATH 142A,A02,083220,Chow; Bennett,10,0,32,22
1657745189782,MATH 142A,A03,093480,Chow; Bennett,9,0,32,23
1657745189782,MATH 142A,B03,093481,Chow; Bennett,8,0,32,24
1657745189782,MATH 142A,B04,093558,Chow; Bennett,13,0,32,19
1657745189782,MATH 142A,B05,093559,Chow; Bennett,6,0,32,26
1657745195805,MATH 193A,A01,083224,Rotar; Vladimir,8,0,34,26
1657745195805,MATH 193A,A02,083225,Rotar; Vladimir,9,0,34,25
1657745195805,MATH 193A,A03,083781,Rotar; Vladimir,5,0,34,29
1657745195805,MATH 193A,A04,083782,Rotar; Vladimir,10,0,34,24
1657745195805,MATH 193A,A05,093482,Rotar; Vladimir,10,0,34,24
1657745201827,MATH 197,001,091859,McAuley; Julian John,9999,0,9999,0
1657745201827,MATH 197,002,095566,Kedlaya; Kiran S.,9997,0,9999,2
1657745201827,MATH 197,003,095567,Xiao; Ming,9999,0,9999,0
1657745201827,MATH 197,004,095571,Perols; Johan Lars,9998,0,9999,1
1657745208888,COGS 9,A01,083615,Shannon; Kyle Michael,9,0,75,66
1657745214924,COGS 11,A01,083617,Boyle; Mary E. T.,23,0,48,25
1657745220947,COGS 13,A01,083071,Bastos; Amalia Pinkusfeld,11,0,71,60
1657745226973,COGS 14A,A01,092681,Semenuks; Arturs,5,1,100,95
1657745232999,COGS 14B,A01,083073,Cheng; Tzu-Han,6,0,63,57
1657745239023,COGS 17,A01,092677,Semenuks; Arturs,6,0,81,75
1657745245046,COGS 100,A01,083619,Allen; Michael Gordon,17,0,70,53
1657745251068,COGS 101A,A01,083621,Davis; Joshua Daniel,9,0,68,59
1657745257092,COGS 101B,A01,091572,Allen; Michael Gordon,12,0,65,53
1657745263126,COGS 101C,A01,083625,Delgado; Tania,17,0,35,18
1657745269149,COGS 107A,A01,083627,Boyle; Mary E. T.,13,0,60,47
1657745275183,COGS 118A,A01,083075,Gupta; Anjum,21,0,76,55
1657745281209,CSE 3,A50,083646,Miranda; Gregory Joseph,24,0,50,26
1657745287233,CSE 8A,A50,083650,Miranda; Gregory Joseph,17,1,56,39
1657745293260,CSE 11,A01,083080,Cao; Yingjun,6,15,40,34
1657745299286,CSE 12,A01,083652,Krause-Levy; Sophia Louisa,28,1,120,92
1657745305322,CSE 15L,A01,083654,Morris; Justin Loren,9,0,50,41
1657745305322,CSE 15L,A02,083655,Morris; Justin Loren,9,0,50,41
1657745311344,CSE 20,A01,083657,Tran; Khoa Dang,39,0,80,41
1657745317368,CSE 21,A01,095574,Bach; Quang Tran,22,0,48,26
1657745323392,CSE 30,A01,083084,Eldon; John,6,0,80,74
1657745323392,CSE 30,B01,095061,Bhaskar; Nishant,9,0,50,41
1657745329416,CSE 100,A01,083659,Cao; Yingjun,5,4,70,65
1657745335442,CSE 134B,A01,083661,Powell; Thomas Allan,24,0,100,76
1657745341469,CSE 140,A01,083663,Gungor; Onat,15,0,85,70
1657745347494,CSE 140L,A01,083088,Eldon; John,23,0,100,77
1657745353520,CSE 175,A01,083665,Kumar; Rakesh,3,0,25,22
1657745359543,CSE 190,A00,092507,Dubnov; Shlomo,8,0,20,12
1657745365569,ECE 45,A01,083139,Congero; Spencer William,6,0,75,69
1657745371600,ECE 65,A50,083695,Saad; Andrew S,12,0,30,18
1657745371600,ECE 65,A51,095125,Saad; Andrew S,24,0,26,2
1657745377626,ECE 109,A01,091882,Touri; Behrouz,20,0,70,50
1657745383661,ECE 180,A00,083140,Abi Samra; Nicholas Camill,1,0,30,29
1657745383661,ECE 180,B00,083141,Abi Samra; Nicholas Camill,0,0,30,30
1657745389685,MATH 10A,A01,083735,Patchell; Gregory David,2,0,30,28
1657745389685,MATH 10A,A02,083736,Patchell; Gregory David,20,0,30,10
1657745389685,MATH 10A,A03,083737,Patchell; Gregory David,16,0,30,14
1657745395715,MATH 10B,A01,083207,Lim; Seonhee,8,0,34,26
1657745395715,MATH 10B,A02,083208,Lim; Seonhee,9,0,35,26
1657745395715,MATH 10B,A03,093472,Lim; Seonhee,7,0,34,27
1657745395715,MATH 10B,B01,083739,Sinha; Shubham,13,0,30,17
1657745401758,MATH 18,A01,083743,Cinel; Cameron Alexander,9,0,30,21
1657745401758,MATH 18,A02,083744,Cinel; Cameron Alexander,18,0,30,12
1657745401758,MATH 18,A03,083745,Cinel; Cameron Alexander,10,0,30,20
1657745401758,MATH 18,B01,083748,Rideout; David Porter,5,0,37,32
1657745401758,MATH 18,B02,083749,Rideout; David Porter,5,0,36,31
1657745401758,MATH 18,B03,083750,Rideout; David Porter,3,0,37,34
1657745401758,MATH 18,B04,083751,Rideout; David Porter,6,0,36,30
1657745401758,MATH 18,B05,093473,Rideout; David Porter,6,0,36,30
1657745401758,MATH 18,B06,093474,Rideout; David Porter,6,0,36,30
1657745407781,MATH 20A,A01,083754,Zheng; Zequn,14,0,40,26
1657745413807,MATH 20B,A01,083756,Briones; Jor-el Thomas Caparas,4,0,36,32
1657745413807,MATH 20B,A02,083757,Briones; Jor-el Thomas Caparas,1,0,36,35
1657745413807,MATH 20B,A03,093475,Briones; Jor-el Thomas Caparas,2,0,36,34
1657745419832,MATH 20C,A01,083760,Briones; Jor-el Thomas Caparas,1,0,35,34
1657745419832,MATH 20C,A02,083761,Briones; Jor-el Thomas Caparas,8,0,35,27
1657745419832,MATH 20C,A03,093476,Briones; Jor-el Thomas Caparas,0,1,36,36
1657745419832,MATH 20C,B01,083762,Bach; Quang Tran,1,0,30,29
1657745425856,MATH 20D,A01,083765,Tran; Brian Kha,5,0,30,25
1657745425856,MATH 20D,A02,083766,Tran; Brian Kha,5,0,30,25
1657745425856,MATH 20D,A03,083767,Tran; Brian Kha,5,0,30,25
1657745431890,MATH 20E,A01,083771,Ganguly; Soumya,9,0,32,23
1657745431890,MATH 20E,A02,083772,Ganguly; Soumya,6,0,32,26
1657745431890,MATH 20E,B01,083773,Ciotti; Benjamin,20,0,35,15
1657745431890,MATH 20E,B02,083774,Ciotti; Benjamin,18,0,35,17
1657745437912,MATH 103A,A01,083777,Greenfeld; Be'Eri,3,0,36,33
1657745437912,MATH 103A,A02,083778,Greenfeld; Be'Eri,5,0,36,31
1657745437912,MATH 103A,A03,093561,Greenfeld; Be'Eri,6,0,36,30
1657745437912,MATH 103A,B01,083779,Greenfeld; Be'Eri,7,0,36,29
1657745437912,MATH 103A,B02,083780,Greenfeld; Be'Eri,4,0,36,32
1657745437912,MATH 103A,B03,093562,Greenfeld; Be'Eri,3,0,36,33
1657745443941,MATH 105,A01,085443,Carter; Anne Toulson,15,0,35,20
1657745443941,MATH 105,A02,093477,Carter; Anne Toulson,20,0,35,15
1657745449966,MATH 109,A01,083213,Ganzberger; Geoffrey Michael,3,0,34,31
1657745449966,MATH 109,A02,083214,Ganzberger; Geoffrey Michael,4,0,34,30
1657745449966,MATH 109,A03,093478,Ganzberger; Geoffrey Michael,2,0,34,32
1657745449966,MATH 109,B01,083215,Ganzberger; Geoffrey Michael,1,0,32,31
1657745449966,MATH 109,B02,083216,Ganzberger; Geoffrey Michael,2,0,32,30
1657745449966,MATH 109,B03,093479,Ganzberger; Geoffrey Michael,8,0,32,24
1657745455995,MATH 142A,A01,083219,Chow; Bennett,7,0,32,25
1657745455995,MATH 142A,A02,083220,Chow; Bennett,10,0,32,22
1657745455995,MATH 142A,A03,093480,Chow; Bennett,9,0,32,23
1657745455995,MATH 142A,B03,093481,Chow; Bennett,8,0,32,24
1657745455995,MATH 142A,B04,093558,Chow; Bennett,13,0,32,19
1657745455995,MATH 142A,B05,093559,Chow; Bennett,6,0,32,26
1657745462018,MATH 193A,A01,083224,Rotar; Vladimir,8,0,34,26
1657745462018,MATH 193A,A02,083225,Rotar; Vladimir,9,0,34,25
1657745462018,MATH 193A,A03,083781,Rotar; Vladimir,5,0,34,29
1657745462018,MATH 193A,A04,083782,Rotar; Vladimir,10,0,34,24
1657745462018,MATH 193A,A05,093482,Rotar; Vladimir,10,0,34,24
1657745468043,MATH 197,001,091859,McAuley; Julian John,9999,0,9999,0
1657745468043,MATH 197,002,095566,Kedlaya; Kiran S.,9997,0,9999,2
1657745468043,MATH 197,003,095567,Xiao; Ming,9999,0,9999,0
1657745468043,MATH 197,004,095571,Perols; Johan Lars,9998,0,9999,1
1657745475092,COGS 9,A01,083615,Shannon; Kyle Michael,9,0,75,66
1657745481121,COGS 11,A01,083617,Boyle; Mary E. T.,23,0,48,25
1657745487145,COGS 13,A01,083071,Bastos; Amalia Pinkusfeld,11,0,71,60
1657745493167,COGS 14A,A01,092681,Semenuks; Arturs,5,1,100,95
1657745499285,COGS 14B,A01,083073,Cheng; Tzu-Han,6,0,63,57
1657745505321,COGS 17,A01,092677,Semenuks; Arturs,6,0,81,75
1657745511353,COGS 100,A01,083619,Allen; Michael Gordon,17,0,70,53
1657745517382,COGS 101A,A01,083621,Davis; Joshua Daniel,9,0,68,59
1657745523417,COGS 101B,A01,091572,Allen; Michael Gordon,12,0,65,53
1657745529445,COGS 101C,A01,083625,Delgado; Tania,17,0,35,18
1657745535468,COGS 107A,A01,083627,Boyle; Mary E. T.,13,0,60,47
1657745541492,COGS 118A,A01,083075,Gupta; Anjum,21,0,76,55
1657745547518,CSE 3,A50,083646,Miranda; Gregory Joseph,24,0,50,26
1657745553545,CSE 8A,A50,083650,Miranda; Gregory Joseph,17,1,56,39
1657745559567,CSE 11,A01,083080,Cao; Yingjun,6,15,40,34
1657745565590,CSE 12,A01,083652,Krause-Levy; Sophia Louisa,28,1,120,92
1657745571613,CSE 15L,A01,083654,Morris; Justin Loren,9,0,50,41
1657745571613,CSE 15L,A02,083655,Morris; Justin Loren,9,0,50,41
1657745577646,CSE 20,A01,083657,Tran; Khoa Dang,39,0,80,41
1657745583673,CSE 21,A01,095574,Bach; Quang Tran,22,0,48,26
1657745589698,CSE 30,A01,083084,Eldon; John,6,0,80,74
1657745589698,CSE 30,B01,095061,Bhaskar; Nishant,9,0,50,41
1657745595721,CSE 100,A01,083659,Cao; Yingjun,5,4,70,65
1657745601746,CSE 134B,A01,083661,Powell; Thomas Allan,24,0,100,76
1657745607781,CSE 140,A01,083663,Gungor; Onat,15,0,85,70
1657745613803,CSE 140L,A01,083088,Eldon; John,23,0,100,77
1657745619836,CSE 175,A01,083665,Kumar; Rakesh,3,0,25,22
1657745625861,CSE 190,A00,092507,Dubnov; Shlomo,8,0,20,12
1657745631888,ECE 45,A01,083139,Congero; Spencer William,6,0,75,69
1657745637928,ECE 65,A50,083695,Saad; Andrew S,12,0,30,18
1657745637928,ECE 65,A51,095125,Saad; Andrew S,24,0,26,2
1657745643954,ECE 109,A01,091882,Touri; Behrouz,20,0,70,50
1657745649978,ECE 180,A00,083140,Abi Samra; Nicholas Camill,1,0,30,29
1657745649978,ECE 180,B00,083141,Abi Samra; Nicholas Camill,0,0,30,30
1657745656004,MATH 10A,A01,083735,Patchell; Gregory David,2,0,30,28
1657745656004,MATH 10A,A02,083736,Patchell; Gregory David,20,0,30,10
1657745656004,MATH 10A,A03,083737,Patchell; Gregory David,16,0,30,14
1657745662035,MATH 10B,A01,083207,Lim; Seonhee,8,0,34,26
1657745662035,MATH 10B,A02,083208,Lim; Seonhee,9,0,35,26
1657745662035,MATH 10B,A03,093472,Lim; Seonhee,7,0,34,27
1657745662035,MATH 10B,B01,083739,Sinha; Shubham,13,0,30,17
1657745668077,MATH 18,A01,083743,Cinel; Cameron Alexander,9,0,30,21
1657745668077,MATH 18,A02,083744,Cinel; Cameron Alexander,18,0,30,12
1657745668077,MATH 18,A03,083745,Cinel; Cameron Alexander,10,0,30,20
1657745668077,MATH 18,B01,083748,Rideout; David Porter,5,0,37,32
1657745668077,MATH 18,B02,083749,Rideout; David Porter,5,0,36,31
1657745668077,MATH 18,B03,083750,Rideout; David Porter,3,0,37,34
1657745668077,MATH 18,B04,083751,Rideout; David Porter,6,0,36,30
1657745668077,MATH 18,B05,093473,Rideout; David Porter,6,0,36,30
1657745668077,MATH 18,B06,093474,Rideout; David Porter,6,0,36,30
1657745674110,MATH 20A,A01,083754,Zheng; Zequn,14,0,40,26
1657745680149,MATH 20B,A01,083756,Briones; Jor-el Thomas Caparas,4,0,36,32
1657745680149,MATH 20B,A02,083757,Briones; Jor-el Thomas Caparas,1,0,36,35
1657745680149,MATH 20B,A03,093475,Briones; Jor-el Thomas Caparas,2,0,36,34
1657745686188,MATH 20C,A01,083760,Briones; Jor-el Thomas Caparas,1,0,35,34
1657745686188,MATH 20C,A02,083761,Briones; Jor-el Thomas Caparas,8,0,35,27
1657745686188,MATH 20C,A03,093476,Briones; Jor-el Thomas Caparas,0,1,36,36
1657745686188,MATH 20C,B01,083762,Bach; Quang Tran,1,0,30,29
1657745692211,MATH 20D,A01,083765,Tran; Brian Kha,5,0,30,25
1657745692211,MATH 20D,A02,083766,Tran; Brian Kha,5,0,30,25
1657745692211,MATH 20D,A03,083767,Tran; Brian Kha,5,0,30,25
1657745698235,MATH 20E,A01,083771,Ganguly; Soumya,9,0,32,23
1657745698235,MATH 20E,A02,083772,Ganguly; Soumya,6,0,32,26
1657745698235,MATH 20E,B01,083773,Ciotti; Benjamin,20,0,35,15
1657745698235,MATH 20E,B02,083774,Ciotti; Benjamin,18,0,35,17
1657745704264,MATH 103A,A01,083777,Greenfeld; Be'Eri,3,0,36,33
1657745704264,MATH 103A,A02,083778,Greenfeld; Be'Eri,5,0,36,31
1657745704264,MATH 103A,A03,093561,Greenfeld; Be'Eri,6,0,36,30
1657745704264,MATH 103A,B01,083779,Greenfeld; Be'Eri,7,0,36,29
1657745704264,MATH 103A,B02,083780,Greenfeld; Be'Eri,4,0,36,32
1657745704264,MATH 103A,B03,093562,Greenfeld; Be'Eri,3,0,36,33
1657745710292,MATH 105,A01,085443,Carter; Anne Toulson,15,0,35,20
1657745710292,MATH 105,A02,093477,Carter; Anne Toulson,20,0,35,15
1657745716321,MATH 109,A01,083213,Ganzberger; Geoffrey Michael,3,0,34,31
1657745716321,MATH 109,A02,083214,Ganzberger; Geoffrey Michael,4,0,34,30
1657745716321,MATH 109,A03,093478,Ganzberger; Geoffrey Michael,2,0,34,32
1657745716321,MATH 109,B01,083215,Ganzberger; Geoffrey Michael,1,0,32,31
1657745716321,MATH 109,B02,083216,Ganzberger; Geoffrey Michael,2,0,32,30
1657745716321,MATH 109,B03,093479,Ganzberger; Geoffrey Michael,8,0,32,24
1657745722348,MATH 142A,A01,083219,Chow; Bennett,7,0,32,25
1657745722348,MATH 142A,A02,083220,Chow; Bennett,10,0,32,22
1657745722348,MATH 142A,A03,093480,Chow; Bennett,9,0,32,23
1657745722348,MATH 142A,B03,093481,Chow; Bennett,8,0,32,24
1657745722348,MATH 142A,B04,093558,Chow; Bennett,13,0,32,19
1657745722348,MATH 142A,B05,093559,Chow; Bennett,6,0,32,26
1657745728374,MATH 193A,A01,083224,Rotar; Vladimir,8,0,34,26
1657745728374,MATH 193A,A02,083225,Rotar; Vladimir,9,0,34,25
1657745728374,MATH 193A,A03,083781,Rotar; Vladimir,5,0,34,29
1657745728374,MATH 193A,A04,083782,Rotar; Vladimir,10,0,34,24
1657745728374,MATH 193A,A05,093482,Rotar; Vladimir,10,0,34,24
1657745734400,MATH 197,001,091859,McAuley; Julian John,9999,0,9999,0
1657745734400,MATH 197,002,095566,Kedlaya; Kiran S.,9997,0,9999,2
1657745734400,MATH 197,003,095567,Xiao; Ming,9999,0,9999,0
1657745734400,MATH 197,004,095571,Perols; Johan Lars,9998,0,9999,1
1657745741479,COGS 9,A01,083615,Shannon; Kyle Michael,9,0,75,66
1657745747504,COGS 11,A01,083617,Boyle; Mary E. T.,23,0,48,25
1657745753530,COGS 13,A01,083071,Bastos; Amalia Pinkusfeld,11,0,71,60
1657745759557,COGS 14A,A01,092681,Semenuks; Arturs,5,1,100,95
1657745765582,COGS 14B,A01,083073,Cheng; Tzu-Han,6,0,63,57
1657745771619,COGS 17,A01,092677,Semenuks; Arturs,6,0,81,75
1657745777642,COGS 100,A01,083619,Allen; Michael Gordon,17,0,70,53
1657745783665,COGS 101A,A01,083621,Davis; Joshua Daniel,9,0,68,59
1657745789687,COGS 101B,A01,091572,Allen; Michael Gordon,12,0,65,53
1657745795710,COGS 101C,A01,083625,Delgado; Tania,17,0,35,18
1657745801735,COGS 107A,A01,083627,Boyle; Mary E. T.,13,0,60,47
1657745807769,COGS 118A,A01,083075,Gupta; Anjum,21,0,76,55
1657745813801,CSE 3,A50,083646,Miranda; Gregory Joseph,24,0,50,26
1657745819827,CSE 8A,A50,083650,Miranda; Gregory Joseph,17,1,56,39
1657745825859,CSE 11,A01,083080,Cao; Yingjun,6,15,40,34
1657745831882,CSE 12,A01,083652,Krause-Levy; Sophia Louisa,28,1,120,92
1657745837904,CSE 15L,A01,083654,Morris; Justin Loren,9,0,50,41
1657745837904,CSE 15L,A02,083655,Morris; Justin Loren,9,0,50,41
1657745843929,CSE 20,A01,083657,Tran; Khoa Dang,39,0,80,41
1657745849968,CSE 21,A01,095574,Bach; Quang Tran,22,0,48,26
1657745855995,CSE 30,A01,083084,Eldon; John,6,0,80,74
1657745855995,CSE 30,B01,095061,Bhaskar; Nishant,9,0,50,41
1657745862017,CSE 100,A01,083659,Cao; Yingjun,5,4,70,65
1657745868040,CSE 134B,A01,083661,Powell; Thomas Allan,24,0,100,76
1657745874062,CSE 140,A01,083663,Gungor; Onat,15,0,85,70
1657745880087,CSE 140L,A01,083088,Eldon; John,23,0,100,77
1657745886118,CSE 175,A01,083665,Kumar; Rakesh,3,0,25,22
1657745892144,CSE 190,A00,092507,Dubnov; Shlomo,8,0,20,12
1657745898181,ECE 45,A01,083139,Congero; Spencer William,6,0,75,69
1657745904205,ECE 65,A50,083695,Saad; Andrew S,12,0,30,18
1657745904205,ECE 65,A51,095125,Saad; Andrew S,24,0,26,2
1657745910227,ECE 109,A01,091882,Touri; Behrouz,20,0,70,50
1657745916255,ECE 180,A00,083140,Abi Samra; Nicholas Camill,1,0,30,29
1657745916255,ECE 180,B00,083141,Abi Samra; Nicholas Camill,0,0,30,30
1657745922279,MATH 10A,A01,083735,Patchell; Gregory David,2,0,30,28
1657745922279,MATH 10A,A02,083736,Patchell; Gregory David,20,0,30,10
1657745922279,MATH 10A,A03,083737,Patchell; Gregory David,16,0,30,14
1657745928303,MATH 10B,A01,083207,Lim; Seonhee,8,0,34,26
1657745928303,MATH 10B,A02,083208,Lim; Seonhee,9,0,35,26
1657745928303,MATH 10B,A03,093472,Lim; Seonhee,7,0,34,27
1657745928303,MATH 10B,B01,083739,Sinha; Shubham,13,0,30,17
1657745934333,MATH 18,A01,083743,Cinel; Cameron Alexander,9,0,30,21
1657745934333,MATH 18,A02,083744,Cinel; Cameron Alexander,18,0,30,12
1657745934333,MATH 18,A03,083745,Cinel; Cameron Alexander,10,0,30,20
1657745934333,MATH 18,B01,083748,Rideout; David Porter,5,0,37,32
1657745934333,MATH 18,B02,083749,Rideout; David Porter,5,0,36,31
1657745934333,MATH 18,B03,083750,Rideout; David Porter,3,0,37,34
1657745934333,MATH 18,B04,083751,Rideout; David Porter,6,0,36,30
1657745934333,MATH 18,B05,093473,Rideout; David Porter,6,0,36,30
1657745934333,MATH 18,B06,093474,Rideout; David Porter,6,0,36,30
1657745940365,MATH 20A,A01,083754,Zheng; Zequn,14,0,40,26
1657745946392,MATH 20B,A01,083756,Briones; Jor-el Thomas Caparas,4,0,36,32
1657745946392,MATH 20B,A02,083757,Briones; Jor-el Thomas Caparas,1,0,36,35
1657745946392,MATH 20B,A03,093475,Briones; Jor-el Thomas Caparas,2,0,36,34
1657745952435,MATH 20C,A01,083760,Briones; Jor-el Thomas Caparas,1,0,35,34
1657745952435,MATH 20C,A02,083761,Briones; Jor-el Thomas Caparas,8,0,35,27
1657745952435,MATH 20C,A03,093476,Briones; Jor-el Thomas Caparas,0,1,36,36
1657745952435,MATH 20C,B01,083762,Bach; Quang Tran,1,0,30,29
1657745958459,MATH 20D,A01,083765,Tran; Brian Kha,5,0,30,25
1657745958459,MATH 20D,A02,083766,Tran; Brian Kha,5,0,30,25
1657745958459,MATH 20D,A03,083767,Tran; Brian Kha,5,0,30,25
1657745964490,MATH 20E,A01,083771,Ganguly; Soumya,9,0,32,23
1657745964490,MATH 20E,A02,083772,Ganguly; Soumya,6,0,32,26
1657745964490,MATH 20E,B01,083773,Ciotti; Benjamin,20,0,35,15
1657745964490,MATH 20E,B02,083774,Ciotti; Benjamin,18,0,35,17
1657745970513,MATH 103A,A01,083777,Greenfeld; Be'Eri,3,0,36,33
1657745970513,MATH 103A,A02,083778,Greenfeld; Be'Eri,5,0,36,31
1657745970513,MATH 103A,A03,093561,Greenfeld; Be'Eri,6,0,36,30
1657745970513,MATH 103A,B01,083779,Greenfeld; Be'Eri,7,0,36,29
1657745970513,MATH 103A,B02,083780,Greenfeld; Be'Eri,4,0,36,32
1657745970513,MATH 103A,B03,093562,Greenfeld; Be'Eri,3,0,36,33
1657745976550,MATH 105,A01,085443,Carter; Anne Toulson,15,0,35,20
1657745976550,MATH 105,A02,093477,Carter; Anne Toulson,20,0,35,15
1657745982584,MATH 109,A01,083213,Ganzberger; Geoffrey Michael,3,0,34,31
1657745982584,MATH 109,A02,083214,Ganzberger; Geoffrey Michael,4,0,34,30
1657745982584,MATH 109,A03,093478,Ganzberger; Geoffrey Michael,2,0,34,32
1657745982584,MATH 109,B01,083215,Ganzberger; Geoffrey Michael,1,0,32,31
1657745982584,MATH 109,B02,083216,Ganzberger; Geoffrey Michael,2,0,32,30
1657745982584,MATH 109,B03,093479,Ganzberger; Geoffrey Michael,8,0,32,24
1657745988605,MATH 142A,A01,083219,Chow; Bennett,7,0,32,25
1657745988605,MATH 142A,A02,083220,Chow; Bennett,10,0,32,22
1657745988605,MATH 142A,A03,093480,Chow; Bennett,9,0,32,23
1657745988605,MATH 142A,B03,093481,Chow; Bennett,8,0,32,24
1657745988605,MATH 142A,B04,093558,Chow; Bennett,13,0,32,19
1657745988605,MATH 142A,B05,093559,Chow; Bennett,6,0,32,26
1657745994636,MATH 193A,A01,083224,Rotar; Vladimir,8,0,34,26
1657745994636,MATH 193A,A02,083225,Rotar; Vladimir,9,0,34,25
1657745994636,MATH 193A,A03,083781,Rotar; Vladimir,5,0,34,29
1657745994636,MATH 193A,A04,083782,Rotar; Vladimir,10,0,34,24
1657745994636,MATH 193A,A05,093482,Rotar; Vladimir,10,0,34,24
1657746000662,MATH 197,001,091859,McAuley; Julian John,9999,0,9999,0
1657746000662,MATH 197,002,095566,Kedlaya; Kiran S.,9997,0,9999,2
1657746000662,MATH 197,003,095567,Xiao; Ming,9999,0,9999,0
1657746000662,MATH 197,004,095571,Perols; Johan Lars,9998,0,9999,1
1657746007714,COGS 9,A01,083615,Shannon; Kyle Michael,9,0,75,66
1657746013738,COGS 11,A01,083617,Boyle; Mary E. T.,23,0,48,25
1657746019773,COGS 13,A01,083071,Bastos; Amalia Pinkusfeld,11,0,71,60
1657746025798,COGS 14A,A01,092681,Semenuks; Arturs,5,1,100,95
1657746031825,COGS 14B,A01,083073,Cheng; Tzu-Han,6,0,63,57
1657746037860,COGS 17,A01,092677,Semenuks; Arturs,6,0,81,75
1657746043882,COGS 100,A01,083619,Allen; Michael Gordon,17,0,70,53
1657746049905,COGS 101A,A01,083621,Davis; Joshua Daniel,9,0,68,59
1657746055931,COGS 101B,A01,091572,Allen; Michael Gordon,12,0,65,53
1657746061953,COGS 101C,A01,083625,Delgado; Tania,17,0,35,18
1657746067974,COGS 107A,A01,083627,Boyle; Mary E. T.,13,0,60,47
1657746074010,COGS 118A,A01,083075,Gupta; Anjum,21,0,76,55
1657746080032,CSE 3,A50,083646,Miranda; Gregory Joseph,24,0,50,26
1657746086054,CSE 8A,A50,083650,Miranda; Gregory Joseph,17,1,56,39
1657746092077,CSE 11,A01,083080,Cao; Yingjun,6,15,40,34
1657746098184,CSE 12,A01,083652,Krause-Levy; Sophia Louisa,28,1,120,92
1657746104209,CSE 15L,A01,083654,Morris; Justin Loren,9,0,50,41
1657746104209,CSE 15L,A02,083655,Morris; Justin Loren,9,0,50,41
1657746110235,CSE 20,A01,083657,Tran; Khoa Dang,39,0,80,41
1657746116261,CSE 21,A01,095574,Bach; Quang Tran,22,0,48,26
1657746122282,CSE 30,A01,083084,Eldon; John,6,0,80,74
1657746122282,CSE 30,B01,095061,Bhaskar; Nishant,9,0,50,41
1657746128310,CSE 100,A01,083659,Cao; Yingjun,5,4,70,65
1657746134337,CSE 134B,A01,083661,Powell; Thomas Allan,24,0,100,76
1657746140359,CSE 140,A01,083663,Gungor; Onat,15,0,85,70
1657746146382,CSE 140L,A01,083088,Eldon; John,23,0,100,77
1657746152413,CSE 175,A01,083665,Kumar; Rakesh,3,0,25,22
1657746158437,CSE 190,A00,092507,Dubnov; Shlomo,8,0,20,12
1657746164459,ECE 45,A01,083139,Congero; Spencer William,6,0,75,69
1657746170488,ECE 65,A50,083695,Saad; Andrew S,12,0,30,18
1657746170488,ECE 65,A51,095125,Saad; Andrew S,24,0,26,2
1657746176514,ECE 109,A01,091882,Touri; Behrouz,20,0,70,50
1657746182542,ECE 180,A00,083140,Abi Samra; Nicholas Camill,1,0,30,29
1657746182542,ECE 180,B00,083141,Abi Samra; Nicholas Camill,0,0,30,30
1657746188564,MATH 10A,A01,083735,Patchell; Gregory David,2,0,30,28
1657746188564,MATH 10A,A02,083736,Patchell; Gregory David,20,0,30,10
1657746188564,MATH 10A,A03,083737,Patchell; Gregory David,16,0,30,14
1657746194590,MATH 10B,A01,083207,Lim; Seonhee,8,0,34,26
1657746194590,MATH 10B,A02,083208,Lim; Seonhee,9,0,35,26
1657746194590,MATH 10B,A03,093472,Lim; Seonhee,7,0,34,27
1657746194590,MATH 10B,B01,083739,Sinha; Shubham,13,0,30,17
1657746200620,MATH 18,A01,083743,Cinel; Cameron Alexander,9,0,30,21
1657746200620,MATH 18,A02,083744,Cinel; Cameron Alexander,18,0,30,12
1657746200620,MATH 18,A03,083745,Cinel; Cameron Alexander,10,0,30,20
1657746200620,MATH 18,B01,083748,Rideout; David Porter,5,0,37,32
1657746200620,MATH 18,B02,083749,Rideout; David Porter,5,0,36,31
1657746200620,MATH 18,B03,083750,Rideout; David Porter,3,0,37,34
1657746200620,MATH 18,B04,083751,Rideout; David Porter,6,0,36,30
1657746200620,MATH 18,B05,093473,Rideout; David Porter,6,0,36,30
1657746200620,MATH 18,B06,093474,Rideout; David Porter,6,0,36,30
1657746206643,MATH 20A,A01,083754,Zheng; Zequn,14,0,40,26
1657746212671,MATH 20B,A01,083756,Briones; Jor-el Thomas Caparas,4,0,36,32
1657746212671,MATH 20B,A02,083757,Briones; Jor-el Thomas Caparas,1,0,36,35
1657746212671,MATH 20B,A03,093475,Briones; Jor-el Thomas Caparas,2,0,36,34
1657746218696,MATH 20C,A01,083760,Briones; Jor-el Thomas Caparas,1,0,35,34
1657746218696,MATH 20C,A02,083761,Briones; Jor-el Thomas Caparas,8,0,35,27
1657746218696,MATH 20C,A03,093476,Briones; Jor-el Thomas Caparas,0,1,36,36
1657746218696,MATH 20C,B01,083762,Bach; Quang Tran,1,0,30,29
1657746224733,MATH 20D,A01,083765,Tran; Brian Kha,5,0,30,25
1657746224733,MATH 20D,A02,083766,Tran; Brian Kha,5,0,30,25
1657746224733,MATH 20D,A03,083767,Tran; Brian Kha,5,0,30,25
1657746230765,MATH 20E,A01,083771,Ganguly; Soumya,9,0,32,23
1657746230765,MATH 20E,A02,083772,Ganguly; Soumya,6,0,32,26
1657746230765,MATH 20E,B01,083773,Ciotti; Benjamin,20,0,35,15
1657746230765,MATH 20E,B02,083774,Ciotti; Benjamin,18,0,35,17
1657746236794,MATH 103A,A01,083777,Greenfeld; Be'Eri,3,0,36,33
1657746236794,MATH 103A,A02,083778,Greenfeld; Be'Eri,5,0,36,31
1657746236794,MATH 103A,A03,093561,Greenfeld; Be'Eri,6,0,36,30
1657746236794,MATH 103A,B01,083779,Greenfeld; Be'Eri,7,0,36,29
1657746236794,MATH 103A,B02,083780,Greenfeld; Be'Eri,4,0,36,32
1657746236794,MATH 103A,B03,093562,Greenfeld; Be'Eri,3,0,36,33
1657746242821,MATH 105,A01,085443,Carter; Anne Toulson,15,0,35,20
1657746242821,MATH 105,A02,093477,Carter; Anne Toulson,20,0,35,15
1657746248848,MATH 109,A01,083213,Ganzberger; Geoffrey Michael,3,0,34,31
1657746248848,MATH 109,A02,083214,Ganzberger; Geoffrey Michael,4,0,34,30
1657746248848,MATH 109,A03,093478,Ganzberger; Geoffrey Michael,2,0,34,32
1657746248848,MATH 109,B01,083215,Ganzberger; Geoffrey Michael,1,0,32,31
1657746248848,MATH 109,B02,083216,Ganzberger; Geoffrey Michael,2,0,32,30
1657746248848,MATH 109,B03,093479,Ganzberger; Geoffrey Michael,8,0,32,24
1657746254873,MATH 142A,A01,083219,Chow; Bennett,7,0,32,25
1657746254873,MATH 142A,A02,083220,Chow; Bennett,10,0,32,22
1657746254873,MATH 142A,A03,093480,Chow; Bennett,9,0,32,23
1657746254873,MATH 142A,B03,093481,Chow; Bennett,8,0,32,24
1657746254873,MATH 142A,B04,093558,Chow; Bennett,13,0,32,19
1657746254873,MATH 142A,B05,093559,Chow; Bennett,6,0,32,26
1657746260908,MATH 193A,A01,083224,Rotar; Vladimir,8,0,34,26
1657746260908,MATH 193A,A02,083225,Rotar; Vladimir,9,0,34,25
1657746260908,MATH 193A,A03,083781,Rotar; Vladimir,5,0,34,29
1657746260908,MATH 193A,A04,083782,Rotar; Vladimir,10,0,34,24
1657746260908,MATH 193A,A05,093482,Rotar; Vladimir,10,0,34,24
1657746266937,MATH 197,001,091859,McAuley; Julian John,9999,0,9999,0
1657746266937,MATH 197,002,095566,Kedlaya; Kiran S.,9997,0,9999,2
1657746266937,MATH 197,003,095567,Xiao; Ming,9999,0,9999,0
1657746266937,MATH 197,004,095571,Perols; Johan Lars,9998,0,9999,1
1657746273994,COGS 9,A01,083615,Shannon; Kyle Michael,9,0,75,66
1657746280023,COGS 11,A01,083617,Boyle; Mary E. T.,23,0,48,25
1657746286046,COGS 13,A01,083071,Bastos; Amalia Pinkusfeld,11,0,71,60
1657746292078,COGS 14A,A01,092681,Semenuks; Arturs,5,1,100,95
1657746298117,COGS 14B,A01,083073,Cheng; Tzu-Han,6,0,63,57
1657746304139,COGS 17,A01,092677,Semenuks; Arturs,6,0,81,75
1657746310162,COGS 100,A01,083619,Allen; Michael Gordon,17,0,70,53
1657746316187,COGS 101A,A01,083621,Davis; Joshua Daniel,9,0,68,59
1657746322211,COGS 101B,A01,091572,Allen; Michael Gordon,12,0,65,53
1657746328234,COGS 101C,A01,083625,Delgado; Tania,17,0,35,18
1657746334257,COGS 107A,A01,083627,Boyle; Mary E. T.,13,0,60,47
1657746340280,COGS 118A,A01,083075,Gupta; Anjum,21,0,76,55
1657746346310,CSE 3,A50,083646,Miranda; Gregory Joseph,24,0,50,26
1657746352338,CSE 8A,A50,083650,Miranda; Gregory Joseph,17,1,56,39
1657746358361,CSE 11,A01,083080,Cao; Yingjun,6,15,40,34
1657746364390,CSE 12,A01,083652,Krause-Levy; Sophia Louisa,28,1,120,92
1657746370414,CSE 15L,A01,083654,Morris; Justin Loren,9,0,50,41
1657746370414,CSE 15L,A02,083655,Morris; Justin Loren,9,0,50,41
1657746376452,CSE 20,A01,083657,Tran; Khoa Dang,39,0,80,41
1657746382492,CSE 21,A01,095574,Bach; Quang Tran,22,0,48,26
1657746388524,CSE 30,A01,083084,Eldon; John,6,0,80,74
1657746388524,CSE 30,B01,095061,Bhaskar; Nishant,9,0,50,41
1657746394551,CSE 100,A01,083659,Cao; Yingjun,5,4,70,65
1657746400576,CSE 134B,A01,083661,Powell; Thomas Allan,24,0,100,76
1657746406608,CSE 140,A01,083663,Gungor; Onat,15,0,85,70
1657746412631,CSE 140L,A01,083088,Eldon; John,23,0,100,77
1657746418654,CSE 175,A01,083665,Kumar; Rakesh,3,0,25,22
1657746424689,CSE 190,A00,092507,Dubnov; Shlomo,8,0,20,12
1657746430711,ECE 45,A01,083139,Congero; Spencer William,6,0,75,69
1657746436734,ECE 65,A50,083695,Saad; Andrew S,12,0,30,18
1657746436734,ECE 65,A51,095125,Saad; Andrew S,24,0,26,2
1657746442758,ECE 109,A01,091882,Touri; Behrouz,20,0,70,50
1657746448784,ECE 180,A00,083140,Abi Samra; Nicholas Camill,1,0,30,29
1657746448784,ECE 180,B00,083141,Abi Samra; Nicholas Camill,0,0,30,30
1657746454816,MATH 10A,A01,083735,Patchell; Gregory David,2,0,30,28
1657746454816,MATH 10A,A02,083736,Patchell; Gregory David,20,0,30,10
1657746454816,MATH 10A,A03,083737,Patchell; Gregory David,16,0,30,14
1657746460843,MATH 10B,A01,083207,Lim; Seonhee,8,0,34,26
1657746460843,MATH 10B,A02,083208,Lim; Seonhee,9,0,35,26
1657746460843,MATH 10B,A03,093472,Lim; Seonhee,7,0,34,27
1657746460843,MATH 10B,B01,083739,Sinha; Shubham,13,0,30,17
1657746466868,MATH 18,A01,083743,Cinel; Cameron Alexander,9,0,30,21
1657746466868,MATH 18,A02,083744,Cinel; Cameron Alexander,18,0,30,12
1657746466868,MATH 18,A03,083745,Cinel; Cameron Alexander,10,0,30,20
1657746466868,MATH 18,B01,083748,Rideout; David Porter,5,0,37,32
1657746466868,MATH 18,B02,083749,Rideout; David Porter,5,0,36,31
1657746466868,MATH 18,B03,083750,Rideout; David Porter,3,0,37,34
1657746466868,MATH 18,B04,083751,Rideout; David Porter,6,0,36,30
1657746466868,MATH 18,B05,093473,Rideout; David Porter,6,0,36,30
1657746466868,MATH 18,B06,093474,Rideout; David Porter,6,0,36,30
1657746472894,MATH 20A,A01,083754,Zheng; Zequn,14,0,40,26
1657746478929,MATH 20B,A01,083756,Briones; Jor-el Thomas Caparas,4,0,36,32
1657746478929,MATH 20B,A02,083757,Briones; Jor-el Thomas Caparas,1,0,36,35
1657746478929,MATH 20B,A03,093475,Briones; Jor-el Thomas Caparas,2,0,36,34
1657746484961,MATH 20C,A01,083760,Briones; Jor-el Thomas Caparas,1,0,35,34
1657746484961,MATH 20C,A02,083761,Briones; Jor-el Thomas Caparas,8,0,35,27
1657746484961,MATH 20C,A03,093476,Briones; Jor-el Thomas Caparas,0,1,36,36
1657746484961,MATH 20C,B01,083762,Bach; Quang Tran,1,0,30,29
1657746490988,MATH 20D,A01,083765,Tran; Brian Kha,5,0,30,25
1657746490988,MATH 20D,A02,083766,Tran; Brian Kha,5,0,30,25
1657746490988,MATH 20D,A03,083767,Tran; Brian Kha,5,0,30,25
1657746497010,MATH 20E,A01,083771,Ganguly; Soumya,9,0,32,23
1657746497010,MATH 20E,A02,083772,Ganguly; Soumya,6,0,32,26
1657746497010,MATH 20E,B01,083773,Ciotti; Benjamin,20,0,35,15
1657746497010,MATH 20E,B02,083774,Ciotti; Benjamin,18,0,35,17
1657746503049,MATH 103A,A01,083777,Greenfeld; Be'Eri,3,0,36,33
1657746503049,MATH 103A,A02,083778,Greenfeld; Be'Eri,5,0,36,31
1657746503049,MATH 103A,A03,093561,Greenfeld; Be'Eri,6,0,36,30
1657746503049,MATH 103A,B01,083779,Greenfeld; Be'Eri,7,0,36,29
1657746503049,MATH 103A,B02,083780,Greenfeld; Be'Eri,4,0,36,32
1657746503049,MATH 103A,B03,093562,Greenfeld; Be'Eri,3,0,36,33
1657746509072,MATH 105,A01,085443,Carter; Anne Toulson,15,0,35,20
1657746509072,MATH 105,A02,093477,Carter; Anne Toulson,20,0,35,15
1657746515096,MATH 109,A01,083213,Ganzberger; Geoffrey Michael,3,0,34,31
1657746515096,MATH 109,A02,083214,Ganzberger; Geoffrey Michael,4,0,34,30
1657746515096,MATH 109,A03,093478,Ganzberger; Geoffrey Michael,2,0,34,32
1657746515096,MATH 109,B01,083215,Ganzberger; Geoffrey Michael,1,0,32,31
1657746515096,MATH 109,B02,083216,Ganzberger; Geoffrey Michael,2,0,32,30
1657746515096,MATH 109,B03,093479,Ganzberger; Geoffrey Michael,8,0,32,24
1657746521124,MATH 142A,A01,083219,Chow; Bennett,7,0,32,25
1657746521124,MATH 142A,A02,083220,Chow; Bennett,10,0,32,22
1657746521124,MATH 142A,A03,093480,Chow; Bennett,9,0,32,23
1657746521124,MATH 142A,B03,093481,Chow; Bennett,8,0,32,24
1657746521124,MATH 142A,B04,093558,Chow; Bennett,13,0,32,19
1657746521124,MATH 142A,B05,093559,Chow; Bennett,6,0,32,26
1657746527170,MATH 193A,A01,083224,Rotar; Vladimir,8,0,34,26
1657746527170,MATH 193A,A02,083225,Rotar; Vladimir,9,0,34,25
1657746527170,MATH 193A,A03,083781,Rotar; Vladimir,5,0,34,29
1657746527170,MATH 193A,A04,083782,Rotar; Vladimir,10,0,34,24
1657746527170,MATH 193A,A05,093482,Rotar; Vladimir,10,0,34,24
1657746533193,MATH 197,001,091859,McAuley; Julian John,9999,0,9999,0
1657746533193,MATH 197,002,095566,Kedlaya; Kiran S.,9997,0,9999,2
1657746533193,MATH 197,003,095567,Xiao; Ming,9999,0,9999,0
1657746533193,MATH 197,004,095571,Perols; Johan Lars,9998,0,9999,1
1657746540256,COGS 9,A01,083615,Shannon; Kyle Michael,9,0,75,66
1657746546284,COGS 11,A01,083617,Boyle; Mary E. T.,23,0,48,25
1657746552310,COGS 13,A01,083071,Bastos; Amalia Pinkusfeld,11,0,71,60
1657746558334,COGS 14A,A01,092681,Semenuks; Arturs,5,1,100,95
1657746564360,COGS 14B,A01,083073,Cheng; Tzu-Han,6,0,63,57
1657746570387,COGS 17,A01,092677,Semenuks; Arturs,6,0,81,75
1657746576414,COGS 100,A01,083619,Allen; Michael Gordon,17,0,70,53
1657746582444,COGS 101A,A01,083621,Davis; Joshua Daniel,9,0,68,59
1657746588470,COGS 101B,A01,091572,Allen; Michael Gordon,12,0,65,53
1657746594494,COGS 101C,A01,083625,Delgado; Tania,17,0,35,18
1657746600525,COGS 107A,A01,083627,Boyle; Mary E. T.,13,0,60,47
1657746606548,COGS 118A,A01,083075,Gupta; Anjum,21,0,76,55
1657746612571,CSE 3,A50,083646,Miranda; Gregory Joseph,24,0,50,26
1657746618594,CSE 8A,A50,083650,Miranda; Gregory Joseph,17,1,56,39
1657746624621,CSE 11,A01,083080,Cao; Yingjun,6,15,40,34
1657746630648,CSE 12,A01,083652,Krause-Levy; Sophia Louisa,28,1,120,92
1657746636674,CSE 15L,A01,083654,Morris; Justin Loren,9,0,50,41
1657746636674,CSE 15L,A02,083655,Morris; Justin Loren,9,0,50,41
1657746642697,CSE 20,A01,083657,Tran; Khoa Dang,39,0,80,41
1657746648721,CSE 21,A01,095574,Bach; Quang Tran,22,0,48,26
1657746654749,CSE 30,A01,083084,Eldon; John,6,0,80,74
1657746654749,CSE 30,B01,095061,Bhaskar; Nishant,9,0,50,41
1657746660776,CSE 100,A01,083659,Cao; Yingjun,5,4,70,65
1657746666811,CSE 134B,A01,083661,Powell; Thomas Allan,24,0,100,76
1657746672851,CSE 140,A01,083663,Gungor; Onat,15,0,85,70
1657746678873,CSE 140L,A01,083088,Eldon; John,23,0,100,77
1657746684908,CSE 175,A01,083665,Kumar; Rakesh,3,0,25,22
1657746690942,CSE 190,A00,092507,Dubnov; Shlomo,8,0,20,12
1657746697036,ECE 45,A01,083139,Congero; Spencer William,6,0,75,69
1657746703061,ECE 65,A50,083695,Saad; Andrew S,12,0,30,18
1657746703061,ECE 65,A51,095125,Saad; Andrew S,24,0,26,2
1657746709101,ECE 109,A01,091882,Touri; Behrouz,20,0,70,50
1657746715133,ECE 180,A00,083140,Abi Samra; Nicholas Camill,1,0,30,29
1657746715133,ECE 180,B00,083141,Abi Samra; Nicholas Camill,0,0,30,30
1657746721155,MATH 10A,A01,083735,Patchell; Gregory David,2,0,30,28
1657746721155,MATH 10A,A02,083736,Patchell; Gregory David,20,0,30,10
1657746721155,MATH 10A,A03,083737,Patchell; Gregory David,16,0,30,14
1657746727186,MATH 10B,A01,083207,Lim; Seonhee,8,0,34,26
1657746727186,MATH 10B,A02,083208,Lim; Seonhee,9,0,35,26
1657746727186,MATH 10B,A03,093472,Lim; Seonhee,7,0,34,27
1657746727186,MATH 10B,B01,083739,Sinha; Shubham,13,0,30,17
1657746733211,MATH 18,A01,083743,Cinel; Cameron Alexander,9,0,30,21
1657746733211,MATH 18,A02,083744,Cinel; Cameron Alexander,18,0,30,12
1657746733211,MATH 18,A03,083745,Cinel; Cameron Alexander,10,0,30,20
1657746733211,MATH 18,B01,083748,Rideout; David Porter,5,0,37,32
1657746733211,MATH 18,B02,083749,Rideout; David Porter,5,0,36,31
1657746733211,MATH 18,B03,083750,Rideout; David Porter,3,0,37,34
1657746733211,MATH 18,B04,083751,Rideout; David Porter,6,0,36,30
1657746733211,MATH 18,B05,093473,Rideout; David Porter,6,0,36,30
1657746733211,MATH 18,B06,093474,Rideout; David Porter,6,0,36,30
1657746739242,MATH 20A,A01,083754,Zheng; Zequn,14,0,40,26
1657746745271,MATH 20B,A01,083756,Briones; Jor-el Thomas Caparas,4,0,36,32
1657746745271,MATH 20B,A02,083757,Briones; Jor-el Thomas Caparas,1,0,36,35
1657746745271,MATH 20B,A03,093475,Briones; Jor-el Thomas Caparas,2,0,36,34
1657746751301,MATH 20C,A01,083760,Briones; Jor-el Thomas Caparas,1,0,35,34
1657746751301,MATH 20C,A02,083761,Briones; Jor-el Thomas Caparas,8,0,35,27
1657746751301,MATH 20C,A03,093476,Briones; Jor-el Thomas Caparas,0,1,36,36
1657746751301,MATH 20C,B01,083762,Bach; Quang Tran,1,0,30,29
1657746757329,MATH 20D,A01,083765,Tran; Brian Kha,5,0,30,25
1657746757329,MATH 20D,A02,083766,Tran; Brian Kha,5,0,30,25
1657746757329,MATH 20D,A03,083767,Tran; Brian Kha,5,0,30,25
1657746763359,MATH 20E,A01,083771,Ganguly; Soumya,9,0,32,23
1657746763359,MATH 20E,A02,083772,Ganguly; Soumya,6,0,32,26
1657746763359,MATH 20E,B01,083773,Ciotti; Benjamin,20,0,35,15
1657746763359,MATH 20E,B02,083774,Ciotti; Benjamin,18,0,35,17
1657746769386,MATH 103A,A01,083777,Greenfeld; Be'Eri,3,0,36,33
1657746769386,MATH 103A,A02,083778,Greenfeld; Be'Eri,5,0,36,31
1657746769386,MATH 103A,A03,093561,Greenfeld; Be'Eri,6,0,36,30
1657746769386,MATH 103A,B01,083779,Greenfeld; Be'Eri,7,0,36,29
1657746769386,MATH 103A,B02,083780,Greenfeld; Be'Eri,4,0,36,32
1657746769386,MATH 103A,B03,093562,Greenfeld; Be'Eri,3,0,36,33
1657746775409,MATH 105,A01,085443,Carter; Anne Toulson,15,0,35,20
1657746775409,MATH 105,A02,093477,Carter; Anne Toulson,20,0,35,15
1657746781432,MATH 109,A01,083213,Ganzberger; Geoffrey Michael,3,0,34,31
1657746781432,MATH 109,A02,083214,Ganzberger; Geoffrey Michael,4,0,34,30
1657746781432,MATH 109,A03,093478,Ganzberger; Geoffrey Michael,2,0,34,32
1657746781432,MATH 109,B01,083215,Ganzberger; Geoffrey Michael,1,0,32,31
1657746781432,MATH 109,B02,083216,Ganzberger; Geoffrey Michael,2,0,32,30
1657746781432,MATH 109,B03,093479,Ganzberger; Geoffrey Michael,8,0,32,24
1657746787464,MATH 142A,A01,083219,Chow; Bennett,7,0,32,25
1657746787464,MATH 142A,A02,083220,Chow; Bennett,10,0,32,22
1657746787464,MATH 142A,A03,093480,Chow; Bennett,9,0,32,23
1657746787464,MATH 142A,B03,093481,Chow; Bennett,8,0,32,24
1657746787464,MATH 142A,B04,093558,Chow; Bennett,13,0,32,19
1657746787464,MATH 142A,B05,093559,Chow; Bennett,6,0,32,26
1657746793491,MATH 193A,A01,083224,Rotar; Vladimir,8,0,34,26
1657746793491,MATH 193A,A02,083225,Rotar; Vladimir,9,0,34,25
1657746793491,MATH 193A,A03,083781,Rotar; Vladimir,5,0,34,29
1657746793491,MATH 193A,A04,083782,Rotar; Vladimir,10,0,34,24
1657746793491,MATH 193A,A05,093482,Rotar; Vladimir,10,0,34,24
1657746799518,MATH 197,001,091859,McAuley; Julian John,9999,0,9999,0
1657746799518,MATH 197,002,095566,Kedlaya; Kiran S.,9997,0,9999,2
1657746799518,MATH 197,003,095567,Xiao; Ming,9999,0,9999,0
1657746799518,MATH 197,004,095571,Perols; Johan Lars,9998,0,9999,1
1657746806597,COGS 9,A01,083615,Shannon; Kyle Michael,9,0,75,66
1657746812623,COGS 11,A01,083617,Boyle; Mary E. T.,23,0,48,25
1657746818648,COGS 13,A01,083071,Bastos; Amalia Pinkusfeld,11,0,71,60
1657746824672,COGS 14A,A01,092681,Semenuks; Arturs,5,1,100,95
1657746830694,COGS 14B,A01,083073,Cheng; Tzu-Han,6,0,63,57
1657746836721,COGS 17,A01,092677,Semenuks; Arturs,6,0,81,75
1657746842744,COGS 100,A01,083619,Allen; Michael Gordon,17,0,70,53
1657746848772,COGS 101A,A01,083621,Davis; Joshua Daniel,9,0,68,59
1657746854796,COGS 101B,A01,091572,Allen; Michael Gordon,12,0,65,53
1657746860820,COGS 101C,A01,083625,Delgado; Tania,17,0,35,18
1657746866843,COGS 107A,A01,083627,Boyle; Mary E. T.,13,0,60,47
1657746872865,COGS 118A,A01,083075,Gupta; Anjum,21,0,76,55
1657746878890,CSE 3,A50,083646,Miranda; Gregory Joseph,24,0,50,26
1657746884918,CSE 8A,A50,083650,Miranda; Gregory Joseph,17,1,56,39
1657746890950,CSE 11,A01,083080,Cao; Yingjun,6,15,40,34
1657746896975,CSE 12,A01,083652,Krause-Levy; Sophia Louisa,28,1,120,92
1657746903005,CSE 15L,A01,083654,Morris; Justin Loren,9,0,50,41
1657746903005,CSE 15L,A02,083655,Morris; Justin Loren,9,0,50,41
1657746909030,CSE 20,A01,083657,Tran; Khoa Dang,39,0,80,41
1657746915053,CSE 21,A01,095574,Bach; Quang Tran,22,0,48,26
1657746921079,CSE 30,A01,083084,Eldon; John,6,0,80,74
1657746921079,CSE 30,B01,095061,Bhaskar; Nishant,9,0,50,41
1657746927104,CSE 100,A01,083659,Cao; Yingjun,5,4,70,65
1657746933127,CSE 134B,A01,083661,Powell; Thomas Allan,24,0,100,76
1657746939149,CSE 140,A01,083663,Gungor; Onat,15,0,85,70
1657746945173,CSE 140L,A01,083088,Eldon; John,23,0,100,77
1657746951199,CSE 175,A01,083665,Kumar; Rakesh,3,0,25,22
1657746957222,CSE 190,A00,092507,Dubnov; Shlomo,8,0,20,12
1657746963246,ECE 45,A01,083139,Congero; Spencer William,6,0,75,69
1657746969272,ECE 65,A50,083695,Saad; Andrew S,12,0,30,18
1657746969272,ECE 65,A51,095125,Saad; Andrew S,24,0,26,2
1657746975295,ECE 109,A01,091882,Touri; Behrouz,20,0,70,50
1657746981320,ECE 180,A00,083140,Abi Samra; Nicholas Camill,1,0,30,29
1657746981320,ECE 180,B00,083141,Abi Samra; Nicholas Camill,0,0,30,30
1657746987344,MATH 10A,A01,083735,Patchell; Gregory David,2,0,30,28
1657746987344,MATH 10A,A02,083736,Patchell; Gregory David,20,0,30,10
1657746987344,MATH 10A,A03,083737,Patchell; Gregory David,16,0,30,14
1657746993385,MATH 10B,A01,083207,Lim; Seonhee,8,0,34,26
1657746993385,MATH 10B,A02,083208,Lim; Seonhee,9,0,35,26
1657746993385,MATH 10B,A03,093472,Lim; Seonhee,7,0,34,27
1657746993385,MATH 10B,B01,083739,Sinha; Shubham,13,0,30,17
1657746999413,MATH 18,A01,083743,Cinel; Cameron Alexander,9,0,30,21
1657746999413,MATH 18,A02,083744,Cinel; Cameron Alexander,18,0,30,12
1657746999413,MATH 18,A03,083745,Cinel; Cameron Alexander,10,0,30,20
1657746999413,MATH 18,B01,083748,Rideout; David Porter,5,0,37,32
1657746999413,MATH 18,B02,083749,Rideout; David Porter,5,0,36,31
1657746999413,MATH 18,B03,083750,Rideout; David Porter,3,0,37,34
1657746999413,MATH 18,B04,083751,Rideout; David Porter,6,0,36,30
1657746999413,MATH 18,B05,093473,Rideout; David Porter,6,0,36,30
1657746999413,MATH 18,B06,093474,Rideout; David Porter,6,0,36,30
1657747005436,MATH 20A,A01,083754,Zheng; Zequn,14,0,40,26
1657747011464,MATH 20B,A01,083756,Briones; Jor-el Thomas Caparas,4,0,36,32
1657747011464,MATH 20B,A02,083757,Briones; Jor-el Thomas Caparas,1,0,36,35
1657747011464,MATH 20B,A03,093475,Briones; Jor-el Thomas Caparas,2,0,36,34
1657747017488,MATH 20C,A01,083760,Briones; Jor-el Thomas Caparas,1,0,35,34
1657747017488,MATH 20C,A02,083761,Briones; Jor-el Thomas Caparas,8,0,35,27
1657747017488,MATH 20C,A03,093476,Briones; Jor-el Thomas Caparas,0,1,36,36
1657747017488,MATH 20C,B01,083762,Bach; Quang Tran,1,0,30,29
1657747023512,MATH 20D,A01,083765,Tran; Brian Kha,5,0,30,25
1657747023512,MATH 20D,A02,083766,Tran; Brian Kha,5,0,30,25
1657747023512,MATH 20D,A03,083767,Tran; Brian Kha,5,0,30,25
1657747029535,MATH 20E,A01,083771,Ganguly; Soumya,9,0,32,23
1657747029535,MATH 20E,A02,083772,Ganguly; Soumya,6,0,32,26
1657747029535,MATH 20E,B01,083773,Ciotti; Benjamin,20,0,35,15
1657747029535,MATH 20E,B02,083774,Ciotti; Benjamin,18,0,35,17
1657747035564,MATH 103A,A01,083777,Greenfeld; Be'Eri,3,0,36,33
1657747035564,MATH 103A,A02,083778,Greenfeld; Be'Eri,5,0,36,31
1657747035564,MATH 103A,A03,093561,Greenfeld; Be'Eri,6,0,36,30
1657747035564,MATH 103A,B01,083779,Greenfeld; Be'Eri,7,0,36,29
1657747035564,MATH 103A,B02,083780,Greenfeld; Be'Eri,4,0,36,32
1657747035564,MATH 103A,B03,093562,Greenfeld; Be'Eri,3,0,36,33
1657747041588,MATH 105,A01,085443,Carter; Anne Toulson,15,0,35,20
1657747041588,MATH 105,A02,093477,Carter; Anne Toulson,20,0,35,15
1657747047616,MATH 109,A01,083213,Ganzberger; Geoffrey Michael,3,0,34,31
1657747047616,MATH 109,A02,083214,Ganzberger; Geoffrey Michael,4,0,34,30
1657747047616,MATH 109,A03,093478,Ganzberger; Geoffrey Michael,2,0,34,32
1657747047616,MATH 109,B01,083215,Ganzberger; Geoffrey Michael,1,0,32,31
1657747047616,MATH 109,B02,083216,Ganzberger; Geoffrey Michael,2,0,32,30
1657747047616,MATH 109,B03,093479,Ganzberger; Geoffrey Michael,8,0,32,24
1657747053644,MATH 142A,A01,083219,Chow; Bennett,7,0,32,25
1657747053644,MATH 142A,A02,083220,Chow; Bennett,10,0,32,22
1657747053644,MATH 142A,A03,093480,Chow; Bennett,9,0,32,23
1657747053644,MATH 142A,B03,093481,Chow; Bennett,8,0,32,24
1657747053644,MATH 142A,B04,093558,Chow; Bennett,13,0,32,19
1657747053644,MATH 142A,B05,093559,Chow; Bennett,6,0,32,26
1657747059673,MATH 193A,A01,083224,Rotar; Vladimir,8,0,34,26
1657747059673,MATH 193A,A02,083225,Rotar; Vladimir,9,0,34,25
1657747059673,MATH 193A,A03,083781,Rotar; Vladimir,5,0,34,29
1657747059673,MATH 193A,A04,083782,Rotar; Vladimir,10,0,34,24
1657747059673,MATH 193A,A05,093482,Rotar; Vladimir,10,0,34,24
1657747065705,MATH 197,001,091859,McAuley; Julian John,9999,0,9999,0
1657747065705,MATH 197,002,095566,Kedlaya; Kiran S.,9997,0,9999,2
1657747065705,MATH 197,003,095567,Xiao; Ming,9999,0,9999,0
1657747065705,MATH 197,004,095571,Perols; Johan Lars,9998,0,9999,1
1657747072773,COGS 9,A01,083615,Shannon; Kyle Michael,9,0,75,66
1657747078800,COGS 11,A01,083617,Boyle; Mary E. T.,23,0,48,25
1657747084826,COGS 13,A01,083071,Bastos; Amalia Pinkusfeld,11,0,71,60
1657747090853,COGS 14A,A01,092681,Semenuks; Arturs,5,1,100,95
1657747096879,COGS 14B,A01,083073,Cheng; Tzu-Han,6,0,63,57
1657747102905,COGS 17,A01,092677,Semenuks; Arturs,6,0,81,75
1657747108931,COGS 100,A01,083619,Allen; Michael Gordon,17,0,70,53
1657747114982,COGS 101A,A01,083621,Davis; Joshua Daniel,9,0,68,59
1657747121008,COGS 101B,A01,091572,Allen; Michael Gordon,12,0,65,53
1657747127036,COGS 101C,A01,083625,Delgado; Tania,17,0,35,18
1657747133062,COGS 107A,A01,083627,Boyle; Mary E. T.,13,0,60,47
1657747139085,COGS 118A,A01,083075,Gupta; Anjum,21,0,76,55
1657747145109,CSE 3,A50,083646,Miranda; Gregory Joseph,24,0,50,26
1657747151134,CSE 8A,A50,083650,Miranda; Gregory Joseph,17,1,56,39
1657747157156,CSE 11,A01,083080,Cao; Yingjun,6,15,40,34
1657747163182,CSE 12,A01,083652,Krause-Levy; Sophia Louisa,28,1,120,92
1657747169206,CSE 15L,A01,083654,Morris; Justin Loren,9,0,50,41
1657747169206,CSE 15L,A02,083655,Morris; Justin Loren,9,0,50,41
1657747175245,CSE 20,A01,083657,Tran; Khoa Dang,39,0,80,41
1657747181280,CSE 21,A01,095574,Bach; Quang Tran,22,0,48,26
1657747187315,CSE 30,A01,083084,Eldon; John,6,0,80,74
1657747187315,CSE 30,B01,095061,Bhaskar; Nishant,9,0,50,41
1657747193345,CSE 100,A01,083659,Cao; Yingjun,5,4,70,65
1657747199374,CSE 134B,A01,083661,Powell; Thomas Allan,24,0,100,76
1657747205404,CSE 140,A01,083663,Gungor; Onat,15,0,85,70
1657747211436,CSE 140L,A01,083088,Eldon; John,23,0,100,77
1657747217459,CSE 175,A01,083665,Kumar; Rakesh,3,0,25,22
1657747223481,CSE 190,A00,092507,Dubnov; Shlomo,8,0,20,12
1657747229512,ECE 45,A01,083139,Congero; Spencer William,6,0,75,69
1657747235545,ECE 65,A50,083695,Saad; Andrew S,12,0,30,18
1657747235545,ECE 65,A51,095125,Saad; Andrew S,24,0,26,2
1657747241571,ECE 109,A01,091882,Touri; Behrouz,20,0,70,50
1657747247598,ECE 180,A00,083140,Abi Samra; Nicholas Camill,1,0,30,29
1657747247598,ECE 180,B00,083141,Abi Samra; Nicholas Camill,0,0,30,30
1657747253622,MATH 10A,A01,083735,Patchell; Gregory David,2,0,30,28
1657747253622,MATH 10A,A02,083736,Patchell; Gregory David,20,0,30,10
1657747253622,MATH 10A,A03,083737,Patchell; Gregory David,16,0,30,14
1657747259649,MATH 10B,A01,083207,Lim; Seonhee,8,0,34,26
1657747259649,MATH 10B,A02,083208,Lim; Seonhee,9,0,35,26
1657747259649,MATH 10B,A03,093472,Lim; Seonhee,7,0,34,27
1657747259649,MATH 10B,B01,083739,Sinha; Shubham,13,0,30,17
1657747265674,MATH 18,A01,083743,Cinel; Cameron Alexander,9,0,30,21
1657747265674,MATH 18,A02,083744,Cinel; Cameron Alexander,18,0,30,12
1657747265674,MATH 18,A03,083745,Cinel; Cameron Alexander,10,0,30,20
1657747265674,MATH 18,B01,083748,Rideout; David Porter,5,0,37,32
1657747265674,MATH 18,B02,083749,Rideout; David Porter,5,0,36,31
1657747265674,MATH 18,B03,083750,Rideout; David Porter,3,0,37,34
1657747265674,MATH 18,B04,083751,Rideout; David Porter,6,0,36,30
1657747265674,MATH 18,B05,093473,Rideout; David Porter,6,0,36,30
1657747265674,MATH 18,B06,093474,Rideout; David Porter,6,0,36,30
1657747271699,MATH 20A,A01,083754,Zheng; Zequn,14,0,40,26
1657747277726,MATH 20B,A01,083756,Briones; Jor-el Thomas Caparas,4,0,36,32
1657747277726,MATH 20B,A02,083757,Briones; Jor-el Thomas Caparas,1,0,36,35
1657747277726,MATH 20B,A03,093475,Briones; Jor-el Thomas Caparas,2,0,36,34
1657747283753,MATH 20C,A01,083760,Briones; Jor-el Thomas Caparas,1,0,35,34
1657747283753,MATH 20C,A02,083761,Briones; Jor-el Thomas Caparas,8,0,35,27
1657747283753,MATH 20C,A03,093476,Briones; Jor-el Thomas Caparas,0,1,36,36
1657747283753,MATH 20C,B01,083762,Bach; Quang Tran,1,0,30,29
1657747289787,MATH 20D,A01,083765,Tran; Brian Kha,5,0,30,25
1657747289787,MATH 20D,A02,083766,Tran; Brian Kha,5,0,30,25
1657747289787,MATH 20D,A03,083767,Tran; Brian Kha,5,0,30,25
1657747295888,MATH 20E,A01,083771,Ganguly; Soumya,9,0,32,23
1657747295888,MATH 20E,A02,083772,Ganguly; Soumya,6,0,32,26
1657747295888,MATH 20E,B01,083773,Ciotti; Benjamin,20,0,35,15
1657747295888,MATH 20E,B02,083774,Ciotti; Benjamin,18,0,35,17
1657747301916,MATH 103A,A01,083777,Greenfeld; Be'Eri,3,0,36,33
1657747301916,MATH 103A,A02,083778,Greenfeld; Be'Eri,5,0,36,31
1657747301916,MATH 103A,A03,093561,Greenfeld; Be'Eri,6,0,36,30
1657747301916,MATH 103A,B01,083779,Greenfeld; Be'Eri,7,0,36,29
1657747301916,MATH 103A,B02,083780,Greenfeld; Be'Eri,4,0,36,32
1657747301916,MATH 103A,B03,093562,Greenfeld; Be'Eri,3,0,36,33
1657747307941,MATH 105,A01,085443,Carter; Anne Toulson,15,0,35,20
1657747307941,MATH 105,A02,093477,Carter; Anne Toulson,20,0,35,15
1657747313973,MATH 109,A01,083213,Ganzberger; Geoffrey Michael,3,0,34,31
1657747313973,MATH 109,A02,083214,Ganzberger; Geoffrey Michael,4,0,34,30
1657747313973,MATH 109,A03,093478,Ganzberger; Geoffrey Michael,2,0,34,32
1657747313973,MATH 109,B01,083215,Ganzberger; Geoffrey Michael,1,0,32,31
1657747313973,MATH 109,B02,083216,Ganzberger; Geoffrey Michael,2,0,32,30
1657747313973,MATH 109,B03,093479,Ganzberger; Geoffrey Michael,8,0,32,24
1657747319995,MATH 142A,A01,083219,Chow; Bennett,7,0,32,25
1657747319995,MATH 142A,A02,083220,Chow; Bennett,10,0,32,22
1657747319995,MATH 142A,A03,093480,Chow; Bennett,9,0,32,23
1657747319995,MATH 142A,B03,093481,Chow; Bennett,8,0,32,24
1657747319995,MATH 142A,B04,093558,Chow; Bennett,13,0,32,19
1657747319995,MATH 142A,B05,093559,Chow; Bennett,6,0,32,26
1657747326018,MATH 193A,A01,083224,Rotar; Vladimir,8,0,34,26
1657747326018,MATH 193A,A02,083225,Rotar; Vladimir,9,0,34,25
1657747326018,MATH 193A,A03,083781,Rotar; Vladimir,5,0,34,29
1657747326018,MATH 193A,A04,083782,Rotar; Vladimir,10,0,34,24
1657747326018,MATH 193A,A05,093482,Rotar; Vladimir,10,0,34,24
1657747332040,MATH 197,001,091859,McAuley; Julian John,9999,0,9999,0
1657747332040,MATH 197,002,095566,Kedlaya; Kiran S.,9997,0,9999,2
1657747332040,MATH 197,003,095567,Xiao; Ming,9999,0,9999,0
1657747332040,MATH 197,004,095571,Perols; Johan Lars,9998,0,9999,1
1657747339106,COGS 9,A01,083615,Shannon; Kyle Michael,9,0,75,66
1657747345129,COGS 11,A01,083617,Boyle; Mary E. T.,23,0,48,25
1657747351150,COGS 13,A01,083071,Bastos; Amalia Pinkusfeld,11,0,71,60
1657747357177,COGS 14A,A01,092681,Semenuks; Arturs,5,1,100,95
1657747363201,COGS 14B,A01,083073,Cheng; Tzu-Han,6,0,63,57
1657747369238,COGS 17,A01,092677,Semenuks; Arturs,6,0,81,75
1657747375261,COGS 100,A01,083619,Allen; Michael Gordon,17,0,70,53
1657747381285,COGS 101A,A01,083621,Davis; Joshua Daniel,9,0,68,59
1657747387308,COGS 101B,A01,091572,Allen; Michael Gordon,12,0,65,53
1657747393334,COGS 101C,A01,083625,Delgado; Tania,17,0,35,18
1657747399361,COGS 107A,A01,083627,Boyle; Mary E. T.,13,0,60,47
1657747405388,COGS 118A,A01,083075,Gupta; Anjum,21,0,76,55
1657747411410,CSE 3,A50,083646,Miranda; Gregory Joseph,24,0,50,26
1657747417444,CSE 8A,A50,083650,Miranda; Gregory Joseph,17,1,56,39
1657747423467,CSE 11,A01,083080,Cao; Yingjun,6,15,40,34
1657747429495,CSE 12,A01,083652,Krause-Levy; Sophia Louisa,28,1,120,92
1657747435525,CSE 15L,A01,083654,Morris; Justin Loren,9,0,50,41
1657747435525,CSE 15L,A02,083655,Morris; Justin Loren,9,0,50,41
1657747441549,CSE 20,A01,083657,Tran; Khoa Dang,39,0,80,41
1657747447572,CSE 21,A01,095574,Bach; Quang Tran,22,0,48,26
1657747453594,CSE 30,A01,083084,Eldon; John,6,0,80,74
1657747453594,CSE 30,B01,095061,Bhaskar; Nishant,9,0,50,41
1657747459618,CSE 100,A01,083659,Cao; Yingjun,5,4,70,65
1657747465639,CSE 134B,A01,083661,Powell; Thomas Allan,24,0,100,76
1657747471665,CSE 140,A01,083663,Gungor; Onat,15,0,85,70
1657747477694,CSE 140L,A01,083088,Eldon; John,23,0,100,77
1657747483728,CSE 175,A01,083665,Kumar; Rakesh,3,0,25,22
1657747489755,CSE 190,A00,092507,Dubnov; Shlomo,8,0,20,12
1657747495778,ECE 45,A01,083139,Congero; Spencer William,6,0,75,69
1657747501807,ECE 65,A50,083695,Saad; Andrew S,12,0,30,18
1657747501807,ECE 65,A51,095125,Saad; Andrew S,24,0,26,2
1657747507836,ECE 109,A01,091882,Touri; Behrouz,20,0,70,50
1657747513860,ECE 180,A00,083140,Abi Samra; Nicholas Camill,1,0,30,29
1657747513860,ECE 180,B00,083141,Abi Samra; Nicholas Camill,0,0,30,30
1657747519884,MATH 10A,A01,083735,Patchell; Gregory David,2,0,30,28
1657747519884,MATH 10A,A02,083736,Patchell; Gregory David,20,0,30,10
1657747519884,MATH 10A,A03,083737,Patchell; Gregory David,16,0,30,14
1657747525930,MATH 10B,A01,083207,Lim; Seonhee,8,0,34,26
1657747525930,MATH 10B,A02,083208,Lim; Seonhee,9,0,35,26
1657747525930,MATH 10B,A03,093472,Lim; Seonhee,7,0,34,27
1657747525930,MATH 10B,B01,083739,Sinha; Shubham,13,0,30,17
1657747531955,MATH 18,A01,083743,Cinel; Cameron Alexander,9,0,30,21
1657747531955,MATH 18,A02,083744,Cinel; Cameron Alexander,18,0,30,12
1657747531955,MATH 18,A03,083745,Cinel; Cameron Alexander,10,0,30,20
1657747531955,MATH 18,B01,083748,Rideout; David Porter,5,0,37,32
1657747531955,MATH 18,B02,083749,Rideout; David Porter,5,0,36,31
1657747531955,MATH 18,B03,083750,Rideout; David Porter,3,0,37,34
1657747531955,MATH 18,B04,083751,Rideout; David Porter,6,0,36,30
1657747531955,MATH 18,B05,093473,Rideout; David Porter,6,0,36,30
1657747531955,MATH 18,B06,093474,Rideout; David Porter,6,0,36,30
1657747537982,MATH 20A,A01,083754,Zheng; Zequn,14,0,40,26
1657747544003,MATH 20B,A01,083756,Briones; Jor-el Thomas Caparas,4,0,36,32
1657747544003,MATH 20B,A02,083757,Briones; Jor-el Thomas Caparas,1,0,36,35
1657747544003,MATH 20B,A03,093475,Briones; Jor-el Thomas Caparas,2,0,36,34
1657747550045,MATH 20C,A01,083760,Briones; Jor-el Thomas Caparas,1,0,35,34
1657747550045,MATH 20C,A02,083761,Briones; Jor-el Thomas Caparas,8,0,35,27
1657747550045,MATH 20C,A03,093476,Briones; Jor-el Thomas Caparas,0,1,36,36
1657747550045,MATH 20C,B01,083762,Bach; Quang Tran,1,0,30,29
1657747556077,MATH 20D,A01,083765,Tran; Brian Kha,5,0,30,25
1657747556077,MATH 20D,A02,083766,Tran; Brian Kha,5,0,30,25
1657747556077,MATH 20D,A03,083767,Tran; Brian Kha,5,0,30,25
1657747562102,MATH 20E,A01,083771,Ganguly; Soumya,9,0,32,23
1657747562102,MATH 20E,A02,083772,Ganguly; Soumya,6,0,32,26
1657747562102,MATH 20E,B01,083773,Ciotti; Benjamin,20,0,35,15
1657747562102,MATH 20E,B02,083774,Ciotti; Benjamin,18,0,35,17
1657747568126,MATH 103A,A01,083777,Greenfeld; Be'Eri,3,0,36,33
1657747568126,MATH 103A,A02,083778,Greenfeld; Be'Eri,5,0,36,31
1657747568126,MATH 103A,A03,093561,Greenfeld; Be'Eri,6,0,36,30
1657747568126,MATH 103A,B01,083779,Greenfeld; Be'Eri,7,0,36,29
1657747568126,MATH 103A,B02,083780,Greenfeld; Be'Eri,4,0,36,32
1657747568126,MATH 103A,B03,093562,Greenfeld; Be'Eri,3,0,36,33
1657747574148,MATH 105,A01,085443,Carter; Anne Toulson,15,0,35,20
1657747574148,MATH 105,A02,093477,Carter; Anne Toulson,20,0,35,15
1657747580170,MATH 109,A01,083213,Ganzberger; Geoffrey Michael,3,0,34,31
1657747580170,MATH 109,A02,083214,Ganzberger; Geoffrey Michael,4,0,34,30
1657747580170,MATH 109,A03,093478,Ganzberger; Geoffrey Michael,2,0,34,32
1657747580170,MATH 109,B01,083215,Ganzberger; Geoffrey Michael,1,0,32,31
1657747580170,MATH 109,B02,083216,Ganzberger; Geoffrey Michael,2,0,32,30
1657747580170,MATH 109,B03,093479,Ganzberger; Geoffrey Michael,8,0,32,24
1657747586200,MATH 142A,A01,083219,Chow; Bennett,7,0,32,25
1657747586200,MATH 142A,A02,083220,Chow; Bennett,10,0,32,22
1657747586200,MATH 142A,A03,093480,Chow; Bennett,9,0,32,23
1657747586200,MATH 142A,B03,093481,Chow; Bennett,8,0,32,24
1657747586200,MATH 142A,B04,093558,Chow; Bennett,13,0,32,19
1657747586200,MATH 142A,B05,093559,Chow; Bennett,6,0,32,26
1657747592242,MATH 193A,A01,083224,Rotar; Vladimir,8,0,34,26
1657747592242,MATH 193A,A02,083225,Rotar; Vladimir,9,0,34,25
1657747592242,MATH 193A,A03,083781,Rotar; Vladimir,5,0,34,29
1657747592242,MATH 193A,A04,083782,Rotar; Vladimir,10,0,34,24
1657747592242,MATH 193A,A05,093482,Rotar; Vladimir,10,0,34,24
1657747598272,MATH 197,001,091859,McAuley; Julian John,9999,0,9999,0
1657747598272,MATH 197,002,095566,Kedlaya; Kiran S.,9997,0,9999,2
1657747598272,MATH 197,003,095567,Xiao; Ming,9999,0,9999,0
1657747598272,MATH 197,004,095571,Perols; Johan Lars,9998,0,9999,1
1657747605336,COGS 9,A01,083615,Shannon; Kyle Michael,9,0,75,66
1657747611360,COGS 11,A01,083617,Boyle; Mary E. T.,23,0,48,25
1657747617390,COGS 13,A01,083071,Bastos; Amalia Pinkusfeld,11,0,71,60
1657747623415,COGS 14A,A01,092681,Semenuks; Arturs,5,1,100,95
1657747629458,COGS 14B,A01,083073,Cheng; Tzu-Han,6,0,63,57
1657747635484,COGS 17,A01,092677,Semenuks; Arturs,6,0,81,75
1657747641507,COGS 100,A01,083619,Allen; Michael Gordon,17,0,70,53
1657747647537,COGS 101A,A01,083621,Davis; Joshua Daniel,9,0,68,59
1657747653567,COGS 101B,A01,091572,Allen; Michael Gordon,12,0,65,53
1657747659592,COGS 101C,A01,083625,Delgado; Tania,17,0,35,18
1657747665623,COGS 107A,A01,083627,Boyle; Mary E. T.,13,0,60,47
1657747671664,COGS 118A,A01,083075,Gupta; Anjum,21,0,76,55
1657747677688,CSE 3,A50,083646,Miranda; Gregory Joseph,24,0,50,26
1657747683711,CSE 8A,A50,083650,Miranda; Gregory Joseph,17,1,56,39
1657747689733,CSE 11,A01,083080,Cao; Yingjun,6,15,40,34
1657747695763,CSE 12,A01,083652,Krause-Levy; Sophia Louisa,28,1,120,92
1657747701786,CSE 15L,A01,083654,Morris; Justin Loren,9,0,50,41
1657747701786,CSE 15L,A02,083655,Morris; Justin Loren,9,0,50,41
1657747707809,CSE 20,A01,083657,Tran; Khoa Dang,39,0,80,41
1657747713838,CSE 21,A01,095574,Bach; Quang Tran,22,0,48,26
1657747719870,CSE 30,A01,083084,Eldon; John,6,0,80,74
1657747719870,CSE 30,B01,095061,Bhaskar; Nishant,9,0,50,41
1657747725898,CSE 100,A01,083659,Cao; Yingjun,5,4,70,65
1657747731924,CSE 134B,A01,083661,Powell; Thomas Allan,24,0,100,76
1657747737950,CSE 140,A01,083663,Gungor; Onat,15,0,85,70
1657747743973,CSE 140L,A01,083088,Eldon; John,23,0,100,77
1657747750001,CSE 175,A01,083665,Kumar; Rakesh,3,0,25,22
1657747756031,CSE 190,A00,092507,Dubnov; Shlomo,8,0,20,12
1657747762052,ECE 45,A01,083139,Congero; Spencer William,6,0,75,69
1657747768080,ECE 65,A50,083695,Saad; Andrew S,12,0,30,18
1657747768080,ECE 65,A51,095125,Saad; Andrew S,24,0,26,2
1657747774103,ECE 109,A01,091882,Touri; Behrouz,20,0,70,50
1657747780126,ECE 180,A00,083140,Abi Samra; Nicholas Camill,1,0,30,29
1657747780126,ECE 180,B00,083141,Abi Samra; Nicholas Camill,0,0,30,30
1657747786152,MATH 10A,A01,083735,Patchell; Gregory David,2,0,30,28
1657747786152,MATH 10A,A02,083736,Patchell; Gregory David,20,0,30,10
1657747786152,MATH 10A,A03,083737,Patchell; Gregory David,16,0,30,14
1657747792180,MATH 10B,A01,083207,Lim; Seonhee,8,0,34,26
1657747792180,MATH 10B,A02,083208,Lim; Seonhee,9,0,35,26
1657747792180,MATH 10B,A03,093472,Lim; Seonhee,7,0,34,27
1657747792180,MATH 10B,B01,083739,Sinha; Shubham,13,0,30,17
1657747798212,MATH 18,A01,083743,Cinel; Cameron Alexander,9,0,30,21
1657747798212,MATH 18,A02,083744,Cinel; Cameron Alexander,18,0,30,12
1657747798212,MATH 18,A03,083745,Cinel; Cameron Alexander,10,0,30,20
1657747798212,MATH 18,B01,083748,Rideout; David Porter,5,0,37,32
1657747798212,MATH 18,B02,083749,Rideout; David Porter,5,0,36,31
1657747798212,MATH 18,B03,083750,Rideout; David Porter,3,0,37,34
1657747798212,MATH 18,B04,083751,Rideout; David Porter,6,0,36,30
1657747798212,MATH 18,B05,093473,Rideout; David Porter,6,0,36,30
1657747798212,MATH 18,B06,093474,Rideout; David Porter,6,0,36,30
1657747804237,MATH 20A,A01,083754,Zheng; Zequn,14,0,40,26
1657747810260,MATH 20B,A01,083756,Briones; Jor-el Thomas Caparas,4,0,36,32
1657747810260,MATH 20B,A02,083757,Briones; Jor-el Thomas Caparas,1,0,36,35
1657747810260,MATH 20B,A03,093475,Briones; Jor-el Thomas Caparas,2,0,36,34
1657747816283,MATH 20C,A01,083760,Briones; Jor-el Thomas Caparas,1,0,35,34
1657747816283,MATH 20C,A02,083761,Briones; Jor-el Thomas Caparas,8,0,35,27
1657747816283,MATH 20C,A03,093476,Briones; Jor-el Thomas Caparas,0,1,36,36
1657747816283,MATH 20C,B01,083762,Bach; Quang Tran,1,0,30,29
1657747822316,MATH 20D,A01,083765,Tran; Brian Kha,5,0,30,25
1657747822316,MATH 20D,A02,083766,Tran; Brian Kha,5,0,30,25
1657747822316,MATH 20D,A03,083767,Tran; Brian Kha,5,0,30,25
1657747828348,MATH 20E,A01,083771,Ganguly; Soumya,9,0,32,23
1657747828348,MATH 20E,A02,083772,Ganguly; Soumya,6,0,32,26
1657747828348,MATH 20E,B01,083773,Ciotti; Benjamin,20,0,35,15
1657747828348,MATH 20E,B02,083774,Ciotti; Benjamin,18,0,35,17
1657747834378,MATH 103A,A01,083777,Greenfeld; Be'Eri,3,0,36,33
1657747834378,MATH 103A,A02,083778,Greenfeld; Be'Eri,5,0,36,31
1657747834378,MATH 103A,A03,093561,Greenfeld; Be'Eri,6,0,36,30
1657747834378,MATH 103A,B01,083779,Greenfeld; Be'Eri,7,0,36,29
1657747834378,MATH 103A,B02,083780,Greenfeld; Be'Eri,4,0,36,32
1657747834378,MATH 103A,B03,093562,Greenfeld; Be'Eri,3,0,36,33
1657747840410,MATH 105,A01,085443,Carter; Anne Toulson,15,0,35,20
1657747840410,MATH 105,A02,093477,Carter; Anne Toulson,20,0,35,15
1657747846438,MATH 109,A01,083213,Ganzberger; Geoffrey Michael,3,0,34,31
1657747846438,MATH 109,A02,083214,Ganzberger; Geoffrey Michael,4,0,34,30
1657747846438,MATH 109,A03,093478,Ganzberger; Geoffrey Michael,2,0,34,32
1657747846438,MATH 109,B01,083215,Ganzberger; Geoffrey Michael,1,0,32,31
1657747846438,MATH 109,B02,083216,Ganzberger; Geoffrey Michael,2,0,32,30
1657747846438,MATH 109,B03,093479,Ganzberger; Geoffrey Michael,8,0,32,24
1657747852466,MATH 142A,A01,083219,Chow; Bennett,7,0,32,25
1657747852466,MATH 142A,A02,083220,Chow; Bennett,10,0,32,22
1657747852466,MATH 142A,A03,093480,Chow; Bennett,9,0,32,23
1657747852466,MATH 142A,B03,093481,Chow; Bennett,8,0,32,24
1657747852466,MATH 142A,B04,093558,Chow; Bennett,13,0,32,19
1657747852466,MATH 142A,B05,093559,Chow; Bennett,6,0,32,26
1657747858493,MATH 193A,A01,083224,Rotar; Vladimir,8,0,34,26
1657747858493,MATH 193A,A02,083225,Rotar; Vladimir,9,0,34,25
1657747858493,MATH 193A,A03,083781,Rotar; Vladimir,5,0,34,29
1657747858493,MATH 193A,A04,083782,Rotar; Vladimir,10,0,34,24
1657747858493,MATH 193A,A05,093482,Rotar; Vladimir,10,0,34,24
1657747864523,MATH 197,001,091859,McAuley; Julian John,9999,0,9999,0
1657747864523,MATH 197,002,095566,Kedlaya; Kiran S.,9997,0,9999,2
1657747864523,MATH 197,003,095567,Xiao; Ming,9999,0,9999,0
1657747864523,MATH 197,004,095571,Perols; Johan Lars,9998,0,9999,1
1657747871576,COGS 9,A01,083615,Shannon; Kyle Michael,9,0,75,66
1657747877610,COGS 11,A01,083617,Boyle; Mary E. T.,23,0,48,25
1657747883633,COGS 13,A01,083071,Bastos; Amalia Pinkusfeld,11,0,71,60
1657747889729,COGS 14A,A01,092681,Semenuks; Arturs,5,1,100,95
1657747895753,COGS 14B,A01,083073,Cheng; Tzu-Han,6,0,63,57
1657747901778,COGS 17,A01,092677,Semenuks; Arturs,6,0,81,75
1657747907804,COGS 100,A01,083619,Allen; Michael Gordon,17,0,70,53
1657747913834,COGS 101A,A01,083621,Davis; Joshua Daniel,9,0,68,59
1657747919858,COGS 101B,A01,091572,Allen; Michael Gordon,12,0,65,53
1657747925881,COGS 101C,A01,083625,Delgado; Tania,17,0,35,18
1657747931916,COGS 107A,A01,083627,Boyle; Mary E. T.,13,0,60,47
1657747937940,COGS 118A,A01,083075,Gupta; Anjum,21,0,76,55
1657747943963,CSE 3,A50,083646,Miranda; Gregory Joseph,24,0,50,26
1657747949998,CSE 8A,A50,083650,Miranda; Gregory Joseph,17,1,56,39
1657747956034,CSE 11,A01,083080,Cao; Yingjun,6,15,40,34
1657747962069,CSE 12,A01,083652,Krause-Levy; Sophia Louisa,28,1,120,92
1657747968095,CSE 15L,A01,083654,Morris; Justin Loren,9,0,50,41
1657747968095,CSE 15L,A02,083655,Morris; Justin Loren,9,0,50,41
1657747974120,CSE 20,A01,083657,Tran; Khoa Dang,39,0,80,41
1657747980142,CSE 21,A01,095574,Bach; Quang Tran,22,0,48,26
1657747986177,CSE 30,A01,083084,Eldon; John,6,0,80,74
1657747986177,CSE 30,B01,095061,Bhaskar; Nishant,9,0,50,41
1657747992202,CSE 100,A01,083659,Cao; Yingjun,5,4,70,65
1657747998224,CSE 134B,A01,083661,Powell; Thomas Allan,24,0,100,76
1657748004246,CSE 140,A01,083663,Gungor; Onat,15,0,85,70
1657748010272,CSE 140L,A01,083088,Eldon; John,23,0,100,77
1657748016296,CSE 175,A01,083665,Kumar; Rakesh,3,0,25,22
1657748022317,CSE 190,A00,092507,Dubnov; Shlomo,8,0,20,12
1657748028341,ECE 45,A01,083139,Congero; Spencer William,6,0,75,69
1657748034369,ECE 65,A50,083695,Saad; Andrew S,12,0,30,18
1657748034369,ECE 65,A51,095125,Saad; Andrew S,24,0,26,2
1657748040392,ECE 109,A01,091882,Touri; Behrouz,20,0,70,50
1657748046418,ECE 180,A00,083140,Abi Samra; Nicholas Camill,1,0,30,29
1657748046418,ECE 180,B00,083141,Abi Samra; Nicholas Camill,0,0,30,30
1657748052446,MATH 10A,A01,083735,Patchell; Gregory David,2,0,30,28
1657748052446,MATH 10A,A02,083736,Patchell; Gregory David,20,0,30,10
1657748052446,MATH 10A,A03,083737,Patchell; Gregory David,16,0,30,14
1657748058476,MATH 10B,A01,083207,Lim; Seonhee,8,0,34,26
1657748058476,MATH 10B,A02,083208,Lim; Seonhee,9,0,35,26
1657748058476,MATH 10B,A03,093472,Lim; Seonhee,7,0,34,27
1657748058476,MATH 10B,B01,083739,Sinha; Shubham,13,0,30,17
1657748064499,MATH 18,A01,083743,Cinel; Cameron Alexander,9,0,30,21
1657748064499,MATH 18,A02,083744,Cinel; Cameron Alexander,18,0,30,12
1657748064499,MATH 18,A03,083745,Cinel; Cameron Alexander,10,0,30,20
1657748064499,MATH 18,B01,083748,Rideout; David Porter,5,0,37,32
1657748064499,MATH 18,B02,083749,Rideout; David Porter,5,0,36,31
1657748064499,MATH 18,B03,083750,Rideout; David Porter,3,0,37,34
1657748064499,MATH 18,B04,083751,Rideout; David Porter,6,0,36,30
1657748064499,MATH 18,B05,093473,Rideout; David Porter,6,0,36,30
1657748064499,MATH 18,B06,093474,Rideout; David Porter,6,0,36,30
1657748070521,MATH 20A,A01,083754,Zheng; Zequn,14,0,40,26
1657748076549,MATH 20B,A01,083756,Briones; Jor-el Thomas Caparas,4,0,36,32
1657748076549,MATH 20B,A02,083757,Briones; Jor-el Thomas Caparas,1,0,36,35
1657748076549,MATH 20B,A03,093475,Briones; Jor-el Thomas Caparas,2,0,36,34
1657748082583,MATH 20C,A01,083760,Briones; Jor-el Thomas Caparas,1,0,35,34
1657748082583,MATH 20C,A02,083761,Briones; Jor-el Thomas Caparas,8,0,35,27
1657748082583,MATH 20C,A03,093476,Briones; Jor-el Thomas Caparas,0,1,36,36
1657748082583,MATH 20C,B01,083762,Bach; Quang Tran,1,0,30,29
1657748088607,MATH 20D,A01,083765,Tran; Brian Kha,5,0,30,25
1657748088607,MATH 20D,A02,083766,Tran; Brian Kha,5,0,30,25
1657748088607,MATH 20D,A03,083767,Tran; Brian Kha,5,0,30,25
1657748094635,MATH 20E,A01,083771,Ganguly; Soumya,9,0,32,23
1657748094635,MATH 20E,A02,083772,Ganguly; Soumya,6,0,32,26
1657748094635,MATH 20E,B01,083773,Ciotti; Benjamin,20,0,35,15
1657748094635,MATH 20E,B02,083774,Ciotti; Benjamin,18,0,35,17
1657748100660,MATH 103A,A01,083777,Greenfeld; Be'Eri,3,0,36,33
1657748100660,MATH 103A,A02,083778,Greenfeld; Be'Eri,5,0,36,31
1657748100660,MATH 103A,A03,093561,Greenfeld; Be'Eri,6,0,36,30
1657748100660,MATH 103A,B01,083779,Greenfeld; Be'Eri,7,0,36,29
1657748100660,MATH 103A,B02,083780,Greenfeld; Be'Eri,4,0,36,32
1657748100660,MATH 103A,B03,093562,Greenfeld; Be'Eri,3,0,36,33
1657748106684,MATH 105,A01,085443,Carter; Anne Toulson,15,0,35,20
1657748106684,MATH 105,A02,093477,Carter; Anne Toulson,20,0,35,15
1657748112706,MATH 109,A01,083213,Ganzberger; Geoffrey Michael,3,0,34,31
1657748112706,MATH 109,A02,083214,Ganzberger; Geoffrey Michael,4,0,34,30
1657748112706,MATH 109,A03,093478,Ganzberger; Geoffrey Michael,2,0,34,32
1657748112706,MATH 109,B01,083215,Ganzberger; Geoffrey Michael,1,0,32,31
1657748112706,MATH 109,B02,083216,Ganzberger; Geoffrey Michael,2,0,32,30
1657748112706,MATH 109,B03,093479,Ganzberger; Geoffrey Michael,8,0,32,24
1657748118731,MATH 142A,A01,083219,Chow; Bennett,7,0,32,25
1657748118731,MATH 142A,A02,083220,Chow; Bennett,10,0,32,22
1657748118731,MATH 142A,A03,093480,Chow; Bennett,9,0,32,23
1657748118731,MATH 142A,B03,093481,Chow; Bennett,8,0,32,24
1657748118731,MATH 142A,B04,093558,Chow; Bennett,13,0,32,19
1657748118731,MATH 142A,B05,093559,Chow; Bennett,6,0,32,26
1657748124771,MATH 193A,A01,083224,Rotar; Vladimir,8,0,34,26
1657748124771,MATH 193A,A02,083225,Rotar; Vladimir,9,0,34,25
1657748124771,MATH 193A,A03,083781,Rotar; Vladimir,5,0,34,29
1657748124771,MATH 193A,A04,083782,Rotar; Vladimir,10,0,34,24
1657748124771,MATH 193A,A05,093482,Rotar; Vladimir,10,0,34,24
1657748130793,MATH 197,001,091859,McAuley; Julian John,9999,0,9999,0
1657748130793,MATH 197,002,095566,Kedlaya; Kiran S.,9997,0,9999,2
1657748130793,MATH 197,003,095567,Xiao; Ming,9999,0,9999,0
1657748130793,MATH 197,004,095571,Perols; Johan Lars,9998,0,9999,1
1657748137852,COGS 9,A01,083615,Shannon; Kyle Michael,9,0,75,66
1657748143875,COGS 11,A01,083617,Boyle; Mary E. T.,23,0,48,25
1657748149896,COGS 13,A01,083071,Bastos; Amalia Pinkusfeld,11,0,71,60
1657748155925,COGS 14A,A01,092681,Semenuks; Arturs,5,1,100,95
1657748161952,COGS 14B,A01,083073,Cheng; Tzu-Han,6,0,63,57
1657748167979,COGS 17,A01,092677,Semenuks; Arturs,6,0,81,75
1657748174001,COGS 100,A01,083619,Allen; Michael Gordon,17,0,70,53
1657748180037,COGS 101A,A01,083621,Davis; Joshua Daniel,9,0,68,59
1657748186072,COGS 101B,A01,091572,Allen; Michael Gordon,12,0,65,53
1657748192100,COGS 101C,A01,083625,Delgado; Tania,17,0,35,18
1657748198123,COGS 107A,A01,083627,Boyle; Mary E. T.,13,0,60,47
1657748204146,COGS 118A,A01,083075,Gupta; Anjum,21,0,76,55
1657748210172,CSE 3,A50,083646,Miranda; Gregory Joseph,24,0,50,26
1657748216201,CSE 8A,A50,083650,Miranda; Gregory Joseph,17,1,56,39
1657748222233,CSE 11,A01,083080,Cao; Yingjun,6,15,40,34
1657748228259,CSE 12,A01,083652,Krause-Levy; Sophia Louisa,28,1,120,92
1657748234281,CSE 15L,A01,083654,Morris; Justin Loren,9,0,50,41
1657748234281,CSE 15L,A02,083655,Morris; Justin Loren,9,0,50,41
1657748240314,CSE 20,A01,083657,Tran; Khoa Dang,39,0,80,41
1657748246339,CSE 21,A01,095574,Bach; Quang Tran,22,0,48,26
1657748252366,CSE 30,A01,083084,Eldon; John,6,0,80,74
1657748252366,CSE 30,B01,095061,Bhaskar; Nishant,9,0,50,41
1657748258390,CSE 100,A01,083659,Cao; Yingjun,5,4,70,65
1657748264424,CSE 134B,A01,083661,Powell; Thomas Allan,24,0,100,76
1657748270447,CSE 140,A01,083663,Gungor; Onat,15,0,85,70
1657748276471,CSE 140L,A01,083088,Eldon; John,23,0,100,77
1657748282494,CSE 175,A01,083665,Kumar; Rakesh,3,0,25,22
1657748288517,CSE 190,A00,092507,Dubnov; Shlomo,8,0,20,12
1657748294559,ECE 45,A01,083139,Congero; Spencer William,6,0,75,69
1657748300584,ECE 65,A50,083695,Saad; Andrew S,12,0,30,18
1657748300584,ECE 65,A51,095125,Saad; Andrew S,24,0,26,2
1657748306607,ECE 109,A01,091882,Touri; Behrouz,20,0,70,50
1657748312633,ECE 180,A00,083140,Abi Samra; Nicholas Camill,1,0,30,29
1657748312633,ECE 180,B00,083141,Abi Samra; Nicholas Camill,0,0,30,30
1657748318675,MATH 10A,A01,083735,Patchell; Gregory David,2,0,30,28
1657748318675,MATH 10A,A02,083736,Patchell; Gregory David,20,0,30,10
1657748318675,MATH 10A,A03,083737,Patchell; Gregory David,16,0,30,14
1657748324704,MATH 10B,A01,083207,Lim; Seonhee,8,0,34,26
1657748324704,MATH 10B,A02,083208,Lim; Seonhee,9,0,35,26
1657748324704,MATH 10B,A03,093472,Lim; Seonhee,7,0,34,27
1657748324704,MATH 10B,B01,083739,Sinha; Shubham,13,0,30,17
1657748330733,MATH 18,A01,083743,Cinel; Cameron Alexander,9,0,30,21
1657748330733,MATH 18,A02,083744,Cinel; Cameron Alexander,18,0,30,12
1657748330733,MATH 18,A03,083745,Cinel; Cameron Alexander,10,0,30,20
1657748330733,MATH 18,B01,083748,Rideout; David Porter,5,0,37,32
1657748330733,MATH 18,B02,083749,Rideout; David Porter,5,0,36,31
1657748330733,MATH 18,B03,083750,Rideout; David Porter,3,0,37,34
1657748330733,MATH 18,B04,083751,Rideout; David Porter,6,0,36,30
1657748330733,MATH 18,B05,093473,Rideout; David Porter,6,0,36,30
1657748330733,MATH 18,B06,093474,Rideout; David Porter,6,0,36,30
1657748336768,MATH 20A,A01,083754,Zheng; Zequn,14,0,40,26
1657748342795,MATH 20B,A01,083756,Briones; Jor-el Thomas Caparas,4,0,36,32
1657748342795,MATH 20B,A02,083757,Briones; Jor-el Thomas Caparas,1,0,36,35
1657748342795,MATH 20B,A03,093475,Briones; Jor-el Thomas Caparas,2,0,36,34
1657748348819,MATH 20C,A01,083760,Briones; Jor-el Thomas Caparas,1,0,35,34
1657748348819,MATH 20C,A02,083761,Briones; Jor-el Thomas Caparas,8,0,35,27
1657748348819,MATH 20C,A03,093476,Briones; Jor-el Thomas Caparas,0,1,36,36
1657748348819,MATH 20C,B01,083762,Bach; Quang Tran,1,0,30,29
1657748354847,MATH 20D,A01,083765,Tran; Brian Kha,5,0,30,25
1657748354847,MATH 20D,A02,083766,Tran; Brian Kha,5,0,30,25
1657748354847,MATH 20D,A03,083767,Tran; Brian Kha,5,0,30,25
1657748360875,MATH 20E,A01,083771,Ganguly; Soumya,9,0,32,23
1657748360875,MATH 20E,A02,083772,Ganguly; Soumya,6,0,32,26
1657748360875,MATH 20E,B01,083773,Ciotti; Benjamin,20,0,35,15
1657748360875,MATH 20E,B02,083774,Ciotti; Benjamin,18,0,35,17
1657748366898,MATH 103A,A01,083777,Greenfeld; Be'Eri,3,0,36,33
1657748366898,MATH 103A,A02,083778,Greenfeld; Be'Eri,5,0,36,31
1657748366898,MATH 103A,A03,093561,Greenfeld; Be'Eri,6,0,36,30
1657748366898,MATH 103A,B01,083779,Greenfeld; Be'Eri,7,0,36,29
1657748366898,MATH 103A,B02,083780,Greenfeld; Be'Eri,4,0,36,32
1657748366898,MATH 103A,B03,093562,Greenfeld; Be'Eri,3,0,36,33
1657748372929,MATH 105,A01,085443,Carter; Anne Toulson,15,0,35,20
1657748372929,MATH 105,A02,093477,Carter; Anne Toulson,20,0,35,15
1657748378961,MATH 109,A01,083213,Ganzberger; Geoffrey Michael,3,0,34,31
1657748378961,MATH 109,A02,083214,Ganzberger; Geoffrey Michael,4,0,34,30
1657748378961,MATH 109,A03,093478,Ganzberger; Geoffrey Michael,2,0,34,32
1657748378961,MATH 109,B01,083215,Ganzberger; Geoffrey Michael,1,0,32,31
1657748378961,MATH 109,B02,083216,Ganzberger; Geoffrey Michael,2,0,32,30
1657748378961,MATH 109,B03,093479,Ganzberger; Geoffrey Michael,8,0,32,24
1657748384991,MATH 142A,A01,083219,Chow; Bennett,7,0,32,25
1657748384991,MATH 142A,A02,083220,Chow; Bennett,10,0,32,22
1657748384991,MATH 142A,A03,093480,Chow; Bennett,9,0,32,23
1657748384991,MATH 142A,B03,093481,Chow; Bennett,8,0,32,24
1657748384991,MATH 142A,B04,093558,Chow; Bennett,13,0,32,19
1657748384991,MATH 142A,B05,093559,Chow; Bennett,6,0,32,26
1657748391015,MATH 193A,A01,083224,Rotar; Vladimir,8,0,34,26
1657748391015,MATH 193A,A02,083225,Rotar; Vladimir,9,0,34,25
1657748391015,MATH 193A,A03,083781,Rotar; Vladimir,5,0,34,29
1657748391015,MATH 193A,A04,083782,Rotar; Vladimir,10,0,34,24
1657748391015,MATH 193A,A05,093482,Rotar; Vladimir,10,0,34,24
1657748397040,MATH 197,001,091859,McAuley; Julian John,9999,0,9999,0
1657748397040,MATH 197,002,095566,Kedlaya; Kiran S.,9997,0,9999,2
1657748397040,MATH 197,003,095567,Xiao; Ming,9999,0,9999,0
1657748397040,MATH 197,004,095571,Perols; Johan Lars,9998,0,9999,1
1657748404096,COGS 9,A01,083615,Shannon; Kyle Michael,9,0,75,66
1657748410119,COGS 11,A01,083617,Boyle; Mary E. T.,23,0,48,25
1657748416140,COGS 13,A01,083071,Bastos; Amalia Pinkusfeld,11,0,71,60
1657748422172,COGS 14A,A01,092681,Semenuks; Arturs,5,1,100,95
1657748428196,COGS 14B,A01,083073,Cheng; Tzu-Han,6,0,63,57
1657748434223,COGS 17,A01,092677,Semenuks; Arturs,6,0,81,75
1657748440246,COGS 100,A01,083619,Allen; Michael Gordon,17,0,70,53
1657748446268,COGS 101A,A01,083621,Davis; Joshua Daniel,9,0,68,59
1657748452291,COGS 101B,A01,091572,Allen; Michael Gordon,12,0,65,53
1657748458321,COGS 101C,A01,083625,Delgado; Tania,17,0,35,18
1657748464344,COGS 107A,A01,083627,Boyle; Mary E. T.,13,0,60,47
1657748470370,COGS 118A,A01,083075,Gupta; Anjum,21,0,76,55
1657748476392,CSE 3,A50,083646,Miranda; Gregory Joseph,24,0,50,26
1657748482419,CSE 8A,A50,083650,Miranda; Gregory Joseph,17,1,56,39
1657748488524,CSE 11,A01,083080,Cao; Yingjun,6,15,40,34
1657748494548,CSE 12,A01,083652,Krause-Levy; Sophia Louisa,28,1,120,92
1657748500577,CSE 15L,A01,083654,Morris; Justin Loren,9,0,50,41
1657748500577,CSE 15L,A02,083655,Morris; Justin Loren,9,0,50,41
1657748506600,CSE 20,A01,083657,Tran; Khoa Dang,39,0,80,41
1657748512627,CSE 21,A01,095574,Bach; Quang Tran,22,0,48,26
1657748518654,CSE 30,A01,083084,Eldon; John,6,0,80,74
1657748518654,CSE 30,B01,095061,Bhaskar; Nishant,9,0,50,41
1657748524680,CSE 100,A01,083659,Cao; Yingjun,5,4,70,65
1657748530703,CSE 134B,A01,083661,Powell; Thomas Allan,24,0,100,76
1657748536726,CSE 140,A01,083663,Gungor; Onat,15,0,85,70
1657748542749,CSE 140L,A01,083088,Eldon; John,23,0,100,77
1657748548772,CSE 175,A01,083665,Kumar; Rakesh,3,0,25,22
1657748554793,CSE 190,A00,092507,Dubnov; Shlomo,8,0,20,12
1657748560819,ECE 45,A01,083139,Congero; Spencer William,6,0,75,69
1657748566841,ECE 65,A50,083695,Saad; Andrew S,12,0,30,18
1657748566841,ECE 65,A51,095125,Saad; Andrew S,24,0,26,2
1657748572863,ECE 109,A01,091882,Touri; Behrouz,20,0,70,50
1657748578886,ECE 180,A00,083140,Abi Samra; Nicholas Camill,1,0,30,29
1657748578886,ECE 180,B00,083141,Abi Samra; Nicholas Camill,0,0,30,30
1657748584913,MATH 10A,A01,083735,Patchell; Gregory David,2,0,30,28
1657748584913,MATH 10A,A02,083736,Patchell; Gregory David,20,0,30,10
1657748584913,MATH 10A,A03,083737,Patchell; Gregory David,16,0,30,14
1657748590952,MATH 10B,A01,083207,Lim; Seonhee,8,0,34,26
1657748590952,MATH 10B,A02,083208,Lim; Seonhee,9,0,35,26
1657748590952,MATH 10B,A03,093472,Lim; Seonhee,7,0,34,27
1657748590952,MATH 10B,B01,083739,Sinha; Shubham,13,0,30,17
1657748596977,MATH 18,A01,083743,Cinel; Cameron Alexander,9,0,30,21
1657748596977,MATH 18,A02,083744,Cinel; Cameron Alexander,18,0,30,12
1657748596977,MATH 18,A03,083745,Cinel; Cameron Alexander,10,0,30,20
1657748596977,MATH 18,B01,083748,Rideout; David Porter,5,0,37,32
1657748596977,MATH 18,B02,083749,Rideout; David Porter,5,0,36,31
1657748596977,MATH 18,B03,083750,Rideout; David Porter,3,0,37,34
1657748596977,MATH 18,B04,083751,Rideout; David Porter,6,0,36,30
1657748596977,MATH 18,B05,093473,Rideout; David Porter,6,0,36,30
1657748596977,MATH 18,B06,093474,Rideout; David Porter,6,0,36,30
1657748603001,MATH 20A,A01,083754,Zheng; Zequn,14,0,40,26
1657748609032,MATH 20B,A01,083756,Briones; Jor-el Thomas Caparas,4,0,36,32
1657748609032,MATH 20B,A02,083757,Briones; Jor-el Thomas Caparas,1,0,36,35
1657748609032,MATH 20B,A03,093475,Briones; Jor-el Thomas Caparas,2,0,36,34
1657748615060,MATH 20C,A01,083760,Briones; Jor-el Thomas Caparas,1,0,35,34
1657748615060,MATH 20C,A02,083761,Briones; Jor-el Thomas Caparas,8,0,35,27
1657748615060,MATH 20C,A03,093476,Briones; Jor-el Thomas Caparas,0,1,36,36
1657748615060,MATH 20C,B01,083762,Bach; Quang Tran,1,0,30,29
1657748621088,MATH 20D,A01,083765,Tran; Brian Kha,5,0,30,25
1657748621088,MATH 20D,A02,083766,Tran; Brian Kha,5,0,30,25
1657748621088,MATH 20D,A03,083767,Tran; Brian Kha,5,0,30,25
1657748627116,MATH 20E,A01,083771,Ganguly; Soumya,9,0,32,23
1657748627116,MATH 20E,A02,083772,Ganguly; Soumya,6,0,32,26
1657748627116,MATH 20E,B01,083773,Ciotti; Benjamin,20,0,35,15
1657748627116,MATH 20E,B02,083774,Ciotti; Benjamin,18,0,35,17
1657748633140,MATH 103A,A01,083777,Greenfeld; Be'Eri,3,0,36,33
1657748633140,MATH 103A,A02,083778,Greenfeld; Be'Eri,5,0,36,31
1657748633140,MATH 103A,A03,093561,Greenfeld; Be'Eri,6,0,36,30
1657748633140,MATH 103A,B01,083779,Greenfeld; Be'Eri,7,0,36,29
1657748633140,MATH 103A,B02,083780,Greenfeld; Be'Eri,4,0,36,32
1657748633140,MATH 103A,B03,093562,Greenfeld; Be'Eri,3,0,36,33
1657748639168,MATH 105,A01,085443,Carter; Anne Toulson,15,0,35,20
1657748639168,MATH 105,A02,093477,Carter; Anne Toulson,20,0,35,15
1657748645195,MATH 109,A01,083213,Ganzberger; Geoffrey Michael,3,0,34,31
1657748645195,MATH 109,A02,083214,Ganzberger; Geoffrey Michael,4,0,34,30
1657748645195,MATH 109,A03,093478,Ganzberger; Geoffrey Michael,2,0,34,32
1657748645195,MATH 109,B01,083215,Ganzberger; Geoffrey Michael,1,0,32,31
1657748645195,MATH 109,B02,083216,Ganzberger; Geoffrey Michael,2,0,32,30
1657748645195,MATH 109,B03,093479,Ganzberger; Geoffrey Michael,8,0,32,24
1657748651219,MATH 142A,A01,083219,Chow; Bennett,7,0,32,25
1657748651219,MATH 142A,A02,083220,Chow; Bennett,10,0,32,22
1657748651219,MATH 142A,A03,093480,Chow; Bennett,9,0,32,23
1657748651219,MATH 142A,B03,093481,Chow; Bennett,8,0,32,24
1657748651219,MATH 142A,B04,093558,Chow; Bennett,13,0,32,19
1657748651219,MATH 142A,B05,093559,Chow; Bennett,6,0,32,26
1657748657248,MATH 193A,A01,083224,Rotar; Vladimir,8,0,34,26
1657748657248,MATH 193A,A02,083225,Rotar; Vladimir,9,0,34,25
1657748657248,MATH 193A,A03,083781,Rotar; Vladimir,5,0,34,29
1657748657248,MATH 193A,A04,083782,Rotar; Vladimir,10,0,34,24
1657748657248,MATH 193A,A05,093482,Rotar; Vladimir,10,0,34,24
1657748663273,MATH 197,001,091859,McAuley; Julian John,9999,0,9999,0
1657748663273,MATH 197,002,095566,Kedlaya; Kiran S.,9997,0,9999,2
1657748663273,MATH 197,003,095567,Xiao; Ming,9999,0,9999,0
1657748663273,MATH 197,004,095571,Perols; Johan Lars,9998,0,9999,1
1657748670329,COGS 9,A01,083615,Shannon; Kyle Michael,9,0,75,66
1657748676359,COGS 11,A01,083617,Boyle; Mary E. T.,23,0,48,25
1657748682382,COGS 13,A01,083071,Bastos; Amalia Pinkusfeld,11,0,71,60
1657748688407,COGS 14A,A01,092681,Semenuks; Arturs,5,1,100,95
1657748694429,COGS 14B,A01,083073,Cheng; Tzu-Han,6,0,63,57
1657748700456,COGS 17,A01,092677,Semenuks; Arturs,6,0,81,75
1657748706478,COGS 100,A01,083619,Allen; Michael Gordon,17,0,70,53
1657748712501,COGS 101A,A01,083621,Davis; Joshua Daniel,9,0,68,59
1657748718523,COGS 101B,A01,091572,Allen; Michael Gordon,12,0,65,53
1657748724551,COGS 101C,A01,083625,Delgado; Tania,17,0,35,18
1657748730576,COGS 107A,A01,083627,Boyle; Mary E. T.,13,0,60,47
1657748736606,COGS 118A,A01,083075,Gupta; Anjum,21,0,76,55
1657748742633,CSE 3,A50,083646,Miranda; Gregory Joseph,24,0,50,26
1657748748657,CSE 8A,A50,083650,Miranda; Gregory Joseph,17,1,56,39
1657748754678,CSE 11,A01,083080,Cao; Yingjun,6,15,40,34
1657748760703,CSE 12,A01,083652,Krause-Levy; Sophia Louisa,28,1,120,92
1657748766740,CSE 15L,A01,083654,Morris; Justin Loren,9,0,50,41
1657748766740,CSE 15L,A02,083655,Morris; Justin Loren,9,0,50,41
1657748772764,CSE 20,A01,083657,Tran; Khoa Dang,39,0,80,41
1657748778791,CSE 21,A01,095574,Bach; Quang Tran,22,0,48,26
1657748784814,CSE 30,A01,083084,Eldon; John,6,0,80,74
1657748784814,CSE 30,B01,095061,Bhaskar; Nishant,9,0,50,41
1657748790837,CSE 100,A01,083659,Cao; Yingjun,5,4,70,65
1657748796882,CSE 134B,A01,083661,Powell; Thomas Allan,24,0,100,76
1657748802909,CSE 140,A01,083663,Gungor; Onat,15,0,85,70
1657748808935,CSE 140L,A01,083088,Eldon; John,23,0,100,77
1657748814960,CSE 175,A01,083665,Kumar; Rakesh,3,0,25,22
1657748820986,CSE 190,A00,092507,Dubnov; Shlomo,8,0,20,12
1657748827009,ECE 45,A01,083139,Congero; Spencer William,6,0,75,69
1657748833038,ECE 65,A50,083695,Saad; Andrew S,12,0,30,18
1657748833038,ECE 65,A51,095125,Saad; Andrew S,24,0,26,2
1657748839065,ECE 109,A01,091882,Touri; Behrouz,20,0,70,50
1657748845097,ECE 180,A00,083140,Abi Samra; Nicholas Camill,1,0,30,29
1657748845097,ECE 180,B00,083141,Abi Samra; Nicholas Camill,0,0,30,30
1657748851137,MATH 10A,A01,083735,Patchell; Gregory David,2,0,30,28
1657748851137,MATH 10A,A02,083736,Patchell; Gregory David,20,0,30,10
1657748851137,MATH 10A,A03,083737,Patchell; Gregory David,16,0,30,14
1657748857175,MATH 10B,A01,083207,Lim; Seonhee,8,0,34,26
1657748857175,MATH 10B,A02,083208,Lim; Seonhee,9,0,35,26
1657748857175,MATH 10B,A03,093472,Lim; Seonhee,7,0,34,27
1657748857175,MATH 10B,B01,083739,Sinha; Shubham,13,0,30,17
1657748863205,MATH 18,A01,083743,Cinel; Cameron Alexander,9,0,30,21
1657748863205,MATH 18,A02,083744,Cinel; Cameron Alexander,18,0,30,12
1657748863205,MATH 18,A03,083745,Cinel; Cameron Alexander,10,0,30,20
1657748863205,MATH 18,B01,083748,Rideout; David Porter,5,0,37,32
1657748863205,MATH 18,B02,083749,Rideout; David Porter,5,0,36,31
1657748863205,MATH 18,B03,083750,Rideout; David Porter,3,0,37,34
1657748863205,MATH 18,B04,083751,Rideout; David Porter,6,0,36,30
1657748863205,MATH 18,B05,093473,Rideout; David Porter,6,0,36,30
1657748863205,MATH 18,B06,093474,Rideout; David Porter,6,0,36,30
1657748869227,MATH 20A,A01,083754,Zheng; Zequn,14,0,40,26
1657748875263,MATH 20B,A01,083756,Briones; Jor-el Thomas Caparas,4,0,36,32
1657748875263,MATH 20B,A02,083757,Briones; Jor-el Thomas Caparas,1,0,36,35
1657748875263,MATH 20B,A03,093475,Briones; Jor-el Thomas Caparas,2,0,36,34
1657748881289,MATH 20C,A01,083760,Briones; Jor-el Thomas Caparas,1,0,35,34
1657748881289,MATH 20C,A02,083761,Briones; Jor-el Thomas Caparas,8,0,35,27
1657748881289,MATH 20C,A03,093476,Briones; Jor-el Thomas Caparas,0,1,36,36
1657748881289,MATH 20C,B01,083762,Bach; Quang Tran,1,0,30,29
1657748887316,MATH 20D,A01,083765,Tran; Brian Kha,5,0,30,25
1657748887316,MATH 20D,A02,083766,Tran; Brian Kha,5,0,30,25
1657748887316,MATH 20D,A03,083767,Tran; Brian Kha,5,0,30,25
1657748893344,MATH 20E,A01,083771,Ganguly; Soumya,9,0,32,23
1657748893344,MATH 20E,A02,083772,Ganguly; Soumya,6,0,32,26
1657748893344,MATH 20E,B01,083773,Ciotti; Benjamin,20,0,35,15
1657748893344,MATH 20E,B02,083774,Ciotti; Benjamin,18,0,35,17
1657748899374,MATH 103A,A01,083777,Greenfeld; Be'Eri,3,0,36,33
1657748899374,MATH 103A,A02,083778,Greenfeld; Be'Eri,5,0,36,31
1657748899374,MATH 103A,A03,093561,Greenfeld; Be'Eri,6,0,36,30
1657748899374,MATH 103A,B01,083779,Greenfeld; Be'Eri,7,0,36,29
1657748899374,MATH 103A,B02,083780,Greenfeld; Be'Eri,4,0,36,32
1657748899374,MATH 103A,B03,093562,Greenfeld; Be'Eri,3,0,36,33
1657748905400,MATH 105,A01,085443,Carter; Anne Toulson,15,0,35,20
1657748905400,MATH 105,A02,093477,Carter; Anne Toulson,20,0,35,15
1657748911440,MATH 109,A01,083213,Ganzberger; Geoffrey Michael,3,0,34,31
1657748911440,MATH 109,A02,083214,Ganzberger; Geoffrey Michael,4,0,34,30
1657748911440,MATH 109,A03,093478,Ganzberger; Geoffrey Michael,2,0,34,32
1657748911440,MATH 109,B01,083215,Ganzberger; Geoffrey Michael,1,0,32,31
1657748911440,MATH 109,B02,083216,Ganzberger; Geoffrey Michael,2,0,32,30
1657748911440,MATH 109,B03,093479,Ganzberger; Geoffrey Michael,8,0,32,24
1657748917464,MATH 142A,A01,083219,Chow; Bennett,7,0,32,25
1657748917464,MATH 142A,A02,083220,Chow; Bennett,10,0,32,22
1657748917464,MATH 142A,A03,093480,Chow; Bennett,9,0,32,23
1657748917464,MATH 142A,B03,093481,Chow; Bennett,8,0,32,24
1657748917464,MATH 142A,B04,093558,Chow; Bennett,13,0,32,19
1657748917464,MATH 142A,B05,093559,Chow; Bennett,6,0,32,26
1657748923500,MATH 193A,A01,083224,Rotar; Vladimir,8,0,34,26
1657748923500,MATH 193A,A02,083225,Rotar; Vladimir,9,0,34,25
1657748923500,MATH 193A,A03,083781,Rotar; Vladimir,5,0,34,29
1657748923500,MATH 193A,A04,083782,Rotar; Vladimir,10,0,34,24
1657748923500,MATH 193A,A05,093482,Rotar; Vladimir,10,0,34,24
1657748929523,MATH 197,001,091859,McAuley; Julian John,9999,0,9999,0
1657748929523,MATH 197,002,095566,Kedlaya; Kiran S.,9997,0,9999,2
1657748929523,MATH 197,003,095567,Xiao; Ming,9999,0,9999,0
1657748929523,MATH 197,004,095571,Perols; Johan Lars,9998,0,9999,1
1657748936573,COGS 9,A01,083615,Shannon; Kyle Michael,9,0,75,66
1657748942597,COGS 11,A01,083617,Boyle; Mary E. T.,23,0,48,25
1657748948624,COGS 13,A01,083071,Bastos; Amalia Pinkusfeld,11,0,71,60
1657748954646,COGS 14A,A01,092681,Semenuks; Arturs,5,1,100,95
1657748960670,COGS 14B,A01,083073,Cheng; Tzu-Han,6,0,63,57
1657748966694,COGS 17,A01,092677,Semenuks; Arturs,6,0,81,75
1657748972717,COGS 100,A01,083619,Allen; Michael Gordon,17,0,70,53
1657748978743,COGS 101A,A01,083621,Davis; Joshua Daniel,9,0,68,59
1657748984766,COGS 101B,A01,091572,Allen; Michael Gordon,12,0,65,53
1657748990798,COGS 101C,A01,083625,Delgado; Tania,17,0,35,18
1657748996820,COGS 107A,A01,083627,Boyle; Mary E. T.,13,0,60,47
1657749002846,COGS 118A,A01,083075,Gupta; Anjum,21,0,76,55
1657749008869,CSE 3,A50,083646,Miranda; Gregory Joseph,24,0,50,26
1657749014897,CSE 8A,A50,083650,Miranda; Gregory Joseph,17,1,56,39
1657749020929,CSE 11,A01,083080,Cao; Yingjun,6,15,40,34
1657749026955,CSE 12,A01,083652,Krause-Levy; Sophia Louisa,28,1,120,92
1657749032979,CSE 15L,A01,083654,Morris; Justin Loren,9,0,50,41
1657749032979,CSE 15L,A02,083655,Morris; Justin Loren,9,0,50,41
1657749039001,CSE 20,A01,083657,Tran; Khoa Dang,39,0,80,41
1657749045030,CSE 21,A01,095574,Bach; Quang Tran,22,0,48,26
1657749051058,CSE 30,A01,083084,Eldon; John,6,0,80,74
1657749051058,CSE 30,B01,095061,Bhaskar; Nishant,9,0,50,41
1657749057086,CSE 100,A01,083659,Cao; Yingjun,5,4,70,65
1657749063110,CSE 134B,A01,083661,Powell; Thomas Allan,24,0,100,76
1657749069139,CSE 140,A01,083663,Gungor; Onat,15,0,85,70
1657749075160,CSE 140L,A01,083088,Eldon; John,23,0,100,77
1657749081183,CSE 175,A01,083665,Kumar; Rakesh,3,0,25,22
1657749087302,CSE 190,A00,092507,Dubnov; Shlomo,8,0,20,12
1657749093325,ECE 45,A01,083139,Congero; Spencer William,6,0,75,69
1657749099357,ECE 65,A50,083695,Saad; Andrew S,12,0,30,18
1657749099357,ECE 65,A51,095125,Saad; Andrew S,24,0,26,2
1657749105379,ECE 109,A01,091882,Touri; Behrouz,20,0,70,50
1657749111402,ECE 180,A00,083140,Abi Samra; Nicholas Camill,1,0,30,29
1657749111402,ECE 180,B00,083141,Abi Samra; Nicholas Camill,0,0,30,30
1657749117433,MATH 10A,A01,083735,Patchell; Gregory David,2,0,30,28
1657749117433,MATH 10A,A02,083736,Patchell; Gregory David,20,0,30,10
1657749117433,MATH 10A,A03,083737,Patchell; Gregory David,16,0,30,14
1657749123462,MATH 10B,A01,083207,Lim; Seonhee,8,0,34,26
1657749123462,MATH 10B,A02,083208,Lim; Seonhee,9,0,35,26
1657749123462,MATH 10B,A03,093472,Lim; Seonhee,7,0,34,27
1657749123462,MATH 10B,B01,083739,Sinha; Shubham,13,0,30,17
1657749129486,MATH 18,A01,083743,Cinel; Cameron Alexander,9,0,30,21
1657749129486,MATH 18,A02,083744,Cinel; Cameron Alexander,18,0,30,12
1657749129486,MATH 18,A03,083745,Cinel; Cameron Alexander,10,0,30,20
1657749129486,MATH 18,B01,083748,Rideout; David Porter,5,0,37,32
1657749129486,MATH 18,B02,083749,Rideout; David Porter,5,0,36,31
1657749129486,MATH 18,B03,083750,Rideout; David Porter,3,0,37,34
1657749129486,MATH 18,B04,083751,Rideout; David Porter,6,0,36,30
1657749129486,MATH 18,B05,093473,Rideout; David Porter,6,0,36,30
1657749129486,MATH 18,B06,093474,Rideout; David Porter,6,0,36,30
1657749135509,MATH 20A,A01,083754,Zheng; Zequn,14,0,40,26
1657749141538,MATH 20B,A01,083756,Briones; Jor-el Thomas Caparas,4,0,36,32
1657749141538,MATH 20B,A02,083757,Briones; Jor-el Thomas Caparas,1,0,36,35
1657749141538,MATH 20B,A03,093475,Briones; Jor-el Thomas Caparas,2,0,36,34
1657749147566,MATH 20C,A01,083760,Briones; Jor-el Thomas Caparas,1,0,35,34
1657749147566,MATH 20C,A02,083761,Briones; Jor-el Thomas Caparas,8,0,35,27
1657749147566,MATH 20C,A03,093476,Briones; Jor-el Thomas Caparas,0,1,36,36
1657749147566,MATH 20C,B01,083762,Bach; Quang Tran,1,0,30,29
1657749153605,MATH 20D,A01,083765,Tran; Brian Kha,5,0,30,25
1657749153605,MATH 20D,A02,083766,Tran; Brian Kha,5,0,30,25
1657749153605,MATH 20D,A03,083767,Tran; Brian Kha,5,0,30,25
1657749159628,MATH 20E,A01,083771,Ganguly; Soumya,9,0,32,23
1657749159628,MATH 20E,A02,083772,Ganguly; Soumya,6,0,32,26
1657749159628,MATH 20E,B01,083773,Ciotti; Benjamin,20,0,35,15
1657749159628,MATH 20E,B02,083774,Ciotti; Benjamin,18,0,35,17
1657749165658,MATH 103A,A01,083777,Greenfeld; Be'Eri,3,0,36,33
1657749165658,MATH 103A,A02,083778,Greenfeld; Be'Eri,5,0,36,31
1657749165658,MATH 103A,A03,093561,Greenfeld; Be'Eri,6,0,36,30
1657749165658,MATH 103A,B01,083779,Greenfeld; Be'Eri,7,0,36,29
1657749165658,MATH 103A,B02,083780,Greenfeld; Be'Eri,4,0,36,32
1657749165658,MATH 103A,B03,093562,Greenfeld; Be'Eri,3,0,36,33
1657749171685,MATH 105,A01,085443,Carter; Anne Toulson,15,0,35,20
1657749171685,MATH 105,A02,093477,Carter; Anne Toulson,20,0,35,15
1657749177716,MATH 109,A01,083213,Ganzberger; Geoffrey Michael,3,0,34,31
1657749177716,MATH 109,A02,083214,Ganzberger; Geoffrey Michael,4,0,34,30
1657749177716,MATH 109,A03,093478,Ganzberger; Geoffrey Michael,2,0,34,32
1657749177716,MATH 109,B01,083215,Ganzberger; Geoffrey Michael,1,0,32,31
1657749177716,MATH 109,B02,083216,Ganzberger; Geoffrey Michael,2,0,32,30
1657749177716,MATH 109,B03,093479,Ganzberger; Geoffrey Michael,8,0,32,24
1657749183749,MATH 142A,A01,083219,Chow; Bennett,7,0,32,25
1657749183749,MATH 142A,A02,083220,Chow; Bennett,10,0,32,22
1657749183749,MATH 142A,A03,093480,Chow; Bennett,9,0,32,23
1657749183749,MATH 142A,B03,093481,Chow; Bennett,8,0,32,24
1657749183749,MATH 142A,B04,093558,Chow; Bennett,13,0,32,19
1657749183749,MATH 142A,B05,093559,Chow; Bennett,6,0,32,26
1657749189776,MATH 193A,A01,083224,Rotar; Vladimir,8,0,34,26
1657749189776,MATH 193A,A02,083225,Rotar; Vladimir,9,0,34,25
1657749189776,MATH 193A,A03,083781,Rotar; Vladimir,5,0,34,29
1657749189776,MATH 193A,A04,083782,Rotar; Vladimir,10,0,34,24
1657749189776,MATH 193A,A05,093482,Rotar; Vladimir,10,0,34,24
1657749195807,MATH 197,001,091859,McAuley; Julian John,9999,0,9999,0
1657749195807,MATH 197,002,095566,Kedlaya; Kiran S.,9997,0,9999,2
1657749195807,MATH 197,003,095567,Xiao; Ming,9999,0,9999,0
1657749195807,MATH 197,004,095571,Perols; Johan Lars,9998,0,9999,1
1657749202878,COGS 9,A01,083615,Shannon; Kyle Michael,9,0,75,66
1657749208905,COGS 11,A01,083617,Boyle; Mary E. T.,23,0,48,25
1657749214940,COGS 13,A01,083071,Bastos; Amalia Pinkusfeld,11,0,71,60
1657749220964,COGS 14A,A01,092681,Semenuks; Arturs,5,1,100,95
1657749226993,COGS 14B,A01,083073,Cheng; Tzu-Han,6,0,63,57
1657749233015,COGS 17,A01,092677,Semenuks; Arturs,6,0,81,75
1657749239041,COGS 100,A01,083619,Allen; Michael Gordon,17,0,70,53
1657749245069,COGS 101A,A01,083621,Davis; Joshua Daniel,9,0,68,59
1657749251096,COGS 101B,A01,091572,Allen; Michael Gordon,12,0,65,53
1657749257123,COGS 101C,A01,083625,Delgado; Tania,17,0,35,18
1657749263145,COGS 107A,A01,083627,Boyle; Mary E. T.,13,0,60,47
1657749269168,COGS 118A,A01,083075,Gupta; Anjum,21,0,76,55
1657749275199,CSE 3,A50,083646,Miranda; Gregory Joseph,24,0,50,26
1657749281220,CSE 8A,A50,083650,Miranda; Gregory Joseph,17,1,56,39
1657749287241,CSE 11,A01,083080,Cao; Yingjun,6,15,40,34
1657749293263,CSE 12,A01,083652,Krause-Levy; Sophia Louisa,28,1,120,92
1657749299290,CSE 15L,A01,083654,Morris; Justin Loren,9,0,50,41
1657749299290,CSE 15L,A02,083655,Morris; Justin Loren,9,0,50,41
1657749305325,CSE 20,A01,083657,Tran; Khoa Dang,39,0,80,41
1657749311348,CSE 21,A01,095574,Bach; Quang Tran,22,0,48,26
1657749317372,CSE 30,A01,083084,Eldon; John,6,0,80,74
1657749317372,CSE 30,B01,095061,Bhaskar; Nishant,9,0,50,41
1657749323397,CSE 100,A01,083659,Cao; Yingjun,5,4,70,65
1657749329418,CSE 134B,A01,083661,Powell; Thomas Allan,24,0,100,76
1657749335442,CSE 140,A01,083663,Gungor; Onat,15,0,85,70
1657749341465,CSE 140L,A01,083088,Eldon; John,23,0,100,77
1657749347487,CSE 175,A01,083665,Kumar; Rakesh,3,0,25,22
1657749353526,CSE 190,A00,092507,Dubnov; Shlomo,8,0,20,12
1657749359550,ECE 45,A01,083139,Congero; Spencer William,6,0,75,69
1657749365578,ECE 65,A50,083695,Saad; Andrew S,12,0,30,18
1657749365578,ECE 65,A51,095125,Saad; Andrew S,24,0,26,2
1657749371603,ECE 109,A01,091882,Touri; Behrouz,20,0,70,50
1657749377627,ECE 180,A00,083140,Abi Samra; Nicholas Camill,1,0,30,29
1657749377627,ECE 180,B00,083141,Abi Samra; Nicholas Camill,0,0,30,30
1657749383656,MATH 10A,A01,083735,Patchell; Gregory David,2,0,30,28
1657749383656,MATH 10A,A02,083736,Patchell; Gregory David,20,0,30,10
1657749383656,MATH 10A,A03,083737,Patchell; Gregory David,16,0,30,14
1657749389684,MATH 10B,A01,083207,Lim; Seonhee,8,0,34,26
1657749389684,MATH 10B,A02,083208,Lim; Seonhee,9,0,35,26
1657749389684,MATH 10B,A03,093472,Lim; Seonhee,7,0,34,27
1657749389684,MATH 10B,B01,083739,Sinha; Shubham,13,0,30,17
1657749395722,MATH 18,A01,083743,Cinel; Cameron Alexander,9,0,30,21
1657749395722,MATH 18,A02,083744,Cinel; Cameron Alexander,18,0,30,12
1657749395722,MATH 18,A03,083745,Cinel; Cameron Alexander,10,0,30,20
1657749395722,MATH 18,B01,083748,Rideout; David Porter,5,0,37,32
1657749395722,MATH 18,B02,083749,Rideout; David Porter,5,0,36,31
1657749395722,MATH 18,B03,083750,Rideout; David Porter,3,0,37,34
1657749395722,MATH 18,B04,083751,Rideout; David Porter,6,0,36,30
1657749395722,MATH 18,B05,093473,Rideout; David Porter,6,0,36,30
1657749395722,MATH 18,B06,093474,Rideout; David Porter,6,0,36,30
1657749401753,MATH 20A,A01,083754,Zheng; Zequn,14,0,40,26
1657749407781,MATH 20B,A01,083756,Briones; Jor-el Thomas Caparas,4,0,36,32
1657749407781,MATH 20B,A02,083757,Briones; Jor-el Thomas Caparas,1,0,36,35
1657749407781,MATH 20B,A03,093475,Briones; Jor-el Thomas Caparas,2,0,36,34
1657749413833,MATH 20C,A01,083760,Briones; Jor-el Thomas Caparas,1,0,35,34
1657749413833,MATH 20C,A02,083761,Briones; Jor-el Thomas Caparas,8,0,35,27
1657749413833,MATH 20C,A03,093476,Briones; Jor-el Thomas Caparas,0,1,36,36
1657749413833,MATH 20C,B01,083762,Bach; Quang Tran,1,0,30,29
1657749419858,MATH 20D,A01,083765,Tran; Brian Kha,5,0,30,25
1657749419858,MATH 20D,A02,083766,Tran; Brian Kha,5,0,30,25
1657749419858,MATH 20D,A03,083767,Tran; Brian Kha,5,0,30,25
1657749425889,MATH 20E,A01,083771,Ganguly; Soumya,9,0,32,23
1657749425889,MATH 20E,A02,083772,Ganguly; Soumya,6,0,32,26
1657749425889,MATH 20E,B01,083773,Ciotti; Benjamin,20,0,35,15
1657749425889,MATH 20E,B02,083774,Ciotti; Benjamin,18,0,35,17
1657749431922,MATH 103A,A01,083777,Greenfeld; Be'Eri,3,0,36,33
1657749431922,MATH 103A,A02,083778,Greenfeld; Be'Eri,5,0,36,31
1657749431922,MATH 103A,A03,093561,Greenfeld; Be'Eri,6,0,36,30
1657749431922,MATH 103A,B01,083779,Greenfeld; Be'Eri,7,0,36,29
1657749431922,MATH 103A,B02,083780,Greenfeld; Be'Eri,4,0,36,32
1657749431922,MATH 103A,B03,093562,Greenfeld; Be'Eri,3,0,36,33
1657749437949,MATH 105,A01,085443,Carter; Anne Toulson,15,0,35,20
1657749437949,MATH 105,A02,093477,Carter; Anne Toulson,20,0,35,15
1657749451372,MATH 109,A01,083213,Ganzberger; Geoffrey Michael,3,0,34,31
1657749451372,MATH 109,A02,083214,Ganzberger; Geoffrey Michael,4,0,34,30
1657749451372,MATH 109,A03,093478,Ganzberger; Geoffrey Michael,2,0,34,32
1657749451372,MATH 109,B01,083215,Ganzberger; Geoffrey Michael,1,0,32,31
1657749451372,MATH 109,B02,083216,Ganzberger; Geoffrey Michael,2,0,32,30
1657749451372,MATH 109,B03,093479,Ganzberger; Geoffrey Michael,8,0,32,24
1657749457396,MATH 142A,A01,083219,Chow; Bennett,7,0,32,25
1657749457396,MATH 142A,A02,083220,Chow; Bennett,10,0,32,22
1657749457396,MATH 142A,A03,093480,Chow; Bennett,9,0,32,23
1657749457396,MATH 142A,B03,093481,Chow; Bennett,8,0,32,24
1657749457396,MATH 142A,B04,093558,Chow; Bennett,13,0,32,19
1657749457396,MATH 142A,B05,093559,Chow; Bennett,6,0,32,26
1657749463425,MATH 193A,A01,083224,Rotar; Vladimir,8,0,34,26
1657749463425,MATH 193A,A02,083225,Rotar; Vladimir,9,0,34,25
1657749463425,MATH 193A,A03,083781,Rotar; Vladimir,5,0,34,29
1657749463425,MATH 193A,A04,083782,Rotar; Vladimir,10,0,34,24
1657749463425,MATH 193A,A05,093482,Rotar; Vladimir,10,0,34,24
1657749469452,MATH 197,001,091859,McAuley; Julian John,9999,0,9999,0
1657749469452,MATH 197,002,095566,Kedlaya; Kiran S.,9997,0,9999,2
1657749469452,MATH 197,003,095567,Xiao; Ming,9999,0,9999,0
1657749469452,MATH 197,004,095571,Perols; Johan Lars,9998,0,9999,1
1657749476514,COGS 9,A01,083615,Shannon; Kyle Michael,9,0,75,66
1657749482538,COGS 11,A01,083617,Boyle; Mary E. T.,23,0,48,25
1657749488560,COGS 13,A01,083071,Bastos; Amalia Pinkusfeld,11,0,71,60
1657749494583,COGS 14A,A01,092681,Semenuks; Arturs,5,1,100,95
1657749500606,COGS 14B,A01,083073,Cheng; Tzu-Han,6,0,63,57
1657749506630,COGS 17,A01,092677,Semenuks; Arturs,6,0,81,75
1657749512653,COGS 100,A01,083619,Allen; Michael Gordon,17,0,70,53
1657749518674,COGS 101A,A01,083621,Davis; Joshua Daniel,9,0,68,59
1657749524705,COGS 101B,A01,091572,Allen; Michael Gordon,12,0,65,53
1657749530728,COGS 101C,A01,083625,Delgado; Tania,17,0,35,18
1657749536751,COGS 107A,A01,083627,Boyle; Mary E. T.,13,0,60,47
1657749542774,COGS 118A,A01,083075,Gupta; Anjum,21,0,76,55
1657749548797,CSE 3,A50,083646,Miranda; Gregory Joseph,24,0,50,26
1657749554825,CSE 8A,A50,083650,Miranda; Gregory Joseph,17,1,56,39
1657749560850,CSE 11,A01,083080,Cao; Yingjun,6,15,40,34
1657749566878,CSE 12,A01,083652,Krause-Levy; Sophia Louisa,28,1,120,92
1657749572905,CSE 15L,A01,083654,Morris; Justin Loren,9,0,50,41
1657749572905,CSE 15L,A02,083655,Morris; Justin Loren,9,0,50,41
1657749578927,CSE 20,A01,083657,Tran; Khoa Dang,39,0,80,41
1657749584953,CSE 21,A01,095574,Bach; Quang Tran,22,0,48,26
1657749590977,CSE 30,A01,083084,Eldon; John,6,0,80,74
1657749590977,CSE 30,B01,095061,Bhaskar; Nishant,9,0,50,41
1657749596998,CSE 100,A01,083659,Cao; Yingjun,5,4,70,65
1657749603027,CSE 134B,A01,083661,Powell; Thomas Allan,24,0,100,76
1657749609055,CSE 140,A01,083663,Gungor; Onat,15,0,85,70
1657749615081,CSE 140L,A01,083088,Eldon; John,23,0,100,77
1657749621103,CSE 175,A01,083665,Kumar; Rakesh,3,0,25,22
1657749627124,CSE 190,A00,092507,Dubnov; Shlomo,8,0,20,12
1657749633166,ECE 45,A01,083139,Congero; Spencer William,6,0,75,69
1657749639191,ECE 65,A50,083695,Saad; Andrew S,12,0,30,18
1657749639191,ECE 65,A51,095125,Saad; Andrew S,24,0,26,2
1657749645216,ECE 109,A01,091882,Touri; Behrouz,20,0,70,50
1657749651245,ECE 180,A00,083140,Abi Samra; Nicholas Camill,1,0,30,29
1657749651245,ECE 180,B00,083141,Abi Samra; Nicholas Camill,0,0,30,30
1657749657277,MATH 10A,A01,083735,Patchell; Gregory David,2,0,30,28
1657749657277,MATH 10A,A02,083736,Patchell; Gregory David,20,0,30,10
1657749657277,MATH 10A,A03,083737,Patchell; Gregory David,16,0,30,14
1657749663302,MATH 10B,A01,083207,Lim; Seonhee,8,0,34,26
1657749663302,MATH 10B,A02,083208,Lim; Seonhee,9,0,35,26
1657749663302,MATH 10B,A03,093472,Lim; Seonhee,7,0,34,27
1657749663302,MATH 10B,B01,083739,Sinha; Shubham,13,0,30,17
1657749669329,MATH 18,A01,083743,Cinel; Cameron Alexander,9,0,30,21
1657749669329,MATH 18,A02,083744,Cinel; Cameron Alexander,18,0,30,12
1657749669329,MATH 18,A03,083745,Cinel; Cameron Alexander,10,0,30,20
1657749669329,MATH 18,B01,083748,Rideout; David Porter,5,0,37,32
1657749669329,MATH 18,B02,083749,Rideout; David Porter,5,0,36,31
1657749669329,MATH 18,B03,083750,Rideout; David Porter,3,0,37,34
1657749669329,MATH 18,B04,083751,Rideout; David Porter,6,0,36,30
1657749669329,MATH 18,B05,093473,Rideout; David Porter,6,0,36,30
1657749669329,MATH 18,B06,093474,Rideout; David Porter,6,0,36,30
1657749675352,MATH 20A,A01,083754,Zheng; Zequn,14,0,40,26
1657749681380,MATH 20B,A01,083756,Briones; Jor-el Thomas Caparas,4,0,36,32
1657749681380,MATH 20B,A02,083757,Briones; Jor-el Thomas Caparas,1,0,36,35
1657749681380,MATH 20B,A03,093475,Briones; Jor-el Thomas Caparas,2,0,36,34
1657749687418,MATH 20C,A01,083760,Briones; Jor-el Thomas Caparas,1,0,35,34
1657749687418,MATH 20C,A02,083761,Briones; Jor-el Thomas Caparas,8,0,35,27
1657749687418,MATH 20C,A03,093476,Briones; Jor-el Thomas Caparas,0,1,36,36
1657749687418,MATH 20C,B01,083762,Bach; Quang Tran,1,0,30,29
1657749693535,MATH 20D,A01,083765,Tran; Brian Kha,5,0,30,25
1657749693535,MATH 20D,A02,083766,Tran; Brian Kha,5,0,30,25
1657749693535,MATH 20D,A03,083767,Tran; Brian Kha,5,0,30,25
1657749699564,MATH 20E,A01,083771,Ganguly; Soumya,9,0,32,23
1657749699564,MATH 20E,A02,083772,Ganguly; Soumya,6,0,32,26
1657749699564,MATH 20E,B01,083773,Ciotti; Benjamin,20,0,35,15
1657749699564,MATH 20E,B02,083774,Ciotti; Benjamin,18,0,35,17
1657749705588,MATH 103A,A01,083777,Greenfeld; Be'Eri,3,0,36,33
1657749705588,MATH 103A,A02,083778,Greenfeld; Be'Eri,5,0,36,31
1657749705588,MATH 103A,A03,093561,Greenfeld; Be'Eri,6,0,36,30
1657749705588,MATH 103A,B01,083779,Greenfeld; Be'Eri,7,0,36,29
1657749705588,MATH 103A,B02,083780,Greenfeld; Be'Eri,4,0,36,32
1657749705588,MATH 103A,B03,093562,Greenfeld; Be'Eri,3,0,36,33
1657749711622,MATH 105,A01,085443,Carter; Anne Toulson,15,0,35,20
1657749711622,MATH 105,A02,093477,Carter; Anne Toulson,20,0,35,15
1657749717649,MATH 109,A01,083213,Ganzberger; Geoffrey Michael,3,0,34,31
1657749717649,MATH 109,A02,083214,Ganzberger; Geoffrey Michael,4,0,34,30
1657749717649,MATH 109,A03,093478,Ganzberger; Geoffrey Michael,2,0,34,32
1657749717649,MATH 109,B01,083215,Ganzberger; Geoffrey Michael,1,0,32,31
1657749717649,MATH 109,B02,083216,Ganzberger; Geoffrey Michael,2,0,32,30
1657749717649,MATH 109,B03,093479,Ganzberger; Geoffrey Michael,8,0,32,24
1657749723671,MATH 142A,A01,083219,Chow; Bennett,7,0,32,25
1657749723671,MATH 142A,A02,083220,Chow; Bennett,10,0,32,22
1657749723671,MATH 142A,A03,093480,Chow; Bennett,9,0,32,23
1657749723671,MATH 142A,B03,093481,Chow; Bennett,8,0,32,24
1657749723671,MATH 142A,B04,093558,Chow; Bennett,13,0,32,19
1657749723671,MATH 142A,B05,093559,Chow; Bennett,6,0,32,26
1657749729704,MATH 193A,A01,083224,Rotar; Vladimir,8,0,34,26
1657749729704,MATH 193A,A02,083225,Rotar; Vladimir,9,0,34,25
1657749729704,MATH 193A,A03,083781,Rotar; Vladimir,5,0,34,29
1657749729704,MATH 193A,A04,083782,Rotar; Vladimir,10,0,34,24
1657749729704,MATH 193A,A05,093482,Rotar; Vladimir,10,0,34,24
1657749735727,MATH 197,001,091859,McAuley; Julian John,9999,0,9999,0
1657749735727,MATH 197,002,095566,Kedlaya; Kiran S.,9997,0,9999,2
1657749735727,MATH 197,003,095567,Xiao; Ming,9999,0,9999,0
1657749735727,MATH 197,004,095571,Perols; Johan Lars,9998,0,9999,1
1657749742784,COGS 9,A01,083615,Shannon; Kyle Michael,9,0,75,66
1657749748806,COGS 11,A01,083617,Boyle; Mary E. T.,23,0,48,25
1657749754828,COGS 13,A01,083071,Bastos; Amalia Pinkusfeld,11,0,71,60
1657749760852,COGS 14A,A01,092681,Semenuks; Arturs,5,1,100,95
1657749766874,COGS 14B,A01,083073,Cheng; Tzu-Han,6,0,63,57
1657749772900,COGS 17,A01,092677,Semenuks; Arturs,6,0,81,75
1657749778932,COGS 100,A01,083619,Allen; Michael Gordon,17,0,70,53
1657749784954,COGS 101A,A01,083621,Davis; Joshua Daniel,9,0,68,59
1657749790981,COGS 101B,A01,091572,Allen; Michael Gordon,12,0,65,53
1657749797007,COGS 101C,A01,083625,Delgado; Tania,17,0,35,18
1657749803030,COGS 107A,A01,083627,Boyle; Mary E. T.,13,0,60,47
1657749809053,COGS 118A,A01,083075,Gupta; Anjum,21,0,76,55
1657749815094,CSE 3,A50,083646,Miranda; Gregory Joseph,24,0,50,26
1657749821121,CSE 8A,A50,083650,Miranda; Gregory Joseph,17,1,56,39
1657749827147,CSE 11,A01,083080,Cao; Yingjun,6,15,40,34
1657749833169,CSE 12,A01,083652,Krause-Levy; Sophia Louisa,28,1,120,92
1657749839198,CSE 15L,A01,083654,Morris; Justin Loren,9,0,50,41
1657749839198,CSE 15L,A02,083655,Morris; Justin Loren,9,0,50,41
1657749845227,CSE 20,A01,083657,Tran; Khoa Dang,39,0,80,41
1657749851249,CSE 21,A01,095574,Bach; Quang Tran,22,0,48,26
1657749857274,CSE 30,A01,083084,Eldon; John,6,0,80,74
1657749857274,CSE 30,B01,095061,Bhaskar; Nishant,9,0,50,41
1657749863296,CSE 100,A01,083659,Cao; Yingjun,5,4,70,65
1657749869321,CSE 134B,A01,083661,Powell; Thomas Allan,24,0,100,76
1657749875345,CSE 140,A01,083663,Gungor; Onat,15,0,85,70
1657749881381,CSE 140L,A01,083088,Eldon; John,23,0,100,77
1657749887408,CSE 175,A01,083665,Kumar; Rakesh,3,0,25,22
1657749893430,CSE 190,A00,092507,Dubnov; Shlomo,8,0,20,12
1657749899455,ECE 45,A01,083139,Congero; Spencer William,6,0,75,69
1657749905486,ECE 65,A50,083695,Saad; Andrew S,12,0,30,18
1657749905486,ECE 65,A51,095125,Saad; Andrew S,24,0,26,2
1657749911509,ECE 109,A01,091882,Touri; Behrouz,20,0,70,50
1657749917533,ECE 180,A00,083140,Abi Samra; Nicholas Camill,1,0,30,29
1657749917533,ECE 180,B00,083141,Abi Samra; Nicholas Camill,0,0,30,30
1657749923556,MATH 10A,A01,083735,Patchell; Gregory David,2,0,30,28
1657749923556,MATH 10A,A02,083736,Patchell; Gregory David,20,0,30,10
1657749923556,MATH 10A,A03,083737,Patchell; Gregory David,16,0,30,14
1657749929580,MATH 10B,A01,083207,Lim; Seonhee,8,0,34,26
1657749929580,MATH 10B,A02,083208,Lim; Seonhee,9,0,35,26
1657749929580,MATH 10B,A03,093472,Lim; Seonhee,7,0,34,27
1657749929580,MATH 10B,B01,083739,Sinha; Shubham,13,0,30,17
1657749935610,MATH 18,A01,083743,Cinel; Cameron Alexander,9,0,30,21
1657749935610,MATH 18,A02,083744,Cinel; Cameron Alexander,18,0,30,12
1657749935610,MATH 18,A03,083745,Cinel; Cameron Alexander,10,0,30,20
1657749935610,MATH 18,B01,083748,Rideout; David Porter,5,0,37,32
1657749935610,MATH 18,B02,083749,Rideout; David Porter,5,0,36,31
1657749935610,MATH 18,B03,083750,Rideout; David Porter,3,0,37,34
1657749935610,MATH 18,B04,083751,Rideout; David Porter,6,0,36,30
1657749935610,MATH 18,B05,093473,Rideout; David Porter,6,0,36,30
1657749935610,MATH 18,B06,093474,Rideout; David Porter,6,0,36,30
1657749941636,MATH 20A,A01,083754,Zheng; Zequn,14,0,40,26
1657749947664,MATH 20B,A01,083756,Briones; Jor-el Thomas Caparas,4,0,36,32
1657749947664,MATH 20B,A02,083757,Briones; Jor-el Thomas Caparas,1,0,36,35
1657749947664,MATH 20B,A03,093475,Briones; Jor-el Thomas Caparas,2,0,36,34
1657749953691,MATH 20C,A01,083760,Briones; Jor-el Thomas Caparas,1,0,35,34
1657749953691,MATH 20C,A02,083761,Briones; Jor-el Thomas Caparas,8,0,35,27
1657749953691,MATH 20C,A03,093476,Briones; Jor-el Thomas Caparas,0,1,36,36
1657749953691,MATH 20C,B01,083762,Bach; Quang Tran,1,0,30,29
1657749959722,MATH 20D,A01,083765,Tran; Brian Kha,5,0,30,25
1657749959722,MATH 20D,A02,083766,Tran; Brian Kha,5,0,30,25
1657749959722,MATH 20D,A03,083767,Tran; Brian Kha,5,0,30,25
1657749965747,MATH 20E,A01,083771,Ganguly; Soumya,9,0,32,23
1657749965747,MATH 20E,A02,083772,Ganguly; Soumya,6,0,32,26
1657749965747,MATH 20E,B01,083773,Ciotti; Benjamin,20,0,35,15
1657749965747,MATH 20E,B02,083774,Ciotti; Benjamin,18,0,35,17
1657749971776,MATH 103A,A01,083777,Greenfeld; Be'Eri,3,0,36,33
1657749971776,MATH 103A,A02,083778,Greenfeld; Be'Eri,5,0,36,31
1657749971776,MATH 103A,A03,093561,Greenfeld; Be'Eri,6,0,36,30
1657749971776,MATH 103A,B01,083779,Greenfeld; Be'Eri,7,0,36,29
1657749971776,MATH 103A,B02,083780,Greenfeld; Be'Eri,4,0,36,32
1657749971776,MATH 103A,B03,093562,Greenfeld; Be'Eri,3,0,36,33
1657749977805,MATH 105,A01,085443,Carter; Anne Toulson,15,0,35,20
1657749977805,MATH 105,A02,093477,Carter; Anne Toulson,20,0,35,15
1657749983833,MATH 109,A01,083213,Ganzberger; Geoffrey Michael,3,0,34,31
1657749983833,MATH 109,A02,083214,Ganzberger; Geoffrey Michael,4,0,34,30
1657749983833,MATH 109,A03,093478,Ganzberger; Geoffrey Michael,2,0,34,32
1657749983833,MATH 109,B01,083215,Ganzberger; Geoffrey Michael,1,0,32,31
1657749983833,MATH 109,B02,083216,Ganzberger; Geoffrey Michael,2,0,32,30
1657749983833,MATH 109,B03,093479,Ganzberger; Geoffrey Michael,8,0,32,24
1657749989866,MATH 142A,A01,083219,Chow; Bennett,7,0,32,25
1657749989866,MATH 142A,A02,083220,Chow; Bennett,10,0,32,22
1657749989866,MATH 142A,A03,093480,Chow; Bennett,9,0,32,23
1657749989866,MATH 142A,B03,093481,Chow; Bennett,8,0,32,24
1657749989866,MATH 142A,B04,093558,Chow; Bennett,13,0,32,19
1657749989866,MATH 142A,B05,093559,Chow; Bennett,6,0,32,26
1657749995893,MATH 193A,A01,083224,Rotar; Vladimir,8,0,34,26
1657749995893,MATH 193A,A02,083225,Rotar; Vladimir,9,0,34,25
1657749995893,MATH 193A,A03,083781,Rotar; Vladimir,5,0,34,29
1657749995893,MATH 193A,A04,083782,Rotar; Vladimir,10,0,34,24
1657749995893,MATH 193A,A05,093482,Rotar; Vladimir,10,0,34,24
1657750001923,MATH 197,001,091859,McAuley; Julian John,9999,0,9999,0
1657750001923,MATH 197,002,095566,Kedlaya; Kiran S.,9997,0,9999,2
1657750001923,MATH 197,003,095567,Xiao; Ming,9999,0,9999,0
1657750001923,MATH 197,004,095571,Perols; Johan Lars,9998,0,9999,1
1657750008973,COGS 9,A01,083615,Shannon; Kyle Michael,9,0,75,66
1657750014998,COGS 11,A01,083617,Boyle; Mary E. T.,23,0,48,25
1657750021024,COGS 13,A01,083071,Bastos; Amalia Pinkusfeld,11,0,71,60
1657750027050,COGS 14A,A01,092681,Semenuks; Arturs,5,1,100,95
1657750033073,COGS 14B,A01,083073,Cheng; Tzu-Han,6,0,63,57
1657750039099,COGS 17,A01,092677,Semenuks; Arturs,6,0,81,75
1657750045121,COGS 100,A01,083619,Allen; Michael Gordon,17,0,70,53
1657750051144,COGS 101A,A01,083621,Davis; Joshua Daniel,9,0,68,59
1657750057173,COGS 101B,A01,091572,Allen; Michael Gordon,12,0,65,53
1657750063202,COGS 101C,A01,083625,Delgado; Tania,17,0,35,18
1657750069223,COGS 107A,A01,083627,Boyle; Mary E. T.,13,0,60,47
1657750075258,COGS 118A,A01,083075,Gupta; Anjum,21,0,76,55
1657750081281,CSE 3,A50,083646,Miranda; Gregory Joseph,24,0,50,26
1657750087315,CSE 8A,A50,083650,Miranda; Gregory Joseph,17,1,56,39
1657750093341,CSE 11,A01,083080,Cao; Yingjun,6,15,40,34
1657750099363,CSE 12,A01,083652,Krause-Levy; Sophia Louisa,28,1,120,92
1657750105385,CSE 15L,A01,083654,Morris; Justin Loren,9,0,50,41
1657750105385,CSE 15L,A02,083655,Morris; Justin Loren,9,0,50,41
1657750111416,CSE 20,A01,083657,Tran; Khoa Dang,39,0,80,41
1657750117445,CSE 21,A01,095574,Bach; Quang Tran,22,0,48,26
1657750123470,CSE 30,A01,083084,Eldon; John,6,0,80,74
1657750123470,CSE 30,B01,095061,Bhaskar; Nishant,9,0,50,41
1657750129495,CSE 100,A01,083659,Cao; Yingjun,5,4,70,65
1657750135517,CSE 134B,A01,083661,Powell; Thomas Allan,24,0,100,76
1657750141541,CSE 140,A01,083663,Gungor; Onat,15,0,85,70
1657750147566,CSE 140L,A01,083088,Eldon; John,23,0,100,77
1657750153591,CSE 175,A01,083665,Kumar; Rakesh,3,0,25,22
1657750159616,CSE 190,A00,092507,Dubnov; Shlomo,8,0,20,12
1657750165637,ECE 45,A01,083139,Congero; Spencer William,6,0,75,69
1657750171659,ECE 65,A50,083695,Saad; Andrew S,12,0,30,18
1657750171659,ECE 65,A51,095125,Saad; Andrew S,24,0,26,2
1657750177686,ECE 109,A01,091882,Touri; Behrouz,20,0,70,50
1657750183715,ECE 180,A00,083140,Abi Samra; Nicholas Camill,1,0,30,29
1657750183715,ECE 180,B00,083141,Abi Samra; Nicholas Camill,0,0,30,30
1657750189746,MATH 10A,A01,083735,Patchell; Gregory David,2,0,30,28
1657750189746,MATH 10A,A02,083736,Patchell; Gregory David,20,0,30,10
1657750189746,MATH 10A,A03,083737,Patchell; Gregory David,16,0,30,14
1657750195773,MATH 10B,A01,083207,Lim; Seonhee,8,0,34,26
1657750195773,MATH 10B,A02,083208,Lim; Seonhee,9,0,35,26
1657750195773,MATH 10B,A03,093472,Lim; Seonhee,7,0,34,27
1657750195773,MATH 10B,B01,083739,Sinha; Shubham,13,0,30,17
1657750201795,MATH 18,A01,083743,Cinel; Cameron Alexander,9,0,30,21
1657750201795,MATH 18,A02,083744,Cinel; Cameron Alexander,18,0,30,12
1657750201795,MATH 18,A03,083745,Cinel; Cameron Alexander,10,0,30,20
1657750201795,MATH 18,B01,083748,Rideout; David Porter,5,0,37,32
1657750201795,MATH 18,B02,083749,Rideout; David Porter,5,0,36,31
1657750201795,MATH 18,B03,083750,Rideout; David Porter,3,0,37,34
1657750201795,MATH 18,B04,083751,Rideout; David Porter,6,0,36,30
1657750201795,MATH 18,B05,093473,Rideout; David Porter,6,0,36,30
1657750201795,MATH 18,B06,093474,Rideout; David Porter,6,0,36,30
1657750207823,MATH 20A,A01,083754,Zheng; Zequn,14,0,40,26
1657750213854,MATH 20B,A01,083756,Briones; Jor-el Thomas Caparas,4,0,36,32
1657750213854,MATH 20B,A02,083757,Briones; Jor-el Thomas Caparas,1,0,36,35
1657750213854,MATH 20B,A03,093475,Briones; Jor-el Thomas Caparas,2,0,36,34
1657750219880,MATH 20C,A01,083760,Briones; Jor-el Thomas Caparas,1,0,35,34
1657750219880,MATH 20C,A02,083761,Briones; Jor-el Thomas Caparas,8,0,35,27
1657750219880,MATH 20C,A03,093476,Briones; Jor-el Thomas Caparas,0,1,36,36
1657750219880,MATH 20C,B01,083762,Bach; Quang Tran,1,0,30,29
1657750225908,MATH 20D,A01,083765,Tran; Brian Kha,5,0,30,25
1657750225908,MATH 20D,A02,083766,Tran; Brian Kha,5,0,30,25
1657750225908,MATH 20D,A03,083767,Tran; Brian Kha,5,0,30,25
1657750231936,MATH 20E,A01,083771,Ganguly; Soumya,9,0,32,23
1657750231936,MATH 20E,A02,083772,Ganguly; Soumya,6,0,32,26
1657750231936,MATH 20E,B01,083773,Ciotti; Benjamin,20,0,35,15
1657750231936,MATH 20E,B02,083774,Ciotti; Benjamin,18,0,35,17
1657750237959,MATH 103A,A01,083777,Greenfeld; Be'Eri,3,0,36,33
1657750237959,MATH 103A,A02,083778,Greenfeld; Be'Eri,5,0,36,31
1657750237959,MATH 103A,A03,093561,Greenfeld; Be'Eri,6,0,36,30
1657750237959,MATH 103A,B01,083779,Greenfeld; Be'Eri,7,0,36,29
1657750237959,MATH 103A,B02,083780,Greenfeld; Be'Eri,4,0,36,32
1657750237959,MATH 103A,B03,093562,Greenfeld; Be'Eri,3,0,36,33
1657750243988,MATH 105,A01,085443,Carter; Anne Toulson,15,0,35,20
1657750243988,MATH 105,A02,093477,Carter; Anne Toulson,20,0,35,15
1657750250016,MATH 109,A01,083213,Ganzberger; Geoffrey Michael,3,0,34,31
1657750250016,MATH 109,A02,083214,Ganzberger; Geoffrey Michael,4,0,34,30
1657750250016,MATH 109,A03,093478,Ganzberger; Geoffrey Michael,2,0,34,32
1657750250016,MATH 109,B01,083215,Ganzberger; Geoffrey Michael,1,0,32,31
1657750250016,MATH 109,B02,083216,Ganzberger; Geoffrey Michael,2,0,32,30
1657750250016,MATH 109,B03,093479,Ganzberger; Geoffrey Michael,8,0,32,24
1657750256046,MATH 142A,A01,083219,Chow; Bennett,7,0,32,25
1657750256046,MATH 142A,A02,083220,Chow; Bennett,10,0,32,22
1657750256046,MATH 142A,A03,093480,Chow; Bennett,9,0,32,23
1657750256046,MATH 142A,B03,093481,Chow; Bennett,8,0,32,24
1657750256046,MATH 142A,B04,093558,Chow; Bennett,13,0,32,19
1657750256046,MATH 142A,B05,093559,Chow; Bennett,6,0,32,26
1657750262077,MATH 193A,A01,083224,Rotar; Vladimir,8,0,34,26
1657750262077,MATH 193A,A02,083225,Rotar; Vladimir,9,0,34,25
1657750262077,MATH 193A,A03,083781,Rotar; Vladimir,5,0,34,29
1657750262077,MATH 193A,A04,083782,Rotar; Vladimir,10,0,34,24
1657750262077,MATH 193A,A05,093482,Rotar; Vladimir,10,0,34,24
1657750268105,MATH 197,001,091859,McAuley; Julian John,9999,0,9999,0
1657750268105,MATH 197,002,095566,Kedlaya; Kiran S.,9997,0,9999,2
1657750268105,MATH 197,003,095567,Xiao; Ming,9999,0,9999,0
1657750268105,MATH 197,004,095571,Perols; Johan Lars,9998,0,9999,1
1657750275160,COGS 9,A01,083615,Shannon; Kyle Michael,9,0,75,66
1657750281184,COGS 11,A01,083617,Boyle; Mary E. T.,23,0,48,25
1657750287281,COGS 13,A01,083071,Bastos; Amalia Pinkusfeld,11,0,71,60
1657750293306,COGS 14A,A01,092681,Semenuks; Arturs,5,1,100,95
1657750299334,COGS 14B,A01,083073,Cheng; Tzu-Han,6,0,63,57
1657750305358,COGS 17,A01,092677,Semenuks; Arturs,6,0,81,75
1657750311381,COGS 100,A01,083619,Allen; Michael Gordon,17,0,70,53
1657750317412,COGS 101A,A01,083621,Davis; Joshua Daniel,9,0,68,59
1657750323442,COGS 101B,A01,091572,Allen; Michael Gordon,12,0,65,53
1657750329465,COGS 101C,A01,083625,Delgado; Tania,17,0,35,18
1657750335491,COGS 107A,A01,083627,Boyle; Mary E. T.,13,0,60,47
1657750341517,COGS 118A,A01,083075,Gupta; Anjum,21,0,76,55
1657750347545,CSE 3,A50,083646,Miranda; Gregory Joseph,24,0,50,26
1657750353568,CSE 8A,A50,083650,Miranda; Gregory Joseph,17,1,56,39
1657750359589,CSE 11,A01,083080,Cao; Yingjun,6,15,40,34
1657750365626,CSE 12,A01,083652,Krause-Levy; Sophia Louisa,28,1,120,92
1657750371649,CSE 15L,A01,083654,Morris; Justin Loren,9,0,50,41
1657750371649,CSE 15L,A02,083655,Morris; Justin Loren,9,0,50,41
1657750377671,CSE 20,A01,083657,Tran; Khoa Dang,39,0,80,41
1657750383702,CSE 21,A01,095574,Bach; Quang Tran,22,0,48,26
1657750389732,CSE 30,A01,083084,Eldon; John,6,0,80,74
1657750389732,CSE 30,B01,095061,Bhaskar; Nishant,9,0,50,41
1657750395758,CSE 100,A01,083659,Cao; Yingjun,5,4,70,65
1657750401780,CSE 134B,A01,083661,Powell; Thomas Allan,24,0,100,76
1657750407809,CSE 140,A01,083663,Gungor; Onat,15,0,85,70
1657750413832,CSE 140L,A01,083088,Eldon; John,23,0,100,77
1657750419861,CSE 175,A01,083665,Kumar; Rakesh,3,0,25,22
1657750425888,CSE 190,A00,092507,Dubnov; Shlomo,8,0,20,12
1657750431913,ECE 45,A01,083139,Congero; Spencer William,6,0,75,69
1657750437937,ECE 65,A50,083695,Saad; Andrew S,12,0,30,18
1657750437937,ECE 65,A51,095125,Saad; Andrew S,24,0,26,2
1657750443968,ECE 109,A01,091882,Touri; Behrouz,20,0,70,50
1657750449992,ECE 180,A00,083140,Abi Samra; Nicholas Camill,1,0,30,29
1657750449992,ECE 180,B00,083141,Abi Samra; Nicholas Camill,0,0,30,30
1657750456019,MATH 10A,A01,083735,Patchell; Gregory David,2,0,30,28
1657750456019,MATH 10A,A02,083736,Patchell; Gregory David,20,0,30,10
1657750456019,MATH 10A,A03,083737,Patchell; Gregory David,16,0,30,14
1657750462047,MATH 10B,A01,083207,Lim; Seonhee,8,0,34,26
1657750462047,MATH 10B,A02,083208,Lim; Seonhee,9,0,35,26
1657750462047,MATH 10B,A03,093472,Lim; Seonhee,7,0,34,27
1657750462047,MATH 10B,B01,083739,Sinha; Shubham,13,0,30,17
1657750468076,MATH 18,A01,083743,Cinel; Cameron Alexander,9,0,30,21
1657750468076,MATH 18,A02,083744,Cinel; Cameron Alexander,18,0,30,12
1657750468076,MATH 18,A03,083745,Cinel; Cameron Alexander,10,0,30,20
1657750468076,MATH 18,B01,083748,Rideout; David Porter,5,0,37,32
1657750468076,MATH 18,B02,083749,Rideout; David Porter,5,0,36,31
1657750468076,MATH 18,B03,083750,Rideout; David Porter,3,0,37,34
1657750468076,MATH 18,B04,083751,Rideout; David Porter,6,0,36,30
1657750468076,MATH 18,B05,093473,Rideout; David Porter,6,0,36,30
1657750468076,MATH 18,B06,093474,Rideout; David Porter,6,0,36,30
1657750474102,MATH 20A,A01,083754,Zheng; Zequn,14,0,40,26
1657750480126,MATH 20B,A01,083756,Briones; Jor-el Thomas Caparas,4,0,36,32
1657750480126,MATH 20B,A02,083757,Briones; Jor-el Thomas Caparas,1,0,36,35
1657750480126,MATH 20B,A03,093475,Briones; Jor-el Thomas Caparas,2,0,36,34
1657750486151,MATH 20C,A01,083760,Briones; Jor-el Thomas Caparas,1,0,35,34
1657750486151,MATH 20C,A02,083761,Briones; Jor-el Thomas Caparas,8,0,35,27
1657750486151,MATH 20C,A03,093476,Briones; Jor-el Thomas Caparas,0,1,36,36
1657750486151,MATH 20C,B01,083762,Bach; Quang Tran,1,0,30,29
1657750492175,MATH 20D,A01,083765,Tran; Brian Kha,5,0,30,25
1657750492175,MATH 20D,A02,083766,Tran; Brian Kha,5,0,30,25
1657750492175,MATH 20D,A03,083767,Tran; Brian Kha,5,0,30,25
1657750498199,MATH 20E,A01,083771,Ganguly; Soumya,9,0,32,23
1657750498199,MATH 20E,A02,083772,Ganguly; Soumya,6,0,32,26
1657750498199,MATH 20E,B01,083773,Ciotti; Benjamin,20,0,35,15
1657750498199,MATH 20E,B02,083774,Ciotti; Benjamin,18,0,35,17
1657750504225,MATH 103A,A01,083777,Greenfeld; Be'Eri,3,0,36,33
1657750504225,MATH 103A,A02,083778,Greenfeld; Be'Eri,5,0,36,31
1657750504225,MATH 103A,A03,093561,Greenfeld; Be'Eri,6,0,36,30
1657750504225,MATH 103A,B01,083779,Greenfeld; Be'Eri,7,0,36,29
1657750504225,MATH 103A,B02,083780,Greenfeld; Be'Eri,4,0,36,32
1657750504225,MATH 103A,B03,093562,Greenfeld; Be'Eri,3,0,36,33
1657750510252,MATH 105,A01,085443,Carter; Anne Toulson,15,0,35,20
1657750510252,MATH 105,A02,093477,Carter; Anne Toulson,20,0,35,15
1657750516275,MATH 109,A01,083213,Ganzberger; Geoffrey Michael,3,0,34,31
1657750516275,MATH 109,A02,083214,Ganzberger; Geoffrey Michael,4,0,34,30
1657750516275,MATH 109,A03,093478,Ganzberger; Geoffrey Michael,2,0,34,32
1657750516275,MATH 109,B01,083215,Ganzberger; Geoffrey Michael,1,0,32,31
1657750516275,MATH 109,B02,083216,Ganzberger; Geoffrey Michael,2,0,32,30
1657750516275,MATH 109,B03,093479,Ganzberger; Geoffrey Michael,8,0,32,24
1657750522297,MATH 142A,A01,083219,Chow; Bennett,7,0,32,25
1657750522297,MATH 142A,A02,083220,Chow; Bennett,10,0,32,22
1657750522297,MATH 142A,A03,093480,Chow; Bennett,9,0,32,23
1657750522297,MATH 142A,B03,093481,Chow; Bennett,8,0,32,24
1657750522297,MATH 142A,B04,093558,Chow; Bennett,13,0,32,19
1657750522297,MATH 142A,B05,093559,Chow; Bennett,6,0,32,26
1657750528324,MATH 193A,A01,083224,Rotar; Vladimir,8,0,34,26
1657750528324,MATH 193A,A02,083225,Rotar; Vladimir,9,0,34,25
1657750528324,MATH 193A,A03,083781,Rotar; Vladimir,5,0,34,29
1657750528324,MATH 193A,A04,083782,Rotar; Vladimir,10,0,34,24
1657750528324,MATH 193A,A05,093482,Rotar; Vladimir,10,0,34,24
1657750534346,MATH 197,001,091859,McAuley; Julian John,9999,0,9999,0
1657750534346,MATH 197,002,095566,Kedlaya; Kiran S.,9997,0,9999,2
1657750534346,MATH 197,003,095567,Xiao; Ming,9999,0,9999,0
1657750534346,MATH 197,004,095571,Perols; Johan Lars,9998,0,9999,1
1657750541407,COGS 9,A01,083615,Shannon; Kyle Michael,9,0,75,66
1657750547434,COGS 11,A01,083617,Boyle; Mary E. T.,23,0,48,25
1657750553468,COGS 13,A01,083071,Bastos; Amalia Pinkusfeld,11,0,71,60
1657750559492,COGS 14A,A01,092681,Semenuks; Arturs,5,1,100,95
1657750565516,COGS 14B,A01,083073,Cheng; Tzu-Han,6,0,63,57
1657750571547,COGS 17,A01,092677,Semenuks; Arturs,6,0,81,75
1657750577570,COGS 100,A01,083619,Allen; Michael Gordon,17,0,70,53
1657750583595,COGS 101A,A01,083621,Davis; Joshua Daniel,9,0,68,59
1657750589623,COGS 101B,A01,091572,Allen; Michael Gordon,12,0,65,53
1657750595654,COGS 101C,A01,083625,Delgado; Tania,17,0,35,18
1657750601676,COGS 107A,A01,083627,Boyle; Mary E. T.,13,0,60,47
1657750607706,COGS 118A,A01,083075,Gupta; Anjum,21,0,76,55
1657750613730,CSE 3,A50,083646,Miranda; Gregory Joseph,24,0,50,26
1657750619757,CSE 8A,A50,083650,Miranda; Gregory Joseph,17,1,56,39
1657750625787,CSE 11,A01,083080,Cao; Yingjun,6,15,40,34
1657750631809,CSE 12,A01,083652,Krause-Levy; Sophia Louisa,28,1,120,92
1657750637832,CSE 15L,A01,083654,Morris; Justin Loren,9,0,50,41
1657750637832,CSE 15L,A02,083655,Morris; Justin Loren,9,0,50,41
1657750643855,CSE 20,A01,083657,Tran; Khoa Dang,39,0,80,41
1657750649882,CSE 21,A01,095574,Bach; Quang Tran,22,0,48,26
1657750655906,CSE 30,A01,083084,Eldon; John,6,0,80,74
1657750655906,CSE 30,B01,095061,Bhaskar; Nishant,9,0,50,41
1657750661929,CSE 100,A01,083659,Cao; Yingjun,5,4,70,65
1657750667955,CSE 134B,A01,083661,Powell; Thomas Allan,24,0,100,76
1657750673985,CSE 140,A01,083663,Gungor; Onat,15,0,85,70
1657750680011,CSE 140L,A01,083088,Eldon; John,23,0,100,77
1657750686039,CSE 175,A01,083665,Kumar; Rakesh,3,0,25,22
1657750692060,CSE 190,A00,092507,Dubnov; Shlomo,8,0,20,12
1657750698086,ECE 45,A01,083139,Congero; Spencer William,6,0,75,69
1657750704109,ECE 65,A50,083695,Saad; Andrew S,12,0,30,18
1657750704109,ECE 65,A51,095125,Saad; Andrew S,24,0,26,2
1657750710131,ECE 109,A01,091882,Touri; Behrouz,20,0,70,50
1657750716154,ECE 180,A00,083140,Abi Samra; Nicholas Camill,1,0,30,29
1657750716154,ECE 180,B00,083141,Abi Samra; Nicholas Camill,0,0,30,30
1657750722181,MATH 10A,A01,083735,Patchell; Gregory David,2,0,30,28
1657750722181,MATH 10A,A02,083736,Patchell; Gregory David,20,0,30,10
1657750722181,MATH 10A,A03,083737,Patchell; Gregory David,16,0,30,14
1657750728204,MATH 10B,A01,083207,Lim; Seonhee,8,0,34,26
1657750728204,MATH 10B,A02,083208,Lim; Seonhee,9,0,35,26
1657750728204,MATH 10B,A03,093472,Lim; Seonhee,7,0,34,27
1657750728204,MATH 10B,B01,083739,Sinha; Shubham,13,0,30,17
1657750734237,MATH 18,A01,083743,Cinel; Cameron Alexander,9,0,30,21
1657750734237,MATH 18,A02,083744,Cinel; Cameron Alexander,18,0,30,12
1657750734237,MATH 18,A03,083745,Cinel; Cameron Alexander,10,0,30,20
1657750734237,MATH 18,B01,083748,Rideout; David Porter,5,0,37,32
1657750734237,MATH 18,B02,083749,Rideout; David Porter,5,0,36,31
1657750734237,MATH 18,B03,083750,Rideout; David Porter,3,0,37,34
1657750734237,MATH 18,B04,083751,Rideout; David Porter,6,0,36,30
1657750734237,MATH 18,B05,093473,Rideout; David Porter,6,0,36,30
1657750734237,MATH 18,B06,093474,Rideout; David Porter,6,0,36,30
1657750740264,MATH 20A,A01,083754,Zheng; Zequn,14,0,40,26
1657750746292,MATH 20B,A01,083756,Briones; Jor-el Thomas Caparas,4,0,36,32
1657750746292,MATH 20B,A02,083757,Briones; Jor-el Thomas Caparas,1,0,36,35
1657750746292,MATH 20B,A03,093475,Briones; Jor-el Thomas Caparas,2,0,36,34
1657750752315,MATH 20C,A01,083760,Briones; Jor-el Thomas Caparas,1,0,35,34
1657750752315,MATH 20C,A02,083761,Briones; Jor-el Thomas Caparas,8,0,35,27
1657750752315,MATH 20C,A03,093476,Briones; Jor-el Thomas Caparas,0,1,36,36
1657750752315,MATH 20C,B01,083762,Bach; Quang Tran,1,0,30,29
1657750758353,MATH 20D,A01,083765,Tran; Brian Kha,5,0,30,25
1657750758353,MATH 20D,A02,083766,Tran; Brian Kha,5,0,30,25
1657750758353,MATH 20D,A03,083767,Tran; Brian Kha,5,0,30,25
1657750764381,MATH 20E,A01,083771,Ganguly; Soumya,9,0,32,23
1657750764381,MATH 20E,A02,083772,Ganguly; Soumya,6,0,32,26
1657750764381,MATH 20E,B01,083773,Ciotti; Benjamin,20,0,35,15
1657750764381,MATH 20E,B02,083774,Ciotti; Benjamin,18,0,35,17
1657750770409,MATH 103A,A01,083777,Greenfeld; Be'Eri,3,0,36,33
1657750770409,MATH 103A,A02,083778,Greenfeld; Be'Eri,5,0,36,31
1657750770409,MATH 103A,A03,093561,Greenfeld; Be'Eri,6,0,36,30
1657750770409,MATH 103A,B01,083779,Greenfeld; Be'Eri,7,0,36,29
1657750770409,MATH 103A,B02,083780,Greenfeld; Be'Eri,4,0,36,32
1657750770409,MATH 103A,B03,093562,Greenfeld; Be'Eri,3,0,36,33
1657750776436,MATH 105,A01,085443,Carter; Anne Toulson,15,0,35,20
1657750776436,MATH 105,A02,093477,Carter; Anne Toulson,20,0,35,15
1657750782463,MATH 109,A01,083213,Ganzberger; Geoffrey Michael,3,0,34,31
1657750782463,MATH 109,A02,083214,Ganzberger; Geoffrey Michael,4,0,34,30
1657750782463,MATH 109,A03,093478,Ganzberger; Geoffrey Michael,2,0,34,32
1657750782463,MATH 109,B01,083215,Ganzberger; Geoffrey Michael,1,0,32,31
1657750782463,MATH 109,B02,083216,Ganzberger; Geoffrey Michael,2,0,32,30
1657750782463,MATH 109,B03,093479,Ganzberger; Geoffrey Michael,8,0,32,24
1657750788492,MATH 142A,A01,083219,Chow; Bennett,7,0,32,25
1657750788492,MATH 142A,A02,083220,Chow; Bennett,10,0,32,22
1657750788492,MATH 142A,A03,093480,Chow; Bennett,9,0,32,23
1657750788492,MATH 142A,B03,093481,Chow; Bennett,8,0,32,24
1657750788492,MATH 142A,B04,093558,Chow; Bennett,13,0,32,19
1657750788492,MATH 142A,B05,093559,Chow; Bennett,6,0,32,26
1657750794516,MATH 193A,A01,083224,Rotar; Vladimir,8,0,34,26
1657750794516,MATH 193A,A02,083225,Rotar; Vladimir,9,0,34,25
1657750794516,MATH 193A,A03,083781,Rotar; Vladimir,5,0,34,29
1657750794516,MATH 193A,A04,083782,Rotar; Vladimir,10,0,34,24
1657750794516,MATH 193A,A05,093482,Rotar; Vladimir,10,0,34,24
1657750800542,MATH 197,001,091859,McAuley; Julian John,9999,0,9999,0
1657750800542,MATH 197,002,095566,Kedlaya; Kiran S.,9997,0,9999,2
1657750800542,MATH 197,003,095567,Xiao; Ming,9999,0,9999,0
1657750800542,MATH 197,004,095571,Perols; Johan Lars,9998,0,9999,1
1657750807608,COGS 9,A01,083615,Shannon; Kyle Michael,9,0,75,66
1657750813630,COGS 11,A01,083617,Boyle; Mary E. T.,23,0,48,25
1657750819654,COGS 13,A01,083071,Bastos; Amalia Pinkusfeld,11,0,71,60
1657750825678,COGS 14A,A01,092681,Semenuks; Arturs,5,1,100,95
1657750831704,COGS 14B,A01,083073,Cheng; Tzu-Han,6,0,63,57
1657750837738,COGS 17,A01,092677,Semenuks; Arturs,6,0,81,75
1657750843759,COGS 100,A01,083619,Allen; Michael Gordon,17,0,70,53
1657750849802,COGS 101A,A01,083621,Davis; Joshua Daniel,9,0,68,59
1657750855837,COGS 101B,A01,091572,Allen; Michael Gordon,12,0,65,53
1657750861860,COGS 101C,A01,083625,Delgado; Tania,17,0,35,18
1657750867889,COGS 107A,A01,083627,Boyle; Mary E. T.,13,0,60,47
1657750873916,COGS 118A,A01,083075,Gupta; Anjum,21,0,76,55
1657750879946,CSE 3,A50,083646,Miranda; Gregory Joseph,24,0,50,26
1657750886045,CSE 8A,A50,083650,Miranda; Gregory Joseph,17,1,56,39
1657750892073,CSE 11,A01,083080,Cao; Yingjun,6,15,40,34
1657750898100,CSE 12,A01,083652,Krause-Levy; Sophia Louisa,28,1,120,92
1657750904124,CSE 15L,A01,083654,Morris; Justin Loren,9,0,50,41
1657750904124,CSE 15L,A02,083655,Morris; Justin Loren,9,0,50,41
1657750910149,CSE 20,A01,083657,Tran; Khoa Dang,39,0,80,41
1657750916182,CSE 21,A01,095574,Bach; Quang Tran,22,0,48,26
1657750922208,CSE 30,A01,083084,Eldon; John,6,0,80,74
1657750922208,CSE 30,B01,095061,Bhaskar; Nishant,9,0,50,41
1657750928231,CSE 100,A01,083659,Cao; Yingjun,5,4,70,65
1657750934253,CSE 134B,A01,083661,Powell; Thomas Allan,24,0,100,76
1657750940279,CSE 140,A01,083663,Gungor; Onat,15,0,85,70
1657750946302,CSE 140L,A01,083088,Eldon; John,23,0,100,77
1657750952331,CSE 175,A01,083665,Kumar; Rakesh,3,0,25,22
1657750958355,CSE 190,A00,092507,Dubnov; Shlomo,8,0,20,12
1657750964378,ECE 45,A01,083139,Congero; Spencer William,6,0,75,69
1657750970407,ECE 65,A50,083695,Saad; Andrew S,12,0,30,18
1657750970407,ECE 65,A51,095125,Saad; Andrew S,24,0,26,2
1657750976439,ECE 109,A01,091882,Touri; Behrouz,20,0,70,50
1657750982462,ECE 180,A00,083140,Abi Samra; Nicholas Camill,1,0,30,29
1657750982462,ECE 180,B00,083141,Abi Samra; Nicholas Camill,0,0,30,30
1657750988493,MATH 10A,A01,083735,Patchell; Gregory David,2,0,30,28
1657750988493,MATH 10A,A02,083736,Patchell; Gregory David,20,0,30,10
1657750988493,MATH 10A,A03,083737,Patchell; Gregory David,16,0,30,14
1657750994519,MATH 10B,A01,083207,Lim; Seonhee,8,0,34,26
1657750994519,MATH 10B,A02,083208,Lim; Seonhee,9,0,35,26
1657750994519,MATH 10B,A03,093472,Lim; Seonhee,7,0,34,27
1657750994519,MATH 10B,B01,083739,Sinha; Shubham,13,0,30,17
1657751000550,MATH 18,A01,083743,Cinel; Cameron Alexander,9,0,30,21
1657751000550,MATH 18,A02,083744,Cinel; Cameron Alexander,18,0,30,12
1657751000550,MATH 18,A03,083745,Cinel; Cameron Alexander,10,0,30,20
1657751000550,MATH 18,B01,083748,Rideout; David Porter,5,0,37,32
1657751000550,MATH 18,B02,083749,Rideout; David Porter,5,0,36,31
1657751000550,MATH 18,B03,083750,Rideout; David Porter,3,0,37,34
1657751000550,MATH 18,B04,083751,Rideout; David Porter,6,0,36,30
1657751000550,MATH 18,B05,093473,Rideout; David Porter,6,0,36,30
1657751000550,MATH 18,B06,093474,Rideout; David Porter,6,0,36,30
1657751006576,MATH 20A,A01,083754,Zheng; Zequn,14,0,40,26
1657751012599,MATH 20B,A01,083756,Briones; Jor-el Thomas Caparas,4,0,36,32
1657751012599,MATH 20B,A02,083757,Briones; Jor-el Thomas Caparas,1,0,36,35
1657751012599,MATH 20B,A03,093475,Briones; Jor-el Thomas Caparas,2,0,36,34
1657751018622,MATH 20C,A01,083760,Briones; Jor-el Thomas Caparas,1,0,35,34
1657751018622,MATH 20C,A02,083761,Briones; Jor-el Thomas Caparas,8,0,35,27
1657751018622,MATH 20C,A03,093476,Briones; Jor-el Thomas Caparas,0,1,36,36
1657751018622,MATH 20C,B01,083762,Bach; Quang Tran,1,0,30,29
1657751024658,MATH 20D,A01,083765,Tran; Brian Kha,5,0,30,25
1657751024658,MATH 20D,A02,083766,Tran; Brian Kha,5,0,30,25
1657751024658,MATH 20D,A03,083767,Tran; Brian Kha,5,0,30,25
1657751030688,MATH 20E,A01,083771,Ganguly; Soumya,9,0,32,23
1657751030688,MATH 20E,A02,083772,Ganguly; Soumya,6,0,32,26
1657751030688,MATH 20E,B01,083773,Ciotti; Benjamin,20,0,35,15
1657751030688,MATH 20E,B02,083774,Ciotti; Benjamin,18,0,35,17
1657751036716,MATH 103A,A01,083777,Greenfeld; Be'Eri,3,0,36,33
1657751036716,MATH 103A,A02,083778,Greenfeld; Be'Eri,5,0,36,31
1657751036716,MATH 103A,A03,093561,Greenfeld; Be'Eri,6,0,36,30
1657751036716,MATH 103A,B01,083779,Greenfeld; Be'Eri,7,0,36,29
1657751036716,MATH 103A,B02,083780,Greenfeld; Be'Eri,4,0,36,32
1657751036716,MATH 103A,B03,093562,Greenfeld; Be'Eri,3,0,36,33
1657751042746,MATH 105,A01,085443,Carter; Anne Toulson,15,0,35,20
1657751042746,MATH 105,A02,093477,Carter; Anne Toulson,20,0,35,15
1657751048777,MATH 109,A01,083213,Ganzberger; Geoffrey Michael,3,0,34,31
1657751048777,MATH 109,A02,083214,Ganzberger; Geoffrey Michael,4,0,34,30
1657751048777,MATH 109,A03,093478,Ganzberger; Geoffrey Michael,2,0,34,32
1657751048777,MATH 109,B01,083215,Ganzberger; Geoffrey Michael,1,0,32,31
1657751048777,MATH 109,B02,083216,Ganzberger; Geoffrey Michael,2,0,32,30
1657751048777,MATH 109,B03,093479,Ganzberger; Geoffrey Michael,8,0,32,24
1657751054810,MATH 142A,A01,083219,Chow; Bennett,7,0,32,25
1657751054810,MATH 142A,A02,083220,Chow; Bennett,10,0,32,22
1657751054810,MATH 142A,A03,093480,Chow; Bennett,9,0,32,23
1657751054810,MATH 142A,B03,093481,Chow; Bennett,8,0,32,24
1657751054810,MATH 142A,B04,093558,Chow; Bennett,13,0,32,19
1657751054810,MATH 142A,B05,093559,Chow; Bennett,6,0,32,26
1657751060837,MATH 193A,A01,083224,Rotar; Vladimir,8,0,34,26
1657751060837,MATH 193A,A02,083225,Rotar; Vladimir,9,0,34,25
1657751060837,MATH 193A,A03,083781,Rotar; Vladimir,5,0,34,29
1657751060837,MATH 193A,A04,083782,Rotar; Vladimir,10,0,34,24
1657751060837,MATH 193A,A05,093482,Rotar; Vladimir,10,0,34,24
1657751066860,MATH 197,001,091859,McAuley; Julian John,9999,0,9999,0
1657751066860,MATH 197,002,095566,Kedlaya; Kiran S.,9997,0,9999,2
1657751066860,MATH 197,003,095567,Xiao; Ming,9999,0,9999,0
1657751066860,MATH 197,004,095571,Perols; Johan Lars,9998,0,9999,1
1657751073920,COGS 9,A01,083615,Shannon; Kyle Michael,9,0,75,66
1657751079944,COGS 11,A01,083617,Boyle; Mary E. T.,23,0,48,25
1657751085975,COGS 13,A01,083071,Bastos; Amalia Pinkusfeld,11,0,71,60
1657751091999,COGS 14A,A01,092681,Semenuks; Arturs,5,1,100,95
1657751098028,COGS 14B,A01,083073,Cheng; Tzu-Han,6,0,63,57
1657751104063,COGS 17,A01,092677,Semenuks; Arturs,6,0,81,75
1657751110087,COGS 100,A01,083619,Allen; Michael Gordon,17,0,70,53
1657751116110,COGS 101A,A01,083621,Davis; Joshua Daniel,9,0,68,59
1657751122134,COGS 101B,A01,091572,Allen; Michael Gordon,12,0,65,53
1657751128160,COGS 101C,A01,083625,Delgado; Tania,17,0,35,18
1657751134183,COGS 107A,A01,083627,Boyle; Mary E. T.,13,0,60,47
1657751140206,COGS 118A,A01,083075,Gupta; Anjum,21,0,76,55
1657751146229,CSE 3,A50,083646,Miranda; Gregory Joseph,24,0,50,26
1657751152253,CSE 8A,A50,083650,Miranda; Gregory Joseph,17,1,56,39
1657751158278,CSE 11,A01,083080,Cao; Yingjun,6,15,40,34
1657751164305,CSE 12,A01,083652,Krause-Levy; Sophia Louisa,28,1,120,92
1657751170328,CSE 15L,A01,083654,Morris; Justin Loren,9,0,50,41
1657751170328,CSE 15L,A02,083655,Morris; Justin Loren,9,0,50,41
1657751176354,CSE 20,A01,083657,Tran; Khoa Dang,39,0,80,41
1657751182377,CSE 21,A01,095574,Bach; Quang Tran,22,0,48,26
1657751188403,CSE 30,A01,083084,Eldon; John,6,0,80,74
1657751188403,CSE 30,B01,095061,Bhaskar; Nishant,9,0,50,41
1657751194428,CSE 100,A01,083659,Cao; Yingjun,5,4,70,65
1657751200451,CSE 134B,A01,083661,Powell; Thomas Allan,24,0,100,76
1657751206477,CSE 140,A01,083663,Gungor; Onat,15,0,85,70
1657751212502,CSE 140L,A01,083088,Eldon; John,23,0,100,77
1657751218534,CSE 175,A01,083665,Kumar; Rakesh,3,0,25,22
1657751224564,CSE 190,A00,092507,Dubnov; Shlomo,8,0,20,12
1657751230588,ECE 45,A01,083139,Congero; Spencer William,6,0,75,69
1657751236611,ECE 65,A50,083695,Saad; Andrew S,12,0,30,18
1657751236611,ECE 65,A51,095125,Saad; Andrew S,24,0,26,2
1657751242642,ECE 109,A01,091882,Touri; Behrouz,20,0,70,50
1657751248665,ECE 180,A00,083140,Abi Samra; Nicholas Camill,1,0,30,29
1657751248665,ECE 180,B00,083141,Abi Samra; Nicholas Camill,0,0,30,30
1657751254687,MATH 10A,A01,083735,Patchell; Gregory David,2,0,30,28
1657751254687,MATH 10A,A02,083736,Patchell; Gregory David,20,0,30,10
1657751254687,MATH 10A,A03,083737,Patchell; Gregory David,16,0,30,14
1657751260717,MATH 10B,A01,083207,Lim; Seonhee,8,0,34,26
1657751260717,MATH 10B,A02,083208,Lim; Seonhee,9,0,35,26
1657751260717,MATH 10B,A03,093472,Lim; Seonhee,7,0,34,27
1657751260717,MATH 10B,B01,083739,Sinha; Shubham,13,0,30,17
1657751266751,MATH 18,A01,083743,Cinel; Cameron Alexander,9,0,30,21
1657751266751,MATH 18,A02,083744,Cinel; Cameron Alexander,18,0,30,12
1657751266751,MATH 18,A03,083745,Cinel; Cameron Alexander,10,0,30,20
1657751266751,MATH 18,B01,083748,Rideout; David Porter,5,0,37,32
1657751266751,MATH 18,B02,083749,Rideout; David Porter,5,0,36,31
1657751266751,MATH 18,B03,083750,Rideout; David Porter,3,0,37,34
1657751266751,MATH 18,B04,083751,Rideout; David Porter,6,0,36,30
1657751266751,MATH 18,B05,093473,Rideout; David Porter,6,0,36,30
1657751266751,MATH 18,B06,093474,Rideout; David Porter,6,0,36,30
1657751272773,MATH 20A,A01,083754,Zheng; Zequn,14,0,40,26
1657751278796,MATH 20B,A01,083756,Briones; Jor-el Thomas Caparas,4,0,36,32
1657751278796,MATH 20B,A02,083757,Briones; Jor-el Thomas Caparas,1,0,36,35
1657751278796,MATH 20B,A03,093475,Briones; Jor-el Thomas Caparas,2,0,36,34
1657751284839,MATH 20C,A01,083760,Briones; Jor-el Thomas Caparas,1,0,35,34
1657751284839,MATH 20C,A02,083761,Briones; Jor-el Thomas Caparas,8,0,35,27
1657751284839,MATH 20C,A03,093476,Briones; Jor-el Thomas Caparas,0,1,36,36
1657751284839,MATH 20C,B01,083762,Bach; Quang Tran,1,0,30,29
1657751290861,MATH 20D,A01,083765,Tran; Brian Kha,5,0,30,25
1657751290861,MATH 20D,A02,083766,Tran; Brian Kha,5,0,30,25
1657751290861,MATH 20D,A03,083767,Tran; Brian Kha,5,0,30,25
1657751296890,MATH 20E,A01,083771,Ganguly; Soumya,9,0,32,23
1657751296890,MATH 20E,A02,083772,Ganguly; Soumya,6,0,32,26
1657751296890,MATH 20E,B01,083773,Ciotti; Benjamin,20,0,35,15
1657751296890,MATH 20E,B02,083774,Ciotti; Benjamin,18,0,35,17
1657751302918,MATH 103A,A01,083777,Greenfeld; Be'Eri,3,0,36,33
1657751302918,MATH 103A,A02,083778,Greenfeld; Be'Eri,5,0,36,31
1657751302918,MATH 103A,A03,093561,Greenfeld; Be'Eri,6,0,36,30
1657751302918,MATH 103A,B01,083779,Greenfeld; Be'Eri,7,0,36,29
1657751302918,MATH 103A,B02,083780,Greenfeld; Be'Eri,4,0,36,32
1657751302918,MATH 103A,B03,093562,Greenfeld; Be'Eri,3,0,36,33
1657751308953,MATH 105,A01,085443,Carter; Anne Toulson,15,0,35,20
1657751308953,MATH 105,A02,093477,Carter; Anne Toulson,20,0,35,15
1657751314979,MATH 109,A01,083213,Ganzberger; Geoffrey Michael,3,0,34,31
1657751314979,MATH 109,A02,083214,Ganzberger; Geoffrey Michael,4,0,34,30
1657751314979,MATH 109,A03,093478,Ganzberger; Geoffrey Michael,2,0,34,32
1657751314979,MATH 109,B01,083215,Ganzberger; Geoffrey Michael,1,0,32,31
1657751314979,MATH 109,B02,083216,Ganzberger; Geoffrey Michael,2,0,32,30
1657751314979,MATH 109,B03,093479,Ganzberger; Geoffrey Michael,8,0,32,24
1657751321008,MATH 142A,A01,083219,Chow; Bennett,7,0,32,25
1657751321008,MATH 142A,A02,083220,Chow; Bennett,10,0,32,22
1657751321008,MATH 142A,A03,093480,Chow; Bennett,9,0,32,23
1657751321008,MATH 142A,B03,093481,Chow; Bennett,8,0,32,24
1657751321008,MATH 142A,B04,093558,Chow; Bennett,13,0,32,19
1657751321008,MATH 142A,B05,093559,Chow; Bennett,6,0,32,26
1657751327031,MATH 193A,A01,083224,Rotar; Vladimir,8,0,34,26
1657751327031,MATH 193A,A02,083225,Rotar; Vladimir,9,0,34,25
1657751327031,MATH 193A,A03,083781,Rotar; Vladimir,5,0,34,29
1657751327031,MATH 193A,A04,083782,Rotar; Vladimir,10,0,34,24
1657751327031,MATH 193A,A05,093482,Rotar; Vladimir,10,0,34,24
1657751333056,MATH 197,001,091859,McAuley; Julian John,9999,0,9999,0
1657751333056,MATH 197,002,095566,Kedlaya; Kiran S.,9997,0,9999,2
1657751333056,MATH 197,003,095567,Xiao; Ming,9999,0,9999,0
1657751333056,MATH 197,004,095571,Perols; Johan Lars,9998,0,9999,1
1657751340115,COGS 9,A01,083615,Shannon; Kyle Michael,9,0,75,66
1657751346140,COGS 11,A01,083617,Boyle; Mary E. T.,23,0,48,25
1657751352169,COGS 13,A01,083071,Bastos; Amalia Pinkusfeld,11,0,71,60
1657751358191,COGS 14A,A01,092681,Semenuks; Arturs,5,1,100,95
1657751364219,COGS 14B,A01,083073,Cheng; Tzu-Han,6,0,63,57
1657751370241,COGS 17,A01,092677,Semenuks; Arturs,6,0,81,75
1657751376264,COGS 100,A01,083619,Allen; Michael Gordon,17,0,70,53
1657751382288,COGS 101A,A01,083621,Davis; Joshua Daniel,9,0,68,59
1657751388310,COGS 101B,A01,091572,Allen; Michael Gordon,12,0,65,53
1657751394332,COGS 101C,A01,083625,Delgado; Tania,17,0,35,18
1657751400371,COGS 107A,A01,083627,Boyle; Mary E. T.,13,0,60,47
1657751406400,COGS 118A,A01,083075,Gupta; Anjum,21,0,76,55
1657751412428,CSE 3,A50,083646,Miranda; Gregory Joseph,24,0,50,26
1657751418454,CSE 8A,A50,083650,Miranda; Gregory Joseph,17,1,56,39
1657751424478,CSE 11,A01,083080,Cao; Yingjun,6,15,40,34
1657751430505,CSE 12,A01,083652,Krause-Levy; Sophia Louisa,28,1,120,92
1657751436540,CSE 15L,A01,083654,Morris; Justin Loren,9,0,50,41
1657751436540,CSE 15L,A02,083655,Morris; Justin Loren,9,0,50,41
1657751442562,CSE 20,A01,083657,Tran; Khoa Dang,39,0,80,41
1657751448585,CSE 21,A01,095574,Bach; Quang Tran,22,0,48,26
1657751454607,CSE 30,A01,083084,Eldon; John,6,0,80,74
1657751454607,CSE 30,B01,095061,Bhaskar; Nishant,9,0,50,41
1657751460635,CSE 100,A01,083659,Cao; Yingjun,5,4,70,65
1657751466672,CSE 134B,A01,083661,Powell; Thomas Allan,24,0,100,76
1657751472699,CSE 140,A01,083663,Gungor; Onat,15,0,85,70
1657751478722,CSE 140L,A01,083088,Eldon; John,23,0,100,77
1657751484832,CSE 175,A01,083665,Kumar; Rakesh,3,0,25,22
1657751490854,CSE 190,A00,092507,Dubnov; Shlomo,8,0,20,12
1657751496877,ECE 45,A01,083139,Congero; Spencer William,6,0,75,69
1657751502903,ECE 65,A50,083695,Saad; Andrew S,12,0,30,18
1657751502903,ECE 65,A51,095125,Saad; Andrew S,24,0,26,2
1657751508929,ECE 109,A01,091882,Touri; Behrouz,20,0,70,50
1657751514952,ECE 180,A00,083140,Abi Samra; Nicholas Camill,1,0,30,29
1657751514952,ECE 180,B00,083141,Abi Samra; Nicholas Camill,0,0,30,30
1657751520978,MATH 10A,A01,083735,Patchell; Gregory David,2,0,30,28
1657751520978,MATH 10A,A02,083736,Patchell; Gregory David,20,0,30,10
1657751520978,MATH 10A,A03,083737,Patchell; Gregory David,16,0,30,14
1657751527009,MATH 10B,A01,083207,Lim; Seonhee,8,0,34,26
1657751527009,MATH 10B,A02,083208,Lim; Seonhee,9,0,35,26
1657751527009,MATH 10B,A03,093472,Lim; Seonhee,7,0,34,27
1657751527009,MATH 10B,B01,083739,Sinha; Shubham,13,0,30,17
1657751533034,MATH 18,A01,083743,Cinel; Cameron Alexander,9,0,30,21
1657751533034,MATH 18,A02,083744,Cinel; Cameron Alexander,18,0,30,12
1657751533034,MATH 18,A03,083745,Cinel; Cameron Alexander,10,0,30,20
1657751533034,MATH 18,B01,083748,Rideout; David Porter,5,0,37,32
1657751533034,MATH 18,B02,083749,Rideout; David Porter,5,0,36,31
1657751533034,MATH 18,B03,083750,Rideout; David Porter,3,0,37,34
1657751533034,MATH 18,B04,083751,Rideout; David Porter,6,0,36,30
1657751533034,MATH 18,B05,093473,Rideout; David Porter,6,0,36,30
1657751533034,MATH 18,B06,093474,Rideout; David Porter,6,0,36,30
1657751539062,MATH 20A,A01,083754,Zheng; Zequn,14,0,40,26
1657751545087,MATH 20B,A01,083756,Briones; Jor-el Thomas Caparas,4,0,36,32
1657751545087,MATH 20B,A02,083757,Briones; Jor-el Thomas Caparas,1,0,36,35
1657751545087,MATH 20B,A03,093475,Briones; Jor-el Thomas Caparas,2,0,36,34
1657751551109,MATH 20C,A01,083760,Briones; Jor-el Thomas Caparas,1,0,35,34
1657751551109,MATH 20C,A02,083761,Briones; Jor-el Thomas Caparas,8,0,35,27
1657751551109,MATH 20C,A03,093476,Briones; Jor-el Thomas Caparas,0,1,36,36
1657751551109,MATH 20C,B01,083762,Bach; Quang Tran,1,0,30,29
1657751557133,MATH 20D,A01,083765,Tran; Brian Kha,5,0,30,25
1657751557133,MATH 20D,A02,083766,Tran; Brian Kha,5,0,30,25
1657751557133,MATH 20D,A03,083767,Tran; Brian Kha,5,0,30,25
1657751563157,MATH 20E,A01,083771,Ganguly; Soumya,9,0,32,23
1657751563157,MATH 20E,A02,083772,Ganguly; Soumya,6,0,32,26
1657751563157,MATH 20E,B01,083773,Ciotti; Benjamin,20,0,35,15
1657751563157,MATH 20E,B02,083774,Ciotti; Benjamin,18,0,35,17
1657751569193,MATH 103A,A01,083777,Greenfeld; Be'Eri,3,0,36,33
1657751569193,MATH 103A,A02,083778,Greenfeld; Be'Eri,5,0,36,31
1657751569193,MATH 103A,A03,093561,Greenfeld; Be'Eri,6,0,36,30
1657751569193,MATH 103A,B01,083779,Greenfeld; Be'Eri,7,0,36,29
1657751569193,MATH 103A,B02,083780,Greenfeld; Be'Eri,4,0,36,32
1657751569193,MATH 103A,B03,093562,Greenfeld; Be'Eri,3,0,36,33
1657751575218,MATH 105,A01,085443,Carter; Anne Toulson,15,0,35,20
1657751575218,MATH 105,A02,093477,Carter; Anne Toulson,20,0,35,15
1657751581246,MATH 109,A01,083213,Ganzberger; Geoffrey Michael,3,0,34,31
1657751581246,MATH 109,A02,083214,Ganzberger; Geoffrey Michael,4,0,34,30
1657751581246,MATH 109,A03,093478,Ganzberger; Geoffrey Michael,2,0,34,32
1657751581246,MATH 109,B01,083215,Ganzberger; Geoffrey Michael,1,0,32,31
1657751581246,MATH 109,B02,083216,Ganzberger; Geoffrey Michael,2,0,32,30
1657751581246,MATH 109,B03,093479,Ganzberger; Geoffrey Michael,8,0,32,24
1657751587272,MATH 142A,A01,083219,Chow; Bennett,7,0,32,25
1657751587272,MATH 142A,A02,083220,Chow; Bennett,10,0,32,22
1657751587272,MATH 142A,A03,093480,Chow; Bennett,9,0,32,23
1657751587272,MATH 142A,B03,093481,Chow; Bennett,8,0,32,24
1657751587272,MATH 142A,B04,093558,Chow; Bennett,13,0,32,19
1657751587272,MATH 142A,B05,093559,Chow; Bennett,6,0,32,26
1657751593298,MATH 193A,A01,083224,Rotar; Vladimir,8,0,34,26
1657751593298,MATH 193A,A02,083225,Rotar; Vladimir,9,0,34,25
1657751593298,MATH 193A,A03,083781,Rotar; Vladimir,5,0,34,29
1657751593298,MATH 193A,A04,083782,Rotar; Vladimir,10,0,34,24
1657751593298,MATH 193A,A05,093482,Rotar; Vladimir,10,0,34,24
1657751599323,MATH 197,001,091859,McAuley; Julian John,9999,0,9999,0
1657751599323,MATH 197,002,095566,Kedlaya; Kiran S.,9997,0,9999,2
1657751599323,MATH 197,003,095567,Xiao; Ming,9999,0,9999,0
1657751599323,MATH 197,004,095571,Perols; Johan Lars,9998,0,9999,1
1657751606373,COGS 9,A01,083615,Shannon; Kyle Michael,9,0,75,66
1657751612396,COGS 11,A01,083617,Boyle; Mary E. T.,23,0,48,25
1657751618437,COGS 13,A01,083071,Bastos; Amalia Pinkusfeld,11,0,71,60
1657751624459,COGS 14A,A01,092681,Semenuks; Arturs,5,1,100,95
1657751630485,COGS 14B,A01,083073,Cheng; Tzu-Han,6,0,63,57
1657751636517,COGS 17,A01,092677,Semenuks; Arturs,6,0,81,75
1657751642556,COGS 100,A01,083619,Allen; Michael Gordon,17,0,70,53
1657751648586,COGS 101A,A01,083621,Davis; Joshua Daniel,9,0,68,59
1657751654613,COGS 101B,A01,091572,Allen; Michael Gordon,12,0,65,53
1657751660636,COGS 101C,A01,083625,Delgado; Tania,17,0,35,18
1657751666661,COGS 107A,A01,083627,Boyle; Mary E. T.,13,0,60,47
1657751672692,COGS 118A,A01,083075,Gupta; Anjum,21,0,76,55
1657751678719,CSE 3,A50,083646,Miranda; Gregory Joseph,24,0,50,26
1657751684753,CSE 8A,A50,083650,Miranda; Gregory Joseph,17,1,56,39
1657751690777,CSE 11,A01,083080,Cao; Yingjun,6,15,40,34
1657751696805,CSE 12,A01,083652,Krause-Levy; Sophia Louisa,28,1,120,92
1657751702833,CSE 15L,A01,083654,Morris; Justin Loren,9,0,50,41
1657751702833,CSE 15L,A02,083655,Morris; Justin Loren,9,0,50,41
1657751708866,CSE 20,A01,083657,Tran; Khoa Dang,39,0,80,41
1657751714892,CSE 21,A01,095574,Bach; Quang Tran,22,0,48,26
1657751720916,CSE 30,A01,083084,Eldon; John,6,0,80,74
1657751720916,CSE 30,B01,095061,Bhaskar; Nishant,9,0,50,41
1657751726938,CSE 100,A01,083659,Cao; Yingjun,5,4,70,65
1657751732959,CSE 134B,A01,083661,Powell; Thomas Allan,24,0,100,76
1657751738989,CSE 140,A01,083663,Gungor; Onat,15,0,85,70
1657751745011,CSE 140L,A01,083088,Eldon; John,23,0,100,77
1657751751037,CSE 175,A01,083665,Kumar; Rakesh,3,0,25,22
1657751757064,CSE 190,A00,092507,Dubnov; Shlomo,8,0,20,12
1657751763093,ECE 45,A01,083139,Congero; Spencer William,6,0,75,69
1657751769116,ECE 65,A50,083695,Saad; Andrew S,12,0,30,18
1657751769116,ECE 65,A51,095125,Saad; Andrew S,24,0,26,2
1657751775138,ECE 109,A01,091882,Touri; Behrouz,20,0,70,50
1657751781167,ECE 180,A00,083140,Abi Samra; Nicholas Camill,1,0,30,29
1657751781167,ECE 180,B00,083141,Abi Samra; Nicholas Camill,0,0,30,30
1657751787192,MATH 10A,A01,083735,Patchell; Gregory David,2,0,30,28
1657751787192,MATH 10A,A02,083736,Patchell; Gregory David,20,0,30,10
1657751787192,MATH 10A,A03,083737,Patchell; Gregory David,16,0,30,14
1657751793220,MATH 10B,A01,083207,Lim; Seonhee,8,0,34,26
1657751793220,MATH 10B,A02,083208,Lim; Seonhee,9,0,35,26
1657751793220,MATH 10B,A03,093472,Lim; Seonhee,7,0,34,27
1657751793220,MATH 10B,B01,083739,Sinha; Shubham,13,0,30,17
1657751799258,MATH 18,A01,083743,Cinel; Cameron Alexander,9,0,30,21
1657751799258,MATH 18,A02,083744,Cinel; Cameron Alexander,18,0,30,12
1657751799258,MATH 18,A03,083745,Cinel; Cameron Alexander,10,0,30,20
1657751799258,MATH 18,B01,083748,Rideout; David Porter,5,0,37,32
1657751799258,MATH 18,B02,083749,Rideout; David Porter,5,0,36,31
1657751799258,MATH 18,B03,083750,Rideout; David Porter,3,0,37,34
1657751799258,MATH 18,B04,083751,Rideout; David Porter,6,0,36,30
1657751799258,MATH 18,B05,093473,Rideout; David Porter,6,0,36,30
1657751799258,MATH 18,B06,093474,Rideout; David Porter,6,0,36,30
1657751805279,MATH 20A,A01,083754,Zheng; Zequn,14,0,40,26
1657751811302,MATH 20B,A01,083756,Briones; Jor-el Thomas Caparas,4,0,36,32
1657751811302,MATH 20B,A02,083757,Briones; Jor-el Thomas Caparas,1,0,36,35
1657751811302,MATH 20B,A03,093475,Briones; Jor-el Thomas Caparas,2,0,36,34
1657751817324,MATH 20C,A01,083760,Briones; Jor-el Thomas Caparas,1,0,35,34
1657751817324,MATH 20C,A02,083761,Briones; Jor-el Thomas Caparas,8,0,35,27
1657751817324,MATH 20C,A03,093476,Briones; Jor-el Thomas Caparas,0,1,36,36
1657751817324,MATH 20C,B01,083762,Bach; Quang Tran,1,0,30,29
1657751823352,MATH 20D,A01,083765,Tran; Brian Kha,5,0,30,25
1657751823352,MATH 20D,A02,083766,Tran; Brian Kha,5,0,30,25
1657751823352,MATH 20D,A03,083767,Tran; Brian Kha,5,0,30,25
1657751829374,MATH 20E,A01,083771,Ganguly; Soumya,9,0,32,23
1657751829374,MATH 20E,A02,083772,Ganguly; Soumya,6,0,32,26
1657751829374,MATH 20E,B01,083773,Ciotti; Benjamin,20,0,35,15
1657751829374,MATH 20E,B02,083774,Ciotti; Benjamin,18,0,35,17
1657751835397,MATH 103A,A01,083777,Greenfeld; Be'Eri,3,0,36,33
1657751835397,MATH 103A,A02,083778,Greenfeld; Be'Eri,5,0,36,31
1657751835397,MATH 103A,A03,093561,Greenfeld; Be'Eri,6,0,36,30
1657751835397,MATH 103A,B01,083779,Greenfeld; Be'Eri,7,0,36,29
1657751835397,MATH 103A,B02,083780,Greenfeld; Be'Eri,4,0,36,32
1657751835397,MATH 103A,B03,093562,Greenfeld; Be'Eri,3,0,36,33
1657751841420,MATH 105,A01,085443,Carter; Anne Toulson,15,0,35,20
1657751841420,MATH 105,A02,093477,Carter; Anne Toulson,20,0,35,15
1657751847446,MATH 109,A01,083213,Ganzberger; Geoffrey Michael,3,0,34,31
1657751847446,MATH 109,A02,083214,Ganzberger; Geoffrey Michael,4,0,34,30
1657751847446,MATH 109,A03,093478,Ganzberger; Geoffrey Michael,2,0,34,32
1657751847446,MATH 109,B01,083215,Ganzberger; Geoffrey Michael,1,0,32,31
1657751847446,MATH 109,B02,083216,Ganzberger; Geoffrey Michael,2,0,32,30
1657751847446,MATH 109,B03,093479,Ganzberger; Geoffrey Michael,8,0,32,24
1657751853473,MATH 142A,A01,083219,Chow; Bennett,7,0,32,25
1657751853473,MATH 142A,A02,083220,Chow; Bennett,10,0,32,22
1657751853473,MATH 142A,A03,093480,Chow; Bennett,9,0,32,23
1657751853473,MATH 142A,B03,093481,Chow; Bennett,8,0,32,24
1657751853473,MATH 142A,B04,093558,Chow; Bennett,13,0,32,19
1657751853473,MATH 142A,B05,093559,Chow; Bennett,6,0,32,26
1657751859513,MATH 193A,A01,083224,Rotar; Vladimir,8,0,34,26
1657751859513,MATH 193A,A02,083225,Rotar; Vladimir,9,0,34,25
1657751859513,MATH 193A,A03,083781,Rotar; Vladimir,5,0,34,29
1657751859513,MATH 193A,A04,083782,Rotar; Vladimir,10,0,34,24
1657751859513,MATH 193A,A05,093482,Rotar; Vladimir,10,0,34,24
1657751865536,MATH 197,001,091859,McAuley; Julian John,9999,0,9999,0
1657751865536,MATH 197,002,095566,Kedlaya; Kiran S.,9997,0,9999,2
1657751865536,MATH 197,003,095567,Xiao; Ming,9999,0,9999,0
1657751865536,MATH 197,004,095571,Perols; Johan Lars,9998,0,9999,1
1657751872600,COGS 9,A01,083615,Shannon; Kyle Michael,9,0,75,66
1657751878629,COGS 11,A01,083617,Boyle; Mary E. T.,23,0,48,25
1657751884656,COGS 13,A01,083071,Bastos; Amalia Pinkusfeld,11,0,71,60
1657751890677,COGS 14A,A01,092681,Semenuks; Arturs,5,1,100,95
1657751896704,COGS 14B,A01,083073,Cheng; Tzu-Han,6,0,63,57
1657751902729,COGS 17,A01,092677,Semenuks; Arturs,6,0,81,75
1657751908758,COGS 100,A01,083619,Allen; Michael Gordon,17,0,70,53
1657751914784,COGS 101A,A01,083621,Davis; Joshua Daniel,9,0,68,59
1657751920821,COGS 101B,A01,091572,Allen; Michael Gordon,12,0,65,53
1657751926847,COGS 101C,A01,083625,Delgado; Tania,17,0,35,18
1657751932870,COGS 107A,A01,083627,Boyle; Mary E. T.,13,0,60,47
1657751938891,COGS 118A,A01,083075,Gupta; Anjum,21,0,76,55
1657751944928,CSE 3,A50,083646,Miranda; Gregory Joseph,24,0,50,26
1657751950961,CSE 8A,A50,083650,Miranda; Gregory Joseph,17,1,56,39
1657751956990,CSE 11,A01,083080,Cao; Yingjun,6,15,40,34
1657751963022,CSE 12,A01,083652,Krause-Levy; Sophia Louisa,28,1,120,92
1657751969054,CSE 15L,A01,083654,Morris; Justin Loren,9,0,50,41
1657751969054,CSE 15L,A02,083655,Morris; Justin Loren,9,0,50,41
1657751975078,CSE 20,A01,083657,Tran; Khoa Dang,39,0,80,41
1657751981106,CSE 21,A01,095574,Bach; Quang Tran,22,0,48,26
1657751987129,CSE 30,A01,083084,Eldon; John,6,0,80,74
1657751987129,CSE 30,B01,095061,Bhaskar; Nishant,9,0,50,41
1657751993156,CSE 100,A01,083659,Cao; Yingjun,5,4,70,65
1657751999185,CSE 134B,A01,083661,Powell; Thomas Allan,24,0,100,76
1657752005214,CSE 140,A01,083663,Gungor; Onat,15,0,85,70
1657752011238,CSE 140L,A01,083088,Eldon; John,23,0,100,77
1657752017277,CSE 175,A01,083665,Kumar; Rakesh,3,0,25,22
1657752023299,CSE 190,A00,092507,Dubnov; Shlomo,8,0,20,12
1657752029322,ECE 45,A01,083139,Congero; Spencer William,6,0,75,69
1657752035349,ECE 65,A50,083695,Saad; Andrew S,12,0,30,18
1657752035349,ECE 65,A51,095125,Saad; Andrew S,24,0,26,2
1657752041372,ECE 109,A01,091882,Touri; Behrouz,20,0,70,50
1657752047396,ECE 180,A00,083140,Abi Samra; Nicholas Camill,1,0,30,29
1657752047396,ECE 180,B00,083141,Abi Samra; Nicholas Camill,0,0,30,30
1657752053430,MATH 10A,A01,083735,Patchell; Gregory David,2,0,30,28
1657752053430,MATH 10A,A02,083736,Patchell; Gregory David,20,0,30,10
1657752053430,MATH 10A,A03,083737,Patchell; Gregory David,16,0,30,14
1657752059458,MATH 10B,A01,083207,Lim; Seonhee,8,0,34,26
1657752059458,MATH 10B,A02,083208,Lim; Seonhee,9,0,35,26
1657752059458,MATH 10B,A03,093472,Lim; Seonhee,7,0,34,27
1657752059458,MATH 10B,B01,083739,Sinha; Shubham,13,0,30,17
1657752065484,MATH 18,A01,083743,Cinel; Cameron Alexander,9,0,30,21
1657752065484,MATH 18,A02,083744,Cinel; Cameron Alexander,18,0,30,12
1657752065484,MATH 18,A03,083745,Cinel; Cameron Alexander,10,0,30,20
1657752065484,MATH 18,B01,083748,Rideout; David Porter,5,0,37,32
1657752065484,MATH 18,B02,083749,Rideout; David Porter,5,0,36,31
1657752065484,MATH 18,B03,083750,Rideout; David Porter,3,0,37,34
1657752065484,MATH 18,B04,083751,Rideout; David Porter,6,0,36,30
1657752065484,MATH 18,B05,093473,Rideout; David Porter,6,0,36,30
1657752065484,MATH 18,B06,093474,Rideout; David Porter,6,0,36,30
1657752071508,MATH 20A,A01,083754,Zheng; Zequn,14,0,40,26
1657752077539,MATH 20B,A01,083756,Briones; Jor-el Thomas Caparas,4,0,36,32
1657752077539,MATH 20B,A02,083757,Briones; Jor-el Thomas Caparas,1,0,36,35
1657752077539,MATH 20B,A03,093475,Briones; Jor-el Thomas Caparas,2,0,36,34
1657752083649,MATH 20C,A01,083760,Briones; Jor-el Thomas Caparas,1,0,35,34
1657752083649,MATH 20C,A02,083761,Briones; Jor-el Thomas Caparas,8,0,35,27
1657752083649,MATH 20C,A03,093476,Briones; Jor-el Thomas Caparas,0,1,36,36
1657752083649,MATH 20C,B01,083762,Bach; Quang Tran,1,0,30,29
1657752089676,MATH 20D,A01,083765,Tran; Brian Kha,5,0,30,25
1657752089676,MATH 20D,A02,083766,Tran; Brian Kha,5,0,30,25
1657752089676,MATH 20D,A03,083767,Tran; Brian Kha,5,0,30,25
1657752095718,MATH 20E,A01,083771,Ganguly; Soumya,9,0,32,23
1657752095718,MATH 20E,A02,083772,Ganguly; Soumya,6,0,32,26
1657752095718,MATH 20E,B01,083773,Ciotti; Benjamin,20,0,35,15
1657752095718,MATH 20E,B02,083774,Ciotti; Benjamin,18,0,35,17
1657752101740,MATH 103A,A01,083777,Greenfeld; Be'Eri,3,0,36,33
1657752101740,MATH 103A,A02,083778,Greenfeld; Be'Eri,5,0,36,31
1657752101740,MATH 103A,A03,093561,Greenfeld; Be'Eri,6,0,36,30
1657752101740,MATH 103A,B01,083779,Greenfeld; Be'Eri,7,0,36,29
1657752101740,MATH 103A,B02,083780,Greenfeld; Be'Eri,4,0,36,32
1657752101740,MATH 103A,B03,093562,Greenfeld; Be'Eri,3,0,36,33
1657752107763,MATH 105,A01,085443,Carter; Anne Toulson,15,0,35,20
1657752107763,MATH 105,A02,093477,Carter; Anne Toulson,20,0,35,15
1657752113795,MATH 109,A01,083213,Ganzberger; Geoffrey Michael,3,0,34,31
1657752113795,MATH 109,A02,083214,Ganzberger; Geoffrey Michael,4,0,34,30
1657752113795,MATH 109,A03,093478,Ganzberger; Geoffrey Michael,2,0,34,32
1657752113795,MATH 109,B01,083215,Ganzberger; Geoffrey Michael,1,0,32,31
1657752113795,MATH 109,B02,083216,Ganzberger; Geoffrey Michael,2,0,32,30
1657752113795,MATH 109,B03,093479,Ganzberger; Geoffrey Michael,8,0,32,24
1657752119820,MATH 142A,A01,083219,Chow; Bennett,7,0,32,25
1657752119820,MATH 142A,A02,083220,Chow; Bennett,10,0,32,22
1657752119820,MATH 142A,A03,093480,Chow; Bennett,9,0,32,23
1657752119820,MATH 142A,B03,093481,Chow; Bennett,8,0,32,24
1657752119820,MATH 142A,B04,093558,Chow; Bennett,13,0,32,19
1657752119820,MATH 142A,B05,093559,Chow; Bennett,6,0,32,26
1657752125852,MATH 193A,A01,083224,Rotar; Vladimir,8,0,34,26
1657752125852,MATH 193A,A02,083225,Rotar; Vladimir,9,0,34,25
1657752125852,MATH 193A,A03,083781,Rotar; Vladimir,5,0,34,29
1657752125852,MATH 193A,A04,083782,Rotar; Vladimir,10,0,34,24
1657752125852,MATH 193A,A05,093482,Rotar; Vladimir,10,0,34,24
1657752131876,MATH 197,001,091859,McAuley; Julian John,9999,0,9999,0
1657752131876,MATH 197,002,095566,Kedlaya; Kiran S.,9997,0,9999,2
1657752131876,MATH 197,003,095567,Xiao; Ming,9999,0,9999,0
1657752131876,MATH 197,004,095571,Perols; Johan Lars,9998,0,9999,1
1657752138930,COGS 9,A01,083615,Shannon; Kyle Michael,9,0,75,66
1657752144954,COGS 11,A01,083617,Boyle; Mary E. T.,23,0,48,25
1657752150977,COGS 13,A01,083071,Bastos; Amalia Pinkusfeld,11,0,71,60
1657752157014,COGS 14A,A01,092681,Semenuks; Arturs,5,1,100,95
1657752163041,COGS 14B,A01,083073,Cheng; Tzu-Han,6,0,63,57
1657752169074,COGS 17,A01,092677,Semenuks; Arturs,6,0,81,75
1657752175099,COGS 100,A01,083619,Allen; Michael Gordon,17,0,70,53
1657752181121,COGS 101A,A01,083621,Davis; Joshua Daniel,9,0,68,59
1657752187145,COGS 101B,A01,091572,Allen; Michael Gordon,12,0,65,53
1657752193167,COGS 101C,A01,083625,Delgado; Tania,17,0,35,18
1657752199192,COGS 107A,A01,083627,Boyle; Mary E. T.,13,0,60,47
1657752205215,COGS 118A,A01,083075,Gupta; Anjum,21,0,76,55
1657752211243,CSE 3,A50,083646,Miranda; Gregory Joseph,24,0,50,26
1657752217270,CSE 8A,A50,083650,Miranda; Gregory Joseph,17,1,56,39
1657752223294,CSE 11,A01,083080,Cao; Yingjun,6,15,40,34
1657752229316,CSE 12,A01,083652,Krause-Levy; Sophia Louisa,28,1,120,92
1657752235342,CSE 15L,A01,083654,Morris; Justin Loren,9,0,50,41
1657752235342,CSE 15L,A02,083655,Morris; Justin Loren,9,0,50,41
1657752241367,CSE 20,A01,083657,Tran; Khoa Dang,39,0,80,41
1657752247390,CSE 21,A01,095574,Bach; Quang Tran,22,0,48,26
1657752253414,CSE 30,A01,083084,Eldon; John,6,0,80,74
1657752253414,CSE 30,B01,095061,Bhaskar; Nishant,9,0,50,41
1657752259437,CSE 100,A01,083659,Cao; Yingjun,5,4,70,65
1657752265463,CSE 134B,A01,083661,Powell; Thomas Allan,24,0,100,76
1657752271486,CSE 140,A01,083663,Gungor; Onat,15,0,85,70
1657752277518,CSE 140L,A01,083088,Eldon; John,23,0,100,77
1657752283550,CSE 175,A01,083665,Kumar; Rakesh,3,0,25,22
1657752289572,CSE 190,A00,092507,Dubnov; Shlomo,8,0,20,12
1657752295595,ECE 45,A01,083139,Congero; Spencer William,6,0,75,69
1657752301621,ECE 65,A50,083695,Saad; Andrew S,12,0,30,18
1657752301621,ECE 65,A51,095125,Saad; Andrew S,24,0,26,2
1657752307653,ECE 109,A01,091882,Touri; Behrouz,20,0,70,50
1657752313686,ECE 180,A00,083140,Abi Samra; Nicholas Camill,1,0,30,29
1657752313686,ECE 180,B00,083141,Abi Samra; Nicholas Camill,0,0,30,30
1657752319709,MATH 10A,A01,083735,Patchell; Gregory David,2,0,30,28
1657752319709,MATH 10A,A02,083736,Patchell; Gregory David,20,0,30,10
1657752319709,MATH 10A,A03,083737,Patchell; Gregory David,16,0,30,14
1657752325730,MATH 10B,A01,083207,Lim; Seonhee,8,0,34,26
1657752325730,MATH 10B,A02,083208,Lim; Seonhee,9,0,35,26
1657752325730,MATH 10B,A03,093472,Lim; Seonhee,7,0,34,27
1657752325730,MATH 10B,B01,083739,Sinha; Shubham,13,0,30,17
1657752331755,MATH 18,A01,083743,Cinel; Cameron Alexander,9,0,30,21
1657752331755,MATH 18,A02,083744,Cinel; Cameron Alexander,18,0,30,12
1657752331755,MATH 18,A03,083745,Cinel; Cameron Alexander,10,0,30,20
1657752331755,MATH 18,B01,083748,Rideout; David Porter,5,0,37,32
1657752331755,MATH 18,B02,083749,Rideout; David Porter,5,0,36,31
1657752331755,MATH 18,B03,083750,Rideout; David Porter,3,0,37,34
1657752331755,MATH 18,B04,083751,Rideout; David Porter,6,0,36,30
1657752331755,MATH 18,B05,093473,Rideout; David Porter,6,0,36,30
1657752331755,MATH 18,B06,093474,Rideout; David Porter,6,0,36,30
1657752337779,MATH 20A,A01,083754,Zheng; Zequn,14,0,40,26
1657752343807,MATH 20B,A01,083756,Briones; Jor-el Thomas Caparas,4,0,36,32
1657752343807,MATH 20B,A02,083757,Briones; Jor-el Thomas Caparas,1,0,36,35
1657752343807,MATH 20B,A03,093475,Briones; Jor-el Thomas Caparas,2,0,36,34
1657752349831,MATH 20C,A01,083760,Briones; Jor-el Thomas Caparas,1,0,35,34
1657752349831,MATH 20C,A02,083761,Briones; Jor-el Thomas Caparas,8,0,35,27
1657752349831,MATH 20C,A03,093476,Briones; Jor-el Thomas Caparas,0,1,36,36
1657752349831,MATH 20C,B01,083762,Bach; Quang Tran,1,0,30,29
1657752355855,MATH 20D,A01,083765,Tran; Brian Kha,5,0,30,25
1657752355855,MATH 20D,A02,083766,Tran; Brian Kha,5,0,30,25
1657752355855,MATH 20D,A03,083767,Tran; Brian Kha,5,0,30,25
1657752361877,MATH 20E,A01,083771,Ganguly; Soumya,9,0,32,23
1657752361877,MATH 20E,A02,083772,Ganguly; Soumya,6,0,32,26
1657752361877,MATH 20E,B01,083773,Ciotti; Benjamin,20,0,35,15
1657752361877,MATH 20E,B02,083774,Ciotti; Benjamin,18,0,35,17
1657752367903,MATH 103A,A01,083777,Greenfeld; Be'Eri,3,0,36,33
1657752367903,MATH 103A,A02,083778,Greenfeld; Be'Eri,5,0,36,31
1657752367903,MATH 103A,A03,093561,Greenfeld; Be'Eri,6,0,36,30
1657752367903,MATH 103A,B01,083779,Greenfeld; Be'Eri,7,0,36,29
1657752367903,MATH 103A,B02,083780,Greenfeld; Be'Eri,4,0,36,32
1657752367903,MATH 103A,B03,093562,Greenfeld; Be'Eri,3,0,36,33
1657752373926,MATH 105,A01,085443,Carter; Anne Toulson,15,0,35,20
1657752373926,MATH 105,A02,093477,Carter; Anne Toulson,20,0,35,15
1657752379957,MATH 109,A01,083213,Ganzberger; Geoffrey Michael,3,0,34,31
1657752379957,MATH 109,A02,083214,Ganzberger; Geoffrey Michael,4,0,34,30
1657752379957,MATH 109,A03,093478,Ganzberger; Geoffrey Michael,2,0,34,32
1657752379957,MATH 109,B01,083215,Ganzberger; Geoffrey Michael,1,0,32,31
1657752379957,MATH 109,B02,083216,Ganzberger; Geoffrey Michael,2,0,32,30
1657752379957,MATH 109,B03,093479,Ganzberger; Geoffrey Michael,8,0,32,24
1657752385993,MATH 142A,A01,083219,Chow; Bennett,7,0,32,25
1657752385993,MATH 142A,A02,083220,Chow; Bennett,10,0,32,22
1657752385993,MATH 142A,A03,093480,Chow; Bennett,9,0,32,23
1657752385993,MATH 142A,B03,093481,Chow; Bennett,8,0,32,24
1657752385993,MATH 142A,B04,093558,Chow; Bennett,13,0,32,19
1657752385993,MATH 142A,B05,093559,Chow; Bennett,6,0,32,26
1657752392036,MATH 193A,A01,083224,Rotar; Vladimir,8,0,34,26
1657752392036,MATH 193A,A02,083225,Rotar; Vladimir,9,0,34,25
1657752392036,MATH 193A,A03,083781,Rotar; Vladimir,5,0,34,29
1657752392036,MATH 193A,A04,083782,Rotar; Vladimir,10,0,34,24
1657752392036,MATH 193A,A05,093482,Rotar; Vladimir,10,0,34,24
1657752398067,MATH 197,001,091859,McAuley; Julian John,9999,0,9999,0
1657752398067,MATH 197,002,095566,Kedlaya; Kiran S.,9997,0,9999,2
1657752398067,MATH 197,003,095567,Xiao; Ming,9999,0,9999,0
1657752398067,MATH 197,004,095571,Perols; Johan Lars,9998,0,9999,1
1657752405137,COGS 9,A01,083615,Shannon; Kyle Michael,9,0,75,66
1657752411169,COGS 11,A01,083617,Boyle; Mary E. T.,23,0,48,25
1657752417194,COGS 13,A01,083071,Bastos; Amalia Pinkusfeld,11,0,71,60
1657752423219,COGS 14A,A01,092681,Semenuks; Arturs,5,1,100,95
1657752429241,COGS 14B,A01,083073,Cheng; Tzu-Han,6,0,63,57
1657752435264,COGS 17,A01,092677,Semenuks; Arturs,6,0,81,75
1657752441291,COGS 100,A01,083619,Allen; Michael Gordon,17,0,70,53
1657752447316,COGS 101A,A01,083621,Davis; Joshua Daniel,9,0,68,59
1657752453338,COGS 101B,A01,091572,Allen; Michael Gordon,12,0,65,53
1657752459361,COGS 101C,A01,083625,Delgado; Tania,17,0,35,18
1657752465387,COGS 107A,A01,083627,Boyle; Mary E. T.,13,0,60,47
1657752471427,COGS 118A,A01,083075,Gupta; Anjum,21,0,76,55
1657752477455,CSE 3,A50,083646,Miranda; Gregory Joseph,24,0,50,26
1657752483482,CSE 8A,A50,083650,Miranda; Gregory Joseph,17,1,56,39
1657752489508,CSE 11,A01,083080,Cao; Yingjun,6,15,40,34
1657752495530,CSE 12,A01,083652,Krause-Levy; Sophia Louisa,28,1,120,92
1657752501560,CSE 15L,A01,083654,Morris; Justin Loren,9,0,50,41
1657752501560,CSE 15L,A02,083655,Morris; Justin Loren,9,0,50,41
1657752507582,CSE 20,A01,083657,Tran; Khoa Dang,39,0,80,41
1657752513611,CSE 21,A01,095574,Bach; Quang Tran,22,0,48,26
1657752519637,CSE 30,A01,083084,Eldon; John,6,0,80,74
1657752519637,CSE 30,B01,095061,Bhaskar; Nishant,9,0,50,41
1657752525673,CSE 100,A01,083659,Cao; Yingjun,5,4,70,65
1657752531709,CSE 134B,A01,083661,Powell; Thomas Allan,24,0,100,76
1657752537737,CSE 140,A01,083663,Gungor; Onat,15,0,85,70
1657752543761,CSE 140L,A01,083088,Eldon; John,23,0,100,77
1657752549784,CSE 175,A01,083665,Kumar; Rakesh,3,0,25,22
1657752555807,CSE 190,A00,092507,Dubnov; Shlomo,8,0,20,12
1657752561830,ECE 45,A01,083139,Congero; Spencer William,6,0,75,69
1657752567870,ECE 65,A50,083695,Saad; Andrew S,12,0,30,18
1657752567870,ECE 65,A51,095125,Saad; Andrew S,24,0,26,2
1657752573892,ECE 109,A01,091882,Touri; Behrouz,20,0,70,50
1657752579919,ECE 180,A00,083140,Abi Samra; Nicholas Camill,1,0,30,29
1657752579919,ECE 180,B00,083141,Abi Samra; Nicholas Camill,0,0,30,30
1657752585942,MATH 10A,A01,083735,Patchell; Gregory David,2,0,30,28
1657752585942,MATH 10A,A02,083736,Patchell; Gregory David,20,0,30,10
1657752585942,MATH 10A,A03,083737,Patchell; Gregory David,16,0,30,14
1657752591969,MATH 10B,A01,083207,Lim; Seonhee,8,0,34,26
1657752591969,MATH 10B,A02,083208,Lim; Seonhee,9,0,35,26
1657752591969,MATH 10B,A03,093472,Lim; Seonhee,7,0,34,27
1657752591969,MATH 10B,B01,083739,Sinha; Shubham,13,0,30,17
1657752598007,MATH 18,A01,083743,Cinel; Cameron Alexander,9,0,30,21
1657752598007,MATH 18,A02,083744,Cinel; Cameron Alexander,18,0,30,12
1657752598007,MATH 18,A03,083745,Cinel; Cameron Alexander,10,0,30,20
1657752598007,MATH 18,B01,083748,Rideout; David Porter,5,0,37,32
1657752598007,MATH 18,B02,083749,Rideout; David Porter,5,0,36,31
1657752598007,MATH 18,B03,083750,Rideout; David Porter,3,0,37,34
1657752598007,MATH 18,B04,083751,Rideout; David Porter,6,0,36,30
1657752598007,MATH 18,B05,093473,Rideout; David Porter,6,0,36,30
1657752598007,MATH 18,B06,093474,Rideout; David Porter,6,0,36,30
1657752604029,MATH 20A,A01,083754,Zheng; Zequn,14,0,40,26
1657752610052,MATH 20B,A01,083756,Briones; Jor-el Thomas Caparas,4,0,36,32
1657752610052,MATH 20B,A02,083757,Briones; Jor-el Thomas Caparas,1,0,36,35
1657752610052,MATH 20B,A03,093475,Briones; Jor-el Thomas Caparas,2,0,36,34
1657752616093,MATH 20C,A01,083760,Briones; Jor-el Thomas Caparas,1,0,35,34
1657752616093,MATH 20C,A02,083761,Briones; Jor-el Thomas Caparas,8,0,35,27
1657752616093,MATH 20C,A03,093476,Briones; Jor-el Thomas Caparas,0,1,36,36
1657752616093,MATH 20C,B01,083762,Bach; Quang Tran,1,0,30,29
1657752622120,MATH 20D,A01,083765,Tran; Brian Kha,5,0,30,25
1657752622120,MATH 20D,A02,083766,Tran; Brian Kha,5,0,30,25
1657752622120,MATH 20D,A03,083767,Tran; Brian Kha,5,0,30,25
1657752628145,MATH 20E,A01,083771,Ganguly; Soumya,9,0,32,23
1657752628145,MATH 20E,A02,083772,Ganguly; Soumya,6,0,32,26
1657752628145,MATH 20E,B01,083773,Ciotti; Benjamin,20,0,35,15
1657752628145,MATH 20E,B02,083774,Ciotti; Benjamin,18,0,35,17
1657752634174,MATH 103A,A01,083777,Greenfeld; Be'Eri,3,0,36,33
1657752634174,MATH 103A,A02,083778,Greenfeld; Be'Eri,5,0,36,31
1657752634174,MATH 103A,A03,093561,Greenfeld; Be'Eri,6,0,36,30
1657752634174,MATH 103A,B01,083779,Greenfeld; Be'Eri,7,0,36,29
1657752634174,MATH 103A,B02,083780,Greenfeld; Be'Eri,4,0,36,32
1657752634174,MATH 103A,B03,093562,Greenfeld; Be'Eri,3,0,36,33
1657752640197,MATH 105,A01,085443,Carter; Anne Toulson,15,0,35,20
1657752640197,MATH 105,A02,093477,Carter; Anne Toulson,20,0,35,15
1657752646222,MATH 109,A01,083213,Ganzberger; Geoffrey Michael,3,0,34,31
1657752646222,MATH 109,A02,083214,Ganzberger; Geoffrey Michael,4,0,34,30
1657752646222,MATH 109,A03,093478,Ganzberger; Geoffrey Michael,2,0,34,32
1657752646222,MATH 109,B01,083215,Ganzberger; Geoffrey Michael,1,0,32,31
1657752646222,MATH 109,B02,083216,Ganzberger; Geoffrey Michael,2,0,32,30
1657752646222,MATH 109,B03,093479,Ganzberger; Geoffrey Michael,8,0,32,24
1657752652251,MATH 142A,A01,083219,Chow; Bennett,7,0,32,25
1657752652251,MATH 142A,A02,083220,Chow; Bennett,10,0,32,22
1657752652251,MATH 142A,A03,093480,Chow; Bennett,9,0,32,23
1657752652251,MATH 142A,B03,093481,Chow; Bennett,8,0,32,24
1657752652251,MATH 142A,B04,093558,Chow; Bennett,13,0,32,19
1657752652251,MATH 142A,B05,093559,Chow; Bennett,6,0,32,26
1657752658277,MATH 193A,A01,083224,Rotar; Vladimir,8,0,34,26
1657752658277,MATH 193A,A02,083225,Rotar; Vladimir,9,0,34,25
1657752658277,MATH 193A,A03,083781,Rotar; Vladimir,5,0,34,29
1657752658277,MATH 193A,A04,083782,Rotar; Vladimir,10,0,34,24
1657752658277,MATH 193A,A05,093482,Rotar; Vladimir,10,0,34,24
1657752664309,MATH 197,001,091859,McAuley; Julian John,9999,0,9999,0
1657752664309,MATH 197,002,095566,Kedlaya; Kiran S.,9997,0,9999,2
1657752664309,MATH 197,003,095567,Xiao; Ming,9999,0,9999,0
1657752664309,MATH 197,004,095571,Perols; Johan Lars,9998,0,9999,1
1657752671375,COGS 9,A01,083615,Shannon; Kyle Michael,9,0,75,66
1657752677474,COGS 11,A01,083617,Boyle; Mary E. T.,23,0,48,25
1657752683499,COGS 13,A01,083071,Bastos; Amalia Pinkusfeld,11,0,71,60
1657752689524,COGS 14A,A01,092681,Semenuks; Arturs,5,1,100,95
1657752695551,COGS 14B,A01,083073,Cheng; Tzu-Han,6,0,63,57
1657752701586,COGS 17,A01,092677,Semenuks; Arturs,6,0,81,75
1657752707612,COGS 100,A01,083619,Allen; Michael Gordon,17,0,70,53
1657752713638,COGS 101A,A01,083621,Davis; Joshua Daniel,9,0,68,59
1657752719660,COGS 101B,A01,091572,Allen; Michael Gordon,12,0,65,53
1657752725683,COGS 101C,A01,083625,Delgado; Tania,17,0,35,18
1657752731717,COGS 107A,A01,083627,Boyle; Mary E. T.,13,0,60,47
1657752737745,COGS 118A,A01,083075,Gupta; Anjum,21,0,76,55
1657752743770,CSE 3,A50,083646,Miranda; Gregory Joseph,24,0,50,26
1657752749800,CSE 8A,A50,083650,Miranda; Gregory Joseph,17,1,56,39
1657752755825,CSE 11,A01,083080,Cao; Yingjun,6,15,40,34
1657752761863,CSE 12,A01,083652,Krause-Levy; Sophia Louisa,28,1,120,92
1657752767889,CSE 15L,A01,083654,Morris; Justin Loren,9,0,50,41
1657752767889,CSE 15L,A02,083655,Morris; Justin Loren,9,0,50,41
1657752773931,CSE 20,A01,083657,Tran; Khoa Dang,39,0,80,41
1657752779956,CSE 21,A01,095574,Bach; Quang Tran,22,0,48,26
1657752785991,CSE 30,A01,083084,Eldon; John,6,0,80,74
1657752785991,CSE 30,B01,095061,Bhaskar; Nishant,9,0,50,41
1657752792014,CSE 100,A01,083659,Cao; Yingjun,5,4,70,65
1657752798036,CSE 134B,A01,083661,Powell; Thomas Allan,24,0,100,76
1657752804060,CSE 140,A01,083663,Gungor; Onat,15,0,85,70
1657752810083,CSE 140L,A01,083088,Eldon; John,23,0,100,77
1657752816121,CSE 175,A01,083665,Kumar; Rakesh,3,0,25,22
1657752822151,CSE 190,A00,092507,Dubnov; Shlomo,8,0,20,12
1657752828183,ECE 45,A01,083139,Congero; Spencer William,6,0,75,69
1657752834210,ECE 65,A50,083695,Saad; Andrew S,12,0,30,18
1657752834210,ECE 65,A51,095125,Saad; Andrew S,24,0,26,2
1657752840232,ECE 109,A01,091882,Touri; Behrouz,20,0,70,50
1657752846278,ECE 180,A00,083140,Abi Samra; Nicholas Camill,1,0,30,29
1657752846278,ECE 180,B00,083141,Abi Samra; Nicholas Camill,0,0,30,30
1657752852303,MATH 10A,A01,083735,Patchell; Gregory David,2,0,30,28
1657752852303,MATH 10A,A02,083736,Patchell; Gregory David,20,0,30,10
1657752852303,MATH 10A,A03,083737,Patchell; Gregory David,16,0,30,14
1657752858335,MATH 10B,A01,083207,Lim; Seonhee,8,0,34,26
1657752858335,MATH 10B,A02,083208,Lim; Seonhee,9,0,35,26
1657752858335,MATH 10B,A03,093472,Lim; Seonhee,7,0,34,27
1657752858335,MATH 10B,B01,083739,Sinha; Shubham,13,0,30,17
1657752864366,MATH 18,A01,083743,Cinel; Cameron Alexander,9,0,30,21
1657752864366,MATH 18,A02,083744,Cinel; Cameron Alexander,18,0,30,12
1657752864366,MATH 18,A03,083745,Cinel; Cameron Alexander,10,0,30,20
1657752864366,MATH 18,B01,083748,Rideout; David Porter,5,0,37,32
1657752864366,MATH 18,B02,083749,Rideout; David Porter,5,0,36,31
1657752864366,MATH 18,B03,083750,Rideout; David Porter,3,0,37,34
1657752864366,MATH 18,B04,083751,Rideout; David Porter,6,0,36,30
1657752864366,MATH 18,B05,093473,Rideout; David Porter,6,0,36,30
1657752864366,MATH 18,B06,093474,Rideout; David Porter,6,0,36,30
1657752870394,MATH 20A,A01,083754,Zheng; Zequn,14,0,40,26
1657752876421,MATH 20B,A01,083756,Briones; Jor-el Thomas Caparas,4,0,36,32
1657752876421,MATH 20B,A02,083757,Briones; Jor-el Thomas Caparas,1,0,36,35
1657752876421,MATH 20B,A03,093475,Briones; Jor-el Thomas Caparas,2,0,36,34
1657752882452,MATH 20C,A01,083760,Briones; Jor-el Thomas Caparas,1,0,35,34
1657752882452,MATH 20C,A02,083761,Briones; Jor-el Thomas Caparas,8,0,35,27
1657752882452,MATH 20C,A03,093476,Briones; Jor-el Thomas Caparas,0,1,36,36
1657752882452,MATH 20C,B01,083762,Bach; Quang Tran,1,0,30,29
1657752888483,MATH 20D,A01,083765,Tran; Brian Kha,5,0,30,25
1657752888483,MATH 20D,A02,083766,Tran; Brian Kha,5,0,30,25
1657752888483,MATH 20D,A03,083767,Tran; Brian Kha,5,0,30,25
1657752894506,MATH 20E,A01,083771,Ganguly; Soumya,9,0,32,23
1657752894506,MATH 20E,A02,083772,Ganguly; Soumya,6,0,32,26
1657752894506,MATH 20E,B01,083773,Ciotti; Benjamin,20,0,35,15
1657752894506,MATH 20E,B02,083774,Ciotti; Benjamin,18,0,35,17
1657752900540,MATH 103A,A01,083777,Greenfeld; Be'Eri,3,0,36,33
1657752900540,MATH 103A,A02,083778,Greenfeld; Be'Eri,5,0,36,31
1657752900540,MATH 103A,A03,093561,Greenfeld; Be'Eri,6,0,36,30
1657752900540,MATH 103A,B01,083779,Greenfeld; Be'Eri,7,0,36,29
1657752900540,MATH 103A,B02,083780,Greenfeld; Be'Eri,4,0,36,32
1657752900540,MATH 103A,B03,093562,Greenfeld; Be'Eri,3,0,36,33
1657752906564,MATH 105,A01,085443,Carter; Anne Toulson,15,0,35,20
1657752906564,MATH 105,A02,093477,Carter; Anne Toulson,20,0,35,15
1657752912601,MATH 109,A01,083213,Ganzberger; Geoffrey Michael,3,0,34,31
1657752912601,MATH 109,A02,083214,Ganzberger; Geoffrey Michael,4,0,34,30
1657752912601,MATH 109,A03,093478,Ganzberger; Geoffrey Michael,2,0,34,32
1657752912601,MATH 109,B01,083215,Ganzberger; Geoffrey Michael,1,0,32,31
1657752912601,MATH 109,B02,083216,Ganzberger; Geoffrey Michael,2,0,32,30
1657752912601,MATH 109,B03,093479,Ganzberger; Geoffrey Michael,8,0,32,24
1657752918628,MATH 142A,A01,083219,Chow; Bennett,7,0,32,25
1657752918628,MATH 142A,A02,083220,Chow; Bennett,10,0,32,22
1657752918628,MATH 142A,A03,093480,Chow; Bennett,9,0,32,23
1657752918628,MATH 142A,B03,093481,Chow; Bennett,8,0,32,24
1657752918628,MATH 142A,B04,093558,Chow; Bennett,13,0,32,19
1657752918628,MATH 142A,B05,093559,Chow; Bennett,6,0,32,26
1657752924669,MATH 193A,A01,083224,Rotar; Vladimir,8,0,34,26
1657752924669,MATH 193A,A02,083225,Rotar; Vladimir,9,0,34,25
1657752924669,MATH 193A,A03,083781,Rotar; Vladimir,5,0,34,29
1657752924669,MATH 193A,A04,083782,Rotar; Vladimir,10,0,34,24
1657752924669,MATH 193A,A05,093482,Rotar; Vladimir,10,0,34,24
1657752930692,MATH 197,001,091859,McAuley; Julian John,9999,0,9999,0
1657752930692,MATH 197,002,095566,Kedlaya; Kiran S.,9997,0,9999,2
1657752930692,MATH 197,003,095567,Xiao; Ming,9999,0,9999,0
1657752930692,MATH 197,004,095571,Perols; Johan Lars,9998,0,9999,1
1657752937748,COGS 9,A01,083615,Shannon; Kyle Michael,9,0,75,66
1657752943773,COGS 11,A01,083617,Boyle; Mary E. T.,23,0,48,25
1657752949796,COGS 13,A01,083071,Bastos; Amalia Pinkusfeld,11,0,71,60
1657752955821,COGS 14A,A01,092681,Semenuks; Arturs,5,1,100,95
1657752961844,COGS 14B,A01,083073,Cheng; Tzu-Han,6,0,63,57
1657752967872,COGS 17,A01,092677,Semenuks; Arturs,6,0,81,75
1657752973904,COGS 100,A01,083619,Allen; Michael Gordon,17,0,70,53
1657752979935,COGS 101A,A01,083621,Davis; Joshua Daniel,9,0,68,59
1657752985962,COGS 101B,A01,091572,Allen; Michael Gordon,12,0,65,53
1657752991985,COGS 101C,A01,083625,Delgado; Tania,17,0,35,18
1657752998017,COGS 107A,A01,083627,Boyle; Mary E. T.,13,0,60,47
1657753004042,COGS 118A,A01,083075,Gupta; Anjum,21,0,76,55
1657753010066,CSE 3,A50,083646,Miranda; Gregory Joseph,24,0,50,26
1657753016091,CSE 8A,A50,083650,Miranda; Gregory Joseph,17,1,56,39
1657753022131,CSE 11,A01,083080,Cao; Yingjun,6,15,40,34
1657753028154,CSE 12,A01,083652,Krause-Levy; Sophia Louisa,28,1,120,92
1657753034177,CSE 15L,A01,083654,Morris; Justin Loren,9,0,50,41
1657753034177,CSE 15L,A02,083655,Morris; Justin Loren,9,0,50,41
1657753040211,CSE 20,A01,083657,Tran; Khoa Dang,39,0,80,41
1657753046232,CSE 21,A01,095574,Bach; Quang Tran,22,0,48,26
1657753052255,CSE 30,A01,083084,Eldon; John,6,0,80,74
1657753052255,CSE 30,B01,095061,Bhaskar; Nishant,9,0,50,41
1657753058279,CSE 100,A01,083659,Cao; Yingjun,5,4,70,65
1657753064305,CSE 134B,A01,083661,Powell; Thomas Allan,24,0,100,76
1657753070331,CSE 140,A01,083663,Gungor; Onat,15,0,85,70
1657753076355,CSE 140L,A01,083088,Eldon; John,23,0,100,77
1657753082378,CSE 175,A01,083665,Kumar; Rakesh,3,0,25,22
1657753088416,CSE 190,A00,092507,Dubnov; Shlomo,8,0,20,12
1657753094439,ECE 45,A01,083139,Congero; Spencer William,6,0,75,69
1657753100466,ECE 65,A50,083695,Saad; Andrew S,12,0,30,18
1657753100466,ECE 65,A51,095125,Saad; Andrew S,24,0,26,2
1657753106493,ECE 109,A01,091882,Touri; Behrouz,20,0,70,50
1657753112523,ECE 180,A00,083140,Abi Samra; Nicholas Camill,1,0,30,29
1657753112523,ECE 180,B00,083141,Abi Samra; Nicholas Camill,0,0,30,30
1657753118561,MATH 10A,A01,083735,Patchell; Gregory David,2,0,30,28
1657753118561,MATH 10A,A02,083736,Patchell; Gregory David,20,0,30,10
1657753118561,MATH 10A,A03,083737,Patchell; Gregory David,16,0,30,14
1657753124590,MATH 10B,A01,083207,Lim; Seonhee,8,0,34,26
1657753124590,MATH 10B,A02,083208,Lim; Seonhee,9,0,35,26
1657753124590,MATH 10B,A03,093472,Lim; Seonhee,7,0,34,27
1657753124590,MATH 10B,B01,083739,Sinha; Shubham,13,0,30,17
1657753130614,MATH 18,A01,083743,Cinel; Cameron Alexander,9,0,30,21
1657753130614,MATH 18,A02,083744,Cinel; Cameron Alexander,18,0,30,12
1657753130614,MATH 18,A03,083745,Cinel; Cameron Alexander,10,0,30,20
1657753130614,MATH 18,B01,083748,Rideout; David Porter,5,0,37,32
1657753130614,MATH 18,B02,083749,Rideout; David Porter,5,0,36,31
1657753130614,MATH 18,B03,083750,Rideout; David Porter,3,0,37,34
1657753130614,MATH 18,B04,083751,Rideout; David Porter,6,0,36,30
1657753130614,MATH 18,B05,093473,Rideout; David Porter,6,0,36,30
1657753130614,MATH 18,B06,093474,Rideout; David Porter,6,0,36,30
1657753136637,MATH 20A,A01,083754,Zheng; Zequn,14,0,40,26
1657753142669,MATH 20B,A01,083756,Briones; Jor-el Thomas Caparas,4,0,36,32
1657753142669,MATH 20B,A02,083757,Briones; Jor-el Thomas Caparas,1,0,36,35
1657753142669,MATH 20B,A03,093475,Briones; Jor-el Thomas Caparas,2,0,36,34
1657753148693,MATH 20C,A01,083760,Briones; Jor-el Thomas Caparas,1,0,35,34
1657753148693,MATH 20C,A02,083761,Briones; Jor-el Thomas Caparas,8,0,35,27
1657753148693,MATH 20C,A03,093476,Briones; Jor-el Thomas Caparas,0,1,36,36
1657753148693,MATH 20C,B01,083762,Bach; Quang Tran,1,0,30,29
1657753154718,MATH 20D,A01,083765,Tran; Brian Kha,5,0,30,25
1657753154718,MATH 20D,A02,083766,Tran; Brian Kha,5,0,30,25
1657753154718,MATH 20D,A03,083767,Tran; Brian Kha,5,0,30,25
1657753160741,MATH 20E,A01,083771,Ganguly; Soumya,9,0,32,23
1657753160741,MATH 20E,A02,083772,Ganguly; Soumya,6,0,32,26
1657753160741,MATH 20E,B01,083773,Ciotti; Benjamin,20,0,35,15
1657753160741,MATH 20E,B02,083774,Ciotti; Benjamin,18,0,35,17
1657753166781,MATH 103A,A01,083777,Greenfeld; Be'Eri,3,0,36,33
1657753166781,MATH 103A,A02,083778,Greenfeld; Be'Eri,5,0,36,31
1657753166781,MATH 103A,A03,093561,Greenfeld; Be'Eri,6,0,36,30
1657753166781,MATH 103A,B01,083779,Greenfeld; Be'Eri,7,0,36,29
1657753166781,MATH 103A,B02,083780,Greenfeld; Be'Eri,4,0,36,32
1657753166781,MATH 103A,B03,093562,Greenfeld; Be'Eri,3,0,36,33
1657753172816,MATH 105,A01,085443,Carter; Anne Toulson,15,0,35,20
1657753172816,MATH 105,A02,093477,Carter; Anne Toulson,20,0,35,15
1657753178841,MATH 109,A01,083213,Ganzberger; Geoffrey Michael,3,0,34,31
1657753178841,MATH 109,A02,083214,Ganzberger; Geoffrey Michael,4,0,34,30
1657753178841,MATH 109,A03,093478,Ganzberger; Geoffrey Michael,2,0,34,32
1657753178841,MATH 109,B01,083215,Ganzberger; Geoffrey Michael,1,0,32,31
1657753178841,MATH 109,B02,083216,Ganzberger; Geoffrey Michael,2,0,32,30
1657753178841,MATH 109,B03,093479,Ganzberger; Geoffrey Michael,8,0,32,24
1657753184867,MATH 142A,A01,083219,Chow; Bennett,7,0,32,25
1657753184867,MATH 142A,A02,083220,Chow; Bennett,10,0,32,22
1657753184867,MATH 142A,A03,093480,Chow; Bennett,9,0,32,23
1657753184867,MATH 142A,B03,093481,Chow; Bennett,8,0,32,24
1657753184867,MATH 142A,B04,093558,Chow; Bennett,13,0,32,19
1657753184867,MATH 142A,B05,093559,Chow; Bennett,6,0,32,26
1657753190894,MATH 193A,A01,083224,Rotar; Vladimir,8,0,34,26
1657753190894,MATH 193A,A02,083225,Rotar; Vladimir,9,0,34,25
1657753190894,MATH 193A,A03,083781,Rotar; Vladimir,5,0,34,29
1657753190894,MATH 193A,A04,083782,Rotar; Vladimir,10,0,34,24
1657753190894,MATH 193A,A05,093482,Rotar; Vladimir,10,0,34,24
1657753196920,MATH 197,001,091859,McAuley; Julian John,9999,0,9999,0
1657753196920,MATH 197,002,095566,Kedlaya; Kiran S.,9997,0,9999,2
1657753196920,MATH 197,003,095567,Xiao; Ming,9999,0,9999,0
1657753196920,MATH 197,004,095571,Perols; Johan Lars,9998,0,9999,1
1657753203979,COGS 9,A01,083615,Shannon; Kyle Michael,9,0,75,66
1657753210009,COGS 11,A01,083617,Boyle; Mary E. T.,23,0,48,25
1657753216031,COGS 13,A01,083071,Bastos; Amalia Pinkusfeld,11,0,71,60
1657753222057,COGS 14A,A01,092681,Semenuks; Arturs,5,1,100,95
1657753228084,COGS 14B,A01,083073,Cheng; Tzu-Han,6,0,63,57
1657753234111,COGS 17,A01,092677,Semenuks; Arturs,6,0,81,75
1657753240137,COGS 100,A01,083619,Allen; Michael Gordon,17,0,70,53
1657753246159,COGS 101A,A01,083621,Davis; Joshua Daniel,9,0,68,59
1657753252183,COGS 101B,A01,091572,Allen; Michael Gordon,12,0,65,53
1657753258209,COGS 101C,A01,083625,Delgado; Tania,17,0,35,18
1657753264235,COGS 107A,A01,083627,Boyle; Mary E. T.,13,0,60,47
1657753270257,COGS 118A,A01,083075,Gupta; Anjum,21,0,76,55
1657753276377,CSE 3,A50,083646,Miranda; Gregory Joseph,24,0,50,26
1657753282401,CSE 8A,A50,083650,Miranda; Gregory Joseph,17,1,56,39
1657753288425,CSE 11,A01,083080,Cao; Yingjun,6,15,40,34
1657753294448,CSE 12,A01,083652,Krause-Levy; Sophia Louisa,28,1,120,92
1657753300475,CSE 15L,A01,083654,Morris; Justin Loren,9,0,50,41
1657753300475,CSE 15L,A02,083655,Morris; Justin Loren,9,0,50,41
1657753306501,CSE 20,A01,083657,Tran; Khoa Dang,39,0,80,41
1657753312536,CSE 21,A01,095574,Bach; Quang Tran,22,0,48,26
1657753318563,CSE 30,A01,083084,Eldon; John,6,0,80,74
1657753318563,CSE 30,B01,095061,Bhaskar; Nishant,9,0,50,41
1657753324587,CSE 100,A01,083659,Cao; Yingjun,5,4,70,65
1657753330613,CSE 134B,A01,083661,Powell; Thomas Allan,24,0,100,76
1657753336635,CSE 140,A01,083663,Gungor; Onat,15,0,85,70
1657753342662,CSE 140L,A01,083088,Eldon; John,23,0,100,77
1657753348685,CSE 175,A01,083665,Kumar; Rakesh,3,0,25,22
1657753354710,CSE 190,A00,092507,Dubnov; Shlomo,8,0,20,12
1657753360732,ECE 45,A01,083139,Congero; Spencer William,6,0,75,69
1657753366768,ECE 65,A50,083695,Saad; Andrew S,12,0,30,18
1657753366768,ECE 65,A51,095125,Saad; Andrew S,24,0,26,2
1657753372803,ECE 109,A01,091882,Touri; Behrouz,20,0,70,50
1657753378833,ECE 180,A00,083140,Abi Samra; Nicholas Camill,1,0,30,29
1657753378833,ECE 180,B00,083141,Abi Samra; Nicholas Camill,0,0,30,30
1657753384868,MATH 10A,A01,083735,Patchell; Gregory David,2,0,30,28
1657753384868,MATH 10A,A02,083736,Patchell; Gregory David,20,0,30,10
1657753384868,MATH 10A,A03,083737,Patchell; Gregory David,16,0,30,14
1657753390893,MATH 10B,A01,083207,Lim; Seonhee,8,0,34,26
1657753390893,MATH 10B,A02,083208,Lim; Seonhee,9,0,35,26
1657753390893,MATH 10B,A03,093472,Lim; Seonhee,7,0,34,27
1657753390893,MATH 10B,B01,083739,Sinha; Shubham,13,0,30,17
1657753396918,MATH 18,A01,083743,Cinel; Cameron Alexander,9,0,30,21
1657753396918,MATH 18,A02,083744,Cinel; Cameron Alexander,18,0,30,12
1657753396918,MATH 18,A03,083745,Cinel; Cameron Alexander,10,0,30,20
1657753396918,MATH 18,B01,083748,Rideout; David Porter,5,0,37,32
1657753396918,MATH 18,B02,083749,Rideout; David Porter,5,0,36,31
1657753396918,MATH 18,B03,083750,Rideout; David Porter,3,0,37,34
1657753396918,MATH 18,B04,083751,Rideout; David Porter,6,0,36,30
1657753396918,MATH 18,B05,093473,Rideout; David Porter,6,0,36,30
1657753396918,MATH 18,B06,093474,Rideout; David Porter,6,0,36,30
1657753402945,MATH 20A,A01,083754,Zheng; Zequn,14,0,40,26
1657753408971,MATH 20B,A01,083756,Briones; Jor-el Thomas Caparas,4,0,36,32
1657753408971,MATH 20B,A02,083757,Briones; Jor-el Thomas Caparas,1,0,36,35
1657753408971,MATH 20B,A03,093475,Briones; Jor-el Thomas Caparas,2,0,36,34
1657753414998,MATH 20C,A01,083760,Briones; Jor-el Thomas Caparas,1,0,35,34
1657753414998,MATH 20C,A02,083761,Briones; Jor-el Thomas Caparas,8,0,35,27
1657753414998,MATH 20C,A03,093476,Briones; Jor-el Thomas Caparas,0,1,36,36
1657753414998,MATH 20C,B01,083762,Bach; Quang Tran,1,0,30,29
1657753421025,MATH 20D,A01,083765,Tran; Brian Kha,5,0,30,25
1657753421025,MATH 20D,A02,083766,Tran; Brian Kha,5,0,30,25
1657753421025,MATH 20D,A03,083767,Tran; Brian Kha,5,0,30,25
1657753427049,MATH 20E,A01,083771,Ganguly; Soumya,9,0,32,23
1657753427049,MATH 20E,A02,083772,Ganguly; Soumya,6,0,32,26
1657753427049,MATH 20E,B01,083773,Ciotti; Benjamin,20,0,35,15
1657753427049,MATH 20E,B02,083774,Ciotti; Benjamin,18,0,35,17
1657753433080,MATH 103A,A01,083777,Greenfeld; Be'Eri,3,0,36,33
1657753433080,MATH 103A,A02,083778,Greenfeld; Be'Eri,5,0,36,31
1657753433080,MATH 103A,A03,093561,Greenfeld; Be'Eri,6,0,36,30
1657753433080,MATH 103A,B01,083779,Greenfeld; Be'Eri,7,0,36,29
1657753433080,MATH 103A,B02,083780,Greenfeld; Be'Eri,4,0,36,32
1657753433080,MATH 103A,B03,093562,Greenfeld; Be'Eri,3,0,36,33
1657753439106,MATH 105,A01,085443,Carter; Anne Toulson,15,0,35,20
1657753439106,MATH 105,A02,093477,Carter; Anne Toulson,20,0,35,15
1657753445135,MATH 109,A01,083213,Ganzberger; Geoffrey Michael,3,0,34,31
1657753445135,MATH 109,A02,083214,Ganzberger; Geoffrey Michael,4,0,34,30
1657753445135,MATH 109,A03,093478,Ganzberger; Geoffrey Michael,2,0,34,32
1657753445135,MATH 109,B01,083215,Ganzberger; Geoffrey Michael,1,0,32,31
1657753445135,MATH 109,B02,083216,Ganzberger; Geoffrey Michael,2,0,32,30
1657753445135,MATH 109,B03,093479,Ganzberger; Geoffrey Michael,8,0,32,24
1657753451158,MATH 142A,A01,083219,Chow; Bennett,7,0,32,25
1657753451158,MATH 142A,A02,083220,Chow; Bennett,10,0,32,22
1657753451158,MATH 142A,A03,093480,Chow; Bennett,9,0,32,23
1657753451158,MATH 142A,B03,093481,Chow; Bennett,8,0,32,24
1657753451158,MATH 142A,B04,093558,Chow; Bennett,13,0,32,19
1657753451158,MATH 142A,B05,093559,Chow; Bennett,6,0,32,26
1657753457183,MATH 193A,A01,083224,Rotar; Vladimir,8,0,34,26
1657753457183,MATH 193A,A02,083225,Rotar; Vladimir,9,0,34,25
1657753457183,MATH 193A,A03,083781,Rotar; Vladimir,5,0,34,29
1657753457183,MATH 193A,A04,083782,Rotar; Vladimir,10,0,34,24
1657753457183,MATH 193A,A05,093482,Rotar; Vladimir,10,0,34,24
1657753463206,MATH 197,001,091859,McAuley; Julian John,9999,0,9999,0
1657753463206,MATH 197,002,095566,Kedlaya; Kiran S.,9997,0,9999,2
1657753463206,MATH 197,003,095567,Xiao; Ming,9999,0,9999,0
1657753463206,MATH 197,004,095571,Perols; Johan Lars,9998,0,9999,1
1657753470266,COGS 9,A01,083615,Shannon; Kyle Michael,9,0,75,66
1657753476291,COGS 11,A01,083617,Boyle; Mary E. T.,23,0,48,25
1657753482313,COGS 13,A01,083071,Bastos; Amalia Pinkusfeld,11,0,71,60
1657753488337,COGS 14A,A01,092681,Semenuks; Arturs,5,1,100,95
1657753494360,COGS 14B,A01,083073,Cheng; Tzu-Han,6,0,63,57
1657753500390,COGS 17,A01,092677,Semenuks; Arturs,6,0,81,75
1657753506412,COGS 100,A01,083619,Allen; Michael Gordon,17,0,70,53
1657753512436,COGS 101A,A01,083621,Davis; Joshua Daniel,9,0,68,59
1657753518461,COGS 101B,A01,091572,Allen; Michael Gordon,12,0,65,53
1657753524487,COGS 101C,A01,083625,Delgado; Tania,17,0,35,18
1657753530512,COGS 107A,A01,083627,Boyle; Mary E. T.,13,0,60,47
1657753536537,COGS 118A,A01,083075,Gupta; Anjum,21,0,76,55
1657753542571,CSE 3,A50,083646,Miranda; Gregory Joseph,24,0,50,26
1657753548593,CSE 8A,A50,083650,Miranda; Gregory Joseph,17,1,56,39
1657753554620,CSE 11,A01,083080,Cao; Yingjun,6,15,40,34
1657753560652,CSE 12,A01,083652,Krause-Levy; Sophia Louisa,28,1,120,92
1657753566679,CSE 15L,A01,083654,Morris; Justin Loren,9,0,50,41
1657753566679,CSE 15L,A02,083655,Morris; Justin Loren,9,0,50,41
1657753572702,CSE 20,A01,083657,Tran; Khoa Dang,39,0,80,41
1657753578727,CSE 21,A01,095574,Bach; Quang Tran,22,0,48,26
1657753584755,CSE 30,A01,083084,Eldon; John,6,0,80,74
1657753584755,CSE 30,B01,095061,Bhaskar; Nishant,9,0,50,41
1657753590781,CSE 100,A01,083659,Cao; Yingjun,5,4,70,65
1657753596808,CSE 134B,A01,083661,Powell; Thomas Allan,24,0,100,76
1657753602832,CSE 140,A01,083663,Gungor; Onat,15,0,85,70
1657753608863,CSE 140L,A01,083088,Eldon; John,23,0,100,77
1657753614891,CSE 175,A01,083665,Kumar; Rakesh,3,0,25,22
1657753620917,CSE 190,A00,092507,Dubnov; Shlomo,8,0,20,12
1657753626944,ECE 45,A01,083139,Congero; Spencer William,6,0,75,69
1657753632970,ECE 65,A50,083695,Saad; Andrew S,12,0,30,18
1657753632970,ECE 65,A51,095125,Saad; Andrew S,24,0,26,2
1657753638992,ECE 109,A01,091882,Touri; Behrouz,20,0,70,50
1657753645017,ECE 180,A00,083140,Abi Samra; Nicholas Camill,1,0,30,29
1657753645017,ECE 180,B00,083141,Abi Samra; Nicholas Camill,0,0,30,30
1657753651041,MATH 10A,A01,083735,Patchell; Gregory David,2,0,30,28
1657753651041,MATH 10A,A02,083736,Patchell; Gregory David,20,0,30,10
1657753651041,MATH 10A,A03,083737,Patchell; Gregory David,16,0,30,14
1657753657066,MATH 10B,A01,083207,Lim; Seonhee,8,0,34,26
1657753657066,MATH 10B,A02,083208,Lim; Seonhee,9,0,35,26
1657753657066,MATH 10B,A03,093472,Lim; Seonhee,7,0,34,27
1657753657066,MATH 10B,B01,083739,Sinha; Shubham,13,0,30,17
1657753663092,MATH 18,A01,083743,Cinel; Cameron Alexander,9,0,30,21
1657753663092,MATH 18,A02,083744,Cinel; Cameron Alexander,18,0,30,12
1657753663092,MATH 18,A03,083745,Cinel; Cameron Alexander,10,0,30,20
1657753663092,MATH 18,B01,083748,Rideout; David Porter,5,0,37,32
1657753663092,MATH 18,B02,083749,Rideout; David Porter,5,0,36,31
1657753663092,MATH 18,B03,083750,Rideout; David Porter,3,0,37,34
1657753663092,MATH 18,B04,083751,Rideout; David Porter,6,0,36,30
1657753663092,MATH 18,B05,093473,Rideout; David Porter,6,0,36,30
1657753663092,MATH 18,B06,093474,Rideout; David Porter,6,0,36,30
1657753669115,MATH 20A,A01,083754,Zheng; Zequn,14,0,40,26
1657753675141,MATH 20B,A01,083756,Briones; Jor-el Thomas Caparas,4,0,36,32
1657753675141,MATH 20B,A02,083757,Briones; Jor-el Thomas Caparas,1,0,36,35
1657753675141,MATH 20B,A03,093475,Briones; Jor-el Thomas Caparas,2,0,36,34
1657753681169,MATH 20C,A01,083760,Briones; Jor-el Thomas Caparas,1,0,35,34
1657753681169,MATH 20C,A02,083761,Briones; Jor-el Thomas Caparas,8,0,35,27
1657753681169,MATH 20C,A03,093476,Briones; Jor-el Thomas Caparas,0,1,36,36
1657753681169,MATH 20C,B01,083762,Bach; Quang Tran,1,0,30,29
1657753687198,MATH 20D,A01,083765,Tran; Brian Kha,5,0,30,25
1657753687198,MATH 20D,A02,083766,Tran; Brian Kha,5,0,30,25
1657753687198,MATH 20D,A03,083767,Tran; Brian Kha,5,0,30,25
1657753693229,MATH 20E,A01,083771,Ganguly; Soumya,9,0,32,23
1657753693229,MATH 20E,A02,083772,Ganguly; Soumya,6,0,32,26
1657753693229,MATH 20E,B01,083773,Ciotti; Benjamin,20,0,35,15
1657753693229,MATH 20E,B02,083774,Ciotti; Benjamin,18,0,35,17
1657753699257,MATH 103A,A01,083777,Greenfeld; Be'Eri,3,0,36,33
1657753699257,MATH 103A,A02,083778,Greenfeld; Be'Eri,5,0,36,31
1657753699257,MATH 103A,A03,093561,Greenfeld; Be'Eri,6,0,36,30
1657753699257,MATH 103A,B01,083779,Greenfeld; Be'Eri,7,0,36,29
1657753699257,MATH 103A,B02,083780,Greenfeld; Be'Eri,4,0,36,32
1657753699257,MATH 103A,B03,093562,Greenfeld; Be'Eri,3,0,36,33
1657753705280,MATH 105,A01,085443,Carter; Anne Toulson,15,0,35,20
1657753705280,MATH 105,A02,093477,Carter; Anne Toulson,20,0,35,15
1657753711311,MATH 109,A01,083213,Ganzberger; Geoffrey Michael,3,0,34,31
1657753711311,MATH 109,A02,083214,Ganzberger; Geoffrey Michael,4,0,34,30
1657753711311,MATH 109,A03,093478,Ganzberger; Geoffrey Michael,2,0,34,32
1657753711311,MATH 109,B01,083215,Ganzberger; Geoffrey Michael,1,0,32,31
1657753711311,MATH 109,B02,083216,Ganzberger; Geoffrey Michael,2,0,32,30
1657753711311,MATH 109,B03,093479,Ganzberger; Geoffrey Michael,8,0,32,24
1657753717340,MATH 142A,A01,083219,Chow; Bennett,7,0,32,25
1657753717340,MATH 142A,A02,083220,Chow; Bennett,10,0,32,22
1657753717340,MATH 142A,A03,093480,Chow; Bennett,9,0,32,23
1657753717340,MATH 142A,B03,093481,Chow; Bennett,8,0,32,24
1657753717340,MATH 142A,B04,093558,Chow; Bennett,13,0,32,19
1657753717340,MATH 142A,B05,093559,Chow; Bennett,6,0,32,26
1657753723363,MATH 193A,A01,083224,Rotar; Vladimir,8,0,34,26
1657753723363,MATH 193A,A02,083225,Rotar; Vladimir,9,0,34,25
1657753723363,MATH 193A,A03,083781,Rotar; Vladimir,5,0,34,29
1657753723363,MATH 193A,A04,083782,Rotar; Vladimir,10,0,34,24
1657753723363,MATH 193A,A05,093482,Rotar; Vladimir,10,0,34,24
1657753729389,MATH 197,001,091859,McAuley; Julian John,9999,0,9999,0
1657753729389,MATH 197,002,095566,Kedlaya; Kiran S.,9997,0,9999,2
1657753729389,MATH 197,003,095567,Xiao; Ming,9999,0,9999,0
1657753729389,MATH 197,004,095571,Perols; Johan Lars,9998,0,9999,1
1657753736450,COGS 9,A01,083615,Shannon; Kyle Michael,9,0,75,66
1657753742473,COGS 11,A01,083617,Boyle; Mary E. T.,23,0,48,25
1657753748496,COGS 13,A01,083071,Bastos; Amalia Pinkusfeld,11,0,71,60
1657753754526,COGS 14A,A01,092681,Semenuks; Arturs,5,1,100,95
1657753760553,COGS 14B,A01,083073,Cheng; Tzu-Han,6,0,63,57
1657753766578,COGS 17,A01,092677,Semenuks; Arturs,6,0,81,75
1657753772600,COGS 100,A01,083619,Allen; Michael Gordon,17,0,70,53
1657753778636,COGS 101A,A01,083621,Davis; Joshua Daniel,9,0,68,59
1657753784659,COGS 101B,A01,091572,Allen; Michael Gordon,12,0,65,53
1657753790681,COGS 101C,A01,083625,Delgado; Tania,17,0,35,18
1657753796705,COGS 107A,A01,083627,Boyle; Mary E. T.,13,0,60,47
1657753802734,COGS 118A,A01,083075,Gupta; Anjum,21,0,76,55
1657753808760,CSE 3,A50,083646,Miranda; Gregory Joseph,24,0,50,26
1657753814782,CSE 8A,A50,083650,Miranda; Gregory Joseph,17,1,56,39
1657753820805,CSE 11,A01,083080,Cao; Yingjun,6,15,40,34
1657753826829,CSE 12,A01,083652,Krause-Levy; Sophia Louisa,28,1,120,92
1657753832850,CSE 15L,A01,083654,Morris; Justin Loren,9,0,50,41
1657753832850,CSE 15L,A02,083655,Morris; Justin Loren,9,0,50,41
1657753838874,CSE 20,A01,083657,Tran; Khoa Dang,39,0,80,41
1657753844901,CSE 21,A01,095574,Bach; Quang Tran,22,0,48,26
1657753850924,CSE 30,A01,083084,Eldon; John,6,0,80,74
1657753850924,CSE 30,B01,095061,Bhaskar; Nishant,9,0,50,41
1657753856948,CSE 100,A01,083659,Cao; Yingjun,5,4,70,65
1657753862974,CSE 134B,A01,083661,Powell; Thomas Allan,24,0,100,76
1657753869000,CSE 140,A01,083663,Gungor; Onat,15,0,85,70
1657753875118,CSE 140L,A01,083088,Eldon; John,23,0,100,77
1657753881140,CSE 175,A01,083665,Kumar; Rakesh,3,0,25,22
1657753887162,CSE 190,A00,092507,Dubnov; Shlomo,8,0,20,12
1657753893194,ECE 45,A01,083139,Congero; Spencer William,6,0,75,69
1657753899221,ECE 65,A50,083695,Saad; Andrew S,12,0,30,18
1657753899221,ECE 65,A51,095125,Saad; Andrew S,24,0,26,2
1657753905248,ECE 109,A01,091882,Touri; Behrouz,20,0,70,50
1657753911279,ECE 180,A00,083140,Abi Samra; Nicholas Camill,1,0,30,29
1657753911279,ECE 180,B00,083141,Abi Samra; Nicholas Camill,0,0,30,30
1657753917308,MATH 10A,A01,083735,Patchell; Gregory David,2,0,30,28
1657753917308,MATH 10A,A02,083736,Patchell; Gregory David,20,0,30,10
1657753917308,MATH 10A,A03,083737,Patchell; Gregory David,16,0,30,14
1657753923338,MATH 10B,A01,083207,Lim; Seonhee,8,0,34,26
1657753923338,MATH 10B,A02,083208,Lim; Seonhee,9,0,35,26
1657753923338,MATH 10B,A03,093472,Lim; Seonhee,7,0,34,27
1657753923338,MATH 10B,B01,083739,Sinha; Shubham,13,0,30,17
1657753929366,MATH 18,A01,083743,Cinel; Cameron Alexander,9,0,30,21
1657753929366,MATH 18,A02,083744,Cinel; Cameron Alexander,18,0,30,12
1657753929366,MATH 18,A03,083745,Cinel; Cameron Alexander,10,0,30,20
1657753929366,MATH 18,B01,083748,Rideout; David Porter,5,0,37,32
1657753929366,MATH 18,B02,083749,Rideout; David Porter,5,0,36,31
1657753929366,MATH 18,B03,083750,Rideout; David Porter,3,0,37,34
1657753929366,MATH 18,B04,083751,Rideout; David Porter,6,0,36,30
1657753929366,MATH 18,B05,093473,Rideout; David Porter,6,0,36,30
1657753929366,MATH 18,B06,093474,Rideout; David Porter,6,0,36,30
1657753935388,MATH 20A,A01,083754,Zheng; Zequn,14,0,40,26
1657753941412,MATH 20B,A01,083756,Briones; Jor-el Thomas Caparas,4,0,36,32
1657753941412,MATH 20B,A02,083757,Briones; Jor-el Thomas Caparas,1,0,36,35
1657753941412,MATH 20B,A03,093475,Briones; Jor-el Thomas Caparas,2,0,36,34
1657753947447,MATH 20C,A01,083760,Briones; Jor-el Thomas Caparas,1,0,35,34
1657753947447,MATH 20C,A02,083761,Briones; Jor-el Thomas Caparas,8,0,35,27
1657753947447,MATH 20C,A03,093476,Briones; Jor-el Thomas Caparas,0,1,36,36
1657753947447,MATH 20C,B01,083762,Bach; Quang Tran,1,0,30,29
1657753953475,MATH 20D,A01,083765,Tran; Brian Kha,5,0,30,25
1657753953475,MATH 20D,A02,083766,Tran; Brian Kha,5,0,30,25
1657753953475,MATH 20D,A03,083767,Tran; Brian Kha,5,0,30,25
1657753959498,MATH 20E,A01,083771,Ganguly; Soumya,9,0,32,23
1657753959498,MATH 20E,A02,083772,Ganguly; Soumya,6,0,32,26
1657753959498,MATH 20E,B01,083773,Ciotti; Benjamin,20,0,35,15
1657753959498,MATH 20E,B02,083774,Ciotti; Benjamin,18,0,35,17
1657753965520,MATH 103A,A01,083777,Greenfeld; Be'Eri,3,0,36,33
1657753965520,MATH 103A,A02,083778,Greenfeld; Be'Eri,5,0,36,31
1657753965520,MATH 103A,A03,093561,Greenfeld; Be'Eri,6,0,36,30
1657753965520,MATH 103A,B01,083779,Greenfeld; Be'Eri,7,0,36,29
1657753965520,MATH 103A,B02,083780,Greenfeld; Be'Eri,4,0,36,32
1657753965520,MATH 103A,B03,093562,Greenfeld; Be'Eri,3,0,36,33
1657753971549,MATH 105,A01,085443,Carter; Anne Toulson,15,0,35,20
1657753971549,MATH 105,A02,093477,Carter; Anne Toulson,20,0,35,15
1657753977578,MATH 109,A01,083213,Ganzberger; Geoffrey Michael,3,0,34,31
1657753977578,MATH 109,A02,083214,Ganzberger; Geoffrey Michael,4,0,34,30
1657753977578,MATH 109,A03,093478,Ganzberger; Geoffrey Michael,2,0,34,32
1657753977578,MATH 109,B01,083215,Ganzberger; Geoffrey Michael,1,0,32,31
1657753977578,MATH 109,B02,083216,Ganzberger; Geoffrey Michael,2,0,32,30
1657753977578,MATH 109,B03,093479,Ganzberger; Geoffrey Michael,8,0,32,24
1657753983602,MATH 142A,A01,083219,Chow; Bennett,7,0,32,25
1657753983602,MATH 142A,A02,083220,Chow; Bennett,10,0,32,22
1657753983602,MATH 142A,A03,093480,Chow; Bennett,9,0,32,23
1657753983602,MATH 142A,B03,093481,Chow; Bennett,8,0,32,24
1657753983602,MATH 142A,B04,093558,Chow; Bennett,13,0,32,19
1657753983602,MATH 142A,B05,093559,Chow; Bennett,6,0,32,26
1657753989639,MATH 193A,A01,083224,Rotar; Vladimir,8,0,34,26
1657753989639,MATH 193A,A02,083225,Rotar; Vladimir,9,0,34,25
1657753989639,MATH 193A,A03,083781,Rotar; Vladimir,5,0,34,29
1657753989639,MATH 193A,A04,083782,Rotar; Vladimir,10,0,34,24
1657753989639,MATH 193A,A05,093482,Rotar; Vladimir,10,0,34,24
1657753995681,MATH 197,001,091859,McAuley; Julian John,9999,0,9999,0
1657753995681,MATH 197,002,095566,Kedlaya; Kiran S.,9997,0,9999,2
1657753995681,MATH 197,003,095567,Xiao; Ming,9999,0,9999,0
1657753995681,MATH 197,004,095571,Perols; Johan Lars,9998,0,9999,1
1657754002738,COGS 9,A01,083615,Shannon; Kyle Michael,9,0,75,66
1657754008761,COGS 11,A01,083617,Boyle; Mary E. T.,23,0,48,25
1657754014799,COGS 13,A01,083071,Bastos; Amalia Pinkusfeld,11,0,71,60
1657754020824,COGS 14A,A01,092681,Semenuks; Arturs,5,1,100,95
1657754026856,COGS 14B,A01,083073,Cheng; Tzu-Han,6,0,63,57
1657754032880,COGS 17,A01,092677,Semenuks; Arturs,6,0,81,75
1657754038912,COGS 100,A01,083619,Allen; Michael Gordon,17,0,70,53
1657754044936,COGS 101A,A01,083621,Davis; Joshua Daniel,9,0,68,59
1657754050959,COGS 101B,A01,091572,Allen; Michael Gordon,12,0,65,53
1657754056987,COGS 101C,A01,083625,Delgado; Tania,17,0,35,18
1657754063022,COGS 107A,A01,083627,Boyle; Mary E. T.,13,0,60,47
1657754069049,COGS 118A,A01,083075,Gupta; Anjum,21,0,76,55
1657754075077,CSE 3,A50,083646,Miranda; Gregory Joseph,24,0,50,26
1657754081103,CSE 8A,A50,083650,Miranda; Gregory Joseph,17,1,56,39
1657754087126,CSE 11,A01,083080,Cao; Yingjun,6,15,40,34
1657754093154,CSE 12,A01,083652,Krause-Levy; Sophia Louisa,28,1,120,92
1657754099180,CSE 15L,A01,083654,Morris; Justin Loren,9,0,50,41
1657754099180,CSE 15L,A02,083655,Morris; Justin Loren,9,0,50,41
1657754105213,CSE 20,A01,083657,Tran; Khoa Dang,39,0,80,41
1657754111236,CSE 21,A01,095574,Bach; Quang Tran,22,0,48,26
1657754117262,CSE 30,A01,083084,Eldon; John,6,0,80,74
1657754117262,CSE 30,B01,095061,Bhaskar; Nishant,9,0,50,41
1657754123284,CSE 100,A01,083659,Cao; Yingjun,5,4,70,65
1657754129307,CSE 134B,A01,083661,Powell; Thomas Allan,24,0,100,76
1657754135331,CSE 140,A01,083663,Gungor; Onat,15,0,85,70
1657754141358,CSE 140L,A01,083088,Eldon; John,23,0,100,77
1657754147389,CSE 175,A01,083665,Kumar; Rakesh,3,0,25,22
1657754153410,CSE 190,A00,092507,Dubnov; Shlomo,8,0,20,12
1657754159439,ECE 45,A01,083139,Congero; Spencer William,6,0,75,69
1657754165463,ECE 65,A50,083695,Saad; Andrew S,12,0,30,18
1657754165463,ECE 65,A51,095125,Saad; Andrew S,24,0,26,2
1657754171489,ECE 109,A01,091882,Touri; Behrouz,20,0,70,50
1657754177519,ECE 180,A00,083140,Abi Samra; Nicholas Camill,1,0,30,29
1657754177519,ECE 180,B00,083141,Abi Samra; Nicholas Camill,0,0,30,30
1657754183547,MATH 10A,A01,083735,Patchell; Gregory David,2,0,30,28
1657754183547,MATH 10A,A02,083736,Patchell; Gregory David,20,0,30,10
1657754183547,MATH 10A,A03,083737,Patchell; Gregory David,16,0,30,14
1657754189575,MATH 10B,A01,083207,Lim; Seonhee,8,0,34,26
1657754189575,MATH 10B,A02,083208,Lim; Seonhee,9,0,35,26
1657754189575,MATH 10B,A03,093472,Lim; Seonhee,7,0,34,27
1657754189575,MATH 10B,B01,083739,Sinha; Shubham,13,0,30,17
1657754195601,MATH 18,A01,083743,Cinel; Cameron Alexander,9,0,30,21
1657754195601,MATH 18,A02,083744,Cinel; Cameron Alexander,18,0,30,12
1657754195601,MATH 18,A03,083745,Cinel; Cameron Alexander,10,0,30,20
1657754195601,MATH 18,B01,083748,Rideout; David Porter,5,0,37,32
1657754195601,MATH 18,B02,083749,Rideout; David Porter,5,0,36,31
1657754195601,MATH 18,B03,083750,Rideout; David Porter,3,0,37,34
1657754195601,MATH 18,B04,083751,Rideout; David Porter,6,0,36,30
1657754195601,MATH 18,B05,093473,Rideout; David Porter,6,0,36,30
1657754195601,MATH 18,B06,093474,Rideout; David Porter,6,0,36,30
1657754201631,MATH 20A,A01,083754,Zheng; Zequn,14,0,40,26
1657754207667,MATH 20B,A01,083756,Briones; Jor-el Thomas Caparas,4,0,36,32
1657754207667,MATH 20B,A02,083757,Briones; Jor-el Thomas Caparas,1,0,36,35
1657754207667,MATH 20B,A03,093475,Briones; Jor-el Thomas Caparas,2,0,36,34
1657754213695,MATH 20C,A01,083760,Briones; Jor-el Thomas Caparas,1,0,35,34
1657754213695,MATH 20C,A02,083761,Briones; Jor-el Thomas Caparas,8,0,35,27
1657754213695,MATH 20C,A03,093476,Briones; Jor-el Thomas Caparas,0,1,36,36
1657754213695,MATH 20C,B01,083762,Bach; Quang Tran,1,0,30,29
1657754219732,MATH 20D,A01,083765,Tran; Brian Kha,5,0,30,25
1657754219732,MATH 20D,A02,083766,Tran; Brian Kha,5,0,30,25
1657754219732,MATH 20D,A03,083767,Tran; Brian Kha,5,0,30,25
1657754225764,MATH 20E,A01,083771,Ganguly; Soumya,9,0,32,23
1657754225764,MATH 20E,A02,083772,Ganguly; Soumya,6,0,32,26
1657754225764,MATH 20E,B01,083773,Ciotti; Benjamin,20,0,35,15
1657754225764,MATH 20E,B02,083774,Ciotti; Benjamin,18,0,35,17
1657754231793,MATH 103A,A01,083777,Greenfeld; Be'Eri,3,0,36,33
1657754231793,MATH 103A,A02,083778,Greenfeld; Be'Eri,5,0,36,31
1657754231793,MATH 103A,A03,093561,Greenfeld; Be'Eri,6,0,36,30
1657754231793,MATH 103A,B01,083779,Greenfeld; Be'Eri,7,0,36,29
1657754231793,MATH 103A,B02,083780,Greenfeld; Be'Eri,4,0,36,32
1657754231793,MATH 103A,B03,093562,Greenfeld; Be'Eri,3,0,36,33
1657754237820,MATH 105,A01,085443,Carter; Anne Toulson,15,0,35,20
1657754237820,MATH 105,A02,093477,Carter; Anne Toulson,20,0,35,15
1657754243849,MATH 109,A01,083213,Ganzberger; Geoffrey Michael,3,0,34,31
1657754243849,MATH 109,A02,083214,Ganzberger; Geoffrey Michael,4,0,34,30
1657754243849,MATH 109,A03,093478,Ganzberger; Geoffrey Michael,2,0,34,32
1657754243849,MATH 109,B01,083215,Ganzberger; Geoffrey Michael,1,0,32,31
1657754243849,MATH 109,B02,083216,Ganzberger; Geoffrey Michael,2,0,32,30
1657754243849,MATH 109,B03,093479,Ganzberger; Geoffrey Michael,8,0,32,24
1657754249872,MATH 142A,A01,083219,Chow; Bennett,7,0,32,25
1657754249872,MATH 142A,A02,083220,Chow; Bennett,10,0,32,22
1657754249872,MATH 142A,A03,093480,Chow; Bennett,9,0,32,23
1657754249872,MATH 142A,B03,093481,Chow; Bennett,8,0,32,24
1657754249872,MATH 142A,B04,093558,Chow; Bennett,13,0,32,19
1657754249872,MATH 142A,B05,093559,Chow; Bennett,6,0,32,26
1657754255900,MATH 193A,A01,083224,Rotar; Vladimir,8,0,34,26
1657754255900,MATH 193A,A02,083225,Rotar; Vladimir,9,0,34,25
1657754255900,MATH 193A,A03,083781,Rotar; Vladimir,5,0,34,29
1657754255900,MATH 193A,A04,083782,Rotar; Vladimir,10,0,34,24
1657754255900,MATH 193A,A05,093482,Rotar; Vladimir,10,0,34,24
1657754261923,MATH 197,001,091859,McAuley; Julian John,9999,0,9999,0
1657754261923,MATH 197,002,095566,Kedlaya; Kiran S.,9997,0,9999,2
1657754261923,MATH 197,003,095567,Xiao; Ming,9999,0,9999,0
1657754261923,MATH 197,004,095571,Perols; Johan Lars,9998,0,9999,1
1657754268985,COGS 9,A01,083615,Shannon; Kyle Michael,9,0,75,66
1657754275008,COGS 11,A01,083617,Boyle; Mary E. T.,23,0,48,25
1657754281032,COGS 13,A01,083071,Bastos; Amalia Pinkusfeld,11,0,71,60
1657754287059,COGS 14A,A01,092681,Semenuks; Arturs,5,1,100,95
1657754293080,COGS 14B,A01,083073,Cheng; Tzu-Han,6,0,63,57
1657754299107,COGS 17,A01,092677,Semenuks; Arturs,6,0,81,75
1657754305133,COGS 100,A01,083619,Allen; Michael Gordon,17,0,70,53
1657754311158,COGS 101A,A01,083621,Davis; Joshua Daniel,9,0,68,59
1657754317181,COGS 101B,A01,091572,Allen; Michael Gordon,12,0,65,53
1657754323203,COGS 101C,A01,083625,Delgado; Tania,17,0,35,18
1657754329229,COGS 107A,A01,083627,Boyle; Mary E. T.,13,0,60,47
1657754335260,COGS 118A,A01,083075,Gupta; Anjum,21,0,76,55
1657754341289,CSE 3,A50,083646,Miranda; Gregory Joseph,24,0,50,26
1657754347314,CSE 8A,A50,083650,Miranda; Gregory Joseph,17,1,56,39
1657754353340,CSE 11,A01,083080,Cao; Yingjun,6,15,40,34
1657754359375,CSE 12,A01,083652,Krause-Levy; Sophia Louisa,28,1,120,92
1657754365400,CSE 15L,A01,083654,Morris; Justin Loren,9,0,50,41
1657754365400,CSE 15L,A02,083655,Morris; Justin Loren,9,0,50,41
1657754371432,CSE 20,A01,083657,Tran; Khoa Dang,39,0,80,41
1657754377455,CSE 21,A01,095574,Bach; Quang Tran,22,0,48,26
1657754383482,CSE 30,A01,083084,Eldon; John,6,0,80,74
1657754383482,CSE 30,B01,095061,Bhaskar; Nishant,9,0,50,41
1657754389510,CSE 100,A01,083659,Cao; Yingjun,5,4,70,65
1657754395536,CSE 134B,A01,083661,Powell; Thomas Allan,24,0,100,76
1657754401569,CSE 140,A01,083663,Gungor; Onat,15,0,85,70
1657754407596,CSE 140L,A01,083088,Eldon; John,23,0,100,77
1657754413621,CSE 175,A01,083665,Kumar; Rakesh,3,0,25,22
1657754419646,CSE 190,A00,092507,Dubnov; Shlomo,8,0,20,12
1657754425671,ECE 45,A01,083139,Congero; Spencer William,6,0,75,69
1657754431694,ECE 65,A50,083695,Saad; Andrew S,12,0,30,18
1657754431694,ECE 65,A51,095125,Saad; Andrew S,24,0,26,2
1657754437716,ECE 109,A01,091882,Touri; Behrouz,20,0,70,50
1657754443741,ECE 180,A00,083140,Abi Samra; Nicholas Camill,1,0,30,29
1657754443741,ECE 180,B00,083141,Abi Samra; Nicholas Camill,0,0,30,30
1657754449765,MATH 10A,A01,083735,Patchell; Gregory David,2,0,30,28
1657754449765,MATH 10A,A02,083736,Patchell; Gregory David,20,0,30,10
1657754449765,MATH 10A,A03,083737,Patchell; Gregory David,16,0,30,14
1657754455788,MATH 10B,A01,083207,Lim; Seonhee,8,0,34,26
1657754455788,MATH 10B,A02,083208,Lim; Seonhee,9,0,35,26
1657754455788,MATH 10B,A03,093472,Lim; Seonhee,7,0,34,27
1657754455788,MATH 10B,B01,083739,Sinha; Shubham,13,0,30,17
1657754461818,MATH 18,A01,083743,Cinel; Cameron Alexander,9,0,30,21
1657754461818,MATH 18,A02,083744,Cinel; Cameron Alexander,18,0,30,12
1657754461818,MATH 18,A03,083745,Cinel; Cameron Alexander,10,0,30,20
1657754461818,MATH 18,B01,083748,Rideout; David Porter,5,0,37,32
1657754461818,MATH 18,B02,083749,Rideout; David Porter,5,0,36,31
1657754461818,MATH 18,B03,083750,Rideout; David Porter,3,0,37,34
1657754461818,MATH 18,B04,083751,Rideout; David Porter,6,0,36,30
1657754461818,MATH 18,B05,093473,Rideout; David Porter,6,0,36,30
1657754461818,MATH 18,B06,093474,Rideout; David Porter,6,0,36,30
1657754467843,MATH 20A,A01,083754,Zheng; Zequn,14,0,40,26
1657754473938,MATH 20B,A01,083756,Briones; Jor-el Thomas Caparas,4,0,36,32
1657754473938,MATH 20B,A02,083757,Briones; Jor-el Thomas Caparas,1,0,36,35
1657754473938,MATH 20B,A03,093475,Briones; Jor-el Thomas Caparas,2,0,36,34
1657754479962,MATH 20C,A01,083760,Briones; Jor-el Thomas Caparas,1,0,35,34
1657754479962,MATH 20C,A02,083761,Briones; Jor-el Thomas Caparas,8,0,35,27
1657754479962,MATH 20C,A03,093476,Briones; Jor-el Thomas Caparas,0,1,36,36
1657754479962,MATH 20C,B01,083762,Bach; Quang Tran,1,0,30,29
1657754485995,MATH 20D,A01,083765,Tran; Brian Kha,5,0,30,25
1657754485995,MATH 20D,A02,083766,Tran; Brian Kha,5,0,30,25
1657754485995,MATH 20D,A03,083767,Tran; Brian Kha,5,0,30,25
1657754492018,MATH 20E,A01,083771,Ganguly; Soumya,9,0,32,23
1657754492018,MATH 20E,A02,083772,Ganguly; Soumya,6,0,32,26
1657754492018,MATH 20E,B01,083773,Ciotti; Benjamin,20,0,35,15
1657754492018,MATH 20E,B02,083774,Ciotti; Benjamin,18,0,35,17
1657754498045,MATH 103A,A01,083777,Greenfeld; Be'Eri,3,0,36,33
1657754498045,MATH 103A,A02,083778,Greenfeld; Be'Eri,5,0,36,31
1657754498045,MATH 103A,A03,093561,Greenfeld; Be'Eri,6,0,36,30
1657754498045,MATH 103A,B01,083779,Greenfeld; Be'Eri,7,0,36,29
1657754498045,MATH 103A,B02,083780,Greenfeld; Be'Eri,4,0,36,32
1657754498045,MATH 103A,B03,093562,Greenfeld; Be'Eri,3,0,36,33
1657754504072,MATH 105,A01,085443,Carter; Anne Toulson,15,0,35,20
1657754504072,MATH 105,A02,093477,Carter; Anne Toulson,20,0,35,15
1657754510095,MATH 109,A01,083213,Ganzberger; Geoffrey Michael,3,0,34,31
1657754510095,MATH 109,A02,083214,Ganzberger; Geoffrey Michael,4,0,34,30
1657754510095,MATH 109,A03,093478,Ganzberger; Geoffrey Michael,2,0,34,32
1657754510095,MATH 109,B01,083215,Ganzberger; Geoffrey Michael,1,0,32,31
1657754510095,MATH 109,B02,083216,Ganzberger; Geoffrey Michael,2,0,32,30
1657754510095,MATH 109,B03,093479,Ganzberger; Geoffrey Michael,8,0,32,24
1657754516123,MATH 142A,A01,083219,Chow; Bennett,7,0,32,25
1657754516123,MATH 142A,A02,083220,Chow; Bennett,10,0,32,22
1657754516123,MATH 142A,A03,093480,Chow; Bennett,9,0,32,23
1657754516123,MATH 142A,B03,093481,Chow; Bennett,8,0,32,24
1657754516123,MATH 142A,B04,093558,Chow; Bennett,13,0,32,19
1657754516123,MATH 142A,B05,093559,Chow; Bennett,6,0,32,26
1657754522151,MATH 193A,A01,083224,Rotar; Vladimir,8,0,34,26
1657754522151,MATH 193A,A02,083225,Rotar; Vladimir,9,0,34,25
1657754522151,MATH 193A,A03,083781,Rotar; Vladimir,5,0,34,29
1657754522151,MATH 193A,A04,083782,Rotar; Vladimir,10,0,34,24
1657754522151,MATH 193A,A05,093482,Rotar; Vladimir,10,0,34,24
1657754528173,MATH 197,001,091859,McAuley; Julian John,9999,0,9999,0
1657754528173,MATH 197,002,095566,Kedlaya; Kiran S.,9997,0,9999,2
1657754528173,MATH 197,003,095567,Xiao; Ming,9999,0,9999,0
1657754528173,MATH 197,004,095571,Perols; Johan Lars,9998,0,9999,1
1657754535238,COGS 9,A01,083615,Shannon; Kyle Michael,9,0,75,66
1657754541279,COGS 11,A01,083617,Boyle; Mary E. T.,23,0,48,25
1657754547303,COGS 13,A01,083071,Bastos; Amalia Pinkusfeld,11,0,71,60
1657754553329,COGS 14A,A01,092681,Semenuks; Arturs,5,1,100,95
1657754559351,COGS 14B,A01,083073,Cheng; Tzu-Han,6,0,63,57
1657754565373,COGS 17,A01,092677,Semenuks; Arturs,6,0,81,75
1657754571404,COGS 100,A01,083619,Allen; Michael Gordon,17,0,70,53
1657754577427,COGS 101A,A01,083621,Davis; Joshua Daniel,9,0,68,59
1657754583449,COGS 101B,A01,091572,Allen; Michael Gordon,12,0,65,53
1657754589472,COGS 101C,A01,083625,Delgado; Tania,17,0,35,18
1657754595497,COGS 107A,A01,083627,Boyle; Mary E. T.,13,0,60,47
1657754601522,COGS 118A,A01,083075,Gupta; Anjum,21,0,76,55
1657754607545,CSE 3,A50,083646,Miranda; Gregory Joseph,24,0,50,26
1657754613577,CSE 8A,A50,083650,Miranda; Gregory Joseph,17,1,56,39
1657754619599,CSE 11,A01,083080,Cao; Yingjun,6,15,40,34
1657754625623,CSE 12,A01,083652,Krause-Levy; Sophia Louisa,28,1,120,92
1657754631646,CSE 15L,A01,083654,Morris; Justin Loren,9,0,50,41
1657754631646,CSE 15L,A02,083655,Morris; Justin Loren,9,0,50,41
1657754637670,CSE 20,A01,083657,Tran; Khoa Dang,39,0,80,41
1657754643697,CSE 21,A01,095574,Bach; Quang Tran,22,0,48,26
1657754649721,CSE 30,A01,083084,Eldon; John,6,0,80,74
1657754649721,CSE 30,B01,095061,Bhaskar; Nishant,9,0,50,41
1657754655744,CSE 100,A01,083659,Cao; Yingjun,5,4,70,65
1657754661770,CSE 134B,A01,083661,Powell; Thomas Allan,24,0,100,76
1657754667794,CSE 140,A01,083663,Gungor; Onat,15,0,85,70
1657754673818,CSE 140L,A01,083088,Eldon; John,23,0,100,77
1657754679842,CSE 175,A01,083665,Kumar; Rakesh,3,0,25,22
1657754685867,CSE 190,A00,092507,Dubnov; Shlomo,8,0,20,12
1657754691894,ECE 45,A01,083139,Congero; Spencer William,6,0,75,69
1657754697921,ECE 65,A50,083695,Saad; Andrew S,12,0,30,18
1657754697921,ECE 65,A51,095125,Saad; Andrew S,24,0,26,2
1657754703947,ECE 109,A01,091882,Touri; Behrouz,20,0,70,50
1657754709969,ECE 180,A00,083140,Abi Samra; Nicholas Camill,1,0,30,29
1657754709969,ECE 180,B00,083141,Abi Samra; Nicholas Camill,0,0,30,30
1657754715997,MATH 10A,A01,083735,Patchell; Gregory David,2,0,30,28
1657754715997,MATH 10A,A02,083736,Patchell; Gregory David,20,0,30,10
1657754715997,MATH 10A,A03,083737,Patchell; Gregory David,16,0,30,14
1657754722024,MATH 10B,A01,083207,Lim; Seonhee,8,0,34,26
1657754722024,MATH 10B,A02,083208,Lim; Seonhee,9,0,35,26
1657754722024,MATH 10B,A03,093472,Lim; Seonhee,7,0,34,27
1657754722024,MATH 10B,B01,083739,Sinha; Shubham,13,0,30,17
1657754728049,MATH 18,A01,083743,Cinel; Cameron Alexander,9,0,30,21
1657754728049,MATH 18,A02,083744,Cinel; Cameron Alexander,18,0,30,12
1657754728049,MATH 18,A03,083745,Cinel; Cameron Alexander,10,0,30,20
1657754728049,MATH 18,B01,083748,Rideout; David Porter,5,0,37,32
1657754728049,MATH 18,B02,083749,Rideout; David Porter,5,0,36,31
1657754728049,MATH 18,B03,083750,Rideout; David Porter,3,0,37,34
1657754728049,MATH 18,B04,083751,Rideout; David Porter,6,0,36,30
1657754728049,MATH 18,B05,093473,Rideout; David Porter,6,0,36,30
1657754728049,MATH 18,B06,093474,Rideout; David Porter,6,0,36,30
1657754734074,MATH 20A,A01,083754,Zheng; Zequn,14,0,40,26
1657754740097,MATH 20B,A01,083756,Briones; Jor-el Thomas Caparas,4,0,36,32
1657754740097,MATH 20B,A02,083757,Briones; Jor-el Thomas Caparas,1,0,36,35
1657754740097,MATH 20B,A03,093475,Briones; Jor-el Thomas Caparas,2,0,36,34
1657754746129,MATH 20C,A01,083760,Briones; Jor-el Thomas Caparas,1,0,35,34
1657754746129,MATH 20C,A02,083761,Briones; Jor-el Thomas Caparas,8,0,35,27
1657754746129,MATH 20C,A03,093476,Briones; Jor-el Thomas Caparas,0,1,36,36
1657754746129,MATH 20C,B01,083762,Bach; Quang Tran,1,0,30,29
1657754752156,MATH 20D,A01,083765,Tran; Brian Kha,5,0,30,25
1657754752156,MATH 20D,A02,083766,Tran; Brian Kha,5,0,30,25
1657754752156,MATH 20D,A03,083767,Tran; Brian Kha,5,0,30,25
1657754758185,MATH 20E,A01,083771,Ganguly; Soumya,9,0,32,23
1657754758185,MATH 20E,A02,083772,Ganguly; Soumya,6,0,32,26
1657754758185,MATH 20E,B01,083773,Ciotti; Benjamin,20,0,35,15
1657754758185,MATH 20E,B02,083774,Ciotti; Benjamin,18,0,35,17
1657754764210,MATH 103A,A01,083777,Greenfeld; Be'Eri,3,0,36,33
1657754764210,MATH 103A,A02,083778,Greenfeld; Be'Eri,5,0,36,31
1657754764210,MATH 103A,A03,093561,Greenfeld; Be'Eri,6,0,36,30
1657754764210,MATH 103A,B01,083779,Greenfeld; Be'Eri,7,0,36,29
1657754764210,MATH 103A,B02,083780,Greenfeld; Be'Eri,4,0,36,32
1657754764210,MATH 103A,B03,093562,Greenfeld; Be'Eri,3,0,36,33
1657754770253,MATH 105,A01,085443,Carter; Anne Toulson,15,0,35,20
1657754770253,MATH 105,A02,093477,Carter; Anne Toulson,20,0,35,15
1657754776294,MATH 109,A01,083213,Ganzberger; Geoffrey Michael,3,0,34,31
1657754776294,MATH 109,A02,083214,Ganzberger; Geoffrey Michael,4,0,34,30
1657754776294,MATH 109,A03,093478,Ganzberger; Geoffrey Michael,2,0,34,32
1657754776294,MATH 109,B01,083215,Ganzberger; Geoffrey Michael,1,0,32,31
1657754776294,MATH 109,B02,083216,Ganzberger; Geoffrey Michael,2,0,32,30
1657754776294,MATH 109,B03,093479,Ganzberger; Geoffrey Michael,8,0,32,24
1657754782317,MATH 142A,A01,083219,Chow; Bennett,7,0,32,25
1657754782317,MATH 142A,A02,083220,Chow; Bennett,10,0,32,22
1657754782317,MATH 142A,A03,093480,Chow; Bennett,9,0,32,23
1657754782317,MATH 142A,B03,093481,Chow; Bennett,8,0,32,24
1657754782317,MATH 142A,B04,093558,Chow; Bennett,13,0,32,19
1657754782317,MATH 142A,B05,093559,Chow; Bennett,6,0,32,26
1657754788339,MATH 193A,A01,083224,Rotar; Vladimir,8,0,34,26
1657754788339,MATH 193A,A02,083225,Rotar; Vladimir,9,0,34,25
1657754788339,MATH 193A,A03,083781,Rotar; Vladimir,5,0,34,29
1657754788339,MATH 193A,A04,083782,Rotar; Vladimir,10,0,34,24
1657754788339,MATH 193A,A05,093482,Rotar; Vladimir,10,0,34,24
1657754794362,MATH 197,001,091859,McAuley; Julian John,9999,0,9999,0
1657754794362,MATH 197,002,095566,Kedlaya; Kiran S.,9997,0,9999,2
1657754794362,MATH 197,003,095567,Xiao; Ming,9999,0,9999,0
1657754794362,MATH 197,004,095571,Perols; Johan Lars,9998,0,9999,1
1657754801423,COGS 9,A01,083615,Shannon; Kyle Michael,9,0,75,66
1657754807449,COGS 11,A01,083617,Boyle; Mary E. T.,23,0,48,25
1657754813475,COGS 13,A01,083071,Bastos; Amalia Pinkusfeld,11,0,71,60
1657754819498,COGS 14A,A01,092681,Semenuks; Arturs,5,1,100,95
1657754825526,COGS 14B,A01,083073,Cheng; Tzu-Han,6,0,63,57
1657754831547,COGS 17,A01,092677,Semenuks; Arturs,6,0,81,75
1657754837571,COGS 100,A01,083619,Allen; Michael Gordon,17,0,70,53
1657754843598,COGS 101A,A01,083621,Davis; Joshua Daniel,9,0,68,59
1657754849621,COGS 101B,A01,091572,Allen; Michael Gordon,12,0,65,53
1657754855648,COGS 101C,A01,083625,Delgado; Tania,17,0,35,18
1657754861671,COGS 107A,A01,083627,Boyle; Mary E. T.,13,0,60,47
1657754867694,COGS 118A,A01,083075,Gupta; Anjum,21,0,76,55
1657754873721,CSE 3,A50,083646,Miranda; Gregory Joseph,24,0,50,26
1657754879748,CSE 8A,A50,083650,Miranda; Gregory Joseph,17,1,56,39
1657754885771,CSE 11,A01,083080,Cao; Yingjun,6,15,40,34
1657754891795,CSE 12,A01,083652,Krause-Levy; Sophia Louisa,28,1,120,92
1657754897819,CSE 15L,A01,083654,Morris; Justin Loren,9,0,50,41
1657754897819,CSE 15L,A02,083655,Morris; Justin Loren,9,0,50,41
1657754903841,CSE 20,A01,083657,Tran; Khoa Dang,39,0,80,41
1657754909867,CSE 21,A01,095574,Bach; Quang Tran,22,0,48,26
1657754915895,CSE 30,A01,083084,Eldon; John,6,0,80,74
1657754915895,CSE 30,B01,095061,Bhaskar; Nishant,9,0,50,41
1657754921920,CSE 100,A01,083659,Cao; Yingjun,5,4,70,65
1657754927948,CSE 134B,A01,083661,Powell; Thomas Allan,24,0,100,76
1657754933971,CSE 140,A01,083663,Gungor; Onat,15,0,85,70
1657754940002,CSE 140L,A01,083088,Eldon; John,23,0,100,77
1657754946028,CSE 175,A01,083665,Kumar; Rakesh,3,0,25,22
1657754952054,CSE 190,A00,092507,Dubnov; Shlomo,8,0,20,12
1657754958078,ECE 45,A01,083139,Congero; Spencer William,6,0,75,69
1657754964115,ECE 65,A50,083695,Saad; Andrew S,12,0,30,18
1657754964115,ECE 65,A51,095125,Saad; Andrew S,24,0,26,2
1657754970138,ECE 109,A01,091882,Touri; Behrouz,20,0,70,50
1657754976165,ECE 180,A00,083140,Abi Samra; Nicholas Camill,1,0,30,29
1657754976165,ECE 180,B00,083141,Abi Samra; Nicholas Camill,0,0,30,30
1657754982192,MATH 10A,A01,083735,Patchell; Gregory David,2,0,30,28
1657754982192,MATH 10A,A02,083736,Patchell; Gregory David,20,0,30,10
1657754982192,MATH 10A,A03,083737,Patchell; Gregory David,16,0,30,14
1657754988222,MATH 10B,A01,083207,Lim; Seonhee,8,0,34,26
1657754988222,MATH 10B,A02,083208,Lim; Seonhee,9,0,35,26
1657754988222,MATH 10B,A03,093472,Lim; Seonhee,7,0,34,27
1657754988222,MATH 10B,B01,083739,Sinha; Shubham,13,0,30,17
1657754994247,MATH 18,A01,083743,Cinel; Cameron Alexander,9,0,30,21
1657754994247,MATH 18,A02,083744,Cinel; Cameron Alexander,18,0,30,12
1657754994247,MATH 18,A03,083745,Cinel; Cameron Alexander,10,0,30,20
1657754994247,MATH 18,B01,083748,Rideout; David Porter,5,0,37,32
1657754994247,MATH 18,B02,083749,Rideout; David Porter,5,0,36,31
1657754994247,MATH 18,B03,083750,Rideout; David Porter,3,0,37,34
1657754994247,MATH 18,B04,083751,Rideout; David Porter,6,0,36,30
1657754994247,MATH 18,B05,093473,Rideout; David Porter,6,0,36,30
1657754994247,MATH 18,B06,093474,Rideout; David Porter,6,0,36,30
1657755000270,MATH 20A,A01,083754,Zheng; Zequn,14,0,40,26
1657755006292,MATH 20B,A01,083756,Briones; Jor-el Thomas Caparas,4,0,36,32
1657755006292,MATH 20B,A02,083757,Briones; Jor-el Thomas Caparas,1,0,36,35
1657755006292,MATH 20B,A03,093475,Briones; Jor-el Thomas Caparas,2,0,36,34
1657755012323,MATH 20C,A01,083760,Briones; Jor-el Thomas Caparas,1,0,35,34
1657755012323,MATH 20C,A02,083761,Briones; Jor-el Thomas Caparas,8,0,35,27
1657755012323,MATH 20C,A03,093476,Briones; Jor-el Thomas Caparas,0,1,36,36
1657755012323,MATH 20C,B01,083762,Bach; Quang Tran,1,0,30,29
1657755018352,MATH 20D,A01,083765,Tran; Brian Kha,5,0,30,25
1657755018352,MATH 20D,A02,083766,Tran; Brian Kha,5,0,30,25
1657755018352,MATH 20D,A03,083767,Tran; Brian Kha,5,0,30,25
1657755024375,MATH 20E,A01,083771,Ganguly; Soumya,9,0,32,23
1657755024375,MATH 20E,A02,083772,Ganguly; Soumya,6,0,32,26
1657755024375,MATH 20E,B01,083773,Ciotti; Benjamin,20,0,35,15
1657755024375,MATH 20E,B02,083774,Ciotti; Benjamin,18,0,35,17
1657755030406,MATH 103A,A01,083777,Greenfeld; Be'Eri,3,0,36,33
1657755030406,MATH 103A,A02,083778,Greenfeld; Be'Eri,5,0,36,31
1657755030406,MATH 103A,A03,093561,Greenfeld; Be'Eri,6,0,36,30
1657755030406,MATH 103A,B01,083779,Greenfeld; Be'Eri,7,0,36,29
1657755030406,MATH 103A,B02,083780,Greenfeld; Be'Eri,4,0,36,32
1657755030406,MATH 103A,B03,093562,Greenfeld; Be'Eri,3,0,36,33
1657755036434,MATH 105,A01,085443,Carter; Anne Toulson,15,0,35,20
1657755036434,MATH 105,A02,093477,Carter; Anne Toulson,20,0,35,15
1657755042458,MATH 109,A01,083213,Ganzberger; Geoffrey Michael,3,0,34,31
1657755042458,MATH 109,A02,083214,Ganzberger; Geoffrey Michael,4,0,34,30
1657755042458,MATH 109,A03,093478,Ganzberger; Geoffrey Michael,2,0,34,32
1657755042458,MATH 109,B01,083215,Ganzberger; Geoffrey Michael,1,0,32,31
1657755042458,MATH 109,B02,083216,Ganzberger; Geoffrey Michael,2,0,32,30
1657755042458,MATH 109,B03,093479,Ganzberger; Geoffrey Michael,8,0,32,24
1657755048494,MATH 142A,A01,083219,Chow; Bennett,7,0,32,25
1657755048494,MATH 142A,A02,083220,Chow; Bennett,10,0,32,22
1657755048494,MATH 142A,A03,093480,Chow; Bennett,9,0,32,23
1657755048494,MATH 142A,B03,093481,Chow; Bennett,8,0,32,24
1657755048494,MATH 142A,B04,093558,Chow; Bennett,13,0,32,19
1657755048494,MATH 142A,B05,093559,Chow; Bennett,6,0,32,26
1657755054523,MATH 193A,A01,083224,Rotar; Vladimir,8,0,34,26
1657755054523,MATH 193A,A02,083225,Rotar; Vladimir,9,0,34,25
1657755054523,MATH 193A,A03,083781,Rotar; Vladimir,5,0,34,29
1657755054523,MATH 193A,A04,083782,Rotar; Vladimir,10,0,34,24
1657755054523,MATH 193A,A05,093482,Rotar; Vladimir,10,0,34,24
1657755060549,MATH 197,001,091859,McAuley; Julian John,9999,0,9999,0
1657755060549,MATH 197,002,095566,Kedlaya; Kiran S.,9997,0,9999,2
1657755060549,MATH 197,003,095567,Xiao; Ming,9999,0,9999,0
1657755060549,MATH 197,004,095571,Perols; Johan Lars,9998,0,9999,1
1657755067685,COGS 9,A01,083615,Shannon; Kyle Michael,9,0,75,66
1657755073711,COGS 11,A01,083617,Boyle; Mary E. T.,23,0,48,25
1657755079738,COGS 13,A01,083071,Bastos; Amalia Pinkusfeld,11,0,71,60
1657755085766,COGS 14A,A01,092681,Semenuks; Arturs,5,1,100,95
1657755091792,COGS 14B,A01,083073,Cheng; Tzu-Han,6,0,63,57
1657755097831,COGS 17,A01,092677,Semenuks; Arturs,6,0,81,75
1657755103855,COGS 100,A01,083619,Allen; Michael Gordon,17,0,70,53
1657755109879,COGS 101A,A01,083621,Davis; Joshua Daniel,9,0,68,59
1657755115904,COGS 101B,A01,091572,Allen; Michael Gordon,12,0,65,53
1657755121927,COGS 101C,A01,083625,Delgado; Tania,17,0,35,18
1657755127956,COGS 107A,A01,083627,Boyle; Mary E. T.,13,0,60,47
1657755133980,COGS 118A,A01,083075,Gupta; Anjum,21,0,76,55
1657755140013,CSE 3,A50,083646,Miranda; Gregory Joseph,24,0,50,26
1657755146037,CSE 8A,A50,083650,Miranda; Gregory Joseph,17,1,56,39
1657755152060,CSE 11,A01,083080,Cao; Yingjun,6,15,40,34
1657755158091,CSE 12,A01,083652,Krause-Levy; Sophia Louisa,28,1,120,92
1657755164113,CSE 15L,A01,083654,Morris; Justin Loren,9,0,50,41
1657755164113,CSE 15L,A02,083655,Morris; Justin Loren,9,0,50,41
1657755170140,CSE 20,A01,083657,Tran; Khoa Dang,39,0,80,41
1657755176168,CSE 21,A01,095574,Bach; Quang Tran,22,0,48,26
1657755182196,CSE 30,A01,083084,Eldon; John,6,0,80,74
1657755182196,CSE 30,B01,095061,Bhaskar; Nishant,9,0,50,41
1657755188221,CSE 100,A01,083659,Cao; Yingjun,5,4,70,65
1657755194243,CSE 134B,A01,083661,Powell; Thomas Allan,24,0,100,76
1657755200271,CSE 140,A01,083663,Gungor; Onat,15,0,85,70
1657755206293,CSE 140L,A01,083088,Eldon; John,23,0,100,77
1657755212318,CSE 175,A01,083665,Kumar; Rakesh,3,0,25,22
1657755218341,CSE 190,A00,092507,Dubnov; Shlomo,8,0,20,12
1657755224363,ECE 45,A01,083139,Congero; Spencer William,6,0,75,69
1657755230394,ECE 65,A50,083695,Saad; Andrew S,12,0,30,18
1657755230394,ECE 65,A51,095125,Saad; Andrew S,24,0,26,2
1657755236415,ECE 109,A01,091882,Touri; Behrouz,20,0,70,50
1657755242440,ECE 180,A00,083140,Abi Samra; Nicholas Camill,1,0,30,29
1657755242440,ECE 180,B00,083141,Abi Samra; Nicholas Camill,0,0,30,30
1657755248472,MATH 10A,A01,083735,Patchell; Gregory David,2,0,30,28
1657755248472,MATH 10A,A02,083736,Patchell; Gregory David,20,0,30,10
1657755248472,MATH 10A,A03,083737,Patchell; Gregory David,16,0,30,14
1657755254497,MATH 10B,A01,083207,Lim; Seonhee,8,0,34,26
1657755254497,MATH 10B,A02,083208,Lim; Seonhee,9,0,35,26
1657755254497,MATH 10B,A03,093472,Lim; Seonhee,7,0,34,27
1657755254497,MATH 10B,B01,083739,Sinha; Shubham,13,0,30,17
1657755260520,MATH 18,A01,083743,Cinel; Cameron Alexander,9,0,30,21
1657755260520,MATH 18,A02,083744,Cinel; Cameron Alexander,18,0,30,12
1657755260520,MATH 18,A03,083745,Cinel; Cameron Alexander,10,0,30,20
1657755260520,MATH 18,B01,083748,Rideout; David Porter,5,0,37,32
1657755260520,MATH 18,B02,083749,Rideout; David Porter,5,0,36,31
1657755260520,MATH 18,B03,083750,Rideout; David Porter,3,0,37,34
1657755260520,MATH 18,B04,083751,Rideout; David Porter,6,0,36,30
1657755260520,MATH 18,B05,093473,Rideout; David Porter,6,0,36,30
1657755260520,MATH 18,B06,093474,Rideout; David Porter,6,0,36,30
1657755266547,MATH 20A,A01,083754,Zheng; Zequn,14,0,40,26
1657755272571,MATH 20B,A01,083756,Briones; Jor-el Thomas Caparas,4,0,36,32
1657755272571,MATH 20B,A02,083757,Briones; Jor-el Thomas Caparas,1,0,36,35
1657755272571,MATH 20B,A03,093475,Briones; Jor-el Thomas Caparas,2,0,36,34
1657755278593,MATH 20C,A01,083760,Briones; Jor-el Thomas Caparas,1,0,35,34
1657755278593,MATH 20C,A02,083761,Briones; Jor-el Thomas Caparas,8,0,35,27
1657755278593,MATH 20C,A03,093476,Briones; Jor-el Thomas Caparas,0,1,36,36
1657755278593,MATH 20C,B01,083762,Bach; Quang Tran,1,0,30,29
1657755284617,MATH 20D,A01,083765,Tran; Brian Kha,5,0,30,25
1657755284617,MATH 20D,A02,083766,Tran; Brian Kha,5,0,30,25
1657755284617,MATH 20D,A03,083767,Tran; Brian Kha,5,0,30,25
1657755290649,MATH 20E,A01,083771,Ganguly; Soumya,9,0,32,23
1657755290649,MATH 20E,A02,083772,Ganguly; Soumya,6,0,32,26
1657755290649,MATH 20E,B01,083773,Ciotti; Benjamin,20,0,35,15
1657755290649,MATH 20E,B02,083774,Ciotti; Benjamin,18,0,35,17
1657755296695,MATH 103A,A01,083777,Greenfeld; Be'Eri,3,0,36,33
1657755296695,MATH 103A,A02,083778,Greenfeld; Be'Eri,5,0,36,31
1657755296695,MATH 103A,A03,093561,Greenfeld; Be'Eri,6,0,36,30
1657755296695,MATH 103A,B01,083779,Greenfeld; Be'Eri,7,0,36,29
1657755296695,MATH 103A,B02,083780,Greenfeld; Be'Eri,4,0,36,32
1657755296695,MATH 103A,B03,093562,Greenfeld; Be'Eri,3,0,36,33
1657755302724,MATH 105,A01,085443,Carter; Anne Toulson,15,0,35,20
1657755302724,MATH 105,A02,093477,Carter; Anne Toulson,20,0,35,15
1657755308751,MATH 109,A01,083213,Ganzberger; Geoffrey Michael,3,0,34,31
1657755308751,MATH 109,A02,083214,Ganzberger; Geoffrey Michael,4,0,34,30
1657755308751,MATH 109,A03,093478,Ganzberger; Geoffrey Michael,2,0,34,32
1657755308751,MATH 109,B01,083215,Ganzberger; Geoffrey Michael,1,0,32,31
1657755308751,MATH 109,B02,083216,Ganzberger; Geoffrey Michael,2,0,32,30
1657755308751,MATH 109,B03,093479,Ganzberger; Geoffrey Michael,8,0,32,24
1657755314784,MATH 142A,A01,083219,Chow; Bennett,7,0,32,25
1657755314784,MATH 142A,A02,083220,Chow; Bennett,10,0,32,22
1657755314784,MATH 142A,A03,093480,Chow; Bennett,9,0,32,23
1657755314784,MATH 142A,B03,093481,Chow; Bennett,8,0,32,24
1657755314784,MATH 142A,B04,093558,Chow; Bennett,13,0,32,19
1657755314784,MATH 142A,B05,093559,Chow; Bennett,6,0,32,26
1657755320817,MATH 193A,A01,083224,Rotar; Vladimir,8,0,34,26
1657755320817,MATH 193A,A02,083225,Rotar; Vladimir,9,0,34,25
1657755320817,MATH 193A,A03,083781,Rotar; Vladimir,5,0,34,29
1657755320817,MATH 193A,A04,083782,Rotar; Vladimir,10,0,34,24
1657755320817,MATH 193A,A05,093482,Rotar; Vladimir,10,0,34,24
1657755326880,MATH 197,001,091859,McAuley; Julian John,9999,0,9999,0
1657755326880,MATH 197,002,095566,Kedlaya; Kiran S.,9997,0,9999,2
1657755326880,MATH 197,003,095567,Xiao; Ming,9999,0,9999,0
1657755326880,MATH 197,004,095571,Perols; Johan Lars,9998,0,9999,1
1657755333946,COGS 9,A01,083615,Shannon; Kyle Michael,9,0,75,66
1657755339969,COGS 11,A01,083617,Boyle; Mary E. T.,23,0,48,25
1657755345992,COGS 13,A01,083071,Bastos; Amalia Pinkusfeld,11,0,71,60
1657755352020,COGS 14A,A01,092681,Semenuks; Arturs,5,1,100,95
1657755358043,COGS 14B,A01,083073,Cheng; Tzu-Han,6,0,63,57
1657755364069,COGS 17,A01,092677,Semenuks; Arturs,6,0,81,75
1657755370102,COGS 100,A01,083619,Allen; Michael Gordon,17,0,70,53
1657755376132,COGS 101A,A01,083621,Davis; Joshua Daniel,9,0,68,59
1657755382158,COGS 101B,A01,091572,Allen; Michael Gordon,12,0,65,53
1657755388181,COGS 101C,A01,083625,Delgado; Tania,17,0,35,18
1657755394207,COGS 107A,A01,083627,Boyle; Mary E. T.,13,0,60,47
1657755400229,COGS 118A,A01,083075,Gupta; Anjum,21,0,76,55
1657755406257,CSE 3,A50,083646,Miranda; Gregory Joseph,24,0,50,26
1657755412280,CSE 8A,A50,083650,Miranda; Gregory Joseph,17,1,56,39
1657755418303,CSE 11,A01,083080,Cao; Yingjun,6,15,40,34
1657755424325,CSE 12,A01,083652,Krause-Levy; Sophia Louisa,28,1,120,92
1657755430352,CSE 15L,A01,083654,Morris; Justin Loren,9,0,50,41
1657755430352,CSE 15L,A02,083655,Morris; Justin Loren,9,0,50,41
1657755436408,CSE 20,A01,083657,Tran; Khoa Dang,39,0,80,41
1657755442439,CSE 21,A01,095574,Bach; Quang Tran,22,0,48,26
1657755448463,CSE 30,A01,083084,Eldon; John,6,0,80,74
1657755448463,CSE 30,B01,095061,Bhaskar; Nishant,9,0,50,41
1657755454493,CSE 100,A01,083659,Cao; Yingjun,5,4,70,65
1657755460516,CSE 134B,A01,083661,Powell; Thomas Allan,24,0,100,76
1657755466542,CSE 140,A01,083663,Gungor; Onat,15,0,85,70
1657755472565,CSE 140L,A01,083088,Eldon; John,23,0,100,77
1657755478590,CSE 175,A01,083665,Kumar; Rakesh,3,0,25,22
1657755484613,CSE 190,A00,092507,Dubnov; Shlomo,8,0,20,12
1657755490637,ECE 45,A01,083139,Congero; Spencer William,6,0,75,69
1657755496660,ECE 65,A50,083695,Saad; Andrew S,12,0,30,18
1657755496660,ECE 65,A51,095125,Saad; Andrew S,24,0,26,2
1657755502682,ECE 109,A01,091882,Touri; Behrouz,20,0,70,50
1657755508725,ECE 180,A00,083140,Abi Samra; Nicholas Camill,1,0,30,29
1657755508725,ECE 180,B00,083141,Abi Samra; Nicholas Camill,0,0,30,30
1657755514749,MATH 10A,A01,083735,Patchell; Gregory David,2,0,30,28
1657755514749,MATH 10A,A02,083736,Patchell; Gregory David,20,0,30,10
1657755514749,MATH 10A,A03,083737,Patchell; Gregory David,16,0,30,14
1657755520772,MATH 10B,A01,083207,Lim; Seonhee,8,0,34,26
1657755520772,MATH 10B,A02,083208,Lim; Seonhee,9,0,35,26
1657755520772,MATH 10B,A03,093472,Lim; Seonhee,7,0,34,27
1657755520772,MATH 10B,B01,083739,Sinha; Shubham,13,0,30,17
1657755526802,MATH 18,A01,083743,Cinel; Cameron Alexander,9,0,30,21
1657755526802,MATH 18,A02,083744,Cinel; Cameron Alexander,18,0,30,12
1657755526802,MATH 18,A03,083745,Cinel; Cameron Alexander,10,0,30,20
1657755526802,MATH 18,B01,083748,Rideout; David Porter,5,0,37,32
1657755526802,MATH 18,B02,083749,Rideout; David Porter,5,0,36,31
1657755526802,MATH 18,B03,083750,Rideout; David Porter,3,0,37,34
1657755526802,MATH 18,B04,083751,Rideout; David Porter,6,0,36,30
1657755526802,MATH 18,B05,093473,Rideout; David Porter,6,0,36,30
1657755526802,MATH 18,B06,093474,Rideout; David Porter,6,0,36,30
1657755532825,MATH 20A,A01,083754,Zheng; Zequn,14,0,40,26
1657755538849,MATH 20B,A01,083756,Briones; Jor-el Thomas Caparas,4,0,36,32
1657755538849,MATH 20B,A02,083757,Briones; Jor-el Thomas Caparas,1,0,36,35
1657755538849,MATH 20B,A03,093475,Briones; Jor-el Thomas Caparas,2,0,36,34
1657755544876,MATH 20C,A01,083760,Briones; Jor-el Thomas Caparas,1,0,35,34
1657755544876,MATH 20C,A02,083761,Briones; Jor-el Thomas Caparas,8,0,35,27
1657755544876,MATH 20C,A03,093476,Briones; Jor-el Thomas Caparas,0,1,36,36
1657755544876,MATH 20C,B01,083762,Bach; Quang Tran,1,0,30,29
1657755550899,MATH 20D,A01,083765,Tran; Brian Kha,5,0,30,25
1657755550899,MATH 20D,A02,083766,Tran; Brian Kha,5,0,30,25
1657755550899,MATH 20D,A03,083767,Tran; Brian Kha,5,0,30,25
1657755556924,MATH 20E,A01,083771,Ganguly; Soumya,9,0,32,23
1657755556924,MATH 20E,A02,083772,Ganguly; Soumya,6,0,32,26
1657755556924,MATH 20E,B01,083773,Ciotti; Benjamin,20,0,35,15
1657755556924,MATH 20E,B02,083774,Ciotti; Benjamin,18,0,35,17
1657755562952,MATH 103A,A01,083777,Greenfeld; Be'Eri,3,0,36,33
1657755562952,MATH 103A,A02,083778,Greenfeld; Be'Eri,5,0,36,31
1657755562952,MATH 103A,A03,093561,Greenfeld; Be'Eri,6,0,36,30
1657755562952,MATH 103A,B01,083779,Greenfeld; Be'Eri,7,0,36,29
1657755562952,MATH 103A,B02,083780,Greenfeld; Be'Eri,4,0,36,32
1657755562952,MATH 103A,B03,093562,Greenfeld; Be'Eri,3,0,36,33
1657755568975,MATH 105,A01,085443,Carter; Anne Toulson,15,0,35,20
1657755568975,MATH 105,A02,093477,Carter; Anne Toulson,20,0,35,15
1657755574999,MATH 109,A01,083213,Ganzberger; Geoffrey Michael,3,0,34,31
1657755574999,MATH 109,A02,083214,Ganzberger; Geoffrey Michael,4,0,34,30
1657755574999,MATH 109,A03,093478,Ganzberger; Geoffrey Michael,2,0,34,32
1657755574999,MATH 109,B01,083215,Ganzberger; Geoffrey Michael,1,0,32,31
1657755574999,MATH 109,B02,083216,Ganzberger; Geoffrey Michael,2,0,32,30
1657755574999,MATH 109,B03,093479,Ganzberger; Geoffrey Michael,8,0,32,24
1657755581028,MATH 142A,A01,083219,Chow; Bennett,7,0,32,25
1657755581028,MATH 142A,A02,083220,Chow; Bennett,10,0,32,22
1657755581028,MATH 142A,A03,093480,Chow; Bennett,9,0,32,23
1657755581028,MATH 142A,B03,093481,Chow; Bennett,8,0,32,24
1657755581028,MATH 142A,B04,093558,Chow; Bennett,13,0,32,19
1657755581028,MATH 142A,B05,093559,Chow; Bennett,6,0,32,26
1657755587058,MATH 193A,A01,083224,Rotar; Vladimir,8,0,34,26
1657755587058,MATH 193A,A02,083225,Rotar; Vladimir,9,0,34,25
1657755587058,MATH 193A,A03,083781,Rotar; Vladimir,5,0,34,29
1657755587058,MATH 193A,A04,083782,Rotar; Vladimir,10,0,34,24
1657755587058,MATH 193A,A05,093482,Rotar; Vladimir,10,0,34,24
1657755593081,MATH 197,001,091859,McAuley; Julian John,9999,0,9999,0
1657755593081,MATH 197,002,095566,Kedlaya; Kiran S.,9997,0,9999,2
1657755593081,MATH 197,003,095567,Xiao; Ming,9999,0,9999,0
1657755593081,MATH 197,004,095571,Perols; Johan Lars,9998,0,9999,1
1657755600159,COGS 9,A01,083615,Shannon; Kyle Michael,9,0,75,66
1657755606185,COGS 11,A01,083617,Boyle; Mary E. T.,23,0,48,25
1657755612210,COGS 13,A01,083071,Bastos; Amalia Pinkusfeld,11,0,71,60
1657755618236,COGS 14A,A01,092681,Semenuks; Arturs,5,1,100,95
1657755624262,COGS 14B,A01,083073,Cheng; Tzu-Han,6,0,63,57
1657755630292,COGS 17,A01,092677,Semenuks; Arturs,6,0,81,75
1657755636315,COGS 100,A01,083619,Allen; Michael Gordon,17,0,70,53
1657755642342,COGS 101A,A01,083621,Davis; Joshua Daniel,9,0,68,59
1657755648371,COGS 101B,A01,091572,Allen; Michael Gordon,12,0,65,53
1657755654401,COGS 101C,A01,083625,Delgado; Tania,17,0,35,18
1657755660427,COGS 107A,A01,083627,Boyle; Mary E. T.,13,0,60,47
1657755666524,COGS 118A,A01,083075,Gupta; Anjum,21,0,76,55
1657755672546,CSE 3,A50,083646,Miranda; Gregory Joseph,24,0,50,26
1657755678569,CSE 8A,A50,083650,Miranda; Gregory Joseph,17,1,56,39
1657755684597,CSE 11,A01,083080,Cao; Yingjun,6,15,40,34
1657755690644,CSE 12,A01,083652,Krause-Levy; Sophia Louisa,28,1,120,92
1657755696666,CSE 15L,A01,083654,Morris; Justin Loren,9,0,50,41
1657755696666,CSE 15L,A02,083655,Morris; Justin Loren,9,0,50,41
1657755702695,CSE 20,A01,083657,Tran; Khoa Dang,39,0,80,41
1657755708723,CSE 21,A01,095574,Bach; Quang Tran,22,0,48,26
1657755714753,CSE 30,A01,083084,Eldon; John,6,0,80,74
1657755714753,CSE 30,B01,095061,Bhaskar; Nishant,9,0,50,41
1657755720776,CSE 100,A01,083659,Cao; Yingjun,5,4,70,65
1657755726800,CSE 134B,A01,083661,Powell; Thomas Allan,24,0,100,76
1657755732826,CSE 140,A01,083663,Gungor; Onat,15,0,85,70
1657755738853,CSE 140L,A01,083088,Eldon; John,23,0,100,77
1657755744875,CSE 175,A01,083665,Kumar; Rakesh,3,0,25,22
1657755750898,CSE 190,A00,092507,Dubnov; Shlomo,8,0,20,12
1657755756921,ECE 45,A01,083139,Congero; Spencer William,6,0,75,69
1657755762949,ECE 65,A50,083695,Saad; Andrew S,12,0,30,18
1657755762949,ECE 65,A51,095125,Saad; Andrew S,24,0,26,2
1657755768972,ECE 109,A01,091882,Touri; Behrouz,20,0,70,50
1657755774994,ECE 180,A00,083140,Abi Samra; Nicholas Camill,1,0,30,29
1657755774994,ECE 180,B00,083141,Abi Samra; Nicholas Camill,0,0,30,30
1657755781027,MATH 10A,A01,083735,Patchell; Gregory David,2,0,30,28
1657755781027,MATH 10A,A02,083736,Patchell; Gregory David,20,0,30,10
1657755781027,MATH 10A,A03,083737,Patchell; Gregory David,16,0,30,14
1657755787056,MATH 10B,A01,083207,Lim; Seonhee,8,0,34,26
1657755787056,MATH 10B,A02,083208,Lim; Seonhee,9,0,35,26
1657755787056,MATH 10B,A03,093472,Lim; Seonhee,7,0,34,27
1657755787056,MATH 10B,B01,083739,Sinha; Shubham,13,0,30,17
1657755793094,MATH 18,A01,083743,Cinel; Cameron Alexander,9,0,30,21
1657755793094,MATH 18,A02,083744,Cinel; Cameron Alexander,18,0,30,12
1657755793094,MATH 18,A03,083745,Cinel; Cameron Alexander,10,0,30,20
1657755793094,MATH 18,B01,083748,Rideout; David Porter,5,0,37,32
1657755793094,MATH 18,B02,083749,Rideout; David Porter,5,0,36,31
1657755793094,MATH 18,B03,083750,Rideout; David Porter,3,0,37,34
1657755793094,MATH 18,B04,083751,Rideout; David Porter,6,0,36,30
1657755793094,MATH 18,B05,093473,Rideout; David Porter,6,0,36,30
1657755793094,MATH 18,B06,093474,Rideout; David Porter,6,0,36,30
1657755799120,MATH 20A,A01,083754,Zheng; Zequn,14,0,40,26
1657755805148,MATH 20B,A01,083756,Briones; Jor-el Thomas Caparas,4,0,36,32
1657755805148,MATH 20B,A02,083757,Briones; Jor-el Thomas Caparas,1,0,36,35
1657755805148,MATH 20B,A03,093475,Briones; Jor-el Thomas Caparas,2,0,36,34
1657755811171,MATH 20C,A01,083760,Briones; Jor-el Thomas Caparas,1,0,35,34
1657755811171,MATH 20C,A02,083761,Briones; Jor-el Thomas Caparas,8,0,35,27
1657755811171,MATH 20C,A03,093476,Briones; Jor-el Thomas Caparas,0,1,36,36
1657755811171,MATH 20C,B01,083762,Bach; Quang Tran,1,0,30,29
1657755817198,MATH 20D,A01,083765,Tran; Brian Kha,5,0,30,25
1657755817198,MATH 20D,A02,083766,Tran; Brian Kha,5,0,30,25
1657755817198,MATH 20D,A03,083767,Tran; Brian Kha,5,0,30,25
1657755823222,MATH 20E,A01,083771,Ganguly; Soumya,9,0,32,23
1657755823222,MATH 20E,A02,083772,Ganguly; Soumya,6,0,32,26
1657755823222,MATH 20E,B01,083773,Ciotti; Benjamin,20,0,35,15
1657755823222,MATH 20E,B02,083774,Ciotti; Benjamin,18,0,35,17
1657755829249,MATH 103A,A01,083777,Greenfeld; Be'Eri,3,0,36,33
1657755829249,MATH 103A,A02,083778,Greenfeld; Be'Eri,5,0,36,31
1657755829249,MATH 103A,A03,093561,Greenfeld; Be'Eri,6,0,36,30
1657755829249,MATH 103A,B01,083779,Greenfeld; Be'Eri,7,0,36,29
1657755829249,MATH 103A,B02,083780,Greenfeld; Be'Eri,4,0,36,32
1657755829249,MATH 103A,B03,093562,Greenfeld; Be'Eri,3,0,36,33
1657755835271,MATH 105,A01,085443,Carter; Anne Toulson,15,0,35,20
1657755835271,MATH 105,A02,093477,Carter; Anne Toulson,20,0,35,15
1657755841295,MATH 109,A01,083213,Ganzberger; Geoffrey Michael,3,0,34,31
1657755841295,MATH 109,A02,083214,Ganzberger; Geoffrey Michael,4,0,34,30
1657755841295,MATH 109,A03,093478,Ganzberger; Geoffrey Michael,2,0,34,32
1657755841295,MATH 109,B01,083215,Ganzberger; Geoffrey Michael,1,0,32,31
1657755841295,MATH 109,B02,083216,Ganzberger; Geoffrey Michael,2,0,32,30
1657755841295,MATH 109,B03,093479,Ganzberger; Geoffrey Michael,8,0,32,24
1657755847325,MATH 142A,A01,083219,Chow; Bennett,7,0,32,25
1657755847325,MATH 142A,A02,083220,Chow; Bennett,10,0,32,22
1657755847325,MATH 142A,A03,093480,Chow; Bennett,9,0,32,23
1657755847325,MATH 142A,B03,093481,Chow; Bennett,8,0,32,24
1657755847325,MATH 142A,B04,093558,Chow; Bennett,13,0,32,19
1657755847325,MATH 142A,B05,093559,Chow; Bennett,6,0,32,26
1657755853358,MATH 193A,A01,083224,Rotar; Vladimir,8,0,34,26
1657755853358,MATH 193A,A02,083225,Rotar; Vladimir,9,0,34,25
1657755853358,MATH 193A,A03,083781,Rotar; Vladimir,5,0,34,29
1657755853358,MATH 193A,A04,083782,Rotar; Vladimir,10,0,34,24
1657755853358,MATH 193A,A05,093482,Rotar; Vladimir,10,0,34,24
1657755859385,MATH 197,001,091859,McAuley; Julian John,9999,0,9999,0
1657755859385,MATH 197,002,095566,Kedlaya; Kiran S.,9997,0,9999,2
1657755859385,MATH 197,003,095567,Xiao; Ming,9999,0,9999,0
1657755859385,MATH 197,004,095571,Perols; Johan Lars,9998,0,9999,1
1657755866453,COGS 9,A01,083615,Shannon; Kyle Michael,9,0,75,66
1657755872477,COGS 11,A01,083617,Boyle; Mary E. T.,23,0,48,25
1657755878502,COGS 13,A01,083071,Bastos; Amalia Pinkusfeld,11,0,71,60
1657755884530,COGS 14A,A01,092681,Semenuks; Arturs,5,1,100,95
1657755890552,COGS 14B,A01,083073,Cheng; Tzu-Han,6,0,63,57
1657755896576,COGS 17,A01,092677,Semenuks; Arturs,6,0,81,75
1657755902603,COGS 100,A01,083619,Allen; Michael Gordon,17,0,70,53
1657755908634,COGS 101A,A01,083621,Davis; Joshua Daniel,9,0,68,59
1657755914667,COGS 101B,A01,091572,Allen; Michael Gordon,12,0,65,53
1657755920690,COGS 101C,A01,083625,Delgado; Tania,17,0,35,18
1657755926720,COGS 107A,A01,083627,Boyle; Mary E. T.,13,0,60,47
1657755932744,COGS 118A,A01,083075,Gupta; Anjum,21,0,76,55
1657755938770,CSE 3,A50,083646,Miranda; Gregory Joseph,24,0,50,26
1657755944804,CSE 8A,A50,083650,Miranda; Gregory Joseph,17,1,56,39
1657755950831,CSE 11,A01,083080,Cao; Yingjun,6,15,40,34
1657755956854,CSE 12,A01,083652,Krause-Levy; Sophia Louisa,28,1,120,92
1657755962887,CSE 15L,A01,083654,Morris; Justin Loren,9,0,50,41
1657755962887,CSE 15L,A02,083655,Morris; Justin Loren,9,0,50,41
1657755968917,CSE 20,A01,083657,Tran; Khoa Dang,39,0,80,41
1657755974948,CSE 21,A01,095574,Bach; Quang Tran,22,0,48,26
1657755980971,CSE 30,A01,083084,Eldon; John,6,0,80,74
1657755980971,CSE 30,B01,095061,Bhaskar; Nishant,9,0,50,41
1657755986994,CSE 100,A01,083659,Cao; Yingjun,5,4,70,65
1657755993023,CSE 134B,A01,083661,Powell; Thomas Allan,24,0,100,76
1657755999045,CSE 140,A01,083663,Gungor; Onat,15,0,85,70
1657756005080,CSE 140L,A01,083088,Eldon; John,23,0,100,77
1657756011102,CSE 175,A01,083665,Kumar; Rakesh,3,0,25,22
1657756017135,CSE 190,A00,092507,Dubnov; Shlomo,8,0,20,12
1657756023162,ECE 45,A01,083139,Congero; Spencer William,6,0,75,69
1657756029190,ECE 65,A50,083695,Saad; Andrew S,12,0,30,18
1657756029190,ECE 65,A51,095125,Saad; Andrew S,24,0,26,2
1657756035222,ECE 109,A01,091882,Touri; Behrouz,20,0,70,50
1657756041248,ECE 180,A00,083140,Abi Samra; Nicholas Camill,1,0,30,29
1657756041248,ECE 180,B00,083141,Abi Samra; Nicholas Camill,0,0,30,30
1657756047275,MATH 10A,A01,083735,Patchell; Gregory David,2,0,30,28
1657756047275,MATH 10A,A02,083736,Patchell; Gregory David,20,0,30,10
1657756047275,MATH 10A,A03,083737,Patchell; Gregory David,16,0,30,14
1657756053298,MATH 10B,A01,083207,Lim; Seonhee,8,0,34,26
1657756053298,MATH 10B,A02,083208,Lim; Seonhee,9,0,35,26
1657756053298,MATH 10B,A03,093472,Lim; Seonhee,7,0,34,27
1657756053298,MATH 10B,B01,083739,Sinha; Shubham,13,0,30,17
1657756059329,MATH 18,A01,083743,Cinel; Cameron Alexander,9,0,30,21
1657756059329,MATH 18,A02,083744,Cinel; Cameron Alexander,18,0,30,12
1657756059329,MATH 18,A03,083745,Cinel; Cameron Alexander,10,0,30,20
1657756059329,MATH 18,B01,083748,Rideout; David Porter,5,0,37,32
1657756059329,MATH 18,B02,083749,Rideout; David Porter,5,0,36,31
1657756059329,MATH 18,B03,083750,Rideout; David Porter,3,0,37,34
1657756059329,MATH 18,B04,083751,Rideout; David Porter,6,0,36,30
1657756059329,MATH 18,B05,093473,Rideout; David Porter,6,0,36,30
1657756059329,MATH 18,B06,093474,Rideout; David Porter,6,0,36,30
1657756065352,MATH 20A,A01,083754,Zheng; Zequn,14,0,40,26
1657756071382,MATH 20B,A01,083756,Briones; Jor-el Thomas Caparas,4,0,36,32
1657756071382,MATH 20B,A02,083757,Briones; Jor-el Thomas Caparas,1,0,36,35
1657756071382,MATH 20B,A03,093475,Briones; Jor-el Thomas Caparas,2,0,36,34
1657756077406,MATH 20C,A01,083760,Briones; Jor-el Thomas Caparas,1,0,35,34
1657756077406,MATH 20C,A02,083761,Briones; Jor-el Thomas Caparas,8,0,35,27
1657756077406,MATH 20C,A03,093476,Briones; Jor-el Thomas Caparas,0,1,36,36
1657756077406,MATH 20C,B01,083762,Bach; Quang Tran,1,0,30,29
1657756083429,MATH 20D,A01,083765,Tran; Brian Kha,5,0,30,25
1657756083429,MATH 20D,A02,083766,Tran; Brian Kha,5,0,30,25
1657756083429,MATH 20D,A03,083767,Tran; Brian Kha,5,0,30,25
1657756089454,MATH 20E,A01,083771,Ganguly; Soumya,9,0,32,23
1657756089454,MATH 20E,A02,083772,Ganguly; Soumya,6,0,32,26
1657756089454,MATH 20E,B01,083773,Ciotti; Benjamin,20,0,35,15
1657756089454,MATH 20E,B02,083774,Ciotti; Benjamin,18,0,35,17
1657756095480,MATH 103A,A01,083777,Greenfeld; Be'Eri,3,0,36,33
1657756095480,MATH 103A,A02,083778,Greenfeld; Be'Eri,5,0,36,31
1657756095480,MATH 103A,A03,093561,Greenfeld; Be'Eri,6,0,36,30
1657756095480,MATH 103A,B01,083779,Greenfeld; Be'Eri,7,0,36,29
1657756095480,MATH 103A,B02,083780,Greenfeld; Be'Eri,4,0,36,32
1657756095480,MATH 103A,B03,093562,Greenfeld; Be'Eri,3,0,36,33
1657756101501,MATH 105,A01,085443,Carter; Anne Toulson,15,0,35,20
1657756101501,MATH 105,A02,093477,Carter; Anne Toulson,20,0,35,15
1657756107535,MATH 109,A01,083213,Ganzberger; Geoffrey Michael,3,0,34,31
1657756107535,MATH 109,A02,083214,Ganzberger; Geoffrey Michael,4,0,34,30
1657756107535,MATH 109,A03,093478,Ganzberger; Geoffrey Michael,2,0,34,32
1657756107535,MATH 109,B01,083215,Ganzberger; Geoffrey Michael,1,0,32,31
1657756107535,MATH 109,B02,083216,Ganzberger; Geoffrey Michael,2,0,32,30
1657756107535,MATH 109,B03,093479,Ganzberger; Geoffrey Michael,8,0,32,24
1657756113566,MATH 142A,A01,083219,Chow; Bennett,7,0,32,25
1657756113566,MATH 142A,A02,083220,Chow; Bennett,10,0,32,22
1657756113566,MATH 142A,A03,093480,Chow; Bennett,9,0,32,23
1657756113566,MATH 142A,B03,093481,Chow; Bennett,8,0,32,24
1657756113566,MATH 142A,B04,093558,Chow; Bennett,13,0,32,19
1657756113566,MATH 142A,B05,093559,Chow; Bennett,6,0,32,26
1657756119590,MATH 193A,A01,083224,Rotar; Vladimir,8,0,34,26
1657756119590,MATH 193A,A02,083225,Rotar; Vladimir,9,0,34,25
1657756119590,MATH 193A,A03,083781,Rotar; Vladimir,5,0,34,29
1657756119590,MATH 193A,A04,083782,Rotar; Vladimir,10,0,34,24
1657756119590,MATH 193A,A05,093482,Rotar; Vladimir,10,0,34,24
1657756125614,MATH 197,001,091859,McAuley; Julian John,9999,0,9999,0
1657756125614,MATH 197,002,095566,Kedlaya; Kiran S.,9997,0,9999,2
1657756125614,MATH 197,003,095567,Xiao; Ming,9999,0,9999,0
1657756125614,MATH 197,004,095571,Perols; Johan Lars,9998,0,9999,1
1657756132686,COGS 9,A01,083615,Shannon; Kyle Michael,9,0,75,66
1657756138710,COGS 11,A01,083617,Boyle; Mary E. T.,23,0,48,25
1657756144738,COGS 13,A01,083071,Bastos; Amalia Pinkusfeld,11,0,71,60
1657756150765,COGS 14A,A01,092681,Semenuks; Arturs,5,1,100,95
1657756156789,COGS 14B,A01,083073,Cheng; Tzu-Han,6,0,63,57
1657756162816,COGS 17,A01,092677,Semenuks; Arturs,6,0,81,75
1657756168839,COGS 100,A01,083619,Allen; Michael Gordon,17,0,70,53
1657756174861,COGS 101A,A01,083621,Davis; Joshua Daniel,9,0,68,59
1657756180884,COGS 101B,A01,091572,Allen; Michael Gordon,12,0,65,53
1657756186910,COGS 101C,A01,083625,Delgado; Tania,17,0,35,18
1657756192961,COGS 107A,A01,083627,Boyle; Mary E. T.,13,0,60,47
1657756198998,COGS 118A,A01,083075,Gupta; Anjum,21,0,76,55
1657756205022,CSE 3,A50,083646,Miranda; Gregory Joseph,24,0,50,26
1657756211050,CSE 8A,A50,083650,Miranda; Gregory Joseph,17,1,56,39
1657756217074,CSE 11,A01,083080,Cao; Yingjun,6,15,40,34
1657756223101,CSE 12,A01,083652,Krause-Levy; Sophia Louisa,28,1,120,92
1657756229128,CSE 15L,A01,083654,Morris; Justin Loren,9,0,50,41
1657756229128,CSE 15L,A02,083655,Morris; Justin Loren,9,0,50,41
1657756235150,CSE 20,A01,083657,Tran; Khoa Dang,39,0,80,41
1657756241174,CSE 21,A01,095574,Bach; Quang Tran,22,0,48,26
1657756247200,CSE 30,A01,083084,Eldon; John,6,0,80,74
1657756247200,CSE 30,B01,095061,Bhaskar; Nishant,9,0,50,41
1657756253224,CSE 100,A01,083659,Cao; Yingjun,5,4,70,65
1657756259247,CSE 134B,A01,083661,Powell; Thomas Allan,24,0,100,76
1657756265351,CSE 140,A01,083663,Gungor; Onat,15,0,85,70
1657756271373,CSE 140L,A01,083088,Eldon; John,23,0,100,77
1657756277397,CSE 175,A01,083665,Kumar; Rakesh,3,0,25,22
1657756283419,CSE 190,A00,092507,Dubnov; Shlomo,8,0,20,12
1657756289446,ECE 45,A01,083139,Congero; Spencer William,6,0,75,69
1657756295475,ECE 65,A50,083695,Saad; Andrew S,12,0,30,18
1657756295475,ECE 65,A51,095125,Saad; Andrew S,24,0,26,2
1657756301500,ECE 109,A01,091882,Touri; Behrouz,20,0,70,50
1657756307526,ECE 180,A00,083140,Abi Samra; Nicholas Camill,1,0,30,29
1657756307526,ECE 180,B00,083141,Abi Samra; Nicholas Camill,0,0,30,30
1657756313553,MATH 10A,A01,083735,Patchell; Gregory David,2,0,30,28
1657756313553,MATH 10A,A02,083736,Patchell; Gregory David,20,0,30,10
1657756313553,MATH 10A,A03,083737,Patchell; Gregory David,16,0,30,14
1657756319587,MATH 10B,A01,083207,Lim; Seonhee,8,0,34,26
1657756319587,MATH 10B,A02,083208,Lim; Seonhee,9,0,35,26
1657756319587,MATH 10B,A03,093472,Lim; Seonhee,7,0,34,27
1657756319587,MATH 10B,B01,083739,Sinha; Shubham,13,0,30,17
1657756325618,MATH 18,A01,083743,Cinel; Cameron Alexander,9,0,30,21
1657756325618,MATH 18,A02,083744,Cinel; Cameron Alexander,18,0,30,12
1657756325618,MATH 18,A03,083745,Cinel; Cameron Alexander,10,0,30,20
1657756325618,MATH 18,B01,083748,Rideout; David Porter,5,0,37,32
1657756325618,MATH 18,B02,083749,Rideout; David Porter,5,0,36,31
1657756325618,MATH 18,B03,083750,Rideout; David Porter,3,0,37,34
1657756325618,MATH 18,B04,083751,Rideout; David Porter,6,0,36,30
1657756325618,MATH 18,B05,093473,Rideout; David Porter,6,0,36,30
1657756325618,MATH 18,B06,093474,Rideout; David Porter,6,0,36,30
1657756331642,MATH 20A,A01,083754,Zheng; Zequn,14,0,40,26
1657756337665,MATH 20B,A01,083756,Briones; Jor-el Thomas Caparas,4,0,36,32
1657756337665,MATH 20B,A02,083757,Briones; Jor-el Thomas Caparas,1,0,36,35
1657756337665,MATH 20B,A03,093475,Briones; Jor-el Thomas Caparas,2,0,36,34
1657756343693,MATH 20C,A01,083760,Briones; Jor-el Thomas Caparas,1,0,35,34
1657756343693,MATH 20C,A02,083761,Briones; Jor-el Thomas Caparas,8,0,35,27
1657756343693,MATH 20C,A03,093476,Briones; Jor-el Thomas Caparas,0,1,36,36
1657756343693,MATH 20C,B01,083762,Bach; Quang Tran,1,0,30,29
1657756349718,MATH 20D,A01,083765,Tran; Brian Kha,5,0,30,25
1657756349718,MATH 20D,A02,083766,Tran; Brian Kha,5,0,30,25
1657756349718,MATH 20D,A03,083767,Tran; Brian Kha,5,0,30,25
1657756355749,MATH 20E,A01,083771,Ganguly; Soumya,9,0,32,23
1657756355749,MATH 20E,A02,083772,Ganguly; Soumya,6,0,32,26
1657756355749,MATH 20E,B01,083773,Ciotti; Benjamin,20,0,35,15
1657756355749,MATH 20E,B02,083774,Ciotti; Benjamin,18,0,35,17
1657756361773,MATH 103A,A01,083777,Greenfeld; Be'Eri,3,0,36,33
1657756361773,MATH 103A,A02,083778,Greenfeld; Be'Eri,5,0,36,31
1657756361773,MATH 103A,A03,093561,Greenfeld; Be'Eri,6,0,36,30
1657756361773,MATH 103A,B01,083779,Greenfeld; Be'Eri,7,0,36,29
1657756361773,MATH 103A,B02,083780,Greenfeld; Be'Eri,4,0,36,32
1657756361773,MATH 103A,B03,093562,Greenfeld; Be'Eri,3,0,36,33
1657756367800,MATH 105,A01,085443,Carter; Anne Toulson,15,0,35,20
1657756367800,MATH 105,A02,093477,Carter; Anne Toulson,20,0,35,15
1657756373823,MATH 109,A01,083213,Ganzberger; Geoffrey Michael,3,0,34,31
1657756373823,MATH 109,A02,083214,Ganzberger; Geoffrey Michael,4,0,34,30
1657756373823,MATH 109,A03,093478,Ganzberger; Geoffrey Michael,2,0,34,32
1657756373823,MATH 109,B01,083215,Ganzberger; Geoffrey Michael,1,0,32,31
1657756373823,MATH 109,B02,083216,Ganzberger; Geoffrey Michael,2,0,32,30
1657756373823,MATH 109,B03,093479,Ganzberger; Geoffrey Michael,8,0,32,24
1657756379852,MATH 142A,A01,083219,Chow; Bennett,7,0,32,25
1657756379852,MATH 142A,A02,083220,Chow; Bennett,10,0,32,22
1657756379852,MATH 142A,A03,093480,Chow; Bennett,9,0,32,23
1657756379852,MATH 142A,B03,093481,Chow; Bennett,8,0,32,24
1657756379852,MATH 142A,B04,093558,Chow; Bennett,13,0,32,19
1657756379852,MATH 142A,B05,093559,Chow; Bennett,6,0,32,26
1657756385880,MATH 193A,A01,083224,Rotar; Vladimir,8,0,34,26
1657756385880,MATH 193A,A02,083225,Rotar; Vladimir,9,0,34,25
1657756385880,MATH 193A,A03,083781,Rotar; Vladimir,5,0,34,29
1657756385880,MATH 193A,A04,083782,Rotar; Vladimir,10,0,34,24
1657756385880,MATH 193A,A05,093482,Rotar; Vladimir,10,0,34,24
1657756391902,MATH 197,001,091859,McAuley; Julian John,9999,0,9999,0
1657756391902,MATH 197,002,095566,Kedlaya; Kiran S.,9997,0,9999,2
1657756391902,MATH 197,003,095567,Xiao; Ming,9999,0,9999,0
1657756391902,MATH 197,004,095571,Perols; Johan Lars,9998,0,9999,1
1657756398955,COGS 9,A01,083615,Shannon; Kyle Michael,9,0,75,66
1657756404985,COGS 11,A01,083617,Boyle; Mary E. T.,23,0,48,25
1657756411007,COGS 13,A01,083071,Bastos; Amalia Pinkusfeld,11,0,71,60
1657756417040,COGS 14A,A01,092681,Semenuks; Arturs,5,1,100,95
1657756423066,COGS 14B,A01,083073,Cheng; Tzu-Han,6,0,63,57
1657756429092,COGS 17,A01,092677,Semenuks; Arturs,6,0,81,75
1657756435118,COGS 100,A01,083619,Allen; Michael Gordon,17,0,70,53
1657756441144,COGS 101A,A01,083621,Davis; Joshua Daniel,9,0,68,59
1657756447183,COGS 101B,A01,091572,Allen; Michael Gordon,12,0,65,53
1657756453207,COGS 101C,A01,083625,Delgado; Tania,17,0,35,18
1657756459234,COGS 107A,A01,083627,Boyle; Mary E. T.,13,0,60,47
1657756465256,COGS 118A,A01,083075,Gupta; Anjum,21,0,76,55
1657756471282,CSE 3,A50,083646,Miranda; Gregory Joseph,24,0,50,26
1657756477308,CSE 8A,A50,083650,Miranda; Gregory Joseph,17,1,56,39
1657756483335,CSE 11,A01,083080,Cao; Yingjun,6,15,40,34
1657756489359,CSE 12,A01,083652,Krause-Levy; Sophia Louisa,28,1,120,92
1657756495380,CSE 15L,A01,083654,Morris; Justin Loren,9,0,50,41
1657756495380,CSE 15L,A02,083655,Morris; Justin Loren,9,0,50,41
1657756501403,CSE 20,A01,083657,Tran; Khoa Dang,39,0,80,41
1657756507430,CSE 21,A01,095574,Bach; Quang Tran,22,0,48,26
1657756513451,CSE 30,A01,083084,Eldon; John,6,0,80,74
1657756513451,CSE 30,B01,095061,Bhaskar; Nishant,9,0,50,41
1657756519473,CSE 100,A01,083659,Cao; Yingjun,5,4,70,65
1657756525495,CSE 134B,A01,083661,Powell; Thomas Allan,24,0,100,76
1657756531527,CSE 140,A01,083663,Gungor; Onat,15,0,85,70
1657756543516,CSE 140L,A01,083088,Eldon; John,23,0,100,77
1657756549542,CSE 175,A01,083665,Kumar; Rakesh,3,0,25,22
1657756555569,CSE 190,A00,092507,Dubnov; Shlomo,8,0,20,12
1657756561601,ECE 45,A01,083139,Congero; Spencer William,6,0,75,69
1657756567622,ECE 65,A50,083695,Saad; Andrew S,12,0,30,18
1657756567622,ECE 65,A51,095125,Saad; Andrew S,24,0,26,2
1657756573645,ECE 109,A01,091882,Touri; Behrouz,20,0,70,50
1657756579668,ECE 180,A00,083140,Abi Samra; Nicholas Camill,1,0,30,29
1657756579668,ECE 180,B00,083141,Abi Samra; Nicholas Camill,0,0,30,30
1657756585689,MATH 10A,A01,083735,Patchell; Gregory David,2,0,30,28
1657756585689,MATH 10A,A02,083736,Patchell; Gregory David,20,0,30,10
1657756585689,MATH 10A,A03,083737,Patchell; Gregory David,16,0,30,14
1657756591718,MATH 10B,A01,083207,Lim; Seonhee,8,0,34,26
1657756591718,MATH 10B,A02,083208,Lim; Seonhee,9,0,35,26
1657756591718,MATH 10B,A03,093472,Lim; Seonhee,7,0,34,27
1657756591718,MATH 10B,B01,083739,Sinha; Shubham,13,0,30,17
1657756597748,MATH 18,A01,083743,Cinel; Cameron Alexander,9,0,30,21
1657756597748,MATH 18,A02,083744,Cinel; Cameron Alexander,18,0,30,12
1657756597748,MATH 18,A03,083745,Cinel; Cameron Alexander,10,0,30,20
1657756597748,MATH 18,B01,083748,Rideout; David Porter,5,0,37,32
1657756597748,MATH 18,B02,083749,Rideout; David Porter,5,0,36,31
1657756597748,MATH 18,B03,083750,Rideout; David Porter,3,0,37,34
1657756597748,MATH 18,B04,083751,Rideout; David Porter,6,0,36,30
1657756597748,MATH 18,B05,093473,Rideout; David Porter,6,0,36,30
1657756597748,MATH 18,B06,093474,Rideout; David Porter,6,0,36,30
1657756603777,MATH 20A,A01,083754,Zheng; Zequn,14,0,40,26
1657756609802,MATH 20B,A01,083756,Briones; Jor-el Thomas Caparas,4,0,36,32
1657756609802,MATH 20B,A02,083757,Briones; Jor-el Thomas Caparas,1,0,36,35
1657756609802,MATH 20B,A03,093475,Briones; Jor-el Thomas Caparas,2,0,36,34
1657756615831,MATH 20C,A01,083760,Briones; Jor-el Thomas Caparas,1,0,35,34
1657756615831,MATH 20C,A02,083761,Briones; Jor-el Thomas Caparas,8,0,35,27
1657756615831,MATH 20C,A03,093476,Briones; Jor-el Thomas Caparas,0,1,36,36
1657756615831,MATH 20C,B01,083762,Bach; Quang Tran,1,0,30,29
1657756621860,MATH 20D,A01,083765,Tran; Brian Kha,5,0,30,25
1657756621860,MATH 20D,A02,083766,Tran; Brian Kha,5,0,30,25
1657756621860,MATH 20D,A03,083767,Tran; Brian Kha,5,0,30,25
1657756627889,MATH 20E,A01,083771,Ganguly; Soumya,9,0,32,23
1657756627889,MATH 20E,A02,083772,Ganguly; Soumya,6,0,32,26
1657756627889,MATH 20E,B01,083773,Ciotti; Benjamin,20,0,35,15
1657756627889,MATH 20E,B02,083774,Ciotti; Benjamin,18,0,35,17
1657756633913,MATH 103A,A01,083777,Greenfeld; Be'Eri,3,0,36,33
1657756633913,MATH 103A,A02,083778,Greenfeld; Be'Eri,5,0,36,31
1657756633913,MATH 103A,A03,093561,Greenfeld; Be'Eri,6,0,36,30
1657756633913,MATH 103A,B01,083779,Greenfeld; Be'Eri,7,0,36,29
1657756633913,MATH 103A,B02,083780,Greenfeld; Be'Eri,4,0,36,32
1657756633913,MATH 103A,B03,093562,Greenfeld; Be'Eri,3,0,36,33
1657756639934,MATH 105,A01,085443,Carter; Anne Toulson,15,0,35,20
1657756639934,MATH 105,A02,093477,Carter; Anne Toulson,20,0,35,15
1657756645961,MATH 109,A01,083213,Ganzberger; Geoffrey Michael,3,0,34,31
1657756645961,MATH 109,A02,083214,Ganzberger; Geoffrey Michael,4,0,34,30
1657756645961,MATH 109,A03,093478,Ganzberger; Geoffrey Michael,2,0,34,32
1657756645961,MATH 109,B01,083215,Ganzberger; Geoffrey Michael,1,0,32,31
1657756645961,MATH 109,B02,083216,Ganzberger; Geoffrey Michael,2,0,32,30
1657756645961,MATH 109,B03,093479,Ganzberger; Geoffrey Michael,8,0,32,24
1657756651985,MATH 142A,A01,083219,Chow; Bennett,7,0,32,25
1657756651985,MATH 142A,A02,083220,Chow; Bennett,10,0,32,22
1657756651985,MATH 142A,A03,093480,Chow; Bennett,9,0,32,23
1657756651985,MATH 142A,B03,093481,Chow; Bennett,8,0,32,24
1657756651985,MATH 142A,B04,093558,Chow; Bennett,13,0,32,19
1657756651985,MATH 142A,B05,093559,Chow; Bennett,6,0,32,26
1657756658011,MATH 193A,A01,083224,Rotar; Vladimir,8,0,34,26
1657756658011,MATH 193A,A02,083225,Rotar; Vladimir,9,0,34,25
1657756658011,MATH 193A,A03,083781,Rotar; Vladimir,5,0,34,29
1657756658011,MATH 193A,A04,083782,Rotar; Vladimir,10,0,34,24
1657756658011,MATH 193A,A05,093482,Rotar; Vladimir,10,0,34,24
1657756664034,MATH 197,001,091859,McAuley; Julian John,9999,0,9999,0
1657756664034,MATH 197,002,095566,Kedlaya; Kiran S.,9997,0,9999,2
1657756664034,MATH 197,003,095567,Xiao; Ming,9999,0,9999,0
1657756664034,MATH 197,004,095571,Perols; Johan Lars,9998,0,9999,1
1657756671095,COGS 9,A01,083615,Shannon; Kyle Michael,9,0,75,66
1657756677118,COGS 11,A01,083617,Boyle; Mary E. T.,23,0,48,25
1657756683142,COGS 13,A01,083071,Bastos; Amalia Pinkusfeld,11,0,71,60
1657756689165,COGS 14A,A01,092681,Semenuks; Arturs,5,1,100,95
1657756695192,COGS 14B,A01,083073,Cheng; Tzu-Han,6,0,63,57
1657756701216,COGS 17,A01,092677,Semenuks; Arturs,6,0,81,75
1657756707239,COGS 100,A01,083619,Allen; Michael Gordon,17,0,70,53
1657756713265,COGS 101A,A01,083621,Davis; Joshua Daniel,9,0,68,59
1657756719299,COGS 101B,A01,091572,Allen; Michael Gordon,12,0,65,53
1657756725326,COGS 101C,A01,083625,Delgado; Tania,17,0,35,18
1657756731349,COGS 107A,A01,083627,Boyle; Mary E. T.,13,0,60,47
1657756737383,COGS 118A,A01,083075,Gupta; Anjum,21,0,76,55
1657756743419,CSE 3,A50,083646,Miranda; Gregory Joseph,24,0,50,26
1657756749446,CSE 8A,A50,083650,Miranda; Gregory Joseph,17,1,56,39
1657756755471,CSE 11,A01,083080,Cao; Yingjun,6,15,40,34
1657756761507,CSE 12,A01,083652,Krause-Levy; Sophia Louisa,28,1,120,92
1657756767534,CSE 15L,A01,083654,Morris; Justin Loren,9,0,50,41
1657756767534,CSE 15L,A02,083655,Morris; Justin Loren,9,0,50,41
1657756773560,CSE 20,A01,083657,Tran; Khoa Dang,39,0,80,41
1657756779584,CSE 21,A01,095574,Bach; Quang Tran,22,0,48,26
1657756785606,CSE 30,A01,083084,Eldon; John,6,0,80,74
1657756785606,CSE 30,B01,095061,Bhaskar; Nishant,9,0,50,41
1657756791628,CSE 100,A01,083659,Cao; Yingjun,5,4,70,65
1657756797654,CSE 134B,A01,083661,Powell; Thomas Allan,24,0,100,76
1657756803681,CSE 140,A01,083663,Gungor; Onat,15,0,85,70
1657756809706,CSE 140L,A01,083088,Eldon; John,23,0,100,77
1657756815728,CSE 175,A01,083665,Kumar; Rakesh,3,0,25,22
1657756821750,CSE 190,A00,092507,Dubnov; Shlomo,8,0,20,12
1657756827773,ECE 45,A01,083139,Congero; Spencer William,6,0,75,69
1657756833794,ECE 65,A50,083695,Saad; Andrew S,12,0,30,18
1657756833794,ECE 65,A51,095125,Saad; Andrew S,24,0,26,2
1657756839821,ECE 109,A01,091882,Touri; Behrouz,20,0,70,50
1657756845843,ECE 180,A00,083140,Abi Samra; Nicholas Camill,1,0,30,29
1657756845843,ECE 180,B00,083141,Abi Samra; Nicholas Camill,0,0,30,30
1657756851872,MATH 10A,A01,083735,Patchell; Gregory David,2,0,30,28
1657756851872,MATH 10A,A02,083736,Patchell; Gregory David,20,0,30,10
1657756851872,MATH 10A,A03,083737,Patchell; Gregory David,16,0,30,14
1657756857894,MATH 10B,A01,083207,Lim; Seonhee,8,0,34,26
1657756857894,MATH 10B,A02,083208,Lim; Seonhee,9,0,35,26
1657756857894,MATH 10B,A03,093472,Lim; Seonhee,7,0,34,27
1657756857894,MATH 10B,B01,083739,Sinha; Shubham,13,0,30,17
1657756863934,MATH 18,A01,083743,Cinel; Cameron Alexander,9,0,30,21
1657756863934,MATH 18,A02,083744,Cinel; Cameron Alexander,18,0,30,12
1657756863934,MATH 18,A03,083745,Cinel; Cameron Alexander,10,0,30,20
1657756863934,MATH 18,B01,083748,Rideout; David Porter,5,0,37,32
1657756863934,MATH 18,B02,083749,Rideout; David Porter,5,0,36,31
1657756863934,MATH 18,B03,083750,Rideout; David Porter,3,0,37,34
1657756863934,MATH 18,B04,083751,Rideout; David Porter,6,0,36,30
1657756863934,MATH 18,B05,093473,Rideout; David Porter,6,0,36,30
1657756863934,MATH 18,B06,093474,Rideout; David Porter,6,0,36,30
1657756870045,MATH 20A,A01,083754,Zheng; Zequn,14,0,40,26
1657756876067,MATH 20B,A01,083756,Briones; Jor-el Thomas Caparas,4,0,36,32
1657756876067,MATH 20B,A02,083757,Briones; Jor-el Thomas Caparas,1,0,36,35
1657756876067,MATH 20B,A03,093475,Briones; Jor-el Thomas Caparas,2,0,36,34
1657756882096,MATH 20C,A01,083760,Briones; Jor-el Thomas Caparas,1,0,35,34
1657756882096,MATH 20C,A02,083761,Briones; Jor-el Thomas Caparas,8,0,35,27
1657756882096,MATH 20C,A03,093476,Briones; Jor-el Thomas Caparas,0,1,36,36
1657756882096,MATH 20C,B01,083762,Bach; Quang Tran,1,0,30,29
1657756888118,MATH 20D,A01,083765,Tran; Brian Kha,5,0,30,25
1657756888118,MATH 20D,A02,083766,Tran; Brian Kha,5,0,30,25
1657756888118,MATH 20D,A03,083767,Tran; Brian Kha,5,0,30,25
1657756894141,MATH 20E,A01,083771,Ganguly; Soumya,9,0,32,23
1657756894141,MATH 20E,A02,083772,Ganguly; Soumya,6,0,32,26
1657756894141,MATH 20E,B01,083773,Ciotti; Benjamin,20,0,35,15
1657756894141,MATH 20E,B02,083774,Ciotti; Benjamin,18,0,35,17
1657756900176,MATH 103A,A01,083777,Greenfeld; Be'Eri,3,0,36,33
1657756900176,MATH 103A,A02,083778,Greenfeld; Be'Eri,5,0,36,31
1657756900176,MATH 103A,A03,093561,Greenfeld; Be'Eri,6,0,36,30
1657756900176,MATH 103A,B01,083779,Greenfeld; Be'Eri,7,0,36,29
1657756900176,MATH 103A,B02,083780,Greenfeld; Be'Eri,4,0,36,32
1657756900176,MATH 103A,B03,093562,Greenfeld; Be'Eri,3,0,36,33
1657756906204,MATH 105,A01,085443,Carter; Anne Toulson,15,0,35,20
1657756906204,MATH 105,A02,093477,Carter; Anne Toulson,20,0,35,15
1657756912227,MATH 109,A01,083213,Ganzberger; Geoffrey Michael,3,0,34,31
1657756912227,MATH 109,A02,083214,Ganzberger; Geoffrey Michael,4,0,34,30
1657756912227,MATH 109,A03,093478,Ganzberger; Geoffrey Michael,2,0,34,32
1657756912227,MATH 109,B01,083215,Ganzberger; Geoffrey Michael,1,0,32,31
1657756912227,MATH 109,B02,083216,Ganzberger; Geoffrey Michael,2,0,32,30
1657756912227,MATH 109,B03,093479,Ganzberger; Geoffrey Michael,8,0,32,24
1657756918261,MATH 142A,A01,083219,Chow; Bennett,7,0,32,25
1657756918261,MATH 142A,A02,083220,Chow; Bennett,10,0,32,22
1657756918261,MATH 142A,A03,093480,Chow; Bennett,9,0,32,23
1657756918261,MATH 142A,B03,093481,Chow; Bennett,8,0,32,24
1657756918261,MATH 142A,B04,093558,Chow; Bennett,13,0,32,19
1657756918261,MATH 142A,B05,093559,Chow; Bennett,6,0,32,26
1657756924288,MATH 193A,A01,083224,Rotar; Vladimir,8,0,34,26
1657756924288,MATH 193A,A02,083225,Rotar; Vladimir,9,0,34,25
1657756924288,MATH 193A,A03,083781,Rotar; Vladimir,5,0,34,29
1657756924288,MATH 193A,A04,083782,Rotar; Vladimir,10,0,34,24
1657756924288,MATH 193A,A05,093482,Rotar; Vladimir,10,0,34,24
1657756930312,MATH 197,001,091859,McAuley; Julian John,9999,0,9999,0
1657756930312,MATH 197,002,095566,Kedlaya; Kiran S.,9997,0,9999,2
1657756930312,MATH 197,003,095567,Xiao; Ming,9999,0,9999,0
1657756930312,MATH 197,004,095571,Perols; Johan Lars,9998,0,9999,1
1657756937362,COGS 9,A01,083615,Shannon; Kyle Michael,9,0,75,66
1657756943385,COGS 11,A01,083617,Boyle; Mary E. T.,23,0,48,25
1657756949408,COGS 13,A01,083071,Bastos; Amalia Pinkusfeld,11,0,71,60
1657756955435,COGS 14A,A01,092681,Semenuks; Arturs,5,1,100,95
1657756961457,COGS 14B,A01,083073,Cheng; Tzu-Han,6,0,63,57
1657756967481,COGS 17,A01,092677,Semenuks; Arturs,6,0,81,75
1657756973514,COGS 100,A01,083619,Allen; Michael Gordon,17,0,70,53
1657756979536,COGS 101A,A01,083621,Davis; Joshua Daniel,9,0,68,59
1657756985568,COGS 101B,A01,091572,Allen; Michael Gordon,12,0,65,53
1657756991593,COGS 101C,A01,083625,Delgado; Tania,17,0,35,18
1657756997621,COGS 107A,A01,083627,Boyle; Mary E. T.,13,0,60,47
1657757003649,COGS 118A,A01,083075,Gupta; Anjum,21,0,76,55
1657757009679,CSE 3,A50,083646,Miranda; Gregory Joseph,24,0,50,26
1657757015703,CSE 8A,A50,083650,Miranda; Gregory Joseph,17,1,56,39
1657757021727,CSE 11,A01,083080,Cao; Yingjun,6,15,40,34
1657757027750,CSE 12,A01,083652,Krause-Levy; Sophia Louisa,28,1,120,92
1657757033778,CSE 15L,A01,083654,Morris; Justin Loren,9,0,50,41
1657757033778,CSE 15L,A02,083655,Morris; Justin Loren,9,0,50,41
1657757039805,CSE 20,A01,083657,Tran; Khoa Dang,39,0,80,41
1657757045838,CSE 21,A01,095574,Bach; Quang Tran,22,0,48,26
1657757051862,CSE 30,A01,083084,Eldon; John,6,0,80,74
1657757051862,CSE 30,B01,095061,Bhaskar; Nishant,9,0,50,41
1657757057890,CSE 100,A01,083659,Cao; Yingjun,5,4,70,65
1657757063913,CSE 134B,A01,083661,Powell; Thomas Allan,24,0,100,76
1657757069937,CSE 140,A01,083663,Gungor; Onat,15,0,85,70
1657757075971,CSE 140L,A01,083088,Eldon; John,23,0,100,77
1657757081994,CSE 175,A01,083665,Kumar; Rakesh,3,0,25,22
1657757088019,CSE 190,A00,092507,Dubnov; Shlomo,8,0,20,12
1657757094046,ECE 45,A01,083139,Congero; Spencer William,6,0,75,69
1657757100080,ECE 65,A50,083695,Saad; Andrew S,12,0,30,18
1657757100080,ECE 65,A51,095125,Saad; Andrew S,24,0,26,2
1657757106102,ECE 109,A01,091882,Touri; Behrouz,20,0,70,50
1657757112127,ECE 180,A00,083140,Abi Samra; Nicholas Camill,1,0,30,29
1657757112127,ECE 180,B00,083141,Abi Samra; Nicholas Camill,0,0,30,30
1657757118149,MATH 10A,A01,083735,Patchell; Gregory David,2,0,30,28
1657757118149,MATH 10A,A02,083736,Patchell; Gregory David,20,0,30,10
1657757118149,MATH 10A,A03,083737,Patchell; Gregory David,16,0,30,14
1657757124173,MATH 10B,A01,083207,Lim; Seonhee,8,0,34,26
1657757124173,MATH 10B,A02,083208,Lim; Seonhee,9,0,35,26
1657757124173,MATH 10B,A03,093472,Lim; Seonhee,7,0,34,27
1657757124173,MATH 10B,B01,083739,Sinha; Shubham,13,0,30,17
1657757130202,MATH 18,A01,083743,Cinel; Cameron Alexander,9,0,30,21
1657757130202,MATH 18,A02,083744,Cinel; Cameron Alexander,18,0,30,12
1657757130202,MATH 18,A03,083745,Cinel; Cameron Alexander,10,0,30,20
1657757130202,MATH 18,B01,083748,Rideout; David Porter,5,0,37,32
1657757130202,MATH 18,B02,083749,Rideout; David Porter,5,0,36,31
1657757130202,MATH 18,B03,083750,Rideout; David Porter,3,0,37,34
1657757130202,MATH 18,B04,083751,Rideout; David Porter,6,0,36,30
1657757130202,MATH 18,B05,093473,Rideout; David Porter,6,0,36,30
1657757130202,MATH 18,B06,093474,Rideout; David Porter,6,0,36,30
1657757136230,MATH 20A,A01,083754,Zheng; Zequn,14,0,40,26
1657757142259,MATH 20B,A01,083756,Briones; Jor-el Thomas Caparas,4,0,36,32
1657757142259,MATH 20B,A02,083757,Briones; Jor-el Thomas Caparas,1,0,36,35
1657757142259,MATH 20B,A03,093475,Briones; Jor-el Thomas Caparas,2,0,36,34
1657757148283,MATH 20C,A01,083760,Briones; Jor-el Thomas Caparas,1,0,35,34
1657757148283,MATH 20C,A02,083761,Briones; Jor-el Thomas Caparas,8,0,35,27
1657757148283,MATH 20C,A03,093476,Briones; Jor-el Thomas Caparas,0,1,36,36
1657757148283,MATH 20C,B01,083762,Bach; Quang Tran,1,0,30,29
1657757154307,MATH 20D,A01,083765,Tran; Brian Kha,5,0,30,25
1657757154307,MATH 20D,A02,083766,Tran; Brian Kha,5,0,30,25
1657757154307,MATH 20D,A03,083767,Tran; Brian Kha,5,0,30,25
1657757160334,MATH 20E,A01,083771,Ganguly; Soumya,9,0,32,23
1657757160334,MATH 20E,A02,083772,Ganguly; Soumya,6,0,32,26
1657757160334,MATH 20E,B01,083773,Ciotti; Benjamin,20,0,35,15
1657757160334,MATH 20E,B02,083774,Ciotti; Benjamin,18,0,35,17
1657757166363,MATH 103A,A01,083777,Greenfeld; Be'Eri,3,0,36,33
1657757166363,MATH 103A,A02,083778,Greenfeld; Be'Eri,5,0,36,31
1657757166363,MATH 103A,A03,093561,Greenfeld; Be'Eri,6,0,36,30
1657757166363,MATH 103A,B01,083779,Greenfeld; Be'Eri,7,0,36,29
1657757166363,MATH 103A,B02,083780,Greenfeld; Be'Eri,4,0,36,32
1657757166363,MATH 103A,B03,093562,Greenfeld; Be'Eri,3,0,36,33
1657757172390,MATH 105,A01,085443,Carter; Anne Toulson,15,0,35,20
1657757172390,MATH 105,A02,093477,Carter; Anne Toulson,20,0,35,15
1657757178414,MATH 109,A01,083213,Ganzberger; Geoffrey Michael,3,0,34,31
1657757178414,MATH 109,A02,083214,Ganzberger; Geoffrey Michael,4,0,34,30
1657757178414,MATH 109,A03,093478,Ganzberger; Geoffrey Michael,2,0,34,32
1657757178414,MATH 109,B01,083215,Ganzberger; Geoffrey Michael,1,0,32,31
1657757178414,MATH 109,B02,083216,Ganzberger; Geoffrey Michael,2,0,32,30
1657757178414,MATH 109,B03,093479,Ganzberger; Geoffrey Michael,8,0,32,24
1657757184437,MATH 142A,A01,083219,Chow; Bennett,7,0,32,25
1657757184437,MATH 142A,A02,083220,Chow; Bennett,10,0,32,22
1657757184437,MATH 142A,A03,093480,Chow; Bennett,9,0,32,23
1657757184437,MATH 142A,B03,093481,Chow; Bennett,8,0,32,24
1657757184437,MATH 142A,B04,093558,Chow; Bennett,13,0,32,19
1657757184437,MATH 142A,B05,093559,Chow; Bennett,6,0,32,26
1657757190460,MATH 193A,A01,083224,Rotar; Vladimir,8,0,34,26
1657757190460,MATH 193A,A02,083225,Rotar; Vladimir,9,0,34,25
1657757190460,MATH 193A,A03,083781,Rotar; Vladimir,5,0,34,29
1657757190460,MATH 193A,A04,083782,Rotar; Vladimir,10,0,34,24
1657757190460,MATH 193A,A05,093482,Rotar; Vladimir,10,0,34,24
1657757196483,MATH 197,001,091859,McAuley; Julian John,9999,0,9999,0
1657757196483,MATH 197,002,095566,Kedlaya; Kiran S.,9997,0,9999,2
1657757196483,MATH 197,003,095567,Xiao; Ming,9999,0,9999,0
1657757196483,MATH 197,004,095571,Perols; Johan Lars,9998,0,9999,1
1657757203544,COGS 9,A01,083615,Shannon; Kyle Michael,9,0,75,66
1657757209573,COGS 11,A01,083617,Boyle; Mary E. T.,23,0,48,25
1657757215599,COGS 13,A01,083071,Bastos; Amalia Pinkusfeld,11,0,71,60
1657757221626,COGS 14A,A01,092681,Semenuks; Arturs,5,1,100,95
1657757227654,COGS 14B,A01,083073,Cheng; Tzu-Han,6,0,63,57
1657757233684,COGS 17,A01,092677,Semenuks; Arturs,6,0,81,75
1657757239706,COGS 100,A01,083619,Allen; Michael Gordon,17,0,70,53
1657757245728,COGS 101A,A01,083621,Davis; Joshua Daniel,9,0,68,59
1657757251751,COGS 101B,A01,091572,Allen; Michael Gordon,12,0,65,53
1657757257773,COGS 101C,A01,083625,Delgado; Tania,17,0,35,18
1657757263796,COGS 107A,A01,083627,Boyle; Mary E. T.,13,0,60,47
1657757269819,COGS 118A,A01,083075,Gupta; Anjum,21,0,76,55
1657757275859,CSE 3,A50,083646,Miranda; Gregory Joseph,24,0,50,26
1657757281883,CSE 8A,A50,083650,Miranda; Gregory Joseph,17,1,56,39
1657757287905,CSE 11,A01,083080,Cao; Yingjun,6,15,40,34
1657757293932,CSE 12,A01,083652,Krause-Levy; Sophia Louisa,28,1,120,92
1657757299958,CSE 15L,A01,083654,Morris; Justin Loren,9,0,50,41
1657757299958,CSE 15L,A02,083655,Morris; Justin Loren,9,0,50,41
1657757305990,CSE 20,A01,083657,Tran; Khoa Dang,39,0,80,41
1657757312020,CSE 21,A01,095574,Bach; Quang Tran,22,0,48,26
1657757318049,CSE 30,A01,083084,Eldon; John,6,0,80,74
1657757318049,CSE 30,B01,095061,Bhaskar; Nishant,9,0,50,41
1657757324088,CSE 100,A01,083659,Cao; Yingjun,5,4,70,65
1657757330112,CSE 134B,A01,083661,Powell; Thomas Allan,24,0,100,76
1657757336143,CSE 140,A01,083663,Gungor; Onat,15,0,85,70
1657757342165,CSE 140L,A01,083088,Eldon; John,23,0,100,77
1657757348187,CSE 175,A01,083665,Kumar; Rakesh,3,0,25,22
1657757354214,CSE 190,A00,092507,Dubnov; Shlomo,8,0,20,12
1657757360238,ECE 45,A01,083139,Congero; Spencer William,6,0,75,69
1657757366267,ECE 65,A50,083695,Saad; Andrew S,12,0,30,18
1657757366267,ECE 65,A51,095125,Saad; Andrew S,24,0,26,2
1657757372290,ECE 109,A01,091882,Touri; Behrouz,20,0,70,50
1657757378315,ECE 180,A00,083140,Abi Samra; Nicholas Camill,1,0,30,29
1657757378315,ECE 180,B00,083141,Abi Samra; Nicholas Camill,0,0,30,30
1657757384341,MATH 10A,A01,083735,Patchell; Gregory David,2,0,30,28
1657757384341,MATH 10A,A02,083736,Patchell; Gregory David,20,0,30,10
1657757384341,MATH 10A,A03,083737,Patchell; Gregory David,16,0,30,14
1657757390365,MATH 10B,A01,083207,Lim; Seonhee,8,0,34,26
1657757390365,MATH 10B,A02,083208,Lim; Seonhee,9,0,35,26
1657757390365,MATH 10B,A03,093472,Lim; Seonhee,7,0,34,27
1657757390365,MATH 10B,B01,083739,Sinha; Shubham,13,0,30,17
1657757396391,MATH 18,A01,083743,Cinel; Cameron Alexander,9,0,30,21
1657757396391,MATH 18,A02,083744,Cinel; Cameron Alexander,18,0,30,12
1657757396391,MATH 18,A03,083745,Cinel; Cameron Alexander,10,0,30,20
1657757396391,MATH 18,B01,083748,Rideout; David Porter,5,0,37,32
1657757396391,MATH 18,B02,083749,Rideout; David Porter,5,0,36,31
1657757396391,MATH 18,B03,083750,Rideout; David Porter,3,0,37,34
1657757396391,MATH 18,B04,083751,Rideout; David Porter,6,0,36,30
1657757396391,MATH 18,B05,093473,Rideout; David Porter,6,0,36,30
1657757396391,MATH 18,B06,093474,Rideout; David Porter,6,0,36,30
1657757402415,MATH 20A,A01,083754,Zheng; Zequn,14,0,40,26
1657757408438,MATH 20B,A01,083756,Briones; Jor-el Thomas Caparas,4,0,36,32
1657757408438,MATH 20B,A02,083757,Briones; Jor-el Thomas Caparas,1,0,36,35
1657757408438,MATH 20B,A03,093475,Briones; Jor-el Thomas Caparas,2,0,36,34
1657757414468,MATH 20C,A01,083760,Briones; Jor-el Thomas Caparas,1,0,35,34
1657757414468,MATH 20C,A02,083761,Briones; Jor-el Thomas Caparas,8,0,35,27
1657757414468,MATH 20C,A03,093476,Briones; Jor-el Thomas Caparas,0,1,36,36
1657757414468,MATH 20C,B01,083762,Bach; Quang Tran,1,0,30,29
1657757420505,MATH 20D,A01,083765,Tran; Brian Kha,5,0,30,25
1657757420505,MATH 20D,A02,083766,Tran; Brian Kha,5,0,30,25
1657757420505,MATH 20D,A03,083767,Tran; Brian Kha,5,0,30,25
1657757426529,MATH 20E,A01,083771,Ganguly; Soumya,9,0,32,23
1657757426529,MATH 20E,A02,083772,Ganguly; Soumya,6,0,32,26
1657757426529,MATH 20E,B01,083773,Ciotti; Benjamin,20,0,35,15
1657757426529,MATH 20E,B02,083774,Ciotti; Benjamin,18,0,35,17
1657757432558,MATH 103A,A01,083777,Greenfeld; Be'Eri,3,0,36,33
1657757432558,MATH 103A,A02,083778,Greenfeld; Be'Eri,5,0,36,31
1657757432558,MATH 103A,A03,093561,Greenfeld; Be'Eri,6,0,36,30
1657757432558,MATH 103A,B01,083779,Greenfeld; Be'Eri,7,0,36,29
1657757432558,MATH 103A,B02,083780,Greenfeld; Be'Eri,4,0,36,32
1657757432558,MATH 103A,B03,093562,Greenfeld; Be'Eri,3,0,36,33
1657757438581,MATH 105,A01,085443,Carter; Anne Toulson,15,0,35,20
1657757438581,MATH 105,A02,093477,Carter; Anne Toulson,20,0,35,15
1657757444606,MATH 109,A01,083213,Ganzberger; Geoffrey Michael,3,0,34,31
1657757444606,MATH 109,A02,083214,Ganzberger; Geoffrey Michael,4,0,34,30
1657757444606,MATH 109,A03,093478,Ganzberger; Geoffrey Michael,2,0,34,32
1657757444606,MATH 109,B01,083215,Ganzberger; Geoffrey Michael,1,0,32,31
1657757444606,MATH 109,B02,083216,Ganzberger; Geoffrey Michael,2,0,32,30
1657757444606,MATH 109,B03,093479,Ganzberger; Geoffrey Michael,8,0,32,24
1657757450632,MATH 142A,A01,083219,Chow; Bennett,7,0,32,25
1657757450632,MATH 142A,A02,083220,Chow; Bennett,10,0,32,22
1657757450632,MATH 142A,A03,093480,Chow; Bennett,9,0,32,23
1657757450632,MATH 142A,B03,093481,Chow; Bennett,8,0,32,24
1657757450632,MATH 142A,B04,093558,Chow; Bennett,13,0,32,19
1657757450632,MATH 142A,B05,093559,Chow; Bennett,6,0,32,26
1657757456661,MATH 193A,A01,083224,Rotar; Vladimir,8,0,34,26
1657757456661,MATH 193A,A02,083225,Rotar; Vladimir,9,0,34,25
1657757456661,MATH 193A,A03,083781,Rotar; Vladimir,5,0,34,29
1657757456661,MATH 193A,A04,083782,Rotar; Vladimir,10,0,34,24
1657757456661,MATH 193A,A05,093482,Rotar; Vladimir,10,0,34,24
1657757462687,MATH 197,001,091859,McAuley; Julian John,9999,0,9999,0
1657757462687,MATH 197,002,095566,Kedlaya; Kiran S.,9997,0,9999,2
1657757462687,MATH 197,003,095567,Xiao; Ming,9999,0,9999,0
1657757462687,MATH 197,004,095571,Perols; Johan Lars,9998,0,9999,1
1657757469822,COGS 9,A01,083615,Shannon; Kyle Michael,9,0,75,66
1657757475850,COGS 11,A01,083617,Boyle; Mary E. T.,23,0,48,25
1657757481890,COGS 13,A01,083071,Bastos; Amalia Pinkusfeld,11,0,71,60
1657757487931,COGS 14A,A01,092681,Semenuks; Arturs,5,1,100,95
1657757493959,COGS 14B,A01,083073,Cheng; Tzu-Han,6,0,63,57
1657757499987,COGS 17,A01,092677,Semenuks; Arturs,6,0,81,75
1657757506012,COGS 100,A01,083619,Allen; Michael Gordon,17,0,70,53
1657757512047,COGS 101A,A01,083621,Davis; Joshua Daniel,9,0,68,59
1657757518070,COGS 101B,A01,091572,Allen; Michael Gordon,12,0,65,53
1657757524101,COGS 101C,A01,083625,Delgado; Tania,17,0,35,18
1657757530127,COGS 107A,A01,083627,Boyle; Mary E. T.,13,0,60,47
1657757536150,COGS 118A,A01,083075,Gupta; Anjum,21,0,76,55
1657757542175,CSE 3,A50,083646,Miranda; Gregory Joseph,24,0,50,26
1657757548199,CSE 8A,A50,083650,Miranda; Gregory Joseph,17,1,56,39
1657757554222,CSE 11,A01,083080,Cao; Yingjun,6,15,40,34
1657757560245,CSE 12,A01,083652,Krause-Levy; Sophia Louisa,28,1,120,92
1657757566278,CSE 15L,A01,083654,Morris; Justin Loren,9,0,50,41
1657757566278,CSE 15L,A02,083655,Morris; Justin Loren,9,0,50,41
1657757572312,CSE 20,A01,083657,Tran; Khoa Dang,39,0,80,41
1657757578337,CSE 21,A01,095574,Bach; Quang Tran,22,0,48,26
1657757584361,CSE 30,A01,083084,Eldon; John,6,0,80,74
1657757584361,CSE 30,B01,095061,Bhaskar; Nishant,9,0,50,41
1657757590384,CSE 100,A01,083659,Cao; Yingjun,5,4,70,65
1657757596407,CSE 134B,A01,083661,Powell; Thomas Allan,24,0,100,76
1657757602431,CSE 140,A01,083663,Gungor; Onat,15,0,85,70
1657757608454,CSE 140L,A01,083088,Eldon; John,23,0,100,77
1657757614477,CSE 175,A01,083665,Kumar; Rakesh,3,0,25,22
1657757620504,CSE 190,A00,092507,Dubnov; Shlomo,8,0,20,12
1657757626528,ECE 45,A01,083139,Congero; Spencer William,6,0,75,69
1657757632556,ECE 65,A50,083695,Saad; Andrew S,12,0,30,18
1657757632556,ECE 65,A51,095125,Saad; Andrew S,24,0,26,2
1657757638581,ECE 109,A01,091882,Touri; Behrouz,20,0,70,50
1657757644607,ECE 180,A00,083140,Abi Samra; Nicholas Camill,1,0,30,29
1657757644607,ECE 180,B00,083141,Abi Samra; Nicholas Camill,0,0,30,30
1657757650633,MATH 10A,A01,083735,Patchell; Gregory David,2,0,30,28
1657757650633,MATH 10A,A02,083736,Patchell; Gregory David,20,0,30,10
1657757650633,MATH 10A,A03,083737,Patchell; Gregory David,16,0,30,14
1657757656673,MATH 10B,A01,083207,Lim; Seonhee,8,0,34,26
1657757656673,MATH 10B,A02,083208,Lim; Seonhee,9,0,35,26
1657757656673,MATH 10B,A03,093472,Lim; Seonhee,7,0,34,27
1657757656673,MATH 10B,B01,083739,Sinha; Shubham,13,0,30,17
1657757662696,MATH 18,A01,083743,Cinel; Cameron Alexander,9,0,30,21
1657757662696,MATH 18,A02,083744,Cinel; Cameron Alexander,18,0,30,12
1657757662696,MATH 18,A03,083745,Cinel; Cameron Alexander,10,0,30,20
1657757662696,MATH 18,B01,083748,Rideout; David Porter,5,0,37,32
1657757662696,MATH 18,B02,083749,Rideout; David Porter,5,0,36,31
1657757662696,MATH 18,B03,083750,Rideout; David Porter,3,0,37,34
1657757662696,MATH 18,B04,083751,Rideout; David Porter,6,0,36,30
1657757662696,MATH 18,B05,093473,Rideout; David Porter,6,0,36,30
1657757662696,MATH 18,B06,093474,Rideout; David Porter,6,0,36,30
1657757668718,MATH 20A,A01,083754,Zheng; Zequn,14,0,40,26
1657757674749,MATH 20B,A01,083756,Briones; Jor-el Thomas Caparas,4,0,36,32
1657757674749,MATH 20B,A02,083757,Briones; Jor-el Thomas Caparas,1,0,36,35
1657757674749,MATH 20B,A03,093475,Briones; Jor-el Thomas Caparas,2,0,36,34
1657757680772,MATH 20C,A01,083760,Briones; Jor-el Thomas Caparas,1,0,35,34
1657757680772,MATH 20C,A02,083761,Briones; Jor-el Thomas Caparas,8,0,35,27
1657757680772,MATH 20C,A03,093476,Briones; Jor-el Thomas Caparas,0,1,36,36
1657757680772,MATH 20C,B01,083762,Bach; Quang Tran,1,0,30,29
1657757686794,MATH 20D,A01,083765,Tran; Brian Kha,5,0,30,25
1657757686794,MATH 20D,A02,083766,Tran; Brian Kha,5,0,30,25
1657757686794,MATH 20D,A03,083767,Tran; Brian Kha,5,0,30,25
1657757692817,MATH 20E,A01,083771,Ganguly; Soumya,9,0,32,23
1657757692817,MATH 20E,A02,083772,Ganguly; Soumya,6,0,32,26
1657757692817,MATH 20E,B01,083773,Ciotti; Benjamin,20,0,35,15
1657757692817,MATH 20E,B02,083774,Ciotti; Benjamin,18,0,35,17
1657757698846,MATH 103A,A01,083777,Greenfeld; Be'Eri,3,0,36,33
1657757698846,MATH 103A,A02,083778,Greenfeld; Be'Eri,5,0,36,31
1657757698846,MATH 103A,A03,093561,Greenfeld; Be'Eri,6,0,36,30
1657757698846,MATH 103A,B01,083779,Greenfeld; Be'Eri,7,0,36,29
1657757698846,MATH 103A,B02,083780,Greenfeld; Be'Eri,4,0,36,32
1657757698846,MATH 103A,B03,093562,Greenfeld; Be'Eri,3,0,36,33
1657757704871,MATH 105,A01,085443,Carter; Anne Toulson,15,0,35,20
1657757704871,MATH 105,A02,093477,Carter; Anne Toulson,20,0,35,15
1657757710896,MATH 109,A01,083213,Ganzberger; Geoffrey Michael,3,0,34,31
1657757710896,MATH 109,A02,083214,Ganzberger; Geoffrey Michael,4,0,34,30
1657757710896,MATH 109,A03,093478,Ganzberger; Geoffrey Michael,2,0,34,32
1657757710896,MATH 109,B01,083215,Ganzberger; Geoffrey Michael,1,0,32,31
1657757710896,MATH 109,B02,083216,Ganzberger; Geoffrey Michael,2,0,32,30
1657757710896,MATH 109,B03,093479,Ganzberger; Geoffrey Michael,8,0,32,24
1657757716919,MATH 142A,A01,083219,Chow; Bennett,7,0,32,25
1657757716919,MATH 142A,A02,083220,Chow; Bennett,10,0,32,22
1657757716919,MATH 142A,A03,093480,Chow; Bennett,9,0,32,23
1657757716919,MATH 142A,B03,093481,Chow; Bennett,8,0,32,24
1657757716919,MATH 142A,B04,093558,Chow; Bennett,13,0,32,19
1657757716919,MATH 142A,B05,093559,Chow; Bennett,6,0,32,26
1657757722946,MATH 193A,A01,083224,Rotar; Vladimir,8,0,34,26
1657757722946,MATH 193A,A02,083225,Rotar; Vladimir,9,0,34,25
1657757722946,MATH 193A,A03,083781,Rotar; Vladimir,5,0,34,29
1657757722946,MATH 193A,A04,083782,Rotar; Vladimir,10,0,34,24
1657757722946,MATH 193A,A05,093482,Rotar; Vladimir,10,0,34,24
1657757728969,MATH 197,001,091859,McAuley; Julian John,9999,0,9999,0
1657757728969,MATH 197,002,095566,Kedlaya; Kiran S.,9997,0,9999,2
1657757728969,MATH 197,003,095567,Xiao; Ming,9999,0,9999,0
1657757728969,MATH 197,004,095571,Perols; Johan Lars,9998,0,9999,1
1657757736033,COGS 9,A01,083615,Shannon; Kyle Michael,9,0,75,66
1657757742060,COGS 11,A01,083617,Boyle; Mary E. T.,23,0,48,25
1657757748090,COGS 13,A01,083071,Bastos; Amalia Pinkusfeld,11,0,71,60
1657757754118,COGS 14A,A01,092681,Semenuks; Arturs,5,1,100,95
1657757760141,COGS 14B,A01,083073,Cheng; Tzu-Han,6,0,63,57
1657757766170,COGS 17,A01,092677,Semenuks; Arturs,6,0,81,75
1657757772197,COGS 100,A01,083619,Allen; Michael Gordon,17,0,70,53
1657757778225,COGS 101A,A01,083621,Davis; Joshua Daniel,9,0,68,59
1657757784252,COGS 101B,A01,091572,Allen; Michael Gordon,12,0,65,53
1657757790274,COGS 101C,A01,083625,Delgado; Tania,17,0,35,18
1657757796297,COGS 107A,A01,083627,Boyle; Mary E. T.,13,0,60,47
1657757802321,COGS 118A,A01,083075,Gupta; Anjum,21,0,76,55
1657757808348,CSE 3,A50,083646,Miranda; Gregory Joseph,24,0,50,26
1657757814372,CSE 8A,A50,083650,Miranda; Gregory Joseph,17,1,56,39
1657757820476,CSE 11,A01,083080,Cao; Yingjun,6,15,40,34
1657757826513,CSE 12,A01,083652,Krause-Levy; Sophia Louisa,28,1,120,92
1657757832539,CSE 15L,A01,083654,Morris; Justin Loren,9,0,50,41
1657757832539,CSE 15L,A02,083655,Morris; Justin Loren,9,0,50,41
1657757838566,CSE 20,A01,083657,Tran; Khoa Dang,39,0,80,41
1657757844593,CSE 21,A01,095574,Bach; Quang Tran,22,0,48,26
1657757850621,CSE 30,A01,083084,Eldon; John,6,0,80,74
1657757850621,CSE 30,B01,095061,Bhaskar; Nishant,9,0,50,41
1657757856644,CSE 100,A01,083659,Cao; Yingjun,5,4,70,65
1657757862671,CSE 134B,A01,083661,Powell; Thomas Allan,24,0,100,76
1657757868692,CSE 140,A01,083663,Gungor; Onat,15,0,85,70
1657757874719,CSE 140L,A01,083088,Eldon; John,23,0,100,77
1657757880745,CSE 175,A01,083665,Kumar; Rakesh,3,0,25,22
1657757886775,CSE 190,A00,092507,Dubnov; Shlomo,8,0,20,12
1657757892797,ECE 45,A01,083139,Congero; Spencer William,6,0,75,69
1657757898822,ECE 65,A50,083695,Saad; Andrew S,12,0,30,18
1657757898822,ECE 65,A51,095125,Saad; Andrew S,24,0,26,2
1657757904848,ECE 109,A01,091882,Touri; Behrouz,20,0,70,50
1657757910878,ECE 180,A00,083140,Abi Samra; Nicholas Camill,1,0,30,29
1657757910878,ECE 180,B00,083141,Abi Samra; Nicholas Camill,0,0,30,30
1657757916918,MATH 10A,A01,083735,Patchell; Gregory David,2,0,30,28
1657757916918,MATH 10A,A02,083736,Patchell; Gregory David,20,0,30,10
1657757916918,MATH 10A,A03,083737,Patchell; Gregory David,16,0,30,14
1657757922942,MATH 10B,A01,083207,Lim; Seonhee,8,0,34,26
1657757922942,MATH 10B,A02,083208,Lim; Seonhee,9,0,35,26
1657757922942,MATH 10B,A03,093472,Lim; Seonhee,7,0,34,27
1657757922942,MATH 10B,B01,083739,Sinha; Shubham,13,0,30,17
1657757928967,MATH 18,A01,083743,Cinel; Cameron Alexander,9,0,30,21
1657757928967,MATH 18,A02,083744,Cinel; Cameron Alexander,18,0,30,12
1657757928967,MATH 18,A03,083745,Cinel; Cameron Alexander,10,0,30,20
1657757928967,MATH 18,B01,083748,Rideout; David Porter,5,0,37,32
1657757928967,MATH 18,B02,083749,Rideout; David Porter,5,0,36,31
1657757928967,MATH 18,B03,083750,Rideout; David Porter,3,0,37,34
1657757928967,MATH 18,B04,083751,Rideout; David Porter,6,0,36,30
1657757928967,MATH 18,B05,093473,Rideout; David Porter,6,0,36,30
1657757928967,MATH 18,B06,093474,Rideout; David Porter,6,0,36,30
1657757934992,MATH 20A,A01,083754,Zheng; Zequn,14,0,40,26
1657757941018,MATH 20B,A01,083756,Briones; Jor-el Thomas Caparas,4,0,36,32
1657757941018,MATH 20B,A02,083757,Briones; Jor-el Thomas Caparas,1,0,36,35
1657757941018,MATH 20B,A03,093475,Briones; Jor-el Thomas Caparas,2,0,36,34
1657757947046,MATH 20C,A01,083760,Briones; Jor-el Thomas Caparas,1,0,35,34
1657757947046,MATH 20C,A02,083761,Briones; Jor-el Thomas Caparas,8,0,35,27
1657757947046,MATH 20C,A03,093476,Briones; Jor-el Thomas Caparas,0,1,36,36
1657757947046,MATH 20C,B01,083762,Bach; Quang Tran,1,0,30,29
1657757953074,MATH 20D,A01,083765,Tran; Brian Kha,5,0,30,25
1657757953074,MATH 20D,A02,083766,Tran; Brian Kha,5,0,30,25
1657757953074,MATH 20D,A03,083767,Tran; Brian Kha,5,0,30,25
1657757959098,MATH 20E,A01,083771,Ganguly; Soumya,9,0,32,23
1657757959098,MATH 20E,A02,083772,Ganguly; Soumya,6,0,32,26
1657757959098,MATH 20E,B01,083773,Ciotti; Benjamin,20,0,35,15
1657757959098,MATH 20E,B02,083774,Ciotti; Benjamin,18,0,35,17
1657757965132,MATH 103A,A01,083777,Greenfeld; Be'Eri,3,0,36,33
1657757965132,MATH 103A,A02,083778,Greenfeld; Be'Eri,5,0,36,31
1657757965132,MATH 103A,A03,093561,Greenfeld; Be'Eri,6,0,36,30
1657757965132,MATH 103A,B01,083779,Greenfeld; Be'Eri,7,0,36,29
1657757965132,MATH 103A,B02,083780,Greenfeld; Be'Eri,4,0,36,32
1657757965132,MATH 103A,B03,093562,Greenfeld; Be'Eri,3,0,36,33
1657757971156,MATH 105,A01,085443,Carter; Anne Toulson,15,0,35,20
1657757971156,MATH 105,A02,093477,Carter; Anne Toulson,20,0,35,15
1657757977179,MATH 109,A01,083213,Ganzberger; Geoffrey Michael,3,0,34,31
1657757977179,MATH 109,A02,083214,Ganzberger; Geoffrey Michael,4,0,34,30
1657757977179,MATH 109,A03,093478,Ganzberger; Geoffrey Michael,2,0,34,32
1657757977179,MATH 109,B01,083215,Ganzberger; Geoffrey Michael,1,0,32,31
1657757977179,MATH 109,B02,083216,Ganzberger; Geoffrey Michael,2,0,32,30
1657757977179,MATH 109,B03,093479,Ganzberger; Geoffrey Michael,8,0,32,24
1657757983203,MATH 142A,A01,083219,Chow; Bennett,7,0,32,25
1657757983203,MATH 142A,A02,083220,Chow; Bennett,10,0,32,22
1657757983203,MATH 142A,A03,093480,Chow; Bennett,9,0,32,23
1657757983203,MATH 142A,B03,093481,Chow; Bennett,8,0,32,24
1657757983203,MATH 142A,B04,093558,Chow; Bennett,13,0,32,19
1657757983203,MATH 142A,B05,093559,Chow; Bennett,6,0,32,26
1657757989232,MATH 193A,A01,083224,Rotar; Vladimir,8,0,34,26
1657757989232,MATH 193A,A02,083225,Rotar; Vladimir,9,0,34,25
1657757989232,MATH 193A,A03,083781,Rotar; Vladimir,5,0,34,29
1657757989232,MATH 193A,A04,083782,Rotar; Vladimir,10,0,34,24
1657757989232,MATH 193A,A05,093482,Rotar; Vladimir,10,0,34,24
1657757995254,MATH 197,001,091859,McAuley; Julian John,9999,0,9999,0
1657757995254,MATH 197,002,095566,Kedlaya; Kiran S.,9997,0,9999,2
1657757995254,MATH 197,003,095567,Xiao; Ming,9999,0,9999,0
1657757995254,MATH 197,004,095571,Perols; Johan Lars,9998,0,9999,1
1657758002311,COGS 9,A01,083615,Shannon; Kyle Michael,9,0,75,66
1657758008333,COGS 11,A01,083617,Boyle; Mary E. T.,23,0,48,25
1657758014373,COGS 13,A01,083071,Bastos; Amalia Pinkusfeld,11,0,71,60
1657758020398,COGS 14A,A01,092681,Semenuks; Arturs,5,1,100,95
1657758026426,COGS 14B,A01,083073,Cheng; Tzu-Han,6,0,63,57
1657758032447,COGS 17,A01,092677,Semenuks; Arturs,6,0,81,75
1657758038479,COGS 100,A01,083619,Allen; Michael Gordon,17,0,70,53
1657758044506,COGS 101A,A01,083621,Davis; Joshua Daniel,9,0,68,59
1657758050528,COGS 101B,A01,091572,Allen; Michael Gordon,12,0,65,53
1657758056552,COGS 101C,A01,083625,Delgado; Tania,17,0,35,18
1657758062652,COGS 107A,A01,083627,Boyle; Mary E. T.,13,0,60,47
1657758068674,COGS 118A,A01,083075,Gupta; Anjum,21,0,76,55
1657758074698,CSE 3,A50,083646,Miranda; Gregory Joseph,24,0,50,26
1657758080720,CSE 8A,A50,083650,Miranda; Gregory Joseph,17,1,56,39
1657758086743,CSE 11,A01,083080,Cao; Yingjun,6,15,40,34
1657758092772,CSE 12,A01,083652,Krause-Levy; Sophia Louisa,28,1,120,92
1657758098803,CSE 15L,A01,083654,Morris; Justin Loren,9,0,50,41
1657758098803,CSE 15L,A02,083655,Morris; Justin Loren,9,0,50,41
1657758104829,CSE 20,A01,083657,Tran; Khoa Dang,39,0,80,41
1657758110855,CSE 21,A01,095574,Bach; Quang Tran,22,0,48,26
1657758116884,CSE 30,A01,083084,Eldon; John,6,0,80,74
1657758116884,CSE 30,B01,095061,Bhaskar; Nishant,9,0,50,41
1657758122907,CSE 100,A01,083659,Cao; Yingjun,5,4,70,65
1657758128930,CSE 134B,A01,083661,Powell; Thomas Allan,24,0,100,76
1657758134956,CSE 140,A01,083663,Gungor; Onat,15,0,85,70
1657758140989,CSE 140L,A01,083088,Eldon; John,23,0,100,77
1657758147012,CSE 175,A01,083665,Kumar; Rakesh,3,0,25,22
1657758153036,CSE 190,A00,092507,Dubnov; Shlomo,8,0,20,12
1657758159063,ECE 45,A01,083139,Congero; Spencer William,6,0,75,69
1657758165092,ECE 65,A50,083695,Saad; Andrew S,12,0,30,18
1657758165092,ECE 65,A51,095125,Saad; Andrew S,24,0,26,2
1657758171115,ECE 109,A01,091882,Touri; Behrouz,20,0,70,50
1657758177143,ECE 180,A00,083140,Abi Samra; Nicholas Camill,1,0,30,29
1657758177143,ECE 180,B00,083141,Abi Samra; Nicholas Camill,0,0,30,30
1657758183171,MATH 10A,A01,083735,Patchell; Gregory David,2,0,30,28
1657758183171,MATH 10A,A02,083736,Patchell; Gregory David,20,0,30,10
1657758183171,MATH 10A,A03,083737,Patchell; Gregory David,16,0,30,14
1657758189195,MATH 10B,A01,083207,Lim; Seonhee,8,0,34,26
1657758189195,MATH 10B,A02,083208,Lim; Seonhee,9,0,35,26
1657758189195,MATH 10B,A03,093472,Lim; Seonhee,7,0,34,27
1657758189195,MATH 10B,B01,083739,Sinha; Shubham,13,0,30,17
1657758195218,MATH 18,A01,083743,Cinel; Cameron Alexander,9,0,30,21
1657758195218,MATH 18,A02,083744,Cinel; Cameron Alexander,18,0,30,12
1657758195218,MATH 18,A03,083745,Cinel; Cameron Alexander,10,0,30,20
1657758195218,MATH 18,B01,083748,Rideout; David Porter,5,0,37,32
1657758195218,MATH 18,B02,083749,Rideout; David Porter,5,0,36,31
1657758195218,MATH 18,B03,083750,Rideout; David Porter,3,0,37,34
1657758195218,MATH 18,B04,083751,Rideout; David Porter,6,0,36,30
1657758195218,MATH 18,B05,093473,Rideout; David Porter,6,0,36,30
1657758195218,MATH 18,B06,093474,Rideout; David Porter,6,0,36,30
1657758201243,MATH 20A,A01,083754,Zheng; Zequn,14,0,40,26
1657758207271,MATH 20B,A01,083756,Briones; Jor-el Thomas Caparas,4,0,36,32
1657758207271,MATH 20B,A02,083757,Briones; Jor-el Thomas Caparas,1,0,36,35
1657758207271,MATH 20B,A03,093475,Briones; Jor-el Thomas Caparas,2,0,36,34
1657758213305,MATH 20C,A01,083760,Briones; Jor-el Thomas Caparas,1,0,35,34
1657758213305,MATH 20C,A02,083761,Briones; Jor-el Thomas Caparas,8,0,35,27
1657758213305,MATH 20C,A03,093476,Briones; Jor-el Thomas Caparas,0,1,36,36
1657758213305,MATH 20C,B01,083762,Bach; Quang Tran,1,0,30,29
1657758219329,MATH 20D,A01,083765,Tran; Brian Kha,5,0,30,25
1657758219329,MATH 20D,A02,083766,Tran; Brian Kha,5,0,30,25
1657758219329,MATH 20D,A03,083767,Tran; Brian Kha,5,0,30,25
1657758225356,MATH 20E,A01,083771,Ganguly; Soumya,9,0,32,23
1657758225356,MATH 20E,A02,083772,Ganguly; Soumya,6,0,32,26
1657758225356,MATH 20E,B01,083773,Ciotti; Benjamin,20,0,35,15
1657758225356,MATH 20E,B02,083774,Ciotti; Benjamin,18,0,35,17
1657758231386,MATH 103A,A01,083777,Greenfeld; Be'Eri,3,0,36,33
1657758231386,MATH 103A,A02,083778,Greenfeld; Be'Eri,5,0,36,31
1657758231386,MATH 103A,A03,093561,Greenfeld; Be'Eri,6,0,36,30
1657758231386,MATH 103A,B01,083779,Greenfeld; Be'Eri,7,0,36,29
1657758231386,MATH 103A,B02,083780,Greenfeld; Be'Eri,4,0,36,32
1657758231386,MATH 103A,B03,093562,Greenfeld; Be'Eri,3,0,36,33
1657758237409,MATH 105,A01,085443,Carter; Anne Toulson,15,0,35,20
1657758237409,MATH 105,A02,093477,Carter; Anne Toulson,20,0,35,15
1657758243433,MATH 109,A01,083213,Ganzberger; Geoffrey Michael,3,0,34,31
1657758243433,MATH 109,A02,083214,Ganzberger; Geoffrey Michael,4,0,34,30
1657758243433,MATH 109,A03,093478,Ganzberger; Geoffrey Michael,2,0,34,32
1657758243433,MATH 109,B01,083215,Ganzberger; Geoffrey Michael,1,0,32,31
1657758243433,MATH 109,B02,083216,Ganzberger; Geoffrey Michael,2,0,32,30
1657758243433,MATH 109,B03,093479,Ganzberger; Geoffrey Michael,8,0,32,24
1657758249465,MATH 142A,A01,083219,Chow; Bennett,7,0,32,25
1657758249465,MATH 142A,A02,083220,Chow; Bennett,10,0,32,22
1657758249465,MATH 142A,A03,093480,Chow; Bennett,9,0,32,23
1657758249465,MATH 142A,B03,093481,Chow; Bennett,8,0,32,24
1657758249465,MATH 142A,B04,093558,Chow; Bennett,13,0,32,19
1657758249465,MATH 142A,B05,093559,Chow; Bennett,6,0,32,26
1657758255492,MATH 193A,A01,083224,Rotar; Vladimir,8,0,34,26
1657758255492,MATH 193A,A02,083225,Rotar; Vladimir,9,0,34,25
1657758255492,MATH 193A,A03,083781,Rotar; Vladimir,5,0,34,29
1657758255492,MATH 193A,A04,083782,Rotar; Vladimir,10,0,34,24
1657758255492,MATH 193A,A05,093482,Rotar; Vladimir,10,0,34,24
1657758261516,MATH 197,001,091859,McAuley; Julian John,9999,0,9999,0
1657758261516,MATH 197,002,095566,Kedlaya; Kiran S.,9997,0,9999,2
1657758261516,MATH 197,003,095567,Xiao; Ming,9999,0,9999,0
1657758261516,MATH 197,004,095571,Perols; Johan Lars,9998,0,9999,1
1657758268580,COGS 9,A01,083615,Shannon; Kyle Michael,9,0,75,66
1657758274604,COGS 11,A01,083617,Boyle; Mary E. T.,23,0,48,25
1657758280630,COGS 13,A01,083071,Bastos; Amalia Pinkusfeld,11,0,71,60
1657758286651,COGS 14A,A01,092681,Semenuks; Arturs,5,1,100,95
1657758292681,COGS 14B,A01,083073,Cheng; Tzu-Han,6,0,63,57
1657758298717,COGS 17,A01,092677,Semenuks; Arturs,6,0,81,75
1657758304743,COGS 100,A01,083619,Allen; Michael Gordon,17,0,70,53
1657758310766,COGS 101A,A01,083621,Davis; Joshua Daniel,9,0,68,59
1657758316788,COGS 101B,A01,091572,Allen; Michael Gordon,12,0,65,53
1657758322810,COGS 101C,A01,083625,Delgado; Tania,17,0,35,18
1657758328832,COGS 107A,A01,083627,Boyle; Mary E. T.,13,0,60,47
1657758334859,COGS 118A,A01,083075,Gupta; Anjum,21,0,76,55
1657758340888,CSE 3,A50,083646,Miranda; Gregory Joseph,24,0,50,26
1657758346910,CSE 8A,A50,083650,Miranda; Gregory Joseph,17,1,56,39
1657758352932,CSE 11,A01,083080,Cao; Yingjun,6,15,40,34
1657758358958,CSE 12,A01,083652,Krause-Levy; Sophia Louisa,28,1,120,92
1657758364985,CSE 15L,A01,083654,Morris; Justin Loren,9,0,50,41
1657758364985,CSE 15L,A02,083655,Morris; Justin Loren,9,0,50,41
1657758371008,CSE 20,A01,083657,Tran; Khoa Dang,39,0,80,41
1657758377035,CSE 21,A01,095574,Bach; Quang Tran,22,0,48,26
1657758383061,CSE 30,A01,083084,Eldon; John,6,0,80,74
1657758383061,CSE 30,B01,095061,Bhaskar; Nishant,9,0,50,41
1657758389088,CSE 100,A01,083659,Cao; Yingjun,5,4,70,65
1657758395113,CSE 134B,A01,083661,Powell; Thomas Allan,24,0,100,76
1657758401138,CSE 140,A01,083663,Gungor; Onat,15,0,85,70
1657758407162,CSE 140L,A01,083088,Eldon; John,23,0,100,77
1657758413185,CSE 175,A01,083665,Kumar; Rakesh,3,0,25,22
1657758419207,CSE 190,A00,092507,Dubnov; Shlomo,8,0,20,12
1657758425229,ECE 45,A01,083139,Congero; Spencer William,6,0,75,69
1657758431254,ECE 65,A50,083695,Saad; Andrew S,12,0,30,18
1657758431254,ECE 65,A51,095125,Saad; Andrew S,24,0,26,2
1657758437278,ECE 109,A01,091882,Touri; Behrouz,20,0,70,50
1657758443311,ECE 180,A00,083140,Abi Samra; Nicholas Camill,1,0,30,29
1657758443311,ECE 180,B00,083141,Abi Samra; Nicholas Camill,0,0,30,30
1657758449337,MATH 10A,A01,083735,Patchell; Gregory David,2,0,30,28
1657758449337,MATH 10A,A02,083736,Patchell; Gregory David,20,0,30,10
1657758449337,MATH 10A,A03,083737,Patchell; Gregory David,16,0,30,14
1657758455366,MATH 10B,A01,083207,Lim; Seonhee,8,0,34,26
1657758455366,MATH 10B,A02,083208,Lim; Seonhee,9,0,35,26
1657758455366,MATH 10B,A03,093472,Lim; Seonhee,7,0,34,27
1657758455366,MATH 10B,B01,083739,Sinha; Shubham,13,0,30,17
1657758461391,MATH 18,A01,083743,Cinel; Cameron Alexander,9,0,30,21
1657758461391,MATH 18,A02,083744,Cinel; Cameron Alexander,18,0,30,12
1657758461391,MATH 18,A03,083745,Cinel; Cameron Alexander,10,0,30,20
1657758461391,MATH 18,B01,083748,Rideout; David Porter,5,0,37,32
1657758461391,MATH 18,B02,083749,Rideout; David Porter,5,0,36,31
1657758461391,MATH 18,B03,083750,Rideout; David Porter,3,0,37,34
1657758461391,MATH 18,B04,083751,Rideout; David Porter,6,0,36,30
1657758461391,MATH 18,B05,093473,Rideout; David Porter,6,0,36,30
1657758461391,MATH 18,B06,093474,Rideout; David Porter,6,0,36,30
1657758467415,MATH 20A,A01,083754,Zheng; Zequn,14,0,40,26
1657758473439,MATH 20B,A01,083756,Briones; Jor-el Thomas Caparas,4,0,36,32
1657758473439,MATH 20B,A02,083757,Briones; Jor-el Thomas Caparas,1,0,36,35
1657758473439,MATH 20B,A03,093475,Briones; Jor-el Thomas Caparas,2,0,36,34
1657758479472,MATH 20C,A01,083760,Briones; Jor-el Thomas Caparas,1,0,35,34
1657758479472,MATH 20C,A02,083761,Briones; Jor-el Thomas Caparas,8,0,35,27
1657758479472,MATH 20C,A03,093476,Briones; Jor-el Thomas Caparas,0,1,36,36
1657758479472,MATH 20C,B01,083762,Bach; Quang Tran,1,0,30,29
1657758485495,MATH 20D,A01,083765,Tran; Brian Kha,5,0,30,25
1657758485495,MATH 20D,A02,083766,Tran; Brian Kha,5,0,30,25
1657758485495,MATH 20D,A03,083767,Tran; Brian Kha,5,0,30,25
1657758491528,MATH 20E,A01,083771,Ganguly; Soumya,9,0,32,23
1657758491528,MATH 20E,A02,083772,Ganguly; Soumya,6,0,32,26
1657758491528,MATH 20E,B01,083773,Ciotti; Benjamin,20,0,35,15
1657758491528,MATH 20E,B02,083774,Ciotti; Benjamin,18,0,35,17
1657758497559,MATH 103A,A01,083777,Greenfeld; Be'Eri,3,0,36,33
1657758497559,MATH 103A,A02,083778,Greenfeld; Be'Eri,5,0,36,31
1657758497559,MATH 103A,A03,093561,Greenfeld; Be'Eri,6,0,36,30
1657758497559,MATH 103A,B01,083779,Greenfeld; Be'Eri,7,0,36,29
1657758497559,MATH 103A,B02,083780,Greenfeld; Be'Eri,4,0,36,32
1657758497559,MATH 103A,B03,093562,Greenfeld; Be'Eri,3,0,36,33
1657758503589,MATH 105,A01,085443,Carter; Anne Toulson,15,0,35,20
1657758503589,MATH 105,A02,093477,Carter; Anne Toulson,20,0,35,15
1657758509615,MATH 109,A01,083213,Ganzberger; Geoffrey Michael,3,0,34,31
1657758509615,MATH 109,A02,083214,Ganzberger; Geoffrey Michael,4,0,34,30
1657758509615,MATH 109,A03,093478,Ganzberger; Geoffrey Michael,2,0,34,32
1657758509615,MATH 109,B01,083215,Ganzberger; Geoffrey Michael,1,0,32,31
1657758509615,MATH 109,B02,083216,Ganzberger; Geoffrey Michael,2,0,32,30
1657758509615,MATH 109,B03,093479,Ganzberger; Geoffrey Michael,8,0,32,24
1657758515640,MATH 142A,A01,083219,Chow; Bennett,7,0,32,25
1657758515640,MATH 142A,A02,083220,Chow; Bennett,10,0,32,22
1657758515640,MATH 142A,A03,093480,Chow; Bennett,9,0,32,23
1657758515640,MATH 142A,B03,093481,Chow; Bennett,8,0,32,24
1657758515640,MATH 142A,B04,093558,Chow; Bennett,13,0,32,19
1657758515640,MATH 142A,B05,093559,Chow; Bennett,6,0,32,26
1657758521666,MATH 193A,A01,083224,Rotar; Vladimir,8,0,34,26
1657758521666,MATH 193A,A02,083225,Rotar; Vladimir,9,0,34,25
1657758521666,MATH 193A,A03,083781,Rotar; Vladimir,5,0,34,29
1657758521666,MATH 193A,A04,083782,Rotar; Vladimir,10,0,34,24
1657758521666,MATH 193A,A05,093482,Rotar; Vladimir,10,0,34,24
1657758527690,MATH 197,001,091859,McAuley; Julian John,9999,0,9999,0
1657758527690,MATH 197,002,095566,Kedlaya; Kiran S.,9997,0,9999,2
1657758527690,MATH 197,003,095567,Xiao; Ming,9999,0,9999,0
1657758527690,MATH 197,004,095571,Perols; Johan Lars,9998,0,9999,1
1657758534744,COGS 9,A01,083615,Shannon; Kyle Michael,9,0,75,66
1657758540776,COGS 11,A01,083617,Boyle; Mary E. T.,23,0,48,25
1657758546802,COGS 13,A01,083071,Bastos; Amalia Pinkusfeld,11,0,71,60
1657758552829,COGS 14A,A01,092681,Semenuks; Arturs,5,1,100,95
1657758558863,COGS 14B,A01,083073,Cheng; Tzu-Han,6,0,63,57
1657758564887,COGS 17,A01,092677,Semenuks; Arturs,6,0,81,75
1657758570911,COGS 100,A01,083619,Allen; Michael Gordon,17,0,70,53
1657758576934,COGS 101A,A01,083621,Davis; Joshua Daniel,9,0,68,59
1657758582957,COGS 101B,A01,091572,Allen; Michael Gordon,12,0,65,53
1657758588983,COGS 101C,A01,083625,Delgado; Tania,17,0,35,18
1657758595012,COGS 107A,A01,083627,Boyle; Mary E. T.,13,0,60,47
1657758601035,COGS 118A,A01,083075,Gupta; Anjum,21,0,76,55
1657758607060,CSE 3,A50,083646,Miranda; Gregory Joseph,24,0,50,26
1657758613083,CSE 8A,A50,083650,Miranda; Gregory Joseph,17,1,56,39
1657758619110,CSE 11,A01,083080,Cao; Yingjun,6,15,40,34
1657758625133,CSE 12,A01,083652,Krause-Levy; Sophia Louisa,28,1,120,92
1657758631159,CSE 15L,A01,083654,Morris; Justin Loren,9,0,50,41
1657758631159,CSE 15L,A02,083655,Morris; Justin Loren,9,0,50,41
1657758637192,CSE 20,A01,083657,Tran; Khoa Dang,39,0,80,41
1657758643216,CSE 21,A01,095574,Bach; Quang Tran,22,0,48,26
1657758649239,CSE 30,A01,083084,Eldon; John,6,0,80,74
1657758649239,CSE 30,B01,095061,Bhaskar; Nishant,9,0,50,41
1657758655263,CSE 100,A01,083659,Cao; Yingjun,5,4,70,65
1657758661365,CSE 134B,A01,083661,Powell; Thomas Allan,24,0,100,76
1657758667388,CSE 140,A01,083663,Gungor; Onat,15,0,85,70
1657758673416,CSE 140L,A01,083088,Eldon; John,23,0,100,77
1657758679446,CSE 175,A01,083665,Kumar; Rakesh,3,0,25,22
1657758685468,CSE 190,A00,092507,Dubnov; Shlomo,8,0,20,12
1657758691489,ECE 45,A01,083139,Congero; Spencer William,6,0,75,69
1657758697525,ECE 65,A50,083695,Saad; Andrew S,12,0,30,18
1657758697525,ECE 65,A51,095125,Saad; Andrew S,24,0,26,2
1657758703550,ECE 109,A01,091882,Touri; Behrouz,20,0,70,50
1657758709576,ECE 180,A00,083140,Abi Samra; Nicholas Camill,1,0,30,29
1657758709576,ECE 180,B00,083141,Abi Samra; Nicholas Camill,0,0,30,30
1657758715602,MATH 10A,A01,083735,Patchell; Gregory David,2,0,30,28
1657758715602,MATH 10A,A02,083736,Patchell; Gregory David,20,0,30,10
1657758715602,MATH 10A,A03,083737,Patchell; Gregory David,16,0,30,14
1657758721624,MATH 10B,A01,083207,Lim; Seonhee,8,0,34,26
1657758721624,MATH 10B,A02,083208,Lim; Seonhee,9,0,35,26
1657758721624,MATH 10B,A03,093472,Lim; Seonhee,7,0,34,27
1657758721624,MATH 10B,B01,083739,Sinha; Shubham,13,0,30,17
1657758727648,MATH 18,A01,083743,Cinel; Cameron Alexander,9,0,30,21
1657758727648,MATH 18,A02,083744,Cinel; Cameron Alexander,18,0,30,12
1657758727648,MATH 18,A03,083745,Cinel; Cameron Alexander,10,0,30,20
1657758727648,MATH 18,B01,083748,Rideout; David Porter,5,0,37,32
1657758727648,MATH 18,B02,083749,Rideout; David Porter,5,0,36,31
1657758727648,MATH 18,B03,083750,Rideout; David Porter,3,0,37,34
1657758727648,MATH 18,B04,083751,Rideout; David Porter,6,0,36,30
1657758727648,MATH 18,B05,093473,Rideout; David Porter,6,0,36,30
1657758727648,MATH 18,B06,093474,Rideout; David Porter,6,0,36,30
1657758733671,MATH 20A,A01,083754,Zheng; Zequn,14,0,40,26
1657758739695,MATH 20B,A01,083756,Briones; Jor-el Thomas Caparas,4,0,36,32
1657758739695,MATH 20B,A02,083757,Briones; Jor-el Thomas Caparas,1,0,36,35
1657758739695,MATH 20B,A03,093475,Briones; Jor-el Thomas Caparas,2,0,36,34
1657758745722,MATH 20C,A01,083760,Briones; Jor-el Thomas Caparas,1,0,35,34
1657758745722,MATH 20C,A02,083761,Briones; Jor-el Thomas Caparas,8,0,35,27
1657758745722,MATH 20C,A03,093476,Briones; Jor-el Thomas Caparas,0,1,36,36
1657758745722,MATH 20C,B01,083762,Bach; Quang Tran,1,0,30,29
1657758751746,MATH 20D,A01,083765,Tran; Brian Kha,5,0,30,25
1657758751746,MATH 20D,A02,083766,Tran; Brian Kha,5,0,30,25
1657758751746,MATH 20D,A03,083767,Tran; Brian Kha,5,0,30,25
1657758757768,MATH 20E,A01,083771,Ganguly; Soumya,9,0,32,23
1657758757768,MATH 20E,A02,083772,Ganguly; Soumya,6,0,32,26
1657758757768,MATH 20E,B01,083773,Ciotti; Benjamin,20,0,35,15
1657758757768,MATH 20E,B02,083774,Ciotti; Benjamin,18,0,35,17
1657758763791,MATH 103A,A01,083777,Greenfeld; Be'Eri,3,0,36,33
1657758763791,MATH 103A,A02,083778,Greenfeld; Be'Eri,5,0,36,31
1657758763791,MATH 103A,A03,093561,Greenfeld; Be'Eri,6,0,36,30
1657758763791,MATH 103A,B01,083779,Greenfeld; Be'Eri,7,0,36,29
1657758763791,MATH 103A,B02,083780,Greenfeld; Be'Eri,4,0,36,32
1657758763791,MATH 103A,B03,093562,Greenfeld; Be'Eri,3,0,36,33
1657758769830,MATH 105,A01,085443,Carter; Anne Toulson,15,0,35,20
1657758769830,MATH 105,A02,093477,Carter; Anne Toulson,20,0,35,15
1657758775853,MATH 109,A01,083213,Ganzberger; Geoffrey Michael,3,0,34,31
1657758775853,MATH 109,A02,083214,Ganzberger; Geoffrey Michael,4,0,34,30
1657758775853,MATH 109,A03,093478,Ganzberger; Geoffrey Michael,2,0,34,32
1657758775853,MATH 109,B01,083215,Ganzberger; Geoffrey Michael,1,0,32,31
1657758775853,MATH 109,B02,083216,Ganzberger; Geoffrey Michael,2,0,32,30
1657758775853,MATH 109,B03,093479,Ganzberger; Geoffrey Michael,8,0,32,24
1657758781876,MATH 142A,A01,083219,Chow; Bennett,7,0,32,25
1657758781876,MATH 142A,A02,083220,Chow; Bennett,10,0,32,22
1657758781876,MATH 142A,A03,093480,Chow; Bennett,9,0,32,23
1657758781876,MATH 142A,B03,093481,Chow; Bennett,8,0,32,24
1657758781876,MATH 142A,B04,093558,Chow; Bennett,13,0,32,19
1657758781876,MATH 142A,B05,093559,Chow; Bennett,6,0,32,26
1657758787910,MATH 193A,A01,083224,Rotar; Vladimir,8,0,34,26
1657758787910,MATH 193A,A02,083225,Rotar; Vladimir,9,0,34,25
1657758787910,MATH 193A,A03,083781,Rotar; Vladimir,5,0,34,29
1657758787910,MATH 193A,A04,083782,Rotar; Vladimir,10,0,34,24
1657758787910,MATH 193A,A05,093482,Rotar; Vladimir,10,0,34,24
1657758793933,MATH 197,001,091859,McAuley; Julian John,9999,0,9999,0
1657758793933,MATH 197,002,095566,Kedlaya; Kiran S.,9997,0,9999,2
1657758793933,MATH 197,003,095567,Xiao; Ming,9999,0,9999,0
1657758793933,MATH 197,004,095571,Perols; Johan Lars,9998,0,9999,1
1657758800997,COGS 9,A01,083615,Shannon; Kyle Michael,9,0,75,66
1657758807020,COGS 11,A01,083617,Boyle; Mary E. T.,23,0,48,25
1657758813042,COGS 13,A01,083071,Bastos; Amalia Pinkusfeld,11,0,71,60
1657758819068,COGS 14A,A01,092681,Semenuks; Arturs,5,1,100,95
1657758825092,COGS 14B,A01,083073,Cheng; Tzu-Han,6,0,63,57
1657758831116,COGS 17,A01,092677,Semenuks; Arturs,6,0,81,75
1657758837138,COGS 100,A01,083619,Allen; Michael Gordon,17,0,70,53
1657758843170,COGS 101A,A01,083621,Davis; Joshua Daniel,9,0,68,59
1657758849192,COGS 101B,A01,091572,Allen; Michael Gordon,12,0,65,53
1657758855215,COGS 101C,A01,083625,Delgado; Tania,17,0,35,18
1657758861240,COGS 107A,A01,083627,Boyle; Mary E. T.,13,0,60,47
1657758867270,COGS 118A,A01,083075,Gupta; Anjum,21,0,76,55
1657758873293,CSE 3,A50,083646,Miranda; Gregory Joseph,24,0,50,26
1657758879321,CSE 8A,A50,083650,Miranda; Gregory Joseph,17,1,56,39
1657758885343,CSE 11,A01,083080,Cao; Yingjun,6,15,40,34
1657758891366,CSE 12,A01,083652,Krause-Levy; Sophia Louisa,28,1,120,92
1657758897394,CSE 15L,A01,083654,Morris; Justin Loren,9,0,50,41
1657758897394,CSE 15L,A02,083655,Morris; Justin Loren,9,0,50,41
1657758903421,CSE 20,A01,083657,Tran; Khoa Dang,39,0,80,41
1657758909458,CSE 21,A01,095574,Bach; Quang Tran,22,0,48,26
1657758915485,CSE 30,A01,083084,Eldon; John,6,0,80,74
1657758915485,CSE 30,B01,095061,Bhaskar; Nishant,9,0,50,41
1657758921517,CSE 100,A01,083659,Cao; Yingjun,5,4,70,65
1657758927552,CSE 134B,A01,083661,Powell; Thomas Allan,24,0,100,76
1657758933578,CSE 140,A01,083663,Gungor; Onat,15,0,85,70
1657758939601,CSE 140L,A01,083088,Eldon; John,23,0,100,77
1657758945623,CSE 175,A01,083665,Kumar; Rakesh,3,0,25,22
1657758951649,CSE 190,A00,092507,Dubnov; Shlomo,8,0,20,12
1657758957676,ECE 45,A01,083139,Congero; Spencer William,6,0,75,69
1657758963706,ECE 65,A50,083695,Saad; Andrew S,12,0,30,18
1657758963706,ECE 65,A51,095125,Saad; Andrew S,24,0,26,2
1657758969736,ECE 109,A01,091882,Touri; Behrouz,20,0,70,50
1657758975766,ECE 180,A00,083140,Abi Samra; Nicholas Camill,1,0,30,29
1657758975766,ECE 180,B00,083141,Abi Samra; Nicholas Camill,0,0,30,30
1657758981796,MATH 10A,A01,083735,Patchell; Gregory David,2,0,30,28
1657758981796,MATH 10A,A02,083736,Patchell; Gregory David,20,0,30,10
1657758981796,MATH 10A,A03,083737,Patchell; Gregory David,16,0,30,14
1657758987819,MATH 10B,A01,083207,Lim; Seonhee,8,0,34,26
1657758987819,MATH 10B,A02,083208,Lim; Seonhee,9,0,35,26
1657758987819,MATH 10B,A03,093472,Lim; Seonhee,7,0,34,27
1657758987819,MATH 10B,B01,083739,Sinha; Shubham,13,0,30,17
1657758993849,MATH 18,A01,083743,Cinel; Cameron Alexander,9,0,30,21
1657758993849,MATH 18,A02,083744,Cinel; Cameron Alexander,18,0,30,12
1657758993849,MATH 18,A03,083745,Cinel; Cameron Alexander,10,0,30,20
1657758993849,MATH 18,B01,083748,Rideout; David Porter,5,0,37,32
1657758993849,MATH 18,B02,083749,Rideout; David Porter,5,0,36,31
1657758993849,MATH 18,B03,083750,Rideout; David Porter,3,0,37,34
1657758993849,MATH 18,B04,083751,Rideout; David Porter,6,0,36,30
1657758993849,MATH 18,B05,093473,Rideout; David Porter,6,0,36,30
1657758993849,MATH 18,B06,093474,Rideout; David Porter,6,0,36,30
1657758999871,MATH 20A,A01,083754,Zheng; Zequn,14,0,40,26
1657759005900,MATH 20B,A01,083756,Briones; Jor-el Thomas Caparas,4,0,36,32
1657759005900,MATH 20B,A02,083757,Briones; Jor-el Thomas Caparas,1,0,36,35
1657759005900,MATH 20B,A03,093475,Briones; Jor-el Thomas Caparas,2,0,36,34
1657759011922,MATH 20C,A01,083760,Briones; Jor-el Thomas Caparas,1,0,35,34
1657759011922,MATH 20C,A02,083761,Briones; Jor-el Thomas Caparas,8,0,35,27
1657759011922,MATH 20C,A03,093476,Briones; Jor-el Thomas Caparas,0,1,36,36
1657759011922,MATH 20C,B01,083762,Bach; Quang Tran,1,0,30,29
1657759017950,MATH 20D,A01,083765,Tran; Brian Kha,5,0,30,25
1657759017950,MATH 20D,A02,083766,Tran; Brian Kha,5,0,30,25
1657759017950,MATH 20D,A03,083767,Tran; Brian Kha,5,0,30,25
1657759023972,MATH 20E,A01,083771,Ganguly; Soumya,9,0,32,23
1657759023972,MATH 20E,A02,083772,Ganguly; Soumya,6,0,32,26
1657759023972,MATH 20E,B01,083773,Ciotti; Benjamin,20,0,35,15
1657759023972,MATH 20E,B02,083774,Ciotti; Benjamin,18,0,35,17
1657759029999,MATH 103A,A01,083777,Greenfeld; Be'Eri,3,0,36,33
1657759029999,MATH 103A,A02,083778,Greenfeld; Be'Eri,5,0,36,31
1657759029999,MATH 103A,A03,093561,Greenfeld; Be'Eri,6,0,36,30
1657759029999,MATH 103A,B01,083779,Greenfeld; Be'Eri,7,0,36,29
1657759029999,MATH 103A,B02,083780,Greenfeld; Be'Eri,4,0,36,32
1657759029999,MATH 103A,B03,093562,Greenfeld; Be'Eri,3,0,36,33
1657759036025,MATH 105,A01,085443,Carter; Anne Toulson,15,0,35,20
1657759036025,MATH 105,A02,093477,Carter; Anne Toulson,20,0,35,15
1657759042053,MATH 109,A01,083213,Ganzberger; Geoffrey Michael,3,0,34,31
1657759042053,MATH 109,A02,083214,Ganzberger; Geoffrey Michael,4,0,34,30
1657759042053,MATH 109,A03,093478,Ganzberger; Geoffrey Michael,2,0,34,32
1657759042053,MATH 109,B01,083215,Ganzberger; Geoffrey Michael,1,0,32,31
1657759042053,MATH 109,B02,083216,Ganzberger; Geoffrey Michael,2,0,32,30
1657759042053,MATH 109,B03,093479,Ganzberger; Geoffrey Michael,8,0,32,24
1657759048078,MATH 142A,A01,083219,Chow; Bennett,7,0,32,25
1657759048078,MATH 142A,A02,083220,Chow; Bennett,10,0,32,22
1657759048078,MATH 142A,A03,093480,Chow; Bennett,9,0,32,23
1657759048078,MATH 142A,B03,093481,Chow; Bennett,8,0,32,24
1657759048078,MATH 142A,B04,093558,Chow; Bennett,13,0,32,19
1657759048078,MATH 142A,B05,093559,Chow; Bennett,6,0,32,26
1657759054107,MATH 193A,A01,083224,Rotar; Vladimir,8,0,34,26
1657759054107,MATH 193A,A02,083225,Rotar; Vladimir,9,0,34,25
1657759054107,MATH 193A,A03,083781,Rotar; Vladimir,5,0,34,29
1657759054107,MATH 193A,A04,083782,Rotar; Vladimir,10,0,34,24
1657759054107,MATH 193A,A05,093482,Rotar; Vladimir,10,0,34,24
1657759060133,MATH 197,001,091859,McAuley; Julian John,9999,0,9999,0
1657759060133,MATH 197,002,095566,Kedlaya; Kiran S.,9997,0,9999,2
1657759060133,MATH 197,003,095567,Xiao; Ming,9999,0,9999,0
1657759060133,MATH 197,004,095571,Perols; Johan Lars,9998,0,9999,1
1657759067189,COGS 9,A01,083615,Shannon; Kyle Michael,9,0,75,66
1657759073213,COGS 11,A01,083617,Boyle; Mary E. T.,23,0,48,25
1657759079235,COGS 13,A01,083071,Bastos; Amalia Pinkusfeld,11,0,71,60
1657759085267,COGS 14A,A01,092681,Semenuks; Arturs,5,1,100,95
1657759091293,COGS 14B,A01,083073,Cheng; Tzu-Han,6,0,63,57
1657759097316,COGS 17,A01,092677,Semenuks; Arturs,6,0,81,75
1657759103339,COGS 100,A01,083619,Allen; Michael Gordon,17,0,70,53
1657759109373,COGS 101A,A01,083621,Davis; Joshua Daniel,9,0,68,59
1657759115399,COGS 101B,A01,091572,Allen; Michael Gordon,12,0,65,53
1657759121424,COGS 101C,A01,083625,Delgado; Tania,17,0,35,18
1657759127445,COGS 107A,A01,083627,Boyle; Mary E. T.,13,0,60,47
1657759133467,COGS 118A,A01,083075,Gupta; Anjum,21,0,76,55
1657759139493,CSE 3,A50,083646,Miranda; Gregory Joseph,24,0,50,26
1657759145532,CSE 8A,A50,083650,Miranda; Gregory Joseph,17,1,56,39
1657759151558,CSE 11,A01,083080,Cao; Yingjun,6,15,40,34
1657759157581,CSE 12,A01,083652,Krause-Levy; Sophia Louisa,28,1,120,92
1657759163609,CSE 15L,A01,083654,Morris; Justin Loren,9,0,50,41
1657759163609,CSE 15L,A02,083655,Morris; Justin Loren,9,0,50,41
1657759169630,CSE 20,A01,083657,Tran; Khoa Dang,39,0,80,41
1657759175655,CSE 21,A01,095574,Bach; Quang Tran,22,0,48,26
1657759181677,CSE 30,A01,083084,Eldon; John,6,0,80,74
1657759181677,CSE 30,B01,095061,Bhaskar; Nishant,9,0,50,41
1657759187703,CSE 100,A01,083659,Cao; Yingjun,5,4,70,65
1657759193724,CSE 134B,A01,083661,Powell; Thomas Allan,24,0,100,76
1657759199748,CSE 140,A01,083663,Gungor; Onat,15,0,85,70
1657759205771,CSE 140L,A01,083088,Eldon; John,23,0,100,77
1657759211797,CSE 175,A01,083665,Kumar; Rakesh,3,0,25,22
1657759217822,CSE 190,A00,092507,Dubnov; Shlomo,8,0,20,12
1657759223848,ECE 45,A01,083139,Congero; Spencer William,6,0,75,69
1657759229875,ECE 65,A50,083695,Saad; Andrew S,12,0,30,18
1657759229875,ECE 65,A51,095125,Saad; Andrew S,24,0,26,2
1657759235898,ECE 109,A01,091882,Touri; Behrouz,20,0,70,50
1657759241923,ECE 180,A00,083140,Abi Samra; Nicholas Camill,1,0,30,29
1657759241923,ECE 180,B00,083141,Abi Samra; Nicholas Camill,0,0,30,30
1657759247949,MATH 10A,A01,083735,Patchell; Gregory David,2,0,30,28
1657759247949,MATH 10A,A02,083736,Patchell; Gregory David,20,0,30,10
1657759247949,MATH 10A,A03,083737,Patchell; Gregory David,16,0,30,14
1657759253973,MATH 10B,A01,083207,Lim; Seonhee,8,0,34,26
1657759253973,MATH 10B,A02,083208,Lim; Seonhee,9,0,35,26
1657759253973,MATH 10B,A03,093472,Lim; Seonhee,7,0,34,27
1657759253973,MATH 10B,B01,083739,Sinha; Shubham,13,0,30,17
1657759260093,MATH 18,A01,083743,Cinel; Cameron Alexander,9,0,30,21
1657759260093,MATH 18,A02,083744,Cinel; Cameron Alexander,18,0,30,12
1657759260093,MATH 18,A03,083745,Cinel; Cameron Alexander,10,0,30,20
1657759260093,MATH 18,B01,083748,Rideout; David Porter,5,0,37,32
1657759260093,MATH 18,B02,083749,Rideout; David Porter,5,0,36,31
1657759260093,MATH 18,B03,083750,Rideout; David Porter,3,0,37,34
1657759260093,MATH 18,B04,083751,Rideout; David Porter,6,0,36,30
1657759260093,MATH 18,B05,093473,Rideout; David Porter,6,0,36,30
1657759260093,MATH 18,B06,093474,Rideout; David Porter,6,0,36,30
1657759266121,MATH 20A,A01,083754,Zheng; Zequn,14,0,40,26
1657759272147,MATH 20B,A01,083756,Briones; Jor-el Thomas Caparas,4,0,36,32
1657759272147,MATH 20B,A02,083757,Briones; Jor-el Thomas Caparas,1,0,36,35
1657759272147,MATH 20B,A03,093475,Briones; Jor-el Thomas Caparas,2,0,36,34
1657759278169,MATH 20C,A01,083760,Briones; Jor-el Thomas Caparas,1,0,35,34
1657759278169,MATH 20C,A02,083761,Briones; Jor-el Thomas Caparas,8,0,35,27
1657759278169,MATH 20C,A03,093476,Briones; Jor-el Thomas Caparas,0,1,36,36
1657759278169,MATH 20C,B01,083762,Bach; Quang Tran,1,0,30,29
1657759284197,MATH 20D,A01,083765,Tran; Brian Kha,5,0,30,25
1657759284197,MATH 20D,A02,083766,Tran; Brian Kha,5,0,30,25
1657759284197,MATH 20D,A03,083767,Tran; Brian Kha,5,0,30,25
1657759290226,MATH 20E,A01,083771,Ganguly; Soumya,9,0,32,23
1657759290226,MATH 20E,A02,083772,Ganguly; Soumya,6,0,32,26
1657759290226,MATH 20E,B01,083773,Ciotti; Benjamin,20,0,35,15
1657759290226,MATH 20E,B02,083774,Ciotti; Benjamin,18,0,35,17
1657759296250,MATH 103A,A01,083777,Greenfeld; Be'Eri,3,0,36,33
1657759296250,MATH 103A,A02,083778,Greenfeld; Be'Eri,5,0,36,31
1657759296250,MATH 103A,A03,093561,Greenfeld; Be'Eri,6,0,36,30
1657759296250,MATH 103A,B01,083779,Greenfeld; Be'Eri,7,0,36,29
1657759296250,MATH 103A,B02,083780,Greenfeld; Be'Eri,4,0,36,32
1657759296250,MATH 103A,B03,093562,Greenfeld; Be'Eri,3,0,36,33
1657759302272,MATH 105,A01,085443,Carter; Anne Toulson,15,0,35,20
1657759302272,MATH 105,A02,093477,Carter; Anne Toulson,20,0,35,15
1657759308299,MATH 109,A01,083213,Ganzberger; Geoffrey Michael,3,0,34,31
1657759308299,MATH 109,A02,083214,Ganzberger; Geoffrey Michael,4,0,34,30
1657759308299,MATH 109,A03,093478,Ganzberger; Geoffrey Michael,2,0,34,32
1657759308299,MATH 109,B01,083215,Ganzberger; Geoffrey Michael,1,0,32,31
1657759308299,MATH 109,B02,083216,Ganzberger; Geoffrey Michael,2,0,32,30
1657759308299,MATH 109,B03,093479,Ganzberger; Geoffrey Michael,8,0,32,24
1657759314322,MATH 142A,A01,083219,Chow; Bennett,7,0,32,25
1657759314322,MATH 142A,A02,083220,Chow; Bennett,10,0,32,22
1657759314322,MATH 142A,A03,093480,Chow; Bennett,9,0,32,23
1657759314322,MATH 142A,B03,093481,Chow; Bennett,8,0,32,24
1657759314322,MATH 142A,B04,093558,Chow; Bennett,13,0,32,19
1657759314322,MATH 142A,B05,093559,Chow; Bennett,6,0,32,26
1657759320349,MATH 193A,A01,083224,Rotar; Vladimir,8,0,34,26
1657759320349,MATH 193A,A02,083225,Rotar; Vladimir,9,0,34,25
1657759320349,MATH 193A,A03,083781,Rotar; Vladimir,5,0,34,29
1657759320349,MATH 193A,A04,083782,Rotar; Vladimir,10,0,34,24
1657759320349,MATH 193A,A05,093482,Rotar; Vladimir,10,0,34,24
1657759326385,MATH 197,001,091859,McAuley; Julian John,9999,0,9999,0
1657759326385,MATH 197,002,095566,Kedlaya; Kiran S.,9997,0,9999,2
1657759326385,MATH 197,003,095567,Xiao; Ming,9999,0,9999,0
1657759326385,MATH 197,004,095571,Perols; Johan Lars,9998,0,9999,1
1657759333468,COGS 9,A01,083615,Shannon; Kyle Michael,9,0,75,66
1657759339501,COGS 11,A01,083617,Boyle; Mary E. T.,23,0,48,25
1657759345526,COGS 13,A01,083071,Bastos; Amalia Pinkusfeld,11,0,71,60
1657759351554,COGS 14A,A01,092681,Semenuks; Arturs,5,1,100,95
1657759357577,COGS 14B,A01,083073,Cheng; Tzu-Han,6,0,63,57
1657759363603,COGS 17,A01,092677,Semenuks; Arturs,6,0,81,75
1657759369626,COGS 100,A01,083619,Allen; Michael Gordon,17,0,70,53
1657759375652,COGS 101A,A01,083621,Davis; Joshua Daniel,9,0,68,59
1657759381674,COGS 101B,A01,091572,Allen; Michael Gordon,12,0,65,53
1657759387695,COGS 101C,A01,083625,Delgado; Tania,17,0,35,18
1657759393718,COGS 107A,A01,083627,Boyle; Mary E. T.,13,0,60,47
1657759399741,COGS 118A,A01,083075,Gupta; Anjum,21,0,76,55
1657759405769,CSE 3,A50,083646,Miranda; Gregory Joseph,24,0,50,26
1657759411794,CSE 8A,A50,083650,Miranda; Gregory Joseph,17,1,56,39
1657759417818,CSE 11,A01,083080,Cao; Yingjun,6,15,40,34
1657759423840,CSE 12,A01,083652,Krause-Levy; Sophia Louisa,28,1,120,92
1657759429862,CSE 15L,A01,083654,Morris; Justin Loren,9,0,50,41
1657759429862,CSE 15L,A02,083655,Morris; Justin Loren,9,0,50,41
1657759435885,CSE 20,A01,083657,Tran; Khoa Dang,39,0,80,41
1657759441910,CSE 21,A01,095574,Bach; Quang Tran,22,0,48,26
1657759447932,CSE 30,A01,083084,Eldon; John,6,0,80,74
1657759447932,CSE 30,B01,095061,Bhaskar; Nishant,9,0,50,41
1657759453954,CSE 100,A01,083659,Cao; Yingjun,5,4,70,65
1657759459976,CSE 134B,A01,083661,Powell; Thomas Allan,24,0,100,76
1657759465999,CSE 140,A01,083663,Gungor; Onat,15,0,85,70
1657759472030,CSE 140L,A01,083088,Eldon; John,23,0,100,77
1657759478052,CSE 175,A01,083665,Kumar; Rakesh,3,0,25,22
1657759484083,CSE 190,A00,092507,Dubnov; Shlomo,8,0,20,12
1657759490106,ECE 45,A01,083139,Congero; Spencer William,6,0,75,69
1657759496130,ECE 65,A50,083695,Saad; Andrew S,12,0,30,18
1657759496130,ECE 65,A51,095125,Saad; Andrew S,24,0,26,2
1657759502154,ECE 109,A01,091882,Touri; Behrouz,20,0,70,50
1657759508179,ECE 180,A00,083140,Abi Samra; Nicholas Camill,1,0,30,29
1657759508179,ECE 180,B00,083141,Abi Samra; Nicholas Camill,0,0,30,30
1657759514202,MATH 10A,A01,083735,Patchell; Gregory David,2,0,30,28
1657759514202,MATH 10A,A02,083736,Patchell; Gregory David,20,0,30,10
1657759514202,MATH 10A,A03,083737,Patchell; Gregory David,16,0,30,14
1657759520225,MATH 10B,A01,083207,Lim; Seonhee,8,0,34,26
1657759520225,MATH 10B,A02,083208,Lim; Seonhee,9,0,35,26
1657759520225,MATH 10B,A03,093472,Lim; Seonhee,7,0,34,27
1657759520225,MATH 10B,B01,083739,Sinha; Shubham,13,0,30,17
1657759526251,MATH 18,A01,083743,Cinel; Cameron Alexander,9,0,30,21
1657759526251,MATH 18,A02,083744,Cinel; Cameron Alexander,18,0,30,12
1657759526251,MATH 18,A03,083745,Cinel; Cameron Alexander,10,0,30,20
1657759526251,MATH 18,B01,083748,Rideout; David Porter,5,0,37,32
1657759526251,MATH 18,B02,083749,Rideout; David Porter,5,0,36,31
1657759526251,MATH 18,B03,083750,Rideout; David Porter,3,0,37,34
1657759526251,MATH 18,B04,083751,Rideout; David Porter,6,0,36,30
1657759526251,MATH 18,B05,093473,Rideout; David Porter,6,0,36,30
1657759526251,MATH 18,B06,093474,Rideout; David Porter,6,0,36,30
1657759532272,MATH 20A,A01,083754,Zheng; Zequn,14,0,40,26
1657759538296,MATH 20B,A01,083756,Briones; Jor-el Thomas Caparas,4,0,36,32
1657759538296,MATH 20B,A02,083757,Briones; Jor-el Thomas Caparas,1,0,36,35
1657759538296,MATH 20B,A03,093475,Briones; Jor-el Thomas Caparas,2,0,36,34
1657759544319,MATH 20C,A01,083760,Briones; Jor-el Thomas Caparas,1,0,35,34
1657759544319,MATH 20C,A02,083761,Briones; Jor-el Thomas Caparas,8,0,35,27
1657759544319,MATH 20C,A03,093476,Briones; Jor-el Thomas Caparas,0,1,36,36
1657759544319,MATH 20C,B01,083762,Bach; Quang Tran,1,0,30,29
1657759550352,MATH 20D,A01,083765,Tran; Brian Kha,5,0,30,25
1657759550352,MATH 20D,A02,083766,Tran; Brian Kha,5,0,30,25
1657759550352,MATH 20D,A03,083767,Tran; Brian Kha,5,0,30,25
1657759556381,MATH 20E,A01,083771,Ganguly; Soumya,9,0,32,23
1657759556381,MATH 20E,A02,083772,Ganguly; Soumya,6,0,32,26
1657759556381,MATH 20E,B01,083773,Ciotti; Benjamin,20,0,35,15
1657759556381,MATH 20E,B02,083774,Ciotti; Benjamin,18,0,35,17
1657759562409,MATH 103A,A01,083777,Greenfeld; Be'Eri,3,0,36,33
1657759562409,MATH 103A,A02,083778,Greenfeld; Be'Eri,5,0,36,31
1657759562409,MATH 103A,A03,093561,Greenfeld; Be'Eri,6,0,36,30
1657759562409,MATH 103A,B01,083779,Greenfeld; Be'Eri,7,0,36,29
1657759562409,MATH 103A,B02,083780,Greenfeld; Be'Eri,4,0,36,32
1657759562409,MATH 103A,B03,093562,Greenfeld; Be'Eri,3,0,36,33
1657759568436,MATH 105,A01,085443,Carter; Anne Toulson,15,0,35,20
1657759568436,MATH 105,A02,093477,Carter; Anne Toulson,20,0,35,15
1657759574468,MATH 109,A01,083213,Ganzberger; Geoffrey Michael,3,0,34,31
1657759574468,MATH 109,A02,083214,Ganzberger; Geoffrey Michael,4,0,34,30
1657759574468,MATH 109,A03,093478,Ganzberger; Geoffrey Michael,2,0,34,32
1657759574468,MATH 109,B01,083215,Ganzberger; Geoffrey Michael,1,0,32,31
1657759574468,MATH 109,B02,083216,Ganzberger; Geoffrey Michael,2,0,32,30
1657759574468,MATH 109,B03,093479,Ganzberger; Geoffrey Michael,8,0,32,24
1657759580495,MATH 142A,A01,083219,Chow; Bennett,7,0,32,25
1657759580495,MATH 142A,A02,083220,Chow; Bennett,10,0,32,22
1657759580495,MATH 142A,A03,093480,Chow; Bennett,9,0,32,23
1657759580495,MATH 142A,B03,093481,Chow; Bennett,8,0,32,24
1657759580495,MATH 142A,B04,093558,Chow; Bennett,13,0,32,19
1657759580495,MATH 142A,B05,093559,Chow; Bennett,6,0,32,26
1657759586518,MATH 193A,A01,083224,Rotar; Vladimir,8,0,34,26
1657759586518,MATH 193A,A02,083225,Rotar; Vladimir,9,0,34,25
1657759586518,MATH 193A,A03,083781,Rotar; Vladimir,5,0,34,29
1657759586518,MATH 193A,A04,083782,Rotar; Vladimir,10,0,34,24
1657759586518,MATH 193A,A05,093482,Rotar; Vladimir,10,0,34,24
1657759592544,MATH 197,001,091859,McAuley; Julian John,9999,0,9999,0
1657759592544,MATH 197,002,095566,Kedlaya; Kiran S.,9997,0,9999,2
1657759592544,MATH 197,003,095567,Xiao; Ming,9999,0,9999,0
1657759592544,MATH 197,004,095571,Perols; Johan Lars,9998,0,9999,1
1657759599628,COGS 9,A01,083615,Shannon; Kyle Michael,9,0,75,66
1657759605655,COGS 11,A01,083617,Boyle; Mary E. T.,23,0,48,25
1657759611682,COGS 13,A01,083071,Bastos; Amalia Pinkusfeld,11,0,71,60
1657759617710,COGS 14A,A01,092681,Semenuks; Arturs,5,1,100,95
1657759623742,COGS 14B,A01,083073,Cheng; Tzu-Han,6,0,63,57
1657759629768,COGS 17,A01,092677,Semenuks; Arturs,6,0,81,75
1657759635794,COGS 100,A01,083619,Allen; Michael Gordon,17,0,70,53
1657759641817,COGS 101A,A01,083621,Davis; Joshua Daniel,9,0,68,59
1657759647847,COGS 101B,A01,091572,Allen; Michael Gordon,12,0,65,53
1657759653870,COGS 101C,A01,083625,Delgado; Tania,17,0,35,18
1657759659892,COGS 107A,A01,083627,Boyle; Mary E. T.,13,0,60,47
1657759665923,COGS 118A,A01,083075,Gupta; Anjum,21,0,76,55
1657759671949,CSE 3,A50,083646,Miranda; Gregory Joseph,24,0,50,26
1657759677973,CSE 8A,A50,083650,Miranda; Gregory Joseph,17,1,56,39
1657759683999,CSE 11,A01,083080,Cao; Yingjun,6,15,40,34
1657759690035,CSE 12,A01,083652,Krause-Levy; Sophia Louisa,28,1,120,92
1657759696070,CSE 15L,A01,083654,Morris; Justin Loren,9,0,50,41
1657759696070,CSE 15L,A02,083655,Morris; Justin Loren,9,0,50,41
1657759702092,CSE 20,A01,083657,Tran; Khoa Dang,39,0,80,41
1657759708124,CSE 21,A01,095574,Bach; Quang Tran,22,0,48,26
1657759714147,CSE 30,A01,083084,Eldon; John,6,0,80,74
1657759714147,CSE 30,B01,095061,Bhaskar; Nishant,9,0,50,41
1657759720169,CSE 100,A01,083659,Cao; Yingjun,5,4,70,65
1657759726194,CSE 134B,A01,083661,Powell; Thomas Allan,24,0,100,76
1657759732217,CSE 140,A01,083663,Gungor; Onat,15,0,85,70
1657759738248,CSE 140L,A01,083088,Eldon; John,23,0,100,77
1657759744271,CSE 175,A01,083665,Kumar; Rakesh,3,0,25,22
1657759750296,CSE 190,A00,092507,Dubnov; Shlomo,8,0,20,12
1657759756320,ECE 45,A01,083139,Congero; Spencer William,6,0,75,69
1657759762347,ECE 65,A50,083695,Saad; Andrew S,12,0,30,18
1657759762347,ECE 65,A51,095125,Saad; Andrew S,24,0,26,2
1657759768370,ECE 109,A01,091882,Touri; Behrouz,20,0,70,50
1657759774393,ECE 180,A00,083140,Abi Samra; Nicholas Camill,1,0,30,29
1657759774393,ECE 180,B00,083141,Abi Samra; Nicholas Camill,0,0,30,30
1657759780417,MATH 10A,A01,083735,Patchell; Gregory David,2,0,30,28
1657759780417,MATH 10A,A02,083736,Patchell; Gregory David,20,0,30,10
1657759780417,MATH 10A,A03,083737,Patchell; Gregory David,16,0,30,14
1657759786445,MATH 10B,A01,083207,Lim; Seonhee,8,0,34,26
1657759786445,MATH 10B,A02,083208,Lim; Seonhee,9,0,35,26
1657759786445,MATH 10B,A03,093472,Lim; Seonhee,7,0,34,27
1657759786445,MATH 10B,B01,083739,Sinha; Shubham,13,0,30,17
1657759792475,MATH 18,A01,083743,Cinel; Cameron Alexander,9,0,30,21
1657759792475,MATH 18,A02,083744,Cinel; Cameron Alexander,18,0,30,12
1657759792475,MATH 18,A03,083745,Cinel; Cameron Alexander,10,0,30,20
1657759792475,MATH 18,B01,083748,Rideout; David Porter,5,0,37,32
1657759792475,MATH 18,B02,083749,Rideout; David Porter,5,0,36,31
1657759792475,MATH 18,B03,083750,Rideout; David Porter,3,0,37,34
1657759792475,MATH 18,B04,083751,Rideout; David Porter,6,0,36,30
1657759792475,MATH 18,B05,093473,Rideout; David Porter,6,0,36,30
1657759792475,MATH 18,B06,093474,Rideout; David Porter,6,0,36,30
1657759798503,MATH 20A,A01,083754,Zheng; Zequn,14,0,40,26
1657759804531,MATH 20B,A01,083756,Briones; Jor-el Thomas Caparas,4,0,36,32
1657759804531,MATH 20B,A02,083757,Briones; Jor-el Thomas Caparas,1,0,36,35
1657759804531,MATH 20B,A03,093475,Briones; Jor-el Thomas Caparas,2,0,36,34
1657759810560,MATH 20C,A01,083760,Briones; Jor-el Thomas Caparas,1,0,35,34
1657759810560,MATH 20C,A02,083761,Briones; Jor-el Thomas Caparas,8,0,35,27
1657759810560,MATH 20C,A03,093476,Briones; Jor-el Thomas Caparas,0,1,36,36
1657759810560,MATH 20C,B01,083762,Bach; Quang Tran,1,0,30,29
1657759816586,MATH 20D,A01,083765,Tran; Brian Kha,5,0,30,25
1657759816586,MATH 20D,A02,083766,Tran; Brian Kha,5,0,30,25
1657759816586,MATH 20D,A03,083767,Tran; Brian Kha,5,0,30,25
1657759822617,MATH 20E,A01,083771,Ganguly; Soumya,9,0,32,23
1657759822617,MATH 20E,A02,083772,Ganguly; Soumya,6,0,32,26
1657759822617,MATH 20E,B01,083773,Ciotti; Benjamin,20,0,35,15
1657759822617,MATH 20E,B02,083774,Ciotti; Benjamin,18,0,35,17
1657759828645,MATH 103A,A01,083777,Greenfeld; Be'Eri,3,0,36,33
1657759828645,MATH 103A,A02,083778,Greenfeld; Be'Eri,5,0,36,31
1657759828645,MATH 103A,A03,093561,Greenfeld; Be'Eri,6,0,36,30
1657759828645,MATH 103A,B01,083779,Greenfeld; Be'Eri,7,0,36,29
1657759828645,MATH 103A,B02,083780,Greenfeld; Be'Eri,4,0,36,32
1657759828645,MATH 103A,B03,093562,Greenfeld; Be'Eri,3,0,36,33
1657759834669,MATH 105,A01,085443,Carter; Anne Toulson,15,0,35,20
1657759834669,MATH 105,A02,093477,Carter; Anne Toulson,20,0,35,15
1657759840693,MATH 109,A01,083213,Ganzberger; Geoffrey Michael,3,0,34,31
1657759840693,MATH 109,A02,083214,Ganzberger; Geoffrey Michael,4,0,34,30
1657759840693,MATH 109,A03,093478,Ganzberger; Geoffrey Michael,2,0,34,32
1657759840693,MATH 109,B01,083215,Ganzberger; Geoffrey Michael,1,0,32,31
1657759840693,MATH 109,B02,083216,Ganzberger; Geoffrey Michael,2,0,32,30
1657759840693,MATH 109,B03,093479,Ganzberger; Geoffrey Michael,8,0,32,24
1657759846716,MATH 142A,A01,083219,Chow; Bennett,7,0,32,25
1657759846716,MATH 142A,A02,083220,Chow; Bennett,10,0,32,22
1657759846716,MATH 142A,A03,093480,Chow; Bennett,9,0,32,23
1657759846716,MATH 142A,B03,093481,Chow; Bennett,8,0,32,24
1657759846716,MATH 142A,B04,093558,Chow; Bennett,13,0,32,19
1657759846716,MATH 142A,B05,093559,Chow; Bennett,6,0,32,26
1657759852751,MATH 193A,A01,083224,Rotar; Vladimir,8,0,34,26
1657759852751,MATH 193A,A02,083225,Rotar; Vladimir,9,0,34,25
1657759852751,MATH 193A,A03,083781,Rotar; Vladimir,5,0,34,29
1657759852751,MATH 193A,A04,083782,Rotar; Vladimir,10,0,34,24
1657759852751,MATH 193A,A05,093482,Rotar; Vladimir,10,0,34,24
1657759858870,MATH 197,001,091859,McAuley; Julian John,9999,0,9999,0
1657759858870,MATH 197,002,095566,Kedlaya; Kiran S.,9997,0,9999,2
1657759858870,MATH 197,003,095567,Xiao; Ming,9999,0,9999,0
1657759858870,MATH 197,004,095571,Perols; Johan Lars,9998,0,9999,1
1657759865922,COGS 9,A01,083615,Shannon; Kyle Michael,9,0,75,66
1657759871944,COGS 11,A01,083617,Boyle; Mary E. T.,23,0,48,25
1657759877967,COGS 13,A01,083071,Bastos; Amalia Pinkusfeld,11,0,71,60
1657759883994,COGS 14A,A01,092681,Semenuks; Arturs,5,1,100,95
1657759890021,COGS 14B,A01,083073,Cheng; Tzu-Han,6,0,63,57
1657759896044,COGS 17,A01,092677,Semenuks; Arturs,6,0,81,75
1657759902069,COGS 100,A01,083619,Allen; Michael Gordon,17,0,70,53
1657759908098,COGS 101A,A01,083621,Davis; Joshua Daniel,9,0,68,59
1657759914128,COGS 101B,A01,091572,Allen; Michael Gordon,12,0,65,53
1657759920157,COGS 101C,A01,083625,Delgado; Tania,17,0,35,18
1657759926179,COGS 107A,A01,083627,Boyle; Mary E. T.,13,0,60,47
1657759932204,COGS 118A,A01,083075,Gupta; Anjum,21,0,76,55
1657759938234,CSE 3,A50,083646,Miranda; Gregory Joseph,24,0,50,26
1657759944257,CSE 8A,A50,083650,Miranda; Gregory Joseph,17,1,56,39
1657759950283,CSE 11,A01,083080,Cao; Yingjun,6,15,40,34
1657759956316,CSE 12,A01,083652,Krause-Levy; Sophia Louisa,28,1,120,92
1657759962341,CSE 15L,A01,083654,Morris; Justin Loren,9,0,50,41
1657759962341,CSE 15L,A02,083655,Morris; Justin Loren,9,0,50,41
1657759968367,CSE 20,A01,083657,Tran; Khoa Dang,39,0,80,41
1657759974393,CSE 21,A01,095574,Bach; Quang Tran,22,0,48,26
1657759980420,CSE 30,A01,083084,Eldon; John,6,0,80,74
1657759980420,CSE 30,B01,095061,Bhaskar; Nishant,9,0,50,41
1657759986445,CSE 100,A01,083659,Cao; Yingjun,5,4,70,65
1657759992481,CSE 134B,A01,083661,Powell; Thomas Allan,24,0,100,76
1657759998508,CSE 140,A01,083663,Gungor; Onat,15,0,85,70
1657760004533,CSE 140L,A01,083088,Eldon; John,23,0,100,77
1657760010559,CSE 175,A01,083665,Kumar; Rakesh,3,0,25,22
1657760016584,CSE 190,A00,092507,Dubnov; Shlomo,8,0,20,12
1657760022616,ECE 45,A01,083139,Congero; Spencer William,6,0,75,69
1657760028643,ECE 65,A50,083695,Saad; Andrew S,12,0,30,18
1657760028643,ECE 65,A51,095125,Saad; Andrew S,24,0,26,2
1657760034669,ECE 109,A01,091882,Touri; Behrouz,20,0,70,50
1657760040692,ECE 180,A00,083140,Abi Samra; Nicholas Camill,1,0,30,29
1657760040692,ECE 180,B00,083141,Abi Samra; Nicholas Camill,0,0,30,30
1657760046719,MATH 10A,A01,083735,Patchell; Gregory David,2,0,30,28
1657760046719,MATH 10A,A02,083736,Patchell; Gregory David,20,0,30,10
1657760046719,MATH 10A,A03,083737,Patchell; Gregory David,16,0,30,14
1657760052742,MATH 10B,A01,083207,Lim; Seonhee,8,0,34,26
1657760052742,MATH 10B,A02,083208,Lim; Seonhee,9,0,35,26
1657760052742,MATH 10B,A03,093472,Lim; Seonhee,7,0,34,27
1657760052742,MATH 10B,B01,083739,Sinha; Shubham,13,0,30,17
1657760058774,MATH 18,A01,083743,Cinel; Cameron Alexander,9,0,30,21
1657760058774,MATH 18,A02,083744,Cinel; Cameron Alexander,18,0,30,12
1657760058774,MATH 18,A03,083745,Cinel; Cameron Alexander,10,0,30,20
1657760058774,MATH 18,B01,083748,Rideout; David Porter,5,0,37,32
1657760058774,MATH 18,B02,083749,Rideout; David Porter,5,0,36,31
1657760058774,MATH 18,B03,083750,Rideout; David Porter,3,0,37,34
1657760058774,MATH 18,B04,083751,Rideout; David Porter,6,0,36,30
1657760058774,MATH 18,B05,093473,Rideout; David Porter,6,0,36,30
1657760058774,MATH 18,B06,093474,Rideout; David Porter,6,0,36,30
1657760064798,MATH 20A,A01,083754,Zheng; Zequn,14,0,40,26
1657760070822,MATH 20B,A01,083756,Briones; Jor-el Thomas Caparas,4,0,36,32
1657760070822,MATH 20B,A02,083757,Briones; Jor-el Thomas Caparas,1,0,36,35
1657760070822,MATH 20B,A03,093475,Briones; Jor-el Thomas Caparas,2,0,36,34
1657760076847,MATH 20C,A01,083760,Briones; Jor-el Thomas Caparas,1,0,35,34
1657760076847,MATH 20C,A02,083761,Briones; Jor-el Thomas Caparas,8,0,35,27
1657760076847,MATH 20C,A03,093476,Briones; Jor-el Thomas Caparas,0,1,36,36
1657760076847,MATH 20C,B01,083762,Bach; Quang Tran,1,0,30,29
1657760082870,MATH 20D,A01,083765,Tran; Brian Kha,5,0,30,25
1657760082870,MATH 20D,A02,083766,Tran; Brian Kha,5,0,30,25
1657760082870,MATH 20D,A03,083767,Tran; Brian Kha,5,0,30,25
1657760088898,MATH 20E,A01,083771,Ganguly; Soumya,9,0,32,23
1657760088898,MATH 20E,A02,083772,Ganguly; Soumya,6,0,32,26
1657760088898,MATH 20E,B01,083773,Ciotti; Benjamin,20,0,35,15
1657760088898,MATH 20E,B02,083774,Ciotti; Benjamin,18,0,35,17
1657760094934,MATH 103A,A01,083777,Greenfeld; Be'Eri,3,0,36,33
1657760094934,MATH 103A,A02,083778,Greenfeld; Be'Eri,5,0,36,31
1657760094934,MATH 103A,A03,093561,Greenfeld; Be'Eri,6,0,36,30
1657760094934,MATH 103A,B01,083779,Greenfeld; Be'Eri,7,0,36,29
1657760094934,MATH 103A,B02,083780,Greenfeld; Be'Eri,4,0,36,32
1657760094934,MATH 103A,B03,093562,Greenfeld; Be'Eri,3,0,36,33
1657760100958,MATH 105,A01,085443,Carter; Anne Toulson,15,0,35,20
1657760100958,MATH 105,A02,093477,Carter; Anne Toulson,20,0,35,15
1657760106990,MATH 109,A01,083213,Ganzberger; Geoffrey Michael,3,0,34,31
1657760106990,MATH 109,A02,083214,Ganzberger; Geoffrey Michael,4,0,34,30
1657760106990,MATH 109,A03,093478,Ganzberger; Geoffrey Michael,2,0,34,32
1657760106990,MATH 109,B01,083215,Ganzberger; Geoffrey Michael,1,0,32,31
1657760106990,MATH 109,B02,083216,Ganzberger; Geoffrey Michael,2,0,32,30
1657760106990,MATH 109,B03,093479,Ganzberger; Geoffrey Michael,8,0,32,24
1657760113018,MATH 142A,A01,083219,Chow; Bennett,7,0,32,25
1657760113018,MATH 142A,A02,083220,Chow; Bennett,10,0,32,22
1657760113018,MATH 142A,A03,093480,Chow; Bennett,9,0,32,23
1657760113018,MATH 142A,B03,093481,Chow; Bennett,8,0,32,24
1657760113018,MATH 142A,B04,093558,Chow; Bennett,13,0,32,19
1657760113018,MATH 142A,B05,093559,Chow; Bennett,6,0,32,26
1657760119051,MATH 193A,A01,083224,Rotar; Vladimir,8,0,34,26
1657760119051,MATH 193A,A02,083225,Rotar; Vladimir,9,0,34,25
1657760119051,MATH 193A,A03,083781,Rotar; Vladimir,5,0,34,29
1657760119051,MATH 193A,A04,083782,Rotar; Vladimir,10,0,34,24
1657760119051,MATH 193A,A05,093482,Rotar; Vladimir,10,0,34,24
1657760125074,MATH 197,001,091859,McAuley; Julian John,9999,0,9999,0
1657760125074,MATH 197,002,095566,Kedlaya; Kiran S.,9997,0,9999,2
1657760125074,MATH 197,003,095567,Xiao; Ming,9999,0,9999,0
1657760125074,MATH 197,004,095571,Perols; Johan Lars,9998,0,9999,1
1657760132129,COGS 9,A01,083615,Shannon; Kyle Michael,9,0,75,66
1657760138159,COGS 11,A01,083617,Boyle; Mary E. T.,23,0,48,25
1657760144183,COGS 13,A01,083071,Bastos; Amalia Pinkusfeld,11,0,71,60
1657760150207,COGS 14A,A01,092681,Semenuks; Arturs,5,1,100,95
1657760156234,COGS 14B,A01,083073,Cheng; Tzu-Han,6,0,63,57
1657760162260,COGS 17,A01,092677,Semenuks; Arturs,6,0,81,75
1657760168293,COGS 100,A01,083619,Allen; Michael Gordon,17,0,70,53
1657760174320,COGS 101A,A01,083621,Davis; Joshua Daniel,9,0,68,59
1657760180348,COGS 101B,A01,091572,Allen; Michael Gordon,12,0,65,53
1657760186371,COGS 101C,A01,083625,Delgado; Tania,17,0,35,18
1657760192394,COGS 107A,A01,083627,Boyle; Mary E. T.,13,0,60,47
1657760198423,COGS 118A,A01,083075,Gupta; Anjum,21,0,76,55
1657760204447,CSE 3,A50,083646,Miranda; Gregory Joseph,24,0,50,26
1657760210475,CSE 8A,A50,083650,Miranda; Gregory Joseph,17,1,56,39
1657760216499,CSE 11,A01,083080,Cao; Yingjun,6,15,40,34
1657760222522,CSE 12,A01,083652,Krause-Levy; Sophia Louisa,28,1,120,92
1657760228546,CSE 15L,A01,083654,Morris; Justin Loren,9,0,50,41
1657760228546,CSE 15L,A02,083655,Morris; Justin Loren,9,0,50,41
1657760234569,CSE 20,A01,083657,Tran; Khoa Dang,39,0,80,41
1657760240593,CSE 21,A01,095574,Bach; Quang Tran,22,0,48,26
1657760246618,CSE 30,A01,083084,Eldon; John,6,0,80,74
1657760246618,CSE 30,B01,095061,Bhaskar; Nishant,9,0,50,41
1657760252643,CSE 100,A01,083659,Cao; Yingjun,5,4,70,65
1657760258667,CSE 134B,A01,083661,Powell; Thomas Allan,24,0,100,76
1657760264691,CSE 140,A01,083663,Gungor; Onat,15,0,85,70
1657760270713,CSE 140L,A01,083088,Eldon; John,23,0,100,77
1657760276739,CSE 175,A01,083665,Kumar; Rakesh,3,0,25,22
1657760282763,CSE 190,A00,092507,Dubnov; Shlomo,8,0,20,12
1657760288787,ECE 45,A01,083139,Congero; Spencer William,6,0,75,69
1657760294812,ECE 65,A50,083695,Saad; Andrew S,12,0,30,18
1657760294812,ECE 65,A51,095125,Saad; Andrew S,24,0,26,2
1657760300836,ECE 109,A01,091882,Touri; Behrouz,20,0,70,50
1657760306858,ECE 180,A00,083140,Abi Samra; Nicholas Camill,1,0,30,29
1657760306858,ECE 180,B00,083141,Abi Samra; Nicholas Camill,0,0,30,30
1657760312881,MATH 10A,A01,083735,Patchell; Gregory David,2,0,30,28
1657760312881,MATH 10A,A02,083736,Patchell; Gregory David,20,0,30,10
1657760312881,MATH 10A,A03,083737,Patchell; Gregory David,16,0,30,14
1657760318912,MATH 10B,A01,083207,Lim; Seonhee,8,0,34,26
1657760318912,MATH 10B,A02,083208,Lim; Seonhee,9,0,35,26
1657760318912,MATH 10B,A03,093472,Lim; Seonhee,7,0,34,27
1657760318912,MATH 10B,B01,083739,Sinha; Shubham,13,0,30,17
1657760324936,MATH 18,A01,083743,Cinel; Cameron Alexander,9,0,30,21
1657760324936,MATH 18,A02,083744,Cinel; Cameron Alexander,18,0,30,12
1657760324936,MATH 18,A03,083745,Cinel; Cameron Alexander,10,0,30,20
1657760324936,MATH 18,B01,083748,Rideout; David Porter,5,0,37,32
1657760324936,MATH 18,B02,083749,Rideout; David Porter,5,0,36,31
1657760324936,MATH 18,B03,083750,Rideout; David Porter,3,0,37,34
1657760324936,MATH 18,B04,083751,Rideout; David Porter,6,0,36,30
1657760324936,MATH 18,B05,093473,Rideout; David Porter,6,0,36,30
1657760324936,MATH 18,B06,093474,Rideout; David Porter,6,0,36,30
1657760330958,MATH 20A,A01,083754,Zheng; Zequn,14,0,40,26
1657760336982,MATH 20B,A01,083756,Briones; Jor-el Thomas Caparas,4,0,36,32
1657760336982,MATH 20B,A02,083757,Briones; Jor-el Thomas Caparas,1,0,36,35
1657760336982,MATH 20B,A03,093475,Briones; Jor-el Thomas Caparas,2,0,36,34
1657760343015,MATH 20C,A01,083760,Briones; Jor-el Thomas Caparas,1,0,35,34
1657760343015,MATH 20C,A02,083761,Briones; Jor-el Thomas Caparas,8,0,35,27
1657760343015,MATH 20C,A03,093476,Briones; Jor-el Thomas Caparas,0,1,36,36
1657760343015,MATH 20C,B01,083762,Bach; Quang Tran,1,0,30,29
1657760349038,MATH 20D,A01,083765,Tran; Brian Kha,5,0,30,25
1657760349038,MATH 20D,A02,083766,Tran; Brian Kha,5,0,30,25
1657760349038,MATH 20D,A03,083767,Tran; Brian Kha,5,0,30,25
1657760355068,MATH 20E,A01,083771,Ganguly; Soumya,9,0,32,23
1657760355068,MATH 20E,A02,083772,Ganguly; Soumya,6,0,32,26
1657760355068,MATH 20E,B01,083773,Ciotti; Benjamin,20,0,35,15
1657760355068,MATH 20E,B02,083774,Ciotti; Benjamin,18,0,35,17
1657760361094,MATH 103A,A01,083777,Greenfeld; Be'Eri,3,0,36,33
1657760361094,MATH 103A,A02,083778,Greenfeld; Be'Eri,5,0,36,31
1657760361094,MATH 103A,A03,093561,Greenfeld; Be'Eri,6,0,36,30
1657760361094,MATH 103A,B01,083779,Greenfeld; Be'Eri,7,0,36,29
1657760361094,MATH 103A,B02,083780,Greenfeld; Be'Eri,4,0,36,32
1657760361094,MATH 103A,B03,093562,Greenfeld; Be'Eri,3,0,36,33
1657760367116,MATH 105,A01,085443,Carter; Anne Toulson,15,0,35,20
1657760367116,MATH 105,A02,093477,Carter; Anne Toulson,20,0,35,15
1657760373139,MATH 109,A01,083213,Ganzberger; Geoffrey Michael,3,0,34,31
1657760373139,MATH 109,A02,083214,Ganzberger; Geoffrey Michael,4,0,34,30
1657760373139,MATH 109,A03,093478,Ganzberger; Geoffrey Michael,2,0,34,32
1657760373139,MATH 109,B01,083215,Ganzberger; Geoffrey Michael,1,0,32,31
1657760373139,MATH 109,B02,083216,Ganzberger; Geoffrey Michael,2,0,32,30
1657760373139,MATH 109,B03,093479,Ganzberger; Geoffrey Michael,8,0,32,24
1657760379171,MATH 142A,A01,083219,Chow; Bennett,7,0,32,25
1657760379171,MATH 142A,A02,083220,Chow; Bennett,10,0,32,22
1657760379171,MATH 142A,A03,093480,Chow; Bennett,9,0,32,23
1657760379171,MATH 142A,B03,093481,Chow; Bennett,8,0,32,24
1657760379171,MATH 142A,B04,093558,Chow; Bennett,13,0,32,19
1657760379171,MATH 142A,B05,093559,Chow; Bennett,6,0,32,26
1657760385197,MATH 193A,A01,083224,Rotar; Vladimir,8,0,34,26
1657760385197,MATH 193A,A02,083225,Rotar; Vladimir,9,0,34,25
1657760385197,MATH 193A,A03,083781,Rotar; Vladimir,5,0,34,29
1657760385197,MATH 193A,A04,083782,Rotar; Vladimir,10,0,34,24
1657760385197,MATH 193A,A05,093482,Rotar; Vladimir,10,0,34,24
1657760391220,MATH 197,001,091859,McAuley; Julian John,9999,0,9999,0
1657760391220,MATH 197,002,095566,Kedlaya; Kiran S.,9997,0,9999,2
1657760391220,MATH 197,003,095567,Xiao; Ming,9999,0,9999,0
1657760391220,MATH 197,004,095571,Perols; Johan Lars,9998,0,9999,1
1657760398278,COGS 9,A01,083615,Shannon; Kyle Michael,9,0,75,66
1657760404306,COGS 11,A01,083617,Boyle; Mary E. T.,23,0,48,25
1657760410337,COGS 13,A01,083071,Bastos; Amalia Pinkusfeld,11,0,71,60
1657760416360,COGS 14A,A01,092681,Semenuks; Arturs,5,1,100,95
1657760422383,COGS 14B,A01,083073,Cheng; Tzu-Han,6,0,63,57
1657760428405,COGS 17,A01,092677,Semenuks; Arturs,6,0,81,75
1657760434430,COGS 100,A01,083619,Allen; Michael Gordon,17,0,70,53
1657760440452,COGS 101A,A01,083621,Davis; Joshua Daniel,9,0,68,59
1657760446478,COGS 101B,A01,091572,Allen; Michael Gordon,12,0,65,53
1657760452593,COGS 101C,A01,083625,Delgado; Tania,17,0,35,18
1657760458615,COGS 107A,A01,083627,Boyle; Mary E. T.,13,0,60,47
1657760464639,COGS 118A,A01,083075,Gupta; Anjum,21,0,76,55
1657760470670,CSE 3,A50,083646,Miranda; Gregory Joseph,24,0,50,26
1657760476695,CSE 8A,A50,083650,Miranda; Gregory Joseph,17,1,56,39
1657760482716,CSE 11,A01,083080,Cao; Yingjun,6,15,40,34
1657760488746,CSE 12,A01,083652,Krause-Levy; Sophia Louisa,28,1,120,92
1657760494767,CSE 15L,A01,083654,Morris; Justin Loren,9,0,50,41
1657760494767,CSE 15L,A02,083655,Morris; Justin Loren,9,0,50,41
1657760500789,CSE 20,A01,083657,Tran; Khoa Dang,39,0,80,41
1657760506811,CSE 21,A01,095574,Bach; Quang Tran,22,0,48,26
1657760512836,CSE 30,A01,083084,Eldon; John,6,0,80,74
1657760512836,CSE 30,B01,095061,Bhaskar; Nishant,9,0,50,41
1657760518859,CSE 100,A01,083659,Cao; Yingjun,5,4,70,65
1657760524885,CSE 134B,A01,083661,Powell; Thomas Allan,24,0,100,76
1657760530916,CSE 140,A01,083663,Gungor; Onat,15,0,85,70
1657760536946,CSE 140L,A01,083088,Eldon; John,23,0,100,77
1657760542973,CSE 175,A01,083665,Kumar; Rakesh,3,0,25,22
1657760548999,CSE 190,A00,092507,Dubnov; Shlomo,8,0,20,12
1657760555021,ECE 45,A01,083139,Congero; Spencer William,6,0,75,69
1657760561045,ECE 65,A50,083695,Saad; Andrew S,12,0,30,18
1657760561045,ECE 65,A51,095125,Saad; Andrew S,24,0,26,2
1657760567068,ECE 109,A01,091882,Touri; Behrouz,20,0,70,50
1657760573090,ECE 180,A00,083140,Abi Samra; Nicholas Camill,1,0,30,29
1657760573090,ECE 180,B00,083141,Abi Samra; Nicholas Camill,0,0,30,30
1657760579118,MATH 10A,A01,083735,Patchell; Gregory David,2,0,30,28
1657760579118,MATH 10A,A02,083736,Patchell; Gregory David,20,0,30,10
1657760579118,MATH 10A,A03,083737,Patchell; Gregory David,16,0,30,14
1657760585143,MATH 10B,A01,083207,Lim; Seonhee,8,0,34,26
1657760585143,MATH 10B,A02,083208,Lim; Seonhee,9,0,35,26
1657760585143,MATH 10B,A03,093472,Lim; Seonhee,7,0,34,27
1657760585143,MATH 10B,B01,083739,Sinha; Shubham,13,0,30,17
1657760591168,MATH 18,A01,083743,Cinel; Cameron Alexander,9,0,30,21
1657760591168,MATH 18,A02,083744,Cinel; Cameron Alexander,18,0,30,12
1657760591168,MATH 18,A03,083745,Cinel; Cameron Alexander,10,0,30,20
1657760591168,MATH 18,B01,083748,Rideout; David Porter,5,0,37,32
1657760591168,MATH 18,B02,083749,Rideout; David Porter,5,0,36,31
1657760591168,MATH 18,B03,083750,Rideout; David Porter,3,0,37,34
1657760591168,MATH 18,B04,083751,Rideout; David Porter,6,0,36,30
1657760591168,MATH 18,B05,093473,Rideout; David Porter,6,0,36,30
1657760591168,MATH 18,B06,093474,Rideout; David Porter,6,0,36,30
1657760597194,MATH 20A,A01,083754,Zheng; Zequn,14,0,40,26
1657760603221,MATH 20B,A01,083756,Briones; Jor-el Thomas Caparas,4,0,36,32
1657760603221,MATH 20B,A02,083757,Briones; Jor-el Thomas Caparas,1,0,36,35
1657760603221,MATH 20B,A03,093475,Briones; Jor-el Thomas Caparas,2,0,36,34
1657760609245,MATH 20C,A01,083760,Briones; Jor-el Thomas Caparas,1,0,35,34
1657760609245,MATH 20C,A02,083761,Briones; Jor-el Thomas Caparas,8,0,35,27
1657760609245,MATH 20C,A03,093476,Briones; Jor-el Thomas Caparas,0,1,36,36
1657760609245,MATH 20C,B01,083762,Bach; Quang Tran,1,0,30,29
1657760615268,MATH 20D,A01,083765,Tran; Brian Kha,5,0,30,25
1657760615268,MATH 20D,A02,083766,Tran; Brian Kha,5,0,30,25
1657760615268,MATH 20D,A03,083767,Tran; Brian Kha,5,0,30,25
1657760621292,MATH 20E,A01,083771,Ganguly; Soumya,9,0,32,23
1657760621292,MATH 20E,A02,083772,Ganguly; Soumya,6,0,32,26
1657760621292,MATH 20E,B01,083773,Ciotti; Benjamin,20,0,35,15
1657760621292,MATH 20E,B02,083774,Ciotti; Benjamin,18,0,35,17
1657760627322,MATH 103A,A01,083777,Greenfeld; Be'Eri,3,0,36,33
1657760627322,MATH 103A,A02,083778,Greenfeld; Be'Eri,5,0,36,31
1657760627322,MATH 103A,A03,093561,Greenfeld; Be'Eri,6,0,36,30
1657760627322,MATH 103A,B01,083779,Greenfeld; Be'Eri,7,0,36,29
1657760627322,MATH 103A,B02,083780,Greenfeld; Be'Eri,4,0,36,32
1657760627322,MATH 103A,B03,093562,Greenfeld; Be'Eri,3,0,36,33
1657760633346,MATH 105,A01,085443,Carter; Anne Toulson,15,0,35,20
1657760633346,MATH 105,A02,093477,Carter; Anne Toulson,20,0,35,15
1657760639370,MATH 109,A01,083213,Ganzberger; Geoffrey Michael,3,0,34,31
1657760639370,MATH 109,A02,083214,Ganzberger; Geoffrey Michael,4,0,34,30
1657760639370,MATH 109,A03,093478,Ganzberger; Geoffrey Michael,2,0,34,32
1657760639370,MATH 109,B01,083215,Ganzberger; Geoffrey Michael,1,0,32,31
1657760639370,MATH 109,B02,083216,Ganzberger; Geoffrey Michael,2,0,32,30
1657760639370,MATH 109,B03,093479,Ganzberger; Geoffrey Michael,8,0,32,24
1657760645404,MATH 142A,A01,083219,Chow; Bennett,7,0,32,25
1657760645404,MATH 142A,A02,083220,Chow; Bennett,10,0,32,22
1657760645404,MATH 142A,A03,093480,Chow; Bennett,9,0,32,23
1657760645404,MATH 142A,B03,093481,Chow; Bennett,8,0,32,24
1657760645404,MATH 142A,B04,093558,Chow; Bennett,13,0,32,19
1657760645404,MATH 142A,B05,093559,Chow; Bennett,6,0,32,26
1657760651434,MATH 193A,A01,083224,Rotar; Vladimir,8,0,34,26
1657760651434,MATH 193A,A02,083225,Rotar; Vladimir,9,0,34,25
1657760651434,MATH 193A,A03,083781,Rotar; Vladimir,5,0,34,29
1657760651434,MATH 193A,A04,083782,Rotar; Vladimir,10,0,34,24
1657760651434,MATH 193A,A05,093482,Rotar; Vladimir,10,0,34,24
1657760657462,MATH 197,001,091859,McAuley; Julian John,9999,0,9999,0
1657760657462,MATH 197,002,095566,Kedlaya; Kiran S.,9997,0,9999,2
1657760657462,MATH 197,003,095567,Xiao; Ming,9999,0,9999,0
1657760657462,MATH 197,004,095571,Perols; Johan Lars,9998,0,9999,1
1657760664537,COGS 9,A01,083615,Shannon; Kyle Michael,9,0,75,66
1657760670560,COGS 11,A01,083617,Boyle; Mary E. T.,23,0,48,25
1657760676583,COGS 13,A01,083071,Bastos; Amalia Pinkusfeld,11,0,71,60
1657760682613,COGS 14A,A01,092681,Semenuks; Arturs,5,1,100,95
1657760688640,COGS 14B,A01,083073,Cheng; Tzu-Han,6,0,63,57
1657760694663,COGS 17,A01,092677,Semenuks; Arturs,6,0,81,75
1657760700690,COGS 100,A01,083619,Allen; Michael Gordon,17,0,70,53
1657760706712,COGS 101A,A01,083621,Davis; Joshua Daniel,9,0,68,59
1657760712742,COGS 101B,A01,091572,Allen; Michael Gordon,12,0,65,53
1657760718766,COGS 101C,A01,083625,Delgado; Tania,17,0,35,18
1657760724788,COGS 107A,A01,083627,Boyle; Mary E. T.,13,0,60,47
1657760730814,COGS 118A,A01,083075,Gupta; Anjum,21,0,76,55
1657760736840,CSE 3,A50,083646,Miranda; Gregory Joseph,24,0,50,26
1657760742868,CSE 8A,A50,083650,Miranda; Gregory Joseph,17,1,56,39
1657760748890,CSE 11,A01,083080,Cao; Yingjun,6,15,40,34
1657760754917,CSE 12,A01,083652,Krause-Levy; Sophia Louisa,28,1,120,92
1657760760943,CSE 15L,A01,083654,Morris; Justin Loren,9,0,50,41
1657760760943,CSE 15L,A02,083655,Morris; Justin Loren,9,0,50,41
1657760766964,CSE 20,A01,083657,Tran; Khoa Dang,39,0,80,41
1657760772991,CSE 21,A01,095574,Bach; Quang Tran,22,0,48,26
1657760779022,CSE 30,A01,083084,Eldon; John,6,0,80,74
1657760779022,CSE 30,B01,095061,Bhaskar; Nishant,9,0,50,41
1657760785046,CSE 100,A01,083659,Cao; Yingjun,5,4,70,65
1657760791068,CSE 134B,A01,083661,Powell; Thomas Allan,24,0,100,76
1657760797090,CSE 140,A01,083663,Gungor; Onat,15,0,85,70
1657760803113,CSE 140L,A01,083088,Eldon; John,23,0,100,77
1657760809140,CSE 175,A01,083665,Kumar; Rakesh,3,0,25,22
1657760815162,CSE 190,A00,092507,Dubnov; Shlomo,8,0,20,12
1657760821191,ECE 45,A01,083139,Congero; Spencer William,6,0,75,69
1657760827214,ECE 65,A50,083695,Saad; Andrew S,12,0,30,18
1657760827214,ECE 65,A51,095125,Saad; Andrew S,24,0,26,2
1657760833240,ECE 109,A01,091882,Touri; Behrouz,20,0,70,50
1657760839267,ECE 180,A00,083140,Abi Samra; Nicholas Camill,1,0,30,29
1657760839267,ECE 180,B00,083141,Abi Samra; Nicholas Camill,0,0,30,30
1657760845297,MATH 10A,A01,083735,Patchell; Gregory David,2,0,30,28
1657760845297,MATH 10A,A02,083736,Patchell; Gregory David,20,0,30,10
1657760845297,MATH 10A,A03,083737,Patchell; Gregory David,16,0,30,14
1657760851322,MATH 10B,A01,083207,Lim; Seonhee,8,0,34,26
1657760851322,MATH 10B,A02,083208,Lim; Seonhee,9,0,35,26
1657760851322,MATH 10B,A03,093472,Lim; Seonhee,7,0,34,27
1657760851322,MATH 10B,B01,083739,Sinha; Shubham,13,0,30,17
1657760857354,MATH 18,A01,083743,Cinel; Cameron Alexander,9,0,30,21
1657760857354,MATH 18,A02,083744,Cinel; Cameron Alexander,18,0,30,12
1657760857354,MATH 18,A03,083745,Cinel; Cameron Alexander,10,0,30,20
1657760857354,MATH 18,B01,083748,Rideout; David Porter,5,0,37,32
1657760857354,MATH 18,B02,083749,Rideout; David Porter,5,0,36,31
1657760857354,MATH 18,B03,083750,Rideout; David Porter,3,0,37,34
1657760857354,MATH 18,B04,083751,Rideout; David Porter,6,0,36,30
1657760857354,MATH 18,B05,093473,Rideout; David Porter,6,0,36,30
1657760857354,MATH 18,B06,093474,Rideout; David Porter,6,0,36,30
1657760863381,MATH 20A,A01,083754,Zheng; Zequn,14,0,40,26
1657760869410,MATH 20B,A01,083756,Briones; Jor-el Thomas Caparas,4,0,36,32
1657760869410,MATH 20B,A02,083757,Briones; Jor-el Thomas Caparas,1,0,36,35
1657760869410,MATH 20B,A03,093475,Briones; Jor-el Thomas Caparas,2,0,36,34
1657760875439,MATH 20C,A01,083760,Briones; Jor-el Thomas Caparas,1,0,35,34
1657760875439,MATH 20C,A02,083761,Briones; Jor-el Thomas Caparas,8,0,35,27
1657760875439,MATH 20C,A03,093476,Briones; Jor-el Thomas Caparas,0,1,36,36
1657760875439,MATH 20C,B01,083762,Bach; Quang Tran,1,0,30,29
1657760881466,MATH 20D,A01,083765,Tran; Brian Kha,5,0,30,25
1657760881466,MATH 20D,A02,083766,Tran; Brian Kha,5,0,30,25
1657760881466,MATH 20D,A03,083767,Tran; Brian Kha,5,0,30,25
1657760887490,MATH 20E,A01,083771,Ganguly; Soumya,9,0,32,23
1657760887490,MATH 20E,A02,083772,Ganguly; Soumya,6,0,32,26
1657760887490,MATH 20E,B01,083773,Ciotti; Benjamin,20,0,35,15
1657760887490,MATH 20E,B02,083774,Ciotti; Benjamin,18,0,35,17
1657760893513,MATH 103A,A01,083777,Greenfeld; Be'Eri,3,0,36,33
1657760893513,MATH 103A,A02,083778,Greenfeld; Be'Eri,5,0,36,31
1657760893513,MATH 103A,A03,093561,Greenfeld; Be'Eri,6,0,36,30
1657760893513,MATH 103A,B01,083779,Greenfeld; Be'Eri,7,0,36,29
1657760893513,MATH 103A,B02,083780,Greenfeld; Be'Eri,4,0,36,32
1657760893513,MATH 103A,B03,093562,Greenfeld; Be'Eri,3,0,36,33
1657760899538,MATH 105,A01,085443,Carter; Anne Toulson,15,0,35,20
1657760899538,MATH 105,A02,093477,Carter; Anne Toulson,20,0,35,15
1657760905567,MATH 109,A01,083213,Ganzberger; Geoffrey Michael,3,0,34,31
1657760905567,MATH 109,A02,083214,Ganzberger; Geoffrey Michael,4,0,34,30
1657760905567,MATH 109,A03,093478,Ganzberger; Geoffrey Michael,2,0,34,32
1657760905567,MATH 109,B01,083215,Ganzberger; Geoffrey Michael,1,0,32,31
1657760905567,MATH 109,B02,083216,Ganzberger; Geoffrey Michael,2,0,32,30
1657760905567,MATH 109,B03,093479,Ganzberger; Geoffrey Michael,8,0,32,24
1657760911589,MATH 142A,A01,083219,Chow; Bennett,7,0,32,25
1657760911589,MATH 142A,A02,083220,Chow; Bennett,10,0,32,22
1657760911589,MATH 142A,A03,093480,Chow; Bennett,9,0,32,23
1657760911589,MATH 142A,B03,093481,Chow; Bennett,8,0,32,24
1657760911589,MATH 142A,B04,093558,Chow; Bennett,13,0,32,19
1657760911589,MATH 142A,B05,093559,Chow; Bennett,6,0,32,26
1657760917612,MATH 193A,A01,083224,Rotar; Vladimir,8,0,34,26
1657760917612,MATH 193A,A02,083225,Rotar; Vladimir,9,0,34,25
1657760917612,MATH 193A,A03,083781,Rotar; Vladimir,5,0,34,29
1657760917612,MATH 193A,A04,083782,Rotar; Vladimir,10,0,34,24
1657760917612,MATH 193A,A05,093482,Rotar; Vladimir,10,0,34,24
1657760923638,MATH 197,001,091859,McAuley; Julian John,9999,0,9999,0
1657760923638,MATH 197,002,095566,Kedlaya; Kiran S.,9997,0,9999,2
1657760923638,MATH 197,003,095567,Xiao; Ming,9999,0,9999,0
1657760923638,MATH 197,004,095571,Perols; Johan Lars,9998,0,9999,1
1657760930689,COGS 9,A01,083615,Shannon; Kyle Michael,9,0,75,66
1657760936713,COGS 11,A01,083617,Boyle; Mary E. T.,23,0,48,25
1657760942745,COGS 13,A01,083071,Bastos; Amalia Pinkusfeld,11,0,71,60
1657760948767,COGS 14A,A01,092681,Semenuks; Arturs,5,1,100,95
1657760954792,COGS 14B,A01,083073,Cheng; Tzu-Han,6,0,63,57
1657760960815,COGS 17,A01,092677,Semenuks; Arturs,6,0,81,75
1657760966844,COGS 100,A01,083619,Allen; Michael Gordon,17,0,70,53
1657760972865,COGS 101A,A01,083621,Davis; Joshua Daniel,9,0,68,59
1657760978891,COGS 101B,A01,091572,Allen; Michael Gordon,12,0,65,53
1657760984917,COGS 101C,A01,083625,Delgado; Tania,17,0,35,18
1657760990941,COGS 107A,A01,083627,Boyle; Mary E. T.,13,0,60,47
1657760996964,COGS 118A,A01,083075,Gupta; Anjum,21,0,76,55
1657761002988,CSE 3,A50,083646,Miranda; Gregory Joseph,24,0,50,26
1657761009010,CSE 8A,A50,083650,Miranda; Gregory Joseph,17,1,56,39
1657761015031,CSE 11,A01,083080,Cao; Yingjun,6,15,40,34
1657761021056,CSE 12,A01,083652,Krause-Levy; Sophia Louisa,28,1,120,92
1657761027082,CSE 15L,A01,083654,Morris; Justin Loren,9,0,50,41
1657761027082,CSE 15L,A02,083655,Morris; Justin Loren,9,0,50,41
1657761033108,CSE 20,A01,083657,Tran; Khoa Dang,39,0,80,41
1657761039134,CSE 21,A01,095574,Bach; Quang Tran,22,0,48,26
1657761045157,CSE 30,A01,083084,Eldon; John,6,0,80,74
1657761045157,CSE 30,B01,095061,Bhaskar; Nishant,9,0,50,41
1657761051253,CSE 100,A01,083659,Cao; Yingjun,5,4,70,65
1657761057277,CSE 134B,A01,083661,Powell; Thomas Allan,24,0,100,76
1657761063298,CSE 140,A01,083663,Gungor; Onat,15,0,85,70
1657761069321,CSE 140L,A01,083088,Eldon; John,23,0,100,77
1657761075347,CSE 175,A01,083665,Kumar; Rakesh,3,0,25,22
1657761081373,CSE 190,A00,092507,Dubnov; Shlomo,8,0,20,12
1657761087399,ECE 45,A01,083139,Congero; Spencer William,6,0,75,69
1657761093422,ECE 65,A50,083695,Saad; Andrew S,12,0,30,18
1657761093422,ECE 65,A51,095125,Saad; Andrew S,24,0,26,2
1657761099444,ECE 109,A01,091882,Touri; Behrouz,20,0,70,50
1657761105470,ECE 180,A00,083140,Abi Samra; Nicholas Camill,1,0,30,29
1657761105470,ECE 180,B00,083141,Abi Samra; Nicholas Camill,0,0,30,30
1657761111493,MATH 10A,A01,083735,Patchell; Gregory David,2,0,30,28
1657761111493,MATH 10A,A02,083736,Patchell; Gregory David,20,0,30,10
1657761111493,MATH 10A,A03,083737,Patchell; Gregory David,16,0,30,14
1657761117516,MATH 10B,A01,083207,Lim; Seonhee,8,0,34,26
1657761117516,MATH 10B,A02,083208,Lim; Seonhee,9,0,35,26
1657761117516,MATH 10B,A03,093472,Lim; Seonhee,7,0,34,27
1657761117516,MATH 10B,B01,083739,Sinha; Shubham,13,0,30,17
1657761123542,MATH 18,A01,083743,Cinel; Cameron Alexander,9,0,30,21
1657761123542,MATH 18,A02,083744,Cinel; Cameron Alexander,18,0,30,12
1657761123542,MATH 18,A03,083745,Cinel; Cameron Alexander,10,0,30,20
1657761123542,MATH 18,B01,083748,Rideout; David Porter,5,0,37,32
1657761123542,MATH 18,B02,083749,Rideout; David Porter,5,0,36,31
1657761123542,MATH 18,B03,083750,Rideout; David Porter,3,0,37,34
1657761123542,MATH 18,B04,083751,Rideout; David Porter,6,0,36,30
1657761123542,MATH 18,B05,093473,Rideout; David Porter,6,0,36,30
1657761123542,MATH 18,B06,093474,Rideout; David Porter,6,0,36,30
1657761129569,MATH 20A,A01,083754,Zheng; Zequn,14,0,40,26
1657761135594,MATH 20B,A01,083756,Briones; Jor-el Thomas Caparas,4,0,36,32
1657761135594,MATH 20B,A02,083757,Briones; Jor-el Thomas Caparas,1,0,36,35
1657761135594,MATH 20B,A03,093475,Briones; Jor-el Thomas Caparas,2,0,36,34
1657761141617,MATH 20C,A01,083760,Briones; Jor-el Thomas Caparas,1,0,35,34
1657761141617,MATH 20C,A02,083761,Briones; Jor-el Thomas Caparas,8,0,35,27
1657761141617,MATH 20C,A03,093476,Briones; Jor-el Thomas Caparas,0,1,36,36
1657761141617,MATH 20C,B01,083762,Bach; Quang Tran,1,0,30,29
1657761147644,MATH 20D,A01,083765,Tran; Brian Kha,5,0,30,25
1657761147644,MATH 20D,A02,083766,Tran; Brian Kha,5,0,30,25
1657761147644,MATH 20D,A03,083767,Tran; Brian Kha,5,0,30,25
1657761153668,MATH 20E,A01,083771,Ganguly; Soumya,9,0,32,23
1657761153668,MATH 20E,A02,083772,Ganguly; Soumya,6,0,32,26
1657761153668,MATH 20E,B01,083773,Ciotti; Benjamin,20,0,35,15
1657761153668,MATH 20E,B02,083774,Ciotti; Benjamin,18,0,35,17
1657761159692,MATH 103A,A01,083777,Greenfeld; Be'Eri,3,0,36,33
1657761159692,MATH 103A,A02,083778,Greenfeld; Be'Eri,5,0,36,31
1657761159692,MATH 103A,A03,093561,Greenfeld; Be'Eri,6,0,36,30
1657761159692,MATH 103A,B01,083779,Greenfeld; Be'Eri,7,0,36,29
1657761159692,MATH 103A,B02,083780,Greenfeld; Be'Eri,4,0,36,32
1657761159692,MATH 103A,B03,093562,Greenfeld; Be'Eri,3,0,36,33
1657761165720,MATH 105,A01,085443,Carter; Anne Toulson,15,0,35,20
1657761165720,MATH 105,A02,093477,Carter; Anne Toulson,20,0,35,15
1657761171749,MATH 109,A01,083213,Ganzberger; Geoffrey Michael,3,0,34,31
1657761171749,MATH 109,A02,083214,Ganzberger; Geoffrey Michael,4,0,34,30
1657761171749,MATH 109,A03,093478,Ganzberger; Geoffrey Michael,2,0,34,32
1657761171749,MATH 109,B01,083215,Ganzberger; Geoffrey Michael,1,0,32,31
1657761171749,MATH 109,B02,083216,Ganzberger; Geoffrey Michael,2,0,32,30
1657761171749,MATH 109,B03,093479,Ganzberger; Geoffrey Michael,8,0,32,24
1657761177778,MATH 142A,A01,083219,Chow; Bennett,7,0,32,25
1657761177778,MATH 142A,A02,083220,Chow; Bennett,10,0,32,22
1657761177778,MATH 142A,A03,093480,Chow; Bennett,9,0,32,23
1657761177778,MATH 142A,B03,093481,Chow; Bennett,8,0,32,24
1657761177778,MATH 142A,B04,093558,Chow; Bennett,13,0,32,19
1657761177778,MATH 142A,B05,093559,Chow; Bennett,6,0,32,26
1657761183801,MATH 193A,A01,083224,Rotar; Vladimir,8,0,34,26
1657761183801,MATH 193A,A02,083225,Rotar; Vladimir,9,0,34,25
1657761183801,MATH 193A,A03,083781,Rotar; Vladimir,5,0,34,29
1657761183801,MATH 193A,A04,083782,Rotar; Vladimir,10,0,34,24
1657761183801,MATH 193A,A05,093482,Rotar; Vladimir,10,0,34,24
1657761189828,MATH 197,001,091859,McAuley; Julian John,9999,0,9999,0
1657761189828,MATH 197,002,095566,Kedlaya; Kiran S.,9997,0,9999,2
1657761189828,MATH 197,003,095567,Xiao; Ming,9999,0,9999,0
1657761189828,MATH 197,004,095571,Perols; Johan Lars,9998,0,9999,1
1657761196882,COGS 9,A01,083615,Shannon; Kyle Michael,9,0,75,66
1657761202905,COGS 11,A01,083617,Boyle; Mary E. T.,23,0,48,25
1657761208928,COGS 13,A01,083071,Bastos; Amalia Pinkusfeld,11,0,71,60
1657761214956,COGS 14A,A01,092681,Semenuks; Arturs,5,1,100,95
1657761220980,COGS 14B,A01,083073,Cheng; Tzu-Han,6,0,63,57
1657761227002,COGS 17,A01,092677,Semenuks; Arturs,6,0,81,75
1657761233028,COGS 100,A01,083619,Allen; Michael Gordon,17,0,70,53
1657761239052,COGS 101A,A01,083621,Davis; Joshua Daniel,9,0,68,59
1657761245078,COGS 101B,A01,091572,Allen; Michael Gordon,12,0,65,53
1657761251101,COGS 101C,A01,083625,Delgado; Tania,17,0,35,18
1657761257126,COGS 107A,A01,083627,Boyle; Mary E. T.,13,0,60,47
1657761263151,COGS 118A,A01,083075,Gupta; Anjum,21,0,76,55
1657761269175,CSE 3,A50,083646,Miranda; Gregory Joseph,24,0,50,26
1657761275199,CSE 8A,A50,083650,Miranda; Gregory Joseph,17,1,56,39
1657761281222,CSE 11,A01,083080,Cao; Yingjun,6,15,40,34
1657761287249,CSE 12,A01,083652,Krause-Levy; Sophia Louisa,28,1,120,92
1657761293276,CSE 15L,A01,083654,Morris; Justin Loren,9,0,50,41
1657761293276,CSE 15L,A02,083655,Morris; Justin Loren,9,0,50,41
1657761299299,CSE 20,A01,083657,Tran; Khoa Dang,39,0,80,41
1657761305321,CSE 21,A01,095574,Bach; Quang Tran,22,0,48,26
1657761311348,CSE 30,A01,083084,Eldon; John,6,0,80,74
1657761311348,CSE 30,B01,095061,Bhaskar; Nishant,9,0,50,41
1657761317385,CSE 100,A01,083659,Cao; Yingjun,5,4,70,65
1657761323409,CSE 134B,A01,083661,Powell; Thomas Allan,24,0,100,76
1657761329433,CSE 140,A01,083663,Gungor; Onat,15,0,85,70
1657761335459,CSE 140L,A01,083088,Eldon; John,23,0,100,77
1657761341482,CSE 175,A01,083665,Kumar; Rakesh,3,0,25,22
1657761347506,CSE 190,A00,092507,Dubnov; Shlomo,8,0,20,12
1657761353529,ECE 45,A01,083139,Congero; Spencer William,6,0,75,69
1657761359558,ECE 65,A50,083695,Saad; Andrew S,12,0,30,18
1657761359558,ECE 65,A51,095125,Saad; Andrew S,24,0,26,2
1657761365580,ECE 109,A01,091882,Touri; Behrouz,20,0,70,50
1657761371611,ECE 180,A00,083140,Abi Samra; Nicholas Camill,1,0,30,29
1657761371611,ECE 180,B00,083141,Abi Samra; Nicholas Camill,0,0,30,30
1657761377639,MATH 10A,A01,083735,Patchell; Gregory David,2,0,30,28
1657761377639,MATH 10A,A02,083736,Patchell; Gregory David,20,0,30,10
1657761377639,MATH 10A,A03,083737,Patchell; Gregory David,16,0,30,14
1657761383662,MATH 10B,A01,083207,Lim; Seonhee,8,0,34,26
1657761383662,MATH 10B,A02,083208,Lim; Seonhee,9,0,35,26
1657761383662,MATH 10B,A03,093472,Lim; Seonhee,7,0,34,27
1657761383662,MATH 10B,B01,083739,Sinha; Shubham,13,0,30,17
1657761389700,MATH 18,A01,083743,Cinel; Cameron Alexander,9,0,30,21
1657761389700,MATH 18,A02,083744,Cinel; Cameron Alexander,18,0,30,12
1657761389700,MATH 18,A03,083745,Cinel; Cameron Alexander,10,0,30,20
1657761389700,MATH 18,B01,083748,Rideout; David Porter,5,0,37,32
1657761389700,MATH 18,B02,083749,Rideout; David Porter,5,0,36,31
1657761389700,MATH 18,B03,083750,Rideout; David Porter,3,0,37,34
1657761389700,MATH 18,B04,083751,Rideout; David Porter,6,0,36,30
1657761389700,MATH 18,B05,093473,Rideout; David Porter,6,0,36,30
1657761389700,MATH 18,B06,093474,Rideout; David Porter,6,0,36,30
1657761395723,MATH 20A,A01,083754,Zheng; Zequn,14,0,40,26
1657761401748,MATH 20B,A01,083756,Briones; Jor-el Thomas Caparas,4,0,36,32
1657761401748,MATH 20B,A02,083757,Briones; Jor-el Thomas Caparas,1,0,36,35
1657761401748,MATH 20B,A03,093475,Briones; Jor-el Thomas Caparas,2,0,36,34
1657761407772,MATH 20C,A01,083760,Briones; Jor-el Thomas Caparas,1,0,35,34
1657761407772,MATH 20C,A02,083761,Briones; Jor-el Thomas Caparas,8,0,35,27
1657761407772,MATH 20C,A03,093476,Briones; Jor-el Thomas Caparas,0,1,36,36
1657761407772,MATH 20C,B01,083762,Bach; Quang Tran,1,0,30,29
1657761413799,MATH 20D,A01,083765,Tran; Brian Kha,5,0,30,25
1657761413799,MATH 20D,A02,083766,Tran; Brian Kha,5,0,30,25
1657761413799,MATH 20D,A03,083767,Tran; Brian Kha,5,0,30,25
1657761419822,MATH 20E,A01,083771,Ganguly; Soumya,9,0,32,23
1657761419822,MATH 20E,A02,083772,Ganguly; Soumya,6,0,32,26
1657761419822,MATH 20E,B01,083773,Ciotti; Benjamin,20,0,35,15
1657761419822,MATH 20E,B02,083774,Ciotti; Benjamin,18,0,35,17
1657761425861,MATH 103A,A01,083777,Greenfeld; Be'Eri,3,0,36,33
1657761425861,MATH 103A,A02,083778,Greenfeld; Be'Eri,5,0,36,31
1657761425861,MATH 103A,A03,093561,Greenfeld; Be'Eri,6,0,36,30
1657761425861,MATH 103A,B01,083779,Greenfeld; Be'Eri,7,0,36,29
1657761425861,MATH 103A,B02,083780,Greenfeld; Be'Eri,4,0,36,32
1657761425861,MATH 103A,B03,093562,Greenfeld; Be'Eri,3,0,36,33
1657761431885,MATH 105,A01,085443,Carter; Anne Toulson,15,0,35,20
1657761431885,MATH 105,A02,093477,Carter; Anne Toulson,20,0,35,15
1657761437911,MATH 109,A01,083213,Ganzberger; Geoffrey Michael,3,0,34,31
1657761437911,MATH 109,A02,083214,Ganzberger; Geoffrey Michael,4,0,34,30
1657761437911,MATH 109,A03,093478,Ganzberger; Geoffrey Michael,2,0,34,32
1657761437911,MATH 109,B01,083215,Ganzberger; Geoffrey Michael,1,0,32,31
1657761437911,MATH 109,B02,083216,Ganzberger; Geoffrey Michael,2,0,32,30
1657761437911,MATH 109,B03,093479,Ganzberger; Geoffrey Michael,8,0,32,24
1657761443935,MATH 142A,A01,083219,Chow; Bennett,7,0,32,25
1657761443935,MATH 142A,A02,083220,Chow; Bennett,10,0,32,22
1657761443935,MATH 142A,A03,093480,Chow; Bennett,9,0,32,23
1657761443935,MATH 142A,B03,093481,Chow; Bennett,8,0,32,24
1657761443935,MATH 142A,B04,093558,Chow; Bennett,13,0,32,19
1657761443935,MATH 142A,B05,093559,Chow; Bennett,6,0,32,26
1657761449963,MATH 193A,A01,083224,Rotar; Vladimir,8,0,34,26
1657761449963,MATH 193A,A02,083225,Rotar; Vladimir,9,0,34,25
1657761449963,MATH 193A,A03,083781,Rotar; Vladimir,5,0,34,29
1657761449963,MATH 193A,A04,083782,Rotar; Vladimir,10,0,34,24
1657761449963,MATH 193A,A05,093482,Rotar; Vladimir,10,0,34,24
1657761455986,MATH 197,001,091859,McAuley; Julian John,9999,0,9999,0
1657761455986,MATH 197,002,095566,Kedlaya; Kiran S.,9997,0,9999,2
1657761455986,MATH 197,003,095567,Xiao; Ming,9999,0,9999,0
1657761455986,MATH 197,004,095571,Perols; Johan Lars,9998,0,9999,1
1657761463046,COGS 9,A01,083615,Shannon; Kyle Michael,9,0,75,66
1657761469083,COGS 11,A01,083617,Boyle; Mary E. T.,23,0,48,25
1657761475105,COGS 13,A01,083071,Bastos; Amalia Pinkusfeld,11,0,71,60
1657761481126,COGS 14A,A01,092681,Semenuks; Arturs,5,1,100,95
1657761487159,COGS 14B,A01,083073,Cheng; Tzu-Han,6,0,63,57
1657761493181,COGS 17,A01,092677,Semenuks; Arturs,6,0,81,75
1657761499210,COGS 100,A01,083619,Allen; Michael Gordon,17,0,70,53
1657761505234,COGS 101A,A01,083621,Davis; Joshua Daniel,9,0,68,59
1657761511257,COGS 101B,A01,091572,Allen; Michael Gordon,12,0,65,53
1657761517291,COGS 101C,A01,083625,Delgado; Tania,17,0,35,18
1657761523313,COGS 107A,A01,083627,Boyle; Mary E. T.,13,0,60,47
1657761529342,COGS 118A,A01,083075,Gupta; Anjum,21,0,76,55
1657761535365,CSE 3,A50,083646,Miranda; Gregory Joseph,24,0,50,26
1657761541388,CSE 8A,A50,083650,Miranda; Gregory Joseph,17,1,56,39
1657761547426,CSE 11,A01,083080,Cao; Yingjun,6,15,40,34
1657761553450,CSE 12,A01,083652,Krause-Levy; Sophia Louisa,28,1,120,92
1657761559472,CSE 15L,A01,083654,Morris; Justin Loren,9,0,50,41
1657761559472,CSE 15L,A02,083655,Morris; Justin Loren,9,0,50,41
1657761565497,CSE 20,A01,083657,Tran; Khoa Dang,39,0,80,41
1657761571520,CSE 21,A01,095574,Bach; Quang Tran,22,0,48,26
1657761577547,CSE 30,A01,083084,Eldon; John,6,0,80,74
1657761577547,CSE 30,B01,095061,Bhaskar; Nishant,9,0,50,41
1657761583582,CSE 100,A01,083659,Cao; Yingjun,5,4,70,65
1657761589609,CSE 134B,A01,083661,Powell; Thomas Allan,24,0,100,76
1657761595632,CSE 140,A01,083663,Gungor; Onat,15,0,85,70
1657761601655,CSE 140L,A01,083088,Eldon; John,23,0,100,77
1657761607679,CSE 175,A01,083665,Kumar; Rakesh,3,0,25,22
1657761613705,CSE 190,A00,092507,Dubnov; Shlomo,8,0,20,12
1657761619728,ECE 45,A01,083139,Congero; Spencer William,6,0,75,69
1657761625755,ECE 65,A50,083695,Saad; Andrew S,12,0,30,18
1657761625755,ECE 65,A51,095125,Saad; Andrew S,24,0,26,2
1657761631781,ECE 109,A01,091882,Touri; Behrouz,20,0,70,50
1657761637803,ECE 180,A00,083140,Abi Samra; Nicholas Camill,1,0,30,29
1657761637803,ECE 180,B00,083141,Abi Samra; Nicholas Camill,0,0,30,30
1657761643827,MATH 10A,A01,083735,Patchell; Gregory David,2,0,30,28
1657761643827,MATH 10A,A02,083736,Patchell; Gregory David,20,0,30,10
1657761643827,MATH 10A,A03,083737,Patchell; Gregory David,16,0,30,14
1657761649940,MATH 10B,A01,083207,Lim; Seonhee,8,0,34,26
1657761649940,MATH 10B,A02,083208,Lim; Seonhee,9,0,35,26
1657761649940,MATH 10B,A03,093472,Lim; Seonhee,7,0,34,27
1657761649940,MATH 10B,B01,083739,Sinha; Shubham,13,0,30,17
1657761655964,MATH 18,A01,083743,Cinel; Cameron Alexander,9,0,30,21
1657761655964,MATH 18,A02,083744,Cinel; Cameron Alexander,18,0,30,12
1657761655964,MATH 18,A03,083745,Cinel; Cameron Alexander,10,0,30,20
1657761655964,MATH 18,B01,083748,Rideout; David Porter,5,0,37,32
1657761655964,MATH 18,B02,083749,Rideout; David Porter,5,0,36,31
1657761655964,MATH 18,B03,083750,Rideout; David Porter,3,0,37,34
1657761655964,MATH 18,B04,083751,Rideout; David Porter,6,0,36,30
1657761655964,MATH 18,B05,093473,Rideout; David Porter,6,0,36,30
1657761655964,MATH 18,B06,093474,Rideout; David Porter,6,0,36,30
1657761661987,MATH 20A,A01,083754,Zheng; Zequn,14,0,40,26
1657761668010,MATH 20B,A01,083756,Briones; Jor-el Thomas Caparas,4,0,36,32
1657761668010,MATH 20B,A02,083757,Briones; Jor-el Thomas Caparas,1,0,36,35
1657761668010,MATH 20B,A03,093475,Briones; Jor-el Thomas Caparas,2,0,36,34
1657761674034,MATH 20C,A01,083760,Briones; Jor-el Thomas Caparas,1,0,35,34
1657761674034,MATH 20C,A02,083761,Briones; Jor-el Thomas Caparas,8,0,35,27
1657761674034,MATH 20C,A03,093476,Briones; Jor-el Thomas Caparas,0,1,36,36
1657761674034,MATH 20C,B01,083762,Bach; Quang Tran,1,0,30,29
1657761680072,MATH 20D,A01,083765,Tran; Brian Kha,5,0,30,25
1657761680072,MATH 20D,A02,083766,Tran; Brian Kha,5,0,30,25
1657761680072,MATH 20D,A03,083767,Tran; Brian Kha,5,0,30,25
1657761686099,MATH 20E,A01,083771,Ganguly; Soumya,9,0,32,23
1657761686099,MATH 20E,A02,083772,Ganguly; Soumya,6,0,32,26
1657761686099,MATH 20E,B01,083773,Ciotti; Benjamin,20,0,35,15
1657761686099,MATH 20E,B02,083774,Ciotti; Benjamin,18,0,35,17
1657761692127,MATH 103A,A01,083777,Greenfeld; Be'Eri,3,0,36,33
1657761692127,MATH 103A,A02,083778,Greenfeld; Be'Eri,5,0,36,31
1657761692127,MATH 103A,A03,093561,Greenfeld; Be'Eri,6,0,36,30
1657761692127,MATH 103A,B01,083779,Greenfeld; Be'Eri,7,0,36,29
1657761692127,MATH 103A,B02,083780,Greenfeld; Be'Eri,4,0,36,32
1657761692127,MATH 103A,B03,093562,Greenfeld; Be'Eri,3,0,36,33
1657761698153,MATH 105,A01,085443,Carter; Anne Toulson,15,0,35,20
1657761698153,MATH 105,A02,093477,Carter; Anne Toulson,20,0,35,15
1657761704182,MATH 109,A01,083213,Ganzberger; Geoffrey Michael,3,0,34,31
1657761704182,MATH 109,A02,083214,Ganzberger; Geoffrey Michael,4,0,34,30
1657761704182,MATH 109,A03,093478,Ganzberger; Geoffrey Michael,2,0,34,32
1657761704182,MATH 109,B01,083215,Ganzberger; Geoffrey Michael,1,0,32,31
1657761704182,MATH 109,B02,083216,Ganzberger; Geoffrey Michael,2,0,32,30
1657761704182,MATH 109,B03,093479,Ganzberger; Geoffrey Michael,8,0,32,24
1657761710206,MATH 142A,A01,083219,Chow; Bennett,7,0,32,25
1657761710206,MATH 142A,A02,083220,Chow; Bennett,10,0,32,22
1657761710206,MATH 142A,A03,093480,Chow; Bennett,9,0,32,23
1657761710206,MATH 142A,B03,093481,Chow; Bennett,8,0,32,24
1657761710206,MATH 142A,B04,093558,Chow; Bennett,13,0,32,19
1657761710206,MATH 142A,B05,093559,Chow; Bennett,6,0,32,26
1657761716230,MATH 193A,A01,083224,Rotar; Vladimir,8,0,34,26
1657761716230,MATH 193A,A02,083225,Rotar; Vladimir,9,0,34,25
1657761716230,MATH 193A,A03,083781,Rotar; Vladimir,5,0,34,29
1657761716230,MATH 193A,A04,083782,Rotar; Vladimir,10,0,34,24
1657761716230,MATH 193A,A05,093482,Rotar; Vladimir,10,0,34,24
1657761722253,MATH 197,001,091859,McAuley; Julian John,9999,0,9999,0
1657761722253,MATH 197,002,095566,Kedlaya; Kiran S.,9997,0,9999,2
1657761722253,MATH 197,003,095567,Xiao; Ming,9999,0,9999,0
1657761722253,MATH 197,004,095571,Perols; Johan Lars,9998,0,9999,1
1657761729308,COGS 9,A01,083615,Shannon; Kyle Michael,9,0,75,66
1657761735330,COGS 11,A01,083617,Boyle; Mary E. T.,23,0,48,25
1657761741355,COGS 13,A01,083071,Bastos; Amalia Pinkusfeld,11,0,71,60
1657761747377,COGS 14A,A01,092681,Semenuks; Arturs,5,1,100,95
1657761753404,COGS 14B,A01,083073,Cheng; Tzu-Han,6,0,63,57
1657761759427,COGS 17,A01,092677,Semenuks; Arturs,6,0,81,75
1657761765451,COGS 100,A01,083619,Allen; Michael Gordon,17,0,70,53
1657761771478,COGS 101A,A01,083621,Davis; Joshua Daniel,9,0,68,59
1657761777507,COGS 101B,A01,091572,Allen; Michael Gordon,12,0,65,53
1657761783529,COGS 101C,A01,083625,Delgado; Tania,17,0,35,18
1657761789552,COGS 107A,A01,083627,Boyle; Mary E. T.,13,0,60,47
1657761795577,COGS 118A,A01,083075,Gupta; Anjum,21,0,76,55
1657761801601,CSE 3,A50,083646,Miranda; Gregory Joseph,24,0,50,26
1657761807624,CSE 8A,A50,083650,Miranda; Gregory Joseph,17,1,56,39
1657761813650,CSE 11,A01,083080,Cao; Yingjun,6,15,40,34
1657761819674,CSE 12,A01,083652,Krause-Levy; Sophia Louisa,28,1,120,92
1657761825705,CSE 15L,A01,083654,Morris; Justin Loren,9,0,50,41
1657761825705,CSE 15L,A02,083655,Morris; Justin Loren,9,0,50,41
1657761831727,CSE 20,A01,083657,Tran; Khoa Dang,39,0,80,41
1657761837751,CSE 21,A01,095574,Bach; Quang Tran,22,0,48,26
1657761843774,CSE 30,A01,083084,Eldon; John,6,0,80,74
1657761843774,CSE 30,B01,095061,Bhaskar; Nishant,9,0,50,41
1657761849811,CSE 100,A01,083659,Cao; Yingjun,5,4,70,65
1657761855836,CSE 134B,A01,083661,Powell; Thomas Allan,24,0,100,76
1657761861864,CSE 140,A01,083663,Gungor; Onat,15,0,85,70
1657761867889,CSE 140L,A01,083088,Eldon; John,23,0,100,77
1657761873913,CSE 175,A01,083665,Kumar; Rakesh,3,0,25,22
1657761879934,CSE 190,A00,092507,Dubnov; Shlomo,8,0,20,12
1657761885956,ECE 45,A01,083139,Congero; Spencer William,6,0,75,69
1657761891984,ECE 65,A50,083695,Saad; Andrew S,12,0,30,18
1657761891984,ECE 65,A51,095125,Saad; Andrew S,24,0,26,2
1657761898007,ECE 109,A01,091882,Touri; Behrouz,20,0,70,50
1657761904031,ECE 180,A00,083140,Abi Samra; Nicholas Camill,1,0,30,29
1657761904031,ECE 180,B00,083141,Abi Samra; Nicholas Camill,0,0,30,30
1657761910058,MATH 10A,A01,083735,Patchell; Gregory David,2,0,30,28
1657761910058,MATH 10A,A02,083736,Patchell; Gregory David,20,0,30,10
1657761910058,MATH 10A,A03,083737,Patchell; Gregory David,16,0,30,14
1657761916088,MATH 10B,A01,083207,Lim; Seonhee,8,0,34,26
1657761916088,MATH 10B,A02,083208,Lim; Seonhee,9,0,35,26
1657761916088,MATH 10B,A03,093472,Lim; Seonhee,7,0,34,27
1657761916088,MATH 10B,B01,083739,Sinha; Shubham,13,0,30,17
1657761922112,MATH 18,A01,083743,Cinel; Cameron Alexander,9,0,30,21
1657761922112,MATH 18,A02,083744,Cinel; Cameron Alexander,18,0,30,12
1657761922112,MATH 18,A03,083745,Cinel; Cameron Alexander,10,0,30,20
1657761922112,MATH 18,B01,083748,Rideout; David Porter,5,0,37,32
1657761922112,MATH 18,B02,083749,Rideout; David Porter,5,0,36,31
1657761922112,MATH 18,B03,083750,Rideout; David Porter,3,0,37,34
1657761922112,MATH 18,B04,083751,Rideout; David Porter,6,0,36,30
1657761922112,MATH 18,B05,093473,Rideout; David Porter,6,0,36,30
1657761922112,MATH 18,B06,093474,Rideout; David Porter,6,0,36,30
1657761928135,MATH 20A,A01,083754,Zheng; Zequn,14,0,40,26
1657761934157,MATH 20B,A01,083756,Briones; Jor-el Thomas Caparas,4,0,36,32
1657761934157,MATH 20B,A02,083757,Briones; Jor-el Thomas Caparas,1,0,36,35
1657761934157,MATH 20B,A03,093475,Briones; Jor-el Thomas Caparas,2,0,36,34
1657761940185,MATH 20C,A01,083760,Briones; Jor-el Thomas Caparas,1,0,35,34
1657761940185,MATH 20C,A02,083761,Briones; Jor-el Thomas Caparas,8,0,35,27
1657761940185,MATH 20C,A03,093476,Briones; Jor-el Thomas Caparas,0,1,36,36
1657761940185,MATH 20C,B01,083762,Bach; Quang Tran,1,0,30,29
1657761946208,MATH 20D,A01,083765,Tran; Brian Kha,5,0,30,25
1657761946208,MATH 20D,A02,083766,Tran; Brian Kha,5,0,30,25
1657761946208,MATH 20D,A03,083767,Tran; Brian Kha,5,0,30,25
1657761952231,MATH 20E,A01,083771,Ganguly; Soumya,9,0,32,23
1657761952231,MATH 20E,A02,083772,Ganguly; Soumya,6,0,32,26
1657761952231,MATH 20E,B01,083773,Ciotti; Benjamin,20,0,35,15
1657761952231,MATH 20E,B02,083774,Ciotti; Benjamin,18,0,35,17
1657761958261,MATH 103A,A01,083777,Greenfeld; Be'Eri,3,0,36,33
1657761958261,MATH 103A,A02,083778,Greenfeld; Be'Eri,5,0,36,31
1657761958261,MATH 103A,A03,093561,Greenfeld; Be'Eri,6,0,36,30
1657761958261,MATH 103A,B01,083779,Greenfeld; Be'Eri,7,0,36,29
1657761958261,MATH 103A,B02,083780,Greenfeld; Be'Eri,4,0,36,32
1657761958261,MATH 103A,B03,093562,Greenfeld; Be'Eri,3,0,36,33
1657761964288,MATH 105,A01,085443,Carter; Anne Toulson,15,0,35,20
1657761964288,MATH 105,A02,093477,Carter; Anne Toulson,20,0,35,15
1657761970317,MATH 109,A01,083213,Ganzberger; Geoffrey Michael,3,0,34,31
1657761970317,MATH 109,A02,083214,Ganzberger; Geoffrey Michael,4,0,34,30
1657761970317,MATH 109,A03,093478,Ganzberger; Geoffrey Michael,2,0,34,32
1657761970317,MATH 109,B01,083215,Ganzberger; Geoffrey Michael,1,0,32,31
1657761970317,MATH 109,B02,083216,Ganzberger; Geoffrey Michael,2,0,32,30
1657761970317,MATH 109,B03,093479,Ganzberger; Geoffrey Michael,8,0,32,24
1657761976347,MATH 142A,A01,083219,Chow; Bennett,7,0,32,25
1657761976347,MATH 142A,A02,083220,Chow; Bennett,10,0,32,22
1657761976347,MATH 142A,A03,093480,Chow; Bennett,9,0,32,23
1657761976347,MATH 142A,B03,093481,Chow; Bennett,8,0,32,24
1657761976347,MATH 142A,B04,093558,Chow; Bennett,13,0,32,19
1657761976347,MATH 142A,B05,093559,Chow; Bennett,6,0,32,26
1657761982378,MATH 193A,A01,083224,Rotar; Vladimir,8,0,34,26
1657761982378,MATH 193A,A02,083225,Rotar; Vladimir,9,0,34,25
1657761982378,MATH 193A,A03,083781,Rotar; Vladimir,5,0,34,29
1657761982378,MATH 193A,A04,083782,Rotar; Vladimir,10,0,34,24
1657761982378,MATH 193A,A05,093482,Rotar; Vladimir,10,0,34,24
1657761988401,MATH 197,001,091859,McAuley; Julian John,9999,0,9999,0
1657761988401,MATH 197,002,095566,Kedlaya; Kiran S.,9997,0,9999,2
1657761988401,MATH 197,003,095567,Xiao; Ming,9999,0,9999,0
1657761988401,MATH 197,004,095571,Perols; Johan Lars,9998,0,9999,1
1657761995453,COGS 9,A01,083615,Shannon; Kyle Michael,9,0,75,66
1657762001477,COGS 11,A01,083617,Boyle; Mary E. T.,23,0,48,25
1657762007501,COGS 13,A01,083071,Bastos; Amalia Pinkusfeld,11,0,71,60
1657762013526,COGS 14A,A01,092681,Semenuks; Arturs,5,1,100,95
1657762019553,COGS 14B,A01,083073,Cheng; Tzu-Han,6,0,63,57
1657762025576,COGS 17,A01,092677,Semenuks; Arturs,6,0,81,75
1657762031599,COGS 100,A01,083619,Allen; Michael Gordon,17,0,70,53
1657762037631,COGS 101A,A01,083621,Davis; Joshua Daniel,9,0,68,59
1657762043657,COGS 101B,A01,091572,Allen; Michael Gordon,12,0,65,53
1657762049684,COGS 101C,A01,083625,Delgado; Tania,17,0,35,18
1657762055707,COGS 107A,A01,083627,Boyle; Mary E. T.,13,0,60,47
1657762061741,COGS 118A,A01,083075,Gupta; Anjum,21,0,76,55
1657762067769,CSE 3,A50,083646,Miranda; Gregory Joseph,24,0,50,26
1657762073826,CSE 8A,A50,083650,Miranda; Gregory Joseph,17,1,56,39
1657762079850,CSE 11,A01,083080,Cao; Yingjun,6,15,40,34
1657762085881,CSE 12,A01,083652,Krause-Levy; Sophia Louisa,28,1,120,92
1657762091908,CSE 15L,A01,083654,Morris; Justin Loren,9,0,50,41
1657762091908,CSE 15L,A02,083655,Morris; Justin Loren,9,0,50,41
1657762097934,CSE 20,A01,083657,Tran; Khoa Dang,39,0,80,41
1657762103957,CSE 21,A01,095574,Bach; Quang Tran,22,0,48,26
1657762109983,CSE 30,A01,083084,Eldon; John,6,0,80,74
1657762109983,CSE 30,B01,095061,Bhaskar; Nishant,9,0,50,41
1657762116006,CSE 100,A01,083659,Cao; Yingjun,5,4,70,65
1657762122031,CSE 134B,A01,083661,Powell; Thomas Allan,24,0,100,76
1657762128059,CSE 140,A01,083663,Gungor; Onat,15,0,85,70
1657762134083,CSE 140L,A01,083088,Eldon; John,23,0,100,77
1657762140112,CSE 175,A01,083665,Kumar; Rakesh,3,0,25,22
1657762146138,CSE 190,A00,092507,Dubnov; Shlomo,8,0,20,12
1657762152161,ECE 45,A01,083139,Congero; Spencer William,6,0,75,69
1657762158183,ECE 65,A50,083695,Saad; Andrew S,12,0,30,18
1657762158183,ECE 65,A51,095125,Saad; Andrew S,24,0,26,2
1657762164210,ECE 109,A01,091882,Touri; Behrouz,20,0,70,50
1657762170236,ECE 180,A00,083140,Abi Samra; Nicholas Camill,1,0,30,29
1657762170236,ECE 180,B00,083141,Abi Samra; Nicholas Camill,0,0,30,30
1657762176259,MATH 10A,A01,083735,Patchell; Gregory David,2,0,30,28
1657762176259,MATH 10A,A02,083736,Patchell; Gregory David,20,0,30,10
1657762176259,MATH 10A,A03,083737,Patchell; Gregory David,16,0,30,14
1657762182285,MATH 10B,A01,083207,Lim; Seonhee,8,0,34,26
1657762182285,MATH 10B,A02,083208,Lim; Seonhee,9,0,35,26
1657762182285,MATH 10B,A03,093472,Lim; Seonhee,7,0,34,27
1657762182285,MATH 10B,B01,083739,Sinha; Shubham,13,0,30,17
1657762188313,MATH 18,A01,083743,Cinel; Cameron Alexander,9,0,30,21
1657762188313,MATH 18,A02,083744,Cinel; Cameron Alexander,18,0,30,12
1657762188313,MATH 18,A03,083745,Cinel; Cameron Alexander,10,0,30,20
1657762188313,MATH 18,B01,083748,Rideout; David Porter,5,0,37,32
1657762188313,MATH 18,B02,083749,Rideout; David Porter,5,0,36,31
1657762188313,MATH 18,B03,083750,Rideout; David Porter,3,0,37,34
1657762188313,MATH 18,B04,083751,Rideout; David Porter,6,0,36,30
1657762188313,MATH 18,B05,093473,Rideout; David Porter,6,0,36,30
1657762188313,MATH 18,B06,093474,Rideout; David Porter,6,0,36,30
1657762194339,MATH 20A,A01,083754,Zheng; Zequn,14,0,40,26
1657762200363,MATH 20B,A01,083756,Briones; Jor-el Thomas Caparas,4,0,36,32
1657762200363,MATH 20B,A02,083757,Briones; Jor-el Thomas Caparas,1,0,36,35
1657762200363,MATH 20B,A03,093475,Briones; Jor-el Thomas Caparas,2,0,36,34
1657762206387,MATH 20C,A01,083760,Briones; Jor-el Thomas Caparas,1,0,35,34
1657762206387,MATH 20C,A02,083761,Briones; Jor-el Thomas Caparas,8,0,35,27
1657762206387,MATH 20C,A03,093476,Briones; Jor-el Thomas Caparas,0,1,36,36
1657762206387,MATH 20C,B01,083762,Bach; Quang Tran,1,0,30,29
1657762212414,MATH 20D,A01,083765,Tran; Brian Kha,5,0,30,25
1657762212414,MATH 20D,A02,083766,Tran; Brian Kha,5,0,30,25
1657762212414,MATH 20D,A03,083767,Tran; Brian Kha,5,0,30,25
1657762218441,MATH 20E,A01,083771,Ganguly; Soumya,9,0,32,23
1657762218441,MATH 20E,A02,083772,Ganguly; Soumya,6,0,32,26
1657762218441,MATH 20E,B01,083773,Ciotti; Benjamin,20,0,35,15
1657762218441,MATH 20E,B02,083774,Ciotti; Benjamin,18,0,35,17
1657762224472,MATH 103A,A01,083777,Greenfeld; Be'Eri,3,0,36,33
1657762224472,MATH 103A,A02,083778,Greenfeld; Be'Eri,5,0,36,31
1657762224472,MATH 103A,A03,093561,Greenfeld; Be'Eri,6,0,36,30
1657762224472,MATH 103A,B01,083779,Greenfeld; Be'Eri,7,0,36,29
1657762224472,MATH 103A,B02,083780,Greenfeld; Be'Eri,4,0,36,32
1657762224472,MATH 103A,B03,093562,Greenfeld; Be'Eri,3,0,36,33
1657762230496,MATH 105,A01,085443,Carter; Anne Toulson,15,0,35,20
1657762230496,MATH 105,A02,093477,Carter; Anne Toulson,20,0,35,15
1657762236521,MATH 109,A01,083213,Ganzberger; Geoffrey Michael,3,0,34,31
1657762236521,MATH 109,A02,083214,Ganzberger; Geoffrey Michael,4,0,34,30
1657762236521,MATH 109,A03,093478,Ganzberger; Geoffrey Michael,2,0,34,32
1657762236521,MATH 109,B01,083215,Ganzberger; Geoffrey Michael,1,0,32,31
1657762236521,MATH 109,B02,083216,Ganzberger; Geoffrey Michael,2,0,32,30
1657762236521,MATH 109,B03,093479,Ganzberger; Geoffrey Michael,8,0,32,24
1657762242546,MATH 142A,A01,083219,Chow; Bennett,7,0,32,25
1657762242546,MATH 142A,A02,083220,Chow; Bennett,10,0,32,22
1657762242546,MATH 142A,A03,093480,Chow; Bennett,9,0,32,23
1657762242546,MATH 142A,B03,093481,Chow; Bennett,8,0,32,24
1657762242546,MATH 142A,B04,093558,Chow; Bennett,13,0,32,19
1657762242546,MATH 142A,B05,093559,Chow; Bennett,6,0,32,26
1657762248640,MATH 193A,A01,083224,Rotar; Vladimir,8,0,34,26
1657762248640,MATH 193A,A02,083225,Rotar; Vladimir,9,0,34,25
1657762248640,MATH 193A,A03,083781,Rotar; Vladimir,5,0,34,29
1657762248640,MATH 193A,A04,083782,Rotar; Vladimir,10,0,34,24
1657762248640,MATH 193A,A05,093482,Rotar; Vladimir,10,0,34,24
1657762254667,MATH 197,001,091859,McAuley; Julian John,9999,0,9999,0
1657762254667,MATH 197,002,095566,Kedlaya; Kiran S.,9997,0,9999,2
1657762254667,MATH 197,003,095567,Xiao; Ming,9999,0,9999,0
1657762254667,MATH 197,004,095571,Perols; Johan Lars,9998,0,9999,1
1657762261731,COGS 9,A01,083615,Shannon; Kyle Michael,9,0,75,66
1657762267762,COGS 11,A01,083617,Boyle; Mary E. T.,23,0,48,25
1657762273788,COGS 13,A01,083071,Bastos; Amalia Pinkusfeld,11,0,71,60
1657762279811,COGS 14A,A01,092681,Semenuks; Arturs,5,1,100,95
1657762285835,COGS 14B,A01,083073,Cheng; Tzu-Han,6,0,63,57
1657762291859,COGS 17,A01,092677,Semenuks; Arturs,6,0,81,75
1657762297887,COGS 100,A01,083619,Allen; Michael Gordon,17,0,70,53
1657762303915,COGS 101A,A01,083621,Davis; Joshua Daniel,9,0,68,59
1657762309950,COGS 101B,A01,091572,Allen; Michael Gordon,12,0,65,53
1657762315975,COGS 101C,A01,083625,Delgado; Tania,17,0,35,18
1657762321999,COGS 107A,A01,083627,Boyle; Mary E. T.,13,0,60,47
1657762328037,COGS 118A,A01,083075,Gupta; Anjum,21,0,76,55
1657762334060,CSE 3,A50,083646,Miranda; Gregory Joseph,24,0,50,26
1657762340085,CSE 8A,A50,083650,Miranda; Gregory Joseph,17,1,56,39
1657762346108,CSE 11,A01,083080,Cao; Yingjun,6,15,40,34
1657762352133,CSE 12,A01,083652,Krause-Levy; Sophia Louisa,28,1,120,92
1657762358162,CSE 15L,A01,083654,Morris; Justin Loren,9,0,50,41
1657762358162,CSE 15L,A02,083655,Morris; Justin Loren,9,0,50,41
1657762364193,CSE 20,A01,083657,Tran; Khoa Dang,39,0,80,41
1657762370220,CSE 21,A01,095574,Bach; Quang Tran,22,0,48,26
1657762376247,CSE 30,A01,083084,Eldon; John,6,0,80,74
1657762376247,CSE 30,B01,095061,Bhaskar; Nishant,9,0,50,41
1657762382277,CSE 100,A01,083659,Cao; Yingjun,5,4,70,65
1657762388300,CSE 134B,A01,083661,Powell; Thomas Allan,24,0,100,76
1657762394327,CSE 140,A01,083663,Gungor; Onat,15,0,85,70
1657762400360,CSE 140L,A01,083088,Eldon; John,23,0,100,77
1657762406383,CSE 175,A01,083665,Kumar; Rakesh,3,0,25,22
1657762412405,CSE 190,A00,092507,Dubnov; Shlomo,8,0,20,12
1657762418427,ECE 45,A01,083139,Congero; Spencer William,6,0,75,69
1657762424463,ECE 65,A50,083695,Saad; Andrew S,12,0,30,18
1657762424463,ECE 65,A51,095125,Saad; Andrew S,24,0,26,2
1657762430489,ECE 109,A01,091882,Touri; Behrouz,20,0,70,50
1657762436517,ECE 180,A00,083140,Abi Samra; Nicholas Camill,1,0,30,29
1657762436517,ECE 180,B00,083141,Abi Samra; Nicholas Camill,0,0,30,30
1657762442555,MATH 10A,A01,083735,Patchell; Gregory David,2,0,30,28
1657762442555,MATH 10A,A02,083736,Patchell; Gregory David,20,0,30,10
1657762442555,MATH 10A,A03,083737,Patchell; Gregory David,16,0,30,14
1657762448579,MATH 10B,A01,083207,Lim; Seonhee,8,0,34,26
1657762448579,MATH 10B,A02,083208,Lim; Seonhee,9,0,35,26
1657762448579,MATH 10B,A03,093472,Lim; Seonhee,7,0,34,27
1657762448579,MATH 10B,B01,083739,Sinha; Shubham,13,0,30,17
1657762454610,MATH 18,A01,083743,Cinel; Cameron Alexander,9,0,30,21
1657762454610,MATH 18,A02,083744,Cinel; Cameron Alexander,18,0,30,12
1657762454610,MATH 18,A03,083745,Cinel; Cameron Alexander,10,0,30,20
1657762454610,MATH 18,B01,083748,Rideout; David Porter,5,0,37,32
1657762454610,MATH 18,B02,083749,Rideout; David Porter,5,0,36,31
1657762454610,MATH 18,B03,083750,Rideout; David Porter,3,0,37,34
1657762454610,MATH 18,B04,083751,Rideout; David Porter,6,0,36,30
1657762454610,MATH 18,B05,093473,Rideout; David Porter,6,0,36,30
1657762454610,MATH 18,B06,093474,Rideout; David Porter,6,0,36,30
1657762460637,MATH 20A,A01,083754,Zheng; Zequn,14,0,40,26
1657762466662,MATH 20B,A01,083756,Briones; Jor-el Thomas Caparas,4,0,36,32
1657762466662,MATH 20B,A02,083757,Briones; Jor-el Thomas Caparas,1,0,36,35
1657762466662,MATH 20B,A03,093475,Briones; Jor-el Thomas Caparas,2,0,36,34
1657762472686,MATH 20C,A01,083760,Briones; Jor-el Thomas Caparas,1,0,35,34
1657762472686,MATH 20C,A02,083761,Briones; Jor-el Thomas Caparas,8,0,35,27
1657762472686,MATH 20C,A03,093476,Briones; Jor-el Thomas Caparas,0,1,36,36
1657762472686,MATH 20C,B01,083762,Bach; Quang Tran,1,0,30,29
1657762478710,MATH 20D,A01,083765,Tran; Brian Kha,5,0,30,25
1657762478710,MATH 20D,A02,083766,Tran; Brian Kha,5,0,30,25
1657762478710,MATH 20D,A03,083767,Tran; Brian Kha,5,0,30,25
1657762484736,MATH 20E,A01,083771,Ganguly; Soumya,9,0,32,23
1657762484736,MATH 20E,A02,083772,Ganguly; Soumya,6,0,32,26
1657762484736,MATH 20E,B01,083773,Ciotti; Benjamin,20,0,35,15
1657762484736,MATH 20E,B02,083774,Ciotti; Benjamin,18,0,35,17
1657762490767,MATH 103A,A01,083777,Greenfeld; Be'Eri,3,0,36,33
1657762490767,MATH 103A,A02,083778,Greenfeld; Be'Eri,5,0,36,31
1657762490767,MATH 103A,A03,093561,Greenfeld; Be'Eri,6,0,36,30
1657762490767,MATH 103A,B01,083779,Greenfeld; Be'Eri,7,0,36,29
1657762490767,MATH 103A,B02,083780,Greenfeld; Be'Eri,4,0,36,32
1657762490767,MATH 103A,B03,093562,Greenfeld; Be'Eri,3,0,36,33
1657762496791,MATH 105,A01,085443,Carter; Anne Toulson,15,0,35,20
1657762496791,MATH 105,A02,093477,Carter; Anne Toulson,20,0,35,15
1657762502824,MATH 109,A01,083213,Ganzberger; Geoffrey Michael,3,0,34,31
1657762502824,MATH 109,A02,083214,Ganzberger; Geoffrey Michael,4,0,34,30
1657762502824,MATH 109,A03,093478,Ganzberger; Geoffrey Michael,2,0,34,32
1657762502824,MATH 109,B01,083215,Ganzberger; Geoffrey Michael,1,0,32,31
1657762502824,MATH 109,B02,083216,Ganzberger; Geoffrey Michael,2,0,32,30
1657762502824,MATH 109,B03,093479,Ganzberger; Geoffrey Michael,8,0,32,24
1657762508875,MATH 142A,A01,083219,Chow; Bennett,7,0,32,25
1657762508875,MATH 142A,A02,083220,Chow; Bennett,10,0,32,22
1657762508875,MATH 142A,A03,093480,Chow; Bennett,9,0,32,23
1657762508875,MATH 142A,B03,093481,Chow; Bennett,8,0,32,24
1657762508875,MATH 142A,B04,093558,Chow; Bennett,13,0,32,19
1657762508875,MATH 142A,B05,093559,Chow; Bennett,6,0,32,26
1657762514912,MATH 193A,A01,083224,Rotar; Vladimir,8,0,34,26
1657762514912,MATH 193A,A02,083225,Rotar; Vladimir,9,0,34,25
1657762514912,MATH 193A,A03,083781,Rotar; Vladimir,5,0,34,29
1657762514912,MATH 193A,A04,083782,Rotar; Vladimir,10,0,34,24
1657762514912,MATH 193A,A05,093482,Rotar; Vladimir,10,0,34,24
1657762520935,MATH 197,001,091859,McAuley; Julian John,9999,0,9999,0
1657762520935,MATH 197,002,095566,Kedlaya; Kiran S.,9997,0,9999,2
1657762520935,MATH 197,003,095567,Xiao; Ming,9999,0,9999,0
1657762520935,MATH 197,004,095571,Perols; Johan Lars,9998,0,9999,1
1657762527990,COGS 9,A01,083615,Shannon; Kyle Michael,9,0,75,66
1657762534017,COGS 11,A01,083617,Boyle; Mary E. T.,23,0,48,25
1657762540040,COGS 13,A01,083071,Bastos; Amalia Pinkusfeld,11,0,71,60
1657762546067,COGS 14A,A01,092681,Semenuks; Arturs,5,1,100,95
1657762552104,COGS 14B,A01,083073,Cheng; Tzu-Han,6,0,63,57
1657762558135,COGS 17,A01,092677,Semenuks; Arturs,6,0,81,75
1657762564159,COGS 100,A01,083619,Allen; Michael Gordon,17,0,70,53
1657762570186,COGS 101A,A01,083621,Davis; Joshua Daniel,9,0,68,59
1657762576210,COGS 101B,A01,091572,Allen; Michael Gordon,12,0,65,53
1657762582233,COGS 101C,A01,083625,Delgado; Tania,17,0,35,18
1657762588256,COGS 107A,A01,083627,Boyle; Mary E. T.,13,0,60,47
1657762594283,COGS 118A,A01,083075,Gupta; Anjum,21,0,76,55
1657762600305,CSE 3,A50,083646,Miranda; Gregory Joseph,24,0,50,26
1657762606338,CSE 8A,A50,083650,Miranda; Gregory Joseph,17,1,56,39
1657762612365,CSE 11,A01,083080,Cao; Yingjun,6,15,40,34
1657762618392,CSE 12,A01,083652,Krause-Levy; Sophia Louisa,28,1,120,92
1657762624426,CSE 15L,A01,083654,Morris; Justin Loren,9,0,50,41
1657762624426,CSE 15L,A02,083655,Morris; Justin Loren,9,0,50,41
1657762630462,CSE 20,A01,083657,Tran; Khoa Dang,39,0,80,41
1657762636490,CSE 21,A01,095574,Bach; Quang Tran,22,0,48,26
1657762642517,CSE 30,A01,083084,Eldon; John,6,0,80,74
1657762642517,CSE 30,B01,095061,Bhaskar; Nishant,9,0,50,41
1657762648541,CSE 100,A01,083659,Cao; Yingjun,5,4,70,65
1657762654568,CSE 134B,A01,083661,Powell; Thomas Allan,24,0,100,76
1657762660589,CSE 140,A01,083663,Gungor; Onat,15,0,85,70
1657762666616,CSE 140L,A01,083088,Eldon; John,23,0,100,77
1657762672642,CSE 175,A01,083665,Kumar; Rakesh,3,0,25,22
1657762678665,CSE 190,A00,092507,Dubnov; Shlomo,8,0,20,12
1657762684688,ECE 45,A01,083139,Congero; Spencer William,6,0,75,69
1657762690732,ECE 65,A50,083695,Saad; Andrew S,12,0,30,18
1657762690732,ECE 65,A51,095125,Saad; Andrew S,24,0,26,2
1657762696760,ECE 109,A01,091882,Touri; Behrouz,20,0,70,50
1657762702787,ECE 180,A00,083140,Abi Samra; Nicholas Camill,1,0,30,29
1657762702787,ECE 180,B00,083141,Abi Samra; Nicholas Camill,0,0,30,30
1657762708813,MATH 10A,A01,083735,Patchell; Gregory David,2,0,30,28
1657762708813,MATH 10A,A02,083736,Patchell; Gregory David,20,0,30,10
1657762708813,MATH 10A,A03,083737,Patchell; Gregory David,16,0,30,14
1657762714847,MATH 10B,A01,083207,Lim; Seonhee,8,0,34,26
1657762714847,MATH 10B,A02,083208,Lim; Seonhee,9,0,35,26
1657762714847,MATH 10B,A03,093472,Lim; Seonhee,7,0,34,27
1657762714847,MATH 10B,B01,083739,Sinha; Shubham,13,0,30,17
1657762720871,MATH 18,A01,083743,Cinel; Cameron Alexander,9,0,30,21
1657762720871,MATH 18,A02,083744,Cinel; Cameron Alexander,18,0,30,12
1657762720871,MATH 18,A03,083745,Cinel; Cameron Alexander,10,0,30,20
1657762720871,MATH 18,B01,083748,Rideout; David Porter,5,0,37,32
1657762720871,MATH 18,B02,083749,Rideout; David Porter,5,0,36,31
1657762720871,MATH 18,B03,083750,Rideout; David Porter,3,0,37,34
1657762720871,MATH 18,B04,083751,Rideout; David Porter,6,0,36,30
1657762720871,MATH 18,B05,093473,Rideout; David Porter,6,0,36,30
1657762720871,MATH 18,B06,093474,Rideout; David Porter,6,0,36,30
1657762726899,MATH 20A,A01,083754,Zheng; Zequn,14,0,40,26
1657762732927,MATH 20B,A01,083756,Briones; Jor-el Thomas Caparas,4,0,36,32
1657762732927,MATH 20B,A02,083757,Briones; Jor-el Thomas Caparas,1,0,36,35
1657762732927,MATH 20B,A03,093475,Briones; Jor-el Thomas Caparas,2,0,36,34
1657762738954,MATH 20C,A01,083760,Briones; Jor-el Thomas Caparas,1,0,35,34
1657762738954,MATH 20C,A02,083761,Briones; Jor-el Thomas Caparas,8,0,35,27
1657762738954,MATH 20C,A03,093476,Briones; Jor-el Thomas Caparas,0,1,36,36
1657762738954,MATH 20C,B01,083762,Bach; Quang Tran,1,0,30,29
1657762744988,MATH 20D,A01,083765,Tran; Brian Kha,5,0,30,25
1657762744988,MATH 20D,A02,083766,Tran; Brian Kha,5,0,30,25
1657762744988,MATH 20D,A03,083767,Tran; Brian Kha,5,0,30,25
1657762751015,MATH 20E,A01,083771,Ganguly; Soumya,9,0,32,23
1657762751015,MATH 20E,A02,083772,Ganguly; Soumya,6,0,32,26
1657762751015,MATH 20E,B01,083773,Ciotti; Benjamin,20,0,35,15
1657762751015,MATH 20E,B02,083774,Ciotti; Benjamin,18,0,35,17
1657762757039,MATH 103A,A01,083777,Greenfeld; Be'Eri,3,0,36,33
1657762757039,MATH 103A,A02,083778,Greenfeld; Be'Eri,5,0,36,31
1657762757039,MATH 103A,A03,093561,Greenfeld; Be'Eri,6,0,36,30
1657762757039,MATH 103A,B01,083779,Greenfeld; Be'Eri,7,0,36,29
1657762757039,MATH 103A,B02,083780,Greenfeld; Be'Eri,4,0,36,32
1657762757039,MATH 103A,B03,093562,Greenfeld; Be'Eri,3,0,36,33
1657762763064,MATH 105,A01,085443,Carter; Anne Toulson,15,0,35,20
1657762763064,MATH 105,A02,093477,Carter; Anne Toulson,20,0,35,15
1657762769094,MATH 109,A01,083213,Ganzberger; Geoffrey Michael,3,0,34,31
1657762769094,MATH 109,A02,083214,Ganzberger; Geoffrey Michael,4,0,34,30
1657762769094,MATH 109,A03,093478,Ganzberger; Geoffrey Michael,2,0,34,32
1657762769094,MATH 109,B01,083215,Ganzberger; Geoffrey Michael,1,0,32,31
1657762769094,MATH 109,B02,083216,Ganzberger; Geoffrey Michael,2,0,32,30
1657762769094,MATH 109,B03,093479,Ganzberger; Geoffrey Michael,8,0,32,24
1657762775117,MATH 142A,A01,083219,Chow; Bennett,7,0,32,25
1657762775117,MATH 142A,A02,083220,Chow; Bennett,10,0,32,22
1657762775117,MATH 142A,A03,093480,Chow; Bennett,9,0,32,23
1657762775117,MATH 142A,B03,093481,Chow; Bennett,8,0,32,24
1657762775117,MATH 142A,B04,093558,Chow; Bennett,13,0,32,19
1657762775117,MATH 142A,B05,093559,Chow; Bennett,6,0,32,26
1657762781140,MATH 193A,A01,083224,Rotar; Vladimir,8,0,34,26
1657762781140,MATH 193A,A02,083225,Rotar; Vladimir,9,0,34,25
1657762781140,MATH 193A,A03,083781,Rotar; Vladimir,5,0,34,29
1657762781140,MATH 193A,A04,083782,Rotar; Vladimir,10,0,34,24
1657762781140,MATH 193A,A05,093482,Rotar; Vladimir,10,0,34,24
1657762787164,MATH 197,001,091859,McAuley; Julian John,9999,0,9999,0
1657762787164,MATH 197,002,095566,Kedlaya; Kiran S.,9997,0,9999,2
1657762787164,MATH 197,003,095567,Xiao; Ming,9999,0,9999,0
1657762787164,MATH 197,004,095571,Perols; Johan Lars,9998,0,9999,1
1657762794236,COGS 9,A01,083615,Shannon; Kyle Michael,9,0,75,66
1657762800260,COGS 11,A01,083617,Boyle; Mary E. T.,23,0,48,25
1657762806287,COGS 13,A01,083071,Bastos; Amalia Pinkusfeld,11,0,71,60
1657762812310,COGS 14A,A01,092681,Semenuks; Arturs,5,1,100,95
1657762818342,COGS 14B,A01,083073,Cheng; Tzu-Han,6,0,63,57
1657762824365,COGS 17,A01,092677,Semenuks; Arturs,6,0,81,75
1657762830392,COGS 100,A01,083619,Allen; Michael Gordon,17,0,70,53
1657762836414,COGS 101A,A01,083621,Davis; Joshua Daniel,9,0,68,59
1657762842532,COGS 101B,A01,091572,Allen; Michael Gordon,12,0,65,53
1657762848572,COGS 101C,A01,083625,Delgado; Tania,17,0,35,18
1657762854600,COGS 107A,A01,083627,Boyle; Mary E. T.,13,0,60,47
1657762860622,COGS 118A,A01,083075,Gupta; Anjum,21,0,76,55
1657762866649,CSE 3,A50,083646,Miranda; Gregory Joseph,24,0,50,26
1657762872672,CSE 8A,A50,083650,Miranda; Gregory Joseph,17,1,56,39
1657762878697,CSE 11,A01,083080,Cao; Yingjun,6,15,40,34
1657762884726,CSE 12,A01,083652,Krause-Levy; Sophia Louisa,28,1,120,92
1657762890762,CSE 15L,A01,083654,Morris; Justin Loren,9,0,50,41
1657762890762,CSE 15L,A02,083655,Morris; Justin Loren,9,0,50,41
1657762896790,CSE 20,A01,083657,Tran; Khoa Dang,39,0,80,41
1657762902814,CSE 21,A01,095574,Bach; Quang Tran,22,0,48,26
1657762908837,CSE 30,A01,083084,Eldon; John,6,0,80,74
1657762908837,CSE 30,B01,095061,Bhaskar; Nishant,9,0,50,41
1657762914875,CSE 100,A01,083659,Cao; Yingjun,5,4,70,65
1657762920901,CSE 134B,A01,083661,Powell; Thomas Allan,24,0,100,76
1657762926923,CSE 140,A01,083663,Gungor; Onat,15,0,85,70
1657762932947,CSE 140L,A01,083088,Eldon; John,23,0,100,77
1657762938970,CSE 175,A01,083665,Kumar; Rakesh,3,0,25,22
1657762944994,CSE 190,A00,092507,Dubnov; Shlomo,8,0,20,12
1657762951020,ECE 45,A01,083139,Congero; Spencer William,6,0,75,69
1657762957044,ECE 65,A50,083695,Saad; Andrew S,12,0,30,18
1657762957044,ECE 65,A51,095125,Saad; Andrew S,24,0,26,2
1657762963070,ECE 109,A01,091882,Touri; Behrouz,20,0,70,50
1657762969093,ECE 180,A00,083140,Abi Samra; Nicholas Camill,1,0,30,29
1657762969093,ECE 180,B00,083141,Abi Samra; Nicholas Camill,0,0,30,30
1657762975125,MATH 10A,A01,083735,Patchell; Gregory David,2,0,30,28
1657762975125,MATH 10A,A02,083736,Patchell; Gregory David,20,0,30,10
1657762975125,MATH 10A,A03,083737,Patchell; Gregory David,16,0,30,14
1657762981152,MATH 10B,A01,083207,Lim; Seonhee,8,0,34,26
1657762981152,MATH 10B,A02,083208,Lim; Seonhee,9,0,35,26
1657762981152,MATH 10B,A03,093472,Lim; Seonhee,7,0,34,27
1657762981152,MATH 10B,B01,083739,Sinha; Shubham,13,0,30,17
1657762987176,MATH 18,A01,083743,Cinel; Cameron Alexander,9,0,30,21
1657762987176,MATH 18,A02,083744,Cinel; Cameron Alexander,18,0,30,12
1657762987176,MATH 18,A03,083745,Cinel; Cameron Alexander,10,0,30,20
1657762987176,MATH 18,B01,083748,Rideout; David Porter,5,0,37,32
1657762987176,MATH 18,B02,083749,Rideout; David Porter,5,0,36,31
1657762987176,MATH 18,B03,083750,Rideout; David Porter,3,0,37,34
1657762987176,MATH 18,B04,083751,Rideout; David Porter,6,0,36,30
1657762987176,MATH 18,B05,093473,Rideout; David Porter,6,0,36,30
1657762987176,MATH 18,B06,093474,Rideout; David Porter,6,0,36,30
1657762993199,MATH 20A,A01,083754,Zheng; Zequn,14,0,40,26
1657762999221,MATH 20B,A01,083756,Briones; Jor-el Thomas Caparas,4,0,36,32
1657762999221,MATH 20B,A02,083757,Briones; Jor-el Thomas Caparas,1,0,36,35
1657762999221,MATH 20B,A03,093475,Briones; Jor-el Thomas Caparas,2,0,36,34
1657763005244,MATH 20C,A01,083760,Briones; Jor-el Thomas Caparas,1,0,35,34
1657763005244,MATH 20C,A02,083761,Briones; Jor-el Thomas Caparas,8,0,35,27
1657763005244,MATH 20C,A03,093476,Briones; Jor-el Thomas Caparas,0,1,36,36
1657763005244,MATH 20C,B01,083762,Bach; Quang Tran,1,0,30,29
1657763011267,MATH 20D,A01,083765,Tran; Brian Kha,5,0,30,25
1657763011267,MATH 20D,A02,083766,Tran; Brian Kha,5,0,30,25
1657763011267,MATH 20D,A03,083767,Tran; Brian Kha,5,0,30,25
1657763017297,MATH 20E,A01,083771,Ganguly; Soumya,9,0,32,23
1657763017297,MATH 20E,A02,083772,Ganguly; Soumya,6,0,32,26
1657763017297,MATH 20E,B01,083773,Ciotti; Benjamin,20,0,35,15
1657763017297,MATH 20E,B02,083774,Ciotti; Benjamin,18,0,35,17
1657763023320,MATH 103A,A01,083777,Greenfeld; Be'Eri,3,0,36,33
1657763023320,MATH 103A,A02,083778,Greenfeld; Be'Eri,5,0,36,31
1657763023320,MATH 103A,A03,093561,Greenfeld; Be'Eri,6,0,36,30
1657763023320,MATH 103A,B01,083779,Greenfeld; Be'Eri,7,0,36,29
1657763023320,MATH 103A,B02,083780,Greenfeld; Be'Eri,4,0,36,32
1657763023320,MATH 103A,B03,093562,Greenfeld; Be'Eri,3,0,36,33
1657763029343,MATH 105,A01,085443,Carter; Anne Toulson,15,0,35,20
1657763029343,MATH 105,A02,093477,Carter; Anne Toulson,20,0,35,15
1657763035367,MATH 109,A01,083213,Ganzberger; Geoffrey Michael,3,0,34,31
1657763035367,MATH 109,A02,083214,Ganzberger; Geoffrey Michael,4,0,34,30
1657763035367,MATH 109,A03,093478,Ganzberger; Geoffrey Michael,2,0,34,32
1657763035367,MATH 109,B01,083215,Ganzberger; Geoffrey Michael,1,0,32,31
1657763035367,MATH 109,B02,083216,Ganzberger; Geoffrey Michael,2,0,32,30
1657763035367,MATH 109,B03,093479,Ganzberger; Geoffrey Michael,8,0,32,24
1657763041391,MATH 142A,A01,083219,Chow; Bennett,7,0,32,25
1657763041391,MATH 142A,A02,083220,Chow; Bennett,10,0,32,22
1657763041391,MATH 142A,A03,093480,Chow; Bennett,9,0,32,23
1657763041391,MATH 142A,B03,093481,Chow; Bennett,8,0,32,24
1657763041391,MATH 142A,B04,093558,Chow; Bennett,13,0,32,19
1657763041391,MATH 142A,B05,093559,Chow; Bennett,6,0,32,26
1657763047415,MATH 193A,A01,083224,Rotar; Vladimir,8,0,34,26
1657763047415,MATH 193A,A02,083225,Rotar; Vladimir,9,0,34,25
1657763047415,MATH 193A,A03,083781,Rotar; Vladimir,5,0,34,29
1657763047415,MATH 193A,A04,083782,Rotar; Vladimir,10,0,34,24
1657763047415,MATH 193A,A05,093482,Rotar; Vladimir,10,0,34,24
1657763053437,MATH 197,001,091859,McAuley; Julian John,9999,0,9999,0
1657763053437,MATH 197,002,095566,Kedlaya; Kiran S.,9997,0,9999,2
1657763053437,MATH 197,003,095567,Xiao; Ming,9999,0,9999,0
1657763053437,MATH 197,004,095571,Perols; Johan Lars,9998,0,9999,1
1657763060489,COGS 9,A01,083615,Shannon; Kyle Michael,9,0,75,66
1657763066513,COGS 11,A01,083617,Boyle; Mary E. T.,23,0,48,25
1657763072536,COGS 13,A01,083071,Bastos; Amalia Pinkusfeld,11,0,71,60
1657763078565,COGS 14A,A01,092681,Semenuks; Arturs,5,1,100,95
1657763084586,COGS 14B,A01,083073,Cheng; Tzu-Han,6,0,63,57
1657763090616,COGS 17,A01,092677,Semenuks; Arturs,6,0,81,75
1657763096641,COGS 100,A01,083619,Allen; Michael Gordon,17,0,70,53
1657763102664,COGS 101A,A01,083621,Davis; Joshua Daniel,9,0,68,59
1657763108690,COGS 101B,A01,091572,Allen; Michael Gordon,12,0,65,53
1657763114713,COGS 101C,A01,083625,Delgado; Tania,17,0,35,18
1657763120736,COGS 107A,A01,083627,Boyle; Mary E. T.,13,0,60,47
1657763126762,COGS 118A,A01,083075,Gupta; Anjum,21,0,76,55
1657763132789,CSE 3,A50,083646,Miranda; Gregory Joseph,24,0,50,26
1657763138817,CSE 8A,A50,083650,Miranda; Gregory Joseph,17,1,56,39
1657763144847,CSE 11,A01,083080,Cao; Yingjun,6,15,40,34
1657763150875,CSE 12,A01,083652,Krause-Levy; Sophia Louisa,28,1,120,92
1657763156898,CSE 15L,A01,083654,Morris; Justin Loren,9,0,50,41
1657763156898,CSE 15L,A02,083655,Morris; Justin Loren,9,0,50,41
1657763162922,CSE 20,A01,083657,Tran; Khoa Dang,39,0,80,41
1657763168945,CSE 21,A01,095574,Bach; Quang Tran,22,0,48,26
1657763174969,CSE 30,A01,083084,Eldon; John,6,0,80,74
1657763174969,CSE 30,B01,095061,Bhaskar; Nishant,9,0,50,41
1657763180992,CSE 100,A01,083659,Cao; Yingjun,5,4,70,65
1657763187017,CSE 134B,A01,083661,Powell; Thomas Allan,24,0,100,76
1657763193039,CSE 140,A01,083663,Gungor; Onat,15,0,85,70
1657763199061,CSE 140L,A01,083088,Eldon; John,23,0,100,77
1657763205084,CSE 175,A01,083665,Kumar; Rakesh,3,0,25,22
1657763211108,CSE 190,A00,092507,Dubnov; Shlomo,8,0,20,12
1657763217139,ECE 45,A01,083139,Congero; Spencer William,6,0,75,69
1657763223162,ECE 65,A50,083695,Saad; Andrew S,12,0,30,18
1657763223162,ECE 65,A51,095125,Saad; Andrew S,24,0,26,2
1657763229189,ECE 109,A01,091882,Touri; Behrouz,20,0,70,50
1657763235218,ECE 180,A00,083140,Abi Samra; Nicholas Camill,1,0,30,29
1657763235218,ECE 180,B00,083141,Abi Samra; Nicholas Camill,0,0,30,30
1657763241248,MATH 10A,A01,083735,Patchell; Gregory David,2,0,30,28
1657763241248,MATH 10A,A02,083736,Patchell; Gregory David,20,0,30,10
1657763241248,MATH 10A,A03,083737,Patchell; Gregory David,16,0,30,14
1657763247270,MATH 10B,A01,083207,Lim; Seonhee,8,0,34,26
1657763247270,MATH 10B,A02,083208,Lim; Seonhee,9,0,35,26
1657763247270,MATH 10B,A03,093472,Lim; Seonhee,7,0,34,27
1657763247270,MATH 10B,B01,083739,Sinha; Shubham,13,0,30,17
1657763253293,MATH 18,A01,083743,Cinel; Cameron Alexander,9,0,30,21
1657763253293,MATH 18,A02,083744,Cinel; Cameron Alexander,18,0,30,12
1657763253293,MATH 18,A03,083745,Cinel; Cameron Alexander,10,0,30,20
1657763253293,MATH 18,B01,083748,Rideout; David Porter,5,0,37,32
1657763253293,MATH 18,B02,083749,Rideout; David Porter,5,0,36,31
1657763253293,MATH 18,B03,083750,Rideout; David Porter,3,0,37,34
1657763253293,MATH 18,B04,083751,Rideout; David Porter,6,0,36,30
1657763253293,MATH 18,B05,093473,Rideout; David Porter,6,0,36,30
1657763253293,MATH 18,B06,093474,Rideout; David Porter,6,0,36,30
1657763259319,MATH 20A,A01,083754,Zheng; Zequn,14,0,40,26
1657763265341,MATH 20B,A01,083756,Briones; Jor-el Thomas Caparas,4,0,36,32
1657763265341,MATH 20B,A02,083757,Briones; Jor-el Thomas Caparas,1,0,36,35
1657763265341,MATH 20B,A03,093475,Briones; Jor-el Thomas Caparas,2,0,36,34
1657763271367,MATH 20C,A01,083760,Briones; Jor-el Thomas Caparas,1,0,35,34
1657763271367,MATH 20C,A02,083761,Briones; Jor-el Thomas Caparas,8,0,35,27
1657763271367,MATH 20C,A03,093476,Briones; Jor-el Thomas Caparas,0,1,36,36
1657763271367,MATH 20C,B01,083762,Bach; Quang Tran,1,0,30,29
1657763277414,MATH 20D,A01,083765,Tran; Brian Kha,5,0,30,25
1657763277414,MATH 20D,A02,083766,Tran; Brian Kha,5,0,30,25
1657763277414,MATH 20D,A03,083767,Tran; Brian Kha,5,0,30,25
1657763283438,MATH 20E,A01,083771,Ganguly; Soumya,9,0,32,23
1657763283438,MATH 20E,A02,083772,Ganguly; Soumya,6,0,32,26
1657763283438,MATH 20E,B01,083773,Ciotti; Benjamin,20,0,35,15
1657763283438,MATH 20E,B02,083774,Ciotti; Benjamin,18,0,35,17
1657763289467,MATH 103A,A01,083777,Greenfeld; Be'Eri,3,0,36,33
1657763289467,MATH 103A,A02,083778,Greenfeld; Be'Eri,5,0,36,31
1657763289467,MATH 103A,A03,093561,Greenfeld; Be'Eri,6,0,36,30
1657763289467,MATH 103A,B01,083779,Greenfeld; Be'Eri,7,0,36,29
1657763289467,MATH 103A,B02,083780,Greenfeld; Be'Eri,4,0,36,32
1657763289467,MATH 103A,B03,093562,Greenfeld; Be'Eri,3,0,36,33
1657763295490,MATH 105,A01,085443,Carter; Anne Toulson,15,0,35,20
1657763295490,MATH 105,A02,093477,Carter; Anne Toulson,20,0,35,15
1657763301520,MATH 109,A01,083213,Ganzberger; Geoffrey Michael,3,0,34,31
1657763301520,MATH 109,A02,083214,Ganzberger; Geoffrey Michael,4,0,34,30
1657763301520,MATH 109,A03,093478,Ganzberger; Geoffrey Michael,2,0,34,32
1657763301520,MATH 109,B01,083215,Ganzberger; Geoffrey Michael,1,0,32,31
1657763301520,MATH 109,B02,083216,Ganzberger; Geoffrey Michael,2,0,32,30
1657763301520,MATH 109,B03,093479,Ganzberger; Geoffrey Michael,8,0,32,24
1657763307542,MATH 142A,A01,083219,Chow; Bennett,7,0,32,25
1657763307542,MATH 142A,A02,083220,Chow; Bennett,10,0,32,22
1657763307542,MATH 142A,A03,093480,Chow; Bennett,9,0,32,23
1657763307542,MATH 142A,B03,093481,Chow; Bennett,8,0,32,24
1657763307542,MATH 142A,B04,093558,Chow; Bennett,13,0,32,19
1657763307542,MATH 142A,B05,093559,Chow; Bennett,6,0,32,26
1657763313566,MATH 193A,A01,083224,Rotar; Vladimir,8,0,34,26
1657763313566,MATH 193A,A02,083225,Rotar; Vladimir,9,0,34,25
1657763313566,MATH 193A,A03,083781,Rotar; Vladimir,5,0,34,29
1657763313566,MATH 193A,A04,083782,Rotar; Vladimir,10,0,34,24
1657763313566,MATH 193A,A05,093482,Rotar; Vladimir,10,0,34,24
1657763319606,MATH 197,001,091859,McAuley; Julian John,9999,0,9999,0
1657763319606,MATH 197,002,095566,Kedlaya; Kiran S.,9997,0,9999,2
1657763319606,MATH 197,003,095567,Xiao; Ming,9999,0,9999,0
1657763319606,MATH 197,004,095571,Perols; Johan Lars,9998,0,9999,1
1657763326657,COGS 9,A01,083615,Shannon; Kyle Michael,9,0,75,66
1657763332682,COGS 11,A01,083617,Boyle; Mary E. T.,23,0,48,25
1657763338709,COGS 13,A01,083071,Bastos; Amalia Pinkusfeld,11,0,71,60
1657763344732,COGS 14A,A01,092681,Semenuks; Arturs,5,1,100,95
1657763350758,COGS 14B,A01,083073,Cheng; Tzu-Han,6,0,63,57
1657763356780,COGS 17,A01,092677,Semenuks; Arturs,6,0,81,75
1657763362803,COGS 100,A01,083619,Allen; Michael Gordon,17,0,70,53
1657763368824,COGS 101A,A01,083621,Davis; Joshua Daniel,9,0,68,59
1657763374863,COGS 101B,A01,091572,Allen; Michael Gordon,12,0,65,53
1657763380905,COGS 101C,A01,083625,Delgado; Tania,17,0,35,18
1657763386932,COGS 107A,A01,083627,Boyle; Mary E. T.,13,0,60,47
1657763392955,COGS 118A,A01,083075,Gupta; Anjum,21,0,76,55
1657763398980,CSE 3,A50,083646,Miranda; Gregory Joseph,24,0,50,26
1657763405009,CSE 8A,A50,083650,Miranda; Gregory Joseph,17,1,56,39
1657763411036,CSE 11,A01,083080,Cao; Yingjun,6,15,40,34
1657763417067,CSE 12,A01,083652,Krause-Levy; Sophia Louisa,28,1,120,92
1657763423091,CSE 15L,A01,083654,Morris; Justin Loren,9,0,50,41
1657763423091,CSE 15L,A02,083655,Morris; Justin Loren,9,0,50,41
1657763429118,CSE 20,A01,083657,Tran; Khoa Dang,39,0,80,41
1657763435145,CSE 21,A01,095574,Bach; Quang Tran,22,0,48,26
1657763441254,CSE 30,A01,083084,Eldon; John,6,0,80,74
1657763441254,CSE 30,B01,095061,Bhaskar; Nishant,9,0,50,41
1657763447279,CSE 100,A01,083659,Cao; Yingjun,5,4,70,65
1657763453302,CSE 134B,A01,083661,Powell; Thomas Allan,24,0,100,76
1657763459326,CSE 140,A01,083663,Gungor; Onat,15,0,85,70
1657763465349,CSE 140L,A01,083088,Eldon; John,23,0,100,77
1657763471373,CSE 175,A01,083665,Kumar; Rakesh,3,0,25,22
1657763477406,CSE 190,A00,092507,Dubnov; Shlomo,8,0,20,12
1657763483432,ECE 45,A01,083139,Congero; Spencer William,6,0,75,69
1657763489460,ECE 65,A50,083695,Saad; Andrew S,12,0,30,18
1657763489460,ECE 65,A51,095125,Saad; Andrew S,24,0,26,2
1657763495485,ECE 109,A01,091882,Touri; Behrouz,20,0,70,50
1657763501518,ECE 180,A00,083140,Abi Samra; Nicholas Camill,1,0,30,29
1657763501518,ECE 180,B00,083141,Abi Samra; Nicholas Camill,0,0,30,30
1657763507546,MATH 10A,A01,083735,Patchell; Gregory David,2,0,30,28
1657763507546,MATH 10A,A02,083736,Patchell; Gregory David,20,0,30,10
1657763507546,MATH 10A,A03,083737,Patchell; Gregory David,16,0,30,14
1657763513570,MATH 10B,A01,083207,Lim; Seonhee,8,0,34,26
1657763513570,MATH 10B,A02,083208,Lim; Seonhee,9,0,35,26
1657763513570,MATH 10B,A03,093472,Lim; Seonhee,7,0,34,27
1657763513570,MATH 10B,B01,083739,Sinha; Shubham,13,0,30,17
1657763519595,MATH 18,A01,083743,Cinel; Cameron Alexander,9,0,30,21
1657763519595,MATH 18,A02,083744,Cinel; Cameron Alexander,18,0,30,12
1657763519595,MATH 18,A03,083745,Cinel; Cameron Alexander,10,0,30,20
1657763519595,MATH 18,B01,083748,Rideout; David Porter,5,0,37,32
1657763519595,MATH 18,B02,083749,Rideout; David Porter,5,0,36,31
1657763519595,MATH 18,B03,083750,Rideout; David Porter,3,0,37,34
1657763519595,MATH 18,B04,083751,Rideout; David Porter,6,0,36,30
1657763519595,MATH 18,B05,093473,Rideout; David Porter,6,0,36,30
1657763519595,MATH 18,B06,093474,Rideout; David Porter,6,0,36,30
1657763525618,MATH 20A,A01,083754,Zheng; Zequn,14,0,40,26
1657763531655,MATH 20B,A01,083756,Briones; Jor-el Thomas Caparas,4,0,36,32
1657763531655,MATH 20B,A02,083757,Briones; Jor-el Thomas Caparas,1,0,36,35
1657763531655,MATH 20B,A03,093475,Briones; Jor-el Thomas Caparas,2,0,36,34
1657763537684,MATH 20C,A01,083760,Briones; Jor-el Thomas Caparas,1,0,35,34
1657763537684,MATH 20C,A02,083761,Briones; Jor-el Thomas Caparas,8,0,35,27
1657763537684,MATH 20C,A03,093476,Briones; Jor-el Thomas Caparas,0,1,36,36
1657763537684,MATH 20C,B01,083762,Bach; Quang Tran,1,0,30,29
1657763543709,MATH 20D,A01,083765,Tran; Brian Kha,5,0,30,25
1657763543709,MATH 20D,A02,083766,Tran; Brian Kha,5,0,30,25
1657763543709,MATH 20D,A03,083767,Tran; Brian Kha,5,0,30,25
1657763549738,MATH 20E,A01,083771,Ganguly; Soumya,9,0,32,23
1657763549738,MATH 20E,A02,083772,Ganguly; Soumya,6,0,32,26
1657763549738,MATH 20E,B01,083773,Ciotti; Benjamin,20,0,35,15
1657763549738,MATH 20E,B02,083774,Ciotti; Benjamin,18,0,35,17
1657763555769,MATH 103A,A01,083777,Greenfeld; Be'Eri,3,0,36,33
1657763555769,MATH 103A,A02,083778,Greenfeld; Be'Eri,5,0,36,31
1657763555769,MATH 103A,A03,093561,Greenfeld; Be'Eri,6,0,36,30
1657763555769,MATH 103A,B01,083779,Greenfeld; Be'Eri,7,0,36,29
1657763555769,MATH 103A,B02,083780,Greenfeld; Be'Eri,4,0,36,32
1657763555769,MATH 103A,B03,093562,Greenfeld; Be'Eri,3,0,36,33
1657763561792,MATH 105,A01,085443,Carter; Anne Toulson,15,0,35,20
1657763561792,MATH 105,A02,093477,Carter; Anne Toulson,20,0,35,15
1657763567821,MATH 109,A01,083213,Ganzberger; Geoffrey Michael,3,0,34,31
1657763567821,MATH 109,A02,083214,Ganzberger; Geoffrey Michael,4,0,34,30
1657763567821,MATH 109,A03,093478,Ganzberger; Geoffrey Michael,2,0,34,32
1657763567821,MATH 109,B01,083215,Ganzberger; Geoffrey Michael,1,0,32,31
1657763567821,MATH 109,B02,083216,Ganzberger; Geoffrey Michael,2,0,32,30
1657763567821,MATH 109,B03,093479,Ganzberger; Geoffrey Michael,8,0,32,24
1657763573849,MATH 142A,A01,083219,Chow; Bennett,7,0,32,25
1657763573849,MATH 142A,A02,083220,Chow; Bennett,10,0,32,22
1657763573849,MATH 142A,A03,093480,Chow; Bennett,9,0,32,23
1657763573849,MATH 142A,B03,093481,Chow; Bennett,8,0,32,24
1657763573849,MATH 142A,B04,093558,Chow; Bennett,13,0,32,19
1657763573849,MATH 142A,B05,093559,Chow; Bennett,6,0,32,26
1657763579877,MATH 193A,A01,083224,Rotar; Vladimir,8,0,34,26
1657763579877,MATH 193A,A02,083225,Rotar; Vladimir,9,0,34,25
1657763579877,MATH 193A,A03,083781,Rotar; Vladimir,5,0,34,29
1657763579877,MATH 193A,A04,083782,Rotar; Vladimir,10,0,34,24
1657763579877,MATH 193A,A05,093482,Rotar; Vladimir,10,0,34,24
1657763585902,MATH 197,001,091859,McAuley; Julian John,9999,0,9999,0
1657763585902,MATH 197,002,095566,Kedlaya; Kiran S.,9997,0,9999,2
1657763585902,MATH 197,003,095567,Xiao; Ming,9999,0,9999,0
1657763585902,MATH 197,004,095571,Perols; Johan Lars,9998,0,9999,1
1657763592958,COGS 9,A01,083615,Shannon; Kyle Michael,9,0,75,66
1657763598986,COGS 11,A01,083617,Boyle; Mary E. T.,23,0,48,25
1657763605008,COGS 13,A01,083071,Bastos; Amalia Pinkusfeld,11,0,71,60
1657763611030,COGS 14A,A01,092681,Semenuks; Arturs,5,1,100,95
1657763617069,COGS 14B,A01,083073,Cheng; Tzu-Han,6,0,63,57
1657763623097,COGS 17,A01,092677,Semenuks; Arturs,6,0,81,75
1657763629122,COGS 100,A01,083619,Allen; Michael Gordon,17,0,70,53
1657763635145,COGS 101A,A01,083621,Davis; Joshua Daniel,9,0,68,59
1657763641169,COGS 101B,A01,091572,Allen; Michael Gordon,12,0,65,53
1657763647195,COGS 101C,A01,083625,Delgado; Tania,17,0,35,18
1657763653229,COGS 107A,A01,083627,Boyle; Mary E. T.,13,0,60,47
1657763659252,COGS 118A,A01,083075,Gupta; Anjum,21,0,76,55
1657763665275,CSE 3,A50,083646,Miranda; Gregory Joseph,24,0,50,26
1657763671302,CSE 8A,A50,083650,Miranda; Gregory Joseph,17,1,56,39
1657763677329,CSE 11,A01,083080,Cao; Yingjun,6,15,40,34
1657763683353,CSE 12,A01,083652,Krause-Levy; Sophia Louisa,28,1,120,92
1657763689384,CSE 15L,A01,083654,Morris; Justin Loren,9,0,50,41
1657763689384,CSE 15L,A02,083655,Morris; Justin Loren,9,0,50,41
1657763695413,CSE 20,A01,083657,Tran; Khoa Dang,39,0,80,41
1657763701439,CSE 21,A01,095574,Bach; Quang Tran,22,0,48,26
1657763707466,CSE 30,A01,083084,Eldon; John,6,0,80,74
1657763707466,CSE 30,B01,095061,Bhaskar; Nishant,9,0,50,41
1657763713492,CSE 100,A01,083659,Cao; Yingjun,5,4,70,65
1657763719533,CSE 134B,A01,083661,Powell; Thomas Allan,24,0,100,76
1657763725556,CSE 140,A01,083663,Gungor; Onat,15,0,85,70
1657763731577,CSE 140L,A01,083088,Eldon; John,23,0,100,77
1657763737599,CSE 175,A01,083665,Kumar; Rakesh,3,0,25,22
1657763743631,CSE 190,A00,092507,Dubnov; Shlomo,8,0,20,12
1657763749657,ECE 45,A01,083139,Congero; Spencer William,6,0,75,69
1657763755681,ECE 65,A50,083695,Saad; Andrew S,12,0,30,18
1657763755681,ECE 65,A51,095125,Saad; Andrew S,24,0,26,2
1657763761704,ECE 109,A01,091882,Touri; Behrouz,20,0,70,50
1657763767725,ECE 180,A00,083140,Abi Samra; Nicholas Camill,1,0,30,29
1657763767725,ECE 180,B00,083141,Abi Samra; Nicholas Camill,0,0,30,30
1657763773752,MATH 10A,A01,083735,Patchell; Gregory David,2,0,30,28
1657763773752,MATH 10A,A02,083736,Patchell; Gregory David,20,0,30,10
1657763773752,MATH 10A,A03,083737,Patchell; Gregory David,16,0,30,14
1657763779777,MATH 10B,A01,083207,Lim; Seonhee,8,0,34,26
1657763779777,MATH 10B,A02,083208,Lim; Seonhee,9,0,35,26
1657763779777,MATH 10B,A03,093472,Lim; Seonhee,7,0,34,27
1657763779777,MATH 10B,B01,083739,Sinha; Shubham,13,0,30,17
1657763785808,MATH 18,A01,083743,Cinel; Cameron Alexander,9,0,30,21
1657763785808,MATH 18,A02,083744,Cinel; Cameron Alexander,18,0,30,12
1657763785808,MATH 18,A03,083745,Cinel; Cameron Alexander,10,0,30,20
1657763785808,MATH 18,B01,083748,Rideout; David Porter,5,0,37,32
1657763785808,MATH 18,B02,083749,Rideout; David Porter,5,0,36,31
1657763785808,MATH 18,B03,083750,Rideout; David Porter,3,0,37,34
1657763785808,MATH 18,B04,083751,Rideout; David Porter,6,0,36,30
1657763785808,MATH 18,B05,093473,Rideout; David Porter,6,0,36,30
1657763785808,MATH 18,B06,093474,Rideout; David Porter,6,0,36,30
1657763791843,MATH 20A,A01,083754,Zheng; Zequn,14,0,40,26
1657763797864,MATH 20B,A01,083756,Briones; Jor-el Thomas Caparas,4,0,36,32
1657763797864,MATH 20B,A02,083757,Briones; Jor-el Thomas Caparas,1,0,36,35
1657763797864,MATH 20B,A03,093475,Briones; Jor-el Thomas Caparas,2,0,36,34
1657763803888,MATH 20C,A01,083760,Briones; Jor-el Thomas Caparas,1,0,35,34
1657763803888,MATH 20C,A02,083761,Briones; Jor-el Thomas Caparas,8,0,35,27
1657763803888,MATH 20C,A03,093476,Briones; Jor-el Thomas Caparas,0,1,36,36
1657763803888,MATH 20C,B01,083762,Bach; Quang Tran,1,0,30,29
1657763809911,MATH 20D,A01,083765,Tran; Brian Kha,5,0,30,25
1657763809911,MATH 20D,A02,083766,Tran; Brian Kha,5,0,30,25
1657763809911,MATH 20D,A03,083767,Tran; Brian Kha,5,0,30,25
1657763815936,MATH 20E,A01,083771,Ganguly; Soumya,9,0,32,23
1657763815936,MATH 20E,A02,083772,Ganguly; Soumya,6,0,32,26
1657763815936,MATH 20E,B01,083773,Ciotti; Benjamin,20,0,35,15
1657763815936,MATH 20E,B02,083774,Ciotti; Benjamin,18,0,35,17
1657763821965,MATH 103A,A01,083777,Greenfeld; Be'Eri,3,0,36,33
1657763821965,MATH 103A,A02,083778,Greenfeld; Be'Eri,5,0,36,31
1657763821965,MATH 103A,A03,093561,Greenfeld; Be'Eri,6,0,36,30
1657763821965,MATH 103A,B01,083779,Greenfeld; Be'Eri,7,0,36,29
1657763821965,MATH 103A,B02,083780,Greenfeld; Be'Eri,4,0,36,32
1657763821965,MATH 103A,B03,093562,Greenfeld; Be'Eri,3,0,36,33
1657763827989,MATH 105,A01,085443,Carter; Anne Toulson,15,0,35,20
1657763827989,MATH 105,A02,093477,Carter; Anne Toulson,20,0,35,15
1657763834014,MATH 109,A01,083213,Ganzberger; Geoffrey Michael,3,0,34,31
1657763834014,MATH 109,A02,083214,Ganzberger; Geoffrey Michael,4,0,34,30
1657763834014,MATH 109,A03,093478,Ganzberger; Geoffrey Michael,2,0,34,32
1657763834014,MATH 109,B01,083215,Ganzberger; Geoffrey Michael,1,0,32,31
1657763834014,MATH 109,B02,083216,Ganzberger; Geoffrey Michael,2,0,32,30
1657763834014,MATH 109,B03,093479,Ganzberger; Geoffrey Michael,8,0,32,24
1657763840043,MATH 142A,A01,083219,Chow; Bennett,7,0,32,25
1657763840043,MATH 142A,A02,083220,Chow; Bennett,10,0,32,22
1657763840043,MATH 142A,A03,093480,Chow; Bennett,9,0,32,23
1657763840043,MATH 142A,B03,093481,Chow; Bennett,8,0,32,24
1657763840043,MATH 142A,B04,093558,Chow; Bennett,13,0,32,19
1657763840043,MATH 142A,B05,093559,Chow; Bennett,6,0,32,26
1657763846067,MATH 193A,A01,083224,Rotar; Vladimir,8,0,34,26
1657763846067,MATH 193A,A02,083225,Rotar; Vladimir,9,0,34,25
1657763846067,MATH 193A,A03,083781,Rotar; Vladimir,5,0,34,29
1657763846067,MATH 193A,A04,083782,Rotar; Vladimir,10,0,34,24
1657763846067,MATH 193A,A05,093482,Rotar; Vladimir,10,0,34,24
1657763852093,MATH 197,001,091859,McAuley; Julian John,9999,0,9999,0
1657763852093,MATH 197,002,095566,Kedlaya; Kiran S.,9997,0,9999,2
1657763852093,MATH 197,003,095567,Xiao; Ming,9999,0,9999,0
1657763852093,MATH 197,004,095571,Perols; Johan Lars,9998,0,9999,1
1657763859141,COGS 9,A01,083615,Shannon; Kyle Michael,9,0,75,66
1657763865164,COGS 11,A01,083617,Boyle; Mary E. T.,23,0,48,25
1657763871191,COGS 13,A01,083071,Bastos; Amalia Pinkusfeld,11,0,71,60
1657763877215,COGS 14A,A01,092681,Semenuks; Arturs,5,1,100,95
1657763883238,COGS 14B,A01,083073,Cheng; Tzu-Han,6,0,63,57
1657763889261,COGS 17,A01,092677,Semenuks; Arturs,6,0,81,75
1657763895306,COGS 100,A01,083619,Allen; Michael Gordon,17,0,70,53
1657763901330,COGS 101A,A01,083621,Davis; Joshua Daniel,9,0,68,59
1657763907372,COGS 101B,A01,091572,Allen; Michael Gordon,12,0,65,53
1657763913395,COGS 101C,A01,083625,Delgado; Tania,17,0,35,18
1657763919417,COGS 107A,A01,083627,Boyle; Mary E. T.,13,0,60,47
1657763925440,COGS 118A,A01,083075,Gupta; Anjum,21,0,76,55
1657763931468,CSE 3,A50,083646,Miranda; Gregory Joseph,24,0,50,26
1657763937491,CSE 8A,A50,083650,Miranda; Gregory Joseph,17,1,56,39
1657763943517,CSE 11,A01,083080,Cao; Yingjun,6,15,40,34
1657763949559,CSE 12,A01,083652,Krause-Levy; Sophia Louisa,28,1,120,92
1657763955588,CSE 15L,A01,083654,Morris; Justin Loren,9,0,50,41
1657763955588,CSE 15L,A02,083655,Morris; Justin Loren,9,0,50,41
1657763961611,CSE 20,A01,083657,Tran; Khoa Dang,39,0,80,41
1657763967639,CSE 21,A01,095574,Bach; Quang Tran,22,0,48,26
1657763973664,CSE 30,A01,083084,Eldon; John,6,0,80,74
1657763973664,CSE 30,B01,095061,Bhaskar; Nishant,9,0,50,41
1657763979688,CSE 100,A01,083659,Cao; Yingjun,5,4,70,65
1657763985715,CSE 134B,A01,083661,Powell; Thomas Allan,24,0,100,76
1657763991742,CSE 140,A01,083663,Gungor; Onat,15,0,85,70
1657763997769,CSE 140L,A01,083088,Eldon; John,23,0,100,77
1657764003792,CSE 175,A01,083665,Kumar; Rakesh,3,0,25,22
1657764009815,CSE 190,A00,092507,Dubnov; Shlomo,8,0,20,12
1657764015839,ECE 45,A01,083139,Congero; Spencer William,6,0,75,69
1657764021865,ECE 65,A50,083695,Saad; Andrew S,12,0,30,18
1657764021865,ECE 65,A51,095125,Saad; Andrew S,24,0,26,2
1657764027889,ECE 109,A01,091882,Touri; Behrouz,20,0,70,50
1657764033916,ECE 180,A00,083140,Abi Samra; Nicholas Camill,1,0,30,29
1657764033916,ECE 180,B00,083141,Abi Samra; Nicholas Camill,0,0,30,30
1657764040011,MATH 10A,A01,083735,Patchell; Gregory David,2,0,30,28
1657764040011,MATH 10A,A02,083736,Patchell; Gregory David,20,0,30,10
1657764040011,MATH 10A,A03,083737,Patchell; Gregory David,16,0,30,14
1657764046035,MATH 10B,A01,083207,Lim; Seonhee,8,0,34,26
1657764046035,MATH 10B,A02,083208,Lim; Seonhee,9,0,35,26
1657764046035,MATH 10B,A03,093472,Lim; Seonhee,7,0,34,27
1657764046035,MATH 10B,B01,083739,Sinha; Shubham,13,0,30,17
1657764052067,MATH 18,A01,083743,Cinel; Cameron Alexander,9,0,30,21
1657764052067,MATH 18,A02,083744,Cinel; Cameron Alexander,18,0,30,12
1657764052067,MATH 18,A03,083745,Cinel; Cameron Alexander,10,0,30,20
1657764052067,MATH 18,B01,083748,Rideout; David Porter,5,0,37,32
1657764052067,MATH 18,B02,083749,Rideout; David Porter,5,0,36,31
1657764052067,MATH 18,B03,083750,Rideout; David Porter,3,0,37,34
1657764052067,MATH 18,B04,083751,Rideout; David Porter,6,0,36,30
1657764052067,MATH 18,B05,093473,Rideout; David Porter,6,0,36,30
1657764052067,MATH 18,B06,093474,Rideout; David Porter,6,0,36,30
1657764058089,MATH 20A,A01,083754,Zheng; Zequn,14,0,40,26
1657764064112,MATH 20B,A01,083756,Briones; Jor-el Thomas Caparas,4,0,36,32
1657764064112,MATH 20B,A02,083757,Briones; Jor-el Thomas Caparas,1,0,36,35
1657764064112,MATH 20B,A03,093475,Briones; Jor-el Thomas Caparas,2,0,36,34
1657764070140,MATH 20C,A01,083760,Briones; Jor-el Thomas Caparas,1,0,35,34
1657764070140,MATH 20C,A02,083761,Briones; Jor-el Thomas Caparas,8,0,35,27
1657764070140,MATH 20C,A03,093476,Briones; Jor-el Thomas Caparas,0,1,36,36
1657764070140,MATH 20C,B01,083762,Bach; Quang Tran,1,0,30,29
1657764076162,MATH 20D,A01,083765,Tran; Brian Kha,5,0,30,25
1657764076162,MATH 20D,A02,083766,Tran; Brian Kha,5,0,30,25
1657764076162,MATH 20D,A03,083767,Tran; Brian Kha,5,0,30,25
1657764082186,MATH 20E,A01,083771,Ganguly; Soumya,9,0,32,23
1657764082186,MATH 20E,A02,083772,Ganguly; Soumya,6,0,32,26
1657764082186,MATH 20E,B01,083773,Ciotti; Benjamin,20,0,35,15
1657764082186,MATH 20E,B02,083774,Ciotti; Benjamin,18,0,35,17
1657764088220,MATH 103A,A01,083777,Greenfeld; Be'Eri,3,0,36,33
1657764088220,MATH 103A,A02,083778,Greenfeld; Be'Eri,5,0,36,31
1657764088220,MATH 103A,A03,093561,Greenfeld; Be'Eri,6,0,36,30
1657764088220,MATH 103A,B01,083779,Greenfeld; Be'Eri,7,0,36,29
1657764088220,MATH 103A,B02,083780,Greenfeld; Be'Eri,4,0,36,32
1657764088220,MATH 103A,B03,093562,Greenfeld; Be'Eri,3,0,36,33
1657764094248,MATH 105,A01,085443,Carter; Anne Toulson,15,0,35,20
1657764094248,MATH 105,A02,093477,Carter; Anne Toulson,20,0,35,15
1657764100270,MATH 109,A01,083213,Ganzberger; Geoffrey Michael,3,0,34,31
1657764100270,MATH 109,A02,083214,Ganzberger; Geoffrey Michael,4,0,34,30
1657764100270,MATH 109,A03,093478,Ganzberger; Geoffrey Michael,2,0,34,32
1657764100270,MATH 109,B01,083215,Ganzberger; Geoffrey Michael,1,0,32,31
1657764100270,MATH 109,B02,083216,Ganzberger; Geoffrey Michael,2,0,32,30
1657764100270,MATH 109,B03,093479,Ganzberger; Geoffrey Michael,8,0,32,24
1657764106299,MATH 142A,A01,083219,Chow; Bennett,7,0,32,25
1657764106299,MATH 142A,A02,083220,Chow; Bennett,10,0,32,22
1657764106299,MATH 142A,A03,093480,Chow; Bennett,9,0,32,23
1657764106299,MATH 142A,B03,093481,Chow; Bennett,8,0,32,24
1657764106299,MATH 142A,B04,093558,Chow; Bennett,13,0,32,19
1657764106299,MATH 142A,B05,093559,Chow; Bennett,6,0,32,26
1657764112321,MATH 193A,A01,083224,Rotar; Vladimir,8,0,34,26
1657764112321,MATH 193A,A02,083225,Rotar; Vladimir,9,0,34,25
1657764112321,MATH 193A,A03,083781,Rotar; Vladimir,5,0,34,29
1657764112321,MATH 193A,A04,083782,Rotar; Vladimir,10,0,34,24
1657764112321,MATH 193A,A05,093482,Rotar; Vladimir,10,0,34,24
1657764118352,MATH 197,001,091859,McAuley; Julian John,9999,0,9999,0
1657764118352,MATH 197,002,095566,Kedlaya; Kiran S.,9997,0,9999,2
1657764118352,MATH 197,003,095567,Xiao; Ming,9999,0,9999,0
1657764118352,MATH 197,004,095571,Perols; Johan Lars,9998,0,9999,1
1657764125407,COGS 9,A01,083615,Shannon; Kyle Michael,9,0,75,66
1657764131437,COGS 11,A01,083617,Boyle; Mary E. T.,23,0,48,25
1657764137466,COGS 13,A01,083071,Bastos; Amalia Pinkusfeld,11,0,71,60
1657764143497,COGS 14A,A01,092681,Semenuks; Arturs,5,1,100,95
1657764149524,COGS 14B,A01,083073,Cheng; Tzu-Han,6,0,63,57
1657764155551,COGS 17,A01,092677,Semenuks; Arturs,6,0,81,75
1657764161578,COGS 100,A01,083619,Allen; Michael Gordon,17,0,70,53
1657764167602,COGS 101A,A01,083621,Davis; Joshua Daniel,9,0,68,59
1657764173628,COGS 101B,A01,091572,Allen; Michael Gordon,12,0,65,53
1657764179652,COGS 101C,A01,083625,Delgado; Tania,17,0,35,18
1657764185675,COGS 107A,A01,083627,Boyle; Mary E. T.,13,0,60,47
1657764191698,COGS 118A,A01,083075,Gupta; Anjum,21,0,76,55
1657764197721,CSE 3,A50,083646,Miranda; Gregory Joseph,24,0,50,26
1657764203753,CSE 8A,A50,083650,Miranda; Gregory Joseph,17,1,56,39
1657764209775,CSE 11,A01,083080,Cao; Yingjun,6,15,40,34
1657764215799,CSE 12,A01,083652,Krause-Levy; Sophia Louisa,28,1,120,92
1657764221826,CSE 15L,A01,083654,Morris; Justin Loren,9,0,50,41
1657764221826,CSE 15L,A02,083655,Morris; Justin Loren,9,0,50,41
1657764227849,CSE 20,A01,083657,Tran; Khoa Dang,39,0,80,41
1657764233871,CSE 21,A01,095574,Bach; Quang Tran,22,0,48,26
1657764239896,CSE 30,A01,083084,Eldon; John,6,0,80,74
1657764239896,CSE 30,B01,095061,Bhaskar; Nishant,9,0,50,41
1657764245927,CSE 100,A01,083659,Cao; Yingjun,5,4,70,65
1657764251955,CSE 134B,A01,083661,Powell; Thomas Allan,24,0,100,76
1657764257979,CSE 140,A01,083663,Gungor; Onat,15,0,85,70
1657764264014,CSE 140L,A01,083088,Eldon; John,23,0,100,77
1657764270040,CSE 175,A01,083665,Kumar; Rakesh,3,0,25,22
1657764276067,CSE 190,A00,092507,Dubnov; Shlomo,8,0,20,12
1657764282090,ECE 45,A01,083139,Congero; Spencer William,6,0,75,69
1657764288114,ECE 65,A50,083695,Saad; Andrew S,12,0,30,18
1657764288114,ECE 65,A51,095125,Saad; Andrew S,24,0,26,2
1657764294139,ECE 109,A01,091882,Touri; Behrouz,20,0,70,50
1657764300161,ECE 180,A00,083140,Abi Samra; Nicholas Camill,1,0,30,29
1657764300161,ECE 180,B00,083141,Abi Samra; Nicholas Camill,0,0,30,30
1657764306184,MATH 10A,A01,083735,Patchell; Gregory David,2,0,30,28
1657764306184,MATH 10A,A02,083736,Patchell; Gregory David,20,0,30,10
1657764306184,MATH 10A,A03,083737,Patchell; Gregory David,16,0,30,14
1657764312208,MATH 10B,A01,083207,Lim; Seonhee,8,0,34,26
1657764312208,MATH 10B,A02,083208,Lim; Seonhee,9,0,35,26
1657764312208,MATH 10B,A03,093472,Lim; Seonhee,7,0,34,27
1657764312208,MATH 10B,B01,083739,Sinha; Shubham,13,0,30,17
1657764318240,MATH 18,A01,083743,Cinel; Cameron Alexander,9,0,30,21
1657764318240,MATH 18,A02,083744,Cinel; Cameron Alexander,18,0,30,12
1657764318240,MATH 18,A03,083745,Cinel; Cameron Alexander,10,0,30,20
1657764318240,MATH 18,B01,083748,Rideout; David Porter,5,0,37,32
1657764318240,MATH 18,B02,083749,Rideout; David Porter,5,0,36,31
1657764318240,MATH 18,B03,083750,Rideout; David Porter,3,0,37,34
1657764318240,MATH 18,B04,083751,Rideout; David Porter,6,0,36,30
1657764318240,MATH 18,B05,093473,Rideout; David Porter,6,0,36,30
1657764318240,MATH 18,B06,093474,Rideout; David Porter,6,0,36,30
1657764324266,MATH 20A,A01,083754,Zheng; Zequn,14,0,40,26
1657764330293,MATH 20B,A01,083756,Briones; Jor-el Thomas Caparas,4,0,36,32
1657764330293,MATH 20B,A02,083757,Briones; Jor-el Thomas Caparas,1,0,36,35
1657764330293,MATH 20B,A03,093475,Briones; Jor-el Thomas Caparas,2,0,36,34
1657764336356,MATH 20C,A01,083760,Briones; Jor-el Thomas Caparas,1,0,35,34
1657764336356,MATH 20C,A02,083761,Briones; Jor-el Thomas Caparas,8,0,35,27
1657764336356,MATH 20C,A03,093476,Briones; Jor-el Thomas Caparas,0,1,36,36
1657764336356,MATH 20C,B01,083762,Bach; Quang Tran,1,0,30,29
1657764342381,MATH 20D,A01,083765,Tran; Brian Kha,5,0,30,25
1657764342381,MATH 20D,A02,083766,Tran; Brian Kha,5,0,30,25
1657764342381,MATH 20D,A03,083767,Tran; Brian Kha,5,0,30,25
1657764348409,MATH 20E,A01,083771,Ganguly; Soumya,9,0,32,23
1657764348409,MATH 20E,A02,083772,Ganguly; Soumya,6,0,32,26
1657764348409,MATH 20E,B01,083773,Ciotti; Benjamin,20,0,35,15
1657764348409,MATH 20E,B02,083774,Ciotti; Benjamin,18,0,35,17
1657764354437,MATH 103A,A01,083777,Greenfeld; Be'Eri,3,0,36,33
1657764354437,MATH 103A,A02,083778,Greenfeld; Be'Eri,5,0,36,31
1657764354437,MATH 103A,A03,093561,Greenfeld; Be'Eri,6,0,36,30
1657764354437,MATH 103A,B01,083779,Greenfeld; Be'Eri,7,0,36,29
1657764354437,MATH 103A,B02,083780,Greenfeld; Be'Eri,4,0,36,32
1657764354437,MATH 103A,B03,093562,Greenfeld; Be'Eri,3,0,36,33
1657764360461,MATH 105,A01,085443,Carter; Anne Toulson,15,0,35,20
1657764360461,MATH 105,A02,093477,Carter; Anne Toulson,20,0,35,15
1657764366484,MATH 109,A01,083213,Ganzberger; Geoffrey Michael,3,0,34,31
1657764366484,MATH 109,A02,083214,Ganzberger; Geoffrey Michael,4,0,34,30
1657764366484,MATH 109,A03,093478,Ganzberger; Geoffrey Michael,2,0,34,32
1657764366484,MATH 109,B01,083215,Ganzberger; Geoffrey Michael,1,0,32,31
1657764366484,MATH 109,B02,083216,Ganzberger; Geoffrey Michael,2,0,32,30
1657764366484,MATH 109,B03,093479,Ganzberger; Geoffrey Michael,8,0,32,24
1657764372509,MATH 142A,A01,083219,Chow; Bennett,7,0,32,25
1657764372509,MATH 142A,A02,083220,Chow; Bennett,10,0,32,22
1657764372509,MATH 142A,A03,093480,Chow; Bennett,9,0,32,23
1657764372509,MATH 142A,B03,093481,Chow; Bennett,8,0,32,24
1657764372509,MATH 142A,B04,093558,Chow; Bennett,13,0,32,19
1657764372509,MATH 142A,B05,093559,Chow; Bennett,6,0,32,26
1657764378532,MATH 193A,A01,083224,Rotar; Vladimir,8,0,34,26
1657764378532,MATH 193A,A02,083225,Rotar; Vladimir,9,0,34,25
1657764378532,MATH 193A,A03,083781,Rotar; Vladimir,5,0,34,29
1657764378532,MATH 193A,A04,083782,Rotar; Vladimir,10,0,34,24
1657764378532,MATH 193A,A05,093482,Rotar; Vladimir,10,0,34,24
1657764384556,MATH 197,001,091859,McAuley; Julian John,9999,0,9999,0
1657764384556,MATH 197,002,095566,Kedlaya; Kiran S.,9997,0,9999,2
1657764384556,MATH 197,003,095567,Xiao; Ming,9999,0,9999,0
1657764384556,MATH 197,004,095571,Perols; Johan Lars,9998,0,9999,1
1657764391604,COGS 9,A01,083615,Shannon; Kyle Michael,9,0,75,66
1657764397629,COGS 11,A01,083617,Boyle; Mary E. T.,23,0,48,25
1657764403651,COGS 13,A01,083071,Bastos; Amalia Pinkusfeld,11,0,71,60
1657764409672,COGS 14A,A01,092681,Semenuks; Arturs,5,1,100,95
1657764415696,COGS 14B,A01,083073,Cheng; Tzu-Han,6,0,63,57
1657764421719,COGS 17,A01,092677,Semenuks; Arturs,6,0,81,75
1657764427744,COGS 100,A01,083619,Allen; Michael Gordon,17,0,70,53
1657764433765,COGS 101A,A01,083621,Davis; Joshua Daniel,9,0,68,59
1657764439787,COGS 101B,A01,091572,Allen; Michael Gordon,12,0,65,53
1657764445813,COGS 101C,A01,083625,Delgado; Tania,17,0,35,18
1657764451836,COGS 107A,A01,083627,Boyle; Mary E. T.,13,0,60,47
1657764457861,COGS 118A,A01,083075,Gupta; Anjum,21,0,76,55
1657764463889,CSE 3,A50,083646,Miranda; Gregory Joseph,24,0,50,26
1657764469911,CSE 8A,A50,083650,Miranda; Gregory Joseph,17,1,56,39
1657764475939,CSE 11,A01,083080,Cao; Yingjun,6,15,40,34
1657764481962,CSE 12,A01,083652,Krause-Levy; Sophia Louisa,28,1,120,92
1657764487987,CSE 15L,A01,083654,Morris; Justin Loren,9,0,50,41
1657764487987,CSE 15L,A02,083655,Morris; Justin Loren,9,0,50,41
1657764494011,CSE 20,A01,083657,Tran; Khoa Dang,39,0,80,41
1657764500032,CSE 21,A01,095574,Bach; Quang Tran,22,0,48,26
1657764506055,CSE 30,A01,083084,Eldon; John,6,0,80,74
1657764506055,CSE 30,B01,095061,Bhaskar; Nishant,9,0,50,41
1657764512082,CSE 100,A01,083659,Cao; Yingjun,5,4,70,65
1657764518119,CSE 134B,A01,083661,Powell; Thomas Allan,24,0,100,76
1657764524149,CSE 140,A01,083663,Gungor; Onat,15,0,85,70
1657764530179,CSE 140L,A01,083088,Eldon; John,23,0,100,77
1657764536204,CSE 175,A01,083665,Kumar; Rakesh,3,0,25,22
1657764542234,CSE 190,A00,092507,Dubnov; Shlomo,8,0,20,12
1657764548257,ECE 45,A01,083139,Congero; Spencer William,6,0,75,69
1657764554293,ECE 65,A50,083695,Saad; Andrew S,12,0,30,18
1657764554293,ECE 65,A51,095125,Saad; Andrew S,24,0,26,2
1657764560320,ECE 109,A01,091882,Touri; Behrouz,20,0,70,50
1657764566345,ECE 180,A00,083140,Abi Samra; Nicholas Camill,1,0,30,29
1657764566345,ECE 180,B00,083141,Abi Samra; Nicholas Camill,0,0,30,30
1657764572373,MATH 10A,A01,083735,Patchell; Gregory David,2,0,30,28
1657764572373,MATH 10A,A02,083736,Patchell; Gregory David,20,0,30,10
1657764572373,MATH 10A,A03,083737,Patchell; Gregory David,16,0,30,14
1657764578395,MATH 10B,A01,083207,Lim; Seonhee,8,0,34,26
1657764578395,MATH 10B,A02,083208,Lim; Seonhee,9,0,35,26
1657764578395,MATH 10B,A03,093472,Lim; Seonhee,7,0,34,27
1657764578395,MATH 10B,B01,083739,Sinha; Shubham,13,0,30,17
1657764584430,MATH 18,A01,083743,Cinel; Cameron Alexander,9,0,30,21
1657764584430,MATH 18,A02,083744,Cinel; Cameron Alexander,18,0,30,12
1657764584430,MATH 18,A03,083745,Cinel; Cameron Alexander,10,0,30,20
1657764584430,MATH 18,B01,083748,Rideout; David Porter,5,0,37,32
1657764584430,MATH 18,B02,083749,Rideout; David Porter,5,0,36,31
1657764584430,MATH 18,B03,083750,Rideout; David Porter,3,0,37,34
1657764584430,MATH 18,B04,083751,Rideout; David Porter,6,0,36,30
1657764584430,MATH 18,B05,093473,Rideout; David Porter,6,0,36,30
1657764584430,MATH 18,B06,093474,Rideout; David Porter,6,0,36,30
1657764590456,MATH 20A,A01,083754,Zheng; Zequn,14,0,40,26
1657764596489,MATH 20B,A01,083756,Briones; Jor-el Thomas Caparas,4,0,36,32
1657764596489,MATH 20B,A02,083757,Briones; Jor-el Thomas Caparas,1,0,36,35
1657764596489,MATH 20B,A03,093475,Briones; Jor-el Thomas Caparas,2,0,36,34
1657764602516,MATH 20C,A01,083760,Briones; Jor-el Thomas Caparas,1,0,35,34
1657764602516,MATH 20C,A02,083761,Briones; Jor-el Thomas Caparas,8,0,35,27
1657764602516,MATH 20C,A03,093476,Briones; Jor-el Thomas Caparas,0,1,36,36
1657764602516,MATH 20C,B01,083762,Bach; Quang Tran,1,0,30,29
1657764608545,MATH 20D,A01,083765,Tran; Brian Kha,5,0,30,25
1657764608545,MATH 20D,A02,083766,Tran; Brian Kha,5,0,30,25
1657764608545,MATH 20D,A03,083767,Tran; Brian Kha,5,0,30,25
1657764614573,MATH 20E,A01,083771,Ganguly; Soumya,9,0,32,23
1657764614573,MATH 20E,A02,083772,Ganguly; Soumya,6,0,32,26
1657764614573,MATH 20E,B01,083773,Ciotti; Benjamin,20,0,35,15
1657764614573,MATH 20E,B02,083774,Ciotti; Benjamin,18,0,35,17
1657764620598,MATH 103A,A01,083777,Greenfeld; Be'Eri,3,0,36,33
1657764620598,MATH 103A,A02,083778,Greenfeld; Be'Eri,5,0,36,31
1657764620598,MATH 103A,A03,093561,Greenfeld; Be'Eri,6,0,36,30
1657764620598,MATH 103A,B01,083779,Greenfeld; Be'Eri,7,0,36,29
1657764620598,MATH 103A,B02,083780,Greenfeld; Be'Eri,4,0,36,32
1657764620598,MATH 103A,B03,093562,Greenfeld; Be'Eri,3,0,36,33
1657764626622,MATH 105,A01,085443,Carter; Anne Toulson,15,0,35,20
1657764626622,MATH 105,A02,093477,Carter; Anne Toulson,20,0,35,15
1657764632650,MATH 109,A01,083213,Ganzberger; Geoffrey Michael,3,0,34,31
1657764632650,MATH 109,A02,083214,Ganzberger; Geoffrey Michael,4,0,34,30
1657764632650,MATH 109,A03,093478,Ganzberger; Geoffrey Michael,2,0,34,32
1657764632650,MATH 109,B01,083215,Ganzberger; Geoffrey Michael,1,0,32,31
1657764632650,MATH 109,B02,083216,Ganzberger; Geoffrey Michael,2,0,32,30
1657764632650,MATH 109,B03,093479,Ganzberger; Geoffrey Michael,8,0,32,24
1657764638748,MATH 142A,A01,083219,Chow; Bennett,7,0,32,25
1657764638748,MATH 142A,A02,083220,Chow; Bennett,10,0,32,22
1657764638748,MATH 142A,A03,093480,Chow; Bennett,9,0,32,23
1657764638748,MATH 142A,B03,093481,Chow; Bennett,8,0,32,24
1657764638748,MATH 142A,B04,093558,Chow; Bennett,13,0,32,19
1657764638748,MATH 142A,B05,093559,Chow; Bennett,6,0,32,26
1657764644779,MATH 193A,A01,083224,Rotar; Vladimir,8,0,34,26
1657764644779,MATH 193A,A02,083225,Rotar; Vladimir,9,0,34,25
1657764644779,MATH 193A,A03,083781,Rotar; Vladimir,5,0,34,29
1657764644779,MATH 193A,A04,083782,Rotar; Vladimir,10,0,34,24
1657764644779,MATH 193A,A05,093482,Rotar; Vladimir,10,0,34,24
1657764650801,MATH 197,001,091859,McAuley; Julian John,9999,0,9999,0
1657764650801,MATH 197,002,095566,Kedlaya; Kiran S.,9997,0,9999,2
1657764650801,MATH 197,003,095567,Xiao; Ming,9999,0,9999,0
1657764650801,MATH 197,004,095571,Perols; Johan Lars,9998,0,9999,1
1657764657867,COGS 9,A01,083615,Shannon; Kyle Michael,9,0,75,66
1657764663893,COGS 11,A01,083617,Boyle; Mary E. T.,23,0,48,25
1657764669921,COGS 13,A01,083071,Bastos; Amalia Pinkusfeld,11,0,71,60
1657764675944,COGS 14A,A01,092681,Semenuks; Arturs,5,1,100,95
1657764681973,COGS 14B,A01,083073,Cheng; Tzu-Han,6,0,63,57
1657764687998,COGS 17,A01,092677,Semenuks; Arturs,6,0,81,75
1657764694023,COGS 100,A01,083619,Allen; Michael Gordon,17,0,70,53
1657764700049,COGS 101A,A01,083621,Davis; Joshua Daniel,9,0,68,59
1657764706072,COGS 101B,A01,091572,Allen; Michael Gordon,12,0,65,53
1657764712098,COGS 101C,A01,083625,Delgado; Tania,17,0,35,18
1657764718120,COGS 107A,A01,083627,Boyle; Mary E. T.,13,0,60,47
1657764724142,COGS 118A,A01,083075,Gupta; Anjum,21,0,76,55
1657764730163,CSE 3,A50,083646,Miranda; Gregory Joseph,24,0,50,26
1657764736187,CSE 8A,A50,083650,Miranda; Gregory Joseph,17,1,56,39
1657764742213,CSE 11,A01,083080,Cao; Yingjun,6,15,40,34
1657764748235,CSE 12,A01,083652,Krause-Levy; Sophia Louisa,28,1,120,92
1657764754258,CSE 15L,A01,083654,Morris; Justin Loren,9,0,50,41
1657764754258,CSE 15L,A02,083655,Morris; Justin Loren,9,0,50,41
1657764760281,CSE 20,A01,083657,Tran; Khoa Dang,39,0,80,41
1657764766308,CSE 21,A01,095574,Bach; Quang Tran,22,0,48,26
1657764772332,CSE 30,A01,083084,Eldon; John,6,0,80,74
1657764772332,CSE 30,B01,095061,Bhaskar; Nishant,9,0,50,41
1657764778355,CSE 100,A01,083659,Cao; Yingjun,5,4,70,65
1657764784377,CSE 134B,A01,083661,Powell; Thomas Allan,24,0,100,76
1657764790400,CSE 140,A01,083663,Gungor; Onat,15,0,85,70
1657764796422,CSE 140L,A01,083088,Eldon; John,23,0,100,77
1657764802445,CSE 175,A01,083665,Kumar; Rakesh,3,0,25,22
1657764808468,CSE 190,A00,092507,Dubnov; Shlomo,8,0,20,12
1657764814492,ECE 45,A01,083139,Congero; Spencer William,6,0,75,69
1657764820516,ECE 65,A50,083695,Saad; Andrew S,12,0,30,18
1657764820516,ECE 65,A51,095125,Saad; Andrew S,24,0,26,2
1657764826542,ECE 109,A01,091882,Touri; Behrouz,20,0,70,50
1657764832565,ECE 180,A00,083140,Abi Samra; Nicholas Camill,1,0,30,29
1657764832565,ECE 180,B00,083141,Abi Samra; Nicholas Camill,0,0,30,30
1657764838588,MATH 10A,A01,083735,Patchell; Gregory David,2,0,30,28
1657764838588,MATH 10A,A02,083736,Patchell; Gregory David,20,0,30,10
1657764838588,MATH 10A,A03,083737,Patchell; Gregory David,16,0,30,14
1657764844617,MATH 10B,A01,083207,Lim; Seonhee,8,0,34,26
1657764844617,MATH 10B,A02,083208,Lim; Seonhee,9,0,35,26
1657764844617,MATH 10B,A03,093472,Lim; Seonhee,7,0,34,27
1657764844617,MATH 10B,B01,083739,Sinha; Shubham,13,0,30,17
1657764850644,MATH 18,A01,083743,Cinel; Cameron Alexander,9,0,30,21
1657764850644,MATH 18,A02,083744,Cinel; Cameron Alexander,18,0,30,12
1657764850644,MATH 18,A03,083745,Cinel; Cameron Alexander,10,0,30,20
1657764850644,MATH 18,B01,083748,Rideout; David Porter,5,0,37,32
1657764850644,MATH 18,B02,083749,Rideout; David Porter,5,0,36,31
1657764850644,MATH 18,B03,083750,Rideout; David Porter,3,0,37,34
1657764850644,MATH 18,B04,083751,Rideout; David Porter,6,0,36,30
1657764850644,MATH 18,B05,093473,Rideout; David Porter,6,0,36,30
1657764850644,MATH 18,B06,093474,Rideout; David Porter,6,0,36,30
1657764856667,MATH 20A,A01,083754,Zheng; Zequn,14,0,40,26
1657764862694,MATH 20B,A01,083756,Briones; Jor-el Thomas Caparas,4,0,36,32
1657764862694,MATH 20B,A02,083757,Briones; Jor-el Thomas Caparas,1,0,36,35
1657764862694,MATH 20B,A03,093475,Briones; Jor-el Thomas Caparas,2,0,36,34
1657764868716,MATH 20C,A01,083760,Briones; Jor-el Thomas Caparas,1,0,35,34
1657764868716,MATH 20C,A02,083761,Briones; Jor-el Thomas Caparas,8,0,35,27
1657764868716,MATH 20C,A03,093476,Briones; Jor-el Thomas Caparas,0,1,36,36
1657764868716,MATH 20C,B01,083762,Bach; Quang Tran,1,0,30,29
1657764874757,MATH 20D,A01,083765,Tran; Brian Kha,5,0,30,25
1657764874757,MATH 20D,A02,083766,Tran; Brian Kha,5,0,30,25
1657764874757,MATH 20D,A03,083767,Tran; Brian Kha,5,0,30,25
1657764880783,MATH 20E,A01,083771,Ganguly; Soumya,9,0,32,23
1657764880783,MATH 20E,A02,083772,Ganguly; Soumya,6,0,32,26
1657764880783,MATH 20E,B01,083773,Ciotti; Benjamin,20,0,35,15
1657764880783,MATH 20E,B02,083774,Ciotti; Benjamin,18,0,35,17
1657764886810,MATH 103A,A01,083777,Greenfeld; Be'Eri,3,0,36,33
1657764886810,MATH 103A,A02,083778,Greenfeld; Be'Eri,5,0,36,31
1657764886810,MATH 103A,A03,093561,Greenfeld; Be'Eri,6,0,36,30
1657764886810,MATH 103A,B01,083779,Greenfeld; Be'Eri,7,0,36,29
1657764886810,MATH 103A,B02,083780,Greenfeld; Be'Eri,4,0,36,32
1657764886810,MATH 103A,B03,093562,Greenfeld; Be'Eri,3,0,36,33
1657764892834,MATH 105,A01,085443,Carter; Anne Toulson,15,0,35,20
1657764892834,MATH 105,A02,093477,Carter; Anne Toulson,20,0,35,15
1657764898857,MATH 109,A01,083213,Ganzberger; Geoffrey Michael,3,0,34,31
1657764898857,MATH 109,A02,083214,Ganzberger; Geoffrey Michael,4,0,34,30
1657764898857,MATH 109,A03,093478,Ganzberger; Geoffrey Michael,2,0,34,32
1657764898857,MATH 109,B01,083215,Ganzberger; Geoffrey Michael,1,0,32,31
1657764898857,MATH 109,B02,083216,Ganzberger; Geoffrey Michael,2,0,32,30
1657764898857,MATH 109,B03,093479,Ganzberger; Geoffrey Michael,8,0,32,24
1657764904881,MATH 142A,A01,083219,Chow; Bennett,7,0,32,25
1657764904881,MATH 142A,A02,083220,Chow; Bennett,10,0,32,22
1657764904881,MATH 142A,A03,093480,Chow; Bennett,9,0,32,23
1657764904881,MATH 142A,B03,093481,Chow; Bennett,8,0,32,24
1657764904881,MATH 142A,B04,093558,Chow; Bennett,13,0,32,19
1657764904881,MATH 142A,B05,093559,Chow; Bennett,6,0,32,26
1657764910908,MATH 193A,A01,083224,Rotar; Vladimir,8,0,34,26
1657764910908,MATH 193A,A02,083225,Rotar; Vladimir,9,0,34,25
1657764910908,MATH 193A,A03,083781,Rotar; Vladimir,5,0,34,29
1657764910908,MATH 193A,A04,083782,Rotar; Vladimir,10,0,34,24
1657764910908,MATH 193A,A05,093482,Rotar; Vladimir,10,0,34,24
1657764916931,MATH 197,001,091859,McAuley; Julian John,9999,0,9999,0
1657764916931,MATH 197,002,095566,Kedlaya; Kiran S.,9997,0,9999,2
1657764916931,MATH 197,003,095567,Xiao; Ming,9999,0,9999,0
1657764916931,MATH 197,004,095571,Perols; Johan Lars,9998,0,9999,1
1657764923982,COGS 9,A01,083615,Shannon; Kyle Michael,9,0,75,66
1657764930008,COGS 11,A01,083617,Boyle; Mary E. T.,23,0,48,25
1657764936031,COGS 13,A01,083071,Bastos; Amalia Pinkusfeld,11,0,71,60
1657764942056,COGS 14A,A01,092681,Semenuks; Arturs,5,1,100,95
1657764948082,COGS 14B,A01,083073,Cheng; Tzu-Han,6,0,63,57
1657764954106,COGS 17,A01,092677,Semenuks; Arturs,6,0,81,75
1657764960129,COGS 100,A01,083619,Allen; Michael Gordon,17,0,70,53
1657764966159,COGS 101A,A01,083621,Davis; Joshua Daniel,9,0,68,59
1657764972185,COGS 101B,A01,091572,Allen; Michael Gordon,12,0,65,53
1657764978211,COGS 101C,A01,083625,Delgado; Tania,17,0,35,18
1657764984234,COGS 107A,A01,083627,Boyle; Mary E. T.,13,0,60,47
1657764990257,COGS 118A,A01,083075,Gupta; Anjum,21,0,76,55
1657764996300,CSE 3,A50,083646,Miranda; Gregory Joseph,24,0,50,26
1657765002327,CSE 8A,A50,083650,Miranda; Gregory Joseph,17,1,56,39
1657765008351,CSE 11,A01,083080,Cao; Yingjun,6,15,40,34
1657765014380,CSE 12,A01,083652,Krause-Levy; Sophia Louisa,28,1,120,92
1657765020406,CSE 15L,A01,083654,Morris; Justin Loren,9,0,50,41
1657765020406,CSE 15L,A02,083655,Morris; Justin Loren,9,0,50,41
1657765026429,CSE 20,A01,083657,Tran; Khoa Dang,39,0,80,41
1657765032452,CSE 21,A01,095574,Bach; Quang Tran,22,0,48,26
1657765038476,CSE 30,A01,083084,Eldon; John,6,0,80,74
1657765038476,CSE 30,B01,095061,Bhaskar; Nishant,9,0,50,41
1657765044499,CSE 100,A01,083659,Cao; Yingjun,5,4,70,65
1657765050523,CSE 134B,A01,083661,Powell; Thomas Allan,24,0,100,76
1657765056553,CSE 140,A01,083663,Gungor; Onat,15,0,85,70
1657765062576,CSE 140L,A01,083088,Eldon; John,23,0,100,77
1657765082147,CSE 175,A01,083665,Kumar; Rakesh,3,0,25,22
1657765088168,CSE 190,A00,092507,Dubnov; Shlomo,8,0,20,12
1657765094192,ECE 45,A01,083139,Congero; Spencer William,6,0,75,69
1657765100216,ECE 65,A50,083695,Saad; Andrew S,12,0,30,18
1657765100216,ECE 65,A51,095125,Saad; Andrew S,24,0,26,2
1657765106256,ECE 109,A01,091882,Touri; Behrouz,20,0,70,50
1657765112282,ECE 180,A00,083140,Abi Samra; Nicholas Camill,1,0,30,29
1657765112282,ECE 180,B00,083141,Abi Samra; Nicholas Camill,0,0,30,30
1657765118308,MATH 10A,A01,083735,Patchell; Gregory David,2,0,30,28
1657765118308,MATH 10A,A02,083736,Patchell; Gregory David,20,0,30,10
1657765118308,MATH 10A,A03,083737,Patchell; Gregory David,16,0,30,14
1657765124338,MATH 10B,A01,083207,Lim; Seonhee,8,0,34,26
1657765124338,MATH 10B,A02,083208,Lim; Seonhee,9,0,35,26
1657765124338,MATH 10B,A03,093472,Lim; Seonhee,7,0,34,27
1657765124338,MATH 10B,B01,083739,Sinha; Shubham,13,0,30,17
1657765130363,MATH 18,A01,083743,Cinel; Cameron Alexander,9,0,30,21
1657765130363,MATH 18,A02,083744,Cinel; Cameron Alexander,18,0,30,12
1657765130363,MATH 18,A03,083745,Cinel; Cameron Alexander,10,0,30,20
1657765130363,MATH 18,B01,083748,Rideout; David Porter,5,0,37,32
1657765130363,MATH 18,B02,083749,Rideout; David Porter,5,0,36,31
1657765130363,MATH 18,B03,083750,Rideout; David Porter,3,0,37,34
1657765130363,MATH 18,B04,083751,Rideout; David Porter,6,0,36,30
1657765130363,MATH 18,B05,093473,Rideout; David Porter,6,0,36,30
1657765130363,MATH 18,B06,093474,Rideout; David Porter,6,0,36,30
1657765136388,MATH 20A,A01,083754,Zheng; Zequn,14,0,40,26
1657765142426,MATH 20B,A01,083756,Briones; Jor-el Thomas Caparas,4,0,36,32
1657765142426,MATH 20B,A02,083757,Briones; Jor-el Thomas Caparas,1,0,36,35
1657765142426,MATH 20B,A03,093475,Briones; Jor-el Thomas Caparas,2,0,36,34
1657765148456,MATH 20C,A01,083760,Briones; Jor-el Thomas Caparas,1,0,35,34
1657765148456,MATH 20C,A02,083761,Briones; Jor-el Thomas Caparas,8,0,35,27
1657765148456,MATH 20C,A03,093476,Briones; Jor-el Thomas Caparas,0,1,36,36
1657765148456,MATH 20C,B01,083762,Bach; Quang Tran,1,0,30,29
1657765154485,MATH 20D,A01,083765,Tran; Brian Kha,5,0,30,25
1657765154485,MATH 20D,A02,083766,Tran; Brian Kha,5,0,30,25
1657765154485,MATH 20D,A03,083767,Tran; Brian Kha,5,0,30,25
1657765160514,MATH 20E,A01,083771,Ganguly; Soumya,9,0,32,23
1657765160514,MATH 20E,A02,083772,Ganguly; Soumya,6,0,32,26
1657765160514,MATH 20E,B01,083773,Ciotti; Benjamin,20,0,35,15
1657765160514,MATH 20E,B02,083774,Ciotti; Benjamin,18,0,35,17
1657765166538,MATH 103A,A01,083777,Greenfeld; Be'Eri,3,0,36,33
1657765166538,MATH 103A,A02,083778,Greenfeld; Be'Eri,5,0,36,31
1657765166538,MATH 103A,A03,093561,Greenfeld; Be'Eri,6,0,36,30
1657765166538,MATH 103A,B01,083779,Greenfeld; Be'Eri,7,0,36,29
1657765166538,MATH 103A,B02,083780,Greenfeld; Be'Eri,4,0,36,32
1657765166538,MATH 103A,B03,093562,Greenfeld; Be'Eri,3,0,36,33
1657765172560,MATH 105,A01,085443,Carter; Anne Toulson,15,0,35,20
1657765172560,MATH 105,A02,093477,Carter; Anne Toulson,20,0,35,15
1657765178588,MATH 109,A01,083213,Ganzberger; Geoffrey Michael,3,0,34,31
1657765178588,MATH 109,A02,083214,Ganzberger; Geoffrey Michael,4,0,34,30
1657765178588,MATH 109,A03,093478,Ganzberger; Geoffrey Michael,2,0,34,32
1657765178588,MATH 109,B01,083215,Ganzberger; Geoffrey Michael,1,0,32,31
1657765178588,MATH 109,B02,083216,Ganzberger; Geoffrey Michael,2,0,32,30
1657765178588,MATH 109,B03,093479,Ganzberger; Geoffrey Michael,8,0,32,24
1657765184612,MATH 142A,A01,083219,Chow; Bennett,7,0,32,25
1657765184612,MATH 142A,A02,083220,Chow; Bennett,10,0,32,22
1657765184612,MATH 142A,A03,093480,Chow; Bennett,9,0,32,23
1657765184612,MATH 142A,B03,093481,Chow; Bennett,8,0,32,24
1657765184612,MATH 142A,B04,093558,Chow; Bennett,13,0,32,19
1657765184612,MATH 142A,B05,093559,Chow; Bennett,6,0,32,26
1657765190636,MATH 193A,A01,083224,Rotar; Vladimir,8,0,34,26
1657765190636,MATH 193A,A02,083225,Rotar; Vladimir,9,0,34,25
1657765190636,MATH 193A,A03,083781,Rotar; Vladimir,5,0,34,29
1657765190636,MATH 193A,A04,083782,Rotar; Vladimir,10,0,34,24
1657765190636,MATH 193A,A05,093482,Rotar; Vladimir,10,0,34,24
1657765196658,MATH 197,001,091859,McAuley; Julian John,9999,0,9999,0
1657765196658,MATH 197,002,095566,Kedlaya; Kiran S.,9997,0,9999,2
1657765196658,MATH 197,003,095567,Xiao; Ming,9999,0,9999,0
1657765196658,MATH 197,004,095571,Perols; Johan Lars,9998,0,9999,1
1657765203715,COGS 9,A01,083615,Shannon; Kyle Michael,9,0,75,66
1657765209754,COGS 11,A01,083617,Boyle; Mary E. T.,23,0,48,25
1657765215778,COGS 13,A01,083071,Bastos; Amalia Pinkusfeld,11,0,71,60
1657765221802,COGS 14A,A01,092681,Semenuks; Arturs,5,1,100,95
1657765227827,COGS 14B,A01,083073,Cheng; Tzu-Han,6,0,63,57
1657765233850,COGS 17,A01,092677,Semenuks; Arturs,6,0,81,75
1657765239873,COGS 100,A01,083619,Allen; Michael Gordon,17,0,70,53
1657765245973,COGS 101A,A01,083621,Davis; Joshua Daniel,9,0,68,59
1657765251998,COGS 101B,A01,091572,Allen; Michael Gordon,12,0,65,53
1657765258020,COGS 101C,A01,083625,Delgado; Tania,17,0,35,18
1657765264042,COGS 107A,A01,083627,Boyle; Mary E. T.,13,0,60,47
1657765270066,COGS 118A,A01,083075,Gupta; Anjum,21,0,76,55
1657765276101,CSE 3,A50,083646,Miranda; Gregory Joseph,24,0,50,26
1657765282126,CSE 8A,A50,083650,Miranda; Gregory Joseph,17,1,56,39
1657765288148,CSE 11,A01,083080,Cao; Yingjun,6,15,40,34
1657765294172,CSE 12,A01,083652,Krause-Levy; Sophia Louisa,28,1,120,92
1657765300196,CSE 15L,A01,083654,Morris; Justin Loren,9,0,50,41
1657765300196,CSE 15L,A02,083655,Morris; Justin Loren,9,0,50,41
1657765306218,CSE 20,A01,083657,Tran; Khoa Dang,39,0,80,41
1657765312245,CSE 21,A01,095574,Bach; Quang Tran,22,0,48,26
1657765318274,CSE 30,A01,083084,Eldon; John,6,0,80,74
1657765318274,CSE 30,B01,095061,Bhaskar; Nishant,9,0,50,41
1657765324298,CSE 100,A01,083659,Cao; Yingjun,5,4,70,65
1657765330319,CSE 134B,A01,083661,Powell; Thomas Allan,24,0,100,76
1657765336346,CSE 140,A01,083663,Gungor; Onat,15,0,85,70
1657765342382,CSE 140L,A01,083088,Eldon; John,23,0,100,77
1657765348406,CSE 175,A01,083665,Kumar; Rakesh,3,0,25,22
1657765354428,CSE 190,A00,092507,Dubnov; Shlomo,8,0,20,12
1657765360457,ECE 45,A01,083139,Congero; Spencer William,6,0,75,69
1657765366482,ECE 65,A50,083695,Saad; Andrew S,12,0,30,18
1657765366482,ECE 65,A51,095125,Saad; Andrew S,24,0,26,2
1657765372506,ECE 109,A01,091882,Touri; Behrouz,20,0,70,50
1657765378529,ECE 180,A00,083140,Abi Samra; Nicholas Camill,1,0,30,29
1657765378529,ECE 180,B00,083141,Abi Samra; Nicholas Camill,0,0,30,30
1657765384560,MATH 10A,A01,083735,Patchell; Gregory David,2,0,30,28
1657765384560,MATH 10A,A02,083736,Patchell; Gregory David,20,0,30,10
1657765384560,MATH 10A,A03,083737,Patchell; Gregory David,16,0,30,14
1657765390585,MATH 10B,A01,083207,Lim; Seonhee,8,0,34,26
1657765390585,MATH 10B,A02,083208,Lim; Seonhee,9,0,35,26
1657765390585,MATH 10B,A03,093472,Lim; Seonhee,7,0,34,27
1657765390585,MATH 10B,B01,083739,Sinha; Shubham,13,0,30,17
1657765396618,MATH 18,A01,083743,Cinel; Cameron Alexander,9,0,30,21
1657765396618,MATH 18,A02,083744,Cinel; Cameron Alexander,18,0,30,12
1657765396618,MATH 18,A03,083745,Cinel; Cameron Alexander,10,0,30,20
1657765396618,MATH 18,B01,083748,Rideout; David Porter,5,0,37,32
1657765396618,MATH 18,B02,083749,Rideout; David Porter,5,0,36,31
1657765396618,MATH 18,B03,083750,Rideout; David Porter,3,0,37,34
1657765396618,MATH 18,B04,083751,Rideout; David Porter,6,0,36,30
1657765396618,MATH 18,B05,093473,Rideout; David Porter,6,0,36,30
1657765396618,MATH 18,B06,093474,Rideout; David Porter,6,0,36,30
1657765402645,MATH 20A,A01,083754,Zheng; Zequn,14,0,40,26
1657765408672,MATH 20B,A01,083756,Briones; Jor-el Thomas Caparas,4,0,36,32
1657765408672,MATH 20B,A02,083757,Briones; Jor-el Thomas Caparas,1,0,36,35
1657765408672,MATH 20B,A03,093475,Briones; Jor-el Thomas Caparas,2,0,36,34
1657765414698,MATH 20C,A01,083760,Briones; Jor-el Thomas Caparas,1,0,35,34
1657765414698,MATH 20C,A02,083761,Briones; Jor-el Thomas Caparas,8,0,35,27
1657765414698,MATH 20C,A03,093476,Briones; Jor-el Thomas Caparas,0,1,36,36
1657765414698,MATH 20C,B01,083762,Bach; Quang Tran,1,0,30,29
1657765420725,MATH 20D,A01,083765,Tran; Brian Kha,5,0,30,25
1657765420725,MATH 20D,A02,083766,Tran; Brian Kha,5,0,30,25
1657765420725,MATH 20D,A03,083767,Tran; Brian Kha,5,0,30,25
1657765426750,MATH 20E,A01,083771,Ganguly; Soumya,9,0,32,23
1657765426750,MATH 20E,A02,083772,Ganguly; Soumya,6,0,32,26
1657765426750,MATH 20E,B01,083773,Ciotti; Benjamin,20,0,35,15
1657765426750,MATH 20E,B02,083774,Ciotti; Benjamin,18,0,35,17
1657765432774,MATH 103A,A01,083777,Greenfeld; Be'Eri,3,0,36,33
1657765432774,MATH 103A,A02,083778,Greenfeld; Be'Eri,5,0,36,31
1657765432774,MATH 103A,A03,093561,Greenfeld; Be'Eri,6,0,36,30
1657765432774,MATH 103A,B01,083779,Greenfeld; Be'Eri,7,0,36,29
1657765432774,MATH 103A,B02,083780,Greenfeld; Be'Eri,4,0,36,32
1657765432774,MATH 103A,B03,093562,Greenfeld; Be'Eri,3,0,36,33
1657765438799,MATH 105,A01,085443,Carter; Anne Toulson,15,0,35,20
1657765438799,MATH 105,A02,093477,Carter; Anne Toulson,20,0,35,15
1657765444823,MATH 109,A01,083213,Ganzberger; Geoffrey Michael,3,0,34,31
1657765444823,MATH 109,A02,083214,Ganzberger; Geoffrey Michael,4,0,34,30
1657765444823,MATH 109,A03,093478,Ganzberger; Geoffrey Michael,2,0,34,32
1657765444823,MATH 109,B01,083215,Ganzberger; Geoffrey Michael,1,0,32,31
1657765444823,MATH 109,B02,083216,Ganzberger; Geoffrey Michael,2,0,32,30
1657765444823,MATH 109,B03,093479,Ganzberger; Geoffrey Michael,8,0,32,24
1657765450856,MATH 142A,A01,083219,Chow; Bennett,7,0,32,25
1657765450856,MATH 142A,A02,083220,Chow; Bennett,10,0,32,22
1657765450856,MATH 142A,A03,093480,Chow; Bennett,9,0,32,23
1657765450856,MATH 142A,B03,093481,Chow; Bennett,8,0,32,24
1657765450856,MATH 142A,B04,093558,Chow; Bennett,13,0,32,19
1657765450856,MATH 142A,B05,093559,Chow; Bennett,6,0,32,26
1657765456881,MATH 193A,A01,083224,Rotar; Vladimir,8,0,34,26
1657765456881,MATH 193A,A02,083225,Rotar; Vladimir,9,0,34,25
1657765456881,MATH 193A,A03,083781,Rotar; Vladimir,5,0,34,29
1657765456881,MATH 193A,A04,083782,Rotar; Vladimir,10,0,34,24
1657765456881,MATH 193A,A05,093482,Rotar; Vladimir,10,0,34,24
1657765462903,MATH 197,001,091859,McAuley; Julian John,9999,0,9999,0
1657765462903,MATH 197,002,095566,Kedlaya; Kiran S.,9997,0,9999,2
1657765462903,MATH 197,003,095567,Xiao; Ming,9999,0,9999,0
1657765462903,MATH 197,004,095571,Perols; Johan Lars,9998,0,9999,1
1657765469968,COGS 9,A01,083615,Shannon; Kyle Michael,9,0,75,66
1657765475994,COGS 11,A01,083617,Boyle; Mary E. T.,23,0,48,25
1657765482021,COGS 13,A01,083071,Bastos; Amalia Pinkusfeld,11,0,71,60
1657765488044,COGS 14A,A01,092681,Semenuks; Arturs,5,1,100,95
1657765494069,COGS 14B,A01,083073,Cheng; Tzu-Han,6,0,63,57
1657765500096,COGS 17,A01,092677,Semenuks; Arturs,6,0,81,75
1657765506119,COGS 100,A01,083619,Allen; Michael Gordon,17,0,70,53
1657765512145,COGS 101A,A01,083621,Davis; Joshua Daniel,9,0,68,59
1657765518172,COGS 101B,A01,091572,Allen; Michael Gordon,12,0,65,53
1657765524196,COGS 101C,A01,083625,Delgado; Tania,17,0,35,18
1657765530222,COGS 107A,A01,083627,Boyle; Mary E. T.,13,0,60,47
1657765536246,COGS 118A,A01,083075,Gupta; Anjum,21,0,76,55
1657765542268,CSE 3,A50,083646,Miranda; Gregory Joseph,24,0,50,26
1657765548291,CSE 8A,A50,083650,Miranda; Gregory Joseph,17,1,56,39
1657765554316,CSE 11,A01,083080,Cao; Yingjun,6,15,40,34
1657765560342,CSE 12,A01,083652,Krause-Levy; Sophia Louisa,28,1,120,92
1657765566368,CSE 15L,A01,083654,Morris; Justin Loren,9,0,50,41
1657765566368,CSE 15L,A02,083655,Morris; Justin Loren,9,0,50,41
1657765572389,CSE 20,A01,083657,Tran; Khoa Dang,39,0,80,41
1657765578412,CSE 21,A01,095574,Bach; Quang Tran,22,0,48,26
1657765584440,CSE 30,A01,083084,Eldon; John,6,0,80,74
1657765584440,CSE 30,B01,095061,Bhaskar; Nishant,9,0,50,41
1657765590467,CSE 100,A01,083659,Cao; Yingjun,5,4,70,65
1657765596494,CSE 134B,A01,083661,Powell; Thomas Allan,24,0,100,76
1657765602522,CSE 140,A01,083663,Gungor; Onat,15,0,85,70
1657765608548,CSE 140L,A01,083088,Eldon; John,23,0,100,77
1657765614572,CSE 175,A01,083665,Kumar; Rakesh,3,0,25,22
1657765620594,CSE 190,A00,092507,Dubnov; Shlomo,8,0,20,12
1657765626634,ECE 45,A01,083139,Congero; Spencer William,6,0,75,69
1657765632656,ECE 65,A50,083695,Saad; Andrew S,12,0,30,18
1657765632656,ECE 65,A51,095125,Saad; Andrew S,24,0,26,2
1657765638679,ECE 109,A01,091882,Touri; Behrouz,20,0,70,50
1657765644703,ECE 180,A00,083140,Abi Samra; Nicholas Camill,1,0,30,29
1657765644703,ECE 180,B00,083141,Abi Samra; Nicholas Camill,0,0,30,30
1657765650728,MATH 10A,A01,083735,Patchell; Gregory David,2,0,30,28
1657765650728,MATH 10A,A02,083736,Patchell; Gregory David,20,0,30,10
1657765650728,MATH 10A,A03,083737,Patchell; Gregory David,16,0,30,14
1657765656752,MATH 10B,A01,083207,Lim; Seonhee,8,0,34,26
1657765656752,MATH 10B,A02,083208,Lim; Seonhee,9,0,35,26
1657765656752,MATH 10B,A03,093472,Lim; Seonhee,7,0,34,27
1657765656752,MATH 10B,B01,083739,Sinha; Shubham,13,0,30,17
1657765662780,MATH 18,A01,083743,Cinel; Cameron Alexander,9,0,30,21
1657765662780,MATH 18,A02,083744,Cinel; Cameron Alexander,18,0,30,12
1657765662780,MATH 18,A03,083745,Cinel; Cameron Alexander,10,0,30,20
1657765662780,MATH 18,B01,083748,Rideout; David Porter,5,0,37,32
1657765662780,MATH 18,B02,083749,Rideout; David Porter,5,0,36,31
1657765662780,MATH 18,B03,083750,Rideout; David Porter,3,0,37,34
1657765662780,MATH 18,B04,083751,Rideout; David Porter,6,0,36,30
1657765662780,MATH 18,B05,093473,Rideout; David Porter,6,0,36,30
1657765662780,MATH 18,B06,093474,Rideout; David Porter,6,0,36,30
1657765668807,MATH 20A,A01,083754,Zheng; Zequn,14,0,40,26
1657765674830,MATH 20B,A01,083756,Briones; Jor-el Thomas Caparas,4,0,36,32
1657765674830,MATH 20B,A02,083757,Briones; Jor-el Thomas Caparas,1,0,36,35
1657765674830,MATH 20B,A03,093475,Briones; Jor-el Thomas Caparas,2,0,36,34
1657765680857,MATH 20C,A01,083760,Briones; Jor-el Thomas Caparas,1,0,35,34
1657765680857,MATH 20C,A02,083761,Briones; Jor-el Thomas Caparas,8,0,35,27
1657765680857,MATH 20C,A03,093476,Briones; Jor-el Thomas Caparas,0,1,36,36
1657765680857,MATH 20C,B01,083762,Bach; Quang Tran,1,0,30,29
1657765686884,MATH 20D,A01,083765,Tran; Brian Kha,5,0,30,25
1657765686884,MATH 20D,A02,083766,Tran; Brian Kha,5,0,30,25
1657765686884,MATH 20D,A03,083767,Tran; Brian Kha,5,0,30,25
1657765692912,MATH 20E,A01,083771,Ganguly; Soumya,9,0,32,23
1657765692912,MATH 20E,A02,083772,Ganguly; Soumya,6,0,32,26
1657765692912,MATH 20E,B01,083773,Ciotti; Benjamin,20,0,35,15
1657765692912,MATH 20E,B02,083774,Ciotti; Benjamin,18,0,35,17
1657765698937,MATH 103A,A01,083777,Greenfeld; Be'Eri,3,0,36,33
1657765698937,MATH 103A,A02,083778,Greenfeld; Be'Eri,5,0,36,31
1657765698937,MATH 103A,A03,093561,Greenfeld; Be'Eri,6,0,36,30
1657765698937,MATH 103A,B01,083779,Greenfeld; Be'Eri,7,0,36,29
1657765698937,MATH 103A,B02,083780,Greenfeld; Be'Eri,4,0,36,32
1657765698937,MATH 103A,B03,093562,Greenfeld; Be'Eri,3,0,36,33
1657765704960,MATH 105,A01,085443,Carter; Anne Toulson,15,0,35,20
1657765704960,MATH 105,A02,093477,Carter; Anne Toulson,20,0,35,15
1657765710992,MATH 109,A01,083213,Ganzberger; Geoffrey Michael,3,0,34,31
1657765710992,MATH 109,A02,083214,Ganzberger; Geoffrey Michael,4,0,34,30
1657765710992,MATH 109,A03,093478,Ganzberger; Geoffrey Michael,2,0,34,32
1657765710992,MATH 109,B01,083215,Ganzberger; Geoffrey Michael,1,0,32,31
1657765710992,MATH 109,B02,083216,Ganzberger; Geoffrey Michael,2,0,32,30
1657765710992,MATH 109,B03,093479,Ganzberger; Geoffrey Michael,8,0,32,24
1657765717022,MATH 142A,A01,083219,Chow; Bennett,7,0,32,25
1657765717022,MATH 142A,A02,083220,Chow; Bennett,10,0,32,22
1657765717022,MATH 142A,A03,093480,Chow; Bennett,9,0,32,23
1657765717022,MATH 142A,B03,093481,Chow; Bennett,8,0,32,24
1657765717022,MATH 142A,B04,093558,Chow; Bennett,13,0,32,19
1657765717022,MATH 142A,B05,093559,Chow; Bennett,6,0,32,26
1657765723045,MATH 193A,A01,083224,Rotar; Vladimir,8,0,34,26
1657765723045,MATH 193A,A02,083225,Rotar; Vladimir,9,0,34,25
1657765723045,MATH 193A,A03,083781,Rotar; Vladimir,5,0,34,29
1657765723045,MATH 193A,A04,083782,Rotar; Vladimir,10,0,34,24
1657765723045,MATH 193A,A05,093482,Rotar; Vladimir,10,0,34,24
1657765729071,MATH 197,001,091859,McAuley; Julian John,9999,0,9999,0
1657765729071,MATH 197,002,095566,Kedlaya; Kiran S.,9997,0,9999,2
1657765729071,MATH 197,003,095567,Xiao; Ming,9999,0,9999,0
1657765729071,MATH 197,004,095571,Perols; Johan Lars,9998,0,9999,1
1657765736144,COGS 9,A01,083615,Shannon; Kyle Michael,9,0,75,66
1657765742176,COGS 11,A01,083617,Boyle; Mary E. T.,23,0,48,25
1657765748202,COGS 13,A01,083071,Bastos; Amalia Pinkusfeld,11,0,71,60
1657765754224,COGS 14A,A01,092681,Semenuks; Arturs,5,1,100,95
1657765760251,COGS 14B,A01,083073,Cheng; Tzu-Han,6,0,63,57
1657765766274,COGS 17,A01,092677,Semenuks; Arturs,6,0,81,75
1657765772302,COGS 100,A01,083619,Allen; Michael Gordon,17,0,70,53
1657765778329,COGS 101A,A01,083621,Davis; Joshua Daniel,9,0,68,59
1657765784355,COGS 101B,A01,091572,Allen; Michael Gordon,12,0,65,53
1657765790380,COGS 101C,A01,083625,Delgado; Tania,17,0,35,18
1657765796403,COGS 107A,A01,083627,Boyle; Mary E. T.,13,0,60,47
1657765802426,COGS 118A,A01,083075,Gupta; Anjum,21,0,76,55
1657765808458,CSE 3,A50,083646,Miranda; Gregory Joseph,24,0,50,26
1657765814480,CSE 8A,A50,083650,Miranda; Gregory Joseph,17,1,56,39
1657765820504,CSE 11,A01,083080,Cao; Yingjun,6,15,40,34
1657765826530,CSE 12,A01,083652,Krause-Levy; Sophia Louisa,28,1,120,92
1657765832559,CSE 15L,A01,083654,Morris; Justin Loren,9,0,50,41
1657765832559,CSE 15L,A02,083655,Morris; Justin Loren,9,0,50,41
1657765838582,CSE 20,A01,083657,Tran; Khoa Dang,39,0,80,41
1657765844720,CSE 21,A01,095574,Bach; Quang Tran,22,0,48,26
1657765850743,CSE 30,A01,083084,Eldon; John,6,0,80,74
1657765850743,CSE 30,B01,095061,Bhaskar; Nishant,9,0,50,41
1657765856770,CSE 100,A01,083659,Cao; Yingjun,5,4,70,65
1657765862797,CSE 134B,A01,083661,Powell; Thomas Allan,24,0,100,76
1657765868820,CSE 140,A01,083663,Gungor; Onat,15,0,85,70
1657765874846,CSE 140L,A01,083088,Eldon; John,23,0,100,77
1657765880876,CSE 175,A01,083665,Kumar; Rakesh,3,0,25,22
1657765886910,CSE 190,A00,092507,Dubnov; Shlomo,8,0,20,12
1657765892938,ECE 45,A01,083139,Congero; Spencer William,6,0,75,69
1657765898965,ECE 65,A50,083695,Saad; Andrew S,12,0,30,18
1657765898965,ECE 65,A51,095125,Saad; Andrew S,24,0,26,2
1657765904998,ECE 109,A01,091882,Touri; Behrouz,20,0,70,50
1657765911020,ECE 180,A00,083140,Abi Samra; Nicholas Camill,1,0,30,29
1657765911020,ECE 180,B00,083141,Abi Samra; Nicholas Camill,0,0,30,30
1657765917043,MATH 10A,A01,083735,Patchell; Gregory David,2,0,30,28
1657765917043,MATH 10A,A02,083736,Patchell; Gregory David,20,0,30,10
1657765917043,MATH 10A,A03,083737,Patchell; Gregory David,16,0,30,14
1657765923067,MATH 10B,A01,083207,Lim; Seonhee,8,0,34,26
1657765923067,MATH 10B,A02,083208,Lim; Seonhee,9,0,35,26
1657765923067,MATH 10B,A03,093472,Lim; Seonhee,7,0,34,27
1657765923067,MATH 10B,B01,083739,Sinha; Shubham,13,0,30,17
1657765929097,MATH 18,A01,083743,Cinel; Cameron Alexander,9,0,30,21
1657765929097,MATH 18,A02,083744,Cinel; Cameron Alexander,18,0,30,12
1657765929097,MATH 18,A03,083745,Cinel; Cameron Alexander,10,0,30,20
1657765929097,MATH 18,B01,083748,Rideout; David Porter,5,0,37,32
1657765929097,MATH 18,B02,083749,Rideout; David Porter,5,0,36,31
1657765929097,MATH 18,B03,083750,Rideout; David Porter,3,0,37,34
1657765929097,MATH 18,B04,083751,Rideout; David Porter,6,0,36,30
1657765929097,MATH 18,B05,093473,Rideout; David Porter,6,0,36,30
1657765929097,MATH 18,B06,093474,Rideout; David Porter,6,0,36,30
1657765935120,MATH 20A,A01,083754,Zheng; Zequn,14,0,40,26
1657765941147,MATH 20B,A01,083756,Briones; Jor-el Thomas Caparas,4,0,36,32
1657765941147,MATH 20B,A02,083757,Briones; Jor-el Thomas Caparas,1,0,36,35
1657765941147,MATH 20B,A03,093475,Briones; Jor-el Thomas Caparas,2,0,36,34
1657765947174,MATH 20C,A01,083760,Briones; Jor-el Thomas Caparas,1,0,35,34
1657765947174,MATH 20C,A02,083761,Briones; Jor-el Thomas Caparas,8,0,35,27
1657765947174,MATH 20C,A03,093476,Briones; Jor-el Thomas Caparas,0,1,36,36
1657765947174,MATH 20C,B01,083762,Bach; Quang Tran,1,0,30,29
1657765953205,MATH 20D,A01,083765,Tran; Brian Kha,5,0,30,25
1657765953205,MATH 20D,A02,083766,Tran; Brian Kha,5,0,30,25
1657765953205,MATH 20D,A03,083767,Tran; Brian Kha,5,0,30,25
1657765959230,MATH 20E,A01,083771,Ganguly; Soumya,9,0,32,23
1657765959230,MATH 20E,A02,083772,Ganguly; Soumya,6,0,32,26
1657765959230,MATH 20E,B01,083773,Ciotti; Benjamin,20,0,35,15
1657765959230,MATH 20E,B02,083774,Ciotti; Benjamin,18,0,35,17
1657765965254,MATH 103A,A01,083777,Greenfeld; Be'Eri,3,0,36,33
1657765965254,MATH 103A,A02,083778,Greenfeld; Be'Eri,5,0,36,31
1657765965254,MATH 103A,A03,093561,Greenfeld; Be'Eri,6,0,36,30
1657765965254,MATH 103A,B01,083779,Greenfeld; Be'Eri,7,0,36,29
1657765965254,MATH 103A,B02,083780,Greenfeld; Be'Eri,4,0,36,32
1657765965254,MATH 103A,B03,093562,Greenfeld; Be'Eri,3,0,36,33
1657765971275,MATH 105,A01,085443,Carter; Anne Toulson,15,0,35,20
1657765971275,MATH 105,A02,093477,Carter; Anne Toulson,20,0,35,15
1657765977299,MATH 109,A01,083213,Ganzberger; Geoffrey Michael,3,0,34,31
1657765977299,MATH 109,A02,083214,Ganzberger; Geoffrey Michael,4,0,34,30
1657765977299,MATH 109,A03,093478,Ganzberger; Geoffrey Michael,2,0,34,32
1657765977299,MATH 109,B01,083215,Ganzberger; Geoffrey Michael,1,0,32,31
1657765977299,MATH 109,B02,083216,Ganzberger; Geoffrey Michael,2,0,32,30
1657765977299,MATH 109,B03,093479,Ganzberger; Geoffrey Michael,8,0,32,24
1657765983340,MATH 142A,A01,083219,Chow; Bennett,7,0,32,25
1657765983340,MATH 142A,A02,083220,Chow; Bennett,10,0,32,22
1657765983340,MATH 142A,A03,093480,Chow; Bennett,9,0,32,23
1657765983340,MATH 142A,B03,093481,Chow; Bennett,8,0,32,24
1657765983340,MATH 142A,B04,093558,Chow; Bennett,13,0,32,19
1657765983340,MATH 142A,B05,093559,Chow; Bennett,6,0,32,26
1657765989367,MATH 193A,A01,083224,Rotar; Vladimir,8,0,34,26
1657765989367,MATH 193A,A02,083225,Rotar; Vladimir,9,0,34,25
1657765989367,MATH 193A,A03,083781,Rotar; Vladimir,5,0,34,29
1657765989367,MATH 193A,A04,083782,Rotar; Vladimir,10,0,34,24
1657765989367,MATH 193A,A05,093482,Rotar; Vladimir,10,0,34,24
1657765995397,MATH 197,001,091859,McAuley; Julian John,9999,0,9999,0
1657765995397,MATH 197,002,095566,Kedlaya; Kiran S.,9997,0,9999,2
1657765995397,MATH 197,003,095567,Xiao; Ming,9999,0,9999,0
1657765995397,MATH 197,004,095571,Perols; Johan Lars,9998,0,9999,1
1657766002449,COGS 9,A01,083615,Shannon; Kyle Michael,9,0,75,66
1657766008477,COGS 11,A01,083617,Boyle; Mary E. T.,23,0,48,25
1657766014501,COGS 13,A01,083071,Bastos; Amalia Pinkusfeld,11,0,71,60
1657766020526,COGS 14A,A01,092681,Semenuks; Arturs,5,1,100,95
1657766026550,COGS 14B,A01,083073,Cheng; Tzu-Han,6,0,63,57
1657766032573,COGS 17,A01,092677,Semenuks; Arturs,6,0,81,75
1657766038594,COGS 100,A01,083619,Allen; Michael Gordon,17,0,70,53
1657766044633,COGS 101A,A01,083621,Davis; Joshua Daniel,9,0,68,59
1657766050657,COGS 101B,A01,091572,Allen; Michael Gordon,12,0,65,53
1657766056678,COGS 101C,A01,083625,Delgado; Tania,17,0,35,18
1657766062700,COGS 107A,A01,083627,Boyle; Mary E. T.,13,0,60,47
1657766068727,COGS 118A,A01,083075,Gupta; Anjum,21,0,76,55
1657766074753,CSE 3,A50,083646,Miranda; Gregory Joseph,24,0,50,26
1657766080780,CSE 8A,A50,083650,Miranda; Gregory Joseph,17,1,56,39
1657766086801,CSE 11,A01,083080,Cao; Yingjun,6,15,40,34
1657766092827,CSE 12,A01,083652,Krause-Levy; Sophia Louisa,28,1,120,92
1657766098859,CSE 15L,A01,083654,Morris; Justin Loren,9,0,50,41
1657766098859,CSE 15L,A02,083655,Morris; Justin Loren,9,0,50,41
1657766104885,CSE 20,A01,083657,Tran; Khoa Dang,39,0,80,41
1657766110909,CSE 21,A01,095574,Bach; Quang Tran,22,0,48,26
1657766116937,CSE 30,A01,083084,Eldon; John,6,0,80,74
1657766116937,CSE 30,B01,095061,Bhaskar; Nishant,9,0,50,41
1657766122970,CSE 100,A01,083659,Cao; Yingjun,5,4,70,65
1657766128993,CSE 134B,A01,083661,Powell; Thomas Allan,24,0,100,76
1657766135017,CSE 140,A01,083663,Gungor; Onat,15,0,85,70
1657766141043,CSE 140L,A01,083088,Eldon; John,23,0,100,77
1657766147068,CSE 175,A01,083665,Kumar; Rakesh,3,0,25,22
1657766153092,CSE 190,A00,092507,Dubnov; Shlomo,8,0,20,12
1657766159116,ECE 45,A01,083139,Congero; Spencer William,6,0,75,69
1657766165139,ECE 65,A50,083695,Saad; Andrew S,12,0,30,18
1657766165139,ECE 65,A51,095125,Saad; Andrew S,24,0,26,2
1657766171162,ECE 109,A01,091882,Touri; Behrouz,20,0,70,50
1657766177186,ECE 180,A00,083140,Abi Samra; Nicholas Camill,1,0,30,29
1657766177186,ECE 180,B00,083141,Abi Samra; Nicholas Camill,0,0,30,30
1657766183212,MATH 10A,A01,083735,Patchell; Gregory David,2,0,30,28
1657766183212,MATH 10A,A02,083736,Patchell; Gregory David,20,0,30,10
1657766183212,MATH 10A,A03,083737,Patchell; Gregory David,16,0,30,14
1657766189236,MATH 10B,A01,083207,Lim; Seonhee,8,0,34,26
1657766189236,MATH 10B,A02,083208,Lim; Seonhee,9,0,35,26
1657766189236,MATH 10B,A03,093472,Lim; Seonhee,7,0,34,27
1657766189236,MATH 10B,B01,083739,Sinha; Shubham,13,0,30,17
1657766195261,MATH 18,A01,083743,Cinel; Cameron Alexander,9,0,30,21
1657766195261,MATH 18,A02,083744,Cinel; Cameron Alexander,18,0,30,12
1657766195261,MATH 18,A03,083745,Cinel; Cameron Alexander,10,0,30,20
1657766195261,MATH 18,B01,083748,Rideout; David Porter,5,0,37,32
1657766195261,MATH 18,B02,083749,Rideout; David Porter,5,0,36,31
1657766195261,MATH 18,B03,083750,Rideout; David Porter,3,0,37,34
1657766195261,MATH 18,B04,083751,Rideout; David Porter,6,0,36,30
1657766195261,MATH 18,B05,093473,Rideout; David Porter,6,0,36,30
1657766195261,MATH 18,B06,093474,Rideout; David Porter,6,0,36,30
1657766201285,MATH 20A,A01,083754,Zheng; Zequn,14,0,40,26
1657766207312,MATH 20B,A01,083756,Briones; Jor-el Thomas Caparas,4,0,36,32
1657766207312,MATH 20B,A02,083757,Briones; Jor-el Thomas Caparas,1,0,36,35
1657766207312,MATH 20B,A03,093475,Briones; Jor-el Thomas Caparas,2,0,36,34
1657766213340,MATH 20C,A01,083760,Briones; Jor-el Thomas Caparas,1,0,35,34
1657766213340,MATH 20C,A02,083761,Briones; Jor-el Thomas Caparas,8,0,35,27
1657766213340,MATH 20C,A03,093476,Briones; Jor-el Thomas Caparas,0,1,36,36
1657766213340,MATH 20C,B01,083762,Bach; Quang Tran,1,0,30,29
1657766219367,MATH 20D,A01,083765,Tran; Brian Kha,5,0,30,25
1657766219367,MATH 20D,A02,083766,Tran; Brian Kha,5,0,30,25
1657766219367,MATH 20D,A03,083767,Tran; Brian Kha,5,0,30,25
1657766225398,MATH 20E,A01,083771,Ganguly; Soumya,9,0,32,23
1657766225398,MATH 20E,A02,083772,Ganguly; Soumya,6,0,32,26
1657766225398,MATH 20E,B01,083773,Ciotti; Benjamin,20,0,35,15
1657766225398,MATH 20E,B02,083774,Ciotti; Benjamin,18,0,35,17
1657766231421,MATH 103A,A01,083777,Greenfeld; Be'Eri,3,0,36,33
1657766231421,MATH 103A,A02,083778,Greenfeld; Be'Eri,5,0,36,31
1657766231421,MATH 103A,A03,093561,Greenfeld; Be'Eri,6,0,36,30
1657766231421,MATH 103A,B01,083779,Greenfeld; Be'Eri,7,0,36,29
1657766231421,MATH 103A,B02,083780,Greenfeld; Be'Eri,4,0,36,32
1657766231421,MATH 103A,B03,093562,Greenfeld; Be'Eri,3,0,36,33
1657766237447,MATH 105,A01,085443,Carter; Anne Toulson,15,0,35,20
1657766237447,MATH 105,A02,093477,Carter; Anne Toulson,20,0,35,15
1657766243476,MATH 109,A01,083213,Ganzberger; Geoffrey Michael,3,0,34,31
1657766243476,MATH 109,A02,083214,Ganzberger; Geoffrey Michael,4,0,34,30
1657766243476,MATH 109,A03,093478,Ganzberger; Geoffrey Michael,2,0,34,32
1657766243476,MATH 109,B01,083215,Ganzberger; Geoffrey Michael,1,0,32,31
1657766243476,MATH 109,B02,083216,Ganzberger; Geoffrey Michael,2,0,32,30
1657766243476,MATH 109,B03,093479,Ganzberger; Geoffrey Michael,8,0,32,24
1657766249511,MATH 142A,A01,083219,Chow; Bennett,7,0,32,25
1657766249511,MATH 142A,A02,083220,Chow; Bennett,10,0,32,22
1657766249511,MATH 142A,A03,093480,Chow; Bennett,9,0,32,23
1657766249511,MATH 142A,B03,093481,Chow; Bennett,8,0,32,24
1657766249511,MATH 142A,B04,093558,Chow; Bennett,13,0,32,19
1657766249511,MATH 142A,B05,093559,Chow; Bennett,6,0,32,26
1657766255541,MATH 193A,A01,083224,Rotar; Vladimir,8,0,34,26
1657766255541,MATH 193A,A02,083225,Rotar; Vladimir,9,0,34,25
1657766255541,MATH 193A,A03,083781,Rotar; Vladimir,5,0,34,29
1657766255541,MATH 193A,A04,083782,Rotar; Vladimir,10,0,34,24
1657766255541,MATH 193A,A05,093482,Rotar; Vladimir,10,0,34,24
1657766261563,MATH 197,001,091859,McAuley; Julian John,9999,0,9999,0
1657766261563,MATH 197,002,095566,Kedlaya; Kiran S.,9997,0,9999,2
1657766261563,MATH 197,003,095567,Xiao; Ming,9999,0,9999,0
1657766261563,MATH 197,004,095571,Perols; Johan Lars,9998,0,9999,1
1657766268638,COGS 9,A01,083615,Shannon; Kyle Michael,9,0,75,66
1657766274661,COGS 11,A01,083617,Boyle; Mary E. T.,23,0,48,25
1657766280682,COGS 13,A01,083071,Bastos; Amalia Pinkusfeld,11,0,71,60
1657766286708,COGS 14A,A01,092681,Semenuks; Arturs,5,1,100,95
1657766292737,COGS 14B,A01,083073,Cheng; Tzu-Han,6,0,63,57
1657766298759,COGS 17,A01,092677,Semenuks; Arturs,6,0,81,75
1657766304794,COGS 100,A01,083619,Allen; Michael Gordon,17,0,70,53
1657766310818,COGS 101A,A01,083621,Davis; Joshua Daniel,9,0,68,59
1657766316840,COGS 101B,A01,091572,Allen; Michael Gordon,12,0,65,53
1657766322861,COGS 101C,A01,083625,Delgado; Tania,17,0,35,18
1657766328888,COGS 107A,A01,083627,Boyle; Mary E. T.,13,0,60,47
1657766334910,COGS 118A,A01,083075,Gupta; Anjum,21,0,76,55
1657766340934,CSE 3,A50,083646,Miranda; Gregory Joseph,24,0,50,26
1657766346969,CSE 8A,A50,083650,Miranda; Gregory Joseph,17,1,56,39
1657766353004,CSE 11,A01,083080,Cao; Yingjun,6,15,40,34
1657766359031,CSE 12,A01,083652,Krause-Levy; Sophia Louisa,28,1,120,92
1657766365060,CSE 15L,A01,083654,Morris; Justin Loren,9,0,50,41
1657766365060,CSE 15L,A02,083655,Morris; Justin Loren,9,0,50,41
1657766371081,CSE 20,A01,083657,Tran; Khoa Dang,39,0,80,41
1657766377106,CSE 21,A01,095574,Bach; Quang Tran,22,0,48,26
1657766383130,CSE 30,A01,083084,Eldon; John,6,0,80,74
1657766383130,CSE 30,B01,095061,Bhaskar; Nishant,9,0,50,41
1657766389156,CSE 100,A01,083659,Cao; Yingjun,5,4,70,65
1657766395182,CSE 134B,A01,083661,Powell; Thomas Allan,24,0,100,76
1657766401204,CSE 140,A01,083663,Gungor; Onat,15,0,85,70
1657766407229,CSE 140L,A01,083088,Eldon; John,23,0,100,77
1657766413251,CSE 175,A01,083665,Kumar; Rakesh,3,0,25,22
1657766419274,CSE 190,A00,092507,Dubnov; Shlomo,8,0,20,12
1657766425298,ECE 45,A01,083139,Congero; Spencer William,6,0,75,69
1657766431327,ECE 65,A50,083695,Saad; Andrew S,12,0,30,18
1657766431327,ECE 65,A51,095125,Saad; Andrew S,24,0,26,2
1657766437357,ECE 109,A01,091882,Touri; Behrouz,20,0,70,50
1657766443456,ECE 180,A00,083140,Abi Samra; Nicholas Camill,1,0,30,29
1657766443456,ECE 180,B00,083141,Abi Samra; Nicholas Camill,0,0,30,30
1657766449480,MATH 10A,A01,083735,Patchell; Gregory David,2,0,30,28
1657766449480,MATH 10A,A02,083736,Patchell; Gregory David,20,0,30,10
1657766449480,MATH 10A,A03,083737,Patchell; Gregory David,16,0,30,14
1657766455507,MATH 10B,A01,083207,Lim; Seonhee,8,0,34,26
1657766455507,MATH 10B,A02,083208,Lim; Seonhee,9,0,35,26
1657766455507,MATH 10B,A03,093472,Lim; Seonhee,7,0,34,27
1657766455507,MATH 10B,B01,083739,Sinha; Shubham,13,0,30,17
1657766461534,MATH 18,A01,083743,Cinel; Cameron Alexander,9,0,30,21
1657766461534,MATH 18,A02,083744,Cinel; Cameron Alexander,18,0,30,12
1657766461534,MATH 18,A03,083745,Cinel; Cameron Alexander,10,0,30,20
1657766461534,MATH 18,B01,083748,Rideout; David Porter,5,0,37,32
1657766461534,MATH 18,B02,083749,Rideout; David Porter,5,0,36,31
1657766461534,MATH 18,B03,083750,Rideout; David Porter,3,0,37,34
1657766461534,MATH 18,B04,083751,Rideout; David Porter,6,0,36,30
1657766461534,MATH 18,B05,093473,Rideout; David Porter,6,0,36,30
1657766461534,MATH 18,B06,093474,Rideout; David Porter,6,0,36,30
1657766467563,MATH 20A,A01,083754,Zheng; Zequn,14,0,40,26
1657766473587,MATH 20B,A01,083756,Briones; Jor-el Thomas Caparas,4,0,36,32
1657766473587,MATH 20B,A02,083757,Briones; Jor-el Thomas Caparas,1,0,36,35
1657766473587,MATH 20B,A03,093475,Briones; Jor-el Thomas Caparas,2,0,36,34
1657766479615,MATH 20C,A01,083760,Briones; Jor-el Thomas Caparas,1,0,35,34
1657766479615,MATH 20C,A02,083761,Briones; Jor-el Thomas Caparas,8,0,35,27
1657766479615,MATH 20C,A03,093476,Briones; Jor-el Thomas Caparas,0,1,36,36
1657766479615,MATH 20C,B01,083762,Bach; Quang Tran,1,0,30,29
1657766485641,MATH 20D,A01,083765,Tran; Brian Kha,5,0,30,25
1657766485641,MATH 20D,A02,083766,Tran; Brian Kha,5,0,30,25
1657766485641,MATH 20D,A03,083767,Tran; Brian Kha,5,0,30,25
1657766491670,MATH 20E,A01,083771,Ganguly; Soumya,9,0,32,23
1657766491670,MATH 20E,A02,083772,Ganguly; Soumya,6,0,32,26
1657766491670,MATH 20E,B01,083773,Ciotti; Benjamin,20,0,35,15
1657766491670,MATH 20E,B02,083774,Ciotti; Benjamin,18,0,35,17
1657766497709,MATH 103A,A01,083777,Greenfeld; Be'Eri,3,0,36,33
1657766497709,MATH 103A,A02,083778,Greenfeld; Be'Eri,5,0,36,31
1657766497709,MATH 103A,A03,093561,Greenfeld; Be'Eri,6,0,36,30
1657766497709,MATH 103A,B01,083779,Greenfeld; Be'Eri,7,0,36,29
1657766497709,MATH 103A,B02,083780,Greenfeld; Be'Eri,4,0,36,32
1657766497709,MATH 103A,B03,093562,Greenfeld; Be'Eri,3,0,36,33
1657766503731,MATH 105,A01,085443,Carter; Anne Toulson,15,0,35,20
1657766503731,MATH 105,A02,093477,Carter; Anne Toulson,20,0,35,15
1657766509758,MATH 109,A01,083213,Ganzberger; Geoffrey Michael,3,0,34,31
1657766509758,MATH 109,A02,083214,Ganzberger; Geoffrey Michael,4,0,34,30
1657766509758,MATH 109,A03,093478,Ganzberger; Geoffrey Michael,2,0,34,32
1657766509758,MATH 109,B01,083215,Ganzberger; Geoffrey Michael,1,0,32,31
1657766509758,MATH 109,B02,083216,Ganzberger; Geoffrey Michael,2,0,32,30
1657766509758,MATH 109,B03,093479,Ganzberger; Geoffrey Michael,8,0,32,24
1657766515785,MATH 142A,A01,083219,Chow; Bennett,7,0,32,25
1657766515785,MATH 142A,A02,083220,Chow; Bennett,10,0,32,22
1657766515785,MATH 142A,A03,093480,Chow; Bennett,9,0,32,23
1657766515785,MATH 142A,B03,093481,Chow; Bennett,8,0,32,24
1657766515785,MATH 142A,B04,093558,Chow; Bennett,13,0,32,19
1657766515785,MATH 142A,B05,093559,Chow; Bennett,6,0,32,26
1657766521808,MATH 193A,A01,083224,Rotar; Vladimir,8,0,34,26
1657766521808,MATH 193A,A02,083225,Rotar; Vladimir,9,0,34,25
1657766521808,MATH 193A,A03,083781,Rotar; Vladimir,5,0,34,29
1657766521808,MATH 193A,A04,083782,Rotar; Vladimir,10,0,34,24
1657766521808,MATH 193A,A05,093482,Rotar; Vladimir,10,0,34,24
1657766527836,MATH 197,001,091859,McAuley; Julian John,9999,0,9999,0
1657766527836,MATH 197,002,095566,Kedlaya; Kiran S.,9997,0,9999,2
1657766527836,MATH 197,003,095567,Xiao; Ming,9999,0,9999,0
1657766527836,MATH 197,004,095571,Perols; Johan Lars,9998,0,9999,1
1657766534902,COGS 9,A01,083615,Shannon; Kyle Michael,9,0,75,66
1657766540925,COGS 11,A01,083617,Boyle; Mary E. T.,23,0,48,25
1657766546946,COGS 13,A01,083071,Bastos; Amalia Pinkusfeld,11,0,71,60
1657766552968,COGS 14A,A01,092681,Semenuks; Arturs,5,1,100,95
1657766558994,COGS 14B,A01,083073,Cheng; Tzu-Han,6,0,63,57
1657766565020,COGS 17,A01,092677,Semenuks; Arturs,6,0,81,75
1657766571044,COGS 100,A01,083619,Allen; Michael Gordon,17,0,70,53
1657766577066,COGS 101A,A01,083621,Davis; Joshua Daniel,9,0,68,59
1657766583092,COGS 101B,A01,091572,Allen; Michael Gordon,12,0,65,53
1657766589136,COGS 101C,A01,083625,Delgado; Tania,17,0,35,18
1657766595169,COGS 107A,A01,083627,Boyle; Mary E. T.,13,0,60,47
1657766601195,COGS 118A,A01,083075,Gupta; Anjum,21,0,76,55
1657766607223,CSE 3,A50,083646,Miranda; Gregory Joseph,24,0,50,26
1657766613246,CSE 8A,A50,083650,Miranda; Gregory Joseph,17,1,56,39
1657766619270,CSE 11,A01,083080,Cao; Yingjun,6,15,40,34
1657766625292,CSE 12,A01,083652,Krause-Levy; Sophia Louisa,28,1,120,92
1657766631317,CSE 15L,A01,083654,Morris; Justin Loren,9,0,50,41
1657766631317,CSE 15L,A02,083655,Morris; Justin Loren,9,0,50,41
1657766637340,CSE 20,A01,083657,Tran; Khoa Dang,39,0,80,41
1657766643364,CSE 21,A01,095574,Bach; Quang Tran,22,0,48,26
1657766649388,CSE 30,A01,083084,Eldon; John,6,0,80,74
1657766649388,CSE 30,B01,095061,Bhaskar; Nishant,9,0,50,41
1657766655414,CSE 100,A01,083659,Cao; Yingjun,5,4,70,65
1657766661436,CSE 134B,A01,083661,Powell; Thomas Allan,24,0,100,76
1657766667460,CSE 140,A01,083663,Gungor; Onat,15,0,85,70
1657766673482,CSE 140L,A01,083088,Eldon; John,23,0,100,77
1657766679508,CSE 175,A01,083665,Kumar; Rakesh,3,0,25,22
1657766685532,CSE 190,A00,092507,Dubnov; Shlomo,8,0,20,12
1657766691557,ECE 45,A01,083139,Congero; Spencer William,6,0,75,69
1657766697581,ECE 65,A50,083695,Saad; Andrew S,12,0,30,18
1657766697581,ECE 65,A51,095125,Saad; Andrew S,24,0,26,2
1657766703605,ECE 109,A01,091882,Touri; Behrouz,20,0,70,50
1657766709631,ECE 180,A00,083140,Abi Samra; Nicholas Camill,1,0,30,29
1657766709631,ECE 180,B00,083141,Abi Samra; Nicholas Camill,0,0,30,30
1657766715655,MATH 10A,A01,083735,Patchell; Gregory David,2,0,30,28
1657766715655,MATH 10A,A02,083736,Patchell; Gregory David,20,0,30,10
1657766715655,MATH 10A,A03,083737,Patchell; Gregory David,16,0,30,14
1657766721684,MATH 10B,A01,083207,Lim; Seonhee,8,0,34,26
1657766721684,MATH 10B,A02,083208,Lim; Seonhee,9,0,35,26
1657766721684,MATH 10B,A03,093472,Lim; Seonhee,7,0,34,27
1657766721684,MATH 10B,B01,083739,Sinha; Shubham,13,0,30,17
1657766727714,MATH 18,A01,083743,Cinel; Cameron Alexander,9,0,30,21
1657766727714,MATH 18,A02,083744,Cinel; Cameron Alexander,18,0,30,12
1657766727714,MATH 18,A03,083745,Cinel; Cameron Alexander,10,0,30,20
1657766727714,MATH 18,B01,083748,Rideout; David Porter,5,0,37,32
1657766727714,MATH 18,B02,083749,Rideout; David Porter,5,0,36,31
1657766727714,MATH 18,B03,083750,Rideout; David Porter,3,0,37,34
1657766727714,MATH 18,B04,083751,Rideout; David Porter,6,0,36,30
1657766727714,MATH 18,B05,093473,Rideout; David Porter,6,0,36,30
1657766727714,MATH 18,B06,093474,Rideout; David Porter,6,0,36,30
1657766733737,MATH 20A,A01,083754,Zheng; Zequn,14,0,40,26
1657766739766,MATH 20B,A01,083756,Briones; Jor-el Thomas Caparas,4,0,36,32
1657766739766,MATH 20B,A02,083757,Briones; Jor-el Thomas Caparas,1,0,36,35
1657766739766,MATH 20B,A03,093475,Briones; Jor-el Thomas Caparas,2,0,36,34
1657766745793,MATH 20C,A01,083760,Briones; Jor-el Thomas Caparas,1,0,35,34
1657766745793,MATH 20C,A02,083761,Briones; Jor-el Thomas Caparas,8,0,35,27
1657766745793,MATH 20C,A03,093476,Briones; Jor-el Thomas Caparas,0,1,36,36
1657766745793,MATH 20C,B01,083762,Bach; Quang Tran,1,0,30,29
1657766751824,MATH 20D,A01,083765,Tran; Brian Kha,5,0,30,25
1657766751824,MATH 20D,A02,083766,Tran; Brian Kha,5,0,30,25
1657766751824,MATH 20D,A03,083767,Tran; Brian Kha,5,0,30,25
1657766757855,MATH 20E,A01,083771,Ganguly; Soumya,9,0,32,23
1657766757855,MATH 20E,A02,083772,Ganguly; Soumya,6,0,32,26
1657766757855,MATH 20E,B01,083773,Ciotti; Benjamin,20,0,35,15
1657766757855,MATH 20E,B02,083774,Ciotti; Benjamin,18,0,35,17
1657766763878,MATH 103A,A01,083777,Greenfeld; Be'Eri,3,0,36,33
1657766763878,MATH 103A,A02,083778,Greenfeld; Be'Eri,5,0,36,31
1657766763878,MATH 103A,A03,093561,Greenfeld; Be'Eri,6,0,36,30
1657766763878,MATH 103A,B01,083779,Greenfeld; Be'Eri,7,0,36,29
1657766763878,MATH 103A,B02,083780,Greenfeld; Be'Eri,4,0,36,32
1657766763878,MATH 103A,B03,093562,Greenfeld; Be'Eri,3,0,36,33
1657766769910,MATH 105,A01,085443,Carter; Anne Toulson,15,0,35,20
1657766769910,MATH 105,A02,093477,Carter; Anne Toulson,20,0,35,15
1657766775939,MATH 109,A01,083213,Ganzberger; Geoffrey Michael,3,0,34,31
1657766775939,MATH 109,A02,083214,Ganzberger; Geoffrey Michael,4,0,34,30
1657766775939,MATH 109,A03,093478,Ganzberger; Geoffrey Michael,2,0,34,32
1657766775939,MATH 109,B01,083215,Ganzberger; Geoffrey Michael,1,0,32,31
1657766775939,MATH 109,B02,083216,Ganzberger; Geoffrey Michael,2,0,32,30
1657766775939,MATH 109,B03,093479,Ganzberger; Geoffrey Michael,8,0,32,24
1657766781963,MATH 142A,A01,083219,Chow; Bennett,7,0,32,25
1657766781963,MATH 142A,A02,083220,Chow; Bennett,10,0,32,22
1657766781963,MATH 142A,A03,093480,Chow; Bennett,9,0,32,23
1657766781963,MATH 142A,B03,093481,Chow; Bennett,8,0,32,24
1657766781963,MATH 142A,B04,093558,Chow; Bennett,13,0,32,19
1657766781963,MATH 142A,B05,093559,Chow; Bennett,6,0,32,26
1657766787986,MATH 193A,A01,083224,Rotar; Vladimir,8,0,34,26
1657766787986,MATH 193A,A02,083225,Rotar; Vladimir,9,0,34,25
1657766787986,MATH 193A,A03,083781,Rotar; Vladimir,5,0,34,29
1657766787986,MATH 193A,A04,083782,Rotar; Vladimir,10,0,34,24
1657766787986,MATH 193A,A05,093482,Rotar; Vladimir,10,0,34,24
1657766794009,MATH 197,001,091859,McAuley; Julian John,9999,0,9999,0
1657766794009,MATH 197,002,095566,Kedlaya; Kiran S.,9997,0,9999,2
1657766794009,MATH 197,003,095567,Xiao; Ming,9999,0,9999,0
1657766794009,MATH 197,004,095571,Perols; Johan Lars,9998,0,9999,1
1657766801062,COGS 9,A01,083615,Shannon; Kyle Michael,9,0,75,66
1657766807089,COGS 11,A01,083617,Boyle; Mary E. T.,23,0,48,25
1657766813113,COGS 13,A01,083071,Bastos; Amalia Pinkusfeld,11,0,71,60
1657766819139,COGS 14A,A01,092681,Semenuks; Arturs,5,1,100,95
1657766825163,COGS 14B,A01,083073,Cheng; Tzu-Han,6,0,63,57
1657766831185,COGS 17,A01,092677,Semenuks; Arturs,6,0,81,75
1657766837208,COGS 100,A01,083619,Allen; Michael Gordon,17,0,70,53
1657766843239,COGS 101A,A01,083621,Davis; Joshua Daniel,9,0,68,59
1657766849275,COGS 101B,A01,091572,Allen; Michael Gordon,12,0,65,53
1657766855301,COGS 101C,A01,083625,Delgado; Tania,17,0,35,18
1657766861330,COGS 107A,A01,083627,Boyle; Mary E. T.,13,0,60,47
1657766867352,COGS 118A,A01,083075,Gupta; Anjum,21,0,76,55
1657766873381,CSE 3,A50,083646,Miranda; Gregory Joseph,24,0,50,26
1657766879405,CSE 8A,A50,083650,Miranda; Gregory Joseph,17,1,56,39
1657766885426,CSE 11,A01,083080,Cao; Yingjun,6,15,40,34
1657766891453,CSE 12,A01,083652,Krause-Levy; Sophia Louisa,28,1,120,92
1657766897486,CSE 15L,A01,083654,Morris; Justin Loren,9,0,50,41
1657766897486,CSE 15L,A02,083655,Morris; Justin Loren,9,0,50,41
1657766903515,CSE 20,A01,083657,Tran; Khoa Dang,39,0,80,41
1657766909537,CSE 21,A01,095574,Bach; Quang Tran,22,0,48,26
1657766915565,CSE 30,A01,083084,Eldon; John,6,0,80,74
1657766915565,CSE 30,B01,095061,Bhaskar; Nishant,9,0,50,41
1657766921590,CSE 100,A01,083659,Cao; Yingjun,5,4,70,65
1657766927617,CSE 134B,A01,083661,Powell; Thomas Allan,24,0,100,76
1657766933654,CSE 140,A01,083663,Gungor; Onat,15,0,85,70
1657766939679,CSE 140L,A01,083088,Eldon; John,23,0,100,77
1657766945700,CSE 175,A01,083665,Kumar; Rakesh,3,0,25,22
1657766951723,CSE 190,A00,092507,Dubnov; Shlomo,8,0,20,12
1657766957747,ECE 45,A01,083139,Congero; Spencer William,6,0,75,69
1657766963774,ECE 65,A50,083695,Saad; Andrew S,12,0,30,18
1657766963774,ECE 65,A51,095125,Saad; Andrew S,24,0,26,2
1657766969797,ECE 109,A01,091882,Touri; Behrouz,20,0,70,50
1657766975823,ECE 180,A00,083140,Abi Samra; Nicholas Camill,1,0,30,29
1657766975823,ECE 180,B00,083141,Abi Samra; Nicholas Camill,0,0,30,30
1657766981860,MATH 10A,A01,083735,Patchell; Gregory David,2,0,30,28
1657766981860,MATH 10A,A02,083736,Patchell; Gregory David,20,0,30,10
1657766981860,MATH 10A,A03,083737,Patchell; Gregory David,16,0,30,14
1657766987885,MATH 10B,A01,083207,Lim; Seonhee,8,0,34,26
1657766987885,MATH 10B,A02,083208,Lim; Seonhee,9,0,35,26
1657766987885,MATH 10B,A03,093472,Lim; Seonhee,7,0,34,27
1657766987885,MATH 10B,B01,083739,Sinha; Shubham,13,0,30,17
1657766993916,MATH 18,A01,083743,Cinel; Cameron Alexander,9,0,30,21
1657766993916,MATH 18,A02,083744,Cinel; Cameron Alexander,18,0,30,12
1657766993916,MATH 18,A03,083745,Cinel; Cameron Alexander,10,0,30,20
1657766993916,MATH 18,B01,083748,Rideout; David Porter,5,0,37,32
1657766993916,MATH 18,B02,083749,Rideout; David Porter,5,0,36,31
1657766993916,MATH 18,B03,083750,Rideout; David Porter,3,0,37,34
1657766993916,MATH 18,B04,083751,Rideout; David Porter,6,0,36,30
1657766993916,MATH 18,B05,093473,Rideout; David Porter,6,0,36,30
1657766993916,MATH 18,B06,093474,Rideout; David Porter,6,0,36,30
1657766999940,MATH 20A,A01,083754,Zheng; Zequn,14,0,40,26
1657767005963,MATH 20B,A01,083756,Briones; Jor-el Thomas Caparas,4,0,36,32
1657767005963,MATH 20B,A02,083757,Briones; Jor-el Thomas Caparas,1,0,36,35
1657767005963,MATH 20B,A03,093475,Briones; Jor-el Thomas Caparas,2,0,36,34
1657767011987,MATH 20C,A01,083760,Briones; Jor-el Thomas Caparas,1,0,35,34
1657767011987,MATH 20C,A02,083761,Briones; Jor-el Thomas Caparas,8,0,35,27
1657767011987,MATH 20C,A03,093476,Briones; Jor-el Thomas Caparas,0,1,36,36
1657767011987,MATH 20C,B01,083762,Bach; Quang Tran,1,0,30,29
1657767018010,MATH 20D,A01,083765,Tran; Brian Kha,5,0,30,25
1657767018010,MATH 20D,A02,083766,Tran; Brian Kha,5,0,30,25
1657767018010,MATH 20D,A03,083767,Tran; Brian Kha,5,0,30,25
1657767024035,MATH 20E,A01,083771,Ganguly; Soumya,9,0,32,23
1657767024035,MATH 20E,A02,083772,Ganguly; Soumya,6,0,32,26
1657767024035,MATH 20E,B01,083773,Ciotti; Benjamin,20,0,35,15
1657767024035,MATH 20E,B02,083774,Ciotti; Benjamin,18,0,35,17
1657767030059,MATH 103A,A01,083777,Greenfeld; Be'Eri,3,0,36,33
1657767030059,MATH 103A,A02,083778,Greenfeld; Be'Eri,5,0,36,31
1657767030059,MATH 103A,A03,093561,Greenfeld; Be'Eri,6,0,36,30
1657767030059,MATH 103A,B01,083779,Greenfeld; Be'Eri,7,0,36,29
1657767030059,MATH 103A,B02,083780,Greenfeld; Be'Eri,4,0,36,32
1657767030059,MATH 103A,B03,093562,Greenfeld; Be'Eri,3,0,36,33
1657767036084,MATH 105,A01,085443,Carter; Anne Toulson,15,0,35,20
1657767036084,MATH 105,A02,093477,Carter; Anne Toulson,20,0,35,15
1657767042186,MATH 109,A01,083213,Ganzberger; Geoffrey Michael,3,0,34,31
1657767042186,MATH 109,A02,083214,Ganzberger; Geoffrey Michael,4,0,34,30
1657767042186,MATH 109,A03,093478,Ganzberger; Geoffrey Michael,2,0,34,32
1657767042186,MATH 109,B01,083215,Ganzberger; Geoffrey Michael,1,0,32,31
1657767042186,MATH 109,B02,083216,Ganzberger; Geoffrey Michael,2,0,32,30
1657767042186,MATH 109,B03,093479,Ganzberger; Geoffrey Michael,8,0,32,24
1657767048215,MATH 142A,A01,083219,Chow; Bennett,7,0,32,25
1657767048215,MATH 142A,A02,083220,Chow; Bennett,10,0,32,22
1657767048215,MATH 142A,A03,093480,Chow; Bennett,9,0,32,23
1657767048215,MATH 142A,B03,093481,Chow; Bennett,8,0,32,24
1657767048215,MATH 142A,B04,093558,Chow; Bennett,13,0,32,19
1657767048215,MATH 142A,B05,093559,Chow; Bennett,6,0,32,26
1657767054240,MATH 193A,A01,083224,Rotar; Vladimir,8,0,34,26
1657767054240,MATH 193A,A02,083225,Rotar; Vladimir,9,0,34,25
1657767054240,MATH 193A,A03,083781,Rotar; Vladimir,5,0,34,29
1657767054240,MATH 193A,A04,083782,Rotar; Vladimir,10,0,34,24
1657767054240,MATH 193A,A05,093482,Rotar; Vladimir,10,0,34,24
1657767060269,MATH 197,001,091859,McAuley; Julian John,9999,0,9999,0
1657767060269,MATH 197,002,095566,Kedlaya; Kiran S.,9997,0,9999,2
1657767060269,MATH 197,003,095567,Xiao; Ming,9999,0,9999,0
1657767060269,MATH 197,004,095571,Perols; Johan Lars,9998,0,9999,1
1657767067334,COGS 9,A01,083615,Shannon; Kyle Michael,9,0,75,66
1657767073367,COGS 11,A01,083617,Boyle; Mary E. T.,23,0,48,25
1657767079390,COGS 13,A01,083071,Bastos; Amalia Pinkusfeld,11,0,71,60
1657767085417,COGS 14A,A01,092681,Semenuks; Arturs,5,1,100,95
1657767091446,COGS 14B,A01,083073,Cheng; Tzu-Han,6,0,63,57
1657767097469,COGS 17,A01,092677,Semenuks; Arturs,6,0,81,75
1657767103492,COGS 100,A01,083619,Allen; Michael Gordon,17,0,70,53
1657767109515,COGS 101A,A01,083621,Davis; Joshua Daniel,9,0,68,59
1657767115537,COGS 101B,A01,091572,Allen; Michael Gordon,12,0,65,53
1657767121564,COGS 101C,A01,083625,Delgado; Tania,17,0,35,18
1657767127597,COGS 107A,A01,083627,Boyle; Mary E. T.,13,0,60,47
1657767133620,COGS 118A,A01,083075,Gupta; Anjum,21,0,76,55
1657767139649,CSE 3,A50,083646,Miranda; Gregory Joseph,24,0,50,26
1657767145677,CSE 8A,A50,083650,Miranda; Gregory Joseph,17,1,56,39
1657767151708,CSE 11,A01,083080,Cao; Yingjun,6,15,40,34
1657767157730,CSE 12,A01,083652,Krause-Levy; Sophia Louisa,28,1,120,92
1657767163752,CSE 15L,A01,083654,Morris; Justin Loren,9,0,50,41
1657767163752,CSE 15L,A02,083655,Morris; Justin Loren,9,0,50,41
1657767169777,CSE 20,A01,083657,Tran; Khoa Dang,39,0,80,41
1657767175806,CSE 21,A01,095574,Bach; Quang Tran,22,0,48,26
1657767181829,CSE 30,A01,083084,Eldon; John,6,0,80,74
1657767181829,CSE 30,B01,095061,Bhaskar; Nishant,9,0,50,41
1657767187850,CSE 100,A01,083659,Cao; Yingjun,5,4,70,65
1657767193875,CSE 134B,A01,083661,Powell; Thomas Allan,24,0,100,76
1657767199898,CSE 140,A01,083663,Gungor; Onat,15,0,85,70
1657767205920,CSE 140L,A01,083088,Eldon; John,23,0,100,77
1657767211948,CSE 175,A01,083665,Kumar; Rakesh,3,0,25,22
1657767217973,CSE 190,A00,092507,Dubnov; Shlomo,8,0,20,12
1657767224000,ECE 45,A01,083139,Congero; Spencer William,6,0,75,69
1657767230024,ECE 65,A50,083695,Saad; Andrew S,12,0,30,18
1657767230024,ECE 65,A51,095125,Saad; Andrew S,24,0,26,2
1657767236049,ECE 109,A01,091882,Touri; Behrouz,20,0,70,50
1657767242071,ECE 180,A00,083140,Abi Samra; Nicholas Camill,1,0,30,29
1657767242071,ECE 180,B00,083141,Abi Samra; Nicholas Camill,0,0,30,30
1657767248101,MATH 10A,A01,083735,Patchell; Gregory David,2,0,30,28
1657767248101,MATH 10A,A02,083736,Patchell; Gregory David,20,0,30,10
1657767248101,MATH 10A,A03,083737,Patchell; Gregory David,16,0,30,14
1657767254125,MATH 10B,A01,083207,Lim; Seonhee,8,0,34,26
1657767254125,MATH 10B,A02,083208,Lim; Seonhee,9,0,35,26
1657767254125,MATH 10B,A03,093472,Lim; Seonhee,7,0,34,27
1657767254125,MATH 10B,B01,083739,Sinha; Shubham,13,0,30,17
1657767260148,MATH 18,A01,083743,Cinel; Cameron Alexander,9,0,30,21
1657767260148,MATH 18,A02,083744,Cinel; Cameron Alexander,18,0,30,12
1657767260148,MATH 18,A03,083745,Cinel; Cameron Alexander,10,0,30,20
1657767260148,MATH 18,B01,083748,Rideout; David Porter,5,0,37,32
1657767260148,MATH 18,B02,083749,Rideout; David Porter,5,0,36,31
1657767260148,MATH 18,B03,083750,Rideout; David Porter,3,0,37,34
1657767260148,MATH 18,B04,083751,Rideout; David Porter,6,0,36,30
1657767260148,MATH 18,B05,093473,Rideout; David Porter,6,0,36,30
1657767260148,MATH 18,B06,093474,Rideout; David Porter,6,0,36,30
1657767266171,MATH 20A,A01,083754,Zheng; Zequn,14,0,40,26
1657767272195,MATH 20B,A01,083756,Briones; Jor-el Thomas Caparas,4,0,36,32
1657767272195,MATH 20B,A02,083757,Briones; Jor-el Thomas Caparas,1,0,36,35
1657767272195,MATH 20B,A03,093475,Briones; Jor-el Thomas Caparas,2,0,36,34
1657767278224,MATH 20C,A01,083760,Briones; Jor-el Thomas Caparas,1,0,35,34
1657767278224,MATH 20C,A02,083761,Briones; Jor-el Thomas Caparas,8,0,35,27
1657767278224,MATH 20C,A03,093476,Briones; Jor-el Thomas Caparas,0,1,36,36
1657767278224,MATH 20C,B01,083762,Bach; Quang Tran,1,0,30,29
1657767284248,MATH 20D,A01,083765,Tran; Brian Kha,5,0,30,25
1657767284248,MATH 20D,A02,083766,Tran; Brian Kha,5,0,30,25
1657767284248,MATH 20D,A03,083767,Tran; Brian Kha,5,0,30,25
1657767290288,MATH 20E,A01,083771,Ganguly; Soumya,9,0,32,23
1657767290288,MATH 20E,A02,083772,Ganguly; Soumya,6,0,32,26
1657767290288,MATH 20E,B01,083773,Ciotti; Benjamin,20,0,35,15
1657767290288,MATH 20E,B02,083774,Ciotti; Benjamin,18,0,35,17
1657767296313,MATH 103A,A01,083777,Greenfeld; Be'Eri,3,0,36,33
1657767296313,MATH 103A,A02,083778,Greenfeld; Be'Eri,5,0,36,31
1657767296313,MATH 103A,A03,093561,Greenfeld; Be'Eri,6,0,36,30
1657767296313,MATH 103A,B01,083779,Greenfeld; Be'Eri,7,0,36,29
1657767296313,MATH 103A,B02,083780,Greenfeld; Be'Eri,4,0,36,32
1657767296313,MATH 103A,B03,093562,Greenfeld; Be'Eri,3,0,36,33
1657767302348,MATH 105,A01,085443,Carter; Anne Toulson,15,0,35,20
1657767302348,MATH 105,A02,093477,Carter; Anne Toulson,20,0,35,15
1657767308372,MATH 109,A01,083213,Ganzberger; Geoffrey Michael,3,0,34,31
1657767308372,MATH 109,A02,083214,Ganzberger; Geoffrey Michael,4,0,34,30
1657767308372,MATH 109,A03,093478,Ganzberger; Geoffrey Michael,2,0,34,32
1657767308372,MATH 109,B01,083215,Ganzberger; Geoffrey Michael,1,0,32,31
1657767308372,MATH 109,B02,083216,Ganzberger; Geoffrey Michael,2,0,32,30
1657767308372,MATH 109,B03,093479,Ganzberger; Geoffrey Michael,8,0,32,24
1657767314396,MATH 142A,A01,083219,Chow; Bennett,7,0,32,25
1657767314396,MATH 142A,A02,083220,Chow; Bennett,10,0,32,22
1657767314396,MATH 142A,A03,093480,Chow; Bennett,9,0,32,23
1657767314396,MATH 142A,B03,093481,Chow; Bennett,8,0,32,24
1657767314396,MATH 142A,B04,093558,Chow; Bennett,13,0,32,19
1657767314396,MATH 142A,B05,093559,Chow; Bennett,6,0,32,26
1657767320423,MATH 193A,A01,083224,Rotar; Vladimir,8,0,34,26
1657767320423,MATH 193A,A02,083225,Rotar; Vladimir,9,0,34,25
1657767320423,MATH 193A,A03,083781,Rotar; Vladimir,5,0,34,29
1657767320423,MATH 193A,A04,083782,Rotar; Vladimir,10,0,34,24
1657767320423,MATH 193A,A05,093482,Rotar; Vladimir,10,0,34,24
1657767326453,MATH 197,001,091859,McAuley; Julian John,9999,0,9999,0
1657767326453,MATH 197,002,095566,Kedlaya; Kiran S.,9997,0,9999,2
1657767326453,MATH 197,003,095567,Xiao; Ming,9999,0,9999,0
1657767326453,MATH 197,004,095571,Perols; Johan Lars,9998,0,9999,1
1657767333515,COGS 9,A01,083615,Shannon; Kyle Michael,9,0,75,66
1657767339555,COGS 11,A01,083617,Boyle; Mary E. T.,23,0,48,25
1657767345583,COGS 13,A01,083071,Bastos; Amalia Pinkusfeld,11,0,71,60
1657767351606,COGS 14A,A01,092681,Semenuks; Arturs,5,1,100,95
1657767357633,COGS 14B,A01,083073,Cheng; Tzu-Han,6,0,63,57
1657767363656,COGS 17,A01,092677,Semenuks; Arturs,6,0,81,75
1657767369680,COGS 100,A01,083619,Allen; Michael Gordon,17,0,70,53
1657767375706,COGS 101A,A01,083621,Davis; Joshua Daniel,9,0,68,59
1657767381731,COGS 101B,A01,091572,Allen; Michael Gordon,12,0,65,53
1657767387754,COGS 101C,A01,083625,Delgado; Tania,17,0,35,18
1657767393778,COGS 107A,A01,083627,Boyle; Mary E. T.,13,0,60,47
1657767399803,COGS 118A,A01,083075,Gupta; Anjum,21,0,76,55
1657767405834,CSE 3,A50,083646,Miranda; Gregory Joseph,24,0,50,26
1657767411861,CSE 8A,A50,083650,Miranda; Gregory Joseph,17,1,56,39
1657767417888,CSE 11,A01,083080,Cao; Yingjun,6,15,40,34
1657767423920,CSE 12,A01,083652,Krause-Levy; Sophia Louisa,28,1,120,92
1657767429944,CSE 15L,A01,083654,Morris; Justin Loren,9,0,50,41
1657767429944,CSE 15L,A02,083655,Morris; Justin Loren,9,0,50,41
1657767435971,CSE 20,A01,083657,Tran; Khoa Dang,39,0,80,41
1657767442001,CSE 21,A01,095574,Bach; Quang Tran,22,0,48,26
1657767448022,CSE 30,A01,083084,Eldon; John,6,0,80,74
1657767448022,CSE 30,B01,095061,Bhaskar; Nishant,9,0,50,41
1657767454062,CSE 100,A01,083659,Cao; Yingjun,5,4,70,65
1657767460085,CSE 134B,A01,083661,Powell; Thomas Allan,24,0,100,76
1657767466108,CSE 140,A01,083663,Gungor; Onat,15,0,85,70
1657767472132,CSE 140L,A01,083088,Eldon; John,23,0,100,77
1657767478154,CSE 175,A01,083665,Kumar; Rakesh,3,0,25,22
1657767484177,CSE 190,A00,092507,Dubnov; Shlomo,8,0,20,12
1657767490200,ECE 45,A01,083139,Congero; Spencer William,6,0,75,69
1657767496226,ECE 65,A50,083695,Saad; Andrew S,12,0,30,18
1657767496226,ECE 65,A51,095125,Saad; Andrew S,24,0,26,2
1657767502248,ECE 109,A01,091882,Touri; Behrouz,20,0,70,50
1657767508278,ECE 180,A00,083140,Abi Samra; Nicholas Camill,1,0,30,29
1657767508278,ECE 180,B00,083141,Abi Samra; Nicholas Camill,0,0,30,30
1657767514301,MATH 10A,A01,083735,Patchell; Gregory David,2,0,30,28
1657767514301,MATH 10A,A02,083736,Patchell; Gregory David,20,0,30,10
1657767514301,MATH 10A,A03,083737,Patchell; Gregory David,16,0,30,14
1657767520331,MATH 10B,A01,083207,Lim; Seonhee,8,0,34,26
1657767520331,MATH 10B,A02,083208,Lim; Seonhee,9,0,35,26
1657767520331,MATH 10B,A03,093472,Lim; Seonhee,7,0,34,27
1657767520331,MATH 10B,B01,083739,Sinha; Shubham,13,0,30,17
1657767526360,MATH 18,A01,083743,Cinel; Cameron Alexander,9,0,30,21
1657767526360,MATH 18,A02,083744,Cinel; Cameron Alexander,18,0,30,12
1657767526360,MATH 18,A03,083745,Cinel; Cameron Alexander,10,0,30,20
1657767526360,MATH 18,B01,083748,Rideout; David Porter,5,0,37,32
1657767526360,MATH 18,B02,083749,Rideout; David Porter,5,0,36,31
1657767526360,MATH 18,B03,083750,Rideout; David Porter,3,0,37,34
1657767526360,MATH 18,B04,083751,Rideout; David Porter,6,0,36,30
1657767526360,MATH 18,B05,093473,Rideout; David Porter,6,0,36,30
1657767526360,MATH 18,B06,093474,Rideout; David Porter,6,0,36,30
1657767532390,MATH 20A,A01,083754,Zheng; Zequn,14,0,40,26
1657767538412,MATH 20B,A01,083756,Briones; Jor-el Thomas Caparas,4,0,36,32
1657767538412,MATH 20B,A02,083757,Briones; Jor-el Thomas Caparas,1,0,36,35
1657767538412,MATH 20B,A03,093475,Briones; Jor-el Thomas Caparas,2,0,36,34
1657767544435,MATH 20C,A01,083760,Briones; Jor-el Thomas Caparas,1,0,35,34
1657767544435,MATH 20C,A02,083761,Briones; Jor-el Thomas Caparas,8,0,35,27
1657767544435,MATH 20C,A03,093476,Briones; Jor-el Thomas Caparas,0,1,36,36
1657767544435,MATH 20C,B01,083762,Bach; Quang Tran,1,0,30,29
1657767550463,MATH 20D,A01,083765,Tran; Brian Kha,5,0,30,25
1657767550463,MATH 20D,A02,083766,Tran; Brian Kha,5,0,30,25
1657767550463,MATH 20D,A03,083767,Tran; Brian Kha,5,0,30,25
1657767556490,MATH 20E,A01,083771,Ganguly; Soumya,9,0,32,23
1657767556490,MATH 20E,A02,083772,Ganguly; Soumya,6,0,32,26
1657767556490,MATH 20E,B01,083773,Ciotti; Benjamin,20,0,35,15
1657767556490,MATH 20E,B02,083774,Ciotti; Benjamin,18,0,35,17
1657767562513,MATH 103A,A01,083777,Greenfeld; Be'Eri,3,0,36,33
1657767562513,MATH 103A,A02,083778,Greenfeld; Be'Eri,5,0,36,31
1657767562513,MATH 103A,A03,093561,Greenfeld; Be'Eri,6,0,36,30
1657767562513,MATH 103A,B01,083779,Greenfeld; Be'Eri,7,0,36,29
1657767562513,MATH 103A,B02,083780,Greenfeld; Be'Eri,4,0,36,32
1657767562513,MATH 103A,B03,093562,Greenfeld; Be'Eri,3,0,36,33
1657767568536,MATH 105,A01,085443,Carter; Anne Toulson,15,0,35,20
1657767568536,MATH 105,A02,093477,Carter; Anne Toulson,20,0,35,15
1657767574560,MATH 109,A01,083213,Ganzberger; Geoffrey Michael,3,0,34,31
1657767574560,MATH 109,A02,083214,Ganzberger; Geoffrey Michael,4,0,34,30
1657767574560,MATH 109,A03,093478,Ganzberger; Geoffrey Michael,2,0,34,32
1657767574560,MATH 109,B01,083215,Ganzberger; Geoffrey Michael,1,0,32,31
1657767574560,MATH 109,B02,083216,Ganzberger; Geoffrey Michael,2,0,32,30
1657767574560,MATH 109,B03,093479,Ganzberger; Geoffrey Michael,8,0,32,24
1657767580584,MATH 142A,A01,083219,Chow; Bennett,7,0,32,25
1657767580584,MATH 142A,A02,083220,Chow; Bennett,10,0,32,22
1657767580584,MATH 142A,A03,093480,Chow; Bennett,9,0,32,23
1657767580584,MATH 142A,B03,093481,Chow; Bennett,8,0,32,24
1657767580584,MATH 142A,B04,093558,Chow; Bennett,13,0,32,19
1657767580584,MATH 142A,B05,093559,Chow; Bennett,6,0,32,26
1657767586607,MATH 193A,A01,083224,Rotar; Vladimir,8,0,34,26
1657767586607,MATH 193A,A02,083225,Rotar; Vladimir,9,0,34,25
1657767586607,MATH 193A,A03,083781,Rotar; Vladimir,5,0,34,29
1657767586607,MATH 193A,A04,083782,Rotar; Vladimir,10,0,34,24
1657767586607,MATH 193A,A05,093482,Rotar; Vladimir,10,0,34,24
1657767592630,MATH 197,001,091859,McAuley; Julian John,9999,0,9999,0
1657767592630,MATH 197,002,095566,Kedlaya; Kiran S.,9997,0,9999,2
1657767592630,MATH 197,003,095567,Xiao; Ming,9999,0,9999,0
1657767592630,MATH 197,004,095571,Perols; Johan Lars,9998,0,9999,1
1657767599684,COGS 9,A01,083615,Shannon; Kyle Michael,9,0,75,66
1657767605710,COGS 11,A01,083617,Boyle; Mary E. T.,23,0,48,25
1657767611737,COGS 13,A01,083071,Bastos; Amalia Pinkusfeld,11,0,71,60
1657767617762,COGS 14A,A01,092681,Semenuks; Arturs,5,1,100,95
1657767623788,COGS 14B,A01,083073,Cheng; Tzu-Han,6,0,63,57
1657767629811,COGS 17,A01,092677,Semenuks; Arturs,6,0,81,75
1657767635924,COGS 100,A01,083619,Allen; Michael Gordon,17,0,70,53
1657767641951,COGS 101A,A01,083621,Davis; Joshua Daniel,9,0,68,59
1657767647975,COGS 101B,A01,091572,Allen; Michael Gordon,12,0,65,53
1657767653998,COGS 101C,A01,083625,Delgado; Tania,17,0,35,18
1657767660025,COGS 107A,A01,083627,Boyle; Mary E. T.,13,0,60,47
1657767666047,COGS 118A,A01,083075,Gupta; Anjum,21,0,76,55
1657767672069,CSE 3,A50,083646,Miranda; Gregory Joseph,24,0,50,26
1657767678096,CSE 8A,A50,083650,Miranda; Gregory Joseph,17,1,56,39
1657767684118,CSE 11,A01,083080,Cao; Yingjun,6,15,40,34
1657767690142,CSE 12,A01,083652,Krause-Levy; Sophia Louisa,28,1,120,92
1657767696169,CSE 15L,A01,083654,Morris; Justin Loren,9,0,50,41
1657767696169,CSE 15L,A02,083655,Morris; Justin Loren,9,0,50,41
1657767702192,CSE 20,A01,083657,Tran; Khoa Dang,39,0,80,41
1657767708215,CSE 21,A01,095574,Bach; Quang Tran,22,0,48,26
1657767714242,CSE 30,A01,083084,Eldon; John,6,0,80,74
1657767714242,CSE 30,B01,095061,Bhaskar; Nishant,9,0,50,41
1657767720268,CSE 100,A01,083659,Cao; Yingjun,5,4,70,65
1657767726291,CSE 134B,A01,083661,Powell; Thomas Allan,24,0,100,76
1657767732317,CSE 140,A01,083663,Gungor; Onat,15,0,85,70
1657767738340,CSE 140L,A01,083088,Eldon; John,23,0,100,77
1657767744362,CSE 175,A01,083665,Kumar; Rakesh,3,0,25,22
1657767750383,CSE 190,A00,092507,Dubnov; Shlomo,8,0,20,12
1657767756406,ECE 45,A01,083139,Congero; Spencer William,6,0,75,69
1657767762429,ECE 65,A50,083695,Saad; Andrew S,12,0,30,18
1657767762429,ECE 65,A51,095125,Saad; Andrew S,24,0,26,2
1657767768450,ECE 109,A01,091882,Touri; Behrouz,20,0,70,50
1657767774473,ECE 180,A00,083140,Abi Samra; Nicholas Camill,1,0,30,29
1657767774473,ECE 180,B00,083141,Abi Samra; Nicholas Camill,0,0,30,30
1657767780496,MATH 10A,A01,083735,Patchell; Gregory David,2,0,30,28
1657767780496,MATH 10A,A02,083736,Patchell; Gregory David,20,0,30,10
1657767780496,MATH 10A,A03,083737,Patchell; Gregory David,16,0,30,14
1657767786520,MATH 10B,A01,083207,Lim; Seonhee,8,0,34,26
1657767786520,MATH 10B,A02,083208,Lim; Seonhee,9,0,35,26
1657767786520,MATH 10B,A03,093472,Lim; Seonhee,7,0,34,27
1657767786520,MATH 10B,B01,083739,Sinha; Shubham,13,0,30,17
1657767792555,MATH 18,A01,083743,Cinel; Cameron Alexander,9,0,30,21
1657767792555,MATH 18,A02,083744,Cinel; Cameron Alexander,18,0,30,12
1657767792555,MATH 18,A03,083745,Cinel; Cameron Alexander,10,0,30,20
1657767792555,MATH 18,B01,083748,Rideout; David Porter,5,0,37,32
1657767792555,MATH 18,B02,083749,Rideout; David Porter,5,0,36,31
1657767792555,MATH 18,B03,083750,Rideout; David Porter,3,0,37,34
1657767792555,MATH 18,B04,083751,Rideout; David Porter,6,0,36,30
1657767792555,MATH 18,B05,093473,Rideout; David Porter,6,0,36,30
1657767792555,MATH 18,B06,093474,Rideout; David Porter,6,0,36,30
1657767798756,MATH 20A,A01,083754,Zheng; Zequn,14,0,40,26
1657767804780,MATH 20B,A01,083756,Briones; Jor-el Thomas Caparas,4,0,36,32
1657767804780,MATH 20B,A02,083757,Briones; Jor-el Thomas Caparas,1,0,36,35
1657767804780,MATH 20B,A03,093475,Briones; Jor-el Thomas Caparas,2,0,36,34
1657767810810,MATH 20C,A01,083760,Briones; Jor-el Thomas Caparas,1,0,35,34
1657767810810,MATH 20C,A02,083761,Briones; Jor-el Thomas Caparas,8,0,35,27
1657767810810,MATH 20C,A03,093476,Briones; Jor-el Thomas Caparas,0,1,36,36
1657767810810,MATH 20C,B01,083762,Bach; Quang Tran,1,0,30,29
1657767816832,MATH 20D,A01,083765,Tran; Brian Kha,5,0,30,25
1657767816832,MATH 20D,A02,083766,Tran; Brian Kha,5,0,30,25
1657767816832,MATH 20D,A03,083767,Tran; Brian Kha,5,0,30,25
1657767822860,MATH 20E,A01,083771,Ganguly; Soumya,9,0,32,23
1657767822860,MATH 20E,A02,083772,Ganguly; Soumya,6,0,32,26
1657767822860,MATH 20E,B01,083773,Ciotti; Benjamin,20,0,35,15
1657767822860,MATH 20E,B02,083774,Ciotti; Benjamin,18,0,35,17
1657767828887,MATH 103A,A01,083777,Greenfeld; Be'Eri,3,0,36,33
1657767828887,MATH 103A,A02,083778,Greenfeld; Be'Eri,5,0,36,31
1657767828887,MATH 103A,A03,093561,Greenfeld; Be'Eri,6,0,36,30
1657767828887,MATH 103A,B01,083779,Greenfeld; Be'Eri,7,0,36,29
1657767828887,MATH 103A,B02,083780,Greenfeld; Be'Eri,4,0,36,32
1657767828887,MATH 103A,B03,093562,Greenfeld; Be'Eri,3,0,36,33
1657767834910,MATH 105,A01,085443,Carter; Anne Toulson,15,0,35,20
1657767834910,MATH 105,A02,093477,Carter; Anne Toulson,20,0,35,15
1657767840933,MATH 109,A01,083213,Ganzberger; Geoffrey Michael,3,0,34,31
1657767840933,MATH 109,A02,083214,Ganzberger; Geoffrey Michael,4,0,34,30
1657767840933,MATH 109,A03,093478,Ganzberger; Geoffrey Michael,2,0,34,32
1657767840933,MATH 109,B01,083215,Ganzberger; Geoffrey Michael,1,0,32,31
1657767840933,MATH 109,B02,083216,Ganzberger; Geoffrey Michael,2,0,32,30
1657767840933,MATH 109,B03,093479,Ganzberger; Geoffrey Michael,8,0,32,24
1657767846958,MATH 142A,A01,083219,Chow; Bennett,7,0,32,25
1657767846958,MATH 142A,A02,083220,Chow; Bennett,10,0,32,22
1657767846958,MATH 142A,A03,093480,Chow; Bennett,9,0,32,23
1657767846958,MATH 142A,B03,093481,Chow; Bennett,8,0,32,24
1657767846958,MATH 142A,B04,093558,Chow; Bennett,13,0,32,19
1657767846958,MATH 142A,B05,093559,Chow; Bennett,6,0,32,26
1657767852987,MATH 193A,A01,083224,Rotar; Vladimir,8,0,34,26
1657767852987,MATH 193A,A02,083225,Rotar; Vladimir,9,0,34,25
1657767852987,MATH 193A,A03,083781,Rotar; Vladimir,5,0,34,29
1657767852987,MATH 193A,A04,083782,Rotar; Vladimir,10,0,34,24
1657767852987,MATH 193A,A05,093482,Rotar; Vladimir,10,0,34,24
1657767859013,MATH 197,001,091859,McAuley; Julian John,9999,0,9999,0
1657767859013,MATH 197,002,095566,Kedlaya; Kiran S.,9997,0,9999,2
1657767859013,MATH 197,003,095567,Xiao; Ming,9999,0,9999,0
1657767859013,MATH 197,004,095571,Perols; Johan Lars,9998,0,9999,1
1657767866067,COGS 9,A01,083615,Shannon; Kyle Michael,9,0,75,66
1657767872092,COGS 11,A01,083617,Boyle; Mary E. T.,23,0,48,25
1657767878115,COGS 13,A01,083071,Bastos; Amalia Pinkusfeld,11,0,71,60
1657767884140,COGS 14A,A01,092681,Semenuks; Arturs,5,1,100,95
1657767890164,COGS 14B,A01,083073,Cheng; Tzu-Han,6,0,63,57
1657767896192,COGS 17,A01,092677,Semenuks; Arturs,6,0,81,75
1657767902219,COGS 100,A01,083619,Allen; Michael Gordon,17,0,70,53
1657767908246,COGS 101A,A01,083621,Davis; Joshua Daniel,9,0,68,59
1657767914271,COGS 101B,A01,091572,Allen; Michael Gordon,12,0,65,53
1657767920299,COGS 101C,A01,083625,Delgado; Tania,17,0,35,18
1657767926331,COGS 107A,A01,083627,Boyle; Mary E. T.,13,0,60,47
1657767932357,COGS 118A,A01,083075,Gupta; Anjum,21,0,76,55
1657767938379,CSE 3,A50,083646,Miranda; Gregory Joseph,24,0,50,26
1657767944406,CSE 8A,A50,083650,Miranda; Gregory Joseph,17,1,56,39
1657767950430,CSE 11,A01,083080,Cao; Yingjun,6,15,40,34
1657767956454,CSE 12,A01,083652,Krause-Levy; Sophia Louisa,28,1,120,92
1657767962475,CSE 15L,A01,083654,Morris; Justin Loren,9,0,50,41
1657767962475,CSE 15L,A02,083655,Morris; Justin Loren,9,0,50,41
1657767968501,CSE 20,A01,083657,Tran; Khoa Dang,39,0,80,41
1657767974526,CSE 21,A01,095574,Bach; Quang Tran,22,0,48,26
1657767980554,CSE 30,A01,083084,Eldon; John,6,0,80,74
1657767980554,CSE 30,B01,095061,Bhaskar; Nishant,9,0,50,41
1657767986577,CSE 100,A01,083659,Cao; Yingjun,5,4,70,65
1657767992602,CSE 134B,A01,083661,Powell; Thomas Allan,24,0,100,76
1657767998639,CSE 140,A01,083663,Gungor; Onat,15,0,85,70
1657768004662,CSE 140L,A01,083088,Eldon; John,23,0,100,77
1657768010687,CSE 175,A01,083665,Kumar; Rakesh,3,0,25,22
1657768016713,CSE 190,A00,092507,Dubnov; Shlomo,8,0,20,12
1657768022736,ECE 45,A01,083139,Congero; Spencer William,6,0,75,69
1657768028760,ECE 65,A50,083695,Saad; Andrew S,12,0,30,18
1657768028760,ECE 65,A51,095125,Saad; Andrew S,24,0,26,2
1657768034784,ECE 109,A01,091882,Touri; Behrouz,20,0,70,50
1657768040811,ECE 180,A00,083140,Abi Samra; Nicholas Camill,1,0,30,29
1657768040811,ECE 180,B00,083141,Abi Samra; Nicholas Camill,0,0,30,30
1657768046837,MATH 10A,A01,083735,Patchell; Gregory David,2,0,30,28
1657768046837,MATH 10A,A02,083736,Patchell; Gregory David,20,0,30,10
1657768046837,MATH 10A,A03,083737,Patchell; Gregory David,16,0,30,14
1657768052866,MATH 10B,A01,083207,Lim; Seonhee,8,0,34,26
1657768052866,MATH 10B,A02,083208,Lim; Seonhee,9,0,35,26
1657768052866,MATH 10B,A03,093472,Lim; Seonhee,7,0,34,27
1657768052866,MATH 10B,B01,083739,Sinha; Shubham,13,0,30,17
1657768058890,MATH 18,A01,083743,Cinel; Cameron Alexander,9,0,30,21
1657768058890,MATH 18,A02,083744,Cinel; Cameron Alexander,18,0,30,12
1657768058890,MATH 18,A03,083745,Cinel; Cameron Alexander,10,0,30,20
1657768058890,MATH 18,B01,083748,Rideout; David Porter,5,0,37,32
1657768058890,MATH 18,B02,083749,Rideout; David Porter,5,0,36,31
1657768058890,MATH 18,B03,083750,Rideout; David Porter,3,0,37,34
1657768058890,MATH 18,B04,083751,Rideout; David Porter,6,0,36,30
1657768058890,MATH 18,B05,093473,Rideout; David Porter,6,0,36,30
1657768058890,MATH 18,B06,093474,Rideout; David Porter,6,0,36,30
1657768064916,MATH 20A,A01,083754,Zheng; Zequn,14,0,40,26
1657768070939,MATH 20B,A01,083756,Briones; Jor-el Thomas Caparas,4,0,36,32
1657768070939,MATH 20B,A02,083757,Briones; Jor-el Thomas Caparas,1,0,36,35
1657768070939,MATH 20B,A03,093475,Briones; Jor-el Thomas Caparas,2,0,36,34
1657768076966,MATH 20C,A01,083760,Briones; Jor-el Thomas Caparas,1,0,35,34
1657768076966,MATH 20C,A02,083761,Briones; Jor-el Thomas Caparas,8,0,35,27
1657768076966,MATH 20C,A03,093476,Briones; Jor-el Thomas Caparas,0,1,36,36
1657768076966,MATH 20C,B01,083762,Bach; Quang Tran,1,0,30,29
1657768082989,MATH 20D,A01,083765,Tran; Brian Kha,5,0,30,25
1657768082989,MATH 20D,A02,083766,Tran; Brian Kha,5,0,30,25
1657768082989,MATH 20D,A03,083767,Tran; Brian Kha,5,0,30,25
1657768089017,MATH 20E,A01,083771,Ganguly; Soumya,9,0,32,23
1657768089017,MATH 20E,A02,083772,Ganguly; Soumya,6,0,32,26
1657768089017,MATH 20E,B01,083773,Ciotti; Benjamin,20,0,35,15
1657768089017,MATH 20E,B02,083774,Ciotti; Benjamin,18,0,35,17
1657768095039,MATH 103A,A01,083777,Greenfeld; Be'Eri,3,0,36,33
1657768095039,MATH 103A,A02,083778,Greenfeld; Be'Eri,5,0,36,31
1657768095039,MATH 103A,A03,093561,Greenfeld; Be'Eri,6,0,36,30
1657768095039,MATH 103A,B01,083779,Greenfeld; Be'Eri,7,0,36,29
1657768095039,MATH 103A,B02,083780,Greenfeld; Be'Eri,4,0,36,32
1657768095039,MATH 103A,B03,093562,Greenfeld; Be'Eri,3,0,36,33
1657768101062,MATH 105,A01,085443,Carter; Anne Toulson,15,0,35,20
1657768101062,MATH 105,A02,093477,Carter; Anne Toulson,20,0,35,15
1657768107083,MATH 109,A01,083213,Ganzberger; Geoffrey Michael,3,0,34,31
1657768107083,MATH 109,A02,083214,Ganzberger; Geoffrey Michael,4,0,34,30
1657768107083,MATH 109,A03,093478,Ganzberger; Geoffrey Michael,2,0,34,32
1657768107083,MATH 109,B01,083215,Ganzberger; Geoffrey Michael,1,0,32,31
1657768107083,MATH 109,B02,083216,Ganzberger; Geoffrey Michael,2,0,32,30
1657768107083,MATH 109,B03,093479,Ganzberger; Geoffrey Michael,8,0,32,24
1657768113111,MATH 142A,A01,083219,Chow; Bennett,7,0,32,25
1657768113111,MATH 142A,A02,083220,Chow; Bennett,10,0,32,22
1657768113111,MATH 142A,A03,093480,Chow; Bennett,9,0,32,23
1657768113111,MATH 142A,B03,093481,Chow; Bennett,8,0,32,24
1657768113111,MATH 142A,B04,093558,Chow; Bennett,13,0,32,19
1657768113111,MATH 142A,B05,093559,Chow; Bennett,6,0,32,26
1657768119135,MATH 193A,A01,083224,Rotar; Vladimir,8,0,34,26
1657768119135,MATH 193A,A02,083225,Rotar; Vladimir,9,0,34,25
1657768119135,MATH 193A,A03,083781,Rotar; Vladimir,5,0,34,29
1657768119135,MATH 193A,A04,083782,Rotar; Vladimir,10,0,34,24
1657768119135,MATH 193A,A05,093482,Rotar; Vladimir,10,0,34,24
1657768125160,MATH 197,001,091859,McAuley; Julian John,9999,0,9999,0
1657768125160,MATH 197,002,095566,Kedlaya; Kiran S.,9997,0,9999,2
1657768125160,MATH 197,003,095567,Xiao; Ming,9999,0,9999,0
1657768125160,MATH 197,004,095571,Perols; Johan Lars,9998,0,9999,1
1657768132211,COGS 9,A01,083615,Shannon; Kyle Michael,9,0,75,66
1657768138241,COGS 11,A01,083617,Boyle; Mary E. T.,23,0,48,25
1657768144266,COGS 13,A01,083071,Bastos; Amalia Pinkusfeld,11,0,71,60
1657768150302,COGS 14A,A01,092681,Semenuks; Arturs,5,1,100,95
1657768156328,COGS 14B,A01,083073,Cheng; Tzu-Han,6,0,63,57
1657768162350,COGS 17,A01,092677,Semenuks; Arturs,6,0,81,75
1657768168373,COGS 100,A01,083619,Allen; Michael Gordon,17,0,70,53
1657768174401,COGS 101A,A01,083621,Davis; Joshua Daniel,9,0,68,59
1657768180428,COGS 101B,A01,091572,Allen; Michael Gordon,12,0,65,53
1657768186451,COGS 101C,A01,083625,Delgado; Tania,17,0,35,18
1657768192474,COGS 107A,A01,083627,Boyle; Mary E. T.,13,0,60,47
1657768198497,COGS 118A,A01,083075,Gupta; Anjum,21,0,76,55
1657768204521,CSE 3,A50,083646,Miranda; Gregory Joseph,24,0,50,26
1657768210547,CSE 8A,A50,083650,Miranda; Gregory Joseph,17,1,56,39
1657768216574,CSE 11,A01,083080,Cao; Yingjun,6,15,40,34
1657768222597,CSE 12,A01,083652,Krause-Levy; Sophia Louisa,28,1,120,92
1657768228624,CSE 15L,A01,083654,Morris; Justin Loren,9,0,50,41
1657768228624,CSE 15L,A02,083655,Morris; Justin Loren,9,0,50,41
1657768234744,CSE 20,A01,083657,Tran; Khoa Dang,39,0,80,41
1657768240765,CSE 21,A01,095574,Bach; Quang Tran,22,0,48,26
1657768246793,CSE 30,A01,083084,Eldon; John,6,0,80,74
1657768246793,CSE 30,B01,095061,Bhaskar; Nishant,9,0,50,41
1657768252821,CSE 100,A01,083659,Cao; Yingjun,5,4,70,65
1657768258847,CSE 134B,A01,083661,Powell; Thomas Allan,24,0,100,76
1657768264871,CSE 140,A01,083663,Gungor; Onat,15,0,85,70
1657768270897,CSE 140L,A01,083088,Eldon; John,23,0,100,77
1657768276921,CSE 175,A01,083665,Kumar; Rakesh,3,0,25,22
1657768282944,CSE 190,A00,092507,Dubnov; Shlomo,8,0,20,12
1657768288968,ECE 45,A01,083139,Congero; Spencer William,6,0,75,69
1657768294992,ECE 65,A50,083695,Saad; Andrew S,12,0,30,18
1657768294992,ECE 65,A51,095125,Saad; Andrew S,24,0,26,2
1657768301014,ECE 109,A01,091882,Touri; Behrouz,20,0,70,50
1657768307041,ECE 180,A00,083140,Abi Samra; Nicholas Camill,1,0,30,29
1657768307041,ECE 180,B00,083141,Abi Samra; Nicholas Camill,0,0,30,30
1657768313070,MATH 10A,A01,083735,Patchell; Gregory David,2,0,30,28
1657768313070,MATH 10A,A02,083736,Patchell; Gregory David,20,0,30,10
1657768313070,MATH 10A,A03,083737,Patchell; Gregory David,16,0,30,14
1657768319094,MATH 10B,A01,083207,Lim; Seonhee,8,0,34,26
1657768319094,MATH 10B,A02,083208,Lim; Seonhee,9,0,35,26
1657768319094,MATH 10B,A03,093472,Lim; Seonhee,7,0,34,27
1657768319094,MATH 10B,B01,083739,Sinha; Shubham,13,0,30,17
1657768325125,MATH 18,A01,083743,Cinel; Cameron Alexander,9,0,30,21
1657768325125,MATH 18,A02,083744,Cinel; Cameron Alexander,18,0,30,12
1657768325125,MATH 18,A03,083745,Cinel; Cameron Alexander,10,0,30,20
1657768325125,MATH 18,B01,083748,Rideout; David Porter,5,0,37,32
1657768325125,MATH 18,B02,083749,Rideout; David Porter,5,0,36,31
1657768325125,MATH 18,B03,083750,Rideout; David Porter,3,0,37,34
1657768325125,MATH 18,B04,083751,Rideout; David Porter,6,0,36,30
1657768325125,MATH 18,B05,093473,Rideout; David Porter,6,0,36,30
1657768325125,MATH 18,B06,093474,Rideout; David Porter,6,0,36,30
1657768331151,MATH 20A,A01,083754,Zheng; Zequn,14,0,40,26
1657768337176,MATH 20B,A01,083756,Briones; Jor-el Thomas Caparas,4,0,36,32
1657768337176,MATH 20B,A02,083757,Briones; Jor-el Thomas Caparas,1,0,36,35
1657768337176,MATH 20B,A03,093475,Briones; Jor-el Thomas Caparas,2,0,36,34
1657768343200,MATH 20C,A01,083760,Briones; Jor-el Thomas Caparas,1,0,35,34
1657768343200,MATH 20C,A02,083761,Briones; Jor-el Thomas Caparas,8,0,35,27
1657768343200,MATH 20C,A03,093476,Briones; Jor-el Thomas Caparas,0,1,36,36
1657768343200,MATH 20C,B01,083762,Bach; Quang Tran,1,0,30,29
1657768349224,MATH 20D,A01,083765,Tran; Brian Kha,5,0,30,25
1657768349224,MATH 20D,A02,083766,Tran; Brian Kha,5,0,30,25
1657768349224,MATH 20D,A03,083767,Tran; Brian Kha,5,0,30,25
1657768355249,MATH 20E,A01,083771,Ganguly; Soumya,9,0,32,23
1657768355249,MATH 20E,A02,083772,Ganguly; Soumya,6,0,32,26
1657768355249,MATH 20E,B01,083773,Ciotti; Benjamin,20,0,35,15
1657768355249,MATH 20E,B02,083774,Ciotti; Benjamin,18,0,35,17
1657768361273,MATH 103A,A01,083777,Greenfeld; Be'Eri,3,0,36,33
1657768361273,MATH 103A,A02,083778,Greenfeld; Be'Eri,5,0,36,31
1657768361273,MATH 103A,A03,093561,Greenfeld; Be'Eri,6,0,36,30
1657768361273,MATH 103A,B01,083779,Greenfeld; Be'Eri,7,0,36,29
1657768361273,MATH 103A,B02,083780,Greenfeld; Be'Eri,4,0,36,32
1657768361273,MATH 103A,B03,093562,Greenfeld; Be'Eri,3,0,36,33
1657768367301,MATH 105,A01,085443,Carter; Anne Toulson,15,0,35,20
1657768367301,MATH 105,A02,093477,Carter; Anne Toulson,20,0,35,15
1657768373323,MATH 109,A01,083213,Ganzberger; Geoffrey Michael,3,0,34,31
1657768373323,MATH 109,A02,083214,Ganzberger; Geoffrey Michael,4,0,34,30
1657768373323,MATH 109,A03,093478,Ganzberger; Geoffrey Michael,2,0,34,32
1657768373323,MATH 109,B01,083215,Ganzberger; Geoffrey Michael,1,0,32,31
1657768373323,MATH 109,B02,083216,Ganzberger; Geoffrey Michael,2,0,32,30
1657768373323,MATH 109,B03,093479,Ganzberger; Geoffrey Michael,8,0,32,24
1657768379346,MATH 142A,A01,083219,Chow; Bennett,7,0,32,25
1657768379346,MATH 142A,A02,083220,Chow; Bennett,10,0,32,22
1657768379346,MATH 142A,A03,093480,Chow; Bennett,9,0,32,23
1657768379346,MATH 142A,B03,093481,Chow; Bennett,8,0,32,24
1657768379346,MATH 142A,B04,093558,Chow; Bennett,13,0,32,19
1657768379346,MATH 142A,B05,093559,Chow; Bennett,6,0,32,26
1657768385369,MATH 193A,A01,083224,Rotar; Vladimir,8,0,34,26
1657768385369,MATH 193A,A02,083225,Rotar; Vladimir,9,0,34,25
1657768385369,MATH 193A,A03,083781,Rotar; Vladimir,5,0,34,29
1657768385369,MATH 193A,A04,083782,Rotar; Vladimir,10,0,34,24
1657768385369,MATH 193A,A05,093482,Rotar; Vladimir,10,0,34,24
1657768391391,MATH 197,001,091859,McAuley; Julian John,9999,0,9999,0
1657768391391,MATH 197,002,095566,Kedlaya; Kiran S.,9997,0,9999,2
1657768391391,MATH 197,003,095567,Xiao; Ming,9999,0,9999,0
1657768391391,MATH 197,004,095571,Perols; Johan Lars,9998,0,9999,1
1657768398451,COGS 9,A01,083615,Shannon; Kyle Michael,9,0,75,66
1657768404483,COGS 11,A01,083617,Boyle; Mary E. T.,23,0,48,25
1657768410510,COGS 13,A01,083071,Bastos; Amalia Pinkusfeld,11,0,71,60
1657768416535,COGS 14A,A01,092681,Semenuks; Arturs,5,1,100,95
1657768422569,COGS 14B,A01,083073,Cheng; Tzu-Han,6,0,63,57
1657768428591,COGS 17,A01,092677,Semenuks; Arturs,6,0,81,75
1657768434615,COGS 100,A01,083619,Allen; Michael Gordon,17,0,70,53
1657768440638,COGS 101A,A01,083621,Davis; Joshua Daniel,9,0,68,59
1657768446665,COGS 101B,A01,091572,Allen; Michael Gordon,12,0,65,53
1657768452687,COGS 101C,A01,083625,Delgado; Tania,17,0,35,18
1657768458709,COGS 107A,A01,083627,Boyle; Mary E. T.,13,0,60,47
1657768464732,COGS 118A,A01,083075,Gupta; Anjum,21,0,76,55
1657768470760,CSE 3,A50,083646,Miranda; Gregory Joseph,24,0,50,26
1657768476787,CSE 8A,A50,083650,Miranda; Gregory Joseph,17,1,56,39
1657768482823,CSE 11,A01,083080,Cao; Yingjun,6,15,40,34
1657768488847,CSE 12,A01,083652,Krause-Levy; Sophia Louisa,28,1,120,92
1657768494875,CSE 15L,A01,083654,Morris; Justin Loren,9,0,50,41
1657768494875,CSE 15L,A02,083655,Morris; Justin Loren,9,0,50,41
1657768500901,CSE 20,A01,083657,Tran; Khoa Dang,39,0,80,41
1657768506926,CSE 21,A01,095574,Bach; Quang Tran,22,0,48,26
1657768512949,CSE 30,A01,083084,Eldon; John,6,0,80,74
1657768512949,CSE 30,B01,095061,Bhaskar; Nishant,9,0,50,41
1657768518975,CSE 100,A01,083659,Cao; Yingjun,5,4,70,65
1657768524999,CSE 134B,A01,083661,Powell; Thomas Allan,24,0,100,76
1657768531025,CSE 140,A01,083663,Gungor; Onat,15,0,85,70
1657768537048,CSE 140L,A01,083088,Eldon; John,23,0,100,77
1657768543070,CSE 175,A01,083665,Kumar; Rakesh,3,0,25,22
1657768549096,CSE 190,A00,092507,Dubnov; Shlomo,8,0,20,12
1657768555144,ECE 45,A01,083139,Congero; Spencer William,6,0,75,69
1657768561171,ECE 65,A50,083695,Saad; Andrew S,12,0,30,18
1657768561171,ECE 65,A51,095125,Saad; Andrew S,24,0,26,2
1657768567203,ECE 109,A01,091882,Touri; Behrouz,20,0,70,50
1657768573228,ECE 180,A00,083140,Abi Samra; Nicholas Camill,1,0,30,29
1657768573228,ECE 180,B00,083141,Abi Samra; Nicholas Camill,0,0,30,30
1657768579255,MATH 10A,A01,083735,Patchell; Gregory David,2,0,30,28
1657768579255,MATH 10A,A02,083736,Patchell; Gregory David,20,0,30,10
1657768579255,MATH 10A,A03,083737,Patchell; Gregory David,16,0,30,14
1657768585284,MATH 10B,A01,083207,Lim; Seonhee,8,0,34,26
1657768585284,MATH 10B,A02,083208,Lim; Seonhee,9,0,35,26
1657768585284,MATH 10B,A03,093472,Lim; Seonhee,7,0,34,27
1657768585284,MATH 10B,B01,083739,Sinha; Shubham,13,0,30,17
1657768591315,MATH 18,A01,083743,Cinel; Cameron Alexander,9,0,30,21
1657768591315,MATH 18,A02,083744,Cinel; Cameron Alexander,18,0,30,12
1657768591315,MATH 18,A03,083745,Cinel; Cameron Alexander,10,0,30,20
1657768591315,MATH 18,B01,083748,Rideout; David Porter,5,0,37,32
1657768591315,MATH 18,B02,083749,Rideout; David Porter,5,0,36,31
1657768591315,MATH 18,B03,083750,Rideout; David Porter,3,0,37,34
1657768591315,MATH 18,B04,083751,Rideout; David Porter,6,0,36,30
1657768591315,MATH 18,B05,093473,Rideout; David Porter,6,0,36,30
1657768591315,MATH 18,B06,093474,Rideout; David Porter,6,0,36,30
1657768597338,MATH 20A,A01,083754,Zheng; Zequn,14,0,40,26
1657768603367,MATH 20B,A01,083756,Briones; Jor-el Thomas Caparas,4,0,36,32
1657768603367,MATH 20B,A02,083757,Briones; Jor-el Thomas Caparas,1,0,36,35
1657768603367,MATH 20B,A03,093475,Briones; Jor-el Thomas Caparas,2,0,36,34
1657768609401,MATH 20C,A01,083760,Briones; Jor-el Thomas Caparas,1,0,35,34
1657768609401,MATH 20C,A02,083761,Briones; Jor-el Thomas Caparas,8,0,35,27
1657768609401,MATH 20C,A03,093476,Briones; Jor-el Thomas Caparas,0,1,36,36
1657768609401,MATH 20C,B01,083762,Bach; Quang Tran,1,0,30,29
1657768615428,MATH 20D,A01,083765,Tran; Brian Kha,5,0,30,25
1657768615428,MATH 20D,A02,083766,Tran; Brian Kha,5,0,30,25
1657768615428,MATH 20D,A03,083767,Tran; Brian Kha,5,0,30,25
1657768621453,MATH 20E,A01,083771,Ganguly; Soumya,9,0,32,23
1657768621453,MATH 20E,A02,083772,Ganguly; Soumya,6,0,32,26
1657768621453,MATH 20E,B01,083773,Ciotti; Benjamin,20,0,35,15
1657768621453,MATH 20E,B02,083774,Ciotti; Benjamin,18,0,35,17
1657768627482,MATH 103A,A01,083777,Greenfeld; Be'Eri,3,0,36,33
1657768627482,MATH 103A,A02,083778,Greenfeld; Be'Eri,5,0,36,31
1657768627482,MATH 103A,A03,093561,Greenfeld; Be'Eri,6,0,36,30
1657768627482,MATH 103A,B01,083779,Greenfeld; Be'Eri,7,0,36,29
1657768627482,MATH 103A,B02,083780,Greenfeld; Be'Eri,4,0,36,32
1657768627482,MATH 103A,B03,093562,Greenfeld; Be'Eri,3,0,36,33
1657768633505,MATH 105,A01,085443,Carter; Anne Toulson,15,0,35,20
1657768633505,MATH 105,A02,093477,Carter; Anne Toulson,20,0,35,15
1657768639529,MATH 109,A01,083213,Ganzberger; Geoffrey Michael,3,0,34,31
1657768639529,MATH 109,A02,083214,Ganzberger; Geoffrey Michael,4,0,34,30
1657768639529,MATH 109,A03,093478,Ganzberger; Geoffrey Michael,2,0,34,32
1657768639529,MATH 109,B01,083215,Ganzberger; Geoffrey Michael,1,0,32,31
1657768639529,MATH 109,B02,083216,Ganzberger; Geoffrey Michael,2,0,32,30
1657768639529,MATH 109,B03,093479,Ganzberger; Geoffrey Michael,8,0,32,24
1657768645554,MATH 142A,A01,083219,Chow; Bennett,7,0,32,25
1657768645554,MATH 142A,A02,083220,Chow; Bennett,10,0,32,22
1657768645554,MATH 142A,A03,093480,Chow; Bennett,9,0,32,23
1657768645554,MATH 142A,B03,093481,Chow; Bennett,8,0,32,24
1657768645554,MATH 142A,B04,093558,Chow; Bennett,13,0,32,19
1657768645554,MATH 142A,B05,093559,Chow; Bennett,6,0,32,26
1657768651575,MATH 193A,A01,083224,Rotar; Vladimir,8,0,34,26
1657768651575,MATH 193A,A02,083225,Rotar; Vladimir,9,0,34,25
1657768651575,MATH 193A,A03,083781,Rotar; Vladimir,5,0,34,29
1657768651575,MATH 193A,A04,083782,Rotar; Vladimir,10,0,34,24
1657768651575,MATH 193A,A05,093482,Rotar; Vladimir,10,0,34,24
1657768657600,MATH 197,001,091859,McAuley; Julian John,9999,0,9999,0
1657768657600,MATH 197,002,095566,Kedlaya; Kiran S.,9997,0,9999,2
1657768657600,MATH 197,003,095567,Xiao; Ming,9999,0,9999,0
1657768657600,MATH 197,004,095571,Perols; Johan Lars,9998,0,9999,1
1657768664655,COGS 9,A01,083615,Shannon; Kyle Michael,9,0,75,66
1657768670682,COGS 11,A01,083617,Boyle; Mary E. T.,23,0,48,25
1657768676708,COGS 13,A01,083071,Bastos; Amalia Pinkusfeld,11,0,71,60
1657768682733,COGS 14A,A01,092681,Semenuks; Arturs,5,1,100,95
1657768688759,COGS 14B,A01,083073,Cheng; Tzu-Han,6,0,63,57
1657768694789,COGS 17,A01,092677,Semenuks; Arturs,6,0,81,75
1657768700815,COGS 100,A01,083619,Allen; Michael Gordon,17,0,70,53
1657768706839,COGS 101A,A01,083621,Davis; Joshua Daniel,9,0,68,59
1657768712867,COGS 101B,A01,091572,Allen; Michael Gordon,12,0,65,53
1657768718890,COGS 101C,A01,083625,Delgado; Tania,17,0,35,18
1657768724912,COGS 107A,A01,083627,Boyle; Mary E. T.,13,0,60,47
1657768730935,COGS 118A,A01,083075,Gupta; Anjum,21,0,76,55
1657768736958,CSE 3,A50,083646,Miranda; Gregory Joseph,24,0,50,26
1657768742982,CSE 8A,A50,083650,Miranda; Gregory Joseph,17,1,56,39
1657768749019,CSE 11,A01,083080,Cao; Yingjun,6,15,40,34
1657768755049,CSE 12,A01,083652,Krause-Levy; Sophia Louisa,28,1,120,92
1657768761071,CSE 15L,A01,083654,Morris; Justin Loren,9,0,50,41
1657768761071,CSE 15L,A02,083655,Morris; Justin Loren,9,0,50,41
1657768767094,CSE 20,A01,083657,Tran; Khoa Dang,39,0,80,41
1657768773117,CSE 21,A01,095574,Bach; Quang Tran,22,0,48,26
1657768779143,CSE 30,A01,083084,Eldon; John,6,0,80,74
1657768779143,CSE 30,B01,095061,Bhaskar; Nishant,9,0,50,41
1657768785169,CSE 100,A01,083659,Cao; Yingjun,5,4,70,65
1657768791192,CSE 134B,A01,083661,Powell; Thomas Allan,24,0,100,76
1657768797218,CSE 140,A01,083663,Gungor; Onat,15,0,85,70
1657768803246,CSE 140L,A01,083088,Eldon; John,23,0,100,77
1657768809268,CSE 175,A01,083665,Kumar; Rakesh,3,0,25,22
1657768815291,CSE 190,A00,092507,Dubnov; Shlomo,8,0,20,12
1657768821314,ECE 45,A01,083139,Congero; Spencer William,6,0,75,69
1657768827338,ECE 65,A50,083695,Saad; Andrew S,12,0,30,18
1657768827338,ECE 65,A51,095125,Saad; Andrew S,24,0,26,2
1657768833448,ECE 109,A01,091882,Touri; Behrouz,20,0,70,50
1657768839469,ECE 180,A00,083140,Abi Samra; Nicholas Camill,1,0,30,29
1657768839469,ECE 180,B00,083141,Abi Samra; Nicholas Camill,0,0,30,30
1657768845496,MATH 10A,A01,083735,Patchell; Gregory David,2,0,30,28
1657768845496,MATH 10A,A02,083736,Patchell; Gregory David,20,0,30,10
1657768845496,MATH 10A,A03,083737,Patchell; Gregory David,16,0,30,14
1657768851522,MATH 10B,A01,083207,Lim; Seonhee,8,0,34,26
1657768851522,MATH 10B,A02,083208,Lim; Seonhee,9,0,35,26
1657768851522,MATH 10B,A03,093472,Lim; Seonhee,7,0,34,27
1657768851522,MATH 10B,B01,083739,Sinha; Shubham,13,0,30,17
1657768857547,MATH 18,A01,083743,Cinel; Cameron Alexander,9,0,30,21
1657768857547,MATH 18,A02,083744,Cinel; Cameron Alexander,18,0,30,12
1657768857547,MATH 18,A03,083745,Cinel; Cameron Alexander,10,0,30,20
1657768857547,MATH 18,B01,083748,Rideout; David Porter,5,0,37,32
1657768857547,MATH 18,B02,083749,Rideout; David Porter,5,0,36,31
1657768857547,MATH 18,B03,083750,Rideout; David Porter,3,0,37,34
1657768857547,MATH 18,B04,083751,Rideout; David Porter,6,0,36,30
1657768857547,MATH 18,B05,093473,Rideout; David Porter,6,0,36,30
1657768857547,MATH 18,B06,093474,Rideout; David Porter,6,0,36,30
1657768863573,MATH 20A,A01,083754,Zheng; Zequn,14,0,40,26
1657768869597,MATH 20B,A01,083756,Briones; Jor-el Thomas Caparas,4,0,36,32
1657768869597,MATH 20B,A02,083757,Briones; Jor-el Thomas Caparas,1,0,36,35
1657768869597,MATH 20B,A03,093475,Briones; Jor-el Thomas Caparas,2,0,36,34
1657768875622,MATH 20C,A01,083760,Briones; Jor-el Thomas Caparas,1,0,35,34
1657768875622,MATH 20C,A02,083761,Briones; Jor-el Thomas Caparas,8,0,35,27
1657768875622,MATH 20C,A03,093476,Briones; Jor-el Thomas Caparas,0,1,36,36
1657768875622,MATH 20C,B01,083762,Bach; Quang Tran,1,0,30,29
1657768881650,MATH 20D,A01,083765,Tran; Brian Kha,5,0,30,25
1657768881650,MATH 20D,A02,083766,Tran; Brian Kha,5,0,30,25
1657768881650,MATH 20D,A03,083767,Tran; Brian Kha,5,0,30,25
1657768887672,MATH 20E,A01,083771,Ganguly; Soumya,9,0,32,23
1657768887672,MATH 20E,A02,083772,Ganguly; Soumya,6,0,32,26
1657768887672,MATH 20E,B01,083773,Ciotti; Benjamin,20,0,35,15
1657768887672,MATH 20E,B02,083774,Ciotti; Benjamin,18,0,35,17
1657768893706,MATH 103A,A01,083777,Greenfeld; Be'Eri,3,0,36,33
1657768893706,MATH 103A,A02,083778,Greenfeld; Be'Eri,5,0,36,31
1657768893706,MATH 103A,A03,093561,Greenfeld; Be'Eri,6,0,36,30
1657768893706,MATH 103A,B01,083779,Greenfeld; Be'Eri,7,0,36,29
1657768893706,MATH 103A,B02,083780,Greenfeld; Be'Eri,4,0,36,32
1657768893706,MATH 103A,B03,093562,Greenfeld; Be'Eri,3,0,36,33
1657768899732,MATH 105,A01,085443,Carter; Anne Toulson,15,0,35,20
1657768899732,MATH 105,A02,093477,Carter; Anne Toulson,20,0,35,15
1657768905756,MATH 109,A01,083213,Ganzberger; Geoffrey Michael,3,0,34,31
1657768905756,MATH 109,A02,083214,Ganzberger; Geoffrey Michael,4,0,34,30
1657768905756,MATH 109,A03,093478,Ganzberger; Geoffrey Michael,2,0,34,32
1657768905756,MATH 109,B01,083215,Ganzberger; Geoffrey Michael,1,0,32,31
1657768905756,MATH 109,B02,083216,Ganzberger; Geoffrey Michael,2,0,32,30
1657768905756,MATH 109,B03,093479,Ganzberger; Geoffrey Michael,8,0,32,24
1657768911780,MATH 142A,A01,083219,Chow; Bennett,7,0,32,25
1657768911780,MATH 142A,A02,083220,Chow; Bennett,10,0,32,22
1657768911780,MATH 142A,A03,093480,Chow; Bennett,9,0,32,23
1657768911780,MATH 142A,B03,093481,Chow; Bennett,8,0,32,24
1657768911780,MATH 142A,B04,093558,Chow; Bennett,13,0,32,19
1657768911780,MATH 142A,B05,093559,Chow; Bennett,6,0,32,26
1657768917810,MATH 193A,A01,083224,Rotar; Vladimir,8,0,34,26
1657768917810,MATH 193A,A02,083225,Rotar; Vladimir,9,0,34,25
1657768917810,MATH 193A,A03,083781,Rotar; Vladimir,5,0,34,29
1657768917810,MATH 193A,A04,083782,Rotar; Vladimir,10,0,34,24
1657768917810,MATH 193A,A05,093482,Rotar; Vladimir,10,0,34,24
1657768923836,MATH 197,001,091859,McAuley; Julian John,9999,0,9999,0
1657768923836,MATH 197,002,095566,Kedlaya; Kiran S.,9997,0,9999,2
1657768923836,MATH 197,003,095567,Xiao; Ming,9999,0,9999,0
1657768923836,MATH 197,004,095571,Perols; Johan Lars,9998,0,9999,1
1657768930911,COGS 9,A01,083615,Shannon; Kyle Michael,9,0,75,66
1657768936935,COGS 11,A01,083617,Boyle; Mary E. T.,23,0,48,25
1657768942959,COGS 13,A01,083071,Bastos; Amalia Pinkusfeld,11,0,71,60
1657768948983,COGS 14A,A01,092681,Semenuks; Arturs,5,1,100,95
1657768955007,COGS 14B,A01,083073,Cheng; Tzu-Han,6,0,63,57
1657768961034,COGS 17,A01,092677,Semenuks; Arturs,6,0,81,75
1657768967057,COGS 100,A01,083619,Allen; Michael Gordon,17,0,70,53
1657768973079,COGS 101A,A01,083621,Davis; Joshua Daniel,9,0,68,59
1657768979102,COGS 101B,A01,091572,Allen; Michael Gordon,12,0,65,53
1657768985124,COGS 101C,A01,083625,Delgado; Tania,17,0,35,18
1657768991146,COGS 107A,A01,083627,Boyle; Mary E. T.,13,0,60,47
1657768997187,COGS 118A,A01,083075,Gupta; Anjum,21,0,76,55
1657769003210,CSE 3,A50,083646,Miranda; Gregory Joseph,24,0,50,26
1657769009238,CSE 8A,A50,083650,Miranda; Gregory Joseph,17,1,56,39
1657769015263,CSE 11,A01,083080,Cao; Yingjun,6,15,40,34
1657769021287,CSE 12,A01,083652,Krause-Levy; Sophia Louisa,28,1,120,92
1657769027321,CSE 15L,A01,083654,Morris; Justin Loren,9,0,50,41
1657769027321,CSE 15L,A02,083655,Morris; Justin Loren,9,0,50,41
1657769033344,CSE 20,A01,083657,Tran; Khoa Dang,39,0,80,41
1657769039366,CSE 21,A01,095574,Bach; Quang Tran,22,0,48,26
1657769045389,CSE 30,A01,083084,Eldon; John,6,0,80,74
1657769045389,CSE 30,B01,095061,Bhaskar; Nishant,9,0,50,41
1657769051415,CSE 100,A01,083659,Cao; Yingjun,5,4,70,65
1657769057439,CSE 134B,A01,083661,Powell; Thomas Allan,24,0,100,76
1657769063463,CSE 140,A01,083663,Gungor; Onat,15,0,85,70
1657769069491,CSE 140L,A01,083088,Eldon; John,23,0,100,77
1657769075514,CSE 175,A01,083665,Kumar; Rakesh,3,0,25,22
1657769081539,CSE 190,A00,092507,Dubnov; Shlomo,8,0,20,12
1657769087563,ECE 45,A01,083139,Congero; Spencer William,6,0,75,69
1657769093589,ECE 65,A50,083695,Saad; Andrew S,12,0,30,18
1657769093589,ECE 65,A51,095125,Saad; Andrew S,24,0,26,2
1657769099612,ECE 109,A01,091882,Touri; Behrouz,20,0,70,50
1657769105638,ECE 180,A00,083140,Abi Samra; Nicholas Camill,1,0,30,29
1657769105638,ECE 180,B00,083141,Abi Samra; Nicholas Camill,0,0,30,30
1657769111665,MATH 10A,A01,083735,Patchell; Gregory David,2,0,30,28
1657769111665,MATH 10A,A02,083736,Patchell; Gregory David,20,0,30,10
1657769111665,MATH 10A,A03,083737,Patchell; Gregory David,16,0,30,14
1657769117692,MATH 10B,A01,083207,Lim; Seonhee,8,0,34,26
1657769117692,MATH 10B,A02,083208,Lim; Seonhee,9,0,35,26
1657769117692,MATH 10B,A03,093472,Lim; Seonhee,7,0,34,27
1657769117692,MATH 10B,B01,083739,Sinha; Shubham,13,0,30,17
1657769123717,MATH 18,A01,083743,Cinel; Cameron Alexander,9,0,30,21
1657769123717,MATH 18,A02,083744,Cinel; Cameron Alexander,18,0,30,12
1657769123717,MATH 18,A03,083745,Cinel; Cameron Alexander,10,0,30,20
1657769123717,MATH 18,B01,083748,Rideout; David Porter,5,0,37,32
1657769123717,MATH 18,B02,083749,Rideout; David Porter,5,0,36,31
1657769123717,MATH 18,B03,083750,Rideout; David Porter,3,0,37,34
1657769123717,MATH 18,B04,083751,Rideout; David Porter,6,0,36,30
1657769123717,MATH 18,B05,093473,Rideout; David Porter,6,0,36,30
1657769123717,MATH 18,B06,093474,Rideout; David Porter,6,0,36,30
1657769129743,MATH 20A,A01,083754,Zheng; Zequn,14,0,40,26
1657769135766,MATH 20B,A01,083756,Briones; Jor-el Thomas Caparas,4,0,36,32
1657769135766,MATH 20B,A02,083757,Briones; Jor-el Thomas Caparas,1,0,36,35
1657769135766,MATH 20B,A03,093475,Briones; Jor-el Thomas Caparas,2,0,36,34
1657769141792,MATH 20C,A01,083760,Briones; Jor-el Thomas Caparas,1,0,35,34
1657769141792,MATH 20C,A02,083761,Briones; Jor-el Thomas Caparas,8,0,35,27
1657769141792,MATH 20C,A03,093476,Briones; Jor-el Thomas Caparas,0,1,36,36
1657769141792,MATH 20C,B01,083762,Bach; Quang Tran,1,0,30,29
1657769147822,MATH 20D,A01,083765,Tran; Brian Kha,5,0,30,25
1657769147822,MATH 20D,A02,083766,Tran; Brian Kha,5,0,30,25
1657769147822,MATH 20D,A03,083767,Tran; Brian Kha,5,0,30,25
1657769153846,MATH 20E,A01,083771,Ganguly; Soumya,9,0,32,23
1657769153846,MATH 20E,A02,083772,Ganguly; Soumya,6,0,32,26
1657769153846,MATH 20E,B01,083773,Ciotti; Benjamin,20,0,35,15
1657769153846,MATH 20E,B02,083774,Ciotti; Benjamin,18,0,35,17
1657769159870,MATH 103A,A01,083777,Greenfeld; Be'Eri,3,0,36,33
1657769159870,MATH 103A,A02,083778,Greenfeld; Be'Eri,5,0,36,31
1657769159870,MATH 103A,A03,093561,Greenfeld; Be'Eri,6,0,36,30
1657769159870,MATH 103A,B01,083779,Greenfeld; Be'Eri,7,0,36,29
1657769159870,MATH 103A,B02,083780,Greenfeld; Be'Eri,4,0,36,32
1657769159870,MATH 103A,B03,093562,Greenfeld; Be'Eri,3,0,36,33
1657769165905,MATH 105,A01,085443,Carter; Anne Toulson,15,0,35,20
1657769165905,MATH 105,A02,093477,Carter; Anne Toulson,20,0,35,15
1657769171930,MATH 109,A01,083213,Ganzberger; Geoffrey Michael,3,0,34,31
1657769171930,MATH 109,A02,083214,Ganzberger; Geoffrey Michael,4,0,34,30
1657769171930,MATH 109,A03,093478,Ganzberger; Geoffrey Michael,2,0,34,32
1657769171930,MATH 109,B01,083215,Ganzberger; Geoffrey Michael,1,0,32,31
1657769171930,MATH 109,B02,083216,Ganzberger; Geoffrey Michael,2,0,32,30
1657769171930,MATH 109,B03,093479,Ganzberger; Geoffrey Michael,8,0,32,24
1657769177961,MATH 142A,A01,083219,Chow; Bennett,7,0,32,25
1657769177961,MATH 142A,A02,083220,Chow; Bennett,10,0,32,22
1657769177961,MATH 142A,A03,093480,Chow; Bennett,9,0,32,23
1657769177961,MATH 142A,B03,093481,Chow; Bennett,8,0,32,24
1657769177961,MATH 142A,B04,093558,Chow; Bennett,13,0,32,19
1657769177961,MATH 142A,B05,093559,Chow; Bennett,6,0,32,26
1657769183984,MATH 193A,A01,083224,Rotar; Vladimir,8,0,34,26
1657769183984,MATH 193A,A02,083225,Rotar; Vladimir,9,0,34,25
1657769183984,MATH 193A,A03,083781,Rotar; Vladimir,5,0,34,29
1657769183984,MATH 193A,A04,083782,Rotar; Vladimir,10,0,34,24
1657769183984,MATH 193A,A05,093482,Rotar; Vladimir,10,0,34,24
1657769190007,MATH 197,001,091859,McAuley; Julian John,9999,0,9999,0
1657769190007,MATH 197,002,095566,Kedlaya; Kiran S.,9997,0,9999,2
1657769190007,MATH 197,003,095567,Xiao; Ming,9999,0,9999,0
1657769190007,MATH 197,004,095571,Perols; Johan Lars,9998,0,9999,1
1657769197068,COGS 9,A01,083615,Shannon; Kyle Michael,9,0,75,66
1657769203095,COGS 11,A01,083617,Boyle; Mary E. T.,23,0,48,25
1657769209118,COGS 13,A01,083071,Bastos; Amalia Pinkusfeld,11,0,71,60
1657769215140,COGS 14A,A01,092681,Semenuks; Arturs,5,1,100,95
1657769221164,COGS 14B,A01,083073,Cheng; Tzu-Han,6,0,63,57
1657769227187,COGS 17,A01,092677,Semenuks; Arturs,6,0,81,75
1657769233209,COGS 100,A01,083619,Allen; Michael Gordon,17,0,70,53
1657769239233,COGS 101A,A01,083621,Davis; Joshua Daniel,9,0,68,59
1657769245259,COGS 101B,A01,091572,Allen; Michael Gordon,12,0,65,53
1657769251283,COGS 101C,A01,083625,Delgado; Tania,17,0,35,18
1657769257307,COGS 107A,A01,083627,Boyle; Mary E. T.,14,0,60,46
1657769263333,COGS 118A,A01,083075,Gupta; Anjum,21,0,76,55
1657769269363,CSE 3,A50,083646,Miranda; Gregory Joseph,24,0,50,26
1657769275391,CSE 8A,A50,083650,Miranda; Gregory Joseph,17,1,56,39
1657769281418,CSE 11,A01,083080,Cao; Yingjun,6,15,40,34
1657769287442,CSE 12,A01,083652,Krause-Levy; Sophia Louisa,28,1,120,92
1657769293464,CSE 15L,A01,083654,Morris; Justin Loren,9,0,50,41
1657769293464,CSE 15L,A02,083655,Morris; Justin Loren,9,0,50,41
1657769299488,CSE 20,A01,083657,Tran; Khoa Dang,39,0,80,41
1657769305516,CSE 21,A01,095574,Bach; Quang Tran,22,0,48,26
1657769311539,CSE 30,A01,083084,Eldon; John,6,0,80,74
1657769311539,CSE 30,B01,095061,Bhaskar; Nishant,9,0,50,41
1657769317565,CSE 100,A01,083659,Cao; Yingjun,5,4,70,65
1657769323591,CSE 134B,A01,083661,Powell; Thomas Allan,24,0,100,76
1657769329617,CSE 140,A01,083663,Gungor; Onat,15,0,85,70
1657769335638,CSE 140L,A01,083088,Eldon; John,23,0,100,77
1657769341661,CSE 175,A01,083665,Kumar; Rakesh,3,0,25,22
1657769347684,CSE 190,A00,092507,Dubnov; Shlomo,8,0,20,12
1657769353706,ECE 45,A01,083139,Congero; Spencer William,6,0,75,69
1657769359729,ECE 65,A50,083695,Saad; Andrew S,12,0,30,18
1657769359729,ECE 65,A51,095125,Saad; Andrew S,24,0,26,2
1657769365753,ECE 109,A01,091882,Touri; Behrouz,20,0,70,50
1657769371783,ECE 180,A00,083140,Abi Samra; Nicholas Camill,1,0,30,29
1657769371783,ECE 180,B00,083141,Abi Samra; Nicholas Camill,0,0,30,30
1657769377809,MATH 10A,A01,083735,Patchell; Gregory David,2,0,30,28
1657769377809,MATH 10A,A02,083736,Patchell; Gregory David,20,0,30,10
1657769377809,MATH 10A,A03,083737,Patchell; Gregory David,16,0,30,14
1657769383840,MATH 10B,A01,083207,Lim; Seonhee,8,0,34,26
1657769383840,MATH 10B,A02,083208,Lim; Seonhee,9,0,35,26
1657769383840,MATH 10B,A03,093472,Lim; Seonhee,7,0,34,27
1657769383840,MATH 10B,B01,083739,Sinha; Shubham,13,0,30,17
1657769389865,MATH 18,A01,083743,Cinel; Cameron Alexander,9,0,30,21
1657769389865,MATH 18,A02,083744,Cinel; Cameron Alexander,18,0,30,12
1657769389865,MATH 18,A03,083745,Cinel; Cameron Alexander,10,0,30,20
1657769389865,MATH 18,B01,083748,Rideout; David Porter,5,0,37,32
1657769389865,MATH 18,B02,083749,Rideout; David Porter,5,0,36,31
1657769389865,MATH 18,B03,083750,Rideout; David Porter,3,0,37,34
1657769389865,MATH 18,B04,083751,Rideout; David Porter,6,0,36,30
1657769389865,MATH 18,B05,093473,Rideout; David Porter,6,0,36,30
1657769389865,MATH 18,B06,093474,Rideout; David Porter,6,0,36,30
1657769395901,MATH 20A,A01,083754,Zheng; Zequn,14,0,40,26
1657769401928,MATH 20B,A01,083756,Briones; Jor-el Thomas Caparas,4,0,36,32
1657769401928,MATH 20B,A02,083757,Briones; Jor-el Thomas Caparas,1,0,36,35
1657769401928,MATH 20B,A03,093475,Briones; Jor-el Thomas Caparas,2,0,36,34
1657769407951,MATH 20C,A01,083760,Briones; Jor-el Thomas Caparas,1,0,35,34
1657769407951,MATH 20C,A02,083761,Briones; Jor-el Thomas Caparas,8,0,35,27
1657769407951,MATH 20C,A03,093476,Briones; Jor-el Thomas Caparas,0,1,36,36
1657769407951,MATH 20C,B01,083762,Bach; Quang Tran,1,0,30,29
1657769413985,MATH 20D,A01,083765,Tran; Brian Kha,5,0,30,25
1657769413985,MATH 20D,A02,083766,Tran; Brian Kha,5,0,30,25
1657769413985,MATH 20D,A03,083767,Tran; Brian Kha,5,0,30,25
1657769420009,MATH 20E,A01,083771,Ganguly; Soumya,9,0,32,23
1657769420009,MATH 20E,A02,083772,Ganguly; Soumya,6,0,32,26
1657769420009,MATH 20E,B01,083773,Ciotti; Benjamin,20,0,35,15
1657769420009,MATH 20E,B02,083774,Ciotti; Benjamin,18,0,35,17
1657769426033,MATH 103A,A01,083777,Greenfeld; Be'Eri,3,0,36,33
1657769426033,MATH 103A,A02,083778,Greenfeld; Be'Eri,5,0,36,31
1657769426033,MATH 103A,A03,093561,Greenfeld; Be'Eri,6,0,36,30
1657769426033,MATH 103A,B01,083779,Greenfeld; Be'Eri,7,0,36,29
1657769426033,MATH 103A,B02,083780,Greenfeld; Be'Eri,4,0,36,32
1657769426033,MATH 103A,B03,093562,Greenfeld; Be'Eri,3,0,36,33
1657769432127,MATH 105,A01,085443,Carter; Anne Toulson,15,0,35,20
1657769432127,MATH 105,A02,093477,Carter; Anne Toulson,20,0,35,15
1657769438150,MATH 109,A01,083213,Ganzberger; Geoffrey Michael,3,0,34,31
1657769438150,MATH 109,A02,083214,Ganzberger; Geoffrey Michael,4,0,34,30
1657769438150,MATH 109,A03,093478,Ganzberger; Geoffrey Michael,2,0,34,32
1657769438150,MATH 109,B01,083215,Ganzberger; Geoffrey Michael,1,0,32,31
1657769438150,MATH 109,B02,083216,Ganzberger; Geoffrey Michael,2,0,32,30
1657769438150,MATH 109,B03,093479,Ganzberger; Geoffrey Michael,8,0,32,24
1657769444175,MATH 142A,A01,083219,Chow; Bennett,7,0,32,25
1657769444175,MATH 142A,A02,083220,Chow; Bennett,10,0,32,22
1657769444175,MATH 142A,A03,093480,Chow; Bennett,9,0,32,23
1657769444175,MATH 142A,B03,093481,Chow; Bennett,8,0,32,24
1657769444175,MATH 142A,B04,093558,Chow; Bennett,13,0,32,19
1657769444175,MATH 142A,B05,093559,Chow; Bennett,6,0,32,26
1657769450203,MATH 193A,A01,083224,Rotar; Vladimir,8,0,34,26
1657769450203,MATH 193A,A02,083225,Rotar; Vladimir,9,0,34,25
1657769450203,MATH 193A,A03,083781,Rotar; Vladimir,5,0,34,29
1657769450203,MATH 193A,A04,083782,Rotar; Vladimir,10,0,34,24
1657769450203,MATH 193A,A05,093482,Rotar; Vladimir,10,0,34,24
1657769456225,MATH 197,001,091859,McAuley; Julian John,9999,0,9999,0
1657769456225,MATH 197,002,095566,Kedlaya; Kiran S.,9997,0,9999,2
1657769456225,MATH 197,003,095567,Xiao; Ming,9999,0,9999,0
1657769456225,MATH 197,004,095571,Perols; Johan Lars,9998,0,9999,1
1657769463276,COGS 9,A01,083615,Shannon; Kyle Michael,9,0,75,66
1657769469306,COGS 11,A01,083617,Boyle; Mary E. T.,23,0,48,25
1657769475331,COGS 13,A01,083071,Bastos; Amalia Pinkusfeld,11,0,71,60
1657769481357,COGS 14A,A01,092681,Semenuks; Arturs,5,1,100,95
1657769487383,COGS 14B,A01,083073,Cheng; Tzu-Han,6,0,63,57
1657769493406,COGS 17,A01,092677,Semenuks; Arturs,6,0,81,75
1657769499431,COGS 100,A01,083619,Allen; Michael Gordon,17,0,70,53
1657769505456,COGS 101A,A01,083621,Davis; Joshua Daniel,9,0,68,59
1657769511480,COGS 101B,A01,091572,Allen; Michael Gordon,12,0,65,53
1657769517509,COGS 101C,A01,083625,Delgado; Tania,17,0,35,18
1657769523539,COGS 107A,A01,083627,Boyle; Mary E. T.,14,0,60,46
1657769529566,COGS 118A,A01,083075,Gupta; Anjum,21,0,76,55
1657769535589,CSE 3,A50,083646,Miranda; Gregory Joseph,24,0,50,26
1657769541614,CSE 8A,A50,083650,Miranda; Gregory Joseph,17,1,56,39
1657769547642,CSE 11,A01,083080,Cao; Yingjun,6,15,40,34
1657769553668,CSE 12,A01,083652,Krause-Levy; Sophia Louisa,28,1,120,92
1657769559701,CSE 15L,A01,083654,Morris; Justin Loren,9,0,50,41
1657769559701,CSE 15L,A02,083655,Morris; Justin Loren,9,0,50,41
1657769565723,CSE 20,A01,083657,Tran; Khoa Dang,39,0,80,41
1657769571746,CSE 21,A01,095574,Bach; Quang Tran,22,0,48,26
1657769577768,CSE 30,A01,083084,Eldon; John,6,0,80,74
1657769577768,CSE 30,B01,095061,Bhaskar; Nishant,9,0,50,41
1657769583793,CSE 100,A01,083659,Cao; Yingjun,5,4,70,65
1657769589816,CSE 134B,A01,083661,Powell; Thomas Allan,24,0,100,76
1657769595839,CSE 140,A01,083663,Gungor; Onat,15,0,85,70
1657769601861,CSE 140L,A01,083088,Eldon; John,23,0,100,77
1657769607890,CSE 175,A01,083665,Kumar; Rakesh,3,0,25,22
1657769613913,CSE 190,A00,092507,Dubnov; Shlomo,8,0,20,12
1657769619938,ECE 45,A01,083139,Congero; Spencer William,6,0,75,69
1657769625962,ECE 65,A50,083695,Saad; Andrew S,12,0,30,18
1657769625962,ECE 65,A51,095125,Saad; Andrew S,24,0,26,2
1657769631985,ECE 109,A01,091882,Touri; Behrouz,20,0,70,50
1657769638009,ECE 180,A00,083140,Abi Samra; Nicholas Camill,1,0,30,29
1657769638009,ECE 180,B00,083141,Abi Samra; Nicholas Camill,0,0,30,30
1657769644033,MATH 10A,A01,083735,Patchell; Gregory David,2,0,30,28
1657769644033,MATH 10A,A02,083736,Patchell; Gregory David,20,0,30,10
1657769644033,MATH 10A,A03,083737,Patchell; Gregory David,16,0,30,14
1657769650056,MATH 10B,A01,083207,Lim; Seonhee,8,0,34,26
1657769650056,MATH 10B,A02,083208,Lim; Seonhee,9,0,35,26
1657769650056,MATH 10B,A03,093472,Lim; Seonhee,7,0,34,27
1657769650056,MATH 10B,B01,083739,Sinha; Shubham,13,0,30,17
1657769656092,MATH 18,A01,083743,Cinel; Cameron Alexander,9,0,30,21
1657769656092,MATH 18,A02,083744,Cinel; Cameron Alexander,18,0,30,12
1657769656092,MATH 18,A03,083745,Cinel; Cameron Alexander,10,0,30,20
1657769656092,MATH 18,B01,083748,Rideout; David Porter,5,0,37,32
1657769656092,MATH 18,B02,083749,Rideout; David Porter,5,0,36,31
1657769656092,MATH 18,B03,083750,Rideout; David Porter,3,0,37,34
1657769656092,MATH 18,B04,083751,Rideout; David Porter,6,0,36,30
1657769656092,MATH 18,B05,093473,Rideout; David Porter,6,0,36,30
1657769656092,MATH 18,B06,093474,Rideout; David Porter,6,0,36,30
1657769662119,MATH 20A,A01,083754,Zheng; Zequn,14,0,40,26
1657769668142,MATH 20B,A01,083756,Briones; Jor-el Thomas Caparas,4,0,36,32
1657769668142,MATH 20B,A02,083757,Briones; Jor-el Thomas Caparas,1,0,36,35
1657769668142,MATH 20B,A03,093475,Briones; Jor-el Thomas Caparas,2,0,36,34
1657769674165,MATH 20C,A01,083760,Briones; Jor-el Thomas Caparas,1,0,35,34
1657769674165,MATH 20C,A02,083761,Briones; Jor-el Thomas Caparas,8,0,35,27
1657769674165,MATH 20C,A03,093476,Briones; Jor-el Thomas Caparas,0,1,36,36
1657769674165,MATH 20C,B01,083762,Bach; Quang Tran,1,0,30,29
1657769680192,MATH 20D,A01,083765,Tran; Brian Kha,5,0,30,25
1657769680192,MATH 20D,A02,083766,Tran; Brian Kha,5,0,30,25
1657769680192,MATH 20D,A03,083767,Tran; Brian Kha,5,0,30,25
1657769686221,MATH 20E,A01,083771,Ganguly; Soumya,9,0,32,23
1657769686221,MATH 20E,A02,083772,Ganguly; Soumya,6,0,32,26
1657769686221,MATH 20E,B01,083773,Ciotti; Benjamin,20,0,35,15
1657769686221,MATH 20E,B02,083774,Ciotti; Benjamin,18,0,35,17
1657769692251,MATH 103A,A01,083777,Greenfeld; Be'Eri,3,0,36,33
1657769692251,MATH 103A,A02,083778,Greenfeld; Be'Eri,5,0,36,31
1657769692251,MATH 103A,A03,093561,Greenfeld; Be'Eri,6,0,36,30
1657769692251,MATH 103A,B01,083779,Greenfeld; Be'Eri,7,0,36,29
1657769692251,MATH 103A,B02,083780,Greenfeld; Be'Eri,4,0,36,32
1657769692251,MATH 103A,B03,093562,Greenfeld; Be'Eri,3,0,36,33
1657769698289,MATH 105,A01,085443,Carter; Anne Toulson,15,0,35,20
1657769698289,MATH 105,A02,093477,Carter; Anne Toulson,20,0,35,15
1657769704323,MATH 109,A01,083213,Ganzberger; Geoffrey Michael,3,0,34,31
1657769704323,MATH 109,A02,083214,Ganzberger; Geoffrey Michael,4,0,34,30
1657769704323,MATH 109,A03,093478,Ganzberger; Geoffrey Michael,2,0,34,32
1657769704323,MATH 109,B01,083215,Ganzberger; Geoffrey Michael,1,0,32,31
1657769704323,MATH 109,B02,083216,Ganzberger; Geoffrey Michael,2,0,32,30
1657769704323,MATH 109,B03,093479,Ganzberger; Geoffrey Michael,8,0,32,24
1657769710350,MATH 142A,A01,083219,Chow; Bennett,7,0,32,25
1657769710350,MATH 142A,A02,083220,Chow; Bennett,10,0,32,22
1657769710350,MATH 142A,A03,093480,Chow; Bennett,9,0,32,23
1657769710350,MATH 142A,B03,093481,Chow; Bennett,8,0,32,24
1657769710350,MATH 142A,B04,093558,Chow; Bennett,13,0,32,19
1657769710350,MATH 142A,B05,093559,Chow; Bennett,6,0,32,26
1657769716375,MATH 193A,A01,083224,Rotar; Vladimir,8,0,34,26
1657769716375,MATH 193A,A02,083225,Rotar; Vladimir,9,0,34,25
1657769716375,MATH 193A,A03,083781,Rotar; Vladimir,5,0,34,29
1657769716375,MATH 193A,A04,083782,Rotar; Vladimir,10,0,34,24
1657769716375,MATH 193A,A05,093482,Rotar; Vladimir,10,0,34,24
1657769722404,MATH 197,001,091859,McAuley; Julian John,9999,0,9999,0
1657769722404,MATH 197,002,095566,Kedlaya; Kiran S.,9997,0,9999,2
1657769722404,MATH 197,003,095567,Xiao; Ming,9999,0,9999,0
1657769722404,MATH 197,004,095571,Perols; Johan Lars,9998,0,9999,1
1657769729459,COGS 9,A01,083615,Shannon; Kyle Michael,9,0,75,66
1657769735481,COGS 11,A01,083617,Boyle; Mary E. T.,23,0,48,25
1657769741511,COGS 13,A01,083071,Bastos; Amalia Pinkusfeld,11,0,71,60
1657769747534,COGS 14A,A01,092681,Semenuks; Arturs,5,1,100,95
1657769753561,COGS 14B,A01,083073,Cheng; Tzu-Han,6,0,63,57
1657769759584,COGS 17,A01,092677,Semenuks; Arturs,6,0,81,75
1657769765609,COGS 100,A01,083619,Allen; Michael Gordon,17,0,70,53
1657769771635,COGS 101A,A01,083621,Davis; Joshua Daniel,9,0,68,59
1657769777656,COGS 101B,A01,091572,Allen; Michael Gordon,12,0,65,53
1657769783712,COGS 101C,A01,083625,Delgado; Tania,17,0,35,18
1657769789735,COGS 107A,A01,083627,Boyle; Mary E. T.,14,0,60,46
1657769795758,COGS 118A,A01,083075,Gupta; Anjum,21,0,76,55
1657769801782,CSE 3,A50,083646,Miranda; Gregory Joseph,24,0,50,26
1657769807811,CSE 8A,A50,083650,Miranda; Gregory Joseph,17,1,56,39
1657769813842,CSE 11,A01,083080,Cao; Yingjun,6,15,40,34
1657769819872,CSE 12,A01,083652,Krause-Levy; Sophia Louisa,28,1,120,92
1657769825899,CSE 15L,A01,083654,Morris; Justin Loren,9,0,50,41
1657769825899,CSE 15L,A02,083655,Morris; Justin Loren,9,0,50,41
1657769831927,CSE 20,A01,083657,Tran; Khoa Dang,39,0,80,41
1657769837954,CSE 21,A01,095574,Bach; Quang Tran,22,0,48,26
1657769843982,CSE 30,A01,083084,Eldon; John,6,0,80,74
1657769843982,CSE 30,B01,095061,Bhaskar; Nishant,9,0,50,41
1657769850005,CSE 100,A01,083659,Cao; Yingjun,5,4,70,65
1657769856033,CSE 134B,A01,083661,Powell; Thomas Allan,24,0,100,76
1657769862059,CSE 140,A01,083663,Gungor; Onat,15,0,85,70
1657769868085,CSE 140L,A01,083088,Eldon; John,23,0,100,77
1657769874112,CSE 175,A01,083665,Kumar; Rakesh,3,0,25,22
1657769880137,CSE 190,A00,092507,Dubnov; Shlomo,8,0,20,12
1657769886159,ECE 45,A01,083139,Congero; Spencer William,6,0,75,69
1657769892181,ECE 65,A50,083695,Saad; Andrew S,12,0,30,18
1657769892181,ECE 65,A51,095125,Saad; Andrew S,24,0,26,2
1657769898202,ECE 109,A01,091882,Touri; Behrouz,20,0,70,50
1657769904230,ECE 180,A00,083140,Abi Samra; Nicholas Camill,1,0,30,29
1657769904230,ECE 180,B00,083141,Abi Samra; Nicholas Camill,0,0,30,30
1657769910258,MATH 10A,A01,083735,Patchell; Gregory David,2,0,30,28
1657769910258,MATH 10A,A02,083736,Patchell; Gregory David,20,0,30,10
1657769910258,MATH 10A,A03,083737,Patchell; Gregory David,16,0,30,14
1657769916282,MATH 10B,A01,083207,Lim; Seonhee,8,0,34,26
1657769916282,MATH 10B,A02,083208,Lim; Seonhee,9,0,35,26
1657769916282,MATH 10B,A03,093472,Lim; Seonhee,7,0,34,27
1657769916282,MATH 10B,B01,083739,Sinha; Shubham,13,0,30,17
1657769922321,MATH 18,A01,083743,Cinel; Cameron Alexander,9,0,30,21
1657769922321,MATH 18,A02,083744,Cinel; Cameron Alexander,18,0,30,12
1657769922321,MATH 18,A03,083745,Cinel; Cameron Alexander,10,0,30,20
1657769922321,MATH 18,B01,083748,Rideout; David Porter,5,0,37,32
1657769922321,MATH 18,B02,083749,Rideout; David Porter,5,0,36,31
1657769922321,MATH 18,B03,083750,Rideout; David Porter,3,0,37,34
1657769922321,MATH 18,B04,083751,Rideout; David Porter,6,0,36,30
1657769922321,MATH 18,B05,093473,Rideout; David Porter,6,0,36,30
1657769922321,MATH 18,B06,093474,Rideout; David Porter,6,0,36,30
1657769928348,MATH 20A,A01,083754,Zheng; Zequn,14,0,40,26
1657769934372,MATH 20B,A01,083756,Briones; Jor-el Thomas Caparas,4,0,36,32
1657769934372,MATH 20B,A02,083757,Briones; Jor-el Thomas Caparas,1,0,36,35
1657769934372,MATH 20B,A03,093475,Briones; Jor-el Thomas Caparas,2,0,36,34
1657769940394,MATH 20C,A01,083760,Briones; Jor-el Thomas Caparas,1,0,35,34
1657769940394,MATH 20C,A02,083761,Briones; Jor-el Thomas Caparas,8,0,35,27
1657769940394,MATH 20C,A03,093476,Briones; Jor-el Thomas Caparas,0,1,36,36
1657769940394,MATH 20C,B01,083762,Bach; Quang Tran,1,0,30,29
1657769946423,MATH 20D,A01,083765,Tran; Brian Kha,5,0,30,25
1657769946423,MATH 20D,A02,083766,Tran; Brian Kha,5,0,30,25
1657769946423,MATH 20D,A03,083767,Tran; Brian Kha,5,0,30,25
1657769952447,MATH 20E,A01,083771,Ganguly; Soumya,9,0,32,23
1657769952447,MATH 20E,A02,083772,Ganguly; Soumya,6,0,32,26
1657769952447,MATH 20E,B01,083773,Ciotti; Benjamin,20,0,35,15
1657769952447,MATH 20E,B02,083774,Ciotti; Benjamin,18,0,35,17
1657769958476,MATH 103A,A01,083777,Greenfeld; Be'Eri,3,0,36,33
1657769958476,MATH 103A,A02,083778,Greenfeld; Be'Eri,5,0,36,31
1657769958476,MATH 103A,A03,093561,Greenfeld; Be'Eri,6,0,36,30
1657769958476,MATH 103A,B01,083779,Greenfeld; Be'Eri,7,0,36,29
1657769958476,MATH 103A,B02,083780,Greenfeld; Be'Eri,4,0,36,32
1657769958476,MATH 103A,B03,093562,Greenfeld; Be'Eri,3,0,36,33
1657769964500,MATH 105,A01,085443,Carter; Anne Toulson,15,0,35,20
1657769964500,MATH 105,A02,093477,Carter; Anne Toulson,20,0,35,15
1657769970528,MATH 109,A01,083213,Ganzberger; Geoffrey Michael,3,0,34,31
1657769970528,MATH 109,A02,083214,Ganzberger; Geoffrey Michael,4,0,34,30
1657769970528,MATH 109,A03,093478,Ganzberger; Geoffrey Michael,2,0,34,32
1657769970528,MATH 109,B01,083215,Ganzberger; Geoffrey Michael,1,0,32,31
1657769970528,MATH 109,B02,083216,Ganzberger; Geoffrey Michael,2,0,32,30
1657769970528,MATH 109,B03,093479,Ganzberger; Geoffrey Michael,8,0,32,24
1657769976553,MATH 142A,A01,083219,Chow; Bennett,7,0,32,25
1657769976553,MATH 142A,A02,083220,Chow; Bennett,10,0,32,22
1657769976553,MATH 142A,A03,093480,Chow; Bennett,9,0,32,23
1657769976553,MATH 142A,B03,093481,Chow; Bennett,8,0,32,24
1657769976553,MATH 142A,B04,093558,Chow; Bennett,13,0,32,19
1657769976553,MATH 142A,B05,093559,Chow; Bennett,6,0,32,26
1657769982577,MATH 193A,A01,083224,Rotar; Vladimir,8,0,34,26
1657769982577,MATH 193A,A02,083225,Rotar; Vladimir,9,0,34,25
1657769982577,MATH 193A,A03,083781,Rotar; Vladimir,5,0,34,29
1657769982577,MATH 193A,A04,083782,Rotar; Vladimir,10,0,34,24
1657769982577,MATH 193A,A05,093482,Rotar; Vladimir,10,0,34,24
1657769988603,MATH 197,001,091859,McAuley; Julian John,9999,0,9999,0
1657769988603,MATH 197,002,095566,Kedlaya; Kiran S.,9997,0,9999,2
1657769988603,MATH 197,003,095567,Xiao; Ming,9999,0,9999,0
1657769988603,MATH 197,004,095571,Perols; Johan Lars,9998,0,9999,1
1657769995655,COGS 9,A01,083615,Shannon; Kyle Michael,9,0,75,66
1657770001680,COGS 11,A01,083617,Boyle; Mary E. T.,23,0,48,25
1657770007703,COGS 13,A01,083071,Bastos; Amalia Pinkusfeld,11,0,71,60
1657770013725,COGS 14A,A01,092681,Semenuks; Arturs,5,1,100,95
1657770019749,COGS 14B,A01,083073,Cheng; Tzu-Han,6,0,63,57
1657770025848,COGS 17,A01,092677,Semenuks; Arturs,6,0,81,75
1657770031877,COGS 100,A01,083619,Allen; Michael Gordon,17,0,70,53
1657770037916,COGS 101A,A01,083621,Davis; Joshua Daniel,9,0,68,59
1657770043947,COGS 101B,A01,091572,Allen; Michael Gordon,12,0,65,53
1657770049977,COGS 101C,A01,083625,Delgado; Tania,17,0,35,18
1657770056001,COGS 107A,A01,083627,Boyle; Mary E. T.,14,0,60,46
1657770062029,COGS 118A,A01,083075,Gupta; Anjum,21,0,76,55
1657770068056,CSE 3,A50,083646,Miranda; Gregory Joseph,24,0,50,26
1657770074082,CSE 8A,A50,083650,Miranda; Gregory Joseph,17,1,56,39
1657770080105,CSE 11,A01,083080,Cao; Yingjun,6,15,40,34
1657770086128,CSE 12,A01,083652,Krause-Levy; Sophia Louisa,28,1,120,92
1657770092153,CSE 15L,A01,083654,Morris; Justin Loren,9,0,50,41
1657770092153,CSE 15L,A02,083655,Morris; Justin Loren,9,0,50,41
1657770098180,CSE 20,A01,083657,Tran; Khoa Dang,39,0,80,41
1657770104203,CSE 21,A01,095574,Bach; Quang Tran,22,0,48,26
1657770110227,CSE 30,A01,083084,Eldon; John,6,0,80,74
1657770110227,CSE 30,B01,095061,Bhaskar; Nishant,9,0,50,41
1657770116258,CSE 100,A01,083659,Cao; Yingjun,5,4,70,65
1657770122280,CSE 134B,A01,083661,Powell; Thomas Allan,24,0,100,76
1657770128306,CSE 140,A01,083663,Gungor; Onat,15,0,85,70
1657770134329,CSE 140L,A01,083088,Eldon; John,23,0,100,77
1657770140353,CSE 175,A01,083665,Kumar; Rakesh,3,0,25,22
1657770146374,CSE 190,A00,092507,Dubnov; Shlomo,8,0,20,12
1657770152401,ECE 45,A01,083139,Congero; Spencer William,6,0,75,69
1657770158430,ECE 65,A50,083695,Saad; Andrew S,12,0,30,18
1657770158430,ECE 65,A51,095125,Saad; Andrew S,24,0,26,2
1657770164455,ECE 109,A01,091882,Touri; Behrouz,20,0,70,50
1657770170478,ECE 180,A00,083140,Abi Samra; Nicholas Camill,1,0,30,29
1657770170478,ECE 180,B00,083141,Abi Samra; Nicholas Camill,0,0,30,30
1657770176513,MATH 10A,A01,083735,Patchell; Gregory David,2,0,30,28
1657770176513,MATH 10A,A02,083736,Patchell; Gregory David,20,0,30,10
1657770176513,MATH 10A,A03,083737,Patchell; Gregory David,16,0,30,14
1657770182543,MATH 10B,A01,083207,Lim; Seonhee,8,0,34,26
1657770182543,MATH 10B,A02,083208,Lim; Seonhee,9,0,35,26
1657770182543,MATH 10B,A03,093472,Lim; Seonhee,7,0,34,27
1657770182543,MATH 10B,B01,083739,Sinha; Shubham,13,0,30,17
1657770188569,MATH 18,A01,083743,Cinel; Cameron Alexander,9,0,30,21
1657770188569,MATH 18,A02,083744,Cinel; Cameron Alexander,18,0,30,12
1657770188569,MATH 18,A03,083745,Cinel; Cameron Alexander,10,0,30,20
1657770188569,MATH 18,B01,083748,Rideout; David Porter,5,0,37,32
1657770188569,MATH 18,B02,083749,Rideout; David Porter,5,0,36,31
1657770188569,MATH 18,B03,083750,Rideout; David Porter,3,0,37,34
1657770188569,MATH 18,B04,083751,Rideout; David Porter,6,0,36,30
1657770188569,MATH 18,B05,093473,Rideout; David Porter,6,0,36,30
1657770188569,MATH 18,B06,093474,Rideout; David Porter,6,0,36,30
1657770194597,MATH 20A,A01,083754,Zheng; Zequn,14,0,40,26
1657770200619,MATH 20B,A01,083756,Briones; Jor-el Thomas Caparas,4,0,36,32
1657770200619,MATH 20B,A02,083757,Briones; Jor-el Thomas Caparas,1,0,36,35
1657770200619,MATH 20B,A03,093475,Briones; Jor-el Thomas Caparas,2,0,36,34
1657770206648,MATH 20C,A01,083760,Briones; Jor-el Thomas Caparas,1,0,35,34
1657770206648,MATH 20C,A02,083761,Briones; Jor-el Thomas Caparas,8,0,35,27
1657770206648,MATH 20C,A03,093476,Briones; Jor-el Thomas Caparas,0,1,36,36
1657770206648,MATH 20C,B01,083762,Bach; Quang Tran,1,0,30,29
1657770212675,MATH 20D,A01,083765,Tran; Brian Kha,5,0,30,25
1657770212675,MATH 20D,A02,083766,Tran; Brian Kha,5,0,30,25
1657770212675,MATH 20D,A03,083767,Tran; Brian Kha,5,0,30,25
1657770218698,MATH 20E,A01,083771,Ganguly; Soumya,9,0,32,23
1657770218698,MATH 20E,A02,083772,Ganguly; Soumya,6,0,32,26
1657770218698,MATH 20E,B01,083773,Ciotti; Benjamin,20,0,35,15
1657770218698,MATH 20E,B02,083774,Ciotti; Benjamin,18,0,35,17
1657770224726,MATH 103A,A01,083777,Greenfeld; Be'Eri,3,0,36,33
1657770224726,MATH 103A,A02,083778,Greenfeld; Be'Eri,5,0,36,31
1657770224726,MATH 103A,A03,093561,Greenfeld; Be'Eri,6,0,36,30
1657770224726,MATH 103A,B01,083779,Greenfeld; Be'Eri,7,0,36,29
1657770224726,MATH 103A,B02,083780,Greenfeld; Be'Eri,4,0,36,32
1657770224726,MATH 103A,B03,093562,Greenfeld; Be'Eri,3,0,36,33
1657770230749,MATH 105,A01,085443,Carter; Anne Toulson,15,0,35,20
1657770230749,MATH 105,A02,093477,Carter; Anne Toulson,20,0,35,15
1657770236773,MATH 109,A01,083213,Ganzberger; Geoffrey Michael,3,0,34,31
1657770236773,MATH 109,A02,083214,Ganzberger; Geoffrey Michael,4,0,34,30
1657770236773,MATH 109,A03,093478,Ganzberger; Geoffrey Michael,2,0,34,32
1657770236773,MATH 109,B01,083215,Ganzberger; Geoffrey Michael,1,0,32,31
1657770236773,MATH 109,B02,083216,Ganzberger; Geoffrey Michael,2,0,32,30
1657770236773,MATH 109,B03,093479,Ganzberger; Geoffrey Michael,8,0,32,24
1657770242802,MATH 142A,A01,083219,Chow; Bennett,7,0,32,25
1657770242802,MATH 142A,A02,083220,Chow; Bennett,10,0,32,22
1657770242802,MATH 142A,A03,093480,Chow; Bennett,9,0,32,23
1657770242802,MATH 142A,B03,093481,Chow; Bennett,8,0,32,24
1657770242802,MATH 142A,B04,093558,Chow; Bennett,13,0,32,19
1657770242802,MATH 142A,B05,093559,Chow; Bennett,6,0,32,26
1657770248824,MATH 193A,A01,083224,Rotar; Vladimir,8,0,34,26
1657770248824,MATH 193A,A02,083225,Rotar; Vladimir,9,0,34,25
1657770248824,MATH 193A,A03,083781,Rotar; Vladimir,5,0,34,29
1657770248824,MATH 193A,A04,083782,Rotar; Vladimir,10,0,34,24
1657770248824,MATH 193A,A05,093482,Rotar; Vladimir,10,0,34,24
1657770254856,MATH 197,001,091859,McAuley; Julian John,9999,0,9999,0
1657770254856,MATH 197,002,095566,Kedlaya; Kiran S.,9997,0,9999,2
1657770254856,MATH 197,003,095567,Xiao; Ming,9999,0,9999,0
1657770254856,MATH 197,004,095571,Perols; Johan Lars,9998,0,9999,1
1657770261915,COGS 9,A01,083615,Shannon; Kyle Michael,9,0,75,66
1657770267942,COGS 11,A01,083617,Boyle; Mary E. T.,23,0,48,25
1657770273969,COGS 13,A01,083071,Bastos; Amalia Pinkusfeld,11,0,71,60
1657770279995,COGS 14A,A01,092681,Semenuks; Arturs,5,1,100,95
1657770286018,COGS 14B,A01,083073,Cheng; Tzu-Han,6,0,63,57
1657770292042,COGS 17,A01,092677,Semenuks; Arturs,6,0,81,75
1657770298065,COGS 100,A01,083619,Allen; Michael Gordon,17,0,70,53
1657770304089,COGS 101A,A01,083621,Davis; Joshua Daniel,9,0,68,59
1657770310114,COGS 101B,A01,091572,Allen; Michael Gordon,12,0,65,53
1657770316140,COGS 101C,A01,083625,Delgado; Tania,17,0,35,18
1657770322163,COGS 107A,A01,083627,Boyle; Mary E. T.,14,0,60,46
1657770328190,COGS 118A,A01,083075,Gupta; Anjum,21,0,76,55
1657770334214,CSE 3,A50,083646,Miranda; Gregory Joseph,24,0,50,26
1657770340237,CSE 8A,A50,083650,Miranda; Gregory Joseph,17,1,56,39
1657770346259,CSE 11,A01,083080,Cao; Yingjun,6,15,40,34
1657770352282,CSE 12,A01,083652,Krause-Levy; Sophia Louisa,28,1,120,92
1657770358308,CSE 15L,A01,083654,Morris; Justin Loren,9,0,50,41
1657770358308,CSE 15L,A02,083655,Morris; Justin Loren,9,0,50,41
1657770364336,CSE 20,A01,083657,Tran; Khoa Dang,39,0,80,41
1657770370359,CSE 21,A01,095574,Bach; Quang Tran,22,0,48,26
1657770376381,CSE 30,A01,083084,Eldon; John,6,0,80,74
1657770376381,CSE 30,B01,095061,Bhaskar; Nishant,9,0,50,41
1657770382403,CSE 100,A01,083659,Cao; Yingjun,5,4,70,65
1657770388425,CSE 134B,A01,083661,Powell; Thomas Allan,24,0,100,76
1657770394453,CSE 140,A01,083663,Gungor; Onat,15,0,85,70
1657770400479,CSE 140L,A01,083088,Eldon; John,23,0,100,77
1657770406504,CSE 175,A01,083665,Kumar; Rakesh,3,0,25,22
1657770412526,CSE 190,A00,092507,Dubnov; Shlomo,8,0,20,12
1657770418549,ECE 45,A01,083139,Congero; Spencer William,6,0,75,69
1657770424571,ECE 65,A50,083695,Saad; Andrew S,12,0,30,18
1657770424571,ECE 65,A51,095125,Saad; Andrew S,24,0,26,2
1657770430599,ECE 109,A01,091882,Touri; Behrouz,20,0,70,50
1657770436623,ECE 180,A00,083140,Abi Samra; Nicholas Camill,1,0,30,29
1657770436623,ECE 180,B00,083141,Abi Samra; Nicholas Camill,0,0,30,30
1657770442650,MATH 10A,A01,083735,Patchell; Gregory David,2,0,30,28
1657770442650,MATH 10A,A02,083736,Patchell; Gregory David,20,0,30,10
1657770442650,MATH 10A,A03,083737,Patchell; Gregory David,16,0,30,14
1657770448680,MATH 10B,A01,083207,Lim; Seonhee,8,0,34,26
1657770448680,MATH 10B,A02,083208,Lim; Seonhee,9,0,35,26
1657770448680,MATH 10B,A03,093472,Lim; Seonhee,7,0,34,27
1657770448680,MATH 10B,B01,083739,Sinha; Shubham,13,0,30,17
1657770454711,MATH 18,A01,083743,Cinel; Cameron Alexander,9,0,30,21
1657770454711,MATH 18,A02,083744,Cinel; Cameron Alexander,18,0,30,12
1657770454711,MATH 18,A03,083745,Cinel; Cameron Alexander,10,0,30,20
1657770454711,MATH 18,B01,083748,Rideout; David Porter,5,0,37,32
1657770454711,MATH 18,B02,083749,Rideout; David Porter,5,0,36,31
1657770454711,MATH 18,B03,083750,Rideout; David Porter,3,0,37,34
1657770454711,MATH 18,B04,083751,Rideout; David Porter,6,0,36,30
1657770454711,MATH 18,B05,093473,Rideout; David Porter,6,0,36,30
1657770454711,MATH 18,B06,093474,Rideout; David Porter,6,0,36,30
1657770460735,MATH 20A,A01,083754,Zheng; Zequn,14,0,40,26
1657770466756,MATH 20B,A01,083756,Briones; Jor-el Thomas Caparas,4,0,36,32
1657770466756,MATH 20B,A02,083757,Briones; Jor-el Thomas Caparas,1,0,36,35
1657770466756,MATH 20B,A03,093475,Briones; Jor-el Thomas Caparas,2,0,36,34
1657770472783,MATH 20C,A01,083760,Briones; Jor-el Thomas Caparas,1,0,35,34
1657770472783,MATH 20C,A02,083761,Briones; Jor-el Thomas Caparas,8,0,35,27
1657770472783,MATH 20C,A03,093476,Briones; Jor-el Thomas Caparas,0,1,36,36
1657770472783,MATH 20C,B01,083762,Bach; Quang Tran,1,0,30,29
1657770478820,MATH 20D,A01,083765,Tran; Brian Kha,5,0,30,25
1657770478820,MATH 20D,A02,083766,Tran; Brian Kha,5,0,30,25
1657770478820,MATH 20D,A03,083767,Tran; Brian Kha,5,0,30,25
1657770484850,MATH 20E,A01,083771,Ganguly; Soumya,9,0,32,23
1657770484850,MATH 20E,A02,083772,Ganguly; Soumya,6,0,32,26
1657770484850,MATH 20E,B01,083773,Ciotti; Benjamin,20,0,35,15
1657770484850,MATH 20E,B02,083774,Ciotti; Benjamin,18,0,35,17
1657770490875,MATH 103A,A01,083777,Greenfeld; Be'Eri,3,0,36,33
1657770490875,MATH 103A,A02,083778,Greenfeld; Be'Eri,5,0,36,31
1657770490875,MATH 103A,A03,093561,Greenfeld; Be'Eri,6,0,36,30
1657770490875,MATH 103A,B01,083779,Greenfeld; Be'Eri,7,0,36,29
1657770490875,MATH 103A,B02,083780,Greenfeld; Be'Eri,4,0,36,32
1657770490875,MATH 103A,B03,093562,Greenfeld; Be'Eri,3,0,36,33
1657770496904,MATH 105,A01,085443,Carter; Anne Toulson,15,0,35,20
1657770496904,MATH 105,A02,093477,Carter; Anne Toulson,20,0,35,15
1657770502931,MATH 109,A01,083213,Ganzberger; Geoffrey Michael,3,0,34,31
1657770502931,MATH 109,A02,083214,Ganzberger; Geoffrey Michael,4,0,34,30
1657770502931,MATH 109,A03,093478,Ganzberger; Geoffrey Michael,2,0,34,32
1657770502931,MATH 109,B01,083215,Ganzberger; Geoffrey Michael,1,0,32,31
1657770502931,MATH 109,B02,083216,Ganzberger; Geoffrey Michael,2,0,32,30
1657770502931,MATH 109,B03,093479,Ganzberger; Geoffrey Michael,8,0,32,24
1657770508956,MATH 142A,A01,083219,Chow; Bennett,7,0,32,25
1657770508956,MATH 142A,A02,083220,Chow; Bennett,10,0,32,22
1657770508956,MATH 142A,A03,093480,Chow; Bennett,9,0,32,23
1657770508956,MATH 142A,B03,093481,Chow; Bennett,8,0,32,24
1657770508956,MATH 142A,B04,093558,Chow; Bennett,13,0,32,19
1657770508956,MATH 142A,B05,093559,Chow; Bennett,6,0,32,26
1657770514979,MATH 193A,A01,083224,Rotar; Vladimir,8,0,34,26
1657770514979,MATH 193A,A02,083225,Rotar; Vladimir,9,0,34,25
1657770514979,MATH 193A,A03,083781,Rotar; Vladimir,5,0,34,29
1657770514979,MATH 193A,A04,083782,Rotar; Vladimir,10,0,34,24
1657770514979,MATH 193A,A05,093482,Rotar; Vladimir,10,0,34,24
1657770521001,MATH 197,001,091859,McAuley; Julian John,9999,0,9999,0
1657770521001,MATH 197,002,095566,Kedlaya; Kiran S.,9997,0,9999,2
1657770521001,MATH 197,003,095567,Xiao; Ming,9999,0,9999,0
1657770521001,MATH 197,004,095571,Perols; Johan Lars,9998,0,9999,1
1657770528059,COGS 9,A01,083615,Shannon; Kyle Michael,9,0,75,66
1657770534081,COGS 11,A01,083617,Boyle; Mary E. T.,23,0,48,25
1657770540107,COGS 13,A01,083071,Bastos; Amalia Pinkusfeld,11,0,71,60
1657770546131,COGS 14A,A01,092681,Semenuks; Arturs,5,1,100,95
1657770552153,COGS 14B,A01,083073,Cheng; Tzu-Han,6,0,63,57
1657770558180,COGS 17,A01,092677,Semenuks; Arturs,6,0,81,75
1657770564207,COGS 100,A01,083619,Allen; Michael Gordon,17,0,70,53
1657770570233,COGS 101A,A01,083621,Davis; Joshua Daniel,9,0,68,59
1657770576258,COGS 101B,A01,091572,Allen; Michael Gordon,12,0,65,53
1657770582285,COGS 101C,A01,083625,Delgado; Tania,17,0,35,18
1657770588309,COGS 107A,A01,083627,Boyle; Mary E. T.,14,0,60,46
1657770594332,COGS 118A,A01,083075,Gupta; Anjum,21,0,76,55
1657770600363,CSE 3,A50,083646,Miranda; Gregory Joseph,24,0,50,26
1657770606388,CSE 8A,A50,083650,Miranda; Gregory Joseph,17,1,56,39
1657770612413,CSE 11,A01,083080,Cao; Yingjun,6,15,40,34
1657770618437,CSE 12,A01,083652,Krause-Levy; Sophia Louisa,28,1,120,92
1657770624548,CSE 15L,A01,083654,Morris; Justin Loren,9,0,50,41
1657770624548,CSE 15L,A02,083655,Morris; Justin Loren,9,0,50,41
1657770630575,CSE 20,A01,083657,Tran; Khoa Dang,39,0,80,41
1657770636602,CSE 21,A01,095574,Bach; Quang Tran,22,0,48,26
1657770642624,CSE 30,A01,083084,Eldon; John,6,0,80,74
1657770642624,CSE 30,B01,095061,Bhaskar; Nishant,9,0,50,41
1657770648647,CSE 100,A01,083659,Cao; Yingjun,5,4,70,65
1657770654674,CSE 134B,A01,083661,Powell; Thomas Allan,24,0,100,76
1657770660702,CSE 140,A01,083663,Gungor; Onat,15,0,85,70
1657770666728,CSE 140L,A01,083088,Eldon; John,23,0,100,77
1657770672750,CSE 175,A01,083665,Kumar; Rakesh,3,0,25,22
1657770678773,CSE 190,A00,092507,Dubnov; Shlomo,8,0,20,12
1657770684796,ECE 45,A01,083139,Congero; Spencer William,6,0,75,69
1657770690820,ECE 65,A50,083695,Saad; Andrew S,12,0,30,18
1657770690820,ECE 65,A51,095125,Saad; Andrew S,24,0,26,2
1657770696858,ECE 109,A01,091882,Touri; Behrouz,20,0,70,50
1657770702880,ECE 180,A00,083140,Abi Samra; Nicholas Camill,1,0,30,29
1657770702880,ECE 180,B00,083141,Abi Samra; Nicholas Camill,0,0,30,30
1657770708909,MATH 10A,A01,083735,Patchell; Gregory David,2,0,30,28
1657770708909,MATH 10A,A02,083736,Patchell; Gregory David,20,0,30,10
1657770708909,MATH 10A,A03,083737,Patchell; Gregory David,16,0,30,14
1657770714933,MATH 10B,A01,083207,Lim; Seonhee,8,0,34,26
1657770714933,MATH 10B,A02,083208,Lim; Seonhee,9,0,35,26
1657770714933,MATH 10B,A03,093472,Lim; Seonhee,7,0,34,27
1657770714933,MATH 10B,B01,083739,Sinha; Shubham,13,0,30,17
1657770720963,MATH 18,A01,083743,Cinel; Cameron Alexander,9,0,30,21
1657770720963,MATH 18,A02,083744,Cinel; Cameron Alexander,18,0,30,12
1657770720963,MATH 18,A03,083745,Cinel; Cameron Alexander,10,0,30,20
1657770720963,MATH 18,B01,083748,Rideout; David Porter,5,0,37,32
1657770720963,MATH 18,B02,083749,Rideout; David Porter,5,0,36,31
1657770720963,MATH 18,B03,083750,Rideout; David Porter,3,0,37,34
1657770720963,MATH 18,B04,083751,Rideout; David Porter,6,0,36,30
1657770720963,MATH 18,B05,093473,Rideout; David Porter,6,0,36,30
1657770720963,MATH 18,B06,093474,Rideout; David Porter,6,0,36,30
1657770726986,MATH 20A,A01,083754,Zheng; Zequn,14,0,40,26
1657770733013,MATH 20B,A01,083756,Briones; Jor-el Thomas Caparas,4,0,36,32
1657770733013,MATH 20B,A02,083757,Briones; Jor-el Thomas Caparas,1,0,36,35
1657770733013,MATH 20B,A03,093475,Briones; Jor-el Thomas Caparas,2,0,36,34
1657770739041,MATH 20C,A01,083760,Briones; Jor-el Thomas Caparas,1,0,35,34
1657770739041,MATH 20C,A02,083761,Briones; Jor-el Thomas Caparas,8,0,35,27
1657770739041,MATH 20C,A03,093476,Briones; Jor-el Thomas Caparas,0,1,36,36
1657770739041,MATH 20C,B01,083762,Bach; Quang Tran,1,0,30,29
1657770745068,MATH 20D,A01,083765,Tran; Brian Kha,5,0,30,25
1657770745068,MATH 20D,A02,083766,Tran; Brian Kha,5,0,30,25
1657770745068,MATH 20D,A03,083767,Tran; Brian Kha,5,0,30,25
1657770751091,MATH 20E,A01,083771,Ganguly; Soumya,9,0,32,23
1657770751091,MATH 20E,A02,083772,Ganguly; Soumya,6,0,32,26
1657770751091,MATH 20E,B01,083773,Ciotti; Benjamin,20,0,35,15
1657770751091,MATH 20E,B02,083774,Ciotti; Benjamin,18,0,35,17
1657770757119,MATH 103A,A01,083777,Greenfeld; Be'Eri,3,0,36,33
1657770757119,MATH 103A,A02,083778,Greenfeld; Be'Eri,5,0,36,31
1657770757119,MATH 103A,A03,093561,Greenfeld; Be'Eri,6,0,36,30
1657770757119,MATH 103A,B01,083779,Greenfeld; Be'Eri,7,0,36,29
1657770757119,MATH 103A,B02,083780,Greenfeld; Be'Eri,4,0,36,32
1657770757119,MATH 103A,B03,093562,Greenfeld; Be'Eri,3,0,36,33
1657770763142,MATH 105,A01,085443,Carter; Anne Toulson,15,0,35,20
1657770763142,MATH 105,A02,093477,Carter; Anne Toulson,20,0,35,15
1657770769180,MATH 109,A01,083213,Ganzberger; Geoffrey Michael,3,0,34,31
1657770769180,MATH 109,A02,083214,Ganzberger; Geoffrey Michael,4,0,34,30
1657770769180,MATH 109,A03,093478,Ganzberger; Geoffrey Michael,2,0,34,32
1657770769180,MATH 109,B01,083215,Ganzberger; Geoffrey Michael,1,0,32,31
1657770769180,MATH 109,B02,083216,Ganzberger; Geoffrey Michael,2,0,32,30
1657770769180,MATH 109,B03,093479,Ganzberger; Geoffrey Michael,8,0,32,24
1657770775205,MATH 142A,A01,083219,Chow; Bennett,7,0,32,25
1657770775205,MATH 142A,A02,083220,Chow; Bennett,10,0,32,22
1657770775205,MATH 142A,A03,093480,Chow; Bennett,9,0,32,23
1657770775205,MATH 142A,B03,093481,Chow; Bennett,8,0,32,24
1657770775205,MATH 142A,B04,093558,Chow; Bennett,13,0,32,19
1657770775205,MATH 142A,B05,093559,Chow; Bennett,6,0,32,26
1657770781232,MATH 193A,A01,083224,Rotar; Vladimir,8,0,34,26
1657770781232,MATH 193A,A02,083225,Rotar; Vladimir,9,0,34,25
1657770781232,MATH 193A,A03,083781,Rotar; Vladimir,5,0,34,29
1657770781232,MATH 193A,A04,083782,Rotar; Vladimir,10,0,34,24
1657770781232,MATH 193A,A05,093482,Rotar; Vladimir,10,0,34,24
1657770787260,MATH 197,001,091859,McAuley; Julian John,9999,0,9999,0
1657770787260,MATH 197,002,095566,Kedlaya; Kiran S.,9997,0,9999,2
1657770787260,MATH 197,003,095567,Xiao; Ming,9999,0,9999,0
1657770787260,MATH 197,004,095571,Perols; Johan Lars,9998,0,9999,1
1657770794327,COGS 9,A01,083615,Shannon; Kyle Michael,9,0,75,66
1657770800354,COGS 11,A01,083617,Boyle; Mary E. T.,23,0,48,25
1657770806380,COGS 13,A01,083071,Bastos; Amalia Pinkusfeld,11,0,71,60
1657770812405,COGS 14A,A01,092681,Semenuks; Arturs,5,1,100,95
1657770818431,COGS 14B,A01,083073,Cheng; Tzu-Han,6,0,63,57
1657770824454,COGS 17,A01,092677,Semenuks; Arturs,6,0,81,75
1657770830480,COGS 100,A01,083619,Allen; Michael Gordon,17,0,70,53
1657770836508,COGS 101A,A01,083621,Davis; Joshua Daniel,9,0,68,59
1657770842530,COGS 101B,A01,091572,Allen; Michael Gordon,12,0,65,53
1657770848556,COGS 101C,A01,083625,Delgado; Tania,17,0,35,18
1657770854589,COGS 107A,A01,083627,Boyle; Mary E. T.,14,0,60,46
1657770860614,COGS 118A,A01,083075,Gupta; Anjum,21,0,76,55
1657770866638,CSE 3,A50,083646,Miranda; Gregory Joseph,24,0,50,26
1657770872660,CSE 8A,A50,083650,Miranda; Gregory Joseph,17,1,56,39
1657770878687,CSE 11,A01,083080,Cao; Yingjun,6,15,40,34
1657770884711,CSE 12,A01,083652,Krause-Levy; Sophia Louisa,28,1,120,92
1657770890733,CSE 15L,A01,083654,Morris; Justin Loren,9,0,50,41
1657770890733,CSE 15L,A02,083655,Morris; Justin Loren,9,0,50,41
1657770896760,CSE 20,A01,083657,Tran; Khoa Dang,39,0,80,41
1657770902788,CSE 21,A01,095574,Bach; Quang Tran,22,0,48,26
1657770908810,CSE 30,A01,083084,Eldon; John,6,0,80,74
1657770908810,CSE 30,B01,095061,Bhaskar; Nishant,9,0,50,41
1657770914833,CSE 100,A01,083659,Cao; Yingjun,5,4,70,65
1657770920855,CSE 134B,A01,083661,Powell; Thomas Allan,24,0,100,76
1657770926877,CSE 140,A01,083663,Gungor; Onat,15,0,85,70
1657770932903,CSE 140L,A01,083088,Eldon; John,23,0,100,77
1657770938927,CSE 175,A01,083665,Kumar; Rakesh,3,0,25,22
1657770944952,CSE 190,A00,092507,Dubnov; Shlomo,8,0,20,12
1657770950976,ECE 45,A01,083139,Congero; Spencer William,6,0,75,69
1657770957004,ECE 65,A50,083695,Saad; Andrew S,12,0,30,18
1657770957004,ECE 65,A51,095125,Saad; Andrew S,24,0,26,2
1657770963025,ECE 109,A01,091882,Touri; Behrouz,20,0,70,50
1657770969049,ECE 180,A00,083140,Abi Samra; Nicholas Camill,1,0,30,29
1657770969049,ECE 180,B00,083141,Abi Samra; Nicholas Camill,0,0,30,30
1657770975072,MATH 10A,A01,083735,Patchell; Gregory David,2,0,30,28
1657770975072,MATH 10A,A02,083736,Patchell; Gregory David,20,0,30,10
1657770975072,MATH 10A,A03,083737,Patchell; Gregory David,16,0,30,14
1657770981099,MATH 10B,A01,083207,Lim; Seonhee,8,0,34,26
1657770981099,MATH 10B,A02,083208,Lim; Seonhee,9,0,35,26
1657770981099,MATH 10B,A03,093472,Lim; Seonhee,7,0,34,27
1657770981099,MATH 10B,B01,083739,Sinha; Shubham,13,0,30,17
1657770987131,MATH 18,A01,083743,Cinel; Cameron Alexander,9,0,30,21
1657770987131,MATH 18,A02,083744,Cinel; Cameron Alexander,18,0,30,12
1657770987131,MATH 18,A03,083745,Cinel; Cameron Alexander,10,0,30,20
1657770987131,MATH 18,B01,083748,Rideout; David Porter,5,0,37,32
1657770987131,MATH 18,B02,083749,Rideout; David Porter,5,0,36,31
1657770987131,MATH 18,B03,083750,Rideout; David Porter,3,0,37,34
1657770987131,MATH 18,B04,083751,Rideout; David Porter,6,0,36,30
1657770987131,MATH 18,B05,093473,Rideout; David Porter,6,0,36,30
1657770987131,MATH 18,B06,093474,Rideout; David Porter,6,0,36,30
1657770993160,MATH 20A,A01,083754,Zheng; Zequn,14,0,40,26
1657770999184,MATH 20B,A01,083756,Briones; Jor-el Thomas Caparas,4,0,36,32
1657770999184,MATH 20B,A02,083757,Briones; Jor-el Thomas Caparas,1,0,36,35
1657770999184,MATH 20B,A03,093475,Briones; Jor-el Thomas Caparas,2,0,36,34
1657771005212,MATH 20C,A01,083760,Briones; Jor-el Thomas Caparas,1,0,35,34
1657771005212,MATH 20C,A02,083761,Briones; Jor-el Thomas Caparas,8,0,35,27
1657771005212,MATH 20C,A03,093476,Briones; Jor-el Thomas Caparas,0,1,36,36
1657771005212,MATH 20C,B01,083762,Bach; Quang Tran,1,0,30,29
1657771011240,MATH 20D,A01,083765,Tran; Brian Kha,5,0,30,25
1657771011240,MATH 20D,A02,083766,Tran; Brian Kha,5,0,30,25
1657771011240,MATH 20D,A03,083767,Tran; Brian Kha,5,0,30,25
1657771017263,MATH 20E,A01,083771,Ganguly; Soumya,9,0,32,23
1657771017263,MATH 20E,A02,083772,Ganguly; Soumya,6,0,32,26
1657771017263,MATH 20E,B01,083773,Ciotti; Benjamin,20,0,35,15
1657771017263,MATH 20E,B02,083774,Ciotti; Benjamin,18,0,35,17
1657771023294,MATH 103A,A01,083777,Greenfeld; Be'Eri,3,0,36,33
1657771023294,MATH 103A,A02,083778,Greenfeld; Be'Eri,5,0,36,31
1657771023294,MATH 103A,A03,093561,Greenfeld; Be'Eri,6,0,36,30
1657771023294,MATH 103A,B01,083779,Greenfeld; Be'Eri,7,0,36,29
1657771023294,MATH 103A,B02,083780,Greenfeld; Be'Eri,4,0,36,32
1657771023294,MATH 103A,B03,093562,Greenfeld; Be'Eri,3,0,36,33
1657771029323,MATH 105,A01,085443,Carter; Anne Toulson,15,0,35,20
1657771029323,MATH 105,A02,093477,Carter; Anne Toulson,20,0,35,15
1657771035347,MATH 109,A01,083213,Ganzberger; Geoffrey Michael,3,0,34,31
1657771035347,MATH 109,A02,083214,Ganzberger; Geoffrey Michael,4,0,34,30
1657771035347,MATH 109,A03,093478,Ganzberger; Geoffrey Michael,2,0,34,32
1657771035347,MATH 109,B01,083215,Ganzberger; Geoffrey Michael,1,0,32,31
1657771035347,MATH 109,B02,083216,Ganzberger; Geoffrey Michael,2,0,32,30
1657771035347,MATH 109,B03,093479,Ganzberger; Geoffrey Michael,8,0,32,24
1657771041375,MATH 142A,A01,083219,Chow; Bennett,7,0,32,25
1657771041375,MATH 142A,A02,083220,Chow; Bennett,10,0,32,22
1657771041375,MATH 142A,A03,093480,Chow; Bennett,9,0,32,23
1657771041375,MATH 142A,B03,093481,Chow; Bennett,8,0,32,24
1657771041375,MATH 142A,B04,093558,Chow; Bennett,13,0,32,19
1657771041375,MATH 142A,B05,093559,Chow; Bennett,6,0,32,26
1657771047401,MATH 193A,A01,083224,Rotar; Vladimir,8,0,34,26
1657771047401,MATH 193A,A02,083225,Rotar; Vladimir,9,0,34,25
1657771047401,MATH 193A,A03,083781,Rotar; Vladimir,5,0,34,29
1657771047401,MATH 193A,A04,083782,Rotar; Vladimir,10,0,34,24
1657771047401,MATH 193A,A05,093482,Rotar; Vladimir,10,0,34,24
1657771053426,MATH 197,001,091859,McAuley; Julian John,9999,0,9999,0
1657771053426,MATH 197,002,095566,Kedlaya; Kiran S.,9997,0,9999,2
1657771053426,MATH 197,003,095567,Xiao; Ming,9999,0,9999,0
1657771053426,MATH 197,004,095571,Perols; Johan Lars,9998,0,9999,1
1657771060490,COGS 9,A01,083615,Shannon; Kyle Michael,9,0,75,66
1657771066516,COGS 11,A01,083617,Boyle; Mary E. T.,23,0,48,25
1657771072543,COGS 13,A01,083071,Bastos; Amalia Pinkusfeld,11,0,71,60
1657771078564,COGS 14A,A01,092681,Semenuks; Arturs,5,1,100,95
1657771084589,COGS 14B,A01,083073,Cheng; Tzu-Han,6,0,63,57
1657771090616,COGS 17,A01,092677,Semenuks; Arturs,6,0,81,75
1657771096638,COGS 100,A01,083619,Allen; Michael Gordon,17,0,70,53
1657771102666,COGS 101A,A01,083621,Davis; Joshua Daniel,9,0,68,59
1657771108688,COGS 101B,A01,091572,Allen; Michael Gordon,12,0,65,53
1657771114716,COGS 101C,A01,083625,Delgado; Tania,17,0,35,18
1657771120740,COGS 107A,A01,083627,Boyle; Mary E. T.,14,0,60,46
1657771126765,COGS 118A,A01,083075,Gupta; Anjum,21,0,76,55
1657771132795,CSE 3,A50,083646,Miranda; Gregory Joseph,24,0,50,26
1657771138820,CSE 8A,A50,083650,Miranda; Gregory Joseph,17,1,56,39
1657771144848,CSE 11,A01,083080,Cao; Yingjun,6,15,40,34
1657771150874,CSE 12,A01,083652,Krause-Levy; Sophia Louisa,28,1,120,92
1657771156897,CSE 15L,A01,083654,Morris; Justin Loren,9,0,50,41
1657771156897,CSE 15L,A02,083655,Morris; Justin Loren,9,0,50,41
1657771162921,CSE 20,A01,083657,Tran; Khoa Dang,39,0,80,41
1657771168943,CSE 21,A01,095574,Bach; Quang Tran,22,0,48,26
1657771174970,CSE 30,A01,083084,Eldon; John,6,0,80,74
1657771174970,CSE 30,B01,095061,Bhaskar; Nishant,9,0,50,41
1657771180996,CSE 100,A01,083659,Cao; Yingjun,5,4,70,65
1657771187020,CSE 134B,A01,083661,Powell; Thomas Allan,24,0,100,76
1657771193058,CSE 140,A01,083663,Gungor; Onat,15,0,85,70
1657771199082,CSE 140L,A01,083088,Eldon; John,23,0,100,77
1657771205108,CSE 175,A01,083665,Kumar; Rakesh,3,0,25,22
1657771211132,CSE 190,A00,092507,Dubnov; Shlomo,8,0,20,12
1657771217158,ECE 45,A01,083139,Congero; Spencer William,6,0,75,69
1657771223253,ECE 65,A50,083695,Saad; Andrew S,12,0,30,18
1657771223253,ECE 65,A51,095125,Saad; Andrew S,24,0,26,2
1657771229277,ECE 109,A01,091882,Touri; Behrouz,20,0,70,50
1657771235299,ECE 180,A00,083140,Abi Samra; Nicholas Camill,1,0,30,29
1657771235299,ECE 180,B00,083141,Abi Samra; Nicholas Camill,0,0,30,30
1657771241322,MATH 10A,A01,083735,Patchell; Gregory David,2,0,30,28
1657771241322,MATH 10A,A02,083736,Patchell; Gregory David,20,0,30,10
1657771241322,MATH 10A,A03,083737,Patchell; Gregory David,16,0,30,14
1657771247355,MATH 10B,A01,083207,Lim; Seonhee,8,0,34,26
1657771247355,MATH 10B,A02,083208,Lim; Seonhee,9,0,35,26
1657771247355,MATH 10B,A03,093472,Lim; Seonhee,7,0,34,27
1657771247355,MATH 10B,B01,083739,Sinha; Shubham,13,0,30,17
1657771253386,MATH 18,A01,083743,Cinel; Cameron Alexander,9,0,30,21
1657771253386,MATH 18,A02,083744,Cinel; Cameron Alexander,18,0,30,12
1657771253386,MATH 18,A03,083745,Cinel; Cameron Alexander,10,0,30,20
1657771253386,MATH 18,B01,083748,Rideout; David Porter,5,0,37,32
1657771253386,MATH 18,B02,083749,Rideout; David Porter,5,0,36,31
1657771253386,MATH 18,B03,083750,Rideout; David Porter,3,0,37,34
1657771253386,MATH 18,B04,083751,Rideout; David Porter,6,0,36,30
1657771253386,MATH 18,B05,093473,Rideout; David Porter,6,0,36,30
1657771253386,MATH 18,B06,093474,Rideout; David Porter,6,0,36,30
1657771259409,MATH 20A,A01,083754,Zheng; Zequn,14,0,40,26
1657771265432,MATH 20B,A01,083756,Briones; Jor-el Thomas Caparas,4,0,36,32
1657771265432,MATH 20B,A02,083757,Briones; Jor-el Thomas Caparas,1,0,36,35
1657771265432,MATH 20B,A03,093475,Briones; Jor-el Thomas Caparas,2,0,36,34
1657771271453,MATH 20C,A01,083760,Briones; Jor-el Thomas Caparas,1,0,35,34
1657771271453,MATH 20C,A02,083761,Briones; Jor-el Thomas Caparas,8,0,35,27
1657771271453,MATH 20C,A03,093476,Briones; Jor-el Thomas Caparas,0,1,36,36
1657771271453,MATH 20C,B01,083762,Bach; Quang Tran,1,0,30,29
1657771277476,MATH 20D,A01,083765,Tran; Brian Kha,5,0,30,25
1657771277476,MATH 20D,A02,083766,Tran; Brian Kha,5,0,30,25
1657771277476,MATH 20D,A03,083767,Tran; Brian Kha,5,0,30,25
1657771283499,MATH 20E,A01,083771,Ganguly; Soumya,9,0,32,23
1657771283499,MATH 20E,A02,083772,Ganguly; Soumya,6,0,32,26
1657771283499,MATH 20E,B01,083773,Ciotti; Benjamin,20,0,35,15
1657771283499,MATH 20E,B02,083774,Ciotti; Benjamin,18,0,35,17
1657771289527,MATH 103A,A01,083777,Greenfeld; Be'Eri,3,0,36,33
1657771289527,MATH 103A,A02,083778,Greenfeld; Be'Eri,5,0,36,31
1657771289527,MATH 103A,A03,093561,Greenfeld; Be'Eri,6,0,36,30
1657771289527,MATH 103A,B01,083779,Greenfeld; Be'Eri,7,0,36,29
1657771289527,MATH 103A,B02,083780,Greenfeld; Be'Eri,4,0,36,32
1657771289527,MATH 103A,B03,093562,Greenfeld; Be'Eri,3,0,36,33
1657771295551,MATH 105,A01,085443,Carter; Anne Toulson,15,0,35,20
1657771295551,MATH 105,A02,093477,Carter; Anne Toulson,20,0,35,15
1657771301580,MATH 109,A01,083213,Ganzberger; Geoffrey Michael,3,0,34,31
1657771301580,MATH 109,A02,083214,Ganzberger; Geoffrey Michael,4,0,34,30
1657771301580,MATH 109,A03,093478,Ganzberger; Geoffrey Michael,2,0,34,32
1657771301580,MATH 109,B01,083215,Ganzberger; Geoffrey Michael,1,0,32,31
1657771301580,MATH 109,B02,083216,Ganzberger; Geoffrey Michael,2,0,32,30
1657771301580,MATH 109,B03,093479,Ganzberger; Geoffrey Michael,8,0,32,24
1657771307610,MATH 142A,A01,083219,Chow; Bennett,7,0,32,25
1657771307610,MATH 142A,A02,083220,Chow; Bennett,10,0,32,22
1657771307610,MATH 142A,A03,093480,Chow; Bennett,9,0,32,23
1657771307610,MATH 142A,B03,093481,Chow; Bennett,8,0,32,24
1657771307610,MATH 142A,B04,093558,Chow; Bennett,13,0,32,19
1657771307610,MATH 142A,B05,093559,Chow; Bennett,6,0,32,26
1657771313633,MATH 193A,A01,083224,Rotar; Vladimir,8,0,34,26
1657771313633,MATH 193A,A02,083225,Rotar; Vladimir,9,0,34,25
1657771313633,MATH 193A,A03,083781,Rotar; Vladimir,5,0,34,29
1657771313633,MATH 193A,A04,083782,Rotar; Vladimir,10,0,34,24
1657771313633,MATH 193A,A05,093482,Rotar; Vladimir,10,0,34,24
1657771319656,MATH 197,001,091859,McAuley; Julian John,9999,0,9999,0
1657771319656,MATH 197,002,095566,Kedlaya; Kiran S.,9997,0,9999,2
1657771319656,MATH 197,003,095567,Xiao; Ming,9999,0,9999,0
1657771319656,MATH 197,004,095571,Perols; Johan Lars,9998,0,9999,1
1657771326708,COGS 9,A01,083615,Shannon; Kyle Michael,9,0,75,66
1657771332734,COGS 11,A01,083617,Boyle; Mary E. T.,23,0,48,25
1657771338761,COGS 13,A01,083071,Bastos; Amalia Pinkusfeld,11,0,71,60
1657771344784,COGS 14A,A01,092681,Semenuks; Arturs,5,1,100,95
1657771350807,COGS 14B,A01,083073,Cheng; Tzu-Han,6,0,63,57
1657771356829,COGS 17,A01,092677,Semenuks; Arturs,6,0,81,75
1657771362853,COGS 100,A01,083619,Allen; Michael Gordon,17,0,70,53
1657771368882,COGS 101A,A01,083621,Davis; Joshua Daniel,9,0,68,59
1657771374904,COGS 101B,A01,091572,Allen; Michael Gordon,12,0,65,53
1657771380932,COGS 101C,A01,083625,Delgado; Tania,17,0,35,18
1657771386958,COGS 107A,A01,083627,Boyle; Mary E. T.,14,0,60,46
1657771392985,COGS 118A,A01,083075,Gupta; Anjum,21,0,76,55
1657771399014,CSE 3,A50,083646,Miranda; Gregory Joseph,24,0,50,26
1657771405038,CSE 8A,A50,083650,Miranda; Gregory Joseph,17,1,56,39
1657771411065,CSE 11,A01,083080,Cao; Yingjun,6,15,40,34
1657771417091,CSE 12,A01,083652,Krause-Levy; Sophia Louisa,28,1,120,92
1657771423114,CSE 15L,A01,083654,Morris; Justin Loren,9,0,50,41
1657771423114,CSE 15L,A02,083655,Morris; Justin Loren,9,0,50,41
1657771429141,CSE 20,A01,083657,Tran; Khoa Dang,39,0,80,41
1657771435163,CSE 21,A01,095574,Bach; Quang Tran,22,0,48,26
1657771441192,CSE 30,A01,083084,Eldon; John,6,0,80,74
1657771441192,CSE 30,B01,095061,Bhaskar; Nishant,9,0,50,41
1657771447214,CSE 100,A01,083659,Cao; Yingjun,5,4,70,65
1657771453238,CSE 134B,A01,083661,Powell; Thomas Allan,24,0,100,76
1657771459261,CSE 140,A01,083663,Gungor; Onat,15,0,85,70
1657771465295,CSE 140L,A01,083088,Eldon; John,23,0,100,77
1657771471317,CSE 175,A01,083665,Kumar; Rakesh,3,0,25,22
1657771477340,CSE 190,A00,092507,Dubnov; Shlomo,8,0,20,12
1657771483363,ECE 45,A01,083139,Congero; Spencer William,6,0,75,69
1657771489386,ECE 65,A50,083695,Saad; Andrew S,12,0,30,18
1657771489386,ECE 65,A51,095125,Saad; Andrew S,24,0,26,2
1657771495413,ECE 109,A01,091882,Touri; Behrouz,20,0,70,50
1657771501435,ECE 180,A00,083140,Abi Samra; Nicholas Camill,1,0,30,29
1657771501435,ECE 180,B00,083141,Abi Samra; Nicholas Camill,0,0,30,30
1657771507464,MATH 10A,A01,083735,Patchell; Gregory David,2,0,30,28
1657771507464,MATH 10A,A02,083736,Patchell; Gregory David,20,0,30,10
1657771507464,MATH 10A,A03,083737,Patchell; Gregory David,16,0,30,14
1657771513492,MATH 10B,A01,083207,Lim; Seonhee,8,0,34,26
1657771513492,MATH 10B,A02,083208,Lim; Seonhee,9,0,35,26
1657771513492,MATH 10B,A03,093472,Lim; Seonhee,7,0,34,27
1657771513492,MATH 10B,B01,083739,Sinha; Shubham,13,0,30,17
1657771519519,MATH 18,A01,083743,Cinel; Cameron Alexander,9,0,30,21
1657771519519,MATH 18,A02,083744,Cinel; Cameron Alexander,18,0,30,12
1657771519519,MATH 18,A03,083745,Cinel; Cameron Alexander,10,0,30,20
1657771519519,MATH 18,B01,083748,Rideout; David Porter,5,0,37,32
1657771519519,MATH 18,B02,083749,Rideout; David Porter,5,0,36,31
1657771519519,MATH 18,B03,083750,Rideout; David Porter,3,0,37,34
1657771519519,MATH 18,B04,083751,Rideout; David Porter,6,0,36,30
1657771519519,MATH 18,B05,093473,Rideout; David Porter,6,0,36,30
1657771519519,MATH 18,B06,093474,Rideout; David Porter,6,0,36,30
1657771525543,MATH 20A,A01,083754,Zheng; Zequn,14,0,40,26
1657771531567,MATH 20B,A01,083756,Briones; Jor-el Thomas Caparas,4,0,36,32
1657771531567,MATH 20B,A02,083757,Briones; Jor-el Thomas Caparas,1,0,36,35
1657771531567,MATH 20B,A03,093475,Briones; Jor-el Thomas Caparas,2,0,36,34
1657771537591,MATH 20C,A01,083760,Briones; Jor-el Thomas Caparas,1,0,35,34
1657771537591,MATH 20C,A02,083761,Briones; Jor-el Thomas Caparas,8,0,35,27
1657771537591,MATH 20C,A03,093476,Briones; Jor-el Thomas Caparas,0,1,36,36
1657771537591,MATH 20C,B01,083762,Bach; Quang Tran,1,0,30,29
1657771543615,MATH 20D,A01,083765,Tran; Brian Kha,5,0,30,25
1657771543615,MATH 20D,A02,083766,Tran; Brian Kha,5,0,30,25
1657771543615,MATH 20D,A03,083767,Tran; Brian Kha,5,0,30,25
1657771549639,MATH 20E,A01,083771,Ganguly; Soumya,9,0,32,23
1657771549639,MATH 20E,A02,083772,Ganguly; Soumya,6,0,32,26
1657771549639,MATH 20E,B01,083773,Ciotti; Benjamin,20,0,35,15
1657771549639,MATH 20E,B02,083774,Ciotti; Benjamin,18,0,35,17
1657771555662,MATH 103A,A01,083777,Greenfeld; Be'Eri,3,0,36,33
1657771555662,MATH 103A,A02,083778,Greenfeld; Be'Eri,5,0,36,31
1657771555662,MATH 103A,A03,093561,Greenfeld; Be'Eri,6,0,36,30
1657771555662,MATH 103A,B01,083779,Greenfeld; Be'Eri,7,0,36,29
1657771555662,MATH 103A,B02,083780,Greenfeld; Be'Eri,4,0,36,32
1657771555662,MATH 103A,B03,093562,Greenfeld; Be'Eri,3,0,36,33
1657771561685,MATH 105,A01,085443,Carter; Anne Toulson,15,0,35,20
1657771561685,MATH 105,A02,093477,Carter; Anne Toulson,20,0,35,15
1657771567707,MATH 109,A01,083213,Ganzberger; Geoffrey Michael,3,0,34,31
1657771567707,MATH 109,A02,083214,Ganzberger; Geoffrey Michael,4,0,34,30
1657771567707,MATH 109,A03,093478,Ganzberger; Geoffrey Michael,2,0,34,32
1657771567707,MATH 109,B01,083215,Ganzberger; Geoffrey Michael,1,0,32,31
1657771567707,MATH 109,B02,083216,Ganzberger; Geoffrey Michael,2,0,32,30
1657771567707,MATH 109,B03,093479,Ganzberger; Geoffrey Michael,8,0,32,24
1657771573735,MATH 142A,A01,083219,Chow; Bennett,7,0,32,25
1657771573735,MATH 142A,A02,083220,Chow; Bennett,10,0,32,22
1657771573735,MATH 142A,A03,093480,Chow; Bennett,9,0,32,23
1657771573735,MATH 142A,B03,093481,Chow; Bennett,8,0,32,24
1657771573735,MATH 142A,B04,093558,Chow; Bennett,13,0,32,19
1657771573735,MATH 142A,B05,093559,Chow; Bennett,6,0,32,26
1657771579762,MATH 193A,A01,083224,Rotar; Vladimir,8,0,34,26
1657771579762,MATH 193A,A02,083225,Rotar; Vladimir,9,0,34,25
1657771579762,MATH 193A,A03,083781,Rotar; Vladimir,5,0,34,29
1657771579762,MATH 193A,A04,083782,Rotar; Vladimir,10,0,34,24
1657771579762,MATH 193A,A05,093482,Rotar; Vladimir,10,0,34,24
1657771585790,MATH 197,001,091859,McAuley; Julian John,9999,0,9999,0
1657771585790,MATH 197,002,095566,Kedlaya; Kiran S.,9997,0,9999,2
1657771585790,MATH 197,003,095567,Xiao; Ming,9999,0,9999,0
1657771585790,MATH 197,004,095571,Perols; Johan Lars,9998,0,9999,1
1657771592871,COGS 9,A01,083615,Shannon; Kyle Michael,9,0,75,66
1657771598894,COGS 11,A01,083617,Boyle; Mary E. T.,23,0,48,25
1657771604917,COGS 13,A01,083071,Bastos; Amalia Pinkusfeld,11,0,71,60
1657771610943,COGS 14A,A01,092681,Semenuks; Arturs,5,1,100,95
1657771616966,COGS 14B,A01,083073,Cheng; Tzu-Han,6,0,63,57
1657771622989,COGS 17,A01,092677,Semenuks; Arturs,6,0,81,75
1657771629012,COGS 100,A01,083619,Allen; Michael Gordon,17,0,70,53
1657771635038,COGS 101A,A01,083621,Davis; Joshua Daniel,9,0,68,59
1657771641064,COGS 101B,A01,091572,Allen; Michael Gordon,12,0,65,53
1657771647089,COGS 101C,A01,083625,Delgado; Tania,17,0,35,18
1657771653113,COGS 107A,A01,083627,Boyle; Mary E. T.,14,0,60,46
1657771659138,COGS 118A,A01,083075,Gupta; Anjum,21,0,76,55
1657771665162,CSE 3,A50,083646,Miranda; Gregory Joseph,24,0,50,26
1657771671189,CSE 8A,A50,083650,Miranda; Gregory Joseph,17,1,56,39
1657771677212,CSE 11,A01,083080,Cao; Yingjun,6,15,40,34
1657771683241,CSE 12,A01,083652,Krause-Levy; Sophia Louisa,28,1,120,92
1657771689275,CSE 15L,A01,083654,Morris; Justin Loren,9,0,50,41
1657771689275,CSE 15L,A02,083655,Morris; Justin Loren,9,0,50,41
1657771695296,CSE 20,A01,083657,Tran; Khoa Dang,39,0,80,41
1657771701318,CSE 21,A01,095574,Bach; Quang Tran,22,0,48,26
1657771707344,CSE 30,A01,083084,Eldon; John,6,0,80,74
1657771707344,CSE 30,B01,095061,Bhaskar; Nishant,9,0,50,41
1657771713370,CSE 100,A01,083659,Cao; Yingjun,5,4,70,65
1657771719394,CSE 134B,A01,083661,Powell; Thomas Allan,24,0,100,76
1657771725417,CSE 140,A01,083663,Gungor; Onat,15,0,85,70
1657771731443,CSE 140L,A01,083088,Eldon; John,23,0,100,77
1657771737466,CSE 175,A01,083665,Kumar; Rakesh,3,0,25,22
1657771743489,CSE 190,A00,092507,Dubnov; Shlomo,8,0,20,12
1657771749516,ECE 45,A01,083139,Congero; Spencer William,6,0,75,69
1657771755548,ECE 65,A50,083695,Saad; Andrew S,12,0,30,18
1657771755548,ECE 65,A51,095125,Saad; Andrew S,24,0,26,2
1657771761569,ECE 109,A01,091882,Touri; Behrouz,20,0,70,50
1657771767602,ECE 180,A00,083140,Abi Samra; Nicholas Camill,1,0,30,29
1657771767602,ECE 180,B00,083141,Abi Samra; Nicholas Camill,0,0,30,30
1657771773626,MATH 10A,A01,083735,Patchell; Gregory David,2,0,30,28
1657771773626,MATH 10A,A02,083736,Patchell; Gregory David,20,0,30,10
1657771773626,MATH 10A,A03,083737,Patchell; Gregory David,16,0,30,14
1657771779656,MATH 10B,A01,083207,Lim; Seonhee,8,0,34,26
1657771779656,MATH 10B,A02,083208,Lim; Seonhee,9,0,35,26
1657771779656,MATH 10B,A03,093472,Lim; Seonhee,7,0,34,27
1657771779656,MATH 10B,B01,083739,Sinha; Shubham,13,0,30,17
1657771785681,MATH 18,A01,083743,Cinel; Cameron Alexander,9,0,30,21
1657771785681,MATH 18,A02,083744,Cinel; Cameron Alexander,18,0,30,12
1657771785681,MATH 18,A03,083745,Cinel; Cameron Alexander,10,0,30,20
1657771785681,MATH 18,B01,083748,Rideout; David Porter,5,0,37,32
1657771785681,MATH 18,B02,083749,Rideout; David Porter,5,0,36,31
1657771785681,MATH 18,B03,083750,Rideout; David Porter,3,0,37,34
1657771785681,MATH 18,B04,083751,Rideout; David Porter,6,0,36,30
1657771785681,MATH 18,B05,093473,Rideout; David Porter,6,0,36,30
1657771785681,MATH 18,B06,093474,Rideout; David Porter,6,0,36,30
1657771791704,MATH 20A,A01,083754,Zheng; Zequn,14,0,40,26
1657771797728,MATH 20B,A01,083756,Briones; Jor-el Thomas Caparas,4,0,36,32
1657771797728,MATH 20B,A02,083757,Briones; Jor-el Thomas Caparas,1,0,36,35
1657771797728,MATH 20B,A03,093475,Briones; Jor-el Thomas Caparas,2,0,36,34
1657771803754,MATH 20C,A01,083760,Briones; Jor-el Thomas Caparas,1,0,35,34
1657771803754,MATH 20C,A02,083761,Briones; Jor-el Thomas Caparas,8,0,35,27
1657771803754,MATH 20C,A03,093476,Briones; Jor-el Thomas Caparas,0,1,36,36
1657771803754,MATH 20C,B01,083762,Bach; Quang Tran,1,0,30,29
1657771809781,MATH 20D,A01,083765,Tran; Brian Kha,5,0,30,25
1657771809781,MATH 20D,A02,083766,Tran; Brian Kha,5,0,30,25
1657771809781,MATH 20D,A03,083767,Tran; Brian Kha,5,0,30,25
1657771815808,MATH 20E,A01,083771,Ganguly; Soumya,9,0,32,23
1657771815808,MATH 20E,A02,083772,Ganguly; Soumya,6,0,32,26
1657771815808,MATH 20E,B01,083773,Ciotti; Benjamin,20,0,35,15
1657771815808,MATH 20E,B02,083774,Ciotti; Benjamin,18,0,35,17
1657771821903,MATH 103A,A01,083777,Greenfeld; Be'Eri,3,0,36,33
1657771821903,MATH 103A,A02,083778,Greenfeld; Be'Eri,5,0,36,31
1657771821903,MATH 103A,A03,093561,Greenfeld; Be'Eri,6,0,36,30
1657771821903,MATH 103A,B01,083779,Greenfeld; Be'Eri,7,0,36,29
1657771821903,MATH 103A,B02,083780,Greenfeld; Be'Eri,4,0,36,32
1657771821903,MATH 103A,B03,093562,Greenfeld; Be'Eri,3,0,36,33
1657771827926,MATH 105,A01,085443,Carter; Anne Toulson,15,0,35,20
1657771827926,MATH 105,A02,093477,Carter; Anne Toulson,20,0,35,15
1657771833950,MATH 109,A01,083213,Ganzberger; Geoffrey Michael,3,0,34,31
1657771833950,MATH 109,A02,083214,Ganzberger; Geoffrey Michael,4,0,34,30
1657771833950,MATH 109,A03,093478,Ganzberger; Geoffrey Michael,2,0,34,32
1657771833950,MATH 109,B01,083215,Ganzberger; Geoffrey Michael,1,0,32,31
1657771833950,MATH 109,B02,083216,Ganzberger; Geoffrey Michael,2,0,32,30
1657771833950,MATH 109,B03,093479,Ganzberger; Geoffrey Michael,8,0,32,24
1657771839973,MATH 142A,A01,083219,Chow; Bennett,7,0,32,25
1657771839973,MATH 142A,A02,083220,Chow; Bennett,10,0,32,22
1657771839973,MATH 142A,A03,093480,Chow; Bennett,9,0,32,23
1657771839973,MATH 142A,B03,093481,Chow; Bennett,8,0,32,24
1657771839973,MATH 142A,B04,093558,Chow; Bennett,13,0,32,19
1657771839973,MATH 142A,B05,093559,Chow; Bennett,6,0,32,26
1657771846010,MATH 193A,A01,083224,Rotar; Vladimir,8,0,34,26
1657771846010,MATH 193A,A02,083225,Rotar; Vladimir,9,0,34,25
1657771846010,MATH 193A,A03,083781,Rotar; Vladimir,5,0,34,29
1657771846010,MATH 193A,A04,083782,Rotar; Vladimir,10,0,34,24
1657771846010,MATH 193A,A05,093482,Rotar; Vladimir,10,0,34,24
1657771852032,MATH 197,001,091859,McAuley; Julian John,9999,0,9999,0
1657771852032,MATH 197,002,095566,Kedlaya; Kiran S.,9997,0,9999,2
1657771852032,MATH 197,003,095567,Xiao; Ming,9999,0,9999,0
1657771852032,MATH 197,004,095571,Perols; Johan Lars,9998,0,9999,1
1657771859097,COGS 9,A01,083615,Shannon; Kyle Michael,9,0,75,66
1657771865120,COGS 11,A01,083617,Boyle; Mary E. T.,23,0,48,25
1657771871143,COGS 13,A01,083071,Bastos; Amalia Pinkusfeld,11,0,71,60
1657771877166,COGS 14A,A01,092681,Semenuks; Arturs,5,1,100,95
1657771883187,COGS 14B,A01,083073,Cheng; Tzu-Han,6,0,63,57
1657771889210,COGS 17,A01,092677,Semenuks; Arturs,6,0,81,75
1657771895236,COGS 100,A01,083619,Allen; Michael Gordon,17,0,70,53
1657771901262,COGS 101A,A01,083621,Davis; Joshua Daniel,9,0,68,59
1657771907290,COGS 101B,A01,091572,Allen; Michael Gordon,12,0,65,53
1657771913314,COGS 101C,A01,083625,Delgado; Tania,17,0,35,18
1657771919338,COGS 107A,A01,083627,Boyle; Mary E. T.,14,0,60,46
1657771925366,COGS 118A,A01,083075,Gupta; Anjum,21,0,76,55
1657771931392,CSE 3,A50,083646,Miranda; Gregory Joseph,24,0,50,26
1657771937415,CSE 8A,A50,083650,Miranda; Gregory Joseph,17,1,56,39
1657771943440,CSE 11,A01,083080,Cao; Yingjun,6,15,40,34
1657771949464,CSE 12,A01,083652,Krause-Levy; Sophia Louisa,28,1,120,92
1657771955489,CSE 15L,A01,083654,Morris; Justin Loren,9,0,50,41
1657771955489,CSE 15L,A02,083655,Morris; Justin Loren,9,0,50,41
1657771961515,CSE 20,A01,083657,Tran; Khoa Dang,39,0,80,41
1657771967546,CSE 21,A01,095574,Bach; Quang Tran,22,0,48,26
1657771973568,CSE 30,A01,083084,Eldon; John,6,0,80,74
1657771973568,CSE 30,B01,095061,Bhaskar; Nishant,9,0,50,41
1657771979594,CSE 100,A01,083659,Cao; Yingjun,5,4,70,65
1657771985621,CSE 134B,A01,083661,Powell; Thomas Allan,24,0,100,76
1657771991644,CSE 140,A01,083663,Gungor; Onat,15,0,85,70
1657771997670,CSE 140L,A01,083088,Eldon; John,23,0,100,77
1657772003690,CSE 175,A01,083665,Kumar; Rakesh,3,0,25,22
1657772009719,CSE 190,A00,092507,Dubnov; Shlomo,8,0,20,12
1657772015747,ECE 45,A01,083139,Congero; Spencer William,6,0,75,69
1657772021773,ECE 65,A50,083695,Saad; Andrew S,12,0,30,18
1657772021773,ECE 65,A51,095125,Saad; Andrew S,24,0,26,2
1657772027803,ECE 109,A01,091882,Touri; Behrouz,20,0,70,50
1657772033826,ECE 180,A00,083140,Abi Samra; Nicholas Camill,1,0,30,29
1657772033826,ECE 180,B00,083141,Abi Samra; Nicholas Camill,0,0,30,30
1657772039849,MATH 10A,A01,083735,Patchell; Gregory David,2,0,30,28
1657772039849,MATH 10A,A02,083736,Patchell; Gregory David,20,0,30,10
1657772039849,MATH 10A,A03,083737,Patchell; Gregory David,16,0,30,14
1657772045877,MATH 10B,A01,083207,Lim; Seonhee,8,0,34,26
1657772045877,MATH 10B,A02,083208,Lim; Seonhee,9,0,35,26
1657772045877,MATH 10B,A03,093472,Lim; Seonhee,7,0,34,27
1657772045877,MATH 10B,B01,083739,Sinha; Shubham,13,0,30,17
1657772051903,MATH 18,A01,083743,Cinel; Cameron Alexander,9,0,30,21
1657772051903,MATH 18,A02,083744,Cinel; Cameron Alexander,18,0,30,12
1657772051903,MATH 18,A03,083745,Cinel; Cameron Alexander,10,0,30,20
1657772051903,MATH 18,B01,083748,Rideout; David Porter,5,0,37,32
1657772051903,MATH 18,B02,083749,Rideout; David Porter,5,0,36,31
1657772051903,MATH 18,B03,083750,Rideout; David Porter,3,0,37,34
1657772051903,MATH 18,B04,083751,Rideout; David Porter,6,0,36,30
1657772051903,MATH 18,B05,093473,Rideout; David Porter,6,0,36,30
1657772051903,MATH 18,B06,093474,Rideout; David Porter,6,0,36,30
1657772057926,MATH 20A,A01,083754,Zheng; Zequn,14,0,40,26
1657772063950,MATH 20B,A01,083756,Briones; Jor-el Thomas Caparas,4,0,36,32
1657772063950,MATH 20B,A02,083757,Briones; Jor-el Thomas Caparas,1,0,36,35
1657772063950,MATH 20B,A03,093475,Briones; Jor-el Thomas Caparas,2,0,36,34
1657772069979,MATH 20C,A01,083760,Briones; Jor-el Thomas Caparas,1,0,35,34
1657772069979,MATH 20C,A02,083761,Briones; Jor-el Thomas Caparas,8,0,35,27
1657772069979,MATH 20C,A03,093476,Briones; Jor-el Thomas Caparas,0,1,36,36
1657772069979,MATH 20C,B01,083762,Bach; Quang Tran,1,0,30,29
1657772076003,MATH 20D,A01,083765,Tran; Brian Kha,5,0,30,25
1657772076003,MATH 20D,A02,083766,Tran; Brian Kha,5,0,30,25
1657772076003,MATH 20D,A03,083767,Tran; Brian Kha,5,0,30,25
1657772082032,MATH 20E,A01,083771,Ganguly; Soumya,9,0,32,23
1657772082032,MATH 20E,A02,083772,Ganguly; Soumya,6,0,32,26
1657772082032,MATH 20E,B01,083773,Ciotti; Benjamin,20,0,35,15
1657772082032,MATH 20E,B02,083774,Ciotti; Benjamin,18,0,35,17
1657772088056,MATH 103A,A01,083777,Greenfeld; Be'Eri,3,0,36,33
1657772088056,MATH 103A,A02,083778,Greenfeld; Be'Eri,5,0,36,31
1657772088056,MATH 103A,A03,093561,Greenfeld; Be'Eri,6,0,36,30
1657772088056,MATH 103A,B01,083779,Greenfeld; Be'Eri,7,0,36,29
1657772088056,MATH 103A,B02,083780,Greenfeld; Be'Eri,4,0,36,32
1657772088056,MATH 103A,B03,093562,Greenfeld; Be'Eri,3,0,36,33
1657772094086,MATH 105,A01,085443,Carter; Anne Toulson,15,0,35,20
1657772094086,MATH 105,A02,093477,Carter; Anne Toulson,20,0,35,15
1657772100110,MATH 109,A01,083213,Ganzberger; Geoffrey Michael,3,0,34,31
1657772100110,MATH 109,A02,083214,Ganzberger; Geoffrey Michael,4,0,34,30
1657772100110,MATH 109,A03,093478,Ganzberger; Geoffrey Michael,2,0,34,32
1657772100110,MATH 109,B01,083215,Ganzberger; Geoffrey Michael,1,0,32,31
1657772100110,MATH 109,B02,083216,Ganzberger; Geoffrey Michael,2,0,32,30
1657772100110,MATH 109,B03,093479,Ganzberger; Geoffrey Michael,8,0,32,24
1657772106149,MATH 142A,A01,083219,Chow; Bennett,7,0,32,25
1657772106149,MATH 142A,A02,083220,Chow; Bennett,10,0,32,22
1657772106149,MATH 142A,A03,093480,Chow; Bennett,9,0,32,23
1657772106149,MATH 142A,B03,093481,Chow; Bennett,8,0,32,24
1657772106149,MATH 142A,B04,093558,Chow; Bennett,13,0,32,19
1657772106149,MATH 142A,B05,093559,Chow; Bennett,6,0,32,26
1657772112177,MATH 193A,A01,083224,Rotar; Vladimir,8,0,34,26
1657772112177,MATH 193A,A02,083225,Rotar; Vladimir,9,0,34,25
1657772112177,MATH 193A,A03,083781,Rotar; Vladimir,5,0,34,29
1657772112177,MATH 193A,A04,083782,Rotar; Vladimir,10,0,34,24
1657772112177,MATH 193A,A05,093482,Rotar; Vladimir,10,0,34,24
1657772118210,MATH 197,001,091859,McAuley; Julian John,9999,0,9999,0
1657772118210,MATH 197,002,095566,Kedlaya; Kiran S.,9997,0,9999,2
1657772118210,MATH 197,003,095567,Xiao; Ming,9999,0,9999,0
1657772118210,MATH 197,004,095571,Perols; Johan Lars,9998,0,9999,1
1657772125279,COGS 9,A01,083615,Shannon; Kyle Michael,9,0,75,66
1657772131303,COGS 11,A01,083617,Boyle; Mary E. T.,23,0,48,25
1657772137329,COGS 13,A01,083071,Bastos; Amalia Pinkusfeld,11,0,71,60
1657772143356,COGS 14A,A01,092681,Semenuks; Arturs,5,1,100,95
1657772149383,COGS 14B,A01,083073,Cheng; Tzu-Han,6,0,63,57
1657772155409,COGS 17,A01,092677,Semenuks; Arturs,6,0,81,75
1657772161433,COGS 100,A01,083619,Allen; Michael Gordon,17,0,70,53
1657772167457,COGS 101A,A01,083621,Davis; Joshua Daniel,9,0,68,59
1657772173483,COGS 101B,A01,091572,Allen; Michael Gordon,12,0,65,53
1657772179510,COGS 101C,A01,083625,Delgado; Tania,17,0,35,18
1657772185541,COGS 107A,A01,083627,Boyle; Mary E. T.,14,0,60,46
1657772191562,COGS 118A,A01,083075,Gupta; Anjum,21,0,76,55
1657772197591,CSE 3,A50,083646,Miranda; Gregory Joseph,24,0,50,26
1657772203614,CSE 8A,A50,083650,Miranda; Gregory Joseph,17,1,56,39
1657772209653,CSE 11,A01,083080,Cao; Yingjun,6,15,40,34
1657772215681,CSE 12,A01,083652,Krause-Levy; Sophia Louisa,28,1,120,92
1657772221712,CSE 15L,A01,083654,Morris; Justin Loren,9,0,50,41
1657772221712,CSE 15L,A02,083655,Morris; Justin Loren,9,0,50,41
1657772227734,CSE 20,A01,083657,Tran; Khoa Dang,39,0,80,41
1657772233760,CSE 21,A01,095574,Bach; Quang Tran,22,0,48,26
1657772239793,CSE 30,A01,083084,Eldon; John,6,0,80,74
1657772239793,CSE 30,B01,095061,Bhaskar; Nishant,9,0,50,41
1657772245820,CSE 100,A01,083659,Cao; Yingjun,5,4,70,65
1657772251842,CSE 134B,A01,083661,Powell; Thomas Allan,24,0,100,76
1657772257863,CSE 140,A01,083663,Gungor; Onat,15,0,85,70
1657772263889,CSE 140L,A01,083088,Eldon; John,23,0,100,77
1657772269912,CSE 175,A01,083665,Kumar; Rakesh,3,0,25,22
1657772275935,CSE 190,A00,092507,Dubnov; Shlomo,8,0,20,12
1657772281957,ECE 45,A01,083139,Congero; Spencer William,6,0,75,69
1657772287987,ECE 65,A50,083695,Saad; Andrew S,12,0,30,18
1657772287987,ECE 65,A51,095125,Saad; Andrew S,24,0,26,2
1657772294013,ECE 109,A01,091882,Touri; Behrouz,20,0,70,50
1657772300034,ECE 180,A00,083140,Abi Samra; Nicholas Camill,1,0,30,29
1657772300034,ECE 180,B00,083141,Abi Samra; Nicholas Camill,0,0,30,30
1657772306062,MATH 10A,A01,083735,Patchell; Gregory David,2,0,30,28
1657772306062,MATH 10A,A02,083736,Patchell; Gregory David,20,0,30,10
1657772306062,MATH 10A,A03,083737,Patchell; Gregory David,16,0,30,14
1657772312092,MATH 10B,A01,083207,Lim; Seonhee,8,0,34,26
1657772312092,MATH 10B,A02,083208,Lim; Seonhee,9,0,35,26
1657772312092,MATH 10B,A03,093472,Lim; Seonhee,7,0,34,27
1657772312092,MATH 10B,B01,083739,Sinha; Shubham,13,0,30,17
1657772318116,MATH 18,A01,083743,Cinel; Cameron Alexander,9,0,30,21
1657772318116,MATH 18,A02,083744,Cinel; Cameron Alexander,18,0,30,12
1657772318116,MATH 18,A03,083745,Cinel; Cameron Alexander,10,0,30,20
1657772318116,MATH 18,B01,083748,Rideout; David Porter,5,0,37,32
1657772318116,MATH 18,B02,083749,Rideout; David Porter,5,0,36,31
1657772318116,MATH 18,B03,083750,Rideout; David Porter,3,0,37,34
1657772318116,MATH 18,B04,083751,Rideout; David Porter,6,0,36,30
1657772318116,MATH 18,B05,093473,Rideout; David Porter,6,0,36,30
1657772318116,MATH 18,B06,093474,Rideout; David Porter,6,0,36,30
1657772324140,MATH 20A,A01,083754,Zheng; Zequn,14,0,40,26
1657772330167,MATH 20B,A01,083756,Briones; Jor-el Thomas Caparas,4,0,36,32
1657772330167,MATH 20B,A02,083757,Briones; Jor-el Thomas Caparas,1,0,36,35
1657772330167,MATH 20B,A03,093475,Briones; Jor-el Thomas Caparas,2,0,36,34
1657772336195,MATH 20C,A01,083760,Briones; Jor-el Thomas Caparas,1,0,35,34
1657772336195,MATH 20C,A02,083761,Briones; Jor-el Thomas Caparas,8,0,35,27
1657772336195,MATH 20C,A03,093476,Briones; Jor-el Thomas Caparas,0,1,36,36
1657772336195,MATH 20C,B01,083762,Bach; Quang Tran,1,0,30,29
1657772342263,MATH 20D,A01,083765,Tran; Brian Kha,5,0,30,25
1657772342263,MATH 20D,A02,083766,Tran; Brian Kha,5,0,30,25
1657772342263,MATH 20D,A03,083767,Tran; Brian Kha,5,0,30,25
1657772348287,MATH 20E,A01,083771,Ganguly; Soumya,9,0,32,23
1657772348287,MATH 20E,A02,083772,Ganguly; Soumya,6,0,32,26
1657772348287,MATH 20E,B01,083773,Ciotti; Benjamin,20,0,35,15
1657772348287,MATH 20E,B02,083774,Ciotti; Benjamin,18,0,35,17
1657772354311,MATH 103A,A01,083777,Greenfeld; Be'Eri,3,0,36,33
1657772354311,MATH 103A,A02,083778,Greenfeld; Be'Eri,5,0,36,31
1657772354311,MATH 103A,A03,093561,Greenfeld; Be'Eri,6,0,36,30
1657772354311,MATH 103A,B01,083779,Greenfeld; Be'Eri,7,0,36,29
1657772354311,MATH 103A,B02,083780,Greenfeld; Be'Eri,4,0,36,32
1657772354311,MATH 103A,B03,093562,Greenfeld; Be'Eri,3,0,36,33
1657772360336,MATH 105,A01,085443,Carter; Anne Toulson,15,0,35,20
1657772360336,MATH 105,A02,093477,Carter; Anne Toulson,20,0,35,15
1657772366364,MATH 109,A01,083213,Ganzberger; Geoffrey Michael,3,0,34,31
1657772366364,MATH 109,A02,083214,Ganzberger; Geoffrey Michael,4,0,34,30
1657772366364,MATH 109,A03,093478,Ganzberger; Geoffrey Michael,2,0,34,32
1657772366364,MATH 109,B01,083215,Ganzberger; Geoffrey Michael,1,0,32,31
1657772366364,MATH 109,B02,083216,Ganzberger; Geoffrey Michael,2,0,32,30
1657772366364,MATH 109,B03,093479,Ganzberger; Geoffrey Michael,8,0,32,24
1657772372388,MATH 142A,A01,083219,Chow; Bennett,7,0,32,25
1657772372388,MATH 142A,A02,083220,Chow; Bennett,10,0,32,22
1657772372388,MATH 142A,A03,093480,Chow; Bennett,9,0,32,23
1657772372388,MATH 142A,B03,093481,Chow; Bennett,8,0,32,24
1657772372388,MATH 142A,B04,093558,Chow; Bennett,13,0,32,19
1657772372388,MATH 142A,B05,093559,Chow; Bennett,6,0,32,26
1657772378414,MATH 193A,A01,083224,Rotar; Vladimir,8,0,34,26
1657772378414,MATH 193A,A02,083225,Rotar; Vladimir,9,0,34,25
1657772378414,MATH 193A,A03,083781,Rotar; Vladimir,5,0,34,29
1657772378414,MATH 193A,A04,083782,Rotar; Vladimir,10,0,34,24
1657772378414,MATH 193A,A05,093482,Rotar; Vladimir,10,0,34,24
1657772384438,MATH 197,001,091859,McAuley; Julian John,9999,0,9999,0
1657772384438,MATH 197,002,095566,Kedlaya; Kiran S.,9997,0,9999,2
1657772384438,MATH 197,003,095567,Xiao; Ming,9999,0,9999,0
1657772384438,MATH 197,004,095571,Perols; Johan Lars,9998,0,9999,1
1657772391489,COGS 9,A01,083615,Shannon; Kyle Michael,9,0,75,66
1657772397522,COGS 11,A01,083617,Boyle; Mary E. T.,23,0,48,25
1657772403545,COGS 13,A01,083071,Bastos; Amalia Pinkusfeld,11,0,71,60
1657772409570,COGS 14A,A01,092681,Semenuks; Arturs,5,1,100,95
1657772415664,COGS 14B,A01,083073,Cheng; Tzu-Han,6,0,63,57
1657772421686,COGS 17,A01,092677,Semenuks; Arturs,6,0,81,75
1657772427710,COGS 100,A01,083619,Allen; Michael Gordon,17,0,70,53
1657772433737,COGS 101A,A01,083621,Davis; Joshua Daniel,9,0,68,59
1657772439761,COGS 101B,A01,091572,Allen; Michael Gordon,12,0,65,53
1657772445785,COGS 101C,A01,083625,Delgado; Tania,17,0,35,18
1657772451812,COGS 107A,A01,083627,Boyle; Mary E. T.,14,0,60,46
1657772457836,COGS 118A,A01,083075,Gupta; Anjum,21,0,76,55
1657772463860,CSE 3,A50,083646,Miranda; Gregory Joseph,24,0,50,26
1657772469885,CSE 8A,A50,083650,Miranda; Gregory Joseph,17,1,56,39
1657772475906,CSE 11,A01,083080,Cao; Yingjun,6,15,40,34
1657772481930,CSE 12,A01,083652,Krause-Levy; Sophia Louisa,28,1,120,92
1657772487953,CSE 15L,A01,083654,Morris; Justin Loren,9,0,50,41
1657772487953,CSE 15L,A02,083655,Morris; Justin Loren,9,0,50,41
1657772493977,CSE 20,A01,083657,Tran; Khoa Dang,39,0,80,41
1657772500001,CSE 21,A01,095574,Bach; Quang Tran,22,0,48,26
1657772506026,CSE 30,A01,083084,Eldon; John,6,0,80,74
1657772506026,CSE 30,B01,095061,Bhaskar; Nishant,9,0,50,41
1657772512050,CSE 100,A01,083659,Cao; Yingjun,5,4,70,65
1657772518077,CSE 134B,A01,083661,Powell; Thomas Allan,24,0,100,76
1657772524112,CSE 140,A01,083663,Gungor; Onat,15,0,85,70
1657772530136,CSE 140L,A01,083088,Eldon; John,23,0,100,77
1657772536160,CSE 175,A01,083665,Kumar; Rakesh,3,0,25,22
1657772542185,CSE 190,A00,092507,Dubnov; Shlomo,8,0,20,12
1657772548212,ECE 45,A01,083139,Congero; Spencer William,6,0,75,69
1657772554235,ECE 65,A50,083695,Saad; Andrew S,12,0,30,18
1657772554235,ECE 65,A51,095125,Saad; Andrew S,24,0,26,2
1657772560261,ECE 109,A01,091882,Touri; Behrouz,20,0,70,50
1657772566284,ECE 180,A00,083140,Abi Samra; Nicholas Camill,1,0,30,29
1657772566284,ECE 180,B00,083141,Abi Samra; Nicholas Camill,0,0,30,30
1657772572313,MATH 10A,A01,083735,Patchell; Gregory David,2,0,30,28
1657772572313,MATH 10A,A02,083736,Patchell; Gregory David,20,0,30,10
1657772572313,MATH 10A,A03,083737,Patchell; Gregory David,16,0,30,14
1657772578335,MATH 10B,A01,083207,Lim; Seonhee,8,0,34,26
1657772578335,MATH 10B,A02,083208,Lim; Seonhee,9,0,35,26
1657772578335,MATH 10B,A03,093472,Lim; Seonhee,7,0,34,27
1657772578335,MATH 10B,B01,083739,Sinha; Shubham,13,0,30,17
1657772584370,MATH 18,A01,083743,Cinel; Cameron Alexander,9,0,30,21
1657772584370,MATH 18,A02,083744,Cinel; Cameron Alexander,18,0,30,12
1657772584370,MATH 18,A03,083745,Cinel; Cameron Alexander,10,0,30,20
1657772584370,MATH 18,B01,083748,Rideout; David Porter,5,0,37,32
1657772584370,MATH 18,B02,083749,Rideout; David Porter,5,0,36,31
1657772584370,MATH 18,B03,083750,Rideout; David Porter,3,0,37,34
1657772584370,MATH 18,B04,083751,Rideout; David Porter,6,0,36,30
1657772584370,MATH 18,B05,093473,Rideout; David Porter,6,0,36,30
1657772584370,MATH 18,B06,093474,Rideout; David Porter,6,0,36,30
1657772590395,MATH 20A,A01,083754,Zheng; Zequn,14,0,40,26
1657772596418,MATH 20B,A01,083756,Briones; Jor-el Thomas Caparas,4,0,36,32
1657772596418,MATH 20B,A02,083757,Briones; Jor-el Thomas Caparas,1,0,36,35
1657772596418,MATH 20B,A03,093475,Briones; Jor-el Thomas Caparas,2,0,36,34
1657772602442,MATH 20C,A01,083760,Briones; Jor-el Thomas Caparas,1,0,35,34
1657772602442,MATH 20C,A02,083761,Briones; Jor-el Thomas Caparas,8,0,35,27
1657772602442,MATH 20C,A03,093476,Briones; Jor-el Thomas Caparas,0,1,36,36
1657772602442,MATH 20C,B01,083762,Bach; Quang Tran,1,0,30,29
1657772608466,MATH 20D,A01,083765,Tran; Brian Kha,5,0,30,25
1657772608466,MATH 20D,A02,083766,Tran; Brian Kha,5,0,30,25
1657772608466,MATH 20D,A03,083767,Tran; Brian Kha,5,0,30,25
1657772614491,MATH 20E,A01,083771,Ganguly; Soumya,9,0,32,23
1657772614491,MATH 20E,A02,083772,Ganguly; Soumya,6,0,32,26
1657772614491,MATH 20E,B01,083773,Ciotti; Benjamin,20,0,35,15
1657772614491,MATH 20E,B02,083774,Ciotti; Benjamin,18,0,35,17
1657772620526,MATH 103A,A01,083777,Greenfeld; Be'Eri,3,0,36,33
1657772620526,MATH 103A,A02,083778,Greenfeld; Be'Eri,5,0,36,31
1657772620526,MATH 103A,A03,093561,Greenfeld; Be'Eri,6,0,36,30
1657772620526,MATH 103A,B01,083779,Greenfeld; Be'Eri,7,0,36,29
1657772620526,MATH 103A,B02,083780,Greenfeld; Be'Eri,4,0,36,32
1657772620526,MATH 103A,B03,093562,Greenfeld; Be'Eri,3,0,36,33
1657772626550,MATH 105,A01,085443,Carter; Anne Toulson,15,0,35,20
1657772626550,MATH 105,A02,093477,Carter; Anne Toulson,20,0,35,15
1657772632575,MATH 109,A01,083213,Ganzberger; Geoffrey Michael,3,0,34,31
1657772632575,MATH 109,A02,083214,Ganzberger; Geoffrey Michael,4,0,34,30
1657772632575,MATH 109,A03,093478,Ganzberger; Geoffrey Michael,2,0,34,32
1657772632575,MATH 109,B01,083215,Ganzberger; Geoffrey Michael,1,0,32,31
1657772632575,MATH 109,B02,083216,Ganzberger; Geoffrey Michael,2,0,32,30
1657772632575,MATH 109,B03,093479,Ganzberger; Geoffrey Michael,8,0,32,24
1657772638598,MATH 142A,A01,083219,Chow; Bennett,7,0,32,25
1657772638598,MATH 142A,A02,083220,Chow; Bennett,10,0,32,22
1657772638598,MATH 142A,A03,093480,Chow; Bennett,9,0,32,23
1657772638598,MATH 142A,B03,093481,Chow; Bennett,8,0,32,24
1657772638598,MATH 142A,B04,093558,Chow; Bennett,13,0,32,19
1657772638598,MATH 142A,B05,093559,Chow; Bennett,6,0,32,26
1657772644622,MATH 193A,A01,083224,Rotar; Vladimir,8,0,34,26
1657772644622,MATH 193A,A02,083225,Rotar; Vladimir,9,0,34,25
1657772644622,MATH 193A,A03,083781,Rotar; Vladimir,5,0,34,29
1657772644622,MATH 193A,A04,083782,Rotar; Vladimir,10,0,34,24
1657772644622,MATH 193A,A05,093482,Rotar; Vladimir,10,0,34,24
1657772650647,MATH 197,001,091859,McAuley; Julian John,9999,0,9999,0
1657772650647,MATH 197,002,095566,Kedlaya; Kiran S.,9997,0,9999,2
1657772650647,MATH 197,003,095567,Xiao; Ming,9999,0,9999,0
1657772650647,MATH 197,004,095571,Perols; Johan Lars,9998,0,9999,1
1657772657708,COGS 9,A01,083615,Shannon; Kyle Michael,9,0,75,66
1657772663732,COGS 11,A01,083617,Boyle; Mary E. T.,23,0,48,25
1657772669756,COGS 13,A01,083071,Bastos; Amalia Pinkusfeld,11,0,71,60
1657772675780,COGS 14A,A01,092681,Semenuks; Arturs,5,1,100,95
1657772681811,COGS 14B,A01,083073,Cheng; Tzu-Han,6,0,63,57
1657772687837,COGS 17,A01,092677,Semenuks; Arturs,6,0,81,75
1657772693861,COGS 100,A01,083619,Allen; Michael Gordon,17,0,70,53
1657772699888,COGS 101A,A01,083621,Davis; Joshua Daniel,9,0,68,59
1657772705911,COGS 101B,A01,091572,Allen; Michael Gordon,12,0,65,53
1657772711935,COGS 101C,A01,083625,Delgado; Tania,17,0,35,18
1657772717959,COGS 107A,A01,083627,Boyle; Mary E. T.,14,0,60,46
1657772723991,COGS 118A,A01,083075,Gupta; Anjum,21,0,76,55
1657772730014,CSE 3,A50,083646,Miranda; Gregory Joseph,24,0,50,26
1657772736042,CSE 8A,A50,083650,Miranda; Gregory Joseph,17,1,56,39
1657772742068,CSE 11,A01,083080,Cao; Yingjun,6,15,40,34
1657772748102,CSE 12,A01,083652,Krause-Levy; Sophia Louisa,28,1,120,92
1657772754124,CSE 15L,A01,083654,Morris; Justin Loren,9,0,50,41
1657772754124,CSE 15L,A02,083655,Morris; Justin Loren,9,0,50,41
1657772760150,CSE 20,A01,083657,Tran; Khoa Dang,39,0,80,41
1657772766172,CSE 21,A01,095574,Bach; Quang Tran,22,0,48,26
1657772772204,CSE 30,A01,083084,Eldon; John,6,0,80,74
1657772772204,CSE 30,B01,095061,Bhaskar; Nishant,9,0,50,41
1657772778236,CSE 100,A01,083659,Cao; Yingjun,5,4,70,65
1657772784261,CSE 134B,A01,083661,Powell; Thomas Allan,24,0,100,76
1657772790282,CSE 140,A01,083663,Gungor; Onat,15,0,85,70
1657772796313,CSE 140L,A01,083088,Eldon; John,23,0,100,77
1657772802337,CSE 175,A01,083665,Kumar; Rakesh,3,0,25,22
1657772808363,CSE 190,A00,092507,Dubnov; Shlomo,8,0,20,12
1657772814397,ECE 45,A01,083139,Congero; Spencer William,6,0,75,69
1657772820425,ECE 65,A50,083695,Saad; Andrew S,12,0,30,18
1657772820425,ECE 65,A51,095125,Saad; Andrew S,24,0,26,2
1657772826464,ECE 109,A01,091882,Touri; Behrouz,20,0,70,50
1657772832490,ECE 180,A00,083140,Abi Samra; Nicholas Camill,1,0,30,29
1657772832490,ECE 180,B00,083141,Abi Samra; Nicholas Camill,0,0,30,30
1657772838515,MATH 10A,A01,083735,Patchell; Gregory David,2,0,30,28
1657772838515,MATH 10A,A02,083736,Patchell; Gregory David,20,0,30,10
1657772838515,MATH 10A,A03,083737,Patchell; Gregory David,16,0,30,14
1657772844547,MATH 10B,A01,083207,Lim; Seonhee,8,0,34,26
1657772844547,MATH 10B,A02,083208,Lim; Seonhee,9,0,35,26
1657772844547,MATH 10B,A03,093472,Lim; Seonhee,7,0,34,27
1657772844547,MATH 10B,B01,083739,Sinha; Shubham,13,0,30,17
1657772850571,MATH 18,A01,083743,Cinel; Cameron Alexander,9,0,30,21
1657772850571,MATH 18,A02,083744,Cinel; Cameron Alexander,18,0,30,12
1657772850571,MATH 18,A03,083745,Cinel; Cameron Alexander,10,0,30,20
1657772850571,MATH 18,B01,083748,Rideout; David Porter,5,0,37,32
1657772850571,MATH 18,B02,083749,Rideout; David Porter,5,0,36,31
1657772850571,MATH 18,B03,083750,Rideout; David Porter,3,0,37,34
1657772850571,MATH 18,B04,083751,Rideout; David Porter,6,0,36,30
1657772850571,MATH 18,B05,093473,Rideout; David Porter,6,0,36,30
1657772850571,MATH 18,B06,093474,Rideout; David Porter,6,0,36,30
1657772856594,MATH 20A,A01,083754,Zheng; Zequn,14,0,40,26
1657772862622,MATH 20B,A01,083756,Briones; Jor-el Thomas Caparas,4,0,36,32
1657772862622,MATH 20B,A02,083757,Briones; Jor-el Thomas Caparas,1,0,36,35
1657772862622,MATH 20B,A03,093475,Briones; Jor-el Thomas Caparas,2,0,36,34
1657772868662,MATH 20C,A01,083760,Briones; Jor-el Thomas Caparas,1,0,35,34
1657772868662,MATH 20C,A02,083761,Briones; Jor-el Thomas Caparas,8,0,35,27
1657772868662,MATH 20C,A03,093476,Briones; Jor-el Thomas Caparas,0,1,36,36
1657772868662,MATH 20C,B01,083762,Bach; Quang Tran,1,0,30,29
1657772874687,MATH 20D,A01,083765,Tran; Brian Kha,5,0,30,25
1657772874687,MATH 20D,A02,083766,Tran; Brian Kha,5,0,30,25
1657772874687,MATH 20D,A03,083767,Tran; Brian Kha,5,0,30,25
1657772880720,MATH 20E,A01,083771,Ganguly; Soumya,9,0,32,23
1657772880720,MATH 20E,A02,083772,Ganguly; Soumya,6,0,32,26
1657772880720,MATH 20E,B01,083773,Ciotti; Benjamin,20,0,35,15
1657772880720,MATH 20E,B02,083774,Ciotti; Benjamin,18,0,35,17
1657772886751,MATH 103A,A01,083777,Greenfeld; Be'Eri,3,0,36,33
1657772886751,MATH 103A,A02,083778,Greenfeld; Be'Eri,5,0,36,31
1657772886751,MATH 103A,A03,093561,Greenfeld; Be'Eri,6,0,36,30
1657772886751,MATH 103A,B01,083779,Greenfeld; Be'Eri,7,0,36,29
1657772886751,MATH 103A,B02,083780,Greenfeld; Be'Eri,4,0,36,32
1657772886751,MATH 103A,B03,093562,Greenfeld; Be'Eri,3,0,36,33
1657772892776,MATH 105,A01,085443,Carter; Anne Toulson,15,0,35,20
1657772892776,MATH 105,A02,093477,Carter; Anne Toulson,20,0,35,15
1657772898811,MATH 109,A01,083213,Ganzberger; Geoffrey Michael,3,0,34,31
1657772898811,MATH 109,A02,083214,Ganzberger; Geoffrey Michael,4,0,34,30
1657772898811,MATH 109,A03,093478,Ganzberger; Geoffrey Michael,2,0,34,32
1657772898811,MATH 109,B01,083215,Ganzberger; Geoffrey Michael,1,0,32,31
1657772898811,MATH 109,B02,083216,Ganzberger; Geoffrey Michael,2,0,32,30
1657772898811,MATH 109,B03,093479,Ganzberger; Geoffrey Michael,8,0,32,24
1657772904841,MATH 142A,A01,083219,Chow; Bennett,7,0,32,25
1657772904841,MATH 142A,A02,083220,Chow; Bennett,10,0,32,22
1657772904841,MATH 142A,A03,093480,Chow; Bennett,9,0,32,23
1657772904841,MATH 142A,B03,093481,Chow; Bennett,8,0,32,24
1657772904841,MATH 142A,B04,093558,Chow; Bennett,13,0,32,19
1657772904841,MATH 142A,B05,093559,Chow; Bennett,6,0,32,26
1657772910866,MATH 193A,A01,083224,Rotar; Vladimir,8,0,34,26
1657772910866,MATH 193A,A02,083225,Rotar; Vladimir,9,0,34,25
1657772910866,MATH 193A,A03,083781,Rotar; Vladimir,5,0,34,29
1657772910866,MATH 193A,A04,083782,Rotar; Vladimir,10,0,34,24
1657772910866,MATH 193A,A05,093482,Rotar; Vladimir,10,0,34,24
1657772916892,MATH 197,001,091859,McAuley; Julian John,9999,0,9999,0
1657772916892,MATH 197,002,095566,Kedlaya; Kiran S.,9997,0,9999,2
1657772916892,MATH 197,003,095567,Xiao; Ming,9999,0,9999,0
1657772916892,MATH 197,004,095571,Perols; Johan Lars,9998,0,9999,1
1657772923966,COGS 9,A01,083615,Shannon; Kyle Michael,9,0,75,66
1657772930002,COGS 11,A01,083617,Boyle; Mary E. T.,23,0,48,25
1657772936030,COGS 13,A01,083071,Bastos; Amalia Pinkusfeld,11,0,71,60
1657772942053,COGS 14A,A01,092681,Semenuks; Arturs,5,1,100,95
1657772948080,COGS 14B,A01,083073,Cheng; Tzu-Han,6,0,63,57
1657772954106,COGS 17,A01,092677,Semenuks; Arturs,6,0,81,75
1657772960127,COGS 100,A01,083619,Allen; Michael Gordon,17,0,70,53
1657772966150,COGS 101A,A01,083621,Davis; Joshua Daniel,9,0,68,59
1657772972173,COGS 101B,A01,091572,Allen; Michael Gordon,12,0,65,53
1657772978209,COGS 101C,A01,083625,Delgado; Tania,17,0,35,18
1657772984233,COGS 107A,A01,083627,Boyle; Mary E. T.,14,0,60,46
1657772990260,COGS 118A,A01,083075,Gupta; Anjum,21,0,76,55
1657772996289,CSE 3,A50,083646,Miranda; Gregory Joseph,24,0,50,26
1657773002315,CSE 8A,A50,083650,Miranda; Gregory Joseph,17,1,56,39
1657773008338,CSE 11,A01,083080,Cao; Yingjun,6,15,40,34
1657773014433,CSE 12,A01,083652,Krause-Levy; Sophia Louisa,28,1,120,92
1657773020456,CSE 15L,A01,083654,Morris; Justin Loren,9,0,50,41
1657773020456,CSE 15L,A02,083655,Morris; Justin Loren,9,0,50,41
1657773026494,CSE 20,A01,083657,Tran; Khoa Dang,39,0,80,41
1657773032521,CSE 21,A01,095574,Bach; Quang Tran,22,0,48,26
1657773038561,CSE 30,A01,083084,Eldon; John,6,0,80,74
1657773038561,CSE 30,B01,095061,Bhaskar; Nishant,9,0,50,41
1657773044583,CSE 100,A01,083659,Cao; Yingjun,5,4,70,65
1657773050606,CSE 134B,A01,083661,Powell; Thomas Allan,24,0,100,76
1657773056636,CSE 140,A01,083663,Gungor; Onat,15,0,85,70
1657773062659,CSE 140L,A01,083088,Eldon; John,23,0,100,77
1657773068682,CSE 175,A01,083665,Kumar; Rakesh,3,0,25,22
1657773074706,CSE 190,A00,092507,Dubnov; Shlomo,8,0,20,12
1657773080728,ECE 45,A01,083139,Congero; Spencer William,6,0,75,69
1657773086761,ECE 65,A50,083695,Saad; Andrew S,12,0,30,18
1657773086761,ECE 65,A51,095125,Saad; Andrew S,24,0,26,2
1657773092787,ECE 109,A01,091882,Touri; Behrouz,20,0,70,50
1657773098811,ECE 180,A00,083140,Abi Samra; Nicholas Camill,1,0,30,29
1657773098811,ECE 180,B00,083141,Abi Samra; Nicholas Camill,0,0,30,30
1657773104840,MATH 10A,A01,083735,Patchell; Gregory David,2,0,30,28
1657773104840,MATH 10A,A02,083736,Patchell; Gregory David,20,0,30,10
1657773104840,MATH 10A,A03,083737,Patchell; Gregory David,16,0,30,14
1657773110865,MATH 10B,A01,083207,Lim; Seonhee,8,0,34,26
1657773110865,MATH 10B,A02,083208,Lim; Seonhee,9,0,35,26
1657773110865,MATH 10B,A03,093472,Lim; Seonhee,7,0,34,27
1657773110865,MATH 10B,B01,083739,Sinha; Shubham,13,0,30,17
1657773116899,MATH 18,A01,083743,Cinel; Cameron Alexander,9,0,30,21
1657773116899,MATH 18,A02,083744,Cinel; Cameron Alexander,18,0,30,12
1657773116899,MATH 18,A03,083745,Cinel; Cameron Alexander,10,0,30,20
1657773116899,MATH 18,B01,083748,Rideout; David Porter,5,0,37,32
1657773116899,MATH 18,B02,083749,Rideout; David Porter,5,0,36,31
1657773116899,MATH 18,B03,083750,Rideout; David Porter,3,0,37,34
1657773116899,MATH 18,B04,083751,Rideout; David Porter,6,0,36,30
1657773116899,MATH 18,B05,093473,Rideout; David Porter,6,0,36,30
1657773116899,MATH 18,B06,093474,Rideout; David Porter,6,0,36,30
1657773122922,MATH 20A,A01,083754,Zheng; Zequn,14,0,40,26
1657773128946,MATH 20B,A01,083756,Briones; Jor-el Thomas Caparas,4,0,36,32
1657773128946,MATH 20B,A02,083757,Briones; Jor-el Thomas Caparas,1,0,36,35
1657773128946,MATH 20B,A03,093475,Briones; Jor-el Thomas Caparas,2,0,36,34
1657773134983,MATH 20C,A01,083760,Briones; Jor-el Thomas Caparas,1,0,35,34
1657773134983,MATH 20C,A02,083761,Briones; Jor-el Thomas Caparas,8,0,35,27
1657773134983,MATH 20C,A03,093476,Briones; Jor-el Thomas Caparas,0,1,36,36
1657773134983,MATH 20C,B01,083762,Bach; Quang Tran,1,0,30,29
1657773141012,MATH 20D,A01,083765,Tran; Brian Kha,5,0,30,25
1657773141012,MATH 20D,A02,083766,Tran; Brian Kha,5,0,30,25
1657773141012,MATH 20D,A03,083767,Tran; Brian Kha,5,0,30,25
1657773147035,MATH 20E,A01,083771,Ganguly; Soumya,9,0,32,23
1657773147035,MATH 20E,A02,083772,Ganguly; Soumya,6,0,32,26
1657773147035,MATH 20E,B01,083773,Ciotti; Benjamin,20,0,35,15
1657773147035,MATH 20E,B02,083774,Ciotti; Benjamin,18,0,35,17
1657773153064,MATH 103A,A01,083777,Greenfeld; Be'Eri,3,0,36,33
1657773153064,MATH 103A,A02,083778,Greenfeld; Be'Eri,5,0,36,31
1657773153064,MATH 103A,A03,093561,Greenfeld; Be'Eri,6,0,36,30
1657773153064,MATH 103A,B01,083779,Greenfeld; Be'Eri,7,0,36,29
1657773153064,MATH 103A,B02,083780,Greenfeld; Be'Eri,4,0,36,32
1657773153064,MATH 103A,B03,093562,Greenfeld; Be'Eri,3,0,36,33
1657773159091,MATH 105,A01,085443,Carter; Anne Toulson,15,0,35,20
1657773159091,MATH 105,A02,093477,Carter; Anne Toulson,20,0,35,15
1657773165121,MATH 109,A01,083213,Ganzberger; Geoffrey Michael,3,0,34,31
1657773165121,MATH 109,A02,083214,Ganzberger; Geoffrey Michael,4,0,34,30
1657773165121,MATH 109,A03,093478,Ganzberger; Geoffrey Michael,2,0,34,32
1657773165121,MATH 109,B01,083215,Ganzberger; Geoffrey Michael,1,0,32,31
1657773165121,MATH 109,B02,083216,Ganzberger; Geoffrey Michael,2,0,32,30
1657773165121,MATH 109,B03,093479,Ganzberger; Geoffrey Michael,8,0,32,24
1657773171144,MATH 142A,A01,083219,Chow; Bennett,7,0,32,25
1657773171144,MATH 142A,A02,083220,Chow; Bennett,10,0,32,22
1657773171144,MATH 142A,A03,093480,Chow; Bennett,9,0,32,23
1657773171144,MATH 142A,B03,093481,Chow; Bennett,8,0,32,24
1657773171144,MATH 142A,B04,093558,Chow; Bennett,13,0,32,19
1657773171144,MATH 142A,B05,093559,Chow; Bennett,6,0,32,26
1657773177171,MATH 193A,A01,083224,Rotar; Vladimir,8,0,34,26
1657773177171,MATH 193A,A02,083225,Rotar; Vladimir,9,0,34,25
1657773177171,MATH 193A,A03,083781,Rotar; Vladimir,5,0,34,29
1657773177171,MATH 193A,A04,083782,Rotar; Vladimir,10,0,34,24
1657773177171,MATH 193A,A05,093482,Rotar; Vladimir,10,0,34,24
1657773183193,MATH 197,001,091859,McAuley; Julian John,9999,0,9999,0
1657773183193,MATH 197,002,095566,Kedlaya; Kiran S.,9997,0,9999,2
1657773183193,MATH 197,003,095567,Xiao; Ming,9999,0,9999,0
1657773183193,MATH 197,004,095571,Perols; Johan Lars,9998,0,9999,1
1657773190254,COGS 9,A01,083615,Shannon; Kyle Michael,9,0,75,66
1657773196275,COGS 11,A01,083617,Boyle; Mary E. T.,23,0,48,25
1657773202298,COGS 13,A01,083071,Bastos; Amalia Pinkusfeld,11,0,71,60
1657773208323,COGS 14A,A01,092681,Semenuks; Arturs,5,1,100,95
1657773214348,COGS 14B,A01,083073,Cheng; Tzu-Han,6,0,63,57
1657773220373,COGS 17,A01,092677,Semenuks; Arturs,6,0,81,75
1657773226395,COGS 100,A01,083619,Allen; Michael Gordon,17,0,70,53
1657773232418,COGS 101A,A01,083621,Davis; Joshua Daniel,9,0,68,59
1657773238445,COGS 101B,A01,091572,Allen; Michael Gordon,12,0,65,53
1657773244472,COGS 101C,A01,083625,Delgado; Tania,17,0,35,18
1657773250496,COGS 107A,A01,083627,Boyle; Mary E. T.,14,0,60,46
1657773256522,COGS 118A,A01,083075,Gupta; Anjum,21,0,76,55
1657773262547,CSE 3,A50,083646,Miranda; Gregory Joseph,24,0,50,26
1657773268571,CSE 8A,A50,083650,Miranda; Gregory Joseph,17,1,56,39
1657773274592,CSE 11,A01,083080,Cao; Yingjun,6,15,40,34
1657773280619,CSE 12,A01,083652,Krause-Levy; Sophia Louisa,28,1,120,92
1657773286641,CSE 15L,A01,083654,Morris; Justin Loren,9,0,50,41
1657773286641,CSE 15L,A02,083655,Morris; Justin Loren,9,0,50,41
1657773292663,CSE 20,A01,083657,Tran; Khoa Dang,39,0,80,41
1657773298690,CSE 21,A01,095574,Bach; Quang Tran,22,0,48,26
1657773304713,CSE 30,A01,083084,Eldon; John,6,0,80,74
1657773304713,CSE 30,B01,095061,Bhaskar; Nishant,9,0,50,41
1657773310739,CSE 100,A01,083659,Cao; Yingjun,5,4,70,65
1657773316766,CSE 134B,A01,083661,Powell; Thomas Allan,24,0,100,76
1657773322788,CSE 140,A01,083663,Gungor; Onat,15,0,85,70
1657773328810,CSE 140L,A01,083088,Eldon; John,23,0,100,77
1657773334832,CSE 175,A01,083665,Kumar; Rakesh,3,0,25,22
1657773340860,CSE 190,A00,092507,Dubnov; Shlomo,8,0,20,12
1657773346883,ECE 45,A01,083139,Congero; Spencer William,6,0,75,69
1657773352909,ECE 65,A50,083695,Saad; Andrew S,12,0,30,18
1657773352909,ECE 65,A51,095125,Saad; Andrew S,24,0,26,2
1657773358937,ECE 109,A01,091882,Touri; Behrouz,20,0,70,50
1657773364960,ECE 180,A00,083140,Abi Samra; Nicholas Camill,1,0,30,29
1657773364960,ECE 180,B00,083141,Abi Samra; Nicholas Camill,0,0,30,30
1657773370989,MATH 10A,A01,083735,Patchell; Gregory David,2,0,30,28
1657773370989,MATH 10A,A02,083736,Patchell; Gregory David,20,0,30,10
1657773370989,MATH 10A,A03,083737,Patchell; Gregory David,16,0,30,14
1657773377027,MATH 10B,A01,083207,Lim; Seonhee,8,0,34,26
1657773377027,MATH 10B,A02,083208,Lim; Seonhee,9,0,35,26
1657773377027,MATH 10B,A03,093472,Lim; Seonhee,7,0,34,27
1657773377027,MATH 10B,B01,083739,Sinha; Shubham,13,0,30,17
1657773383061,MATH 18,A01,083743,Cinel; Cameron Alexander,9,0,30,21
1657773383061,MATH 18,A02,083744,Cinel; Cameron Alexander,18,0,30,12
1657773383061,MATH 18,A03,083745,Cinel; Cameron Alexander,10,0,30,20
1657773383061,MATH 18,B01,083748,Rideout; David Porter,5,0,37,32
1657773383061,MATH 18,B02,083749,Rideout; David Porter,5,0,36,31
1657773383061,MATH 18,B03,083750,Rideout; David Porter,3,0,37,34
1657773383061,MATH 18,B04,083751,Rideout; David Porter,6,0,36,30
1657773383061,MATH 18,B05,093473,Rideout; David Porter,6,0,36,30
1657773383061,MATH 18,B06,093474,Rideout; David Porter,6,0,36,30
1657773389088,MATH 20A,A01,083754,Zheng; Zequn,14,0,40,26
1657773395123,MATH 20B,A01,083756,Briones; Jor-el Thomas Caparas,4,0,36,32
1657773395123,MATH 20B,A02,083757,Briones; Jor-el Thomas Caparas,1,0,36,35
1657773395123,MATH 20B,A03,093475,Briones; Jor-el Thomas Caparas,2,0,36,34
1657773401157,MATH 20C,A01,083760,Briones; Jor-el Thomas Caparas,1,0,35,34
1657773401157,MATH 20C,A02,083761,Briones; Jor-el Thomas Caparas,8,0,35,27
1657773401157,MATH 20C,A03,093476,Briones; Jor-el Thomas Caparas,0,1,36,36
1657773401157,MATH 20C,B01,083762,Bach; Quang Tran,1,0,30,29
1657773407217,MATH 20D,A01,083765,Tran; Brian Kha,5,0,30,25
1657773407217,MATH 20D,A02,083766,Tran; Brian Kha,5,0,30,25
1657773407217,MATH 20D,A03,083767,Tran; Brian Kha,5,0,30,25
1657773413240,MATH 20E,A01,083771,Ganguly; Soumya,9,0,32,23
1657773413240,MATH 20E,A02,083772,Ganguly; Soumya,6,0,32,26
1657773413240,MATH 20E,B01,083773,Ciotti; Benjamin,20,0,35,15
1657773413240,MATH 20E,B02,083774,Ciotti; Benjamin,18,0,35,17
1657773419264,MATH 103A,A01,083777,Greenfeld; Be'Eri,3,0,36,33
1657773419264,MATH 103A,A02,083778,Greenfeld; Be'Eri,5,0,36,31
1657773419264,MATH 103A,A03,093561,Greenfeld; Be'Eri,6,0,36,30
1657773419264,MATH 103A,B01,083779,Greenfeld; Be'Eri,7,0,36,29
1657773419264,MATH 103A,B02,083780,Greenfeld; Be'Eri,4,0,36,32
1657773419264,MATH 103A,B03,093562,Greenfeld; Be'Eri,3,0,36,33
1657773425293,MATH 105,A01,085443,Carter; Anne Toulson,15,0,35,20
1657773425293,MATH 105,A02,093477,Carter; Anne Toulson,20,0,35,15
1657773431319,MATH 109,A01,083213,Ganzberger; Geoffrey Michael,3,0,34,31
1657773431319,MATH 109,A02,083214,Ganzberger; Geoffrey Michael,4,0,34,30
1657773431319,MATH 109,A03,093478,Ganzberger; Geoffrey Michael,2,0,34,32
1657773431319,MATH 109,B01,083215,Ganzberger; Geoffrey Michael,1,0,32,31
1657773431319,MATH 109,B02,083216,Ganzberger; Geoffrey Michael,2,0,32,30
1657773431319,MATH 109,B03,093479,Ganzberger; Geoffrey Michael,8,0,32,24
1657773437342,MATH 142A,A01,083219,Chow; Bennett,7,0,32,25
1657773437342,MATH 142A,A02,083220,Chow; Bennett,10,0,32,22
1657773437342,MATH 142A,A03,093480,Chow; Bennett,9,0,32,23
1657773437342,MATH 142A,B03,093481,Chow; Bennett,8,0,32,24
1657773437342,MATH 142A,B04,093558,Chow; Bennett,13,0,32,19
1657773437342,MATH 142A,B05,093559,Chow; Bennett,6,0,32,26
1657773443364,MATH 193A,A01,083224,Rotar; Vladimir,8,0,34,26
1657773443364,MATH 193A,A02,083225,Rotar; Vladimir,9,0,34,25
1657773443364,MATH 193A,A03,083781,Rotar; Vladimir,5,0,34,29
1657773443364,MATH 193A,A04,083782,Rotar; Vladimir,10,0,34,24
1657773443364,MATH 193A,A05,093482,Rotar; Vladimir,10,0,34,24
1657773449387,MATH 197,001,091859,McAuley; Julian John,9999,0,9999,0
1657773449387,MATH 197,002,095566,Kedlaya; Kiran S.,9997,0,9999,2
1657773449387,MATH 197,003,095567,Xiao; Ming,9999,0,9999,0
1657773449387,MATH 197,004,095571,Perols; Johan Lars,9998,0,9999,1
1657773456445,COGS 9,A01,083615,Shannon; Kyle Michael,9,0,75,66
1657773462475,COGS 11,A01,083617,Boyle; Mary E. T.,23,0,48,25
1657773468501,COGS 13,A01,083071,Bastos; Amalia Pinkusfeld,11,0,71,60
1657773474524,COGS 14A,A01,092681,Semenuks; Arturs,5,1,100,95
1657773480559,COGS 14B,A01,083073,Cheng; Tzu-Han,6,0,63,57
1657773486584,COGS 17,A01,092677,Semenuks; Arturs,6,0,81,75
1657773492607,COGS 100,A01,083619,Allen; Michael Gordon,17,0,70,53
1657773498634,COGS 101A,A01,083621,Davis; Joshua Daniel,9,0,68,59
1657773504656,COGS 101B,A01,091572,Allen; Michael Gordon,12,0,65,53
1657773510680,COGS 101C,A01,083625,Delgado; Tania,17,0,35,18
1657773516721,COGS 107A,A01,083627,Boyle; Mary E. T.,14,0,60,46
1657773522744,COGS 118A,A01,083075,Gupta; Anjum,21,0,76,55
1657773528772,CSE 3,A50,083646,Miranda; Gregory Joseph,24,0,50,26
1657773534801,CSE 8A,A50,083650,Miranda; Gregory Joseph,17,1,56,39
1657773540824,CSE 11,A01,083080,Cao; Yingjun,6,15,40,34
1657773546851,CSE 12,A01,083652,Krause-Levy; Sophia Louisa,28,1,120,92
1657773552878,CSE 15L,A01,083654,Morris; Justin Loren,9,0,50,41
1657773552878,CSE 15L,A02,083655,Morris; Justin Loren,9,0,50,41
1657773558906,CSE 20,A01,083657,Tran; Khoa Dang,39,0,80,41
1657773564928,CSE 21,A01,095574,Bach; Quang Tran,22,0,48,26
1657773570955,CSE 30,A01,083084,Eldon; John,6,0,80,74
1657773570955,CSE 30,B01,095061,Bhaskar; Nishant,9,0,50,41
1657773576980,CSE 100,A01,083659,Cao; Yingjun,5,4,70,65
1657773583003,CSE 134B,A01,083661,Powell; Thomas Allan,24,0,100,76
1657773589040,CSE 140,A01,083663,Gungor; Onat,15,0,85,70
1657773595063,CSE 140L,A01,083088,Eldon; John,23,0,100,77
1657773601085,CSE 175,A01,083665,Kumar; Rakesh,3,0,25,22
1657773607108,CSE 190,A00,092507,Dubnov; Shlomo,8,0,20,12
1657773613203,ECE 45,A01,083139,Congero; Spencer William,6,0,75,69
1657773619225,ECE 65,A50,083695,Saad; Andrew S,12,0,30,18
1657773619225,ECE 65,A51,095125,Saad; Andrew S,24,0,26,2
1657773625252,ECE 109,A01,091882,Touri; Behrouz,20,0,70,50
1657773631277,ECE 180,A00,083140,Abi Samra; Nicholas Camill,1,0,30,29
1657773631277,ECE 180,B00,083141,Abi Samra; Nicholas Camill,0,0,30,30
1657773637300,MATH 10A,A01,083735,Patchell; Gregory David,2,0,30,28
1657773637300,MATH 10A,A02,083736,Patchell; Gregory David,20,0,30,10
1657773637300,MATH 10A,A03,083737,Patchell; Gregory David,16,0,30,14
1657773643322,MATH 10B,A01,083207,Lim; Seonhee,8,0,34,26
1657773643322,MATH 10B,A02,083208,Lim; Seonhee,9,0,35,26
1657773643322,MATH 10B,A03,093472,Lim; Seonhee,7,0,34,27
1657773643322,MATH 10B,B01,083739,Sinha; Shubham,13,0,30,17
1657773649345,MATH 18,A01,083743,Cinel; Cameron Alexander,9,0,30,21
1657773649345,MATH 18,A02,083744,Cinel; Cameron Alexander,18,0,30,12
1657773649345,MATH 18,A03,083745,Cinel; Cameron Alexander,10,0,30,20
1657773649345,MATH 18,B01,083748,Rideout; David Porter,5,0,37,32
1657773649345,MATH 18,B02,083749,Rideout; David Porter,5,0,36,31
1657773649345,MATH 18,B03,083750,Rideout; David Porter,3,0,37,34
1657773649345,MATH 18,B04,083751,Rideout; David Porter,6,0,36,30
1657773649345,MATH 18,B05,093473,Rideout; David Porter,6,0,36,30
1657773649345,MATH 18,B06,093474,Rideout; David Porter,6,0,36,30
1657773655372,MATH 20A,A01,083754,Zheng; Zequn,14,0,40,26
1657773661398,MATH 20B,A01,083756,Briones; Jor-el Thomas Caparas,4,0,36,32
1657773661398,MATH 20B,A02,083757,Briones; Jor-el Thomas Caparas,1,0,36,35
1657773661398,MATH 20B,A03,093475,Briones; Jor-el Thomas Caparas,2,0,36,34
1657773667421,MATH 20C,A01,083760,Briones; Jor-el Thomas Caparas,1,0,35,34
1657773667421,MATH 20C,A02,083761,Briones; Jor-el Thomas Caparas,8,0,35,27
1657773667421,MATH 20C,A03,093476,Briones; Jor-el Thomas Caparas,0,1,36,36
1657773667421,MATH 20C,B01,083762,Bach; Quang Tran,1,0,30,29
1657773673448,MATH 20D,A01,083765,Tran; Brian Kha,5,0,30,25
1657773673448,MATH 20D,A02,083766,Tran; Brian Kha,5,0,30,25
1657773673448,MATH 20D,A03,083767,Tran; Brian Kha,5,0,30,25
1657773679473,MATH 20E,A01,083771,Ganguly; Soumya,9,0,32,23
1657773679473,MATH 20E,A02,083772,Ganguly; Soumya,6,0,32,26
1657773679473,MATH 20E,B01,083773,Ciotti; Benjamin,20,0,35,15
1657773679473,MATH 20E,B02,083774,Ciotti; Benjamin,18,0,35,17
1657773685498,MATH 103A,A01,083777,Greenfeld; Be'Eri,3,0,36,33
1657773685498,MATH 103A,A02,083778,Greenfeld; Be'Eri,5,0,36,31
1657773685498,MATH 103A,A03,093561,Greenfeld; Be'Eri,6,0,36,30
1657773685498,MATH 103A,B01,083779,Greenfeld; Be'Eri,7,0,36,29
1657773685498,MATH 103A,B02,083780,Greenfeld; Be'Eri,4,0,36,32
1657773685498,MATH 103A,B03,093562,Greenfeld; Be'Eri,3,0,36,33
1657773691521,MATH 105,A01,085443,Carter; Anne Toulson,15,0,35,20
1657773691521,MATH 105,A02,093477,Carter; Anne Toulson,20,0,35,15
1657773697549,MATH 109,A01,083213,Ganzberger; Geoffrey Michael,3,0,34,31
1657773697549,MATH 109,A02,083214,Ganzberger; Geoffrey Michael,4,0,34,30
1657773697549,MATH 109,A03,093478,Ganzberger; Geoffrey Michael,2,0,34,32
1657773697549,MATH 109,B01,083215,Ganzberger; Geoffrey Michael,1,0,32,31
1657773697549,MATH 109,B02,083216,Ganzberger; Geoffrey Michael,2,0,32,30
1657773697549,MATH 109,B03,093479,Ganzberger; Geoffrey Michael,8,0,32,24
1657773703578,MATH 142A,A01,083219,Chow; Bennett,7,0,32,25
1657773703578,MATH 142A,A02,083220,Chow; Bennett,10,0,32,22
1657773703578,MATH 142A,A03,093480,Chow; Bennett,9,0,32,23
1657773703578,MATH 142A,B03,093481,Chow; Bennett,8,0,32,24
1657773703578,MATH 142A,B04,093558,Chow; Bennett,13,0,32,19
1657773703578,MATH 142A,B05,093559,Chow; Bennett,6,0,32,26
1657773709605,MATH 193A,A01,083224,Rotar; Vladimir,8,0,34,26
1657773709605,MATH 193A,A02,083225,Rotar; Vladimir,9,0,34,25
1657773709605,MATH 193A,A03,083781,Rotar; Vladimir,5,0,34,29
1657773709605,MATH 193A,A04,083782,Rotar; Vladimir,10,0,34,24
1657773709605,MATH 193A,A05,093482,Rotar; Vladimir,10,0,34,24
1657773715627,MATH 197,001,091859,McAuley; Julian John,9999,0,9999,0
1657773715627,MATH 197,002,095566,Kedlaya; Kiran S.,9997,0,9999,2
1657773715627,MATH 197,003,095567,Xiao; Ming,9999,0,9999,0
1657773715627,MATH 197,004,095571,Perols; Johan Lars,9998,0,9999,1
1657773722679,COGS 9,A01,083615,Shannon; Kyle Michael,9,0,75,66
1657773728713,COGS 11,A01,083617,Boyle; Mary E. T.,23,0,48,25
1657773734738,COGS 13,A01,083071,Bastos; Amalia Pinkusfeld,11,0,71,60
1657773740760,COGS 14A,A01,092681,Semenuks; Arturs,5,1,100,95
1657773746784,COGS 14B,A01,083073,Cheng; Tzu-Han,6,0,63,57
1657773752811,COGS 17,A01,092677,Semenuks; Arturs,6,0,81,75
1657773758838,COGS 100,A01,083619,Allen; Michael Gordon,17,0,70,53
1657773764861,COGS 101A,A01,083621,Davis; Joshua Daniel,9,0,68,59
1657773770884,COGS 101B,A01,091572,Allen; Michael Gordon,12,0,65,53
1657773776909,COGS 101C,A01,083625,Delgado; Tania,17,0,35,18
1657773782936,COGS 107A,A01,083627,Boyle; Mary E. T.,14,0,60,46
1657773788960,COGS 118A,A01,083075,Gupta; Anjum,21,0,76,55
1657773794988,CSE 3,A50,083646,Miranda; Gregory Joseph,24,0,50,26
1657773801015,CSE 8A,A50,083650,Miranda; Gregory Joseph,17,1,56,39
1657773807041,CSE 11,A01,083080,Cao; Yingjun,6,15,40,34
1657773813066,CSE 12,A01,083652,Krause-Levy; Sophia Louisa,28,1,120,92
1657773819091,CSE 15L,A01,083654,Morris; Justin Loren,9,0,50,41
1657773819091,CSE 15L,A02,083655,Morris; Justin Loren,9,0,50,41
1657773825117,CSE 20,A01,083657,Tran; Khoa Dang,39,0,80,41
1657773831146,CSE 21,A01,095574,Bach; Quang Tran,22,0,48,26
1657773837169,CSE 30,A01,083084,Eldon; John,6,0,80,74
1657773837169,CSE 30,B01,095061,Bhaskar; Nishant,9,0,50,41
1657773843192,CSE 100,A01,083659,Cao; Yingjun,5,4,70,65
1657773849219,CSE 134B,A01,083661,Powell; Thomas Allan,24,0,100,76
1657773855244,CSE 140,A01,083663,Gungor; Onat,15,0,85,70
1657773861280,CSE 140L,A01,083088,Eldon; John,23,0,100,77
1657773867303,CSE 175,A01,083665,Kumar; Rakesh,3,0,25,22
1657773873328,CSE 190,A00,092507,Dubnov; Shlomo,8,0,20,12
1657773879350,ECE 45,A01,083139,Congero; Spencer William,6,0,75,69
1657773885385,ECE 65,A50,083695,Saad; Andrew S,12,0,30,18
1657773885385,ECE 65,A51,095125,Saad; Andrew S,24,0,26,2
1657773891408,ECE 109,A01,091882,Touri; Behrouz,20,0,70,50
1657773897431,ECE 180,A00,083140,Abi Samra; Nicholas Camill,1,0,30,29
1657773897431,ECE 180,B00,083141,Abi Samra; Nicholas Camill,0,0,30,30
1657773903454,MATH 10A,A01,083735,Patchell; Gregory David,2,0,30,28
1657773903454,MATH 10A,A02,083736,Patchell; Gregory David,20,0,30,10
1657773903454,MATH 10A,A03,083737,Patchell; Gregory David,16,0,30,14
1657773909477,MATH 10B,A01,083207,Lim; Seonhee,8,0,34,26
1657773909477,MATH 10B,A02,083208,Lim; Seonhee,9,0,35,26
1657773909477,MATH 10B,A03,093472,Lim; Seonhee,7,0,34,27
1657773909477,MATH 10B,B01,083739,Sinha; Shubham,13,0,30,17
1657773915508,MATH 18,A01,083743,Cinel; Cameron Alexander,9,0,30,21
1657773915508,MATH 18,A02,083744,Cinel; Cameron Alexander,18,0,30,12
1657773915508,MATH 18,A03,083745,Cinel; Cameron Alexander,10,0,30,20
1657773915508,MATH 18,B01,083748,Rideout; David Porter,5,0,37,32
1657773915508,MATH 18,B02,083749,Rideout; David Porter,5,0,36,31
1657773915508,MATH 18,B03,083750,Rideout; David Porter,3,0,37,34
1657773915508,MATH 18,B04,083751,Rideout; David Porter,6,0,36,30
1657773915508,MATH 18,B05,093473,Rideout; David Porter,6,0,36,30
1657773915508,MATH 18,B06,093474,Rideout; David Porter,6,0,36,30
1657773921535,MATH 20A,A01,083754,Zheng; Zequn,14,0,40,26
1657773927560,MATH 20B,A01,083756,Briones; Jor-el Thomas Caparas,4,0,36,32
1657773927560,MATH 20B,A02,083757,Briones; Jor-el Thomas Caparas,1,0,36,35
1657773927560,MATH 20B,A03,093475,Briones; Jor-el Thomas Caparas,2,0,36,34
1657773933589,MATH 20C,A01,083760,Briones; Jor-el Thomas Caparas,1,0,35,34
1657773933589,MATH 20C,A02,083761,Briones; Jor-el Thomas Caparas,8,0,35,27
1657773933589,MATH 20C,A03,093476,Briones; Jor-el Thomas Caparas,0,1,36,36
1657773933589,MATH 20C,B01,083762,Bach; Quang Tran,1,0,30,29
1657773939618,MATH 20D,A01,083765,Tran; Brian Kha,5,0,30,25
1657773939618,MATH 20D,A02,083766,Tran; Brian Kha,5,0,30,25
1657773939618,MATH 20D,A03,083767,Tran; Brian Kha,5,0,30,25
1657773945645,MATH 20E,A01,083771,Ganguly; Soumya,9,0,32,23
1657773945645,MATH 20E,A02,083772,Ganguly; Soumya,6,0,32,26
1657773945645,MATH 20E,B01,083773,Ciotti; Benjamin,20,0,35,15
1657773945645,MATH 20E,B02,083774,Ciotti; Benjamin,18,0,35,17
1657773951673,MATH 103A,A01,083777,Greenfeld; Be'Eri,3,0,36,33
1657773951673,MATH 103A,A02,083778,Greenfeld; Be'Eri,5,0,36,31
1657773951673,MATH 103A,A03,093561,Greenfeld; Be'Eri,6,0,36,30
1657773951673,MATH 103A,B01,083779,Greenfeld; Be'Eri,7,0,36,29
1657773951673,MATH 103A,B02,083780,Greenfeld; Be'Eri,4,0,36,32
1657773951673,MATH 103A,B03,093562,Greenfeld; Be'Eri,3,0,36,33
1657773957702,MATH 105,A01,085443,Carter; Anne Toulson,15,0,35,20
1657773957702,MATH 105,A02,093477,Carter; Anne Toulson,20,0,35,15
1657773963725,MATH 109,A01,083213,Ganzberger; Geoffrey Michael,3,0,34,31
1657773963725,MATH 109,A02,083214,Ganzberger; Geoffrey Michael,4,0,34,30
1657773963725,MATH 109,A03,093478,Ganzberger; Geoffrey Michael,2,0,34,32
1657773963725,MATH 109,B01,083215,Ganzberger; Geoffrey Michael,1,0,32,31
1657773963725,MATH 109,B02,083216,Ganzberger; Geoffrey Michael,2,0,32,30
1657773963725,MATH 109,B03,093479,Ganzberger; Geoffrey Michael,8,0,32,24
1657773969765,MATH 142A,A01,083219,Chow; Bennett,7,0,32,25
1657773969765,MATH 142A,A02,083220,Chow; Bennett,10,0,32,22
1657773969765,MATH 142A,A03,093480,Chow; Bennett,9,0,32,23
1657773969765,MATH 142A,B03,093481,Chow; Bennett,8,0,32,24
1657773969765,MATH 142A,B04,093558,Chow; Bennett,13,0,32,19
1657773969765,MATH 142A,B05,093559,Chow; Bennett,6,0,32,26
1657773975794,MATH 193A,A01,083224,Rotar; Vladimir,8,0,34,26
1657773975794,MATH 193A,A02,083225,Rotar; Vladimir,9,0,34,25
1657773975794,MATH 193A,A03,083781,Rotar; Vladimir,5,0,34,29
1657773975794,MATH 193A,A04,083782,Rotar; Vladimir,10,0,34,24
1657773975794,MATH 193A,A05,093482,Rotar; Vladimir,10,0,34,24
1657773981818,MATH 197,001,091859,McAuley; Julian John,9999,0,9999,0
1657773981818,MATH 197,002,095566,Kedlaya; Kiran S.,9997,0,9999,2
1657773981818,MATH 197,003,095567,Xiao; Ming,9999,0,9999,0
1657773981818,MATH 197,004,095571,Perols; Johan Lars,9998,0,9999,1
1657773988867,COGS 9,A01,083615,Shannon; Kyle Michael,9,0,75,66
1657773994891,COGS 11,A01,083617,Boyle; Mary E. T.,23,0,48,25
1657774000920,COGS 13,A01,083071,Bastos; Amalia Pinkusfeld,11,0,71,60
1657774006946,COGS 14A,A01,092681,Semenuks; Arturs,5,1,100,95
1657774012973,COGS 14B,A01,083073,Cheng; Tzu-Han,6,0,63,57
1657774019000,COGS 17,A01,092677,Semenuks; Arturs,6,0,81,75
1657774025022,COGS 100,A01,083619,Allen; Michael Gordon,17,0,70,53
1657774031046,COGS 101A,A01,083621,Davis; Joshua Daniel,9,0,68,59
1657774037075,COGS 101B,A01,091572,Allen; Michael Gordon,12,0,65,53
1657774043102,COGS 101C,A01,083625,Delgado; Tania,17,0,35,18
1657774049136,COGS 107A,A01,083627,Boyle; Mary E. T.,14,0,60,46
1657774055160,COGS 118A,A01,083075,Gupta; Anjum,21,0,76,55
1657774061187,CSE 3,A50,083646,Miranda; Gregory Joseph,24,0,50,26
1657774067221,CSE 8A,A50,083650,Miranda; Gregory Joseph,17,1,56,39
1657774073257,CSE 11,A01,083080,Cao; Yingjun,6,15,40,34
1657774079281,CSE 12,A01,083652,Krause-Levy; Sophia Louisa,28,1,120,92
1657774085303,CSE 15L,A01,083654,Morris; Justin Loren,9,0,50,41
1657774085303,CSE 15L,A02,083655,Morris; Justin Loren,9,0,50,41
1657774091326,CSE 20,A01,083657,Tran; Khoa Dang,39,0,80,41
1657774097349,CSE 21,A01,095574,Bach; Quang Tran,22,0,48,26
1657774103376,CSE 30,A01,083084,Eldon; John,6,0,80,74
1657774103376,CSE 30,B01,095061,Bhaskar; Nishant,9,0,50,41
1657774109414,CSE 100,A01,083659,Cao; Yingjun,5,4,70,65
1657774115449,CSE 134B,A01,083661,Powell; Thomas Allan,24,0,100,76
1657774121476,CSE 140,A01,083663,Gungor; Onat,15,0,85,70
1657774127500,CSE 140L,A01,083088,Eldon; John,23,0,100,77
1657774133526,CSE 175,A01,083665,Kumar; Rakesh,3,0,25,22
1657774139553,CSE 190,A00,092507,Dubnov; Shlomo,8,0,20,12
1657774145580,ECE 45,A01,083139,Congero; Spencer William,6,0,75,69
1657774151603,ECE 65,A50,083695,Saad; Andrew S,12,0,30,18
1657774151603,ECE 65,A51,095125,Saad; Andrew S,24,0,26,2
1657774157629,ECE 109,A01,091882,Touri; Behrouz,20,0,70,50
1657774163653,ECE 180,A00,083140,Abi Samra; Nicholas Camill,1,0,30,29
1657774163653,ECE 180,B00,083141,Abi Samra; Nicholas Camill,0,0,30,30
1657774169675,MATH 10A,A01,083735,Patchell; Gregory David,2,0,30,28
1657774169675,MATH 10A,A02,083736,Patchell; Gregory David,20,0,30,10
1657774169675,MATH 10A,A03,083737,Patchell; Gregory David,16,0,30,14
1657774175697,MATH 10B,A01,083207,Lim; Seonhee,8,0,34,26
1657774175697,MATH 10B,A02,083208,Lim; Seonhee,9,0,35,26
1657774175697,MATH 10B,A03,093472,Lim; Seonhee,7,0,34,27
1657774175697,MATH 10B,B01,083739,Sinha; Shubham,13,0,30,17
1657774181730,MATH 18,A01,083743,Cinel; Cameron Alexander,9,0,30,21
1657774181730,MATH 18,A02,083744,Cinel; Cameron Alexander,18,0,30,12
1657774181730,MATH 18,A03,083745,Cinel; Cameron Alexander,10,0,30,20
1657774181730,MATH 18,B01,083748,Rideout; David Porter,5,0,37,32
1657774181730,MATH 18,B02,083749,Rideout; David Porter,5,0,36,31
1657774181730,MATH 18,B03,083750,Rideout; David Porter,3,0,37,34
1657774181730,MATH 18,B04,083751,Rideout; David Porter,6,0,36,30
1657774181730,MATH 18,B05,093473,Rideout; David Porter,6,0,36,30
1657774181730,MATH 18,B06,093474,Rideout; David Porter,6,0,36,30
1657774187757,MATH 20A,A01,083754,Zheng; Zequn,14,0,40,26
1657774193780,MATH 20B,A01,083756,Briones; Jor-el Thomas Caparas,4,0,36,32
1657774193780,MATH 20B,A02,083757,Briones; Jor-el Thomas Caparas,1,0,36,35
1657774193780,MATH 20B,A03,093475,Briones; Jor-el Thomas Caparas,2,0,36,34
1657774199805,MATH 20C,A01,083760,Briones; Jor-el Thomas Caparas,1,0,35,34
1657774199805,MATH 20C,A02,083761,Briones; Jor-el Thomas Caparas,8,0,35,27
1657774199805,MATH 20C,A03,093476,Briones; Jor-el Thomas Caparas,0,1,36,36
1657774199805,MATH 20C,B01,083762,Bach; Quang Tran,1,0,30,29
1657774205828,MATH 20D,A01,083765,Tran; Brian Kha,5,0,30,25
1657774205828,MATH 20D,A02,083766,Tran; Brian Kha,5,0,30,25
1657774205828,MATH 20D,A03,083767,Tran; Brian Kha,5,0,30,25
1657774211933,MATH 20E,A01,083771,Ganguly; Soumya,9,0,32,23
1657774211933,MATH 20E,A02,083772,Ganguly; Soumya,6,0,32,26
1657774211933,MATH 20E,B01,083773,Ciotti; Benjamin,20,0,35,15
1657774211933,MATH 20E,B02,083774,Ciotti; Benjamin,18,0,35,17
1657774217963,MATH 103A,A01,083777,Greenfeld; Be'Eri,3,0,36,33
1657774217963,MATH 103A,A02,083778,Greenfeld; Be'Eri,5,0,36,31
1657774217963,MATH 103A,A03,093561,Greenfeld; Be'Eri,6,0,36,30
1657774217963,MATH 103A,B01,083779,Greenfeld; Be'Eri,7,0,36,29
1657774217963,MATH 103A,B02,083780,Greenfeld; Be'Eri,4,0,36,32
1657774217963,MATH 103A,B03,093562,Greenfeld; Be'Eri,3,0,36,33
1657774223985,MATH 105,A01,085443,Carter; Anne Toulson,15,0,35,20
1657774223985,MATH 105,A02,093477,Carter; Anne Toulson,20,0,35,15
1657774230015,MATH 109,A01,083213,Ganzberger; Geoffrey Michael,3,0,34,31
1657774230015,MATH 109,A02,083214,Ganzberger; Geoffrey Michael,4,0,34,30
1657774230015,MATH 109,A03,093478,Ganzberger; Geoffrey Michael,2,0,34,32
1657774230015,MATH 109,B01,083215,Ganzberger; Geoffrey Michael,1,0,32,31
1657774230015,MATH 109,B02,083216,Ganzberger; Geoffrey Michael,2,0,32,30
1657774230015,MATH 109,B03,093479,Ganzberger; Geoffrey Michael,8,0,32,24
1657774236043,MATH 142A,A01,083219,Chow; Bennett,7,0,32,25
1657774236043,MATH 142A,A02,083220,Chow; Bennett,10,0,32,22
1657774236043,MATH 142A,A03,093480,Chow; Bennett,9,0,32,23
1657774236043,MATH 142A,B03,093481,Chow; Bennett,8,0,32,24
1657774236043,MATH 142A,B04,093558,Chow; Bennett,13,0,32,19
1657774236043,MATH 142A,B05,093559,Chow; Bennett,6,0,32,26
1657774242070,MATH 193A,A01,083224,Rotar; Vladimir,8,0,34,26
1657774242070,MATH 193A,A02,083225,Rotar; Vladimir,9,0,34,25
1657774242070,MATH 193A,A03,083781,Rotar; Vladimir,5,0,34,29
1657774242070,MATH 193A,A04,083782,Rotar; Vladimir,10,0,34,24
1657774242070,MATH 193A,A05,093482,Rotar; Vladimir,10,0,34,24
1657774248096,MATH 197,001,091859,McAuley; Julian John,9999,0,9999,0
1657774248096,MATH 197,002,095566,Kedlaya; Kiran S.,9997,0,9999,2
1657774248096,MATH 197,003,095567,Xiao; Ming,9999,0,9999,0
1657774248096,MATH 197,004,095571,Perols; Johan Lars,9998,0,9999,1
1657774255154,COGS 9,A01,083615,Shannon; Kyle Michael,9,0,75,66
1657774261193,COGS 11,A01,083617,Boyle; Mary E. T.,23,0,48,25
1657774267219,COGS 13,A01,083071,Bastos; Amalia Pinkusfeld,11,0,71,60
1657774273249,COGS 14A,A01,092681,Semenuks; Arturs,5,1,100,95
1657774279271,COGS 14B,A01,083073,Cheng; Tzu-Han,6,0,63,57
1657774285295,COGS 17,A01,092677,Semenuks; Arturs,6,0,81,75
1657774291320,COGS 100,A01,083619,Allen; Michael Gordon,17,0,70,53
1657774297344,COGS 101A,A01,083621,Davis; Joshua Daniel,9,0,68,59
1657774303368,COGS 101B,A01,091572,Allen; Michael Gordon,12,0,65,53
1657774309395,COGS 101C,A01,083625,Delgado; Tania,17,0,35,18
1657774315418,COGS 107A,A01,083627,Boyle; Mary E. T.,14,0,60,46
1657774321460,COGS 118A,A01,083075,Gupta; Anjum,21,0,76,55
1657774327484,CSE 3,A50,083646,Miranda; Gregory Joseph,24,0,50,26
1657774333512,CSE 8A,A50,083650,Miranda; Gregory Joseph,17,1,56,39
1657774339540,CSE 11,A01,083080,Cao; Yingjun,6,15,40,34
1657774345564,CSE 12,A01,083652,Krause-Levy; Sophia Louisa,28,1,120,92
1657774351589,CSE 15L,A01,083654,Morris; Justin Loren,9,0,50,41
1657774351589,CSE 15L,A02,083655,Morris; Justin Loren,9,0,50,41
1657774357618,CSE 20,A01,083657,Tran; Khoa Dang,39,0,80,41
1657774363640,CSE 21,A01,095574,Bach; Quang Tran,22,0,48,26
1657774369670,CSE 30,A01,083084,Eldon; John,6,0,80,74
1657774369670,CSE 30,B01,095061,Bhaskar; Nishant,9,0,50,41
1657774375702,CSE 100,A01,083659,Cao; Yingjun,5,4,70,65
1657774381741,CSE 134B,A01,083661,Powell; Thomas Allan,24,0,100,76
1657774387764,CSE 140,A01,083663,Gungor; Onat,15,0,85,70
1657774393789,CSE 140L,A01,083088,Eldon; John,23,0,100,77
1657774399814,CSE 175,A01,083665,Kumar; Rakesh,3,0,25,22
1657774405839,CSE 190,A00,092507,Dubnov; Shlomo,8,0,20,12
1657774411866,ECE 45,A01,083139,Congero; Spencer William,6,0,75,69
1657774417892,ECE 65,A50,083695,Saad; Andrew S,12,0,30,18
1657774417892,ECE 65,A51,095125,Saad; Andrew S,24,0,26,2
1657774423918,ECE 109,A01,091882,Touri; Behrouz,20,0,70,50
1657774429945,ECE 180,A00,083140,Abi Samra; Nicholas Camill,1,0,30,29
1657774429945,ECE 180,B00,083141,Abi Samra; Nicholas Camill,0,0,30,30
1657774435970,MATH 10A,A01,083735,Patchell; Gregory David,2,0,30,28
1657774435970,MATH 10A,A02,083736,Patchell; Gregory David,20,0,30,10
1657774435970,MATH 10A,A03,083737,Patchell; Gregory David,16,0,30,14
1657774441999,MATH 10B,A01,083207,Lim; Seonhee,8,0,34,26
1657774441999,MATH 10B,A02,083208,Lim; Seonhee,9,0,35,26
1657774441999,MATH 10B,A03,093472,Lim; Seonhee,7,0,34,27
1657774441999,MATH 10B,B01,083739,Sinha; Shubham,13,0,30,17
1657774448023,MATH 18,A01,083743,Cinel; Cameron Alexander,9,0,30,21
1657774448023,MATH 18,A02,083744,Cinel; Cameron Alexander,18,0,30,12
1657774448023,MATH 18,A03,083745,Cinel; Cameron Alexander,10,0,30,20
1657774448023,MATH 18,B01,083748,Rideout; David Porter,5,0,37,32
1657774448023,MATH 18,B02,083749,Rideout; David Porter,5,0,36,31
1657774448023,MATH 18,B03,083750,Rideout; David Porter,3,0,37,34
1657774448023,MATH 18,B04,083751,Rideout; David Porter,6,0,36,30
1657774448023,MATH 18,B05,093473,Rideout; David Porter,6,0,36,30
1657774448023,MATH 18,B06,093474,Rideout; David Porter,6,0,36,30
1657774454052,MATH 20A,A01,083754,Zheng; Zequn,14,0,40,26
1657774460075,MATH 20B,A01,083756,Briones; Jor-el Thomas Caparas,4,0,36,32
1657774460075,MATH 20B,A02,083757,Briones; Jor-el Thomas Caparas,1,0,36,35
1657774460075,MATH 20B,A03,093475,Briones; Jor-el Thomas Caparas,2,0,36,34
1657774466099,MATH 20C,A01,083760,Briones; Jor-el Thomas Caparas,1,0,35,34
1657774466099,MATH 20C,A02,083761,Briones; Jor-el Thomas Caparas,8,0,35,27
1657774466099,MATH 20C,A03,093476,Briones; Jor-el Thomas Caparas,0,1,36,36
1657774466099,MATH 20C,B01,083762,Bach; Quang Tran,1,0,30,29
1657774472124,MATH 20D,A01,083765,Tran; Brian Kha,5,0,30,25
1657774472124,MATH 20D,A02,083766,Tran; Brian Kha,5,0,30,25
1657774472124,MATH 20D,A03,083767,Tran; Brian Kha,5,0,30,25
1657774478146,MATH 20E,A01,083771,Ganguly; Soumya,9,0,32,23
1657774478146,MATH 20E,A02,083772,Ganguly; Soumya,6,0,32,26
1657774478146,MATH 20E,B01,083773,Ciotti; Benjamin,20,0,35,15
1657774478146,MATH 20E,B02,083774,Ciotti; Benjamin,18,0,35,17
1657774484169,MATH 103A,A01,083777,Greenfeld; Be'Eri,3,0,36,33
1657774484169,MATH 103A,A02,083778,Greenfeld; Be'Eri,5,0,36,31
1657774484169,MATH 103A,A03,093561,Greenfeld; Be'Eri,6,0,36,30
1657774484169,MATH 103A,B01,083779,Greenfeld; Be'Eri,7,0,36,29
1657774484169,MATH 103A,B02,083780,Greenfeld; Be'Eri,4,0,36,32
1657774484169,MATH 103A,B03,093562,Greenfeld; Be'Eri,3,0,36,33
1657774490196,MATH 105,A01,085443,Carter; Anne Toulson,15,0,35,20
1657774490196,MATH 105,A02,093477,Carter; Anne Toulson,20,0,35,15
1657774496225,MATH 109,A01,083213,Ganzberger; Geoffrey Michael,3,0,34,31
1657774496225,MATH 109,A02,083214,Ganzberger; Geoffrey Michael,4,0,34,30
1657774496225,MATH 109,A03,093478,Ganzberger; Geoffrey Michael,2,0,34,32
1657774496225,MATH 109,B01,083215,Ganzberger; Geoffrey Michael,1,0,32,31
1657774496225,MATH 109,B02,083216,Ganzberger; Geoffrey Michael,2,0,32,30
1657774496225,MATH 109,B03,093479,Ganzberger; Geoffrey Michael,8,0,32,24
1657774502250,MATH 142A,A01,083219,Chow; Bennett,7,0,32,25
1657774502250,MATH 142A,A02,083220,Chow; Bennett,10,0,32,22
1657774502250,MATH 142A,A03,093480,Chow; Bennett,9,0,32,23
1657774502250,MATH 142A,B03,093481,Chow; Bennett,8,0,32,24
1657774502250,MATH 142A,B04,093558,Chow; Bennett,13,0,32,19
1657774502250,MATH 142A,B05,093559,Chow; Bennett,6,0,32,26
1657774508274,MATH 193A,A01,083224,Rotar; Vladimir,8,0,34,26
1657774508274,MATH 193A,A02,083225,Rotar; Vladimir,9,0,34,25
1657774508274,MATH 193A,A03,083781,Rotar; Vladimir,5,0,34,29
1657774508274,MATH 193A,A04,083782,Rotar; Vladimir,10,0,34,24
1657774508274,MATH 193A,A05,093482,Rotar; Vladimir,10,0,34,24
1657774514302,MATH 197,001,091859,McAuley; Julian John,9999,0,9999,0
1657774514302,MATH 197,002,095566,Kedlaya; Kiran S.,9997,0,9999,2
1657774514302,MATH 197,003,095567,Xiao; Ming,9999,0,9999,0
1657774514302,MATH 197,004,095571,Perols; Johan Lars,9998,0,9999,1
1657774521352,COGS 9,A01,083615,Shannon; Kyle Michael,9,0,75,66
1657774527376,COGS 11,A01,083617,Boyle; Mary E. T.,23,0,48,25
1657774533399,COGS 13,A01,083071,Bastos; Amalia Pinkusfeld,11,0,71,60
1657774539425,COGS 14A,A01,092681,Semenuks; Arturs,5,1,100,95
1657774545455,COGS 14B,A01,083073,Cheng; Tzu-Han,6,0,63,57
1657774551484,COGS 17,A01,092677,Semenuks; Arturs,6,0,81,75
1657774557510,COGS 100,A01,083619,Allen; Michael Gordon,17,0,70,53
1657774563538,COGS 101A,A01,083621,Davis; Joshua Daniel,9,0,68,59
1657774569564,COGS 101B,A01,091572,Allen; Michael Gordon,12,0,65,53
1657774575591,COGS 101C,A01,083625,Delgado; Tania,17,0,35,18
1657774581613,COGS 107A,A01,083627,Boyle; Mary E. T.,14,0,60,46
1657774587641,COGS 118A,A01,083075,Gupta; Anjum,21,0,76,55
1657774593670,CSE 3,A50,083646,Miranda; Gregory Joseph,24,0,50,26
1657774599692,CSE 8A,A50,083650,Miranda; Gregory Joseph,17,1,56,39
1657774605718,CSE 11,A01,083080,Cao; Yingjun,6,15,40,34
1657774611741,CSE 12,A01,083652,Krause-Levy; Sophia Louisa,28,1,120,92
1657774617768,CSE 15L,A01,083654,Morris; Justin Loren,9,0,50,41
1657774617768,CSE 15L,A02,083655,Morris; Justin Loren,9,0,50,41
1657774623790,CSE 20,A01,083657,Tran; Khoa Dang,39,0,80,41
1657774629815,CSE 21,A01,095574,Bach; Quang Tran,22,0,48,26
1657774635838,CSE 30,A01,083084,Eldon; John,6,0,80,74
1657774635838,CSE 30,B01,095061,Bhaskar; Nishant,9,0,50,41
1657774641861,CSE 100,A01,083659,Cao; Yingjun,5,4,70,65
1657774647884,CSE 134B,A01,083661,Powell; Thomas Allan,24,0,100,76
1657774653907,CSE 140,A01,083663,Gungor; Onat,15,0,85,70
1657774659930,CSE 140L,A01,083088,Eldon; John,23,0,100,77
1657774665963,CSE 175,A01,083665,Kumar; Rakesh,3,0,25,22
1657774671985,CSE 190,A00,092507,Dubnov; Shlomo,8,0,20,12
1657774678015,ECE 45,A01,083139,Congero; Spencer William,6,0,75,69
1657774684039,ECE 65,A50,083695,Saad; Andrew S,12,0,30,18
1657774684039,ECE 65,A51,095125,Saad; Andrew S,24,0,26,2
1657774690067,ECE 109,A01,091882,Touri; Behrouz,20,0,70,50
1657774696090,ECE 180,A00,083140,Abi Samra; Nicholas Camill,1,0,30,29
1657774696090,ECE 180,B00,083141,Abi Samra; Nicholas Camill,0,0,30,30
1657774702117,MATH 10A,A01,083735,Patchell; Gregory David,2,0,30,28
1657774702117,MATH 10A,A02,083736,Patchell; Gregory David,20,0,30,10
1657774702117,MATH 10A,A03,083737,Patchell; Gregory David,16,0,30,14
1657774708145,MATH 10B,A01,083207,Lim; Seonhee,8,0,34,26
1657774708145,MATH 10B,A02,083208,Lim; Seonhee,9,0,35,26
1657774708145,MATH 10B,A03,093472,Lim; Seonhee,7,0,34,27
1657774708145,MATH 10B,B01,083739,Sinha; Shubham,13,0,30,17
1657774714170,MATH 18,A01,083743,Cinel; Cameron Alexander,9,0,30,21
1657774714170,MATH 18,A02,083744,Cinel; Cameron Alexander,18,0,30,12
1657774714170,MATH 18,A03,083745,Cinel; Cameron Alexander,10,0,30,20
1657774714170,MATH 18,B01,083748,Rideout; David Porter,5,0,37,32
1657774714170,MATH 18,B02,083749,Rideout; David Porter,5,0,36,31
1657774714170,MATH 18,B03,083750,Rideout; David Porter,3,0,37,34
1657774714170,MATH 18,B04,083751,Rideout; David Porter,6,0,36,30
1657774714170,MATH 18,B05,093473,Rideout; David Porter,6,0,36,30
1657774714170,MATH 18,B06,093474,Rideout; David Porter,6,0,36,30
1657774720196,MATH 20A,A01,083754,Zheng; Zequn,14,0,40,26
1657774726223,MATH 20B,A01,083756,Briones; Jor-el Thomas Caparas,4,0,36,32
1657774726223,MATH 20B,A02,083757,Briones; Jor-el Thomas Caparas,1,0,36,35
1657774726223,MATH 20B,A03,093475,Briones; Jor-el Thomas Caparas,2,0,36,34
1657774732259,MATH 20C,A01,083760,Briones; Jor-el Thomas Caparas,1,0,35,34
1657774732259,MATH 20C,A02,083761,Briones; Jor-el Thomas Caparas,8,0,35,27
1657774732259,MATH 20C,A03,093476,Briones; Jor-el Thomas Caparas,0,1,36,36
1657774732259,MATH 20C,B01,083762,Bach; Quang Tran,1,0,30,29
1657774738287,MATH 20D,A01,083765,Tran; Brian Kha,5,0,30,25
1657774738287,MATH 20D,A02,083766,Tran; Brian Kha,5,0,30,25
1657774738287,MATH 20D,A03,083767,Tran; Brian Kha,5,0,30,25
1657774744310,MATH 20E,A01,083771,Ganguly; Soumya,9,0,32,23
1657774744310,MATH 20E,A02,083772,Ganguly; Soumya,6,0,32,26
1657774744310,MATH 20E,B01,083773,Ciotti; Benjamin,20,0,35,15
1657774744310,MATH 20E,B02,083774,Ciotti; Benjamin,18,0,35,17
1657774750337,MATH 103A,A01,083777,Greenfeld; Be'Eri,3,0,36,33
1657774750337,MATH 103A,A02,083778,Greenfeld; Be'Eri,5,0,36,31
1657774750337,MATH 103A,A03,093561,Greenfeld; Be'Eri,6,0,36,30
1657774750337,MATH 103A,B01,083779,Greenfeld; Be'Eri,7,0,36,29
1657774750337,MATH 103A,B02,083780,Greenfeld; Be'Eri,4,0,36,32
1657774750337,MATH 103A,B03,093562,Greenfeld; Be'Eri,3,0,36,33
1657774756367,MATH 105,A01,085443,Carter; Anne Toulson,15,0,35,20
1657774756367,MATH 105,A02,093477,Carter; Anne Toulson,20,0,35,15
1657774762391,MATH 109,A01,083213,Ganzberger; Geoffrey Michael,3,0,34,31
1657774762391,MATH 109,A02,083214,Ganzberger; Geoffrey Michael,4,0,34,30
1657774762391,MATH 109,A03,093478,Ganzberger; Geoffrey Michael,2,0,34,32
1657774762391,MATH 109,B01,083215,Ganzberger; Geoffrey Michael,1,0,32,31
1657774762391,MATH 109,B02,083216,Ganzberger; Geoffrey Michael,2,0,32,30
1657774762391,MATH 109,B03,093479,Ganzberger; Geoffrey Michael,8,0,32,24
1657774768416,MATH 142A,A01,083219,Chow; Bennett,7,0,32,25
1657774768416,MATH 142A,A02,083220,Chow; Bennett,10,0,32,22
1657774768416,MATH 142A,A03,093480,Chow; Bennett,9,0,32,23
1657774768416,MATH 142A,B03,093481,Chow; Bennett,8,0,32,24
1657774768416,MATH 142A,B04,093558,Chow; Bennett,13,0,32,19
1657774768416,MATH 142A,B05,093559,Chow; Bennett,6,0,32,26
1657774774440,MATH 193A,A01,083224,Rotar; Vladimir,8,0,34,26
1657774774440,MATH 193A,A02,083225,Rotar; Vladimir,9,0,34,25
1657774774440,MATH 193A,A03,083781,Rotar; Vladimir,5,0,34,29
1657774774440,MATH 193A,A04,083782,Rotar; Vladimir,10,0,34,24
1657774774440,MATH 193A,A05,093482,Rotar; Vladimir,10,0,34,24
1657774780462,MATH 197,001,091859,McAuley; Julian John,9999,0,9999,0
1657774780462,MATH 197,002,095566,Kedlaya; Kiran S.,9997,0,9999,2
1657774780462,MATH 197,003,095567,Xiao; Ming,9999,0,9999,0
1657774780462,MATH 197,004,095571,Perols; Johan Lars,9998,0,9999,1
1657774787544,COGS 9,A01,083615,Shannon; Kyle Michael,9,0,75,66
1657774793567,COGS 11,A01,083617,Boyle; Mary E. T.,23,0,48,25
1657774799595,COGS 13,A01,083071,Bastos; Amalia Pinkusfeld,11,0,71,60
1657774805694,COGS 14A,A01,092681,Semenuks; Arturs,5,1,100,95
1657774811724,COGS 14B,A01,083073,Cheng; Tzu-Han,6,0,63,57
1657774817752,COGS 17,A01,092677,Semenuks; Arturs,6,0,81,75
1657774823778,COGS 100,A01,083619,Allen; Michael Gordon,17,0,70,53
1657774829801,COGS 101A,A01,083621,Davis; Joshua Daniel,9,0,68,59
1657774835826,COGS 101B,A01,091572,Allen; Michael Gordon,12,0,65,53
1657774841848,COGS 101C,A01,083625,Delgado; Tania,17,0,35,18
1657774847874,COGS 107A,A01,083627,Boyle; Mary E. T.,14,0,60,46
1657774853897,COGS 118A,A01,083075,Gupta; Anjum,21,0,76,55
1657774859931,CSE 3,A50,083646,Miranda; Gregory Joseph,24,0,50,26
1657774865956,CSE 8A,A50,083650,Miranda; Gregory Joseph,17,1,56,39
1657774871977,CSE 11,A01,083080,Cao; Yingjun,6,15,40,34
1657774878001,CSE 12,A01,083652,Krause-Levy; Sophia Louisa,28,1,120,92
1657774884024,CSE 15L,A01,083654,Morris; Justin Loren,9,0,50,41
1657774884024,CSE 15L,A02,083655,Morris; Justin Loren,9,0,50,41
1657774890046,CSE 20,A01,083657,Tran; Khoa Dang,39,0,80,41
1657774896068,CSE 21,A01,095574,Bach; Quang Tran,22,0,48,26
1657774902091,CSE 30,A01,083084,Eldon; John,6,0,80,74
1657774902091,CSE 30,B01,095061,Bhaskar; Nishant,9,0,50,41
1657774908117,CSE 100,A01,083659,Cao; Yingjun,5,4,70,65
1657774914144,CSE 134B,A01,083661,Powell; Thomas Allan,24,0,100,76
1657774920169,CSE 140,A01,083663,Gungor; Onat,15,0,85,70
1657774926191,CSE 140L,A01,083088,Eldon; John,23,0,100,77
1657774932216,CSE 175,A01,083665,Kumar; Rakesh,3,0,25,22
1657774938242,CSE 190,A00,092507,Dubnov; Shlomo,8,0,20,12
1657774944268,ECE 45,A01,083139,Congero; Spencer William,6,0,75,69
1657774950295,ECE 65,A50,083695,Saad; Andrew S,12,0,30,18
1657774950295,ECE 65,A51,095125,Saad; Andrew S,24,0,26,2
1657774956318,ECE 109,A01,091882,Touri; Behrouz,20,0,70,50
1657774962342,ECE 180,A00,083140,Abi Samra; Nicholas Camill,1,0,30,29
1657774962342,ECE 180,B00,083141,Abi Samra; Nicholas Camill,0,0,30,30
1657774968365,MATH 10A,A01,083735,Patchell; Gregory David,2,0,30,28
1657774968365,MATH 10A,A02,083736,Patchell; Gregory David,20,0,30,10
1657774968365,MATH 10A,A03,083737,Patchell; Gregory David,16,0,30,14
1657774974388,MATH 10B,A01,083207,Lim; Seonhee,8,0,34,26
1657774974388,MATH 10B,A02,083208,Lim; Seonhee,9,0,35,26
1657774974388,MATH 10B,A03,093472,Lim; Seonhee,7,0,34,27
1657774974388,MATH 10B,B01,083739,Sinha; Shubham,13,0,30,17
1657774980412,MATH 18,A01,083743,Cinel; Cameron Alexander,9,0,30,21
1657774980412,MATH 18,A02,083744,Cinel; Cameron Alexander,18,0,30,12
1657774980412,MATH 18,A03,083745,Cinel; Cameron Alexander,10,0,30,20
1657774980412,MATH 18,B01,083748,Rideout; David Porter,5,0,37,32
1657774980412,MATH 18,B02,083749,Rideout; David Porter,5,0,36,31
1657774980412,MATH 18,B03,083750,Rideout; David Porter,3,0,37,34
1657774980412,MATH 18,B04,083751,Rideout; David Porter,6,0,36,30
1657774980412,MATH 18,B05,093473,Rideout; David Porter,6,0,36,30
1657774980412,MATH 18,B06,093474,Rideout; David Porter,6,0,36,30
1657774986437,MATH 20A,A01,083754,Zheng; Zequn,14,0,40,26
1657774992459,MATH 20B,A01,083756,Briones; Jor-el Thomas Caparas,4,0,36,32
1657774992459,MATH 20B,A02,083757,Briones; Jor-el Thomas Caparas,1,0,36,35
1657774992459,MATH 20B,A03,093475,Briones; Jor-el Thomas Caparas,2,0,36,34
1657774998491,MATH 20C,A01,083760,Briones; Jor-el Thomas Caparas,1,0,35,34
1657774998491,MATH 20C,A02,083761,Briones; Jor-el Thomas Caparas,8,0,35,27
1657774998491,MATH 20C,A03,093476,Briones; Jor-el Thomas Caparas,0,1,36,36
1657774998491,MATH 20C,B01,083762,Bach; Quang Tran,1,0,30,29
1657775004527,MATH 20D,A01,083765,Tran; Brian Kha,5,0,30,25
1657775004527,MATH 20D,A02,083766,Tran; Brian Kha,5,0,30,25
1657775004527,MATH 20D,A03,083767,Tran; Brian Kha,5,0,30,25
1657775010553,MATH 20E,A01,083771,Ganguly; Soumya,9,0,32,23
1657775010553,MATH 20E,A02,083772,Ganguly; Soumya,6,0,32,26
1657775010553,MATH 20E,B01,083773,Ciotti; Benjamin,20,0,35,15
1657775010553,MATH 20E,B02,083774,Ciotti; Benjamin,18,0,35,17
1657775016669,MATH 103A,A01,083777,Greenfeld; Be'Eri,3,0,36,33
1657775016669,MATH 103A,A02,083778,Greenfeld; Be'Eri,5,0,36,31
1657775016669,MATH 103A,A03,093561,Greenfeld; Be'Eri,6,0,36,30
1657775016669,MATH 103A,B01,083779,Greenfeld; Be'Eri,7,0,36,29
1657775016669,MATH 103A,B02,083780,Greenfeld; Be'Eri,4,0,36,32
1657775016669,MATH 103A,B03,093562,Greenfeld; Be'Eri,3,0,36,33
1657775022702,MATH 105,A01,085443,Carter; Anne Toulson,15,0,35,20
1657775022702,MATH 105,A02,093477,Carter; Anne Toulson,20,0,35,15
1657775028727,MATH 109,A01,083213,Ganzberger; Geoffrey Michael,3,0,34,31
1657775028727,MATH 109,A02,083214,Ganzberger; Geoffrey Michael,4,0,34,30
1657775028727,MATH 109,A03,093478,Ganzberger; Geoffrey Michael,2,0,34,32
1657775028727,MATH 109,B01,083215,Ganzberger; Geoffrey Michael,1,0,32,31
1657775028727,MATH 109,B02,083216,Ganzberger; Geoffrey Michael,2,0,32,30
1657775028727,MATH 109,B03,093479,Ganzberger; Geoffrey Michael,8,0,32,24
1657775034755,MATH 142A,A01,083219,Chow; Bennett,7,0,32,25
1657775034755,MATH 142A,A02,083220,Chow; Bennett,10,0,32,22
1657775034755,MATH 142A,A03,093480,Chow; Bennett,9,0,32,23
1657775034755,MATH 142A,B03,093481,Chow; Bennett,8,0,32,24
1657775034755,MATH 142A,B04,093558,Chow; Bennett,13,0,32,19
1657775034755,MATH 142A,B05,093559,Chow; Bennett,6,0,32,26
1657775040780,MATH 193A,A01,083224,Rotar; Vladimir,8,0,34,26
1657775040780,MATH 193A,A02,083225,Rotar; Vladimir,9,0,34,25
1657775040780,MATH 193A,A03,083781,Rotar; Vladimir,5,0,34,29
1657775040780,MATH 193A,A04,083782,Rotar; Vladimir,10,0,34,24
1657775040780,MATH 193A,A05,093482,Rotar; Vladimir,10,0,34,24
1657775046805,MATH 197,001,091859,McAuley; Julian John,9999,0,9999,0
1657775046805,MATH 197,002,095566,Kedlaya; Kiran S.,9997,0,9999,2
1657775046805,MATH 197,003,095567,Xiao; Ming,9999,0,9999,0
1657775046805,MATH 197,004,095571,Perols; Johan Lars,9998,0,9999,1
1657775053856,COGS 9,A01,083615,Shannon; Kyle Michael,9,0,75,66
1657775059885,COGS 11,A01,083617,Boyle; Mary E. T.,23,0,48,25
1657775065907,COGS 13,A01,083071,Bastos; Amalia Pinkusfeld,11,0,71,60
1657775071930,COGS 14A,A01,092681,Semenuks; Arturs,5,1,100,95
1657775077956,COGS 14B,A01,083073,Cheng; Tzu-Han,6,0,63,57
1657775083979,COGS 17,A01,092677,Semenuks; Arturs,6,0,81,75
1657775090002,COGS 100,A01,083619,Allen; Michael Gordon,17,0,70,53
1657775096024,COGS 101A,A01,083621,Davis; Joshua Daniel,9,0,68,59
1657775102051,COGS 101B,A01,091572,Allen; Michael Gordon,12,0,65,53
1657775108073,COGS 101C,A01,083625,Delgado; Tania,17,0,35,18
1657775114105,COGS 107A,A01,083627,Boyle; Mary E. T.,14,0,60,46
1657775120128,COGS 118A,A01,083075,Gupta; Anjum,21,0,76,55
1657775126153,CSE 3,A50,083646,Miranda; Gregory Joseph,24,0,50,26
1657775132180,CSE 8A,A50,083650,Miranda; Gregory Joseph,17,1,56,39
1657775138204,CSE 11,A01,083080,Cao; Yingjun,6,15,40,34
1657775144230,CSE 12,A01,083652,Krause-Levy; Sophia Louisa,28,1,120,92
1657775150261,CSE 15L,A01,083654,Morris; Justin Loren,9,0,50,41
1657775150261,CSE 15L,A02,083655,Morris; Justin Loren,9,0,50,41
1657775156283,CSE 20,A01,083657,Tran; Khoa Dang,39,0,80,41
1657775162305,CSE 21,A01,095574,Bach; Quang Tran,22,0,48,26
1657775168331,CSE 30,A01,083084,Eldon; John,6,0,80,74
1657775168331,CSE 30,B01,095061,Bhaskar; Nishant,9,0,50,41
1657775174353,CSE 100,A01,083659,Cao; Yingjun,5,4,70,65
1657775180378,CSE 134B,A01,083661,Powell; Thomas Allan,24,0,100,76
1657775186402,CSE 140,A01,083663,Gungor; Onat,15,0,85,70
1657775192428,CSE 140L,A01,083088,Eldon; John,23,0,100,77
1657775198451,CSE 175,A01,083665,Kumar; Rakesh,3,0,25,22
1657775204473,CSE 190,A00,092507,Dubnov; Shlomo,8,0,20,12
1657775210500,ECE 45,A01,083139,Congero; Spencer William,6,0,75,69
1657775216528,ECE 65,A50,083695,Saad; Andrew S,12,0,30,18
1657775216528,ECE 65,A51,095125,Saad; Andrew S,24,0,26,2
1657775222550,ECE 109,A01,091882,Touri; Behrouz,20,0,70,50
1657775228573,ECE 180,A00,083140,Abi Samra; Nicholas Camill,1,0,30,29
1657775228573,ECE 180,B00,083141,Abi Samra; Nicholas Camill,0,0,30,30
1657775234596,MATH 10A,A01,083735,Patchell; Gregory David,2,0,30,28
1657775234596,MATH 10A,A02,083736,Patchell; Gregory David,20,0,30,10
1657775234596,MATH 10A,A03,083737,Patchell; Gregory David,16,0,30,14
1657775240619,MATH 10B,A01,083207,Lim; Seonhee,8,0,34,26
1657775240619,MATH 10B,A02,083208,Lim; Seonhee,9,0,35,26
1657775240619,MATH 10B,A03,093472,Lim; Seonhee,7,0,34,27
1657775240619,MATH 10B,B01,083739,Sinha; Shubham,13,0,30,17
1657775246651,MATH 18,A01,083743,Cinel; Cameron Alexander,9,0,30,21
1657775246651,MATH 18,A02,083744,Cinel; Cameron Alexander,18,0,30,12
1657775246651,MATH 18,A03,083745,Cinel; Cameron Alexander,10,0,30,20
1657775246651,MATH 18,B01,083748,Rideout; David Porter,5,0,37,32
1657775246651,MATH 18,B02,083749,Rideout; David Porter,5,0,36,31
1657775246651,MATH 18,B03,083750,Rideout; David Porter,3,0,37,34
1657775246651,MATH 18,B04,083751,Rideout; David Porter,6,0,36,30
1657775246651,MATH 18,B05,093473,Rideout; David Porter,6,0,36,30
1657775246651,MATH 18,B06,093474,Rideout; David Porter,6,0,36,30
1657775252675,MATH 20A,A01,083754,Zheng; Zequn,14,0,40,26
1657775258702,MATH 20B,A01,083756,Briones; Jor-el Thomas Caparas,4,0,36,32
1657775258702,MATH 20B,A02,083757,Briones; Jor-el Thomas Caparas,1,0,36,35
1657775258702,MATH 20B,A03,093475,Briones; Jor-el Thomas Caparas,2,0,36,34
1657775264726,MATH 20C,A01,083760,Briones; Jor-el Thomas Caparas,1,0,35,34
1657775264726,MATH 20C,A02,083761,Briones; Jor-el Thomas Caparas,8,0,35,27
1657775264726,MATH 20C,A03,093476,Briones; Jor-el Thomas Caparas,0,1,36,36
1657775264726,MATH 20C,B01,083762,Bach; Quang Tran,1,0,30,29
1657775270751,MATH 20D,A01,083765,Tran; Brian Kha,5,0,30,25
1657775270751,MATH 20D,A02,083766,Tran; Brian Kha,5,0,30,25
1657775270751,MATH 20D,A03,083767,Tran; Brian Kha,5,0,30,25
1657775276774,MATH 20E,A01,083771,Ganguly; Soumya,9,0,32,23
1657775276774,MATH 20E,A02,083772,Ganguly; Soumya,6,0,32,26
1657775276774,MATH 20E,B01,083773,Ciotti; Benjamin,20,0,35,15
1657775276774,MATH 20E,B02,083774,Ciotti; Benjamin,18,0,35,17
1657775282804,MATH 103A,A01,083777,Greenfeld; Be'Eri,3,0,36,33
1657775282804,MATH 103A,A02,083778,Greenfeld; Be'Eri,5,0,36,31
1657775282804,MATH 103A,A03,093561,Greenfeld; Be'Eri,6,0,36,30
1657775282804,MATH 103A,B01,083779,Greenfeld; Be'Eri,7,0,36,29
1657775282804,MATH 103A,B02,083780,Greenfeld; Be'Eri,4,0,36,32
1657775282804,MATH 103A,B03,093562,Greenfeld; Be'Eri,3,0,36,33
1657775288829,MATH 105,A01,085443,Carter; Anne Toulson,15,0,35,20
1657775288829,MATH 105,A02,093477,Carter; Anne Toulson,20,0,35,15
1657775294852,MATH 109,A01,083213,Ganzberger; Geoffrey Michael,3,0,34,31
1657775294852,MATH 109,A02,083214,Ganzberger; Geoffrey Michael,4,0,34,30
1657775294852,MATH 109,A03,093478,Ganzberger; Geoffrey Michael,2,0,34,32
1657775294852,MATH 109,B01,083215,Ganzberger; Geoffrey Michael,1,0,32,31
1657775294852,MATH 109,B02,083216,Ganzberger; Geoffrey Michael,2,0,32,30
1657775294852,MATH 109,B03,093479,Ganzberger; Geoffrey Michael,8,0,32,24
1657775300878,MATH 142A,A01,083219,Chow; Bennett,7,0,32,25
1657775300878,MATH 142A,A02,083220,Chow; Bennett,10,0,32,22
1657775300878,MATH 142A,A03,093480,Chow; Bennett,9,0,32,23
1657775300878,MATH 142A,B03,093481,Chow; Bennett,8,0,32,24
1657775300878,MATH 142A,B04,093558,Chow; Bennett,13,0,32,19
1657775300878,MATH 142A,B05,093559,Chow; Bennett,6,0,32,26
1657775306906,MATH 193A,A01,083224,Rotar; Vladimir,8,0,34,26
1657775306906,MATH 193A,A02,083225,Rotar; Vladimir,9,0,34,25
1657775306906,MATH 193A,A03,083781,Rotar; Vladimir,5,0,34,29
1657775306906,MATH 193A,A04,083782,Rotar; Vladimir,10,0,34,24
1657775306906,MATH 193A,A05,093482,Rotar; Vladimir,10,0,34,24
1657775312940,MATH 197,001,091859,McAuley; Julian John,9999,0,9999,0
1657775312940,MATH 197,002,095566,Kedlaya; Kiran S.,9997,0,9999,2
1657775312940,MATH 197,003,095567,Xiao; Ming,9999,0,9999,0
1657775312940,MATH 197,004,095571,Perols; Johan Lars,9998,0,9999,1
1657775319998,COGS 9,A01,083615,Shannon; Kyle Michael,9,0,75,66
1657775326026,COGS 11,A01,083617,Boyle; Mary E. T.,23,0,48,25
1657775332049,COGS 13,A01,083071,Bastos; Amalia Pinkusfeld,11,0,71,60
1657775338075,COGS 14A,A01,092681,Semenuks; Arturs,5,1,100,95
1657775344099,COGS 14B,A01,083073,Cheng; Tzu-Han,6,0,63,57
1657775350121,COGS 17,A01,092677,Semenuks; Arturs,6,0,81,75
1657775356148,COGS 100,A01,083619,Allen; Michael Gordon,17,0,70,53
1657775362170,COGS 101A,A01,083621,Davis; Joshua Daniel,9,0,68,59
1657775368197,COGS 101B,A01,091572,Allen; Michael Gordon,12,0,65,53
1657775374220,COGS 101C,A01,083625,Delgado; Tania,17,0,35,18
1657775380247,COGS 107A,A01,083627,Boyle; Mary E. T.,14,0,60,46
1657775386272,COGS 118A,A01,083075,Gupta; Anjum,21,0,76,55
1657775392295,CSE 3,A50,083646,Miranda; Gregory Joseph,24,0,50,26
1657775398320,CSE 8A,A50,083650,Miranda; Gregory Joseph,17,1,56,39
1657775404421,CSE 11,A01,083080,Cao; Yingjun,6,15,40,34
1657775410442,CSE 12,A01,083652,Krause-Levy; Sophia Louisa,28,1,120,92
1657775416464,CSE 15L,A01,083654,Morris; Justin Loren,9,0,50,41
1657775416464,CSE 15L,A02,083655,Morris; Justin Loren,9,0,50,41
1657775422488,CSE 20,A01,083657,Tran; Khoa Dang,39,0,80,41
1657775428510,CSE 21,A01,095574,Bach; Quang Tran,22,0,48,26
1657775434539,CSE 30,A01,083084,Eldon; John,6,0,80,74
1657775434539,CSE 30,B01,095061,Bhaskar; Nishant,9,0,50,41
1657775440565,CSE 100,A01,083659,Cao; Yingjun,5,4,70,65
1657775446591,CSE 134B,A01,083661,Powell; Thomas Allan,24,0,100,76
1657775452615,CSE 140,A01,083663,Gungor; Onat,15,0,85,70
1657775458637,CSE 140L,A01,083088,Eldon; John,23,0,100,77
1657775464673,CSE 175,A01,083665,Kumar; Rakesh,3,0,25,22
1657775470699,CSE 190,A00,092507,Dubnov; Shlomo,8,0,20,12
1657775476722,ECE 45,A01,083139,Congero; Spencer William,6,0,75,69
1657775482746,ECE 65,A50,083695,Saad; Andrew S,12,0,30,18
1657775482746,ECE 65,A51,095125,Saad; Andrew S,24,0,26,2
1657775488768,ECE 109,A01,091882,Touri; Behrouz,20,0,70,50
1657775494795,ECE 180,A00,083140,Abi Samra; Nicholas Camill,1,0,30,29
1657775494795,ECE 180,B00,083141,Abi Samra; Nicholas Camill,0,0,30,30
1657775500826,MATH 10A,A01,083735,Patchell; Gregory David,2,0,30,28
1657775500826,MATH 10A,A02,083736,Patchell; Gregory David,20,0,30,10
1657775500826,MATH 10A,A03,083737,Patchell; Gregory David,16,0,30,14
1657775506851,MATH 10B,A01,083207,Lim; Seonhee,8,0,34,26
1657775506851,MATH 10B,A02,083208,Lim; Seonhee,9,0,35,26
1657775506851,MATH 10B,A03,093472,Lim; Seonhee,7,0,34,27
1657775506851,MATH 10B,B01,083739,Sinha; Shubham,13,0,30,17
1657775512879,MATH 18,A01,083743,Cinel; Cameron Alexander,9,0,30,21
1657775512879,MATH 18,A02,083744,Cinel; Cameron Alexander,18,0,30,12
1657775512879,MATH 18,A03,083745,Cinel; Cameron Alexander,10,0,30,20
1657775512879,MATH 18,B01,083748,Rideout; David Porter,5,0,37,32
1657775512879,MATH 18,B02,083749,Rideout; David Porter,5,0,36,31
1657775512879,MATH 18,B03,083750,Rideout; David Porter,3,0,37,34
1657775512879,MATH 18,B04,083751,Rideout; David Porter,6,0,36,30
1657775512879,MATH 18,B05,093473,Rideout; David Porter,6,0,36,30
1657775512879,MATH 18,B06,093474,Rideout; David Porter,6,0,36,30
1657775518903,MATH 20A,A01,083754,Zheng; Zequn,14,0,40,26
1657775524924,MATH 20B,A01,083756,Briones; Jor-el Thomas Caparas,4,0,36,32
1657775524924,MATH 20B,A02,083757,Briones; Jor-el Thomas Caparas,1,0,36,35
1657775524924,MATH 20B,A03,093475,Briones; Jor-el Thomas Caparas,2,0,36,34
1657775530953,MATH 20C,A01,083760,Briones; Jor-el Thomas Caparas,1,0,35,34
1657775530953,MATH 20C,A02,083761,Briones; Jor-el Thomas Caparas,8,0,35,27
1657775530953,MATH 20C,A03,093476,Briones; Jor-el Thomas Caparas,0,1,36,36
1657775530953,MATH 20C,B01,083762,Bach; Quang Tran,1,0,30,29
1657775536977,MATH 20D,A01,083765,Tran; Brian Kha,5,0,30,25
1657775536977,MATH 20D,A02,083766,Tran; Brian Kha,5,0,30,25
1657775536977,MATH 20D,A03,083767,Tran; Brian Kha,5,0,30,25
1657775543005,MATH 20E,A01,083771,Ganguly; Soumya,9,0,32,23
1657775543005,MATH 20E,A02,083772,Ganguly; Soumya,6,0,32,26
1657775543005,MATH 20E,B01,083773,Ciotti; Benjamin,20,0,35,15
1657775543005,MATH 20E,B02,083774,Ciotti; Benjamin,18,0,35,17
1657775549030,MATH 103A,A01,083777,Greenfeld; Be'Eri,3,0,36,33
1657775549030,MATH 103A,A02,083778,Greenfeld; Be'Eri,5,0,36,31
1657775549030,MATH 103A,A03,093561,Greenfeld; Be'Eri,6,0,36,30
1657775549030,MATH 103A,B01,083779,Greenfeld; Be'Eri,7,0,36,29
1657775549030,MATH 103A,B02,083780,Greenfeld; Be'Eri,4,0,36,32
1657775549030,MATH 103A,B03,093562,Greenfeld; Be'Eri,3,0,36,33
1657775555056,MATH 105,A01,085443,Carter; Anne Toulson,15,0,35,20
1657775555056,MATH 105,A02,093477,Carter; Anne Toulson,20,0,35,15
1657775561079,MATH 109,A01,083213,Ganzberger; Geoffrey Michael,3,0,34,31
1657775561079,MATH 109,A02,083214,Ganzberger; Geoffrey Michael,4,0,34,30
1657775561079,MATH 109,A03,093478,Ganzberger; Geoffrey Michael,2,0,34,32
1657775561079,MATH 109,B01,083215,Ganzberger; Geoffrey Michael,1,0,32,31
1657775561079,MATH 109,B02,083216,Ganzberger; Geoffrey Michael,2,0,32,30
1657775561079,MATH 109,B03,093479,Ganzberger; Geoffrey Michael,8,0,32,24
1657775567116,MATH 142A,A01,083219,Chow; Bennett,7,0,32,25
1657775567116,MATH 142A,A02,083220,Chow; Bennett,10,0,32,22
1657775567116,MATH 142A,A03,093480,Chow; Bennett,9,0,32,23
1657775567116,MATH 142A,B03,093481,Chow; Bennett,8,0,32,24
1657775567116,MATH 142A,B04,093558,Chow; Bennett,13,0,32,19
1657775567116,MATH 142A,B05,093559,Chow; Bennett,6,0,32,26
1657775573146,MATH 193A,A01,083224,Rotar; Vladimir,8,0,34,26
1657775573146,MATH 193A,A02,083225,Rotar; Vladimir,9,0,34,25
1657775573146,MATH 193A,A03,083781,Rotar; Vladimir,5,0,34,29
1657775573146,MATH 193A,A04,083782,Rotar; Vladimir,10,0,34,24
1657775573146,MATH 193A,A05,093482,Rotar; Vladimir,10,0,34,24
1657775579168,MATH 197,001,091859,McAuley; Julian John,9999,0,9999,0
1657775579168,MATH 197,002,095566,Kedlaya; Kiran S.,9997,0,9999,2
1657775579168,MATH 197,003,095567,Xiao; Ming,9999,0,9999,0
1657775579168,MATH 197,004,095571,Perols; Johan Lars,9998,0,9999,1
1657775586221,COGS 9,A01,083615,Shannon; Kyle Michael,9,0,75,66
1657775592247,COGS 11,A01,083617,Boyle; Mary E. T.,23,0,48,25
1657775598275,COGS 13,A01,083071,Bastos; Amalia Pinkusfeld,11,0,71,60
1657775604299,COGS 14A,A01,092681,Semenuks; Arturs,5,1,100,95
1657775610322,COGS 14B,A01,083073,Cheng; Tzu-Han,6,0,63,57
1657775616348,COGS 17,A01,092677,Semenuks; Arturs,6,0,81,75
1657775622374,COGS 100,A01,083619,Allen; Michael Gordon,17,0,70,53
1657775628397,COGS 101A,A01,083621,Davis; Joshua Daniel,9,0,68,59
1657775634419,COGS 101B,A01,091572,Allen; Michael Gordon,12,0,65,53
1657775640441,COGS 101C,A01,083625,Delgado; Tania,17,0,35,18
1657775646472,COGS 107A,A01,083627,Boyle; Mary E. T.,14,0,60,46
1657775652495,COGS 118A,A01,083075,Gupta; Anjum,21,0,76,55
1657775658518,CSE 3,A50,083646,Miranda; Gregory Joseph,24,0,50,26
1657775664547,CSE 8A,A50,083650,Miranda; Gregory Joseph,17,1,56,39
1657775670570,CSE 11,A01,083080,Cao; Yingjun,6,15,40,34
1657775676594,CSE 12,A01,083652,Krause-Levy; Sophia Louisa,28,1,120,92
1657775682623,CSE 15L,A01,083654,Morris; Justin Loren,9,0,50,41
1657775682623,CSE 15L,A02,083655,Morris; Justin Loren,9,0,50,41
1657775688646,CSE 20,A01,083657,Tran; Khoa Dang,39,0,80,41
1657775694675,CSE 21,A01,095574,Bach; Quang Tran,22,0,48,26
1657775700701,CSE 30,A01,083084,Eldon; John,6,0,80,74
1657775700701,CSE 30,B01,095061,Bhaskar; Nishant,9,0,50,41
1657775706723,CSE 100,A01,083659,Cao; Yingjun,5,4,70,65
1657775712749,CSE 134B,A01,083661,Powell; Thomas Allan,24,0,100,76
1657775718771,CSE 140,A01,083663,Gungor; Onat,15,0,85,70
1657775724808,CSE 140L,A01,083088,Eldon; John,23,0,100,77
1657775730840,CSE 175,A01,083665,Kumar; Rakesh,3,0,25,22
1657775736874,CSE 190,A00,092507,Dubnov; Shlomo,8,0,20,12
1657775742897,ECE 45,A01,083139,Congero; Spencer William,6,0,75,69
1657775748924,ECE 65,A50,083695,Saad; Andrew S,12,0,30,18
1657775748924,ECE 65,A51,095125,Saad; Andrew S,24,0,26,2
1657775754947,ECE 109,A01,091882,Touri; Behrouz,20,0,70,50
1657775760974,ECE 180,A00,083140,Abi Samra; Nicholas Camill,1,0,30,29
1657775760974,ECE 180,B00,083141,Abi Samra; Nicholas Camill,0,0,30,30
1657775766998,MATH 10A,A01,083735,Patchell; Gregory David,2,0,30,28
1657775766998,MATH 10A,A02,083736,Patchell; Gregory David,20,0,30,10
1657775766998,MATH 10A,A03,083737,Patchell; Gregory David,16,0,30,14
1657775773024,MATH 10B,A01,083207,Lim; Seonhee,8,0,34,26
1657775773024,MATH 10B,A02,083208,Lim; Seonhee,9,0,35,26
1657775773024,MATH 10B,A03,093472,Lim; Seonhee,7,0,34,27
1657775773024,MATH 10B,B01,083739,Sinha; Shubham,13,0,30,17
1657775779052,MATH 18,A01,083743,Cinel; Cameron Alexander,9,0,30,21
1657775779052,MATH 18,A02,083744,Cinel; Cameron Alexander,18,0,30,12
1657775779052,MATH 18,A03,083745,Cinel; Cameron Alexander,10,0,30,20
1657775779052,MATH 18,B01,083748,Rideout; David Porter,5,0,37,32
1657775779052,MATH 18,B02,083749,Rideout; David Porter,5,0,36,31
1657775779052,MATH 18,B03,083750,Rideout; David Porter,3,0,37,34
1657775779052,MATH 18,B04,083751,Rideout; David Porter,6,0,36,30
1657775779052,MATH 18,B05,093473,Rideout; David Porter,6,0,36,30
1657775779052,MATH 18,B06,093474,Rideout; David Porter,6,0,36,30
1657775785074,MATH 20A,A01,083754,Zheng; Zequn,14,0,40,26
1657775791101,MATH 20B,A01,083756,Briones; Jor-el Thomas Caparas,4,0,36,32
1657775791101,MATH 20B,A02,083757,Briones; Jor-el Thomas Caparas,1,0,36,35
1657775791101,MATH 20B,A03,093475,Briones; Jor-el Thomas Caparas,2,0,36,34
1657775797124,MATH 20C,A01,083760,Briones; Jor-el Thomas Caparas,1,0,35,34
1657775797124,MATH 20C,A02,083761,Briones; Jor-el Thomas Caparas,8,0,35,27
1657775797124,MATH 20C,A03,093476,Briones; Jor-el Thomas Caparas,0,1,36,36
1657775797124,MATH 20C,B01,083762,Bach; Quang Tran,1,0,30,29
1657775803152,MATH 20D,A01,083765,Tran; Brian Kha,5,0,30,25
1657775803152,MATH 20D,A02,083766,Tran; Brian Kha,5,0,30,25
1657775803152,MATH 20D,A03,083767,Tran; Brian Kha,5,0,30,25
1657775809175,MATH 20E,A01,083771,Ganguly; Soumya,9,0,32,23
1657775809175,MATH 20E,A02,083772,Ganguly; Soumya,6,0,32,26
1657775809175,MATH 20E,B01,083773,Ciotti; Benjamin,20,0,35,15
1657775809175,MATH 20E,B02,083774,Ciotti; Benjamin,18,0,35,17
1657775815198,MATH 103A,A01,083777,Greenfeld; Be'Eri,3,0,36,33
1657775815198,MATH 103A,A02,083778,Greenfeld; Be'Eri,5,0,36,31
1657775815198,MATH 103A,A03,093561,Greenfeld; Be'Eri,6,0,36,30
1657775815198,MATH 103A,B01,083779,Greenfeld; Be'Eri,7,0,36,29
1657775815198,MATH 103A,B02,083780,Greenfeld; Be'Eri,4,0,36,32
1657775815198,MATH 103A,B03,093562,Greenfeld; Be'Eri,3,0,36,33
1657775821221,MATH 105,A01,085443,Carter; Anne Toulson,15,0,35,20
1657775821221,MATH 105,A02,093477,Carter; Anne Toulson,20,0,35,15
1657775827246,MATH 109,A01,083213,Ganzberger; Geoffrey Michael,3,0,34,31
1657775827246,MATH 109,A02,083214,Ganzberger; Geoffrey Michael,4,0,34,30
1657775827246,MATH 109,A03,093478,Ganzberger; Geoffrey Michael,2,0,34,32
1657775827246,MATH 109,B01,083215,Ganzberger; Geoffrey Michael,1,0,32,31
1657775827246,MATH 109,B02,083216,Ganzberger; Geoffrey Michael,2,0,32,30
1657775827246,MATH 109,B03,093479,Ganzberger; Geoffrey Michael,8,0,32,24
1657775833275,MATH 142A,A01,083219,Chow; Bennett,7,0,32,25
1657775833275,MATH 142A,A02,083220,Chow; Bennett,10,0,32,22
1657775833275,MATH 142A,A03,093480,Chow; Bennett,9,0,32,23
1657775833275,MATH 142A,B03,093481,Chow; Bennett,8,0,32,24
1657775833275,MATH 142A,B04,093558,Chow; Bennett,13,0,32,19
1657775833275,MATH 142A,B05,093559,Chow; Bennett,6,0,32,26
1657775839300,MATH 193A,A01,083224,Rotar; Vladimir,8,0,34,26
1657775839300,MATH 193A,A02,083225,Rotar; Vladimir,9,0,34,25
1657775839300,MATH 193A,A03,083781,Rotar; Vladimir,5,0,34,29
1657775839300,MATH 193A,A04,083782,Rotar; Vladimir,10,0,34,24
1657775839300,MATH 193A,A05,093482,Rotar; Vladimir,10,0,34,24
1657775845324,MATH 197,001,091859,McAuley; Julian John,9999,0,9999,0
1657775845324,MATH 197,002,095566,Kedlaya; Kiran S.,9997,0,9999,2
1657775845324,MATH 197,003,095567,Xiao; Ming,9999,0,9999,0
1657775845324,MATH 197,004,095571,Perols; Johan Lars,9998,0,9999,1
1657775852390,COGS 9,A01,083615,Shannon; Kyle Michael,9,0,75,66
1657775858414,COGS 11,A01,083617,Boyle; Mary E. T.,23,0,48,25
1657775864440,COGS 13,A01,083071,Bastos; Amalia Pinkusfeld,11,0,71,60
1657775870467,COGS 14A,A01,092681,Semenuks; Arturs,5,1,100,95
1657775876497,COGS 14B,A01,083073,Cheng; Tzu-Han,6,0,63,57
1657775882524,COGS 17,A01,092677,Semenuks; Arturs,6,0,81,75
1657775888552,COGS 100,A01,083619,Allen; Michael Gordon,17,0,70,53
1657775894576,COGS 101A,A01,083621,Davis; Joshua Daniel,9,0,68,59
1657775900600,COGS 101B,A01,091572,Allen; Michael Gordon,12,0,65,53
1657775906625,COGS 101C,A01,083625,Delgado; Tania,17,0,35,18
1657775912652,COGS 107A,A01,083627,Boyle; Mary E. T.,14,0,60,46
1657775918682,COGS 118A,A01,083075,Gupta; Anjum,21,0,76,55
1657775924708,CSE 3,A50,083646,Miranda; Gregory Joseph,24,0,50,26
1657775930732,CSE 8A,A50,083650,Miranda; Gregory Joseph,17,1,56,39
1657775936758,CSE 11,A01,083080,Cao; Yingjun,6,15,40,34
1657775942792,CSE 12,A01,083652,Krause-Levy; Sophia Louisa,28,1,120,92
1657775948819,CSE 15L,A01,083654,Morris; Justin Loren,9,0,50,41
1657775948819,CSE 15L,A02,083655,Morris; Justin Loren,9,0,50,41
1657775954843,CSE 20,A01,083657,Tran; Khoa Dang,39,0,80,41
1657775960866,CSE 21,A01,095574,Bach; Quang Tran,22,0,48,26
1657775966888,CSE 30,A01,083084,Eldon; John,6,0,80,74
1657775966888,CSE 30,B01,095061,Bhaskar; Nishant,9,0,50,41
1657775972911,CSE 100,A01,083659,Cao; Yingjun,5,4,70,65
1657775978934,CSE 134B,A01,083661,Powell; Thomas Allan,24,0,100,76
1657775984957,CSE 140,A01,083663,Gungor; Onat,15,0,85,70
1657775990980,CSE 140L,A01,083088,Eldon; John,23,0,100,77
1657775997010,CSE 175,A01,083665,Kumar; Rakesh,3,0,25,22
1657776003107,CSE 190,A00,092507,Dubnov; Shlomo,8,0,20,12
1657776009134,ECE 45,A01,083139,Congero; Spencer William,6,0,75,69
1657776015156,ECE 65,A50,083695,Saad; Andrew S,12,0,30,18
1657776015156,ECE 65,A51,095125,Saad; Andrew S,24,0,26,2
1657776021179,ECE 109,A01,091882,Touri; Behrouz,20,0,70,50
1657776027205,ECE 180,A00,083140,Abi Samra; Nicholas Camill,1,0,30,29
1657776027205,ECE 180,B00,083141,Abi Samra; Nicholas Camill,0,0,30,30
1657776033232,MATH 10A,A01,083735,Patchell; Gregory David,2,0,30,28
1657776033232,MATH 10A,A02,083736,Patchell; Gregory David,20,0,30,10
1657776033232,MATH 10A,A03,083737,Patchell; Gregory David,16,0,30,14
1657776039257,MATH 10B,A01,083207,Lim; Seonhee,8,0,34,26
1657776039257,MATH 10B,A02,083208,Lim; Seonhee,9,0,35,26
1657776039257,MATH 10B,A03,093472,Lim; Seonhee,7,0,34,27
1657776039257,MATH 10B,B01,083739,Sinha; Shubham,13,0,30,17
1657776045294,MATH 18,A01,083743,Cinel; Cameron Alexander,9,0,30,21
1657776045294,MATH 18,A02,083744,Cinel; Cameron Alexander,18,0,30,12
1657776045294,MATH 18,A03,083745,Cinel; Cameron Alexander,10,0,30,20
1657776045294,MATH 18,B01,083748,Rideout; David Porter,5,0,37,32
1657776045294,MATH 18,B02,083749,Rideout; David Porter,5,0,36,31
1657776045294,MATH 18,B03,083750,Rideout; David Porter,3,0,37,34
1657776045294,MATH 18,B04,083751,Rideout; David Porter,6,0,36,30
1657776045294,MATH 18,B05,093473,Rideout; David Porter,6,0,36,30
1657776045294,MATH 18,B06,093474,Rideout; David Porter,6,0,36,30
1657776051320,MATH 20A,A01,083754,Zheng; Zequn,14,0,40,26
1657776057344,MATH 20B,A01,083756,Briones; Jor-el Thomas Caparas,4,0,36,32
1657776057344,MATH 20B,A02,083757,Briones; Jor-el Thomas Caparas,1,0,36,35
1657776057344,MATH 20B,A03,093475,Briones; Jor-el Thomas Caparas,2,0,36,34
1657776063367,MATH 20C,A01,083760,Briones; Jor-el Thomas Caparas,1,0,35,34
1657776063367,MATH 20C,A02,083761,Briones; Jor-el Thomas Caparas,8,0,35,27
1657776063367,MATH 20C,A03,093476,Briones; Jor-el Thomas Caparas,0,1,36,36
1657776063367,MATH 20C,B01,083762,Bach; Quang Tran,1,0,30,29
1657776069394,MATH 20D,A01,083765,Tran; Brian Kha,5,0,30,25
1657776069394,MATH 20D,A02,083766,Tran; Brian Kha,5,0,30,25
1657776069394,MATH 20D,A03,083767,Tran; Brian Kha,5,0,30,25
1657776075423,MATH 20E,A01,083771,Ganguly; Soumya,9,0,32,23
1657776075423,MATH 20E,A02,083772,Ganguly; Soumya,6,0,32,26
1657776075423,MATH 20E,B01,083773,Ciotti; Benjamin,20,0,35,15
1657776075423,MATH 20E,B02,083774,Ciotti; Benjamin,18,0,35,17
1657776081453,MATH 103A,A01,083777,Greenfeld; Be'Eri,3,0,36,33
1657776081453,MATH 103A,A02,083778,Greenfeld; Be'Eri,5,0,36,31
1657776081453,MATH 103A,A03,093561,Greenfeld; Be'Eri,6,0,36,30
1657776081453,MATH 103A,B01,083779,Greenfeld; Be'Eri,7,0,36,29
1657776081453,MATH 103A,B02,083780,Greenfeld; Be'Eri,4,0,36,32
1657776081453,MATH 103A,B03,093562,Greenfeld; Be'Eri,3,0,36,33
1657776087487,MATH 105,A01,085443,Carter; Anne Toulson,15,0,35,20
1657776087487,MATH 105,A02,093477,Carter; Anne Toulson,20,0,35,15
1657776093535,MATH 109,A01,083213,Ganzberger; Geoffrey Michael,3,0,34,31
1657776093535,MATH 109,A02,083214,Ganzberger; Geoffrey Michael,4,0,34,30
1657776093535,MATH 109,A03,093478,Ganzberger; Geoffrey Michael,2,0,34,32
1657776093535,MATH 109,B01,083215,Ganzberger; Geoffrey Michael,1,0,32,31
1657776093535,MATH 109,B02,083216,Ganzberger; Geoffrey Michael,2,0,32,30
1657776093535,MATH 109,B03,093479,Ganzberger; Geoffrey Michael,8,0,32,24
1657776099568,MATH 142A,A01,083219,Chow; Bennett,7,0,32,25
1657776099568,MATH 142A,A02,083220,Chow; Bennett,10,0,32,22
1657776099568,MATH 142A,A03,093480,Chow; Bennett,9,0,32,23
1657776099568,MATH 142A,B03,093481,Chow; Bennett,8,0,32,24
1657776099568,MATH 142A,B04,093558,Chow; Bennett,13,0,32,19
1657776099568,MATH 142A,B05,093559,Chow; Bennett,6,0,32,26
1657776105589,MATH 193A,A01,083224,Rotar; Vladimir,8,0,34,26
1657776105589,MATH 193A,A02,083225,Rotar; Vladimir,9,0,34,25
1657776105589,MATH 193A,A03,083781,Rotar; Vladimir,5,0,34,29
1657776105589,MATH 193A,A04,083782,Rotar; Vladimir,10,0,34,24
1657776105589,MATH 193A,A05,093482,Rotar; Vladimir,10,0,34,24
1657776111613,MATH 197,001,091859,McAuley; Julian John,9999,0,9999,0
1657776111613,MATH 197,002,095566,Kedlaya; Kiran S.,9997,0,9999,2
1657776111613,MATH 197,003,095567,Xiao; Ming,9999,0,9999,0
1657776111613,MATH 197,004,095571,Perols; Johan Lars,9998,0,9999,1
1657776118676,COGS 9,A01,083615,Shannon; Kyle Michael,9,0,75,66
1657776124700,COGS 11,A01,083617,Boyle; Mary E. T.,23,0,48,25
1657776130724,COGS 13,A01,083071,Bastos; Amalia Pinkusfeld,11,0,71,60
1657776136745,COGS 14A,A01,092681,Semenuks; Arturs,5,1,100,95
1657776142771,COGS 14B,A01,083073,Cheng; Tzu-Han,6,0,63,57
1657776148798,COGS 17,A01,092677,Semenuks; Arturs,6,0,81,75
1657776154821,COGS 100,A01,083619,Allen; Michael Gordon,17,0,70,53
1657776160853,COGS 101A,A01,083621,Davis; Joshua Daniel,9,0,68,59
1657776166875,COGS 101B,A01,091572,Allen; Michael Gordon,12,0,65,53
1657776172901,COGS 101C,A01,083625,Delgado; Tania,17,0,35,18
1657776178924,COGS 107A,A01,083627,Boyle; Mary E. T.,14,0,60,46
1657776184947,COGS 118A,A01,083075,Gupta; Anjum,21,0,76,55
1657776190970,CSE 3,A50,083646,Miranda; Gregory Joseph,24,0,50,26
1657776197000,CSE 8A,A50,083650,Miranda; Gregory Joseph,17,1,56,39
1657776203023,CSE 11,A01,083080,Cao; Yingjun,6,15,40,34
1657776209049,CSE 12,A01,083652,Krause-Levy; Sophia Louisa,28,1,120,92
1657776215071,CSE 15L,A01,083654,Morris; Justin Loren,9,0,50,41
1657776215071,CSE 15L,A02,083655,Morris; Justin Loren,9,0,50,41
1657776221096,CSE 20,A01,083657,Tran; Khoa Dang,39,0,80,41
1657776227118,CSE 21,A01,095574,Bach; Quang Tran,22,0,48,26
1657776233141,CSE 30,A01,083084,Eldon; John,6,0,80,74
1657776233141,CSE 30,B01,095061,Bhaskar; Nishant,9,0,50,41
1657776239165,CSE 100,A01,083659,Cao; Yingjun,5,4,70,65
1657776245189,CSE 134B,A01,083661,Powell; Thomas Allan,24,0,100,76
1657776251215,CSE 140,A01,083663,Gungor; Onat,15,0,85,70
1657776257237,CSE 140L,A01,083088,Eldon; John,23,0,100,77
1657776263263,CSE 175,A01,083665,Kumar; Rakesh,3,0,25,22
1657776269287,CSE 190,A00,092507,Dubnov; Shlomo,8,0,20,12
1657776275310,ECE 45,A01,083139,Congero; Spencer William,6,0,75,69
1657776281335,ECE 65,A50,083695,Saad; Andrew S,12,0,30,18
1657776281335,ECE 65,A51,095125,Saad; Andrew S,24,0,26,2
1657776287363,ECE 109,A01,091882,Touri; Behrouz,20,0,70,50
1657776293387,ECE 180,A00,083140,Abi Samra; Nicholas Camill,1,0,30,29
1657776293387,ECE 180,B00,083141,Abi Samra; Nicholas Camill,0,0,30,30
1657776299409,MATH 10A,A01,083735,Patchell; Gregory David,2,0,30,28
1657776299409,MATH 10A,A02,083736,Patchell; Gregory David,20,0,30,10
1657776299409,MATH 10A,A03,083737,Patchell; Gregory David,16,0,30,14
1657776305434,MATH 10B,A01,083207,Lim; Seonhee,8,0,34,26
1657776305434,MATH 10B,A02,083208,Lim; Seonhee,9,0,35,26
1657776305434,MATH 10B,A03,093472,Lim; Seonhee,7,0,34,27
1657776305434,MATH 10B,B01,083739,Sinha; Shubham,13,0,30,17
1657776311457,MATH 18,A01,083743,Cinel; Cameron Alexander,9,0,30,21
1657776311457,MATH 18,A02,083744,Cinel; Cameron Alexander,18,0,30,12
1657776311457,MATH 18,A03,083745,Cinel; Cameron Alexander,10,0,30,20
1657776311457,MATH 18,B01,083748,Rideout; David Porter,5,0,37,32
1657776311457,MATH 18,B02,083749,Rideout; David Porter,5,0,36,31
1657776311457,MATH 18,B03,083750,Rideout; David Porter,3,0,37,34
1657776311457,MATH 18,B04,083751,Rideout; David Porter,6,0,36,30
1657776311457,MATH 18,B05,093473,Rideout; David Porter,6,0,36,30
1657776311457,MATH 18,B06,093474,Rideout; David Porter,6,0,36,30
1657776317487,MATH 20A,A01,083754,Zheng; Zequn,14,0,40,26
1657776323516,MATH 20B,A01,083756,Briones; Jor-el Thomas Caparas,4,0,36,32
1657776323516,MATH 20B,A02,083757,Briones; Jor-el Thomas Caparas,1,0,36,35
1657776323516,MATH 20B,A03,093475,Briones; Jor-el Thomas Caparas,2,0,36,34
1657776329549,MATH 20C,A01,083760,Briones; Jor-el Thomas Caparas,1,0,35,34
1657776329549,MATH 20C,A02,083761,Briones; Jor-el Thomas Caparas,8,0,35,27
1657776329549,MATH 20C,A03,093476,Briones; Jor-el Thomas Caparas,0,1,36,36
1657776329549,MATH 20C,B01,083762,Bach; Quang Tran,1,0,30,29
1657776335583,MATH 20D,A01,083765,Tran; Brian Kha,5,0,30,25
1657776335583,MATH 20D,A02,083766,Tran; Brian Kha,5,0,30,25
1657776335583,MATH 20D,A03,083767,Tran; Brian Kha,5,0,30,25
1657776341611,MATH 20E,A01,083771,Ganguly; Soumya,9,0,32,23
1657776341611,MATH 20E,A02,083772,Ganguly; Soumya,6,0,32,26
1657776341611,MATH 20E,B01,083773,Ciotti; Benjamin,20,0,35,15
1657776341611,MATH 20E,B02,083774,Ciotti; Benjamin,18,0,35,17
1657776347638,MATH 103A,A01,083777,Greenfeld; Be'Eri,3,0,36,33
1657776347638,MATH 103A,A02,083778,Greenfeld; Be'Eri,5,0,36,31
1657776347638,MATH 103A,A03,093561,Greenfeld; Be'Eri,6,0,36,30
1657776347638,MATH 103A,B01,083779,Greenfeld; Be'Eri,7,0,36,29
1657776347638,MATH 103A,B02,083780,Greenfeld; Be'Eri,4,0,36,32
1657776347638,MATH 103A,B03,093562,Greenfeld; Be'Eri,3,0,36,33
1657776353673,MATH 105,A01,085443,Carter; Anne Toulson,15,0,35,20
1657776353673,MATH 105,A02,093477,Carter; Anne Toulson,20,0,35,15
1657776359697,MATH 109,A01,083213,Ganzberger; Geoffrey Michael,3,0,34,31
1657776359697,MATH 109,A02,083214,Ganzberger; Geoffrey Michael,4,0,34,30
1657776359697,MATH 109,A03,093478,Ganzberger; Geoffrey Michael,2,0,34,32
1657776359697,MATH 109,B01,083215,Ganzberger; Geoffrey Michael,1,0,32,31
1657776359697,MATH 109,B02,083216,Ganzberger; Geoffrey Michael,2,0,32,30
1657776359697,MATH 109,B03,093479,Ganzberger; Geoffrey Michael,8,0,32,24
1657776365722,MATH 142A,A01,083219,Chow; Bennett,7,0,32,25
1657776365722,MATH 142A,A02,083220,Chow; Bennett,10,0,32,22
1657776365722,MATH 142A,A03,093480,Chow; Bennett,9,0,32,23
1657776365722,MATH 142A,B03,093481,Chow; Bennett,8,0,32,24
1657776365722,MATH 142A,B04,093558,Chow; Bennett,13,0,32,19
1657776365722,MATH 142A,B05,093559,Chow; Bennett,6,0,32,26
1657776371745,MATH 193A,A01,083224,Rotar; Vladimir,8,0,34,26
1657776371745,MATH 193A,A02,083225,Rotar; Vladimir,9,0,34,25
1657776371745,MATH 193A,A03,083781,Rotar; Vladimir,5,0,34,29
1657776371745,MATH 193A,A04,083782,Rotar; Vladimir,10,0,34,24
1657776371745,MATH 193A,A05,093482,Rotar; Vladimir,10,0,34,24
1657776377772,MATH 197,001,091859,McAuley; Julian John,9999,0,9999,0
1657776377772,MATH 197,002,095566,Kedlaya; Kiran S.,9997,0,9999,2
1657776377772,MATH 197,003,095567,Xiao; Ming,9999,0,9999,0
1657776377772,MATH 197,004,095571,Perols; Johan Lars,9998,0,9999,1
1657776384838,COGS 9,A01,083615,Shannon; Kyle Michael,9,0,75,66
1657776390861,COGS 11,A01,083617,Boyle; Mary E. T.,23,0,48,25
1657776396885,COGS 13,A01,083071,Bastos; Amalia Pinkusfeld,11,0,71,60
1657776402909,COGS 14A,A01,092681,Semenuks; Arturs,5,1,100,95
1657776408936,COGS 14B,A01,083073,Cheng; Tzu-Han,6,0,63,57
1657776414967,COGS 17,A01,092677,Semenuks; Arturs,6,0,81,75
1657776420989,COGS 100,A01,083619,Allen; Michael Gordon,17,0,70,53
1657776427021,COGS 101A,A01,083621,Davis; Joshua Daniel,9,0,68,59
1657776433052,COGS 101B,A01,091572,Allen; Michael Gordon,12,0,65,53
1657776439093,COGS 101C,A01,083625,Delgado; Tania,17,0,35,18
1657776445119,COGS 107A,A01,083627,Boyle; Mary E. T.,14,0,60,46
1657776451144,COGS 118A,A01,083075,Gupta; Anjum,21,0,76,55
1657776457171,CSE 3,A50,083646,Miranda; Gregory Joseph,24,0,50,26
1657776463199,CSE 8A,A50,083650,Miranda; Gregory Joseph,17,1,56,39
1657776469231,CSE 11,A01,083080,Cao; Yingjun,6,15,40,34
1657776475255,CSE 12,A01,083652,Krause-Levy; Sophia Louisa,28,1,120,92
1657776481282,CSE 15L,A01,083654,Morris; Justin Loren,9,0,50,41
1657776481282,CSE 15L,A02,083655,Morris; Justin Loren,9,0,50,41
1657776487305,CSE 20,A01,083657,Tran; Khoa Dang,39,0,80,41
1657776493332,CSE 21,A01,095574,Bach; Quang Tran,22,0,48,26
1657776499359,CSE 30,A01,083084,Eldon; John,6,0,80,74
1657776499359,CSE 30,B01,095061,Bhaskar; Nishant,9,0,50,41
1657776505396,CSE 100,A01,083659,Cao; Yingjun,5,4,70,65
1657776511421,CSE 134B,A01,083661,Powell; Thomas Allan,24,0,100,76
1657776517447,CSE 140,A01,083663,Gungor; Onat,15,0,85,70
1657776523470,CSE 140L,A01,083088,Eldon; John,23,0,100,77
1657776529495,CSE 175,A01,083665,Kumar; Rakesh,3,0,25,22
1657776535518,CSE 190,A00,092507,Dubnov; Shlomo,8,0,20,12
1657776541539,ECE 45,A01,083139,Congero; Spencer William,6,0,75,69
1657776547563,ECE 65,A50,083695,Saad; Andrew S,12,0,30,18
1657776547563,ECE 65,A51,095125,Saad; Andrew S,24,0,26,2
1657776553584,ECE 109,A01,091882,Touri; Behrouz,20,0,70,50
1657776559609,ECE 180,A00,083140,Abi Samra; Nicholas Camill,1,0,30,29
1657776559609,ECE 180,B00,083141,Abi Samra; Nicholas Camill,0,0,30,30
1657776565636,MATH 10A,A01,083735,Patchell; Gregory David,2,0,30,28
1657776565636,MATH 10A,A02,083736,Patchell; Gregory David,20,0,30,10
1657776565636,MATH 10A,A03,083737,Patchell; Gregory David,16,0,30,14
1657776571663,MATH 10B,A01,083207,Lim; Seonhee,8,0,34,26
1657776571663,MATH 10B,A02,083208,Lim; Seonhee,9,0,35,26
1657776571663,MATH 10B,A03,093472,Lim; Seonhee,7,0,34,27
1657776571663,MATH 10B,B01,083739,Sinha; Shubham,13,0,30,17
1657776577694,MATH 18,A01,083743,Cinel; Cameron Alexander,9,0,30,21
1657776577694,MATH 18,A02,083744,Cinel; Cameron Alexander,18,0,30,12
1657776577694,MATH 18,A03,083745,Cinel; Cameron Alexander,10,0,30,20
1657776577694,MATH 18,B01,083748,Rideout; David Porter,5,0,37,32
1657776577694,MATH 18,B02,083749,Rideout; David Porter,5,0,36,31
1657776577694,MATH 18,B03,083750,Rideout; David Porter,3,0,37,34
1657776577694,MATH 18,B04,083751,Rideout; David Porter,6,0,36,30
1657776577694,MATH 18,B05,093473,Rideout; David Porter,6,0,36,30
1657776577694,MATH 18,B06,093474,Rideout; David Porter,6,0,36,30
1657776583721,MATH 20A,A01,083754,Zheng; Zequn,14,0,40,26
1657776589743,MATH 20B,A01,083756,Briones; Jor-el Thomas Caparas,4,0,36,32
1657776589743,MATH 20B,A02,083757,Briones; Jor-el Thomas Caparas,1,0,36,35
1657776589743,MATH 20B,A03,093475,Briones; Jor-el Thomas Caparas,2,0,36,34
1657776595774,MATH 20C,A01,083760,Briones; Jor-el Thomas Caparas,1,0,35,34
1657776595774,MATH 20C,A02,083761,Briones; Jor-el Thomas Caparas,8,0,35,27
1657776595774,MATH 20C,A03,093476,Briones; Jor-el Thomas Caparas,0,1,36,36
1657776595774,MATH 20C,B01,083762,Bach; Quang Tran,1,0,30,29
1657776601889,MATH 20D,A01,083765,Tran; Brian Kha,5,0,30,25
1657776601889,MATH 20D,A02,083766,Tran; Brian Kha,5,0,30,25
1657776601889,MATH 20D,A03,083767,Tran; Brian Kha,5,0,30,25
1657776607917,MATH 20E,A01,083771,Ganguly; Soumya,9,0,32,23
1657776607917,MATH 20E,A02,083772,Ganguly; Soumya,6,0,32,26
1657776607917,MATH 20E,B01,083773,Ciotti; Benjamin,20,0,35,15
1657776607917,MATH 20E,B02,083774,Ciotti; Benjamin,18,0,35,17
1657776613945,MATH 103A,A01,083777,Greenfeld; Be'Eri,3,0,36,33
1657776613945,MATH 103A,A02,083778,Greenfeld; Be'Eri,5,0,36,31
1657776613945,MATH 103A,A03,093561,Greenfeld; Be'Eri,6,0,36,30
1657776613945,MATH 103A,B01,083779,Greenfeld; Be'Eri,7,0,36,29
1657776613945,MATH 103A,B02,083780,Greenfeld; Be'Eri,4,0,36,32
1657776613945,MATH 103A,B03,093562,Greenfeld; Be'Eri,3,0,36,33
1657776619969,MATH 105,A01,085443,Carter; Anne Toulson,15,0,35,20
1657776619969,MATH 105,A02,093477,Carter; Anne Toulson,20,0,35,15
1657776625997,MATH 109,A01,083213,Ganzberger; Geoffrey Michael,3,0,34,31
1657776625997,MATH 109,A02,083214,Ganzberger; Geoffrey Michael,4,0,34,30
1657776625997,MATH 109,A03,093478,Ganzberger; Geoffrey Michael,2,0,34,32
1657776625997,MATH 109,B01,083215,Ganzberger; Geoffrey Michael,1,0,32,31
1657776625997,MATH 109,B02,083216,Ganzberger; Geoffrey Michael,2,0,32,30
1657776625997,MATH 109,B03,093479,Ganzberger; Geoffrey Michael,8,0,32,24
1657776632021,MATH 142A,A01,083219,Chow; Bennett,7,0,32,25
1657776632021,MATH 142A,A02,083220,Chow; Bennett,10,0,32,22
1657776632021,MATH 142A,A03,093480,Chow; Bennett,9,0,32,23
1657776632021,MATH 142A,B03,093481,Chow; Bennett,8,0,32,24
1657776632021,MATH 142A,B04,093558,Chow; Bennett,13,0,32,19
1657776632021,MATH 142A,B05,093559,Chow; Bennett,6,0,32,26
1657776638045,MATH 193A,A01,083224,Rotar; Vladimir,8,0,34,26
1657776638045,MATH 193A,A02,083225,Rotar; Vladimir,9,0,34,25
1657776638045,MATH 193A,A03,083781,Rotar; Vladimir,5,0,34,29
1657776638045,MATH 193A,A04,083782,Rotar; Vladimir,10,0,34,24
1657776638045,MATH 193A,A05,093482,Rotar; Vladimir,10,0,34,24
1657776644071,MATH 197,001,091859,McAuley; Julian John,9999,0,9999,0
1657776644071,MATH 197,002,095566,Kedlaya; Kiran S.,9997,0,9999,2
1657776644071,MATH 197,003,095567,Xiao; Ming,9999,0,9999,0
1657776644071,MATH 197,004,095571,Perols; Johan Lars,9998,0,9999,1
1657776651134,COGS 9,A01,083615,Shannon; Kyle Michael,9,0,75,66
1657776657158,COGS 11,A01,083617,Boyle; Mary E. T.,23,0,48,25
1657776663182,COGS 13,A01,083071,Bastos; Amalia Pinkusfeld,11,0,71,60
1657776669206,COGS 14A,A01,092681,Semenuks; Arturs,5,1,100,95
1657776675228,COGS 14B,A01,083073,Cheng; Tzu-Han,6,0,63,57
1657776681263,COGS 17,A01,092677,Semenuks; Arturs,6,0,81,75
1657776687285,COGS 100,A01,083619,Allen; Michael Gordon,17,0,70,53
1657776693308,COGS 101A,A01,083621,Davis; Joshua Daniel,9,0,68,59
1657776699332,COGS 101B,A01,091572,Allen; Michael Gordon,12,0,65,53
1657776705359,COGS 101C,A01,083625,Delgado; Tania,17,0,35,18
1657776711381,COGS 107A,A01,083627,Boyle; Mary E. T.,14,0,60,46
1657776717405,COGS 118A,A01,083075,Gupta; Anjum,21,0,76,55
1657776723429,CSE 3,A50,083646,Miranda; Gregory Joseph,24,0,50,26
1657776729450,CSE 8A,A50,083650,Miranda; Gregory Joseph,17,1,56,39
1657776735474,CSE 11,A01,083080,Cao; Yingjun,6,15,40,34
1657776741501,CSE 12,A01,083652,Krause-Levy; Sophia Louisa,28,1,120,92
1657776747522,CSE 15L,A01,083654,Morris; Justin Loren,9,0,50,41
1657776747522,CSE 15L,A02,083655,Morris; Justin Loren,9,0,50,41
1657776753549,CSE 20,A01,083657,Tran; Khoa Dang,39,0,80,41
1657776759572,CSE 21,A01,095574,Bach; Quang Tran,22,0,48,26
1657776765596,CSE 30,A01,083084,Eldon; John,6,0,80,74
1657776765596,CSE 30,B01,095061,Bhaskar; Nishant,9,0,50,41
1657776771621,CSE 100,A01,083659,Cao; Yingjun,5,4,70,65
1657776777645,CSE 134B,A01,083661,Powell; Thomas Allan,24,0,100,76
1657776783668,CSE 140,A01,083663,Gungor; Onat,15,0,85,70
1657776789691,CSE 140L,A01,083088,Eldon; John,23,0,100,77
1657776795718,CSE 175,A01,083665,Kumar; Rakesh,3,0,25,22
1657776801748,CSE 190,A00,092507,Dubnov; Shlomo,8,0,20,12
1657776807780,ECE 45,A01,083139,Congero; Spencer William,6,0,75,69
1657776813804,ECE 65,A50,083695,Saad; Andrew S,12,0,30,18
1657776813804,ECE 65,A51,095125,Saad; Andrew S,24,0,26,2
1657776819832,ECE 109,A01,091882,Touri; Behrouz,20,0,70,50
1657776825855,ECE 180,A00,083140,Abi Samra; Nicholas Camill,1,0,30,29
1657776825855,ECE 180,B00,083141,Abi Samra; Nicholas Camill,0,0,30,30
1657776831882,MATH 10A,A01,083735,Patchell; Gregory David,2,0,30,28
1657776831882,MATH 10A,A02,083736,Patchell; Gregory David,20,0,30,10
1657776831882,MATH 10A,A03,083737,Patchell; Gregory David,16,0,30,14
1657776837905,MATH 10B,A01,083207,Lim; Seonhee,8,0,34,26
1657776837905,MATH 10B,A02,083208,Lim; Seonhee,10,0,35,25
1657776837905,MATH 10B,A03,093472,Lim; Seonhee,7,0,34,27
1657776837905,MATH 10B,B01,083739,Sinha; Shubham,13,0,30,17
1657776843936,MATH 18,A01,083743,Cinel; Cameron Alexander,9,0,30,21
1657776843936,MATH 18,A02,083744,Cinel; Cameron Alexander,18,0,30,12
1657776843936,MATH 18,A03,083745,Cinel; Cameron Alexander,10,0,30,20
1657776843936,MATH 18,B01,083748,Rideout; David Porter,5,0,37,32
1657776843936,MATH 18,B02,083749,Rideout; David Porter,5,0,36,31
1657776843936,MATH 18,B03,083750,Rideout; David Porter,3,0,37,34
1657776843936,MATH 18,B04,083751,Rideout; David Porter,6,0,36,30
1657776843936,MATH 18,B05,093473,Rideout; David Porter,6,0,36,30
1657776843936,MATH 18,B06,093474,Rideout; David Porter,6,0,36,30
1657776849960,MATH 20A,A01,083754,Zheng; Zequn,14,0,40,26
1657776855991,MATH 20B,A01,083756,Briones; Jor-el Thomas Caparas,4,0,36,32
1657776855991,MATH 20B,A02,083757,Briones; Jor-el Thomas Caparas,1,0,36,35
1657776855991,MATH 20B,A03,093475,Briones; Jor-el Thomas Caparas,2,0,36,34
1657776862015,MATH 20C,A01,083760,Briones; Jor-el Thomas Caparas,1,0,35,34
1657776862015,MATH 20C,A02,083761,Briones; Jor-el Thomas Caparas,8,0,35,27
1657776862015,MATH 20C,A03,093476,Briones; Jor-el Thomas Caparas,0,1,36,36
1657776862015,MATH 20C,B01,083762,Bach; Quang Tran,1,0,30,29
1657776868043,MATH 20D,A01,083765,Tran; Brian Kha,5,0,30,25
1657776868043,MATH 20D,A02,083766,Tran; Brian Kha,5,0,30,25
1657776868043,MATH 20D,A03,083767,Tran; Brian Kha,5,0,30,25
1657776874067,MATH 20E,A01,083771,Ganguly; Soumya,9,0,32,23
1657776874067,MATH 20E,A02,083772,Ganguly; Soumya,6,0,32,26
1657776874067,MATH 20E,B01,083773,Ciotti; Benjamin,20,0,35,15
1657776874067,MATH 20E,B02,083774,Ciotti; Benjamin,18,0,35,17
1657776880100,MATH 103A,A01,083777,Greenfeld; Be'Eri,3,0,36,33
1657776880100,MATH 103A,A02,083778,Greenfeld; Be'Eri,5,0,36,31
1657776880100,MATH 103A,A03,093561,Greenfeld; Be'Eri,6,0,36,30
1657776880100,MATH 103A,B01,083779,Greenfeld; Be'Eri,7,0,36,29
1657776880100,MATH 103A,B02,083780,Greenfeld; Be'Eri,4,0,36,32
1657776880100,MATH 103A,B03,093562,Greenfeld; Be'Eri,3,0,36,33
1657776886132,MATH 105,A01,085443,Carter; Anne Toulson,15,0,35,20
1657776886132,MATH 105,A02,093477,Carter; Anne Toulson,20,0,35,15
1657776892156,MATH 109,A01,083213,Ganzberger; Geoffrey Michael,3,0,34,31
1657776892156,MATH 109,A02,083214,Ganzberger; Geoffrey Michael,4,0,34,30
1657776892156,MATH 109,A03,093478,Ganzberger; Geoffrey Michael,2,0,34,32
1657776892156,MATH 109,B01,083215,Ganzberger; Geoffrey Michael,1,0,32,31
1657776892156,MATH 109,B02,083216,Ganzberger; Geoffrey Michael,2,0,32,30
1657776892156,MATH 109,B03,093479,Ganzberger; Geoffrey Michael,8,0,32,24
1657776898179,MATH 142A,A01,083219,Chow; Bennett,7,0,32,25
1657776898179,MATH 142A,A02,083220,Chow; Bennett,10,0,32,22
1657776898179,MATH 142A,A03,093480,Chow; Bennett,9,0,32,23
1657776898179,MATH 142A,B03,093481,Chow; Bennett,8,0,32,24
1657776898179,MATH 142A,B04,093558,Chow; Bennett,13,0,32,19
1657776898179,MATH 142A,B05,093559,Chow; Bennett,6,0,32,26
1657776904203,MATH 193A,A01,083224,Rotar; Vladimir,8,0,34,26
1657776904203,MATH 193A,A02,083225,Rotar; Vladimir,9,0,34,25
1657776904203,MATH 193A,A03,083781,Rotar; Vladimir,5,0,34,29
1657776904203,MATH 193A,A04,083782,Rotar; Vladimir,10,0,34,24
1657776904203,MATH 193A,A05,093482,Rotar; Vladimir,10,0,34,24
1657776910233,MATH 197,001,091859,McAuley; Julian John,9999,0,9999,0
1657776910233,MATH 197,002,095566,Kedlaya; Kiran S.,9997,0,9999,2
1657776910233,MATH 197,003,095567,Xiao; Ming,9999,0,9999,0
1657776910233,MATH 197,004,095571,Perols; Johan Lars,9998,0,9999,1
1657776917286,COGS 9,A01,083615,Shannon; Kyle Michael,9,0,75,66
1657776923315,COGS 11,A01,083617,Boyle; Mary E. T.,23,0,48,25
1657776929342,COGS 13,A01,083071,Bastos; Amalia Pinkusfeld,11,0,71,60
1657776935369,COGS 14A,A01,092681,Semenuks; Arturs,5,1,100,95
1657776941392,COGS 14B,A01,083073,Cheng; Tzu-Han,6,0,63,57
1657776947419,COGS 17,A01,092677,Semenuks; Arturs,6,0,81,75
1657776953446,COGS 100,A01,083619,Allen; Michael Gordon,17,0,70,53
1657776959473,COGS 101A,A01,083621,Davis; Joshua Daniel,9,0,68,59
1657776965508,COGS 101B,A01,091572,Allen; Michael Gordon,12,0,65,53
1657776971531,COGS 101C,A01,083625,Delgado; Tania,17,0,35,18
1657776977554,COGS 107A,A01,083627,Boyle; Mary E. T.,14,0,60,46
1657776983602,COGS 118A,A01,083075,Gupta; Anjum,21,0,76,55
1657776989625,CSE 3,A50,083646,Miranda; Gregory Joseph,24,0,50,26
1657776995649,CSE 8A,A50,083650,Miranda; Gregory Joseph,17,1,56,39
1657777001671,CSE 11,A01,083080,Cao; Yingjun,6,15,40,34
1657777007693,CSE 12,A01,083652,Krause-Levy; Sophia Louisa,28,1,120,92
1657777013716,CSE 15L,A01,083654,Morris; Justin Loren,9,0,50,41
1657777013716,CSE 15L,A02,083655,Morris; Justin Loren,9,0,50,41
1657777019739,CSE 20,A01,083657,Tran; Khoa Dang,39,0,80,41
1657777025787,CSE 21,A01,095574,Bach; Quang Tran,22,0,48,26
1657777031811,CSE 30,A01,083084,Eldon; John,6,0,80,74
1657777031811,CSE 30,B01,095061,Bhaskar; Nishant,9,0,50,41
1657777037834,CSE 100,A01,083659,Cao; Yingjun,5,4,70,65
1657777043861,CSE 134B,A01,083661,Powell; Thomas Allan,24,0,100,76
1657777049894,CSE 140,A01,083663,Gungor; Onat,15,0,85,70
1657777055921,CSE 140L,A01,083088,Eldon; John,23,0,100,77
1657777061944,CSE 175,A01,083665,Kumar; Rakesh,3,0,25,22
1657777067970,CSE 190,A00,092507,Dubnov; Shlomo,8,0,20,12
1657777074001,ECE 45,A01,083139,Congero; Spencer William,6,0,75,69
1657777080024,ECE 65,A50,083695,Saad; Andrew S,12,0,30,18
1657777080024,ECE 65,A51,095125,Saad; Andrew S,24,0,26,2
1657777086049,ECE 109,A01,091882,Touri; Behrouz,20,0,70,50
1657777092071,ECE 180,A00,083140,Abi Samra; Nicholas Camill,1,0,30,29
1657777092071,ECE 180,B00,083141,Abi Samra; Nicholas Camill,0,0,30,30
1657777098101,MATH 10A,A01,083735,Patchell; Gregory David,2,0,30,28
1657777098101,MATH 10A,A02,083736,Patchell; Gregory David,20,0,30,10
1657777098101,MATH 10A,A03,083737,Patchell; Gregory David,16,0,30,14
1657777104128,MATH 10B,A01,083207,Lim; Seonhee,8,0,34,26
1657777104128,MATH 10B,A02,083208,Lim; Seonhee,10,0,35,25
1657777104128,MATH 10B,A03,093472,Lim; Seonhee,7,0,34,27
1657777104128,MATH 10B,B01,083739,Sinha; Shubham,13,0,30,17
1657777110159,MATH 18,A01,083743,Cinel; Cameron Alexander,9,0,30,21
1657777110159,MATH 18,A02,083744,Cinel; Cameron Alexander,18,0,30,12
1657777110159,MATH 18,A03,083745,Cinel; Cameron Alexander,10,0,30,20
1657777110159,MATH 18,B01,083748,Rideout; David Porter,5,0,37,32
1657777110159,MATH 18,B02,083749,Rideout; David Porter,5,0,36,31
1657777110159,MATH 18,B03,083750,Rideout; David Porter,3,0,37,34
1657777110159,MATH 18,B04,083751,Rideout; David Porter,6,0,36,30
1657777110159,MATH 18,B05,093473,Rideout; David Porter,6,0,36,30
1657777110159,MATH 18,B06,093474,Rideout; David Porter,6,0,36,30
1657777116186,MATH 20A,A01,083754,Zheng; Zequn,14,0,40,26
1657777122209,MATH 20B,A01,083756,Briones; Jor-el Thomas Caparas,4,0,36,32
1657777122209,MATH 20B,A02,083757,Briones; Jor-el Thomas Caparas,1,0,36,35
1657777122209,MATH 20B,A03,093475,Briones; Jor-el Thomas Caparas,2,0,36,34
1657777128237,MATH 20C,A01,083760,Briones; Jor-el Thomas Caparas,1,0,35,34
1657777128237,MATH 20C,A02,083761,Briones; Jor-el Thomas Caparas,8,0,35,27
1657777128237,MATH 20C,A03,093476,Briones; Jor-el Thomas Caparas,0,1,36,36
1657777128237,MATH 20C,B01,083762,Bach; Quang Tran,1,0,30,29
1657777134261,MATH 20D,A01,083765,Tran; Brian Kha,5,0,30,25
1657777134261,MATH 20D,A02,083766,Tran; Brian Kha,5,0,30,25
1657777134261,MATH 20D,A03,083767,Tran; Brian Kha,5,0,30,25
1657777140285,MATH 20E,A01,083771,Ganguly; Soumya,9,0,32,23
1657777140285,MATH 20E,A02,083772,Ganguly; Soumya,6,0,32,26
1657777140285,MATH 20E,B01,083773,Ciotti; Benjamin,20,0,35,15
1657777140285,MATH 20E,B02,083774,Ciotti; Benjamin,18,0,35,17
1657777146314,MATH 103A,A01,083777,Greenfeld; Be'Eri,3,0,36,33
1657777146314,MATH 103A,A02,083778,Greenfeld; Be'Eri,5,0,36,31
1657777146314,MATH 103A,A03,093561,Greenfeld; Be'Eri,6,0,36,30
1657777146314,MATH 103A,B01,083779,Greenfeld; Be'Eri,7,0,36,29
1657777146314,MATH 103A,B02,083780,Greenfeld; Be'Eri,4,0,36,32
1657777146314,MATH 103A,B03,093562,Greenfeld; Be'Eri,3,0,36,33
1657777152342,MATH 105,A01,085443,Carter; Anne Toulson,15,0,35,20
1657777152342,MATH 105,A02,093477,Carter; Anne Toulson,20,0,35,15
1657777158367,MATH 109,A01,083213,Ganzberger; Geoffrey Michael,3,0,34,31
1657777158367,MATH 109,A02,083214,Ganzberger; Geoffrey Michael,4,0,34,30
1657777158367,MATH 109,A03,093478,Ganzberger; Geoffrey Michael,2,0,34,32
1657777158367,MATH 109,B01,083215,Ganzberger; Geoffrey Michael,1,0,32,31
1657777158367,MATH 109,B02,083216,Ganzberger; Geoffrey Michael,2,0,32,30
1657777158367,MATH 109,B03,093479,Ganzberger; Geoffrey Michael,8,0,32,24
1657777164396,MATH 142A,A01,083219,Chow; Bennett,7,0,32,25
1657777164396,MATH 142A,A02,083220,Chow; Bennett,10,0,32,22
1657777164396,MATH 142A,A03,093480,Chow; Bennett,9,0,32,23
1657777164396,MATH 142A,B03,093481,Chow; Bennett,8,0,32,24
1657777164396,MATH 142A,B04,093558,Chow; Bennett,13,0,32,19
1657777164396,MATH 142A,B05,093559,Chow; Bennett,6,0,32,26
1657777170419,MATH 193A,A01,083224,Rotar; Vladimir,8,0,34,26
1657777170419,MATH 193A,A02,083225,Rotar; Vladimir,9,0,34,25
1657777170419,MATH 193A,A03,083781,Rotar; Vladimir,5,0,34,29
1657777170419,MATH 193A,A04,083782,Rotar; Vladimir,10,0,34,24
1657777170419,MATH 193A,A05,093482,Rotar; Vladimir,10,0,34,24
1657777176442,MATH 197,001,091859,McAuley; Julian John,9999,0,9999,0
1657777176442,MATH 197,002,095566,Kedlaya; Kiran S.,9997,0,9999,2
1657777176442,MATH 197,003,095567,Xiao; Ming,9999,0,9999,0
1657777176442,MATH 197,004,095571,Perols; Johan Lars,9998,0,9999,1
1657777183496,COGS 9,A01,083615,Shannon; Kyle Michael,9,0,75,66
1657777189523,COGS 11,A01,083617,Boyle; Mary E. T.,23,0,48,25
1657777195618,COGS 13,A01,083071,Bastos; Amalia Pinkusfeld,11,0,71,60
1657777201645,COGS 14A,A01,092681,Semenuks; Arturs,5,1,100,95
1657777207667,COGS 14B,A01,083073,Cheng; Tzu-Han,6,0,63,57
1657777213690,COGS 17,A01,092677,Semenuks; Arturs,6,0,81,75
1657777219716,COGS 100,A01,083619,Allen; Michael Gordon,17,0,70,53
1657777225737,COGS 101A,A01,083621,Davis; Joshua Daniel,9,0,68,59
1657777231763,COGS 101B,A01,091572,Allen; Michael Gordon,12,0,65,53
1657777237785,COGS 101C,A01,083625,Delgado; Tania,17,0,35,18
1657777243814,COGS 107A,A01,083627,Boyle; Mary E. T.,14,0,60,46
1657777249839,COGS 118A,A01,083075,Gupta; Anjum,21,0,76,55
1657777255862,CSE 3,A50,083646,Miranda; Gregory Joseph,24,0,50,26
1657777261884,CSE 8A,A50,083650,Miranda; Gregory Joseph,17,1,56,39
1657777267910,CSE 11,A01,083080,Cao; Yingjun,6,15,40,34
1657777273933,CSE 12,A01,083652,Krause-Levy; Sophia Louisa,28,1,120,92
1657777279960,CSE 15L,A01,083654,Morris; Justin Loren,9,0,50,41
1657777279960,CSE 15L,A02,083655,Morris; Justin Loren,9,0,50,41
1657777285985,CSE 20,A01,083657,Tran; Khoa Dang,39,0,80,41
1657777292013,CSE 21,A01,095574,Bach; Quang Tran,22,0,48,26
1657777298037,CSE 30,A01,083084,Eldon; John,6,0,80,74
1657777298037,CSE 30,B01,095061,Bhaskar; Nishant,9,0,50,41
1657777304060,CSE 100,A01,083659,Cao; Yingjun,5,4,70,65
1657777310083,CSE 134B,A01,083661,Powell; Thomas Allan,24,0,100,76
1657777316110,CSE 140,A01,083663,Gungor; Onat,15,0,85,70
1657777322134,CSE 140L,A01,083088,Eldon; John,23,0,100,77
1657777328158,CSE 175,A01,083665,Kumar; Rakesh,3,0,25,22
1657777334182,CSE 190,A00,092507,Dubnov; Shlomo,8,0,20,12
1657777340206,ECE 45,A01,083139,Congero; Spencer William,6,0,75,69
1657777346230,ECE 65,A50,083695,Saad; Andrew S,12,0,30,18
1657777346230,ECE 65,A51,095125,Saad; Andrew S,24,0,26,2
1657777352259,ECE 109,A01,091882,Touri; Behrouz,20,0,70,50
1657777358285,ECE 180,A00,083140,Abi Samra; Nicholas Camill,1,0,30,29
1657777358285,ECE 180,B00,083141,Abi Samra; Nicholas Camill,0,0,30,30
1657777364308,MATH 10A,A01,083735,Patchell; Gregory David,2,0,30,28
1657777364308,MATH 10A,A02,083736,Patchell; Gregory David,20,0,30,10
1657777364308,MATH 10A,A03,083737,Patchell; Gregory David,16,0,30,14
1657777370336,MATH 10B,A01,083207,Lim; Seonhee,8,0,34,26
1657777370336,MATH 10B,A02,083208,Lim; Seonhee,10,0,35,25
1657777370336,MATH 10B,A03,093472,Lim; Seonhee,7,0,34,27
1657777370336,MATH 10B,B01,083739,Sinha; Shubham,13,0,30,17
1657777376367,MATH 18,A01,083743,Cinel; Cameron Alexander,9,0,30,21
1657777376367,MATH 18,A02,083744,Cinel; Cameron Alexander,18,0,30,12
1657777376367,MATH 18,A03,083745,Cinel; Cameron Alexander,10,0,30,20
1657777376367,MATH 18,B01,083748,Rideout; David Porter,5,0,37,32
1657777376367,MATH 18,B02,083749,Rideout; David Porter,5,0,36,31
1657777376367,MATH 18,B03,083750,Rideout; David Porter,3,0,37,34
1657777376367,MATH 18,B04,083751,Rideout; David Porter,6,0,36,30
1657777376367,MATH 18,B05,093473,Rideout; David Porter,6,0,36,30
1657777376367,MATH 18,B06,093474,Rideout; David Porter,6,0,36,30
1657777382397,MATH 20A,A01,083754,Zheng; Zequn,14,0,40,26
1657777388420,MATH 20B,A01,083756,Briones; Jor-el Thomas Caparas,4,0,36,32
1657777388420,MATH 20B,A02,083757,Briones; Jor-el Thomas Caparas,1,0,36,35
1657777388420,MATH 20B,A03,093475,Briones; Jor-el Thomas Caparas,2,0,36,34
1657777394447,MATH 20C,A01,083760,Briones; Jor-el Thomas Caparas,1,0,35,34
1657777394447,MATH 20C,A02,083761,Briones; Jor-el Thomas Caparas,8,0,35,27
1657777394447,MATH 20C,A03,093476,Briones; Jor-el Thomas Caparas,0,1,36,36
1657777394447,MATH 20C,B01,083762,Bach; Quang Tran,1,0,30,29
1657777400476,MATH 20D,A01,083765,Tran; Brian Kha,5,0,30,25
1657777400476,MATH 20D,A02,083766,Tran; Brian Kha,5,0,30,25
1657777400476,MATH 20D,A03,083767,Tran; Brian Kha,5,0,30,25
1657777406499,MATH 20E,A01,083771,Ganguly; Soumya,9,0,32,23
1657777406499,MATH 20E,A02,083772,Ganguly; Soumya,6,0,32,26
1657777406499,MATH 20E,B01,083773,Ciotti; Benjamin,20,0,35,15
1657777406499,MATH 20E,B02,083774,Ciotti; Benjamin,18,0,35,17
1657777412522,MATH 103A,A01,083777,Greenfeld; Be'Eri,3,0,36,33
1657777412522,MATH 103A,A02,083778,Greenfeld; Be'Eri,5,0,36,31
1657777412522,MATH 103A,A03,093561,Greenfeld; Be'Eri,6,0,36,30
1657777412522,MATH 103A,B01,083779,Greenfeld; Be'Eri,7,0,36,29
1657777412522,MATH 103A,B02,083780,Greenfeld; Be'Eri,4,0,36,32
1657777412522,MATH 103A,B03,093562,Greenfeld; Be'Eri,3,0,36,33
1657777418545,MATH 105,A01,085443,Carter; Anne Toulson,15,0,35,20
1657777418545,MATH 105,A02,093477,Carter; Anne Toulson,20,0,35,15
1657777424570,MATH 109,A01,083213,Ganzberger; Geoffrey Michael,3,0,34,31
1657777424570,MATH 109,A02,083214,Ganzberger; Geoffrey Michael,4,0,34,30
1657777424570,MATH 109,A03,093478,Ganzberger; Geoffrey Michael,2,0,34,32
1657777424570,MATH 109,B01,083215,Ganzberger; Geoffrey Michael,1,0,32,31
1657777424570,MATH 109,B02,083216,Ganzberger; Geoffrey Michael,2,0,32,30
1657777424570,MATH 109,B03,093479,Ganzberger; Geoffrey Michael,8,0,32,24
1657777430605,MATH 142A,A01,083219,Chow; Bennett,7,0,32,25
1657777430605,MATH 142A,A02,083220,Chow; Bennett,10,0,32,22
1657777430605,MATH 142A,A03,093480,Chow; Bennett,9,0,32,23
1657777430605,MATH 142A,B03,093481,Chow; Bennett,8,0,32,24
1657777430605,MATH 142A,B04,093558,Chow; Bennett,13,0,32,19
1657777430605,MATH 142A,B05,093559,Chow; Bennett,6,0,32,26
1657777436644,MATH 193A,A01,083224,Rotar; Vladimir,8,0,34,26
1657777436644,MATH 193A,A02,083225,Rotar; Vladimir,9,0,34,25
1657777436644,MATH 193A,A03,083781,Rotar; Vladimir,5,0,34,29
1657777436644,MATH 193A,A04,083782,Rotar; Vladimir,10,0,34,24
1657777436644,MATH 193A,A05,093482,Rotar; Vladimir,10,0,34,24
1657777442666,MATH 197,001,091859,McAuley; Julian John,9999,0,9999,0
1657777442666,MATH 197,002,095566,Kedlaya; Kiran S.,9997,0,9999,2
1657777442666,MATH 197,003,095567,Xiao; Ming,9999,0,9999,0
1657777442666,MATH 197,004,095571,Perols; Johan Lars,9998,0,9999,1
1657777449717,COGS 9,A01,083615,Shannon; Kyle Michael,9,0,75,66
1657777455749,COGS 11,A01,083617,Boyle; Mary E. T.,23,0,48,25
1657777461771,COGS 13,A01,083071,Bastos; Amalia Pinkusfeld,11,0,71,60
1657777467802,COGS 14A,A01,092681,Semenuks; Arturs,5,1,100,95
1657777473826,COGS 14B,A01,083073,Cheng; Tzu-Han,6,0,63,57
1657777479849,COGS 17,A01,092677,Semenuks; Arturs,6,0,81,75
1657777485871,COGS 100,A01,083619,Allen; Michael Gordon,17,0,70,53
1657777491902,COGS 101A,A01,083621,Davis; Joshua Daniel,9,0,68,59
1657777497926,COGS 101B,A01,091572,Allen; Michael Gordon,12,0,65,53
1657777503949,COGS 101C,A01,083625,Delgado; Tania,17,0,35,18
1657777509971,COGS 107A,A01,083627,Boyle; Mary E. T.,14,0,60,46
1657777515995,COGS 118A,A01,083075,Gupta; Anjum,21,0,76,55
1657777522018,CSE 3,A50,083646,Miranda; Gregory Joseph,24,0,50,26
1657777528039,CSE 8A,A50,083650,Miranda; Gregory Joseph,17,1,56,39
1657777534062,CSE 11,A01,083080,Cao; Yingjun,6,15,40,34
1657777540089,CSE 12,A01,083652,Krause-Levy; Sophia Louisa,28,1,120,92
1657777546112,CSE 15L,A01,083654,Morris; Justin Loren,9,0,50,41
1657777546112,CSE 15L,A02,083655,Morris; Justin Loren,9,0,50,41
1657777552135,CSE 20,A01,083657,Tran; Khoa Dang,39,0,80,41
1657777558161,CSE 21,A01,095574,Bach; Quang Tran,22,0,48,26
1657777564182,CSE 30,A01,083084,Eldon; John,6,0,80,74
1657777564182,CSE 30,B01,095061,Bhaskar; Nishant,9,0,50,41
1657777570204,CSE 100,A01,083659,Cao; Yingjun,5,4,70,65
1657777576228,CSE 134B,A01,083661,Powell; Thomas Allan,24,0,100,76
1657777582257,CSE 140,A01,083663,Gungor; Onat,15,0,85,70
1657777588279,CSE 140L,A01,083088,Eldon; John,23,0,100,77
1657777594303,CSE 175,A01,083665,Kumar; Rakesh,3,0,25,22
1657777600335,CSE 190,A00,092507,Dubnov; Shlomo,8,0,20,12
1657777606362,ECE 45,A01,083139,Congero; Spencer William,6,0,75,69
1657777612385,ECE 65,A50,083695,Saad; Andrew S,12,0,30,18
1657777612385,ECE 65,A51,095125,Saad; Andrew S,24,0,26,2
1657777618411,ECE 109,A01,091882,Touri; Behrouz,20,0,70,50
1657777624435,ECE 180,A00,083140,Abi Samra; Nicholas Camill,1,0,30,29
1657777624435,ECE 180,B00,083141,Abi Samra; Nicholas Camill,0,0,30,30
1657777630458,MATH 10A,A01,083735,Patchell; Gregory David,2,0,30,28
1657777630458,MATH 10A,A02,083736,Patchell; Gregory David,20,0,30,10
1657777630458,MATH 10A,A03,083737,Patchell; Gregory David,16,0,30,14
1657777636482,MATH 10B,A01,083207,Lim; Seonhee,8,0,34,26
1657777636482,MATH 10B,A02,083208,Lim; Seonhee,10,0,35,25
1657777636482,MATH 10B,A03,093472,Lim; Seonhee,7,0,34,27
1657777636482,MATH 10B,B01,083739,Sinha; Shubham,13,0,30,17
1657777642507,MATH 18,A01,083743,Cinel; Cameron Alexander,9,0,30,21
1657777642507,MATH 18,A02,083744,Cinel; Cameron Alexander,18,0,30,12
1657777642507,MATH 18,A03,083745,Cinel; Cameron Alexander,10,0,30,20
1657777642507,MATH 18,B01,083748,Rideout; David Porter,5,0,37,32
1657777642507,MATH 18,B02,083749,Rideout; David Porter,5,0,36,31
1657777642507,MATH 18,B03,083750,Rideout; David Porter,3,0,37,34
1657777642507,MATH 18,B04,083751,Rideout; David Porter,6,0,36,30
1657777642507,MATH 18,B05,093473,Rideout; David Porter,6,0,36,30
1657777642507,MATH 18,B06,093474,Rideout; David Porter,6,0,36,30
1657777648529,MATH 20A,A01,083754,Zheng; Zequn,14,0,40,26
1657777654567,MATH 20B,A01,083756,Briones; Jor-el Thomas Caparas,4,0,36,32
1657777654567,MATH 20B,A02,083757,Briones; Jor-el Thomas Caparas,1,0,36,35
1657777654567,MATH 20B,A03,093475,Briones; Jor-el Thomas Caparas,2,0,36,34
1657777660590,MATH 20C,A01,083760,Briones; Jor-el Thomas Caparas,1,0,35,34
1657777660590,MATH 20C,A02,083761,Briones; Jor-el Thomas Caparas,8,0,35,27
1657777660590,MATH 20C,A03,093476,Briones; Jor-el Thomas Caparas,0,1,36,36
1657777660590,MATH 20C,B01,083762,Bach; Quang Tran,1,0,30,29
1657777666615,MATH 20D,A01,083765,Tran; Brian Kha,5,0,30,25
1657777666615,MATH 20D,A02,083766,Tran; Brian Kha,5,0,30,25
1657777666615,MATH 20D,A03,083767,Tran; Brian Kha,5,0,30,25
1657777672662,MATH 20E,A01,083771,Ganguly; Soumya,9,0,32,23
1657777672662,MATH 20E,A02,083772,Ganguly; Soumya,6,0,32,26
1657777672662,MATH 20E,B01,083773,Ciotti; Benjamin,20,0,35,15
1657777672662,MATH 20E,B02,083774,Ciotti; Benjamin,18,0,35,17
1657777678701,MATH 103A,A01,083777,Greenfeld; Be'Eri,3,0,36,33
1657777678701,MATH 103A,A02,083778,Greenfeld; Be'Eri,5,0,36,31
1657777678701,MATH 103A,A03,093561,Greenfeld; Be'Eri,6,0,36,30
1657777678701,MATH 103A,B01,083779,Greenfeld; Be'Eri,7,0,36,29
1657777678701,MATH 103A,B02,083780,Greenfeld; Be'Eri,4,0,36,32
1657777678701,MATH 103A,B03,093562,Greenfeld; Be'Eri,3,0,36,33
1657777684722,MATH 105,A01,085443,Carter; Anne Toulson,15,0,35,20
1657777684722,MATH 105,A02,093477,Carter; Anne Toulson,20,0,35,15
1657777690749,MATH 109,A01,083213,Ganzberger; Geoffrey Michael,3,0,34,31
1657777690749,MATH 109,A02,083214,Ganzberger; Geoffrey Michael,4,0,34,30
1657777690749,MATH 109,A03,093478,Ganzberger; Geoffrey Michael,2,0,34,32
1657777690749,MATH 109,B01,083215,Ganzberger; Geoffrey Michael,1,0,32,31
1657777690749,MATH 109,B02,083216,Ganzberger; Geoffrey Michael,2,0,32,30
1657777690749,MATH 109,B03,093479,Ganzberger; Geoffrey Michael,8,0,32,24
1657777696772,MATH 142A,A01,083219,Chow; Bennett,7,0,32,25
1657777696772,MATH 142A,A02,083220,Chow; Bennett,10,0,32,22
1657777696772,MATH 142A,A03,093480,Chow; Bennett,9,0,32,23
1657777696772,MATH 142A,B03,093481,Chow; Bennett,8,0,32,24
1657777696772,MATH 142A,B04,093558,Chow; Bennett,13,0,32,19
1657777696772,MATH 142A,B05,093559,Chow; Bennett,6,0,32,26
1657777702795,MATH 193A,A01,083224,Rotar; Vladimir,8,0,34,26
1657777702795,MATH 193A,A02,083225,Rotar; Vladimir,9,0,34,25
1657777702795,MATH 193A,A03,083781,Rotar; Vladimir,5,0,34,29
1657777702795,MATH 193A,A04,083782,Rotar; Vladimir,10,0,34,24
1657777702795,MATH 193A,A05,093482,Rotar; Vladimir,10,0,34,24
1657777708819,MATH 197,001,091859,McAuley; Julian John,9999,0,9999,0
1657777708819,MATH 197,002,095566,Kedlaya; Kiran S.,9997,0,9999,2
1657777708819,MATH 197,003,095567,Xiao; Ming,9999,0,9999,0
1657777708819,MATH 197,004,095571,Perols; Johan Lars,9998,0,9999,1
1657777715878,COGS 9,A01,083615,Shannon; Kyle Michael,9,0,75,66
1657777721902,COGS 11,A01,083617,Boyle; Mary E. T.,23,0,48,25
1657777727925,COGS 13,A01,083071,Bastos; Amalia Pinkusfeld,11,0,71,60
1657777733951,COGS 14A,A01,092681,Semenuks; Arturs,5,1,100,95
1657777739974,COGS 14B,A01,083073,Cheng; Tzu-Han,6,0,63,57
1657777746004,COGS 17,A01,092677,Semenuks; Arturs,6,0,81,75
1657777752031,COGS 100,A01,083619,Allen; Michael Gordon,17,0,70,53
1657777758066,COGS 101A,A01,083621,Davis; Joshua Daniel,9,0,68,59
1657777764089,COGS 101B,A01,091572,Allen; Michael Gordon,12,0,65,53
1657777770115,COGS 101C,A01,083625,Delgado; Tania,17,0,35,18
1657777776142,COGS 107A,A01,083627,Boyle; Mary E. T.,14,0,60,46
1657777782165,COGS 118A,A01,083075,Gupta; Anjum,21,0,76,55
1657777788188,CSE 3,A50,083646,Miranda; Gregory Joseph,24,0,50,26
1657777794291,CSE 8A,A50,083650,Miranda; Gregory Joseph,17,1,56,39
1657777800313,CSE 11,A01,083080,Cao; Yingjun,6,15,40,34
1657777806341,CSE 12,A01,083652,Krause-Levy; Sophia Louisa,28,1,120,92
1657777812376,CSE 15L,A01,083654,Morris; Justin Loren,9,0,50,41
1657777812376,CSE 15L,A02,083655,Morris; Justin Loren,9,0,50,41
1657777818399,CSE 20,A01,083657,Tran; Khoa Dang,39,0,80,41
1657777824422,CSE 21,A01,095574,Bach; Quang Tran,22,0,48,26
1657777830450,CSE 30,A01,083084,Eldon; John,6,0,80,74
1657777830450,CSE 30,B01,095061,Bhaskar; Nishant,9,0,50,41
1657777836472,CSE 100,A01,083659,Cao; Yingjun,5,4,70,65
1657777842498,CSE 134B,A01,083661,Powell; Thomas Allan,24,0,100,76
1657777848523,CSE 140,A01,083663,Gungor; Onat,15,0,85,70
1657777854546,CSE 140L,A01,083088,Eldon; John,23,0,100,77
1657777860569,CSE 175,A01,083665,Kumar; Rakesh,3,0,25,22
1657777866594,CSE 190,A00,092507,Dubnov; Shlomo,8,0,20,12
1657777872616,ECE 45,A01,083139,Congero; Spencer William,6,0,75,69
1657777878641,ECE 65,A50,083695,Saad; Andrew S,12,0,30,18
1657777878641,ECE 65,A51,095125,Saad; Andrew S,24,0,26,2
1657777884667,ECE 109,A01,091882,Touri; Behrouz,20,0,70,50
1657777890690,ECE 180,A00,083140,Abi Samra; Nicholas Camill,1,0,30,29
1657777890690,ECE 180,B00,083141,Abi Samra; Nicholas Camill,0,0,30,30
1657777896726,MATH 10A,A01,083735,Patchell; Gregory David,2,0,30,28
1657777896726,MATH 10A,A02,083736,Patchell; Gregory David,20,0,30,10
1657777896726,MATH 10A,A03,083737,Patchell; Gregory David,16,0,30,14
1657777902754,MATH 10B,A01,083207,Lim; Seonhee,8,0,34,26
1657777902754,MATH 10B,A02,083208,Lim; Seonhee,10,0,35,25
1657777902754,MATH 10B,A03,093472,Lim; Seonhee,7,0,34,27
1657777902754,MATH 10B,B01,083739,Sinha; Shubham,13,0,30,17
1657777908780,MATH 18,A01,083743,Cinel; Cameron Alexander,9,0,30,21
1657777908780,MATH 18,A02,083744,Cinel; Cameron Alexander,18,0,30,12
1657777908780,MATH 18,A03,083745,Cinel; Cameron Alexander,10,0,30,20
1657777908780,MATH 18,B01,083748,Rideout; David Porter,5,0,37,32
1657777908780,MATH 18,B02,083749,Rideout; David Porter,5,0,36,31
1657777908780,MATH 18,B03,083750,Rideout; David Porter,3,0,37,34
1657777908780,MATH 18,B04,083751,Rideout; David Porter,6,0,36,30
1657777908780,MATH 18,B05,093473,Rideout; David Porter,6,0,36,30
1657777908780,MATH 18,B06,093474,Rideout; David Porter,6,0,36,30
1657777914806,MATH 20A,A01,083754,Zheng; Zequn,14,0,40,26
1657777920840,MATH 20B,A01,083756,Briones; Jor-el Thomas Caparas,4,0,36,32
1657777920840,MATH 20B,A02,083757,Briones; Jor-el Thomas Caparas,1,0,36,35
1657777920840,MATH 20B,A03,093475,Briones; Jor-el Thomas Caparas,2,0,36,34
1657777926869,MATH 20C,A01,083760,Briones; Jor-el Thomas Caparas,1,0,35,34
1657777926869,MATH 20C,A02,083761,Briones; Jor-el Thomas Caparas,8,0,35,27
1657777926869,MATH 20C,A03,093476,Briones; Jor-el Thomas Caparas,0,1,36,36
1657777926869,MATH 20C,B01,083762,Bach; Quang Tran,1,0,30,29
1657777932897,MATH 20D,A01,083765,Tran; Brian Kha,5,0,30,25
1657777932897,MATH 20D,A02,083766,Tran; Brian Kha,5,0,30,25
1657777932897,MATH 20D,A03,083767,Tran; Brian Kha,5,0,30,25
1657777938925,MATH 20E,A01,083771,Ganguly; Soumya,9,0,32,23
1657777938925,MATH 20E,A02,083772,Ganguly; Soumya,6,0,32,26
1657777938925,MATH 20E,B01,083773,Ciotti; Benjamin,20,0,35,15
1657777938925,MATH 20E,B02,083774,Ciotti; Benjamin,18,0,35,17
1657777944948,MATH 103A,A01,083777,Greenfeld; Be'Eri,3,0,36,33
1657777944948,MATH 103A,A02,083778,Greenfeld; Be'Eri,5,0,36,31
1657777944948,MATH 103A,A03,093561,Greenfeld; Be'Eri,6,0,36,30
1657777944948,MATH 103A,B01,083779,Greenfeld; Be'Eri,7,0,36,29
1657777944948,MATH 103A,B02,083780,Greenfeld; Be'Eri,4,0,36,32
1657777944948,MATH 103A,B03,093562,Greenfeld; Be'Eri,3,0,36,33
1657777950976,MATH 105,A01,085443,Carter; Anne Toulson,15,0,35,20
1657777950976,MATH 105,A02,093477,Carter; Anne Toulson,20,0,35,15
1657777957000,MATH 109,A01,083213,Ganzberger; Geoffrey Michael,3,0,34,31
1657777957000,MATH 109,A02,083214,Ganzberger; Geoffrey Michael,4,0,34,30
1657777957000,MATH 109,A03,093478,Ganzberger; Geoffrey Michael,2,0,34,32
1657777957000,MATH 109,B01,083215,Ganzberger; Geoffrey Michael,1,0,32,31
1657777957000,MATH 109,B02,083216,Ganzberger; Geoffrey Michael,2,0,32,30
1657777957000,MATH 109,B03,093479,Ganzberger; Geoffrey Michael,8,0,32,24
1657777963027,MATH 142A,A01,083219,Chow; Bennett,7,0,32,25
1657777963027,MATH 142A,A02,083220,Chow; Bennett,10,0,32,22
1657777963027,MATH 142A,A03,093480,Chow; Bennett,9,0,32,23
1657777963027,MATH 142A,B03,093481,Chow; Bennett,8,0,32,24
1657777963027,MATH 142A,B04,093558,Chow; Bennett,13,0,32,19
1657777963027,MATH 142A,B05,093559,Chow; Bennett,6,0,32,26
1657777969052,MATH 193A,A01,083224,Rotar; Vladimir,8,0,34,26
1657777969052,MATH 193A,A02,083225,Rotar; Vladimir,9,0,34,25
1657777969052,MATH 193A,A03,083781,Rotar; Vladimir,5,0,34,29
1657777969052,MATH 193A,A04,083782,Rotar; Vladimir,10,0,34,24
1657777969052,MATH 193A,A05,093482,Rotar; Vladimir,10,0,34,24
1657777975078,MATH 197,001,091859,McAuley; Julian John,9999,0,9999,0
1657777975078,MATH 197,002,095566,Kedlaya; Kiran S.,9997,0,9999,2
1657777975078,MATH 197,003,095567,Xiao; Ming,9999,0,9999,0
1657777975078,MATH 197,004,095571,Perols; Johan Lars,9998,0,9999,1
1657777982140,COGS 9,A01,083615,Shannon; Kyle Michael,9,0,75,66
1657777988166,COGS 11,A01,083617,Boyle; Mary E. T.,23,0,48,25
1657777994189,COGS 13,A01,083071,Bastos; Amalia Pinkusfeld,11,0,71,60
1657778000213,COGS 14A,A01,092681,Semenuks; Arturs,5,1,100,95
1657778006240,COGS 14B,A01,083073,Cheng; Tzu-Han,6,0,63,57
1657778012263,COGS 17,A01,092677,Semenuks; Arturs,6,0,81,75
1657778018287,COGS 100,A01,083619,Allen; Michael Gordon,17,0,70,53
1657778024309,COGS 101A,A01,083621,Davis; Joshua Daniel,9,0,68,59
1657778030335,COGS 101B,A01,091572,Allen; Michael Gordon,12,0,65,53
1657778036369,COGS 101C,A01,083625,Delgado; Tania,17,0,35,18
1657778042395,COGS 107A,A01,083627,Boyle; Mary E. T.,14,0,60,46
1657778048421,COGS 118A,A01,083075,Gupta; Anjum,21,0,76,55
1657778054446,CSE 3,A50,083646,Miranda; Gregory Joseph,24,0,50,26
1657778060470,CSE 8A,A50,083650,Miranda; Gregory Joseph,17,1,56,39
1657778066495,CSE 11,A01,083080,Cao; Yingjun,6,15,40,34
1657778072518,CSE 12,A01,083652,Krause-Levy; Sophia Louisa,28,1,120,92
1657778078540,CSE 15L,A01,083654,Morris; Justin Loren,9,0,50,41
1657778078540,CSE 15L,A02,083655,Morris; Justin Loren,9,0,50,41
1657778084566,CSE 20,A01,083657,Tran; Khoa Dang,39,0,80,41
1657778090590,CSE 21,A01,095574,Bach; Quang Tran,22,0,48,26
1657778096614,CSE 30,A01,083084,Eldon; John,6,0,80,74
1657778096614,CSE 30,B01,095061,Bhaskar; Nishant,9,0,50,41
1657778102638,CSE 100,A01,083659,Cao; Yingjun,5,4,70,65
1657778108664,CSE 134B,A01,083661,Powell; Thomas Allan,24,0,100,76
1657778114688,CSE 140,A01,083663,Gungor; Onat,15,0,85,70
1657778120711,CSE 140L,A01,083088,Eldon; John,23,0,100,77
1657778126732,CSE 175,A01,083665,Kumar; Rakesh,3,0,25,22
1657778132755,CSE 190,A00,092507,Dubnov; Shlomo,8,0,20,12
1657778138778,ECE 45,A01,083139,Congero; Spencer William,6,0,75,69
1657778144801,ECE 65,A50,083695,Saad; Andrew S,12,0,30,18
1657778144801,ECE 65,A51,095125,Saad; Andrew S,24,0,26,2
1657778150823,ECE 109,A01,091882,Touri; Behrouz,20,0,70,50
1657778156846,ECE 180,A00,083140,Abi Samra; Nicholas Camill,1,0,30,29
1657778156846,ECE 180,B00,083141,Abi Samra; Nicholas Camill,0,0,30,30
1657778162875,MATH 10A,A01,083735,Patchell; Gregory David,2,0,30,28
1657778162875,MATH 10A,A02,083736,Patchell; Gregory David,20,0,30,10
1657778162875,MATH 10A,A03,083737,Patchell; Gregory David,16,0,30,14
1657778168897,MATH 10B,A01,083207,Lim; Seonhee,8,0,34,26
1657778168897,MATH 10B,A02,083208,Lim; Seonhee,10,0,35,25
1657778168897,MATH 10B,A03,093472,Lim; Seonhee,7,0,34,27
1657778168897,MATH 10B,B01,083739,Sinha; Shubham,13,0,30,17
1657778174921,MATH 18,A01,083743,Cinel; Cameron Alexander,9,0,30,21
1657778174921,MATH 18,A02,083744,Cinel; Cameron Alexander,18,0,30,12
1657778174921,MATH 18,A03,083745,Cinel; Cameron Alexander,10,0,30,20
1657778174921,MATH 18,B01,083748,Rideout; David Porter,5,0,37,32
1657778174921,MATH 18,B02,083749,Rideout; David Porter,5,0,36,31
1657778174921,MATH 18,B03,083750,Rideout; David Porter,3,0,37,34
1657778174921,MATH 18,B04,083751,Rideout; David Porter,6,0,36,30
1657778174921,MATH 18,B05,093473,Rideout; David Porter,6,0,36,30
1657778174921,MATH 18,B06,093474,Rideout; David Porter,6,0,36,30
1657778180948,MATH 20A,A01,083754,Zheng; Zequn,14,0,40,26
1657778186975,MATH 20B,A01,083756,Briones; Jor-el Thomas Caparas,4,0,36,32
1657778186975,MATH 20B,A02,083757,Briones; Jor-el Thomas Caparas,1,0,36,35
1657778186975,MATH 20B,A03,093475,Briones; Jor-el Thomas Caparas,2,0,36,34
1657778193000,MATH 20C,A01,083760,Briones; Jor-el Thomas Caparas,1,0,35,34
1657778193000,MATH 20C,A02,083761,Briones; Jor-el Thomas Caparas,8,0,35,27
1657778193000,MATH 20C,A03,093476,Briones; Jor-el Thomas Caparas,0,1,36,36
1657778193000,MATH 20C,B01,083762,Bach; Quang Tran,1,0,30,29
1657778199027,MATH 20D,A01,083765,Tran; Brian Kha,5,0,30,25
1657778199027,MATH 20D,A02,083766,Tran; Brian Kha,5,0,30,25
1657778199027,MATH 20D,A03,083767,Tran; Brian Kha,5,0,30,25
1657778205049,MATH 20E,A01,083771,Ganguly; Soumya,9,0,32,23
1657778205049,MATH 20E,A02,083772,Ganguly; Soumya,6,0,32,26
1657778205049,MATH 20E,B01,083773,Ciotti; Benjamin,20,0,35,15
1657778205049,MATH 20E,B02,083774,Ciotti; Benjamin,18,0,35,17
1657778211073,MATH 103A,A01,083777,Greenfeld; Be'Eri,3,0,36,33
1657778211073,MATH 103A,A02,083778,Greenfeld; Be'Eri,5,0,36,31
1657778211073,MATH 103A,A03,093561,Greenfeld; Be'Eri,6,0,36,30
1657778211073,MATH 103A,B01,083779,Greenfeld; Be'Eri,7,0,36,29
1657778211073,MATH 103A,B02,083780,Greenfeld; Be'Eri,4,0,36,32
1657778211073,MATH 103A,B03,093562,Greenfeld; Be'Eri,3,0,36,33
1657778217100,MATH 105,A01,085443,Carter; Anne Toulson,15,0,35,20
1657778217100,MATH 105,A02,093477,Carter; Anne Toulson,20,0,35,15
1657778223127,MATH 109,A01,083213,Ganzberger; Geoffrey Michael,3,0,34,31
1657778223127,MATH 109,A02,083214,Ganzberger; Geoffrey Michael,4,0,34,30
1657778223127,MATH 109,A03,093478,Ganzberger; Geoffrey Michael,2,0,34,32
1657778223127,MATH 109,B01,083215,Ganzberger; Geoffrey Michael,1,0,32,31
1657778223127,MATH 109,B02,083216,Ganzberger; Geoffrey Michael,2,0,32,30
1657778223127,MATH 109,B03,093479,Ganzberger; Geoffrey Michael,8,0,32,24
1657778229150,MATH 142A,A01,083219,Chow; Bennett,7,0,32,25
1657778229150,MATH 142A,A02,083220,Chow; Bennett,10,0,32,22
1657778229150,MATH 142A,A03,093480,Chow; Bennett,9,0,32,23
1657778229150,MATH 142A,B03,093481,Chow; Bennett,8,0,32,24
1657778229150,MATH 142A,B04,093558,Chow; Bennett,13,0,32,19
1657778229150,MATH 142A,B05,093559,Chow; Bennett,6,0,32,26
1657778235173,MATH 193A,A01,083224,Rotar; Vladimir,8,0,34,26
1657778235173,MATH 193A,A02,083225,Rotar; Vladimir,9,0,34,25
1657778235173,MATH 193A,A03,083781,Rotar; Vladimir,5,0,34,29
1657778235173,MATH 193A,A04,083782,Rotar; Vladimir,10,0,34,24
1657778235173,MATH 193A,A05,093482,Rotar; Vladimir,10,0,34,24
1657778241197,MATH 197,001,091859,McAuley; Julian John,9999,0,9999,0
1657778241197,MATH 197,002,095566,Kedlaya; Kiran S.,9997,0,9999,2
1657778241197,MATH 197,003,095567,Xiao; Ming,9999,0,9999,0
1657778241197,MATH 197,004,095571,Perols; Johan Lars,9998,0,9999,1
1657778248250,COGS 9,A01,083615,Shannon; Kyle Michael,9,0,75,66
1657778254277,COGS 11,A01,083617,Boyle; Mary E. T.,23,0,48,25
1657778260301,COGS 13,A01,083071,Bastos; Amalia Pinkusfeld,11,0,71,60
1657778266328,COGS 14A,A01,092681,Semenuks; Arturs,5,1,100,95
1657778272357,COGS 14B,A01,083073,Cheng; Tzu-Han,6,0,63,57
1657778278380,COGS 17,A01,092677,Semenuks; Arturs,6,0,81,75
1657778284408,COGS 100,A01,083619,Allen; Michael Gordon,17,0,70,53
1657778290435,COGS 101A,A01,083621,Davis; Joshua Daniel,9,0,68,59
1657778296457,COGS 101B,A01,091572,Allen; Michael Gordon,12,0,65,53
1657778302478,COGS 101C,A01,083625,Delgado; Tania,17,0,35,18
1657778308501,COGS 107A,A01,083627,Boyle; Mary E. T.,14,0,60,46
1657778314524,COGS 118A,A01,083075,Gupta; Anjum,21,0,76,55
1657778320549,CSE 3,A50,083646,Miranda; Gregory Joseph,24,0,50,26
1657778326571,CSE 8A,A50,083650,Miranda; Gregory Joseph,17,1,56,39
1657778332595,CSE 11,A01,083080,Cao; Yingjun,6,15,40,34
1657778338618,CSE 12,A01,083652,Krause-Levy; Sophia Louisa,28,1,120,92
1657778344645,CSE 15L,A01,083654,Morris; Justin Loren,9,0,50,41
1657778344645,CSE 15L,A02,083655,Morris; Justin Loren,9,0,50,41
1657778350668,CSE 20,A01,083657,Tran; Khoa Dang,39,0,80,41
1657778356694,CSE 21,A01,095574,Bach; Quang Tran,22,0,48,26
1657778362722,CSE 30,A01,083084,Eldon; John,6,0,80,74
1657778362722,CSE 30,B01,095061,Bhaskar; Nishant,9,0,50,41
1657778368744,CSE 100,A01,083659,Cao; Yingjun,5,4,70,65
1657778374775,CSE 134B,A01,083661,Powell; Thomas Allan,24,0,100,76
1657778380798,CSE 140,A01,083663,Gungor; Onat,15,0,85,70
1657778386821,CSE 140L,A01,083088,Eldon; John,23,0,100,77
1657778392933,CSE 175,A01,083665,Kumar; Rakesh,3,0,25,22
1657778398956,CSE 190,A00,092507,Dubnov; Shlomo,8,0,20,12
1657778404978,ECE 45,A01,083139,Congero; Spencer William,6,0,75,69
1657778411000,ECE 65,A50,083695,Saad; Andrew S,12,0,30,18
1657778411000,ECE 65,A51,095125,Saad; Andrew S,24,0,26,2
1657778417026,ECE 109,A01,091882,Touri; Behrouz,20,0,70,50
1657778423049,ECE 180,A00,083140,Abi Samra; Nicholas Camill,1,0,30,29
1657778423049,ECE 180,B00,083141,Abi Samra; Nicholas Camill,0,0,30,30
1657778429076,MATH 10A,A01,083735,Patchell; Gregory David,2,0,30,28
1657778429076,MATH 10A,A02,083736,Patchell; Gregory David,20,0,30,10
1657778429076,MATH 10A,A03,083737,Patchell; Gregory David,16,0,30,14
1657778435105,MATH 10B,A01,083207,Lim; Seonhee,8,0,34,26
1657778435105,MATH 10B,A02,083208,Lim; Seonhee,10,0,35,25
1657778435105,MATH 10B,A03,093472,Lim; Seonhee,7,0,34,27
1657778435105,MATH 10B,B01,083739,Sinha; Shubham,13,0,30,17
1657778441127,MATH 18,A01,083743,Cinel; Cameron Alexander,9,0,30,21
1657778441127,MATH 18,A02,083744,Cinel; Cameron Alexander,18,0,30,12
1657778441127,MATH 18,A03,083745,Cinel; Cameron Alexander,10,0,30,20
1657778441127,MATH 18,B01,083748,Rideout; David Porter,5,0,37,32
1657778441127,MATH 18,B02,083749,Rideout; David Porter,5,0,36,31
1657778441127,MATH 18,B03,083750,Rideout; David Porter,3,0,37,34
1657778441127,MATH 18,B04,083751,Rideout; David Porter,6,0,36,30
1657778441127,MATH 18,B05,093473,Rideout; David Porter,6,0,36,30
1657778441127,MATH 18,B06,093474,Rideout; David Porter,6,0,36,30
1657778447150,MATH 20A,A01,083754,Zheng; Zequn,14,0,40,26
1657778453184,MATH 20B,A01,083756,Briones; Jor-el Thomas Caparas,4,0,36,32
1657778453184,MATH 20B,A02,083757,Briones; Jor-el Thomas Caparas,1,0,36,35
1657778453184,MATH 20B,A03,093475,Briones; Jor-el Thomas Caparas,2,0,36,34
1657778459209,MATH 20C,A01,083760,Briones; Jor-el Thomas Caparas,1,0,35,34
1657778459209,MATH 20C,A02,083761,Briones; Jor-el Thomas Caparas,8,0,35,27
1657778459209,MATH 20C,A03,093476,Briones; Jor-el Thomas Caparas,0,1,36,36
1657778459209,MATH 20C,B01,083762,Bach; Quang Tran,1,0,30,29
1657778465232,MATH 20D,A01,083765,Tran; Brian Kha,5,0,30,25
1657778465232,MATH 20D,A02,083766,Tran; Brian Kha,5,0,30,25
1657778465232,MATH 20D,A03,083767,Tran; Brian Kha,5,0,30,25
1657778471258,MATH 20E,A01,083771,Ganguly; Soumya,9,0,32,23
1657778471258,MATH 20E,A02,083772,Ganguly; Soumya,6,0,32,26
1657778471258,MATH 20E,B01,083773,Ciotti; Benjamin,20,0,35,15
1657778471258,MATH 20E,B02,083774,Ciotti; Benjamin,18,0,35,17
1657778477298,MATH 103A,A01,083777,Greenfeld; Be'Eri,3,0,36,33
1657778477298,MATH 103A,A02,083778,Greenfeld; Be'Eri,5,0,36,31
1657778477298,MATH 103A,A03,093561,Greenfeld; Be'Eri,6,0,36,30
1657778477298,MATH 103A,B01,083779,Greenfeld; Be'Eri,7,0,36,29
1657778477298,MATH 103A,B02,083780,Greenfeld; Be'Eri,4,0,36,32
1657778477298,MATH 103A,B03,093562,Greenfeld; Be'Eri,3,0,36,33
1657778483322,MATH 105,A01,085443,Carter; Anne Toulson,15,0,35,20
1657778483322,MATH 105,A02,093477,Carter; Anne Toulson,20,0,35,15
1657778489347,MATH 109,A01,083213,Ganzberger; Geoffrey Michael,3,0,34,31
1657778489347,MATH 109,A02,083214,Ganzberger; Geoffrey Michael,4,0,34,30
1657778489347,MATH 109,A03,093478,Ganzberger; Geoffrey Michael,2,0,34,32
1657778489347,MATH 109,B01,083215,Ganzberger; Geoffrey Michael,1,0,32,31
1657778489347,MATH 109,B02,083216,Ganzberger; Geoffrey Michael,2,0,32,30
1657778489347,MATH 109,B03,093479,Ganzberger; Geoffrey Michael,8,0,32,24
1657778495371,MATH 142A,A01,083219,Chow; Bennett,7,0,32,25
1657778495371,MATH 142A,A02,083220,Chow; Bennett,10,0,32,22
1657778495371,MATH 142A,A03,093480,Chow; Bennett,9,0,32,23
1657778495371,MATH 142A,B03,093481,Chow; Bennett,8,0,32,24
1657778495371,MATH 142A,B04,093558,Chow; Bennett,13,0,32,19
1657778495371,MATH 142A,B05,093559,Chow; Bennett,6,0,32,26
1657778501400,MATH 193A,A01,083224,Rotar; Vladimir,8,0,34,26
1657778501400,MATH 193A,A02,083225,Rotar; Vladimir,9,0,34,25
1657778501400,MATH 193A,A03,083781,Rotar; Vladimir,5,0,34,29
1657778501400,MATH 193A,A04,083782,Rotar; Vladimir,10,0,34,24
1657778501400,MATH 193A,A05,093482,Rotar; Vladimir,10,0,34,24
1657778507428,MATH 197,001,091859,McAuley; Julian John,9999,0,9999,0
1657778507428,MATH 197,002,095566,Kedlaya; Kiran S.,9997,0,9999,2
1657778507428,MATH 197,003,095567,Xiao; Ming,9999,0,9999,0
1657778507428,MATH 197,004,095571,Perols; Johan Lars,9998,0,9999,1
1657778514486,COGS 9,A01,083615,Shannon; Kyle Michael,9,0,75,66
1657778520518,COGS 11,A01,083617,Boyle; Mary E. T.,23,0,48,25
1657778526541,COGS 13,A01,083071,Bastos; Amalia Pinkusfeld,11,0,71,60
1657778532565,COGS 14A,A01,092681,Semenuks; Arturs,5,1,100,95
1657778538588,COGS 14B,A01,083073,Cheng; Tzu-Han,6,0,63,57
1657778544612,COGS 17,A01,092677,Semenuks; Arturs,6,0,81,75
1657778550640,COGS 100,A01,083619,Allen; Michael Gordon,17,0,70,53
1657778556664,COGS 101A,A01,083621,Davis; Joshua Daniel,9,0,68,59
1657778562691,COGS 101B,A01,091572,Allen; Michael Gordon,12,0,65,53
1657778568713,COGS 101C,A01,083625,Delgado; Tania,17,0,35,18
1657778574739,COGS 107A,A01,083627,Boyle; Mary E. T.,14,0,60,46
1657778580773,COGS 118A,A01,083075,Gupta; Anjum,21,0,76,55
1657778586797,CSE 3,A50,083646,Miranda; Gregory Joseph,24,0,50,26
1657778592820,CSE 8A,A50,083650,Miranda; Gregory Joseph,17,1,56,39
1657778598845,CSE 11,A01,083080,Cao; Yingjun,6,15,40,34
1657778604867,CSE 12,A01,083652,Krause-Levy; Sophia Louisa,28,1,120,92
1657778610894,CSE 15L,A01,083654,Morris; Justin Loren,9,0,50,41
1657778610894,CSE 15L,A02,083655,Morris; Justin Loren,9,0,50,41
1657778616917,CSE 20,A01,083657,Tran; Khoa Dang,39,0,80,41
1657778622951,CSE 21,A01,095574,Bach; Quang Tran,22,0,48,26
1657778628975,CSE 30,A01,083084,Eldon; John,6,0,80,74
1657778628975,CSE 30,B01,095061,Bhaskar; Nishant,9,0,50,41
1657778635009,CSE 100,A01,083659,Cao; Yingjun,5,4,70,65
1657778641043,CSE 134B,A01,083661,Powell; Thomas Allan,24,0,100,76
1657778647067,CSE 140,A01,083663,Gungor; Onat,15,0,85,70
1657778653095,CSE 140L,A01,083088,Eldon; John,23,0,100,77
1657778659118,CSE 175,A01,083665,Kumar; Rakesh,3,0,25,22
1657778665139,CSE 190,A00,092507,Dubnov; Shlomo,8,0,20,12
1657778671165,ECE 45,A01,083139,Congero; Spencer William,6,0,75,69
1657778677192,ECE 65,A50,083695,Saad; Andrew S,12,0,30,18
1657778677192,ECE 65,A51,095125,Saad; Andrew S,24,0,26,2
1657778683220,ECE 109,A01,091882,Touri; Behrouz,20,0,70,50
1657778689244,ECE 180,A00,083140,Abi Samra; Nicholas Camill,1,0,30,29
1657778689244,ECE 180,B00,083141,Abi Samra; Nicholas Camill,0,0,30,30
1657778695275,MATH 10A,A01,083735,Patchell; Gregory David,2,0,30,28
1657778695275,MATH 10A,A02,083736,Patchell; Gregory David,20,0,30,10
1657778695275,MATH 10A,A03,083737,Patchell; Gregory David,16,0,30,14
1657778701307,MATH 10B,A01,083207,Lim; Seonhee,8,0,34,26
1657778701307,MATH 10B,A02,083208,Lim; Seonhee,10,0,35,25
1657778701307,MATH 10B,A03,093472,Lim; Seonhee,7,0,34,27
1657778701307,MATH 10B,B01,083739,Sinha; Shubham,13,0,30,17
1657778707355,MATH 18,A01,083743,Cinel; Cameron Alexander,9,0,30,21
1657778707355,MATH 18,A02,083744,Cinel; Cameron Alexander,18,0,30,12
1657778707355,MATH 18,A03,083745,Cinel; Cameron Alexander,10,0,30,20
1657778707355,MATH 18,B01,083748,Rideout; David Porter,5,0,37,32
1657778707355,MATH 18,B02,083749,Rideout; David Porter,5,0,36,31
1657778707355,MATH 18,B03,083750,Rideout; David Porter,3,0,37,34
1657778707355,MATH 18,B04,083751,Rideout; David Porter,6,0,36,30
1657778707355,MATH 18,B05,093473,Rideout; David Porter,6,0,36,30
1657778707355,MATH 18,B06,093474,Rideout; David Porter,6,0,36,30
1657778713379,MATH 20A,A01,083754,Zheng; Zequn,14,0,40,26
1657778719405,MATH 20B,A01,083756,Briones; Jor-el Thomas Caparas,4,0,36,32
1657778719405,MATH 20B,A02,083757,Briones; Jor-el Thomas Caparas,1,0,36,35
1657778719405,MATH 20B,A03,093475,Briones; Jor-el Thomas Caparas,2,0,36,34
1657778725428,MATH 20C,A01,083760,Briones; Jor-el Thomas Caparas,1,0,35,34
1657778725428,MATH 20C,A02,083761,Briones; Jor-el Thomas Caparas,8,0,35,27
1657778725428,MATH 20C,A03,093476,Briones; Jor-el Thomas Caparas,0,1,36,36
1657778725428,MATH 20C,B01,083762,Bach; Quang Tran,1,0,30,29
1657778731453,MATH 20D,A01,083765,Tran; Brian Kha,5,0,30,25
1657778731453,MATH 20D,A02,083766,Tran; Brian Kha,5,0,30,25
1657778731453,MATH 20D,A03,083767,Tran; Brian Kha,5,0,30,25
1657778737482,MATH 20E,A01,083771,Ganguly; Soumya,9,0,32,23
1657778737482,MATH 20E,A02,083772,Ganguly; Soumya,6,0,32,26
1657778737482,MATH 20E,B01,083773,Ciotti; Benjamin,20,0,35,15
1657778737482,MATH 20E,B02,083774,Ciotti; Benjamin,18,0,35,17
1657778743509,MATH 103A,A01,083777,Greenfeld; Be'Eri,3,0,36,33
1657778743509,MATH 103A,A02,083778,Greenfeld; Be'Eri,5,0,36,31
1657778743509,MATH 103A,A03,093561,Greenfeld; Be'Eri,6,0,36,30
1657778743509,MATH 103A,B01,083779,Greenfeld; Be'Eri,7,0,36,29
1657778743509,MATH 103A,B02,083780,Greenfeld; Be'Eri,4,0,36,32
1657778743509,MATH 103A,B03,093562,Greenfeld; Be'Eri,3,0,36,33
1657778749536,MATH 105,A01,085443,Carter; Anne Toulson,15,0,35,20
1657778749536,MATH 105,A02,093477,Carter; Anne Toulson,20,0,35,15
1657778755565,MATH 109,A01,083213,Ganzberger; Geoffrey Michael,3,0,34,31
1657778755565,MATH 109,A02,083214,Ganzberger; Geoffrey Michael,4,0,34,30
1657778755565,MATH 109,A03,093478,Ganzberger; Geoffrey Michael,2,0,34,32
1657778755565,MATH 109,B01,083215,Ganzberger; Geoffrey Michael,1,0,32,31
1657778755565,MATH 109,B02,083216,Ganzberger; Geoffrey Michael,2,0,32,30
1657778755565,MATH 109,B03,093479,Ganzberger; Geoffrey Michael,8,0,32,24
1657778761601,MATH 142A,A01,083219,Chow; Bennett,7,0,32,25
1657778761601,MATH 142A,A02,083220,Chow; Bennett,10,0,32,22
1657778761601,MATH 142A,A03,093480,Chow; Bennett,9,0,32,23
1657778761601,MATH 142A,B03,093481,Chow; Bennett,8,0,32,24
1657778761601,MATH 142A,B04,093558,Chow; Bennett,13,0,32,19
1657778761601,MATH 142A,B05,093559,Chow; Bennett,6,0,32,26
1657778767625,MATH 193A,A01,083224,Rotar; Vladimir,8,0,34,26
1657778767625,MATH 193A,A02,083225,Rotar; Vladimir,9,0,34,25
1657778767625,MATH 193A,A03,083781,Rotar; Vladimir,5,0,34,29
1657778767625,MATH 193A,A04,083782,Rotar; Vladimir,10,0,34,24
1657778767625,MATH 193A,A05,093482,Rotar; Vladimir,10,0,34,24
1657778773651,MATH 197,001,091859,McAuley; Julian John,9999,0,9999,0
1657778773651,MATH 197,002,095566,Kedlaya; Kiran S.,9997,0,9999,2
1657778773651,MATH 197,003,095567,Xiao; Ming,9999,0,9999,0
1657778773651,MATH 197,004,095571,Perols; Johan Lars,9998,0,9999,1
1657778780719,COGS 9,A01,083615,Shannon; Kyle Michael,9,0,75,66
1657778786741,COGS 11,A01,083617,Boyle; Mary E. T.,23,0,48,25
1657778792764,COGS 13,A01,083071,Bastos; Amalia Pinkusfeld,11,0,71,60
1657778798789,COGS 14A,A01,092681,Semenuks; Arturs,5,1,100,95
1657778804812,COGS 14B,A01,083073,Cheng; Tzu-Han,6,0,63,57
1657778810836,COGS 17,A01,092677,Semenuks; Arturs,6,0,81,75
1657778816862,COGS 100,A01,083619,Allen; Michael Gordon,17,0,70,53
1657778822885,COGS 101A,A01,083621,Davis; Joshua Daniel,9,0,68,59
1657778828908,COGS 101B,A01,091572,Allen; Michael Gordon,12,0,65,53
1657778834932,COGS 101C,A01,083625,Delgado; Tania,17,0,35,18
1657778840956,COGS 107A,A01,083627,Boyle; Mary E. T.,14,0,60,46
1657778846977,COGS 118A,A01,083075,Gupta; Anjum,21,0,76,55
1657778853005,CSE 3,A50,083646,Miranda; Gregory Joseph,24,0,50,26
1657778859031,CSE 8A,A50,083650,Miranda; Gregory Joseph,17,1,56,39
1657778865055,CSE 11,A01,083080,Cao; Yingjun,6,15,40,34
1657778871077,CSE 12,A01,083652,Krause-Levy; Sophia Louisa,28,1,120,92
1657778877104,CSE 15L,A01,083654,Morris; Justin Loren,9,0,50,41
1657778877104,CSE 15L,A02,083655,Morris; Justin Loren,9,0,50,41
1657778883129,CSE 20,A01,083657,Tran; Khoa Dang,39,0,80,41
1657778889151,CSE 21,A01,095574,Bach; Quang Tran,22,0,48,26
1657778895180,CSE 30,A01,083084,Eldon; John,6,0,80,74
1657778895180,CSE 30,B01,095061,Bhaskar; Nishant,9,0,50,41
1657778901206,CSE 100,A01,083659,Cao; Yingjun,5,4,70,65
1657778907233,CSE 134B,A01,083661,Powell; Thomas Allan,24,0,100,76
1657778913259,CSE 140,A01,083663,Gungor; Onat,15,0,85,70
1657778919285,CSE 140L,A01,083088,Eldon; John,23,0,100,77
1657778925309,CSE 175,A01,083665,Kumar; Rakesh,3,0,25,22
1657778931333,CSE 190,A00,092507,Dubnov; Shlomo,8,0,20,12
1657778937357,ECE 45,A01,083139,Congero; Spencer William,6,0,75,69
1657778943387,ECE 65,A50,083695,Saad; Andrew S,12,0,30,18
1657778943387,ECE 65,A51,095125,Saad; Andrew S,24,0,26,2
1657778949413,ECE 109,A01,091882,Touri; Behrouz,20,0,70,50
1657778955441,ECE 180,A00,083140,Abi Samra; Nicholas Camill,1,0,30,29
1657778955441,ECE 180,B00,083141,Abi Samra; Nicholas Camill,0,0,30,30
1657778961468,MATH 10A,A01,083735,Patchell; Gregory David,2,0,30,28
1657778961468,MATH 10A,A02,083736,Patchell; Gregory David,20,0,30,10
1657778961468,MATH 10A,A03,083737,Patchell; Gregory David,16,0,30,14
1657778967491,MATH 10B,A01,083207,Lim; Seonhee,8,0,34,26
1657778967491,MATH 10B,A02,083208,Lim; Seonhee,10,0,35,25
1657778967491,MATH 10B,A03,093472,Lim; Seonhee,7,0,34,27
1657778967491,MATH 10B,B01,083739,Sinha; Shubham,13,0,30,17
1657778973516,MATH 18,A01,083743,Cinel; Cameron Alexander,9,0,30,21
1657778973516,MATH 18,A02,083744,Cinel; Cameron Alexander,18,0,30,12
1657778973516,MATH 18,A03,083745,Cinel; Cameron Alexander,10,0,30,20
1657778973516,MATH 18,B01,083748,Rideout; David Porter,5,0,37,32
1657778973516,MATH 18,B02,083749,Rideout; David Porter,5,0,36,31
1657778973516,MATH 18,B03,083750,Rideout; David Porter,3,0,37,34
1657778973516,MATH 18,B04,083751,Rideout; David Porter,6,0,36,30
1657778973516,MATH 18,B05,093473,Rideout; David Porter,6,0,36,30
1657778973516,MATH 18,B06,093474,Rideout; David Porter,6,0,36,30
1657778979548,MATH 20A,A01,083754,Zheng; Zequn,14,0,40,26
1657778985578,MATH 20B,A01,083756,Briones; Jor-el Thomas Caparas,4,0,36,32
1657778985578,MATH 20B,A02,083757,Briones; Jor-el Thomas Caparas,1,0,36,35
1657778985578,MATH 20B,A03,093475,Briones; Jor-el Thomas Caparas,2,0,36,34
1657778991673,MATH 20C,A01,083760,Briones; Jor-el Thomas Caparas,1,0,35,34
1657778991673,MATH 20C,A02,083761,Briones; Jor-el Thomas Caparas,8,0,35,27
1657778991673,MATH 20C,A03,093476,Briones; Jor-el Thomas Caparas,0,1,36,36
1657778991673,MATH 20C,B01,083762,Bach; Quang Tran,1,0,30,29
1657778997696,MATH 20D,A01,083765,Tran; Brian Kha,5,0,30,25
1657778997696,MATH 20D,A02,083766,Tran; Brian Kha,5,0,30,25
1657778997696,MATH 20D,A03,083767,Tran; Brian Kha,5,0,30,25
1657779003723,MATH 20E,A01,083771,Ganguly; Soumya,9,0,32,23
1657779003723,MATH 20E,A02,083772,Ganguly; Soumya,6,0,32,26
1657779003723,MATH 20E,B01,083773,Ciotti; Benjamin,20,0,35,15
1657779003723,MATH 20E,B02,083774,Ciotti; Benjamin,18,0,35,17
1657779009763,MATH 103A,A01,083777,Greenfeld; Be'Eri,3,0,36,33
1657779009763,MATH 103A,A02,083778,Greenfeld; Be'Eri,5,0,36,31
1657779009763,MATH 103A,A03,093561,Greenfeld; Be'Eri,6,0,36,30
1657779009763,MATH 103A,B01,083779,Greenfeld; Be'Eri,7,0,36,29
1657779009763,MATH 103A,B02,083780,Greenfeld; Be'Eri,4,0,36,32
1657779009763,MATH 103A,B03,093562,Greenfeld; Be'Eri,3,0,36,33
1657779015790,MATH 105,A01,085443,Carter; Anne Toulson,15,0,35,20
1657779015790,MATH 105,A02,093477,Carter; Anne Toulson,20,0,35,15
1657779021819,MATH 109,A01,083213,Ganzberger; Geoffrey Michael,3,0,34,31
1657779021819,MATH 109,A02,083214,Ganzberger; Geoffrey Michael,4,0,34,30
1657779021819,MATH 109,A03,093478,Ganzberger; Geoffrey Michael,2,0,34,32
1657779021819,MATH 109,B01,083215,Ganzberger; Geoffrey Michael,1,0,32,31
1657779021819,MATH 109,B02,083216,Ganzberger; Geoffrey Michael,2,0,32,30
1657779021819,MATH 109,B03,093479,Ganzberger; Geoffrey Michael,8,0,32,24
1657779027843,MATH 142A,A01,083219,Chow; Bennett,7,0,32,25
1657779027843,MATH 142A,A02,083220,Chow; Bennett,10,0,32,22
1657779027843,MATH 142A,A03,093480,Chow; Bennett,9,0,32,23
1657779027843,MATH 142A,B03,093481,Chow; Bennett,8,0,32,24
1657779027843,MATH 142A,B04,093558,Chow; Bennett,13,0,32,19
1657779027843,MATH 142A,B05,093559,Chow; Bennett,6,0,32,26
1657779033871,MATH 193A,A01,083224,Rotar; Vladimir,8,0,34,26
1657779033871,MATH 193A,A02,083225,Rotar; Vladimir,9,0,34,25
1657779033871,MATH 193A,A03,083781,Rotar; Vladimir,5,0,34,29
1657779033871,MATH 193A,A04,083782,Rotar; Vladimir,10,0,34,24
1657779033871,MATH 193A,A05,093482,Rotar; Vladimir,10,0,34,24
1657779039893,MATH 197,001,091859,McAuley; Julian John,9999,0,9999,0
1657779039893,MATH 197,002,095566,Kedlaya; Kiran S.,9997,0,9999,2
1657779039893,MATH 197,003,095567,Xiao; Ming,9999,0,9999,0
1657779039893,MATH 197,004,095571,Perols; Johan Lars,9998,0,9999,1
1657779046953,COGS 9,A01,083615,Shannon; Kyle Michael,9,0,75,66
1657779052976,COGS 11,A01,083617,Boyle; Mary E. T.,23,0,48,25
1657779059003,COGS 13,A01,083071,Bastos; Amalia Pinkusfeld,11,0,71,60
1657779065031,COGS 14A,A01,092681,Semenuks; Arturs,5,1,100,95
1657779071055,COGS 14B,A01,083073,Cheng; Tzu-Han,6,0,63,57
1657779077088,COGS 17,A01,092677,Semenuks; Arturs,6,0,81,75
1657779083119,COGS 100,A01,083619,Allen; Michael Gordon,17,0,70,53
1657779089144,COGS 101A,A01,083621,Davis; Joshua Daniel,9,0,68,59
1657779095166,COGS 101B,A01,091572,Allen; Michael Gordon,12,0,65,53
1657779101190,COGS 101C,A01,083625,Delgado; Tania,17,0,35,18
1657779107213,COGS 107A,A01,083627,Boyle; Mary E. T.,14,0,60,46
1657779113240,COGS 118A,A01,083075,Gupta; Anjum,21,0,76,55
1657779119270,CSE 3,A50,083646,Miranda; Gregory Joseph,24,0,50,26
1657779125296,CSE 8A,A50,083650,Miranda; Gregory Joseph,17,1,56,39
1657779131321,CSE 11,A01,083080,Cao; Yingjun,6,15,40,34
1657779137346,CSE 12,A01,083652,Krause-Levy; Sophia Louisa,28,1,120,92
1657779143372,CSE 15L,A01,083654,Morris; Justin Loren,9,0,50,41
1657779143372,CSE 15L,A02,083655,Morris; Justin Loren,9,0,50,41
1657779149397,CSE 20,A01,083657,Tran; Khoa Dang,39,0,80,41
1657779155424,CSE 21,A01,095574,Bach; Quang Tran,22,0,48,26
1657779161452,CSE 30,A01,083084,Eldon; John,6,0,80,74
1657779161452,CSE 30,B01,095061,Bhaskar; Nishant,9,0,50,41
1657779167475,CSE 100,A01,083659,Cao; Yingjun,5,4,70,65
1657779173503,CSE 134B,A01,083661,Powell; Thomas Allan,24,0,100,76
1657779179527,CSE 140,A01,083663,Gungor; Onat,15,0,85,70
1657779185551,CSE 140L,A01,083088,Eldon; John,23,0,100,77
1657779191573,CSE 175,A01,083665,Kumar; Rakesh,3,0,25,22
1657779197597,CSE 190,A00,092507,Dubnov; Shlomo,8,0,20,12
1657779203621,ECE 45,A01,083139,Congero; Spencer William,6,0,75,69
1657779209645,ECE 65,A50,083695,Saad; Andrew S,12,0,30,18
1657779209645,ECE 65,A51,095125,Saad; Andrew S,24,0,26,2
1657779215671,ECE 109,A01,091882,Touri; Behrouz,20,0,70,50
1657779221699,ECE 180,A00,083140,Abi Samra; Nicholas Camill,1,0,30,29
1657779221699,ECE 180,B00,083141,Abi Samra; Nicholas Camill,0,0,30,30
1657779227725,MATH 10A,A01,083735,Patchell; Gregory David,2,0,30,28
1657779227725,MATH 10A,A02,083736,Patchell; Gregory David,20,0,30,10
1657779227725,MATH 10A,A03,083737,Patchell; Gregory David,16,0,30,14
1657779233756,MATH 10B,A01,083207,Lim; Seonhee,8,0,34,26
1657779233756,MATH 10B,A02,083208,Lim; Seonhee,10,0,35,25
1657779233756,MATH 10B,A03,093472,Lim; Seonhee,7,0,34,27
1657779233756,MATH 10B,B01,083739,Sinha; Shubham,13,0,30,17
1657779239779,MATH 18,A01,083743,Cinel; Cameron Alexander,9,0,30,21
1657779239779,MATH 18,A02,083744,Cinel; Cameron Alexander,18,0,30,12
1657779239779,MATH 18,A03,083745,Cinel; Cameron Alexander,10,0,30,20
1657779239779,MATH 18,B01,083748,Rideout; David Porter,5,0,37,32
1657779239779,MATH 18,B02,083749,Rideout; David Porter,5,0,36,31
1657779239779,MATH 18,B03,083750,Rideout; David Porter,3,0,37,34
1657779239779,MATH 18,B04,083751,Rideout; David Porter,6,0,36,30
1657779239779,MATH 18,B05,093473,Rideout; David Porter,6,0,36,30
1657779239779,MATH 18,B06,093474,Rideout; David Porter,6,0,36,30
1657779245806,MATH 20A,A01,083754,Zheng; Zequn,14,0,40,26
1657779251830,MATH 20B,A01,083756,Briones; Jor-el Thomas Caparas,4,0,36,32
1657779251830,MATH 20B,A02,083757,Briones; Jor-el Thomas Caparas,1,0,36,35
1657779251830,MATH 20B,A03,093475,Briones; Jor-el Thomas Caparas,2,0,36,34
1657779257855,MATH 20C,A01,083760,Briones; Jor-el Thomas Caparas,1,0,35,34
1657779257855,MATH 20C,A02,083761,Briones; Jor-el Thomas Caparas,8,0,35,27
1657779257855,MATH 20C,A03,093476,Briones; Jor-el Thomas Caparas,0,1,36,36
1657779257855,MATH 20C,B01,083762,Bach; Quang Tran,1,0,30,29
1657779263878,MATH 20D,A01,083765,Tran; Brian Kha,5,0,30,25
1657779263878,MATH 20D,A02,083766,Tran; Brian Kha,5,0,30,25
1657779263878,MATH 20D,A03,083767,Tran; Brian Kha,5,0,30,25
1657779269903,MATH 20E,A01,083771,Ganguly; Soumya,9,0,32,23
1657779269903,MATH 20E,A02,083772,Ganguly; Soumya,6,0,32,26
1657779269903,MATH 20E,B01,083773,Ciotti; Benjamin,20,0,35,15
1657779269903,MATH 20E,B02,083774,Ciotti; Benjamin,18,0,35,17
1657779275927,MATH 103A,A01,083777,Greenfeld; Be'Eri,3,0,36,33
1657779275927,MATH 103A,A02,083778,Greenfeld; Be'Eri,5,0,36,31
1657779275927,MATH 103A,A03,093561,Greenfeld; Be'Eri,6,0,36,30
1657779275927,MATH 103A,B01,083779,Greenfeld; Be'Eri,7,0,36,29
1657779275927,MATH 103A,B02,083780,Greenfeld; Be'Eri,4,0,36,32
1657779275927,MATH 103A,B03,093562,Greenfeld; Be'Eri,3,0,36,33
1657779281956,MATH 105,A01,085443,Carter; Anne Toulson,15,0,35,20
1657779281956,MATH 105,A02,093477,Carter; Anne Toulson,20,0,35,15
1657779287981,MATH 109,A01,083213,Ganzberger; Geoffrey Michael,3,0,34,31
1657779287981,MATH 109,A02,083214,Ganzberger; Geoffrey Michael,4,0,34,30
1657779287981,MATH 109,A03,093478,Ganzberger; Geoffrey Michael,2,0,34,32
1657779287981,MATH 109,B01,083215,Ganzberger; Geoffrey Michael,1,0,32,31
1657779287981,MATH 109,B02,083216,Ganzberger; Geoffrey Michael,2,0,32,30
1657779287981,MATH 109,B03,093479,Ganzberger; Geoffrey Michael,8,0,32,24
1657779294005,MATH 142A,A01,083219,Chow; Bennett,7,0,32,25
1657779294005,MATH 142A,A02,083220,Chow; Bennett,10,0,32,22
1657779294005,MATH 142A,A03,093480,Chow; Bennett,9,0,32,23
1657779294005,MATH 142A,B03,093481,Chow; Bennett,8,0,32,24
1657779294005,MATH 142A,B04,093558,Chow; Bennett,13,0,32,19
1657779294005,MATH 142A,B05,093559,Chow; Bennett,6,0,32,26
1657779300030,MATH 193A,A01,083224,Rotar; Vladimir,8,0,34,26
1657779300030,MATH 193A,A02,083225,Rotar; Vladimir,9,0,34,25
1657779300030,MATH 193A,A03,083781,Rotar; Vladimir,5,0,34,29
1657779300030,MATH 193A,A04,083782,Rotar; Vladimir,10,0,34,24
1657779300030,MATH 193A,A05,093482,Rotar; Vladimir,10,0,34,24
1657779306058,MATH 197,001,091859,McAuley; Julian John,9999,0,9999,0
1657779306058,MATH 197,002,095566,Kedlaya; Kiran S.,9997,0,9999,2
1657779306058,MATH 197,003,095567,Xiao; Ming,9999,0,9999,0
1657779306058,MATH 197,004,095571,Perols; Johan Lars,9998,0,9999,1
1657779313129,COGS 9,A01,083615,Shannon; Kyle Michael,9,0,75,66
1657779319152,COGS 11,A01,083617,Boyle; Mary E. T.,23,0,48,25
1657779325175,COGS 13,A01,083071,Bastos; Amalia Pinkusfeld,11,0,71,60
1657779331204,COGS 14A,A01,092681,Semenuks; Arturs,5,1,100,95
1657779337228,COGS 14B,A01,083073,Cheng; Tzu-Han,6,0,63,57
1657779343251,COGS 17,A01,092677,Semenuks; Arturs,6,0,81,75
1657779349274,COGS 100,A01,083619,Allen; Michael Gordon,17,0,70,53
1657779355300,COGS 101A,A01,083621,Davis; Joshua Daniel,9,0,68,59
1657779361324,COGS 101B,A01,091572,Allen; Michael Gordon,12,0,65,53
1657779367351,COGS 101C,A01,083625,Delgado; Tania,17,0,35,18
1657779373374,COGS 107A,A01,083627,Boyle; Mary E. T.,14,0,60,46
1657779379400,COGS 118A,A01,083075,Gupta; Anjum,21,0,76,55
1657779385429,CSE 3,A50,083646,Miranda; Gregory Joseph,24,0,50,26
1657779391452,CSE 8A,A50,083650,Miranda; Gregory Joseph,17,1,56,39
1657779397476,CSE 11,A01,083080,Cao; Yingjun,6,15,40,34
1657779403499,CSE 12,A01,083652,Krause-Levy; Sophia Louisa,28,1,120,92
1657779409527,CSE 15L,A01,083654,Morris; Justin Loren,9,0,50,41
1657779409527,CSE 15L,A02,083655,Morris; Justin Loren,9,0,50,41
1657779415551,CSE 20,A01,083657,Tran; Khoa Dang,39,0,80,41
1657779421574,CSE 21,A01,095574,Bach; Quang Tran,22,0,48,26
1657779427599,CSE 30,A01,083084,Eldon; John,6,0,80,74
1657779427599,CSE 30,B01,095061,Bhaskar; Nishant,9,0,50,41
1657779433626,CSE 100,A01,083659,Cao; Yingjun,5,4,70,65
1657779439649,CSE 134B,A01,083661,Powell; Thomas Allan,24,0,100,76
1657779445672,CSE 140,A01,083663,Gungor; Onat,15,0,85,70
1657779451700,CSE 140L,A01,083088,Eldon; John,23,0,100,77
1657779457722,CSE 175,A01,083665,Kumar; Rakesh,3,0,25,22
1657779463747,CSE 190,A00,092507,Dubnov; Shlomo,8,0,20,12
1657779469770,ECE 45,A01,083139,Congero; Spencer William,6,0,75,69
1657779475794,ECE 65,A50,083695,Saad; Andrew S,12,0,30,18
1657779475794,ECE 65,A51,095125,Saad; Andrew S,24,0,26,2
1657779481822,ECE 109,A01,091882,Touri; Behrouz,20,0,70,50
1657779487848,ECE 180,A00,083140,Abi Samra; Nicholas Camill,1,0,30,29
1657779487848,ECE 180,B00,083141,Abi Samra; Nicholas Camill,0,0,30,30
1657779493870,MATH 10A,A01,083735,Patchell; Gregory David,2,0,30,28
1657779493870,MATH 10A,A02,083736,Patchell; Gregory David,20,0,30,10
1657779493870,MATH 10A,A03,083737,Patchell; Gregory David,16,0,30,14
1657779499894,MATH 10B,A01,083207,Lim; Seonhee,8,0,34,26
1657779499894,MATH 10B,A02,083208,Lim; Seonhee,10,0,35,25
1657779499894,MATH 10B,A03,093472,Lim; Seonhee,7,0,34,27
1657779499894,MATH 10B,B01,083739,Sinha; Shubham,13,0,30,17
1657779505919,MATH 18,A01,083743,Cinel; Cameron Alexander,9,0,30,21
1657779505919,MATH 18,A02,083744,Cinel; Cameron Alexander,18,0,30,12
1657779505919,MATH 18,A03,083745,Cinel; Cameron Alexander,10,0,30,20
1657779505919,MATH 18,B01,083748,Rideout; David Porter,5,0,37,32
1657779505919,MATH 18,B02,083749,Rideout; David Porter,5,0,36,31
1657779505919,MATH 18,B03,083750,Rideout; David Porter,3,0,37,34
1657779505919,MATH 18,B04,083751,Rideout; David Porter,6,0,36,30
1657779505919,MATH 18,B05,093473,Rideout; David Porter,6,0,36,30
1657779505919,MATH 18,B06,093474,Rideout; David Porter,6,0,36,30
1657779511942,MATH 20A,A01,083754,Zheng; Zequn,14,0,40,26
1657779517968,MATH 20B,A01,083756,Briones; Jor-el Thomas Caparas,4,0,36,32
1657779517968,MATH 20B,A02,083757,Briones; Jor-el Thomas Caparas,1,0,36,35
1657779517968,MATH 20B,A03,093475,Briones; Jor-el Thomas Caparas,2,0,36,34
1657779523999,MATH 20C,A01,083760,Briones; Jor-el Thomas Caparas,1,0,35,34
1657779523999,MATH 20C,A02,083761,Briones; Jor-el Thomas Caparas,8,0,35,27
1657779523999,MATH 20C,A03,093476,Briones; Jor-el Thomas Caparas,0,1,36,36
1657779523999,MATH 20C,B01,083762,Bach; Quang Tran,1,0,30,29
1657779530034,MATH 20D,A01,083765,Tran; Brian Kha,5,0,30,25
1657779530034,MATH 20D,A02,083766,Tran; Brian Kha,5,0,30,25
1657779530034,MATH 20D,A03,083767,Tran; Brian Kha,5,0,30,25
1657779536065,MATH 20E,A01,083771,Ganguly; Soumya,9,0,32,23
1657779536065,MATH 20E,A02,083772,Ganguly; Soumya,6,0,32,26
1657779536065,MATH 20E,B01,083773,Ciotti; Benjamin,20,0,35,15
1657779536065,MATH 20E,B02,083774,Ciotti; Benjamin,18,0,35,17
1657779542090,MATH 103A,A01,083777,Greenfeld; Be'Eri,3,0,36,33
1657779542090,MATH 103A,A02,083778,Greenfeld; Be'Eri,5,0,36,31
1657779542090,MATH 103A,A03,093561,Greenfeld; Be'Eri,6,0,36,30
1657779542090,MATH 103A,B01,083779,Greenfeld; Be'Eri,7,0,36,29
1657779542090,MATH 103A,B02,083780,Greenfeld; Be'Eri,4,0,36,32
1657779542090,MATH 103A,B03,093562,Greenfeld; Be'Eri,3,0,36,33
1657779548121,MATH 105,A01,085443,Carter; Anne Toulson,15,0,35,20
1657779548121,MATH 105,A02,093477,Carter; Anne Toulson,20,0,35,15
1657779554150,MATH 109,A01,083213,Ganzberger; Geoffrey Michael,3,0,34,31
1657779554150,MATH 109,A02,083214,Ganzberger; Geoffrey Michael,4,0,34,30
1657779554150,MATH 109,A03,093478,Ganzberger; Geoffrey Michael,2,0,34,32
1657779554150,MATH 109,B01,083215,Ganzberger; Geoffrey Michael,1,0,32,31
1657779554150,MATH 109,B02,083216,Ganzberger; Geoffrey Michael,2,0,32,30
1657779554150,MATH 109,B03,093479,Ganzberger; Geoffrey Michael,8,0,32,24
1657779560176,MATH 142A,A01,083219,Chow; Bennett,7,0,32,25
1657779560176,MATH 142A,A02,083220,Chow; Bennett,10,0,32,22
1657779560176,MATH 142A,A03,093480,Chow; Bennett,9,0,32,23
1657779560176,MATH 142A,B03,093481,Chow; Bennett,8,0,32,24
1657779560176,MATH 142A,B04,093558,Chow; Bennett,13,0,32,19
1657779560176,MATH 142A,B05,093559,Chow; Bennett,6,0,32,26
1657779566205,MATH 193A,A01,083224,Rotar; Vladimir,8,0,34,26
1657779566205,MATH 193A,A02,083225,Rotar; Vladimir,9,0,34,25
1657779566205,MATH 193A,A03,083781,Rotar; Vladimir,5,0,34,29
1657779566205,MATH 193A,A04,083782,Rotar; Vladimir,10,0,34,24
1657779566205,MATH 193A,A05,093482,Rotar; Vladimir,10,0,34,24
1657779572229,MATH 197,001,091859,McAuley; Julian John,9999,0,9999,0
1657779572229,MATH 197,002,095566,Kedlaya; Kiran S.,9997,0,9999,2
1657779572229,MATH 197,003,095567,Xiao; Ming,9999,0,9999,0
1657779572229,MATH 197,004,095571,Perols; Johan Lars,9998,0,9999,1
1657779579297,COGS 9,A01,083615,Shannon; Kyle Michael,9,0,75,66
1657779585398,COGS 11,A01,083617,Boyle; Mary E. T.,23,0,48,25
1657779591428,COGS 13,A01,083071,Bastos; Amalia Pinkusfeld,11,0,71,60
1657779597452,COGS 14A,A01,092681,Semenuks; Arturs,5,1,100,95
1657779603479,COGS 14B,A01,083073,Cheng; Tzu-Han,6,0,63,57
1657779609501,COGS 17,A01,092677,Semenuks; Arturs,6,0,81,75
1657779615524,COGS 100,A01,083619,Allen; Michael Gordon,17,0,70,53
1657779621547,COGS 101A,A01,083621,Davis; Joshua Daniel,9,0,68,59
1657779627574,COGS 101B,A01,091572,Allen; Michael Gordon,12,0,65,53
1657779633596,COGS 101C,A01,083625,Delgado; Tania,17,0,35,18
1657779639623,COGS 107A,A01,083627,Boyle; Mary E. T.,14,0,60,46
1657779645649,COGS 118A,A01,083075,Gupta; Anjum,21,0,76,55
1657779651679,CSE 3,A50,083646,Miranda; Gregory Joseph,24,0,50,26
1657779657701,CSE 8A,A50,083650,Miranda; Gregory Joseph,17,1,56,39
1657779663724,CSE 11,A01,083080,Cao; Yingjun,6,15,40,34
1657779669748,CSE 12,A01,083652,Krause-Levy; Sophia Louisa,28,1,120,92
1657779675771,CSE 15L,A01,083654,Morris; Justin Loren,9,0,50,41
1657779675771,CSE 15L,A02,083655,Morris; Justin Loren,9,0,50,41
1657779681794,CSE 20,A01,083657,Tran; Khoa Dang,39,0,80,41
1657779687817,CSE 21,A01,095574,Bach; Quang Tran,22,0,48,26
1657779693842,CSE 30,A01,083084,Eldon; John,6,0,80,74
1657779693842,CSE 30,B01,095061,Bhaskar; Nishant,9,0,50,41
1657779699866,CSE 100,A01,083659,Cao; Yingjun,5,4,70,65
1657779705888,CSE 134B,A01,083661,Powell; Thomas Allan,24,0,100,76
1657779711911,CSE 140,A01,083663,Gungor; Onat,15,0,85,70
1657779717932,CSE 140L,A01,083088,Eldon; John,23,0,100,77
1657779723956,CSE 175,A01,083665,Kumar; Rakesh,3,0,25,22
1657779729978,CSE 190,A00,092507,Dubnov; Shlomo,8,0,20,12
1657779736005,ECE 45,A01,083139,Congero; Spencer William,6,0,75,69
1657779742030,ECE 65,A50,083695,Saad; Andrew S,12,0,30,18
1657779742030,ECE 65,A51,095125,Saad; Andrew S,24,0,26,2
1657779748054,ECE 109,A01,091882,Touri; Behrouz,20,0,70,50
1657779754077,ECE 180,A00,083140,Abi Samra; Nicholas Camill,1,0,30,29
1657779754077,ECE 180,B00,083141,Abi Samra; Nicholas Camill,0,0,30,30
1657779760120,MATH 10A,A01,083735,Patchell; Gregory David,2,0,30,28
1657779760120,MATH 10A,A02,083736,Patchell; Gregory David,20,0,30,10
1657779760120,MATH 10A,A03,083737,Patchell; Gregory David,16,0,30,14
1657779766143,MATH 10B,A01,083207,Lim; Seonhee,8,0,34,26
1657779766143,MATH 10B,A02,083208,Lim; Seonhee,10,0,35,25
1657779766143,MATH 10B,A03,093472,Lim; Seonhee,7,0,34,27
1657779766143,MATH 10B,B01,083739,Sinha; Shubham,13,0,30,17
1657779772178,MATH 18,A01,083743,Cinel; Cameron Alexander,9,0,30,21
1657779772178,MATH 18,A02,083744,Cinel; Cameron Alexander,18,0,30,12
1657779772178,MATH 18,A03,083745,Cinel; Cameron Alexander,10,0,30,20
1657779772178,MATH 18,B01,083748,Rideout; David Porter,5,0,37,32
1657779772178,MATH 18,B02,083749,Rideout; David Porter,5,0,36,31
1657779772178,MATH 18,B03,083750,Rideout; David Porter,3,0,37,34
1657779772178,MATH 18,B04,083751,Rideout; David Porter,6,0,36,30
1657779772178,MATH 18,B05,093473,Rideout; David Porter,6,0,36,30
1657779772178,MATH 18,B06,093474,Rideout; David Porter,6,0,36,30
1657779778207,MATH 20A,A01,083754,Zheng; Zequn,14,0,40,26
1657779784231,MATH 20B,A01,083756,Briones; Jor-el Thomas Caparas,4,0,36,32
1657779784231,MATH 20B,A02,083757,Briones; Jor-el Thomas Caparas,1,0,36,35
1657779784231,MATH 20B,A03,093475,Briones; Jor-el Thomas Caparas,2,0,36,34
1657779790258,MATH 20C,A01,083760,Briones; Jor-el Thomas Caparas,1,0,35,34
1657779790258,MATH 20C,A02,083761,Briones; Jor-el Thomas Caparas,8,0,35,27
1657779790258,MATH 20C,A03,093476,Briones; Jor-el Thomas Caparas,0,1,36,36
1657779790258,MATH 20C,B01,083762,Bach; Quang Tran,1,0,30,29
1657779796286,MATH 20D,A01,083765,Tran; Brian Kha,5,0,30,25
1657779796286,MATH 20D,A02,083766,Tran; Brian Kha,5,0,30,25
1657779796286,MATH 20D,A03,083767,Tran; Brian Kha,5,0,30,25
1657779802317,MATH 20E,A01,083771,Ganguly; Soumya,10,0,32,22
1657779802317,MATH 20E,A02,083772,Ganguly; Soumya,6,0,32,26
1657779802317,MATH 20E,B01,083773,Ciotti; Benjamin,20,0,35,15
1657779802317,MATH 20E,B02,083774,Ciotti; Benjamin,18,0,35,17
1657779808346,MATH 103A,A01,083777,Greenfeld; Be'Eri,3,0,36,33
1657779808346,MATH 103A,A02,083778,Greenfeld; Be'Eri,5,0,36,31
1657779808346,MATH 103A,A03,093561,Greenfeld; Be'Eri,6,0,36,30
1657779808346,MATH 103A,B01,083779,Greenfeld; Be'Eri,7,0,36,29
1657779808346,MATH 103A,B02,083780,Greenfeld; Be'Eri,4,0,36,32
1657779808346,MATH 103A,B03,093562,Greenfeld; Be'Eri,3,0,36,33
1657779814375,MATH 105,A01,085443,Carter; Anne Toulson,15,0,35,20
1657779814375,MATH 105,A02,093477,Carter; Anne Toulson,20,0,35,15
1657779820398,MATH 109,A01,083213,Ganzberger; Geoffrey Michael,3,0,34,31
1657779820398,MATH 109,A02,083214,Ganzberger; Geoffrey Michael,4,0,34,30
1657779820398,MATH 109,A03,093478,Ganzberger; Geoffrey Michael,2,0,34,32
1657779820398,MATH 109,B01,083215,Ganzberger; Geoffrey Michael,1,0,32,31
1657779820398,MATH 109,B02,083216,Ganzberger; Geoffrey Michael,2,0,32,30
1657779820398,MATH 109,B03,093479,Ganzberger; Geoffrey Michael,8,0,32,24
1657779826421,MATH 142A,A01,083219,Chow; Bennett,7,0,32,25
1657779826421,MATH 142A,A02,083220,Chow; Bennett,10,0,32,22
1657779826421,MATH 142A,A03,093480,Chow; Bennett,9,0,32,23
1657779826421,MATH 142A,B03,093481,Chow; Bennett,8,0,32,24
1657779826421,MATH 142A,B04,093558,Chow; Bennett,13,0,32,19
1657779826421,MATH 142A,B05,093559,Chow; Bennett,6,0,32,26
1657779832450,MATH 193A,A01,083224,Rotar; Vladimir,8,0,34,26
1657779832450,MATH 193A,A02,083225,Rotar; Vladimir,9,0,34,25
1657779832450,MATH 193A,A03,083781,Rotar; Vladimir,5,0,34,29
1657779832450,MATH 193A,A04,083782,Rotar; Vladimir,10,0,34,24
1657779832450,MATH 193A,A05,093482,Rotar; Vladimir,10,0,34,24
1657779838477,MATH 197,001,091859,McAuley; Julian John,9999,0,9999,0
1657779838477,MATH 197,002,095566,Kedlaya; Kiran S.,9997,0,9999,2
1657779838477,MATH 197,003,095567,Xiao; Ming,9999,0,9999,0
1657779838477,MATH 197,004,095571,Perols; Johan Lars,9998,0,9999,1
1657779845538,COGS 9,A01,083615,Shannon; Kyle Michael,9,0,75,66
1657779851562,COGS 11,A01,083617,Boyle; Mary E. T.,23,0,48,25
1657779857591,COGS 13,A01,083071,Bastos; Amalia Pinkusfeld,11,0,71,60
1657779863614,COGS 14A,A01,092681,Semenuks; Arturs,5,1,100,95
1657779869649,COGS 14B,A01,083073,Cheng; Tzu-Han,6,0,63,57
1657779875671,COGS 17,A01,092677,Semenuks; Arturs,6,0,81,75
1657779881695,COGS 100,A01,083619,Allen; Michael Gordon,17,0,70,53
1657779887725,COGS 101A,A01,083621,Davis; Joshua Daniel,9,0,68,59
1657779893753,COGS 101B,A01,091572,Allen; Michael Gordon,12,0,65,53
1657779899780,COGS 101C,A01,083625,Delgado; Tania,17,0,35,18
1657779905804,COGS 107A,A01,083627,Boyle; Mary E. T.,14,0,60,46
1657779911828,COGS 118A,A01,083075,Gupta; Anjum,21,0,76,55
1657779917857,CSE 3,A50,083646,Miranda; Gregory Joseph,24,0,50,26
1657779923880,CSE 8A,A50,083650,Miranda; Gregory Joseph,17,1,56,39
1657779929906,CSE 11,A01,083080,Cao; Yingjun,6,15,40,34
1657779935934,CSE 12,A01,083652,Krause-Levy; Sophia Louisa,28,1,120,92
1657779941957,CSE 15L,A01,083654,Morris; Justin Loren,9,0,50,41
1657779941957,CSE 15L,A02,083655,Morris; Justin Loren,9,0,50,41
1657779947979,CSE 20,A01,083657,Tran; Khoa Dang,39,0,80,41
1657779954005,CSE 21,A01,095574,Bach; Quang Tran,22,0,48,26
1657779960028,CSE 30,A01,083084,Eldon; John,6,0,80,74
1657779960028,CSE 30,B01,095061,Bhaskar; Nishant,9,0,50,41
1657779966054,CSE 100,A01,083659,Cao; Yingjun,5,4,70,65
1657779972077,CSE 134B,A01,083661,Powell; Thomas Allan,24,0,100,76
1657779978103,CSE 140,A01,083663,Gungor; Onat,15,0,85,70
1657779984126,CSE 140L,A01,083088,Eldon; John,23,0,100,77
1657779990148,CSE 175,A01,083665,Kumar; Rakesh,3,0,25,22
1657779996170,CSE 190,A00,092507,Dubnov; Shlomo,8,0,20,12
1657780002195,ECE 45,A01,083139,Congero; Spencer William,6,0,75,69
1657780008222,ECE 65,A50,083695,Saad; Andrew S,12,0,30,18
1657780008222,ECE 65,A51,095125,Saad; Andrew S,24,0,26,2
1657780014246,ECE 109,A01,091882,Touri; Behrouz,20,0,70,50
1657780020271,ECE 180,A00,083140,Abi Samra; Nicholas Camill,1,0,30,29
1657780020271,ECE 180,B00,083141,Abi Samra; Nicholas Camill,0,0,30,30
1657780040628,MATH 10A,A01,083735,Patchell; Gregory David,2,0,30,28
1657780040628,MATH 10A,A02,083736,Patchell; Gregory David,20,0,30,10
1657780040628,MATH 10A,A03,083737,Patchell; Gregory David,16,0,30,14
1657780046660,MATH 10B,A01,083207,Lim; Seonhee,8,0,34,26
1657780046660,MATH 10B,A02,083208,Lim; Seonhee,10,0,35,25
1657780046660,MATH 10B,A03,093472,Lim; Seonhee,7,0,34,27
1657780046660,MATH 10B,B01,083739,Sinha; Shubham,13,0,30,17
1657780052692,MATH 18,A01,083743,Cinel; Cameron Alexander,9,0,30,21
1657780052692,MATH 18,A02,083744,Cinel; Cameron Alexander,18,0,30,12
1657780052692,MATH 18,A03,083745,Cinel; Cameron Alexander,10,0,30,20
1657780052692,MATH 18,B01,083748,Rideout; David Porter,5,0,37,32
1657780052692,MATH 18,B02,083749,Rideout; David Porter,5,0,36,31
1657780052692,MATH 18,B03,083750,Rideout; David Porter,3,0,37,34
1657780052692,MATH 18,B04,083751,Rideout; David Porter,6,0,36,30
1657780052692,MATH 18,B05,093473,Rideout; David Porter,6,0,36,30
1657780052692,MATH 18,B06,093474,Rideout; David Porter,6,0,36,30
1657780058714,MATH 20A,A01,083754,Zheng; Zequn,14,0,40,26
1657780064745,MATH 20B,A01,083756,Briones; Jor-el Thomas Caparas,4,0,36,32
1657780064745,MATH 20B,A02,083757,Briones; Jor-el Thomas Caparas,1,0,36,35
1657780064745,MATH 20B,A03,093475,Briones; Jor-el Thomas Caparas,2,0,36,34
1657780070772,MATH 20C,A01,083760,Briones; Jor-el Thomas Caparas,1,0,35,34
1657780070772,MATH 20C,A02,083761,Briones; Jor-el Thomas Caparas,8,0,35,27
1657780070772,MATH 20C,A03,093476,Briones; Jor-el Thomas Caparas,0,1,36,36
1657780070772,MATH 20C,B01,083762,Bach; Quang Tran,1,0,30,29
1657780076799,MATH 20D,A01,083765,Tran; Brian Kha,5,0,30,25
1657780076799,MATH 20D,A02,083766,Tran; Brian Kha,5,0,30,25
1657780076799,MATH 20D,A03,083767,Tran; Brian Kha,5,0,30,25
1657780082825,MATH 20E,A01,083771,Ganguly; Soumya,10,0,32,22
1657780082825,MATH 20E,A02,083772,Ganguly; Soumya,6,0,32,26
1657780082825,MATH 20E,B01,083773,Ciotti; Benjamin,20,0,35,15
1657780082825,MATH 20E,B02,083774,Ciotti; Benjamin,18,0,35,17
1657780088848,MATH 103A,A01,083777,Greenfeld; Be'Eri,3,0,36,33
1657780088848,MATH 103A,A02,083778,Greenfeld; Be'Eri,5,0,36,31
1657780088848,MATH 103A,A03,093561,Greenfeld; Be'Eri,6,0,36,30
1657780088848,MATH 103A,B01,083779,Greenfeld; Be'Eri,7,0,36,29
1657780088848,MATH 103A,B02,083780,Greenfeld; Be'Eri,4,0,36,32
1657780088848,MATH 103A,B03,093562,Greenfeld; Be'Eri,3,0,36,33
1657780094872,MATH 105,A01,085443,Carter; Anne Toulson,15,0,35,20
1657780094872,MATH 105,A02,093477,Carter; Anne Toulson,20,0,35,15
1657780100905,MATH 109,A01,083213,Ganzberger; Geoffrey Michael,3,0,34,31
1657780100905,MATH 109,A02,083214,Ganzberger; Geoffrey Michael,4,0,34,30
1657780100905,MATH 109,A03,093478,Ganzberger; Geoffrey Michael,2,0,34,32
1657780100905,MATH 109,B01,083215,Ganzberger; Geoffrey Michael,1,0,32,31
1657780100905,MATH 109,B02,083216,Ganzberger; Geoffrey Michael,2,0,32,30
1657780100905,MATH 109,B03,093479,Ganzberger; Geoffrey Michael,8,0,32,24
1657780106931,MATH 142A,A01,083219,Chow; Bennett,7,0,32,25
1657780106931,MATH 142A,A02,083220,Chow; Bennett,10,0,32,22
1657780106931,MATH 142A,A03,093480,Chow; Bennett,9,0,32,23
1657780106931,MATH 142A,B03,093481,Chow; Bennett,8,0,32,24
1657780106931,MATH 142A,B04,093558,Chow; Bennett,13,0,32,19
1657780106931,MATH 142A,B05,093559,Chow; Bennett,6,0,32,26
1657780112955,MATH 193A,A01,083224,Rotar; Vladimir,8,0,34,26
1657780112955,MATH 193A,A02,083225,Rotar; Vladimir,9,0,34,25
1657780112955,MATH 193A,A03,083781,Rotar; Vladimir,5,0,34,29
1657780112955,MATH 193A,A04,083782,Rotar; Vladimir,10,0,34,24
1657780112955,MATH 193A,A05,093482,Rotar; Vladimir,10,0,34,24
1657780118993,MATH 197,001,091859,McAuley; Julian John,9999,0,9999,0
1657780118993,MATH 197,002,095566,Kedlaya; Kiran S.,9997,0,9999,2
1657780118993,MATH 197,003,095567,Xiao; Ming,9999,0,9999,0
1657780118993,MATH 197,004,095571,Perols; Johan Lars,9998,0,9999,1
1657780126056,COGS 9,A01,083615,Shannon; Kyle Michael,9,0,75,66
1657780132086,COGS 11,A01,083617,Boyle; Mary E. T.,23,0,48,25
1657780138114,COGS 13,A01,083071,Bastos; Amalia Pinkusfeld,11,0,71,60
1657780144140,COGS 14A,A01,092681,Semenuks; Arturs,5,1,100,95
1657780150168,COGS 14B,A01,083073,Cheng; Tzu-Han,6,0,63,57
1657780156191,COGS 17,A01,092677,Semenuks; Arturs,6,0,81,75
1657780162215,COGS 100,A01,083619,Allen; Michael Gordon,17,0,70,53
1657780168248,COGS 101A,A01,083621,Davis; Joshua Daniel,9,0,68,59
1657780174272,COGS 101B,A01,091572,Allen; Michael Gordon,12,0,65,53
1657780180298,COGS 101C,A01,083625,Delgado; Tania,17,0,35,18
1657780186324,COGS 107A,A01,083627,Boyle; Mary E. T.,14,0,60,46
1657780192349,COGS 118A,A01,083075,Gupta; Anjum,21,0,76,55
1657780198447,CSE 3,A50,083646,Miranda; Gregory Joseph,24,0,50,26
1657780204475,CSE 8A,A50,083650,Miranda; Gregory Joseph,17,1,56,39
1657780210499,CSE 11,A01,083080,Cao; Yingjun,6,15,40,34
1657780216534,CSE 12,A01,083652,Krause-Levy; Sophia Louisa,28,1,120,92
1657780222561,CSE 15L,A01,083654,Morris; Justin Loren,9,0,50,41
1657780222561,CSE 15L,A02,083655,Morris; Justin Loren,9,0,50,41
1657780228583,CSE 20,A01,083657,Tran; Khoa Dang,39,0,80,41
1657780234608,CSE 21,A01,095574,Bach; Quang Tran,22,0,48,26
1657780240637,CSE 30,A01,083084,Eldon; John,6,0,80,74
1657780240637,CSE 30,B01,095061,Bhaskar; Nishant,9,0,50,41
1657780246665,CSE 100,A01,083659,Cao; Yingjun,5,4,70,65
1657780252691,CSE 134B,A01,083661,Powell; Thomas Allan,24,0,100,76
1657780258714,CSE 140,A01,083663,Gungor; Onat,15,0,85,70
1657780264736,CSE 140L,A01,083088,Eldon; John,23,0,100,77
1657780270758,CSE 175,A01,083665,Kumar; Rakesh,3,0,25,22
1657780276799,CSE 190,A00,092507,Dubnov; Shlomo,8,0,20,12
1657780282827,ECE 45,A01,083139,Congero; Spencer William,6,0,75,69
1657780288851,ECE 65,A50,083695,Saad; Andrew S,12,0,30,18
1657780288851,ECE 65,A51,095125,Saad; Andrew S,24,0,26,2
1657780294876,ECE 109,A01,091882,Touri; Behrouz,20,0,70,50
1657780300901,ECE 180,A00,083140,Abi Samra; Nicholas Camill,1,0,30,29
1657780300901,ECE 180,B00,083141,Abi Samra; Nicholas Camill,0,0,30,30
1657780306925,MATH 10A,A01,083735,Patchell; Gregory David,2,0,30,28
1657780306925,MATH 10A,A02,083736,Patchell; Gregory David,20,0,30,10
1657780306925,MATH 10A,A03,083737,Patchell; Gregory David,16,0,30,14
1657780312952,MATH 10B,A01,083207,Lim; Seonhee,8,0,34,26
1657780312952,MATH 10B,A02,083208,Lim; Seonhee,10,0,35,25
1657780312952,MATH 10B,A03,093472,Lim; Seonhee,7,0,34,27
1657780312952,MATH 10B,B01,083739,Sinha; Shubham,13,0,30,17
1657780318976,MATH 18,A01,083743,Cinel; Cameron Alexander,9,0,30,21
1657780318976,MATH 18,A02,083744,Cinel; Cameron Alexander,18,0,30,12
1657780318976,MATH 18,A03,083745,Cinel; Cameron Alexander,10,0,30,20
1657780318976,MATH 18,B01,083748,Rideout; David Porter,5,0,37,32
1657780318976,MATH 18,B02,083749,Rideout; David Porter,5,0,36,31
1657780318976,MATH 18,B03,083750,Rideout; David Porter,3,0,37,34
1657780318976,MATH 18,B04,083751,Rideout; David Porter,6,0,36,30
1657780318976,MATH 18,B05,093473,Rideout; David Porter,6,0,36,30
1657780318976,MATH 18,B06,093474,Rideout; David Porter,6,0,36,30
1657780325001,MATH 20A,A01,083754,Zheng; Zequn,14,0,40,26
1657780331024,MATH 20B,A01,083756,Briones; Jor-el Thomas Caparas,4,0,36,32
1657780331024,MATH 20B,A02,083757,Briones; Jor-el Thomas Caparas,1,0,36,35
1657780331024,MATH 20B,A03,093475,Briones; Jor-el Thomas Caparas,2,0,36,34
1657780337052,MATH 20C,A01,083760,Briones; Jor-el Thomas Caparas,1,0,35,34
1657780337052,MATH 20C,A02,083761,Briones; Jor-el Thomas Caparas,8,0,35,27
1657780337052,MATH 20C,A03,093476,Briones; Jor-el Thomas Caparas,0,1,36,36
1657780337052,MATH 20C,B01,083762,Bach; Quang Tran,1,0,30,29
1657780343082,MATH 20D,A01,083765,Tran; Brian Kha,5,0,30,25
1657780343082,MATH 20D,A02,083766,Tran; Brian Kha,5,0,30,25
1657780343082,MATH 20D,A03,083767,Tran; Brian Kha,5,0,30,25
1657780349112,MATH 20E,A01,083771,Ganguly; Soumya,10,0,32,22
1657780349112,MATH 20E,A02,083772,Ganguly; Soumya,6,0,32,26
1657780349112,MATH 20E,B01,083773,Ciotti; Benjamin,20,0,35,15
1657780349112,MATH 20E,B02,083774,Ciotti; Benjamin,18,0,35,17
1657780355143,MATH 103A,A01,083777,Greenfeld; Be'Eri,3,0,36,33
1657780355143,MATH 103A,A02,083778,Greenfeld; Be'Eri,5,0,36,31
1657780355143,MATH 103A,A03,093561,Greenfeld; Be'Eri,6,0,36,30
1657780355143,MATH 103A,B01,083779,Greenfeld; Be'Eri,7,0,36,29
1657780355143,MATH 103A,B02,083780,Greenfeld; Be'Eri,4,0,36,32
1657780355143,MATH 103A,B03,093562,Greenfeld; Be'Eri,3,0,36,33
1657780361172,MATH 105,A01,085443,Carter; Anne Toulson,15,0,35,20
1657780361172,MATH 105,A02,093477,Carter; Anne Toulson,20,0,35,15
1657780367197,MATH 109,A01,083213,Ganzberger; Geoffrey Michael,3,0,34,31
1657780367197,MATH 109,A02,083214,Ganzberger; Geoffrey Michael,4,0,34,30
1657780367197,MATH 109,A03,093478,Ganzberger; Geoffrey Michael,2,0,34,32
1657780367197,MATH 109,B01,083215,Ganzberger; Geoffrey Michael,1,0,32,31
1657780367197,MATH 109,B02,083216,Ganzberger; Geoffrey Michael,2,0,32,30
1657780367197,MATH 109,B03,093479,Ganzberger; Geoffrey Michael,8,0,32,24
1657780373226,MATH 142A,A01,083219,Chow; Bennett,7,0,32,25
1657780373226,MATH 142A,A02,083220,Chow; Bennett,10,0,32,22
1657780373226,MATH 142A,A03,093480,Chow; Bennett,9,0,32,23
1657780373226,MATH 142A,B03,093481,Chow; Bennett,8,0,32,24
1657780373226,MATH 142A,B04,093558,Chow; Bennett,13,0,32,19
1657780373226,MATH 142A,B05,093559,Chow; Bennett,6,0,32,26
1657780379250,MATH 193A,A01,083224,Rotar; Vladimir,8,0,34,26
1657780379250,MATH 193A,A02,083225,Rotar; Vladimir,9,0,34,25
1657780379250,MATH 193A,A03,083781,Rotar; Vladimir,5,0,34,29
1657780379250,MATH 193A,A04,083782,Rotar; Vladimir,10,0,34,24
1657780379250,MATH 193A,A05,093482,Rotar; Vladimir,10,0,34,24
1657780385274,MATH 197,001,091859,McAuley; Julian John,9999,0,9999,0
1657780385274,MATH 197,002,095566,Kedlaya; Kiran S.,9997,0,9999,2
1657780385274,MATH 197,003,095567,Xiao; Ming,9999,0,9999,0
1657780385274,MATH 197,004,095571,Perols; Johan Lars,9998,0,9999,1
1657780392335,COGS 9,A01,083615,Shannon; Kyle Michael,9,0,75,66
1657780398357,COGS 11,A01,083617,Boyle; Mary E. T.,23,0,48,25
1657780404380,COGS 13,A01,083071,Bastos; Amalia Pinkusfeld,11,0,71,60
1657780410403,COGS 14A,A01,092681,Semenuks; Arturs,5,1,100,95
1657780416426,COGS 14B,A01,083073,Cheng; Tzu-Han,6,0,63,57
1657780422449,COGS 17,A01,092677,Semenuks; Arturs,6,0,81,75
1657780428481,COGS 100,A01,083619,Allen; Michael Gordon,17,0,70,53
1657780434509,COGS 101A,A01,083621,Davis; Joshua Daniel,9,0,68,59
1657780440534,COGS 101B,A01,091572,Allen; Michael Gordon,12,0,65,53
1657780446559,COGS 101C,A01,083625,Delgado; Tania,17,0,35,18
1657780452586,COGS 107A,A01,083627,Boyle; Mary E. T.,14,0,60,46
1657780458611,COGS 118A,A01,083075,Gupta; Anjum,21,0,76,55
1657780464637,CSE 3,A50,083646,Miranda; Gregory Joseph,24,0,50,26
1657780470662,CSE 8A,A50,083650,Miranda; Gregory Joseph,17,1,56,39
1657780476690,CSE 11,A01,083080,Cao; Yingjun,6,15,40,34
1657780482714,CSE 12,A01,083652,Krause-Levy; Sophia Louisa,28,1,120,92
1657780488738,CSE 15L,A01,083654,Morris; Justin Loren,9,0,50,41
1657780488738,CSE 15L,A02,083655,Morris; Justin Loren,9,0,50,41
1657780494769,CSE 20,A01,083657,Tran; Khoa Dang,39,0,80,41
1657780500793,CSE 21,A01,095574,Bach; Quang Tran,22,0,48,26
1657780506815,CSE 30,A01,083084,Eldon; John,6,0,80,74
1657780506815,CSE 30,B01,095061,Bhaskar; Nishant,9,0,50,41
1657780512837,CSE 100,A01,083659,Cao; Yingjun,5,4,70,65
1657780518860,CSE 134B,A01,083661,Powell; Thomas Allan,24,0,100,76
1657780524882,CSE 140,A01,083663,Gungor; Onat,15,0,85,70
1657780530911,CSE 140L,A01,083088,Eldon; John,23,0,100,77
1657780536937,CSE 175,A01,083665,Kumar; Rakesh,3,0,25,22
1657780542960,CSE 190,A00,092507,Dubnov; Shlomo,8,0,20,12
1657780548985,ECE 45,A01,083139,Congero; Spencer William,6,0,75,69
1657780555014,ECE 65,A50,083695,Saad; Andrew S,12,0,30,18
1657780555014,ECE 65,A51,095125,Saad; Andrew S,24,0,26,2
1657780561041,ECE 109,A01,091882,Touri; Behrouz,20,0,70,50
1657780567063,ECE 180,A00,083140,Abi Samra; Nicholas Camill,1,0,30,29
1657780567063,ECE 180,B00,083141,Abi Samra; Nicholas Camill,0,0,30,30
1657780573093,MATH 10A,A01,083735,Patchell; Gregory David,2,0,30,28
1657780573093,MATH 10A,A02,083736,Patchell; Gregory David,20,0,30,10
1657780573093,MATH 10A,A03,083737,Patchell; Gregory David,16,0,30,14
1657780579116,MATH 10B,A01,083207,Lim; Seonhee,8,0,34,26
1657780579116,MATH 10B,A02,083208,Lim; Seonhee,10,0,35,25
1657780579116,MATH 10B,A03,093472,Lim; Seonhee,7,0,34,27
1657780579116,MATH 10B,B01,083739,Sinha; Shubham,13,0,30,17
1657780585140,MATH 18,A01,083743,Cinel; Cameron Alexander,9,0,30,21
1657780585140,MATH 18,A02,083744,Cinel; Cameron Alexander,18,0,30,12
1657780585140,MATH 18,A03,083745,Cinel; Cameron Alexander,10,0,30,20
1657780585140,MATH 18,B01,083748,Rideout; David Porter,5,0,37,32
1657780585140,MATH 18,B02,083749,Rideout; David Porter,5,0,36,31
1657780585140,MATH 18,B03,083750,Rideout; David Porter,3,0,37,34
1657780585140,MATH 18,B04,083751,Rideout; David Porter,6,0,36,30
1657780585140,MATH 18,B05,093473,Rideout; David Porter,6,0,36,30
1657780585140,MATH 18,B06,093474,Rideout; David Porter,6,0,36,30
1657780591166,MATH 20A,A01,083754,Zheng; Zequn,14,0,40,26
1657780597201,MATH 20B,A01,083756,Briones; Jor-el Thomas Caparas,4,0,36,32
1657780597201,MATH 20B,A02,083757,Briones; Jor-el Thomas Caparas,1,0,36,35
1657780597201,MATH 20B,A03,093475,Briones; Jor-el Thomas Caparas,2,0,36,34
1657780603230,MATH 20C,A01,083760,Briones; Jor-el Thomas Caparas,1,0,35,34
1657780603230,MATH 20C,A02,083761,Briones; Jor-el Thomas Caparas,8,0,35,27
1657780603230,MATH 20C,A03,093476,Briones; Jor-el Thomas Caparas,0,1,36,36
1657780603230,MATH 20C,B01,083762,Bach; Quang Tran,1,0,30,29
1657780609258,MATH 20D,A01,083765,Tran; Brian Kha,5,0,30,25
1657780609258,MATH 20D,A02,083766,Tran; Brian Kha,5,0,30,25
1657780609258,MATH 20D,A03,083767,Tran; Brian Kha,5,0,30,25
1657780615281,MATH 20E,A01,083771,Ganguly; Soumya,10,0,32,22
1657780615281,MATH 20E,A02,083772,Ganguly; Soumya,6,0,32,26
1657780615281,MATH 20E,B01,083773,Ciotti; Benjamin,20,0,35,15
1657780615281,MATH 20E,B02,083774,Ciotti; Benjamin,18,0,35,17
1657780621312,MATH 103A,A01,083777,Greenfeld; Be'Eri,3,0,36,33
1657780621312,MATH 103A,A02,083778,Greenfeld; Be'Eri,5,0,36,31
1657780621312,MATH 103A,A03,093561,Greenfeld; Be'Eri,6,0,36,30
1657780621312,MATH 103A,B01,083779,Greenfeld; Be'Eri,7,0,36,29
1657780621312,MATH 103A,B02,083780,Greenfeld; Be'Eri,4,0,36,32
1657780621312,MATH 103A,B03,093562,Greenfeld; Be'Eri,3,0,36,33
1657780627335,MATH 105,A01,085443,Carter; Anne Toulson,15,0,35,20
1657780627335,MATH 105,A02,093477,Carter; Anne Toulson,20,0,35,15
1657780633371,MATH 109,A01,083213,Ganzberger; Geoffrey Michael,3,0,34,31
1657780633371,MATH 109,A02,083214,Ganzberger; Geoffrey Michael,4,0,34,30
1657780633371,MATH 109,A03,093478,Ganzberger; Geoffrey Michael,2,0,34,32
1657780633371,MATH 109,B01,083215,Ganzberger; Geoffrey Michael,1,0,32,31
1657780633371,MATH 109,B02,083216,Ganzberger; Geoffrey Michael,2,0,32,30
1657780633371,MATH 109,B03,093479,Ganzberger; Geoffrey Michael,8,0,32,24
1657780639395,MATH 142A,A01,083219,Chow; Bennett,7,0,32,25
1657780639395,MATH 142A,A02,083220,Chow; Bennett,10,0,32,22
1657780639395,MATH 142A,A03,093480,Chow; Bennett,9,0,32,23
1657780639395,MATH 142A,B03,093481,Chow; Bennett,8,0,32,24
1657780639395,MATH 142A,B04,093558,Chow; Bennett,13,0,32,19
1657780639395,MATH 142A,B05,093559,Chow; Bennett,6,0,32,26
1657780645419,MATH 193A,A01,083224,Rotar; Vladimir,8,0,34,26
1657780645419,MATH 193A,A02,083225,Rotar; Vladimir,9,0,34,25
1657780645419,MATH 193A,A03,083781,Rotar; Vladimir,5,0,34,29
1657780645419,MATH 193A,A04,083782,Rotar; Vladimir,10,0,34,24
1657780645419,MATH 193A,A05,093482,Rotar; Vladimir,10,0,34,24
1657780651446,MATH 197,001,091859,McAuley; Julian John,9999,0,9999,0
1657780651446,MATH 197,002,095566,Kedlaya; Kiran S.,9997,0,9999,2
1657780651446,MATH 197,003,095567,Xiao; Ming,9999,0,9999,0
1657780651446,MATH 197,004,095571,Perols; Johan Lars,9998,0,9999,1
1657780658499,COGS 9,A01,083615,Shannon; Kyle Michael,9,0,75,66
1657780664525,COGS 11,A01,083617,Boyle; Mary E. T.,23,0,48,25
1657780670553,COGS 13,A01,083071,Bastos; Amalia Pinkusfeld,11,0,71,60
1657780676577,COGS 14A,A01,092681,Semenuks; Arturs,5,1,100,95
1657780682600,COGS 14B,A01,083073,Cheng; Tzu-Han,6,0,63,57
1657780688623,COGS 17,A01,092677,Semenuks; Arturs,6,0,81,75
1657780694650,COGS 100,A01,083619,Allen; Michael Gordon,17,0,70,53
1657780700677,COGS 101A,A01,083621,Davis; Joshua Daniel,9,0,68,59
1657780706699,COGS 101B,A01,091572,Allen; Michael Gordon,12,0,65,53
1657780712727,COGS 101C,A01,083625,Delgado; Tania,17,0,35,18
1657780718779,COGS 107A,A01,083627,Boyle; Mary E. T.,14,0,60,46
1657780724801,COGS 118A,A01,083075,Gupta; Anjum,21,0,76,55
1657780730832,CSE 3,A50,083646,Miranda; Gregory Joseph,24,0,50,26
1657780736861,CSE 8A,A50,083650,Miranda; Gregory Joseph,17,1,56,39
1657780742889,CSE 11,A01,083080,Cao; Yingjun,6,15,40,34
1657780748916,CSE 12,A01,083652,Krause-Levy; Sophia Louisa,28,1,120,92
1657780754944,CSE 15L,A01,083654,Morris; Justin Loren,9,0,50,41
1657780754944,CSE 15L,A02,083655,Morris; Justin Loren,9,0,50,41
1657780760970,CSE 20,A01,083657,Tran; Khoa Dang,39,0,80,41
1657780766996,CSE 21,A01,095574,Bach; Quang Tran,22,0,48,26
1657780773024,CSE 30,A01,083084,Eldon; John,6,0,80,74
1657780773024,CSE 30,B01,095061,Bhaskar; Nishant,9,0,50,41
1657780779048,CSE 100,A01,083659,Cao; Yingjun,5,4,70,65
1657780785078,CSE 134B,A01,083661,Powell; Thomas Allan,24,0,100,76
1657780791101,CSE 140,A01,083663,Gungor; Onat,15,0,85,70
1657780797195,CSE 140L,A01,083088,Eldon; John,23,0,100,77
1657780803221,CSE 175,A01,083665,Kumar; Rakesh,3,0,25,22
1657780809245,CSE 190,A00,092507,Dubnov; Shlomo,8,0,20,12
1657780815272,ECE 45,A01,083139,Congero; Spencer William,6,0,75,69
1657780821296,ECE 65,A50,083695,Saad; Andrew S,12,0,30,18
1657780821296,ECE 65,A51,095125,Saad; Andrew S,24,0,26,2
1657780827321,ECE 109,A01,091882,Touri; Behrouz,20,0,70,50
1657780833354,ECE 180,A00,083140,Abi Samra; Nicholas Camill,1,0,30,29
1657780833354,ECE 180,B00,083141,Abi Samra; Nicholas Camill,0,0,30,30
1657780839378,MATH 10A,A01,083735,Patchell; Gregory David,2,0,30,28
1657780839378,MATH 10A,A02,083736,Patchell; Gregory David,20,0,30,10
1657780839378,MATH 10A,A03,083737,Patchell; Gregory David,16,0,30,14
1657780845406,MATH 10B,A01,083207,Lim; Seonhee,8,0,34,26
1657780845406,MATH 10B,A02,083208,Lim; Seonhee,10,0,35,25
1657780845406,MATH 10B,A03,093472,Lim; Seonhee,7,0,34,27
1657780845406,MATH 10B,B01,083739,Sinha; Shubham,13,0,30,17
1657780851431,MATH 18,A01,083743,Cinel; Cameron Alexander,9,0,30,21
1657780851431,MATH 18,A02,083744,Cinel; Cameron Alexander,18,0,30,12
1657780851431,MATH 18,A03,083745,Cinel; Cameron Alexander,10,0,30,20
1657780851431,MATH 18,B01,083748,Rideout; David Porter,5,0,37,32
1657780851431,MATH 18,B02,083749,Rideout; David Porter,5,0,36,31
1657780851431,MATH 18,B03,083750,Rideout; David Porter,3,0,37,34
1657780851431,MATH 18,B04,083751,Rideout; David Porter,6,0,36,30
1657780851431,MATH 18,B05,093473,Rideout; David Porter,6,0,36,30
1657780851431,MATH 18,B06,093474,Rideout; David Porter,6,0,36,30
1657780857452,MATH 20A,A01,083754,Zheng; Zequn,14,0,40,26
1657780863478,MATH 20B,A01,083756,Briones; Jor-el Thomas Caparas,4,0,36,32
1657780863478,MATH 20B,A02,083757,Briones; Jor-el Thomas Caparas,1,0,36,35
1657780863478,MATH 20B,A03,093475,Briones; Jor-el Thomas Caparas,2,0,36,34
1657780869501,MATH 20C,A01,083760,Briones; Jor-el Thomas Caparas,1,0,35,34
1657780869501,MATH 20C,A02,083761,Briones; Jor-el Thomas Caparas,8,0,35,27
1657780869501,MATH 20C,A03,093476,Briones; Jor-el Thomas Caparas,0,1,36,36
1657780869501,MATH 20C,B01,083762,Bach; Quang Tran,1,0,30,29
1657780875529,MATH 20D,A01,083765,Tran; Brian Kha,5,0,30,25
1657780875529,MATH 20D,A02,083766,Tran; Brian Kha,5,0,30,25
1657780875529,MATH 20D,A03,083767,Tran; Brian Kha,5,0,30,25
1657780881555,MATH 20E,A01,083771,Ganguly; Soumya,10,0,32,22
1657780881555,MATH 20E,A02,083772,Ganguly; Soumya,6,0,32,26
1657780881555,MATH 20E,B01,083773,Ciotti; Benjamin,20,0,35,15
1657780881555,MATH 20E,B02,083774,Ciotti; Benjamin,18,0,35,17
1657780887584,MATH 103A,A01,083777,Greenfeld; Be'Eri,3,0,36,33
1657780887584,MATH 103A,A02,083778,Greenfeld; Be'Eri,5,0,36,31
1657780887584,MATH 103A,A03,093561,Greenfeld; Be'Eri,6,0,36,30
1657780887584,MATH 103A,B01,083779,Greenfeld; Be'Eri,7,0,36,29
1657780887584,MATH 103A,B02,083780,Greenfeld; Be'Eri,4,0,36,32
1657780887584,MATH 103A,B03,093562,Greenfeld; Be'Eri,3,0,36,33
1657780893607,MATH 105,A01,085443,Carter; Anne Toulson,15,0,35,20
1657780893607,MATH 105,A02,093477,Carter; Anne Toulson,20,0,35,15
1657780899630,MATH 109,A01,083213,Ganzberger; Geoffrey Michael,3,0,34,31
1657780899630,MATH 109,A02,083214,Ganzberger; Geoffrey Michael,4,0,34,30
1657780899630,MATH 109,A03,093478,Ganzberger; Geoffrey Michael,2,0,34,32
1657780899630,MATH 109,B01,083215,Ganzberger; Geoffrey Michael,1,0,32,31
1657780899630,MATH 109,B02,083216,Ganzberger; Geoffrey Michael,2,0,32,30
1657780899630,MATH 109,B03,093479,Ganzberger; Geoffrey Michael,8,0,32,24
1657780905660,MATH 142A,A01,083219,Chow; Bennett,7,0,32,25
1657780905660,MATH 142A,A02,083220,Chow; Bennett,10,0,32,22
1657780905660,MATH 142A,A03,093480,Chow; Bennett,9,0,32,23
1657780905660,MATH 142A,B03,093481,Chow; Bennett,8,0,32,24
1657780905660,MATH 142A,B04,093558,Chow; Bennett,13,0,32,19
1657780905660,MATH 142A,B05,093559,Chow; Bennett,6,0,32,26
1657780911682,MATH 193A,A01,083224,Rotar; Vladimir,8,0,34,26
1657780911682,MATH 193A,A02,083225,Rotar; Vladimir,9,0,34,25
1657780911682,MATH 193A,A03,083781,Rotar; Vladimir,5,0,34,29
1657780911682,MATH 193A,A04,083782,Rotar; Vladimir,10,0,34,24
1657780911682,MATH 193A,A05,093482,Rotar; Vladimir,10,0,34,24
1657780917705,MATH 197,001,091859,McAuley; Julian John,9999,0,9999,0
1657780917705,MATH 197,002,095566,Kedlaya; Kiran S.,9997,0,9999,2
1657780917705,MATH 197,003,095567,Xiao; Ming,9999,0,9999,0
1657780917705,MATH 197,004,095571,Perols; Johan Lars,9998,0,9999,1
1657780924760,COGS 9,A01,083615,Shannon; Kyle Michael,9,0,75,66
1657780930783,COGS 11,A01,083617,Boyle; Mary E. T.,23,0,48,25
1657780936808,COGS 13,A01,083071,Bastos; Amalia Pinkusfeld,11,0,71,60
1657780942832,COGS 14A,A01,092681,Semenuks; Arturs,5,1,100,95
1657780948858,COGS 14B,A01,083073,Cheng; Tzu-Han,6,0,63,57
1657780954881,COGS 17,A01,092677,Semenuks; Arturs,6,0,81,75
1657780960903,COGS 100,A01,083619,Allen; Michael Gordon,17,0,70,53
1657780966926,COGS 101A,A01,083621,Davis; Joshua Daniel,9,0,68,59
1657780972953,COGS 101B,A01,091572,Allen; Michael Gordon,12,0,65,53
1657780978984,COGS 101C,A01,083625,Delgado; Tania,17,0,35,18
1657780985012,COGS 107A,A01,083627,Boyle; Mary E. T.,14,0,60,46
1657780991034,COGS 118A,A01,083075,Gupta; Anjum,21,0,76,55
1657780997062,CSE 3,A50,083646,Miranda; Gregory Joseph,24,0,50,26
1657781003087,CSE 8A,A50,083650,Miranda; Gregory Joseph,17,1,56,39
1657781009110,CSE 11,A01,083080,Cao; Yingjun,6,15,40,34
1657781015138,CSE 12,A01,083652,Krause-Levy; Sophia Louisa,28,1,120,92
1657781021166,CSE 15L,A01,083654,Morris; Justin Loren,9,0,50,41
1657781021166,CSE 15L,A02,083655,Morris; Justin Loren,9,0,50,41
1657781027188,CSE 20,A01,083657,Tran; Khoa Dang,39,0,80,41
1657781033216,CSE 21,A01,095574,Bach; Quang Tran,22,0,48,26
1657781039240,CSE 30,A01,083084,Eldon; John,6,0,80,74
1657781039240,CSE 30,B01,095061,Bhaskar; Nishant,9,0,50,41
1657781045262,CSE 100,A01,083659,Cao; Yingjun,5,4,70,65
1657781051285,CSE 134B,A01,083661,Powell; Thomas Allan,24,0,100,76
1657781057308,CSE 140,A01,083663,Gungor; Onat,15,0,85,70
1657781063336,CSE 140L,A01,083088,Eldon; John,23,0,100,77
1657781069359,CSE 175,A01,083665,Kumar; Rakesh,3,0,25,22
1657781075382,CSE 190,A00,092507,Dubnov; Shlomo,8,0,20,12
1657781081404,ECE 45,A01,083139,Congero; Spencer William,6,0,75,69
1657781087432,ECE 65,A50,083695,Saad; Andrew S,12,0,30,18
1657781087432,ECE 65,A51,095125,Saad; Andrew S,24,0,26,2
1657781093458,ECE 109,A01,091882,Touri; Behrouz,20,0,70,50
1657781099481,ECE 180,A00,083140,Abi Samra; Nicholas Camill,1,0,30,29
1657781099481,ECE 180,B00,083141,Abi Samra; Nicholas Camill,0,0,30,30
1657781105504,MATH 10A,A01,083735,Patchell; Gregory David,2,0,30,28
1657781105504,MATH 10A,A02,083736,Patchell; Gregory David,20,0,30,10
1657781105504,MATH 10A,A03,083737,Patchell; Gregory David,16,0,30,14
1657781111528,MATH 10B,A01,083207,Lim; Seonhee,8,0,34,26
1657781111528,MATH 10B,A02,083208,Lim; Seonhee,10,0,35,25
1657781111528,MATH 10B,A03,093472,Lim; Seonhee,7,0,34,27
1657781111528,MATH 10B,B01,083739,Sinha; Shubham,13,0,30,17
1657781117553,MATH 18,A01,083743,Cinel; Cameron Alexander,9,0,30,21
1657781117553,MATH 18,A02,083744,Cinel; Cameron Alexander,18,0,30,12
1657781117553,MATH 18,A03,083745,Cinel; Cameron Alexander,10,0,30,20
1657781117553,MATH 18,B01,083748,Rideout; David Porter,5,0,37,32
1657781117553,MATH 18,B02,083749,Rideout; David Porter,5,0,36,31
1657781117553,MATH 18,B03,083750,Rideout; David Porter,3,0,37,34
1657781117553,MATH 18,B04,083751,Rideout; David Porter,6,0,36,30
1657781117553,MATH 18,B05,093473,Rideout; David Porter,6,0,36,30
1657781117553,MATH 18,B06,093474,Rideout; David Porter,6,0,36,30
1657781123575,MATH 20A,A01,083754,Zheng; Zequn,14,0,40,26
1657781129599,MATH 20B,A01,083756,Briones; Jor-el Thomas Caparas,4,0,36,32
1657781129599,MATH 20B,A02,083757,Briones; Jor-el Thomas Caparas,1,0,36,35
1657781129599,MATH 20B,A03,093475,Briones; Jor-el Thomas Caparas,2,0,36,34
1657781135627,MATH 20C,A01,083760,Briones; Jor-el Thomas Caparas,1,0,35,34
1657781135627,MATH 20C,A02,083761,Briones; Jor-el Thomas Caparas,8,0,35,27
1657781135627,MATH 20C,A03,093476,Briones; Jor-el Thomas Caparas,0,1,36,36
1657781135627,MATH 20C,B01,083762,Bach; Quang Tran,1,0,30,29
1657781141652,MATH 20D,A01,083765,Tran; Brian Kha,5,0,30,25
1657781141652,MATH 20D,A02,083766,Tran; Brian Kha,5,0,30,25
1657781141652,MATH 20D,A03,083767,Tran; Brian Kha,5,0,30,25
1657781147683,MATH 20E,A01,083771,Ganguly; Soumya,10,0,32,22
1657781147683,MATH 20E,A02,083772,Ganguly; Soumya,6,0,32,26
1657781147683,MATH 20E,B01,083773,Ciotti; Benjamin,20,0,35,15
1657781147683,MATH 20E,B02,083774,Ciotti; Benjamin,18,0,35,17
1657781153707,MATH 103A,A01,083777,Greenfeld; Be'Eri,3,0,36,33
1657781153707,MATH 103A,A02,083778,Greenfeld; Be'Eri,5,0,36,31
1657781153707,MATH 103A,A03,093561,Greenfeld; Be'Eri,6,0,36,30
1657781153707,MATH 103A,B01,083779,Greenfeld; Be'Eri,7,0,36,29
1657781153707,MATH 103A,B02,083780,Greenfeld; Be'Eri,4,0,36,32
1657781153707,MATH 103A,B03,093562,Greenfeld; Be'Eri,3,0,36,33
1657781159731,MATH 105,A01,085443,Carter; Anne Toulson,15,0,35,20
1657781159731,MATH 105,A02,093477,Carter; Anne Toulson,20,0,35,15
1657781165760,MATH 109,A01,083213,Ganzberger; Geoffrey Michael,3,0,34,31
1657781165760,MATH 109,A02,083214,Ganzberger; Geoffrey Michael,4,0,34,30
1657781165760,MATH 109,A03,093478,Ganzberger; Geoffrey Michael,2,0,34,32
1657781165760,MATH 109,B01,083215,Ganzberger; Geoffrey Michael,1,0,32,31
1657781165760,MATH 109,B02,083216,Ganzberger; Geoffrey Michael,2,0,32,30
1657781165760,MATH 109,B03,093479,Ganzberger; Geoffrey Michael,8,0,32,24
1657781171788,MATH 142A,A01,083219,Chow; Bennett,7,0,32,25
1657781171788,MATH 142A,A02,083220,Chow; Bennett,10,0,32,22
1657781171788,MATH 142A,A03,093480,Chow; Bennett,9,0,32,23
1657781171788,MATH 142A,B03,093481,Chow; Bennett,8,0,32,24
1657781171788,MATH 142A,B04,093558,Chow; Bennett,13,0,32,19
1657781171788,MATH 142A,B05,093559,Chow; Bennett,6,0,32,26
1657781177815,MATH 193A,A01,083224,Rotar; Vladimir,8,0,34,26
1657781177815,MATH 193A,A02,083225,Rotar; Vladimir,9,0,34,25
1657781177815,MATH 193A,A03,083781,Rotar; Vladimir,5,0,34,29
1657781177815,MATH 193A,A04,083782,Rotar; Vladimir,10,0,34,24
1657781177815,MATH 193A,A05,093482,Rotar; Vladimir,10,0,34,24
1657781183843,MATH 197,001,091859,McAuley; Julian John,9999,0,9999,0
1657781183843,MATH 197,002,095566,Kedlaya; Kiran S.,9997,0,9999,2
1657781183843,MATH 197,003,095567,Xiao; Ming,9999,0,9999,0
1657781183843,MATH 197,004,095571,Perols; Johan Lars,9998,0,9999,1
1657781190905,COGS 9,A01,083615,Shannon; Kyle Michael,9,0,75,66
1657781196935,COGS 11,A01,083617,Boyle; Mary E. T.,23,0,48,25
1657781202962,COGS 13,A01,083071,Bastos; Amalia Pinkusfeld,11,0,71,60
1657781208986,COGS 14A,A01,092681,Semenuks; Arturs,5,1,100,95
1657781215009,COGS 14B,A01,083073,Cheng; Tzu-Han,6,0,63,57
1657781221033,COGS 17,A01,092677,Semenuks; Arturs,6,0,81,75
1657781227058,COGS 100,A01,083619,Allen; Michael Gordon,17,0,70,53
1657781233086,COGS 101A,A01,083621,Davis; Joshua Daniel,9,0,68,59
1657781239109,COGS 101B,A01,091572,Allen; Michael Gordon,12,0,65,53
1657781245135,COGS 101C,A01,083625,Delgado; Tania,17,0,35,18
1657781251158,COGS 107A,A01,083627,Boyle; Mary E. T.,14,0,60,46
1657781257182,COGS 118A,A01,083075,Gupta; Anjum,21,0,76,55
1657781263206,CSE 3,A50,083646,Miranda; Gregory Joseph,24,0,50,26
1657781269237,CSE 8A,A50,083650,Miranda; Gregory Joseph,17,1,56,39
1657781275260,CSE 11,A01,083080,Cao; Yingjun,6,15,40,34
1657781281284,CSE 12,A01,083652,Krause-Levy; Sophia Louisa,28,1,120,92
1657781287316,CSE 15L,A01,083654,Morris; Justin Loren,9,0,50,41
1657781287316,CSE 15L,A02,083655,Morris; Justin Loren,9,0,50,41
1657781293339,CSE 20,A01,083657,Tran; Khoa Dang,39,0,80,41
1657781299363,CSE 21,A01,095574,Bach; Quang Tran,22,0,48,26
1657781305404,CSE 30,A01,083084,Eldon; John,6,0,80,74
1657781305404,CSE 30,B01,095061,Bhaskar; Nishant,9,0,50,41
1657781311435,CSE 100,A01,083659,Cao; Yingjun,5,4,70,65
1657781317459,CSE 134B,A01,083661,Powell; Thomas Allan,24,0,100,76
1657781323482,CSE 140,A01,083663,Gungor; Onat,15,0,85,70
1657781329508,CSE 140L,A01,083088,Eldon; John,23,0,100,77
1657781335533,CSE 175,A01,083665,Kumar; Rakesh,3,0,25,22
1657781341555,CSE 190,A00,092507,Dubnov; Shlomo,8,0,20,12
1657781347580,ECE 45,A01,083139,Congero; Spencer William,6,0,75,69
1657781353604,ECE 65,A50,083695,Saad; Andrew S,12,0,30,18
1657781353604,ECE 65,A51,095125,Saad; Andrew S,24,0,26,2
1657781359631,ECE 109,A01,091882,Touri; Behrouz,20,0,70,50
1657781365653,ECE 180,A00,083140,Abi Samra; Nicholas Camill,1,0,30,29
1657781365653,ECE 180,B00,083141,Abi Samra; Nicholas Camill,0,0,30,30
1657781371693,MATH 10A,A01,083735,Patchell; Gregory David,2,0,30,28
1657781371693,MATH 10A,A02,083736,Patchell; Gregory David,20,0,30,10
1657781371693,MATH 10A,A03,083737,Patchell; Gregory David,16,0,30,14
1657781377722,MATH 10B,A01,083207,Lim; Seonhee,8,0,34,26
1657781377722,MATH 10B,A02,083208,Lim; Seonhee,10,0,35,25
1657781377722,MATH 10B,A03,093472,Lim; Seonhee,7,0,34,27
1657781377722,MATH 10B,B01,083739,Sinha; Shubham,13,0,30,17
1657781383753,MATH 18,A01,083743,Cinel; Cameron Alexander,9,0,30,21
1657781383753,MATH 18,A02,083744,Cinel; Cameron Alexander,18,0,30,12
1657781383753,MATH 18,A03,083745,Cinel; Cameron Alexander,10,0,30,20
1657781383753,MATH 18,B01,083748,Rideout; David Porter,5,0,37,32
1657781383753,MATH 18,B02,083749,Rideout; David Porter,5,0,36,31
1657781383753,MATH 18,B03,083750,Rideout; David Porter,3,0,37,34
1657781383753,MATH 18,B04,083751,Rideout; David Porter,6,0,36,30
1657781383753,MATH 18,B05,093473,Rideout; David Porter,6,0,36,30
1657781383753,MATH 18,B06,093474,Rideout; David Porter,6,0,36,30
1657781389777,MATH 20A,A01,083754,Zheng; Zequn,14,0,40,26
1657781395875,MATH 20B,A01,083756,Briones; Jor-el Thomas Caparas,4,0,36,32
1657781395875,MATH 20B,A02,083757,Briones; Jor-el Thomas Caparas,1,0,36,35
1657781395875,MATH 20B,A03,093475,Briones; Jor-el Thomas Caparas,2,0,36,34
1657781401901,MATH 20C,A01,083760,Briones; Jor-el Thomas Caparas,1,0,35,34
1657781401901,MATH 20C,A02,083761,Briones; Jor-el Thomas Caparas,8,0,35,27
1657781401901,MATH 20C,A03,093476,Briones; Jor-el Thomas Caparas,0,1,36,36
1657781401901,MATH 20C,B01,083762,Bach; Quang Tran,1,0,30,29
1657781407928,MATH 20D,A01,083765,Tran; Brian Kha,5,0,30,25
1657781407928,MATH 20D,A02,083766,Tran; Brian Kha,5,0,30,25
1657781407928,MATH 20D,A03,083767,Tran; Brian Kha,5,0,30,25
1657781413950,MATH 20E,A01,083771,Ganguly; Soumya,10,0,32,22
1657781413950,MATH 20E,A02,083772,Ganguly; Soumya,6,0,32,26
1657781413950,MATH 20E,B01,083773,Ciotti; Benjamin,20,0,35,15
1657781413950,MATH 20E,B02,083774,Ciotti; Benjamin,18,0,35,17
1657781419980,MATH 103A,A01,083777,Greenfeld; Be'Eri,3,0,36,33
1657781419980,MATH 103A,A02,083778,Greenfeld; Be'Eri,5,0,36,31
1657781419980,MATH 103A,A03,093561,Greenfeld; Be'Eri,6,0,36,30
1657781419980,MATH 103A,B01,083779,Greenfeld; Be'Eri,7,0,36,29
1657781419980,MATH 103A,B02,083780,Greenfeld; Be'Eri,4,0,36,32
1657781419980,MATH 103A,B03,093562,Greenfeld; Be'Eri,3,0,36,33
1657781426003,MATH 105,A01,085443,Carter; Anne Toulson,15,0,35,20
1657781426003,MATH 105,A02,093477,Carter; Anne Toulson,20,0,35,15
1657781432028,MATH 109,A01,083213,Ganzberger; Geoffrey Michael,3,0,34,31
1657781432028,MATH 109,A02,083214,Ganzberger; Geoffrey Michael,4,0,34,30
1657781432028,MATH 109,A03,093478,Ganzberger; Geoffrey Michael,2,0,34,32
1657781432028,MATH 109,B01,083215,Ganzberger; Geoffrey Michael,1,0,32,31
1657781432028,MATH 109,B02,083216,Ganzberger; Geoffrey Michael,2,0,32,30
1657781432028,MATH 109,B03,093479,Ganzberger; Geoffrey Michael,8,0,32,24
1657781438055,MATH 142A,A01,083219,Chow; Bennett,7,0,32,25
1657781438055,MATH 142A,A02,083220,Chow; Bennett,10,0,32,22
1657781438055,MATH 142A,A03,093480,Chow; Bennett,9,0,32,23
1657781438055,MATH 142A,B03,093481,Chow; Bennett,8,0,32,24
1657781438055,MATH 142A,B04,093558,Chow; Bennett,13,0,32,19
1657781438055,MATH 142A,B05,093559,Chow; Bennett,6,0,32,26
1657781444084,MATH 193A,A01,083224,Rotar; Vladimir,8,0,34,26
1657781444084,MATH 193A,A02,083225,Rotar; Vladimir,9,0,34,25
1657781444084,MATH 193A,A03,083781,Rotar; Vladimir,5,0,34,29
1657781444084,MATH 193A,A04,083782,Rotar; Vladimir,10,0,34,24
1657781444084,MATH 193A,A05,093482,Rotar; Vladimir,10,0,34,24
1657781450106,MATH 197,001,091859,McAuley; Julian John,9999,0,9999,0
1657781450106,MATH 197,002,095566,Kedlaya; Kiran S.,9997,0,9999,2
1657781450106,MATH 197,003,095567,Xiao; Ming,9999,0,9999,0
1657781450106,MATH 197,004,095571,Perols; Johan Lars,9998,0,9999,1
1657781457161,COGS 9,A01,083615,Shannon; Kyle Michael,9,0,75,66
1657781463189,COGS 11,A01,083617,Boyle; Mary E. T.,23,0,48,25
1657781469223,COGS 13,A01,083071,Bastos; Amalia Pinkusfeld,11,0,71,60
1657781475245,COGS 14A,A01,092681,Semenuks; Arturs,5,1,100,95
1657781481268,COGS 14B,A01,083073,Cheng; Tzu-Han,6,0,63,57
1657781487296,COGS 17,A01,092677,Semenuks; Arturs,6,0,81,75
1657781493321,COGS 100,A01,083619,Allen; Michael Gordon,17,0,70,53
1657781499349,COGS 101A,A01,083621,Davis; Joshua Daniel,9,0,68,59
1657781505372,COGS 101B,A01,091572,Allen; Michael Gordon,12,0,65,53
1657781511396,COGS 101C,A01,083625,Delgado; Tania,17,0,35,18
1657781517423,COGS 107A,A01,083627,Boyle; Mary E. T.,14,0,60,46
1657781523450,COGS 118A,A01,083075,Gupta; Anjum,21,0,76,55
1657781529479,CSE 3,A50,083646,Miranda; Gregory Joseph,24,0,50,26
1657781535503,CSE 8A,A50,083650,Miranda; Gregory Joseph,17,1,56,39
1657781541529,CSE 11,A01,083080,Cao; Yingjun,6,15,40,34
1657781547551,CSE 12,A01,083652,Krause-Levy; Sophia Louisa,28,1,120,92
1657781553573,CSE 15L,A01,083654,Morris; Justin Loren,9,0,50,41
1657781553573,CSE 15L,A02,083655,Morris; Justin Loren,9,0,50,41
1657781559601,CSE 20,A01,083657,Tran; Khoa Dang,39,0,80,41
1657781565630,CSE 21,A01,095574,Bach; Quang Tran,22,0,48,26
1657781571655,CSE 30,A01,083084,Eldon; John,6,0,80,74
1657781571655,CSE 30,B01,095061,Bhaskar; Nishant,9,0,50,41
1657781577681,CSE 100,A01,083659,Cao; Yingjun,5,4,70,65
1657781583708,CSE 134B,A01,083661,Powell; Thomas Allan,24,0,100,76
1657781589731,CSE 140,A01,083663,Gungor; Onat,15,0,85,70
1657781595756,CSE 140L,A01,083088,Eldon; John,23,0,100,77
1657781601778,CSE 175,A01,083665,Kumar; Rakesh,3,0,25,22
1657781607806,CSE 190,A00,092507,Dubnov; Shlomo,8,0,20,12
1657781613829,ECE 45,A01,083139,Congero; Spencer William,6,0,75,69
1657781619858,ECE 65,A50,083695,Saad; Andrew S,12,0,30,18
1657781619858,ECE 65,A51,095125,Saad; Andrew S,24,0,26,2
1657781625882,ECE 109,A01,091882,Touri; Behrouz,20,0,70,50
1657781631905,ECE 180,A00,083140,Abi Samra; Nicholas Camill,1,0,30,29
1657781631905,ECE 180,B00,083141,Abi Samra; Nicholas Camill,0,0,30,30
1657781637929,MATH 10A,A01,083735,Patchell; Gregory David,2,0,30,28
1657781637929,MATH 10A,A02,083736,Patchell; Gregory David,20,0,30,10
1657781637929,MATH 10A,A03,083737,Patchell; Gregory David,16,0,30,14
1657781643954,MATH 10B,A01,083207,Lim; Seonhee,8,0,34,26
1657781643954,MATH 10B,A02,083208,Lim; Seonhee,10,0,35,25
1657781643954,MATH 10B,A03,093472,Lim; Seonhee,7,0,34,27
1657781643954,MATH 10B,B01,083739,Sinha; Shubham,13,0,30,17
1657781649984,MATH 18,A01,083743,Cinel; Cameron Alexander,9,0,30,21
1657781649984,MATH 18,A02,083744,Cinel; Cameron Alexander,18,0,30,12
1657781649984,MATH 18,A03,083745,Cinel; Cameron Alexander,10,0,30,20
1657781649984,MATH 18,B01,083748,Rideout; David Porter,5,0,37,32
1657781649984,MATH 18,B02,083749,Rideout; David Porter,5,0,36,31
1657781649984,MATH 18,B03,083750,Rideout; David Porter,3,0,37,34
1657781649984,MATH 18,B04,083751,Rideout; David Porter,6,0,36,30
1657781649984,MATH 18,B05,093473,Rideout; David Porter,6,0,36,30
1657781649984,MATH 18,B06,093474,Rideout; David Porter,6,0,36,30
1657781656010,MATH 20A,A01,083754,Zheng; Zequn,14,0,40,26
1657781662032,MATH 20B,A01,083756,Briones; Jor-el Thomas Caparas,4,0,36,32
1657781662032,MATH 20B,A02,083757,Briones; Jor-el Thomas Caparas,1,0,36,35
1657781662032,MATH 20B,A03,093475,Briones; Jor-el Thomas Caparas,2,0,36,34
1657781668061,MATH 20C,A01,083760,Briones; Jor-el Thomas Caparas,1,0,35,34
1657781668061,MATH 20C,A02,083761,Briones; Jor-el Thomas Caparas,8,0,35,27
1657781668061,MATH 20C,A03,093476,Briones; Jor-el Thomas Caparas,0,1,36,36
1657781668061,MATH 20C,B01,083762,Bach; Quang Tran,1,0,30,29
1657781674087,MATH 20D,A01,083765,Tran; Brian Kha,5,0,30,25
1657781674087,MATH 20D,A02,083766,Tran; Brian Kha,5,0,30,25
1657781674087,MATH 20D,A03,083767,Tran; Brian Kha,5,0,30,25
1657781680116,MATH 20E,A01,083771,Ganguly; Soumya,10,0,32,22
1657781680116,MATH 20E,A02,083772,Ganguly; Soumya,6,0,32,26
1657781680116,MATH 20E,B01,083773,Ciotti; Benjamin,20,0,35,15
1657781680116,MATH 20E,B02,083774,Ciotti; Benjamin,18,0,35,17
1657781686145,MATH 103A,A01,083777,Greenfeld; Be'Eri,3,0,36,33
1657781686145,MATH 103A,A02,083778,Greenfeld; Be'Eri,5,0,36,31
1657781686145,MATH 103A,A03,093561,Greenfeld; Be'Eri,6,0,36,30
1657781686145,MATH 103A,B01,083779,Greenfeld; Be'Eri,7,0,36,29
1657781686145,MATH 103A,B02,083780,Greenfeld; Be'Eri,4,0,36,32
1657781686145,MATH 103A,B03,093562,Greenfeld; Be'Eri,3,0,36,33
1657781692171,MATH 105,A01,085443,Carter; Anne Toulson,15,0,35,20
1657781692171,MATH 105,A02,093477,Carter; Anne Toulson,20,0,35,15
1657781698194,MATH 109,A01,083213,Ganzberger; Geoffrey Michael,3,0,34,31
1657781698194,MATH 109,A02,083214,Ganzberger; Geoffrey Michael,4,0,34,30
1657781698194,MATH 109,A03,093478,Ganzberger; Geoffrey Michael,2,0,34,32
1657781698194,MATH 109,B01,083215,Ganzberger; Geoffrey Michael,1,0,32,31
1657781698194,MATH 109,B02,083216,Ganzberger; Geoffrey Michael,2,0,32,30
1657781698194,MATH 109,B03,093479,Ganzberger; Geoffrey Michael,8,0,32,24
1657781704217,MATH 142A,A01,083219,Chow; Bennett,7,0,32,25
1657781704217,MATH 142A,A02,083220,Chow; Bennett,10,0,32,22
1657781704217,MATH 142A,A03,093480,Chow; Bennett,9,0,32,23
1657781704217,MATH 142A,B03,093481,Chow; Bennett,8,0,32,24
1657781704217,MATH 142A,B04,093558,Chow; Bennett,13,0,32,19
1657781704217,MATH 142A,B05,093559,Chow; Bennett,6,0,32,26
1657781710242,MATH 193A,A01,083224,Rotar; Vladimir,8,0,34,26
1657781710242,MATH 193A,A02,083225,Rotar; Vladimir,9,0,34,25
1657781710242,MATH 193A,A03,083781,Rotar; Vladimir,5,0,34,29
1657781710242,MATH 193A,A04,083782,Rotar; Vladimir,10,0,34,24
1657781710242,MATH 193A,A05,093482,Rotar; Vladimir,10,0,34,24
1657781716265,MATH 197,001,091859,McAuley; Julian John,9999,0,9999,0
1657781716265,MATH 197,002,095566,Kedlaya; Kiran S.,9997,0,9999,2
1657781716265,MATH 197,003,095567,Xiao; Ming,9999,0,9999,0
1657781716265,MATH 197,004,095571,Perols; Johan Lars,9998,0,9999,1
1657781723327,COGS 9,A01,083615,Shannon; Kyle Michael,9,0,75,66
1657781729350,COGS 11,A01,083617,Boyle; Mary E. T.,23,0,48,25
1657781735376,COGS 13,A01,083071,Bastos; Amalia Pinkusfeld,11,0,71,60
1657781741401,COGS 14A,A01,092681,Semenuks; Arturs,5,1,100,95
1657781747427,COGS 14B,A01,083073,Cheng; Tzu-Han,6,0,63,57
1657781753451,COGS 17,A01,092677,Semenuks; Arturs,6,0,81,75
1657781759488,COGS 100,A01,083619,Allen; Michael Gordon,17,0,70,53
1657781765510,COGS 101A,A01,083621,Davis; Joshua Daniel,9,0,68,59
1657781771537,COGS 101B,A01,091572,Allen; Michael Gordon,12,0,65,53
1657781777561,COGS 101C,A01,083625,Delgado; Tania,17,0,35,18
1657781783585,COGS 107A,A01,083627,Boyle; Mary E. T.,14,0,60,46
1657781789607,COGS 118A,A01,083075,Gupta; Anjum,21,0,76,55
1657781795632,CSE 3,A50,083646,Miranda; Gregory Joseph,24,0,50,26
1657781801660,CSE 8A,A50,083650,Miranda; Gregory Joseph,17,1,56,39
1657781807687,CSE 11,A01,083080,Cao; Yingjun,6,15,40,34
1657781813712,CSE 12,A01,083652,Krause-Levy; Sophia Louisa,28,1,120,92
1657781819735,CSE 15L,A01,083654,Morris; Justin Loren,9,0,50,41
1657781819735,CSE 15L,A02,083655,Morris; Justin Loren,9,0,50,41
1657781825763,CSE 20,A01,083657,Tran; Khoa Dang,39,0,80,41
1657781831790,CSE 21,A01,095574,Bach; Quang Tran,22,0,48,26
1657781837815,CSE 30,A01,083084,Eldon; John,6,0,80,74
1657781837815,CSE 30,B01,095061,Bhaskar; Nishant,9,0,50,41
1657781843837,CSE 100,A01,083659,Cao; Yingjun,5,4,70,65
1657781849865,CSE 134B,A01,083661,Powell; Thomas Allan,24,0,100,76
1657781855891,CSE 140,A01,083663,Gungor; Onat,15,0,85,70
1657781861917,CSE 140L,A01,083088,Eldon; John,23,0,100,77
1657781867940,CSE 175,A01,083665,Kumar; Rakesh,3,0,25,22
1657781873964,CSE 190,A00,092507,Dubnov; Shlomo,8,0,20,12
1657781879993,ECE 45,A01,083139,Congero; Spencer William,6,0,75,69
1657781886017,ECE 65,A50,083695,Saad; Andrew S,12,0,30,18
1657781886017,ECE 65,A51,095125,Saad; Andrew S,24,0,26,2
1657781892042,ECE 109,A01,091882,Touri; Behrouz,20,0,70,50
1657781898070,ECE 180,A00,083140,Abi Samra; Nicholas Camill,1,0,30,29
1657781898070,ECE 180,B00,083141,Abi Samra; Nicholas Camill,0,0,30,30
1657781904094,MATH 10A,A01,083735,Patchell; Gregory David,2,0,30,28
1657781904094,MATH 10A,A02,083736,Patchell; Gregory David,20,0,30,10
1657781904094,MATH 10A,A03,083737,Patchell; Gregory David,16,0,30,14
1657781910128,MATH 10B,A01,083207,Lim; Seonhee,8,0,34,26
1657781910128,MATH 10B,A02,083208,Lim; Seonhee,10,0,35,25
1657781910128,MATH 10B,A03,093472,Lim; Seonhee,7,0,34,27
1657781910128,MATH 10B,B01,083739,Sinha; Shubham,13,0,30,17
1657781916157,MATH 18,A01,083743,Cinel; Cameron Alexander,9,0,30,21
1657781916157,MATH 18,A02,083744,Cinel; Cameron Alexander,18,0,30,12
1657781916157,MATH 18,A03,083745,Cinel; Cameron Alexander,10,0,30,20
1657781916157,MATH 18,B01,083748,Rideout; David Porter,5,0,37,32
1657781916157,MATH 18,B02,083749,Rideout; David Porter,5,0,36,31
1657781916157,MATH 18,B03,083750,Rideout; David Porter,3,0,37,34
1657781916157,MATH 18,B04,083751,Rideout; David Porter,6,0,36,30
1657781916157,MATH 18,B05,093473,Rideout; David Porter,6,0,36,30
1657781916157,MATH 18,B06,093474,Rideout; David Porter,6,0,36,30
1657781922185,MATH 20A,A01,083754,Zheng; Zequn,14,0,40,26
1657781928212,MATH 20B,A01,083756,Briones; Jor-el Thomas Caparas,4,0,36,32
1657781928212,MATH 20B,A02,083757,Briones; Jor-el Thomas Caparas,1,0,36,35
1657781928212,MATH 20B,A03,093475,Briones; Jor-el Thomas Caparas,2,0,36,34
1657781934246,MATH 20C,A01,083760,Briones; Jor-el Thomas Caparas,1,0,35,34
1657781934246,MATH 20C,A02,083761,Briones; Jor-el Thomas Caparas,8,0,35,27
1657781934246,MATH 20C,A03,093476,Briones; Jor-el Thomas Caparas,0,1,36,36
1657781934246,MATH 20C,B01,083762,Bach; Quang Tran,1,0,30,29
1657781940275,MATH 20D,A01,083765,Tran; Brian Kha,5,0,30,25
1657781940275,MATH 20D,A02,083766,Tran; Brian Kha,5,0,30,25
1657781940275,MATH 20D,A03,083767,Tran; Brian Kha,5,0,30,25
1657781946301,MATH 20E,A01,083771,Ganguly; Soumya,10,0,32,22
1657781946301,MATH 20E,A02,083772,Ganguly; Soumya,6,0,32,26
1657781946301,MATH 20E,B01,083773,Ciotti; Benjamin,20,0,35,15
1657781946301,MATH 20E,B02,083774,Ciotti; Benjamin,18,0,35,17
1657781952332,MATH 103A,A01,083777,Greenfeld; Be'Eri,3,0,36,33
1657781952332,MATH 103A,A02,083778,Greenfeld; Be'Eri,5,0,36,31
1657781952332,MATH 103A,A03,093561,Greenfeld; Be'Eri,6,0,36,30
1657781952332,MATH 103A,B01,083779,Greenfeld; Be'Eri,7,0,36,29
1657781952332,MATH 103A,B02,083780,Greenfeld; Be'Eri,4,0,36,32
1657781952332,MATH 103A,B03,093562,Greenfeld; Be'Eri,3,0,36,33
1657781958359,MATH 105,A01,085443,Carter; Anne Toulson,15,0,35,20
1657781958359,MATH 105,A02,093477,Carter; Anne Toulson,20,0,35,15
1657781964382,MATH 109,A01,083213,Ganzberger; Geoffrey Michael,3,0,34,31
1657781964382,MATH 109,A02,083214,Ganzberger; Geoffrey Michael,4,0,34,30
1657781964382,MATH 109,A03,093478,Ganzberger; Geoffrey Michael,2,0,34,32
1657781964382,MATH 109,B01,083215,Ganzberger; Geoffrey Michael,1,0,32,31
1657781964382,MATH 109,B02,083216,Ganzberger; Geoffrey Michael,2,0,32,30
1657781964382,MATH 109,B03,093479,Ganzberger; Geoffrey Michael,8,0,32,24
1657781970411,MATH 142A,A01,083219,Chow; Bennett,7,0,32,25
1657781970411,MATH 142A,A02,083220,Chow; Bennett,10,0,32,22
1657781970411,MATH 142A,A03,093480,Chow; Bennett,9,0,32,23
1657781970411,MATH 142A,B03,093481,Chow; Bennett,8,0,32,24
1657781970411,MATH 142A,B04,093558,Chow; Bennett,13,0,32,19
1657781970411,MATH 142A,B05,093559,Chow; Bennett,6,0,32,26
1657781976641,MATH 193A,A01,083224,Rotar; Vladimir,8,0,34,26
1657781976641,MATH 193A,A02,083225,Rotar; Vladimir,9,0,34,25
1657781976641,MATH 193A,A03,083781,Rotar; Vladimir,5,0,34,29
1657781976641,MATH 193A,A04,083782,Rotar; Vladimir,10,0,34,24
1657781976641,MATH 193A,A05,093482,Rotar; Vladimir,10,0,34,24
1657781982667,MATH 197,001,091859,McAuley; Julian John,9999,0,9999,0
1657781982667,MATH 197,002,095566,Kedlaya; Kiran S.,9997,0,9999,2
1657781982667,MATH 197,003,095567,Xiao; Ming,9999,0,9999,0
1657781982667,MATH 197,004,095571,Perols; Johan Lars,9998,0,9999,1
1657781989820,COGS 9,A01,083615,Shannon; Kyle Michael,9,0,75,66
1657781995842,COGS 11,A01,083617,Boyle; Mary E. T.,23,0,48,25
1657782001867,COGS 13,A01,083071,Bastos; Amalia Pinkusfeld,11,0,71,60
1657782007893,COGS 14A,A01,092681,Semenuks; Arturs,5,1,100,95
1657782013916,COGS 14B,A01,083073,Cheng; Tzu-Han,6,0,63,57
1657782019944,COGS 17,A01,092677,Semenuks; Arturs,6,0,81,75
1657782025967,COGS 100,A01,083619,Allen; Michael Gordon,17,0,70,53
1657782031993,COGS 101A,A01,083621,Davis; Joshua Daniel,9,0,68,59
1657782038015,COGS 101B,A01,091572,Allen; Michael Gordon,12,0,65,53
1657782044039,COGS 101C,A01,083625,Delgado; Tania,17,0,35,18
1657782050064,COGS 107A,A01,083627,Boyle; Mary E. T.,14,0,60,46
1657782056088,COGS 118A,A01,083075,Gupta; Anjum,21,0,76,55
1657782062166,CSE 3,A50,083646,Miranda; Gregory Joseph,24,0,50,26
1657782068190,CSE 8A,A50,083650,Miranda; Gregory Joseph,17,1,56,39
1657782074224,CSE 11,A01,083080,Cao; Yingjun,6,15,40,34
1657782080254,CSE 12,A01,083652,Krause-Levy; Sophia Louisa,28,1,120,92
1657782086277,CSE 15L,A01,083654,Morris; Justin Loren,9,0,50,41
1657782086277,CSE 15L,A02,083655,Morris; Justin Loren,9,0,50,41
1657782092300,CSE 20,A01,083657,Tran; Khoa Dang,39,0,80,41
1657782098324,CSE 21,A01,095574,Bach; Quang Tran,22,0,48,26
1657782104357,CSE 30,A01,083084,Eldon; John,6,0,80,74
1657782104357,CSE 30,B01,095061,Bhaskar; Nishant,9,0,50,41
1657782110382,CSE 100,A01,083659,Cao; Yingjun,5,4,70,65
1657782116405,CSE 134B,A01,083661,Powell; Thomas Allan,24,0,100,76
1657782122437,CSE 140,A01,083663,Gungor; Onat,15,0,85,70
1657782128460,CSE 140L,A01,083088,Eldon; John,23,0,100,77
1657782134484,CSE 175,A01,083665,Kumar; Rakesh,3,0,25,22
1657782140507,CSE 190,A00,092507,Dubnov; Shlomo,8,0,20,12
1657782146530,ECE 45,A01,083139,Congero; Spencer William,6,0,75,69
1657782152560,ECE 65,A50,083695,Saad; Andrew S,12,0,30,18
1657782152560,ECE 65,A51,095125,Saad; Andrew S,24,0,26,2
1657782158588,ECE 109,A01,091882,Touri; Behrouz,20,0,70,50
1657782164612,ECE 180,A00,083140,Abi Samra; Nicholas Camill,1,0,30,29
1657782164612,ECE 180,B00,083141,Abi Samra; Nicholas Camill,0,0,30,30
1657782170636,MATH 10A,A01,083735,Patchell; Gregory David,2,0,30,28
1657782170636,MATH 10A,A02,083736,Patchell; Gregory David,20,0,30,10
1657782170636,MATH 10A,A03,083737,Patchell; Gregory David,16,0,30,14
1657782176659,MATH 10B,A01,083207,Lim; Seonhee,8,0,34,26
1657782176659,MATH 10B,A02,083208,Lim; Seonhee,10,0,35,25
1657782176659,MATH 10B,A03,093472,Lim; Seonhee,7,0,34,27
1657782176659,MATH 10B,B01,083739,Sinha; Shubham,13,0,30,17
1657782182689,MATH 18,A01,083743,Cinel; Cameron Alexander,9,0,30,21
1657782182689,MATH 18,A02,083744,Cinel; Cameron Alexander,18,0,30,12
1657782182689,MATH 18,A03,083745,Cinel; Cameron Alexander,10,0,30,20
1657782182689,MATH 18,B01,083748,Rideout; David Porter,5,0,37,32
1657782182689,MATH 18,B02,083749,Rideout; David Porter,5,0,36,31
1657782182689,MATH 18,B03,083750,Rideout; David Porter,3,0,37,34
1657782182689,MATH 18,B04,083751,Rideout; David Porter,6,0,36,30
1657782182689,MATH 18,B05,093473,Rideout; David Porter,6,0,36,30
1657782182689,MATH 18,B06,093474,Rideout; David Porter,6,0,36,30
1657782188713,MATH 20A,A01,083754,Zheng; Zequn,14,0,40,26
1657782194737,MATH 20B,A01,083756,Briones; Jor-el Thomas Caparas,4,0,36,32
1657782194737,MATH 20B,A02,083757,Briones; Jor-el Thomas Caparas,1,0,36,35
1657782194737,MATH 20B,A03,093475,Briones; Jor-el Thomas Caparas,2,0,36,34
1657782200760,MATH 20C,A01,083760,Briones; Jor-el Thomas Caparas,1,0,35,34
1657782200760,MATH 20C,A02,083761,Briones; Jor-el Thomas Caparas,8,0,35,27
1657782200760,MATH 20C,A03,093476,Briones; Jor-el Thomas Caparas,0,1,36,36
1657782200760,MATH 20C,B01,083762,Bach; Quang Tran,1,0,30,29
1657782206784,MATH 20D,A01,083765,Tran; Brian Kha,5,0,30,25
1657782206784,MATH 20D,A02,083766,Tran; Brian Kha,5,0,30,25
1657782206784,MATH 20D,A03,083767,Tran; Brian Kha,5,0,30,25
1657782212810,MATH 20E,A01,083771,Ganguly; Soumya,10,0,32,22
1657782212810,MATH 20E,A02,083772,Ganguly; Soumya,6,0,32,26
1657782212810,MATH 20E,B01,083773,Ciotti; Benjamin,20,0,35,15
1657782212810,MATH 20E,B02,083774,Ciotti; Benjamin,18,0,35,17
1657782218840,MATH 103A,A01,083777,Greenfeld; Be'Eri,3,0,36,33
1657782218840,MATH 103A,A02,083778,Greenfeld; Be'Eri,5,0,36,31
1657782218840,MATH 103A,A03,093561,Greenfeld; Be'Eri,6,0,36,30
1657782218840,MATH 103A,B01,083779,Greenfeld; Be'Eri,7,0,36,29
1657782218840,MATH 103A,B02,083780,Greenfeld; Be'Eri,4,0,36,32
1657782218840,MATH 103A,B03,093562,Greenfeld; Be'Eri,3,0,36,33
1657782224869,MATH 105,A01,085443,Carter; Anne Toulson,15,0,35,20
1657782224869,MATH 105,A02,093477,Carter; Anne Toulson,20,0,35,15
1657782230894,MATH 109,A01,083213,Ganzberger; Geoffrey Michael,3,0,34,31
1657782230894,MATH 109,A02,083214,Ganzberger; Geoffrey Michael,4,0,34,30
1657782230894,MATH 109,A03,093478,Ganzberger; Geoffrey Michael,2,0,34,32
1657782230894,MATH 109,B01,083215,Ganzberger; Geoffrey Michael,1,0,32,31
1657782230894,MATH 109,B02,083216,Ganzberger; Geoffrey Michael,2,0,32,30
1657782230894,MATH 109,B03,093479,Ganzberger; Geoffrey Michael,8,0,32,24
1657782236925,MATH 142A,A01,083219,Chow; Bennett,7,0,32,25
1657782236925,MATH 142A,A02,083220,Chow; Bennett,10,0,32,22
1657782236925,MATH 142A,A03,093480,Chow; Bennett,9,0,32,23
1657782236925,MATH 142A,B03,093481,Chow; Bennett,8,0,32,24
1657782236925,MATH 142A,B04,093558,Chow; Bennett,13,0,32,19
1657782236925,MATH 142A,B05,093559,Chow; Bennett,6,0,32,26
1657782242954,MATH 193A,A01,083224,Rotar; Vladimir,8,0,34,26
1657782242954,MATH 193A,A02,083225,Rotar; Vladimir,9,0,34,25
1657782242954,MATH 193A,A03,083781,Rotar; Vladimir,5,0,34,29
1657782242954,MATH 193A,A04,083782,Rotar; Vladimir,10,0,34,24
1657782242954,MATH 193A,A05,093482,Rotar; Vladimir,10,0,34,24
1657782248981,MATH 197,001,091859,McAuley; Julian John,9999,0,9999,0
1657782248981,MATH 197,002,095566,Kedlaya; Kiran S.,9997,0,9999,2
1657782248981,MATH 197,003,095567,Xiao; Ming,9999,0,9999,0
1657782248981,MATH 197,004,095571,Perols; Johan Lars,9998,0,9999,1
1657782256047,COGS 9,A01,083615,Shannon; Kyle Michael,9,0,75,66
1657782262074,COGS 11,A01,083617,Boyle; Mary E. T.,23,0,48,25
1657782268097,COGS 13,A01,083071,Bastos; Amalia Pinkusfeld,11,0,71,60
1657782274120,COGS 14A,A01,092681,Semenuks; Arturs,5,1,100,95
1657782280146,COGS 14B,A01,083073,Cheng; Tzu-Han,6,0,63,57
1657782286169,COGS 17,A01,092677,Semenuks; Arturs,6,0,81,75
1657782292197,COGS 100,A01,083619,Allen; Michael Gordon,17,0,70,53
1657782298226,COGS 101A,A01,083621,Davis; Joshua Daniel,9,0,68,59
1657782304251,COGS 101B,A01,091572,Allen; Michael Gordon,12,0,65,53
1657782310279,COGS 101C,A01,083625,Delgado; Tania,17,0,35,18
1657782316301,COGS 107A,A01,083627,Boyle; Mary E. T.,14,0,60,46
1657782322329,COGS 118A,A01,083075,Gupta; Anjum,21,0,76,55
1657782328356,CSE 3,A50,083646,Miranda; Gregory Joseph,24,0,50,26
1657782334380,CSE 8A,A50,083650,Miranda; Gregory Joseph,17,1,56,39
1657782340409,CSE 11,A01,083080,Cao; Yingjun,6,15,40,34
1657782346435,CSE 12,A01,083652,Krause-Levy; Sophia Louisa,28,1,120,92
1657782352462,CSE 15L,A01,083654,Morris; Justin Loren,9,0,50,41
1657782352462,CSE 15L,A02,083655,Morris; Justin Loren,9,0,50,41
1657782358488,CSE 20,A01,083657,Tran; Khoa Dang,39,0,80,41
1657782364514,CSE 21,A01,095574,Bach; Quang Tran,22,0,48,26
1657782370537,CSE 30,A01,083084,Eldon; John,6,0,80,74
1657782370537,CSE 30,B01,095061,Bhaskar; Nishant,9,0,50,41
1657782376559,CSE 100,A01,083659,Cao; Yingjun,5,4,70,65
1657782382582,CSE 134B,A01,083661,Powell; Thomas Allan,24,0,100,76
1657782388610,CSE 140,A01,083663,Gungor; Onat,15,0,85,70
1657782394638,CSE 140L,A01,083088,Eldon; John,23,0,100,77
1657782400667,CSE 175,A01,083665,Kumar; Rakesh,3,0,25,22
1657782406692,CSE 190,A00,092507,Dubnov; Shlomo,8,0,20,12
1657782412723,ECE 45,A01,083139,Congero; Spencer William,6,0,75,69
1657782418749,ECE 65,A50,083695,Saad; Andrew S,12,0,30,18
1657782418749,ECE 65,A51,095125,Saad; Andrew S,24,0,26,2
1657782424776,ECE 109,A01,091882,Touri; Behrouz,20,0,70,50
1657782430797,ECE 180,A00,083140,Abi Samra; Nicholas Camill,1,0,30,29
1657782430797,ECE 180,B00,083141,Abi Samra; Nicholas Camill,0,0,30,30
1657782436820,MATH 10A,A01,083735,Patchell; Gregory David,2,0,30,28
1657782436820,MATH 10A,A02,083736,Patchell; Gregory David,20,0,30,10
1657782436820,MATH 10A,A03,083737,Patchell; Gregory David,16,0,30,14
1657782442844,MATH 10B,A01,083207,Lim; Seonhee,8,0,34,26
1657782442844,MATH 10B,A02,083208,Lim; Seonhee,10,0,35,25
1657782442844,MATH 10B,A03,093472,Lim; Seonhee,7,0,34,27
1657782442844,MATH 10B,B01,083739,Sinha; Shubham,13,0,30,17
1657782448870,MATH 18,A01,083743,Cinel; Cameron Alexander,9,0,30,21
1657782448870,MATH 18,A02,083744,Cinel; Cameron Alexander,18,0,30,12
1657782448870,MATH 18,A03,083745,Cinel; Cameron Alexander,10,0,30,20
1657782448870,MATH 18,B01,083748,Rideout; David Porter,5,0,37,32
1657782448870,MATH 18,B02,083749,Rideout; David Porter,5,0,36,31
1657782448870,MATH 18,B03,083750,Rideout; David Porter,3,0,37,34
1657782448870,MATH 18,B04,083751,Rideout; David Porter,6,0,36,30
1657782448870,MATH 18,B05,093473,Rideout; David Porter,6,0,36,30
1657782448870,MATH 18,B06,093474,Rideout; David Porter,6,0,36,30
1657782454892,MATH 20A,A01,083754,Zheng; Zequn,14,0,40,26
1657782460917,MATH 20B,A01,083756,Briones; Jor-el Thomas Caparas,4,0,36,32
1657782460917,MATH 20B,A02,083757,Briones; Jor-el Thomas Caparas,1,0,36,35
1657782460917,MATH 20B,A03,093475,Briones; Jor-el Thomas Caparas,2,0,36,34
1657782466949,MATH 20C,A01,083760,Briones; Jor-el Thomas Caparas,1,0,35,34
1657782466949,MATH 20C,A02,083761,Briones; Jor-el Thomas Caparas,8,0,35,27
1657782466949,MATH 20C,A03,093476,Briones; Jor-el Thomas Caparas,0,1,36,36
1657782466949,MATH 20C,B01,083762,Bach; Quang Tran,1,0,30,29
1657782472972,MATH 20D,A01,083765,Tran; Brian Kha,5,0,30,25
1657782472972,MATH 20D,A02,083766,Tran; Brian Kha,5,0,30,25
1657782472972,MATH 20D,A03,083767,Tran; Brian Kha,5,0,30,25
1657782478999,MATH 20E,A01,083771,Ganguly; Soumya,10,0,32,22
1657782478999,MATH 20E,A02,083772,Ganguly; Soumya,6,0,32,26
1657782478999,MATH 20E,B01,083773,Ciotti; Benjamin,20,0,35,15
1657782478999,MATH 20E,B02,083774,Ciotti; Benjamin,18,0,35,17
1657782485021,MATH 103A,A01,083777,Greenfeld; Be'Eri,3,0,36,33
1657782485021,MATH 103A,A02,083778,Greenfeld; Be'Eri,5,0,36,31
1657782485021,MATH 103A,A03,093561,Greenfeld; Be'Eri,6,0,36,30
1657782485021,MATH 103A,B01,083779,Greenfeld; Be'Eri,7,0,36,29
1657782485021,MATH 103A,B02,083780,Greenfeld; Be'Eri,4,0,36,32
1657782485021,MATH 103A,B03,093562,Greenfeld; Be'Eri,3,0,36,33
1657782491045,MATH 105,A01,085443,Carter; Anne Toulson,15,0,35,20
1657782491045,MATH 105,A02,093477,Carter; Anne Toulson,20,0,35,15
1657782497076,MATH 109,A01,083213,Ganzberger; Geoffrey Michael,3,0,34,31
1657782497076,MATH 109,A02,083214,Ganzberger; Geoffrey Michael,4,0,34,30
1657782497076,MATH 109,A03,093478,Ganzberger; Geoffrey Michael,2,0,34,32
1657782497076,MATH 109,B01,083215,Ganzberger; Geoffrey Michael,1,0,32,31
1657782497076,MATH 109,B02,083216,Ganzberger; Geoffrey Michael,2,0,32,30
1657782497076,MATH 109,B03,093479,Ganzberger; Geoffrey Michael,8,0,32,24
1657782503106,MATH 142A,A01,083219,Chow; Bennett,7,0,32,25
1657782503106,MATH 142A,A02,083220,Chow; Bennett,10,0,32,22
1657782503106,MATH 142A,A03,093480,Chow; Bennett,9,0,32,23
1657782503106,MATH 142A,B03,093481,Chow; Bennett,8,0,32,24
1657782503106,MATH 142A,B04,093558,Chow; Bennett,13,0,32,19
1657782503106,MATH 142A,B05,093559,Chow; Bennett,6,0,32,26
1657782509136,MATH 193A,A01,083224,Rotar; Vladimir,8,0,34,26
1657782509136,MATH 193A,A02,083225,Rotar; Vladimir,9,0,34,25
1657782509136,MATH 193A,A03,083781,Rotar; Vladimir,5,0,34,29
1657782509136,MATH 193A,A04,083782,Rotar; Vladimir,10,0,34,24
1657782509136,MATH 193A,A05,093482,Rotar; Vladimir,10,0,34,24
1657782515158,MATH 197,001,091859,McAuley; Julian John,9999,0,9999,0
1657782515158,MATH 197,002,095566,Kedlaya; Kiran S.,9997,0,9999,2
1657782515158,MATH 197,003,095567,Xiao; Ming,9999,0,9999,0
1657782515158,MATH 197,004,095571,Perols; Johan Lars,9998,0,9999,1
1657782522222,COGS 9,A01,083615,Shannon; Kyle Michael,9,0,75,66
1657782528252,COGS 11,A01,083617,Boyle; Mary E. T.,23,0,48,25
1657782534276,COGS 13,A01,083071,Bastos; Amalia Pinkusfeld,11,0,71,60
1657782540300,COGS 14A,A01,092681,Semenuks; Arturs,5,1,100,95
1657782546336,COGS 14B,A01,083073,Cheng; Tzu-Han,6,0,63,57
1657782552363,COGS 17,A01,092677,Semenuks; Arturs,6,0,81,75
1657782558399,COGS 100,A01,083619,Allen; Michael Gordon,17,0,70,53
1657782564428,COGS 101A,A01,083621,Davis; Joshua Daniel,9,0,68,59
1657782570453,COGS 101B,A01,091572,Allen; Michael Gordon,12,0,65,53
1657782576478,COGS 101C,A01,083625,Delgado; Tania,17,0,35,18
1657782582505,COGS 107A,A01,083627,Boyle; Mary E. T.,14,0,60,46
1657782588610,COGS 118A,A01,083075,Gupta; Anjum,21,0,76,55
1657782594639,CSE 3,A50,083646,Miranda; Gregory Joseph,24,0,50,26
1657782600667,CSE 8A,A50,083650,Miranda; Gregory Joseph,17,1,56,39
1657782606706,CSE 11,A01,083080,Cao; Yingjun,6,15,40,34
1657782612727,CSE 12,A01,083652,Krause-Levy; Sophia Louisa,28,1,120,92
1657782618756,CSE 15L,A01,083654,Morris; Justin Loren,9,0,50,41
1657782618756,CSE 15L,A02,083655,Morris; Justin Loren,9,0,50,41
1657782624784,CSE 20,A01,083657,Tran; Khoa Dang,39,0,80,41
1657782630808,CSE 21,A01,095574,Bach; Quang Tran,22,0,48,26
1657782636854,CSE 30,A01,083084,Eldon; John,6,0,80,74
1657782636854,CSE 30,B01,095061,Bhaskar; Nishant,9,0,50,41
1657782642881,CSE 100,A01,083659,Cao; Yingjun,5,4,70,65
1657782648908,CSE 134B,A01,083661,Powell; Thomas Allan,24,0,100,76
1657782654935,CSE 140,A01,083663,Gungor; Onat,15,0,85,70
1657782660958,CSE 140L,A01,083088,Eldon; John,23,0,100,77
1657782666981,CSE 175,A01,083665,Kumar; Rakesh,3,0,25,22
1657782673005,CSE 190,A00,092507,Dubnov; Shlomo,8,0,20,12
1657782679028,ECE 45,A01,083139,Congero; Spencer William,6,0,75,69
1657782685059,ECE 65,A50,083695,Saad; Andrew S,12,0,30,18
1657782685059,ECE 65,A51,095125,Saad; Andrew S,24,0,26,2
1657782691084,ECE 109,A01,091882,Touri; Behrouz,20,0,70,50
1657782697120,ECE 180,A00,083140,Abi Samra; Nicholas Camill,1,0,30,29
1657782697120,ECE 180,B00,083141,Abi Samra; Nicholas Camill,0,0,30,30
1657782703152,MATH 10A,A01,083735,Patchell; Gregory David,2,0,30,28
1657782703152,MATH 10A,A02,083736,Patchell; Gregory David,20,0,30,10
1657782703152,MATH 10A,A03,083737,Patchell; Gregory David,16,0,30,14
1657782709177,MATH 10B,A01,083207,Lim; Seonhee,8,0,34,26
1657782709177,MATH 10B,A02,083208,Lim; Seonhee,10,0,35,25
1657782709177,MATH 10B,A03,093472,Lim; Seonhee,7,0,34,27
1657782709177,MATH 10B,B01,083739,Sinha; Shubham,13,0,30,17
1657782715204,MATH 18,A01,083743,Cinel; Cameron Alexander,9,0,30,21
1657782715204,MATH 18,A02,083744,Cinel; Cameron Alexander,18,0,30,12
1657782715204,MATH 18,A03,083745,Cinel; Cameron Alexander,10,0,30,20
1657782715204,MATH 18,B01,083748,Rideout; David Porter,5,0,37,32
1657782715204,MATH 18,B02,083749,Rideout; David Porter,5,0,36,31
1657782715204,MATH 18,B03,083750,Rideout; David Porter,3,0,37,34
1657782715204,MATH 18,B04,083751,Rideout; David Porter,6,0,36,30
1657782715204,MATH 18,B05,093473,Rideout; David Porter,6,0,36,30
1657782715204,MATH 18,B06,093474,Rideout; David Porter,6,0,36,30
1657782721227,MATH 20A,A01,083754,Zheng; Zequn,14,0,40,26
1657782727259,MATH 20B,A01,083756,Briones; Jor-el Thomas Caparas,4,0,36,32
1657782727259,MATH 20B,A02,083757,Briones; Jor-el Thomas Caparas,1,0,36,35
1657782727259,MATH 20B,A03,093475,Briones; Jor-el Thomas Caparas,2,0,36,34
1657782733285,MATH 20C,A01,083760,Briones; Jor-el Thomas Caparas,1,0,35,34
1657782733285,MATH 20C,A02,083761,Briones; Jor-el Thomas Caparas,8,0,35,27
1657782733285,MATH 20C,A03,093476,Briones; Jor-el Thomas Caparas,0,1,36,36
1657782733285,MATH 20C,B01,083762,Bach; Quang Tran,1,0,30,29
1657782739311,MATH 20D,A01,083765,Tran; Brian Kha,5,0,30,25
1657782739311,MATH 20D,A02,083766,Tran; Brian Kha,5,0,30,25
1657782739311,MATH 20D,A03,083767,Tran; Brian Kha,5,0,30,25
1657782745344,MATH 20E,A01,083771,Ganguly; Soumya,10,0,32,22
1657782745344,MATH 20E,A02,083772,Ganguly; Soumya,6,0,32,26
1657782745344,MATH 20E,B01,083773,Ciotti; Benjamin,20,0,35,15
1657782745344,MATH 20E,B02,083774,Ciotti; Benjamin,18,0,35,17
1657782751369,MATH 103A,A01,083777,Greenfeld; Be'Eri,3,0,36,33
1657782751369,MATH 103A,A02,083778,Greenfeld; Be'Eri,5,0,36,31
1657782751369,MATH 103A,A03,093561,Greenfeld; Be'Eri,6,0,36,30
1657782751369,MATH 103A,B01,083779,Greenfeld; Be'Eri,7,0,36,29
1657782751369,MATH 103A,B02,083780,Greenfeld; Be'Eri,4,0,36,32
1657782751369,MATH 103A,B03,093562,Greenfeld; Be'Eri,3,0,36,33
1657782757394,MATH 105,A01,085443,Carter; Anne Toulson,15,0,35,20
1657782757394,MATH 105,A02,093477,Carter; Anne Toulson,20,0,35,15
1657782763426,MATH 109,A01,083213,Ganzberger; Geoffrey Michael,3,0,34,31
1657782763426,MATH 109,A02,083214,Ganzberger; Geoffrey Michael,4,0,34,30
1657782763426,MATH 109,A03,093478,Ganzberger; Geoffrey Michael,2,0,34,32
1657782763426,MATH 109,B01,083215,Ganzberger; Geoffrey Michael,1,0,32,31
1657782763426,MATH 109,B02,083216,Ganzberger; Geoffrey Michael,2,0,32,30
1657782763426,MATH 109,B03,093479,Ganzberger; Geoffrey Michael,8,0,32,24
1657782769451,MATH 142A,A01,083219,Chow; Bennett,7,0,32,25
1657782769451,MATH 142A,A02,083220,Chow; Bennett,10,0,32,22
1657782769451,MATH 142A,A03,093480,Chow; Bennett,9,0,32,23
1657782769451,MATH 142A,B03,093481,Chow; Bennett,8,0,32,24
1657782769451,MATH 142A,B04,093558,Chow; Bennett,13,0,32,19
1657782769451,MATH 142A,B05,093559,Chow; Bennett,6,0,32,26
1657782775483,MATH 193A,A01,083224,Rotar; Vladimir,8,0,34,26
1657782775483,MATH 193A,A02,083225,Rotar; Vladimir,9,0,34,25
1657782775483,MATH 193A,A03,083781,Rotar; Vladimir,5,0,34,29
1657782775483,MATH 193A,A04,083782,Rotar; Vladimir,10,0,34,24
1657782775483,MATH 193A,A05,093482,Rotar; Vladimir,10,0,34,24
1657782781508,MATH 197,001,091859,McAuley; Julian John,9999,0,9999,0
1657782781508,MATH 197,002,095566,Kedlaya; Kiran S.,9997,0,9999,2
1657782781508,MATH 197,003,095567,Xiao; Ming,9999,0,9999,0
1657782781508,MATH 197,004,095571,Perols; Johan Lars,9998,0,9999,1
1657782788566,COGS 9,A01,083615,Shannon; Kyle Michael,9,0,75,66
1657782794596,COGS 11,A01,083617,Boyle; Mary E. T.,23,0,48,25
1657782800618,COGS 13,A01,083071,Bastos; Amalia Pinkusfeld,11,0,71,60
1657782806646,COGS 14A,A01,092681,Semenuks; Arturs,5,1,100,95
1657782812669,COGS 14B,A01,083073,Cheng; Tzu-Han,6,0,63,57
1657782818691,COGS 17,A01,092677,Semenuks; Arturs,6,0,81,75
1657782824716,COGS 100,A01,083619,Allen; Michael Gordon,17,0,70,53
1657782830740,COGS 101A,A01,083621,Davis; Joshua Daniel,9,0,68,59
1657782836764,COGS 101B,A01,091572,Allen; Michael Gordon,12,0,65,53
1657782842787,COGS 101C,A01,083625,Delgado; Tania,17,0,35,18
1657782848818,COGS 107A,A01,083627,Boyle; Mary E. T.,14,0,60,46
1657782854845,COGS 118A,A01,083075,Gupta; Anjum,21,0,76,55
1657782860882,CSE 3,A50,083646,Miranda; Gregory Joseph,24,0,50,26
1657782866906,CSE 8A,A50,083650,Miranda; Gregory Joseph,17,1,56,39
1657782872937,CSE 11,A01,083080,Cao; Yingjun,6,15,40,34
1657782878963,CSE 12,A01,083652,Krause-Levy; Sophia Louisa,28,1,120,92
1657782885003,CSE 15L,A01,083654,Morris; Justin Loren,9,0,50,41
1657782885003,CSE 15L,A02,083655,Morris; Justin Loren,9,0,50,41
1657782891040,CSE 20,A01,083657,Tran; Khoa Dang,39,0,80,41
1657782897073,CSE 21,A01,095574,Bach; Quang Tran,22,0,48,26
1657782903129,CSE 30,A01,083084,Eldon; John,6,0,80,74
1657782903129,CSE 30,B01,095061,Bhaskar; Nishant,9,0,50,41
1657782909172,CSE 100,A01,083659,Cao; Yingjun,5,4,70,65
1657782915204,CSE 134B,A01,083661,Powell; Thomas Allan,24,0,100,76
1657782921238,CSE 140,A01,083663,Gungor; Onat,15,0,85,70
1657782927262,CSE 140L,A01,083088,Eldon; John,23,0,100,77
1657782933313,CSE 175,A01,083665,Kumar; Rakesh,3,0,25,22
1657782939348,CSE 190,A00,092507,Dubnov; Shlomo,8,0,20,12
1657782945372,ECE 45,A01,083139,Congero; Spencer William,6,0,75,69
1657782951400,ECE 65,A50,083695,Saad; Andrew S,12,0,30,18
1657782951400,ECE 65,A51,095125,Saad; Andrew S,24,0,26,2
1657782957426,ECE 109,A01,091882,Touri; Behrouz,20,0,70,50
1657782963469,ECE 180,A00,083140,Abi Samra; Nicholas Camill,1,0,30,29
1657782963469,ECE 180,B00,083141,Abi Samra; Nicholas Camill,0,0,30,30
1657782969508,MATH 10A,A01,083735,Patchell; Gregory David,2,0,30,28
1657782969508,MATH 10A,A02,083736,Patchell; Gregory David,20,0,30,10
1657782969508,MATH 10A,A03,083737,Patchell; Gregory David,16,0,30,14
1657782975538,MATH 10B,A01,083207,Lim; Seonhee,8,0,34,26
1657782975538,MATH 10B,A02,083208,Lim; Seonhee,10,0,35,25
1657782975538,MATH 10B,A03,093472,Lim; Seonhee,7,0,34,27
1657782975538,MATH 10B,B01,083739,Sinha; Shubham,13,0,30,17
1657782981587,MATH 18,A01,083743,Cinel; Cameron Alexander,9,0,30,21
1657782981587,MATH 18,A02,083744,Cinel; Cameron Alexander,18,0,30,12
1657782981587,MATH 18,A03,083745,Cinel; Cameron Alexander,10,0,30,20
1657782981587,MATH 18,B01,083748,Rideout; David Porter,5,0,37,32
1657782981587,MATH 18,B02,083749,Rideout; David Porter,5,0,36,31
1657782981587,MATH 18,B03,083750,Rideout; David Porter,3,0,37,34
1657782981587,MATH 18,B04,083751,Rideout; David Porter,6,0,36,30
1657782981587,MATH 18,B05,093473,Rideout; David Porter,6,0,36,30
1657782981587,MATH 18,B06,093474,Rideout; David Porter,6,0,36,30
1657782987619,MATH 20A,A01,083754,Zheng; Zequn,14,0,40,26
1657782993657,MATH 20B,A01,083756,Briones; Jor-el Thomas Caparas,4,0,36,32
1657782993657,MATH 20B,A02,083757,Briones; Jor-el Thomas Caparas,1,0,36,35
1657782993657,MATH 20B,A03,093475,Briones; Jor-el Thomas Caparas,2,0,36,34
1657782999684,MATH 20C,A01,083760,Briones; Jor-el Thomas Caparas,1,0,35,34
1657782999684,MATH 20C,A02,083761,Briones; Jor-el Thomas Caparas,8,0,35,27
1657782999684,MATH 20C,A03,093476,Briones; Jor-el Thomas Caparas,0,1,36,36
1657782999684,MATH 20C,B01,083762,Bach; Quang Tran,1,0,30,29
1657783005717,MATH 20D,A01,083765,Tran; Brian Kha,5,0,30,25
1657783005717,MATH 20D,A02,083766,Tran; Brian Kha,5,0,30,25
1657783005717,MATH 20D,A03,083767,Tran; Brian Kha,5,0,30,25
1657783011743,MATH 20E,A01,083771,Ganguly; Soumya,10,0,32,22
1657783011743,MATH 20E,A02,083772,Ganguly; Soumya,6,0,32,26
1657783011743,MATH 20E,B01,083773,Ciotti; Benjamin,20,0,35,15
1657783011743,MATH 20E,B02,083774,Ciotti; Benjamin,18,0,35,17
1657783017781,MATH 103A,A01,083777,Greenfeld; Be'Eri,3,0,36,33
1657783017781,MATH 103A,A02,083778,Greenfeld; Be'Eri,5,0,36,31
1657783017781,MATH 103A,A03,093561,Greenfeld; Be'Eri,6,0,36,30
1657783017781,MATH 103A,B01,083779,Greenfeld; Be'Eri,7,0,36,29
1657783017781,MATH 103A,B02,083780,Greenfeld; Be'Eri,4,0,36,32
1657783017781,MATH 103A,B03,093562,Greenfeld; Be'Eri,3,0,36,33
1657783023807,MATH 105,A01,085443,Carter; Anne Toulson,15,0,35,20
1657783023807,MATH 105,A02,093477,Carter; Anne Toulson,20,0,35,15
1657783029840,MATH 109,A01,083213,Ganzberger; Geoffrey Michael,3,0,34,31
1657783029840,MATH 109,A02,083214,Ganzberger; Geoffrey Michael,4,0,34,30
1657783029840,MATH 109,A03,093478,Ganzberger; Geoffrey Michael,2,0,34,32
1657783029840,MATH 109,B01,083215,Ganzberger; Geoffrey Michael,1,0,32,31
1657783029840,MATH 109,B02,083216,Ganzberger; Geoffrey Michael,2,0,32,30
1657783029840,MATH 109,B03,093479,Ganzberger; Geoffrey Michael,8,0,32,24
1657783035888,MATH 142A,A01,083219,Chow; Bennett,7,0,32,25
1657783035888,MATH 142A,A02,083220,Chow; Bennett,10,0,32,22
1657783035888,MATH 142A,A03,093480,Chow; Bennett,9,0,32,23
1657783035888,MATH 142A,B03,093481,Chow; Bennett,8,0,32,24
1657783035888,MATH 142A,B04,093558,Chow; Bennett,13,0,32,19
1657783035888,MATH 142A,B05,093559,Chow; Bennett,6,0,32,26
1657783041920,MATH 193A,A01,083224,Rotar; Vladimir,8,0,34,26
1657783041920,MATH 193A,A02,083225,Rotar; Vladimir,9,0,34,25
1657783041920,MATH 193A,A03,083781,Rotar; Vladimir,5,0,34,29
1657783041920,MATH 193A,A04,083782,Rotar; Vladimir,10,0,34,24
1657783041920,MATH 193A,A05,093482,Rotar; Vladimir,10,0,34,24
1657783047956,MATH 197,001,091859,McAuley; Julian John,9999,0,9999,0
1657783047956,MATH 197,002,095566,Kedlaya; Kiran S.,9997,0,9999,2
1657783047956,MATH 197,003,095567,Xiao; Ming,9999,0,9999,0
1657783047956,MATH 197,004,095571,Perols; Johan Lars,9998,0,9999,1
1657783055064,COGS 9,A01,083615,Shannon; Kyle Michael,9,0,75,66
1657783061090,COGS 11,A01,083617,Boyle; Mary E. T.,23,0,48,25
1657783067115,COGS 13,A01,083071,Bastos; Amalia Pinkusfeld,11,0,71,60
1657783073145,COGS 14A,A01,092681,Semenuks; Arturs,5,1,100,95
1657783079171,COGS 14B,A01,083073,Cheng; Tzu-Han,6,0,63,57
1657783085211,COGS 17,A01,092677,Semenuks; Arturs,6,0,81,75
1657783091236,COGS 100,A01,083619,Allen; Michael Gordon,17,0,70,53
1657783097261,COGS 101A,A01,083621,Davis; Joshua Daniel,9,0,68,59
1657783103289,COGS 101B,A01,091572,Allen; Michael Gordon,12,0,65,53
1657783109314,COGS 101C,A01,083625,Delgado; Tania,17,0,35,18
1657783115343,COGS 107A,A01,083627,Boyle; Mary E. T.,14,0,60,46
1657783121368,COGS 118A,A01,083075,Gupta; Anjum,21,0,76,55
1657783127402,CSE 3,A50,083646,Miranda; Gregory Joseph,24,0,50,26
1657783133427,CSE 8A,A50,083650,Miranda; Gregory Joseph,17,1,56,39
1657783139452,CSE 11,A01,083080,Cao; Yingjun,6,15,40,34
1657783145483,CSE 12,A01,083652,Krause-Levy; Sophia Louisa,28,1,120,92
1657783151539,CSE 15L,A01,083654,Morris; Justin Loren,9,0,50,41
1657783151539,CSE 15L,A02,083655,Morris; Justin Loren,9,0,50,41
1657783157570,CSE 20,A01,083657,Tran; Khoa Dang,39,0,80,41
1657783163596,CSE 21,A01,095574,Bach; Quang Tran,22,0,48,26
1657783169624,CSE 30,A01,083084,Eldon; John,6,0,80,74
1657783169624,CSE 30,B01,095061,Bhaskar; Nishant,9,0,50,41
1657783175665,CSE 100,A01,083659,Cao; Yingjun,5,4,70,65
1657783181689,CSE 134B,A01,083661,Powell; Thomas Allan,24,0,100,76
1657783187788,CSE 140,A01,083663,Gungor; Onat,15,0,85,70
1657783193827,CSE 140L,A01,083088,Eldon; John,23,0,100,77
1657783199863,CSE 175,A01,083665,Kumar; Rakesh,3,0,25,22
1657783205894,CSE 190,A00,092507,Dubnov; Shlomo,8,0,20,12
1657783211920,ECE 45,A01,083139,Congero; Spencer William,6,0,75,69
1657783217951,ECE 65,A50,083695,Saad; Andrew S,12,0,30,18
1657783217951,ECE 65,A51,095125,Saad; Andrew S,24,0,26,2
1657783223981,ECE 109,A01,091882,Touri; Behrouz,20,0,70,50
1657783230007,ECE 180,A00,083140,Abi Samra; Nicholas Camill,1,0,30,29
1657783230007,ECE 180,B00,083141,Abi Samra; Nicholas Camill,0,0,30,30
1657783236039,MATH 10A,A01,083735,Patchell; Gregory David,2,0,30,28
1657783236039,MATH 10A,A02,083736,Patchell; Gregory David,20,0,30,10
1657783236039,MATH 10A,A03,083737,Patchell; Gregory David,16,0,30,14
1657783242066,MATH 10B,A01,083207,Lim; Seonhee,8,0,34,26
1657783242066,MATH 10B,A02,083208,Lim; Seonhee,10,0,35,25
1657783242066,MATH 10B,A03,093472,Lim; Seonhee,7,0,34,27
1657783242066,MATH 10B,B01,083739,Sinha; Shubham,13,0,30,17
1657783248092,MATH 18,A01,083743,Cinel; Cameron Alexander,9,0,30,21
1657783248092,MATH 18,A02,083744,Cinel; Cameron Alexander,18,0,30,12
1657783248092,MATH 18,A03,083745,Cinel; Cameron Alexander,10,0,30,20
1657783248092,MATH 18,B01,083748,Rideout; David Porter,5,0,37,32
1657783248092,MATH 18,B02,083749,Rideout; David Porter,5,0,36,31
1657783248092,MATH 18,B03,083750,Rideout; David Porter,3,0,37,34
1657783248092,MATH 18,B04,083751,Rideout; David Porter,6,0,36,30
1657783248092,MATH 18,B05,093473,Rideout; David Porter,6,0,36,30
1657783248092,MATH 18,B06,093474,Rideout; David Porter,6,0,36,30
1657783254115,MATH 20A,A01,083754,Zheng; Zequn,14,0,40,26
1657783260139,MATH 20B,A01,083756,Briones; Jor-el Thomas Caparas,4,0,36,32
1657783260139,MATH 20B,A02,083757,Briones; Jor-el Thomas Caparas,1,0,36,35
1657783260139,MATH 20B,A03,093475,Briones; Jor-el Thomas Caparas,2,0,36,34
1657783266172,MATH 20C,A01,083760,Briones; Jor-el Thomas Caparas,1,0,35,34
1657783266172,MATH 20C,A02,083761,Briones; Jor-el Thomas Caparas,8,0,35,27
1657783266172,MATH 20C,A03,093476,Briones; Jor-el Thomas Caparas,0,1,36,36
1657783266172,MATH 20C,B01,083762,Bach; Quang Tran,1,0,30,29
1657783272198,MATH 20D,A01,083765,Tran; Brian Kha,5,0,30,25
1657783272198,MATH 20D,A02,083766,Tran; Brian Kha,5,0,30,25
1657783272198,MATH 20D,A03,083767,Tran; Brian Kha,5,0,30,25
1657783278227,MATH 20E,A01,083771,Ganguly; Soumya,10,0,32,22
1657783278227,MATH 20E,A02,083772,Ganguly; Soumya,6,0,32,26
1657783278227,MATH 20E,B01,083773,Ciotti; Benjamin,20,0,35,15
1657783278227,MATH 20E,B02,083774,Ciotti; Benjamin,18,0,35,17
1657783284260,MATH 103A,A01,083777,Greenfeld; Be'Eri,3,0,36,33
1657783284260,MATH 103A,A02,083778,Greenfeld; Be'Eri,5,0,36,31
1657783284260,MATH 103A,A03,093561,Greenfeld; Be'Eri,6,0,36,30
1657783284260,MATH 103A,B01,083779,Greenfeld; Be'Eri,7,0,36,29
1657783284260,MATH 103A,B02,083780,Greenfeld; Be'Eri,4,0,36,32
1657783284260,MATH 103A,B03,093562,Greenfeld; Be'Eri,3,0,36,33
1657783290290,MATH 105,A01,085443,Carter; Anne Toulson,15,0,35,20
1657783290290,MATH 105,A02,093477,Carter; Anne Toulson,20,0,35,15
1657783296316,MATH 109,A01,083213,Ganzberger; Geoffrey Michael,3,0,34,31
1657783296316,MATH 109,A02,083214,Ganzberger; Geoffrey Michael,4,0,34,30
1657783296316,MATH 109,A03,093478,Ganzberger; Geoffrey Michael,2,0,34,32
1657783296316,MATH 109,B01,083215,Ganzberger; Geoffrey Michael,1,0,32,31
1657783296316,MATH 109,B02,083216,Ganzberger; Geoffrey Michael,2,0,32,30
1657783296316,MATH 109,B03,093479,Ganzberger; Geoffrey Michael,8,0,32,24
1657783302341,MATH 142A,A01,083219,Chow; Bennett,7,0,32,25
1657783302341,MATH 142A,A02,083220,Chow; Bennett,10,0,32,22
1657783302341,MATH 142A,A03,093480,Chow; Bennett,9,0,32,23
1657783302341,MATH 142A,B03,093481,Chow; Bennett,8,0,32,24
1657783302341,MATH 142A,B04,093558,Chow; Bennett,13,0,32,19
1657783302341,MATH 142A,B05,093559,Chow; Bennett,6,0,32,26
1657783308373,MATH 193A,A01,083224,Rotar; Vladimir,8,0,34,26
1657783308373,MATH 193A,A02,083225,Rotar; Vladimir,9,0,34,25
1657783308373,MATH 193A,A03,083781,Rotar; Vladimir,5,0,34,29
1657783308373,MATH 193A,A04,083782,Rotar; Vladimir,10,0,34,24
1657783308373,MATH 193A,A05,093482,Rotar; Vladimir,10,0,34,24
1657783314398,MATH 197,001,091859,McAuley; Julian John,9999,0,9999,0
1657783314398,MATH 197,002,095566,Kedlaya; Kiran S.,9997,0,9999,2
1657783314398,MATH 197,003,095567,Xiao; Ming,9999,0,9999,0
1657783314398,MATH 197,004,095571,Perols; Johan Lars,9998,0,9999,1
1657783321479,COGS 9,A01,083615,Shannon; Kyle Michael,9,0,75,66
1657783327517,COGS 11,A01,083617,Boyle; Mary E. T.,23,0,48,25
1657783333547,COGS 13,A01,083071,Bastos; Amalia Pinkusfeld,11,0,71,60
1657783339578,COGS 14A,A01,092681,Semenuks; Arturs,5,1,100,95
1657783345608,COGS 14B,A01,083073,Cheng; Tzu-Han,6,0,63,57
1657783351632,COGS 17,A01,092677,Semenuks; Arturs,6,0,81,75
1657783357664,COGS 100,A01,083619,Allen; Michael Gordon,17,0,70,53
1657783363689,COGS 101A,A01,083621,Davis; Joshua Daniel,9,0,68,59
1657783369713,COGS 101B,A01,091572,Allen; Michael Gordon,12,0,65,53
1657783375736,COGS 101C,A01,083625,Delgado; Tania,17,0,35,18
1657783381759,COGS 107A,A01,083627,Boyle; Mary E. T.,14,0,60,46
1657783387783,COGS 118A,A01,083075,Gupta; Anjum,21,0,76,55
1657783393812,CSE 3,A50,083646,Miranda; Gregory Joseph,24,0,50,26
1657783399838,CSE 8A,A50,083650,Miranda; Gregory Joseph,17,1,56,39
1657783405861,CSE 11,A01,083080,Cao; Yingjun,6,15,40,34
1657783411889,CSE 12,A01,083652,Krause-Levy; Sophia Louisa,28,1,120,92
1657783417917,CSE 15L,A01,083654,Morris; Justin Loren,9,0,50,41
1657783417917,CSE 15L,A02,083655,Morris; Justin Loren,9,0,50,41
1657783423942,CSE 20,A01,083657,Tran; Khoa Dang,39,0,80,41
1657783429967,CSE 21,A01,095574,Bach; Quang Tran,22,0,48,26
1657783435999,CSE 30,A01,083084,Eldon; John,6,0,80,74
1657783435999,CSE 30,B01,095061,Bhaskar; Nishant,9,0,50,41
1657783442038,CSE 100,A01,083659,Cao; Yingjun,5,4,70,65
1657783448070,CSE 134B,A01,083661,Powell; Thomas Allan,24,0,100,76
1657783454096,CSE 140,A01,083663,Gungor; Onat,15,0,85,70
1657783460124,CSE 140L,A01,083088,Eldon; John,23,0,100,77
1657783466152,CSE 175,A01,083665,Kumar; Rakesh,3,0,25,22
1657783472185,CSE 190,A00,092507,Dubnov; Shlomo,8,0,20,12
1657783478210,ECE 45,A01,083139,Congero; Spencer William,6,0,75,69
1657783484235,ECE 65,A50,083695,Saad; Andrew S,12,0,30,18
1657783484235,ECE 65,A51,095125,Saad; Andrew S,24,0,26,2
1657783490261,ECE 109,A01,091882,Touri; Behrouz,20,0,70,50
1657783496287,ECE 180,A00,083140,Abi Samra; Nicholas Camill,1,0,30,29
1657783496287,ECE 180,B00,083141,Abi Samra; Nicholas Camill,0,0,30,30
1657783502311,MATH 10A,A01,083735,Patchell; Gregory David,2,0,30,28
1657783502311,MATH 10A,A02,083736,Patchell; Gregory David,20,0,30,10
1657783502311,MATH 10A,A03,083737,Patchell; Gregory David,16,0,30,14
1657783508347,MATH 10B,A01,083207,Lim; Seonhee,8,0,34,26
1657783508347,MATH 10B,A02,083208,Lim; Seonhee,10,0,35,25
1657783508347,MATH 10B,A03,093472,Lim; Seonhee,7,0,34,27
1657783508347,MATH 10B,B01,083739,Sinha; Shubham,13,0,30,17
1657783514372,MATH 18,A01,083743,Cinel; Cameron Alexander,9,0,30,21
1657783514372,MATH 18,A02,083744,Cinel; Cameron Alexander,18,0,30,12
1657783514372,MATH 18,A03,083745,Cinel; Cameron Alexander,10,0,30,20
1657783514372,MATH 18,B01,083748,Rideout; David Porter,5,0,37,32
1657783514372,MATH 18,B02,083749,Rideout; David Porter,5,0,36,31
1657783514372,MATH 18,B03,083750,Rideout; David Porter,3,0,37,34
1657783514372,MATH 18,B04,083751,Rideout; David Porter,6,0,36,30
1657783514372,MATH 18,B05,093473,Rideout; David Porter,6,0,36,30
1657783514372,MATH 18,B06,093474,Rideout; David Porter,6,0,36,30
1657783520396,MATH 20A,A01,083754,Zheng; Zequn,14,0,40,26
1657783526420,MATH 20B,A01,083756,Briones; Jor-el Thomas Caparas,4,0,36,32
1657783526420,MATH 20B,A02,083757,Briones; Jor-el Thomas Caparas,1,0,36,35
1657783526420,MATH 20B,A03,093475,Briones; Jor-el Thomas Caparas,2,0,36,34
1657783532445,MATH 20C,A01,083760,Briones; Jor-el Thomas Caparas,1,0,35,34
1657783532445,MATH 20C,A02,083761,Briones; Jor-el Thomas Caparas,8,0,35,27
1657783532445,MATH 20C,A03,093476,Briones; Jor-el Thomas Caparas,0,1,36,36
1657783532445,MATH 20C,B01,083762,Bach; Quang Tran,1,0,30,29
1657783538474,MATH 20D,A01,083765,Tran; Brian Kha,5,0,30,25
1657783538474,MATH 20D,A02,083766,Tran; Brian Kha,5,0,30,25
1657783538474,MATH 20D,A03,083767,Tran; Brian Kha,5,0,30,25
1657783544501,MATH 20E,A01,083771,Ganguly; Soumya,10,0,32,22
1657783544501,MATH 20E,A02,083772,Ganguly; Soumya,6,0,32,26
1657783544501,MATH 20E,B01,083773,Ciotti; Benjamin,20,0,35,15
1657783544501,MATH 20E,B02,083774,Ciotti; Benjamin,18,0,35,17
1657783550525,MATH 103A,A01,083777,Greenfeld; Be'Eri,3,0,36,33
1657783550525,MATH 103A,A02,083778,Greenfeld; Be'Eri,5,0,36,31
1657783550525,MATH 103A,A03,093561,Greenfeld; Be'Eri,6,0,36,30
1657783550525,MATH 103A,B01,083779,Greenfeld; Be'Eri,7,0,36,29
1657783550525,MATH 103A,B02,083780,Greenfeld; Be'Eri,4,0,36,32
1657783550525,MATH 103A,B03,093562,Greenfeld; Be'Eri,3,0,36,33
1657783556549,MATH 105,A01,085443,Carter; Anne Toulson,15,0,35,20
1657783556549,MATH 105,A02,093477,Carter; Anne Toulson,20,0,35,15
1657783562584,MATH 109,A01,083213,Ganzberger; Geoffrey Michael,3,0,34,31
1657783562584,MATH 109,A02,083214,Ganzberger; Geoffrey Michael,4,0,34,30
1657783562584,MATH 109,A03,093478,Ganzberger; Geoffrey Michael,2,0,34,32
1657783562584,MATH 109,B01,083215,Ganzberger; Geoffrey Michael,1,0,32,31
1657783562584,MATH 109,B02,083216,Ganzberger; Geoffrey Michael,2,0,32,30
1657783562584,MATH 109,B03,093479,Ganzberger; Geoffrey Michael,8,0,32,24
1657783568608,MATH 142A,A01,083219,Chow; Bennett,7,0,32,25
1657783568608,MATH 142A,A02,083220,Chow; Bennett,10,0,32,22
1657783568608,MATH 142A,A03,093480,Chow; Bennett,9,0,32,23
1657783568608,MATH 142A,B03,093481,Chow; Bennett,8,0,32,24
1657783568608,MATH 142A,B04,093558,Chow; Bennett,13,0,32,19
1657783568608,MATH 142A,B05,093559,Chow; Bennett,6,0,32,26
1657783574641,MATH 193A,A01,083224,Rotar; Vladimir,8,0,34,26
1657783574641,MATH 193A,A02,083225,Rotar; Vladimir,9,0,34,25
1657783574641,MATH 193A,A03,083781,Rotar; Vladimir,5,0,34,29
1657783574641,MATH 193A,A04,083782,Rotar; Vladimir,10,0,34,24
1657783574641,MATH 193A,A05,093482,Rotar; Vladimir,10,0,34,24
1657783580666,MATH 197,001,091859,McAuley; Julian John,9999,0,9999,0
1657783580666,MATH 197,002,095566,Kedlaya; Kiran S.,9997,0,9999,2
1657783580666,MATH 197,003,095567,Xiao; Ming,9999,0,9999,0
1657783580666,MATH 197,004,095571,Perols; Johan Lars,9998,0,9999,1
1657783587721,COGS 9,A01,083615,Shannon; Kyle Michael,9,0,75,66
1657783593745,COGS 11,A01,083617,Boyle; Mary E. T.,23,0,48,25
1657783599773,COGS 13,A01,083071,Bastos; Amalia Pinkusfeld,11,0,71,60
1657783605800,COGS 14A,A01,092681,Semenuks; Arturs,5,1,100,95
1657783611829,COGS 14B,A01,083073,Cheng; Tzu-Han,6,0,63,57
1657783617856,COGS 17,A01,092677,Semenuks; Arturs,6,0,81,75
1657783623881,COGS 100,A01,083619,Allen; Michael Gordon,17,0,70,53
1657783629907,COGS 101A,A01,083621,Davis; Joshua Daniel,9,0,68,59
1657783635941,COGS 101B,A01,091572,Allen; Michael Gordon,12,0,65,53
1657783641983,COGS 101C,A01,083625,Delgado; Tania,17,0,35,18
1657783648008,COGS 107A,A01,083627,Boyle; Mary E. T.,14,0,60,46
1657783654032,COGS 118A,A01,083075,Gupta; Anjum,21,0,76,55
1657783660056,CSE 3,A50,083646,Miranda; Gregory Joseph,24,0,50,26
1657783666098,CSE 8A,A50,083650,Miranda; Gregory Joseph,17,1,56,39
1657783672123,CSE 11,A01,083080,Cao; Yingjun,6,15,40,34
1657783678149,CSE 12,A01,083652,Krause-Levy; Sophia Louisa,28,1,120,92
1657783684176,CSE 15L,A01,083654,Morris; Justin Loren,9,0,50,41
1657783684176,CSE 15L,A02,083655,Morris; Justin Loren,9,0,50,41
1657783690199,CSE 20,A01,083657,Tran; Khoa Dang,39,0,80,41
1657783696226,CSE 21,A01,095574,Bach; Quang Tran,22,0,48,26
1657783702251,CSE 30,A01,083084,Eldon; John,6,0,80,74
1657783702251,CSE 30,B01,095061,Bhaskar; Nishant,9,0,50,41
1657783708276,CSE 100,A01,083659,Cao; Yingjun,5,4,70,65
1657783714301,CSE 134B,A01,083661,Powell; Thomas Allan,24,0,100,76
1657783720345,CSE 140,A01,083663,Gungor; Onat,15,0,85,70
1657783726370,CSE 140L,A01,083088,Eldon; John,23,0,100,77
1657783732398,CSE 175,A01,083665,Kumar; Rakesh,3,0,25,22
1657783738423,CSE 190,A00,092507,Dubnov; Shlomo,8,0,20,12
1657783744449,ECE 45,A01,083139,Congero; Spencer William,6,0,75,69
1657783750482,ECE 65,A50,083695,Saad; Andrew S,12,0,30,18
1657783750482,ECE 65,A51,095125,Saad; Andrew S,24,0,26,2
1657783756512,ECE 109,A01,091882,Touri; Behrouz,20,0,70,50
1657783762540,ECE 180,A00,083140,Abi Samra; Nicholas Camill,1,0,30,29
1657783762540,ECE 180,B00,083141,Abi Samra; Nicholas Camill,0,0,30,30
1657783768565,MATH 10A,A01,083735,Patchell; Gregory David,2,0,30,28
1657783768565,MATH 10A,A02,083736,Patchell; Gregory David,20,0,30,10
1657783768565,MATH 10A,A03,083737,Patchell; Gregory David,16,0,30,14
1657783774596,MATH 10B,A01,083207,Lim; Seonhee,8,0,34,26
1657783774596,MATH 10B,A02,083208,Lim; Seonhee,10,0,35,25
1657783774596,MATH 10B,A03,093472,Lim; Seonhee,7,0,34,27
1657783774596,MATH 10B,B01,083739,Sinha; Shubham,13,0,30,17
1657783780622,MATH 18,A01,083743,Cinel; Cameron Alexander,9,0,30,21
1657783780622,MATH 18,A02,083744,Cinel; Cameron Alexander,18,0,30,12
1657783780622,MATH 18,A03,083745,Cinel; Cameron Alexander,10,0,30,20
1657783780622,MATH 18,B01,083748,Rideout; David Porter,5,0,37,32
1657783780622,MATH 18,B02,083749,Rideout; David Porter,5,0,36,31
1657783780622,MATH 18,B03,083750,Rideout; David Porter,3,0,37,34
1657783780622,MATH 18,B04,083751,Rideout; David Porter,6,0,36,30
1657783780622,MATH 18,B05,093473,Rideout; David Porter,6,0,36,30
1657783780622,MATH 18,B06,093474,Rideout; David Porter,6,0,36,30
1657783786740,MATH 20A,A01,083754,Zheng; Zequn,14,0,40,26
1657783792773,MATH 20B,A01,083756,Briones; Jor-el Thomas Caparas,4,0,36,32
1657783792773,MATH 20B,A02,083757,Briones; Jor-el Thomas Caparas,1,0,36,35
1657783792773,MATH 20B,A03,093475,Briones; Jor-el Thomas Caparas,2,0,36,34
1657783798802,MATH 20C,A01,083760,Briones; Jor-el Thomas Caparas,1,0,35,34
1657783798802,MATH 20C,A02,083761,Briones; Jor-el Thomas Caparas,8,0,35,27
1657783798802,MATH 20C,A03,093476,Briones; Jor-el Thomas Caparas,0,1,36,36
1657783798802,MATH 20C,B01,083762,Bach; Quang Tran,1,0,30,29
1657783804825,MATH 20D,A01,083765,Tran; Brian Kha,5,0,30,25
1657783804825,MATH 20D,A02,083766,Tran; Brian Kha,5,0,30,25
1657783804825,MATH 20D,A03,083767,Tran; Brian Kha,5,0,30,25
1657783810850,MATH 20E,A01,083771,Ganguly; Soumya,10,0,32,22
1657783810850,MATH 20E,A02,083772,Ganguly; Soumya,6,0,32,26
1657783810850,MATH 20E,B01,083773,Ciotti; Benjamin,20,0,35,15
1657783810850,MATH 20E,B02,083774,Ciotti; Benjamin,18,0,35,17
1657783816875,MATH 103A,A01,083777,Greenfeld; Be'Eri,3,0,36,33
1657783816875,MATH 103A,A02,083778,Greenfeld; Be'Eri,5,0,36,31
1657783816875,MATH 103A,A03,093561,Greenfeld; Be'Eri,6,0,36,30
1657783816875,MATH 103A,B01,083779,Greenfeld; Be'Eri,7,0,36,29
1657783816875,MATH 103A,B02,083780,Greenfeld; Be'Eri,4,0,36,32
1657783816875,MATH 103A,B03,093562,Greenfeld; Be'Eri,3,0,36,33
1657783822904,MATH 105,A01,085443,Carter; Anne Toulson,15,0,35,20
1657783822904,MATH 105,A02,093477,Carter; Anne Toulson,20,0,35,15
1657783828930,MATH 109,A01,083213,Ganzberger; Geoffrey Michael,3,0,34,31
1657783828930,MATH 109,A02,083214,Ganzberger; Geoffrey Michael,4,0,34,30
1657783828930,MATH 109,A03,093478,Ganzberger; Geoffrey Michael,2,0,34,32
1657783828930,MATH 109,B01,083215,Ganzberger; Geoffrey Michael,1,0,32,31
1657783828930,MATH 109,B02,083216,Ganzberger; Geoffrey Michael,2,0,32,30
1657783828930,MATH 109,B03,093479,Ganzberger; Geoffrey Michael,8,0,32,24
1657783834962,MATH 142A,A01,083219,Chow; Bennett,7,0,32,25
1657783834962,MATH 142A,A02,083220,Chow; Bennett,10,0,32,22
1657783834962,MATH 142A,A03,093480,Chow; Bennett,9,0,32,23
1657783834962,MATH 142A,B03,093481,Chow; Bennett,8,0,32,24
1657783834962,MATH 142A,B04,093558,Chow; Bennett,13,0,32,19
1657783834962,MATH 142A,B05,093559,Chow; Bennett,6,0,32,26
1657783840992,MATH 193A,A01,083224,Rotar; Vladimir,8,0,34,26
1657783840992,MATH 193A,A02,083225,Rotar; Vladimir,9,0,34,25
1657783840992,MATH 193A,A03,083781,Rotar; Vladimir,5,0,34,29
1657783840992,MATH 193A,A04,083782,Rotar; Vladimir,10,0,34,24
1657783840992,MATH 193A,A05,093482,Rotar; Vladimir,10,0,34,24
1657783847019,MATH 197,001,091859,McAuley; Julian John,9999,0,9999,0
1657783847019,MATH 197,002,095566,Kedlaya; Kiran S.,9997,0,9999,2
1657783847019,MATH 197,003,095567,Xiao; Ming,9999,0,9999,0
1657783847019,MATH 197,004,095571,Perols; Johan Lars,9998,0,9999,1
1657783854079,COGS 9,A01,083615,Shannon; Kyle Michael,9,0,75,66
1657783860103,COGS 11,A01,083617,Boyle; Mary E. T.,23,0,48,25
1657783866132,COGS 13,A01,083071,Bastos; Amalia Pinkusfeld,11,0,71,60
1657783872155,COGS 14A,A01,092681,Semenuks; Arturs,5,1,100,95
1657783878183,COGS 14B,A01,083073,Cheng; Tzu-Han,6,0,63,57
1657783884207,COGS 17,A01,092677,Semenuks; Arturs,6,0,81,75
1657783890235,COGS 100,A01,083619,Allen; Michael Gordon,17,0,70,53
1657783896264,COGS 101A,A01,083621,Davis; Joshua Daniel,9,0,68,59
1657783902287,COGS 101B,A01,091572,Allen; Michael Gordon,12,0,65,53
1657783908310,COGS 101C,A01,083625,Delgado; Tania,17,0,35,18
1657783914340,COGS 107A,A01,083627,Boyle; Mary E. T.,14,0,60,46
1657783920368,COGS 118A,A01,083075,Gupta; Anjum,21,0,76,55
1657783926398,CSE 3,A50,083646,Miranda; Gregory Joseph,24,0,50,26
1657783932428,CSE 8A,A50,083650,Miranda; Gregory Joseph,17,1,56,39
1657783938455,CSE 11,A01,083080,Cao; Yingjun,6,15,40,34
1657783944478,CSE 12,A01,083652,Krause-Levy; Sophia Louisa,28,1,120,92
1657783950512,CSE 15L,A01,083654,Morris; Justin Loren,9,0,50,41
1657783950512,CSE 15L,A02,083655,Morris; Justin Loren,9,0,50,41
1657783956534,CSE 20,A01,083657,Tran; Khoa Dang,39,0,80,41
1657783962557,CSE 21,A01,095574,Bach; Quang Tran,22,0,48,26
1657783968590,CSE 30,A01,083084,Eldon; John,6,0,80,74
1657783968590,CSE 30,B01,095061,Bhaskar; Nishant,9,0,50,41
1657783974619,CSE 100,A01,083659,Cao; Yingjun,5,4,70,65
1657783980649,CSE 134B,A01,083661,Powell; Thomas Allan,24,0,100,76
1657783986674,CSE 140,A01,083663,Gungor; Onat,15,0,85,70
1657783992699,CSE 140L,A01,083088,Eldon; John,23,0,100,77
1657783998731,CSE 175,A01,083665,Kumar; Rakesh,3,0,25,22
1657784004756,CSE 190,A00,092507,Dubnov; Shlomo,8,0,20,12
1657784010784,ECE 45,A01,083139,Congero; Spencer William,6,0,75,69
1657784016827,ECE 65,A50,083695,Saad; Andrew S,12,0,30,18
1657784016827,ECE 65,A51,095125,Saad; Andrew S,24,0,26,2
1657784022858,ECE 109,A01,091882,Touri; Behrouz,20,0,70,50
1657784028885,ECE 180,A00,083140,Abi Samra; Nicholas Camill,1,0,30,29
1657784028885,ECE 180,B00,083141,Abi Samra; Nicholas Camill,0,0,30,30
1657784034916,MATH 10A,A01,083735,Patchell; Gregory David,2,0,30,28
1657784034916,MATH 10A,A02,083736,Patchell; Gregory David,20,0,30,10
1657784034916,MATH 10A,A03,083737,Patchell; Gregory David,16,0,30,14
1657784040951,MATH 10B,A01,083207,Lim; Seonhee,8,0,34,26
1657784040951,MATH 10B,A02,083208,Lim; Seonhee,10,0,35,25
1657784040951,MATH 10B,A03,093472,Lim; Seonhee,7,0,34,27
1657784040951,MATH 10B,B01,083739,Sinha; Shubham,13,0,30,17
1657784046987,MATH 18,A01,083743,Cinel; Cameron Alexander,9,0,30,21
1657784046987,MATH 18,A02,083744,Cinel; Cameron Alexander,18,0,30,12
1657784046987,MATH 18,A03,083745,Cinel; Cameron Alexander,10,0,30,20
1657784046987,MATH 18,B01,083748,Rideout; David Porter,5,0,37,32
1657784046987,MATH 18,B02,083749,Rideout; David Porter,5,0,36,31
1657784046987,MATH 18,B03,083750,Rideout; David Porter,3,0,37,34
1657784046987,MATH 18,B04,083751,Rideout; David Porter,6,0,36,30
1657784046987,MATH 18,B05,093473,Rideout; David Porter,6,0,36,30
1657784046987,MATH 18,B06,093474,Rideout; David Porter,6,0,36,30
1657784053032,MATH 20A,A01,083754,Zheng; Zequn,14,0,40,26
1657784059071,MATH 20B,A01,083756,Briones; Jor-el Thomas Caparas,4,0,36,32
1657784059071,MATH 20B,A02,083757,Briones; Jor-el Thomas Caparas,1,0,36,35
1657784059071,MATH 20B,A03,093475,Briones; Jor-el Thomas Caparas,2,0,36,34
1657784065096,MATH 20C,A01,083760,Briones; Jor-el Thomas Caparas,1,0,35,34
1657784065096,MATH 20C,A02,083761,Briones; Jor-el Thomas Caparas,8,0,35,27
1657784065096,MATH 20C,A03,093476,Briones; Jor-el Thomas Caparas,0,1,36,36
1657784065096,MATH 20C,B01,083762,Bach; Quang Tran,1,0,30,29
1657784071120,MATH 20D,A01,083765,Tran; Brian Kha,5,0,30,25
1657784071120,MATH 20D,A02,083766,Tran; Brian Kha,5,0,30,25
1657784071120,MATH 20D,A03,083767,Tran; Brian Kha,5,0,30,25
1657784077148,MATH 20E,A01,083771,Ganguly; Soumya,10,0,32,22
1657784077148,MATH 20E,A02,083772,Ganguly; Soumya,6,0,32,26
1657784077148,MATH 20E,B01,083773,Ciotti; Benjamin,20,0,35,15
1657784077148,MATH 20E,B02,083774,Ciotti; Benjamin,18,0,35,17
1657784083178,MATH 103A,A01,083777,Greenfeld; Be'Eri,3,0,36,33
1657784083178,MATH 103A,A02,083778,Greenfeld; Be'Eri,5,0,36,31
1657784083178,MATH 103A,A03,093561,Greenfeld; Be'Eri,6,0,36,30
1657784083178,MATH 103A,B01,083779,Greenfeld; Be'Eri,7,0,36,29
1657784083178,MATH 103A,B02,083780,Greenfeld; Be'Eri,4,0,36,32
1657784083178,MATH 103A,B03,093562,Greenfeld; Be'Eri,3,0,36,33
1657784089208,MATH 105,A01,085443,Carter; Anne Toulson,15,0,35,20
1657784089208,MATH 105,A02,093477,Carter; Anne Toulson,20,0,35,15
1657784095241,MATH 109,A01,083213,Ganzberger; Geoffrey Michael,3,0,34,31
1657784095241,MATH 109,A02,083214,Ganzberger; Geoffrey Michael,4,0,34,30
1657784095241,MATH 109,A03,093478,Ganzberger; Geoffrey Michael,2,0,34,32
1657784095241,MATH 109,B01,083215,Ganzberger; Geoffrey Michael,1,0,32,31
1657784095241,MATH 109,B02,083216,Ganzberger; Geoffrey Michael,2,0,32,30
1657784095241,MATH 109,B03,093479,Ganzberger; Geoffrey Michael,8,0,32,24
1657784101274,MATH 142A,A01,083219,Chow; Bennett,7,0,32,25
1657784101274,MATH 142A,A02,083220,Chow; Bennett,10,0,32,22
1657784101274,MATH 142A,A03,093480,Chow; Bennett,9,0,32,23
1657784101274,MATH 142A,B03,093481,Chow; Bennett,8,0,32,24
1657784101274,MATH 142A,B04,093558,Chow; Bennett,13,0,32,19
1657784101274,MATH 142A,B05,093559,Chow; Bennett,6,0,32,26
1657784107316,MATH 193A,A01,083224,Rotar; Vladimir,8,0,34,26
1657784107316,MATH 193A,A02,083225,Rotar; Vladimir,9,0,34,25
1657784107316,MATH 193A,A03,083781,Rotar; Vladimir,5,0,34,29
1657784107316,MATH 193A,A04,083782,Rotar; Vladimir,10,0,34,24
1657784107316,MATH 193A,A05,093482,Rotar; Vladimir,10,0,34,24
1657784113341,MATH 197,001,091859,McAuley; Julian John,9999,0,9999,0
1657784113341,MATH 197,002,095566,Kedlaya; Kiran S.,9997,0,9999,2
1657784113341,MATH 197,003,095567,Xiao; Ming,9999,0,9999,0
1657784113341,MATH 197,004,095571,Perols; Johan Lars,9998,0,9999,1
1657784120413,COGS 9,A01,083615,Shannon; Kyle Michael,9,0,75,66
1657784126444,COGS 11,A01,083617,Boyle; Mary E. T.,23,0,48,25
1657784132473,COGS 13,A01,083071,Bastos; Amalia Pinkusfeld,11,0,71,60
1657784138501,COGS 14A,A01,092681,Semenuks; Arturs,5,1,100,95
1657784144543,COGS 14B,A01,083073,Cheng; Tzu-Han,6,0,63,57
1657784150568,COGS 17,A01,092677,Semenuks; Arturs,6,0,81,75
1657784156604,COGS 100,A01,083619,Allen; Michael Gordon,17,0,70,53
1657784162632,COGS 101A,A01,083621,Davis; Joshua Daniel,9,0,68,59
1657784168658,COGS 101B,A01,091572,Allen; Michael Gordon,12,0,65,53
1657784174691,COGS 101C,A01,083625,Delgado; Tania,17,0,35,18
1657784180715,COGS 107A,A01,083627,Boyle; Mary E. T.,14,0,60,46
1657784186764,COGS 118A,A01,083075,Gupta; Anjum,21,0,76,55
1657784192799,CSE 3,A50,083646,Miranda; Gregory Joseph,24,0,50,26
1657784198825,CSE 8A,A50,083650,Miranda; Gregory Joseph,17,1,56,39
1657784204849,CSE 11,A01,083080,Cao; Yingjun,6,15,40,34
1657784210878,CSE 12,A01,083652,Krause-Levy; Sophia Louisa,28,1,120,92
1657784216906,CSE 15L,A01,083654,Morris; Justin Loren,9,0,50,41
1657784216906,CSE 15L,A02,083655,Morris; Justin Loren,9,0,50,41
1657784222936,CSE 20,A01,083657,Tran; Khoa Dang,39,0,80,41
1657784228961,CSE 21,A01,095574,Bach; Quang Tran,22,0,48,26
1657784234997,CSE 30,A01,083084,Eldon; John,6,0,80,74
1657784234997,CSE 30,B01,095061,Bhaskar; Nishant,9,0,50,41
1657784241023,CSE 100,A01,083659,Cao; Yingjun,5,4,70,65
1657784247057,CSE 134B,A01,083661,Powell; Thomas Allan,24,0,100,76
1657784253083,CSE 140,A01,083663,Gungor; Onat,15,0,85,70
1657784259118,CSE 140L,A01,083088,Eldon; John,23,0,100,77
1657784265156,CSE 175,A01,083665,Kumar; Rakesh,3,0,25,22
1657784271186,CSE 190,A00,092507,Dubnov; Shlomo,8,0,20,12
1657784277217,ECE 45,A01,083139,Congero; Spencer William,6,0,75,69
1657784283251,ECE 65,A50,083695,Saad; Andrew S,12,0,30,18
1657784283251,ECE 65,A51,095125,Saad; Andrew S,24,0,26,2
1657784289284,ECE 109,A01,091882,Touri; Behrouz,20,0,70,50
1657784295314,ECE 180,A00,083140,Abi Samra; Nicholas Camill,1,0,30,29
1657784295314,ECE 180,B00,083141,Abi Samra; Nicholas Camill,0,0,30,30
1657784301343,MATH 10A,A01,083735,Patchell; Gregory David,2,0,30,28
1657784301343,MATH 10A,A02,083736,Patchell; Gregory David,20,0,30,10
1657784301343,MATH 10A,A03,083737,Patchell; Gregory David,16,0,30,14
1657784307371,MATH 10B,A01,083207,Lim; Seonhee,8,0,34,26
1657784307371,MATH 10B,A02,083208,Lim; Seonhee,10,0,35,25
1657784307371,MATH 10B,A03,093472,Lim; Seonhee,7,0,34,27
1657784307371,MATH 10B,B01,083739,Sinha; Shubham,13,0,30,17
1657784313416,MATH 18,A01,083743,Cinel; Cameron Alexander,9,0,30,21
1657784313416,MATH 18,A02,083744,Cinel; Cameron Alexander,18,0,30,12
1657784313416,MATH 18,A03,083745,Cinel; Cameron Alexander,10,0,30,20
1657784313416,MATH 18,B01,083748,Rideout; David Porter,5,0,37,32
1657784313416,MATH 18,B02,083749,Rideout; David Porter,5,0,36,31
1657784313416,MATH 18,B03,083750,Rideout; David Porter,3,0,37,34
1657784313416,MATH 18,B04,083751,Rideout; David Porter,6,0,36,30
1657784313416,MATH 18,B05,093473,Rideout; David Porter,6,0,36,30
1657784313416,MATH 18,B06,093474,Rideout; David Porter,6,0,36,30
1657784319440,MATH 20A,A01,083754,Zheng; Zequn,14,0,40,26
1657784325475,MATH 20B,A01,083756,Briones; Jor-el Thomas Caparas,4,0,36,32
1657784325475,MATH 20B,A02,083757,Briones; Jor-el Thomas Caparas,1,0,36,35
1657784325475,MATH 20B,A03,093475,Briones; Jor-el Thomas Caparas,2,0,36,34
1657784331500,MATH 20C,A01,083760,Briones; Jor-el Thomas Caparas,1,0,35,34
1657784331500,MATH 20C,A02,083761,Briones; Jor-el Thomas Caparas,8,0,35,27
1657784331500,MATH 20C,A03,093476,Briones; Jor-el Thomas Caparas,0,1,36,36
1657784331500,MATH 20C,B01,083762,Bach; Quang Tran,1,0,30,29
1657784337525,MATH 20D,A01,083765,Tran; Brian Kha,5,0,30,25
1657784337525,MATH 20D,A02,083766,Tran; Brian Kha,5,0,30,25
1657784337525,MATH 20D,A03,083767,Tran; Brian Kha,5,0,30,25
1657784343560,MATH 20E,A01,083771,Ganguly; Soumya,10,0,32,22
1657784343560,MATH 20E,A02,083772,Ganguly; Soumya,6,0,32,26
1657784343560,MATH 20E,B01,083773,Ciotti; Benjamin,20,0,35,15
1657784343560,MATH 20E,B02,083774,Ciotti; Benjamin,18,0,35,17
1657784349592,MATH 103A,A01,083777,Greenfeld; Be'Eri,3,0,36,33
1657784349592,MATH 103A,A02,083778,Greenfeld; Be'Eri,5,0,36,31
1657784349592,MATH 103A,A03,093561,Greenfeld; Be'Eri,6,0,36,30
1657784349592,MATH 103A,B01,083779,Greenfeld; Be'Eri,7,0,36,29
1657784349592,MATH 103A,B02,083780,Greenfeld; Be'Eri,4,0,36,32
1657784349592,MATH 103A,B03,093562,Greenfeld; Be'Eri,3,0,36,33
1657784355622,MATH 105,A01,085443,Carter; Anne Toulson,15,0,35,20
1657784355622,MATH 105,A02,093477,Carter; Anne Toulson,20,0,35,15
1657784361653,MATH 109,A01,083213,Ganzberger; Geoffrey Michael,3,0,34,31
1657784361653,MATH 109,A02,083214,Ganzberger; Geoffrey Michael,4,0,34,30
1657784361653,MATH 109,A03,093478,Ganzberger; Geoffrey Michael,2,0,34,32
1657784361653,MATH 109,B01,083215,Ganzberger; Geoffrey Michael,1,0,32,31
1657784361653,MATH 109,B02,083216,Ganzberger; Geoffrey Michael,2,0,32,30
1657784361653,MATH 109,B03,093479,Ganzberger; Geoffrey Michael,8,0,32,24
1657784367686,MATH 142A,A01,083219,Chow; Bennett,7,0,32,25
1657784367686,MATH 142A,A02,083220,Chow; Bennett,10,0,32,22
1657784367686,MATH 142A,A03,093480,Chow; Bennett,9,0,32,23
1657784367686,MATH 142A,B03,093481,Chow; Bennett,8,0,32,24
1657784367686,MATH 142A,B04,093558,Chow; Bennett,13,0,32,19
1657784367686,MATH 142A,B05,093559,Chow; Bennett,6,0,32,26
1657784373713,MATH 193A,A01,083224,Rotar; Vladimir,8,0,34,26
1657784373713,MATH 193A,A02,083225,Rotar; Vladimir,9,0,34,25
1657784373713,MATH 193A,A03,083781,Rotar; Vladimir,5,0,34,29
1657784373713,MATH 193A,A04,083782,Rotar; Vladimir,10,0,34,24
1657784373713,MATH 193A,A05,093482,Rotar; Vladimir,10,0,34,24
1657784379741,MATH 197,001,091859,McAuley; Julian John,9999,0,9999,0
1657784379741,MATH 197,002,095566,Kedlaya; Kiran S.,9997,0,9999,2
1657784379741,MATH 197,003,095567,Xiao; Ming,9999,0,9999,0
1657784379741,MATH 197,004,095571,Perols; Johan Lars,9998,0,9999,1
1657784386885,COGS 9,A01,083615,Shannon; Kyle Michael,9,0,75,66
1657784392912,COGS 11,A01,083617,Boyle; Mary E. T.,23,0,48,25
1657784398938,COGS 13,A01,083071,Bastos; Amalia Pinkusfeld,11,0,71,60
1657784404966,COGS 14A,A01,092681,Semenuks; Arturs,5,1,100,95
1657784410995,COGS 14B,A01,083073,Cheng; Tzu-Han,6,0,63,57
1657784417018,COGS 17,A01,092677,Semenuks; Arturs,6,0,81,75
1657784423042,COGS 100,A01,083619,Allen; Michael Gordon,17,0,70,53
1657784429066,COGS 101A,A01,083621,Davis; Joshua Daniel,9,0,68,59
1657784435091,COGS 101B,A01,091572,Allen; Michael Gordon,12,0,65,53
1657784441121,COGS 101C,A01,083625,Delgado; Tania,17,0,35,18
1657784447157,COGS 107A,A01,083627,Boyle; Mary E. T.,14,0,60,46
1657784453194,COGS 118A,A01,083075,Gupta; Anjum,21,0,76,55
1657784459230,CSE 3,A50,083646,Miranda; Gregory Joseph,24,0,50,26
1657784465269,CSE 8A,A50,083650,Miranda; Gregory Joseph,17,1,56,39
1657784471300,CSE 11,A01,083080,Cao; Yingjun,6,15,40,34
1657784477331,CSE 12,A01,083652,Krause-Levy; Sophia Louisa,28,1,120,92
1657784483365,CSE 15L,A01,083654,Morris; Justin Loren,9,0,50,41
1657784483365,CSE 15L,A02,083655,Morris; Justin Loren,9,0,50,41
1657784489391,CSE 20,A01,083657,Tran; Khoa Dang,39,0,80,41
1657784495416,CSE 21,A01,095574,Bach; Quang Tran,22,0,48,26
1657784501455,CSE 30,A01,083084,Eldon; John,6,0,80,74
1657784501455,CSE 30,B01,095061,Bhaskar; Nishant,9,0,50,41
1657784507479,CSE 100,A01,083659,Cao; Yingjun,5,4,70,65
1657784513503,CSE 134B,A01,083661,Powell; Thomas Allan,24,0,100,76
1657784519530,CSE 140,A01,083663,Gungor; Onat,15,0,85,70
1657784525559,CSE 140L,A01,083088,Eldon; John,23,0,100,77
1657784531584,CSE 175,A01,083665,Kumar; Rakesh,3,0,25,22
1657784537609,CSE 190,A00,092507,Dubnov; Shlomo,8,0,20,12
1657784543637,ECE 45,A01,083139,Congero; Spencer William,6,0,75,69
1657784549682,ECE 65,A50,083695,Saad; Andrew S,12,0,30,18
1657784549682,ECE 65,A51,095125,Saad; Andrew S,24,0,26,2
1657784555711,ECE 109,A01,091882,Touri; Behrouz,20,0,70,50
1657784561737,ECE 180,A00,083140,Abi Samra; Nicholas Camill,1,0,30,29
1657784561737,ECE 180,B00,083141,Abi Samra; Nicholas Camill,0,0,30,30
1657784567775,MATH 10A,A01,083735,Patchell; Gregory David,2,0,30,28
1657784567775,MATH 10A,A02,083736,Patchell; Gregory David,20,0,30,10
1657784567775,MATH 10A,A03,083737,Patchell; Gregory David,16,0,30,14
1657784573814,MATH 10B,A01,083207,Lim; Seonhee,8,0,34,26
1657784573814,MATH 10B,A02,083208,Lim; Seonhee,10,0,35,25
1657784573814,MATH 10B,A03,093472,Lim; Seonhee,7,0,34,27
1657784573814,MATH 10B,B01,083739,Sinha; Shubham,13,0,30,17
1657784579845,MATH 18,A01,083743,Cinel; Cameron Alexander,9,0,30,21
1657784579845,MATH 18,A02,083744,Cinel; Cameron Alexander,18,0,30,12
1657784579845,MATH 18,A03,083745,Cinel; Cameron Alexander,10,0,30,20
1657784579845,MATH 18,B01,083748,Rideout; David Porter,5,0,37,32
1657784579845,MATH 18,B02,083749,Rideout; David Porter,5,0,36,31
1657784579845,MATH 18,B03,083750,Rideout; David Porter,3,0,37,34
1657784579845,MATH 18,B04,083751,Rideout; David Porter,6,0,36,30
1657784579845,MATH 18,B05,093473,Rideout; David Porter,6,0,36,30
1657784579845,MATH 18,B06,093474,Rideout; David Porter,6,0,36,30
1657784585869,MATH 20A,A01,083754,Zheng; Zequn,14,0,40,26
1657784591894,MATH 20B,A01,083756,Briones; Jor-el Thomas Caparas,4,0,36,32
1657784591894,MATH 20B,A02,083757,Briones; Jor-el Thomas Caparas,1,0,36,35
1657784591894,MATH 20B,A03,093475,Briones; Jor-el Thomas Caparas,2,0,36,34
1657784597920,MATH 20C,A01,083760,Briones; Jor-el Thomas Caparas,1,0,35,34
1657784597920,MATH 20C,A02,083761,Briones; Jor-el Thomas Caparas,8,0,35,27
1657784597920,MATH 20C,A03,093476,Briones; Jor-el Thomas Caparas,0,1,36,36
1657784597920,MATH 20C,B01,083762,Bach; Quang Tran,1,0,30,29
1657784603949,MATH 20D,A01,083765,Tran; Brian Kha,5,0,30,25
1657784603949,MATH 20D,A02,083766,Tran; Brian Kha,5,0,30,25
1657784603949,MATH 20D,A03,083767,Tran; Brian Kha,5,0,30,25
1657784609982,MATH 20E,A01,083771,Ganguly; Soumya,10,0,32,22
1657784609982,MATH 20E,A02,083772,Ganguly; Soumya,6,0,32,26
1657784609982,MATH 20E,B01,083773,Ciotti; Benjamin,20,0,35,15
1657784609982,MATH 20E,B02,083774,Ciotti; Benjamin,18,0,35,17
1657784616011,MATH 103A,A01,083777,Greenfeld; Be'Eri,3,0,36,33
1657784616011,MATH 103A,A02,083778,Greenfeld; Be'Eri,5,0,36,31
1657784616011,MATH 103A,A03,093561,Greenfeld; Be'Eri,6,0,36,30
1657784616011,MATH 103A,B01,083779,Greenfeld; Be'Eri,7,0,36,29
1657784616011,MATH 103A,B02,083780,Greenfeld; Be'Eri,4,0,36,32
1657784616011,MATH 103A,B03,093562,Greenfeld; Be'Eri,3,0,36,33
1657784622047,MATH 105,A01,085443,Carter; Anne Toulson,15,0,35,20
1657784622047,MATH 105,A02,093477,Carter; Anne Toulson,20,0,35,15
1657784628078,MATH 109,A01,083213,Ganzberger; Geoffrey Michael,3,0,34,31
1657784628078,MATH 109,A02,083214,Ganzberger; Geoffrey Michael,4,0,34,30
1657784628078,MATH 109,A03,093478,Ganzberger; Geoffrey Michael,2,0,34,32
1657784628078,MATH 109,B01,083215,Ganzberger; Geoffrey Michael,1,0,32,31
1657784628078,MATH 109,B02,083216,Ganzberger; Geoffrey Michael,2,0,32,30
1657784628078,MATH 109,B03,093479,Ganzberger; Geoffrey Michael,8,0,32,24
1657784634113,MATH 142A,A01,083219,Chow; Bennett,7,0,32,25
1657784634113,MATH 142A,A02,083220,Chow; Bennett,10,0,32,22
1657784634113,MATH 142A,A03,093480,Chow; Bennett,9,0,32,23
1657784634113,MATH 142A,B03,093481,Chow; Bennett,8,0,32,24
1657784634113,MATH 142A,B04,093558,Chow; Bennett,13,0,32,19
1657784634113,MATH 142A,B05,093559,Chow; Bennett,6,0,32,26
1657784640140,MATH 193A,A01,083224,Rotar; Vladimir,8,0,34,26
1657784640140,MATH 193A,A02,083225,Rotar; Vladimir,9,0,34,25
1657784640140,MATH 193A,A03,083781,Rotar; Vladimir,5,0,34,29
1657784640140,MATH 193A,A04,083782,Rotar; Vladimir,10,0,34,24
1657784640140,MATH 193A,A05,093482,Rotar; Vladimir,10,0,34,24
1657784646176,MATH 197,001,091859,McAuley; Julian John,9999,0,9999,0
1657784646176,MATH 197,002,095566,Kedlaya; Kiran S.,9997,0,9999,2
1657784646176,MATH 197,003,095567,Xiao; Ming,9999,0,9999,0
1657784646176,MATH 197,004,095571,Perols; Johan Lars,9998,0,9999,1
1657784653247,COGS 9,A01,083615,Shannon; Kyle Michael,9,0,75,66
1657784659277,COGS 11,A01,083617,Boyle; Mary E. T.,23,0,48,25
1657784665301,COGS 13,A01,083071,Bastos; Amalia Pinkusfeld,11,0,71,60
1657784671327,COGS 14A,A01,092681,Semenuks; Arturs,5,1,100,95
1657784677352,COGS 14B,A01,083073,Cheng; Tzu-Han,6,0,63,57
1657784683376,COGS 17,A01,092677,Semenuks; Arturs,6,0,81,75
1657784689406,COGS 100,A01,083619,Allen; Michael Gordon,17,0,70,53
1657784695434,COGS 101A,A01,083621,Davis; Joshua Daniel,9,0,68,59
1657784701463,COGS 101B,A01,091572,Allen; Michael Gordon,12,0,65,53
1657784707487,COGS 101C,A01,083625,Delgado; Tania,17,0,35,18
1657784713520,COGS 107A,A01,083627,Boyle; Mary E. T.,14,0,60,46
1657784719546,COGS 118A,A01,083075,Gupta; Anjum,21,0,76,55
1657784725585,CSE 3,A50,083646,Miranda; Gregory Joseph,24,0,50,26
1657784731609,CSE 8A,A50,083650,Miranda; Gregory Joseph,17,1,56,39
1657784737645,CSE 11,A01,083080,Cao; Yingjun,6,15,40,34
1657784743671,CSE 12,A01,083652,Krause-Levy; Sophia Louisa,28,1,120,92
1657784749694,CSE 15L,A01,083654,Morris; Justin Loren,9,0,50,41
1657784749694,CSE 15L,A02,083655,Morris; Justin Loren,9,0,50,41
1657784755719,CSE 20,A01,083657,Tran; Khoa Dang,39,0,80,41
1657784761745,CSE 21,A01,095574,Bach; Quang Tran,22,0,48,26
1657784767778,CSE 30,A01,083084,Eldon; John,6,0,80,74
1657784767778,CSE 30,B01,095061,Bhaskar; Nishant,9,0,50,41
1657784773802,CSE 100,A01,083659,Cao; Yingjun,5,4,70,65
1657784779828,CSE 134B,A01,083661,Powell; Thomas Allan,24,0,100,76
1657784785857,CSE 140,A01,083663,Gungor; Onat,15,0,85,70
1657784791886,CSE 140L,A01,083088,Eldon; John,23,0,100,77
1657784797915,CSE 175,A01,083665,Kumar; Rakesh,3,0,25,22
1657784803949,CSE 190,A00,092507,Dubnov; Shlomo,8,0,20,12
1657784809983,ECE 45,A01,083139,Congero; Spencer William,6,0,75,69
1657784816011,ECE 65,A50,083695,Saad; Andrew S,12,0,30,18
1657784816011,ECE 65,A51,095125,Saad; Andrew S,24,0,26,2
1657784822043,ECE 109,A01,091882,Touri; Behrouz,20,0,70,50
1657784828074,ECE 180,A00,083140,Abi Samra; Nicholas Camill,1,0,30,29
1657784828074,ECE 180,B00,083141,Abi Samra; Nicholas Camill,0,0,30,30
1657784834105,MATH 10A,A01,083735,Patchell; Gregory David,2,0,30,28
1657784834105,MATH 10A,A02,083736,Patchell; Gregory David,20,0,30,10
1657784834105,MATH 10A,A03,083737,Patchell; Gregory David,16,0,30,14
1657784840134,MATH 10B,A01,083207,Lim; Seonhee,8,0,34,26
1657784840134,MATH 10B,A02,083208,Lim; Seonhee,10,0,35,25
1657784840134,MATH 10B,A03,093472,Lim; Seonhee,7,0,34,27
1657784840134,MATH 10B,B01,083739,Sinha; Shubham,13,0,30,17
1657784846175,MATH 18,A01,083743,Cinel; Cameron Alexander,9,0,30,21
1657784846175,MATH 18,A02,083744,Cinel; Cameron Alexander,18,0,30,12
1657784846175,MATH 18,A03,083745,Cinel; Cameron Alexander,10,0,30,20
1657784846175,MATH 18,B01,083748,Rideout; David Porter,5,0,37,32
1657784846175,MATH 18,B02,083749,Rideout; David Porter,5,0,36,31
1657784846175,MATH 18,B03,083750,Rideout; David Porter,3,0,37,34
1657784846175,MATH 18,B04,083751,Rideout; David Porter,6,0,36,30
1657784846175,MATH 18,B05,093473,Rideout; David Porter,6,0,36,30
1657784846175,MATH 18,B06,093474,Rideout; David Porter,6,0,36,30
1657784852201,MATH 20A,A01,083754,Zheng; Zequn,14,0,40,26
1657784858227,MATH 20B,A01,083756,Briones; Jor-el Thomas Caparas,4,0,36,32
1657784858227,MATH 20B,A02,083757,Briones; Jor-el Thomas Caparas,1,0,36,35
1657784858227,MATH 20B,A03,093475,Briones; Jor-el Thomas Caparas,2,0,36,34
1657784864254,MATH 20C,A01,083760,Briones; Jor-el Thomas Caparas,1,0,35,34
1657784864254,MATH 20C,A02,083761,Briones; Jor-el Thomas Caparas,8,0,35,27
1657784864254,MATH 20C,A03,093476,Briones; Jor-el Thomas Caparas,0,1,36,36
1657784864254,MATH 20C,B01,083762,Bach; Quang Tran,1,0,30,29
1657784870286,MATH 20D,A01,083765,Tran; Brian Kha,5,0,30,25
1657784870286,MATH 20D,A02,083766,Tran; Brian Kha,5,0,30,25
1657784870286,MATH 20D,A03,083767,Tran; Brian Kha,5,0,30,25
1657784876320,MATH 20E,A01,083771,Ganguly; Soumya,10,0,32,22
1657784876320,MATH 20E,A02,083772,Ganguly; Soumya,6,0,32,26
1657784876320,MATH 20E,B01,083773,Ciotti; Benjamin,20,0,35,15
1657784876320,MATH 20E,B02,083774,Ciotti; Benjamin,18,0,35,17
1657784882348,MATH 103A,A01,083777,Greenfeld; Be'Eri,3,0,36,33
1657784882348,MATH 103A,A02,083778,Greenfeld; Be'Eri,5,0,36,31
1657784882348,MATH 103A,A03,093561,Greenfeld; Be'Eri,6,0,36,30
1657784882348,MATH 103A,B01,083779,Greenfeld; Be'Eri,7,0,36,29
1657784882348,MATH 103A,B02,083780,Greenfeld; Be'Eri,4,0,36,32
1657784882348,MATH 103A,B03,093562,Greenfeld; Be'Eri,3,0,36,33
1657784888375,MATH 105,A01,085443,Carter; Anne Toulson,15,0,35,20
1657784888375,MATH 105,A02,093477,Carter; Anne Toulson,20,0,35,15
1657784894401,MATH 109,A01,083213,Ganzberger; Geoffrey Michael,3,0,34,31
1657784894401,MATH 109,A02,083214,Ganzberger; Geoffrey Michael,4,0,34,30
1657784894401,MATH 109,A03,093478,Ganzberger; Geoffrey Michael,2,0,34,32
1657784894401,MATH 109,B01,083215,Ganzberger; Geoffrey Michael,1,0,32,31
1657784894401,MATH 109,B02,083216,Ganzberger; Geoffrey Michael,2,0,32,30
1657784894401,MATH 109,B03,093479,Ganzberger; Geoffrey Michael,8,0,32,24
1657784900426,MATH 142A,A01,083219,Chow; Bennett,7,0,32,25
1657784900426,MATH 142A,A02,083220,Chow; Bennett,10,0,32,22
1657784900426,MATH 142A,A03,093480,Chow; Bennett,9,0,32,23
1657784900426,MATH 142A,B03,093481,Chow; Bennett,8,0,32,24
1657784900426,MATH 142A,B04,093558,Chow; Bennett,13,0,32,19
1657784900426,MATH 142A,B05,093559,Chow; Bennett,6,0,32,26
1657784906453,MATH 193A,A01,083224,Rotar; Vladimir,8,0,34,26
1657784906453,MATH 193A,A02,083225,Rotar; Vladimir,9,0,34,25
1657784906453,MATH 193A,A03,083781,Rotar; Vladimir,5,0,34,29
1657784906453,MATH 193A,A04,083782,Rotar; Vladimir,10,0,34,24
1657784906453,MATH 193A,A05,093482,Rotar; Vladimir,10,0,34,24
1657784912482,MATH 197,001,091859,McAuley; Julian John,9999,0,9999,0
1657784912482,MATH 197,002,095566,Kedlaya; Kiran S.,9997,0,9999,2
1657784912482,MATH 197,003,095567,Xiao; Ming,9999,0,9999,0
1657784912482,MATH 197,004,095571,Perols; Johan Lars,9998,0,9999,1
1657784919579,COGS 9,A01,083615,Shannon; Kyle Michael,9,0,75,66
1657784925610,COGS 11,A01,083617,Boyle; Mary E. T.,23,0,48,25
1657784931643,COGS 13,A01,083071,Bastos; Amalia Pinkusfeld,11,0,71,60
1657784937675,COGS 14A,A01,092681,Semenuks; Arturs,5,1,100,95
1657784943699,COGS 14B,A01,083073,Cheng; Tzu-Han,6,0,63,57
1657784949724,COGS 17,A01,092677,Semenuks; Arturs,6,0,81,75
1657784955749,COGS 100,A01,083619,Allen; Michael Gordon,17,0,70,53
1657784961775,COGS 101A,A01,083621,Davis; Joshua Daniel,9,0,68,59
1657784967807,COGS 101B,A01,091572,Allen; Michael Gordon,12,0,65,53
1657784973834,COGS 101C,A01,083625,Delgado; Tania,17,0,35,18
1657784979935,COGS 107A,A01,083627,Boyle; Mary E. T.,14,0,60,46
1657784985968,COGS 118A,A01,083075,Gupta; Anjum,21,0,76,55
1657784991994,CSE 3,A50,083646,Miranda; Gregory Joseph,24,0,50,26
1657784998018,CSE 8A,A50,083650,Miranda; Gregory Joseph,17,1,56,39
1657785004049,CSE 11,A01,083080,Cao; Yingjun,6,15,40,34
1657785010082,CSE 12,A01,083652,Krause-Levy; Sophia Louisa,28,1,120,92
1657785016112,CSE 15L,A01,083654,Morris; Justin Loren,9,0,50,41
1657785016112,CSE 15L,A02,083655,Morris; Justin Loren,9,0,50,41
1657785022137,CSE 20,A01,083657,Tran; Khoa Dang,39,0,80,41
1657785028161,CSE 21,A01,095574,Bach; Quang Tran,22,0,48,26
1657785034197,CSE 30,A01,083084,Eldon; John,6,0,80,74
1657785034197,CSE 30,B01,095061,Bhaskar; Nishant,9,0,50,41
1657785040223,CSE 100,A01,083659,Cao; Yingjun,5,4,70,65
1657785046247,CSE 134B,A01,083661,Powell; Thomas Allan,24,0,100,76
1657785052274,CSE 140,A01,083663,Gungor; Onat,15,0,85,70
1657785058298,CSE 140L,A01,083088,Eldon; John,23,0,100,77
1657785064324,CSE 175,A01,083665,Kumar; Rakesh,3,0,25,22
1657785070347,CSE 190,A00,092507,Dubnov; Shlomo,8,0,20,12
1657785076373,ECE 45,A01,083139,Congero; Spencer William,6,0,75,69
1657785082400,ECE 65,A50,083695,Saad; Andrew S,12,0,30,18
1657785082400,ECE 65,A51,095125,Saad; Andrew S,24,0,26,2
1657785088432,ECE 109,A01,091882,Touri; Behrouz,20,0,70,50
1657785094464,ECE 180,A00,083140,Abi Samra; Nicholas Camill,1,0,30,29
1657785094464,ECE 180,B00,083141,Abi Samra; Nicholas Camill,0,0,30,30
1657785100513,MATH 10A,A01,083735,Patchell; Gregory David,2,0,30,28
1657785100513,MATH 10A,A02,083736,Patchell; Gregory David,20,0,30,10
1657785100513,MATH 10A,A03,083737,Patchell; Gregory David,16,0,30,14
1657785106543,MATH 10B,A01,083207,Lim; Seonhee,8,0,34,26
1657785106543,MATH 10B,A02,083208,Lim; Seonhee,10,0,35,25
1657785106543,MATH 10B,A03,093472,Lim; Seonhee,7,0,34,27
1657785106543,MATH 10B,B01,083739,Sinha; Shubham,13,0,30,17
1657785112572,MATH 18,A01,083743,Cinel; Cameron Alexander,9,0,30,21
1657785112572,MATH 18,A02,083744,Cinel; Cameron Alexander,18,0,30,12
1657785112572,MATH 18,A03,083745,Cinel; Cameron Alexander,10,0,30,20
1657785112572,MATH 18,B01,083748,Rideout; David Porter,5,0,37,32
1657785112572,MATH 18,B02,083749,Rideout; David Porter,5,0,36,31
1657785112572,MATH 18,B03,083750,Rideout; David Porter,3,0,37,34
1657785112572,MATH 18,B04,083751,Rideout; David Porter,6,0,36,30
1657785112572,MATH 18,B05,093473,Rideout; David Porter,6,0,36,30
1657785112572,MATH 18,B06,093474,Rideout; David Porter,6,0,36,30
1657785118598,MATH 20A,A01,083754,Zheng; Zequn,14,0,40,26
1657785124624,MATH 20B,A01,083756,Briones; Jor-el Thomas Caparas,4,0,36,32
1657785124624,MATH 20B,A02,083757,Briones; Jor-el Thomas Caparas,1,0,36,35
1657785124624,MATH 20B,A03,093475,Briones; Jor-el Thomas Caparas,2,0,36,34
1657785130660,MATH 20C,A01,083760,Briones; Jor-el Thomas Caparas,1,0,35,34
1657785130660,MATH 20C,A02,083761,Briones; Jor-el Thomas Caparas,8,0,35,27
1657785130660,MATH 20C,A03,093476,Briones; Jor-el Thomas Caparas,0,1,36,36
1657785130660,MATH 20C,B01,083762,Bach; Quang Tran,1,0,30,29
1657785136694,MATH 20D,A01,083765,Tran; Brian Kha,5,0,30,25
1657785136694,MATH 20D,A02,083766,Tran; Brian Kha,5,0,30,25
1657785136694,MATH 20D,A03,083767,Tran; Brian Kha,5,0,30,25
1657785142729,MATH 20E,A01,083771,Ganguly; Soumya,10,0,32,22
1657785142729,MATH 20E,A02,083772,Ganguly; Soumya,6,0,32,26
1657785142729,MATH 20E,B01,083773,Ciotti; Benjamin,20,0,35,15
1657785142729,MATH 20E,B02,083774,Ciotti; Benjamin,18,0,35,17
1657785148758,MATH 103A,A01,083777,Greenfeld; Be'Eri,3,0,36,33
1657785148758,MATH 103A,A02,083778,Greenfeld; Be'Eri,5,0,36,31
1657785148758,MATH 103A,A03,093561,Greenfeld; Be'Eri,6,0,36,30
1657785148758,MATH 103A,B01,083779,Greenfeld; Be'Eri,7,0,36,29
1657785148758,MATH 103A,B02,083780,Greenfeld; Be'Eri,4,0,36,32
1657785148758,MATH 103A,B03,093562,Greenfeld; Be'Eri,3,0,36,33
1657785154784,MATH 105,A01,085443,Carter; Anne Toulson,15,0,35,20
1657785154784,MATH 105,A02,093477,Carter; Anne Toulson,20,0,35,15
1657785160812,MATH 109,A01,083213,Ganzberger; Geoffrey Michael,3,0,34,31
1657785160812,MATH 109,A02,083214,Ganzberger; Geoffrey Michael,4,0,34,30
1657785160812,MATH 109,A03,093478,Ganzberger; Geoffrey Michael,2,0,34,32
1657785160812,MATH 109,B01,083215,Ganzberger; Geoffrey Michael,1,0,32,31
1657785160812,MATH 109,B02,083216,Ganzberger; Geoffrey Michael,2,0,32,30
1657785160812,MATH 109,B03,093479,Ganzberger; Geoffrey Michael,8,0,32,24
1657785166839,MATH 142A,A01,083219,Chow; Bennett,7,0,32,25
1657785166839,MATH 142A,A02,083220,Chow; Bennett,10,0,32,22
1657785166839,MATH 142A,A03,093480,Chow; Bennett,9,0,32,23
1657785166839,MATH 142A,B03,093481,Chow; Bennett,8,0,32,24
1657785166839,MATH 142A,B04,093558,Chow; Bennett,13,0,32,19
1657785166839,MATH 142A,B05,093559,Chow; Bennett,6,0,32,26
1657785172862,MATH 193A,A01,083224,Rotar; Vladimir,8,0,34,26
1657785172862,MATH 193A,A02,083225,Rotar; Vladimir,9,0,34,25
1657785172862,MATH 193A,A03,083781,Rotar; Vladimir,5,0,34,29
1657785172862,MATH 193A,A04,083782,Rotar; Vladimir,10,0,34,24
1657785172862,MATH 193A,A05,093482,Rotar; Vladimir,10,0,34,24
1657785178893,MATH 197,001,091859,McAuley; Julian John,9999,0,9999,0
1657785178893,MATH 197,002,095566,Kedlaya; Kiran S.,9997,0,9999,2
1657785178893,MATH 197,003,095567,Xiao; Ming,9999,0,9999,0
1657785178893,MATH 197,004,095571,Perols; Johan Lars,9998,0,9999,1
1657785185983,COGS 9,A01,083615,Shannon; Kyle Michael,9,0,75,66
1657785192007,COGS 11,A01,083617,Boyle; Mary E. T.,23,0,48,25
1657785198037,COGS 13,A01,083071,Bastos; Amalia Pinkusfeld,11,0,71,60
1657785204067,COGS 14A,A01,092681,Semenuks; Arturs,5,1,100,95
1657785210095,COGS 14B,A01,083073,Cheng; Tzu-Han,6,0,63,57
1657785216125,COGS 17,A01,092677,Semenuks; Arturs,6,0,81,75
1657785222151,COGS 100,A01,083619,Allen; Michael Gordon,17,0,70,53
1657785228176,COGS 101A,A01,083621,Davis; Joshua Daniel,9,0,68,59
1657785234202,COGS 101B,A01,091572,Allen; Michael Gordon,12,0,65,53
1657785240229,COGS 101C,A01,083625,Delgado; Tania,17,0,35,18
1657785246267,COGS 107A,A01,083627,Boyle; Mary E. T.,14,0,60,46
1657785252295,COGS 118A,A01,083075,Gupta; Anjum,21,0,76,55
1657785258322,CSE 3,A50,083646,Miranda; Gregory Joseph,24,0,50,26
1657785264346,CSE 8A,A50,083650,Miranda; Gregory Joseph,17,1,56,39
1657785270369,CSE 11,A01,083080,Cao; Yingjun,6,15,40,34
1657785276397,CSE 12,A01,083652,Krause-Levy; Sophia Louisa,28,1,120,92
1657785282427,CSE 15L,A01,083654,Morris; Justin Loren,9,0,50,41
1657785282427,CSE 15L,A02,083655,Morris; Justin Loren,9,0,50,41
1657785288453,CSE 20,A01,083657,Tran; Khoa Dang,39,0,80,41
1657785294478,CSE 21,A01,095574,Bach; Quang Tran,22,0,48,26
1657785300504,CSE 30,A01,083084,Eldon; John,6,0,80,74
1657785300504,CSE 30,B01,095061,Bhaskar; Nishant,9,0,50,41
1657785306542,CSE 100,A01,083659,Cao; Yingjun,5,4,70,65
1657785312578,CSE 134B,A01,083661,Powell; Thomas Allan,24,0,100,76
1657785318602,CSE 140,A01,083663,Gungor; Onat,15,0,85,70
1657785324626,CSE 140L,A01,083088,Eldon; John,23,0,100,77
1657785330651,CSE 175,A01,083665,Kumar; Rakesh,3,0,25,22
1657785336675,CSE 190,A00,092507,Dubnov; Shlomo,8,0,20,12
1657785342699,ECE 45,A01,083139,Congero; Spencer William,6,0,75,69
1657785348724,ECE 65,A50,083695,Saad; Andrew S,12,0,30,18
1657785348724,ECE 65,A51,095125,Saad; Andrew S,24,0,26,2
1657785354750,ECE 109,A01,091882,Touri; Behrouz,20,0,70,50
1657785360774,ECE 180,A00,083140,Abi Samra; Nicholas Camill,1,0,30,29
1657785360774,ECE 180,B00,083141,Abi Samra; Nicholas Camill,0,0,30,30
1657785366807,MATH 10A,A01,083735,Patchell; Gregory David,2,0,30,28
1657785366807,MATH 10A,A02,083736,Patchell; Gregory David,20,0,30,10
1657785366807,MATH 10A,A03,083737,Patchell; Gregory David,16,0,30,14
1657785372838,MATH 10B,A01,083207,Lim; Seonhee,8,0,34,26
1657785372838,MATH 10B,A02,083208,Lim; Seonhee,10,0,35,25
1657785372838,MATH 10B,A03,093472,Lim; Seonhee,7,0,34,27
1657785372838,MATH 10B,B01,083739,Sinha; Shubham,13,0,30,17
1657785378881,MATH 18,A01,083743,Cinel; Cameron Alexander,9,0,30,21
1657785378881,MATH 18,A02,083744,Cinel; Cameron Alexander,18,0,30,12
1657785378881,MATH 18,A03,083745,Cinel; Cameron Alexander,10,0,30,20
1657785378881,MATH 18,B01,083748,Rideout; David Porter,5,0,37,32
1657785378881,MATH 18,B02,083749,Rideout; David Porter,5,0,36,31
1657785378881,MATH 18,B03,083750,Rideout; David Porter,3,0,37,34
1657785378881,MATH 18,B04,083751,Rideout; David Porter,6,0,36,30
1657785378881,MATH 18,B05,093473,Rideout; David Porter,6,0,36,30
1657785378881,MATH 18,B06,093474,Rideout; David Porter,6,0,36,30
1657785384909,MATH 20A,A01,083754,Zheng; Zequn,14,0,40,26
1657785390943,MATH 20B,A01,083756,Briones; Jor-el Thomas Caparas,4,0,36,32
1657785390943,MATH 20B,A02,083757,Briones; Jor-el Thomas Caparas,1,0,36,35
1657785390943,MATH 20B,A03,093475,Briones; Jor-el Thomas Caparas,2,0,36,34
1657785396970,MATH 20C,A01,083760,Briones; Jor-el Thomas Caparas,1,0,35,34
1657785396970,MATH 20C,A02,083761,Briones; Jor-el Thomas Caparas,8,0,35,27
1657785396970,MATH 20C,A03,093476,Briones; Jor-el Thomas Caparas,0,1,36,36
1657785396970,MATH 20C,B01,083762,Bach; Quang Tran,1,0,30,29
1657785403002,MATH 20D,A01,083765,Tran; Brian Kha,5,0,30,25
1657785403002,MATH 20D,A02,083766,Tran; Brian Kha,5,0,30,25
1657785403002,MATH 20D,A03,083767,Tran; Brian Kha,5,0,30,25
1657785409027,MATH 20E,A01,083771,Ganguly; Soumya,10,0,32,22
1657785409027,MATH 20E,A02,083772,Ganguly; Soumya,6,0,32,26
1657785409027,MATH 20E,B01,083773,Ciotti; Benjamin,20,0,35,15
1657785409027,MATH 20E,B02,083774,Ciotti; Benjamin,18,0,35,17
1657785415064,MATH 103A,A01,083777,Greenfeld; Be'Eri,3,0,36,33
1657785415064,MATH 103A,A02,083778,Greenfeld; Be'Eri,5,0,36,31
1657785415064,MATH 103A,A03,093561,Greenfeld; Be'Eri,6,0,36,30
1657785415064,MATH 103A,B01,083779,Greenfeld; Be'Eri,7,0,36,29
1657785415064,MATH 103A,B02,083780,Greenfeld; Be'Eri,4,0,36,32
1657785415064,MATH 103A,B03,093562,Greenfeld; Be'Eri,3,0,36,33
1657785421091,MATH 105,A01,085443,Carter; Anne Toulson,15,0,35,20
1657785421091,MATH 105,A02,093477,Carter; Anne Toulson,20,0,35,15
1657785427116,MATH 109,A01,083213,Ganzberger; Geoffrey Michael,3,0,34,31
1657785427116,MATH 109,A02,083214,Ganzberger; Geoffrey Michael,4,0,34,30
1657785427116,MATH 109,A03,093478,Ganzberger; Geoffrey Michael,2,0,34,32
1657785427116,MATH 109,B01,083215,Ganzberger; Geoffrey Michael,1,0,32,31
1657785427116,MATH 109,B02,083216,Ganzberger; Geoffrey Michael,2,0,32,30
1657785427116,MATH 109,B03,093479,Ganzberger; Geoffrey Michael,8,0,32,24
1657785433142,MATH 142A,A01,083219,Chow; Bennett,7,0,32,25
1657785433142,MATH 142A,A02,083220,Chow; Bennett,10,0,32,22
1657785433142,MATH 142A,A03,093480,Chow; Bennett,9,0,32,23
1657785433142,MATH 142A,B03,093481,Chow; Bennett,8,0,32,24
1657785433142,MATH 142A,B04,093558,Chow; Bennett,13,0,32,19
1657785433142,MATH 142A,B05,093559,Chow; Bennett,6,0,32,26
1657785439167,MATH 193A,A01,083224,Rotar; Vladimir,8,0,34,26
1657785439167,MATH 193A,A02,083225,Rotar; Vladimir,9,0,34,25
1657785439167,MATH 193A,A03,083781,Rotar; Vladimir,5,0,34,29
1657785439167,MATH 193A,A04,083782,Rotar; Vladimir,10,0,34,24
1657785439167,MATH 193A,A05,093482,Rotar; Vladimir,10,0,34,24
1657785445193,MATH 197,001,091859,McAuley; Julian John,9999,0,9999,0
1657785445193,MATH 197,002,095566,Kedlaya; Kiran S.,9997,0,9999,2
1657785445193,MATH 197,003,095567,Xiao; Ming,9999,0,9999,0
1657785445193,MATH 197,004,095571,Perols; Johan Lars,9998,0,9999,1
1657785452272,COGS 9,A01,083615,Shannon; Kyle Michael,9,0,75,66
1657785458302,COGS 11,A01,083617,Boyle; Mary E. T.,23,0,48,25
1657785464328,COGS 13,A01,083071,Bastos; Amalia Pinkusfeld,11,0,71,60
1657785470351,COGS 14A,A01,092681,Semenuks; Arturs,5,1,100,95
1657785476376,COGS 14B,A01,083073,Cheng; Tzu-Han,6,0,63,57
1657785482403,COGS 17,A01,092677,Semenuks; Arturs,6,0,81,75
1657785488433,COGS 100,A01,083619,Allen; Michael Gordon,17,0,70,53
1657785494456,COGS 101A,A01,083621,Davis; Joshua Daniel,9,0,68,59
1657785500486,COGS 101B,A01,091572,Allen; Michael Gordon,12,0,65,53
1657785506510,COGS 101C,A01,083625,Delgado; Tania,17,0,35,18
1657785512534,COGS 107A,A01,083627,Boyle; Mary E. T.,14,0,60,46
1657785518561,COGS 118A,A01,083075,Gupta; Anjum,21,0,76,55
1657785524586,CSE 3,A50,083646,Miranda; Gregory Joseph,24,0,50,26
1657785530610,CSE 8A,A50,083650,Miranda; Gregory Joseph,17,1,56,39
1657785536633,CSE 11,A01,083080,Cao; Yingjun,6,15,40,34
1657785542663,CSE 12,A01,083652,Krause-Levy; Sophia Louisa,28,1,120,92
1657785548700,CSE 15L,A01,083654,Morris; Justin Loren,9,0,50,41
1657785548700,CSE 15L,A02,083655,Morris; Justin Loren,9,0,50,41
1657785554725,CSE 20,A01,083657,Tran; Khoa Dang,39,0,80,41
1657785560752,CSE 21,A01,095574,Bach; Quang Tran,22,0,48,26
1657785566781,CSE 30,A01,083084,Eldon; John,6,0,80,74
1657785566781,CSE 30,B01,095061,Bhaskar; Nishant,9,0,50,41
1657785572805,CSE 100,A01,083659,Cao; Yingjun,5,4,70,65
1657785578900,CSE 134B,A01,083661,Powell; Thomas Allan,24,0,100,76
1657785584933,CSE 140,A01,083663,Gungor; Onat,15,0,85,70
1657785590956,CSE 140L,A01,083088,Eldon; John,23,0,100,77
1657785596980,CSE 175,A01,083665,Kumar; Rakesh,3,0,25,22
1657785603004,CSE 190,A00,092507,Dubnov; Shlomo,8,0,20,12
1657785609029,ECE 45,A01,083139,Congero; Spencer William,6,0,75,69
1657785615054,ECE 65,A50,083695,Saad; Andrew S,12,0,30,18
1657785615054,ECE 65,A51,095125,Saad; Andrew S,24,0,26,2
1657785621078,ECE 109,A01,091882,Touri; Behrouz,20,0,70,50
1657785627106,ECE 180,A00,083140,Abi Samra; Nicholas Camill,1,0,30,29
1657785627106,ECE 180,B00,083141,Abi Samra; Nicholas Camill,0,0,30,30
1657785633133,MATH 10A,A01,083735,Patchell; Gregory David,2,0,30,28
1657785633133,MATH 10A,A02,083736,Patchell; Gregory David,20,0,30,10
1657785633133,MATH 10A,A03,083737,Patchell; Gregory David,16,0,30,14
1657785639159,MATH 10B,A01,083207,Lim; Seonhee,8,0,34,26
1657785639159,MATH 10B,A02,083208,Lim; Seonhee,10,0,35,25
1657785639159,MATH 10B,A03,093472,Lim; Seonhee,7,0,34,27
1657785639159,MATH 10B,B01,083739,Sinha; Shubham,13,0,30,17
1657785645193,MATH 18,A01,083743,Cinel; Cameron Alexander,9,0,30,21
1657785645193,MATH 18,A02,083744,Cinel; Cameron Alexander,18,0,30,12
1657785645193,MATH 18,A03,083745,Cinel; Cameron Alexander,10,0,30,20
1657785645193,MATH 18,B01,083748,Rideout; David Porter,5,0,37,32
1657785645193,MATH 18,B02,083749,Rideout; David Porter,5,0,36,31
1657785645193,MATH 18,B03,083750,Rideout; David Porter,3,0,37,34
1657785645193,MATH 18,B04,083751,Rideout; David Porter,6,0,36,30
1657785645193,MATH 18,B05,093473,Rideout; David Porter,6,0,36,30
1657785645193,MATH 18,B06,093474,Rideout; David Porter,6,0,36,30
1657785651217,MATH 20A,A01,083754,Zheng; Zequn,14,0,40,26
1657785657242,MATH 20B,A01,083756,Briones; Jor-el Thomas Caparas,4,0,36,32
1657785657242,MATH 20B,A02,083757,Briones; Jor-el Thomas Caparas,1,0,36,35
1657785657242,MATH 20B,A03,093475,Briones; Jor-el Thomas Caparas,2,0,36,34
1657785663269,MATH 20C,A01,083760,Briones; Jor-el Thomas Caparas,1,0,35,34
1657785663269,MATH 20C,A02,083761,Briones; Jor-el Thomas Caparas,8,0,35,27
1657785663269,MATH 20C,A03,093476,Briones; Jor-el Thomas Caparas,0,1,36,36
1657785663269,MATH 20C,B01,083762,Bach; Quang Tran,1,0,30,29
1657785669300,MATH 20D,A01,083765,Tran; Brian Kha,5,0,30,25
1657785669300,MATH 20D,A02,083766,Tran; Brian Kha,5,0,30,25
1657785669300,MATH 20D,A03,083767,Tran; Brian Kha,5,0,30,25
1657785675337,MATH 20E,A01,083771,Ganguly; Soumya,10,0,32,22
1657785675337,MATH 20E,A02,083772,Ganguly; Soumya,6,0,32,26
1657785675337,MATH 20E,B01,083773,Ciotti; Benjamin,20,0,35,15
1657785675337,MATH 20E,B02,083774,Ciotti; Benjamin,18,0,35,17
1657785681362,MATH 103A,A01,083777,Greenfeld; Be'Eri,3,0,36,33
1657785681362,MATH 103A,A02,083778,Greenfeld; Be'Eri,5,0,36,31
1657785681362,MATH 103A,A03,093561,Greenfeld; Be'Eri,6,0,36,30
1657785681362,MATH 103A,B01,083779,Greenfeld; Be'Eri,7,0,36,29
1657785681362,MATH 103A,B02,083780,Greenfeld; Be'Eri,4,0,36,32
1657785681362,MATH 103A,B03,093562,Greenfeld; Be'Eri,3,0,36,33
1657785687389,MATH 105,A01,085443,Carter; Anne Toulson,15,0,35,20
1657785687389,MATH 105,A02,093477,Carter; Anne Toulson,20,0,35,15
1657785693414,MATH 109,A01,083213,Ganzberger; Geoffrey Michael,3,0,34,31
1657785693414,MATH 109,A02,083214,Ganzberger; Geoffrey Michael,4,0,34,30
1657785693414,MATH 109,A03,093478,Ganzberger; Geoffrey Michael,2,0,34,32
1657785693414,MATH 109,B01,083215,Ganzberger; Geoffrey Michael,1,0,32,31
1657785693414,MATH 109,B02,083216,Ganzberger; Geoffrey Michael,2,0,32,30
1657785693414,MATH 109,B03,093479,Ganzberger; Geoffrey Michael,8,0,32,24
1657785699450,MATH 142A,A01,083219,Chow; Bennett,7,0,32,25
1657785699450,MATH 142A,A02,083220,Chow; Bennett,10,0,32,22
1657785699450,MATH 142A,A03,093480,Chow; Bennett,9,0,32,23
1657785699450,MATH 142A,B03,093481,Chow; Bennett,8,0,32,24
1657785699450,MATH 142A,B04,093558,Chow; Bennett,13,0,32,19
1657785699450,MATH 142A,B05,093559,Chow; Bennett,6,0,32,26
1657785705475,MATH 193A,A01,083224,Rotar; Vladimir,8,0,34,26
1657785705475,MATH 193A,A02,083225,Rotar; Vladimir,9,0,34,25
1657785705475,MATH 193A,A03,083781,Rotar; Vladimir,5,0,34,29
1657785705475,MATH 193A,A04,083782,Rotar; Vladimir,10,0,34,24
1657785705475,MATH 193A,A05,093482,Rotar; Vladimir,10,0,34,24
1657785711499,MATH 197,001,091859,McAuley; Julian John,9999,0,9999,0
1657785711499,MATH 197,002,095566,Kedlaya; Kiran S.,9997,0,9999,2
1657785711499,MATH 197,003,095567,Xiao; Ming,9999,0,9999,0
1657785711499,MATH 197,004,095571,Perols; Johan Lars,9998,0,9999,1
1657785718574,COGS 9,A01,083615,Shannon; Kyle Michael,9,0,75,66
1657785724600,COGS 11,A01,083617,Boyle; Mary E. T.,23,0,48,25
1657785730625,COGS 13,A01,083071,Bastos; Amalia Pinkusfeld,11,0,71,60
1657785736650,COGS 14A,A01,092681,Semenuks; Arturs,5,1,100,95
1657785742678,COGS 14B,A01,083073,Cheng; Tzu-Han,6,0,63,57
1657785748702,COGS 17,A01,092677,Semenuks; Arturs,6,0,81,75
1657785754725,COGS 100,A01,083619,Allen; Michael Gordon,17,0,70,53
1657785760748,COGS 101A,A01,083621,Davis; Joshua Daniel,9,0,68,59
1657785766775,COGS 101B,A01,091572,Allen; Michael Gordon,12,0,65,53
1657785772799,COGS 101C,A01,083625,Delgado; Tania,17,0,35,18
1657785778821,COGS 107A,A01,083627,Boyle; Mary E. T.,14,0,60,46
1657785784844,COGS 118A,A01,083075,Gupta; Anjum,21,0,76,55
1657785790869,CSE 3,A50,083646,Miranda; Gregory Joseph,24,0,50,26
1657785796898,CSE 8A,A50,083650,Miranda; Gregory Joseph,17,1,56,39
1657785802921,CSE 11,A01,083080,Cao; Yingjun,6,15,40,34
1657785808946,CSE 12,A01,083652,Krause-Levy; Sophia Louisa,28,1,120,92
1657785814968,CSE 15L,A01,083654,Morris; Justin Loren,9,0,50,41
1657785814968,CSE 15L,A02,083655,Morris; Justin Loren,9,0,50,41
1657785820995,CSE 20,A01,083657,Tran; Khoa Dang,39,0,80,41
1657785827022,CSE 21,A01,095574,Bach; Quang Tran,22,0,48,26
1657785833054,CSE 30,A01,083084,Eldon; John,6,0,80,74
1657785833054,CSE 30,B01,095061,Bhaskar; Nishant,9,0,50,41
1657785839083,CSE 100,A01,083659,Cao; Yingjun,5,4,70,65
1657785845110,CSE 134B,A01,083661,Powell; Thomas Allan,24,0,100,76
1657785851133,CSE 140,A01,083663,Gungor; Onat,15,0,85,70
1657785857159,CSE 140L,A01,083088,Eldon; John,23,0,100,77
1657785863185,CSE 175,A01,083665,Kumar; Rakesh,3,0,25,22
1657785869210,CSE 190,A00,092507,Dubnov; Shlomo,8,0,20,12
1657785875234,ECE 45,A01,083139,Congero; Spencer William,6,0,75,69
1657785881262,ECE 65,A50,083695,Saad; Andrew S,12,0,30,18
1657785881262,ECE 65,A51,095125,Saad; Andrew S,24,0,26,2
1657785887287,ECE 109,A01,091882,Touri; Behrouz,20,0,70,50
1657785893311,ECE 180,A00,083140,Abi Samra; Nicholas Camill,1,0,30,29
1657785893311,ECE 180,B00,083141,Abi Samra; Nicholas Camill,0,0,30,30
1657785899341,MATH 10A,A01,083735,Patchell; Gregory David,2,0,30,28
1657785899341,MATH 10A,A02,083736,Patchell; Gregory David,20,0,30,10
1657785899341,MATH 10A,A03,083737,Patchell; Gregory David,16,0,30,14
1657785905367,MATH 10B,A01,083207,Lim; Seonhee,8,0,34,26
1657785905367,MATH 10B,A02,083208,Lim; Seonhee,10,0,35,25
1657785905367,MATH 10B,A03,093472,Lim; Seonhee,7,0,34,27
1657785905367,MATH 10B,B01,083739,Sinha; Shubham,13,0,30,17
1657785911391,MATH 18,A01,083743,Cinel; Cameron Alexander,9,0,30,21
1657785911391,MATH 18,A02,083744,Cinel; Cameron Alexander,18,0,30,12
1657785911391,MATH 18,A03,083745,Cinel; Cameron Alexander,10,0,30,20
1657785911391,MATH 18,B01,083748,Rideout; David Porter,5,0,37,32
1657785911391,MATH 18,B02,083749,Rideout; David Porter,5,0,36,31
1657785911391,MATH 18,B03,083750,Rideout; David Porter,3,0,37,34
1657785911391,MATH 18,B04,083751,Rideout; David Porter,6,0,36,30
1657785911391,MATH 18,B05,093473,Rideout; David Porter,6,0,36,30
1657785911391,MATH 18,B06,093474,Rideout; David Porter,6,0,36,30
1657785917413,MATH 20A,A01,083754,Zheng; Zequn,14,0,40,26
1657785923441,MATH 20B,A01,083756,Briones; Jor-el Thomas Caparas,4,0,36,32
1657785923441,MATH 20B,A02,083757,Briones; Jor-el Thomas Caparas,1,0,36,35
1657785923441,MATH 20B,A03,093475,Briones; Jor-el Thomas Caparas,2,0,36,34
1657785929466,MATH 20C,A01,083760,Briones; Jor-el Thomas Caparas,1,0,35,34
1657785929466,MATH 20C,A02,083761,Briones; Jor-el Thomas Caparas,8,0,35,27
1657785929466,MATH 20C,A03,093476,Briones; Jor-el Thomas Caparas,0,1,36,36
1657785929466,MATH 20C,B01,083762,Bach; Quang Tran,1,0,30,29
1657785935491,MATH 20D,A01,083765,Tran; Brian Kha,5,0,30,25
1657785935491,MATH 20D,A02,083766,Tran; Brian Kha,5,0,30,25
1657785935491,MATH 20D,A03,083767,Tran; Brian Kha,5,0,30,25
1657785941524,MATH 20E,A01,083771,Ganguly; Soumya,10,0,32,22
1657785941524,MATH 20E,A02,083772,Ganguly; Soumya,6,0,32,26
1657785941524,MATH 20E,B01,083773,Ciotti; Benjamin,20,0,35,15
1657785941524,MATH 20E,B02,083774,Ciotti; Benjamin,18,0,35,17
1657785947548,MATH 103A,A01,083777,Greenfeld; Be'Eri,3,0,36,33
1657785947548,MATH 103A,A02,083778,Greenfeld; Be'Eri,5,0,36,31
1657785947548,MATH 103A,A03,093561,Greenfeld; Be'Eri,6,0,36,30
1657785947548,MATH 103A,B01,083779,Greenfeld; Be'Eri,7,0,36,29
1657785947548,MATH 103A,B02,083780,Greenfeld; Be'Eri,4,0,36,32
1657785947548,MATH 103A,B03,093562,Greenfeld; Be'Eri,3,0,36,33
1657785953571,MATH 105,A01,085443,Carter; Anne Toulson,15,0,35,20
1657785953571,MATH 105,A02,093477,Carter; Anne Toulson,20,0,35,15
1657785959595,MATH 109,A01,083213,Ganzberger; Geoffrey Michael,3,0,34,31
1657785959595,MATH 109,A02,083214,Ganzberger; Geoffrey Michael,4,0,34,30
1657785959595,MATH 109,A03,093478,Ganzberger; Geoffrey Michael,2,0,34,32
1657785959595,MATH 109,B01,083215,Ganzberger; Geoffrey Michael,1,0,32,31
1657785959595,MATH 109,B02,083216,Ganzberger; Geoffrey Michael,2,0,32,30
1657785959595,MATH 109,B03,093479,Ganzberger; Geoffrey Michael,8,0,32,24
1657785965630,MATH 142A,A01,083219,Chow; Bennett,7,0,32,25
1657785965630,MATH 142A,A02,083220,Chow; Bennett,10,0,32,22
1657785965630,MATH 142A,A03,093480,Chow; Bennett,9,0,32,23
1657785965630,MATH 142A,B03,093481,Chow; Bennett,8,0,32,24
1657785965630,MATH 142A,B04,093558,Chow; Bennett,13,0,32,19
1657785965630,MATH 142A,B05,093559,Chow; Bennett,6,0,32,26
1657785971659,MATH 193A,A01,083224,Rotar; Vladimir,8,0,34,26
1657785971659,MATH 193A,A02,083225,Rotar; Vladimir,9,0,34,25
1657785971659,MATH 193A,A03,083781,Rotar; Vladimir,5,0,34,29
1657785971659,MATH 193A,A04,083782,Rotar; Vladimir,10,0,34,24
1657785971659,MATH 193A,A05,093482,Rotar; Vladimir,10,0,34,24
1657785977688,MATH 197,001,091859,McAuley; Julian John,9999,0,9999,0
1657785977688,MATH 197,002,095566,Kedlaya; Kiran S.,9997,0,9999,2
1657785977688,MATH 197,003,095567,Xiao; Ming,9999,0,9999,0
1657785977688,MATH 197,004,095571,Perols; Johan Lars,9998,0,9999,1
1657785984758,COGS 9,A01,083615,Shannon; Kyle Michael,9,0,75,66
1657785990785,COGS 11,A01,083617,Boyle; Mary E. T.,23,0,48,25
1657785996809,COGS 13,A01,083071,Bastos; Amalia Pinkusfeld,11,0,71,60
1657786002834,COGS 14A,A01,092681,Semenuks; Arturs,5,1,100,95
1657786008859,COGS 14B,A01,083073,Cheng; Tzu-Han,6,0,63,57
1657786014882,COGS 17,A01,092677,Semenuks; Arturs,6,0,81,75
1657786020905,COGS 100,A01,083619,Allen; Michael Gordon,17,0,70,53
1657786026929,COGS 101A,A01,083621,Davis; Joshua Daniel,9,0,68,59
1657786032952,COGS 101B,A01,091572,Allen; Michael Gordon,12,0,65,53
1657786038979,COGS 101C,A01,083625,Delgado; Tania,17,0,35,18
1657786045003,COGS 107A,A01,083627,Boyle; Mary E. T.,14,0,60,46
1657786051026,COGS 118A,A01,083075,Gupta; Anjum,21,0,76,55
1657786057055,CSE 3,A50,083646,Miranda; Gregory Joseph,24,0,50,26
1657786063080,CSE 8A,A50,083650,Miranda; Gregory Joseph,17,1,56,39
1657786069120,CSE 11,A01,083080,Cao; Yingjun,6,15,40,34
1657786075143,CSE 12,A01,083652,Krause-Levy; Sophia Louisa,28,1,120,92
1657786081169,CSE 15L,A01,083654,Morris; Justin Loren,9,0,50,41
1657786081169,CSE 15L,A02,083655,Morris; Justin Loren,9,0,50,41
1657786087192,CSE 20,A01,083657,Tran; Khoa Dang,39,0,80,41
1657786093216,CSE 21,A01,095574,Bach; Quang Tran,22,0,48,26
1657786099244,CSE 30,A01,083084,Eldon; John,6,0,80,74
1657786099244,CSE 30,B01,095061,Bhaskar; Nishant,9,0,50,41
1657786105269,CSE 100,A01,083659,Cao; Yingjun,5,4,70,65
1657786111291,CSE 134B,A01,083661,Powell; Thomas Allan,24,0,100,76
1657786117320,CSE 140,A01,083663,Gungor; Onat,15,0,85,70
1657786123343,CSE 140L,A01,083088,Eldon; John,23,0,100,77
1657786129371,CSE 175,A01,083665,Kumar; Rakesh,3,0,25,22
1657786135395,CSE 190,A00,092507,Dubnov; Shlomo,8,0,20,12
1657786141421,ECE 45,A01,083139,Congero; Spencer William,6,0,75,69
1657786147450,ECE 65,A50,083695,Saad; Andrew S,12,0,30,18
1657786147450,ECE 65,A51,095125,Saad; Andrew S,24,0,26,2
1657786153473,ECE 109,A01,091882,Touri; Behrouz,20,0,70,50
1657786159496,ECE 180,A00,083140,Abi Samra; Nicholas Camill,1,0,30,29
1657786159496,ECE 180,B00,083141,Abi Samra; Nicholas Camill,0,0,30,30
1657786165526,MATH 10A,A01,083735,Patchell; Gregory David,2,0,30,28
1657786165526,MATH 10A,A02,083736,Patchell; Gregory David,20,0,30,10
1657786165526,MATH 10A,A03,083737,Patchell; Gregory David,16,0,30,14
1657786171552,MATH 10B,A01,083207,Lim; Seonhee,8,0,34,26
1657786171552,MATH 10B,A02,083208,Lim; Seonhee,10,0,35,25
1657786171552,MATH 10B,A03,093472,Lim; Seonhee,7,0,34,27
1657786171552,MATH 10B,B01,083739,Sinha; Shubham,13,0,30,17
1657786177654,MATH 18,A01,083743,Cinel; Cameron Alexander,9,0,30,21
1657786177654,MATH 18,A02,083744,Cinel; Cameron Alexander,18,0,30,12
1657786177654,MATH 18,A03,083745,Cinel; Cameron Alexander,10,0,30,20
1657786177654,MATH 18,B01,083748,Rideout; David Porter,5,0,37,32
1657786177654,MATH 18,B02,083749,Rideout; David Porter,5,0,36,31
1657786177654,MATH 18,B03,083750,Rideout; David Porter,3,0,37,34
1657786177654,MATH 18,B04,083751,Rideout; David Porter,6,0,36,30
1657786177654,MATH 18,B05,093473,Rideout; David Porter,6,0,36,30
1657786177654,MATH 18,B06,093474,Rideout; David Porter,6,0,36,30
1657786183681,MATH 20A,A01,083754,Zheng; Zequn,14,0,40,26
1657786189713,MATH 20B,A01,083756,Briones; Jor-el Thomas Caparas,4,0,36,32
1657786189713,MATH 20B,A02,083757,Briones; Jor-el Thomas Caparas,1,0,36,35
1657786189713,MATH 20B,A03,093475,Briones; Jor-el Thomas Caparas,2,0,36,34
1657786195743,MATH 20C,A01,083760,Briones; Jor-el Thomas Caparas,1,0,35,34
1657786195743,MATH 20C,A02,083761,Briones; Jor-el Thomas Caparas,8,0,35,27
1657786195743,MATH 20C,A03,093476,Briones; Jor-el Thomas Caparas,0,1,36,36
1657786195743,MATH 20C,B01,083762,Bach; Quang Tran,1,0,30,29
1657786201777,MATH 20D,A01,083765,Tran; Brian Kha,5,0,30,25
1657786201777,MATH 20D,A02,083766,Tran; Brian Kha,5,0,30,25
1657786201777,MATH 20D,A03,083767,Tran; Brian Kha,5,0,30,25
1657786207803,MATH 20E,A01,083771,Ganguly; Soumya,10,0,32,22
1657786207803,MATH 20E,A02,083772,Ganguly; Soumya,6,0,32,26
1657786207803,MATH 20E,B01,083773,Ciotti; Benjamin,20,0,35,15
1657786207803,MATH 20E,B02,083774,Ciotti; Benjamin,18,0,35,17
1657786213829,MATH 103A,A01,083777,Greenfeld; Be'Eri,3,0,36,33
1657786213829,MATH 103A,A02,083778,Greenfeld; Be'Eri,5,0,36,31
1657786213829,MATH 103A,A03,093561,Greenfeld; Be'Eri,6,0,36,30
1657786213829,MATH 103A,B01,083779,Greenfeld; Be'Eri,7,0,36,29
1657786213829,MATH 103A,B02,083780,Greenfeld; Be'Eri,4,0,36,32
1657786213829,MATH 103A,B03,093562,Greenfeld; Be'Eri,3,0,36,33
1657786219855,MATH 105,A01,085443,Carter; Anne Toulson,15,0,35,20
1657786219855,MATH 105,A02,093477,Carter; Anne Toulson,20,0,35,15
1657786225886,MATH 109,A01,083213,Ganzberger; Geoffrey Michael,3,0,34,31
1657786225886,MATH 109,A02,083214,Ganzberger; Geoffrey Michael,4,0,34,30
1657786225886,MATH 109,A03,093478,Ganzberger; Geoffrey Michael,2,0,34,32
1657786225886,MATH 109,B01,083215,Ganzberger; Geoffrey Michael,1,0,32,31
1657786225886,MATH 109,B02,083216,Ganzberger; Geoffrey Michael,2,0,32,30
1657786225886,MATH 109,B03,093479,Ganzberger; Geoffrey Michael,8,0,32,24
1657786231917,MATH 142A,A01,083219,Chow; Bennett,7,0,32,25
1657786231917,MATH 142A,A02,083220,Chow; Bennett,10,0,32,22
1657786231917,MATH 142A,A03,093480,Chow; Bennett,9,0,32,23
1657786231917,MATH 142A,B03,093481,Chow; Bennett,8,0,32,24
1657786231917,MATH 142A,B04,093558,Chow; Bennett,13,0,32,19
1657786231917,MATH 142A,B05,093559,Chow; Bennett,6,0,32,26
1657786237941,MATH 193A,A01,083224,Rotar; Vladimir,8,0,34,26
1657786237941,MATH 193A,A02,083225,Rotar; Vladimir,9,0,34,25
1657786237941,MATH 193A,A03,083781,Rotar; Vladimir,5,0,34,29
1657786237941,MATH 193A,A04,083782,Rotar; Vladimir,10,0,34,24
1657786237941,MATH 193A,A05,093482,Rotar; Vladimir,10,0,34,24
1657786243965,MATH 197,001,091859,McAuley; Julian John,9999,0,9999,0
1657786243965,MATH 197,002,095566,Kedlaya; Kiran S.,9997,0,9999,2
1657786243965,MATH 197,003,095567,Xiao; Ming,9999,0,9999,0
1657786243965,MATH 197,004,095571,Perols; Johan Lars,9998,0,9999,1
1657786251027,COGS 9,A01,083615,Shannon; Kyle Michael,9,0,75,66
1657786257051,COGS 11,A01,083617,Boyle; Mary E. T.,23,0,48,25
1657786263074,COGS 13,A01,083071,Bastos; Amalia Pinkusfeld,11,0,71,60
1657786269100,COGS 14A,A01,092681,Semenuks; Arturs,5,1,100,95
1657786275130,COGS 14B,A01,083073,Cheng; Tzu-Han,6,0,63,57
1657786281155,COGS 17,A01,092677,Semenuks; Arturs,6,0,81,75
1657786287186,COGS 100,A01,083619,Allen; Michael Gordon,17,0,70,53
1657786293211,COGS 101A,A01,083621,Davis; Joshua Daniel,9,0,68,59
1657786299241,COGS 101B,A01,091572,Allen; Michael Gordon,12,0,65,53
1657786305269,COGS 101C,A01,083625,Delgado; Tania,17,0,35,18
1657786311314,COGS 107A,A01,083627,Boyle; Mary E. T.,14,0,60,46
1657786317347,COGS 118A,A01,083075,Gupta; Anjum,21,0,76,55
1657786323377,CSE 3,A50,083646,Miranda; Gregory Joseph,24,0,50,26
1657786329401,CSE 8A,A50,083650,Miranda; Gregory Joseph,17,1,56,39
1657786335425,CSE 11,A01,083080,Cao; Yingjun,6,15,40,34
1657786341459,CSE 12,A01,083652,Krause-Levy; Sophia Louisa,28,1,120,92
1657786347482,CSE 15L,A01,083654,Morris; Justin Loren,9,0,50,41
1657786347482,CSE 15L,A02,083655,Morris; Justin Loren,9,0,50,41
1657786353514,CSE 20,A01,083657,Tran; Khoa Dang,39,0,80,41
1657786359543,CSE 21,A01,095574,Bach; Quang Tran,22,0,48,26
1657786365667,CSE 30,A01,083084,Eldon; John,6,0,80,74
1657786365667,CSE 30,B01,095061,Bhaskar; Nishant,9,0,50,41
1657786371699,CSE 100,A01,083659,Cao; Yingjun,5,4,70,65
1657786377741,CSE 134B,A01,083661,Powell; Thomas Allan,24,0,100,76
1657786383766,CSE 140,A01,083663,Gungor; Onat,15,0,85,70
1657786389795,CSE 140L,A01,083088,Eldon; John,23,0,100,77
1657786395820,CSE 175,A01,083665,Kumar; Rakesh,3,0,25,22
1657786401850,CSE 190,A00,092507,Dubnov; Shlomo,8,0,20,12
1657786407875,ECE 45,A01,083139,Congero; Spencer William,6,0,75,69
1657786413913,ECE 65,A50,083695,Saad; Andrew S,12,0,30,18
1657786413913,ECE 65,A51,095125,Saad; Andrew S,24,0,26,2
1657786419938,ECE 109,A01,091882,Touri; Behrouz,20,0,70,50
1657786425961,ECE 180,A00,083140,Abi Samra; Nicholas Camill,1,0,30,29
1657786425961,ECE 180,B00,083141,Abi Samra; Nicholas Camill,0,0,30,30
1657786431987,MATH 10A,A01,083735,Patchell; Gregory David,2,0,30,28
1657786431987,MATH 10A,A02,083736,Patchell; Gregory David,20,0,30,10
1657786431987,MATH 10A,A03,083737,Patchell; Gregory David,16,0,30,14
1657786438014,MATH 10B,A01,083207,Lim; Seonhee,8,0,34,26
1657786438014,MATH 10B,A02,083208,Lim; Seonhee,10,0,35,25
1657786438014,MATH 10B,A03,093472,Lim; Seonhee,7,0,34,27
1657786438014,MATH 10B,B01,083739,Sinha; Shubham,13,0,30,17
1657786444042,MATH 18,A01,083743,Cinel; Cameron Alexander,9,0,30,21
1657786444042,MATH 18,A02,083744,Cinel; Cameron Alexander,18,0,30,12
1657786444042,MATH 18,A03,083745,Cinel; Cameron Alexander,10,0,30,20
1657786444042,MATH 18,B01,083748,Rideout; David Porter,5,0,37,32
1657786444042,MATH 18,B02,083749,Rideout; David Porter,5,0,36,31
1657786444042,MATH 18,B03,083750,Rideout; David Porter,3,0,37,34
1657786444042,MATH 18,B04,083751,Rideout; David Porter,6,0,36,30
1657786444042,MATH 18,B05,093473,Rideout; David Porter,6,0,36,30
1657786444042,MATH 18,B06,093474,Rideout; David Porter,6,0,36,30
1657786450075,MATH 20A,A01,083754,Zheng; Zequn,14,0,40,26
1657786456100,MATH 20B,A01,083756,Briones; Jor-el Thomas Caparas,4,0,36,32
1657786456100,MATH 20B,A02,083757,Briones; Jor-el Thomas Caparas,1,0,36,35
1657786456100,MATH 20B,A03,093475,Briones; Jor-el Thomas Caparas,2,0,36,34
1657786462125,MATH 20C,A01,083760,Briones; Jor-el Thomas Caparas,1,0,35,34
1657786462125,MATH 20C,A02,083761,Briones; Jor-el Thomas Caparas,8,0,35,27
1657786462125,MATH 20C,A03,093476,Briones; Jor-el Thomas Caparas,0,1,36,36
1657786462125,MATH 20C,B01,083762,Bach; Quang Tran,1,0,30,29
1657786468156,MATH 20D,A01,083765,Tran; Brian Kha,5,0,30,25
1657786468156,MATH 20D,A02,083766,Tran; Brian Kha,5,0,30,25
1657786468156,MATH 20D,A03,083767,Tran; Brian Kha,5,0,30,25
1657786474192,MATH 20E,A01,083771,Ganguly; Soumya,10,0,32,22
1657786474192,MATH 20E,A02,083772,Ganguly; Soumya,6,0,32,26
1657786474192,MATH 20E,B01,083773,Ciotti; Benjamin,20,0,35,15
1657786474192,MATH 20E,B02,083774,Ciotti; Benjamin,18,0,35,17
1657786480217,MATH 103A,A01,083777,Greenfeld; Be'Eri,3,0,36,33
1657786480217,MATH 103A,A02,083778,Greenfeld; Be'Eri,5,0,36,31
1657786480217,MATH 103A,A03,093561,Greenfeld; Be'Eri,6,0,36,30
1657786480217,MATH 103A,B01,083779,Greenfeld; Be'Eri,7,0,36,29
1657786480217,MATH 103A,B02,083780,Greenfeld; Be'Eri,4,0,36,32
1657786480217,MATH 103A,B03,093562,Greenfeld; Be'Eri,3,0,36,33
1657786486249,MATH 105,A01,085443,Carter; Anne Toulson,15,0,35,20
1657786486249,MATH 105,A02,093477,Carter; Anne Toulson,20,0,35,15
1657786492273,MATH 109,A01,083213,Ganzberger; Geoffrey Michael,3,0,34,31
1657786492273,MATH 109,A02,083214,Ganzberger; Geoffrey Michael,4,0,34,30
1657786492273,MATH 109,A03,093478,Ganzberger; Geoffrey Michael,2,0,34,32
1657786492273,MATH 109,B01,083215,Ganzberger; Geoffrey Michael,1,0,32,31
1657786492273,MATH 109,B02,083216,Ganzberger; Geoffrey Michael,2,0,32,30
1657786492273,MATH 109,B03,093479,Ganzberger; Geoffrey Michael,8,0,32,24
1657786498297,MATH 142A,A01,083219,Chow; Bennett,7,0,32,25
1657786498297,MATH 142A,A02,083220,Chow; Bennett,10,0,32,22
1657786498297,MATH 142A,A03,093480,Chow; Bennett,9,0,32,23
1657786498297,MATH 142A,B03,093481,Chow; Bennett,8,0,32,24
1657786498297,MATH 142A,B04,093558,Chow; Bennett,13,0,32,19
1657786498297,MATH 142A,B05,093559,Chow; Bennett,6,0,32,26
1657786504329,MATH 193A,A01,083224,Rotar; Vladimir,8,0,34,26
1657786504329,MATH 193A,A02,083225,Rotar; Vladimir,9,0,34,25
1657786504329,MATH 193A,A03,083781,Rotar; Vladimir,5,0,34,29
1657786504329,MATH 193A,A04,083782,Rotar; Vladimir,10,0,34,24
1657786504329,MATH 193A,A05,093482,Rotar; Vladimir,10,0,34,24
1657786510354,MATH 197,001,091859,McAuley; Julian John,9999,0,9999,0
1657786510354,MATH 197,002,095566,Kedlaya; Kiran S.,9997,0,9999,2
1657786510354,MATH 197,003,095567,Xiao; Ming,9999,0,9999,0
1657786510354,MATH 197,004,095571,Perols; Johan Lars,9998,0,9999,1
1657786517426,COGS 9,A01,083615,Shannon; Kyle Michael,9,0,75,66
1657786523448,COGS 11,A01,083617,Boyle; Mary E. T.,23,0,48,25
1657786529472,COGS 13,A01,083071,Bastos; Amalia Pinkusfeld,11,0,71,60
1657786535496,COGS 14A,A01,092681,Semenuks; Arturs,5,1,100,95
1657786541524,COGS 14B,A01,083073,Cheng; Tzu-Han,6,0,63,57
1657786547546,COGS 17,A01,092677,Semenuks; Arturs,6,0,81,75
1657786553571,COGS 100,A01,083619,Allen; Michael Gordon,17,0,70,53
1657786559594,COGS 101A,A01,083621,Davis; Joshua Daniel,9,0,68,59
1657786565618,COGS 101B,A01,091572,Allen; Michael Gordon,12,0,65,53
1657786571649,COGS 101C,A01,083625,Delgado; Tania,17,0,35,18
1657786577677,COGS 107A,A01,083627,Boyle; Mary E. T.,14,0,60,46
1657786583700,COGS 118A,A01,083075,Gupta; Anjum,21,0,76,55
1657786589724,CSE 3,A50,083646,Miranda; Gregory Joseph,24,0,50,26
1657786595752,CSE 8A,A50,083650,Miranda; Gregory Joseph,17,1,56,39
1657786601787,CSE 11,A01,083080,Cao; Yingjun,6,15,40,34
1657786607816,CSE 12,A01,083652,Krause-Levy; Sophia Louisa,28,1,120,92
1657786613839,CSE 15L,A01,083654,Morris; Justin Loren,9,0,50,41
1657786613839,CSE 15L,A02,083655,Morris; Justin Loren,9,0,50,41
1657786619869,CSE 20,A01,083657,Tran; Khoa Dang,39,0,80,41
1657786625897,CSE 21,A01,095574,Bach; Quang Tran,22,0,48,26
1657786631922,CSE 30,A01,083084,Eldon; John,6,0,80,74
1657786631922,CSE 30,B01,095061,Bhaskar; Nishant,9,0,50,41
1657786637946,CSE 100,A01,083659,Cao; Yingjun,5,4,70,65
1657786643972,CSE 134B,A01,083661,Powell; Thomas Allan,24,0,100,76
1657786649996,CSE 140,A01,083663,Gungor; Onat,15,0,85,70
1657786656027,CSE 140L,A01,083088,Eldon; John,23,0,100,77
1657786662050,CSE 175,A01,083665,Kumar; Rakesh,3,0,25,22
1657786668078,CSE 190,A00,092507,Dubnov; Shlomo,8,0,20,12
1657786674102,ECE 45,A01,083139,Congero; Spencer William,6,0,75,69
1657786680126,ECE 65,A50,083695,Saad; Andrew S,12,0,30,18
1657786680126,ECE 65,A51,095125,Saad; Andrew S,24,0,26,2
1657786686149,ECE 109,A01,091882,Touri; Behrouz,20,0,70,50
1657786692172,ECE 180,A00,083140,Abi Samra; Nicholas Camill,1,0,30,29
1657786692172,ECE 180,B00,083141,Abi Samra; Nicholas Camill,0,0,30,30
1657786698202,MATH 10A,A01,083735,Patchell; Gregory David,2,0,30,28
1657786698202,MATH 10A,A02,083736,Patchell; Gregory David,20,0,30,10
1657786698202,MATH 10A,A03,083737,Patchell; Gregory David,16,0,30,14
1657786704226,MATH 10B,A01,083207,Lim; Seonhee,8,0,34,26
1657786704226,MATH 10B,A02,083208,Lim; Seonhee,10,0,35,25
1657786704226,MATH 10B,A03,093472,Lim; Seonhee,7,0,34,27
1657786704226,MATH 10B,B01,083739,Sinha; Shubham,13,0,30,17
1657786710252,MATH 18,A01,083743,Cinel; Cameron Alexander,9,0,30,21
1657786710252,MATH 18,A02,083744,Cinel; Cameron Alexander,18,0,30,12
1657786710252,MATH 18,A03,083745,Cinel; Cameron Alexander,10,0,30,20
1657786710252,MATH 18,B01,083748,Rideout; David Porter,5,0,37,32
1657786710252,MATH 18,B02,083749,Rideout; David Porter,5,0,36,31
1657786710252,MATH 18,B03,083750,Rideout; David Porter,3,0,37,34
1657786710252,MATH 18,B04,083751,Rideout; David Porter,6,0,36,30
1657786710252,MATH 18,B05,093473,Rideout; David Porter,6,0,36,30
1657786710252,MATH 18,B06,093474,Rideout; David Porter,6,0,36,30
1657786716281,MATH 20A,A01,083754,Zheng; Zequn,14,0,40,26
1657786722305,MATH 20B,A01,083756,Briones; Jor-el Thomas Caparas,4,0,36,32
1657786722305,MATH 20B,A02,083757,Briones; Jor-el Thomas Caparas,1,0,36,35
1657786722305,MATH 20B,A03,093475,Briones; Jor-el Thomas Caparas,2,0,36,34
1657786728336,MATH 20C,A01,083760,Briones; Jor-el Thomas Caparas,1,0,35,34
1657786728336,MATH 20C,A02,083761,Briones; Jor-el Thomas Caparas,8,0,35,27
1657786728336,MATH 20C,A03,093476,Briones; Jor-el Thomas Caparas,0,1,36,36
1657786728336,MATH 20C,B01,083762,Bach; Quang Tran,1,0,30,29
1657786734364,MATH 20D,A01,083765,Tran; Brian Kha,5,0,30,25
1657786734364,MATH 20D,A02,083766,Tran; Brian Kha,5,0,30,25
1657786734364,MATH 20D,A03,083767,Tran; Brian Kha,5,0,30,25
1657786740391,MATH 20E,A01,083771,Ganguly; Soumya,10,0,32,22
1657786740391,MATH 20E,A02,083772,Ganguly; Soumya,6,0,32,26
1657786740391,MATH 20E,B01,083773,Ciotti; Benjamin,20,0,35,15
1657786740391,MATH 20E,B02,083774,Ciotti; Benjamin,18,0,35,17
1657786746424,MATH 103A,A01,083777,Greenfeld; Be'Eri,3,0,36,33
1657786746424,MATH 103A,A02,083778,Greenfeld; Be'Eri,5,0,36,31
1657786746424,MATH 103A,A03,093561,Greenfeld; Be'Eri,6,0,36,30
1657786746424,MATH 103A,B01,083779,Greenfeld; Be'Eri,7,0,36,29
1657786746424,MATH 103A,B02,083780,Greenfeld; Be'Eri,4,0,36,32
1657786746424,MATH 103A,B03,093562,Greenfeld; Be'Eri,3,0,36,33
1657786752448,MATH 105,A01,085443,Carter; Anne Toulson,15,0,35,20
1657786752448,MATH 105,A02,093477,Carter; Anne Toulson,20,0,35,15
1657786758475,MATH 109,A01,083213,Ganzberger; Geoffrey Michael,3,0,34,31
1657786758475,MATH 109,A02,083214,Ganzberger; Geoffrey Michael,4,0,34,30
1657786758475,MATH 109,A03,093478,Ganzberger; Geoffrey Michael,2,0,34,32
1657786758475,MATH 109,B01,083215,Ganzberger; Geoffrey Michael,1,0,32,31
1657786758475,MATH 109,B02,083216,Ganzberger; Geoffrey Michael,2,0,32,30
1657786758475,MATH 109,B03,093479,Ganzberger; Geoffrey Michael,8,0,32,24
1657786764504,MATH 142A,A01,083219,Chow; Bennett,7,0,32,25
1657786764504,MATH 142A,A02,083220,Chow; Bennett,10,0,32,22
1657786764504,MATH 142A,A03,093480,Chow; Bennett,9,0,32,23
1657786764504,MATH 142A,B03,093481,Chow; Bennett,8,0,32,24
1657786764504,MATH 142A,B04,093558,Chow; Bennett,13,0,32,19
1657786764504,MATH 142A,B05,093559,Chow; Bennett,6,0,32,26
1657786770532,MATH 193A,A01,083224,Rotar; Vladimir,8,0,34,26
1657786770532,MATH 193A,A02,083225,Rotar; Vladimir,9,0,34,25
1657786770532,MATH 193A,A03,083781,Rotar; Vladimir,5,0,34,29
1657786770532,MATH 193A,A04,083782,Rotar; Vladimir,10,0,34,24
1657786770532,MATH 193A,A05,093482,Rotar; Vladimir,10,0,34,24
1657786776644,MATH 197,001,091859,McAuley; Julian John,9999,0,9999,0
1657786776644,MATH 197,002,095566,Kedlaya; Kiran S.,9997,0,9999,2
1657786776644,MATH 197,003,095567,Xiao; Ming,9999,0,9999,0
1657786776644,MATH 197,004,095571,Perols; Johan Lars,9998,0,9999,1
1657786783716,COGS 9,A01,083615,Shannon; Kyle Michael,9,0,75,66
1657786789739,COGS 11,A01,083617,Boyle; Mary E. T.,23,0,48,25
1657786795768,COGS 13,A01,083071,Bastos; Amalia Pinkusfeld,11,0,71,60
1657786801792,COGS 14A,A01,092681,Semenuks; Arturs,5,1,100,95
1657786807818,COGS 14B,A01,083073,Cheng; Tzu-Han,6,0,63,57
1657786813842,COGS 17,A01,092677,Semenuks; Arturs,6,0,81,75
1657786819866,COGS 100,A01,083619,Allen; Michael Gordon,17,0,70,53
1657786825890,COGS 101A,A01,083621,Davis; Joshua Daniel,9,0,68,59
1657786831913,COGS 101B,A01,091572,Allen; Michael Gordon,12,0,65,53
1657786837939,COGS 101C,A01,083625,Delgado; Tania,17,0,35,18
1657786843966,COGS 107A,A01,083627,Boyle; Mary E. T.,14,0,60,46
1657786849993,COGS 118A,A01,083075,Gupta; Anjum,21,0,76,55
1657786856019,CSE 3,A50,083646,Miranda; Gregory Joseph,24,0,50,26
1657786862043,CSE 8A,A50,083650,Miranda; Gregory Joseph,17,1,56,39
1657786868066,CSE 11,A01,083080,Cao; Yingjun,6,15,40,34
1657786874093,CSE 12,A01,083652,Krause-Levy; Sophia Louisa,28,1,120,92
1657786880116,CSE 15L,A01,083654,Morris; Justin Loren,9,0,50,41
1657786880116,CSE 15L,A02,083655,Morris; Justin Loren,9,0,50,41
1657786886144,CSE 20,A01,083657,Tran; Khoa Dang,39,0,80,41
1657786892172,CSE 21,A01,095574,Bach; Quang Tran,22,0,48,26
1657786898196,CSE 30,A01,083084,Eldon; John,6,0,80,74
1657786898196,CSE 30,B01,095061,Bhaskar; Nishant,9,0,50,41
1657786904220,CSE 100,A01,083659,Cao; Yingjun,5,4,70,65
1657786910243,CSE 134B,A01,083661,Powell; Thomas Allan,24,0,100,76
1657786916293,CSE 140,A01,083663,Gungor; Onat,15,0,85,70
1657786922322,CSE 140L,A01,083088,Eldon; John,23,0,100,77
1657786928346,CSE 175,A01,083665,Kumar; Rakesh,3,0,25,22
1657786934374,CSE 190,A00,092507,Dubnov; Shlomo,8,0,20,12
1657786940401,ECE 45,A01,083139,Congero; Spencer William,6,0,75,69
1657786946428,ECE 65,A50,083695,Saad; Andrew S,12,0,30,18
1657786946428,ECE 65,A51,095125,Saad; Andrew S,24,0,26,2
1657786952456,ECE 109,A01,091882,Touri; Behrouz,20,0,70,50
1657786958486,ECE 180,A00,083140,Abi Samra; Nicholas Camill,1,0,30,29
1657786958486,ECE 180,B00,083141,Abi Samra; Nicholas Camill,0,0,30,30
1657786964513,MATH 10A,A01,083735,Patchell; Gregory David,2,0,30,28
1657786964513,MATH 10A,A02,083736,Patchell; Gregory David,20,0,30,10
1657786964513,MATH 10A,A03,083737,Patchell; Gregory David,16,0,30,14
1657786970551,MATH 10B,A01,083207,Lim; Seonhee,8,0,34,26
1657786970551,MATH 10B,A02,083208,Lim; Seonhee,10,0,35,25
1657786970551,MATH 10B,A03,093472,Lim; Seonhee,7,0,34,27
1657786970551,MATH 10B,B01,083739,Sinha; Shubham,13,0,30,17
1657786976591,MATH 18,A01,083743,Cinel; Cameron Alexander,9,0,30,21
1657786976591,MATH 18,A02,083744,Cinel; Cameron Alexander,18,0,30,12
1657786976591,MATH 18,A03,083745,Cinel; Cameron Alexander,10,0,30,20
1657786976591,MATH 18,B01,083748,Rideout; David Porter,5,0,37,32
1657786976591,MATH 18,B02,083749,Rideout; David Porter,5,0,36,31
1657786976591,MATH 18,B03,083750,Rideout; David Porter,3,0,37,34
1657786976591,MATH 18,B04,083751,Rideout; David Porter,6,0,36,30
1657786976591,MATH 18,B05,093473,Rideout; David Porter,6,0,36,30
1657786976591,MATH 18,B06,093474,Rideout; David Porter,6,0,36,30
1657786982617,MATH 20A,A01,083754,Zheng; Zequn,14,0,40,26
1657786988642,MATH 20B,A01,083756,Briones; Jor-el Thomas Caparas,4,0,36,32
1657786988642,MATH 20B,A02,083757,Briones; Jor-el Thomas Caparas,1,0,36,35
1657786988642,MATH 20B,A03,093475,Briones; Jor-el Thomas Caparas,2,0,36,34
1657786994677,MATH 20C,A01,083760,Briones; Jor-el Thomas Caparas,1,0,35,34
1657786994677,MATH 20C,A02,083761,Briones; Jor-el Thomas Caparas,8,0,35,27
1657786994677,MATH 20C,A03,093476,Briones; Jor-el Thomas Caparas,0,1,36,36
1657786994677,MATH 20C,B01,083762,Bach; Quang Tran,1,0,30,29
1657787000709,MATH 20D,A01,083765,Tran; Brian Kha,5,0,30,25
1657787000709,MATH 20D,A02,083766,Tran; Brian Kha,5,0,30,25
1657787000709,MATH 20D,A03,083767,Tran; Brian Kha,5,0,30,25
1657787006742,MATH 20E,A01,083771,Ganguly; Soumya,10,0,32,22
1657787006742,MATH 20E,A02,083772,Ganguly; Soumya,6,0,32,26
1657787006742,MATH 20E,B01,083773,Ciotti; Benjamin,20,0,35,15
1657787006742,MATH 20E,B02,083774,Ciotti; Benjamin,18,0,35,17
1657787012768,MATH 103A,A01,083777,Greenfeld; Be'Eri,3,0,36,33
1657787012768,MATH 103A,A02,083778,Greenfeld; Be'Eri,5,0,36,31
1657787012768,MATH 103A,A03,093561,Greenfeld; Be'Eri,6,0,36,30
1657787012768,MATH 103A,B01,083779,Greenfeld; Be'Eri,7,0,36,29
1657787012768,MATH 103A,B02,083780,Greenfeld; Be'Eri,4,0,36,32
1657787012768,MATH 103A,B03,093562,Greenfeld; Be'Eri,3,0,36,33
1657787018793,MATH 105,A01,085443,Carter; Anne Toulson,15,0,35,20
1657787018793,MATH 105,A02,093477,Carter; Anne Toulson,20,0,35,15
1657787024830,MATH 109,A01,083213,Ganzberger; Geoffrey Michael,3,0,34,31
1657787024830,MATH 109,A02,083214,Ganzberger; Geoffrey Michael,4,0,34,30
1657787024830,MATH 109,A03,093478,Ganzberger; Geoffrey Michael,2,0,34,32
1657787024830,MATH 109,B01,083215,Ganzberger; Geoffrey Michael,1,0,32,31
1657787024830,MATH 109,B02,083216,Ganzberger; Geoffrey Michael,2,0,32,30
1657787024830,MATH 109,B03,093479,Ganzberger; Geoffrey Michael,8,0,32,24
1657787030857,MATH 142A,A01,083219,Chow; Bennett,7,0,32,25
1657787030857,MATH 142A,A02,083220,Chow; Bennett,10,0,32,22
1657787030857,MATH 142A,A03,093480,Chow; Bennett,9,0,32,23
1657787030857,MATH 142A,B03,093481,Chow; Bennett,8,0,32,24
1657787030857,MATH 142A,B04,093558,Chow; Bennett,13,0,32,19
1657787030857,MATH 142A,B05,093559,Chow; Bennett,6,0,32,26
1657787036888,MATH 193A,A01,083224,Rotar; Vladimir,8,0,34,26
1657787036888,MATH 193A,A02,083225,Rotar; Vladimir,9,0,34,25
1657787036888,MATH 193A,A03,083781,Rotar; Vladimir,5,0,34,29
1657787036888,MATH 193A,A04,083782,Rotar; Vladimir,10,0,34,24
1657787036888,MATH 193A,A05,093482,Rotar; Vladimir,10,0,34,24
1657787042914,MATH 197,001,091859,McAuley; Julian John,9999,0,9999,0
1657787042914,MATH 197,002,095566,Kedlaya; Kiran S.,9997,0,9999,2
1657787042914,MATH 197,003,095567,Xiao; Ming,9999,0,9999,0
1657787042914,MATH 197,004,095571,Perols; Johan Lars,9998,0,9999,1
1657787049987,COGS 9,A01,083615,Shannon; Kyle Michael,9,0,75,66
1657787056018,COGS 11,A01,083617,Boyle; Mary E. T.,23,0,48,25
1657787062043,COGS 13,A01,083071,Bastos; Amalia Pinkusfeld,11,0,71,60
1657787068070,COGS 14A,A01,092681,Semenuks; Arturs,5,1,100,95
1657787074094,COGS 14B,A01,083073,Cheng; Tzu-Han,6,0,63,57
1657787080124,COGS 17,A01,092677,Semenuks; Arturs,6,0,81,75
1657787086148,COGS 100,A01,083619,Allen; Michael Gordon,17,0,70,53
1657787092176,COGS 101A,A01,083621,Davis; Joshua Daniel,9,0,68,59
1657787098207,COGS 101B,A01,091572,Allen; Michael Gordon,12,0,65,53
1657787104233,COGS 101C,A01,083625,Delgado; Tania,17,0,35,18
1657787110257,COGS 107A,A01,083627,Boyle; Mary E. T.,14,0,60,46
1657787116289,COGS 118A,A01,083075,Gupta; Anjum,21,0,76,55
1657787122323,CSE 3,A50,083646,Miranda; Gregory Joseph,24,0,50,26
1657787128353,CSE 8A,A50,083650,Miranda; Gregory Joseph,17,1,56,39
1657787134382,CSE 11,A01,083080,Cao; Yingjun,6,15,40,34
1657787140414,CSE 12,A01,083652,Krause-Levy; Sophia Louisa,28,1,120,92
1657787146443,CSE 15L,A01,083654,Morris; Justin Loren,9,0,50,41
1657787146443,CSE 15L,A02,083655,Morris; Justin Loren,9,0,50,41
1657787152471,CSE 20,A01,083657,Tran; Khoa Dang,39,0,80,41
1657787158502,CSE 21,A01,095574,Bach; Quang Tran,22,0,48,26
1657787164537,CSE 30,A01,083084,Eldon; John,6,0,80,74
1657787164537,CSE 30,B01,095061,Bhaskar; Nishant,9,0,50,41
1657787170574,CSE 100,A01,083659,Cao; Yingjun,5,4,70,65
1657787176598,CSE 134B,A01,083661,Powell; Thomas Allan,24,0,100,76
1657787182625,CSE 140,A01,083663,Gungor; Onat,15,0,85,70
1657787188653,CSE 140L,A01,083088,Eldon; John,23,0,100,77
1657787194682,CSE 175,A01,083665,Kumar; Rakesh,3,0,25,22
1657787200711,CSE 190,A00,092507,Dubnov; Shlomo,8,0,20,12
1657787206742,ECE 45,A01,083139,Congero; Spencer William,6,0,75,69
1657787212773,ECE 65,A50,083695,Saad; Andrew S,12,0,30,18
1657787212773,ECE 65,A51,095125,Saad; Andrew S,24,0,26,2
1657787218812,ECE 109,A01,091882,Touri; Behrouz,20,0,70,50
1657787224841,ECE 180,A00,083140,Abi Samra; Nicholas Camill,1,0,30,29
1657787224841,ECE 180,B00,083141,Abi Samra; Nicholas Camill,0,0,30,30
1657787230874,MATH 10A,A01,083735,Patchell; Gregory David,2,0,30,28
1657787230874,MATH 10A,A02,083736,Patchell; Gregory David,20,0,30,10
1657787230874,MATH 10A,A03,083737,Patchell; Gregory David,16,0,30,14
1657787236902,MATH 10B,A01,083207,Lim; Seonhee,8,0,34,26
1657787236902,MATH 10B,A02,083208,Lim; Seonhee,10,0,35,25
1657787236902,MATH 10B,A03,093472,Lim; Seonhee,7,0,34,27
1657787236902,MATH 10B,B01,083739,Sinha; Shubham,13,0,30,17
1657787242933,MATH 18,A01,083743,Cinel; Cameron Alexander,9,0,30,21
1657787242933,MATH 18,A02,083744,Cinel; Cameron Alexander,18,0,30,12
1657787242933,MATH 18,A03,083745,Cinel; Cameron Alexander,10,0,30,20
1657787242933,MATH 18,B01,083748,Rideout; David Porter,5,0,37,32
1657787242933,MATH 18,B02,083749,Rideout; David Porter,5,0,36,31
1657787242933,MATH 18,B03,083750,Rideout; David Porter,3,0,37,34
1657787242933,MATH 18,B04,083751,Rideout; David Porter,6,0,36,30
1657787242933,MATH 18,B05,093473,Rideout; David Porter,6,0,36,30
1657787242933,MATH 18,B06,093474,Rideout; David Porter,6,0,36,30
1657787248964,MATH 20A,A01,083754,Zheng; Zequn,14,0,40,26
1657787254990,MATH 20B,A01,083756,Briones; Jor-el Thomas Caparas,4,0,36,32
1657787254990,MATH 20B,A02,083757,Briones; Jor-el Thomas Caparas,1,0,36,35
1657787254990,MATH 20B,A03,093475,Briones; Jor-el Thomas Caparas,2,0,36,34
1657787261023,MATH 20C,A01,083760,Briones; Jor-el Thomas Caparas,1,0,35,34
1657787261023,MATH 20C,A02,083761,Briones; Jor-el Thomas Caparas,8,0,35,27
1657787261023,MATH 20C,A03,093476,Briones; Jor-el Thomas Caparas,0,1,36,36
1657787261023,MATH 20C,B01,083762,Bach; Quang Tran,1,0,30,29
1657787267049,MATH 20D,A01,083765,Tran; Brian Kha,5,0,30,25
1657787267049,MATH 20D,A02,083766,Tran; Brian Kha,5,0,30,25
1657787267049,MATH 20D,A03,083767,Tran; Brian Kha,5,0,30,25
1657787273084,MATH 20E,A01,083771,Ganguly; Soumya,10,0,32,22
1657787273084,MATH 20E,A02,083772,Ganguly; Soumya,6,0,32,26
1657787273084,MATH 20E,B01,083773,Ciotti; Benjamin,20,0,35,15
1657787273084,MATH 20E,B02,083774,Ciotti; Benjamin,18,0,35,17
1657787279122,MATH 103A,A01,083777,Greenfeld; Be'Eri,3,0,36,33
1657787279122,MATH 103A,A02,083778,Greenfeld; Be'Eri,5,0,36,31
1657787279122,MATH 103A,A03,093561,Greenfeld; Be'Eri,6,0,36,30
1657787279122,MATH 103A,B01,083779,Greenfeld; Be'Eri,7,0,36,29
1657787279122,MATH 103A,B02,083780,Greenfeld; Be'Eri,4,0,36,32
1657787279122,MATH 103A,B03,093562,Greenfeld; Be'Eri,3,0,36,33
1657787285161,MATH 105,A01,085443,Carter; Anne Toulson,15,0,35,20
1657787285161,MATH 105,A02,093477,Carter; Anne Toulson,20,0,35,15
1657787291203,MATH 109,A01,083213,Ganzberger; Geoffrey Michael,3,0,34,31
1657787291203,MATH 109,A02,083214,Ganzberger; Geoffrey Michael,4,0,34,30
1657787291203,MATH 109,A03,093478,Ganzberger; Geoffrey Michael,2,0,34,32
1657787291203,MATH 109,B01,083215,Ganzberger; Geoffrey Michael,1,0,32,31
1657787291203,MATH 109,B02,083216,Ganzberger; Geoffrey Michael,2,0,32,30
1657787291203,MATH 109,B03,093479,Ganzberger; Geoffrey Michael,8,0,32,24
1657787297232,MATH 142A,A01,083219,Chow; Bennett,7,0,32,25
1657787297232,MATH 142A,A02,083220,Chow; Bennett,10,0,32,22
1657787297232,MATH 142A,A03,093480,Chow; Bennett,9,0,32,23
1657787297232,MATH 142A,B03,093481,Chow; Bennett,8,0,32,24
1657787297232,MATH 142A,B04,093558,Chow; Bennett,13,0,32,19
1657787297232,MATH 142A,B05,093559,Chow; Bennett,6,0,32,26
1657787303259,MATH 193A,A01,083224,Rotar; Vladimir,8,0,34,26
1657787303259,MATH 193A,A02,083225,Rotar; Vladimir,9,0,34,25
1657787303259,MATH 193A,A03,083781,Rotar; Vladimir,5,0,34,29
1657787303259,MATH 193A,A04,083782,Rotar; Vladimir,10,0,34,24
1657787303259,MATH 193A,A05,093482,Rotar; Vladimir,10,0,34,24
1657787309289,MATH 197,001,091859,McAuley; Julian John,9999,0,9999,0
1657787309289,MATH 197,002,095566,Kedlaya; Kiran S.,9997,0,9999,2
1657787309289,MATH 197,003,095567,Xiao; Ming,9999,0,9999,0
1657787309289,MATH 197,004,095571,Perols; Johan Lars,9998,0,9999,1
1657787316374,COGS 9,A01,083615,Shannon; Kyle Michael,9,0,75,66
1657787322399,COGS 11,A01,083617,Boyle; Mary E. T.,23,0,48,25
1657787328425,COGS 13,A01,083071,Bastos; Amalia Pinkusfeld,11,0,71,60
1657787334449,COGS 14A,A01,092681,Semenuks; Arturs,5,1,100,95
1657787340488,COGS 14B,A01,083073,Cheng; Tzu-Han,6,0,63,57
1657787346520,COGS 17,A01,092677,Semenuks; Arturs,6,0,81,75
1657787352552,COGS 100,A01,083619,Allen; Michael Gordon,17,0,70,53
1657787358578,COGS 101A,A01,083621,Davis; Joshua Daniel,9,0,68,59
1657787364606,COGS 101B,A01,091572,Allen; Michael Gordon,12,0,65,53
1657787370727,COGS 101C,A01,083625,Delgado; Tania,17,0,35,18
1657787376762,COGS 107A,A01,083627,Boyle; Mary E. T.,14,0,60,46
1657787382788,COGS 118A,A01,083075,Gupta; Anjum,21,0,76,55
1657787388820,CSE 3,A50,083646,Miranda; Gregory Joseph,24,0,50,26
1657787394844,CSE 8A,A50,083650,Miranda; Gregory Joseph,17,1,56,39
1657787400873,CSE 11,A01,083080,Cao; Yingjun,6,15,40,34
1657787406916,CSE 12,A01,083652,Krause-Levy; Sophia Louisa,28,1,120,92
1657787412945,CSE 15L,A01,083654,Morris; Justin Loren,9,0,50,41
1657787412945,CSE 15L,A02,083655,Morris; Justin Loren,9,0,50,41
1657787418970,CSE 20,A01,083657,Tran; Khoa Dang,39,0,80,41
1657787424995,CSE 21,A01,095574,Bach; Quang Tran,22,0,48,26
1657787431019,CSE 30,A01,083084,Eldon; John,6,0,80,74
1657787431019,CSE 30,B01,095061,Bhaskar; Nishant,9,0,50,41
1657787437045,CSE 100,A01,083659,Cao; Yingjun,5,4,70,65
1657787443070,CSE 134B,A01,083661,Powell; Thomas Allan,24,0,100,76
1657787449102,CSE 140,A01,083663,Gungor; Onat,15,0,85,70
1657787455125,CSE 140L,A01,083088,Eldon; John,23,0,100,77
1657787461156,CSE 175,A01,083665,Kumar; Rakesh,3,0,25,22
1657787467187,CSE 190,A00,092507,Dubnov; Shlomo,8,0,20,12
1657787473217,ECE 45,A01,083139,Congero; Spencer William,6,0,75,69
1657787479243,ECE 65,A50,083695,Saad; Andrew S,12,0,30,18
1657787479243,ECE 65,A51,095125,Saad; Andrew S,24,0,26,2
1657787485268,ECE 109,A01,091882,Touri; Behrouz,20,0,70,50
1657787491294,ECE 180,A00,083140,Abi Samra; Nicholas Camill,1,0,30,29
1657787491294,ECE 180,B00,083141,Abi Samra; Nicholas Camill,0,0,30,30
1657787497321,MATH 10A,A01,083735,Patchell; Gregory David,2,0,30,28
1657787497321,MATH 10A,A02,083736,Patchell; Gregory David,20,0,30,10
1657787497321,MATH 10A,A03,083737,Patchell; Gregory David,16,0,30,14
1657787503358,MATH 10B,A01,083207,Lim; Seonhee,8,0,34,26
1657787503358,MATH 10B,A02,083208,Lim; Seonhee,10,0,35,25
1657787503358,MATH 10B,A03,093472,Lim; Seonhee,7,0,34,27
1657787503358,MATH 10B,B01,083739,Sinha; Shubham,13,0,30,17
1657787509390,MATH 18,A01,083743,Cinel; Cameron Alexander,9,0,30,21
1657787509390,MATH 18,A02,083744,Cinel; Cameron Alexander,18,0,30,12
1657787509390,MATH 18,A03,083745,Cinel; Cameron Alexander,10,0,30,20
1657787509390,MATH 18,B01,083748,Rideout; David Porter,5,0,37,32
1657787509390,MATH 18,B02,083749,Rideout; David Porter,5,0,36,31
1657787509390,MATH 18,B03,083750,Rideout; David Porter,3,0,37,34
1657787509390,MATH 18,B04,083751,Rideout; David Porter,6,0,36,30
1657787509390,MATH 18,B05,093473,Rideout; David Porter,6,0,36,30
1657787509390,MATH 18,B06,093474,Rideout; David Porter,6,0,36,30
1657787515414,MATH 20A,A01,083754,Zheng; Zequn,14,0,40,26
1657787521450,MATH 20B,A01,083756,Briones; Jor-el Thomas Caparas,4,0,36,32
1657787521450,MATH 20B,A02,083757,Briones; Jor-el Thomas Caparas,1,0,36,35
1657787521450,MATH 20B,A03,093475,Briones; Jor-el Thomas Caparas,2,0,36,34
1657787527484,MATH 20C,A01,083760,Briones; Jor-el Thomas Caparas,1,0,35,34
1657787527484,MATH 20C,A02,083761,Briones; Jor-el Thomas Caparas,8,0,35,27
1657787527484,MATH 20C,A03,093476,Briones; Jor-el Thomas Caparas,0,1,36,36
1657787527484,MATH 20C,B01,083762,Bach; Quang Tran,1,0,30,29
1657787533510,MATH 20D,A01,083765,Tran; Brian Kha,5,0,30,25
1657787533510,MATH 20D,A02,083766,Tran; Brian Kha,5,0,30,25
1657787533510,MATH 20D,A03,083767,Tran; Brian Kha,5,0,30,25
1657787539535,MATH 20E,A01,083771,Ganguly; Soumya,10,0,32,22
1657787539535,MATH 20E,A02,083772,Ganguly; Soumya,6,0,32,26
1657787539535,MATH 20E,B01,083773,Ciotti; Benjamin,20,0,35,15
1657787539535,MATH 20E,B02,083774,Ciotti; Benjamin,18,0,35,17
1657787545564,MATH 103A,A01,083777,Greenfeld; Be'Eri,3,0,36,33
1657787545564,MATH 103A,A02,083778,Greenfeld; Be'Eri,5,0,36,31
1657787545564,MATH 103A,A03,093561,Greenfeld; Be'Eri,6,0,36,30
1657787545564,MATH 103A,B01,083779,Greenfeld; Be'Eri,7,0,36,29
1657787545564,MATH 103A,B02,083780,Greenfeld; Be'Eri,4,0,36,32
1657787545564,MATH 103A,B03,093562,Greenfeld; Be'Eri,3,0,36,33
1657787551590,MATH 105,A01,085443,Carter; Anne Toulson,15,0,35,20
1657787551590,MATH 105,A02,093477,Carter; Anne Toulson,20,0,35,15
1657787557618,MATH 109,A01,083213,Ganzberger; Geoffrey Michael,3,0,34,31
1657787557618,MATH 109,A02,083214,Ganzberger; Geoffrey Michael,4,0,34,30
1657787557618,MATH 109,A03,093478,Ganzberger; Geoffrey Michael,2,0,34,32
1657787557618,MATH 109,B01,083215,Ganzberger; Geoffrey Michael,1,0,32,31
1657787557618,MATH 109,B02,083216,Ganzberger; Geoffrey Michael,2,0,32,30
1657787557618,MATH 109,B03,093479,Ganzberger; Geoffrey Michael,8,0,32,24
1657787563645,MATH 142A,A01,083219,Chow; Bennett,7,0,32,25
1657787563645,MATH 142A,A02,083220,Chow; Bennett,10,0,32,22
1657787563645,MATH 142A,A03,093480,Chow; Bennett,9,0,32,23
1657787563645,MATH 142A,B03,093481,Chow; Bennett,8,0,32,24
1657787563645,MATH 142A,B04,093558,Chow; Bennett,13,0,32,19
1657787563645,MATH 142A,B05,093559,Chow; Bennett,6,0,32,26
1657787569671,MATH 193A,A01,083224,Rotar; Vladimir,8,0,34,26
1657787569671,MATH 193A,A02,083225,Rotar; Vladimir,9,0,34,25
1657787569671,MATH 193A,A03,083781,Rotar; Vladimir,5,0,34,29
1657787569671,MATH 193A,A04,083782,Rotar; Vladimir,10,0,34,24
1657787569671,MATH 193A,A05,093482,Rotar; Vladimir,10,0,34,24
1657787575699,MATH 197,001,091859,McAuley; Julian John,9999,0,9999,0
1657787575699,MATH 197,002,095566,Kedlaya; Kiran S.,9997,0,9999,2
1657787575699,MATH 197,003,095567,Xiao; Ming,9999,0,9999,0
1657787575699,MATH 197,004,095571,Perols; Johan Lars,9998,0,9999,1
1657787582789,COGS 9,A01,083615,Shannon; Kyle Michael,9,0,75,66
1657787588820,COGS 11,A01,083617,Boyle; Mary E. T.,23,0,48,25
1657787594856,COGS 13,A01,083071,Bastos; Amalia Pinkusfeld,11,0,71,60
1657787600881,COGS 14A,A01,092681,Semenuks; Arturs,5,1,100,95
1657787606904,COGS 14B,A01,083073,Cheng; Tzu-Han,6,0,63,57
1657787612929,COGS 17,A01,092677,Semenuks; Arturs,6,0,81,75
1657787618953,COGS 100,A01,083619,Allen; Michael Gordon,17,0,70,53
1657787624979,COGS 101A,A01,083621,Davis; Joshua Daniel,9,0,68,59
1657787631017,COGS 101B,A01,091572,Allen; Michael Gordon,12,0,65,53
1657787637041,COGS 101C,A01,083625,Delgado; Tania,17,0,35,18
1657787643069,COGS 107A,A01,083627,Boyle; Mary E. T.,14,0,60,46
1657787649094,COGS 118A,A01,083075,Gupta; Anjum,21,0,76,55
1657787655128,CSE 3,A50,083646,Miranda; Gregory Joseph,24,0,50,26
1657787661151,CSE 8A,A50,083650,Miranda; Gregory Joseph,17,1,56,39
1657787667178,CSE 11,A01,083080,Cao; Yingjun,6,15,40,34
1657787673207,CSE 12,A01,083652,Krause-Levy; Sophia Louisa,28,1,120,92
1657787679232,CSE 15L,A01,083654,Morris; Justin Loren,9,0,50,41
1657787679232,CSE 15L,A02,083655,Morris; Justin Loren,9,0,50,41
1657787685261,CSE 20,A01,083657,Tran; Khoa Dang,39,0,80,41
1657787691286,CSE 21,A01,095574,Bach; Quang Tran,22,0,48,26
1657787697317,CSE 30,A01,083084,Eldon; John,6,0,80,74
1657787697317,CSE 30,B01,095061,Bhaskar; Nishant,9,0,50,41
1657787703350,CSE 100,A01,083659,Cao; Yingjun,5,4,70,65
1657787709376,CSE 134B,A01,083661,Powell; Thomas Allan,24,0,100,76
1657787715401,CSE 140,A01,083663,Gungor; Onat,15,0,85,70
1657787721424,CSE 140L,A01,083088,Eldon; John,23,0,100,77
1657787727451,CSE 175,A01,083665,Kumar; Rakesh,3,0,25,22
1657787733482,CSE 190,A00,092507,Dubnov; Shlomo,8,0,20,12
1657787739510,ECE 45,A01,083139,Congero; Spencer William,6,0,75,69
1657787745541,ECE 65,A50,083695,Saad; Andrew S,12,0,30,18
1657787745541,ECE 65,A51,095125,Saad; Andrew S,24,0,26,2
1657787751565,ECE 109,A01,091882,Touri; Behrouz,20,0,70,50
1657787757591,ECE 180,A00,083140,Abi Samra; Nicholas Camill,1,0,30,29
1657787757591,ECE 180,B00,083141,Abi Samra; Nicholas Camill,0,0,30,30
1657787763626,MATH 10A,A01,083735,Patchell; Gregory David,2,0,30,28
1657787763626,MATH 10A,A02,083736,Patchell; Gregory David,20,0,30,10
1657787763626,MATH 10A,A03,083737,Patchell; Gregory David,16,0,30,14
1657787769664,MATH 10B,A01,083207,Lim; Seonhee,8,0,34,26
1657787769664,MATH 10B,A02,083208,Lim; Seonhee,10,0,35,25
1657787769664,MATH 10B,A03,093472,Lim; Seonhee,7,0,34,27
1657787769664,MATH 10B,B01,083739,Sinha; Shubham,13,0,30,17
1657787775695,MATH 18,A01,083743,Cinel; Cameron Alexander,9,0,30,21
1657787775695,MATH 18,A02,083744,Cinel; Cameron Alexander,18,0,30,12
1657787775695,MATH 18,A03,083745,Cinel; Cameron Alexander,10,0,30,20
1657787775695,MATH 18,B01,083748,Rideout; David Porter,5,0,37,32
1657787775695,MATH 18,B02,083749,Rideout; David Porter,5,0,36,31
1657787775695,MATH 18,B03,083750,Rideout; David Porter,3,0,37,34
1657787775695,MATH 18,B04,083751,Rideout; David Porter,6,0,36,30
1657787775695,MATH 18,B05,093473,Rideout; David Porter,6,0,36,30
1657787775695,MATH 18,B06,093474,Rideout; David Porter,6,0,36,30
1657787781722,MATH 20A,A01,083754,Zheng; Zequn,14,0,40,26
1657787787748,MATH 20B,A01,083756,Briones; Jor-el Thomas Caparas,4,0,36,32
1657787787748,MATH 20B,A02,083757,Briones; Jor-el Thomas Caparas,1,0,36,35
1657787787748,MATH 20B,A03,093475,Briones; Jor-el Thomas Caparas,2,0,36,34
1657787793774,MATH 20C,A01,083760,Briones; Jor-el Thomas Caparas,1,0,35,34
1657787793774,MATH 20C,A02,083761,Briones; Jor-el Thomas Caparas,8,0,35,27
1657787793774,MATH 20C,A03,093476,Briones; Jor-el Thomas Caparas,0,1,36,36
1657787793774,MATH 20C,B01,083762,Bach; Quang Tran,1,0,30,29
1657787799800,MATH 20D,A01,083765,Tran; Brian Kha,5,0,30,25
1657787799800,MATH 20D,A02,083766,Tran; Brian Kha,5,0,30,25
1657787799800,MATH 20D,A03,083767,Tran; Brian Kha,5,0,30,25
1657787805835,MATH 20E,A01,083771,Ganguly; Soumya,10,0,32,22
1657787805835,MATH 20E,A02,083772,Ganguly; Soumya,6,0,32,26
1657787805835,MATH 20E,B01,083773,Ciotti; Benjamin,20,0,35,15
1657787805835,MATH 20E,B02,083774,Ciotti; Benjamin,18,0,35,17
1657787811861,MATH 103A,A01,083777,Greenfeld; Be'Eri,3,0,36,33
1657787811861,MATH 103A,A02,083778,Greenfeld; Be'Eri,5,0,36,31
1657787811861,MATH 103A,A03,093561,Greenfeld; Be'Eri,6,0,36,30
1657787811861,MATH 103A,B01,083779,Greenfeld; Be'Eri,7,0,36,29
1657787811861,MATH 103A,B02,083780,Greenfeld; Be'Eri,4,0,36,32
1657787811861,MATH 103A,B03,093562,Greenfeld; Be'Eri,3,0,36,33
1657787817889,MATH 105,A01,085443,Carter; Anne Toulson,15,0,35,20
1657787817889,MATH 105,A02,093477,Carter; Anne Toulson,20,0,35,15
1657787823913,MATH 109,A01,083213,Ganzberger; Geoffrey Michael,3,0,34,31
1657787823913,MATH 109,A02,083214,Ganzberger; Geoffrey Michael,4,0,34,30
1657787823913,MATH 109,A03,093478,Ganzberger; Geoffrey Michael,2,0,34,32
1657787823913,MATH 109,B01,083215,Ganzberger; Geoffrey Michael,1,0,32,31
1657787823913,MATH 109,B02,083216,Ganzberger; Geoffrey Michael,2,0,32,30
1657787823913,MATH 109,B03,093479,Ganzberger; Geoffrey Michael,8,0,32,24
1657787829937,MATH 142A,A01,083219,Chow; Bennett,7,0,32,25
1657787829937,MATH 142A,A02,083220,Chow; Bennett,10,0,32,22
1657787829937,MATH 142A,A03,093480,Chow; Bennett,9,0,32,23
1657787829937,MATH 142A,B03,093481,Chow; Bennett,8,0,32,24
1657787829937,MATH 142A,B04,093558,Chow; Bennett,13,0,32,19
1657787829937,MATH 142A,B05,093559,Chow; Bennett,6,0,32,26
1657787835961,MATH 193A,A01,083224,Rotar; Vladimir,8,0,34,26
1657787835961,MATH 193A,A02,083225,Rotar; Vladimir,9,0,34,25
1657787835961,MATH 193A,A03,083781,Rotar; Vladimir,5,0,34,29
1657787835961,MATH 193A,A04,083782,Rotar; Vladimir,10,0,34,24
1657787835961,MATH 193A,A05,093482,Rotar; Vladimir,10,0,34,24
1657787841985,MATH 197,001,091859,McAuley; Julian John,9999,0,9999,0
1657787841985,MATH 197,002,095566,Kedlaya; Kiran S.,9997,0,9999,2
1657787841985,MATH 197,003,095567,Xiao; Ming,9999,0,9999,0
1657787841985,MATH 197,004,095571,Perols; Johan Lars,9998,0,9999,1
1657787849048,COGS 9,A01,083615,Shannon; Kyle Michael,9,0,75,66
1657787855075,COGS 11,A01,083617,Boyle; Mary E. T.,23,0,48,25
1657787861099,COGS 13,A01,083071,Bastos; Amalia Pinkusfeld,11,0,71,60
1657787867133,COGS 14A,A01,092681,Semenuks; Arturs,5,1,100,95
1657787873161,COGS 14B,A01,083073,Cheng; Tzu-Han,6,0,63,57
1657787879185,COGS 17,A01,092677,Semenuks; Arturs,6,0,81,75
1657787885207,COGS 100,A01,083619,Allen; Michael Gordon,17,0,70,53
1657787891229,COGS 101A,A01,083621,Davis; Joshua Daniel,9,0,68,59
1657787897257,COGS 101B,A01,091572,Allen; Michael Gordon,12,0,65,53
1657787903281,COGS 101C,A01,083625,Delgado; Tania,17,0,35,18
1657787909307,COGS 107A,A01,083627,Boyle; Mary E. T.,14,0,60,46
1657787915331,COGS 118A,A01,083075,Gupta; Anjum,21,0,76,55
1657787921356,CSE 3,A50,083646,Miranda; Gregory Joseph,24,0,50,26
1657787927379,CSE 8A,A50,083650,Miranda; Gregory Joseph,17,1,56,39
1657787933403,CSE 11,A01,083080,Cao; Yingjun,6,15,40,34
1657787939432,CSE 12,A01,083652,Krause-Levy; Sophia Louisa,28,1,120,92
1657787945457,CSE 15L,A01,083654,Morris; Justin Loren,9,0,50,41
1657787945457,CSE 15L,A02,083655,Morris; Justin Loren,9,0,50,41
1657787951481,CSE 20,A01,083657,Tran; Khoa Dang,39,0,80,41
1657787957508,CSE 21,A01,095574,Bach; Quang Tran,22,0,48,26
1657787963536,CSE 30,A01,083084,Eldon; John,6,0,80,74
1657787963536,CSE 30,B01,095061,Bhaskar; Nishant,9,0,50,41
1657787969645,CSE 100,A01,083659,Cao; Yingjun,5,4,70,65
1657787975669,CSE 134B,A01,083661,Powell; Thomas Allan,24,0,100,76
1657787981694,CSE 140,A01,083663,Gungor; Onat,15,0,85,70
1657787987716,CSE 140L,A01,083088,Eldon; John,23,0,100,77
1657787993745,CSE 175,A01,083665,Kumar; Rakesh,3,0,25,22
1657787999774,CSE 190,A00,092507,Dubnov; Shlomo,8,0,20,12
1657788005799,ECE 45,A01,083139,Congero; Spencer William,6,0,75,69
1657788011828,ECE 65,A50,083695,Saad; Andrew S,12,0,30,18
1657788011828,ECE 65,A51,095125,Saad; Andrew S,24,0,26,2
1657788017853,ECE 109,A01,091882,Touri; Behrouz,20,0,70,50
1657788023882,ECE 180,A00,083140,Abi Samra; Nicholas Camill,1,0,30,29
1657788023882,ECE 180,B00,083141,Abi Samra; Nicholas Camill,0,0,30,30
1657788029907,MATH 10A,A01,083735,Patchell; Gregory David,2,0,30,28
1657788029907,MATH 10A,A02,083736,Patchell; Gregory David,20,0,30,10
1657788029907,MATH 10A,A03,083737,Patchell; Gregory David,16,0,30,14
1657788035935,MATH 10B,A01,083207,Lim; Seonhee,8,0,34,26
1657788035935,MATH 10B,A02,083208,Lim; Seonhee,10,0,35,25
1657788035935,MATH 10B,A03,093472,Lim; Seonhee,7,0,34,27
1657788035935,MATH 10B,B01,083739,Sinha; Shubham,13,0,30,17
1657788041963,MATH 18,A01,083743,Cinel; Cameron Alexander,9,0,30,21
1657788041963,MATH 18,A02,083744,Cinel; Cameron Alexander,18,0,30,12
1657788041963,MATH 18,A03,083745,Cinel; Cameron Alexander,10,0,30,20
1657788041963,MATH 18,B01,083748,Rideout; David Porter,5,0,37,32
1657788041963,MATH 18,B02,083749,Rideout; David Porter,5,0,36,31
1657788041963,MATH 18,B03,083750,Rideout; David Porter,3,0,37,34
1657788041963,MATH 18,B04,083751,Rideout; David Porter,6,0,36,30
1657788041963,MATH 18,B05,093473,Rideout; David Porter,6,0,36,30
1657788041963,MATH 18,B06,093474,Rideout; David Porter,6,0,36,30
1657788047989,MATH 20A,A01,083754,Zheng; Zequn,14,0,40,26
1657788054016,MATH 20B,A01,083756,Briones; Jor-el Thomas Caparas,4,0,36,32
1657788054016,MATH 20B,A02,083757,Briones; Jor-el Thomas Caparas,1,0,36,35
1657788054016,MATH 20B,A03,093475,Briones; Jor-el Thomas Caparas,2,0,36,34
1657788060040,MATH 20C,A01,083760,Briones; Jor-el Thomas Caparas,1,0,35,34
1657788060040,MATH 20C,A02,083761,Briones; Jor-el Thomas Caparas,8,0,35,27
1657788060040,MATH 20C,A03,093476,Briones; Jor-el Thomas Caparas,0,1,36,36
1657788060040,MATH 20C,B01,083762,Bach; Quang Tran,1,0,30,29
1657788066069,MATH 20D,A01,083765,Tran; Brian Kha,5,0,30,25
1657788066069,MATH 20D,A02,083766,Tran; Brian Kha,5,0,30,25
1657788066069,MATH 20D,A03,083767,Tran; Brian Kha,5,0,30,25
1657788072105,MATH 20E,A01,083771,Ganguly; Soumya,10,0,32,22
1657788072105,MATH 20E,A02,083772,Ganguly; Soumya,6,0,32,26
1657788072105,MATH 20E,B01,083773,Ciotti; Benjamin,20,0,35,15
1657788072105,MATH 20E,B02,083774,Ciotti; Benjamin,18,0,35,17
1657788078133,MATH 103A,A01,083777,Greenfeld; Be'Eri,3,0,36,33
1657788078133,MATH 103A,A02,083778,Greenfeld; Be'Eri,5,0,36,31
1657788078133,MATH 103A,A03,093561,Greenfeld; Be'Eri,6,0,36,30
1657788078133,MATH 103A,B01,083779,Greenfeld; Be'Eri,7,0,36,29
1657788078133,MATH 103A,B02,083780,Greenfeld; Be'Eri,4,0,36,32
1657788078133,MATH 103A,B03,093562,Greenfeld; Be'Eri,3,0,36,33
1657788084160,MATH 105,A01,085443,Carter; Anne Toulson,15,0,35,20
1657788084160,MATH 105,A02,093477,Carter; Anne Toulson,20,0,35,15
1657788090188,MATH 109,A01,083213,Ganzberger; Geoffrey Michael,3,0,34,31
1657788090188,MATH 109,A02,083214,Ganzberger; Geoffrey Michael,4,0,34,30
1657788090188,MATH 109,A03,093478,Ganzberger; Geoffrey Michael,2,0,34,32
1657788090188,MATH 109,B01,083215,Ganzberger; Geoffrey Michael,1,0,32,31
1657788090188,MATH 109,B02,083216,Ganzberger; Geoffrey Michael,2,0,32,30
1657788090188,MATH 109,B03,093479,Ganzberger; Geoffrey Michael,8,0,32,24
1657788096221,MATH 142A,A01,083219,Chow; Bennett,7,0,32,25
1657788096221,MATH 142A,A02,083220,Chow; Bennett,10,0,32,22
1657788096221,MATH 142A,A03,093480,Chow; Bennett,9,0,32,23
1657788096221,MATH 142A,B03,093481,Chow; Bennett,8,0,32,24
1657788096221,MATH 142A,B04,093558,Chow; Bennett,13,0,32,19
1657788096221,MATH 142A,B05,093559,Chow; Bennett,6,0,32,26
1657788102249,MATH 193A,A01,083224,Rotar; Vladimir,8,0,34,26
1657788102249,MATH 193A,A02,083225,Rotar; Vladimir,9,0,34,25
1657788102249,MATH 193A,A03,083781,Rotar; Vladimir,5,0,34,29
1657788102249,MATH 193A,A04,083782,Rotar; Vladimir,10,0,34,24
1657788102249,MATH 193A,A05,093482,Rotar; Vladimir,10,0,34,24
1657788108274,MATH 197,001,091859,McAuley; Julian John,9999,0,9999,0
1657788108274,MATH 197,002,095566,Kedlaya; Kiran S.,9997,0,9999,2
1657788108274,MATH 197,003,095567,Xiao; Ming,9999,0,9999,0
1657788108274,MATH 197,004,095571,Perols; Johan Lars,9998,0,9999,1
1657788115354,COGS 9,A01,083615,Shannon; Kyle Michael,9,0,75,66
1657788121379,COGS 11,A01,083617,Boyle; Mary E. T.,23,0,48,25
1657788127405,COGS 13,A01,083071,Bastos; Amalia Pinkusfeld,11,0,71,60
1657788133434,COGS 14A,A01,092681,Semenuks; Arturs,5,1,100,95
1657788139467,COGS 14B,A01,083073,Cheng; Tzu-Han,6,0,63,57
1657788145496,COGS 17,A01,092677,Semenuks; Arturs,6,0,81,75
1657788151521,COGS 100,A01,083619,Allen; Michael Gordon,17,0,70,53
1657788157549,COGS 101A,A01,083621,Davis; Joshua Daniel,9,0,68,59
1657788163577,COGS 101B,A01,091572,Allen; Michael Gordon,12,0,65,53
1657788169603,COGS 101C,A01,083625,Delgado; Tania,17,0,35,18
1657788175629,COGS 107A,A01,083627,Boyle; Mary E. T.,14,0,60,46
1657788181659,COGS 118A,A01,083075,Gupta; Anjum,21,0,76,55
1657788187691,CSE 3,A50,083646,Miranda; Gregory Joseph,24,0,50,26
1657788193721,CSE 8A,A50,083650,Miranda; Gregory Joseph,17,1,56,39
1657788199745,CSE 11,A01,083080,Cao; Yingjun,6,15,40,34
1657788205777,CSE 12,A01,083652,Krause-Levy; Sophia Louisa,28,1,120,92
1657788211803,CSE 15L,A01,083654,Morris; Justin Loren,9,0,50,41
1657788211803,CSE 15L,A02,083655,Morris; Justin Loren,9,0,50,41
1657788217825,CSE 20,A01,083657,Tran; Khoa Dang,39,0,80,41
1657788223849,CSE 21,A01,095574,Bach; Quang Tran,22,0,48,26
1657788229876,CSE 30,A01,083084,Eldon; John,6,0,80,74
1657788229876,CSE 30,B01,095061,Bhaskar; Nishant,9,0,50,41
1657788235902,CSE 100,A01,083659,Cao; Yingjun,5,4,70,65
1657788241927,CSE 134B,A01,083661,Powell; Thomas Allan,24,0,100,76
1657788247950,CSE 140,A01,083663,Gungor; Onat,15,0,85,70
1657788253975,CSE 140L,A01,083088,Eldon; John,23,0,100,77
1657788260000,CSE 175,A01,083665,Kumar; Rakesh,3,0,25,22
1657788266024,CSE 190,A00,092507,Dubnov; Shlomo,8,0,20,12
1657788272050,ECE 45,A01,083139,Congero; Spencer William,6,0,75,69
1657788278077,ECE 65,A50,083695,Saad; Andrew S,12,0,30,18
1657788278077,ECE 65,A51,095125,Saad; Andrew S,24,0,26,2
1657788284102,ECE 109,A01,091882,Touri; Behrouz,20,0,70,50
1657788290127,ECE 180,A00,083140,Abi Samra; Nicholas Camill,1,0,30,29
1657788290127,ECE 180,B00,083141,Abi Samra; Nicholas Camill,0,0,30,30
1657788296166,MATH 10A,A01,083735,Patchell; Gregory David,2,0,30,28
1657788296166,MATH 10A,A02,083736,Patchell; Gregory David,20,0,30,10
1657788296166,MATH 10A,A03,083737,Patchell; Gregory David,16,0,30,14
1657788302205,MATH 10B,A01,083207,Lim; Seonhee,8,0,34,26
1657788302205,MATH 10B,A02,083208,Lim; Seonhee,10,0,35,25
1657788302205,MATH 10B,A03,093472,Lim; Seonhee,7,0,34,27
1657788302205,MATH 10B,B01,083739,Sinha; Shubham,13,0,30,17
1657788308243,MATH 18,A01,083743,Cinel; Cameron Alexander,9,0,30,21
1657788308243,MATH 18,A02,083744,Cinel; Cameron Alexander,18,0,30,12
1657788308243,MATH 18,A03,083745,Cinel; Cameron Alexander,10,0,30,20
1657788308243,MATH 18,B01,083748,Rideout; David Porter,5,0,37,32
1657788308243,MATH 18,B02,083749,Rideout; David Porter,5,0,36,31
1657788308243,MATH 18,B03,083750,Rideout; David Porter,3,0,37,34
1657788308243,MATH 18,B04,083751,Rideout; David Porter,6,0,36,30
1657788308243,MATH 18,B05,093473,Rideout; David Porter,6,0,36,30
1657788308243,MATH 18,B06,093474,Rideout; David Porter,6,0,36,30
1657788314267,MATH 20A,A01,083754,Zheng; Zequn,14,0,40,26
1657788320293,MATH 20B,A01,083756,Briones; Jor-el Thomas Caparas,4,0,36,32
1657788320293,MATH 20B,A02,083757,Briones; Jor-el Thomas Caparas,1,0,36,35
1657788320293,MATH 20B,A03,093475,Briones; Jor-el Thomas Caparas,2,0,36,34
1657788326323,MATH 20C,A01,083760,Briones; Jor-el Thomas Caparas,1,0,35,34
1657788326323,MATH 20C,A02,083761,Briones; Jor-el Thomas Caparas,8,0,35,27
1657788326323,MATH 20C,A03,093476,Briones; Jor-el Thomas Caparas,0,1,36,36
1657788326323,MATH 20C,B01,083762,Bach; Quang Tran,1,0,30,29
1657788332349,MATH 20D,A01,083765,Tran; Brian Kha,5,0,30,25
1657788332349,MATH 20D,A02,083766,Tran; Brian Kha,5,0,30,25
1657788332349,MATH 20D,A03,083767,Tran; Brian Kha,5,0,30,25
1657788338389,MATH 20E,A01,083771,Ganguly; Soumya,10,0,32,22
1657788338389,MATH 20E,A02,083772,Ganguly; Soumya,6,0,32,26
1657788338389,MATH 20E,B01,083773,Ciotti; Benjamin,20,0,35,15
1657788338389,MATH 20E,B02,083774,Ciotti; Benjamin,18,0,35,17
1657788344417,MATH 103A,A01,083777,Greenfeld; Be'Eri,3,0,36,33
1657788344417,MATH 103A,A02,083778,Greenfeld; Be'Eri,5,0,36,31
1657788344417,MATH 103A,A03,093561,Greenfeld; Be'Eri,6,0,36,30
1657788344417,MATH 103A,B01,083779,Greenfeld; Be'Eri,7,0,36,29
1657788344417,MATH 103A,B02,083780,Greenfeld; Be'Eri,4,0,36,32
1657788344417,MATH 103A,B03,093562,Greenfeld; Be'Eri,3,0,36,33
1657788350441,MATH 105,A01,085443,Carter; Anne Toulson,15,0,35,20
1657788350441,MATH 105,A02,093477,Carter; Anne Toulson,20,0,35,15
1657788356465,MATH 109,A01,083213,Ganzberger; Geoffrey Michael,3,0,34,31
1657788356465,MATH 109,A02,083214,Ganzberger; Geoffrey Michael,4,0,34,30
1657788356465,MATH 109,A03,093478,Ganzberger; Geoffrey Michael,2,0,34,32
1657788356465,MATH 109,B01,083215,Ganzberger; Geoffrey Michael,1,0,32,31
1657788356465,MATH 109,B02,083216,Ganzberger; Geoffrey Michael,2,0,32,30
1657788356465,MATH 109,B03,093479,Ganzberger; Geoffrey Michael,8,0,32,24
1657788362493,MATH 142A,A01,083219,Chow; Bennett,7,0,32,25
1657788362493,MATH 142A,A02,083220,Chow; Bennett,10,0,32,22
1657788362493,MATH 142A,A03,093480,Chow; Bennett,9,0,32,23
1657788362493,MATH 142A,B03,093481,Chow; Bennett,8,0,32,24
1657788362493,MATH 142A,B04,093558,Chow; Bennett,13,0,32,19
1657788362493,MATH 142A,B05,093559,Chow; Bennett,6,0,32,26
1657788368525,MATH 193A,A01,083224,Rotar; Vladimir,8,0,34,26
1657788368525,MATH 193A,A02,083225,Rotar; Vladimir,9,0,34,25
1657788368525,MATH 193A,A03,083781,Rotar; Vladimir,5,0,34,29
1657788368525,MATH 193A,A04,083782,Rotar; Vladimir,10,0,34,24
1657788368525,MATH 193A,A05,093482,Rotar; Vladimir,10,0,34,24
1657788374551,MATH 197,001,091859,McAuley; Julian John,9999,0,9999,0
1657788374551,MATH 197,002,095566,Kedlaya; Kiran S.,9997,0,9999,2
1657788374551,MATH 197,003,095567,Xiao; Ming,9999,0,9999,0
1657788374551,MATH 197,004,095571,Perols; Johan Lars,9998,0,9999,1
1657788381613,COGS 9,A01,083615,Shannon; Kyle Michael,9,0,75,66
1657788387643,COGS 11,A01,083617,Boyle; Mary E. T.,23,0,48,25
1657788393669,COGS 13,A01,083071,Bastos; Amalia Pinkusfeld,11,0,71,60
1657788399693,COGS 14A,A01,092681,Semenuks; Arturs,5,1,100,95
1657788405718,COGS 14B,A01,083073,Cheng; Tzu-Han,6,0,63,57
1657788411747,COGS 17,A01,092677,Semenuks; Arturs,6,0,81,75
1657788417780,COGS 100,A01,083619,Allen; Michael Gordon,17,0,70,53
1657788423816,COGS 101A,A01,083621,Davis; Joshua Daniel,9,0,68,59
1657788429853,COGS 101B,A01,091572,Allen; Michael Gordon,12,0,65,53
1657788435876,COGS 101C,A01,083625,Delgado; Tania,17,0,35,18
1657788441902,COGS 107A,A01,083627,Boyle; Mary E. T.,14,0,60,46
1657788447927,COGS 118A,A01,083075,Gupta; Anjum,21,0,76,55
1657788453958,CSE 3,A50,083646,Miranda; Gregory Joseph,24,0,50,26
1657788459988,CSE 8A,A50,083650,Miranda; Gregory Joseph,17,1,56,39
1657788466014,CSE 11,A01,083080,Cao; Yingjun,6,15,40,34
1657788472043,CSE 12,A01,083652,Krause-Levy; Sophia Louisa,28,1,120,92
1657788478067,CSE 15L,A01,083654,Morris; Justin Loren,9,0,50,41
1657788478067,CSE 15L,A02,083655,Morris; Justin Loren,9,0,50,41
1657788484098,CSE 20,A01,083657,Tran; Khoa Dang,39,0,80,41
1657788490122,CSE 21,A01,095574,Bach; Quang Tran,22,0,48,26
1657788496148,CSE 30,A01,083084,Eldon; John,6,0,80,74
1657788496148,CSE 30,B01,095061,Bhaskar; Nishant,9,0,50,41
1657788502178,CSE 100,A01,083659,Cao; Yingjun,5,4,70,65
1657788508205,CSE 134B,A01,083661,Powell; Thomas Allan,24,0,100,76
1657788514230,CSE 140,A01,083663,Gungor; Onat,15,0,85,70
1657788520271,CSE 140L,A01,083088,Eldon; John,23,0,100,77
1657788526299,CSE 175,A01,083665,Kumar; Rakesh,3,0,25,22
1657788532324,CSE 190,A00,092507,Dubnov; Shlomo,8,0,20,12
1657788538355,ECE 45,A01,083139,Congero; Spencer William,6,0,75,69
1657788544380,ECE 65,A50,083695,Saad; Andrew S,12,0,30,18
1657788544380,ECE 65,A51,095125,Saad; Andrew S,24,0,26,2
1657788550410,ECE 109,A01,091882,Touri; Behrouz,20,0,70,50
1657788556435,ECE 180,A00,083140,Abi Samra; Nicholas Camill,1,0,30,29
1657788556435,ECE 180,B00,083141,Abi Samra; Nicholas Camill,0,0,30,30
1657788562461,MATH 10A,A01,083735,Patchell; Gregory David,2,0,30,28
1657788562461,MATH 10A,A02,083736,Patchell; Gregory David,20,0,30,10
1657788562461,MATH 10A,A03,083737,Patchell; Gregory David,16,0,30,14
1657788568593,MATH 10B,A01,083207,Lim; Seonhee,8,0,34,26
1657788568593,MATH 10B,A02,083208,Lim; Seonhee,10,0,35,25
1657788568593,MATH 10B,A03,093472,Lim; Seonhee,7,0,34,27
1657788568593,MATH 10B,B01,083739,Sinha; Shubham,13,0,30,17
1657788574624,MATH 18,A01,083743,Cinel; Cameron Alexander,9,0,30,21
1657788574624,MATH 18,A02,083744,Cinel; Cameron Alexander,18,0,30,12
1657788574624,MATH 18,A03,083745,Cinel; Cameron Alexander,10,0,30,20
1657788574624,MATH 18,B01,083748,Rideout; David Porter,5,0,37,32
1657788574624,MATH 18,B02,083749,Rideout; David Porter,5,0,36,31
1657788574624,MATH 18,B03,083750,Rideout; David Porter,3,0,37,34
1657788574624,MATH 18,B04,083751,Rideout; David Porter,6,0,36,30
1657788574624,MATH 18,B05,093473,Rideout; David Porter,6,0,36,30
1657788574624,MATH 18,B06,093474,Rideout; David Porter,6,0,36,30
1657788580650,MATH 20A,A01,083754,Zheng; Zequn,14,0,40,26
1657788586680,MATH 20B,A01,083756,Briones; Jor-el Thomas Caparas,4,0,36,32
1657788586680,MATH 20B,A02,083757,Briones; Jor-el Thomas Caparas,1,0,36,35
1657788586680,MATH 20B,A03,093475,Briones; Jor-el Thomas Caparas,2,0,36,34
1657788592708,MATH 20C,A01,083760,Briones; Jor-el Thomas Caparas,1,0,35,34
1657788592708,MATH 20C,A02,083761,Briones; Jor-el Thomas Caparas,8,0,35,27
1657788592708,MATH 20C,A03,093476,Briones; Jor-el Thomas Caparas,0,1,36,36
1657788592708,MATH 20C,B01,083762,Bach; Quang Tran,1,0,30,29
1657788598742,MATH 20D,A01,083765,Tran; Brian Kha,5,0,30,25
1657788598742,MATH 20D,A02,083766,Tran; Brian Kha,5,0,30,25
1657788598742,MATH 20D,A03,083767,Tran; Brian Kha,5,0,30,25
1657788604769,MATH 20E,A01,083771,Ganguly; Soumya,10,0,32,22
1657788604769,MATH 20E,A02,083772,Ganguly; Soumya,6,0,32,26
1657788604769,MATH 20E,B01,083773,Ciotti; Benjamin,20,0,35,15
1657788604769,MATH 20E,B02,083774,Ciotti; Benjamin,18,0,35,17
1657788610795,MATH 103A,A01,083777,Greenfeld; Be'Eri,3,0,36,33
1657788610795,MATH 103A,A02,083778,Greenfeld; Be'Eri,5,0,36,31
1657788610795,MATH 103A,A03,093561,Greenfeld; Be'Eri,6,0,36,30
1657788610795,MATH 103A,B01,083779,Greenfeld; Be'Eri,7,0,36,29
1657788610795,MATH 103A,B02,083780,Greenfeld; Be'Eri,4,0,36,32
1657788610795,MATH 103A,B03,093562,Greenfeld; Be'Eri,3,0,36,33
1657788616823,MATH 105,A01,085443,Carter; Anne Toulson,15,0,35,20
1657788616823,MATH 105,A02,093477,Carter; Anne Toulson,20,0,35,15
1657788622861,MATH 109,A01,083213,Ganzberger; Geoffrey Michael,3,0,34,31
1657788622861,MATH 109,A02,083214,Ganzberger; Geoffrey Michael,4,0,34,30
1657788622861,MATH 109,A03,093478,Ganzberger; Geoffrey Michael,2,0,34,32
1657788622861,MATH 109,B01,083215,Ganzberger; Geoffrey Michael,1,0,32,31
1657788622861,MATH 109,B02,083216,Ganzberger; Geoffrey Michael,2,0,32,30
1657788622861,MATH 109,B03,093479,Ganzberger; Geoffrey Michael,8,0,32,24
1657788628887,MATH 142A,A01,083219,Chow; Bennett,7,0,32,25
1657788628887,MATH 142A,A02,083220,Chow; Bennett,10,0,32,22
1657788628887,MATH 142A,A03,093480,Chow; Bennett,9,0,32,23
1657788628887,MATH 142A,B03,093481,Chow; Bennett,8,0,32,24
1657788628887,MATH 142A,B04,093558,Chow; Bennett,13,0,32,19
1657788628887,MATH 142A,B05,093559,Chow; Bennett,6,0,32,26
1657788634917,MATH 193A,A01,083224,Rotar; Vladimir,8,0,34,26
1657788634917,MATH 193A,A02,083225,Rotar; Vladimir,9,0,34,25
1657788634917,MATH 193A,A03,083781,Rotar; Vladimir,5,0,34,29
1657788634917,MATH 193A,A04,083782,Rotar; Vladimir,10,0,34,24
1657788634917,MATH 193A,A05,093482,Rotar; Vladimir,10,0,34,24
1657788640945,MATH 197,001,091859,McAuley; Julian John,9999,0,9999,0
1657788640945,MATH 197,002,095566,Kedlaya; Kiran S.,9997,0,9999,2
1657788640945,MATH 197,003,095567,Xiao; Ming,9999,0,9999,0
1657788640945,MATH 197,004,095571,Perols; Johan Lars,9998,0,9999,1
1657788648011,COGS 9,A01,083615,Shannon; Kyle Michael,9,0,75,66
1657788654040,COGS 11,A01,083617,Boyle; Mary E. T.,23,0,48,25
1657788660064,COGS 13,A01,083071,Bastos; Amalia Pinkusfeld,11,0,71,60
1657788666093,COGS 14A,A01,092681,Semenuks; Arturs,5,1,100,95
1657788672122,COGS 14B,A01,083073,Cheng; Tzu-Han,6,0,63,57
1657788678145,COGS 17,A01,092677,Semenuks; Arturs,6,0,81,75
1657788684174,COGS 100,A01,083619,Allen; Michael Gordon,17,0,70,53
1657788690207,COGS 101A,A01,083621,Davis; Joshua Daniel,9,0,68,59
1657788696235,COGS 101B,A01,091572,Allen; Michael Gordon,12,0,65,53
1657788702267,COGS 101C,A01,083625,Delgado; Tania,17,0,35,18
1657788708291,COGS 107A,A01,083627,Boyle; Mary E. T.,14,0,60,46
1657788714314,COGS 118A,A01,083075,Gupta; Anjum,21,0,76,55
1657788720348,CSE 3,A50,083646,Miranda; Gregory Joseph,24,0,50,26
1657788726374,CSE 8A,A50,083650,Miranda; Gregory Joseph,17,1,56,39
1657788732400,CSE 11,A01,083080,Cao; Yingjun,6,15,40,34
1657788738427,CSE 12,A01,083652,Krause-Levy; Sophia Louisa,28,1,120,92
1657788744455,CSE 15L,A01,083654,Morris; Justin Loren,9,0,50,41
1657788744455,CSE 15L,A02,083655,Morris; Justin Loren,9,0,50,41
1657788750483,CSE 20,A01,083657,Tran; Khoa Dang,39,0,80,41
1657788756512,CSE 21,A01,095574,Bach; Quang Tran,22,0,48,26
1657788762537,CSE 30,A01,083084,Eldon; John,6,0,80,74
1657788762537,CSE 30,B01,095061,Bhaskar; Nishant,9,0,50,41
1657788768562,CSE 100,A01,083659,Cao; Yingjun,5,4,70,65
1657788774584,CSE 134B,A01,083661,Powell; Thomas Allan,24,0,100,76
1657788780612,CSE 140,A01,083663,Gungor; Onat,15,0,85,70
1657788786638,CSE 140L,A01,083088,Eldon; John,23,0,100,77
1657788792661,CSE 175,A01,083665,Kumar; Rakesh,3,0,25,22
1657788798689,CSE 190,A00,092507,Dubnov; Shlomo,8,0,20,12
1657788804714,ECE 45,A01,083139,Congero; Spencer William,6,0,75,69
1657788810741,ECE 65,A50,083695,Saad; Andrew S,12,0,30,18
1657788810741,ECE 65,A51,095125,Saad; Andrew S,24,0,26,2
1657788816767,ECE 109,A01,091882,Touri; Behrouz,20,0,70,50
1657788822791,ECE 180,A00,083140,Abi Samra; Nicholas Camill,1,0,30,29
1657788822791,ECE 180,B00,083141,Abi Samra; Nicholas Camill,0,0,30,30
1657788828816,MATH 10A,A01,083735,Patchell; Gregory David,2,0,30,28
1657788828816,MATH 10A,A02,083736,Patchell; Gregory David,20,0,30,10
1657788828816,MATH 10A,A03,083737,Patchell; Gregory David,16,0,30,14
1657788834841,MATH 10B,A01,083207,Lim; Seonhee,8,0,34,26
1657788834841,MATH 10B,A02,083208,Lim; Seonhee,10,0,35,25
1657788834841,MATH 10B,A03,093472,Lim; Seonhee,7,0,34,27
1657788834841,MATH 10B,B01,083739,Sinha; Shubham,13,0,30,17
1657788840876,MATH 18,A01,083743,Cinel; Cameron Alexander,9,0,30,21
1657788840876,MATH 18,A02,083744,Cinel; Cameron Alexander,18,0,30,12
1657788840876,MATH 18,A03,083745,Cinel; Cameron Alexander,10,0,30,20
1657788840876,MATH 18,B01,083748,Rideout; David Porter,5,0,37,32
1657788840876,MATH 18,B02,083749,Rideout; David Porter,5,0,36,31
1657788840876,MATH 18,B03,083750,Rideout; David Porter,3,0,37,34
1657788840876,MATH 18,B04,083751,Rideout; David Porter,6,0,36,30
1657788840876,MATH 18,B05,093473,Rideout; David Porter,6,0,36,30
1657788840876,MATH 18,B06,093474,Rideout; David Porter,6,0,36,30
1657788846912,MATH 20A,A01,083754,Zheng; Zequn,14,0,40,26
1657788852943,MATH 20B,A01,083756,Briones; Jor-el Thomas Caparas,4,0,36,32
1657788852943,MATH 20B,A02,083757,Briones; Jor-el Thomas Caparas,1,0,36,35
1657788852943,MATH 20B,A03,093475,Briones; Jor-el Thomas Caparas,2,0,36,34
1657788858974,MATH 20C,A01,083760,Briones; Jor-el Thomas Caparas,1,0,35,34
1657788858974,MATH 20C,A02,083761,Briones; Jor-el Thomas Caparas,8,0,35,27
1657788858974,MATH 20C,A03,093476,Briones; Jor-el Thomas Caparas,0,1,36,36
1657788858974,MATH 20C,B01,083762,Bach; Quang Tran,1,0,30,29
1657788865001,MATH 20D,A01,083765,Tran; Brian Kha,5,0,30,25
1657788865001,MATH 20D,A02,083766,Tran; Brian Kha,5,0,30,25
1657788865001,MATH 20D,A03,083767,Tran; Brian Kha,5,0,30,25
1657788871027,MATH 20E,A01,083771,Ganguly; Soumya,10,0,32,22
1657788871027,MATH 20E,A02,083772,Ganguly; Soumya,6,0,32,26
1657788871027,MATH 20E,B01,083773,Ciotti; Benjamin,20,0,35,15
1657788871027,MATH 20E,B02,083774,Ciotti; Benjamin,18,0,35,17
1657788877056,MATH 103A,A01,083777,Greenfeld; Be'Eri,3,0,36,33
1657788877056,MATH 103A,A02,083778,Greenfeld; Be'Eri,5,0,36,31
1657788877056,MATH 103A,A03,093561,Greenfeld; Be'Eri,6,0,36,30
1657788877056,MATH 103A,B01,083779,Greenfeld; Be'Eri,7,0,36,29
1657788877056,MATH 103A,B02,083780,Greenfeld; Be'Eri,4,0,36,32
1657788877056,MATH 103A,B03,093562,Greenfeld; Be'Eri,3,0,36,33
1657788883081,MATH 105,A01,085443,Carter; Anne Toulson,15,0,35,20
1657788883081,MATH 105,A02,093477,Carter; Anne Toulson,20,0,35,15
1657788889104,MATH 109,A01,083213,Ganzberger; Geoffrey Michael,3,0,34,31
1657788889104,MATH 109,A02,083214,Ganzberger; Geoffrey Michael,4,0,34,30
1657788889104,MATH 109,A03,093478,Ganzberger; Geoffrey Michael,2,0,34,32
1657788889104,MATH 109,B01,083215,Ganzberger; Geoffrey Michael,1,0,32,31
1657788889104,MATH 109,B02,083216,Ganzberger; Geoffrey Michael,2,0,32,30
1657788889104,MATH 109,B03,093479,Ganzberger; Geoffrey Michael,8,0,32,24
1657788895130,MATH 142A,A01,083219,Chow; Bennett,7,0,32,25
1657788895130,MATH 142A,A02,083220,Chow; Bennett,10,0,32,22
1657788895130,MATH 142A,A03,093480,Chow; Bennett,9,0,32,23
1657788895130,MATH 142A,B03,093481,Chow; Bennett,8,0,32,24
1657788895130,MATH 142A,B04,093558,Chow; Bennett,13,0,32,19
1657788895130,MATH 142A,B05,093559,Chow; Bennett,6,0,32,26
1657788901161,MATH 193A,A01,083224,Rotar; Vladimir,8,0,34,26
1657788901161,MATH 193A,A02,083225,Rotar; Vladimir,9,0,34,25
1657788901161,MATH 193A,A03,083781,Rotar; Vladimir,5,0,34,29
1657788901161,MATH 193A,A04,083782,Rotar; Vladimir,10,0,34,24
1657788901161,MATH 193A,A05,093482,Rotar; Vladimir,10,0,34,24
1657788907183,MATH 197,001,091859,McAuley; Julian John,9999,0,9999,0
1657788907183,MATH 197,002,095566,Kedlaya; Kiran S.,9997,0,9999,2
1657788907183,MATH 197,003,095567,Xiao; Ming,9999,0,9999,0
1657788907183,MATH 197,004,095571,Perols; Johan Lars,9998,0,9999,1
1657788914248,COGS 9,A01,083615,Shannon; Kyle Michael,9,0,75,66
1657788920271,COGS 11,A01,083617,Boyle; Mary E. T.,23,0,48,25
1657788926300,COGS 13,A01,083071,Bastos; Amalia Pinkusfeld,11,0,71,60
1657788932327,COGS 14A,A01,092681,Semenuks; Arturs,5,1,100,95
1657788938355,COGS 14B,A01,083073,Cheng; Tzu-Han,6,0,63,57
1657788944378,COGS 17,A01,092677,Semenuks; Arturs,6,0,81,75
1657788950402,COGS 100,A01,083619,Allen; Michael Gordon,17,0,70,53
1657788956426,COGS 101A,A01,083621,Davis; Joshua Daniel,9,0,68,59
1657788962462,COGS 101B,A01,091572,Allen; Michael Gordon,12,0,65,53
1657788968488,COGS 101C,A01,083625,Delgado; Tania,17,0,35,18
1657788974513,COGS 107A,A01,083627,Boyle; Mary E. T.,14,0,60,46
1657788980539,COGS 118A,A01,083075,Gupta; Anjum,21,0,76,55
1657788986564,CSE 3,A50,083646,Miranda; Gregory Joseph,24,0,50,26
1657788992591,CSE 8A,A50,083650,Miranda; Gregory Joseph,17,1,56,39
1657788998619,CSE 11,A01,083080,Cao; Yingjun,6,15,40,34
1657789004643,CSE 12,A01,083652,Krause-Levy; Sophia Louisa,28,1,120,92
1657789010667,CSE 15L,A01,083654,Morris; Justin Loren,9,0,50,41
1657789010667,CSE 15L,A02,083655,Morris; Justin Loren,9,0,50,41
1657789016691,CSE 20,A01,083657,Tran; Khoa Dang,39,0,80,41
1657789022718,CSE 21,A01,095574,Bach; Quang Tran,22,0,48,26
1657789028747,CSE 30,A01,083084,Eldon; John,6,0,80,74
1657789028747,CSE 30,B01,095061,Bhaskar; Nishant,9,0,50,41
1657789034770,CSE 100,A01,083659,Cao; Yingjun,5,4,70,65
1657789040796,CSE 134B,A01,083661,Powell; Thomas Allan,24,0,100,76
1657789046824,CSE 140,A01,083663,Gungor; Onat,15,0,85,70
1657789052852,CSE 140L,A01,083088,Eldon; John,23,0,100,77
1657789058874,CSE 175,A01,083665,Kumar; Rakesh,3,0,25,22
1657789064899,CSE 190,A00,092507,Dubnov; Shlomo,8,0,20,12
1657789070931,ECE 45,A01,083139,Congero; Spencer William,6,0,75,69
1657789076955,ECE 65,A50,083695,Saad; Andrew S,12,0,30,18
1657789076955,ECE 65,A51,095125,Saad; Andrew S,24,0,26,2
1657789082985,ECE 109,A01,091882,Touri; Behrouz,20,0,70,50
1657789089010,ECE 180,A00,083140,Abi Samra; Nicholas Camill,1,0,30,29
1657789089010,ECE 180,B00,083141,Abi Samra; Nicholas Camill,0,0,30,30
1657789095035,MATH 10A,A01,083735,Patchell; Gregory David,2,0,30,28
1657789095035,MATH 10A,A02,083736,Patchell; Gregory David,20,0,30,10
1657789095035,MATH 10A,A03,083737,Patchell; Gregory David,16,0,30,14
1657789101065,MATH 10B,A01,083207,Lim; Seonhee,8,0,34,26
1657789101065,MATH 10B,A02,083208,Lim; Seonhee,10,0,35,25
1657789101065,MATH 10B,A03,093472,Lim; Seonhee,7,0,34,27
1657789101065,MATH 10B,B01,083739,Sinha; Shubham,13,0,30,17
1657789107092,MATH 18,A01,083743,Cinel; Cameron Alexander,9,0,30,21
1657789107092,MATH 18,A02,083744,Cinel; Cameron Alexander,18,0,30,12
1657789107092,MATH 18,A03,083745,Cinel; Cameron Alexander,10,0,30,20
1657789107092,MATH 18,B01,083748,Rideout; David Porter,5,0,37,32
1657789107092,MATH 18,B02,083749,Rideout; David Porter,5,0,36,31
1657789107092,MATH 18,B03,083750,Rideout; David Porter,3,0,37,34
1657789107092,MATH 18,B04,083751,Rideout; David Porter,6,0,36,30
1657789107092,MATH 18,B05,093473,Rideout; David Porter,6,0,36,30
1657789107092,MATH 18,B06,093474,Rideout; David Porter,6,0,36,30
1657789113118,MATH 20A,A01,083754,Zheng; Zequn,14,0,40,26
1657789119141,MATH 20B,A01,083756,Briones; Jor-el Thomas Caparas,4,0,36,32
1657789119141,MATH 20B,A02,083757,Briones; Jor-el Thomas Caparas,1,0,36,35
1657789119141,MATH 20B,A03,093475,Briones; Jor-el Thomas Caparas,2,0,36,34
1657789125168,MATH 20C,A01,083760,Briones; Jor-el Thomas Caparas,1,0,35,34
1657789125168,MATH 20C,A02,083761,Briones; Jor-el Thomas Caparas,8,0,35,27
1657789125168,MATH 20C,A03,093476,Briones; Jor-el Thomas Caparas,0,1,36,36
1657789125168,MATH 20C,B01,083762,Bach; Quang Tran,1,0,30,29
1657789131197,MATH 20D,A01,083765,Tran; Brian Kha,5,0,30,25
1657789131197,MATH 20D,A02,083766,Tran; Brian Kha,5,0,30,25
1657789131197,MATH 20D,A03,083767,Tran; Brian Kha,5,0,30,25
1657789137226,MATH 20E,A01,083771,Ganguly; Soumya,10,0,32,22
1657789137226,MATH 20E,A02,083772,Ganguly; Soumya,6,0,32,26
1657789137226,MATH 20E,B01,083773,Ciotti; Benjamin,20,0,35,15
1657789137226,MATH 20E,B02,083774,Ciotti; Benjamin,18,0,35,17
1657789143250,MATH 103A,A01,083777,Greenfeld; Be'Eri,3,0,36,33
1657789143250,MATH 103A,A02,083778,Greenfeld; Be'Eri,5,0,36,31
1657789143250,MATH 103A,A03,093561,Greenfeld; Be'Eri,6,0,36,30
1657789143250,MATH 103A,B01,083779,Greenfeld; Be'Eri,7,0,36,29
1657789143250,MATH 103A,B02,083780,Greenfeld; Be'Eri,4,0,36,32
1657789143250,MATH 103A,B03,093562,Greenfeld; Be'Eri,3,0,36,33
1657789149281,MATH 105,A01,085443,Carter; Anne Toulson,15,0,35,20
1657789149281,MATH 105,A02,093477,Carter; Anne Toulson,20,0,35,15
1657789155310,MATH 109,A01,083213,Ganzberger; Geoffrey Michael,3,0,34,31
1657789155310,MATH 109,A02,083214,Ganzberger; Geoffrey Michael,4,0,34,30
1657789155310,MATH 109,A03,093478,Ganzberger; Geoffrey Michael,2,0,34,32
1657789155310,MATH 109,B01,083215,Ganzberger; Geoffrey Michael,1,0,32,31
1657789155310,MATH 109,B02,083216,Ganzberger; Geoffrey Michael,2,0,32,30
1657789155310,MATH 109,B03,093479,Ganzberger; Geoffrey Michael,8,0,32,24
1657789161341,MATH 142A,A01,083219,Chow; Bennett,7,0,32,25
1657789161341,MATH 142A,A02,083220,Chow; Bennett,10,0,32,22
1657789161341,MATH 142A,A03,093480,Chow; Bennett,9,0,32,23
1657789161341,MATH 142A,B03,093481,Chow; Bennett,8,0,32,24
1657789161341,MATH 142A,B04,093558,Chow; Bennett,13,0,32,19
1657789161341,MATH 142A,B05,093559,Chow; Bennett,6,0,32,26
1657789167439,MATH 193A,A01,083224,Rotar; Vladimir,8,0,34,26
1657789167439,MATH 193A,A02,083225,Rotar; Vladimir,9,0,34,25
1657789167439,MATH 193A,A03,083781,Rotar; Vladimir,5,0,34,29
1657789167439,MATH 193A,A04,083782,Rotar; Vladimir,10,0,34,24
1657789167439,MATH 193A,A05,093482,Rotar; Vladimir,10,0,34,24
1657789173464,MATH 197,001,091859,McAuley; Julian John,9999,0,9999,0
1657789173464,MATH 197,002,095566,Kedlaya; Kiran S.,9997,0,9999,2
1657789173464,MATH 197,003,095567,Xiao; Ming,9999,0,9999,0
1657789173464,MATH 197,004,095571,Perols; Johan Lars,9998,0,9999,1
1657789180527,COGS 9,A01,083615,Shannon; Kyle Michael,9,0,75,66
1657789186550,COGS 11,A01,083617,Boyle; Mary E. T.,23,0,48,25
1657789192575,COGS 13,A01,083071,Bastos; Amalia Pinkusfeld,11,0,71,60
1657789198598,COGS 14A,A01,092681,Semenuks; Arturs,5,1,100,95
1657789204621,COGS 14B,A01,083073,Cheng; Tzu-Han,6,0,63,57
1657789210644,COGS 17,A01,092677,Semenuks; Arturs,6,0,81,75
1657789216687,COGS 100,A01,083619,Allen; Michael Gordon,17,0,70,53
1657789222717,COGS 101A,A01,083621,Davis; Joshua Daniel,9,0,68,59
1657789228744,COGS 101B,A01,091572,Allen; Michael Gordon,12,0,65,53
1657789234768,COGS 101C,A01,083625,Delgado; Tania,17,0,35,18
1657789240791,COGS 107A,A01,083627,Boyle; Mary E. T.,14,0,60,46
1657789246817,COGS 118A,A01,083075,Gupta; Anjum,21,0,76,55
1657789252839,CSE 3,A50,083646,Miranda; Gregory Joseph,24,0,50,26
1657789258862,CSE 8A,A50,083650,Miranda; Gregory Joseph,17,1,56,39
1657789264889,CSE 11,A01,083080,Cao; Yingjun,6,15,40,34
1657789270913,CSE 12,A01,083652,Krause-Levy; Sophia Louisa,28,1,120,92
1657789276937,CSE 15L,A01,083654,Morris; Justin Loren,9,0,50,41
1657789276937,CSE 15L,A02,083655,Morris; Justin Loren,9,0,50,41
1657789282959,CSE 20,A01,083657,Tran; Khoa Dang,39,0,80,41
1657789288983,CSE 21,A01,095574,Bach; Quang Tran,22,0,48,26
1657789295014,CSE 30,A01,083084,Eldon; John,6,0,80,74
1657789295014,CSE 30,B01,095061,Bhaskar; Nishant,9,0,50,41
1657789301041,CSE 100,A01,083659,Cao; Yingjun,5,4,70,65
1657789307068,CSE 134B,A01,083661,Powell; Thomas Allan,24,0,100,76
1657789313092,CSE 140,A01,083663,Gungor; Onat,15,0,85,70
1657789319120,CSE 140L,A01,083088,Eldon; John,23,0,100,77
1657789325158,CSE 175,A01,083665,Kumar; Rakesh,3,0,25,22
1657789331189,CSE 190,A00,092507,Dubnov; Shlomo,8,0,20,12
1657789337215,ECE 45,A01,083139,Congero; Spencer William,6,0,75,69
1657789343245,ECE 65,A50,083695,Saad; Andrew S,12,0,30,18
1657789343245,ECE 65,A51,095125,Saad; Andrew S,24,0,26,2
1657789349270,ECE 109,A01,091882,Touri; Behrouz,20,0,70,50
1657789355298,ECE 180,A00,083140,Abi Samra; Nicholas Camill,1,0,30,29
1657789355298,ECE 180,B00,083141,Abi Samra; Nicholas Camill,0,0,30,30
1657789361324,MATH 10A,A01,083735,Patchell; Gregory David,2,0,30,28
1657789361324,MATH 10A,A02,083736,Patchell; Gregory David,20,0,30,10
1657789361324,MATH 10A,A03,083737,Patchell; Gregory David,16,0,30,14
1657789367362,MATH 10B,A01,083207,Lim; Seonhee,8,0,34,26
1657789367362,MATH 10B,A02,083208,Lim; Seonhee,10,0,35,25
1657789367362,MATH 10B,A03,093472,Lim; Seonhee,7,0,34,27
1657789367362,MATH 10B,B01,083739,Sinha; Shubham,13,0,30,17
1657789373403,MATH 18,A01,083743,Cinel; Cameron Alexander,9,0,30,21
1657789373403,MATH 18,A02,083744,Cinel; Cameron Alexander,18,0,30,12
1657789373403,MATH 18,A03,083745,Cinel; Cameron Alexander,10,0,30,20
1657789373403,MATH 18,B01,083748,Rideout; David Porter,5,0,37,32
1657789373403,MATH 18,B02,083749,Rideout; David Porter,5,0,36,31
1657789373403,MATH 18,B03,083750,Rideout; David Porter,3,0,37,34
1657789373403,MATH 18,B04,083751,Rideout; David Porter,6,0,36,30
1657789373403,MATH 18,B05,093473,Rideout; David Porter,6,0,36,30
1657789373403,MATH 18,B06,093474,Rideout; David Porter,6,0,36,30
1657789379432,MATH 20A,A01,083754,Zheng; Zequn,14,0,40,26
1657789385457,MATH 20B,A01,083756,Briones; Jor-el Thomas Caparas,4,0,36,32
1657789385457,MATH 20B,A02,083757,Briones; Jor-el Thomas Caparas,1,0,36,35
1657789385457,MATH 20B,A03,093475,Briones; Jor-el Thomas Caparas,2,0,36,34
1657789391488,MATH 20C,A01,083760,Briones; Jor-el Thomas Caparas,1,0,35,34
1657789391488,MATH 20C,A02,083761,Briones; Jor-el Thomas Caparas,8,0,35,27
1657789391488,MATH 20C,A03,093476,Briones; Jor-el Thomas Caparas,0,1,36,36
1657789391488,MATH 20C,B01,083762,Bach; Quang Tran,1,0,30,29
1657789397516,MATH 20D,A01,083765,Tran; Brian Kha,5,0,30,25
1657789397516,MATH 20D,A02,083766,Tran; Brian Kha,5,0,30,25
1657789397516,MATH 20D,A03,083767,Tran; Brian Kha,5,0,30,25
1657789403543,MATH 20E,A01,083771,Ganguly; Soumya,10,0,32,22
1657789403543,MATH 20E,A02,083772,Ganguly; Soumya,6,0,32,26
1657789403543,MATH 20E,B01,083773,Ciotti; Benjamin,20,0,35,15
1657789403543,MATH 20E,B02,083774,Ciotti; Benjamin,18,0,35,17
1657789409574,MATH 103A,A01,083777,Greenfeld; Be'Eri,3,0,36,33
1657789409574,MATH 103A,A02,083778,Greenfeld; Be'Eri,5,0,36,31
1657789409574,MATH 103A,A03,093561,Greenfeld; Be'Eri,6,0,36,30
1657789409574,MATH 103A,B01,083779,Greenfeld; Be'Eri,7,0,36,29
1657789409574,MATH 103A,B02,083780,Greenfeld; Be'Eri,4,0,36,32
1657789409574,MATH 103A,B03,093562,Greenfeld; Be'Eri,3,0,36,33
1657789415600,MATH 105,A01,085443,Carter; Anne Toulson,15,0,35,20
1657789415600,MATH 105,A02,093477,Carter; Anne Toulson,20,0,35,15
1657789421624,MATH 109,A01,083213,Ganzberger; Geoffrey Michael,3,0,34,31
1657789421624,MATH 109,A02,083214,Ganzberger; Geoffrey Michael,4,0,34,30
1657789421624,MATH 109,A03,093478,Ganzberger; Geoffrey Michael,2,0,34,32
1657789421624,MATH 109,B01,083215,Ganzberger; Geoffrey Michael,1,0,32,31
1657789421624,MATH 109,B02,083216,Ganzberger; Geoffrey Michael,2,0,32,30
1657789421624,MATH 109,B03,093479,Ganzberger; Geoffrey Michael,8,0,32,24
1657789427656,MATH 142A,A01,083219,Chow; Bennett,7,0,32,25
1657789427656,MATH 142A,A02,083220,Chow; Bennett,10,0,32,22
1657789427656,MATH 142A,A03,093480,Chow; Bennett,9,0,32,23
1657789427656,MATH 142A,B03,093481,Chow; Bennett,8,0,32,24
1657789427656,MATH 142A,B04,093558,Chow; Bennett,13,0,32,19
1657789427656,MATH 142A,B05,093559,Chow; Bennett,6,0,32,26
1657789433682,MATH 193A,A01,083224,Rotar; Vladimir,8,0,34,26
1657789433682,MATH 193A,A02,083225,Rotar; Vladimir,9,0,34,25
1657789433682,MATH 193A,A03,083781,Rotar; Vladimir,5,0,34,29
1657789433682,MATH 193A,A04,083782,Rotar; Vladimir,10,0,34,24
1657789433682,MATH 193A,A05,093482,Rotar; Vladimir,10,0,34,24
1657789439725,MATH 197,001,091859,McAuley; Julian John,9999,0,9999,0
1657789439725,MATH 197,002,095566,Kedlaya; Kiran S.,9997,0,9999,2
1657789439725,MATH 197,003,095567,Xiao; Ming,9999,0,9999,0
1657789439725,MATH 197,004,095571,Perols; Johan Lars,9998,0,9999,1
1657789446785,COGS 9,A01,083615,Shannon; Kyle Michael,9,0,75,66
1657789452808,COGS 11,A01,083617,Boyle; Mary E. T.,23,0,48,25
1657789458835,COGS 13,A01,083071,Bastos; Amalia Pinkusfeld,11,0,71,60
1657789464869,COGS 14A,A01,092681,Semenuks; Arturs,5,1,100,95
1657789470892,COGS 14B,A01,083073,Cheng; Tzu-Han,6,0,63,57
1657789476914,COGS 17,A01,092677,Semenuks; Arturs,6,0,81,75
1657789482942,COGS 100,A01,083619,Allen; Michael Gordon,17,0,70,53
1657789488967,COGS 101A,A01,083621,Davis; Joshua Daniel,9,0,68,59
1657789494995,COGS 101B,A01,091572,Allen; Michael Gordon,12,0,65,53
1657789501018,COGS 101C,A01,083625,Delgado; Tania,17,0,35,18
1657789507045,COGS 107A,A01,083627,Boyle; Mary E. T.,14,0,60,46
1657789513073,COGS 118A,A01,083075,Gupta; Anjum,21,0,76,55
1657789519102,CSE 3,A50,083646,Miranda; Gregory Joseph,24,0,50,26
1657789525126,CSE 8A,A50,083650,Miranda; Gregory Joseph,17,1,56,39
1657789531159,CSE 11,A01,083080,Cao; Yingjun,6,15,40,34
1657789537182,CSE 12,A01,083652,Krause-Levy; Sophia Louisa,28,1,120,92
1657789543214,CSE 15L,A01,083654,Morris; Justin Loren,9,0,50,41
1657789543214,CSE 15L,A02,083655,Morris; Justin Loren,9,0,50,41
1657789549242,CSE 20,A01,083657,Tran; Khoa Dang,39,0,80,41
1657789555269,CSE 21,A01,095574,Bach; Quang Tran,22,0,48,26
1657789561296,CSE 30,A01,083084,Eldon; John,6,0,80,74
1657789561296,CSE 30,B01,095061,Bhaskar; Nishant,9,0,50,41
1657789567321,CSE 100,A01,083659,Cao; Yingjun,5,4,70,65
1657789573355,CSE 134B,A01,083661,Powell; Thomas Allan,24,0,100,76
1657789579383,CSE 140,A01,083663,Gungor; Onat,15,0,85,70
1657789585411,CSE 140L,A01,083088,Eldon; John,23,0,100,77
1657789591439,CSE 175,A01,083665,Kumar; Rakesh,3,0,25,22
1657789597465,CSE 190,A00,092507,Dubnov; Shlomo,8,0,20,12
1657789603488,ECE 45,A01,083139,Congero; Spencer William,6,0,75,69
1657789609516,ECE 65,A50,083695,Saad; Andrew S,12,0,30,18
1657789609516,ECE 65,A51,095125,Saad; Andrew S,24,0,26,2
1657789615539,ECE 109,A01,091882,Touri; Behrouz,20,0,70,50
1657789621564,ECE 180,A00,083140,Abi Samra; Nicholas Camill,1,0,30,29
1657789621564,ECE 180,B00,083141,Abi Samra; Nicholas Camill,0,0,30,30
1657789627593,MATH 10A,A01,083735,Patchell; Gregory David,2,0,30,28
1657789627593,MATH 10A,A02,083736,Patchell; Gregory David,20,0,30,10
1657789627593,MATH 10A,A03,083737,Patchell; Gregory David,16,0,30,14
1657789633622,MATH 10B,A01,083207,Lim; Seonhee,8,0,34,26
1657789633622,MATH 10B,A02,083208,Lim; Seonhee,10,0,35,25
1657789633622,MATH 10B,A03,093472,Lim; Seonhee,7,0,34,27
1657789633622,MATH 10B,B01,083739,Sinha; Shubham,13,0,30,17
1657789639648,MATH 18,A01,083743,Cinel; Cameron Alexander,9,0,30,21
1657789639648,MATH 18,A02,083744,Cinel; Cameron Alexander,18,0,30,12
1657789639648,MATH 18,A03,083745,Cinel; Cameron Alexander,10,0,30,20
1657789639648,MATH 18,B01,083748,Rideout; David Porter,5,0,37,32
1657789639648,MATH 18,B02,083749,Rideout; David Porter,5,0,36,31
1657789639648,MATH 18,B03,083750,Rideout; David Porter,3,0,37,34
1657789639648,MATH 18,B04,083751,Rideout; David Porter,6,0,36,30
1657789639648,MATH 18,B05,093473,Rideout; David Porter,6,0,36,30
1657789639648,MATH 18,B06,093474,Rideout; David Porter,6,0,36,30
1657789645681,MATH 20A,A01,083754,Zheng; Zequn,14,0,40,26
1657789651710,MATH 20B,A01,083756,Briones; Jor-el Thomas Caparas,4,0,36,32
1657789651710,MATH 20B,A02,083757,Briones; Jor-el Thomas Caparas,1,0,36,35
1657789651710,MATH 20B,A03,093475,Briones; Jor-el Thomas Caparas,2,0,36,34
1657789657735,MATH 20C,A01,083760,Briones; Jor-el Thomas Caparas,1,0,35,34
1657789657735,MATH 20C,A02,083761,Briones; Jor-el Thomas Caparas,8,0,35,27
1657789657735,MATH 20C,A03,093476,Briones; Jor-el Thomas Caparas,0,1,36,36
1657789657735,MATH 20C,B01,083762,Bach; Quang Tran,1,0,30,29
1657789663764,MATH 20D,A01,083765,Tran; Brian Kha,5,0,30,25
1657789663764,MATH 20D,A02,083766,Tran; Brian Kha,5,0,30,25
1657789663764,MATH 20D,A03,083767,Tran; Brian Kha,5,0,30,25
1657789669788,MATH 20E,A01,083771,Ganguly; Soumya,10,0,32,22
1657789669788,MATH 20E,A02,083772,Ganguly; Soumya,6,0,32,26
1657789669788,MATH 20E,B01,083773,Ciotti; Benjamin,20,0,35,15
1657789669788,MATH 20E,B02,083774,Ciotti; Benjamin,18,0,35,17
1657789675819,MATH 103A,A01,083777,Greenfeld; Be'Eri,3,0,36,33
1657789675819,MATH 103A,A02,083778,Greenfeld; Be'Eri,5,0,36,31
1657789675819,MATH 103A,A03,093561,Greenfeld; Be'Eri,6,0,36,30
1657789675819,MATH 103A,B01,083779,Greenfeld; Be'Eri,7,0,36,29
1657789675819,MATH 103A,B02,083780,Greenfeld; Be'Eri,4,0,36,32
1657789675819,MATH 103A,B03,093562,Greenfeld; Be'Eri,3,0,36,33
1657789681856,MATH 105,A01,085443,Carter; Anne Toulson,15,0,35,20
1657789681856,MATH 105,A02,093477,Carter; Anne Toulson,20,0,35,15
1657789687879,MATH 109,A01,083213,Ganzberger; Geoffrey Michael,3,0,34,31
1657789687879,MATH 109,A02,083214,Ganzberger; Geoffrey Michael,4,0,34,30
1657789687879,MATH 109,A03,093478,Ganzberger; Geoffrey Michael,2,0,34,32
1657789687879,MATH 109,B01,083215,Ganzberger; Geoffrey Michael,1,0,32,31
1657789687879,MATH 109,B02,083216,Ganzberger; Geoffrey Michael,2,0,32,30
1657789687879,MATH 109,B03,093479,Ganzberger; Geoffrey Michael,8,0,32,24
1657789693910,MATH 142A,A01,083219,Chow; Bennett,7,0,32,25
1657789693910,MATH 142A,A02,083220,Chow; Bennett,10,0,32,22
1657789693910,MATH 142A,A03,093480,Chow; Bennett,9,0,32,23
1657789693910,MATH 142A,B03,093481,Chow; Bennett,8,0,32,24
1657789693910,MATH 142A,B04,093558,Chow; Bennett,13,0,32,19
1657789693910,MATH 142A,B05,093559,Chow; Bennett,6,0,32,26
1657789699938,MATH 193A,A01,083224,Rotar; Vladimir,8,0,34,26
1657789699938,MATH 193A,A02,083225,Rotar; Vladimir,9,0,34,25
1657789699938,MATH 193A,A03,083781,Rotar; Vladimir,5,0,34,29
1657789699938,MATH 193A,A04,083782,Rotar; Vladimir,10,0,34,24
1657789699938,MATH 193A,A05,093482,Rotar; Vladimir,10,0,34,24
1657789705961,MATH 197,001,091859,McAuley; Julian John,9999,0,9999,0
1657789705961,MATH 197,002,095566,Kedlaya; Kiran S.,9997,0,9999,2
1657789705961,MATH 197,003,095567,Xiao; Ming,9999,0,9999,0
1657789705961,MATH 197,004,095571,Perols; Johan Lars,9998,0,9999,1
1657789713020,COGS 9,A01,083615,Shannon; Kyle Michael,9,0,75,66
1657789719056,COGS 11,A01,083617,Boyle; Mary E. T.,23,0,48,25
1657789725080,COGS 13,A01,083071,Bastos; Amalia Pinkusfeld,11,0,71,60
1657789731108,COGS 14A,A01,092681,Semenuks; Arturs,5,1,100,95
1657789737136,COGS 14B,A01,083073,Cheng; Tzu-Han,6,0,63,57
1657789743170,COGS 17,A01,092677,Semenuks; Arturs,6,0,81,75
1657789749198,COGS 100,A01,083619,Allen; Michael Gordon,17,0,70,53
1657789755226,COGS 101A,A01,083621,Davis; Joshua Daniel,9,0,68,59
1657789761328,COGS 101B,A01,091572,Allen; Michael Gordon,12,0,65,53
1657789767356,COGS 101C,A01,083625,Delgado; Tania,17,0,35,18
1657789773380,COGS 107A,A01,083627,Boyle; Mary E. T.,14,0,60,46
1657789779404,COGS 118A,A01,083075,Gupta; Anjum,21,0,76,55
1657789785429,CSE 3,A50,083646,Miranda; Gregory Joseph,24,0,50,26
1657789791453,CSE 8A,A50,083650,Miranda; Gregory Joseph,17,1,56,39
1657789797477,CSE 11,A01,083080,Cao; Yingjun,6,15,40,34
1657789803507,CSE 12,A01,083652,Krause-Levy; Sophia Louisa,28,1,120,92
1657789809536,CSE 15L,A01,083654,Morris; Justin Loren,9,0,50,41
1657789809536,CSE 15L,A02,083655,Morris; Justin Loren,9,0,50,41
1657789815560,CSE 20,A01,083657,Tran; Khoa Dang,39,0,80,41
1657789821583,CSE 21,A01,095574,Bach; Quang Tran,22,0,48,26
1657789827607,CSE 30,A01,083084,Eldon; John,6,0,80,74
1657789827607,CSE 30,B01,095061,Bhaskar; Nishant,9,0,50,41
1657789833631,CSE 100,A01,083659,Cao; Yingjun,5,4,70,65
1657789839653,CSE 134B,A01,083661,Powell; Thomas Allan,24,0,100,76
1657789845680,CSE 140,A01,083663,Gungor; Onat,15,0,85,70
1657789851724,CSE 140L,A01,083088,Eldon; John,23,0,100,77
1657789857747,CSE 175,A01,083665,Kumar; Rakesh,3,0,25,22
1657789863770,CSE 190,A00,092507,Dubnov; Shlomo,8,0,20,12
1657789869797,ECE 45,A01,083139,Congero; Spencer William,6,0,75,69
1657789875826,ECE 65,A50,083695,Saad; Andrew S,12,0,30,18
1657789875826,ECE 65,A51,095125,Saad; Andrew S,24,0,26,2
1657789881849,ECE 109,A01,091882,Touri; Behrouz,20,0,70,50
1657789887883,ECE 180,A00,083140,Abi Samra; Nicholas Camill,1,0,30,29
1657789887883,ECE 180,B00,083141,Abi Samra; Nicholas Camill,0,0,30,30
1657789893911,MATH 10A,A01,083735,Patchell; Gregory David,2,0,30,28
1657789893911,MATH 10A,A02,083736,Patchell; Gregory David,20,0,30,10
1657789893911,MATH 10A,A03,083737,Patchell; Gregory David,16,0,30,14
1657789899936,MATH 10B,A01,083207,Lim; Seonhee,8,0,34,26
1657789899936,MATH 10B,A02,083208,Lim; Seonhee,10,0,35,25
1657789899936,MATH 10B,A03,093472,Lim; Seonhee,7,0,34,27
1657789899936,MATH 10B,B01,083739,Sinha; Shubham,13,0,30,17
1657789905970,MATH 18,A01,083743,Cinel; Cameron Alexander,9,0,30,21
1657789905970,MATH 18,A02,083744,Cinel; Cameron Alexander,18,0,30,12
1657789905970,MATH 18,A03,083745,Cinel; Cameron Alexander,10,0,30,20
1657789905970,MATH 18,B01,083748,Rideout; David Porter,5,0,37,32
1657789905970,MATH 18,B02,083749,Rideout; David Porter,5,0,36,31
1657789905970,MATH 18,B03,083750,Rideout; David Porter,3,0,37,34
1657789905970,MATH 18,B04,083751,Rideout; David Porter,6,0,36,30
1657789905970,MATH 18,B05,093473,Rideout; David Porter,6,0,36,30
1657789905970,MATH 18,B06,093474,Rideout; David Porter,6,0,36,30
1657789911999,MATH 20A,A01,083754,Zheng; Zequn,14,0,40,26
1657789918026,MATH 20B,A01,083756,Briones; Jor-el Thomas Caparas,4,0,36,32
1657789918026,MATH 20B,A02,083757,Briones; Jor-el Thomas Caparas,1,0,36,35
1657789918026,MATH 20B,A03,093475,Briones; Jor-el Thomas Caparas,2,0,36,34
1657789924056,MATH 20C,A01,083760,Briones; Jor-el Thomas Caparas,1,0,35,34
1657789924056,MATH 20C,A02,083761,Briones; Jor-el Thomas Caparas,8,0,35,27
1657789924056,MATH 20C,A03,093476,Briones; Jor-el Thomas Caparas,0,1,36,36
1657789924056,MATH 20C,B01,083762,Bach; Quang Tran,1,0,30,29
1657789930085,MATH 20D,A01,083765,Tran; Brian Kha,5,0,30,25
1657789930085,MATH 20D,A02,083766,Tran; Brian Kha,5,0,30,25
1657789930085,MATH 20D,A03,083767,Tran; Brian Kha,5,0,30,25
1657789936108,MATH 20E,A01,083771,Ganguly; Soumya,10,0,32,22
1657789936108,MATH 20E,A02,083772,Ganguly; Soumya,6,0,32,26
1657789936108,MATH 20E,B01,083773,Ciotti; Benjamin,20,0,35,15
1657789936108,MATH 20E,B02,083774,Ciotti; Benjamin,18,0,35,17
1657789942138,MATH 103A,A01,083777,Greenfeld; Be'Eri,3,0,36,33
1657789942138,MATH 103A,A02,083778,Greenfeld; Be'Eri,5,0,36,31
1657789942138,MATH 103A,A03,093561,Greenfeld; Be'Eri,6,0,36,30
1657789942138,MATH 103A,B01,083779,Greenfeld; Be'Eri,7,0,36,29
1657789942138,MATH 103A,B02,083780,Greenfeld; Be'Eri,4,0,36,32
1657789942138,MATH 103A,B03,093562,Greenfeld; Be'Eri,3,0,36,33
1657789948166,MATH 105,A01,085443,Carter; Anne Toulson,15,0,35,20
1657789948166,MATH 105,A02,093477,Carter; Anne Toulson,20,0,35,15
1657789954192,MATH 109,A01,083213,Ganzberger; Geoffrey Michael,3,0,34,31
1657789954192,MATH 109,A02,083214,Ganzberger; Geoffrey Michael,4,0,34,30
1657789954192,MATH 109,A03,093478,Ganzberger; Geoffrey Michael,2,0,34,32
1657789954192,MATH 109,B01,083215,Ganzberger; Geoffrey Michael,1,0,32,31
1657789954192,MATH 109,B02,083216,Ganzberger; Geoffrey Michael,2,0,32,30
1657789954192,MATH 109,B03,093479,Ganzberger; Geoffrey Michael,8,0,32,24
1657789960216,MATH 142A,A01,083219,Chow; Bennett,7,0,32,25
1657789960216,MATH 142A,A02,083220,Chow; Bennett,10,0,32,22
1657789960216,MATH 142A,A03,093480,Chow; Bennett,9,0,32,23
1657789960216,MATH 142A,B03,093481,Chow; Bennett,8,0,32,24
1657789960216,MATH 142A,B04,093558,Chow; Bennett,13,0,32,19
1657789960216,MATH 142A,B05,093559,Chow; Bennett,6,0,32,26
1657789966241,MATH 193A,A01,083224,Rotar; Vladimir,8,0,34,26
1657789966241,MATH 193A,A02,083225,Rotar; Vladimir,9,0,34,25
1657789966241,MATH 193A,A03,083781,Rotar; Vladimir,5,0,34,29
1657789966241,MATH 193A,A04,083782,Rotar; Vladimir,10,0,34,24
1657789966241,MATH 193A,A05,093482,Rotar; Vladimir,10,0,34,24
1657789972266,MATH 197,001,091859,McAuley; Julian John,9999,0,9999,0
1657789972266,MATH 197,002,095566,Kedlaya; Kiran S.,9997,0,9999,2
1657789972266,MATH 197,003,095567,Xiao; Ming,9999,0,9999,0
1657789972266,MATH 197,004,095571,Perols; Johan Lars,9998,0,9999,1
1657789979323,COGS 9,A01,083615,Shannon; Kyle Michael,9,0,75,66
1657789985347,COGS 11,A01,083617,Boyle; Mary E. T.,23,0,48,25
1657789991375,COGS 13,A01,083071,Bastos; Amalia Pinkusfeld,11,0,71,60
1657789997400,COGS 14A,A01,092681,Semenuks; Arturs,5,1,100,95
1657790003432,COGS 14B,A01,083073,Cheng; Tzu-Han,6,0,63,57
1657790009455,COGS 17,A01,092677,Semenuks; Arturs,6,0,81,75
1657790015478,COGS 100,A01,083619,Allen; Michael Gordon,17,0,70,53
1657790021505,COGS 101A,A01,083621,Davis; Joshua Daniel,9,0,68,59
1657790027533,COGS 101B,A01,091572,Allen; Michael Gordon,12,0,65,53
1657790033561,COGS 101C,A01,083625,Delgado; Tania,17,0,35,18
1657790039585,COGS 107A,A01,083627,Boyle; Mary E. T.,14,0,60,46
1657790045612,COGS 118A,A01,083075,Gupta; Anjum,21,0,76,55
1657790051644,CSE 3,A50,083646,Miranda; Gregory Joseph,24,0,50,26
1657790057669,CSE 8A,A50,083650,Miranda; Gregory Joseph,17,1,56,39
1657790063695,CSE 11,A01,083080,Cao; Yingjun,6,15,40,34
1657790069722,CSE 12,A01,083652,Krause-Levy; Sophia Louisa,28,1,120,92
1657790075746,CSE 15L,A01,083654,Morris; Justin Loren,9,0,50,41
1657790075746,CSE 15L,A02,083655,Morris; Justin Loren,9,0,50,41
1657790081773,CSE 20,A01,083657,Tran; Khoa Dang,39,0,80,41
1657790087795,CSE 21,A01,095574,Bach; Quang Tran,22,0,48,26
1657790093823,CSE 30,A01,083084,Eldon; John,6,0,80,74
1657790093823,CSE 30,B01,095061,Bhaskar; Nishant,9,0,50,41
1657790099847,CSE 100,A01,083659,Cao; Yingjun,5,4,70,65
1657790105872,CSE 134B,A01,083661,Powell; Thomas Allan,24,0,100,76
1657790111894,CSE 140,A01,083663,Gungor; Onat,15,0,85,70
1657790117918,CSE 140L,A01,083088,Eldon; John,23,0,100,77
1657790123943,CSE 175,A01,083665,Kumar; Rakesh,3,0,25,22
1657790129967,CSE 190,A00,092507,Dubnov; Shlomo,8,0,20,12
1657790135989,ECE 45,A01,083139,Congero; Spencer William,6,0,75,69
1657790142016,ECE 65,A50,083695,Saad; Andrew S,12,0,30,18
1657790142016,ECE 65,A51,095125,Saad; Andrew S,24,0,26,2
1657790148043,ECE 109,A01,091882,Touri; Behrouz,20,0,70,50
1657790154065,ECE 180,A00,083140,Abi Samra; Nicholas Camill,1,0,30,29
1657790154065,ECE 180,B00,083141,Abi Samra; Nicholas Camill,0,0,30,30
1657790160088,MATH 10A,A01,083735,Patchell; Gregory David,2,0,30,28
1657790160088,MATH 10A,A02,083736,Patchell; Gregory David,20,0,30,10
1657790160088,MATH 10A,A03,083737,Patchell; Gregory David,16,0,30,14
1657790166112,MATH 10B,A01,083207,Lim; Seonhee,8,0,34,26
1657790166112,MATH 10B,A02,083208,Lim; Seonhee,10,0,35,25
1657790166112,MATH 10B,A03,093472,Lim; Seonhee,7,0,34,27
1657790166112,MATH 10B,B01,083739,Sinha; Shubham,13,0,30,17
1657790172142,MATH 18,A01,083743,Cinel; Cameron Alexander,9,0,30,21
1657790172142,MATH 18,A02,083744,Cinel; Cameron Alexander,18,0,30,12
1657790172142,MATH 18,A03,083745,Cinel; Cameron Alexander,10,0,30,20
1657790172142,MATH 18,B01,083748,Rideout; David Porter,5,0,37,32
1657790172142,MATH 18,B02,083749,Rideout; David Porter,5,0,36,31
1657790172142,MATH 18,B03,083750,Rideout; David Porter,3,0,37,34
1657790172142,MATH 18,B04,083751,Rideout; David Porter,6,0,36,30
1657790172142,MATH 18,B05,093473,Rideout; David Porter,6,0,36,30
1657790172142,MATH 18,B06,093474,Rideout; David Porter,6,0,36,30
1657790178172,MATH 20A,A01,083754,Zheng; Zequn,14,0,40,26
1657790184195,MATH 20B,A01,083756,Briones; Jor-el Thomas Caparas,4,0,36,32
1657790184195,MATH 20B,A02,083757,Briones; Jor-el Thomas Caparas,1,0,36,35
1657790184195,MATH 20B,A03,093475,Briones; Jor-el Thomas Caparas,2,0,36,34
1657790190232,MATH 20C,A01,083760,Briones; Jor-el Thomas Caparas,1,0,35,34
1657790190232,MATH 20C,A02,083761,Briones; Jor-el Thomas Caparas,8,0,35,27
1657790190232,MATH 20C,A03,093476,Briones; Jor-el Thomas Caparas,0,1,36,36
1657790190232,MATH 20C,B01,083762,Bach; Quang Tran,1,0,30,29
1657790196255,MATH 20D,A01,083765,Tran; Brian Kha,5,0,30,25
1657790196255,MATH 20D,A02,083766,Tran; Brian Kha,5,0,30,25
1657790196255,MATH 20D,A03,083767,Tran; Brian Kha,5,0,30,25
1657790202278,MATH 20E,A01,083771,Ganguly; Soumya,10,0,32,22
1657790202278,MATH 20E,A02,083772,Ganguly; Soumya,6,0,32,26
1657790202278,MATH 20E,B01,083773,Ciotti; Benjamin,20,0,35,15
1657790202278,MATH 20E,B02,083774,Ciotti; Benjamin,18,0,35,17
1657790208314,MATH 103A,A01,083777,Greenfeld; Be'Eri,3,0,36,33
1657790208314,MATH 103A,A02,083778,Greenfeld; Be'Eri,5,0,36,31
1657790208314,MATH 103A,A03,093561,Greenfeld; Be'Eri,6,0,36,30
1657790208314,MATH 103A,B01,083779,Greenfeld; Be'Eri,7,0,36,29
1657790208314,MATH 103A,B02,083780,Greenfeld; Be'Eri,4,0,36,32
1657790208314,MATH 103A,B03,093562,Greenfeld; Be'Eri,3,0,36,33
1657790214337,MATH 105,A01,085443,Carter; Anne Toulson,15,0,35,20
1657790214337,MATH 105,A02,093477,Carter; Anne Toulson,20,0,35,15
1657790220368,MATH 109,A01,083213,Ganzberger; Geoffrey Michael,3,0,34,31
1657790220368,MATH 109,A02,083214,Ganzberger; Geoffrey Michael,4,0,34,30
1657790220368,MATH 109,A03,093478,Ganzberger; Geoffrey Michael,2,0,34,32
1657790220368,MATH 109,B01,083215,Ganzberger; Geoffrey Michael,1,0,32,31
1657790220368,MATH 109,B02,083216,Ganzberger; Geoffrey Michael,2,0,32,30
1657790220368,MATH 109,B03,093479,Ganzberger; Geoffrey Michael,8,0,32,24
1657790226392,MATH 142A,A01,083219,Chow; Bennett,7,0,32,25
1657790226392,MATH 142A,A02,083220,Chow; Bennett,10,0,32,22
1657790226392,MATH 142A,A03,093480,Chow; Bennett,9,0,32,23
1657790226392,MATH 142A,B03,093481,Chow; Bennett,8,0,32,24
1657790226392,MATH 142A,B04,093558,Chow; Bennett,13,0,32,19
1657790226392,MATH 142A,B05,093559,Chow; Bennett,6,0,32,26
1657790232415,MATH 193A,A01,083224,Rotar; Vladimir,8,0,34,26
1657790232415,MATH 193A,A02,083225,Rotar; Vladimir,9,0,34,25
1657790232415,MATH 193A,A03,083781,Rotar; Vladimir,5,0,34,29
1657790232415,MATH 193A,A04,083782,Rotar; Vladimir,10,0,34,24
1657790232415,MATH 193A,A05,093482,Rotar; Vladimir,10,0,34,24
1657790238438,MATH 197,001,091859,McAuley; Julian John,9999,0,9999,0
1657790238438,MATH 197,002,095566,Kedlaya; Kiran S.,9997,0,9999,2
1657790238438,MATH 197,003,095567,Xiao; Ming,9999,0,9999,0
1657790238438,MATH 197,004,095571,Perols; Johan Lars,9998,0,9999,1
1657790245493,COGS 9,A01,083615,Shannon; Kyle Michael,9,0,75,66
1657790251521,COGS 11,A01,083617,Boyle; Mary E. T.,23,0,48,25
1657790257548,COGS 13,A01,083071,Bastos; Amalia Pinkusfeld,11,0,71,60
1657790263572,COGS 14A,A01,092681,Semenuks; Arturs,5,1,100,95
1657790269595,COGS 14B,A01,083073,Cheng; Tzu-Han,6,0,63,57
1657790275617,COGS 17,A01,092677,Semenuks; Arturs,6,0,81,75
1657790281651,COGS 100,A01,083619,Allen; Michael Gordon,17,0,70,53
1657790287677,COGS 101A,A01,083621,Davis; Joshua Daniel,9,0,68,59
1657790293700,COGS 101B,A01,091572,Allen; Michael Gordon,12,0,65,53
1657790299723,COGS 101C,A01,083625,Delgado; Tania,17,0,35,18
1657790305747,COGS 107A,A01,083627,Boyle; Mary E. T.,14,0,60,46
1657790311769,COGS 118A,A01,083075,Gupta; Anjum,21,0,76,55
1657790317790,CSE 3,A50,083646,Miranda; Gregory Joseph,24,0,50,26
1657790323815,CSE 8A,A50,083650,Miranda; Gregory Joseph,17,1,56,39
1657790329836,CSE 11,A01,083080,Cao; Yingjun,6,15,40,34
1657790335862,CSE 12,A01,083652,Krause-Levy; Sophia Louisa,28,1,120,92
1657790341890,CSE 15L,A01,083654,Morris; Justin Loren,9,0,50,41
1657790341890,CSE 15L,A02,083655,Morris; Justin Loren,9,0,50,41
1657790347917,CSE 20,A01,083657,Tran; Khoa Dang,39,0,80,41
1657790353947,CSE 21,A01,095574,Bach; Quang Tran,22,0,48,26
1657790360060,CSE 30,A01,083084,Eldon; John,6,0,80,74
1657790360060,CSE 30,B01,095061,Bhaskar; Nishant,9,0,50,41
1657790366084,CSE 100,A01,083659,Cao; Yingjun,5,4,70,65
1657790372107,CSE 134B,A01,083661,Powell; Thomas Allan,24,0,100,76
1657790378134,CSE 140,A01,083663,Gungor; Onat,15,0,85,70
1657790384156,CSE 140L,A01,083088,Eldon; John,23,0,100,77
1657790390197,CSE 175,A01,083665,Kumar; Rakesh,3,0,25,22
1657790396223,CSE 190,A00,092507,Dubnov; Shlomo,8,0,20,12
1657790402245,ECE 45,A01,083139,Congero; Spencer William,6,0,75,69
1657790408268,ECE 65,A50,083695,Saad; Andrew S,12,0,30,18
1657790408268,ECE 65,A51,095125,Saad; Andrew S,24,0,26,2
1657790414295,ECE 109,A01,091882,Touri; Behrouz,20,0,70,50
1657790420318,ECE 180,A00,083140,Abi Samra; Nicholas Camill,1,0,30,29
1657790420318,ECE 180,B00,083141,Abi Samra; Nicholas Camill,0,0,30,30
1657790426341,MATH 10A,A01,083735,Patchell; Gregory David,2,0,30,28
1657790426341,MATH 10A,A02,083736,Patchell; Gregory David,20,0,30,10
1657790426341,MATH 10A,A03,083737,Patchell; Gregory David,16,0,30,14
1657790432371,MATH 10B,A01,083207,Lim; Seonhee,8,0,34,26
1657790432371,MATH 10B,A02,083208,Lim; Seonhee,10,0,35,25
1657790432371,MATH 10B,A03,093472,Lim; Seonhee,7,0,34,27
1657790432371,MATH 10B,B01,083739,Sinha; Shubham,13,0,30,17
1657790438403,MATH 18,A01,083743,Cinel; Cameron Alexander,9,0,30,21
1657790438403,MATH 18,A02,083744,Cinel; Cameron Alexander,18,0,30,12
1657790438403,MATH 18,A03,083745,Cinel; Cameron Alexander,10,0,30,20
1657790438403,MATH 18,B01,083748,Rideout; David Porter,5,0,37,32
1657790438403,MATH 18,B02,083749,Rideout; David Porter,5,0,36,31
1657790438403,MATH 18,B03,083750,Rideout; David Porter,3,0,37,34
1657790438403,MATH 18,B04,083751,Rideout; David Porter,6,0,36,30
1657790438403,MATH 18,B05,093473,Rideout; David Porter,6,0,36,30
1657790438403,MATH 18,B06,093474,Rideout; David Porter,6,0,36,30
1657790444428,MATH 20A,A01,083754,Zheng; Zequn,14,0,40,26
1657790450451,MATH 20B,A01,083756,Briones; Jor-el Thomas Caparas,4,0,36,32
1657790450451,MATH 20B,A02,083757,Briones; Jor-el Thomas Caparas,1,0,36,35
1657790450451,MATH 20B,A03,093475,Briones; Jor-el Thomas Caparas,2,0,36,34
1657790456486,MATH 20C,A01,083760,Briones; Jor-el Thomas Caparas,1,0,35,34
1657790456486,MATH 20C,A02,083761,Briones; Jor-el Thomas Caparas,8,0,35,27
1657790456486,MATH 20C,A03,093476,Briones; Jor-el Thomas Caparas,0,1,36,36
1657790456486,MATH 20C,B01,083762,Bach; Quang Tran,1,0,30,29
1657790462514,MATH 20D,A01,083765,Tran; Brian Kha,5,0,30,25
1657790462514,MATH 20D,A02,083766,Tran; Brian Kha,5,0,30,25
1657790462514,MATH 20D,A03,083767,Tran; Brian Kha,5,0,30,25
1657790468537,MATH 20E,A01,083771,Ganguly; Soumya,10,0,32,22
1657790468537,MATH 20E,A02,083772,Ganguly; Soumya,6,0,32,26
1657790468537,MATH 20E,B01,083773,Ciotti; Benjamin,20,0,35,15
1657790468537,MATH 20E,B02,083774,Ciotti; Benjamin,18,0,35,17
1657790474562,MATH 103A,A01,083777,Greenfeld; Be'Eri,3,0,36,33
1657790474562,MATH 103A,A02,083778,Greenfeld; Be'Eri,5,0,36,31
1657790474562,MATH 103A,A03,093561,Greenfeld; Be'Eri,6,0,36,30
1657790474562,MATH 103A,B01,083779,Greenfeld; Be'Eri,7,0,36,29
1657790474562,MATH 103A,B02,083780,Greenfeld; Be'Eri,4,0,36,32
1657790474562,MATH 103A,B03,093562,Greenfeld; Be'Eri,3,0,36,33
1657790480587,MATH 105,A01,085443,Carter; Anne Toulson,15,0,35,20
1657790480587,MATH 105,A02,093477,Carter; Anne Toulson,20,0,35,15
1657790486613,MATH 109,A01,083213,Ganzberger; Geoffrey Michael,3,0,34,31
1657790486613,MATH 109,A02,083214,Ganzberger; Geoffrey Michael,4,0,34,30
1657790486613,MATH 109,A03,093478,Ganzberger; Geoffrey Michael,2,0,34,32
1657790486613,MATH 109,B01,083215,Ganzberger; Geoffrey Michael,1,0,32,31
1657790486613,MATH 109,B02,083216,Ganzberger; Geoffrey Michael,2,0,32,30
1657790486613,MATH 109,B03,093479,Ganzberger; Geoffrey Michael,8,0,32,24
1657790492642,MATH 142A,A01,083219,Chow; Bennett,7,0,32,25
1657790492642,MATH 142A,A02,083220,Chow; Bennett,10,0,32,22
1657790492642,MATH 142A,A03,093480,Chow; Bennett,9,0,32,23
1657790492642,MATH 142A,B03,093481,Chow; Bennett,8,0,32,24
1657790492642,MATH 142A,B04,093558,Chow; Bennett,13,0,32,19
1657790492642,MATH 142A,B05,093559,Chow; Bennett,6,0,32,26
1657790498669,MATH 193A,A01,083224,Rotar; Vladimir,8,0,34,26
1657790498669,MATH 193A,A02,083225,Rotar; Vladimir,9,0,34,25
1657790498669,MATH 193A,A03,083781,Rotar; Vladimir,5,0,34,29
1657790498669,MATH 193A,A04,083782,Rotar; Vladimir,10,0,34,24
1657790498669,MATH 193A,A05,093482,Rotar; Vladimir,10,0,34,24
1657790504695,MATH 197,001,091859,McAuley; Julian John,9999,0,9999,0
1657790504695,MATH 197,002,095566,Kedlaya; Kiran S.,9997,0,9999,2
1657790504695,MATH 197,003,095567,Xiao; Ming,9999,0,9999,0
1657790504695,MATH 197,004,095571,Perols; Johan Lars,9998,0,9999,1
1657790511750,COGS 9,A01,083615,Shannon; Kyle Michael,9,0,75,66
1657790517773,COGS 11,A01,083617,Boyle; Mary E. T.,23,0,48,25
1657790523799,COGS 13,A01,083071,Bastos; Amalia Pinkusfeld,11,0,71,60
1657790529827,COGS 14A,A01,092681,Semenuks; Arturs,5,1,100,95
1657790535853,COGS 14B,A01,083073,Cheng; Tzu-Han,6,0,63,57
1657790541875,COGS 17,A01,092677,Semenuks; Arturs,6,0,81,75
1657790547898,COGS 100,A01,083619,Allen; Michael Gordon,17,0,70,53
1657790553929,COGS 101A,A01,083621,Davis; Joshua Daniel,9,0,68,59
1657790559956,COGS 101B,A01,091572,Allen; Michael Gordon,12,0,65,53
1657790565979,COGS 101C,A01,083625,Delgado; Tania,17,0,35,18
1657790572002,COGS 107A,A01,083627,Boyle; Mary E. T.,14,0,60,46
1657790578029,COGS 118A,A01,083075,Gupta; Anjum,21,0,76,55
1657790584053,CSE 3,A50,083646,Miranda; Gregory Joseph,24,0,50,26
1657790590076,CSE 8A,A50,083650,Miranda; Gregory Joseph,17,1,56,39
1657790596098,CSE 11,A01,083080,Cao; Yingjun,6,15,40,34
1657790602124,CSE 12,A01,083652,Krause-Levy; Sophia Louisa,28,1,120,92
1657790608151,CSE 15L,A01,083654,Morris; Justin Loren,9,0,50,41
1657790608151,CSE 15L,A02,083655,Morris; Justin Loren,9,0,50,41
1657790614174,CSE 20,A01,083657,Tran; Khoa Dang,39,0,80,41
1657790620198,CSE 21,A01,095574,Bach; Quang Tran,22,0,48,26
1657790626221,CSE 30,A01,083084,Eldon; John,6,0,80,74
1657790626221,CSE 30,B01,095061,Bhaskar; Nishant,9,0,50,41
1657790632243,CSE 100,A01,083659,Cao; Yingjun,5,4,70,65
1657790638270,CSE 134B,A01,083661,Powell; Thomas Allan,24,0,100,76
1657790644296,CSE 140,A01,083663,Gungor; Onat,15,0,85,70
1657790650319,CSE 140L,A01,083088,Eldon; John,23,0,100,77
1657790656343,CSE 175,A01,083665,Kumar; Rakesh,3,0,25,22
1657790662367,CSE 190,A00,092507,Dubnov; Shlomo,8,0,20,12
1657790668390,ECE 45,A01,083139,Congero; Spencer William,6,0,75,69
1657790674412,ECE 65,A50,083695,Saad; Andrew S,12,0,30,18
1657790674412,ECE 65,A51,095125,Saad; Andrew S,24,0,26,2
1657790680437,ECE 109,A01,091882,Touri; Behrouz,20,0,70,50
1657790686463,ECE 180,A00,083140,Abi Samra; Nicholas Camill,1,0,30,29
1657790686463,ECE 180,B00,083141,Abi Samra; Nicholas Camill,0,0,30,30
1657790692484,MATH 10A,A01,083735,Patchell; Gregory David,2,0,30,28
1657790692484,MATH 10A,A02,083736,Patchell; Gregory David,20,0,30,10
1657790692484,MATH 10A,A03,083737,Patchell; Gregory David,16,0,30,14
1657790698509,MATH 10B,A01,083207,Lim; Seonhee,8,0,34,26
1657790698509,MATH 10B,A02,083208,Lim; Seonhee,10,0,35,25
1657790698509,MATH 10B,A03,093472,Lim; Seonhee,7,0,34,27
1657790698509,MATH 10B,B01,083739,Sinha; Shubham,13,0,30,17
1657790704534,MATH 18,A01,083743,Cinel; Cameron Alexander,9,0,30,21
1657790704534,MATH 18,A02,083744,Cinel; Cameron Alexander,18,0,30,12
1657790704534,MATH 18,A03,083745,Cinel; Cameron Alexander,10,0,30,20
1657790704534,MATH 18,B01,083748,Rideout; David Porter,5,0,37,32
1657790704534,MATH 18,B02,083749,Rideout; David Porter,5,0,36,31
1657790704534,MATH 18,B03,083750,Rideout; David Porter,3,0,37,34
1657790704534,MATH 18,B04,083751,Rideout; David Porter,6,0,36,30
1657790704534,MATH 18,B05,093473,Rideout; David Porter,6,0,36,30
1657790704534,MATH 18,B06,093474,Rideout; David Porter,6,0,36,30
1657790710561,MATH 20A,A01,083754,Zheng; Zequn,14,0,40,26
1657790716587,MATH 20B,A01,083756,Briones; Jor-el Thomas Caparas,4,0,36,32
1657790716587,MATH 20B,A02,083757,Briones; Jor-el Thomas Caparas,1,0,36,35
1657790716587,MATH 20B,A03,093475,Briones; Jor-el Thomas Caparas,2,0,36,34
1657790722609,MATH 20C,A01,083760,Briones; Jor-el Thomas Caparas,1,0,35,34
1657790722609,MATH 20C,A02,083761,Briones; Jor-el Thomas Caparas,8,0,35,27
1657790722609,MATH 20C,A03,093476,Briones; Jor-el Thomas Caparas,0,1,36,36
1657790722609,MATH 20C,B01,083762,Bach; Quang Tran,1,0,30,29
1657790728637,MATH 20D,A01,083765,Tran; Brian Kha,5,0,30,25
1657790728637,MATH 20D,A02,083766,Tran; Brian Kha,5,0,30,25
1657790728637,MATH 20D,A03,083767,Tran; Brian Kha,5,0,30,25
1657790734660,MATH 20E,A01,083771,Ganguly; Soumya,10,0,32,22
1657790734660,MATH 20E,A02,083772,Ganguly; Soumya,6,0,32,26
1657790734660,MATH 20E,B01,083773,Ciotti; Benjamin,20,0,35,15
1657790734660,MATH 20E,B02,083774,Ciotti; Benjamin,18,0,35,17
1657790740689,MATH 103A,A01,083777,Greenfeld; Be'Eri,3,0,36,33
1657790740689,MATH 103A,A02,083778,Greenfeld; Be'Eri,5,0,36,31
1657790740689,MATH 103A,A03,093561,Greenfeld; Be'Eri,6,0,36,30
1657790740689,MATH 103A,B01,083779,Greenfeld; Be'Eri,7,0,36,29
1657790740689,MATH 103A,B02,083780,Greenfeld; Be'Eri,4,0,36,32
1657790740689,MATH 103A,B03,093562,Greenfeld; Be'Eri,3,0,36,33
1657790746713,MATH 105,A01,085443,Carter; Anne Toulson,15,0,35,20
1657790746713,MATH 105,A02,093477,Carter; Anne Toulson,20,0,35,15
1657790752735,MATH 109,A01,083213,Ganzberger; Geoffrey Michael,3,0,34,31
1657790752735,MATH 109,A02,083214,Ganzberger; Geoffrey Michael,4,0,34,30
1657790752735,MATH 109,A03,093478,Ganzberger; Geoffrey Michael,2,0,34,32
1657790752735,MATH 109,B01,083215,Ganzberger; Geoffrey Michael,1,0,32,31
1657790752735,MATH 109,B02,083216,Ganzberger; Geoffrey Michael,2,0,32,30
1657790752735,MATH 109,B03,093479,Ganzberger; Geoffrey Michael,8,0,32,24
1657790758763,MATH 142A,A01,083219,Chow; Bennett,7,0,32,25
1657790758763,MATH 142A,A02,083220,Chow; Bennett,10,0,32,22
1657790758763,MATH 142A,A03,093480,Chow; Bennett,9,0,32,23
1657790758763,MATH 142A,B03,093481,Chow; Bennett,8,0,32,24
1657790758763,MATH 142A,B04,093558,Chow; Bennett,13,0,32,19
1657790758763,MATH 142A,B05,093559,Chow; Bennett,6,0,32,26
1657790764785,MATH 193A,A01,083224,Rotar; Vladimir,8,0,34,26
1657790764785,MATH 193A,A02,083225,Rotar; Vladimir,9,0,34,25
1657790764785,MATH 193A,A03,083781,Rotar; Vladimir,5,0,34,29
1657790764785,MATH 193A,A04,083782,Rotar; Vladimir,10,0,34,24
1657790764785,MATH 193A,A05,093482,Rotar; Vladimir,10,0,34,24
1657790770808,MATH 197,001,091859,McAuley; Julian John,9999,0,9999,0
1657790770808,MATH 197,002,095566,Kedlaya; Kiran S.,9997,0,9999,2
1657790770808,MATH 197,003,095567,Xiao; Ming,9999,0,9999,0
1657790770808,MATH 197,004,095571,Perols; Johan Lars,9998,0,9999,1
1657790777867,COGS 9,A01,083615,Shannon; Kyle Michael,9,0,75,66
1657790783892,COGS 11,A01,083617,Boyle; Mary E. T.,23,0,48,25
1657790789916,COGS 13,A01,083071,Bastos; Amalia Pinkusfeld,11,0,71,60
1657790795938,COGS 14A,A01,092681,Semenuks; Arturs,5,1,100,95
1657790801963,COGS 14B,A01,083073,Cheng; Tzu-Han,6,0,63,57
1657790807987,COGS 17,A01,092677,Semenuks; Arturs,6,0,81,75
1657790814010,COGS 100,A01,083619,Allen; Michael Gordon,17,0,70,53
1657790820037,COGS 101A,A01,083621,Davis; Joshua Daniel,9,0,68,59
1657790826060,COGS 101B,A01,091572,Allen; Michael Gordon,12,0,65,53
1657790832091,COGS 101C,A01,083625,Delgado; Tania,17,0,35,18
1657790838115,COGS 107A,A01,083627,Boyle; Mary E. T.,14,0,60,46
1657790844159,COGS 118A,A01,083075,Gupta; Anjum,21,0,76,55
1657790850182,CSE 3,A50,083646,Miranda; Gregory Joseph,24,0,50,26
1657790856210,CSE 8A,A50,083650,Miranda; Gregory Joseph,17,1,56,39
1657790862233,CSE 11,A01,083080,Cao; Yingjun,6,15,40,34
1657790868262,CSE 12,A01,083652,Krause-Levy; Sophia Louisa,28,1,120,92
1657790874289,CSE 15L,A01,083654,Morris; Justin Loren,9,0,50,41
1657790874289,CSE 15L,A02,083655,Morris; Justin Loren,9,0,50,41
1657790880312,CSE 20,A01,083657,Tran; Khoa Dang,39,0,80,41
1657790886336,CSE 21,A01,095574,Bach; Quang Tran,22,0,48,26
1657790892357,CSE 30,A01,083084,Eldon; John,6,0,80,74
1657790892357,CSE 30,B01,095061,Bhaskar; Nishant,9,0,50,41
1657790898383,CSE 100,A01,083659,Cao; Yingjun,5,4,70,65
1657790904408,CSE 134B,A01,083661,Powell; Thomas Allan,24,0,100,76
1657790910443,CSE 140,A01,083663,Gungor; Onat,15,0,85,70
1657790916470,CSE 140L,A01,083088,Eldon; John,23,0,100,77
1657790922492,CSE 175,A01,083665,Kumar; Rakesh,3,0,25,22
1657790928515,CSE 190,A00,092507,Dubnov; Shlomo,8,0,20,12
1657790934542,ECE 45,A01,083139,Congero; Spencer William,6,0,75,69
1657790940575,ECE 65,A50,083695,Saad; Andrew S,12,0,30,18
1657790940575,ECE 65,A51,095125,Saad; Andrew S,24,0,26,2
1657790946599,ECE 109,A01,091882,Touri; Behrouz,20,0,70,50
1657790952623,ECE 180,A00,083140,Abi Samra; Nicholas Camill,1,0,30,29
1657790952623,ECE 180,B00,083141,Abi Samra; Nicholas Camill,0,0,30,30
1657790958738,MATH 10A,A01,083735,Patchell; Gregory David,2,0,30,28
1657790958738,MATH 10A,A02,083736,Patchell; Gregory David,20,0,30,10
1657790958738,MATH 10A,A03,083737,Patchell; Gregory David,16,0,30,14
1657790964761,MATH 10B,A01,083207,Lim; Seonhee,8,0,34,26
1657790964761,MATH 10B,A02,083208,Lim; Seonhee,10,0,35,25
1657790964761,MATH 10B,A03,093472,Lim; Seonhee,7,0,34,27
1657790964761,MATH 10B,B01,083739,Sinha; Shubham,13,0,30,17
1657790970788,MATH 18,A01,083743,Cinel; Cameron Alexander,9,0,30,21
1657790970788,MATH 18,A02,083744,Cinel; Cameron Alexander,18,0,30,12
1657790970788,MATH 18,A03,083745,Cinel; Cameron Alexander,10,0,30,20
1657790970788,MATH 18,B01,083748,Rideout; David Porter,5,0,37,32
1657790970788,MATH 18,B02,083749,Rideout; David Porter,5,0,36,31
1657790970788,MATH 18,B03,083750,Rideout; David Porter,3,0,37,34
1657790970788,MATH 18,B04,083751,Rideout; David Porter,6,0,36,30
1657790970788,MATH 18,B05,093473,Rideout; David Porter,6,0,36,30
1657790970788,MATH 18,B06,093474,Rideout; David Porter,6,0,36,30
1657790976811,MATH 20A,A01,083754,Zheng; Zequn,14,0,40,26
1657790982839,MATH 20B,A01,083756,Briones; Jor-el Thomas Caparas,4,0,36,32
1657790982839,MATH 20B,A02,083757,Briones; Jor-el Thomas Caparas,1,0,36,35
1657790982839,MATH 20B,A03,093475,Briones; Jor-el Thomas Caparas,2,0,36,34
1657790988867,MATH 20C,A01,083760,Briones; Jor-el Thomas Caparas,1,0,35,34
1657790988867,MATH 20C,A02,083761,Briones; Jor-el Thomas Caparas,8,0,35,27
1657790988867,MATH 20C,A03,093476,Briones; Jor-el Thomas Caparas,0,1,36,36
1657790988867,MATH 20C,B01,083762,Bach; Quang Tran,1,0,30,29
1657790994889,MATH 20D,A01,083765,Tran; Brian Kha,5,0,30,25
1657790994889,MATH 20D,A02,083766,Tran; Brian Kha,5,0,30,25
1657790994889,MATH 20D,A03,083767,Tran; Brian Kha,5,0,30,25
1657791000914,MATH 20E,A01,083771,Ganguly; Soumya,10,0,32,22
1657791000914,MATH 20E,A02,083772,Ganguly; Soumya,6,0,32,26
1657791000914,MATH 20E,B01,083773,Ciotti; Benjamin,20,0,35,15
1657791000914,MATH 20E,B02,083774,Ciotti; Benjamin,18,0,35,17
1657791006938,MATH 103A,A01,083777,Greenfeld; Be'Eri,3,0,36,33
1657791006938,MATH 103A,A02,083778,Greenfeld; Be'Eri,5,0,36,31
1657791006938,MATH 103A,A03,093561,Greenfeld; Be'Eri,6,0,36,30
1657791006938,MATH 103A,B01,083779,Greenfeld; Be'Eri,7,0,36,29
1657791006938,MATH 103A,B02,083780,Greenfeld; Be'Eri,4,0,36,32
1657791006938,MATH 103A,B03,093562,Greenfeld; Be'Eri,3,0,36,33
1657791012965,MATH 105,A01,085443,Carter; Anne Toulson,15,0,35,20
1657791012965,MATH 105,A02,093477,Carter; Anne Toulson,20,0,35,15
1657791018992,MATH 109,A01,083213,Ganzberger; Geoffrey Michael,3,0,34,31
1657791018992,MATH 109,A02,083214,Ganzberger; Geoffrey Michael,4,0,34,30
1657791018992,MATH 109,A03,093478,Ganzberger; Geoffrey Michael,2,0,34,32
1657791018992,MATH 109,B01,083215,Ganzberger; Geoffrey Michael,1,0,32,31
1657791018992,MATH 109,B02,083216,Ganzberger; Geoffrey Michael,2,0,32,30
1657791018992,MATH 109,B03,093479,Ganzberger; Geoffrey Michael,8,0,32,24
1657791025023,MATH 142A,A01,083219,Chow; Bennett,7,0,32,25
1657791025023,MATH 142A,A02,083220,Chow; Bennett,10,0,32,22
1657791025023,MATH 142A,A03,093480,Chow; Bennett,9,0,32,23
1657791025023,MATH 142A,B03,093481,Chow; Bennett,8,0,32,24
1657791025023,MATH 142A,B04,093558,Chow; Bennett,13,0,32,19
1657791025023,MATH 142A,B05,093559,Chow; Bennett,6,0,32,26
1657791031048,MATH 193A,A01,083224,Rotar; Vladimir,8,0,34,26
1657791031048,MATH 193A,A02,083225,Rotar; Vladimir,9,0,34,25
1657791031048,MATH 193A,A03,083781,Rotar; Vladimir,5,0,34,29
1657791031048,MATH 193A,A04,083782,Rotar; Vladimir,10,0,34,24
1657791031048,MATH 193A,A05,093482,Rotar; Vladimir,10,0,34,24
1657791037077,MATH 197,001,091859,McAuley; Julian John,9999,0,9999,0
1657791037077,MATH 197,002,095566,Kedlaya; Kiran S.,9997,0,9999,2
1657791037077,MATH 197,003,095567,Xiao; Ming,9999,0,9999,0
1657791037077,MATH 197,004,095571,Perols; Johan Lars,9998,0,9999,1
1657791044136,COGS 9,A01,083615,Shannon; Kyle Michael,9,0,75,66
1657791050158,COGS 11,A01,083617,Boyle; Mary E. T.,23,0,48,25
1657791056183,COGS 13,A01,083071,Bastos; Amalia Pinkusfeld,11,0,71,60
1657791062233,COGS 14A,A01,092681,Semenuks; Arturs,5,1,100,95
1657791068258,COGS 14B,A01,083073,Cheng; Tzu-Han,6,0,63,57
1657791074289,COGS 17,A01,092677,Semenuks; Arturs,6,0,81,75
1657791080318,COGS 100,A01,083619,Allen; Michael Gordon,17,0,70,53
1657791086341,COGS 101A,A01,083621,Davis; Joshua Daniel,9,0,68,59
1657791092364,COGS 101B,A01,091572,Allen; Michael Gordon,12,0,65,53
1657791098392,COGS 101C,A01,083625,Delgado; Tania,17,0,35,18
1657791104416,COGS 107A,A01,083627,Boyle; Mary E. T.,14,0,60,46
1657791110443,COGS 118A,A01,083075,Gupta; Anjum,21,0,76,55
1657791116478,CSE 3,A50,083646,Miranda; Gregory Joseph,24,0,50,26
1657791122500,CSE 8A,A50,083650,Miranda; Gregory Joseph,17,1,56,39
1657791128526,CSE 11,A01,083080,Cao; Yingjun,6,15,40,34
1657791134550,CSE 12,A01,083652,Krause-Levy; Sophia Louisa,28,1,120,92
1657791140581,CSE 15L,A01,083654,Morris; Justin Loren,9,0,50,41
1657791140581,CSE 15L,A02,083655,Morris; Justin Loren,9,0,50,41
1657791146608,CSE 20,A01,083657,Tran; Khoa Dang,39,0,80,41
1657791152630,CSE 21,A01,095574,Bach; Quang Tran,22,0,48,26
1657791158660,CSE 30,A01,083084,Eldon; John,6,0,80,74
1657791158660,CSE 30,B01,095061,Bhaskar; Nishant,9,0,50,41
1657791164714,CSE 100,A01,083659,Cao; Yingjun,5,4,70,65
1657791170737,CSE 134B,A01,083661,Powell; Thomas Allan,24,0,100,76
1657791176763,CSE 140,A01,083663,Gungor; Onat,15,0,85,70
1657791182789,CSE 140L,A01,083088,Eldon; John,23,0,100,77
1657791188813,CSE 175,A01,083665,Kumar; Rakesh,3,0,25,22
1657791194839,CSE 190,A00,092507,Dubnov; Shlomo,8,0,20,12
1657791200867,ECE 45,A01,083139,Congero; Spencer William,6,0,75,69
1657791206892,ECE 65,A50,083695,Saad; Andrew S,12,0,30,18
1657791206892,ECE 65,A51,095125,Saad; Andrew S,24,0,26,2
1657791212916,ECE 109,A01,091882,Touri; Behrouz,20,0,70,50
1657791218939,ECE 180,A00,083140,Abi Samra; Nicholas Camill,1,0,30,29
1657791218939,ECE 180,B00,083141,Abi Samra; Nicholas Camill,0,0,30,30
1657791224963,MATH 10A,A01,083735,Patchell; Gregory David,2,0,30,28
1657791224963,MATH 10A,A02,083736,Patchell; Gregory David,20,0,30,10
1657791224963,MATH 10A,A03,083737,Patchell; Gregory David,16,0,30,14
1657791230985,MATH 10B,A01,083207,Lim; Seonhee,8,0,34,26
1657791230985,MATH 10B,A02,083208,Lim; Seonhee,10,0,35,25
1657791230985,MATH 10B,A03,093472,Lim; Seonhee,7,0,34,27
1657791230985,MATH 10B,B01,083739,Sinha; Shubham,13,0,30,17
1657791237014,MATH 18,A01,083743,Cinel; Cameron Alexander,9,0,30,21
1657791237014,MATH 18,A02,083744,Cinel; Cameron Alexander,18,0,30,12
1657791237014,MATH 18,A03,083745,Cinel; Cameron Alexander,10,0,30,20
1657791237014,MATH 18,B01,083748,Rideout; David Porter,5,0,37,32
1657791237014,MATH 18,B02,083749,Rideout; David Porter,5,0,36,31
1657791237014,MATH 18,B03,083750,Rideout; David Porter,3,0,37,34
1657791237014,MATH 18,B04,083751,Rideout; David Porter,6,0,36,30
1657791237014,MATH 18,B05,093473,Rideout; David Porter,6,0,36,30
1657791237014,MATH 18,B06,093474,Rideout; David Porter,6,0,36,30
1657791243042,MATH 20A,A01,083754,Zheng; Zequn,14,0,40,26
1657791249064,MATH 20B,A01,083756,Briones; Jor-el Thomas Caparas,4,0,36,32
1657791249064,MATH 20B,A02,083757,Briones; Jor-el Thomas Caparas,1,0,36,35
1657791249064,MATH 20B,A03,093475,Briones; Jor-el Thomas Caparas,2,0,36,34
1657791255095,MATH 20C,A01,083760,Briones; Jor-el Thomas Caparas,1,0,35,34
1657791255095,MATH 20C,A02,083761,Briones; Jor-el Thomas Caparas,8,0,35,27
1657791255095,MATH 20C,A03,093476,Briones; Jor-el Thomas Caparas,0,1,36,36
1657791255095,MATH 20C,B01,083762,Bach; Quang Tran,1,0,30,29
1657791261124,MATH 20D,A01,083765,Tran; Brian Kha,5,0,30,25
1657791261124,MATH 20D,A02,083766,Tran; Brian Kha,5,0,30,25
1657791261124,MATH 20D,A03,083767,Tran; Brian Kha,5,0,30,25
1657791267150,MATH 20E,A01,083771,Ganguly; Soumya,10,0,32,22
1657791267150,MATH 20E,A02,083772,Ganguly; Soumya,6,0,32,26
1657791267150,MATH 20E,B01,083773,Ciotti; Benjamin,20,0,35,15
1657791267150,MATH 20E,B02,083774,Ciotti; Benjamin,18,0,35,17
1657791273174,MATH 103A,A01,083777,Greenfeld; Be'Eri,3,0,36,33
1657791273174,MATH 103A,A02,083778,Greenfeld; Be'Eri,5,0,36,31
1657791273174,MATH 103A,A03,093561,Greenfeld; Be'Eri,6,0,36,30
1657791273174,MATH 103A,B01,083779,Greenfeld; Be'Eri,7,0,36,29
1657791273174,MATH 103A,B02,083780,Greenfeld; Be'Eri,4,0,36,32
1657791273174,MATH 103A,B03,093562,Greenfeld; Be'Eri,3,0,36,33
1657791279199,MATH 105,A01,085443,Carter; Anne Toulson,15,0,35,20
1657791279199,MATH 105,A02,093477,Carter; Anne Toulson,20,0,35,15
1657791285223,MATH 109,A01,083213,Ganzberger; Geoffrey Michael,3,0,34,31
1657791285223,MATH 109,A02,083214,Ganzberger; Geoffrey Michael,4,0,34,30
1657791285223,MATH 109,A03,093478,Ganzberger; Geoffrey Michael,2,0,34,32
1657791285223,MATH 109,B01,083215,Ganzberger; Geoffrey Michael,1,0,32,31
1657791285223,MATH 109,B02,083216,Ganzberger; Geoffrey Michael,2,0,32,30
1657791285223,MATH 109,B03,093479,Ganzberger; Geoffrey Michael,8,0,32,24
1657791291254,MATH 142A,A01,083219,Chow; Bennett,7,0,32,25
1657791291254,MATH 142A,A02,083220,Chow; Bennett,10,0,32,22
1657791291254,MATH 142A,A03,093480,Chow; Bennett,9,0,32,23
1657791291254,MATH 142A,B03,093481,Chow; Bennett,8,0,32,24
1657791291254,MATH 142A,B04,093558,Chow; Bennett,13,0,32,19
1657791291254,MATH 142A,B05,093559,Chow; Bennett,6,0,32,26
1657791297279,MATH 193A,A01,083224,Rotar; Vladimir,8,0,34,26
1657791297279,MATH 193A,A02,083225,Rotar; Vladimir,9,0,34,25
1657791297279,MATH 193A,A03,083781,Rotar; Vladimir,5,0,34,29
1657791297279,MATH 193A,A04,083782,Rotar; Vladimir,10,0,34,24
1657791297279,MATH 193A,A05,093482,Rotar; Vladimir,10,0,34,24
1657791303306,MATH 197,001,091859,McAuley; Julian John,9999,0,9999,0
1657791303306,MATH 197,002,095566,Kedlaya; Kiran S.,9997,0,9999,2
1657791303306,MATH 197,003,095567,Xiao; Ming,9999,0,9999,0
1657791303306,MATH 197,004,095571,Perols; Johan Lars,9998,0,9999,1
1657791310376,COGS 9,A01,083615,Shannon; Kyle Michael,9,0,75,66
1657791316401,COGS 11,A01,083617,Boyle; Mary E. T.,23,0,48,25
1657791322425,COGS 13,A01,083071,Bastos; Amalia Pinkusfeld,11,0,71,60
1657791328451,COGS 14A,A01,092681,Semenuks; Arturs,5,1,100,95
1657791334477,COGS 14B,A01,083073,Cheng; Tzu-Han,6,0,63,57
1657791340503,COGS 17,A01,092677,Semenuks; Arturs,6,0,81,75
1657791346531,COGS 100,A01,083619,Allen; Michael Gordon,17,0,70,53
1657791352559,COGS 101A,A01,083621,Davis; Joshua Daniel,9,0,68,59
1657791358583,COGS 101B,A01,091572,Allen; Michael Gordon,12,0,65,53
1657791364611,COGS 101C,A01,083625,Delgado; Tania,17,0,35,18
1657791370636,COGS 107A,A01,083627,Boyle; Mary E. T.,14,0,60,46
1657791376659,COGS 118A,A01,083075,Gupta; Anjum,21,0,76,55
1657791382683,CSE 3,A50,083646,Miranda; Gregory Joseph,24,0,50,26
1657791388712,CSE 8A,A50,083650,Miranda; Gregory Joseph,17,1,56,39
1657791394735,CSE 11,A01,083080,Cao; Yingjun,6,15,40,34
1657791400761,CSE 12,A01,083652,Krause-Levy; Sophia Louisa,28,1,120,92
1657791406782,CSE 15L,A01,083654,Morris; Justin Loren,9,0,50,41
1657791406782,CSE 15L,A02,083655,Morris; Justin Loren,9,0,50,41
1657791412808,CSE 20,A01,083657,Tran; Khoa Dang,39,0,80,41
1657791418830,CSE 21,A01,095574,Bach; Quang Tran,22,0,48,26
1657791424857,CSE 30,A01,083084,Eldon; John,6,0,80,74
1657791424857,CSE 30,B01,095061,Bhaskar; Nishant,9,0,50,41
1657791430883,CSE 100,A01,083659,Cao; Yingjun,5,4,70,65
1657791436910,CSE 134B,A01,083661,Powell; Thomas Allan,24,0,100,76
1657791442938,CSE 140,A01,083663,Gungor; Onat,15,0,85,70
1657791448965,CSE 140L,A01,083088,Eldon; John,23,0,100,77
1657791454990,CSE 175,A01,083665,Kumar; Rakesh,3,0,25,22
1657791461012,CSE 190,A00,092507,Dubnov; Shlomo,8,0,20,12
1657791467035,ECE 45,A01,083139,Congero; Spencer William,6,0,75,69
1657791473058,ECE 65,A50,083695,Saad; Andrew S,12,0,30,18
1657791473058,ECE 65,A51,095125,Saad; Andrew S,24,0,26,2
1657791479080,ECE 109,A01,091882,Touri; Behrouz,20,0,70,50
1657791485103,ECE 180,A00,083140,Abi Samra; Nicholas Camill,1,0,30,29
1657791485103,ECE 180,B00,083141,Abi Samra; Nicholas Camill,0,0,30,30
1657791491126,MATH 10A,A01,083735,Patchell; Gregory David,2,0,30,28
1657791491126,MATH 10A,A02,083736,Patchell; Gregory David,20,0,30,10
1657791491126,MATH 10A,A03,083737,Patchell; Gregory David,16,0,30,14
1657791497155,MATH 10B,A01,083207,Lim; Seonhee,8,0,34,26
1657791497155,MATH 10B,A02,083208,Lim; Seonhee,10,0,35,25
1657791497155,MATH 10B,A03,093472,Lim; Seonhee,7,0,34,27
1657791497155,MATH 10B,B01,083739,Sinha; Shubham,13,0,30,17
1657791503180,MATH 18,A01,083743,Cinel; Cameron Alexander,9,0,30,21
1657791503180,MATH 18,A02,083744,Cinel; Cameron Alexander,18,0,30,12
1657791503180,MATH 18,A03,083745,Cinel; Cameron Alexander,10,0,30,20
1657791503180,MATH 18,B01,083748,Rideout; David Porter,5,0,37,32
1657791503180,MATH 18,B02,083749,Rideout; David Porter,5,0,36,31
1657791503180,MATH 18,B03,083750,Rideout; David Porter,3,0,37,34
1657791503180,MATH 18,B04,083751,Rideout; David Porter,6,0,36,30
1657791503180,MATH 18,B05,093473,Rideout; David Porter,6,0,36,30
1657791503180,MATH 18,B06,093474,Rideout; David Porter,6,0,36,30
1657791509207,MATH 20A,A01,083754,Zheng; Zequn,14,0,40,26
1657791515236,MATH 20B,A01,083756,Briones; Jor-el Thomas Caparas,4,0,36,32
1657791515236,MATH 20B,A02,083757,Briones; Jor-el Thomas Caparas,1,0,36,35
1657791515236,MATH 20B,A03,093475,Briones; Jor-el Thomas Caparas,2,0,36,34
1657791521261,MATH 20C,A01,083760,Briones; Jor-el Thomas Caparas,1,0,35,34
1657791521261,MATH 20C,A02,083761,Briones; Jor-el Thomas Caparas,8,0,35,27
1657791521261,MATH 20C,A03,093476,Briones; Jor-el Thomas Caparas,0,1,36,36
1657791521261,MATH 20C,B01,083762,Bach; Quang Tran,1,0,30,29
1657791527294,MATH 20D,A01,083765,Tran; Brian Kha,5,0,30,25
1657791527294,MATH 20D,A02,083766,Tran; Brian Kha,5,0,30,25
1657791527294,MATH 20D,A03,083767,Tran; Brian Kha,5,0,30,25
1657791533319,MATH 20E,A01,083771,Ganguly; Soumya,10,0,32,22
1657791533319,MATH 20E,A02,083772,Ganguly; Soumya,6,0,32,26
1657791533319,MATH 20E,B01,083773,Ciotti; Benjamin,20,0,35,15
1657791533319,MATH 20E,B02,083774,Ciotti; Benjamin,18,0,35,17
1657791539346,MATH 103A,A01,083777,Greenfeld; Be'Eri,3,0,36,33
1657791539346,MATH 103A,A02,083778,Greenfeld; Be'Eri,5,0,36,31
1657791539346,MATH 103A,A03,093561,Greenfeld; Be'Eri,6,0,36,30
1657791539346,MATH 103A,B01,083779,Greenfeld; Be'Eri,7,0,36,29
1657791539346,MATH 103A,B02,083780,Greenfeld; Be'Eri,4,0,36,32
1657791539346,MATH 103A,B03,093562,Greenfeld; Be'Eri,3,0,36,33
1657791545370,MATH 105,A01,085443,Carter; Anne Toulson,15,0,35,20
1657791545370,MATH 105,A02,093477,Carter; Anne Toulson,20,0,35,15
1657791551392,MATH 109,A01,083213,Ganzberger; Geoffrey Michael,3,0,34,31
1657791551392,MATH 109,A02,083214,Ganzberger; Geoffrey Michael,4,0,34,30
1657791551392,MATH 109,A03,093478,Ganzberger; Geoffrey Michael,2,0,34,32
1657791551392,MATH 109,B01,083215,Ganzberger; Geoffrey Michael,1,0,32,31
1657791551392,MATH 109,B02,083216,Ganzberger; Geoffrey Michael,2,0,32,30
1657791551392,MATH 109,B03,093479,Ganzberger; Geoffrey Michael,8,0,32,24
1657791557493,MATH 142A,A01,083219,Chow; Bennett,7,0,32,25
1657791557493,MATH 142A,A02,083220,Chow; Bennett,10,0,32,22
1657791557493,MATH 142A,A03,093480,Chow; Bennett,9,0,32,23
1657791557493,MATH 142A,B03,093481,Chow; Bennett,8,0,32,24
1657791557493,MATH 142A,B04,093558,Chow; Bennett,13,0,32,19
1657791557493,MATH 142A,B05,093559,Chow; Bennett,6,0,32,26
1657791563517,MATH 193A,A01,083224,Rotar; Vladimir,8,0,34,26
1657791563517,MATH 193A,A02,083225,Rotar; Vladimir,9,0,34,25
1657791563517,MATH 193A,A03,083781,Rotar; Vladimir,5,0,34,29
1657791563517,MATH 193A,A04,083782,Rotar; Vladimir,10,0,34,24
1657791563517,MATH 193A,A05,093482,Rotar; Vladimir,10,0,34,24
1657791569542,MATH 197,001,091859,McAuley; Julian John,9999,0,9999,0
1657791569542,MATH 197,002,095566,Kedlaya; Kiran S.,9997,0,9999,2
1657791569542,MATH 197,003,095567,Xiao; Ming,9999,0,9999,0
1657791569542,MATH 197,004,095571,Perols; Johan Lars,9998,0,9999,1
1657791576606,COGS 9,A01,083615,Shannon; Kyle Michael,9,0,75,66
1657791582630,COGS 11,A01,083617,Boyle; Mary E. T.,23,0,48,25
1657791588657,COGS 13,A01,083071,Bastos; Amalia Pinkusfeld,11,0,71,60
1657791594683,COGS 14A,A01,092681,Semenuks; Arturs,5,1,100,95
1657791600710,COGS 14B,A01,083073,Cheng; Tzu-Han,6,0,63,57
1657791606736,COGS 17,A01,092677,Semenuks; Arturs,6,0,81,75
1657791612762,COGS 100,A01,083619,Allen; Michael Gordon,17,0,70,53
1657791618786,COGS 101A,A01,083621,Davis; Joshua Daniel,9,0,68,59
1657791624809,COGS 101B,A01,091572,Allen; Michael Gordon,12,0,65,53
1657791630835,COGS 101C,A01,083625,Delgado; Tania,17,0,35,18
1657791636870,COGS 107A,A01,083627,Boyle; Mary E. T.,14,0,60,46
1657791642894,COGS 118A,A01,083075,Gupta; Anjum,21,0,76,55
1657791648921,CSE 3,A50,083646,Miranda; Gregory Joseph,24,0,50,26
1657791654945,CSE 8A,A50,083650,Miranda; Gregory Joseph,17,1,56,39
1657791660968,CSE 11,A01,083080,Cao; Yingjun,6,15,40,34
1657791666990,CSE 12,A01,083652,Krause-Levy; Sophia Louisa,28,1,120,92
1657791673015,CSE 15L,A01,083654,Morris; Justin Loren,9,0,50,41
1657791673015,CSE 15L,A02,083655,Morris; Justin Loren,9,0,50,41
1657791679043,CSE 20,A01,083657,Tran; Khoa Dang,39,0,80,41
1657791685069,CSE 21,A01,095574,Bach; Quang Tran,22,0,48,26
1657791691098,CSE 30,A01,083084,Eldon; John,6,0,80,74
1657791691098,CSE 30,B01,095061,Bhaskar; Nishant,9,0,50,41
1657791697123,CSE 100,A01,083659,Cao; Yingjun,5,4,70,65
1657791703149,CSE 134B,A01,083661,Powell; Thomas Allan,24,0,100,76
1657791709174,CSE 140,A01,083663,Gungor; Onat,15,0,85,70
1657791715200,CSE 140L,A01,083088,Eldon; John,23,0,100,77
1657791721224,CSE 175,A01,083665,Kumar; Rakesh,3,0,25,22
1657791727247,CSE 190,A00,092507,Dubnov; Shlomo,8,0,20,12
1657791733272,ECE 45,A01,083139,Congero; Spencer William,6,0,75,69
1657791739296,ECE 65,A50,083695,Saad; Andrew S,12,0,30,18
1657791739296,ECE 65,A51,095125,Saad; Andrew S,24,0,26,2
1657791745319,ECE 109,A01,091882,Touri; Behrouz,20,0,70,50
1657791751341,ECE 180,A00,083140,Abi Samra; Nicholas Camill,1,0,30,29
1657791751341,ECE 180,B00,083141,Abi Samra; Nicholas Camill,0,0,30,30
1657791757365,MATH 10A,A01,083735,Patchell; Gregory David,2,0,30,28
1657791757365,MATH 10A,A02,083736,Patchell; Gregory David,20,0,30,10
1657791757365,MATH 10A,A03,083737,Patchell; Gregory David,16,0,30,14
1657791763390,MATH 10B,A01,083207,Lim; Seonhee,8,0,34,26
1657791763390,MATH 10B,A02,083208,Lim; Seonhee,10,0,35,25
1657791763390,MATH 10B,A03,093472,Lim; Seonhee,7,0,34,27
1657791763390,MATH 10B,B01,083739,Sinha; Shubham,13,0,30,17
1657791769415,MATH 18,A01,083743,Cinel; Cameron Alexander,9,0,30,21
1657791769415,MATH 18,A02,083744,Cinel; Cameron Alexander,18,0,30,12
1657791769415,MATH 18,A03,083745,Cinel; Cameron Alexander,10,0,30,20
1657791769415,MATH 18,B01,083748,Rideout; David Porter,5,0,37,32
1657791769415,MATH 18,B02,083749,Rideout; David Porter,5,0,36,31
1657791769415,MATH 18,B03,083750,Rideout; David Porter,3,0,37,34
1657791769415,MATH 18,B04,083751,Rideout; David Porter,6,0,36,30
1657791769415,MATH 18,B05,093473,Rideout; David Porter,6,0,36,30
1657791769415,MATH 18,B06,093474,Rideout; David Porter,6,0,36,30
1657791775442,MATH 20A,A01,083754,Zheng; Zequn,14,0,40,26
1657791781470,MATH 20B,A01,083756,Briones; Jor-el Thomas Caparas,4,0,36,32
1657791781470,MATH 20B,A02,083757,Briones; Jor-el Thomas Caparas,1,0,36,35
1657791781470,MATH 20B,A03,093475,Briones; Jor-el Thomas Caparas,2,0,36,34
1657791787494,MATH 20C,A01,083760,Briones; Jor-el Thomas Caparas,1,0,35,34
1657791787494,MATH 20C,A02,083761,Briones; Jor-el Thomas Caparas,8,0,35,27
1657791787494,MATH 20C,A03,093476,Briones; Jor-el Thomas Caparas,0,1,36,36
1657791787494,MATH 20C,B01,083762,Bach; Quang Tran,1,0,30,29
1657791793539,MATH 20D,A01,083765,Tran; Brian Kha,5,0,30,25
1657791793539,MATH 20D,A02,083766,Tran; Brian Kha,5,0,30,25
1657791793539,MATH 20D,A03,083767,Tran; Brian Kha,5,0,30,25
1657791799569,MATH 20E,A01,083771,Ganguly; Soumya,10,0,32,22
1657791799569,MATH 20E,A02,083772,Ganguly; Soumya,6,0,32,26
1657791799569,MATH 20E,B01,083773,Ciotti; Benjamin,20,0,35,15
1657791799569,MATH 20E,B02,083774,Ciotti; Benjamin,18,0,35,17
1657791805597,MATH 103A,A01,083777,Greenfeld; Be'Eri,3,0,36,33
1657791805597,MATH 103A,A02,083778,Greenfeld; Be'Eri,5,0,36,31
1657791805597,MATH 103A,A03,093561,Greenfeld; Be'Eri,6,0,36,30
1657791805597,MATH 103A,B01,083779,Greenfeld; Be'Eri,7,0,36,29
1657791805597,MATH 103A,B02,083780,Greenfeld; Be'Eri,4,0,36,32
1657791805597,MATH 103A,B03,093562,Greenfeld; Be'Eri,3,0,36,33
1657791811624,MATH 105,A01,085443,Carter; Anne Toulson,15,0,35,20
1657791811624,MATH 105,A02,093477,Carter; Anne Toulson,20,0,35,15
1657791817671,MATH 109,A01,083213,Ganzberger; Geoffrey Michael,3,0,34,31
1657791817671,MATH 109,A02,083214,Ganzberger; Geoffrey Michael,4,0,34,30
1657791817671,MATH 109,A03,093478,Ganzberger; Geoffrey Michael,2,0,34,32
1657791817671,MATH 109,B01,083215,Ganzberger; Geoffrey Michael,1,0,32,31
1657791817671,MATH 109,B02,083216,Ganzberger; Geoffrey Michael,2,0,32,30
1657791817671,MATH 109,B03,093479,Ganzberger; Geoffrey Michael,8,0,32,24
1657791823700,MATH 142A,A01,083219,Chow; Bennett,7,0,32,25
1657791823700,MATH 142A,A02,083220,Chow; Bennett,10,0,32,22
1657791823700,MATH 142A,A03,093480,Chow; Bennett,9,0,32,23
1657791823700,MATH 142A,B03,093481,Chow; Bennett,8,0,32,24
1657791823700,MATH 142A,B04,093558,Chow; Bennett,13,0,32,19
1657791823700,MATH 142A,B05,093559,Chow; Bennett,6,0,32,26
1657791829722,MATH 193A,A01,083224,Rotar; Vladimir,8,0,34,26
1657791829722,MATH 193A,A02,083225,Rotar; Vladimir,9,0,34,25
1657791829722,MATH 193A,A03,083781,Rotar; Vladimir,5,0,34,29
1657791829722,MATH 193A,A04,083782,Rotar; Vladimir,10,0,34,24
1657791829722,MATH 193A,A05,093482,Rotar; Vladimir,10,0,34,24
1657791835753,MATH 197,001,091859,McAuley; Julian John,9999,0,9999,0
1657791835753,MATH 197,002,095566,Kedlaya; Kiran S.,9997,0,9999,2
1657791835753,MATH 197,003,095567,Xiao; Ming,9999,0,9999,0
1657791835753,MATH 197,004,095571,Perols; Johan Lars,9998,0,9999,1
1657791842803,COGS 9,A01,083615,Shannon; Kyle Michael,9,0,75,66
1657791848831,COGS 11,A01,083617,Boyle; Mary E. T.,23,0,48,25
1657791854872,COGS 13,A01,083071,Bastos; Amalia Pinkusfeld,11,0,71,60
1657791860895,COGS 14A,A01,092681,Semenuks; Arturs,5,1,100,95
1657791866918,COGS 14B,A01,083073,Cheng; Tzu-Han,6,0,63,57
1657791872939,COGS 17,A01,092677,Semenuks; Arturs,6,0,81,75
1657791878963,COGS 100,A01,083619,Allen; Michael Gordon,17,0,70,53
1657791884990,COGS 101A,A01,083621,Davis; Joshua Daniel,9,0,68,59
1657791891012,COGS 101B,A01,091572,Allen; Michael Gordon,12,0,65,53
1657791897035,COGS 101C,A01,083625,Delgado; Tania,17,0,35,18
1657791903057,COGS 107A,A01,083627,Boyle; Mary E. T.,14,0,60,46
1657791909081,COGS 118A,A01,083075,Gupta; Anjum,21,0,76,55
1657791915103,CSE 3,A50,083646,Miranda; Gregory Joseph,24,0,50,26
1657791921129,CSE 8A,A50,083650,Miranda; Gregory Joseph,17,1,56,39
1657791927153,CSE 11,A01,083080,Cao; Yingjun,6,15,40,34
1657791933179,CSE 12,A01,083652,Krause-Levy; Sophia Louisa,28,1,120,92
1657791939205,CSE 15L,A01,083654,Morris; Justin Loren,9,0,50,41
1657791939205,CSE 15L,A02,083655,Morris; Justin Loren,9,0,50,41
1657791945232,CSE 20,A01,083657,Tran; Khoa Dang,39,0,80,41
1657791951255,CSE 21,A01,095574,Bach; Quang Tran,22,0,48,26
1657791957279,CSE 30,A01,083084,Eldon; John,6,0,80,74
1657791957279,CSE 30,B01,095061,Bhaskar; Nishant,9,0,50,41
1657791963305,CSE 100,A01,083659,Cao; Yingjun,5,4,70,65
1657791969331,CSE 134B,A01,083661,Powell; Thomas Allan,24,0,100,76
1657791975353,CSE 140,A01,083663,Gungor; Onat,15,0,85,70
1657791981376,CSE 140L,A01,083088,Eldon; John,23,0,100,77
1657791987400,CSE 175,A01,083665,Kumar; Rakesh,3,0,25,22
1657791993434,CSE 190,A00,092507,Dubnov; Shlomo,8,0,20,12
1657791999457,ECE 45,A01,083139,Congero; Spencer William,6,0,75,69
1657792005485,ECE 65,A50,083695,Saad; Andrew S,12,0,30,18
1657792005485,ECE 65,A51,095125,Saad; Andrew S,24,0,26,2
1657792011508,ECE 109,A01,091882,Touri; Behrouz,20,0,70,50
1657792017533,ECE 180,A00,083140,Abi Samra; Nicholas Camill,1,0,30,29
1657792017533,ECE 180,B00,083141,Abi Samra; Nicholas Camill,0,0,30,30
1657792023572,MATH 10A,A01,083735,Patchell; Gregory David,2,0,30,28
1657792023572,MATH 10A,A02,083736,Patchell; Gregory David,20,0,30,10
1657792023572,MATH 10A,A03,083737,Patchell; Gregory David,16,0,30,14
1657792029608,MATH 10B,A01,083207,Lim; Seonhee,8,0,34,26
1657792029608,MATH 10B,A02,083208,Lim; Seonhee,10,0,35,25
1657792029608,MATH 10B,A03,093472,Lim; Seonhee,7,0,34,27
1657792029608,MATH 10B,B01,083739,Sinha; Shubham,13,0,30,17
1657792035639,MATH 18,A01,083743,Cinel; Cameron Alexander,9,0,30,21
1657792035639,MATH 18,A02,083744,Cinel; Cameron Alexander,18,0,30,12
1657792035639,MATH 18,A03,083745,Cinel; Cameron Alexander,10,0,30,20
1657792035639,MATH 18,B01,083748,Rideout; David Porter,5,0,37,32
1657792035639,MATH 18,B02,083749,Rideout; David Porter,5,0,36,31
1657792035639,MATH 18,B03,083750,Rideout; David Porter,3,0,37,34
1657792035639,MATH 18,B04,083751,Rideout; David Porter,6,0,36,30
1657792035639,MATH 18,B05,093473,Rideout; David Porter,6,0,36,30
1657792035639,MATH 18,B06,093474,Rideout; David Porter,6,0,36,30
1657792041665,MATH 20A,A01,083754,Zheng; Zequn,14,0,40,26
1657792047693,MATH 20B,A01,083756,Briones; Jor-el Thomas Caparas,4,0,36,32
1657792047693,MATH 20B,A02,083757,Briones; Jor-el Thomas Caparas,1,0,36,35
1657792047693,MATH 20B,A03,093475,Briones; Jor-el Thomas Caparas,2,0,36,34
1657792053721,MATH 20C,A01,083760,Briones; Jor-el Thomas Caparas,1,0,35,34
1657792053721,MATH 20C,A02,083761,Briones; Jor-el Thomas Caparas,8,0,35,27
1657792053721,MATH 20C,A03,093476,Briones; Jor-el Thomas Caparas,0,1,36,36
1657792053721,MATH 20C,B01,083762,Bach; Quang Tran,1,0,30,29
1657792059749,MATH 20D,A01,083765,Tran; Brian Kha,5,0,30,25
1657792059749,MATH 20D,A02,083766,Tran; Brian Kha,5,0,30,25
1657792059749,MATH 20D,A03,083767,Tran; Brian Kha,5,0,30,25
1657792065779,MATH 20E,A01,083771,Ganguly; Soumya,10,0,32,22
1657792065779,MATH 20E,A02,083772,Ganguly; Soumya,6,0,32,26
1657792065779,MATH 20E,B01,083773,Ciotti; Benjamin,20,0,35,15
1657792065779,MATH 20E,B02,083774,Ciotti; Benjamin,18,0,35,17
1657792071802,MATH 103A,A01,083777,Greenfeld; Be'Eri,3,0,36,33
1657792071802,MATH 103A,A02,083778,Greenfeld; Be'Eri,5,0,36,31
1657792071802,MATH 103A,A03,093561,Greenfeld; Be'Eri,6,0,36,30
1657792071802,MATH 103A,B01,083779,Greenfeld; Be'Eri,7,0,36,29
1657792071802,MATH 103A,B02,083780,Greenfeld; Be'Eri,4,0,36,32
1657792071802,MATH 103A,B03,093562,Greenfeld; Be'Eri,3,0,36,33
1657792077829,MATH 105,A01,085443,Carter; Anne Toulson,15,0,35,20
1657792077829,MATH 105,A02,093477,Carter; Anne Toulson,20,0,35,15
1657792083858,MATH 109,A01,083213,Ganzberger; Geoffrey Michael,3,0,34,31
1657792083858,MATH 109,A02,083214,Ganzberger; Geoffrey Michael,4,0,34,30
1657792083858,MATH 109,A03,093478,Ganzberger; Geoffrey Michael,2,0,34,32
1657792083858,MATH 109,B01,083215,Ganzberger; Geoffrey Michael,1,0,32,31
1657792083858,MATH 109,B02,083216,Ganzberger; Geoffrey Michael,2,0,32,30
1657792083858,MATH 109,B03,093479,Ganzberger; Geoffrey Michael,8,0,32,24
1657792089882,MATH 142A,A01,083219,Chow; Bennett,7,0,32,25
1657792089882,MATH 142A,A02,083220,Chow; Bennett,10,0,32,22
1657792089882,MATH 142A,A03,093480,Chow; Bennett,9,0,32,23
1657792089882,MATH 142A,B03,093481,Chow; Bennett,8,0,32,24
1657792089882,MATH 142A,B04,093558,Chow; Bennett,13,0,32,19
1657792089882,MATH 142A,B05,093559,Chow; Bennett,6,0,32,26
1657792095913,MATH 193A,A01,083224,Rotar; Vladimir,8,0,34,26
1657792095913,MATH 193A,A02,083225,Rotar; Vladimir,9,0,34,25
1657792095913,MATH 193A,A03,083781,Rotar; Vladimir,5,0,34,29
1657792095913,MATH 193A,A04,083782,Rotar; Vladimir,10,0,34,24
1657792095913,MATH 193A,A05,093482,Rotar; Vladimir,10,0,34,24
1657792101940,MATH 197,001,091859,McAuley; Julian John,9999,0,9999,0
1657792101940,MATH 197,002,095566,Kedlaya; Kiran S.,9997,0,9999,2
1657792101940,MATH 197,003,095567,Xiao; Ming,9999,0,9999,0
1657792101940,MATH 197,004,095571,Perols; Johan Lars,9998,0,9999,1
1657792109003,COGS 9,A01,083615,Shannon; Kyle Michael,9,0,75,66
1657792115029,COGS 11,A01,083617,Boyle; Mary E. T.,23,0,48,25
1657792121055,COGS 13,A01,083071,Bastos; Amalia Pinkusfeld,11,0,71,60
1657792127081,COGS 14A,A01,092681,Semenuks; Arturs,5,1,100,95
1657792133108,COGS 14B,A01,083073,Cheng; Tzu-Han,6,0,63,57
1657792139134,COGS 17,A01,092677,Semenuks; Arturs,6,0,81,75
1657792145156,COGS 100,A01,083619,Allen; Michael Gordon,17,0,70,53
1657792151266,COGS 101A,A01,083621,Davis; Joshua Daniel,9,0,68,59
1657792157289,COGS 101B,A01,091572,Allen; Michael Gordon,12,0,65,53
1657792163314,COGS 101C,A01,083625,Delgado; Tania,17,0,35,18
1657792169338,COGS 107A,A01,083627,Boyle; Mary E. T.,14,0,60,46
1657792175360,COGS 118A,A01,083075,Gupta; Anjum,21,0,76,55
1657792181384,CSE 3,A50,083646,Miranda; Gregory Joseph,24,0,50,26
1657792187408,CSE 8A,A50,083650,Miranda; Gregory Joseph,17,1,56,39
1657792193434,CSE 11,A01,083080,Cao; Yingjun,6,15,40,34
1657792199457,CSE 12,A01,083652,Krause-Levy; Sophia Louisa,28,1,120,92
1657792205480,CSE 15L,A01,083654,Morris; Justin Loren,9,0,50,41
1657792205480,CSE 15L,A02,083655,Morris; Justin Loren,9,0,50,41
1657792211503,CSE 20,A01,083657,Tran; Khoa Dang,39,0,80,41
1657792217529,CSE 21,A01,095574,Bach; Quang Tran,22,0,48,26
1657792223556,CSE 30,A01,083084,Eldon; John,6,0,80,74
1657792223556,CSE 30,B01,095061,Bhaskar; Nishant,9,0,50,41
1657792229581,CSE 100,A01,083659,Cao; Yingjun,5,4,70,65
1657792235603,CSE 134B,A01,083661,Powell; Thomas Allan,24,0,100,76
1657792241627,CSE 140,A01,083663,Gungor; Onat,15,0,85,70
1657792247652,CSE 140L,A01,083088,Eldon; John,23,0,100,77
1657792253673,CSE 175,A01,083665,Kumar; Rakesh,3,0,25,22
1657792259698,CSE 190,A00,092507,Dubnov; Shlomo,8,0,20,12
1657792265732,ECE 45,A01,083139,Congero; Spencer William,6,0,75,69
1657792271757,ECE 65,A50,083695,Saad; Andrew S,12,0,30,18
1657792271757,ECE 65,A51,095125,Saad; Andrew S,24,0,26,2
1657792277780,ECE 109,A01,091882,Touri; Behrouz,20,0,70,50
1657792283807,ECE 180,A00,083140,Abi Samra; Nicholas Camill,1,0,30,29
1657792283807,ECE 180,B00,083141,Abi Samra; Nicholas Camill,0,0,30,30
1657792289832,MATH 10A,A01,083735,Patchell; Gregory David,2,0,30,28
1657792289832,MATH 10A,A02,083736,Patchell; Gregory David,20,0,30,10
1657792289832,MATH 10A,A03,083737,Patchell; Gregory David,16,0,30,14
1657792295855,MATH 10B,A01,083207,Lim; Seonhee,8,0,34,26
1657792295855,MATH 10B,A02,083208,Lim; Seonhee,10,0,35,25
1657792295855,MATH 10B,A03,093472,Lim; Seonhee,7,0,34,27
1657792295855,MATH 10B,B01,083739,Sinha; Shubham,13,0,30,17
1657792301881,MATH 18,A01,083743,Cinel; Cameron Alexander,9,0,30,21
1657792301881,MATH 18,A02,083744,Cinel; Cameron Alexander,18,0,30,12
1657792301881,MATH 18,A03,083745,Cinel; Cameron Alexander,10,0,30,20
1657792301881,MATH 18,B01,083748,Rideout; David Porter,5,0,37,32
1657792301881,MATH 18,B02,083749,Rideout; David Porter,5,0,36,31
1657792301881,MATH 18,B03,083750,Rideout; David Porter,3,0,37,34
1657792301881,MATH 18,B04,083751,Rideout; David Porter,6,0,36,30
1657792301881,MATH 18,B05,093473,Rideout; David Porter,6,0,36,30
1657792301881,MATH 18,B06,093474,Rideout; David Porter,6,0,36,30
1657792307909,MATH 20A,A01,083754,Zheng; Zequn,14,0,40,26
1657792313932,MATH 20B,A01,083756,Briones; Jor-el Thomas Caparas,4,0,36,32
1657792313932,MATH 20B,A02,083757,Briones; Jor-el Thomas Caparas,1,0,36,35
1657792313932,MATH 20B,A03,093475,Briones; Jor-el Thomas Caparas,2,0,36,34
1657792319956,MATH 20C,A01,083760,Briones; Jor-el Thomas Caparas,1,0,35,34
1657792319956,MATH 20C,A02,083761,Briones; Jor-el Thomas Caparas,8,0,35,27
1657792319956,MATH 20C,A03,093476,Briones; Jor-el Thomas Caparas,0,1,36,36
1657792319956,MATH 20C,B01,083762,Bach; Quang Tran,1,0,30,29
1657792325985,MATH 20D,A01,083765,Tran; Brian Kha,5,0,30,25
1657792325985,MATH 20D,A02,083766,Tran; Brian Kha,5,0,30,25
1657792325985,MATH 20D,A03,083767,Tran; Brian Kha,5,0,30,25
1657792332014,MATH 20E,A01,083771,Ganguly; Soumya,10,0,32,22
1657792332014,MATH 20E,A02,083772,Ganguly; Soumya,6,0,32,26
1657792332014,MATH 20E,B01,083773,Ciotti; Benjamin,20,0,35,15
1657792332014,MATH 20E,B02,083774,Ciotti; Benjamin,18,0,35,17
1657792338044,MATH 103A,A01,083777,Greenfeld; Be'Eri,3,0,36,33
1657792338044,MATH 103A,A02,083778,Greenfeld; Be'Eri,5,0,36,31
1657792338044,MATH 103A,A03,093561,Greenfeld; Be'Eri,6,0,36,30
1657792338044,MATH 103A,B01,083779,Greenfeld; Be'Eri,7,0,36,29
1657792338044,MATH 103A,B02,083780,Greenfeld; Be'Eri,4,0,36,32
1657792338044,MATH 103A,B03,093562,Greenfeld; Be'Eri,3,0,36,33
1657792344067,MATH 105,A01,085443,Carter; Anne Toulson,15,0,35,20
1657792344067,MATH 105,A02,093477,Carter; Anne Toulson,20,0,35,15
1657792350096,MATH 109,A01,083213,Ganzberger; Geoffrey Michael,3,0,34,31
1657792350096,MATH 109,A02,083214,Ganzberger; Geoffrey Michael,4,0,34,30
1657792350096,MATH 109,A03,093478,Ganzberger; Geoffrey Michael,2,0,34,32
1657792350096,MATH 109,B01,083215,Ganzberger; Geoffrey Michael,1,0,32,31
1657792350096,MATH 109,B02,083216,Ganzberger; Geoffrey Michael,2,0,32,30
1657792350096,MATH 109,B03,093479,Ganzberger; Geoffrey Michael,8,0,32,24
1657792356121,MATH 142A,A01,083219,Chow; Bennett,7,0,32,25
1657792356121,MATH 142A,A02,083220,Chow; Bennett,10,0,32,22
1657792356121,MATH 142A,A03,093480,Chow; Bennett,9,0,32,23
1657792356121,MATH 142A,B03,093481,Chow; Bennett,8,0,32,24
1657792356121,MATH 142A,B04,093558,Chow; Bennett,13,0,32,19
1657792356121,MATH 142A,B05,093559,Chow; Bennett,6,0,32,26
1657792362145,MATH 193A,A01,083224,Rotar; Vladimir,8,0,34,26
1657792362145,MATH 193A,A02,083225,Rotar; Vladimir,9,0,34,25
1657792362145,MATH 193A,A03,083781,Rotar; Vladimir,5,0,34,29
1657792362145,MATH 193A,A04,083782,Rotar; Vladimir,10,0,34,24
1657792362145,MATH 193A,A05,093482,Rotar; Vladimir,10,0,34,24
1657792368169,MATH 197,001,091859,McAuley; Julian John,9999,0,9999,0
1657792368169,MATH 197,002,095566,Kedlaya; Kiran S.,9997,0,9999,2
1657792368169,MATH 197,003,095567,Xiao; Ming,9999,0,9999,0
1657792368169,MATH 197,004,095571,Perols; Johan Lars,9998,0,9999,1
1657792375224,COGS 9,A01,083615,Shannon; Kyle Michael,9,0,75,66
1657792381248,COGS 11,A01,083617,Boyle; Mary E. T.,23,0,48,25
1657792387271,COGS 13,A01,083071,Bastos; Amalia Pinkusfeld,11,0,71,60
1657792393299,COGS 14A,A01,092681,Semenuks; Arturs,5,1,100,95
1657792399323,COGS 14B,A01,083073,Cheng; Tzu-Han,6,0,63,57
1657792405355,COGS 17,A01,092677,Semenuks; Arturs,6,0,81,75
1657792411380,COGS 100,A01,083619,Allen; Michael Gordon,17,0,70,53
1657792417403,COGS 101A,A01,083621,Davis; Joshua Daniel,9,0,68,59
1657792423428,COGS 101B,A01,091572,Allen; Michael Gordon,12,0,65,53
1657792429452,COGS 101C,A01,083625,Delgado; Tania,17,0,35,18
1657792435476,COGS 107A,A01,083627,Boyle; Mary E. T.,14,0,60,46
1657792441499,COGS 118A,A01,083075,Gupta; Anjum,21,0,76,55
1657792447522,CSE 3,A50,083646,Miranda; Gregory Joseph,24,0,50,26
1657792453555,CSE 8A,A50,083650,Miranda; Gregory Joseph,17,1,56,39
1657792459579,CSE 11,A01,083080,Cao; Yingjun,6,15,40,34
1657792465613,CSE 12,A01,083652,Krause-Levy; Sophia Louisa,28,1,120,92
1657792471643,CSE 15L,A01,083654,Morris; Justin Loren,9,0,50,41
1657792471643,CSE 15L,A02,083655,Morris; Justin Loren,9,0,50,41
1657792477666,CSE 20,A01,083657,Tran; Khoa Dang,39,0,80,41
1657792483689,CSE 21,A01,095574,Bach; Quang Tran,22,0,48,26
1657792489712,CSE 30,A01,083084,Eldon; John,6,0,80,74
1657792489712,CSE 30,B01,095061,Bhaskar; Nishant,9,0,50,41
1657792495739,CSE 100,A01,083659,Cao; Yingjun,5,4,70,65
1657792501761,CSE 134B,A01,083661,Powell; Thomas Allan,24,0,100,76
1657792507784,CSE 140,A01,083663,Gungor; Onat,15,0,85,70
1657792513806,CSE 140L,A01,083088,Eldon; John,23,0,100,77
1657792519829,CSE 175,A01,083665,Kumar; Rakesh,3,0,25,22
1657792525854,CSE 190,A00,092507,Dubnov; Shlomo,8,0,20,12
1657792531881,ECE 45,A01,083139,Congero; Spencer William,6,0,75,69
1657792537903,ECE 65,A50,083695,Saad; Andrew S,12,0,30,18
1657792537903,ECE 65,A51,095125,Saad; Andrew S,24,0,26,2
1657792543927,ECE 109,A01,091882,Touri; Behrouz,20,0,70,50
1657792549950,ECE 180,A00,083140,Abi Samra; Nicholas Camill,1,0,30,29
1657792549950,ECE 180,B00,083141,Abi Samra; Nicholas Camill,0,0,30,30
1657792555977,MATH 10A,A01,083735,Patchell; Gregory David,2,0,30,28
1657792555977,MATH 10A,A02,083736,Patchell; Gregory David,20,0,30,10
1657792555977,MATH 10A,A03,083737,Patchell; Gregory David,16,0,30,14
1657792562002,MATH 10B,A01,083207,Lim; Seonhee,8,0,34,26
1657792562002,MATH 10B,A02,083208,Lim; Seonhee,10,0,35,25
1657792562002,MATH 10B,A03,093472,Lim; Seonhee,7,0,34,27
1657792562002,MATH 10B,B01,083739,Sinha; Shubham,13,0,30,17
1657792568035,MATH 18,A01,083743,Cinel; Cameron Alexander,9,0,30,21
1657792568035,MATH 18,A02,083744,Cinel; Cameron Alexander,18,0,30,12
1657792568035,MATH 18,A03,083745,Cinel; Cameron Alexander,10,0,30,20
1657792568035,MATH 18,B01,083748,Rideout; David Porter,5,0,37,32
1657792568035,MATH 18,B02,083749,Rideout; David Porter,5,0,36,31
1657792568035,MATH 18,B03,083750,Rideout; David Porter,3,0,37,34
1657792568035,MATH 18,B04,083751,Rideout; David Porter,6,0,36,30
1657792568035,MATH 18,B05,093473,Rideout; David Porter,6,0,36,30
1657792568035,MATH 18,B06,093474,Rideout; David Porter,6,0,36,30
1657792574061,MATH 20A,A01,083754,Zheng; Zequn,14,0,40,26
1657792580091,MATH 20B,A01,083756,Briones; Jor-el Thomas Caparas,4,0,36,32
1657792580091,MATH 20B,A02,083757,Briones; Jor-el Thomas Caparas,1,0,36,35
1657792580091,MATH 20B,A03,093475,Briones; Jor-el Thomas Caparas,2,0,36,34
1657792586119,MATH 20C,A01,083760,Briones; Jor-el Thomas Caparas,1,0,35,34
1657792586119,MATH 20C,A02,083761,Briones; Jor-el Thomas Caparas,8,0,35,27
1657792586119,MATH 20C,A03,093476,Briones; Jor-el Thomas Caparas,0,1,36,36
1657792586119,MATH 20C,B01,083762,Bach; Quang Tran,1,0,30,29
1657792592151,MATH 20D,A01,083765,Tran; Brian Kha,5,0,30,25
1657792592151,MATH 20D,A02,083766,Tran; Brian Kha,5,0,30,25
1657792592151,MATH 20D,A03,083767,Tran; Brian Kha,5,0,30,25
1657792598178,MATH 20E,A01,083771,Ganguly; Soumya,10,0,32,22
1657792598178,MATH 20E,A02,083772,Ganguly; Soumya,6,0,32,26
1657792598178,MATH 20E,B01,083773,Ciotti; Benjamin,20,0,35,15
1657792598178,MATH 20E,B02,083774,Ciotti; Benjamin,18,0,35,17
1657792604208,MATH 103A,A01,083777,Greenfeld; Be'Eri,3,0,36,33
1657792604208,MATH 103A,A02,083778,Greenfeld; Be'Eri,5,0,36,31
1657792604208,MATH 103A,A03,093561,Greenfeld; Be'Eri,6,0,36,30
1657792604208,MATH 103A,B01,083779,Greenfeld; Be'Eri,7,0,36,29
1657792604208,MATH 103A,B02,083780,Greenfeld; Be'Eri,4,0,36,32
1657792604208,MATH 103A,B03,093562,Greenfeld; Be'Eri,3,0,36,33
1657792610235,MATH 105,A01,085443,Carter; Anne Toulson,15,0,35,20
1657792610235,MATH 105,A02,093477,Carter; Anne Toulson,20,0,35,15
1657792616263,MATH 109,A01,083213,Ganzberger; Geoffrey Michael,3,0,34,31
1657792616263,MATH 109,A02,083214,Ganzberger; Geoffrey Michael,4,0,34,30
1657792616263,MATH 109,A03,093478,Ganzberger; Geoffrey Michael,2,0,34,32
1657792616263,MATH 109,B01,083215,Ganzberger; Geoffrey Michael,1,0,32,31
1657792616263,MATH 109,B02,083216,Ganzberger; Geoffrey Michael,2,0,32,30
1657792616263,MATH 109,B03,093479,Ganzberger; Geoffrey Michael,8,0,32,24
1657792622286,MATH 142A,A01,083219,Chow; Bennett,7,0,32,25
1657792622286,MATH 142A,A02,083220,Chow; Bennett,10,0,32,22
1657792622286,MATH 142A,A03,093480,Chow; Bennett,9,0,32,23
1657792622286,MATH 142A,B03,093481,Chow; Bennett,8,0,32,24
1657792622286,MATH 142A,B04,093558,Chow; Bennett,13,0,32,19
1657792622286,MATH 142A,B05,093559,Chow; Bennett,6,0,32,26
1657792628311,MATH 193A,A01,083224,Rotar; Vladimir,8,0,34,26
1657792628311,MATH 193A,A02,083225,Rotar; Vladimir,9,0,34,25
1657792628311,MATH 193A,A03,083781,Rotar; Vladimir,5,0,34,29
1657792628311,MATH 193A,A04,083782,Rotar; Vladimir,10,0,34,24
1657792628311,MATH 193A,A05,093482,Rotar; Vladimir,10,0,34,24
1657792634334,MATH 197,001,091859,McAuley; Julian John,9999,0,9999,0
1657792634334,MATH 197,002,095566,Kedlaya; Kiran S.,9997,0,9999,2
1657792634334,MATH 197,003,095567,Xiao; Ming,9999,0,9999,0
1657792634334,MATH 197,004,095571,Perols; Johan Lars,9998,0,9999,1
1657792641391,COGS 9,A01,083615,Shannon; Kyle Michael,9,0,75,66
1657792647412,COGS 11,A01,083617,Boyle; Mary E. T.,23,0,48,25
1657792653436,COGS 13,A01,083071,Bastos; Amalia Pinkusfeld,11,0,71,60
1657792659460,COGS 14A,A01,092681,Semenuks; Arturs,5,1,100,95
1657792665489,COGS 14B,A01,083073,Cheng; Tzu-Han,6,0,63,57
1657792671512,COGS 17,A01,092677,Semenuks; Arturs,6,0,81,75
1657792677539,COGS 100,A01,083619,Allen; Michael Gordon,17,0,70,53
1657792683562,COGS 101A,A01,083621,Davis; Joshua Daniel,9,0,68,59
1657792689591,COGS 101B,A01,091572,Allen; Michael Gordon,12,0,65,53
1657792695615,COGS 101C,A01,083625,Delgado; Tania,17,0,35,18
1657792701639,COGS 107A,A01,083627,Boyle; Mary E. T.,14,0,60,46
1657792707665,COGS 118A,A01,083075,Gupta; Anjum,21,0,76,55
1657792713694,CSE 3,A50,083646,Miranda; Gregory Joseph,24,0,50,26
1657792719717,CSE 8A,A50,083650,Miranda; Gregory Joseph,17,1,56,39
1657792725744,CSE 11,A01,083080,Cao; Yingjun,6,15,40,34
1657792731768,CSE 12,A01,083652,Krause-Levy; Sophia Louisa,28,1,120,92
1657792737792,CSE 15L,A01,083654,Morris; Justin Loren,9,0,50,41
1657792737792,CSE 15L,A02,083655,Morris; Justin Loren,9,0,50,41
1657792743814,CSE 20,A01,083657,Tran; Khoa Dang,39,0,80,41
1657792749910,CSE 21,A01,095574,Bach; Quang Tran,22,0,48,26
1657792755946,CSE 30,A01,083084,Eldon; John,6,0,80,74
1657792755946,CSE 30,B01,095061,Bhaskar; Nishant,9,0,50,41
1657792761970,CSE 100,A01,083659,Cao; Yingjun,5,4,70,65
1657792767992,CSE 134B,A01,083661,Powell; Thomas Allan,24,0,100,76
1657792774023,CSE 140,A01,083663,Gungor; Onat,15,0,85,70
1657792780046,CSE 140L,A01,083088,Eldon; John,23,0,100,77
1657792786072,CSE 175,A01,083665,Kumar; Rakesh,3,0,25,22
1657792792106,CSE 190,A00,092507,Dubnov; Shlomo,8,0,20,12
1657792798130,ECE 45,A01,083139,Congero; Spencer William,6,0,75,69
1657792804159,ECE 65,A50,083695,Saad; Andrew S,12,0,30,18
1657792804159,ECE 65,A51,095125,Saad; Andrew S,24,0,26,2
1657792810182,ECE 109,A01,091882,Touri; Behrouz,20,0,70,50
1657792816206,ECE 180,A00,083140,Abi Samra; Nicholas Camill,1,0,30,29
1657792816206,ECE 180,B00,083141,Abi Samra; Nicholas Camill,0,0,30,30
1657792822234,MATH 10A,A01,083735,Patchell; Gregory David,2,0,30,28
1657792822234,MATH 10A,A02,083736,Patchell; Gregory David,20,0,30,10
1657792822234,MATH 10A,A03,083737,Patchell; Gregory David,16,0,30,14
1657792828261,MATH 10B,A01,083207,Lim; Seonhee,8,0,34,26
1657792828261,MATH 10B,A02,083208,Lim; Seonhee,10,0,35,25
1657792828261,MATH 10B,A03,093472,Lim; Seonhee,7,0,34,27
1657792828261,MATH 10B,B01,083739,Sinha; Shubham,13,0,30,17
1657792834286,MATH 18,A01,083743,Cinel; Cameron Alexander,9,0,30,21
1657792834286,MATH 18,A02,083744,Cinel; Cameron Alexander,18,0,30,12
1657792834286,MATH 18,A03,083745,Cinel; Cameron Alexander,10,0,30,20
1657792834286,MATH 18,B01,083748,Rideout; David Porter,5,0,37,32
1657792834286,MATH 18,B02,083749,Rideout; David Porter,5,0,36,31
1657792834286,MATH 18,B03,083750,Rideout; David Porter,3,0,37,34
1657792834286,MATH 18,B04,083751,Rideout; David Porter,6,0,36,30
1657792834286,MATH 18,B05,093473,Rideout; David Porter,6,0,36,30
1657792834286,MATH 18,B06,093474,Rideout; David Porter,6,0,36,30
1657792840309,MATH 20A,A01,083754,Zheng; Zequn,14,0,40,26
1657792846331,MATH 20B,A01,083756,Briones; Jor-el Thomas Caparas,4,0,36,32
1657792846331,MATH 20B,A02,083757,Briones; Jor-el Thomas Caparas,1,0,36,35
1657792846331,MATH 20B,A03,093475,Briones; Jor-el Thomas Caparas,2,0,36,34
1657792852357,MATH 20C,A01,083760,Briones; Jor-el Thomas Caparas,1,0,35,34
1657792852357,MATH 20C,A02,083761,Briones; Jor-el Thomas Caparas,8,0,35,27
1657792852357,MATH 20C,A03,093476,Briones; Jor-el Thomas Caparas,0,1,36,36
1657792852357,MATH 20C,B01,083762,Bach; Quang Tran,1,0,30,29
1657792858386,MATH 20D,A01,083765,Tran; Brian Kha,5,0,30,25
1657792858386,MATH 20D,A02,083766,Tran; Brian Kha,5,0,30,25
1657792858386,MATH 20D,A03,083767,Tran; Brian Kha,5,0,30,25
1657792864414,MATH 20E,A01,083771,Ganguly; Soumya,10,0,32,22
1657792864414,MATH 20E,A02,083772,Ganguly; Soumya,6,0,32,26
1657792864414,MATH 20E,B01,083773,Ciotti; Benjamin,20,0,35,15
1657792864414,MATH 20E,B02,083774,Ciotti; Benjamin,18,0,35,17
1657792870448,MATH 103A,A01,083777,Greenfeld; Be'Eri,3,0,36,33
1657792870448,MATH 103A,A02,083778,Greenfeld; Be'Eri,5,0,36,31
1657792870448,MATH 103A,A03,093561,Greenfeld; Be'Eri,6,0,36,30
1657792870448,MATH 103A,B01,083779,Greenfeld; Be'Eri,7,0,36,29
1657792870448,MATH 103A,B02,083780,Greenfeld; Be'Eri,4,0,36,32
1657792870448,MATH 103A,B03,093562,Greenfeld; Be'Eri,3,0,36,33
1657792876471,MATH 105,A01,085443,Carter; Anne Toulson,15,0,35,20
1657792876471,MATH 105,A02,093477,Carter; Anne Toulson,20,0,35,15
1657792882494,MATH 109,A01,083213,Ganzberger; Geoffrey Michael,3,0,34,31
1657792882494,MATH 109,A02,083214,Ganzberger; Geoffrey Michael,4,0,34,30
1657792882494,MATH 109,A03,093478,Ganzberger; Geoffrey Michael,2,0,34,32
1657792882494,MATH 109,B01,083215,Ganzberger; Geoffrey Michael,1,0,32,31
1657792882494,MATH 109,B02,083216,Ganzberger; Geoffrey Michael,2,0,32,30
1657792882494,MATH 109,B03,093479,Ganzberger; Geoffrey Michael,8,0,32,24
1657792888522,MATH 142A,A01,083219,Chow; Bennett,7,0,32,25
1657792888522,MATH 142A,A02,083220,Chow; Bennett,10,0,32,22
1657792888522,MATH 142A,A03,093480,Chow; Bennett,9,0,32,23
1657792888522,MATH 142A,B03,093481,Chow; Bennett,8,0,32,24
1657792888522,MATH 142A,B04,093558,Chow; Bennett,13,0,32,19
1657792888522,MATH 142A,B05,093559,Chow; Bennett,6,0,32,26
1657792894545,MATH 193A,A01,083224,Rotar; Vladimir,8,0,34,26
1657792894545,MATH 193A,A02,083225,Rotar; Vladimir,9,0,34,25
1657792894545,MATH 193A,A03,083781,Rotar; Vladimir,5,0,34,29
1657792894545,MATH 193A,A04,083782,Rotar; Vladimir,10,0,34,24
1657792894545,MATH 193A,A05,093482,Rotar; Vladimir,10,0,34,24
1657792900568,MATH 197,001,091859,McAuley; Julian John,9999,0,9999,0
1657792900568,MATH 197,002,095566,Kedlaya; Kiran S.,9997,0,9999,2
1657792900568,MATH 197,003,095567,Xiao; Ming,9999,0,9999,0
1657792900568,MATH 197,004,095571,Perols; Johan Lars,9998,0,9999,1
1657792907631,COGS 9,A01,083615,Shannon; Kyle Michael,9,0,75,66
1657792913655,COGS 11,A01,083617,Boyle; Mary E. T.,23,0,48,25
1657792919677,COGS 13,A01,083071,Bastos; Amalia Pinkusfeld,11,0,71,60
1657792925714,COGS 14A,A01,092681,Semenuks; Arturs,5,1,100,95
1657792931741,COGS 14B,A01,083073,Cheng; Tzu-Han,6,0,63,57
1657792937763,COGS 17,A01,092677,Semenuks; Arturs,6,0,81,75
1657792943786,COGS 100,A01,083619,Allen; Michael Gordon,17,0,70,53
1657792949809,COGS 101A,A01,083621,Davis; Joshua Daniel,9,0,68,59
1657792955831,COGS 101B,A01,091572,Allen; Michael Gordon,12,0,65,53
1657792961855,COGS 101C,A01,083625,Delgado; Tania,17,0,35,18
1657792967882,COGS 107A,A01,083627,Boyle; Mary E. T.,14,0,60,46
1657792973916,COGS 118A,A01,083075,Gupta; Anjum,21,0,76,55
1657792979940,CSE 3,A50,083646,Miranda; Gregory Joseph,24,0,50,26
1657792985967,CSE 8A,A50,083650,Miranda; Gregory Joseph,17,1,56,39
1657792992003,CSE 11,A01,083080,Cao; Yingjun,6,15,40,34
1657792998028,CSE 12,A01,083652,Krause-Levy; Sophia Louisa,28,1,120,92
1657793004054,CSE 15L,A01,083654,Morris; Justin Loren,9,0,50,41
1657793004054,CSE 15L,A02,083655,Morris; Justin Loren,9,0,50,41
1657793010079,CSE 20,A01,083657,Tran; Khoa Dang,39,0,80,41
1657793016122,CSE 21,A01,095574,Bach; Quang Tran,22,0,48,26
1657793022146,CSE 30,A01,083084,Eldon; John,6,0,80,74
1657793022146,CSE 30,B01,095061,Bhaskar; Nishant,9,0,50,41
1657793028169,CSE 100,A01,083659,Cao; Yingjun,5,4,70,65
1657793034197,CSE 134B,A01,083661,Powell; Thomas Allan,24,0,100,76
1657793040230,CSE 140,A01,083663,Gungor; Onat,15,0,85,70
1657793046264,CSE 140L,A01,083088,Eldon; John,23,0,100,77
1657793052290,CSE 175,A01,083665,Kumar; Rakesh,3,0,25,22
1657793058316,CSE 190,A00,092507,Dubnov; Shlomo,8,0,20,12
1657793064339,ECE 45,A01,083139,Congero; Spencer William,6,0,75,69
1657793070363,ECE 65,A50,083695,Saad; Andrew S,12,0,30,18
1657793070363,ECE 65,A51,095125,Saad; Andrew S,24,0,26,2
1657793076388,ECE 109,A01,091882,Touri; Behrouz,20,0,70,50
1657793082412,ECE 180,A00,083140,Abi Samra; Nicholas Camill,1,0,30,29
1657793082412,ECE 180,B00,083141,Abi Samra; Nicholas Camill,0,0,30,30
1657793088436,MATH 10A,A01,083735,Patchell; Gregory David,2,0,30,28
1657793088436,MATH 10A,A02,083736,Patchell; Gregory David,20,0,30,10
1657793088436,MATH 10A,A03,083737,Patchell; Gregory David,16,0,30,14
1657793094460,MATH 10B,A01,083207,Lim; Seonhee,8,0,34,26
1657793094460,MATH 10B,A02,083208,Lim; Seonhee,10,0,35,25
1657793094460,MATH 10B,A03,093472,Lim; Seonhee,7,0,34,27
1657793094460,MATH 10B,B01,083739,Sinha; Shubham,13,0,30,17
1657793100497,MATH 18,A01,083743,Cinel; Cameron Alexander,9,0,30,21
1657793100497,MATH 18,A02,083744,Cinel; Cameron Alexander,18,0,30,12
1657793100497,MATH 18,A03,083745,Cinel; Cameron Alexander,10,0,30,20
1657793100497,MATH 18,B01,083748,Rideout; David Porter,5,0,37,32
1657793100497,MATH 18,B02,083749,Rideout; David Porter,5,0,36,31
1657793100497,MATH 18,B03,083750,Rideout; David Porter,3,0,37,34
1657793100497,MATH 18,B04,083751,Rideout; David Porter,6,0,36,30
1657793100497,MATH 18,B05,093473,Rideout; David Porter,6,0,36,30
1657793100497,MATH 18,B06,093474,Rideout; David Porter,6,0,36,30
1657793106519,MATH 20A,A01,083754,Zheng; Zequn,14,0,40,26
1657793112541,MATH 20B,A01,083756,Briones; Jor-el Thomas Caparas,4,0,36,32
1657793112541,MATH 20B,A02,083757,Briones; Jor-el Thomas Caparas,1,0,36,35
1657793112541,MATH 20B,A03,093475,Briones; Jor-el Thomas Caparas,2,0,36,34
1657793118573,MATH 20C,A01,083760,Briones; Jor-el Thomas Caparas,1,0,35,34
1657793118573,MATH 20C,A02,083761,Briones; Jor-el Thomas Caparas,8,0,35,27
1657793118573,MATH 20C,A03,093476,Briones; Jor-el Thomas Caparas,0,1,36,36
1657793118573,MATH 20C,B01,083762,Bach; Quang Tran,1,0,30,29
1657793124597,MATH 20D,A01,083765,Tran; Brian Kha,5,0,30,25
1657793124597,MATH 20D,A02,083766,Tran; Brian Kha,5,0,30,25
1657793124597,MATH 20D,A03,083767,Tran; Brian Kha,5,0,30,25
1657793130630,MATH 20E,A01,083771,Ganguly; Soumya,10,0,32,22
1657793130630,MATH 20E,A02,083772,Ganguly; Soumya,6,0,32,26
1657793130630,MATH 20E,B01,083773,Ciotti; Benjamin,20,0,35,15
1657793130630,MATH 20E,B02,083774,Ciotti; Benjamin,18,0,35,17
1657793136667,MATH 103A,A01,083777,Greenfeld; Be'Eri,3,0,36,33
1657793136667,MATH 103A,A02,083778,Greenfeld; Be'Eri,5,0,36,31
1657793136667,MATH 103A,A03,093561,Greenfeld; Be'Eri,6,0,36,30
1657793136667,MATH 103A,B01,083779,Greenfeld; Be'Eri,7,0,36,29
1657793136667,MATH 103A,B02,083780,Greenfeld; Be'Eri,4,0,36,32
1657793136667,MATH 103A,B03,093562,Greenfeld; Be'Eri,3,0,36,33
1657793142694,MATH 105,A01,085443,Carter; Anne Toulson,15,0,35,20
1657793142694,MATH 105,A02,093477,Carter; Anne Toulson,20,0,35,15
1657793148717,MATH 109,A01,083213,Ganzberger; Geoffrey Michael,3,0,34,31
1657793148717,MATH 109,A02,083214,Ganzberger; Geoffrey Michael,4,0,34,30
1657793148717,MATH 109,A03,093478,Ganzberger; Geoffrey Michael,2,0,34,32
1657793148717,MATH 109,B01,083215,Ganzberger; Geoffrey Michael,1,0,32,31
1657793148717,MATH 109,B02,083216,Ganzberger; Geoffrey Michael,2,0,32,30
1657793148717,MATH 109,B03,093479,Ganzberger; Geoffrey Michael,8,0,32,24
1657793154742,MATH 142A,A01,083219,Chow; Bennett,7,0,32,25
1657793154742,MATH 142A,A02,083220,Chow; Bennett,10,0,32,22
1657793154742,MATH 142A,A03,093480,Chow; Bennett,9,0,32,23
1657793154742,MATH 142A,B03,093481,Chow; Bennett,8,0,32,24
1657793154742,MATH 142A,B04,093558,Chow; Bennett,13,0,32,19
1657793154742,MATH 142A,B05,093559,Chow; Bennett,6,0,32,26
1657793160764,MATH 193A,A01,083224,Rotar; Vladimir,8,0,34,26
1657793160764,MATH 193A,A02,083225,Rotar; Vladimir,9,0,34,25
1657793160764,MATH 193A,A03,083781,Rotar; Vladimir,5,0,34,29
1657793160764,MATH 193A,A04,083782,Rotar; Vladimir,10,0,34,24
1657793160764,MATH 193A,A05,093482,Rotar; Vladimir,10,0,34,24
1657793166801,MATH 197,001,091859,McAuley; Julian John,9999,0,9999,0
1657793166801,MATH 197,002,095566,Kedlaya; Kiran S.,9997,0,9999,2
1657793166801,MATH 197,003,095567,Xiao; Ming,9999,0,9999,0
1657793166801,MATH 197,004,095571,Perols; Johan Lars,9998,0,9999,1
1657793173865,COGS 9,A01,083615,Shannon; Kyle Michael,9,0,75,66
1657793179897,COGS 11,A01,083617,Boyle; Mary E. T.,23,0,48,25
1657793185920,COGS 13,A01,083071,Bastos; Amalia Pinkusfeld,11,0,71,60
1657793191944,COGS 14A,A01,092681,Semenuks; Arturs,5,1,100,95
1657793197976,COGS 14B,A01,083073,Cheng; Tzu-Han,6,0,63,57
1657793203999,COGS 17,A01,092677,Semenuks; Arturs,6,0,81,75
1657793210023,COGS 100,A01,083619,Allen; Michael Gordon,17,0,70,53
1657793216047,COGS 101A,A01,083621,Davis; Joshua Daniel,9,0,68,59
1657793222070,COGS 101B,A01,091572,Allen; Michael Gordon,12,0,65,53
1657793228091,COGS 101C,A01,083625,Delgado; Tania,17,0,35,18
1657793234116,COGS 107A,A01,083627,Boyle; Mary E. T.,14,0,60,46
1657793240142,COGS 118A,A01,083075,Gupta; Anjum,21,0,76,55
1657793246167,CSE 3,A50,083646,Miranda; Gregory Joseph,24,0,50,26
1657793252190,CSE 8A,A50,083650,Miranda; Gregory Joseph,17,1,56,39
1657793258217,CSE 11,A01,083080,Cao; Yingjun,6,15,40,34
1657793264240,CSE 12,A01,083652,Krause-Levy; Sophia Louisa,28,1,120,92
1657793270264,CSE 15L,A01,083654,Morris; Justin Loren,9,0,50,41
1657793270264,CSE 15L,A02,083655,Morris; Justin Loren,9,0,50,41
1657793276287,CSE 20,A01,083657,Tran; Khoa Dang,39,0,80,41
1657793282319,CSE 21,A01,095574,Bach; Quang Tran,22,0,48,26
1657793288342,CSE 30,A01,083084,Eldon; John,6,0,80,74
1657793288342,CSE 30,B01,095061,Bhaskar; Nishant,9,0,50,41
1657793294368,CSE 100,A01,083659,Cao; Yingjun,5,4,70,65
1657793300396,CSE 134B,A01,083661,Powell; Thomas Allan,24,0,100,76
1657793306421,CSE 140,A01,083663,Gungor; Onat,15,0,85,70
1657793312448,CSE 140L,A01,083088,Eldon; John,23,0,100,77
1657793318471,CSE 175,A01,083665,Kumar; Rakesh,3,0,25,22
1657793324497,CSE 190,A00,092507,Dubnov; Shlomo,8,0,20,12
1657793330524,ECE 45,A01,083139,Congero; Spencer William,6,0,75,69
1657793336547,ECE 65,A50,083695,Saad; Andrew S,12,0,30,18
1657793336547,ECE 65,A51,095125,Saad; Andrew S,24,0,26,2
1657793342574,ECE 109,A01,091882,Touri; Behrouz,20,0,70,50
1657793348667,ECE 180,A00,083140,Abi Samra; Nicholas Camill,1,0,30,29
1657793348667,ECE 180,B00,083141,Abi Samra; Nicholas Camill,0,0,30,30
1657793354691,MATH 10A,A01,083735,Patchell; Gregory David,2,0,30,28
1657793354691,MATH 10A,A02,083736,Patchell; Gregory David,20,0,30,10
1657793354691,MATH 10A,A03,083737,Patchell; Gregory David,16,0,30,14
1657793360719,MATH 10B,A01,083207,Lim; Seonhee,8,0,34,26
1657793360719,MATH 10B,A02,083208,Lim; Seonhee,10,0,35,25
1657793360719,MATH 10B,A03,093472,Lim; Seonhee,7,0,34,27
1657793360719,MATH 10B,B01,083739,Sinha; Shubham,13,0,30,17
1657793366743,MATH 18,A01,083743,Cinel; Cameron Alexander,9,0,30,21
1657793366743,MATH 18,A02,083744,Cinel; Cameron Alexander,18,0,30,12
1657793366743,MATH 18,A03,083745,Cinel; Cameron Alexander,10,0,30,20
1657793366743,MATH 18,B01,083748,Rideout; David Porter,5,0,37,32
1657793366743,MATH 18,B02,083749,Rideout; David Porter,5,0,36,31
1657793366743,MATH 18,B03,083750,Rideout; David Porter,3,0,37,34
1657793366743,MATH 18,B04,083751,Rideout; David Porter,6,0,36,30
1657793366743,MATH 18,B05,093473,Rideout; David Porter,6,0,36,30
1657793366743,MATH 18,B06,093474,Rideout; David Porter,6,0,36,30
1657793372770,MATH 20A,A01,083754,Zheng; Zequn,14,0,40,26
1657793378818,MATH 20B,A01,083756,Briones; Jor-el Thomas Caparas,4,0,36,32
1657793378818,MATH 20B,A02,083757,Briones; Jor-el Thomas Caparas,1,0,36,35
1657793378818,MATH 20B,A03,093475,Briones; Jor-el Thomas Caparas,2,0,36,34
1657793384841,MATH 20C,A01,083760,Briones; Jor-el Thomas Caparas,1,0,35,34
1657793384841,MATH 20C,A02,083761,Briones; Jor-el Thomas Caparas,8,0,35,27
1657793384841,MATH 20C,A03,093476,Briones; Jor-el Thomas Caparas,0,1,36,36
1657793384841,MATH 20C,B01,083762,Bach; Quang Tran,1,0,30,29
1657793390870,MATH 20D,A01,083765,Tran; Brian Kha,5,0,30,25
1657793390870,MATH 20D,A02,083766,Tran; Brian Kha,5,0,30,25
1657793390870,MATH 20D,A03,083767,Tran; Brian Kha,5,0,30,25
1657793396898,MATH 20E,A01,083771,Ganguly; Soumya,10,0,32,22
1657793396898,MATH 20E,A02,083772,Ganguly; Soumya,6,0,32,26
1657793396898,MATH 20E,B01,083773,Ciotti; Benjamin,20,0,35,15
1657793396898,MATH 20E,B02,083774,Ciotti; Benjamin,18,0,35,17
1657793402922,MATH 103A,A01,083777,Greenfeld; Be'Eri,3,0,36,33
1657793402922,MATH 103A,A02,083778,Greenfeld; Be'Eri,5,0,36,31
1657793402922,MATH 103A,A03,093561,Greenfeld; Be'Eri,6,0,36,30
1657793402922,MATH 103A,B01,083779,Greenfeld; Be'Eri,7,0,36,29
1657793402922,MATH 103A,B02,083780,Greenfeld; Be'Eri,4,0,36,32
1657793402922,MATH 103A,B03,093562,Greenfeld; Be'Eri,3,0,36,33
1657793408950,MATH 105,A01,085443,Carter; Anne Toulson,15,0,35,20
1657793408950,MATH 105,A02,093477,Carter; Anne Toulson,20,0,35,15
1657793414973,MATH 109,A01,083213,Ganzberger; Geoffrey Michael,3,0,34,31
1657793414973,MATH 109,A02,083214,Ganzberger; Geoffrey Michael,4,0,34,30
1657793414973,MATH 109,A03,093478,Ganzberger; Geoffrey Michael,2,0,34,32
1657793414973,MATH 109,B01,083215,Ganzberger; Geoffrey Michael,1,0,32,31
1657793414973,MATH 109,B02,083216,Ganzberger; Geoffrey Michael,2,0,32,30
1657793414973,MATH 109,B03,093479,Ganzberger; Geoffrey Michael,8,0,32,24
1657793421003,MATH 142A,A01,083219,Chow; Bennett,7,0,32,25
1657793421003,MATH 142A,A02,083220,Chow; Bennett,10,0,32,22
1657793421003,MATH 142A,A03,093480,Chow; Bennett,9,0,32,23
1657793421003,MATH 142A,B03,093481,Chow; Bennett,8,0,32,24
1657793421003,MATH 142A,B04,093558,Chow; Bennett,13,0,32,19
1657793421003,MATH 142A,B05,093559,Chow; Bennett,6,0,32,26
1657793427032,MATH 193A,A01,083224,Rotar; Vladimir,8,0,34,26
1657793427032,MATH 193A,A02,083225,Rotar; Vladimir,9,0,34,25
1657793427032,MATH 193A,A03,083781,Rotar; Vladimir,5,0,34,29
1657793427032,MATH 193A,A04,083782,Rotar; Vladimir,10,0,34,24
1657793427032,MATH 193A,A05,093482,Rotar; Vladimir,10,0,34,24
1657793433058,MATH 197,001,091859,McAuley; Julian John,9999,0,9999,0
1657793433058,MATH 197,002,095566,Kedlaya; Kiran S.,9997,0,9999,2
1657793433058,MATH 197,003,095567,Xiao; Ming,9999,0,9999,0
1657793433058,MATH 197,004,095571,Perols; Johan Lars,9998,0,9999,1
1657793440122,COGS 9,A01,083615,Shannon; Kyle Michael,9,0,75,66
1657793446147,COGS 11,A01,083617,Boyle; Mary E. T.,23,0,48,25
1657793452173,COGS 13,A01,083071,Bastos; Amalia Pinkusfeld,11,0,71,60
1657793458200,COGS 14A,A01,092681,Semenuks; Arturs,5,1,100,95
1657793464224,COGS 14B,A01,083073,Cheng; Tzu-Han,6,0,63,57
1657793470251,COGS 17,A01,092677,Semenuks; Arturs,6,0,81,75
1657793476284,COGS 100,A01,083619,Allen; Michael Gordon,17,0,70,53
1657793482309,COGS 101A,A01,083621,Davis; Joshua Daniel,9,0,68,59
1657793488335,COGS 101B,A01,091572,Allen; Michael Gordon,12,0,65,53
1657793494359,COGS 101C,A01,083625,Delgado; Tania,17,0,35,18
1657793500381,COGS 107A,A01,083627,Boyle; Mary E. T.,14,0,60,46
1657793506404,COGS 118A,A01,083075,Gupta; Anjum,21,0,76,55
1657793512446,CSE 3,A50,083646,Miranda; Gregory Joseph,24,0,50,26
1657793518468,CSE 8A,A50,083650,Miranda; Gregory Joseph,17,1,56,39
1657793524492,CSE 11,A01,083080,Cao; Yingjun,6,15,40,34
1657793530516,CSE 12,A01,083652,Krause-Levy; Sophia Louisa,28,1,120,92
1657793536539,CSE 15L,A01,083654,Morris; Justin Loren,9,0,50,41
1657793536539,CSE 15L,A02,083655,Morris; Justin Loren,9,0,50,41
1657793542563,CSE 20,A01,083657,Tran; Khoa Dang,39,0,80,41
1657793548591,CSE 21,A01,095574,Bach; Quang Tran,22,0,48,26
1657793554615,CSE 30,A01,083084,Eldon; John,6,0,80,74
1657793554615,CSE 30,B01,095061,Bhaskar; Nishant,9,0,50,41
1657793560640,CSE 100,A01,083659,Cao; Yingjun,5,4,70,65
1657793566666,CSE 134B,A01,083661,Powell; Thomas Allan,24,0,100,76
1657793572688,CSE 140,A01,083663,Gungor; Onat,15,0,85,70
1657793578712,CSE 140L,A01,083088,Eldon; John,23,0,100,77
1657793584735,CSE 175,A01,083665,Kumar; Rakesh,3,0,25,22
1657793590758,CSE 190,A00,092507,Dubnov; Shlomo,8,0,20,12
1657793596781,ECE 45,A01,083139,Congero; Spencer William,6,0,75,69
1657793602802,ECE 65,A50,083695,Saad; Andrew S,12,0,30,18
1657793602802,ECE 65,A51,095125,Saad; Andrew S,24,0,26,2
1657793608831,ECE 109,A01,091882,Touri; Behrouz,20,0,70,50
1657793614856,ECE 180,A00,083140,Abi Samra; Nicholas Camill,1,0,30,29
1657793614856,ECE 180,B00,083141,Abi Samra; Nicholas Camill,0,0,30,30
1657793620892,MATH 10A,A01,083735,Patchell; Gregory David,2,0,30,28
1657793620892,MATH 10A,A02,083736,Patchell; Gregory David,20,0,30,10
1657793620892,MATH 10A,A03,083737,Patchell; Gregory David,16,0,30,14
1657793626924,MATH 10B,A01,083207,Lim; Seonhee,8,0,34,26
1657793626924,MATH 10B,A02,083208,Lim; Seonhee,10,0,35,25
1657793626924,MATH 10B,A03,093472,Lim; Seonhee,7,0,34,27
1657793626924,MATH 10B,B01,083739,Sinha; Shubham,13,0,30,17
1657793632955,MATH 18,A01,083743,Cinel; Cameron Alexander,9,0,30,21
1657793632955,MATH 18,A02,083744,Cinel; Cameron Alexander,18,0,30,12
1657793632955,MATH 18,A03,083745,Cinel; Cameron Alexander,10,0,30,20
1657793632955,MATH 18,B01,083748,Rideout; David Porter,5,0,37,32
1657793632955,MATH 18,B02,083749,Rideout; David Porter,5,0,36,31
1657793632955,MATH 18,B03,083750,Rideout; David Porter,3,0,37,34
1657793632955,MATH 18,B04,083751,Rideout; David Porter,6,0,36,30
1657793632955,MATH 18,B05,093473,Rideout; David Porter,6,0,36,30
1657793632955,MATH 18,B06,093474,Rideout; David Porter,6,0,36,30
1657793638976,MATH 20A,A01,083754,Zheng; Zequn,14,0,40,26
1657793645003,MATH 20B,A01,083756,Briones; Jor-el Thomas Caparas,4,0,36,32
1657793645003,MATH 20B,A02,083757,Briones; Jor-el Thomas Caparas,1,0,36,35
1657793645003,MATH 20B,A03,093475,Briones; Jor-el Thomas Caparas,2,0,36,34
1657793651031,MATH 20C,A01,083760,Briones; Jor-el Thomas Caparas,1,0,35,34
1657793651031,MATH 20C,A02,083761,Briones; Jor-el Thomas Caparas,8,0,35,27
1657793651031,MATH 20C,A03,093476,Briones; Jor-el Thomas Caparas,0,1,36,36
1657793651031,MATH 20C,B01,083762,Bach; Quang Tran,1,0,30,29
1657793657056,MATH 20D,A01,083765,Tran; Brian Kha,5,0,30,25
1657793657056,MATH 20D,A02,083766,Tran; Brian Kha,5,0,30,25
1657793657056,MATH 20D,A03,083767,Tran; Brian Kha,5,0,30,25
1657793663084,MATH 20E,A01,083771,Ganguly; Soumya,10,0,32,22
1657793663084,MATH 20E,A02,083772,Ganguly; Soumya,6,0,32,26
1657793663084,MATH 20E,B01,083773,Ciotti; Benjamin,20,0,35,15
1657793663084,MATH 20E,B02,083774,Ciotti; Benjamin,18,0,35,17
1657793669114,MATH 103A,A01,083777,Greenfeld; Be'Eri,3,0,36,33
1657793669114,MATH 103A,A02,083778,Greenfeld; Be'Eri,5,0,36,31
1657793669114,MATH 103A,A03,093561,Greenfeld; Be'Eri,6,0,36,30
1657793669114,MATH 103A,B01,083779,Greenfeld; Be'Eri,7,0,36,29
1657793669114,MATH 103A,B02,083780,Greenfeld; Be'Eri,4,0,36,32
1657793669114,MATH 103A,B03,093562,Greenfeld; Be'Eri,3,0,36,33
1657793675137,MATH 105,A01,085443,Carter; Anne Toulson,15,0,35,20
1657793675137,MATH 105,A02,093477,Carter; Anne Toulson,20,0,35,15
1657793681165,MATH 109,A01,083213,Ganzberger; Geoffrey Michael,3,0,34,31
1657793681165,MATH 109,A02,083214,Ganzberger; Geoffrey Michael,4,0,34,30
1657793681165,MATH 109,A03,093478,Ganzberger; Geoffrey Michael,2,0,34,32
1657793681165,MATH 109,B01,083215,Ganzberger; Geoffrey Michael,1,0,32,31
1657793681165,MATH 109,B02,083216,Ganzberger; Geoffrey Michael,2,0,32,30
1657793681165,MATH 109,B03,093479,Ganzberger; Geoffrey Michael,8,0,32,24
1657793687189,MATH 142A,A01,083219,Chow; Bennett,7,0,32,25
1657793687189,MATH 142A,A02,083220,Chow; Bennett,10,0,32,22
1657793687189,MATH 142A,A03,093480,Chow; Bennett,9,0,32,23
1657793687189,MATH 142A,B03,093481,Chow; Bennett,8,0,32,24
1657793687189,MATH 142A,B04,093558,Chow; Bennett,13,0,32,19
1657793687189,MATH 142A,B05,093559,Chow; Bennett,6,0,32,26
1657793693213,MATH 193A,A01,083224,Rotar; Vladimir,8,0,34,26
1657793693213,MATH 193A,A02,083225,Rotar; Vladimir,9,0,34,25
1657793693213,MATH 193A,A03,083781,Rotar; Vladimir,5,0,34,29
1657793693213,MATH 193A,A04,083782,Rotar; Vladimir,10,0,34,24
1657793693213,MATH 193A,A05,093482,Rotar; Vladimir,10,0,34,24
1657793699238,MATH 197,001,091859,McAuley; Julian John,9999,0,9999,0
1657793699238,MATH 197,002,095566,Kedlaya; Kiran S.,9997,0,9999,2
1657793699238,MATH 197,003,095567,Xiao; Ming,9999,0,9999,0
1657793699238,MATH 197,004,095571,Perols; Johan Lars,9998,0,9999,1
1657793706289,COGS 9,A01,083615,Shannon; Kyle Michael,9,0,75,66
1657793712334,COGS 11,A01,083617,Boyle; Mary E. T.,23,0,48,25
1657793718361,COGS 13,A01,083071,Bastos; Amalia Pinkusfeld,11,0,71,60
1657793724384,COGS 14A,A01,092681,Semenuks; Arturs,5,1,100,95
1657793730412,COGS 14B,A01,083073,Cheng; Tzu-Han,6,0,63,57
1657793736435,COGS 17,A01,092677,Semenuks; Arturs,6,0,81,75
1657793742461,COGS 100,A01,083619,Allen; Michael Gordon,17,0,70,53
1657793748484,COGS 101A,A01,083621,Davis; Joshua Daniel,9,0,68,59
1657793754508,COGS 101B,A01,091572,Allen; Michael Gordon,12,0,65,53
1657793760530,COGS 101C,A01,083625,Delgado; Tania,17,0,35,18
1657793766566,COGS 107A,A01,083627,Boyle; Mary E. T.,14,0,60,46
1657793772590,COGS 118A,A01,083075,Gupta; Anjum,21,0,76,55
1657793778613,CSE 3,A50,083646,Miranda; Gregory Joseph,24,0,50,26
1657793784635,CSE 8A,A50,083650,Miranda; Gregory Joseph,17,1,56,39
1657793790659,CSE 11,A01,083080,Cao; Yingjun,6,15,40,34
1657793796685,CSE 12,A01,083652,Krause-Levy; Sophia Louisa,28,1,120,92
1657793802709,CSE 15L,A01,083654,Morris; Justin Loren,9,0,50,41
1657793802709,CSE 15L,A02,083655,Morris; Justin Loren,9,0,50,41
1657793808736,CSE 20,A01,083657,Tran; Khoa Dang,39,0,80,41
1657793814771,CSE 21,A01,095574,Bach; Quang Tran,22,0,48,26
1657793820798,CSE 30,A01,083084,Eldon; John,6,0,80,74
1657793820798,CSE 30,B01,095061,Bhaskar; Nishant,9,0,50,41
1657793826823,CSE 100,A01,083659,Cao; Yingjun,5,4,70,65
1657793832850,CSE 134B,A01,083661,Powell; Thomas Allan,24,0,100,76
1657793838876,CSE 140,A01,083663,Gungor; Onat,15,0,85,70
1657793844902,CSE 140L,A01,083088,Eldon; John,23,0,100,77
1657793850928,CSE 175,A01,083665,Kumar; Rakesh,3,0,25,22
1657793856954,CSE 190,A00,092507,Dubnov; Shlomo,8,0,20,12
1657793862978,ECE 45,A01,083139,Congero; Spencer William,6,0,75,69
1657793869004,ECE 65,A50,083695,Saad; Andrew S,12,0,30,18
1657793869004,ECE 65,A51,095125,Saad; Andrew S,24,0,26,2
1657793875028,ECE 109,A01,091882,Touri; Behrouz,20,0,70,50
1657793881053,ECE 180,A00,083140,Abi Samra; Nicholas Camill,1,0,30,29
1657793881053,ECE 180,B00,083141,Abi Samra; Nicholas Camill,0,0,30,30
1657793887077,MATH 10A,A01,083735,Patchell; Gregory David,2,0,30,28
1657793887077,MATH 10A,A02,083736,Patchell; Gregory David,20,0,30,10
1657793887077,MATH 10A,A03,083737,Patchell; Gregory David,16,0,30,14
1657793893105,MATH 10B,A01,083207,Lim; Seonhee,8,0,34,26
1657793893105,MATH 10B,A02,083208,Lim; Seonhee,10,0,35,25
1657793893105,MATH 10B,A03,093472,Lim; Seonhee,7,0,34,27
1657793893105,MATH 10B,B01,083739,Sinha; Shubham,13,0,30,17
1657793899128,MATH 18,A01,083743,Cinel; Cameron Alexander,9,0,30,21
1657793899128,MATH 18,A02,083744,Cinel; Cameron Alexander,18,0,30,12
1657793899128,MATH 18,A03,083745,Cinel; Cameron Alexander,10,0,30,20
1657793899128,MATH 18,B01,083748,Rideout; David Porter,5,0,37,32
1657793899128,MATH 18,B02,083749,Rideout; David Porter,5,0,36,31
1657793899128,MATH 18,B03,083750,Rideout; David Porter,3,0,37,34
1657793899128,MATH 18,B04,083751,Rideout; David Porter,6,0,36,30
1657793899128,MATH 18,B05,093473,Rideout; David Porter,6,0,36,30
1657793899128,MATH 18,B06,093474,Rideout; David Porter,6,0,36,30
1657793905150,MATH 20A,A01,083754,Zheng; Zequn,14,0,40,26
1657793911172,MATH 20B,A01,083756,Briones; Jor-el Thomas Caparas,4,0,36,32
1657793911172,MATH 20B,A02,083757,Briones; Jor-el Thomas Caparas,1,0,36,35
1657793911172,MATH 20B,A03,093475,Briones; Jor-el Thomas Caparas,2,0,36,34
1657793917194,MATH 20C,A01,083760,Briones; Jor-el Thomas Caparas,1,0,35,34
1657793917194,MATH 20C,A02,083761,Briones; Jor-el Thomas Caparas,8,0,35,27
1657793917194,MATH 20C,A03,093476,Briones; Jor-el Thomas Caparas,0,1,36,36
1657793917194,MATH 20C,B01,083762,Bach; Quang Tran,1,0,30,29
1657793923222,MATH 20D,A01,083765,Tran; Brian Kha,5,0,30,25
1657793923222,MATH 20D,A02,083766,Tran; Brian Kha,5,0,30,25
1657793923222,MATH 20D,A03,083767,Tran; Brian Kha,5,0,30,25
1657793929246,MATH 20E,A01,083771,Ganguly; Soumya,10,0,32,22
1657793929246,MATH 20E,A02,083772,Ganguly; Soumya,6,0,32,26
1657793929246,MATH 20E,B01,083773,Ciotti; Benjamin,20,0,35,15
1657793929246,MATH 20E,B02,083774,Ciotti; Benjamin,18,0,35,17
1657793935270,MATH 103A,A01,083777,Greenfeld; Be'Eri,3,0,36,33
1657793935270,MATH 103A,A02,083778,Greenfeld; Be'Eri,5,0,36,31
1657793935270,MATH 103A,A03,093561,Greenfeld; Be'Eri,6,0,36,30
1657793935270,MATH 103A,B01,083779,Greenfeld; Be'Eri,7,0,36,29
1657793935270,MATH 103A,B02,083780,Greenfeld; Be'Eri,4,0,36,32
1657793935270,MATH 103A,B03,093562,Greenfeld; Be'Eri,3,0,36,33
1657793941293,MATH 105,A01,085443,Carter; Anne Toulson,15,0,35,20
1657793941293,MATH 105,A02,093477,Carter; Anne Toulson,20,0,35,15
1657793947414,MATH 109,A01,083213,Ganzberger; Geoffrey Michael,3,0,34,31
1657793947414,MATH 109,A02,083214,Ganzberger; Geoffrey Michael,4,0,34,30
1657793947414,MATH 109,A03,093478,Ganzberger; Geoffrey Michael,2,0,34,32
1657793947414,MATH 109,B01,083215,Ganzberger; Geoffrey Michael,1,0,32,31
1657793947414,MATH 109,B02,083216,Ganzberger; Geoffrey Michael,2,0,32,30
1657793947414,MATH 109,B03,093479,Ganzberger; Geoffrey Michael,8,0,32,24
1657793953438,MATH 142A,A01,083219,Chow; Bennett,7,0,32,25
1657793953438,MATH 142A,A02,083220,Chow; Bennett,10,0,32,22
1657793953438,MATH 142A,A03,093480,Chow; Bennett,9,0,32,23
1657793953438,MATH 142A,B03,093481,Chow; Bennett,8,0,32,24
1657793953438,MATH 142A,B04,093558,Chow; Bennett,13,0,32,19
1657793953438,MATH 142A,B05,093559,Chow; Bennett,6,0,32,26
1657793959462,MATH 193A,A01,083224,Rotar; Vladimir,8,0,34,26
1657793959462,MATH 193A,A02,083225,Rotar; Vladimir,9,0,34,25
1657793959462,MATH 193A,A03,083781,Rotar; Vladimir,5,0,34,29
1657793959462,MATH 193A,A04,083782,Rotar; Vladimir,10,0,34,24
1657793959462,MATH 193A,A05,093482,Rotar; Vladimir,10,0,34,24
1657793965489,MATH 197,001,091859,McAuley; Julian John,9999,0,9999,0
1657793965489,MATH 197,002,095566,Kedlaya; Kiran S.,9997,0,9999,2
1657793965489,MATH 197,003,095567,Xiao; Ming,9999,0,9999,0
1657793965489,MATH 197,004,095571,Perols; Johan Lars,9998,0,9999,1
1657793972553,COGS 9,A01,083615,Shannon; Kyle Michael,9,0,75,66
1657793978577,COGS 11,A01,083617,Boyle; Mary E. T.,23,0,48,25
1657793984599,COGS 13,A01,083071,Bastos; Amalia Pinkusfeld,11,0,71,60
1657793990628,COGS 14A,A01,092681,Semenuks; Arturs,5,1,100,95
1657793996654,COGS 14B,A01,083073,Cheng; Tzu-Han,6,0,63,57
1657794002680,COGS 17,A01,092677,Semenuks; Arturs,6,0,81,75
1657794008705,COGS 100,A01,083619,Allen; Michael Gordon,17,0,70,53
1657794014730,COGS 101A,A01,083621,Davis; Joshua Daniel,9,0,68,59
1657794020754,COGS 101B,A01,091572,Allen; Michael Gordon,12,0,65,53
1657794026782,COGS 101C,A01,083625,Delgado; Tania,17,0,35,18
1657794032810,COGS 107A,A01,083627,Boyle; Mary E. T.,14,0,60,46
1657794038834,COGS 118A,A01,083075,Gupta; Anjum,21,0,76,55
1657794044861,CSE 3,A50,083646,Miranda; Gregory Joseph,24,0,50,26
1657794050885,CSE 8A,A50,083650,Miranda; Gregory Joseph,17,1,56,39
1657794056908,CSE 11,A01,083080,Cao; Yingjun,6,15,40,34
1657794062936,CSE 12,A01,083652,Krause-Levy; Sophia Louisa,28,1,120,92
1657794068967,CSE 15L,A01,083654,Morris; Justin Loren,9,0,50,41
1657794068967,CSE 15L,A02,083655,Morris; Justin Loren,9,0,50,41
1657794074995,CSE 20,A01,083657,Tran; Khoa Dang,39,0,80,41
1657794081021,CSE 21,A01,095574,Bach; Quang Tran,22,0,48,26
1657794087046,CSE 30,A01,083084,Eldon; John,6,0,80,74
1657794087046,CSE 30,B01,095061,Bhaskar; Nishant,9,0,50,41
1657794093069,CSE 100,A01,083659,Cao; Yingjun,5,4,70,65
1657794099091,CSE 134B,A01,083661,Powell; Thomas Allan,24,0,100,76
1657794105117,CSE 140,A01,083663,Gungor; Onat,15,0,85,70
1657794111143,CSE 140L,A01,083088,Eldon; John,23,0,100,77
1657794117169,CSE 175,A01,083665,Kumar; Rakesh,3,0,25,22
1657794123195,CSE 190,A00,092507,Dubnov; Shlomo,8,0,20,12
1657794129218,ECE 45,A01,083139,Congero; Spencer William,6,0,75,69
1657794135241,ECE 65,A50,083695,Saad; Andrew S,12,0,30,18
1657794135241,ECE 65,A51,095125,Saad; Andrew S,24,0,26,2
1657794141263,ECE 109,A01,091882,Touri; Behrouz,20,0,70,50
1657794147291,ECE 180,A00,083140,Abi Samra; Nicholas Camill,1,0,30,29
1657794147291,ECE 180,B00,083141,Abi Samra; Nicholas Camill,0,0,30,30
1657794153322,MATH 10A,A01,083735,Patchell; Gregory David,2,0,30,28
1657794153322,MATH 10A,A02,083736,Patchell; Gregory David,20,0,30,10
1657794153322,MATH 10A,A03,083737,Patchell; Gregory David,16,0,30,14
1657794159345,MATH 10B,A01,083207,Lim; Seonhee,8,0,34,26
1657794159345,MATH 10B,A02,083208,Lim; Seonhee,10,0,35,25
1657794159345,MATH 10B,A03,093472,Lim; Seonhee,7,0,34,27
1657794159345,MATH 10B,B01,083739,Sinha; Shubham,13,0,30,17
1657794165371,MATH 18,A01,083743,Cinel; Cameron Alexander,9,0,30,21
1657794165371,MATH 18,A02,083744,Cinel; Cameron Alexander,18,0,30,12
1657794165371,MATH 18,A03,083745,Cinel; Cameron Alexander,10,0,30,20
1657794165371,MATH 18,B01,083748,Rideout; David Porter,5,0,37,32
1657794165371,MATH 18,B02,083749,Rideout; David Porter,5,0,36,31
1657794165371,MATH 18,B03,083750,Rideout; David Porter,3,0,37,34
1657794165371,MATH 18,B04,083751,Rideout; David Porter,6,0,36,30
1657794165371,MATH 18,B05,093473,Rideout; David Porter,6,0,36,30
1657794165371,MATH 18,B06,093474,Rideout; David Porter,6,0,36,30
1657794171395,MATH 20A,A01,083754,Zheng; Zequn,14,0,40,26
1657794177424,MATH 20B,A01,083756,Briones; Jor-el Thomas Caparas,4,0,36,32
1657794177424,MATH 20B,A02,083757,Briones; Jor-el Thomas Caparas,1,0,36,35
1657794177424,MATH 20B,A03,093475,Briones; Jor-el Thomas Caparas,2,0,36,34
1657794183449,MATH 20C,A01,083760,Briones; Jor-el Thomas Caparas,1,0,35,34
1657794183449,MATH 20C,A02,083761,Briones; Jor-el Thomas Caparas,8,0,35,27
1657794183449,MATH 20C,A03,093476,Briones; Jor-el Thomas Caparas,0,1,36,36
1657794183449,MATH 20C,B01,083762,Bach; Quang Tran,1,0,30,29
1657794189485,MATH 20D,A01,083765,Tran; Brian Kha,5,0,30,25
1657794189485,MATH 20D,A02,083766,Tran; Brian Kha,5,0,30,25
1657794189485,MATH 20D,A03,083767,Tran; Brian Kha,5,0,30,25
1657794195509,MATH 20E,A01,083771,Ganguly; Soumya,10,0,32,22
1657794195509,MATH 20E,A02,083772,Ganguly; Soumya,6,0,32,26
1657794195509,MATH 20E,B01,083773,Ciotti; Benjamin,20,0,35,15
1657794195509,MATH 20E,B02,083774,Ciotti; Benjamin,18,0,35,17
1657794201533,MATH 103A,A01,083777,Greenfeld; Be'Eri,3,0,36,33
1657794201533,MATH 103A,A02,083778,Greenfeld; Be'Eri,5,0,36,31
1657794201533,MATH 103A,A03,093561,Greenfeld; Be'Eri,6,0,36,30
1657794201533,MATH 103A,B01,083779,Greenfeld; Be'Eri,7,0,36,29
1657794201533,MATH 103A,B02,083780,Greenfeld; Be'Eri,4,0,36,32
1657794201533,MATH 103A,B03,093562,Greenfeld; Be'Eri,3,0,36,33
1657794207557,MATH 105,A01,085443,Carter; Anne Toulson,15,0,35,20
1657794207557,MATH 105,A02,093477,Carter; Anne Toulson,20,0,35,15
1657794213581,MATH 109,A01,083213,Ganzberger; Geoffrey Michael,3,0,34,31
1657794213581,MATH 109,A02,083214,Ganzberger; Geoffrey Michael,4,0,34,30
1657794213581,MATH 109,A03,093478,Ganzberger; Geoffrey Michael,2,0,34,32
1657794213581,MATH 109,B01,083215,Ganzberger; Geoffrey Michael,1,0,32,31
1657794213581,MATH 109,B02,083216,Ganzberger; Geoffrey Michael,2,0,32,30
1657794213581,MATH 109,B03,093479,Ganzberger; Geoffrey Michael,8,0,32,24
1657794219610,MATH 142A,A01,083219,Chow; Bennett,7,0,32,25
1657794219610,MATH 142A,A02,083220,Chow; Bennett,10,0,32,22
1657794219610,MATH 142A,A03,093480,Chow; Bennett,9,0,32,23
1657794219610,MATH 142A,B03,093481,Chow; Bennett,8,0,32,24
1657794219610,MATH 142A,B04,093558,Chow; Bennett,13,0,32,19
1657794219610,MATH 142A,B05,093559,Chow; Bennett,6,0,32,26
1657794225638,MATH 193A,A01,083224,Rotar; Vladimir,8,0,34,26
1657794225638,MATH 193A,A02,083225,Rotar; Vladimir,9,0,34,25
1657794225638,MATH 193A,A03,083781,Rotar; Vladimir,5,0,34,29
1657794225638,MATH 193A,A04,083782,Rotar; Vladimir,10,0,34,24
1657794225638,MATH 193A,A05,093482,Rotar; Vladimir,10,0,34,24
1657794231667,MATH 197,001,091859,McAuley; Julian John,9999,0,9999,0
1657794231667,MATH 197,002,095566,Kedlaya; Kiran S.,9997,0,9999,2
1657794231667,MATH 197,003,095567,Xiao; Ming,9999,0,9999,0
1657794231667,MATH 197,004,095571,Perols; Johan Lars,9998,0,9999,1
1657794238718,COGS 9,A01,083615,Shannon; Kyle Michael,9,0,75,66
1657794244740,COGS 11,A01,083617,Boyle; Mary E. T.,23,0,48,25
1657794250762,COGS 13,A01,083071,Bastos; Amalia Pinkusfeld,11,0,71,60
1657794256788,COGS 14A,A01,092681,Semenuks; Arturs,5,1,100,95
1657794262815,COGS 14B,A01,083073,Cheng; Tzu-Han,6,0,63,57
1657794268838,COGS 17,A01,092677,Semenuks; Arturs,6,0,81,75
1657794274866,COGS 100,A01,083619,Allen; Michael Gordon,17,0,70,53
1657794280889,COGS 101A,A01,083621,Davis; Joshua Daniel,9,0,68,59
1657794286913,COGS 101B,A01,091572,Allen; Michael Gordon,12,0,65,53
1657794292935,COGS 101C,A01,083625,Delgado; Tania,17,0,35,18
1657794298957,COGS 107A,A01,083627,Boyle; Mary E. T.,14,0,60,46
1657794304985,COGS 118A,A01,083075,Gupta; Anjum,21,0,76,55
1657794311008,CSE 3,A50,083646,Miranda; Gregory Joseph,24,0,50,26
1657794317030,CSE 8A,A50,083650,Miranda; Gregory Joseph,17,1,56,39
1657794323053,CSE 11,A01,083080,Cao; Yingjun,6,15,40,34
1657794329082,CSE 12,A01,083652,Krause-Levy; Sophia Louisa,28,1,120,92
1657794335105,CSE 15L,A01,083654,Morris; Justin Loren,9,0,50,41
1657794335105,CSE 15L,A02,083655,Morris; Justin Loren,9,0,50,41
1657794341128,CSE 20,A01,083657,Tran; Khoa Dang,39,0,80,41
1657794347181,CSE 21,A01,095574,Bach; Quang Tran,22,0,48,26
1657794353204,CSE 30,A01,083084,Eldon; John,6,0,80,74
1657794353204,CSE 30,B01,095061,Bhaskar; Nishant,9,0,50,41
1657794359230,CSE 100,A01,083659,Cao; Yingjun,5,4,70,65
1657794365254,CSE 134B,A01,083661,Powell; Thomas Allan,24,0,100,76
1657794371281,CSE 140,A01,083663,Gungor; Onat,15,0,85,70
1657794377313,CSE 140L,A01,083088,Eldon; John,23,0,100,77
1657794383337,CSE 175,A01,083665,Kumar; Rakesh,3,0,25,22
1657794389366,CSE 190,A00,092507,Dubnov; Shlomo,8,0,20,12
1657794395407,ECE 45,A01,083139,Congero; Spencer William,6,0,75,69
1657794401431,ECE 65,A50,083695,Saad; Andrew S,12,0,30,18
1657794401431,ECE 65,A51,095125,Saad; Andrew S,24,0,26,2
1657794407456,ECE 109,A01,091882,Touri; Behrouz,20,0,70,50
1657794413484,ECE 180,A00,083140,Abi Samra; Nicholas Camill,1,0,30,29
1657794413484,ECE 180,B00,083141,Abi Samra; Nicholas Camill,0,0,30,30
1657794419507,MATH 10A,A01,083735,Patchell; Gregory David,2,0,30,28
1657794419507,MATH 10A,A02,083736,Patchell; Gregory David,20,0,30,10
1657794419507,MATH 10A,A03,083737,Patchell; Gregory David,16,0,30,14
1657794425532,MATH 10B,A01,083207,Lim; Seonhee,8,0,34,26
1657794425532,MATH 10B,A02,083208,Lim; Seonhee,10,0,35,25
1657794425532,MATH 10B,A03,093472,Lim; Seonhee,7,0,34,27
1657794425532,MATH 10B,B01,083739,Sinha; Shubham,13,0,30,17
1657794431564,MATH 18,A01,083743,Cinel; Cameron Alexander,9,0,30,21
1657794431564,MATH 18,A02,083744,Cinel; Cameron Alexander,18,0,30,12
1657794431564,MATH 18,A03,083745,Cinel; Cameron Alexander,10,0,30,20
1657794431564,MATH 18,B01,083748,Rideout; David Porter,5,0,37,32
1657794431564,MATH 18,B02,083749,Rideout; David Porter,5,0,36,31
1657794431564,MATH 18,B03,083750,Rideout; David Porter,3,0,37,34
1657794431564,MATH 18,B04,083751,Rideout; David Porter,6,0,36,30
1657794431564,MATH 18,B05,093473,Rideout; David Porter,6,0,36,30
1657794431564,MATH 18,B06,093474,Rideout; David Porter,6,0,36,30
1657794437590,MATH 20A,A01,083754,Zheng; Zequn,14,0,40,26
1657794443618,MATH 20B,A01,083756,Briones; Jor-el Thomas Caparas,4,0,36,32
1657794443618,MATH 20B,A02,083757,Briones; Jor-el Thomas Caparas,1,0,36,35
1657794443618,MATH 20B,A03,093475,Briones; Jor-el Thomas Caparas,2,0,36,34
1657794449641,MATH 20C,A01,083760,Briones; Jor-el Thomas Caparas,1,0,35,34
1657794449641,MATH 20C,A02,083761,Briones; Jor-el Thomas Caparas,8,0,35,27
1657794449641,MATH 20C,A03,093476,Briones; Jor-el Thomas Caparas,0,1,36,36
1657794449641,MATH 20C,B01,083762,Bach; Quang Tran,1,0,30,29
1657794455668,MATH 20D,A01,083765,Tran; Brian Kha,5,0,30,25
1657794455668,MATH 20D,A02,083766,Tran; Brian Kha,5,0,30,25
1657794455668,MATH 20D,A03,083767,Tran; Brian Kha,5,0,30,25
1657794461697,MATH 20E,A01,083771,Ganguly; Soumya,10,0,32,22
1657794461697,MATH 20E,A02,083772,Ganguly; Soumya,6,0,32,26
1657794461697,MATH 20E,B01,083773,Ciotti; Benjamin,20,0,35,15
1657794461697,MATH 20E,B02,083774,Ciotti; Benjamin,18,0,35,17
1657794467721,MATH 103A,A01,083777,Greenfeld; Be'Eri,3,0,36,33
1657794467721,MATH 103A,A02,083778,Greenfeld; Be'Eri,5,0,36,31
1657794467721,MATH 103A,A03,093561,Greenfeld; Be'Eri,6,0,36,30
1657794467721,MATH 103A,B01,083779,Greenfeld; Be'Eri,7,0,36,29
1657794467721,MATH 103A,B02,083780,Greenfeld; Be'Eri,4,0,36,32
1657794467721,MATH 103A,B03,093562,Greenfeld; Be'Eri,3,0,36,33
1657794473748,MATH 105,A01,085443,Carter; Anne Toulson,15,0,35,20
1657794473748,MATH 105,A02,093477,Carter; Anne Toulson,20,0,35,15
1657794479772,MATH 109,A01,083213,Ganzberger; Geoffrey Michael,3,0,34,31
1657794479772,MATH 109,A02,083214,Ganzberger; Geoffrey Michael,4,0,34,30
1657794479772,MATH 109,A03,093478,Ganzberger; Geoffrey Michael,2,0,34,32
1657794479772,MATH 109,B01,083215,Ganzberger; Geoffrey Michael,1,0,32,31
1657794479772,MATH 109,B02,083216,Ganzberger; Geoffrey Michael,2,0,32,30
1657794479772,MATH 109,B03,093479,Ganzberger; Geoffrey Michael,8,0,32,24
1657794485799,MATH 142A,A01,083219,Chow; Bennett,7,0,32,25
1657794485799,MATH 142A,A02,083220,Chow; Bennett,10,0,32,22
1657794485799,MATH 142A,A03,093480,Chow; Bennett,9,0,32,23
1657794485799,MATH 142A,B03,093481,Chow; Bennett,8,0,32,24
1657794485799,MATH 142A,B04,093558,Chow; Bennett,13,0,32,19
1657794485799,MATH 142A,B05,093559,Chow; Bennett,6,0,32,26
1657794491822,MATH 193A,A01,083224,Rotar; Vladimir,8,0,34,26
1657794491822,MATH 193A,A02,083225,Rotar; Vladimir,9,0,34,25
1657794491822,MATH 193A,A03,083781,Rotar; Vladimir,5,0,34,29
1657794491822,MATH 193A,A04,083782,Rotar; Vladimir,10,0,34,24
1657794491822,MATH 193A,A05,093482,Rotar; Vladimir,10,0,34,24
1657794497845,MATH 197,001,091859,McAuley; Julian John,9999,0,9999,0
1657794497845,MATH 197,002,095566,Kedlaya; Kiran S.,9997,0,9999,2
1657794497845,MATH 197,003,095567,Xiao; Ming,9999,0,9999,0
1657794497845,MATH 197,004,095571,Perols; Johan Lars,9998,0,9999,1
1657794504909,COGS 9,A01,083615,Shannon; Kyle Michael,9,0,75,66
1657794510934,COGS 11,A01,083617,Boyle; Mary E. T.,23,0,48,25
1657794516959,COGS 13,A01,083071,Bastos; Amalia Pinkusfeld,11,0,71,60
1657794522982,COGS 14A,A01,092681,Semenuks; Arturs,5,1,100,95
1657794529003,COGS 14B,A01,083073,Cheng; Tzu-Han,6,0,63,57
1657794535027,COGS 17,A01,092677,Semenuks; Arturs,6,0,81,75
1657794541137,COGS 100,A01,083619,Allen; Michael Gordon,17,0,70,53
1657794547159,COGS 101A,A01,083621,Davis; Joshua Daniel,9,0,68,59
1657794553186,COGS 101B,A01,091572,Allen; Michael Gordon,12,0,65,53
1657794559207,COGS 101C,A01,083625,Delgado; Tania,17,0,35,18
1657794565230,COGS 107A,A01,083627,Boyle; Mary E. T.,14,0,60,46
1657794571255,COGS 118A,A01,083075,Gupta; Anjum,21,0,76,55
1657794577278,CSE 3,A50,083646,Miranda; Gregory Joseph,24,0,50,26
1657794583301,CSE 8A,A50,083650,Miranda; Gregory Joseph,17,1,56,39
1657794589325,CSE 11,A01,083080,Cao; Yingjun,6,15,40,34
1657794595348,CSE 12,A01,083652,Krause-Levy; Sophia Louisa,28,1,120,92
1657794601373,CSE 15L,A01,083654,Morris; Justin Loren,9,0,50,41
1657794601373,CSE 15L,A02,083655,Morris; Justin Loren,9,0,50,41
1657794607401,CSE 20,A01,083657,Tran; Khoa Dang,39,0,80,41
1657794613423,CSE 21,A01,095574,Bach; Quang Tran,22,0,48,26
1657794619445,CSE 30,A01,083084,Eldon; John,6,0,80,74
1657794619445,CSE 30,B01,095061,Bhaskar; Nishant,9,0,50,41
1657794625470,CSE 100,A01,083659,Cao; Yingjun,5,4,70,65
1657794631498,CSE 134B,A01,083661,Powell; Thomas Allan,24,0,100,76
1657794637520,CSE 140,A01,083663,Gungor; Onat,15,0,85,70
1657794643546,CSE 140L,A01,083088,Eldon; John,23,0,100,77
1657794649571,CSE 175,A01,083665,Kumar; Rakesh,3,0,25,22
1657794655595,CSE 190,A00,092507,Dubnov; Shlomo,8,0,20,12
1657794661617,ECE 45,A01,083139,Congero; Spencer William,6,0,75,69
1657794667638,ECE 65,A50,083695,Saad; Andrew S,12,0,30,18
1657794667638,ECE 65,A51,095125,Saad; Andrew S,24,0,26,2
1657794673659,ECE 109,A01,091882,Touri; Behrouz,20,0,70,50
1657794679694,ECE 180,A00,083140,Abi Samra; Nicholas Camill,1,0,30,29
1657794679694,ECE 180,B00,083141,Abi Samra; Nicholas Camill,0,0,30,30
1657794685721,MATH 10A,A01,083735,Patchell; Gregory David,2,0,30,28
1657794685721,MATH 10A,A02,083736,Patchell; Gregory David,20,0,30,10
1657794685721,MATH 10A,A03,083737,Patchell; Gregory David,16,0,30,14
1657794691744,MATH 10B,A01,083207,Lim; Seonhee,8,0,34,26
1657794691744,MATH 10B,A02,083208,Lim; Seonhee,10,0,35,25
1657794691744,MATH 10B,A03,093472,Lim; Seonhee,7,0,34,27
1657794691744,MATH 10B,B01,083739,Sinha; Shubham,13,0,30,17
1657794697766,MATH 18,A01,083743,Cinel; Cameron Alexander,9,0,30,21
1657794697766,MATH 18,A02,083744,Cinel; Cameron Alexander,18,0,30,12
1657794697766,MATH 18,A03,083745,Cinel; Cameron Alexander,10,0,30,20
1657794697766,MATH 18,B01,083748,Rideout; David Porter,5,0,37,32
1657794697766,MATH 18,B02,083749,Rideout; David Porter,5,0,36,31
1657794697766,MATH 18,B03,083750,Rideout; David Porter,3,0,37,34
1657794697766,MATH 18,B04,083751,Rideout; David Porter,6,0,36,30
1657794697766,MATH 18,B05,093473,Rideout; David Porter,6,0,36,30
1657794697766,MATH 18,B06,093474,Rideout; David Porter,6,0,36,30
1657794703789,MATH 20A,A01,083754,Zheng; Zequn,14,0,40,26
1657794709811,MATH 20B,A01,083756,Briones; Jor-el Thomas Caparas,4,0,36,32
1657794709811,MATH 20B,A02,083757,Briones; Jor-el Thomas Caparas,1,0,36,35
1657794709811,MATH 20B,A03,093475,Briones; Jor-el Thomas Caparas,2,0,36,34
1657794715835,MATH 20C,A01,083760,Briones; Jor-el Thomas Caparas,1,0,35,34
1657794715835,MATH 20C,A02,083761,Briones; Jor-el Thomas Caparas,8,0,35,27
1657794715835,MATH 20C,A03,093476,Briones; Jor-el Thomas Caparas,0,1,36,36
1657794715835,MATH 20C,B01,083762,Bach; Quang Tran,1,0,30,29
1657794721862,MATH 20D,A01,083765,Tran; Brian Kha,5,0,30,25
1657794721862,MATH 20D,A02,083766,Tran; Brian Kha,5,0,30,25
1657794721862,MATH 20D,A03,083767,Tran; Brian Kha,5,0,30,25
1657794727890,MATH 20E,A01,083771,Ganguly; Soumya,10,0,32,22
1657794727890,MATH 20E,A02,083772,Ganguly; Soumya,6,0,32,26
1657794727890,MATH 20E,B01,083773,Ciotti; Benjamin,20,0,35,15
1657794727890,MATH 20E,B02,083774,Ciotti; Benjamin,18,0,35,17
1657794733919,MATH 103A,A01,083777,Greenfeld; Be'Eri,3,0,36,33
1657794733919,MATH 103A,A02,083778,Greenfeld; Be'Eri,5,0,36,31
1657794733919,MATH 103A,A03,093561,Greenfeld; Be'Eri,6,0,36,30
1657794733919,MATH 103A,B01,083779,Greenfeld; Be'Eri,7,0,36,29
1657794733919,MATH 103A,B02,083780,Greenfeld; Be'Eri,4,0,36,32
1657794733919,MATH 103A,B03,093562,Greenfeld; Be'Eri,3,0,36,33
1657794739942,MATH 105,A01,085443,Carter; Anne Toulson,15,0,35,20
1657794739942,MATH 105,A02,093477,Carter; Anne Toulson,20,0,35,15
1657794745965,MATH 109,A01,083213,Ganzberger; Geoffrey Michael,3,0,34,31
1657794745965,MATH 109,A02,083214,Ganzberger; Geoffrey Michael,4,0,34,30
1657794745965,MATH 109,A03,093478,Ganzberger; Geoffrey Michael,2,0,34,32
1657794745965,MATH 109,B01,083215,Ganzberger; Geoffrey Michael,1,0,32,31
1657794745965,MATH 109,B02,083216,Ganzberger; Geoffrey Michael,2,0,32,30
1657794745965,MATH 109,B03,093479,Ganzberger; Geoffrey Michael,8,0,32,24
1657794751994,MATH 142A,A01,083219,Chow; Bennett,7,0,32,25
1657794751994,MATH 142A,A02,083220,Chow; Bennett,10,0,32,22
1657794751994,MATH 142A,A03,093480,Chow; Bennett,9,0,32,23
1657794751994,MATH 142A,B03,093481,Chow; Bennett,8,0,32,24
1657794751994,MATH 142A,B04,093558,Chow; Bennett,13,0,32,19
1657794751994,MATH 142A,B05,093559,Chow; Bennett,6,0,32,26
1657794758019,MATH 193A,A01,083224,Rotar; Vladimir,8,0,34,26
1657794758019,MATH 193A,A02,083225,Rotar; Vladimir,9,0,34,25
1657794758019,MATH 193A,A03,083781,Rotar; Vladimir,5,0,34,29
1657794758019,MATH 193A,A04,083782,Rotar; Vladimir,10,0,34,24
1657794758019,MATH 193A,A05,093482,Rotar; Vladimir,10,0,34,24
1657794764043,MATH 197,001,091859,McAuley; Julian John,9999,0,9999,0
1657794764043,MATH 197,002,095566,Kedlaya; Kiran S.,9997,0,9999,2
1657794764043,MATH 197,003,095567,Xiao; Ming,9999,0,9999,0
1657794764043,MATH 197,004,095571,Perols; Johan Lars,9998,0,9999,1
1657794771108,COGS 9,A01,083615,Shannon; Kyle Michael,9,0,75,66
1657794777130,COGS 11,A01,083617,Boyle; Mary E. T.,23,0,48,25
1657794783155,COGS 13,A01,083071,Bastos; Amalia Pinkusfeld,11,0,71,60
1657794789183,COGS 14A,A01,092681,Semenuks; Arturs,5,1,100,95
1657794795209,COGS 14B,A01,083073,Cheng; Tzu-Han,6,0,63,57
1657794801234,COGS 17,A01,092677,Semenuks; Arturs,6,0,81,75
1657794807255,COGS 100,A01,083619,Allen; Michael Gordon,17,0,70,53
1657794813278,COGS 101A,A01,083621,Davis; Joshua Daniel,9,0,68,59
1657794819303,COGS 101B,A01,091572,Allen; Michael Gordon,12,0,65,53
1657794825327,COGS 101C,A01,083625,Delgado; Tania,17,0,35,18
1657794831352,COGS 107A,A01,083627,Boyle; Mary E. T.,14,0,60,46
1657794837375,COGS 118A,A01,083075,Gupta; Anjum,21,0,76,55
1657794843400,CSE 3,A50,083646,Miranda; Gregory Joseph,24,0,50,26
1657794849427,CSE 8A,A50,083650,Miranda; Gregory Joseph,17,1,56,39
1657794855449,CSE 11,A01,083080,Cao; Yingjun,6,15,40,34
1657794861472,CSE 12,A01,083652,Krause-Levy; Sophia Louisa,28,1,120,92
1657794867496,CSE 15L,A01,083654,Morris; Justin Loren,9,0,50,41
1657794867496,CSE 15L,A02,083655,Morris; Justin Loren,9,0,50,41
1657794873519,CSE 20,A01,083657,Tran; Khoa Dang,39,0,80,41
1657794879546,CSE 21,A01,095574,Bach; Quang Tran,22,0,48,26
1657794885573,CSE 30,A01,083084,Eldon; John,6,0,80,74
1657794885573,CSE 30,B01,095061,Bhaskar; Nishant,9,0,50,41
1657794891596,CSE 100,A01,083659,Cao; Yingjun,5,4,70,65
1657794897623,CSE 134B,A01,083661,Powell; Thomas Allan,24,0,100,76
1657794903651,CSE 140,A01,083663,Gungor; Onat,15,0,85,70
1657794909673,CSE 140L,A01,083088,Eldon; John,23,0,100,77
1657794915694,CSE 175,A01,083665,Kumar; Rakesh,3,0,25,22
1657794921716,CSE 190,A00,092507,Dubnov; Shlomo,8,0,20,12
1657794927739,ECE 45,A01,083139,Congero; Spencer William,6,0,75,69
1657794933761,ECE 65,A50,083695,Saad; Andrew S,12,0,30,18
1657794933761,ECE 65,A51,095125,Saad; Andrew S,24,0,26,2
1657794939783,ECE 109,A01,091882,Touri; Behrouz,20,0,70,50
1657794945809,ECE 180,A00,083140,Abi Samra; Nicholas Camill,1,0,30,29
1657794945809,ECE 180,B00,083141,Abi Samra; Nicholas Camill,0,0,30,30
1657794951831,MATH 10A,A01,083735,Patchell; Gregory David,2,0,30,28
1657794951831,MATH 10A,A02,083736,Patchell; Gregory David,20,0,30,10
1657794951831,MATH 10A,A03,083737,Patchell; Gregory David,16,0,30,14
1657794957870,MATH 10B,A01,083207,Lim; Seonhee,8,0,34,26
1657794957870,MATH 10B,A02,083208,Lim; Seonhee,10,0,35,25
1657794957870,MATH 10B,A03,093472,Lim; Seonhee,7,0,34,27
1657794957870,MATH 10B,B01,083739,Sinha; Shubham,13,0,30,17
1657794963906,MATH 18,A01,083743,Cinel; Cameron Alexander,9,0,30,21
1657794963906,MATH 18,A02,083744,Cinel; Cameron Alexander,18,0,30,12
1657794963906,MATH 18,A03,083745,Cinel; Cameron Alexander,10,0,30,20
1657794963906,MATH 18,B01,083748,Rideout; David Porter,5,0,37,32
1657794963906,MATH 18,B02,083749,Rideout; David Porter,5,0,36,31
1657794963906,MATH 18,B03,083750,Rideout; David Porter,3,0,37,34
1657794963906,MATH 18,B04,083751,Rideout; David Porter,6,0,36,30
1657794963906,MATH 18,B05,093473,Rideout; David Porter,6,0,36,30
1657794963906,MATH 18,B06,093474,Rideout; David Porter,6,0,36,30
1657794969930,MATH 20A,A01,083754,Zheng; Zequn,14,0,40,26
1657794975961,MATH 20B,A01,083756,Briones; Jor-el Thomas Caparas,4,0,36,32
1657794975961,MATH 20B,A02,083757,Briones; Jor-el Thomas Caparas,1,0,36,35
1657794975961,MATH 20B,A03,093475,Briones; Jor-el Thomas Caparas,2,0,36,34
1657794982002,MATH 20C,A01,083760,Briones; Jor-el Thomas Caparas,1,0,35,34
1657794982002,MATH 20C,A02,083761,Briones; Jor-el Thomas Caparas,8,0,35,27
1657794982002,MATH 20C,A03,093476,Briones; Jor-el Thomas Caparas,0,1,36,36
1657794982002,MATH 20C,B01,083762,Bach; Quang Tran,1,0,30,29
1657794988026,MATH 20D,A01,083765,Tran; Brian Kha,5,0,30,25
1657794988026,MATH 20D,A02,083766,Tran; Brian Kha,5,0,30,25
1657794988026,MATH 20D,A03,083767,Tran; Brian Kha,5,0,30,25
1657794994057,MATH 20E,A01,083771,Ganguly; Soumya,10,0,32,22
1657794994057,MATH 20E,A02,083772,Ganguly; Soumya,6,0,32,26
1657794994057,MATH 20E,B01,083773,Ciotti; Benjamin,20,0,35,15
1657794994057,MATH 20E,B02,083774,Ciotti; Benjamin,18,0,35,17
1657795000084,MATH 103A,A01,083777,Greenfeld; Be'Eri,3,0,36,33
1657795000084,MATH 103A,A02,083778,Greenfeld; Be'Eri,5,0,36,31
1657795000084,MATH 103A,A03,093561,Greenfeld; Be'Eri,6,0,36,30
1657795000084,MATH 103A,B01,083779,Greenfeld; Be'Eri,7,0,36,29
1657795000084,MATH 103A,B02,083780,Greenfeld; Be'Eri,4,0,36,32
1657795000084,MATH 103A,B03,093562,Greenfeld; Be'Eri,3,0,36,33
1657795006114,MATH 105,A01,085443,Carter; Anne Toulson,15,0,35,20
1657795006114,MATH 105,A02,093477,Carter; Anne Toulson,20,0,35,15
1657795012139,MATH 109,A01,083213,Ganzberger; Geoffrey Michael,3,0,34,31
1657795012139,MATH 109,A02,083214,Ganzberger; Geoffrey Michael,4,0,34,30
1657795012139,MATH 109,A03,093478,Ganzberger; Geoffrey Michael,2,0,34,32
1657795012139,MATH 109,B01,083215,Ganzberger; Geoffrey Michael,1,0,32,31
1657795012139,MATH 109,B02,083216,Ganzberger; Geoffrey Michael,2,0,32,30
1657795012139,MATH 109,B03,093479,Ganzberger; Geoffrey Michael,8,0,32,24
1657795018163,MATH 142A,A01,083219,Chow; Bennett,7,0,32,25
1657795018163,MATH 142A,A02,083220,Chow; Bennett,10,0,32,22
1657795018163,MATH 142A,A03,093480,Chow; Bennett,9,0,32,23
1657795018163,MATH 142A,B03,093481,Chow; Bennett,8,0,32,24
1657795018163,MATH 142A,B04,093558,Chow; Bennett,13,0,32,19
1657795018163,MATH 142A,B05,093559,Chow; Bennett,6,0,32,26
1657795024193,MATH 193A,A01,083224,Rotar; Vladimir,8,0,34,26
1657795024193,MATH 193A,A02,083225,Rotar; Vladimir,9,0,34,25
1657795024193,MATH 193A,A03,083781,Rotar; Vladimir,5,0,34,29
1657795024193,MATH 193A,A04,083782,Rotar; Vladimir,10,0,34,24
1657795024193,MATH 193A,A05,093482,Rotar; Vladimir,10,0,34,24
1657795030217,MATH 197,001,091859,McAuley; Julian John,9999,0,9999,0
1657795030217,MATH 197,002,095566,Kedlaya; Kiran S.,9997,0,9999,2
1657795030217,MATH 197,003,095567,Xiao; Ming,9999,0,9999,0
1657795030217,MATH 197,004,095571,Perols; Johan Lars,9998,0,9999,1
1657795037275,COGS 9,A01,083615,Shannon; Kyle Michael,9,0,75,66
1657795043299,COGS 11,A01,083617,Boyle; Mary E. T.,23,0,48,25
1657795049322,COGS 13,A01,083071,Bastos; Amalia Pinkusfeld,11,0,71,60
1657795055347,COGS 14A,A01,092681,Semenuks; Arturs,5,1,100,95
1657795061371,COGS 14B,A01,083073,Cheng; Tzu-Han,6,0,63,57
1657795067398,COGS 17,A01,092677,Semenuks; Arturs,6,0,81,75
1657795073430,COGS 100,A01,083619,Allen; Michael Gordon,17,0,70,53
1657795079455,COGS 101A,A01,083621,Davis; Joshua Daniel,9,0,68,59
1657795085484,COGS 101B,A01,091572,Allen; Michael Gordon,12,0,65,53
1657795091513,COGS 101C,A01,083625,Delgado; Tania,17,0,35,18
1657795097539,COGS 107A,A01,083627,Boyle; Mary E. T.,14,0,60,46
1657795103563,COGS 118A,A01,083075,Gupta; Anjum,21,0,76,55
1657795109593,CSE 3,A50,083646,Miranda; Gregory Joseph,24,0,50,26
1657795115615,CSE 8A,A50,083650,Miranda; Gregory Joseph,17,1,56,39
1657795121640,CSE 11,A01,083080,Cao; Yingjun,6,15,40,34
1657795127669,CSE 12,A01,083652,Krause-Levy; Sophia Louisa,28,1,120,92
1657795133696,CSE 15L,A01,083654,Morris; Justin Loren,9,0,50,41
1657795133696,CSE 15L,A02,083655,Morris; Justin Loren,9,0,50,41
1657795139813,CSE 20,A01,083657,Tran; Khoa Dang,39,0,80,41
1657795145839,CSE 21,A01,095574,Bach; Quang Tran,22,0,48,26
1657795151866,CSE 30,A01,083084,Eldon; John,6,0,80,74
1657795151866,CSE 30,B01,095061,Bhaskar; Nishant,9,0,50,41
1657795157895,CSE 100,A01,083659,Cao; Yingjun,5,4,70,65
1657795163920,CSE 134B,A01,083661,Powell; Thomas Allan,24,0,100,76
1657795169943,CSE 140,A01,083663,Gungor; Onat,15,0,85,70
1657795175968,CSE 140L,A01,083088,Eldon; John,23,0,100,77
1657795181991,CSE 175,A01,083665,Kumar; Rakesh,3,0,25,22
1657795188021,CSE 190,A00,092507,Dubnov; Shlomo,8,0,20,12
1657795194052,ECE 45,A01,083139,Congero; Spencer William,6,0,75,69
1657795200084,ECE 65,A50,083695,Saad; Andrew S,12,0,30,18
1657795200084,ECE 65,A51,095125,Saad; Andrew S,24,0,26,2
1657795206114,ECE 109,A01,091882,Touri; Behrouz,20,0,70,50
1657795212139,ECE 180,A00,083140,Abi Samra; Nicholas Camill,1,0,30,29
1657795212139,ECE 180,B00,083141,Abi Samra; Nicholas Camill,0,0,30,30
1657795218174,MATH 10A,A01,083735,Patchell; Gregory David,2,0,30,28
1657795218174,MATH 10A,A02,083736,Patchell; Gregory David,20,0,30,10
1657795218174,MATH 10A,A03,083737,Patchell; Gregory David,16,0,30,14
1657795224200,MATH 10B,A01,083207,Lim; Seonhee,8,0,34,26
1657795224200,MATH 10B,A02,083208,Lim; Seonhee,10,0,35,25
1657795224200,MATH 10B,A03,093472,Lim; Seonhee,7,0,34,27
1657795224200,MATH 10B,B01,083739,Sinha; Shubham,13,0,30,17
1657795230236,MATH 18,A01,083743,Cinel; Cameron Alexander,9,0,30,21
1657795230236,MATH 18,A02,083744,Cinel; Cameron Alexander,18,0,30,12
1657795230236,MATH 18,A03,083745,Cinel; Cameron Alexander,10,0,30,20
1657795230236,MATH 18,B01,083748,Rideout; David Porter,5,0,37,32
1657795230236,MATH 18,B02,083749,Rideout; David Porter,5,0,36,31
1657795230236,MATH 18,B03,083750,Rideout; David Porter,3,0,37,34
1657795230236,MATH 18,B04,083751,Rideout; David Porter,6,0,36,30
1657795230236,MATH 18,B05,093473,Rideout; David Porter,6,0,36,30
1657795230236,MATH 18,B06,093474,Rideout; David Porter,6,0,36,30
1657795236261,MATH 20A,A01,083754,Zheng; Zequn,14,0,40,26
1657795242285,MATH 20B,A01,083756,Briones; Jor-el Thomas Caparas,4,0,36,32
1657795242285,MATH 20B,A02,083757,Briones; Jor-el Thomas Caparas,1,0,36,35
1657795242285,MATH 20B,A03,093475,Briones; Jor-el Thomas Caparas,2,0,36,34
1657795248309,MATH 20C,A01,083760,Briones; Jor-el Thomas Caparas,1,0,35,34
1657795248309,MATH 20C,A02,083761,Briones; Jor-el Thomas Caparas,8,0,35,27
1657795248309,MATH 20C,A03,093476,Briones; Jor-el Thomas Caparas,0,1,36,36
1657795248309,MATH 20C,B01,083762,Bach; Quang Tran,1,0,30,29
1657795254340,MATH 20D,A01,083765,Tran; Brian Kha,5,0,30,25
1657795254340,MATH 20D,A02,083766,Tran; Brian Kha,5,0,30,25
1657795254340,MATH 20D,A03,083767,Tran; Brian Kha,5,0,30,25
1657795260367,MATH 20E,A01,083771,Ganguly; Soumya,10,0,32,22
1657795260367,MATH 20E,A02,083772,Ganguly; Soumya,6,0,32,26
1657795260367,MATH 20E,B01,083773,Ciotti; Benjamin,20,0,35,15
1657795260367,MATH 20E,B02,083774,Ciotti; Benjamin,18,0,35,17
1657795266400,MATH 103A,A01,083777,Greenfeld; Be'Eri,3,0,36,33
1657795266400,MATH 103A,A02,083778,Greenfeld; Be'Eri,5,0,36,31
1657795266400,MATH 103A,A03,093561,Greenfeld; Be'Eri,6,0,36,30
1657795266400,MATH 103A,B01,083779,Greenfeld; Be'Eri,7,0,36,29
1657795266400,MATH 103A,B02,083780,Greenfeld; Be'Eri,4,0,36,32
1657795266400,MATH 103A,B03,093562,Greenfeld; Be'Eri,3,0,36,33
1657795272424,MATH 105,A01,085443,Carter; Anne Toulson,15,0,35,20
1657795272424,MATH 105,A02,093477,Carter; Anne Toulson,20,0,35,15
1657795278456,MATH 109,A01,083213,Ganzberger; Geoffrey Michael,3,0,34,31
1657795278456,MATH 109,A02,083214,Ganzberger; Geoffrey Michael,4,0,34,30
1657795278456,MATH 109,A03,093478,Ganzberger; Geoffrey Michael,2,0,34,32
1657795278456,MATH 109,B01,083215,Ganzberger; Geoffrey Michael,1,0,32,31
1657795278456,MATH 109,B02,083216,Ganzberger; Geoffrey Michael,2,0,32,30
1657795278456,MATH 109,B03,093479,Ganzberger; Geoffrey Michael,8,0,32,24
1657795284487,MATH 142A,A01,083219,Chow; Bennett,7,0,32,25
1657795284487,MATH 142A,A02,083220,Chow; Bennett,10,0,32,22
1657795284487,MATH 142A,A03,093480,Chow; Bennett,9,0,32,23
1657795284487,MATH 142A,B03,093481,Chow; Bennett,8,0,32,24
1657795284487,MATH 142A,B04,093558,Chow; Bennett,13,0,32,19
1657795284487,MATH 142A,B05,093559,Chow; Bennett,6,0,32,26
1657795290521,MATH 193A,A01,083224,Rotar; Vladimir,8,0,34,26
1657795290521,MATH 193A,A02,083225,Rotar; Vladimir,9,0,34,25
1657795290521,MATH 193A,A03,083781,Rotar; Vladimir,5,0,34,29
1657795290521,MATH 193A,A04,083782,Rotar; Vladimir,10,0,34,24
1657795290521,MATH 193A,A05,093482,Rotar; Vladimir,10,0,34,24
1657795296546,MATH 197,001,091859,McAuley; Julian John,9999,0,9999,0
1657795296546,MATH 197,002,095566,Kedlaya; Kiran S.,9997,0,9999,2
1657795296546,MATH 197,003,095567,Xiao; Ming,9999,0,9999,0
1657795296546,MATH 197,004,095571,Perols; Johan Lars,9998,0,9999,1
1657795303644,COGS 9,A01,083615,Shannon; Kyle Michael,9,0,75,66
1657795309674,COGS 11,A01,083617,Boyle; Mary E. T.,23,0,48,25
1657795315699,COGS 13,A01,083071,Bastos; Amalia Pinkusfeld,11,0,71,60
1657795321734,COGS 14A,A01,092681,Semenuks; Arturs,5,1,100,95
1657795327757,COGS 14B,A01,083073,Cheng; Tzu-Han,6,0,63,57
1657795333779,COGS 17,A01,092677,Semenuks; Arturs,6,0,81,75
1657795339804,COGS 100,A01,083619,Allen; Michael Gordon,17,0,70,53
1657795345828,COGS 101A,A01,083621,Davis; Joshua Daniel,9,0,68,59
1657795351856,COGS 101B,A01,091572,Allen; Michael Gordon,12,0,65,53
1657795357879,COGS 101C,A01,083625,Delgado; Tania,17,0,35,18
1657795363904,COGS 107A,A01,083627,Boyle; Mary E. T.,14,0,60,46
1657795369926,COGS 118A,A01,083075,Gupta; Anjum,21,0,76,55
1657795375951,CSE 3,A50,083646,Miranda; Gregory Joseph,24,0,50,26
1657795381980,CSE 8A,A50,083650,Miranda; Gregory Joseph,17,1,56,39
1657795388003,CSE 11,A01,083080,Cao; Yingjun,6,15,40,34
1657795394044,CSE 12,A01,083652,Krause-Levy; Sophia Louisa,28,1,120,92
1657795400072,CSE 15L,A01,083654,Morris; Justin Loren,9,0,50,41
1657795400072,CSE 15L,A02,083655,Morris; Justin Loren,9,0,50,41
1657795406095,CSE 20,A01,083657,Tran; Khoa Dang,39,0,80,41
1657795412121,CSE 21,A01,095574,Bach; Quang Tran,22,0,48,26
1657795418156,CSE 30,A01,083084,Eldon; John,6,0,80,74
1657795418156,CSE 30,B01,095061,Bhaskar; Nishant,9,0,50,41
1657795424181,CSE 100,A01,083659,Cao; Yingjun,5,4,70,65
1657795430210,CSE 134B,A01,083661,Powell; Thomas Allan,24,0,100,76
1657795436235,CSE 140,A01,083663,Gungor; Onat,15,0,85,70
1657795442257,CSE 140L,A01,083088,Eldon; John,23,0,100,77
1657795448284,CSE 175,A01,083665,Kumar; Rakesh,3,0,25,22
1657795454314,CSE 190,A00,092507,Dubnov; Shlomo,8,0,20,12
1657795460339,ECE 45,A01,083139,Congero; Spencer William,6,0,75,69
1657795466366,ECE 65,A50,083695,Saad; Andrew S,12,0,30,18
1657795466366,ECE 65,A51,095125,Saad; Andrew S,24,0,26,2
1657795472396,ECE 109,A01,091882,Touri; Behrouz,20,0,70,50
1657795478426,ECE 180,A00,083140,Abi Samra; Nicholas Camill,1,0,30,29
1657795478426,ECE 180,B00,083141,Abi Samra; Nicholas Camill,0,0,30,30
1657795484457,MATH 10A,A01,083735,Patchell; Gregory David,2,0,30,28
1657795484457,MATH 10A,A02,083736,Patchell; Gregory David,20,0,30,10
1657795484457,MATH 10A,A03,083737,Patchell; Gregory David,16,0,30,14
1657795490484,MATH 10B,A01,083207,Lim; Seonhee,8,0,34,26
1657795490484,MATH 10B,A02,083208,Lim; Seonhee,10,0,35,25
1657795490484,MATH 10B,A03,093472,Lim; Seonhee,7,0,34,27
1657795490484,MATH 10B,B01,083739,Sinha; Shubham,13,0,30,17
1657795496522,MATH 18,A01,083743,Cinel; Cameron Alexander,9,0,30,21
1657795496522,MATH 18,A02,083744,Cinel; Cameron Alexander,18,0,30,12
1657795496522,MATH 18,A03,083745,Cinel; Cameron Alexander,10,0,30,20
1657795496522,MATH 18,B01,083748,Rideout; David Porter,5,0,37,32
1657795496522,MATH 18,B02,083749,Rideout; David Porter,5,0,36,31
1657795496522,MATH 18,B03,083750,Rideout; David Porter,3,0,37,34
1657795496522,MATH 18,B04,083751,Rideout; David Porter,6,0,36,30
1657795496522,MATH 18,B05,093473,Rideout; David Porter,6,0,36,30
1657795496522,MATH 18,B06,093474,Rideout; David Porter,6,0,36,30
1657795502547,MATH 20A,A01,083754,Zheng; Zequn,14,0,40,26
1657795508571,MATH 20B,A01,083756,Briones; Jor-el Thomas Caparas,4,0,36,32
1657795508571,MATH 20B,A02,083757,Briones; Jor-el Thomas Caparas,1,0,36,35
1657795508571,MATH 20B,A03,093475,Briones; Jor-el Thomas Caparas,2,0,36,34
1657795514601,MATH 20C,A01,083760,Briones; Jor-el Thomas Caparas,1,0,35,34
1657795514601,MATH 20C,A02,083761,Briones; Jor-el Thomas Caparas,8,0,35,27
1657795514601,MATH 20C,A03,093476,Briones; Jor-el Thomas Caparas,0,1,36,36
1657795514601,MATH 20C,B01,083762,Bach; Quang Tran,1,0,30,29
1657795520625,MATH 20D,A01,083765,Tran; Brian Kha,5,0,30,25
1657795520625,MATH 20D,A02,083766,Tran; Brian Kha,5,0,30,25
1657795520625,MATH 20D,A03,083767,Tran; Brian Kha,5,0,30,25
1657795526658,MATH 20E,A01,083771,Ganguly; Soumya,10,0,32,22
1657795526658,MATH 20E,A02,083772,Ganguly; Soumya,6,0,32,26
1657795526658,MATH 20E,B01,083773,Ciotti; Benjamin,20,0,35,15
1657795526658,MATH 20E,B02,083774,Ciotti; Benjamin,18,0,35,17
1657795532686,MATH 103A,A01,083777,Greenfeld; Be'Eri,3,0,36,33
1657795532686,MATH 103A,A02,083778,Greenfeld; Be'Eri,5,0,36,31
1657795532686,MATH 103A,A03,093561,Greenfeld; Be'Eri,6,0,36,30
1657795532686,MATH 103A,B01,083779,Greenfeld; Be'Eri,7,0,36,29
1657795532686,MATH 103A,B02,083780,Greenfeld; Be'Eri,4,0,36,32
1657795532686,MATH 103A,B03,093562,Greenfeld; Be'Eri,3,0,36,33
1657795538711,MATH 105,A01,085443,Carter; Anne Toulson,15,0,35,20
1657795538711,MATH 105,A02,093477,Carter; Anne Toulson,20,0,35,15
1657795544737,MATH 109,A01,083213,Ganzberger; Geoffrey Michael,3,0,34,31
1657795544737,MATH 109,A02,083214,Ganzberger; Geoffrey Michael,4,0,34,30
1657795544737,MATH 109,A03,093478,Ganzberger; Geoffrey Michael,2,0,34,32
1657795544737,MATH 109,B01,083215,Ganzberger; Geoffrey Michael,1,0,32,31
1657795544737,MATH 109,B02,083216,Ganzberger; Geoffrey Michael,2,0,32,30
1657795544737,MATH 109,B03,093479,Ganzberger; Geoffrey Michael,8,0,32,24
1657795550767,MATH 142A,A01,083219,Chow; Bennett,7,0,32,25
1657795550767,MATH 142A,A02,083220,Chow; Bennett,10,0,32,22
1657795550767,MATH 142A,A03,093480,Chow; Bennett,9,0,32,23
1657795550767,MATH 142A,B03,093481,Chow; Bennett,8,0,32,24
1657795550767,MATH 142A,B04,093558,Chow; Bennett,13,0,32,19
1657795550767,MATH 142A,B05,093559,Chow; Bennett,6,0,32,26
1657795556810,MATH 193A,A01,083224,Rotar; Vladimir,8,0,34,26
1657795556810,MATH 193A,A02,083225,Rotar; Vladimir,9,0,34,25
1657795556810,MATH 193A,A03,083781,Rotar; Vladimir,5,0,34,29
1657795556810,MATH 193A,A04,083782,Rotar; Vladimir,10,0,34,24
1657795556810,MATH 193A,A05,093482,Rotar; Vladimir,10,0,34,24
1657795562835,MATH 197,001,091859,McAuley; Julian John,9999,0,9999,0
1657795562835,MATH 197,002,095566,Kedlaya; Kiran S.,9997,0,9999,2
1657795562835,MATH 197,003,095567,Xiao; Ming,9999,0,9999,0
1657795562835,MATH 197,004,095571,Perols; Johan Lars,9998,0,9999,1
1657795569908,COGS 9,A01,083615,Shannon; Kyle Michael,9,0,75,66
1657795575935,COGS 11,A01,083617,Boyle; Mary E. T.,23,0,48,25
1657795581962,COGS 13,A01,083071,Bastos; Amalia Pinkusfeld,11,0,71,60
1657795587985,COGS 14A,A01,092681,Semenuks; Arturs,5,1,100,95
1657795594011,COGS 14B,A01,083073,Cheng; Tzu-Han,6,0,63,57
1657795600034,COGS 17,A01,092677,Semenuks; Arturs,6,0,81,75
1657795606063,COGS 100,A01,083619,Allen; Michael Gordon,17,0,70,53
1657795612092,COGS 101A,A01,083621,Davis; Joshua Daniel,9,0,68,59
1657795618122,COGS 101B,A01,091572,Allen; Michael Gordon,12,0,65,53
1657795624150,COGS 101C,A01,083625,Delgado; Tania,17,0,35,18
1657795630178,COGS 107A,A01,083627,Boyle; Mary E. T.,14,0,60,46
1657795636201,COGS 118A,A01,083075,Gupta; Anjum,21,0,76,55
1657795642230,CSE 3,A50,083646,Miranda; Gregory Joseph,24,0,50,26
1657795648259,CSE 8A,A50,083650,Miranda; Gregory Joseph,17,1,56,39
1657795654283,CSE 11,A01,083080,Cao; Yingjun,6,15,40,34
1657795660307,CSE 12,A01,083652,Krause-Levy; Sophia Louisa,28,1,120,92
1657795666331,CSE 15L,A01,083654,Morris; Justin Loren,9,0,50,41
1657795666331,CSE 15L,A02,083655,Morris; Justin Loren,9,0,50,41
1657795672360,CSE 20,A01,083657,Tran; Khoa Dang,39,0,80,41
1657795678388,CSE 21,A01,095574,Bach; Quang Tran,22,0,48,26
1657795684411,CSE 30,A01,083084,Eldon; John,6,0,80,74
1657795684411,CSE 30,B01,095061,Bhaskar; Nishant,9,0,50,41
1657795690437,CSE 100,A01,083659,Cao; Yingjun,5,4,70,65
1657795696472,CSE 134B,A01,083661,Powell; Thomas Allan,24,0,100,76
1657795702494,CSE 140,A01,083663,Gungor; Onat,15,0,85,70
1657795708525,CSE 140L,A01,083088,Eldon; John,23,0,100,77
1657795714553,CSE 175,A01,083665,Kumar; Rakesh,3,0,25,22
1657795720581,CSE 190,A00,092507,Dubnov; Shlomo,8,0,20,12
1657795726612,ECE 45,A01,083139,Congero; Spencer William,6,0,75,69
1657795732655,ECE 65,A50,083695,Saad; Andrew S,12,0,30,18
1657795732655,ECE 65,A51,095125,Saad; Andrew S,24,0,26,2
1657795738753,ECE 109,A01,091882,Touri; Behrouz,20,0,70,50
1657795744782,ECE 180,A00,083140,Abi Samra; Nicholas Camill,1,0,30,29
1657795744782,ECE 180,B00,083141,Abi Samra; Nicholas Camill,0,0,30,30
1657795750806,MATH 10A,A01,083735,Patchell; Gregory David,2,0,30,28
1657795750806,MATH 10A,A02,083736,Patchell; Gregory David,20,0,30,10
1657795750806,MATH 10A,A03,083737,Patchell; Gregory David,16,0,30,14
1657795756833,MATH 10B,A01,083207,Lim; Seonhee,8,0,34,26
1657795756833,MATH 10B,A02,083208,Lim; Seonhee,10,0,35,25
1657795756833,MATH 10B,A03,093472,Lim; Seonhee,7,0,34,27
1657795756833,MATH 10B,B01,083739,Sinha; Shubham,13,0,30,17
1657795762861,MATH 18,A01,083743,Cinel; Cameron Alexander,9,0,30,21
1657795762861,MATH 18,A02,083744,Cinel; Cameron Alexander,18,0,30,12
1657795762861,MATH 18,A03,083745,Cinel; Cameron Alexander,10,0,30,20
1657795762861,MATH 18,B01,083748,Rideout; David Porter,5,0,37,32
1657795762861,MATH 18,B02,083749,Rideout; David Porter,5,0,36,31
1657795762861,MATH 18,B03,083750,Rideout; David Porter,3,0,37,34
1657795762861,MATH 18,B04,083751,Rideout; David Porter,6,0,36,30
1657795762861,MATH 18,B05,093473,Rideout; David Porter,6,0,36,30
1657795762861,MATH 18,B06,093474,Rideout; David Porter,6,0,36,30
1657795768887,MATH 20A,A01,083754,Zheng; Zequn,14,0,40,26
1657795774913,MATH 20B,A01,083756,Briones; Jor-el Thomas Caparas,4,0,36,32
1657795774913,MATH 20B,A02,083757,Briones; Jor-el Thomas Caparas,1,0,36,35
1657795774913,MATH 20B,A03,093475,Briones; Jor-el Thomas Caparas,2,0,36,34
1657795780936,MATH 20C,A01,083760,Briones; Jor-el Thomas Caparas,1,0,35,34
1657795780936,MATH 20C,A02,083761,Briones; Jor-el Thomas Caparas,8,0,35,27
1657795780936,MATH 20C,A03,093476,Briones; Jor-el Thomas Caparas,0,1,36,36
1657795780936,MATH 20C,B01,083762,Bach; Quang Tran,1,0,30,29
1657795786960,MATH 20D,A01,083765,Tran; Brian Kha,5,0,30,25
1657795786960,MATH 20D,A02,083766,Tran; Brian Kha,5,0,30,25
1657795786960,MATH 20D,A03,083767,Tran; Brian Kha,5,0,30,25
1657795792985,MATH 20E,A01,083771,Ganguly; Soumya,10,0,32,22
1657795792985,MATH 20E,A02,083772,Ganguly; Soumya,6,0,32,26
1657795792985,MATH 20E,B01,083773,Ciotti; Benjamin,20,0,35,15
1657795792985,MATH 20E,B02,083774,Ciotti; Benjamin,18,0,35,17
1657795799017,MATH 103A,A01,083777,Greenfeld; Be'Eri,3,0,36,33
1657795799017,MATH 103A,A02,083778,Greenfeld; Be'Eri,5,0,36,31
1657795799017,MATH 103A,A03,093561,Greenfeld; Be'Eri,6,0,36,30
1657795799017,MATH 103A,B01,083779,Greenfeld; Be'Eri,7,0,36,29
1657795799017,MATH 103A,B02,083780,Greenfeld; Be'Eri,4,0,36,32
1657795799017,MATH 103A,B03,093562,Greenfeld; Be'Eri,3,0,36,33
1657795805041,MATH 105,A01,085443,Carter; Anne Toulson,15,0,35,20
1657795805041,MATH 105,A02,093477,Carter; Anne Toulson,20,0,35,15
1657795811070,MATH 109,A01,083213,Ganzberger; Geoffrey Michael,3,0,34,31
1657795811070,MATH 109,A02,083214,Ganzberger; Geoffrey Michael,4,0,34,30
1657795811070,MATH 109,A03,093478,Ganzberger; Geoffrey Michael,2,0,34,32
1657795811070,MATH 109,B01,083215,Ganzberger; Geoffrey Michael,1,0,32,31
1657795811070,MATH 109,B02,083216,Ganzberger; Geoffrey Michael,2,0,32,30
1657795811070,MATH 109,B03,093479,Ganzberger; Geoffrey Michael,8,0,32,24
1657795817101,MATH 142A,A01,083219,Chow; Bennett,7,0,32,25
1657795817101,MATH 142A,A02,083220,Chow; Bennett,10,0,32,22
1657795817101,MATH 142A,A03,093480,Chow; Bennett,9,0,32,23
1657795817101,MATH 142A,B03,093481,Chow; Bennett,8,0,32,24
1657795817101,MATH 142A,B04,093558,Chow; Bennett,13,0,32,19
1657795817101,MATH 142A,B05,093559,Chow; Bennett,6,0,32,26
1657795823143,MATH 193A,A01,083224,Rotar; Vladimir,8,0,34,26
1657795823143,MATH 193A,A02,083225,Rotar; Vladimir,9,0,34,25
1657795823143,MATH 193A,A03,083781,Rotar; Vladimir,5,0,34,29
1657795823143,MATH 193A,A04,083782,Rotar; Vladimir,10,0,34,24
1657795823143,MATH 193A,A05,093482,Rotar; Vladimir,10,0,34,24
1657795829166,MATH 197,001,091859,McAuley; Julian John,9999,0,9999,0
1657795829166,MATH 197,002,095566,Kedlaya; Kiran S.,9997,0,9999,2
1657795829166,MATH 197,003,095567,Xiao; Ming,9999,0,9999,0
1657795829166,MATH 197,004,095571,Perols; Johan Lars,9998,0,9999,1
1657795836247,COGS 9,A01,083615,Shannon; Kyle Michael,9,0,75,66
1657795842275,COGS 11,A01,083617,Boyle; Mary E. T.,23,0,48,25
1657795848300,COGS 13,A01,083071,Bastos; Amalia Pinkusfeld,11,0,71,60
1657795854330,COGS 14A,A01,092681,Semenuks; Arturs,5,1,100,95
1657795860354,COGS 14B,A01,083073,Cheng; Tzu-Han,6,0,63,57
1657795866378,COGS 17,A01,092677,Semenuks; Arturs,6,0,81,75
1657795872408,COGS 100,A01,083619,Allen; Michael Gordon,17,0,70,53
1657795878433,COGS 101A,A01,083621,Davis; Joshua Daniel,9,0,68,59
1657795884468,COGS 101B,A01,091572,Allen; Michael Gordon,12,0,65,53
1657795890498,COGS 101C,A01,083625,Delgado; Tania,17,0,35,18
1657795896525,COGS 107A,A01,083627,Boyle; Mary E. T.,14,0,60,46
1657795902553,COGS 118A,A01,083075,Gupta; Anjum,21,0,76,55
1657795908585,CSE 3,A50,083646,Miranda; Gregory Joseph,24,0,50,26
1657795914612,CSE 8A,A50,083650,Miranda; Gregory Joseph,17,1,56,39
1657795920639,CSE 11,A01,083080,Cao; Yingjun,6,15,40,34
1657795926664,CSE 12,A01,083652,Krause-Levy; Sophia Louisa,28,1,120,92
1657795932693,CSE 15L,A01,083654,Morris; Justin Loren,9,0,50,41
1657795932693,CSE 15L,A02,083655,Morris; Justin Loren,9,0,50,41
1657795938718,CSE 20,A01,083657,Tran; Khoa Dang,39,0,80,41
1657795944741,CSE 21,A01,095574,Bach; Quang Tran,22,0,48,26
1657795950774,CSE 30,A01,083084,Eldon; John,6,0,80,74
1657795950774,CSE 30,B01,095061,Bhaskar; Nishant,9,0,50,41
1657795956807,CSE 100,A01,083659,Cao; Yingjun,5,4,70,65
1657795962836,CSE 134B,A01,083661,Powell; Thomas Allan,24,0,100,76
1657795968863,CSE 140,A01,083663,Gungor; Onat,15,0,85,70
1657795974887,CSE 140L,A01,083088,Eldon; John,23,0,100,77
1657795980918,CSE 175,A01,083665,Kumar; Rakesh,3,0,25,22
1657795986946,CSE 190,A00,092507,Dubnov; Shlomo,8,0,20,12
1657795992976,ECE 45,A01,083139,Congero; Spencer William,6,0,75,69
1657795999006,ECE 65,A50,083695,Saad; Andrew S,12,0,30,18
1657795999006,ECE 65,A51,095125,Saad; Andrew S,24,0,26,2
1657796005034,ECE 109,A01,091882,Touri; Behrouz,20,0,70,50
1657796011058,ECE 180,A00,083140,Abi Samra; Nicholas Camill,1,0,30,29
1657796011058,ECE 180,B00,083141,Abi Samra; Nicholas Camill,0,0,30,30
1657796017093,MATH 10A,A01,083735,Patchell; Gregory David,2,0,30,28
1657796017093,MATH 10A,A02,083736,Patchell; Gregory David,20,0,30,10
1657796017093,MATH 10A,A03,083737,Patchell; Gregory David,16,0,30,14
1657796023120,MATH 10B,A01,083207,Lim; Seonhee,8,0,34,26
1657796023120,MATH 10B,A02,083208,Lim; Seonhee,10,0,35,25
1657796023120,MATH 10B,A03,093472,Lim; Seonhee,7,0,34,27
1657796023120,MATH 10B,B01,083739,Sinha; Shubham,13,0,30,17
1657796029164,MATH 18,A01,083743,Cinel; Cameron Alexander,9,0,30,21
1657796029164,MATH 18,A02,083744,Cinel; Cameron Alexander,18,0,30,12
1657796029164,MATH 18,A03,083745,Cinel; Cameron Alexander,10,0,30,20
1657796029164,MATH 18,B01,083748,Rideout; David Porter,5,0,37,32
1657796029164,MATH 18,B02,083749,Rideout; David Porter,5,0,36,31
1657796029164,MATH 18,B03,083750,Rideout; David Porter,3,0,37,34
1657796029164,MATH 18,B04,083751,Rideout; David Porter,6,0,36,30
1657796029164,MATH 18,B05,093473,Rideout; David Porter,6,0,36,30
1657796029164,MATH 18,B06,093474,Rideout; David Porter,6,0,36,30
1657796035204,MATH 20A,A01,083754,Zheng; Zequn,14,0,40,26
1657796041237,MATH 20B,A01,083756,Briones; Jor-el Thomas Caparas,4,0,36,32
1657796041237,MATH 20B,A02,083757,Briones; Jor-el Thomas Caparas,1,0,36,35
1657796041237,MATH 20B,A03,093475,Briones; Jor-el Thomas Caparas,2,0,36,34
1657796047270,MATH 20C,A01,083760,Briones; Jor-el Thomas Caparas,1,0,35,34
1657796047270,MATH 20C,A02,083761,Briones; Jor-el Thomas Caparas,8,0,35,27
1657796047270,MATH 20C,A03,093476,Briones; Jor-el Thomas Caparas,0,1,36,36
1657796047270,MATH 20C,B01,083762,Bach; Quang Tran,1,0,30,29
1657796053296,MATH 20D,A01,083765,Tran; Brian Kha,5,0,30,25
1657796053296,MATH 20D,A02,083766,Tran; Brian Kha,5,0,30,25
1657796053296,MATH 20D,A03,083767,Tran; Brian Kha,5,0,30,25
1657796059330,MATH 20E,A01,083771,Ganguly; Soumya,10,0,32,22
1657796059330,MATH 20E,A02,083772,Ganguly; Soumya,6,0,32,26
1657796059330,MATH 20E,B01,083773,Ciotti; Benjamin,20,0,35,15
1657796059330,MATH 20E,B02,083774,Ciotti; Benjamin,18,0,35,17
1657796065357,MATH 103A,A01,083777,Greenfeld; Be'Eri,3,0,36,33
1657796065357,MATH 103A,A02,083778,Greenfeld; Be'Eri,5,0,36,31
1657796065357,MATH 103A,A03,093561,Greenfeld; Be'Eri,6,0,36,30
1657796065357,MATH 103A,B01,083779,Greenfeld; Be'Eri,7,0,36,29
1657796065357,MATH 103A,B02,083780,Greenfeld; Be'Eri,4,0,36,32
1657796065357,MATH 103A,B03,093562,Greenfeld; Be'Eri,3,0,36,33
1657796071381,MATH 105,A01,085443,Carter; Anne Toulson,15,0,35,20
1657796071381,MATH 105,A02,093477,Carter; Anne Toulson,20,0,35,15
1657796077414,MATH 109,A01,083213,Ganzberger; Geoffrey Michael,3,0,34,31
1657796077414,MATH 109,A02,083214,Ganzberger; Geoffrey Michael,4,0,34,30
1657796077414,MATH 109,A03,093478,Ganzberger; Geoffrey Michael,2,0,34,32
1657796077414,MATH 109,B01,083215,Ganzberger; Geoffrey Michael,1,0,32,31
1657796077414,MATH 109,B02,083216,Ganzberger; Geoffrey Michael,2,0,32,30
1657796077414,MATH 109,B03,093479,Ganzberger; Geoffrey Michael,8,0,32,24
1657796083449,MATH 142A,A01,083219,Chow; Bennett,7,0,32,25
1657796083449,MATH 142A,A02,083220,Chow; Bennett,10,0,32,22
1657796083449,MATH 142A,A03,093480,Chow; Bennett,9,0,32,23
1657796083449,MATH 142A,B03,093481,Chow; Bennett,8,0,32,24
1657796083449,MATH 142A,B04,093558,Chow; Bennett,13,0,32,19
1657796083449,MATH 142A,B05,093559,Chow; Bennett,6,0,32,26
1657796089480,MATH 193A,A01,083224,Rotar; Vladimir,8,0,34,26
1657796089480,MATH 193A,A02,083225,Rotar; Vladimir,9,0,34,25
1657796089480,MATH 193A,A03,083781,Rotar; Vladimir,5,0,34,29
1657796089480,MATH 193A,A04,083782,Rotar; Vladimir,10,0,34,24
1657796089480,MATH 193A,A05,093482,Rotar; Vladimir,10,0,34,24
1657796095505,MATH 197,001,091859,McAuley; Julian John,9999,0,9999,0
1657796095505,MATH 197,002,095566,Kedlaya; Kiran S.,9997,0,9999,2
1657796095505,MATH 197,003,095567,Xiao; Ming,9999,0,9999,0
1657796095505,MATH 197,004,095571,Perols; Johan Lars,9998,0,9999,1
1657796102562,COGS 9,A01,083615,Shannon; Kyle Michael,9,0,75,66
1657796108587,COGS 11,A01,083617,Boyle; Mary E. T.,23,0,48,25
1657796114618,COGS 13,A01,083071,Bastos; Amalia Pinkusfeld,11,0,71,60
1657796120642,COGS 14A,A01,092681,Semenuks; Arturs,5,1,100,95
1657796126672,COGS 14B,A01,083073,Cheng; Tzu-Han,6,0,63,57
1657796132699,COGS 17,A01,092677,Semenuks; Arturs,6,0,81,75
1657796138725,COGS 100,A01,083619,Allen; Michael Gordon,17,0,70,53
1657796144750,COGS 101A,A01,083621,Davis; Joshua Daniel,9,0,68,59
1657796150778,COGS 101B,A01,091572,Allen; Michael Gordon,12,0,65,53
1657796156803,COGS 101C,A01,083625,Delgado; Tania,17,0,35,18
1657796162830,COGS 107A,A01,083627,Boyle; Mary E. T.,14,0,60,46
1657796168858,COGS 118A,A01,083075,Gupta; Anjum,21,0,76,55
1657796174889,CSE 3,A50,083646,Miranda; Gregory Joseph,24,0,50,26
1657796180912,CSE 8A,A50,083650,Miranda; Gregory Joseph,17,1,56,39
1657796186936,CSE 11,A01,083080,Cao; Yingjun,6,15,40,34
1657796192967,CSE 12,A01,083652,Krause-Levy; Sophia Louisa,28,1,120,92
1657796198991,CSE 15L,A01,083654,Morris; Justin Loren,9,0,50,41
1657796198991,CSE 15L,A02,083655,Morris; Justin Loren,9,0,50,41
1657796205015,CSE 20,A01,083657,Tran; Khoa Dang,39,0,80,41
1657796211041,CSE 21,A01,095574,Bach; Quang Tran,22,0,48,26
1657796217066,CSE 30,A01,083084,Eldon; John,6,0,80,74
1657796217066,CSE 30,B01,095061,Bhaskar; Nishant,9,0,50,41
1657796223098,CSE 100,A01,083659,Cao; Yingjun,5,4,70,65
1657796229127,CSE 134B,A01,083661,Powell; Thomas Allan,24,0,100,76
1657796235156,CSE 140,A01,083663,Gungor; Onat,15,0,85,70
1657796241185,CSE 140L,A01,083088,Eldon; John,23,0,100,77
1657796247213,CSE 175,A01,083665,Kumar; Rakesh,3,0,25,22
1657796263645,CSE 190,A00,092507,Dubnov; Shlomo,8,0,20,12
1657796269679,ECE 45,A01,083139,Congero; Spencer William,6,0,75,69
1657796287269,ECE 65,A50,083695,Saad; Andrew S,12,0,30,18
1657796287269,ECE 65,A51,095125,Saad; Andrew S,24,0,26,2
1657796293319,ECE 109,A01,091882,Touri; Behrouz,20,0,70,50
1657796311418,ECE 180,A00,083140,Abi Samra; Nicholas Camill,1,0,30,29
1657796311418,ECE 180,B00,083141,Abi Samra; Nicholas Camill,0,0,30,30
1657796317446,MATH 10A,A01,083735,Patchell; Gregory David,2,0,30,28
1657796317446,MATH 10A,A02,083736,Patchell; Gregory David,20,0,30,10
1657796317446,MATH 10A,A03,083737,Patchell; Gregory David,16,0,30,14
1657796335113,MATH 10B,A01,083207,Lim; Seonhee,8,0,34,26
1657796335113,MATH 10B,A02,083208,Lim; Seonhee,10,0,35,25
1657796335113,MATH 10B,A03,093472,Lim; Seonhee,7,0,34,27
1657796335113,MATH 10B,B01,083739,Sinha; Shubham,13,0,30,17
1657796341164,MATH 18,A01,083743,Cinel; Cameron Alexander,9,0,30,21
1657796341164,MATH 18,A02,083744,Cinel; Cameron Alexander,18,0,30,12
1657796341164,MATH 18,A03,083745,Cinel; Cameron Alexander,10,0,30,20
1657796341164,MATH 18,B01,083748,Rideout; David Porter,5,0,37,32
1657796341164,MATH 18,B02,083749,Rideout; David Porter,5,0,36,31
1657796341164,MATH 18,B03,083750,Rideout; David Porter,3,0,37,34
1657796341164,MATH 18,B04,083751,Rideout; David Porter,6,0,36,30
1657796341164,MATH 18,B05,093473,Rideout; David Porter,6,0,36,30
1657796341164,MATH 18,B06,093474,Rideout; David Porter,6,0,36,30
1657796358708,MATH 20A,A01,083754,Zheng; Zequn,14,0,40,26
1657796364735,MATH 20B,A01,083756,Briones; Jor-el Thomas Caparas,4,0,36,32
1657796364735,MATH 20B,A02,083757,Briones; Jor-el Thomas Caparas,1,0,36,35
1657796364735,MATH 20B,A03,093475,Briones; Jor-el Thomas Caparas,2,0,36,34
1657796381579,MATH 20C,A01,083760,Briones; Jor-el Thomas Caparas,1,0,35,34
1657796381579,MATH 20C,A02,083761,Briones; Jor-el Thomas Caparas,8,0,35,27
1657796381579,MATH 20C,A03,093476,Briones; Jor-el Thomas Caparas,0,1,36,36
1657796381579,MATH 20C,B01,083762,Bach; Quang Tran,1,0,30,29
1657796387630,MATH 20D,A01,083765,Tran; Brian Kha,5,0,30,25
1657796387630,MATH 20D,A02,083766,Tran; Brian Kha,5,0,30,25
1657796387630,MATH 20D,A03,083767,Tran; Brian Kha,5,0,30,25
1657796404621,MATH 20E,A01,083771,Ganguly; Soumya,10,0,32,22
1657796404621,MATH 20E,A02,083772,Ganguly; Soumya,6,0,32,26
1657796404621,MATH 20E,B01,083773,Ciotti; Benjamin,20,0,35,15
1657796404621,MATH 20E,B02,083774,Ciotti; Benjamin,18,0,35,17
1657796410651,MATH 103A,A01,083777,Greenfeld; Be'Eri,3,0,36,33
1657796410651,MATH 103A,A02,083778,Greenfeld; Be'Eri,5,0,36,31
1657796410651,MATH 103A,A03,093561,Greenfeld; Be'Eri,6,0,36,30
1657796410651,MATH 103A,B01,083779,Greenfeld; Be'Eri,7,0,36,29
1657796410651,MATH 103A,B02,083780,Greenfeld; Be'Eri,4,0,36,32
1657796410651,MATH 103A,B03,093562,Greenfeld; Be'Eri,3,0,36,33
1657796430278,MATH 105,A01,085443,Carter; Anne Toulson,15,0,35,20
1657796430278,MATH 105,A02,093477,Carter; Anne Toulson,20,0,35,15
1657796436316,MATH 109,A01,083213,Ganzberger; Geoffrey Michael,3,0,34,31
1657796436316,MATH 109,A02,083214,Ganzberger; Geoffrey Michael,4,0,34,30
1657796436316,MATH 109,A03,093478,Ganzberger; Geoffrey Michael,2,0,34,32
1657796436316,MATH 109,B01,083215,Ganzberger; Geoffrey Michael,1,0,32,31
1657796436316,MATH 109,B02,083216,Ganzberger; Geoffrey Michael,2,0,32,30
1657796436316,MATH 109,B03,093479,Ganzberger; Geoffrey Michael,8,0,32,24
1657796454822,MATH 142A,A01,083219,Chow; Bennett,7,0,32,25
1657796454822,MATH 142A,A02,083220,Chow; Bennett,10,0,32,22
1657796454822,MATH 142A,A03,093480,Chow; Bennett,9,0,32,23
1657796454822,MATH 142A,B03,093481,Chow; Bennett,8,0,32,24
1657796454822,MATH 142A,B04,093558,Chow; Bennett,13,0,32,19
1657796454822,MATH 142A,B05,093559,Chow; Bennett,6,0,32,26
1657796460857,MATH 193A,A01,083224,Rotar; Vladimir,8,0,34,26
1657796460857,MATH 193A,A02,083225,Rotar; Vladimir,9,0,34,25
1657796460857,MATH 193A,A03,083781,Rotar; Vladimir,5,0,34,29
1657796460857,MATH 193A,A04,083782,Rotar; Vladimir,10,0,34,24
1657796460857,MATH 193A,A05,093482,Rotar; Vladimir,10,0,34,24
1657796479087,MATH 197,001,091859,McAuley; Julian John,9999,0,9999,0
1657796479087,MATH 197,002,095566,Kedlaya; Kiran S.,9997,0,9999,2
1657796479087,MATH 197,003,095567,Xiao; Ming,9999,0,9999,0
1657796479087,MATH 197,004,095571,Perols; Johan Lars,9998,0,9999,1
1657796486212,COGS 9,A01,083615,Shannon; Kyle Michael,9,0,75,66
1657796497413,COGS 11,A01,083617,Boyle; Mary E. T.,23,0,48,25
1657796503441,COGS 13,A01,083071,Bastos; Amalia Pinkusfeld,11,0,71,60
1657796509472,COGS 14A,A01,092681,Semenuks; Arturs,5,1,100,95
1657796515507,COGS 14B,A01,083073,Cheng; Tzu-Han,6,0,63,57
1657796521532,COGS 17,A01,092677,Semenuks; Arturs,6,0,81,75
1657796527556,COGS 100,A01,083619,Allen; Michael Gordon,17,0,70,53
1657796533582,COGS 101A,A01,083621,Davis; Joshua Daniel,9,0,68,59
1657796539611,COGS 101B,A01,091572,Allen; Michael Gordon,12,0,65,53
1657796545654,COGS 101C,A01,083625,Delgado; Tania,17,0,35,18
1657796551691,COGS 107A,A01,083627,Boyle; Mary E. T.,14,0,60,46
1657796557713,COGS 118A,A01,083075,Gupta; Anjum,21,0,76,55
1657796563739,CSE 3,A50,083646,Miranda; Gregory Joseph,24,0,50,26
1657796569763,CSE 8A,A50,083650,Miranda; Gregory Joseph,17,1,56,39
1657796575788,CSE 11,A01,083080,Cao; Yingjun,6,15,40,34
1657796581824,CSE 12,A01,083652,Krause-Levy; Sophia Louisa,28,1,120,92
1657796587852,CSE 15L,A01,083654,Morris; Justin Loren,9,0,50,41
1657796587852,CSE 15L,A02,083655,Morris; Justin Loren,9,0,50,41
1657796593893,CSE 20,A01,083657,Tran; Khoa Dang,39,0,80,41
1657796599930,CSE 21,A01,095574,Bach; Quang Tran,22,0,48,26
1657796605958,CSE 30,A01,083084,Eldon; John,6,0,80,74
1657796605958,CSE 30,B01,095061,Bhaskar; Nishant,9,0,50,41
1657796612088,CSE 100,A01,083659,Cao; Yingjun,5,4,70,65
1657796618118,CSE 134B,A01,083661,Powell; Thomas Allan,24,0,100,76
1657796624149,CSE 140,A01,083663,Gungor; Onat,15,0,85,70
1657796630190,CSE 140L,A01,083088,Eldon; John,23,0,100,77
1657796636219,CSE 175,A01,083665,Kumar; Rakesh,3,0,25,22
1657796642243,CSE 190,A00,092507,Dubnov; Shlomo,8,0,20,12
1657796648277,ECE 45,A01,083139,Congero; Spencer William,6,0,75,69
1657796654313,ECE 65,A50,083695,Saad; Andrew S,12,0,30,18
1657796654313,ECE 65,A51,095125,Saad; Andrew S,24,0,26,2
1657796660344,ECE 109,A01,091882,Touri; Behrouz,20,0,70,50
1657796666369,ECE 180,A00,083140,Abi Samra; Nicholas Camill,1,0,30,29
1657796666369,ECE 180,B00,083141,Abi Samra; Nicholas Camill,0,0,30,30
1657796672395,MATH 10A,A01,083735,Patchell; Gregory David,2,0,30,28
1657796672395,MATH 10A,A02,083736,Patchell; Gregory David,20,0,30,10
1657796672395,MATH 10A,A03,083737,Patchell; Gregory David,16,0,30,14
1657796678434,MATH 10B,A01,083207,Lim; Seonhee,8,0,34,26
1657796678434,MATH 10B,A02,083208,Lim; Seonhee,10,0,35,25
1657796678434,MATH 10B,A03,093472,Lim; Seonhee,7,0,34,27
1657796678434,MATH 10B,B01,083739,Sinha; Shubham,13,0,30,17
1657796684475,MATH 18,A01,083743,Cinel; Cameron Alexander,9,0,30,21
1657796684475,MATH 18,A02,083744,Cinel; Cameron Alexander,18,0,30,12
1657796684475,MATH 18,A03,083745,Cinel; Cameron Alexander,10,0,30,20
1657796684475,MATH 18,B01,083748,Rideout; David Porter,5,0,37,32
1657796684475,MATH 18,B02,083749,Rideout; David Porter,5,0,36,31
1657796684475,MATH 18,B03,083750,Rideout; David Porter,3,0,37,34
1657796684475,MATH 18,B04,083751,Rideout; David Porter,6,0,36,30
1657796684475,MATH 18,B05,093473,Rideout; David Porter,6,0,36,30
1657796684475,MATH 18,B06,093474,Rideout; David Porter,6,0,36,30
1657796690505,MATH 20A,A01,083754,Zheng; Zequn,14,0,40,26
1657796696563,MATH 20B,A01,083756,Briones; Jor-el Thomas Caparas,4,0,36,32
1657796696563,MATH 20B,A02,083757,Briones; Jor-el Thomas Caparas,1,0,36,35
1657796696563,MATH 20B,A03,093475,Briones; Jor-el Thomas Caparas,2,0,36,34
1657796702592,MATH 20C,A01,083760,Briones; Jor-el Thomas Caparas,1,0,35,34
1657796702592,MATH 20C,A02,083761,Briones; Jor-el Thomas Caparas,8,0,35,27
1657796702592,MATH 20C,A03,093476,Briones; Jor-el Thomas Caparas,0,1,36,36
1657796702592,MATH 20C,B01,083762,Bach; Quang Tran,1,0,30,29
1657796708638,MATH 20D,A01,083765,Tran; Brian Kha,5,0,30,25
1657796708638,MATH 20D,A02,083766,Tran; Brian Kha,5,0,30,25
1657796708638,MATH 20D,A03,083767,Tran; Brian Kha,5,0,30,25
1657796714671,MATH 20E,A01,083771,Ganguly; Soumya,10,0,32,22
1657796714671,MATH 20E,A02,083772,Ganguly; Soumya,6,0,32,26
1657796714671,MATH 20E,B01,083773,Ciotti; Benjamin,20,0,35,15
1657796714671,MATH 20E,B02,083774,Ciotti; Benjamin,18,0,35,17
1657796730968,MATH 103A,A01,083777,Greenfeld; Be'Eri,3,0,36,33
1657796730968,MATH 103A,A02,083778,Greenfeld; Be'Eri,5,0,36,31
1657796730968,MATH 103A,A03,093561,Greenfeld; Be'Eri,6,0,36,30
1657796730968,MATH 103A,B01,083779,Greenfeld; Be'Eri,7,0,36,29
1657796730968,MATH 103A,B02,083780,Greenfeld; Be'Eri,4,0,36,32
1657796730968,MATH 103A,B03,093562,Greenfeld; Be'Eri,3,0,36,33
1657796737001,MATH 105,A01,085443,Carter; Anne Toulson,15,0,35,20
1657796737001,MATH 105,A02,093477,Carter; Anne Toulson,20,0,35,15
1657796746156,MATH 109,A01,083213,Ganzberger; Geoffrey Michael,3,0,34,31
1657796746156,MATH 109,A02,083214,Ganzberger; Geoffrey Michael,4,0,34,30
1657796746156,MATH 109,A03,093478,Ganzberger; Geoffrey Michael,2,0,34,32
1657796746156,MATH 109,B01,083215,Ganzberger; Geoffrey Michael,1,0,32,31
1657796746156,MATH 109,B02,083216,Ganzberger; Geoffrey Michael,2,0,32,30
1657796746156,MATH 109,B03,093479,Ganzberger; Geoffrey Michael,8,0,32,24
1657796752188,MATH 142A,A01,083219,Chow; Bennett,7,0,32,25
1657796752188,MATH 142A,A02,083220,Chow; Bennett,10,0,32,22
1657796752188,MATH 142A,A03,093480,Chow; Bennett,9,0,32,23
1657796752188,MATH 142A,B03,093481,Chow; Bennett,8,0,32,24
1657796752188,MATH 142A,B04,093558,Chow; Bennett,13,0,32,19
1657796752188,MATH 142A,B05,093559,Chow; Bennett,6,0,32,26
1657796758217,MATH 193A,A01,083224,Rotar; Vladimir,8,0,34,26
1657796758217,MATH 193A,A02,083225,Rotar; Vladimir,9,0,34,25
1657796758217,MATH 193A,A03,083781,Rotar; Vladimir,5,0,34,29
1657796758217,MATH 193A,A04,083782,Rotar; Vladimir,10,0,34,24
1657796758217,MATH 193A,A05,093482,Rotar; Vladimir,10,0,34,24
1657796764260,MATH 197,001,091859,McAuley; Julian John,9999,0,9999,0
1657796764260,MATH 197,002,095566,Kedlaya; Kiran S.,9997,0,9999,2
1657796764260,MATH 197,003,095567,Xiao; Ming,9999,0,9999,0
1657796764260,MATH 197,004,095571,Perols; Johan Lars,9998,0,9999,1
1657796771342,COGS 9,A01,083615,Shannon; Kyle Michael,9,0,75,66
1657796777375,COGS 11,A01,083617,Boyle; Mary E. T.,23,0,48,25
1657796783402,COGS 13,A01,083071,Bastos; Amalia Pinkusfeld,11,0,71,60
1657796789436,COGS 14A,A01,092681,Semenuks; Arturs,5,1,100,95
1657796795472,COGS 14B,A01,083073,Cheng; Tzu-Han,6,0,63,57
1657796801496,COGS 17,A01,092677,Semenuks; Arturs,6,0,81,75
1657796807529,COGS 100,A01,083619,Allen; Michael Gordon,17,0,70,53
1657796813554,COGS 101A,A01,083621,Davis; Joshua Daniel,9,0,68,59
1657796819584,COGS 101B,A01,091572,Allen; Michael Gordon,12,0,65,53
1657796825610,COGS 101C,A01,083625,Delgado; Tania,17,0,35,18
1657796831636,COGS 107A,A01,083627,Boyle; Mary E. T.,14,0,60,46
1657796837667,COGS 118A,A01,083075,Gupta; Anjum,21,0,76,55
1657796843702,CSE 3,A50,083646,Miranda; Gregory Joseph,24,0,50,26
1657796849730,CSE 8A,A50,083650,Miranda; Gregory Joseph,17,1,56,39
1657796855769,CSE 11,A01,083080,Cao; Yingjun,6,15,40,34
1657796861795,CSE 12,A01,083652,Krause-Levy; Sophia Louisa,28,1,120,92
1657796867818,CSE 15L,A01,083654,Morris; Justin Loren,9,0,50,41
1657796867818,CSE 15L,A02,083655,Morris; Justin Loren,9,0,50,41
1657796873843,CSE 20,A01,083657,Tran; Khoa Dang,39,0,80,41
1657796879878,CSE 21,A01,095574,Bach; Quang Tran,22,0,48,26
1657796885904,CSE 30,A01,083084,Eldon; John,6,0,80,74
1657796885904,CSE 30,B01,095061,Bhaskar; Nishant,9,0,50,41
1657796891930,CSE 100,A01,083659,Cao; Yingjun,5,4,70,65
1657796897966,CSE 134B,A01,083661,Powell; Thomas Allan,24,0,100,76
1657796903998,CSE 140,A01,083663,Gungor; Onat,15,0,85,70
1657796910022,CSE 140L,A01,083088,Eldon; John,23,0,100,77
1657796916047,CSE 175,A01,083665,Kumar; Rakesh,3,0,25,22
1657796922079,CSE 190,A00,092507,Dubnov; Shlomo,8,0,20,12
1657796928117,ECE 45,A01,083139,Congero; Spencer William,6,0,75,69
1657796934146,ECE 65,A50,083695,Saad; Andrew S,12,0,30,18
1657796934146,ECE 65,A51,095125,Saad; Andrew S,24,0,26,2
1657796940177,ECE 109,A01,091882,Touri; Behrouz,20,0,70,50
1657796946202,ECE 180,A00,083140,Abi Samra; Nicholas Camill,1,0,30,29
1657796946202,ECE 180,B00,083141,Abi Samra; Nicholas Camill,0,0,30,30
1657796952464,MATH 10A,A01,083735,Patchell; Gregory David,2,0,30,28
1657796952464,MATH 10A,A02,083736,Patchell; Gregory David,20,0,30,10
1657796952464,MATH 10A,A03,083737,Patchell; Gregory David,16,0,30,14
1657796958501,MATH 10B,A01,083207,Lim; Seonhee,8,0,34,26
1657796958501,MATH 10B,A02,083208,Lim; Seonhee,10,0,35,25
1657796958501,MATH 10B,A03,093472,Lim; Seonhee,7,0,34,27
1657796958501,MATH 10B,B01,083739,Sinha; Shubham,13,0,30,17
1657796964529,MATH 18,A01,083743,Cinel; Cameron Alexander,9,0,30,21
1657796964529,MATH 18,A02,083744,Cinel; Cameron Alexander,18,0,30,12
1657796964529,MATH 18,A03,083745,Cinel; Cameron Alexander,10,0,30,20
1657796964529,MATH 18,B01,083748,Rideout; David Porter,5,0,37,32
1657796964529,MATH 18,B02,083749,Rideout; David Porter,5,0,36,31
1657796964529,MATH 18,B03,083750,Rideout; David Porter,3,0,37,34
1657796964529,MATH 18,B04,083751,Rideout; David Porter,6,0,36,30
1657796964529,MATH 18,B05,093473,Rideout; David Porter,6,0,36,30
1657796964529,MATH 18,B06,093474,Rideout; David Porter,6,0,36,30
1657796970560,MATH 20A,A01,083754,Zheng; Zequn,14,0,40,26
1657796976598,MATH 20B,A01,083756,Briones; Jor-el Thomas Caparas,4,0,36,32
1657796976598,MATH 20B,A02,083757,Briones; Jor-el Thomas Caparas,1,0,36,35
1657796976598,MATH 20B,A03,093475,Briones; Jor-el Thomas Caparas,2,0,36,34
1657796982654,MATH 20C,A01,083760,Briones; Jor-el Thomas Caparas,1,0,35,34
1657796982654,MATH 20C,A02,083761,Briones; Jor-el Thomas Caparas,8,0,35,27
1657796982654,MATH 20C,A03,093476,Briones; Jor-el Thomas Caparas,0,1,36,36
1657796982654,MATH 20C,B01,083762,Bach; Quang Tran,1,0,30,29
1657796988680,MATH 20D,A01,083765,Tran; Brian Kha,5,0,30,25
1657796988680,MATH 20D,A02,083766,Tran; Brian Kha,5,0,30,25
1657796988680,MATH 20D,A03,083767,Tran; Brian Kha,5,0,30,25
1657796994707,MATH 20E,A01,083771,Ganguly; Soumya,10,0,32,22
1657796994707,MATH 20E,A02,083772,Ganguly; Soumya,6,0,32,26
1657796994707,MATH 20E,B01,083773,Ciotti; Benjamin,20,0,35,15
1657796994707,MATH 20E,B02,083774,Ciotti; Benjamin,18,0,35,17
1657797000746,MATH 103A,A01,083777,Greenfeld; Be'Eri,3,0,36,33
1657797000746,MATH 103A,A02,083778,Greenfeld; Be'Eri,5,0,36,31
1657797000746,MATH 103A,A03,093561,Greenfeld; Be'Eri,6,0,36,30
1657797000746,MATH 103A,B01,083779,Greenfeld; Be'Eri,7,0,36,29
1657797000746,MATH 103A,B02,083780,Greenfeld; Be'Eri,4,0,36,32
1657797000746,MATH 103A,B03,093562,Greenfeld; Be'Eri,3,0,36,33
1657797006770,MATH 105,A01,085443,Carter; Anne Toulson,15,0,35,20
1657797006770,MATH 105,A02,093477,Carter; Anne Toulson,20,0,35,15
1657797012795,MATH 109,A01,083213,Ganzberger; Geoffrey Michael,3,0,34,31
1657797012795,MATH 109,A02,083214,Ganzberger; Geoffrey Michael,4,0,34,30
1657797012795,MATH 109,A03,093478,Ganzberger; Geoffrey Michael,2,0,34,32
1657797012795,MATH 109,B01,083215,Ganzberger; Geoffrey Michael,1,0,32,31
1657797012795,MATH 109,B02,083216,Ganzberger; Geoffrey Michael,2,0,32,30
1657797012795,MATH 109,B03,093479,Ganzberger; Geoffrey Michael,8,0,32,24
1657797018833,MATH 142A,A01,083219,Chow; Bennett,7,0,32,25
1657797018833,MATH 142A,A02,083220,Chow; Bennett,10,0,32,22
1657797018833,MATH 142A,A03,093480,Chow; Bennett,9,0,32,23
1657797018833,MATH 142A,B03,093481,Chow; Bennett,8,0,32,24
1657797018833,MATH 142A,B04,093558,Chow; Bennett,13,0,32,19
1657797018833,MATH 142A,B05,093559,Chow; Bennett,6,0,32,26
1657797024858,MATH 193A,A01,083224,Rotar; Vladimir,8,0,34,26
1657797024858,MATH 193A,A02,083225,Rotar; Vladimir,9,0,34,25
1657797024858,MATH 193A,A03,083781,Rotar; Vladimir,5,0,34,29
1657797024858,MATH 193A,A04,083782,Rotar; Vladimir,10,0,34,24
1657797024858,MATH 193A,A05,093482,Rotar; Vladimir,10,0,34,24
1657797030886,MATH 197,001,091859,McAuley; Julian John,9999,0,9999,0
1657797030886,MATH 197,002,095566,Kedlaya; Kiran S.,9997,0,9999,2
1657797030886,MATH 197,003,095567,Xiao; Ming,9999,0,9999,0
1657797030886,MATH 197,004,095571,Perols; Johan Lars,9998,0,9999,1
1657797037972,COGS 9,A01,083615,Shannon; Kyle Michael,9,0,75,66
1657797043999,COGS 11,A01,083617,Boyle; Mary E. T.,23,0,48,25
1657797050026,COGS 13,A01,083071,Bastos; Amalia Pinkusfeld,11,0,71,60
1657797058161,COGS 14A,A01,092681,Semenuks; Arturs,5,1,100,95
1657797064185,COGS 14B,A01,083073,Cheng; Tzu-Han,6,0,63,57
1657797070216,COGS 17,A01,092677,Semenuks; Arturs,6,0,81,75
1657797076252,COGS 100,A01,083619,Allen; Michael Gordon,17,0,70,53
1657797082277,COGS 101A,A01,083621,Davis; Joshua Daniel,9,0,68,59
1657797088300,COGS 101B,A01,091572,Allen; Michael Gordon,12,0,65,53
1657797094324,COGS 101C,A01,083625,Delgado; Tania,17,0,35,18
1657797100501,COGS 107A,A01,083627,Boyle; Mary E. T.,14,0,60,46
1657797106526,COGS 118A,A01,083075,Gupta; Anjum,21,0,76,55
1657797112553,CSE 3,A50,083646,Miranda; Gregory Joseph,24,0,50,26
1657797118587,CSE 8A,A50,083650,Miranda; Gregory Joseph,17,1,56,39
1657797124612,CSE 11,A01,083080,Cao; Yingjun,6,15,40,34
1657797130656,CSE 12,A01,083652,Krause-Levy; Sophia Louisa,28,1,120,92
1657797136684,CSE 15L,A01,083654,Morris; Justin Loren,9,0,50,41
1657797136684,CSE 15L,A02,083655,Morris; Justin Loren,9,0,50,41
1657797142709,CSE 20,A01,083657,Tran; Khoa Dang,39,0,80,41
1657797148735,CSE 21,A01,095574,Bach; Quang Tran,22,0,48,26
1657797154760,CSE 30,A01,083084,Eldon; John,6,0,80,74
1657797154760,CSE 30,B01,095061,Bhaskar; Nishant,9,0,50,41
1657797160785,CSE 100,A01,083659,Cao; Yingjun,5,4,70,65
1657797166809,CSE 134B,A01,083661,Powell; Thomas Allan,24,0,100,76
1657797172836,CSE 140,A01,083663,Gungor; Onat,15,0,85,70
1657797178866,CSE 140L,A01,083088,Eldon; John,23,0,100,77
1657797184893,CSE 175,A01,083665,Kumar; Rakesh,3,0,25,22
1657797190919,CSE 190,A00,092507,Dubnov; Shlomo,8,0,20,12
1657797196945,ECE 45,A01,083139,Congero; Spencer William,6,0,75,69
1657797202982,ECE 65,A50,083695,Saad; Andrew S,12,0,30,18
1657797202982,ECE 65,A51,095125,Saad; Andrew S,24,0,26,2
1657797209007,ECE 109,A01,091882,Touri; Behrouz,20,0,70,50
1657797215044,ECE 180,A00,083140,Abi Samra; Nicholas Camill,1,0,30,29
1657797215044,ECE 180,B00,083141,Abi Samra; Nicholas Camill,0,0,30,30
1657797221080,MATH 10A,A01,083735,Patchell; Gregory David,2,0,30,28
1657797221080,MATH 10A,A02,083736,Patchell; Gregory David,20,0,30,10
1657797221080,MATH 10A,A03,083737,Patchell; Gregory David,16,0,30,14
1657797227204,MATH 10B,A01,083207,Lim; Seonhee,8,0,34,26
1657797227204,MATH 10B,A02,083208,Lim; Seonhee,10,0,35,25
1657797227204,MATH 10B,A03,093472,Lim; Seonhee,7,0,34,27
1657797227204,MATH 10B,B01,083739,Sinha; Shubham,13,0,30,17
1657797233248,MATH 18,A01,083743,Cinel; Cameron Alexander,9,0,30,21
1657797233248,MATH 18,A02,083744,Cinel; Cameron Alexander,18,0,30,12
1657797233248,MATH 18,A03,083745,Cinel; Cameron Alexander,10,0,30,20
1657797233248,MATH 18,B01,083748,Rideout; David Porter,5,0,37,32
1657797233248,MATH 18,B02,083749,Rideout; David Porter,5,0,36,31
1657797233248,MATH 18,B03,083750,Rideout; David Porter,3,0,37,34
1657797233248,MATH 18,B04,083751,Rideout; David Porter,6,0,36,30
1657797233248,MATH 18,B05,093473,Rideout; David Porter,6,0,36,30
1657797233248,MATH 18,B06,093474,Rideout; David Porter,6,0,36,30
1657797239276,MATH 20A,A01,083754,Zheng; Zequn,14,0,40,26
1657797245312,MATH 20B,A01,083756,Briones; Jor-el Thomas Caparas,4,0,36,32
1657797245312,MATH 20B,A02,083757,Briones; Jor-el Thomas Caparas,1,0,36,35
1657797245312,MATH 20B,A03,093475,Briones; Jor-el Thomas Caparas,2,0,36,34
1657797251339,MATH 20C,A01,083760,Briones; Jor-el Thomas Caparas,1,0,35,34
1657797251339,MATH 20C,A02,083761,Briones; Jor-el Thomas Caparas,8,0,35,27
1657797251339,MATH 20C,A03,093476,Briones; Jor-el Thomas Caparas,0,1,36,36
1657797251339,MATH 20C,B01,083762,Bach; Quang Tran,1,0,30,29
1657797257364,MATH 20D,A01,083765,Tran; Brian Kha,5,0,30,25
1657797257364,MATH 20D,A02,083766,Tran; Brian Kha,5,0,30,25
1657797257364,MATH 20D,A03,083767,Tran; Brian Kha,5,0,30,25
1657797263400,MATH 20E,A01,083771,Ganguly; Soumya,10,0,32,22
1657797263400,MATH 20E,A02,083772,Ganguly; Soumya,6,0,32,26
1657797263400,MATH 20E,B01,083773,Ciotti; Benjamin,20,0,35,15
1657797263400,MATH 20E,B02,083774,Ciotti; Benjamin,18,0,35,17
1657797269439,MATH 103A,A01,083777,Greenfeld; Be'Eri,3,0,36,33
1657797269439,MATH 103A,A02,083778,Greenfeld; Be'Eri,5,0,36,31
1657797269439,MATH 103A,A03,093561,Greenfeld; Be'Eri,6,0,36,30
1657797269439,MATH 103A,B01,083779,Greenfeld; Be'Eri,7,0,36,29
1657797269439,MATH 103A,B02,083780,Greenfeld; Be'Eri,4,0,36,32
1657797269439,MATH 103A,B03,093562,Greenfeld; Be'Eri,3,0,36,33
1657797275473,MATH 105,A01,085443,Carter; Anne Toulson,15,0,35,20
1657797275473,MATH 105,A02,093477,Carter; Anne Toulson,20,0,35,15
1657797281515,MATH 109,A01,083213,Ganzberger; Geoffrey Michael,3,0,34,31
1657797281515,MATH 109,A02,083214,Ganzberger; Geoffrey Michael,4,0,34,30
1657797281515,MATH 109,A03,093478,Ganzberger; Geoffrey Michael,2,0,34,32
1657797281515,MATH 109,B01,083215,Ganzberger; Geoffrey Michael,1,0,32,31
1657797281515,MATH 109,B02,083216,Ganzberger; Geoffrey Michael,2,0,32,30
1657797281515,MATH 109,B03,093479,Ganzberger; Geoffrey Michael,8,0,32,24
1657797287554,MATH 142A,A01,083219,Chow; Bennett,7,0,32,25
1657797287554,MATH 142A,A02,083220,Chow; Bennett,10,0,32,22
1657797287554,MATH 142A,A03,093480,Chow; Bennett,9,0,32,23
1657797287554,MATH 142A,B03,093481,Chow; Bennett,8,0,32,24
1657797287554,MATH 142A,B04,093558,Chow; Bennett,13,0,32,19
1657797287554,MATH 142A,B05,093559,Chow; Bennett,6,0,32,26
1657797293594,MATH 193A,A01,083224,Rotar; Vladimir,8,0,34,26
1657797293594,MATH 193A,A02,083225,Rotar; Vladimir,9,0,34,25
1657797293594,MATH 193A,A03,083781,Rotar; Vladimir,5,0,34,29
1657797293594,MATH 193A,A04,083782,Rotar; Vladimir,10,0,34,24
1657797293594,MATH 193A,A05,093482,Rotar; Vladimir,10,0,34,24
1657797299620,MATH 197,001,091859,McAuley; Julian John,9999,0,9999,0
1657797299620,MATH 197,002,095566,Kedlaya; Kiran S.,9997,0,9999,2
1657797299620,MATH 197,003,095567,Xiao; Ming,9999,0,9999,0
1657797299620,MATH 197,004,095571,Perols; Johan Lars,9998,0,9999,1
1657797306716,COGS 9,A01,083615,Shannon; Kyle Michael,9,0,75,66
1657797312740,COGS 11,A01,083617,Boyle; Mary E. T.,23,0,48,25
1657797318767,COGS 13,A01,083071,Bastos; Amalia Pinkusfeld,11,0,71,60
1657797324794,COGS 14A,A01,092681,Semenuks; Arturs,5,1,100,95
1657797330828,COGS 14B,A01,083073,Cheng; Tzu-Han,6,0,63,57
1657797336853,COGS 17,A01,092677,Semenuks; Arturs,6,0,81,75
1657797342896,COGS 100,A01,083619,Allen; Michael Gordon,17,0,70,53
1657797348921,COGS 101A,A01,083621,Davis; Joshua Daniel,9,0,68,59
1657797354949,COGS 101B,A01,091572,Allen; Michael Gordon,12,0,65,53
1657797360981,COGS 101C,A01,083625,Delgado; Tania,17,0,35,18
1657797367006,COGS 107A,A01,083627,Boyle; Mary E. T.,14,0,60,46
1657797373033,COGS 118A,A01,083075,Gupta; Anjum,21,0,76,55
1657797379067,CSE 3,A50,083646,Miranda; Gregory Joseph,24,0,50,26
1657797385096,CSE 8A,A50,083650,Miranda; Gregory Joseph,17,1,56,39
1657797391121,CSE 11,A01,083080,Cao; Yingjun,6,15,40,34
1657797397147,CSE 12,A01,083652,Krause-Levy; Sophia Louisa,28,1,120,92
1657797403180,CSE 15L,A01,083654,Morris; Justin Loren,9,0,50,41
1657797403180,CSE 15L,A02,083655,Morris; Justin Loren,9,0,50,41
1657797409208,CSE 20,A01,083657,Tran; Khoa Dang,39,0,80,41
1657797415234,CSE 21,A01,095574,Bach; Quang Tran,22,0,48,26
1657797421269,CSE 30,A01,083084,Eldon; John,6,0,80,74
1657797421269,CSE 30,B01,095061,Bhaskar; Nishant,9,0,50,41
1657797427301,CSE 100,A01,083659,Cao; Yingjun,5,4,70,65
1657797433333,CSE 134B,A01,083661,Powell; Thomas Allan,24,0,100,76
1657797439367,CSE 140,A01,083663,Gungor; Onat,15,0,85,70
1657797445393,CSE 140L,A01,083088,Eldon; John,23,0,100,77
